date,county,fips,population,confirmed_cases,reported_cases,probable_cases,reported_and_probable_cases,reported_deaths
2022-04-11,Alameda,001,1643700,256680,256649,13879,270528,1826
2022-04-11,Alpine,003,1148,124,124,1,125,0
2022-04-11,Amador,005,37829,8526,8489,646,9135,86
2022-04-11,Butte,007,227075,33037,33031,6659,39690,399
2022-04-11,Calaveras,009,45235,7261,7260,356,7616,119
2022-04-11,Colusa,011,21464,3449,3449,1080,4529,21
2022-04-11,Contra Costa,013,1133247,189206,189154,13263,202417,1296
2022-04-11,Del Norte,015,27424,5813,5811,197,6008,50
2022-04-11,El Dorado,017,186661,26758,26757,3212,29969,207
2022-04-11,Fresno,019,978130,231097,231090,22730,253820,2731
2022-04-11,Glenn,021,27897,4986,4988,1576,6564,47
2022-04-11,Humboldt,023,135768,16914,16913,2977,19890,141
2022-04-11,Imperial,025,180216,55269,55267,11125,66392,910
2022-04-11,Inyo,027,18085,4071,4071,484,4555,56
2022-04-11,Kern,029,883053,191600,191542,46297,237839,2244
2022-04-11,Kings,031,150075,51527,51519,3618,55137,443
2022-04-11,Lake,033,64148,10693,10690,898,11588,134
2022-04-11,Lassen,035,31185,8949,8948,896,9844,65
2022-04-11,Los Angeles,037,10098052,2709466,2709735,123415,2833150,31509
2022-04-11,Madera,039,155013,37377,37356,6066,43422,354
2022-04-11,Marin,041,260295,33643,33648,2250,35898,288
2022-04-11,Mariposa,043,17540,2395,2394,202,2596,29
2022-04-11,Mendocino,045,87422,13084,13087,2990,16077,120
2022-04-11,Merced,047,269075,62253,62231,8519,70750,811
2022-04-11,Modoc,049,8938,743,743,252,995,8
2022-04-11,Mono,051,14174,2967,2967,122,3089,6
2022-04-11,Monterey,053,433212,79198,79103,13765,92868,727
2022-04-11,Napa,055,140530,25827,25824,968,26792,144
2022-04-11,Nevada,057,99092,15970,15976,1213,17189,123
2022-04-11,Orange,059,3164182,546996,546983,41355,588338,6912
2022-04-11,Placer,061,380077,62835,62831,7357,70188,616
2022-04-11,Plumas,063,18699,2886,2887,360,3247,13
2022-04-11,Riverside,065,2383286,591296,591268,28140,619408,6429
2022-04-11,Sacramento,067,1510023,277142,277125,26883,304008,2972
2022-04-11,San Benito,069,59416,12916,12917,520,13437,98
2022-04-11,San Bernardino,071,2135413,562541,562571,24655,587226,6892
2022-04-11,San Diego,073,3302833,754282,754281,51518,805799,5210
2022-04-11,San Francisco,075,870044,125940,125963,8406,134369,844
2022-04-11,San Joaquin,077,732212,166574,166547,9187,175734,2212
2022-04-11,San Luis Obispo,079,281455,52606,52609,3779,56388,476
2022-04-11,San Mateo,081,765935,121509,121514,7059,128573,698
2022-04-11,Santa Barbara,083,443738,85768,85754,4841,90595,680
2022-04-11,Santa Clara,085,1922200,313980,313965,12457,326422,2266
2022-04-11,Santa Cruz,087,273765,47630,47624,2087,49711,259
2022-04-11,Shasta,089,179085,30589,30586,6181,36767,549
2022-04-11,Sierra,091,2930,272,272,42,314,4
2022-04-11,Siskiyou,093,43540,4444,4444,2756,7200,80
2022-04-11,Solano,095,438530,81892,81886,5546,87432,448
2022-04-11,Sonoma,097,501317,83598,83600,2519,86119,485
2022-04-11,Stanislaus,099,539301,117518,117528,17126,134654,1578
2022-04-11,Sutter,101,95872,20589,20591,2094,22685,223
2022-04-11,Tehama,103,63373,12054,12059,2606,14665,201
2022-04-11,Trinity,105,12862,1177,1177,292,1469,20
2022-04-11,Tulare,107,460477,105306,105278,28433,133711,1415
2022-04-11,Tuolumne,109,53932,12629,12632,567,13199,180
2022-04-11,Ventura,111,848112,173346,173343,9281,182624,1467
2022-04-11,Yolo,113,214977,36586,36587,3192,39779,312
2022-04-11,Yuba,115,75493,15848,15848,1211,17059,121
2022-04-10,Alameda,001,1643700,256680,256649,13879,270528,1826
2022-04-10,Alpine,003,1148,124,124,1,125,0
2022-04-10,Amador,005,37829,8526,8489,646,9135,86
2022-04-10,Butte,007,227075,33037,33031,6659,39690,399
2022-04-10,Calaveras,009,45235,7261,7260,356,7616,119
2022-04-10,Colusa,011,21464,3449,3449,1080,4529,21
2022-04-10,Contra Costa,013,1133247,189206,189154,13263,202417,1296
2022-04-10,Del Norte,015,27424,5813,5811,197,6008,50
2022-04-10,El Dorado,017,186661,26758,26757,3212,29969,207
2022-04-10,Fresno,019,978130,231097,231090,22730,253820,2731
2022-04-10,Glenn,021,27897,4986,4988,1576,6564,47
2022-04-10,Humboldt,023,135768,16914,16913,2977,19890,141
2022-04-10,Imperial,025,180216,55269,55267,11125,66392,910
2022-04-10,Inyo,027,18085,4071,4071,484,4555,56
2022-04-10,Kern,029,883053,191600,191542,46297,237839,2244
2022-04-10,Kings,031,150075,51527,51519,3618,55137,443
2022-04-10,Lake,033,64148,10693,10690,898,11588,134
2022-04-10,Lassen,035,31185,8949,8948,896,9844,65
2022-04-10,Los Angeles,037,10098052,2709466,2709735,123415,2833150,31509
2022-04-10,Madera,039,155013,37377,37356,6066,43422,354
2022-04-10,Marin,041,260295,33643,33648,2250,35898,288
2022-04-10,Mariposa,043,17540,2395,2394,202,2596,29
2022-04-10,Mendocino,045,87422,13084,13087,2990,16077,120
2022-04-10,Merced,047,269075,62253,62231,8519,70750,811
2022-04-10,Modoc,049,8938,743,743,252,995,8
2022-04-10,Mono,051,14174,2967,2967,122,3089,6
2022-04-10,Monterey,053,433212,79198,79103,13765,92868,727
2022-04-10,Napa,055,140530,25827,25824,968,26792,144
2022-04-10,Nevada,057,99092,15970,15976,1213,17189,123
2022-04-10,Orange,059,3164182,546996,546983,41355,588338,6912
2022-04-10,Placer,061,380077,62835,62831,7357,70188,616
2022-04-10,Plumas,063,18699,2886,2887,360,3247,13
2022-04-10,Riverside,065,2383286,591296,591268,28140,619408,6429
2022-04-10,Sacramento,067,1510023,277142,277125,26883,304008,2972
2022-04-10,San Benito,069,59416,12916,12917,520,13437,98
2022-04-10,San Bernardino,071,2135413,562541,562571,24655,587226,6892
2022-04-10,San Diego,073,3302833,754282,754281,51518,805799,5210
2022-04-10,San Francisco,075,870044,125940,125963,8406,134369,844
2022-04-10,San Joaquin,077,732212,166574,166547,9187,175734,2212
2022-04-10,San Luis Obispo,079,281455,52606,52609,3779,56388,476
2022-04-10,San Mateo,081,765935,121509,121514,7059,128573,698
2022-04-10,Santa Barbara,083,443738,85768,85754,4841,90595,680
2022-04-10,Santa Clara,085,1922200,313980,313965,12457,326422,2266
2022-04-10,Santa Cruz,087,273765,47630,47624,2087,49711,259
2022-04-10,Shasta,089,179085,30589,30586,6181,36767,549
2022-04-10,Sierra,091,2930,272,272,42,314,4
2022-04-10,Siskiyou,093,43540,4444,4444,2756,7200,80
2022-04-10,Solano,095,438530,81892,81886,5546,87432,448
2022-04-10,Sonoma,097,501317,83598,83600,2519,86119,485
2022-04-10,Stanislaus,099,539301,117518,117528,17126,134654,1578
2022-04-10,Sutter,101,95872,20589,20591,2094,22685,223
2022-04-10,Tehama,103,63373,12054,12059,2606,14665,201
2022-04-10,Trinity,105,12862,1177,1177,292,1469,20
2022-04-10,Tulare,107,460477,105306,105278,28433,133711,1415
2022-04-10,Tuolumne,109,53932,12629,12632,567,13199,180
2022-04-10,Ventura,111,848112,173346,173343,9281,182624,1467
2022-04-10,Yolo,113,214977,36586,36587,3192,39779,312
2022-04-10,Yuba,115,75493,15848,15848,1211,17059,121
2022-04-09,Alameda,001,1643700,256680,256649,13879,270528,1826
2022-04-09,Alpine,003,1148,124,124,1,125,0
2022-04-09,Amador,005,37829,8526,8489,646,9135,86
2022-04-09,Butte,007,227075,33037,33031,6659,39690,399
2022-04-09,Calaveras,009,45235,7261,7260,356,7616,119
2022-04-09,Colusa,011,21464,3449,3449,1080,4529,21
2022-04-09,Contra Costa,013,1133247,189206,189154,13263,202417,1296
2022-04-09,Del Norte,015,27424,5813,5811,197,6008,50
2022-04-09,El Dorado,017,186661,26758,26757,3212,29969,207
2022-04-09,Fresno,019,978130,231097,231090,22730,253820,2731
2022-04-09,Glenn,021,27897,4986,4988,1576,6564,47
2022-04-09,Humboldt,023,135768,16914,16913,2977,19890,141
2022-04-09,Imperial,025,180216,55269,55267,11125,66392,910
2022-04-09,Inyo,027,18085,4071,4071,484,4555,56
2022-04-09,Kern,029,883053,191600,191542,46297,237839,2244
2022-04-09,Kings,031,150075,51527,51519,3618,55137,443
2022-04-09,Lake,033,64148,10693,10690,898,11588,134
2022-04-09,Lassen,035,31185,8949,8948,896,9844,65
2022-04-09,Los Angeles,037,10098052,2709466,2709735,123415,2833150,31509
2022-04-09,Madera,039,155013,37377,37356,6066,43422,354
2022-04-09,Marin,041,260295,33643,33648,2250,35898,288
2022-04-09,Mariposa,043,17540,2395,2394,202,2596,29
2022-04-09,Mendocino,045,87422,13084,13087,2990,16077,120
2022-04-09,Merced,047,269075,62253,62231,8519,70750,811
2022-04-09,Modoc,049,8938,743,743,252,995,8
2022-04-09,Mono,051,14174,2967,2967,122,3089,6
2022-04-09,Monterey,053,433212,79198,79103,13765,92868,727
2022-04-09,Napa,055,140530,25827,25824,968,26792,144
2022-04-09,Nevada,057,99092,15970,15976,1213,17189,123
2022-04-09,Orange,059,3164182,546996,546983,41355,588338,6912
2022-04-09,Placer,061,380077,62835,62831,7357,70188,616
2022-04-09,Plumas,063,18699,2886,2887,360,3247,13
2022-04-09,Riverside,065,2383286,591296,591268,28140,619408,6429
2022-04-09,Sacramento,067,1510023,277142,277125,26883,304008,2972
2022-04-09,San Benito,069,59416,12916,12917,520,13437,98
2022-04-09,San Bernardino,071,2135413,562541,562571,24655,587226,6892
2022-04-09,San Diego,073,3302833,754282,754281,51518,805799,5210
2022-04-09,San Francisco,075,870044,125940,125963,8406,134369,844
2022-04-09,San Joaquin,077,732212,166574,166547,9187,175734,2212
2022-04-09,San Luis Obispo,079,281455,52606,52609,3779,56388,476
2022-04-09,San Mateo,081,765935,121509,121514,7059,128573,698
2022-04-09,Santa Barbara,083,443738,85768,85754,4841,90595,680
2022-04-09,Santa Clara,085,1922200,313980,313965,12457,326422,2266
2022-04-09,Santa Cruz,087,273765,47630,47624,2087,49711,259
2022-04-09,Shasta,089,179085,30589,30586,6181,36767,549
2022-04-09,Sierra,091,2930,272,272,42,314,4
2022-04-09,Siskiyou,093,43540,4444,4444,2756,7200,80
2022-04-09,Solano,095,438530,81892,81886,5546,87432,448
2022-04-09,Sonoma,097,501317,83598,83600,2519,86119,485
2022-04-09,Stanislaus,099,539301,117518,117528,17126,134654,1578
2022-04-09,Sutter,101,95872,20589,20591,2094,22685,223
2022-04-09,Tehama,103,63373,12054,12059,2606,14665,201
2022-04-09,Trinity,105,12862,1177,1177,292,1469,20
2022-04-09,Tulare,107,460477,105306,105278,28433,133711,1415
2022-04-09,Tuolumne,109,53932,12629,12632,567,13199,180
2022-04-09,Ventura,111,848112,173346,173343,9281,182624,1467
2022-04-09,Yolo,113,214977,36586,36587,3192,39779,312
2022-04-09,Yuba,115,75493,15848,15848,1211,17059,121
2022-04-08,Alameda,001,1643700,256680,256649,13879,270528,1826
2022-04-08,Alpine,003,1148,124,124,1,125,0
2022-04-08,Amador,005,37829,8526,8489,646,9135,86
2022-04-08,Butte,007,227075,33037,33031,6659,39690,399
2022-04-08,Calaveras,009,45235,7261,7260,356,7616,119
2022-04-08,Colusa,011,21464,3449,3449,1080,4529,21
2022-04-08,Contra Costa,013,1133247,189206,189154,13263,202417,1296
2022-04-08,Del Norte,015,27424,5813,5811,197,6008,50
2022-04-08,El Dorado,017,186661,26758,26757,3212,29969,207
2022-04-08,Fresno,019,978130,231097,231090,22730,253820,2731
2022-04-08,Glenn,021,27897,4986,4988,1576,6564,47
2022-04-08,Humboldt,023,135768,16914,16913,2977,19890,141
2022-04-08,Imperial,025,180216,55269,55267,11125,66392,910
2022-04-08,Inyo,027,18085,4071,4071,484,4555,56
2022-04-08,Kern,029,883053,191600,191542,46297,237839,2244
2022-04-08,Kings,031,150075,51527,51519,3618,55137,443
2022-04-08,Lake,033,64148,10693,10690,898,11588,134
2022-04-08,Lassen,035,31185,8949,8948,896,9844,65
2022-04-08,Los Angeles,037,10098052,2709466,2709735,123415,2833150,31509
2022-04-08,Madera,039,155013,37377,37356,6066,43422,354
2022-04-08,Marin,041,260295,33643,33648,2250,35898,288
2022-04-08,Mariposa,043,17540,2395,2394,202,2596,29
2022-04-08,Mendocino,045,87422,13084,13087,2990,16077,120
2022-04-08,Merced,047,269075,62253,62231,8519,70750,811
2022-04-08,Modoc,049,8938,743,743,252,995,8
2022-04-08,Mono,051,14174,2967,2967,122,3089,6
2022-04-08,Monterey,053,433212,79198,79103,13765,92868,727
2022-04-08,Napa,055,140530,25827,25824,968,26792,144
2022-04-08,Nevada,057,99092,15970,15976,1213,17189,123
2022-04-08,Orange,059,3164182,546996,546983,41355,588338,6912
2022-04-08,Placer,061,380077,62835,62831,7357,70188,616
2022-04-08,Plumas,063,18699,2886,2887,360,3247,13
2022-04-08,Riverside,065,2383286,591296,591268,28140,619408,6429
2022-04-08,Sacramento,067,1510023,277142,277125,26883,304008,2972
2022-04-08,San Benito,069,59416,12916,12917,520,13437,98
2022-04-08,San Bernardino,071,2135413,562541,562571,24655,587226,6892
2022-04-08,San Diego,073,3302833,754282,754281,51518,805799,5210
2022-04-08,San Francisco,075,870044,125940,125963,8406,134369,844
2022-04-08,San Joaquin,077,732212,166574,166547,9187,175734,2212
2022-04-08,San Luis Obispo,079,281455,52606,52609,3779,56388,476
2022-04-08,San Mateo,081,765935,121509,121514,7059,128573,698
2022-04-08,Santa Barbara,083,443738,85768,85754,4841,90595,680
2022-04-08,Santa Clara,085,1922200,313980,313965,12457,326422,2266
2022-04-08,Santa Cruz,087,273765,47630,47624,2087,49711,259
2022-04-08,Shasta,089,179085,30589,30586,6181,36767,549
2022-04-08,Sierra,091,2930,272,272,42,314,4
2022-04-08,Siskiyou,093,43540,4444,4444,2756,7200,80
2022-04-08,Solano,095,438530,81892,81886,5546,87432,448
2022-04-08,Sonoma,097,501317,83598,83600,2519,86119,485
2022-04-08,Stanislaus,099,539301,117518,117528,17126,134654,1578
2022-04-08,Sutter,101,95872,20589,20591,2094,22685,223
2022-04-08,Tehama,103,63373,12054,12059,2606,14665,201
2022-04-08,Trinity,105,12862,1177,1177,292,1469,20
2022-04-08,Tulare,107,460477,105306,105278,28433,133711,1415
2022-04-08,Tuolumne,109,53932,12629,12632,567,13199,180
2022-04-08,Ventura,111,848112,173346,173343,9281,182624,1467
2022-04-08,Yolo,113,214977,36586,36587,3192,39779,312
2022-04-08,Yuba,115,75493,15848,15848,1211,17059,121
2022-04-07,Alameda,001,1643700,256680,256649,13879,270528,1826
2022-04-07,Alpine,003,1148,124,124,1,125,0
2022-04-07,Amador,005,37829,8526,8489,646,9135,86
2022-04-07,Butte,007,227075,33037,33031,6659,39690,399
2022-04-07,Calaveras,009,45235,7261,7260,356,7616,119
2022-04-07,Colusa,011,21464,3449,3449,1080,4529,21
2022-04-07,Contra Costa,013,1133247,189206,189154,13263,202417,1296
2022-04-07,Del Norte,015,27424,5813,5811,197,6008,50
2022-04-07,El Dorado,017,186661,26758,26757,3212,29969,207
2022-04-07,Fresno,019,978130,231097,231090,22730,253820,2731
2022-04-07,Glenn,021,27897,4986,4988,1576,6564,47
2022-04-07,Humboldt,023,135768,16914,16913,2977,19890,141
2022-04-07,Imperial,025,180216,55269,55267,11125,66392,910
2022-04-07,Inyo,027,18085,4071,4071,484,4555,56
2022-04-07,Kern,029,883053,191600,191542,46297,237839,2244
2022-04-07,Kings,031,150075,51527,51519,3618,55137,443
2022-04-07,Lake,033,64148,10693,10690,898,11588,134
2022-04-07,Lassen,035,31185,8949,8948,896,9844,65
2022-04-07,Los Angeles,037,10098052,2709466,2709735,123415,2833150,31509
2022-04-07,Madera,039,155013,37377,37356,6066,43422,354
2022-04-07,Marin,041,260295,33643,33648,2250,35898,288
2022-04-07,Mariposa,043,17540,2395,2394,202,2596,29
2022-04-07,Mendocino,045,87422,13084,13087,2990,16077,120
2022-04-07,Merced,047,269075,62253,62231,8519,70750,811
2022-04-07,Modoc,049,8938,743,743,252,995,8
2022-04-07,Mono,051,14174,2967,2967,122,3089,6
2022-04-07,Monterey,053,433212,79198,79103,13765,92868,727
2022-04-07,Napa,055,140530,25827,25824,968,26792,144
2022-04-07,Nevada,057,99092,15970,15976,1213,17189,123
2022-04-07,Orange,059,3164182,546996,546983,41355,588338,6912
2022-04-07,Placer,061,380077,62835,62831,7357,70188,616
2022-04-07,Plumas,063,18699,2886,2887,360,3247,13
2022-04-07,Riverside,065,2383286,591296,591268,28140,619408,6429
2022-04-07,Sacramento,067,1510023,277142,277125,26883,304008,2972
2022-04-07,San Benito,069,59416,12916,12917,520,13437,98
2022-04-07,San Bernardino,071,2135413,562541,562571,24655,587226,6892
2022-04-07,San Diego,073,3302833,754282,754281,51518,805799,5210
2022-04-07,San Francisco,075,870044,125940,125963,8406,134369,844
2022-04-07,San Joaquin,077,732212,166574,166547,9187,175734,2212
2022-04-07,San Luis Obispo,079,281455,52606,52609,3779,56388,476
2022-04-07,San Mateo,081,765935,121509,121514,7059,128573,698
2022-04-07,Santa Barbara,083,443738,85768,85754,4841,90595,680
2022-04-07,Santa Clara,085,1922200,313980,313965,12457,326422,2266
2022-04-07,Santa Cruz,087,273765,47630,47624,2087,49711,259
2022-04-07,Shasta,089,179085,30589,30586,6181,36767,549
2022-04-07,Sierra,091,2930,272,272,42,314,4
2022-04-07,Siskiyou,093,43540,4444,4444,2756,7200,80
2022-04-07,Solano,095,438530,81892,81886,5546,87432,448
2022-04-07,Sonoma,097,501317,83598,83600,2519,86119,485
2022-04-07,Stanislaus,099,539301,117518,117528,17126,134654,1578
2022-04-07,Sutter,101,95872,20589,20591,2094,22685,223
2022-04-07,Tehama,103,63373,12054,12059,2606,14665,201
2022-04-07,Trinity,105,12862,1177,1177,292,1469,20
2022-04-07,Tulare,107,460477,105306,105278,28433,133711,1415
2022-04-07,Tuolumne,109,53932,12629,12632,567,13199,180
2022-04-07,Ventura,111,848112,173346,173343,9281,182624,1467
2022-04-07,Yolo,113,214977,36586,36587,3192,39779,312
2022-04-07,Yuba,115,75493,15848,15848,1211,17059,121
2022-04-06,Alameda,001,1643700,256680,256143,13879,270022,1814
2022-04-06,Alpine,003,1148,124,124,1,125,0
2022-04-06,Amador,005,37829,8526,8488,646,9134,86
2022-04-06,Butte,007,227075,33037,32997,6659,39656,396
2022-04-06,Calaveras,009,45235,7261,7258,356,7614,120
2022-04-06,Colusa,011,21464,3449,3447,1080,4527,21
2022-04-06,Contra Costa,013,1133247,189206,188850,13263,202113,1296
2022-04-06,Del Norte,015,27424,5813,5809,197,6006,50
2022-04-06,El Dorado,017,186661,26758,26744,3212,29956,205
2022-04-06,Fresno,019,978130,231097,230942,22730,253672,2725
2022-04-06,Glenn,021,27897,4986,4986,1576,6562,47
2022-04-06,Humboldt,023,135768,16914,16904,2977,19881,140
2022-04-06,Imperial,025,180216,55269,55294,11125,66419,908
2022-04-06,Inyo,027,18085,4071,4068,484,4552,56
2022-04-06,Kern,029,883053,191600,191449,46297,237746,2234
2022-04-06,Kings,031,150075,51527,51491,3618,55109,443
2022-04-06,Lake,033,64148,10693,10679,898,11577,136
2022-04-06,Lassen,035,31185,8949,8945,896,9841,65
2022-04-06,Los Angeles,037,10098052,2709466,2707306,123415,2830721,31465
2022-04-06,Madera,039,155013,37377,37349,6066,43415,354
2022-04-06,Marin,041,260295,33643,33566,2250,35816,288
2022-04-06,Mariposa,043,17540,2395,2392,202,2594,29
2022-04-06,Mendocino,045,87422,13084,13074,2990,16064,119
2022-04-06,Merced,047,269075,62253,62195,8519,70714,810
2022-04-06,Modoc,049,8938,743,741,252,993,8
2022-04-06,Mono,051,14174,2967,2967,122,3089,6
2022-04-06,Monterey,053,433212,79198,79019,13765,92784,727
2022-04-06,Napa,055,140530,25827,25790,968,26758,143
2022-04-06,Nevada,057,99092,15970,15974,1213,17187,123
2022-04-06,Orange,059,3164182,546996,546491,41355,587846,6887
2022-04-06,Placer,061,380077,62835,62787,7357,70144,615
2022-04-06,Plumas,063,18699,2886,2850,360,3210,13
2022-04-06,Riverside,065,2383286,591296,590826,28140,618966,6424
2022-04-06,Sacramento,067,1510023,277142,276567,26883,303450,2953
2022-04-06,San Benito,069,59416,12916,12908,520,13428,98
2022-04-06,San Bernardino,071,2135413,562541,561648,24655,586303,6883
2022-04-06,San Diego,073,3302833,754282,753402,51518,804920,5192
2022-04-06,San Francisco,075,870044,125940,125536,8406,133942,843
2022-04-06,San Joaquin,077,732212,166574,166415,9187,175602,2207
2022-04-06,San Luis Obispo,079,281455,52606,52557,3779,56336,475
2022-04-06,San Mateo,081,765935,121509,121041,7059,128100,693
2022-04-06,Santa Barbara,083,443738,85768,85630,4841,90471,679
2022-04-06,Santa Clara,085,1922200,313980,313278,12457,325735,2265
2022-04-06,Santa Cruz,087,273765,47630,47446,2087,49533,259
2022-04-06,Shasta,089,179085,30589,30565,6181,36746,529
2022-04-06,Sierra,091,2930,272,272,42,314,4
2022-04-06,Siskiyou,093,43540,4444,4442,2756,7198,80
2022-04-06,Solano,095,438530,81892,81789,5546,87335,447
2022-04-06,Sonoma,097,501317,83598,83361,2519,85880,485
2022-04-06,Stanislaus,099,539301,117518,117534,17126,134660,1578
2022-04-06,Sutter,101,95872,20589,20581,2094,22675,222
2022-04-06,Tehama,103,63373,12054,12049,2606,14655,198
2022-04-06,Trinity,105,12862,1177,1173,292,1465,20
2022-04-06,Tulare,107,460477,105306,104826,28433,133259,1414
2022-04-06,Tuolumne,109,53932,12629,12621,567,13188,180
2022-04-06,Ventura,111,848112,173346,173179,9281,182460,1460
2022-04-06,Yolo,113,214977,36586,36393,3192,39585,314
2022-04-06,Yuba,115,75493,15848,15839,1211,17050,121
2022-04-05,Alameda,001,1643700,256652,256143,13879,270022,1814
2022-04-05,Alpine,003,1148,124,124,1,125,0
2022-04-05,Amador,005,37829,8526,8488,646,9134,86
2022-04-05,Butte,007,227075,33037,32997,6659,39656,396
2022-04-05,Calaveras,009,45235,7261,7258,356,7614,120
2022-04-05,Colusa,011,21464,3448,3447,1080,4527,21
2022-04-05,Contra Costa,013,1133247,189191,188850,13263,202113,1296
2022-04-05,Del Norte,015,27424,5813,5809,197,6006,50
2022-04-05,El Dorado,017,186661,26755,26744,3212,29956,205
2022-04-05,Fresno,019,978130,231094,230942,22730,253672,2725
2022-04-05,Glenn,021,27897,4986,4986,1576,6562,47
2022-04-05,Humboldt,023,135768,16913,16904,2977,19881,140
2022-04-05,Imperial,025,180216,55269,55294,11125,66419,908
2022-04-05,Inyo,027,18085,4071,4068,484,4552,56
2022-04-05,Kern,029,883053,191596,191449,46297,237746,2234
2022-04-05,Kings,031,150075,51526,51491,3618,55109,443
2022-04-05,Lake,033,64148,10692,10679,898,11577,136
2022-04-05,Lassen,035,31185,8949,8945,896,9841,65
2022-04-05,Los Angeles,037,10098052,2709457,2707306,123415,2830721,31465
2022-04-05,Madera,039,155013,37376,37349,6066,43415,354
2022-04-05,Marin,041,260295,33633,33566,2250,35816,288
2022-04-05,Mariposa,043,17540,2395,2392,202,2594,29
2022-04-05,Mendocino,045,87422,13083,13074,2990,16064,119
2022-04-05,Merced,047,269075,62251,62195,8519,70714,810
2022-04-05,Modoc,049,8938,743,741,252,993,8
2022-04-05,Mono,051,14174,2967,2967,122,3089,6
2022-04-05,Monterey,053,433212,79197,79019,13765,92784,727
2022-04-05,Napa,055,140530,25827,25790,968,26758,143
2022-04-05,Nevada,057,99092,15969,15974,1213,17187,123
2022-04-05,Orange,059,3164182,546983,546491,41355,587846,6887
2022-04-05,Placer,061,380077,62834,62787,7357,70144,615
2022-04-05,Plumas,063,18699,2886,2850,360,3210,13
2022-04-05,Riverside,065,2383286,591269,590826,28140,618966,6424
2022-04-05,Sacramento,067,1510023,277131,276567,26883,303450,2953
2022-04-05,San Benito,069,59416,12916,12908,520,13428,98
2022-04-05,San Bernardino,071,2135413,562496,561648,24655,586303,6883
2022-04-05,San Diego,073,3302833,754238,753402,51518,804920,5192
2022-04-05,San Francisco,075,870044,125921,125536,8406,133942,843
2022-04-05,San Joaquin,077,732212,166559,166415,9187,175602,2207
2022-04-05,San Luis Obispo,079,281455,52606,52557,3779,56336,475
2022-04-05,San Mateo,081,765935,121500,121041,7059,128100,693
2022-04-05,Santa Barbara,083,443738,85767,85630,4841,90471,679
2022-04-05,Santa Clara,085,1922200,313963,313278,12457,325735,2265
2022-04-05,Santa Cruz,087,273765,47588,47446,2087,49533,259
2022-04-05,Shasta,089,179085,30589,30565,6181,36746,529
2022-04-05,Sierra,091,2930,272,272,42,314,4
2022-04-05,Siskiyou,093,43540,4444,4442,2756,7198,80
2022-04-05,Solano,095,438530,81890,81789,5546,87335,447
2022-04-05,Sonoma,097,501317,83593,83361,2519,85880,485
2022-04-05,Stanislaus,099,539301,117513,117534,17126,134660,1578
2022-04-05,Sutter,101,95872,20587,20581,2094,22675,222
2022-04-05,Tehama,103,63373,12053,12049,2606,14655,198
2022-04-05,Trinity,105,12862,1177,1173,292,1465,20
2022-04-05,Tulare,107,460477,105302,104826,28433,133259,1414
2022-04-05,Tuolumne,109,53932,12627,12621,567,13188,180
2022-04-05,Ventura,111,848112,173337,173179,9281,182460,1460
2022-04-05,Yolo,113,214977,36584,36393,3192,39585,314
2022-04-05,Yuba,115,75493,15846,15839,1211,17050,121
2022-04-04,Alameda,001,1643700,256537,256143,13879,270022,1814
2022-04-04,Alpine,003,1148,124,124,1,125,0
2022-04-04,Amador,005,37829,8525,8488,646,9134,86
2022-04-04,Butte,007,227075,33033,32997,6659,39656,396
2022-04-04,Calaveras,009,45235,7259,7258,356,7614,120
2022-04-04,Colusa,011,21464,3447,3447,1080,4527,21
2022-04-04,Contra Costa,013,1133247,189133,188850,13263,202113,1296
2022-04-04,Del Norte,015,27424,5812,5809,197,6006,50
2022-04-04,El Dorado,017,186661,26754,26744,3212,29956,205
2022-04-04,Fresno,019,978130,231079,230942,22730,253672,2725
2022-04-04,Glenn,021,27897,4985,4986,1576,6562,47
2022-04-04,Humboldt,023,135768,16909,16904,2977,19881,140
2022-04-04,Imperial,025,180216,55267,55294,11125,66419,908
2022-04-04,Inyo,027,18085,4071,4068,484,4552,56
2022-04-04,Kern,029,883053,191586,191449,46297,237746,2234
2022-04-04,Kings,031,150075,51521,51491,3618,55109,443
2022-04-04,Lake,033,64148,10691,10679,898,11577,136
2022-04-04,Lassen,035,31185,8949,8945,896,9841,65
2022-04-04,Los Angeles,037,10098052,2709033,2707306,123415,2830721,31465
2022-04-04,Madera,039,155013,37375,37349,6066,43415,354
2022-04-04,Marin,041,260295,33611,33566,2250,35816,288
2022-04-04,Mariposa,043,17540,2395,2392,202,2594,29
2022-04-04,Mendocino,045,87422,13080,13074,2990,16064,119
2022-04-04,Merced,047,269075,62246,62195,8519,70714,810
2022-04-04,Modoc,049,8938,743,741,252,993,8
2022-04-04,Mono,051,14174,2967,2967,122,3089,6
2022-04-04,Monterey,053,433212,79186,79019,13765,92784,727
2022-04-04,Napa,055,140530,25817,25790,968,26758,143
2022-04-04,Nevada,057,99092,15966,15974,1213,17187,123
2022-04-04,Orange,059,3164182,546910,546491,41355,587846,6887
2022-04-04,Placer,061,380077,62826,62787,7357,70144,615
2022-04-04,Plumas,063,18699,2886,2850,360,3210,13
2022-04-04,Riverside,065,2383286,591213,590826,28140,618966,6424
2022-04-04,Sacramento,067,1510023,277084,276567,26883,303450,2953
2022-04-04,San Benito,069,59416,12914,12908,520,13428,98
2022-04-04,San Bernardino,071,2135413,562395,561648,24655,586303,6883
2022-04-04,San Diego,073,3302833,754042,753402,51518,804920,5192
2022-04-04,San Francisco,075,870044,125791,125536,8406,133942,843
2022-04-04,San Joaquin,077,732212,166538,166415,9187,175602,2207
2022-04-04,San Luis Obispo,079,281455,52588,52557,3779,56336,475
2022-04-04,San Mateo,081,765935,121434,121041,7059,128100,693
2022-04-04,Santa Barbara,083,443738,85731,85630,4841,90471,679
2022-04-04,Santa Clara,085,1922200,313765,313278,12457,325735,2265
2022-04-04,Santa Cruz,087,273765,47550,47446,2087,49533,259
2022-04-04,Shasta,089,179085,30588,30565,6181,36746,529
2022-04-04,Sierra,091,2930,272,272,42,314,4
2022-04-04,Siskiyou,093,43540,4444,4442,2756,7198,80
2022-04-04,Solano,095,438530,81869,81789,5546,87335,447
2022-04-04,Sonoma,097,501317,83563,83361,2519,85880,485
2022-04-04,Stanislaus,099,539301,117503,117534,17126,134660,1578
2022-04-04,Sutter,101,95872,20585,20581,2094,22675,222
2022-04-04,Tehama,103,63373,12052,12049,2606,14655,198
2022-04-04,Trinity,105,12862,1177,1173,292,1465,20
2022-04-04,Tulare,107,460477,105295,104826,28433,133259,1414
2022-04-04,Tuolumne,109,53932,12623,12621,567,13188,180
2022-04-04,Ventura,111,848112,173312,173179,9281,182460,1460
2022-04-04,Yolo,113,214977,36579,36393,3192,39585,314
2022-04-04,Yuba,115,75493,15842,15839,1211,17050,121
2022-04-03,Alameda,001,1643700,256339,255650,13879,269529,1813
2022-04-03,Alpine,003,1148,124,124,1,125,0
2022-04-03,Amador,005,37829,8525,8485,646,9131,86
2022-04-03,Butte,007,227075,33025,32981,6659,39640,396
2022-04-03,Calaveras,009,45235,7259,7254,356,7610,119
2022-04-03,Colusa,011,21464,3447,3445,1080,4525,21
2022-04-03,Contra Costa,013,1133247,189028,188658,13263,201921,1291
2022-04-03,Del Norte,015,27424,5812,5812,197,6009,50
2022-04-03,El Dorado,017,186661,26741,26732,3212,29944,200
2022-04-03,Fresno,019,978130,231048,230559,22730,253289,2722
2022-04-03,Glenn,021,27897,4985,4982,1576,6558,47
2022-04-03,Humboldt,023,135768,16903,16898,2977,19875,140
2022-04-03,Imperial,025,180216,55265,55266,11125,66391,908
2022-04-03,Inyo,027,18085,4069,4063,484,4547,56
2022-04-03,Kern,029,883053,191566,191384,46297,237681,2224
2022-04-03,Kings,031,150075,51516,51470,3618,55088,443
2022-04-03,Lake,033,64148,10690,10674,898,11572,136
2022-04-03,Lassen,035,31185,8948,8943,896,9839,65
2022-04-03,Los Angeles,037,10098052,2708138,2703576,123415,2826991,31410
2022-04-03,Madera,039,155013,37373,37333,6066,43399,354
2022-04-03,Marin,041,260295,33587,33493,2250,35743,287
2022-04-03,Mariposa,043,17540,2394,2391,202,2593,29
2022-04-03,Mendocino,045,87422,13074,13058,2990,16048,119
2022-04-03,Merced,047,269075,62229,62149,8519,70668,808
2022-04-03,Modoc,049,8938,742,741,252,993,8
2022-04-03,Mono,051,14174,2967,2967,122,3089,6
2022-04-03,Monterey,053,433212,79170,78964,13765,92729,726
2022-04-03,Napa,055,140530,25805,25757,968,26725,143
2022-04-03,Nevada,057,99092,15960,15962,1213,17175,123
2022-04-03,Orange,059,3164182,546742,546047,41355,587402,6880
2022-04-03,Placer,061,380077,62802,62740,7357,70097,614
2022-04-03,Plumas,063,18699,2885,2803,360,3163,14
2022-04-03,Riverside,065,2383286,591098,590563,28140,618703,6418
2022-04-03,Sacramento,067,1510023,277009,276218,26883,303101,2950
2022-04-03,San Benito,069,59416,12910,12901,520,13421,98
2022-04-03,San Bernardino,071,2135413,562275,561362,24655,586017,6865
2022-04-03,San Diego,073,3302833,753754,752281,51518,803799,5178
2022-04-03,San Francisco,075,870044,125609,125075,8406,133481,843
2022-04-03,San Joaquin,077,732212,166499,166336,9187,175523,2202
2022-04-03,San Luis Obispo,079,281455,52569,52512,3779,56291,475
2022-04-03,San Mateo,081,765935,121327,120717,7059,127776,693
2022-04-03,Santa Barbara,083,443738,85694,85611,4841,90452,678
2022-04-03,Santa Clara,085,1922200,313524,312517,12457,324974,2258
2022-04-03,Santa Cruz,087,273765,47501,47371,2087,49458,259
2022-04-03,Shasta,089,179085,30581,30556,6181,36737,530
2022-04-03,Sierra,091,2930,272,273,42,315,4
2022-04-03,Siskiyou,093,43540,4444,4439,2756,7195,80
2022-04-03,Solano,095,438530,81833,81848,5546,87394,446
2022-04-03,Sonoma,097,501317,83478,83235,2519,85754,485
2022-04-03,Stanislaus,099,539301,117481,117536,17126,134662,1581
2022-04-03,Sutter,101,95872,20582,20570,2094,22664,222
2022-04-03,Tehama,103,63373,12048,12046,2606,14652,198
2022-04-03,Trinity,105,12862,1177,1173,292,1465,20
2022-04-03,Tulare,107,460477,105289,104736,28433,133169,1410
2022-04-03,Tuolumne,109,53932,12620,12618,567,13185,180
2022-04-03,Ventura,111,848112,173271,173044,9281,182325,1460
2022-04-03,Yolo,113,214977,36566,36347,3192,39539,313
2022-04-03,Yuba,115,75493,15841,15835,1211,17046,120
2022-04-02,Alameda,001,1643700,256283,255650,13879,269529,1813
2022-04-02,Alpine,003,1148,124,124,1,125,0
2022-04-02,Amador,005,37829,8525,8485,646,9131,86
2022-04-02,Butte,007,227075,33021,32981,6659,39640,396
2022-04-02,Calaveras,009,45235,7259,7254,356,7610,119
2022-04-02,Colusa,011,21464,3447,3445,1080,4525,21
2022-04-02,Contra Costa,013,1133247,188990,188658,13263,201921,1291
2022-04-02,Del Norte,015,27424,5811,5812,197,6009,50
2022-04-02,El Dorado,017,186661,26739,26732,3212,29944,200
2022-04-02,Fresno,019,978130,231023,230559,22730,253289,2722
2022-04-02,Glenn,021,27897,4985,4982,1576,6558,47
2022-04-02,Humboldt,023,135768,16901,16898,2977,19875,140
2022-04-02,Imperial,025,180216,55261,55266,11125,66391,908
2022-04-02,Inyo,027,18085,4069,4063,484,4547,56
2022-04-02,Kern,029,883053,191555,191384,46297,237681,2224
2022-04-02,Kings,031,150075,51513,51470,3618,55088,443
2022-04-02,Lake,033,64148,10689,10674,898,11572,136
2022-04-02,Lassen,035,31185,8948,8943,896,9839,65
2022-04-02,Los Angeles,037,10098052,2707770,2703576,123415,2826991,31410
2022-04-02,Madera,039,155013,37370,37333,6066,43399,354
2022-04-02,Marin,041,260295,33574,33493,2250,35743,287
2022-04-02,Mariposa,043,17540,2394,2391,202,2593,29
2022-04-02,Mendocino,045,87422,13072,13058,2990,16048,119
2022-04-02,Merced,047,269075,62227,62149,8519,70668,808
2022-04-02,Modoc,049,8938,742,741,252,993,8
2022-04-02,Mono,051,14174,2967,2967,122,3089,6
2022-04-02,Monterey,053,433212,79164,78964,13765,92729,726
2022-04-02,Napa,055,140530,25803,25757,968,26725,143
2022-04-02,Nevada,057,99092,15959,15962,1213,17175,123
2022-04-02,Orange,059,3164182,546645,546047,41355,587402,6880
2022-04-02,Placer,061,380077,62797,62740,7357,70097,614
2022-04-02,Plumas,063,18699,2885,2803,360,3163,14
2022-04-02,Riverside,065,2383286,591064,590563,28140,618703,6418
2022-04-02,Sacramento,067,1510023,276982,276218,26883,303101,2950
2022-04-02,San Benito,069,59416,12909,12901,520,13421,98
2022-04-02,San Bernardino,071,2135413,562246,561362,24655,586017,6865
2022-04-02,San Diego,073,3302833,753647,752281,51518,803799,5178
2022-04-02,San Francisco,075,870044,125546,125075,8406,133481,843
2022-04-02,San Joaquin,077,732212,166486,166336,9187,175523,2202
2022-04-02,San Luis Obispo,079,281455,52565,52512,3779,56291,475
2022-04-02,San Mateo,081,765935,121270,120717,7059,127776,693
2022-04-02,Santa Barbara,083,443738,85683,85611,4841,90452,678
2022-04-02,Santa Clara,085,1922200,313403,312517,12457,324974,2258
2022-04-02,Santa Cruz,087,273765,47493,47371,2087,49458,259
2022-04-02,Shasta,089,179085,30580,30556,6181,36737,530
2022-04-02,Sierra,091,2930,272,273,42,315,4
2022-04-02,Siskiyou,093,43540,4443,4439,2756,7195,80
2022-04-02,Solano,095,438530,81818,81848,5546,87394,446
2022-04-02,Sonoma,097,501317,83458,83235,2519,85754,485
2022-04-02,Stanislaus,099,539301,117472,117536,17126,134662,1581
2022-04-02,Sutter,101,95872,20577,20570,2094,22664,222
2022-04-02,Tehama,103,63373,12048,12046,2606,14652,198
2022-04-02,Trinity,105,12862,1177,1173,292,1465,20
2022-04-02,Tulare,107,460477,105286,104736,28433,133169,1410
2022-04-02,Tuolumne,109,53932,12620,12618,567,13185,180
2022-04-02,Ventura,111,848112,173247,173044,9281,182325,1460
2022-04-02,Yolo,113,214977,36558,36347,3192,39539,313
2022-04-02,Yuba,115,75493,15841,15835,1211,17046,120
2022-04-01,Alameda,001,1643700,256215,255650,13879,269529,1813
2022-04-01,Alpine,003,1148,124,124,1,125,0
2022-04-01,Amador,005,37829,8525,8485,646,9131,86
2022-04-01,Butte,007,227075,33018,32981,6659,39640,396
2022-04-01,Calaveras,009,45235,7257,7254,356,7610,119
2022-04-01,Colusa,011,21464,3446,3445,1080,4525,21
2022-04-01,Contra Costa,013,1133247,188947,188658,13263,201921,1291
2022-04-01,Del Norte,015,27424,5810,5812,197,6009,50
2022-04-01,El Dorado,017,186661,26737,26732,3212,29944,200
2022-04-01,Fresno,019,978130,231001,230559,22730,253289,2722
2022-04-01,Glenn,021,27897,4985,4982,1576,6558,47
2022-04-01,Humboldt,023,135768,16900,16898,2977,19875,140
2022-04-01,Imperial,025,180216,55260,55266,11125,66391,908
2022-04-01,Inyo,027,18085,4068,4063,484,4547,56
2022-04-01,Kern,029,883053,191546,191384,46297,237681,2224
2022-04-01,Kings,031,150075,51510,51470,3618,55088,443
2022-04-01,Lake,033,64148,10687,10674,898,11572,136
2022-04-01,Lassen,035,31185,8947,8943,896,9839,65
2022-04-01,Los Angeles,037,10098052,2707365,2703576,123415,2826991,31410
2022-04-01,Madera,039,155013,37369,37333,6066,43399,354
2022-04-01,Marin,041,260295,33563,33493,2250,35743,287
2022-04-01,Mariposa,043,17540,2393,2391,202,2593,29
2022-04-01,Mendocino,045,87422,13069,13058,2990,16048,119
2022-04-01,Merced,047,269075,62223,62149,8519,70668,808
2022-04-01,Modoc,049,8938,742,741,252,993,8
2022-04-01,Mono,051,14174,2967,2967,122,3089,6
2022-04-01,Monterey,053,433212,79155,78964,13765,92729,726
2022-04-01,Napa,055,140530,25800,25757,968,26725,143
2022-04-01,Nevada,057,99092,15959,15962,1213,17175,123
2022-04-01,Orange,059,3164182,546553,546047,41355,587402,6880
2022-04-01,Placer,061,380077,62789,62740,7357,70097,614
2022-04-01,Plumas,063,18699,2885,2803,360,3163,14
2022-04-01,Riverside,065,2383286,591016,590563,28140,618703,6418
2022-04-01,Sacramento,067,1510023,276949,276218,26883,303101,2950
2022-04-01,San Benito,069,59416,12908,12901,520,13421,98
2022-04-01,San Bernardino,071,2135413,562219,561362,24655,586017,6865
2022-04-01,San Diego,073,3302833,753512,752281,51518,803799,5178
2022-04-01,San Francisco,075,870044,125469,125075,8406,133481,843
2022-04-01,San Joaquin,077,732212,166473,166336,9187,175523,2202
2022-04-01,San Luis Obispo,079,281455,52560,52512,3779,56291,475
2022-04-01,San Mateo,081,765935,121226,120717,7059,127776,693
2022-04-01,Santa Barbara,083,443738,85671,85611,4841,90452,678
2022-04-01,Santa Clara,085,1922200,313288,312517,12457,324974,2258
2022-04-01,Santa Cruz,087,273765,47482,47371,2087,49458,259
2022-04-01,Shasta,089,179085,30580,30556,6181,36737,530
2022-04-01,Sierra,091,2930,272,273,42,315,4
2022-04-01,Siskiyou,093,43540,4443,4439,2756,7195,80
2022-04-01,Solano,095,438530,81806,81848,5546,87394,446
2022-04-01,Sonoma,097,501317,83428,83235,2519,85754,485
2022-04-01,Stanislaus,099,539301,117465,117536,17126,134662,1581
2022-04-01,Sutter,101,95872,20577,20570,2094,22664,222
2022-04-01,Tehama,103,63373,12047,12046,2606,14652,198
2022-04-01,Trinity,105,12862,1177,1173,292,1465,20
2022-04-01,Tulare,107,460477,105280,104736,28433,133169,1410
2022-04-01,Tuolumne,109,53932,12620,12618,567,13185,180
2022-04-01,Ventura,111,848112,173227,173044,9281,182325,1460
2022-04-01,Yolo,113,214977,36550,36347,3192,39539,313
2022-04-01,Yuba,115,75493,15841,15835,1211,17046,120
2022-03-31,Alameda,001,1643700,256083,255650,13879,269529,1813
2022-03-31,Alpine,003,1148,124,124,1,125,0
2022-03-31,Amador,005,37829,8525,8485,646,9131,86
2022-03-31,Butte,007,227075,33015,32981,6659,39640,396
2022-03-31,Calaveras,009,45235,7257,7254,356,7610,119
2022-03-31,Colusa,011,21464,3445,3445,1080,4525,21
2022-03-31,Contra Costa,013,1133247,188876,188658,13263,201921,1291
2022-03-31,Del Norte,015,27424,5810,5812,197,6009,50
2022-03-31,El Dorado,017,186661,26730,26732,3212,29944,200
2022-03-31,Fresno,019,978130,230969,230559,22730,253289,2722
2022-03-31,Glenn,021,27897,4983,4982,1576,6558,47
2022-03-31,Humboldt,023,135768,16898,16898,2977,19875,140
2022-03-31,Imperial,025,180216,55257,55266,11125,66391,908
2022-03-31,Inyo,027,18085,4067,4063,484,4547,56
2022-03-31,Kern,029,883053,191534,191384,46297,237681,2224
2022-03-31,Kings,031,150075,51501,51470,3618,55088,443
2022-03-31,Lake,033,64148,10687,10674,898,11572,136
2022-03-31,Lassen,035,31185,8945,8943,896,9839,65
2022-03-31,Los Angeles,037,10098052,2706634,2703576,123415,2826991,31410
2022-03-31,Madera,039,155013,37365,37333,6066,43399,354
2022-03-31,Marin,041,260295,33541,33493,2250,35743,287
2022-03-31,Mariposa,043,17540,2392,2391,202,2593,29
2022-03-31,Mendocino,045,87422,13066,13058,2990,16048,119
2022-03-31,Merced,047,269075,62218,62149,8519,70668,808
2022-03-31,Modoc,049,8938,742,741,252,993,8
2022-03-31,Mono,051,14174,2967,2967,122,3089,6
2022-03-31,Monterey,053,433212,79142,78964,13765,92729,726
2022-03-31,Napa,055,140530,25791,25757,968,26725,143
2022-03-31,Nevada,057,99092,15954,15962,1213,17175,123
2022-03-31,Orange,059,3164182,546412,546047,41355,587402,6880
2022-03-31,Placer,061,380077,62772,62740,7357,70097,614
2022-03-31,Plumas,063,18699,2885,2803,360,3163,14
2022-03-31,Riverside,065,2383286,590930,590563,28140,618703,6418
2022-03-31,Sacramento,067,1510023,276883,276218,26883,303101,2950
2022-03-31,San Benito,069,59416,12907,12901,520,13421,98
2022-03-31,San Bernardino,071,2135413,562130,561362,24655,586017,6865
2022-03-31,San Diego,073,3302833,753279,752281,51518,803799,5178
2022-03-31,San Francisco,075,870044,125343,125075,8406,133481,843
2022-03-31,San Joaquin,077,732212,166448,166336,9187,175523,2202
2022-03-31,San Luis Obispo,079,281455,52546,52512,3779,56291,475
2022-03-31,San Mateo,081,765935,121145,120717,7059,127776,693
2022-03-31,Santa Barbara,083,443738,85648,85611,4841,90452,678
2022-03-31,Santa Clara,085,1922200,313098,312517,12457,324974,2258
2022-03-31,Santa Cruz,087,273765,47468,47371,2087,49458,259
2022-03-31,Shasta,089,179085,30575,30556,6181,36737,530
2022-03-31,Sierra,091,2930,272,273,42,315,4
2022-03-31,Siskiyou,093,43540,4441,4439,2756,7195,80
2022-03-31,Solano,095,438530,81782,81848,5546,87394,446
2022-03-31,Sonoma,097,501317,83398,83235,2519,85754,485
2022-03-31,Stanislaus,099,539301,117450,117536,17126,134662,1581
2022-03-31,Sutter,101,95872,20575,20570,2094,22664,222
2022-03-31,Tehama,103,63373,12046,12046,2606,14652,198
2022-03-31,Trinity,105,12862,1177,1173,292,1465,20
2022-03-31,Tulare,107,460477,105273,104736,28433,133169,1410
2022-03-31,Tuolumne,109,53932,12620,12618,567,13185,180
2022-03-31,Ventura,111,848112,173196,173044,9281,182325,1460
2022-03-31,Yolo,113,214977,36539,36347,3192,39539,313
2022-03-31,Yuba,115,75493,15841,15835,1211,17046,120
2022-03-30,Alameda,001,1643700,255968,255467,13879,269346,1812
2022-03-30,Alpine,003,1148,124,124,1,125,0
2022-03-30,Amador,005,37829,8525,8485,646,9131,86
2022-03-30,Butte,007,227075,33009,32968,6659,39627,396
2022-03-30,Calaveras,009,45235,7256,7253,356,7609,119
2022-03-30,Colusa,011,21464,3445,3445,1080,4525,21
2022-03-30,Contra Costa,013,1133247,188816,188496,13263,201759,1291
2022-03-30,Del Norte,015,27424,5808,5808,197,6005,50
2022-03-30,El Dorado,017,186661,26722,26722,3212,29934,200
2022-03-30,Fresno,019,978130,230957,230448,22730,253178,2720
2022-03-30,Glenn,021,27897,4983,4982,1576,6558,47
2022-03-30,Humboldt,023,135768,16895,16894,2977,19871,140
2022-03-30,Imperial,025,180216,55253,55252,11125,66377,908
2022-03-30,Inyo,027,18085,4066,4062,484,4546,56
2022-03-30,Kern,029,883053,191507,191363,46297,237660,2219
2022-03-30,Kings,031,150075,51494,51446,3618,55064,443
2022-03-30,Lake,033,64148,10685,10674,898,11572,136
2022-03-30,Lassen,035,31185,8945,8943,896,9839,65
2022-03-30,Los Angeles,037,10098052,2705813,2702536,123415,2825951,31384
2022-03-30,Madera,039,155013,37360,37330,6066,43396,354
2022-03-30,Marin,041,260295,33526,33453,2250,35703,287
2022-03-30,Mariposa,043,17540,2392,2390,202,2592,27
2022-03-30,Mendocino,045,87422,13063,13055,2990,16045,118
2022-03-30,Merced,047,269075,62211,62136,8519,70655,808
2022-03-30,Modoc,049,8938,742,739,252,991,8
2022-03-30,Mono,051,14174,2967,2967,122,3089,6
2022-03-30,Monterey,053,433212,79129,78911,13765,92676,726
2022-03-30,Napa,055,140530,25778,25745,968,26713,141
2022-03-30,Nevada,057,99092,15951,15960,1213,17173,123
2022-03-30,Orange,059,3164182,546259,545895,41355,587250,6876
2022-03-30,Placer,061,380077,62757,62705,7357,70062,614
2022-03-30,Plumas,063,18699,2884,2762,360,3122,13
2022-03-30,Riverside,065,2383286,590857,590437,28140,618577,6411
2022-03-30,Sacramento,067,1510023,276820,276081,26883,302964,2949
2022-03-30,San Benito,069,59416,12902,12898,520,13418,98
2022-03-30,San Bernardino,071,2135413,562054,561153,24655,585808,6863
2022-03-30,San Diego,073,3302833,753047,751684,51518,803202,5169
2022-03-30,San Francisco,075,870044,125245,124930,8406,133336,841
2022-03-30,San Joaquin,077,732212,166421,166299,9187,175486,2201
2022-03-30,San Luis Obispo,079,281455,52532,52484,3779,56263,475
2022-03-30,San Mateo,081,765935,121048,120548,7059,127607,693
2022-03-30,Santa Barbara,083,443738,85628,85488,4841,90329,677
2022-03-30,Santa Clara,085,1922200,312929,312253,12457,324710,2258
2022-03-30,Santa Cruz,087,273765,47415,47340,2087,49427,259
2022-03-30,Shasta,089,179085,30573,30555,6181,36736,530
2022-03-30,Sierra,091,2930,272,273,42,315,4
2022-03-30,Siskiyou,093,43540,4441,4439,2756,7195,80
2022-03-30,Solano,095,438530,81769,81816,5546,87362,443
2022-03-30,Sonoma,097,501317,83367,83163,2519,85682,485
2022-03-30,Stanislaus,099,539301,117437,117593,17126,134719,1559
2022-03-30,Sutter,101,95872,20570,20565,2094,22659,222
2022-03-30,Tehama,103,63373,12045,12045,2606,14651,198
2022-03-30,Trinity,105,12862,1176,1173,292,1465,20
2022-03-30,Tulare,107,460477,105266,104667,28433,133100,1410
2022-03-30,Tuolumne,109,53932,12618,12616,567,13183,180
2022-03-30,Ventura,111,848112,173157,172984,9281,182265,1460
2022-03-30,Yolo,113,214977,36531,36325,3192,39517,313
2022-03-30,Yuba,115,75493,15839,15830,1211,17041,120
2022-03-29,Alameda,001,1643700,255865,255261,13879,269140,1810
2022-03-29,Alpine,003,1148,124,124,1,125,0
2022-03-29,Amador,005,37829,8525,8483,646,9129,86
2022-03-29,Butte,007,227075,33006,32954,6659,39613,396
2022-03-29,Calaveras,009,45235,7255,7250,356,7606,119
2022-03-29,Colusa,011,21464,3445,3445,1080,4525,21
2022-03-29,Contra Costa,013,1133247,188735,188359,13263,201622,1290
2022-03-29,Del Norte,015,27424,5807,5806,197,6003,50
2022-03-29,El Dorado,017,186661,26721,26706,3212,29918,200
2022-03-29,Fresno,019,978130,230929,230256,22730,252986,2718
2022-03-29,Glenn,021,27897,4982,4983,1576,6559,47
2022-03-29,Humboldt,023,135768,16891,16892,2977,19869,140
2022-03-29,Imperial,025,180216,55237,55233,11125,66358,908
2022-03-29,Inyo,027,18085,4064,4062,484,4546,56
2022-03-29,Kern,029,883053,191477,191338,46297,237635,2220
2022-03-29,Kings,031,150075,51486,51416,3618,55034,443
2022-03-29,Lake,033,64148,10681,10674,898,11572,136
2022-03-29,Lassen,035,31185,8944,8943,896,9839,65
2022-03-29,Los Angeles,037,10098052,2705039,2702005,123415,2825420,31378
2022-03-29,Madera,039,155013,37351,37325,6066,43391,354
2022-03-29,Marin,041,260295,33510,33431,2250,35681,287
2022-03-29,Mariposa,043,17540,2392,2388,202,2590,23
2022-03-29,Mendocino,045,87422,13061,13053,2990,16043,119
2022-03-29,Merced,047,269075,62199,62123,8519,70642,806
2022-03-29,Modoc,049,8938,740,737,252,989,8
2022-03-29,Mono,051,14174,2967,2966,122,3088,5
2022-03-29,Monterey,053,433212,79120,78774,13765,92539,725
2022-03-29,Napa,055,140530,25772,25732,968,26700,141
2022-03-29,Nevada,057,99092,15945,15956,1213,17169,123
2022-03-29,Orange,059,3164182,546114,545832,41355,587187,6871
2022-03-29,Placer,061,380077,62742,62687,7357,70044,614
2022-03-29,Plumas,063,18699,2883,2761,360,3121,13
2022-03-29,Riverside,065,2383286,590762,590359,28140,618499,6403
2022-03-29,Sacramento,067,1510023,276759,276040,26883,302923,2946
2022-03-29,San Benito,069,59416,12900,12892,520,13412,97
2022-03-29,San Bernardino,071,2135413,561960,561026,24655,585681,6860
2022-03-29,San Diego,073,3302833,752811,751240,51518,802758,5159
2022-03-29,San Francisco,075,870044,125105,124789,8406,133195,840
2022-03-29,San Joaquin,077,732212,166392,166241,9187,175428,2198
2022-03-29,San Luis Obispo,079,281455,52517,52455,3779,56234,472
2022-03-29,San Mateo,081,765935,120957,120435,7059,127494,686
2022-03-29,Santa Barbara,083,443738,85607,85464,4841,90305,676
2022-03-29,Santa Clara,085,1922200,312701,312067,12457,324524,2259
2022-03-29,Santa Cruz,087,273765,47395,47323,2087,49410,259
2022-03-29,Shasta,089,179085,30566,30552,6181,36733,529
2022-03-29,Sierra,091,2930,272,273,42,315,4
2022-03-29,Siskiyou,093,43540,4441,4439,2756,7195,80
2022-03-29,Solano,095,438530,81750,81713,5546,87259,441
2022-03-29,Sonoma,097,501317,83338,83130,2519,85649,485
2022-03-29,Stanislaus,099,539301,117419,117683,17126,134809,1559
2022-03-29,Sutter,101,95872,20568,20556,2094,22650,221
2022-03-29,Tehama,103,63373,12044,12045,2606,14651,198
2022-03-29,Trinity,105,12862,1176,1173,292,1465,20
2022-03-29,Tulare,107,460477,105261,104622,28433,133055,1406
2022-03-29,Tuolumne,109,53932,12615,12615,567,13182,180
2022-03-29,Ventura,111,848112,173104,172946,9281,182227,1460
2022-03-29,Yolo,113,214977,36523,36296,3192,39488,313
2022-03-29,Yuba,115,75493,15835,15824,1211,17035,117
2022-03-28,Alameda,001,1643700,255730,255192,13879,269071,1808
2022-03-28,Alpine,003,1148,124,124,1,125,0
2022-03-28,Amador,005,37829,8524,8480,646,9126,86
2022-03-28,Butte,007,227075,32989,32947,6659,39606,392
2022-03-28,Calaveras,009,45235,7255,7247,356,7603,119
2022-03-28,Colusa,011,21464,3445,3445,1080,4525,21
2022-03-28,Contra Costa,013,1133247,188655,188305,13263,201568,1290
2022-03-28,Del Norte,015,27424,5805,5834,197,6031,50
2022-03-28,El Dorado,017,186661,26715,26703,3212,29915,200
2022-03-28,Fresno,019,978130,230906,230144,22716,252860,2717
2022-03-28,Glenn,021,27897,4982,4983,1576,6559,47
2022-03-28,Humboldt,023,135768,16890,16916,2977,19893,140
2022-03-28,Imperial,025,180216,55225,55245,11125,66370,909
2022-03-28,Inyo,027,18085,4063,4062,484,4546,56
2022-03-28,Kern,029,883053,191453,191333,46297,237630,2212
2022-03-28,Kings,031,150075,51473,51405,3618,55023,443
2022-03-28,Lake,033,64148,10680,10673,898,11571,136
2022-03-28,Lassen,035,31185,8944,8946,896,9842,63
2022-03-28,Los Angeles,037,10098052,2704264,2700997,123413,2824410,31349
2022-03-28,Madera,039,155013,37348,37324,6066,43390,354
2022-03-28,Marin,041,260295,33487,33391,2245,35636,287
2022-03-28,Mariposa,043,17540,2391,2388,202,2590,23
2022-03-28,Mendocino,045,87422,13058,13046,2990,16036,118
2022-03-28,Merced,047,269075,62189,62116,8519,70635,805
2022-03-28,Modoc,049,8938,739,736,252,988,7
2022-03-28,Mono,051,14174,2967,2966,122,3088,5
2022-03-28,Monterey,053,433212,79088,78784,13763,92547,724
2022-03-28,Napa,055,140530,25768,25723,968,26691,140
2022-03-28,Nevada,057,99092,15944,15969,1213,17182,123
2022-03-28,Orange,059,3164182,545989,545700,41355,587055,6860
2022-03-28,Placer,061,380077,62723,62687,7357,70044,613
2022-03-28,Plumas,063,18699,2883,2760,360,3120,13
2022-03-28,Riverside,065,2383286,590674,590298,28140,618438,6397
2022-03-28,Sacramento,067,1510023,276691,275889,26883,302772,2946
2022-03-28,San Benito,069,59416,12900,12889,520,13409,97
2022-03-28,San Bernardino,071,2135413,561883,560836,24643,585479,6858
2022-03-28,San Diego,073,3302833,752576,750659,51518,802177,5155
2022-03-28,San Francisco,075,870044,124972,124678,8406,133084,839
2022-03-28,San Joaquin,077,732212,166361,166247,9187,175434,2196
2022-03-28,San Luis Obispo,079,281455,52492,52434,3779,56213,470
2022-03-28,San Mateo,081,765935,120853,120337,7059,127396,686
2022-03-28,Santa Barbara,083,443738,85580,85442,4841,90283,675
2022-03-28,Santa Clara,085,1922200,312468,311953,12457,324410,2257
2022-03-28,Santa Cruz,087,273765,47363,47324,2087,49411,259
2022-03-28,Shasta,089,179085,30565,30550,6181,36731,527
2022-03-28,Sierra,091,2930,272,273,42,315,4
2022-03-28,Siskiyou,093,43540,4440,4438,2756,7194,80
2022-03-28,Solano,095,438530,81728,81704,5546,87250,441
2022-03-28,Sonoma,097,501317,83295,83105,2519,85624,485
2022-03-28,Stanislaus,099,539301,117407,117783,17125,134908,1562
2022-03-28,Sutter,101,95872,20563,20549,2094,22643,221
2022-03-28,Tehama,103,63373,12043,12041,2606,14647,200
2022-03-28,Trinity,105,12862,1176,1173,292,1465,20
2022-03-28,Tulare,107,460477,105249,104576,28433,133009,1404
2022-03-28,Tuolumne,109,53932,12615,12627,567,13194,180
2022-03-28,Ventura,111,848112,173062,172867,9281,182148,1455
2022-03-28,Yolo,113,214977,36513,36282,3192,39474,312
2022-03-28,Yuba,115,75493,15834,15821,1210,17031,117
2022-03-27,Alameda,001,1643700,255558,255132,13869,269001,1809
2022-03-27,Alpine,003,1148,124,124,1,125,0
2022-03-27,Amador,005,37829,8521,8480,646,9126,86
2022-03-27,Butte,007,227075,32976,32943,6650,39593,392
2022-03-27,Calaveras,009,45235,7253,7245,356,7601,119
2022-03-27,Colusa,011,21464,3445,3445,1079,4524,21
2022-03-27,Contra Costa,013,1133247,188548,188251,13261,201512,1290
2022-03-27,Del Norte,015,27424,5804,5836,197,6033,50
2022-03-27,El Dorado,017,186661,26702,26699,3210,29909,200
2022-03-27,Fresno,019,978130,230858,230049,22700,252749,2717
2022-03-27,Glenn,021,27897,4981,4983,1576,6559,47
2022-03-27,Humboldt,023,135768,16886,16920,2977,19897,140
2022-03-27,Imperial,025,180216,55213,55240,11122,66362,909
2022-03-27,Inyo,027,18085,4062,4062,482,4544,56
2022-03-27,Kern,029,883053,191417,191332,46294,237626,2213
2022-03-27,Kings,031,150075,51464,51400,3618,55018,443
2022-03-27,Lake,033,64148,10679,10672,897,11569,136
2022-03-27,Lassen,035,31185,8944,8946,896,9842,63
2022-03-27,Los Angeles,037,10098052,2703570,2700983,123408,2824391,31348
2022-03-27,Madera,039,155013,37344,37323,6064,43387,354
2022-03-27,Marin,041,260295,33451,33391,2240,35631,287
2022-03-27,Mariposa,043,17540,2391,2390,202,2592,23
2022-03-27,Mendocino,045,87422,13051,13046,2988,16034,118
2022-03-27,Merced,047,269075,62179,62110,8517,70627,805
2022-03-27,Modoc,049,8938,738,736,251,987,7
2022-03-27,Mono,051,14174,2967,2966,122,3088,5
2022-03-27,Monterey,053,433212,79069,78778,13754,92532,724
2022-03-27,Napa,055,140530,25756,25723,968,26691,140
2022-03-27,Nevada,057,99092,15940,15967,1212,17179,123
2022-03-27,Orange,059,3164182,545863,545644,41326,586970,6860
2022-03-27,Placer,061,380077,62702,62680,7357,70037,613
2022-03-27,Plumas,063,18699,2883,2760,358,3118,13
2022-03-27,Riverside,065,2383286,590596,590251,28138,618389,6395
2022-03-27,Sacramento,067,1510023,276607,275854,26872,302726,2941
2022-03-27,San Benito,069,59416,12895,12889,519,13408,97
2022-03-27,San Bernardino,071,2135413,561774,560853,24642,585495,6862
2022-03-27,San Diego,073,3302833,752329,750659,51505,802164,5155
2022-03-27,San Francisco,075,870044,124797,124619,8403,133022,839
2022-03-27,San Joaquin,077,732212,166328,166238,9186,175424,2196
2022-03-27,San Luis Obispo,079,281455,52471,52430,3779,56209,470
2022-03-27,San Mateo,081,765935,120751,120324,7054,127378,686
2022-03-27,Santa Barbara,083,443738,85547,85434,4840,90274,675
2022-03-27,Santa Clara,085,1922200,312266,311822,12454,324276,2257
2022-03-27,Santa Cruz,087,273765,47329,47321,2083,49404,259
2022-03-27,Shasta,089,179085,30560,30550,6180,36730,527
2022-03-27,Sierra,091,2930,272,273,42,315,4
2022-03-27,Siskiyou,093,43540,4440,4436,2755,7191,80
2022-03-27,Solano,095,438530,81694,81691,5542,87233,441
2022-03-27,Sonoma,097,501317,83246,83088,2517,85605,485
2022-03-27,Stanislaus,099,539301,117386,117778,17124,134902,1562
2022-03-27,Sutter,101,95872,20557,20545,2094,22639,221
2022-03-27,Tehama,103,63373,12043,12040,2605,14645,200
2022-03-27,Trinity,105,12862,1176,1173,292,1465,20
2022-03-27,Tulare,107,460477,105240,104582,28424,133006,1404
2022-03-27,Tuolumne,109,53932,12613,12628,567,13195,180
2022-03-27,Ventura,111,848112,173018,172831,9281,182112,1455
2022-03-27,Yolo,113,214977,36502,36232,3192,39424,312
2022-03-27,Yuba,115,75493,15831,15821,1201,17022,117
2022-03-26,Alameda,001,1643700,255493,254691,13867,268558,1803
2022-03-26,Alpine,003,1148,124,124,1,125,0
2022-03-26,Amador,005,37829,8521,8476,646,9122,86
2022-03-26,Butte,007,227075,32972,32929,6650,39579,391
2022-03-26,Calaveras,009,45235,7251,7240,356,7596,120
2022-03-26,Colusa,011,21464,3444,3445,1079,4524,21
2022-03-26,Contra Costa,013,1133247,188502,187990,13261,201251,1285
2022-03-26,Del Norte,015,27424,5802,5831,197,6028,50
2022-03-26,El Dorado,017,186661,26694,26674,3209,29883,200
2022-03-26,Fresno,019,978130,230836,229799,22700,252499,2710
2022-03-26,Glenn,021,27897,4981,4978,1576,6554,47
2022-03-26,Humboldt,023,135768,16883,16911,2977,19888,139
2022-03-26,Imperial,025,180216,55207,55230,11122,66352,913
2022-03-26,Inyo,027,18085,4062,4060,482,4542,56
2022-03-26,Kern,029,883053,191405,191288,46290,237578,2201
2022-03-26,Kings,031,150075,51463,51397,3618,55015,444
2022-03-26,Lake,033,64148,10679,10659,897,11556,136
2022-03-26,Lassen,035,31185,8944,8944,896,9840,63
2022-03-26,Los Angeles,037,10098052,2703184,2698028,123391,2821419,31291
2022-03-26,Madera,039,155013,37341,37321,6064,43385,354
2022-03-26,Marin,041,260295,33439,33317,2237,35554,287
2022-03-26,Mariposa,043,17540,2391,2386,202,2588,23
2022-03-26,Mendocino,045,87422,13049,13038,2988,16026,118
2022-03-26,Merced,047,269075,62174,62083,8515,70598,805
2022-03-26,Modoc,049,8938,738,736,251,987,7
2022-03-26,Mono,051,14174,2967,2966,122,3088,5
2022-03-26,Monterey,053,433212,79063,78688,13752,92440,724
2022-03-26,Napa,055,140530,25753,25701,967,26668,139
2022-03-26,Nevada,057,99092,15936,15960,1212,17172,123
2022-03-26,Orange,059,3164182,545786,545294,41308,586602,6853
2022-03-26,Placer,061,380077,62691,62634,7355,69989,613
2022-03-26,Plumas,063,18699,2883,2758,358,3116,13
2022-03-26,Riverside,065,2383286,590530,590060,28136,618196,6397
2022-03-26,Sacramento,067,1510023,276580,275529,26871,302400,2935
2022-03-26,San Benito,069,59416,12895,12885,519,13404,97
2022-03-26,San Bernardino,071,2135413,561724,560742,24639,585381,6840
2022-03-26,San Diego,073,3302833,752208,750170,51497,801667,5146
2022-03-26,San Francisco,075,870044,124695,124265,8395,132660,839
2022-03-26,San Joaquin,077,732212,166309,166079,9185,175264,2195
2022-03-26,San Luis Obispo,079,281455,52466,52369,3779,56148,469
2022-03-26,San Mateo,081,765935,120697,120165,7049,127214,684
2022-03-26,Santa Barbara,083,443738,85528,85477,4839,90316,674
2022-03-26,Santa Clara,085,1922200,312120,311189,12450,323639,2250
2022-03-26,Santa Cruz,087,273765,47319,47329,2083,49412,259
2022-03-26,Shasta,089,179085,30558,30542,6179,36721,527
2022-03-26,Sierra,091,2930,272,273,42,315,4
2022-03-26,Siskiyou,093,43540,4439,4433,2755,7188,80
2022-03-26,Solano,095,438530,81684,81659,5542,87201,441
2022-03-26,Sonoma,097,501317,83220,83113,2516,85629,485
2022-03-26,Stanislaus,099,539301,117379,117962,17122,135084,1565
2022-03-26,Sutter,101,95872,20555,20536,2094,22630,221
2022-03-26,Tehama,103,63373,12043,12036,2605,14641,195
2022-03-26,Trinity,105,12862,1176,1174,292,1466,20
2022-03-26,Tulare,107,460477,105233,104538,28424,132962,1400
2022-03-26,Tuolumne,109,53932,12611,12628,567,13195,180
2022-03-26,Ventura,111,848112,172979,172690,9277,181967,1455
2022-03-26,Yolo,113,214977,36497,36234,3192,39426,311
2022-03-26,Yuba,115,75493,15830,15807,1201,17008,117
2022-03-25,Alameda,001,1643700,255431,254691,13865,268556,1803
2022-03-25,Alpine,003,1148,124,124,1,125,0
2022-03-25,Amador,005,37829,8520,8476,646,9122,86
2022-03-25,Butte,007,227075,32966,32929,6649,39578,391
2022-03-25,Calaveras,009,45235,7250,7240,356,7596,120
2022-03-25,Colusa,011,21464,3444,3445,1079,4524,21
2022-03-25,Contra Costa,013,1133247,188464,187990,13260,201250,1285
2022-03-25,Del Norte,015,27424,5802,5831,197,6028,50
2022-03-25,El Dorado,017,186661,26690,26674,3209,29883,200
2022-03-25,Fresno,019,978130,230808,229799,22690,252489,2710
2022-03-25,Glenn,021,27897,4981,4978,1576,6554,47
2022-03-25,Humboldt,023,135768,16883,16911,2977,19888,139
2022-03-25,Imperial,025,180216,55203,55230,11122,66352,913
2022-03-25,Inyo,027,18085,4061,4060,482,4542,56
2022-03-25,Kern,029,883053,191395,191288,46289,237577,2201
2022-03-25,Kings,031,150075,51462,51397,3618,55015,444
2022-03-25,Lake,033,64148,10679,10659,897,11556,136
2022-03-25,Lassen,035,31185,8943,8944,896,9840,63
2022-03-25,Los Angeles,037,10098052,2702806,2698028,123378,2821406,31291
2022-03-25,Madera,039,155013,37339,37321,6063,43384,354
2022-03-25,Marin,041,260295,33424,33317,2231,35548,287
2022-03-25,Mariposa,043,17540,2391,2386,202,2588,23
2022-03-25,Mendocino,045,87422,13049,13038,2988,16026,118
2022-03-25,Merced,047,269075,62167,62083,8515,70598,805
2022-03-25,Modoc,049,8938,738,736,251,987,7
2022-03-25,Mono,051,14174,2966,2966,122,3088,5
2022-03-25,Monterey,053,433212,79056,78688,13748,92436,724
2022-03-25,Napa,055,140530,25746,25701,967,26668,139
2022-03-25,Nevada,057,99092,15935,15960,1212,17172,123
2022-03-25,Orange,059,3164182,545712,545294,41296,586590,6853
2022-03-25,Placer,061,380077,62685,62634,7353,69987,613
2022-03-25,Plumas,063,18699,2882,2758,358,3116,13
2022-03-25,Riverside,065,2383286,590471,590060,28127,618187,6397
2022-03-25,Sacramento,067,1510023,276542,275529,26870,302399,2935
2022-03-25,San Benito,069,59416,12895,12885,519,13404,97
2022-03-25,San Bernardino,071,2135413,561688,560742,24636,585378,6840
2022-03-25,San Diego,073,3302833,752088,750170,51491,801661,5146
2022-03-25,San Francisco,075,870044,124617,124265,8386,132651,839
2022-03-25,San Joaquin,077,732212,166294,166079,9185,175264,2195
2022-03-25,San Luis Obispo,079,281455,52463,52369,3778,56147,469
2022-03-25,San Mateo,081,765935,120648,120165,7049,127214,684
2022-03-25,Santa Barbara,083,443738,85513,85477,4837,90314,674
2022-03-25,Santa Clara,085,1922200,311973,311189,12446,323635,2250
2022-03-25,Santa Cruz,087,273765,47311,47329,2083,49412,259
2022-03-25,Shasta,089,179085,30556,30542,6178,36720,527
2022-03-25,Sierra,091,2930,272,273,42,315,4
2022-03-25,Siskiyou,093,43540,4437,4433,2755,7188,80
2022-03-25,Solano,095,438530,81669,81659,5540,87199,441
2022-03-25,Sonoma,097,501317,83184,83113,2516,85629,485
2022-03-25,Stanislaus,099,539301,117365,117962,17121,135083,1565
2022-03-25,Sutter,101,95872,20550,20536,2094,22630,221
2022-03-25,Tehama,103,63373,12041,12036,2605,14641,195
2022-03-25,Trinity,105,12862,1176,1174,292,1466,20
2022-03-25,Tulare,107,460477,105228,104538,28420,132958,1400
2022-03-25,Tuolumne,109,53932,12610,12628,567,13195,180
2022-03-25,Ventura,111,848112,172943,172690,9277,181967,1455
2022-03-25,Yolo,113,214977,36486,36234,3192,39426,311
2022-03-25,Yuba,115,75493,15826,15807,1201,17008,117
2022-03-24,Alameda,001,1643700,255328,254691,13848,268539,1803
2022-03-24,Alpine,003,1148,124,124,1,125,0
2022-03-24,Amador,005,37829,8520,8476,646,9122,86
2022-03-24,Butte,007,227075,32959,32929,6648,39577,391
2022-03-24,Calaveras,009,45235,7247,7240,356,7596,120
2022-03-24,Colusa,011,21464,3444,3445,1079,4524,21
2022-03-24,Contra Costa,013,1133247,188386,187990,13259,201249,1285
2022-03-24,Del Norte,015,27424,5798,5831,197,6028,50
2022-03-24,El Dorado,017,186661,26681,26674,3209,29883,200
2022-03-24,Fresno,019,978130,230768,229799,22678,252477,2710
2022-03-24,Glenn,021,27897,4980,4978,1576,6554,47
2022-03-24,Humboldt,023,135768,16878,16911,2975,19886,139
2022-03-24,Imperial,025,180216,55198,55230,11119,66349,913
2022-03-24,Inyo,027,18085,4060,4060,482,4542,56
2022-03-24,Kern,029,883053,191383,191288,46284,237572,2201
2022-03-24,Kings,031,150075,51453,51397,3616,55013,444
2022-03-24,Lake,033,64148,10678,10659,897,11556,136
2022-03-24,Lassen,035,31185,8942,8944,896,9840,63
2022-03-24,Los Angeles,037,10098052,2702275,2698028,123346,2821374,31291
2022-03-24,Madera,039,155013,37337,37321,6061,43382,354
2022-03-24,Marin,041,260295,33401,33317,2222,35539,287
2022-03-24,Mariposa,043,17540,2391,2386,202,2588,23
2022-03-24,Mendocino,045,87422,13044,13038,2985,16023,118
2022-03-24,Merced,047,269075,62161,62083,8514,70597,805
2022-03-24,Modoc,049,8938,738,736,251,987,7
2022-03-24,Mono,051,14174,2966,2966,122,3088,5
2022-03-24,Monterey,053,433212,79029,78688,13735,92423,724
2022-03-24,Napa,055,140530,25738,25701,967,26668,139
2022-03-24,Nevada,057,99092,15931,15960,1211,17171,123
2022-03-24,Orange,059,3164182,545613,545294,41275,586569,6853
2022-03-24,Placer,061,380077,62666,62634,7352,69986,613
2022-03-24,Plumas,063,18699,2882,2758,358,3116,13
2022-03-24,Riverside,065,2383286,590394,590060,28120,618180,6397
2022-03-24,Sacramento,067,1510023,276475,275529,26866,302395,2935
2022-03-24,San Benito,069,59416,12894,12885,519,13404,97
2022-03-24,San Bernardino,071,2135413,561613,560742,24630,585372,6840
2022-03-24,San Diego,073,3302833,751880,750170,51478,801648,5146
2022-03-24,San Francisco,075,870044,124540,124265,8381,132646,839
2022-03-24,San Joaquin,077,732212,166267,166079,9185,175264,2195
2022-03-24,San Luis Obispo,079,281455,52448,52369,3777,56146,469
2022-03-24,San Mateo,081,765935,120599,120165,7046,127211,684
2022-03-24,Santa Barbara,083,443738,85498,85477,4835,90312,674
2022-03-24,Santa Clara,085,1922200,311830,311189,12429,323618,2250
2022-03-24,Santa Cruz,087,273765,47294,47329,2082,49411,259
2022-03-24,Shasta,089,179085,30548,30542,6178,36720,527
2022-03-24,Sierra,091,2930,272,273,42,315,4
2022-03-24,Siskiyou,093,43540,4434,4433,2754,7187,80
2022-03-24,Solano,095,438530,81649,81659,5539,87198,441
2022-03-24,Sonoma,097,501317,83149,83113,2516,85629,485
2022-03-24,Stanislaus,099,539301,117356,117962,17120,135082,1565
2022-03-24,Sutter,101,95872,20545,20536,2094,22630,221
2022-03-24,Tehama,103,63373,12040,12036,2604,14640,195
2022-03-24,Trinity,105,12862,1176,1174,292,1466,20
2022-03-24,Tulare,107,460477,105218,104538,28415,132953,1400
2022-03-24,Tuolumne,109,53932,12608,12628,567,13195,180
2022-03-24,Ventura,111,848112,172900,172690,9275,181965,1455
2022-03-24,Yolo,113,214977,36479,36234,3191,39425,311
2022-03-24,Yuba,115,75493,15821,15807,1198,17005,117
2022-03-23,Alameda,001,1643700,255198,254559,13838,268397,1802
2022-03-23,Alpine,003,1148,124,124,1,125,0
2022-03-23,Amador,005,37829,8520,8475,646,9121,86
2022-03-23,Butte,007,227075,32946,32920,6647,39567,387
2022-03-23,Calaveras,009,45235,7242,7237,356,7593,120
2022-03-23,Colusa,011,21464,3443,3444,1079,4523,21
2022-03-23,Contra Costa,013,1133247,188288,187898,13248,201146,1279
2022-03-23,Del Norte,015,27424,5796,5830,196,6026,50
2022-03-23,El Dorado,017,186661,26675,26670,3209,29879,200
2022-03-23,Fresno,019,978130,230732,229656,22661,252317,2710
2022-03-23,Glenn,021,27897,4980,4975,1576,6551,47
2022-03-23,Humboldt,023,135768,16877,16908,2973,19881,139
2022-03-23,Imperial,025,180216,55193,55211,11107,66318,909
2022-03-23,Inyo,027,18085,4060,4060,482,4542,56
2022-03-23,Kern,029,883053,191367,191241,46280,237521,2196
2022-03-23,Kings,031,150075,51441,51384,3615,54999,442
2022-03-23,Lake,033,64148,10674,10658,896,11554,135
2022-03-23,Lassen,035,31185,8941,8944,895,9839,63
2022-03-23,Los Angeles,037,10098052,2701609,2697227,123317,2820544,31267
2022-03-23,Madera,039,155013,37333,37317,6056,43373,354
2022-03-23,Marin,041,260295,33377,33274,2217,35491,287
2022-03-23,Mariposa,043,17540,2389,2382,201,2583,11
2022-03-23,Mendocino,045,87422,13040,13033,2984,16017,118
2022-03-23,Merced,047,269075,62151,62056,8511,70567,805
2022-03-23,Modoc,049,8938,738,736,251,987,7
2022-03-23,Mono,051,14174,2966,2966,122,3088,5
2022-03-23,Monterey,053,433212,79010,78655,13713,92368,724
2022-03-23,Napa,055,140530,25725,25691,965,26656,139
2022-03-23,Nevada,057,99092,15929,15958,1211,17169,123
2022-03-23,Orange,059,3164182,545485,545158,41267,586425,6852
2022-03-23,Placer,061,380077,62648,62622,7350,69972,613
2022-03-23,Plumas,063,18699,2882,2747,358,3105,13
2022-03-23,Riverside,065,2383286,590322,589947,28114,618061,6388
2022-03-23,Sacramento,067,1510023,276414,275398,26860,302258,2934
2022-03-23,San Benito,069,59416,12893,12884,519,13403,97
2022-03-23,San Bernardino,071,2135413,561542,560550,24625,585175,6828
2022-03-23,San Diego,073,3302833,751686,749871,51456,801327,5143
2022-03-23,San Francisco,075,870044,124427,124110,8376,132486,838
2022-03-23,San Joaquin,077,732212,166232,166041,9183,175224,2187
2022-03-23,San Luis Obispo,079,281455,52431,52344,3772,56116,469
2022-03-23,San Mateo,081,765935,120516,120080,7035,127115,685
2022-03-23,Santa Barbara,083,443738,85479,85464,4834,90298,673
2022-03-23,Santa Clara,085,1922200,311669,310956,12418,323374,2250
2022-03-23,Santa Cruz,087,273765,47273,47314,2075,49389,259
2022-03-23,Shasta,089,179085,30544,30524,6177,36701,526
2022-03-23,Sierra,091,2930,272,273,42,315,4
2022-03-23,Siskiyou,093,43540,4433,4433,2754,7187,80
2022-03-23,Solano,095,438530,81615,81615,5538,87153,441
2022-03-23,Sonoma,097,501317,83118,83074,2514,85588,482
2022-03-23,Stanislaus,099,539301,117337,118041,17117,135158,1568
2022-03-23,Sutter,101,95872,20542,20532,2094,22626,218
2022-03-23,Tehama,103,63373,12038,12035,2604,14639,195
2022-03-23,Trinity,105,12862,1176,1174,292,1466,20
2022-03-23,Tulare,107,460477,105201,104489,28410,132899,1394
2022-03-23,Tuolumne,109,53932,12607,12629,567,13196,180
2022-03-23,Ventura,111,848112,172853,172647,9273,181920,1455
2022-03-23,Yolo,113,214977,36464,36197,3191,39388,308
2022-03-23,Yuba,115,75493,15815,15801,1198,16999,117
2022-03-22,Alameda,001,1643700,255080,254467,13788,268255,1802
2022-03-22,Alpine,003,1148,124,122,1,123,0
2022-03-22,Amador,005,37829,8519,8462,645,9107,86
2022-03-22,Butte,007,227075,32936,32907,6643,39550,387
2022-03-22,Calaveras,009,45235,7240,7237,356,7593,120
2022-03-22,Colusa,011,21464,3442,3445,1079,4524,21
2022-03-22,Contra Costa,013,1133247,188212,187813,13225,201038,1279
2022-03-22,Del Norte,015,27424,5791,5824,196,6020,50
2022-03-22,El Dorado,017,186661,26668,26661,3209,29870,200
2022-03-22,Fresno,019,978130,230685,229551,22654,252205,2708
2022-03-22,Glenn,021,27897,4977,4971,1576,6547,47
2022-03-22,Humboldt,023,135768,16874,16911,2973,19884,139
2022-03-22,Imperial,025,180216,55184,55170,11098,66268,908
2022-03-22,Inyo,027,18085,4060,4060,482,4542,56
2022-03-22,Kern,029,883053,191344,191213,46271,237484,2195
2022-03-22,Kings,031,150075,51429,51369,3614,54983,442
2022-03-22,Lake,033,64148,10672,10657,895,11552,135
2022-03-22,Lassen,035,31185,8941,8940,894,9834,63
2022-03-22,Los Angeles,037,10098052,2700965,2696746,123274,2820020,31250
2022-03-22,Madera,039,155013,37329,37304,6054,43358,354
2022-03-22,Marin,041,260295,33353,33253,2212,35465,287
2022-03-22,Mariposa,043,17540,2387,2382,201,2583,6
2022-03-22,Mendocino,045,87422,13035,13030,2982,16012,118
2022-03-22,Merced,047,269075,62141,62056,8507,70563,805
2022-03-22,Modoc,049,8938,738,735,251,986,7
2022-03-22,Mono,051,14174,2966,2963,122,3085,5
2022-03-22,Monterey,053,433212,78994,78614,13705,92319,724
2022-03-22,Napa,055,140530,25716,25688,965,26653,139
2022-03-22,Nevada,057,99092,15921,15950,1211,17161,123
2022-03-22,Orange,059,3164182,545342,545075,41253,586328,6843
2022-03-22,Placer,061,380077,62637,62604,7348,69952,610
2022-03-22,Plumas,063,18699,2881,2744,358,3102,13
2022-03-22,Riverside,065,2383286,590250,589816,28112,617928,6383
2022-03-22,Sacramento,067,1510023,276341,275374,26849,302223,2927
2022-03-22,San Benito,069,59416,12892,12884,518,13402,97
2022-03-22,San Bernardino,071,2135413,561461,560371,24605,584976,6811
2022-03-22,San Diego,073,3302833,751480,749647,51436,801083,5141
2022-03-22,San Francisco,075,870044,124320,123998,8373,132371,838
2022-03-22,San Joaquin,077,732212,166204,165992,9179,175171,2187
2022-03-22,San Luis Obispo,079,281455,52423,52257,3771,56028,465
2022-03-22,San Mateo,081,765935,120446,119975,7029,127004,686
2022-03-22,Santa Barbara,083,443738,85463,85457,4833,90290,672
2022-03-22,Santa Clara,085,1922200,311498,310787,12410,323197,2249
2022-03-22,Santa Cruz,087,273765,47254,47287,2074,49361,259
2022-03-22,Shasta,089,179085,30538,30528,6176,36704,525
2022-03-22,Sierra,091,2930,272,273,42,315,4
2022-03-22,Siskiyou,093,43540,4433,4429,2754,7183,80
2022-03-22,Solano,095,438530,81591,81587,5537,87124,440
2022-03-22,Sonoma,097,501317,83091,83042,2512,85554,482
2022-03-22,Stanislaus,099,539301,117318,118025,17114,135139,1568
2022-03-22,Sutter,101,95872,20541,20525,2090,22615,218
2022-03-22,Tehama,103,63373,12036,12034,2604,14638,162
2022-03-22,Trinity,105,12862,1176,1174,292,1466,20
2022-03-22,Tulare,107,460477,105188,104431,28400,132831,1391
2022-03-22,Tuolumne,109,53932,12607,12628,567,13195,180
2022-03-22,Ventura,111,848112,172806,172590,9271,181861,1455
2022-03-22,Yolo,113,214977,36446,36184,3189,39373,308
2022-03-22,Yuba,115,75493,15812,15795,1197,16992,117
2022-03-21,Alameda,001,1643700,254846,254354,13781,268135,1799
2022-03-21,Alpine,003,1148,124,122,1,123,0
2022-03-21,Amador,005,37829,8517,8461,644,9105,85
2022-03-21,Butte,007,227075,32925,32895,6640,39535,385
2022-03-21,Calaveras,009,45235,7239,7237,356,7593,119
2022-03-21,Colusa,011,21464,3442,3445,1079,4524,21
2022-03-21,Contra Costa,013,1133247,188148,187509,13208,200717,1276
2022-03-21,Del Norte,015,27424,5790,5824,196,6020,50
2022-03-21,El Dorado,017,186661,26657,26610,3207,29817,199
2022-03-21,Fresno,019,978130,230635,229374,22645,252019,2707
2022-03-21,Glenn,021,27897,4975,4972,1569,6541,46
2022-03-21,Humboldt,023,135768,16865,16912,2960,19872,139
2022-03-21,Imperial,025,180216,55168,55133,11092,66225,908
2022-03-21,Inyo,027,18085,4059,4060,482,4542,56
2022-03-21,Kern,029,883053,191309,191184,46266,237450,2187
2022-03-21,Kings,031,150075,51415,51366,3612,54978,441
2022-03-21,Lake,033,64148,10670,10655,895,11550,135
2022-03-21,Lassen,035,31185,8940,8939,894,9833,63
2022-03-21,Los Angeles,037,10098052,2700136,2694711,123233,2817944,31218
2022-03-21,Madera,039,155013,37322,37288,6050,43338,354
2022-03-21,Marin,041,260295,33311,33242,2208,35450,287
2022-03-21,Mariposa,043,17540,2386,2383,200,2583,6
2022-03-21,Mendocino,045,87422,13027,13028,2980,16008,118
2022-03-21,Merced,047,269075,62127,62048,8503,70551,803
2022-03-21,Modoc,049,8938,736,734,251,985,7
2022-03-21,Mono,051,14174,2966,2962,122,3084,5
2022-03-21,Monterey,053,433212,78948,78572,13691,92263,724
2022-03-21,Napa,055,140530,25708,25684,963,26647,138
2022-03-21,Nevada,057,99092,15917,15963,1210,17173,123
2022-03-21,Orange,059,3164182,545190,544943,41242,586185,6841
2022-03-21,Placer,061,380077,62618,62550,7348,69898,610
2022-03-21,Plumas,063,18699,2881,2744,358,3102,13
2022-03-21,Riverside,065,2383286,590170,589707,28106,617813,6376
2022-03-21,Sacramento,067,1510023,276248,275334,26831,302165,2925
2022-03-21,San Benito,069,59416,12886,12872,518,13390,97
2022-03-21,San Bernardino,071,2135413,561374,560210,24593,584803,6807
2022-03-21,San Diego,073,3302833,751246,748833,51416,800249,5138
2022-03-21,San Francisco,075,870044,124152,123912,8363,132275,835
2022-03-21,San Joaquin,077,732212,166178,165939,9175,175114,2185
2022-03-21,San Luis Obispo,079,281455,52398,52219,3766,55985,463
2022-03-21,San Mateo,081,765935,120286,119899,7027,126926,684
2022-03-21,Santa Barbara,083,443738,85447,85416,4830,90246,672
2022-03-21,Santa Clara,085,1922200,311112,310509,12407,322916,2245
2022-03-21,Santa Cruz,087,273765,47217,47267,2072,49339,259
2022-03-21,Shasta,089,179085,30532,30523,6173,36696,525
2022-03-21,Sierra,091,2930,272,273,42,315,4
2022-03-21,Siskiyou,093,43540,4433,4426,2754,7180,80
2022-03-21,Solano,095,438530,81563,81399,5537,86936,441
2022-03-21,Sonoma,097,501317,83054,82979,2511,85490,482
2022-03-21,Stanislaus,099,539301,117287,118144,17112,135256,1571
2022-03-21,Sutter,101,95872,20538,20523,2076,22599,218
2022-03-21,Tehama,103,63373,12032,12030,2604,14634,160
2022-03-21,Trinity,105,12862,1176,1174,292,1466,20
2022-03-21,Tulare,107,460477,105168,104350,28394,132744,1389
2022-03-21,Tuolumne,109,53932,12607,12620,567,13187,180
2022-03-21,Ventura,111,848112,172737,172537,9267,181804,1452
2022-03-21,Yolo,113,214977,36431,36141,3188,39329,307
2022-03-21,Yuba,115,75493,15809,15790,1196,16986,117
2022-03-20,Alameda,001,1643700,254720,254293,13771,268064,1801
2022-03-20,Alpine,003,1148,122,122,1,123,0
2022-03-20,Amador,005,37829,8514,8460,644,9104,85
2022-03-20,Butte,007,227075,32911,32892,6635,39527,385
2022-03-20,Calaveras,009,45235,7238,7233,353,7586,119
2022-03-20,Colusa,011,21464,3442,3446,1079,4525,21
2022-03-20,Contra Costa,013,1133247,188049,187467,13196,200663,1276
2022-03-20,Del Norte,015,27424,5787,5821,196,6017,50
2022-03-20,El Dorado,017,186661,26650,26608,3207,29815,199
2022-03-20,Fresno,019,978130,230556,229297,22638,251935,2707
2022-03-20,Glenn,021,27897,4973,4972,1569,6541,46
2022-03-20,Humboldt,023,135768,16863,16913,2958,19871,139
2022-03-20,Imperial,025,180216,55157,55133,11088,66221,908
2022-03-20,Inyo,027,18085,4059,4060,482,4542,56
2022-03-20,Kern,029,883053,191265,191170,46261,237431,2187
2022-03-20,Kings,031,150075,51403,51360,3612,54972,441
2022-03-20,Lake,033,64148,10666,10652,895,11547,135
2022-03-20,Lassen,035,31185,8938,8938,894,9832,63
2022-03-20,Los Angeles,037,10098052,2699364,2694698,123191,2817889,31219
2022-03-20,Madera,039,155013,37316,37284,6045,43329,354
2022-03-20,Marin,041,260295,33293,33232,2207,35439,275
2022-03-20,Mariposa,043,17540,2386,2383,200,2583,6
2022-03-20,Mendocino,045,87422,13021,13027,2974,16001,118
2022-03-20,Merced,047,269075,62116,62041,8497,70538,803
2022-03-20,Modoc,049,8938,736,734,251,985,7
2022-03-20,Mono,051,14174,2964,2962,122,3084,5
2022-03-20,Monterey,053,433212,78915,78566,13680,92246,723
2022-03-20,Napa,055,140530,25696,25682,963,26645,138
2022-03-20,Nevada,057,99092,15913,15964,1210,17174,123
2022-03-20,Orange,059,3164182,545069,544862,41224,586086,6841
2022-03-20,Placer,061,380077,62597,62525,7347,69872,610
2022-03-20,Plumas,063,18699,2881,2744,358,3102,13
2022-03-20,Riverside,065,2383286,590074,589657,28101,617758,6376
2022-03-20,Sacramento,067,1510023,276170,275317,26817,302134,2927
2022-03-20,San Benito,069,59416,12886,12869,517,13386,97
2022-03-20,San Bernardino,071,2135413,561300,560220,24586,584806,6805
2022-03-20,San Diego,073,3302833,751004,748833,51385,800218,5138
2022-03-20,San Francisco,075,870044,124002,123858,8351,132209,835
2022-03-20,San Joaquin,077,732212,166146,165927,9171,175098,2185
2022-03-20,San Luis Obispo,079,281455,52374,52217,3763,55980,463
2022-03-20,San Mateo,081,765935,120228,119901,7023,126924,684
2022-03-20,Santa Barbara,083,443738,85421,85412,4829,90241,672
2022-03-20,Santa Clara,085,1922200,310899,310412,12399,322811,2243
2022-03-20,Santa Cruz,087,273765,47191,47265,2071,49336,259
2022-03-20,Shasta,089,179085,30522,30522,6173,36695,525
2022-03-20,Sierra,091,2930,272,273,42,315,4
2022-03-20,Siskiyou,093,43540,4432,4426,2754,7180,80
2022-03-20,Solano,095,438530,81535,81393,5536,86929,441
2022-03-20,Sonoma,097,501317,83012,82965,2510,85475,481
2022-03-20,Stanislaus,099,539301,117262,118146,17108,135254,1572
2022-03-20,Sutter,101,95872,20531,20519,2066,22585,218
2022-03-20,Tehama,103,63373,12029,12030,2604,14634,160
2022-03-20,Trinity,105,12862,1176,1174,292,1466,20
2022-03-20,Tulare,107,460477,105146,104353,28372,132725,1389
2022-03-20,Tuolumne,109,53932,12602,12617,567,13184,180
2022-03-20,Ventura,111,848112,172685,172514,9262,181776,1451
2022-03-20,Yolo,113,214977,36410,36135,3187,39322,307
2022-03-20,Yuba,115,75493,15802,15787,1195,16982,117
2022-03-19,Alameda,001,1643700,254651,253936,13770,267706,1797
2022-03-19,Alpine,003,1148,122,122,1,123,0
2022-03-19,Amador,005,37829,8511,8456,644,9100,85
2022-03-19,Butte,007,227075,32904,32856,6634,39490,385
2022-03-19,Calaveras,009,45235,7238,7229,353,7582,119
2022-03-19,Colusa,011,21464,3440,3445,1079,4524,21
2022-03-19,Contra Costa,013,1133247,188013,187225,13196,200421,1276
2022-03-19,Del Norte,015,27424,5784,5815,196,6011,48
2022-03-19,El Dorado,017,186661,26646,26618,3207,29825,199
2022-03-19,Fresno,019,978130,230533,228965,22638,251603,2694
2022-03-19,Glenn,021,27897,4973,4971,1569,6540,44
2022-03-19,Humboldt,023,135768,16858,16901,2957,19858,138
2022-03-19,Imperial,025,180216,55156,55038,11087,66125,898
2022-03-19,Inyo,027,18085,4059,4061,482,4543,56
2022-03-19,Kern,029,883053,191253,190943,46254,237197,2184
2022-03-19,Kings,031,150075,51398,51334,3612,54946,441
2022-03-19,Lake,033,64148,10666,10641,895,11536,135
2022-03-19,Lassen,035,31185,8938,8925,894,9819,63
2022-03-19,Los Angeles,037,10098052,2699010,2686759,123160,2809919,31133
2022-03-19,Madera,039,155013,37316,37273,6045,43318,354
2022-03-19,Marin,041,260295,33275,33163,2204,35367,272
2022-03-19,Mariposa,043,17540,2385,2378,200,2578,6
2022-03-19,Mendocino,045,87422,13021,13012,2974,15986,117
2022-03-19,Merced,047,269075,62110,61985,8495,70480,800
2022-03-19,Modoc,049,8938,736,734,251,985,7
2022-03-19,Mono,051,14174,2964,2961,122,3083,5
2022-03-19,Monterey,053,433212,78904,78483,13673,92156,720
2022-03-19,Napa,055,140530,25693,25654,963,26617,138
2022-03-19,Nevada,057,99092,15911,15960,1209,17169,123
2022-03-19,Orange,059,3164182,544997,543907,41207,585114,6817
2022-03-19,Placer,061,380077,62582,62483,7347,69830,605
2022-03-19,Plumas,063,18699,2881,2724,358,3082,13
2022-03-19,Riverside,065,2383286,590021,589017,28095,617112,6359
2022-03-19,Sacramento,067,1510023,276131,274855,26815,301670,2913
2022-03-19,San Benito,069,59416,12885,12859,517,13376,97
2022-03-19,San Bernardino,071,2135413,561254,559935,24585,584520,6778
2022-03-19,San Diego,073,3302833,750899,747344,51374,798718,5133
2022-03-19,San Francisco,075,870044,123938,123587,8347,131934,833
2022-03-19,San Joaquin,077,732212,166120,165765,9168,174933,2181
2022-03-19,San Luis Obispo,079,281455,52368,52174,3763,55937,463
2022-03-19,San Mateo,081,765935,120192,119782,7021,126803,667
2022-03-19,Santa Barbara,083,443738,85408,85336,4828,90164,671
2022-03-19,Santa Clara,085,1922200,310782,309918,12392,322310,2225
2022-03-19,Santa Cruz,087,273765,47183,47203,2067,49270,256
2022-03-19,Shasta,089,179085,30518,30495,6173,36668,525
2022-03-19,Sierra,091,2930,272,273,42,315,4
2022-03-19,Siskiyou,093,43540,4431,4422,2754,7176,76
2022-03-19,Solano,095,438530,81526,81340,5533,86873,441
2022-03-19,Sonoma,097,501317,82996,82838,2508,85346,472
2022-03-19,Stanislaus,099,539301,117252,118138,17107,135245,1568
2022-03-19,Sutter,101,95872,20528,20503,2066,22569,218
2022-03-19,Tehama,103,63373,12029,12007,2604,14611,160
2022-03-19,Trinity,105,12862,1176,1173,292,1465,20
2022-03-19,Tulare,107,460477,105138,104290,28367,132657,1384
2022-03-19,Tuolumne,109,53932,12602,12617,567,13184,180
2022-03-19,Ventura,111,848112,172654,172380,9261,181641,1451
2022-03-19,Yolo,113,214977,36401,36086,3187,39273,306
2022-03-19,Yuba,115,75493,15798,15768,1194,16962,117
2022-03-18,Alameda,001,1643700,254589,253936,13766,267702,1797
2022-03-18,Alpine,003,1148,122,122,1,123,0
2022-03-18,Amador,005,37829,8511,8456,644,9100,85
2022-03-18,Butte,007,227075,32899,32856,6631,39487,385
2022-03-18,Calaveras,009,45235,7238,7229,353,7582,119
2022-03-18,Colusa,011,21464,3440,3445,1079,4524,21
2022-03-18,Contra Costa,013,1133247,187983,187225,13193,200418,1276
2022-03-18,Del Norte,015,27424,5782,5815,195,6010,48
2022-03-18,El Dorado,017,186661,26642,26618,3206,29824,199
2022-03-18,Fresno,019,978130,230501,228965,22638,251603,2694
2022-03-18,Glenn,021,27897,4973,4971,1569,6540,44
2022-03-18,Humboldt,023,135768,16854,16901,2956,19857,138
2022-03-18,Imperial,025,180216,55154,55038,11087,66125,898
2022-03-18,Inyo,027,18085,4059,4061,482,4543,56
2022-03-18,Kern,029,883053,191241,190943,46251,237194,2184
2022-03-18,Kings,031,150075,51392,51334,3612,54946,441
2022-03-18,Lake,033,64148,10664,10641,893,11534,135
2022-03-18,Lassen,035,31185,8937,8925,894,9819,63
2022-03-18,Los Angeles,037,10098052,2698673,2686759,123137,2809896,31133
2022-03-18,Madera,039,155013,37311,37273,6045,43318,354
2022-03-18,Marin,041,260295,33261,33163,2204,35367,272
2022-03-18,Mariposa,043,17540,2384,2378,200,2578,6
2022-03-18,Mendocino,045,87422,13015,13012,2974,15986,117
2022-03-18,Merced,047,269075,62100,61985,8495,70480,800
2022-03-18,Modoc,049,8938,736,734,251,985,7
2022-03-18,Mono,051,14174,2963,2961,122,3083,5
2022-03-18,Monterey,053,433212,78885,78483,13668,92151,720
2022-03-18,Napa,055,140530,25690,25654,963,26617,138
2022-03-18,Nevada,057,99092,15908,15960,1208,17168,123
2022-03-18,Orange,059,3164182,544928,543907,41198,585105,6817
2022-03-18,Placer,061,380077,62574,62483,7347,69830,605
2022-03-18,Plumas,063,18699,2881,2724,358,3082,13
2022-03-18,Riverside,065,2383286,589964,589017,28091,617108,6359
2022-03-18,Sacramento,067,1510023,276098,274855,26810,301665,2913
2022-03-18,San Benito,069,59416,12883,12859,517,13376,97
2022-03-18,San Bernardino,071,2135413,561216,559935,24583,584518,6778
2022-03-18,San Diego,073,3302833,750790,747344,51358,798702,5133
2022-03-18,San Francisco,075,870044,123859,123587,8340,131927,833
2022-03-18,San Joaquin,077,732212,166106,165765,9163,174928,2181
2022-03-18,San Luis Obispo,079,281455,52362,52174,3763,55937,463
2022-03-18,San Mateo,081,765935,120155,119782,7017,126799,667
2022-03-18,Santa Barbara,083,443738,85399,85336,4828,90164,671
2022-03-18,Santa Clara,085,1922200,310681,309918,12390,322308,2225
2022-03-18,Santa Cruz,087,273765,47171,47203,2066,49269,256
2022-03-18,Shasta,089,179085,30517,30495,6173,36668,525
2022-03-18,Sierra,091,2930,272,273,42,315,4
2022-03-18,Siskiyou,093,43540,4431,4422,2754,7176,76
2022-03-18,Solano,095,438530,81515,81340,5527,86867,441
2022-03-18,Sonoma,097,501317,82977,82838,2508,85346,472
2022-03-18,Stanislaus,099,539301,117238,118138,17107,135245,1568
2022-03-18,Sutter,101,95872,20524,20503,2066,22569,218
2022-03-18,Tehama,103,63373,12028,12007,2604,14611,160
2022-03-18,Trinity,105,12862,1176,1173,292,1465,20
2022-03-18,Tulare,107,460477,105132,104290,28360,132650,1384
2022-03-18,Tuolumne,109,53932,12601,12617,567,13184,180
2022-03-18,Ventura,111,848112,172634,172380,9257,181637,1451
2022-03-18,Yolo,113,214977,36390,36086,3187,39273,306
2022-03-18,Yuba,115,75493,15796,15768,1194,16962,117
2022-03-17,Alameda,001,1643700,254496,253936,13760,267696,1797
2022-03-17,Alpine,003,1148,122,122,1,123,0
2022-03-17,Amador,005,37829,8504,8456,644,9100,85
2022-03-17,Butte,007,227075,32885,32856,6630,39486,385
2022-03-17,Calaveras,009,45235,7235,7229,353,7582,119
2022-03-17,Colusa,011,21464,3440,3445,1079,4524,21
2022-03-17,Contra Costa,013,1133247,187920,187225,13183,200408,1276
2022-03-17,Del Norte,015,27424,5780,5815,195,6010,48
2022-03-17,El Dorado,017,186661,26635,26618,3206,29824,199
2022-03-17,Fresno,019,978130,230453,228965,22636,251601,2694
2022-03-17,Glenn,021,27897,4973,4971,1569,6540,44
2022-03-17,Humboldt,023,135768,16850,16901,2954,19855,138
2022-03-17,Imperial,025,180216,55143,55038,11085,66123,898
2022-03-17,Inyo,027,18085,4059,4061,482,4543,56
2022-03-17,Kern,029,883053,191211,190943,46248,237191,2184
2022-03-17,Kings,031,150075,51389,51334,3611,54945,441
2022-03-17,Lake,033,64148,10661,10641,893,11534,135
2022-03-17,Lassen,035,31185,8935,8925,894,9819,63
2022-03-17,Los Angeles,037,10098052,2698027,2686759,123102,2809861,31133
2022-03-17,Madera,039,155013,37307,37273,6045,43318,354
2022-03-17,Marin,041,260295,33248,33163,2203,35366,272
2022-03-17,Mariposa,043,17540,2384,2378,200,2578,6
2022-03-17,Mendocino,045,87422,13012,13012,2971,15983,117
2022-03-17,Merced,047,269075,62094,61985,8493,70478,800
2022-03-17,Modoc,049,8938,736,734,251,985,7
2022-03-17,Mono,051,14174,2963,2961,121,3082,5
2022-03-17,Monterey,053,433212,78862,78483,13663,92146,720
2022-03-17,Napa,055,140530,25685,25654,963,26617,138
2022-03-17,Nevada,057,99092,15905,15960,1208,17168,123
2022-03-17,Orange,059,3164182,544834,543907,41187,585094,6817
2022-03-17,Placer,061,380077,62560,62483,7345,69828,605
2022-03-17,Plumas,063,18699,2880,2724,358,3082,13
2022-03-17,Riverside,065,2383286,589884,589017,28084,617101,6359
2022-03-17,Sacramento,067,1510023,276032,274855,26803,301658,2913
2022-03-17,San Benito,069,59416,12882,12859,517,13376,97
2022-03-17,San Bernardino,071,2135413,561153,559935,24580,584515,6778
2022-03-17,San Diego,073,3302833,750611,747344,51346,798690,5133
2022-03-17,San Francisco,075,870044,123779,123587,8335,131922,833
2022-03-17,San Joaquin,077,732212,166082,165765,9162,174927,2181
2022-03-17,San Luis Obispo,079,281455,52349,52174,3761,55935,463
2022-03-17,San Mateo,081,765935,120109,119782,7012,126794,667
2022-03-17,Santa Barbara,083,443738,85383,85336,4828,90164,671
2022-03-17,Santa Clara,085,1922200,310564,309918,12386,322304,2225
2022-03-17,Santa Cruz,087,273765,47153,47203,2065,49268,256
2022-03-17,Shasta,089,179085,30514,30495,6171,36666,525
2022-03-17,Sierra,091,2930,272,273,42,315,4
2022-03-17,Siskiyou,093,43540,4430,4422,2754,7176,76
2022-03-17,Solano,095,438530,81485,81340,5524,86864,441
2022-03-17,Sonoma,097,501317,82947,82838,2506,85344,472
2022-03-17,Stanislaus,099,539301,117225,118138,17103,135241,1568
2022-03-17,Sutter,101,95872,20514,20503,2052,22555,218
2022-03-17,Tehama,103,63373,12028,12007,2603,14610,160
2022-03-17,Trinity,105,12862,1176,1173,292,1465,20
2022-03-17,Tulare,107,460477,105117,104290,28350,132640,1384
2022-03-17,Tuolumne,109,53932,12599,12617,566,13183,180
2022-03-17,Ventura,111,848112,172587,172380,9255,181635,1451
2022-03-17,Yolo,113,214977,36377,36086,3187,39273,306
2022-03-17,Yuba,115,75493,15794,15768,1194,16962,117
2022-03-16,Alameda,001,1643700,254402,253792,13756,267548,1794
2022-03-16,Alpine,003,1148,122,122,1,123,0
2022-03-16,Amador,005,37829,8496,8449,644,9093,85
2022-03-16,Butte,007,227075,32873,32837,6625,39462,385
2022-03-16,Calaveras,009,45235,7233,7229,353,7582,120
2022-03-16,Colusa,011,21464,3440,3445,1078,4523,22
2022-03-16,Contra Costa,013,1133247,187861,187100,13175,200275,1266
2022-03-16,Del Norte,015,27424,5780,5811,193,6004,48
2022-03-16,El Dorado,017,186661,26623,26602,3205,29807,199
2022-03-16,Fresno,019,978130,230405,228786,22624,251410,2689
2022-03-16,Glenn,021,27897,4973,4969,1568,6537,44
2022-03-16,Humboldt,023,135768,16847,16893,2954,19847,138
2022-03-16,Imperial,025,180216,55131,55002,11083,66085,897
2022-03-16,Inyo,027,18085,4058,4061,482,4543,56
2022-03-16,Kern,029,883053,191168,190835,46241,237076,2170
2022-03-16,Kings,031,150075,51374,51321,3611,54932,437
2022-03-16,Lake,033,64148,10659,10633,892,11525,133
2022-03-16,Lassen,035,31185,8932,8924,894,9818,62
2022-03-16,Los Angeles,037,10098052,2697404,2685789,123060,2808849,31102
2022-03-16,Madera,039,155013,37299,37262,6044,43306,354
2022-03-16,Marin,041,260295,33227,33136,2201,35337,272
2022-03-16,Mariposa,043,17540,2382,2376,200,2576,6
2022-03-16,Mendocino,045,87422,13009,13011,2970,15981,117
2022-03-16,Merced,047,269075,62077,61959,8487,70446,798
2022-03-16,Modoc,049,8938,735,734,251,985,7
2022-03-16,Mono,051,14174,2963,2960,121,3081,5
2022-03-16,Monterey,053,433212,78841,78416,13658,92074,720
2022-03-16,Napa,055,140530,25676,25638,962,26600,138
2022-03-16,Nevada,057,99092,15903,15960,1208,17168,123
2022-03-16,Orange,059,3164182,544713,543326,41164,584490,6791
2022-03-16,Placer,061,380077,62545,62435,7343,69778,605
2022-03-16,Plumas,063,18699,2880,2723,358,3081,13
2022-03-16,Riverside,065,2383286,589785,588761,28082,616843,6351
2022-03-16,Sacramento,067,1510023,275964,274709,26797,301506,2910
2022-03-16,San Benito,069,59416,12877,12854,517,13371,97
2022-03-16,San Bernardino,071,2135413,561073,559746,24574,584320,6775
2022-03-16,San Diego,073,3302833,750398,746970,51324,798294,5126
2022-03-16,San Francisco,075,870044,123679,123446,8326,131772,831
2022-03-16,San Joaquin,077,732212,166035,165703,9159,174862,2169
2022-03-16,San Luis Obispo,079,281455,52331,52132,3758,55890,462
2022-03-16,San Mateo,081,765935,120049,119680,7003,126683,660
2022-03-16,Santa Barbara,083,443738,85350,85322,4823,90145,670
2022-03-16,Santa Clara,085,1922200,310379,309689,12372,322061,2224
2022-03-16,Santa Cruz,087,273765,47124,47161,2065,49226,255
2022-03-16,Shasta,089,179085,30505,30489,6167,36656,527
2022-03-16,Sierra,091,2930,272,273,42,315,4
2022-03-16,Siskiyou,093,43540,4427,4419,2752,7171,76
2022-03-16,Solano,095,438530,81462,81277,5522,86799,440
2022-03-16,Sonoma,097,501317,82902,82791,2501,85292,472
2022-03-16,Stanislaus,099,539301,117199,118072,17101,135173,1567
2022-03-16,Sutter,101,95872,20512,20494,2051,22545,218
2022-03-16,Tehama,103,63373,12026,11999,2603,14602,160
2022-03-16,Trinity,105,12862,1176,1173,292,1465,20
2022-03-16,Tulare,107,460477,105103,104217,28342,132559,1377
2022-03-16,Tuolumne,109,53932,12594,12610,566,13176,180
2022-03-16,Ventura,111,848112,172547,172212,9251,181463,1451
2022-03-16,Yolo,113,214977,36355,36079,3186,39265,307
2022-03-16,Yuba,115,75493,15789,15758,1194,16952,117
2022-03-15,Alameda,001,1643700,254274,253694,13746,267440,1793
2022-03-15,Alpine,003,1148,122,122,1,123,0
2022-03-15,Amador,005,37829,8493,8448,644,9092,85
2022-03-15,Butte,007,227075,32860,32822,6623,39445,385
2022-03-15,Calaveras,009,45235,7231,7236,353,7589,118
2022-03-15,Colusa,011,21464,3440,3445,1078,4523,21
2022-03-15,Contra Costa,013,1133247,187782,187021,13166,200187,1265
2022-03-15,Del Norte,015,27424,5777,5806,190,5996,48
2022-03-15,El Dorado,017,186661,26620,26596,3205,29801,199
2022-03-15,Fresno,019,978130,230362,228631,22614,251245,2689
2022-03-15,Glenn,021,27897,4971,4966,1568,6534,44
2022-03-15,Humboldt,023,135768,16841,16889,2953,19842,138
2022-03-15,Imperial,025,180216,55122,54981,11073,66054,896
2022-03-15,Inyo,027,18085,4058,4062,481,4543,56
2022-03-15,Kern,029,883053,191140,190645,46233,236878,2168
2022-03-15,Kings,031,150075,51354,51317,3607,54924,437
2022-03-15,Lake,033,64148,10655,10631,892,11523,131
2022-03-15,Lassen,035,31185,8930,8926,893,9819,62
2022-03-15,Los Angeles,037,10098052,2696742,2685071,123002,2808073,31077
2022-03-15,Madera,039,155013,37289,37258,6043,43301,354
2022-03-15,Marin,041,260295,33203,33111,2200,35311,272
2022-03-15,Mariposa,043,17540,2380,2377,200,2577,6
2022-03-15,Mendocino,045,87422,13004,13005,2969,15974,117
2022-03-15,Merced,047,269075,62058,61916,8477,70393,798
2022-03-15,Modoc,049,8938,735,733,251,984,7
2022-03-15,Mono,051,14174,2963,2961,121,3082,5
2022-03-15,Monterey,053,433212,78809,78400,13651,92051,718
2022-03-15,Napa,055,140530,25668,25657,960,26617,138
2022-03-15,Nevada,057,99092,15901,15960,1206,17166,123
2022-03-15,Orange,059,3164182,544572,543197,41157,584354,6780
2022-03-15,Placer,061,380077,62527,62398,7342,69740,604
2022-03-15,Plumas,063,18699,2880,2722,358,3080,13
2022-03-15,Riverside,065,2383286,589685,588622,28073,616695,6333
2022-03-15,Sacramento,067,1510023,275882,274633,26790,301423,2907
2022-03-15,San Benito,069,59416,12873,12849,517,13366,95
2022-03-15,San Bernardino,071,2135413,561000,559605,24569,584174,6770
2022-03-15,San Diego,073,3302833,750156,746474,51303,797777,5116
2022-03-15,San Francisco,075,870044,123565,123526,8317,131843,831
2022-03-15,San Joaquin,077,732212,165992,165664,9153,174817,2161
2022-03-15,San Luis Obispo,079,281455,52321,52060,3754,55814,458
2022-03-15,San Mateo,081,765935,119999,119586,6997,126583,649
2022-03-15,Santa Barbara,083,443738,85325,85353,4818,90171,668
2022-03-15,Santa Clara,085,1922200,310214,309535,12359,321894,2224
2022-03-15,Santa Cruz,087,273765,47070,47117,2065,49182,255
2022-03-15,Shasta,089,179085,30496,30476,6165,36641,524
2022-03-15,Sierra,091,2930,272,273,42,315,4
2022-03-15,Siskiyou,093,43540,4427,4420,2752,7172,76
2022-03-15,Solano,095,438530,81426,81260,5521,86781,440
2022-03-15,Sonoma,097,501317,82858,82737,2501,85238,472
2022-03-15,Stanislaus,099,539301,117180,118085,17097,135182,1567
2022-03-15,Sutter,101,95872,20509,20480,2041,22521,217
2022-03-15,Tehama,103,63373,12023,11997,2602,14599,160
2022-03-15,Trinity,105,12862,1176,1173,292,1465,20
2022-03-15,Tulare,107,460477,105083,104153,28328,132481,1375
2022-03-15,Tuolumne,109,53932,12590,12602,566,13168,180
2022-03-15,Ventura,111,848112,172502,172150,9247,181397,1451
2022-03-15,Yolo,113,214977,36342,36079,3180,39259,308
2022-03-15,Yuba,115,75493,15780,15756,1194,16950,116
2022-03-14,Alameda,001,1643700,254164,253629,13740,267369,1791
2022-03-14,Alpine,003,1148,122,122,1,123,0
2022-03-14,Amador,005,37829,8488,8448,644,9092,85
2022-03-14,Butte,007,227075,32842,32812,6622,39434,385
2022-03-14,Calaveras,009,45235,7230,7245,353,7598,118
2022-03-14,Colusa,011,21464,3439,3445,1078,4523,21
2022-03-14,Contra Costa,013,1133247,187691,186969,13157,200126,1265
2022-03-14,Del Norte,015,27424,5772,5807,190,5997,48
2022-03-14,El Dorado,017,186661,26615,26570,3205,29775,199
2022-03-14,Fresno,019,978130,230288,228470,22605,251075,2682
2022-03-14,Glenn,021,27897,4969,4966,1567,6533,44
2022-03-14,Humboldt,023,135768,16834,16890,2951,19841,137
2022-03-14,Imperial,025,180216,55110,54933,11068,66001,897
2022-03-14,Inyo,027,18085,4058,4062,481,4543,56
2022-03-14,Kern,029,883053,191109,190526,46222,236748,2166
2022-03-14,Kings,031,150075,51336,51293,3606,54899,437
2022-03-14,Lake,033,64148,10652,10631,892,11523,131
2022-03-14,Lassen,035,31185,8930,8927,892,9819,62
2022-03-14,Los Angeles,037,10098052,2696134,2683369,122934,2806303,31034
2022-03-14,Madera,039,155013,37284,37255,6042,43297,354
2022-03-14,Marin,041,260295,33174,33099,2200,35299,272
2022-03-14,Mariposa,043,17540,2379,2376,200,2576,6
2022-03-14,Mendocino,045,87422,12997,12992,2960,15952,117
2022-03-14,Merced,047,269075,62041,61905,8475,70380,795
2022-03-14,Modoc,049,8938,734,731,251,982,7
2022-03-14,Mono,051,14174,2962,2961,121,3082,5
2022-03-14,Monterey,053,433212,78795,78376,13612,91988,718
2022-03-14,Napa,055,140530,25652,25649,960,26609,138
2022-03-14,Nevada,057,99092,15899,15954,1206,17160,123
2022-03-14,Orange,059,3164182,544436,543099,41148,584247,6775
2022-03-14,Placer,061,380077,62509,62389,7340,69729,601
2022-03-14,Plumas,063,18699,2880,2711,358,3069,13
2022-03-14,Riverside,065,2383286,589549,588531,28063,616594,6332
2022-03-14,Sacramento,067,1510023,275804,274682,26785,301467,2899
2022-03-14,San Benito,069,59416,12868,12846,516,13362,95
2022-03-14,San Bernardino,071,2135413,560918,559505,24563,584068,6767
2022-03-14,San Diego,073,3302833,749848,745515,51277,796792,5108
2022-03-14,San Francisco,075,870044,123475,123575,8311,131886,824
2022-03-14,San Joaquin,077,732212,165953,165662,9152,174814,2142
2022-03-14,San Luis Obispo,079,281455,52294,52046,3751,55797,458
2022-03-14,San Mateo,081,765935,119925,119564,6994,126558,649
2022-03-14,Santa Barbara,083,443738,85288,85396,4817,90213,667
2022-03-14,Santa Clara,085,1922200,310025,309600,12356,321956,2223
2022-03-14,Santa Cruz,087,273765,47031,47107,2062,49169,255
2022-03-14,Shasta,089,179085,30491,30462,6162,36624,520
2022-03-14,Sierra,091,2930,272,273,42,315,4
2022-03-14,Siskiyou,093,43540,4421,4419,2751,7170,76
2022-03-14,Solano,095,438530,81378,81233,5516,86749,440
2022-03-14,Sonoma,097,501317,82826,82731,2499,85230,473
2022-03-14,Stanislaus,099,539301,117143,118088,17094,135182,1567
2022-03-14,Sutter,101,95872,20502,20478,2041,22519,217
2022-03-14,Tehama,103,63373,12021,11996,2602,14598,160
2022-03-14,Trinity,105,12862,1176,1172,292,1464,20
2022-03-14,Tulare,107,460477,105051,104121,28315,132436,1365
2022-03-14,Tuolumne,109,53932,12589,12567,565,13132,180
2022-03-14,Ventura,111,848112,172451,172107,9245,181352,1442
2022-03-14,Yolo,113,214977,36327,36059,3178,39237,308
2022-03-14,Yuba,115,75493,15769,15748,1194,16942,116
2022-03-13,Alameda,001,1643700,254044,253547,13731,267278,1792
2022-03-13,Alpine,003,1148,122,122,1,123,0
2022-03-13,Amador,005,37829,8486,8444,644,9088,85
2022-03-13,Butte,007,227075,32823,32806,6618,39424,384
2022-03-13,Calaveras,009,45235,7225,7253,353,7606,118
2022-03-13,Colusa,011,21464,3439,3444,1076,4520,21
2022-03-13,Contra Costa,013,1133247,187599,186911,13141,200052,1265
2022-03-13,Del Norte,015,27424,5767,5808,190,5998,48
2022-03-13,El Dorado,017,186661,26610,26563,3203,29766,199
2022-03-13,Fresno,019,978130,230209,228421,22592,251013,2683
2022-03-13,Glenn,021,27897,4965,4966,1566,6532,44
2022-03-13,Humboldt,023,135768,16826,16883,2951,19834,137
2022-03-13,Imperial,025,180216,55100,54934,11062,65996,897
2022-03-13,Inyo,027,18085,4058,4062,480,4542,56
2022-03-13,Kern,029,883053,191056,190495,46207,236702,2166
2022-03-13,Kings,031,150075,51328,51273,3605,54878,437
2022-03-13,Lake,033,64148,10649,10626,892,11518,131
2022-03-13,Lassen,035,31185,8929,8929,891,9820,62
2022-03-13,Los Angeles,037,10098052,2695421,2683351,122892,2806243,31034
2022-03-13,Madera,039,155013,37276,37248,6042,43290,354
2022-03-13,Marin,041,260295,33149,33083,2199,35282,272
2022-03-13,Mariposa,043,17540,2377,2376,200,2576,6
2022-03-13,Mendocino,045,87422,12991,12987,2955,15942,117
2022-03-13,Merced,047,269075,62017,61895,8463,70358,795
2022-03-13,Modoc,049,8938,734,731,251,982,7
2022-03-13,Mono,051,14174,2962,2961,121,3082,5
2022-03-13,Monterey,053,433212,78761,78366,13560,91926,718
2022-03-13,Napa,055,140530,25637,25639,959,26598,138
2022-03-13,Nevada,057,99092,15892,15959,1206,17165,123
2022-03-13,Orange,059,3164182,544317,543036,41122,584158,6774
2022-03-13,Placer,061,380077,62482,62372,7337,69709,601
2022-03-13,Plumas,063,18699,2880,2711,358,3069,13
2022-03-13,Riverside,065,2383286,589417,588487,28056,616543,6332
2022-03-13,Sacramento,067,1510023,275701,274715,26773,301488,2899
2022-03-13,San Benito,069,59416,12862,12844,514,13358,95
2022-03-13,San Bernardino,071,2135413,560824,559450,24554,584004,6767
2022-03-13,San Diego,073,3302833,749521,745515,51242,796757,5108
2022-03-13,San Francisco,075,870044,123354,123622,8305,131927,824
2022-03-13,San Joaquin,077,732212,165904,165641,9149,174790,2142
2022-03-13,San Luis Obispo,079,281455,52264,52040,3748,55788,458
2022-03-13,San Mateo,081,765935,119847,119521,6984,126505,649
2022-03-13,Santa Barbara,083,443738,85246,85453,4815,90268,667
2022-03-13,Santa Clara,085,1922200,309854,309493,12347,321840,2225
2022-03-13,Santa Cruz,087,273765,46980,47087,2061,49148,255
2022-03-13,Shasta,089,179085,30473,30457,6159,36616,520
2022-03-13,Sierra,091,2930,272,273,42,315,4
2022-03-13,Siskiyou,093,43540,4421,4418,2751,7169,76
2022-03-13,Solano,095,438530,81342,81217,5512,86729,440
2022-03-13,Sonoma,097,501317,82790,82711,2497,85208,473
2022-03-13,Stanislaus,099,539301,117111,118075,17091,135166,1567
2022-03-13,Sutter,101,95872,20499,20474,2040,22514,217
2022-03-13,Tehama,103,63373,12020,11997,2601,14598,160
2022-03-13,Trinity,105,12862,1176,1172,292,1464,20
2022-03-13,Tulare,107,460477,105013,104119,28302,132421,1365
2022-03-13,Tuolumne,109,53932,12586,12565,565,13130,180
2022-03-13,Ventura,111,848112,172394,172080,9240,181320,1442
2022-03-13,Yolo,113,214977,36311,36019,3174,39193,308
2022-03-13,Yuba,115,75493,15764,15741,1194,16935,116
2022-03-12,Alameda,001,1643700,253981,253079,13726,266805,1783
2022-03-12,Alpine,003,1148,122,122,1,123,0
2022-03-12,Amador,005,37829,8482,8427,644,9071,84
2022-03-12,Butte,007,227075,32819,32774,6616,39390,380
2022-03-12,Calaveras,009,45235,7224,7253,353,7606,118
2022-03-12,Colusa,011,21464,3439,3440,1076,4516,21
2022-03-12,Contra Costa,013,1133247,187557,186618,13140,199758,1256
2022-03-12,Del Norte,015,27424,5766,5791,190,5981,48
2022-03-12,El Dorado,017,186661,26606,26538,3203,29741,199
2022-03-12,Fresno,019,978130,230185,228041,22592,250633,2653
2022-03-12,Glenn,021,27897,4965,4955,1566,6521,44
2022-03-12,Humboldt,023,135768,16823,16862,2950,19812,137
2022-03-12,Imperial,025,180216,55096,54837,11058,65895,896
2022-03-12,Inyo,027,18085,4058,4056,480,4536,56
2022-03-12,Kern,029,883053,191040,190330,46201,236531,2162
2022-03-12,Kings,031,150075,51322,51145,3605,54750,436
2022-03-12,Lake,033,64148,10646,10594,891,11485,131
2022-03-12,Lassen,035,31185,8928,8915,891,9806,62
2022-03-12,Los Angeles,037,10098052,2695104,2678858,122872,2801730,30901
2022-03-12,Madera,039,155013,37272,37223,6042,43265,354
2022-03-12,Marin,041,260295,33124,33015,2198,35213,272
2022-03-12,Mariposa,043,17540,2377,2372,200,2572,6
2022-03-12,Mendocino,045,87422,12987,12965,2955,15920,117
2022-03-12,Merced,047,269075,62012,61840,8462,70302,795
2022-03-12,Modoc,049,8938,734,730,251,981,7
2022-03-12,Mono,051,14174,2962,2960,120,3080,5
2022-03-12,Monterey,053,433212,78753,78285,13558,91843,716
2022-03-12,Napa,055,140530,25627,25584,958,26542,138
2022-03-12,Nevada,057,99092,15885,15947,1206,17153,123
2022-03-12,Orange,059,3164182,544250,542354,41112,583466,6718
2022-03-12,Placer,061,380077,62473,62282,7337,69619,598
2022-03-12,Plumas,063,18699,2880,2707,358,3065,13
2022-03-12,Riverside,065,2383286,589354,588022,28051,616073,6317
2022-03-12,Sacramento,067,1510023,275660,274519,26769,301288,2886
2022-03-12,San Benito,069,59416,12859,12868,514,13382,95
2022-03-12,San Bernardino,071,2135413,560784,559013,24553,583566,6734
2022-03-12,San Diego,073,3302833,749395,744386,51220,795606,5090
2022-03-12,San Francisco,075,870044,123290,123610,8300,131910,823
2022-03-12,San Joaquin,077,732212,165888,165516,9146,174662,2117
2022-03-12,San Luis Obispo,079,281455,52255,51947,3745,55692,457
2022-03-12,San Mateo,081,765935,119810,119288,6983,126271,641
2022-03-12,Santa Barbara,083,443738,85228,85421,4815,90236,664
2022-03-12,Santa Clara,085,1922200,309760,308989,12341,321330,2208
2022-03-12,Santa Cruz,087,273765,46967,46982,2060,49042,254
2022-03-12,Shasta,089,179085,30461,30419,6157,36576,517
2022-03-12,Sierra,091,2930,272,273,42,315,4
2022-03-12,Siskiyou,093,43540,4421,4405,2751,7156,75
2022-03-12,Solano,095,438530,81328,81058,5512,86570,436
2022-03-12,Sonoma,097,501317,82773,82622,2495,85117,473
2022-03-12,Stanislaus,099,539301,117098,117884,17090,134974,1564
2022-03-12,Sutter,101,95872,20497,20429,2040,22469,217
2022-03-12,Tehama,103,63373,12020,11983,2601,14584,159
2022-03-12,Trinity,105,12862,1175,1172,292,1464,20
2022-03-12,Tulare,107,460477,105007,103994,28297,132291,1358
2022-03-12,Tuolumne,109,53932,12585,12476,565,13041,180
2022-03-12,Ventura,111,848112,172369,171932,9237,181169,1442
2022-03-12,Yolo,113,214977,36304,35982,3172,39154,308
2022-03-12,Yuba,115,75493,15764,15722,1194,16916,116
2022-03-11,Alameda,001,1643700,253916,253079,13726,266805,1783
2022-03-11,Alpine,003,1148,122,122,1,123,0
2022-03-11,Amador,005,37829,8480,8427,644,9071,84
2022-03-11,Butte,007,227075,32815,32774,6615,39389,380
2022-03-11,Calaveras,009,45235,7224,7253,353,7606,118
2022-03-11,Colusa,011,21464,3439,3440,1076,4516,21
2022-03-11,Contra Costa,013,1133247,187510,186618,13139,199757,1256
2022-03-11,Del Norte,015,27424,5762,5791,190,5981,48
2022-03-11,El Dorado,017,186661,26601,26538,3203,29741,199
2022-03-11,Fresno,019,978130,230129,228041,22589,250630,2653
2022-03-11,Glenn,021,27897,4965,4955,1566,6521,44
2022-03-11,Humboldt,023,135768,16818,16862,2948,19810,137
2022-03-11,Imperial,025,180216,55089,54837,11057,65894,896
2022-03-11,Inyo,027,18085,4058,4056,480,4536,56
2022-03-11,Kern,029,883053,191019,190330,46196,236526,2162
2022-03-11,Kings,031,150075,51302,51145,3605,54750,436
2022-03-11,Lake,033,64148,10642,10594,891,11485,131
2022-03-11,Lassen,035,31185,8927,8915,891,9806,62
2022-03-11,Los Angeles,037,10098052,2694788,2678858,122847,2801705,30901
2022-03-11,Madera,039,155013,37267,37223,6042,43265,354
2022-03-11,Marin,041,260295,33108,33015,2197,35212,272
2022-03-11,Mariposa,043,17540,2377,2372,200,2572,6
2022-03-11,Mendocino,045,87422,12981,12965,2955,15920,117
2022-03-11,Merced,047,269075,62001,61840,8460,70300,795
2022-03-11,Modoc,049,8938,734,730,251,981,7
2022-03-11,Mono,051,14174,2961,2960,120,3080,5
2022-03-11,Monterey,053,433212,78740,78285,13552,91837,716
2022-03-11,Napa,055,140530,25617,25584,958,26542,138
2022-03-11,Nevada,057,99092,15882,15947,1206,17153,123
2022-03-11,Orange,059,3164182,544177,542354,41097,583451,6718
2022-03-11,Placer,061,380077,62462,62282,7336,69618,598
2022-03-11,Plumas,063,18699,2878,2707,358,3065,13
2022-03-11,Riverside,065,2383286,589283,588022,28047,616069,6317
2022-03-11,Sacramento,067,1510023,275594,274519,26766,301285,2886
2022-03-11,San Benito,069,59416,12858,12868,514,13382,95
2022-03-11,San Bernardino,071,2135413,560728,559013,24547,583560,6734
2022-03-11,San Diego,073,3302833,749229,744386,51208,795594,5090
2022-03-11,San Francisco,075,870044,123240,123610,8296,131906,823
2022-03-11,San Joaquin,077,732212,165856,165516,9143,174659,2117
2022-03-11,San Luis Obispo,079,281455,52247,51947,3744,55691,457
2022-03-11,San Mateo,081,765935,119762,119288,6980,126268,641
2022-03-11,Santa Barbara,083,443738,85208,85421,4814,90235,664
2022-03-11,Santa Clara,085,1922200,309656,308989,12336,321325,2208
2022-03-11,Santa Cruz,087,273765,46952,46982,2060,49042,254
2022-03-11,Shasta,089,179085,30456,30419,6154,36573,517
2022-03-11,Sierra,091,2930,272,273,42,315,4
2022-03-11,Siskiyou,093,43540,4419,4405,2749,7154,75
2022-03-11,Solano,095,438530,81314,81058,5511,86569,436
2022-03-11,Sonoma,097,501317,82748,82622,2493,85115,473
2022-03-11,Stanislaus,099,539301,117084,117884,17089,134973,1564
2022-03-11,Sutter,101,95872,20495,20429,2040,22469,217
2022-03-11,Tehama,103,63373,12018,11983,2601,14584,159
2022-03-11,Trinity,105,12862,1175,1172,292,1464,20
2022-03-11,Tulare,107,460477,104994,103994,28291,132285,1358
2022-03-11,Tuolumne,109,53932,12583,12476,565,13041,180
2022-03-11,Ventura,111,848112,172333,171932,9232,181164,1442
2022-03-11,Yolo,113,214977,36291,35982,3172,39154,308
2022-03-11,Yuba,115,75493,15761,15722,1194,16916,116
2022-03-10,Alameda,001,1643700,253806,253079,13719,266798,1783
2022-03-10,Alpine,003,1148,122,122,1,123,0
2022-03-10,Amador,005,37829,8479,8427,644,9071,84
2022-03-10,Butte,007,227075,32801,32774,6613,39387,380
2022-03-10,Calaveras,009,45235,7223,7253,352,7605,118
2022-03-10,Colusa,011,21464,3439,3440,1076,4516,21
2022-03-10,Contra Costa,013,1133247,187425,186618,13130,199748,1256
2022-03-10,Del Norte,015,27424,5753,5791,190,5981,48
2022-03-10,El Dorado,017,186661,26589,26538,3202,29740,199
2022-03-10,Fresno,019,978130,230054,228041,22580,250621,2653
2022-03-10,Glenn,021,27897,4963,4955,1566,6521,44
2022-03-10,Humboldt,023,135768,16808,16862,2947,19809,137
2022-03-10,Imperial,025,180216,55079,54837,11050,65887,896
2022-03-10,Inyo,027,18085,4057,4056,480,4536,56
2022-03-10,Kern,029,883053,190985,190330,46182,236512,2162
2022-03-10,Kings,031,150075,51273,51145,3604,54749,436
2022-03-10,Lake,033,64148,10632,10594,890,11484,131
2022-03-10,Lassen,035,31185,8927,8915,891,9806,62
2022-03-10,Los Angeles,037,10098052,2694242,2678858,122809,2801667,30901
2022-03-10,Madera,039,155013,37260,37223,6035,43258,354
2022-03-10,Marin,041,260295,33094,33015,2193,35208,272
2022-03-10,Mariposa,043,17540,2377,2372,200,2572,6
2022-03-10,Mendocino,045,87422,12977,12965,2955,15920,117
2022-03-10,Merced,047,269075,61984,61840,8454,70294,795
2022-03-10,Modoc,049,8938,733,730,251,981,7
2022-03-10,Mono,051,14174,2961,2960,120,3080,5
2022-03-10,Monterey,053,433212,78717,78285,13525,91810,716
2022-03-10,Napa,055,140530,25608,25584,957,26541,138
2022-03-10,Nevada,057,99092,15875,15947,1206,17153,123
2022-03-10,Orange,059,3164182,544058,542354,41080,583434,6718
2022-03-10,Placer,061,380077,62441,62282,7331,69613,598
2022-03-10,Plumas,063,18699,2877,2707,358,3065,13
2022-03-10,Riverside,065,2383286,589165,588022,28040,616062,6317
2022-03-10,Sacramento,067,1510023,275515,274519,26760,301279,2886
2022-03-10,San Benito,069,59416,12857,12868,513,13381,95
2022-03-10,San Bernardino,071,2135413,560657,559013,24539,583552,6734
2022-03-10,San Diego,073,3302833,748963,744386,51175,795561,5090
2022-03-10,San Francisco,075,870044,123173,123610,8289,131899,823
2022-03-10,San Joaquin,077,732212,165828,165516,9141,174657,2117
2022-03-10,San Luis Obispo,079,281455,52224,51947,3741,55688,457
2022-03-10,San Mateo,081,765935,119697,119288,6977,126265,641
2022-03-10,Santa Barbara,083,443738,85176,85421,4813,90234,664
2022-03-10,Santa Clara,085,1922200,309526,308989,12326,321315,2208
2022-03-10,Santa Cruz,087,273765,46919,46982,2060,49042,254
2022-03-10,Shasta,089,179085,30450,30419,6152,36571,517
2022-03-10,Sierra,091,2930,272,273,42,315,4
2022-03-10,Siskiyou,093,43540,4419,4405,2749,7154,75
2022-03-10,Solano,095,438530,81276,81058,5510,86568,436
2022-03-10,Sonoma,097,501317,82721,82622,2493,85115,473
2022-03-10,Stanislaus,099,539301,117044,117884,17087,134971,1564
2022-03-10,Sutter,101,95872,20490,20429,2040,22469,217
2022-03-10,Tehama,103,63373,12017,11983,2601,14584,159
2022-03-10,Trinity,105,12862,1175,1172,292,1464,20
2022-03-10,Tulare,107,460477,104973,103994,28285,132279,1358
2022-03-10,Tuolumne,109,53932,12580,12476,565,13041,180
2022-03-10,Ventura,111,848112,172293,171932,9229,181161,1442
2022-03-10,Yolo,113,214977,36277,35982,3171,39153,308
2022-03-10,Yuba,115,75493,15751,15722,1193,16915,116
2022-03-09,Alameda,001,1643700,253683,252893,13712,266605,1781
2022-03-09,Alpine,003,1148,122,125,1,126,0
2022-03-09,Amador,005,37829,8473,8409,644,9053,84
2022-03-09,Butte,007,227075,32792,32767,6608,39375,380
2022-03-09,Calaveras,009,45235,7221,7249,352,7601,117
2022-03-09,Colusa,011,21464,3438,3439,1076,4515,21
2022-03-09,Contra Costa,013,1133247,187333,186483,13116,199599,1256
2022-03-09,Del Norte,015,27424,5749,5765,190,5955,48
2022-03-09,El Dorado,017,186661,26584,26515,3202,29717,198
2022-03-09,Fresno,019,978130,229955,227885,22571,250456,2653
2022-03-09,Glenn,021,27897,4961,4953,1565,6518,44
2022-03-09,Humboldt,023,135768,16803,16854,2944,19798,137
2022-03-09,Imperial,025,180216,55073,54764,11041,65805,894
2022-03-09,Inyo,027,18085,4057,4056,480,4536,56
2022-03-09,Kern,029,883053,190934,190254,46169,236423,2159
2022-03-09,Kings,031,150075,51253,51122,3604,54726,435
2022-03-09,Lake,033,64148,10626,10586,890,11476,130
2022-03-09,Lassen,035,31185,8927,8901,891,9792,62
2022-03-09,Los Angeles,037,10098052,2693600,2677901,122772,2800673,30842
2022-03-09,Madera,039,155013,37253,37207,6034,43241,354
2022-03-09,Marin,041,260295,33075,32967,2192,35159,272
2022-03-09,Mariposa,043,17540,2374,2372,200,2572,6
2022-03-09,Mendocino,045,87422,12973,12957,2950,15907,117
2022-03-09,Merced,047,269075,61967,61792,8448,70240,792
2022-03-09,Modoc,049,8938,732,730,250,980,7
2022-03-09,Mono,051,14174,2961,2962,120,3082,5
2022-03-09,Monterey,053,433212,78693,78258,13476,91734,716
2022-03-09,Napa,055,140530,25587,25561,956,26517,138
2022-03-09,Nevada,057,99092,15866,15938,1205,17143,123
2022-03-09,Orange,059,3164182,543928,542278,41065,583343,6700
2022-03-09,Placer,061,380077,62418,62242,7326,69568,598
2022-03-09,Plumas,063,18699,2876,2708,358,3066,13
2022-03-09,Riverside,065,2383286,589068,587833,28030,615863,6305
2022-03-09,Sacramento,067,1510023,275432,274373,26743,301116,2877
2022-03-09,San Benito,069,59416,12854,12864,513,13377,95
2022-03-09,San Bernardino,071,2135413,560566,558795,24527,583322,6723
2022-03-09,San Diego,073,3302833,748685,743956,51147,795103,5083
2022-03-09,San Francisco,075,870044,123085,123676,8284,131960,812
2022-03-09,San Joaquin,077,732212,165789,165444,9134,174578,2113
2022-03-09,San Luis Obispo,079,281455,52205,51923,3738,55661,457
2022-03-09,San Mateo,081,765935,119639,119194,6965,126159,639
2022-03-09,Santa Barbara,083,443738,85160,85382,4811,90193,661
2022-03-09,Santa Clara,085,1922200,309398,308765,12315,321080,2206
2022-03-09,Santa Cruz,087,273765,46879,46917,2059,48976,254
2022-03-09,Shasta,089,179085,30430,30407,6151,36558,493
2022-03-09,Sierra,091,2930,272,273,42,315,4
2022-03-09,Siskiyou,093,43540,4417,4403,2748,7151,75
2022-03-09,Solano,095,438530,81240,80984,5508,86492,436
2022-03-09,Sonoma,097,501317,82688,82574,2491,85065,473
2022-03-09,Stanislaus,099,539301,117006,117827,17082,134909,1541
2022-03-09,Sutter,101,95872,20478,20409,2036,22445,217
2022-03-09,Tehama,103,63373,12013,11980,2601,14581,159
2022-03-09,Trinity,105,12862,1175,1174,292,1466,20
2022-03-09,Tulare,107,460477,104943,103932,28269,132201,1350
2022-03-09,Tuolumne,109,53932,12578,12444,565,13009,180
2022-03-09,Ventura,111,848112,172244,171852,9226,181078,1448
2022-03-09,Yolo,113,214977,36257,35973,3155,39128,308
2022-03-09,Yuba,115,75493,15746,15714,1192,16906,115
2022-03-08,Alameda,001,1643700,253530,252744,13700,266444,1769
2022-03-08,Alpine,003,1148,122,125,1,126,0
2022-03-08,Amador,005,37829,8459,8407,644,9051,84
2022-03-08,Butte,007,227075,32778,32759,6602,39361,380
2022-03-08,Calaveras,009,45235,7217,7245,352,7597,117
2022-03-08,Colusa,011,21464,3435,3439,1075,4514,21
2022-03-08,Contra Costa,013,1133247,187243,186396,13103,199499,1256
2022-03-08,Del Norte,015,27424,5744,5763,190,5953,48
2022-03-08,El Dorado,017,186661,26574,26503,3196,29699,197
2022-03-08,Fresno,019,978130,229854,227808,22562,250370,2653
2022-03-08,Glenn,021,27897,4960,4944,1564,6508,43
2022-03-08,Humboldt,023,135768,16790,16837,2931,19768,137
2022-03-08,Imperial,025,180216,55056,54721,11033,65754,890
2022-03-08,Inyo,027,18085,4054,4056,480,4536,56
2022-03-08,Kern,029,883053,190872,190208,46154,236362,2154
2022-03-08,Kings,031,150075,51211,51089,3601,54690,434
2022-03-08,Lake,033,64148,10615,10571,890,11461,130
2022-03-08,Lassen,035,31185,8926,8897,891,9788,62
2022-03-08,Los Angeles,037,10098052,2692909,2677166,122734,2799900,30803
2022-03-08,Madera,039,155013,37241,37185,6033,43218,354
2022-03-08,Marin,041,260295,33035,32943,2191,35134,272
2022-03-08,Mariposa,043,17540,2372,2371,200,2571,6
2022-03-08,Mendocino,045,87422,12969,12950,2949,15899,117
2022-03-08,Merced,047,269075,61947,61767,8437,70204,791
2022-03-08,Modoc,049,8938,731,729,250,979,7
2022-03-08,Mono,051,14174,2960,2961,120,3081,5
2022-03-08,Monterey,053,433212,78673,78247,13436,91683,711
2022-03-08,Napa,055,140530,25562,25528,955,26483,137
2022-03-08,Nevada,057,99092,15856,15939,1204,17143,122
2022-03-08,Orange,059,3164182,543780,542164,41044,583208,6692
2022-03-08,Placer,061,380077,62390,62221,7325,69546,594
2022-03-08,Plumas,063,18699,2876,2703,358,3061,13
2022-03-08,Riverside,065,2383286,588959,587686,28021,615707,6294
2022-03-08,Sacramento,067,1510023,275338,274276,26722,300998,2872
2022-03-08,San Benito,069,59416,12851,12855,513,13368,94
2022-03-08,San Bernardino,071,2135413,560476,558512,24517,583029,6715
2022-03-08,San Diego,073,3302833,748328,743604,51131,794735,5077
2022-03-08,San Francisco,075,870044,122995,123675,8279,131954,807
2022-03-08,San Joaquin,077,732212,165754,165381,9132,174513,2104
2022-03-08,San Luis Obispo,079,281455,52179,51900,3735,55635,451
2022-03-08,San Mateo,081,765935,119556,119103,6955,126058,638
2022-03-08,Santa Barbara,083,443738,85128,85363,4811,90174,659
2022-03-08,Santa Clara,085,1922200,309188,308528,12305,320833,2206
2022-03-08,Santa Cruz,087,273765,46842,46875,2059,48934,254
2022-03-08,Shasta,089,179085,30411,30372,6148,36520,493
2022-03-08,Sierra,091,2930,272,273,42,315,4
2022-03-08,Siskiyou,093,43540,4413,4404,2748,7152,74
2022-03-08,Solano,095,438530,81210,80924,5504,86428,434
2022-03-08,Sonoma,097,501317,82638,82571,2490,85061,473
2022-03-08,Stanislaus,099,539301,116962,117782,17073,134855,1541
2022-03-08,Sutter,101,95872,20469,20403,2036,22439,217
2022-03-08,Tehama,103,63373,12009,11972,2600,14572,158
2022-03-08,Trinity,105,12862,1175,1174,292,1466,20
2022-03-08,Tulare,107,460477,104903,103893,28257,132150,1334
2022-03-08,Tuolumne,109,53932,12573,12427,563,12990,180
2022-03-08,Ventura,111,848112,172182,171806,9220,181026,1447
2022-03-08,Yolo,113,214977,36233,35946,3154,39100,306
2022-03-08,Yuba,115,75493,15739,15705,1191,16896,115
2022-03-07,Alameda,001,1643700,253331,252578,13682,266260,1766
2022-03-07,Alpine,003,1148,122,125,1,126,0
2022-03-07,Amador,005,37829,8456,8368,644,9012,84
2022-03-07,Butte,007,227075,32763,32734,6599,39333,378
2022-03-07,Calaveras,009,45235,7213,7242,352,7594,116
2022-03-07,Colusa,011,21464,3433,3437,1075,4512,21
2022-03-07,Contra Costa,013,1133247,187141,186087,13079,199166,1256
2022-03-07,Del Norte,015,27424,5740,5758,190,5948,48
2022-03-07,El Dorado,017,186661,26567,26487,3195,29682,196
2022-03-07,Fresno,019,978130,229765,227670,22540,250210,2653
2022-03-07,Glenn,021,27897,4954,4939,1564,6503,43
2022-03-07,Humboldt,023,135768,16777,16829,2926,19755,137
2022-03-07,Imperial,025,180216,55033,54712,11027,65739,890
2022-03-07,Inyo,027,18085,4052,4054,480,4534,56
2022-03-07,Kern,029,883053,190812,190163,46129,236292,2152
2022-03-07,Kings,031,150075,51181,51065,3595,54660,433
2022-03-07,Lake,033,64148,10605,10562,889,11451,130
2022-03-07,Lassen,035,31185,8925,8896,891,9787,62
2022-03-07,Los Angeles,037,10098052,2692100,2675497,122691,2798188,30759
2022-03-07,Madera,039,155013,37231,37164,6030,43194,354
2022-03-07,Marin,041,260295,32998,32919,2190,35109,272
2022-03-07,Mariposa,043,17540,2371,2369,200,2569,6
2022-03-07,Mendocino,045,87422,12961,12940,2948,15888,117
2022-03-07,Merced,047,269075,61907,61751,8430,70181,791
2022-03-07,Modoc,049,8938,731,729,250,979,7
2022-03-07,Mono,051,14174,2960,2960,120,3080,5
2022-03-07,Monterey,053,433212,78638,78161,13386,91547,706
2022-03-07,Napa,055,140530,25535,25500,955,26455,136
2022-03-07,Nevada,057,99092,15849,15935,1198,17133,122
2022-03-07,Orange,059,3164182,543607,542028,41016,583044,6687
2022-03-07,Placer,061,380077,62360,62215,7323,69538,591
2022-03-07,Plumas,063,18699,2876,2702,358,3060,13
2022-03-07,Riverside,065,2383286,588827,587537,28013,615550,6279
2022-03-07,Sacramento,067,1510023,275237,274079,26710,300789,2866
2022-03-07,San Benito,069,59416,12845,12843,513,13356,94
2022-03-07,San Bernardino,071,2135413,560370,558265,24505,582770,6703
2022-03-07,San Diego,073,3302833,747984,742287,51088,793375,5068
2022-03-07,San Francisco,075,870044,122893,123655,8273,131928,807
2022-03-07,San Joaquin,077,732212,165701,165343,9125,174468,2091
2022-03-07,San Luis Obispo,079,281455,52138,51874,3730,55604,448
2022-03-07,San Mateo,081,765935,119477,119035,6949,125984,630
2022-03-07,Santa Barbara,083,443738,85090,85345,4810,90155,659
2022-03-07,Santa Clara,085,1922200,308994,308517,12299,320816,2202
2022-03-07,Santa Cruz,087,273765,46790,46823,2058,48881,254
2022-03-07,Shasta,089,179085,30400,30352,6144,36496,493
2022-03-07,Sierra,091,2930,272,273,42,315,4
2022-03-07,Siskiyou,093,43540,4409,4398,2747,7145,74
2022-03-07,Solano,095,438530,81144,80886,5502,86388,435
2022-03-07,Sonoma,097,501317,82595,82530,2489,85019,473
2022-03-07,Stanislaus,099,539301,116925,117713,17065,134778,1537
2022-03-07,Sutter,101,95872,20458,20400,2035,22435,217
2022-03-07,Tehama,103,63373,12003,11966,2597,14563,158
2022-03-07,Trinity,105,12862,1173,1173,292,1465,20
2022-03-07,Tulare,107,460477,104864,103834,28245,132079,1316
2022-03-07,Tuolumne,109,53932,12565,12408,562,12970,179
2022-03-07,Ventura,111,848112,172132,171886,9218,181104,1436
2022-03-07,Yolo,113,214977,36209,35934,3149,39083,306
2022-03-07,Yuba,115,75493,15733,15701,1190,16891,115
2022-03-06,Alameda,001,1643700,253145,252460,13673,266133,1766
2022-03-06,Alpine,003,1148,122,125,1,126,0
2022-03-06,Amador,005,37829,8453,8367,642,9009,84
2022-03-06,Butte,007,227075,32754,32714,6595,39309,376
2022-03-06,Calaveras,009,45235,7211,7236,351,7587,116
2022-03-06,Colusa,011,21464,3433,3435,1074,4509,21
2022-03-06,Contra Costa,013,1133247,187020,185974,13055,199029,1256
2022-03-06,Del Norte,015,27424,5725,5744,188,5932,48
2022-03-06,El Dorado,017,186661,26558,26478,3193,29671,196
2022-03-06,Fresno,019,978130,229618,227514,22530,250044,2653
2022-03-06,Glenn,021,27897,4949,4939,1564,6503,43
2022-03-06,Humboldt,023,135768,16765,16813,2923,19736,137
2022-03-06,Imperial,025,180216,55017,54719,11011,65730,890
2022-03-06,Inyo,027,18085,4049,4053,480,4533,56
2022-03-06,Kern,029,883053,190756,190088,46106,236194,2152
2022-03-06,Kings,031,150075,51112,51050,3592,54642,432
2022-03-06,Lake,033,64148,10591,10539,888,11427,130
2022-03-06,Lassen,035,31185,8912,8887,890,9777,62
2022-03-06,Los Angeles,037,10098052,2691168,2675456,122640,2798096,30759
2022-03-06,Madera,039,155013,37202,37135,6022,43157,354
2022-03-06,Marin,041,260295,32972,32879,2189,35068,272
2022-03-06,Mariposa,043,17540,2370,2365,199,2564,6
2022-03-06,Mendocino,045,87422,12949,12923,2944,15867,116
2022-03-06,Merced,047,269075,61874,61722,8413,70135,791
2022-03-06,Modoc,049,8938,731,729,250,979,7
2022-03-06,Mono,051,14174,2960,2959,120,3079,5
2022-03-06,Monterey,053,433212,78591,78154,13354,91508,706
2022-03-06,Napa,055,140530,25500,25457,953,26410,136
2022-03-06,Nevada,057,99092,15838,15924,1197,17121,122
2022-03-06,Orange,059,3164182,543446,541903,40967,582870,6688
2022-03-06,Placer,061,380077,62329,62185,7319,69504,591
2022-03-06,Plumas,063,18699,2871,2704,358,3062,13
2022-03-06,Riverside,065,2383286,588665,587388,27991,615379,6279
2022-03-06,Sacramento,067,1510023,275101,273935,26687,300622,2869
2022-03-06,San Benito,069,59416,12834,12835,512,13347,94
2022-03-06,San Bernardino,071,2135413,560244,558139,24491,582630,6701
2022-03-06,San Diego,073,3302833,747590,742287,51038,793325,5068
2022-03-06,San Francisco,075,870044,122769,123742,8270,132012,806
2022-03-06,San Joaquin,077,732212,165616,165252,9119,174371,2091
2022-03-06,San Luis Obispo,079,281455,52100,51828,3727,55555,448
2022-03-06,San Mateo,081,765935,119397,118916,6940,125856,630
2022-03-06,Santa Barbara,083,443738,85049,85317,4805,90122,659
2022-03-06,Santa Clara,085,1922200,308736,308250,12296,320546,2201
2022-03-06,Santa Cruz,087,273765,46736,46755,2057,48812,254
2022-03-06,Shasta,089,179085,30375,30332,6127,36459,493
2022-03-06,Sierra,091,2930,272,273,42,315,4
2022-03-06,Siskiyou,093,43540,4405,4398,2745,7143,74
2022-03-06,Solano,095,438530,81085,80833,5496,86329,435
2022-03-06,Sonoma,097,501317,82556,82458,2485,84943,473
2022-03-06,Stanislaus,099,539301,116873,117680,17055,134735,1536
2022-03-06,Sutter,101,95872,20440,20390,2031,22421,217
2022-03-06,Tehama,103,63373,11995,11963,2597,14560,158
2022-03-06,Trinity,105,12862,1173,1172,291,1463,20
2022-03-06,Tulare,107,460477,104803,103794,28229,132023,1316
2022-03-06,Tuolumne,109,53932,12560,12379,560,12939,179
2022-03-06,Ventura,111,848112,172062,171819,9216,181035,1436
2022-03-06,Yolo,113,214977,36185,35882,3145,39027,306
2022-03-06,Yuba,115,75493,15728,15694,1189,16883,115
2022-03-05,Alameda,001,1643700,253030,251988,13667,265655,1760
2022-03-05,Alpine,003,1148,122,125,1,126,0
2022-03-05,Amador,005,37829,8450,8344,642,8986,83
2022-03-05,Butte,007,227075,32747,32663,6590,39253,372
2022-03-05,Calaveras,009,45235,7208,7236,351,7587,116
2022-03-05,Colusa,011,21464,3433,3433,1074,4507,21
2022-03-05,Contra Costa,013,1133247,186960,185734,13049,198783,1235
2022-03-05,Del Norte,015,27424,5722,5725,188,5913,48
2022-03-05,El Dorado,017,186661,26551,26446,3190,29636,193
2022-03-05,Fresno,019,978130,229566,227154,22528,249682,2640
2022-03-05,Glenn,021,27897,4948,4927,1564,6491,43
2022-03-05,Humboldt,023,135768,16758,16781,2921,19702,136
2022-03-05,Imperial,025,180216,55007,54650,11009,65659,880
2022-03-05,Inyo,027,18085,4048,4043,479,4522,56
2022-03-05,Kern,029,883053,190724,189817,46088,235905,2141
2022-03-05,Kings,031,150075,51105,50926,3590,54516,431
2022-03-05,Lake,033,64148,10583,10512,887,11399,130
2022-03-05,Lassen,035,31185,8903,8818,890,9708,62
2022-03-05,Los Angeles,037,10098052,2690819,2671564,122606,2794170,30608
2022-03-05,Madera,039,155013,37187,37100,6022,43122,354
2022-03-05,Marin,041,260295,32960,32829,2189,35018,272
2022-03-05,Mariposa,043,17540,2370,2363,199,2562,6
2022-03-05,Mendocino,045,87422,12946,12845,2943,15788,113
2022-03-05,Merced,047,269075,61864,61653,8413,70066,789
2022-03-05,Modoc,049,8938,731,729,250,979,7
2022-03-05,Mono,051,14174,2960,2961,120,3081,5
2022-03-05,Monterey,053,433212,78573,78028,13347,91375,704
2022-03-05,Napa,055,140530,25482,25405,952,26357,134
2022-03-05,Nevada,057,99092,15834,15907,1196,17103,122
2022-03-05,Orange,059,3164182,543320,541463,40954,582417,6638
2022-03-05,Placer,061,380077,62315,62117,7313,69430,591
2022-03-05,Plumas,063,18699,2870,2701,358,3059,13
2022-03-05,Riverside,065,2383286,588574,586785,27987,614772,6239
2022-03-05,Sacramento,067,1510023,275041,273487,26682,300169,2847
2022-03-05,San Benito,069,59416,12832,12820,512,13332,94
2022-03-05,San Bernardino,071,2135413,560189,557421,24485,581906,6641
2022-03-05,San Diego,073,3302833,747391,740747,51023,791770,5045
2022-03-05,San Francisco,075,870044,122704,123537,8265,131802,798
2022-03-05,San Joaquin,077,732212,165574,165085,9112,174197,2069
2022-03-05,San Luis Obispo,079,281455,52093,51739,3724,55463,446
2022-03-05,San Mateo,081,765935,119341,118646,6937,125583,621
2022-03-05,Santa Barbara,083,443738,85034,85249,4805,90054,655
2022-03-05,Santa Clara,085,1922200,308618,307689,12293,319982,2195
2022-03-05,Santa Cruz,087,273765,46716,46622,2057,48679,253
2022-03-05,Shasta,089,179085,30363,30282,6126,36408,492
2022-03-05,Sierra,091,2930,272,273,41,314,4
2022-03-05,Siskiyou,093,43540,4404,4389,2744,7133,74
2022-03-05,Solano,095,438530,81068,80690,5496,86186,435
2022-03-05,Sonoma,097,501317,82534,82313,2485,84798,473
2022-03-05,Stanislaus,099,539301,116848,117501,17053,134554,1531
2022-03-05,Sutter,101,95872,20433,20346,2031,22377,217
2022-03-05,Tehama,103,63373,11993,11939,2597,14536,158
2022-03-05,Trinity,105,12862,1173,1170,291,1461,20
2022-03-05,Tulare,107,460477,104790,103534,28219,131753,1305
2022-03-05,Tuolumne,109,53932,12556,12325,559,12884,178
2022-03-05,Ventura,111,848112,172020,171666,9214,180880,1436
2022-03-05,Yolo,113,214977,36171,35856,3145,39001,306
2022-03-05,Yuba,115,75493,15720,15666,1189,16855,115
2022-03-04,Alameda,001,1643700,252941,251988,13659,265647,1760
2022-03-04,Alpine,003,1148,122,125,1,126,0
2022-03-04,Amador,005,37829,8449,8344,642,8986,83
2022-03-04,Butte,007,227075,32741,32663,6583,39246,372
2022-03-04,Calaveras,009,45235,7207,7236,351,7587,116
2022-03-04,Colusa,011,21464,3431,3433,1074,4507,21
2022-03-04,Contra Costa,013,1133247,186890,185734,13046,198780,1235
2022-03-04,Del Norte,015,27424,5713,5725,188,5913,48
2022-03-04,El Dorado,017,186661,26547,26446,3190,29636,193
2022-03-04,Fresno,019,978130,229502,227154,22522,249676,2640
2022-03-04,Glenn,021,27897,4947,4927,1564,6491,43
2022-03-04,Humboldt,023,135768,16755,16781,2921,19702,136
2022-03-04,Imperial,025,180216,54999,54650,11005,65655,880
2022-03-04,Inyo,027,18085,4048,4043,479,4522,56
2022-03-04,Kern,029,883053,190683,189817,46075,235892,2141
2022-03-04,Kings,031,150075,51092,50926,3590,54516,431
2022-03-04,Lake,033,64148,10582,10512,887,11399,130
2022-03-04,Lassen,035,31185,8901,8818,890,9708,62
2022-03-04,Los Angeles,037,10098052,2690328,2671564,122578,2794142,30608
2022-03-04,Madera,039,155013,37176,37100,6022,43122,354
2022-03-04,Marin,041,260295,32939,32829,2187,35016,272
2022-03-04,Mariposa,043,17540,2365,2363,199,2562,6
2022-03-04,Mendocino,045,87422,12940,12845,2943,15788,113
2022-03-04,Merced,047,269075,61852,61653,8411,70064,789
2022-03-04,Modoc,049,8938,731,729,250,979,7
2022-03-04,Mono,051,14174,2960,2961,120,3081,5
2022-03-04,Monterey,053,433212,78553,78028,13340,91368,704
2022-03-04,Napa,055,140530,25467,25405,951,26356,134
2022-03-04,Nevada,057,99092,15829,15907,1196,17103,122
2022-03-04,Orange,059,3164182,543200,541463,40935,582398,6638
2022-03-04,Placer,061,380077,62306,62117,7309,69426,591
2022-03-04,Plumas,063,18699,2870,2701,357,3058,13
2022-03-04,Riverside,065,2383286,588486,586785,27986,614771,6239
2022-03-04,Sacramento,067,1510023,274971,273487,26678,300165,2847
2022-03-04,San Benito,069,59416,12828,12820,512,13332,94
2022-03-04,San Bernardino,071,2135413,560108,557421,24484,581905,6641
2022-03-04,San Diego,073,3302833,747146,740747,51007,791754,5045
2022-03-04,San Francisco,075,870044,122646,123537,8258,131795,798
2022-03-04,San Joaquin,077,732212,165543,165085,9111,174196,2069
2022-03-04,San Luis Obispo,079,281455,52085,51739,3723,55462,446
2022-03-04,San Mateo,081,765935,119283,118646,6934,125580,621
2022-03-04,Santa Barbara,083,443738,85012,85249,4805,90054,655
2022-03-04,Santa Clara,085,1922200,308470,307689,12291,319980,2195
2022-03-04,Santa Cruz,087,273765,46694,46622,2057,48679,253
2022-03-04,Shasta,089,179085,30354,30282,6123,36405,492
2022-03-04,Sierra,091,2930,272,273,41,314,4
2022-03-04,Siskiyou,093,43540,4402,4389,2740,7129,74
2022-03-04,Solano,095,438530,81034,80690,5493,86183,435
2022-03-04,Sonoma,097,501317,82505,82313,2484,84797,473
2022-03-04,Stanislaus,099,539301,116829,117501,17051,134552,1531
2022-03-04,Sutter,101,95872,20429,20346,2031,22377,217
2022-03-04,Tehama,103,63373,11990,11939,2597,14536,158
2022-03-04,Trinity,105,12862,1173,1170,291,1461,20
2022-03-04,Tulare,107,460477,104772,103534,28214,131748,1305
2022-03-04,Tuolumne,109,53932,12551,12325,559,12884,178
2022-03-04,Ventura,111,848112,171973,171666,9211,180877,1436
2022-03-04,Yolo,113,214977,36154,35856,3145,39001,306
2022-03-04,Yuba,115,75493,15716,15666,1188,16854,115
2022-03-03,Alameda,001,1643700,252821,251988,13647,265635,1760
2022-03-03,Alpine,003,1148,122,125,1,126,0
2022-03-03,Amador,005,37829,8448,8344,642,8986,83
2022-03-03,Butte,007,227075,32724,32663,6577,39240,372
2022-03-03,Calaveras,009,45235,7194,7236,351,7587,116
2022-03-03,Colusa,011,21464,3431,3433,1074,4507,21
2022-03-03,Contra Costa,013,1133247,186815,185734,13033,198767,1235
2022-03-03,Del Norte,015,27424,5706,5725,188,5913,48
2022-03-03,El Dorado,017,186661,26530,26446,3189,29635,193
2022-03-03,Fresno,019,978130,229370,227154,22513,249667,2640
2022-03-03,Glenn,021,27897,4945,4927,1563,6490,43
2022-03-03,Humboldt,023,135768,16741,16781,2920,19701,136
2022-03-03,Imperial,025,180216,54983,54650,10997,65647,880
2022-03-03,Inyo,027,18085,4047,4043,479,4522,56
2022-03-03,Kern,029,883053,190615,189817,46055,235872,2141
2022-03-03,Kings,031,150075,51069,50926,3587,54513,431
2022-03-03,Lake,033,64148,10575,10512,885,11397,130
2022-03-03,Lassen,035,31185,8893,8818,890,9708,62
2022-03-03,Los Angeles,037,10098052,2689607,2671564,122535,2794099,30608
2022-03-03,Madera,039,155013,37159,37100,6017,43117,354
2022-03-03,Marin,041,260295,32912,32829,2187,35016,272
2022-03-03,Mariposa,043,17540,2364,2363,199,2562,6
2022-03-03,Mendocino,045,87422,12929,12845,2940,15785,113
2022-03-03,Merced,047,269075,61835,61653,8405,70058,789
2022-03-03,Modoc,049,8938,731,729,250,979,7
2022-03-03,Mono,051,14174,2959,2961,120,3081,5
2022-03-03,Monterey,053,433212,78525,78028,13322,91350,704
2022-03-03,Napa,055,140530,25444,25405,950,26355,134
2022-03-03,Nevada,057,99092,15824,15907,1191,17098,122
2022-03-03,Orange,059,3164182,543024,541463,40907,582370,6638
2022-03-03,Placer,061,380077,62284,62117,7305,69422,591
2022-03-03,Plumas,063,18699,2869,2701,357,3058,13
2022-03-03,Riverside,065,2383286,588353,586785,27981,614766,6239
2022-03-03,Sacramento,067,1510023,274859,273487,26660,300147,2847
2022-03-03,San Benito,069,59416,12825,12820,512,13332,94
2022-03-03,San Bernardino,071,2135413,560001,557421,24478,581899,6641
2022-03-03,San Diego,073,3302833,746799,740747,50988,791735,5045
2022-03-03,San Francisco,075,870044,122573,123537,8247,131784,798
2022-03-03,San Joaquin,077,732212,165469,165085,9108,174193,2069
2022-03-03,San Luis Obispo,079,281455,52030,51739,3716,55455,446
2022-03-03,San Mateo,081,765935,119207,118646,6924,125570,621
2022-03-03,Santa Barbara,083,443738,84992,85249,4796,90045,655
2022-03-03,Santa Clara,085,1922200,308284,307689,12277,319966,2195
2022-03-03,Santa Cruz,087,273765,46647,46622,2055,48677,253
2022-03-03,Shasta,089,179085,30337,30282,6119,36401,492
2022-03-03,Sierra,091,2930,272,273,41,314,4
2022-03-03,Siskiyou,093,43540,4399,4389,2740,7129,74
2022-03-03,Solano,095,438530,80985,80690,5491,86181,435
2022-03-03,Sonoma,097,501317,82458,82313,2479,84792,473
2022-03-03,Stanislaus,099,539301,116796,117501,17044,134545,1531
2022-03-03,Sutter,101,95872,20420,20346,2031,22377,217
2022-03-03,Tehama,103,63373,11986,11939,2597,14536,158
2022-03-03,Trinity,105,12862,1172,1170,291,1461,20
2022-03-03,Tulare,107,460477,104724,103534,28204,131738,1305
2022-03-03,Tuolumne,109,53932,12541,12325,559,12884,178
2022-03-03,Ventura,111,848112,171920,171666,9209,180875,1436
2022-03-03,Yolo,113,214977,36130,35856,3135,38991,306
2022-03-03,Yuba,115,75493,15710,15666,1184,16850,115
2022-03-02,Alameda,001,1643700,252640,251886,13631,265517,1759
2022-03-02,Alpine,003,1148,122,125,1,126,0
2022-03-02,Amador,005,37829,8436,8341,642,8983,83
2022-03-02,Butte,007,227075,32711,32636,6572,39208,372
2022-03-02,Calaveras,009,45235,7193,7225,351,7576,116
2022-03-02,Colusa,011,21464,3428,3428,1074,4502,21
2022-03-02,Contra Costa,013,1133247,186721,185589,13016,198605,1236
2022-03-02,Del Norte,015,27424,5699,5708,186,5894,47
2022-03-02,El Dorado,017,186661,26516,26433,3186,29619,192
2022-03-02,Fresno,019,978130,229236,226932,22504,249436,2629
2022-03-02,Glenn,021,27897,4945,4922,1562,6484,43
2022-03-02,Humboldt,023,135768,16731,16747,2913,19660,135
2022-03-02,Imperial,025,180216,54957,54629,10988,65617,878
2022-03-02,Inyo,027,18085,4045,4041,478,4519,56
2022-03-02,Kern,029,883053,190548,189656,46035,235691,2136
2022-03-02,Kings,031,150075,51043,50819,3584,54403,431
2022-03-02,Lake,033,64148,10561,10495,883,11378,130
2022-03-02,Lassen,035,31185,8890,8811,889,9700,62
2022-03-02,Los Angeles,037,10098052,2688728,2670287,122489,2792776,30535
2022-03-02,Madera,039,155013,37139,37077,6016,43093,354
2022-03-02,Marin,041,260295,32895,32794,2186,34980,272
2022-03-02,Mariposa,043,17540,2364,2359,199,2558,6
2022-03-02,Mendocino,045,87422,12916,12832,2935,15767,112
2022-03-02,Merced,047,269075,61808,61606,8395,70001,785
2022-03-02,Modoc,049,8938,731,729,250,979,7
2022-03-02,Mono,051,14174,2959,2961,120,3081,5
2022-03-02,Monterey,053,433212,78491,77963,13299,91262,703
2022-03-02,Napa,055,140530,25393,25382,948,26330,134
2022-03-02,Nevada,057,99092,15813,15920,1190,17110,122
2022-03-02,Orange,059,3164182,542817,541230,40877,582107,6623
2022-03-02,Placer,061,380077,62261,62066,7302,69368,589
2022-03-02,Plumas,063,18699,2869,2700,356,3056,13
2022-03-02,Riverside,065,2383286,588199,586513,27970,614483,6229
2022-03-02,Sacramento,067,1510023,274739,273291,26650,299941,2837
2022-03-02,San Benito,069,59416,12814,12814,512,13326,94
2022-03-02,San Bernardino,071,2135413,559898,557082,24472,581554,6619
2022-03-02,San Diego,073,3302833,746432,739803,50941,790744,5034
2022-03-02,San Francisco,075,870044,122477,123442,8245,131687,792
2022-03-02,San Joaquin,077,732212,165407,164968,9102,174070,2063
2022-03-02,San Luis Obispo,079,281455,51992,51686,3711,55397,446
2022-03-02,San Mateo,081,765935,119120,118518,6907,125425,617
2022-03-02,Santa Barbara,083,443738,84967,85183,4795,89978,655
2022-03-02,Santa Clara,085,1922200,308057,307354,12263,319617,2184
2022-03-02,Santa Cruz,087,273765,46578,46534,2054,48588,253
2022-03-02,Shasta,089,179085,30315,30253,6109,36362,490
2022-03-02,Sierra,091,2930,272,273,41,314,4
2022-03-02,Siskiyou,093,43540,4397,4384,2737,7121,74
2022-03-02,Solano,095,438530,80909,80626,5488,86114,433
2022-03-02,Sonoma,097,501317,82413,82208,2475,84683,473
2022-03-02,Stanislaus,099,539301,116759,117411,17016,134427,1519
2022-03-02,Sutter,101,95872,20397,20317,2013,22330,216
2022-03-02,Tehama,103,63373,11981,11930,2596,14526,158
2022-03-02,Trinity,105,12862,1170,1160,291,1451,20
2022-03-02,Tulare,107,460477,104679,103451,28187,131638,1302
2022-03-02,Tuolumne,109,53932,12536,12297,559,12856,179
2022-03-02,Ventura,111,848112,171869,171770,9205,180975,1427
2022-03-02,Yolo,113,214977,36112,35799,3131,38930,305
2022-03-02,Yuba,115,75493,15697,15653,1179,16832,115
2022-03-01,Alameda,001,1643700,252475,251830,13620,265450,1749
2022-03-01,Alpine,003,1148,122,125,1,126,0
2022-03-01,Amador,005,37829,8388,8334,640,8974,83
2022-03-01,Butte,007,227075,32687,32575,6569,39144,372
2022-03-01,Calaveras,009,45235,7190,7223,350,7573,116
2022-03-01,Colusa,011,21464,3427,3423,1074,4497,21
2022-03-01,Contra Costa,013,1133247,186605,185378,13002,198380,1231
2022-03-01,Del Norte,015,27424,5696,5701,184,5885,45
2022-03-01,El Dorado,017,186661,26496,26413,3184,29597,192
2022-03-01,Fresno,019,978130,229088,226594,22493,249087,2628
2022-03-01,Glenn,021,27897,4944,4919,1560,6479,40
2022-03-01,Humboldt,023,135768,16710,16727,2906,19633,135
2022-03-01,Imperial,025,180216,54939,54570,10981,65551,875
2022-03-01,Inyo,027,18085,4041,4041,477,4518,56
2022-03-01,Kern,029,883053,190472,189365,46010,235375,2120
2022-03-01,Kings,031,150075,51021,50763,3580,54343,427
2022-03-01,Lake,033,64148,10549,10471,881,11352,128
2022-03-01,Lassen,035,31185,8886,8801,889,9690,61
2022-03-01,Los Angeles,037,10098052,2687779,2669489,122429,2791918,30486
2022-03-01,Madera,039,155013,37119,37046,6009,43055,354
2022-03-01,Marin,041,260295,32870,32764,2184,34948,272
2022-03-01,Mariposa,043,17540,2363,2357,198,2555,6
2022-03-01,Mendocino,045,87422,12904,12818,2933,15751,112
2022-03-01,Merced,047,269075,61779,61549,8380,69929,781
2022-03-01,Modoc,049,8938,731,729,250,979,7
2022-03-01,Mono,051,14174,2958,2960,120,3080,6
2022-03-01,Monterey,053,433212,78465,77911,13286,91197,696
2022-03-01,Napa,055,140530,25360,25344,948,26292,134
2022-03-01,Nevada,057,99092,15805,15916,1187,17103,121
2022-03-01,Orange,059,3164182,542596,541054,40840,581894,6612
2022-03-01,Placer,061,380077,62230,62021,7297,69318,583
2022-03-01,Plumas,063,18699,2869,2694,356,3050,13
2022-03-01,Riverside,065,2383286,588031,586184,27969,614153,6198
2022-03-01,Sacramento,067,1510023,274609,273089,26636,299725,2831
2022-03-01,San Benito,069,59416,12809,12806,512,13318,94
2022-03-01,San Bernardino,071,2135413,559765,556743,24470,581213,6588
2022-03-01,San Diego,073,3302833,745993,739136,50899,790035,5029
2022-03-01,San Francisco,075,870044,122375,123481,8240,131721,792
2022-03-01,San Joaquin,077,732212,165340,164894,9097,173991,2062
2022-03-01,San Luis Obispo,079,281455,51955,51592,3707,55299,445
2022-03-01,San Mateo,081,765935,119043,118358,6899,125257,613
2022-03-01,Santa Barbara,083,443738,84928,85134,4791,89925,654
2022-03-01,Santa Clara,085,1922200,307805,306978,12250,319228,2190
2022-03-01,Santa Cruz,087,273765,46528,46471,2051,48522,253
2022-03-01,Shasta,089,179085,30285,30227,6106,36333,489
2022-03-01,Sierra,091,2930,272,274,41,315,5
2022-03-01,Siskiyou,093,43540,4393,4384,2732,7116,74
2022-03-01,Solano,095,438530,80838,80556,5485,86041,434
2022-03-01,Sonoma,097,501317,82344,82103,2469,84572,477
2022-03-01,Stanislaus,099,539301,116706,117308,16991,134299,1521
2022-03-01,Sutter,101,95872,20383,20288,2009,22297,217
2022-03-01,Tehama,103,63373,11974,11923,2593,14516,158
2022-03-01,Trinity,105,12862,1169,1159,291,1450,20
2022-03-01,Tulare,107,460477,104598,103371,28167,131538,1302
2022-03-01,Tuolumne,109,53932,12529,12276,557,12833,175
2022-03-01,Ventura,111,848112,171800,171672,9198,180870,1427
2022-03-01,Yolo,113,214977,36085,35801,3127,38928,299
2022-03-01,Yuba,115,75493,15689,15637,1178,16815,116
2022-02-28,Alameda,001,1643700,252259,251714,13606,265320,1742
2022-02-28,Alpine,003,1148,122,125,1,126,0
2022-02-28,Amador,005,37829,8382,8308,639,8947,83
2022-02-28,Butte,007,227075,32663,32550,6564,39114,368
2022-02-28,Calaveras,009,45235,7187,7220,349,7569,110
2022-02-28,Colusa,011,21464,3424,3422,1072,4494,21
2022-02-28,Contra Costa,013,1133247,186500,185272,12982,198254,1231
2022-02-28,Del Norte,015,27424,5692,5699,183,5882,45
2022-02-28,El Dorado,017,186661,26488,26409,3179,29588,191
2022-02-28,Fresno,019,978130,228885,226519,22474,248993,2622
2022-02-28,Glenn,021,27897,4940,4918,1560,6478,40
2022-02-28,Humboldt,023,135768,16695,16717,2902,19619,135
2022-02-28,Imperial,025,180216,54914,54517,10975,65492,875
2022-02-28,Inyo,027,18085,4041,4041,476,4517,56
2022-02-28,Kern,029,883053,190377,189245,45979,235224,2115
2022-02-28,Kings,031,150075,50982,50741,3579,54320,427
2022-02-28,Lake,033,64148,10538,10468,877,11345,128
2022-02-28,Lassen,035,31185,8829,8794,889,9683,55
2022-02-28,Los Angeles,037,10098052,2686609,2666804,122345,2789149,30410
2022-02-28,Madera,039,155013,37092,37023,5991,43014,354
2022-02-28,Marin,041,260295,32844,32775,2184,34959,272
2022-02-28,Mariposa,043,17540,2360,2354,196,2550,6
2022-02-28,Mendocino,045,87422,12896,12800,2925,15725,112
2022-02-28,Merced,047,269075,61735,61519,8362,69881,781
2022-02-28,Modoc,049,8938,731,727,250,977,7
2022-02-28,Mono,051,14174,2958,2961,120,3081,5
2022-02-28,Monterey,053,433212,78398,77865,13264,91129,693
2022-02-28,Napa,055,140530,25336,25317,948,26265,129
2022-02-28,Nevada,057,99092,15799,15908,1181,17089,121
2022-02-28,Orange,059,3164182,542341,540839,40826,581665,6605
2022-02-28,Placer,061,380077,62198,61976,7291,69267,577
2022-02-28,Plumas,063,18699,2869,2691,355,3046,13
2022-02-28,Riverside,065,2383286,587833,585891,27936,613827,6179
2022-02-28,Sacramento,067,1510023,274477,273038,26610,299648,2825
2022-02-28,San Benito,069,59416,12805,12798,512,13310,94
2022-02-28,San Bernardino,071,2135413,559573,556540,24456,580996,6576
2022-02-28,San Diego,073,3302833,745593,737760,50870,788630,5018
2022-02-28,San Francisco,075,870044,122217,123402,8232,131634,792
2022-02-28,San Joaquin,077,732212,165254,164833,9088,173921,2060
2022-02-28,San Luis Obispo,079,281455,51896,51565,3699,55264,440
2022-02-28,San Mateo,081,765935,118940,118301,6893,125194,611
2022-02-28,Santa Barbara,083,443738,84886,85076,4786,89862,653
2022-02-28,Santa Clara,085,1922200,307523,306930,12228,319158,2180
2022-02-28,Santa Cruz,087,273765,46456,46447,2050,48497,253
2022-02-28,Shasta,089,179085,30261,30213,6102,36315,488
2022-02-28,Sierra,091,2930,272,273,41,314,4
2022-02-28,Siskiyou,093,43540,4390,4382,2726,7108,74
2022-02-28,Solano,095,438530,80769,80544,5474,86018,430
2022-02-28,Sonoma,097,501317,82280,82058,2466,84524,477
2022-02-28,Stanislaus,099,539301,116639,117231,16976,134207,1521
2022-02-28,Sutter,101,95872,20370,20285,2006,22291,214
2022-02-28,Tehama,103,63373,11961,11917,2592,14509,158
2022-02-28,Trinity,105,12862,1169,1160,291,1451,20
2022-02-28,Tulare,107,460477,104548,103304,28149,131453,1300
2022-02-28,Tuolumne,109,53932,12518,12247,556,12803,175
2022-02-28,Ventura,111,848112,171716,171614,9197,180811,1423
2022-02-28,Yolo,113,214977,36047,35754,3120,38874,299
2022-02-28,Yuba,115,75493,15675,15625,1177,16802,115
2022-02-27,Alameda,001,1643700,251980,251624,13597,265221,1744
2022-02-27,Alpine,003,1148,122,125,1,126,0
2022-02-27,Amador,005,37829,8378,8305,636,8941,83
2022-02-27,Butte,007,227075,32626,32551,6552,39103,368
2022-02-27,Calaveras,009,45235,7179,7214,349,7563,110
2022-02-27,Colusa,011,21464,3423,3422,1072,4494,21
2022-02-27,Contra Costa,013,1133247,186363,185185,12961,198146,1230
2022-02-27,Del Norte,015,27424,5674,5691,181,5872,45
2022-02-27,El Dorado,017,186661,26469,26410,3177,29587,191
2022-02-27,Fresno,019,978130,228684,226397,22449,248846,2621
2022-02-27,Glenn,021,27897,4938,4915,1560,6475,40
2022-02-27,Humboldt,023,135768,16673,16713,2895,19608,135
2022-02-27,Imperial,025,180216,54865,54509,10954,65463,875
2022-02-27,Inyo,027,18085,4040,4041,472,4513,56
2022-02-27,Kern,029,883053,190256,189219,45939,235158,2115
2022-02-27,Kings,031,150075,50953,50733,3577,54310,428
2022-02-27,Lake,033,64148,10519,10463,877,11340,128
2022-02-27,Lassen,035,31185,8821,8786,889,9675,55
2022-02-27,Los Angeles,037,10098052,2685317,2666789,122261,2789050,30410
2022-02-27,Madera,039,155013,37066,37009,5983,42992,354
2022-02-27,Marin,041,260295,32806,32756,2182,34938,272
2022-02-27,Mariposa,043,17540,2357,2352,196,2548,6
2022-02-27,Mendocino,045,87422,12877,12798,2912,15710,112
2022-02-27,Merced,047,269075,61684,61491,8345,69836,779
2022-02-27,Modoc,049,8938,730,727,250,977,7
2022-02-27,Mono,051,14174,2957,2960,120,3080,5
2022-02-27,Monterey,053,433212,78337,77851,13240,91091,693
2022-02-27,Napa,055,140530,25297,25316,948,26264,129
2022-02-27,Nevada,057,99092,15791,15900,1177,17077,121
2022-02-27,Orange,059,3164182,542094,540659,40796,581455,6605
2022-02-27,Placer,061,380077,62154,61965,7287,69252,577
2022-02-27,Plumas,063,18699,2866,2691,355,3046,13
2022-02-27,Riverside,065,2383286,587593,585833,27910,613743,6179
2022-02-27,Sacramento,067,1510023,274291,272927,26578,299505,2822
2022-02-27,San Benito,069,59416,12798,12798,512,13310,94
2022-02-27,San Bernardino,071,2135413,559392,556457,24446,580903,6572
2022-02-27,San Diego,073,3302833,745109,737760,50827,788587,5018
2022-02-27,San Francisco,075,870044,122093,123327,8220,131547,791
2022-02-27,San Joaquin,077,732212,165148,164814,9084,173898,2060
2022-02-27,San Luis Obispo,079,281455,51803,51564,3692,55256,439
2022-02-27,San Mateo,081,765935,118824,118244,6888,125132,611
2022-02-27,Santa Barbara,083,443738,84846,85050,4782,89832,653
2022-02-27,Santa Clara,085,1922200,307222,306756,12196,318952,2180
2022-02-27,Santa Cruz,087,273765,46395,46411,2049,48460,253
2022-02-27,Shasta,089,179085,30229,30206,6096,36302,488
2022-02-27,Sierra,091,2930,272,273,41,314,4
2022-02-27,Siskiyou,093,43540,4385,4378,2713,7091,74
2022-02-27,Solano,095,438530,80691,80515,5463,85978,430
2022-02-27,Sonoma,097,501317,82198,82041,2460,84501,476
2022-02-27,Stanislaus,099,539301,116570,117200,16959,134159,1522
2022-02-27,Sutter,101,95872,20353,20280,2001,22281,214
2022-02-27,Tehama,103,63373,11948,11915,2591,14506,158
2022-02-27,Trinity,105,12862,1168,1158,291,1449,20
2022-02-27,Tulare,107,460477,104473,103270,28094,131364,1300
2022-02-27,Tuolumne,109,53932,12504,12243,555,12798,175
2022-02-27,Ventura,111,848112,171640,171660,9195,180855,1423
2022-02-27,Yolo,113,214977,36020,35744,3115,38859,299
2022-02-27,Yuba,115,75493,15664,15619,1175,16794,113
2022-02-26,Alameda,001,1643700,251869,250867,13592,264459,1716
2022-02-26,Alpine,003,1148,122,125,1,126,0
2022-02-26,Amador,005,37829,8375,8282,635,8917,83
2022-02-26,Butte,007,227075,32612,32466,6551,39017,368
2022-02-26,Calaveras,009,45235,7178,7192,349,7541,110
2022-02-26,Colusa,011,21464,3423,3414,1072,4486,21
2022-02-26,Contra Costa,013,1133247,186293,184686,12942,197628,1209
2022-02-26,Del Norte,015,27424,5669,5639,181,5820,45
2022-02-26,El Dorado,017,186661,26458,26355,3173,29528,191
2022-02-26,Fresno,019,978130,228594,225679,22449,248128,2597
2022-02-26,Glenn,021,27897,4936,4909,1559,6468,40
2022-02-26,Humboldt,023,135768,16648,16619,2894,19513,133
2022-02-26,Imperial,025,180216,54838,54367,10952,65319,871
2022-02-26,Inyo,027,18085,4039,4034,467,4501,56
2022-02-26,Kern,029,883053,190207,188584,45919,234503,2106
2022-02-26,Kings,031,150075,50940,50579,3577,54156,423
2022-02-26,Lake,033,64148,10513,10383,877,11260,128
2022-02-26,Lassen,035,31185,8820,8761,889,9650,55
2022-02-26,Los Angeles,037,10098052,2684760,2660973,122219,2783192,30202
2022-02-26,Madera,039,155013,37053,36933,5981,42914,330
2022-02-26,Marin,041,260295,32792,32651,2180,34831,267
2022-02-26,Mariposa,043,17540,2356,2332,196,2528,6
2022-02-26,Mendocino,045,87422,12871,12762,2912,15674,111
2022-02-26,Merced,047,269075,61663,61348,8344,69692,775
2022-02-26,Modoc,049,8938,730,726,250,976,7
2022-02-26,Mono,051,14174,2957,2959,119,3078,5
2022-02-26,Monterey,053,433212,78306,77610,13233,90843,692
2022-02-26,Napa,055,140530,25282,25221,947,26168,130
2022-02-26,Nevada,057,99092,15787,15850,1175,17025,121
2022-02-26,Orange,059,3164182,541984,539992,40779,580771,6540
2022-02-26,Placer,061,380077,62135,61803,7284,69087,573
2022-02-26,Plumas,063,18699,2866,2673,355,3028,13
2022-02-26,Riverside,065,2383286,587474,584835,27902,612737,6143
2022-02-26,Sacramento,067,1510023,274197,272339,26565,298904,2793
2022-02-26,San Benito,069,59416,12794,12770,512,13282,92
2022-02-26,San Bernardino,071,2135413,559309,555668,24440,580108,6505
2022-02-26,San Diego,073,3302833,744877,736049,50808,786857,5002
2022-02-26,San Francisco,075,870044,122025,123079,8212,131291,769
2022-02-26,San Joaquin,077,732212,165113,164418,9083,173501,2048
2022-02-26,San Luis Obispo,079,281455,51789,51358,3689,55047,438
2022-02-26,San Mateo,081,765935,118770,117860,6886,124746,603
2022-02-26,Santa Barbara,083,443738,84816,84830,4782,89612,652
2022-02-26,Santa Clara,085,1922200,307069,305895,12194,318089,2166
2022-02-26,Santa Cruz,087,273765,46373,46186,2049,48235,251
2022-02-26,Shasta,089,179085,30221,30108,6090,36198,485
2022-02-26,Sierra,091,2930,272,270,41,311,1
2022-02-26,Siskiyou,093,43540,4385,4359,2711,7070,72
2022-02-26,Solano,095,438530,80657,80225,5460,85685,428
2022-02-26,Sonoma,097,501317,82162,81702,2458,84160,432
2022-02-26,Stanislaus,099,539301,116529,116896,16954,133850,1503
2022-02-26,Sutter,101,95872,20344,20230,2001,22231,214
2022-02-26,Tehama,103,63373,11942,11878,2588,14466,158
2022-02-26,Trinity,105,12862,1167,1156,291,1447,20
2022-02-26,Tulare,107,460477,104436,102983,28079,131062,1295
2022-02-26,Tuolumne,109,53932,12502,12169,555,12724,175
2022-02-26,Ventura,111,848112,171606,171292,9193,180485,1411
2022-02-26,Yolo,113,214977,35999,35615,3112,38727,296
2022-02-26,Yuba,115,75493,15653,15587,1175,16762,113
2022-02-25,Alameda,001,1643700,251743,250867,13583,264450,1716
2022-02-25,Alpine,003,1148,122,125,1,126,0
2022-02-25,Amador,005,37829,8364,8282,635,8917,83
2022-02-25,Butte,007,227075,32600,32466,6549,39015,368
2022-02-25,Calaveras,009,45235,7176,7192,349,7541,110
2022-02-25,Colusa,011,21464,3423,3414,1072,4486,21
2022-02-25,Contra Costa,013,1133247,186207,184686,12920,197606,1209
2022-02-25,Del Norte,015,27424,5659,5639,181,5820,45
2022-02-25,El Dorado,017,186661,26449,26355,3173,29528,191
2022-02-25,Fresno,019,978130,228497,225679,22442,248121,2597
2022-02-25,Glenn,021,27897,4934,4909,1559,6468,40
2022-02-25,Humboldt,023,135768,16637,16619,2894,19513,133
2022-02-25,Imperial,025,180216,54820,54367,10951,65318,871
2022-02-25,Inyo,027,18085,4038,4034,467,4501,56
2022-02-25,Kern,029,883053,190141,188584,45906,234490,2106
2022-02-25,Kings,031,150075,50926,50579,3576,54155,423
2022-02-25,Lake,033,64148,10498,10383,877,11260,128
2022-02-25,Lassen,035,31185,8818,8761,889,9650,55
2022-02-25,Los Angeles,037,10098052,2684169,2660973,122189,2783162,30202
2022-02-25,Madera,039,155013,37033,36933,5980,42913,330
2022-02-25,Marin,041,260295,32778,32651,2180,34831,267
2022-02-25,Mariposa,043,17540,2353,2332,196,2528,6
2022-02-25,Mendocino,045,87422,12869,12762,2912,15674,111
2022-02-25,Merced,047,269075,61631,61348,8340,69688,775
2022-02-25,Modoc,049,8938,730,726,250,976,7
2022-02-25,Mono,051,14174,2956,2959,119,3078,5
2022-02-25,Monterey,053,433212,78279,77610,13227,90837,692
2022-02-25,Napa,055,140530,25273,25221,947,26168,130
2022-02-25,Nevada,057,99092,15776,15850,1172,17022,121
2022-02-25,Orange,059,3164182,541852,539992,40757,580749,6540
2022-02-25,Placer,061,380077,62120,61803,7278,69081,573
2022-02-25,Plumas,063,18699,2864,2673,354,3027,13
2022-02-25,Riverside,065,2383286,587317,584835,27890,612725,6143
2022-02-25,Sacramento,067,1510023,274095,272339,26560,298899,2793
2022-02-25,San Benito,069,59416,12792,12770,512,13282,92
2022-02-25,San Bernardino,071,2135413,559207,555668,24434,580102,6505
2022-02-25,San Diego,073,3302833,744574,736049,50789,786838,5002
2022-02-25,San Francisco,075,870044,121946,123079,8208,131287,769
2022-02-25,San Joaquin,077,732212,165073,164418,9078,173496,2048
2022-02-25,San Luis Obispo,079,281455,51785,51358,3680,55038,438
2022-02-25,San Mateo,081,765935,118709,117860,6882,124742,603
2022-02-25,Santa Barbara,083,443738,84781,84830,4782,89612,652
2022-02-25,Santa Clara,085,1922200,306885,305895,12191,318086,2166
2022-02-25,Santa Cruz,087,273765,46339,46186,2047,48233,251
2022-02-25,Shasta,089,179085,30211,30108,6088,36196,485
2022-02-25,Sierra,091,2930,272,270,41,311,1
2022-02-25,Siskiyou,093,43540,4385,4359,2710,7069,72
2022-02-25,Solano,095,438530,80628,80225,5459,85684,428
2022-02-25,Sonoma,097,501317,82112,81702,2456,84158,432
2022-02-25,Stanislaus,099,539301,116502,116896,16950,133846,1503
2022-02-25,Sutter,101,95872,20335,20230,2001,22231,214
2022-02-25,Tehama,103,63373,11940,11878,2588,14466,158
2022-02-25,Trinity,105,12862,1167,1156,291,1447,20
2022-02-25,Tulare,107,460477,104399,102983,28056,131039,1295
2022-02-25,Tuolumne,109,53932,12500,12169,555,12724,175
2022-02-25,Ventura,111,848112,171556,171292,9193,180485,1411
2022-02-25,Yolo,113,214977,35984,35615,3112,38727,296
2022-02-25,Yuba,115,75493,15645,15587,1175,16762,113
2022-02-24,Alameda,001,1643700,251537,250867,13574,264441,1716
2022-02-24,Alpine,003,1148,122,125,1,126,0
2022-02-24,Amador,005,37829,8359,8282,634,8916,83
2022-02-24,Butte,007,227075,32579,32466,6544,39010,368
2022-02-24,Calaveras,009,45235,7173,7192,347,7539,110
2022-02-24,Colusa,011,21464,3422,3414,1071,4485,21
2022-02-24,Contra Costa,013,1133247,186077,184686,12912,197598,1209
2022-02-24,Del Norte,015,27424,5644,5639,180,5819,45
2022-02-24,El Dorado,017,186661,26435,26355,3173,29528,191
2022-02-24,Fresno,019,978130,228300,225679,22430,248109,2597
2022-02-24,Glenn,021,27897,4932,4909,1558,6467,40
2022-02-24,Humboldt,023,135768,16620,16619,2893,19512,133
2022-02-24,Imperial,025,180216,54782,54367,10933,65300,871
2022-02-24,Inyo,027,18085,4037,4034,466,4500,56
2022-02-24,Kern,029,883053,189998,188584,45872,234456,2106
2022-02-24,Kings,031,150075,50896,50579,3571,54150,423
2022-02-24,Lake,033,64148,10479,10383,877,11260,128
2022-02-24,Lassen,035,31185,8814,8761,888,9649,55
2022-02-24,Los Angeles,037,10098052,2683019,2660973,122133,2783106,30202
2022-02-24,Madera,039,155013,37006,36933,5978,42911,330
2022-02-24,Marin,041,260295,32757,32651,2179,34830,267
2022-02-24,Mariposa,043,17540,2347,2332,195,2527,6
2022-02-24,Mendocino,045,87422,12862,12762,2908,15670,111
2022-02-24,Merced,047,269075,61601,61348,8331,69679,775
2022-02-24,Modoc,049,8938,729,726,250,976,7
2022-02-24,Mono,051,14174,2955,2959,119,3078,5
2022-02-24,Monterey,053,433212,78225,77610,13218,90828,692
2022-02-24,Napa,055,140530,25232,25221,943,26164,130
2022-02-24,Nevada,057,99092,15762,15850,1172,17022,121
2022-02-24,Orange,059,3164182,541607,539992,40723,580715,6540
2022-02-24,Placer,061,380077,62082,61803,7276,69079,573
2022-02-24,Plumas,063,18699,2858,2673,352,3025,13
2022-02-24,Riverside,065,2383286,587064,584835,27863,612698,6143
2022-02-24,Sacramento,067,1510023,273920,272339,26542,298881,2793
2022-02-24,San Benito,069,59416,12781,12770,511,13281,92
2022-02-24,San Bernardino,071,2135413,559018,555668,24424,580092,6505
2022-02-24,San Diego,073,3302833,744136,736049,50748,786797,5002
2022-02-24,San Francisco,075,870044,121826,123079,8201,131280,769
2022-02-24,San Joaquin,077,732212,164940,164418,9073,173491,2048
2022-02-24,San Luis Obispo,079,281455,51739,51358,3678,55036,438
2022-02-24,San Mateo,081,765935,118617,117860,6875,124735,603
2022-02-24,Santa Barbara,083,443738,84718,84830,4781,89611,652
2022-02-24,Santa Clara,085,1922200,306640,305895,12177,318072,2166
2022-02-24,Santa Cruz,087,273765,46257,46186,2045,48231,251
2022-02-24,Shasta,089,179085,30192,30108,6082,36190,485
2022-02-24,Sierra,091,2930,272,270,41,311,1
2022-02-24,Siskiyou,093,43540,4382,4359,2706,7065,72
2022-02-24,Solano,095,438530,80549,80225,5456,85681,428
2022-02-24,Sonoma,097,501317,82058,81702,2451,84153,432
2022-02-24,Stanislaus,099,539301,116424,116896,16940,133836,1503
2022-02-24,Sutter,101,95872,20320,20230,1985,22215,214
2022-02-24,Tehama,103,63373,11934,11878,2587,14465,158
2022-02-24,Trinity,105,12862,1165,1156,291,1447,20
2022-02-24,Tulare,107,460477,104342,102983,28024,131007,1295
2022-02-24,Tuolumne,109,53932,12489,12169,553,12722,175
2022-02-24,Ventura,111,848112,171477,171292,9190,180482,1411
2022-02-24,Yolo,113,214977,35959,35615,3109,38724,296
2022-02-24,Yuba,115,75493,15632,15587,1175,16762,113
2022-02-23,Alameda,001,1643700,251309,247686,13556,261242,1713
2022-02-23,Alpine,003,1148,122,125,1,126,0
2022-02-23,Amador,005,37829,8342,8274,634,8908,79
2022-02-23,Butte,007,227075,32551,32417,6541,38958,367
2022-02-23,Calaveras,009,45235,7163,7182,346,7528,107
2022-02-23,Colusa,011,21464,3418,3411,1071,4482,21
2022-02-23,Contra Costa,013,1133247,185930,184013,12898,196911,1209
2022-02-23,Del Norte,015,27424,5632,5625,179,5804,45
2022-02-23,El Dorado,017,186661,26419,26317,3169,29486,189
2022-02-23,Fresno,019,978130,228106,225308,22408,247716,2596
2022-02-23,Glenn,021,27897,4928,4909,1556,6465,40
2022-02-23,Humboldt,023,135768,16604,16601,2890,19491,132
2022-02-23,Imperial,025,180216,54747,54292,10920,65212,871
2022-02-23,Inyo,027,18085,4036,4031,463,4494,54
2022-02-23,Kern,029,883053,189885,188432,45822,234254,2106
2022-02-23,Kings,031,150075,50863,50416,3569,53985,423
2022-02-23,Lake,033,64148,10461,10368,876,11244,126
2022-02-23,Lassen,035,31185,8798,8749,888,9637,55
2022-02-23,Los Angeles,037,10098052,2681662,2659569,122089,2781658,30167
2022-02-23,Madera,039,155013,36974,36876,5967,42843,330
2022-02-23,Marin,041,260295,32733,32625,2178,34803,267
2022-02-23,Mariposa,043,17540,2342,2325,194,2519,6
2022-02-23,Mendocino,045,87422,12854,12747,2905,15652,111
2022-02-23,Merced,047,269075,61572,61295,8326,69621,772
2022-02-23,Modoc,049,8938,729,723,249,972,7
2022-02-23,Mono,051,14174,2954,2960,119,3079,5
2022-02-23,Monterey,053,433212,78186,77472,13195,90667,691
2022-02-23,Napa,055,140530,25209,25185,938,26123,128
2022-02-23,Nevada,057,99092,15756,15825,1169,16994,121
2022-02-23,Orange,059,3164182,541300,539631,40701,580332,6520
2022-02-23,Placer,061,380077,62035,61758,7268,69026,573
2022-02-23,Plumas,063,18699,2854,2663,352,3015,13
2022-02-23,Riverside,065,2383286,586771,584381,27826,612207,6119
2022-02-23,Sacramento,067,1510023,273758,272057,26519,298576,2796
2022-02-23,San Benito,069,59416,12774,12756,510,13266,92
2022-02-23,San Bernardino,071,2135413,558857,555238,24407,579645,6479
2022-02-23,San Diego,073,3302833,743609,735406,50706,786112,4988
2022-02-23,San Francisco,075,870044,121700,122127,8199,130326,769
2022-02-23,San Joaquin,077,732212,164851,164257,9067,173324,2042
2022-02-23,San Luis Obispo,079,281455,51691,51264,3677,54941,434
2022-02-23,San Mateo,081,765935,118524,117585,6866,124451,603
2022-02-23,Santa Barbara,083,443738,84657,84760,4777,89537,651
2022-02-23,Santa Clara,085,1922200,306381,305484,12167,317651,2157
2022-02-23,Santa Cruz,087,273765,46189,46059,2044,48103,251
2022-02-23,Shasta,089,179085,30165,30066,6079,36145,481
2022-02-23,Sierra,091,2930,272,270,41,311,1
2022-02-23,Siskiyou,093,43540,4379,4356,2704,7060,71
2022-02-23,Solano,095,438530,80457,80103,5454,85557,427
2022-02-23,Sonoma,097,501317,82005,81594,2450,84044,432
2022-02-23,Stanislaus,099,539301,116348,116789,16931,133720,1482
2022-02-23,Sutter,101,95872,20303,20194,1981,22175,213
2022-02-23,Tehama,103,63373,11924,11863,2587,14450,154
2022-02-23,Trinity,105,12862,1165,1156,291,1447,20
2022-02-23,Tulare,107,460477,104276,102812,27995,130807,1290
2022-02-23,Tuolumne,109,53932,12479,12158,552,12710,175
2022-02-23,Ventura,111,848112,171393,171163,9183,180346,1401
2022-02-23,Yolo,113,214977,35921,35590,3102,38692,296
2022-02-23,Yuba,115,75493,15629,15571,1173,16744,113
2022-02-22,Alameda,001,1643700,251069,247434,13541,260975,1706
2022-02-22,Alpine,003,1148,122,124,1,125,0
2022-02-22,Amador,005,37829,8332,8243,634,8877,79
2022-02-22,Butte,007,227075,32516,32359,6536,38895,366
2022-02-22,Calaveras,009,45235,7154,7178,346,7524,107
2022-02-22,Colusa,011,21464,3418,3402,1069,4471,21
2022-02-22,Contra Costa,013,1133247,185775,183812,12879,196691,1201
2022-02-22,Del Norte,015,27424,5624,5611,178,5789,45
2022-02-22,El Dorado,017,186661,26409,26289,3169,29458,189
2022-02-22,Fresno,019,978130,227873,225104,22380,247484,2592
2022-02-22,Glenn,021,27897,4927,4900,1555,6455,40
2022-02-22,Humboldt,023,135768,16583,16559,2885,19444,132
2022-02-22,Imperial,025,180216,54712,54227,10913,65140,864
2022-02-22,Inyo,027,18085,4035,4026,462,4488,54
2022-02-22,Kern,029,883053,189743,188237,45783,234020,2102
2022-02-22,Kings,031,150075,50800,50359,3566,53925,423
2022-02-22,Lake,033,64148,10450,10353,874,11227,126
2022-02-22,Lassen,035,31185,8794,8730,888,9618,55
2022-02-22,Los Angeles,037,10098052,2680200,2658230,122001,2780231,30129
2022-02-22,Madera,039,155013,36941,36833,5957,42790,330
2022-02-22,Marin,041,260295,32708,32591,2177,34768,267
2022-02-22,Mariposa,043,17540,2334,2322,194,2516,6
2022-02-22,Mendocino,045,87422,12840,12714,2895,15609,110
2022-02-22,Merced,047,269075,61512,61241,8319,69560,770
2022-02-22,Modoc,049,8938,726,720,249,969,6
2022-02-22,Mono,051,14174,2954,2961,119,3080,5
2022-02-22,Monterey,053,433212,78132,77359,13175,90534,690
2022-02-22,Napa,055,140530,25180,25151,937,26088,128
2022-02-22,Nevada,057,99092,15740,15815,1168,16983,121
2022-02-22,Orange,059,3164182,541013,539390,40668,580058,6502
2022-02-22,Placer,061,380077,61997,61709,7263,68972,572
2022-02-22,Plumas,063,18699,2849,2659,350,3009,13
2022-02-22,Riverside,065,2383286,586513,583969,27803,611772,6097
2022-02-22,Sacramento,067,1510023,273568,271789,26495,298284,2775
2022-02-22,San Benito,069,59416,12763,12742,509,13251,92
2022-02-22,San Bernardino,071,2135413,558657,554903,24389,579292,6451
2022-02-22,San Diego,073,3302833,743073,734536,50655,785191,4974
2022-02-22,San Francisco,075,870044,121572,121954,8195,130149,769
2022-02-22,San Joaquin,077,732212,164731,164111,9056,173167,2040
2022-02-22,San Luis Obispo,079,281455,51606,51193,3671,54864,431
2022-02-22,San Mateo,081,765935,118429,117418,6861,124279,603
2022-02-22,Santa Barbara,083,443738,84594,84701,4771,89472,650
2022-02-22,Santa Clara,085,1922200,306099,305045,12160,317205,2155
2022-02-22,Santa Cruz,087,273765,46123,45958,2044,48002,251
2022-02-22,Shasta,089,179085,30141,30024,6074,36098,479
2022-02-22,Sierra,091,2930,272,269,40,309,0
2022-02-22,Siskiyou,093,43540,4376,4350,2699,7049,70
2022-02-22,Solano,095,438530,80380,79968,5452,85420,425
2022-02-22,Sonoma,097,501317,81937,81412,2446,83858,431
2022-02-22,Stanislaus,099,539301,116269,116676,16913,133589,1475
2022-02-22,Sutter,101,95872,20287,20164,1978,22142,210
2022-02-22,Tehama,103,63373,11916,11852,2586,14438,152
2022-02-22,Trinity,105,12862,1165,1147,290,1437,20
2022-02-22,Tulare,107,460477,104164,102717,27959,130676,1287
2022-02-22,Tuolumne,109,53932,12458,12136,551,12687,175
2022-02-22,Ventura,111,848112,171309,171064,9177,180241,1401
2022-02-22,Yolo,113,214977,35883,35527,3096,38623,292
2022-02-22,Yuba,115,75493,15619,15550,1172,16722,110
2022-02-21,Alameda,001,1643700,250781,247434,13525,260959,1704
2022-02-21,Alpine,003,1148,122,124,1,125,0
2022-02-21,Amador,005,37829,8325,8246,634,8880,79
2022-02-21,Butte,007,227075,32473,32356,6513,38869,366
2022-02-21,Calaveras,009,45235,7146,7175,346,7521,107
2022-02-21,Colusa,011,21464,3416,3401,1067,4468,21
2022-02-21,Contra Costa,013,1133247,185537,183701,12865,196566,1201
2022-02-21,Del Norte,015,27424,5606,5601,177,5778,45
2022-02-21,El Dorado,017,186661,26383,26273,3164,29437,189
2022-02-21,Fresno,019,978130,227550,224923,22321,247244,2592
2022-02-21,Glenn,021,27897,4923,4897,1555,6452,40
2022-02-21,Humboldt,023,135768,16539,16548,2877,19425,132
2022-02-21,Imperial,025,180216,54657,54208,10895,65103,864
2022-02-21,Inyo,027,18085,4031,4023,462,4485,54
2022-02-21,Kern,029,883053,189551,188188,45731,233919,2102
2022-02-21,Kings,031,150075,50733,50188,3563,53751,422
2022-02-21,Lake,033,64148,10427,10334,872,11206,126
2022-02-21,Lassen,035,31185,8786,8705,883,9588,55
2022-02-21,Los Angeles,037,10098052,2678404,2656873,121905,2778778,30108
2022-02-21,Madera,039,155013,36900,36796,5935,42731,330
2022-02-21,Marin,041,260295,32685,32570,2177,34747,258
2022-02-21,Mariposa,043,17540,2331,2321,194,2515,6
2022-02-21,Mendocino,045,87422,12814,12706,2883,15589,110
2022-02-21,Merced,047,269075,61455,61209,8302,69511,770
2022-02-21,Modoc,049,8938,725,718,249,967,6
2022-02-21,Mono,051,14174,2953,2960,119,3079,5
2022-02-21,Monterey,053,433212,78038,77354,13133,90487,690
2022-02-21,Napa,055,140530,25139,25126,937,26063,128
2022-02-21,Nevada,057,99092,15728,15810,1165,16975,121
2022-02-21,Orange,059,3164182,540664,539068,40643,579711,6502
2022-02-21,Placer,061,380077,61940,61727,7259,68986,572
2022-02-21,Plumas,063,18699,2845,2657,345,3002,13
2022-02-21,Riverside,065,2383286,586141,583712,27754,611466,6097
2022-02-21,Sacramento,067,1510023,273306,271588,26461,298049,2769
2022-02-21,San Benito,069,59416,12750,12731,509,13240,92
2022-02-21,San Bernardino,071,2135413,558419,554662,24367,579029,6441
2022-02-21,San Diego,073,3302833,742440,732298,50583,782881,4974
2022-02-21,San Francisco,075,870044,121390,121865,8191,130056,769
2022-02-21,San Joaquin,077,732212,164588,164036,9045,173081,2040
2022-02-21,San Luis Obispo,079,281455,51513,51184,3664,54848,429
2022-02-21,San Mateo,081,765935,118339,117259,6853,124112,605
2022-02-21,Santa Barbara,083,443738,84519,84626,4763,89389,650
2022-02-21,Santa Clara,085,1922200,305757,304858,12154,317012,2158
2022-02-21,Santa Cruz,087,273765,45998,45941,2043,47984,251
2022-02-21,Shasta,089,179085,30094,30004,6066,36070,479
2022-02-21,Sierra,091,2930,272,269,40,309,0
2022-02-21,Siskiyou,093,43540,4364,4337,2694,7031,70
2022-02-21,Solano,095,438530,80282,79906,5446,85352,425
2022-02-21,Sonoma,097,501317,81825,81361,2440,83801,431
2022-02-21,Stanislaus,099,539301,116158,116597,16889,133486,1475
2022-02-21,Sutter,101,95872,20259,20152,1976,22128,210
2022-02-21,Tehama,103,63373,11903,11842,2585,14427,152
2022-02-21,Trinity,105,12862,1164,1147,290,1437,20
2022-02-21,Tulare,107,460477,104066,102614,27907,130521,1287
2022-02-21,Tuolumne,109,53932,12449,12126,548,12674,175
2022-02-21,Ventura,111,848112,171169,170939,9168,180107,1401
2022-02-21,Yolo,113,214977,35841,35518,3087,38605,292
2022-02-21,Yuba,115,75493,15599,15546,1163,16709,110
2022-02-20,Alameda,001,1643700,250556,246028,13515,259543,1700
2022-02-20,Alpine,003,1148,122,124,1,125,0
2022-02-20,Amador,005,37829,8314,8203,634,8837,79
2022-02-20,Butte,007,227075,32443,32173,6508,38681,364
2022-02-20,Calaveras,009,45235,7143,7136,345,7481,107
2022-02-20,Colusa,011,21464,3413,3389,1066,4455,21
2022-02-20,Contra Costa,013,1133247,185409,182797,12860,195657,1190
2022-02-20,Del Norte,015,27424,5591,5511,177,5688,45
2022-02-20,El Dorado,017,186661,26361,26101,3163,29264,189
2022-02-20,Fresno,019,978130,227358,223594,22308,245902,2544
2022-02-20,Glenn,021,27897,4920,4881,1555,6436,39
2022-02-20,Humboldt,023,135768,16527,16393,2873,19266,132
2022-02-20,Imperial,025,180216,54596,53967,10880,64847,862
2022-02-20,Inyo,027,18085,4030,4018,461,4479,52
2022-02-20,Kern,029,883053,189418,187158,45687,232845,2095
2022-02-20,Kings,031,150075,50705,49724,3559,53283,421
2022-02-20,Lake,033,64148,10394,10184,871,11055,126
2022-02-20,Lassen,035,31185,8774,8640,883,9523,55
2022-02-20,Los Angeles,037,10098052,2677084,2642878,121819,2764697,29842
2022-02-20,Madera,039,155013,36868,36526,5931,42457,330
2022-02-20,Marin,041,260295,32668,32441,2176,34617,258
2022-02-20,Mariposa,043,17540,2325,2310,192,2502,6
2022-02-20,Mendocino,045,87422,12804,12625,2880,15505,110
2022-02-20,Merced,047,269075,61427,60886,8300,69186,769
2022-02-20,Modoc,049,8938,724,714,249,963,6
2022-02-20,Mono,051,14174,2953,2956,119,3075,5
2022-02-20,Monterey,053,433212,77978,76765,13118,89883,682
2022-02-20,Napa,055,140530,25119,24970,935,25905,127
2022-02-20,Nevada,057,99092,15717,15715,1164,16879,121
2022-02-20,Orange,059,3164182,540345,538019,40609,578628,6416
2022-02-20,Placer,061,380077,61907,61417,7251,68668,560
2022-02-20,Plumas,063,18699,2841,2646,343,2989,13
2022-02-20,Riverside,065,2383286,585867,581788,27726,609514,6087
2022-02-20,Sacramento,067,1510023,273125,270080,26435,296515,2747
2022-02-20,San Benito,069,59416,12747,12665,509,13174,92
2022-02-20,San Bernardino,071,2135413,558215,553151,24351,577502,6400
2022-02-20,San Diego,073,3302833,741839,729549,50528,780077,4947
2022-02-20,San Francisco,075,870044,121249,121197,8181,129378,756
2022-02-20,San Joaquin,077,732212,164465,163083,9034,172117,2033
2022-02-20,San Luis Obispo,079,281455,51482,50823,3660,54483,424
2022-02-20,San Mateo,081,765935,118267,116648,6845,123493,598
2022-02-20,Santa Barbara,083,443738,84474,83988,4762,88750,642
2022-02-20,Santa Clara,085,1922200,305477,303077,12146,315223,2138
2022-02-20,Santa Cruz,087,273765,45931,45532,2040,47572,250
2022-02-20,Shasta,089,179085,30062,29847,6059,35906,479
2022-02-20,Sierra,091,2930,272,269,40,309,0
2022-02-20,Siskiyou,093,43540,4358,4307,2693,7000,70
2022-02-20,Solano,095,438530,80206,78914,5442,84356,424
2022-02-20,Sonoma,097,501317,81749,80843,2439,83282,431
2022-02-20,Stanislaus,099,539301,116090,115976,16873,132849,1454
2022-02-20,Sutter,101,95872,20246,20060,1973,22033,210
2022-02-20,Tehama,103,63373,11891,11760,2582,14342,152
2022-02-20,Trinity,105,12862,1163,1130,290,1420,20
2022-02-20,Tulare,107,460477,103974,101996,27880,129876,1286
2022-02-20,Tuolumne,109,53932,12426,12036,547,12583,175
2022-02-20,Ventura,111,848112,171072,170331,9163,179494,1384
2022-02-20,Yolo,113,214977,35815,35363,3084,38447,293
2022-02-20,Yuba,115,75493,15583,15449,1162,16611,112
2022-02-19,Alameda,001,1643700,250386,246028,13513,259541,1700
2022-02-19,Alpine,003,1148,122,124,1,125,0
2022-02-19,Amador,005,37829,8310,8203,634,8837,79
2022-02-19,Butte,007,227075,32419,32173,6505,38678,364
2022-02-19,Calaveras,009,45235,7143,7136,345,7481,107
2022-02-19,Colusa,011,21464,3412,3389,1064,4453,21
2022-02-19,Contra Costa,013,1133247,185312,182797,12859,195656,1190
2022-02-19,Del Norte,015,27424,5581,5511,176,5687,45
2022-02-19,El Dorado,017,186661,26345,26101,3161,29262,189
2022-02-19,Fresno,019,978130,227240,223594,22303,245897,2544
2022-02-19,Glenn,021,27897,4916,4881,1555,6436,39
2022-02-19,Humboldt,023,135768,16512,16393,2873,19266,132
2022-02-19,Imperial,025,180216,54579,53967,10873,64840,862
2022-02-19,Inyo,027,18085,4029,4018,460,4478,52
2022-02-19,Kern,029,883053,189319,187158,45662,232820,2095
2022-02-19,Kings,031,150075,50682,49724,3557,53281,421
2022-02-19,Lake,033,64148,10386,10184,871,11055,126
2022-02-19,Lassen,035,31185,8762,8640,882,9522,55
2022-02-19,Los Angeles,037,10098052,2676304,2642878,121778,2764656,29842
2022-02-19,Madera,039,155013,36846,36526,5930,42456,330
2022-02-19,Marin,041,260295,32645,32441,2175,34616,258
2022-02-19,Mariposa,043,17540,2322,2310,192,2502,6
2022-02-19,Mendocino,045,87422,12794,12625,2880,15505,110
2022-02-19,Merced,047,269075,61381,60886,8296,69182,769
2022-02-19,Modoc,049,8938,724,714,248,962,6
2022-02-19,Mono,051,14174,2952,2956,119,3075,5
2022-02-19,Monterey,053,433212,77888,76765,13107,89872,682
2022-02-19,Napa,055,140530,25109,24970,935,25905,127
2022-02-19,Nevada,057,99092,15709,15715,1164,16879,121
2022-02-19,Orange,059,3164182,540147,538019,40585,578604,6416
2022-02-19,Placer,061,380077,61862,61417,7250,68667,560
2022-02-19,Plumas,063,18699,2840,2646,343,2989,13
2022-02-19,Riverside,065,2383286,585688,581788,27712,609500,6087
2022-02-19,Sacramento,067,1510023,272984,270080,26424,296504,2747
2022-02-19,San Benito,069,59416,12733,12665,508,13173,92
2022-02-19,San Bernardino,071,2135413,558055,553151,24344,577495,6400
2022-02-19,San Diego,073,3302833,741479,729549,50486,780035,4947
2022-02-19,San Francisco,075,870044,121162,121197,8177,129374,756
2022-02-19,San Joaquin,077,732212,164389,163083,9023,172106,2033
2022-02-19,San Luis Obispo,079,281455,51470,50823,3656,54479,424
2022-02-19,San Mateo,081,765935,118227,116648,6843,123491,598
2022-02-19,Santa Barbara,083,443738,84405,83988,4761,88749,642
2022-02-19,Santa Clara,085,1922200,305281,303077,12144,315221,2138
2022-02-19,Santa Cruz,087,273765,45893,45532,2039,47571,250
2022-02-19,Shasta,089,179085,30048,29847,6056,35903,479
2022-02-19,Sierra,091,2930,272,269,40,309,0
2022-02-19,Siskiyou,093,43540,4356,4307,2693,7000,70
2022-02-19,Solano,095,438530,80164,78914,5441,84355,424
2022-02-19,Sonoma,097,501317,81704,80843,2439,83282,431
2022-02-19,Stanislaus,099,539301,116020,115976,16867,132843,1454
2022-02-19,Sutter,101,95872,20238,20060,1973,22033,210
2022-02-19,Tehama,103,63373,11884,11760,2582,14342,152
2022-02-19,Trinity,105,12862,1161,1130,290,1420,20
2022-02-19,Tulare,107,460477,103924,101996,27854,129850,1286
2022-02-19,Tuolumne,109,53932,12418,12036,547,12583,175
2022-02-19,Ventura,111,848112,170997,170331,9160,179491,1384
2022-02-19,Yolo,113,214977,35784,35363,3080,38443,293
2022-02-19,Yuba,115,75493,15574,15449,1162,16611,112
2022-02-18,Alameda,001,1643700,250221,246028,13505,259533,1700
2022-02-18,Alpine,003,1148,121,124,1,125,0
2022-02-18,Amador,005,37829,8302,8203,632,8835,79
2022-02-18,Butte,007,227075,32399,32173,6500,38673,364
2022-02-18,Calaveras,009,45235,7138,7136,344,7480,107
2022-02-18,Colusa,011,21464,3410,3389,1064,4453,21
2022-02-18,Contra Costa,013,1133247,185205,182797,12853,195650,1190
2022-02-18,Del Norte,015,27424,5570,5511,176,5687,45
2022-02-18,El Dorado,017,186661,26334,26101,3160,29261,189
2022-02-18,Fresno,019,978130,227052,223594,22294,245888,2544
2022-02-18,Glenn,021,27897,4915,4881,1554,6435,39
2022-02-18,Humboldt,023,135768,16495,16393,2868,19261,132
2022-02-18,Imperial,025,180216,54556,53967,10862,64829,862
2022-02-18,Inyo,027,18085,4028,4018,460,4478,52
2022-02-18,Kern,029,883053,189204,187158,45617,232775,2095
2022-02-18,Kings,031,150075,50594,49724,3557,53281,421
2022-02-18,Lake,033,64148,10369,10184,869,11053,126
2022-02-18,Lassen,035,31185,8742,8640,881,9521,55
2022-02-18,Los Angeles,037,10098052,2675331,2642878,121722,2764600,29842
2022-02-18,Madera,039,155013,36820,36526,5928,42454,330
2022-02-18,Marin,041,260295,32627,32441,2173,34614,258
2022-02-18,Mariposa,043,17540,2320,2310,192,2502,6
2022-02-18,Mendocino,045,87422,12783,12625,2880,15505,110
2022-02-18,Merced,047,269075,61337,60886,8286,69172,769
2022-02-18,Modoc,049,8938,724,714,248,962,6
2022-02-18,Mono,051,14174,2952,2956,119,3075,5
2022-02-18,Monterey,053,433212,77815,76765,13100,89865,682
2022-02-18,Napa,055,140530,25091,24970,935,25905,127
2022-02-18,Nevada,057,99092,15701,15715,1164,16879,121
2022-02-18,Orange,059,3164182,539914,538019,40546,578565,6416
2022-02-18,Placer,061,380077,61832,61417,7242,68659,560
2022-02-18,Plumas,063,18699,2837,2646,343,2989,13
2022-02-18,Riverside,065,2383286,585503,581788,27703,609491,6087
2022-02-18,Sacramento,067,1510023,272789,270080,26416,296496,2747
2022-02-18,San Benito,069,59416,12725,12665,508,13173,92
2022-02-18,San Bernardino,071,2135413,557876,553151,24339,577490,6400
2022-02-18,San Diego,073,3302833,741048,729549,50463,780012,4947
2022-02-18,San Francisco,075,870044,121075,121197,8169,129366,756
2022-02-18,San Joaquin,077,732212,164322,163083,9015,172098,2033
2022-02-18,San Luis Obispo,079,281455,51454,50823,3653,54476,424
2022-02-18,San Mateo,081,765935,118162,116648,6840,123488,598
2022-02-18,Santa Barbara,083,443738,84364,83988,4759,88747,642
2022-02-18,Santa Clara,085,1922200,305043,303077,12143,315220,2138
2022-02-18,Santa Cruz,087,273765,45859,45532,2038,47570,250
2022-02-18,Shasta,089,179085,30036,29847,6055,35902,479
2022-02-18,Sierra,091,2930,272,269,40,309,0
2022-02-18,Siskiyou,093,43540,4353,4307,2691,6998,70
2022-02-18,Solano,095,438530,80093,78914,5440,84354,424
2022-02-18,Sonoma,097,501317,81647,80843,2438,83281,431
2022-02-18,Stanislaus,099,539301,115970,115976,16853,132829,1454
2022-02-18,Sutter,101,95872,20227,20060,1973,22033,210
2022-02-18,Tehama,103,63373,11873,11760,2582,14342,152
2022-02-18,Trinity,105,12862,1160,1130,289,1419,20
2022-02-18,Tulare,107,460477,103882,101996,27810,129806,1286
2022-02-18,Tuolumne,109,53932,12411,12036,546,12582,175
2022-02-18,Ventura,111,848112,170907,170331,9156,179487,1384
2022-02-18,Yolo,113,214977,35756,35363,3078,38441,293
2022-02-18,Yuba,115,75493,15561,15449,1162,16611,112
2022-02-17,Alameda,001,1643700,249956,246028,13483,259511,1700
2022-02-17,Alpine,003,1148,121,124,1,125,0
2022-02-17,Amador,005,37829,8298,8203,630,8833,79
2022-02-17,Butte,007,227075,32361,32173,6495,38668,364
2022-02-17,Calaveras,009,45235,7129,7136,341,7477,107
2022-02-17,Colusa,011,21464,3407,3389,1064,4453,21
2022-02-17,Contra Costa,013,1133247,185010,182797,12819,195616,1190
2022-02-17,Del Norte,015,27424,5549,5511,176,5687,45
2022-02-17,El Dorado,017,186661,26308,26101,3150,29251,189
2022-02-17,Fresno,019,978130,226762,223594,22267,245861,2544
2022-02-17,Glenn,021,27897,4913,4881,1551,6432,39
2022-02-17,Humboldt,023,135768,16454,16393,2867,19260,132
2022-02-17,Imperial,025,180216,54489,53967,10840,64807,862
2022-02-17,Inyo,027,18085,4027,4018,459,4477,52
2022-02-17,Kern,029,883053,189051,187158,45565,232723,2095
2022-02-17,Kings,031,150075,50529,49724,3551,53275,421
2022-02-17,Lake,033,64148,10339,10184,865,11049,126
2022-02-17,Lassen,035,31185,8732,8640,879,9519,55
2022-02-17,Los Angeles,037,10098052,2673503,2642878,121640,2764518,29842
2022-02-17,Madera,039,155013,36774,36526,5922,42448,330
2022-02-17,Marin,041,260295,32600,32441,2171,34612,258
2022-02-17,Mariposa,043,17540,2317,2310,191,2501,6
2022-02-17,Mendocino,045,87422,12766,12625,2877,15502,110
2022-02-17,Merced,047,269075,61261,60886,8268,69154,769
2022-02-17,Modoc,049,8938,723,714,248,962,6
2022-02-17,Mono,051,14174,2950,2956,119,3075,5
2022-02-17,Monterey,053,433212,77702,76765,13058,89823,682
2022-02-17,Napa,055,140530,25060,24970,933,25903,127
2022-02-17,Nevada,057,99092,15689,15715,1163,16878,121
2022-02-17,Orange,059,3164182,539584,538019,40518,578537,6416
2022-02-17,Placer,061,380077,61791,61417,7234,68651,560
2022-02-17,Plumas,063,18699,2834,2646,343,2989,13
2022-02-17,Riverside,065,2383286,585118,581788,27676,609464,6087
2022-02-17,Sacramento,067,1510023,272498,270080,26368,296448,2747
2022-02-17,San Benito,069,59416,12714,12665,508,13173,92
2022-02-17,San Bernardino,071,2135413,557576,553151,24328,577479,6400
2022-02-17,San Diego,073,3302833,740430,729549,50418,779967,4947
2022-02-17,San Francisco,075,870044,120940,121197,8158,129355,756
2022-02-17,San Joaquin,077,732212,164160,163083,9001,172084,2033
2022-02-17,San Luis Obispo,079,281455,51350,50823,3645,54468,424
2022-02-17,San Mateo,081,765935,118068,116648,6831,123479,598
2022-02-17,Santa Barbara,083,443738,84261,83988,4751,88739,642
2022-02-17,Santa Clara,085,1922200,304679,303077,12128,315205,2138
2022-02-17,Santa Cruz,087,273765,45778,45532,2036,47568,250
2022-02-17,Shasta,089,179085,30008,29847,6052,35899,479
2022-02-17,Sierra,091,2930,272,269,40,309,0
2022-02-17,Siskiyou,093,43540,4344,4307,2687,6994,70
2022-02-17,Solano,095,438530,80010,78914,5433,84347,424
2022-02-17,Sonoma,097,501317,81580,80843,2431,83274,431
2022-02-17,Stanislaus,099,539301,115866,115976,16835,132811,1454
2022-02-17,Sutter,101,95872,20212,20060,1965,22025,210
2022-02-17,Tehama,103,63373,11864,11760,2580,14340,152
2022-02-17,Trinity,105,12862,1158,1130,287,1417,20
2022-02-17,Tulare,107,460477,103766,101996,27782,129778,1286
2022-02-17,Tuolumne,109,53932,12400,12036,546,12582,175
2022-02-17,Ventura,111,848112,170767,170331,9155,179486,1384
2022-02-17,Yolo,113,214977,35718,35363,3077,38440,293
2022-02-17,Yuba,115,75493,15546,15449,1162,16611,112
2022-02-16,Alameda,001,1643700,249640,245662,13444,259106,1691
2022-02-16,Alpine,003,1148,121,124,1,125,0
2022-02-16,Amador,005,37829,8280,8197,628,8825,77
2022-02-16,Butte,007,227075,32319,32095,6483,38578,363
2022-02-16,Calaveras,009,45235,7123,7129,338,7467,107
2022-02-16,Colusa,011,21464,3402,3384,1064,4448,21
2022-02-16,Contra Costa,013,1133247,184771,182423,12781,195204,1179
2022-02-16,Del Norte,015,27424,5527,5473,172,5645,45
2022-02-16,El Dorado,017,186661,26280,26061,3146,29207,189
2022-02-16,Fresno,019,978130,226401,223056,22223,245279,2542
2022-02-16,Glenn,021,27897,4909,4873,1546,6419,39
2022-02-16,Humboldt,023,135768,16428,16342,2856,19198,132
2022-02-16,Imperial,025,180216,54419,53901,10806,64707,861
2022-02-16,Inyo,027,18085,4023,4013,456,4469,52
2022-02-16,Kern,029,883053,188831,186740,45474,232214,2084
2022-02-16,Kings,031,150075,50476,49575,3542,53117,420
2022-02-16,Lake,033,64148,10313,10145,865,11010,125
2022-02-16,Lassen,035,31185,8699,8618,879,9497,55
2022-02-16,Los Angeles,037,10098052,2671416,2640005,121528,2761533,29749
2022-02-16,Madera,039,155013,36706,36382,5907,42289,330
2022-02-16,Marin,041,260295,32564,32381,2168,34549,257
2022-02-16,Mariposa,043,17540,2315,2305,191,2496,6
2022-02-16,Mendocino,045,87422,12744,12605,2867,15472,108
2022-02-16,Merced,047,269075,61195,60776,8235,69011,767
2022-02-16,Modoc,049,8938,723,711,244,955,6
2022-02-16,Mono,051,14174,2948,2953,119,3072,5
2022-02-16,Monterey,053,433212,77551,76624,13017,89641,682
2022-02-16,Napa,055,140530,25021,24897,930,25827,128
2022-02-16,Nevada,057,99092,15672,15677,1159,16836,121
2022-02-16,Orange,059,3164182,539192,537934,40472,578406,6392
2022-02-16,Placer,061,380077,61743,61278,7221,68499,556
2022-02-16,Plumas,063,18699,2831,2644,341,2985,13
2022-02-16,Riverside,065,2383286,584728,580828,27629,608457,6064
2022-02-16,Sacramento,067,1510023,272171,269416,26312,295728,2736
2022-02-16,San Benito,069,59416,12688,12644,508,13152,92
2022-02-16,San Bernardino,071,2135413,557299,552353,24303,576656,6379
2022-02-16,San Diego,073,3302833,739650,728610,50341,778951,4931
2022-02-16,San Francisco,075,870044,120768,120987,8153,129140,756
2022-02-16,San Joaquin,077,732212,163990,162752,8991,171743,2032
2022-02-16,San Luis Obispo,079,281455,51281,50704,3632,54336,425
2022-02-16,San Mateo,081,765935,117951,116438,6812,123250,595
2022-02-16,Santa Barbara,083,443738,84186,83968,4738,88706,642
2022-02-16,Santa Clara,085,1922200,304296,302439,12091,314530,2130
2022-02-16,Santa Cruz,087,273765,45687,45274,2034,47308,250
2022-02-16,Shasta,089,179085,29969,29767,6040,35807,477
2022-02-16,Sierra,091,2930,271,269,40,309,0
2022-02-16,Siskiyou,093,43540,4337,4302,2681,6983,71
2022-02-16,Solano,095,438530,79893,78742,5426,84168,422
2022-02-16,Sonoma,097,501317,81459,80642,2421,83063,431
2022-02-16,Stanislaus,099,539301,115745,115751,16804,132555,1443
2022-02-16,Sutter,101,95872,20195,20020,1962,21982,210
2022-02-16,Tehama,103,63373,11846,11738,2578,14316,152
2022-02-16,Trinity,105,12862,1158,1130,286,1416,20
2022-02-16,Tulare,107,460477,103641,101817,27728,129545,1281
2022-02-16,Tuolumne,109,53932,12388,11991,545,12536,171
2022-02-16,Ventura,111,848112,170632,170117,9147,179264,1372
2022-02-16,Yolo,113,214977,35665,35284,3074,38358,292
2022-02-16,Yuba,115,75493,15521,15405,1159,16564,110
2022-02-15,Alameda,001,1643700,249290,245265,13416,258681,1683
2022-02-15,Alpine,003,1148,121,124,1,125,0
2022-02-15,Amador,005,37829,8269,8183,627,8810,77
2022-02-15,Butte,007,227075,32267,32011,6469,38480,361
2022-02-15,Calaveras,009,45235,7114,7115,338,7453,106
2022-02-15,Colusa,011,21464,3394,3374,1063,4437,21
2022-02-15,Contra Costa,013,1133247,184509,182041,12750,194791,1179
2022-02-15,Del Norte,015,27424,5501,5439,170,5609,45
2022-02-15,El Dorado,017,186661,26260,25988,3141,29129,189
2022-02-15,Fresno,019,978130,226016,222673,22158,244831,2543
2022-02-15,Glenn,021,27897,4900,4862,1545,6407,39
2022-02-15,Humboldt,023,135768,16383,16297,2841,19138,132
2022-02-15,Imperial,025,180216,54356,53813,10786,64599,860
2022-02-15,Inyo,027,18085,4022,4009,455,4464,52
2022-02-15,Kern,029,883053,188611,186324,45383,231707,2072
2022-02-15,Kings,031,150075,50382,49473,3533,53006,418
2022-02-15,Lake,033,64148,10279,10112,859,10971,123
2022-02-15,Lassen,035,31185,8684,8587,877,9464,55
2022-02-15,Los Angeles,037,10098052,2669164,2638266,121391,2759657,29691
2022-02-15,Madera,039,155013,36641,36260,5883,42143,330
2022-02-15,Marin,041,260295,32522,32355,2166,34521,255
2022-02-15,Mariposa,043,17540,2314,2302,191,2493,6
2022-02-15,Mendocino,045,87422,12727,12580,2847,15427,108
2022-02-15,Merced,047,269075,61111,60674,8202,68876,763
2022-02-15,Modoc,049,8938,721,710,241,951,6
2022-02-15,Mono,051,14174,2947,2952,119,3071,5
2022-02-15,Monterey,053,433212,77426,75530,12957,88487,682
2022-02-15,Napa,055,140530,24970,24832,923,25755,127
2022-02-15,Nevada,057,99092,15645,15643,1158,16801,121
2022-02-15,Orange,059,3164182,538743,537478,40430,577908,6374
2022-02-15,Placer,061,380077,61680,61170,7210,68380,554
2022-02-15,Plumas,063,18699,2827,2638,341,2979,13
2022-02-15,Riverside,065,2383286,584232,579940,27569,607509,6049
2022-02-15,Sacramento,067,1510023,271784,268950,26227,295177,2721
2022-02-15,San Benito,069,59416,12669,12616,508,13124,91
2022-02-15,San Bernardino,071,2135413,556929,551803,24280,576083,6372
2022-02-15,San Diego,073,3302833,738660,727486,50253,777739,4914
2022-02-15,San Francisco,075,870044,120596,120759,8141,128900,756
2022-02-15,San Joaquin,077,732212,163773,162518,8977,171495,2021
2022-02-15,San Luis Obispo,079,281455,51178,50534,3617,54151,419
2022-02-15,San Mateo,081,765935,117814,116253,6791,123044,595
2022-02-15,Santa Barbara,083,443738,84050,83734,4724,88458,640
2022-02-15,Santa Clara,085,1922200,303793,301831,12052,313883,2130
2022-02-15,Santa Cruz,087,273765,45581,45171,2029,47200,250
2022-02-15,Shasta,089,179085,29920,29684,6026,35710,477
2022-02-15,Sierra,091,2930,271,269,40,309,0
2022-02-15,Siskiyou,093,43540,4330,4288,2674,6962,70
2022-02-15,Solano,095,438530,79753,78626,5419,84045,426
2022-02-15,Sonoma,097,501317,81340,80433,2416,82849,431
2022-02-15,Stanislaus,099,539301,115605,115549,16767,132316,1429
2022-02-15,Sutter,101,95872,20168,19980,1957,21937,208
2022-02-15,Tehama,103,63373,11829,11717,2576,14293,151
2022-02-15,Trinity,105,12862,1152,1125,283,1408,20
2022-02-15,Tulare,107,460477,103484,101645,27670,129315,1278
2022-02-15,Tuolumne,109,53932,12368,11945,543,12488,171
2022-02-15,Ventura,111,848112,170460,169942,9138,179080,1372
2022-02-15,Yolo,113,214977,35614,35241,3064,38305,289
2022-02-15,Yuba,115,75493,15492,15372,1154,16526,109
2022-02-14,Alameda,001,1643700,248851,244315,13383,257698,1677
2022-02-14,Alpine,003,1148,121,125,1,126,0
2022-02-14,Amador,005,37829,8254,8164,624,8788,77
2022-02-14,Butte,007,227075,32206,31946,6455,38401,360
2022-02-14,Calaveras,009,45235,7102,7097,336,7433,106
2022-02-14,Colusa,011,21464,3391,3367,1059,4426,21
2022-02-14,Contra Costa,013,1133247,184215,181753,12709,194462,1167
2022-02-14,Del Norte,015,27424,5478,5426,169,5595,45
2022-02-14,El Dorado,017,186661,26225,25915,3133,29048,188
2022-02-14,Fresno,019,978130,225530,222360,22072,244432,2538
2022-02-14,Glenn,021,27897,4894,4854,1545,6399,39
2022-02-14,Humboldt,023,135768,16342,16264,2816,19080,132
2022-02-14,Imperial,025,180216,54286,53765,10753,64518,860
2022-02-14,Inyo,027,18085,4021,4010,454,4464,52
2022-02-14,Kern,029,883053,188264,186037,45274,231311,2063
2022-02-14,Kings,031,150075,50276,49395,3522,52917,419
2022-02-14,Lake,033,64148,10244,10090,856,10946,123
2022-02-14,Lassen,035,31185,8673,8539,875,9414,55
2022-02-14,Los Angeles,037,10098052,2666584,2636064,121261,2757325,29650
2022-02-14,Madera,039,155013,36573,36194,5860,42054,330
2022-02-14,Marin,041,260295,32486,32304,2163,34467,255
2022-02-14,Mariposa,043,17540,2308,2295,191,2486,6
2022-02-14,Mendocino,045,87422,12699,12541,2815,15356,108
2022-02-14,Merced,047,269075,61021,60591,8156,68747,758
2022-02-14,Modoc,049,8938,716,707,241,948,6
2022-02-14,Mono,051,14174,2946,2954,119,3073,5
2022-02-14,Monterey,053,433212,77250,75407,12875,88282,678
2022-02-14,Napa,055,140530,24911,24776,923,25699,127
2022-02-14,Nevada,057,99092,15626,15629,1157,16786,121
2022-02-14,Orange,059,3164182,538239,536924,40368,577292,6355
2022-02-14,Placer,061,380077,61604,61123,7195,68318,554
2022-02-14,Plumas,063,18699,2826,2631,339,2970,13
2022-02-14,Riverside,065,2383286,583675,579174,27499,606673,5994
2022-02-14,Sacramento,067,1510023,271332,268547,26113,294660,2717
2022-02-14,San Benito,069,59416,12645,12598,506,13104,91
2022-02-14,San Bernardino,071,2135413,556496,551338,24260,575598,6372
2022-02-14,San Diego,073,3302833,737669,723902,50164,774066,4894
2022-02-14,San Francisco,075,870044,120406,120581,8131,128712,756
2022-02-14,San Joaquin,077,732212,163533,162363,8954,171317,2018
2022-02-14,San Luis Obispo,079,281455,51054,50465,3606,54071,416
2022-02-14,San Mateo,081,765935,117646,116129,6782,122911,592
2022-02-14,Santa Barbara,083,443738,83903,83697,4713,88410,636
2022-02-14,Santa Clara,085,1922200,303242,301319,12028,313347,2127
2022-02-14,Santa Cruz,087,273765,45415,45042,2025,47067,250
2022-02-14,Shasta,089,179085,29835,29595,6008,35603,474
2022-02-14,Sierra,091,2930,271,269,40,309,0
2022-02-14,Siskiyou,093,43540,4317,4278,2660,6938,69
2022-02-14,Solano,095,438530,79562,78533,5408,83941,427
2022-02-14,Sonoma,097,501317,81196,80336,2406,82742,431
2022-02-14,Stanislaus,099,539301,115424,115426,16721,132147,1406
2022-02-14,Sutter,101,95872,20139,19957,1951,21908,209
2022-02-14,Tehama,103,63373,11805,11686,2575,14261,151
2022-02-14,Trinity,105,12862,1149,1123,283,1406,20
2022-02-14,Tulare,107,460477,103274,101448,27567,129015,1276
2022-02-14,Tuolumne,109,53932,12337,11920,540,12460,170
2022-02-14,Ventura,111,848112,170283,169725,9126,178851,1361
2022-02-14,Yolo,113,214977,35551,35112,3054,38166,286
2022-02-14,Yuba,115,75493,15462,15375,1150,16525,108
2022-02-13,Alameda,001,1643700,248347,243681,13351,257032,1677
2022-02-13,Alpine,003,1148,121,125,1,126,0
2022-02-13,Amador,005,37829,8225,8146,621,8767,77
2022-02-13,Butte,007,227075,32129,31865,6432,38297,360
2022-02-13,Calaveras,009,45235,7094,7083,333,7416,106
2022-02-13,Colusa,011,21464,3387,3366,1057,4423,21
2022-02-13,Contra Costa,013,1133247,183830,181313,12643,193956,1159
2022-02-13,Del Norte,015,27424,5446,5379,169,5548,45
2022-02-13,El Dorado,017,186661,26188,25871,3124,28995,188
2022-02-13,Fresno,019,978130,224985,221686,22018,243704,2537
2022-02-13,Glenn,021,27897,4884,4847,1542,6389,39
2022-02-13,Humboldt,023,135768,16294,16210,2789,18999,132
2022-02-13,Imperial,025,180216,54200,53658,10707,64365,860
2022-02-13,Inyo,027,18085,4018,4006,452,4458,52
2022-02-13,Kern,029,883053,188018,185640,45187,230827,2063
2022-02-13,Kings,031,150075,50149,49243,3508,52751,416
2022-02-13,Lake,033,64148,10181,10042,848,10890,123
2022-02-13,Lassen,035,31185,8642,8503,873,9376,55
2022-02-13,Los Angeles,037,10098052,2663419,2631267,121119,2752386,29595
2022-02-13,Madera,039,155013,36454,36054,5831,41885,330
2022-02-13,Marin,041,260295,32414,32222,2156,34378,255
2022-02-13,Mariposa,043,17540,2302,2292,189,2481,6
2022-02-13,Mendocino,045,87422,12668,12521,2773,15294,108
2022-02-13,Merced,047,269075,60876,60460,8102,68562,758
2022-02-13,Modoc,049,8938,714,704,234,938,6
2022-02-13,Mono,051,14174,2944,2949,119,3068,5
2022-02-13,Monterey,053,433212,77041,75295,12803,88098,678
2022-02-13,Napa,055,140530,24833,24743,920,25663,127
2022-02-13,Nevada,057,99092,15591,15590,1150,16740,121
2022-02-13,Orange,059,3164182,537610,536134,40306,576440,6355
2022-02-13,Placer,061,380077,61526,61020,7171,68191,554
2022-02-13,Plumas,063,18699,2818,2626,336,2962,13
2022-02-13,Riverside,065,2383286,583074,578363,27454,605817,5995
2022-02-13,Sacramento,067,1510023,270821,267947,25976,293923,2699
2022-02-13,San Benito,069,59416,12611,12578,505,13083,91
2022-02-13,San Bernardino,071,2135413,555974,550632,24227,574859,6367
2022-02-13,San Diego,073,3302833,736489,723902,50061,773963,4894
2022-02-13,San Francisco,075,870044,120150,120295,8119,128414,756
2022-02-13,San Joaquin,077,732212,163221,162028,8925,170953,2018
2022-02-13,San Luis Obispo,079,281455,50911,50384,3598,53982,415
2022-02-13,San Mateo,081,765935,117422,115876,6757,122633,592
2022-02-13,Santa Barbara,083,443738,83738,83547,4705,88252,635
2022-02-13,Santa Clara,085,1922200,302584,300412,11990,312402,2114
2022-02-13,Santa Cruz,087,273765,45258,44887,2023,46910,240
2022-02-13,Shasta,089,179085,29753,29531,5983,35514,474
2022-02-13,Sierra,091,2930,271,269,40,309,0
2022-02-13,Siskiyou,093,43540,4310,4264,2644,6908,69
2022-02-13,Solano,095,438530,79404,78424,5385,83809,426
2022-02-13,Sonoma,097,501317,81030,80172,2398,82570,431
2022-02-13,Stanislaus,099,539301,115217,115156,16680,131836,1406
2022-02-13,Sutter,101,95872,20098,19900,1951,21851,209
2022-02-13,Tehama,103,63373,11776,11644,2570,14214,151
2022-02-13,Trinity,105,12862,1146,1120,280,1400,20
2022-02-13,Tulare,107,460477,103050,101135,27470,128605,1276
2022-02-13,Tuolumne,109,53932,12312,11891,535,12426,170
2022-02-13,Ventura,111,848112,170087,169422,9106,178528,1361
2022-02-13,Yolo,113,214977,35482,35057,3042,38099,286
2022-02-13,Yuba,115,75493,15428,15346,1148,16494,107
2022-02-12,Alameda,001,1643700,248127,242137,13337,255474,1668
2022-02-12,Alpine,003,1148,121,124,1,125,0
2022-02-12,Amador,005,37829,8219,8091,621,8712,76
2022-02-12,Butte,007,227075,32102,31601,6427,38028,360
2022-02-12,Calaveras,009,45235,7091,7022,332,7354,106
2022-02-12,Colusa,011,21464,3383,3345,1057,4402,21
2022-02-12,Contra Costa,013,1133247,183638,180270,12636,192906,1141
2022-02-12,Del Norte,015,27424,5426,5262,169,5431,45
2022-02-12,El Dorado,017,186661,26172,25692,3124,28816,188
2022-02-12,Fresno,019,978130,224770,219909,22009,241918,2509
2022-02-12,Glenn,021,27897,4883,4818,1541,6359,39
2022-02-12,Humboldt,023,135768,16270,16058,2785,18843,132
2022-02-12,Imperial,025,180216,54157,53304,10696,64000,860
2022-02-12,Inyo,027,18085,4016,3991,452,4443,52
2022-02-12,Kern,029,883053,187910,184639,45150,229789,2037
2022-02-12,Kings,031,150075,50108,48893,3501,52394,415
2022-02-12,Lake,033,64148,10160,9926,843,10769,123
2022-02-12,Lassen,035,31185,8619,8477,872,9349,55
2022-02-12,Los Angeles,037,10098052,2662282,2616426,121043,2737469,29364
2022-02-12,Madera,039,155013,36421,35710,5823,41533,330
2022-02-12,Marin,041,260295,32381,32048,2153,34201,255
2022-02-12,Mariposa,043,17540,2302,2286,189,2475,6
2022-02-12,Mendocino,045,87422,12652,12439,2773,15212,107
2022-02-12,Merced,047,269075,60824,60187,8097,68284,758
2022-02-12,Modoc,049,8938,714,697,234,931,6
2022-02-12,Mono,051,14174,2944,2939,119,3058,5
2022-02-12,Monterey,053,433212,76981,74842,12780,87622,672
2022-02-12,Napa,055,140530,24805,24530,920,25450,124
2022-02-12,Nevada,057,99092,15579,15499,1148,16647,119
2022-02-12,Orange,059,3164182,537323,534503,40270,574773,6305
2022-02-12,Placer,061,380077,61465,60636,7168,67804,554
2022-02-12,Plumas,063,18699,2817,2617,335,2952,13
2022-02-12,Riverside,065,2383286,582714,575566,27430,602996,5961
2022-02-12,Sacramento,067,1510023,270582,266347,25966,292313,2686
2022-02-12,San Benito,069,59416,12598,12526,505,13031,91
2022-02-12,San Bernardino,071,2135413,555740,548822,24214,573036,6360
2022-02-12,San Diego,073,3302833,735968,720287,50014,770301,4854
2022-02-12,San Francisco,075,870044,120029,119113,8108,127221,740
2022-02-12,San Joaquin,077,732212,163093,161234,8920,170154,2014
2022-02-12,San Luis Obispo,079,281455,50875,50064,3594,53658,416
2022-02-12,San Mateo,081,765935,117331,115235,6749,121984,589
2022-02-12,Santa Barbara,083,443738,83649,83390,4695,88085,631
2022-02-12,Santa Clara,085,1922200,302226,298176,11982,310158,2093
2022-02-12,Santa Cruz,087,273765,45221,44447,2021,46468,239
2022-02-12,Shasta,089,179085,29725,29370,5979,35349,473
2022-02-12,Sierra,091,2930,271,268,40,308,0
2022-02-12,Siskiyou,093,43540,4303,4231,2641,6872,68
2022-02-12,Solano,095,438530,79361,77865,5382,83247,424
2022-02-12,Sonoma,097,501317,80924,79533,2396,81929,431
2022-02-12,Stanislaus,099,539301,115095,114531,16668,131199,1406
2022-02-12,Sutter,101,95872,20083,19800,1951,21751,211
2022-02-12,Tehama,103,63373,11762,11580,2570,14150,151
2022-02-12,Trinity,105,12862,1145,1115,280,1395,20
2022-02-12,Tulare,107,460477,102953,100434,27430,127864,1273
2022-02-12,Tuolumne,109,53932,12294,11754,535,12289,125
2022-02-12,Ventura,111,848112,169980,168736,9101,177837,1340
2022-02-12,Yolo,113,214977,35441,34773,3039,37812,286
2022-02-12,Yuba,115,75493,15412,15242,1147,16389,107
2022-02-11,Alameda,001,1643700,247845,242137,13323,255460,1668
2022-02-11,Alpine,003,1148,121,124,1,125,0
2022-02-11,Amador,005,37829,8206,8091,621,8712,76
2022-02-11,Butte,007,227075,32058,31601,6416,38017,360
2022-02-11,Calaveras,009,45235,7088,7022,332,7354,106
2022-02-11,Colusa,011,21464,3381,3345,1056,4401,21
2022-02-11,Contra Costa,013,1133247,183427,180270,12617,192887,1141
2022-02-11,Del Norte,015,27424,5411,5262,168,5430,45
2022-02-11,El Dorado,017,186661,26151,25692,3123,28815,188
2022-02-11,Fresno,019,978130,224474,219909,21997,241906,2509
2022-02-11,Glenn,021,27897,4879,4818,1541,6359,39
2022-02-11,Humboldt,023,135768,16240,16058,2780,18838,132
2022-02-11,Imperial,025,180216,54126,53304,10685,63989,860
2022-02-11,Inyo,027,18085,4013,3991,447,4438,52
2022-02-11,Kern,029,883053,187747,184639,45096,229735,2037
2022-02-11,Kings,031,150075,50069,48893,3500,52393,415
2022-02-11,Lake,033,64148,10134,9926,841,10767,123
2022-02-11,Lassen,035,31185,8579,8477,872,9349,55
2022-02-11,Los Angeles,037,10098052,2660645,2616426,120957,2737383,29364
2022-02-11,Madera,039,155013,36378,35710,5818,41528,330
2022-02-11,Marin,041,260295,32347,32048,2150,34198,255
2022-02-11,Mariposa,043,17540,2297,2286,189,2475,6
2022-02-11,Mendocino,045,87422,12636,12439,2773,15212,107
2022-02-11,Merced,047,269075,60774,60187,8090,68277,758
2022-02-11,Modoc,049,8938,712,697,234,931,6
2022-02-11,Mono,051,14174,2943,2939,119,3058,5
2022-02-11,Monterey,053,433212,76862,74842,12765,87607,672
2022-02-11,Napa,055,140530,24777,24530,920,25450,124
2022-02-11,Nevada,057,99092,15564,15499,1145,16644,119
2022-02-11,Orange,059,3164182,536973,534503,40205,574708,6305
2022-02-11,Placer,061,380077,61413,60636,7166,67802,554
2022-02-11,Plumas,063,18699,2813,2617,333,2950,13
2022-02-11,Riverside,065,2383286,582287,575566,27413,602979,5961
2022-02-11,Sacramento,067,1510023,270320,266347,25953,292300,2686
2022-02-11,San Benito,069,59416,12593,12526,505,13031,91
2022-02-11,San Bernardino,071,2135413,555417,548822,24199,573021,6360
2022-02-11,San Diego,073,3302833,735245,720287,49961,770248,4854
2022-02-11,San Francisco,075,870044,119908,119113,8091,127204,740
2022-02-11,San Joaquin,077,732212,162921,161234,8909,170143,2014
2022-02-11,San Luis Obispo,079,281455,50838,50064,3590,53654,416
2022-02-11,San Mateo,081,765935,117214,115235,6740,121975,589
2022-02-11,Santa Barbara,083,443738,83565,83390,4694,88084,631
2022-02-11,Santa Clara,085,1922200,301785,298176,11963,310139,2093
2022-02-11,Santa Cruz,087,273765,45128,44447,2021,46468,239
2022-02-11,Shasta,089,179085,29694,29370,5971,35341,473
2022-02-11,Sierra,091,2930,270,268,39,307,0
2022-02-11,Siskiyou,093,43540,4292,4231,2635,6866,68
2022-02-11,Solano,095,438530,79227,77865,5377,83242,424
2022-02-11,Sonoma,097,501317,80835,79533,2394,81927,431
2022-02-11,Stanislaus,099,539301,114995,114531,16655,131186,1406
2022-02-11,Sutter,101,95872,20059,19800,1949,21749,211
2022-02-11,Tehama,103,63373,11749,11580,2569,14149,151
2022-02-11,Trinity,105,12862,1144,1115,279,1394,20
2022-02-11,Tulare,107,460477,102836,100434,27376,127810,1273
2022-02-11,Tuolumne,109,53932,12279,11754,533,12287,125
2022-02-11,Ventura,111,848112,169839,168736,9096,177832,1340
2022-02-11,Yolo,113,214977,35408,34773,3037,37810,286
2022-02-11,Yuba,115,75493,15396,15242,1146,16388,107
2022-02-10,Alameda,001,1643700,247306,242137,13277,255414,1668
2022-02-10,Alpine,003,1148,121,124,1,125,0
2022-02-10,Amador,005,37829,8195,8091,614,8705,76
2022-02-10,Butte,007,227075,32006,31601,6404,38005,360
2022-02-10,Calaveras,009,45235,7076,7022,330,7352,106
2022-02-10,Colusa,011,21464,3375,3345,1054,4399,21
2022-02-10,Contra Costa,013,1133247,183054,180270,12552,192822,1141
2022-02-10,Del Norte,015,27424,5381,5262,166,5428,45
2022-02-10,El Dorado,017,186661,26103,25692,3116,28808,188
2022-02-10,Fresno,019,978130,223881,219909,21914,241823,2509
2022-02-10,Glenn,021,27897,4873,4818,1539,6357,39
2022-02-10,Humboldt,023,135768,16189,16058,2757,18815,132
2022-02-10,Imperial,025,180216,54056,53304,10636,63940,860
2022-02-10,Inyo,027,18085,4009,3991,447,4438,52
2022-02-10,Kern,029,883053,187440,184639,44983,229622,2037
2022-02-10,Kings,031,150075,49956,48893,3489,52382,415
2022-02-10,Lake,033,64148,10103,9926,839,10765,123
2022-02-10,Lassen,035,31185,8565,8477,870,9347,55
2022-02-10,Los Angeles,037,10098052,2657489,2616426,120767,2737193,29364
2022-02-10,Madera,039,155013,36278,35710,5785,41495,330
2022-02-10,Marin,041,260295,32289,32048,2138,34186,255
2022-02-10,Mariposa,043,17540,2293,2286,188,2474,6
2022-02-10,Mendocino,045,87422,12616,12439,2749,15188,107
2022-02-10,Merced,047,269075,60647,60187,8035,68222,758
2022-02-10,Modoc,049,8938,711,697,233,930,6
2022-02-10,Mono,051,14174,2941,2939,118,3057,5
2022-02-10,Monterey,053,433212,76676,74842,12677,87519,672
2022-02-10,Napa,055,140530,24710,24530,918,25448,124
2022-02-10,Nevada,057,99092,15538,15499,1144,16643,119
2022-02-10,Orange,059,3164182,536321,534503,40136,574639,6305
2022-02-10,Placer,061,380077,61332,60636,7157,67793,554
2022-02-10,Plumas,063,18699,2810,2617,326,2943,13
2022-02-10,Riverside,065,2383286,581546,575566,27355,602921,5961
2022-02-10,Sacramento,067,1510023,269830,266347,25865,292212,2686
2022-02-10,San Benito,069,59416,12570,12526,503,13029,91
2022-02-10,San Bernardino,071,2135413,554867,548822,24167,572989,6360
2022-02-10,San Diego,073,3302833,734091,720287,49840,770127,4854
2022-02-10,San Francisco,075,870044,119694,119113,8073,127186,740
2022-02-10,San Joaquin,077,732212,162603,161234,8902,170136,2014
2022-02-10,San Luis Obispo,079,281455,50738,50064,3579,53643,416
2022-02-10,San Mateo,081,765935,116986,115235,6723,121958,589
2022-02-10,Santa Barbara,083,443738,83381,83390,4686,88076,631
2022-02-10,Santa Clara,085,1922200,301090,298176,11904,310080,2093
2022-02-10,Santa Cruz,087,273765,44983,44447,2020,46467,239
2022-02-10,Shasta,089,179085,29632,29370,5951,35321,473
2022-02-10,Sierra,091,2930,270,268,39,307,0
2022-02-10,Siskiyou,093,43540,4287,4231,2622,6853,68
2022-02-10,Solano,095,438530,79033,77865,5360,83225,424
2022-02-10,Sonoma,097,501317,80700,79533,2379,81912,431
2022-02-10,Stanislaus,099,539301,114813,114531,16610,131141,1406
2022-02-10,Sutter,101,95872,20020,19800,1934,21734,211
2022-02-10,Tehama,103,63373,11716,11580,2566,14146,151
2022-02-10,Trinity,105,12862,1141,1115,278,1393,20
2022-02-10,Tulare,107,460477,102632,100434,27294,127728,1273
2022-02-10,Tuolumne,109,53932,12257,11754,528,12282,125
2022-02-10,Ventura,111,848112,169559,168736,9082,177818,1340
2022-02-10,Yolo,113,214977,35329,34773,3030,37803,286
2022-02-10,Yuba,115,75493,15366,15242,1140,16382,107
2022-02-09,Alameda,001,1643700,246776,241141,13219,254360,1668
2022-02-09,Alpine,003,1148,120,124,1,125,0
2022-02-09,Amador,005,37829,8181,8069,609,8678,76
2022-02-09,Butte,007,227075,31914,31433,6388,37821,359
2022-02-09,Calaveras,009,45235,7058,7005,326,7331,106
2022-02-09,Colusa,011,21464,3372,3331,1053,4384,21
2022-02-09,Contra Costa,013,1133247,182698,179695,12505,192200,1132
2022-02-09,Del Norte,015,27424,5334,5204,165,5369,45
2022-02-09,El Dorado,017,186661,26064,25572,3105,28677,186
2022-02-09,Fresno,019,978130,223279,218989,21834,240823,2502
2022-02-09,Glenn,021,27897,4862,4804,1538,6342,39
2022-02-09,Humboldt,023,135768,16142,15929,2732,18661,131
2022-02-09,Imperial,025,180216,53955,53102,10562,63664,858
2022-02-09,Inyo,027,18085,4003,3989,446,4435,52
2022-02-09,Kern,029,883053,187068,184068,44868,228936,2021
2022-02-09,Kings,031,150075,49848,48718,3483,52201,410
2022-02-09,Lake,033,64148,10063,9880,834,10714,124
2022-02-09,Lassen,035,31185,8537,8459,869,9328,55
2022-02-09,Los Angeles,037,10098052,2653822,2611611,120631,2732242,29263
2022-02-09,Madera,039,155013,36177,35559,5754,41313,330
2022-02-09,Marin,041,260295,32240,31965,2131,34096,255
2022-02-09,Mariposa,043,17540,2290,2279,188,2467,6
2022-02-09,Mendocino,045,87422,12583,12378,2720,15098,107
2022-02-09,Merced,047,269075,60519,59952,7983,67935,755
2022-02-09,Modoc,049,8938,707,691,232,923,6
2022-02-09,Mono,051,14174,2939,2937,118,3055,5
2022-02-09,Monterey,053,433212,76473,74500,12586,87086,670
2022-02-09,Napa,055,140530,24665,24429,913,25342,123
2022-02-09,Nevada,057,99092,15518,15446,1142,16588,119
2022-02-09,Orange,059,3164182,535694,534316,40056,574372,6263
2022-02-09,Placer,061,380077,61236,60490,7137,67627,553
2022-02-09,Plumas,063,18699,2805,2609,322,2931,13
2022-02-09,Riverside,065,2383286,580795,573907,27308,601215,5911
2022-02-09,Sacramento,067,1510023,269280,265624,25740,291364,2673
2022-02-09,San Benito,069,59416,12547,12492,503,12995,91
2022-02-09,San Bernardino,071,2135413,554260,547768,24138,571906,6349
2022-02-09,San Diego,073,3302833,732717,717896,49730,767626,4832
2022-02-09,San Francisco,075,870044,119443,118550,8062,126612,731
2022-02-09,San Joaquin,077,732212,162301,160618,8892,169510,2014
2022-02-09,San Luis Obispo,079,281455,50596,49833,3574,53407,414
2022-02-09,San Mateo,081,765935,116799,114890,6682,121572,589
2022-02-09,Santa Barbara,083,443738,83203,82830,4680,87510,629
2022-02-09,Santa Clara,085,1922200,300347,297157,11846,309003,2090
2022-02-09,Santa Cruz,087,273765,44798,44200,2013,46213,239
2022-02-09,Shasta,089,179085,29562,29215,5930,35145,471
2022-02-09,Sierra,091,2930,269,268,39,307,0
2022-02-09,Siskiyou,093,43540,4273,4217,2615,6832,68
2022-02-09,Solano,095,438530,78832,77299,5348,82647,423
2022-02-09,Sonoma,097,501317,80526,79165,2373,81538,431
2022-02-09,Stanislaus,099,539301,114564,114039,16498,130537,1406
2022-02-09,Sutter,101,95872,19978,19758,1921,21679,207
2022-02-09,Tehama,103,63373,11691,11542,2562,14104,149
2022-02-09,Trinity,105,12862,1137,1110,277,1387,20
2022-02-09,Tulare,107,460477,102417,100049,27194,127243,1271
2022-02-09,Tuolumne,109,53932,12219,11702,525,12227,95
2022-02-09,Ventura,111,848112,169323,168253,9070,177323,1325
2022-02-09,Yolo,113,214977,35257,34588,3015,37603,285
2022-02-09,Yuba,115,75493,15336,15187,1128,16315,105
2022-02-08,Alameda,001,1643700,246144,240587,13145,253732,1651
2022-02-08,Alpine,003,1148,120,124,1,125,0
2022-02-08,Amador,005,37829,8173,8050,602,8652,76
2022-02-08,Butte,007,227075,31830,31353,6365,37718,359
2022-02-08,Calaveras,009,45235,7042,6981,324,7305,101
2022-02-08,Colusa,011,21464,3363,3320,1052,4372,21
2022-02-08,Contra Costa,013,1133247,182270,179078,12427,191505,1132
2022-02-08,Del Norte,015,27424,5307,5156,160,5316,44
2022-02-08,El Dorado,017,186661,26017,25446,3095,28541,186
2022-02-08,Fresno,019,978130,222545,218416,21729,240145,2502
2022-02-08,Glenn,021,27897,4845,4784,1534,6318,39
2022-02-08,Humboldt,023,135768,16081,15865,2699,18564,130
2022-02-08,Imperial,025,180216,53827,52977,10512,63489,855
2022-02-08,Inyo,027,18085,3998,3983,446,4429,52
2022-02-08,Kern,029,883053,186739,183519,44734,228253,2010
2022-02-08,Kings,031,150075,49700,48479,3471,51950,411
2022-02-08,Lake,033,64148,10032,9806,828,10634,125
2022-02-08,Lassen,035,31185,8528,8423,865,9288,55
2022-02-08,Los Angeles,037,10098052,2649528,2611204,120441,2731645,29259
2022-02-08,Madera,039,155013,36070,35381,5696,41077,330
2022-02-08,Marin,041,260295,32164,31878,2125,34003,255
2022-02-08,Mariposa,043,17540,2288,2266,180,2446,6
2022-02-08,Mendocino,045,87422,12550,12336,2690,15026,107
2022-02-08,Merced,047,269075,60409,59789,7924,67713,751
2022-02-08,Modoc,049,8938,703,684,232,916,6
2022-02-08,Mono,051,14174,2938,2932,118,3050,5
2022-02-08,Monterey,053,433212,76265,74316,12494,86810,670
2022-02-08,Napa,055,140530,24591,24346,906,25252,121
2022-02-08,Nevada,057,99092,15491,15383,1139,16522,117
2022-02-08,Orange,059,3164182,535010,533507,39971,573478,6205
2022-02-08,Placer,061,380077,61127,60301,7124,67425,553
2022-02-08,Plumas,063,18699,2794,2596,317,2913,13
2022-02-08,Riverside,065,2383286,579961,571892,27232,599124,5908
2022-02-08,Sacramento,067,1510023,268648,264479,25566,290045,2664
2022-02-08,San Benito,069,59416,12523,12434,501,12935,91
2022-02-08,San Bernardino,071,2135413,553572,544658,24098,568756,6335
2022-02-08,San Diego,073,3302833,731110,717896,49597,767493,4832
2022-02-08,San Francisco,075,870044,119131,117942,8053,125995,731
2022-02-08,San Joaquin,077,732212,161924,160147,8873,169020,2005
2022-02-08,San Luis Obispo,079,281455,50430,49556,3542,53098,410
2022-02-08,San Mateo,081,765935,116577,114541,6652,121193,589
2022-02-08,Santa Barbara,083,443738,83037,82461,4654,87115,627
2022-02-08,Santa Clara,085,1922200,299470,295679,11797,307476,2091
2022-02-08,Santa Cruz,087,273765,44643,43884,2008,45892,239
2022-02-08,Shasta,089,179085,29476,29084,5901,34985,470
2022-02-08,Sierra,091,2930,269,267,39,306,0
2022-02-08,Siskiyou,093,43540,4263,4191,2605,6796,68
2022-02-08,Solano,095,438530,78597,77031,5334,82365,421
2022-02-08,Sonoma,097,501317,80308,78798,2352,81150,431
2022-02-08,Stanislaus,099,539301,114306,113733,16421,130154,1406
2022-02-08,Sutter,101,95872,19940,19717,1909,21626,203
2022-02-08,Tehama,103,63373,11667,11491,2553,14044,149
2022-02-08,Trinity,105,12862,1131,1110,277,1387,20
2022-02-08,Tulare,107,460477,102129,99694,27061,126755,1267
2022-02-08,Tuolumne,109,53932,12196,11665,523,12188,92
2022-02-08,Ventura,111,848112,169091,167830,9054,176884,1325
2022-02-08,Yolo,113,214977,35177,34462,3002,37464,281
2022-02-08,Yuba,115,75493,15291,15126,1106,16232,107
2022-02-07,Alameda,001,1643700,245439,238678,13077,251755,1643
2022-02-07,Alpine,003,1148,120,124,1,125,0
2022-02-07,Amador,005,37829,8145,7980,594,8574,75
2022-02-07,Butte,007,227075,31744,31184,6338,37522,355
2022-02-07,Calaveras,009,45235,7020,6910,323,7233,100
2022-02-07,Colusa,011,21464,3353,3283,1045,4328,21
2022-02-07,Contra Costa,013,1133247,181807,177767,12358,190125,1130
2022-02-07,Del Norte,015,27424,5268,5093,155,5248,44
2022-02-07,El Dorado,017,186661,25956,25257,3083,28340,185
2022-02-07,Fresno,019,978130,221695,216495,21596,238091,2493
2022-02-07,Glenn,021,27897,4839,4762,1530,6292,39
2022-02-07,Humboldt,023,135768,16007,15764,2674,18438,129
2022-02-07,Imperial,025,180216,53717,52689,10441,63130,853
2022-02-07,Inyo,027,18085,3993,3976,440,4416,51
2022-02-07,Kern,029,883053,186278,182047,44562,226609,1998
2022-02-07,Kings,031,150075,49517,48147,3455,51602,403
2022-02-07,Lake,033,64148,9986,9519,820,10339,125
2022-02-07,Lassen,035,31185,8510,8362,859,9221,55
2022-02-07,Los Angeles,037,10098052,2645103,2607438,120228,2727666,29210
2022-02-07,Madera,039,155013,35944,35083,5647,40730,330
2022-02-07,Marin,041,260295,32096,31670,2114,33784,255
2022-02-07,Mariposa,043,17540,2283,2253,176,2429,6
2022-02-07,Mendocino,045,87422,12492,12237,2652,14889,107
2022-02-07,Merced,047,269075,60283,59472,7832,67304,748
2022-02-07,Modoc,049,8938,699,679,232,911,6
2022-02-07,Mono,051,14174,2936,2917,118,3035,5
2022-02-07,Monterey,053,433212,76008,69433,12388,81821,670
2022-02-07,Napa,055,140530,24506,23237,896,24133,120
2022-02-07,Nevada,057,99092,15455,15268,1133,16401,113
2022-02-07,Orange,059,3164182,534252,531442,39887,571329,6179
2022-02-07,Placer,061,380077,61002,59894,7109,67003,546
2022-02-07,Plumas,063,18699,2785,2573,309,2882,13
2022-02-07,Riverside,065,2383286,579009,568874,27145,596019,5868
2022-02-07,Sacramento,067,1510023,267992,262834,25388,288222,2631
2022-02-07,San Benito,069,59416,12486,12285,499,12784,90
2022-02-07,San Bernardino,071,2135413,552787,542846,24062,566908,6335
2022-02-07,San Diego,073,3302833,729364,716244,49414,765658,4811
2022-02-07,San Francisco,075,870044,118794,113945,8028,121973,727
2022-02-07,San Joaquin,077,732212,161537,159358,8854,168212,1998
2022-02-07,San Luis Obispo,079,281455,50265,48994,3521,52515,406
2022-02-07,San Mateo,081,765935,116290,107060,6624,113684,589
2022-02-07,Santa Barbara,083,443738,82851,81608,4639,86247,624
2022-02-07,Santa Clara,085,1922200,298512,293360,11749,305109,2085
2022-02-07,Santa Cruz,087,273765,44426,43244,2004,45248,239
2022-02-07,Shasta,089,179085,29388,28900,5874,34774,468
2022-02-07,Sierra,091,2930,269,265,39,304,0
2022-02-07,Siskiyou,093,43540,4252,4157,2589,6746,68
2022-02-07,Solano,095,438530,78332,73934,5308,79242,420
2022-02-07,Sonoma,097,501317,80045,78296,2341,80637,431
2022-02-07,Stanislaus,099,539301,114041,113029,16326,129355,1406
2022-02-07,Sutter,101,95872,19908,19599,1881,21480,203
2022-02-07,Tehama,103,63373,11629,11418,2545,13963,146
2022-02-07,Trinity,105,12862,1127,1109,274,1383,20
2022-02-07,Tulare,107,460477,101772,98774,26921,125695,1263
2022-02-07,Tuolumne,109,53932,12148,11578,519,12097,92
2022-02-07,Ventura,111,848112,168774,166904,9041,175945,1324
2022-02-07,Yolo,113,214977,35069,34007,2987,36994,281
2022-02-07,Yuba,115,75493,15245,14998,1099,16097,105
2022-02-06,Alameda,001,1643700,244533,237188,12996,250184,1643
2022-02-06,Alpine,003,1148,120,123,1,124,0
2022-02-06,Amador,005,37829,8116,7922,582,8504,73
2022-02-06,Butte,007,227075,31618,31021,6292,37313,355
2022-02-06,Calaveras,009,45235,6993,6870,318,7188,99
2022-02-06,Colusa,011,21464,3344,3282,1044,4326,21
2022-02-06,Contra Costa,013,1133247,181174,176863,12201,189064,1128
2022-02-06,Del Norte,015,27424,5209,5038,153,5191,44
2022-02-06,El Dorado,017,186661,25892,25165,3071,28236,185
2022-02-06,Fresno,019,978130,220858,214726,21341,236067,2489
2022-02-06,Glenn,021,27897,4826,4738,1520,6258,39
2022-02-06,Humboldt,023,135768,15920,15658,2635,18293,128
2022-02-06,Imperial,025,180216,53525,52396,10389,62785,853
2022-02-06,Inyo,027,18085,3991,3970,437,4407,51
2022-02-06,Kern,029,883053,185735,181188,44318,225506,1996
2022-02-06,Kings,031,150075,49295,47669,3429,51098,401
2022-02-06,Lake,033,64148,9918,9468,803,10271,125
2022-02-06,Lassen,035,31185,8491,8326,854,9180,55
2022-02-06,Los Angeles,037,10098052,2639606,2602620,119962,2722582,29180
2022-02-06,Madera,039,155013,35752,34901,5546,40447,330
2022-02-06,Marin,041,260295,31996,31488,2101,33589,255
2022-02-06,Mariposa,043,17540,2275,2244,165,2409,6
2022-02-06,Mendocino,045,87422,12448,12169,2585,14754,107
2022-02-06,Merced,047,269075,60064,59112,7672,66784,748
2022-02-06,Modoc,049,8938,694,675,231,906,6
2022-02-06,Mono,051,14174,2931,2901,116,3017,5
2022-02-06,Monterey,053,433212,75636,67912,12228,80140,670
2022-02-06,Napa,055,140530,24389,23230,888,24118,120
2022-02-06,Nevada,057,99092,15390,15192,1120,16312,113
2022-02-06,Orange,059,3164182,533300,527906,39782,567688,6171
2022-02-06,Placer,061,380077,60826,59507,7083,66590,544
2022-02-06,Plumas,063,18699,2774,2559,300,2859,13
2022-02-06,Riverside,065,2383286,577856,568276,27066,595342,5865
2022-02-06,Sacramento,067,1510023,267148,261353,25126,286479,2631
2022-02-06,San Benito,069,59416,12431,12186,491,12677,90
2022-02-06,San Bernardino,071,2135413,551836,541103,23999,565102,6334
2022-02-06,San Diego,073,3302833,727279,709938,49172,759110,4786
2022-02-06,San Francisco,075,870044,118412,113115,8002,121117,728
2022-02-06,San Joaquin,077,732212,160971,158510,8824,167334,1997
2022-02-06,San Luis Obispo,079,281455,50041,48843,3464,52307,405
2022-02-06,San Mateo,081,765935,115951,105556,6584,112140,587
2022-02-06,Santa Barbara,083,443738,82534,81118,4600,85718,623
2022-02-06,Santa Clara,085,1922200,297375,291732,11627,303359,2075
2022-02-06,Santa Cruz,087,273765,44108,42952,1990,44942,239
2022-02-06,Shasta,089,179085,29260,28762,5824,34586,468
2022-02-06,Sierra,091,2930,269,265,39,304,0
2022-02-06,Siskiyou,093,43540,4231,4118,2563,6681,68
2022-02-06,Solano,095,438530,78023,73475,5268,78743,419
2022-02-06,Sonoma,097,501317,79710,77887,2328,80215,431
2022-02-06,Stanislaus,099,539301,113641,112521,16182,128703,1406
2022-02-06,Sutter,101,95872,19864,19523,1838,21361,203
2022-02-06,Tehama,103,63373,11589,11366,2524,13890,146
2022-02-06,Trinity,105,12862,1126,1102,273,1375,20
2022-02-06,Tulare,107,460477,101327,98260,26734,124994,1262
2022-02-06,Tuolumne,109,53932,12098,11507,502,12009,92
2022-02-06,Ventura,111,848112,168397,166235,9030,175265,1323
2022-02-06,Yolo,113,214977,34933,33784,2969,36753,281
2022-02-06,Yuba,115,75493,15198,14917,1090,16007,104
2022-02-05,Alameda,001,1643700,244121,235698,12987,248685,1638
2022-02-05,Alpine,003,1148,120,124,1,125,0
2022-02-05,Amador,005,37829,8107,7855,579,8434,71
2022-02-05,Butte,007,227075,31565,30733,6278,37011,355
2022-02-05,Calaveras,009,45235,6977,6789,318,7107,99
2022-02-05,Colusa,011,21464,3337,3234,1042,4276,21
2022-02-05,Contra Costa,013,1133247,180897,175871,12185,188056,1115
2022-02-05,Del Norte,015,27424,5169,4978,151,5129,44
2022-02-05,El Dorado,017,186661,25862,24813,3069,27882,185
2022-02-05,Fresno,019,978130,220512,213539,21325,234864,2477
2022-02-05,Glenn,021,27897,4823,4691,1513,6204,39
2022-02-05,Humboldt,023,135768,15873,15514,2631,18145,127
2022-02-05,Imperial,025,180216,53464,52153,10376,62529,853
2022-02-05,Inyo,027,18085,3988,3948,437,4385,51
2022-02-05,Kern,029,883053,185526,180296,44212,224508,1987
2022-02-05,Kings,031,150075,49211,47538,3422,50960,402
2022-02-05,Lake,033,64148,9900,9289,796,10085,124
2022-02-05,Lassen,035,31185,8481,8288,852,9140,55
2022-02-05,Los Angeles,037,10098052,2637438,2572702,119839,2692541,28947
2022-02-05,Madera,039,155013,35698,34471,5531,40002,329
2022-02-05,Marin,041,260295,31948,31299,2097,33396,255
2022-02-05,Mariposa,043,17540,2274,2222,164,2386,6
2022-02-05,Mendocino,045,87422,12420,12066,2583,14649,107
2022-02-05,Merced,047,269075,59971,58908,7664,66572,744
2022-02-05,Modoc,049,8938,693,664,231,895,6
2022-02-05,Mono,051,14174,2930,2904,116,3020,5
2022-02-05,Monterey,053,433212,75521,67342,12188,79530,666
2022-02-05,Napa,055,140530,24334,22973,887,23860,118
2022-02-05,Nevada,057,99092,15369,15002,1115,16117,113
2022-02-05,Orange,059,3164182,532860,527516,39691,567207,6134
2022-02-05,Placer,061,380077,60697,59043,7069,66112,533
2022-02-05,Plumas,063,18699,2773,2550,299,2849,13
2022-02-05,Riverside,065,2383286,577254,563991,26995,590986,5827
2022-02-05,Sacramento,067,1510023,266762,259437,25090,284527,2610
2022-02-05,San Benito,069,59416,12386,12142,491,12633,90
2022-02-05,San Bernardino,071,2135413,551332,539312,23977,563289,6322
2022-02-05,San Diego,073,3302833,726413,703957,49105,753062,4735
2022-02-05,San Francisco,075,870044,118202,112481,7973,120454,720
2022-02-05,San Joaquin,077,732212,160787,157420,8819,166239,1989
2022-02-05,San Luis Obispo,079,281455,50004,48361,3462,51823,404
2022-02-05,San Mateo,081,765935,115763,104810,6576,111386,587
2022-02-05,Santa Barbara,083,443738,82372,80478,4588,85066,617
2022-02-05,Santa Clara,085,1922200,296710,289262,11611,300873,2067
2022-02-05,Santa Cruz,087,273765,44035,42553,1987,44540,239
2022-02-05,Shasta,089,179085,29218,28604,5814,34418,466
2022-02-05,Sierra,091,2930,269,262,39,301,0
2022-02-05,Siskiyou,093,43540,4224,4106,2550,6656,67
2022-02-05,Solano,095,438530,77948,73112,5260,78372,415
2022-02-05,Sonoma,097,501317,79546,77213,2325,79538,431
2022-02-05,Stanislaus,099,539301,113438,111783,16161,127944,1406
2022-02-05,Sutter,101,95872,19835,19406,1832,21238,203
2022-02-05,Tehama,103,63373,11570,11259,2517,13776,146
2022-02-05,Trinity,105,12862,1124,1085,273,1358,20
2022-02-05,Tulare,107,460477,101164,97414,26650,124064,1254
2022-02-05,Tuolumne,109,53932,12073,11409,499,11908,91
2022-02-05,Ventura,111,848112,168171,165532,9014,174546,1308
2022-02-05,Yolo,113,214977,34850,33614,2956,36570,281
2022-02-05,Yuba,115,75493,15168,14801,1082,15883,105
2022-02-04,Alameda,001,1643700,243638,235698,12977,248675,1638
2022-02-04,Alpine,003,1148,120,124,1,125,0
2022-02-04,Amador,005,37829,8091,7855,575,8430,71
2022-02-04,Butte,007,227075,31505,30733,6268,37001,355
2022-02-04,Calaveras,009,45235,6967,6789,316,7105,99
2022-02-04,Colusa,011,21464,3332,3234,1040,4274,21
2022-02-04,Contra Costa,013,1133247,180569,175871,12156,188027,1115
2022-02-04,Del Norte,015,27424,5147,4978,151,5129,44
2022-02-04,El Dorado,017,186661,25827,24813,3064,27877,185
2022-02-04,Fresno,019,978130,220029,213539,21298,234837,2477
2022-02-04,Glenn,021,27897,4814,4691,1510,6201,39
2022-02-04,Humboldt,023,135768,15847,15514,2628,18142,127
2022-02-04,Imperial,025,180216,53391,52153,10358,62511,853
2022-02-04,Inyo,027,18085,3985,3948,436,4384,51
2022-02-04,Kern,029,883053,185303,180296,44083,224379,1987
2022-02-04,Kings,031,150075,49130,47538,3415,50953,402
2022-02-04,Lake,033,64148,9878,9289,793,10082,124
2022-02-04,Lassen,035,31185,8458,8288,852,9140,55
2022-02-04,Los Angeles,037,10098052,2634806,2572702,119712,2692414,28947
2022-02-04,Madera,039,155013,35612,34471,5523,39994,329
2022-02-04,Marin,041,260295,31883,31299,2088,33387,255
2022-02-04,Mariposa,043,17540,2272,2222,162,2384,6
2022-02-04,Mendocino,045,87422,12389,12066,2581,14647,107
2022-02-04,Merced,047,269075,59892,58908,7654,66562,744
2022-02-04,Modoc,049,8938,693,664,231,895,6
2022-02-04,Mono,051,14174,2928,2904,116,3020,5
2022-02-04,Monterey,053,433212,75328,67342,12154,79496,666
2022-02-04,Napa,055,140530,24287,22973,883,23856,118
2022-02-04,Nevada,057,99092,15335,15002,1111,16113,113
2022-02-04,Orange,059,3164182,532312,527516,39633,567149,6134
2022-02-04,Placer,061,380077,60594,59043,7058,66101,533
2022-02-04,Plumas,063,18699,2767,2550,298,2848,13
2022-02-04,Riverside,065,2383286,576548,563991,26982,590973,5827
2022-02-04,Sacramento,067,1510023,266290,259437,25067,284504,2610
2022-02-04,San Benito,069,59416,12367,12142,489,12631,90
2022-02-04,San Bernardino,071,2135413,550756,539312,23960,563272,6322
2022-02-04,San Diego,073,3302833,725292,703957,49037,752994,4735
2022-02-04,San Francisco,075,870044,117959,112481,7948,120429,720
2022-02-04,San Joaquin,077,732212,160558,157420,8810,166230,1989
2022-02-04,San Luis Obispo,079,281455,49943,48361,3455,51816,404
2022-02-04,San Mateo,081,765935,115535,104810,6561,111371,587
2022-02-04,Santa Barbara,083,443738,82222,80478,4587,85065,617
2022-02-04,Santa Clara,085,1922200,296036,289262,11590,300852,2067
2022-02-04,Santa Cruz,087,273765,43832,42553,1983,44536,239
2022-02-04,Shasta,089,179085,29169,28604,5803,34407,466
2022-02-04,Sierra,091,2930,269,262,39,301,0
2022-02-04,Siskiyou,093,43540,4216,4106,2543,6649,67
2022-02-04,Solano,095,438530,77748,73112,5224,78336,415
2022-02-04,Sonoma,097,501317,79393,77213,2248,79461,431
2022-02-04,Stanislaus,099,539301,113253,111783,16134,127917,1406
2022-02-04,Sutter,101,95872,19811,19406,1825,21231,203
2022-02-04,Tehama,103,63373,11556,11259,2516,13775,146
2022-02-04,Trinity,105,12862,1123,1085,272,1357,20
2022-02-04,Tulare,107,460477,100987,97414,26568,123982,1254
2022-02-04,Tuolumne,109,53932,12060,11409,498,11907,91
2022-02-04,Ventura,111,848112,167902,165532,9006,174538,1308
2022-02-04,Yolo,113,214977,34757,33614,2950,36564,281
2022-02-04,Yuba,115,75493,15149,14801,1082,15883,105
2022-02-03,Alameda,001,1643700,242869,235698,12918,248616,1638
2022-02-03,Alpine,003,1148,120,124,1,125,0
2022-02-03,Amador,005,37829,8071,7855,570,8425,71
2022-02-03,Butte,007,227075,31396,30733,6240,36973,355
2022-02-03,Calaveras,009,45235,6936,6789,312,7101,99
2022-02-03,Colusa,011,21464,3319,3234,1038,4272,21
2022-02-03,Contra Costa,013,1133247,179962,175871,12055,187926,1115
2022-02-03,Del Norte,015,27424,5105,4978,148,5126,44
2022-02-03,El Dorado,017,186661,25754,24813,3058,27871,185
2022-02-03,Fresno,019,978130,219083,213539,21131,234670,2477
2022-02-03,Glenn,021,27897,4796,4691,1492,6183,39
2022-02-03,Humboldt,023,135768,15770,15514,2591,18105,127
2022-02-03,Imperial,025,180216,53249,52153,10308,62461,853
2022-02-03,Inyo,027,18085,3982,3948,432,4380,51
2022-02-03,Kern,029,883053,184842,180296,43867,224163,1987
2022-02-03,Kings,031,150075,48967,47538,3407,50945,402
2022-02-03,Lake,033,64148,9825,9289,787,10076,124
2022-02-03,Lassen,035,31185,8431,8288,851,9139,55
2022-02-03,Los Angeles,037,10098052,2629375,2572702,119445,2692147,28947
2022-02-03,Madera,039,155013,35471,34471,5478,39949,329
2022-02-03,Marin,041,260295,31786,31299,2083,33382,255
2022-02-03,Mariposa,043,17540,2260,2222,159,2381,6
2022-02-03,Mendocino,045,87422,12345,12066,2557,14623,107
2022-02-03,Merced,047,269075,59742,58908,7558,66466,744
2022-02-03,Modoc,049,8938,690,664,231,895,6
2022-02-03,Mono,051,14174,2923,2904,115,3019,5
2022-02-03,Monterey,053,433212,75038,67342,11964,79306,666
2022-02-03,Napa,055,140530,24154,22973,883,23856,118
2022-02-03,Nevada,057,99092,15295,15002,1100,16102,113
2022-02-03,Orange,059,3164182,531390,527516,39539,567055,6134
2022-02-03,Placer,061,380077,60393,59043,7035,66078,533
2022-02-03,Plumas,063,18699,2753,2550,295,2845,13
2022-02-03,Riverside,065,2383286,575334,563991,26911,590902,5827
2022-02-03,Sacramento,067,1510023,265379,259437,24875,284312,2610
2022-02-03,San Benito,069,59416,12340,12142,486,12628,90
2022-02-03,San Bernardino,071,2135413,549742,539312,23923,563235,6322
2022-02-03,San Diego,073,3302833,723313,703957,48868,752825,4735
2022-02-03,San Francisco,075,870044,117625,112481,7917,120398,720
2022-02-03,San Joaquin,077,732212,160074,157420,8781,166201,1989
2022-02-03,San Luis Obispo,079,281455,49744,48361,3438,51799,404
2022-02-03,San Mateo,081,765935,115183,104810,6527,111337,587
2022-02-03,Santa Barbara,083,443738,81861,80478,4558,85036,617
2022-02-03,Santa Clara,085,1922200,294849,289262,11481,300743,2067
2022-02-03,Santa Cruz,087,273765,43489,42553,1976,44529,239
2022-02-03,Shasta,089,179085,29062,28604,5774,34378,466
2022-02-03,Sierra,091,2930,269,262,39,301,0
2022-02-03,Siskiyou,093,43540,4201,4106,2526,6632,67
2022-02-03,Solano,095,438530,77410,73112,5206,78318,415
2022-02-03,Sonoma,097,501317,79095,77213,2241,79454,431
2022-02-03,Stanislaus,099,539301,112881,111783,16052,127835,1406
2022-02-03,Sutter,101,95872,19759,19406,1816,21222,203
2022-02-03,Tehama,103,63373,11525,11259,2507,13766,146
2022-02-03,Trinity,105,12862,1121,1085,271,1356,20
2022-02-03,Tulare,107,460477,100592,97414,26419,123833,1254
2022-02-03,Tuolumne,109,53932,12019,11409,487,11896,91
2022-02-03,Ventura,111,848112,167515,165532,8996,174528,1308
2022-02-03,Yolo,113,214977,34649,33614,2936,36550,281
2022-02-03,Yuba,115,75493,15098,14801,1066,15867,105
2022-02-02,Alameda,001,1643700,241927,234300,12816,247116,1632
2022-02-02,Alpine,003,1148,120,123,1,124,0
2022-02-02,Amador,005,37829,8041,7781,560,8341,71
2022-02-02,Butte,007,227075,31286,30550,6208,36758,355
2022-02-02,Calaveras,009,45235,6907,6753,308,7061,99
2022-02-02,Colusa,011,21464,3304,3211,1037,4248,21
2022-02-02,Contra Costa,013,1133247,179358,174876,11957,186833,1113
2022-02-02,Del Norte,015,27424,5063,4924,143,5067,44
2022-02-02,El Dorado,017,186661,25685,24690,3039,27729,185
2022-02-02,Fresno,019,978130,218056,211976,21010,232986,2463
2022-02-02,Glenn,021,27897,4772,4667,1482,6149,39
2022-02-02,Humboldt,023,135768,15709,15392,2552,17944,127
2022-02-02,Imperial,025,180216,53052,51875,10169,62044,853
2022-02-02,Inyo,027,18085,3976,3944,431,4375,51
2022-02-02,Kern,029,883053,184243,179386,43647,223033,1974
2022-02-02,Kings,031,150075,48779,47061,3381,50442,401
2022-02-02,Lake,033,64148,9765,9235,780,10015,120
2022-02-02,Lassen,035,31185,8414,8258,842,9100,55
2022-02-02,Los Angeles,037,10098052,2623162,2561902,119057,2680959,28850
2022-02-02,Madera,039,155013,35296,34265,5404,39669,329
2022-02-02,Marin,041,260295,31687,31149,2073,33222,255
2022-02-02,Mariposa,043,17540,2249,2215,155,2370,6
2022-02-02,Mendocino,045,87422,12292,11996,2518,14514,105
2022-02-02,Merced,047,269075,59568,58532,7472,66004,744
2022-02-02,Modoc,049,8938,684,662,231,893,6
2022-02-02,Mono,051,14174,2912,2887,115,3002,5
2022-02-02,Monterey,053,433212,74646,66852,11786,78638,666
2022-02-02,Napa,055,140530,24033,22859,869,23728,117
2022-02-02,Nevada,057,99092,15238,14895,1076,15971,112
2022-02-02,Orange,059,3164182,530332,524418,39448,563866,6127
2022-02-02,Placer,061,380077,60197,58654,7004,65658,533
2022-02-02,Plumas,063,18699,2737,2540,291,2831,12
2022-02-02,Riverside,065,2383286,574037,561220,26863,588083,5827
2022-02-02,Sacramento,067,1510023,264430,258078,24664,282742,2602
2022-02-02,San Benito,069,59416,12301,12058,482,12540,90
2022-02-02,San Bernardino,071,2135413,548760,537485,23861,561346,6317
2022-02-02,San Diego,073,3302833,721089,703957,48691,752648,4735
2022-02-02,San Francisco,075,870044,117254,112008,7901,119909,714
2022-02-02,San Joaquin,077,732212,159485,156537,8757,165294,1986
2022-02-02,San Luis Obispo,079,281455,49545,48119,3425,51544,403
2022-02-02,San Mateo,081,765935,114813,104201,6457,110658,587
2022-02-02,Santa Barbara,083,443738,81516,79979,4527,84506,612
2022-02-02,Santa Clara,085,1922200,293688,287443,11365,298808,2051
2022-02-02,Santa Cruz,087,273765,43209,42127,1966,44093,239
2022-02-02,Shasta,089,179085,28962,28429,5728,34157,465
2022-02-02,Sierra,091,2930,269,262,39,301,0
2022-02-02,Siskiyou,093,43540,4191,4078,2499,6577,67
2022-02-02,Solano,095,438530,77055,72711,5183,77894,414
2022-02-02,Sonoma,097,501317,78780,76681,2229,78910,431
2022-02-02,Stanislaus,099,539301,112483,111167,15920,127087,1403
2022-02-02,Sutter,101,95872,19694,19290,1786,21076,203
2022-02-02,Tehama,103,63373,11470,11193,2488,13681,146
2022-02-02,Trinity,105,12862,1118,1074,269,1343,20
2022-02-02,Tulare,107,460477,100207,96820,26252,123072,1249
2022-02-02,Tuolumne,109,53932,11943,11342,484,11826,91
2022-02-02,Ventura,111,848112,167117,164905,8977,173882,1292
2022-02-02,Yolo,113,214977,34529,33332,2914,36246,281
2022-02-02,Yuba,115,75493,15033,14720,1058,15778,104
2022-02-01,Alameda,001,1643700,240852,233782,12711,246493,1620
2022-02-01,Alpine,003,1148,120,123,1,124,0
2022-02-01,Amador,005,37829,7994,7783,554,8337,73
2022-02-01,Butte,007,227075,31147,30496,6169,36665,355
2022-02-01,Calaveras,009,45235,6870,6749,304,7053,98
2022-02-01,Colusa,011,21464,3285,3202,1014,4216,21
2022-02-01,Contra Costa,013,1133247,178618,174379,11815,186194,1115
2022-02-01,Del Norte,015,27424,5015,4907,140,5047,44
2022-02-01,El Dorado,017,186661,25626,24664,3021,27685,184
2022-02-01,Fresno,019,978130,216886,211352,20862,232214,2464
2022-02-01,Glenn,021,27897,4758,4649,1472,6121,39
2022-02-01,Humboldt,023,135768,15626,15354,2522,17876,127
2022-02-01,Imperial,025,180216,52846,51675,10098,61773,846
2022-02-01,Inyo,027,18085,3966,3928,428,4356,51
2022-02-01,Kern,029,883053,183612,178987,43400,222387,1967
2022-02-01,Kings,031,150075,48519,46959,3357,50316,400
2022-02-01,Lake,033,64148,9708,9211,773,9984,119
2022-02-01,Lassen,035,31185,8395,8231,837,9068,55
2022-02-01,Los Angeles,037,10098052,2615997,2548794,118674,2667468,28752
2022-02-01,Madera,039,155013,35071,34124,5322,39446,329
2022-02-01,Marin,041,260295,31565,31099,2057,33156,255
2022-02-01,Mariposa,043,17540,2242,2210,154,2364,6
2022-02-01,Mendocino,045,87422,12230,11978,2482,14460,105
2022-02-01,Merced,047,269075,59382,58362,7348,65710,743
2022-02-01,Modoc,049,8938,677,664,231,895,6
2022-02-01,Mono,051,14174,2906,2888,115,3003,5
2022-02-01,Monterey,053,433212,74228,66553,11594,78147,665
2022-02-01,Napa,055,140530,23936,22795,852,23647,116
2022-02-01,Nevada,057,99092,15175,14863,1063,15926,112
2022-02-01,Orange,059,3164182,529187,523741,39306,563047,6108
2022-02-01,Placer,061,380077,59951,58486,6964,65450,532
2022-02-01,Plumas,063,18699,2722,2526,288,2814,12
2022-02-01,Riverside,065,2383286,572654,560010,26814,586824,5825
2022-02-01,Sacramento,067,1510023,263432,257504,24381,281885,2593
2022-02-01,San Benito,069,59416,12235,12053,479,12532,90
2022-02-01,San Bernardino,071,2135413,547546,536591,23799,560390,6311
2022-02-01,San Diego,073,3302833,718567,701009,48477,749486,4710
2022-02-01,San Francisco,075,870044,116788,111606,7882,119488,713
2022-02-01,San Joaquin,077,732212,158952,156300,8734,165034,1987
2022-02-01,San Luis Obispo,079,281455,49314,47842,3363,51205,403
2022-02-01,San Mateo,081,765935,114338,103868,6415,110283,589
2022-02-01,Santa Barbara,083,443738,81070,79659,4491,84150,608
2022-02-01,Santa Clara,085,1922200,292133,286109,11258,297367,2070
2022-02-01,Santa Cruz,087,273765,42912,41782,1950,43732,239
2022-02-01,Shasta,089,179085,28837,28382,5674,34056,465
2022-02-01,Sierra,091,2930,267,262,39,301,0
2022-02-01,Siskiyou,093,43540,4177,4072,2472,6544,66
2022-02-01,Solano,095,438530,76781,72494,5167,77661,415
2022-02-01,Sonoma,097,501317,78419,76379,2207,78586,431
2022-02-01,Stanislaus,099,539301,112066,110925,15817,126742,1403
2022-02-01,Sutter,101,95872,19626,19256,1753,21009,202
2022-02-01,Tehama,103,63373,11413,11165,2474,13639,146
2022-02-01,Trinity,105,12862,1114,1073,269,1342,19
2022-02-01,Tulare,107,460477,99740,96467,26044,122511,1247
2022-02-01,Tuolumne,109,53932,11894,11318,475,11793,91
2022-02-01,Ventura,111,848112,166615,164721,8954,173675,1293
2022-02-01,Yolo,113,214977,34392,33257,2883,36140,275
2022-02-01,Yuba,115,75493,14973,14693,1051,15744,103
2022-01-31,Alameda,001,1643700,239511,232743,12595,245338,1607
2022-01-31,Alpine,003,1148,119,123,1,124,0
2022-01-31,Amador,005,37829,7941,7682,539,8221,73
2022-01-31,Butte,007,227075,30982,30371,6129,36500,354
2022-01-31,Calaveras,009,45235,6838,6700,293,6993,96
2022-01-31,Colusa,011,21464,3274,3187,1005,4192,21
2022-01-31,Contra Costa,013,1133247,177805,173466,11688,185154,1115
2022-01-31,Del Norte,015,27424,4982,4879,136,5015,43
2022-01-31,El Dorado,017,186661,25524,24545,2991,27536,184
2022-01-31,Fresno,019,978130,215395,210589,20667,231256,2464
2022-01-31,Glenn,021,27897,4722,4641,1460,6101,39
2022-01-31,Humboldt,023,135768,15536,15308,2488,17796,126
2022-01-31,Imperial,025,180216,52640,51472,9975,61447,846
2022-01-31,Inyo,027,18085,3955,3922,422,4344,50
2022-01-31,Kern,029,883053,182847,178375,43072,221447,1967
2022-01-31,Kings,031,150075,48160,46845,3323,50168,398
2022-01-31,Lake,033,64148,9635,9141,761,9902,119
2022-01-31,Lassen,035,31185,8366,8162,831,8993,55
2022-01-31,Los Angeles,037,10098052,2607756,2541189,118265,2659454,28718
2022-01-31,Madera,039,155013,34856,33886,5228,39114,329
2022-01-31,Marin,041,260295,31440,31023,2040,33063,253
2022-01-31,Mariposa,043,17540,2232,2203,145,2348,6
2022-01-31,Mendocino,045,87422,12164,11896,2440,14336,104
2022-01-31,Merced,047,269075,59098,58198,7153,65351,740
2022-01-31,Modoc,049,8938,674,661,231,892,6
2022-01-31,Mono,051,14174,2892,2889,115,3004,5
2022-01-31,Monterey,053,433212,73781,66117,11384,77501,661
2022-01-31,Napa,055,140530,23770,22707,836,23543,113
2022-01-31,Nevada,057,99092,15098,14813,1050,15863,112
2022-01-31,Orange,059,3164182,527865,522358,39168,561526,6098
2022-01-31,Placer,061,380077,59702,58252,6932,65184,523
2022-01-31,Plumas,063,18699,2709,2513,286,2799,12
2022-01-31,Riverside,065,2383286,570831,558166,26746,584912,5785
2022-01-31,Sacramento,067,1510023,262188,256594,24106,280700,2571
2022-01-31,San Benito,069,59416,12175,11976,478,12454,90
2022-01-31,San Bernardino,071,2135413,545932,535276,23718,558994,6302
2022-01-31,San Diego,073,3302833,715645,698571,48220,746791,4686
2022-01-31,San Francisco,075,870044,116378,111119,7849,118968,712
2022-01-31,San Joaquin,077,732212,158195,155736,8700,164436,1985
2022-01-31,San Luis Obispo,079,281455,49060,47656,3304,50960,395
2022-01-31,San Mateo,081,765935,113824,103313,6356,109669,589
2022-01-31,Santa Barbara,083,443738,80564,79267,4448,83715,606
2022-01-31,Santa Clara,085,1922200,290440,284562,11150,295712,2041
2022-01-31,Santa Cruz,087,273765,42540,41630,1943,43573,239
2022-01-31,Shasta,089,179085,28708,28190,5632,33822,462
2022-01-31,Sierra,091,2930,266,261,39,300,0
2022-01-31,Siskiyou,093,43540,4161,4054,2456,6510,66
2022-01-31,Solano,095,438530,76050,72258,5120,77378,414
2022-01-31,Sonoma,097,501317,77962,76199,2181,78380,431
2022-01-31,Stanislaus,099,539301,111530,110493,15651,126144,1403
2022-01-31,Sutter,101,95872,19547,19189,1707,20896,202
2022-01-31,Tehama,103,63373,11351,11112,2444,13556,145
2022-01-31,Trinity,105,12862,1109,1071,266,1337,19
2022-01-31,Tulare,107,460477,99146,96053,25797,121850,1245
2022-01-31,Tuolumne,109,53932,11802,11278,468,11746,91
2022-01-31,Ventura,111,848112,166079,164060,8930,172990,1286
2022-01-31,Yolo,113,214977,34238,33175,2857,36032,274
2022-01-31,Yuba,115,75493,14910,14652,1030,15682,103
2022-01-30,Alameda,001,1643700,237980,231838,12444,244282,1607
2022-01-30,Alpine,003,1148,119,123,1,124,0
2022-01-30,Amador,005,37829,7890,7644,516,8160,73
2022-01-30,Butte,007,227075,30782,30255,6067,36322,354
2022-01-30,Calaveras,009,45235,6784,6676,279,6955,96
2022-01-30,Colusa,011,21464,3252,3168,993,4161,21
2022-01-30,Contra Costa,013,1133247,176831,172902,11485,184387,1102
2022-01-30,Del Norte,015,27424,4941,4833,133,4966,43
2022-01-30,El Dorado,017,186661,25401,24491,2964,27455,184
2022-01-30,Fresno,019,978130,213823,209645,20410,230055,2463
2022-01-30,Glenn,021,27897,4691,4619,1450,6069,39
2022-01-30,Humboldt,023,135768,15423,15247,2428,17675,126
2022-01-30,Imperial,025,180216,52336,51415,9784,61199,846
2022-01-30,Inyo,027,18085,3938,3921,419,4340,50
2022-01-30,Kern,029,883053,182001,177924,42748,220672,1967
2022-01-30,Kings,031,150075,47811,46654,3263,49917,398
2022-01-30,Lake,033,64148,9548,9080,740,9820,119
2022-01-30,Lassen,035,31185,8343,8158,822,8980,55
2022-01-30,Los Angeles,037,10098052,2597626,2530739,117777,2648516,28678
2022-01-30,Madera,039,155013,34558,33752,5035,38787,329
2022-01-30,Marin,041,260295,31293,30875,2026,32901,253
2022-01-30,Mariposa,043,17540,2220,2177,139,2316,6
2022-01-30,Mendocino,045,87422,12091,11860,2336,14196,104
2022-01-30,Merced,047,269075,58736,58006,6859,64865,740
2022-01-30,Modoc,049,8938,671,661,231,892,6
2022-01-30,Mono,051,14174,2886,2888,115,3003,5
2022-01-30,Monterey,053,433212,73194,65996,11099,77095,661
2022-01-30,Napa,055,140530,23602,22588,819,23407,114
2022-01-30,Nevada,057,99092,15010,14741,1033,15774,112
2022-01-30,Orange,059,3164182,526231,521334,39021,560355,6098
2022-01-30,Placer,061,380077,59368,58030,6896,64926,523
2022-01-30,Plumas,063,18699,2687,2510,272,2782,12
2022-01-30,Riverside,065,2383286,568776,557088,26645,583733,5767
2022-01-30,Sacramento,067,1510023,260802,255715,23612,279327,2572
2022-01-30,San Benito,069,59416,12107,11945,473,12418,90
2022-01-30,San Bernardino,071,2135413,544255,534050,23612,557662,6302
2022-01-30,San Diego,073,3302833,712053,687145,47797,734942,4665
2022-01-30,San Francisco,075,870044,115830,110772,7814,118586,712
2022-01-30,San Joaquin,077,732212,157204,155165,8664,163829,1985
2022-01-30,San Luis Obispo,079,281455,48661,47599,3267,50866,394
2022-01-30,San Mateo,081,765935,113253,102979,6307,109286,589
2022-01-30,Santa Barbara,083,443738,79886,79072,4385,83457,606
2022-01-30,Santa Clara,085,1922200,288438,282846,11018,293864,2035
2022-01-30,Santa Cruz,087,273765,42098,41330,1933,43263,239
2022-01-30,Shasta,089,179085,28545,28105,5545,33650,462
2022-01-30,Sierra,091,2930,266,261,39,300,0
2022-01-30,Siskiyou,093,43540,4131,4039,2409,6448,66
2022-01-30,Solano,095,438530,75523,71857,5072,76929,414
2022-01-30,Sonoma,097,501317,77445,75890,2160,78050,431
2022-01-30,Stanislaus,099,539301,110877,110111,15451,125562,1403
2022-01-30,Sutter,101,95872,19454,19108,1607,20715,202
2022-01-30,Tehama,103,63373,11277,11071,2413,13484,145
2022-01-30,Trinity,105,12862,1103,1068,266,1334,19
2022-01-30,Tulare,107,460477,98455,95676,25523,121199,1245
2022-01-30,Tuolumne,109,53932,11693,11242,431,11673,91
2022-01-30,Ventura,111,848112,165497,163521,8900,172421,1286
2022-01-30,Yolo,113,214977,34037,33043,2823,35866,274
2022-01-30,Yuba,115,75493,14820,14584,1010,15594,103
2022-01-29,Alameda,001,1643700,237305,225602,12427,238029,1605
2022-01-29,Alpine,003,1148,119,123,1,124,0
2022-01-29,Amador,005,37829,7868,7505,513,8018,73
2022-01-29,Butte,007,227075,30697,29557,6043,35600,353
2022-01-29,Calaveras,009,45235,6765,6484,279,6763,96
2022-01-29,Colusa,011,21464,3246,3107,989,4096,21
2022-01-29,Contra Costa,013,1133247,176302,168003,11455,179458,1101
2022-01-29,Del Norte,015,27424,4923,4589,130,4719,43
2022-01-29,El Dorado,017,186661,25358,24008,2957,26965,184
2022-01-29,Fresno,019,978130,213365,202691,20376,223067,2457
2022-01-29,Glenn,021,27897,4684,4516,1443,5959,39
2022-01-29,Humboldt,023,135768,15376,14812,2421,17233,126
2022-01-29,Imperial,025,180216,52222,50153,9726,59879,845
2022-01-29,Inyo,027,18085,3936,3895,411,4306,50
2022-01-29,Kern,029,883053,181665,174456,42581,217037,1962
2022-01-29,Kings,031,150075,47696,45047,3256,48303,397
2022-01-29,Lake,033,64148,9514,8747,736,9483,119
2022-01-29,Lassen,035,31185,8325,7961,819,8780,55
2022-01-29,Los Angeles,037,10098052,2593720,2473332,117509,2590841,28467
2022-01-29,Madera,039,155013,34447,32753,5010,37763,329
2022-01-29,Marin,041,260295,31227,30137,2024,32161,253
2022-01-29,Mariposa,043,17540,2218,2117,137,2254,6
2022-01-29,Mendocino,045,87422,12067,11591,2321,13912,104
2022-01-29,Merced,047,269075,58629,56472,6854,63326,735
2022-01-29,Modoc,049,8938,671,654,231,885,6
2022-01-29,Mono,051,14174,2884,2860,115,2975,5
2022-01-29,Monterey,053,433212,73040,64090,11046,75136,658
2022-01-29,Napa,055,140530,23545,22121,817,22938,113
2022-01-29,Nevada,057,99092,14976,14337,1030,15367,112
2022-01-29,Orange,059,3164182,525527,511255,38913,550168,6038
2022-01-29,Placer,061,380077,59174,56562,6879,63441,523
2022-01-29,Plumas,063,18699,2677,2463,268,2731,12
2022-01-29,Riverside,065,2383286,567752,548121,26603,574724,5726
2022-01-29,Sacramento,067,1510023,260188,249130,23557,272687,2558
2022-01-29,San Benito,069,59416,12048,11670,472,12142,90
2022-01-29,San Bernardino,071,2135413,543524,525249,23568,548817,6297
2022-01-29,San Diego,073,3302833,710725,683027,47705,730732,4643
2022-01-29,San Francisco,075,870044,115555,108265,7766,116031,712
2022-01-29,San Joaquin,077,732212,156958,150849,8650,159499,1971
2022-01-29,San Luis Obispo,079,281455,48572,46374,3263,49637,391
2022-01-29,San Mateo,081,765935,112915,100306,6282,106588,586
2022-01-29,Santa Barbara,083,443738,79663,76546,4378,80924,604
2022-01-29,Santa Clara,085,1922200,287487,273879,10990,284869,2019
2022-01-29,Santa Cruz,087,273765,41971,39228,1931,41159,240
2022-01-29,Shasta,089,179085,28488,27504,5531,33035,452
2022-01-29,Sierra,091,2930,266,260,39,299,0
2022-01-29,Siskiyou,093,43540,4121,3987,2402,6389,66
2022-01-29,Solano,095,438530,75378,69862,5060,74922,407
2022-01-29,Sonoma,097,501317,77230,73439,2155,75594,427
2022-01-29,Stanislaus,099,539301,110627,107668,15405,123073,1403
2022-01-29,Sutter,101,95872,19405,18797,1590,20387,202
2022-01-29,Tehama,103,63373,11244,10880,2408,13288,145
2022-01-29,Trinity,105,12862,1100,1033,265,1298,19
2022-01-29,Tulare,107,460477,98205,93154,25449,118603,1237
2022-01-29,Tuolumne,109,53932,11668,10806,423,11229,91
2022-01-29,Ventura,111,848112,165167,160466,8883,169349,1271
2022-01-29,Yolo,113,214977,33927,32123,2807,34930,275
2022-01-29,Yuba,115,75493,14779,14295,1008,15303,103
2022-01-28,Alameda,001,1643700,236362,225602,12409,238011,1605
2022-01-28,Alpine,003,1148,119,123,1,124,0
2022-01-28,Amador,005,37829,7842,7505,512,8017,73
2022-01-28,Butte,007,227075,30619,29557,6024,35581,353
2022-01-28,Calaveras,009,45235,6748,6484,278,6762,96
2022-01-28,Colusa,011,21464,3241,3107,987,4094,21
2022-01-28,Contra Costa,013,1133247,175765,168003,11417,179420,1101
2022-01-28,Del Norte,015,27424,4899,4589,129,4718,43
2022-01-28,El Dorado,017,186661,25315,24008,2950,26958,184
2022-01-28,Fresno,019,978130,212499,202691,20324,223015,2457
2022-01-28,Glenn,021,27897,4671,4516,1441,5957,39
2022-01-28,Humboldt,023,135768,15339,14812,2411,17223,126
2022-01-28,Imperial,025,180216,52095,50153,9690,59843,845
2022-01-28,Inyo,027,18085,3932,3895,408,4303,50
2022-01-28,Kern,029,883053,181251,174456,42421,216877,1962
2022-01-28,Kings,031,150075,47565,45047,3246,48293,397
2022-01-28,Lake,033,64148,9481,8747,734,9481,119
2022-01-28,Lassen,035,31185,8258,7961,817,8778,55
2022-01-28,Los Angeles,037,10098052,2587973,2473332,117294,2590626,28467
2022-01-28,Madera,039,155013,34315,32753,4993,37746,329
2022-01-28,Marin,041,260295,31135,30137,2002,32139,253
2022-01-28,Mariposa,043,17540,2208,2117,135,2252,6
2022-01-28,Mendocino,045,87422,12023,11591,2319,13910,104
2022-01-28,Merced,047,269075,58531,56472,6839,63311,735
2022-01-28,Modoc,049,8938,670,654,231,885,6
2022-01-28,Mono,051,14174,2879,2860,114,2974,5
2022-01-28,Monterey,053,433212,72841,64090,10997,75087,658
2022-01-28,Napa,055,140530,23468,22121,815,22936,113
2022-01-28,Nevada,057,99092,14939,14337,1028,15365,112
2022-01-28,Orange,059,3164182,524452,511255,38823,550078,6038
2022-01-28,Placer,061,380077,58968,56562,6856,63418,523
2022-01-28,Plumas,063,18699,2669,2463,266,2729,12
2022-01-28,Riverside,065,2383286,566421,548121,26562,574683,5726
2022-01-28,Sacramento,067,1510023,259436,249130,23502,272632,2558
2022-01-28,San Benito,069,59416,12026,11670,467,12137,90
2022-01-28,San Bernardino,071,2135413,542491,525249,23532,548781,6297
2022-01-28,San Diego,073,3302833,708898,683027,47632,730659,4643
2022-01-28,San Francisco,075,870044,115192,108265,7717,115982,712
2022-01-28,San Joaquin,077,732212,156666,150849,8640,159489,1971
2022-01-28,San Luis Obispo,079,281455,48488,46374,3255,49629,391
2022-01-28,San Mateo,081,765935,112571,100306,6259,106565,586
2022-01-28,Santa Barbara,083,443738,79415,76546,4375,80921,604
2022-01-28,Santa Clara,085,1922200,286276,273879,10942,284821,2019
2022-01-28,Santa Cruz,087,273765,41789,39228,1918,41146,240
2022-01-28,Shasta,089,179085,28431,27504,5517,33021,452
2022-01-28,Sierra,091,2930,266,260,39,299,0
2022-01-28,Siskiyou,093,43540,4111,3987,2398,6385,66
2022-01-28,Solano,095,438530,74810,69862,4993,74855,407
2022-01-28,Sonoma,097,501317,77027,73439,2148,75587,427
2022-01-28,Stanislaus,099,539301,110352,107668,15362,123030,1403
2022-01-28,Sutter,101,95872,19361,18797,1588,20385,202
2022-01-28,Tehama,103,63373,11212,10880,2401,13281,145
2022-01-28,Trinity,105,12862,1091,1033,265,1298,19
2022-01-28,Tulare,107,460477,97949,93154,25341,118495,1237
2022-01-28,Tuolumne,109,53932,11635,10806,419,11225,91
2022-01-28,Ventura,111,848112,164714,160466,8864,169330,1271
2022-01-28,Yolo,113,214977,33823,32123,2800,34923,275
2022-01-28,Yuba,115,75493,14739,14295,1003,15298,103
2022-01-27,Alameda,001,1643700,234784,225602,12273,237875,1605
2022-01-27,Alpine,003,1148,119,123,1,124,0
2022-01-27,Amador,005,37829,7795,7505,500,8005,73
2022-01-27,Butte,007,227075,30466,29557,5972,35529,353
2022-01-27,Calaveras,009,45235,6723,6484,262,6746,96
2022-01-27,Colusa,011,21464,3227,3107,983,4090,21
2022-01-27,Contra Costa,013,1133247,174742,168003,11240,179243,1101
2022-01-27,Del Norte,015,27424,4855,4589,125,4714,43
2022-01-27,El Dorado,017,186661,25204,24008,2931,26939,184
2022-01-27,Fresno,019,978130,210877,202691,20126,222817,2457
2022-01-27,Glenn,021,27897,4640,4516,1433,5949,39
2022-01-27,Humboldt,023,135768,15249,14812,2374,17186,126
2022-01-27,Imperial,025,180216,51831,50153,9576,59729,845
2022-01-27,Inyo,027,18085,3925,3895,398,4293,50
2022-01-27,Kern,029,883053,180477,174456,42054,216510,1962
2022-01-27,Kings,031,150075,47219,45047,3207,48254,397
2022-01-27,Lake,033,64148,9428,8747,717,9464,119
2022-01-27,Lassen,035,31185,8215,7961,811,8772,55
2022-01-27,Los Angeles,037,10098052,2576814,2473332,116783,2590115,28467
2022-01-27,Madera,039,155013,34100,32753,4886,37639,329
2022-01-27,Marin,041,260295,30973,30137,1987,32124,253
2022-01-27,Mariposa,043,17540,2185,2117,132,2249,6
2022-01-27,Mendocino,045,87422,11972,11591,2270,13861,104
2022-01-27,Merced,047,269075,58270,56472,6674,63146,735
2022-01-27,Modoc,049,8938,668,654,230,884,6
2022-01-27,Mono,051,14174,2874,2860,114,2974,5
2022-01-27,Monterey,053,433212,72227,64090,10742,74832,658
2022-01-27,Napa,055,140530,23310,22121,787,22908,113
2022-01-27,Nevada,057,99092,14866,14337,1000,15337,112
2022-01-27,Orange,059,3164182,522721,511255,38686,549941,6038
2022-01-27,Placer,061,380077,58651,56562,6804,63366,523
2022-01-27,Plumas,063,18699,2659,2463,253,2716,12
2022-01-27,Riverside,065,2383286,564250,548121,26493,574614,5726
2022-01-27,Sacramento,067,1510023,258204,249130,23165,272295,2558
2022-01-27,San Benito,069,59416,11968,11670,462,12132,90
2022-01-27,San Bernardino,071,2135413,540652,525249,23431,548680,6297
2022-01-27,San Diego,073,3302833,705524,683027,47287,730314,4643
2022-01-27,San Francisco,075,870044,114689,108265,7655,115920,712
2022-01-27,San Joaquin,077,732212,155800,150849,8591,159440,1971
2022-01-27,San Luis Obispo,079,281455,48214,46374,3217,49591,391
2022-01-27,San Mateo,081,765935,111996,100306,6187,106493,586
2022-01-27,Santa Barbara,083,443738,78937,76546,4320,80866,604
2022-01-27,Santa Clara,085,1922200,284181,273879,10794,284673,2019
2022-01-27,Santa Cruz,087,273765,41140,39228,1897,41125,240
2022-01-27,Shasta,089,179085,28297,27504,5466,32970,452
2022-01-27,Sierra,091,2930,265,260,39,299,0
2022-01-27,Siskiyou,093,43540,4090,3987,2361,6348,66
2022-01-27,Solano,095,438530,74148,69862,4944,74806,407
2022-01-27,Sonoma,097,501317,76563,73439,2137,75576,427
2022-01-27,Stanislaus,099,539301,109823,107668,15218,122886,1403
2022-01-27,Sutter,101,95872,19252,18797,1562,20359,202
2022-01-27,Tehama,103,63373,11160,10880,2386,13266,145
2022-01-27,Trinity,105,12862,1087,1033,264,1297,19
2022-01-27,Tulare,107,460477,97331,93154,25074,118228,1237
2022-01-27,Tuolumne,109,53932,11583,10806,410,11216,91
2022-01-27,Ventura,111,848112,164062,160466,8832,169298,1271
2022-01-27,Yolo,113,214977,33688,32123,2784,34907,275
2022-01-27,Yuba,115,75493,14660,14295,987,15282,103
2022-01-26,Alameda,001,1643700,232900,222680,12111,234791,1596
2022-01-26,Alpine,003,1148,119,123,1,124,0
2022-01-26,Amador,005,37829,7720,7427,486,7913,73
2022-01-26,Butte,007,227075,30268,29229,5917,35146,353
2022-01-26,Calaveras,009,45235,6685,6387,255,6642,96
2022-01-26,Colusa,011,21464,3211,3094,977,4071,21
2022-01-26,Contra Costa,013,1133247,173600,165972,11077,177049,1095
2022-01-26,Del Norte,015,27424,4798,4542,124,4666,43
2022-01-26,El Dorado,017,186661,25082,23819,2908,26727,181
2022-01-26,Fresno,019,978130,209025,199689,19918,219607,2452
2022-01-26,Glenn,021,27897,4607,4472,1428,5900,39
2022-01-26,Humboldt,023,135768,15149,14715,2329,17044,126
2022-01-26,Imperial,025,180216,51472,49477,9416,58893,839
2022-01-26,Inyo,027,18085,3922,3889,367,4256,50
2022-01-26,Kern,029,883053,179568,173052,41709,214761,1953
2022-01-26,Kings,031,150075,46815,44367,3177,47544,396
2022-01-26,Lake,033,64148,9346,8645,707,9352,119
2022-01-26,Lassen,035,31185,8179,7888,811,8699,55
2022-01-26,Los Angeles,037,10098052,2564584,2450620,116334,2566954,28382
2022-01-26,Madera,039,155013,33859,32323,4760,37083,329
2022-01-26,Marin,041,260295,30790,29813,1968,31781,253
2022-01-26,Mariposa,043,17540,2168,2108,125,2233,6
2022-01-26,Mendocino,045,87422,11925,11453,2220,13673,103
2022-01-26,Merced,047,269075,57903,56060,6498,62558,733
2022-01-26,Modoc,049,8938,667,652,229,881,6
2022-01-26,Mono,051,14174,2871,2852,114,2966,4
2022-01-26,Monterey,053,433212,71680,63264,10448,73712,659
2022-01-26,Napa,055,140530,23154,21864,776,22640,112
2022-01-26,Nevada,057,99092,14772,14128,989,15117,112
2022-01-26,Orange,059,3164182,520728,506419,38521,544940,6007
2022-01-26,Placer,061,380077,58317,55892,6740,62632,524
2022-01-26,Plumas,063,18699,2632,2425,251,2676,12
2022-01-26,Riverside,065,2383286,561722,543788,26375,570163,5701
2022-01-26,Sacramento,067,1510023,256617,246416,22818,269234,2559
2022-01-26,San Benito,069,59416,11897,11563,449,12012,90
2022-01-26,San Bernardino,071,2135413,538489,521699,23324,545023,6291
2022-01-26,San Diego,073,3302833,701293,676392,46929,723321,4622
2022-01-26,San Francisco,075,870044,114051,107174,7619,114793,704
2022-01-26,San Joaquin,077,732212,154806,148770,8542,157312,1971
2022-01-26,San Luis Obispo,079,281455,47910,45716,3190,48906,391
2022-01-26,San Mateo,081,765935,111352,99016,6056,105072,586
2022-01-26,Santa Barbara,083,443738,78409,75548,4259,79807,600
2022-01-26,Santa Clara,085,1922200,282052,270470,10616,281086,2015
2022-01-26,Santa Cruz,087,273765,40644,38298,1882,40180,239
2022-01-26,Shasta,089,179085,28149,27255,5416,32671,452
2022-01-26,Sierra,091,2930,264,260,38,298,0
2022-01-26,Siskiyou,093,43540,4074,3971,2336,6307,66
2022-01-26,Solano,095,438530,73444,69150,4884,74034,401
2022-01-26,Sonoma,097,501317,76008,72509,2105,74614,423
2022-01-26,Stanislaus,099,539301,109265,106582,15002,121584,1396
2022-01-26,Sutter,101,95872,19141,18670,1516,20186,202
2022-01-26,Tehama,103,63373,11107,10749,2370,13119,145
2022-01-26,Trinity,105,12862,1082,1008,264,1272,19
2022-01-26,Tulare,107,460477,96593,91904,24824,116728,1234
2022-01-26,Tuolumne,109,53932,11400,10699,399,11098,91
2022-01-26,Ventura,111,848112,163350,159077,8792,167869,1263
2022-01-26,Yolo,113,214977,33477,31913,2744,34657,275
2022-01-26,Yuba,115,75493,14575,14171,965,15136,103
2022-01-25,Alameda,001,1643700,231004,219753,11929,231682,1589
2022-01-25,Alpine,003,1148,119,122,1,123,0
2022-01-25,Amador,005,37829,7643,7352,475,7827,73
2022-01-25,Butte,007,227075,30061,28887,5845,34732,351
2022-01-25,Calaveras,009,45235,6626,6266,241,6507,95
2022-01-25,Colusa,011,21464,3191,3074,975,4049,21
2022-01-25,Contra Costa,013,1133247,172266,163792,10862,174654,1092
2022-01-25,Del Norte,015,27424,4727,4514,118,4632,43
2022-01-25,El Dorado,017,186661,24946,23339,2882,26221,179
2022-01-25,Fresno,019,978130,206881,198262,19645,217907,2434
2022-01-25,Glenn,021,27897,4574,4418,1412,5830,39
2022-01-25,Humboldt,023,135768,15056,14574,2303,16877,126
2022-01-25,Imperial,025,180216,51010,48913,9175,58088,832
2022-01-25,Inyo,027,18085,3907,3857,322,4179,50
2022-01-25,Kern,029,883053,178558,171695,41244,212939,1947
2022-01-25,Kings,031,150075,46340,43853,3132,46985,396
2022-01-25,Lake,033,64148,9267,8543,695,9238,118
2022-01-25,Lassen,035,31185,8149,7834,800,8634,55
2022-01-25,Los Angeles,037,10098052,2549637,2433516,115699,2549215,28293
2022-01-25,Madera,039,155013,33536,31794,4620,36414,329
2022-01-25,Marin,041,260295,30610,29589,1955,31544,253
2022-01-25,Mariposa,043,17540,2156,2069,119,2188,6
2022-01-25,Mendocino,045,87422,11805,11280,2117,13397,103
2022-01-25,Merced,047,269075,57527,55555,6355,61910,733
2022-01-25,Modoc,049,8938,665,652,229,881,6
2022-01-25,Mono,051,14174,2861,2826,113,2939,4
2022-01-25,Monterey,053,433212,71111,62498,10040,72538,654
2022-01-25,Napa,055,140530,22959,21668,740,22408,111
2022-01-25,Nevada,057,99092,14657,13944,965,14909,112
2022-01-25,Orange,059,3164182,518438,504274,38328,542602,5980
2022-01-25,Placer,061,380077,57918,55465,6667,62132,518
2022-01-25,Plumas,063,18699,2607,2397,247,2644,12
2022-01-25,Riverside,065,2383286,558640,540723,26205,566928,5686
2022-01-25,Sacramento,067,1510023,254790,244468,22283,266751,2545
2022-01-25,San Benito,069,59416,11798,11446,445,11891,88
2022-01-25,San Bernardino,071,2135413,536005,519150,23210,542360,6288
2022-01-25,San Diego,073,3302833,696276,670110,46475,716585,4604
2022-01-25,San Francisco,075,870044,113285,106254,7574,113828,703
2022-01-25,San Joaquin,077,732212,153807,147271,8488,155759,1972
2022-01-25,San Luis Obispo,079,281455,47549,45130,3142,48272,391
2022-01-25,San Mateo,081,765935,110559,98010,5944,103954,586
2022-01-25,Santa Barbara,083,443738,77741,74686,4177,78863,594
2022-01-25,Santa Clara,085,1922200,279395,268031,10409,278440,2006
2022-01-25,Santa Cruz,087,273765,39998,37850,1867,39717,237
2022-01-25,Shasta,089,179085,27986,27090,5346,32436,452
2022-01-25,Sierra,091,2930,264,260,33,293,0
2022-01-25,Siskiyou,093,43540,4050,3958,2300,6258,65
2022-01-25,Solano,095,438530,72868,68657,4832,73489,399
2022-01-25,Sonoma,097,501317,75313,71633,2067,73700,423
2022-01-25,Stanislaus,099,539301,108597,105965,14777,120742,1396
2022-01-25,Sutter,101,95872,19038,18508,1474,19982,200
2022-01-25,Tehama,103,63373,11045,10669,2345,13014,145
2022-01-25,Trinity,105,12862,1075,999,262,1261,19
2022-01-25,Tulare,107,460477,95768,91237,24489,115726,1229
2022-01-25,Tuolumne,109,53932,11220,10516,375,10891,91
2022-01-25,Ventura,111,848112,162496,157971,8748,166719,1263
2022-01-25,Yolo,113,214977,33216,31677,2697,34374,274
2022-01-25,Yuba,115,75493,14491,14038,937,14975,103
2022-01-24,Alameda,001,1643700,228568,216252,11661,227913,1581
2022-01-24,Alpine,003,1148,119,120,1,121,0
2022-01-24,Amador,005,37829,7593,7166,437,7603,73
2022-01-24,Butte,007,227075,29829,28607,5781,34388,350
2022-01-24,Calaveras,009,45235,6579,6172,227,6399,95
2022-01-24,Colusa,011,21464,3172,3052,959,4011,21
2022-01-24,Contra Costa,013,1133247,170771,162161,10646,172807,1092
2022-01-24,Del Norte,015,27424,4667,4460,118,4578,43
2022-01-24,El Dorado,017,186661,24778,23128,2852,25980,179
2022-01-24,Fresno,019,978130,204567,196092,19350,215442,2430
2022-01-24,Glenn,021,27897,4532,4367,1402,5769,39
2022-01-24,Humboldt,023,135768,14944,14416,2257,16673,126
2022-01-24,Imperial,025,180216,50468,48228,8867,57095,824
2022-01-24,Inyo,027,18085,3901,3805,297,4102,50
2022-01-24,Kern,029,883053,177249,169892,40763,210655,1946
2022-01-24,Kings,031,150075,45761,43260,3059,46319,396
2022-01-24,Lake,033,64148,9158,8423,680,9103,118
2022-01-24,Lassen,035,31185,8065,7732,781,8513,55
2022-01-24,Los Angeles,037,10098052,2533110,2391045,114926,2505971,28230
2022-01-24,Madera,039,155013,33096,31339,4435,35774,329
2022-01-24,Marin,041,260295,30381,29301,1917,31218,253
2022-01-24,Mariposa,043,17540,2131,2033,115,2148,6
2022-01-24,Mendocino,045,87422,11701,11002,2039,13041,103
2022-01-24,Merced,047,269075,57036,54970,6074,61044,730
2022-01-24,Modoc,049,8938,662,648,228,876,6
2022-01-24,Mono,051,14174,2851,2802,112,2914,4
2022-01-24,Monterey,053,433212,70261,61975,9676,71651,654
2022-01-24,Napa,055,140530,22779,21494,727,22221,111
2022-01-24,Nevada,057,99092,14529,13774,942,14716,112
2022-01-24,Orange,059,3164182,515849,501634,38080,539714,5969
2022-01-24,Placer,061,380077,57432,54933,6619,61552,518
2022-01-24,Plumas,063,18699,2575,2370,233,2603,12
2022-01-24,Riverside,065,2383286,554918,535962,25995,561957,5661
2022-01-24,Sacramento,067,1510023,252562,241522,21716,263238,2526
2022-01-24,San Benito,069,59416,11702,11331,432,11763,88
2022-01-24,San Bernardino,071,2135413,533184,515604,23050,538654,6285
2022-01-24,San Diego,073,3302833,690590,663580,45928,709508,4586
2022-01-24,San Francisco,075,870044,112320,105418,7475,112893,703
2022-01-24,San Joaquin,077,732212,152475,145984,8440,154424,1959
2022-01-24,San Luis Obispo,079,281455,47070,44616,3087,47703,387
2022-01-24,San Mateo,081,765935,109621,96968,5824,102792,586
2022-01-24,Santa Barbara,083,443738,76935,73866,4081,77947,591
2022-01-24,Santa Clara,085,1922200,276464,265341,10199,275540,2006
2022-01-24,Santa Cruz,087,273765,39230,37188,1847,39035,237
2022-01-24,Shasta,089,179085,27798,26871,5256,32127,452
2022-01-24,Sierra,091,2930,264,258,33,291,0
2022-01-24,Siskiyou,093,43540,4040,3934,2261,6195,64
2022-01-24,Solano,095,438530,72184,68094,4753,72847,400
2022-01-24,Sonoma,097,501317,74402,70733,2040,72773,423
2022-01-24,Stanislaus,099,539301,107842,104933,14501,119434,1395
2022-01-24,Sutter,101,95872,18920,18336,1381,19717,200
2022-01-24,Tehama,103,63373,10974,10567,2326,12893,145
2022-01-24,Trinity,105,12862,1067,978,260,1238,19
2022-01-24,Tulare,107,460477,94755,90089,24122,114211,1219
2022-01-24,Tuolumne,109,53932,11102,10374,365,10739,91
2022-01-24,Ventura,111,848112,161472,156551,8703,165254,1261
2022-01-24,Yolo,113,214977,32924,31480,2663,34143,273
2022-01-24,Yuba,115,75493,14384,13862,896,14758,103
2022-01-23,Alameda,001,1643700,225892,214003,11325,225328,1583
2022-01-23,Alpine,003,1148,119,120,1,121,0
2022-01-23,Amador,005,37829,7538,7090,397,7487,73
2022-01-23,Butte,007,227075,29537,28340,5673,34013,350
2022-01-23,Calaveras,009,45235,6514,6095,204,6299,95
2022-01-23,Colusa,011,21464,3146,3040,952,3992,21
2022-01-23,Contra Costa,013,1133247,168907,160798,10274,171072,1092
2022-01-23,Del Norte,015,27424,4600,4419,112,4531,43
2022-01-23,El Dorado,017,186661,24586,22925,2803,25728,179
2022-01-23,Fresno,019,978130,202099,193642,18897,212539,2430
2022-01-23,Glenn,021,27897,4481,4340,1378,5718,39
2022-01-23,Humboldt,023,135768,14825,14296,2174,16470,126
2022-01-23,Imperial,025,180216,49876,47935,8584,56519,824
2022-01-23,Inyo,027,18085,3874,3781,283,4064,50
2022-01-23,Kern,029,883053,175899,168585,40238,208823,1946
2022-01-23,Kings,031,150075,45125,42622,2955,45577,397
2022-01-23,Lake,033,64148,8989,8363,653,9016,118
2022-01-23,Lassen,035,31185,8015,7710,757,8467,55
2022-01-23,Los Angeles,037,10098052,2512772,2390590,113777,2504367,28231
2022-01-23,Madera,039,155013,32730,30962,4193,35155,329
2022-01-23,Marin,041,260295,30127,29025,1878,30903,253
2022-01-23,Mariposa,043,17540,2116,2011,112,2123,6
2022-01-23,Mendocino,045,87422,11576,10889,1915,12804,103
2022-01-23,Merced,047,269075,56491,54644,5630,60274,730
2022-01-23,Modoc,049,8938,660,645,225,870,6
2022-01-23,Mono,051,14174,2843,2788,110,2898,4
2022-01-23,Monterey,053,433212,69439,61522,9237,70759,654
2022-01-23,Napa,055,140530,22516,21281,714,21995,111
2022-01-23,Nevada,057,99092,14366,13629,914,14543,112
2022-01-23,Orange,059,3164182,512751,498968,37793,536761,5970
2022-01-23,Placer,061,380077,56861,54568,6533,61101,518
2022-01-23,Plumas,063,18699,2543,2368,204,2572,12
2022-01-23,Riverside,065,2383286,550490,532273,25689,557962,5661
2022-01-23,Sacramento,067,1510023,250029,239589,20770,260359,2530
2022-01-23,San Benito,069,59416,11578,11225,421,11646,88
2022-01-23,San Bernardino,071,2135413,529847,512657,22796,535453,6281
2022-01-23,San Diego,073,3302833,683923,640215,45135,685350,4566
2022-01-23,San Francisco,075,870044,111237,104485,7359,111844,704
2022-01-23,San Joaquin,077,732212,150857,144621,8364,152985,1959
2022-01-23,San Luis Obispo,079,281455,46376,44183,3007,47190,386
2022-01-23,San Mateo,081,765935,108548,95940,5677,101617,586
2022-01-23,Santa Barbara,083,443738,75806,73041,3952,76993,590
2022-01-23,Santa Clara,085,1922200,273104,261991,9870,271861,2005
2022-01-23,Santa Cruz,087,273765,38713,36547,1816,38363,237
2022-01-23,Shasta,089,179085,27501,26732,5133,31865,452
2022-01-23,Sierra,091,2930,263,252,33,285,0
2022-01-23,Siskiyou,093,43540,4014,3916,2203,6119,64
2022-01-23,Solano,095,438530,71387,67457,4657,72114,400
2022-01-23,Sonoma,097,501317,73457,69791,1993,71784,423
2022-01-23,Stanislaus,099,539301,106978,104067,14220,118287,1395
2022-01-23,Sutter,101,95872,18756,18175,1264,19439,200
2022-01-23,Tehama,103,63373,10873,10481,2295,12776,145
2022-01-23,Trinity,105,12862,1064,961,258,1219,19
2022-01-23,Tulare,107,460477,93601,89120,23693,112813,1219
2022-01-23,Tuolumne,109,53932,10911,10243,347,10590,91
2022-01-23,Ventura,111,848112,160288,155052,8631,163683,1261
2022-01-23,Yolo,113,214977,32558,30908,2621,33529,273
2022-01-23,Yuba,115,75493,14258,13762,841,14603,103
2022-01-22,Alameda,001,1643700,224801,203927,11292,215219,1575
2022-01-22,Alpine,003,1148,118,119,1,120,0
2022-01-22,Amador,005,37829,7505,6845,392,7237,73
2022-01-22,Butte,007,227075,29420,27232,5649,32881,350
2022-01-22,Calaveras,009,45235,6484,5835,203,6038,95
2022-01-22,Colusa,011,21464,3129,2954,949,3903,21
2022-01-22,Contra Costa,013,1133247,167968,154111,10244,164355,1091
2022-01-22,Del Norte,015,27424,4564,4269,108,4377,43
2022-01-22,El Dorado,017,186661,24516,22273,2793,25066,179
2022-01-22,Fresno,019,978130,201280,185292,18845,204137,2429
2022-01-22,Glenn,021,27897,4475,4174,1375,5549,39
2022-01-22,Humboldt,023,135768,14758,13628,2161,15789,125
2022-01-22,Imperial,025,180216,49687,45741,8519,54260,820
2022-01-22,Inyo,027,18085,3870,3706,259,3965,50
2022-01-22,Kern,029,883053,175277,162902,39930,202832,1946
2022-01-22,Kings,031,150075,44919,40580,2943,43523,396
2022-01-22,Lake,033,64148,8955,8056,645,8701,118
2022-01-22,Lassen,035,31185,7982,7545,750,8295,55
2022-01-22,Los Angeles,037,10098052,2505349,2286280,113273,2399553,28038
2022-01-22,Madera,039,155013,32610,29595,4179,33774,329
2022-01-22,Marin,041,260295,30001,27893,1873,29766,253
2022-01-22,Mariposa,043,17540,2112,1920,112,2032,6
2022-01-22,Mendocino,045,87422,11526,10395,1893,12288,103
2022-01-22,Merced,047,269075,56342,53025,5621,58646,727
2022-01-22,Modoc,049,8938,659,639,225,864,6
2022-01-22,Mono,051,14174,2842,2723,106,2829,4
2022-01-22,Monterey,053,433212,69235,59038,9199,68237,651
2022-01-22,Napa,055,140530,22421,20402,704,21106,111
2022-01-22,Nevada,057,99092,14299,12957,906,13863,112
2022-01-22,Orange,059,3164182,511147,480329,37544,517873,5946
2022-01-22,Placer,061,380077,56595,52557,6494,59051,512
2022-01-22,Plumas,063,18699,2525,2289,200,2489,12
2022-01-22,Riverside,065,2383286,548575,513567,25617,539184,5623
2022-01-22,Sacramento,067,1510023,249033,230206,20666,250872,2510
2022-01-22,San Benito,069,59416,11518,10743,416,11159,88
2022-01-22,San Bernardino,071,2135413,528388,495209,22714,517923,6267
2022-01-22,San Diego,073,3302833,681453,628904,44935,673839,4559
2022-01-22,San Francisco,075,870044,110581,100238,7210,107448,702
2022-01-22,San Joaquin,077,732212,150419,138264,8336,146600,1960
2022-01-22,San Luis Obispo,079,281455,46258,42154,3000,45154,385
2022-01-22,San Mateo,081,765935,107980,91440,5611,97051,585
2022-01-22,Santa Barbara,083,443738,75386,69555,3946,73501,589
2022-01-22,Santa Clara,085,1922200,271394,249205,9803,259008,1993
2022-01-22,Santa Cruz,087,273765,38538,33741,1810,35551,237
2022-01-22,Shasta,089,179085,27408,25919,5111,31030,450
2022-01-22,Sierra,091,2930,263,248,32,280,0
2022-01-22,Siskiyou,093,43540,3996,3845,2182,6027,62
2022-01-22,Solano,095,438530,71163,63882,4618,68500,391
2022-01-22,Sonoma,097,501317,73036,66013,1984,67997,422
2022-01-22,Stanislaus,099,539301,106524,100092,14130,114222,1393
2022-01-22,Sutter,101,95872,18688,17616,1251,18867,199
2022-01-22,Tehama,103,63373,10838,10171,2287,12458,142
2022-01-22,Trinity,105,12862,1062,925,258,1183,19
2022-01-22,Tulare,107,460477,93236,85223,23571,108794,1211
2022-01-22,Tuolumne,109,53932,10843,9731,341,10072,91
2022-01-22,Ventura,111,848112,159596,148742,8601,157343,1250
2022-01-22,Yolo,113,214977,32386,30061,2603,32664,273
2022-01-22,Yuba,115,75493,14168,13288,836,14124,103
2022-01-21,Alameda,001,1643700,223225,203927,11262,215189,1575
2022-01-21,Alpine,003,1148,118,119,1,120,0
2022-01-21,Amador,005,37829,7448,6845,389,7234,73
2022-01-21,Butte,007,227075,29291,27232,5606,32838,350
2022-01-21,Calaveras,009,45235,6439,5835,203,6038,95
2022-01-21,Colusa,011,21464,3122,2954,944,3898,21
2022-01-21,Contra Costa,013,1133247,166907,154111,10163,164274,1091
2022-01-21,Del Norte,015,27424,4523,4269,108,4377,43
2022-01-21,El Dorado,017,186661,24434,22273,2776,25049,179
2022-01-21,Fresno,019,978130,200037,185292,18759,204051,2429
2022-01-21,Glenn,021,27897,4457,4174,1370,5544,39
2022-01-21,Humboldt,023,135768,14689,13628,2142,15770,125
2022-01-21,Imperial,025,180216,49496,45741,8441,54182,820
2022-01-21,Inyo,027,18085,3857,3706,253,3959,50
2022-01-21,Kern,029,883053,174557,162902,39556,202458,1946
2022-01-21,Kings,031,150075,44722,40580,2936,43516,396
2022-01-21,Lake,033,64148,8898,8056,632,8688,118
2022-01-21,Lassen,035,31185,7930,7545,746,8291,55
2022-01-21,Los Angeles,037,10098052,2494028,2286280,112816,2399096,28038
2022-01-21,Madera,039,155013,32317,29595,4151,33746,329
2022-01-21,Marin,041,260295,29824,27893,1852,29745,253
2022-01-21,Mariposa,043,17540,2100,1920,111,2031,6
2022-01-21,Mendocino,045,87422,11445,10395,1890,12285,103
2022-01-21,Merced,047,269075,56182,53025,5617,58642,727
2022-01-21,Modoc,049,8938,658,639,225,864,6
2022-01-21,Mono,051,14174,2828,2723,103,2826,4
2022-01-21,Monterey,053,433212,68778,59038,9073,68111,651
2022-01-21,Napa,055,140530,22302,20402,696,21098,111
2022-01-21,Nevada,057,99092,14202,12957,902,13859,112
2022-01-21,Orange,059,3164182,508893,480329,37301,517630,5946
2022-01-21,Placer,061,380077,56201,52557,6431,58988,512
2022-01-21,Plumas,063,18699,2513,2289,195,2484,12
2022-01-21,Riverside,065,2383286,545922,513567,25537,539104,5623
2022-01-21,Sacramento,067,1510023,247649,230206,20566,250772,2510
2022-01-21,San Benito,069,59416,11483,10743,413,11156,88
2022-01-21,San Bernardino,071,2135413,526445,495209,22645,517854,6267
2022-01-21,San Diego,073,3302833,677252,628904,44775,673679,4559
2022-01-21,San Francisco,075,870044,109816,100238,7114,107352,702
2022-01-21,San Joaquin,077,732212,149832,138264,8301,146565,1960
2022-01-21,San Luis Obispo,079,281455,46132,42154,2997,45151,385
2022-01-21,San Mateo,081,765935,107323,91440,5568,97008,585
2022-01-21,Santa Barbara,083,443738,74884,69555,3938,73493,589
2022-01-21,Santa Clara,085,1922200,269542,249205,9696,258901,1993
2022-01-21,Santa Cruz,087,273765,37842,33741,1797,35538,237
2022-01-21,Shasta,089,179085,27320,25919,5063,30982,450
2022-01-21,Sierra,091,2930,261,248,31,279,0
2022-01-21,Siskiyou,093,43540,3989,3845,2163,6008,62
2022-01-21,Solano,095,438530,70751,63882,4536,68418,391
2022-01-21,Sonoma,097,501317,72522,66013,1974,67987,422
2022-01-21,Stanislaus,099,539301,106019,100092,14068,114160,1393
2022-01-21,Sutter,101,95872,18601,17616,1234,18850,199
2022-01-21,Tehama,103,63373,10803,10171,2285,12456,142
2022-01-21,Trinity,105,12862,1056,925,257,1182,19
2022-01-21,Tulare,107,460477,92788,85223,23410,108633,1211
2022-01-21,Tuolumne,109,53932,10761,9731,334,10065,91
2022-01-21,Ventura,111,848112,158787,148742,8572,157314,1250
2022-01-21,Yolo,113,214977,32225,30061,2581,32642,273
2022-01-21,Yuba,115,75493,14096,13288,829,14117,103
2022-01-20,Alameda,001,1643700,220162,203927,11018,214945,1575
2022-01-20,Alpine,003,1148,118,119,1,120,0
2022-01-20,Amador,005,37829,7383,6845,371,7216,73
2022-01-20,Butte,007,227075,29031,27232,5528,32760,350
2022-01-20,Calaveras,009,45235,6334,5835,194,6029,95
2022-01-20,Colusa,011,21464,3091,2954,932,3886,21
2022-01-20,Contra Costa,013,1133247,164934,154111,9898,164009,1091
2022-01-20,Del Norte,015,27424,4483,4269,105,4374,43
2022-01-20,El Dorado,017,186661,24232,22273,2733,25006,179
2022-01-20,Fresno,019,978130,197433,185292,18406,203698,2429
2022-01-20,Glenn,021,27897,4422,4174,1361,5535,39
2022-01-20,Humboldt,023,135768,14560,13628,2090,15718,125
2022-01-20,Imperial,025,180216,48981,45741,8274,54015,820
2022-01-20,Inyo,027,18085,3845,3706,242,3948,50
2022-01-20,Kern,029,883053,173033,162902,39007,201909,1946
2022-01-20,Kings,031,150075,44167,40580,2892,43472,396
2022-01-20,Lake,033,64148,8803,8056,604,8660,118
2022-01-20,Lassen,035,31185,7882,7545,730,8275,55
2022-01-20,Los Angeles,037,10098052,2469277,2286280,111836,2398116,28038
2022-01-20,Madera,039,155013,31924,29595,4025,33620,329
2022-01-20,Marin,041,260295,29529,27893,1815,29708,253
2022-01-20,Mariposa,043,17540,2073,1920,108,2028,6
2022-01-20,Mendocino,045,87422,11348,10395,1815,12210,103
2022-01-20,Merced,047,269075,55753,53025,5390,58415,727
2022-01-20,Modoc,049,8938,656,639,225,864,6
2022-01-20,Mono,051,14174,2820,2723,102,2825,4
2022-01-20,Monterey,053,433212,68020,59038,8650,67688,651
2022-01-20,Napa,055,140530,22036,20402,657,21059,111
2022-01-20,Nevada,057,99092,14054,12957,879,13836,112
2022-01-20,Orange,059,3164182,504932,480329,36934,517263,5946
2022-01-20,Placer,061,380077,55711,52557,6373,58930,512
2022-01-20,Plumas,063,18699,2485,2289,191,2480,12
2022-01-20,Riverside,065,2383286,541353,513567,25298,538865,5623
2022-01-20,Sacramento,067,1510023,245452,230206,19931,250137,2510
2022-01-20,San Benito,069,59416,11371,10743,400,11143,88
2022-01-20,San Bernardino,071,2135413,522444,495209,22368,517577,6267
2022-01-20,San Diego,073,3302833,670146,628904,44093,672997,4559
2022-01-20,San Francisco,075,870044,108651,100238,6972,107210,702
2022-01-20,San Joaquin,077,732212,148177,138264,8203,146467,1960
2022-01-20,San Luis Obispo,079,281455,45623,42154,2963,45117,385
2022-01-20,San Mateo,081,765935,106144,91440,5358,96798,585
2022-01-20,Santa Barbara,083,443738,73988,69555,3826,73381,589
2022-01-20,Santa Clara,085,1922200,266169,249205,9363,258568,1993
2022-01-20,Santa Cruz,087,273765,36989,33741,1774,35515,237
2022-01-20,Shasta,089,179085,27130,25919,4996,30915,450
2022-01-20,Sierra,091,2930,261,248,29,277,0
2022-01-20,Siskiyou,093,43540,3977,3845,2129,5974,62
2022-01-20,Solano,095,438530,69791,63882,4447,68329,391
2022-01-20,Sonoma,097,501317,71498,66013,1927,67940,422
2022-01-20,Stanislaus,099,539301,105063,100092,13861,113953,1393
2022-01-20,Sutter,101,95872,18435,17616,1205,18821,199
2022-01-20,Tehama,103,63373,10727,10171,2267,12438,142
2022-01-20,Trinity,105,12862,1043,925,256,1181,19
2022-01-20,Tulare,107,460477,91815,85223,23110,108333,1211
2022-01-20,Tuolumne,109,53932,10619,9731,322,10053,91
2022-01-20,Ventura,111,848112,157401,148742,8500,157242,1250
2022-01-20,Yolo,113,214977,31947,30061,2547,32608,273
2022-01-20,Yuba,115,75493,13989,13288,796,14084,103
2022-01-19,Alameda,001,1643700,216799,199739,10684,210423,1571
2022-01-19,Alpine,003,1148,117,119,1,120,0
2022-01-19,Amador,005,37829,7302,6789,329,7118,73
2022-01-19,Butte,007,227075,28726,26839,5452,32291,351
2022-01-19,Calaveras,009,45235,6243,5765,185,5950,95
2022-01-19,Colusa,011,21464,3066,2938,924,3862,21
2022-01-19,Contra Costa,013,1133247,162620,151543,9655,161198,1091
2022-01-19,Del Norte,015,27424,4444,4240,104,4344,43
2022-01-19,El Dorado,017,186661,23980,21953,2691,24644,177
2022-01-19,Fresno,019,978130,194537,181526,18100,199626,2430
2022-01-19,Glenn,021,27897,4371,4127,1351,5478,39
2022-01-19,Humboldt,023,135768,14401,13391,2036,15427,125
2022-01-19,Imperial,025,180216,48256,45156,8073,53229,820
2022-01-19,Inyo,027,18085,3822,3680,203,3883,49
2022-01-19,Kern,029,883053,171277,160747,38324,199071,1946
2022-01-19,Kings,031,150075,43468,40027,2813,42840,395
2022-01-19,Lake,033,64148,8677,7972,591,8563,118
2022-01-19,Lassen,035,31185,7827,7507,707,8214,55
2022-01-19,Los Angeles,037,10098052,2440869,2251718,110418,2362136,27934
2022-01-19,Madera,039,155013,31542,29021,3848,32869,329
2022-01-19,Marin,041,260295,29235,27375,1772,29147,251
2022-01-19,Mariposa,043,17540,2048,1896,102,1998,6
2022-01-19,Mendocino,045,87422,11176,10252,1721,11973,103
2022-01-19,Merced,047,269075,55207,52355,5035,57390,724
2022-01-19,Modoc,049,8938,654,635,224,859,6
2022-01-19,Mono,051,14174,2798,2677,100,2777,4
2022-01-19,Monterey,053,433212,67117,58426,8193,66619,651
2022-01-19,Napa,055,140530,21784,20090,629,20719,110
2022-01-19,Nevada,057,99092,13900,12703,849,13552,112
2022-01-19,Orange,059,3164182,500443,468460,36572,505032,5943
2022-01-19,Placer,061,380077,55142,51545,6303,57848,511
2022-01-19,Plumas,063,18699,2446,2239,184,2423,12
2022-01-19,Riverside,065,2383286,535817,503575,25056,528631,5604
2022-01-19,Sacramento,067,1510023,242713,226035,19195,245230,2512
2022-01-19,San Benito,069,59416,11230,10639,388,11027,88
2022-01-19,San Bernardino,071,2135413,517951,487846,21999,509845,6265
2022-01-19,San Diego,073,3302833,661325,614709,43402,658111,4553
2022-01-19,San Francisco,075,870044,107268,98652,6886,105538,694
2022-01-19,San Joaquin,077,732212,146264,135953,8105,144058,1959
2022-01-19,San Luis Obispo,079,281455,45023,41374,2897,44271,382
2022-01-19,San Mateo,081,765935,104790,89715,5090,94805,585
2022-01-19,Santa Barbara,083,443738,72989,68531,3722,72253,586
2022-01-19,Santa Clara,085,1922200,262384,244922,8999,253921,1991
2022-01-19,Santa Cruz,087,273765,35746,33026,1750,34776,237
2022-01-19,Shasta,089,179085,26864,25355,4924,30279,450
2022-01-19,Sierra,091,2930,261,245,28,273,0
2022-01-19,Siskiyou,093,43540,3953,3821,2073,5894,62
2022-01-19,Solano,095,438530,68949,63003,4319,67322,392
2022-01-19,Sonoma,097,501317,70404,64689,1885,66574,420
2022-01-19,Stanislaus,099,539301,104014,98952,13567,112519,1381
2022-01-19,Sutter,101,95872,18265,17436,1114,18550,199
2022-01-19,Tehama,103,63373,10613,10064,2220,12284,142
2022-01-19,Trinity,105,12862,1031,916,255,1171,19
2022-01-19,Tulare,107,460477,90639,83743,22635,106378,1200
2022-01-19,Tuolumne,109,53932,10460,9613,298,9911,91
2022-01-19,Ventura,111,848112,155887,144738,8429,153167,1234
2022-01-19,Yolo,113,214977,31595,29392,2510,31902,273
2022-01-19,Yuba,115,75493,13826,13114,783,13897,104
2022-01-18,Alameda,001,1643700,213440,195728,10369,206097,1566
2022-01-18,Alpine,003,1148,117,118,1,119,0
2022-01-18,Amador,005,37829,7164,6691,292,6983,73
2022-01-18,Butte,007,227075,28333,26514,5374,31888,347
2022-01-18,Calaveras,009,45235,6155,5684,170,5854,94
2022-01-18,Colusa,011,21464,3022,2903,919,3822,21
2022-01-18,Contra Costa,013,1133247,160600,149446,9285,158731,1085
2022-01-18,Del Norte,015,27424,4374,4229,99,4328,43
2022-01-18,El Dorado,017,186661,23599,21707,2645,24352,175
2022-01-18,Fresno,019,978130,191108,178922,17689,196611,2425
2022-01-18,Glenn,021,27897,4338,4070,1339,5409,39
2022-01-18,Humboldt,023,135768,14233,13218,1967,15185,125
2022-01-18,Imperial,025,180216,47567,44742,7895,52637,819
2022-01-18,Inyo,027,18085,3781,3654,192,3846,49
2022-01-18,Kern,029,883053,169262,158864,37564,196428,1943
2022-01-18,Kings,031,150075,42590,39440,2730,42170,392
2022-01-18,Lake,033,64148,8564,7919,571,8490,117
2022-01-18,Lassen,035,31185,7744,7461,668,8129,55
2022-01-18,Los Angeles,037,10098052,2407420,2227360,108986,2336346,27871
2022-01-18,Madera,039,155013,31016,28717,3660,32377,329
2022-01-18,Marin,041,260295,28933,27036,1729,28765,251
2022-01-18,Mariposa,043,17540,2023,1872,98,1970,6
2022-01-18,Mendocino,045,87422,11006,10114,1639,11753,103
2022-01-18,Merced,047,269075,54596,51746,4753,56499,718
2022-01-18,Modoc,049,8938,652,633,219,852,6
2022-01-18,Mono,051,14174,2777,2643,99,2742,4
2022-01-18,Monterey,053,433212,66347,57846,7705,65551,650
2022-01-18,Napa,055,140530,21451,19911,612,20523,109
2022-01-18,Nevada,057,99092,13717,12584,806,13390,111
2022-01-18,Orange,059,3164182,495093,461324,36070,497394,5938
2022-01-18,Placer,061,380077,54499,50983,6228,57211,508
2022-01-18,Plumas,063,18699,2410,2218,178,2396,12
2022-01-18,Riverside,065,2383286,529837,497278,24744,522022,5599
2022-01-18,Sacramento,067,1510023,239801,223745,18194,241939,2496
2022-01-18,San Benito,069,59416,11085,10520,374,10894,88
2022-01-18,San Bernardino,071,2135413,512755,483753,21579,505332,6258
2022-01-18,San Diego,073,3302833,651059,605137,42423,647560,4547
2022-01-18,San Francisco,075,870044,105792,96505,6763,103268,694
2022-01-18,San Joaquin,077,732212,144306,134365,7962,142327,1957
2022-01-18,San Luis Obispo,079,281455,44338,40848,2810,43658,381
2022-01-18,San Mateo,081,765935,103313,88225,4891,93116,585
2022-01-18,Santa Barbara,083,443738,71772,67216,3548,70764,581
2022-01-18,Santa Clara,085,1922200,258197,240281,8594,248875,1986
2022-01-18,Santa Cruz,087,273765,35109,32203,1715,33918,237
2022-01-18,Shasta,089,179085,26582,25162,4827,29989,448
2022-01-18,Sierra,091,2930,257,244,28,272,0
2022-01-18,Siskiyou,093,43540,3919,3799,2019,5818,62
2022-01-18,Solano,095,438530,68099,62204,4210,66414,391
2022-01-18,Sonoma,097,501317,69024,63714,1832,65546,419
2022-01-18,Stanislaus,099,539301,102792,98000,13218,111218,1379
2022-01-18,Sutter,101,95872,18074,17295,1042,18337,198
2022-01-18,Tehama,103,63373,10510,9975,2166,12141,142
2022-01-18,Trinity,105,12862,1018,907,254,1161,19
2022-01-18,Tulare,107,460477,89290,82667,22222,104889,1196
2022-01-18,Tuolumne,109,53932,10291,9528,286,9814,91
2022-01-18,Ventura,111,848112,154177,143384,8356,151740,1233
2022-01-18,Yolo,113,214977,31224,28786,2459,31245,270
2022-01-18,Yuba,115,75493,13665,12971,757,13728,101
2022-01-17,Alameda,001,1643700,208767,193276,9780,203056,1565
2022-01-17,Alpine,003,1148,116,118,0,118,0
2022-01-17,Amador,005,37829,7050,6640,234,6874,73
2022-01-17,Butte,007,227075,27954,26303,5269,31572,348
2022-01-17,Calaveras,009,45235,6023,5584,142,5726,94
2022-01-17,Colusa,011,21464,2999,2905,912,3817,21
2022-01-17,Contra Costa,013,1133247,157839,147993,8797,156790,1086
2022-01-17,Del Norte,015,27424,4322,4209,92,4301,43
2022-01-17,El Dorado,017,186661,23342,21540,2563,24103,175
2022-01-17,Fresno,019,978130,187467,176959,17202,194161,2426
2022-01-17,Glenn,021,27897,4285,4055,1325,5380,39
2022-01-17,Humboldt,023,135768,14027,13120,1803,14923,125
2022-01-17,Imperial,025,180216,46884,44412,7746,52158,821
2022-01-17,Inyo,027,18085,3759,3650,165,3815,49
2022-01-17,Kern,029,883053,166735,157645,36682,194327,1944
2022-01-17,Kings,031,150075,41458,39143,2606,41749,392
2022-01-17,Lake,033,64148,8415,7864,531,8395,117
2022-01-17,Lassen,035,31185,7644,7417,629,8046,55
2022-01-17,Los Angeles,037,10098052,2368195,2205740,106995,2312735,27832
2022-01-17,Madera,039,155013,30355,28568,3473,32041,329
2022-01-17,Marin,041,260295,28526,26633,1673,28306,251
2022-01-17,Mariposa,043,17540,1997,1862,92,1954,6
2022-01-17,Mendocino,045,87422,10783,10030,1510,11540,103
2022-01-17,Merced,047,269075,53918,51227,4193,55420,718
2022-01-17,Modoc,049,8938,648,630,219,849,6
2022-01-17,Mono,051,14174,2753,2642,98,2740,4
2022-01-17,Monterey,053,433212,65232,57318,7282,64600,647
2022-01-17,Napa,055,140530,21107,19647,589,20236,109
2022-01-17,Nevada,057,99092,13529,12414,768,13182,111
2022-01-17,Orange,059,3164182,489129,457418,35597,493015,5933
2022-01-17,Placer,061,380077,53767,50511,6084,56595,508
2022-01-17,Plumas,063,18699,2366,2205,148,2353,12
2022-01-17,Riverside,065,2383286,523029,491322,24287,515609,5600
2022-01-17,Sacramento,067,1510023,235895,221143,16841,237984,2497
2022-01-17,San Benito,069,59416,10917,10432,346,10778,88
2022-01-17,San Bernardino,071,2135413,506594,480243,21047,501290,6259
2022-01-17,San Diego,073,3302833,638819,569241,41223,610464,4545
2022-01-17,San Francisco,075,870044,104145,95292,6562,101854,694
2022-01-17,San Joaquin,077,732212,141430,133414,7818,141232,1958
2022-01-17,San Luis Obispo,079,281455,43507,40425,2708,43133,379
2022-01-17,San Mateo,081,765935,101348,87013,4634,91647,585
2022-01-17,Santa Barbara,083,443738,70450,66704,3348,70052,581
2022-01-17,Santa Clara,085,1922200,253633,237934,8153,246087,1985
2022-01-17,Santa Cruz,087,273765,34353,31714,1677,33391,237
2022-01-17,Shasta,089,179085,26293,25025,4705,29730,448
2022-01-17,Sierra,091,2930,255,242,28,270,0
2022-01-17,Siskiyou,093,43540,3880,3764,1939,5703,62
2022-01-17,Solano,095,438530,67060,61497,3948,65445,391
2022-01-17,Sonoma,097,501317,67516,62763,1769,64532,419
2022-01-17,Stanislaus,099,539301,101479,96951,12746,109697,1379
2022-01-17,Sutter,101,95872,17864,17159,908,18067,198
2022-01-17,Tehama,103,63373,10380,9912,2101,12013,142
2022-01-17,Trinity,105,12862,1005,906,250,1156,19
2022-01-17,Tulare,107,460477,87666,81741,21658,103399,1199
2022-01-17,Tuolumne,109,53932,10156,9416,251,9667,91
2022-01-17,Ventura,111,848112,152059,142070,8245,150315,1234
2022-01-17,Yolo,113,214977,30694,28638,2394,31032,270
2022-01-17,Yuba,115,75493,13467,12871,701,13572,101
2022-01-16,Alameda,001,1643700,205713,190691,9523,200214,1564
2022-01-16,Alpine,003,1148,116,118,0,118,0
2022-01-16,Amador,005,37829,6976,6618,227,6845,73
2022-01-16,Butte,007,227075,27621,26139,5219,31358,348
2022-01-16,Calaveras,009,45235,5922,5537,138,5675,94
2022-01-16,Colusa,011,21464,2982,2886,900,3786,21
2022-01-16,Contra Costa,013,1133247,155927,146307,8596,154903,1086
2022-01-16,Del Norte,015,27424,4279,4177,90,4267,43
2022-01-16,El Dorado,017,186661,23065,21303,2524,23827,175
2022-01-16,Fresno,019,978130,184758,174818,16861,191679,2425
2022-01-16,Glenn,021,27897,4230,4049,1303,5352,39
2022-01-16,Humboldt,023,135768,13879,13075,1784,14859,125
2022-01-16,Imperial,025,180216,46306,44035,7619,51654,821
2022-01-16,Inyo,027,18085,3722,3602,143,3745,49
2022-01-16,Kern,029,883053,165468,156655,35889,192544,1944
2022-01-16,Kings,031,150075,41084,38861,2579,41440,392
2022-01-16,Lake,033,64148,8311,7823,496,8319,117
2022-01-16,Lassen,035,31185,7601,7391,615,8006,55
2022-01-16,Los Angeles,037,10098052,2345008,2174403,105519,2279922,27805
2022-01-16,Madera,039,155013,29983,28313,3423,31736,329
2022-01-16,Marin,041,260295,28230,26292,1659,27951,251
2022-01-16,Mariposa,043,17540,1970,1851,87,1938,6
2022-01-16,Mendocino,045,87422,10637,9992,1393,11385,102
2022-01-16,Merced,047,269075,53331,50882,4171,55053,718
2022-01-16,Modoc,049,8938,645,629,219,848,6
2022-01-16,Mono,051,14174,2749,2614,96,2710,4
2022-01-16,Monterey,053,433212,64478,57012,7138,64150,647
2022-01-16,Napa,055,140530,20841,19521,578,20099,109
2022-01-16,Nevada,057,99092,13310,12307,749,13056,111
2022-01-16,Orange,059,3164182,483725,451962,35062,487024,5932
2022-01-16,Placer,061,380077,53049,50076,5972,56048,508
2022-01-16,Plumas,063,18699,2332,2204,139,2343,12
2022-01-16,Riverside,065,2383286,517543,485191,24056,509247,5600
2022-01-16,Sacramento,067,1510023,233031,218819,16119,234938,2491
2022-01-16,San Benito,069,59416,10761,10377,344,10721,88
2022-01-16,San Bernardino,071,2135413,502859,474425,20809,495234,6259
2022-01-16,San Diego,073,3302833,631212,569241,40807,610048,4545
2022-01-16,San Francisco,075,870044,102598,94139,6421,100560,694
2022-01-16,San Joaquin,077,732212,139643,132214,7728,139942,1958
2022-01-16,San Luis Obispo,079,281455,42851,40113,2669,42782,379
2022-01-16,San Mateo,081,765935,99860,85966,4539,90505,585
2022-01-16,Santa Barbara,083,443738,69429,66111,3309,69420,582
2022-01-16,Santa Clara,085,1922200,249894,234293,7999,242292,1984
2022-01-16,Santa Cruz,087,273765,33735,31469,1654,33123,237
2022-01-16,Shasta,089,179085,26048,24980,4637,29617,449
2022-01-16,Sierra,091,2930,252,238,28,266,0
2022-01-16,Siskiyou,093,43540,3853,3748,1899,5647,62
2022-01-16,Solano,095,438530,66376,60885,3816,64701,391
2022-01-16,Sonoma,097,501317,66445,61842,1749,63591,419
2022-01-16,Stanislaus,099,539301,100414,96370,12607,108977,1379
2022-01-16,Sutter,101,95872,17662,16996,886,17882,198
2022-01-16,Tehama,103,63373,10300,9868,2079,11947,142
2022-01-16,Trinity,105,12862,1001,889,248,1137,19
2022-01-16,Tulare,107,460477,86430,80867,21397,102264,1199
2022-01-16,Tuolumne,109,53932,10050,9369,242,9611,91
2022-01-16,Ventura,111,848112,150484,140715,8173,148888,1234
2022-01-16,Yolo,113,214977,30301,28481,2338,30819,270
2022-01-16,Yuba,115,75493,13291,12760,695,13455,101
2022-01-15,Alameda,001,1643700,204362,177768,9472,187240,1561
2022-01-15,Alpine,003,1148,116,117,0,117,0
2022-01-15,Amador,005,37829,6944,6434,213,6647,72
2022-01-15,Butte,007,227075,27468,25032,5169,30201,348
2022-01-15,Calaveras,009,45235,5890,5258,138,5396,93
2022-01-15,Colusa,011,21464,2969,2796,892,3688,21
2022-01-15,Contra Costa,013,1133247,154712,137643,8552,146195,1082
2022-01-15,Del Norte,015,27424,4264,4065,88,4153,43
2022-01-15,El Dorado,017,186661,22966,20434,2507,22941,175
2022-01-15,Fresno,019,978130,183829,167361,16794,184155,2415
2022-01-15,Glenn,021,27897,4223,3906,1296,5202,39
2022-01-15,Humboldt,023,135768,13776,12419,1768,14187,123
2022-01-15,Imperial,025,180216,46169,42508,7507,50015,817
2022-01-15,Inyo,027,18085,3712,3395,143,3538,49
2022-01-15,Kern,029,883053,164629,150085,35498,185583,1938
2022-01-15,Kings,031,150075,40835,37221,2567,39788,391
2022-01-15,Lake,033,64148,8272,7641,483,8124,117
2022-01-15,Lassen,035,31185,7560,7274,609,7883,55
2022-01-15,Los Angeles,037,10098052,2333472,2047927,104573,2152500,27641
2022-01-15,Madera,039,155013,29836,27294,3401,30695,329
2022-01-15,Marin,041,260295,28044,25248,1652,26900,251
2022-01-15,Mariposa,043,17540,1963,1762,87,1849,6
2022-01-15,Mendocino,045,87422,10564,9534,1388,10922,102
2022-01-15,Merced,047,269075,53166,48904,4160,53064,715
2022-01-15,Modoc,049,8938,643,628,219,847,6
2022-01-15,Mono,051,14174,2744,2508,95,2603,4
2022-01-15,Monterey,053,433212,63970,55315,7072,62387,647
2022-01-15,Napa,055,140530,20720,17648,573,18221,109
2022-01-15,Nevada,057,99092,13252,11773,735,12508,111
2022-01-15,Orange,059,3164182,481130,433141,34787,467928,5914
2022-01-15,Placer,061,380077,52767,47780,5938,53718,501
2022-01-15,Plumas,063,18699,2312,2158,134,2292,12
2022-01-15,Riverside,065,2383286,514869,466381,23921,490302,5578
2022-01-15,Sacramento,067,1510023,231914,208156,16017,224173,2491
2022-01-15,San Benito,069,59416,10662,9868,338,10206,87
2022-01-15,San Bernardino,071,2135413,500628,454395,20665,475060,6233
2022-01-15,San Diego,073,3302833,627446,559385,40565,599950,4540
2022-01-15,San Francisco,075,870044,101597,88004,6283,94287,692
2022-01-15,San Joaquin,077,732212,139081,125136,7636,132772,1954
2022-01-15,San Luis Obispo,079,281455,42662,38231,2656,40887,374
2022-01-15,San Mateo,081,765935,98923,80494,4498,84992,582
2022-01-15,Santa Barbara,083,443738,68830,62312,3298,65610,579
2022-01-15,Santa Clara,085,1922200,247673,218986,7881,226867,1974
2022-01-15,Santa Cruz,087,273765,33390,29414,1646,31060,235
2022-01-15,Shasta,089,179085,25960,24482,4605,29087,445
2022-01-15,Sierra,091,2930,251,232,27,259,0
2022-01-15,Siskiyou,093,43540,3841,3661,1888,5549,62
2022-01-15,Solano,095,438530,66097,58061,3765,61826,389
2022-01-15,Sonoma,097,501317,65862,58181,1743,59924,418
2022-01-15,Stanislaus,099,539301,99831,92986,12509,105495,1379
2022-01-15,Sutter,101,95872,17571,16345,876,17221,197
2022-01-15,Tehama,103,63373,10252,9572,2061,11633,141
2022-01-15,Trinity,105,12862,998,872,248,1120,19
2022-01-15,Tulare,107,460477,85993,77769,21282,99051,1192
2022-01-15,Tuolumne,109,53932,9951,9042,237,9279,91
2022-01-15,Ventura,111,848112,149710,134736,8137,142873,1227
2022-01-15,Yolo,113,214977,30124,27311,2318,29629,270
2022-01-15,Yuba,115,75493,13229,12200,691,12891,101
2022-01-14,Alameda,001,1643700,202317,177768,9418,187186,1561
2022-01-14,Alpine,003,1148,116,117,0,117,0
2022-01-14,Amador,005,37829,6869,6434,204,6638,72
2022-01-14,Butte,007,227075,27282,25032,5141,30173,348
2022-01-14,Calaveras,009,45235,5854,5258,137,5395,93
2022-01-14,Colusa,011,21464,2960,2796,882,3678,21
2022-01-14,Contra Costa,013,1133247,153270,137643,8451,146094,1082
2022-01-14,Del Norte,015,27424,4238,4065,87,4152,43
2022-01-14,El Dorado,017,186661,22812,20434,2488,22922,175
2022-01-14,Fresno,019,978130,182174,167361,16722,184083,2415
2022-01-14,Glenn,021,27897,4201,3906,1287,5193,39
2022-01-14,Humboldt,023,135768,13671,12419,1735,14154,123
2022-01-14,Imperial,025,180216,46001,42508,7487,49995,817
2022-01-14,Inyo,027,18085,3687,3395,139,3534,49
2022-01-14,Kern,029,883053,163633,150085,35061,185146,1938
2022-01-14,Kings,031,150075,40586,37221,2558,39779,391
2022-01-14,Lake,033,64148,8215,7641,470,8111,117
2022-01-14,Lassen,035,31185,7530,7274,597,7871,55
2022-01-14,Los Angeles,037,10098052,2314162,2047927,103560,2151487,27641
2022-01-14,Madera,039,155013,29598,27294,3377,30671,329
2022-01-14,Marin,041,260295,27783,25248,1616,26864,251
2022-01-14,Mariposa,043,17540,1948,1762,87,1849,6
2022-01-14,Mendocino,045,87422,10453,9534,1375,10909,102
2022-01-14,Merced,047,269075,52984,48904,4140,53044,715
2022-01-14,Modoc,049,8938,642,628,219,847,6
2022-01-14,Mono,051,14174,2723,2508,93,2601,4
2022-01-14,Monterey,053,433212,63287,55315,6984,62299,647
2022-01-14,Napa,055,140530,20550,17648,567,18215,109
2022-01-14,Nevada,057,99092,13129,11773,722,12495,111
2022-01-14,Orange,059,3164182,477387,433141,34478,467619,5914
2022-01-14,Placer,061,380077,52334,47780,5854,53634,501
2022-01-14,Plumas,063,18699,2304,2158,127,2285,12
2022-01-14,Riverside,065,2383286,511347,466381,23777,490158,5578
2022-01-14,Sacramento,067,1510023,230071,208156,15864,224020,2491
2022-01-14,San Benito,069,59416,10609,9868,337,10205,87
2022-01-14,San Bernardino,071,2135413,497592,454395,20477,474872,6233
2022-01-14,San Diego,073,3302833,621814,559385,40288,599673,4540
2022-01-14,San Francisco,075,870044,100411,88004,6107,94111,692
2022-01-14,San Joaquin,077,732212,138233,125136,7587,132723,1954
2022-01-14,San Luis Obispo,079,281455,42496,38231,2633,40864,374
2022-01-14,San Mateo,081,765935,97704,80494,4469,84963,582
2022-01-14,Santa Barbara,083,443738,68315,62312,3289,65601,579
2022-01-14,Santa Clara,085,1922200,245071,218986,7776,226762,1974
2022-01-14,Santa Cruz,087,273765,33028,29414,1636,31050,235
2022-01-14,Shasta,089,179085,25845,24482,4571,29053,445
2022-01-14,Sierra,091,2930,249,232,25,257,0
2022-01-14,Siskiyou,093,43540,3830,3661,1875,5536,62
2022-01-14,Solano,095,438530,65244,58061,3673,61734,389
2022-01-14,Sonoma,097,501317,65328,58181,1716,59897,418
2022-01-14,Stanislaus,099,539301,99225,92986,12408,105394,1379
2022-01-14,Sutter,101,95872,17443,16345,867,17212,197
2022-01-14,Tehama,103,63373,10199,9572,2050,11622,141
2022-01-14,Trinity,105,12862,993,872,246,1118,19
2022-01-14,Tulare,107,460477,85473,77769,21117,98886,1192
2022-01-14,Tuolumne,109,53932,9828,9042,232,9274,91
2022-01-14,Ventura,111,848112,148606,134736,8079,142815,1227
2022-01-14,Yolo,113,214977,29889,27311,2290,29601,270
2022-01-14,Yuba,115,75493,13127,12200,686,12886,101
2022-01-13,Alameda,001,1643700,198005,177768,9060,186828,1561
2022-01-13,Alpine,003,1148,115,117,0,117,0
2022-01-13,Amador,005,37829,6810,6434,183,6617,72
2022-01-13,Butte,007,227075,26983,25032,5030,30062,348
2022-01-13,Calaveras,009,45235,5763,5258,133,5391,93
2022-01-13,Colusa,011,21464,2929,2796,872,3668,21
2022-01-13,Contra Costa,013,1133247,150735,137643,7991,145634,1082
2022-01-13,Del Norte,015,27424,4203,4065,86,4151,43
2022-01-13,El Dorado,017,186661,22564,20434,2443,22877,175
2022-01-13,Fresno,019,978130,179377,167361,16363,183724,2415
2022-01-13,Glenn,021,27897,4154,3906,1261,5167,39
2022-01-13,Humboldt,023,135768,13519,12419,1673,14092,123
2022-01-13,Imperial,025,180216,45452,42508,7302,49810,817
2022-01-13,Inyo,027,18085,3631,3395,122,3517,49
2022-01-13,Kern,029,883053,162053,150085,34462,184547,1938
2022-01-13,Kings,031,150075,40102,37221,2513,39734,391
2022-01-13,Lake,033,64148,8115,7641,449,8090,117
2022-01-13,Lassen,035,31185,7502,7274,580,7854,55
2022-01-13,Los Angeles,037,10098052,2277744,2047927,101868,2149795,27641
2022-01-13,Madera,039,155013,29134,27294,3284,30578,329
2022-01-13,Marin,041,260295,27439,25248,1572,26820,251
2022-01-13,Mariposa,043,17540,1925,1762,84,1846,6
2022-01-13,Mendocino,045,87422,10362,9534,1306,10840,102
2022-01-13,Merced,047,269075,52326,48904,3874,52778,715
2022-01-13,Modoc,049,8938,639,628,219,847,6
2022-01-13,Mono,051,14174,2700,2508,90,2598,4
2022-01-13,Monterey,053,433212,62370,55315,6693,62008,647
2022-01-13,Napa,055,140530,20253,17648,557,18205,109
2022-01-13,Nevada,057,99092,12941,11773,692,12465,111
2022-01-13,Orange,059,3164182,470929,433141,34030,467171,5914
2022-01-13,Placer,061,380077,51697,47780,5747,53527,501
2022-01-13,Plumas,063,18699,2284,2158,117,2275,12
2022-01-13,Riverside,065,2383286,505069,466381,23444,489825,5578
2022-01-13,Sacramento,067,1510023,227153,208156,15074,223230,2491
2022-01-13,San Benito,069,59416,10507,9868,329,10197,87
2022-01-13,San Bernardino,071,2135413,492021,454395,20021,474416,6233
2022-01-13,San Diego,073,3302833,613301,559385,39422,598807,4540
2022-01-13,San Francisco,075,870044,98662,88004,5908,93912,692
2022-01-13,San Joaquin,077,732212,136151,125136,7475,132611,1954
2022-01-13,San Luis Obispo,079,281455,41891,38231,2528,40759,374
2022-01-13,San Mateo,081,765935,95918,80494,4229,84723,582
2022-01-13,Santa Barbara,083,443738,67320,62312,3102,65414,579
2022-01-13,Santa Clara,085,1922200,240766,218986,7439,226425,1974
2022-01-13,Santa Cruz,087,273765,32249,29414,1614,31028,235
2022-01-13,Shasta,089,179085,25638,24482,4498,28980,445
2022-01-13,Sierra,091,2930,248,232,25,257,0
2022-01-13,Siskiyou,093,43540,3808,3661,1834,5495,62
2022-01-13,Solano,095,438530,64110,58061,3561,61622,389
2022-01-13,Sonoma,097,501317,64263,58181,1657,59838,418
2022-01-13,Stanislaus,099,539301,98109,92986,12140,105126,1379
2022-01-13,Sutter,101,95872,17243,16345,803,17148,197
2022-01-13,Tehama,103,63373,10101,9572,2005,11577,141
2022-01-13,Trinity,105,12862,985,872,246,1118,19
2022-01-13,Tulare,107,460477,84208,77769,20809,98578,1192
2022-01-13,Tuolumne,109,53932,9687,9042,214,9256,91
2022-01-13,Ventura,111,848112,146819,134736,7996,142732,1227
2022-01-13,Yolo,113,214977,29493,27311,2246,29557,270
2022-01-13,Yuba,115,75493,12990,12200,657,12857,101
2022-01-12,Alameda,001,1643700,193386,173001,8593,181594,1563
2022-01-12,Alpine,003,1148,115,117,0,117,0
2022-01-12,Amador,005,37829,6762,6354,169,6523,71
2022-01-12,Butte,007,227075,26656,24631,4941,29572,348
2022-01-12,Calaveras,009,45235,5684,5151,127,5278,93
2022-01-12,Colusa,011,21464,2889,2772,859,3631,21
2022-01-12,Contra Costa,013,1133247,148186,134579,7624,142203,1077
2022-01-12,Del Norte,015,27424,4176,4019,84,4103,43
2022-01-12,El Dorado,017,186661,22242,20092,2403,22495,175
2022-01-12,Fresno,019,978130,176640,165316,15958,181274,2413
2022-01-12,Glenn,021,27897,4102,3859,1239,5098,39
2022-01-12,Humboldt,023,135768,13347,12081,1592,13673,122
2022-01-12,Imperial,025,180216,44803,41985,6982,48967,814
2022-01-12,Inyo,027,18085,3585,3334,106,3440,49
2022-01-12,Kern,029,883053,159930,148435,33727,182162,1933
2022-01-12,Kings,031,150075,39467,36780,2471,39251,391
2022-01-12,Lake,033,64148,7999,7535,405,7940,117
2022-01-12,Lassen,035,31185,7459,7223,553,7776,55
2022-01-12,Los Angeles,037,10098052,2238107,2005065,99679,2104744,27601
2022-01-12,Madera,039,155013,28816,26952,3195,30147,329
2022-01-12,Marin,041,260295,26950,24704,1521,26225,251
2022-01-12,Mariposa,043,17540,1896,1725,82,1807,6
2022-01-12,Mendocino,045,87422,10198,9379,1207,10586,103
2022-01-12,Merced,047,269075,51625,48441,3599,52040,710
2022-01-12,Modoc,049,8938,637,627,219,846,6
2022-01-12,Mono,051,14174,2664,2466,86,2552,4
2022-01-12,Monterey,053,433212,61407,54524,6329,60853,647
2022-01-12,Napa,055,140530,19995,17347,534,17881,109
2022-01-12,Nevada,057,99092,12725,11552,643,12195,111
2022-01-12,Orange,059,3164182,464151,425737,33431,459168,5912
2022-01-12,Placer,061,380077,51039,47004,5635,52639,501
2022-01-12,Plumas,063,18699,2246,2135,106,2241,12
2022-01-12,Riverside,065,2383286,497860,458881,23099,481980,5565
2022-01-12,Sacramento,067,1510023,223770,204696,14196,218892,2479
2022-01-12,San Benito,069,59416,10376,9737,317,10054,87
2022-01-12,San Bernardino,071,2135413,485894,447869,19411,467280,6222
2022-01-12,San Diego,073,3302833,602805,551669,38565,590234,4529
2022-01-12,San Francisco,075,870044,96799,85700,5791,91491,691
2022-01-12,San Joaquin,077,732212,133859,122850,7357,130207,1948
2022-01-12,San Luis Obispo,079,281455,41158,37727,2445,40172,373
2022-01-12,San Mateo,081,765935,93891,78476,3850,82326,582
2022-01-12,Santa Barbara,083,443738,66177,60815,2999,63814,578
2022-01-12,Santa Clara,085,1922200,236232,213177,7054,220231,1971
2022-01-12,Santa Cruz,087,273765,31603,28463,1566,30029,235
2022-01-12,Shasta,089,179085,25421,24324,4432,28756,446
2022-01-12,Sierra,091,2930,247,228,25,253,0
2022-01-12,Siskiyou,093,43540,3781,3639,1787,5426,62
2022-01-12,Solano,095,438530,63059,57052,3439,60491,386
2022-01-12,Sonoma,097,501317,62983,56394,1574,57968,417
2022-01-12,Stanislaus,099,539301,96877,91738,11820,103558,1373
2022-01-12,Sutter,101,95872,17045,16135,770,16905,197
2022-01-12,Tehama,103,63373,10013,9475,1946,11421,141
2022-01-12,Trinity,105,12862,982,868,245,1113,19
2022-01-12,Tulare,107,460477,83122,76943,20400,97343,1192
2022-01-12,Tuolumne,109,53932,9556,8870,196,9066,91
2022-01-12,Ventura,111,848112,144908,132180,7917,140097,1220
2022-01-12,Yolo,113,214977,29094,26888,2168,29056,270
2022-01-12,Yuba,115,75493,12832,12015,630,12645,101
2022-01-11,Alameda,001,1643700,188875,169181,8195,177376,1561
2022-01-11,Alpine,003,1148,115,116,0,116,0
2022-01-11,Amador,005,37829,6678,6317,154,6471,71
2022-01-11,Butte,007,227075,26263,24479,4851,29330,347
2022-01-11,Calaveras,009,45235,5554,5083,113,5196,93
2022-01-11,Colusa,011,21464,2866,2766,845,3611,21
2022-01-11,Contra Costa,013,1133247,145222,132410,7138,139548,1077
2022-01-11,Del Norte,015,27424,4142,4006,82,4088,43
2022-01-11,El Dorado,017,186661,21894,19842,2331,22173,174
2022-01-11,Fresno,019,978130,173596,163509,15638,179147,2404
2022-01-11,Glenn,021,27897,4040,3844,1193,5037,39
2022-01-11,Humboldt,023,135768,13124,11960,1500,13460,122
2022-01-11,Imperial,025,180216,44190,41444,6792,48236,813
2022-01-11,Inyo,027,18085,3487,3278,99,3377,49
2022-01-11,Kern,029,883053,157684,146942,32895,179837,1929
2022-01-11,Kings,031,150075,38880,36524,2441,38965,389
2022-01-11,Lake,033,64148,7922,7494,389,7883,117
2022-01-11,Lassen,035,31185,7410,7210,539,7749,55
2022-01-11,Los Angeles,037,10098052,2195679,1966319,97482,2063801,27563
2022-01-11,Madera,039,155013,28401,26688,3119,29807,329
2022-01-11,Marin,041,260295,26597,24387,1476,25863,251
2022-01-11,Mariposa,043,17540,1874,1718,79,1797,6
2022-01-11,Mendocino,045,87422,10037,9301,1111,10412,102
2022-01-11,Merced,047,269075,50860,48068,3417,51485,708
2022-01-11,Modoc,049,8938,636,626,218,844,6
2022-01-11,Mono,051,14174,2621,2425,85,2510,4
2022-01-11,Monterey,053,433212,60372,53911,5976,59887,646
2022-01-11,Napa,055,140530,19554,17020,485,17505,109
2022-01-11,Nevada,057,99092,12498,11467,608,12075,110
2022-01-11,Orange,059,3164182,456479,417703,32793,450496,5909
2022-01-11,Placer,061,380077,50288,46459,5492,51951,500
2022-01-11,Plumas,063,18699,2223,2099,100,2199,12
2022-01-11,Riverside,065,2383286,490150,453766,22777,476543,5551
2022-01-11,Sacramento,067,1510023,219805,201058,13159,214217,2489
2022-01-11,San Benito,069,59416,10236,9624,304,9928,83
2022-01-11,San Bernardino,071,2135413,478411,442960,18815,461775,6198
2022-01-11,San Diego,073,3302833,590790,536954,37471,574425,4520
2022-01-11,San Francisco,075,870044,94576,83678,5627,89305,691
2022-01-11,San Joaquin,077,732212,131484,121139,7227,128366,1944
2022-01-11,San Luis Obispo,079,281455,40379,37183,2326,39509,372
2022-01-11,San Mateo,081,765935,91602,76756,3627,80383,582
2022-01-11,Santa Barbara,083,443738,64873,59758,2861,62619,578
2022-01-11,Santa Clara,085,1922200,230792,208425,6594,215019,1971
2022-01-11,Santa Cruz,087,273765,31100,27709,1514,29223,232
2022-01-11,Shasta,089,179085,25167,24132,4337,28469,446
2022-01-11,Sierra,091,2930,245,228,25,253,0
2022-01-11,Siskiyou,093,43540,3756,3621,1737,5358,62
2022-01-11,Solano,095,438530,61643,56349,3282,59631,388
2022-01-11,Sonoma,097,501317,61464,55411,1493,56904,416
2022-01-11,Stanislaus,099,539301,95514,90998,11475,102473,1372
2022-01-11,Sutter,101,95872,16844,15993,714,16707,197
2022-01-11,Tehama,103,63373,9882,9406,1898,11304,140
2022-01-11,Trinity,105,12862,970,858,243,1101,19
2022-01-11,Tulare,107,460477,81823,76267,19988,96255,1188
2022-01-11,Tuolumne,109,53932,9398,8811,189,9000,91
2022-01-11,Ventura,111,848112,142676,129548,7784,137332,1220
2022-01-11,Yolo,113,214977,28543,26482,2106,28588,270
2022-01-11,Yuba,115,75493,12658,11912,609,12521,101
2022-01-10,Alameda,001,1643700,183763,165657,7668,173325,1559
2022-01-10,Alpine,003,1148,115,116,0,116,0
2022-01-10,Amador,005,37829,6574,6279,137,6416,71
2022-01-10,Butte,007,227075,25922,24217,4759,28976,347
2022-01-10,Calaveras,009,45235,5454,5025,107,5132,93
2022-01-10,Colusa,011,21464,2838,2758,835,3593,21
2022-01-10,Contra Costa,013,1133247,142491,129951,6626,136577,1077
2022-01-10,Del Norte,015,27424,4119,3970,82,4052,43
2022-01-10,El Dorado,017,186661,21329,19606,2274,21880,172
2022-01-10,Fresno,019,978130,170545,161593,15274,176867,2404
2022-01-10,Glenn,021,27897,3981,3807,1179,4986,39
2022-01-10,Humboldt,023,135768,12879,11778,1367,13145,121
2022-01-10,Imperial,025,180216,43467,41080,6572,47652,811
2022-01-10,Inyo,027,18085,3433,3227,87,3314,49
2022-01-10,Kern,029,883053,155116,145744,32140,177884,1929
2022-01-10,Kings,031,150075,38249,36286,2405,38691,389
2022-01-10,Lake,033,64148,7833,7416,365,7781,117
2022-01-10,Lassen,035,31185,7373,7192,516,7708,55
2022-01-10,Los Angeles,037,10098052,2150159,1932475,95131,2027606,27546
2022-01-10,Madera,039,155013,27949,26501,3020,29521,328
2022-01-10,Marin,041,260295,26110,24023,1402,25425,251
2022-01-10,Mariposa,043,17540,1834,1684,73,1757,6
2022-01-10,Mendocino,045,87422,9864,9163,1023,10186,101
2022-01-10,Merced,047,269075,50061,47632,3132,50764,707
2022-01-10,Modoc,049,8938,635,622,216,838,6
2022-01-10,Mono,051,14174,2555,2415,80,2495,4
2022-01-10,Monterey,053,433212,59419,53485,5658,59143,645
2022-01-10,Napa,055,140530,19176,16775,470,17245,109
2022-01-10,Nevada,057,99092,12274,11300,570,11870,110
2022-01-10,Orange,059,3164182,447785,406170,31945,438115,5906
2022-01-10,Placer,061,380077,49436,45642,5331,50973,498
2022-01-10,Plumas,063,18699,2201,2086,98,2184,12
2022-01-10,Riverside,065,2383286,481904,445536,22322,467858,5546
2022-01-10,Sacramento,067,1510023,215555,198023,12120,210143,2474
2022-01-10,San Benito,069,59416,10064,9467,294,9761,83
2022-01-10,San Bernardino,071,2135413,470417,437207,18106,455313,6184
2022-01-10,San Diego,073,3302833,578111,530506,36337,566843,4500
2022-01-10,San Francisco,075,870044,92767,82209,5364,87573,690
2022-01-10,San Joaquin,077,732212,128807,119587,7028,126615,1927
2022-01-10,San Luis Obispo,079,281455,39560,36618,2228,38846,371
2022-01-10,San Mateo,081,765935,88961,75210,3371,78581,582
2022-01-10,Santa Barbara,083,443738,63613,58957,2670,61627,578
2022-01-10,Santa Clara,085,1922200,224937,203540,6110,209650,1971
2022-01-10,Santa Cruz,087,273765,30261,26906,1478,28384,232
2022-01-10,Shasta,089,179085,24968,23983,4260,28243,446
2022-01-10,Sierra,091,2930,242,223,25,248,0
2022-01-10,Siskiyou,093,43540,3723,3592,1693,5285,62
2022-01-10,Solano,095,438530,60593,55663,3072,58735,385
2022-01-10,Sonoma,097,501317,59925,54478,1447,55925,412
2022-01-10,Stanislaus,099,539301,94176,89997,11158,101155,1372
2022-01-10,Sutter,101,95872,16600,15823,667,16490,196
2022-01-10,Tehama,103,63373,9770,9360,1843,11203,140
2022-01-10,Trinity,105,12862,966,849,241,1090,19
2022-01-10,Tulare,107,460477,80325,75498,19577,95075,1186
2022-01-10,Tuolumne,109,53932,9273,8685,177,8862,91
2022-01-10,Ventura,111,848112,140075,126240,7644,133884,1217
2022-01-10,Yolo,113,214977,27985,26065,2053,28118,270
2022-01-10,Yuba,115,75493,12408,11776,574,12350,101
2022-01-09,Alameda,001,1643700,179275,162701,6990,169691,1561
2022-01-09,Alpine,003,1148,115,116,0,116,0
2022-01-09,Amador,005,37829,6487,6215,125,6340,71
2022-01-09,Butte,007,227075,25533,24018,4644,28662,347
2022-01-09,Calaveras,009,45235,5323,4976,98,5074,93
2022-01-09,Colusa,011,21464,2811,2750,813,3563,21
2022-01-09,Contra Costa,013,1133247,139647,128050,5972,134022,1077
2022-01-09,Del Norte,015,27424,4079,3950,78,4028,43
2022-01-09,El Dorado,017,186661,20968,19430,2208,21638,172
2022-01-09,Fresno,019,978130,167957,159989,14921,174910,2405
2022-01-09,Glenn,021,27897,3926,3797,1158,4955,39
2022-01-09,Humboldt,023,135768,12635,11582,1244,12826,121
2022-01-09,Imperial,025,180216,42628,40608,6299,46907,811
2022-01-09,Inyo,027,18085,3331,3149,78,3227,49
2022-01-09,Kern,029,883053,152660,144819,31390,176209,1927
2022-01-09,Kings,031,150075,37566,36041,2366,38407,389
2022-01-09,Lake,033,64148,7722,7393,321,7714,117
2022-01-09,Lassen,035,31185,7309,7172,487,7659,55
2022-01-09,Los Angeles,037,10098052,2102197,1887830,92211,1980041,27532
2022-01-09,Madera,039,155013,27565,26325,2920,29245,328
2022-01-09,Marin,041,260295,25658,23708,1310,25018,251
2022-01-09,Mariposa,043,17540,1784,1660,72,1732,6
2022-01-09,Mendocino,045,87422,9655,9097,912,10009,101
2022-01-09,Merced,047,269075,49194,47294,2861,50155,706
2022-01-09,Modoc,049,8938,633,619,216,835,6
2022-01-09,Mono,051,14174,2520,2390,73,2463,4
2022-01-09,Monterey,053,433212,58369,53251,5385,58636,645
2022-01-09,Napa,055,140530,18681,16614,454,17068,109
2022-01-09,Nevada,057,99092,12013,11152,508,11660,110
2022-01-09,Orange,059,3164182,437797,400563,31013,431576,5905
2022-01-09,Placer,061,380077,48454,45081,5184,50265,498
2022-01-09,Plumas,063,18699,2162,2081,77,2158,12
2022-01-09,Riverside,065,2383286,472933,440413,21776,462189,5546
2022-01-09,Sacramento,067,1510023,210954,195444,10996,206440,2475
2022-01-09,San Benito,069,59416,9878,9363,266,9629,83
2022-01-09,San Bernardino,071,2135413,462535,430257,17302,447559,6180
2022-01-09,San Diego,073,3302833,564926,478206,34495,512701,4500
2022-01-09,San Francisco,075,870044,90894,80463,5113,85576,690
2022-01-09,San Joaquin,077,732212,125723,118422,6882,125304,1927
2022-01-09,San Luis Obispo,079,281455,38748,36291,2120,38411,371
2022-01-09,San Mateo,081,765935,86468,73867,3041,76908,582
2022-01-09,Santa Barbara,083,443738,61933,58280,2409,60689,578
2022-01-09,Santa Clara,085,1922200,218834,199889,5562,205451,1976
2022-01-09,Santa Cruz,087,273765,29511,26513,1446,27959,232
2022-01-09,Shasta,089,179085,24734,23926,4172,28098,446
2022-01-09,Sierra,091,2930,239,223,24,247,0
2022-01-09,Siskiyou,093,43540,3695,3580,1632,5212,62
2022-01-09,Solano,095,438530,59431,54985,2786,57771,384
2022-01-09,Sonoma,097,501317,58255,53543,1406,54949,412
2022-01-09,Stanislaus,099,539301,92806,89248,10900,100148,1372
2022-01-09,Sutter,101,95872,16314,15695,592,16287,196
2022-01-09,Tehama,103,63373,9649,9306,1789,11095,140
2022-01-09,Trinity,105,12862,962,848,239,1087,19
2022-01-09,Tulare,107,460477,78926,75085,19190,94275,1186
2022-01-09,Tuolumne,109,53932,9118,8595,158,8753,91
2022-01-09,Ventura,111,848112,137018,124269,7416,131685,1217
2022-01-09,Yolo,113,214977,27384,25632,2009,27641,270
2022-01-09,Yuba,115,75493,12211,11666,544,12210,101
2022-01-08,Alameda,001,1643700,177382,148560,6844,155404,1558
2022-01-08,Alpine,003,1148,115,114,0,114,0
2022-01-08,Amador,005,37829,6454,6091,120,6211,71
2022-01-08,Butte,007,227075,25354,23429,4606,28035,347
2022-01-08,Calaveras,009,45235,5277,4823,94,4917,93
2022-01-08,Colusa,011,21464,2802,2713,810,3523,21
2022-01-08,Contra Costa,013,1133247,138152,119907,5895,125802,1077
2022-01-08,Del Norte,015,27424,4062,3902,78,3980,43
2022-01-08,El Dorado,017,186661,20787,18599,2174,20773,172
2022-01-08,Fresno,019,978130,167069,155394,14831,170225,2393
2022-01-08,Glenn,021,27897,3918,3732,1154,4886,39
2022-01-08,Humboldt,023,135768,12516,11149,1218,12367,121
2022-01-08,Imperial,025,180216,42441,39429,6154,45583,800
2022-01-08,Inyo,027,18085,3317,3020,75,3095,49
2022-01-08,Kern,029,883053,151524,140410,30955,171365,1921
2022-01-08,Kings,031,150075,37328,35275,2348,37623,390
2022-01-08,Lake,033,64148,7682,7209,313,7522,117
2022-01-08,Lassen,035,31185,7283,7127,471,7598,55
2022-01-08,Los Angeles,037,10098052,2083855,1765787,90470,1856257,27476
2022-01-08,Madera,039,155013,27397,25767,2883,28650,328
2022-01-08,Marin,041,260295,25372,22377,1299,23676,251
2022-01-08,Mariposa,043,17540,1774,1588,72,1660,6
2022-01-08,Mendocino,045,87422,9581,8792,910,9702,101
2022-01-08,Merced,047,269075,49023,46094,2839,48933,703
2022-01-08,Modoc,049,8938,633,610,216,826,6
2022-01-08,Mono,051,14174,2509,2240,68,2308,4
2022-01-08,Monterey,053,433212,57988,51721,5293,57014,644
2022-01-08,Napa,055,140530,18527,15819,428,16247,109
2022-01-08,Nevada,057,99092,11931,10765,495,11260,110
2022-01-08,Orange,059,3164182,433998,375124,30158,405282,5903
2022-01-08,Placer,061,380077,48015,43172,5142,48314,495
2022-01-08,Plumas,063,18699,2153,2053,72,2125,12
2022-01-08,Riverside,065,2383286,469417,422591,21502,444093,5535
2022-01-08,Sacramento,067,1510023,209572,185118,10839,195957,2470
2022-01-08,San Benito,069,59416,9714,9016,263,9279,83
2022-01-08,San Bernardino,071,2135413,459291,411724,16909,428633,6122
2022-01-08,San Diego,073,3302833,560042,472273,33989,506262,4495
2022-01-08,San Francisco,075,870044,89685,73660,4829,78489,690
2022-01-08,San Joaquin,077,732212,124755,112514,6786,119300,1916
2022-01-08,San Luis Obispo,079,281455,38544,34489,2077,36566,369
2022-01-08,San Mateo,081,765935,85126,67918,2954,70872,582
2022-01-08,Santa Barbara,083,443738,61241,54617,2373,56990,575
2022-01-08,Santa Clara,085,1922200,215776,183842,5354,189196,1966
2022-01-08,Santa Cruz,087,273765,29086,24678,1434,26112,230
2022-01-08,Shasta,089,179085,24647,23585,4140,27725,445
2022-01-08,Sierra,091,2930,235,215,23,238,0
2022-01-08,Siskiyou,093,43540,3683,3545,1618,5163,62
2022-01-08,Solano,095,438530,59022,52452,2717,55169,383
2022-01-08,Sonoma,097,501317,57733,50130,1372,51502,411
2022-01-08,Stanislaus,099,539301,92167,87049,10792,97841,1372
2022-01-08,Sutter,101,95872,16196,15261,580,15841,195
2022-01-08,Tehama,103,63373,9618,9109,1783,10892,140
2022-01-08,Trinity,105,12862,956,836,239,1075,19
2022-01-08,Tulare,107,460477,78538,73600,19053,92653,1185
2022-01-08,Tuolumne,109,53932,9011,8360,155,8515,91
2022-01-08,Ventura,111,848112,135850,117229,7288,124517,1216
2022-01-08,Yolo,113,214977,27090,24006,1982,25988,270
2022-01-08,Yuba,115,75493,12124,11277,541,11818,101
2022-01-07,Alameda,001,1643700,174685,148560,6733,155293,1558
2022-01-07,Alpine,003,1148,115,114,0,114,0
2022-01-07,Amador,005,37829,6405,6091,118,6209,71
2022-01-07,Butte,007,227075,25150,23429,4574,28003,347
2022-01-07,Calaveras,009,45235,5240,4823,94,4917,93
2022-01-07,Colusa,011,21464,2793,2713,799,3512,21
2022-01-07,Contra Costa,013,1133247,136292,119907,5772,125679,1077
2022-01-07,Del Norte,015,27424,4046,3902,77,3979,43
2022-01-07,El Dorado,017,186661,20626,18599,2160,20759,172
2022-01-07,Fresno,019,978130,165707,155394,14745,170139,2393
2022-01-07,Glenn,021,27897,3898,3732,1151,4883,39
2022-01-07,Humboldt,023,135768,12373,11149,1190,12339,121
2022-01-07,Imperial,025,180216,42281,39429,6069,45498,800
2022-01-07,Inyo,027,18085,3298,3020,73,3093,49
2022-01-07,Kern,029,883053,150551,140410,30509,170919,1921
2022-01-07,Kings,031,150075,37148,35275,2334,37609,390
2022-01-07,Lake,033,64148,7635,7209,287,7496,117
2022-01-07,Lassen,035,31185,7269,7127,468,7595,55
2022-01-07,Los Angeles,037,10098052,2052687,1765787,89014,1854801,27476
2022-01-07,Madera,039,155013,27216,25767,2849,28616,328
2022-01-07,Marin,041,260295,24991,22377,1281,23658,251
2022-01-07,Mariposa,043,17540,1758,1588,72,1660,6
2022-01-07,Mendocino,045,87422,9488,8792,909,9701,101
2022-01-07,Merced,047,269075,48856,46094,2814,48908,703
2022-01-07,Modoc,049,8938,632,610,216,826,6
2022-01-07,Mono,051,14174,2471,2240,62,2302,4
2022-01-07,Monterey,053,433212,57573,51721,5204,56925,644
2022-01-07,Napa,055,140530,18300,15819,407,16226,109
2022-01-07,Nevada,057,99092,11804,10765,474,11239,110
2022-01-07,Orange,059,3164182,429180,375124,29550,404674,5903
2022-01-07,Placer,061,380077,47512,43172,5094,48266,495
2022-01-07,Plumas,063,18699,2144,2053,71,2124,12
2022-01-07,Riverside,065,2383286,465601,422591,21270,443861,5535
2022-01-07,Sacramento,067,1510023,207406,185118,10679,195797,2470
2022-01-07,San Benito,069,59416,9668,9016,262,9278,83
2022-01-07,San Bernardino,071,2135413,455495,411724,16685,428409,6122
2022-01-07,San Diego,073,3302833,552912,472273,33448,505721,4495
2022-01-07,San Francisco,075,870044,88238,73660,4567,78227,690
2022-01-07,San Joaquin,077,732212,123814,112514,6727,119241,1916
2022-01-07,San Luis Obispo,079,281455,38327,34489,2022,36511,369
2022-01-07,San Mateo,081,765935,83702,67918,2895,70813,582
2022-01-07,Santa Barbara,083,443738,60543,54617,2351,56968,575
2022-01-07,Santa Clara,085,1922200,212512,183842,5243,189085,1966
2022-01-07,Santa Cruz,087,273765,28608,24678,1421,26099,230
2022-01-07,Shasta,089,179085,24553,23585,4106,27691,445
2022-01-07,Sierra,091,2930,232,215,23,238,0
2022-01-07,Siskiyou,093,43540,3673,3545,1606,5151,62
2022-01-07,Solano,095,438530,58310,52452,2676,55128,383
2022-01-07,Sonoma,097,501317,57132,50130,1284,51414,411
2022-01-07,Stanislaus,099,539301,91644,87049,10705,97754,1372
2022-01-07,Sutter,101,95872,16046,15261,571,15832,195
2022-01-07,Tehama,103,63373,9582,9109,1771,10880,140
2022-01-07,Trinity,105,12862,949,836,238,1074,19
2022-01-07,Tulare,107,460477,78119,73600,18909,92509,1185
2022-01-07,Tuolumne,109,53932,8923,8360,151,8511,91
2022-01-07,Ventura,111,848112,134226,117229,7160,124389,1216
2022-01-07,Yolo,113,214977,26729,24006,1963,25969,270
2022-01-07,Yuba,115,75493,12020,11277,536,11813,101
2022-01-06,Alameda,001,1643700,169319,148560,6320,154880,1558
2022-01-06,Alpine,003,1148,114,114,0,114,0
2022-01-06,Amador,005,37829,6353,6091,112,6203,71
2022-01-06,Butte,007,227075,24860,23429,4487,27916,347
2022-01-06,Calaveras,009,45235,5119,4823,92,4915,93
2022-01-06,Colusa,011,21464,2771,2713,790,3503,21
2022-01-06,Contra Costa,013,1133247,133440,119907,5358,125265,1077
2022-01-06,Del Norte,015,27424,4012,3902,75,3977,43
2022-01-06,El Dorado,017,186661,20293,18599,2119,20718,172
2022-01-06,Fresno,019,978130,163585,155394,14500,169894,2393
2022-01-06,Glenn,021,27897,3871,3732,1124,4856,39
2022-01-06,Humboldt,023,135768,12147,11149,1151,12300,121
2022-01-06,Imperial,025,180216,41699,39429,5863,45292,800
2022-01-06,Inyo,027,18085,3260,3020,73,3093,49
2022-01-06,Kern,029,883053,148886,140410,29832,170242,1921
2022-01-06,Kings,031,150075,36810,35275,2308,37583,390
2022-01-06,Lake,033,64148,7561,7209,275,7484,117
2022-01-06,Lassen,035,31185,7247,7127,462,7589,55
2022-01-06,Los Angeles,037,10098052,1998575,1765787,86681,1852468,27476
2022-01-06,Madera,039,155013,26909,25767,2793,28560,328
2022-01-06,Marin,041,260295,24585,22377,1248,23625,251
2022-01-06,Mariposa,043,17540,1739,1588,70,1658,6
2022-01-06,Mendocino,045,87422,9394,8792,868,9660,101
2022-01-06,Merced,047,269075,48306,46094,2678,48772,703
2022-01-06,Modoc,049,8938,631,610,216,826,6
2022-01-06,Mono,051,14174,2448,2240,59,2299,4
2022-01-06,Monterey,053,433212,56858,51721,4951,56672,644
2022-01-06,Napa,055,140530,17902,15819,398,16217,109
2022-01-06,Nevada,057,99092,11605,10765,462,11227,110
2022-01-06,Orange,059,3164182,419740,375124,28812,403936,5903
2022-01-06,Placer,061,380077,46761,43172,5011,48183,495
2022-01-06,Plumas,063,18699,2128,2053,64,2117,12
2022-01-06,Riverside,065,2383286,458131,422591,20974,443565,5535
2022-01-06,Sacramento,067,1510023,203516,185118,9922,195040,2470
2022-01-06,San Benito,069,59416,9568,9016,255,9271,83
2022-01-06,San Bernardino,071,2135413,448325,411724,16211,427935,6122
2022-01-06,San Diego,073,3302833,541256,472273,32467,504740,4495
2022-01-06,San Francisco,075,870044,85887,73660,4311,77971,690
2022-01-06,San Joaquin,077,732212,121661,112514,6647,119161,1916
2022-01-06,San Luis Obispo,079,281455,37625,34489,1950,36439,369
2022-01-06,San Mateo,081,765935,81368,67918,2714,70632,582
2022-01-06,Santa Barbara,083,443738,59380,54617,2288,56905,575
2022-01-06,Santa Clara,085,1922200,207580,183842,4855,188697,1966
2022-01-06,Santa Cruz,087,273765,28050,24678,1398,26076,230
2022-01-06,Shasta,089,179085,24409,23585,4056,27641,445
2022-01-06,Sierra,091,2930,229,215,23,238,0
2022-01-06,Siskiyou,093,43540,3657,3545,1560,5105,62
2022-01-06,Solano,095,438530,57298,52452,2501,54953,383
2022-01-06,Sonoma,097,501317,55753,50130,1253,51383,411
2022-01-06,Stanislaus,099,539301,90493,87049,10541,97590,1372
2022-01-06,Sutter,101,95872,15870,15261,550,15811,195
2022-01-06,Tehama,103,63373,9506,9109,1744,10853,140
2022-01-06,Trinity,105,12862,942,836,237,1073,19
2022-01-06,Tulare,107,460477,77435,73600,18732,92332,1185
2022-01-06,Tuolumne,109,53932,8814,8360,145,8505,91
2022-01-06,Ventura,111,848112,131532,117229,7006,124235,1216
2022-01-06,Yolo,113,214977,26201,24006,1919,25925,270
2022-01-06,Yuba,115,75493,11885,11277,519,11796,101
2022-01-05,Alameda,001,1643700,164163,144824,5887,150711,1548
2022-01-05,Alpine,003,1148,114,112,0,112,0
2022-01-05,Amador,005,37829,6309,6012,109,6121,70
2022-01-05,Butte,007,227075,24554,23134,4429,27563,343
2022-01-05,Calaveras,009,45235,5063,4758,90,4848,90
2022-01-05,Colusa,011,21464,2757,2704,779,3483,21
2022-01-05,Contra Costa,013,1133247,130438,117188,4912,122100,1071
2022-01-05,Del Norte,015,27424,3991,3862,73,3935,43
2022-01-05,El Dorado,017,186661,19907,18367,2089,20456,171
2022-01-05,Fresno,019,978130,161574,153033,14266,167299,2377
2022-01-05,Glenn,021,27897,3823,3700,1114,4814,39
2022-01-05,Humboldt,023,135768,11942,10938,1103,12041,120
2022-01-05,Imperial,025,180216,41070,38789,5707,44496,800
2022-01-05,Inyo,027,18085,3177,2939,69,3008,49
2022-01-05,Kern,029,883053,147111,138186,29255,167441,1913
2022-01-05,Kings,031,150075,36468,34893,2289,37182,387
2022-01-05,Lake,033,64148,7480,7129,259,7388,117
2022-01-05,Lassen,035,31185,7228,7077,454,7531,55
2022-01-05,Los Angeles,037,10098052,1942372,1729640,84404,1814044,27443
2022-01-05,Madera,039,155013,26669,25392,2703,28095,327
2022-01-05,Marin,041,260295,24245,21829,1197,23026,251
2022-01-05,Mariposa,043,17540,1713,1564,69,1633,6
2022-01-05,Mendocino,045,87422,9263,8625,833,9458,101
2022-01-05,Merced,047,269075,47731,45721,2546,48267,700
2022-01-05,Modoc,049,8938,628,603,216,819,6
2022-01-05,Mono,051,14174,2428,2201,55,2256,4
2022-01-05,Monterey,053,433212,56045,51241,4752,55993,639
2022-01-05,Napa,055,140530,17539,15494,366,15860,108
2022-01-05,Nevada,057,99092,11405,10624,445,11069,110
2022-01-05,Orange,059,3164182,409702,366139,27755,393894,5869
2022-01-05,Placer,061,380077,45880,42456,4915,47371,492
2022-01-05,Plumas,063,18699,2112,2020,62,2082,12
2022-01-05,Riverside,065,2383286,450675,415253,20619,435872,5502
2022-01-05,Sacramento,067,1510023,198935,181488,8962,190450,2455
2022-01-05,San Benito,069,59416,9374,8829,243,9072,83
2022-01-05,San Bernardino,071,2135413,440190,405323,15672,420995,6085
2022-01-05,San Diego,073,3302833,527656,466602,31518,498120,4495
2022-01-05,San Francisco,075,870044,83311,71405,4172,75577,686
2022-01-05,San Joaquin,077,732212,119132,110497,6569,117066,1903
2022-01-05,San Luis Obispo,079,281455,36828,34066,1873,35939,369
2022-01-05,San Mateo,081,765935,79284,66018,2516,68534,578
2022-01-05,Santa Barbara,083,443738,58077,53082,2208,55290,570
2022-01-05,Santa Clara,085,1922200,201768,178629,4439,183068,1961
2022-01-05,Santa Cruz,087,273765,27298,24394,1375,25769,229
2022-01-05,Shasta,089,179085,24250,23361,4027,27388,441
2022-01-05,Sierra,091,2930,226,210,22,232,0
2022-01-05,Siskiyou,093,43540,3647,3513,1531,5044,60
2022-01-05,Solano,095,438530,56262,51505,2365,53870,380
2022-01-05,Sonoma,097,501317,54488,49120,1093,50213,412
2022-01-05,Stanislaus,099,539301,89506,86248,10388,96636,1360
2022-01-05,Sutter,101,95872,15667,15117,511,15628,193
2022-01-05,Tehama,103,63373,9411,9011,1713,10724,140
2022-01-05,Trinity,105,12862,939,822,235,1057,19
2022-01-05,Tulare,107,460477,76682,72718,18555,91273,1173
2022-01-05,Tuolumne,109,53932,8721,8223,138,8361,90
2022-01-05,Ventura,111,848112,128780,114752,6801,121553,1211
2022-01-05,Yolo,113,214977,25622,23401,1879,25280,269
2022-01-05,Yuba,115,75493,11702,11138,494,11632,100
2022-01-04,Alameda,001,1643700,158600,143360,5476,148836,1532
2022-01-04,Alpine,003,1148,114,113,0,113,0
2022-01-04,Amador,005,37829,6242,6025,104,6129,71
2022-01-04,Butte,007,227075,24255,23094,4362,27456,346
2022-01-04,Calaveras,009,45235,4986,4767,87,4854,93
2022-01-04,Colusa,011,21464,2738,2689,772,3461,21
2022-01-04,Contra Costa,013,1133247,127391,116005,4553,120558,1075
2022-01-04,Del Norte,015,27424,3959,3882,70,3952,43
2022-01-04,El Dorado,017,186661,19546,18339,2067,20406,172
2022-01-04,Fresno,019,978130,159416,153244,14034,167278,2380
2022-01-04,Glenn,021,27897,3793,3705,1100,4805,39
2022-01-04,Humboldt,023,135768,11682,10865,1052,11917,120
2022-01-04,Imperial,025,180216,40465,38596,5439,44035,800
2022-01-04,Inyo,027,18085,3093,2870,68,2938,49
2022-01-04,Kern,029,883053,145184,138245,28667,166912,1916
2022-01-04,Kings,031,150075,36153,34931,2273,37204,388
2022-01-04,Lake,033,64148,7439,7152,249,7401,117
2022-01-04,Lassen,035,31185,7205,7111,450,7561,55
2022-01-04,Los Angeles,037,10098052,1882476,1705253,82087,1787340,27419
2022-01-04,Madera,039,155013,26324,25425,2638,28063,328
2022-01-04,Marin,041,260295,23765,21675,1139,22814,251
2022-01-04,Mariposa,043,17540,1677,1564,68,1632,6
2022-01-04,Mendocino,045,87422,9139,8636,810,9446,101
2022-01-04,Merced,047,269075,47122,45583,2416,47999,700
2022-01-04,Modoc,049,8938,625,611,216,827,6
2022-01-04,Mono,051,14174,2379,2190,45,2235,4
2022-01-04,Monterey,053,433212,55313,51176,4561,55737,643
2022-01-04,Napa,055,140530,17037,15370,336,15706,107
2022-01-04,Nevada,057,99092,11249,10608,433,11041,110
2022-01-04,Orange,059,3164182,398942,362051,26614,388665,5897
2022-01-04,Placer,061,380077,45047,42285,4803,47088,494
2022-01-04,Plumas,063,18699,2096,2014,60,2074,12
2022-01-04,Riverside,065,2383286,442156,413366,20265,433631,5504
2022-01-04,Sacramento,067,1510023,194178,181271,8227,189498,2453
2022-01-04,San Benito,069,59416,9186,8763,235,8998,79
2022-01-04,San Bernardino,071,2135413,431673,404409,15139,419548,6060
2022-01-04,San Diego,073,3302833,511229,458499,30571,489070,4487
2022-01-04,San Francisco,075,870044,80447,70666,4024,74690,688
2022-01-04,San Joaquin,077,732212,116725,110374,6436,116810,1911
2022-01-04,San Luis Obispo,079,281455,36019,33788,1785,35573,371
2022-01-04,San Mateo,081,765935,77044,65157,2327,67484,582
2022-01-04,Santa Barbara,083,443738,56553,52449,2131,54580,574
2022-01-04,Santa Clara,085,1922200,195769,176854,3976,180830,1964
2022-01-04,Santa Cruz,087,273765,26536,23904,1344,25248,228
2022-01-04,Shasta,089,179085,24107,23366,3972,27338,442
2022-01-04,Sierra,091,2930,225,214,22,236,0
2022-01-04,Siskiyou,093,43540,3631,3509,1512,5021,61
2022-01-04,Solano,095,438530,54964,51300,2168,53468,383
2022-01-04,Sonoma,097,501317,52782,48653,971,49624,410
2022-01-04,Stanislaus,099,539301,88447,86107,10232,96339,1361
2022-01-04,Sutter,101,95872,15514,15032,486,15518,193
2022-01-04,Tehama,103,63373,9335,9020,1692,10712,140
2022-01-04,Trinity,105,12862,933,833,231,1064,18
2022-01-04,Tulare,107,460477,75903,72893,18351,91244,1172
2022-01-04,Tuolumne,109,53932,8611,8235,133,8368,91
2022-01-04,Ventura,111,848112,125710,114079,6570,120649,1213
2022-01-04,Yolo,113,214977,25001,22938,1838,24776,270
2022-01-04,Yuba,115,75493,11522,11104,481,11585,101
2022-01-03,Alameda,001,1643700,152577,142090,5035,147125,1529
2022-01-03,Alpine,003,1148,113,113,0,113,0
2022-01-03,Amador,005,37829,6182,6004,99,6103,71
2022-01-03,Butte,007,227075,23958,22924,4311,27235,345
2022-01-03,Calaveras,009,45235,4927,4742,82,4824,93
2022-01-03,Colusa,011,21464,2729,2683,765,3448,21
2022-01-03,Contra Costa,013,1133247,124187,114966,3967,118933,1073
2022-01-03,Del Norte,015,27424,3939,3873,66,3939,43
2022-01-03,El Dorado,017,186661,19152,18183,2041,20224,172
2022-01-03,Fresno,019,978130,157437,152674,13855,166529,2379
2022-01-03,Glenn,021,27897,3764,3703,1065,4768,39
2022-01-03,Humboldt,023,135768,11472,10784,1003,11787,119
2022-01-03,Imperial,025,180216,39835,38411,5264,43675,800
2022-01-03,Inyo,027,18085,3024,2845,64,2909,49
2022-01-03,Kern,029,883053,143190,137773,28070,165843,1916
2022-01-03,Kings,031,150075,35835,34817,2245,37062,387
2022-01-03,Lake,033,64148,7338,7134,231,7365,117
2022-01-03,Lassen,035,31185,7187,7103,448,7551,55
2022-01-03,Los Angeles,037,10098052,1821759,1686203,79341,1765544,27394
2022-01-03,Madera,039,155013,26031,25323,2595,27918,320
2022-01-03,Marin,041,260295,23176,21532,1100,22632,251
2022-01-03,Mariposa,043,17540,1635,1559,68,1627,6
2022-01-03,Mendocino,045,87422,8992,8573,760,9333,101
2022-01-03,Merced,047,269075,46530,45459,2311,47770,696
2022-01-03,Modoc,049,8938,622,602,216,818,6
2022-01-03,Mono,051,14174,2300,2172,40,2212,4
2022-01-03,Monterey,053,433212,54496,51047,4358,55405,644
2022-01-03,Napa,055,140530,16529,15260,303,15563,107
2022-01-03,Nevada,057,99092,11084,10572,423,10995,110
2022-01-03,Orange,059,3164182,387767,358052,25430,383482,5894
2022-01-03,Placer,061,380077,44226,42054,4740,46794,489
2022-01-03,Plumas,063,18699,2078,2005,60,2065,12
2022-01-03,Riverside,065,2383286,433678,410155,19766,429921,5504
2022-01-03,Sacramento,067,1510023,189082,179992,7669,187661,2452
2022-01-03,San Benito,069,59416,9021,8688,228,8916,79
2022-01-03,San Bernardino,071,2135413,423350,401938,14683,416621,6056
2022-01-03,San Diego,073,3302833,495071,451154,29621,480775,4476
2022-01-03,San Francisco,075,870044,77629,69315,3770,73085,686
2022-01-03,San Joaquin,077,732212,114417,109757,6355,116112,1903
2022-01-03,San Luis Obispo,079,281455,35205,33667,1692,35359,367
2022-01-03,San Mateo,081,765935,74396,64470,2169,66639,582
2022-01-03,Santa Barbara,083,443738,55092,51912,2037,53949,571
2022-01-03,Santa Clara,085,1922200,189819,174215,3500,177715,1963
2022-01-03,Santa Cruz,087,273765,25727,23765,1311,25076,228
2022-01-03,Shasta,089,179085,23925,23301,3944,27245,440
2022-01-03,Sierra,091,2930,218,213,21,234,0
2022-01-03,Siskiyou,093,43540,3605,3500,1490,4990,61
2022-01-03,Solano,095,438530,53669,51030,1976,53006,380
2022-01-03,Sonoma,097,501317,51084,48391,875,49266,410
2022-01-03,Stanislaus,099,539301,87453,85793,10067,95860,1332
2022-01-03,Sutter,101,95872,15361,14973,466,15439,193
2022-01-03,Tehama,103,63373,9261,9005,1667,10672,140
2022-01-03,Trinity,105,12862,928,833,230,1063,18
2022-01-03,Tulare,107,460477,75198,72664,18130,90794,1167
2022-01-03,Tuolumne,109,53932,8473,8179,129,8308,91
2022-01-03,Ventura,111,848112,122535,112762,6339,119101,1211
2022-01-03,Yolo,113,214977,24319,22563,1773,24336,270
2022-01-03,Yuba,115,75493,11386,11037,462,11499,99
2022-01-02,Alameda,001,1643700,148150,133486,4545,138031,1528
2022-01-02,Alpine,003,1148,111,113,0,113,0
2022-01-02,Amador,005,37829,6116,5913,94,6007,70
2022-01-02,Butte,007,227075,23619,22469,4253,26722,341
2022-01-02,Calaveras,009,45235,4858,4668,74,4742,93
2022-01-02,Colusa,011,21464,2724,2659,754,3413,21
2022-01-02,Contra Costa,013,1133247,120623,109593,3524,113117,1073
2022-01-02,Del Norte,015,27424,3907,3841,64,3905,43
2022-01-02,El Dorado,017,186661,18815,17621,1989,19610,172
2022-01-02,Fresno,019,978130,155737,149927,13655,163582,2379
2022-01-02,Glenn,021,27897,3744,3663,1056,4719,39
2022-01-02,Humboldt,023,135768,11234,10381,924,11305,119
2022-01-02,Imperial,025,180216,39170,37672,5047,42719,800
2022-01-02,Inyo,027,18085,2954,2726,53,2779,49
2022-01-02,Kern,029,883053,141270,136123,27472,163595,1917
2022-01-02,Kings,031,150075,35517,34318,2210,36528,386
2022-01-02,Lake,033,64148,7266,7060,217,7277,117
2022-01-02,Lassen,035,31185,7171,7089,446,7535,55
2022-01-02,Los Angeles,037,10098052,1770672,1596123,76505,1672628,27371
2022-01-02,Madera,039,155013,25777,25002,2538,27540,320
2022-01-02,Marin,041,260295,22617,20475,1029,21504,249
2022-01-02,Mariposa,043,17540,1605,1509,66,1575,6
2022-01-02,Mendocino,045,87422,8873,8422,742,9164,101
2022-01-02,Merced,047,269075,45998,44769,2216,46985,694
2022-01-02,Modoc,049,8938,620,601,215,816,6
2022-01-02,Mono,051,14174,2272,2101,35,2136,4
2022-01-02,Monterey,053,433212,53880,50251,4149,54400,643
2022-01-02,Napa,055,140530,15987,14439,292,14731,107
2022-01-02,Nevada,057,99092,10900,10299,409,10708,110
2022-01-02,Orange,059,3164182,376772,339526,24280,363806,5890
2022-01-02,Placer,061,380077,43499,40857,4653,45510,489
2022-01-02,Plumas,063,18699,2063,1994,56,2050,12
2022-01-02,Riverside,065,2383286,425351,397124,19244,416368,5501
2022-01-02,Sacramento,067,1510023,185020,173562,6835,180397,2448
2022-01-02,San Benito,069,59416,8838,8320,213,8533,79
2022-01-02,San Bernardino,071,2135413,415809,386278,14139,400417,6051
2022-01-02,San Diego,073,3302833,480034,427087,28463,455550,4469
2022-01-02,San Francisco,075,870044,74679,64498,3532,68030,682
2022-01-02,San Joaquin,077,732212,112551,106640,6251,112891,1902
2022-01-02,San Luis Obispo,079,281455,34471,32342,1609,33951,365
2022-01-02,San Mateo,081,765935,71830,60504,1927,62431,581
2022-01-02,Santa Barbara,083,443738,53657,49555,1974,51529,568
2022-01-02,Santa Clara,085,1922200,183680,164547,3098,167645,1969
2022-01-02,Santa Cruz,087,273765,25056,22980,1288,24268,228
2022-01-02,Shasta,089,179085,23736,23161,3895,27056,435
2022-01-02,Sierra,091,2930,217,206,21,227,0
2022-01-02,Siskiyou,093,43540,3580,3474,1467,4941,61
2022-01-02,Solano,095,438530,52729,48957,1811,50768,379
2022-01-02,Sonoma,097,501317,49761,46040,837,46877,410
2022-01-02,Stanislaus,099,539301,86601,84367,9952,94319,1332
2022-01-02,Sutter,101,95872,15189,14741,448,15189,193
2022-01-02,Tehama,103,63373,9196,8944,1645,10589,139
2022-01-02,Trinity,105,12862,926,832,229,1061,17
2022-01-02,Tulare,107,460477,74537,71941,17940,89881,1160
2022-01-02,Tuolumne,109,53932,8367,8044,124,8168,91
2022-01-02,Ventura,111,848112,119616,107992,6120,114112,1211
2022-01-02,Yolo,113,214977,23671,21747,1706,23453,270
2022-01-02,Yuba,115,75493,11264,10844,445,11289,99
2022-01-01,Alameda,001,1643700,146363,133486,4291,137777,1528
2022-01-01,Alpine,003,1148,111,113,0,113,0
2022-01-01,Amador,005,37829,6081,5913,89,6002,70
2022-01-01,Butte,007,227075,23425,22469,4225,26694,341
2022-01-01,Calaveras,009,45235,4822,4668,72,4740,93
2022-01-01,Colusa,011,21464,2722,2659,744,3403,21
2022-01-01,Contra Costa,013,1133247,119264,109593,3396,112989,1073
2022-01-01,Del Norte,015,27424,3901,3841,64,3905,43
2022-01-01,El Dorado,017,186661,18667,17621,1974,19595,172
2022-01-01,Fresno,019,978130,155084,149927,13591,163518,2379
2022-01-01,Glenn,021,27897,3737,3663,1056,4719,39
2022-01-01,Humboldt,023,135768,11101,10381,904,11285,119
2022-01-01,Imperial,025,180216,39021,37672,5002,42674,800
2022-01-01,Inyo,027,18085,2925,2726,51,2777,49
2022-01-01,Kern,029,883053,140579,136123,27161,163284,1917
2022-01-01,Kings,031,150075,35382,34318,2183,36501,386
2022-01-01,Lake,033,64148,7227,7060,212,7272,117
2022-01-01,Lassen,035,31185,7165,7089,441,7530,55
2022-01-01,Los Angeles,037,10098052,1750579,1596123,74549,1670672,27371
2022-01-01,Madera,039,155013,25695,25002,2524,27526,320
2022-01-01,Marin,041,260295,22307,20475,988,21463,249
2022-01-01,Mariposa,043,17540,1594,1509,66,1575,6
2022-01-01,Mendocino,045,87422,8781,8422,736,9158,101
2022-01-01,Merced,047,269075,45865,44769,2206,46975,694
2022-01-01,Modoc,049,8938,617,601,215,816,6
2022-01-01,Mono,051,14174,2248,2101,30,2131,4
2022-01-01,Monterey,053,433212,53583,50251,4066,54317,643
2022-01-01,Napa,055,140530,15837,14439,277,14716,107
2022-01-01,Nevada,057,99092,10828,10299,402,10701,110
2022-01-01,Orange,059,3164182,372561,339526,23567,363093,5890
2022-01-01,Placer,061,380077,43201,40857,4589,45446,489
2022-01-01,Plumas,063,18699,2051,1994,56,2050,12
2022-01-01,Riverside,065,2383286,421869,397124,19041,416165,5501
2022-01-01,Sacramento,067,1510023,183770,173562,6576,180138,2448
2022-01-01,San Benito,069,59416,8747,8320,213,8533,79
2022-01-01,San Bernardino,071,2135413,412738,386278,13863,400141,6051
2022-01-01,San Diego,073,3302833,474129,427087,27960,455047,4469
2022-01-01,San Francisco,075,870044,73269,64498,3318,67816,682
2022-01-01,San Joaquin,077,732212,111853,106640,6200,112840,1902
2022-01-01,San Luis Obispo,079,281455,34269,32342,1599,33941,365
2022-01-01,San Mateo,081,765935,70364,60504,1776,62280,581
2022-01-01,Santa Barbara,083,443738,52921,49555,1939,51494,568
2022-01-01,Santa Clara,085,1922200,180660,164547,2901,167448,1969
2022-01-01,Santa Cruz,087,273765,24735,22980,1273,24253,228
2022-01-01,Shasta,089,179085,23654,23161,3877,27038,435
2022-01-01,Sierra,091,2930,216,206,21,227,0
2022-01-01,Siskiyou,093,43540,3577,3474,1457,4931,61
2022-01-01,Solano,095,438530,52467,48957,1754,50711,379
2022-01-01,Sonoma,097,501317,49370,46040,806,46846,410
2022-01-01,Stanislaus,099,539301,86199,84367,9890,94257,1332
2022-01-01,Sutter,101,95872,15113,14741,446,15187,193
2022-01-01,Tehama,103,63373,9164,8944,1633,10577,139
2022-01-01,Trinity,105,12862,923,832,229,1061,17
2022-01-01,Tulare,107,460477,74294,71941,17838,89779,1160
2022-01-01,Tuolumne,109,53932,8308,8044,121,8165,91
2022-01-01,Ventura,111,848112,118230,107992,5991,113983,1211
2022-01-01,Yolo,113,214977,23254,21747,1668,23415,270
2022-01-01,Yuba,115,75493,11199,10844,439,11283,99
2021-12-31,Alameda,001,1643700,145634,133486,4195,137681,1528
2021-12-31,Alpine,003,1148,111,113,0,113,0
2021-12-31,Amador,005,37829,6058,5913,88,6001,70
2021-12-31,Butte,007,227075,23323,22469,4195,26664,341
2021-12-31,Calaveras,009,45235,4792,4668,72,4740,93
2021-12-31,Colusa,011,21464,2715,2659,738,3397,21
2021-12-31,Contra Costa,013,1133247,118379,109593,3317,112910,1073
2021-12-31,Del Norte,015,27424,3892,3841,62,3903,43
2021-12-31,El Dorado,017,186661,18592,17621,1956,19577,172
2021-12-31,Fresno,019,978130,154784,149927,13574,163501,2379
2021-12-31,Glenn,021,27897,3736,3663,1054,4717,39
2021-12-31,Humboldt,023,135768,11014,10381,885,11266,119
2021-12-31,Imperial,025,180216,38896,37672,4989,42661,800
2021-12-31,Inyo,027,18085,2899,2726,51,2777,49
2021-12-31,Kern,029,883053,140073,136123,27025,163148,1917
2021-12-31,Kings,031,150075,35277,34318,2173,36491,386
2021-12-31,Lake,033,64148,7204,7060,207,7267,117
2021-12-31,Lassen,035,31185,7152,7089,441,7530,55
2021-12-31,Los Angeles,037,10098052,1739841,1596123,73796,1669919,27371
2021-12-31,Madera,039,155013,25628,25002,2507,27509,320
2021-12-31,Marin,041,260295,22151,20475,957,21432,249
2021-12-31,Mariposa,043,17540,1587,1509,65,1574,6
2021-12-31,Mendocino,045,87422,8748,8422,733,9155,101
2021-12-31,Merced,047,269075,45781,44769,2189,46958,694
2021-12-31,Modoc,049,8938,613,601,213,814,6
2021-12-31,Mono,051,14174,2235,2101,29,2130,4
2021-12-31,Monterey,053,433212,53458,50251,4001,54252,643
2021-12-31,Napa,055,140530,15725,14439,267,14706,107
2021-12-31,Nevada,057,99092,10762,10299,396,10695,110
2021-12-31,Orange,059,3164182,370054,339526,23143,362669,5890
2021-12-31,Placer,061,380077,42965,40857,4523,45380,489
2021-12-31,Plumas,063,18699,2046,1994,56,2050,12
2021-12-31,Riverside,065,2383286,420195,397124,18883,416007,5501
2021-12-31,Sacramento,067,1510023,182924,173562,6474,180036,2448
2021-12-31,San Benito,069,59416,8733,8320,212,8532,79
2021-12-31,San Bernardino,071,2135413,410579,386278,13676,399954,6051
2021-12-31,San Diego,073,3302833,470970,427087,27655,454742,4469
2021-12-31,San Francisco,075,870044,72342,64498,3262,67760,682
2021-12-31,San Joaquin,077,732212,111234,106640,6157,112797,1902
2021-12-31,San Luis Obispo,079,281455,34161,32342,1586,33928,365
2021-12-31,San Mateo,081,765935,69491,60504,1722,62226,581
2021-12-31,Santa Barbara,083,443738,52528,49555,1925,51480,568
2021-12-31,Santa Clara,085,1922200,178730,164547,2759,167306,1969
2021-12-31,Santa Cruz,087,273765,24500,22980,1257,24237,228
2021-12-31,Shasta,089,179085,23590,23161,3856,27017,435
2021-12-31,Sierra,091,2930,216,206,21,227,0
2021-12-31,Siskiyou,093,43540,3570,3474,1446,4920,61
2021-12-31,Solano,095,438530,52309,48957,1728,50685,379
2021-12-31,Sonoma,097,501317,49123,46040,793,46833,410
2021-12-31,Stanislaus,099,539301,85876,84367,9846,94213,1332
2021-12-31,Sutter,101,95872,15053,14741,440,15181,193
2021-12-31,Tehama,103,63373,9132,8944,1624,10568,139
2021-12-31,Trinity,105,12862,922,832,229,1061,17
2021-12-31,Tulare,107,460477,74096,71941,17753,89694,1160
2021-12-31,Tuolumne,109,53932,8264,8044,120,8164,91
2021-12-31,Ventura,111,848112,117257,107992,5909,113901,1211
2021-12-31,Yolo,113,214977,23033,21747,1646,23393,270
2021-12-31,Yuba,115,75493,11142,10844,433,11277,99
2021-12-30,Alameda,001,1643700,144362,133486,4063,137549,1528
2021-12-30,Alpine,003,1148,110,113,0,113,0
2021-12-30,Amador,005,37829,6039,5913,87,6000,70
2021-12-30,Butte,007,227075,23202,22469,4173,26642,341
2021-12-30,Calaveras,009,45235,4773,4668,72,4740,93
2021-12-30,Colusa,011,21464,2714,2659,736,3395,21
2021-12-30,Contra Costa,013,1133247,117292,109593,3206,112799,1073
2021-12-30,Del Norte,015,27424,3881,3841,61,3902,43
2021-12-30,El Dorado,017,186661,18489,17621,1935,19556,172
2021-12-30,Fresno,019,978130,154282,149927,13513,163440,2379
2021-12-30,Glenn,021,27897,3731,3663,1051,4714,39
2021-12-30,Humboldt,023,135768,10946,10381,873,11254,119
2021-12-30,Imperial,025,180216,38728,37672,4873,42545,800
2021-12-30,Inyo,027,18085,2881,2726,49,2775,49
2021-12-30,Kern,029,883053,139540,136123,26723,162846,1917
2021-12-30,Kings,031,150075,35159,34318,2158,36476,386
2021-12-30,Lake,033,64148,7190,7060,202,7262,117
2021-12-30,Lassen,035,31185,7146,7089,441,7530,55
2021-12-30,Los Angeles,037,10098052,1716562,1596123,72552,1668675,27371
2021-12-30,Madera,039,155013,25546,25002,2487,27489,320
2021-12-30,Marin,041,260295,21974,20475,933,21408,249
2021-12-30,Mariposa,043,17540,1581,1509,65,1574,6
2021-12-30,Mendocino,045,87422,8731,8422,722,9144,101
2021-12-30,Merced,047,269075,45679,44769,2175,46944,694
2021-12-30,Modoc,049,8938,612,601,213,814,6
2021-12-30,Mono,051,14174,2231,2101,28,2129,4
2021-12-30,Monterey,053,433212,53153,50251,3940,54191,643
2021-12-30,Napa,055,140530,15581,14439,258,14697,107
2021-12-30,Nevada,057,99092,10700,10299,388,10687,110
2021-12-30,Orange,059,3164182,364966,339526,22586,362112,5890
2021-12-30,Placer,061,380077,42687,40857,4474,45331,489
2021-12-30,Plumas,063,18699,2042,1994,55,2049,12
2021-12-30,Riverside,065,2383286,416923,397124,18727,415851,5501
2021-12-30,Sacramento,067,1510023,181674,173562,6330,179892,2448
2021-12-30,San Benito,069,59416,8687,8320,208,8528,79
2021-12-30,San Bernardino,071,2135413,408140,386278,13527,399805,6051
2021-12-30,San Diego,073,3302833,465838,427087,27162,454249,4469
2021-12-30,San Francisco,075,870044,71235,64498,3190,67688,682
2021-12-30,San Joaquin,077,732212,110643,106640,6126,112766,1902
2021-12-30,San Luis Obispo,079,281455,34041,32342,1572,33914,365
2021-12-30,San Mateo,081,765935,68449,60504,1590,62094,581
2021-12-30,Santa Barbara,083,443738,52050,49555,1905,51460,568
2021-12-30,Santa Clara,085,1922200,176456,164547,2634,167181,1969
2021-12-30,Santa Cruz,087,273765,24262,22980,1227,24207,228
2021-12-30,Shasta,089,179085,23540,23161,3850,27011,435
2021-12-30,Sierra,091,2930,216,206,21,227,0
2021-12-30,Siskiyou,093,43540,3561,3474,1444,4918,61
2021-12-30,Solano,095,438530,51960,48957,1681,50638,379
2021-12-30,Sonoma,097,501317,48792,46040,784,46824,410
2021-12-30,Stanislaus,099,539301,85561,84367,9798,94165,1332
2021-12-30,Sutter,101,95872,14993,14741,439,15180,193
2021-12-30,Tehama,103,63373,9104,8944,1618,10562,139
2021-12-30,Trinity,105,12862,919,832,229,1061,17
2021-12-30,Tulare,107,460477,73915,71941,17670,89611,1160
2021-12-30,Tuolumne,109,53932,8225,8044,119,8163,91
2021-12-30,Ventura,111,848112,116000,107992,5809,113801,1211
2021-12-30,Yolo,113,214977,22901,21747,1619,23366,270
2021-12-30,Yuba,115,75493,11095,10844,431,11275,99
2021-12-29,Alameda,001,1643700,141170,131586,3909,135495,1529
2021-12-29,Alpine,003,1148,110,113,0,113,0
2021-12-29,Amador,005,37829,6016,5905,84,5989,70
2021-12-29,Butte,007,227075,23059,22353,4137,26490,338
2021-12-29,Calaveras,009,45235,4745,4646,70,4716,93
2021-12-29,Colusa,011,21464,2704,2657,731,3388,21
2021-12-29,Contra Costa,013,1133247,115189,108165,3079,111244,1072
2021-12-29,Del Norte,015,27424,3867,3826,59,3885,43
2021-12-29,El Dorado,017,186661,18264,17489,1917,19406,172
2021-12-29,Fresno,019,978130,153191,149318,13412,162730,2364
2021-12-29,Glenn,021,27897,3721,3653,1049,4702,39
2021-12-29,Humboldt,023,135768,10841,10249,852,11101,119
2021-12-29,Imperial,025,180216,38497,37460,4803,42263,800
2021-12-29,Inyo,027,18085,2849,2703,49,2752,49
2021-12-29,Kern,029,883053,138738,135648,26333,161981,1913
2021-12-29,Kings,031,150075,35044,34216,2152,36368,386
2021-12-29,Lake,033,64148,7159,7048,200,7248,117
2021-12-29,Lassen,035,31185,7142,7085,440,7525,55
2021-12-29,Los Angeles,037,10098052,1686662,1576414,70856,1647270,27349
2021-12-29,Madera,039,155013,25442,24923,2477,27400,320
2021-12-29,Marin,041,260295,21619,20025,912,20937,249
2021-12-29,Mariposa,043,17540,1559,1507,65,1572,6
2021-12-29,Mendocino,045,87422,8672,8386,718,9104,99
2021-12-29,Merced,047,269075,45461,44548,2161,46709,693
2021-12-29,Modoc,049,8938,609,600,213,813,6
2021-12-29,Mono,051,14174,2207,2056,27,2083,4
2021-12-29,Monterey,053,433212,52742,50097,3834,53931,641
2021-12-29,Napa,055,140530,15257,14247,239,14486,107
2021-12-29,Nevada,057,99092,10608,10274,387,10661,110
2021-12-29,Orange,059,3164182,357459,334557,21906,356463,5887
2021-12-29,Placer,061,380077,42202,40545,4399,44944,489
2021-12-29,Plumas,063,18699,2030,1990,55,2045,12
2021-12-29,Riverside,065,2383286,411508,392989,18515,411504,5486
2021-12-29,Sacramento,067,1510023,179338,172145,6169,178314,2437
2021-12-29,San Benito,069,59416,8543,8239,207,8446,79
2021-12-29,San Bernardino,071,2135413,402942,382872,13318,396190,6049
2021-12-29,San Diego,073,3302833,454968,421045,26468,447513,4461
2021-12-29,San Francisco,075,870044,69531,63117,3120,66237,684
2021-12-29,San Joaquin,077,732212,109471,106063,6075,112138,1891
2021-12-29,San Luis Obispo,079,281455,33648,31936,1523,33459,365
2021-12-29,San Mateo,081,765935,66823,59478,1480,60958,581
2021-12-29,Santa Barbara,083,443738,51210,49003,1880,50883,568
2021-12-29,Santa Clara,085,1922200,173324,162008,2501,164509,1962
2021-12-29,Santa Cruz,087,273765,23984,22669,1194,23863,228
2021-12-29,Shasta,089,179085,23465,23083,3838,26921,435
2021-12-29,Sierra,091,2930,216,206,21,227,0
2021-12-29,Siskiyou,093,43540,3549,3472,1433,4905,61
2021-12-29,Solano,095,438530,51252,48562,1625,50187,379
2021-12-29,Sonoma,097,501317,47996,45479,760,46239,410
2021-12-29,Stanislaus,099,539301,85079,84083,9746,93829,1332
2021-12-29,Sutter,101,95872,14927,14688,438,15126,193
2021-12-29,Tehama,103,63373,9080,8914,1605,10519,138
2021-12-29,Trinity,105,12862,918,832,229,1061,17
2021-12-29,Tulare,107,460477,73622,71752,17551,89303,1160
2021-12-29,Tuolumne,109,53932,8172,8012,118,8130,91
2021-12-29,Ventura,111,848112,114060,106974,5629,112603,1207
2021-12-29,Yolo,113,214977,22671,21564,1588,23152,270
2021-12-29,Yuba,115,75493,11034,10808,427,11235,99
2021-12-28,Alameda,001,1643700,138031,130427,3746,134173,1522
2021-12-28,Alpine,003,1148,110,113,0,113,0
2021-12-28,Amador,005,37829,5997,5900,83,5983,70
2021-12-28,Butte,007,227075,22919,22285,4120,26405,338
2021-12-28,Calaveras,009,45235,4728,4641,69,4710,91
2021-12-28,Colusa,011,21464,2698,2653,729,3382,21
2021-12-28,Contra Costa,013,1133247,112913,107160,2961,110121,1072
2021-12-28,Del Norte,015,27424,3861,3815,59,3874,43
2021-12-28,El Dorado,017,186661,18039,17419,1906,19325,172
2021-12-28,Fresno,019,978130,152138,148987,13335,162322,2365
2021-12-28,Glenn,021,27897,3695,3639,1047,4686,39
2021-12-28,Humboldt,023,135768,10721,10198,827,11025,119
2021-12-28,Imperial,025,180216,38201,37223,4697,41920,800
2021-12-28,Inyo,027,18085,2791,2676,48,2724,48
2021-12-28,Kern,029,883053,138022,135346,25977,161323,1909
2021-12-28,Kings,031,150075,34908,34165,2137,36302,386
2021-12-28,Lake,033,64148,7140,7044,195,7239,116
2021-12-28,Lassen,035,31185,7134,7083,440,7523,55
2021-12-28,Los Angeles,037,10098052,1654473,1561791,69193,1630984,27323
2021-12-28,Madera,039,155013,25317,24865,2460,27325,320
2021-12-28,Marin,041,260295,21205,19739,882,20621,249
2021-12-28,Mariposa,043,17540,1548,1499,64,1563,6
2021-12-28,Mendocino,045,87422,8612,8366,710,9076,98
2021-12-28,Merced,047,269075,45219,44434,2153,46587,691
2021-12-28,Modoc,049,8938,609,599,212,811,6
2021-12-28,Mono,051,14174,2184,2045,25,2070,4
2021-12-28,Monterey,053,433212,52376,49973,3760,53733,639
2021-12-28,Napa,055,140530,14940,14131,212,14343,107
2021-12-28,Nevada,057,99092,10518,10250,384,10634,110
2021-12-28,Orange,059,3164182,349812,331279,21161,352440,5882
2021-12-28,Placer,061,380077,41732,40410,4329,44739,489
2021-12-28,Plumas,063,18699,2027,1989,55,2044,12
2021-12-28,Riverside,065,2383286,406271,390343,18268,408611,5470
2021-12-28,Sacramento,067,1510023,177051,171290,6039,177329,2426
2021-12-28,San Benito,069,59416,8407,8170,205,8375,79
2021-12-28,San Bernardino,071,2135413,397454,381316,13105,394421,6047
2021-12-28,San Diego,073,3302833,444217,417383,25939,443322,4450
2021-12-28,San Francisco,075,870044,67906,61745,3061,64806,682
2021-12-28,San Joaquin,077,732212,108423,105572,6030,111602,1884
2021-12-28,San Luis Obispo,079,281455,33189,31759,1507,33266,365
2021-12-28,San Mateo,081,765935,65314,58712,1391,60103,582
2021-12-28,Santa Barbara,083,443738,50566,48493,1860,50353,568
2021-12-28,Santa Clara,085,1922200,170189,160811,2405,163216,1962
2021-12-28,Santa Cruz,087,273765,23612,22513,1155,23668,228
2021-12-28,Shasta,089,179085,23393,23035,3833,26868,434
2021-12-28,Sierra,091,2930,213,206,21,227,0
2021-12-28,Siskiyou,093,43540,3540,3468,1428,4896,60
2021-12-28,Solano,095,438530,50316,48318,1571,49889,378
2021-12-28,Sonoma,097,501317,47139,45086,734,45820,410
2021-12-28,Stanislaus,099,539301,84597,83946,9695,93641,1331
2021-12-28,Sutter,101,95872,14877,14662,436,15098,193
2021-12-28,Tehama,103,63373,9063,8893,1603,10496,138
2021-12-28,Trinity,105,12862,916,831,228,1059,17
2021-12-28,Tulare,107,460477,73341,71630,17422,89052,1156
2021-12-28,Tuolumne,109,53932,8129,8006,118,8124,91
2021-12-28,Ventura,111,848112,111950,105883,5498,111381,1207
2021-12-28,Yolo,113,214977,22349,21320,1538,22858,270
2021-12-28,Yuba,115,75493,10979,10778,424,11202,99
2021-12-27,Alameda,001,1643700,135465,129910,3604,133514,1530
2021-12-27,Alpine,003,1148,110,113,0,113,0
2021-12-27,Amador,005,37829,5969,5891,83,5974,70
2021-12-27,Butte,007,227075,22788,22234,4097,26331,335
2021-12-27,Calaveras,009,45235,4706,4630,68,4698,91
2021-12-27,Colusa,011,21464,2687,2652,723,3375,21
2021-12-27,Contra Costa,013,1133247,110758,106692,2880,109572,1071
2021-12-27,Del Norte,015,27424,3852,3802,58,3860,43
2021-12-27,El Dorado,017,186661,17880,17361,1893,19254,172
2021-12-27,Fresno,019,978130,151186,148826,13273,162099,2364
2021-12-27,Glenn,021,27897,3687,3634,1042,4676,39
2021-12-27,Humboldt,023,135768,10605,10164,805,10969,119
2021-12-27,Imperial,025,180216,37965,37180,4596,41776,800
2021-12-27,Inyo,027,18085,2762,2662,46,2708,48
2021-12-27,Kern,029,883053,137372,135119,25674,160793,1907
2021-12-27,Kings,031,150075,34760,34126,2124,36250,382
2021-12-27,Lake,033,64148,7117,7037,185,7222,116
2021-12-27,Lassen,035,31185,7128,7080,440,7520,55
2021-12-27,Los Angeles,037,10098052,1618219,1554074,67412,1621486,27300
2021-12-27,Madera,039,155013,25201,24840,2442,27282,320
2021-12-27,Marin,041,260295,20818,19601,855,20456,249
2021-12-27,Mariposa,043,17540,1533,1495,64,1559,6
2021-12-27,Mendocino,045,87422,8545,8351,705,9056,98
2021-12-27,Merced,047,269075,44988,44383,2136,46519,690
2021-12-27,Modoc,049,8938,607,599,212,811,6
2021-12-27,Mono,051,14174,2121,2026,25,2051,4
2021-12-27,Monterey,053,433212,52080,49918,3707,53625,639
2021-12-27,Napa,055,140530,14672,14083,203,14286,107
2021-12-27,Nevada,057,99092,10449,10239,376,10615,110
2021-12-27,Orange,059,3164182,342365,329222,20354,349576,5875
2021-12-27,Placer,061,380077,41348,40263,4281,44544,489
2021-12-27,Plumas,063,18699,2025,1988,53,2041,12
2021-12-27,Riverside,065,2383286,401692,389096,18005,407101,5470
2021-12-27,Sacramento,067,1510023,175040,170858,5865,176723,2422
2021-12-27,San Benito,069,59416,8291,8133,201,8334,79
2021-12-27,San Bernardino,071,2135413,391811,380526,12912,393438,6047
2021-12-27,San Diego,073,3302833,434000,414968,25467,440435,4445
2021-12-27,San Francisco,075,870044,66147,60920,2996,63916,682
2021-12-27,San Joaquin,077,732212,107509,105413,5983,111396,1876
2021-12-27,San Luis Obispo,079,281455,32745,31671,1485,33156,365
2021-12-27,San Mateo,081,765935,63803,58397,1291,59688,581
2021-12-27,Santa Barbara,083,443738,49786,48209,1840,50049,568
2021-12-27,Santa Clara,085,1922200,167221,159904,2282,162186,1961
2021-12-27,Santa Cruz,087,273765,23320,22456,1137,23593,228
2021-12-27,Shasta,089,179085,23330,23015,3822,26837,432
2021-12-27,Sierra,091,2930,213,206,21,227,0
2021-12-27,Siskiyou,093,43540,3531,3466,1423,4889,60
2021-12-27,Solano,095,438530,49581,48172,1523,49695,378
2021-12-27,Sonoma,097,501317,46567,44990,715,45705,410
2021-12-27,Stanislaus,099,539301,84150,83833,9660,93493,1331
2021-12-27,Sutter,101,95872,14822,14642,431,15073,191
2021-12-27,Tehama,103,63373,9048,8887,1596,10483,136
2021-12-27,Trinity,105,12862,916,827,228,1055,17
2021-12-27,Tulare,107,460477,73075,71562,17323,88885,1146
2021-12-27,Tuolumne,109,53932,8092,7978,117,8095,91
2021-12-27,Ventura,111,848112,109863,105212,5362,110574,1206
2021-12-27,Yolo,113,214977,22061,21300,1503,22803,270
2021-12-27,Yuba,115,75493,10918,10759,423,11182,98
2021-12-26,Alameda,001,1643700,133446,127221,3532,130753,1525
2021-12-26,Alpine,003,1148,110,113,0,113,0
2021-12-26,Amador,005,37829,5953,5861,81,5942,70
2021-12-26,Butte,007,227075,22636,22087,4073,26160,330
2021-12-26,Calaveras,009,45235,4684,4591,68,4659,91
2021-12-26,Colusa,011,21464,2677,2647,717,3364,21
2021-12-26,Contra Costa,013,1133247,108991,105022,2781,107803,1071
2021-12-26,Del Norte,015,27424,3847,3795,58,3853,43
2021-12-26,El Dorado,017,186661,17724,17188,1884,19072,172
2021-12-26,Fresno,019,978130,150488,148027,13207,161234,2358
2021-12-26,Glenn,021,27897,3679,3611,1031,4642,39
2021-12-26,Humboldt,023,135768,10462,10052,782,10834,119
2021-12-26,Imperial,025,180216,37664,36878,4501,41379,800
2021-12-26,Inyo,027,18085,2738,2636,43,2679,47
2021-12-26,Kern,029,883053,136653,134591,25418,160009,1908
2021-12-26,Kings,031,150075,34609,34009,2118,36127,379
2021-12-26,Lake,033,64148,7095,7019,182,7201,116
2021-12-26,Lassen,035,31185,7122,7072,439,7511,55
2021-12-26,Los Angeles,037,10098052,1588391,1515469,65607,1581076,27257
2021-12-26,Madera,039,155013,25082,24741,2427,27168,320
2021-12-26,Marin,041,260295,20440,19085,793,19878,249
2021-12-26,Mariposa,043,17540,1527,1480,64,1544,6
2021-12-26,Mendocino,045,87422,8494,8314,703,9017,98
2021-12-26,Merced,047,269075,44739,44208,2125,46333,690
2021-12-26,Modoc,049,8938,606,597,210,807,6
2021-12-26,Mono,051,14174,2095,2000,25,2025,4
2021-12-26,Monterey,053,433212,51804,49709,3659,53368,638
2021-12-26,Napa,055,140530,14436,13809,198,14007,107
2021-12-26,Nevada,057,99092,10389,10153,369,10522,110
2021-12-26,Orange,059,3164182,336051,322991,19555,342546,5863
2021-12-26,Placer,061,380077,41002,39852,4210,44062,489
2021-12-26,Plumas,063,18699,2018,1987,52,2039,12
2021-12-26,Riverside,065,2383286,397522,384567,17835,402402,5470
2021-12-26,Sacramento,067,1510023,173319,169144,5714,174858,2418
2021-12-26,San Benito,069,59416,8210,7991,197,8188,79
2021-12-26,San Bernardino,071,2135413,387279,376052,12739,388791,6043
2021-12-26,San Diego,073,3302833,425011,406616,25013,431629,4442
2021-12-26,San Francisco,075,870044,64564,58229,2934,61163,682
2021-12-26,San Joaquin,077,732212,106692,104590,5932,110522,1872
2021-12-26,San Luis Obispo,079,281455,32307,31290,1467,32757,365
2021-12-26,San Mateo,081,765935,62404,56973,1243,58216,581
2021-12-26,Santa Barbara,083,443738,49113,47553,1810,49363,567
2021-12-26,Santa Clara,085,1922200,164528,156872,2150,159022,1967
2021-12-26,Santa Cruz,087,273765,23034,22176,1123,23299,228
2021-12-26,Shasta,089,179085,23247,22959,3810,26769,432
2021-12-26,Sierra,091,2930,213,202,21,223,0
2021-12-26,Siskiyou,093,43540,3523,3460,1414,4874,60
2021-12-26,Solano,095,438530,49075,47646,1485,49131,377
2021-12-26,Sonoma,097,501317,46075,44358,682,45040,408
2021-12-26,Stanislaus,099,539301,83779,83368,9624,92992,1331
2021-12-26,Sutter,101,95872,14758,14533,428,14961,191
2021-12-26,Tehama,103,63373,9015,8861,1593,10454,136
2021-12-26,Trinity,105,12862,916,826,227,1053,17
2021-12-26,Tulare,107,460477,72829,71292,17211,88503,1137
2021-12-26,Tuolumne,109,53932,8055,7919,117,8036,91
2021-12-26,Ventura,111,848112,108030,103498,5213,108711,1206
2021-12-26,Yolo,113,214977,21778,21084,1463,22547,270
2021-12-26,Yuba,115,75493,10867,10694,421,11115,98
2021-12-25,Alameda,001,1643700,132404,127221,3469,130690,1525
2021-12-25,Alpine,003,1148,110,113,0,113,0
2021-12-25,Amador,005,37829,5933,5861,81,5942,70
2021-12-25,Butte,007,227075,22540,22087,4057,26144,330
2021-12-25,Calaveras,009,45235,4655,4591,67,4658,91
2021-12-25,Colusa,011,21464,2672,2647,711,3358,21
2021-12-25,Contra Costa,013,1133247,108143,105022,2728,107750,1071
2021-12-25,Del Norte,015,27424,3840,3795,57,3852,43
2021-12-25,El Dorado,017,186661,17671,17188,1873,19061,172
2021-12-25,Fresno,019,978130,150182,148027,13171,161198,2358
2021-12-25,Glenn,021,27897,3669,3611,1027,4638,39
2021-12-25,Humboldt,023,135768,10384,10052,775,10827,119
2021-12-25,Imperial,025,180216,37545,36878,4477,41355,800
2021-12-25,Inyo,027,18085,2718,2636,43,2679,47
2021-12-25,Kern,029,883053,136307,134591,25293,159884,1908
2021-12-25,Kings,031,150075,34520,34009,2111,36120,379
2021-12-25,Lake,033,64148,7083,7019,180,7199,116
2021-12-25,Lassen,035,31185,7120,7072,439,7511,55
2021-12-25,Los Angeles,037,10098052,1575615,1515469,64271,1579740,27257
2021-12-25,Madera,039,155013,25034,24741,2421,27162,320
2021-12-25,Marin,041,260295,20102,19085,744,19829,249
2021-12-25,Mariposa,043,17540,1521,1480,64,1544,6
2021-12-25,Mendocino,045,87422,8456,8314,703,9017,98
2021-12-25,Merced,047,269075,44639,44208,2123,46331,690
2021-12-25,Modoc,049,8938,606,597,210,807,6
2021-12-25,Mono,051,14174,2078,2000,25,2025,4
2021-12-25,Monterey,053,433212,51639,49709,3624,53333,638
2021-12-25,Napa,055,140530,14321,13809,190,13999,107
2021-12-25,Nevada,057,99092,10360,10153,369,10522,110
2021-12-25,Orange,059,3164182,333194,322991,18980,341971,5863
2021-12-25,Placer,061,380077,40813,39852,4174,44026,489
2021-12-25,Plumas,063,18699,2016,1987,52,2039,12
2021-12-25,Riverside,065,2383286,395243,384567,17713,402280,5470
2021-12-25,Sacramento,067,1510023,172512,169144,5606,174750,2418
2021-12-25,San Benito,069,59416,8149,7991,197,8188,79
2021-12-25,San Bernardino,071,2135413,385146,376052,12602,388654,6043
2021-12-25,San Diego,073,3302833,420955,406616,24744,431360,4442
2021-12-25,San Francisco,075,870044,63535,58229,2897,61126,682
2021-12-25,San Joaquin,077,732212,106358,104590,5900,110490,1872
2021-12-25,San Luis Obispo,079,281455,32152,31290,1458,32748,365
2021-12-25,San Mateo,081,765935,61377,56973,1200,58173,581
2021-12-25,Santa Barbara,083,443738,48751,47553,1798,49351,567
2021-12-25,Santa Clara,085,1922200,163045,156872,2081,158953,1967
2021-12-25,Santa Cruz,087,273765,22875,22176,1117,23293,228
2021-12-25,Shasta,089,179085,23216,22959,3804,26763,432
2021-12-25,Sierra,091,2930,213,202,21,223,0
2021-12-25,Siskiyou,093,43540,3520,3460,1408,4868,60
2021-12-25,Solano,095,438530,48953,47646,1467,49113,377
2021-12-25,Sonoma,097,501317,45691,44358,656,45014,408
2021-12-25,Stanislaus,099,539301,83564,83368,9603,92971,1331
2021-12-25,Sutter,101,95872,14717,14533,426,14959,191
2021-12-25,Tehama,103,63373,8995,8861,1589,10450,136
2021-12-25,Trinity,105,12862,915,826,227,1053,17
2021-12-25,Tulare,107,460477,72692,71292,17131,88423,1137
2021-12-25,Tuolumne,109,53932,8024,7919,117,8036,91
2021-12-25,Ventura,111,848112,106860,103498,5104,108602,1206
2021-12-25,Yolo,113,214977,21665,21084,1442,22526,270
2021-12-25,Yuba,115,75493,10841,10694,420,11114,98
2021-12-24,Alameda,001,1643700,131808,127221,3451,130672,1525
2021-12-24,Alpine,003,1148,110,113,0,113,0
2021-12-24,Amador,005,37829,5925,5861,80,5941,70
2021-12-24,Butte,007,227075,22485,22087,4044,26131,330
2021-12-24,Calaveras,009,45235,4649,4591,67,4658,91
2021-12-24,Colusa,011,21464,2670,2647,710,3357,21
2021-12-24,Contra Costa,013,1133247,107832,105022,2695,107717,1071
2021-12-24,Del Norte,015,27424,3833,3795,57,3852,43
2021-12-24,El Dorado,017,186661,17619,17188,1868,19056,172
2021-12-24,Fresno,019,978130,150019,148027,13161,161188,2358
2021-12-24,Glenn,021,27897,3668,3611,1027,4638,39
2021-12-24,Humboldt,023,135768,10328,10052,769,10821,119
2021-12-24,Imperial,025,180216,37462,36878,4473,41351,800
2021-12-24,Inyo,027,18085,2698,2636,43,2679,47
2021-12-24,Kern,029,883053,136183,134591,25251,159842,1908
2021-12-24,Kings,031,150075,34454,34009,2110,36119,379
2021-12-24,Lake,033,64148,7079,7019,180,7199,116
2021-12-24,Lassen,035,31185,7117,7072,439,7511,55
2021-12-24,Los Angeles,037,10098052,1570779,1515469,63750,1579219,27257
2021-12-24,Madera,039,155013,25001,24741,2416,27157,320
2021-12-24,Marin,041,260295,19958,19085,714,19799,249
2021-12-24,Mariposa,043,17540,1519,1480,64,1544,6
2021-12-24,Mendocino,045,87422,8439,8314,703,9017,98
2021-12-24,Merced,047,269075,44589,44208,2121,46329,690
2021-12-24,Modoc,049,8938,606,597,210,807,6
2021-12-24,Mono,051,14174,2065,2000,25,2025,4
2021-12-24,Monterey,053,433212,51542,49709,3599,53308,638
2021-12-24,Napa,055,140530,14255,13809,186,13995,107
2021-12-24,Nevada,057,99092,10333,10153,367,10520,110
2021-12-24,Orange,059,3164182,332148,322991,18822,341813,5863
2021-12-24,Placer,061,380077,40695,39852,4158,44010,489
2021-12-24,Plumas,063,18699,2015,1987,52,2039,12
2021-12-24,Riverside,065,2383286,394256,384567,17622,402189,5470
2021-12-24,Sacramento,067,1510023,172203,169144,5569,174713,2418
2021-12-24,San Benito,069,59416,8140,7991,196,8187,79
2021-12-24,San Bernardino,071,2135413,384068,376052,12534,388586,6043
2021-12-24,San Diego,073,3302833,419865,406616,24616,431232,4442
2021-12-24,San Francisco,075,870044,63023,58229,2879,61108,682
2021-12-24,San Joaquin,077,732212,106167,104590,5893,110483,1872
2021-12-24,San Luis Obispo,079,281455,32090,31290,1448,32738,365
2021-12-24,San Mateo,081,765935,60945,56973,1177,58150,581
2021-12-24,Santa Barbara,083,443738,48546,47553,1791,49344,567
2021-12-24,Santa Clara,085,1922200,162225,156872,2048,158920,1967
2021-12-24,Santa Cruz,087,273765,22792,22176,1114,23290,228
2021-12-24,Shasta,089,179085,23185,22959,3800,26759,432
2021-12-24,Sierra,091,2930,212,202,21,223,0
2021-12-24,Siskiyou,093,43540,3515,3460,1404,4864,60
2021-12-24,Solano,095,438530,48901,47646,1465,49111,377
2021-12-24,Sonoma,097,501317,45527,44358,648,45006,408
2021-12-24,Stanislaus,099,539301,83452,83368,9590,92958,1331
2021-12-24,Sutter,101,95872,14697,14533,423,14956,191
2021-12-24,Tehama,103,63373,8986,8861,1586,10447,136
2021-12-24,Trinity,105,12862,913,826,227,1053,17
2021-12-24,Tulare,107,460477,72626,71292,17087,88379,1137
2021-12-24,Tuolumne,109,53932,7999,7919,117,8036,91
2021-12-24,Ventura,111,848112,106412,103498,5048,108546,1206
2021-12-24,Yolo,113,214977,21592,21084,1424,22508,270
2021-12-24,Yuba,115,75493,10818,10694,419,11113,98
2021-12-23,Alameda,001,1643700,131129,127221,3414,130635,1525
2021-12-23,Alpine,003,1148,110,113,0,113,0
2021-12-23,Amador,005,37829,5913,5861,78,5939,70
2021-12-23,Butte,007,227075,22435,22087,4033,26120,330
2021-12-23,Calaveras,009,45235,4638,4591,67,4658,91
2021-12-23,Colusa,011,21464,2664,2647,706,3353,21
2021-12-23,Contra Costa,013,1133247,107412,105022,2650,107672,1071
2021-12-23,Del Norte,015,27424,3830,3795,57,3852,43
2021-12-23,El Dorado,017,186661,17557,17188,1862,19050,172
2021-12-23,Fresno,019,978130,149814,148027,13145,161172,2358
2021-12-23,Glenn,021,27897,3664,3611,1027,4638,39
2021-12-23,Humboldt,023,135768,10275,10052,766,10818,119
2021-12-23,Imperial,025,180216,37389,36878,4445,41323,800
2021-12-23,Inyo,027,18085,2685,2636,43,2679,47
2021-12-23,Kern,029,883053,136032,134591,25153,159744,1908
2021-12-23,Kings,031,150075,34413,34009,2109,36118,379
2021-12-23,Lake,033,64148,7067,7019,178,7197,116
2021-12-23,Lassen,035,31185,7116,7072,439,7511,55
2021-12-23,Los Angeles,037,10098052,1561272,1515469,62648,1578117,27257
2021-12-23,Madera,039,155013,24970,24741,2413,27154,320
2021-12-23,Marin,041,260295,19824,19085,697,19782,249
2021-12-23,Mariposa,043,17540,1514,1480,64,1544,6
2021-12-23,Mendocino,045,87422,8430,8314,703,9017,98
2021-12-23,Merced,047,269075,44540,44208,2119,46327,690
2021-12-23,Modoc,049,8938,606,597,210,807,6
2021-12-23,Mono,051,14174,2044,2000,24,2024,4
2021-12-23,Monterey,053,433212,51424,49709,3577,53286,638
2021-12-23,Napa,055,140530,14174,13809,181,13990,107
2021-12-23,Nevada,057,99092,10310,10153,366,10519,110
2021-12-23,Orange,059,3164182,330471,322991,18488,341479,5863
2021-12-23,Placer,061,380077,40571,39852,4142,43994,489
2021-12-23,Plumas,063,18699,2015,1987,52,2039,12
2021-12-23,Riverside,065,2383286,393050,384567,17551,402118,5470
2021-12-23,Sacramento,067,1510023,171750,169144,5523,174667,2418
2021-12-23,San Benito,069,59416,8122,7991,194,8185,79
2021-12-23,San Bernardino,071,2135413,382940,376052,12431,388483,6043
2021-12-23,San Diego,073,3302833,418032,406616,24418,431034,4442
2021-12-23,San Francisco,075,870044,62290,58229,2852,61081,682
2021-12-23,San Joaquin,077,732212,105950,104590,5880,110470,1872
2021-12-23,San Luis Obispo,079,281455,32018,31290,1444,32734,365
2021-12-23,San Mateo,081,765935,60387,56973,1156,58129,581
2021-12-23,Santa Barbara,083,443738,48347,47553,1789,49342,567
2021-12-23,Santa Clara,085,1922200,161315,156872,1989,158861,1967
2021-12-23,Santa Cruz,087,273765,22676,22176,1102,23278,228
2021-12-23,Shasta,089,179085,23157,22959,3797,26756,432
2021-12-23,Sierra,091,2930,209,202,21,223,0
2021-12-23,Siskiyou,093,43540,3515,3460,1402,4862,60
2021-12-23,Solano,095,438530,48795,47646,1449,49095,377
2021-12-23,Sonoma,097,501317,45349,44358,645,45003,408
2021-12-23,Stanislaus,099,539301,83324,83368,9576,92944,1331
2021-12-23,Sutter,101,95872,14679,14533,422,14955,191
2021-12-23,Tehama,103,63373,8974,8861,1582,10443,136
2021-12-23,Trinity,105,12862,913,826,227,1053,17
2021-12-23,Tulare,107,460477,72550,71292,17042,88334,1137
2021-12-23,Tuolumne,109,53932,7981,7919,116,8035,91
2021-12-23,Ventura,111,848112,105877,103498,4981,108479,1206
2021-12-23,Yolo,113,214977,21519,21084,1406,22490,270
2021-12-23,Yuba,115,75493,10805,10694,419,11113,98
2021-12-22,Alameda,001,1643700,130217,126533,3329,129862,1522
2021-12-22,Alpine,003,1148,110,112,0,112,0
2021-12-22,Amador,005,37829,5900,5850,77,5927,70
2021-12-22,Butte,007,227075,22385,22070,4022,26092,330
2021-12-22,Calaveras,009,45235,4629,4580,67,4647,91
2021-12-22,Colusa,011,21464,2664,2645,703,3348,21
2021-12-22,Contra Costa,013,1133247,106794,104559,2606,107165,1070
2021-12-22,Del Norte,015,27424,3830,3794,57,3851,43
2021-12-22,El Dorado,017,186661,17497,17140,1853,18993,172
2021-12-22,Fresno,019,978130,149532,147838,13119,160957,2349
2021-12-22,Glenn,021,27897,3659,3604,1027,4631,39
2021-12-22,Humboldt,023,135768,10214,10022,761,10783,119
2021-12-22,Imperial,025,180216,37303,36755,4407,41162,798
2021-12-22,Inyo,027,18085,2667,2632,43,2675,47
2021-12-22,Kern,029,883053,135798,134433,25068,159501,1900
2021-12-22,Kings,031,150075,34363,33953,2102,36055,376
2021-12-22,Lake,033,64148,7060,7008,176,7184,116
2021-12-22,Lassen,035,31185,7111,7069,438,7507,55
2021-12-22,Los Angeles,037,10098052,1547775,1507110,61472,1568582,27234
2021-12-22,Madera,039,155013,24931,24702,2409,27111,320
2021-12-22,Marin,041,260295,19603,18927,674,19601,249
2021-12-22,Mariposa,043,17540,1507,1480,64,1544,6
2021-12-22,Mendocino,045,87422,8421,8299,703,9002,99
2021-12-22,Merced,047,269075,44469,44137,2117,46254,689
2021-12-22,Modoc,049,8938,606,595,210,805,6
2021-12-22,Mono,051,14174,2040,1979,24,2003,4
2021-12-22,Monterey,053,433212,51272,49650,3560,53210,639
2021-12-22,Napa,055,140530,14046,13746,171,13917,107
2021-12-22,Nevada,057,99092,10283,10101,361,10462,110
2021-12-22,Orange,059,3164182,328197,321765,18055,339820,5858
2021-12-22,Placer,061,380077,40389,39758,4105,43863,489
2021-12-22,Plumas,063,18699,2011,1986,52,2038,12
2021-12-22,Riverside,065,2383286,391237,383319,17436,400755,5472
2021-12-22,Sacramento,067,1510023,171095,168695,5460,174155,2422
2021-12-22,San Benito,069,59416,8070,7971,192,8163,79
2021-12-22,San Bernardino,071,2135413,381327,375044,12348,387392,6039
2021-12-22,San Diego,073,3302833,413916,404269,24095,428364,4434
2021-12-22,San Francisco,075,870044,61292,57520,2804,60324,682
2021-12-22,San Joaquin,077,732212,105680,104385,5866,110251,1870
2021-12-22,San Luis Obispo,079,281455,31877,31175,1424,32599,365
2021-12-22,San Mateo,081,765935,59703,56604,1127,57731,581
2021-12-22,Santa Barbara,083,443738,48091,47372,1774,49146,566
2021-12-22,Santa Clara,085,1922200,160199,156258,1947,158205,1954
2021-12-22,Santa Cruz,087,273765,22570,22075,1096,23171,228
2021-12-22,Shasta,089,179085,23129,22937,3792,26729,432
2021-12-22,Sierra,091,2930,209,202,21,223,0
2021-12-22,Siskiyou,093,43540,3512,3458,1399,4857,59
2021-12-22,Solano,095,438530,48563,47531,1435,48966,375
2021-12-22,Sonoma,097,501317,45073,44201,634,44835,408
2021-12-22,Stanislaus,099,539301,83181,83245,9561,92806,1331
2021-12-22,Sutter,101,95872,14644,14513,419,14932,191
2021-12-22,Tehama,103,63373,8961,8853,1579,10432,136
2021-12-22,Trinity,105,12862,913,826,227,1053,17
2021-12-22,Tulare,107,460477,72449,71226,16987,88213,1137
2021-12-22,Tuolumne,109,53932,7960,7903,116,8019,91
2021-12-22,Ventura,111,848112,105271,103089,4874,107963,1206
2021-12-22,Yolo,113,214977,21443,21012,1392,22404,270
2021-12-22,Yuba,115,75493,10788,10681,419,11100,98
2021-12-21,Alameda,001,1643700,129233,126007,3273,129280,1518
2021-12-21,Alpine,003,1148,110,112,0,112,0
2021-12-21,Amador,005,37829,5890,5845,77,5922,70
2021-12-21,Butte,007,227075,22323,22041,4009,26050,330
2021-12-21,Calaveras,009,45235,4616,4575,67,4642,91
2021-12-21,Colusa,011,21464,2662,2643,702,3345,21
2021-12-21,Contra Costa,013,1133247,106152,104255,2542,106797,1068
2021-12-21,Del Norte,015,27424,3829,3793,57,3850,43
2021-12-21,El Dorado,017,186661,17434,17098,1841,18939,172
2021-12-21,Fresno,019,978130,149251,147707,13090,160797,2341
2021-12-21,Glenn,021,27897,3645,3602,1027,4629,39
2021-12-21,Humboldt,023,135768,10149,9989,756,10745,118
2021-12-21,Imperial,025,180216,37204,36580,4363,40943,792
2021-12-21,Inyo,027,18085,2655,2627,43,2670,47
2021-12-21,Kern,029,883053,135589,134321,24962,159283,1892
2021-12-21,Kings,031,150075,34303,33914,2101,36015,376
2021-12-21,Lake,033,64148,7055,7004,174,7178,116
2021-12-21,Lassen,035,31185,7109,7069,438,7507,55
2021-12-21,Los Angeles,037,10098052,1533910,1501169,60434,1561603,27220
2021-12-21,Madera,039,155013,24896,24688,2403,27091,320
2021-12-21,Marin,041,260295,19433,18828,639,19467,249
2021-12-21,Mariposa,043,17540,1506,1480,63,1543,6
2021-12-21,Mendocino,045,87422,8405,8282,701,8983,97
2021-12-21,Merced,047,269075,44397,44096,2114,46210,688
2021-12-21,Modoc,049,8938,604,595,208,803,6
2021-12-21,Mono,051,14174,2020,1979,24,2003,4
2021-12-21,Monterey,053,433212,51181,49586,3543,53129,638
2021-12-21,Napa,055,140530,13945,13703,160,13863,107
2021-12-21,Nevada,057,99092,10254,10095,361,10456,110
2021-12-21,Orange,059,3164182,326078,320705,17600,338305,5855
2021-12-21,Placer,061,380077,40245,39649,4076,43725,487
2021-12-21,Plumas,063,18699,2011,1975,52,2027,12
2021-12-21,Riverside,065,2383286,389517,382415,17314,399729,5465
2021-12-21,Sacramento,067,1510023,170446,168422,5402,173824,2419
2021-12-21,San Benito,069,59416,8033,7950,190,8140,79
2021-12-21,San Bernardino,071,2135413,379745,374219,12240,386459,6026
2021-12-21,San Diego,073,3302833,410181,402386,23775,426161,4424
2021-12-21,San Francisco,075,870044,60334,56950,2770,59720,681
2021-12-21,San Joaquin,077,732212,105391,104238,5847,110085,1870
2021-12-21,San Luis Obispo,079,281455,31712,31103,1412,32515,365
2021-12-21,San Mateo,081,765935,59087,56381,1103,57484,581
2021-12-21,Santa Barbara,083,443738,47863,47194,1759,48953,564
2021-12-21,Santa Clara,085,1922200,159175,155769,1904,157673,1951
2021-12-21,Santa Cruz,087,273765,22453,22028,1085,23113,228
2021-12-21,Shasta,089,179085,23099,22920,3788,26708,429
2021-12-21,Sierra,091,2930,207,201,21,222,0
2021-12-21,Siskiyou,093,43540,3511,3455,1399,4854,59
2021-12-21,Solano,095,438530,48406,47474,1428,48902,372
2021-12-21,Sonoma,097,501317,44850,44051,624,44675,408
2021-12-21,Stanislaus,099,539301,83026,83167,9534,92701,1331
2021-12-21,Sutter,101,95872,14621,14492,418,14910,190
2021-12-21,Tehama,103,63373,8953,8849,1574,10423,136
2021-12-21,Trinity,105,12862,913,826,227,1053,17
2021-12-21,Tulare,107,460477,72358,71166,16944,88110,1137
2021-12-21,Tuolumne,109,53932,7936,7893,116,8009,91
2021-12-21,Ventura,111,848112,104655,102631,4761,107392,1205
2021-12-21,Yolo,113,214977,21333,20944,1388,22332,267
2021-12-21,Yuba,115,75493,10771,10668,419,11087,98
2021-12-20,Alameda,001,1643700,128309,125762,3204,128966,1515
2021-12-20,Alpine,003,1148,110,112,0,112,0
2021-12-20,Amador,005,37829,5876,5838,77,5915,70
2021-12-20,Butte,007,227075,22262,22030,4000,26030,329
2021-12-20,Calaveras,009,45235,4606,4569,67,4636,91
2021-12-20,Colusa,011,21464,2660,2644,702,3346,21
2021-12-20,Contra Costa,013,1133247,105629,104051,2495,106546,1068
2021-12-20,Del Norte,015,27424,3827,3792,57,3849,43
2021-12-20,El Dorado,017,186661,17371,17083,1832,18915,172
2021-12-20,Fresno,019,978130,149012,147605,13065,160670,2341
2021-12-20,Glenn,021,27897,3639,3597,1027,4624,39
2021-12-20,Humboldt,023,135768,10106,9973,753,10726,118
2021-12-20,Imperial,025,180216,37088,36532,4332,40864,792
2021-12-20,Inyo,027,18085,2652,2615,43,2658,47
2021-12-20,Kern,029,883053,135391,134203,24902,159105,1883
2021-12-20,Kings,031,150075,34261,33898,2100,35998,376
2021-12-20,Lake,033,64148,7050,6999,174,7173,116
2021-12-20,Lassen,035,31185,7107,7065,437,7502,55
2021-12-20,Los Angeles,037,10098052,1522448,1495251,59706,1554957,27188
2021-12-20,Madera,039,155013,24867,24668,2399,27067,313
2021-12-20,Marin,041,260295,19219,18747,621,19368,249
2021-12-20,Mariposa,043,17540,1497,1479,63,1542,6
2021-12-20,Mendocino,045,87422,8393,8264,699,8963,96
2021-12-20,Merced,047,269075,44340,44071,2109,46180,687
2021-12-20,Modoc,049,8938,604,595,205,800,6
2021-12-20,Mono,051,14174,1998,1973,24,1997,4
2021-12-20,Monterey,053,433212,51086,49556,3525,53081,636
2021-12-20,Napa,055,140530,13861,13672,150,13822,107
2021-12-20,Nevada,057,99092,10214,10079,360,10439,109
2021-12-20,Orange,059,3164182,324483,320235,17279,337514,5852
2021-12-20,Placer,061,380077,40117,39579,4046,43625,485
2021-12-20,Plumas,063,18699,2009,1971,51,2022,12
2021-12-20,Riverside,065,2383286,388075,381841,17222,399063,5452
2021-12-20,Sacramento,067,1510023,169880,168153,5359,173512,2414
2021-12-20,San Benito,069,59416,7991,7934,188,8122,79
2021-12-20,San Bernardino,071,2135413,378295,373881,12156,386037,6023
2021-12-20,San Diego,073,3302833,406951,401483,23537,425020,4412
2021-12-20,San Francisco,075,870044,59273,56661,2708,59369,681
2021-12-20,San Joaquin,077,732212,105147,104188,5838,110026,1865
2021-12-20,San Luis Obispo,079,281455,31598,31075,1404,32479,365
2021-12-20,San Mateo,081,765935,58541,56247,1084,57331,581
2021-12-20,Santa Barbara,083,443738,47654,47131,1754,48885,562
2021-12-20,Santa Clara,085,1922200,158217,155427,1856,157283,1950
2021-12-20,Santa Cruz,087,273765,22372,21989,1080,23069,227
2021-12-20,Shasta,089,179085,23079,22888,3783,26671,429
2021-12-20,Sierra,091,2930,206,201,21,222,0
2021-12-20,Siskiyou,093,43540,3510,3453,1397,4850,59
2021-12-20,Solano,095,438530,48276,47394,1420,48814,370
2021-12-20,Sonoma,097,501317,44660,43982,616,44598,408
2021-12-20,Stanislaus,099,539301,82902,83110,9507,92617,1331
2021-12-20,Sutter,101,95872,14599,14480,418,14898,190
2021-12-20,Tehama,103,63373,8945,8840,1571,10411,136
2021-12-20,Trinity,105,12862,913,826,227,1053,17
2021-12-20,Tulare,107,460477,72265,71124,16879,88003,1129
2021-12-20,Tuolumne,109,53932,7922,7867,112,7979,91
2021-12-20,Ventura,111,848112,104149,102452,4683,107135,1203
2021-12-20,Yolo,113,214977,21240,20903,1376,22279,267
2021-12-20,Yuba,115,75493,10755,10656,416,11072,97
2021-12-19,Alameda,001,1643700,127435,125464,3157,128621,1519
2021-12-19,Alpine,003,1148,110,112,0,112,0
2021-12-19,Amador,005,37829,5864,5832,76,5908,70
2021-12-19,Butte,007,227075,22210,22022,3994,26016,329
2021-12-19,Calaveras,009,45235,4590,4563,66,4629,91
2021-12-19,Colusa,011,21464,2660,2643,699,3342,21
2021-12-19,Contra Costa,013,1133247,105132,103906,2460,106366,1068
2021-12-19,Del Norte,015,27424,3823,3797,57,3854,43
2021-12-19,El Dorado,017,186661,17315,17067,1830,18897,172
2021-12-19,Fresno,019,978130,148772,147505,13043,160548,2341
2021-12-19,Glenn,021,27897,3635,3596,1026,4622,39
2021-12-19,Humboldt,023,135768,10066,9957,748,10705,118
2021-12-19,Imperial,025,180216,36960,36501,4286,40787,792
2021-12-19,Inyo,027,18085,2643,2613,43,2656,47
2021-12-19,Kern,029,883053,135195,134136,24831,158967,1883
2021-12-19,Kings,031,150075,34201,33874,2096,35970,378
2021-12-19,Lake,033,64148,7041,6999,171,7170,116
2021-12-19,Lassen,035,31185,7103,7065,437,7502,55
2021-12-19,Los Angeles,037,10098052,1513495,1495082,59096,1554178,27189
2021-12-19,Madera,039,155013,24842,24642,2393,27035,313
2021-12-19,Marin,041,260295,19043,18707,598,19305,249
2021-12-19,Mariposa,043,17540,1491,1475,63,1538,6
2021-12-19,Mendocino,045,87422,8376,8257,696,8953,96
2021-12-19,Merced,047,269075,44245,44045,2101,46146,687
2021-12-19,Modoc,049,8938,603,595,205,800,6
2021-12-19,Mono,051,14174,1987,1968,23,1991,4
2021-12-19,Monterey,053,433212,50986,49516,3503,53019,636
2021-12-19,Napa,055,140530,13788,13659,141,13800,107
2021-12-19,Nevada,057,99092,10178,10057,357,10414,109
2021-12-19,Orange,059,3164182,323097,319615,17050,336665,5852
2021-12-19,Placer,061,380077,39998,39525,4030,43555,485
2021-12-19,Plumas,063,18699,2006,1971,51,2022,12
2021-12-19,Riverside,065,2383286,386648,381305,17145,398450,5452
2021-12-19,Sacramento,067,1510023,169386,167933,5330,173263,2415
2021-12-19,San Benito,069,59416,7965,7929,187,8116,79
2021-12-19,San Bernardino,071,2135413,377017,373480,12115,385595,6023
2021-12-19,San Diego,073,3302833,404445,398197,23340,421537,4406
2021-12-19,San Francisco,075,870044,58400,56358,2652,59010,681
2021-12-19,San Joaquin,077,732212,104890,104125,5824,109949,1865
2021-12-19,San Luis Obispo,079,281455,31474,31035,1392,32427,366
2021-12-19,San Mateo,081,765935,58077,56132,1069,57201,581
2021-12-19,Santa Barbara,083,443738,47432,47070,1747,48817,562
2021-12-19,Santa Clara,085,1922200,157324,155049,1828,156877,1950
2021-12-19,Santa Cruz,087,273765,22272,21960,1075,23035,227
2021-12-19,Shasta,089,179085,23043,22875,3779,26654,429
2021-12-19,Sierra,091,2930,205,201,21,222,0
2021-12-19,Siskiyou,093,43540,3507,3452,1397,4849,59
2021-12-19,Solano,095,438530,48157,47341,1414,48755,370
2021-12-19,Sonoma,097,501317,44478,43944,614,44558,408
2021-12-19,Stanislaus,099,539301,82764,83040,9476,92516,1331
2021-12-19,Sutter,101,95872,14560,14475,417,14892,190
2021-12-19,Tehama,103,63373,8937,8840,1571,10411,136
2021-12-19,Trinity,105,12862,913,826,227,1053,17
2021-12-19,Tulare,107,460477,72169,71085,16838,87923,1129
2021-12-19,Tuolumne,109,53932,7905,7865,111,7976,91
2021-12-19,Ventura,111,848112,103569,102170,4618,106788,1203
2021-12-19,Yolo,113,214977,21161,20887,1357,22244,267
2021-12-19,Yuba,115,75493,10738,10646,414,11060,97
2021-12-18,Alameda,001,1643700,127030,124583,3132,127715,1512
2021-12-18,Alpine,003,1148,110,110,0,110,0
2021-12-18,Amador,005,37829,5858,5821,76,5897,69
2021-12-18,Butte,007,227075,22193,21956,3989,25945,328
2021-12-18,Calaveras,009,45235,4583,4534,66,4600,91
2021-12-18,Colusa,011,21464,2658,2635,697,3332,21
2021-12-18,Contra Costa,013,1133247,104918,103380,2446,105826,1065
2021-12-18,Del Norte,015,27424,3820,3791,57,3848,43
2021-12-18,El Dorado,017,186661,17287,16968,1827,18795,171
2021-12-18,Fresno,019,978130,148669,147038,13031,160069,2335
2021-12-18,Glenn,021,27897,3632,3590,1026,4616,39
2021-12-18,Humboldt,023,135768,10050,9889,748,10637,118
2021-12-18,Imperial,025,180216,36888,36280,4274,40554,790
2021-12-18,Inyo,027,18085,2637,2607,43,2650,47
2021-12-18,Kern,029,883053,135105,133754,24784,158538,1873
2021-12-18,Kings,031,150075,34169,33783,2092,35875,374
2021-12-18,Lake,033,64148,7040,6976,171,7147,115
2021-12-18,Lassen,035,31185,7101,7061,436,7497,55
2021-12-18,Los Angeles,037,10098052,1509417,1484840,58779,1543619,27135
2021-12-18,Madera,039,155013,24827,24575,2391,26966,313
2021-12-18,Marin,041,260295,18944,18537,586,19123,249
2021-12-18,Mariposa,043,17540,1490,1468,63,1531,6
2021-12-18,Mendocino,045,87422,8370,8219,696,8915,95
2021-12-18,Merced,047,269075,44211,43929,2100,46029,686
2021-12-18,Modoc,049,8938,601,595,205,800,6
2021-12-18,Mono,051,14174,1985,1956,23,1979,4
2021-12-18,Monterey,053,433212,50929,49343,3498,52841,635
2021-12-18,Napa,055,140530,13762,13581,139,13720,107
2021-12-18,Nevada,057,99092,10156,9991,355,10346,108
2021-12-18,Orange,059,3164182,322436,318149,16911,335060,5844
2021-12-18,Placer,061,380077,39896,39336,4016,43352,485
2021-12-18,Plumas,063,18699,2006,1964,51,2015,13
2021-12-18,Riverside,065,2383286,385956,379354,17103,396457,5439
2021-12-18,Sacramento,067,1510023,169149,167046,5309,172355,2404
2021-12-18,San Benito,069,59416,7950,7894,187,8081,79
2021-12-18,San Bernardino,071,2135413,376370,371658,12087,383745,6017
2021-12-18,San Diego,073,3302833,403495,397130,23287,420417,4399
2021-12-18,San Francisco,075,870044,57903,55562,2621,58183,679
2021-12-18,San Joaquin,077,732212,104802,103698,5814,109512,1858
2021-12-18,San Luis Obispo,079,281455,31431,30873,1386,32259,365
2021-12-18,San Mateo,081,765935,57838,55730,1064,56794,580
2021-12-18,Santa Barbara,083,443738,47336,46776,1745,48521,562
2021-12-18,Santa Clara,085,1922200,156874,154243,1815,156058,1946
2021-12-18,Santa Cruz,087,273765,22220,21805,1073,22878,225
2021-12-18,Shasta,089,179085,23022,22811,3779,26590,429
2021-12-18,Sierra,091,2930,205,199,21,220,0
2021-12-18,Siskiyou,093,43540,3505,3441,1396,4837,58
2021-12-18,Solano,095,438530,48111,47174,1412,48586,369
2021-12-18,Sonoma,097,501317,44367,43658,610,44268,407
2021-12-18,Stanislaus,099,539301,82682,82736,9465,92201,1330
2021-12-18,Sutter,101,95872,14542,14435,417,14852,190
2021-12-18,Tehama,103,63373,8931,8814,1570,10384,136
2021-12-18,Trinity,105,12862,913,823,227,1050,17
2021-12-18,Tulare,107,460477,72131,70922,16813,87735,1120
2021-12-18,Tuolumne,109,53932,7891,7834,111,7945,91
2021-12-18,Ventura,111,848112,103284,101612,4594,106206,1201
2021-12-18,Yolo,113,214977,21121,20793,1351,22144,267
2021-12-18,Yuba,115,75493,10725,10599,414,11013,96
2021-12-17,Alameda,001,1643700,126696,124583,3112,127695,1512
2021-12-17,Alpine,003,1148,110,110,0,110,0
2021-12-17,Amador,005,37829,5851,5821,76,5897,69
2021-12-17,Butte,007,227075,22173,21956,3983,25939,328
2021-12-17,Calaveras,009,45235,4579,4534,66,4600,91
2021-12-17,Colusa,011,21464,2657,2635,696,3331,21
2021-12-17,Contra Costa,013,1133247,104714,103380,2442,105822,1065
2021-12-17,Del Norte,015,27424,3819,3791,57,3848,43
2021-12-17,El Dorado,017,186661,17258,16968,1824,18792,171
2021-12-17,Fresno,019,978130,148564,147038,13031,160069,2335
2021-12-17,Glenn,021,27897,3625,3590,1026,4616,39
2021-12-17,Humboldt,023,135768,10031,9889,746,10635,118
2021-12-17,Imperial,025,180216,36826,36280,4256,40536,790
2021-12-17,Inyo,027,18085,2632,2607,43,2650,47
2021-12-17,Kern,029,883053,135015,133754,24742,158496,1873
2021-12-17,Kings,031,150075,34150,33783,2092,35875,374
2021-12-17,Lake,033,64148,7036,6976,171,7147,115
2021-12-17,Lassen,035,31185,7101,7061,435,7496,55
2021-12-17,Los Angeles,037,10098052,1505474,1484840,58533,1543373,27135
2021-12-17,Madera,039,155013,24811,24575,2386,26961,313
2021-12-17,Marin,041,260295,18868,18537,582,19119,249
2021-12-17,Mariposa,043,17540,1486,1468,63,1531,6
2021-12-17,Mendocino,045,87422,8359,8219,696,8915,95
2021-12-17,Merced,047,269075,44184,43929,2099,46028,686
2021-12-17,Modoc,049,8938,601,595,205,800,6
2021-12-17,Mono,051,14174,1982,1956,23,1979,4
2021-12-17,Monterey,053,433212,50872,49343,3493,52836,635
2021-12-17,Napa,055,140530,13735,13581,138,13719,107
2021-12-17,Nevada,057,99092,10145,9991,355,10346,108
2021-12-17,Orange,059,3164182,321878,318149,16843,334992,5844
2021-12-17,Placer,061,380077,39842,39336,4010,43346,485
2021-12-17,Plumas,063,18699,2005,1964,51,2015,13
2021-12-17,Riverside,065,2383286,385310,379354,17092,396446,5439
2021-12-17,Sacramento,067,1510023,168921,167046,5296,172342,2404
2021-12-17,San Benito,069,59416,7948,7894,187,8081,79
2021-12-17,San Bernardino,071,2135413,375832,371658,12070,383728,6017
2021-12-17,San Diego,073,3302833,402558,397130,23239,420369,4399
2021-12-17,San Francisco,075,870044,57576,55562,2591,58153,679
2021-12-17,San Joaquin,077,732212,104728,103698,5796,109494,1858
2021-12-17,San Luis Obispo,079,281455,31403,30873,1382,32255,365
2021-12-17,San Mateo,081,765935,57649,55730,1057,56787,580
2021-12-17,Santa Barbara,083,443738,47259,46776,1739,48515,562
2021-12-17,Santa Clara,085,1922200,156500,154243,1800,156043,1946
2021-12-17,Santa Cruz,087,273765,22174,21805,1070,22875,225
2021-12-17,Shasta,089,179085,23009,22811,3777,26588,429
2021-12-17,Sierra,091,2930,204,199,21,220,0
2021-12-17,Siskiyou,093,43540,3501,3441,1394,4835,58
2021-12-17,Solano,095,438530,48043,47174,1408,48582,369
2021-12-17,Sonoma,097,501317,44272,43658,607,44265,407
2021-12-17,Stanislaus,099,539301,82631,82736,9459,92195,1330
2021-12-17,Sutter,101,95872,14531,14435,415,14850,190
2021-12-17,Tehama,103,63373,8924,8814,1569,10383,136
2021-12-17,Trinity,105,12862,913,823,227,1050,17
2021-12-17,Tulare,107,460477,72089,70922,16782,87704,1120
2021-12-17,Tuolumne,109,53932,7879,7834,111,7945,91
2021-12-17,Ventura,111,848112,103034,101612,4582,106194,1201
2021-12-17,Yolo,113,214977,21088,20793,1346,22139,267
2021-12-17,Yuba,115,75493,10713,10599,411,11010,96
2021-12-16,Alameda,001,1643700,126323,124583,3099,127682,1512
2021-12-16,Alpine,003,1148,108,110,0,110,0
2021-12-16,Amador,005,37829,5843,5821,76,5897,69
2021-12-16,Butte,007,227075,22154,21956,3980,25936,328
2021-12-16,Calaveras,009,45235,4571,4534,66,4600,91
2021-12-16,Colusa,011,21464,2657,2635,696,3331,21
2021-12-16,Contra Costa,013,1133247,104492,103380,2429,105809,1065
2021-12-16,Del Norte,015,27424,3816,3791,57,3848,43
2021-12-16,El Dorado,017,186661,17222,16968,1819,18787,171
2021-12-16,Fresno,019,978130,148407,147038,13025,160063,2335
2021-12-16,Glenn,021,27897,3624,3590,1026,4616,39
2021-12-16,Humboldt,023,135768,10007,9889,737,10626,118
2021-12-16,Imperial,025,180216,36741,36280,4225,40505,790
2021-12-16,Inyo,027,18085,2628,2607,42,2649,47
2021-12-16,Kern,029,883053,134873,133754,24691,158445,1873
2021-12-16,Kings,031,150075,34126,33783,2091,35874,374
2021-12-16,Lake,033,64148,7032,6976,171,7147,115
2021-12-16,Lassen,035,31185,7098,7061,434,7495,55
2021-12-16,Los Angeles,037,10098052,1501266,1484840,58262,1543102,27135
2021-12-16,Madera,039,155013,24781,24575,2382,26957,313
2021-12-16,Marin,041,260295,18821,18537,574,19111,249
2021-12-16,Mariposa,043,17540,1484,1468,63,1531,6
2021-12-16,Mendocino,045,87422,8348,8219,693,8912,95
2021-12-16,Merced,047,269075,44145,43929,2099,46028,686
2021-12-16,Modoc,049,8938,601,595,205,800,6
2021-12-16,Mono,051,14174,1979,1956,23,1979,4
2021-12-16,Monterey,053,433212,50801,49343,3476,52819,635
2021-12-16,Napa,055,140530,13703,13581,138,13719,107
2021-12-16,Nevada,057,99092,10119,9991,355,10346,108
2021-12-16,Orange,059,3164182,321275,318149,16763,334912,5844
2021-12-16,Placer,061,380077,39765,39336,4005,43341,485
2021-12-16,Plumas,063,18699,2005,1964,51,2015,13
2021-12-16,Riverside,065,2383286,384510,379354,17078,396432,5439
2021-12-16,Sacramento,067,1510023,168635,167046,5271,172317,2404
2021-12-16,San Benito,069,59416,7941,7894,187,8081,79
2021-12-16,San Bernardino,071,2135413,375189,371658,12052,383710,6017
2021-12-16,San Diego,073,3302833,401375,397130,23175,420305,4399
2021-12-16,San Francisco,075,870044,57200,55562,2568,58130,679
2021-12-16,San Joaquin,077,732212,104607,103698,5789,109487,1858
2021-12-16,San Luis Obispo,079,281455,31334,30873,1376,32249,365
2021-12-16,San Mateo,081,765935,57448,55730,1054,56784,580
2021-12-16,Santa Barbara,083,443738,47137,46776,1735,48511,562
2021-12-16,Santa Clara,085,1922200,156172,154243,1790,156033,1946
2021-12-16,Santa Cruz,087,273765,22127,21805,1069,22874,225
2021-12-16,Shasta,089,179085,22979,22811,3775,26586,429
2021-12-16,Sierra,091,2930,204,199,21,220,0
2021-12-16,Siskiyou,093,43540,3500,3441,1390,4831,58
2021-12-16,Solano,095,438530,47975,47174,1401,48575,369
2021-12-16,Sonoma,097,501317,44174,43658,605,44263,407
2021-12-16,Stanislaus,099,539301,82544,82736,9445,92181,1330
2021-12-16,Sutter,101,95872,14518,14435,414,14849,190
2021-12-16,Tehama,103,63373,8917,8814,1568,10382,136
2021-12-16,Trinity,105,12862,913,823,227,1050,17
2021-12-16,Tulare,107,460477,72040,70922,16755,87677,1120
2021-12-16,Tuolumne,109,53932,7860,7834,111,7945,91
2021-12-16,Ventura,111,848112,102766,101612,4575,106187,1201
2021-12-16,Yolo,113,214977,21038,20793,1341,22134,267
2021-12-16,Yuba,115,75493,10698,10599,410,11009,96
2021-12-15,Alameda,001,1643700,126000,124342,3087,127429,1509
2021-12-15,Alpine,003,1148,108,109,0,109,0
2021-12-15,Amador,005,37829,5837,5810,76,5886,69
2021-12-15,Butte,007,227075,22135,21922,3979,25901,327
2021-12-15,Calaveras,009,45235,4565,4523,66,4589,89
2021-12-15,Colusa,011,21464,2656,2632,695,3327,21
2021-12-15,Contra Costa,013,1133247,104268,103236,2426,105662,1064
2021-12-15,Del Norte,015,27424,3815,3789,56,3845,43
2021-12-15,El Dorado,017,186661,17188,16936,1813,18749,171
2021-12-15,Fresno,019,978130,148278,146859,13014,159873,2319
2021-12-15,Glenn,021,27897,3624,3589,1026,4615,39
2021-12-15,Humboldt,023,135768,9987,9854,736,10590,118
2021-12-15,Imperial,025,180216,36663,36187,4181,40368,789
2021-12-15,Inyo,027,18085,2623,2606,42,2648,47
2021-12-15,Kern,029,883053,134733,133590,24644,158234,1866
2021-12-15,Kings,031,150075,34097,33716,2087,35803,374
2021-12-15,Lake,033,64148,7023,6968,170,7138,115
2021-12-15,Lassen,035,31185,7098,7062,434,7496,55
2021-12-15,Los Angeles,037,10098052,1497378,1482735,58068,1540803,27116
2021-12-15,Madera,039,155013,24763,24549,2376,26925,313
2021-12-15,Marin,041,260295,18763,18514,569,19083,249
2021-12-15,Mariposa,043,17540,1481,1463,63,1526,6
2021-12-15,Mendocino,045,87422,8343,8209,690,8899,95
2021-12-15,Merced,047,269075,44103,43890,2087,45977,685
2021-12-15,Modoc,049,8938,601,595,205,800,6
2021-12-15,Mono,051,14174,1975,1955,23,1978,4
2021-12-15,Monterey,053,433212,50746,49279,3456,52735,635
2021-12-15,Napa,055,140530,13674,13557,136,13693,107
2021-12-15,Nevada,057,99092,10098,9958,355,10313,107
2021-12-15,Orange,059,3164182,320699,317808,16721,334529,5838
2021-12-15,Placer,061,380077,39710,39264,3995,43259,485
2021-12-15,Plumas,063,18699,2001,1957,51,2008,12
2021-12-15,Riverside,065,2383286,383794,378769,17067,395836,5438
2021-12-15,Sacramento,067,1510023,168326,166793,5249,172042,2401
2021-12-15,San Benito,069,59416,7926,7877,187,8064,79
2021-12-15,San Bernardino,071,2135413,374657,371122,12020,383142,6013
2021-12-15,San Diego,073,3302833,400186,396546,23106,419652,4395
2021-12-15,San Francisco,075,870044,56882,55414,2550,57964,679
2021-12-15,San Joaquin,077,732212,104449,103579,5779,109358,1853
2021-12-15,San Luis Obispo,079,281455,31286,30784,1369,32153,365
2021-12-15,San Mateo,081,765935,57308,55657,1043,56700,580
2021-12-15,Santa Barbara,083,443738,47056,46681,1733,48414,562
2021-12-15,Santa Clara,085,1922200,155847,153928,1769,155697,1944
2021-12-15,Santa Cruz,087,273765,22087,21753,1062,22815,225
2021-12-15,Shasta,089,179085,22964,22778,3771,26549,427
2021-12-15,Sierra,091,2930,204,199,21,220,0
2021-12-15,Siskiyou,093,43540,3499,3434,1389,4823,58
2021-12-15,Solano,095,438530,47894,47098,1394,48492,367
2021-12-15,Sonoma,097,501317,44091,43580,600,44180,407
2021-12-15,Stanislaus,099,539301,82437,82628,9437,92065,1298
2021-12-15,Sutter,101,95872,14498,14428,413,14841,189
2021-12-15,Tehama,103,63373,8910,8806,1567,10373,136
2021-12-15,Trinity,105,12862,912,822,227,1049,17
2021-12-15,Tulare,107,460477,71987,70846,16724,87570,1120
2021-12-15,Tuolumne,109,53932,7851,7818,110,7928,91
2021-12-15,Ventura,111,848112,102551,101447,4569,106016,1199
2021-12-15,Yolo,113,214977,21009,20749,1336,22085,267
2021-12-15,Yuba,115,75493,10687,10587,409,10996,96
2021-12-14,Alameda,001,1643700,125680,124272,3078,127350,1506
2021-12-14,Alpine,003,1148,107,109,0,109,0
2021-12-14,Amador,005,37829,5831,5808,75,5883,69
2021-12-14,Butte,007,227075,22102,21901,3977,25878,326
2021-12-14,Calaveras,009,45235,4553,4517,66,4583,89
2021-12-14,Colusa,011,21464,2654,2628,695,3323,21
2021-12-14,Contra Costa,013,1133247,104083,103135,2422,105557,1064
2021-12-14,Del Norte,015,27424,3812,3788,56,3844,43
2021-12-14,El Dorado,017,186661,17154,16915,1811,18726,170
2021-12-14,Fresno,019,978130,148111,146756,13011,159767,2316
2021-12-14,Glenn,021,27897,3623,3589,1026,4615,39
2021-12-14,Humboldt,023,135768,9975,9836,728,10564,118
2021-12-14,Imperial,025,180216,36591,36049,4138,40187,789
2021-12-14,Inyo,027,18085,2623,2601,42,2643,46
2021-12-14,Kern,029,883053,134597,133498,24596,158094,1863
2021-12-14,Kings,031,150075,34060,33693,2084,35777,373
2021-12-14,Lake,033,64148,7013,6961,170,7131,115
2021-12-14,Lassen,035,31185,7097,7061,434,7495,55
2021-12-14,Los Angeles,037,10098052,1493738,1481131,57885,1539016,27099
2021-12-14,Madera,039,155013,24737,24535,2368,26903,313
2021-12-14,Marin,041,260295,18715,18491,567,19058,249
2021-12-14,Mariposa,043,17540,1478,1463,62,1525,6
2021-12-14,Mendocino,045,87422,8315,8206,688,8894,95
2021-12-14,Merced,047,269075,44057,43870,2085,45955,684
2021-12-14,Modoc,049,8938,600,595,205,800,6
2021-12-14,Mono,051,14174,1968,1955,23,1978,4
2021-12-14,Monterey,053,433212,50662,49237,3445,52682,635
2021-12-14,Napa,055,140530,13645,13528,136,13664,107
2021-12-14,Nevada,057,99092,10072,9956,354,10310,106
2021-12-14,Orange,059,3164182,320148,317465,16667,334132,5827
2021-12-14,Placer,061,380077,39633,39221,3990,43211,482
2021-12-14,Plumas,063,18699,1997,1950,49,1999,12
2021-12-14,Riverside,065,2383286,383123,378227,17050,395277,5427
2021-12-14,Sacramento,067,1510023,168016,166605,5226,171831,2394
2021-12-14,San Benito,069,59416,7908,7871,187,8058,79
2021-12-14,San Bernardino,071,2135413,374045,370604,11990,382594,6013
2021-12-14,San Diego,073,3302833,399047,395876,23056,418932,4393
2021-12-14,San Francisco,075,870044,56569,55278,2538,57816,679
2021-12-14,San Joaquin,077,732212,104304,103488,5761,109249,1848
2021-12-14,San Luis Obispo,079,281455,31227,30753,1365,32118,363
2021-12-14,San Mateo,081,765935,57143,55601,1036,56637,580
2021-12-14,Santa Barbara,083,443738,46957,46648,1728,48376,560
2021-12-14,Santa Clara,085,1922200,155521,153814,1756,155570,1945
2021-12-14,Santa Cruz,087,273765,22021,21737,1057,22794,225
2021-12-14,Shasta,089,179085,22937,22756,3770,26526,427
2021-12-14,Sierra,091,2930,202,199,21,220,0
2021-12-14,Siskiyou,093,43540,3494,3430,1388,4818,58
2021-12-14,Solano,095,438530,47846,47065,1388,48453,367
2021-12-14,Sonoma,097,501317,44009,43538,598,44136,407
2021-12-14,Stanislaus,099,539301,82351,82581,9423,92004,1293
2021-12-14,Sutter,101,95872,14486,14421,412,14833,189
2021-12-14,Tehama,103,63373,8906,8805,1567,10372,134
2021-12-14,Trinity,105,12862,912,821,227,1048,17
2021-12-14,Tulare,107,460477,71915,70803,16693,87496,1120
2021-12-14,Tuolumne,109,53932,7838,7815,110,7925,91
2021-12-14,Ventura,111,848112,102327,101343,4562,105905,1199
2021-12-14,Yolo,113,214977,20974,20734,1322,22056,267
2021-12-14,Yuba,115,75493,10670,10574,409,10983,92
2021-12-13,Alameda,001,1643700,125398,124174,3062,127236,1501
2021-12-13,Alpine,003,1148,107,109,0,109,0
2021-12-13,Amador,005,37829,5827,5797,75,5872,69
2021-12-13,Butte,007,227075,22079,21889,3973,25862,326
2021-12-13,Calaveras,009,45235,4546,4507,65,4572,89
2021-12-13,Colusa,011,21464,2652,2627,695,3322,21
2021-12-13,Contra Costa,013,1133247,103932,103041,2411,105452,1064
2021-12-13,Del Norte,015,27424,3808,3787,56,3843,42
2021-12-13,El Dorado,017,186661,17131,16896,1809,18705,170
2021-12-13,Fresno,019,978130,147962,146641,13001,159642,2312
2021-12-13,Glenn,021,27897,3618,3589,1024,4613,37
2021-12-13,Humboldt,023,135768,9946,9821,724,10545,118
2021-12-13,Imperial,025,180216,36507,35974,4116,40090,787
2021-12-13,Inyo,027,18085,2622,2592,42,2634,46
2021-12-13,Kern,029,883053,134470,133381,24543,157924,1863
2021-12-13,Kings,031,150075,34017,33680,2079,35759,372
2021-12-13,Lake,033,64148,7011,6958,168,7126,115
2021-12-13,Lassen,035,31185,7096,7057,434,7491,55
2021-12-13,Los Angeles,037,10098052,1490958,1480195,57718,1537913,27085
2021-12-13,Madera,039,155013,24709,24527,2363,26890,311
2021-12-13,Marin,041,260295,18655,18471,564,19035,249
2021-12-13,Mariposa,043,17540,1476,1462,62,1524,6
2021-12-13,Mendocino,045,87422,8302,8196,686,8882,95
2021-12-13,Merced,047,269075,44018,43848,2081,45929,682
2021-12-13,Modoc,049,8938,599,595,205,800,6
2021-12-13,Mono,051,14174,1961,1952,23,1975,4
2021-12-13,Monterey,053,433212,50609,49222,3427,52649,631
2021-12-13,Napa,055,140530,13632,13518,136,13654,107
2021-12-13,Nevada,057,99092,10053,9946,353,10299,106
2021-12-13,Orange,059,3164182,319683,317112,16613,333725,5824
2021-12-13,Placer,061,380077,39572,39168,3979,43147,481
2021-12-13,Plumas,063,18699,1993,1943,49,1992,12
2021-12-13,Riverside,065,2383286,382543,377728,17035,394763,5414
2021-12-13,Sacramento,067,1510023,167737,166439,5192,171631,2392
2021-12-13,San Benito,069,59416,7899,7856,187,8043,79
2021-12-13,San Bernardino,071,2135413,373480,370274,11984,382258,6011
2021-12-13,San Diego,073,3302833,398238,395266,23004,418270,4389
2021-12-13,San Francisco,075,870044,56298,55245,2525,57770,678
2021-12-13,San Joaquin,077,732212,104188,103449,5752,109201,1846
2021-12-13,San Luis Obispo,079,281455,31178,30746,1361,32107,363
2021-12-13,San Mateo,081,765935,56983,55569,1027,56596,580
2021-12-13,Santa Barbara,083,443738,46870,46608,1723,48331,560
2021-12-13,Santa Clara,085,1922200,155256,153672,1745,155417,1944
2021-12-13,Santa Cruz,087,273765,21966,21698,1054,22752,225
2021-12-13,Shasta,089,179085,22916,22731,3768,26499,426
2021-12-13,Sierra,091,2930,202,199,21,220,0
2021-12-13,Siskiyou,093,43540,3490,3426,1385,4811,57
2021-12-13,Solano,095,438530,47772,47045,1383,48428,365
2021-12-13,Sonoma,097,501317,43913,43492,596,44088,407
2021-12-13,Stanislaus,099,539301,82237,82507,9403,91910,1282
2021-12-13,Sutter,101,95872,14479,14408,412,14820,188
2021-12-13,Tehama,103,63373,8893,8800,1567,10367,134
2021-12-13,Trinity,105,12862,912,820,227,1047,17
2021-12-13,Tulare,107,460477,71858,70758,16669,87427,1114
2021-12-13,Tuolumne,109,53932,7827,7804,110,7914,91
2021-12-13,Ventura,111,848112,102103,101180,4551,105731,1197
2021-12-13,Yolo,113,214977,20926,20706,1316,22022,267
2021-12-13,Yuba,115,75493,10653,10570,409,10979,92
2021-12-12,Alameda,001,1643700,125112,124075,3049,127124,1503
2021-12-12,Alpine,003,1148,107,109,0,109,0
2021-12-12,Amador,005,37829,5820,5797,74,5871,69
2021-12-12,Butte,007,227075,22054,21874,3970,25844,326
2021-12-12,Calaveras,009,45235,4536,4501,65,4566,89
2021-12-12,Colusa,011,21464,2647,2627,692,3319,21
2021-12-12,Contra Costa,013,1133247,103745,102976,2409,105385,1065
2021-12-12,Del Norte,015,27424,3805,3793,56,3849,42
2021-12-12,El Dorado,017,186661,17095,16890,1801,18691,170
2021-12-12,Fresno,019,978130,147800,146518,12986,159504,2310
2021-12-12,Glenn,021,27897,3615,3589,1024,4613,37
2021-12-12,Humboldt,023,135768,9921,9804,717,10521,118
2021-12-12,Imperial,025,180216,36374,35926,4082,40008,787
2021-12-12,Inyo,027,18085,2617,2592,42,2634,46
2021-12-12,Kern,029,883053,134304,133314,24502,157816,1861
2021-12-12,Kings,031,150075,33966,33661,2077,35738,372
2021-12-12,Lake,033,64148,7004,6955,166,7121,115
2021-12-12,Lassen,035,31185,7095,7057,434,7491,55
2021-12-12,Los Angeles,037,10098052,1488053,1479054,57533,1536587,27074
2021-12-12,Madera,039,155013,24679,24493,2355,26848,311
2021-12-12,Marin,041,260295,18602,18451,560,19011,249
2021-12-12,Mariposa,043,17540,1475,1461,62,1523,6
2021-12-12,Mendocino,045,87422,8289,8190,685,8875,95
2021-12-12,Merced,047,269075,43984,43821,2074,45895,682
2021-12-12,Modoc,049,8938,599,595,204,799,6
2021-12-12,Mono,051,14174,1957,1947,23,1970,4
2021-12-12,Monterey,053,433212,50556,49192,3399,52591,631
2021-12-12,Napa,055,140530,13589,13508,134,13642,107
2021-12-12,Nevada,057,99092,10026,9938,352,10290,106
2021-12-12,Orange,059,3164182,319181,316918,16549,333467,5825
2021-12-12,Placer,061,380077,39507,39139,3973,43112,481
2021-12-12,Plumas,063,18699,1989,1942,47,1989,12
2021-12-12,Riverside,065,2383286,381871,377467,17009,394476,5414
2021-12-12,Sacramento,067,1510023,167470,166291,5171,171462,2392
2021-12-12,San Benito,069,59416,7879,7853,187,8040,79
2021-12-12,San Bernardino,071,2135413,372849,369977,11959,381936,6011
2021-12-12,San Diego,073,3302833,397338,393307,22966,416273,4378
2021-12-12,San Francisco,075,870044,56044,55180,2513,57693,678
2021-12-12,San Joaquin,077,732212,104048,103405,5742,109147,1846
2021-12-12,San Luis Obispo,079,281455,31125,30719,1359,32078,363
2021-12-12,San Mateo,081,765935,56868,55505,1022,56527,580
2021-12-12,Santa Barbara,083,443738,46795,46586,1721,48307,560
2021-12-12,Santa Clara,085,1922200,154977,153452,1731,155183,1945
2021-12-12,Santa Cruz,087,273765,21917,21671,1052,22723,225
2021-12-12,Shasta,089,179085,22888,22732,3767,26499,426
2021-12-12,Sierra,091,2930,202,199,21,220,0
2021-12-12,Siskiyou,093,43540,3490,3424,1385,4809,57
2021-12-12,Solano,095,438530,47706,47021,1378,48399,365
2021-12-12,Sonoma,097,501317,43820,43424,593,44017,407
2021-12-12,Stanislaus,099,539301,82139,82460,9392,91852,1282
2021-12-12,Sutter,101,95872,14468,14396,412,14808,189
2021-12-12,Tehama,103,63373,8882,8796,1565,10361,134
2021-12-12,Trinity,105,12862,910,820,227,1047,17
2021-12-12,Tulare,107,460477,71779,70733,16627,87360,1115
2021-12-12,Tuolumne,109,53932,7810,7794,110,7904,91
2021-12-12,Ventura,111,848112,101909,101105,4537,105642,1197
2021-12-12,Yolo,113,214977,20876,20685,1305,21990,267
2021-12-12,Yuba,115,75493,10639,10565,406,10971,92
2021-12-11,Alameda,001,1643700,124977,123572,3047,126619,1496
2021-12-11,Alpine,003,1148,107,109,0,109,0
2021-12-11,Amador,005,37829,5815,5787,74,5861,69
2021-12-11,Butte,007,227075,22040,21819,3969,25788,326
2021-12-11,Calaveras,009,45235,4528,4469,64,4533,89
2021-12-11,Colusa,011,21464,2643,2619,691,3310,21
2021-12-11,Contra Costa,013,1133247,103659,102618,2407,105025,1061
2021-12-11,Del Norte,015,27424,3805,3778,56,3834,42
2021-12-11,El Dorado,017,186661,17074,16796,1800,18596,170
2021-12-11,Fresno,019,978130,147713,145988,12980,158968,2294
2021-12-11,Glenn,021,27897,3614,3585,1024,4609,37
2021-12-11,Humboldt,023,135768,9904,9721,714,10435,118
2021-12-11,Imperial,025,180216,36316,35635,4072,39707,782
2021-12-11,Inyo,027,18085,2612,2576,42,2618,46
2021-12-11,Kern,029,883053,134235,132852,24467,157319,1854
2021-12-11,Kings,031,150075,33953,33530,2075,35605,371
2021-12-11,Lake,033,64148,7003,6932,164,7096,114
2021-12-11,Lassen,035,31185,7094,7049,434,7483,55
2021-12-11,Los Angeles,037,10098052,1486837,1474030,57441,1531471,27031
2021-12-11,Madera,039,155013,24673,24417,2354,26771,311
2021-12-11,Marin,041,260295,18568,18339,557,18896,249
2021-12-11,Mariposa,043,17540,1474,1450,62,1512,6
2021-12-11,Mendocino,045,87422,8282,8130,685,8815,95
2021-12-11,Merced,047,269075,43965,43690,2073,45763,681
2021-12-11,Modoc,049,8938,599,594,204,798,6
2021-12-11,Mono,051,14174,1953,1926,23,1949,4
2021-12-11,Monterey,053,433212,50528,49008,3396,52404,631
2021-12-11,Napa,055,140530,13572,13459,134,13593,107
2021-12-11,Nevada,057,99092,10012,9880,352,10232,106
2021-12-11,Orange,059,3164182,318928,315759,16521,332280,5805
2021-12-11,Placer,061,380077,39449,38959,3966,42925,481
2021-12-11,Plumas,063,18699,1983,1934,47,1981,12
2021-12-11,Riverside,065,2383286,381454,375649,16995,392644,5408
2021-12-11,Sacramento,067,1510023,167340,165530,5161,170691,2386
2021-12-11,San Benito,069,59416,7865,7808,187,7995,79
2021-12-11,San Bernardino,071,2135413,372491,368145,11950,380095,6007
2021-12-11,San Diego,073,3302833,396914,392274,22928,415202,4374
2021-12-11,San Francisco,075,870044,55891,54869,2508,57377,678
2021-12-11,San Joaquin,077,732212,103987,103013,5738,108751,1842
2021-12-11,San Luis Obispo,079,281455,31102,30567,1355,31922,362
2021-12-11,San Mateo,081,765935,56790,55284,1020,56304,580
2021-12-11,Santa Barbara,083,443738,46761,46309,1721,48030,559
2021-12-11,Santa Clara,085,1922200,154778,152846,1719,154565,1941
2021-12-11,Santa Cruz,087,273765,21893,21557,1052,22609,225
2021-12-11,Shasta,089,179085,22873,22660,3763,26423,419
2021-12-11,Sierra,091,2930,202,199,21,220,0
2021-12-11,Siskiyou,093,43540,3484,3418,1382,4800,57
2021-12-11,Solano,095,438530,47677,46891,1373,48264,365
2021-12-11,Sonoma,097,501317,43772,43227,593,43820,407
2021-12-11,Stanislaus,099,539301,82089,82133,9383,91516,1264
2021-12-11,Sutter,101,95872,14459,14354,412,14766,187
2021-12-11,Tehama,103,63373,8879,8776,1563,10339,134
2021-12-11,Trinity,105,12862,910,819,227,1046,17
2021-12-11,Tulare,107,460477,71736,70523,16617,87140,1103
2021-12-11,Tuolumne,109,53932,7801,7760,110,7870,91
2021-12-11,Ventura,111,848112,101834,100711,4530,105241,1195
2021-12-11,Yolo,113,214977,20857,20608,1301,21909,267
2021-12-11,Yuba,115,75493,10627,10519,405,10924,92
2021-12-10,Alameda,001,1643700,124853,123572,3040,126612,1496
2021-12-10,Alpine,003,1148,106,109,0,109,0
2021-12-10,Amador,005,37829,5808,5787,74,5861,69
2021-12-10,Butte,007,227075,22027,21819,3967,25786,326
2021-12-10,Calaveras,009,45235,4525,4469,64,4533,89
2021-12-10,Colusa,011,21464,2642,2619,691,3310,21
2021-12-10,Contra Costa,013,1133247,103562,102618,2406,105024,1061
2021-12-10,Del Norte,015,27424,3805,3778,56,3834,42
2021-12-10,El Dorado,017,186661,17061,16796,1800,18596,170
2021-12-10,Fresno,019,978130,147624,145988,12974,158962,2294
2021-12-10,Glenn,021,27897,3614,3585,1024,4609,37
2021-12-10,Humboldt,023,135768,9887,9721,712,10433,118
2021-12-10,Imperial,025,180216,36260,35635,4057,39692,782
2021-12-10,Inyo,027,18085,2609,2576,42,2618,46
2021-12-10,Kern,029,883053,134147,132852,24443,157295,1854
2021-12-10,Kings,031,150075,33938,33530,2073,35603,371
2021-12-10,Lake,033,64148,6996,6932,164,7096,114
2021-12-10,Lassen,035,31185,7093,7049,434,7483,55
2021-12-10,Los Angeles,037,10098052,1485743,1474030,57353,1531383,27031
2021-12-10,Madera,039,155013,24655,24417,2352,26769,311
2021-12-10,Marin,041,260295,18546,18339,557,18896,249
2021-12-10,Mariposa,043,17540,1471,1450,62,1512,6
2021-12-10,Mendocino,045,87422,8275,8130,684,8814,95
2021-12-10,Merced,047,269075,43947,43690,2071,45761,681
2021-12-10,Modoc,049,8938,599,594,204,798,6
2021-12-10,Mono,051,14174,1950,1926,23,1949,4
2021-12-10,Monterey,053,433212,50491,49008,3390,52398,631
2021-12-10,Napa,055,140530,13560,13459,133,13592,107
2021-12-10,Nevada,057,99092,10003,9880,352,10232,106
2021-12-10,Orange,059,3164182,318657,315759,16489,332248,5805
2021-12-10,Placer,061,380077,39406,38959,3963,42922,481
2021-12-10,Plumas,063,18699,1981,1934,47,1981,12
2021-12-10,Riverside,065,2383286,381047,375649,16984,392633,5408
2021-12-10,Sacramento,067,1510023,167186,165530,5159,170689,2386
2021-12-10,San Benito,069,59416,7861,7808,187,7995,79
2021-12-10,San Bernardino,071,2135413,372117,368145,11927,380072,6007
2021-12-10,San Diego,073,3302833,396435,392274,22914,415188,4374
2021-12-10,San Francisco,075,870044,55806,54869,2502,57371,678
2021-12-10,San Joaquin,077,732212,103932,103013,5734,108747,1842
2021-12-10,San Luis Obispo,079,281455,31092,30567,1352,31919,362
2021-12-10,San Mateo,081,765935,56733,55284,1017,56301,580
2021-12-10,Santa Barbara,083,443738,46725,46309,1720,48029,559
2021-12-10,Santa Clara,085,1922200,154607,152846,1706,154552,1941
2021-12-10,Santa Cruz,087,273765,21874,21557,1051,22608,225
2021-12-10,Shasta,089,179085,22862,22660,3760,26420,419
2021-12-10,Sierra,091,2930,202,199,21,220,0
2021-12-10,Siskiyou,093,43540,3477,3418,1382,4800,57
2021-12-10,Solano,095,438530,47635,46891,1369,48260,365
2021-12-10,Sonoma,097,501317,43738,43227,592,43819,407
2021-12-10,Stanislaus,099,539301,82023,82133,9377,91510,1264
2021-12-10,Sutter,101,95872,14450,14354,412,14766,187
2021-12-10,Tehama,103,63373,8877,8776,1561,10337,134
2021-12-10,Trinity,105,12862,910,819,227,1046,17
2021-12-10,Tulare,107,460477,71707,70523,16592,87115,1103
2021-12-10,Tuolumne,109,53932,7795,7760,110,7870,91
2021-12-10,Ventura,111,848112,101730,100711,4527,105238,1195
2021-12-10,Yolo,113,214977,20843,20608,1299,21907,267
2021-12-10,Yuba,115,75493,10615,10519,404,10923,92
2021-12-09,Alameda,001,1643700,124710,123572,3035,126607,1496
2021-12-09,Alpine,003,1148,106,109,0,109,0
2021-12-09,Amador,005,37829,5805,5787,73,5860,69
2021-12-09,Butte,007,227075,22006,21819,3964,25783,326
2021-12-09,Calaveras,009,45235,4516,4469,64,4533,89
2021-12-09,Colusa,011,21464,2640,2619,691,3310,21
2021-12-09,Contra Costa,013,1133247,103442,102618,2400,105018,1061
2021-12-09,Del Norte,015,27424,3804,3778,56,3834,42
2021-12-09,El Dorado,017,186661,17033,16796,1795,18591,170
2021-12-09,Fresno,019,978130,147476,145988,12964,158952,2294
2021-12-09,Glenn,021,27897,3614,3585,1024,4609,37
2021-12-09,Humboldt,023,135768,9865,9721,711,10432,118
2021-12-09,Imperial,025,180216,36190,35635,4027,39662,782
2021-12-09,Inyo,027,18085,2607,2576,42,2618,46
2021-12-09,Kern,029,883053,134021,132852,24410,157262,1854
2021-12-09,Kings,031,150075,33912,33530,2070,35600,371
2021-12-09,Lake,033,64148,6988,6932,164,7096,114
2021-12-09,Lassen,035,31185,7091,7049,434,7483,55
2021-12-09,Los Angeles,037,10098052,1484211,1474030,57267,1531297,27031
2021-12-09,Madera,039,155013,24630,24417,2349,26766,311
2021-12-09,Marin,041,260295,18533,18339,555,18894,249
2021-12-09,Mariposa,043,17540,1470,1450,62,1512,6
2021-12-09,Mendocino,045,87422,8262,8130,684,8814,95
2021-12-09,Merced,047,269075,43908,43690,2060,45750,681
2021-12-09,Modoc,049,8938,599,594,204,798,6
2021-12-09,Mono,051,14174,1946,1926,23,1949,4
2021-12-09,Monterey,053,433212,50443,49008,3379,52387,631
2021-12-09,Napa,055,140530,13540,13459,129,13588,107
2021-12-09,Nevada,057,99092,9984,9880,352,10232,106
2021-12-09,Orange,059,3164182,318327,315759,16450,332209,5805
2021-12-09,Placer,061,380077,39363,38959,3950,42909,481
2021-12-09,Plumas,063,18699,1973,1934,47,1981,12
2021-12-09,Riverside,065,2383286,380500,375649,16968,392617,5408
2021-12-09,Sacramento,067,1510023,166968,165530,5144,170674,2386
2021-12-09,San Benito,069,59416,7849,7808,186,7994,79
2021-12-09,San Bernardino,071,2135413,371631,368145,11907,380052,6007
2021-12-09,San Diego,073,3302833,395789,392274,22884,415158,4374
2021-12-09,San Francisco,075,870044,55721,54869,2495,57364,678
2021-12-09,San Joaquin,077,732212,103839,103013,5728,108741,1842
2021-12-09,San Luis Obispo,079,281455,31064,30567,1350,31917,362
2021-12-09,San Mateo,081,765935,56645,55284,1015,56299,580
2021-12-09,Santa Barbara,083,443738,46645,46309,1713,48022,559
2021-12-09,Santa Clara,085,1922200,154392,152846,1695,154541,1941
2021-12-09,Santa Cruz,087,273765,21846,21557,1051,22608,225
2021-12-09,Shasta,089,179085,22846,22660,3759,26419,419
2021-12-09,Sierra,091,2930,202,199,21,220,0
2021-12-09,Siskiyou,093,43540,3473,3418,1381,4799,57
2021-12-09,Solano,095,438530,47598,46891,1367,48258,365
2021-12-09,Sonoma,097,501317,43681,43227,591,43818,407
2021-12-09,Stanislaus,099,539301,81953,82133,9364,91497,1264
2021-12-09,Sutter,101,95872,14435,14354,412,14766,187
2021-12-09,Tehama,103,63373,8870,8776,1560,10336,134
2021-12-09,Trinity,105,12862,910,819,227,1046,17
2021-12-09,Tulare,107,460477,71650,70523,16563,87086,1103
2021-12-09,Tuolumne,109,53932,7784,7760,110,7870,91
2021-12-09,Ventura,111,848112,101585,100711,4515,105226,1195
2021-12-09,Yolo,113,214977,20820,20608,1291,21899,267
2021-12-09,Yuba,115,75493,10607,10519,401,10920,92
2021-12-08,Alameda,001,1643700,124561,123438,3025,126463,1496
2021-12-08,Alpine,003,1148,106,108,0,108,0
2021-12-08,Amador,005,37829,5800,5781,73,5854,69
2021-12-08,Butte,007,227075,21990,21780,3961,25741,326
2021-12-08,Calaveras,009,45235,4507,4455,64,4519,89
2021-12-08,Colusa,011,21464,2637,2619,690,3309,21
2021-12-08,Contra Costa,013,1133247,103311,102506,2399,104905,1058
2021-12-08,Del Norte,015,27424,3803,3767,56,3823,42
2021-12-08,El Dorado,017,186661,17001,16757,1795,18552,170
2021-12-08,Fresno,019,978130,147320,145830,12954,158784,2293
2021-12-08,Glenn,021,27897,3614,3584,1020,4604,37
2021-12-08,Humboldt,023,135768,9843,9704,709,10413,117
2021-12-08,Imperial,025,180216,36111,35537,3996,39533,782
2021-12-08,Inyo,027,18085,2604,2570,42,2612,46
2021-12-08,Kern,029,883053,133898,132709,24362,157071,1846
2021-12-08,Kings,031,150075,33877,33468,2069,35537,371
2021-12-08,Lake,033,64148,6982,6927,163,7090,114
2021-12-08,Lassen,035,31185,7089,7041,432,7473,55
2021-12-08,Los Angeles,037,10098052,1482685,1472410,57156,1529566,27018
2021-12-08,Madera,039,155013,24609,24396,2342,26738,311
2021-12-08,Marin,041,260295,18512,18305,552,18857,249
2021-12-08,Mariposa,043,17540,1468,1447,62,1509,6
2021-12-08,Mendocino,045,87422,8249,8118,683,8801,95
2021-12-08,Merced,047,269075,43876,43631,2052,45683,680
2021-12-08,Modoc,049,8938,599,594,204,798,6
2021-12-08,Mono,051,14174,1940,1924,23,1947,4
2021-12-08,Monterey,053,433212,50378,48957,3363,52320,631
2021-12-08,Napa,055,140530,13526,13421,129,13550,107
2021-12-08,Nevada,057,99092,9968,9862,352,10214,106
2021-12-08,Orange,059,3164182,317980,315421,16412,331833,5795
2021-12-08,Placer,061,380077,39311,38934,3945,42879,478
2021-12-08,Plumas,063,18699,1971,1924,47,1971,12
2021-12-08,Riverside,065,2383286,379997,375099,16944,392043,5404
2021-12-08,Sacramento,067,1510023,166715,165278,5116,170394,2373
2021-12-08,San Benito,069,59416,7840,7793,186,7979,79
2021-12-08,San Bernardino,071,2135413,371167,367516,11882,379398,6006
2021-12-08,San Diego,073,3302833,395135,391676,22852,414528,4369
2021-12-08,San Francisco,075,870044,55634,54792,2487,57279,677
2021-12-08,San Joaquin,077,732212,103738,102877,5718,108595,1841
2021-12-08,San Luis Obispo,079,281455,31016,30519,1345,31864,361
2021-12-08,San Mateo,081,765935,56575,55220,1009,56229,580
2021-12-08,Santa Barbara,083,443738,46590,46250,1710,47960,558
2021-12-08,Santa Clara,085,1922200,154230,152674,1684,154358,1937
2021-12-08,Santa Cruz,087,273765,21799,21505,1049,22554,224
2021-12-08,Shasta,089,179085,22826,22616,3753,26369,419
2021-12-08,Sierra,091,2930,202,199,21,220,0
2021-12-08,Siskiyou,093,43540,3472,3415,1379,4794,57
2021-12-08,Solano,095,438530,47568,46837,1366,48203,365
2021-12-08,Sonoma,097,501317,43618,43179,590,43769,405
2021-12-08,Stanislaus,099,539301,81870,82038,9352,91390,1264
2021-12-08,Sutter,101,95872,14419,14336,410,14746,187
2021-12-08,Tehama,103,63373,8861,8768,1560,10328,133
2021-12-08,Trinity,105,12862,910,818,227,1045,17
2021-12-08,Tulare,107,460477,71587,70472,16538,87010,1102
2021-12-08,Tuolumne,109,53932,7771,7749,110,7859,91
2021-12-08,Ventura,111,848112,101457,100647,4512,105159,1194
2021-12-08,Yolo,113,214977,20794,20575,1285,21860,267
2021-12-08,Yuba,115,75493,10593,10499,398,10897,92
2021-12-07,Alameda,001,1643700,124391,123325,3016,126341,1497
2021-12-07,Alpine,003,1148,106,108,0,108,0
2021-12-07,Amador,005,37829,5797,5778,72,5850,69
2021-12-07,Butte,007,227075,21966,21761,3956,25717,324
2021-12-07,Calaveras,009,45235,4491,4445,64,4509,88
2021-12-07,Colusa,011,21464,2635,2619,690,3309,21
2021-12-07,Contra Costa,013,1133247,103188,102421,2390,104811,1058
2021-12-07,Del Norte,015,27424,3802,3766,56,3822,42
2021-12-07,El Dorado,017,186661,16978,16742,1792,18534,170
2021-12-07,Fresno,019,978130,147174,145715,12941,158656,2289
2021-12-07,Glenn,021,27897,3613,3579,1020,4599,36
2021-12-07,Humboldt,023,135768,9819,9693,704,10397,117
2021-12-07,Imperial,025,180216,36033,35502,3975,39477,778
2021-12-07,Inyo,027,18085,2601,2567,42,2609,46
2021-12-07,Kern,029,883053,133740,132564,24309,156873,1838
2021-12-07,Kings,031,150075,33845,33441,2066,35507,372
2021-12-07,Lake,033,64148,6977,6925,163,7088,113
2021-12-07,Lassen,035,31185,7088,7040,431,7471,55
2021-12-07,Los Angeles,037,10098052,1480905,1470904,57052,1527956,27007
2021-12-07,Madera,039,155013,24586,24367,2335,26702,311
2021-12-07,Marin,041,260295,18478,18284,546,18830,249
2021-12-07,Mariposa,043,17540,1466,1446,62,1508,6
2021-12-07,Mendocino,045,87422,8231,8107,683,8790,95
2021-12-07,Merced,047,269075,43835,43600,2045,45645,675
2021-12-07,Modoc,049,8938,599,594,203,797,6
2021-12-07,Mono,051,14174,1938,1921,23,1944,4
2021-12-07,Monterey,053,433212,50295,48880,3346,52226,631
2021-12-07,Napa,055,140530,13508,13409,129,13538,107
2021-12-07,Nevada,057,99092,9954,9858,351,10209,105
2021-12-07,Orange,059,3164182,317648,315138,16363,331501,5784
2021-12-07,Placer,061,380077,39235,38860,3941,42801,474
2021-12-07,Plumas,063,18699,1967,1915,47,1962,12
2021-12-07,Riverside,065,2383286,379467,374552,16928,391480,5397
2021-12-07,Sacramento,067,1510023,166469,165148,5102,170250,2375
2021-12-07,San Benito,069,59416,7824,7776,186,7962,78
2021-12-07,San Bernardino,071,2135413,370601,366981,11864,378845,6007
2021-12-07,San Diego,073,3302833,394285,391110,22814,413924,4357
2021-12-07,San Francisco,075,870044,55524,54729,2482,57211,676
2021-12-07,San Joaquin,077,732212,103619,102797,5706,108503,1839
2021-12-07,San Luis Obispo,079,281455,30977,30495,1343,31838,361
2021-12-07,San Mateo,081,765935,56486,55163,1003,56166,580
2021-12-07,Santa Barbara,083,443738,46519,46205,1708,47913,556
2021-12-07,Santa Clara,085,1922200,154044,152465,1675,154140,1941
2021-12-07,Santa Cruz,087,273765,21752,21493,1049,22542,224
2021-12-07,Shasta,089,179085,22804,22594,3750,26344,418
2021-12-07,Sierra,091,2930,202,199,21,220,0
2021-12-07,Siskiyou,093,43540,3470,3412,1379,4791,57
2021-12-07,Solano,095,438530,47528,46812,1364,48176,365
2021-12-07,Sonoma,097,501317,43544,43154,589,43743,405
2021-12-07,Stanislaus,099,539301,81793,81980,9340,91320,1258
2021-12-07,Sutter,101,95872,14411,14322,409,14731,186
2021-12-07,Tehama,103,63373,8853,8765,1559,10324,133
2021-12-07,Trinity,105,12862,910,818,227,1045,17
2021-12-07,Tulare,107,460477,71528,70411,16509,86920,1103
2021-12-07,Tuolumne,109,53932,7763,7743,110,7853,91
2021-12-07,Ventura,111,848112,101361,100569,4502,105071,1194
2021-12-07,Yolo,113,214977,20768,20560,1282,21842,263
2021-12-07,Yuba,115,75493,10576,10491,397,10888,91
2021-12-06,Alameda,001,1643700,124228,123227,3013,126240,1496
2021-12-06,Alpine,003,1148,106,108,0,108,0
2021-12-06,Amador,005,37829,5791,5769,71,5840,67
2021-12-06,Butte,007,227075,21949,21732,3953,25685,321
2021-12-06,Calaveras,009,45235,4484,4443,64,4507,88
2021-12-06,Colusa,011,21464,2634,2615,686,3301,21
2021-12-06,Contra Costa,013,1133247,103068,102327,2386,104713,1058
2021-12-06,Del Norte,015,27424,3800,3744,56,3800,42
2021-12-06,El Dorado,017,186661,16953,16726,1790,18516,168
2021-12-06,Fresno,019,978130,146979,145539,12932,158471,2285
2021-12-06,Glenn,021,27897,3610,3577,1019,4596,36
2021-12-06,Humboldt,023,135768,9799,9671,697,10368,117
2021-12-06,Imperial,025,180216,35952,35453,3956,39409,778
2021-12-06,Inyo,027,18085,2595,2562,41,2603,46
2021-12-06,Kern,029,883053,133554,132366,24251,156617,1835
2021-12-06,Kings,031,150075,33812,33399,2061,35460,368
2021-12-06,Lake,033,64148,6973,6922,163,7085,113
2021-12-06,Lassen,035,31185,7083,7032,429,7461,51
2021-12-06,Los Angeles,037,10098052,1479243,1470059,56960,1527019,26993
2021-12-06,Madera,039,155013,24559,24334,2331,26665,307
2021-12-06,Marin,041,260295,18450,18252,544,18796,249
2021-12-06,Mariposa,043,17540,1463,1443,62,1505,6
2021-12-06,Mendocino,045,87422,8218,8079,679,8758,95
2021-12-06,Merced,047,269075,43795,43549,2035,45584,672
2021-12-06,Modoc,049,8938,599,593,203,796,6
2021-12-06,Mono,051,14174,1933,1913,23,1936,4
2021-12-06,Monterey,053,433212,50217,48831,3326,52157,626
2021-12-06,Napa,055,140530,13485,13387,127,13514,107
2021-12-06,Nevada,057,99092,9926,9847,350,10197,105
2021-12-06,Orange,059,3164182,317271,314859,16320,331179,5771
2021-12-06,Placer,061,380077,39177,38785,3936,42721,473
2021-12-06,Plumas,063,18699,1959,1913,47,1960,10
2021-12-06,Riverside,065,2383286,378949,374116,16914,391030,5388
2021-12-06,Sacramento,067,1510023,166191,164926,5081,170007,2367
2021-12-06,San Benito,069,59416,7808,7755,186,7941,78
2021-12-06,San Bernardino,071,2135413,370051,366606,11837,378443,5998
2021-12-06,San Diego,073,3302833,393436,390389,22769,413158,4352
2021-12-06,San Francisco,075,870044,55416,54659,2477,57136,674
2021-12-06,San Joaquin,077,732212,103492,102728,5699,108427,1837
2021-12-06,San Luis Obispo,079,281455,30939,30464,1341,31805,361
2021-12-06,San Mateo,081,765935,56412,55112,1000,56112,580
2021-12-06,Santa Barbara,083,443738,46428,46146,1707,47853,556
2021-12-06,Santa Clara,085,1922200,153834,152310,1659,153969,1937
2021-12-06,Santa Cruz,087,273765,21717,21450,1046,22496,224
2021-12-06,Shasta,089,179085,22781,22556,3742,26298,416
2021-12-06,Sierra,091,2930,201,198,21,219,0
2021-12-06,Siskiyou,093,43540,3468,3409,1374,4783,57
2021-12-06,Solano,095,438530,47483,46748,1363,48111,360
2021-12-06,Sonoma,097,501317,43476,43114,581,43695,405
2021-12-06,Stanislaus,099,539301,81699,81889,9306,91195,1241
2021-12-06,Sutter,101,95872,14399,14319,409,14728,186
2021-12-06,Tehama,103,63373,8845,8760,1559,10319,133
2021-12-06,Trinity,105,12862,910,815,226,1041,17
2021-12-06,Tulare,107,460477,71452,70285,16470,86755,1101
2021-12-06,Tuolumne,109,53932,7749,7726,110,7836,91
2021-12-06,Ventura,111,848112,101259,100426,4494,104920,1194
2021-12-06,Yolo,113,214977,20744,20548,1281,21829,263
2021-12-06,Yuba,115,75493,10561,10480,392,10872,91
2021-12-05,Alameda,001,1643700,124040,123104,3005,126109,1496
2021-12-05,Alpine,003,1148,105,108,0,108,0
2021-12-05,Amador,005,37829,5788,5761,71,5832,67
2021-12-05,Butte,007,227075,21915,21720,3947,25667,320
2021-12-05,Calaveras,009,45235,4468,4434,64,4498,88
2021-12-05,Colusa,011,21464,2633,2615,685,3300,21
2021-12-05,Contra Costa,013,1133247,102938,102251,2376,104627,1058
2021-12-05,Del Norte,015,27424,3798,3751,56,3807,42
2021-12-05,El Dorado,017,186661,16916,16717,1784,18501,168
2021-12-05,Fresno,019,978130,146805,145452,12913,158365,2284
2021-12-05,Glenn,021,27897,3608,3577,1018,4595,36
2021-12-05,Humboldt,023,135768,9769,9662,694,10356,117
2021-12-05,Imperial,025,180216,35858,35422,3926,39348,778
2021-12-05,Inyo,027,18085,2588,2559,41,2600,46
2021-12-05,Kern,029,883053,133389,132286,24199,156485,1833
2021-12-05,Kings,031,150075,33748,33360,2061,35421,369
2021-12-05,Lake,033,64148,6968,6919,162,7081,113
2021-12-05,Lassen,035,31185,7081,7031,429,7460,51
2021-12-05,Los Angeles,037,10098052,1477406,1468937,56823,1525760,26991
2021-12-05,Madera,039,155013,24518,24311,2328,26639,307
2021-12-05,Marin,041,260295,18403,18216,536,18752,249
2021-12-05,Mariposa,043,17540,1460,1440,61,1501,6
2021-12-05,Mendocino,045,87422,8199,8069,673,8742,95
2021-12-05,Merced,047,269075,43751,43534,2026,45560,672
2021-12-05,Modoc,049,8938,599,593,203,796,6
2021-12-05,Mono,051,14174,1926,1907,23,1930,4
2021-12-05,Monterey,053,433212,50146,48813,3294,52107,626
2021-12-05,Napa,055,140530,13459,13382,124,13506,107
2021-12-05,Nevada,057,99092,9905,9827,350,10177,105
2021-12-05,Orange,059,3164182,316839,314560,16277,330837,5771
2021-12-05,Placer,061,380077,39119,38738,3927,42665,473
2021-12-05,Plumas,063,18699,1955,1913,46,1959,9
2021-12-05,Riverside,065,2383286,378294,373827,16884,390711,5388
2021-12-05,Sacramento,067,1510023,165884,164721,5063,169784,2367
2021-12-05,San Benito,069,59416,7791,7748,185,7933,78
2021-12-05,San Bernardino,071,2135413,369356,366282,11790,378072,5998
2021-12-05,San Diego,073,3302833,392637,387979,22721,410700,4351
2021-12-05,San Francisco,075,870044,55315,54603,2475,57078,674
2021-12-05,San Joaquin,077,732212,103351,102698,5694,108392,1837
2021-12-05,San Luis Obispo,079,281455,30869,30454,1338,31792,360
2021-12-05,San Mateo,081,765935,56323,55050,990,56040,580
2021-12-05,Santa Barbara,083,443738,46345,46097,1699,47796,555
2021-12-05,Santa Clara,085,1922200,153579,152114,1639,153753,1933
2021-12-05,Santa Cruz,087,273765,21667,21424,1046,22470,224
2021-12-05,Shasta,089,179085,22724,22550,3741,26291,416
2021-12-05,Sierra,091,2930,201,198,21,219,0
2021-12-05,Siskiyou,093,43540,3466,3409,1372,4781,57
2021-12-05,Solano,095,438530,47420,46715,1361,48076,360
2021-12-05,Sonoma,097,501317,43399,43038,576,43614,405
2021-12-05,Stanislaus,099,539301,81565,81847,9296,91143,1241
2021-12-05,Sutter,101,95872,14375,14303,404,14707,186
2021-12-05,Tehama,103,63373,8837,8755,1558,10313,133
2021-12-05,Trinity,105,12862,909,815,226,1041,17
2021-12-05,Tulare,107,460477,71370,70254,16422,86676,1102
2021-12-05,Tuolumne,109,53932,7736,7718,110,7828,91
2021-12-05,Ventura,111,848112,101123,100367,4481,104848,1194
2021-12-05,Yolo,113,214977,20702,20512,1279,21791,263
2021-12-05,Yuba,115,75493,10548,10467,385,10852,91
2021-12-04,Alameda,001,1643700,123929,122508,3001,125509,1494
2021-12-04,Alpine,003,1148,105,108,0,108,0
2021-12-04,Amador,005,37829,5785,5729,71,5800,67
2021-12-04,Butte,007,227075,21896,21638,3943,25581,318
2021-12-04,Calaveras,009,45235,4460,4392,63,4455,88
2021-12-04,Colusa,011,21464,2633,2600,683,3283,21
2021-12-04,Contra Costa,013,1133247,102863,101824,2370,104194,1056
2021-12-04,Del Norte,015,27424,3795,3726,56,3782,42
2021-12-04,El Dorado,017,186661,16907,16621,1783,18404,168
2021-12-04,Fresno,019,978130,146717,144734,12908,157642,2270
2021-12-04,Glenn,021,27897,3608,3559,1018,4577,36
2021-12-04,Humboldt,023,135768,9754,9596,690,10286,117
2021-12-04,Imperial,025,180216,35803,35206,3913,39119,776
2021-12-04,Inyo,027,18085,2583,2538,41,2579,46
2021-12-04,Kern,029,883053,133311,131771,24176,155947,1817
2021-12-04,Kings,031,150075,33724,33183,2060,35243,367
2021-12-04,Lake,033,64148,6959,6903,162,7065,113
2021-12-04,Lassen,035,31185,7080,7014,427,7441,51
2021-12-04,Los Angeles,037,10098052,1476537,1463270,56745,1520015,26952
2021-12-04,Madera,039,155013,24504,24188,2324,26512,307
2021-12-04,Marin,041,260295,18381,18075,535,18610,249
2021-12-04,Mariposa,043,17540,1456,1421,61,1482,6
2021-12-04,Mendocino,045,87422,8194,7981,673,8654,91
2021-12-04,Merced,047,269075,43724,43337,2024,45361,671
2021-12-04,Modoc,049,8938,599,591,203,794,6
2021-12-04,Mono,051,14174,1926,1883,23,1906,4
2021-12-04,Monterey,053,433212,50113,48682,3287,51969,626
2021-12-04,Napa,055,140530,13449,13327,123,13450,106
2021-12-04,Nevada,057,99092,9898,9752,350,10102,105
2021-12-04,Orange,059,3164182,316610,313112,16251,329363,5748
2021-12-04,Placer,061,380077,39079,38460,3921,42381,473
2021-12-04,Plumas,063,18699,1952,1903,46,1949,7
2021-12-04,Riverside,065,2383286,377937,371768,16878,388646,5381
2021-12-04,Sacramento,067,1510023,165741,163900,5055,168955,2365
2021-12-04,San Benito,069,59416,7765,7688,185,7873,78
2021-12-04,San Bernardino,071,2135413,368970,364154,11776,375930,5983
2021-12-04,San Diego,073,3302833,392158,386710,22691,409401,4350
2021-12-04,San Francisco,075,870044,55247,54286,2472,56758,674
2021-12-04,San Joaquin,077,732212,103297,102286,5692,107978,1835
2021-12-04,San Luis Obispo,079,281455,30848,30318,1334,31652,360
2021-12-04,San Mateo,081,765935,56271,54774,987,55761,579
2021-12-04,Santa Barbara,083,443738,46300,45774,1699,47473,555
2021-12-04,Santa Clara,085,1922200,153425,151275,1625,152900,1928
2021-12-04,Santa Cruz,087,273765,21641,21286,1045,22331,224
2021-12-04,Shasta,089,179085,22707,22418,3739,26157,414
2021-12-04,Sierra,091,2930,201,196,21,217,0
2021-12-04,Siskiyou,093,43540,3464,3398,1372,4770,57
2021-12-04,Solano,095,438530,47400,46529,1360,47889,360
2021-12-04,Sonoma,097,501317,43353,42778,573,43351,405
2021-12-04,Stanislaus,099,539301,81493,81462,9289,90751,1231
2021-12-04,Sutter,101,95872,14367,14258,403,14661,186
2021-12-04,Tehama,103,63373,8835,8742,1558,10300,131
2021-12-04,Trinity,105,12862,908,801,226,1027,17
2021-12-04,Tulare,107,460477,71332,70014,16394,86408,1100
2021-12-04,Tuolumne,109,53932,7731,7676,110,7786,91
2021-12-04,Ventura,111,848112,101032,99751,4477,104228,1192
2021-12-04,Yolo,113,214977,20680,20442,1276,21718,261
2021-12-04,Yuba,115,75493,10537,10418,384,10802,91
2021-12-03,Alameda,001,1643700,123836,122508,2991,125499,1494
2021-12-03,Alpine,003,1148,105,108,0,108,0
2021-12-03,Amador,005,37829,5780,5729,70,5799,67
2021-12-03,Butte,007,227075,21883,21638,3938,25576,318
2021-12-03,Calaveras,009,45235,4451,4392,63,4455,88
2021-12-03,Colusa,011,21464,2631,2600,683,3283,21
2021-12-03,Contra Costa,013,1133247,102789,101824,2365,104189,1056
2021-12-03,Del Norte,015,27424,3793,3726,56,3782,42
2021-12-03,El Dorado,017,186661,16878,16621,1781,18402,168
2021-12-03,Fresno,019,978130,146604,144734,12906,157640,2270
2021-12-03,Glenn,021,27897,3607,3559,1017,4576,36
2021-12-03,Humboldt,023,135768,9737,9596,688,10284,117
2021-12-03,Imperial,025,180216,35759,35206,3883,39089,776
2021-12-03,Inyo,027,18085,2576,2538,41,2579,46
2021-12-03,Kern,029,883053,133240,131771,24140,155911,1817
2021-12-03,Kings,031,150075,33696,33183,2060,35243,367
2021-12-03,Lake,033,64148,6959,6903,162,7065,113
2021-12-03,Lassen,035,31185,7078,7014,426,7440,51
2021-12-03,Los Angeles,037,10098052,1475596,1463270,56664,1519934,26952
2021-12-03,Madera,039,155013,24478,24188,2320,26508,307
2021-12-03,Marin,041,260295,18349,18075,531,18606,249
2021-12-03,Mariposa,043,17540,1454,1421,61,1482,6
2021-12-03,Mendocino,045,87422,8187,7981,673,8654,91
2021-12-03,Merced,047,269075,43701,43337,2021,45358,671
2021-12-03,Modoc,049,8938,599,591,203,794,6
2021-12-03,Mono,051,14174,1920,1883,23,1906,4
2021-12-03,Monterey,053,433212,50074,48682,3276,51958,626
2021-12-03,Napa,055,140530,13437,13327,123,13450,106
2021-12-03,Nevada,057,99092,9887,9752,350,10102,105
2021-12-03,Orange,059,3164182,316341,313112,16218,329330,5748
2021-12-03,Placer,061,380077,39042,38460,3914,42374,473
2021-12-03,Plumas,063,18699,1949,1903,46,1949,7
2021-12-03,Riverside,065,2383286,377546,371768,16872,388640,5381
2021-12-03,Sacramento,067,1510023,165561,163900,5041,168941,2365
2021-12-03,San Benito,069,59416,7758,7688,185,7873,78
2021-12-03,San Bernardino,071,2135413,368526,364154,11766,375920,5983
2021-12-03,San Diego,073,3302833,391682,386710,22667,409377,4350
2021-12-03,San Francisco,075,870044,55177,54286,2468,56754,674
2021-12-03,San Joaquin,077,732212,103240,102286,5691,107977,1835
2021-12-03,San Luis Obispo,079,281455,30822,30318,1331,31649,360
2021-12-03,San Mateo,081,765935,56208,54774,984,55758,579
2021-12-03,Santa Barbara,083,443738,46263,45774,1699,47473,555
2021-12-03,Santa Clara,085,1922200,153243,151275,1610,152885,1928
2021-12-03,Santa Cruz,087,273765,21614,21286,1045,22331,224
2021-12-03,Shasta,089,179085,22692,22418,3739,26157,414
2021-12-03,Sierra,091,2930,201,196,21,217,0
2021-12-03,Siskiyou,093,43540,3461,3398,1370,4768,57
2021-12-03,Solano,095,438530,47358,46529,1359,47888,360
2021-12-03,Sonoma,097,501317,43317,42778,571,43349,405
2021-12-03,Stanislaus,099,539301,81436,81462,9280,90742,1231
2021-12-03,Sutter,101,95872,14354,14258,401,14659,186
2021-12-03,Tehama,103,63373,8834,8742,1557,10299,131
2021-12-03,Trinity,105,12862,908,801,226,1027,17
2021-12-03,Tulare,107,460477,71293,70014,16361,86375,1100
2021-12-03,Tuolumne,109,53932,7722,7676,110,7786,91
2021-12-03,Ventura,111,848112,100945,99751,4470,104221,1192
2021-12-03,Yolo,113,214977,20663,20442,1275,21717,261
2021-12-03,Yuba,115,75493,10529,10418,384,10802,91
2021-12-02,Alameda,001,1643700,123680,122508,2983,125491,1494
2021-12-02,Alpine,003,1148,105,108,0,108,0
2021-12-02,Amador,005,37829,5775,5729,69,5798,67
2021-12-02,Butte,007,227075,21858,21638,3935,25573,318
2021-12-02,Calaveras,009,45235,4441,4392,62,4454,88
2021-12-02,Colusa,011,21464,2630,2600,683,3283,21
2021-12-02,Contra Costa,013,1133247,102675,101824,2361,104185,1056
2021-12-02,Del Norte,015,27424,3785,3726,56,3782,42
2021-12-02,El Dorado,017,186661,16857,16621,1779,18400,168
2021-12-02,Fresno,019,978130,146438,144734,12896,157630,2270
2021-12-02,Glenn,021,27897,3607,3559,1014,4573,36
2021-12-02,Humboldt,023,135768,9718,9596,686,10282,117
2021-12-02,Imperial,025,180216,35692,35206,3860,39066,776
2021-12-02,Inyo,027,18085,2571,2538,41,2579,46
2021-12-02,Kern,029,883053,133069,131771,24087,155858,1817
2021-12-02,Kings,031,150075,33641,33183,2058,35241,367
2021-12-02,Lake,033,64148,6955,6903,162,7065,113
2021-12-02,Lassen,035,31185,7074,7014,426,7440,51
2021-12-02,Los Angeles,037,10098052,1474084,1463270,56580,1519850,26952
2021-12-02,Madera,039,155013,24441,24188,2311,26499,307
2021-12-02,Marin,041,260295,18319,18075,527,18602,249
2021-12-02,Mariposa,043,17540,1452,1421,61,1482,6
2021-12-02,Mendocino,045,87422,8171,7981,672,8653,91
2021-12-02,Merced,047,269075,43655,43337,2015,45352,671
2021-12-02,Modoc,049,8938,598,591,203,794,6
2021-12-02,Mono,051,14174,1914,1883,23,1906,4
2021-12-02,Monterey,053,433212,50001,48682,3254,51936,626
2021-12-02,Napa,055,140530,13424,13327,123,13450,106
2021-12-02,Nevada,057,99092,9869,9752,349,10101,105
2021-12-02,Orange,059,3164182,315998,313112,16181,329293,5748
2021-12-02,Placer,061,380077,38977,38460,3909,42369,473
2021-12-02,Plumas,063,18699,1947,1903,46,1949,7
2021-12-02,Riverside,065,2383286,377020,371768,16862,388630,5381
2021-12-02,Sacramento,067,1510023,165333,163900,5031,168931,2365
2021-12-02,San Benito,069,59416,7738,7688,185,7873,78
2021-12-02,San Bernardino,071,2135413,367980,364154,11746,375900,5983
2021-12-02,San Diego,073,3302833,391036,386710,22613,409323,4350
2021-12-02,San Francisco,075,870044,55079,54286,2463,56749,674
2021-12-02,San Joaquin,077,732212,103126,102286,5686,107972,1835
2021-12-02,San Luis Obispo,079,281455,30789,30318,1324,31642,360
2021-12-02,San Mateo,081,765935,56127,54774,976,55750,579
2021-12-02,Santa Barbara,083,443738,46182,45774,1696,47470,555
2021-12-02,Santa Clara,085,1922200,152996,151275,1593,152868,1928
2021-12-02,Santa Cruz,087,273765,21562,21286,1044,22330,224
2021-12-02,Shasta,089,179085,22659,22418,3738,26156,414
2021-12-02,Sierra,091,2930,201,196,21,217,0
2021-12-02,Siskiyou,093,43540,3460,3398,1363,4761,57
2021-12-02,Solano,095,438530,47307,46529,1357,47886,360
2021-12-02,Sonoma,097,501317,43245,42778,571,43349,405
2021-12-02,Stanislaus,099,539301,81344,81462,9271,90733,1231
2021-12-02,Sutter,101,95872,14341,14258,398,14656,186
2021-12-02,Tehama,103,63373,8827,8742,1555,10297,131
2021-12-02,Trinity,105,12862,908,801,226,1027,17
2021-12-02,Tulare,107,460477,71205,70014,16309,86323,1100
2021-12-02,Tuolumne,109,53932,7707,7676,109,7785,91
2021-12-02,Ventura,111,848112,100820,99751,4468,104219,1192
2021-12-02,Yolo,113,214977,20639,20442,1271,21713,261
2021-12-02,Yuba,115,75493,10513,10418,381,10799,91
2021-12-01,Alameda,001,1643700,123530,122298,2973,125271,1492
2021-12-01,Alpine,003,1148,105,108,0,108,0
2021-12-01,Amador,005,37829,5768,5723,69,5792,67
2021-12-01,Butte,007,227075,21838,21600,3930,25530,318
2021-12-01,Calaveras,009,45235,4436,4371,62,4433,88
2021-12-01,Colusa,011,21464,2623,2595,680,3275,20
2021-12-01,Contra Costa,013,1133247,102566,101651,2350,104001,1048
2021-12-01,Del Norte,015,27424,3783,3722,56,3778,42
2021-12-01,El Dorado,017,186661,16836,16575,1777,18352,166
2021-12-01,Fresno,019,978130,146232,144507,12887,157394,2264
2021-12-01,Glenn,021,27897,3600,3556,1013,4569,36
2021-12-01,Humboldt,023,135768,9694,9573,681,10254,117
2021-12-01,Imperial,025,180216,35611,35085,3833,38918,776
2021-12-01,Inyo,027,18085,2567,2533,41,2574,46
2021-12-01,Kern,029,883053,132922,131580,24032,155612,1804
2021-12-01,Kings,031,150075,33592,33112,2057,35169,364
2021-12-01,Lake,033,64148,6947,6896,161,7057,112
2021-12-01,Lassen,035,31185,7068,7008,424,7432,51
2021-12-01,Los Angeles,037,10098052,1472496,1461394,56485,1517879,26928
2021-12-01,Madera,039,155013,24409,24134,2302,26436,307
2021-12-01,Marin,041,260295,18282,18038,521,18559,249
2021-12-01,Mariposa,043,17540,1448,1415,61,1476,6
2021-12-01,Mendocino,045,87422,8157,7966,667,8633,90
2021-12-01,Merced,047,269075,43599,43259,1994,45253,670
2021-12-01,Modoc,049,8938,598,576,203,779,5
2021-12-01,Mono,051,14174,1909,1876,23,1899,4
2021-12-01,Monterey,053,433212,49952,48611,3245,51856,626
2021-12-01,Napa,055,140530,13407,13319,120,13439,107
2021-12-01,Nevada,057,99092,9856,9706,349,10055,105
2021-12-01,Orange,059,3164182,315634,312772,16143,328915,5735
2021-12-01,Placer,061,380077,38921,38373,3903,42276,472
2021-12-01,Plumas,063,18699,1943,1893,46,1939,7
2021-12-01,Riverside,065,2383286,376496,371189,16845,388034,5369
2021-12-01,Sacramento,067,1510023,165120,163616,5011,168627,2360
2021-12-01,San Benito,069,59416,7724,7669,185,7854,78
2021-12-01,San Bernardino,071,2135413,367400,363368,11720,375088,5973
2021-12-01,San Diego,073,3302833,390241,386056,22560,408616,4346
2021-12-01,San Francisco,075,870044,54997,54199,2456,56655,672
2021-12-01,San Joaquin,077,732212,103018,102109,5685,107794,1834
2021-12-01,San Luis Obispo,079,281455,30747,30238,1320,31558,360
2021-12-01,San Mateo,081,765935,56046,54711,972,55683,579
2021-12-01,Santa Barbara,083,443738,46112,45681,1694,47375,554
2021-12-01,Santa Clara,085,1922200,152778,150961,1576,152537,1925
2021-12-01,Santa Cruz,087,273765,21532,21191,1043,22234,224
2021-12-01,Shasta,089,179085,22627,22375,3732,26107,410
2021-12-01,Sierra,091,2930,201,195,21,216,0
2021-12-01,Siskiyou,093,43540,3457,3391,1363,4754,55
2021-12-01,Solano,095,438530,47263,46485,1357,47842,360
2021-12-01,Sonoma,097,501317,43171,42713,570,43283,405
2021-12-01,Stanislaus,099,539301,81251,81330,9259,90589,1231
2021-12-01,Sutter,101,95872,14326,14229,397,14626,186
2021-12-01,Tehama,103,63373,8817,8728,1555,10283,130
2021-12-01,Trinity,105,12862,903,801,226,1027,17
2021-12-01,Tulare,107,460477,71126,69953,16269,86222,1098
2021-12-01,Tuolumne,109,53932,7699,7655,109,7764,91
2021-12-01,Ventura,111,848112,100714,99680,4457,104137,1191
2021-12-01,Yolo,113,214977,20611,20393,1271,21664,260
2021-12-01,Yuba,115,75493,10501,10401,380,10781,89
2021-11-30,Alameda,001,1643700,123363,122196,2964,125160,1489
2021-11-30,Alpine,003,1148,105,108,0,108,0
2021-11-30,Amador,005,37829,5760,5716,69,5785,66
2021-11-30,Butte,007,227075,21809,21565,3921,25486,318
2021-11-30,Calaveras,009,45235,4418,4360,62,4422,88
2021-11-30,Colusa,011,21464,2622,2592,680,3272,21
2021-11-30,Contra Costa,013,1133247,102428,101538,2343,103881,1046
2021-11-30,Del Norte,015,27424,3777,3718,56,3774,42
2021-11-30,El Dorado,017,186661,16808,16558,1771,18329,166
2021-11-30,Fresno,019,978130,146034,144384,12879,157263,2259
2021-11-30,Glenn,021,27897,3595,3555,1012,4567,36
2021-11-30,Humboldt,023,135768,9663,9539,675,10214,116
2021-11-30,Imperial,025,180216,35503,34999,3805,38804,773
2021-11-30,Inyo,027,18085,2558,2530,41,2571,46
2021-11-30,Kern,029,883053,132749,131451,23975,155426,1799
2021-11-30,Kings,031,150075,33541,33074,2053,35127,362
2021-11-30,Lake,033,64148,6942,6892,159,7051,110
2021-11-30,Lassen,035,31185,7064,7003,423,7426,51
2021-11-30,Los Angeles,037,10098052,1470710,1460177,56380,1516557,26913
2021-11-30,Madera,039,155013,24375,24108,2297,26405,307
2021-11-30,Marin,041,260295,18238,18010,519,18529,249
2021-11-30,Mariposa,043,17540,1442,1412,61,1473,6
2021-11-30,Mendocino,045,87422,8128,7960,661,8621,89
2021-11-30,Merced,047,269075,43527,43200,1987,45187,668
2021-11-30,Modoc,049,8938,597,576,203,779,5
2021-11-30,Mono,051,14174,1906,1873,23,1896,4
2021-11-30,Monterey,053,433212,49888,48581,3235,51816,626
2021-11-30,Napa,055,140530,13387,13308,120,13428,105
2021-11-30,Nevada,057,99092,9840,9699,348,10047,105
2021-11-30,Orange,059,3164182,315214,312451,16101,328552,5724
2021-11-30,Placer,061,380077,38817,38324,3895,42219,470
2021-11-30,Plumas,063,18699,1938,1887,45,1932,7
2021-11-30,Riverside,065,2383286,375812,370739,16820,387559,5358
2021-11-30,Sacramento,067,1510023,164840,163420,4988,168408,2353
2021-11-30,San Benito,069,59416,7702,7645,184,7829,78
2021-11-30,San Bernardino,071,2135413,366733,363006,11698,374704,5967
2021-11-30,San Diego,073,3302833,389313,385405,22516,407921,4340
2021-11-30,San Francisco,075,870044,54890,54147,2447,56594,672
2021-11-30,San Joaquin,077,732212,102892,101972,5677,107649,1834
2021-11-30,San Luis Obispo,079,281455,30721,30200,1317,31517,360
2021-11-30,San Mateo,081,765935,55943,54656,962,55618,579
2021-11-30,Santa Barbara,083,443738,46016,45628,1688,47316,553
2021-11-30,Santa Clara,085,1922200,152517,150799,1557,152356,1929
2021-11-30,Santa Cruz,087,273765,21473,21169,1039,22208,224
2021-11-30,Shasta,089,179085,22597,22347,3729,26076,401
2021-11-30,Sierra,091,2930,198,195,21,216,0
2021-11-30,Siskiyou,093,43540,3453,3385,1360,4745,55
2021-11-30,Solano,095,438530,47200,46434,1351,47785,358
2021-11-30,Sonoma,097,501317,43093,42663,569,43232,405
2021-11-30,Stanislaus,099,539301,81152,81276,9232,90508,1227
2021-11-30,Sutter,101,95872,14315,14210,394,14604,186
2021-11-30,Tehama,103,63373,8810,8727,1554,10281,130
2021-11-30,Trinity,105,12862,902,799,226,1025,17
2021-11-30,Tulare,107,460477,71039,69900,16220,86120,1099
2021-11-30,Tuolumne,109,53932,7684,7643,109,7752,91
2021-11-30,Ventura,111,848112,100561,99601,4445,104046,1191
2021-11-30,Yolo,113,214977,20569,20376,1265,21641,260
2021-11-30,Yuba,115,75493,10482,10398,375,10773,89
2021-11-29,Alameda,001,1643700,123206,122136,2954,125090,1489
2021-11-29,Alpine,003,1148,105,108,0,108,0
2021-11-29,Amador,005,37829,5753,5706,69,5775,66
2021-11-29,Butte,007,227075,21784,21544,3915,25459,314
2021-11-29,Calaveras,009,45235,4402,4353,62,4415,88
2021-11-29,Colusa,011,21464,2620,2585,677,3262,20
2021-11-29,Contra Costa,013,1133247,102280,101441,2335,103776,1046
2021-11-29,Del Norte,015,27424,3774,3704,56,3760,42
2021-11-29,El Dorado,017,186661,16790,16534,1766,18300,166
2021-11-29,Fresno,019,978130,145831,144282,12864,157146,2254
2021-11-29,Glenn,021,27897,3592,3555,1011,4566,36
2021-11-29,Humboldt,023,135768,9646,9514,668,10182,115
2021-11-29,Imperial,025,180216,35439,34960,3784,38744,773
2021-11-29,Inyo,027,18085,2553,2529,41,2570,46
2021-11-29,Kern,029,883053,132564,131362,23933,155295,1789
2021-11-29,Kings,031,150075,33489,33059,2049,35108,363
2021-11-29,Lake,033,64148,6930,6889,159,7048,110
2021-11-29,Lassen,035,31185,7061,7003,421,7424,51
2021-11-29,Los Angeles,037,10098052,1468863,1459446,56293,1515739,26889
2021-11-29,Madera,039,155013,24339,24069,2289,26358,307
2021-11-29,Marin,041,260295,18191,17980,514,18494,249
2021-11-29,Mariposa,043,17540,1434,1409,61,1470,6
2021-11-29,Mendocino,045,87422,8111,7954,657,8611,89
2021-11-29,Merced,047,269075,43452,43167,1980,45147,667
2021-11-29,Modoc,049,8938,596,569,203,772,5
2021-11-29,Mono,051,14174,1889,1859,23,1882,4
2021-11-29,Monterey,053,433212,49828,48548,3219,51767,626
2021-11-29,Napa,055,140530,13377,13304,120,13424,104
2021-11-29,Nevada,057,99092,9826,9689,348,10037,105
2021-11-29,Orange,059,3164182,314814,312203,16055,328258,5709
2021-11-29,Placer,061,380077,38752,38261,3890,42151,470
2021-11-29,Plumas,063,18699,1935,1884,45,1929,7
2021-11-29,Riverside,065,2383286,375279,370334,16809,387143,5358
2021-11-29,Sacramento,067,1510023,164591,163282,4955,168237,2342
2021-11-29,San Benito,069,59416,7681,7631,183,7814,77
2021-11-29,San Bernardino,071,2135413,366139,362694,11666,374360,5962
2021-11-29,San Diego,073,3302833,388421,384853,22482,407335,4335
2021-11-29,San Francisco,075,870044,54792,54125,2443,56568,669
2021-11-29,San Joaquin,077,732212,102753,101927,5670,107597,1834
2021-11-29,San Luis Obispo,079,281455,30687,30165,1313,31478,359
2021-11-29,San Mateo,081,765935,55841,54622,958,55580,579
2021-11-29,Santa Barbara,083,443738,45919,45576,1684,47260,549
2021-11-29,Santa Clara,085,1922200,152246,150620,1551,152171,1925
2021-11-29,Santa Cruz,087,273765,21436,21149,1038,22187,224
2021-11-29,Shasta,089,179085,22562,22315,3725,26040,399
2021-11-29,Sierra,091,2930,198,195,21,216,0
2021-11-29,Siskiyou,093,43540,3450,3374,1353,4727,55
2021-11-29,Solano,095,438530,47148,46412,1349,47761,357
2021-11-29,Sonoma,097,501317,43018,42624,566,43190,405
2021-11-29,Stanislaus,099,539301,81072,81227,9214,90441,1223
2021-11-29,Sutter,101,95872,14299,14204,391,14595,186
2021-11-29,Tehama,103,63373,8805,8720,1549,10269,130
2021-11-29,Trinity,105,12862,897,798,226,1024,17
2021-11-29,Tulare,107,460477,70960,69850,16185,86035,1096
2021-11-29,Tuolumne,109,53932,7671,7627,109,7736,90
2021-11-29,Ventura,111,848112,100441,99520,4435,103955,1190
2021-11-29,Yolo,113,214977,20525,20344,1262,21606,257
2021-11-29,Yuba,115,75493,10465,10395,374,10769,89
2021-11-28,Alameda,001,1643700,122986,122082,2948,125030,1491
2021-11-28,Alpine,003,1148,105,108,0,108,0
2021-11-28,Amador,005,37829,5743,5703,69,5772,66
2021-11-28,Butte,007,227075,21746,21530,3913,25443,313
2021-11-28,Calaveras,009,45235,4380,4350,62,4412,88
2021-11-28,Colusa,011,21464,2616,2586,676,3262,19
2021-11-28,Contra Costa,013,1133247,102107,101355,2324,103679,1046
2021-11-28,Del Norte,015,27424,3769,3703,56,3759,42
2021-11-28,El Dorado,017,186661,16749,16527,1765,18292,166
2021-11-28,Fresno,019,978130,145587,144164,12844,157008,2252
2021-11-28,Glenn,021,27897,3589,3547,1009,4556,36
2021-11-28,Humboldt,023,135768,9614,9499,664,10163,115
2021-11-28,Imperial,025,180216,35331,34929,3760,38689,773
2021-11-28,Inyo,027,18085,2546,2531,41,2572,46
2021-11-28,Kern,029,883053,132356,131279,23876,155155,1789
2021-11-28,Kings,031,150075,33415,33057,2042,35099,364
2021-11-28,Lake,033,64148,6920,6885,158,7043,110
2021-11-28,Lassen,035,31185,7053,7002,417,7419,51
2021-11-28,Los Angeles,037,10098052,1466696,1458646,56205,1514851,26878
2021-11-28,Madera,039,155013,24291,24055,2282,26337,307
2021-11-28,Marin,041,260295,18142,17962,510,18472,249
2021-11-28,Mariposa,043,17540,1430,1406,61,1467,6
2021-11-28,Mendocino,045,87422,8080,7943,652,8595,89
2021-11-28,Merced,047,269075,43386,43166,1965,45131,667
2021-11-28,Modoc,049,8938,595,569,203,772,5
2021-11-28,Mono,051,14174,1883,1841,23,1864,4
2021-11-28,Monterey,053,433212,49763,48537,3199,51736,626
2021-11-28,Napa,055,140530,13364,13303,120,13423,104
2021-11-28,Nevada,057,99092,9799,9684,347,10031,105
2021-11-28,Orange,059,3164182,314430,312028,16012,328040,5693
2021-11-28,Placer,061,380077,38671,38240,3871,42111,470
2021-11-28,Plumas,063,18699,1929,1884,44,1928,7
2021-11-28,Riverside,065,2383286,374623,370051,16787,386838,5358
2021-11-28,Sacramento,067,1510023,164236,163170,4932,168102,2335
2021-11-28,San Benito,069,59416,7663,7623,182,7805,77
2021-11-28,San Bernardino,071,2135413,365423,362407,11639,374046,5958
2021-11-28,San Diego,073,3302833,387529,383025,22418,405443,4325
2021-11-28,San Francisco,075,870044,54716,54082,2440,56522,669
2021-11-28,San Joaquin,077,732212,102572,101895,5653,107548,1834
2021-11-28,San Luis Obispo,079,281455,30622,30152,1309,31461,358
2021-11-28,San Mateo,081,765935,55746,54567,954,55521,579
2021-11-28,Santa Barbara,083,443738,45840,45551,1673,47224,549
2021-11-28,Santa Clara,085,1922200,151941,150436,1536,151972,1920
2021-11-28,Santa Cruz,087,273765,21365,21110,1037,22147,224
2021-11-28,Shasta,089,179085,22522,22316,3723,26039,400
2021-11-28,Sierra,091,2930,198,195,21,216,0
2021-11-28,Siskiyou,093,43540,3444,3372,1349,4721,55
2021-11-28,Solano,095,438530,47086,46385,1348,47733,356
2021-11-28,Sonoma,097,501317,42932,42583,563,43146,405
2021-11-28,Stanislaus,099,539301,80957,81181,9194,90375,1223
2021-11-28,Sutter,101,95872,14277,14192,385,14577,186
2021-11-28,Tehama,103,63373,8797,8720,1545,10265,130
2021-11-28,Trinity,105,12862,896,797,226,1023,17
2021-11-28,Tulare,107,460477,70863,69833,16129,85962,1095
2021-11-28,Tuolumne,109,53932,7650,7620,109,7729,90
2021-11-28,Ventura,111,848112,100285,99486,4424,103910,1190
2021-11-28,Yolo,113,214977,20483,20333,1261,21594,257
2021-11-28,Yuba,115,75493,10447,10391,372,10763,89
2021-11-27,Alameda,001,1643700,122890,121618,2945,124563,1477
2021-11-27,Alpine,003,1148,105,106,0,106,0
2021-11-27,Amador,005,37829,5742,5670,69,5739,66
2021-11-27,Butte,007,227075,21723,21384,3908,25292,309
2021-11-27,Calaveras,009,45235,4374,4294,62,4356,85
2021-11-27,Colusa,011,21464,2615,2568,674,3242,19
2021-11-27,Contra Costa,013,1133247,102021,100961,2323,103284,1045
2021-11-27,Del Norte,015,27424,3762,3661,56,3717,42
2021-11-27,El Dorado,017,186661,16714,16399,1764,18163,161
2021-11-27,Fresno,019,978130,145477,143386,12840,156226,2246
2021-11-27,Glenn,021,27897,3585,3532,1008,4540,36
2021-11-27,Humboldt,023,135768,9586,9399,662,10061,115
2021-11-27,Imperial,025,180216,35248,34611,3744,38355,769
2021-11-27,Inyo,027,18085,2543,2506,41,2547,45
2021-11-27,Kern,029,883053,132272,130245,23847,154092,1773
2021-11-27,Kings,031,150075,33392,32891,2040,34931,358
2021-11-27,Lake,033,64148,6917,6836,157,6993,110
2021-11-27,Lassen,035,31185,7051,6959,416,7375,47
2021-11-27,Los Angeles,037,10098052,1465690,1454495,56135,1510630,26817
2021-11-27,Madera,039,155013,24271,23880,2278,26158,296
2021-11-27,Marin,041,260295,18104,17857,505,18362,248
2021-11-27,Mariposa,043,17540,1428,1374,61,1435,6
2021-11-27,Mendocino,045,87422,8061,7871,652,8523,89
2021-11-27,Merced,047,269075,43351,42921,1962,44883,664
2021-11-27,Modoc,049,8938,593,551,203,754,5
2021-11-27,Mono,051,14174,1881,1810,23,1833,4
2021-11-27,Monterey,053,433212,49730,48400,3185,51585,625
2021-11-27,Napa,055,140530,13350,13256,120,13376,104
2021-11-27,Nevada,057,99092,9777,9584,346,9930,103
2021-11-27,Orange,059,3164182,314178,310809,15975,326784,5665
2021-11-27,Placer,061,380077,38610,38001,3865,41866,468
2021-11-27,Plumas,063,18699,1925,1860,44,1904,7
2021-11-27,Riverside,065,2383286,374265,367601,16780,384381,5306
2021-11-27,Sacramento,067,1510023,164080,162328,4929,167257,2335
2021-11-27,San Benito,069,59416,7646,7575,182,7757,77
2021-11-27,San Bernardino,071,2135413,364992,360033,11630,371663,5932
2021-11-27,San Diego,073,3302833,387027,382634,22392,405026,4319
2021-11-27,San Francisco,075,870044,54666,53830,2437,56267,669
2021-11-27,San Joaquin,077,732212,102505,101368,5650,107018,1833
2021-11-27,San Luis Obispo,079,281455,30587,29983,1305,31288,358
2021-11-27,San Mateo,081,765935,55689,54360,951,55311,577
2021-11-27,Santa Barbara,083,443738,45786,45318,1671,46989,548
2021-11-27,Santa Clara,085,1922200,151734,149700,1530,151230,1922
2021-11-27,Santa Cruz,087,273765,21325,20929,1034,21963,222
2021-11-27,Shasta,089,179085,22499,22151,3722,25873,396
2021-11-27,Sierra,091,2930,197,194,21,215,0
2021-11-27,Siskiyou,093,43540,3441,3336,1347,4683,54
2021-11-27,Solano,095,438530,47050,46163,1345,47508,356
2021-11-27,Sonoma,097,501317,42869,42368,563,42931,405
2021-11-27,Stanislaus,099,539301,80889,80782,9176,89958,1220
2021-11-27,Sutter,101,95872,14269,14127,384,14511,181
2021-11-27,Tehama,103,63373,8795,8675,1544,10219,129
2021-11-27,Trinity,105,12862,896,789,226,1015,17
2021-11-27,Tulare,107,460477,70811,69377,16113,85490,1082
2021-11-27,Tuolumne,109,53932,7637,7574,109,7683,90
2021-11-27,Ventura,111,848112,100212,99163,4416,103579,1188
2021-11-27,Yolo,113,214977,20462,20237,1252,21489,257
2021-11-27,Yuba,115,75493,10437,10335,372,10707,88
2021-11-26,Alameda,001,1643700,122779,121618,2943,124561,1477
2021-11-26,Alpine,003,1148,105,106,0,106,0
2021-11-26,Amador,005,37829,5738,5670,69,5739,66
2021-11-26,Butte,007,227075,21700,21384,3903,25287,309
2021-11-26,Calaveras,009,45235,4365,4294,62,4356,85
2021-11-26,Colusa,011,21464,2613,2568,673,3241,19
2021-11-26,Contra Costa,013,1133247,101933,100961,2319,103280,1045
2021-11-26,Del Norte,015,27424,3759,3661,56,3717,42
2021-11-26,El Dorado,017,186661,16697,16399,1761,18160,161
2021-11-26,Fresno,019,978130,145345,143386,12831,156217,2246
2021-11-26,Glenn,021,27897,3583,3532,1008,4540,36
2021-11-26,Humboldt,023,135768,9567,9399,658,10057,115
2021-11-26,Imperial,025,180216,35191,34611,3731,38342,769
2021-11-26,Inyo,027,18085,2543,2506,41,2547,45
2021-11-26,Kern,029,883053,132189,130245,23803,154048,1773
2021-11-26,Kings,031,150075,33368,32891,2038,34929,358
2021-11-26,Lake,033,64148,6915,6836,157,6993,110
2021-11-26,Lassen,035,31185,7045,6959,416,7375,47
2021-11-26,Los Angeles,037,10098052,1464846,1454495,56073,1510568,26817
2021-11-26,Madera,039,155013,24244,23880,2276,26156,296
2021-11-26,Marin,041,260295,18075,17857,505,18362,248
2021-11-26,Mariposa,043,17540,1422,1374,60,1434,6
2021-11-26,Mendocino,045,87422,8051,7871,652,8523,89
2021-11-26,Merced,047,269075,43321,42921,1957,44878,664
2021-11-26,Modoc,049,8938,591,551,203,754,5
2021-11-26,Mono,051,14174,1870,1810,23,1833,4
2021-11-26,Monterey,053,433212,49686,48400,3178,51578,625
2021-11-26,Napa,055,140530,13334,13256,120,13376,104
2021-11-26,Nevada,057,99092,9766,9584,346,9930,103
2021-11-26,Orange,059,3164182,313908,310809,15943,326752,5665
2021-11-26,Placer,061,380077,38565,38001,3857,41858,468
2021-11-26,Plumas,063,18699,1920,1860,44,1904,7
2021-11-26,Riverside,065,2383286,373864,367601,16773,384374,5306
2021-11-26,Sacramento,067,1510023,163968,162328,4924,167252,2335
2021-11-26,San Benito,069,59416,7638,7575,182,7757,77
2021-11-26,San Bernardino,071,2135413,364562,360033,11623,371656,5932
2021-11-26,San Diego,073,3302833,386471,382634,22380,405014,4319
2021-11-26,San Francisco,075,870044,54618,53830,2435,56265,669
2021-11-26,San Joaquin,077,732212,102448,101368,5649,107017,1833
2021-11-26,San Luis Obispo,079,281455,30545,29983,1302,31285,358
2021-11-26,San Mateo,081,765935,55625,54360,950,55310,577
2021-11-26,Santa Barbara,083,443738,45739,45318,1670,46988,548
2021-11-26,Santa Clara,085,1922200,151566,149700,1522,151222,1922
2021-11-26,Santa Cruz,087,273765,21285,20929,1034,21963,222
2021-11-26,Shasta,089,179085,22480,22151,3720,25871,396
2021-11-26,Sierra,091,2930,197,194,21,215,0
2021-11-26,Siskiyou,093,43540,3438,3336,1346,4682,54
2021-11-26,Solano,095,438530,47008,46163,1344,47507,356
2021-11-26,Sonoma,097,501317,42818,42368,561,42929,405
2021-11-26,Stanislaus,099,539301,80816,80782,9165,89947,1220
2021-11-26,Sutter,101,95872,14256,14127,383,14510,181
2021-11-26,Tehama,103,63373,8793,8675,1543,10218,129
2021-11-26,Trinity,105,12862,895,789,226,1015,17
2021-11-26,Tulare,107,460477,70765,69377,16081,85458,1082
2021-11-26,Tuolumne,109,53932,7627,7574,109,7683,90
2021-11-26,Ventura,111,848112,100132,99163,4411,103574,1188
2021-11-26,Yolo,113,214977,20443,20237,1244,21481,257
2021-11-26,Yuba,115,75493,10431,10335,372,10707,88
2021-11-25,Alameda,001,1643700,122672,121618,2938,124556,1477
2021-11-25,Alpine,003,1148,105,106,0,106,0
2021-11-25,Amador,005,37829,5730,5670,69,5739,66
2021-11-25,Butte,007,227075,21682,21384,3901,25285,309
2021-11-25,Calaveras,009,45235,4360,4294,62,4356,85
2021-11-25,Colusa,011,21464,2610,2568,671,3239,19
2021-11-25,Contra Costa,013,1133247,101828,100961,2314,103275,1045
2021-11-25,Del Norte,015,27424,3754,3661,56,3717,42
2021-11-25,El Dorado,017,186661,16678,16399,1760,18159,161
2021-11-25,Fresno,019,978130,145211,143386,12824,156210,2246
2021-11-25,Glenn,021,27897,3582,3532,1007,4539,36
2021-11-25,Humboldt,023,135768,9548,9399,655,10054,115
2021-11-25,Imperial,025,180216,35146,34611,3718,38329,769
2021-11-25,Inyo,027,18085,2541,2506,41,2547,45
2021-11-25,Kern,029,883053,132091,130245,23757,154002,1773
2021-11-25,Kings,031,150075,33340,32891,2037,34928,358
2021-11-25,Lake,033,64148,6908,6836,157,6993,110
2021-11-25,Lassen,035,31185,7043,6959,415,7374,47
2021-11-25,Los Angeles,037,10098052,1463879,1454495,56015,1510510,26817
2021-11-25,Madera,039,155013,24209,23880,2275,26155,296
2021-11-25,Marin,041,260295,18048,17857,500,18357,248
2021-11-25,Mariposa,043,17540,1419,1374,60,1434,6
2021-11-25,Mendocino,045,87422,8033,7871,652,8523,89
2021-11-25,Merced,047,269075,43282,42921,1952,44873,664
2021-11-25,Modoc,049,8938,590,551,203,754,5
2021-11-25,Mono,051,14174,1859,1810,23,1833,4
2021-11-25,Monterey,053,433212,49641,48400,3169,51569,625
2021-11-25,Napa,055,140530,13326,13256,120,13376,104
2021-11-25,Nevada,057,99092,9747,9584,343,9927,103
2021-11-25,Orange,059,3164182,313645,310809,15911,326720,5665
2021-11-25,Placer,061,380077,38519,38001,3851,41852,468
2021-11-25,Plumas,063,18699,1918,1860,44,1904,7
2021-11-25,Riverside,065,2383286,373450,367601,16766,384367,5306
2021-11-25,Sacramento,067,1510023,163788,162328,4918,167246,2335
2021-11-25,San Benito,069,59416,7631,7575,182,7757,77
2021-11-25,San Bernardino,071,2135413,364169,360033,11606,371639,5932
2021-11-25,San Diego,073,3302833,386026,382634,22361,404995,4319
2021-11-25,San Francisco,075,870044,54568,53830,2432,56262,669
2021-11-25,San Joaquin,077,732212,102364,101368,5645,107013,1833
2021-11-25,San Luis Obispo,079,281455,30515,29983,1300,31283,358
2021-11-25,San Mateo,081,765935,55576,54360,948,55308,577
2021-11-25,Santa Barbara,083,443738,45700,45318,1668,46986,548
2021-11-25,Santa Clara,085,1922200,151409,149700,1517,151217,1922
2021-11-25,Santa Cruz,087,273765,21252,20929,1034,21963,222
2021-11-25,Shasta,089,179085,22454,22151,3720,25871,396
2021-11-25,Sierra,091,2930,197,194,21,215,0
2021-11-25,Siskiyou,093,43540,3435,3336,1346,4682,54
2021-11-25,Solano,095,438530,46971,46163,1343,47506,356
2021-11-25,Sonoma,097,501317,42761,42368,557,42925,405
2021-11-25,Stanislaus,099,539301,80752,80782,9151,89933,1220
2021-11-25,Sutter,101,95872,14240,14127,382,14509,181
2021-11-25,Tehama,103,63373,8785,8675,1543,10218,129
2021-11-25,Trinity,105,12862,895,789,226,1015,17
2021-11-25,Tulare,107,460477,70698,69377,16054,85431,1082
2021-11-25,Tuolumne,109,53932,7615,7574,109,7683,90
2021-11-25,Ventura,111,848112,100065,99163,4408,103571,1188
2021-11-25,Yolo,113,214977,20413,20237,1238,21475,257
2021-11-25,Yuba,115,75493,10422,10335,371,10706,88
2021-11-24,Alameda,001,1643700,122608,121618,2934,124552,1477
2021-11-24,Alpine,003,1148,105,106,0,106,0
2021-11-24,Amador,005,37829,5720,5670,69,5739,66
2021-11-24,Butte,007,227075,21667,21384,3900,25284,309
2021-11-24,Calaveras,009,45235,4353,4294,62,4356,85
2021-11-24,Colusa,011,21464,2610,2568,670,3238,19
2021-11-24,Contra Costa,013,1133247,101791,100961,2311,103272,1045
2021-11-24,Del Norte,015,27424,3751,3661,56,3717,42
2021-11-24,El Dorado,017,186661,16666,16399,1759,18158,161
2021-11-24,Fresno,019,978130,145157,143386,12824,156210,2246
2021-11-24,Glenn,021,27897,3577,3532,1006,4538,36
2021-11-24,Humboldt,023,135768,9534,9399,655,10054,115
2021-11-24,Imperial,025,180216,35118,34611,3712,38323,769
2021-11-24,Inyo,027,18085,2538,2506,41,2547,45
2021-11-24,Kern,029,883053,132028,130245,23745,153990,1773
2021-11-24,Kings,031,150075,33326,32891,2035,34926,358
2021-11-24,Lake,033,64148,6904,6836,157,6993,110
2021-11-24,Lassen,035,31185,7043,6959,415,7374,47
2021-11-24,Los Angeles,037,10098052,1463394,1454495,55972,1510467,26817
2021-11-24,Madera,039,155013,24186,23880,2269,26149,296
2021-11-24,Marin,041,260295,18036,17857,498,18355,248
2021-11-24,Mariposa,043,17540,1419,1374,60,1434,6
2021-11-24,Mendocino,045,87422,8021,7871,652,8523,89
2021-11-24,Merced,047,269075,43250,42921,1949,44870,664
2021-11-24,Modoc,049,8938,590,551,203,754,5
2021-11-24,Mono,051,14174,1856,1810,23,1833,4
2021-11-24,Monterey,053,433212,49628,48400,3167,51567,625
2021-11-24,Napa,055,140530,13322,13256,120,13376,104
2021-11-24,Nevada,057,99092,9732,9584,343,9927,103
2021-11-24,Orange,059,3164182,313489,310809,15896,326705,5665
2021-11-24,Placer,061,380077,38486,38001,3849,41850,468
2021-11-24,Plumas,063,18699,1916,1860,44,1904,7
2021-11-24,Riverside,065,2383286,373270,367601,16760,384361,5306
2021-11-24,Sacramento,067,1510023,163716,162328,4918,167246,2335
2021-11-24,San Benito,069,59416,7629,7575,182,7757,77
2021-11-24,San Bernardino,071,2135413,363959,360033,11595,371628,5932
2021-11-24,San Diego,073,3302833,385770,382634,22348,404982,4319
2021-11-24,San Francisco,075,870044,54537,53830,2430,56260,669
2021-11-24,San Joaquin,077,732212,102323,101368,5642,107010,1833
2021-11-24,San Luis Obispo,079,281455,30496,29983,1300,31283,358
2021-11-24,San Mateo,081,765935,55547,54360,947,55307,577
2021-11-24,Santa Barbara,083,443738,45673,45318,1668,46986,548
2021-11-24,Santa Clara,085,1922200,151313,149700,1516,151216,1922
2021-11-24,Santa Cruz,087,273765,21228,20929,1033,21962,222
2021-11-24,Shasta,089,179085,22442,22151,3717,25868,396
2021-11-24,Sierra,091,2930,197,194,21,215,0
2021-11-24,Siskiyou,093,43540,3433,3336,1346,4682,54
2021-11-24,Solano,095,438530,46943,46163,1341,47504,356
2021-11-24,Sonoma,097,501317,42730,42368,555,42923,405
2021-11-24,Stanislaus,099,539301,80715,80782,9146,89928,1220
2021-11-24,Sutter,101,95872,14227,14127,380,14507,181
2021-11-24,Tehama,103,63373,8782,8675,1542,10217,129
2021-11-24,Trinity,105,12862,895,789,226,1015,17
2021-11-24,Tulare,107,460477,70673,69377,16035,85412,1082
2021-11-24,Tuolumne,109,53932,7611,7574,109,7683,90
2021-11-24,Ventura,111,848112,100030,99163,4404,103567,1188
2021-11-24,Yolo,113,214977,20405,20237,1237,21474,257
2021-11-24,Yuba,115,75493,10418,10335,370,10705,88
2021-11-23,Alameda,001,1643700,122491,121618,2926,124544,1477
2021-11-23,Alpine,003,1148,105,106,0,106,0
2021-11-23,Amador,005,37829,5713,5670,69,5739,66
2021-11-23,Butte,007,227075,21638,21384,3896,25280,309
2021-11-23,Calaveras,009,45235,4347,4294,61,4355,85
2021-11-23,Colusa,011,21464,2606,2568,668,3236,19
2021-11-23,Contra Costa,013,1133247,101683,100961,2309,103270,1045
2021-11-23,Del Norte,015,27424,3748,3661,56,3717,42
2021-11-23,El Dorado,017,186661,16634,16399,1756,18155,161
2021-11-23,Fresno,019,978130,145022,143386,12814,156200,2246
2021-11-23,Glenn,021,27897,3572,3532,1006,4538,36
2021-11-23,Humboldt,023,135768,9512,9399,652,10051,115
2021-11-23,Imperial,025,180216,35049,34611,3693,38304,769
2021-11-23,Inyo,027,18085,2534,2506,41,2547,45
2021-11-23,Kern,029,883053,131922,130245,23696,153941,1773
2021-11-23,Kings,031,150075,33285,32891,2034,34925,358
2021-11-23,Lake,033,64148,6899,6836,157,6993,110
2021-11-23,Lassen,035,31185,7039,6959,412,7371,47
2021-11-23,Los Angeles,037,10098052,1462381,1454495,55909,1510404,26817
2021-11-23,Madera,039,155013,24160,23880,2267,26147,296
2021-11-23,Marin,041,260295,18005,17857,494,18351,248
2021-11-23,Mariposa,043,17540,1416,1374,60,1434,6
2021-11-23,Mendocino,045,87422,8000,7871,649,8520,89
2021-11-23,Merced,047,269075,43212,42921,1948,44869,664
2021-11-23,Modoc,049,8938,588,551,203,754,5
2021-11-23,Mono,051,14174,1842,1810,23,1833,4
2021-11-23,Monterey,053,433212,49592,48400,3161,51561,625
2021-11-23,Napa,055,140530,13313,13256,120,13376,104
2021-11-23,Nevada,057,99092,9703,9584,342,9926,103
2021-11-23,Orange,059,3164182,313239,310809,15860,326669,5665
2021-11-23,Placer,061,380077,38428,38001,3832,41833,468
2021-11-23,Plumas,063,18699,1912,1860,44,1904,7
2021-11-23,Riverside,065,2383286,372887,367601,16747,384348,5306
2021-11-23,Sacramento,067,1510023,163531,162328,4907,167235,2335
2021-11-23,San Benito,069,59416,7621,7575,180,7755,77
2021-11-23,San Bernardino,071,2135413,363547,360033,11580,371613,5932
2021-11-23,San Diego,073,3302833,385279,382634,22325,404959,4319
2021-11-23,San Francisco,075,870044,54477,53830,2427,56257,669
2021-11-23,San Joaquin,077,732212,102214,101368,5631,106999,1833
2021-11-23,San Luis Obispo,079,281455,30461,29983,1297,31280,358
2021-11-23,San Mateo,081,765935,55497,54360,946,55306,577
2021-11-23,Santa Barbara,083,443738,45620,45318,1668,46986,548
2021-11-23,Santa Clara,085,1922200,151101,149700,1504,151204,1922
2021-11-23,Santa Cruz,087,273765,21190,20929,1033,21962,222
2021-11-23,Shasta,089,179085,22406,22151,3715,25866,396
2021-11-23,Sierra,091,2930,197,194,21,215,0
2021-11-23,Siskiyou,093,43540,3428,3336,1345,4681,54
2021-11-23,Solano,095,438530,46889,46163,1337,47500,356
2021-11-23,Sonoma,097,501317,42679,42368,552,42920,405
2021-11-23,Stanislaus,099,539301,80646,80782,9133,89915,1220
2021-11-23,Sutter,101,95872,14211,14127,379,14506,181
2021-11-23,Tehama,103,63373,8769,8675,1541,10216,129
2021-11-23,Trinity,105,12862,894,789,226,1015,17
2021-11-23,Tulare,107,460477,70626,69377,16005,85382,1082
2021-11-23,Tuolumne,109,53932,7599,7574,109,7683,90
2021-11-23,Ventura,111,848112,99947,99163,4398,103561,1188
2021-11-23,Yolo,113,214977,20384,20237,1229,21466,257
2021-11-23,Yuba,115,75493,10406,10335,370,10705,88
2021-11-22,Alameda,001,1643700,122378,121566,2923,124489,1475
2021-11-22,Alpine,003,1148,105,106,0,106,0
2021-11-22,Amador,005,37829,5700,5670,69,5739,66
2021-11-22,Butte,007,227075,21599,21363,3890,25253,305
2021-11-22,Calaveras,009,45235,4335,4294,61,4355,84
2021-11-22,Colusa,011,21464,2603,2565,668,3233,19
2021-11-22,Contra Costa,013,1133247,101594,100877,2304,103181,1045
2021-11-22,Del Norte,015,27424,3745,3659,56,3715,42
2021-11-22,El Dorado,017,186661,16611,16378,1753,18131,161
2021-11-22,Fresno,019,978130,144888,143290,12808,156098,2243
2021-11-22,Glenn,021,27897,3567,3530,1005,4535,36
2021-11-22,Humboldt,023,135768,9485,9389,647,10036,115
2021-11-22,Imperial,025,180216,34988,34562,3678,38240,766
2021-11-22,Inyo,027,18085,2528,2501,41,2542,44
2021-11-22,Kern,029,883053,131760,130091,23645,153736,1762
2021-11-22,Kings,031,150075,33249,32867,2029,34896,358
2021-11-22,Lake,033,64148,6894,6837,157,6994,110
2021-11-22,Lassen,035,31185,7038,6954,411,7365,47
2021-11-22,Los Angeles,037,10098052,1461313,1453945,55831,1509776,26800
2021-11-22,Madera,039,155013,24126,23872,2260,26132,296
2021-11-22,Marin,041,260295,17974,17842,492,18334,248
2021-11-22,Mariposa,043,17540,1412,1372,60,1432,6
2021-11-22,Mendocino,045,87422,7984,7859,648,8507,89
2021-11-22,Merced,047,269075,43161,42898,1937,44835,660
2021-11-22,Modoc,049,8938,587,551,203,754,5
2021-11-22,Mono,051,14174,1835,1809,23,1832,4
2021-11-22,Monterey,053,433212,49565,48374,3157,51531,611
2021-11-22,Napa,055,140530,13305,13255,119,13374,104
2021-11-22,Nevada,057,99092,9686,9575,340,9915,96
2021-11-22,Orange,059,3164182,312999,310654,15834,326488,5663
2021-11-22,Placer,061,380077,38383,37956,3824,41780,465
2021-11-22,Plumas,063,18699,1909,1858,44,1902,7
2021-11-22,Riverside,065,2383286,372450,367301,16737,384038,5283
2021-11-22,Sacramento,067,1510023,163338,162222,4898,167120,2328
2021-11-22,San Benito,069,59416,7601,7567,180,7747,77
2021-11-22,San Bernardino,071,2135413,363136,359851,11570,371421,5916
2021-11-22,San Diego,073,3302833,384784,382132,22301,404433,4317
2021-11-22,San Francisco,075,870044,54385,53778,2421,56199,669
2021-11-22,San Joaquin,077,732212,102089,101299,5626,106925,1833
2021-11-22,San Luis Obispo,079,281455,30435,29963,1296,31259,358
2021-11-22,San Mateo,081,765935,55440,54330,944,55274,577
2021-11-22,Santa Barbara,083,443738,45544,45279,1668,46947,546
2021-11-22,Santa Clara,085,1922200,150916,149541,1494,151035,1919
2021-11-22,Santa Cruz,087,273765,21149,20891,1033,21924,222
2021-11-22,Shasta,089,179085,22392,22116,3710,25826,393
2021-11-22,Sierra,091,2930,197,193,21,214,0
2021-11-22,Siskiyou,093,43540,3423,3336,1343,4679,54
2021-11-22,Solano,095,438530,46840,46153,1335,47488,356
2021-11-22,Sonoma,097,501317,42618,42344,551,42895,404
2021-11-22,Stanislaus,099,539301,80557,80718,9123,89841,1209
2021-11-22,Sutter,101,95872,14195,14125,377,14502,181
2021-11-22,Tehama,103,63373,8762,8669,1536,10205,127
2021-11-22,Trinity,105,12862,893,785,226,1011,17
2021-11-22,Tulare,107,460477,70562,69314,15968,85282,1075
2021-11-22,Tuolumne,109,53932,7584,7567,109,7676,90
2021-11-22,Ventura,111,848112,99881,99114,4395,103509,1186
2021-11-22,Yolo,113,214977,20361,20227,1227,21454,257
2021-11-22,Yuba,115,75493,10397,10332,369,10701,88
2021-11-21,Alameda,001,1643700,122249,121443,2919,124362,1475
2021-11-21,Alpine,003,1148,103,106,0,106,0
2021-11-21,Amador,005,37829,5695,5662,68,5730,66
2021-11-21,Butte,007,227075,21558,21342,3885,25227,306
2021-11-21,Calaveras,009,45235,4326,4287,61,4348,84
2021-11-21,Colusa,011,21464,2599,2562,667,3229,19
2021-11-21,Contra Costa,013,1133247,101491,100807,2298,103105,1045
2021-11-21,Del Norte,015,27424,3741,3659,56,3715,42
2021-11-21,El Dorado,017,186661,16584,16370,1747,18117,161
2021-11-21,Fresno,019,978130,144720,143203,12793,155996,2242
2021-11-21,Glenn,021,27897,3563,3529,1005,4534,36
2021-11-21,Humboldt,023,135768,9463,9378,646,10024,115
2021-11-21,Imperial,025,180216,34900,34527,3667,38194,766
2021-11-21,Inyo,027,18085,2521,2501,41,2542,44
2021-11-21,Kern,029,883053,131596,130020,23599,153619,1762
2021-11-21,Kings,031,150075,33211,32843,2025,34868,356
2021-11-21,Lake,033,64148,6887,6834,157,6991,110
2021-11-21,Lassen,035,31185,7029,6953,411,7364,47
2021-11-21,Los Angeles,037,10098052,1460245,1453181,55783,1508964,26793
2021-11-21,Madera,039,155013,24100,23856,2255,26111,296
2021-11-21,Marin,041,260295,17945,17829,489,18318,248
2021-11-21,Mariposa,043,17540,1411,1371,59,1430,6
2021-11-21,Mendocino,045,87422,7978,7846,645,8491,89
2021-11-21,Merced,047,269075,43106,42881,1933,44814,660
2021-11-21,Modoc,049,8938,583,551,203,754,5
2021-11-21,Mono,051,14174,1825,1799,22,1821,4
2021-11-21,Monterey,053,433212,49519,48358,3148,51506,611
2021-11-21,Napa,055,140530,13292,13250,119,13369,104
2021-11-21,Nevada,057,99092,9660,9556,339,9895,96
2021-11-21,Orange,059,3164182,312741,310477,15801,326278,5663
2021-11-21,Placer,061,380077,38301,37929,3823,41752,465
2021-11-21,Plumas,063,18699,1908,1858,44,1902,7
2021-11-21,Riverside,065,2383286,371962,367093,16729,383822,5283
2021-11-21,Sacramento,067,1510023,163119,162087,4888,166975,2327
2021-11-21,San Benito,069,59416,7587,7563,179,7742,77
2021-11-21,San Bernardino,071,2135413,362652,359621,11535,371156,5912
2021-11-21,San Diego,073,3302833,384246,380747,22276,403023,4317
2021-11-21,San Francisco,075,870044,54316,53741,2416,56157,669
2021-11-21,San Joaquin,077,732212,101984,101264,5613,106877,1833
2021-11-21,San Luis Obispo,079,281455,30397,29948,1296,31244,358
2021-11-21,San Mateo,081,765935,55387,54290,942,55232,577
2021-11-21,Santa Barbara,083,443738,45483,45237,1665,46902,546
2021-11-21,Santa Clara,085,1922200,150710,149387,1474,150861,1918
2021-11-21,Santa Cruz,087,273765,21105,20866,1031,21897,222
2021-11-21,Shasta,089,179085,22361,22112,3708,25820,393
2021-11-21,Sierra,091,2930,197,193,21,214,0
2021-11-21,Siskiyou,093,43540,3418,3333,1342,4675,54
2021-11-21,Solano,095,438530,46784,46122,1328,47450,356
2021-11-21,Sonoma,097,501317,42558,42298,550,42848,404
2021-11-21,Stanislaus,099,539301,80463,80687,9109,89796,1209
2021-11-21,Sutter,101,95872,14181,14111,377,14488,181
2021-11-21,Tehama,103,63373,8756,8669,1535,10204,127
2021-11-21,Trinity,105,12862,891,784,224,1008,17
2021-11-21,Tulare,107,460477,70478,69285,15928,85213,1075
2021-11-21,Tuolumne,109,53932,7576,7560,108,7668,90
2021-11-21,Ventura,111,848112,99790,99081,4391,103472,1186
2021-11-21,Yolo,113,214977,20333,20209,1224,21433,257
2021-11-21,Yuba,115,75493,10388,10326,369,10695,88
2021-11-20,Alameda,001,1643700,122155,121059,2913,123972,1473
2021-11-20,Alpine,003,1148,103,105,0,105,0
2021-11-20,Amador,005,37829,5689,5652,67,5719,66
2021-11-20,Butte,007,227075,21542,21265,3881,25146,300
2021-11-20,Calaveras,009,45235,4317,4268,61,4329,84
2021-11-20,Colusa,011,21464,2598,2549,666,3215,19
2021-11-20,Contra Costa,013,1133247,101414,100491,2294,102785,1043
2021-11-20,Del Norte,015,27424,3738,3637,56,3693,42
2021-11-20,El Dorado,017,186661,16562,16308,1745,18053,161
2021-11-20,Fresno,019,978130,144649,142579,12786,155365,2233
2021-11-20,Glenn,021,27897,3562,3526,1004,4530,35
2021-11-20,Humboldt,023,135768,9450,9302,644,9946,115
2021-11-20,Imperial,025,180216,34848,34312,3661,37973,766
2021-11-20,Inyo,027,18085,2520,2467,41,2508,44
2021-11-20,Kern,029,883053,131496,129488,23562,153050,1750
2021-11-20,Kings,031,150075,33201,32720,2025,34745,354
2021-11-20,Lake,033,64148,6884,6808,157,6965,110
2021-11-20,Lassen,035,31185,7028,6931,411,7342,47
2021-11-20,Los Angeles,037,10098052,1459630,1448963,55737,1504700,26741
2021-11-20,Madera,039,155013,24088,23720,2252,25972,296
2021-11-20,Marin,041,260295,17930,17774,489,18263,248
2021-11-20,Mariposa,043,17540,1410,1354,59,1413,6
2021-11-20,Mendocino,045,87422,7970,7773,645,8418,89
2021-11-20,Merced,047,269075,43080,42692,1933,44625,656
2021-11-20,Modoc,049,8938,582,550,203,753,5
2021-11-20,Mono,051,14174,1819,1767,22,1789,4
2021-11-20,Monterey,053,433212,49506,48260,3140,51400,609
2021-11-20,Napa,055,140530,13289,13184,119,13303,103
2021-11-20,Nevada,057,99092,9644,9480,339,9819,92
2021-11-20,Orange,059,3164182,312543,309672,15784,325456,5658
2021-11-20,Placer,061,380077,38261,37800,3818,41618,462
2021-11-20,Plumas,063,18699,1904,1841,44,1885,7
2021-11-20,Riverside,065,2383286,371690,365809,16717,382526,5265
2021-11-20,Sacramento,067,1510023,163015,161533,4884,166417,2316
2021-11-20,San Benito,069,59416,7583,7533,179,7712,77
2021-11-20,San Bernardino,071,2135413,362384,358322,11524,369846,5897
2021-11-20,San Diego,073,3302833,383913,380147,22250,402397,4311
2021-11-20,San Francisco,075,870044,54278,53525,2415,55940,669
2021-11-20,San Joaquin,077,732212,101934,100922,5608,106530,1832
2021-11-20,San Luis Obispo,079,281455,30382,29815,1295,31110,355
2021-11-20,San Mateo,081,765935,55353,54132,941,55073,577
2021-11-20,Santa Barbara,083,443738,45451,45074,1665,46739,544
2021-11-20,Santa Clara,085,1922200,150603,148829,1473,150302,1917
2021-11-20,Santa Cruz,087,273765,21087,20756,1031,21787,222
2021-11-20,Shasta,089,179085,22337,21968,3707,25675,383
2021-11-20,Sierra,091,2930,197,191,21,212,0
2021-11-20,Siskiyou,093,43540,3415,3313,1342,4655,54
2021-11-20,Solano,095,438530,46763,46006,1328,47334,356
2021-11-20,Sonoma,097,501317,42527,42151,550,42701,403
2021-11-20,Stanislaus,099,539301,80417,80412,9105,89517,1205
2021-11-20,Sutter,101,95872,14173,14074,377,14451,181
2021-11-20,Tehama,103,63373,8751,8648,1535,10183,125
2021-11-20,Trinity,105,12862,887,771,224,995,17
2021-11-20,Tulare,107,460477,70439,69074,15906,84980,1054
2021-11-20,Tuolumne,109,53932,7567,7511,108,7619,90
2021-11-20,Ventura,111,848112,99741,98893,4384,103277,1186
2021-11-20,Yolo,113,214977,20325,20139,1220,21359,257
2021-11-20,Yuba,115,75493,10382,10290,368,10658,88
2021-11-19,Alameda,001,1643700,122080,121059,2910,123969,1473
2021-11-19,Alpine,003,1148,103,105,0,105,0
2021-11-19,Amador,005,37829,5679,5652,67,5719,66
2021-11-19,Butte,007,227075,21519,21265,3874,25139,300
2021-11-19,Calaveras,009,45235,4310,4268,61,4329,84
2021-11-19,Colusa,011,21464,2596,2549,665,3214,19
2021-11-19,Contra Costa,013,1133247,101358,100491,2289,102780,1043
2021-11-19,Del Norte,015,27424,3733,3637,56,3693,42
2021-11-19,El Dorado,017,186661,16541,16308,1743,18051,161
2021-11-19,Fresno,019,978130,144531,142579,12782,155361,2233
2021-11-19,Glenn,021,27897,3561,3526,1003,4529,35
2021-11-19,Humboldt,023,135768,9437,9302,641,9943,115
2021-11-19,Imperial,025,180216,34810,34312,3654,37966,766
2021-11-19,Inyo,027,18085,2516,2467,41,2508,44
2021-11-19,Kern,029,883053,131392,129488,23519,153007,1750
2021-11-19,Kings,031,150075,33175,32720,2023,34743,354
2021-11-19,Lake,033,64148,6881,6808,157,6965,110
2021-11-19,Lassen,035,31185,7024,6931,410,7341,47
2021-11-19,Los Angeles,037,10098052,1458948,1448963,55682,1504645,26741
2021-11-19,Madera,039,155013,24067,23720,2248,25968,296
2021-11-19,Marin,041,260295,17911,17774,487,18261,248
2021-11-19,Mariposa,043,17540,1408,1354,59,1413,6
2021-11-19,Mendocino,045,87422,7950,7773,645,8418,89
2021-11-19,Merced,047,269075,43054,42692,1932,44624,656
2021-11-19,Modoc,049,8938,581,550,203,753,5
2021-11-19,Mono,051,14174,1808,1767,22,1789,4
2021-11-19,Monterey,053,433212,49484,48260,3140,51400,609
2021-11-19,Napa,055,140530,13279,13184,118,13302,103
2021-11-19,Nevada,057,99092,9631,9480,339,9819,92
2021-11-19,Orange,059,3164182,312390,309672,15759,325431,5658
2021-11-19,Placer,061,380077,38224,37800,3814,41614,462
2021-11-19,Plumas,063,18699,1900,1841,44,1885,7
2021-11-19,Riverside,065,2383286,371416,365809,16713,382522,5265
2021-11-19,Sacramento,067,1510023,162890,161533,4880,166413,2316
2021-11-19,San Benito,069,59416,7577,7533,177,7710,77
2021-11-19,San Bernardino,071,2135413,362067,358322,11515,369837,5897
2021-11-19,San Diego,073,3302833,383512,380147,22223,402370,4311
2021-11-19,San Francisco,075,870044,54240,53525,2415,55940,669
2021-11-19,San Joaquin,077,732212,101876,100922,5604,106526,1832
2021-11-19,San Luis Obispo,079,281455,30364,29815,1293,31108,355
2021-11-19,San Mateo,081,765935,55304,54132,937,55069,577
2021-11-19,Santa Barbara,083,443738,45414,45074,1665,46739,544
2021-11-19,Santa Clara,085,1922200,150455,148829,1470,150299,1917
2021-11-19,Santa Cruz,087,273765,21060,20756,1028,21784,222
2021-11-19,Shasta,089,179085,22325,21968,3706,25674,383
2021-11-19,Sierra,091,2930,197,191,21,212,0
2021-11-19,Siskiyou,093,43540,3412,3313,1342,4655,54
2021-11-19,Solano,095,438530,46733,46006,1324,47330,356
2021-11-19,Sonoma,097,501317,42494,42151,547,42698,403
2021-11-19,Stanislaus,099,539301,80360,80412,9095,89507,1205
2021-11-19,Sutter,101,95872,14171,14074,377,14451,181
2021-11-19,Tehama,103,63373,8748,8648,1535,10183,125
2021-11-19,Trinity,105,12862,885,771,224,995,17
2021-11-19,Tulare,107,460477,70399,69074,15878,84952,1054
2021-11-19,Tuolumne,109,53932,7556,7511,108,7619,90
2021-11-19,Ventura,111,848112,99676,98893,4380,103273,1186
2021-11-19,Yolo,113,214977,20314,20139,1217,21356,257
2021-11-19,Yuba,115,75493,10379,10290,368,10658,88
2021-11-18,Alameda,001,1643700,121956,121059,2903,123962,1473
2021-11-18,Alpine,003,1148,103,105,0,105,0
2021-11-18,Amador,005,37829,5677,5652,67,5719,66
2021-11-18,Butte,007,227075,21502,21265,3867,25132,300
2021-11-18,Calaveras,009,45235,4303,4268,60,4328,84
2021-11-18,Colusa,011,21464,2588,2549,665,3214,19
2021-11-18,Contra Costa,013,1133247,101256,100491,2281,102772,1043
2021-11-18,Del Norte,015,27424,3730,3637,56,3693,42
2021-11-18,El Dorado,017,186661,16522,16308,1740,18048,161
2021-11-18,Fresno,019,978130,144391,142579,12773,155352,2233
2021-11-18,Glenn,021,27897,3560,3526,1002,4528,35
2021-11-18,Humboldt,023,135768,9421,9302,636,9938,115
2021-11-18,Imperial,025,180216,34756,34312,3638,37950,766
2021-11-18,Inyo,027,18085,2508,2467,41,2508,44
2021-11-18,Kern,029,883053,131248,129488,23471,152959,1750
2021-11-18,Kings,031,150075,33138,32720,2020,34740,354
2021-11-18,Lake,033,64148,6876,6808,157,6965,110
2021-11-18,Lassen,035,31185,7021,6931,405,7336,47
2021-11-18,Los Angeles,037,10098052,1457965,1448963,55618,1504581,26741
2021-11-18,Madera,039,155013,24042,23720,2245,25965,296
2021-11-18,Marin,041,260295,17894,17774,483,18257,248
2021-11-18,Mariposa,043,17540,1405,1354,59,1413,6
2021-11-18,Mendocino,045,87422,7928,7773,636,8409,89
2021-11-18,Merced,047,269075,42998,42692,1930,44622,656
2021-11-18,Modoc,049,8938,569,550,203,753,5
2021-11-18,Mono,051,14174,1800,1767,22,1789,4
2021-11-18,Monterey,053,433212,49459,48260,3135,51395,609
2021-11-18,Napa,055,140530,13267,13184,117,13301,103
2021-11-18,Nevada,057,99092,9607,9480,339,9819,92
2021-11-18,Orange,059,3164182,312154,309672,15740,325412,5658
2021-11-18,Placer,061,380077,38181,37800,3803,41603,462
2021-11-18,Plumas,063,18699,1899,1841,44,1885,7
2021-11-18,Riverside,065,2383286,371045,365809,16700,382509,5265
2021-11-18,Sacramento,067,1510023,162663,161533,4865,166398,2316
2021-11-18,San Benito,069,59416,7567,7533,177,7710,77
2021-11-18,San Bernardino,071,2135413,361636,358322,11496,369818,5897
2021-11-18,San Diego,073,3302833,383006,380147,22207,402354,4311
2021-11-18,San Francisco,075,870044,54188,53525,2411,55936,669
2021-11-18,San Joaquin,077,732212,101784,100922,5595,106517,1832
2021-11-18,San Luis Obispo,079,281455,30334,29815,1292,31107,355
2021-11-18,San Mateo,081,765935,55246,54132,934,55066,577
2021-11-18,Santa Barbara,083,443738,45368,45074,1658,46732,544
2021-11-18,Santa Clara,085,1922200,150268,148829,1462,150291,1917
2021-11-18,Santa Cruz,087,273765,21009,20756,1027,21783,222
2021-11-18,Shasta,089,179085,22289,21968,3701,25669,383
2021-11-18,Sierra,091,2930,196,191,21,212,0
2021-11-18,Siskiyou,093,43540,3412,3313,1338,4651,54
2021-11-18,Solano,095,438530,46691,46006,1321,47327,356
2021-11-18,Sonoma,097,501317,42446,42151,545,42696,403
2021-11-18,Stanislaus,099,539301,80293,80412,9087,89499,1205
2021-11-18,Sutter,101,95872,14160,14074,376,14450,181
2021-11-18,Tehama,103,63373,8743,8648,1535,10183,125
2021-11-18,Trinity,105,12862,884,771,224,995,17
2021-11-18,Tulare,107,460477,70326,69074,15829,84903,1054
2021-11-18,Tuolumne,109,53932,7546,7511,108,7619,90
2021-11-18,Ventura,111,848112,99598,98893,4376,103269,1186
2021-11-18,Yolo,113,214977,20297,20139,1212,21351,257
2021-11-18,Yuba,115,75493,10373,10290,368,10658,88
2021-11-17,Alameda,001,1643700,121831,120913,2902,123815,1472
2021-11-17,Alpine,003,1148,103,105,0,105,0
2021-11-17,Amador,005,37829,5670,5646,67,5713,66
2021-11-17,Butte,007,227075,21476,21230,3864,25094,300
2021-11-17,Calaveras,009,45235,4296,4259,60,4319,84
2021-11-17,Colusa,011,21464,2585,2546,664,3210,19
2021-11-17,Contra Costa,013,1133247,101164,100387,2277,102664,1039
2021-11-17,Del Norte,015,27424,3727,3630,56,3686,42
2021-11-17,El Dorado,017,186661,16503,16269,1739,18008,161
2021-11-17,Fresno,019,978130,144210,142366,12762,155128,2230
2021-11-17,Glenn,021,27897,3558,3527,1001,4528,34
2021-11-17,Humboldt,023,135768,9410,9270,633,9903,115
2021-11-17,Imperial,025,180216,34700,34256,3617,37873,766
2021-11-17,Inyo,027,18085,2502,2457,41,2498,44
2021-11-17,Kern,029,883053,131076,129307,23429,152736,1743
2021-11-17,Kings,031,150075,33110,32669,2016,34685,352
2021-11-17,Lake,033,64148,6872,6795,156,6951,110
2021-11-17,Lassen,035,31185,7019,6918,405,7323,47
2021-11-17,Los Angeles,037,10098052,1456864,1447947,55552,1503499,26721
2021-11-17,Madera,039,155013,24008,23673,2243,25916,287
2021-11-17,Marin,041,260295,17875,17757,481,18238,248
2021-11-17,Mariposa,043,17540,1401,1353,59,1412,6
2021-11-17,Mendocino,045,87422,7920,7735,635,8370,89
2021-11-17,Merced,047,269075,42938,42612,1927,44539,654
2021-11-17,Modoc,049,8938,565,540,203,743,5
2021-11-17,Mono,051,14174,1796,1765,22,1787,5
2021-11-17,Monterey,053,433212,49411,48221,3124,51345,609
2021-11-17,Napa,055,140530,13243,13167,117,13284,103
2021-11-17,Nevada,057,99092,9594,9447,339,9786,92
2021-11-17,Orange,059,3164182,311908,309396,15706,325102,5651
2021-11-17,Placer,061,380077,38133,37725,3794,41519,460
2021-11-17,Plumas,063,18699,1895,1833,44,1877,7
2021-11-17,Riverside,065,2383286,370634,365406,16687,382093,5229
2021-11-17,Sacramento,067,1510023,162491,161269,4857,166126,2302
2021-11-17,San Benito,069,59416,7560,7524,177,7701,77
2021-11-17,San Bernardino,071,2135413,361279,357947,11480,369427,5893
2021-11-17,San Diego,073,3302833,382507,379769,22181,401950,4301
2021-11-17,San Francisco,075,870044,54133,53469,2408,55877,667
2021-11-17,San Joaquin,077,732212,101682,100764,5590,106354,1828
2021-11-17,San Luis Obispo,079,281455,30308,29731,1289,31020,354
2021-11-17,San Mateo,081,765935,55178,54092,931,55023,577
2021-11-17,Santa Barbara,083,443738,45330,45000,1658,46658,542
2021-11-17,Santa Clara,085,1922200,150104,148626,1454,150080,1915
2021-11-17,Santa Cruz,087,273765,20974,20700,1027,21727,222
2021-11-17,Shasta,089,179085,22256,21883,3699,25582,382
2021-11-17,Sierra,091,2930,195,189,21,210,0
2021-11-17,Siskiyou,093,43540,3408,3307,1335,4642,54
2021-11-17,Solano,095,438530,46658,45948,1320,47268,353
2021-11-17,Sonoma,097,501317,42400,42093,542,42635,403
2021-11-17,Stanislaus,099,539301,80205,80276,9077,89353,1199
2021-11-17,Sutter,101,95872,14146,14064,374,14438,181
2021-11-17,Tehama,103,63373,8733,8633,1532,10165,125
2021-11-17,Trinity,105,12862,883,765,224,989,17
2021-11-17,Tulare,107,460477,70255,68977,15802,84779,1047
2021-11-17,Tuolumne,109,53932,7529,7485,108,7593,90
2021-11-17,Ventura,111,848112,99537,98812,4370,103182,1183
2021-11-17,Yolo,113,214977,20278,20100,1208,21308,257
2021-11-17,Yuba,115,75493,10361,10275,364,10639,88
2021-11-16,Alameda,001,1643700,121721,120809,2898,123707,1467
2021-11-16,Alpine,003,1148,103,105,0,105,0
2021-11-16,Amador,005,37829,5664,5644,67,5711,66
2021-11-16,Butte,007,227075,21451,21208,3859,25067,297
2021-11-16,Calaveras,009,45235,4287,4249,60,4309,83
2021-11-16,Colusa,011,21464,2579,2538,664,3202,19
2021-11-16,Contra Costa,013,1133247,101040,100320,2274,102594,1038
2021-11-16,Del Norte,015,27424,3721,3630,56,3686,42
2021-11-16,El Dorado,017,186661,16477,16248,1737,17985,159
2021-11-16,Fresno,019,978130,144023,142200,12746,154946,2218
2021-11-16,Glenn,021,27897,3557,3527,998,4525,34
2021-11-16,Humboldt,023,135768,9389,9252,629,9881,115
2021-11-16,Imperial,025,180216,34616,34177,3603,37780,766
2021-11-16,Inyo,027,18085,2495,2449,41,2490,42
2021-11-16,Kern,029,883053,130919,129136,23367,152503,1735
2021-11-16,Kings,031,150075,33060,32614,2009,34623,350
2021-11-16,Lake,033,64148,6867,6789,156,6945,110
2021-11-16,Lassen,035,31185,7009,6915,405,7320,47
2021-11-16,Los Angeles,037,10098052,1455701,1446815,55480,1502295,26703
2021-11-16,Madera,039,155013,23971,23642,2237,25879,287
2021-11-16,Marin,041,260295,17856,17736,480,18216,248
2021-11-16,Mariposa,043,17540,1393,1349,58,1407,6
2021-11-16,Mendocino,045,87422,7878,7723,631,8354,89
2021-11-16,Merced,047,269075,42901,42578,1920,44498,653
2021-11-16,Modoc,049,8938,564,539,202,741,5
2021-11-16,Mono,051,14174,1787,1767,22,1789,4
2021-11-16,Monterey,053,433212,49381,48195,3110,51305,609
2021-11-16,Napa,055,140530,13232,13151,117,13268,103
2021-11-16,Nevada,057,99092,9577,9435,338,9773,92
2021-11-16,Orange,059,3164182,311641,309170,15672,324842,5651
2021-11-16,Placer,061,380077,38091,37676,3788,41464,459
2021-11-16,Plumas,063,18699,1888,1832,44,1876,7
2021-11-16,Riverside,065,2383286,370213,365078,16665,381743,5208
2021-11-16,Sacramento,067,1510023,162312,161102,4844,165946,2299
2021-11-16,San Benito,069,59416,7547,7513,177,7690,77
2021-11-16,San Bernardino,071,2135413,360867,357528,11428,368956,5901
2021-11-16,San Diego,073,3302833,381949,379435,22154,401589,4287
2021-11-16,San Francisco,075,870044,54060,53415,2401,55816,667
2021-11-16,San Joaquin,077,732212,101542,100637,5574,106211,1807
2021-11-16,San Luis Obispo,079,281455,30277,29703,1286,30989,356
2021-11-16,San Mateo,081,765935,55116,54034,929,54963,577
2021-11-16,Santa Barbara,083,443738,45262,44932,1655,46587,539
2021-11-16,Santa Clara,085,1922200,149924,148452,1442,149894,1916
2021-11-16,Santa Cruz,087,273765,20929,20684,1025,21709,222
2021-11-16,Shasta,089,179085,22217,21853,3695,25548,379
2021-11-16,Sierra,091,2930,195,189,21,210,0
2021-11-16,Siskiyou,093,43540,3405,3304,1333,4637,54
2021-11-16,Solano,095,438530,46618,45908,1319,47227,351
2021-11-16,Sonoma,097,501317,42351,42056,541,42597,401
2021-11-16,Stanislaus,099,539301,80109,80214,9053,89267,1196
2021-11-16,Sutter,101,95872,14134,14058,373,14431,181
2021-11-16,Tehama,103,63373,8726,8621,1525,10146,125
2021-11-16,Trinity,105,12862,883,762,223,985,17
2021-11-16,Tulare,107,460477,70175,68881,15764,84645,1039
2021-11-16,Tuolumne,109,53932,7519,7478,108,7586,90
2021-11-16,Ventura,111,848112,99462,98731,4367,103098,1183
2021-11-16,Yolo,113,214977,20239,20077,1206,21283,257
2021-11-16,Yuba,115,75493,10353,10262,362,10624,85
2021-11-15,Alameda,001,1643700,121566,120731,2893,123624,1464
2021-11-15,Alpine,003,1148,103,105,0,105,0
2021-11-15,Amador,005,37829,5660,5637,67,5704,66
2021-11-15,Butte,007,227075,21425,21182,3855,25037,296
2021-11-15,Calaveras,009,45235,4273,4237,60,4297,83
2021-11-15,Colusa,011,21464,2572,2535,661,3196,19
2021-11-15,Contra Costa,013,1133247,100933,100251,2271,102522,1038
2021-11-15,Del Norte,015,27424,3716,3630,55,3685,42
2021-11-15,El Dorado,017,186661,16453,16236,1733,17969,159
2021-11-15,Fresno,019,978130,143799,142015,12730,154745,2210
2021-11-15,Glenn,021,27897,3555,3526,998,4524,34
2021-11-15,Humboldt,023,135768,9366,9230,621,9851,115
2021-11-15,Imperial,025,180216,34543,34130,3587,37717,766
2021-11-15,Inyo,027,18085,2490,2442,41,2483,42
2021-11-15,Kern,029,883053,130711,128928,23296,152224,1730
2021-11-15,Kings,031,150075,33026,32584,2004,34588,348
2021-11-15,Lake,033,64148,6863,6784,156,6940,109
2021-11-15,Lassen,035,31185,6999,6915,403,7318,47
2021-11-15,Los Angeles,037,10098052,1454515,1446114,55414,1501528,26677
2021-11-15,Madera,039,155013,23932,23605,2226,25831,287
2021-11-15,Marin,041,260295,17839,17723,479,18202,248
2021-11-15,Mariposa,043,17540,1392,1347,56,1403,6
2021-11-15,Mendocino,045,87422,7858,7694,625,8319,89
2021-11-15,Merced,047,269075,42842,42552,1910,44462,648
2021-11-15,Modoc,049,8938,563,538,201,739,5
2021-11-15,Mono,051,14174,1782,1763,22,1785,4
2021-11-15,Monterey,053,433212,49349,48154,3104,51258,609
2021-11-15,Napa,055,140530,13224,13143,117,13260,103
2021-11-15,Nevada,057,99092,9548,9420,337,9757,92
2021-11-15,Orange,059,3164182,311365,308859,15648,324507,5646
2021-11-15,Placer,061,380077,38027,37610,3784,41394,452
2021-11-15,Plumas,063,18699,1882,1829,44,1873,7
2021-11-15,Riverside,065,2383286,369767,364750,16646,381396,5199
2021-11-15,Sacramento,067,1510023,162092,160937,4831,165768,2293
2021-11-15,San Benito,069,59416,7542,7511,176,7687,77
2021-11-15,San Bernardino,071,2135413,360453,357306,11408,368714,5898
2021-11-15,San Diego,073,3302833,381399,378845,22129,400974,4284
2021-11-15,San Francisco,075,870044,53992,53374,2398,55772,667
2021-11-15,San Joaquin,077,732212,101388,100587,5563,106150,1799
2021-11-15,San Luis Obispo,079,281455,30234,29669,1274,30943,351
2021-11-15,San Mateo,081,765935,55063,54010,926,54936,576
2021-11-15,Santa Barbara,083,443738,45206,44879,1649,46528,539
2021-11-15,Santa Clara,085,1922200,149706,148313,1435,149748,1914
2021-11-15,Santa Cruz,087,273765,20887,20630,1024,21654,223
2021-11-15,Shasta,089,179085,22171,21779,3690,25469,374
2021-11-15,Sierra,091,2930,195,189,21,210,0
2021-11-15,Siskiyou,093,43540,3398,3302,1331,4633,54
2021-11-15,Solano,095,438530,46579,45885,1314,47199,351
2021-11-15,Sonoma,097,501317,42300,42021,540,42561,401
2021-11-15,Stanislaus,099,539301,80023,80129,9039,89168,1174
2021-11-15,Sutter,101,95872,14121,14043,372,14415,181
2021-11-15,Tehama,103,63373,8721,8615,1524,10139,125
2021-11-15,Trinity,105,12862,881,757,221,978,17
2021-11-15,Tulare,107,460477,70088,68826,15717,84543,1039
2021-11-15,Tuolumne,109,53932,7508,7461,108,7569,90
2021-11-15,Ventura,111,848112,99378,98605,4362,102967,1183
2021-11-15,Yolo,113,214977,20209,20065,1201,21266,255
2021-11-15,Yuba,115,75493,10334,10254,358,10612,85
2021-11-14,Alameda,001,1643700,121391,120629,2889,123518,1461
2021-11-14,Alpine,003,1148,102,105,0,105,0
2021-11-14,Amador,005,37829,5653,5632,66,5698,66
2021-11-14,Butte,007,227075,21395,21146,3846,24992,296
2021-11-14,Calaveras,009,45235,4262,4222,60,4282,83
2021-11-14,Colusa,011,21464,2570,2532,658,3190,19
2021-11-14,Contra Costa,013,1133247,100823,100188,2269,102457,1038
2021-11-14,Del Norte,015,27424,3713,3629,55,3684,42
2021-11-14,El Dorado,017,186661,16412,16212,1728,17940,159
2021-11-14,Fresno,019,978130,143517,141869,12699,154568,2209
2021-11-14,Glenn,021,27897,3553,3521,998,4519,34
2021-11-14,Humboldt,023,135768,9336,9215,611,9826,115
2021-11-14,Imperial,025,180216,34439,34078,3572,37650,766
2021-11-14,Inyo,027,18085,2478,2441,41,2482,42
2021-11-14,Kern,029,883053,130471,128842,23226,152068,1730
2021-11-14,Kings,031,150075,32969,32545,1997,34542,349
2021-11-14,Lake,033,64148,6855,6777,156,6933,109
2021-11-14,Lassen,035,31185,6989,6911,402,7313,47
2021-11-14,Los Angeles,037,10098052,1453154,1445284,55338,1500622,26667
2021-11-14,Madera,039,155013,23882,23566,2217,25783,287
2021-11-14,Marin,041,260295,17824,17712,479,18191,247
2021-11-14,Mariposa,043,17540,1382,1337,52,1389,6
2021-11-14,Mendocino,045,87422,7825,7684,621,8305,89
2021-11-14,Merced,047,269075,42752,42513,1904,44417,648
2021-11-14,Modoc,049,8938,561,538,201,739,5
2021-11-14,Mono,051,14174,1770,1760,22,1782,4
2021-11-14,Monterey,053,433212,49294,48135,3087,51222,609
2021-11-14,Napa,055,140530,13206,13132,117,13249,103
2021-11-14,Nevada,057,99092,9520,9408,337,9745,92
2021-11-14,Orange,059,3164182,311049,308699,15627,324326,5646
2021-11-14,Placer,061,380077,37946,37569,3774,41343,452
2021-11-14,Plumas,063,18699,1879,1829,43,1872,7
2021-11-14,Riverside,065,2383286,369269,364490,16629,381119,5199
2021-11-14,Sacramento,067,1510023,161854,160761,4814,165575,2295
2021-11-14,San Benito,069,59416,7531,7507,175,7682,77
2021-11-14,San Bernardino,071,2135413,359873,357014,11391,368405,5897
2021-11-14,San Diego,073,3302833,380795,377633,22096,399729,4280
2021-11-14,San Francisco,075,870044,53917,53338,2393,55731,667
2021-11-14,San Joaquin,077,732212,101260,100518,5558,106076,1799
2021-11-14,San Luis Obispo,079,281455,30152,29645,1270,30915,352
2021-11-14,San Mateo,081,765935,55009,53978,924,54902,576
2021-11-14,Santa Barbara,083,443738,45127,44842,1646,46488,539
2021-11-14,Santa Clara,085,1922200,149507,148152,1427,149579,1913
2021-11-14,Santa Cruz,087,273765,20833,20609,1022,21631,223
2021-11-14,Shasta,089,179085,22119,21771,3677,25448,373
2021-11-14,Sierra,091,2930,195,189,21,210,0
2021-11-14,Siskiyou,093,43540,3389,3302,1330,4632,54
2021-11-14,Solano,095,438530,46523,45860,1307,47167,351
2021-11-14,Sonoma,097,501317,42234,41974,538,42512,401
2021-11-14,Stanislaus,099,539301,79887,80076,9025,89101,1174
2021-11-14,Sutter,101,95872,14104,14031,367,14398,181
2021-11-14,Tehama,103,63373,8711,8607,1522,10129,125
2021-11-14,Trinity,105,12862,878,754,219,973,17
2021-11-14,Tulare,107,460477,69969,68772,15658,84430,1037
2021-11-14,Tuolumne,109,53932,7490,7439,107,7546,90
2021-11-14,Ventura,111,848112,99263,98550,4361,102911,1183
2021-11-14,Yolo,113,214977,20182,20040,1195,21235,255
2021-11-14,Yuba,115,75493,10327,10238,357,10595,85
2021-11-13,Alameda,001,1643700,121319,120407,2887,123294,1454
2021-11-13,Alpine,003,1148,102,105,0,105,0
2021-11-13,Amador,005,37829,5652,5614,66,5680,66
2021-11-13,Butte,007,227075,21375,21104,3843,24947,296
2021-11-13,Calaveras,009,45235,4251,4203,60,4263,83
2021-11-13,Colusa,011,21464,2568,2522,658,3180,19
2021-11-13,Contra Costa,013,1133247,100749,100004,2263,102267,1028
2021-11-13,Del Norte,015,27424,3713,3629,55,3684,42
2021-11-13,El Dorado,017,186661,16400,16163,1725,17888,159
2021-11-13,Fresno,019,978130,143410,141452,12688,154140,2205
2021-11-13,Glenn,021,27897,3553,3514,997,4511,34
2021-11-13,Humboldt,023,135768,9321,9177,606,9783,115
2021-11-13,Imperial,025,180216,34389,33990,3555,37545,766
2021-11-13,Inyo,027,18085,2472,2436,41,2477,42
2021-11-13,Kern,029,883053,130371,128472,23182,151654,1719
2021-11-13,Kings,031,150075,32952,32452,1996,34448,347
2021-11-13,Lake,033,64148,6850,6769,156,6925,109
2021-11-13,Lassen,035,31185,6984,6897,402,7299,47
2021-11-13,Los Angeles,037,10098052,1452499,1443088,55297,1498385,26649
2021-11-13,Madera,039,155013,23852,23462,2212,25674,287
2021-11-13,Marin,041,260295,17811,17684,477,18161,247
2021-11-13,Mariposa,043,17540,1379,1323,52,1375,6
2021-11-13,Mendocino,045,87422,7806,7652,619,8271,89
2021-11-13,Merced,047,269075,42713,42411,1901,44312,644
2021-11-13,Modoc,049,8938,560,536,201,737,5
2021-11-13,Mono,051,14174,1766,1750,22,1772,4
2021-11-13,Monterey,053,433212,49269,48087,3085,51172,609
2021-11-13,Napa,055,140530,13198,13110,117,13227,103
2021-11-13,Nevada,057,99092,9500,9369,335,9704,92
2021-11-13,Orange,059,3164182,310884,308211,15599,323810,5641
2021-11-13,Placer,061,380077,37896,37453,3771,41224,445
2021-11-13,Plumas,063,18699,1876,1828,43,1871,8
2021-11-13,Riverside,065,2383286,368964,363801,16622,380423,5187
2021-11-13,Sacramento,067,1510023,161719,160397,4801,165198,2291
2021-11-13,San Benito,069,59416,7518,7491,174,7665,77
2021-11-13,San Bernardino,071,2135413,359621,356325,11384,367709,5873
2021-11-13,San Diego,073,3302833,380458,377633,22068,399701,4280
2021-11-13,San Francisco,075,870044,53884,53195,2392,55587,667
2021-11-13,San Joaquin,077,732212,101204,100263,5549,105812,1799
2021-11-13,San Luis Obispo,079,281455,30122,29589,1268,30857,351
2021-11-13,San Mateo,081,765935,54971,53853,923,54776,574
2021-11-13,Santa Barbara,083,443738,45094,44734,1646,46380,537
2021-11-13,Santa Clara,085,1922200,149388,147821,1422,149243,1905
2021-11-13,Santa Cruz,087,273765,20818,20565,1021,21586,223
2021-11-13,Shasta,089,179085,22088,21713,3673,25386,366
2021-11-13,Sierra,091,2930,194,188,21,209,0
2021-11-13,Siskiyou,093,43540,3380,3299,1329,4628,54
2021-11-13,Solano,095,438530,46494,45774,1303,47077,350
2021-11-13,Sonoma,097,501317,42200,41882,537,42419,399
2021-11-13,Stanislaus,099,539301,79809,79872,9011,88883,1174
2021-11-13,Sutter,101,95872,14094,14017,366,14383,181
2021-11-13,Tehama,103,63373,8705,8592,1518,10110,125
2021-11-13,Trinity,105,12862,877,749,219,968,17
2021-11-13,Tulare,107,460477,69903,68619,15635,84254,1033
2021-11-13,Tuolumne,109,53932,7473,7392,107,7499,90
2021-11-13,Ventura,111,848112,99205,98452,4358,102810,1183
2021-11-13,Yolo,113,214977,20167,20009,1190,21199,255
2021-11-13,Yuba,115,75493,10317,10218,355,10573,85
2021-11-12,Alameda,001,1643700,121235,120407,2884,123291,1454
2021-11-12,Alpine,003,1148,102,105,0,105,0
2021-11-12,Amador,005,37829,5646,5614,65,5679,66
2021-11-12,Butte,007,227075,21358,21104,3839,24943,296
2021-11-12,Calaveras,009,45235,4240,4203,60,4263,83
2021-11-12,Colusa,011,21464,2564,2522,657,3179,19
2021-11-12,Contra Costa,013,1133247,100693,100004,2262,102266,1028
2021-11-12,Del Norte,015,27424,3713,3629,55,3684,42
2021-11-12,El Dorado,017,186661,16381,16163,1724,17887,159
2021-11-12,Fresno,019,978130,143268,141452,12679,154131,2205
2021-11-12,Glenn,021,27897,3550,3514,996,4510,34
2021-11-12,Humboldt,023,135768,9314,9177,604,9781,115
2021-11-12,Imperial,025,180216,34363,33990,3545,37535,766
2021-11-12,Inyo,027,18085,2468,2436,41,2477,42
2021-11-12,Kern,029,883053,130234,128472,23150,151622,1719
2021-11-12,Kings,031,150075,32926,32452,1994,34446,347
2021-11-12,Lake,033,64148,6846,6769,156,6925,109
2021-11-12,Lassen,035,31185,6980,6897,401,7298,47
2021-11-12,Los Angeles,037,10098052,1451772,1443088,55252,1498340,26649
2021-11-12,Madera,039,155013,23823,23462,2207,25669,287
2021-11-12,Marin,041,260295,17795,17684,476,18160,247
2021-11-12,Mariposa,043,17540,1372,1323,52,1375,6
2021-11-12,Mendocino,045,87422,7794,7652,616,8268,89
2021-11-12,Merced,047,269075,42684,42411,1899,44310,644
2021-11-12,Modoc,049,8938,559,536,201,737,5
2021-11-12,Mono,051,14174,1764,1750,22,1772,4
2021-11-12,Monterey,053,433212,49237,48087,3079,51166,609
2021-11-12,Napa,055,140530,13189,13110,117,13227,103
2021-11-12,Nevada,057,99092,9486,9369,334,9703,92
2021-11-12,Orange,059,3164182,310697,308211,15581,323792,5641
2021-11-12,Placer,061,380077,37856,37453,3768,41221,445
2021-11-12,Plumas,063,18699,1871,1828,43,1871,8
2021-11-12,Riverside,065,2383286,368698,363801,16618,380419,5187
2021-11-12,Sacramento,067,1510023,161561,160397,4796,165193,2291
2021-11-12,San Benito,069,59416,7518,7491,174,7665,77
2021-11-12,San Bernardino,071,2135413,359317,356325,11373,367698,5873
2021-11-12,San Diego,073,3302833,380083,377633,22046,399679,4280
2021-11-12,San Francisco,075,870044,53849,53195,2388,55583,667
2021-11-12,San Joaquin,077,732212,101158,100263,5543,105806,1799
2021-11-12,San Luis Obispo,079,281455,30093,29589,1267,30856,351
2021-11-12,San Mateo,081,765935,54922,53853,920,54773,574
2021-11-12,Santa Barbara,083,443738,45040,44734,1645,46379,537
2021-11-12,Santa Clara,085,1922200,149246,147821,1417,149238,1905
2021-11-12,Santa Cruz,087,273765,20791,20565,1019,21584,223
2021-11-12,Shasta,089,179085,22056,21713,3670,25383,366
2021-11-12,Sierra,091,2930,193,188,21,209,0
2021-11-12,Siskiyou,093,43540,3379,3299,1327,4626,54
2021-11-12,Solano,095,438530,46467,45774,1299,47073,350
2021-11-12,Sonoma,097,501317,42160,41882,537,42419,399
2021-11-12,Stanislaus,099,539301,79757,79872,9003,88875,1174
2021-11-12,Sutter,101,95872,14087,14017,366,14383,181
2021-11-12,Tehama,103,63373,8701,8592,1517,10109,125
2021-11-12,Trinity,105,12862,870,749,219,968,17
2021-11-12,Tulare,107,460477,69861,68619,15600,84219,1033
2021-11-12,Tuolumne,109,53932,7460,7392,106,7498,90
2021-11-12,Ventura,111,848112,99140,98452,4357,102809,1183
2021-11-12,Yolo,113,214977,20153,20009,1184,21193,255
2021-11-12,Yuba,115,75493,10308,10218,354,10572,85
2021-11-11,Alameda,001,1643700,121120,120147,2876,123023,1453
2021-11-11,Alpine,003,1148,102,105,0,105,0
2021-11-11,Amador,005,37829,5643,5603,64,5667,66
2021-11-11,Butte,007,227075,21316,21047,3834,24881,293
2021-11-11,Calaveras,009,45235,4222,4179,60,4239,83
2021-11-11,Colusa,011,21464,2556,2518,655,3173,19
2021-11-11,Contra Costa,013,1133247,100587,99808,2257,102065,1028
2021-11-11,Del Norte,015,27424,3711,3622,55,3677,42
2021-11-11,El Dorado,017,186661,16347,16085,1721,17806,159
2021-11-11,Fresno,019,978130,143066,140833,12652,153485,2202
2021-11-11,Glenn,021,27897,3548,3503,996,4499,34
2021-11-11,Humboldt,023,135768,9291,9125,601,9726,115
2021-11-11,Imperial,025,180216,34294,33844,3523,37367,766
2021-11-11,Inyo,027,18085,2463,2428,41,2469,42
2021-11-11,Kern,029,883053,130050,128023,23086,151109,1709
2021-11-11,Kings,031,150075,32875,32318,1992,34310,345
2021-11-11,Lake,033,64148,6839,6745,156,6901,107
2021-11-11,Lassen,035,31185,6974,6875,401,7276,47
2021-11-11,Los Angeles,037,10098052,1450687,1440436,55193,1495629,26614
2021-11-11,Madera,039,155013,23776,23316,2199,25515,287
2021-11-11,Marin,041,260295,17785,17639,476,18115,247
2021-11-11,Mariposa,043,17540,1362,1317,52,1369,6
2021-11-11,Mendocino,045,87422,7779,7612,607,8219,89
2021-11-11,Merced,047,269075,42628,42292,1897,44189,643
2021-11-11,Modoc,049,8938,557,536,201,737,5
2021-11-11,Mono,051,14174,1760,1743,22,1765,4
2021-11-11,Monterey,053,433212,49202,48008,3067,51075,609
2021-11-11,Napa,055,140530,13181,13075,117,13192,103
2021-11-11,Nevada,057,99092,9464,9308,334,9642,92
2021-11-11,Orange,059,3164182,310427,307674,15543,323217,5633
2021-11-11,Placer,061,380077,37805,37333,3760,41093,440
2021-11-11,Plumas,063,18699,1867,1814,43,1857,7
2021-11-11,Riverside,065,2383286,368267,362930,16600,379530,5175
2021-11-11,Sacramento,067,1510023,161347,159962,4777,164739,2289
2021-11-11,San Benito,069,59416,7510,7473,174,7647,76
2021-11-11,San Bernardino,071,2135413,358894,355413,11360,366773,5849
2021-11-11,San Diego,073,3302833,379568,376428,22023,398451,4272
2021-11-11,San Francisco,075,870044,53789,53063,2386,55449,666
2021-11-11,San Joaquin,077,732212,101063,99937,5528,105465,1799
2021-11-11,San Luis Obispo,079,281455,30042,29532,1265,30797,351
2021-11-11,San Mateo,081,765935,54871,53722,915,54637,574
2021-11-11,Santa Barbara,083,443738,44982,44603,1642,46245,534
2021-11-11,Santa Clara,085,1922200,149064,147458,1411,148869,1901
2021-11-11,Santa Cruz,087,273765,20746,20479,1019,21498,222
2021-11-11,Shasta,089,179085,22009,21600,3668,25268,364
2021-11-11,Sierra,091,2930,192,186,21,207,0
2021-11-11,Siskiyou,093,43540,3373,3297,1326,4623,53
2021-11-11,Solano,095,438530,46430,45679,1298,46977,350
2021-11-11,Sonoma,097,501317,42124,41774,537,42311,395
2021-11-11,Stanislaus,099,539301,79672,79570,8989,88559,1166
2021-11-11,Sutter,101,95872,14073,13993,365,14358,181
2021-11-11,Tehama,103,63373,8689,8565,1515,10080,125
2021-11-11,Trinity,105,12862,869,748,219,967,17
2021-11-11,Tulare,107,460477,69768,68367,15563,83930,1028
2021-11-11,Tuolumne,109,53932,7447,7354,106,7460,90
2021-11-11,Ventura,111,848112,99062,98297,4350,102647,1182
2021-11-11,Yolo,113,214977,20126,19946,1182,21128,255
2021-11-11,Yuba,115,75493,10292,10191,354,10545,85
2021-11-10,Alameda,001,1643700,121011,120147,2867,123014,1453
2021-11-10,Alpine,003,1148,102,105,0,105,0
2021-11-10,Amador,005,37829,5637,5603,64,5667,66
2021-11-10,Butte,007,227075,21290,21047,3830,24877,293
2021-11-10,Calaveras,009,45235,4211,4179,60,4239,83
2021-11-10,Colusa,011,21464,2550,2518,655,3173,19
2021-11-10,Contra Costa,013,1133247,100503,99808,2253,102061,1028
2021-11-10,Del Norte,015,27424,3710,3622,55,3677,42
2021-11-10,El Dorado,017,186661,16331,16085,1720,17805,159
2021-11-10,Fresno,019,978130,142888,140833,12640,153473,2202
2021-11-10,Glenn,021,27897,3548,3503,995,4498,34
2021-11-10,Humboldt,023,135768,9273,9125,601,9726,115
2021-11-10,Imperial,025,180216,34245,33844,3504,37348,766
2021-11-10,Inyo,027,18085,2456,2428,41,2469,42
2021-11-10,Kern,029,883053,129901,128023,23030,151053,1709
2021-11-10,Kings,031,150075,32842,32318,1990,34308,345
2021-11-10,Lake,033,64148,6829,6745,156,6901,107
2021-11-10,Lassen,035,31185,6969,6875,401,7276,47
2021-11-10,Los Angeles,037,10098052,1449739,1440436,55136,1495572,26614
2021-11-10,Madera,039,155013,23727,23316,2193,25509,287
2021-11-10,Marin,041,260295,17772,17639,474,18113,247
2021-11-10,Mariposa,043,17540,1356,1317,52,1369,6
2021-11-10,Mendocino,045,87422,7767,7612,606,8218,89
2021-11-10,Merced,047,269075,42593,42292,1895,44187,643
2021-11-10,Modoc,049,8938,556,536,200,736,5
2021-11-10,Mono,051,14174,1758,1743,22,1765,4
2021-11-10,Monterey,053,433212,49169,48008,3055,51063,609
2021-11-10,Napa,055,140530,13167,13075,116,13191,103
2021-11-10,Nevada,057,99092,9457,9308,332,9640,92
2021-11-10,Orange,059,3164182,310164,307674,15511,323185,5633
2021-11-10,Placer,061,380077,37760,37333,3753,41086,440
2021-11-10,Plumas,063,18699,1864,1814,42,1856,7
2021-11-10,Riverside,065,2383286,367887,362930,16594,379524,5175
2021-11-10,Sacramento,067,1510023,161193,159962,4767,164729,2289
2021-11-10,San Benito,069,59416,7502,7473,174,7647,76
2021-11-10,San Bernardino,071,2135413,358554,355413,11352,366765,5849
2021-11-10,San Diego,073,3302833,379153,376428,22001,398429,4272
2021-11-10,San Francisco,075,870044,53727,53063,2383,55446,666
2021-11-10,San Joaquin,077,732212,100956,99937,5522,105459,1799
2021-11-10,San Luis Obispo,079,281455,30011,29532,1264,30796,351
2021-11-10,San Mateo,081,765935,54817,53722,914,54636,574
2021-11-10,Santa Barbara,083,443738,44944,44603,1641,46244,534
2021-11-10,Santa Clara,085,1922200,148916,147458,1405,148863,1901
2021-11-10,Santa Cruz,087,273765,20719,20479,1018,21497,222
2021-11-10,Shasta,089,179085,21973,21600,3666,25266,364
2021-11-10,Sierra,091,2930,191,186,21,207,0
2021-11-10,Siskiyou,093,43540,3371,3297,1326,4623,53
2021-11-10,Solano,095,438530,46400,45679,1296,46975,350
2021-11-10,Sonoma,097,501317,42073,41774,537,42311,395
2021-11-10,Stanislaus,099,539301,79570,79570,8973,88543,1166
2021-11-10,Sutter,101,95872,14065,13993,365,14358,181
2021-11-10,Tehama,103,63373,8677,8565,1509,10074,125
2021-11-10,Trinity,105,12862,865,748,218,966,17
2021-11-10,Tulare,107,460477,69707,68367,15522,83889,1028
2021-11-10,Tuolumne,109,53932,7423,7354,106,7460,90
2021-11-10,Ventura,111,848112,98991,98297,4350,102647,1182
2021-11-10,Yolo,113,214977,20108,19946,1181,21127,255
2021-11-10,Yuba,115,75493,10283,10191,354,10545,85
2021-11-09,Alameda,001,1643700,120874,120051,2857,122908,1450
2021-11-09,Alpine,003,1148,102,105,0,105,0
2021-11-09,Amador,005,37829,5633,5596,64,5660,66
2021-11-09,Butte,007,227075,21269,21022,3827,24849,291
2021-11-09,Calaveras,009,45235,4207,4174,60,4234,84
2021-11-09,Colusa,011,21464,2545,2517,654,3171,19
2021-11-09,Contra Costa,013,1133247,100408,99732,2245,101977,1028
2021-11-09,Del Norte,015,27424,3709,3620,55,3675,42
2021-11-09,El Dorado,017,186661,16293,16073,1715,17788,160
2021-11-09,Fresno,019,978130,142647,140666,12627,153293,2188
2021-11-09,Glenn,021,27897,3543,3499,994,4493,34
2021-11-09,Humboldt,023,135768,9253,9112,596,9708,115
2021-11-09,Imperial,025,180216,34193,33751,3490,37241,766
2021-11-09,Inyo,027,18085,2452,2404,41,2445,42
2021-11-09,Kern,029,883053,129658,127901,22967,150868,1694
2021-11-09,Kings,031,150075,32775,32279,1986,34265,344
2021-11-09,Lake,033,64148,6820,6743,156,6899,106
2021-11-09,Lassen,035,31185,6957,6846,401,7247,47
2021-11-09,Los Angeles,037,10098052,1448497,1439125,55076,1494201,26581
2021-11-09,Madera,039,155013,23677,23285,2184,25469,287
2021-11-09,Marin,041,260295,17753,17630,472,18102,247
2021-11-09,Mariposa,043,17540,1348,1317,51,1368,5
2021-11-09,Mendocino,045,87422,7744,7598,600,8198,85
2021-11-09,Merced,047,269075,42551,42251,1891,44142,613
2021-11-09,Modoc,049,8938,555,536,198,734,5
2021-11-09,Mono,051,14174,1753,1738,22,1760,4
2021-11-09,Monterey,053,433212,49133,47975,3030,51005,609
2021-11-09,Napa,055,140530,13149,13051,116,13167,103
2021-11-09,Nevada,057,99092,9438,9288,332,9620,92
2021-11-09,Orange,059,3164182,309880,307412,15483,322895,5621
2021-11-09,Placer,061,380077,37706,37291,3736,41027,440
2021-11-09,Plumas,063,18699,1862,1802,42,1844,7
2021-11-09,Riverside,065,2383286,367422,362557,16579,379136,5160
2021-11-09,Sacramento,067,1510023,160952,159856,4757,164613,2286
2021-11-09,San Benito,069,59416,7491,7471,173,7644,76
2021-11-09,San Bernardino,071,2135413,358107,354972,11335,366307,5839
2021-11-09,San Diego,073,3302833,378646,375997,21975,397972,4272
2021-11-09,San Francisco,075,870044,53651,52996,2377,55373,666
2021-11-09,San Joaquin,077,732212,100780,99848,5509,105357,1794
2021-11-09,San Luis Obispo,079,281455,29968,29488,1263,30751,350
2021-11-09,San Mateo,081,765935,54771,53697,904,54601,574
2021-11-09,Santa Barbara,083,443738,44877,44579,1634,46213,533
2021-11-09,Santa Clara,085,1922200,148709,147281,1398,148679,1901
2021-11-09,Santa Cruz,087,273765,20684,20463,1017,21480,222
2021-11-09,Shasta,089,179085,21918,21558,3661,25219,364
2021-11-09,Sierra,091,2930,191,186,21,207,0
2021-11-09,Siskiyou,093,43540,3369,3295,1324,4619,52
2021-11-09,Solano,095,438530,46346,45639,1295,46934,350
2021-11-09,Sonoma,097,501317,42017,41727,535,42262,395
2021-11-09,Stanislaus,099,539301,79465,79505,8956,88461,1165
2021-11-09,Sutter,101,95872,14050,13988,363,14351,180
2021-11-09,Tehama,103,63373,8659,8555,1507,10062,125
2021-11-09,Trinity,105,12862,864,746,218,964,17
2021-11-09,Tulare,107,460477,69600,68298,15482,83780,1024
2021-11-09,Tuolumne,109,53932,7403,7347,106,7453,90
2021-11-09,Ventura,111,848112,98912,98202,4345,102547,1182
2021-11-09,Yolo,113,214977,20084,19931,1177,21108,255
2021-11-09,Yuba,115,75493,10266,10175,348,10523,85
2021-11-08,Alameda,001,1643700,120731,119983,2851,122834,1447
2021-11-08,Alpine,003,1148,102,105,0,105,0
2021-11-08,Amador,005,37829,5627,5590,64,5654,66
2021-11-08,Butte,007,227075,21241,21000,3819,24819,288
2021-11-08,Calaveras,009,45235,4199,4166,60,4226,82
2021-11-08,Colusa,011,21464,2544,2514,653,3167,19
2021-11-08,Contra Costa,013,1133247,100306,99669,2241,101910,1028
2021-11-08,Del Norte,015,27424,3705,3619,55,3674,42
2021-11-08,El Dorado,017,186661,16274,16055,1710,17765,156
2021-11-08,Fresno,019,978130,142347,140466,12610,153076,2179
2021-11-08,Glenn,021,27897,3540,3496,990,4486,34
2021-11-08,Humboldt,023,135768,9226,9095,586,9681,109
2021-11-08,Imperial,025,180216,34114,33690,3470,37160,766
2021-11-08,Inyo,027,18085,2445,2398,41,2439,41
2021-11-08,Kern,029,883053,129423,127722,22884,150606,1692
2021-11-08,Kings,031,150075,32729,32248,1985,34233,344
2021-11-08,Lake,033,64148,6814,6737,156,6893,106
2021-11-08,Lassen,035,31185,6950,6830,399,7229,46
2021-11-08,Los Angeles,037,10098052,1447154,1438322,55017,1493339,26575
2021-11-08,Madera,039,155013,23628,23253,2172,25425,287
2021-11-08,Marin,041,260295,17736,17617,469,18086,247
2021-11-08,Mariposa,043,17540,1340,1316,50,1366,5
2021-11-08,Mendocino,045,87422,7730,7581,594,8175,85
2021-11-08,Merced,047,269075,42480,42224,1883,44107,607
2021-11-08,Modoc,049,8938,554,529,198,727,5
2021-11-08,Mono,051,14174,1749,1739,22,1761,4
2021-11-08,Monterey,053,433212,49092,47942,3009,50951,602
2021-11-08,Napa,055,140530,13135,13045,116,13161,103
2021-11-08,Nevada,057,99092,9420,9278,330,9608,92
2021-11-08,Orange,059,3164182,309606,307156,15452,322608,5616
2021-11-08,Placer,061,380077,37654,37250,3733,40983,439
2021-11-08,Plumas,063,18699,1861,1788,41,1829,7
2021-11-08,Riverside,065,2383286,366967,362201,16565,378766,5152
2021-11-08,Sacramento,067,1510023,160737,159735,4737,164472,2275
2021-11-08,San Benito,069,59416,7489,7461,173,7634,75
2021-11-08,San Bernardino,071,2135413,357603,354741,11316,366057,5836
2021-11-08,San Diego,073,3302833,378058,375557,21928,397485,4259
2021-11-08,San Francisco,075,870044,53598,52942,2371,55313,666
2021-11-08,San Joaquin,077,732212,100664,99736,5507,105243,1794
2021-11-08,San Luis Obispo,079,281455,29916,29464,1259,30723,350
2021-11-08,San Mateo,081,765935,54696,53658,899,54557,574
2021-11-08,Santa Barbara,083,443738,44823,44548,1633,46181,532
2021-11-08,Santa Clara,085,1922200,148481,147183,1392,148575,1899
2021-11-08,Santa Cruz,087,273765,20655,20435,1017,21452,222
2021-11-08,Shasta,089,179085,21871,21504,3655,25159,354
2021-11-08,Sierra,091,2930,191,183,21,204,0
2021-11-08,Siskiyou,093,43540,3365,3290,1313,4603,50
2021-11-08,Solano,095,438530,46305,45613,1291,46904,350
2021-11-08,Sonoma,097,501317,41949,41669,533,42202,395
2021-11-08,Stanislaus,099,539301,79313,79417,8942,88359,1150
2021-11-08,Sutter,101,95872,14042,13976,359,14335,180
2021-11-08,Tehama,103,63373,8650,8534,1507,10041,123
2021-11-08,Trinity,105,12862,864,743,217,960,13
2021-11-08,Tulare,107,460477,69483,68199,15444,83643,1020
2021-11-08,Tuolumne,109,53932,7384,7328,105,7433,90
2021-11-08,Ventura,111,848112,98819,98144,4343,102487,1182
2021-11-08,Yolo,113,214977,20046,19916,1172,21088,255
2021-11-08,Yuba,115,75493,10255,10172,345,10517,83
2021-11-07,Alameda,001,1643700,120574,119902,2845,122747,1444
2021-11-07,Alpine,003,1148,102,105,0,105,0
2021-11-07,Amador,005,37829,5620,5580,62,5642,66
2021-11-07,Butte,007,227075,21202,20969,3810,24779,288
2021-11-07,Calaveras,009,45235,4172,4158,59,4217,82
2021-11-07,Colusa,011,21464,2538,2511,651,3162,19
2021-11-07,Contra Costa,013,1133247,100194,99596,2232,101828,1028
2021-11-07,Del Norte,015,27424,3703,3617,55,3672,42
2021-11-07,El Dorado,017,186661,16237,16040,1707,17747,156
2021-11-07,Fresno,019,978130,142006,140263,12588,152851,2179
2021-11-07,Glenn,021,27897,3533,3493,989,4482,34
2021-11-07,Humboldt,023,135768,9201,9074,582,9656,109
2021-11-07,Imperial,025,180216,34041,33674,3450,37124,766
2021-11-07,Inyo,027,18085,2432,2394,41,2435,41
2021-11-07,Kern,029,883053,129151,127583,22792,150375,1692
2021-11-07,Kings,031,150075,32639,32221,1981,34202,343
2021-11-07,Lake,033,64148,6798,6734,155,6889,106
2021-11-07,Lassen,035,31185,6941,6819,395,7214,46
2021-11-07,Los Angeles,037,10098052,1445662,1437314,54943,1492257,26573
2021-11-07,Madera,039,155013,23583,23225,2165,25390,287
2021-11-07,Marin,041,260295,17716,17594,468,18062,247
2021-11-07,Mariposa,043,17540,1339,1306,50,1356,5
2021-11-07,Mendocino,045,87422,7701,7567,590,8157,85
2021-11-07,Merced,047,269075,42398,42186,1853,44039,607
2021-11-07,Modoc,049,8938,551,528,197,725,5
2021-11-07,Mono,051,14174,1743,1739,22,1761,4
2021-11-07,Monterey,053,433212,49040,47924,3004,50928,602
2021-11-07,Napa,055,140530,13114,13041,116,13157,103
2021-11-07,Nevada,057,99092,9372,9254,330,9584,92
2021-11-07,Orange,059,3164182,309282,306954,15413,322367,5616
2021-11-07,Placer,061,380077,37578,37202,3718,40920,439
2021-11-07,Plumas,063,18699,1854,1787,40,1827,7
2021-11-07,Riverside,065,2383286,366433,361960,16545,378505,5152
2021-11-07,Sacramento,067,1510023,160506,159549,4719,164268,2277
2021-11-07,San Benito,069,59416,7476,7460,173,7633,75
2021-11-07,San Bernardino,071,2135413,357102,354488,11293,365781,5832
2021-11-07,San Diego,073,3302833,377470,375165,21895,397060,4250
2021-11-07,San Francisco,075,870044,53514,52868,2365,55233,666
2021-11-07,San Joaquin,077,732212,100479,99696,5501,105197,1794
2021-11-07,San Luis Obispo,079,281455,29866,29454,1255,30709,350
2021-11-07,San Mateo,081,765935,54637,53600,897,54497,574
2021-11-07,Santa Barbara,083,443738,44760,44501,1632,46133,532
2021-11-07,Santa Clara,085,1922200,148278,147054,1379,148433,1898
2021-11-07,Santa Cruz,087,273765,20597,20397,1016,21413,222
2021-11-07,Shasta,089,179085,21823,21479,3649,25128,354
2021-11-07,Sierra,091,2930,189,183,21,204,0
2021-11-07,Siskiyou,093,43540,3359,3289,1311,4600,51
2021-11-07,Solano,095,438530,46250,45582,1284,46866,350
2021-11-07,Sonoma,097,501317,41900,41630,533,42163,395
2021-11-07,Stanislaus,099,539301,79158,79351,8922,88273,1150
2021-11-07,Sutter,101,95872,14029,13964,356,14320,180
2021-11-07,Tehama,103,63373,8626,8528,1505,10033,121
2021-11-07,Trinity,105,12862,863,742,216,958,13
2021-11-07,Tulare,107,460477,69330,68145,15401,83546,1020
2021-11-07,Tuolumne,109,53932,7366,7300,103,7403,90
2021-11-07,Ventura,111,848112,98728,98085,4341,102426,1182
2021-11-07,Yolo,113,214977,20025,19899,1167,21066,255
2021-11-07,Yuba,115,75493,10238,10162,340,10502,83
2021-11-06,Alameda,001,1643700,120511,119499,2842,122341,1436
2021-11-06,Alpine,003,1148,102,105,0,105,0
2021-11-06,Amador,005,37829,5614,5557,62,5619,66
2021-11-06,Butte,007,227075,21182,20796,3806,24602,288
2021-11-06,Calaveras,009,45235,4164,4105,59,4164,82
2021-11-06,Colusa,011,21464,2537,2501,650,3151,19
2021-11-06,Contra Costa,013,1133247,100139,99282,2230,101512,1025
2021-11-06,Del Norte,015,27424,3700,3607,55,3662,42
2021-11-06,El Dorado,017,186661,16220,15958,1707,17665,156
2021-11-06,Fresno,019,978130,141889,139249,12586,151835,2170
2021-11-06,Glenn,021,27897,3530,3479,989,4468,33
2021-11-06,Humboldt,023,135768,9189,8972,578,9550,109
2021-11-06,Imperial,025,180216,33995,33471,3443,36914,766
2021-11-06,Inyo,027,18085,2426,2353,41,2394,41
2021-11-06,Kern,029,883053,129018,126848,22739,149587,1684
2021-11-06,Kings,031,150075,32606,32018,1976,33994,342
2021-11-06,Lake,033,64148,6796,6695,155,6850,106
2021-11-06,Lassen,035,31185,6936,6796,394,7190,46
2021-11-06,Los Angeles,037,10098052,1444887,1433081,54899,1487980,26533
2021-11-06,Madera,039,155013,23547,22994,2156,25150,287
2021-11-06,Marin,041,260295,17697,17520,465,17985,247
2021-11-06,Mariposa,043,17540,1337,1282,50,1332,5
2021-11-06,Mendocino,045,87422,7679,7486,590,8076,85
2021-11-06,Merced,047,269075,42374,41958,1845,43803,604
2021-11-06,Modoc,049,8938,550,523,197,720,5
2021-11-06,Mono,051,14174,1741,1725,22,1747,4
2021-11-06,Monterey,053,433212,49008,47830,2994,50824,602
2021-11-06,Napa,055,140530,13104,12950,116,13066,103
2021-11-06,Nevada,057,99092,9350,9169,329,9498,91
2021-11-06,Orange,059,3164182,309075,306049,15387,321436,5611
2021-11-06,Placer,061,380077,37537,36967,3715,40682,438
2021-11-06,Plumas,063,18699,1850,1755,39,1794,7
2021-11-06,Riverside,065,2383286,366115,360584,16536,377120,5138
2021-11-06,Sacramento,067,1510023,160413,158766,4714,163480,2263
2021-11-06,San Benito,069,59416,7469,7429,173,7602,75
2021-11-06,San Bernardino,071,2135413,356831,353142,11289,364431,5813
2021-11-06,San Diego,073,3302833,377123,373423,21877,395300,4246
2021-11-06,San Francisco,075,870044,53460,52556,2362,54918,666
2021-11-06,San Joaquin,077,732212,100422,99372,5500,104872,1782
2021-11-06,San Luis Obispo,079,281455,29838,29335,1251,30586,350
2021-11-06,San Mateo,081,765935,54603,53442,896,54338,574
2021-11-06,Santa Barbara,083,443738,44724,44301,1631,45932,532
2021-11-06,Santa Clara,085,1922200,148133,146519,1374,147893,1894
2021-11-06,Santa Cruz,087,273765,20578,20311,1014,21325,222
2021-11-06,Shasta,089,179085,21804,21281,3644,24925,349
2021-11-06,Sierra,091,2930,189,181,21,202,0
2021-11-06,Siskiyou,093,43540,3359,3279,1309,4588,48
2021-11-06,Solano,095,438530,46220,45465,1283,46748,350
2021-11-06,Sonoma,097,501317,41850,41398,532,41930,395
2021-11-06,Stanislaus,099,539301,79090,78902,8914,87816,1193
2021-11-06,Sutter,101,95872,14025,13908,355,14263,180
2021-11-06,Tehama,103,63373,8615,8474,1503,9977,120
2021-11-06,Trinity,105,12862,860,732,216,948,11
2021-11-06,Tulare,107,460477,69280,67767,15373,83140,1010
2021-11-06,Tuolumne,109,53932,7353,7245,103,7348,90
2021-11-06,Ventura,111,848112,98662,97770,4336,102106,1180
2021-11-06,Yolo,113,214977,20008,19827,1163,20990,255
2021-11-06,Yuba,115,75493,10224,10107,340,10447,83
2021-11-05,Alameda,001,1643700,120429,119499,2840,122339,1436
2021-11-05,Alpine,003,1148,102,105,0,105,0
2021-11-05,Amador,005,37829,5609,5557,62,5619,66
2021-11-05,Butte,007,227075,21169,20796,3805,24601,288
2021-11-05,Calaveras,009,45235,4159,4105,59,4164,82
2021-11-05,Colusa,011,21464,2537,2501,649,3150,19
2021-11-05,Contra Costa,013,1133247,100073,99282,2228,101510,1025
2021-11-05,Del Norte,015,27424,3698,3607,55,3662,42
2021-11-05,El Dorado,017,186661,16202,15958,1701,17659,156
2021-11-05,Fresno,019,978130,141711,139249,12577,151826,2170
2021-11-05,Glenn,021,27897,3530,3479,989,4468,33
2021-11-05,Humboldt,023,135768,9175,8972,578,9550,109
2021-11-05,Imperial,025,180216,33960,33471,3440,36911,766
2021-11-05,Inyo,027,18085,2418,2353,41,2394,41
2021-11-05,Kern,029,883053,128891,126848,22683,149531,1684
2021-11-05,Kings,031,150075,32582,32018,1975,33993,342
2021-11-05,Lake,033,64148,6790,6695,155,6850,106
2021-11-05,Lassen,035,31185,6932,6796,393,7189,46
2021-11-05,Los Angeles,037,10098052,1444068,1433081,54861,1487942,26533
2021-11-05,Madera,039,155013,23509,22994,2155,25149,287
2021-11-05,Marin,041,260295,17675,17520,464,17984,247
2021-11-05,Mariposa,043,17540,1334,1282,49,1331,5
2021-11-05,Mendocino,045,87422,7668,7486,589,8075,85
2021-11-05,Merced,047,269075,42348,41958,1841,43799,604
2021-11-05,Modoc,049,8938,550,523,197,720,5
2021-11-05,Mono,051,14174,1740,1725,22,1747,4
2021-11-05,Monterey,053,433212,48979,47830,2992,50822,602
2021-11-05,Napa,055,140530,13082,12950,116,13066,103
2021-11-05,Nevada,057,99092,9337,9169,329,9498,91
2021-11-05,Orange,059,3164182,308878,306049,15365,321414,5611
2021-11-05,Placer,061,380077,37510,36967,3705,40672,438
2021-11-05,Plumas,063,18699,1843,1755,39,1794,7
2021-11-05,Riverside,065,2383286,365774,360584,16526,377110,5138
2021-11-05,Sacramento,067,1510023,160290,158766,4708,163474,2263
2021-11-05,San Benito,069,59416,7467,7429,172,7601,75
2021-11-05,San Bernardino,071,2135413,356500,353142,11278,364420,5813
2021-11-05,San Diego,073,3302833,376758,373423,21865,395288,4246
2021-11-05,San Francisco,075,870044,53409,52556,2359,54915,666
2021-11-05,San Joaquin,077,732212,100369,99372,5491,104863,1782
2021-11-05,San Luis Obispo,079,281455,29815,29335,1251,30586,350
2021-11-05,San Mateo,081,765935,54562,53442,894,54336,574
2021-11-05,Santa Barbara,083,443738,44679,44301,1630,45931,532
2021-11-05,Santa Clara,085,1922200,147995,146519,1373,147892,1894
2021-11-05,Santa Cruz,087,273765,20554,20311,1013,21324,222
2021-11-05,Shasta,089,179085,21772,21281,3639,24920,349
2021-11-05,Sierra,091,2930,189,181,21,202,0
2021-11-05,Siskiyou,093,43540,3354,3279,1308,4587,48
2021-11-05,Solano,095,438530,46174,45465,1280,46745,350
2021-11-05,Sonoma,097,501317,41810,41398,532,41930,395
2021-11-05,Stanislaus,099,539301,79032,78902,8902,87804,1193
2021-11-05,Sutter,101,95872,14017,13908,354,14262,180
2021-11-05,Tehama,103,63373,8608,8474,1502,9976,120
2021-11-05,Trinity,105,12862,860,732,216,948,11
2021-11-05,Tulare,107,460477,69207,67767,15336,83103,1010
2021-11-05,Tuolumne,109,53932,7336,7245,102,7347,90
2021-11-05,Ventura,111,848112,98622,97770,4333,102103,1180
2021-11-05,Yolo,113,214977,19997,19827,1162,20989,255
2021-11-05,Yuba,115,75493,10211,10107,338,10445,83
2021-11-04,Alameda,001,1643700,120314,119499,2834,122333,1436
2021-11-04,Alpine,003,1148,102,105,0,105,0
2021-11-04,Amador,005,37829,5601,5557,62,5619,66
2021-11-04,Butte,007,227075,21127,20796,3795,24591,288
2021-11-04,Calaveras,009,45235,4145,4105,57,4162,82
2021-11-04,Colusa,011,21464,2531,2501,648,3149,19
2021-11-04,Contra Costa,013,1133247,99981,99282,2223,101505,1025
2021-11-04,Del Norte,015,27424,3695,3607,55,3662,42
2021-11-04,El Dorado,017,186661,16176,15958,1697,17655,156
2021-11-04,Fresno,019,978130,141432,139249,12570,151819,2170
2021-11-04,Glenn,021,27897,3525,3479,988,4467,33
2021-11-04,Humboldt,023,135768,9150,8972,575,9547,109
2021-11-04,Imperial,025,180216,33902,33471,3430,36901,766
2021-11-04,Inyo,027,18085,2410,2353,41,2394,41
2021-11-04,Kern,029,883053,128659,126848,22615,149463,1684
2021-11-04,Kings,031,150075,32503,32018,1967,33985,342
2021-11-04,Lake,033,64148,6780,6695,153,6848,106
2021-11-04,Lassen,035,31185,6922,6796,388,7184,46
2021-11-04,Los Angeles,037,10098052,1442771,1433081,54777,1487858,26533
2021-11-04,Madera,039,155013,23454,22994,2144,25138,287
2021-11-04,Marin,041,260295,17663,17520,462,17982,247
2021-11-04,Mariposa,043,17540,1327,1282,49,1331,5
2021-11-04,Mendocino,045,87422,7655,7486,583,8069,85
2021-11-04,Merced,047,269075,42293,41958,1837,43795,604
2021-11-04,Modoc,049,8938,549,523,197,720,5
2021-11-04,Mono,051,14174,1735,1725,22,1747,4
2021-11-04,Monterey,053,433212,48934,47830,2976,50806,602
2021-11-04,Napa,055,140530,13061,12950,116,13066,103
2021-11-04,Nevada,057,99092,9306,9169,328,9497,91
2021-11-04,Orange,059,3164182,308630,306049,15346,321395,5611
2021-11-04,Placer,061,380077,37439,36967,3696,40663,438
2021-11-04,Plumas,063,18699,1835,1755,35,1790,7
2021-11-04,Riverside,065,2383286,365378,360584,16517,377101,5138
2021-11-04,Sacramento,067,1510023,160056,158766,4687,163453,2263
2021-11-04,San Benito,069,59416,7461,7429,172,7601,75
2021-11-04,San Bernardino,071,2135413,356066,353142,11271,364413,5813
2021-11-04,San Diego,073,3302833,376277,373423,21844,395267,4246
2021-11-04,San Francisco,075,870044,53328,52556,2355,54911,666
2021-11-04,San Joaquin,077,732212,100261,99372,5479,104851,1782
2021-11-04,San Luis Obispo,079,281455,29791,29335,1245,30580,350
2021-11-04,San Mateo,081,765935,54503,53442,888,54330,574
2021-11-04,Santa Barbara,083,443738,44623,44301,1630,45931,532
2021-11-04,Santa Clara,085,1922200,147840,146519,1369,147888,1894
2021-11-04,Santa Cruz,087,273765,20519,20311,1013,21324,222
2021-11-04,Shasta,089,179085,21714,21281,3633,24914,349
2021-11-04,Sierra,091,2930,187,181,21,202,0
2021-11-04,Siskiyou,093,43540,3351,3279,1301,4580,48
2021-11-04,Solano,095,438530,46132,45465,1279,46744,350
2021-11-04,Sonoma,097,501317,41750,41398,532,41930,395
2021-11-04,Stanislaus,099,539301,78894,78902,8896,87798,1193
2021-11-04,Sutter,101,95872,14006,13908,352,14260,180
2021-11-04,Tehama,103,63373,8599,8474,1498,9972,120
2021-11-04,Trinity,105,12862,859,732,216,948,11
2021-11-04,Tulare,107,460477,69091,67767,15290,83057,1010
2021-11-04,Tuolumne,109,53932,7314,7245,100,7345,90
2021-11-04,Ventura,111,848112,98534,97770,4330,102100,1180
2021-11-04,Yolo,113,214977,19971,19827,1156,20983,255
2021-11-04,Yuba,115,75493,10197,10107,336,10443,83
2021-11-03,Alameda,001,1643700,120172,119356,2831,122187,1428
2021-11-03,Alpine,003,1148,102,105,0,105,0
2021-11-03,Amador,005,37829,5595,5545,61,5606,66
2021-11-03,Butte,007,227075,21082,20769,3786,24555,284
2021-11-03,Calaveras,009,45235,4127,4087,56,4143,82
2021-11-03,Colusa,011,21464,2525,2499,648,3147,20
2021-11-03,Contra Costa,013,1133247,99881,99168,2218,101386,1025
2021-11-03,Del Norte,015,27424,3693,3600,54,3654,42
2021-11-03,El Dorado,017,186661,16150,15915,1694,17609,156
2021-11-03,Fresno,019,978130,141068,138873,12551,151424,2166
2021-11-03,Glenn,021,27897,3521,3470,988,4458,33
2021-11-03,Humboldt,023,135768,9132,8949,570,9519,109
2021-11-03,Imperial,025,180216,33831,33402,3420,36822,766
2021-11-03,Inyo,027,18085,2389,2344,41,2385,41
2021-11-03,Kern,029,883053,128398,126523,22513,149036,1681
2021-11-03,Kings,031,150075,32448,31923,1959,33882,341
2021-11-03,Lake,033,64148,6764,6685,153,6838,106
2021-11-03,Lassen,035,31185,6906,6782,382,7164,46
2021-11-03,Los Angeles,037,10098052,1441422,1431209,54693,1485902,26517
2021-11-03,Madera,039,155013,23387,22893,2135,25028,287
2021-11-03,Marin,041,260295,17642,17491,458,17949,247
2021-11-03,Mariposa,043,17540,1317,1276,49,1325,5
2021-11-03,Mendocino,045,87422,7639,7457,575,8032,84
2021-11-03,Merced,047,269075,42232,41849,1827,43676,597
2021-11-03,Modoc,049,8938,549,521,195,716,5
2021-11-03,Mono,051,14174,1731,1719,22,1741,4
2021-11-03,Monterey,053,433212,48884,47794,2963,50757,601
2021-11-03,Napa,055,140530,13049,12937,115,13052,103
2021-11-03,Nevada,057,99092,9279,9131,327,9458,91
2021-11-03,Orange,059,3164182,308318,305661,15313,320974,5607
2021-11-03,Placer,061,380077,37369,36868,3691,40559,438
2021-11-03,Plumas,063,18699,1824,1739,34,1773,7
2021-11-03,Riverside,065,2383286,364920,360060,16513,376573,5131
2021-11-03,Sacramento,067,1510023,159832,158311,4676,162987,2259
2021-11-03,San Benito,069,59416,7453,7419,172,7591,75
2021-11-03,San Bernardino,071,2135413,355594,352225,11251,363476,5813
2021-11-03,San Diego,073,3302833,375766,372951,21821,394772,4241
2021-11-03,San Francisco,075,870044,53234,52493,2350,54843,663
2021-11-03,San Joaquin,077,732212,100149,99188,5468,104656,1776
2021-11-03,San Luis Obispo,079,281455,29749,29276,1239,30515,348
2021-11-03,San Mateo,081,765935,54439,53396,882,54278,571
2021-11-03,Santa Barbara,083,443738,44566,44220,1627,45847,531
2021-11-03,Santa Clara,085,1922200,147670,146259,1362,147621,1897
2021-11-03,Santa Cruz,087,273765,20484,20275,1013,21288,222
2021-11-03,Shasta,089,179085,21656,21215,3626,24841,346
2021-11-03,Sierra,091,2930,185,180,21,201,0
2021-11-03,Siskiyou,093,43540,3347,3276,1299,4575,46
2021-11-03,Solano,095,438530,46105,45411,1277,46688,351
2021-11-03,Sonoma,097,501317,41673,41326,530,41856,395
2021-11-03,Stanislaus,099,539301,78763,78736,8880,87616,1193
2021-11-03,Sutter,101,95872,13993,13876,350,14226,179
2021-11-03,Tehama,103,63373,8586,8438,1498,9936,118
2021-11-03,Trinity,105,12862,858,730,216,946,11
2021-11-03,Tulare,107,460477,68963,67588,15246,82834,1007
2021-11-03,Tuolumne,109,53932,7297,7218,98,7316,90
2021-11-03,Ventura,111,848112,98425,97682,4326,102008,1178
2021-11-03,Yolo,113,214977,19953,19758,1148,20906,250
2021-11-03,Yuba,115,75493,10185,10092,336,10428,83
2021-11-02,Alameda,001,1643700,120026,119241,2825,122066,1425
2021-11-02,Alpine,003,1148,101,105,0,105,0
2021-11-02,Amador,005,37829,5590,5535,61,5596,66
2021-11-02,Butte,007,227075,21038,20744,3775,24519,282
2021-11-02,Calaveras,009,45235,4104,4075,56,4131,82
2021-11-02,Colusa,011,21464,2520,2497,647,3144,19
2021-11-02,Contra Costa,013,1133247,99778,99080,2206,101286,1025
2021-11-02,Del Norte,015,27424,3691,3596,54,3650,42
2021-11-02,El Dorado,017,186661,16121,15883,1694,17577,154
2021-11-02,Fresno,019,978130,140746,138644,12522,151166,2158
2021-11-02,Glenn,021,27897,3513,3469,985,4454,33
2021-11-02,Humboldt,023,135768,9091,8937,569,9506,109
2021-11-02,Imperial,025,180216,33758,33371,3406,36777,766
2021-11-02,Inyo,027,18085,2382,2324,41,2365,41
2021-11-02,Kern,029,883053,128142,126311,22391,148702,1665
2021-11-02,Kings,031,150075,32389,31896,1954,33850,339
2021-11-02,Lake,033,64148,6759,6681,152,6833,106
2021-11-02,Lassen,035,31185,6894,6777,379,7156,45
2021-11-02,Los Angeles,037,10098052,1439971,1429601,54618,1484219,26496
2021-11-02,Madera,039,155013,23306,22837,2124,24961,287
2021-11-02,Marin,041,260295,17614,17482,458,17940,247
2021-11-02,Mariposa,043,17540,1306,1270,48,1318,5
2021-11-02,Mendocino,045,87422,7615,7447,563,8010,84
2021-11-02,Merced,047,269075,42165,41785,1819,43604,596
2021-11-02,Modoc,049,8938,546,520,194,714,5
2021-11-02,Mono,051,14174,1727,1718,22,1740,4
2021-11-02,Monterey,053,433212,48833,47775,2945,50720,599
2021-11-02,Napa,055,140530,13031,12930,115,13045,104
2021-11-02,Nevada,057,99092,9249,9122,326,9448,91
2021-11-02,Orange,059,3164182,308002,305369,15266,320635,5600
2021-11-02,Placer,061,380077,37297,36817,3676,40493,438
2021-11-02,Plumas,063,18699,1813,1721,34,1755,7
2021-11-02,Riverside,065,2383286,364468,359586,16493,376079,5116
2021-11-02,Sacramento,067,1510023,159576,158112,4653,162765,2250
2021-11-02,San Benito,069,59416,7437,7407,172,7579,75
2021-11-02,San Bernardino,071,2135413,355122,351832,11198,363030,5813
2021-11-02,San Diego,073,3302833,375171,372440,21791,394231,4232
2021-11-02,San Francisco,075,870044,53115,52450,2346,54796,663
2021-11-02,San Joaquin,077,732212,100014,99076,5457,104533,1772
2021-11-02,San Luis Obispo,079,281455,29716,29224,1236,30460,348
2021-11-02,San Mateo,081,765935,54367,53351,879,54230,571
2021-11-02,Santa Barbara,083,443738,44510,44177,1623,45800,531
2021-11-02,Santa Clara,085,1922200,147476,146115,1355,147470,1896
2021-11-02,Santa Cruz,087,273765,20451,20266,1012,21278,222
2021-11-02,Shasta,089,179085,21581,21127,3616,24743,344
2021-11-02,Sierra,091,2930,185,180,20,200,0
2021-11-02,Siskiyou,093,43540,3345,3272,1296,4568,46
2021-11-02,Solano,095,438530,46065,45378,1271,46649,350
2021-11-02,Sonoma,097,501317,41594,41288,529,41817,395
2021-11-02,Stanislaus,099,539301,78608,78629,8860,87489,1193
2021-11-02,Sutter,101,95872,13972,13868,350,14218,179
2021-11-02,Tehama,103,63373,8570,8422,1495,9917,116
2021-11-02,Trinity,105,12862,858,729,216,945,11
2021-11-02,Tulare,107,460477,68839,67502,15198,82700,1002
2021-11-02,Tuolumne,109,53932,7276,7204,96,7300,90
2021-11-02,Ventura,111,848112,98320,97574,4322,101896,1178
2021-11-02,Yolo,113,214977,19922,19736,1146,20882,250
2021-11-02,Yuba,115,75493,10162,10080,334,10414,83
2021-11-01,Alameda,001,1643700,119890,119159,2823,121982,1421
2021-11-01,Alpine,003,1148,101,105,0,105,0
2021-11-01,Amador,005,37829,5588,5532,61,5593,64
2021-11-01,Butte,007,227075,20988,20710,3770,24480,281
2021-11-01,Calaveras,009,45235,4094,4059,55,4114,82
2021-11-01,Colusa,011,21464,2518,2494,644,3138,19
2021-11-01,Contra Costa,013,1133247,99654,99011,2197,101208,1025
2021-11-01,Del Norte,015,27424,3689,3594,54,3648,42
2021-11-01,El Dorado,017,186661,16097,15858,1688,17546,154
2021-11-01,Fresno,019,978130,140372,138421,12491,150912,2149
2021-11-01,Glenn,021,27897,3506,3461,983,4444,33
2021-11-01,Humboldt,023,135768,9063,8929,565,9494,108
2021-11-01,Imperial,025,180216,33707,33342,3397,36739,766
2021-11-01,Inyo,027,18085,2370,2307,41,2348,41
2021-11-01,Kern,029,883053,127842,126092,22276,148368,1660
2021-11-01,Kings,031,150075,32336,31866,1952,33818,337
2021-11-01,Lake,033,64148,6748,6676,151,6827,106
2021-11-01,Lassen,035,31185,6879,6775,376,7151,42
2021-11-01,Los Angeles,037,10098052,1438585,1428891,54526,1483417,26483
2021-11-01,Madera,039,155013,23227,22801,2119,24920,283
2021-11-01,Marin,041,260295,17594,17460,457,17917,247
2021-11-01,Mariposa,043,17540,1298,1266,47,1313,5
2021-11-01,Mendocino,045,87422,7582,7422,545,7967,84
2021-11-01,Merced,047,269075,42075,41740,1817,43557,594
2021-11-01,Modoc,049,8938,541,520,192,712,5
2021-11-01,Mono,051,14174,1723,1714,22,1736,3
2021-11-01,Monterey,053,433212,48791,47756,2933,50689,597
2021-11-01,Napa,055,140530,13004,12916,114,13030,101
2021-11-01,Nevada,057,99092,9226,9108,325,9433,91
2021-11-01,Orange,059,3164182,307660,305192,15224,320416,5596
2021-11-01,Placer,061,380077,37214,36747,3664,40411,435
2021-11-01,Plumas,063,18699,1794,1719,34,1753,7
2021-11-01,Riverside,065,2383286,363967,359263,16471,375734,5115
2021-11-01,Sacramento,067,1510023,159303,157893,4629,162522,2239
2021-11-01,San Benito,069,59416,7427,7406,171,7577,73
2021-11-01,San Bernardino,071,2135413,354638,351620,11178,362798,5815
2021-11-01,San Diego,073,3302833,374586,372043,21773,393816,4232
2021-11-01,San Francisco,075,870044,53028,52418,2339,54757,661
2021-11-01,San Joaquin,077,732212,99851,98969,5450,104419,1772
2021-11-01,San Luis Obispo,079,281455,29672,29199,1232,30431,343
2021-11-01,San Mateo,081,765935,54301,53314,875,54189,571
2021-11-01,Santa Barbara,083,443738,44443,44146,1619,45765,529
2021-11-01,Santa Clara,085,1922200,147279,145978,1350,147328,1907
2021-11-01,Santa Cruz,087,273765,20416,20238,1012,21250,221
2021-11-01,Shasta,089,179085,21528,21104,3609,24713,338
2021-11-01,Sierra,091,2930,185,180,20,200,0
2021-11-01,Siskiyou,093,43540,3338,3272,1291,4563,46
2021-11-01,Solano,095,438530,46010,45358,1271,46629,350
2021-11-01,Sonoma,097,501317,41521,41234,529,41763,395
2021-11-01,Stanislaus,099,539301,78479,78534,8845,87379,1193
2021-11-01,Sutter,101,95872,13948,13852,348,14200,179
2021-11-01,Tehama,103,63373,8542,8412,1492,9904,116
2021-11-01,Trinity,105,12862,856,727,216,943,11
2021-11-01,Tulare,107,460477,68694,67388,15146,82534,1002
2021-11-01,Tuolumne,109,53932,7260,7175,95,7270,90
2021-11-01,Ventura,111,848112,98230,97507,4320,101827,1178
2021-11-01,Yolo,113,214977,19902,19708,1139,20847,250
2021-11-01,Yuba,115,75493,10144,10066,332,10398,83
2021-10-31,Alameda,001,1643700,119746,119071,2820,121891,1419
2021-10-31,Alpine,003,1148,101,105,0,105,0
2021-10-31,Amador,005,37829,5577,5518,61,5579,64
2021-10-31,Butte,007,227075,20927,20689,3761,24450,281
2021-10-31,Calaveras,009,45235,4076,4052,54,4106,82
2021-10-31,Colusa,011,21464,2516,2493,641,3134,18
2021-10-31,Contra Costa,013,1133247,99526,98936,2195,101131,1025
2021-10-31,Del Norte,015,27424,3683,3591,54,3645,42
2021-10-31,El Dorado,017,186661,16051,15841,1685,17526,154
2021-10-31,Fresno,019,978130,139967,138165,12459,150624,2147
2021-10-31,Glenn,021,27897,3501,3459,983,4442,33
2021-10-31,Humboldt,023,135768,9016,8919,559,9478,108
2021-10-31,Imperial,025,180216,33632,33334,3385,36719,766
2021-10-31,Inyo,027,18085,2351,2309,41,2350,41
2021-10-31,Kern,029,883053,127472,125917,22151,148068,1666
2021-10-31,Kings,031,150075,32250,31814,1940,33754,338
2021-10-31,Lake,033,64148,6737,6665,149,6814,106
2021-10-31,Lassen,035,31185,6864,6768,371,7139,42
2021-10-31,Los Angeles,037,10098052,1437047,1427933,54443,1482376,26474
2021-10-31,Madera,039,155013,23132,22744,2106,24850,283
2021-10-31,Marin,041,260295,17566,17443,456,17899,247
2021-10-31,Mariposa,043,17540,1292,1257,46,1303,5
2021-10-31,Mendocino,045,87422,7541,7403,528,7931,84
2021-10-31,Merced,047,269075,41981,41699,1797,43496,589
2021-10-31,Modoc,049,8938,535,517,189,706,5
2021-10-31,Mono,051,14174,1719,1711,22,1733,3
2021-10-31,Monterey,053,433212,48750,47744,2915,50659,596
2021-10-31,Napa,055,140530,12987,12906,112,13018,101
2021-10-31,Nevada,057,99092,9189,9084,320,9404,91
2021-10-31,Orange,059,3164182,307311,305032,15141,320173,5596
2021-10-31,Placer,061,380077,37117,36698,3650,40348,435
2021-10-31,Plumas,063,18699,1776,1716,34,1750,7
2021-10-31,Riverside,065,2383286,363388,359005,16457,375462,5104
2021-10-31,Sacramento,067,1510023,158952,157667,4614,162281,2243
2021-10-31,San Benito,069,59416,7418,7397,169,7566,73
2021-10-31,San Bernardino,071,2135413,354106,351411,11164,362575,5810
2021-10-31,San Diego,073,3302833,374014,371603,21743,393346,4218
2021-10-31,San Francisco,075,870044,52919,52370,2333,54703,661
2021-10-31,San Joaquin,077,732212,99688,98893,5436,104329,1772
2021-10-31,San Luis Obispo,079,281455,29618,29176,1231,30407,343
2021-10-31,San Mateo,081,765935,54243,53284,873,54157,571
2021-10-31,Santa Barbara,083,443738,44373,44113,1614,45727,529
2021-10-31,Santa Clara,085,1922200,147065,145829,1336,147165,1908
2021-10-31,Santa Cruz,087,273765,20381,20218,1011,21229,221
2021-10-31,Shasta,089,179085,21445,21086,3597,24683,338
2021-10-31,Sierra,091,2930,185,180,20,200,0
2021-10-31,Siskiyou,093,43540,3332,3271,1290,4561,46
2021-10-31,Solano,095,438530,45962,45310,1264,46574,350
2021-10-31,Sonoma,097,501317,41452,41183,526,41709,395
2021-10-31,Stanislaus,099,539301,78288,78426,8830,87256,1193
2021-10-31,Sutter,101,95872,13929,13838,345,14183,179
2021-10-31,Tehama,103,63373,8511,8391,1488,9879,116
2021-10-31,Trinity,105,12862,856,724,216,940,11
2021-10-31,Tulare,107,460477,68498,67310,15055,82365,1002
2021-10-31,Tuolumne,109,53932,7231,7141,94,7235,90
2021-10-31,Ventura,111,848112,98109,97460,4315,101775,1178
2021-10-31,Yolo,113,214977,19858,19662,1133,20795,250
2021-10-31,Yuba,115,75493,10126,10051,322,10373,83
2021-10-30,Alameda,001,1643700,119686,118632,2817,121449,1419
2021-10-30,Alpine,003,1148,101,105,0,105,0
2021-10-30,Amador,005,37829,5568,5480,60,5540,64
2021-10-30,Butte,007,227075,20912,20516,3755,24271,277
2021-10-30,Calaveras,009,45235,4069,3992,54,4046,82
2021-10-30,Colusa,011,21464,2516,2484,640,3124,19
2021-10-30,Contra Costa,013,1133247,99462,98562,2194,100756,1024
2021-10-30,Del Norte,015,27424,3680,3574,54,3628,42
2021-10-30,El Dorado,017,186661,16035,15752,1680,17432,154
2021-10-30,Fresno,019,978130,139823,136901,12454,149355,2131
2021-10-30,Glenn,021,27897,3497,3442,983,4425,33
2021-10-30,Humboldt,023,135768,9001,8871,557,9428,105
2021-10-30,Imperial,025,180216,33587,33156,3381,36537,766
2021-10-30,Inyo,027,18085,2348,2249,41,2290,41
2021-10-30,Kern,029,883053,127320,124892,22080,146972,1653
2021-10-30,Kings,031,150075,32216,31578,1936,33514,337
2021-10-30,Lake,033,64148,6732,6610,149,6759,106
2021-10-30,Lassen,035,31185,6858,6719,369,7088,42
2021-10-30,Los Angeles,037,10098052,1436326,1424257,54389,1478646,26625
2021-10-30,Madera,039,155013,23088,22524,2101,24625,283
2021-10-30,Marin,041,260295,17551,17380,454,17834,247
2021-10-30,Mariposa,043,17540,1289,1228,46,1274,5
2021-10-30,Mendocino,045,87422,7518,7338,526,7864,84
2021-10-30,Merced,047,269075,41941,41428,1795,43223,586
2021-10-30,Modoc,049,8938,533,513,188,701,5
2021-10-30,Mono,051,14174,1719,1684,22,1706,3
2021-10-30,Monterey,053,433212,48733,47649,2909,50558,588
2021-10-30,Napa,055,140530,12973,12863,111,12974,101
2021-10-30,Nevada,057,99092,9170,9015,320,9335,91
2021-10-30,Orange,059,3164182,307132,304120,15119,319239,5588
2021-10-30,Placer,061,380077,37071,36400,3644,40044,434
2021-10-30,Plumas,063,18699,1771,1695,34,1729,7
2021-10-30,Riverside,065,2383286,363088,357645,16448,374093,5088
2021-10-30,Sacramento,067,1510023,158793,157125,4605,161730,2233
2021-10-30,San Benito,069,59416,7411,7362,169,7531,71
2021-10-30,San Bernardino,071,2135413,353829,350076,11150,361226,5777
2021-10-30,San Diego,073,3302833,373640,370006,21721,391727,4213
2021-10-30,San Francisco,075,870044,52890,52161,2331,54492,661
2021-10-30,San Joaquin,077,732212,99633,98314,5435,103749,1768
2021-10-30,San Luis Obispo,079,281455,29586,29053,1228,30281,341
2021-10-30,San Mateo,081,765935,54203,53083,873,53956,571
2021-10-30,Santa Barbara,083,443738,44338,43972,1613,45585,528
2021-10-30,Santa Clara,085,1922200,146960,145262,1332,146594,1903
2021-10-30,Santa Cruz,087,273765,20363,20134,1009,21143,221
2021-10-30,Shasta,089,179085,21400,20878,3591,24469,332
2021-10-30,Sierra,091,2930,185,175,20,195,0
2021-10-30,Siskiyou,093,43540,3331,3257,1287,4544,46
2021-10-30,Solano,095,438530,45941,45146,1262,46408,346
2021-10-30,Sonoma,097,501317,41413,40924,526,41450,393
2021-10-30,Stanislaus,099,539301,78218,77871,8823,86694,1191
2021-10-30,Sutter,101,95872,13916,13773,345,14118,178
2021-10-30,Tehama,103,63373,8500,8307,1483,9790,114
2021-10-30,Trinity,105,12862,854,708,215,923,11
2021-10-30,Tulare,107,460477,68427,66745,15008,81753,995
2021-10-30,Tuolumne,109,53932,7207,7050,93,7143,90
2021-10-30,Ventura,111,848112,98060,97182,4312,101494,1174
2021-10-30,Yolo,113,214977,19839,19568,1131,20699,250
2021-10-30,Yuba,115,75493,10115,9969,322,10291,82
2021-10-29,Alameda,001,1643700,119606,118632,2813,121445,1419
2021-10-29,Alpine,003,1148,101,105,0,105,0
2021-10-29,Amador,005,37829,5557,5480,60,5540,64
2021-10-29,Butte,007,227075,20888,20516,3745,24261,277
2021-10-29,Calaveras,009,45235,4062,3992,54,4046,82
2021-10-29,Colusa,011,21464,2516,2484,638,3122,19
2021-10-29,Contra Costa,013,1133247,99392,98562,2192,100754,1024
2021-10-29,Del Norte,015,27424,3673,3574,54,3628,42
2021-10-29,El Dorado,017,186661,16021,15752,1680,17432,154
2021-10-29,Fresno,019,978130,139608,136901,12442,149343,2131
2021-10-29,Glenn,021,27897,3496,3442,982,4424,33
2021-10-29,Humboldt,023,135768,8996,8871,556,9427,105
2021-10-29,Imperial,025,180216,33560,33156,3378,36534,766
2021-10-29,Inyo,027,18085,2345,2249,41,2290,41
2021-10-29,Kern,029,883053,127143,124892,21990,146882,1653
2021-10-29,Kings,031,150075,32182,31578,1934,33512,337
2021-10-29,Lake,033,64148,6723,6610,146,6756,106
2021-10-29,Lassen,035,31185,6849,6719,366,7085,42
2021-10-29,Los Angeles,037,10098052,1435482,1424257,54346,1478603,26625
2021-10-29,Madera,039,155013,23036,22524,2096,24620,283
2021-10-29,Marin,041,260295,17535,17380,453,17833,247
2021-10-29,Mariposa,043,17540,1285,1228,46,1274,5
2021-10-29,Mendocino,045,87422,7510,7338,526,7864,84
2021-10-29,Merced,047,269075,41891,41428,1789,43217,586
2021-10-29,Modoc,049,8938,531,513,187,700,5
2021-10-29,Mono,051,14174,1717,1684,22,1706,3
2021-10-29,Monterey,053,433212,48709,47649,2909,50558,588
2021-10-29,Napa,055,140530,12952,12863,111,12974,101
2021-10-29,Nevada,057,99092,9158,9015,320,9335,91
2021-10-29,Orange,059,3164182,306908,304120,15099,319219,5588
2021-10-29,Placer,061,380077,37035,36400,3633,40033,434
2021-10-29,Plumas,063,18699,1765,1695,34,1729,7
2021-10-29,Riverside,065,2383286,362754,357645,16443,374088,5088
2021-10-29,Sacramento,067,1510023,158605,157125,4596,161721,2233
2021-10-29,San Benito,069,59416,7408,7362,169,7531,71
2021-10-29,San Bernardino,071,2135413,353530,350076,11141,361217,5777
2021-10-29,San Diego,073,3302833,373264,370006,21693,391699,4213
2021-10-29,San Francisco,075,870044,52831,52161,2325,54486,661
2021-10-29,San Joaquin,077,732212,99576,98314,5430,103744,1768
2021-10-29,San Luis Obispo,079,281455,29560,29053,1226,30279,341
2021-10-29,San Mateo,081,765935,54159,53083,871,53954,571
2021-10-29,Santa Barbara,083,443738,44298,43972,1610,45582,528
2021-10-29,Santa Clara,085,1922200,146845,145262,1325,146587,1903
2021-10-29,Santa Cruz,087,273765,20356,20134,1008,21142,221
2021-10-29,Shasta,089,179085,21361,20878,3585,24463,332
2021-10-29,Sierra,091,2930,183,175,20,195,0
2021-10-29,Siskiyou,093,43540,3331,3257,1286,4543,46
2021-10-29,Solano,095,438530,45904,45146,1261,46407,346
2021-10-29,Sonoma,097,501317,41392,40924,526,41450,393
2021-10-29,Stanislaus,099,539301,78132,77871,8812,86683,1191
2021-10-29,Sutter,101,95872,13897,13773,345,14118,178
2021-10-29,Tehama,103,63373,8487,8307,1482,9789,114
2021-10-29,Trinity,105,12862,853,708,215,923,11
2021-10-29,Tulare,107,460477,68322,66745,14962,81707,995
2021-10-29,Tuolumne,109,53932,7194,7050,93,7143,90
2021-10-29,Ventura,111,848112,98005,97182,4308,101490,1174
2021-10-29,Yolo,113,214977,19821,19568,1126,20694,250
2021-10-29,Yuba,115,75493,10107,9969,318,10287,82
2021-10-28,Alameda,001,1643700,119480,118632,2806,121438,1419
2021-10-28,Alpine,003,1148,101,105,0,105,0
2021-10-28,Amador,005,37829,5544,5480,60,5540,64
2021-10-28,Butte,007,227075,20845,20516,3736,24252,277
2021-10-28,Calaveras,009,45235,4049,3992,54,4046,82
2021-10-28,Colusa,011,21464,2513,2484,637,3121,19
2021-10-28,Contra Costa,013,1133247,99261,98562,2187,100749,1024
2021-10-28,Del Norte,015,27424,3672,3574,54,3628,42
2021-10-28,El Dorado,017,186661,15995,15752,1677,17429,154
2021-10-28,Fresno,019,978130,139278,136901,12414,149315,2131
2021-10-28,Glenn,021,27897,3493,3442,980,4422,33
2021-10-28,Humboldt,023,135768,8980,8871,551,9422,105
2021-10-28,Imperial,025,180216,33495,33156,3371,36527,766
2021-10-28,Inyo,027,18085,2328,2249,41,2290,41
2021-10-28,Kern,029,883053,126895,124892,21876,146768,1653
2021-10-28,Kings,031,150075,32113,31578,1929,33507,337
2021-10-28,Lake,033,64148,6713,6610,146,6756,106
2021-10-28,Lassen,035,31185,6839,6719,362,7081,42
2021-10-28,Los Angeles,037,10098052,1434345,1424257,54272,1478529,26625
2021-10-28,Madera,039,155013,22982,22524,2085,24609,283
2021-10-28,Marin,041,260295,17517,17380,452,17832,247
2021-10-28,Mariposa,043,17540,1281,1228,46,1274,5
2021-10-28,Mendocino,045,87422,7497,7338,515,7853,84
2021-10-28,Merced,047,269075,41806,41428,1778,43206,586
2021-10-28,Modoc,049,8938,530,513,187,700,5
2021-10-28,Mono,051,14174,1711,1684,22,1706,3
2021-10-28,Monterey,053,433212,48680,47649,2891,50540,588
2021-10-28,Napa,055,140530,12943,12863,110,12973,101
2021-10-28,Nevada,057,99092,9140,9015,320,9335,91
2021-10-28,Orange,059,3164182,306622,304120,15034,319154,5588
2021-10-28,Placer,061,380077,36956,36400,3624,40024,434
2021-10-28,Plumas,063,18699,1757,1695,34,1729,7
2021-10-28,Riverside,065,2383286,362316,357645,16419,374064,5088
2021-10-28,Sacramento,067,1510023,158339,157125,4584,161709,2233
2021-10-28,San Benito,069,59416,7400,7362,169,7531,71
2021-10-28,San Bernardino,071,2135413,353115,350076,11119,361195,5777
2021-10-28,San Diego,073,3302833,372791,370006,21670,391676,4213
2021-10-28,San Francisco,075,870044,52784,52161,2318,54479,661
2021-10-28,San Joaquin,077,732212,99448,98314,5429,103743,1768
2021-10-28,San Luis Obispo,079,281455,29531,29053,1223,30276,341
2021-10-28,San Mateo,081,765935,54114,53083,869,53952,571
2021-10-28,Santa Barbara,083,443738,44259,43972,1608,45580,528
2021-10-28,Santa Clara,085,1922200,146688,145262,1320,146582,1903
2021-10-28,Santa Cruz,087,273765,20332,20134,1008,21142,221
2021-10-28,Shasta,089,179085,21286,20878,3578,24456,332
2021-10-28,Sierra,091,2930,182,175,20,195,0
2021-10-28,Siskiyou,093,43540,3330,3257,1286,4543,46
2021-10-28,Solano,095,438530,45865,45146,1260,46406,346
2021-10-28,Sonoma,097,501317,41324,40924,525,41449,393
2021-10-28,Stanislaus,099,539301,77980,77871,8796,86667,1191
2021-10-28,Sutter,101,95872,13884,13773,341,14114,178
2021-10-28,Tehama,103,63373,8449,8307,1479,9786,114
2021-10-28,Trinity,105,12862,850,708,215,923,11
2021-10-28,Tulare,107,460477,68182,66745,14904,81649,995
2021-10-28,Tuolumne,109,53932,7163,7050,93,7143,90
2021-10-28,Ventura,111,848112,97920,97182,4305,101487,1174
2021-10-28,Yolo,113,214977,19783,19568,1121,20689,250
2021-10-28,Yuba,115,75493,10078,9969,315,10284,82
2021-10-27,Alameda,001,1643700,119357,118487,2804,121291,1414
2021-10-27,Alpine,003,1148,101,105,0,105,0
2021-10-27,Amador,005,37829,5532,5470,59,5529,64
2021-10-27,Butte,007,227075,20801,20446,3722,24168,274
2021-10-27,Calaveras,009,45235,4031,3970,53,4023,82
2021-10-27,Colusa,011,21464,2512,2480,636,3116,18
2021-10-27,Contra Costa,013,1133247,99153,98442,2175,100617,1018
2021-10-27,Del Norte,015,27424,3665,3571,53,3624,42
2021-10-27,El Dorado,017,186661,15964,15723,1672,17395,154
2021-10-27,Fresno,019,978130,138897,136447,12384,148831,2128
2021-10-27,Glenn,021,27897,3489,3435,979,4414,33
2021-10-27,Humboldt,023,135768,8960,8851,549,9400,105
2021-10-27,Imperial,025,180216,33456,33068,3366,36434,766
2021-10-27,Inyo,027,18085,2308,2236,41,2277,41
2021-10-27,Kern,029,883053,126625,124557,21776,146333,1647
2021-10-27,Kings,031,150075,32047,31437,1924,33361,335
2021-10-27,Lake,033,64148,6686,6589,146,6735,105
2021-10-27,Lassen,035,31185,6825,6706,360,7066,42
2021-10-27,Los Angeles,037,10098052,1433113,1422615,54213,1476828,26604
2021-10-27,Madera,039,155013,22897,22413,2063,24476,283
2021-10-27,Marin,041,260295,17502,17362,452,17814,247
2021-10-27,Mariposa,043,17540,1268,1228,46,1274,5
2021-10-27,Mendocino,045,87422,7483,7321,508,7829,84
2021-10-27,Merced,047,269075,41708,41310,1764,43074,583
2021-10-27,Modoc,049,8938,526,513,187,700,5
2021-10-27,Mono,051,14174,1708,1682,22,1704,3
2021-10-27,Monterey,053,433212,48642,47610,2869,50479,588
2021-10-27,Napa,055,140530,12928,12856,109,12965,101
2021-10-27,Nevada,057,99092,9123,8987,319,9306,90
2021-10-27,Orange,059,3164182,306302,303825,14983,318808,5584
2021-10-27,Placer,061,380077,36890,36296,3617,39913,434
2021-10-27,Plumas,063,18699,1749,1686,34,1720,7
2021-10-27,Riverside,065,2383286,361887,357152,16411,373563,5081
2021-10-27,Sacramento,067,1510023,158071,156830,4563,161393,2230
2021-10-27,San Benito,069,59416,7394,7337,169,7506,71
2021-10-27,San Bernardino,071,2135413,352694,349624,11098,360722,5770
2021-10-27,San Diego,073,3302833,372215,369579,21646,391225,4207
2021-10-27,San Francisco,075,870044,52732,52108,2314,54422,655
2021-10-27,San Joaquin,077,732212,99288,98168,5414,103582,1753
2021-10-27,San Luis Obispo,079,281455,29492,29002,1221,30223,341
2021-10-27,San Mateo,081,765935,54059,53032,861,53893,571
2021-10-27,Santa Barbara,083,443738,44206,43901,1605,45506,527
2021-10-27,Santa Clara,085,1922200,146511,145081,1312,146393,1902
2021-10-27,Santa Cruz,087,273765,20305,20091,1006,21097,221
2021-10-27,Shasta,089,179085,21212,20813,3570,24383,331
2021-10-27,Sierra,091,2930,181,176,20,196,0
2021-10-27,Siskiyou,093,43540,3327,3256,1282,4538,46
2021-10-27,Solano,095,438530,45820,45089,1252,46341,346
2021-10-27,Sonoma,097,501317,41248,40829,523,41352,393
2021-10-27,Stanislaus,099,539301,77820,77687,8782,86469,1191
2021-10-27,Sutter,101,95872,13870,13754,341,14095,177
2021-10-27,Tehama,103,63373,8427,8265,1477,9742,113
2021-10-27,Trinity,105,12862,850,706,214,920,11
2021-10-27,Tulare,107,460477,68028,66568,14846,81414,991
2021-10-27,Tuolumne,109,53932,7136,7009,92,7101,90
2021-10-27,Ventura,111,848112,97828,97108,4300,101408,1172
2021-10-27,Yolo,113,214977,19754,19517,1114,20631,250
2021-10-27,Yuba,115,75493,10057,9945,313,10258,82
2021-10-26,Alameda,001,1643700,119220,118360,2801,121161,1407
2021-10-26,Alpine,003,1148,101,105,0,105,0
2021-10-26,Amador,005,37829,5524,5465,58,5523,64
2021-10-26,Butte,007,227075,20743,20387,3705,24092,274
2021-10-26,Calaveras,009,45235,4020,3966,53,4019,81
2021-10-26,Colusa,011,21464,2510,2478,635,3113,18
2021-10-26,Contra Costa,013,1133247,99030,98352,2165,100517,1017
2021-10-26,Del Norte,015,27424,3660,3563,53,3616,42
2021-10-26,El Dorado,017,186661,15936,15690,1663,17353,153
2021-10-26,Fresno,019,978130,138452,136211,12348,148559,2122
2021-10-26,Glenn,021,27897,3474,3431,976,4407,33
2021-10-26,Humboldt,023,135768,8942,8830,543,9373,105
2021-10-26,Imperial,025,180216,33391,33012,3361,36373,766
2021-10-26,Inyo,027,18085,2293,2200,41,2241,41
2021-10-26,Kern,029,883053,126282,124351,21655,146006,1645
2021-10-26,Kings,031,150075,31980,31382,1917,33299,336
2021-10-26,Lake,033,64148,6676,6584,144,6728,105
2021-10-26,Lassen,035,31185,6805,6689,358,7047,42
2021-10-26,Los Angeles,037,10098052,1431765,1421795,54142,1475937,26599
2021-10-26,Madera,039,155013,22807,22363,2052,24415,283
2021-10-26,Marin,041,260295,17485,17354,451,17805,244
2021-10-26,Mariposa,043,17540,1263,1225,45,1270,5
2021-10-26,Mendocino,045,87422,7454,7308,491,7799,83
2021-10-26,Merced,047,269075,41630,41267,1757,43024,583
2021-10-26,Modoc,049,8938,526,513,187,700,5
2021-10-26,Mono,051,14174,1703,1680,22,1702,3
2021-10-26,Monterey,053,433212,48604,47572,2858,50430,588
2021-10-26,Napa,055,140530,12916,12849,109,12958,101
2021-10-26,Nevada,057,99092,9092,8971,318,9289,90
2021-10-26,Orange,059,3164182,306032,303533,14944,318477,5580
2021-10-26,Placer,061,380077,36792,36245,3611,39856,434
2021-10-26,Plumas,063,18699,1740,1645,34,1679,7
2021-10-26,Riverside,065,2383286,361400,356775,16401,373176,5068
2021-10-26,Sacramento,067,1510023,157770,156643,4546,161189,2228
2021-10-26,San Benito,069,59416,7371,7325,169,7494,71
2021-10-26,San Bernardino,071,2135413,352272,349346,11083,360429,5764
2021-10-26,San Diego,073,3302833,371696,369043,21616,390659,4198
2021-10-26,San Francisco,075,870044,52657,52063,2311,54374,655
2021-10-26,San Joaquin,077,732212,99111,98036,5399,103435,1748
2021-10-26,San Luis Obispo,079,281455,29453,28928,1215,30143,337
2021-10-26,San Mateo,081,765935,53987,52974,858,53832,571
2021-10-26,Santa Barbara,083,443738,44160,43835,1604,45439,525
2021-10-26,Santa Clara,085,1922200,146312,144932,1306,146238,1903
2021-10-26,Santa Cruz,087,273765,20274,20067,1005,21072,221
2021-10-26,Shasta,089,179085,21152,20725,3552,24277,330
2021-10-26,Sierra,091,2930,181,169,20,189,0
2021-10-26,Siskiyou,093,43540,3321,3254,1280,4534,46
2021-10-26,Solano,095,438530,45763,45044,1251,46295,344
2021-10-26,Sonoma,097,501317,41166,40794,521,41315,393
2021-10-26,Stanislaus,099,539301,77644,77552,8757,86309,1157
2021-10-26,Sutter,101,95872,13840,13739,340,14079,176
2021-10-26,Tehama,103,63373,8398,8247,1471,9718,112
2021-10-26,Trinity,105,12862,846,705,214,919,11
2021-10-26,Tulare,107,460477,67868,66476,14784,81260,991
2021-10-26,Tuolumne,109,53932,7110,6995,90,7085,90
2021-10-26,Ventura,111,848112,97719,97014,4296,101310,1170
2021-10-26,Yolo,113,214977,19726,19490,1111,20601,248
2021-10-26,Yuba,115,75493,10039,9927,308,10235,82
2021-10-25,Alameda,001,1643700,119070,118319,2799,121118,1404
2021-10-25,Alpine,003,1148,101,105,0,105,0
2021-10-25,Amador,005,37829,5510,5455,58,5513,64
2021-10-25,Butte,007,227075,20669,20331,3697,24028,273
2021-10-25,Calaveras,009,45235,3990,3942,52,3994,82
2021-10-25,Colusa,011,21464,2508,2471,633,3104,18
2021-10-25,Contra Costa,013,1133247,98911,98267,2160,100427,1017
2021-10-25,Del Norte,015,27424,3653,3562,53,3615,42
2021-10-25,El Dorado,017,186661,15901,15663,1661,17324,149
2021-10-25,Fresno,019,978130,138017,135974,12309,148283,2112
2021-10-25,Glenn,021,27897,3473,3421,975,4396,33
2021-10-25,Humboldt,023,135768,8918,8825,538,9363,105
2021-10-25,Imperial,025,180216,33330,32968,3350,36318,766
2021-10-25,Inyo,027,18085,2275,2183,41,2224,41
2021-10-25,Kern,029,883053,125931,124078,21516,145594,1649
2021-10-25,Kings,031,150075,31891,31329,1908,33237,335
2021-10-25,Lake,033,64148,6663,6571,144,6715,105
2021-10-25,Lassen,035,31185,6794,6688,356,7044,42
2021-10-25,Los Angeles,037,10098052,1430401,1421061,54076,1475137,26579
2021-10-25,Madera,039,155013,22753,22325,2044,24369,281
2021-10-25,Marin,041,260295,17463,17334,449,17783,244
2021-10-25,Mariposa,043,17540,1249,1220,45,1265,5
2021-10-25,Mendocino,045,87422,7424,7296,487,7783,82
2021-10-25,Merced,047,269075,41562,41207,1730,42937,583
2021-10-25,Modoc,049,8938,524,512,185,697,5
2021-10-25,Mono,051,14174,1695,1677,22,1699,3
2021-10-25,Monterey,053,433212,48572,47547,2856,50403,587
2021-10-25,Napa,055,140530,12903,12841,109,12950,100
2021-10-25,Nevada,057,99092,9066,8958,318,9276,90
2021-10-25,Orange,059,3164182,305734,303279,14906,318185,5574
2021-10-25,Placer,061,380077,36685,36153,3601,39754,431
2021-10-25,Plumas,063,18699,1728,1641,34,1675,7
2021-10-25,Riverside,065,2383286,360973,356381,16386,372767,5056
2021-10-25,Sacramento,067,1510023,157464,156516,4520,161036,2235
2021-10-25,San Benito,069,59416,7357,7314,168,7482,71
2021-10-25,San Bernardino,071,2135413,351774,349075,11071,360146,5748
2021-10-25,San Diego,073,3302833,371110,368386,21588,389974,4196
2021-10-25,San Francisco,075,870044,52583,52041,2304,54345,649
2021-10-25,San Joaquin,077,732212,98908,97980,5390,103370,1740
2021-10-25,San Luis Obispo,079,281455,29405,28907,1210,30117,336
2021-10-25,San Mateo,081,765935,53926,52927,854,53781,571
2021-10-25,Santa Barbara,083,443738,44101,43775,1604,45379,525
2021-10-25,Santa Clara,085,1922200,146122,144895,1301,146196,1901
2021-10-25,Santa Cruz,087,273765,20246,20053,1004,21057,221
2021-10-25,Shasta,089,179085,21080,20666,3545,24211,326
2021-10-25,Sierra,091,2930,181,168,20,188,0
2021-10-25,Siskiyou,093,43540,3317,3248,1275,4523,46
2021-10-25,Solano,095,438530,45702,45022,1249,46271,344
2021-10-25,Sonoma,097,501317,41093,40746,519,41265,393
2021-10-25,Stanislaus,099,539301,77451,77452,8728,86180,1145
2021-10-25,Sutter,101,95872,13827,13721,337,14058,176
2021-10-25,Tehama,103,63373,8371,8224,1467,9691,111
2021-10-25,Trinity,105,12862,841,699,213,912,11
2021-10-25,Tulare,107,460477,67674,66357,14721,81078,986
2021-10-25,Tuolumne,109,53932,7076,6952,89,7041,90
2021-10-25,Ventura,111,848112,97628,96932,4293,101225,1167
2021-10-25,Yolo,113,214977,19677,19457,1107,20564,248
2021-10-25,Yuba,115,75493,10023,9924,304,10228,82
2021-10-24,Alameda,001,1643700,118937,117816,2794,120610,1397
2021-10-24,Alpine,003,1148,101,105,0,105,0
2021-10-24,Amador,005,37829,5505,5412,58,5470,64
2021-10-24,Butte,007,227075,20600,20101,3685,23786,273
2021-10-24,Calaveras,009,45235,3971,3865,51,3916,81
2021-10-24,Colusa,011,21464,2504,2458,630,3088,18
2021-10-24,Contra Costa,013,1133247,98792,97855,2151,100006,1008
2021-10-24,Del Norte,015,27424,3649,3540,53,3593,42
2021-10-24,El Dorado,017,186661,15865,15540,1657,17197,149
2021-10-24,Fresno,019,978130,137585,134466,12271,146737,2094
2021-10-24,Glenn,021,27897,3466,3399,973,4372,33
2021-10-24,Humboldt,023,135768,8905,8753,532,9285,105
2021-10-24,Imperial,025,180216,33252,32777,3342,36119,766
2021-10-24,Inyo,027,18085,2243,2108,41,2149,41
2021-10-24,Kern,029,883053,125599,122939,21397,144336,1636
2021-10-24,Kings,031,150075,31762,30942,1892,32834,325
2021-10-24,Lake,033,64148,6640,6501,143,6644,105
2021-10-24,Lassen,035,31185,6777,6632,355,6987,27
2021-10-24,Los Angeles,037,10098052,1428961,1415919,54008,1469927,26527
2021-10-24,Madera,039,155013,22676,22062,2031,24093,281
2021-10-24,Marin,041,260295,17447,17264,448,17712,244
2021-10-24,Mariposa,043,17540,1246,1184,45,1229,5
2021-10-24,Mendocino,045,87422,7400,7220,476,7696,82
2021-10-24,Merced,047,269075,41440,40808,1725,42533,581
2021-10-24,Modoc,049,8938,523,507,185,692,5
2021-10-24,Mono,051,14174,1690,1655,22,1677,3
2021-10-24,Monterey,053,433212,48524,47456,2845,50301,586
2021-10-24,Napa,055,140530,12892,12789,109,12898,100
2021-10-24,Nevada,057,99092,9043,8861,315,9176,90
2021-10-24,Orange,059,3164182,305385,302237,14868,317105,5546
2021-10-24,Placer,061,380077,36581,35822,3587,39409,426
2021-10-24,Plumas,063,18699,1718,1623,33,1656,7
2021-10-24,Riverside,065,2383286,360499,354688,16366,371054,5041
2021-10-24,Sacramento,067,1510023,157121,155125,4496,159621,2232
2021-10-24,San Benito,069,59416,7337,7280,168,7448,71
2021-10-24,San Bernardino,071,2135413,351227,347681,11060,358741,5688
2021-10-24,San Diego,073,3302833,370507,366085,21557,387642,4183
2021-10-24,San Francisco,075,870044,52520,51820,2298,54118,649
2021-10-24,San Joaquin,077,732212,98735,97440,5384,102824,1721
2021-10-24,San Luis Obispo,079,281455,29344,28755,1203,29958,333
2021-10-24,San Mateo,081,765935,53853,52719,854,53573,571
2021-10-24,Santa Barbara,083,443738,44035,43552,1602,45154,523
2021-10-24,Santa Clara,085,1922200,145931,144276,1291,145567,1897
2021-10-24,Santa Cruz,087,273765,20208,19967,1003,20970,221
2021-10-24,Shasta,089,179085,20980,20386,3539,23925,321
2021-10-24,Sierra,091,2930,181,168,20,188,0
2021-10-24,Siskiyou,093,43540,3310,3231,1271,4502,46
2021-10-24,Solano,095,438530,45652,44861,1244,46105,341
2021-10-24,Sonoma,097,501317,41011,40476,519,40995,393
2021-10-24,Stanislaus,099,539301,77259,76812,8716,85528,1145
2021-10-24,Sutter,101,95872,13800,13616,329,13945,175
2021-10-24,Tehama,103,63373,8323,8105,1455,9560,110
2021-10-24,Trinity,105,12862,837,696,210,906,11
2021-10-24,Tulare,107,460477,67502,65585,14649,80234,978
2021-10-24,Tuolumne,109,53932,7036,6840,87,6927,90
2021-10-24,Ventura,111,848112,97521,96664,4292,100956,1167
2021-10-24,Yolo,113,214977,19630,19280,1104,20384,248
2021-10-24,Yuba,115,75493,9998,9838,303,10141,82
2021-10-23,Alameda,001,1643700,118850,117816,2789,120605,1397
2021-10-23,Alpine,003,1148,101,105,0,105,0
2021-10-23,Amador,005,37829,5498,5412,58,5470,64
2021-10-23,Butte,007,227075,20566,20101,3676,23777,273
2021-10-23,Calaveras,009,45235,3964,3865,50,3915,81
2021-10-23,Colusa,011,21464,2502,2458,629,3087,18
2021-10-23,Contra Costa,013,1133247,98740,97855,2147,100002,1008
2021-10-23,Del Norte,015,27424,3647,3540,53,3593,42
2021-10-23,El Dorado,017,186661,15839,15540,1655,17195,149
2021-10-23,Fresno,019,978130,137408,134466,12264,146730,2094
2021-10-23,Glenn,021,27897,3464,3399,972,4371,33
2021-10-23,Humboldt,023,135768,8890,8753,527,9280,105
2021-10-23,Imperial,025,180216,33205,32777,3338,36115,766
2021-10-23,Inyo,027,18085,2232,2108,41,2149,41
2021-10-23,Kern,029,883053,125439,122939,21309,144248,1636
2021-10-23,Kings,031,150075,31716,30942,1890,32832,325
2021-10-23,Lake,033,64148,6635,6501,143,6644,105
2021-10-23,Lassen,035,31185,6774,6632,353,6985,27
2021-10-23,Los Angeles,037,10098052,1428285,1415919,53953,1469872,26527
2021-10-23,Madera,039,155013,22627,22062,2022,24084,281
2021-10-23,Marin,041,260295,17430,17264,447,17711,244
2021-10-23,Mariposa,043,17540,1243,1184,44,1228,5
2021-10-23,Mendocino,045,87422,7393,7220,475,7695,82
2021-10-23,Merced,047,269075,41399,40808,1723,42531,581
2021-10-23,Modoc,049,8938,521,507,185,692,5
2021-10-23,Mono,051,14174,1684,1655,22,1677,3
2021-10-23,Monterey,053,433212,48506,47456,2841,50297,586
2021-10-23,Napa,055,140530,12887,12789,109,12898,100
2021-10-23,Nevada,057,99092,9032,8861,313,9174,90
2021-10-23,Orange,059,3164182,305198,302237,14852,317089,5546
2021-10-23,Placer,061,380077,36519,35822,3581,39403,426
2021-10-23,Plumas,063,18699,1717,1623,33,1656,7
2021-10-23,Riverside,065,2383286,360179,354688,16359,371047,5041
2021-10-23,Sacramento,067,1510023,156992,155125,4488,159613,2232
2021-10-23,San Benito,069,59416,7327,7280,168,7448,71
2021-10-23,San Bernardino,071,2135413,350959,347681,11053,358734,5688
2021-10-23,San Diego,073,3302833,370149,366085,21526,387611,4183
2021-10-23,San Francisco,075,870044,52485,51820,2297,54117,649
2021-10-23,San Joaquin,077,732212,98667,97440,5375,102815,1721
2021-10-23,San Luis Obispo,079,281455,29307,28755,1201,29956,333
2021-10-23,San Mateo,081,765935,53815,52719,853,53572,571
2021-10-23,Santa Barbara,083,443738,44004,43552,1600,45152,523
2021-10-23,Santa Clara,085,1922200,145823,144276,1287,145563,1897
2021-10-23,Santa Cruz,087,273765,20196,19967,1003,20970,221
2021-10-23,Shasta,089,179085,20944,20386,3527,23913,321
2021-10-23,Sierra,091,2930,180,168,20,188,0
2021-10-23,Siskiyou,093,43540,3308,3231,1271,4502,46
2021-10-23,Solano,095,438530,45627,44861,1241,46102,341
2021-10-23,Sonoma,097,501317,40971,40476,519,40995,393
2021-10-23,Stanislaus,099,539301,77170,76812,8697,85509,1145
2021-10-23,Sutter,101,95872,13795,13616,328,13944,175
2021-10-23,Tehama,103,63373,8311,8105,1454,9559,110
2021-10-23,Trinity,105,12862,836,696,210,906,11
2021-10-23,Tulare,107,460477,67413,65585,14589,80174,978
2021-10-23,Tuolumne,109,53932,7015,6840,87,6927,90
2021-10-23,Ventura,111,848112,97460,96664,4292,100956,1167
2021-10-23,Yolo,113,214977,19613,19280,1101,20381,248
2021-10-23,Yuba,115,75493,9990,9838,303,10141,82
2021-10-22,Alameda,001,1643700,118763,117816,2786,120602,1397
2021-10-22,Alpine,003,1148,101,105,0,105,0
2021-10-22,Amador,005,37829,5487,5412,58,5470,64
2021-10-22,Butte,007,227075,20534,20101,3672,23773,273
2021-10-22,Calaveras,009,45235,3956,3865,50,3915,81
2021-10-22,Colusa,011,21464,2499,2458,629,3087,18
2021-10-22,Contra Costa,013,1133247,98649,97855,2145,100000,1008
2021-10-22,Del Norte,015,27424,3643,3540,53,3593,42
2021-10-22,El Dorado,017,186661,15826,15540,1653,17193,149
2021-10-22,Fresno,019,978130,137195,134466,12255,146721,2094
2021-10-22,Glenn,021,27897,3454,3399,972,4371,33
2021-10-22,Humboldt,023,135768,8877,8753,526,9279,105
2021-10-22,Imperial,025,180216,33162,32777,3338,36115,766
2021-10-22,Inyo,027,18085,2219,2108,41,2149,41
2021-10-22,Kern,029,883053,125252,122939,21236,144175,1636
2021-10-22,Kings,031,150075,31681,30942,1889,32831,325
2021-10-22,Lake,033,64148,6625,6501,143,6644,105
2021-10-22,Lassen,035,31185,6767,6632,350,6982,27
2021-10-22,Los Angeles,037,10098052,1427532,1415919,53893,1469812,26527
2021-10-22,Madera,039,155013,22578,22062,2009,24071,281
2021-10-22,Marin,041,260295,17418,17264,447,17711,244
2021-10-22,Mariposa,043,17540,1240,1184,44,1228,5
2021-10-22,Mendocino,045,87422,7379,7220,474,7694,82
2021-10-22,Merced,047,269075,41360,40808,1718,42526,581
2021-10-22,Modoc,049,8938,521,507,185,692,5
2021-10-22,Mono,051,14174,1682,1655,22,1677,3
2021-10-22,Monterey,053,433212,48473,47456,2839,50295,586
2021-10-22,Napa,055,140530,12881,12789,109,12898,100
2021-10-22,Nevada,057,99092,9015,8861,312,9173,90
2021-10-22,Orange,059,3164182,304982,302237,14821,317058,5546
2021-10-22,Placer,061,380077,36491,35822,3572,39394,426
2021-10-22,Plumas,063,18699,1711,1623,33,1656,7
2021-10-22,Riverside,065,2383286,359868,354688,16354,371042,5041
2021-10-22,Sacramento,067,1510023,156805,155125,4478,159603,2232
2021-10-22,San Benito,069,59416,7322,7280,168,7448,71
2021-10-22,San Bernardino,071,2135413,350630,347681,11039,358720,5688
2021-10-22,San Diego,073,3302833,369736,366085,21508,387593,4183
2021-10-22,San Francisco,075,870044,52450,51820,2290,54110,649
2021-10-22,San Joaquin,077,732212,98608,97440,5372,102812,1721
2021-10-22,San Luis Obispo,079,281455,29277,28755,1201,29956,333
2021-10-22,San Mateo,081,765935,53766,52719,846,53565,571
2021-10-22,Santa Barbara,083,443738,43963,43552,1600,45152,523
2021-10-22,Santa Clara,085,1922200,145667,144276,1280,145556,1897
2021-10-22,Santa Cruz,087,273765,20174,19967,1003,20970,221
2021-10-22,Shasta,089,179085,20912,20386,3524,23910,321
2021-10-22,Sierra,091,2930,179,168,19,187,0
2021-10-22,Siskiyou,093,43540,3306,3231,1268,4499,46
2021-10-22,Solano,095,438530,45592,44861,1237,46098,341
2021-10-22,Sonoma,097,501317,40914,40476,519,40995,393
2021-10-22,Stanislaus,099,539301,77067,76812,8678,85490,1145
2021-10-22,Sutter,101,95872,13780,13616,328,13944,175
2021-10-22,Tehama,103,63373,8289,8105,1449,9554,110
2021-10-22,Trinity,105,12862,835,696,210,906,11
2021-10-22,Tulare,107,460477,67325,65585,14535,80120,978
2021-10-22,Tuolumne,109,53932,6980,6840,87,6927,90
2021-10-22,Ventura,111,848112,97407,96664,4286,100950,1167
2021-10-22,Yolo,113,214977,19586,19280,1099,20379,248
2021-10-22,Yuba,115,75493,9976,9838,301,10139,82
2021-10-21,Alameda,001,1643700,118648,117816,2781,120597,1397
2021-10-21,Alpine,003,1148,101,105,0,105,0
2021-10-21,Amador,005,37829,5479,5412,58,5470,64
2021-10-21,Butte,007,227075,20451,20101,3659,23760,273
2021-10-21,Calaveras,009,45235,3937,3865,50,3915,81
2021-10-21,Colusa,011,21464,2495,2458,622,3080,18
2021-10-21,Contra Costa,013,1133247,98534,97855,2139,99994,1008
2021-10-21,Del Norte,015,27424,3637,3540,52,3592,42
2021-10-21,El Dorado,017,186661,15798,15540,1646,17186,149
2021-10-21,Fresno,019,978130,136848,134466,12216,146682,2094
2021-10-21,Glenn,021,27897,3450,3399,968,4367,33
2021-10-21,Humboldt,023,135768,8863,8753,522,9275,105
2021-10-21,Imperial,025,180216,33107,32777,3334,36111,766
2021-10-21,Inyo,027,18085,2197,2108,41,2149,41
2021-10-21,Kern,029,883053,125005,122939,21124,144063,1636
2021-10-21,Kings,031,150075,31583,30942,1883,32825,325
2021-10-21,Lake,033,64148,6612,6501,142,6643,105
2021-10-21,Lassen,035,31185,6754,6632,346,6978,27
2021-10-21,Los Angeles,037,10098052,1426420,1415919,53843,1469762,26527
2021-10-21,Madera,039,155013,22520,22062,1999,24061,281
2021-10-21,Marin,041,260295,17400,17264,447,17711,244
2021-10-21,Mariposa,043,17540,1234,1184,43,1227,5
2021-10-21,Mendocino,045,87422,7361,7220,466,7686,82
2021-10-21,Merced,047,269075,41258,40808,1711,42519,581
2021-10-21,Modoc,049,8938,521,507,185,692,5
2021-10-21,Mono,051,14174,1673,1655,22,1677,3
2021-10-21,Monterey,053,433212,48439,47456,2827,50283,586
2021-10-21,Napa,055,140530,12869,12789,109,12898,100
2021-10-21,Nevada,057,99092,8990,8861,312,9173,90
2021-10-21,Orange,059,3164182,304709,302237,14785,317022,5546
2021-10-21,Placer,061,380077,36402,35822,3559,39381,426
2021-10-21,Plumas,063,18699,1697,1623,33,1656,7
2021-10-21,Riverside,065,2383286,359423,354688,16343,371031,5041
2021-10-21,Sacramento,067,1510023,156486,155125,4453,159578,2232
2021-10-21,San Benito,069,59416,7315,7280,166,7446,71
2021-10-21,San Bernardino,071,2135413,350252,347681,11004,358685,5688
2021-10-21,San Diego,073,3302833,369211,366085,21478,387563,4183
2021-10-21,San Francisco,075,870044,52394,51820,2289,54109,649
2021-10-21,San Joaquin,077,732212,98469,97440,5365,102805,1721
2021-10-21,San Luis Obispo,079,281455,29235,28755,1199,29954,333
2021-10-21,San Mateo,081,765935,53720,52719,845,53564,571
2021-10-21,Santa Barbara,083,443738,43897,43552,1598,45150,523
2021-10-21,Santa Clara,085,1922200,145494,144276,1276,145552,1897
2021-10-21,Santa Cruz,087,273765,20150,19967,1001,20968,221
2021-10-21,Shasta,089,179085,20850,20386,3509,23895,321
2021-10-21,Sierra,091,2930,178,168,18,186,0
2021-10-21,Siskiyou,093,43540,3301,3231,1266,4497,46
2021-10-21,Solano,095,438530,45540,44861,1235,46096,341
2021-10-21,Sonoma,097,501317,40845,40476,517,40993,393
2021-10-21,Stanislaus,099,539301,76898,76812,8667,85479,1145
2021-10-21,Sutter,101,95872,13752,13616,324,13940,175
2021-10-21,Tehama,103,63373,8262,8105,1442,9547,110
2021-10-21,Trinity,105,12862,833,696,210,906,11
2021-10-21,Tulare,107,460477,67134,65585,14464,80049,978
2021-10-21,Tuolumne,109,53932,6942,6840,86,6926,90
2021-10-21,Ventura,111,848112,97316,96664,4284,100948,1167
2021-10-21,Yolo,113,214977,19539,19280,1097,20377,248
2021-10-21,Yuba,115,75493,9952,9838,300,10138,82
2021-10-20,Alameda,001,1643700,118523,117654,2780,120434,1390
2021-10-20,Alpine,003,1148,101,103,0,103,0
2021-10-20,Amador,005,37829,5471,5379,58,5437,64
2021-10-20,Butte,007,227075,20397,20021,3644,23665,270
2021-10-20,Calaveras,009,45235,3917,3844,49,3893,81
2021-10-20,Colusa,011,21464,2491,2454,620,3074,18
2021-10-20,Contra Costa,013,1133247,98419,97721,2135,99856,1008
2021-10-20,Del Norte,015,27424,3633,3536,52,3588,42
2021-10-20,El Dorado,017,186661,15768,15502,1643,17145,149
2021-10-20,Fresno,019,978130,136449,134025,12191,146216,2084
2021-10-20,Glenn,021,27897,3442,3382,967,4349,33
2021-10-20,Humboldt,023,135768,8841,8727,520,9247,105
2021-10-20,Imperial,025,180216,33033,32705,3326,36031,766
2021-10-20,Inyo,027,18085,2177,2077,40,2117,40
2021-10-20,Kern,029,883053,124711,122630,21004,143634,1623
2021-10-20,Kings,031,150075,31506,30805,1873,32678,322
2021-10-20,Lake,033,64148,6590,6475,141,6616,104
2021-10-20,Lassen,035,31185,6739,6622,346,6968,27
2021-10-20,Los Angeles,037,10098052,1425304,1414931,53767,1468698,26506
2021-10-20,Madera,039,155013,22450,21983,1990,23973,281
2021-10-20,Marin,041,260295,17379,17250,445,17695,244
2021-10-20,Mariposa,043,17540,1227,1174,43,1217,5
2021-10-20,Mendocino,045,87422,7333,7189,463,7652,82
2021-10-20,Merced,047,269075,41171,40685,1700,42385,581
2021-10-20,Modoc,049,8938,521,504,185,689,5
2021-10-20,Mono,051,14174,1673,1653,22,1675,3
2021-10-20,Monterey,053,433212,48409,47430,2819,50249,587
2021-10-20,Napa,055,140530,12855,12773,108,12881,100
2021-10-20,Nevada,057,99092,8962,8836,312,9148,90
2021-10-20,Orange,059,3164182,304425,301957,14763,316720,5534
2021-10-20,Placer,061,380077,36312,35729,3550,39279,425
2021-10-20,Plumas,063,18699,1690,1604,33,1637,7
2021-10-20,Riverside,065,2383286,358979,354311,16326,370637,5030
2021-10-20,Sacramento,067,1510023,156186,154822,4429,159251,2222
2021-10-20,San Benito,069,59416,7312,7275,164,7439,71
2021-10-20,San Bernardino,071,2135413,349851,347217,10972,358189,5663
2021-10-20,San Diego,073,3302833,368695,365698,21459,387157,4178
2021-10-20,San Francisco,075,870044,52344,51755,2288,54043,646
2021-10-20,San Joaquin,077,732212,98322,97246,5357,102603,1721
2021-10-20,San Luis Obispo,079,281455,29190,28727,1195,29922,332
2021-10-20,San Mateo,081,765935,53649,52663,837,53500,571
2021-10-20,Santa Barbara,083,443738,43834,43489,1597,45086,523
2021-10-20,Santa Clara,085,1922200,145358,144124,1271,145395,1896
2021-10-20,Santa Cruz,087,273765,20137,19951,1001,20952,219
2021-10-20,Shasta,089,179085,20789,20313,3482,23795,320
2021-10-20,Sierra,091,2930,178,168,18,186,0
2021-10-20,Siskiyou,093,43540,3301,3224,1260,4484,46
2021-10-20,Solano,095,438530,45507,44819,1233,46052,341
2021-10-20,Sonoma,097,501317,40799,40404,517,40921,393
2021-10-20,Stanislaus,099,539301,76748,76631,8648,85279,1145
2021-10-20,Sutter,101,95872,13728,13592,318,13910,175
2021-10-20,Tehama,103,63373,8231,8081,1431,9512,110
2021-10-20,Trinity,105,12862,833,693,209,902,11
2021-10-20,Tulare,107,460477,66960,65413,14419,79832,967
2021-10-20,Tuolumne,109,53932,6919,6803,86,6889,89
2021-10-20,Ventura,111,848112,97234,96610,4280,100890,1166
2021-10-20,Yolo,113,214977,19495,19236,1094,20330,248
2021-10-20,Yuba,115,75493,9935,9808,297,10105,82
2021-10-19,Alameda,001,1643700,118401,117542,2774,120316,1383
2021-10-19,Alpine,003,1148,101,103,0,103,0
2021-10-19,Amador,005,37829,5455,5367,58,5425,64
2021-10-19,Butte,007,227075,20344,19974,3636,23610,268
2021-10-19,Calaveras,009,45235,3900,3826,48,3874,80
2021-10-19,Colusa,011,21464,2488,2447,618,3065,18
2021-10-19,Contra Costa,013,1133247,98328,97613,2129,99742,1004
2021-10-19,Del Norte,015,27424,3626,3531,52,3583,42
2021-10-19,El Dorado,017,186661,15743,15478,1638,17116,149
2021-10-19,Fresno,019,978130,136091,133813,12156,145969,2073
2021-10-19,Glenn,021,27897,3439,3380,963,4343,33
2021-10-19,Humboldt,023,135768,8817,8714,514,9228,105
2021-10-19,Imperial,025,180216,32966,32632,3321,35953,764
2021-10-19,Inyo,027,18085,2146,2045,40,2085,40
2021-10-19,Kern,029,883053,124394,122391,20880,143271,1613
2021-10-19,Kings,031,150075,31412,30757,1866,32623,322
2021-10-19,Lake,033,64148,6586,6465,141,6606,104
2021-10-19,Lassen,035,31185,6733,6612,342,6954,27
2021-10-19,Los Angeles,037,10098052,1424065,1413882,53690,1467572,26473
2021-10-19,Madera,039,155013,22387,21950,1982,23932,281
2021-10-19,Marin,041,260295,17365,17241,442,17683,244
2021-10-19,Mariposa,043,17540,1221,1171,41,1212,5
2021-10-19,Mendocino,045,87422,7318,7172,460,7632,82
2021-10-19,Merced,047,269075,41055,40628,1680,42308,580
2021-10-19,Modoc,049,8938,519,502,185,687,5
2021-10-19,Mono,051,14174,1669,1651,22,1673,3
2021-10-19,Monterey,053,433212,48370,47412,2808,50220,583
2021-10-19,Napa,055,140530,12848,12769,108,12877,100
2021-10-19,Nevada,057,99092,8941,8829,311,9140,90
2021-10-19,Orange,059,3164182,304168,301700,14730,316430,5527
2021-10-19,Placer,061,380077,36191,35663,3535,39198,422
2021-10-19,Plumas,063,18699,1672,1586,33,1619,8
2021-10-19,Riverside,065,2383286,358558,353891,16318,370209,5020
2021-10-19,Sacramento,067,1510023,155880,154570,4403,158973,2227
2021-10-19,San Benito,069,59416,7296,7264,164,7428,71
2021-10-19,San Bernardino,071,2135413,349452,346814,10942,357756,5627
2021-10-19,San Diego,073,3302833,368102,365285,21428,386713,4170
2021-10-19,San Francisco,075,870044,52281,51704,2286,53990,645
2021-10-19,San Joaquin,077,732212,98154,97105,5346,102451,1721
2021-10-19,San Luis Obispo,079,281455,29142,28670,1192,29862,332
2021-10-19,San Mateo,081,765935,53591,52617,835,53452,571
2021-10-19,Santa Barbara,083,443738,43767,43413,1595,45008,522
2021-10-19,Santa Clara,085,1922200,145185,143989,1263,145252,1898
2021-10-19,Santa Cruz,087,273765,20113,19895,999,20894,218
2021-10-19,Shasta,089,179085,20712,20209,3474,23683,319
2021-10-19,Sierra,091,2930,175,168,18,186,0
2021-10-19,Siskiyou,093,43540,3297,3216,1255,4471,46
2021-10-19,Solano,095,438530,45465,44782,1227,46009,341
2021-10-19,Sonoma,097,501317,40725,40379,516,40895,392
2021-10-19,Stanislaus,099,539301,76606,76526,8636,85162,1145
2021-10-19,Sutter,101,95872,13704,13569,317,13886,174
2021-10-19,Tehama,103,63373,8201,8057,1415,9472,108
2021-10-19,Trinity,105,12862,826,691,209,900,11
2021-10-19,Tulare,107,460477,66773,65253,14350,79603,958
2021-10-19,Tuolumne,109,53932,6890,6782,85,6867,89
2021-10-19,Ventura,111,848112,97158,96539,4275,100814,1166
2021-10-19,Yolo,113,214977,19450,19206,1089,20295,248
2021-10-19,Yuba,115,75493,9917,9796,296,10092,82
2021-10-18,Alameda,001,1643700,118264,117506,2765,120271,1381
2021-10-18,Alpine,003,1148,101,103,0,103,0
2021-10-18,Amador,005,37829,5444,5345,58,5403,64
2021-10-18,Butte,007,227075,20294,19921,3628,23549,265
2021-10-18,Calaveras,009,45235,3875,3819,47,3866,80
2021-10-18,Colusa,011,21464,2487,2444,616,3060,18
2021-10-18,Contra Costa,013,1133247,98216,97585,2125,99710,995
2021-10-18,Del Norte,015,27424,3619,3529,52,3581,41
2021-10-18,El Dorado,017,186661,15712,15452,1635,17087,149
2021-10-18,Fresno,019,978130,135694,133688,12121,145809,2063
2021-10-18,Glenn,021,27897,3435,3370,957,4327,32
2021-10-18,Humboldt,023,135768,8798,8699,506,9205,104
2021-10-18,Imperial,025,180216,32875,32558,3320,35878,764
2021-10-18,Inyo,027,18085,2128,2020,40,2060,40
2021-10-18,Kern,029,883053,124095,122231,20784,143015,1605
2021-10-18,Kings,031,150075,31297,30698,1853,32551,320
2021-10-18,Lake,033,64148,6567,6455,137,6592,104
2021-10-18,Lassen,035,31185,6713,6607,339,6946,26
2021-10-18,Los Angeles,037,10098052,1422827,1413291,53612,1466903,26446
2021-10-18,Madera,039,155013,22333,21909,1970,23879,277
2021-10-18,Marin,041,260295,17345,17232,439,17671,244
2021-10-18,Mariposa,043,17540,1213,1160,41,1201,5
2021-10-18,Mendocino,045,87422,7299,7156,452,7608,82
2021-10-18,Merced,047,269075,40931,40573,1670,42243,579
2021-10-18,Modoc,049,8938,519,498,185,683,5
2021-10-18,Mono,051,14174,1663,1648,21,1669,3
2021-10-18,Monterey,053,433212,48348,47389,2803,50192,583
2021-10-18,Napa,055,140530,12833,12762,108,12870,100
2021-10-18,Nevada,057,99092,8922,8816,311,9127,90
2021-10-18,Orange,059,3164182,303829,301573,14696,316269,5524
2021-10-18,Placer,061,380077,36114,35598,3531,39129,420
2021-10-18,Plumas,063,18699,1664,1579,33,1612,6
2021-10-18,Riverside,065,2383286,358145,353699,16304,370003,5008
2021-10-18,Sacramento,067,1510023,155575,154428,4371,158799,2203
2021-10-18,San Benito,069,59416,7284,7253,164,7417,71
2021-10-18,San Bernardino,071,2135413,349030,346742,10928,357670,5606
2021-10-18,San Diego,073,3302833,367536,364948,21390,386338,4169
2021-10-18,San Francisco,075,870044,52218,51671,2280,53951,644
2021-10-18,San Joaquin,077,732212,97989,97041,5336,102377,1721
2021-10-18,San Luis Obispo,079,281455,29103,28644,1189,29833,331
2021-10-18,San Mateo,081,765935,53526,52594,834,53428,571
2021-10-18,Santa Barbara,083,443738,43708,43386,1593,44979,522
2021-10-18,Santa Clara,085,1922200,145030,143891,1254,145145,1895
2021-10-18,Santa Cruz,087,273765,20099,19876,997,20873,218
2021-10-18,Shasta,089,179085,20631,20146,3463,23609,313
2021-10-18,Sierra,091,2930,175,166,18,184,0
2021-10-18,Siskiyou,093,43540,3294,3210,1247,4457,42
2021-10-18,Solano,095,438530,45421,44758,1224,45982,339
2021-10-18,Sonoma,097,501317,40661,40349,513,40862,392
2021-10-18,Stanislaus,099,539301,76442,76466,8624,85090,1145
2021-10-18,Sutter,101,95872,13670,13557,315,13872,172
2021-10-18,Tehama,103,63373,8166,8042,1403,9445,107
2021-10-18,Trinity,105,12862,825,688,209,897,11
2021-10-18,Tulare,107,460477,66597,65171,14284,79455,958
2021-10-18,Tuolumne,109,53932,6861,6755,85,6840,89
2021-10-18,Ventura,111,848112,97063,96506,4272,100778,1165
2021-10-18,Yolo,113,214977,19412,19197,1086,20283,248
2021-10-18,Yuba,115,75493,9890,9782,294,10076,82
2021-10-17,Alameda,001,1643700,118113,117423,2760,120183,1376
2021-10-17,Alpine,003,1148,101,103,0,103,0
2021-10-17,Amador,005,37829,5421,5341,57,5398,64
2021-10-17,Butte,007,227075,20209,19897,3619,23516,265
2021-10-17,Calaveras,009,45235,3859,3805,47,3852,80
2021-10-17,Colusa,011,21464,2482,2442,609,3051,18
2021-10-17,Contra Costa,013,1133247,98092,97485,2114,99599,995
2021-10-17,Del Norte,015,27424,3614,3526,52,3578,41
2021-10-17,El Dorado,017,186661,15654,15438,1628,17066,149
2021-10-17,Fresno,019,978130,135228,133429,12086,145515,2063
2021-10-17,Glenn,021,27897,3424,3364,954,4318,32
2021-10-17,Humboldt,023,135768,8778,8690,503,9193,104
2021-10-17,Imperial,025,180216,32793,32520,3313,35833,764
2021-10-17,Inyo,027,18085,2100,2000,40,2040,40
2021-10-17,Kern,029,883053,123746,122085,20684,142769,1603
2021-10-17,Kings,031,150075,31184,30636,1844,32480,315
2021-10-17,Lake,033,64148,6551,6437,136,6573,104
2021-10-17,Lassen,035,31185,6701,6605,335,6940,26
2021-10-17,Los Angeles,037,10098052,1421490,1412371,53536,1465907,26443
2021-10-17,Madera,039,155013,22271,21869,1960,23829,277
2021-10-17,Marin,041,260295,17323,17211,439,17650,243
2021-10-17,Mariposa,043,17540,1206,1150,41,1191,5
2021-10-17,Mendocino,045,87422,7270,7148,446,7594,82
2021-10-17,Merced,047,269075,40803,40531,1656,42187,579
2021-10-17,Modoc,049,8938,516,498,183,681,5
2021-10-17,Mono,051,14174,1661,1640,20,1660,3
2021-10-17,Monterey,053,433212,48306,47369,2793,50162,583
2021-10-17,Napa,055,140530,12818,12753,105,12858,100
2021-10-17,Nevada,057,99092,8905,8794,310,9104,90
2021-10-17,Orange,059,3164182,303514,301414,14663,316077,5524
2021-10-17,Placer,061,380077,36015,35559,3516,39075,420
2021-10-17,Plumas,063,18699,1640,1571,32,1603,6
2021-10-17,Riverside,065,2383286,357662,353500,16290,369790,5008
2021-10-17,Sacramento,067,1510023,155174,154080,4353,158433,2213
2021-10-17,San Benito,069,59416,7275,7250,163,7413,71
2021-10-17,San Bernardino,071,2135413,348601,346524,10908,357432,5597
2021-10-17,San Diego,073,3302833,366928,364675,21362,386037,4163
2021-10-17,San Francisco,075,870044,52145,51625,2270,53895,644
2021-10-17,San Joaquin,077,732212,97816,96950,5327,102277,1721
2021-10-17,San Luis Obispo,079,281455,29050,28604,1181,29785,331
2021-10-17,San Mateo,081,765935,53474,52541,830,53371,571
2021-10-17,Santa Barbara,083,443738,43645,43344,1592,44936,522
2021-10-17,Santa Clara,085,1922200,144854,143768,1245,145013,1895
2021-10-17,Santa Cruz,087,273765,20071,19861,995,20856,218
2021-10-17,Shasta,089,179085,20541,20116,3453,23569,312
2021-10-17,Sierra,091,2930,173,165,18,183,0
2021-10-17,Siskiyou,093,43540,3286,3204,1244,4448,42
2021-10-17,Solano,095,438530,45364,44722,1223,45945,340
2021-10-17,Sonoma,097,501317,40585,40306,512,40818,392
2021-10-17,Stanislaus,099,539301,76243,76354,8611,84965,1145
2021-10-17,Sutter,101,95872,13653,13543,313,13856,172
2021-10-17,Tehama,103,63373,8134,8015,1386,9401,107
2021-10-17,Trinity,105,12862,822,686,208,894,11
2021-10-17,Tulare,107,460477,66412,65057,14210,79267,958
2021-10-17,Tuolumne,109,53932,6827,6735,84,6819,89
2021-10-17,Ventura,111,848112,96962,96458,4269,100727,1165
2021-10-17,Yolo,113,214977,19370,19171,1077,20248,248
2021-10-17,Yuba,115,75493,9864,9771,292,10063,82
2021-10-16,Alameda,001,1643700,118024,117027,2759,119786,1365
2021-10-16,Alpine,003,1148,100,102,0,102,0
2021-10-16,Amador,005,37829,5414,5310,57,5367,64
2021-10-16,Butte,007,227075,20178,19612,3612,23224,260
2021-10-16,Calaveras,009,45235,3852,3771,47,3818,80
2021-10-16,Colusa,011,21464,2478,2431,606,3037,18
2021-10-16,Contra Costa,013,1133247,98000,97107,2107,99214,982
2021-10-16,Del Norte,015,27424,3611,3516,52,3568,41
2021-10-16,El Dorado,017,186661,15632,15315,1626,16941,149
2021-10-16,Fresno,019,978130,135079,132433,12075,144508,2051
2021-10-16,Glenn,021,27897,3418,3331,954,4285,26
2021-10-16,Humboldt,023,135768,8766,8621,498,9119,104
2021-10-16,Imperial,025,180216,32778,32368,3311,35679,764
2021-10-16,Inyo,027,18085,2086,1932,40,1972,39
2021-10-16,Kern,029,883053,123591,121354,20601,141955,1590
2021-10-16,Kings,031,150075,31138,30418,1841,32259,314
2021-10-16,Lake,033,64148,6540,6378,136,6514,104
2021-10-16,Lassen,035,31185,6692,6559,330,6889,26
2021-10-16,Los Angeles,037,10098052,1420840,1409418,53481,1462899,26398
2021-10-16,Madera,039,155013,22227,21707,1956,23663,277
2021-10-16,Marin,041,260295,17314,17148,439,17587,243
2021-10-16,Mariposa,043,17540,1203,1096,41,1137,5
2021-10-16,Mendocino,045,87422,7259,7099,446,7545,82
2021-10-16,Merced,047,269075,40770,40265,1655,41920,577
2021-10-16,Modoc,049,8938,513,492,183,675,5
2021-10-16,Mono,051,14174,1657,1628,20,1648,3
2021-10-16,Monterey,053,433212,48289,47293,2785,50078,582
2021-10-16,Napa,055,140530,12807,12706,105,12811,100
2021-10-16,Nevada,057,99092,8885,8739,310,9049,90
2021-10-16,Orange,059,3164182,303338,300722,14638,315360,5509
2021-10-16,Placer,061,380077,35931,35343,3510,38853,412
2021-10-16,Plumas,063,18699,1635,1542,31,1573,6
2021-10-16,Riverside,065,2383286,357393,352435,16278,368713,4990
2021-10-16,Sacramento,067,1510023,154975,153264,4349,157613,2192
2021-10-16,San Benito,069,59416,7262,7210,162,7372,71
2021-10-16,San Bernardino,071,2135413,348396,345418,10900,356318,5566
2021-10-16,San Diego,073,3302833,366605,363109,21346,384455,4151
2021-10-16,San Francisco,075,870044,52097,51436,2266,53702,645
2021-10-16,San Joaquin,077,732212,97745,96507,5324,101831,1708
2021-10-16,San Luis Obispo,079,281455,29024,28460,1180,29640,329
2021-10-16,San Mateo,081,765935,53425,52399,829,53228,569
2021-10-16,Santa Barbara,083,443738,43609,43175,1591,44766,521
2021-10-16,Santa Clara,085,1922200,144754,143282,1237,144519,1890
2021-10-16,Santa Cruz,087,273765,20056,19794,994,20788,218
2021-10-16,Shasta,089,179085,20491,19932,3442,23374,309
2021-10-16,Sierra,091,2930,171,160,18,178,0
2021-10-16,Siskiyou,093,43540,3284,3173,1237,4410,42
2021-10-16,Solano,095,438530,45338,44585,1219,45804,334
2021-10-16,Sonoma,097,501317,40545,40195,512,40707,390
2021-10-16,Stanislaus,099,539301,76157,75868,8602,84470,1142
2021-10-16,Sutter,101,95872,13634,13471,312,13783,169
2021-10-16,Tehama,103,63373,8121,7907,1381,9288,104
2021-10-16,Trinity,105,12862,822,679,208,887,11
2021-10-16,Tulare,107,460477,66274,64489,14177,78666,951
2021-10-16,Tuolumne,109,53932,6795,6666,84,6750,89
2021-10-16,Ventura,111,848112,96930,96181,4264,100445,1164
2021-10-16,Yolo,113,214977,19343,19078,1071,20149,247
2021-10-16,Yuba,115,75493,9840,9705,289,9994,82
2021-10-15,Alameda,001,1643700,117950,117027,2755,119782,1365
2021-10-15,Alpine,003,1148,100,102,0,102,0
2021-10-15,Amador,005,37829,5390,5310,57,5367,64
2021-10-15,Butte,007,227075,20141,19612,3605,23217,260
2021-10-15,Calaveras,009,45235,3846,3771,47,3818,80
2021-10-15,Colusa,011,21464,2476,2431,603,3034,18
2021-10-15,Contra Costa,013,1133247,97918,97107,2103,99210,982
2021-10-15,Del Norte,015,27424,3609,3516,52,3568,41
2021-10-15,El Dorado,017,186661,15612,15315,1621,16936,149
2021-10-15,Fresno,019,978130,134826,132433,12068,144501,2051
2021-10-15,Glenn,021,27897,3413,3331,953,4284,26
2021-10-15,Humboldt,023,135768,8757,8621,496,9117,104
2021-10-15,Imperial,025,180216,32731,32368,3307,35675,764
2021-10-15,Inyo,027,18085,2068,1932,40,1972,39
2021-10-15,Kern,029,883053,123456,121354,20526,141880,1590
2021-10-15,Kings,031,150075,31083,30418,1837,32255,314
2021-10-15,Lake,033,64148,6531,6378,136,6514,104
2021-10-15,Lassen,035,31185,6680,6559,329,6888,26
2021-10-15,Los Angeles,037,10098052,1420148,1409418,53432,1462850,26398
2021-10-15,Madera,039,155013,22183,21707,1948,23655,277
2021-10-15,Marin,041,260295,17303,17148,439,17587,243
2021-10-15,Mariposa,043,17540,1195,1096,41,1137,5
2021-10-15,Mendocino,045,87422,7244,7099,446,7545,82
2021-10-15,Merced,047,269075,40740,40265,1652,41917,577
2021-10-15,Modoc,049,8938,512,492,183,675,5
2021-10-15,Mono,051,14174,1654,1628,20,1648,3
2021-10-15,Monterey,053,433212,48267,47293,2783,50076,582
2021-10-15,Napa,055,140530,12803,12706,105,12811,100
2021-10-15,Nevada,057,99092,8870,8739,310,9049,90
2021-10-15,Orange,059,3164182,303170,300722,14619,315341,5509
2021-10-15,Placer,061,380077,35877,35343,3504,38847,412
2021-10-15,Plumas,063,18699,1627,1542,31,1573,6
2021-10-15,Riverside,065,2383286,357151,352435,16273,368708,4990
2021-10-15,Sacramento,067,1510023,154790,153264,4339,157603,2192
2021-10-15,San Benito,069,59416,7259,7210,162,7372,71
2021-10-15,San Bernardino,071,2135413,348160,345418,10898,356316,5566
2021-10-15,San Diego,073,3302833,366241,363109,21321,384430,4151
2021-10-15,San Francisco,075,870044,52057,51436,2259,53695,645
2021-10-15,San Joaquin,077,732212,97667,96507,5317,101824,1708
2021-10-15,San Luis Obispo,079,281455,29003,28460,1178,29638,329
2021-10-15,San Mateo,081,765935,53381,52399,828,53227,569
2021-10-15,Santa Barbara,083,443738,43571,43175,1591,44766,521
2021-10-15,Santa Clara,085,1922200,144632,143282,1229,144511,1890
2021-10-15,Santa Cruz,087,273765,20045,19794,994,20788,218
2021-10-15,Shasta,089,179085,20433,19932,3434,23366,309
2021-10-15,Sierra,091,2930,170,160,18,178,0
2021-10-15,Siskiyou,093,43540,3283,3173,1234,4407,42
2021-10-15,Solano,095,438530,45312,44585,1219,45804,334
2021-10-15,Sonoma,097,501317,40511,40195,511,40706,390
2021-10-15,Stanislaus,099,539301,76077,75868,8586,84454,1142
2021-10-15,Sutter,101,95872,13617,13471,310,13781,169
2021-10-15,Tehama,103,63373,8100,7907,1375,9282,104
2021-10-15,Trinity,105,12862,822,679,208,887,11
2021-10-15,Tulare,107,460477,66194,64489,14140,78629,951
2021-10-15,Tuolumne,109,53932,6772,6666,82,6748,89
2021-10-15,Ventura,111,848112,96888,96181,4261,100442,1164
2021-10-15,Yolo,113,214977,19328,19078,1067,20145,247
2021-10-15,Yuba,115,75493,9830,9705,288,9993,82
2021-10-14,Alameda,001,1643700,117839,117027,2750,119777,1365
2021-10-14,Alpine,003,1148,100,102,0,102,0
2021-10-14,Amador,005,37829,5379,5310,57,5367,64
2021-10-14,Butte,007,227075,20089,19612,3600,23212,260
2021-10-14,Calaveras,009,45235,3833,3771,46,3817,80
2021-10-14,Colusa,011,21464,2474,2431,601,3032,18
2021-10-14,Contra Costa,013,1133247,97783,97107,2095,99202,982
2021-10-14,Del Norte,015,27424,3603,3516,52,3568,41
2021-10-14,El Dorado,017,186661,15573,15315,1618,16933,149
2021-10-14,Fresno,019,978130,134536,132433,12047,144480,2051
2021-10-14,Glenn,021,27897,3408,3331,952,4283,26
2021-10-14,Humboldt,023,135768,8740,8621,493,9114,104
2021-10-14,Imperial,025,180216,32668,32368,3300,35668,764
2021-10-14,Inyo,027,18085,2049,1932,40,1972,39
2021-10-14,Kern,029,883053,123186,121354,20426,141780,1590
2021-10-14,Kings,031,150075,31018,30418,1829,32247,314
2021-10-14,Lake,033,64148,6510,6378,135,6513,104
2021-10-14,Lassen,035,31185,6674,6559,328,6887,26
2021-10-14,Los Angeles,037,10098052,1419167,1409418,53381,1462799,26398
2021-10-14,Madera,039,155013,22118,21707,1943,23650,277
2021-10-14,Marin,041,260295,17298,17148,437,17585,243
2021-10-14,Mariposa,043,17540,1182,1096,40,1136,5
2021-10-14,Mendocino,045,87422,7230,7099,444,7543,82
2021-10-14,Merced,047,269075,40651,40265,1639,41904,577
2021-10-14,Modoc,049,8938,512,492,183,675,5
2021-10-14,Mono,051,14174,1647,1628,20,1648,3
2021-10-14,Monterey,053,433212,48241,47293,2778,50071,582
2021-10-14,Napa,055,140530,12788,12706,105,12811,100
2021-10-14,Nevada,057,99092,8843,8739,308,9047,90
2021-10-14,Orange,059,3164182,302963,300722,14602,315324,5509
2021-10-14,Placer,061,380077,35810,35343,3490,38833,412
2021-10-14,Plumas,063,18699,1612,1542,31,1573,6
2021-10-14,Riverside,065,2383286,356754,352435,16262,368697,4990
2021-10-14,Sacramento,067,1510023,154538,153264,4317,157581,2192
2021-10-14,San Benito,069,59416,7248,7210,162,7372,71
2021-10-14,San Bernardino,071,2135413,347802,345418,10892,356310,5566
2021-10-14,San Diego,073,3302833,365793,363109,21294,384403,4151
2021-10-14,San Francisco,075,870044,52001,51436,2255,53691,645
2021-10-14,San Joaquin,077,732212,97538,96507,5308,101815,1708
2021-10-14,San Luis Obispo,079,281455,28959,28460,1174,29634,329
2021-10-14,San Mateo,081,765935,53332,52399,827,53226,569
2021-10-14,Santa Barbara,083,443738,43515,43175,1586,44761,521
2021-10-14,Santa Clara,085,1922200,144491,143282,1223,144505,1890
2021-10-14,Santa Cruz,087,273765,20022,19794,994,20788,218
2021-10-14,Shasta,089,179085,20377,19932,3422,23354,309
2021-10-14,Sierra,091,2930,170,160,18,178,0
2021-10-14,Siskiyou,093,43540,3280,3173,1226,4399,42
2021-10-14,Solano,095,438530,45262,44585,1211,45796,334
2021-10-14,Sonoma,097,501317,40460,40195,508,40703,390
2021-10-14,Stanislaus,099,539301,75931,75868,8573,84441,1142
2021-10-14,Sutter,101,95872,13597,13471,309,13780,169
2021-10-14,Tehama,103,63373,8069,7907,1368,9275,104
2021-10-14,Trinity,105,12862,821,679,207,886,11
2021-10-14,Tulare,107,460477,66010,64489,14093,78582,951
2021-10-14,Tuolumne,109,53932,6741,6666,81,6747,89
2021-10-14,Ventura,111,848112,96820,96181,4255,100436,1164
2021-10-14,Yolo,113,214977,19295,19078,1060,20138,247
2021-10-14,Yuba,115,75493,9816,9705,279,9984,82
2021-10-13,Alameda,001,1643700,117733,116914,2745,119659,1360
2021-10-13,Alpine,003,1148,100,102,0,102,0
2021-10-13,Amador,005,37829,5365,5305,57,5362,63
2021-10-13,Butte,007,227075,20015,19546,3596,23142,257
2021-10-13,Calaveras,009,45235,3812,3756,44,3800,79
2021-10-13,Colusa,011,21464,2467,2430,597,3027,18
2021-10-13,Contra Costa,013,1133247,97667,96975,2094,99069,969
2021-10-13,Del Norte,015,27424,3598,3512,52,3564,39
2021-10-13,El Dorado,017,186661,15549,15302,1613,16915,149
2021-10-13,Fresno,019,978130,134203,132055,12020,144075,2048
2021-10-13,Glenn,021,27897,3403,3327,949,4276,26
2021-10-13,Humboldt,023,135768,8729,8604,489,9093,102
2021-10-13,Imperial,025,180216,32607,32317,3297,35614,762
2021-10-13,Inyo,027,18085,2012,1907,40,1947,39
2021-10-13,Kern,029,883053,122943,120956,20331,141287,1586
2021-10-13,Kings,031,150075,30937,30246,1822,32068,312
2021-10-13,Lake,033,64148,6490,6371,135,6506,103
2021-10-13,Lassen,035,31185,6663,6535,322,6857,25
2021-10-13,Los Angeles,037,10098052,1418111,1408384,53324,1461708,26379
2021-10-13,Madera,039,155013,22065,21609,1928,23537,277
2021-10-13,Marin,041,260295,17274,17137,436,17573,243
2021-10-13,Mariposa,043,17540,1168,1090,40,1130,5
2021-10-13,Mendocino,045,87422,7214,7088,436,7524,82
2021-10-13,Merced,047,269075,40565,40164,1629,41793,577
2021-10-13,Modoc,049,8938,510,490,181,671,5
2021-10-13,Mono,051,14174,1647,1612,20,1632,3
2021-10-13,Monterey,053,433212,48222,47273,2771,50044,582
2021-10-13,Napa,055,140530,12777,12695,103,12798,100
2021-10-13,Nevada,057,99092,8821,8725,308,9033,90
2021-10-13,Orange,059,3164182,302755,300468,14586,315054,5503
2021-10-13,Placer,061,380077,35744,35254,3481,38735,412
2021-10-13,Plumas,063,18699,1598,1514,31,1545,6
2021-10-13,Riverside,065,2383286,356424,352044,16249,368293,4978
2021-10-13,Sacramento,067,1510023,154288,153141,4295,157436,2182
2021-10-13,San Benito,069,59416,7242,7196,161,7357,71
2021-10-13,San Bernardino,071,2135413,347479,344951,10876,355827,5562
2021-10-13,San Diego,073,3302833,365356,362564,21272,383836,4141
2021-10-13,San Francisco,075,870044,51959,51379,2251,53630,644
2021-10-13,San Joaquin,077,732212,97395,96343,5303,101646,1696
2021-10-13,San Luis Obispo,079,281455,28921,28397,1171,29568,330
2021-10-13,San Mateo,081,765935,53280,52352,823,53175,569
2021-10-13,Santa Barbara,083,443738,43463,43109,1586,44695,518
2021-10-13,Santa Clara,085,1922200,144353,143064,1222,144286,1886
2021-10-13,Santa Cruz,087,273765,19996,19763,993,20756,217
2021-10-13,Shasta,089,179085,20307,19802,3401,23203,307
2021-10-13,Sierra,091,2930,170,155,18,173,0
2021-10-13,Siskiyou,093,43540,3272,3173,1225,4398,42
2021-10-13,Solano,095,438530,45223,44558,1208,45766,334
2021-10-13,Sonoma,097,501317,40404,40122,508,40630,390
2021-10-13,Stanislaus,099,539301,75790,75698,8564,84262,1136
2021-10-13,Sutter,101,95872,13567,13458,307,13765,169
2021-10-13,Tehama,103,63373,8031,7849,1362,9211,103
2021-10-13,Trinity,105,12862,818,677,207,884,11
2021-10-13,Tulare,107,460477,65830,64297,14038,78335,945
2021-10-13,Tuolumne,109,53932,6727,6644,80,6724,89
2021-10-13,Ventura,111,848112,96746,96099,4249,100348,1162
2021-10-13,Yolo,113,214977,19266,19023,1058,20081,247
2021-10-13,Yuba,115,75493,9791,9690,265,9955,80
2021-10-12,Alameda,001,1643700,117630,116813,2740,119553,1357
2021-10-12,Alpine,003,1148,100,102,0,102,0
2021-10-12,Amador,005,37829,5354,5301,57,5358,63
2021-10-12,Butte,007,227075,19946,19506,3584,23090,256
2021-10-12,Calaveras,009,45235,3797,3750,44,3794,75
2021-10-12,Colusa,011,21464,2464,2428,595,3023,18
2021-10-12,Contra Costa,013,1133247,97553,96894,2085,98979,960
2021-10-12,Del Norte,015,27424,3592,3511,52,3563,39
2021-10-12,El Dorado,017,186661,15515,15287,1611,16898,148
2021-10-12,Fresno,019,978130,133841,131848,11991,143839,2042
2021-10-12,Glenn,021,27897,3388,3321,947,4268,26
2021-10-12,Humboldt,023,135768,8702,8587,483,9070,102
2021-10-12,Imperial,025,180216,32555,32267,3295,35562,762
2021-10-12,Inyo,027,18085,1980,1889,40,1929,39
2021-10-12,Kern,029,883053,122658,120826,20220,141046,1580
2021-10-12,Kings,031,150075,30863,30200,1811,32011,312
2021-10-12,Lake,033,64148,6475,6372,133,6505,97
2021-10-12,Lassen,035,31185,6653,6526,321,6847,25
2021-10-12,Los Angeles,037,10098052,1417049,1407462,53276,1460738,26362
2021-10-12,Madera,039,155013,21994,21574,1915,23489,277
2021-10-12,Marin,041,260295,17251,17126,436,17562,242
2021-10-12,Mariposa,043,17540,1154,1088,40,1128,5
2021-10-12,Mendocino,045,87422,7185,7077,433,7510,82
2021-10-12,Merced,047,269075,40486,40113,1623,41736,567
2021-10-12,Modoc,049,8938,505,485,180,665,5
2021-10-12,Mono,051,14174,1645,1608,20,1628,3
2021-10-12,Monterey,053,433212,48191,47254,2763,50017,582
2021-10-12,Napa,055,140530,12763,12671,103,12774,97
2021-10-12,Nevada,057,99092,8809,8720,307,9027,89
2021-10-12,Orange,059,3164182,302501,300256,14560,314816,5499
2021-10-12,Placer,061,380077,35681,35214,3473,38687,404
2021-10-12,Plumas,063,18699,1584,1488,30,1518,6
2021-10-12,Riverside,065,2383286,356098,351771,16235,368006,4973
2021-10-12,Sacramento,067,1510023,153983,152935,4270,157205,2170
2021-10-12,San Benito,069,59416,7228,7193,161,7354,71
2021-10-12,San Bernardino,071,2135413,347166,344788,10867,355655,5563
2021-10-12,San Diego,073,3302833,364833,362256,21243,383499,4137
2021-10-12,San Francisco,075,870044,51895,51301,2250,53551,643
2021-10-12,San Joaquin,077,732212,97258,96237,5298,101535,1690
2021-10-12,San Luis Obispo,079,281455,28874,28379,1170,29549,327
2021-10-12,San Mateo,081,765935,53229,52328,822,53150,569
2021-10-12,Santa Barbara,083,443738,43402,43076,1586,44662,515
2021-10-12,Santa Clara,085,1922200,144199,142954,1220,144174,1882
2021-10-12,Santa Cruz,087,273765,19971,19757,993,20750,218
2021-10-12,Shasta,089,179085,20233,19731,3380,23111,304
2021-10-12,Sierra,091,2930,170,153,18,171,0
2021-10-12,Siskiyou,093,43540,3261,3166,1219,4385,42
2021-10-12,Solano,095,438530,45180,44516,1203,45719,329
2021-10-12,Sonoma,097,501317,40362,40105,507,40612,390
2021-10-12,Stanislaus,099,539301,75638,75589,8550,84139,1126
2021-10-12,Sutter,101,95872,13544,13436,303,13739,168
2021-10-12,Tehama,103,63373,7998,7820,1358,9178,103
2021-10-12,Trinity,105,12862,815,676,207,883,11
2021-10-12,Tulare,107,460477,65645,64216,13980,78196,944
2021-10-12,Tuolumne,109,53932,6710,6637,79,6716,89
2021-10-12,Ventura,111,848112,96645,96022,4244,100266,1160
2021-10-12,Yolo,113,214977,19239,18987,1050,20037,247
2021-10-12,Yuba,115,75493,9776,9676,261,9937,70
2021-10-11,Alameda,001,1643700,117489,116759,2739,119498,1358
2021-10-11,Alpine,003,1148,100,102,0,102,0
2021-10-11,Amador,005,37829,5342,5286,57,5343,62
2021-10-11,Butte,007,227075,19887,19452,3579,23031,253
2021-10-11,Calaveras,009,45235,3776,3750,44,3794,75
2021-10-11,Colusa,011,21464,2460,2427,588,3015,18
2021-10-11,Contra Costa,013,1133247,97416,96832,2080,98912,960
2021-10-11,Del Norte,015,27424,3589,3510,48,3558,39
2021-10-11,El Dorado,017,186661,15486,15273,1607,16880,146
2021-10-11,Fresno,019,978130,133513,131703,11957,143660,2036
2021-10-11,Glenn,021,27897,3371,3308,946,4254,26
2021-10-11,Humboldt,023,135768,8677,8571,476,9047,101
2021-10-11,Imperial,025,180216,32505,32207,3289,35496,762
2021-10-11,Inyo,027,18085,1957,1862,39,1901,39
2021-10-11,Kern,029,883053,122422,120684,20124,140808,1575
2021-10-11,Kings,031,150075,30774,30180,1801,31981,309
2021-10-11,Lake,033,64148,6459,6361,129,6490,97
2021-10-11,Lassen,035,31185,6633,6499,318,6817,25
2021-10-11,Los Angeles,037,10098052,1416005,1406826,53225,1460051,26346
2021-10-11,Madera,039,155013,21937,21555,1897,23452,272
2021-10-11,Marin,041,260295,17233,17121,432,17553,242
2021-10-11,Mariposa,043,17540,1124,1083,39,1122,5
2021-10-11,Mendocino,045,87422,7169,7064,429,7493,82
2021-10-11,Merced,047,269075,40370,40064,1599,41663,566
2021-10-11,Modoc,049,8938,502,482,177,659,5
2021-10-11,Mono,051,14174,1635,1604,20,1624,3
2021-10-11,Monterey,053,433212,48162,47241,2756,49997,580
2021-10-11,Napa,055,140530,12740,12654,101,12755,96
2021-10-11,Nevada,057,99092,8789,8716,306,9022,90
2021-10-11,Orange,059,3164182,302273,299941,14531,314472,5499
2021-10-11,Placer,061,380077,35612,35173,3456,38629,404
2021-10-11,Plumas,063,18699,1566,1469,28,1497,6
2021-10-11,Riverside,065,2383286,355755,351444,16230,367674,4973
2021-10-11,Sacramento,067,1510023,153694,152681,4239,156920,2169
2021-10-11,San Benito,069,59416,7207,7184,159,7343,71
2021-10-11,San Bernardino,071,2135413,346777,344594,10859,355453,5549
2021-10-11,San Diego,073,3302833,364312,361712,21211,382923,4124
2021-10-11,San Francisco,075,870044,51824,51275,2246,53521,643
2021-10-11,San Joaquin,077,732212,97104,96152,5287,101439,1681
2021-10-11,San Luis Obispo,079,281455,28827,28355,1165,29520,327
2021-10-11,San Mateo,081,765935,53181,52298,821,53119,569
2021-10-11,Santa Barbara,083,443738,43355,43018,1585,44603,515
2021-10-11,Santa Clara,085,1922200,144037,142836,1216,144052,1882
2021-10-11,Santa Cruz,087,273765,19947,19745,992,20737,217
2021-10-11,Shasta,089,179085,20154,19662,3364,23026,295
2021-10-11,Sierra,091,2930,165,147,17,164,0
2021-10-11,Siskiyou,093,43540,3254,3159,1215,4374,42
2021-10-11,Solano,095,438530,45132,44474,1200,45674,329
2021-10-11,Sonoma,097,501317,40317,40067,507,40574,390
2021-10-11,Stanislaus,099,539301,75466,75478,8529,84007,1118
2021-10-11,Sutter,101,95872,13525,13427,301,13728,165
2021-10-11,Tehama,103,63373,7957,7795,1349,9144,102
2021-10-11,Trinity,105,12862,809,675,206,881,11
2021-10-11,Tulare,107,460477,65464,64094,13913,78007,942
2021-10-11,Tuolumne,109,53932,6672,6602,79,6681,89
2021-10-11,Ventura,111,848112,96548,95876,4237,100113,1160
2021-10-11,Yolo,113,214977,19193,18977,1047,20024,247
2021-10-11,Yuba,115,75493,9759,9657,249,9906,69
2021-10-10,Alameda,001,1643700,117368,116679,2735,119414,1358
2021-10-10,Alpine,003,1148,100,102,0,102,0
2021-10-10,Amador,005,37829,5328,5278,57,5335,62
2021-10-10,Butte,007,227075,19823,19430,3565,22995,253
2021-10-10,Calaveras,009,45235,3764,3747,44,3791,75
2021-10-10,Colusa,011,21464,2459,2425,587,3012,18
2021-10-10,Contra Costa,013,1133247,97317,96760,2074,98834,960
2021-10-10,Del Norte,015,27424,3585,3507,48,3555,39
2021-10-10,El Dorado,017,186661,15455,15250,1601,16851,146
2021-10-10,Fresno,019,978130,133185,131434,11928,143362,2035
2021-10-10,Glenn,021,27897,3367,3297,944,4241,26
2021-10-10,Humboldt,023,135768,8655,8554,472,9026,101
2021-10-10,Imperial,025,180216,32431,32167,3286,35453,762
2021-10-10,Inyo,027,18085,1936,1857,39,1896,39
2021-10-10,Kern,029,883053,122096,120552,20020,140572,1573
2021-10-10,Kings,031,150075,30685,30122,1791,31913,308
2021-10-10,Lake,033,64148,6443,6349,128,6477,97
2021-10-10,Lassen,035,31185,6613,6495,317,6812,26
2021-10-10,Los Angeles,037,10098052,1414826,1406034,53150,1459184,26338
2021-10-10,Madera,039,155013,21891,21486,1888,23374,272
2021-10-10,Marin,041,260295,17216,17112,432,17544,242
2021-10-10,Mariposa,043,17540,1121,1074,39,1113,5
2021-10-10,Mendocino,045,87422,7154,7060,421,7481,81
2021-10-10,Merced,047,269075,40285,40036,1582,41618,566
2021-10-10,Modoc,049,8938,502,482,177,659,5
2021-10-10,Mono,051,14174,1634,1596,20,1616,3
2021-10-10,Monterey,053,433212,48132,47228,2755,49983,580
2021-10-10,Napa,055,140530,12717,12641,101,12742,96
2021-10-10,Nevada,057,99092,8777,8689,306,8995,90
2021-10-10,Orange,059,3164182,302011,299787,14503,314290,5499
2021-10-10,Placer,061,380077,35519,35128,3444,38572,404
2021-10-10,Plumas,063,18699,1550,1468,26,1494,6
2021-10-10,Riverside,065,2383286,355383,351248,16211,367459,4973
2021-10-10,Sacramento,067,1510023,153429,152405,4222,156627,2178
2021-10-10,San Benito,069,59416,7202,7180,158,7338,71
2021-10-10,San Bernardino,071,2135413,346471,344423,10851,355274,5551
2021-10-10,San Diego,073,3302833,363786,361038,21164,382202,4113
2021-10-10,San Francisco,075,870044,51776,51216,2243,53459,643
2021-10-10,San Joaquin,077,732212,96933,96084,5270,101354,1681
2021-10-10,San Luis Obispo,079,281455,28783,28343,1165,29508,326
2021-10-10,San Mateo,081,765935,53139,52273,820,53093,569
2021-10-10,Santa Barbara,083,443738,43308,42987,1584,44571,515
2021-10-10,Santa Clara,085,1922200,143872,142768,1209,143977,1881
2021-10-10,Santa Cruz,087,273765,19927,19727,992,20719,217
2021-10-10,Shasta,089,179085,20065,19635,3355,22990,296
2021-10-10,Sierra,091,2930,163,147,17,164,0
2021-10-10,Siskiyou,093,43540,3240,3155,1208,4363,42
2021-10-10,Solano,095,438530,45076,44431,1200,45631,329
2021-10-10,Sonoma,097,501317,40265,40027,507,40534,390
2021-10-10,Stanislaus,099,539301,75289,75403,8515,83918,1118
2021-10-10,Sutter,101,95872,13501,13412,296,13708,165
2021-10-10,Tehama,103,63373,7919,7764,1340,9104,102
2021-10-10,Trinity,105,12862,808,669,205,874,11
2021-10-10,Tulare,107,460477,65292,63930,13862,77792,940
2021-10-10,Tuolumne,109,53932,6648,6580,78,6658,89
2021-10-10,Ventura,111,848112,96459,95829,4237,100066,1160
2021-10-10,Yolo,113,214977,19161,18952,1042,19994,247
2021-10-10,Yuba,115,75493,9743,9641,244,9885,69
2021-10-09,Alameda,001,1643700,117269,116253,2733,118986,1356
2021-10-09,Alpine,003,1148,99,102,0,102,0
2021-10-09,Amador,005,37829,5326,5237,56,5293,62
2021-10-09,Butte,007,227075,19793,19277,3562,22839,250
2021-10-09,Calaveras,009,45235,3760,3716,44,3760,75
2021-10-09,Colusa,011,21464,2455,2419,586,3005,18
2021-10-09,Contra Costa,013,1133247,97244,96378,2068,98446,958
2021-10-09,Del Norte,015,27424,3584,3495,48,3543,39
2021-10-09,El Dorado,017,186661,15437,15153,1598,16751,144
2021-10-09,Fresno,019,978130,133052,130508,11908,142416,2018
2021-10-09,Glenn,021,27897,3363,3277,943,4220,26
2021-10-09,Humboldt,023,135768,8641,8448,470,8918,97
2021-10-09,Imperial,025,180216,32397,31989,3284,35273,760
2021-10-09,Inyo,027,18085,1927,1808,39,1847,39
2021-10-09,Kern,029,883053,121957,119795,19993,139788,1559
2021-10-09,Kings,031,150075,30636,29894,1789,31683,308
2021-10-09,Lake,033,64148,6424,6283,127,6410,97
2021-10-09,Lassen,035,31185,6608,6442,316,6758,25
2021-10-09,Los Angeles,037,10098052,1414239,1402810,53111,1455921,26280
2021-10-09,Madera,039,155013,21858,21313,1874,23187,271
2021-10-09,Marin,041,260295,17211,17049,430,17479,242
2021-10-09,Mariposa,043,17540,1114,1042,38,1080,5
2021-10-09,Mendocino,045,87422,7147,7011,420,7431,82
2021-10-09,Merced,047,269075,40243,39784,1582,41366,565
2021-10-09,Modoc,049,8938,500,477,176,653,5
2021-10-09,Mono,051,14174,1631,1577,20,1597,3
2021-10-09,Monterey,053,433212,48120,47168,2752,49920,577
2021-10-09,Napa,055,140530,12713,12586,101,12687,96
2021-10-09,Nevada,057,99092,8766,8613,305,8918,90
2021-10-09,Orange,059,3164182,301831,299089,14484,313573,5457
2021-10-09,Placer,061,380077,35481,34877,3437,38314,393
2021-10-09,Plumas,063,18699,1539,1418,26,1444,6
2021-10-09,Riverside,065,2383286,355132,350082,16194,366276,4965
2021-10-09,Sacramento,067,1510023,153219,151566,4209,155775,2160
2021-10-09,San Benito,069,59416,7194,7123,158,7281,71
2021-10-09,San Bernardino,071,2135413,346287,343452,10847,354299,5556
2021-10-09,San Diego,073,3302833,363471,359909,21159,381068,4111
2021-10-09,San Francisco,075,870044,51729,50960,2236,53196,643
2021-10-09,San Joaquin,077,732212,96866,95606,5265,100871,1669
2021-10-09,San Luis Obispo,079,281455,28766,28197,1163,29360,324
2021-10-09,San Mateo,081,765935,53106,52121,819,52940,569
2021-10-09,Santa Barbara,083,443738,43281,42735,1584,44319,514
2021-10-09,Santa Clara,085,1922200,143749,142298,1203,143501,1873
2021-10-09,Santa Cruz,087,273765,19918,19635,991,20626,217
2021-10-09,Shasta,089,179085,20015,19437,3350,22787,290
2021-10-09,Sierra,091,2930,160,141,17,158,0
2021-10-09,Siskiyou,093,43540,3239,3124,1207,4331,42
2021-10-09,Solano,095,438530,45059,44265,1199,45464,329
2021-10-09,Sonoma,097,501317,40221,39848,507,40355,387
2021-10-09,Stanislaus,099,539301,75199,74899,8505,83404,1114
2021-10-09,Sutter,101,95872,13492,13314,294,13608,165
2021-10-09,Tehama,103,63373,7908,7670,1335,9005,99
2021-10-09,Trinity,105,12862,807,660,205,865,11
2021-10-09,Tulare,107,460477,65184,63398,13840,77238,932
2021-10-09,Tuolumne,109,53932,6629,6521,78,6599,89
2021-10-09,Ventura,111,848112,96405,95542,4234,99776,1158
2021-10-09,Yolo,113,214977,19140,18850,1039,19889,247
2021-10-09,Yuba,115,75493,9731,9551,242,9793,69
2021-10-08,Alameda,001,1643700,117187,116253,2730,118983,1356
2021-10-08,Alpine,003,1148,99,102,0,102,0
2021-10-08,Amador,005,37829,5313,5237,56,5293,62
2021-10-08,Butte,007,227075,19764,19277,3558,22835,250
2021-10-08,Calaveras,009,45235,3755,3716,44,3760,75
2021-10-08,Colusa,011,21464,2453,2419,586,3005,18
2021-10-08,Contra Costa,013,1133247,97200,96378,2063,98441,958
2021-10-08,Del Norte,015,27424,3583,3495,48,3543,39
2021-10-08,El Dorado,017,186661,15418,15153,1594,16747,144
2021-10-08,Fresno,019,978130,132856,130508,11884,142392,2018
2021-10-08,Glenn,021,27897,3355,3277,941,4218,26
2021-10-08,Humboldt,023,135768,8630,8448,467,8915,97
2021-10-08,Imperial,025,180216,32367,31989,3280,35269,760
2021-10-08,Inyo,027,18085,1909,1808,39,1847,39
2021-10-08,Kern,029,883053,121820,119795,19951,139746,1559
2021-10-08,Kings,031,150075,30542,29894,1788,31682,308
2021-10-08,Lake,033,64148,6416,6283,127,6410,97
2021-10-08,Lassen,035,31185,6594,6442,313,6755,25
2021-10-08,Los Angeles,037,10098052,1413576,1402810,53075,1455885,26280
2021-10-08,Madera,039,155013,21799,21313,1867,23180,271
2021-10-08,Marin,041,260295,17200,17049,429,17478,242
2021-10-08,Mariposa,043,17540,1107,1042,36,1078,5
2021-10-08,Mendocino,045,87422,7134,7011,420,7431,82
2021-10-08,Merced,047,269075,40211,39784,1579,41363,565
2021-10-08,Modoc,049,8938,498,477,176,653,5
2021-10-08,Mono,051,14174,1628,1577,20,1597,3
2021-10-08,Monterey,053,433212,48093,47168,2750,49918,577
2021-10-08,Napa,055,140530,12697,12586,101,12687,96
2021-10-08,Nevada,057,99092,8753,8613,305,8918,90
2021-10-08,Orange,059,3164182,301683,299089,14464,313553,5457
2021-10-08,Placer,061,380077,35443,34877,3429,38306,393
2021-10-08,Plumas,063,18699,1527,1418,26,1444,6
2021-10-08,Riverside,065,2383286,354863,350082,16183,366265,4965
2021-10-08,Sacramento,067,1510023,153053,151566,4195,155761,2160
2021-10-08,San Benito,069,59416,7190,7123,156,7279,71
2021-10-08,San Bernardino,071,2135413,346083,343452,10839,354291,5556
2021-10-08,San Diego,073,3302833,363136,359909,21141,381050,4111
2021-10-08,San Francisco,075,870044,51682,50960,2227,53187,643
2021-10-08,San Joaquin,077,732212,96797,95606,5259,100865,1669
2021-10-08,San Luis Obispo,079,281455,28739,28197,1162,29359,324
2021-10-08,San Mateo,081,765935,53078,52121,819,52940,569
2021-10-08,Santa Barbara,083,443738,43246,42735,1583,44318,514
2021-10-08,Santa Clara,085,1922200,143636,142298,1198,143496,1873
2021-10-08,Santa Cruz,087,273765,19903,19635,991,20626,217
2021-10-08,Shasta,089,179085,19973,19437,3344,22781,290
2021-10-08,Sierra,091,2930,158,141,15,156,0
2021-10-08,Siskiyou,093,43540,3231,3124,1206,4330,42
2021-10-08,Solano,095,438530,45020,44265,1198,45463,329
2021-10-08,Sonoma,097,501317,40186,39848,507,40355,387
2021-10-08,Stanislaus,099,539301,75130,74899,8496,83395,1114
2021-10-08,Sutter,101,95872,13478,13314,292,13606,165
2021-10-08,Tehama,103,63373,7891,7670,1333,9003,99
2021-10-08,Trinity,105,12862,806,660,205,865,11
2021-10-08,Tulare,107,460477,65066,63398,13808,77206,932
2021-10-08,Tuolumne,109,53932,6606,6521,78,6599,89
2021-10-08,Ventura,111,848112,96354,95542,4228,99770,1158
2021-10-08,Yolo,113,214977,19127,18850,1035,19885,247
2021-10-08,Yuba,115,75493,9711,9551,241,9792,69
2021-10-07,Alameda,001,1643700,117068,116253,2729,118982,1356
2021-10-07,Alpine,003,1148,99,102,0,102,0
2021-10-07,Amador,005,37829,5306,5237,56,5293,62
2021-10-07,Butte,007,227075,19715,19277,3547,22824,250
2021-10-07,Calaveras,009,45235,3743,3716,44,3760,75
2021-10-07,Colusa,011,21464,2450,2419,580,2999,18
2021-10-07,Contra Costa,013,1133247,97077,96378,2059,98437,958
2021-10-07,Del Norte,015,27424,3580,3495,48,3543,39
2021-10-07,El Dorado,017,186661,15382,15153,1590,16743,144
2021-10-07,Fresno,019,978130,132582,130508,11858,142366,2018
2021-10-07,Glenn,021,27897,3348,3277,938,4215,26
2021-10-07,Humboldt,023,135768,8604,8448,464,8912,97
2021-10-07,Imperial,025,180216,32296,31989,3266,35255,760
2021-10-07,Inyo,027,18085,1890,1808,39,1847,39
2021-10-07,Kern,029,883053,121589,119795,19885,139680,1559
2021-10-07,Kings,031,150075,30477,29894,1782,31676,308
2021-10-07,Lake,033,64148,6405,6283,127,6410,97
2021-10-07,Lassen,035,31185,6576,6442,311,6753,25
2021-10-07,Los Angeles,037,10098052,1412615,1402810,53030,1455840,26280
2021-10-07,Madera,039,155013,21726,21313,1852,23165,271
2021-10-07,Marin,041,260295,17182,17049,429,17478,242
2021-10-07,Mariposa,043,17540,1099,1042,36,1078,5
2021-10-07,Mendocino,045,87422,7124,7011,416,7427,82
2021-10-07,Merced,047,269075,40144,39784,1563,41347,565
2021-10-07,Modoc,049,8938,495,477,175,652,5
2021-10-07,Mono,051,14174,1619,1577,20,1597,3
2021-10-07,Monterey,053,433212,48068,47168,2741,49909,577
2021-10-07,Napa,055,140530,12682,12586,101,12687,96
2021-10-07,Nevada,057,99092,8725,8613,305,8918,90
2021-10-07,Orange,059,3164182,301457,299089,14450,313539,5457
2021-10-07,Placer,061,380077,35381,34877,3422,38299,393
2021-10-07,Plumas,063,18699,1510,1418,26,1444,6
2021-10-07,Riverside,065,2383286,354530,350082,16171,366253,4965
2021-10-07,Sacramento,067,1510023,152771,151566,4168,155734,2160
2021-10-07,San Benito,069,59416,7174,7123,154,7277,71
2021-10-07,San Bernardino,071,2135413,345812,343452,10832,354284,5556
2021-10-07,San Diego,073,3302833,362724,359909,21120,381029,4111
2021-10-07,San Francisco,075,870044,51612,50960,2224,53184,643
2021-10-07,San Joaquin,077,732212,96643,95606,5251,100857,1669
2021-10-07,San Luis Obispo,079,281455,28688,28197,1160,29357,324
2021-10-07,San Mateo,081,765935,53038,52121,817,52938,569
2021-10-07,Santa Barbara,083,443738,43177,42735,1577,44312,514
2021-10-07,Santa Clara,085,1922200,143485,142298,1192,143490,1873
2021-10-07,Santa Cruz,087,273765,19883,19635,990,20625,217
2021-10-07,Shasta,089,179085,19884,19437,3329,22766,290
2021-10-07,Sierra,091,2930,158,141,15,156,0
2021-10-07,Siskiyou,093,43540,3227,3124,1201,4325,42
2021-10-07,Solano,095,438530,44975,44265,1194,45459,329
2021-10-07,Sonoma,097,501317,40149,39848,505,40353,387
2021-10-07,Stanislaus,099,539301,74968,74899,8471,83370,1114
2021-10-07,Sutter,101,95872,13456,13314,289,13603,165
2021-10-07,Tehama,103,63373,7858,7670,1327,8997,99
2021-10-07,Trinity,105,12862,804,660,205,865,11
2021-10-07,Tulare,107,460477,64900,63398,13770,77168,932
2021-10-07,Tuolumne,109,53932,6584,6521,78,6599,89
2021-10-07,Ventura,111,848112,96281,95542,4225,99767,1158
2021-10-07,Yolo,113,214977,19094,18850,1030,19880,247
2021-10-07,Yuba,115,75493,9685,9551,234,9785,69
2021-10-06,Alameda,001,1643700,116931,116058,2723,118781,1353
2021-10-06,Alpine,003,1148,99,102,0,102,0
2021-10-06,Amador,005,37829,5303,5205,56,5261,62
2021-10-06,Butte,007,227075,19652,19208,3540,22748,247
2021-10-06,Calaveras,009,45235,3734,3669,44,3713,75
2021-10-06,Colusa,011,21464,2448,2414,573,2987,18
2021-10-06,Contra Costa,013,1133247,96950,96184,2055,98239,953
2021-10-06,Del Norte,015,27424,3577,3490,45,3535,39
2021-10-06,El Dorado,017,186661,15357,15078,1588,16666,140
2021-10-06,Fresno,019,978130,132293,130074,11832,141906,2008
2021-10-06,Glenn,021,27897,3338,3270,936,4206,26
2021-10-06,Humboldt,023,135768,8589,8416,457,8873,94
2021-10-06,Imperial,025,180216,32243,31930,3254,35184,760
2021-10-06,Inyo,027,18085,1875,1806,39,1845,39
2021-10-06,Kern,029,883053,121332,119491,19792,139283,1552
2021-10-06,Kings,031,150075,30411,29785,1774,31559,308
2021-10-06,Lake,033,64148,6391,6271,127,6398,97
2021-10-06,Lassen,035,31185,6559,6429,310,6739,25
2021-10-06,Los Angeles,037,10098052,1411657,1401675,52983,1454658,26252
2021-10-06,Madera,039,155013,21671,21230,1842,23072,269
2021-10-06,Marin,041,260295,17173,17042,426,17468,242
2021-10-06,Mariposa,043,17540,1092,1036,36,1072,5
2021-10-06,Mendocino,045,87422,7115,6986,415,7401,81
2021-10-06,Merced,047,269075,40066,39666,1554,41220,563
2021-10-06,Modoc,049,8938,495,477,173,650,5
2021-10-06,Mono,051,14174,1607,1568,20,1588,3
2021-10-06,Monterey,053,433212,48035,47136,2736,49872,577
2021-10-06,Napa,055,140530,12658,12552,100,12652,96
2021-10-06,Nevada,057,99092,8709,8582,304,8886,90
2021-10-06,Orange,059,3164182,301220,298785,14437,313222,5448
2021-10-06,Placer,061,380077,35330,34764,3415,38179,390
2021-10-06,Plumas,063,18699,1487,1383,26,1409,6
2021-10-06,Riverside,065,2383286,354174,349645,16150,365795,4953
2021-10-06,Sacramento,067,1510023,152518,151164,4137,155301,2141
2021-10-06,San Benito,069,59416,7159,7108,154,7262,69
2021-10-06,San Bernardino,071,2135413,345518,343022,10825,353847,5551
2021-10-06,San Diego,073,3302833,362225,359564,21092,380656,4104
2021-10-06,San Francisco,075,870044,51549,50894,2221,53115,641
2021-10-06,San Joaquin,077,732212,96509,95418,5239,100657,1658
2021-10-06,San Luis Obispo,079,281455,28638,28170,1154,29324,323
2021-10-06,San Mateo,081,765935,52988,52056,812,52868,569
2021-10-06,Santa Barbara,083,443738,43094,42687,1575,44262,513
2021-10-06,Santa Clara,085,1922200,143334,142124,1187,143311,1872
2021-10-06,Santa Cruz,087,273765,19854,19604,988,20592,217
2021-10-06,Shasta,089,179085,19810,19325,3316,22641,287
2021-10-06,Sierra,091,2930,156,138,15,153,0
2021-10-06,Siskiyou,093,43540,3217,3116,1194,4310,42
2021-10-06,Solano,095,438530,44941,44185,1193,45378,328
2021-10-06,Sonoma,097,501317,40099,39787,505,40292,383
2021-10-06,Stanislaus,099,539301,74826,74699,8458,83157,1114
2021-10-06,Sutter,101,95872,13435,13284,287,13571,164
2021-10-06,Tehama,103,63373,7822,7629,1320,8949,99
2021-10-06,Trinity,105,12862,801,656,205,861,11
2021-10-06,Tulare,107,460477,64720,63198,13710,76908,926
2021-10-06,Tuolumne,109,53932,6559,6486,78,6564,89
2021-10-06,Ventura,111,848112,96190,95449,4217,99666,1158
2021-10-06,Yolo,113,214977,19062,18815,1025,19840,247
2021-10-06,Yuba,115,75493,9661,9520,233,9753,69
2021-10-05,Alameda,001,1643700,116787,115968,2717,118685,1350
2021-10-05,Alpine,003,1148,99,102,0,102,0
2021-10-05,Amador,005,37829,5282,5194,55,5249,61
2021-10-05,Butte,007,227075,19604,19137,3530,22667,246
2021-10-05,Calaveras,009,45235,3718,3657,44,3701,73
2021-10-05,Colusa,011,21464,2441,2414,572,2986,18
2021-10-05,Contra Costa,013,1133247,96834,96108,2048,98156,941
2021-10-05,Del Norte,015,27424,3575,3485,44,3529,39
2021-10-05,El Dorado,017,186661,15318,15052,1585,16637,140
2021-10-05,Fresno,019,978130,131954,129957,11797,141754,1987
2021-10-05,Glenn,021,27897,3327,3270,932,4202,26
2021-10-05,Humboldt,023,135768,8557,8398,453,8851,94
2021-10-05,Imperial,025,180216,32195,31909,3249,35158,759
2021-10-05,Inyo,027,18085,1858,1800,39,1839,39
2021-10-05,Kern,029,883053,121066,119260,19690,138950,1540
2021-10-05,Kings,031,150075,30336,29749,1768,31517,301
2021-10-05,Lake,033,64148,6370,6264,126,6390,97
2021-10-05,Lassen,035,31185,6540,6417,308,6725,25
2021-10-05,Los Angeles,037,10098052,1410512,1400300,52931,1453231,26223
2021-10-05,Madera,039,155013,21613,21183,1829,23012,269
2021-10-05,Marin,041,260295,17161,17024,426,17450,242
2021-10-05,Mariposa,043,17540,1073,1033,33,1066,5
2021-10-05,Mendocino,045,87422,7099,6972,408,7380,79
2021-10-05,Merced,047,269075,40000,39608,1545,41153,562
2021-10-05,Modoc,049,8938,491,475,172,647,5
2021-10-05,Mono,051,14174,1599,1565,20,1585,3
2021-10-05,Monterey,053,433212,48018,47087,2726,49813,573
2021-10-05,Napa,055,140530,12634,12533,100,12633,96
2021-10-05,Nevada,057,99092,8679,8576,304,8880,90
2021-10-05,Orange,059,3164182,300943,298589,14405,312994,5441
2021-10-05,Placer,061,380077,35250,34728,3408,38136,382
2021-10-05,Plumas,063,18699,1462,1357,26,1383,6
2021-10-05,Riverside,065,2383286,353814,349365,16135,365500,4942
2021-10-05,Sacramento,067,1510023,152245,151111,4108,155219,2126
2021-10-05,San Benito,069,59416,7141,7103,152,7255,69
2021-10-05,San Bernardino,071,2135413,345189,342711,10818,353529,5557
2021-10-05,San Diego,073,3302833,361641,359194,21065,380259,4092
2021-10-05,San Francisco,075,870044,51452,50826,2218,53044,641
2021-10-05,San Joaquin,077,732212,96356,95276,5212,100488,1651
2021-10-05,San Luis Obispo,079,281455,28594,28113,1152,29265,324
2021-10-05,San Mateo,081,765935,52942,52008,812,52820,569
2021-10-05,Santa Barbara,083,443738,43015,42595,1571,44166,511
2021-10-05,Santa Clara,085,1922200,143176,141971,1180,143151,1873
2021-10-05,Santa Cruz,087,273765,19812,19582,988,20570,216
2021-10-05,Shasta,089,179085,19737,19285,3303,22588,286
2021-10-05,Sierra,091,2930,152,136,15,151,0
2021-10-05,Siskiyou,093,43540,3203,3107,1194,4301,42
2021-10-05,Solano,095,438530,44870,44149,1191,45340,325
2021-10-05,Sonoma,097,501317,40045,39756,500,40256,383
2021-10-05,Stanislaus,099,539301,74664,74599,8441,83040,1114
2021-10-05,Sutter,101,95872,13407,13270,286,13556,164
2021-10-05,Tehama,103,63373,7794,7607,1311,8918,98
2021-10-05,Trinity,105,12862,798,655,205,860,11
2021-10-05,Tulare,107,460477,64513,63093,13656,76749,920
2021-10-05,Tuolumne,109,53932,6544,6473,77,6550,89
2021-10-05,Ventura,111,848112,96084,95351,4216,99567,1155
2021-10-05,Yolo,113,214977,19025,18782,1019,19801,245
2021-10-05,Yuba,115,75493,9629,9504,230,9734,69
2021-10-04,Alameda,001,1643700,116624,115845,2714,118559,1347
2021-10-04,Alpine,003,1148,99,102,0,102,0
2021-10-04,Amador,005,37829,5272,5163,54,5217,61
2021-10-04,Butte,007,227075,19527,19081,3518,22599,245
2021-10-04,Calaveras,009,45235,3709,3641,44,3685,73
2021-10-04,Colusa,011,21464,2440,2414,571,2985,18
2021-10-04,Contra Costa,013,1133247,96692,95958,2043,98001,937
2021-10-04,Del Norte,015,27424,3573,3485,40,3525,39
2021-10-04,El Dorado,017,186661,15270,15031,1578,16609,138
2021-10-04,Fresno,019,978130,131645,129665,11770,141435,1978
2021-10-04,Glenn,021,27897,3321,3270,927,4197,26
2021-10-04,Humboldt,023,135768,8523,8355,445,8800,94
2021-10-04,Imperial,025,180216,32146,31866,3242,35108,757
2021-10-04,Inyo,027,18085,1846,1792,36,1828,39
2021-10-04,Kern,029,883053,120778,118984,19569,138553,1531
2021-10-04,Kings,031,150075,30243,29702,1765,31467,303
2021-10-04,Lake,033,64148,6357,6248,126,6374,97
2021-10-04,Lassen,035,31185,6523,6405,308,6713,25
2021-10-04,Los Angeles,037,10098052,1409399,1399604,52872,1452476,26186
2021-10-04,Madera,039,155013,21549,21126,1817,22943,266
2021-10-04,Marin,041,260295,17145,17008,425,17433,242
2021-10-04,Mariposa,043,17540,1061,1024,33,1057,5
2021-10-04,Mendocino,045,87422,7081,6947,405,7352,79
2021-10-04,Merced,047,269075,39885,39565,1528,41093,558
2021-10-04,Modoc,049,8938,488,473,172,645,5
2021-10-04,Mono,051,14174,1592,1561,20,1581,3
2021-10-04,Monterey,053,433212,47997,47058,2719,49777,571
2021-10-04,Napa,055,140530,12610,12506,100,12606,96
2021-10-04,Nevada,057,99092,8659,8563,304,8867,90
2021-10-04,Orange,059,3164182,300648,298165,14373,312538,5438
2021-10-04,Placer,061,380077,35166,34630,3380,38010,379
2021-10-04,Plumas,063,18699,1440,1329,26,1355,6
2021-10-04,Riverside,065,2383286,353434,348828,16125,364953,4923
2021-10-04,Sacramento,067,1510023,151922,150887,4081,154968,2115
2021-10-04,San Benito,069,59416,7128,7099,152,7251,69
2021-10-04,San Bernardino,071,2135413,344832,342418,10806,353224,5551
2021-10-04,San Diego,073,3302833,361062,358525,21034,379559,4090
2021-10-04,San Francisco,075,870044,51357,50798,2214,53012,638
2021-10-04,San Joaquin,077,732212,96159,95198,5192,100390,1649
2021-10-04,San Luis Obispo,079,281455,28549,28090,1146,29236,323
2021-10-04,San Mateo,081,765935,52882,51958,811,52769,569
2021-10-04,Santa Barbara,083,443738,42931,42585,1570,44155,511
2021-10-04,Santa Clara,085,1922200,143032,141840,1174,143014,1869
2021-10-04,Santa Cruz,087,273765,19783,19559,987,20546,216
2021-10-04,Shasta,089,179085,19630,19170,3289,22459,279
2021-10-04,Sierra,091,2930,145,136,14,150,0
2021-10-04,Siskiyou,093,43540,3194,3103,1179,4282,42
2021-10-04,Solano,095,438530,44811,44092,1187,45279,322
2021-10-04,Sonoma,097,501317,39980,39720,500,40220,381
2021-10-04,Stanislaus,099,539301,74511,74444,8422,82866,1106
2021-10-04,Sutter,101,95872,13378,13261,285,13546,164
2021-10-04,Tehama,103,63373,7753,7585,1305,8890,95
2021-10-04,Trinity,105,12862,797,649,204,853,11
2021-10-04,Tulare,107,460477,64322,62957,13588,76545,920
2021-10-04,Tuolumne,109,53932,6518,6442,77,6519,89
2021-10-04,Ventura,111,848112,95992,95170,4210,99380,1153
2021-10-04,Yolo,113,214977,18981,18761,1014,19775,242
2021-10-04,Yuba,115,75493,9590,9481,228,9709,68
2021-10-03,Alameda,001,1643700,116484,115751,2704,118455,1349
2021-10-03,Alpine,003,1148,99,102,0,102,0
2021-10-03,Amador,005,37829,5254,5160,52,5212,61
2021-10-03,Butte,007,227075,19454,19066,3502,22568,245
2021-10-03,Calaveras,009,45235,3692,3632,44,3676,73
2021-10-03,Colusa,011,21464,2439,2413,568,2981,18
2021-10-03,Contra Costa,013,1133247,96558,95890,2036,97926,937
2021-10-03,Del Norte,015,27424,3567,3483,39,3522,39
2021-10-03,El Dorado,017,186661,15212,15014,1571,16585,139
2021-10-03,Fresno,019,978130,131265,129365,11729,141094,1978
2021-10-03,Glenn,021,27897,3314,3266,922,4188,26
2021-10-03,Humboldt,023,135768,8478,8352,441,8793,94
2021-10-03,Imperial,025,180216,32079,31844,3233,35077,757
2021-10-03,Inyo,027,18085,1825,1788,36,1824,39
2021-10-03,Kern,029,883053,120474,118851,19447,138298,1535
2021-10-03,Kings,031,150075,30142,29623,1758,31381,300
2021-10-03,Lake,033,64148,6331,6239,126,6365,97
2021-10-03,Lassen,035,31185,6501,6400,306,6706,25
2021-10-03,Los Angeles,037,10098052,1408128,1398790,52817,1451607,26179
2021-10-03,Madera,039,155013,21477,21066,1807,22873,266
2021-10-03,Marin,041,260295,17122,16995,420,17415,242
2021-10-03,Mariposa,043,17540,1054,1011,33,1044,5
2021-10-03,Mendocino,045,87422,7061,6939,396,7335,79
2021-10-03,Merced,047,269075,39778,39516,1511,41027,558
2021-10-03,Modoc,049,8938,487,472,171,643,5
2021-10-03,Mono,051,14174,1588,1554,20,1574,3
2021-10-03,Monterey,053,433212,47972,47049,2708,49757,571
2021-10-03,Napa,055,140530,12582,12489,98,12587,96
2021-10-03,Nevada,057,99092,8624,8545,304,8849,90
2021-10-03,Orange,059,3164182,300366,298027,14353,312380,5447
2021-10-03,Placer,061,380077,35028,34596,3363,37959,379
2021-10-03,Plumas,063,18699,1412,1328,26,1354,6
2021-10-03,Riverside,065,2383286,353003,348593,16105,364698,4924
2021-10-03,Sacramento,067,1510023,151632,150664,4053,154717,2120
2021-10-03,San Benito,069,59416,7119,7095,152,7247,69
2021-10-03,San Bernardino,071,2135413,344424,342302,10799,353101,5555
2021-10-03,San Diego,073,3302833,360466,358153,21002,379155,4081
2021-10-03,San Francisco,075,870044,51269,50733,2211,52944,638
2021-10-03,San Joaquin,077,732212,95969,95133,5184,100317,1649
2021-10-03,San Luis Obispo,079,281455,28482,28065,1141,29206,325
2021-10-03,San Mateo,081,765935,52815,51923,810,52733,569
2021-10-03,Santa Barbara,083,443738,42834,42550,1562,44112,511
2021-10-03,Santa Clara,085,1922200,142862,141737,1166,142903,1869
2021-10-03,Santa Cruz,087,273765,19743,19548,985,20533,216
2021-10-03,Shasta,089,179085,19525,19132,3259,22391,279
2021-10-03,Sierra,091,2930,142,136,14,150,0
2021-10-03,Siskiyou,093,43540,3181,3096,1168,4264,42
2021-10-03,Solano,095,438530,44747,44051,1184,45235,322
2021-10-03,Sonoma,097,501317,39914,39679,500,40179,381
2021-10-03,Stanislaus,099,539301,74324,74366,8404,82770,1106
2021-10-03,Sutter,101,95872,13363,13248,281,13529,164
2021-10-03,Tehama,103,63373,7710,7564,1300,8864,94
2021-10-03,Trinity,105,12862,793,647,202,849,11
2021-10-03,Tulare,107,460477,64120,62860,13514,76374,924
2021-10-03,Tuolumne,109,53932,6489,6430,75,6505,89
2021-10-03,Ventura,111,848112,95887,95108,4207,99315,1153
2021-10-03,Yolo,113,214977,18952,18720,1007,19727,242
2021-10-03,Yuba,115,75493,9572,9462,227,9689,68
2021-10-02,Alameda,001,1643700,116378,115185,2700,117885,1343
2021-10-02,Alpine,003,1148,99,102,0,102,0
2021-10-02,Amador,005,37829,5245,5105,52,5157,61
2021-10-02,Butte,007,227075,19423,18911,3495,22406,243
2021-10-02,Calaveras,009,45235,3685,3585,44,3629,72
2021-10-02,Colusa,011,21464,2438,2403,566,2969,18
2021-10-02,Contra Costa,013,1133247,96487,95369,2032,97401,933
2021-10-02,Del Norte,015,27424,3562,3468,39,3507,39
2021-10-02,El Dorado,017,186661,15186,14887,1570,16457,136
2021-10-02,Fresno,019,978130,131094,128450,11716,140166,1964
2021-10-02,Glenn,021,27897,3309,3234,922,4156,26
2021-10-02,Humboldt,023,135768,8459,8244,441,8685,94
2021-10-02,Imperial,025,180216,32045,31674,3229,34903,757
2021-10-02,Inyo,027,18085,1816,1746,36,1782,39
2021-10-02,Kern,029,883053,120341,117962,19365,137327,1524
2021-10-02,Kings,031,150075,30093,29339,1754,31093,301
2021-10-02,Lake,033,64148,6322,6191,126,6317,97
2021-10-02,Lassen,035,31185,6496,6360,306,6666,25
2021-10-02,Los Angeles,037,10098052,1407522,1395070,52780,1447850,26126
2021-10-02,Madera,039,155013,21452,20931,1798,22729,266
2021-10-02,Marin,041,260295,17117,16936,417,17353,242
2021-10-02,Mariposa,043,17540,1052,967,33,1000,5
2021-10-02,Mendocino,045,87422,7051,6869,396,7265,78
2021-10-02,Merced,047,269075,39751,39196,1508,40704,552
2021-10-02,Modoc,049,8938,485,468,171,639,5
2021-10-02,Mono,051,14174,1586,1540,20,1560,3
2021-10-02,Monterey,053,433212,47917,46964,2707,49671,571
2021-10-02,Napa,055,140530,12571,12433,98,12531,96
2021-10-02,Nevada,057,99092,8613,8474,303,8777,87
2021-10-02,Orange,059,3164182,300201,297307,14333,311640,5435
2021-10-02,Placer,061,380077,34962,34377,3354,37731,381
2021-10-02,Plumas,063,18699,1401,1298,26,1324,6
2021-10-02,Riverside,065,2383286,352762,347227,16094,363321,4895
2021-10-02,Sacramento,067,1510023,151458,149897,4045,153942,2099
2021-10-02,San Benito,069,59416,7112,7055,152,7207,69
2021-10-02,San Bernardino,071,2135413,344241,341212,10749,351961,5540
2021-10-02,San Diego,073,3302833,360144,356454,20980,377434,4078
2021-10-02,San Francisco,075,870044,51220,50393,2206,52599,634
2021-10-02,San Joaquin,077,732212,95904,94599,5178,99777,1646
2021-10-02,San Luis Obispo,079,281455,28458,27915,1141,29056,323
2021-10-02,San Mateo,081,765935,52774,51767,806,52573,573
2021-10-02,Santa Barbara,083,443738,42794,42423,1562,43985,508
2021-10-02,Santa Clara,085,1922200,142748,141231,1162,142393,1862
2021-10-02,Santa Cruz,087,273765,19726,19461,984,20445,214
2021-10-02,Shasta,089,179085,19479,18912,3253,22165,270
2021-10-02,Sierra,091,2930,141,131,14,145,0
2021-10-02,Siskiyou,093,43540,3180,3053,1165,4218,42
2021-10-02,Solano,095,438530,44702,43800,1183,44983,321
2021-10-02,Sonoma,097,501317,39880,39497,499,39996,382
2021-10-02,Stanislaus,099,539301,74238,73859,8390,82249,1099
2021-10-02,Sutter,101,95872,13354,13160,280,13440,160
2021-10-02,Tehama,103,63373,7695,7453,1300,8753,93
2021-10-02,Trinity,105,12862,790,625,202,827,10
2021-10-02,Tulare,107,460477,64046,62247,13487,75734,908
2021-10-02,Tuolumne,109,53932,6475,6369,75,6444,89
2021-10-02,Ventura,111,848112,95815,94854,4202,99056,1148
2021-10-02,Yolo,113,214977,18927,18640,1003,19643,242
2021-10-02,Yuba,115,75493,9553,9370,226,9596,66
2021-10-01,Alameda,001,1643700,116302,115185,2694,117879,1343
2021-10-01,Alpine,003,1148,99,102,0,102,0
2021-10-01,Amador,005,37829,5225,5105,52,5157,61
2021-10-01,Butte,007,227075,19382,18911,3489,22400,243
2021-10-01,Calaveras,009,45235,3675,3585,44,3629,72
2021-10-01,Colusa,011,21464,2436,2403,566,2969,18
2021-10-01,Contra Costa,013,1133247,96388,95369,2028,97397,933
2021-10-01,Del Norte,015,27424,3559,3468,38,3506,39
2021-10-01,El Dorado,017,186661,15168,14887,1566,16453,136
2021-10-01,Fresno,019,978130,130906,128450,11705,140155,1964
2021-10-01,Glenn,021,27897,3307,3234,921,4155,26
2021-10-01,Humboldt,023,135768,8443,8244,441,8685,94
2021-10-01,Imperial,025,180216,32027,31674,3220,34894,757
2021-10-01,Inyo,027,18085,1807,1746,36,1782,39
2021-10-01,Kern,029,883053,120189,117962,19307,137269,1524
2021-10-01,Kings,031,150075,30059,29339,1748,31087,301
2021-10-01,Lake,033,64148,6312,6191,126,6317,97
2021-10-01,Lassen,035,31185,6485,6360,304,6664,25
2021-10-01,Los Angeles,037,10098052,1406761,1395070,52735,1447805,26126
2021-10-01,Madera,039,155013,21402,20931,1789,22720,266
2021-10-01,Marin,041,260295,17102,16936,416,17352,242
2021-10-01,Mariposa,043,17540,1045,967,33,1000,5
2021-10-01,Mendocino,045,87422,7039,6869,396,7265,78
2021-10-01,Merced,047,269075,39705,39196,1499,40695,552
2021-10-01,Modoc,049,8938,484,468,171,639,5
2021-10-01,Mono,051,14174,1583,1540,20,1560,3
2021-10-01,Monterey,053,433212,47896,46964,2704,49668,571
2021-10-01,Napa,055,140530,12561,12433,97,12530,96
2021-10-01,Nevada,057,99092,8599,8474,302,8776,87
2021-10-01,Orange,059,3164182,300017,297307,14313,311620,5435
2021-10-01,Placer,061,380077,34928,34377,3350,37727,381
2021-10-01,Plumas,063,18699,1392,1298,26,1324,6
2021-10-01,Riverside,065,2383286,352469,347227,16086,363313,4895
2021-10-01,Sacramento,067,1510023,151307,149897,4034,153931,2099
2021-10-01,San Benito,069,59416,7110,7055,150,7205,69
2021-10-01,San Bernardino,071,2135413,344042,341212,10746,351958,5540
2021-10-01,San Diego,073,3302833,359777,356454,20959,377413,4078
2021-10-01,San Francisco,075,870044,51179,50393,2204,52597,634
2021-10-01,San Joaquin,077,732212,95834,94599,5174,99773,1646
2021-10-01,San Luis Obispo,079,281455,28434,27915,1138,29053,323
2021-10-01,San Mateo,081,765935,52734,51767,803,52570,573
2021-10-01,Santa Barbara,083,443738,42758,42423,1562,43985,508
2021-10-01,Santa Clara,085,1922200,142655,141231,1157,142388,1862
2021-10-01,Santa Cruz,087,273765,19706,19461,983,20444,214
2021-10-01,Shasta,089,179085,19425,18912,3245,22157,270
2021-10-01,Sierra,091,2930,141,131,14,145,0
2021-10-01,Siskiyou,093,43540,3179,3053,1162,4215,42
2021-10-01,Solano,095,438530,44650,43800,1177,44977,321
2021-10-01,Sonoma,097,501317,39848,39497,498,39995,382
2021-10-01,Stanislaus,099,539301,74154,73859,8379,82238,1099
2021-10-01,Sutter,101,95872,13338,13160,278,13438,160
2021-10-01,Tehama,103,63373,7683,7453,1298,8751,93
2021-10-01,Trinity,105,12862,788,625,202,827,10
2021-10-01,Tulare,107,460477,63943,62247,13452,75699,908
2021-10-01,Tuolumne,109,53932,6458,6369,75,6444,89
2021-10-01,Ventura,111,848112,95748,94854,4197,99051,1148
2021-10-01,Yolo,113,214977,18903,18640,999,19639,242
2021-10-01,Yuba,115,75493,9531,9370,226,9596,66
2021-09-30,Alameda,001,1643700,116157,115185,2691,117876,1343
2021-09-30,Alpine,003,1148,99,102,0,102,0
2021-09-30,Amador,005,37829,5213,5105,52,5157,61
2021-09-30,Butte,007,227075,19333,18911,3480,22391,243
2021-09-30,Calaveras,009,45235,3661,3585,44,3629,72
2021-09-30,Colusa,011,21464,2433,2403,565,2968,18
2021-09-30,Contra Costa,013,1133247,96284,95369,2022,97391,933
2021-09-30,Del Norte,015,27424,3555,3468,35,3503,39
2021-09-30,El Dorado,017,186661,15143,14887,1558,16445,136
2021-09-30,Fresno,019,978130,130630,128450,11671,140121,1964
2021-09-30,Glenn,021,27897,3297,3234,919,4153,26
2021-09-30,Humboldt,023,135768,8411,8244,435,8679,94
2021-09-30,Imperial,025,180216,31975,31674,3215,34889,757
2021-09-30,Inyo,027,18085,1797,1746,36,1782,39
2021-09-30,Kern,029,883053,119945,117962,19225,137187,1524
2021-09-30,Kings,031,150075,29969,29339,1744,31083,301
2021-09-30,Lake,033,64148,6294,6191,126,6317,97
2021-09-30,Lassen,035,31185,6471,6360,304,6664,25
2021-09-30,Los Angeles,037,10098052,1405555,1395070,52676,1447746,26126
2021-09-30,Madera,039,155013,21319,20931,1774,22705,266
2021-09-30,Marin,041,260295,17082,16936,415,17351,242
2021-09-30,Mariposa,043,17540,1023,967,33,1000,5
2021-09-30,Mendocino,045,87422,7030,6869,387,7256,78
2021-09-30,Merced,047,269075,39608,39196,1495,40691,552
2021-09-30,Modoc,049,8938,484,468,170,638,5
2021-09-30,Mono,051,14174,1575,1540,20,1560,3
2021-09-30,Monterey,053,433212,47867,46964,2692,49656,571
2021-09-30,Napa,055,140530,12541,12433,97,12530,96
2021-09-30,Nevada,057,99092,8582,8474,301,8775,87
2021-09-30,Orange,059,3164182,299745,297307,14274,311581,5435
2021-09-30,Placer,061,380077,34876,34377,3329,37706,381
2021-09-30,Plumas,063,18699,1374,1298,26,1324,6
2021-09-30,Riverside,065,2383286,352036,347227,16065,363292,4895
2021-09-30,Sacramento,067,1510023,151052,149897,4008,153905,2099
2021-09-30,San Benito,069,59416,7104,7055,150,7205,69
2021-09-30,San Bernardino,071,2135413,343732,341212,10732,351944,5540
2021-09-30,San Diego,073,3302833,359283,356454,20933,377387,4078
2021-09-30,San Francisco,075,870044,51102,50393,2200,52593,634
2021-09-30,San Joaquin,077,732212,95705,94599,5166,99765,1646
2021-09-30,San Luis Obispo,079,281455,28386,27915,1134,29049,323
2021-09-30,San Mateo,081,765935,52685,51767,800,52567,573
2021-09-30,Santa Barbara,083,443738,42702,42423,1561,43984,508
2021-09-30,Santa Clara,085,1922200,142504,141231,1154,142385,1862
2021-09-30,Santa Cruz,087,273765,19666,19461,982,20443,214
2021-09-30,Shasta,089,179085,19363,18912,3230,22142,270
2021-09-30,Sierra,091,2930,140,131,14,145,0
2021-09-30,Siskiyou,093,43540,3171,3053,1157,4210,42
2021-09-30,Solano,095,438530,44598,43800,1174,44974,321
2021-09-30,Sonoma,097,501317,39799,39497,498,39995,382
2021-09-30,Stanislaus,099,539301,73994,73859,8360,82219,1099
2021-09-30,Sutter,101,95872,13317,13160,278,13438,160
2021-09-30,Tehama,103,63373,7646,7453,1287,8740,93
2021-09-30,Trinity,105,12862,784,625,202,827,10
2021-09-30,Tulare,107,460477,63767,62247,13393,75640,908
2021-09-30,Tuolumne,109,53932,6435,6369,75,6444,89
2021-09-30,Ventura,111,848112,95643,94854,4190,99044,1148
2021-09-30,Yolo,113,214977,18864,18640,996,19636,242
2021-09-30,Yuba,115,75493,9508,9370,225,9595,66
2021-09-29,Alameda,001,1643700,116008,114998,2688,117686,1339
2021-09-29,Alpine,003,1148,99,101,0,101,0
2021-09-29,Amador,005,37829,5191,5058,52,5110,61
2021-09-29,Butte,007,227075,19279,18835,3473,22308,242
2021-09-29,Calaveras,009,45235,3644,3553,43,3596,72
2021-09-29,Colusa,011,21464,2431,2401,565,2966,18
2021-09-29,Contra Costa,013,1133247,96170,95213,2014,97227,929
2021-09-29,Del Norte,015,27424,3549,3467,35,3502,39
2021-09-29,El Dorado,017,186661,15109,14834,1551,16385,136
2021-09-29,Fresno,019,978130,130332,128068,11651,139719,1957
2021-09-29,Glenn,021,27897,3293,3213,916,4129,26
2021-09-29,Humboldt,023,135768,8387,8203,434,8637,94
2021-09-29,Imperial,025,180216,31908,31600,3210,34810,757
2021-09-29,Inyo,027,18085,1787,1740,35,1775,39
2021-09-29,Kern,029,883053,119710,117605,19149,136754,1513
2021-09-29,Kings,031,150075,29886,29195,1729,30924,299
2021-09-29,Lake,033,64148,6274,6164,126,6290,97
2021-09-29,Lassen,035,31185,6457,6347,304,6651,25
2021-09-29,Los Angeles,037,10098052,1404344,1393617,52604,1446221,26098
2021-09-29,Madera,039,155013,21274,20818,1758,22576,266
2021-09-29,Marin,041,260295,17064,16921,413,17334,242
2021-09-29,Mariposa,043,17540,1008,963,33,996,5
2021-09-29,Mendocino,045,87422,7018,6821,379,7200,78
2021-09-29,Merced,047,269075,39514,39026,1484,40510,552
2021-09-29,Modoc,049,8938,482,468,170,638,5
2021-09-29,Mono,051,14174,1573,1527,20,1547,3
2021-09-29,Monterey,053,433212,47830,46917,2679,49596,571
2021-09-29,Napa,055,140530,12521,12416,93,12509,96
2021-09-29,Nevada,057,99092,8569,8434,301,8735,87
2021-09-29,Orange,059,3164182,299476,296936,14238,311174,5429
2021-09-29,Placer,061,380077,34812,34271,3306,37577,379
2021-09-29,Plumas,063,18699,1355,1289,26,1315,6
2021-09-29,Riverside,065,2383286,351602,346558,16052,362610,4886
2021-09-29,Sacramento,067,1510023,150802,149686,3998,153684,2099
2021-09-29,San Benito,069,59416,7093,7039,150,7189,69
2021-09-29,San Bernardino,071,2135413,343412,340672,10718,351390,5539
2021-09-29,San Diego,073,3302833,358781,355899,20903,376802,4066
2021-09-29,San Francisco,075,870044,51017,50286,2196,52482,629
2021-09-29,San Joaquin,077,732212,95548,94356,5144,99500,1645
2021-09-29,San Luis Obispo,079,281455,28340,27800,1128,28928,323
2021-09-29,San Mateo,081,765935,52626,51673,798,52471,573
2021-09-29,Santa Barbara,083,443738,42630,42328,1558,43886,507
2021-09-29,Santa Clara,085,1922200,142370,141036,1148,142184,1861
2021-09-29,Santa Cruz,087,273765,19648,19425,981,20406,214
2021-09-29,Shasta,089,179085,19297,18805,3218,22023,271
2021-09-29,Sierra,091,2930,136,130,14,144,0
2021-09-29,Siskiyou,093,43540,3158,3043,1150,4193,42
2021-09-29,Solano,095,438530,44542,43724,1167,44891,321
2021-09-29,Sonoma,097,501317,39738,39426,496,39922,370
2021-09-29,Stanislaus,099,539301,73863,73634,8349,81983,1096
2021-09-29,Sutter,101,95872,13290,13135,275,13410,155
2021-09-29,Tehama,103,63373,7616,7409,1272,8681,88
2021-09-29,Trinity,105,12862,780,616,202,818,10
2021-09-29,Tulare,107,460477,63595,62046,13334,75380,908
2021-09-29,Tuolumne,109,53932,6418,6336,75,6411,89
2021-09-29,Ventura,111,848112,95553,94753,4186,98939,1144
2021-09-29,Yolo,113,214977,18831,18587,991,19578,239
2021-09-29,Yuba,115,75493,9477,9351,221,9572,66
2021-09-28,Alameda,001,1643700,115848,114869,2682,117551,1333
2021-09-28,Alpine,003,1148,99,101,0,101,0
2021-09-28,Amador,005,37829,5169,5049,52,5101,61
2021-09-28,Butte,007,227075,19228,18764,3460,22224,241
2021-09-28,Calaveras,009,45235,3624,3530,43,3573,72
2021-09-28,Colusa,011,21464,2428,2399,563,2962,18
2021-09-28,Contra Costa,013,1133247,96028,95115,2009,97124,929
2021-09-28,Del Norte,015,27424,3546,3462,35,3497,39
2021-09-28,El Dorado,017,186661,15062,14793,1547,16340,133
2021-09-28,Fresno,019,978130,129988,127877,11618,139495,1948
2021-09-28,Glenn,021,27897,3288,3205,916,4121,26
2021-09-28,Humboldt,023,135768,8346,8159,431,8590,91
2021-09-28,Imperial,025,180216,31864,31543,3205,34748,757
2021-09-28,Inyo,027,18085,1773,1708,34,1742,39
2021-09-28,Kern,029,883053,119442,117420,19054,136474,1506
2021-09-28,Kings,031,150075,29785,29141,1721,30862,295
2021-09-28,Lake,033,64148,6259,6155,126,6281,95
2021-09-28,Lassen,035,31185,6451,6340,300,6640,25
2021-09-28,Los Angeles,037,10098052,1403050,1392445,52535,1444980,26068
2021-09-28,Madera,039,155013,21220,20764,1742,22506,266
2021-09-28,Marin,041,260295,17045,16887,411,17298,242
2021-09-28,Mariposa,043,17540,1003,952,33,985,5
2021-09-28,Mendocino,045,87422,6996,6804,377,7181,78
2021-09-28,Merced,047,269075,39426,38953,1471,40424,551
2021-09-28,Modoc,049,8938,481,467,170,637,5
2021-09-28,Mono,051,14174,1563,1527,20,1547,3
2021-09-28,Monterey,053,433212,47793,46859,2670,49529,571
2021-09-28,Napa,055,140530,12504,12388,92,12480,96
2021-09-28,Nevada,057,99092,8546,8409,300,8709,84
2021-09-28,Orange,059,3164182,299223,296596,14210,310806,5421
2021-09-28,Placer,061,380077,34747,34187,3288,37475,370
2021-09-28,Plumas,063,18699,1346,1276,26,1302,6
2021-09-28,Riverside,065,2383286,351143,346096,16031,362127,4874
2021-09-28,Sacramento,067,1510023,150512,149310,3976,153286,2086
2021-09-28,San Benito,069,59416,7076,7028,149,7177,69
2021-09-28,San Bernardino,071,2135413,343063,340342,10701,351043,5540
2021-09-28,San Diego,073,3302833,358220,355373,20872,376245,4054
2021-09-28,San Francisco,075,870044,50916,50234,2195,52429,627
2021-09-28,San Joaquin,077,732212,95395,94194,5131,99325,1639
2021-09-28,San Luis Obispo,079,281455,28305,27755,1123,28878,321
2021-09-28,San Mateo,081,765935,52580,51620,797,52417,571
2021-09-28,Santa Barbara,083,443738,42558,42226,1557,43783,506
2021-09-28,Santa Clara,085,1922200,142209,140886,1139,142025,1858
2021-09-28,Santa Cruz,087,273765,19607,19324,980,20304,214
2021-09-28,Shasta,089,179085,19236,18701,3204,21905,267
2021-09-28,Sierra,091,2930,135,130,13,143,0
2021-09-28,Siskiyou,093,43540,3146,3032,1147,4179,42
2021-09-28,Solano,095,438530,44469,43652,1164,44816,316
2021-09-28,Sonoma,097,501317,39691,39395,495,39890,370
2021-09-28,Stanislaus,099,539301,73692,73528,8337,81865,1094
2021-09-28,Sutter,101,95872,13271,13102,271,13373,155
2021-09-28,Tehama,103,63373,7598,7382,1257,8639,88
2021-09-28,Trinity,105,12862,777,613,202,815,10
2021-09-28,Tulare,107,460477,63435,61916,13275,75191,905
2021-09-28,Tuolumne,109,53932,6392,6308,75,6383,89
2021-09-28,Ventura,111,848112,95427,94632,4183,98815,1143
2021-09-28,Yolo,113,214977,18805,18564,988,19552,239
2021-09-28,Yuba,115,75493,9458,9323,220,9543,66
2021-09-27,Alameda,001,1643700,115659,114731,2673,117404,1327
2021-09-27,Alpine,003,1148,99,101,0,101,0
2021-09-27,Amador,005,37829,5155,5017,52,5069,59
2021-09-27,Butte,007,227075,19171,18687,3444,22131,239
2021-09-27,Calaveras,009,45235,3604,3514,42,3556,70
2021-09-27,Colusa,011,21464,2427,2393,562,2955,18
2021-09-27,Contra Costa,013,1133247,95897,94979,2000,96979,924
2021-09-27,Del Norte,015,27424,3544,3468,33,3501,37
2021-09-27,El Dorado,017,186661,15023,14764,1540,16304,132
2021-09-27,Fresno,019,978130,129670,127475,11586,139061,1942
2021-09-27,Glenn,021,27897,3274,3189,911,4100,26
2021-09-27,Humboldt,023,135768,8306,8118,431,8549,91
2021-09-27,Imperial,025,180216,31801,31491,3198,34689,756
2021-09-27,Inyo,027,18085,1761,1698,34,1732,39
2021-09-27,Kern,029,883053,119166,117064,18956,136020,1503
2021-09-27,Kings,031,150075,29687,28998,1709,30707,297
2021-09-27,Lake,033,64148,6239,6126,124,6250,95
2021-09-27,Lassen,035,31185,6436,6327,296,6623,25
2021-09-27,Los Angeles,037,10098052,1401714,1391538,52466,1444004,26040
2021-09-27,Madera,039,155013,21155,20691,1734,22425,262
2021-09-27,Marin,041,260295,17023,16861,410,17271,242
2021-09-27,Mariposa,043,17540,993,931,33,964,5
2021-09-27,Mendocino,045,87422,6970,6761,370,7131,74
2021-09-27,Merced,047,269075,39327,38840,1465,40305,548
2021-09-27,Modoc,049,8938,480,465,168,633,5
2021-09-27,Mono,051,14174,1551,1525,20,1545,3
2021-09-27,Monterey,053,433212,47750,46811,2658,49469,571
2021-09-27,Napa,055,140530,12480,12354,91,12445,95
2021-09-27,Nevada,057,99092,8523,8379,297,8676,84
2021-09-27,Orange,059,3164182,298918,296334,14179,310513,5409
2021-09-27,Placer,061,380077,34660,34087,3283,37370,370
2021-09-27,Plumas,063,18699,1336,1269,26,1295,6
2021-09-27,Riverside,065,2383286,350701,345529,16021,361550,4864
2021-09-27,Sacramento,067,1510023,150194,149096,3954,153050,2076
2021-09-27,San Benito,069,59416,7059,7017,149,7166,67
2021-09-27,San Bernardino,071,2135413,342649,339952,10676,350628,5544
2021-09-27,San Diego,073,3302833,357562,354755,20847,375602,4054
2021-09-27,San Francisco,075,870044,50832,50157,2191,52348,622
2021-09-27,San Joaquin,077,732212,95212,94085,5128,99213,1633
2021-09-27,San Luis Obispo,079,281455,28250,27674,1120,28794,320
2021-09-27,San Mateo,081,765935,52502,51552,797,52349,571
2021-09-27,Santa Barbara,083,443738,42491,42012,1553,43565,505
2021-09-27,Santa Clara,085,1922200,142027,140802,1129,141931,1853
2021-09-27,Santa Cruz,087,273765,19583,19292,979,20271,214
2021-09-27,Shasta,089,179085,19155,18599,3177,21776,267
2021-09-27,Sierra,091,2930,135,128,13,141,0
2021-09-27,Siskiyou,093,43540,3134,3015,1142,4157,42
2021-09-27,Solano,095,438530,44394,43582,1158,44740,314
2021-09-27,Sonoma,097,501317,39638,39347,495,39842,370
2021-09-27,Stanislaus,099,539301,73538,73370,8317,81687,1091
2021-09-27,Sutter,101,95872,13240,13082,268,13350,155
2021-09-27,Tehama,103,63373,7557,7345,1247,8592,88
2021-09-27,Trinity,105,12862,766,605,201,806,9
2021-09-27,Tulare,107,460477,63235,61708,13204,74912,904
2021-09-27,Tuolumne,109,53932,6371,6264,75,6339,89
2021-09-27,Ventura,111,848112,95301,94477,4179,98656,1138
2021-09-27,Yolo,113,214977,18773,18524,987,19511,239
2021-09-27,Yuba,115,75493,9421,9292,216,9508,64
2021-09-26,Alameda,001,1643700,115462,114601,2666,117267,1326
2021-09-26,Alpine,003,1148,99,101,0,101,0
2021-09-26,Amador,005,37829,5123,5001,51,5052,59
2021-09-26,Butte,007,227075,19095,18634,3427,22061,238
2021-09-26,Calaveras,009,45235,3583,3505,42,3547,70
2021-09-26,Colusa,011,21464,2421,2392,559,2951,18
2021-09-26,Contra Costa,013,1133247,95723,94877,1987,96864,924
2021-09-26,Del Norte,015,27424,3539,3466,32,3498,37
2021-09-26,El Dorado,017,186661,14981,14738,1532,16270,132
2021-09-26,Fresno,019,978130,129314,127235,11546,138781,1939
2021-09-26,Glenn,021,27897,3263,3182,910,4092,26
2021-09-26,Humboldt,023,135768,8271,8098,430,8528,91
2021-09-26,Imperial,025,180216,31740,31462,3197,34659,756
2021-09-26,Inyo,027,18085,1746,1685,34,1719,39
2021-09-26,Kern,029,883053,118830,116927,18846,135773,1502
2021-09-26,Kings,031,150075,29586,28930,1698,30628,293
2021-09-26,Lake,033,64148,6222,6113,124,6237,95
2021-09-26,Lassen,035,31185,6426,6319,291,6610,25
2021-09-26,Los Angeles,037,10098052,1400225,1390577,52395,1442972,26035
2021-09-26,Madera,039,155013,21081,20629,1715,22344,262
2021-09-26,Marin,041,260295,17000,16860,410,17270,242
2021-09-26,Mariposa,043,17540,987,929,33,962,5
2021-09-26,Mendocino,045,87422,6936,6744,355,7099,74
2021-09-26,Merced,047,269075,39166,38717,1460,40177,548
2021-09-26,Modoc,049,8938,480,465,167,632,5
2021-09-26,Mono,051,14174,1547,1516,20,1536,3
2021-09-26,Monterey,053,433212,47703,46792,2644,49436,571
2021-09-26,Napa,055,140530,12456,12340,90,12430,95
2021-09-26,Nevada,057,99092,8492,8356,292,8648,84
2021-09-26,Orange,059,3164182,298581,296085,14147,310232,5409
2021-09-26,Placer,061,380077,34566,34043,3273,37316,370
2021-09-26,Plumas,063,18699,1318,1268,26,1294,6
2021-09-26,Riverside,065,2383286,350168,345257,16007,361264,4864
2021-09-26,Sacramento,067,1510023,149790,148745,3935,152680,2071
2021-09-26,San Benito,069,59416,7042,7012,148,7160,67
2021-09-26,San Bernardino,071,2135413,342195,339771,10661,350432,5545
2021-09-26,San Diego,073,3302833,356920,354414,20806,375220,4051
2021-09-26,San Francisco,075,870044,50706,50092,2183,52275,622
2021-09-26,San Joaquin,077,732212,95008,93935,5114,99049,1633
2021-09-26,San Luis Obispo,079,281455,28176,27624,1115,28739,319
2021-09-26,San Mateo,081,765935,52433,51496,795,52291,571
2021-09-26,Santa Barbara,083,443738,42404,41946,1550,43496,505
2021-09-26,Santa Clara,085,1922200,141827,140667,1125,141792,1852
2021-09-26,Santa Cruz,087,273765,19558,19279,979,20258,214
2021-09-26,Shasta,089,179085,19046,18566,3154,21720,266
2021-09-26,Sierra,091,2930,135,128,13,141,0
2021-09-26,Siskiyou,093,43540,3120,2998,1132,4130,42
2021-09-26,Solano,095,438530,44327,43537,1157,44694,314
2021-09-26,Sonoma,097,501317,39579,39302,495,39797,370
2021-09-26,Stanislaus,099,539301,73336,73243,8289,81532,1091
2021-09-26,Sutter,101,95872,13203,13045,267,13312,155
2021-09-26,Tehama,103,63373,7499,7323,1237,8560,88
2021-09-26,Trinity,105,12862,763,591,201,792,9
2021-09-26,Tulare,107,460477,63014,61560,13125,74685,904
2021-09-26,Tuolumne,109,53932,6343,6236,73,6309,89
2021-09-26,Ventura,111,848112,95188,94391,4172,98563,1138
2021-09-26,Yolo,113,214977,18737,18496,979,19475,239
2021-09-26,Yuba,115,75493,9394,9275,216,9491,64
2021-09-25,Alameda,001,1643700,115382,114014,2663,116677,1324
2021-09-25,Alpine,003,1148,99,101,0,101,0
2021-09-25,Amador,005,37829,5109,4934,51,4985,59
2021-09-25,Butte,007,227075,19066,18396,3418,21814,236
2021-09-25,Calaveras,009,45235,3580,3461,42,3503,70
2021-09-25,Colusa,011,21464,2419,2387,557,2944,16
2021-09-25,Contra Costa,013,1133247,95652,94337,1983,96320,924
2021-09-25,Del Norte,015,27424,3538,3404,32,3436,35
2021-09-25,El Dorado,017,186661,14958,14641,1528,16169,130
2021-09-25,Fresno,019,978130,129170,126299,11533,137832,1927
2021-09-25,Glenn,021,27897,3258,3144,909,4053,25
2021-09-25,Humboldt,023,135768,8252,8014,428,8442,88
2021-09-25,Imperial,025,180216,31713,31280,3197,34477,755
2021-09-25,Inyo,027,18085,1738,1657,34,1691,39
2021-09-25,Kern,029,883053,118675,116021,18778,134799,1485
2021-09-25,Kings,031,150075,29535,28636,1695,30331,293
2021-09-25,Lake,033,64148,6217,6046,122,6168,92
2021-09-25,Lassen,035,31185,6414,6248,290,6538,25
2021-09-25,Los Angeles,037,10098052,1399510,1386417,52356,1438773,25964
2021-09-25,Madera,039,155013,21056,20432,1709,22141,262
2021-09-25,Marin,041,260295,16991,16802,408,17210,242
2021-09-25,Mariposa,043,17540,982,906,33,939,5
2021-09-25,Mendocino,045,87422,6917,6657,354,7011,74
2021-09-25,Merced,047,269075,39120,38393,1458,39851,546
2021-09-25,Modoc,049,8938,480,460,167,627,5
2021-09-25,Mono,051,14174,1544,1501,20,1521,3
2021-09-25,Monterey,053,433212,47673,46653,2642,49295,567
2021-09-25,Napa,055,140530,12436,12266,90,12356,95
2021-09-25,Nevada,057,99092,8475,8285,292,8577,84
2021-09-25,Orange,059,3164182,298408,294514,14129,308643,5374
2021-09-25,Placer,061,380077,34502,33764,3270,37034,367
2021-09-25,Plumas,063,18699,1314,1238,26,1264,6
2021-09-25,Riverside,065,2383286,349845,343463,15999,359462,4843
2021-09-25,Sacramento,067,1510023,149614,147728,3926,151654,2049
2021-09-25,San Benito,069,59416,7037,6965,148,7113,67
2021-09-25,San Bernardino,071,2135413,341962,338413,10647,349060,5540
2021-09-25,San Diego,073,3302833,356570,352017,20780,372797,4039
2021-09-25,San Francisco,075,870044,50662,49840,2182,52022,615
2021-09-25,San Joaquin,077,732212,94922,93273,5112,98385,1628
2021-09-25,San Luis Obispo,079,281455,28138,27447,1111,28558,318
2021-09-25,San Mateo,081,765935,52369,51266,793,52059,568
2021-09-25,Santa Barbara,083,443738,42346,41728,1550,43278,505
2021-09-25,Santa Clara,085,1922200,141721,140023,1123,141146,1844
2021-09-25,Santa Cruz,087,273765,19542,19200,977,20177,214
2021-09-25,Shasta,089,179085,18995,18256,3145,21401,262
2021-09-25,Sierra,091,2930,134,127,13,140,0
2021-09-25,Siskiyou,093,43540,3113,2956,1122,4078,41
2021-09-25,Solano,095,438530,44286,43331,1154,44485,312
2021-09-25,Sonoma,097,501317,39538,39112,495,39607,369
2021-09-25,Stanislaus,099,539301,73226,72628,8275,80903,1091
2021-09-25,Sutter,101,95872,13185,12976,264,13240,154
2021-09-25,Tehama,103,63373,7484,7200,1235,8435,86
2021-09-25,Trinity,105,12862,763,576,201,777,9
2021-09-25,Tulare,107,460477,62932,60909,13080,73989,898
2021-09-25,Tuolumne,109,53932,6331,6168,73,6241,89
2021-09-25,Ventura,111,848112,95121,94059,4168,98227,1129
2021-09-25,Yolo,113,214977,18715,18393,978,19371,239
2021-09-25,Yuba,115,75493,9374,9191,216,9407,61
2021-09-24,Alameda,001,1643700,115275,114014,2659,116673,1324
2021-09-24,Alpine,003,1148,99,101,0,101,0
2021-09-24,Amador,005,37829,5079,4934,51,4985,59
2021-09-24,Butte,007,227075,19014,18396,3409,21805,236
2021-09-24,Calaveras,009,45235,3573,3461,41,3502,70
2021-09-24,Colusa,011,21464,2416,2387,556,2943,16
2021-09-24,Contra Costa,013,1133247,95544,94337,1979,96316,924
2021-09-24,Del Norte,015,27424,3535,3404,32,3436,35
2021-09-24,El Dorado,017,186661,14940,14641,1524,16165,130
2021-09-24,Fresno,019,978130,128971,126299,11521,137820,1927
2021-09-24,Glenn,021,27897,3251,3144,909,4053,25
2021-09-24,Humboldt,023,135768,8233,8014,425,8439,88
2021-09-24,Imperial,025,180216,31675,31280,3194,34474,755
2021-09-24,Inyo,027,18085,1729,1657,34,1691,39
2021-09-24,Kern,029,883053,118539,116021,18712,134733,1485
2021-09-24,Kings,031,150075,29494,28636,1690,30326,293
2021-09-24,Lake,033,64148,6209,6046,122,6168,92
2021-09-24,Lassen,035,31185,6406,6248,289,6537,25
2021-09-24,Los Angeles,037,10098052,1398629,1386417,52313,1438730,25964
2021-09-24,Madera,039,155013,21025,20432,1700,22132,262
2021-09-24,Marin,041,260295,16977,16802,407,17209,242
2021-09-24,Mariposa,043,17540,970,906,33,939,5
2021-09-24,Mendocino,045,87422,6904,6657,354,7011,74
2021-09-24,Merced,047,269075,39076,38393,1458,39851,546
2021-09-24,Modoc,049,8938,480,460,166,626,5
2021-09-24,Mono,051,14174,1539,1501,20,1521,3
2021-09-24,Monterey,053,433212,47652,46653,2634,49287,567
2021-09-24,Napa,055,140530,12417,12266,90,12356,95
2021-09-24,Nevada,057,99092,8461,8285,289,8574,84
2021-09-24,Orange,059,3164182,298200,294514,14111,308625,5374
2021-09-24,Placer,061,380077,34447,33764,3257,37021,367
2021-09-24,Plumas,063,18699,1310,1238,26,1264,6
2021-09-24,Riverside,065,2383286,349511,343463,15990,359453,4843
2021-09-24,Sacramento,067,1510023,149430,147728,3922,151650,2049
2021-09-24,San Benito,069,59416,7031,6965,148,7113,67
2021-09-24,San Bernardino,071,2135413,341696,338413,10637,349050,5540
2021-09-24,San Diego,073,3302833,356216,352017,20765,372782,4039
2021-09-24,San Francisco,075,870044,50598,49840,2174,52014,615
2021-09-24,San Joaquin,077,732212,94809,93273,5110,98383,1628
2021-09-24,San Luis Obispo,079,281455,28107,27447,1106,28553,318
2021-09-24,San Mateo,081,765935,52309,51266,792,52058,568
2021-09-24,Santa Barbara,083,443738,42306,41728,1549,43277,505
2021-09-24,Santa Clara,085,1922200,141609,140023,1122,141145,1844
2021-09-24,Santa Cruz,087,273765,19519,19200,976,20176,214
2021-09-24,Shasta,089,179085,18940,18256,3131,21387,262
2021-09-24,Sierra,091,2930,133,127,13,140,0
2021-09-24,Siskiyou,093,43540,3104,2956,1116,4072,41
2021-09-24,Solano,095,438530,44249,43331,1152,44483,312
2021-09-24,Sonoma,097,501317,39505,39112,495,39607,369
2021-09-24,Stanislaus,099,539301,73110,72628,8260,80888,1091
2021-09-24,Sutter,101,95872,13166,12976,263,13239,154
2021-09-24,Tehama,103,63373,7472,7200,1230,8430,86
2021-09-24,Trinity,105,12862,760,576,201,777,9
2021-09-24,Tulare,107,460477,62841,60909,13037,73946,898
2021-09-24,Tuolumne,109,53932,6302,6168,73,6241,89
2021-09-24,Ventura,111,848112,95043,94059,4161,98220,1129
2021-09-24,Yolo,113,214977,18683,18393,975,19368,239
2021-09-24,Yuba,115,75493,9355,9191,216,9407,61
2021-09-23,Alameda,001,1643700,115116,114014,2654,116668,1324
2021-09-23,Alpine,003,1148,99,101,0,101,0
2021-09-23,Amador,005,37829,5066,4934,51,4985,59
2021-09-23,Butte,007,227075,18952,18396,3385,21781,236
2021-09-23,Calaveras,009,45235,3553,3461,41,3502,70
2021-09-23,Colusa,011,21464,2414,2387,554,2941,16
2021-09-23,Contra Costa,013,1133247,95403,94337,1972,96309,924
2021-09-23,Del Norte,015,27424,3526,3404,31,3435,35
2021-09-23,El Dorado,017,186661,14914,14641,1518,16159,130
2021-09-23,Fresno,019,978130,128675,126299,11504,137803,1927
2021-09-23,Glenn,021,27897,3238,3144,906,4050,25
2021-09-23,Humboldt,023,135768,8207,8014,423,8437,88
2021-09-23,Imperial,025,180216,31639,31280,3194,34474,755
2021-09-23,Inyo,027,18085,1715,1657,34,1691,39
2021-09-23,Kern,029,883053,118280,116021,18631,134652,1485
2021-09-23,Kings,031,150075,29390,28636,1681,30317,293
2021-09-23,Lake,033,64148,6199,6046,122,6168,92
2021-09-23,Lassen,035,31185,6397,6248,284,6532,25
2021-09-23,Los Angeles,037,10098052,1397435,1386417,52248,1438665,25964
2021-09-23,Madera,039,155013,20943,20432,1696,22128,262
2021-09-23,Marin,041,260295,16962,16802,406,17208,242
2021-09-23,Mariposa,043,17540,957,906,33,939,5
2021-09-23,Mendocino,045,87422,6882,6657,350,7007,74
2021-09-23,Merced,047,269075,38973,38393,1451,39844,546
2021-09-23,Modoc,049,8938,479,460,166,626,5
2021-09-23,Mono,051,14174,1536,1501,20,1521,3
2021-09-23,Monterey,053,433212,47603,46653,2621,49274,567
2021-09-23,Napa,055,140530,12400,12266,90,12356,95
2021-09-23,Nevada,057,99092,8434,8285,289,8574,84
2021-09-23,Orange,059,3164182,297903,294514,14087,308601,5374
2021-09-23,Placer,061,380077,34371,33764,3250,37014,367
2021-09-23,Plumas,063,18699,1293,1238,25,1263,6
2021-09-23,Riverside,065,2383286,349058,343463,15983,359446,4843
2021-09-23,Sacramento,067,1510023,149101,147728,3902,151630,2049
2021-09-23,San Benito,069,59416,7020,6965,148,7113,67
2021-09-23,San Bernardino,071,2135413,341334,338413,10621,349034,5540
2021-09-23,San Diego,073,3302833,355752,352017,20726,372743,4039
2021-09-23,San Francisco,075,870044,50525,49840,2172,52012,615
2021-09-23,San Joaquin,077,732212,94637,93273,5095,98368,1628
2021-09-23,San Luis Obispo,079,281455,28064,27447,1104,28551,318
2021-09-23,San Mateo,081,765935,52234,51266,791,52057,568
2021-09-23,Santa Barbara,083,443738,42228,41728,1546,43274,505
2021-09-23,Santa Clara,085,1922200,141459,140023,1115,141138,1844
2021-09-23,Santa Cruz,087,273765,19488,19200,976,20176,214
2021-09-23,Shasta,089,179085,18860,18256,3114,21370,262
2021-09-23,Sierra,091,2930,133,127,13,140,0
2021-09-23,Siskiyou,093,43540,3100,2956,1105,4061,41
2021-09-23,Solano,095,438530,44181,43331,1149,44480,312
2021-09-23,Sonoma,097,501317,39446,39112,492,39604,369
2021-09-23,Stanislaus,099,539301,72955,72628,8228,80856,1091
2021-09-23,Sutter,101,95872,13137,12976,263,13239,154
2021-09-23,Tehama,103,63373,7431,7200,1225,8425,86
2021-09-23,Trinity,105,12862,746,576,200,776,9
2021-09-23,Tulare,107,460477,62664,60909,12982,73891,898
2021-09-23,Tuolumne,109,53932,6277,6168,72,6240,89
2021-09-23,Ventura,111,848112,94940,94059,4154,98213,1129
2021-09-23,Yolo,113,214977,18652,18393,970,19363,239
2021-09-23,Yuba,115,75493,9327,9191,215,9406,61
2021-09-22,Alameda,001,1643700,114960,113862,2650,116512,1322
2021-09-22,Alpine,003,1148,99,100,0,100,0
2021-09-22,Amador,005,37829,5050,4915,51,4966,59
2021-09-22,Butte,007,227075,18893,18337,3370,21707,235
2021-09-22,Calaveras,009,45235,3537,3448,41,3489,70
2021-09-22,Colusa,011,21464,2409,2384,553,2937,16
2021-09-22,Contra Costa,013,1133247,95218,94209,1964,96173,924
2021-09-22,Del Norte,015,27424,3515,3386,30,3416,35
2021-09-22,El Dorado,017,186661,14878,14605,1511,16116,127
2021-09-22,Fresno,019,978130,128418,126006,11492,137498,1908
2021-09-22,Glenn,021,27897,3233,3138,905,4043,25
2021-09-22,Humboldt,023,135768,8184,7998,415,8413,80
2021-09-22,Imperial,025,180216,31587,31243,3187,34430,755
2021-09-22,Inyo,027,18085,1705,1651,34,1685,39
2021-09-22,Kern,029,883053,118039,115757,18509,134266,1477
2021-09-22,Kings,031,150075,29306,28589,1675,30264,292
2021-09-22,Lake,033,64148,6187,6035,122,6157,93
2021-09-22,Lassen,035,31185,6377,6209,280,6489,25
2021-09-22,Los Angeles,037,10098052,1396111,1384719,52192,1436911,25930
2021-09-22,Madera,039,155013,20886,20382,1688,22070,262
2021-09-22,Marin,041,260295,16952,16782,403,17185,242
2021-09-22,Mariposa,043,17540,951,901,33,934,5
2021-09-22,Mendocino,045,87422,6855,6624,344,6968,70
2021-09-22,Merced,047,269075,38841,38305,1449,39754,541
2021-09-22,Modoc,049,8938,476,458,166,624,5
2021-09-22,Mono,051,14174,1527,1496,19,1515,3
2021-09-22,Monterey,053,433212,47552,46615,2614,49229,566
2021-09-22,Napa,055,140530,12377,12248,89,12337,95
2021-09-22,Nevada,057,99092,8411,8273,286,8559,84
2021-09-22,Orange,059,3164182,297628,294214,14070,308284,5366
2021-09-22,Placer,061,380077,34284,33661,3237,36898,367
2021-09-22,Plumas,063,18699,1281,1230,25,1255,6
2021-09-22,Riverside,065,2383286,348523,342946,15958,358904,4830
2021-09-22,Sacramento,067,1510023,148788,147533,3871,151404,2043
2021-09-22,San Benito,069,59416,7009,6961,146,7107,67
2021-09-22,San Bernardino,071,2135413,340939,337938,10612,348550,5528
2021-09-22,San Diego,073,3302833,355292,351132,20704,371836,4027
2021-09-22,San Francisco,075,870044,50440,49734,2167,51901,610
2021-09-22,San Joaquin,077,732212,94405,93010,5069,98079,1626
2021-09-22,San Luis Obispo,079,281455,28016,27398,1101,28499,315
2021-09-22,San Mateo,081,765935,52161,51197,787,51984,568
2021-09-22,Santa Barbara,083,443738,42165,41678,1545,43223,504
2021-09-22,Santa Clara,085,1922200,141296,139803,1108,140911,1844
2021-09-22,Santa Cruz,087,273765,19449,19177,976,20153,214
2021-09-22,Shasta,089,179085,18770,18153,3102,21255,260
2021-09-22,Sierra,091,2930,133,127,13,140,0
2021-09-22,Siskiyou,093,43540,3083,2947,1095,4042,41
2021-09-22,Solano,095,438530,44116,43269,1148,44417,312
2021-09-22,Sonoma,097,501317,39393,39063,491,39554,369
2021-09-22,Stanislaus,099,539301,72789,72355,8209,80564,1091
2021-09-22,Sutter,101,95872,13117,12960,260,13220,153
2021-09-22,Tehama,103,63373,7404,7173,1222,8395,86
2021-09-22,Trinity,105,12862,745,572,200,772,9
2021-09-22,Tulare,107,460477,62455,60776,12911,73687,896
2021-09-22,Tuolumne,109,53932,6256,6155,71,6226,89
2021-09-22,Ventura,111,848112,94835,93978,4148,98126,1122
2021-09-22,Yolo,113,214977,18613,18342,963,19305,239
2021-09-22,Yuba,115,75493,9298,9169,210,9379,61
2021-09-21,Alameda,001,1643700,114804,113765,2650,116415,1321
2021-09-21,Alpine,003,1148,99,100,0,100,0
2021-09-21,Amador,005,37829,5028,4897,51,4948,59
2021-09-21,Butte,007,227075,18797,18229,3333,21562,232
2021-09-21,Calaveras,009,45235,3519,3437,41,3478,70
2021-09-21,Colusa,011,21464,2406,2378,552,2930,16
2021-09-21,Contra Costa,013,1133247,95024,94101,1950,96051,924
2021-09-21,Del Norte,015,27424,3502,3378,30,3408,34
2021-09-21,El Dorado,017,186661,14848,14578,1504,16082,127
2021-09-21,Fresno,019,978130,128068,125789,11474,137263,1892
2021-09-21,Glenn,021,27897,3226,3134,900,4034,25
2021-09-21,Humboldt,023,135768,8152,7955,410,8365,80
2021-09-21,Imperial,025,180216,31530,31185,3185,34370,755
2021-09-21,Inyo,027,18085,1695,1646,34,1680,39
2021-09-21,Kern,029,883053,117746,115534,18395,133929,1467
2021-09-21,Kings,031,150075,29218,28545,1667,30212,291
2021-09-21,Lake,033,64148,6164,6013,122,6135,90
2021-09-21,Lassen,035,31185,6359,6159,276,6435,25
2021-09-21,Los Angeles,037,10098052,1394655,1383277,52136,1435413,25893
2021-09-21,Madera,039,155013,20826,20317,1677,21994,262
2021-09-21,Marin,041,260295,16937,16748,402,17150,242
2021-09-21,Mariposa,043,17540,946,894,32,926,5
2021-09-21,Mendocino,045,87422,6817,6580,333,6913,68
2021-09-21,Merced,047,269075,38720,38225,1445,39670,539
2021-09-21,Modoc,049,8938,473,458,166,624,5
2021-09-21,Mono,051,14174,1525,1495,18,1513,3
2021-09-21,Monterey,053,433212,47484,46583,2602,49185,565
2021-09-21,Napa,055,140530,12356,12238,89,12327,95
2021-09-21,Nevada,057,99092,8384,8259,277,8536,84
2021-09-21,Orange,059,3164182,297297,293898,14040,307938,5357
2021-09-21,Placer,061,380077,34183,33609,3226,36835,365
2021-09-21,Plumas,063,18699,1274,1225,25,1250,5
2021-09-21,Riverside,065,2383286,347963,342460,15934,358394,4817
2021-09-21,Sacramento,067,1510023,148406,147378,3843,151221,2027
2021-09-21,San Benito,069,59416,6998,6950,145,7095,67
2021-09-21,San Bernardino,071,2135413,340499,337387,10595,347982,5520
2021-09-21,San Diego,073,3302833,354675,350265,20680,370945,4021
2021-09-21,San Francisco,075,870044,50344,49653,2164,51817,609
2021-09-21,San Joaquin,077,732212,94171,92762,5058,97820,1621
2021-09-21,San Luis Obispo,079,281455,27957,27318,1097,28415,314
2021-09-21,San Mateo,081,765935,52091,51136,787,51923,568
2021-09-21,Santa Barbara,083,443738,42096,41644,1541,43185,503
2021-09-21,Santa Clara,085,1922200,141079,139657,1104,140761,1843
2021-09-21,Santa Cruz,087,273765,19419,19140,975,20115,212
2021-09-21,Shasta,089,179085,18642,18027,3078,21105,258
2021-09-21,Sierra,091,2930,133,127,13,140,0
2021-09-21,Siskiyou,093,43540,3069,2927,1081,4008,36
2021-09-21,Solano,095,438530,44040,43220,1148,44368,311
2021-09-21,Sonoma,097,501317,39340,39042,491,39533,369
2021-09-21,Stanislaus,099,539301,72605,72211,8187,80398,1091
2021-09-21,Sutter,101,95872,13094,12930,257,13187,153
2021-09-21,Tehama,103,63373,7358,7151,1218,8369,85
2021-09-21,Trinity,105,12862,734,572,198,770,9
2021-09-21,Tulare,107,460477,62241,60607,12850,73457,896
2021-09-21,Tuolumne,109,53932,6224,6139,71,6210,89
2021-09-21,Ventura,111,848112,94730,93818,4140,97958,1120
2021-09-21,Yolo,113,214977,18577,18313,959,19272,239
2021-09-21,Yuba,115,75493,9270,9135,210,9345,61
2021-09-20,Alameda,001,1643700,114621,113637,2646,116283,1320
2021-09-20,Alpine,003,1148,99,100,0,100,0
2021-09-20,Amador,005,37829,5010,4883,50,4933,59
2021-09-20,Butte,007,227075,18715,18135,3317,21452,231
2021-09-20,Calaveras,009,45235,3498,3395,40,3435,66
2021-09-20,Colusa,011,21464,2404,2376,549,2925,16
2021-09-20,Contra Costa,013,1133247,94874,93919,1944,95863,924
2021-09-20,Del Norte,015,27424,3494,3374,29,3403,34
2021-09-20,El Dorado,017,186661,14815,14545,1492,16037,127
2021-09-20,Fresno,019,978130,127656,125287,11453,136740,1889
2021-09-20,Glenn,021,27897,3214,3112,898,4010,25
2021-09-20,Humboldt,023,135768,8116,7938,405,8343,80
2021-09-20,Imperial,025,180216,31448,31146,3184,34330,755
2021-09-20,Inyo,027,18085,1687,1641,33,1674,39
2021-09-20,Kern,029,883053,117406,115271,18263,133534,1459
2021-09-20,Kings,031,150075,29131,28471,1661,30132,285
2021-09-20,Lake,033,64148,6149,5984,121,6105,87
2021-09-20,Lassen,035,31185,6329,6132,276,6408,25
2021-09-20,Los Angeles,037,10098052,1393134,1382206,52056,1434262,25858
2021-09-20,Madera,039,155013,20773,20203,1669,21872,257
2021-09-20,Marin,041,260295,16912,16732,400,17132,242
2021-09-20,Mariposa,043,17540,935,887,32,919,5
2021-09-20,Mendocino,045,87422,6783,6568,327,6895,67
2021-09-20,Merced,047,269075,38609,38144,1435,39579,536
2021-09-20,Modoc,049,8938,472,457,164,621,5
2021-09-20,Mono,051,14174,1519,1480,18,1498,3
2021-09-20,Monterey,053,433212,47442,46506,2585,49091,565
2021-09-20,Napa,055,140530,12331,12209,88,12297,95
2021-09-20,Nevada,057,99092,8364,8228,275,8503,84
2021-09-20,Orange,059,3164182,296954,293642,14013,307655,5354
2021-09-20,Placer,061,380077,34092,33531,3211,36742,364
2021-09-20,Plumas,063,18699,1269,1211,25,1236,5
2021-09-20,Riverside,065,2383286,347463,341961,15921,357882,4802
2021-09-20,Sacramento,067,1510023,148032,147016,3809,150825,2016
2021-09-20,San Benito,069,59416,6989,6947,144,7091,67
2021-09-20,San Bernardino,071,2135413,340106,337059,10579,347638,5507
2021-09-20,San Diego,073,3302833,353995,349579,20643,370222,4009
2021-09-20,San Francisco,075,870044,50237,49559,2163,51722,605
2021-09-20,San Joaquin,077,732212,93928,92614,5045,97659,1615
2021-09-20,San Luis Obispo,079,281455,27881,27259,1089,28348,313
2021-09-20,San Mateo,081,765935,52005,51100,784,51884,567
2021-09-20,Santa Barbara,083,443738,41997,41589,1537,43126,500
2021-09-20,Santa Clara,085,1922200,140878,139578,1102,140680,1841
2021-09-20,Santa Cruz,087,273765,19387,19121,975,20096,211
2021-09-20,Shasta,089,179085,18543,17893,3047,20940,258
2021-09-20,Sierra,091,2930,131,126,13,139,0
2021-09-20,Siskiyou,093,43540,3047,2902,1068,3970,35
2021-09-20,Solano,095,438530,43972,43152,1140,44292,312
2021-09-20,Sonoma,097,501317,39295,38991,491,39482,369
2021-09-20,Stanislaus,099,539301,72406,72031,8168,80199,1091
2021-09-20,Sutter,101,95872,13058,12896,252,13148,153
2021-09-20,Tehama,103,63373,7326,7121,1206,8327,84
2021-09-20,Trinity,105,12862,728,568,197,765,7
2021-09-20,Tulare,107,460477,62040,60302,12794,73096,896
2021-09-20,Tuolumne,109,53932,6198,6113,71,6184,89
2021-09-20,Ventura,111,848112,94617,93700,4133,97833,1120
2021-09-20,Yolo,113,214977,18531,18287,957,19244,239
2021-09-20,Yuba,115,75493,9234,9107,208,9315,61
2021-09-19,Alameda,001,1643700,114405,113446,2641,116087,1320
2021-09-19,Alpine,003,1148,99,100,0,100,0
2021-09-19,Amador,005,37829,4970,4875,49,4924,59
2021-09-19,Butte,007,227075,18622,18063,3290,21353,230
2021-09-19,Calaveras,009,45235,3472,3390,37,3427,66
2021-09-19,Colusa,011,21464,2402,2375,547,2922,16
2021-09-19,Contra Costa,013,1133247,94690,93788,1934,95722,924
2021-09-19,Del Norte,015,27424,3468,3344,28,3372,34
2021-09-19,El Dorado,017,186661,14762,14512,1486,15998,127
2021-09-19,Fresno,019,978130,127252,124985,11416,136401,1888
2021-09-19,Glenn,021,27897,3205,3102,893,3995,25
2021-09-19,Humboldt,023,135768,8071,7914,403,8317,80
2021-09-19,Imperial,025,180216,31379,31122,3181,34303,755
2021-09-19,Inyo,027,18085,1678,1639,33,1672,39
2021-09-19,Kern,029,883053,117093,115074,18157,133231,1459
2021-09-19,Kings,031,150075,29003,28416,1652,30068,284
2021-09-19,Lake,033,64148,6118,5962,121,6083,87
2021-09-19,Lassen,035,31185,6309,6129,270,6399,25
2021-09-19,Los Angeles,037,10098052,1391161,1381200,51957,1433157,25852
2021-09-19,Madera,039,155013,20694,20161,1659,21820,257
2021-09-19,Marin,041,260295,16883,16711,398,17109,242
2021-09-19,Mariposa,043,17540,927,881,32,913,5
2021-09-19,Mendocino,045,87422,6738,6538,321,6859,67
2021-09-19,Merced,047,269075,38452,38068,1427,39495,535
2021-09-19,Modoc,049,8938,469,457,162,619,5
2021-09-19,Mono,051,14174,1514,1480,18,1498,3
2021-09-19,Monterey,053,433212,47387,46486,2582,49068,565
2021-09-19,Napa,055,140530,12310,12190,86,12276,95
2021-09-19,Nevada,057,99092,8336,8203,273,8476,84
2021-09-19,Orange,059,3164182,296586,293258,13991,307249,5354
2021-09-19,Placer,061,380077,33979,33406,3193,36599,364
2021-09-19,Plumas,063,18699,1261,1211,25,1236,5
2021-09-19,Riverside,065,2383286,346870,341566,15912,357478,4804
2021-09-19,Sacramento,067,1510023,147672,146603,3764,150367,2012
2021-09-19,San Benito,069,59416,6970,6942,144,7086,67
2021-09-19,San Bernardino,071,2135413,339615,336688,10568,347256,5506
2021-09-19,San Diego,073,3302833,353278,349225,20607,369832,4006
2021-09-19,San Francisco,075,870044,50129,49458,2155,51613,605
2021-09-19,San Joaquin,077,732212,93632,92467,5034,97501,1615
2021-09-19,San Luis Obispo,079,281455,27779,27208,1080,28288,313
2021-09-19,San Mateo,081,765935,51906,51028,783,51811,567
2021-09-19,Santa Barbara,083,443738,41892,41512,1537,43049,500
2021-09-19,Santa Clara,085,1922200,140691,139410,1097,140507,1841
2021-09-19,Santa Cruz,087,273765,19349,19096,975,20071,211
2021-09-19,Shasta,089,179085,18429,17813,3011,20824,258
2021-09-19,Sierra,091,2930,130,126,13,139,0
2021-09-19,Siskiyou,093,43540,3021,2882,1059,3941,35
2021-09-19,Solano,095,438530,43883,43056,1135,44191,312
2021-09-19,Sonoma,097,501317,39223,38956,487,39443,369
2021-09-19,Stanislaus,099,539301,72163,71830,8144,79974,1091
2021-09-19,Sutter,101,95872,13031,12868,245,13113,153
2021-09-19,Tehama,103,63373,7272,7081,1196,8277,84
2021-09-19,Trinity,105,12862,717,562,195,757,7
2021-09-19,Tulare,107,460477,61779,60160,12701,72861,896
2021-09-19,Tuolumne,109,53932,6156,6097,71,6168,89
2021-09-19,Ventura,111,848112,94455,93491,4124,97615,1120
2021-09-19,Yolo,113,214977,18482,18238,951,19189,239
2021-09-19,Yuba,115,75493,9208,9087,207,9294,61
2021-09-18,Alameda,001,1643700,114305,113300,2640,115940,1320
2021-09-18,Alpine,003,1148,99,100,0,100,0
2021-09-18,Amador,005,37829,4960,4850,49,4899,59
2021-09-18,Butte,007,227075,18585,17961,3276,21237,230
2021-09-18,Calaveras,009,45235,3465,3361,36,3397,66
2021-09-18,Colusa,011,21464,2402,2373,546,2919,16
2021-09-18,Contra Costa,013,1133247,94599,93656,1930,95586,924
2021-09-18,Del Norte,015,27424,3460,3326,26,3352,34
2021-09-18,El Dorado,017,186661,14739,14472,1483,15955,127
2021-09-18,Fresno,019,978130,127110,124771,11398,136169,1889
2021-09-18,Glenn,021,27897,3197,3086,890,3976,25
2021-09-18,Humboldt,023,135768,8057,7881,402,8283,80
2021-09-18,Imperial,025,180216,31355,31096,3180,34276,755
2021-09-18,Inyo,027,18085,1672,1636,33,1669,39
2021-09-18,Kern,029,883053,116939,114781,18093,132874,1459
2021-09-18,Kings,031,150075,28955,28330,1647,29977,285
2021-09-18,Lake,033,64148,6101,5936,121,6057,87
2021-09-18,Lassen,035,31185,6299,6121,268,6389,25
2021-09-18,Los Angeles,037,10098052,1390403,1379880,51905,1431785,25849
2021-09-18,Madera,039,155013,20650,20126,1649,21775,257
2021-09-18,Marin,041,260295,16866,16685,397,17082,242
2021-09-18,Mariposa,043,17540,924,871,32,903,5
2021-09-18,Mendocino,045,87422,6717,6523,321,6844,67
2021-09-18,Merced,047,269075,38415,37977,1421,39398,535
2021-09-18,Modoc,049,8938,469,457,161,618,5
2021-09-18,Mono,051,14174,1511,1480,18,1498,3
2021-09-18,Monterey,053,433212,47349,46466,2579,49045,565
2021-09-18,Napa,055,140530,12298,12168,86,12254,95
2021-09-18,Nevada,057,99092,8319,8183,273,8456,84
2021-09-18,Orange,059,3164182,296391,293005,13977,306982,5354
2021-09-18,Placer,061,380077,33907,33309,3190,36499,364
2021-09-18,Plumas,063,18699,1260,1204,25,1229,5
2021-09-18,Riverside,065,2383286,346485,341136,15897,357033,4802
2021-09-18,Sacramento,067,1510023,147490,146162,3755,149917,2016
2021-09-18,San Benito,069,59416,6965,6937,144,7081,67
2021-09-18,San Bernardino,071,2135413,339343,336380,10555,346935,5501
2021-09-18,San Diego,073,3302833,352881,348848,20597,369445,4006
2021-09-18,San Francisco,075,870044,50066,49359,2150,51509,605
2021-09-18,San Joaquin,077,732212,93523,92242,5022,97264,1615
2021-09-18,San Luis Obispo,079,281455,27742,27181,1077,28258,313
2021-09-18,San Mateo,081,765935,51855,50961,781,51742,567
2021-09-18,Santa Barbara,083,443738,41827,41465,1537,43002,500
2021-09-18,Santa Clara,085,1922200,140571,139233,1094,140327,1841
2021-09-18,Santa Cruz,087,273765,19329,19079,975,20054,211
2021-09-18,Shasta,089,179085,18366,17777,2994,20771,258
2021-09-18,Sierra,091,2930,129,125,13,138,0
2021-09-18,Siskiyou,093,43540,3018,2875,1053,3928,35
2021-09-18,Solano,095,438530,43843,42966,1132,44098,312
2021-09-18,Sonoma,097,501317,39188,38891,485,39376,369
2021-09-18,Stanislaus,099,539301,72018,71587,8119,79706,1091
2021-09-18,Sutter,101,95872,13017,12829,245,13074,153
2021-09-18,Tehama,103,63373,7257,7055,1189,8244,84
2021-09-18,Trinity,105,12862,715,561,195,756,7
2021-09-18,Tulare,107,460477,61703,60003,12649,72652,896
2021-09-18,Tuolumne,109,53932,6141,6069,71,6140,89
2021-09-18,Ventura,111,848112,94387,93424,4119,97543,1120
2021-09-18,Yolo,113,214977,18456,18213,945,19158,239
2021-09-18,Yuba,115,75493,9194,9061,206,9267,61
2021-09-17,Alameda,001,1643700,114179,113070,2638,115708,1320
2021-09-17,Alpine,003,1148,99,99,0,99,0
2021-09-17,Amador,005,37829,4944,4835,48,4883,58
2021-09-17,Butte,007,227075,18534,17870,3267,21137,230
2021-09-17,Calaveras,009,45235,3453,3338,35,3373,66
2021-09-17,Colusa,011,21464,2401,2369,541,2910,16
2021-09-17,Contra Costa,013,1133247,94497,93485,1927,95412,924
2021-09-17,Del Norte,015,27424,3455,3311,24,3335,34
2021-09-17,El Dorado,017,186661,14720,14421,1481,15902,127
2021-09-17,Fresno,019,978130,126891,124296,11385,135681,1882
2021-09-17,Glenn,021,27897,3180,3072,888,3960,25
2021-09-17,Humboldt,023,135768,8036,7850,402,8252,80
2021-09-17,Imperial,025,180216,31329,31031,3178,34209,755
2021-09-17,Inyo,027,18085,1664,1634,33,1667,39
2021-09-17,Kern,029,883053,116748,114303,17996,132299,1456
2021-09-17,Kings,031,150075,28890,28240,1645,29885,281
2021-09-17,Lake,033,64148,6088,5915,121,6036,87
2021-09-17,Lassen,035,31185,6284,6080,266,6346,25
2021-09-17,Los Angeles,037,10098052,1389427,1377905,51838,1429743,25820
2021-09-17,Madera,039,155013,20598,20040,1637,21677,257
2021-09-17,Marin,041,260295,16853,16658,395,17053,242
2021-09-17,Mariposa,043,17540,922,869,32,901,5
2021-09-17,Mendocino,045,87422,6698,6498,321,6819,67
2021-09-17,Merced,047,269075,38368,37803,1419,39222,533
2021-09-17,Modoc,049,8938,469,456,161,617,5
2021-09-17,Mono,051,14174,1507,1457,18,1475,3
2021-09-17,Monterey,053,433212,47326,46421,2578,48999,564
2021-09-17,Napa,055,140530,12277,12153,86,12239,95
2021-09-17,Nevada,057,99092,8304,8157,273,8430,84
2021-09-17,Orange,059,3164182,296172,292685,13959,306644,5346
2021-09-17,Placer,061,380077,33846,33188,3180,36368,362
2021-09-17,Plumas,063,18699,1251,1192,24,1216,5
2021-09-17,Riverside,065,2383286,346084,340445,15886,356331,4792
2021-09-17,Sacramento,067,1510023,147291,145985,3744,149729,1999
2021-09-17,San Benito,069,59416,6962,6929,144,7073,67
2021-09-17,San Bernardino,071,2135413,338987,335810,10548,346358,5488
2021-09-17,San Diego,073,3302833,352446,348098,20579,368677,4002
2021-09-17,San Francisco,075,870044,50014,49249,2145,51394,605
2021-09-17,San Joaquin,077,732212,93385,91977,5011,96988,1610
2021-09-17,San Luis Obispo,079,281455,27708,27102,1066,28168,311
2021-09-17,San Mateo,081,765935,51801,50854,780,51634,564
2021-09-17,Santa Barbara,083,443738,41764,41354,1536,42890,498
2021-09-17,Santa Clara,085,1922200,140422,138939,1093,140032,1838
2021-09-17,Santa Cruz,087,273765,19304,19039,975,20014,211
2021-09-17,Shasta,089,179085,18295,17617,2981,20598,254
2021-09-17,Sierra,091,2930,129,124,13,137,0
2021-09-17,Siskiyou,093,43540,3003,2852,1053,3905,35
2021-09-17,Solano,095,438530,43780,42898,1128,44026,312
2021-09-17,Sonoma,097,501317,39151,38808,484,39292,369
2021-09-17,Stanislaus,099,539301,71911,71408,8101,79509,1091
2021-09-17,Sutter,101,95872,13001,12799,242,13041,153
2021-09-17,Tehama,103,63373,7233,7020,1177,8197,84
2021-09-17,Trinity,105,12862,710,556,194,750,7
2021-09-17,Tulare,107,460477,61588,59689,12615,72304,895
2021-09-17,Tuolumne,109,53932,6122,6047,71,6118,89
2021-09-17,Ventura,111,848112,94275,93273,4117,97390,1116
2021-09-17,Yolo,113,214977,18425,18177,941,19118,239
2021-09-17,Yuba,115,75493,9167,9019,205,9224,61
2021-09-16,Alameda,001,1643700,114000,112770,2635,115405,1318
2021-09-16,Alpine,003,1148,99,99,0,99,0
2021-09-16,Amador,005,37829,4924,4819,48,4867,58
2021-09-16,Butte,007,227075,18460,17750,3251,21001,230
2021-09-16,Calaveras,009,45235,3418,3313,35,3348,66
2021-09-16,Colusa,011,21464,2399,2363,539,2902,16
2021-09-16,Contra Costa,013,1133247,94327,93213,1919,95132,917
2021-09-16,Del Norte,015,27424,3437,3285,24,3309,34
2021-09-16,El Dorado,017,186661,14680,14372,1473,15845,127
2021-09-16,Fresno,019,978130,126535,123853,11344,135197,1868
2021-09-16,Glenn,021,27897,3169,3068,886,3954,24
2021-09-16,Humboldt,023,135768,8002,7809,392,8201,80
2021-09-16,Imperial,025,180216,31286,30966,3170,34136,753
2021-09-16,Inyo,027,18085,1662,1623,33,1656,39
2021-09-16,Kern,029,883053,116477,113828,17928,131756,1448
2021-09-16,Kings,031,150075,28804,28114,1636,29750,280
2021-09-16,Lake,033,64148,6064,5890,118,6008,87
2021-09-16,Lassen,035,31185,6249,6028,261,6289,25
2021-09-16,Los Angeles,037,10098052,1388038,1376277,51772,1428049,25796
2021-09-16,Madera,039,155013,20520,19974,1631,21605,257
2021-09-16,Marin,041,260295,16826,16625,394,17019,242
2021-09-16,Mariposa,043,17540,916,849,32,881,6
2021-09-16,Mendocino,045,87422,6660,6445,312,6757,67
2021-09-16,Merced,047,269075,38261,37675,1416,39091,532
2021-09-16,Modoc,049,8938,467,455,161,616,5
2021-09-16,Mono,051,14174,1501,1449,18,1467,3
2021-09-16,Monterey,053,433212,47272,46342,2572,48914,562
2021-09-16,Napa,055,140530,12252,12115,82,12197,95
2021-09-16,Nevada,057,99092,8276,8121,272,8393,84
2021-09-16,Orange,059,3164182,295826,292183,13939,306122,5340
2021-09-16,Placer,061,380077,33750,33037,3161,36198,354
2021-09-16,Plumas,063,18699,1243,1178,24,1202,5
2021-09-16,Riverside,065,2383286,345552,339770,15872,355642,4786
2021-09-16,Sacramento,067,1510023,146935,145754,3712,149466,1996
2021-09-16,San Benito,069,59416,6949,6913,143,7056,67
2021-09-16,San Bernardino,071,2135413,338561,335129,10541,345670,5474
2021-09-16,San Diego,073,3302833,351821,347472,20544,368016,3994
2021-09-16,San Francisco,075,870044,49929,49133,2136,51269,605
2021-09-16,San Joaquin,077,732212,93146,91650,4966,96616,1608
2021-09-16,San Luis Obispo,079,281455,27634,27044,1062,28106,310
2021-09-16,San Mateo,081,765935,51722,50773,778,51551,564
2021-09-16,Santa Barbara,083,443738,41697,41272,1533,42805,497
2021-09-16,Santa Clara,085,1922200,140267,138685,1089,139774,1835
2021-09-16,Santa Cruz,087,273765,19276,19011,975,19986,211
2021-09-16,Shasta,089,179085,18170,17438,2947,20385,251
2021-09-16,Sierra,091,2930,129,123,13,136,0
2021-09-16,Siskiyou,093,43540,2983,2819,1046,3865,35
2021-09-16,Solano,095,438530,43708,42792,1119,43911,312
2021-09-16,Sonoma,097,501317,39088,38707,483,39190,369
2021-09-16,Stanislaus,099,539301,71678,71105,8085,79190,1091
2021-09-16,Sutter,101,95872,12957,12729,236,12965,152
2021-09-16,Tehama,103,63373,7194,6953,1166,8119,83
2021-09-16,Trinity,105,12862,707,547,193,740,7
2021-09-16,Tulare,107,460477,61366,59459,12541,72000,894
2021-09-16,Tuolumne,109,53932,6102,5999,70,6069,89
2021-09-16,Ventura,111,848112,94136,93087,4113,97200,1110
2021-09-16,Yolo,113,214977,18393,18135,939,19074,239
2021-09-16,Yuba,115,75493,9133,8981,202,9183,61
2021-09-15,Alameda,001,1643700,113828,112498,2627,115125,1317
2021-09-15,Alpine,003,1148,99,99,0,99,0
2021-09-15,Amador,005,37829,4916,4792,48,4840,58
2021-09-15,Butte,007,227075,18362,17664,3232,20896,228
2021-09-15,Calaveras,009,45235,3386,3293,33,3326,66
2021-09-15,Colusa,011,21464,2397,2352,536,2888,16
2021-09-15,Contra Costa,013,1133247,94147,92989,1907,94896,913
2021-09-15,Del Norte,015,27424,3424,3271,22,3293,34
2021-09-15,El Dorado,017,186661,14654,14309,1465,15774,127
2021-09-15,Fresno,019,978130,126158,123370,11297,134667,1867
2021-09-15,Glenn,021,27897,3157,3051,881,3932,20
2021-09-15,Humboldt,023,135768,7967,7754,387,8141,52
2021-09-15,Imperial,025,180216,31231,30891,3165,34056,753
2021-09-15,Inyo,027,18085,1658,1614,33,1647,39
2021-09-15,Kern,029,883053,116130,113546,17829,131375,1434
2021-09-15,Kings,031,150075,28725,27991,1627,29618,279
2021-09-15,Lake,033,64148,6032,5852,117,5969,85
2021-09-15,Lassen,035,31185,6189,6018,256,6274,25
2021-09-15,Los Angeles,037,10098052,1386539,1374307,51703,1426010,25767
2021-09-15,Madera,039,155013,20445,19880,1623,21503,257
2021-09-15,Marin,041,260295,16791,16592,389,16981,242
2021-09-15,Mariposa,043,17540,904,843,32,875,5
2021-09-15,Mendocino,045,87422,6630,6399,307,6706,66
2021-09-15,Merced,047,269075,38153,37508,1414,38922,529
2021-09-15,Modoc,049,8938,467,454,161,615,5
2021-09-15,Mono,051,14174,1495,1445,18,1463,3
2021-09-15,Monterey,053,433212,47202,46317,2560,48877,562
2021-09-15,Napa,055,140530,12231,12082,82,12164,95
2021-09-15,Nevada,057,99092,8254,8081,269,8350,84
2021-09-15,Orange,059,3164182,295504,291834,13920,305754,5328
2021-09-15,Placer,061,380077,33638,32860,3140,36000,352
2021-09-15,Plumas,063,18699,1238,1164,23,1187,5
2021-09-15,Riverside,065,2383286,344969,339077,15848,354925,4769
2021-09-15,Sacramento,067,1510023,146508,145202,3681,148883,1981
2021-09-15,San Benito,069,59416,6946,6902,143,7045,67
2021-09-15,San Bernardino,071,2135413,338103,334556,10527,345083,5470
2021-09-15,San Diego,073,3302833,351193,346933,20518,367451,3983
2021-09-15,San Francisco,075,870044,49818,48999,2131,51130,605
2021-09-15,San Joaquin,077,732212,92869,91322,4923,96245,1607
2021-09-15,San Luis Obispo,079,281455,27551,26943,1056,27999,306
2021-09-15,San Mateo,081,765935,51640,50691,775,51466,564
2021-09-15,Santa Barbara,083,443738,41594,41077,1528,42605,497
2021-09-15,Santa Clara,085,1922200,140094,138410,1084,139494,1833
2021-09-15,Santa Cruz,087,273765,19238,18984,973,19957,210
2021-09-15,Shasta,089,179085,18059,17317,2926,20243,250
2021-09-15,Sierra,091,2930,129,123,13,136,0
2021-09-15,Siskiyou,093,43540,2963,2804,1015,3819,35
2021-09-15,Solano,095,438530,43636,42682,1114,43796,312
2021-09-15,Sonoma,097,501317,39029,38629,482,39111,369
2021-09-15,Stanislaus,099,539301,71456,70852,8064,78916,1091
2021-09-15,Sutter,101,95872,12924,12699,231,12930,151
2021-09-15,Tehama,103,63373,7153,6894,1157,8051,79
2021-09-15,Trinity,105,12862,705,541,191,732,7
2021-09-15,Tulare,107,460477,61107,59149,12480,71629,890
2021-09-15,Tuolumne,109,53932,6076,5969,70,6039,89
2021-09-15,Ventura,111,848112,93995,92960,4106,97066,1109
2021-09-15,Yolo,113,214977,18359,18064,931,18995,239
2021-09-15,Yuba,115,75493,9099,8953,202,9155,61
2021-09-14,Alameda,001,1643700,113619,112329,2622,114951,1316
2021-09-14,Alpine,003,1148,99,98,0,98,0
2021-09-14,Amador,005,37829,4896,4790,48,4838,57
2021-09-14,Butte,007,227075,18230,17516,3208,20724,226
2021-09-14,Calaveras,009,45235,3363,3280,30,3310,66
2021-09-14,Colusa,011,21464,2393,2344,532,2876,16
2021-09-14,Contra Costa,013,1133247,93948,92822,1899,94721,908
2021-09-14,Del Norte,015,27424,3408,3252,21,3273,32
2021-09-14,El Dorado,017,186661,14602,14247,1457,15704,123
2021-09-14,Fresno,019,978130,125683,123151,11249,134400,1856
2021-09-14,Glenn,021,27897,3139,3045,876,3921,20
2021-09-14,Humboldt,023,135768,7933,7717,382,8099,52
2021-09-14,Imperial,025,180216,31181,30845,3162,34007,752
2021-09-14,Inyo,027,18085,1649,1605,32,1637,39
2021-09-14,Kern,029,883053,115750,113250,17703,130953,1428
2021-09-14,Kings,031,150075,28649,27955,1619,29574,278
2021-09-14,Lake,033,64148,6000,5845,117,5962,83
2021-09-14,Lassen,035,31185,6175,5977,251,6228,25
2021-09-14,Los Angeles,037,10098052,1384700,1372831,51620,1424451,25729
2021-09-14,Madera,039,155013,20363,19800,1612,21412,254
2021-09-14,Marin,041,260295,16763,16584,387,16971,242
2021-09-14,Mariposa,043,17540,893,834,31,865,5
2021-09-14,Mendocino,045,87422,6594,6372,295,6667,65
2021-09-14,Merced,047,269075,38003,37430,1410,38840,526
2021-09-14,Modoc,049,8938,466,453,161,614,5
2021-09-14,Mono,051,14174,1491,1440,18,1458,4
2021-09-14,Monterey,053,433212,47160,46224,2548,48772,558
2021-09-14,Napa,055,140530,12198,12070,81,12151,91
2021-09-14,Nevada,057,99092,8220,8056,269,8325,83
2021-09-14,Orange,059,3164182,295111,291423,13896,305319,5319
2021-09-14,Placer,061,380077,33506,32735,3120,35855,350
2021-09-14,Plumas,063,18699,1223,1148,23,1171,5
2021-09-14,Riverside,065,2383286,344329,338534,15817,354351,4748
2021-09-14,Sacramento,067,1510023,146123,145051,3633,148684,1977
2021-09-14,San Benito,069,59416,6936,6887,143,7030,64
2021-09-14,San Bernardino,071,2135413,337609,333968,10502,344470,5465
2021-09-14,San Diego,073,3302833,350524,346204,20473,366677,3966
2021-09-14,San Francisco,075,870044,49683,48998,2129,51127,603
2021-09-14,San Joaquin,077,732212,92630,91128,4913,96041,1596
2021-09-14,San Luis Obispo,079,281455,27478,26845,1051,27896,304
2021-09-14,San Mateo,081,765935,51541,50602,772,51374,564
2021-09-14,Santa Barbara,083,443738,41497,40783,1519,42302,495
2021-09-14,Santa Clara,085,1922200,139859,138321,1081,139402,1828
2021-09-14,Santa Cruz,087,273765,19198,18965,971,19936,210
2021-09-14,Shasta,089,179085,17928,17152,2905,20057,246
2021-09-14,Sierra,091,2930,129,123,13,136,0
2021-09-14,Siskiyou,093,43540,2939,2756,998,3754,35
2021-09-14,Solano,095,438530,43553,42599,1111,43710,307
2021-09-14,Sonoma,097,501317,38960,38595,478,39073,369
2021-09-14,Stanislaus,099,539301,71197,70697,8036,78733,1091
2021-09-14,Sutter,101,95872,12882,12670,224,12894,149
2021-09-14,Tehama,103,63373,7099,6859,1149,8008,80
2021-09-14,Trinity,105,12862,699,538,190,728,7
2021-09-14,Tulare,107,460477,60854,58961,12408,71369,888
2021-09-14,Tuolumne,109,53932,6055,5951,68,6019,89
2021-09-14,Ventura,111,848112,93815,92841,4090,96931,1107
2021-09-14,Yolo,113,214977,18315,18039,926,18965,239
2021-09-14,Yuba,115,75493,9063,8928,202,9130,61
2021-09-13,Alameda,001,1643700,113397,112159,2617,114776,1309
2021-09-13,Alpine,003,1148,98,98,0,98,0
2021-09-13,Amador,005,37829,4878,4761,48,4809,56
2021-09-13,Butte,007,227075,18106,17393,3181,20574,225
2021-09-13,Calaveras,009,45235,3333,3253,28,3281,65
2021-09-13,Colusa,011,21464,2384,2346,527,2873,16
2021-09-13,Contra Costa,013,1133247,93702,92658,1894,94552,908
2021-09-13,Del Norte,015,27424,3372,3232,21,3253,28
2021-09-13,El Dorado,017,186661,14541,14194,1449,15643,119
2021-09-13,Fresno,019,978130,125216,122650,11190,133840,1853
2021-09-13,Glenn,021,27897,3126,3026,868,3894,20
2021-09-13,Humboldt,023,135768,7901,7659,379,8038,52
2021-09-13,Imperial,025,180216,31129,30802,3159,33961,751
2021-09-13,Inyo,027,18085,1642,1602,32,1634,39
2021-09-13,Kern,029,883053,115369,112930,17580,130510,1424
2021-09-13,Kings,031,150075,28539,27858,1607,29465,275
2021-09-13,Lake,033,64148,5978,5809,117,5926,82
2021-09-13,Lassen,035,31185,6140,5953,250,6203,25
2021-09-13,Los Angeles,037,10098052,1382839,1371423,51551,1422974,25703
2021-09-13,Madera,039,155013,20292,19735,1597,21332,252
2021-09-13,Marin,041,260295,16727,16557,386,16943,242
2021-09-13,Mariposa,043,17540,879,825,31,856,5
2021-09-13,Mendocino,045,87422,6559,6323,286,6609,61
2021-09-13,Merced,047,269075,37852,37291,1405,38696,521
2021-09-13,Modoc,049,8938,465,451,161,612,5
2021-09-13,Mono,051,14174,1485,1435,18,1453,3
2021-09-13,Monterey,053,433212,47069,46188,2535,48723,558
2021-09-13,Napa,055,140530,12180,12039,81,12120,91
2021-09-13,Nevada,057,99092,8194,8021,267,8288,83
2021-09-13,Orange,059,3164182,294678,291128,13875,305003,5312
2021-09-13,Placer,061,380077,33341,32617,3103,35720,343
2021-09-13,Plumas,063,18699,1214,1142,23,1165,5
2021-09-13,Riverside,065,2383286,343685,337876,15799,353675,4731
2021-09-13,Sacramento,067,1510023,145636,144537,3599,148136,1956
2021-09-13,San Benito,069,59416,6921,6867,142,7009,64
2021-09-13,San Bernardino,071,2135413,337122,333613,10477,344090,5441
2021-09-13,San Diego,073,3302833,349736,345647,20423,366070,3961
2021-09-13,San Francisco,075,870044,49554,48914,2123,51037,603
2021-09-13,San Joaquin,077,732212,92346,90966,4895,95861,1581
2021-09-13,San Luis Obispo,079,281455,27381,26805,1048,27853,300
2021-09-13,San Mateo,081,765935,51450,50525,767,51292,564
2021-09-13,Santa Barbara,083,443738,41378,40661,1512,42173,494
2021-09-13,Santa Clara,085,1922200,139611,138152,1076,139228,1820
2021-09-13,Santa Cruz,087,273765,19158,18917,970,19887,210
2021-09-13,Shasta,089,179085,17798,17033,2863,19896,243
2021-09-13,Sierra,091,2930,129,123,13,136,0
2021-09-13,Siskiyou,093,43540,2924,2745,986,3731,35
2021-09-13,Solano,095,438530,43449,42501,1108,43609,306
2021-09-13,Sonoma,097,501317,38893,38513,475,38988,368
2021-09-13,Stanislaus,099,539301,70943,70477,8000,78477,1091
2021-09-13,Sutter,101,95872,12824,12624,220,12844,145
2021-09-13,Tehama,103,63373,7036,6803,1137,7940,79
2021-09-13,Trinity,105,12862,697,533,188,721,7
2021-09-13,Tulare,107,460477,60570,58768,12346,71114,887
2021-09-13,Tuolumne,109,53932,6024,5909,68,5977,89
2021-09-13,Ventura,111,848112,93662,92679,4082,96761,1107
2021-09-13,Yolo,113,214977,18271,17974,921,18895,239
2021-09-13,Yuba,115,75493,9018,8884,201,9085,61
2021-09-12,Alameda,001,1643700,113125,111961,2614,114575,1309
2021-09-12,Alpine,003,1148,98,98,0,98,0
2021-09-12,Amador,005,37829,4857,4752,48,4800,56
2021-09-12,Butte,007,227075,17961,17257,3137,20394,221
2021-09-12,Calaveras,009,45235,3302,3236,24,3260,65
2021-09-12,Colusa,011,21464,2381,2344,526,2870,16
2021-09-12,Contra Costa,013,1133247,93435,92498,1882,94380,908
2021-09-12,Del Norte,015,27424,3337,3200,21,3221,28
2021-09-12,El Dorado,017,186661,14468,14167,1433,15600,119
2021-09-12,Fresno,019,978130,124699,122407,11138,133545,1853
2021-09-12,Glenn,021,27897,3109,3016,861,3877,20
2021-09-12,Humboldt,023,135768,7831,7636,368,8004,52
2021-09-12,Imperial,025,180216,31066,30790,3153,33943,751
2021-09-12,Inyo,027,18085,1632,1596,30,1626,39
2021-09-12,Kern,029,883053,114958,112602,17421,130023,1424
2021-09-12,Kings,031,150075,28428,27764,1590,29354,274
2021-09-12,Lake,033,64148,5939,5781,115,5896,82
2021-09-12,Lassen,035,31185,6103,5943,240,6183,25
2021-09-12,Los Angeles,037,10098052,1380782,1365968,51475,1417443,25630
2021-09-12,Madera,039,155013,20205,19691,1584,21275,252
2021-09-12,Marin,041,260295,16704,16526,386,16912,242
2021-09-12,Mariposa,043,17540,868,811,29,840,5
2021-09-12,Mendocino,045,87422,6518,6283,277,6560,61
2021-09-12,Merced,047,269075,37679,37172,1394,38566,521
2021-09-12,Modoc,049,8938,465,451,160,611,5
2021-09-12,Mono,051,14174,1478,1431,18,1449,3
2021-09-12,Monterey,053,433212,46970,46167,2526,48693,558
2021-09-12,Napa,055,140530,12150,12011,81,12092,91
2021-09-12,Nevada,057,99092,8155,7987,264,8251,83
2021-09-12,Orange,059,3164182,294214,290718,13854,304572,5312
2021-09-12,Placer,061,380077,33192,32520,3079,35599,343
2021-09-12,Plumas,063,18699,1195,1138,23,1161,5
2021-09-12,Riverside,065,2383286,343002,337332,15766,353098,4731
2021-09-12,Sacramento,067,1510023,145128,144030,3559,147589,1959
2021-09-12,San Benito,069,59416,6902,6852,141,6993,64
2021-09-12,San Bernardino,071,2135413,336510,333049,10464,343513,5439
2021-09-12,San Diego,073,3302833,348916,345058,20350,365408,3942
2021-09-12,San Francisco,075,870044,49443,48819,2116,50935,603
2021-09-12,San Joaquin,077,732212,92017,90730,4887,95617,1581
2021-09-12,San Luis Obispo,079,281455,27262,26729,1035,27764,299
2021-09-12,San Mateo,081,765935,51342,50432,763,51195,564
2021-09-12,Santa Barbara,083,443738,41268,40600,1504,42104,494
2021-09-12,Santa Clara,085,1922200,139356,137899,1073,138972,1820
2021-09-12,Santa Cruz,087,273765,19126,18892,969,19861,210
2021-09-12,Shasta,089,179085,17633,16957,2805,19762,243
2021-09-12,Sierra,091,2930,129,123,13,136,0
2021-09-12,Siskiyou,093,43540,2896,2730,971,3701,35
2021-09-12,Solano,095,438530,43343,42409,1103,43512,306
2021-09-12,Sonoma,097,501317,38815,38456,473,38929,368
2021-09-12,Stanislaus,099,539301,70643,70184,7961,78145,1091
2021-09-12,Sutter,101,95872,12782,12589,214,12803,145
2021-09-12,Tehama,103,63373,6972,6732,1125,7857,79
2021-09-12,Trinity,105,12862,693,529,186,715,7
2021-09-12,Tulare,107,460477,60216,58582,12286,70868,887
2021-09-12,Tuolumne,109,53932,5991,5888,68,5956,89
2021-09-12,Ventura,111,848112,93545,92496,4076,96572,1107
2021-09-12,Yolo,113,214977,18205,17943,913,18856,239
2021-09-12,Yuba,115,75493,8983,8842,201,9043,61
2021-09-11,Alameda,001,1643700,112997,111715,2612,114327,1309
2021-09-11,Alpine,003,1148,98,98,0,98,0
2021-09-11,Amador,005,37829,4844,4728,47,4775,56
2021-09-11,Butte,007,227075,17879,17218,3110,20328,221
2021-09-11,Calaveras,009,45235,3300,3208,23,3231,65
2021-09-11,Colusa,011,21464,2380,2338,523,2861,16
2021-09-11,Contra Costa,013,1133247,93317,92269,1877,94146,908
2021-09-11,Del Norte,015,27424,3321,3184,21,3205,28
2021-09-11,El Dorado,017,186661,14449,14117,1426,15543,119
2021-09-11,Fresno,019,978130,124519,122224,11116,133340,1853
2021-09-11,Glenn,021,27897,3099,3007,859,3866,20
2021-09-11,Humboldt,023,135768,7809,7615,365,7980,52
2021-09-11,Imperial,025,180216,31041,30760,3149,33909,751
2021-09-11,Inyo,027,18085,1629,1590,30,1620,39
2021-09-11,Kern,029,883053,114707,112205,17305,129510,1424
2021-09-11,Kings,031,150075,28379,27631,1584,29215,275
2021-09-11,Lake,033,64148,5919,5761,115,5876,82
2021-09-11,Lassen,035,31185,6088,5930,236,6166,25
2021-09-11,Los Angeles,037,10098052,1379817,1365831,51410,1417241,25630
2021-09-11,Madera,039,155013,20152,19648,1579,21227,252
2021-09-11,Marin,041,260295,16676,16496,385,16881,242
2021-09-11,Mariposa,043,17540,863,799,29,828,5
2021-09-11,Mendocino,045,87422,6494,6257,277,6534,61
2021-09-11,Merced,047,269075,37625,37042,1391,38433,521
2021-09-11,Modoc,049,8938,465,449,160,609,5
2021-09-11,Mono,051,14174,1472,1431,18,1449,3
2021-09-11,Monterey,053,433212,46933,46140,2524,48664,558
2021-09-11,Napa,055,140530,12127,11991,81,12072,91
2021-09-11,Nevada,057,99092,8140,7967,264,8231,83
2021-09-11,Orange,059,3164182,293913,290429,13837,304266,5306
2021-09-11,Placer,061,380077,33108,32414,3068,35482,344
2021-09-11,Plumas,063,18699,1190,1112,23,1135,5
2021-09-11,Riverside,065,2383286,342564,336585,15752,352337,4731
2021-09-11,Sacramento,067,1510023,144829,143557,3547,147104,1955
2021-09-11,San Benito,069,59416,6889,6844,141,6985,64
2021-09-11,San Bernardino,071,2135413,336170,332512,10450,342962,5430
2021-09-11,San Diego,073,3302833,348426,344355,20326,364681,3942
2021-09-11,San Francisco,075,870044,49388,48660,2111,50771,603
2021-09-11,San Joaquin,077,732212,91872,90482,4880,95362,1581
2021-09-11,San Luis Obispo,079,281455,27216,26651,1034,27685,299
2021-09-11,San Mateo,081,765935,51270,50341,763,51104,564
2021-09-11,Santa Barbara,083,443738,41195,40451,1504,41955,494
2021-09-11,Santa Clara,085,1922200,139206,137659,1070,138729,1820
2021-09-11,Santa Cruz,087,273765,19097,18865,969,19834,210
2021-09-11,Shasta,089,179085,17540,16877,2785,19662,243
2021-09-11,Sierra,091,2930,129,123,13,136,0
2021-09-11,Siskiyou,093,43540,2879,2717,968,3685,35
2021-09-11,Solano,095,438530,43292,42344,1100,43444,306
2021-09-11,Sonoma,097,501317,38768,38399,471,38870,368
2021-09-11,Stanislaus,099,539301,70517,69974,7947,77921,1091
2021-09-11,Sutter,101,95872,12756,12538,211,12749,145
2021-09-11,Tehama,103,63373,6951,6703,1117,7820,79
2021-09-11,Trinity,105,12862,686,526,186,712,7
2021-09-11,Tulare,107,460477,60105,58321,12239,70560,889
2021-09-11,Tuolumne,109,53932,5972,5879,65,5944,89
2021-09-11,Ventura,111,848112,93466,92328,4071,96399,1107
2021-09-11,Yolo,113,214977,18182,17906,908,18814,239
2021-09-11,Yuba,115,75493,8958,8813,201,9014,61
2021-09-10,Alameda,001,1643700,112806,111386,2611,113997,1306
2021-09-10,Alpine,003,1148,97,97,0,97,0
2021-09-10,Amador,005,37829,4832,4706,47,4753,56
2021-09-10,Butte,007,227075,17804,17051,3095,20146,222
2021-09-10,Calaveras,009,45235,3294,3183,23,3206,65
2021-09-10,Colusa,011,21464,2376,2327,520,2847,16
2021-09-10,Contra Costa,013,1133247,93195,92024,1875,93899,908
2021-09-10,Del Norte,015,27424,3306,3128,20,3148,28
2021-09-10,El Dorado,017,186661,14418,14051,1421,15472,119
2021-09-10,Fresno,019,978130,124197,121659,11095,132754,1846
2021-09-10,Glenn,021,27897,3092,2977,859,3836,20
2021-09-10,Humboldt,023,135768,7776,7543,361,7904,52
2021-09-10,Imperial,025,180216,31018,30716,3147,33863,751
2021-09-10,Inyo,027,18085,1625,1590,30,1620,39
2021-09-10,Kern,029,883053,114453,111832,17189,129021,1419
2021-09-10,Kings,031,150075,28305,27473,1575,29048,274
2021-09-10,Lake,033,64148,5903,5713,113,5826,79
2021-09-10,Lassen,035,31185,6080,5914,233,6147,25
2021-09-10,Los Angeles,037,10098052,1378609,1365709,51343,1417052,25630
2021-09-10,Madera,039,155013,20106,19520,1574,21094,252
2021-09-10,Marin,041,260295,16656,16458,382,16840,242
2021-09-10,Mariposa,043,17540,858,795,29,824,5
2021-09-10,Mendocino,045,87422,6462,6184,276,6460,61
2021-09-10,Merced,047,269075,37573,36884,1390,38274,521
2021-09-10,Modoc,049,8938,465,448,160,608,5
2021-09-10,Mono,051,14174,1467,1422,18,1440,3
2021-09-10,Monterey,053,433212,46889,46084,2522,48606,557
2021-09-10,Napa,055,140530,12103,11948,81,12029,90
2021-09-10,Nevada,057,99092,8122,7932,263,8195,83
2021-09-10,Orange,059,3164182,293605,290022,13828,303850,5302
2021-09-10,Placer,061,380077,33007,32264,3055,35319,343
2021-09-10,Plumas,063,18699,1182,1111,23,1134,5
2021-09-10,Riverside,065,2383286,342091,335988,15745,351733,4720
2021-09-10,Sacramento,067,1510023,144486,143244,3539,146783,1950
2021-09-10,San Benito,069,59416,6885,6824,141,6965,64
2021-09-10,San Bernardino,071,2135413,335751,331894,10440,342334,5422
2021-09-10,San Diego,073,3302833,347862,343173,20285,363458,3941
2021-09-10,San Francisco,075,870044,49310,48518,2104,50622,602
2021-09-10,San Joaquin,077,732212,91692,90208,4874,95082,1573
2021-09-10,San Luis Obispo,079,281455,27183,26526,1032,27558,299
2021-09-10,San Mateo,081,765935,51202,50251,762,51013,564
2021-09-10,Santa Barbara,083,443738,41140,40321,1501,41822,492
2021-09-10,Santa Clara,085,1922200,139022,137337,1069,138406,1817
2021-09-10,Santa Cruz,087,273765,19078,18785,968,19753,210
2021-09-10,Shasta,089,179085,17446,16667,2757,19424,242
2021-09-10,Sierra,091,2930,129,117,13,130,0
2021-09-10,Siskiyou,093,43540,2867,2702,964,3666,35
2021-09-10,Solano,095,438530,43218,42230,1093,43323,305
2021-09-10,Sonoma,097,501317,38710,38271,470,38741,368
2021-09-10,Stanislaus,099,539301,70361,69617,7923,77540,1091
2021-09-10,Sutter,101,95872,12722,12468,211,12679,145
2021-09-10,Tehama,103,63373,6918,6652,1111,7763,77
2021-09-10,Trinity,105,12862,682,524,186,710,7
2021-09-10,Tulare,107,460477,59957,57930,12193,70123,883
2021-09-10,Tuolumne,109,53932,5954,5842,64,5906,89
2021-09-10,Ventura,111,848112,93376,92145,4067,96212,1104
2021-09-10,Yolo,113,214977,18157,17825,903,18728,239
2021-09-10,Yuba,115,75493,8939,8760,200,8960,62
2021-09-09,Alameda,001,1643700,112586,111014,2607,113621,1306
2021-09-09,Alpine,003,1148,97,94,0,94,0
2021-09-09,Amador,005,37829,4811,4698,46,4744,56
2021-09-09,Butte,007,227075,17659,16874,3069,19943,221
2021-09-09,Calaveras,009,45235,3263,3165,23,3188,65
2021-09-09,Colusa,011,21464,2369,2321,518,2839,16
2021-09-09,Contra Costa,013,1133247,92985,91687,1870,93557,904
2021-09-09,Del Norte,015,27424,3283,3102,20,3122,28
2021-09-09,El Dorado,017,186661,14361,13970,1411,15381,119
2021-09-09,Fresno,019,978130,123724,121040,11059,132099,1838
2021-09-09,Glenn,021,27897,3080,2947,853,3800,20
2021-09-09,Humboldt,023,135768,7726,7471,355,7826,52
2021-09-09,Imperial,025,180216,30980,30661,3143,33804,751
2021-09-09,Inyo,027,18085,1618,1586,30,1616,39
2021-09-09,Kern,029,883053,114105,111390,17032,128422,1414
2021-09-09,Kings,031,150075,28204,27282,1564,28846,273
2021-09-09,Lake,033,64148,5879,5638,111,5749,79
2021-09-09,Lassen,035,31185,6030,5860,227,6087,25
2021-09-09,Los Angeles,037,10098052,1376745,1363735,51269,1415004,25583
2021-09-09,Madera,039,155013,20033,19401,1561,20962,252
2021-09-09,Marin,041,260295,16633,16416,379,16795,242
2021-09-09,Mariposa,043,17540,845,779,28,807,5
2021-09-09,Mendocino,045,87422,6428,6089,267,6356,61
2021-09-09,Merced,047,269075,37418,36634,1377,38011,516
2021-09-09,Modoc,049,8938,465,448,160,608,5
2021-09-09,Mono,051,14174,1457,1420,18,1438,3
2021-09-09,Monterey,053,433212,46835,45991,2511,48502,556
2021-09-09,Napa,055,140530,12071,11878,81,11959,90
2021-09-09,Nevada,057,99092,8084,7855,263,8118,82
2021-09-09,Orange,059,3164182,293195,289109,13797,302906,5299
2021-09-09,Placer,061,380077,32889,32048,3040,35088,342
2021-09-09,Plumas,063,18699,1172,1098,22,1120,5
2021-09-09,Riverside,065,2383286,341451,334774,15727,350501,4701
2021-09-09,Sacramento,067,1510023,144006,142728,3493,146221,1929
2021-09-09,San Benito,069,59416,6875,6820,140,6960,64
2021-09-09,San Bernardino,071,2135413,335188,331040,10428,341468,5417
2021-09-09,San Diego,073,3302833,347137,342149,20228,362377,3929
2021-09-09,San Francisco,075,870044,49196,48404,2095,50499,597
2021-09-09,San Joaquin,077,732212,91417,89874,4856,94730,1570
2021-09-09,San Luis Obispo,079,281455,27101,26472,1029,27501,296
2021-09-09,San Mateo,081,765935,51080,50143,759,50902,561
2021-09-09,Santa Barbara,083,443738,41033,40180,1497,41677,490
2021-09-09,Santa Clara,085,1922200,138799,137017,1064,138081,1816
2021-09-09,Santa Cruz,087,273765,19032,18728,968,19696,210
2021-09-09,Shasta,089,179085,17300,16401,2715,19116,238
2021-09-09,Sierra,091,2930,129,115,13,128,0
2021-09-09,Siskiyou,093,43540,2844,2683,950,3633,35
2021-09-09,Solano,095,438530,43102,42081,1089,43170,303
2021-09-09,Sonoma,097,501317,38642,38171,469,38640,360
2021-09-09,Stanislaus,099,539301,70080,69178,7890,77068,1074
2021-09-09,Sutter,101,95872,12667,12396,209,12605,144
2021-09-09,Tehama,103,63373,6864,6554,1106,7660,75
2021-09-09,Trinity,105,12862,676,523,184,707,6
2021-09-09,Tulare,107,460477,59715,57564,12133,69697,879
2021-09-09,Tuolumne,109,53932,5926,5802,63,5865,89
2021-09-09,Ventura,111,848112,93233,91610,4058,95668,1098
2021-09-09,Yolo,113,214977,18100,17724,900,18624,239
2021-09-09,Yuba,115,75493,8894,8707,197,8904,55
2021-09-08,Alameda,001,1643700,112332,110781,2604,113385,1305
2021-09-08,Alpine,003,1148,97,94,0,94,0
2021-09-08,Amador,005,37829,4799,4693,46,4739,56
2021-09-08,Butte,007,227075,17526,16775,3052,19827,220
2021-09-08,Calaveras,009,45235,3245,3157,23,3180,63
2021-09-08,Colusa,011,21464,2367,2308,516,2824,16
2021-09-08,Contra Costa,013,1133247,92712,91471,1865,93336,900
2021-09-08,Del Norte,015,27424,3260,3085,20,3105,25
2021-09-08,El Dorado,017,186661,14281,13928,1389,15317,119
2021-09-08,Fresno,019,978130,123233,120644,10997,131641,1831
2021-09-08,Glenn,021,27897,3064,2942,841,3783,20
2021-09-08,Humboldt,023,135768,7682,7438,347,7785,52
2021-09-08,Imperial,025,180216,30947,30609,3130,33739,751
2021-09-08,Inyo,027,18085,1607,1580,30,1610,39
2021-09-08,Kern,029,883053,113708,110933,16892,127825,1409
2021-09-08,Kings,031,150075,28075,27235,1549,28784,267
2021-09-08,Lake,033,64148,5849,5618,109,5727,79
2021-09-08,Lassen,035,31185,6012,5848,220,6068,25
2021-09-08,Los Angeles,037,10098052,1374676,1362029,51181,1413210,25533
2021-09-08,Madera,039,155013,19973,19352,1547,20899,252
2021-09-08,Marin,041,260295,16605,16386,378,16764,242
2021-09-08,Mariposa,043,17540,833,777,27,804,5
2021-09-08,Mendocino,045,87422,6384,6069,258,6327,61
2021-09-08,Merced,047,269075,37257,36500,1366,37866,516
2021-09-08,Modoc,049,8938,465,448,160,608,5
2021-09-08,Mono,051,14174,1451,1418,18,1436,3
2021-09-08,Monterey,053,433212,46786,45959,2505,48464,554
2021-09-08,Napa,055,140530,12036,11842,79,11921,90
2021-09-08,Nevada,057,99092,8048,7843,262,8105,82
2021-09-08,Orange,059,3164182,292787,288511,13773,302284,5290
2021-09-08,Placer,061,380077,32752,31852,3023,34875,337
2021-09-08,Plumas,063,18699,1165,1072,22,1094,5
2021-09-08,Riverside,065,2383286,340692,334037,15702,349739,4683
2021-09-08,Sacramento,067,1510023,143527,142448,3444,145892,1921
2021-09-08,San Benito,069,59416,6857,6800,140,6940,64
2021-09-08,San Bernardino,071,2135413,334585,330279,10412,340691,5411
2021-09-08,San Diego,073,3302833,346209,341437,20182,361619,3926
2021-09-08,San Francisco,075,870044,49057,48263,2092,50355,589
2021-09-08,San Joaquin,077,732212,91138,89631,4832,94463,1561
2021-09-08,San Luis Obispo,079,281455,27007,26303,1024,27327,294
2021-09-08,San Mateo,081,765935,50978,50051,759,50810,561
2021-09-08,Santa Barbara,083,443738,40921,40000,1493,41493,490
2021-09-08,Santa Clara,085,1922200,138565,136836,1060,137896,1810
2021-09-08,Santa Cruz,087,273765,18995,18699,968,19667,210
2021-09-08,Shasta,089,179085,17145,16227,2668,18895,234
2021-09-08,Sierra,091,2930,129,113,13,126,0
2021-09-08,Siskiyou,093,43540,2811,2643,939,3582,35
2021-09-08,Solano,095,438530,43010,41971,1086,43057,302
2021-09-08,Sonoma,097,501317,38559,38075,468,38543,360
2021-09-08,Stanislaus,099,539301,69849,68945,7851,76796,1074
2021-09-08,Sutter,101,95872,12602,12349,206,12555,144
2021-09-08,Tehama,103,63373,6797,6520,1089,7609,75
2021-09-08,Trinity,105,12862,673,520,180,700,6
2021-09-08,Tulare,107,460477,59391,57425,12077,69502,876
2021-09-08,Tuolumne,109,53932,5894,5783,61,5844,89
2021-09-08,Ventura,111,848112,93083,91345,4040,95385,1096
2021-09-08,Yolo,113,214977,18017,17680,895,18575,239
2021-09-08,Yuba,115,75493,8852,8675,195,8870,55
2021-09-07,Alameda,001,1643700,112026,110550,2598,113148,1301
2021-09-07,Alpine,003,1148,96,94,0,94,0
2021-09-07,Amador,005,37829,4772,4679,46,4725,53
2021-09-07,Butte,007,227075,17369,16723,3016,19739,220
2021-09-07,Calaveras,009,45235,3205,3140,21,3161,63
2021-09-07,Colusa,011,21464,2357,2306,515,2821,16
2021-09-07,Contra Costa,013,1133247,92452,91167,1859,93026,891
2021-09-07,Del Norte,015,27424,3246,3081,20,3101,24
2021-09-07,El Dorado,017,186661,14209,13892,1374,15266,119
2021-09-07,Fresno,019,978130,122680,120268,10911,131179,1828
2021-09-07,Glenn,021,27897,3052,2937,834,3771,20
2021-09-07,Humboldt,023,135768,7622,7397,330,7727,52
2021-09-07,Imperial,025,180216,30907,30584,3122,33706,751
2021-09-07,Inyo,027,18085,1601,1579,29,1608,39
2021-09-07,Kern,029,883053,113276,110674,16730,127404,1408
2021-09-07,Kings,031,150075,27951,27169,1531,28700,267
2021-09-07,Lake,033,64148,5806,5597,101,5698,78
2021-09-07,Lassen,035,31185,5994,5842,214,6056,21
2021-09-07,Los Angeles,037,10098052,1372445,1360407,51090,1411497,25486
2021-09-07,Madera,039,155013,19886,19316,1539,20855,249
2021-09-07,Marin,041,260295,16566,16363,378,16741,242
2021-09-07,Mariposa,043,17540,817,771,27,798,5
2021-09-07,Mendocino,045,87422,6324,6036,248,6284,61
2021-09-07,Merced,047,269075,37083,36400,1360,37760,513
2021-09-07,Modoc,049,8938,463,449,160,609,5
2021-09-07,Mono,051,14174,1442,1416,18,1434,3
2021-09-07,Monterey,053,433212,46703,45911,2492,48403,543
2021-09-07,Napa,055,140530,11995,11814,79,11893,90
2021-09-07,Nevada,057,99092,8020,7829,262,8091,82
2021-09-07,Orange,059,3164182,292358,288225,13742,301967,5274
2021-09-07,Placer,061,380077,32599,31710,2995,34705,337
2021-09-07,Plumas,063,18699,1150,1071,22,1093,5
2021-09-07,Riverside,065,2383286,339906,333390,15683,349073,4666
2021-09-07,Sacramento,067,1510023,142986,142364,3398,145762,1905
2021-09-07,San Benito,069,59416,6839,6786,140,6926,64
2021-09-07,San Bernardino,071,2135413,333839,329962,10388,340350,5407
2021-09-07,San Diego,073,3302833,345202,340709,20118,360827,3922
2021-09-07,San Francisco,075,870044,48917,48175,2087,50262,589
2021-09-07,San Joaquin,077,732212,90803,89468,4818,94286,1548
2021-09-07,San Luis Obispo,079,281455,26889,26253,1015,27268,287
2021-09-07,San Mateo,081,765935,50883,49913,758,50671,561
2021-09-07,Santa Barbara,083,443738,40795,39957,1488,41445,489
2021-09-07,Santa Clara,085,1922200,138277,136631,1054,137685,1807
2021-09-07,Santa Cruz,087,273765,18946,18669,966,19635,210
2021-09-07,Shasta,089,179085,16987,16096,2615,18711,226
2021-09-07,Sierra,091,2930,129,111,13,124,0
2021-09-07,Siskiyou,093,43540,2785,2607,922,3529,34
2021-09-07,Solano,095,438530,42880,41862,1082,42944,300
2021-09-07,Sonoma,097,501317,38475,38013,466,38479,358
2021-09-07,Stanislaus,099,539301,69579,68831,7823,76654,1074
2021-09-07,Sutter,101,95872,12528,12310,200,12510,138
2021-09-07,Tehama,103,63373,6745,6482,1069,7551,74
2021-09-07,Trinity,105,12862,667,517,180,697,6
2021-09-07,Tulare,107,460477,59041,57228,11997,69225,874
2021-09-07,Tuolumne,109,53932,5857,5759,61,5820,88
2021-09-07,Ventura,111,848112,92872,91246,4030,95276,1093
2021-09-07,Yolo,113,214977,17948,17653,890,18543,235
2021-09-07,Yuba,115,75493,8809,8642,190,8832,55
2021-09-06,Alameda,001,1643700,111714,110357,2590,112947,1301
2021-09-06,Alpine,003,1148,94,94,0,94,0
2021-09-06,Amador,005,37829,4756,4648,45,4693,53
2021-09-06,Butte,007,227075,17177,16588,2972,19560,218
2021-09-06,Calaveras,009,45235,3184,3122,21,3143,63
2021-09-06,Colusa,011,21464,2350,2306,510,2816,16
2021-09-06,Contra Costa,013,1133247,92158,90971,1849,92820,891
2021-09-06,Del Norte,015,27424,3205,3037,19,3056,24
2021-09-06,El Dorado,017,186661,14140,13848,1358,15206,119
2021-09-06,Fresno,019,978130,122112,119738,10842,130580,1828
2021-09-06,Glenn,021,27897,3024,2912,821,3733,20
2021-09-06,Humboldt,023,135768,7545,7320,312,7632,52
2021-09-06,Imperial,025,180216,30844,30576,3115,33691,751
2021-09-06,Inyo,027,18085,1592,1578,17,1595,39
2021-09-06,Kern,029,883053,112764,110347,16542,126889,1408
2021-09-06,Kings,031,150075,27808,27094,1516,28610,264
2021-09-06,Lake,033,64148,5742,5548,94,5642,78
2021-09-06,Lassen,035,31185,5968,5822,204,6026,21
2021-09-06,Los Angeles,037,10098052,1370069,1359348,50972,1410320,25477
2021-09-06,Madera,039,155013,19783,19191,1515,20706,249
2021-09-06,Marin,041,260295,16526,16356,378,16734,242
2021-09-06,Mariposa,043,17540,805,764,27,791,5
2021-09-06,Mendocino,045,87422,6254,5984,235,6219,61
2021-09-06,Merced,047,269075,36866,36300,1351,37651,513
2021-09-06,Modoc,049,8938,460,449,160,609,5
2021-09-06,Mono,051,14174,1438,1416,18,1434,3
2021-09-06,Monterey,053,433212,46609,45833,2475,48308,541
2021-09-06,Napa,055,140530,11952,11792,78,11870,90
2021-09-06,Nevada,057,99092,7972,7748,260,8008,82
2021-09-06,Orange,059,3164182,291864,287948,13690,301638,5274
2021-09-06,Placer,061,380077,32422,31595,2957,34552,337
2021-09-06,Plumas,063,18699,1129,1068,19,1087,5
2021-09-06,Riverside,065,2383286,339089,333052,15662,348714,4666
2021-09-06,Sacramento,067,1510023,142345,141730,3329,145059,1905
2021-09-06,San Benito,069,59416,6816,6777,137,6914,64
2021-09-06,San Bernardino,071,2135413,332957,329693,10357,340050,5398
2021-09-06,San Diego,073,3302833,344188,340222,20022,360244,3922
2021-09-06,San Francisco,075,870044,48783,48120,2081,50201,589
2021-09-06,San Joaquin,077,732212,90459,89293,4792,94085,1548
2021-09-06,San Luis Obispo,079,281455,26760,26183,1011,27194,286
2021-09-06,San Mateo,081,765935,50754,49859,756,50615,561
2021-09-06,Santa Barbara,083,443738,40665,39876,1479,41355,489
2021-09-06,Santa Clara,085,1922200,137986,136458,1052,137510,1807
2021-09-06,Santa Cruz,087,273765,18894,18615,963,19578,210
2021-09-06,Shasta,089,179085,16807,15985,2560,18545,226
2021-09-06,Sierra,091,2930,129,109,13,122,0
2021-09-06,Siskiyou,093,43540,2741,2595,888,3483,34
2021-09-06,Solano,095,438530,42732,41774,1075,42849,300
2021-09-06,Sonoma,097,501317,38354,37929,465,38394,358
2021-09-06,Stanislaus,099,539301,69237,68596,7779,76375,1074
2021-09-06,Sutter,101,95872,12466,12238,191,12429,138
2021-09-06,Tehama,103,63373,6683,6413,1042,7455,74
2021-09-06,Trinity,105,12862,664,515,178,693,6
2021-09-06,Tulare,107,460477,58682,57068,11918,68986,874
2021-09-06,Tuolumne,109,53932,5821,5697,61,5758,88
2021-09-06,Ventura,111,848112,92696,91132,4018,95150,1093
2021-09-06,Yolo,113,214977,17864,17576,884,18460,235
2021-09-06,Yuba,115,75493,8759,8584,186,8770,55
2021-09-05,Alameda,001,1643700,111524,110173,2587,112760,1301
2021-09-05,Alpine,003,1148,94,94,0,94,0
2021-09-05,Amador,005,37829,4744,4642,45,4687,53
2021-09-05,Butte,007,227075,17087,16504,2944,19448,218
2021-09-05,Calaveras,009,45235,3179,3106,21,3127,63
2021-09-05,Colusa,011,21464,2342,2305,508,2813,16
2021-09-05,Contra Costa,013,1133247,91974,90862,1844,92706,891
2021-09-05,Del Norte,015,27424,3185,3023,19,3042,24
2021-09-05,El Dorado,017,186661,14111,13827,1344,15171,119
2021-09-05,Fresno,019,978130,121815,119384,10805,130189,1828
2021-09-05,Glenn,021,27897,3011,2899,818,3717,20
2021-09-05,Humboldt,023,135768,7512,7312,309,7621,52
2021-09-05,Imperial,025,180216,30815,30548,3113,33661,751
2021-09-05,Inyo,027,18085,1589,1572,17,1589,39
2021-09-05,Kern,029,883053,112464,110073,16382,126455,1408
2021-09-05,Kings,031,150075,27731,26989,1512,28501,264
2021-09-05,Lake,033,64148,5722,5525,94,5619,78
2021-09-05,Lassen,035,31185,5946,5820,200,6020,21
2021-09-05,Los Angeles,037,10098052,1368778,1357748,50900,1408648,25465
2021-09-05,Madera,039,155013,19741,19155,1504,20659,249
2021-09-05,Marin,041,260295,16507,16342,377,16719,242
2021-09-05,Mariposa,043,17540,801,761,27,788,5
2021-09-05,Mendocino,045,87422,6220,5965,235,6200,61
2021-09-05,Merced,047,269075,36790,36243,1350,37593,513
2021-09-05,Modoc,049,8938,460,447,160,607,5
2021-09-05,Mono,051,14174,1438,1416,18,1434,3
2021-09-05,Monterey,053,433212,46581,45795,2466,48261,540
2021-09-05,Napa,055,140530,11927,11770,78,11848,90
2021-09-05,Nevada,057,99092,7950,7722,259,7981,82
2021-09-05,Orange,059,3164182,291576,287614,13673,301287,5274
2021-09-05,Placer,061,380077,32295,31487,2943,34430,337
2021-09-05,Plumas,063,18699,1122,1067,19,1086,5
2021-09-05,Riverside,065,2383286,338638,332604,15650,348254,4654
2021-09-05,Sacramento,067,1510023,141907,141276,3311,144587,1905
2021-09-05,San Benito,069,59416,6815,6764,137,6901,64
2021-09-05,San Bernardino,071,2135413,332576,329062,10342,339404,5392
2021-09-05,San Diego,073,3302833,343630,339427,19986,359413,3914
2021-09-05,San Francisco,075,870044,48705,48035,2076,50111,589
2021-09-05,San Joaquin,077,732212,90293,89121,4775,93896,1548
2021-09-05,San Luis Obispo,079,281455,26711,26098,1010,27108,285
2021-09-05,San Mateo,081,765935,50687,49809,752,50561,561
2021-09-05,Santa Barbara,083,443738,40598,39762,1477,41239,489
2021-09-05,Santa Clara,085,1922200,137776,136146,1050,137196,1807
2021-09-05,Santa Cruz,087,273765,18874,18588,961,19549,210
2021-09-05,Shasta,089,179085,16724,15960,2534,18494,226
2021-09-05,Sierra,091,2930,128,109,13,122,0
2021-09-05,Siskiyou,093,43540,2724,2585,874,3459,34
2021-09-05,Solano,095,438530,42637,41687,1070,42757,300
2021-09-05,Sonoma,097,501317,38269,37881,464,38345,358
2021-09-05,Stanislaus,099,539301,69098,68434,7754,76188,1074
2021-09-05,Sutter,101,95872,12436,12179,185,12364,138
2021-09-05,Tehama,103,63373,6657,6400,1036,7436,74
2021-09-05,Trinity,105,12862,658,505,177,682,6
2021-09-05,Tulare,107,460477,58513,56915,11874,68789,874
2021-09-05,Tuolumne,109,53932,5809,5688,61,5749,88
2021-09-05,Ventura,111,848112,92561,91004,4014,95018,1093
2021-09-05,Yolo,113,214977,17827,17557,878,18435,235
2021-09-05,Yuba,115,75493,8733,8521,184,8705,55
2021-09-04,Alameda,001,1643700,111397,109944,2580,112524,1301
2021-09-04,Alpine,003,1148,94,94,0,94,0
2021-09-04,Amador,005,37829,4726,4637,44,4681,53
2021-09-04,Butte,007,227075,17029,16403,2929,19332,218
2021-09-04,Calaveras,009,45235,3167,3087,20,3107,63
2021-09-04,Colusa,011,21464,2340,2301,508,2809,16
2021-09-04,Contra Costa,013,1133247,91860,90623,1841,92464,891
2021-09-04,Del Norte,015,27424,3174,2984,19,3003,24
2021-09-04,El Dorado,017,186661,14085,13782,1336,15118,119
2021-09-04,Fresno,019,978130,121621,119033,10785,129818,1828
2021-09-04,Glenn,021,27897,3001,2878,813,3691,20
2021-09-04,Humboldt,023,135768,7481,7298,303,7601,52
2021-09-04,Imperial,025,180216,30792,30526,3110,33636,751
2021-09-04,Inyo,027,18085,1587,1571,17,1588,39
2021-09-04,Kern,029,883053,112219,109751,16251,126002,1408
2021-09-04,Kings,031,150075,27643,26896,1506,28402,263
2021-09-04,Lake,033,64148,5704,5507,94,5601,78
2021-09-04,Lassen,035,31185,5931,5814,192,6006,21
2021-09-04,Los Angeles,037,10098052,1367829,1355634,50842,1406476,25454
2021-09-04,Madera,039,155013,19707,19112,1497,20609,249
2021-09-04,Marin,041,260295,16491,16319,376,16695,242
2021-09-04,Mariposa,043,17540,796,759,27,786,5
2021-09-04,Mendocino,045,87422,6184,5933,235,6168,61
2021-09-04,Merced,047,269075,36744,36083,1347,37430,513
2021-09-04,Modoc,049,8938,460,447,160,607,5
2021-09-04,Mono,051,14174,1435,1417,18,1435,3
2021-09-04,Monterey,053,433212,46550,45756,2462,48218,540
2021-09-04,Napa,055,140530,11902,11760,76,11836,90
2021-09-04,Nevada,057,99092,7935,7691,258,7949,82
2021-09-04,Orange,059,3164182,291313,287244,13652,300896,5274
2021-09-04,Placer,061,380077,32191,31374,2926,34300,337
2021-09-04,Plumas,063,18699,1114,1067,19,1086,5
2021-09-04,Riverside,065,2383286,338168,331958,15638,347596,4654
2021-09-04,Sacramento,067,1510023,141614,140735,3303,144038,1896
2021-09-04,San Benito,069,59416,6806,6758,137,6895,64
2021-09-04,San Bernardino,071,2135413,332244,328425,10328,338753,5393
2021-09-04,San Diego,073,3302833,343196,338748,19964,358712,3914
2021-09-04,San Francisco,075,870044,48630,47937,2067,50004,589
2021-09-04,San Joaquin,077,732212,90177,88846,4767,93613,1548
2021-09-04,San Luis Obispo,079,281455,26679,26020,1010,27030,285
2021-09-04,San Mateo,081,765935,50630,49721,752,50473,560
2021-09-04,Santa Barbara,083,443738,40532,39667,1475,41142,489
2021-09-04,Santa Clara,085,1922200,137590,135845,1047,136892,1806
2021-09-04,Santa Cruz,087,273765,18856,18579,957,19536,210
2021-09-04,Shasta,089,179085,16647,15924,2508,18432,226
2021-09-04,Sierra,091,2930,126,108,13,121,0
2021-09-04,Siskiyou,093,43540,2698,2563,863,3426,34
2021-09-04,Solano,095,438530,42564,41614,1068,42682,300
2021-09-04,Sonoma,097,501317,38236,37809,464,38273,358
2021-09-04,Stanislaus,099,539301,68951,68210,7730,75940,1074
2021-09-04,Sutter,101,95872,12395,12137,184,12321,138
2021-09-04,Tehama,103,63373,6632,6367,1018,7385,74
2021-09-04,Trinity,105,12862,656,497,177,674,6
2021-09-04,Tulare,107,460477,58405,56719,11831,68550,874
2021-09-04,Tuolumne,109,53932,5791,5667,59,5726,88
2021-09-04,Ventura,111,848112,92426,90904,4011,94915,1090
2021-09-04,Yolo,113,214977,17793,17522,874,18396,235
2021-09-04,Yuba,115,75493,8705,8475,183,8658,55
2021-09-03,Alameda,001,1643700,111247,109636,2577,112213,1301
2021-09-03,Alpine,003,1148,94,94,0,94,0
2021-09-03,Amador,005,37829,4704,4614,44,4658,53
2021-09-03,Butte,007,227075,16939,16259,2903,19162,215
2021-09-03,Calaveras,009,45235,3158,3069,20,3089,63
2021-09-03,Colusa,011,21464,2335,2295,507,2802,16
2021-09-03,Contra Costa,013,1133247,91709,90299,1838,92137,886
2021-09-03,Del Norte,015,27424,3146,2943,18,2961,24
2021-09-03,El Dorado,017,186661,14052,13710,1332,15042,119
2021-09-03,Fresno,019,978130,121289,118508,10763,129271,1822
2021-09-03,Glenn,021,27897,2992,2867,808,3675,20
2021-09-03,Humboldt,023,135768,7457,7194,298,7492,52
2021-09-03,Imperial,025,180216,30769,30475,3103,33578,751
2021-09-03,Inyo,027,18085,1582,1567,17,1584,39
2021-09-03,Kern,029,883053,112003,109296,16140,125436,1407
2021-09-03,Kings,031,150075,27559,26753,1503,28256,263
2021-09-03,Lake,033,64148,5684,5479,92,5571,78
2021-09-03,Lassen,035,31185,5914,5789,187,5976,21
2021-09-03,Los Angeles,037,10098052,1366497,1351185,50775,1401960,25384
2021-09-03,Madera,039,155013,19622,19021,1491,20512,247
2021-09-03,Marin,041,260295,16469,16293,375,16668,242
2021-09-03,Mariposa,043,17540,789,753,25,778,5
2021-09-03,Mendocino,045,87422,6149,5891,235,6126,61
2021-09-03,Merced,047,269075,36690,35941,1338,37279,512
2021-09-03,Modoc,049,8938,460,445,160,605,5
2021-09-03,Mono,051,14174,1434,1410,18,1428,3
2021-09-03,Monterey,053,433212,46512,45707,2458,48165,540
2021-09-03,Napa,055,140530,11881,11733,76,11809,89
2021-09-03,Nevada,057,99092,7902,7632,258,7890,82
2021-09-03,Orange,059,3164182,290994,286818,13624,300442,5253
2021-09-03,Placer,061,380077,32084,31238,2902,34140,335
2021-09-03,Plumas,063,18699,1103,1057,19,1076,5
2021-09-03,Riverside,065,2383286,337636,331011,15622,346633,4653
2021-09-03,Sacramento,067,1510023,141245,139982,3284,143266,1886
2021-09-03,San Benito,069,59416,6800,6746,137,6883,64
2021-09-03,San Bernardino,071,2135413,331831,327599,10317,337916,5381
2021-09-03,San Diego,073,3302833,342576,337627,19932,357559,3911
2021-09-03,San Francisco,075,870044,48554,47822,2061,49883,589
2021-09-03,San Joaquin,077,732212,90024,88366,4759,93125,1540
2021-09-03,San Luis Obispo,079,281455,26603,25917,1008,26925,283
2021-09-03,San Mateo,081,765935,50536,49617,750,50367,560
2021-09-03,Santa Barbara,083,443738,40465,39507,1472,40979,489
2021-09-03,Santa Clara,085,1922200,137388,135522,1043,136565,1801
2021-09-03,Santa Cruz,087,273765,18831,18532,957,19489,210
2021-09-03,Shasta,089,179085,16572,15778,2484,18262,226
2021-09-03,Sierra,091,2930,124,105,13,118,0
2021-09-03,Siskiyou,093,43540,2686,2529,850,3379,34
2021-09-03,Solano,095,438530,42466,41457,1065,42522,300
2021-09-03,Sonoma,097,501317,38173,37699,464,38163,358
2021-09-03,Stanislaus,099,539301,68777,67887,7704,75591,1074
2021-09-03,Sutter,101,95872,12356,12073,183,12256,139
2021-09-03,Tehama,103,63373,6593,6334,1011,7345,72
2021-09-03,Trinity,105,12862,654,490,172,662,6
2021-09-03,Tulare,107,460477,58278,56401,11778,68179,872
2021-09-03,Tuolumne,109,53932,5749,5630,59,5689,88
2021-09-03,Ventura,111,848112,92292,90742,4007,94749,1088
2021-09-03,Yolo,113,214977,17770,17446,868,18314,235
2021-09-03,Yuba,115,75493,8673,8412,183,8595,55
2021-09-02,Alameda,001,1643700,110988,109377,2574,111951,1301
2021-09-02,Alpine,003,1148,93,92,0,92,0
2021-09-02,Amador,005,37829,4688,4606,44,4650,53
2021-09-02,Butte,007,227075,16813,16154,2884,19038,215
2021-09-02,Calaveras,009,45235,3147,3042,20,3062,62
2021-09-02,Colusa,011,21464,2331,2290,505,2795,16
2021-09-02,Contra Costa,013,1133247,91529,90038,1827,91865,886
2021-09-02,Del Norte,015,27424,3115,2891,18,2909,24
2021-09-02,El Dorado,017,186661,13992,13641,1306,14947,119
2021-09-02,Fresno,019,978130,120803,117974,10720,128694,1804
2021-09-02,Glenn,021,27897,2976,2855,804,3659,20
2021-09-02,Humboldt,023,135768,7409,7141,287,7428,52
2021-09-02,Imperial,025,180216,30725,30449,3099,33548,751
2021-09-02,Inyo,027,18085,1577,1564,16,1580,39
2021-09-02,Kern,029,883053,111590,108930,15996,124926,1404
2021-09-02,Kings,031,150075,27466,26638,1493,28131,263
2021-09-02,Lake,033,64148,5654,5432,88,5520,78
2021-09-02,Lassen,035,31185,5900,5747,180,5927,21
2021-09-02,Los Angeles,037,10098052,1364639,1351105,50679,1401784,25382
2021-09-02,Madera,039,155013,19531,18937,1472,20409,247
2021-09-02,Marin,041,260295,16456,16244,373,16617,242
2021-09-02,Mariposa,043,17540,782,745,22,767,5
2021-09-02,Mendocino,045,87422,6107,5848,232,6080,61
2021-09-02,Merced,047,269075,36527,35820,1331,37151,508
2021-09-02,Modoc,049,8938,460,437,160,597,5
2021-09-02,Mono,051,14174,1434,1409,18,1427,3
2021-09-02,Monterey,053,433212,46447,45648,2443,48091,539
2021-09-02,Napa,055,140530,11852,11684,76,11760,88
2021-09-02,Nevada,057,99092,7850,7575,257,7832,82
2021-09-02,Orange,059,3164182,290534,286326,13591,299917,5240
2021-09-02,Placer,061,380077,31946,31067,2873,33940,330
2021-09-02,Plumas,063,18699,1092,1045,18,1063,5
2021-09-02,Riverside,065,2383286,336920,330190,15597,345787,4644
2021-09-02,Sacramento,067,1510023,140661,139274,3245,142519,1882
2021-09-02,San Benito,069,59416,6795,6734,136,6870,64
2021-09-02,San Bernardino,071,2135413,331226,326940,10244,337184,5369
2021-09-02,San Diego,073,3302833,341610,336382,19879,356261,3909
2021-09-02,San Francisco,075,870044,48446,47674,2057,49731,587
2021-09-02,San Joaquin,077,732212,89739,88056,4735,92791,1540
2021-09-02,San Luis Obispo,079,281455,26518,25851,1003,26854,283
2021-09-02,San Mateo,081,765935,50437,49490,747,50237,558
2021-09-02,Santa Barbara,083,443738,40374,39386,1459,40845,486
2021-09-02,Santa Clara,085,1922200,137087,135216,1037,136253,1799
2021-09-02,Santa Cruz,087,273765,18797,18473,954,19427,210
2021-09-02,Shasta,089,179085,16434,15670,2455,18125,224
2021-09-02,Sierra,091,2930,124,105,13,118,0
2021-09-02,Siskiyou,093,43540,2665,2513,822,3335,34
2021-09-02,Solano,095,438530,42360,41293,1062,42355,294
2021-09-02,Sonoma,097,501317,38092,37558,464,38022,352
2021-09-02,Stanislaus,099,539301,68536,67576,7681,75257,1074
2021-09-02,Sutter,101,95872,12286,11995,179,12174,138
2021-09-02,Tehama,103,63373,6534,6265,992,7257,72
2021-09-02,Trinity,105,12862,650,484,170,654,6
2021-09-02,Tulare,107,460477,58048,56105,11726,67831,872
2021-09-02,Tuolumne,109,53932,5693,5578,59,5637,88
2021-09-02,Ventura,111,848112,92109,90610,4002,94612,1084
2021-09-02,Yolo,113,214977,17701,17357,857,18214,235
2021-09-02,Yuba,115,75493,8613,8363,183,8546,55
2021-09-01,Alameda,001,1643700,110716,109075,2568,111643,1299
2021-09-01,Alpine,003,1148,93,92,0,92,0
2021-09-01,Amador,005,37829,4672,4599,43,4642,53
2021-09-01,Butte,007,227075,16698,16046,2859,18905,215
2021-09-01,Calaveras,009,45235,3139,3023,20,3043,59
2021-09-01,Colusa,011,21464,2326,2281,505,2786,16
2021-09-01,Contra Costa,013,1133247,91302,89834,1820,91654,877
2021-09-01,Del Norte,015,27424,3082,2860,18,2878,24
2021-09-01,El Dorado,017,186661,13936,13577,1279,14856,119
2021-09-01,Fresno,019,978130,120317,117492,10664,128156,1800
2021-09-01,Glenn,021,27897,2951,2846,794,3640,20
2021-09-01,Humboldt,023,135768,7361,7090,280,7370,52
2021-09-01,Imperial,025,180216,30688,30393,3094,33487,750
2021-09-01,Inyo,027,18085,1573,1561,15,1576,39
2021-09-01,Kern,029,883053,111159,108449,15854,124303,1400
2021-09-01,Kings,031,150075,27353,26443,1482,27925,263
2021-09-01,Lake,033,64148,5612,5396,83,5479,77
2021-09-01,Lassen,035,31185,5878,5731,176,5907,21
2021-09-01,Los Angeles,037,10098052,1362380,1348589,50571,1399160,25341
2021-09-01,Madera,039,155013,19453,18852,1457,20309,247
2021-09-01,Marin,041,260295,16434,16224,368,16592,240
2021-09-01,Mariposa,043,17540,774,735,22,757,5
2021-09-01,Mendocino,045,87422,6064,5821,227,6048,59
2021-09-01,Merced,047,269075,36350,35686,1322,37008,500
2021-09-01,Modoc,049,8938,454,436,158,594,5
2021-09-01,Mono,051,14174,1434,1400,18,1418,3
2021-09-01,Monterey,053,433212,46367,45590,2428,48018,539
2021-09-01,Napa,055,140530,11819,11653,76,11729,88
2021-09-01,Nevada,057,99092,7797,7508,256,7764,82
2021-09-01,Orange,059,3164182,290059,285840,13553,299393,5233
2021-09-01,Placer,061,380077,31792,30902,2859,33761,330
2021-09-01,Plumas,063,18699,1084,1033,18,1051,5
2021-09-01,Riverside,065,2383286,336104,329388,15567,344955,4634
2021-09-01,Sacramento,067,1510023,140051,138499,3199,141698,1875
2021-09-01,San Benito,069,59416,6778,6716,136,6852,64
2021-09-01,San Bernardino,071,2135413,330576,326250,10215,336465,5364
2021-09-01,San Diego,073,3302833,340573,335302,19830,355132,3908
2021-09-01,San Francisco,075,870044,48337,47538,2050,49588,584
2021-09-01,San Joaquin,077,732212,89418,87640,4712,92352,1540
2021-09-01,San Luis Obispo,079,281455,26422,25691,998,26689,283
2021-09-01,San Mateo,081,765935,50319,49394,741,50135,558
2021-09-01,Santa Barbara,083,443738,40257,39263,1443,40706,483
2021-09-01,Santa Clara,085,1922200,136819,134855,1030,135885,1796
2021-09-01,Santa Cruz,087,273765,18749,18453,952,19405,210
2021-09-01,Shasta,089,179085,16301,15552,2414,17966,221
2021-09-01,Sierra,091,2930,123,98,13,111,0
2021-09-01,Siskiyou,093,43540,2635,2482,802,3284,34
2021-09-01,Solano,095,438530,42209,41194,1056,42250,293
2021-09-01,Sonoma,097,501317,37997,37454,463,37917,352
2021-09-01,Stanislaus,099,539301,68252,67287,7650,74937,1075
2021-09-01,Sutter,101,95872,12222,11945,172,12117,136
2021-09-01,Tehama,103,63373,6500,6228,975,7203,72
2021-09-01,Trinity,105,12862,649,482,167,649,5
2021-09-01,Tulare,107,460477,57766,55768,11689,67457,870
2021-09-01,Tuolumne,109,53932,5654,5553,59,5612,88
2021-09-01,Ventura,111,848112,91894,90471,3986,94457,1089
2021-09-01,Yolo,113,214977,17645,17264,851,18115,235
2021-09-01,Yuba,115,75493,8552,8308,183,8491,55
2021-08-31,Alameda,001,1643700,110413,108837,2561,111398,1297
2021-08-31,Alpine,003,1148,91,92,0,92,0
2021-08-31,Amador,005,37829,4651,4555,43,4598,53
2021-08-31,Butte,007,227075,16557,15896,2818,18714,216
2021-08-31,Calaveras,009,45235,3104,3008,20,3028,59
2021-08-31,Colusa,011,21464,2324,2275,503,2778,16
2021-08-31,Contra Costa,013,1133247,91008,89546,1808,91354,871
2021-08-31,Del Norte,015,27424,3046,2830,18,2848,19
2021-08-31,El Dorado,017,186661,13866,13539,1262,14801,119
2021-08-31,Fresno,019,978130,119744,117155,10591,127746,1801
2021-08-31,Glenn,021,27897,2934,2829,781,3610,20
2021-08-31,Humboldt,023,135768,7285,7030,267,7297,52
2021-08-31,Imperial,025,180216,30651,30348,3086,33434,750
2021-08-31,Inyo,027,18085,1569,1550,15,1565,39
2021-08-31,Kern,029,883053,110657,108151,15675,123826,1393
2021-08-31,Kings,031,150075,27212,26405,1468,27873,260
2021-08-31,Lake,033,64148,5568,5359,80,5439,74
2021-08-31,Lassen,035,31185,5852,5702,173,5875,21
2021-08-31,Los Angeles,037,10098052,1359792,1346686,50492,1397178,25303
2021-08-31,Madera,039,155013,19363,18811,1439,20250,247
2021-08-31,Marin,041,260295,16405,16215,365,16580,240
2021-08-31,Mariposa,043,17540,766,732,22,754,5
2021-08-31,Mendocino,045,87422,6022,5777,225,6002,59
2021-08-31,Merced,047,269075,36180,35512,1317,36829,498
2021-08-31,Modoc,049,8938,453,436,158,594,5
2021-08-31,Mono,051,14174,1422,1398,18,1416,3
2021-08-31,Monterey,053,433212,46283,45550,2415,47965,539
2021-08-31,Napa,055,140530,11772,11618,76,11694,88
2021-08-31,Nevada,057,99092,7730,7460,256,7716,82
2021-08-31,Orange,059,3164182,289460,285310,13519,298829,5229
2021-08-31,Placer,061,380077,31604,30745,2821,33566,325
2021-08-31,Plumas,063,18699,1080,1018,17,1035,5
2021-08-31,Riverside,065,2383286,335130,328556,15534,344090,4627
2021-08-31,Sacramento,067,1510023,139366,137879,3167,141046,1863
2021-08-31,San Benito,069,59416,6766,6694,134,6828,64
2021-08-31,San Bernardino,071,2135413,329832,325446,10195,335641,5350
2021-08-31,San Diego,073,3302833,339308,334377,19780,354157,3888
2021-08-31,San Francisco,075,870044,48187,47440,2039,49479,581
2021-08-31,San Joaquin,077,732212,88973,87365,4697,92062,1540
2021-08-31,San Luis Obispo,079,281455,26298,25518,994,26512,282
2021-08-31,San Mateo,081,765935,50208,49299,741,50040,556
2021-08-31,Santa Barbara,083,443738,40104,39091,1437,40528,481
2021-08-31,Santa Clara,085,1922200,136469,134637,1023,135660,1793
2021-08-31,Santa Cruz,087,273765,18708,18419,949,19368,210
2021-08-31,Shasta,089,179085,16148,15368,2387,17755,220
2021-08-31,Sierra,091,2930,120,95,13,108,0
2021-08-31,Siskiyou,093,43540,2615,2435,786,3221,33
2021-08-31,Solano,095,438530,42070,41067,1049,42116,289
2021-08-31,Sonoma,097,501317,37901,37379,462,37841,352
2021-08-31,Stanislaus,099,539301,67897,67004,7615,74619,1075
2021-08-31,Sutter,101,95872,12156,11901,168,12069,136
2021-08-31,Tehama,103,63373,6440,6169,944,7113,72
2021-08-31,Trinity,105,12862,643,480,167,647,3
2021-08-31,Tulare,107,460477,57433,55567,11618,67185,870
2021-08-31,Tuolumne,109,53932,5618,5516,59,5575,88
2021-08-31,Ventura,111,848112,91677,90292,3974,94266,1081
2021-08-31,Yolo,113,214977,17565,17205,842,18047,234
2021-08-31,Yuba,115,75493,8498,8253,183,8436,54
2021-08-30,Alameda,001,1643700,110088,107734,2550,110284,1296
2021-08-30,Alpine,003,1148,91,92,0,92,0
2021-08-30,Amador,005,37829,4640,4507,43,4550,53
2021-08-30,Butte,007,227075,16406,15719,2785,18504,214
2021-08-30,Calaveras,009,45235,3085,2975,20,2995,59
2021-08-30,Colusa,011,21464,2315,2271,499,2770,16
2021-08-30,Contra Costa,013,1133247,90749,87679,1798,89477,872
2021-08-30,Del Norte,015,27424,3004,2796,17,2813,11
2021-08-30,El Dorado,017,186661,13797,13217,1245,14462,119
2021-08-30,Fresno,019,978130,119177,115867,10528,126395,1790
2021-08-30,Glenn,021,27897,2923,2804,778,3582,20
2021-08-30,Humboldt,023,135768,7232,6930,261,7191,52
2021-08-30,Imperial,025,180216,30613,30311,3081,33392,750
2021-08-30,Inyo,027,18085,1564,1544,15,1559,39
2021-08-30,Kern,029,883053,110178,107615,15511,123126,1389
2021-08-30,Kings,031,150075,27096,26236,1453,27689,259
2021-08-30,Lake,033,64148,5533,5323,77,5400,74
2021-08-30,Lassen,035,31185,5830,5667,167,5834,21
2021-08-30,Los Angeles,037,10098052,1357334,1344949,50405,1395354,25269
2021-08-30,Madera,039,155013,19281,18622,1419,20041,247
2021-08-30,Marin,041,260295,16374,16160,365,16525,240
2021-08-30,Mariposa,043,17540,760,715,21,736,5
2021-08-30,Mendocino,045,87422,5988,5721,221,5942,55
2021-08-30,Merced,047,269075,36052,35335,1313,36648,497
2021-08-30,Modoc,049,8938,451,436,157,593,5
2021-08-30,Mono,051,14174,1421,1390,18,1408,3
2021-08-30,Monterey,053,433212,46221,45463,2398,47861,539
2021-08-30,Napa,055,140530,11723,11579,74,11653,87
2021-08-30,Nevada,057,99092,7671,7356,253,7609,82
2021-08-30,Orange,059,3164182,288879,284750,13470,298220,5223
2021-08-30,Placer,061,380077,31439,29825,2798,32623,319
2021-08-30,Plumas,063,18699,1063,998,17,1015,5
2021-08-30,Riverside,065,2383286,334232,327593,15503,343096,4623
2021-08-30,Sacramento,067,1510023,138711,134571,3121,137692,1847
2021-08-30,San Benito,069,59416,6757,6663,134,6797,64
2021-08-30,San Bernardino,071,2135413,329156,324870,10165,335035,5348
2021-08-30,San Diego,073,3302833,338028,333011,19708,352719,3885
2021-08-30,San Francisco,075,870044,48048,46966,2025,48991,581
2021-08-30,San Joaquin,077,732212,88642,86203,4676,90879,1528
2021-08-30,San Luis Obispo,079,281455,26172,25422,987,26409,280
2021-08-30,San Mateo,081,765935,50084,48839,735,49574,554
2021-08-30,Santa Barbara,083,443738,39953,38998,1432,40430,481
2021-08-30,Santa Clara,085,1922200,136148,133281,1016,134297,1789
2021-08-30,Santa Cruz,087,273765,18653,18326,945,19271,210
2021-08-30,Shasta,089,179085,16019,15238,2344,17582,217
2021-08-30,Sierra,091,2930,118,91,13,104,0
2021-08-30,Siskiyou,093,43540,2602,2411,775,3186,33
2021-08-30,Solano,095,438530,41907,39986,1045,41031,290
2021-08-30,Sonoma,097,501317,37795,36764,462,37226,352
2021-08-30,Stanislaus,099,539301,67557,66173,7584,73757,1074
2021-08-30,Sutter,101,95872,12085,11791,161,11952,136
2021-08-30,Tehama,103,63373,6361,6085,920,7005,71
2021-08-30,Trinity,105,12862,632,468,164,632,3
2021-08-30,Tulare,107,460477,57121,55140,11542,66682,870
2021-08-30,Tuolumne,109,53932,5572,5492,59,5551,74
2021-08-30,Ventura,111,848112,91461,90149,3962,94111,1082
2021-08-30,Yolo,113,214977,17502,17071,838,17909,231
2021-08-30,Yuba,115,75493,8424,8129,182,8311,54
2021-08-29,Alameda,001,1643700,109746,107494,2538,110032,1296
2021-08-29,Alpine,003,1148,91,92,0,92,0
2021-08-29,Amador,005,37829,4626,4501,43,4544,53
2021-08-29,Butte,007,227075,16236,15602,2748,18350,214
2021-08-29,Calaveras,009,45235,3052,2970,20,2990,59
2021-08-29,Colusa,011,21464,2307,2260,493,2753,16
2021-08-29,Contra Costa,013,1133247,90451,87439,1793,89232,872
2021-08-29,Del Norte,015,27424,2961,2752,17,2769,11
2021-08-29,El Dorado,017,186661,13742,13166,1234,14400,119
2021-08-29,Fresno,019,978130,118580,115502,10463,125965,1790
2021-08-29,Glenn,021,27897,2905,2778,772,3550,20
2021-08-29,Humboldt,023,135768,7188,6922,246,7168,52
2021-08-29,Imperial,025,180216,30552,30293,3071,33364,750
2021-08-29,Inyo,027,18085,1554,1543,14,1557,39
2021-08-29,Kern,029,883053,109727,107324,15340,122664,1389
2021-08-29,Kings,031,150075,26944,26143,1438,27581,259
2021-08-29,Lake,033,64148,5493,5293,67,5360,74
2021-08-29,Lassen,035,31185,5807,5666,163,5829,21
2021-08-29,Los Angeles,037,10098052,1354573,1342541,50293,1392834,25263
2021-08-29,Madera,039,155013,19194,18594,1403,19997,247
2021-08-29,Marin,041,260295,16343,16134,362,16496,240
2021-08-29,Mariposa,043,17540,754,709,19,728,5
2021-08-29,Mendocino,045,87422,5930,5689,208,5897,55
2021-08-29,Merced,047,269075,35813,35250,1301,36551,497
2021-08-29,Modoc,049,8938,448,436,157,593,5
2021-08-29,Mono,051,14174,1414,1387,18,1405,3
2021-08-29,Monterey,053,433212,46115,45424,2374,47798,539
2021-08-29,Napa,055,140530,11692,11552,74,11626,87
2021-08-29,Nevada,057,99092,7615,7294,252,7546,82
2021-08-29,Orange,059,3164182,288252,284432,13428,297860,5223
2021-08-29,Placer,061,380077,31266,29674,2757,32431,319
2021-08-29,Plumas,063,18699,1052,996,17,1013,5
2021-08-29,Riverside,065,2383286,333373,326987,15482,342469,4623
2021-08-29,Sacramento,067,1510023,137958,133981,3072,137053,1843
2021-08-29,San Benito,069,59416,6731,6646,134,6780,64
2021-08-29,San Bernardino,071,2135413,328369,324266,10131,334397,5347
2021-08-29,San Diego,073,3302833,336918,332014,19614,351628,3880
2021-08-29,San Francisco,075,870044,47913,46885,2013,48898,581
2021-08-29,San Joaquin,077,732212,88195,85922,4655,90577,1528
2021-08-29,San Luis Obispo,079,281455,25974,25288,982,26270,280
2021-08-29,San Mateo,081,765935,49970,48737,730,49467,554
2021-08-29,Santa Barbara,083,443738,39787,38900,1428,40328,481
2021-08-29,Santa Clara,085,1922200,135794,132979,1010,133989,1789
2021-08-29,Santa Cruz,087,273765,18606,18285,943,19228,210
2021-08-29,Shasta,089,179085,15865,15198,2317,17515,217
2021-08-29,Sierra,091,2930,116,91,13,104,0
2021-08-29,Siskiyou,093,43540,2555,2407,755,3162,33
2021-08-29,Solano,095,438530,41752,39887,1038,40925,290
2021-08-29,Sonoma,097,501317,37659,36650,458,37108,352
2021-08-29,Stanislaus,099,539301,67211,65956,7548,73504,1074
2021-08-29,Sutter,101,95872,12027,11719,154,11873,136
2021-08-29,Tehama,103,63373,6290,6040,897,6937,71
2021-08-29,Trinity,105,12862,629,468,160,628,3
2021-08-29,Tulare,107,460477,56788,54974,11458,66432,870
2021-08-29,Tuolumne,109,53932,5547,5478,58,5536,74
2021-08-29,Ventura,111,848112,91204,90114,3953,94067,1082
2021-08-29,Yolo,113,214977,17403,17015,826,17841,231
2021-08-29,Yuba,115,75493,8360,8042,182,8224,54
2021-08-28,Alameda,001,1643700,109581,107007,2529,109536,1296
2021-08-28,Alpine,003,1148,91,92,0,92,0
2021-08-28,Amador,005,37829,4607,4484,43,4527,53
2021-08-28,Butte,007,227075,16177,15487,2720,18207,214
2021-08-28,Calaveras,009,45235,3041,2926,20,2946,59
2021-08-28,Colusa,011,21464,2303,2252,491,2743,16
2021-08-28,Contra Costa,013,1133247,90239,86938,1790,88728,872
2021-08-28,Del Norte,015,27424,2934,2734,16,2750,11
2021-08-28,El Dorado,017,186661,13702,13089,1228,14317,119
2021-08-28,Fresno,019,978130,118339,115079,10434,125513,1792
2021-08-28,Glenn,021,27897,2896,2773,765,3538,20
2021-08-28,Humboldt,023,135768,7153,6887,241,7128,52
2021-08-28,Imperial,025,180216,30525,30260,3067,33327,750
2021-08-28,Inyo,027,18085,1552,1539,14,1553,39
2021-08-28,Kern,029,883053,109489,107012,15198,122210,1389
2021-08-28,Kings,031,150075,26877,26059,1435,27494,257
2021-08-28,Lake,033,64148,5470,5267,63,5330,74
2021-08-28,Lassen,035,31185,5792,5665,162,5827,21
2021-08-28,Los Angeles,037,10098052,1353363,1337097,50220,1387317,25234
2021-08-28,Madera,039,155013,19143,18553,1388,19941,247
2021-08-28,Marin,041,260295,16328,16106,362,16468,240
2021-08-28,Mariposa,043,17540,752,704,19,723,5
2021-08-28,Mendocino,045,87422,5905,5658,208,5866,55
2021-08-28,Merced,047,269075,35761,35108,1298,36406,497
2021-08-28,Modoc,049,8938,448,436,156,592,5
2021-08-28,Mono,051,14174,1411,1385,18,1403,3
2021-08-28,Monterey,053,433212,46073,45394,2369,47763,539
2021-08-28,Napa,055,140530,11669,11512,73,11585,88
2021-08-28,Nevada,057,99092,7591,7238,250,7488,82
2021-08-28,Orange,059,3164182,287894,283953,13379,297332,5222
2021-08-28,Placer,061,380077,31157,29428,2744,32172,319
2021-08-28,Plumas,063,18699,1045,991,17,1008,5
2021-08-28,Riverside,065,2383286,332785,326222,15472,341694,4623
2021-08-28,Sacramento,067,1510023,137566,132985,3056,136041,1844
2021-08-28,San Benito,069,59416,6724,6636,134,6770,64
2021-08-28,San Bernardino,071,2135413,327921,323672,10123,333795,5348
2021-08-28,San Diego,073,3302833,336332,331330,19581,350911,3880
2021-08-28,San Francisco,075,870044,47841,46654,2006,48660,581
2021-08-28,San Joaquin,077,732212,88026,85481,4646,90127,1527
2021-08-28,San Luis Obispo,079,281455,25908,25138,977,26115,280
2021-08-28,San Mateo,081,765935,49895,48575,726,49301,554
2021-08-28,Santa Barbara,083,443738,39715,38780,1427,40207,481
2021-08-28,Santa Clara,085,1922200,135587,132488,1008,133496,1789
2021-08-28,Santa Cruz,087,273765,18589,18240,940,19180,210
2021-08-28,Shasta,089,179085,15762,15147,2298,17445,217
2021-08-28,Sierra,091,2930,112,91,13,104,0
2021-08-28,Siskiyou,093,43540,2547,2402,744,3146,33
2021-08-28,Solano,095,438530,41703,39610,1037,40647,290
2021-08-28,Sonoma,097,501317,37586,36466,456,36922,352
2021-08-28,Stanislaus,099,539301,67053,65670,7531,73201,1074
2021-08-28,Sutter,101,95872,12006,11669,153,11822,136
2021-08-28,Tehama,103,63373,6265,6004,884,6888,71
2021-08-28,Trinity,105,12862,625,463,159,622,3
2021-08-28,Tulare,107,460477,56658,54746,11416,66162,870
2021-08-28,Tuolumne,109,53932,5531,5469,58,5527,74
2021-08-28,Ventura,111,848112,91086,89934,3951,93885,1081
2021-08-28,Yolo,113,214977,17367,16907,819,17726,231
2021-08-28,Yuba,115,75493,8329,7985,181,8166,55
2021-08-27,Alameda,001,1643700,109371,106622,2526,109148,1296
2021-08-27,Alpine,003,1148,91,92,0,92,0
2021-08-27,Amador,005,37829,4591,4458,42,4500,53
2021-08-27,Butte,007,227075,16097,15277,2701,17978,214
2021-08-27,Calaveras,009,45235,3028,2903,20,2923,59
2021-08-27,Colusa,011,21464,2297,2240,489,2729,16
2021-08-27,Contra Costa,013,1133247,90041,86386,1787,88173,872
2021-08-27,Del Norte,015,27424,2902,2695,16,2711,11
2021-08-27,El Dorado,017,186661,13663,12968,1224,14192,119
2021-08-27,Fresno,019,978130,117905,114481,10411,124892,1774
2021-08-27,Glenn,021,27897,2878,2754,757,3511,20
2021-08-27,Humboldt,023,135768,7120,6782,238,7020,52
2021-08-27,Imperial,025,180216,30505,30201,3063,33264,750
2021-08-27,Inyo,027,18085,1551,1529,14,1543,39
2021-08-27,Kern,029,883053,109195,106570,15088,121658,1385
2021-08-27,Kings,031,150075,26798,25957,1433,27390,257
2021-08-27,Lake,033,64148,5445,5228,62,5290,74
2021-08-27,Lassen,035,31185,5776,5646,157,5803,21
2021-08-27,Los Angeles,037,10098052,1351842,1337006,50153,1387159,25230
2021-08-27,Madera,039,155013,19087,18476,1375,19851,247
2021-08-27,Marin,041,260295,16312,16055,360,16415,240
2021-08-27,Mariposa,043,17540,746,690,19,709,5
2021-08-27,Mendocino,045,87422,5874,5602,207,5809,55
2021-08-27,Merced,047,269075,35707,34906,1289,36195,495
2021-08-27,Modoc,049,8938,448,434,156,590,5
2021-08-27,Mono,051,14174,1406,1385,18,1403,3
2021-08-27,Monterey,053,433212,46024,45337,2361,47698,539
2021-08-27,Napa,055,140530,11635,11460,73,11533,87
2021-08-27,Nevada,057,99092,7551,7169,248,7417,82
2021-08-27,Orange,059,3164182,287533,283407,13340,296747,5206
2021-08-27,Placer,061,380077,31027,29157,2724,31881,320
2021-08-27,Plumas,063,18699,1039,984,17,1001,5
2021-08-27,Riverside,065,2383286,332268,325379,15457,340836,4622
2021-08-27,Sacramento,067,1510023,137131,131921,3043,134964,1838
2021-08-27,San Benito,069,59416,6718,6622,134,6756,64
2021-08-27,San Bernardino,071,2135413,327397,322893,10105,332998,5342
2021-08-27,San Diego,073,3302833,335550,330162,19527,349689,3877
2021-08-27,San Francisco,075,870044,47765,46456,1988,48444,581
2021-08-27,San Joaquin,077,732212,87843,84949,4627,89576,1524
2021-08-27,San Luis Obispo,079,281455,25860,24952,974,25926,280
2021-08-27,San Mateo,081,765935,49820,48424,722,49146,553
2021-08-27,Santa Barbara,083,443738,39623,38675,1425,40100,480
2021-08-27,Santa Clara,085,1922200,135357,132011,1005,133016,1783
2021-08-27,Santa Cruz,087,273765,18550,18163,936,19099,210
2021-08-27,Shasta,089,179085,15682,14996,2282,17278,217
2021-08-27,Sierra,091,2930,111,91,13,104,0
2021-08-27,Siskiyou,093,43540,2532,2358,730,3088,33
2021-08-27,Solano,095,438530,41589,39347,1033,40380,287
2021-08-27,Sonoma,097,501317,37514,36326,455,36781,342
2021-08-27,Stanislaus,099,539301,66843,65167,7493,72660,1061
2021-08-27,Sutter,101,95872,11960,11590,151,11741,135
2021-08-27,Tehama,103,63373,6232,5964,869,6833,71
2021-08-27,Trinity,105,12862,625,458,158,616,3
2021-08-27,Tulare,107,460477,56522,54443,11370,65813,870
2021-08-27,Tuolumne,109,53932,5499,5438,58,5496,74
2021-08-27,Ventura,111,848112,90957,89774,3947,93721,1076
2021-08-27,Yolo,113,214977,17325,16805,814,17619,231
2021-08-27,Yuba,115,75493,8272,7926,181,8107,54
2021-08-26,Alameda,001,1643700,109090,106146,2517,108663,1296
2021-08-26,Alpine,003,1148,91,92,0,92,0
2021-08-26,Amador,005,37829,4576,4442,41,4483,53
2021-08-26,Butte,007,227075,15964,15159,2665,17824,214
2021-08-26,Calaveras,009,45235,3014,2873,20,2893,59
2021-08-26,Colusa,011,21464,2290,2234,485,2719,16
2021-08-26,Contra Costa,013,1133247,89682,85808,1781,87589,866
2021-08-26,Del Norte,015,27424,2866,2625,16,2641,8
2021-08-26,El Dorado,017,186661,13594,12863,1210,14073,118
2021-08-26,Fresno,019,978130,117403,113854,10354,124208,1770
2021-08-26,Glenn,021,27897,2858,2740,748,3488,20
2021-08-26,Humboldt,023,135768,7062,6695,228,6923,53
2021-08-26,Imperial,025,180216,30456,30121,3054,33175,748
2021-08-26,Inyo,027,18085,1541,1521,13,1534,39
2021-08-26,Kern,029,883053,108767,106051,14943,120994,1380
2021-08-26,Kings,031,150075,26675,25838,1425,27263,260
2021-08-26,Lake,033,64148,5399,5196,59,5255,74
2021-08-26,Lassen,035,31185,5764,5626,155,5781,21
2021-08-26,Los Angeles,037,10098052,1349578,1334372,50057,1384429,25199
2021-08-26,Madera,039,155013,19017,18393,1362,19755,247
2021-08-26,Marin,041,260295,16283,15983,357,16340,240
2021-08-26,Mariposa,043,17540,736,677,19,696,5
2021-08-26,Mendocino,045,87422,5836,5533,202,5735,55
2021-08-26,Merced,047,269075,35540,34755,1268,36023,495
2021-08-26,Modoc,049,8938,448,433,156,589,5
2021-08-26,Mono,051,14174,1402,1385,18,1403,3
2021-08-26,Monterey,053,433212,45951,45265,2350,47615,539
2021-08-26,Napa,055,140530,11613,11394,72,11466,87
2021-08-26,Nevada,057,99092,7492,7086,245,7331,80
2021-08-26,Orange,059,3164182,287041,282814,13317,296131,5200
2021-08-26,Placer,061,380077,30859,28898,2698,31596,319
2021-08-26,Plumas,063,18699,1032,971,16,987,5
2021-08-26,Riverside,065,2383286,331476,324486,15436,339922,4615
2021-08-26,Sacramento,067,1510023,136598,130977,3001,133978,1827
2021-08-26,San Benito,069,59416,6708,6604,134,6738,64
2021-08-26,San Bernardino,071,2135413,326739,322100,10081,332181,5339
2021-08-26,San Diego,073,3302833,334522,328276,19461,347737,3869
2021-08-26,San Francisco,075,870044,47638,46288,1983,48271,581
2021-08-26,San Joaquin,077,732212,87465,84429,4604,89033,1513
2021-08-26,San Luis Obispo,079,281455,25711,24831,968,25799,278
2021-08-26,San Mateo,081,765935,49691,48263,720,48983,553
2021-08-26,Santa Barbara,083,443738,39539,38566,1424,39990,479
2021-08-26,Santa Clara,085,1922200,135031,131443,1001,132444,1782
2021-08-26,Santa Cruz,087,273765,18490,18072,934,19006,210
2021-08-26,Shasta,089,179085,15559,14891,2255,17146,217
2021-08-26,Sierra,091,2930,109,90,13,103,0
2021-08-26,Siskiyou,093,43540,2510,2342,716,3058,33
2021-08-26,Solano,095,438530,41440,39027,1025,40052,286
2021-08-26,Sonoma,097,501317,37425,36102,455,36557,337
2021-08-26,Stanislaus,099,539301,66545,64785,7452,72237,1061
2021-08-26,Sutter,101,95872,11900,11499,148,11647,135
2021-08-26,Tehama,103,63373,6174,5913,856,6769,68
2021-08-26,Trinity,105,12862,620,450,156,606,3
2021-08-26,Tulare,107,460477,56265,54157,11324,65481,870
2021-08-26,Tuolumne,109,53932,5479,5387,58,5445,74
2021-08-26,Ventura,111,848112,90771,89595,3938,93533,1080
2021-08-26,Yolo,113,214977,17259,16727,803,17530,231
2021-08-26,Yuba,115,75493,8199,7834,179,8013,54
2021-08-25,Alameda,001,1643700,108761,105636,2509,108145,1296
2021-08-25,Alpine,003,1148,91,92,0,92,0
2021-08-25,Amador,005,37829,4561,4415,41,4456,53
2021-08-25,Butte,007,227075,15858,15039,2623,17662,214
2021-08-25,Calaveras,009,45235,2994,2851,20,2871,59
2021-08-25,Colusa,011,21464,2283,2227,476,2703,16
2021-08-25,Contra Costa,013,1133247,89299,85322,1775,87097,863
2021-08-25,Del Norte,015,27424,2821,2573,16,2589,8
2021-08-25,El Dorado,017,186661,13535,12787,1194,13981,118
2021-08-25,Fresno,019,978130,116865,113384,10310,123694,1761
2021-08-25,Glenn,021,27897,2837,2728,736,3464,20
2021-08-25,Humboldt,023,135768,6993,6653,218,6871,52
2021-08-25,Imperial,025,180216,30419,30085,3047,33132,748
2021-08-25,Inyo,027,18085,1537,1518,13,1531,39
2021-08-25,Kern,029,883053,108336,105687,14787,120474,1379
2021-08-25,Kings,031,150075,26568,25676,1418,27094,258
2021-08-25,Lake,033,64148,5369,5163,56,5219,74
2021-08-25,Lassen,035,31185,5747,5583,154,5737,21
2021-08-25,Los Angeles,037,10098052,1346976,1331400,49969,1381369,25170
2021-08-25,Madera,039,155013,18953,18311,1339,19650,247
2021-08-25,Marin,041,260295,16261,15938,351,16289,240
2021-08-25,Mariposa,043,17540,730,676,19,695,5
2021-08-25,Mendocino,045,87422,5800,5486,197,5683,53
2021-08-25,Merced,047,269075,35408,34600,1256,35856,492
2021-08-25,Modoc,049,8938,448,433,156,589,5
2021-08-25,Mono,051,14174,1398,1382,18,1400,3
2021-08-25,Monterey,053,433212,45877,45196,2335,47531,539
2021-08-25,Napa,055,140530,11579,11348,71,11419,87
2021-08-25,Nevada,057,99092,7426,7000,244,7244,77
2021-08-25,Orange,059,3164182,286516,282061,13284,295345,5193
2021-08-25,Placer,061,380077,30683,28740,2665,31405,319
2021-08-25,Plumas,063,18699,1017,962,16,978,5
2021-08-25,Riverside,065,2383286,330632,323548,15414,338962,4610
2021-08-25,Sacramento,067,1510023,135918,130046,2962,133008,1827
2021-08-25,San Benito,069,59416,6687,6587,133,6720,64
2021-08-25,San Bernardino,071,2135413,326045,321228,10060,331288,5337
2021-08-25,San Diego,073,3302833,333250,327166,19381,346547,3859
2021-08-25,San Francisco,075,870044,47489,46107,1978,48085,578
2021-08-25,San Joaquin,077,732212,87080,84002,4588,88590,1510
2021-08-25,San Luis Obispo,079,281455,25519,24607,965,25572,276
2021-08-25,San Mateo,081,765935,49567,48153,716,48869,553
2021-08-25,Santa Barbara,083,443738,39409,38450,1424,39874,479
2021-08-25,Santa Clara,085,1922200,134662,130995,998,131993,1783
2021-08-25,Santa Cruz,087,273765,18429,17987,931,18918,210
2021-08-25,Shasta,089,179085,15430,14752,2223,16975,217
2021-08-25,Sierra,091,2930,106,90,13,103,0
2021-08-25,Siskiyou,093,43540,2465,2322,697,3019,33
2021-08-25,Solano,095,438530,41269,38848,1013,39861,286
2021-08-25,Sonoma,097,501317,37301,35986,452,36438,336
2021-08-25,Stanislaus,099,539301,66264,64441,7419,71860,1061
2021-08-25,Sutter,101,95872,11832,11451,144,11595,134
2021-08-25,Tehama,103,63373,6115,5861,839,6700,68
2021-08-25,Trinity,105,12862,614,450,155,605,3
2021-08-25,Tulare,107,460477,55980,53877,11254,65131,866
2021-08-25,Tuolumne,109,53932,5453,5354,58,5412,74
2021-08-25,Ventura,111,848112,90588,89379,3924,93303,1068
2021-08-25,Yolo,113,214977,17194,16667,793,17460,231
2021-08-25,Yuba,115,75493,8133,7771,178,7949,54
2021-08-24,Alameda,001,1643700,108432,105319,2499,107818,1296
2021-08-24,Alpine,003,1148,91,92,0,92,0
2021-08-24,Amador,005,37829,4542,4380,41,4421,50
2021-08-24,Butte,007,227075,15702,14964,2589,17553,214
2021-08-24,Calaveras,009,45235,2953,2811,20,2831,59
2021-08-24,Colusa,011,21464,2275,2221,472,2693,16
2021-08-24,Contra Costa,013,1133247,88937,84963,1769,86732,857
2021-08-24,Del Norte,015,27424,2794,2543,16,2559,8
2021-08-24,El Dorado,017,186661,13458,12732,1178,13910,118
2021-08-24,Fresno,019,978130,116260,113024,10250,123274,1761
2021-08-24,Glenn,021,27897,2822,2717,728,3445,20
2021-08-24,Humboldt,023,135768,6930,6585,205,6790,52
2021-08-24,Imperial,025,180216,30358,30045,3040,33085,748
2021-08-24,Inyo,027,18085,1532,1512,13,1525,39
2021-08-24,Kern,029,883053,107872,105399,14620,120019,1375
2021-08-24,Kings,031,150075,26447,25629,1402,27031,258
2021-08-24,Lake,033,64148,5334,5135,56,5191,72
2021-08-24,Lassen,035,31185,5731,5576,152,5728,21
2021-08-24,Los Angeles,037,10098052,1344115,1328777,49867,1378644,25135
2021-08-24,Madera,039,155013,18877,18251,1322,19573,247
2021-08-24,Marin,041,260295,16225,15900,347,16247,240
2021-08-24,Mariposa,043,17540,723,670,19,689,5
2021-08-24,Mendocino,045,87422,5756,5416,190,5606,52
2021-08-24,Merced,047,269075,35240,34490,1245,35735,491
2021-08-24,Modoc,049,8938,448,432,156,588,5
2021-08-24,Mono,051,14174,1396,1382,18,1400,3
2021-08-24,Monterey,053,433212,45811,45126,2317,47443,539
2021-08-24,Napa,055,140530,11546,11299,70,11369,85
2021-08-24,Nevada,057,99092,7356,6981,242,7223,77
2021-08-24,Orange,059,3164182,285917,281461,13258,294719,5187
2021-08-24,Placer,061,380077,30480,28618,2626,31244,318
2021-08-24,Plumas,063,18699,1007,953,16,969,5
2021-08-24,Riverside,065,2383286,329758,322620,15383,338003,4605
2021-08-24,Sacramento,067,1510023,135234,129542,2914,132456,1812
2021-08-24,San Benito,069,59416,6674,6576,133,6709,64
2021-08-24,San Bernardino,071,2135413,325290,320300,10030,330330,5328
2021-08-24,San Diego,073,3302833,331797,325823,19281,345104,3851
2021-08-24,San Francisco,075,870044,47314,46010,1966,47976,574
2021-08-24,San Joaquin,077,732212,86639,83684,4550,88234,1508
2021-08-24,San Luis Obispo,079,281455,25341,24443,955,25398,274
2021-08-24,San Mateo,081,765935,49418,48050,714,48764,553
2021-08-24,Santa Barbara,083,443738,39278,38307,1423,39730,478
2021-08-24,Santa Clara,085,1922200,134238,130763,994,131757,1779
2021-08-24,Santa Cruz,087,273765,18355,17928,925,18853,209
2021-08-24,Shasta,089,179085,15322,14664,2191,16855,217
2021-08-24,Sierra,091,2930,103,90,13,103,0
2021-08-24,Siskiyou,093,43540,2443,2294,682,2976,33
2021-08-24,Solano,095,438530,41060,38724,1001,39725,283
2021-08-24,Sonoma,097,501317,37172,35849,450,36299,336
2021-08-24,Stanislaus,099,539301,65937,64195,7369,71564,1058
2021-08-24,Sutter,101,95872,11765,11384,141,11525,134
2021-08-24,Tehama,103,63373,6069,5826,824,6650,67
2021-08-24,Trinity,105,12862,603,446,147,593,3
2021-08-24,Tulare,107,460477,55628,53702,11164,64866,856
2021-08-24,Tuolumne,109,53932,5422,5287,58,5345,74
2021-08-24,Ventura,111,848112,90403,89167,3913,93080,1068
2021-08-24,Yolo,113,214977,17117,16492,780,17272,231
2021-08-24,Yuba,115,75493,8050,7723,176,7899,54
2021-08-23,Alameda,001,1643700,108030,104922,2487,107409,1294
2021-08-23,Alpine,003,1148,91,91,0,91,0
2021-08-23,Amador,005,37829,4528,4369,41,4410,50
2021-08-23,Butte,007,227075,15556,14847,2554,17401,211
2021-08-23,Calaveras,009,45235,2925,2803,20,2823,59
2021-08-23,Colusa,011,21464,2271,2206,469,2675,16
2021-08-23,Contra Costa,013,1133247,88557,84651,1762,86413,857
2021-08-23,Del Norte,015,27424,2748,2499,16,2515,8
2021-08-23,El Dorado,017,186661,13355,12684,1156,13840,118
2021-08-23,Fresno,019,978130,115700,112445,10200,122645,1759
2021-08-23,Glenn,021,27897,2806,2696,721,3417,20
2021-08-23,Humboldt,023,135768,6855,6498,190,6688,52
2021-08-23,Imperial,025,180216,30307,30011,3037,33048,748
2021-08-23,Inyo,027,18085,1525,1509,13,1522,39
2021-08-23,Kern,029,883053,107417,104995,14464,119459,1375
2021-08-23,Kings,031,150075,26315,25465,1396,26861,257
2021-08-23,Lake,033,64148,5294,5099,54,5153,69
2021-08-23,Lassen,035,31185,5719,5562,152,5714,21
2021-08-23,Los Angeles,037,10098052,1341161,1326412,49742,1376154,25096
2021-08-23,Madera,039,155013,18791,18155,1307,19462,246
2021-08-23,Marin,041,260295,16177,15856,343,16199,240
2021-08-23,Mariposa,043,17540,712,645,19,664,5
2021-08-23,Mendocino,045,87422,5689,5374,183,5557,51
2021-08-23,Merced,047,269075,35058,34322,1240,35562,488
2021-08-23,Modoc,049,8938,445,431,155,586,6
2021-08-23,Mono,051,14174,1392,1384,18,1402,3
2021-08-23,Monterey,053,433212,45713,45047,2306,47353,538
2021-08-23,Napa,055,140530,11508,11257,70,11327,85
2021-08-23,Nevada,057,99092,7276,6930,240,7170,77
2021-08-23,Orange,059,3164182,285281,280891,13223,294114,5181
2021-08-23,Placer,061,380077,30280,28540,2588,31128,314
2021-08-23,Plumas,063,18699,999,934,16,950,5
2021-08-23,Riverside,065,2383286,328846,321650,15357,337007,4598
2021-08-23,Sacramento,067,1510023,134447,128969,2847,131816,1807
2021-08-23,San Benito,069,59416,6656,6562,131,6693,64
2021-08-23,San Bernardino,071,2135413,324485,319577,9991,329568,5324
2021-08-23,San Diego,073,3302833,330353,324536,19168,343704,3848
2021-08-23,San Francisco,075,870044,47160,45945,1957,47902,573
2021-08-23,San Joaquin,077,732212,86205,83466,4517,87983,1499
2021-08-23,San Luis Obispo,079,281455,25159,24317,953,25270,274
2021-08-23,San Mateo,081,765935,49280,47935,711,48646,553
2021-08-23,Santa Barbara,083,443738,39099,38181,1421,39602,478
2021-08-23,Santa Clara,085,1922200,133838,130489,990,131479,1778
2021-08-23,Santa Cruz,087,273765,18298,17871,923,18794,209
2021-08-23,Shasta,089,179085,15196,14537,2152,16689,216
2021-08-23,Sierra,091,2930,103,90,13,103,0
2021-08-23,Siskiyou,093,43540,2422,2274,661,2935,33
2021-08-23,Solano,095,438530,40907,38612,992,39604,283
2021-08-23,Sonoma,097,501317,37052,35769,449,36218,336
2021-08-23,Stanislaus,099,539301,65604,63922,7330,71252,1058
2021-08-23,Sutter,101,95872,11676,11314,133,11447,133
2021-08-23,Tehama,103,63373,6015,5805,806,6611,67
2021-08-23,Trinity,105,12862,600,435,144,579,3
2021-08-23,Tulare,107,460477,55321,53370,11092,64462,856
2021-08-23,Tuolumne,109,53932,5380,5240,58,5298,73
2021-08-23,Ventura,111,848112,90184,88960,3901,92861,1063
2021-08-23,Yolo,113,214977,17030,16445,765,17210,226
2021-08-23,Yuba,115,75493,7979,7653,174,7827,54
2021-08-22,Alameda,001,1643700,107580,104539,2454,106993,1294
2021-08-22,Alpine,003,1148,91,91,0,91,0
2021-08-22,Amador,005,37829,4498,4349,41,4390,50
2021-08-22,Butte,007,227075,15417,14791,2518,17309,211
2021-08-22,Calaveras,009,45235,2890,2771,20,2791,59
2021-08-22,Colusa,011,21464,2263,2201,463,2664,16
2021-08-22,Contra Costa,013,1133247,88015,84371,1748,86119,857
2021-08-22,Del Norte,015,27424,2688,2455,16,2471,8
2021-08-22,El Dorado,017,186661,13251,12629,1136,13765,118
2021-08-22,Fresno,019,978130,115101,112057,10133,122190,1759
2021-08-22,Glenn,021,27897,2781,2678,709,3387,20
2021-08-22,Humboldt,023,135768,6778,6483,171,6654,52
2021-08-22,Imperial,025,180216,30249,29993,3032,33025,748
2021-08-22,Inyo,027,18085,1519,1505,13,1518,39
2021-08-22,Kern,029,883053,106892,104691,14309,119000,1375
2021-08-22,Kings,031,150075,26157,25391,1379,26770,257
2021-08-22,Lake,033,64148,5248,5069,51,5120,69
2021-08-22,Lassen,035,31185,5687,5556,147,5703,21
2021-08-22,Los Angeles,037,10098052,1337859,1324151,49610,1373761,25089
2021-08-22,Madera,039,155013,18672,18120,1292,19412,246
2021-08-22,Marin,041,260295,16125,15822,335,16157,240
2021-08-22,Mariposa,043,17540,702,638,17,655,5
2021-08-22,Mendocino,045,87422,5630,5336,183,5519,51
2021-08-22,Merced,047,269075,34855,34234,1227,35461,488
2021-08-22,Modoc,049,8938,443,431,155,586,6
2021-08-22,Mono,051,14174,1390,1378,18,1396,3
2021-08-22,Monterey,053,433212,45614,45017,2292,47309,538
2021-08-22,Napa,055,140530,11463,11231,70,11301,85
2021-08-22,Nevada,057,99092,7202,6864,238,7102,77
2021-08-22,Orange,059,3164182,284590,280390,13178,293568,5181
2021-08-22,Placer,061,380077,30071,28395,2552,30947,314
2021-08-22,Plumas,063,18699,980,923,15,938,5
2021-08-22,Riverside,065,2383286,327824,320836,15308,336144,4594
2021-08-22,Sacramento,067,1510023,133672,128231,2806,131037,1802
2021-08-22,San Benito,069,59416,6639,6550,131,6681,64
2021-08-22,San Bernardino,071,2135413,323516,318839,9956,328795,5324
2021-08-22,San Diego,073,3302833,329028,323591,19063,342654,3848
2021-08-22,San Francisco,075,870044,46994,45831,1947,47778,573
2021-08-22,San Joaquin,077,732212,85747,83121,4482,87603,1498
2021-08-22,San Luis Obispo,079,281455,24953,24250,946,25196,274
2021-08-22,San Mateo,081,765935,49104,47821,706,48527,553
2021-08-22,Santa Barbara,083,443738,38915,38099,1413,39512,478
2021-08-22,Santa Clara,085,1922200,133421,130189,983,131172,1778
2021-08-22,Santa Cruz,087,273765,18237,17823,918,18741,209
2021-08-22,Shasta,089,179085,15058,14478,2116,16594,216
2021-08-22,Sierra,091,2930,103,87,13,100,0
2021-08-22,Siskiyou,093,43540,2393,2261,643,2904,33
2021-08-22,Solano,095,438530,40708,38489,979,39468,283
2021-08-22,Sonoma,097,501317,36896,35676,446,36122,336
2021-08-22,Stanislaus,099,539301,65253,63683,7240,70923,1058
2021-08-22,Sutter,101,95872,11594,11251,129,11380,133
2021-08-22,Tehama,103,63373,5969,5791,787,6578,67
2021-08-22,Trinity,105,12862,593,433,142,575,3
2021-08-22,Tulare,107,460477,55001,53220,11007,64227,856
2021-08-22,Tuolumne,109,53932,5337,5214,58,5272,73
2021-08-22,Ventura,111,848112,89975,88791,3884,92675,1063
2021-08-22,Yolo,113,214977,16928,16374,756,17130,226
2021-08-22,Yuba,115,75493,7905,7626,173,7799,54
2021-08-21,Alameda,001,1643700,107377,104281,2447,106728,1294
2021-08-21,Alpine,003,1148,91,91,0,91,0
2021-08-21,Amador,005,37829,4488,4338,39,4377,50
2021-08-21,Butte,007,227075,15349,14714,2497,17211,211
2021-08-21,Calaveras,009,45235,2874,2744,20,2764,59
2021-08-21,Colusa,011,21464,2257,2192,459,2651,16
2021-08-21,Contra Costa,013,1133247,87756,84136,1740,85876,857
2021-08-21,Del Norte,015,27424,2665,2409,16,2425,8
2021-08-21,El Dorado,017,186661,13207,12590,1132,13722,118
2021-08-21,Fresno,019,978130,114905,111765,10120,121885,1759
2021-08-21,Glenn,021,27897,2769,2654,702,3356,20
2021-08-21,Humboldt,023,135768,6740,6446,165,6611,52
2021-08-21,Imperial,025,180216,30206,29976,3029,33005,748
2021-08-21,Inyo,027,18085,1516,1500,13,1513,39
2021-08-21,Kern,029,883053,106636,104443,14185,118628,1375
2021-08-21,Kings,031,150075,26086,25313,1374,26687,257
2021-08-21,Lake,033,64148,5228,5055,49,5104,69
2021-08-21,Lassen,035,31185,5673,5553,147,5700,21
2021-08-21,Los Angeles,037,10098052,1336566,1321308,49519,1370827,25080
2021-08-21,Madera,039,155013,18634,18067,1286,19353,246
2021-08-21,Marin,041,260295,16091,15775,333,16108,240
2021-08-21,Mariposa,043,17540,692,634,17,651,5
2021-08-21,Mendocino,045,87422,5584,5307,182,5489,51
2021-08-21,Merced,047,269075,34750,34148,1222,35370,488
2021-08-21,Modoc,049,8938,443,430,155,585,6
2021-08-21,Mono,051,14174,1390,1378,18,1396,3
2021-08-21,Monterey,053,433212,45567,44969,2285,47254,538
2021-08-21,Napa,055,140530,11428,11211,70,11281,85
2021-08-21,Nevada,057,99092,7158,6810,237,7047,77
2021-08-21,Orange,059,3164182,284139,279855,13144,292999,5181
2021-08-21,Placer,061,380077,29933,28289,2527,30816,314
2021-08-21,Plumas,063,18699,976,916,14,930,5
2021-08-21,Riverside,065,2383286,327243,320086,15295,335381,4594
2021-08-21,Sacramento,067,1510023,133177,127751,2794,130545,1809
2021-08-21,San Benito,069,59416,6629,6542,130,6672,64
2021-08-21,San Bernardino,071,2135413,323065,318293,9935,328228,5324
2021-08-21,San Diego,073,3302833,328366,322620,19020,341640,3848
2021-08-21,San Francisco,075,870044,46892,45637,1940,47577,573
2021-08-21,San Joaquin,077,732212,85530,82825,4467,87292,1498
2021-08-21,San Luis Obispo,079,281455,24895,24169,946,25115,273
2021-08-21,San Mateo,081,765935,49007,47685,706,48391,553
2021-08-21,Santa Barbara,083,443738,38833,37951,1409,39360,478
2021-08-21,Santa Clara,085,1922200,133156,129911,979,130890,1778
2021-08-21,Santa Cruz,087,273765,18200,17763,913,18676,209
2021-08-21,Shasta,089,179085,14984,14417,2102,16519,217
2021-08-21,Sierra,091,2930,98,85,13,98,0
2021-08-21,Siskiyou,093,43540,2379,2246,632,2878,33
2021-08-21,Solano,095,438530,40597,38423,969,39392,281
2021-08-21,Sonoma,097,501317,36809,35582,445,36027,336
2021-08-21,Stanislaus,099,539301,65071,63512,7222,70734,1058
2021-08-21,Sutter,101,95872,11549,11204,127,11331,133
2021-08-21,Tehama,103,63373,5944,5757,780,6537,67
2021-08-21,Trinity,105,12862,588,431,140,571,3
2021-08-21,Tulare,107,460477,54857,53045,10963,64008,857
2021-08-21,Tuolumne,109,53932,5306,5193,58,5251,73
2021-08-21,Ventura,111,848112,89831,88558,3869,92427,1063
2021-08-21,Yolo,113,214977,16881,16322,750,17072,226
2021-08-21,Yuba,115,75493,7859,7580,172,7752,54
2021-08-20,Alameda,001,1643700,107131,103812,2439,106251,1294
2021-08-20,Alpine,003,1148,91,91,0,91,0
2021-08-20,Amador,005,37829,4462,4323,39,4362,50
2021-08-20,Butte,007,227075,15277,14617,2475,17092,211
2021-08-20,Calaveras,009,45235,2853,2717,20,2737,59
2021-08-20,Colusa,011,21464,2252,2178,457,2635,16
2021-08-20,Contra Costa,013,1133247,87479,83721,1733,85454,857
2021-08-20,Del Norte,015,27424,2633,2316,16,2332,8
2021-08-20,El Dorado,017,186661,13169,12495,1124,13619,118
2021-08-20,Fresno,019,978130,114552,111315,10088,121403,1759
2021-08-20,Glenn,021,27897,2762,2642,695,3337,20
2021-08-20,Humboldt,023,135768,6689,6349,160,6509,52
2021-08-20,Imperial,025,180216,30183,29934,3029,32963,747
2021-08-20,Inyo,027,18085,1510,1495,13,1508,39
2021-08-20,Kern,029,883053,106352,104048,14057,118105,1373
2021-08-20,Kings,031,150075,26020,25241,1372,26613,256
2021-08-20,Lake,033,64148,5213,5024,46,5070,69
2021-08-20,Lassen,035,31185,5653,5539,147,5686,21
2021-08-20,Los Angeles,037,10098052,1334693,1317541,49420,1366961,25049
2021-08-20,Madera,039,155013,18585,18018,1271,19289,246
2021-08-20,Marin,041,260295,16073,15727,329,16056,240
2021-08-20,Mariposa,043,17540,687,630,17,647,5
2021-08-20,Mendocino,045,87422,5538,5241,181,5422,51
2021-08-20,Merced,047,269075,34685,34035,1214,35249,486
2021-08-20,Modoc,049,8938,443,429,155,584,6
2021-08-20,Mono,051,14174,1389,1368,18,1386,3
2021-08-20,Monterey,053,433212,45529,44890,2278,47168,538
2021-08-20,Napa,055,140530,11396,11152,70,11222,83
2021-08-20,Nevada,057,99092,7115,6753,231,6984,77
2021-08-20,Orange,059,3164182,283694,279193,13123,292316,5179
2021-08-20,Placer,061,380077,29838,28156,2498,30654,313
2021-08-20,Plumas,063,18699,967,908,14,922,5
2021-08-20,Riverside,065,2383286,326546,319072,15264,334336,4594
2021-08-20,Sacramento,067,1510023,132702,127226,2777,130003,1797
2021-08-20,San Benito,069,59416,6615,6508,130,6638,64
2021-08-20,San Bernardino,071,2135413,322452,317372,9906,327278,5322
2021-08-20,San Diego,073,3302833,327456,321102,18951,340053,3846
2021-08-20,San Francisco,075,870044,46795,45432,1925,47357,573
2021-08-20,San Joaquin,077,732212,85300,82419,4449,86868,1496
2021-08-20,San Luis Obispo,079,281455,24817,23986,942,24928,273
2021-08-20,San Mateo,081,765935,48893,47561,703,48264,551
2021-08-20,Santa Barbara,083,443738,38749,37794,1404,39198,477
2021-08-20,Santa Clara,085,1922200,132873,129510,974,130484,1774
2021-08-20,Santa Cruz,087,273765,18160,17701,910,18611,209
2021-08-20,Shasta,089,179085,14905,14277,2083,16360,215
2021-08-20,Sierra,091,2930,97,83,13,96,0
2021-08-20,Siskiyou,093,43540,2363,2226,627,2853,33
2021-08-20,Solano,095,438530,40457,38214,958,39172,277
2021-08-20,Sonoma,097,501317,36740,35416,444,35860,336
2021-08-20,Stanislaus,099,539301,64882,63219,7199,70418,1047
2021-08-20,Sutter,101,95872,11493,11136,126,11262,133
2021-08-20,Tehama,103,63373,5928,5730,768,6498,66
2021-08-20,Trinity,105,12862,588,422,139,561,3
2021-08-20,Tulare,107,460477,54726,52855,10920,63775,856
2021-08-20,Tuolumne,109,53932,5282,5153,57,5210,73
2021-08-20,Ventura,111,848112,89665,88285,3866,92151,1061
2021-08-20,Yolo,113,214977,16827,16236,744,16980,225
2021-08-20,Yuba,115,75493,7818,7523,172,7695,54
2021-08-19,Alameda,001,1643700,106683,103276,2416,105692,1294
2021-08-19,Alpine,003,1148,91,91,0,91,0
2021-08-19,Amador,005,37829,4455,4317,39,4356,50
2021-08-19,Butte,007,227075,15142,14518,2446,16964,211
2021-08-19,Calaveras,009,45235,2833,2673,20,2693,59
2021-08-19,Colusa,011,21464,2243,2167,453,2620,16
2021-08-19,Contra Costa,013,1133247,87037,83296,1719,85015,852
2021-08-19,Del Norte,015,27424,2583,2257,16,2273,8
2021-08-19,El Dorado,017,186661,13084,12410,1104,13514,118
2021-08-19,Fresno,019,978130,114114,110947,10034,120981,1759
2021-08-19,Glenn,021,27897,2743,2629,688,3317,20
2021-08-19,Humboldt,023,135768,6628,6246,154,6400,52
2021-08-19,Imperial,025,180216,30137,29865,3024,32889,747
2021-08-19,Inyo,027,18085,1503,1494,13,1507,39
2021-08-19,Kern,029,883053,105956,103731,13916,117647,1371
2021-08-19,Kings,031,150075,25889,25128,1360,26488,256
2021-08-19,Lake,033,64148,5183,4991,42,5033,69
2021-08-19,Lassen,035,31185,5635,5520,146,5666,21
2021-08-19,Los Angeles,037,10098052,1331715,1314453,49280,1363733,25020
2021-08-19,Madera,039,155013,18523,17947,1256,19203,246
2021-08-19,Marin,041,260295,16040,15672,326,15998,240
2021-08-19,Mariposa,043,17540,672,618,17,635,5
2021-08-19,Mendocino,045,87422,5505,5167,178,5345,51
2021-08-19,Merced,047,269075,34550,33851,1201,35052,486
2021-08-19,Modoc,049,8938,443,427,155,582,6
2021-08-19,Mono,051,14174,1385,1349,18,1367,3
2021-08-19,Monterey,053,433212,45456,44821,2267,47088,538
2021-08-19,Napa,055,140530,11344,11104,70,11174,83
2021-08-19,Nevada,057,99092,7051,6695,229,6924,77
2021-08-19,Orange,059,3164182,283058,278562,13072,291634,5172
2021-08-19,Placer,061,380077,29658,27953,2480,30433,313
2021-08-19,Plumas,063,18699,954,896,14,910,5
2021-08-19,Riverside,065,2383286,325518,318056,15235,333291,4589
2021-08-19,Sacramento,067,1510023,131998,126720,2741,129461,1801
2021-08-19,San Benito,069,59416,6597,6493,128,6621,64
2021-08-19,San Bernardino,071,2135413,321630,316398,9883,326281,5318
2021-08-19,San Diego,073,3302833,326197,319582,18860,338442,3839
2021-08-19,San Francisco,075,870044,46632,45220,1911,47131,571
2021-08-19,San Joaquin,077,732212,84855,82047,4398,86445,1491
2021-08-19,San Luis Obispo,079,281455,24678,23878,935,24813,271
2021-08-19,San Mateo,081,765935,48758,47431,701,48132,551
2021-08-19,Santa Barbara,083,443738,38604,37693,1401,39094,477
2021-08-19,Santa Clara,085,1922200,132483,129133,967,130100,1774
2021-08-19,Santa Cruz,087,273765,18098,17644,903,18547,209
2021-08-19,Shasta,089,179085,14781,14200,2060,16260,214
2021-08-19,Sierra,091,2930,93,83,13,96,0
2021-08-19,Siskiyou,093,43540,2348,2218,615,2833,33
2021-08-19,Solano,095,438530,40299,38025,946,38971,273
2021-08-19,Sonoma,097,501317,36652,35233,443,35676,336
2021-08-19,Stanislaus,099,539301,64540,62928,7155,70083,1047
2021-08-19,Sutter,101,95872,11409,11057,125,11182,133
2021-08-19,Tehama,103,63373,5892,5683,741,6424,66
2021-08-19,Trinity,105,12862,584,414,137,551,3
2021-08-19,Tulare,107,460477,54494,52685,10856,63541,856
2021-08-19,Tuolumne,109,53932,5246,5112,56,5168,64
2021-08-19,Ventura,111,848112,89462,88073,3851,91924,1060
2021-08-19,Yolo,113,214977,16741,16153,736,16889,225
2021-08-19,Yuba,115,75493,7765,7458,171,7629,51
2021-08-18,Alameda,001,1643700,106267,102696,2394,105090,1294
2021-08-18,Alpine,003,1148,90,91,0,91,0
2021-08-18,Amador,005,37829,4438,4279,38,4317,50
2021-08-18,Butte,007,227075,15032,14426,2420,16846,208
2021-08-18,Calaveras,009,45235,2793,2643,19,2662,59
2021-08-18,Colusa,011,21464,2235,2160,449,2609,16
2021-08-18,Contra Costa,013,1133247,86538,82767,1713,84480,851
2021-08-18,Del Norte,015,27424,2526,2219,16,2235,8
2021-08-18,El Dorado,017,186661,12994,12306,1090,13396,118
2021-08-18,Fresno,019,978130,113660,110523,9971,120494,1759
2021-08-18,Glenn,021,27897,2712,2623,680,3303,20
2021-08-18,Humboldt,023,135768,6556,6195,149,6344,52
2021-08-18,Imperial,025,180216,30104,29821,3022,32843,746
2021-08-18,Inyo,027,18085,1500,1494,13,1507,39
2021-08-18,Kern,029,883053,105609,103440,13821,117261,1370
2021-08-18,Kings,031,150075,25780,24984,1352,26336,256
2021-08-18,Lake,033,64148,5142,4957,41,4998,69
2021-08-18,Lassen,035,31185,5616,5506,145,5651,21
2021-08-18,Los Angeles,037,10098052,1328567,1311477,49148,1360625,24984
2021-08-18,Madera,039,155013,18463,17871,1243,19114,246
2021-08-18,Marin,041,260295,16002,15610,323,15933,240
2021-08-18,Mariposa,043,17540,659,615,16,631,5
2021-08-18,Mendocino,045,87422,5454,5129,175,5304,51
2021-08-18,Merced,047,269075,34385,33708,1190,34898,484
2021-08-18,Modoc,049,8938,443,427,154,581,6
2021-08-18,Mono,051,14174,1382,1344,18,1362,3
2021-08-18,Monterey,053,433212,45372,44735,2250,46985,532
2021-08-18,Napa,055,140530,11305,11060,69,11129,83
2021-08-18,Nevada,057,99092,6985,6633,229,6862,76
2021-08-18,Orange,059,3164182,282420,277795,13017,290812,5168
2021-08-18,Placer,061,380077,29432,27741,2452,30193,312
2021-08-18,Plumas,063,18699,945,874,14,888,5
2021-08-18,Riverside,065,2383286,324518,317107,15201,332308,4585
2021-08-18,Sacramento,067,1510023,131238,125599,2710,128309,1781
2021-08-18,San Benito,069,59416,6586,6481,127,6608,64
2021-08-18,San Bernardino,071,2135413,320829,315477,9864,325341,5304
2021-08-18,San Diego,073,3302833,324854,318152,18794,336946,3834
2021-08-18,San Francisco,075,870044,46429,44957,1901,46858,568
2021-08-18,San Joaquin,077,732212,84402,81601,4367,85968,1491
2021-08-18,San Luis Obispo,079,281455,24528,23726,924,24650,270
2021-08-18,San Mateo,081,765935,48592,47255,700,47955,551
2021-08-18,Santa Barbara,083,443738,38472,37599,1395,38994,475
2021-08-18,Santa Clara,085,1922200,132120,128563,964,129527,1773
2021-08-18,Santa Cruz,087,273765,18043,17566,899,18465,209
2021-08-18,Shasta,089,179085,14682,14087,2041,16128,213
2021-08-18,Sierra,091,2930,92,83,13,96,0
2021-08-18,Siskiyou,093,43540,2319,2204,603,2807,33
2021-08-18,Solano,095,438530,40093,37812,931,38743,271
2021-08-18,Sonoma,097,501317,36508,35063,442,35505,333
2021-08-18,Stanislaus,099,539301,64210,62613,7111,69724,1047
2021-08-18,Sutter,101,95872,11337,11004,120,11124,130
2021-08-18,Tehama,103,63373,5857,5653,731,6384,66
2021-08-18,Trinity,105,12862,577,409,134,543,3
2021-08-18,Tulare,107,460477,54254,52486,10787,63273,856
2021-08-18,Tuolumne,109,53932,5210,5081,54,5135,64
2021-08-18,Ventura,111,848112,89230,87835,3841,91676,1055
2021-08-18,Yolo,113,214977,16657,16047,717,16764,225
2021-08-18,Yuba,115,75493,7700,7391,171,7562,51
2021-08-17,Alameda,001,1643700,105860,102379,2378,104757,1290
2021-08-17,Alpine,003,1148,90,91,0,91,0
2021-08-17,Amador,005,37829,4409,4266,38,4304,50
2021-08-17,Butte,007,227075,14925,14357,2386,16743,206
2021-08-17,Calaveras,009,45235,2759,2624,19,2643,59
2021-08-17,Colusa,011,21464,2226,2156,445,2601,16
2021-08-17,Contra Costa,013,1133247,86091,82482,1702,84184,848
2021-08-17,Del Norte,015,27424,2472,2188,16,2204,8
2021-08-17,El Dorado,017,186661,12906,12242,1076,13318,118
2021-08-17,Fresno,019,978130,113177,110263,9907,120170,1755
2021-08-17,Glenn,021,27897,2698,2608,673,3281,20
2021-08-17,Humboldt,023,135768,6478,6155,147,6302,52
2021-08-17,Imperial,025,180216,30053,29768,3018,32786,746
2021-08-17,Inyo,027,18085,1497,1492,13,1505,39
2021-08-17,Kern,029,883053,105213,103048,13697,116745,1367
2021-08-17,Kings,031,150075,25674,24930,1341,26271,254
2021-08-17,Lake,033,64148,5099,4930,35,4965,68
2021-08-17,Lassen,035,31185,5599,5499,143,5642,21
2021-08-17,Los Angeles,037,10098052,1325022,1307999,49016,1357015,24952
2021-08-17,Madera,039,155013,18389,17838,1223,19061,246
2021-08-17,Marin,041,260295,15946,15570,323,15893,240
2021-08-17,Mariposa,043,17540,651,609,15,624,5
2021-08-17,Mendocino,045,87422,5399,5097,175,5272,51
2021-08-17,Merced,047,269075,34235,33508,1180,34688,482
2021-08-17,Modoc,049,8938,440,424,152,576,6
2021-08-17,Mono,051,14174,1377,1341,18,1359,3
2021-08-17,Monterey,053,433212,45289,44672,2240,46912,528
2021-08-17,Napa,055,140530,11264,11007,68,11075,83
2021-08-17,Nevada,057,99092,6910,6605,227,6832,75
2021-08-17,Orange,059,3164182,281772,277121,12981,290102,5164
2021-08-17,Placer,061,380077,29217,27634,2423,30057,312
2021-08-17,Plumas,063,18699,933,860,14,874,5
2021-08-17,Riverside,065,2383286,323506,316051,15158,331209,4582
2021-08-17,Sacramento,067,1510023,130445,125151,2667,127818,1774
2021-08-17,San Benito,069,59416,6567,6470,127,6597,64
2021-08-17,San Bernardino,071,2135413,319893,314402,9824,324226,5302
2021-08-17,San Diego,073,3302833,323241,317058,18697,335755,3824
2021-08-17,San Francisco,075,870044,46229,44820,1895,46715,567
2021-08-17,San Joaquin,077,732212,83933,81300,4334,85634,1489
2021-08-17,San Luis Obispo,079,281455,24372,23556,921,24477,268
2021-08-17,San Mateo,081,765935,48434,47127,695,47822,551
2021-08-17,Santa Barbara,083,443738,38314,37478,1387,38865,475
2021-08-17,Santa Clara,085,1922200,131718,128354,959,129313,1773
2021-08-17,Santa Cruz,087,273765,17957,17528,898,18426,209
2021-08-17,Shasta,089,179085,14550,14012,2022,16034,214
2021-08-17,Sierra,091,2930,91,82,13,95,0
2021-08-17,Siskiyou,093,43540,2303,2183,590,2773,33
2021-08-17,Solano,095,438530,39864,37662,918,38580,269
2021-08-17,Sonoma,097,501317,36360,34943,438,35381,333
2021-08-17,Stanislaus,099,539301,63873,62385,7051,69436,1047
2021-08-17,Sutter,101,95872,11265,10973,120,11093,130
2021-08-17,Tehama,103,63373,5823,5612,709,6321,66
2021-08-17,Trinity,105,12862,572,406,131,537,3
2021-08-17,Tulare,107,460477,53985,52362,10719,63081,856
2021-08-17,Tuolumne,109,53932,5167,5042,53,5095,64
2021-08-17,Ventura,111,848112,88992,87601,3820,91421,1053
2021-08-17,Yolo,113,214977,16568,15975,703,16678,225
2021-08-17,Yuba,115,75493,7629,7355,171,7526,51
2021-08-16,Alameda,001,1643700,105359,102052,2366,104418,1287
2021-08-16,Alpine,003,1148,90,91,0,91,0
2021-08-16,Amador,005,37829,4399,4235,38,4273,50
2021-08-16,Butte,007,227075,14807,14283,2352,16635,206
2021-08-16,Calaveras,009,45235,2700,2609,18,2627,57
2021-08-16,Colusa,011,21464,2215,2147,441,2588,16
2021-08-16,Contra Costa,013,1133247,85548,82070,1692,83762,848
2021-08-16,Del Norte,015,27424,2395,2125,16,2141,8
2021-08-16,El Dorado,017,186661,12804,12139,1063,13202,118
2021-08-16,Fresno,019,978130,112676,109623,9855,119478,1753
2021-08-16,Glenn,021,27897,2679,2593,667,3260,20
2021-08-16,Humboldt,023,135768,6407,6064,125,6189,52
2021-08-16,Imperial,025,180216,30013,29737,3002,32739,746
2021-08-16,Inyo,027,18085,1494,1490,13,1503,39
2021-08-16,Kern,029,883053,104838,102690,13581,116271,1367
2021-08-16,Kings,031,150075,25572,24817,1331,26148,254
2021-08-16,Lake,033,64148,5072,4898,34,4932,68
2021-08-16,Lassen,035,31185,5583,5481,135,5616,21
2021-08-16,Los Angeles,037,10098052,1321644,1305330,48870,1354200,24923
2021-08-16,Madera,039,155013,18314,17756,1202,18958,246
2021-08-16,Marin,041,260295,15887,15497,321,15818,239
2021-08-16,Mariposa,043,17540,634,597,15,612,5
2021-08-16,Mendocino,045,87422,5343,5037,173,5210,49
2021-08-16,Merced,047,269075,34033,33364,1168,34532,481
2021-08-16,Modoc,049,8938,438,421,151,572,5
2021-08-16,Mono,051,14174,1372,1339,18,1357,3
2021-08-16,Monterey,053,433212,45210,44595,2228,46823,527
2021-08-16,Napa,055,140530,11235,10946,68,11014,83
2021-08-16,Nevada,057,99092,6855,6535,226,6761,74
2021-08-16,Orange,059,3164182,280979,275985,12936,288921,5161
2021-08-16,Placer,061,380077,29034,27384,2390,29774,306
2021-08-16,Plumas,063,18699,922,851,14,865,5
2021-08-16,Riverside,065,2383286,322415,314774,15121,329895,4582
2021-08-16,Sacramento,067,1510023,129635,124554,2624,127178,1762
2021-08-16,San Benito,069,59416,6543,6452,127,6579,64
2021-08-16,San Bernardino,071,2135413,318931,313617,9797,323414,5301
2021-08-16,San Diego,073,3302833,321636,315348,18563,333911,3824
2021-08-16,San Francisco,075,870044,46026,44681,1886,46567,567
2021-08-16,San Joaquin,077,732212,83430,81087,4307,85394,1488
2021-08-16,San Luis Obispo,079,281455,24222,23452,913,24365,265
2021-08-16,San Mateo,081,765935,48253,47024,688,47712,548
2021-08-16,Santa Barbara,083,443738,38144,37358,1382,38740,475
2021-08-16,Santa Clara,085,1922200,131253,127978,955,128933,1773
2021-08-16,Santa Cruz,087,273765,17895,17491,892,18383,209
2021-08-16,Shasta,089,179085,14459,13862,2005,15867,211
2021-08-16,Sierra,091,2930,88,82,13,95,0
2021-08-16,Siskiyou,093,43540,2286,2169,570,2739,33
2021-08-16,Solano,095,438530,39583,37436,904,38340,263
2021-08-16,Sonoma,097,501317,36190,34844,436,35280,333
2021-08-16,Stanislaus,099,539301,63534,62033,6999,69032,1039
2021-08-16,Sutter,101,95872,11196,10902,119,11021,130
2021-08-16,Tehama,103,63373,5760,5565,704,6269,66
2021-08-16,Trinity,105,12862,566,400,130,530,3
2021-08-16,Tulare,107,460477,53742,52162,10649,62811,856
2021-08-16,Tuolumne,109,53932,5128,4984,52,5036,64
2021-08-16,Ventura,111,848112,88747,86954,3802,90756,1052
2021-08-16,Yolo,113,214977,16467,15922,695,16617,225
2021-08-16,Yuba,115,75493,7545,7314,170,7484,51
2021-08-15,Alameda,001,1643700,104867,101660,2349,104009,1287
2021-08-15,Alpine,003,1148,90,91,0,91,0
2021-08-15,Amador,005,37829,4371,4231,38,4269,49
2021-08-15,Butte,007,227075,14682,14263,2328,16591,206
2021-08-15,Calaveras,009,45235,2658,2599,18,2617,57
2021-08-15,Colusa,011,21464,2203,2140,431,2571,16
2021-08-15,Contra Costa,013,1133247,85064,81781,1677,83458,848
2021-08-15,Del Norte,015,27424,2328,2060,16,2076,8
2021-08-15,El Dorado,017,186661,12669,12057,1046,13103,118
2021-08-15,Fresno,019,978130,112199,109382,9791,119173,1753
2021-08-15,Glenn,021,27897,2655,2592,655,3247,20
2021-08-15,Humboldt,023,135768,6332,6024,119,6143,52
2021-08-15,Imperial,025,180216,29947,29711,2997,32708,746
2021-08-15,Inyo,027,18085,1493,1489,13,1502,39
2021-08-15,Kern,029,883053,104394,102524,13468,115992,1367
2021-08-15,Kings,031,150075,25427,24736,1321,26057,254
2021-08-15,Lake,033,64148,5013,4886,33,4919,68
2021-08-15,Lassen,035,31185,5566,5482,134,5616,21
2021-08-15,Los Angeles,037,10098052,1318112,1302882,48697,1351579,24918
2021-08-15,Madera,039,155013,18226,17714,1186,18900,246
2021-08-15,Marin,041,260295,15828,15461,319,15780,239
2021-08-15,Mariposa,043,17540,627,591,14,605,5
2021-08-15,Mendocino,045,87422,5287,5022,167,5189,49
2021-08-15,Merced,047,269075,33789,33305,1157,34462,481
2021-08-15,Modoc,049,8938,436,421,151,572,5
2021-08-15,Mono,051,14174,1368,1334,18,1352,3
2021-08-15,Monterey,053,433212,45088,44567,2206,46773,527
2021-08-15,Napa,055,140530,11180,10919,68,10987,83
2021-08-15,Nevada,057,99092,6770,6486,226,6712,74
2021-08-15,Orange,059,3164182,280208,275447,12895,288342,5161
2021-08-15,Placer,061,380077,28812,27220,2342,29562,306
2021-08-15,Plumas,063,18699,910,850,14,864,5
2021-08-15,Riverside,065,2383286,321276,314133,15093,329226,4582
2021-08-15,Sacramento,067,1510023,128818,123924,2592,126516,1761
2021-08-15,San Benito,069,59416,6525,6446,126,6572,64
2021-08-15,San Bernardino,071,2135413,317857,313120,9765,322885,5301
2021-08-15,San Diego,073,3302833,320164,314247,18438,332685,3824
2021-08-15,San Francisco,075,870044,45801,44531,1869,46400,567
2021-08-15,San Joaquin,077,732212,82941,80832,4267,85099,1488
2021-08-15,San Luis Obispo,079,281455,24025,23404,903,24307,265
2021-08-15,San Mateo,081,765935,48066,46897,682,47579,548
2021-08-15,Santa Barbara,083,443738,37973,37276,1375,38651,475
2021-08-15,Santa Clara,085,1922200,130820,127715,949,128664,1773
2021-08-15,Santa Cruz,087,273765,17825,17440,885,18325,209
2021-08-15,Shasta,089,179085,14356,13835,1980,15815,211
2021-08-15,Sierra,091,2930,87,82,12,94,0
2021-08-15,Siskiyou,093,43540,2265,2169,556,2725,33
2021-08-15,Solano,095,438530,39328,37320,893,38213,263
2021-08-15,Sonoma,097,501317,35994,34706,428,35134,333
2021-08-15,Stanislaus,099,539301,63167,61795,6921,68716,1039
2021-08-15,Sutter,101,95872,11105,10863,119,10982,130
2021-08-15,Tehama,103,63373,5712,5550,698,6248,66
2021-08-15,Trinity,105,12862,562,400,129,529,3
2021-08-15,Tulare,107,460477,53484,52046,10589,62635,856
2021-08-15,Tuolumne,109,53932,5090,4934,50,4984,64
2021-08-15,Ventura,111,848112,88442,86797,3788,90585,1052
2021-08-15,Yolo,113,214977,16370,15873,685,16558,225
2021-08-15,Yuba,115,75493,7468,7265,169,7434,51
2021-08-14,Alameda,001,1643700,104653,101305,2345,103650,1287
2021-08-14,Alpine,003,1148,90,91,0,91,0
2021-08-14,Amador,005,37829,4353,4206,38,4244,49
2021-08-14,Butte,007,227075,14645,14192,2312,16504,206
2021-08-14,Calaveras,009,45235,2651,2579,18,2597,57
2021-08-14,Colusa,011,21464,2192,2134,427,2561,16
2021-08-14,Contra Costa,013,1133247,84815,81458,1669,83127,848
2021-08-14,Del Norte,015,27424,2301,2015,16,2031,8
2021-08-14,El Dorado,017,186661,12633,12019,1038,13057,118
2021-08-14,Fresno,019,978130,112038,109056,9762,118818,1753
2021-08-14,Glenn,021,27897,2644,2583,653,3236,20
2021-08-14,Humboldt,023,135768,6278,5998,115,6113,52
2021-08-14,Imperial,025,180216,29920,29671,2997,32668,746
2021-08-14,Inyo,027,18085,1491,1487,13,1500,39
2021-08-14,Kern,029,883053,104199,102306,13372,115678,1367
2021-08-14,Kings,031,150075,25329,24647,1312,25959,254
2021-08-14,Lake,033,64148,4996,4850,32,4882,68
2021-08-14,Lassen,035,31185,5559,5475,133,5608,21
2021-08-14,Los Angeles,037,10098052,1316340,1299346,48558,1347904,24911
2021-08-14,Madera,039,155013,18179,17691,1181,18872,246
2021-08-14,Marin,041,260295,15794,15441,319,15760,239
2021-08-14,Mariposa,043,17540,623,584,14,598,5
2021-08-14,Mendocino,045,87422,5251,4977,164,5141,49
2021-08-14,Merced,047,269075,33725,33234,1151,34385,481
2021-08-14,Modoc,049,8938,436,421,151,572,5
2021-08-14,Mono,051,14174,1363,1332,18,1350,3
2021-08-14,Monterey,053,433212,45044,44514,2203,46717,527
2021-08-14,Napa,055,140530,11150,10878,67,10945,83
2021-08-14,Nevada,057,99092,6735,6419,225,6644,74
2021-08-14,Orange,059,3164182,279774,274732,12867,287599,5161
2021-08-14,Placer,061,380077,28666,27115,2318,29433,306
2021-08-14,Plumas,063,18699,900,849,14,863,5
2021-08-14,Riverside,065,2383286,320561,313264,15072,328336,4582
2021-08-14,Sacramento,067,1510023,128324,123438,2574,126012,1758
2021-08-14,San Benito,069,59416,6512,6428,126,6554,64
2021-08-14,San Bernardino,071,2135413,317308,312142,9744,321886,5301
2021-08-14,San Diego,073,3302833,319494,313589,18370,331959,3824
2021-08-14,San Francisco,075,870044,45671,44353,1850,46203,567
2021-08-14,San Joaquin,077,732212,82725,80585,4252,84837,1488
2021-08-14,San Luis Obispo,079,281455,23964,23328,900,24228,265
2021-08-14,San Mateo,081,765935,47947,46792,678,47470,548
2021-08-14,Santa Barbara,083,443738,37878,37118,1372,38490,475
2021-08-14,Santa Clara,085,1922200,130541,127432,946,128378,1772
2021-08-14,Santa Cruz,087,273765,17786,17384,884,18268,209
2021-08-14,Shasta,089,179085,14281,13813,1959,15772,211
2021-08-14,Sierra,091,2930,86,81,12,93,0
2021-08-14,Siskiyou,093,43540,2255,2160,546,2706,33
2021-08-14,Solano,095,438530,39241,37237,881,38118,263
2021-08-14,Sonoma,097,501317,35871,34606,426,35032,333
2021-08-14,Stanislaus,099,539301,62993,61564,6876,68440,1039
2021-08-14,Sutter,101,95872,11060,10808,118,10926,130
2021-08-14,Tehama,103,63373,5688,5530,694,6224,66
2021-08-14,Trinity,105,12862,556,399,129,528,3
2021-08-14,Tulare,107,460477,53348,51951,10543,62494,856
2021-08-14,Tuolumne,109,53932,5055,4924,50,4974,64
2021-08-14,Ventura,111,848112,88285,86569,3768,90337,1052
2021-08-14,Yolo,113,214977,16325,15815,675,16490,225
2021-08-14,Yuba,115,75493,7419,7223,169,7392,51
2021-08-13,Alameda,001,1643700,104354,100930,2337,103267,1284
2021-08-13,Alpine,003,1148,90,91,0,91,0
2021-08-13,Amador,005,37829,4325,4169,38,4207,49
2021-08-13,Butte,007,227075,14574,14100,2296,16396,206
2021-08-13,Calaveras,009,45235,2644,2564,18,2582,57
2021-08-13,Colusa,011,21464,2185,2123,422,2545,16
2021-08-13,Contra Costa,013,1133247,84503,81046,1661,82707,848
2021-08-13,Del Norte,015,27424,2260,1973,16,1989,8
2021-08-13,El Dorado,017,186661,12594,11951,1026,12977,118
2021-08-13,Fresno,019,978130,111748,108638,9738,118376,1753
2021-08-13,Glenn,021,27897,2633,2574,651,3225,20
2021-08-13,Humboldt,023,135768,6231,5882,112,5994,52
2021-08-13,Imperial,025,180216,29893,29654,2996,32650,745
2021-08-13,Inyo,027,18085,1490,1484,13,1497,39
2021-08-13,Kern,029,883053,103991,102029,13263,115292,1364
2021-08-13,Kings,031,150075,25244,24531,1305,25836,253
2021-08-13,Lake,033,64148,4973,4811,31,4842,68
2021-08-13,Lassen,035,31185,5551,5455,132,5587,21
2021-08-13,Los Angeles,037,10098052,1314026,1295406,48422,1343828,24891
2021-08-13,Madera,039,155013,18130,17614,1172,18786,246
2021-08-13,Marin,041,260295,15764,15380,319,15699,239
2021-08-13,Mariposa,043,17540,617,577,14,591,5
2021-08-13,Mendocino,045,87422,5198,4924,162,5086,49
2021-08-13,Merced,047,269075,33677,33111,1146,34257,480
2021-08-13,Modoc,049,8938,435,421,150,571,5
2021-08-13,Mono,051,14174,1360,1331,18,1349,3
2021-08-13,Monterey,053,433212,44984,44450,2201,46651,527
2021-08-13,Napa,055,140530,11114,10830,67,10897,83
2021-08-13,Nevada,057,99092,6694,6356,224,6580,74
2021-08-13,Orange,059,3164182,279279,274004,12818,286822,5159
2021-08-13,Placer,061,380077,28566,26987,2291,29278,306
2021-08-13,Plumas,063,18699,886,842,14,856,5
2021-08-13,Riverside,065,2383286,319823,312408,15047,327455,4581
2021-08-13,Sacramento,067,1510023,127854,122868,2546,125414,1758
2021-08-13,San Benito,069,59416,6506,6422,124,6546,64
2021-08-13,San Bernardino,071,2135413,316640,311378,9725,321103,5301
2021-08-13,San Diego,073,3302833,318448,312293,18292,330585,3821
2021-08-13,San Francisco,075,870044,45534,44196,1827,46023,567
2021-08-13,San Joaquin,077,732212,82508,80232,4236,84468,1481
2021-08-13,San Luis Obispo,079,281455,23901,23226,897,24123,265
2021-08-13,San Mateo,081,765935,47826,46660,677,47337,548
2021-08-13,Santa Barbara,083,443738,37793,37023,1368,38391,474
2021-08-13,Santa Clara,085,1922200,130254,126958,941,127899,1769
2021-08-13,Santa Cruz,087,273765,17747,17332,877,18209,209
2021-08-13,Shasta,089,179085,14218,13698,1945,15643,211
2021-08-13,Sierra,091,2930,85,81,12,93,0
2021-08-13,Siskiyou,093,43540,2246,2147,542,2689,33
2021-08-13,Solano,095,438530,39107,37104,873,37977,264
2021-08-13,Sonoma,097,501317,35766,34464,426,34890,333
2021-08-13,Stanislaus,099,539301,62823,61294,6834,68128,1039
2021-08-13,Sutter,101,95872,11016,10751,117,10868,130
2021-08-13,Tehama,103,63373,5664,5496,692,6188,66
2021-08-13,Trinity,105,12862,552,392,129,521,3
2021-08-13,Tulare,107,460477,53244,51770,10469,62239,856
2021-08-13,Tuolumne,109,53932,5022,4899,49,4948,64
2021-08-13,Ventura,111,848112,88127,86368,3755,90123,1052
2021-08-13,Yolo,113,214977,16272,15761,665,16426,225
2021-08-13,Yuba,115,75493,7381,7184,169,7353,51
2021-08-12,Alameda,001,1643700,103857,100472,2324,102796,1284
2021-08-12,Alpine,003,1148,90,91,0,91,0
2021-08-12,Amador,005,37829,4295,4161,37,4198,49
2021-08-12,Butte,007,227075,14496,14006,2278,16284,206
2021-08-12,Calaveras,009,45235,2627,2531,18,2549,57
2021-08-12,Colusa,011,21464,2180,2111,421,2532,17
2021-08-12,Contra Costa,013,1133247,84021,80738,1646,82384,846
2021-08-12,Del Norte,015,27424,2188,1923,16,1939,8
2021-08-12,El Dorado,017,186661,12480,11880,1018,12898,118
2021-08-12,Fresno,019,978130,111331,108193,9671,117864,1753
2021-08-12,Glenn,021,27897,2625,2559,645,3204,20
2021-08-12,Humboldt,023,135768,6161,5845,108,5953,52
2021-08-12,Imperial,025,180216,29837,29585,2990,32575,745
2021-08-12,Inyo,027,18085,1488,1483,13,1496,39
2021-08-12,Kern,029,883053,103702,101698,13183,114881,1364
2021-08-12,Kings,031,150075,25144,24423,1296,25719,252
2021-08-12,Lake,033,64148,4947,4774,31,4805,68
2021-08-12,Lassen,035,31185,5529,5428,131,5559,21
2021-08-12,Los Angeles,037,10098052,1310836,1291875,48287,1340162,24874
2021-08-12,Madera,039,155013,18066,17564,1160,18724,246
2021-08-12,Marin,041,260295,15715,15277,315,15592,239
2021-08-12,Mariposa,043,17540,608,568,13,581,5
2021-08-12,Mendocino,045,87422,5168,4873,156,5029,49
2021-08-12,Merced,047,269075,33553,32960,1139,34099,480
2021-08-12,Modoc,049,8938,434,423,150,573,5
2021-08-12,Mono,051,14174,1355,1325,18,1343,3
2021-08-12,Monterey,053,433212,44908,44383,2184,46567,527
2021-08-12,Napa,055,140530,11065,10780,66,10846,83
2021-08-12,Nevada,057,99092,6633,6283,224,6507,74
2021-08-12,Orange,059,3164182,278601,273167,12760,285927,5158
2021-08-12,Placer,061,380077,28366,26856,2268,29124,306
2021-08-12,Plumas,063,18699,878,829,14,843,5
2021-08-12,Riverside,065,2383286,318813,311304,15014,326318,4575
2021-08-12,Sacramento,067,1510023,127082,122222,2516,124738,1758
2021-08-12,San Benito,069,59416,6489,6398,122,6520,64
2021-08-12,San Bernardino,071,2135413,315766,310420,9696,320116,5297
2021-08-12,San Diego,073,3302833,317077,310596,18206,328802,3821
2021-08-12,San Francisco,075,870044,45326,43774,1814,45588,564
2021-08-12,San Joaquin,077,732212,82112,79945,4213,84158,1479
2021-08-12,San Luis Obispo,079,281455,23800,23101,884,23985,264
2021-08-12,San Mateo,081,765935,47682,46435,674,47109,548
2021-08-12,Santa Barbara,083,443738,37654,36881,1360,38241,473
2021-08-12,Santa Clara,085,1922200,129805,126614,935,127549,1769
2021-08-12,Santa Cruz,087,273765,17683,17261,876,18137,209
2021-08-12,Shasta,089,179085,14132,13621,1918,15539,211
2021-08-12,Sierra,091,2930,85,81,12,93,0
2021-08-12,Siskiyou,093,43540,2239,2134,532,2666,33
2021-08-12,Solano,095,438530,38878,36980,864,37844,262
2021-08-12,Sonoma,097,501317,35618,34299,423,34722,333
2021-08-12,Stanislaus,099,539301,62560,61026,6775,67801,1039
2021-08-12,Sutter,101,95872,10955,10695,115,10810,130
2021-08-12,Tehama,103,63373,5634,5462,683,6145,66
2021-08-12,Trinity,105,12862,548,386,128,514,3
2021-08-12,Tulare,107,460477,53098,51632,10419,62051,856
2021-08-12,Tuolumne,109,53932,4975,4845,47,4892,64
2021-08-12,Ventura,111,848112,87891,86106,3731,89837,1052
2021-08-12,Yolo,113,214977,16200,15686,651,16337,224
2021-08-12,Yuba,115,75493,7333,7128,168,7296,51
2021-08-11,Alameda,001,1643700,103338,100040,2320,102360,1281
2021-08-11,Alpine,003,1148,90,91,0,91,0
2021-08-11,Amador,005,37829,4271,4127,37,4164,49
2021-08-11,Butte,007,227075,14392,13905,2253,16158,206
2021-08-11,Calaveras,009,45235,2605,2505,18,2523,57
2021-08-11,Colusa,011,21464,2170,2101,419,2520,16
2021-08-11,Contra Costa,013,1133247,83519,80275,1628,81903,843
2021-08-11,Del Norte,015,27424,2129,1893,16,1909,8
2021-08-11,El Dorado,017,186661,12367,11799,1006,12805,119
2021-08-11,Fresno,019,978130,110875,107773,9624,117397,1751
2021-08-11,Glenn,021,27897,2616,2547,638,3185,20
2021-08-11,Humboldt,023,135768,6114,5765,107,5872,52
2021-08-11,Imperial,025,180216,29794,29565,2986,32551,745
2021-08-11,Inyo,027,18085,1488,1483,13,1496,39
2021-08-11,Kern,029,883053,103388,101448,13073,114521,1363
2021-08-11,Kings,031,150075,25031,24304,1287,25591,250
2021-08-11,Lake,033,64148,4910,4713,30,4743,68
2021-08-11,Lassen,035,31185,5520,5408,129,5537,21
2021-08-11,Los Angeles,037,10098052,1307516,1288238,48099,1336337,24851
2021-08-11,Madera,039,155013,18015,17511,1149,18660,245
2021-08-11,Marin,041,260295,15666,15235,315,15550,239
2021-08-11,Mariposa,043,17540,598,554,12,566,5
2021-08-11,Mendocino,045,87422,5099,4796,147,4943,49
2021-08-11,Merced,047,269075,33420,32802,1135,33937,479
2021-08-11,Modoc,049,8938,434,421,150,571,5
2021-08-11,Mono,051,14174,1350,1320,18,1338,3
2021-08-11,Monterey,053,433212,44809,44314,2166,46480,527
2021-08-11,Napa,055,140530,11024,10732,66,10798,83
2021-08-11,Nevada,057,99092,6579,6172,221,6393,74
2021-08-11,Orange,059,3164182,277744,272212,12713,284925,5155
2021-08-11,Placer,061,380077,28154,26687,2242,28929,305
2021-08-11,Plumas,063,18699,868,824,14,838,5
2021-08-11,Riverside,065,2383286,317820,310265,14979,325244,4570
2021-08-11,Sacramento,067,1510023,126289,121603,2474,124077,1757
2021-08-11,San Benito,069,59416,6476,6381,122,6503,64
2021-08-11,San Bernardino,071,2135413,314873,309498,9674,319172,5296
2021-08-11,San Diego,073,3302833,315603,309406,18105,327511,3818
2021-08-11,San Francisco,075,870044,45102,43555,1806,45361,564
2021-08-11,San Joaquin,077,732212,81704,79641,4185,83826,1478
2021-08-11,San Luis Obispo,079,281455,23696,22920,877,23797,264
2021-08-11,San Mateo,081,765935,47514,46300,671,46971,548
2021-08-11,Santa Barbara,083,443738,37490,36699,1351,38050,472
2021-08-11,Santa Clara,085,1922200,129324,126301,927,127228,1769
2021-08-11,Santa Cruz,087,273765,17617,17191,873,18064,209
2021-08-11,Shasta,089,179085,14058,13546,1902,15448,211
2021-08-11,Sierra,091,2930,84,81,12,93,0
2021-08-11,Siskiyou,093,43540,2225,2124,525,2649,33
2021-08-11,Solano,095,438530,38642,36862,850,37712,262
2021-08-11,Sonoma,097,501317,35441,34188,418,34606,333
2021-08-11,Stanislaus,099,539301,62229,60767,6745,67512,1037
2021-08-11,Sutter,101,95872,10883,10628,115,10743,130
2021-08-11,Tehama,103,63373,5604,5410,666,6076,66
2021-08-11,Trinity,105,12862,546,385,128,513,3
2021-08-11,Tulare,107,460477,52930,51464,10374,61838,854
2021-08-11,Tuolumne,109,53932,4943,4794,47,4841,64
2021-08-11,Ventura,111,848112,87639,85863,3710,89573,1051
2021-08-11,Yolo,113,214977,16125,15593,637,16230,218
2021-08-11,Yuba,115,75493,7274,7063,167,7230,53
2021-08-10,Alameda,001,1643700,102854,99771,2312,102083,1281
2021-08-10,Alpine,003,1148,90,91,0,91,0
2021-08-10,Amador,005,37829,4255,4093,37,4130,49
2021-08-10,Butte,007,227075,14308,13853,2231,16084,205
2021-08-10,Calaveras,009,45235,2578,2491,16,2507,57
2021-08-10,Colusa,011,21464,2157,2088,410,2498,16
2021-08-10,Contra Costa,013,1133247,82975,80018,1618,81636,840
2021-08-10,Del Norte,015,27424,2085,1870,16,1886,8
2021-08-10,El Dorado,017,186661,12268,11734,996,12730,117
2021-08-10,Fresno,019,978130,110421,107616,9571,117187,1747
2021-08-10,Glenn,021,27897,2603,2538,629,3167,20
2021-08-10,Humboldt,023,135768,6060,5718,104,5822,52
2021-08-10,Imperial,025,180216,29759,29522,2980,32502,745
2021-08-10,Inyo,027,18085,1488,1482,13,1495,39
2021-08-10,Kern,029,883053,103059,101254,12977,114231,1359
2021-08-10,Kings,031,150075,24904,24252,1271,25523,251
2021-08-10,Lake,033,64148,4869,4700,30,4730,67
2021-08-10,Lassen,035,31185,5502,5401,129,5530,21
2021-08-10,Los Angeles,037,10098052,1303768,1285140,47935,1333075,24821
2021-08-10,Madera,039,155013,17942,17481,1139,18620,245
2021-08-10,Marin,041,260295,15619,15194,315,15509,239
2021-08-10,Mariposa,043,17540,585,550,12,562,5
2021-08-10,Mendocino,045,87422,5054,4775,143,4918,49
2021-08-10,Merced,047,269075,33272,32721,1127,33848,477
2021-08-10,Modoc,049,8938,433,421,150,571,5
2021-08-10,Mono,051,14174,1345,1320,18,1338,3
2021-08-10,Monterey,053,433212,44747,44259,2151,46410,527
2021-08-10,Napa,055,140530,10968,10703,65,10768,83
2021-08-10,Nevada,057,99092,6514,6151,220,6371,73
2021-08-10,Orange,059,3164182,276864,271688,12665,284353,5155
2021-08-10,Placer,061,380077,27935,26561,2200,28761,305
2021-08-10,Plumas,063,18699,859,816,14,830,5
2021-08-10,Riverside,065,2383286,316705,309529,14953,324482,4564
2021-08-10,Sacramento,067,1510023,125436,121159,2444,123603,1755
2021-08-10,San Benito,069,59416,6462,6371,122,6493,64
2021-08-10,San Bernardino,071,2135413,313951,308672,9657,318329,5295
2021-08-10,San Diego,073,3302833,313945,308288,18029,326317,3815
2021-08-10,San Francisco,075,870044,44849,43389,1791,45180,564
2021-08-10,San Joaquin,077,732212,81306,79391,4168,83559,1478
2021-08-10,San Luis Obispo,079,281455,23570,22776,875,23651,264
2021-08-10,San Mateo,081,765935,47341,46184,669,46853,548
2021-08-10,Santa Barbara,083,443738,37325,36574,1344,37918,472
2021-08-10,Santa Clara,085,1922200,128861,126019,920,126939,1770
2021-08-10,Santa Cruz,087,273765,17534,17142,871,18013,209
2021-08-10,Shasta,089,179085,13980,13461,1878,15339,211
2021-08-10,Sierra,091,2930,84,76,12,88,0
2021-08-10,Siskiyou,093,43540,2216,2088,518,2606,33
2021-08-10,Solano,095,438530,38397,36767,839,37606,262
2021-08-10,Sonoma,097,501317,35296,34054,415,34469,333
2021-08-10,Stanislaus,099,539301,61883,60605,6708,67313,1037
2021-08-10,Sutter,101,95872,10818,10569,115,10684,130
2021-08-10,Tehama,103,63373,5575,5392,661,6053,66
2021-08-10,Trinity,105,12862,546,384,128,512,3
2021-08-10,Tulare,107,460477,52765,51390,10322,61712,854
2021-08-10,Tuolumne,109,53932,4913,4780,45,4825,64
2021-08-10,Ventura,111,848112,87349,85714,3689,89403,1051
2021-08-10,Yolo,113,214977,16038,15568,627,16195,218
2021-08-10,Yuba,115,75493,7224,7028,167,7195,50
2021-08-09,Alameda,001,1643700,102292,99496,2307,101803,1276
2021-08-09,Alpine,003,1148,90,91,0,91,0
2021-08-09,Amador,005,37829,4229,4078,37,4115,48
2021-08-09,Butte,007,227075,14213,13813,2200,16013,205
2021-08-09,Calaveras,009,45235,2552,2472,16,2488,57
2021-08-09,Colusa,011,21464,2147,2075,402,2477,16
2021-08-09,Contra Costa,013,1133247,82429,79740,1606,81346,840
2021-08-09,Del Norte,015,27424,2017,1848,16,1864,8
2021-08-09,El Dorado,017,186661,12160,11672,982,12654,117
2021-08-09,Fresno,019,978130,109927,107310,9532,116842,1747
2021-08-09,Glenn,021,27897,2592,2532,619,3151,20
2021-08-09,Humboldt,023,135768,5969,5632,102,5734,52
2021-08-09,Imperial,025,180216,29715,29512,2974,32486,745
2021-08-09,Inyo,027,18085,1488,1481,13,1494,39
2021-08-09,Kern,029,883053,102748,101069,12891,113960,1359
2021-08-09,Kings,031,150075,24796,24155,1256,25411,250
2021-08-09,Lake,033,64148,4834,4670,28,4698,66
2021-08-09,Lassen,035,31185,5480,5393,128,5521,21
2021-08-09,Los Angeles,037,10098052,1299771,1282891,47742,1330633,24798
2021-08-09,Madera,039,155013,17883,17429,1119,18548,245
2021-08-09,Marin,041,260295,15566,15154,314,15468,239
2021-08-09,Mariposa,043,17540,572,545,12,557,5
2021-08-09,Mendocino,045,87422,5003,4732,135,4867,49
2021-08-09,Merced,047,269075,33126,32666,1120,33786,477
2021-08-09,Modoc,049,8938,433,419,150,569,5
2021-08-09,Mono,051,14174,1342,1337,18,1355,3
2021-08-09,Monterey,053,433212,44674,44190,2135,46325,527
2021-08-09,Napa,055,140530,10921,10679,65,10744,83
2021-08-09,Nevada,057,99092,6443,6088,219,6307,73
2021-08-09,Orange,059,3164182,275827,271036,12613,283649,5153
2021-08-09,Placer,061,380077,27712,26457,2169,28626,305
2021-08-09,Plumas,063,18699,842,803,14,817,5
2021-08-09,Riverside,065,2383286,315628,308678,14933,323611,4562
2021-08-09,Sacramento,067,1510023,124601,120812,2419,123231,1748
2021-08-09,San Benito,069,59416,6442,6359,120,6479,63
2021-08-09,San Bernardino,071,2135413,312967,308038,9633,317671,5295
2021-08-09,San Diego,073,3302833,312281,306855,17933,324788,3811
2021-08-09,San Francisco,075,870044,44604,43261,1773,45034,564
2021-08-09,San Joaquin,077,732212,80922,79198,4150,83348,1469
2021-08-09,San Luis Obispo,079,281455,23431,22695,866,23561,264
2021-08-09,San Mateo,081,765935,47169,46040,665,46705,548
2021-08-09,Santa Barbara,083,443738,37139,36474,1336,37810,470
2021-08-09,Santa Clara,085,1922200,128358,125791,911,126702,2187
2021-08-09,Santa Cruz,087,273765,17473,17082,871,17953,209
2021-08-09,Shasta,089,179085,13863,13397,1867,15264,210
2021-08-09,Sierra,091,2930,83,75,12,87,0
2021-08-09,Siskiyou,093,43540,2204,2047,502,2549,32
2021-08-09,Solano,095,438530,38121,36653,837,37490,262
2021-08-09,Sonoma,097,501317,35115,33933,413,34346,333
2021-08-09,Stanislaus,099,539301,61607,60410,6657,67067,1037
2021-08-09,Sutter,101,95872,10769,10525,112,10637,129
2021-08-09,Tehama,103,63373,5532,5373,659,6032,66
2021-08-09,Trinity,105,12862,544,378,126,504,3
2021-08-09,Tulare,107,460477,52604,51274,10257,61531,854
2021-08-09,Tuolumne,109,53932,4871,4745,45,4790,64
2021-08-09,Ventura,111,848112,87078,85514,3678,89192,1047
2021-08-09,Yolo,113,214977,15959,15521,606,16127,218
2021-08-09,Yuba,115,75493,7165,6994,167,7161,50
2021-08-08,Alameda,001,1643700,101738,99135,2300,101435,1276
2021-08-08,Alpine,003,1148,90,91,0,91,0
2021-08-08,Amador,005,37829,4195,4057,36,4093,48
2021-08-08,Butte,007,227075,14128,13791,2181,15972,205
2021-08-08,Calaveras,009,45235,2521,2462,16,2478,57
2021-08-08,Colusa,011,21464,2130,2070,395,2465,16
2021-08-08,Contra Costa,013,1133247,81901,79454,1599,81053,840
2021-08-08,Del Norte,015,27424,1971,1810,16,1826,8
2021-08-08,El Dorado,017,186661,12041,11631,971,12602,117
2021-08-08,Fresno,019,978130,109486,107078,9498,116576,1747
2021-08-08,Glenn,021,27897,2583,2527,614,3141,20
2021-08-08,Humboldt,023,135768,5881,5571,102,5673,52
2021-08-08,Imperial,025,180216,29691,29485,2963,32448,745
2021-08-08,Inyo,027,18085,1488,1481,13,1494,39
2021-08-08,Kern,029,883053,102428,100909,12779,113688,1359
2021-08-08,Kings,031,150075,24682,24095,1247,25342,250
2021-08-08,Lake,033,64148,4784,4636,27,4663,66
2021-08-08,Lassen,035,31185,5465,5391,127,5518,21
2021-08-08,Los Angeles,037,10098052,1295526,1279982,47557,1327539,24793
2021-08-08,Madera,039,155013,17804,17398,1102,18500,245
2021-08-08,Marin,041,260295,15513,15124,312,15436,239
2021-08-08,Mariposa,043,17540,568,538,12,550,5
2021-08-08,Mendocino,045,87422,4941,4702,122,4824,49
2021-08-08,Merced,047,269075,32979,32634,1111,33745,477
2021-08-08,Modoc,049,8938,432,419,149,568,5
2021-08-08,Mono,051,14174,1338,1336,18,1354,3
2021-08-08,Monterey,053,433212,44604,44171,2124,46295,527
2021-08-08,Napa,055,140530,10885,10668,65,10733,83
2021-08-08,Nevada,057,99092,6359,6009,217,6226,73
2021-08-08,Orange,059,3164182,274914,270532,12574,283106,5153
2021-08-08,Placer,061,380077,27504,26332,2128,28460,305
2021-08-08,Plumas,063,18699,833,803,14,817,5
2021-08-08,Riverside,065,2383286,314507,308042,14909,322951,4562
2021-08-08,Sacramento,067,1510023,123774,120109,2407,122516,1744
2021-08-08,San Benito,069,59416,6425,6350,119,6469,63
2021-08-08,San Bernardino,071,2135413,311821,307378,9603,316981,5295
2021-08-08,San Diego,073,3302833,310937,305983,17837,323820,3811
2021-08-08,San Francisco,075,870044,44344,43098,1750,44848,564
2021-08-08,San Joaquin,077,732212,80474,79002,4134,83136,1469
2021-08-08,San Luis Obispo,079,281455,23257,22668,858,23526,263
2021-08-08,San Mateo,081,765935,46980,45927,662,46589,548
2021-08-08,Santa Barbara,083,443738,36962,36417,1329,37746,470
2021-08-08,Santa Clara,085,1922200,127907,125553,906,126459,2187
2021-08-08,Santa Cruz,087,273765,17399,17035,866,17901,209
2021-08-08,Shasta,089,179085,13777,13381,1856,15237,210
2021-08-08,Sierra,091,2930,83,74,12,86,0
2021-08-08,Siskiyou,093,43540,2188,2041,497,2538,32
2021-08-08,Solano,095,438530,37869,36551,833,37384,262
2021-08-08,Sonoma,097,501317,34871,33805,412,34217,333
2021-08-08,Stanislaus,099,539301,61285,60269,6612,66881,1037
2021-08-08,Sutter,101,95872,10709,10481,111,10592,129
2021-08-08,Tehama,103,63373,5494,5359,656,6015,66
2021-08-08,Trinity,105,12862,539,378,126,504,3
2021-08-08,Tulare,107,460477,52425,51220,10197,61417,854
2021-08-08,Tuolumne,109,53932,4832,4731,45,4776,64
2021-08-08,Ventura,111,848112,86787,85382,3668,89050,1047
2021-08-08,Yolo,113,214977,15866,15477,599,16076,218
2021-08-08,Yuba,115,75493,7126,6967,167,7134,50
2021-08-07,Alameda,001,1643700,101486,98812,2294,101106,1276
2021-08-07,Alpine,003,1148,90,91,0,91,0
2021-08-07,Amador,005,37829,4178,4041,35,4076,48
2021-08-07,Butte,007,227075,14076,13714,2170,15884,205
2021-08-07,Calaveras,009,45235,2510,2446,16,2462,57
2021-08-07,Colusa,011,21464,2125,2067,386,2453,16
2021-08-07,Contra Costa,013,1133247,81604,79168,1596,80764,840
2021-08-07,Del Norte,015,27424,1939,1791,16,1807,8
2021-08-07,El Dorado,017,186661,11991,11575,964,12539,117
2021-08-07,Fresno,019,978130,109284,106861,9472,116333,1747
2021-08-07,Glenn,021,27897,2575,2515,613,3128,20
2021-08-07,Humboldt,023,135768,5831,5510,99,5609,52
2021-08-07,Imperial,025,180216,29672,29470,2963,32433,745
2021-08-07,Inyo,027,18085,1486,1476,13,1489,39
2021-08-07,Kern,029,883053,102270,100693,12724,113417,1359
2021-08-07,Kings,031,150075,24622,24048,1241,25289,250
2021-08-07,Lake,033,64148,4763,4613,27,4640,66
2021-08-07,Lassen,035,31185,5461,5386,127,5513,21
2021-08-07,Los Angeles,037,10098052,1293504,1276853,47408,1324261,24786
2021-08-07,Madera,039,155013,17769,17366,1097,18463,245
2021-08-07,Marin,041,260295,15479,15085,311,15396,239
2021-08-07,Mariposa,043,17540,565,530,12,542,5
2021-08-07,Mendocino,045,87422,4905,4690,120,4810,49
2021-08-07,Merced,047,269075,32915,32569,1108,33677,477
2021-08-07,Modoc,049,8938,432,419,149,568,5
2021-08-07,Mono,051,14174,1335,1329,18,1347,3
2021-08-07,Monterey,053,433212,44552,44124,2119,46243,527
2021-08-07,Napa,055,140530,10864,10658,64,10722,83
2021-08-07,Nevada,057,99092,6309,5967,215,6182,73
2021-08-07,Orange,059,3164182,274321,269900,12543,282443,5153
2021-08-07,Placer,061,380077,27316,26244,2120,28364,305
2021-08-07,Plumas,063,18699,828,801,14,815,5
2021-08-07,Riverside,065,2383286,313835,307326,14902,322228,4562
2021-08-07,Sacramento,067,1510023,123273,119636,2403,122039,1744
2021-08-07,San Benito,069,59416,6415,6332,119,6451,63
2021-08-07,San Bernardino,071,2135413,311234,306663,9586,316249,5295
2021-08-07,San Diego,073,3302833,310183,304974,17802,322776,3811
2021-08-07,San Francisco,075,870044,44173,42926,1732,44658,564
2021-08-07,San Joaquin,077,732212,80310,78769,4120,82889,1469
2021-08-07,San Luis Obispo,079,281455,23188,22579,857,23436,263
2021-08-07,San Mateo,081,765935,46853,45804,660,46464,548
2021-08-07,Santa Barbara,083,443738,36866,36303,1323,37626,470
2021-08-07,Santa Clara,085,1922200,127636,125196,901,126097,2188
2021-08-07,Santa Cruz,087,273765,17356,16994,864,17858,209
2021-08-07,Shasta,089,179085,13722,13361,1848,15209,210
2021-08-07,Sierra,091,2930,83,74,12,86,0
2021-08-07,Siskiyou,093,43540,2176,2039,495,2534,32
2021-08-07,Solano,095,438530,37753,36458,825,37283,262
2021-08-07,Sonoma,097,501317,34749,33716,412,34128,333
2021-08-07,Stanislaus,099,539301,61118,60093,6582,66675,1037
2021-08-07,Sutter,101,95872,10672,10447,111,10558,129
2021-08-07,Tehama,103,63373,5484,5343,651,5994,66
2021-08-07,Trinity,105,12862,535,377,125,502,3
2021-08-07,Tulare,107,460477,52338,51133,10159,61292,854
2021-08-07,Tuolumne,109,53932,4802,4721,45,4766,64
2021-08-07,Ventura,111,848112,86607,85232,3653,88885,1047
2021-08-07,Yolo,113,214977,15822,15423,592,16015,218
2021-08-07,Yuba,115,75493,7101,6937,165,7102,50
2021-08-06,Alameda,001,1643700,101154,98487,2287,100774,1275
2021-08-06,Alpine,003,1148,90,91,0,91,0
2021-08-06,Amador,005,37829,4157,4002,35,4037,48
2021-08-06,Butte,007,227075,14028,13626,2158,15784,205
2021-08-06,Calaveras,009,45235,2499,2419,16,2435,57
2021-08-06,Colusa,011,21464,2119,2045,380,2425,16
2021-08-06,Contra Costa,013,1133247,81309,78796,1590,80386,840
2021-08-06,Del Norte,015,27424,1912,1755,15,1770,8
2021-08-06,El Dorado,017,186661,11942,11498,952,12450,117
2021-08-06,Fresno,019,978130,109020,106542,9445,115987,1747
2021-08-06,Glenn,021,27897,2560,2504,611,3115,20
2021-08-06,Humboldt,023,135768,5780,5421,96,5517,52
2021-08-06,Imperial,025,180216,29661,29404,2959,32363,745
2021-08-06,Inyo,027,18085,1483,1471,13,1484,39
2021-08-06,Kern,029,883053,102093,100427,12639,113066,1359
2021-08-06,Kings,031,150075,24567,23974,1237,25211,250
2021-08-06,Lake,033,64148,4740,4557,27,4584,66
2021-08-06,Lassen,035,31185,5439,5368,127,5495,21
2021-08-06,Los Angeles,037,10098052,1291022,1273081,47258,1320339,24772
2021-08-06,Madera,039,155013,17730,17324,1088,18412,245
2021-08-06,Marin,041,260295,15446,15051,311,15362,239
2021-08-06,Mariposa,043,17540,556,511,12,523,5
2021-08-06,Mendocino,045,87422,4863,4649,119,4768,49
2021-08-06,Merced,047,269075,32855,32456,1105,33561,477
2021-08-06,Modoc,049,8938,432,419,149,568,5
2021-08-06,Mono,051,14174,1334,1328,18,1346,3
2021-08-06,Monterey,053,433212,44484,44058,2106,46164,527
2021-08-06,Napa,055,140530,10837,10620,64,10684,83
2021-08-06,Nevada,057,99092,6253,5874,215,6089,73
2021-08-06,Orange,059,3164182,273756,269077,12526,281603,5151
2021-08-06,Placer,061,380077,27193,26086,2098,28184,305
2021-08-06,Plumas,063,18699,819,795,14,809,5
2021-08-06,Riverside,065,2383286,313125,306304,14891,321195,4562
2021-08-06,Sacramento,067,1510023,122785,119169,2383,121552,1740
2021-08-06,San Benito,069,59416,6398,6315,119,6434,63
2021-08-06,San Bernardino,071,2135413,310535,305806,9578,315384,5286
2021-08-06,San Diego,073,3302833,309144,303691,17753,321444,3810
2021-08-06,San Francisco,075,870044,44016,42659,1714,44373,565
2021-08-06,San Joaquin,077,732212,80162,78405,4108,82513,1469
2021-08-06,San Luis Obispo,079,281455,23120,22472,852,23324,263
2021-08-06,San Mateo,081,765935,46701,45665,655,46320,548
2021-08-06,Santa Barbara,083,443738,36776,36208,1319,37527,470
2021-08-06,Santa Clara,085,1922200,127345,124767,896,125663,2185
2021-08-06,Santa Cruz,087,273765,17314,16924,860,17784,207
2021-08-06,Shasta,089,179085,13656,13284,1842,15126,210
2021-08-06,Sierra,091,2930,83,73,12,85,0
2021-08-06,Siskiyou,093,43540,2166,2030,491,2521,32
2021-08-06,Solano,095,438530,37643,36351,816,37167,262
2021-08-06,Sonoma,097,501317,34662,33594,411,34005,333
2021-08-06,Stanislaus,099,539301,60980,59854,6561,66415,1037
2021-08-06,Sutter,101,95872,10629,10391,111,10502,128
2021-08-06,Tehama,103,63373,5460,5325,650,5975,66
2021-08-06,Trinity,105,12862,534,371,124,495,3
2021-08-06,Tulare,107,460477,52237,51018,10112,61130,854
2021-08-06,Tuolumne,109,53932,4774,4674,45,4719,64
2021-08-06,Ventura,111,848112,86436,85046,3641,88687,1047
2021-08-06,Yolo,113,214977,15769,15299,587,15886,218
2021-08-06,Yuba,115,75493,7078,6904,165,7069,50
2021-08-05,Alameda,001,1643700,100669,98052,2282,100334,1275
2021-08-05,Alpine,003,1148,90,91,0,91,0
2021-08-05,Amador,005,37829,4137,3992,35,4027,48
2021-08-05,Butte,007,227075,13972,13564,2136,15700,206
2021-08-05,Calaveras,009,45235,2480,2397,16,2413,57
2021-08-05,Colusa,011,21464,2107,2036,376,2412,16
2021-08-05,Contra Costa,013,1133247,80882,78514,1583,80097,840
2021-08-05,Del Norte,015,27424,1885,1731,15,1746,8
2021-08-05,El Dorado,017,186661,11858,11408,941,12349,117
2021-08-05,Fresno,019,978130,108650,106219,9408,115627,1747
2021-08-05,Glenn,021,27897,2555,2494,608,3102,20
2021-08-05,Humboldt,023,135768,5705,5328,95,5423,52
2021-08-05,Imperial,025,180216,29630,29383,2955,32338,745
2021-08-05,Inyo,027,18085,1479,1468,13,1481,38
2021-08-05,Kern,029,883053,101871,100091,12554,112645,1358
2021-08-05,Kings,031,150075,24483,23906,1231,25137,249
2021-08-05,Lake,033,64148,4701,4490,25,4515,66
2021-08-05,Lassen,035,31185,5431,5344,127,5471,21
2021-08-05,Los Angeles,037,10098052,1287810,1269445,47127,1316572,24756
2021-08-05,Madera,039,155013,17689,17301,1080,18381,245
2021-08-05,Marin,041,260295,15402,15005,307,15312,239
2021-08-05,Mariposa,043,17540,545,504,11,515,5
2021-08-05,Mendocino,045,87422,4820,4597,110,4707,49
2021-08-05,Merced,047,269075,32787,32381,1094,33475,477
2021-08-05,Modoc,049,8938,431,418,149,567,5
2021-08-05,Mono,051,14174,1326,1309,18,1327,3
2021-08-05,Monterey,053,433212,44427,43992,2088,46080,527
2021-08-05,Napa,055,140530,10801,10591,62,10653,83
2021-08-05,Nevada,057,99092,6171,5778,212,5990,73
2021-08-05,Orange,059,3164182,272975,268329,12501,280830,5149
2021-08-05,Placer,061,380077,26993,25965,2071,28036,305
2021-08-05,Plumas,063,18699,810,787,14,801,5
2021-08-05,Riverside,065,2383286,312208,305415,14864,320279,4562
2021-08-05,Sacramento,067,1510023,122076,118590,2370,120960,1739
2021-08-05,San Benito,069,59416,6380,6305,119,6424,63
2021-08-05,San Bernardino,071,2135413,309698,304956,9557,314513,5284
2021-08-05,San Diego,073,3302833,307871,302220,17673,319893,3806
2021-08-05,San Francisco,075,870044,43806,42301,1705,44006,564
2021-08-05,San Joaquin,077,732212,79801,78151,4090,82241,1468
2021-08-05,San Luis Obispo,079,281455,23005,22362,846,23208,263
2021-08-05,San Mateo,081,765935,46528,45554,653,46207,548
2021-08-05,Santa Barbara,083,443738,36670,36112,1316,37428,470
2021-08-05,Santa Clara,085,1922200,127012,124490,896,125386,2185
2021-08-05,Santa Cruz,087,273765,17271,16867,857,17724,207
2021-08-05,Shasta,089,179085,13598,13217,1834,15051,210
2021-08-05,Sierra,091,2930,78,73,12,85,0
2021-08-05,Siskiyou,093,43540,2145,2024,481,2505,32
2021-08-05,Solano,095,438530,37462,36250,809,37059,262
2021-08-05,Sonoma,097,501317,34527,33455,410,33865,330
2021-08-05,Stanislaus,099,539301,60764,59692,6523,66215,1037
2021-08-05,Sutter,101,95872,10574,10349,111,10460,127
2021-08-05,Tehama,103,63373,5442,5305,646,5951,66
2021-08-05,Trinity,105,12862,528,367,124,491,3
2021-08-05,Tulare,107,460477,52120,50889,10055,60944,854
2021-08-05,Tuolumne,109,53932,4744,4619,45,4664,64
2021-08-05,Ventura,111,848112,86186,84837,3627,88464,1047
2021-08-05,Yolo,113,214977,15703,15250,577,15827,218
2021-08-05,Yuba,115,75493,7035,6872,163,7035,50
2021-08-04,Alameda,001,1643700,100169,97477,2272,99749,1274
2021-08-04,Alpine,003,1148,90,91,0,91,0
2021-08-04,Amador,005,37829,4107,3962,34,3996,48
2021-08-04,Butte,007,227075,13905,13509,2120,15629,205
2021-08-04,Calaveras,009,45235,2458,2374,16,2390,57
2021-08-04,Colusa,011,21464,2095,2025,370,2395,16
2021-08-04,Contra Costa,013,1133247,80365,77966,1578,79544,840
2021-08-04,Del Norte,015,27424,1862,1701,15,1716,8
2021-08-04,El Dorado,017,186661,11780,11319,930,12249,117
2021-08-04,Fresno,019,978130,108283,105899,9367,115266,1747
2021-08-04,Glenn,021,27897,2547,2487,608,3095,20
2021-08-04,Humboldt,023,135768,5629,5271,94,5365,52
2021-08-04,Imperial,025,180216,29582,29375,2952,32327,745
2021-08-04,Inyo,027,18085,1478,1465,13,1478,38
2021-08-04,Kern,029,883053,101621,99868,12469,112337,1358
2021-08-04,Kings,031,150075,24411,23840,1223,25063,250
2021-08-04,Lake,033,64148,4670,4423,20,4443,65
2021-08-04,Lassen,035,31185,5423,5340,127,5467,21
2021-08-04,Los Angeles,037,10098052,1284324,1265788,46969,1312757,24737
2021-08-04,Madera,039,155013,17654,17251,1073,18324,245
2021-08-04,Marin,041,260295,15355,14950,305,15255,239
2021-08-04,Mariposa,043,17540,530,497,11,508,5
2021-08-04,Mendocino,045,87422,4796,4560,106,4666,49
2021-08-04,Merced,047,269075,32650,32274,1089,33363,476
2021-08-04,Modoc,049,8938,431,416,149,565,5
2021-08-04,Mono,051,14174,1322,1307,18,1325,3
2021-08-04,Monterey,053,433212,44362,43926,2077,46003,526
2021-08-04,Napa,055,140530,10764,10544,62,10606,82
2021-08-04,Nevada,057,99092,6107,5702,211,5913,73
2021-08-04,Orange,059,3164182,272101,267199,12464,279663,5146
2021-08-04,Placer,061,380077,26776,25688,2051,27739,305
2021-08-04,Plumas,063,18699,804,784,14,798,5
2021-08-04,Riverside,065,2383286,311283,304272,14838,319110,4562
2021-08-04,Sacramento,067,1510023,121317,117882,2344,120226,1736
2021-08-04,San Benito,069,59416,6365,6300,119,6419,63
2021-08-04,San Bernardino,071,2135413,308842,304164,9540,313704,5285
2021-08-04,San Diego,073,3302833,306354,301100,17609,318709,3805
2021-08-04,San Francisco,075,870044,43552,41913,1692,43605,562
2021-08-04,San Joaquin,077,732212,79444,77846,4078,81924,1466
2021-08-04,San Luis Obispo,079,281455,22897,22245,840,23085,262
2021-08-04,San Mateo,081,765935,46355,45392,652,46044,548
2021-08-04,Santa Barbara,083,443738,36541,36013,1308,37321,470
2021-08-04,Santa Clara,085,1922200,126621,124127,889,125016,2183
2021-08-04,Santa Cruz,087,273765,17210,16820,850,17670,208
2021-08-04,Shasta,089,179085,13546,13134,1823,14957,211
2021-08-04,Sierra,091,2930,78,73,12,85,0
2021-08-04,Siskiyou,093,43540,2125,2010,476,2486,32
2021-08-04,Solano,095,438530,37262,36025,800,36825,262
2021-08-04,Sonoma,097,501317,34355,33311,408,33719,330
2021-08-04,Stanislaus,099,539301,60541,59396,6485,65881,1037
2021-08-04,Sutter,101,95872,10537,10294,111,10405,127
2021-08-04,Tehama,103,63373,5416,5281,641,5922,66
2021-08-04,Trinity,105,12862,526,362,121,483,3
2021-08-04,Tulare,107,460477,52010,50797,10011,60808,855
2021-08-04,Tuolumne,109,53932,4719,4584,45,4629,64
2021-08-04,Ventura,111,848112,85928,84406,3605,88011,1047
2021-08-04,Yolo,113,214977,15625,15189,564,15753,215
2021-08-04,Yuba,115,75493,6995,6827,161,6988,50
2021-08-03,Alameda,001,1643700,99718,97275,2267,99542,1270
2021-08-03,Alpine,003,1148,90,91,0,91,0
2021-08-03,Amador,005,37829,4071,3953,34,3987,48
2021-08-03,Butte,007,227075,13839,13468,2105,15573,205
2021-08-03,Calaveras,009,45235,2436,2356,16,2372,57
2021-08-03,Colusa,011,21464,2082,2023,364,2387,16
2021-08-03,Contra Costa,013,1133247,79881,77739,1571,79310,836
2021-08-03,Del Norte,015,27424,1830,1691,14,1705,8
2021-08-03,El Dorado,017,186661,11690,11255,920,12175,117
2021-08-03,Fresno,019,978130,107920,105732,9335,115067,1746
2021-08-03,Glenn,021,27897,2540,2481,606,3087,20
2021-08-03,Humboldt,023,135768,5564,5199,89,5288,52
2021-08-03,Imperial,025,180216,29560,29333,2943,32276,745
2021-08-03,Inyo,027,18085,1475,1459,13,1472,38
2021-08-03,Kern,029,883053,101360,99708,12390,112098,1358
2021-08-03,Kings,031,150075,24323,23780,1216,24996,249
2021-08-03,Lake,033,64148,4614,4408,16,4424,66
2021-08-03,Lassen,035,31185,5413,5341,127,5468,21
2021-08-03,Los Angeles,037,10098052,1280589,1262678,46797,1309475,24721
2021-08-03,Madera,039,155013,17613,17220,1058,18278,245
2021-08-03,Marin,041,260295,15306,14906,302,15208,243
2021-08-03,Mariposa,043,17540,519,495,11,506,5
2021-08-03,Mendocino,045,87422,4747,4546,105,4651,49
2021-08-03,Merced,047,269075,32567,32197,1087,33284,476
2021-08-03,Modoc,049,8938,431,416,149,565,5
2021-08-03,Mono,051,14174,1317,1303,18,1321,3
2021-08-03,Monterey,053,433212,44299,43872,2064,45936,525
2021-08-03,Napa,055,140530,10721,10527,61,10588,82
2021-08-03,Nevada,057,99092,6026,5685,210,5895,73
2021-08-03,Orange,059,3164182,271362,266649,12434,279083,5146
2021-08-03,Placer,061,380077,26575,25624,2026,27650,305
2021-08-03,Plumas,063,18699,797,779,14,793,5
2021-08-03,Riverside,065,2383286,310359,303499,14811,318310,4562
2021-08-03,Sacramento,067,1510023,120574,117591,2323,119914,1732
2021-08-03,San Benito,069,59416,6349,6284,118,6402,63
2021-08-03,San Bernardino,071,2135413,307923,303386,9520,312906,5265
2021-08-03,San Diego,073,3302833,304920,300189,17505,317694,3803
2021-08-03,San Francisco,075,870044,43269,41758,1672,43430,562
2021-08-03,San Joaquin,077,732212,79095,77615,4057,81672,1461
2021-08-03,San Luis Obispo,079,281455,22757,22166,833,22999,264
2021-08-03,San Mateo,081,765935,46161,45255,647,45902,548
2021-08-03,Santa Barbara,083,443738,36422,35912,1302,37214,469
2021-08-03,Santa Clara,085,1922200,126200,123914,883,124797,2183
2021-08-03,Santa Cruz,087,273765,17143,16778,847,17625,207
2021-08-03,Shasta,089,179085,13473,13091,1812,14903,211
2021-08-03,Sierra,091,2930,78,72,12,84,0
2021-08-03,Siskiyou,093,43540,2114,1998,471,2469,32
2021-08-03,Solano,095,438530,37042,35953,788,36741,261
2021-08-03,Sonoma,097,501317,34173,33243,407,33650,330
2021-08-03,Stanislaus,099,539301,60321,59282,6467,65749,1037
2021-08-03,Sutter,101,95872,10497,10263,110,10373,127
2021-08-03,Tehama,103,63373,5391,5269,636,5905,66
2021-08-03,Trinity,105,12862,523,361,118,479,3
2021-08-03,Tulare,107,460477,51915,50729,9965,60694,854
2021-08-03,Tuolumne,109,53932,4684,4563,45,4608,64
2021-08-03,Ventura,111,848112,85684,84270,3584,87854,1046
2021-08-03,Yolo,113,214977,15533,15149,550,15699,215
2021-08-03,Yuba,115,75493,6958,6781,159,6940,50
2021-08-02,Alameda,001,1643700,99162,96954,2262,99216,1270
2021-08-02,Alpine,003,1148,90,91,0,91,0
2021-08-02,Amador,005,37829,4051,3927,34,3961,48
2021-08-02,Butte,007,227075,13763,13442,2086,15528,205
2021-08-02,Calaveras,009,45235,2410,2347,16,2363,57
2021-08-02,Colusa,011,21464,2070,2019,361,2380,16
2021-08-02,Contra Costa,013,1133247,79371,77516,1557,79073,836
2021-08-02,Del Norte,015,27424,1800,1653,14,1667,8
2021-08-02,El Dorado,017,186661,11587,11226,906,12132,116
2021-08-02,Fresno,019,978130,107577,105471,9298,114769,1744
2021-08-02,Glenn,021,27897,2532,2477,604,3081,20
2021-08-02,Humboldt,023,135768,5481,5161,87,5248,52
2021-08-02,Imperial,025,180216,29527,29302,2938,32240,743
2021-08-02,Inyo,027,18085,1469,1455,13,1468,38
2021-08-02,Kern,029,883053,101105,99556,12296,111852,1357
2021-08-02,Kings,031,150075,24254,23722,1210,24932,249
2021-08-02,Lake,033,64148,4572,4375,16,4391,66
2021-08-02,Lassen,035,31185,5390,5338,125,5463,21
2021-08-02,Los Angeles,037,10098052,1276875,1260807,46590,1307397,24705
2021-08-02,Madera,039,155013,17569,17158,1045,18203,245
2021-08-02,Marin,041,260295,15263,14859,300,15159,239
2021-08-02,Mariposa,043,17540,510,490,11,501,5
2021-08-02,Mendocino,045,87422,4707,4512,102,4614,49
2021-08-02,Merced,047,269075,32469,32163,1080,33243,474
2021-08-02,Modoc,049,8938,431,415,149,564,5
2021-08-02,Mono,051,14174,1310,1296,18,1314,3
2021-08-02,Monterey,053,433212,44239,43842,2056,45898,525
2021-08-02,Napa,055,140530,10678,10490,58,10548,82
2021-08-02,Nevada,057,99092,5955,5611,209,5820,73
2021-08-02,Orange,059,3164182,270448,266050,12388,278438,5146
2021-08-02,Placer,061,380077,26428,25516,1992,27508,306
2021-08-02,Plumas,063,18699,790,762,14,776,5
2021-08-02,Riverside,065,2383286,309421,302756,14796,317552,4562
2021-08-02,Sacramento,067,1510023,119876,117183,2302,119485,1728
2021-08-02,San Benito,069,59416,6330,6276,117,6393,63
2021-08-02,San Bernardino,071,2135413,307047,303000,9488,312488,5253
2021-08-02,San Diego,073,3302833,303438,299021,17425,316446,3798
2021-08-02,San Francisco,075,870044,42975,41553,1648,43201,562
2021-08-02,San Joaquin,077,732212,78752,77447,4030,81477,1461
2021-08-02,San Luis Obispo,079,281455,22663,22093,827,22920,261
2021-08-02,San Mateo,081,765935,45986,45154,634,45788,548
2021-08-02,Santa Barbara,083,443738,36282,35851,1296,37147,469
2021-08-02,Santa Clara,085,1922200,125730,123655,875,124530,2183
2021-08-02,Santa Cruz,087,273765,17086,16746,843,17589,207
2021-08-02,Shasta,089,179085,13410,13049,1798,14847,212
2021-08-02,Sierra,091,2930,78,71,12,83,0
2021-08-02,Siskiyou,093,43540,2103,1992,457,2449,31
2021-08-02,Solano,095,438530,36794,35852,775,36627,260
2021-08-02,Sonoma,097,501317,33946,33132,402,33534,330
2021-08-02,Stanislaus,099,539301,60102,59160,6439,65599,1037
2021-08-02,Sutter,101,95872,10451,10220,110,10330,127
2021-08-02,Tehama,103,63373,5367,5260,632,5892,66
2021-08-02,Trinity,105,12862,518,359,117,476,3
2021-08-02,Tulare,107,460477,51813,50640,9891,60531,854
2021-08-02,Tuolumne,109,53932,4617,4524,45,4569,64
2021-08-02,Ventura,111,848112,85499,84143,3561,87704,1044
2021-08-02,Yolo,113,214977,15433,15072,532,15604,215
2021-08-02,Yuba,115,75493,6916,6743,156,6899,50
2021-08-01,Alameda,001,1643700,98626,96775,2257,99032,1270
2021-08-01,Alpine,003,1148,90,91,0,91,0
2021-08-01,Amador,005,37829,4013,3923,34,3957,48
2021-08-01,Butte,007,227075,13682,13406,2069,15475,205
2021-08-01,Calaveras,009,45235,2386,2341,16,2357,57
2021-08-01,Colusa,011,21464,2059,2014,359,2373,16
2021-08-01,Contra Costa,013,1133247,78935,77360,1549,78909,836
2021-08-01,Del Norte,015,27424,1768,1642,14,1656,8
2021-08-01,El Dorado,017,186661,11486,11189,896,12085,116
2021-08-01,Fresno,019,978130,107252,105339,9251,114590,1744
2021-08-01,Glenn,021,27897,2526,2476,601,3077,20
2021-08-01,Humboldt,023,135768,5404,5118,83,5201,52
2021-08-01,Imperial,025,180216,29492,29297,2934,32231,743
2021-08-01,Inyo,027,18085,1467,1454,13,1467,38
2021-08-01,Kern,029,883053,100828,99396,12222,111618,1357
2021-08-01,Kings,031,150075,24167,23700,1205,24905,249
2021-08-01,Lake,033,64148,4493,4356,16,4372,66
2021-08-01,Lassen,035,31185,5377,5336,123,5459,21
2021-08-01,Los Angeles,037,10098052,1273189,1258461,46367,1304828,24700
2021-08-01,Madera,039,155013,17512,17146,1040,18186,245
2021-08-01,Marin,041,260295,15186,14844,299,15143,239
2021-08-01,Mariposa,043,17540,503,482,11,493,5
2021-08-01,Mendocino,045,87422,4661,4476,98,4574,49
2021-08-01,Merced,047,269075,32378,32144,1074,33218,474
2021-08-01,Modoc,049,8938,429,413,149,562,5
2021-08-01,Mono,051,14174,1307,1294,18,1312,3
2021-08-01,Monterey,053,433212,44190,43808,2043,45851,525
2021-08-01,Napa,055,140530,10630,10473,56,10529,82
2021-08-01,Nevada,057,99092,5868,5561,208,5769,73
2021-08-01,Orange,059,3164182,269635,265467,12345,277812,5146
2021-08-01,Placer,061,380077,26213,25464,1962,27426,306
2021-08-01,Plumas,063,18699,784,761,14,775,5
2021-08-01,Riverside,065,2383286,308488,302256,14778,317034,4562
2021-08-01,Sacramento,067,1510023,119140,116923,2285,119208,1727
2021-08-01,San Benito,069,59416,6313,6271,117,6388,63
2021-08-01,San Bernardino,071,2135413,306111,302542,9477,312019,5248
2021-08-01,San Diego,073,3302833,302251,298002,17361,315363,3798
2021-08-01,San Francisco,075,870044,42637,41432,1635,43067,562
2021-08-01,San Joaquin,077,732212,78386,77338,4003,81341,1461
2021-08-01,San Luis Obispo,079,281455,22560,22083,822,22905,261
2021-08-01,San Mateo,081,765935,45805,45036,626,45662,548
2021-08-01,Santa Barbara,083,443738,36159,35809,1292,37101,469
2021-08-01,Santa Clara,085,1922200,125318,123511,867,124378,2183
2021-08-01,Santa Cruz,087,273765,17007,16709,836,17545,207
2021-08-01,Shasta,089,179085,13339,13036,1789,14825,212
2021-08-01,Sierra,091,2930,76,71,12,83,0
2021-08-01,Siskiyou,093,43540,2097,1989,451,2440,31
2021-08-01,Solano,095,438530,36559,35800,766,36566,260
2021-08-01,Sonoma,097,501317,33754,33076,399,33475,330
2021-08-01,Stanislaus,099,539301,59866,59078,6407,65485,1037
2021-08-01,Sutter,101,95872,10396,10198,107,10305,127
2021-08-01,Tehama,103,63373,5350,5252,628,5880,66
2021-08-01,Trinity,105,12862,515,359,116,475,3
2021-08-01,Tulare,107,460477,51656,50600,9828,60428,854
2021-08-01,Tuolumne,109,53932,4579,4489,45,4534,64
2021-08-01,Ventura,111,848112,85269,84040,3546,87586,1044
2021-08-01,Yolo,113,214977,15361,15042,523,15565,215
2021-08-01,Yuba,115,75493,6879,6721,155,6876,50
2021-07-31,Alameda,001,1643700,98301,95279,2251,97530,1265
2021-07-31,Alpine,003,1148,90,89,0,89,0
2021-07-31,Amador,005,37829,3993,3877,34,3911,48
2021-07-31,Butte,007,227075,13649,13235,2049,15284,205
2021-07-31,Calaveras,009,45235,2377,2294,16,2310,57
2021-07-31,Colusa,011,21464,2053,2006,357,2363,16
2021-07-31,Contra Costa,013,1133247,78656,75866,1547,77413,832
2021-07-31,Del Norte,015,27424,1742,1576,14,1590,8
2021-07-31,El Dorado,017,186661,11433,11017,890,11907,116
2021-07-31,Fresno,019,978130,107093,104639,9237,113876,1744
2021-07-31,Glenn,021,27897,2521,2465,596,3061,20
2021-07-31,Humboldt,023,135768,5349,4978,82,5060,52
2021-07-31,Imperial,025,180216,29475,29164,2931,32095,743
2021-07-31,Inyo,027,18085,1464,1442,13,1455,38
2021-07-31,Kern,029,883053,100663,98903,12163,111066,1357
2021-07-31,Kings,031,150075,24114,23548,1200,24748,248
2021-07-31,Lake,033,64148,4468,4238,16,4254,66
2021-07-31,Lassen,035,31185,5370,5320,123,5443,21
2021-07-31,Los Angeles,037,10098052,1270994,1248545,46220,1294765,24691
2021-07-31,Madera,039,155013,17479,17058,1034,18092,245
2021-07-31,Marin,041,260295,15142,14701,298,14999,239
2021-07-31,Mariposa,043,17540,494,470,11,481,5
2021-07-31,Mendocino,045,87422,4636,4400,95,4495,49
2021-07-31,Merced,047,269075,32330,31959,1069,33028,474
2021-07-31,Modoc,049,8938,429,413,149,562,5
2021-07-31,Mono,051,14174,1305,1287,18,1305,3
2021-07-31,Monterey,053,433212,44150,43720,2033,45753,525
2021-07-31,Napa,055,140530,10610,10401,55,10456,82
2021-07-31,Nevada,057,99092,5829,5373,207,5580,72
2021-07-31,Orange,059,3164182,269061,263446,12326,275772,5144
2021-07-31,Placer,061,380077,26080,25104,1955,27059,306
2021-07-31,Plumas,063,18699,781,743,14,757,5
2021-07-31,Riverside,065,2383286,307872,300315,14768,315083,4554
2021-07-31,Sacramento,067,1510023,118728,115259,2279,117538,1720
2021-07-31,San Benito,069,59416,6302,6251,117,6368,63
2021-07-31,San Bernardino,071,2135413,305542,300726,9474,310200,5240
2021-07-31,San Diego,073,3302833,301582,295054,17315,312369,3798
2021-07-31,San Francisco,075,870044,42413,40412,1615,42027,562
2021-07-31,San Joaquin,077,732212,78221,76575,3990,80565,1443
2021-07-31,San Luis Obispo,079,281455,22506,21922,820,22742,260
2021-07-31,San Mateo,081,765935,45648,44622,621,45243,548
2021-07-31,Santa Barbara,083,443738,36077,35531,1291,36822,467
2021-07-31,Santa Clara,085,1922200,125063,122614,865,123479,2099
2021-07-31,Santa Cruz,087,273765,16968,16576,835,17411,207
2021-07-31,Shasta,089,179085,13302,12918,1781,14699,212
2021-07-31,Sierra,091,2930,76,68,12,80,0
2021-07-31,Siskiyou,093,43540,2088,1976,445,2421,31
2021-07-31,Solano,095,438530,36458,35340,758,36098,263
2021-07-31,Sonoma,097,501317,33629,32601,399,33000,329
2021-07-31,Stanislaus,099,539301,59707,58586,6384,64970,1035
2021-07-31,Sutter,101,95872,10361,10068,106,10174,127
2021-07-31,Tehama,103,63373,5335,5216,625,5841,66
2021-07-31,Trinity,105,12862,514,354,115,469,3
2021-07-31,Tulare,107,460477,51567,50409,9775,60184,854
2021-07-31,Tuolumne,109,53932,4540,4362,45,4407,64
2021-07-31,Ventura,111,848112,85108,83509,3529,87038,1044
2021-07-31,Yolo,113,214977,15313,14863,512,15375,215
2021-07-31,Yuba,115,75493,6856,6615,151,6766,50
2021-07-30,Alameda,001,1643700,97970,95279,2247,97526,1265
2021-07-30,Alpine,003,1148,90,89,0,89,0
2021-07-30,Amador,005,37829,3970,3877,34,3911,48
2021-07-30,Butte,007,227075,13594,13235,2036,15271,205
2021-07-30,Calaveras,009,45235,2367,2294,16,2310,57
2021-07-30,Colusa,011,21464,2049,2006,355,2361,16
2021-07-30,Contra Costa,013,1133247,78413,75866,1543,77409,832
2021-07-30,Del Norte,015,27424,1724,1576,14,1590,8
2021-07-30,El Dorado,017,186661,11400,11017,884,11901,116
2021-07-30,Fresno,019,978130,106899,104639,9225,113864,1744
2021-07-30,Glenn,021,27897,2516,2465,595,3060,20
2021-07-30,Humboldt,023,135768,5285,4978,79,5057,52
2021-07-30,Imperial,025,180216,29461,29164,2928,32092,743
2021-07-30,Inyo,027,18085,1463,1442,13,1455,38
2021-07-30,Kern,029,883053,100538,98903,12116,111019,1357
2021-07-30,Kings,031,150075,24074,23548,1196,24744,248
2021-07-30,Lake,033,64148,4440,4238,16,4254,66
2021-07-30,Lassen,035,31185,5366,5320,123,5443,21
2021-07-30,Los Angeles,037,10098052,1268673,1248545,46069,1294614,24691
2021-07-30,Madera,039,155013,17437,17058,1031,18089,245
2021-07-30,Marin,041,260295,15108,14701,298,14999,239
2021-07-30,Mariposa,043,17540,490,470,11,481,5
2021-07-30,Mendocino,045,87422,4606,4400,94,4494,49
2021-07-30,Merced,047,269075,32289,31959,1065,33024,474
2021-07-30,Modoc,049,8938,427,413,149,562,5
2021-07-30,Mono,051,14174,1300,1287,18,1305,3
2021-07-30,Monterey,053,433212,44116,43720,2024,45744,525
2021-07-30,Napa,055,140530,10588,10401,54,10455,82
2021-07-30,Nevada,057,99092,5772,5373,207,5580,72
2021-07-30,Orange,059,3164182,268436,263446,12300,275746,5144
2021-07-30,Placer,061,380077,25991,25104,1937,27041,306
2021-07-30,Plumas,063,18699,776,743,14,757,5
2021-07-30,Riverside,065,2383286,307235,300315,14758,315073,4554
2021-07-30,Sacramento,067,1510023,118277,115259,2275,117534,1720
2021-07-30,San Benito,069,59416,6295,6251,117,6368,63
2021-07-30,San Bernardino,071,2135413,305028,300726,9468,310194,5240
2021-07-30,San Diego,073,3302833,300812,295054,17257,312311,3798
2021-07-30,San Francisco,075,870044,42199,40412,1600,42012,562
2021-07-30,San Joaquin,077,732212,78067,76575,3985,80560,1443
2021-07-30,San Luis Obispo,079,281455,22468,21922,816,22738,260
2021-07-30,San Mateo,081,765935,45524,44622,608,45230,548
2021-07-30,Santa Barbara,083,443738,36008,35531,1285,36816,467
2021-07-30,Santa Clara,085,1922200,124839,122614,863,123477,2099
2021-07-30,Santa Cruz,087,273765,16942,16576,833,17409,207
2021-07-30,Shasta,089,179085,13254,12918,1781,14699,212
2021-07-30,Sierra,091,2930,75,68,12,80,0
2021-07-30,Siskiyou,093,43540,2079,1976,444,2420,31
2021-07-30,Solano,095,438530,36367,35340,742,36082,263
2021-07-30,Sonoma,097,501317,33534,32601,399,33000,329
2021-07-30,Stanislaus,099,539301,59564,58586,6363,64949,1035
2021-07-30,Sutter,101,95872,10325,10068,106,10174,127
2021-07-30,Tehama,103,63373,5324,5216,625,5841,66
2021-07-30,Trinity,105,12862,514,354,115,469,3
2021-07-30,Tulare,107,460477,51524,50409,9740,60149,854
2021-07-30,Tuolumne,109,53932,4522,4362,45,4407,64
2021-07-30,Ventura,111,848112,84944,83509,3514,87023,1044
2021-07-30,Yolo,113,214977,15251,14863,508,15371,215
2021-07-30,Yuba,115,75493,6820,6615,150,6765,50
2021-07-29,Alameda,001,1643700,97548,95279,2241,97520,1265
2021-07-29,Alpine,003,1148,90,89,0,89,0
2021-07-29,Amador,005,37829,3951,3877,34,3911,48
2021-07-29,Butte,007,227075,13546,13235,2028,15263,205
2021-07-29,Calaveras,009,45235,2354,2294,16,2310,57
2021-07-29,Colusa,011,21464,2042,2006,355,2361,16
2021-07-29,Contra Costa,013,1133247,77975,75866,1539,77405,832
2021-07-29,Del Norte,015,27424,1700,1576,14,1590,8
2021-07-29,El Dorado,017,186661,11336,11017,872,11889,116
2021-07-29,Fresno,019,978130,106636,104639,9198,113837,1744
2021-07-29,Glenn,021,27897,2506,2465,594,3059,20
2021-07-29,Humboldt,023,135768,5225,4978,77,5055,52
2021-07-29,Imperial,025,180216,29415,29164,2926,32090,743
2021-07-29,Inyo,027,18085,1459,1442,13,1455,38
2021-07-29,Kern,029,883053,100332,98903,12038,110941,1357
2021-07-29,Kings,031,150075,24028,23548,1192,24740,248
2021-07-29,Lake,033,64148,4405,4238,16,4254,66
2021-07-29,Lassen,035,31185,5358,5320,120,5440,21
2021-07-29,Los Angeles,037,10098052,1265584,1248545,45886,1294431,24691
2021-07-29,Madera,039,155013,17390,17058,1027,18085,245
2021-07-29,Marin,041,260295,15065,14701,298,14999,239
2021-07-29,Mariposa,043,17540,486,470,11,481,5
2021-07-29,Mendocino,045,87422,4583,4400,92,4492,49
2021-07-29,Merced,047,269075,32234,31959,1065,33024,474
2021-07-29,Modoc,049,8938,427,413,149,562,5
2021-07-29,Mono,051,14174,1298,1287,18,1305,3
2021-07-29,Monterey,053,433212,44067,43720,2014,45734,525
2021-07-29,Napa,055,140530,10556,10401,52,10453,82
2021-07-29,Nevada,057,99092,5720,5373,206,5579,72
2021-07-29,Orange,059,3164182,267723,263446,12268,275714,5144
2021-07-29,Placer,061,380077,25868,25104,1922,27026,306
2021-07-29,Plumas,063,18699,768,743,14,757,5
2021-07-29,Riverside,065,2383286,306530,300315,14734,315049,4554
2021-07-29,Sacramento,067,1510023,117722,115259,2262,117521,1720
2021-07-29,San Benito,069,59416,6284,6251,117,6368,63
2021-07-29,San Bernardino,071,2135413,304389,300726,9458,310184,5240
2021-07-29,San Diego,073,3302833,299752,295054,17191,312245,3798
2021-07-29,San Francisco,075,870044,41952,40412,1579,41991,562
2021-07-29,San Joaquin,077,732212,77811,76575,3977,80552,1443
2021-07-29,San Luis Obispo,079,281455,22414,21922,814,22736,260
2021-07-29,San Mateo,081,765935,45397,44622,598,45220,548
2021-07-29,Santa Barbara,083,443738,35923,35531,1284,36815,467
2021-07-29,Santa Clara,085,1922200,124542,122614,860,123474,2099
2021-07-29,Santa Cruz,087,273765,16889,16576,831,17407,207
2021-07-29,Shasta,089,179085,13200,12918,1772,14690,212
2021-07-29,Sierra,091,2930,75,68,12,80,0
2021-07-29,Siskiyou,093,43540,2074,1976,442,2418,31
2021-07-29,Solano,095,438530,36207,35340,732,36072,263
2021-07-29,Sonoma,097,501317,33359,32601,397,32998,329
2021-07-29,Stanislaus,099,539301,59392,58586,6346,64932,1035
2021-07-29,Sutter,101,95872,10279,10068,105,10173,127
2021-07-29,Tehama,103,63373,5312,5216,619,5835,66
2021-07-29,Trinity,105,12862,512,354,114,468,3
2021-07-29,Tulare,107,460477,51434,50409,9700,60109,854
2021-07-29,Tuolumne,109,53932,4482,4362,44,4406,64
2021-07-29,Ventura,111,848112,84778,83509,3507,87016,1044
2021-07-29,Yolo,113,214977,15183,14863,494,15357,215
2021-07-29,Yuba,115,75493,6772,6615,147,6762,50
2021-07-28,Alameda,001,1643700,97078,94965,2234,97199,1262
2021-07-28,Alpine,003,1148,90,89,0,89,0
2021-07-28,Amador,005,37829,3937,3870,34,3904,48
2021-07-28,Butte,007,227075,13489,13184,2015,15199,205
2021-07-28,Calaveras,009,45235,2336,2289,16,2305,57
2021-07-28,Colusa,011,21464,2038,2001,354,2355,16
2021-07-28,Contra Costa,013,1133247,77489,75487,1531,77018,832
2021-07-28,Del Norte,015,27424,1667,1545,14,1559,8
2021-07-28,El Dorado,017,186661,11287,10967,862,11829,116
2021-07-28,Fresno,019,978130,106388,104458,9178,113636,1744
2021-07-28,Glenn,021,27897,2502,2464,591,3055,20
2021-07-28,Humboldt,023,135768,5174,4946,76,5022,52
2021-07-28,Imperial,025,180216,29368,29096,2926,32022,743
2021-07-28,Inyo,027,18085,1453,1439,12,1451,38
2021-07-28,Kern,029,883053,100175,98781,11991,110772,1352
2021-07-28,Kings,031,150075,23964,23503,1182,24685,248
2021-07-28,Lake,033,64148,4359,4191,15,4206,65
2021-07-28,Lassen,035,31185,5350,5318,120,5438,21
2021-07-28,Los Angeles,037,10098052,1262420,1245485,45715,1291200,24673
2021-07-28,Madera,039,155013,17349,17024,1021,18045,245
2021-07-28,Marin,041,260295,15010,14652,298,14950,239
2021-07-28,Mariposa,043,17540,479,469,11,480,5
2021-07-28,Mendocino,045,87422,4555,4377,92,4469,49
2021-07-28,Merced,047,269075,32178,31886,1061,32947,474
2021-07-28,Modoc,049,8938,425,413,149,562,5
2021-07-28,Mono,051,14174,1297,1286,18,1304,3
2021-07-28,Monterey,053,433212,44020,43668,2004,45672,524
2021-07-28,Napa,055,140530,10516,10376,50,10426,82
2021-07-28,Nevada,057,99092,5666,5320,206,5526,72
2021-07-28,Orange,059,3164182,266931,262735,12238,274973,5143
2021-07-28,Placer,061,380077,25721,24978,1906,26884,306
2021-07-28,Plumas,063,18699,763,754,14,768,5
2021-07-28,Riverside,065,2383286,305762,299611,14715,314326,4554
2021-07-28,Sacramento,067,1510023,117071,114665,2241,116906,1714
2021-07-28,San Benito,069,59416,6273,6236,117,6353,63
2021-07-28,San Bernardino,071,2135413,303759,300121,9446,309567,5236
2021-07-28,San Diego,073,3302833,298465,294176,17128,311304,3798
2021-07-28,San Francisco,075,870044,41617,40144,1553,41697,561
2021-07-28,San Joaquin,077,732212,77560,76312,3947,80259,1443
2021-07-28,San Luis Obispo,079,281455,22355,21865,813,22678,260
2021-07-28,San Mateo,081,765935,45247,44477,589,45066,547
2021-07-28,Santa Barbara,083,443738,35847,35431,1279,36710,467
2021-07-28,Santa Clara,085,1922200,124281,122345,858,123203,2099
2021-07-28,Santa Cruz,087,273765,16851,16551,830,17381,207
2021-07-28,Shasta,089,179085,13156,12882,1762,14644,212
2021-07-28,Sierra,091,2930,71,67,12,79,0
2021-07-28,Siskiyou,093,43540,2065,1971,439,2410,31
2021-07-28,Solano,095,438530,36033,35204,725,35929,262
2021-07-28,Sonoma,097,501317,33216,32434,394,32828,328
2021-07-28,Stanislaus,099,539301,59193,58427,6330,64757,1035
2021-07-28,Sutter,101,95872,10247,10033,104,10137,126
2021-07-28,Tehama,103,63373,5300,5209,616,5825,66
2021-07-28,Trinity,105,12862,511,352,114,466,3
2021-07-28,Tulare,107,460477,51346,50363,9652,60015,854
2021-07-28,Tuolumne,109,53932,4443,4313,44,4357,64
2021-07-28,Ventura,111,848112,84582,83360,3491,86851,1043
2021-07-28,Yolo,113,214977,15111,14801,485,15286,215
2021-07-28,Yuba,115,75493,6739,6591,146,6737,51
2021-07-27,Alameda,001,1643700,96675,94682,2225,96907,1256
2021-07-27,Alpine,003,1148,90,89,0,89,0
2021-07-27,Amador,005,37829,3921,3861,34,3895,48
2021-07-27,Butte,007,227075,13440,13127,2004,15131,205
2021-07-27,Calaveras,009,45235,2325,2280,16,2296,57
2021-07-27,Colusa,011,21464,2030,1999,353,2352,16
2021-07-27,Contra Costa,013,1133247,77001,75227,1527,76754,830
2021-07-27,Del Norte,015,27424,1647,1538,14,1552,8
2021-07-27,El Dorado,017,186661,11227,10941,852,11793,116
2021-07-27,Fresno,019,978130,106093,104288,9155,113443,1746
2021-07-27,Glenn,021,27897,2494,2460,589,3049,20
2021-07-27,Humboldt,023,135768,5120,4925,75,5000,52
2021-07-27,Imperial,025,180216,29323,29048,2925,31973,743
2021-07-27,Inyo,027,18085,1451,1430,12,1442,38
2021-07-27,Kern,029,883053,100005,98724,11935,110659,1352
2021-07-27,Kings,031,150075,23907,23463,1172,24635,248
2021-07-27,Lake,033,64148,4320,4157,15,4172,65
2021-07-27,Lassen,035,31185,5344,5315,120,5435,21
2021-07-27,Los Angeles,037,10098052,1258977,1243336,45544,1288880,24658
2021-07-27,Madera,039,155013,17296,16998,1016,18014,245
2021-07-27,Marin,041,260295,14962,14631,295,14926,239
2021-07-27,Mariposa,043,17540,476,468,11,479,5
2021-07-27,Mendocino,045,87422,4532,4371,92,4463,49
2021-07-27,Merced,047,269075,32111,31825,1058,32883,473
2021-07-27,Modoc,049,8938,424,413,149,562,5
2021-07-27,Mono,051,14174,1293,1288,18,1306,3
2021-07-27,Monterey,053,433212,43980,43646,1993,45639,523
2021-07-27,Napa,055,140530,10486,10354,50,10404,82
2021-07-27,Nevada,057,99092,5589,5305,204,5509,72
2021-07-27,Orange,059,3164182,266187,262193,12213,274406,5143
2021-07-27,Placer,061,380077,25562,24916,1880,26796,306
2021-07-27,Plumas,063,18699,760,752,14,766,5
2021-07-27,Riverside,065,2383286,305031,299160,14696,313856,4554
2021-07-27,Sacramento,067,1510023,116468,114413,2232,116645,1710
2021-07-27,San Benito,069,59416,6264,6229,117,6346,63
2021-07-27,San Bernardino,071,2135413,303052,299593,9424,309017,5236
2021-07-27,San Diego,073,3302833,297371,293408,17055,310463,3798
2021-07-27,San Francisco,075,870044,41258,39939,1535,41474,561
2021-07-27,San Joaquin,077,732212,77297,76166,3927,80093,1442
2021-07-27,San Luis Obispo,079,281455,22300,21803,804,22607,260
2021-07-27,San Mateo,081,765935,45096,44378,586,44964,547
2021-07-27,Santa Barbara,083,443738,35749,35355,1277,36632,467
2021-07-27,Santa Clara,085,1922200,123987,122154,856,123010,2099
2021-07-27,Santa Cruz,087,273765,16805,16523,829,17352,207
2021-07-27,Shasta,089,179085,13105,12846,1749,14595,212
2021-07-27,Sierra,091,2930,71,65,12,77,0
2021-07-27,Siskiyou,093,43540,2060,1964,436,2400,31
2021-07-27,Solano,095,438530,35901,35093,715,35808,261
2021-07-27,Sonoma,097,501317,33071,32367,392,32759,328
2021-07-27,Stanislaus,099,539301,59023,58333,6304,64637,1033
2021-07-27,Sutter,101,95872,10206,9998,104,10102,115
2021-07-27,Tehama,103,63373,5279,5192,614,5806,66
2021-07-27,Trinity,105,12862,510,351,114,465,3
2021-07-27,Tulare,107,460477,51278,50324,9622,59946,854
2021-07-27,Tuolumne,109,53932,4391,4282,44,4326,64
2021-07-27,Ventura,111,848112,84374,83189,3479,86668,1043
2021-07-27,Yolo,113,214977,15037,14759,479,15238,215
2021-07-27,Yuba,115,75493,6717,6564,144,6708,51
2021-07-26,Alameda,001,1643700,96229,94436,2219,96655,1259
2021-07-26,Alpine,003,1148,90,89,0,89,0
2021-07-26,Amador,005,37829,3911,3854,34,3888,48
2021-07-26,Butte,007,227075,13385,13082,1993,15075,203
2021-07-26,Calaveras,009,45235,2320,2276,16,2292,57
2021-07-26,Colusa,011,21464,2023,1996,351,2347,16
2021-07-26,Contra Costa,013,1133247,76501,74854,1520,76374,830
2021-07-26,Del Norte,015,27424,1626,1530,14,1544,8
2021-07-26,El Dorado,017,186661,11163,10899,849,11748,116
2021-07-26,Fresno,019,978130,105889,104143,9131,113274,1742
2021-07-26,Glenn,021,27897,2492,2461,588,3049,20
2021-07-26,Humboldt,023,135768,5081,4906,73,4979,52
2021-07-26,Imperial,025,180216,29283,29034,2924,31958,743
2021-07-26,Inyo,027,18085,1446,1429,12,1441,38
2021-07-26,Kern,029,883053,99839,98633,11870,110503,1351
2021-07-26,Kings,031,150075,23858,23426,1168,24594,247
2021-07-26,Lake,033,64148,4299,4133,15,4148,65
2021-07-26,Lassen,035,31185,5340,5314,120,5434,21
2021-07-26,Los Angeles,037,10098052,1255652,1241527,45374,1286901,24647
2021-07-26,Madera,039,155013,17268,16971,1009,17980,245
2021-07-26,Marin,041,260295,14905,14579,294,14873,239
2021-07-26,Mariposa,043,17540,475,467,11,478,5
2021-07-26,Mendocino,045,87422,4511,4354,92,4446,49
2021-07-26,Merced,047,269075,32020,31774,1054,32828,473
2021-07-26,Modoc,049,8938,424,413,149,562,5
2021-07-26,Mono,051,14174,1292,1286,18,1304,3
2021-07-26,Monterey,053,433212,43937,43595,1980,45575,521
2021-07-26,Napa,055,140530,10463,10332,50,10382,82
2021-07-26,Nevada,057,99092,5503,5280,204,5484,72
2021-07-26,Orange,059,3164182,265549,261803,12192,273995,5142
2021-07-26,Placer,061,380077,25426,24842,1859,26701,304
2021-07-26,Plumas,063,18699,756,750,14,764,5
2021-07-26,Riverside,065,2383286,304337,298626,14682,313308,4553
2021-07-26,Sacramento,067,1510023,115868,113986,2216,116202,1705
2021-07-26,San Benito,069,59416,6258,6222,117,6339,63
2021-07-26,San Bernardino,071,2135413,302439,299238,9412,308650,5237
2021-07-26,San Diego,073,3302833,296257,292688,16981,309669,3793
2021-07-26,San Francisco,075,870044,40904,39800,1509,41309,561
2021-07-26,San Joaquin,077,732212,77062,76033,3923,79956,1440
2021-07-26,San Luis Obispo,079,281455,22251,21752,801,22553,260
2021-07-26,San Mateo,081,765935,44947,44297,577,44874,547
2021-07-26,Santa Barbara,083,443738,35677,35311,1265,36576,467
2021-07-26,Santa Clara,085,1922200,123678,121978,847,122825,2099
2021-07-26,Santa Cruz,087,273765,16766,16493,826,17319,207
2021-07-26,Shasta,089,179085,13056,12819,1736,14555,211
2021-07-26,Sierra,091,2930,70,65,12,77,0
2021-07-26,Siskiyou,093,43540,2057,1962,434,2396,31
2021-07-26,Solano,095,438530,35746,34990,707,35697,259
2021-07-26,Sonoma,097,501317,32936,32283,390,32673,328
2021-07-26,Stanislaus,099,539301,58878,58219,6285,64504,1033
2021-07-26,Sutter,101,95872,10166,9963,101,10064,115
2021-07-26,Tehama,103,63373,5269,5183,610,5793,66
2021-07-26,Trinity,105,12862,510,351,113,464,3
2021-07-26,Tulare,107,460477,51213,50265,9591,59856,854
2021-07-26,Tuolumne,109,53932,4360,4271,44,4315,64
2021-07-26,Ventura,111,848112,84201,83072,3464,86536,1041
2021-07-26,Yolo,113,214977,14976,14727,466,15193,215
2021-07-26,Yuba,115,75493,6683,6538,142,6680,51
2021-07-25,Alameda,001,1643700,95737,94146,2211,96357,1259
2021-07-25,Alpine,003,1148,88,89,0,89,0
2021-07-25,Amador,005,37829,3896,3848,34,3882,48
2021-07-25,Butte,007,227075,13346,13074,1983,15057,203
2021-07-25,Calaveras,009,45235,2311,2275,16,2291,57
2021-07-25,Colusa,011,21464,2014,1996,347,2343,16
2021-07-25,Contra Costa,013,1133247,76016,74634,1506,76140,830
2021-07-25,Del Norte,015,27424,1605,1526,14,1540,8
2021-07-25,El Dorado,017,186661,11105,10878,846,11724,116
2021-07-25,Fresno,019,978130,105648,104019,9115,113134,1742
2021-07-25,Glenn,021,27897,2483,2461,586,3047,20
2021-07-25,Humboldt,023,135768,5021,4892,72,4964,52
2021-07-25,Imperial,025,180216,29246,29037,2923,31960,743
2021-07-25,Inyo,027,18085,1441,1427,12,1439,38
2021-07-25,Kern,029,883053,99667,98503,11799,110302,1351
2021-07-25,Kings,031,150075,23804,23396,1164,24560,247
2021-07-25,Lake,033,64148,4246,4109,14,4123,65
2021-07-25,Lassen,035,31185,5335,5314,120,5434,21
2021-07-25,Los Angeles,037,10098052,1252250,1239596,45198,1284794,24643
2021-07-25,Madera,039,155013,17231,16947,1002,17949,245
2021-07-25,Marin,041,260295,14855,14558,291,14849,239
2021-07-25,Mariposa,043,17540,472,465,11,476,5
2021-07-25,Mendocino,045,87422,4482,4335,90,4425,49
2021-07-25,Merced,047,269075,31947,31760,1052,32812,473
2021-07-25,Modoc,049,8938,424,413,149,562,5
2021-07-25,Mono,051,14174,1289,1286,18,1304,3
2021-07-25,Monterey,053,433212,43898,43590,1972,45562,521
2021-07-25,Napa,055,140530,10427,10316,49,10365,82
2021-07-25,Nevada,057,99092,5438,5256,201,5457,72
2021-07-25,Orange,059,3164182,264841,261351,12169,273520,5142
2021-07-25,Placer,061,380077,25305,24755,1838,26593,304
2021-07-25,Plumas,063,18699,754,750,14,764,5
2021-07-25,Riverside,065,2383286,303573,298181,14664,312845,4553
2021-07-25,Sacramento,067,1510023,115318,113611,2200,115811,1704
2021-07-25,San Benito,069,59416,6251,6217,117,6334,63
2021-07-25,San Bernardino,071,2135413,301785,298982,9406,308388,5237
2021-07-25,San Diego,073,3302833,295185,290626,16912,307538,3793
2021-07-25,San Francisco,075,870044,40567,39663,1484,41147,561
2021-07-25,San Joaquin,077,732212,76807,75926,3904,79830,1440
2021-07-25,San Luis Obispo,079,281455,22178,21741,798,22539,260
2021-07-25,San Mateo,081,765935,44784,44189,571,44760,547
2021-07-25,Santa Barbara,083,443738,35598,35261,1262,36523,467
2021-07-25,Santa Clara,085,1922200,123348,121800,842,122642,2099
2021-07-25,Santa Cruz,087,273765,16719,16474,825,17299,207
2021-07-25,Shasta,089,179085,13009,12815,1731,14546,211
2021-07-25,Sierra,091,2930,70,65,12,77,0
2021-07-25,Siskiyou,093,43540,2049,1963,431,2394,31
2021-07-25,Solano,095,438530,35552,34863,704,35567,259
2021-07-25,Sonoma,097,501317,32811,32202,387,32589,328
2021-07-25,Stanislaus,099,539301,58712,58154,6280,64434,1033
2021-07-25,Sutter,101,95872,10112,9937,99,10036,115
2021-07-25,Tehama,103,63373,5253,5181,609,5790,66
2021-07-25,Trinity,105,12862,508,351,111,462,3
2021-07-25,Tulare,107,460477,51136,50221,9553,59774,854
2021-07-25,Tuolumne,109,53932,4308,4267,44,4311,64
2021-07-25,Ventura,111,848112,83987,82986,3441,86427,1041
2021-07-25,Yolo,113,214977,14915,14693,453,15146,215
2021-07-25,Yuba,115,75493,6650,6519,142,6661,51
2021-07-24,Alameda,001,1643700,95461,93170,2207,95377,1259
2021-07-24,Alpine,003,1148,88,89,0,89,0
2021-07-24,Amador,005,37829,3887,3816,34,3850,48
2021-07-24,Butte,007,227075,13317,12982,1981,14963,203
2021-07-24,Calaveras,009,45235,2307,2267,16,2283,57
2021-07-24,Colusa,011,21464,2013,1992,345,2337,16
2021-07-24,Contra Costa,013,1133247,75790,73682,1503,75185,830
2021-07-24,Del Norte,015,27424,1594,1497,14,1511,8
2021-07-24,El Dorado,017,186661,11071,10773,843,11616,116
2021-07-24,Fresno,019,978130,105530,103637,9106,112743,1736
2021-07-24,Glenn,021,27897,2482,2457,586,3043,20
2021-07-24,Humboldt,023,135768,4986,4780,71,4851,52
2021-07-24,Imperial,025,180216,29226,28996,2923,31919,742
2021-07-24,Inyo,027,18085,1438,1424,12,1436,38
2021-07-24,Kern,029,883053,99588,98261,11777,110038,1350
2021-07-24,Kings,031,150075,23773,23304,1161,24465,246
2021-07-24,Lake,033,64148,4223,3963,14,3977,64
2021-07-24,Lassen,035,31185,5334,5311,120,5431,21
2021-07-24,Los Angeles,037,10098052,1250483,1232164,45078,1277242,24623
2021-07-24,Madera,039,155013,17207,16885,1000,17885,245
2021-07-24,Marin,041,260295,14816,14454,291,14745,238
2021-07-24,Mariposa,043,17540,472,453,11,464,5
2021-07-24,Mendocino,045,87422,4457,4293,90,4383,49
2021-07-24,Merced,047,269075,31925,31661,1051,32712,473
2021-07-24,Modoc,049,8938,424,413,149,562,5
2021-07-24,Mono,051,14174,1287,1284,18,1302,3
2021-07-24,Monterey,053,433212,43873,43525,1965,45490,521
2021-07-24,Napa,055,140530,10411,10230,49,10279,81
2021-07-24,Nevada,057,99092,5406,5183,201,5384,72
2021-07-24,Orange,059,3164182,264377,259973,12157,272130,5141
2021-07-24,Placer,061,380077,25222,24530,1833,26363,303
2021-07-24,Plumas,063,18699,753,737,14,751,4
2021-07-24,Riverside,065,2383286,303105,296912,14654,311566,4552
2021-07-24,Sacramento,067,1510023,115003,112438,2196,114634,1698
2021-07-24,San Benito,069,59416,6247,6200,116,6316,63
2021-07-24,San Bernardino,071,2135413,301395,297899,9397,307296,5236
2021-07-24,San Diego,073,3302833,294719,289368,16884,306252,3788
2021-07-24,San Francisco,075,870044,40402,38954,1467,40421,561
2021-07-24,San Joaquin,077,732212,76679,75461,3893,79354,1436
2021-07-24,San Luis Obispo,079,281455,22147,21616,796,22412,260
2021-07-24,San Mateo,081,765935,44666,43880,565,44445,542
2021-07-24,Santa Barbara,083,443738,35538,35071,1258,36329,465
2021-07-24,Santa Clara,085,1922200,123135,121092,841,121933,2099
2021-07-24,Santa Cruz,087,273765,16696,16416,825,17241,207
2021-07-24,Shasta,089,179085,12981,12759,1728,14487,211
2021-07-24,Sierra,091,2930,69,64,12,76,0
2021-07-24,Siskiyou,093,43540,2049,1951,431,2382,31
2021-07-24,Solano,095,438530,35460,34499,695,35194,259
2021-07-24,Sonoma,097,501317,32687,31928,385,32313,327
2021-07-24,Stanislaus,099,539301,58620,57879,6270,64149,1030
2021-07-24,Sutter,101,95872,10085,9890,99,9989,115
2021-07-24,Tehama,103,63373,5246,5166,607,5773,65
2021-07-24,Trinity,105,12862,508,345,111,456,3
2021-07-24,Tulare,107,460477,51093,50104,9535,59639,854
2021-07-24,Tuolumne,109,53932,4282,4216,44,4260,64
2021-07-24,Ventura,111,848112,83860,82687,3424,86111,1041
2021-07-24,Yolo,113,214977,14878,14557,450,15007,214
2021-07-24,Yuba,115,75493,6631,6449,142,6591,51
2021-07-23,Alameda,001,1643700,95208,93170,2202,95372,1259
2021-07-23,Alpine,003,1148,88,89,0,89,0
2021-07-23,Amador,005,37829,3880,3816,34,3850,48
2021-07-23,Butte,007,227075,13288,12982,1973,14955,203
2021-07-23,Calaveras,009,45235,2296,2267,16,2283,57
2021-07-23,Colusa,011,21464,2012,1992,345,2337,16
2021-07-23,Contra Costa,013,1133247,75532,73682,1493,75175,830
2021-07-23,Del Norte,015,27424,1586,1497,14,1511,8
2021-07-23,El Dorado,017,186661,11042,10773,839,11612,116
2021-07-23,Fresno,019,978130,105399,103637,9096,112733,1736
2021-07-23,Glenn,021,27897,2480,2457,583,3040,20
2021-07-23,Humboldt,023,135768,4964,4780,68,4848,52
2021-07-23,Imperial,025,180216,29214,28996,2923,31919,742
2021-07-23,Inyo,027,18085,1435,1424,12,1436,38
2021-07-23,Kern,029,883053,99505,98261,11751,110012,1350
2021-07-23,Kings,031,150075,23742,23304,1158,24462,246
2021-07-23,Lake,033,64148,4193,3963,14,3977,64
2021-07-23,Lassen,035,31185,5332,5311,120,5431,21
2021-07-23,Los Angeles,037,10098052,1248559,1232164,44991,1277155,24623
2021-07-23,Madera,039,155013,17177,16885,995,17880,245
2021-07-23,Marin,041,260295,14779,14454,289,14743,238
2021-07-23,Mariposa,043,17540,469,453,11,464,5
2021-07-23,Mendocino,045,87422,4444,4293,90,4383,49
2021-07-23,Merced,047,269075,31900,31661,1051,32712,473
2021-07-23,Modoc,049,8938,424,413,149,562,5
2021-07-23,Mono,051,14174,1286,1284,18,1302,3
2021-07-23,Monterey,053,433212,43848,43525,1965,45490,521
2021-07-23,Napa,055,140530,10390,10230,49,10279,81
2021-07-23,Nevada,057,99092,5362,5183,201,5384,72
2021-07-23,Orange,059,3164182,263927,259973,12134,272107,5141
2021-07-23,Placer,061,380077,25142,24530,1817,26347,303
2021-07-23,Plumas,063,18699,751,737,14,751,4
2021-07-23,Riverside,065,2383286,302640,296912,14642,311554,4552
2021-07-23,Sacramento,067,1510023,114650,112438,2194,114632,1698
2021-07-23,San Benito,069,59416,6241,6200,116,6316,63
2021-07-23,San Bernardino,071,2135413,301017,297899,9388,307287,5236
2021-07-23,San Diego,073,3302833,294112,289368,16836,306204,3788
2021-07-23,San Francisco,075,870044,40219,38954,1454,40408,561
2021-07-23,San Joaquin,077,732212,76575,75461,3878,79339,1436
2021-07-23,San Luis Obispo,079,281455,22109,21616,796,22412,260
2021-07-23,San Mateo,081,765935,44561,43880,560,44440,542
2021-07-23,Santa Barbara,083,443738,35471,35071,1257,36328,465
2021-07-23,Santa Clara,085,1922200,122916,121092,838,121930,2099
2021-07-23,Santa Cruz,087,273765,16671,16416,825,17241,207
2021-07-23,Shasta,089,179085,12954,12759,1725,14484,211
2021-07-23,Sierra,091,2930,69,64,12,76,0
2021-07-23,Siskiyou,093,43540,2047,1951,431,2382,31
2021-07-23,Solano,095,438530,35367,34499,691,35190,259
2021-07-23,Sonoma,097,501317,32593,31928,384,32312,327
2021-07-23,Stanislaus,099,539301,58544,57879,6260,64139,1030
2021-07-23,Sutter,101,95872,10056,9890,99,9989,115
2021-07-23,Tehama,103,63373,5237,5166,607,5773,65
2021-07-23,Trinity,105,12862,507,345,110,455,3
2021-07-23,Tulare,107,460477,51047,50104,9510,59614,854
2021-07-23,Tuolumne,109,53932,4260,4216,44,4260,64
2021-07-23,Ventura,111,848112,83698,82687,3406,86093,1041
2021-07-23,Yolo,113,214977,14840,14557,443,15000,214
2021-07-23,Yuba,115,75493,6605,6449,141,6590,51
2021-07-22,Alameda,001,1643700,94859,93170,2197,95367,1259
2021-07-22,Alpine,003,1148,88,89,0,89,0
2021-07-22,Amador,005,37829,3871,3816,34,3850,48
2021-07-22,Butte,007,227075,13254,12982,1964,14946,203
2021-07-22,Calaveras,009,45235,2287,2267,16,2283,57
2021-07-22,Colusa,011,21464,2010,1992,342,2334,16
2021-07-22,Contra Costa,013,1133247,75193,73682,1488,75170,830
2021-07-22,Del Norte,015,27424,1569,1497,14,1511,8
2021-07-22,El Dorado,017,186661,11007,10773,831,11604,116
2021-07-22,Fresno,019,978130,105270,103637,9086,112723,1736
2021-07-22,Glenn,021,27897,2476,2457,583,3040,20
2021-07-22,Humboldt,023,135768,4933,4780,66,4846,52
2021-07-22,Imperial,025,180216,29184,28996,2923,31919,742
2021-07-22,Inyo,027,18085,1433,1424,12,1436,38
2021-07-22,Kern,029,883053,99389,98261,11709,109970,1350
2021-07-22,Kings,031,150075,23703,23304,1156,24460,246
2021-07-22,Lake,033,64148,4142,3963,14,3977,64
2021-07-22,Lassen,035,31185,5329,5311,120,5431,21
2021-07-22,Los Angeles,037,10098052,1246153,1232164,44834,1276998,24623
2021-07-22,Madera,039,155013,17142,16885,993,17878,245
2021-07-22,Marin,041,260295,14738,14454,288,14742,238
2021-07-22,Mariposa,043,17540,462,453,11,464,5
2021-07-22,Mendocino,045,87422,4431,4293,89,4382,49
2021-07-22,Merced,047,269075,31858,31661,1049,32710,473
2021-07-22,Modoc,049,8938,424,413,149,562,5
2021-07-22,Mono,051,14174,1285,1284,18,1302,3
2021-07-22,Monterey,053,433212,43819,43525,1959,45484,521
2021-07-22,Napa,055,140530,10372,10230,49,10279,81
2021-07-22,Nevada,057,99092,5336,5183,200,5383,72
2021-07-22,Orange,059,3164182,263373,259973,12125,272098,5141
2021-07-22,Placer,061,380077,25048,24530,1806,26336,303
2021-07-22,Plumas,063,18699,750,737,14,751,4
2021-07-22,Riverside,065,2383286,302131,296912,14621,311533,4552
2021-07-22,Sacramento,067,1510023,114212,112438,2185,114623,1698
2021-07-22,San Benito,069,59416,6233,6200,116,6316,63
2021-07-22,San Bernardino,071,2135413,300619,297899,9372,307271,5236
2021-07-22,San Diego,073,3302833,293385,289368,16776,306144,3788
2021-07-22,San Francisco,075,870044,40006,38954,1442,40396,561
2021-07-22,San Joaquin,077,732212,76432,75461,3865,79326,1436
2021-07-22,San Luis Obispo,079,281455,22072,21616,792,22408,260
2021-07-22,San Mateo,081,765935,44449,43880,555,44435,542
2021-07-22,Santa Barbara,083,443738,35406,35071,1255,36326,465
2021-07-22,Santa Clara,085,1922200,122674,121092,835,121927,2099
2021-07-22,Santa Cruz,087,273765,16634,16416,825,17241,207
2021-07-22,Shasta,089,179085,12930,12759,1721,14480,211
2021-07-22,Sierra,091,2930,67,64,12,76,0
2021-07-22,Siskiyou,093,43540,2044,1951,431,2382,31
2021-07-22,Solano,095,438530,35217,34499,684,35183,259
2021-07-22,Sonoma,097,501317,32483,31928,382,32310,327
2021-07-22,Stanislaus,099,539301,58416,57879,6248,64127,1030
2021-07-22,Sutter,101,95872,10035,9890,99,9989,115
2021-07-22,Tehama,103,63373,5231,5166,607,5773,65
2021-07-22,Trinity,105,12862,507,345,110,455,3
2021-07-22,Tulare,107,460477,51004,50104,9482,59586,854
2021-07-22,Tuolumne,109,53932,4248,4216,44,4260,64
2021-07-22,Ventura,111,848112,83564,82687,3393,86080,1041
2021-07-22,Yolo,113,214977,14802,14557,442,14999,214
2021-07-22,Yuba,115,75493,6574,6449,138,6587,51
2021-07-21,Alameda,001,1643700,94539,92840,2193,95033,1256
2021-07-21,Alpine,003,1148,88,89,0,89,0
2021-07-21,Amador,005,37829,3858,3813,34,3847,48
2021-07-21,Butte,007,227075,13213,12939,1959,14898,203
2021-07-21,Calaveras,009,45235,2282,2257,16,2273,57
2021-07-21,Colusa,011,21464,2006,1988,341,2329,16
2021-07-21,Contra Costa,013,1133247,74928,73320,1479,74799,827
2021-07-21,Del Norte,015,27424,1559,1492,14,1506,8
2021-07-21,El Dorado,017,186661,10972,10742,827,11569,116
2021-07-21,Fresno,019,978130,105122,103504,9077,112581,1736
2021-07-21,Glenn,021,27897,2474,2455,582,3037,20
2021-07-21,Humboldt,023,135768,4901,4763,64,4827,52
2021-07-21,Imperial,025,180216,29172,28964,2916,31880,742
2021-07-21,Inyo,027,18085,1433,1423,12,1435,38
2021-07-21,Kern,029,883053,99271,98152,11668,109820,1350
2021-07-21,Kings,031,150075,23675,23270,1152,24422,246
2021-07-21,Lake,033,64148,4077,3896,14,3910,64
2021-07-21,Lassen,035,31185,5326,5310,120,5430,21
2021-07-21,Los Angeles,037,10098052,1243673,1229598,44709,1274307,24609
2021-07-21,Madera,039,155013,17118,16858,990,17848,245
2021-07-21,Marin,041,260295,14688,14427,288,14715,238
2021-07-21,Mariposa,043,17540,458,449,11,460,5
2021-07-21,Mendocino,045,87422,4413,4274,89,4363,49
2021-07-21,Merced,047,269075,31819,31607,1044,32651,473
2021-07-21,Modoc,049,8938,424,413,149,562,5
2021-07-21,Mono,051,14174,1282,1282,18,1300,3
2021-07-21,Monterey,053,433212,43789,43502,1955,45457,515
2021-07-21,Napa,055,140530,10346,10209,49,10258,81
2021-07-21,Nevada,057,99092,5301,5152,200,5352,72
2021-07-21,Orange,059,3164182,262821,259615,12094,271709,5139
2021-07-21,Placer,061,380077,24939,24441,1795,26236,303
2021-07-21,Plumas,063,18699,750,736,14,750,4
2021-07-21,Riverside,065,2383286,301618,296419,14604,311023,4552
2021-07-21,Sacramento,067,1510023,113790,112043,2174,114217,1696
2021-07-21,San Benito,069,59416,6223,6196,116,6312,63
2021-07-21,San Bernardino,071,2135413,300173,297519,9364,306883,5230
2021-07-21,San Diego,073,3302833,292532,288682,16712,305394,3787
2021-07-21,San Francisco,075,870044,39782,38699,1437,40136,559
2021-07-21,San Joaquin,077,732212,76243,75288,3853,79141,1434
2021-07-21,San Luis Obispo,079,281455,22035,21579,789,22368,260
2021-07-21,San Mateo,081,765935,44356,43755,551,44306,542
2021-07-21,Santa Barbara,083,443738,35346,34998,1239,36237,465
2021-07-21,Santa Clara,085,1922200,122464,120838,833,121671,2099
2021-07-21,Santa Cruz,087,273765,16600,16407,825,17232,207
2021-07-21,Shasta,089,179085,12897,12751,1718,14469,211
2021-07-21,Sierra,091,2930,67,64,12,76,0
2021-07-21,Siskiyou,093,43540,2042,1943,429,2372,31
2021-07-21,Solano,095,438530,35060,34374,679,35053,258
2021-07-21,Sonoma,097,501317,32367,31789,382,32171,327
2021-07-21,Stanislaus,099,539301,58314,57774,6239,64013,1028
2021-07-21,Sutter,101,95872,10011,9862,99,9961,113
2021-07-21,Tehama,103,63373,5227,5161,607,5768,65
2021-07-21,Trinity,105,12862,505,345,109,454,3
2021-07-21,Tulare,107,460477,50945,50066,9456,59522,854
2021-07-21,Tuolumne,109,53932,4210,4156,44,4200,64
2021-07-21,Ventura,111,848112,83442,82573,3381,85954,1041
2021-07-21,Yolo,113,214977,14759,14525,441,14966,213
2021-07-21,Yuba,115,75493,6546,6425,138,6563,52
2021-07-20,Alameda,001,1643700,94163,92625,2179,94804,1256
2021-07-20,Alpine,003,1148,88,89,0,89,0
2021-07-20,Amador,005,37829,3847,3807,34,3841,48
2021-07-20,Butte,007,227075,13176,12916,1954,14870,203
2021-07-20,Calaveras,009,45235,2277,2249,16,2265,57
2021-07-20,Colusa,011,21464,2006,1985,341,2326,16
2021-07-20,Contra Costa,013,1133247,74643,73143,1461,74604,825
2021-07-20,Del Norte,015,27424,1549,1490,14,1504,8
2021-07-20,El Dorado,017,186661,10932,10727,823,11550,116
2021-07-20,Fresno,019,978130,104986,103438,9058,112496,1736
2021-07-20,Glenn,021,27897,2474,2453,582,3035,20
2021-07-20,Humboldt,023,135768,4856,4735,62,4797,52
2021-07-20,Imperial,025,180216,29152,28933,2916,31849,742
2021-07-20,Inyo,027,18085,1429,1420,12,1432,36
2021-07-20,Kern,029,883053,99161,98082,11641,109723,1350
2021-07-20,Kings,031,150075,23634,23254,1148,24402,246
2021-07-20,Lake,033,64148,4052,3871,14,3885,64
2021-07-20,Lassen,035,31185,5326,5306,120,5426,21
2021-07-20,Los Angeles,037,10098052,1240895,1227404,44552,1271956,24603
2021-07-20,Madera,039,155013,17097,16856,986,17842,245
2021-07-20,Marin,041,260295,14653,14396,285,14681,234
2021-07-20,Mariposa,043,17540,456,448,11,459,5
2021-07-20,Mendocino,045,87422,4396,4259,89,4348,49
2021-07-20,Merced,047,269075,31780,31578,1037,32615,473
2021-07-20,Modoc,049,8938,424,413,149,562,5
2021-07-20,Mono,051,14174,1278,1281,18,1299,3
2021-07-20,Monterey,053,433212,43758,43481,1952,45433,515
2021-07-20,Napa,055,140530,10323,10191,49,10240,81
2021-07-20,Nevada,057,99092,5282,5148,199,5347,72
2021-07-20,Orange,059,3164182,262264,259303,12062,271365,5139
2021-07-20,Placer,061,380077,24847,24408,1771,26179,303
2021-07-20,Plumas,063,18699,748,736,14,750,4
2021-07-20,Riverside,065,2383286,301083,296118,14590,310708,4543
2021-07-20,Sacramento,067,1510023,113350,111796,2144,113940,1695
2021-07-20,San Benito,069,59416,6216,6196,116,6312,63
2021-07-20,San Bernardino,071,2135413,299762,297222,9339,306561,5231
2021-07-20,San Diego,073,3302833,291610,288209,16616,304825,3786
2021-07-20,San Francisco,075,870044,39525,38536,1426,39962,558
2021-07-20,San Joaquin,077,732212,76071,75198,3840,79038,1433
2021-07-20,San Luis Obispo,079,281455,21989,21556,788,22344,259
2021-07-20,San Mateo,081,765935,44239,43670,550,44220,542
2021-07-20,Santa Barbara,083,443738,35275,34935,1233,36168,462
2021-07-20,Santa Clara,085,1922200,122207,120704,831,121535,2098
2021-07-20,Santa Cruz,087,273765,16571,16399,825,17224,207
2021-07-20,Shasta,089,179085,12871,12734,1714,14448,211
2021-07-20,Sierra,091,2930,67,64,12,76,0
2021-07-20,Siskiyou,093,43540,2038,1931,428,2359,31
2021-07-20,Solano,095,438530,34927,34337,672,35009,258
2021-07-20,Sonoma,097,501317,32248,31763,381,32144,326
2021-07-20,Stanislaus,099,539301,58199,57706,6233,63939,1028
2021-07-20,Sutter,101,95872,9984,9854,96,9950,114
2021-07-20,Tehama,103,63373,5225,5153,607,5760,65
2021-07-20,Trinity,105,12862,503,344,108,452,3
2021-07-20,Tulare,107,460477,50903,50047,9439,59486,854
2021-07-20,Tuolumne,109,53932,4191,4156,44,4200,64
2021-07-20,Ventura,111,848112,83289,82504,3364,85868,1041
2021-07-20,Yolo,113,214977,14695,14495,438,14933,213
2021-07-20,Yuba,115,75493,6521,6393,135,6528,52
2021-07-19,Alameda,001,1643700,93791,92357,2163,94520,1256
2021-07-19,Alpine,003,1148,88,89,0,89,0
2021-07-19,Amador,005,37829,3843,3802,34,3836,48
2021-07-19,Butte,007,227075,13133,12901,1948,14849,202
2021-07-19,Calaveras,009,45235,2273,2245,16,2261,57
2021-07-19,Colusa,011,21464,2004,1981,340,2321,16
2021-07-19,Contra Costa,013,1133247,74331,72935,1441,74376,825
2021-07-19,Del Norte,015,27424,1536,1484,14,1498,8
2021-07-19,El Dorado,017,186661,10902,10703,815,11518,114
2021-07-19,Fresno,019,978130,104855,103350,9045,112395,1731
2021-07-19,Glenn,021,27897,2474,2452,581,3033,20
2021-07-19,Humboldt,023,135768,4826,4719,60,4779,52
2021-07-19,Imperial,025,180216,29125,28888,2914,31802,742
2021-07-19,Inyo,027,18085,1428,1417,12,1429,36
2021-07-19,Kern,029,883053,99049,97999,11606,109605,1349
2021-07-19,Kings,031,150075,23604,23221,1142,24363,246
2021-07-19,Lake,033,64148,4016,3848,14,3862,64
2021-07-19,Lassen,035,31185,5325,5305,120,5425,21
2021-07-19,Los Angeles,037,10098052,1238306,1225946,44364,1270310,24600
2021-07-19,Madera,039,155013,17074,16846,983,17829,244
2021-07-19,Marin,041,260295,14618,14369,282,14651,234
2021-07-19,Mariposa,043,17540,450,447,11,458,5
2021-07-19,Mendocino,045,87422,4378,4251,89,4340,49
2021-07-19,Merced,047,269075,31716,31565,1030,32595,472
2021-07-19,Modoc,049,8938,423,413,149,562,5
2021-07-19,Mono,051,14174,1276,1280,18,1298,3
2021-07-19,Monterey,053,433212,43734,43436,1951,45387,515
2021-07-19,Napa,055,140530,10298,10180,47,10227,81
2021-07-19,Nevada,057,99092,5254,5133,198,5331,72
2021-07-19,Orange,059,3164182,261741,258927,12030,270957,5138
2021-07-19,Placer,061,380077,24748,24359,1749,26108,303
2021-07-19,Plumas,063,18699,748,730,14,744,4
2021-07-19,Riverside,065,2383286,300593,295736,14552,310288,4543
2021-07-19,Sacramento,067,1510023,112986,111470,2120,113590,1696
2021-07-19,San Benito,069,59416,6213,6193,116,6309,63
2021-07-19,San Bernardino,071,2135413,299390,296929,9321,306250,5235
2021-07-19,San Diego,073,3302833,290722,287695,16513,304208,3786
2021-07-19,San Francisco,075,870044,39256,38463,1413,39876,560
2021-07-19,San Joaquin,077,732212,75906,75086,3834,78920,1431
2021-07-19,San Luis Obispo,079,281455,21944,21531,784,22315,259
2021-07-19,San Mateo,081,765935,44094,43563,541,44104,542
2021-07-19,Santa Barbara,083,443738,35202,34904,1231,36135,461
2021-07-19,Santa Clara,085,1922200,121949,120554,830,121384,2098
2021-07-19,Santa Cruz,087,273765,16555,16387,825,17212,207
2021-07-19,Shasta,089,179085,12853,12723,1712,14435,209
2021-07-19,Sierra,091,2930,66,64,12,76,0
2021-07-19,Siskiyou,093,43540,2033,1927,426,2353,31
2021-07-19,Solano,095,438530,34754,34262,661,34923,261
2021-07-19,Sonoma,097,501317,32127,31713,380,32093,325
2021-07-19,Stanislaus,099,539301,58098,57644,6223,63867,1027
2021-07-19,Sutter,101,95872,9968,9834,96,9930,114
2021-07-19,Tehama,103,63373,5219,5152,605,5757,65
2021-07-19,Trinity,105,12862,503,344,107,451,3
2021-07-19,Tulare,107,460477,50858,49994,9421,59415,855
2021-07-19,Tuolumne,109,53932,4181,4151,44,4195,64
2021-07-19,Ventura,111,848112,83193,82409,3342,85751,1041
2021-07-19,Yolo,113,214977,14664,14439,436,14875,213
2021-07-19,Yuba,115,75493,6497,6370,135,6505,52
2021-07-18,Alameda,001,1643700,93435,92162,2150,94312,1256
2021-07-18,Alpine,003,1148,88,89,0,89,0
2021-07-18,Amador,005,37829,3832,3799,34,3833,48
2021-07-18,Butte,007,227075,13090,12888,1943,14831,202
2021-07-18,Calaveras,009,45235,2270,2243,16,2259,57
2021-07-18,Colusa,011,21464,2004,1981,339,2320,16
2021-07-18,Contra Costa,013,1133247,74016,72849,1423,74272,825
2021-07-18,Del Norte,015,27424,1527,1482,14,1496,8
2021-07-18,El Dorado,017,186661,10864,10687,807,11494,114
2021-07-18,Fresno,019,978130,104701,103298,9027,112325,1731
2021-07-18,Glenn,021,27897,2473,2452,580,3032,20
2021-07-18,Humboldt,023,135768,4790,4714,60,4774,52
2021-07-18,Imperial,025,180216,29088,28877,2913,31790,742
2021-07-18,Inyo,027,18085,1424,1417,12,1429,36
2021-07-18,Kern,029,883053,98923,97963,11564,109527,1349
2021-07-18,Kings,031,150075,23583,23203,1138,24341,246
2021-07-18,Lake,033,64148,3980,3825,14,3839,64
2021-07-18,Lassen,035,31185,5325,5305,120,5425,21
2021-07-18,Los Angeles,037,10098052,1235632,1224691,44188,1268879,24598
2021-07-18,Madera,039,155013,17049,16838,979,17817,244
2021-07-18,Marin,041,260295,14582,14358,280,14638,234
2021-07-18,Mariposa,043,17540,449,447,11,458,5
2021-07-18,Mendocino,045,87422,4357,4246,89,4335,49
2021-07-18,Merced,047,269075,31685,31537,1028,32565,471
2021-07-18,Modoc,049,8938,423,413,149,562,5
2021-07-18,Mono,051,14174,1275,1280,18,1298,3
2021-07-18,Monterey,053,433212,43716,43422,1942,45364,515
2021-07-18,Napa,055,140530,10281,10174,44,10218,81
2021-07-18,Nevada,057,99092,5228,5124,198,5322,72
2021-07-18,Orange,059,3164182,261256,258724,12000,270724,5138
2021-07-18,Placer,061,380077,24681,24313,1722,26035,303
2021-07-18,Plumas,063,18699,748,730,14,744,4
2021-07-18,Riverside,065,2383286,300101,295522,14510,310032,4543
2021-07-18,Sacramento,067,1510023,112554,111255,2088,113343,1696
2021-07-18,San Benito,069,59416,6205,6191,116,6307,63
2021-07-18,San Bernardino,071,2135413,298916,296739,9306,306045,5233
2021-07-18,San Diego,073,3302833,289906,286287,16430,302717,3786
2021-07-18,San Francisco,075,870044,39024,38367,1402,39769,560
2021-07-18,San Joaquin,077,732212,75729,74997,3821,78818,1431
2021-07-18,San Luis Obispo,079,281455,21909,21527,781,22308,259
2021-07-18,San Mateo,081,765935,43980,43506,535,44041,542
2021-07-18,Santa Barbara,083,443738,35137,34880,1229,36109,461
2021-07-18,Santa Clara,085,1922200,121735,120438,823,121261,2098
2021-07-18,Santa Cruz,087,273765,16523,16372,824,17196,207
2021-07-18,Shasta,089,179085,12828,12714,1708,14422,209
2021-07-18,Sierra,091,2930,66,64,12,76,0
2021-07-18,Siskiyou,093,43540,2027,1927,421,2348,31
2021-07-18,Solano,095,438530,34627,34215,657,34872,261
2021-07-18,Sonoma,097,501317,32022,31675,379,32054,325
2021-07-18,Stanislaus,099,539301,57987,57600,6198,63798,1028
2021-07-18,Sutter,101,95872,9936,9826,96,9922,114
2021-07-18,Tehama,103,63373,5216,5150,604,5754,65
2021-07-18,Trinity,105,12862,503,344,107,451,3
2021-07-18,Tulare,107,460477,50805,49985,9398,59383,855
2021-07-18,Tuolumne,109,53932,4163,4149,44,4193,64
2021-07-18,Ventura,111,848112,83079,82361,3318,85679,1041
2021-07-18,Yolo,113,214977,14605,14425,430,14855,213
2021-07-18,Yuba,115,75493,6456,6357,135,6492,52
2021-07-17,Alameda,001,1643700,93216,91346,2138,93484,1255
2021-07-17,Alpine,003,1148,88,89,0,89,0
2021-07-17,Amador,005,37829,3823,3785,34,3819,48
2021-07-17,Butte,007,227075,13076,12824,1938,14762,202
2021-07-17,Calaveras,009,45235,2263,2237,16,2253,57
2021-07-17,Colusa,011,21464,2001,1976,339,2315,16
2021-07-17,Contra Costa,013,1133247,73834,72254,1410,73664,824
2021-07-17,Del Norte,015,27424,1519,1475,14,1489,8
2021-07-17,El Dorado,017,186661,10837,10622,803,11425,114
2021-07-17,Fresno,019,978130,104629,103055,9014,112069,1730
2021-07-17,Glenn,021,27897,2472,2451,580,3031,20
2021-07-17,Humboldt,023,135768,4777,4654,59,4713,52
2021-07-17,Imperial,025,180216,29072,28840,2913,31753,742
2021-07-17,Inyo,027,18085,1424,1416,12,1428,36
2021-07-17,Kern,029,883053,98866,97796,11527,109323,1348
2021-07-17,Kings,031,150075,23563,23163,1137,24300,246
2021-07-17,Lake,033,64148,3955,3760,14,3774,64
2021-07-17,Lassen,035,31185,5325,5302,120,5422,21
2021-07-17,Los Angeles,037,10098052,1234120,1219733,44044,1263777,24582
2021-07-17,Madera,039,155013,17041,16804,979,17783,240
2021-07-17,Marin,041,260295,14564,14297,278,14575,234
2021-07-17,Mariposa,043,17540,449,445,11,456,5
2021-07-17,Mendocino,045,87422,4345,4209,89,4298,49
2021-07-17,Merced,047,269075,31664,31451,1024,32475,471
2021-07-17,Modoc,049,8938,423,412,149,561,5
2021-07-17,Mono,051,14174,1273,1277,18,1295,3
2021-07-17,Monterey,053,433212,43693,43367,1937,45304,515
2021-07-17,Napa,055,140530,10265,10129,44,10173,81
2021-07-17,Nevada,057,99092,5213,5066,198,5264,72
2021-07-17,Orange,059,3164182,260949,257805,11961,269766,5136
2021-07-17,Placer,061,380077,24614,24169,1708,25877,303
2021-07-17,Plumas,063,18699,743,721,14,735,4
2021-07-17,Riverside,065,2383286,299794,294751,14478,309229,4542
2021-07-17,Sacramento,067,1510023,112318,110432,2066,112498,1694
2021-07-17,San Benito,069,59416,6199,6181,116,6297,63
2021-07-17,San Bernardino,071,2135413,298682,296048,9287,305335,5218
2021-07-17,San Diego,073,3302833,289498,285698,16363,302061,3786
2021-07-17,San Francisco,075,870044,38902,37978,1398,39376,560
2021-07-17,San Joaquin,077,732212,75642,74695,3815,78510,1430
2021-07-17,San Luis Obispo,079,281455,21882,21462,781,22243,258
2021-07-17,San Mateo,081,765935,43909,43324,534,43858,542
2021-07-17,Santa Barbara,083,443738,35095,34769,1226,35995,461
2021-07-17,Santa Clara,085,1922200,121563,119980,820,120800,2097
2021-07-17,Santa Cruz,087,273765,16516,16337,824,17161,207
2021-07-17,Shasta,089,179085,12813,12683,1703,14386,210
2021-07-17,Sierra,091,2930,66,62,12,74,0
2021-07-17,Siskiyou,093,43540,2022,1922,418,2340,29
2021-07-17,Solano,095,438530,34562,34015,649,34664,263
2021-07-17,Sonoma,097,501317,31954,31536,378,31914,322
2021-07-17,Stanislaus,099,539301,57910,57400,6184,63584,1028
2021-07-17,Sutter,101,95872,9926,9778,96,9874,114
2021-07-17,Tehama,103,63373,5213,5145,604,5749,64
2021-07-17,Trinity,105,12862,502,341,107,448,3
2021-07-17,Tulare,107,460477,50784,49937,9386,59323,854
2021-07-17,Tuolumne,109,53932,4153,4131,44,4175,64
2021-07-17,Ventura,111,848112,83011,82125,3307,85432,1041
2021-07-17,Yolo,113,214977,14574,14356,423,14779,213
2021-07-17,Yuba,115,75493,6445,6309,135,6444,52
2021-07-16,Alameda,001,1643700,92973,91346,2126,93472,1255
2021-07-16,Alpine,003,1148,88,89,0,89,0
2021-07-16,Amador,005,37829,3820,3785,34,3819,48
2021-07-16,Butte,007,227075,13051,12824,1935,14759,202
2021-07-16,Calaveras,009,45235,2262,2237,16,2253,57
2021-07-16,Colusa,011,21464,1999,1976,338,2314,16
2021-07-16,Contra Costa,013,1133247,73646,72254,1406,73660,824
2021-07-16,Del Norte,015,27424,1517,1475,14,1489,8
2021-07-16,El Dorado,017,186661,10818,10622,802,11424,114
2021-07-16,Fresno,019,978130,104577,103055,8995,112050,1730
2021-07-16,Glenn,021,27897,2472,2451,580,3031,20
2021-07-16,Humboldt,023,135768,4755,4654,59,4713,52
2021-07-16,Imperial,025,180216,29060,28840,2913,31753,742
2021-07-16,Inyo,027,18085,1422,1416,12,1428,36
2021-07-16,Kern,029,883053,98804,97796,11488,109284,1348
2021-07-16,Kings,031,150075,23538,23163,1135,24298,246
2021-07-16,Lake,033,64148,3928,3760,14,3774,64
2021-07-16,Lassen,035,31185,5324,5302,120,5422,21
2021-07-16,Los Angeles,037,10098052,1232624,1219733,43901,1263634,24582
2021-07-16,Madera,039,155013,17023,16804,979,17783,240
2021-07-16,Marin,041,260295,14540,14297,275,14572,234
2021-07-16,Mariposa,043,17540,449,445,11,456,5
2021-07-16,Mendocino,045,87422,4336,4209,88,4297,49
2021-07-16,Merced,047,269075,31642,31451,1022,32473,471
2021-07-16,Modoc,049,8938,423,412,149,561,5
2021-07-16,Mono,051,14174,1272,1277,18,1295,3
2021-07-16,Monterey,053,433212,43671,43367,1936,45303,515
2021-07-16,Napa,055,140530,10241,10129,43,10172,81
2021-07-16,Nevada,057,99092,5203,5066,198,5264,72
2021-07-16,Orange,059,3164182,260677,257805,11921,269726,5136
2021-07-16,Placer,061,380077,24561,24169,1703,25872,303
2021-07-16,Plumas,063,18699,742,721,14,735,4
2021-07-16,Riverside,065,2383286,299518,294751,14452,309203,4542
2021-07-16,Sacramento,067,1510023,112101,110432,2053,112485,1694
2021-07-16,San Benito,069,59416,6197,6181,116,6297,63
2021-07-16,San Bernardino,071,2135413,298404,296048,9270,305318,5218
2021-07-16,San Diego,073,3302833,289055,285698,16316,302014,3786
2021-07-16,San Francisco,075,870044,38785,37978,1393,39371,560
2021-07-16,San Joaquin,077,732212,75547,74695,3812,78507,1430
2021-07-16,San Luis Obispo,079,281455,21865,21462,781,22243,258
2021-07-16,San Mateo,081,765935,43856,43324,533,43857,542
2021-07-16,Santa Barbara,083,443738,35057,34769,1226,35995,461
2021-07-16,Santa Clara,085,1922200,121416,119980,812,120792,2097
2021-07-16,Santa Cruz,087,273765,16503,16337,824,17161,207
2021-07-16,Shasta,089,179085,12803,12683,1702,14385,210
2021-07-16,Sierra,091,2930,66,62,12,74,0
2021-07-16,Siskiyou,093,43540,2020,1922,416,2338,29
2021-07-16,Solano,095,438530,34495,34015,641,34656,263
2021-07-16,Sonoma,097,501317,31902,31536,375,31911,322
2021-07-16,Stanislaus,099,539301,57861,57400,6173,63573,1028
2021-07-16,Sutter,101,95872,9914,9778,96,9874,114
2021-07-16,Tehama,103,63373,5211,5145,604,5749,64
2021-07-16,Trinity,105,12862,502,341,106,447,3
2021-07-16,Tulare,107,460477,50760,49937,9376,59313,854
2021-07-16,Tuolumne,109,53932,4147,4131,44,4175,64
2021-07-16,Ventura,111,848112,82946,82125,3300,85425,1041
2021-07-16,Yolo,113,214977,14548,14356,419,14775,213
2021-07-16,Yuba,115,75493,6423,6309,134,6443,52
2021-07-15,Alameda,001,1643700,92677,91346,2116,93462,1255
2021-07-15,Alpine,003,1148,88,89,0,89,0
2021-07-15,Amador,005,37829,3817,3785,34,3819,48
2021-07-15,Butte,007,227075,13025,12824,1933,14757,202
2021-07-15,Calaveras,009,45235,2259,2237,16,2253,57
2021-07-15,Colusa,011,21464,1998,1976,337,2313,16
2021-07-15,Contra Costa,013,1133247,73433,72254,1399,73653,824
2021-07-15,Del Norte,015,27424,1514,1475,14,1489,8
2021-07-15,El Dorado,017,186661,10791,10622,800,11422,114
2021-07-15,Fresno,019,978130,104480,103055,8975,112030,1730
2021-07-15,Glenn,021,27897,2472,2451,580,3031,20
2021-07-15,Humboldt,023,135768,4737,4654,58,4712,52
2021-07-15,Imperial,025,180216,29037,28840,2912,31752,742
2021-07-15,Inyo,027,18085,1422,1416,12,1428,36
2021-07-15,Kern,029,883053,98734,97796,11460,109256,1348
2021-07-15,Kings,031,150075,23500,23163,1132,24295,246
2021-07-15,Lake,033,64148,3889,3760,14,3774,64
2021-07-15,Lassen,035,31185,5323,5302,120,5422,21
2021-07-15,Los Angeles,037,10098052,1230652,1219733,43741,1263474,24582
2021-07-15,Madera,039,155013,17001,16804,975,17779,240
2021-07-15,Marin,041,260295,14515,14297,275,14572,234
2021-07-15,Mariposa,043,17540,449,445,11,456,5
2021-07-15,Mendocino,045,87422,4328,4209,87,4296,49
2021-07-15,Merced,047,269075,31612,31451,1022,32473,471
2021-07-15,Modoc,049,8938,423,412,149,561,5
2021-07-15,Mono,051,14174,1272,1277,18,1295,3
2021-07-15,Monterey,053,433212,43642,43367,1933,45300,515
2021-07-15,Napa,055,140530,10216,10129,42,10171,81
2021-07-15,Nevada,057,99092,5186,5066,197,5263,72
2021-07-15,Orange,059,3164182,260326,257805,11890,269695,5136
2021-07-15,Placer,061,380077,24502,24169,1686,25855,303
2021-07-15,Plumas,063,18699,741,721,14,735,4
2021-07-15,Riverside,065,2383286,299196,294751,14437,309188,4542
2021-07-15,Sacramento,067,1510023,111797,110432,2036,112468,1694
2021-07-15,San Benito,069,59416,6195,6181,116,6297,63
2021-07-15,San Bernardino,071,2135413,298099,296048,9255,305303,5218
2021-07-15,San Diego,073,3302833,288419,285698,16239,301937,3786
2021-07-15,San Francisco,075,870044,38633,37978,1385,39363,560
2021-07-15,San Joaquin,077,732212,75430,74695,3807,78502,1430
2021-07-15,San Luis Obispo,079,281455,21833,21462,781,22243,258
2021-07-15,San Mateo,081,765935,43752,43324,528,43852,542
2021-07-15,Santa Barbara,083,443738,35003,34769,1225,35994,461
2021-07-15,Santa Clara,085,1922200,121294,119980,809,120789,2097
2021-07-15,Santa Cruz,087,273765,16490,16337,824,17161,207
2021-07-15,Shasta,089,179085,12795,12683,1698,14381,210
2021-07-15,Sierra,091,2930,66,62,12,74,0
2021-07-15,Siskiyou,093,43540,2019,1922,416,2338,29
2021-07-15,Solano,095,438530,34420,34015,635,34650,263
2021-07-15,Sonoma,097,501317,31841,31536,375,31911,322
2021-07-15,Stanislaus,099,539301,57793,57400,6160,63560,1028
2021-07-15,Sutter,101,95872,9894,9778,95,9873,114
2021-07-15,Tehama,103,63373,5205,5145,603,5748,64
2021-07-15,Trinity,105,12862,502,341,106,447,3
2021-07-15,Tulare,107,460477,50740,49937,9359,59296,854
2021-07-15,Tuolumne,109,53932,4135,4131,44,4175,64
2021-07-15,Ventura,111,848112,82869,82125,3295,85420,1041
2021-07-15,Yolo,113,214977,14521,14356,418,14774,213
2021-07-15,Yuba,115,75493,6408,6309,133,6442,52
2021-07-14,Alameda,001,1643700,92415,91092,2097,93189,1255
2021-07-14,Alpine,003,1148,88,89,0,89,0
2021-07-14,Amador,005,37829,3809,3784,34,3818,48
2021-07-14,Butte,007,227075,12998,12813,1926,14739,202
2021-07-14,Calaveras,009,45235,2253,2234,16,2250,57
2021-07-14,Colusa,011,21464,1995,1974,337,2311,16
2021-07-14,Contra Costa,013,1133247,73207,72091,1386,73477,823
2021-07-14,Del Norte,015,27424,1513,1472,14,1486,8
2021-07-14,El Dorado,017,186661,10765,10598,797,11395,114
2021-07-14,Fresno,019,978130,104400,102966,8964,111930,1728
2021-07-14,Glenn,021,27897,2472,2449,580,3029,20
2021-07-14,Humboldt,023,135768,4714,4644,56,4700,52
2021-07-14,Imperial,025,180216,29008,28822,2912,31734,742
2021-07-14,Inyo,027,18085,1421,1415,12,1427,36
2021-07-14,Kern,029,883053,98670,97736,11435,109171,1346
2021-07-14,Kings,031,150075,23487,23142,1132,24274,246
2021-07-14,Lake,033,64148,3856,3739,14,3753,63
2021-07-14,Lassen,035,31185,5322,5298,120,5418,21
2021-07-14,Los Angeles,037,10098052,1228647,1218265,43596,1261861,24578
2021-07-14,Madera,039,155013,16989,16786,973,17759,240
2021-07-14,Marin,041,260295,14481,14269,273,14542,233
2021-07-14,Mariposa,043,17540,447,445,11,456,5
2021-07-14,Mendocino,045,87422,4315,4193,87,4280,49
2021-07-14,Merced,047,269075,31575,31412,1018,32430,471
2021-07-14,Modoc,049,8938,423,412,149,561,4
2021-07-14,Mono,051,14174,1272,1278,18,1296,3
2021-07-14,Monterey,053,433212,43618,43347,1931,45278,504
2021-07-14,Napa,055,140530,10194,10121,42,10163,81
2021-07-14,Nevada,057,99092,5166,5058,197,5255,72
2021-07-14,Orange,059,3164182,260009,257558,11861,269419,5137
2021-07-14,Placer,061,380077,24449,24125,1674,25799,303
2021-07-14,Plumas,063,18699,734,719,14,733,4
2021-07-14,Riverside,065,2383286,298871,294511,14421,308932,4542
2021-07-14,Sacramento,067,1510023,111469,110193,2012,112205,1688
2021-07-14,San Benito,069,59416,6192,6177,116,6293,63
2021-07-14,San Bernardino,071,2135413,297796,295820,9240,305060,5193
2021-07-14,San Diego,073,3302833,287846,285269,16160,301429,3786
2021-07-14,San Francisco,075,870044,38494,37836,1379,39215,559
2021-07-14,San Joaquin,077,732212,75338,74599,3798,78397,1416
2021-07-14,San Luis Obispo,079,281455,21811,21444,779,22223,258
2021-07-14,San Mateo,081,765935,43655,43249,524,43773,542
2021-07-14,Santa Barbara,083,443738,34963,34719,1223,35942,461
2021-07-14,Santa Clara,085,1922200,121144,119844,806,120650,2098
2021-07-14,Santa Cruz,087,273765,16476,16326,824,17150,207
2021-07-14,Shasta,089,179085,12775,12669,1695,14364,209
2021-07-14,Sierra,091,2930,66,62,12,74,0
2021-07-14,Siskiyou,093,43540,2012,1922,413,2335,29
2021-07-14,Solano,095,438530,34347,33948,635,34583,268
2021-07-14,Sonoma,097,501317,31789,31470,375,31845,322
2021-07-14,Stanislaus,099,539301,57718,57340,6148,63488,1028
2021-07-14,Sutter,101,95872,9871,9766,95,9861,114
2021-07-14,Tehama,103,63373,5203,5142,603,5745,64
2021-07-14,Trinity,105,12862,502,341,106,447,3
2021-07-14,Tulare,107,460477,50723,49908,9345,59253,853
2021-07-14,Tuolumne,109,53932,4132,4128,43,4171,64
2021-07-14,Ventura,111,848112,82775,82041,3284,85325,1040
2021-07-14,Yolo,113,214977,14488,14332,415,14747,213
2021-07-14,Yuba,115,75493,6390,6294,133,6427,52
2021-07-13,Alameda,001,1643700,92151,90874,2087,92961,1255
2021-07-13,Alpine,003,1148,88,89,0,89,0
2021-07-13,Amador,005,37829,3802,3783,34,3817,48
2021-07-13,Butte,007,227075,12984,12802,1925,14727,202
2021-07-13,Calaveras,009,45235,2249,2230,16,2246,57
2021-07-13,Colusa,011,21464,1993,1972,333,2305,16
2021-07-13,Contra Costa,013,1133247,72981,71963,1377,73340,823
2021-07-13,Del Norte,015,27424,1509,1471,14,1485,8
2021-07-13,El Dorado,017,186661,10747,10581,794,11375,114
2021-07-13,Fresno,019,978130,104324,102909,8954,111863,1727
2021-07-13,Glenn,021,27897,2470,2448,580,3028,20
2021-07-13,Humboldt,023,135768,4699,4634,56,4690,51
2021-07-13,Imperial,025,180216,28997,28792,2911,31703,741
2021-07-13,Inyo,027,18085,1420,1415,12,1427,36
2021-07-13,Kern,029,883053,98581,97698,11396,109094,1346
2021-07-13,Kings,031,150075,23469,23132,1132,24264,246
2021-07-13,Lake,033,64148,3829,3719,13,3732,63
2021-07-13,Lassen,035,31185,5320,5292,120,5412,21
2021-07-13,Los Angeles,037,10098052,1226804,1217184,43423,1260607,24569
2021-07-13,Madera,039,155013,16979,16773,969,17742,240
2021-07-13,Marin,041,260295,14452,14254,272,14526,233
2021-07-13,Mariposa,043,17540,446,443,11,454,5
2021-07-13,Mendocino,045,87422,4308,4185,87,4272,49
2021-07-13,Merced,047,269075,31554,31379,1015,32394,471
2021-07-13,Modoc,049,8938,423,411,149,560,4
2021-07-13,Mono,051,14174,1271,1277,18,1295,3
2021-07-13,Monterey,053,433212,43600,43333,1927,45260,504
2021-07-13,Napa,055,140530,10173,10118,42,10160,81
2021-07-13,Nevada,057,99092,5141,5053,197,5250,72
2021-07-13,Orange,059,3164182,259679,257339,11832,269171,5136
2021-07-13,Placer,061,380077,24403,24091,1661,25752,303
2021-07-13,Plumas,063,18699,733,716,14,730,4
2021-07-13,Riverside,065,2383286,298548,294302,14395,308697,4541
2021-07-13,Sacramento,067,1510023,111159,109990,1989,111979,1687
2021-07-13,San Benito,069,59416,6190,6173,116,6289,63
2021-07-13,San Bernardino,071,2135413,297520,295596,9218,304814,5183
2021-07-13,San Diego,073,3302833,287302,284997,16081,301078,3785
2021-07-13,San Francisco,075,870044,38350,37725,1373,39098,559
2021-07-13,San Joaquin,077,732212,75222,74500,3795,78295,1417
2021-07-13,San Luis Obispo,079,281455,21785,21423,776,22199,258
2021-07-13,San Mateo,081,765935,43587,43180,523,43703,542
2021-07-13,Santa Barbara,083,443738,34914,34679,1220,35899,461
2021-07-13,Santa Clara,085,1922200,120990,119727,802,120529,2098
2021-07-13,Santa Cruz,087,273765,16467,16315,822,17137,207
2021-07-13,Shasta,089,179085,12762,12659,1688,14347,209
2021-07-13,Sierra,091,2930,66,62,12,74,0
2021-07-13,Siskiyou,093,43540,2011,1916,411,2327,29
2021-07-13,Solano,095,438530,34283,33918,629,34547,268
2021-07-13,Sonoma,097,501317,31730,31431,375,31806,322
2021-07-13,Stanislaus,099,539301,57649,57282,6134,63416,1028
2021-07-13,Sutter,101,95872,9853,9752,94,9846,114
2021-07-13,Tehama,103,63373,5196,5144,603,5747,64
2021-07-13,Trinity,105,12862,502,341,105,446,3
2021-07-13,Tulare,107,460477,50698,49891,9329,59220,853
2021-07-13,Tuolumne,109,53932,4124,4122,42,4164,64
2021-07-13,Ventura,111,848112,82691,81982,3259,85241,1040
2021-07-13,Yolo,113,214977,14460,14320,408,14728,213
2021-07-13,Yuba,115,75493,6373,6279,133,6412,52
2021-07-12,Alameda,001,1643700,91893,90720,2078,92798,1254
2021-07-12,Alpine,003,1148,88,89,0,89,0
2021-07-12,Amador,005,37829,3795,3781,34,3815,47
2021-07-12,Butte,007,227075,12964,12796,1923,14719,202
2021-07-12,Calaveras,009,45235,2247,2228,16,2244,57
2021-07-12,Colusa,011,21464,1989,1971,332,2303,16
2021-07-12,Contra Costa,013,1133247,72780,71833,1372,73205,823
2021-07-12,Del Norte,015,27424,1506,1469,14,1483,8
2021-07-12,El Dorado,017,186661,10719,10569,792,11361,114
2021-07-12,Fresno,019,978130,104230,102853,8941,111794,1728
2021-07-12,Glenn,021,27897,2470,2446,580,3026,20
2021-07-12,Humboldt,023,135768,4683,4621,56,4677,51
2021-07-12,Imperial,025,180216,28967,28789,2911,31700,741
2021-07-12,Inyo,027,18085,1420,1415,12,1427,36
2021-07-12,Kern,029,883053,98512,97660,11371,109031,1346
2021-07-12,Kings,031,150075,23449,23124,1130,24254,246
2021-07-12,Lake,033,64148,3808,3706,13,3719,63
2021-07-12,Lassen,035,31185,5319,5292,120,5412,21
2021-07-12,Los Angeles,037,10098052,1225021,1216230,43284,1259514,24559
2021-07-12,Madera,039,155013,16968,16772,969,17741,240
2021-07-12,Marin,041,260295,14427,14238,271,14509,233
2021-07-12,Mariposa,043,17540,446,442,11,453,5
2021-07-12,Mendocino,045,87422,4297,4175,87,4262,49
2021-07-12,Merced,047,269075,31523,31374,1014,32388,471
2021-07-12,Modoc,049,8938,422,411,149,560,4
2021-07-12,Mono,051,14174,1269,1275,18,1293,3
2021-07-12,Monterey,053,433212,43579,43315,1923,45238,504
2021-07-12,Napa,055,140530,10155,10104,41,10145,81
2021-07-12,Nevada,057,99092,5118,5046,197,5243,72
2021-07-12,Orange,059,3164182,259325,257171,11807,268978,5136
2021-07-12,Placer,061,380077,24352,24052,1655,25707,302
2021-07-12,Plumas,063,18699,733,716,14,730,4
2021-07-12,Riverside,065,2383286,298240,294108,14365,308473,4541
2021-07-12,Sacramento,067,1510023,110944,109849,1962,111811,1685
2021-07-12,San Benito,069,59416,6187,6166,116,6282,63
2021-07-12,San Bernardino,071,2135413,297249,295447,9204,304651,5171
2021-07-12,San Diego,073,3302833,286837,284648,16005,300653,3785
2021-07-12,San Francisco,075,870044,38203,37656,1370,39026,559
2021-07-12,San Joaquin,077,732212,75128,74424,3785,78209,1415
2021-07-12,San Luis Obispo,079,281455,21766,21408,775,22183,258
2021-07-12,San Mateo,081,765935,43494,43138,516,43654,542
2021-07-12,Santa Barbara,083,443738,34871,34664,1218,35882,461
2021-07-12,Santa Clara,085,1922200,120825,119634,799,120433,2098
2021-07-12,Santa Cruz,087,273765,16442,16310,821,17131,207
2021-07-12,Shasta,089,179085,12754,12648,1685,14333,208
2021-07-12,Sierra,091,2930,66,62,12,74,0
2021-07-12,Siskiyou,093,43540,2006,1916,406,2322,29
2021-07-12,Solano,095,438530,34193,33859,620,34479,268
2021-07-12,Sonoma,097,501317,31682,31377,374,31751,322
2021-07-12,Stanislaus,099,539301,57580,57243,6127,63370,1028
2021-07-12,Sutter,101,95872,9836,9736,93,9829,114
2021-07-12,Tehama,103,63373,5191,5138,602,5740,63
2021-07-12,Trinity,105,12862,498,340,103,443,3
2021-07-12,Tulare,107,460477,50670,49882,9316,59198,853
2021-07-12,Tuolumne,109,53932,4120,4116,42,4158,64
2021-07-12,Ventura,111,848112,82590,81919,3238,85157,1040
2021-07-12,Yolo,113,214977,14432,14303,404,14707,213
2021-07-12,Yuba,115,75493,6358,6266,133,6399,52
2021-07-11,Alameda,001,1643700,91561,90597,2064,92661,1254
2021-07-11,Alpine,003,1148,88,89,0,89,0
2021-07-11,Amador,005,37829,3793,3779,34,3813,47
2021-07-11,Butte,007,227075,12942,12794,1917,14711,202
2021-07-11,Calaveras,009,45235,2244,2226,15,2241,57
2021-07-11,Colusa,011,21464,1988,1971,331,2302,16
2021-07-11,Contra Costa,013,1133247,72570,71744,1365,73109,823
2021-07-11,Del Norte,015,27424,1502,1467,13,1480,8
2021-07-11,El Dorado,017,186661,10690,10554,790,11344,114
2021-07-11,Fresno,019,978130,104135,102813,8921,111734,1728
2021-07-11,Glenn,021,27897,2469,2446,580,3026,20
2021-07-11,Humboldt,023,135768,4670,4611,55,4666,51
2021-07-11,Imperial,025,180216,28949,28787,2910,31697,741
2021-07-11,Inyo,027,18085,1418,1415,12,1427,36
2021-07-11,Kern,029,883053,98439,97637,11355,108992,1346
2021-07-11,Kings,031,150075,23418,23116,1127,24243,246
2021-07-11,Lake,033,64148,3777,3699,13,3712,63
2021-07-11,Lassen,035,31185,5316,5291,120,5411,21
2021-07-11,Los Angeles,037,10098052,1223275,1215182,43126,1258308,24558
2021-07-11,Madera,039,155013,16949,16766,968,17734,240
2021-07-11,Marin,041,260295,14401,14231,271,14502,233
2021-07-11,Mariposa,043,17540,445,442,11,453,5
2021-07-11,Mendocino,045,87422,4277,4167,87,4254,49
2021-07-11,Merced,047,269075,31499,31366,1009,32375,471
2021-07-11,Modoc,049,8938,421,411,149,560,4
2021-07-11,Mono,051,14174,1269,1275,18,1293,3
2021-07-11,Monterey,053,433212,43560,43307,1919,45226,504
2021-07-11,Napa,055,140530,10151,10100,41,10141,81
2021-07-11,Nevada,057,99092,5107,5035,196,5231,72
2021-07-11,Orange,059,3164182,259012,257009,11778,268787,5136
2021-07-11,Placer,061,380077,24295,24017,1643,25660,302
2021-07-11,Plumas,063,18699,733,716,14,730,4
2021-07-11,Riverside,065,2383286,297976,293969,14347,308316,4541
2021-07-11,Sacramento,067,1510023,110666,109696,1952,111648,1685
2021-07-11,San Benito,069,59416,6182,6163,116,6279,63
2021-07-11,San Bernardino,071,2135413,296944,295342,9179,304521,5167
2021-07-11,San Diego,073,3302833,286424,283819,15919,299738,3784
2021-07-11,San Francisco,075,870044,38074,37596,1364,38960,559
2021-07-11,San Joaquin,077,732212,75012,74376,3768,78144,1415
2021-07-11,San Luis Obispo,079,281455,21733,21403,774,22177,258
2021-07-11,San Mateo,081,765935,43415,43107,509,43616,542
2021-07-11,Santa Barbara,083,443738,34824,34646,1218,35864,461
2021-07-11,Santa Clara,085,1922200,120671,119549,798,120347,2098
2021-07-11,Santa Cruz,087,273765,16426,16303,821,17124,207
2021-07-11,Shasta,089,179085,12737,12647,1683,14330,208
2021-07-11,Sierra,091,2930,66,62,12,74,0
2021-07-11,Siskiyou,093,43540,2002,1915,404,2319,29
2021-07-11,Solano,095,438530,34111,33837,616,34453,268
2021-07-11,Sonoma,097,501317,31600,31352,374,31726,322
2021-07-11,Stanislaus,099,539301,57516,57230,6116,63346,1028
2021-07-11,Sutter,101,95872,9822,9728,93,9821,114
2021-07-11,Tehama,103,63373,5188,5138,602,5740,63
2021-07-11,Trinity,105,12862,497,340,103,443,3
2021-07-11,Tulare,107,460477,50645,49877,9297,59174,853
2021-07-11,Tuolumne,109,53932,4114,4116,42,4158,64
2021-07-11,Ventura,111,848112,82518,81875,3218,85093,1040
2021-07-11,Yolo,113,214977,14405,14285,398,14683,213
2021-07-11,Yuba,115,75493,6347,6260,133,6393,52
2021-07-10,Alameda,001,1643700,91410,90090,2060,92150,1252
2021-07-10,Alpine,003,1148,88,89,0,89,0
2021-07-10,Amador,005,37829,3787,3773,34,3807,47
2021-07-10,Butte,007,227075,12931,12764,1914,14678,202
2021-07-10,Calaveras,009,45235,2243,2214,15,2229,57
2021-07-10,Colusa,011,21464,1986,1969,331,2300,16
2021-07-10,Contra Costa,013,1133247,72470,71376,1364,72740,821
2021-07-10,Del Norte,015,27424,1500,1451,13,1464,8
2021-07-10,El Dorado,017,186661,10674,10508,786,11294,114
2021-07-10,Fresno,019,978130,104102,102675,8914,111589,1730
2021-07-10,Glenn,021,27897,2466,2440,579,3019,20
2021-07-10,Humboldt,023,135768,4661,4574,55,4629,51
2021-07-10,Imperial,025,180216,28936,28729,2910,31639,741
2021-07-10,Inyo,027,18085,1417,1415,12,1427,36
2021-07-10,Kern,029,883053,98399,97538,11338,108876,1346
2021-07-10,Kings,031,150075,23411,23090,1126,24216,246
2021-07-10,Lake,033,64148,3760,3667,13,3680,63
2021-07-10,Lassen,035,31185,5316,5290,120,5410,21
2021-07-10,Los Angeles,037,10098052,1222255,1212043,43023,1255066,24542
2021-07-10,Madera,039,155013,16943,16744,965,17709,241
2021-07-10,Marin,041,260295,14387,14194,271,14465,233
2021-07-10,Mariposa,043,17540,445,442,11,453,5
2021-07-10,Mendocino,045,87422,4270,4153,86,4239,49
2021-07-10,Merced,047,269075,31486,31328,1009,32337,470
2021-07-10,Modoc,049,8938,421,410,149,559,4
2021-07-10,Mono,051,14174,1269,1275,18,1293,3
2021-07-10,Monterey,053,433212,43546,43251,1917,45168,499
2021-07-10,Napa,055,140530,10139,10077,41,10118,81
2021-07-10,Nevada,057,99092,5098,5000,196,5196,72
2021-07-10,Orange,059,3164182,258834,256438,11762,268200,5135
2021-07-10,Placer,061,380077,24266,23916,1633,25549,302
2021-07-10,Plumas,063,18699,732,717,14,731,4
2021-07-10,Riverside,065,2383286,297786,293474,14333,307807,4541
2021-07-10,Sacramento,067,1510023,110517,109091,1947,111038,1682
2021-07-10,San Benito,069,59416,6177,6141,116,6257,63
2021-07-10,San Bernardino,071,2135413,296756,294932,9167,304099,5117
2021-07-10,San Diego,073,3302833,286135,283577,15866,299443,3783
2021-07-10,San Francisco,075,870044,37990,37338,1361,38699,559
2021-07-10,San Joaquin,077,732212,74954,74150,3762,77912,1412
2021-07-10,San Luis Obispo,079,281455,21722,21375,773,22148,258
2021-07-10,San Mateo,081,765935,43364,42948,507,43455,542
2021-07-10,Santa Barbara,083,443738,34797,34595,1218,35813,460
2021-07-10,Santa Clara,085,1922200,120568,119330,795,120125,2094
2021-07-10,Santa Cruz,087,273765,16419,16286,821,17107,207
2021-07-10,Shasta,089,179085,12724,12623,1678,14301,206
2021-07-10,Sierra,091,2930,66,61,12,73,0
2021-07-10,Siskiyou,093,43540,2000,1909,401,2310,29
2021-07-10,Solano,095,438530,34070,33678,610,34288,268
2021-07-10,Sonoma,097,501317,31549,31231,374,31605,317
2021-07-10,Stanislaus,099,539301,57479,57104,6106,63210,1026
2021-07-10,Sutter,101,95872,9809,9692,93,9785,114
2021-07-10,Tehama,103,63373,5185,5131,602,5733,63
2021-07-10,Trinity,105,12862,497,341,103,444,3
2021-07-10,Tulare,107,460477,50635,49850,9291,59141,853
2021-07-10,Tuolumne,109,53932,4112,4114,42,4156,64
2021-07-10,Ventura,111,848112,82473,81713,3200,84913,1039
2021-07-10,Yolo,113,214977,14384,14250,395,14645,213
2021-07-10,Yuba,115,75493,6337,6238,133,6371,52
2021-07-09,Alameda,001,1643700,91251,90090,2055,92145,1252
2021-07-09,Alpine,003,1148,88,89,0,89,0
2021-07-09,Amador,005,37829,3786,3773,34,3807,47
2021-07-09,Butte,007,227075,12920,12764,1912,14676,202
2021-07-09,Calaveras,009,45235,2242,2214,15,2229,57
2021-07-09,Colusa,011,21464,1985,1969,331,2300,16
2021-07-09,Contra Costa,013,1133247,72345,71376,1362,72738,821
2021-07-09,Del Norte,015,27424,1495,1451,13,1464,8
2021-07-09,El Dorado,017,186661,10659,10508,785,11293,114
2021-07-09,Fresno,019,978130,104046,102675,8907,111582,1730
2021-07-09,Glenn,021,27897,2465,2440,577,3017,20
2021-07-09,Humboldt,023,135768,4642,4574,55,4629,51
2021-07-09,Imperial,025,180216,28928,28729,2908,31637,741
2021-07-09,Inyo,027,18085,1416,1415,12,1427,36
2021-07-09,Kern,029,883053,98361,97538,11326,108864,1346
2021-07-09,Kings,031,150075,23400,23090,1125,24215,246
2021-07-09,Lake,033,64148,3746,3667,13,3680,63
2021-07-09,Lassen,035,31185,5314,5290,119,5409,21
2021-07-09,Los Angeles,037,10098052,1221250,1212043,42951,1254994,24542
2021-07-09,Madera,039,155013,16933,16744,964,17708,241
2021-07-09,Marin,041,260295,14366,14194,270,14464,233
2021-07-09,Mariposa,043,17540,445,442,11,453,5
2021-07-09,Mendocino,045,87422,4263,4153,86,4239,49
2021-07-09,Merced,047,269075,31471,31328,1009,32337,470
2021-07-09,Modoc,049,8938,421,410,149,559,4
2021-07-09,Mono,051,14174,1269,1275,18,1293,3
2021-07-09,Monterey,053,433212,43537,43251,1917,45168,499
2021-07-09,Napa,055,140530,10132,10077,41,10118,81
2021-07-09,Nevada,057,99092,5089,5000,196,5196,72
2021-07-09,Orange,059,3164182,258629,256438,11748,268186,5135
2021-07-09,Placer,061,380077,24244,23916,1627,25543,302
2021-07-09,Plumas,063,18699,730,717,14,731,4
2021-07-09,Riverside,065,2383286,297600,293474,14320,307794,4541
2021-07-09,Sacramento,067,1510023,110363,109091,1938,111029,1682
2021-07-09,San Benito,069,59416,6175,6141,116,6257,63
2021-07-09,San Bernardino,071,2135413,296604,294932,9160,304092,5117
2021-07-09,San Diego,073,3302833,285847,283577,15818,299395,3783
2021-07-09,San Francisco,075,870044,37910,37338,1354,38692,559
2021-07-09,San Joaquin,077,732212,74880,74150,3755,77905,1412
2021-07-09,San Luis Obispo,079,281455,21710,21375,773,22148,258
2021-07-09,San Mateo,081,765935,43319,42948,503,43451,542
2021-07-09,Santa Barbara,083,443738,34776,34595,1217,35812,460
2021-07-09,Santa Clara,085,1922200,120458,119330,795,120125,2094
2021-07-09,Santa Cruz,087,273765,16416,16286,821,17107,207
2021-07-09,Shasta,089,179085,12718,12623,1673,14296,206
2021-07-09,Sierra,091,2930,66,61,12,73,0
2021-07-09,Siskiyou,093,43540,1998,1909,400,2309,29
2021-07-09,Solano,095,438530,34034,33678,606,34284,268
2021-07-09,Sonoma,097,501317,31513,31231,374,31605,317
2021-07-09,Stanislaus,099,539301,57450,57104,6104,63208,1026
2021-07-09,Sutter,101,95872,9800,9692,93,9785,114
2021-07-09,Tehama,103,63373,5183,5131,602,5733,63
2021-07-09,Trinity,105,12862,496,341,100,441,3
2021-07-09,Tulare,107,460477,50622,49850,9285,59135,853
2021-07-09,Tuolumne,109,53932,4108,4114,42,4156,64
2021-07-09,Ventura,111,848112,82418,81713,3191,84904,1039
2021-07-09,Yolo,113,214977,14369,14250,391,14641,213
2021-07-09,Yuba,115,75493,6324,6238,133,6371,52
2021-07-08,Alameda,001,1643700,91043,90090,2052,92142,1252
2021-07-08,Alpine,003,1148,88,89,0,89,0
2021-07-08,Amador,005,37829,3784,3773,34,3807,47
2021-07-08,Butte,007,227075,12907,12764,1909,14673,202
2021-07-08,Calaveras,009,45235,2240,2214,14,2228,57
2021-07-08,Colusa,011,21464,1985,1969,331,2300,16
2021-07-08,Contra Costa,013,1133247,72217,71376,1357,72733,821
2021-07-08,Del Norte,015,27424,1493,1451,13,1464,8
2021-07-08,El Dorado,017,186661,10642,10508,780,11288,114
2021-07-08,Fresno,019,978130,103984,102675,8896,111571,1730
2021-07-08,Glenn,021,27897,2465,2440,577,3017,20
2021-07-08,Humboldt,023,135768,4627,4574,54,4628,51
2021-07-08,Imperial,025,180216,28916,28729,2906,31635,741
2021-07-08,Inyo,027,18085,1416,1415,12,1427,36
2021-07-08,Kern,029,883053,98313,97538,11311,108849,1346
2021-07-08,Kings,031,150075,23391,23090,1125,24215,246
2021-07-08,Lake,033,64148,3732,3667,13,3680,63
2021-07-08,Lassen,035,31185,5311,5290,119,5409,21
2021-07-08,Los Angeles,037,10098052,1220037,1212043,42854,1254897,24542
2021-07-08,Madera,039,155013,16917,16744,964,17708,241
2021-07-08,Marin,041,260295,14352,14194,270,14464,233
2021-07-08,Mariposa,043,17540,444,442,11,453,5
2021-07-08,Mendocino,045,87422,4260,4153,86,4239,49
2021-07-08,Merced,047,269075,31457,31328,1007,32335,470
2021-07-08,Modoc,049,8938,421,410,149,559,4
2021-07-08,Mono,051,14174,1269,1275,18,1293,3
2021-07-08,Monterey,053,433212,43517,43251,1911,45162,499
2021-07-08,Napa,055,140530,10128,10077,41,10118,81
2021-07-08,Nevada,057,99092,5083,5000,196,5196,72
2021-07-08,Orange,059,3164182,258434,256438,11727,268165,5135
2021-07-08,Placer,061,380077,24205,23916,1619,25535,302
2021-07-08,Plumas,063,18699,729,717,14,731,4
2021-07-08,Riverside,065,2383286,297399,293474,14304,307778,4541
2021-07-08,Sacramento,067,1510023,110141,109091,1931,111022,1682
2021-07-08,San Benito,069,59416,6172,6141,116,6257,63
2021-07-08,San Bernardino,071,2135413,296428,294932,9151,304083,5117
2021-07-08,San Diego,073,3302833,285520,283577,15770,299347,3783
2021-07-08,San Francisco,075,870044,37830,37338,1350,38688,559
2021-07-08,San Joaquin,077,732212,74792,74150,3742,77892,1412
2021-07-08,San Luis Obispo,079,281455,21698,21375,770,22145,258
2021-07-08,San Mateo,081,765935,43269,42948,502,43450,542
2021-07-08,Santa Barbara,083,443738,34749,34595,1215,35810,460
2021-07-08,Santa Clara,085,1922200,120365,119330,794,120124,2094
2021-07-08,Santa Cruz,087,273765,16410,16286,821,17107,207
2021-07-08,Shasta,089,179085,12712,12623,1669,14292,206
2021-07-08,Sierra,091,2930,66,61,12,73,0
2021-07-08,Siskiyou,093,43540,1993,1909,397,2306,29
2021-07-08,Solano,095,438530,33979,33678,600,34278,268
2021-07-08,Sonoma,097,501317,31482,31231,373,31604,317
2021-07-08,Stanislaus,099,539301,57424,57104,6100,63204,1026
2021-07-08,Sutter,101,95872,9785,9692,91,9783,114
2021-07-08,Tehama,103,63373,5180,5131,601,5732,63
2021-07-08,Trinity,105,12862,496,341,100,441,3
2021-07-08,Tulare,107,460477,50604,49850,9277,59127,853
2021-07-08,Tuolumne,109,53932,4106,4114,42,4156,64
2021-07-08,Ventura,111,848112,82353,81713,3175,84888,1039
2021-07-08,Yolo,113,214977,14350,14250,389,14639,213
2021-07-08,Yuba,115,75493,6316,6238,133,6371,52
2021-07-07,Alameda,001,1643700,90858,89995,2046,92041,1253
2021-07-07,Alpine,003,1148,88,89,0,89,0
2021-07-07,Amador,005,37829,3779,3770,34,3804,47
2021-07-07,Butte,007,227075,12894,12750,1904,14654,202
2021-07-07,Calaveras,009,45235,2232,2212,14,2226,57
2021-07-07,Colusa,011,21464,1981,1969,331,2300,16
2021-07-07,Contra Costa,013,1133247,72071,71308,1355,72663,821
2021-07-07,Del Norte,015,27424,1488,1446,13,1459,8
2021-07-07,El Dorado,017,186661,10622,10494,778,11272,114
2021-07-07,Fresno,019,978130,103934,102639,8889,111528,1729
2021-07-07,Glenn,021,27897,2465,2441,577,3018,20
2021-07-07,Humboldt,023,135768,4613,4566,54,4620,51
2021-07-07,Imperial,025,180216,28909,28701,2906,31607,740
2021-07-07,Inyo,027,18085,1415,1415,12,1427,36
2021-07-07,Kern,029,883053,98269,97507,11296,108803,1348
2021-07-07,Kings,031,150075,23378,23085,1122,24207,245
2021-07-07,Lake,033,64148,3713,3660,13,3673,63
2021-07-07,Lassen,035,31185,5311,5286,119,5405,21
2021-07-07,Los Angeles,037,10098052,1218857,1211316,42748,1254064,24531
2021-07-07,Madera,039,155013,16906,16733,962,17695,241
2021-07-07,Marin,041,260295,14333,14183,269,14452,233
2021-07-07,Mariposa,043,17540,442,442,11,453,5
2021-07-07,Mendocino,045,87422,4251,4145,86,4231,49
2021-07-07,Merced,047,269075,31442,31317,1007,32324,470
2021-07-07,Modoc,049,8938,421,410,149,559,4
2021-07-07,Mono,051,14174,1268,1274,18,1292,3
2021-07-07,Monterey,053,433212,43492,43233,1909,45142,494
2021-07-07,Napa,055,140530,10117,10078,41,10119,81
2021-07-07,Nevada,057,99092,5076,4996,196,5192,72
2021-07-07,Orange,059,3164182,258208,256301,11705,268006,5132
2021-07-07,Placer,061,380077,24169,23901,1609,25510,302
2021-07-07,Plumas,063,18699,729,710,14,724,4
2021-07-07,Riverside,065,2383286,297184,293331,14294,307625,4538
2021-07-07,Sacramento,067,1510023,109950,108954,1923,110877,1682
2021-07-07,San Benito,069,59416,6167,6137,116,6253,63
2021-07-07,San Bernardino,071,2135413,296260,294787,9144,303931,5087
2021-07-07,San Diego,073,3302833,285201,283377,15730,299107,3782
2021-07-07,San Francisco,075,870044,37738,37284,1347,38631,558
2021-07-07,San Joaquin,077,732212,74716,74095,3726,77821,1410
2021-07-07,San Luis Obispo,079,281455,21689,21360,768,22128,258
2021-07-07,San Mateo,081,765935,43214,42908,499,43407,542
2021-07-07,Santa Barbara,083,443738,34723,34582,1215,35797,460
2021-07-07,Santa Clara,085,1922200,120267,119250,793,120043,2094
2021-07-07,Santa Cruz,087,273765,16401,16279,820,17099,207
2021-07-07,Shasta,089,179085,12704,12613,1666,14279,206
2021-07-07,Sierra,091,2930,66,60,12,72,0
2021-07-07,Siskiyou,093,43540,1987,1908,393,2301,29
2021-07-07,Solano,095,438530,33930,33659,593,34252,268
2021-07-07,Sonoma,097,501317,31436,31172,373,31545,316
2021-07-07,Stanislaus,099,539301,57392,57102,6095,63197,1028
2021-07-07,Sutter,101,95872,9775,9683,91,9774,114
2021-07-07,Tehama,103,63373,5179,5129,601,5730,63
2021-07-07,Trinity,105,12862,496,341,100,441,3
2021-07-07,Tulare,107,460477,50600,49835,9268,59103,853
2021-07-07,Tuolumne,109,53932,4102,4115,41,4156,64
2021-07-07,Ventura,111,848112,82309,81608,3161,84769,1036
2021-07-07,Yolo,113,214977,14340,14236,386,14622,213
2021-07-07,Yuba,115,75493,6300,6233,133,6366,51
2021-07-06,Alameda,001,1643700,90660,89918,2038,91956,1253
2021-07-06,Alpine,003,1148,88,89,0,89,0
2021-07-06,Amador,005,37829,3778,3768,33,3801,47
2021-07-06,Butte,007,227075,12881,12744,1901,14645,201
2021-07-06,Calaveras,009,45235,2232,2211,14,2225,55
2021-07-06,Colusa,011,21464,1980,1967,328,2295,16
2021-07-06,Contra Costa,013,1133247,71942,71262,1352,72614,820
2021-07-06,Del Norte,015,27424,1484,1445,13,1458,8
2021-07-06,El Dorado,017,186661,10604,10484,777,11261,113
2021-07-06,Fresno,019,978130,103882,102616,8877,111493,1727
2021-07-06,Glenn,021,27897,2464,2438,577,3015,20
2021-07-06,Humboldt,023,135768,4599,4565,53,4618,49
2021-07-06,Imperial,025,180216,28894,28693,2904,31597,739
2021-07-06,Inyo,027,18085,1415,1412,12,1424,36
2021-07-06,Kern,029,883053,98227,97491,11285,108776,1346
2021-07-06,Kings,031,150075,23370,23077,1121,24198,245
2021-07-06,Lake,033,64148,3703,3659,13,3672,63
2021-07-06,Lassen,035,31185,5310,5288,118,5406,21
2021-07-06,Los Angeles,037,10098052,1217641,1210965,42649,1253614,24525
2021-07-06,Madera,039,155013,16894,16730,962,17692,241
2021-07-06,Marin,041,260295,14319,14181,269,14450,233
2021-07-06,Mariposa,043,17540,442,442,11,453,5
2021-07-06,Mendocino,045,87422,4244,4143,86,4229,49
2021-07-06,Merced,047,269075,31425,31317,1006,32323,470
2021-07-06,Modoc,049,8938,421,411,149,560,4
2021-07-06,Mono,051,14174,1267,1274,18,1292,3
2021-07-06,Monterey,053,433212,43470,43224,1908,45132,494
2021-07-06,Napa,055,140530,10106,10081,41,10122,81
2021-07-06,Nevada,057,99092,5067,4988,196,5184,72
2021-07-06,Orange,059,3164182,257964,256227,11688,267915,5129
2021-07-06,Placer,061,380077,24128,23876,1603,25479,302
2021-07-06,Plumas,063,18699,728,708,14,722,4
2021-07-06,Riverside,065,2383286,296981,293227,14276,307503,4539
2021-07-06,Sacramento,067,1510023,109739,108850,1915,110765,1679
2021-07-06,San Benito,069,59416,6163,6137,116,6253,63
2021-07-06,San Bernardino,071,2135413,296081,294712,9131,303843,5056
2021-07-06,San Diego,073,3302833,284846,283278,15671,298949,3782
2021-07-06,San Francisco,075,870044,37621,37251,1346,38597,558
2021-07-06,San Joaquin,077,732212,74646,74019,3714,77733,1410
2021-07-06,San Luis Obispo,079,281455,21672,21354,767,22121,257
2021-07-06,San Mateo,081,765935,43138,42895,499,43394,541
2021-07-06,Santa Barbara,083,443738,34704,34572,1213,35785,460
2021-07-06,Santa Clara,085,1922200,120149,119194,790,119984,2095
2021-07-06,Santa Cruz,087,273765,16396,16274,819,17093,207
2021-07-06,Shasta,089,179085,12694,12606,1664,14270,205
2021-07-06,Sierra,091,2930,65,60,12,72,0
2021-07-06,Siskiyou,093,43540,1984,1905,389,2294,29
2021-07-06,Solano,095,438530,33879,33619,590,34209,268
2021-07-06,Sonoma,097,501317,31373,31130,372,31502,316
2021-07-06,Stanislaus,099,539301,57345,57120,6083,63203,1029
2021-07-06,Sutter,101,95872,9766,9674,90,9764,114
2021-07-06,Tehama,103,63373,5176,5126,600,5726,63
2021-07-06,Trinity,105,12862,496,341,100,441,3
2021-07-06,Tulare,107,460477,50585,49826,9257,59083,853
2021-07-06,Tuolumne,109,53932,4100,4113,41,4154,64
2021-07-06,Ventura,111,848112,82269,81534,3135,84669,1033
2021-07-06,Yolo,113,214977,14318,14227,383,14610,213
2021-07-06,Yuba,115,75493,6289,6231,133,6364,51
2021-07-05,Alameda,001,1643700,90482,89892,2033,91925,1253
2021-07-05,Alpine,003,1148,88,89,0,89,0
2021-07-05,Amador,005,37829,3776,3768,33,3801,47
2021-07-05,Butte,007,227075,12873,12740,1891,14631,201
2021-07-05,Calaveras,009,45235,2228,2211,14,2225,55
2021-07-05,Colusa,011,21464,1978,1966,327,2293,16
2021-07-05,Contra Costa,013,1133247,71814,71235,1352,72587,820
2021-07-05,Del Norte,015,27424,1480,1446,13,1459,8
2021-07-05,El Dorado,017,186661,10579,10481,777,11258,113
2021-07-05,Fresno,019,978130,103824,102592,8862,111454,1727
2021-07-05,Glenn,021,27897,2461,2438,576,3014,20
2021-07-05,Humboldt,023,135768,4585,4563,53,4616,49
2021-07-05,Imperial,025,180216,28875,28689,2903,31592,739
2021-07-05,Inyo,027,18085,1415,1412,12,1424,36
2021-07-05,Kern,029,883053,98180,97479,11264,108743,1346
2021-07-05,Kings,031,150075,23362,23065,1118,24183,245
2021-07-05,Lake,033,64148,3685,3645,13,3658,63
2021-07-05,Lassen,035,31185,5307,5288,117,5405,21
2021-07-05,Los Angeles,037,10098052,1216449,1210653,42546,1253199,24522
2021-07-05,Madera,039,155013,16883,16722,961,17683,241
2021-07-05,Marin,041,260295,14298,14178,269,14447,233
2021-07-05,Mariposa,043,17540,442,441,11,452,5
2021-07-05,Mendocino,045,87422,4239,4139,85,4224,49
2021-07-05,Merced,047,269075,31405,31312,1006,32318,470
2021-07-05,Modoc,049,8938,421,410,149,559,4
2021-07-05,Mono,051,14174,1267,1273,18,1291,3
2021-07-05,Monterey,053,433212,43450,43218,1903,45121,494
2021-07-05,Napa,055,140530,10100,10074,41,10115,81
2021-07-05,Nevada,057,99092,5049,4980,195,5175,72
2021-07-05,Orange,059,3164182,257763,256173,11670,267843,5129
2021-07-05,Placer,061,380077,24081,23867,1595,25462,302
2021-07-05,Plumas,063,18699,727,708,14,722,4
2021-07-05,Riverside,065,2383286,296789,293193,14264,307457,4539
2021-07-05,Sacramento,067,1510023,109556,108758,1906,110664,1679
2021-07-05,San Benito,069,59416,6156,6137,116,6253,63
2021-07-05,San Bernardino,071,2135413,295919,294647,9124,303771,5037
2021-07-05,San Diego,073,3302833,284483,282834,15627,298461,3782
2021-07-05,San Francisco,075,870044,37535,37237,1341,38578,558
2021-07-05,San Joaquin,077,732212,74576,73999,3709,77708,1410
2021-07-05,San Luis Obispo,079,281455,21659,21351,766,22117,257
2021-07-05,San Mateo,081,765935,43086,42876,496,43372,541
2021-07-05,Santa Barbara,083,443738,34684,34569,1213,35782,460
2021-07-05,Santa Clara,085,1922200,120043,119184,788,119972,2095
2021-07-05,Santa Cruz,087,273765,16387,16273,818,17091,208
2021-07-05,Shasta,089,179085,12685,12603,1662,14265,205
2021-07-05,Sierra,091,2930,65,60,12,72,0
2021-07-05,Siskiyou,093,43540,1982,1904,388,2292,29
2021-07-05,Solano,095,438530,33809,33612,584,34196,268
2021-07-05,Sonoma,097,501317,31320,31116,372,31488,316
2021-07-05,Stanislaus,099,539301,57315,57109,6073,63182,1029
2021-07-05,Sutter,101,95872,9754,9667,90,9757,114
2021-07-05,Tehama,103,63373,5175,5125,600,5725,63
2021-07-05,Trinity,105,12862,495,341,99,440,3
2021-07-05,Tulare,107,460477,50567,49818,9254,59072,853
2021-07-05,Tuolumne,109,53932,4096,4112,41,4153,64
2021-07-05,Ventura,111,848112,82218,81519,3116,84635,1033
2021-07-05,Yolo,113,214977,14299,14225,375,14600,213
2021-07-05,Yuba,115,75493,6281,6223,133,6356,51
2021-07-04,Alameda,001,1643700,90317,89683,2030,91713,1253
2021-07-04,Alpine,003,1148,88,89,0,89,0
2021-07-04,Amador,005,37829,3775,3758,33,3791,46
2021-07-04,Butte,007,227075,12863,12684,1891,14575,201
2021-07-04,Calaveras,009,45235,2227,2200,14,2214,55
2021-07-04,Colusa,011,21464,1978,1969,327,2296,15
2021-07-04,Contra Costa,013,1133247,71708,70941,1347,72288,818
2021-07-04,Del Norte,015,27424,1477,1439,13,1452,8
2021-07-04,El Dorado,017,186661,10570,10433,776,11209,113
2021-07-04,Fresno,019,978130,103778,102512,8845,111357,1727
2021-07-04,Glenn,021,27897,2459,2442,575,3017,20
2021-07-04,Humboldt,023,135768,4577,4530,53,4583,49
2021-07-04,Imperial,025,180216,28869,28661,2903,31564,739
2021-07-04,Inyo,027,18085,1415,1412,12,1424,35
2021-07-04,Kern,029,883053,98161,97421,11255,108676,1347
2021-07-04,Kings,031,150075,23354,23051,1118,24169,245
2021-07-04,Lake,033,64148,3675,3623,13,3636,62
2021-07-04,Lassen,035,31185,5306,5277,117,5394,20
2021-07-04,Los Angeles,037,10098052,1215592,1208705,42458,1251163,24506
2021-07-04,Madera,039,155013,16871,16696,959,17655,240
2021-07-04,Marin,041,260295,14283,14143,269,14412,233
2021-07-04,Mariposa,043,17540,442,441,11,452,5
2021-07-04,Mendocino,045,87422,4229,4122,85,4207,49
2021-07-04,Merced,047,269075,31394,31297,1006,32303,469
2021-07-04,Modoc,049,8938,421,410,149,559,4
2021-07-04,Mono,051,14174,1267,1275,18,1293,3
2021-07-04,Monterey,053,433212,43434,43212,1902,45114,492
2021-07-04,Napa,055,140530,10092,10045,40,10085,81
2021-07-04,Nevada,057,99092,5039,4966,195,5161,72
2021-07-04,Orange,059,3164182,257588,255823,11649,267472,5126
2021-07-04,Placer,061,380077,24044,23764,1588,25352,299
2021-07-04,Plumas,063,18699,727,707,14,721,4
2021-07-04,Riverside,065,2383286,296629,293260,14258,307518,4536
2021-07-04,Sacramento,067,1510023,109386,108257,1900,110157,1676
2021-07-04,San Benito,069,59416,6149,6108,116,6224,63
2021-07-04,San Bernardino,071,2135413,295752,294294,9117,303411,5003
2021-07-04,San Diego,073,3302833,284259,282692,15589,298281,3780
2021-07-04,San Francisco,075,870044,37477,37107,1335,38442,558
2021-07-04,San Joaquin,077,732212,74511,73841,3701,77542,1409
2021-07-04,San Luis Obispo,079,281455,21653,21330,765,22095,256
2021-07-04,San Mateo,081,765935,43052,42691,496,43187,541
2021-07-04,Santa Barbara,083,443738,34661,34526,1212,35738,456
2021-07-04,Santa Clara,085,1922200,119953,118966,787,119753,2090
2021-07-04,Santa Cruz,087,273765,16376,16254,818,17072,208
2021-07-04,Shasta,089,179085,12681,12582,1661,14243,204
2021-07-04,Sierra,091,2930,64,60,12,72,0
2021-07-04,Siskiyou,093,43540,1978,1899,387,2286,29
2021-07-04,Solano,095,438530,33768,33486,582,34068,268
2021-07-04,Sonoma,097,501317,31290,31000,371,31371,316
2021-07-04,Stanislaus,099,539301,57301,57018,6067,63085,1018
2021-07-04,Sutter,101,95872,9743,9644,90,9734,114
2021-07-04,Tehama,103,63373,5171,5124,600,5724,63
2021-07-04,Trinity,105,12862,494,341,99,440,3
2021-07-04,Tulare,107,460477,50557,49789,9251,59040,853
2021-07-04,Tuolumne,109,53932,4088,4113,41,4154,64
2021-07-04,Ventura,111,848112,82160,81425,3105,84530,1033
2021-07-04,Yolo,113,214977,14279,14188,372,14560,213
2021-07-04,Yuba,115,75493,6273,6197,133,6330,51
2021-07-03,Alameda,001,1643700,90228,89683,2022,91705,1253
2021-07-03,Alpine,003,1148,88,89,0,89,0
2021-07-03,Amador,005,37829,3775,3758,33,3791,46
2021-07-03,Butte,007,227075,12859,12684,1890,14574,201
2021-07-03,Calaveras,009,45235,2225,2200,14,2214,55
2021-07-03,Colusa,011,21464,1977,1969,327,2296,15
2021-07-03,Contra Costa,013,1133247,71649,70941,1344,72285,818
2021-07-03,Del Norte,015,27424,1474,1439,13,1452,8
2021-07-03,El Dorado,017,186661,10563,10433,774,11207,113
2021-07-03,Fresno,019,978130,103753,102512,8836,111348,1727
2021-07-03,Glenn,021,27897,2459,2442,575,3017,20
2021-07-03,Humboldt,023,135768,4572,4530,53,4583,49
2021-07-03,Imperial,025,180216,28859,28661,2903,31564,739
2021-07-03,Inyo,027,18085,1415,1412,12,1424,35
2021-07-03,Kern,029,883053,98141,97421,11247,108668,1347
2021-07-03,Kings,031,150075,23354,23051,1117,24168,245
2021-07-03,Lake,033,64148,3665,3623,13,3636,62
2021-07-03,Lassen,035,31185,5305,5277,117,5394,20
2021-07-03,Los Angeles,037,10098052,1215165,1208705,42428,1251133,24506
2021-07-03,Madera,039,155013,16862,16696,956,17652,240
2021-07-03,Marin,041,260295,14279,14143,269,14412,233
2021-07-03,Mariposa,043,17540,442,441,11,452,5
2021-07-03,Mendocino,045,87422,4228,4122,85,4207,49
2021-07-03,Merced,047,269075,31381,31297,1005,32302,469
2021-07-03,Modoc,049,8938,420,410,149,559,4
2021-07-03,Mono,051,14174,1266,1275,18,1293,3
2021-07-03,Monterey,053,433212,43422,43212,1899,45111,492
2021-07-03,Napa,055,140530,10087,10045,40,10085,81
2021-07-03,Nevada,057,99092,5025,4966,195,5161,72
2021-07-03,Orange,059,3164182,257504,255823,11642,267465,5126
2021-07-03,Placer,061,380077,24025,23764,1585,25349,299
2021-07-03,Plumas,063,18699,727,707,14,721,4
2021-07-03,Riverside,065,2383286,296537,293260,14254,307514,4536
2021-07-03,Sacramento,067,1510023,109312,108257,1897,110154,1676
2021-07-03,San Benito,069,59416,6142,6108,116,6224,63
2021-07-03,San Bernardino,071,2135413,295662,294294,9114,303408,5003
2021-07-03,San Diego,073,3302833,284128,282692,15570,298262,3780
2021-07-03,San Francisco,075,870044,37436,37107,1332,38439,558
2021-07-03,San Joaquin,077,732212,74475,73841,3696,77537,1409
2021-07-03,San Luis Obispo,079,281455,21641,21330,765,22095,256
2021-07-03,San Mateo,081,765935,43027,42691,495,43186,541
2021-07-03,Santa Barbara,083,443738,34652,34526,1211,35737,456
2021-07-03,Santa Clara,085,1922200,119906,118966,787,119753,2090
2021-07-03,Santa Cruz,087,273765,16369,16254,818,17072,208
2021-07-03,Shasta,089,179085,12677,12582,1659,14241,204
2021-07-03,Sierra,091,2930,64,60,12,72,0
2021-07-03,Siskiyou,093,43540,1977,1899,386,2285,29
2021-07-03,Solano,095,438530,33724,33486,582,34068,268
2021-07-03,Sonoma,097,501317,31256,31000,371,31371,316
2021-07-03,Stanislaus,099,539301,57290,57018,6059,63077,1018
2021-07-03,Sutter,101,95872,9733,9644,90,9734,114
2021-07-03,Tehama,103,63373,5169,5124,600,5724,63
2021-07-03,Trinity,105,12862,494,341,99,440,3
2021-07-03,Tulare,107,460477,50551,49789,9245,59034,853
2021-07-03,Tuolumne,109,53932,4087,4113,41,4154,64
2021-07-03,Ventura,111,848112,82130,81425,3097,84522,1033
2021-07-03,Yolo,113,214977,14269,14188,369,14557,213
2021-07-03,Yuba,115,75493,6267,6197,133,6330,51
2021-07-02,Alameda,001,1643700,90146,89683,2021,91704,1253
2021-07-02,Alpine,003,1148,88,89,0,89,0
2021-07-02,Amador,005,37829,3773,3758,33,3791,46
2021-07-02,Butte,007,227075,12852,12684,1890,14574,201
2021-07-02,Calaveras,009,45235,2223,2200,14,2214,55
2021-07-02,Colusa,011,21464,1976,1969,326,2295,15
2021-07-02,Contra Costa,013,1133247,71579,70941,1340,72281,818
2021-07-02,Del Norte,015,27424,1474,1439,13,1452,8
2021-07-02,El Dorado,017,186661,10555,10433,774,11207,113
2021-07-02,Fresno,019,978130,103724,102512,8830,111342,1727
2021-07-02,Glenn,021,27897,2458,2442,574,3016,20
2021-07-02,Humboldt,023,135768,4569,4530,52,4582,49
2021-07-02,Imperial,025,180216,28853,28661,2902,31563,739
2021-07-02,Inyo,027,18085,1415,1412,12,1424,35
2021-07-02,Kern,029,883053,98123,97421,11238,108659,1347
2021-07-02,Kings,031,150075,23344,23051,1117,24168,245
2021-07-02,Lake,033,64148,3659,3623,13,3636,62
2021-07-02,Lassen,035,31185,5305,5277,117,5394,20
2021-07-02,Los Angeles,037,10098052,1214691,1208705,42390,1251095,24506
2021-07-02,Madera,039,155013,16853,16696,955,17651,240
2021-07-02,Marin,041,260295,14274,14143,269,14412,233
2021-07-02,Mariposa,043,17540,442,441,11,452,5
2021-07-02,Mendocino,045,87422,4224,4122,84,4206,49
2021-07-02,Merced,047,269075,31372,31297,1005,32302,469
2021-07-02,Modoc,049,8938,420,410,149,559,4
2021-07-02,Mono,051,14174,1265,1275,18,1293,3
2021-07-02,Monterey,053,433212,43414,43212,1898,45110,492
2021-07-02,Napa,055,140530,10082,10045,40,10085,81
2021-07-02,Nevada,057,99092,5016,4966,195,5161,72
2021-07-02,Orange,059,3164182,257393,255823,11635,267458,5126
2021-07-02,Placer,061,380077,24008,23764,1578,25342,299
2021-07-02,Plumas,063,18699,727,707,14,721,4
2021-07-02,Riverside,065,2383286,296440,293260,14249,307509,4536
2021-07-02,Sacramento,067,1510023,109234,108257,1896,110153,1676
2021-07-02,San Benito,069,59416,6139,6108,116,6224,63
2021-07-02,San Bernardino,071,2135413,295575,294294,9112,303406,5003
2021-07-02,San Diego,073,3302833,283983,282692,15544,298236,3780
2021-07-02,San Francisco,075,870044,37388,37107,1330,38437,558
2021-07-02,San Joaquin,077,732212,74442,73841,3690,77531,1409
2021-07-02,San Luis Obispo,079,281455,21635,21330,764,22094,256
2021-07-02,San Mateo,081,765935,42991,42691,495,43186,541
2021-07-02,Santa Barbara,083,443738,34642,34526,1211,35737,456
2021-07-02,Santa Clara,085,1922200,119828,118966,787,119753,2090
2021-07-02,Santa Cruz,087,273765,16365,16254,818,17072,208
2021-07-02,Shasta,089,179085,12673,12582,1659,14241,204
2021-07-02,Sierra,091,2930,63,60,12,72,0
2021-07-02,Siskiyou,093,43540,1974,1899,385,2284,29
2021-07-02,Solano,095,438530,33699,33486,582,34068,268
2021-07-02,Sonoma,097,501317,31233,31000,371,31371,316
2021-07-02,Stanislaus,099,539301,57275,57018,6058,63076,1018
2021-07-02,Sutter,101,95872,9728,9644,90,9734,114
2021-07-02,Tehama,103,63373,5167,5124,598,5722,63
2021-07-02,Trinity,105,12862,494,341,99,440,3
2021-07-02,Tulare,107,460477,50541,49789,9237,59026,853
2021-07-02,Tuolumne,109,53932,4084,4113,41,4154,64
2021-07-02,Ventura,111,848112,82087,81425,3089,84514,1033
2021-07-02,Yolo,113,214977,14253,14188,367,14555,213
2021-07-02,Yuba,115,75493,6259,6197,133,6330,51
2021-07-01,Alameda,001,1643700,90045,89683,2019,91702,1253
2021-07-01,Alpine,003,1148,88,89,0,89,0
2021-07-01,Amador,005,37829,3772,3758,33,3791,46
2021-07-01,Butte,007,227075,12840,12684,1888,14572,201
2021-07-01,Calaveras,009,45235,2220,2200,14,2214,55
2021-07-01,Colusa,011,21464,1976,1969,324,2293,15
2021-07-01,Contra Costa,013,1133247,71508,70941,1340,72281,818
2021-07-01,Del Norte,015,27424,1473,1439,13,1452,8
2021-07-01,El Dorado,017,186661,10543,10433,774,11207,113
2021-07-01,Fresno,019,978130,103685,102512,8825,111337,1727
2021-07-01,Glenn,021,27897,2458,2442,574,3016,20
2021-07-01,Humboldt,023,135768,4567,4530,52,4582,49
2021-07-01,Imperial,025,180216,28836,28661,2902,31563,739
2021-07-01,Inyo,027,18085,1415,1412,12,1424,35
2021-07-01,Kern,029,883053,98097,97421,11228,108649,1347
2021-07-01,Kings,031,150075,23330,23051,1117,24168,245
2021-07-01,Lake,033,64148,3656,3623,13,3636,62
2021-07-01,Lassen,035,31185,5303,5277,117,5394,20
2021-07-01,Los Angeles,037,10098052,1214092,1208705,42335,1251040,24506
2021-07-01,Madera,039,155013,16844,16696,954,17650,240
2021-07-01,Marin,041,260295,14270,14143,269,14412,233
2021-07-01,Mariposa,043,17540,442,441,11,452,5
2021-07-01,Mendocino,045,87422,4220,4122,83,4205,49
2021-07-01,Merced,047,269075,31366,31297,1005,32302,469
2021-07-01,Modoc,049,8938,420,410,149,559,4
2021-07-01,Mono,051,14174,1264,1275,18,1293,3
2021-07-01,Monterey,053,433212,43406,43212,1894,45106,492
2021-07-01,Napa,055,140530,10075,10045,40,10085,81
2021-07-01,Nevada,057,99092,5011,4966,195,5161,72
2021-07-01,Orange,059,3164182,257272,255823,11616,267439,5126
2021-07-01,Placer,061,380077,23989,23764,1575,25339,299
2021-07-01,Plumas,063,18699,724,707,12,719,4
2021-07-01,Riverside,065,2383286,296331,293260,14241,307501,4536
2021-07-01,Sacramento,067,1510023,109108,108257,1889,110146,1676
2021-07-01,San Benito,069,59416,6135,6108,116,6224,63
2021-07-01,San Bernardino,071,2135413,295455,294294,9107,303401,5003
2021-07-01,San Diego,073,3302833,283805,282692,15507,298199,3780
2021-07-01,San Francisco,075,870044,37352,37107,1328,38435,558
2021-07-01,San Joaquin,077,732212,74391,73841,3686,77527,1409
2021-07-01,San Luis Obispo,079,281455,21620,21330,763,22093,256
2021-07-01,San Mateo,081,765935,42963,42691,494,43185,541
2021-07-01,Santa Barbara,083,443738,34628,34526,1211,35737,456
2021-07-01,Santa Clara,085,1922200,119779,118966,787,119753,2090
2021-07-01,Santa Cruz,087,273765,16360,16254,818,17072,208
2021-07-01,Shasta,089,179085,12665,12582,1658,14240,204
2021-07-01,Sierra,091,2930,63,60,12,72,0
2021-07-01,Siskiyou,093,43540,1974,1899,385,2284,29
2021-07-01,Solano,095,438530,33658,33486,581,34067,268
2021-07-01,Sonoma,097,501317,31189,31000,371,31371,316
2021-07-01,Stanislaus,099,539301,57260,57018,6054,63072,1018
2021-07-01,Sutter,101,95872,9719,9644,90,9734,114
2021-07-01,Tehama,103,63373,5167,5124,597,5721,63
2021-07-01,Trinity,105,12862,494,341,99,440,3
2021-07-01,Tulare,107,460477,50532,49789,9230,59019,853
2021-07-01,Tuolumne,109,53932,4077,4113,41,4154,64
2021-07-01,Ventura,111,848112,82056,81425,3078,84503,1033
2021-07-01,Yolo,113,214977,14238,14188,365,14553,213
2021-07-01,Yuba,115,75493,6252,6197,133,6330,51
2021-06-30,Alameda,001,1643700,89966,89597,2014,91611,1256
2021-06-30,Alpine,003,1148,88,89,0,89,0
2021-06-30,Amador,005,37829,3770,3756,33,3789,46
2021-06-30,Butte,007,227075,12833,12676,1879,14555,201
2021-06-30,Calaveras,009,45235,2214,2198,14,2212,55
2021-06-30,Colusa,011,21464,1974,1967,321,2288,15
2021-06-30,Contra Costa,013,1133247,71444,70869,1337,72206,818
2021-06-30,Del Norte,015,27424,1468,1435,13,1448,8
2021-06-30,El Dorado,017,186661,10524,10420,774,11194,113
2021-06-30,Fresno,019,978130,103648,102490,8822,111312,1727
2021-06-30,Glenn,021,27897,2456,2440,574,3014,20
2021-06-30,Humboldt,023,135768,4551,4522,50,4572,49
2021-06-30,Imperial,025,180216,28828,28651,2902,31553,739
2021-06-30,Inyo,027,18085,1415,1409,12,1421,35
2021-06-30,Kern,029,883053,98056,97267,11216,108483,1348
2021-06-30,Kings,031,150075,23325,23038,1116,24154,245
2021-06-30,Lake,033,64148,3643,3601,13,3614,56
2021-06-30,Lassen,035,31185,5298,5269,117,5386,20
2021-06-30,Los Angeles,037,10098052,1213422,1208246,42291,1250537,24499
2021-06-30,Madera,039,155013,16836,16688,952,17640,240
2021-06-30,Marin,041,260295,14261,14133,268,14401,232
2021-06-30,Mariposa,043,17540,441,441,11,452,5
2021-06-30,Mendocino,045,87422,4210,4115,83,4198,49
2021-06-30,Merced,047,269075,31356,31286,1005,32291,469
2021-06-30,Modoc,049,8938,420,410,149,559,4
2021-06-30,Mono,051,14174,1264,1275,18,1293,3
2021-06-30,Monterey,053,433212,43401,43209,1892,45101,492
2021-06-30,Napa,055,140530,10067,10039,40,10079,81
2021-06-30,Nevada,057,99092,5000,4958,195,5153,72
2021-06-30,Orange,059,3164182,257143,255764,11606,267370,5125
2021-06-30,Placer,061,380077,23965,23721,1571,25292,299
2021-06-30,Plumas,063,18699,724,705,12,717,4
2021-06-30,Riverside,065,2383286,296217,293280,14231,307511,4535
2021-06-30,Sacramento,067,1510023,108969,108137,1885,110022,1676
2021-06-30,San Benito,069,59416,6131,6105,116,6221,63
2021-06-30,San Bernardino,071,2135413,295296,294211,9102,303313,4975
2021-06-30,San Diego,073,3302833,283669,282583,15479,298062,3780
2021-06-30,San Francisco,075,870044,37303,37065,1323,38388,558
2021-06-30,San Joaquin,077,732212,74329,73777,3685,77462,1409
2021-06-30,San Luis Obispo,079,281455,21607,21326,762,22088,256
2021-06-30,San Mateo,081,765935,42926,42599,493,43092,537
2021-06-30,Santa Barbara,083,443738,34612,34521,1211,35732,456
2021-06-30,Santa Clara,085,1922200,119732,118930,784,119714,2090
2021-06-30,Santa Cruz,087,273765,16354,16250,818,17068,208
2021-06-30,Shasta,089,179085,12659,12564,1658,14222,204
2021-06-30,Sierra,091,2930,63,60,12,72,0
2021-06-30,Siskiyou,093,43540,1972,1900,382,2282,29
2021-06-30,Solano,095,438530,33619,33453,579,34032,268
2021-06-30,Sonoma,097,501317,31159,30947,371,31318,316
2021-06-30,Stanislaus,099,539301,57243,56997,6053,63050,1018
2021-06-30,Sutter,101,95872,9709,9638,90,9728,114
2021-06-30,Tehama,103,63373,5165,5124,597,5721,63
2021-06-30,Trinity,105,12862,494,341,99,440,3
2021-06-30,Tulare,107,460477,50521,49764,9219,58983,853
2021-06-30,Tuolumne,109,53932,4074,4112,41,4153,64
2021-06-30,Ventura,111,848112,82013,81392,3073,84465,1032
2021-06-30,Yolo,113,214977,14232,14178,362,14540,213
2021-06-30,Yuba,115,75493,6245,6191,133,6324,51
2021-06-29,Alameda,001,1643700,89859,89519,2013,91532,1257
2021-06-29,Alpine,003,1148,88,89,0,89,0
2021-06-29,Amador,005,37829,3766,3754,33,3787,46
2021-06-29,Butte,007,227075,12825,12669,1879,14548,201
2021-06-29,Calaveras,009,45235,2208,2198,14,2212,55
2021-06-29,Colusa,011,21464,1972,1967,321,2288,15
2021-06-29,Contra Costa,013,1133247,71370,70775,1337,72112,817
2021-06-29,Del Norte,015,27424,1467,1435,13,1448,8
2021-06-29,El Dorado,017,186661,10511,10403,770,11173,113
2021-06-29,Fresno,019,978130,103615,102464,8819,111283,1725
2021-06-29,Glenn,021,27897,2455,2439,574,3013,20
2021-06-29,Humboldt,023,135768,4547,4514,49,4563,49
2021-06-29,Imperial,025,180216,28819,28645,2900,31545,737
2021-06-29,Inyo,027,18085,1415,1408,12,1420,35
2021-06-29,Kern,029,883053,98035,97173,11210,108383,1347
2021-06-29,Kings,031,150075,23316,23035,1115,24150,245
2021-06-29,Lake,033,64148,3637,3594,13,3607,56
2021-06-29,Lassen,035,31185,5291,5268,117,5385,20
2021-06-29,Los Angeles,037,10098052,1212813,1207895,42260,1250155,24498
2021-06-29,Madera,039,155013,16832,16680,951,17631,240
2021-06-29,Marin,041,260295,14249,14127,268,14395,232
2021-06-29,Mariposa,043,17540,441,441,11,452,5
2021-06-29,Mendocino,045,87422,4206,4107,82,4189,49
2021-06-29,Merced,047,269075,31344,31277,1005,32282,469
2021-06-29,Modoc,049,8938,419,408,149,557,3
2021-06-29,Mono,051,14174,1264,1275,18,1293,3
2021-06-29,Monterey,053,433212,43391,43196,1890,45086,471
2021-06-29,Napa,055,140530,10061,10033,40,10073,81
2021-06-29,Nevada,057,99092,4993,4952,195,5147,72
2021-06-29,Orange,059,3164182,257043,255686,11591,267277,5124
2021-06-29,Placer,061,380077,23945,23693,1569,25262,299
2021-06-29,Plumas,063,18699,724,704,12,716,4
2021-06-29,Riverside,065,2383286,296118,292962,14224,307186,4524
2021-06-29,Sacramento,067,1510023,108816,108067,1882,109949,1677
2021-06-29,San Benito,069,59416,6120,6099,116,6215,63
2021-06-29,San Bernardino,071,2135413,295184,294118,9100,303218,4940
2021-06-29,San Diego,073,3302833,283514,282499,15452,297951,3780
2021-06-29,San Francisco,075,870044,37265,37041,1320,38361,558
2021-06-29,San Joaquin,077,732212,74281,73724,3682,77406,1409
2021-06-29,San Luis Obispo,079,281455,21597,21324,761,22085,256
2021-06-29,San Mateo,081,765935,42892,42540,493,43033,540
2021-06-29,Santa Barbara,083,443738,34602,34507,1210,35717,455
2021-06-29,Santa Clara,085,1922200,119677,118893,783,119676,2090
2021-06-29,Santa Cruz,087,273765,16348,16249,818,17067,208
2021-06-29,Shasta,089,179085,12647,12564,1657,14221,204
2021-06-29,Sierra,091,2930,63,59,12,71,0
2021-06-29,Siskiyou,093,43540,1969,1897,378,2275,29
2021-06-29,Solano,095,438530,33586,33440,577,34017,268
2021-06-29,Sonoma,097,501317,31117,30950,369,31319,316
2021-06-29,Stanislaus,099,539301,57222,56980,6046,63026,1018
2021-06-29,Sutter,101,95872,9698,9634,90,9724,114
2021-06-29,Tehama,103,63373,5165,5124,597,5721,63
2021-06-29,Trinity,105,12862,494,341,99,440,3
2021-06-29,Tulare,107,460477,50508,49751,9214,58965,852
2021-06-29,Tuolumne,109,53932,4072,4111,41,4152,64
2021-06-29,Ventura,111,848112,81975,81363,3067,84430,1032
2021-06-29,Yolo,113,214977,14220,14171,361,14532,213
2021-06-29,Yuba,115,75493,6235,6188,133,6321,51
2021-06-28,Alameda,001,1643700,89766,89638,2010,91648,1259
2021-06-28,Alpine,003,1148,88,89,0,89,0
2021-06-28,Amador,005,37829,3765,3753,33,3786,46
2021-06-28,Butte,007,227075,12816,12697,1877,14574,198
2021-06-28,Calaveras,009,45235,2205,2203,14,2217,55
2021-06-28,Colusa,011,21464,1970,1974,321,2295,15
2021-06-28,Contra Costa,013,1133247,71296,70807,1335,72142,816
2021-06-28,Del Norte,015,27424,1467,1436,13,1449,8
2021-06-28,El Dorado,017,186661,10501,10422,766,11188,115
2021-06-28,Fresno,019,978130,103585,103121,8817,111938,1727
2021-06-28,Glenn,021,27897,2455,2439,574,3013,20
2021-06-28,Humboldt,023,135768,4540,4520,48,4568,49
2021-06-28,Imperial,025,180216,28811,28981,2899,31880,741
2021-06-28,Inyo,027,18085,1412,1407,12,1419,35
2021-06-28,Kern,029,883053,98016,97252,11205,108457,1348
2021-06-28,Kings,031,150075,23310,23134,1115,24249,246
2021-06-28,Lake,033,64148,3629,3591,13,3604,56
2021-06-28,Lassen,035,31185,5289,5268,117,5385,20
2021-06-28,Los Angeles,037,10098052,1212295,1207714,42224,1249938,24496
2021-06-28,Madera,039,155013,16821,16683,950,17633,240
2021-06-28,Marin,041,260295,14234,14186,268,14454,232
2021-06-28,Mariposa,043,17540,441,440,11,451,5
2021-06-28,Mendocino,045,87422,4197,4102,81,4183,49
2021-06-28,Merced,047,269075,31332,31277,1005,32282,469
2021-06-28,Modoc,049,8938,419,411,148,559,3
2021-06-28,Mono,051,14174,1264,1276,18,1294,3
2021-06-28,Monterey,053,433212,43387,43202,1889,45091,462
2021-06-28,Napa,055,140530,10052,10050,39,10089,81
2021-06-28,Nevada,057,99092,4989,4951,195,5146,72
2021-06-28,Orange,059,3164182,256953,255755,11577,267332,5123
2021-06-28,Placer,061,380077,23925,23756,1564,25320,299
2021-06-28,Plumas,063,18699,722,704,12,716,4
2021-06-28,Riverside,065,2383286,295992,292647,14211,306858,4507
2021-06-28,Sacramento,067,1510023,108684,108342,1877,110219,1675
2021-06-28,San Benito,069,59416,6118,6101,116,6217,63
2021-06-28,San Bernardino,071,2135413,295083,294151,9095,303246,4928
2021-06-28,San Diego,073,3302833,283351,282417,15423,297840,3780
2021-06-28,San Francisco,075,870044,37229,37372,1318,38690,559
2021-06-28,San Joaquin,077,732212,74233,73973,3678,77651,1411
2021-06-28,San Luis Obispo,079,281455,21593,21340,760,22100,256
2021-06-28,San Mateo,081,765935,42858,42927,492,43419,540
2021-06-28,Santa Barbara,083,443738,34595,34534,1208,35742,455
2021-06-28,Santa Clara,085,1922200,119613,120377,782,121159,2103
2021-06-28,Santa Cruz,087,273765,16343,16245,818,17063,208
2021-06-28,Shasta,089,179085,12643,12642,1655,14297,203
2021-06-28,Sierra,091,2930,63,58,12,70,0
2021-06-28,Siskiyou,093,43540,1968,1896,378,2274,29
2021-06-28,Solano,095,438530,33550,33524,575,34099,267
2021-06-28,Sonoma,097,501317,31080,31137,368,31505,315
2021-06-28,Stanislaus,099,539301,57204,57047,6042,63089,1018
2021-06-28,Sutter,101,95872,9694,9682,90,9772,114
2021-06-28,Tehama,103,63373,5163,5122,597,5719,63
2021-06-28,Trinity,105,12862,494,341,99,440,3
2021-06-28,Tulare,107,460477,50498,49751,9210,58961,850
2021-06-28,Tuolumne,109,53932,4065,4121,41,4162,64
2021-06-28,Ventura,111,848112,81918,81393,3062,84455,1032
2021-06-28,Yolo,113,214977,14211,14199,358,14557,213
2021-06-28,Yuba,115,75493,6230,6207,133,6340,51
2021-06-27,Alameda,001,1643700,89680,89611,2005,91616,1259
2021-06-27,Alpine,003,1148,88,89,0,89,0
2021-06-27,Amador,005,37829,3764,3752,33,3785,46
2021-06-27,Butte,007,227075,12807,12696,1876,14572,198
2021-06-27,Calaveras,009,45235,2203,2203,14,2217,55
2021-06-27,Colusa,011,21464,1970,1974,321,2295,15
2021-06-27,Contra Costa,013,1133247,71210,70762,1331,72093,816
2021-06-27,Del Norte,015,27424,1464,1436,13,1449,8
2021-06-27,El Dorado,017,186661,10489,10418,763,11181,115
2021-06-27,Fresno,019,978130,103556,103110,8815,111925,1727
2021-06-27,Glenn,021,27897,2454,2439,573,3012,20
2021-06-27,Humboldt,023,135768,4528,4513,45,4558,49
2021-06-27,Imperial,025,180216,28797,28987,2898,31885,741
2021-06-27,Inyo,027,18085,1412,1407,12,1419,35
2021-06-27,Kern,029,883053,97990,97249,11198,108447,1348
2021-06-27,Kings,031,150075,23300,23132,1115,24247,246
2021-06-27,Lake,033,64148,3622,3581,13,3594,56
2021-06-27,Lassen,035,31185,5288,5265,117,5382,20
2021-06-27,Los Angeles,037,10098052,1211750,1207461,42184,1249645,24493
2021-06-27,Madera,039,155013,16813,16680,950,17630,240
2021-06-27,Marin,041,260295,14225,14182,268,14450,232
2021-06-27,Mariposa,043,17540,441,440,11,451,5
2021-06-27,Mendocino,045,87422,4190,4100,81,4181,49
2021-06-27,Merced,047,269075,31320,31266,1005,32271,469
2021-06-27,Modoc,049,8938,419,411,148,559,3
2021-06-27,Mono,051,14174,1264,1279,18,1297,3
2021-06-27,Monterey,053,433212,43374,43199,1889,45088,462
2021-06-27,Napa,055,140530,10046,10046,39,10085,81
2021-06-27,Nevada,057,99092,4983,4946,195,5141,72
2021-06-27,Orange,059,3164182,256839,255710,11566,267276,5123
2021-06-27,Placer,061,380077,23892,23731,1561,25292,299
2021-06-27,Plumas,063,18699,722,704,12,716,4
2021-06-27,Riverside,065,2383286,295889,292641,14204,306845,4507
2021-06-27,Sacramento,067,1510023,108549,108279,1873,110152,1675
2021-06-27,San Benito,069,59416,6112,6101,116,6217,63
2021-06-27,San Bernardino,071,2135413,294970,294115,9093,303208,4927
2021-06-27,San Diego,073,3302833,283211,282359,15397,297756,3780
2021-06-27,San Francisco,075,870044,37192,37360,1317,38677,559
2021-06-27,San Joaquin,077,732212,74197,73960,3676,77636,1411
2021-06-27,San Luis Obispo,079,281455,21586,21340,759,22099,256
2021-06-27,San Mateo,081,765935,42829,42925,489,43414,539
2021-06-27,Santa Barbara,083,443738,34581,34533,1206,35739,455
2021-06-27,Santa Clara,085,1922200,119562,120352,781,121133,2103
2021-06-27,Santa Cruz,087,273765,16334,16241,818,17059,208
2021-06-27,Shasta,089,179085,12637,12640,1654,14294,203
2021-06-27,Sierra,091,2930,63,58,12,70,0
2021-06-27,Siskiyou,093,43540,1966,1896,377,2273,29
2021-06-27,Solano,095,438530,33522,33516,575,34091,267
2021-06-27,Sonoma,097,501317,31042,31129,368,31497,315
2021-06-27,Stanislaus,099,539301,57165,57021,6039,63060,1018
2021-06-27,Sutter,101,95872,9688,9678,90,9768,114
2021-06-27,Tehama,103,63373,5159,5122,597,5719,63
2021-06-27,Trinity,105,12862,494,341,98,439,3
2021-06-27,Tulare,107,460477,50485,49749,9203,58952,850
2021-06-27,Tuolumne,109,53932,4063,4121,41,4162,64
2021-06-27,Ventura,111,848112,81884,81361,3053,84414,1032
2021-06-27,Yolo,113,214977,14196,14194,354,14548,213
2021-06-27,Yuba,115,75493,6224,6205,133,6338,51
2021-06-26,Alameda,001,1643700,89623,89560,2003,91563,1259
2021-06-26,Alpine,003,1148,88,89,0,89,0
2021-06-26,Amador,005,37829,3764,3748,33,3781,46
2021-06-26,Butte,007,227075,12803,12693,1873,14566,198
2021-06-26,Calaveras,009,45235,2201,2202,14,2216,55
2021-06-26,Colusa,011,21464,1970,1973,321,2294,15
2021-06-26,Contra Costa,013,1133247,71167,70712,1330,72042,816
2021-06-26,Del Norte,015,27424,1463,1432,13,1445,8
2021-06-26,El Dorado,017,186661,10481,10414,762,11176,115
2021-06-26,Fresno,019,978130,103536,103091,8813,111904,1727
2021-06-26,Glenn,021,27897,2452,2441,573,3014,20
2021-06-26,Humboldt,023,135768,4525,4509,45,4554,49
2021-06-26,Imperial,025,180216,28793,28970,2898,31868,741
2021-06-26,Inyo,027,18085,1412,1407,12,1419,35
2021-06-26,Kern,029,883053,97964,97239,11189,108428,1348
2021-06-26,Kings,031,150075,23296,23128,1114,24242,246
2021-06-26,Lake,033,64148,3611,3576,13,3589,56
2021-06-26,Lassen,035,31185,5285,5263,117,5380,20
2021-06-26,Los Angeles,037,10098052,1211446,1207198,42149,1249347,24490
2021-06-26,Madera,039,155013,16806,16679,949,17628,240
2021-06-26,Marin,041,260295,14216,14180,268,14448,232
2021-06-26,Mariposa,043,17540,441,440,11,451,5
2021-06-26,Mendocino,045,87422,4188,4096,81,4177,49
2021-06-26,Merced,047,269075,31314,31259,1004,32263,469
2021-06-26,Modoc,049,8938,419,411,148,559,3
2021-06-26,Mono,051,14174,1264,1279,18,1297,3
2021-06-26,Monterey,053,433212,43371,43192,1889,45081,462
2021-06-26,Napa,055,140530,10040,10043,39,10082,81
2021-06-26,Nevada,057,99092,4978,4939,195,5134,72
2021-06-26,Orange,059,3164182,256760,255640,11559,267199,5123
2021-06-26,Placer,061,380077,23878,23702,1559,25261,299
2021-06-26,Plumas,063,18699,722,704,12,716,4
2021-06-26,Riverside,065,2383286,295831,292480,14198,306678,4505
2021-06-26,Sacramento,067,1510023,108478,108179,1871,110050,1675
2021-06-26,San Benito,069,59416,6108,6100,116,6216,63
2021-06-26,San Bernardino,071,2135413,294875,294034,9088,303122,4928
2021-06-26,San Diego,073,3302833,283126,282263,15379,297642,3780
2021-06-26,San Francisco,075,870044,37160,37348,1316,38664,559
2021-06-26,San Joaquin,077,732212,74168,73928,3675,77603,1411
2021-06-26,San Luis Obispo,079,281455,21585,21330,758,22088,256
2021-06-26,San Mateo,081,765935,42809,42898,489,43387,539
2021-06-26,Santa Barbara,083,443738,34572,34525,1206,35731,455
2021-06-26,Santa Clara,085,1922200,119529,120321,781,121102,2103
2021-06-26,Santa Cruz,087,273765,16331,16239,818,17057,208
2021-06-26,Shasta,089,179085,12633,12635,1650,14285,203
2021-06-26,Sierra,091,2930,63,58,12,70,0
2021-06-26,Siskiyou,093,43540,1965,1896,376,2272,29
2021-06-26,Solano,095,438530,33504,33489,573,34062,267
2021-06-26,Sonoma,097,501317,31016,31088,368,31456,315
2021-06-26,Stanislaus,099,539301,57149,57006,6037,63043,1018
2021-06-26,Sutter,101,95872,9687,9669,90,9759,114
2021-06-26,Tehama,103,63373,5159,5119,597,5716,63
2021-06-26,Trinity,105,12862,494,341,98,439,3
2021-06-26,Tulare,107,460477,50479,49745,9203,58948,850
2021-06-26,Tuolumne,109,53932,4063,4121,41,4162,64
2021-06-26,Ventura,111,848112,81860,81352,3052,84404,1032
2021-06-26,Yolo,113,214977,14188,14184,354,14538,213
2021-06-26,Yuba,115,75493,6221,6200,133,6333,51
2021-06-25,Alameda,001,1643700,89557,89453,2000,91453,1271
2021-06-25,Alpine,003,1148,88,89,0,89,0
2021-06-25,Amador,005,37829,3763,3746,33,3779,46
2021-06-25,Butte,007,227075,12798,12682,1870,14552,198
2021-06-25,Calaveras,009,45235,2200,2201,14,2215,55
2021-06-25,Colusa,011,21464,1970,1972,321,2293,15
2021-06-25,Contra Costa,013,1133247,71131,70659,1330,71989,815
2021-06-25,Del Norte,015,27424,1463,1426,13,1439,8
2021-06-25,El Dorado,017,186661,10473,10406,759,11165,115
2021-06-25,Fresno,019,978130,103518,103073,8809,111882,1727
2021-06-25,Glenn,021,27897,2452,2441,573,3014,20
2021-06-25,Humboldt,023,135768,4519,4503,43,4546,49
2021-06-25,Imperial,025,180216,28790,28968,2898,31866,740
2021-06-25,Inyo,027,18085,1411,1406,12,1418,35
2021-06-25,Kern,029,883053,97945,97182,11185,108367,1347
2021-06-25,Kings,031,150075,23290,23118,1114,24232,246
2021-06-25,Lake,033,64148,3605,3571,13,3584,56
2021-06-25,Lassen,035,31185,5284,5259,117,5376,20
2021-06-25,Los Angeles,037,10098052,1211167,1206909,42130,1249039,24483
2021-06-25,Madera,039,155013,16803,16670,949,17619,240
2021-06-25,Marin,041,260295,14213,14179,268,14447,232
2021-06-25,Mariposa,043,17540,441,440,11,451,5
2021-06-25,Mendocino,045,87422,4185,4089,81,4170,49
2021-06-25,Merced,047,269075,31306,31256,1004,32260,467
2021-06-25,Modoc,049,8938,419,411,148,559,3
2021-06-25,Mono,051,14174,1264,1279,18,1297,3
2021-06-25,Monterey,053,433212,43366,43184,1888,45072,462
2021-06-25,Napa,055,140530,10035,10037,39,10076,81
2021-06-25,Nevada,057,99092,4975,4932,195,5127,72
2021-06-25,Orange,059,3164182,256689,255574,11557,267131,5119
2021-06-25,Placer,061,380077,23859,23672,1558,25230,299
2021-06-25,Plumas,063,18699,722,702,11,713,4
2021-06-25,Riverside,065,2383286,295764,291663,14191,305854,4490
2021-06-25,Sacramento,067,1510023,108406,108034,1868,109902,1673
2021-06-25,San Benito,069,59416,6104,6098,116,6214,63
2021-06-25,San Bernardino,071,2135413,294820,293941,9086,303027,4911
2021-06-25,San Diego,073,3302833,283066,282157,15366,297523,3779
2021-06-25,San Francisco,075,870044,37137,37338,1315,38653,559
2021-06-25,San Joaquin,077,732212,74135,73860,3673,77533,1410
2021-06-25,San Luis Obispo,079,281455,21582,21325,757,22082,256
2021-06-25,San Mateo,081,765935,42791,42849,489,43338,537
2021-06-25,Santa Barbara,083,443738,34563,34518,1205,35723,454
2021-06-25,Santa Clara,085,1922200,119509,120272,781,121053,2103
2021-06-25,Santa Cruz,087,273765,16328,16230,816,17046,208
2021-06-25,Shasta,089,179085,12623,12633,1649,14282,202
2021-06-25,Sierra,091,2930,63,58,12,70,0
2021-06-25,Siskiyou,093,43540,1964,1894,376,2270,29
2021-06-25,Solano,095,438530,33484,33449,573,34022,267
2021-06-25,Sonoma,097,501317,30994,31043,368,31411,314
2021-06-25,Stanislaus,099,539301,57133,56973,6030,63003,1018
2021-06-25,Sutter,101,95872,9680,9664,90,9754,114
2021-06-25,Tehama,103,63373,5158,5119,597,5716,63
2021-06-25,Trinity,105,12862,494,338,98,436,3
2021-06-25,Tulare,107,460477,50472,49731,9200,58931,850
2021-06-25,Tuolumne,109,53932,4062,4121,41,4162,64
2021-06-25,Ventura,111,848112,81831,81342,3046,84388,1032
2021-06-25,Yolo,113,214977,14182,14172,354,14526,213
2021-06-25,Yuba,115,75493,6217,6195,133,6328,51
2021-06-24,Alameda,001,1643700,89486,89358,1997,91355,1268
2021-06-24,Alpine,003,1148,88,89,0,89,0
2021-06-24,Amador,005,37829,3759,3745,33,3778,46
2021-06-24,Butte,007,227075,12792,12673,1868,14541,198
2021-06-24,Calaveras,009,45235,2197,2202,14,2216,55
2021-06-24,Colusa,011,21464,1969,1972,321,2293,15
2021-06-24,Contra Costa,013,1133247,71072,70590,1330,71920,813
2021-06-24,Del Norte,015,27424,1462,1421,13,1434,8
2021-06-24,El Dorado,017,186661,10466,10402,759,11161,115
2021-06-24,Fresno,019,978130,103498,103061,8806,111867,1727
2021-06-24,Glenn,021,27897,2451,2439,573,3012,20
2021-06-24,Humboldt,023,135768,4514,4493,43,4536,49
2021-06-24,Imperial,025,180216,28787,28981,2897,31878,740
2021-06-24,Inyo,027,18085,1410,1406,12,1418,35
2021-06-24,Kern,029,883053,97926,97129,11172,108301,1346
2021-06-24,Kings,031,150075,23286,23114,1112,24226,246
2021-06-24,Lake,033,64148,3599,3571,13,3584,56
2021-06-24,Lassen,035,31185,5283,5258,117,5375,20
2021-06-24,Los Angeles,037,10098052,1210843,1206590,42107,1248697,24480
2021-06-24,Madera,039,155013,16792,16662,948,17610,240
2021-06-24,Marin,041,260295,14209,14180,268,14448,232
2021-06-24,Mariposa,043,17540,441,440,11,451,5
2021-06-24,Mendocino,045,87422,4177,4085,81,4166,49
2021-06-24,Merced,047,269075,31296,31248,1003,32251,466
2021-06-24,Modoc,049,8938,419,411,148,559,3
2021-06-24,Mono,051,14174,1264,1276,18,1294,3
2021-06-24,Monterey,053,433212,43359,43180,1888,45068,451
2021-06-24,Napa,055,140530,10033,10036,39,10075,80
2021-06-24,Nevada,057,99092,4973,4927,195,5122,72
2021-06-24,Orange,059,3164182,256625,255520,11549,267069,5117
2021-06-24,Placer,061,380077,23834,23659,1556,25215,299
2021-06-24,Plumas,063,18699,721,702,11,713,4
2021-06-24,Riverside,065,2383286,295684,291067,14180,305247,4473
2021-06-24,Sacramento,067,1510023,108318,107965,1866,109831,1672
2021-06-24,San Benito,069,59416,6101,6098,116,6214,63
2021-06-24,San Bernardino,071,2135413,294751,293895,9081,302976,4898
2021-06-24,San Diego,073,3302833,282961,282053,15354,297407,3778
2021-06-24,San Francisco,075,870044,37115,37320,1313,38633,559
2021-06-24,San Joaquin,077,732212,74087,73814,3673,77487,1408
2021-06-24,San Luis Obispo,079,281455,21576,21326,757,22083,256
2021-06-24,San Mateo,081,765935,42765,42814,488,43302,542
2021-06-24,Santa Barbara,083,443738,34557,34512,1204,35716,454
2021-06-24,Santa Clara,085,1922200,119479,120274,780,121054,2103
2021-06-24,Santa Cruz,087,273765,16327,16227,816,17043,208
2021-06-24,Shasta,089,179085,12618,12629,1645,14274,202
2021-06-24,Sierra,091,2930,63,58,12,70,0
2021-06-24,Siskiyou,093,43540,1964,1892,376,2268,28
2021-06-24,Solano,095,438530,33461,33432,571,34003,267
2021-06-24,Sonoma,097,501317,30965,31020,368,31388,314
2021-06-24,Stanislaus,099,539301,57107,56946,6030,62976,1018
2021-06-24,Sutter,101,95872,9673,9660,90,9750,113
2021-06-24,Tehama,103,63373,5155,5115,597,5712,63
2021-06-24,Trinity,105,12862,493,338,98,436,3
2021-06-24,Tulare,107,460477,50461,49730,9198,58928,850
2021-06-24,Tuolumne,109,53932,4060,4120,41,4161,64
2021-06-24,Ventura,111,848112,81803,81332,3045,84377,1032
2021-06-24,Yolo,113,214977,14173,14169,351,14520,213
2021-06-24,Yuba,115,75493,6212,6195,133,6328,51
2021-06-23,Alameda,001,1643700,89413,89338,1996,91334,1266
2021-06-23,Alpine,003,1148,88,88,0,88,0
2021-06-23,Amador,005,37829,3757,3743,33,3776,46
2021-06-23,Butte,007,227075,12785,12666,1868,14534,198
2021-06-23,Calaveras,009,45235,2196,2199,14,2213,55
2021-06-23,Colusa,011,21464,1968,1972,321,2293,15
2021-06-23,Contra Costa,013,1133247,71007,70526,1329,71855,813
2021-06-23,Del Norte,015,27424,1458,1418,13,1431,8
2021-06-23,El Dorado,017,186661,10457,10395,756,11151,115
2021-06-23,Fresno,019,978130,103469,103020,8804,111824,1724
2021-06-23,Glenn,021,27897,2451,2437,572,3009,20
2021-06-23,Humboldt,023,135768,4505,4490,43,4533,48
2021-06-23,Imperial,025,180216,28780,28908,2897,31805,740
2021-06-23,Inyo,027,18085,1410,1406,12,1418,35
2021-06-23,Kern,029,883053,97898,97078,11159,108237,1345
2021-06-23,Kings,031,150075,23279,23105,1110,24215,245
2021-06-23,Lake,033,64148,3590,3566,13,3579,53
2021-06-23,Lassen,035,31185,5280,5257,117,5374,20
2021-06-23,Los Angeles,037,10098052,1210506,1206358,42097,1248455,24472
2021-06-23,Madera,039,155013,16786,16660,948,17608,240
2021-06-23,Marin,041,260295,14203,14177,268,14445,230
2021-06-23,Mariposa,043,17540,441,439,11,450,5
2021-06-23,Mendocino,045,87422,4173,4078,81,4159,49
2021-06-23,Merced,047,269075,31287,31260,1003,32263,465
2021-06-23,Modoc,049,8938,417,407,148,555,3
2021-06-23,Mono,051,14174,1264,1279,18,1297,3
2021-06-23,Monterey,053,433212,43350,43166,1888,45054,439
2021-06-23,Napa,055,140530,10024,10032,39,10071,80
2021-06-23,Nevada,057,99092,4970,4924,195,5119,72
2021-06-23,Orange,059,3164182,256559,255479,11541,267020,5116
2021-06-23,Placer,061,380077,23805,23630,1551,25181,299
2021-06-23,Plumas,063,18699,720,701,11,712,4
2021-06-23,Riverside,065,2383286,295601,290343,14178,304521,4462
2021-06-23,Sacramento,067,1510023,108226,107868,1861,109729,1671
2021-06-23,San Benito,069,59416,6097,6097,116,6213,63
2021-06-23,San Bernardino,071,2135413,294672,293816,9076,302892,4886
2021-06-23,San Diego,073,3302833,282861,281937,15333,297270,3777
2021-06-23,San Francisco,075,870044,37091,37304,1312,38616,559
2021-06-23,San Joaquin,077,732212,74048,73764,3671,77435,1405
2021-06-23,San Luis Obispo,079,281455,21572,21323,756,22079,257
2021-06-23,San Mateo,081,765935,42749,42756,488,43244,542
2021-06-23,Santa Barbara,083,443738,34547,34505,1204,35709,454
2021-06-23,Santa Clara,085,1922200,119450,120233,780,121013,2098
2021-06-23,Santa Cruz,087,273765,16323,16215,816,17031,209
2021-06-23,Shasta,089,179085,12611,12604,1643,14247,202
2021-06-23,Sierra,091,2930,63,57,12,69,0
2021-06-23,Siskiyou,093,43540,1962,1892,376,2268,28
2021-06-23,Solano,095,438530,33417,33408,571,33979,267
2021-06-23,Sonoma,097,501317,30925,30959,366,31325,314
2021-06-23,Stanislaus,099,539301,57077,56926,6029,62955,1017
2021-06-23,Sutter,101,95872,9667,9653,90,9743,113
2021-06-23,Tehama,103,63373,5155,5119,596,5715,63
2021-06-23,Trinity,105,12862,493,338,98,436,3
2021-06-23,Tulare,107,460477,50454,49711,9194,58905,850
2021-06-23,Tuolumne,109,53932,4057,4120,41,4161,64
2021-06-23,Ventura,111,848112,81780,81312,3042,84354,1032
2021-06-23,Yolo,113,214977,14163,14161,351,14512,212
2021-06-23,Yuba,115,75493,6209,6190,133,6323,51
2021-06-22,Alameda,001,1643700,89346,89308,1996,91304,1263
2021-06-22,Alpine,003,1148,88,88,0,88,0
2021-06-22,Amador,005,37829,3754,3743,33,3776,46
2021-06-22,Butte,007,227075,12781,12662,1865,14527,198
2021-06-22,Calaveras,009,45235,2195,2198,14,2212,55
2021-06-22,Colusa,011,21464,1967,1971,321,2292,15
2021-06-22,Contra Costa,013,1133247,70950,70480,1328,71808,813
2021-06-22,Del Norte,015,27424,1455,1417,13,1430,8
2021-06-22,El Dorado,017,186661,10452,10380,755,11135,113
2021-06-22,Fresno,019,978130,103450,102996,8800,111796,1724
2021-06-22,Glenn,021,27897,2450,2435,570,3005,19
2021-06-22,Humboldt,023,135768,4495,4483,43,4526,42
2021-06-22,Imperial,025,180216,28775,28880,2897,31777,740
2021-06-22,Inyo,027,18085,1410,1405,12,1417,35
2021-06-22,Kern,029,883053,97885,97013,11155,108168,1342
2021-06-22,Kings,031,150075,23271,23098,1109,24207,245
2021-06-22,Lake,033,64148,3588,3564,13,3577,45
2021-06-22,Lassen,035,31185,5275,5254,117,5371,20
2021-06-22,Los Angeles,037,10098052,1210192,1206146,42085,1248231,24461
2021-06-22,Madera,039,155013,16781,16652,948,17600,240
2021-06-22,Marin,041,260295,14201,14174,268,14442,230
2021-06-22,Mariposa,043,17540,441,439,11,450,5
2021-06-22,Mendocino,045,87422,4167,4072,81,4153,49
2021-06-22,Merced,047,269075,31276,31267,1003,32270,464
2021-06-22,Modoc,049,8938,415,405,147,552,3
2021-06-22,Mono,051,14174,1264,1277,18,1295,3
2021-06-22,Monterey,053,433212,43347,43162,1887,45049,427
2021-06-22,Napa,055,140530,10020,10029,39,10068,80
2021-06-22,Nevada,057,99092,4964,4923,195,5118,72
2021-06-22,Orange,059,3164182,256490,255452,11530,266982,5114
2021-06-22,Placer,061,380077,23783,23603,1551,25154,299
2021-06-22,Plumas,063,18699,720,697,11,708,4
2021-06-22,Riverside,065,2383286,295540,289839,14174,304013,4456
2021-06-22,Sacramento,067,1510023,108125,107801,1856,109657,1670
2021-06-22,San Benito,069,59416,6096,6098,116,6214,63
2021-06-22,San Bernardino,071,2135413,294597,293770,9070,302840,4873
2021-06-22,San Diego,073,3302833,282757,281867,15310,297177,3771
2021-06-22,San Francisco,075,870044,37077,37287,1312,38599,556
2021-06-22,San Joaquin,077,732212,74018,73723,3669,77392,1405
2021-06-22,San Luis Obispo,079,281455,21569,21321,755,22076,257
2021-06-22,San Mateo,081,765935,42735,42725,483,43208,542
2021-06-22,Santa Barbara,083,443738,34536,34500,1203,35703,454
2021-06-22,Santa Clara,085,1922200,119418,120194,780,120974,2095
2021-06-22,Santa Cruz,087,273765,16318,16218,816,17034,209
2021-06-22,Shasta,089,179085,12600,12616,1640,14256,202
2021-06-22,Sierra,091,2930,62,57,12,69,0
2021-06-22,Siskiyou,093,43540,1962,1892,376,2268,28
2021-06-22,Solano,095,438530,33399,33397,570,33967,267
2021-06-22,Sonoma,097,501317,30885,30933,366,31299,314
2021-06-22,Stanislaus,099,539301,57061,56915,6027,62942,1017
2021-06-22,Sutter,101,95872,9660,9649,90,9739,113
2021-06-22,Tehama,103,63373,5153,5118,595,5713,63
2021-06-22,Trinity,105,12862,491,337,98,435,3
2021-06-22,Tulare,107,460477,50445,49706,9189,58895,850
2021-06-22,Tuolumne,109,53932,4055,4119,41,4160,64
2021-06-22,Ventura,111,848112,81766,81300,3041,84341,1032
2021-06-22,Yolo,113,214977,14158,14157,349,14506,212
2021-06-22,Yuba,115,75493,6205,6181,133,6314,51
2021-06-21,Alameda,001,1643700,89289,89281,1995,91276,1262
2021-06-21,Alpine,003,1148,88,88,0,88,0
2021-06-21,Amador,005,37829,3748,3742,33,3775,46
2021-06-21,Butte,007,227075,12775,12668,1863,14531,195
2021-06-21,Calaveras,009,45235,2193,2194,14,2208,55
2021-06-21,Colusa,011,21464,1966,1970,320,2290,15
2021-06-21,Contra Costa,013,1133247,70879,70439,1326,71765,813
2021-06-21,Del Norte,015,27424,1451,1416,13,1429,8
2021-06-21,El Dorado,017,186661,10446,10375,754,11129,113
2021-06-21,Fresno,019,978130,103430,102971,8797,111768,1724
2021-06-21,Glenn,021,27897,2449,2433,570,3003,19
2021-06-21,Humboldt,023,135768,4486,4478,42,4520,42
2021-06-21,Imperial,025,180216,28771,28855,2896,31751,740
2021-06-21,Inyo,027,18085,1409,1405,12,1417,35
2021-06-21,Kern,029,883053,97856,96995,11146,108141,1342
2021-06-21,Kings,031,150075,23264,23091,1106,24197,245
2021-06-21,Lake,033,64148,3582,3563,13,3576,45
2021-06-21,Lassen,035,31185,5273,5233,117,5350,19
2021-06-21,Los Angeles,037,10098052,1209900,1205994,42064,1248058,24459
2021-06-21,Madera,039,155013,16772,16647,948,17595,240
2021-06-21,Marin,041,260295,14197,14173,268,14441,230
2021-06-21,Mariposa,043,17540,441,439,11,450,5
2021-06-21,Mendocino,045,87422,4164,4085,81,4166,49
2021-06-21,Merced,047,269075,31266,31264,1002,32266,465
2021-06-21,Modoc,049,8938,415,405,147,552,3
2021-06-21,Mono,051,14174,1264,1277,18,1295,3
2021-06-21,Monterey,053,433212,43344,43157,1887,45044,427
2021-06-21,Napa,055,140530,10015,10028,39,10067,80
2021-06-21,Nevada,057,99092,4960,4921,195,5116,72
2021-06-21,Orange,059,3164182,256418,255400,11523,266923,5113
2021-06-21,Placer,061,380077,23759,23577,1551,25128,298
2021-06-21,Plumas,063,18699,718,697,11,708,4
2021-06-21,Riverside,065,2383286,295464,289797,14169,303966,4456
2021-06-21,Sacramento,067,1510023,108013,107757,1855,109612,1669
2021-06-21,San Benito,069,59416,6092,6098,116,6214,63
2021-06-21,San Bernardino,071,2135413,294510,293736,9066,302802,4850
2021-06-21,San Diego,073,3302833,282652,281811,15290,297101,3771
2021-06-21,San Francisco,075,870044,37061,37275,1311,38586,556
2021-06-21,San Joaquin,077,732212,73977,73687,3668,77355,1405
2021-06-21,San Luis Obispo,079,281455,21560,21316,755,22071,257
2021-06-21,San Mateo,081,765935,42719,42685,482,43167,542
2021-06-21,Santa Barbara,083,443738,34531,34492,1203,35695,455
2021-06-21,Santa Clara,085,1922200,119385,120192,779,120971,2093
2021-06-21,Santa Cruz,087,273765,16316,16212,816,17028,208
2021-06-21,Shasta,089,179085,12587,12617,1637,14254,201
2021-06-21,Sierra,091,2930,62,57,12,69,0
2021-06-21,Siskiyou,093,43540,1962,1892,376,2268,27
2021-06-21,Solano,095,438530,33376,33383,569,33952,266
2021-06-21,Sonoma,097,501317,30862,30912,366,31278,314
2021-06-21,Stanislaus,099,539301,57031,56891,6022,62913,1017
2021-06-21,Sutter,101,95872,9657,9649,90,9739,113
2021-06-21,Tehama,103,63373,5153,5115,594,5709,63
2021-06-21,Trinity,105,12862,491,337,98,435,3
2021-06-21,Tulare,107,460477,50434,49689,9185,58874,849
2021-06-21,Tuolumne,109,53932,4051,4119,41,4160,63
2021-06-21,Ventura,111,848112,81738,81291,3037,84328,1031
2021-06-21,Yolo,113,214977,14152,14165,349,14514,212
2021-06-21,Yuba,115,75493,6204,6172,133,6305,51
2021-06-20,Alameda,001,1643700,89224,89255,1994,91249,1263
2021-06-20,Alpine,003,1148,88,88,0,88,0
2021-06-20,Amador,005,37829,3745,3740,33,3773,46
2021-06-20,Butte,007,227075,12768,12668,1862,14530,194
2021-06-20,Calaveras,009,45235,2192,2193,14,2207,55
2021-06-20,Colusa,011,21464,1966,1970,320,2290,15
2021-06-20,Contra Costa,013,1133247,70823,70401,1324,71725,813
2021-06-20,Del Norte,015,27424,1447,1416,13,1429,8
2021-06-20,El Dorado,017,186661,10432,10372,752,11124,113
2021-06-20,Fresno,019,978130,103389,102947,8794,111741,1724
2021-06-20,Glenn,021,27897,2449,2434,570,3004,19
2021-06-20,Humboldt,023,135768,4480,4472,42,4514,42
2021-06-20,Imperial,025,180216,28762,28855,2895,31750,740
2021-06-20,Inyo,027,18085,1408,1405,12,1417,35
2021-06-20,Kern,029,883053,97835,96985,11135,108120,1342
2021-06-20,Kings,031,150075,23259,23088,1104,24192,245
2021-06-20,Lake,033,64148,3580,3563,13,3576,45
2021-06-20,Lassen,035,31185,5270,5230,117,5347,19
2021-06-20,Los Angeles,037,10098052,1209601,1205874,42056,1247930,24456
2021-06-20,Madera,039,155013,16764,16638,946,17584,240
2021-06-20,Marin,041,260295,14194,14166,268,14434,230
2021-06-20,Mariposa,043,17540,439,439,11,450,5
2021-06-20,Mendocino,045,87422,4157,4080,81,4161,49
2021-06-20,Merced,047,269075,31253,31265,1002,32267,465
2021-06-20,Modoc,049,8938,415,405,147,552,3
2021-06-20,Mono,051,14174,1264,1275,18,1293,3
2021-06-20,Monterey,053,433212,43335,43156,1886,45042,427
2021-06-20,Napa,055,140530,10008,10026,38,10064,80
2021-06-20,Nevada,057,99092,4953,4919,195,5114,72
2021-06-20,Orange,059,3164182,256354,255377,11512,266889,5113
2021-06-20,Placer,061,380077,23725,23562,1547,25109,298
2021-06-20,Plumas,063,18699,717,697,11,708,4
2021-06-20,Riverside,065,2383286,295385,289770,14158,303928,4456
2021-06-20,Sacramento,067,1510023,107902,107700,1852,109552,1669
2021-06-20,San Benito,069,59416,6092,6098,116,6214,63
2021-06-20,San Bernardino,071,2135413,294410,293713,9062,302775,4845
2021-06-20,San Diego,073,3302833,282546,281750,15268,297018,3771
2021-06-20,San Francisco,075,870044,37039,37269,1311,38580,556
2021-06-20,San Joaquin,077,732212,73932,73676,3659,77335,1405
2021-06-20,San Luis Obispo,079,281455,21558,21313,755,22068,257
2021-06-20,San Mateo,081,765935,42689,42681,482,43163,542
2021-06-20,Santa Barbara,083,443738,34522,34487,1203,35690,455
2021-06-20,Santa Clara,085,1922200,119350,120163,779,120942,2093
2021-06-20,Santa Cruz,087,273765,16311,16210,816,17026,208
2021-06-20,Shasta,089,179085,12582,12617,1635,14252,201
2021-06-20,Sierra,091,2930,62,57,12,69,0
2021-06-20,Siskiyou,093,43540,1961,1891,376,2267,27
2021-06-20,Solano,095,438530,33354,33361,567,33928,266
2021-06-20,Sonoma,097,501317,30815,30884,363,31247,314
2021-06-20,Stanislaus,099,539301,57000,56868,6021,62889,1017
2021-06-20,Sutter,101,95872,9654,9645,90,9735,113
2021-06-20,Tehama,103,63373,5149,5115,594,5709,63
2021-06-20,Trinity,105,12862,491,337,98,435,3
2021-06-20,Tulare,107,460477,50425,49685,9183,58868,849
2021-06-20,Tuolumne,109,53932,4048,4117,41,4158,63
2021-06-20,Ventura,111,848112,81722,81282,3035,84317,1031
2021-06-20,Yolo,113,214977,14145,14160,349,14509,212
2021-06-20,Yuba,115,75493,6197,6167,133,6300,51
2021-06-19,Alameda,001,1643700,89189,89202,1994,91196,1263
2021-06-19,Alpine,003,1148,88,88,0,88,0
2021-06-19,Amador,005,37829,3743,3739,33,3772,46
2021-06-19,Butte,007,227075,12764,12659,1862,14521,194
2021-06-19,Calaveras,009,45235,2192,2192,14,2206,55
2021-06-19,Colusa,011,21464,1966,1969,320,2289,15
2021-06-19,Contra Costa,013,1133247,70792,70334,1323,71657,813
2021-06-19,Del Norte,015,27424,1446,1416,13,1429,8
2021-06-19,El Dorado,017,186661,10431,10363,751,11114,113
2021-06-19,Fresno,019,978130,103376,102922,8791,111713,1724
2021-06-19,Glenn,021,27897,2448,2434,569,3003,19
2021-06-19,Humboldt,023,135768,4469,4463,42,4505,42
2021-06-19,Imperial,025,180216,28761,28813,2895,31708,740
2021-06-19,Inyo,027,18085,1408,1405,12,1417,35
2021-06-19,Kern,029,883053,97819,96966,11131,108097,1342
2021-06-19,Kings,031,150075,23256,23086,1104,24190,245
2021-06-19,Lake,033,64148,3576,3563,13,3576,45
2021-06-19,Lassen,035,31185,5269,5225,117,5342,19
2021-06-19,Los Angeles,037,10098052,1209401,1205602,42041,1247643,24454
2021-06-19,Madera,039,155013,16762,16632,946,17578,240
2021-06-19,Marin,041,260295,14186,14152,268,14420,230
2021-06-19,Mariposa,043,17540,439,439,11,450,5
2021-06-19,Mendocino,045,87422,4151,4077,81,4158,49
2021-06-19,Merced,047,269075,31251,31256,1002,32258,465
2021-06-19,Modoc,049,8938,414,402,147,549,3
2021-06-19,Mono,051,14174,1264,1275,18,1293,3
2021-06-19,Monterey,053,433212,43329,43153,1886,45039,427
2021-06-19,Napa,055,140530,10004,10025,38,10063,80
2021-06-19,Nevada,057,99092,4948,4910,195,5105,72
2021-06-19,Orange,059,3164182,256307,255329,11509,266838,5112
2021-06-19,Placer,061,380077,23709,23537,1544,25081,298
2021-06-19,Plumas,063,18699,716,697,11,708,4
2021-06-19,Riverside,065,2383286,295339,289720,14158,303878,4456
2021-06-19,Sacramento,067,1510023,107856,107631,1849,109480,1669
2021-06-19,San Benito,069,59416,6091,6098,116,6214,63
2021-06-19,San Bernardino,071,2135413,294366,293673,9059,302732,4844
2021-06-19,San Diego,073,3302833,282486,281682,15254,296936,3771
2021-06-19,San Francisco,075,870044,37026,37256,1311,38567,556
2021-06-19,San Joaquin,077,732212,73916,73652,3655,77307,1405
2021-06-19,San Luis Obispo,079,281455,21556,21308,755,22063,257
2021-06-19,San Mateo,081,765935,42671,42646,480,43126,542
2021-06-19,Santa Barbara,083,443738,34520,34472,1203,35675,455
2021-06-19,Santa Clara,085,1922200,119327,120110,778,120888,2093
2021-06-19,Santa Cruz,087,273765,16306,16206,816,17022,208
2021-06-19,Shasta,089,179085,12580,12615,1634,14249,201
2021-06-19,Sierra,091,2930,62,57,12,69,0
2021-06-19,Siskiyou,093,43540,1961,1891,375,2266,27
2021-06-19,Solano,095,438530,33344,33341,566,33907,266
2021-06-19,Sonoma,097,501317,30774,30841,362,31203,314
2021-06-19,Stanislaus,099,539301,56981,56847,6018,62865,1017
2021-06-19,Sutter,101,95872,9651,9645,90,9735,113
2021-06-19,Tehama,103,63373,5148,5115,594,5709,63
2021-06-19,Trinity,105,12862,491,337,98,435,3
2021-06-19,Tulare,107,460477,50418,49681,9178,58859,849
2021-06-19,Tuolumne,109,53932,4048,4117,41,4158,63
2021-06-19,Ventura,111,848112,81709,81270,3034,84304,1031
2021-06-19,Yolo,113,214977,14141,14156,348,14504,212
2021-06-19,Yuba,115,75493,6196,6157,133,6290,51
2021-06-18,Alameda,001,1643700,89152,89123,1994,91117,1263
2021-06-18,Alpine,003,1148,88,88,0,88,0
2021-06-18,Amador,005,37829,3743,3739,33,3772,46
2021-06-18,Butte,007,227075,12761,12653,1859,14512,194
2021-06-18,Calaveras,009,45235,2192,2191,14,2205,55
2021-06-18,Colusa,011,21464,1965,1969,320,2289,15
2021-06-18,Contra Costa,013,1133247,70750,70271,1321,71592,813
2021-06-18,Del Norte,015,27424,1446,1415,13,1428,8
2021-06-18,El Dorado,017,186661,10428,10348,749,11097,113
2021-06-18,Fresno,019,978130,103360,102894,8789,111683,1722
2021-06-18,Glenn,021,27897,2447,2430,569,2999,19
2021-06-18,Humboldt,023,135768,4461,4450,42,4492,42
2021-06-18,Imperial,025,180216,28759,28809,2895,31704,740
2021-06-18,Inyo,027,18085,1408,1405,12,1417,35
2021-06-18,Kern,029,883053,97808,96948,11125,108073,1341
2021-06-18,Kings,031,150075,23251,23082,1104,24186,245
2021-06-18,Lake,033,64148,3572,3563,13,3576,45
2021-06-18,Lassen,035,31185,5268,5224,117,5341,19
2021-06-18,Los Angeles,037,10098052,1209244,1205472,42024,1247496,24451
2021-06-18,Madera,039,155013,16756,16625,946,17571,241
2021-06-18,Marin,041,260295,14183,14147,268,14415,230
2021-06-18,Mariposa,043,17540,439,439,11,450,5
2021-06-18,Mendocino,045,87422,4146,4068,81,4149,49
2021-06-18,Merced,047,269075,31249,31262,1002,32264,464
2021-06-18,Modoc,049,8938,414,402,147,549,3
2021-06-18,Mono,051,14174,1263,1275,17,1292,3
2021-06-18,Monterey,053,433212,43326,43148,1886,45034,427
2021-06-18,Napa,055,140530,10000,10021,38,10059,80
2021-06-18,Nevada,057,99092,4940,4903,195,5098,72
2021-06-18,Orange,059,3164182,256270,255274,11506,266780,5108
2021-06-18,Placer,061,380077,23701,23500,1541,25041,298
2021-06-18,Plumas,063,18699,716,697,11,708,4
2021-06-18,Riverside,065,2383286,295291,289676,14157,303833,4457
2021-06-18,Sacramento,067,1510023,107808,107570,1849,109419,1669
2021-06-18,San Benito,069,59416,6090,6097,116,6213,63
2021-06-18,San Bernardino,071,2135413,294321,293629,9055,302684,4826
2021-06-18,San Diego,073,3302833,282410,281608,15243,296851,3771
2021-06-18,San Francisco,075,870044,37017,37246,1311,38557,556
2021-06-18,San Joaquin,077,732212,73898,73623,3653,77276,1403
2021-06-18,San Luis Obispo,079,281455,21552,21301,754,22055,257
2021-06-18,San Mateo,081,765935,42660,42630,479,43109,542
2021-06-18,Santa Barbara,083,443738,34510,34469,1203,35672,455
2021-06-18,Santa Clara,085,1922200,119306,120081,777,120858,2093
2021-06-18,Santa Cruz,087,273765,16302,16202,816,17018,208
2021-06-18,Shasta,089,179085,12576,12607,1632,14239,201
2021-06-18,Sierra,091,2930,61,57,12,69,0
2021-06-18,Siskiyou,093,43540,1961,1890,375,2265,27
2021-06-18,Solano,095,438530,33330,33323,566,33889,266
2021-06-18,Sonoma,097,501317,30756,30816,361,31177,313
2021-06-18,Stanislaus,099,539301,56966,56803,6016,62819,1012
2021-06-18,Sutter,101,95872,9648,9643,90,9733,113
2021-06-18,Tehama,103,63373,5146,5114,594,5708,63
2021-06-18,Trinity,105,12862,491,337,97,434,3
2021-06-18,Tulare,107,460477,50416,49664,9171,58835,849
2021-06-18,Tuolumne,109,53932,4046,4116,41,4157,63
2021-06-18,Ventura,111,848112,81699,81256,3029,84285,1031
2021-06-18,Yolo,113,214977,14138,14148,346,14494,212
2021-06-18,Yuba,115,75493,6190,6150,133,6283,51
2021-06-17,Alameda,001,1643700,89105,89087,1994,91081,1262
2021-06-17,Alpine,003,1148,88,88,0,88,0
2021-06-17,Amador,005,37829,3741,3731,33,3764,46
2021-06-17,Butte,007,227075,12751,12644,1858,14502,194
2021-06-17,Calaveras,009,45235,2191,2189,14,2203,55
2021-06-17,Colusa,011,21464,1964,1969,320,2289,15
2021-06-17,Contra Costa,013,1133247,70711,70190,1317,71507,810
2021-06-17,Del Norte,015,27424,1444,1413,13,1426,8
2021-06-17,El Dorado,017,186661,10418,10341,749,11090,113
2021-06-17,Fresno,019,978130,103334,102867,8785,111652,1722
2021-06-17,Glenn,021,27897,2447,2430,569,2999,19
2021-06-17,Humboldt,023,135768,4452,4438,42,4480,42
2021-06-17,Imperial,025,180216,28751,28801,2895,31696,741
2021-06-17,Inyo,027,18085,1408,1405,12,1417,35
2021-06-17,Kern,029,883053,97793,96840,11119,107959,1340
2021-06-17,Kings,031,150075,23247,23078,1103,24181,245
2021-06-17,Lake,033,64148,3569,3563,9,3572,45
2021-06-17,Lassen,035,31185,5264,5223,117,5340,19
2021-06-17,Los Angeles,037,10098052,1209032,1205301,41995,1247296,24444
2021-06-17,Madera,039,155013,16751,16618,946,17564,241
2021-06-17,Marin,041,260295,14183,14141,268,14409,229
2021-06-17,Mariposa,043,17540,439,439,11,450,5
2021-06-17,Mendocino,045,87422,4139,4054,81,4135,49
2021-06-17,Merced,047,269075,31244,31262,1002,32264,464
2021-06-17,Modoc,049,8938,413,401,147,548,3
2021-06-17,Mono,051,14174,1262,1275,17,1292,3
2021-06-17,Monterey,053,433212,43318,43140,1886,45026,416
2021-06-17,Napa,055,140530,10000,10014,38,10052,80
2021-06-17,Nevada,057,99092,4936,4898,195,5093,72
2021-06-17,Orange,059,3164182,256224,255240,11495,266735,5109
2021-06-17,Placer,061,380077,23685,23461,1539,25000,298
2021-06-17,Plumas,063,18699,715,697,11,708,4
2021-06-17,Riverside,065,2383286,295237,289627,14155,303782,4458
2021-06-17,Sacramento,067,1510023,107744,107492,1847,109339,1666
2021-06-17,San Benito,069,59416,6090,6097,116,6213,63
2021-06-17,San Bernardino,071,2135413,294280,293560,9055,302615,4811
2021-06-17,San Diego,073,3302833,282334,281531,15229,296760,3771
2021-06-17,San Francisco,075,870044,37006,37243,1310,38553,556
2021-06-17,San Joaquin,077,732212,73875,73560,3648,77208,1403
2021-06-17,San Luis Obispo,079,281455,21550,21297,754,22051,257
2021-06-17,San Mateo,081,765935,42654,42615,479,43094,542
2021-06-17,Santa Barbara,083,443738,34504,34466,1203,35669,453
2021-06-17,Santa Clara,085,1922200,119281,120032,776,120808,2093
2021-06-17,Santa Cruz,087,273765,16298,16197,816,17013,208
2021-06-17,Shasta,089,179085,12568,12597,1632,14229,201
2021-06-17,Sierra,091,2930,61,56,12,68,0
2021-06-17,Siskiyou,093,43540,1960,1889,375,2264,27
2021-06-17,Solano,095,438530,33309,33296,565,33861,266
2021-06-17,Sonoma,097,501317,30725,30793,361,31154,323
2021-06-17,Stanislaus,099,539301,56935,56752,6011,62763,1012
2021-06-17,Sutter,101,95872,9645,9629,90,9719,113
2021-06-17,Tehama,103,63373,5145,5112,592,5704,63
2021-06-17,Trinity,105,12862,490,337,97,434,3
2021-06-17,Tulare,107,460477,50411,49649,9163,58812,849
2021-06-17,Tuolumne,109,53932,4045,4116,41,4157,63
2021-06-17,Ventura,111,848112,81690,81248,3026,84274,1030
2021-06-17,Yolo,113,214977,14130,14141,346,14487,212
2021-06-17,Yuba,115,75493,6181,6140,133,6273,51
2021-06-16,Alameda,001,1643700,89056,89045,1993,91038,1265
2021-06-16,Alpine,003,1148,88,88,0,88,0
2021-06-16,Amador,005,37829,3740,3730,33,3763,46
2021-06-16,Butte,007,227075,12749,12635,1856,14491,194
2021-06-16,Calaveras,009,45235,2189,2188,14,2202,55
2021-06-16,Colusa,011,21464,1964,1967,320,2287,15
2021-06-16,Contra Costa,013,1133247,70659,70136,1316,71452,810
2021-06-16,Del Norte,015,27424,1441,1413,13,1426,8
2021-06-16,El Dorado,017,186661,10412,10334,748,11082,113
2021-06-16,Fresno,019,978130,103304,102842,8781,111623,1722
2021-06-16,Glenn,021,27897,2447,2430,569,2999,19
2021-06-16,Humboldt,023,135768,4443,4427,41,4468,42
2021-06-16,Imperial,025,180216,28748,28796,2895,31691,741
2021-06-16,Inyo,027,18085,1407,1405,12,1417,35
2021-06-16,Kern,029,883053,97771,96789,11112,107901,1339
2021-06-16,Kings,031,150075,23246,23072,1102,24174,245
2021-06-16,Lake,033,64148,3569,3562,9,3571,45
2021-06-16,Lassen,035,31185,5261,5216,117,5333,19
2021-06-16,Los Angeles,037,10098052,1208809,1205102,41984,1247086,24439
2021-06-16,Madera,039,155013,16747,16603,946,17549,240
2021-06-16,Marin,041,260295,14181,14137,268,14405,229
2021-06-16,Mariposa,043,17540,439,437,11,448,5
2021-06-16,Mendocino,045,87422,4131,4041,81,4122,49
2021-06-16,Merced,047,269075,31236,31250,1002,32252,463
2021-06-16,Modoc,049,8938,412,383,146,529,3
2021-06-16,Mono,051,14174,1262,1275,17,1292,3
2021-06-16,Monterey,053,433212,43315,43122,1886,45008,416
2021-06-16,Napa,055,140530,9996,10011,38,10049,80
2021-06-16,Nevada,057,99092,4931,4894,195,5089,72
2021-06-16,Orange,059,3164182,256171,255188,11488,266676,5109
2021-06-16,Placer,061,380077,23675,23425,1535,24960,298
2021-06-16,Plumas,063,18699,715,697,11,708,4
2021-06-16,Riverside,065,2383286,295176,289539,14153,303692,4457
2021-06-16,Sacramento,067,1510023,107674,107422,1843,109265,1665
2021-06-16,San Benito,069,59416,6090,6090,116,6206,63
2021-06-16,San Bernardino,071,2135413,294231,293499,9053,302552,4797
2021-06-16,San Diego,073,3302833,282255,281423,15216,296639,3770
2021-06-16,San Francisco,075,870044,36993,37222,1308,38530,555
2021-06-16,San Joaquin,077,732212,73838,73530,3644,77174,1399
2021-06-16,San Luis Obispo,079,281455,21545,21294,754,22048,257
2021-06-16,San Mateo,081,765935,42638,42601,479,43080,542
2021-06-16,Santa Barbara,083,443738,34498,34459,1203,35662,460
2021-06-16,Santa Clara,085,1922200,119249,119982,776,120758,2087
2021-06-16,Santa Cruz,087,273765,16295,16187,816,17003,208
2021-06-16,Shasta,089,179085,12563,12592,1631,14223,200
2021-06-16,Sierra,091,2930,61,56,12,68,0
2021-06-16,Siskiyou,093,43540,1959,1886,375,2261,26
2021-06-16,Solano,095,438530,33281,33276,565,33841,266
2021-06-16,Sonoma,097,501317,30689,30741,361,31102,323
2021-06-16,Stanislaus,099,539301,56904,56738,6009,62747,984
2021-06-16,Sutter,101,95872,9641,9620,90,9710,113
2021-06-16,Tehama,103,63373,5143,5106,592,5698,63
2021-06-16,Trinity,105,12862,489,332,97,429,3
2021-06-16,Tulare,107,460477,50406,49578,9159,58737,849
2021-06-16,Tuolumne,109,53932,4045,4110,41,4151,63
2021-06-16,Ventura,111,848112,81676,81229,3024,84253,1029
2021-06-16,Yolo,113,214977,14121,14135,345,14480,212
2021-06-16,Yuba,115,75493,6171,6134,133,6267,51
2021-06-15,Alameda,001,1643700,89013,89008,1993,91001,1262
2021-06-15,Alpine,003,1148,88,88,0,88,0
2021-06-15,Amador,005,37829,3737,3723,33,3756,46
2021-06-15,Butte,007,227075,12741,12620,1855,14475,194
2021-06-15,Calaveras,009,45235,2188,2188,14,2202,55
2021-06-15,Colusa,011,21464,1964,1967,318,2285,15
2021-06-15,Contra Costa,013,1133247,70597,70101,1316,71417,810
2021-06-15,Del Norte,015,27424,1440,1411,13,1424,8
2021-06-15,El Dorado,017,186661,10403,10330,748,11078,113
2021-06-15,Fresno,019,978130,103273,102828,8780,111608,1722
2021-06-15,Glenn,021,27897,2446,2426,569,2995,19
2021-06-15,Humboldt,023,135768,4434,4414,40,4454,42
2021-06-15,Imperial,025,180216,28742,28789,2895,31684,741
2021-06-15,Inyo,027,18085,1407,1405,12,1417,35
2021-06-15,Kern,029,883053,97743,96782,11104,107886,1338
2021-06-15,Kings,031,150075,23240,23070,1100,24170,245
2021-06-15,Lake,033,64148,3568,3559,9,3568,45
2021-06-15,Lassen,035,31185,5260,5211,117,5328,19
2021-06-15,Los Angeles,037,10098052,1208577,1204926,41976,1246902,24435
2021-06-15,Madera,039,155013,16740,16600,945,17545,240
2021-06-15,Marin,041,260295,14173,14135,268,14403,229
2021-06-15,Mariposa,043,17540,439,437,11,448,5
2021-06-15,Mendocino,045,87422,4124,4034,81,4115,49
2021-06-15,Merced,047,269075,31230,31244,1002,32246,461
2021-06-15,Modoc,049,8938,411,383,146,529,3
2021-06-15,Mono,051,14174,1262,1275,17,1292,3
2021-06-15,Monterey,053,433212,43309,43118,1886,45004,416
2021-06-15,Napa,055,140530,9994,10010,38,10048,80
2021-06-15,Nevada,057,99092,4928,4888,195,5083,72
2021-06-15,Orange,059,3164182,256130,255127,11479,266606,5105
2021-06-15,Placer,061,380077,23653,23396,1534,24930,298
2021-06-15,Plumas,063,18699,714,697,11,708,4
2021-06-15,Riverside,065,2383286,295116,289508,14149,303657,4455
2021-06-15,Sacramento,067,1510023,107599,107370,1837,109207,1662
2021-06-15,San Benito,069,59416,6089,6089,116,6205,63
2021-06-15,San Bernardino,071,2135413,294181,293463,9047,302510,4790
2021-06-15,San Diego,073,3302833,282171,281375,15201,296576,3770
2021-06-15,San Francisco,075,870044,36984,37210,1307,38517,555
2021-06-15,San Joaquin,077,732212,73798,73494,3639,77133,1399
2021-06-15,San Luis Obispo,079,281455,21540,21293,753,22046,257
2021-06-15,San Mateo,081,765935,42624,42593,479,43072,543
2021-06-15,Santa Barbara,083,443738,34493,34451,1203,35654,460
2021-06-15,Santa Clara,085,1922200,119211,119963,776,120739,2086
2021-06-15,Santa Cruz,087,273765,16288,16180,815,16995,208
2021-06-15,Shasta,089,179085,12557,12583,1631,14214,201
2021-06-15,Sierra,091,2930,60,55,12,67,0
2021-06-15,Siskiyou,093,43540,1958,1887,375,2262,26
2021-06-15,Solano,095,438530,33262,33264,565,33829,266
2021-06-15,Sonoma,097,501317,30650,30707,360,31067,323
2021-06-15,Stanislaus,099,539301,56876,56724,6006,62730,979
2021-06-15,Sutter,101,95872,9632,9616,90,9706,113
2021-06-15,Tehama,103,63373,5141,5102,592,5694,63
2021-06-15,Trinity,105,12862,488,332,97,429,3
2021-06-15,Tulare,107,460477,50399,49561,9156,58717,848
2021-06-15,Tuolumne,109,53932,4045,4111,41,4152,63
2021-06-15,Ventura,111,848112,81665,81215,3021,84236,1029
2021-06-15,Yolo,113,214977,14117,14127,343,14470,212
2021-06-15,Yuba,115,75493,6160,6130,133,6263,51
2021-06-14,Alameda,001,1643700,88964,88966,1993,90959,1264
2021-06-14,Alpine,003,1148,88,88,0,88,0
2021-06-14,Amador,005,37829,3736,3722,33,3755,46
2021-06-14,Butte,007,227075,12730,12613,1851,14464,194
2021-06-14,Calaveras,009,45235,2187,2190,14,2204,55
2021-06-14,Colusa,011,21464,1963,1966,318,2284,15
2021-06-14,Contra Costa,013,1133247,70544,70069,1314,71383,810
2021-06-14,Del Norte,015,27424,1440,1411,13,1424,8
2021-06-14,El Dorado,017,186661,10394,10327,747,11074,113
2021-06-14,Fresno,019,978130,103251,102812,8778,111590,1719
2021-06-14,Glenn,021,27897,2446,2426,569,2995,19
2021-06-14,Humboldt,023,135768,4426,4407,39,4446,42
2021-06-14,Imperial,025,180216,28730,28836,2895,31731,741
2021-06-14,Inyo,027,18085,1406,1405,12,1417,35
2021-06-14,Kern,029,883053,97723,96760,11094,107854,1337
2021-06-14,Kings,031,150075,23237,23071,1099,24170,245
2021-06-14,Lake,033,64148,3567,3557,9,3566,45
2021-06-14,Lassen,035,31185,5257,5209,116,5325,19
2021-06-14,Los Angeles,037,10098052,1208342,1204748,41966,1246714,24434
2021-06-14,Madera,039,155013,16734,16597,944,17541,240
2021-06-14,Marin,041,260295,14171,14133,268,14401,229
2021-06-14,Mariposa,043,17540,438,437,11,448,5
2021-06-14,Mendocino,045,87422,4118,4028,81,4109,49
2021-06-14,Merced,047,269075,31221,31241,1001,32242,461
2021-06-14,Modoc,049,8938,402,382,144,526,3
2021-06-14,Mono,051,14174,1262,1275,17,1292,3
2021-06-14,Monterey,053,433212,43306,43110,1886,44996,415
2021-06-14,Napa,055,140530,9990,10000,38,10038,80
2021-06-14,Nevada,057,99092,4921,4885,195,5080,72
2021-06-14,Orange,059,3164182,256092,255069,11475,266544,5103
2021-06-14,Placer,061,380077,23628,23379,1533,24912,298
2021-06-14,Plumas,063,18699,714,696,11,707,4
2021-06-14,Riverside,065,2383286,295062,289476,14149,303625,4453
2021-06-14,Sacramento,067,1510023,107545,107334,1832,109166,1661
2021-06-14,San Benito,069,59416,6089,6087,116,6203,63
2021-06-14,San Bernardino,071,2135413,294125,293446,9043,302489,4790
2021-06-14,San Diego,073,3302833,282065,281314,15181,296495,3770
2021-06-14,San Francisco,075,870044,36971,37206,1307,38513,555
2021-06-14,San Joaquin,077,732212,73769,73453,3639,77092,1398
2021-06-14,San Luis Obispo,079,281455,21538,21302,753,22055,256
2021-06-14,San Mateo,081,765935,42611,42619,478,43097,543
2021-06-14,Santa Barbara,083,443738,34490,34449,1203,35652,460
2021-06-14,Santa Clara,085,1922200,119180,119957,775,120732,2085
2021-06-14,Santa Cruz,087,273765,16286,16175,815,16990,208
2021-06-14,Shasta,089,179085,12546,12561,1628,14189,201
2021-06-14,Sierra,091,2930,59,55,12,67,0
2021-06-14,Siskiyou,093,43540,1958,1886,375,2261,26
2021-06-14,Solano,095,438530,33245,33243,564,33807,266
2021-06-14,Sonoma,097,501317,30618,30679,359,31038,323
2021-06-14,Stanislaus,099,539301,56840,56689,6003,62692,975
2021-06-14,Sutter,101,95872,9629,9607,90,9697,112
2021-06-14,Tehama,103,63373,5139,5102,592,5694,63
2021-06-14,Trinity,105,12862,488,332,97,429,3
2021-06-14,Tulare,107,460477,50394,49538,9153,58691,848
2021-06-14,Tuolumne,109,53932,4042,4108,41,4149,63
2021-06-14,Ventura,111,848112,81655,81209,3021,84230,1028
2021-06-14,Yolo,113,214977,14109,14123,343,14466,212
2021-06-14,Yuba,115,75493,6153,6127,133,6260,50
2021-06-13,Alameda,001,1643700,88907,88947,1992,90939,1264
2021-06-13,Alpine,003,1148,87,88,0,88,0
2021-06-13,Amador,005,37829,3732,3721,33,3754,46
2021-06-13,Butte,007,227075,12719,12586,1848,14434,194
2021-06-13,Calaveras,009,45235,2187,2189,14,2203,55
2021-06-13,Colusa,011,21464,1963,1965,317,2282,15
2021-06-13,Contra Costa,013,1133247,70490,70040,1312,71352,810
2021-06-13,Del Norte,015,27424,1438,1412,13,1425,8
2021-06-13,El Dorado,017,186661,10385,10324,747,11071,113
2021-06-13,Fresno,019,978130,103219,102795,8773,111568,1719
2021-06-13,Glenn,021,27897,2445,2425,567,2992,19
2021-06-13,Humboldt,023,135768,4413,4401,39,4440,42
2021-06-13,Imperial,025,180216,28721,28800,2894,31694,741
2021-06-13,Inyo,027,18085,1406,1405,12,1417,35
2021-06-13,Kern,029,883053,97699,96743,11082,107825,1337
2021-06-13,Kings,031,150075,23232,23069,1098,24167,245
2021-06-13,Lake,033,64148,3567,3556,9,3565,45
2021-06-13,Lassen,035,31185,5252,5209,116,5325,19
2021-06-13,Los Angeles,037,10098052,1208079,1204614,41953,1246567,24433
2021-06-13,Madera,039,155013,16720,16590,944,17534,240
2021-06-13,Marin,041,260295,14165,14126,268,14394,229
2021-06-13,Mariposa,043,17540,438,434,11,445,5
2021-06-13,Mendocino,045,87422,4111,4026,81,4107,49
2021-06-13,Merced,047,269075,31215,31240,1000,32240,461
2021-06-13,Modoc,049,8938,400,382,142,524,3
2021-06-13,Mono,051,14174,1262,1275,17,1292,3
2021-06-13,Monterey,053,433212,43298,43108,1886,44994,415
2021-06-13,Napa,055,140530,9984,9995,38,10033,80
2021-06-13,Nevada,057,99092,4916,4883,195,5078,72
2021-06-13,Orange,059,3164182,256037,255043,11473,266516,5103
2021-06-13,Placer,061,380077,23602,23365,1531,24896,295
2021-06-13,Plumas,063,18699,713,696,11,707,4
2021-06-13,Riverside,065,2383286,294995,289447,14146,303593,4453
2021-06-13,Sacramento,067,1510023,107469,107289,1829,109118,1658
2021-06-13,San Benito,069,59416,6089,6086,116,6202,63
2021-06-13,San Bernardino,071,2135413,294074,293416,9038,302454,4788
2021-06-13,San Diego,073,3302833,281986,281268,15165,296433,3770
2021-06-13,San Francisco,075,870044,36958,37197,1307,38504,555
2021-06-13,San Joaquin,077,732212,73735,73438,3637,77075,1398
2021-06-13,San Luis Obispo,079,281455,21532,21298,752,22050,256
2021-06-13,San Mateo,081,765935,42598,42611,478,43089,542
2021-06-13,Santa Barbara,083,443738,34479,34449,1202,35651,460
2021-06-13,Santa Clara,085,1922200,119156,119946,775,120721,2085
2021-06-13,Santa Cruz,087,273765,16279,16172,815,16987,208
2021-06-13,Shasta,089,179085,12537,12560,1627,14187,201
2021-06-13,Sierra,091,2930,59,55,12,67,0
2021-06-13,Siskiyou,093,43540,1957,1885,375,2260,26
2021-06-13,Solano,095,438530,33224,33234,564,33798,266
2021-06-13,Sonoma,097,501317,30583,30663,357,31020,323
2021-06-13,Stanislaus,099,539301,56813,56671,6002,62673,975
2021-06-13,Sutter,101,95872,9622,9603,90,9693,112
2021-06-13,Tehama,103,63373,5137,5100,592,5692,63
2021-06-13,Trinity,105,12862,487,332,97,429,3
2021-06-13,Tulare,107,460477,50385,49537,9148,58685,848
2021-06-13,Tuolumne,109,53932,4040,4107,40,4147,63
2021-06-13,Ventura,111,848112,81641,81201,3021,84222,1028
2021-06-13,Yolo,113,214977,14101,14120,341,14461,212
2021-06-13,Yuba,115,75493,6146,6125,133,6258,50
2021-06-12,Alameda,001,1643700,88880,88901,1992,90893,1271
2021-06-12,Alpine,003,1148,87,88,0,88,0
2021-06-12,Amador,005,37829,3731,3721,33,3754,46
2021-06-12,Butte,007,227075,12715,12576,1848,14424,194
2021-06-12,Calaveras,009,45235,2187,2189,14,2203,55
2021-06-12,Colusa,011,21464,1963,1965,317,2282,15
2021-06-12,Contra Costa,013,1133247,70459,69989,1309,71298,810
2021-06-12,Del Norte,015,27424,1438,1412,13,1425,8
2021-06-12,El Dorado,017,186661,10380,10320,746,11066,113
2021-06-12,Fresno,019,978130,103209,102783,8772,111555,1720
2021-06-12,Glenn,021,27897,2443,2425,567,2992,19
2021-06-12,Humboldt,023,135768,4405,4396,39,4435,42
2021-06-12,Imperial,025,180216,28718,28799,2894,31693,741
2021-06-12,Inyo,027,18085,1406,1405,12,1417,35
2021-06-12,Kern,029,883053,97684,96731,11078,107809,1337
2021-06-12,Kings,031,150075,23230,23067,1098,24165,245
2021-06-12,Lake,033,64148,3566,3552,9,3561,45
2021-06-12,Lassen,035,31185,5252,5208,116,5324,19
2021-06-12,Los Angeles,037,10098052,1207942,1204439,41946,1246385,24434
2021-06-12,Madera,039,155013,16716,16586,944,17530,240
2021-06-12,Marin,041,260295,14162,14121,268,14389,229
2021-06-12,Mariposa,043,17540,438,434,11,445,5
2021-06-12,Mendocino,045,87422,4108,4024,81,4105,49
2021-06-12,Merced,047,269075,31212,31236,1000,32236,461
2021-06-12,Modoc,049,8938,399,382,142,524,3
2021-06-12,Mono,051,14174,1262,1275,17,1292,3
2021-06-12,Monterey,053,433212,43292,43103,1886,44989,415
2021-06-12,Napa,055,140530,9980,9986,38,10024,80
2021-06-12,Nevada,057,99092,4910,4878,195,5073,72
2021-06-12,Orange,059,3164182,256004,255004,11471,266475,5103
2021-06-12,Placer,061,380077,23583,23345,1531,24876,295
2021-06-12,Plumas,063,18699,713,696,11,707,4
2021-06-12,Riverside,065,2383286,294953,289413,14143,303556,4453
2021-06-12,Sacramento,067,1510023,107409,107199,1826,109025,1658
2021-06-12,San Benito,069,59416,6087,6083,116,6199,63
2021-06-12,San Bernardino,071,2135413,294040,293375,9036,302411,4788
2021-06-12,San Diego,073,3302833,281929,281203,15156,296359,3770
2021-06-12,San Francisco,075,870044,36948,37189,1307,38496,555
2021-06-12,San Joaquin,077,732212,73716,73413,3636,77049,1398
2021-06-12,San Luis Obispo,079,281455,21529,21293,752,22045,256
2021-06-12,San Mateo,081,765935,42593,42604,478,43082,542
2021-06-12,Santa Barbara,083,443738,34474,34450,1202,35652,460
2021-06-12,Santa Clara,085,1922200,119116,119894,775,120669,2085
2021-06-12,Santa Cruz,087,273765,16271,16170,815,16985,208
2021-06-12,Shasta,089,179085,12534,12556,1626,14182,201
2021-06-12,Sierra,091,2930,59,55,12,67,0
2021-06-12,Siskiyou,093,43540,1956,1884,375,2259,25
2021-06-12,Solano,095,438530,33215,33219,564,33783,266
2021-06-12,Sonoma,097,501317,30554,30647,357,31004,323
2021-06-12,Stanislaus,099,539301,56796,56649,6001,62650,974
2021-06-12,Sutter,101,95872,9618,9603,90,9693,112
2021-06-12,Tehama,103,63373,5137,5099,591,5690,63
2021-06-12,Trinity,105,12862,487,332,97,429,3
2021-06-12,Tulare,107,460477,50380,49533,9141,58674,848
2021-06-12,Tuolumne,109,53932,4039,4105,40,4145,63
2021-06-12,Ventura,111,848112,81629,81197,3021,84218,1028
2021-06-12,Yolo,113,214977,14098,14118,339,14457,212
2021-06-12,Yuba,115,75493,6141,6120,133,6253,50
2021-06-11,Alameda,001,1643700,88852,88844,1992,90836,1278
2021-06-11,Alpine,003,1148,87,88,0,88,0
2021-06-11,Amador,005,37829,3731,3710,33,3743,46
2021-06-11,Butte,007,227075,12711,12576,1846,14422,194
2021-06-11,Calaveras,009,45235,2187,2188,14,2202,55
2021-06-11,Colusa,011,21464,1962,1964,317,2281,15
2021-06-11,Contra Costa,013,1133247,70426,69940,1307,71247,808
2021-06-11,Del Norte,015,27424,1438,1409,13,1422,8
2021-06-11,El Dorado,017,186661,10377,10316,746,11062,113
2021-06-11,Fresno,019,978130,103191,102770,8771,111541,1720
2021-06-11,Glenn,021,27897,2443,2425,567,2992,19
2021-06-11,Humboldt,023,135768,4401,4389,39,4428,42
2021-06-11,Imperial,025,180216,28713,28793,2894,31687,741
2021-06-11,Inyo,027,18085,1406,1405,12,1417,35
2021-06-11,Kern,029,883053,97672,96718,11074,107792,1340
2021-06-11,Kings,031,150075,23226,23069,1097,24166,245
2021-06-11,Lake,033,64148,3565,3550,9,3559,45
2021-06-11,Lassen,035,31185,5251,5204,116,5320,18
2021-06-11,Los Angeles,037,10098052,1207795,1204259,41932,1246191,24434
2021-06-11,Madera,039,155013,16713,16582,944,17526,240
2021-06-11,Marin,041,260295,14159,14116,268,14384,229
2021-06-11,Mariposa,043,17540,438,434,11,445,5
2021-06-11,Mendocino,045,87422,4105,4022,81,4103,49
2021-06-11,Merced,047,269075,31207,31231,1000,32231,461
2021-06-11,Modoc,049,8938,399,382,141,523,3
2021-06-11,Mono,051,14174,1262,1274,17,1291,3
2021-06-11,Monterey,053,433212,43288,43097,1886,44983,415
2021-06-11,Napa,055,140530,9977,9977,38,10015,80
2021-06-11,Nevada,057,99092,4908,4873,195,5068,72
2021-06-11,Orange,059,3164182,255970,254975,11468,266443,5101
2021-06-11,Placer,061,380077,23578,23330,1531,24861,294
2021-06-11,Plumas,063,18699,713,696,11,707,4
2021-06-11,Riverside,065,2383286,294915,289376,14138,303514,4451
2021-06-11,Sacramento,067,1510023,107349,107119,1825,108944,1659
2021-06-11,San Benito,069,59416,6086,6082,116,6198,63
2021-06-11,San Bernardino,071,2135413,294004,293335,9032,302367,4788
2021-06-11,San Diego,073,3302833,281889,281144,15149,296293,3768
2021-06-11,San Francisco,075,870044,36943,37177,1307,38484,555
2021-06-11,San Joaquin,077,732212,73699,73347,3633,76980,1397
2021-06-11,San Luis Obispo,079,281455,21528,21288,752,22040,256
2021-06-11,San Mateo,081,765935,42579,42585,478,43063,542
2021-06-11,Santa Barbara,083,443738,34471,34438,1202,35640,460
2021-06-11,Santa Clara,085,1922200,119096,119860,775,120635,2083
2021-06-11,Santa Cruz,087,273765,16263,16164,815,16979,208
2021-06-11,Shasta,089,179085,12526,12550,1624,14174,201
2021-06-11,Sierra,091,2930,59,55,12,67,0
2021-06-11,Siskiyou,093,43540,1955,1882,375,2257,25
2021-06-11,Solano,095,438530,33195,33179,563,33742,266
2021-06-11,Sonoma,097,501317,30536,30624,357,30981,323
2021-06-11,Stanislaus,099,539301,56771,56617,5997,62614,974
2021-06-11,Sutter,101,95872,9615,9600,89,9689,112
2021-06-11,Tehama,103,63373,5136,5099,591,5690,63
2021-06-11,Trinity,105,12862,487,331,97,428,3
2021-06-11,Tulare,107,460477,50374,49516,9140,58656,848
2021-06-11,Tuolumne,109,53932,4036,4104,40,4144,63
2021-06-11,Ventura,111,848112,81619,81189,3021,84210,1026
2021-06-11,Yolo,113,214977,14091,14111,335,14446,212
2021-06-11,Yuba,115,75493,6137,6113,133,6246,50
2021-06-10,Alameda,001,1643700,88808,88806,1991,90797,1275
2021-06-10,Alpine,003,1148,87,88,0,88,0
2021-06-10,Amador,005,37829,3727,3709,33,3742,46
2021-06-10,Butte,007,227075,12694,12565,1846,14411,194
2021-06-10,Calaveras,009,45235,2186,2188,14,2202,55
2021-06-10,Colusa,011,21464,1960,1964,317,2281,15
2021-06-10,Contra Costa,013,1133247,70372,69876,1307,71183,807
2021-06-10,Del Norte,015,27424,1438,1405,13,1418,8
2021-06-10,El Dorado,017,186661,10370,10314,742,11056,113
2021-06-10,Fresno,019,978130,103165,102724,8770,111494,1717
2021-06-10,Glenn,021,27897,2443,2425,567,2992,19
2021-06-10,Humboldt,023,135768,4393,4384,39,4423,42
2021-06-10,Imperial,025,180216,28707,28779,2894,31673,739
2021-06-10,Inyo,027,18085,1406,1405,12,1417,35
2021-06-10,Kern,029,883053,97658,96706,11069,107775,1336
2021-06-10,Kings,031,150075,23225,23067,1097,24164,245
2021-06-10,Lake,033,64148,3560,3550,9,3559,45
2021-06-10,Lassen,035,31185,5249,5201,116,5317,18
2021-06-10,Los Angeles,037,10098052,1207630,1204110,41915,1246025,24440
2021-06-10,Madera,039,155013,16706,16581,943,17524,240
2021-06-10,Marin,041,260295,14156,14118,268,14386,229
2021-06-10,Mariposa,043,17540,436,434,11,445,5
2021-06-10,Mendocino,045,87422,4100,4016,81,4097,48
2021-06-10,Merced,047,269075,31199,31231,997,32228,461
2021-06-10,Modoc,049,8938,398,381,141,522,3
2021-06-10,Mono,051,14174,1261,1274,17,1291,3
2021-06-10,Monterey,053,433212,43282,43090,1886,44976,415
2021-06-10,Napa,055,140530,9976,9974,38,10012,80
2021-06-10,Nevada,057,99092,4903,4866,195,5061,72
2021-06-10,Orange,059,3164182,255940,254950,11461,266411,5097
2021-06-10,Placer,061,380077,23565,23296,1531,24827,293
2021-06-10,Plumas,063,18699,713,696,11,707,4
2021-06-10,Riverside,065,2383286,294873,289335,14133,303468,4450
2021-06-10,Sacramento,067,1510023,107287,107049,1825,108874,1658
2021-06-10,San Benito,069,59416,6086,6079,116,6195,63
2021-06-10,San Bernardino,071,2135413,293963,293281,9029,302310,4782
2021-06-10,San Diego,073,3302833,281831,281052,15132,296184,3766
2021-06-10,San Francisco,075,870044,36933,37159,1305,38464,552
2021-06-10,San Joaquin,077,732212,73665,73276,3632,76908,1393
2021-06-10,San Luis Obispo,079,281455,21525,21280,752,22032,256
2021-06-10,San Mateo,081,765935,42572,42562,478,43040,666
2021-06-10,Santa Barbara,083,443738,34467,34434,1202,35636,460
2021-06-10,Santa Clara,085,1922200,119061,119832,774,120606,2075
2021-06-10,Santa Cruz,087,273765,16262,16159,815,16974,208
2021-06-10,Shasta,089,179085,12516,12536,1623,14159,201
2021-06-10,Sierra,091,2930,58,55,12,67,0
2021-06-10,Siskiyou,093,43540,1955,1881,375,2256,25
2021-06-10,Solano,095,438530,33178,33150,562,33712,265
2021-06-10,Sonoma,097,501317,30501,30571,355,30926,323
2021-06-10,Stanislaus,099,539301,56750,56588,5993,62581,974
2021-06-10,Sutter,101,95872,9608,9594,89,9683,112
2021-06-10,Tehama,103,63373,5136,5096,591,5687,63
2021-06-10,Trinity,105,12862,487,331,97,428,3
2021-06-10,Tulare,107,460477,50366,49503,9140,58643,848
2021-06-10,Tuolumne,109,53932,4036,4100,40,4140,63
2021-06-10,Ventura,111,848112,81608,81172,3020,84192,1026
2021-06-10,Yolo,113,214977,14088,14107,335,14442,212
2021-06-10,Yuba,115,75493,6133,6112,133,6245,50
2021-06-09,Alameda,001,1643700,88765,88762,1990,90752,1271
2021-06-09,Alpine,003,1148,87,88,0,88,0
2021-06-09,Amador,005,37829,3723,3706,33,3739,46
2021-06-09,Butte,007,227075,12688,12555,1844,14399,194
2021-06-09,Calaveras,009,45235,2184,2184,14,2198,55
2021-06-09,Colusa,011,21464,1960,1962,316,2278,15
2021-06-09,Contra Costa,013,1133247,70335,69829,1306,71135,803
2021-06-09,Del Norte,015,27424,1434,1403,13,1416,8
2021-06-09,El Dorado,017,186661,10367,10312,741,11053,113
2021-06-09,Fresno,019,978130,103145,102690,8766,111456,1717
2021-06-09,Glenn,021,27897,2442,2424,567,2991,19
2021-06-09,Humboldt,023,135768,4388,4379,38,4417,42
2021-06-09,Imperial,025,180216,28704,28754,2894,31648,739
2021-06-09,Inyo,027,18085,1406,1405,12,1417,35
2021-06-09,Kern,029,883053,97644,96697,11060,107757,1328
2021-06-09,Kings,031,150075,23223,23061,1097,24158,245
2021-06-09,Lake,033,64148,3557,3541,9,3550,45
2021-06-09,Lassen,035,31185,5248,5200,116,5316,18
2021-06-09,Los Angeles,037,10098052,1207446,1203955,41904,1245859,24432
2021-06-09,Madera,039,155013,16701,16580,943,17523,240
2021-06-09,Marin,041,260295,14151,14114,268,14382,229
2021-06-09,Mariposa,043,17540,436,434,11,445,5
2021-06-09,Mendocino,045,87422,4094,4008,81,4089,47
2021-06-09,Merced,047,269075,31195,31225,997,32222,461
2021-06-09,Modoc,049,8938,396,377,140,517,3
2021-06-09,Mono,051,14174,1261,1274,17,1291,3
2021-06-09,Monterey,053,433212,43275,43082,1886,44968,415
2021-06-09,Napa,055,140530,9970,9971,38,10009,80
2021-06-09,Nevada,057,99092,4893,4863,194,5057,72
2021-06-09,Orange,059,3164182,255896,254893,11457,266350,5080
2021-06-09,Placer,061,380077,23546,23237,1531,24768,293
2021-06-09,Plumas,063,18699,712,697,11,708,4
2021-06-09,Riverside,065,2383286,294827,289299,14131,303430,4450
2021-06-09,Sacramento,067,1510023,107225,106971,1822,108793,1657
2021-06-09,San Benito,069,59416,6082,6078,116,6194,63
2021-06-09,San Bernardino,071,2135413,293921,293222,9029,302251,4782
2021-06-09,San Diego,073,3302833,281767,280941,15120,296061,3765
2021-06-09,San Francisco,075,870044,36920,37143,1304,38447,552
2021-06-09,San Joaquin,077,732212,73639,73232,3631,76863,1392
2021-06-09,San Luis Obispo,079,281455,21524,21259,752,22011,256
2021-06-09,San Mateo,081,765935,42556,42502,477,42979,666
2021-06-09,Santa Barbara,083,443738,34456,34422,1202,35624,460
2021-06-09,Santa Clara,085,1922200,119023,119793,773,120566,2068
2021-06-09,Santa Cruz,087,273765,16259,16155,815,16970,208
2021-06-09,Shasta,089,179085,12506,12521,1621,14142,201
2021-06-09,Sierra,091,2930,57,55,12,67,0
2021-06-09,Siskiyou,093,43540,1954,1871,375,2246,25
2021-06-09,Solano,095,438530,33162,33137,561,33698,264
2021-06-09,Sonoma,097,501317,30479,30540,355,30895,323
2021-06-09,Stanislaus,099,539301,56730,56560,5990,62550,974
2021-06-09,Sutter,101,95872,9599,9586,88,9674,111
2021-06-09,Tehama,103,63373,5135,5093,591,5684,63
2021-06-09,Trinity,105,12862,486,331,97,428,3
2021-06-09,Tulare,107,460477,50362,49496,9138,58634,847
2021-06-09,Tuolumne,109,53932,4033,4100,40,4140,63
2021-06-09,Ventura,111,848112,81598,81154,3019,84173,1026
2021-06-09,Yolo,113,214977,14086,14102,334,14436,212
2021-06-09,Yuba,115,75493,6129,6109,133,6242,50
2021-06-08,Alameda,001,1643700,88717,88731,1990,90721,1267
2021-06-08,Alpine,003,1148,87,88,0,88,0
2021-06-08,Amador,005,37829,3722,3704,33,3737,46
2021-06-08,Butte,007,227075,12682,12540,1842,14382,194
2021-06-08,Calaveras,009,45235,2183,2181,14,2195,55
2021-06-08,Colusa,011,21464,1960,1961,316,2277,15
2021-06-08,Contra Costa,013,1133247,70287,69762,1305,71067,803
2021-06-08,Del Norte,015,27424,1432,1402,13,1415,8
2021-06-08,El Dorado,017,186661,10362,10306,739,11045,113
2021-06-08,Fresno,019,978130,103120,102680,8764,111444,1717
2021-06-08,Glenn,021,27897,2441,2423,567,2990,19
2021-06-08,Humboldt,023,135768,4383,4363,38,4401,42
2021-06-08,Imperial,025,180216,28695,28752,2894,31646,738
2021-06-08,Inyo,027,18085,1406,1405,12,1417,35
2021-06-08,Kern,029,883053,97625,96671,11053,107724,1325
2021-06-08,Kings,031,150075,23222,23036,1097,24133,245
2021-06-08,Lake,033,64148,3556,3540,9,3549,45
2021-06-08,Lassen,035,31185,5248,5200,116,5316,18
2021-06-08,Los Angeles,037,10098052,1207250,1203794,41894,1245688,24426
2021-06-08,Madera,039,155013,16695,16579,942,17521,240
2021-06-08,Marin,041,260295,14149,14111,267,14378,229
2021-06-08,Mariposa,043,17540,436,434,11,445,5
2021-06-08,Mendocino,045,87422,4087,4002,81,4083,47
2021-06-08,Merced,047,269075,31187,31225,997,32222,461
2021-06-08,Modoc,049,8938,390,377,139,516,3
2021-06-08,Mono,051,14174,1261,1274,17,1291,3
2021-06-08,Monterey,053,433212,43269,43078,1885,44963,415
2021-06-08,Napa,055,140530,9966,9962,38,10000,80
2021-06-08,Nevada,057,99092,4888,4861,194,5055,72
2021-06-08,Orange,059,3164182,255854,254852,11450,266302,5078
2021-06-08,Placer,061,380077,23528,23209,1527,24736,293
2021-06-08,Plumas,063,18699,712,692,11,703,4
2021-06-08,Riverside,065,2383286,294791,289268,14123,303391,4452
2021-06-08,Sacramento,067,1510023,107163,106901,1819,108720,1654
2021-06-08,San Benito,069,59416,6080,6076,116,6192,63
2021-06-08,San Bernardino,071,2135413,293872,293186,9025,302211,4778
2021-06-08,San Diego,073,3302833,281704,280879,15111,295990,3764
2021-06-08,San Francisco,075,870044,36905,37134,1303,38437,552
2021-06-08,San Joaquin,077,732212,73595,73186,3626,76812,1390
2021-06-08,San Luis Obispo,079,281455,21518,21251,751,22002,255
2021-06-08,San Mateo,081,765935,42543,42488,477,42965,663
2021-06-08,Santa Barbara,083,443738,34452,34418,1202,35620,459
2021-06-08,Santa Clara,085,1922200,119002,119770,772,120542,2068
2021-06-08,Santa Cruz,087,273765,16256,16160,815,16975,208
2021-06-08,Shasta,089,179085,12491,12498,1621,14119,201
2021-06-08,Sierra,091,2930,57,55,12,67,0
2021-06-08,Siskiyou,093,43540,1952,1870,373,2243,21
2021-06-08,Solano,095,438530,33141,33130,561,33691,259
2021-06-08,Sonoma,097,501317,30452,30523,353,30876,323
2021-06-08,Stanislaus,099,539301,56703,56548,5988,62536,973
2021-06-08,Sutter,101,95872,9596,9581,88,9669,111
2021-06-08,Tehama,103,63373,5132,5093,591,5684,63
2021-06-08,Trinity,105,12862,486,330,96,426,3
2021-06-08,Tulare,107,460477,50350,49485,9133,58618,847
2021-06-08,Tuolumne,109,53932,4030,4099,40,4139,63
2021-06-08,Ventura,111,848112,81582,81142,3018,84160,1026
2021-06-08,Yolo,113,214977,14080,14099,333,14432,212
2021-06-08,Yuba,115,75493,6127,6103,133,6236,50
2021-06-07,Alameda,001,1643700,88660,88688,1990,90678,1267
2021-06-07,Alpine,003,1148,87,88,0,88,0
2021-06-07,Amador,005,37829,3712,3697,33,3730,46
2021-06-07,Butte,007,227075,12675,12533,1841,14374,194
2021-06-07,Calaveras,009,45235,2182,2181,14,2195,55
2021-06-07,Colusa,011,21464,1959,1960,316,2276,15
2021-06-07,Contra Costa,013,1133247,70230,69718,1304,71022,817
2021-06-07,Del Norte,015,27424,1432,1401,13,1414,8
2021-06-07,El Dorado,017,186661,10357,10305,739,11044,113
2021-06-07,Fresno,019,978130,103088,102659,8756,111415,1717
2021-06-07,Glenn,021,27897,2441,2423,567,2990,19
2021-06-07,Humboldt,023,135768,4374,4354,38,4392,42
2021-06-07,Imperial,025,180216,28693,28754,2893,31647,738
2021-06-07,Inyo,027,18085,1406,1404,12,1416,35
2021-06-07,Kern,029,883053,97609,96645,11046,107691,1324
2021-06-07,Kings,031,150075,23218,23023,1097,24120,244
2021-06-07,Lake,033,64148,3554,3540,9,3549,45
2021-06-07,Lassen,035,31185,5243,5198,116,5314,18
2021-06-07,Los Angeles,037,10098052,1207028,1203664,41880,1245544,24413
2021-06-07,Madera,039,155013,16688,16572,942,17514,240
2021-06-07,Marin,041,260295,14145,14108,266,14374,229
2021-06-07,Mariposa,043,17540,436,434,11,445,5
2021-06-07,Mendocino,045,87422,4081,3998,81,4079,47
2021-06-07,Merced,047,269075,31175,31212,996,32208,459
2021-06-07,Modoc,049,8938,389,375,136,511,3
2021-06-07,Mono,051,14174,1261,1275,17,1292,3
2021-06-07,Monterey,053,433212,43262,43077,1885,44962,415
2021-06-07,Napa,055,140530,9958,9962,38,10000,80
2021-06-07,Nevada,057,99092,4886,4860,194,5054,72
2021-06-07,Orange,059,3164182,255814,254808,11443,266251,5073
2021-06-07,Placer,061,380077,23509,23176,1525,24701,293
2021-06-07,Plumas,063,18699,712,692,11,703,4
2021-06-07,Riverside,065,2383286,294748,289232,14119,303351,4451
2021-06-07,Sacramento,067,1510023,107087,106841,1816,108657,1655
2021-06-07,San Benito,069,59416,6079,6074,116,6190,63
2021-06-07,San Bernardino,071,2135413,293834,293129,9024,302153,4775
2021-06-07,San Diego,073,3302833,281622,280808,15098,295906,3764
2021-06-07,San Francisco,075,870044,36889,37122,1303,38425,552
2021-06-07,San Joaquin,077,732212,73550,73130,3619,76749,1388
2021-06-07,San Luis Obispo,079,281455,21505,21252,751,22003,255
2021-06-07,San Mateo,081,765935,42527,42479,477,42956,664
2021-06-07,Santa Barbara,083,443738,34446,34407,1202,35609,459
2021-06-07,Santa Clara,085,1922200,118970,119743,772,120515,2066
2021-06-07,Santa Cruz,087,273765,16254,16159,815,16974,208
2021-06-07,Shasta,089,179085,12477,12483,1616,14099,200
2021-06-07,Sierra,091,2930,57,55,12,67,0
2021-06-07,Siskiyou,093,43540,1952,1869,373,2242,21
2021-06-07,Solano,095,438530,33119,33124,560,33684,258
2021-06-07,Sonoma,097,501317,30416,30504,352,30856,323
2021-06-07,Stanislaus,099,539301,56670,56521,5986,62507,972
2021-06-07,Sutter,101,95872,9592,9571,88,9659,111
2021-06-07,Tehama,103,63373,5128,5092,589,5681,63
2021-06-07,Trinity,105,12862,486,329,96,425,3
2021-06-07,Tulare,107,460477,50344,49471,9133,58604,847
2021-06-07,Tuolumne,109,53932,4029,4098,40,4138,63
2021-06-07,Ventura,111,848112,81565,81137,3017,84154,1025
2021-06-07,Yolo,113,214977,14074,14097,332,14429,211
2021-06-07,Yuba,115,75493,6125,6099,130,6229,49
2021-06-06,Alameda,001,1643700,88621,88636,1989,90625,1267
2021-06-06,Alpine,003,1148,87,88,0,88,0
2021-06-06,Amador,005,37829,3709,3696,33,3729,46
2021-06-06,Butte,007,227075,12664,12527,1840,14367,194
2021-06-06,Calaveras,009,45235,2181,2181,14,2195,55
2021-06-06,Colusa,011,21464,1957,1959,316,2275,15
2021-06-06,Contra Costa,013,1133247,70165,69659,1302,70961,817
2021-06-06,Del Norte,015,27424,1427,1401,13,1414,8
2021-06-06,El Dorado,017,186661,10350,10294,739,11033,113
2021-06-06,Fresno,019,978130,103055,102642,8753,111395,1717
2021-06-06,Glenn,021,27897,2440,2423,567,2990,19
2021-06-06,Humboldt,023,135768,4363,4353,38,4391,42
2021-06-06,Imperial,025,180216,28687,28762,2892,31654,738
2021-06-06,Inyo,027,18085,1405,1404,12,1416,35
2021-06-06,Kern,029,883053,97591,96623,11039,107662,1324
2021-06-06,Kings,031,150075,23212,23021,1097,24118,244
2021-06-06,Lake,033,64148,3554,3535,9,3544,45
2021-06-06,Lassen,035,31185,5241,5191,116,5307,18
2021-06-06,Los Angeles,037,10098052,1206829,1203539,41868,1245407,24410
2021-06-06,Madera,039,155013,16681,16567,942,17509,240
2021-06-06,Marin,041,260295,14139,14106,265,14371,229
2021-06-06,Mariposa,043,17540,435,435,11,446,5
2021-06-06,Mendocino,045,87422,4077,3993,81,4074,47
2021-06-06,Merced,047,269075,31169,31215,995,32210,459
2021-06-06,Modoc,049,8938,389,375,135,510,3
2021-06-06,Mono,051,14174,1261,1275,17,1292,3
2021-06-06,Monterey,053,433212,43257,43078,1885,44963,415
2021-06-06,Napa,055,140530,9952,9963,38,10001,80
2021-06-06,Nevada,057,99092,4879,4854,193,5047,72
2021-06-06,Orange,059,3164182,255778,254782,11438,266220,5073
2021-06-06,Placer,061,380077,23484,23156,1522,24678,293
2021-06-06,Plumas,063,18699,712,692,11,703,4
2021-06-06,Riverside,065,2383286,294709,289201,14113,303314,4451
2021-06-06,Sacramento,067,1510023,107001,106749,1815,108564,1655
2021-06-06,San Benito,069,59416,6073,6074,116,6190,63
2021-06-06,San Bernardino,071,2135413,293778,293117,9015,302132,4773
2021-06-06,San Diego,073,3302833,281542,280743,15081,295824,3764
2021-06-06,San Francisco,075,870044,36876,37118,1301,38419,552
2021-06-06,San Joaquin,077,732212,73518,73105,3615,76720,1388
2021-06-06,San Luis Obispo,079,281455,21502,21246,751,21997,255
2021-06-06,San Mateo,081,765935,42510,42457,477,42934,664
2021-06-06,Santa Barbara,083,443738,34442,34403,1201,35604,459
2021-06-06,Santa Clara,085,1922200,118948,119711,772,120483,2066
2021-06-06,Santa Cruz,087,273765,16253,16158,815,16973,208
2021-06-06,Shasta,089,179085,12462,12478,1612,14090,200
2021-06-06,Sierra,091,2930,57,55,12,67,0
2021-06-06,Siskiyou,093,43540,1949,1869,373,2242,21
2021-06-06,Solano,095,438530,33092,33093,560,33653,258
2021-06-06,Sonoma,097,501317,30385,30478,351,30829,323
2021-06-06,Stanislaus,099,539301,56634,56486,5983,62469,972
2021-06-06,Sutter,101,95872,9585,9567,88,9655,111
2021-06-06,Tehama,103,63373,5118,5092,587,5679,63
2021-06-06,Trinity,105,12862,486,328,96,424,3
2021-06-06,Tulare,107,460477,50336,49466,9128,58594,847
2021-06-06,Tuolumne,109,53932,4027,4097,40,4137,63
2021-06-06,Ventura,111,848112,81554,81130,3014,84144,1025
2021-06-06,Yolo,113,214977,14066,14089,331,14420,210
2021-06-06,Yuba,115,75493,6117,6096,130,6226,49
2021-06-05,Alameda,001,1643700,88588,88612,1989,90601,1268
2021-06-05,Alpine,003,1148,87,88,0,88,0
2021-06-05,Amador,005,37829,3709,3694,33,3727,46
2021-06-05,Butte,007,227075,12658,12514,1839,14353,194
2021-06-05,Calaveras,009,45235,2181,2181,14,2195,55
2021-06-05,Colusa,011,21464,1957,1959,316,2275,15
2021-06-05,Contra Costa,013,1133247,70136,69601,1302,70903,817
2021-06-05,Del Norte,015,27424,1427,1400,13,1413,8
2021-06-05,El Dorado,017,186661,10348,10288,738,11026,113
2021-06-05,Fresno,019,978130,103046,102626,8753,111379,1717
2021-06-05,Glenn,021,27897,2439,2423,567,2990,19
2021-06-05,Humboldt,023,135768,4358,4346,38,4384,42
2021-06-05,Imperial,025,180216,28684,28764,2891,31655,738
2021-06-05,Inyo,027,18085,1405,1405,12,1417,35
2021-06-05,Kern,029,883053,97578,96597,11035,107632,1324
2021-06-05,Kings,031,150075,23209,23017,1097,24114,244
2021-06-05,Lake,033,64148,3551,3534,9,3543,45
2021-06-05,Lassen,035,31185,5240,5191,116,5307,18
2021-06-05,Los Angeles,037,10098052,1206702,1203338,41858,1245196,24411
2021-06-05,Madera,039,155013,16677,16563,942,17505,240
2021-06-05,Marin,041,260295,14137,14101,265,14366,229
2021-06-05,Mariposa,043,17540,435,435,11,446,5
2021-06-05,Mendocino,045,87422,4074,3989,81,4070,47
2021-06-05,Merced,047,269075,31167,31212,994,32206,459
2021-06-05,Modoc,049,8938,389,375,134,509,3
2021-06-05,Mono,051,14174,1261,1274,17,1291,3
2021-06-05,Monterey,053,433212,43253,43071,1884,44955,415
2021-06-05,Napa,055,140530,9947,9960,38,9998,80
2021-06-05,Nevada,057,99092,4877,4849,193,5042,72
2021-06-05,Orange,059,3164182,255754,254752,11435,266187,5069
2021-06-05,Placer,061,380077,23468,23133,1522,24655,293
2021-06-05,Plumas,063,18699,712,692,11,703,4
2021-06-05,Riverside,065,2383286,294674,289157,14109,303266,4451
2021-06-05,Sacramento,067,1510023,106949,106688,1813,108501,1655
2021-06-05,San Benito,069,59416,6071,6074,116,6190,63
2021-06-05,San Bernardino,071,2135413,293745,293081,9013,302094,4772
2021-06-05,San Diego,073,3302833,281501,280676,15068,295744,3764
2021-06-05,San Francisco,075,870044,36867,37111,1301,38412,552
2021-06-05,San Joaquin,077,732212,73502,73078,3609,76687,1388
2021-06-05,San Luis Obispo,079,281455,21499,21236,751,21987,255
2021-06-05,San Mateo,081,765935,42500,42433,477,42910,664
2021-06-05,Santa Barbara,083,443738,34439,34399,1200,35599,459
2021-06-05,Santa Clara,085,1922200,118926,119676,770,120446,2066
2021-06-05,Santa Cruz,087,273765,16253,16154,815,16969,208
2021-06-05,Shasta,089,179085,12453,12472,1611,14083,200
2021-06-05,Sierra,091,2930,57,55,12,67,0
2021-06-05,Siskiyou,093,43540,1949,1867,373,2240,21
2021-06-05,Solano,095,438530,33077,33074,560,33634,257
2021-06-05,Sonoma,097,501317,30358,30450,349,30799,323
2021-06-05,Stanislaus,099,539301,56626,56463,5981,62444,973
2021-06-05,Sutter,101,95872,9582,9559,88,9647,111
2021-06-05,Tehama,103,63373,5117,5092,586,5678,63
2021-06-05,Trinity,105,12862,486,328,96,424,3
2021-06-05,Tulare,107,460477,50330,49463,9128,58591,847
2021-06-05,Tuolumne,109,53932,4025,4098,40,4138,63
2021-06-05,Ventura,111,848112,81545,81119,3012,84131,1025
2021-06-05,Yolo,113,214977,14064,14088,331,14419,210
2021-06-05,Yuba,115,75493,6116,6087,130,6217,49
2021-06-04,Alameda,001,1643700,88561,88585,1986,90571,1263
2021-06-04,Alpine,003,1148,87,88,0,88,0
2021-06-04,Amador,005,37829,3709,3690,33,3723,46
2021-06-04,Butte,007,227075,12647,12494,1836,14330,193
2021-06-04,Calaveras,009,45235,2181,2179,14,2193,55
2021-06-04,Colusa,011,21464,1957,1959,316,2275,15
2021-06-04,Contra Costa,013,1133247,70101,69540,1299,70839,816
2021-06-04,Del Norte,015,27424,1427,1398,13,1411,8
2021-06-04,El Dorado,017,186661,10344,10284,736,11020,112
2021-06-04,Fresno,019,978130,103030,102601,8753,111354,1712
2021-06-04,Glenn,021,27897,2439,2423,566,2989,19
2021-06-04,Humboldt,023,135768,4353,4327,38,4365,42
2021-06-04,Imperial,025,180216,28680,28753,2891,31644,738
2021-06-04,Inyo,027,18085,1405,1404,12,1416,35
2021-06-04,Kern,029,883053,97560,96573,11033,107606,1327
2021-06-04,Kings,031,150075,23208,23002,1097,24099,244
2021-06-04,Lake,033,64148,3549,3528,9,3537,45
2021-06-04,Lassen,035,31185,5240,5180,116,5296,18
2021-06-04,Los Angeles,037,10098052,1206578,1203106,41849,1244955,24400
2021-06-04,Madera,039,155013,16675,16557,942,17499,240
2021-06-04,Marin,041,260295,14136,14099,264,14363,229
2021-06-04,Mariposa,043,17540,435,435,11,446,5
2021-06-04,Mendocino,045,87422,4065,3983,81,4064,47
2021-06-04,Merced,047,269075,31162,31204,993,32197,459
2021-06-04,Modoc,049,8938,387,375,134,509,3
2021-06-04,Mono,051,14174,1261,1275,17,1292,3
2021-06-04,Monterey,053,433212,43249,43068,1884,44952,415
2021-06-04,Napa,055,140530,9943,9958,38,9996,80
2021-06-04,Nevada,057,99092,4873,4844,193,5037,72
2021-06-04,Orange,059,3164182,255717,254730,11432,266162,5059
2021-06-04,Placer,061,380077,23452,23110,1521,24631,293
2021-06-04,Plumas,063,18699,712,691,11,702,4
2021-06-04,Riverside,065,2383286,294648,289098,14105,303203,4452
2021-06-04,Sacramento,067,1510023,106895,106616,1812,108428,1654
2021-06-04,San Benito,069,59416,6069,6073,116,6189,63
2021-06-04,San Bernardino,071,2135413,293722,293056,9011,302067,4768
2021-06-04,San Diego,073,3302833,281458,280556,15061,295617,3763
2021-06-04,San Francisco,075,870044,36862,37079,1300,38379,551
2021-06-04,San Joaquin,077,732212,73483,73039,3607,76646,1388
2021-06-04,San Luis Obispo,079,281455,21496,21234,750,21984,255
2021-06-04,San Mateo,081,765935,42488,42413,477,42890,478
2021-06-04,Santa Barbara,083,443738,34433,34402,1199,35601,459
2021-06-04,Santa Clara,085,1922200,118896,119619,770,120389,2065
2021-06-04,Santa Cruz,087,273765,16251,16150,815,16965,207
2021-06-04,Shasta,089,179085,12447,12458,1606,14064,200
2021-06-04,Sierra,091,2930,57,55,12,67,0
2021-06-04,Siskiyou,093,43540,1948,1865,373,2238,21
2021-06-04,Solano,095,438530,33066,33058,560,33618,256
2021-06-04,Sonoma,097,501317,30337,30411,349,30760,323
2021-06-04,Stanislaus,099,539301,56611,56442,5978,62420,973
2021-06-04,Sutter,101,95872,9577,9554,88,9642,111
2021-06-04,Tehama,103,63373,5112,5090,586,5676,63
2021-06-04,Trinity,105,12862,486,328,96,424,3
2021-06-04,Tulare,107,460477,50321,49452,9126,58578,847
2021-06-04,Tuolumne,109,53932,4024,4095,40,4135,63
2021-06-04,Ventura,111,848112,81538,81104,3010,84114,1023
2021-06-04,Yolo,113,214977,14062,14083,331,14414,210
2021-06-04,Yuba,115,75493,6113,6084,130,6214,49
2021-06-03,Alameda,001,1643700,88523,88555,1983,90538,1257
2021-06-03,Alpine,003,1148,87,88,0,88,0
2021-06-03,Amador,005,37829,3701,3688,33,3721,46
2021-06-03,Butte,007,227075,12643,12478,1835,14313,193
2021-06-03,Calaveras,009,45235,2181,2179,14,2193,55
2021-06-03,Colusa,011,21464,1957,1957,316,2273,15
2021-06-03,Contra Costa,013,1133247,70047,69500,1294,70794,816
2021-06-03,Del Norte,015,27424,1425,1397,13,1410,8
2021-06-03,El Dorado,017,186661,10338,10284,733,11017,112
2021-06-03,Fresno,019,978130,103013,102566,8753,111319,1709
2021-06-03,Glenn,021,27897,2439,2421,566,2987,19
2021-06-03,Humboldt,023,135768,4345,4314,38,4352,42
2021-06-03,Imperial,025,180216,28668,28737,2891,31628,738
2021-06-03,Inyo,027,18085,1405,1404,12,1416,35
2021-06-03,Kern,029,883053,97533,96507,11019,107526,1326
2021-06-03,Kings,031,150075,23204,22982,1097,24079,244
2021-06-03,Lake,033,64148,3547,3526,9,3535,45
2021-06-03,Lassen,035,31185,5231,5177,116,5293,12
2021-06-03,Los Angeles,037,10098052,1206403,1202923,41841,1244764,24386
2021-06-03,Madera,039,155013,16668,16554,942,17496,240
2021-06-03,Marin,041,260295,14131,14095,264,14359,230
2021-06-03,Mariposa,043,17540,435,435,11,446,5
2021-06-03,Mendocino,045,87422,4058,3978,81,4059,47
2021-06-03,Merced,047,269075,31159,31199,993,32192,459
2021-06-03,Modoc,049,8938,386,376,133,509,3
2021-06-03,Mono,051,14174,1261,1275,17,1292,3
2021-06-03,Monterey,053,433212,43246,43063,1884,44947,415
2021-06-03,Napa,055,140530,9936,9957,38,9995,81
2021-06-03,Nevada,057,99092,4869,4837,193,5030,72
2021-06-03,Orange,059,3164182,255689,254676,11422,266098,5056
2021-06-03,Placer,061,380077,23443,23100,1520,24620,293
2021-06-03,Plumas,063,18699,712,691,11,702,4
2021-06-03,Riverside,065,2383286,294593,289035,14101,303136,4447
2021-06-03,Sacramento,067,1510023,106817,106526,1810,108336,1654
2021-06-03,San Benito,069,59416,6069,6073,116,6189,63
2021-06-03,San Bernardino,071,2135413,293690,293021,9011,302032,4762
2021-06-03,San Diego,073,3302833,281395,280430,15051,295481,3761
2021-06-03,San Francisco,075,870044,36856,37072,1300,38372,551
2021-06-03,San Joaquin,077,732212,73455,72989,3603,76592,1388
2021-06-03,San Luis Obispo,079,281455,21491,21224,750,21974,255
2021-06-03,San Mateo,081,765935,42475,42396,477,42873,467
2021-06-03,Santa Barbara,083,443738,34430,34391,1199,35590,459
2021-06-03,Santa Clara,085,1922200,118874,119592,768,120360,2058
2021-06-03,Santa Cruz,087,273765,16249,16144,815,16959,207
2021-06-03,Shasta,089,179085,12432,12441,1603,14044,199
2021-06-03,Sierra,091,2930,57,55,12,67,0
2021-06-03,Siskiyou,093,43540,1948,1862,372,2234,21
2021-06-03,Solano,095,438530,33052,33019,560,33579,256
2021-06-03,Sonoma,097,501317,30315,30383,348,30731,322
2021-06-03,Stanislaus,099,539301,56593,56401,5972,62373,973
2021-06-03,Sutter,101,95872,9568,9539,88,9627,111
2021-06-03,Tehama,103,63373,5112,5087,586,5673,63
2021-06-03,Trinity,105,12862,486,328,96,424,3
2021-06-03,Tulare,107,460477,50318,49442,9122,58564,848
2021-06-03,Tuolumne,109,53932,4022,4095,40,4135,63
2021-06-03,Ventura,111,848112,81526,81078,3008,84086,1023
2021-06-03,Yolo,113,214977,14058,14078,328,14406,210
2021-06-03,Yuba,115,75493,6106,6077,130,6207,49
2021-06-02,Alameda,001,1643700,88478,88525,1981,90506,1254
2021-06-02,Alpine,003,1148,87,88,0,88,0
2021-06-02,Amador,005,37829,3699,3687,33,3720,46
2021-06-02,Butte,007,227075,12623,12432,1832,14264,193
2021-06-02,Calaveras,009,45235,2178,2174,14,2188,55
2021-06-02,Colusa,011,21464,1956,1957,316,2273,15
2021-06-02,Contra Costa,013,1133247,69996,69455,1292,70747,814
2021-06-02,Del Norte,015,27424,1423,1395,13,1408,8
2021-06-02,El Dorado,017,186661,10334,10275,733,11008,110
2021-06-02,Fresno,019,978130,102989,102547,8750,111297,1707
2021-06-02,Glenn,021,27897,2439,2421,566,2987,19
2021-06-02,Humboldt,023,135768,4330,4302,38,4340,42
2021-06-02,Imperial,025,180216,28662,28737,2890,31627,738
2021-06-02,Inyo,027,18085,1404,1403,12,1415,35
2021-06-02,Kern,029,883053,97506,96481,11012,107493,1326
2021-06-02,Kings,031,150075,23202,22981,1097,24078,244
2021-06-02,Lake,033,64148,3542,3522,9,3531,45
2021-06-02,Lassen,035,31185,5230,5177,116,5293,6
2021-06-02,Los Angeles,037,10098052,1206200,1202760,41831,1244591,24375
2021-06-02,Madera,039,155013,16660,16550,942,17492,240
2021-06-02,Marin,041,260295,14129,14091,264,14355,229
2021-06-02,Mariposa,043,17540,435,434,11,445,5
2021-06-02,Mendocino,045,87422,4052,3970,81,4051,47
2021-06-02,Merced,047,269075,31146,31195,992,32187,458
2021-06-02,Modoc,049,8938,385,375,132,507,3
2021-06-02,Mono,051,14174,1261,1275,17,1292,3
2021-06-02,Monterey,053,433212,43244,43056,1884,44940,380
2021-06-02,Napa,055,140530,9935,9953,38,9991,82
2021-06-02,Nevada,057,99092,4866,4833,193,5026,72
2021-06-02,Orange,059,3164182,255641,254637,11417,266054,5055
2021-06-02,Placer,061,380077,23422,23058,1518,24576,293
2021-06-02,Plumas,063,18699,712,690,11,701,4
2021-06-02,Riverside,065,2383286,294534,289012,14091,303103,4445
2021-06-02,Sacramento,067,1510023,106752,106435,1804,108239,1649
2021-06-02,San Benito,069,59416,6068,6073,116,6189,63
2021-06-02,San Bernardino,071,2135413,293642,293004,9006,302010,4760
2021-06-02,San Diego,073,3302833,281315,280347,15030,295377,3760
2021-06-02,San Francisco,075,870044,36836,37050,1299,38349,550
2021-06-02,San Joaquin,077,732212,73424,72893,3600,76493,1387
2021-06-02,San Luis Obispo,079,281455,21484,21214,749,21963,255
2021-06-02,San Mateo,081,765935,42465,42383,476,42859,464
2021-06-02,Santa Barbara,083,443738,34423,34381,1199,35580,456
2021-06-02,Santa Clara,085,1922200,118846,119553,767,120320,2058
2021-06-02,Santa Cruz,087,273765,16246,16144,815,16959,207
2021-06-02,Shasta,089,179085,12414,12426,1598,14024,199
2021-06-02,Sierra,091,2930,57,55,12,67,0
2021-06-02,Siskiyou,093,43540,1948,1861,370,2231,21
2021-06-02,Solano,095,438530,33040,33007,559,33566,256
2021-06-02,Sonoma,097,501317,30296,30359,343,30702,322
2021-06-02,Stanislaus,099,539301,56575,56377,5967,62344,973
2021-06-02,Sutter,101,95872,9565,9533,88,9621,111
2021-06-02,Tehama,103,63373,5109,5081,586,5667,63
2021-06-02,Trinity,105,12862,484,328,96,424,3
2021-06-02,Tulare,107,460477,50309,49434,9118,58552,846
2021-06-02,Tuolumne,109,53932,4021,4095,40,4135,63
2021-06-02,Ventura,111,848112,81501,81033,3008,84041,1020
2021-06-02,Yolo,113,214977,14055,14074,327,14401,210
2021-06-02,Yuba,115,75493,6100,6072,130,6202,48
2021-06-01,Alameda,001,1643700,88443,88472,1979,90451,1253
2021-06-01,Alpine,003,1148,87,88,0,88,0
2021-06-01,Amador,005,37829,3697,3687,33,3720,46
2021-06-01,Butte,007,227075,12609,12427,1831,14258,193
2021-06-01,Calaveras,009,45235,2176,2173,14,2187,55
2021-06-01,Colusa,011,21464,1955,1955,315,2270,15
2021-06-01,Contra Costa,013,1133247,69939,69404,1292,70696,813
2021-06-01,Del Norte,015,27424,1422,1394,13,1407,8
2021-06-01,El Dorado,017,186661,10328,10271,733,11004,110
2021-06-01,Fresno,019,978130,102965,102534,8747,111281,1706
2021-06-01,Glenn,021,27897,2439,2422,566,2988,18
2021-06-01,Humboldt,023,135768,4320,4299,38,4337,42
2021-06-01,Imperial,025,180216,28658,28722,2887,31609,736
2021-06-01,Inyo,027,18085,1404,1403,12,1415,35
2021-06-01,Kern,029,883053,97479,96477,11004,107481,1319
2021-06-01,Kings,031,150075,23198,22977,1097,24074,244
2021-06-01,Lake,033,64148,3541,3523,9,3532,45
2021-06-01,Lassen,035,31185,5223,5172,116,5288,6
2021-06-01,Los Angeles,037,10098052,1205965,1202673,41818,1244491,24367
2021-06-01,Madera,039,155013,16651,16549,941,17490,240
2021-06-01,Marin,041,260295,14127,14081,264,14345,229
2021-06-01,Mariposa,043,17540,435,431,11,442,5
2021-06-01,Mendocino,045,87422,4045,3966,81,4047,47
2021-06-01,Merced,047,269075,31136,31195,992,32187,456
2021-06-01,Modoc,049,8938,383,375,132,507,3
2021-06-01,Mono,051,14174,1261,1275,17,1292,3
2021-06-01,Monterey,053,433212,43238,43051,1884,44935,379
2021-06-01,Napa,055,140530,9933,9949,38,9987,82
2021-06-01,Nevada,057,99092,4861,4825,193,5018,72
2021-06-01,Orange,059,3164182,255605,254603,11409,266012,5051
2021-06-01,Placer,061,380077,23392,23021,1516,24537,293
2021-06-01,Plumas,063,18699,711,690,11,701,4
2021-06-01,Riverside,065,2383286,294482,288996,14085,303081,4442
2021-06-01,Sacramento,067,1510023,106680,106330,1802,108132,1644
2021-06-01,San Benito,069,59416,6067,6073,115,6188,63
2021-06-01,San Bernardino,071,2135413,293617,292990,9005,301995,4758
2021-06-01,San Diego,073,3302833,281211,280305,15013,295318,3756
2021-06-01,San Francisco,075,870044,36820,37031,1299,38330,550
2021-06-01,San Joaquin,077,732212,73392,72858,3598,76456,1383
2021-06-01,San Luis Obispo,079,281455,21479,21217,749,21966,256
2021-06-01,San Mateo,081,765935,42449,42383,475,42858,462
2021-06-01,Santa Barbara,083,443738,34419,34374,1199,35573,456
2021-06-01,Santa Clara,085,1922200,118818,119528,767,120295,2057
2021-06-01,Santa Cruz,087,273765,16242,16143,814,16957,207
2021-06-01,Shasta,089,179085,12405,12409,1593,14002,199
2021-06-01,Sierra,091,2930,57,55,12,67,0
2021-06-01,Siskiyou,093,43540,1941,1860,369,2229,21
2021-06-01,Solano,095,438530,33015,32974,558,33532,256
2021-06-01,Sonoma,097,501317,30257,30324,342,30666,322
2021-06-01,Stanislaus,099,539301,56559,56348,5965,62313,973
2021-06-01,Sutter,101,95872,9558,9528,88,9616,111
2021-06-01,Tehama,103,63373,5107,5079,586,5665,63
2021-06-01,Trinity,105,12862,483,328,95,423,3
2021-06-01,Tulare,107,460477,50301,49419,9114,58533,845
2021-06-01,Tuolumne,109,53932,4021,4094,40,4134,63
2021-06-01,Ventura,111,848112,81485,81018,3007,84025,1021
2021-06-01,Yolo,113,214977,14049,14067,327,14394,210
2021-06-01,Yuba,115,75493,6096,6067,130,6197,48
2021-05-31,Alameda,001,1643700,88406,88458,1975,90433,1253
2021-05-31,Alpine,003,1148,87,88,0,88,0
2021-05-31,Amador,005,37829,3691,3687,33,3720,46
2021-05-31,Butte,007,227075,12596,12429,1831,14260,193
2021-05-31,Calaveras,009,45235,2175,2171,14,2185,55
2021-05-31,Colusa,011,21464,1955,1956,314,2270,15
2021-05-31,Contra Costa,013,1133247,69902,69390,1290,70680,813
2021-05-31,Del Norte,015,27424,1419,1394,13,1407,8
2021-05-31,El Dorado,017,186661,10322,10271,731,11002,110
2021-05-31,Fresno,019,978130,102929,102507,8747,111254,1706
2021-05-31,Glenn,021,27897,2438,2422,565,2987,18
2021-05-31,Humboldt,023,135768,4308,4295,38,4333,42
2021-05-31,Imperial,025,180216,28652,28732,2883,31615,736
2021-05-31,Inyo,027,18085,1403,1403,12,1415,35
2021-05-31,Kern,029,883053,97443,96457,10995,107452,1319
2021-05-31,Kings,031,150075,23194,22977,1097,24074,244
2021-05-31,Lake,033,64148,3536,3523,9,3532,45
2021-05-31,Lassen,035,31185,5221,5172,115,5287,6
2021-05-31,Los Angeles,037,10098052,1205724,1202567,41810,1244377,24364
2021-05-31,Madera,039,155013,16650,16543,940,17483,240
2021-05-31,Marin,041,260295,14125,14080,264,14344,229
2021-05-31,Mariposa,043,17540,435,430,11,441,5
2021-05-31,Mendocino,045,87422,4035,3961,81,4042,47
2021-05-31,Merced,047,269075,31131,31194,992,32186,456
2021-05-31,Modoc,049,8938,382,374,132,506,3
2021-05-31,Mono,051,14174,1261,1275,17,1292,3
2021-05-31,Monterey,053,433212,43234,43051,1884,44935,379
2021-05-31,Napa,055,140530,9926,9948,38,9986,82
2021-05-31,Nevada,057,99092,4851,4823,192,5015,72
2021-05-31,Orange,059,3164182,255577,254572,11402,265974,5051
2021-05-31,Placer,061,380077,23365,23019,1512,24531,293
2021-05-31,Plumas,063,18699,710,690,11,701,4
2021-05-31,Riverside,065,2383286,294425,288970,14073,303043,4442
2021-05-31,Sacramento,067,1510023,106583,106278,1796,108074,1644
2021-05-31,San Benito,069,59416,6067,6072,115,6187,63
2021-05-31,San Bernardino,071,2135413,293569,292973,9004,301977,4758
2021-05-31,San Diego,073,3302833,281107,280254,15001,295255,3756
2021-05-31,San Francisco,075,870044,36805,37022,1298,38320,550
2021-05-31,San Joaquin,077,732212,73343,72856,3592,76448,1383
2021-05-31,San Luis Obispo,079,281455,21471,21215,749,21964,256
2021-05-31,San Mateo,081,765935,42433,42389,475,42864,442
2021-05-31,Santa Barbara,083,443738,34406,34369,1197,35566,456
2021-05-31,Santa Clara,085,1922200,118774,119515,767,120282,2057
2021-05-31,Santa Cruz,087,273765,16239,16139,814,16953,207
2021-05-31,Shasta,089,179085,12389,12408,1590,13998,199
2021-05-31,Sierra,091,2930,57,55,12,67,0
2021-05-31,Siskiyou,093,43540,1940,1856,368,2224,21
2021-05-31,Solano,095,438530,32965,32973,558,33531,256
2021-05-31,Sonoma,097,501317,30214,30314,342,30656,322
2021-05-31,Stanislaus,099,539301,56519,56335,5962,62297,973
2021-05-31,Sutter,101,95872,9539,9523,88,9611,111
2021-05-31,Tehama,103,63373,5104,5076,585,5661,63
2021-05-31,Trinity,105,12862,483,328,95,423,3
2021-05-31,Tulare,107,460477,50290,49404,9109,58513,845
2021-05-31,Tuolumne,109,53932,4019,4095,40,4135,63
2021-05-31,Ventura,111,848112,81470,81017,3004,84021,1021
2021-05-31,Yolo,113,214977,14045,14064,327,14391,210
2021-05-31,Yuba,115,75493,6090,6063,127,6190,48
2021-05-30,Alameda,001,1643700,88383,88429,1975,90404,1253
2021-05-30,Alpine,003,1148,87,88,0,88,0
2021-05-30,Amador,005,37829,3687,3685,33,3718,46
2021-05-30,Butte,007,227075,12586,12427,1829,14256,190
2021-05-30,Calaveras,009,45235,2172,2166,14,2180,55
2021-05-30,Colusa,011,21464,1955,1954,314,2268,15
2021-05-30,Contra Costa,013,1133247,69868,69381,1288,70669,813
2021-05-30,Del Norte,015,27424,1418,1393,13,1406,8
2021-05-30,El Dorado,017,186661,10319,10271,731,11002,110
2021-05-30,Fresno,019,978130,102912,102499,8743,111242,1706
2021-05-30,Glenn,021,27897,2438,2422,564,2986,18
2021-05-30,Humboldt,023,135768,4300,4291,38,4329,42
2021-05-30,Imperial,025,180216,28647,28732,2882,31614,736
2021-05-30,Inyo,027,18085,1403,1403,12,1415,35
2021-05-30,Kern,029,883053,97427,96443,10992,107435,1319
2021-05-30,Kings,031,150075,23193,22974,1096,24070,244
2021-05-30,Lake,033,64148,3536,3517,9,3526,45
2021-05-30,Lassen,035,31185,5219,5171,115,5286,6
2021-05-30,Los Angeles,037,10098052,1205616,1202425,41803,1244228,24360
2021-05-30,Madera,039,155013,16646,16538,940,17478,240
2021-05-30,Marin,041,260295,14121,14083,263,14346,229
2021-05-30,Mariposa,043,17540,435,430,11,441,5
2021-05-30,Mendocino,045,87422,4028,3955,81,4036,47
2021-05-30,Merced,047,269075,31127,31189,991,32180,456
2021-05-30,Modoc,049,8938,382,374,132,506,3
2021-05-30,Mono,051,14174,1261,1275,17,1292,3
2021-05-30,Monterey,053,433212,43231,43049,1884,44933,379
2021-05-30,Napa,055,140530,9925,9948,38,9986,82
2021-05-30,Nevada,057,99092,4845,4818,192,5010,72
2021-05-30,Orange,059,3164182,255554,254559,11401,265960,5051
2021-05-30,Placer,061,380077,23359,23016,1512,24528,293
2021-05-30,Plumas,063,18699,708,690,11,701,4
2021-05-30,Riverside,065,2383286,294404,288961,14071,303032,4442
2021-05-30,Sacramento,067,1510023,106538,106252,1794,108046,1644
2021-05-30,San Benito,069,59416,6067,6072,115,6187,63
2021-05-30,San Bernardino,071,2135413,293543,292981,9003,301984,4758
2021-05-30,San Diego,073,3302833,281051,280209,14996,295205,3756
2021-05-30,San Francisco,075,870044,36786,37016,1298,38314,550
2021-05-30,San Joaquin,077,732212,73326,72853,3591,76444,1383
2021-05-30,San Luis Obispo,079,281455,21462,21211,748,21959,256
2021-05-30,San Mateo,081,765935,42425,42386,475,42861,439
2021-05-30,Santa Barbara,083,443738,34402,34369,1197,35566,456
2021-05-30,Santa Clara,085,1922200,118752,119510,763,120273,2057
2021-05-30,Santa Cruz,087,273765,16237,16140,814,16954,207
2021-05-30,Shasta,089,179085,12387,12408,1587,13995,199
2021-05-30,Sierra,091,2930,57,55,12,67,0
2021-05-30,Siskiyou,093,43540,1940,1856,368,2224,21
2021-05-30,Solano,095,438530,32954,32952,557,33509,256
2021-05-30,Sonoma,097,501317,30197,30310,341,30651,322
2021-05-30,Stanislaus,099,539301,56507,56323,5961,62284,973
2021-05-30,Sutter,101,95872,9538,9519,87,9606,111
2021-05-30,Tehama,103,63373,5104,5073,585,5658,63
2021-05-30,Trinity,105,12862,483,328,95,423,3
2021-05-30,Tulare,107,460477,50283,49397,9100,58497,845
2021-05-30,Tuolumne,109,53932,4019,4094,40,4134,63
2021-05-30,Ventura,111,848112,81466,81012,3003,84015,1021
2021-05-30,Yolo,113,214977,14040,14059,326,14385,210
2021-05-30,Yuba,115,75493,6083,6063,126,6189,48
2021-05-29,Alameda,001,1643700,88360,88433,1973,90406,1253
2021-05-29,Alpine,003,1148,87,88,0,88,0
2021-05-29,Amador,005,37829,3686,3683,33,3716,46
2021-05-29,Butte,007,227075,12580,12425,1829,14254,190
2021-05-29,Calaveras,009,45235,2171,2166,14,2180,55
2021-05-29,Colusa,011,21464,1952,1954,314,2268,15
2021-05-29,Contra Costa,013,1133247,69835,69351,1288,70639,813
2021-05-29,Del Norte,015,27424,1418,1391,13,1404,8
2021-05-29,El Dorado,017,186661,10318,10269,729,10998,110
2021-05-29,Fresno,019,978130,102900,102470,8740,111210,1706
2021-05-29,Glenn,021,27897,2438,2422,563,2985,18
2021-05-29,Humboldt,023,135768,4294,4283,38,4321,42
2021-05-29,Imperial,025,180216,28644,28729,2881,31610,736
2021-05-29,Inyo,027,18085,1403,1404,12,1416,35
2021-05-29,Kern,029,883053,97416,96424,10979,107403,1319
2021-05-29,Kings,031,150075,23192,22970,1095,24065,244
2021-05-29,Lake,033,64148,3536,3515,9,3524,45
2021-05-29,Lassen,035,31185,5219,5171,115,5286,6
2021-05-29,Los Angeles,037,10098052,1205493,1202264,41799,1244063,24359
2021-05-29,Madera,039,155013,16644,16535,940,17475,240
2021-05-29,Marin,041,260295,14117,14071,262,14333,229
2021-05-29,Mariposa,043,17540,434,428,11,439,5
2021-05-29,Mendocino,045,87422,4022,3952,81,4033,47
2021-05-29,Merced,047,269075,31115,31187,991,32178,456
2021-05-29,Modoc,049,8938,382,374,132,506,3
2021-05-29,Mono,051,14174,1261,1275,17,1292,3
2021-05-29,Monterey,053,433212,43229,43042,1884,44926,379
2021-05-29,Napa,055,140530,9922,9948,38,9986,82
2021-05-29,Nevada,057,99092,4844,4816,192,5008,72
2021-05-29,Orange,059,3164182,255532,254537,11391,265928,5049
2021-05-29,Placer,061,380077,23344,23009,1511,24520,293
2021-05-29,Plumas,063,18699,708,689,11,700,4
2021-05-29,Riverside,065,2383286,294384,288908,14070,302978,4442
2021-05-29,Sacramento,067,1510023,106508,106218,1793,108011,1643
2021-05-29,San Benito,069,59416,6066,6072,115,6187,63
2021-05-29,San Bernardino,071,2135413,293511,292961,9002,301963,4757
2021-05-29,San Diego,073,3302833,280992,280151,14991,295142,3756
2021-05-29,San Francisco,075,870044,36777,37008,1298,38306,550
2021-05-29,San Joaquin,077,732212,73310,72827,3589,76416,1383
2021-05-29,San Luis Obispo,079,281455,21460,21201,748,21949,256
2021-05-29,San Mateo,081,765935,42417,42375,474,42849,439
2021-05-29,Santa Barbara,083,443738,34398,34367,1197,35564,456
2021-05-29,Santa Clara,085,1922200,118728,119498,762,120260,2056
2021-05-29,Santa Cruz,087,273765,16236,16137,814,16951,207
2021-05-29,Shasta,089,179085,12379,12401,1586,13987,199
2021-05-29,Sierra,091,2930,57,55,12,67,0
2021-05-29,Siskiyou,093,43540,1935,1856,368,2224,21
2021-05-29,Solano,095,438530,32945,32917,557,33474,256
2021-05-29,Sonoma,097,501317,30174,30298,340,30638,322
2021-05-29,Stanislaus,099,539301,56489,56305,5959,62264,974
2021-05-29,Sutter,101,95872,9534,9516,87,9603,111
2021-05-29,Tehama,103,63373,5103,5070,585,5655,63
2021-05-29,Trinity,105,12862,483,328,95,423,3
2021-05-29,Tulare,107,460477,50273,49392,9096,58488,845
2021-05-29,Tuolumne,109,53932,4019,4093,40,4133,63
2021-05-29,Ventura,111,848112,81458,81008,3003,84011,1021
2021-05-29,Yolo,113,214977,14039,14055,326,14381,210
2021-05-29,Yuba,115,75493,6083,6059,126,6185,48
2021-05-28,Alameda,001,1643700,88336,88391,1969,90360,1261
2021-05-28,Alpine,003,1148,87,88,0,88,0
2021-05-28,Amador,005,37829,3686,3680,33,3713,46
2021-05-28,Butte,007,227075,12577,12407,1828,14235,190
2021-05-28,Calaveras,009,45235,2171,2165,14,2179,55
2021-05-28,Colusa,011,21464,1952,1954,312,2266,15
2021-05-28,Contra Costa,013,1133247,69799,69290,1287,70577,813
2021-05-28,Del Norte,015,27424,1417,1390,13,1403,8
2021-05-28,El Dorado,017,186661,10315,10265,729,10994,110
2021-05-28,Fresno,019,978130,102885,102437,8740,111177,1705
2021-05-28,Glenn,021,27897,2438,2419,563,2982,18
2021-05-28,Humboldt,023,135768,4287,4265,38,4303,42
2021-05-28,Imperial,025,180216,28641,28722,2881,31603,736
2021-05-28,Inyo,027,18085,1403,1404,12,1416,35
2021-05-28,Kern,029,883053,97399,96396,10971,107367,1320
2021-05-28,Kings,031,150075,23190,22962,1095,24057,244
2021-05-28,Lake,033,64148,3534,3515,9,3524,45
2021-05-28,Lassen,035,31185,5219,5169,115,5284,6
2021-05-28,Los Angeles,037,10098052,1205383,1202103,41788,1243891,24357
2021-05-28,Madera,039,155013,16642,16530,940,17470,240
2021-05-28,Marin,041,260295,14116,14063,261,14324,229
2021-05-28,Mariposa,043,17540,434,428,11,439,5
2021-05-28,Mendocino,045,87422,4017,3947,81,4028,47
2021-05-28,Merced,047,269075,31112,31176,991,32167,455
2021-05-28,Modoc,049,8938,382,374,132,506,3
2021-05-28,Mono,051,14174,1261,1274,17,1291,3
2021-05-28,Monterey,053,433212,43228,43036,1884,44920,379
2021-05-28,Napa,055,140530,9922,9941,38,9979,82
2021-05-28,Nevada,057,99092,4842,4813,192,5005,71
2021-05-28,Orange,059,3164182,255512,254494,11389,265883,5047
2021-05-28,Placer,061,380077,23334,22987,1509,24496,293
2021-05-28,Plumas,063,18699,706,688,11,699,4
2021-05-28,Riverside,065,2383286,294362,288872,14068,302940,4442
2021-05-28,Sacramento,067,1510023,106452,106131,1791,107922,1642
2021-05-28,San Benito,069,59416,6066,6074,115,6189,63
2021-05-28,San Bernardino,071,2135413,293488,292905,9002,301907,4757
2021-05-28,San Diego,073,3302833,280929,280043,14980,295023,3756
2021-05-28,San Francisco,075,870044,36771,36987,1298,38285,546
2021-05-28,San Joaquin,077,732212,73280,72793,3587,76380,1383
2021-05-28,San Luis Obispo,079,281455,21455,21190,746,21936,256
2021-05-28,San Mateo,081,765935,42411,42364,474,42838,439
2021-05-28,Santa Barbara,083,443738,34397,34371,1197,35568,455
2021-05-28,Santa Clara,085,1922200,118704,119462,762,120224,2056
2021-05-28,Santa Cruz,087,273765,16235,16129,814,16943,207
2021-05-28,Shasta,089,179085,12370,12383,1584,13967,198
2021-05-28,Sierra,091,2930,57,54,12,66,0
2021-05-28,Siskiyou,093,43540,1933,1850,368,2218,19
2021-05-28,Solano,095,438530,32930,32892,557,33449,256
2021-05-28,Sonoma,097,501317,30155,30270,340,30610,321
2021-05-28,Stanislaus,099,539301,56471,56278,5956,62234,974
2021-05-28,Sutter,101,95872,9530,9511,87,9598,111
2021-05-28,Tehama,103,63373,5097,5064,585,5649,63
2021-05-28,Trinity,105,12862,483,328,95,423,3
2021-05-28,Tulare,107,460477,50268,49375,9087,58462,846
2021-05-28,Tuolumne,109,53932,4019,4090,40,4130,63
2021-05-28,Ventura,111,848112,81447,80985,3002,83987,1021
2021-05-28,Yolo,113,214977,14036,14050,325,14375,210
2021-05-28,Yuba,115,75493,6081,6050,125,6175,48
2021-05-27,Alameda,001,1643700,88301,88342,1968,90310,1274
2021-05-27,Alpine,003,1148,87,88,0,88,0
2021-05-27,Amador,005,37829,3683,3680,33,3713,46
2021-05-27,Butte,007,227075,12571,12401,1827,14228,190
2021-05-27,Calaveras,009,45235,2169,2163,14,2177,55
2021-05-27,Colusa,011,21464,1949,1952,312,2264,15
2021-05-27,Contra Costa,013,1133247,69757,69245,1285,70530,813
2021-05-27,Del Norte,015,27424,1417,1388,13,1401,8
2021-05-27,El Dorado,017,186661,10314,10248,729,10977,112
2021-05-27,Fresno,019,978130,102868,102413,8737,111150,1704
2021-05-27,Glenn,021,27897,2438,2415,563,2978,18
2021-05-27,Humboldt,023,135768,4279,4260,38,4298,42
2021-05-27,Imperial,025,180216,28630,28728,2880,31608,736
2021-05-27,Inyo,027,18085,1403,1404,12,1416,35
2021-05-27,Kern,029,883053,97383,96364,10963,107327,1322
2021-05-27,Kings,031,150075,23187,22953,1095,24048,245
2021-05-27,Lake,033,64148,3529,3509,9,3518,45
2021-05-27,Lassen,035,31185,5218,5170,114,5284,6
2021-05-27,Los Angeles,037,10098052,1205221,1201927,41772,1243699,24348
2021-05-27,Madera,039,155013,16633,16527,940,17467,240
2021-05-27,Marin,041,260295,14112,14061,261,14322,229
2021-05-27,Mariposa,043,17540,432,427,11,438,5
2021-05-27,Mendocino,045,87422,4011,3945,81,4026,47
2021-05-27,Merced,047,269075,31100,31161,991,32152,455
2021-05-27,Modoc,049,8938,381,374,132,506,3
2021-05-27,Mono,051,14174,1261,1276,17,1293,3
2021-05-27,Monterey,053,433212,43222,43032,1884,44916,379
2021-05-27,Napa,055,140530,9921,9934,38,9972,82
2021-05-27,Nevada,057,99092,4838,4807,190,4997,71
2021-05-27,Orange,059,3164182,255475,254438,11385,265823,5059
2021-05-27,Placer,061,380077,23325,22966,1509,24475,293
2021-05-27,Plumas,063,18699,706,687,11,698,4
2021-05-27,Riverside,065,2383286,294326,288835,14063,302898,4443
2021-05-27,Sacramento,067,1510023,106376,106015,1788,107803,1642
2021-05-27,San Benito,069,59416,6065,6074,115,6189,63
2021-05-27,San Bernardino,071,2135413,293452,292755,9000,301755,4756
2021-05-27,San Diego,073,3302833,280855,279960,14966,294926,3756
2021-05-27,San Francisco,075,870044,36765,36980,1295,38275,546
2021-05-27,San Joaquin,077,732212,73248,72714,3583,76297,1388
2021-05-27,San Luis Obispo,079,281455,21450,21171,746,21917,256
2021-05-27,San Mateo,081,765935,42402,42345,474,42819,436
2021-05-27,Santa Barbara,083,443738,34392,34355,1197,35552,456
2021-05-27,Santa Clara,085,1922200,118683,119452,762,120214,2053
2021-05-27,Santa Cruz,087,273765,16232,16134,814,16948,207
2021-05-27,Shasta,089,179085,12359,12380,1584,13964,202
2021-05-27,Sierra,091,2930,57,54,12,66,0
2021-05-27,Siskiyou,093,43540,1930,1846,368,2214,18
2021-05-27,Solano,095,438530,32889,32855,556,33411,257
2021-05-27,Sonoma,097,501317,30128,30253,336,30589,321
2021-05-27,Stanislaus,099,539301,56446,56207,5955,62162,974
2021-05-27,Sutter,101,95872,9526,9501,87,9588,111
2021-05-27,Tehama,103,63373,5094,5064,584,5648,63
2021-05-27,Trinity,105,12862,483,328,95,423,3
2021-05-27,Tulare,107,460477,50254,49366,9078,58444,840
2021-05-27,Tuolumne,109,53932,4018,4090,40,4130,66
2021-05-27,Ventura,111,848112,81434,80965,2999,83964,1023
2021-05-27,Yolo,113,214977,14033,14036,325,14361,213
2021-05-27,Yuba,115,75493,6076,6040,124,6164,48
2021-05-26,Alameda,001,1643700,88272,88297,1968,90265,1266
2021-05-26,Alpine,003,1148,87,88,0,88,0
2021-05-26,Amador,005,37829,3683,3679,33,3712,46
2021-05-26,Butte,007,227075,12562,12332,1826,14158,190
2021-05-26,Calaveras,009,45235,2168,2154,14,2168,55
2021-05-26,Colusa,011,21464,1948,1952,312,2264,15
2021-05-26,Contra Costa,013,1133247,69720,69210,1285,70495,812
2021-05-26,Del Norte,015,27424,1417,1386,12,1398,8
2021-05-26,El Dorado,017,186661,10310,10242,728,10970,112
2021-05-26,Fresno,019,978130,102836,102374,8732,111106,1702
2021-05-26,Glenn,021,27897,2437,2415,563,2978,18
2021-05-26,Humboldt,023,135768,4274,4246,38,4284,42
2021-05-26,Imperial,025,180216,28625,28712,2878,31590,734
2021-05-26,Inyo,027,18085,1403,1403,12,1415,36
2021-05-26,Kern,029,883053,97358,96343,10956,107299,1320
2021-05-26,Kings,031,150075,23183,22950,1094,24044,245
2021-05-26,Lake,033,64148,3528,3508,9,3517,45
2021-05-26,Lassen,035,31185,5217,5164,114,5278,6
2021-05-26,Los Angeles,037,10098052,1205055,1198100,41755,1239855,24221
2021-05-26,Madera,039,155013,16630,16520,940,17460,240
2021-05-26,Marin,041,260295,14109,14061,260,14321,227
2021-05-26,Mariposa,043,17540,432,427,11,438,5
2021-05-26,Mendocino,045,87422,4005,3938,81,4019,47
2021-05-26,Merced,047,269075,31091,31139,991,32130,455
2021-05-26,Modoc,049,8938,381,371,131,502,3
2021-05-26,Mono,051,14174,1261,1274,17,1291,3
2021-05-26,Monterey,053,433212,43216,43018,1883,44901,379
2021-05-26,Napa,055,140530,9914,9932,36,9968,82
2021-05-26,Nevada,057,99092,4833,4803,190,4993,70
2021-05-26,Orange,059,3164182,255439,254368,11382,265750,5058
2021-05-26,Placer,061,380077,23301,22940,1509,24449,293
2021-05-26,Plumas,063,18699,705,685,11,696,4
2021-05-26,Riverside,065,2383286,294280,288782,14056,302838,4443
2021-05-26,Sacramento,067,1510023,106290,105919,1784,107703,1637
2021-05-26,San Benito,069,59416,6065,6074,115,6189,63
2021-05-26,San Bernardino,071,2135413,293417,292662,8999,301661,4755
2021-05-26,San Diego,073,3302833,280780,279859,14956,294815,3755
2021-05-26,San Francisco,075,870044,36753,36954,1295,38249,546
2021-05-26,San Joaquin,077,732212,73206,72681,3580,76261,1388
2021-05-26,San Luis Obispo,079,281455,21444,21163,746,21909,256
2021-05-26,San Mateo,081,765935,42393,42331,474,42805,436
2021-05-26,Santa Barbara,083,443738,34383,34348,1197,35545,459
2021-05-26,Santa Clara,085,1922200,118656,119421,761,120182,2031
2021-05-26,Santa Cruz,087,273765,16231,16139,814,16953,207
2021-05-26,Shasta,089,179085,12345,12357,1581,13938,202
2021-05-26,Sierra,091,2930,57,54,12,66,0
2021-05-26,Siskiyou,093,43540,1928,1847,366,2213,18
2021-05-26,Solano,095,438530,32853,32831,556,33387,257
2021-05-26,Sonoma,097,501317,30102,30230,336,30566,321
2021-05-26,Stanislaus,099,539301,56424,56193,5952,62145,974
2021-05-26,Sutter,101,95872,9521,9495,87,9582,112
2021-05-26,Tehama,103,63373,5093,5054,581,5635,63
2021-05-26,Trinity,105,12862,483,328,95,423,3
2021-05-26,Tulare,107,460477,50247,49352,9074,58426,839
2021-05-26,Tuolumne,109,53932,4014,4088,39,4127,66
2021-05-26,Ventura,111,848112,81411,80944,2997,83941,1023
2021-05-26,Yolo,113,214977,14030,14025,325,14350,213
2021-05-26,Yuba,115,75493,6071,6036,124,6160,49
2021-05-25,Alameda,001,1643700,88241,88237,1968,90205,1263
2021-05-25,Alpine,003,1148,87,88,0,88,0
2021-05-25,Amador,005,37829,3678,3676,33,3709,46
2021-05-25,Butte,007,227075,12551,12295,1825,14120,189
2021-05-25,Calaveras,009,45235,2166,2148,14,2162,55
2021-05-25,Colusa,011,21464,1947,1949,312,2261,15
2021-05-25,Contra Costa,013,1133247,69667,69167,1280,70447,809
2021-05-25,Del Norte,015,27424,1417,1385,12,1397,8
2021-05-25,El Dorado,017,186661,10303,10240,727,10967,112
2021-05-25,Fresno,019,978130,102814,102329,8730,111059,1701
2021-05-25,Glenn,021,27897,2436,2414,562,2976,17
2021-05-25,Humboldt,023,135768,4267,4231,36,4267,42
2021-05-25,Imperial,025,180216,28618,28586,2878,31464,735
2021-05-25,Inyo,027,18085,1403,1402,12,1414,36
2021-05-25,Kern,029,883053,97327,96319,10942,107261,1319
2021-05-25,Kings,031,150075,23176,22944,1094,24038,245
2021-05-25,Lake,033,64148,3527,3508,9,3517,44
2021-05-25,Lassen,035,31185,5213,5164,114,5278,6
2021-05-25,Los Angeles,037,10098052,1204875,1197940,41736,1239676,24212
2021-05-25,Madera,039,155013,16625,16519,939,17458,240
2021-05-25,Marin,041,260295,14103,14053,260,14313,227
2021-05-25,Mariposa,043,17540,431,427,11,438,5
2021-05-25,Mendocino,045,87422,4000,3928,81,4009,47
2021-05-25,Merced,047,269075,31070,31132,991,32123,455
2021-05-25,Modoc,049,8938,380,367,131,498,3
2021-05-25,Mono,051,14174,1261,1274,17,1291,3
2021-05-25,Monterey,053,433212,43212,43012,1882,44894,379
2021-05-25,Napa,055,140530,9912,9926,36,9962,82
2021-05-25,Nevada,057,99092,4827,4795,190,4985,70
2021-05-25,Orange,059,3164182,255410,254321,11381,265702,5057
2021-05-25,Placer,061,380077,23290,22920,1507,24427,292
2021-05-25,Plumas,063,18699,705,684,11,695,4
2021-05-25,Riverside,065,2383286,294241,288725,14053,302778,4443
2021-05-25,Sacramento,067,1510023,106209,105828,1780,107608,1633
2021-05-25,San Benito,069,59416,6065,6073,115,6188,63
2021-05-25,San Bernardino,071,2135413,293357,292485,8997,301482,4755
2021-05-25,San Diego,073,3302833,280700,279786,14951,294737,3753
2021-05-25,San Francisco,075,870044,36730,36939,1295,38234,546
2021-05-25,San Joaquin,077,732212,73164,72628,3577,76205,1387
2021-05-25,San Luis Obispo,079,281455,21441,21153,746,21899,256
2021-05-25,San Mateo,081,765935,42383,42268,474,42742,435
2021-05-25,Santa Barbara,083,443738,34380,34337,1197,35534,459
2021-05-25,Santa Clara,085,1922200,118632,119393,760,120153,2032
2021-05-25,Santa Cruz,087,273765,16226,16141,814,16955,207
2021-05-25,Shasta,089,179085,12336,12328,1579,13907,202
2021-05-25,Sierra,091,2930,56,54,12,66,0
2021-05-25,Siskiyou,093,43540,1927,1845,365,2210,18
2021-05-25,Solano,095,438530,32834,32817,555,33372,256
2021-05-25,Sonoma,097,501317,30073,30207,335,30542,321
2021-05-25,Stanislaus,099,539301,56388,56168,5950,62118,974
2021-05-25,Sutter,101,95872,9517,9495,87,9582,112
2021-05-25,Tehama,103,63373,5091,5048,580,5628,63
2021-05-25,Trinity,105,12862,483,328,94,422,3
2021-05-25,Tulare,107,460477,50237,49326,9066,58392,838
2021-05-25,Tuolumne,109,53932,4014,4084,39,4123,66
2021-05-25,Ventura,111,848112,81393,80905,2997,83902,1022
2021-05-25,Yolo,113,214977,14022,14018,323,14341,213
2021-05-25,Yuba,115,75493,6064,6028,124,6152,49
2021-05-24,Alameda,001,1643700,88199,88182,1967,90149,1263
2021-05-24,Alpine,003,1148,87,88,0,88,0
2021-05-24,Amador,005,37829,3676,3675,33,3708,46
2021-05-24,Butte,007,227075,12538,12279,1822,14101,189
2021-05-24,Calaveras,009,45235,2164,2146,14,2160,54
2021-05-24,Colusa,011,21464,1947,1949,312,2261,15
2021-05-24,Contra Costa,013,1133247,69626,69107,1276,70383,809
2021-05-24,Del Norte,015,27424,1416,1384,12,1396,8
2021-05-24,El Dorado,017,186661,10293,10227,726,10953,112
2021-05-24,Fresno,019,978130,102772,102289,8729,111018,1698
2021-05-24,Glenn,021,27897,2436,2413,562,2975,17
2021-05-24,Humboldt,023,135768,4260,4225,36,4261,42
2021-05-24,Imperial,025,180216,28616,28575,2877,31452,735
2021-05-24,Inyo,027,18085,1403,1402,12,1414,36
2021-05-24,Kern,029,883053,97300,96296,10937,107233,1319
2021-05-24,Kings,031,150075,23172,22940,1094,24034,246
2021-05-24,Lake,033,64148,3525,3506,9,3515,43
2021-05-24,Lassen,035,31185,5209,5163,114,5277,6
2021-05-24,Los Angeles,037,10098052,1204701,1197782,41721,1239503,24201
2021-05-24,Madera,039,155013,16621,16513,938,17451,239
2021-05-24,Marin,041,260295,14101,14051,260,14311,227
2021-05-24,Mariposa,043,17540,430,427,11,438,5
2021-05-24,Mendocino,045,87422,3998,3919,81,4000,47
2021-05-24,Merced,047,269075,31060,31128,990,32118,455
2021-05-24,Modoc,049,8938,380,366,130,496,3
2021-05-24,Mono,051,14174,1261,1270,17,1287,3
2021-05-24,Monterey,053,433212,43207,43005,1881,44886,379
2021-05-24,Napa,055,140530,9912,9924,36,9960,82
2021-05-24,Nevada,057,99092,4824,4790,190,4980,70
2021-05-24,Orange,059,3164182,255376,254287,11371,265658,5056
2021-05-24,Placer,061,380077,23271,22895,1506,24401,292
2021-05-24,Plumas,063,18699,704,683,11,694,4
2021-05-24,Riverside,065,2383286,294184,288669,14043,302712,4442
2021-05-24,Sacramento,067,1510023,106094,105716,1778,107494,1632
2021-05-24,San Benito,069,59416,6065,6072,115,6187,63
2021-05-24,San Bernardino,071,2135413,293317,292343,8996,301339,4747
2021-05-24,San Diego,073,3302833,280591,279715,14941,294656,3749
2021-05-24,San Francisco,075,870044,36710,36934,1293,38227,547
2021-05-24,San Joaquin,077,732212,73132,72586,3576,76162,1371
2021-05-24,San Luis Obispo,079,281455,21423,21146,745,21891,256
2021-05-24,San Mateo,081,765935,42373,42249,474,42723,433
2021-05-24,Santa Barbara,083,443738,34375,34322,1197,35519,459
2021-05-24,Santa Clara,085,1922200,118600,119358,760,120118,2030
2021-05-24,Santa Cruz,087,273765,16221,16135,814,16949,207
2021-05-24,Shasta,089,179085,12319,12315,1576,13891,201
2021-05-24,Sierra,091,2930,56,54,12,66,0
2021-05-24,Siskiyou,093,43540,1924,1840,365,2205,17
2021-05-24,Solano,095,438530,32809,32792,554,33346,254
2021-05-24,Sonoma,097,501317,30058,30187,335,30522,321
2021-05-24,Stanislaus,099,539301,56354,56128,5946,62074,974
2021-05-24,Sutter,101,95872,9511,9486,87,9573,113
2021-05-24,Tehama,103,63373,5088,5043,578,5621,63
2021-05-24,Trinity,105,12862,483,328,94,422,3
2021-05-24,Tulare,107,460477,50230,49318,9062,58380,838
2021-05-24,Tuolumne,109,53932,4014,4083,39,4122,65
2021-05-24,Ventura,111,848112,81380,80876,2995,83871,1022
2021-05-24,Yolo,113,214977,14005,14012,321,14333,213
2021-05-24,Yuba,115,75493,6055,6022,124,6146,49
2021-05-23,Alameda,001,1643700,88135,88157,1964,90121,1263
2021-05-23,Alpine,003,1148,87,88,0,88,0
2021-05-23,Amador,005,37829,3675,3673,33,3706,46
2021-05-23,Butte,007,227075,12524,12271,1821,14092,189
2021-05-23,Calaveras,009,45235,2156,2144,14,2158,54
2021-05-23,Colusa,011,21464,1947,1949,310,2259,15
2021-05-23,Contra Costa,013,1133247,69581,69075,1274,70349,809
2021-05-23,Del Norte,015,27424,1412,1383,12,1395,8
2021-05-23,El Dorado,017,186661,10287,10222,726,10948,112
2021-05-23,Fresno,019,978130,102726,102270,8724,110994,1698
2021-05-23,Glenn,021,27897,2434,2413,562,2975,17
2021-05-23,Humboldt,023,135768,4243,4216,36,4252,42
2021-05-23,Imperial,025,180216,28610,28569,2874,31443,735
2021-05-23,Inyo,027,18085,1403,1402,12,1414,36
2021-05-23,Kern,029,883053,97276,96282,10929,107211,1319
2021-05-23,Kings,031,150075,23159,22939,1092,24031,246
2021-05-23,Lake,033,64148,3522,3504,9,3513,43
2021-05-23,Lassen,035,31185,5205,5163,113,5276,6
2021-05-23,Los Angeles,037,10098052,1204513,1197633,41709,1239342,24197
2021-05-23,Madera,039,155013,16615,16504,938,17442,239
2021-05-23,Marin,041,260295,14092,14048,259,14307,227
2021-05-23,Mariposa,043,17540,430,427,11,438,5
2021-05-23,Mendocino,045,87422,3992,3913,80,3993,47
2021-05-23,Merced,047,269075,31050,31118,990,32108,455
2021-05-23,Modoc,049,8938,376,366,130,496,3
2021-05-23,Mono,051,14174,1260,1270,17,1287,3
2021-05-23,Monterey,053,433212,43197,43003,1881,44884,379
2021-05-23,Napa,055,140530,9908,9923,36,9959,82
2021-05-23,Nevada,057,99092,4814,4790,190,4980,70
2021-05-23,Orange,059,3164182,255338,254277,11365,265642,5050
2021-05-23,Placer,061,380077,23251,22888,1506,24394,292
2021-05-23,Plumas,063,18699,703,683,11,694,4
2021-05-23,Riverside,065,2383286,294116,288641,14039,302680,4442
2021-05-23,Sacramento,067,1510023,105978,105663,1775,107438,1632
2021-05-23,San Benito,069,59416,6064,6072,115,6187,63
2021-05-23,San Bernardino,071,2135413,293266,292327,8995,301322,4747
2021-05-23,San Diego,073,3302833,280501,279690,14930,294620,3751
2021-05-23,San Francisco,075,870044,36699,36927,1292,38219,547
2021-05-23,San Joaquin,077,732212,73083,72571,3573,76144,1371
2021-05-23,San Luis Obispo,079,281455,21413,21141,744,21885,256
2021-05-23,San Mateo,081,765935,42356,42248,474,42722,433
2021-05-23,Santa Barbara,083,443738,34368,34319,1197,35516,459
2021-05-23,Santa Clara,085,1922200,118576,119333,760,120093,2030
2021-05-23,Santa Cruz,087,273765,16218,16130,814,16944,207
2021-05-23,Shasta,089,179085,12302,12313,1572,13885,201
2021-05-23,Sierra,091,2930,56,54,12,66,0
2021-05-23,Siskiyou,093,43540,1919,1826,358,2184,17
2021-05-23,Solano,095,438530,32791,32780,553,33333,254
2021-05-23,Sonoma,097,501317,30029,30168,334,30502,321
2021-05-23,Stanislaus,099,539301,56306,56104,5943,62047,974
2021-05-23,Sutter,101,95872,9502,9479,87,9566,113
2021-05-23,Tehama,103,63373,5081,5041,576,5617,63
2021-05-23,Trinity,105,12862,483,328,94,422,3
2021-05-23,Tulare,107,460477,50216,49310,9058,58368,838
2021-05-23,Tuolumne,109,53932,4011,4081,39,4120,65
2021-05-23,Ventura,111,848112,81350,80872,2994,83866,1022
2021-05-23,Yolo,113,214977,13993,14004,318,14322,213
2021-05-23,Yuba,115,75493,6050,6017,124,6141,49
2021-05-22,Alameda,001,1643700,88109,88101,1964,90065,1263
2021-05-22,Alpine,003,1148,87,88,0,88,0
2021-05-22,Amador,005,37829,3674,3672,33,3705,46
2021-05-22,Butte,007,227075,12512,12265,1820,14085,189
2021-05-22,Calaveras,009,45235,2151,2141,14,2155,54
2021-05-22,Colusa,011,21464,1943,1949,309,2258,15
2021-05-22,Contra Costa,013,1133247,69548,69004,1273,70277,809
2021-05-22,Del Norte,015,27424,1411,1381,12,1393,8
2021-05-22,El Dorado,017,186661,10282,10215,726,10941,112
2021-05-22,Fresno,019,978130,102712,102238,8722,110960,1698
2021-05-22,Glenn,021,27897,2434,2412,562,2974,17
2021-05-22,Humboldt,023,135768,4234,4194,35,4229,42
2021-05-22,Imperial,025,180216,28601,28574,2873,31447,735
2021-05-22,Inyo,027,18085,1403,1402,12,1414,36
2021-05-22,Kern,029,883053,97264,96260,10922,107182,1319
2021-05-22,Kings,031,150075,23159,22936,1092,24028,246
2021-05-22,Lake,033,64148,3519,3502,9,3511,43
2021-05-22,Lassen,035,31185,5205,5163,113,5276,6
2021-05-22,Los Angeles,037,10098052,1204407,1197454,41700,1239154,24192
2021-05-22,Madera,039,155013,16612,16503,938,17441,239
2021-05-22,Marin,041,260295,14089,14043,259,14302,227
2021-05-22,Mariposa,043,17540,430,427,11,438,5
2021-05-22,Mendocino,045,87422,3986,3908,80,3988,47
2021-05-22,Merced,047,269075,31040,31099,990,32089,455
2021-05-22,Modoc,049,8938,376,366,130,496,3
2021-05-22,Mono,051,14174,1258,1270,17,1287,3
2021-05-22,Monterey,053,433212,43191,42998,1881,44879,379
2021-05-22,Napa,055,140530,9906,9918,36,9954,82
2021-05-22,Nevada,057,99092,4807,4787,189,4976,70
2021-05-22,Orange,059,3164182,255317,254238,11359,265597,5048
2021-05-22,Placer,061,380077,23237,22865,1505,24370,292
2021-05-22,Plumas,063,18699,702,683,11,694,4
2021-05-22,Riverside,065,2383286,294084,288580,14038,302618,4442
2021-05-22,Sacramento,067,1510023,105903,105551,1772,107323,1632
2021-05-22,San Benito,069,59416,6064,6071,115,6186,63
2021-05-22,San Bernardino,071,2135413,293241,292292,8995,301287,4747
2021-05-22,San Diego,073,3302833,280442,279614,14922,294536,3751
2021-05-22,San Francisco,075,870044,36689,36906,1290,38196,547
2021-05-22,San Joaquin,077,732212,73061,72528,3570,76098,1371
2021-05-22,San Luis Obispo,079,281455,21405,21134,743,21877,256
2021-05-22,San Mateo,081,765935,42346,42218,474,42692,433
2021-05-22,Santa Barbara,083,443738,34364,34313,1196,35509,459
2021-05-22,Santa Clara,085,1922200,118553,119292,760,120052,2030
2021-05-22,Santa Cruz,087,273765,16218,16125,814,16939,207
2021-05-22,Shasta,089,179085,12295,12307,1569,13876,201
2021-05-22,Sierra,091,2930,56,54,12,66,0
2021-05-22,Siskiyou,093,43540,1918,1824,357,2181,17
2021-05-22,Solano,095,438530,32778,32753,553,33306,254
2021-05-22,Sonoma,097,501317,30017,30154,334,30488,321
2021-05-22,Stanislaus,099,539301,56282,56069,5941,62010,974
2021-05-22,Sutter,101,95872,9497,9476,87,9563,113
2021-05-22,Tehama,103,63373,5080,5036,576,5612,63
2021-05-22,Trinity,105,12862,483,328,94,422,3
2021-05-22,Tulare,107,460477,50210,49299,9053,58352,838
2021-05-22,Tuolumne,109,53932,4011,4078,39,4117,65
2021-05-22,Ventura,111,848112,81346,80859,2994,83853,1022
2021-05-22,Yolo,113,214977,13991,13997,318,14315,213
2021-05-22,Yuba,115,75493,6047,6010,124,6134,49
2021-05-21,Alameda,001,1643700,88083,88041,1963,90004,1263
2021-05-21,Alpine,003,1148,87,88,0,88,0
2021-05-21,Amador,005,37829,3671,3672,33,3705,46
2021-05-21,Butte,007,227075,12505,12236,1818,14054,188
2021-05-21,Calaveras,009,45235,2149,2138,14,2152,54
2021-05-21,Colusa,011,21464,1943,1947,309,2256,15
2021-05-21,Contra Costa,013,1133247,69505,68965,1272,70237,810
2021-05-21,Del Norte,015,27424,1410,1376,12,1388,8
2021-05-21,El Dorado,017,186661,10278,10204,726,10930,112
2021-05-21,Fresno,019,978130,102684,102189,8720,110909,1698
2021-05-21,Glenn,021,27897,2433,2408,562,2970,17
2021-05-21,Humboldt,023,135768,4227,4175,35,4210,42
2021-05-21,Imperial,025,180216,28594,28572,2872,31444,732
2021-05-21,Inyo,027,18085,1403,1402,12,1414,36
2021-05-21,Kern,029,883053,97250,96233,10915,107148,1318
2021-05-21,Kings,031,150075,23159,22927,1092,24019,246
2021-05-21,Lake,033,64148,3517,3500,9,3509,43
2021-05-21,Lassen,035,31185,5204,5161,113,5274,6
2021-05-21,Los Angeles,037,10098052,1204296,1197263,41691,1238954,24180
2021-05-21,Madera,039,155013,16611,16500,937,17437,238
2021-05-21,Marin,041,260295,14084,14042,259,14301,227
2021-05-21,Mariposa,043,17540,429,427,11,438,5
2021-05-21,Mendocino,045,87422,3980,3897,80,3977,47
2021-05-21,Merced,047,269075,31032,31076,990,32066,455
2021-05-21,Modoc,049,8938,376,365,130,495,3
2021-05-21,Mono,051,14174,1258,1269,17,1286,3
2021-05-21,Monterey,053,433212,43189,42995,1881,44876,379
2021-05-21,Napa,055,140530,9902,9913,36,9949,82
2021-05-21,Nevada,057,99092,4806,4779,189,4968,70
2021-05-21,Orange,059,3164182,255298,254171,11357,265528,5042
2021-05-21,Placer,061,380077,23229,22853,1505,24358,292
2021-05-21,Plumas,063,18699,702,683,10,693,4
2021-05-21,Riverside,065,2383286,294057,288499,14031,302530,4442
2021-05-21,Sacramento,067,1510023,105836,105476,1769,107245,1632
2021-05-21,San Benito,069,59416,6064,6068,115,6183,63
2021-05-21,San Bernardino,071,2135413,293209,292205,8992,301197,4744
2021-05-21,San Diego,073,3302833,280371,279554,14912,294466,3748
2021-05-21,San Francisco,075,870044,36683,36879,1290,38169,546
2021-05-21,San Joaquin,077,732212,73041,72467,3568,76035,1371
2021-05-21,San Luis Obispo,079,281455,21399,21128,740,21868,256
2021-05-21,San Mateo,081,765935,42333,42163,473,42636,432
2021-05-21,Santa Barbara,083,443738,34359,34302,1196,35498,459
2021-05-21,Santa Clara,085,1922200,118526,119247,760,120007,2029
2021-05-21,Santa Cruz,087,273765,16214,16120,814,16934,207
2021-05-21,Shasta,089,179085,12278,12289,1567,13856,201
2021-05-21,Sierra,091,2930,56,54,12,66,0
2021-05-21,Siskiyou,093,43540,1917,1815,357,2172,16
2021-05-21,Solano,095,438530,32763,32742,553,33295,254
2021-05-21,Sonoma,097,501317,30004,30126,334,30460,321
2021-05-21,Stanislaus,099,539301,56253,56036,5939,61975,975
2021-05-21,Sutter,101,95872,9495,9470,87,9557,113
2021-05-21,Tehama,103,63373,5074,5030,576,5606,63
2021-05-21,Trinity,105,12862,483,329,93,422,3
2021-05-21,Tulare,107,460477,50205,49271,9051,58322,838
2021-05-21,Tuolumne,109,53932,4009,4079,39,4118,65
2021-05-21,Ventura,111,848112,81338,80821,2991,83812,1021
2021-05-21,Yolo,113,214977,13984,13983,318,14301,213
2021-05-21,Yuba,115,75493,6041,6006,124,6130,49
2021-05-20,Alameda,001,1643700,88039,87975,1962,89937,1264
2021-05-20,Alpine,003,1148,87,88,0,88,0
2021-05-20,Amador,005,37829,3670,3671,33,3704,46
2021-05-20,Butte,007,227075,12498,12220,1815,14035,188
2021-05-20,Calaveras,009,45235,2145,2138,14,2152,54
2021-05-20,Colusa,011,21464,1942,1946,307,2253,15
2021-05-20,Contra Costa,013,1133247,69460,68913,1270,70183,809
2021-05-20,Del Norte,015,27424,1410,1373,12,1385,8
2021-05-20,El Dorado,017,186661,10268,10188,726,10914,112
2021-05-20,Fresno,019,978130,102662,102135,8718,110853,1696
2021-05-20,Glenn,021,27897,2430,2406,562,2968,17
2021-05-20,Humboldt,023,135768,4210,4162,34,4196,42
2021-05-20,Imperial,025,180216,28589,28551,2872,31423,732
2021-05-20,Inyo,027,18085,1403,1402,12,1414,36
2021-05-20,Kern,029,883053,97229,96204,10908,107112,1317
2021-05-20,Kings,031,150075,23157,22922,1092,24014,246
2021-05-20,Lake,033,64148,3514,3500,9,3509,43
2021-05-20,Lassen,035,31185,5202,5160,112,5272,6
2021-05-20,Los Angeles,037,10098052,1204140,1197073,41682,1238755,24168
2021-05-20,Madera,039,155013,16605,16499,935,17434,238
2021-05-20,Marin,041,260295,14080,14036,258,14294,227
2021-05-20,Mariposa,043,17540,429,426,11,437,5
2021-05-20,Mendocino,045,87422,3973,3897,80,3977,47
2021-05-20,Merced,047,269075,31019,31046,989,32035,454
2021-05-20,Modoc,049,8938,376,365,130,495,3
2021-05-20,Mono,051,14174,1257,1269,17,1286,3
2021-05-20,Monterey,053,433212,43183,42984,1880,44864,379
2021-05-20,Napa,055,140530,9899,9913,36,9949,82
2021-05-20,Nevada,057,99092,4805,4775,189,4964,70
2021-05-20,Orange,059,3164182,255255,254127,11354,265481,5038
2021-05-20,Placer,061,380077,23216,22823,1504,24327,292
2021-05-20,Plumas,063,18699,700,682,10,692,4
2021-05-20,Riverside,065,2383286,294009,288453,14026,302479,4442
2021-05-20,Sacramento,067,1510023,105740,105414,1766,107180,1629
2021-05-20,San Benito,069,59416,6063,6067,115,6182,63
2021-05-20,San Bernardino,071,2135413,293163,292153,8991,301144,4728
2021-05-20,San Diego,073,3302833,280283,279490,14900,294390,3749
2021-05-20,San Francisco,075,870044,36674,36860,1290,38150,546
2021-05-20,San Joaquin,077,732212,73003,72388,3566,75954,1371
2021-05-20,San Luis Obispo,079,281455,21387,21095,738,21833,256
2021-05-20,San Mateo,081,765935,42319,42152,471,42623,432
2021-05-20,Santa Barbara,083,443738,34355,34293,1196,35489,459
2021-05-20,Santa Clara,085,1922200,118505,119222,760,119982,2029
2021-05-20,Santa Cruz,087,273765,16209,16119,814,16933,207
2021-05-20,Shasta,089,179085,12265,12266,1564,13830,200
2021-05-20,Sierra,091,2930,56,54,12,66,0
2021-05-20,Siskiyou,093,43540,1910,1811,356,2167,16
2021-05-20,Solano,095,438530,32748,32725,553,33278,253
2021-05-20,Sonoma,097,501317,29987,30107,333,30440,321
2021-05-20,Stanislaus,099,539301,56229,55979,5937,61916,970
2021-05-20,Sutter,101,95872,9491,9467,87,9554,113
2021-05-20,Tehama,103,63373,5072,5029,576,5605,63
2021-05-20,Trinity,105,12862,483,329,92,421,3
2021-05-20,Tulare,107,460477,50194,49217,9048,58265,837
2021-05-20,Tuolumne,109,53932,4008,4077,39,4116,65
2021-05-20,Ventura,111,848112,81327,80800,2991,83791,1019
2021-05-20,Yolo,113,214977,13979,13973,318,14291,211
2021-05-20,Yuba,115,75493,6032,6002,124,6126,49
2021-05-19,Alameda,001,1643700,87999,87889,1960,89849,1260
2021-05-19,Alpine,003,1148,87,88,0,88,0
2021-05-19,Amador,005,37829,3670,3669,33,3702,46
2021-05-19,Butte,007,227075,12488,12198,1815,14013,188
2021-05-19,Calaveras,009,45235,2141,2132,14,2146,54
2021-05-19,Colusa,011,21464,1942,1945,305,2250,15
2021-05-19,Contra Costa,013,1133247,69413,68836,1270,70106,808
2021-05-19,Del Norte,015,27424,1408,1371,12,1383,8
2021-05-19,El Dorado,017,186661,10263,10179,725,10904,112
2021-05-19,Fresno,019,978130,102632,102085,8715,110800,1693
2021-05-19,Glenn,021,27897,2430,2404,562,2966,17
2021-05-19,Humboldt,023,135768,4200,4143,34,4177,42
2021-05-19,Imperial,025,180216,28580,28550,2872,31422,732
2021-05-19,Inyo,027,18085,1403,1402,12,1414,36
2021-05-19,Kern,029,883053,97200,96173,10900,107073,1316
2021-05-19,Kings,031,150075,23151,22919,1092,24011,246
2021-05-19,Lake,033,64148,3514,3497,9,3506,43
2021-05-19,Lassen,035,31185,5201,5157,112,5269,6
2021-05-19,Los Angeles,037,10098052,1203947,1196856,41667,1238523,24143
2021-05-19,Madera,039,155013,16602,16496,935,17431,238
2021-05-19,Marin,041,260295,14076,14033,256,14289,227
2021-05-19,Mariposa,043,17540,429,425,11,436,5
2021-05-19,Mendocino,045,87422,3969,3886,80,3966,47
2021-05-19,Merced,047,269075,31003,31044,989,32033,452
2021-05-19,Modoc,049,8938,376,364,127,491,3
2021-05-19,Mono,051,14174,1257,1266,17,1283,3
2021-05-19,Monterey,053,433212,43178,42973,1879,44852,379
2021-05-19,Napa,055,140530,9896,9906,36,9942,82
2021-05-19,Nevada,057,99092,4803,4769,189,4958,70
2021-05-19,Orange,059,3164182,255218,254087,11344,265431,5035
2021-05-19,Placer,061,380077,23197,22784,1499,24283,291
2021-05-19,Plumas,063,18699,700,682,10,692,4
2021-05-19,Riverside,065,2383286,293962,288398,14024,302422,4442
2021-05-19,Sacramento,067,1510023,105662,105225,1765,106990,1629
2021-05-19,San Benito,069,59416,6062,6064,115,6179,63
2021-05-19,San Bernardino,071,2135413,293119,292078,8988,301066,4725
2021-05-19,San Diego,073,3302833,280199,279345,14879,294224,3746
2021-05-19,San Francisco,075,870044,36661,36835,1289,38124,546
2021-05-19,San Joaquin,077,732212,72960,72338,3561,75899,1369
2021-05-19,San Luis Obispo,079,281455,21379,21085,737,21822,256
2021-05-19,San Mateo,081,765935,42312,42126,471,42597,429
2021-05-19,Santa Barbara,083,443738,34347,34292,1196,35488,459
2021-05-19,Santa Clara,085,1922200,118465,119176,759,119935,2015
2021-05-19,Santa Cruz,087,273765,16205,16121,813,16934,207
2021-05-19,Shasta,089,179085,12247,12233,1560,13793,200
2021-05-19,Sierra,091,2930,56,54,12,66,0
2021-05-19,Siskiyou,093,43540,1907,1803,355,2158,16
2021-05-19,Solano,095,438530,32721,32678,551,33229,253
2021-05-19,Sonoma,097,501317,29972,30080,333,30413,321
2021-05-19,Stanislaus,099,539301,56211,55912,5932,61844,967
2021-05-19,Sutter,101,95872,9484,9459,86,9545,113
2021-05-19,Tehama,103,63373,5063,5026,570,5596,63
2021-05-19,Trinity,105,12862,483,329,92,421,3
2021-05-19,Tulare,107,460477,50181,49163,9043,58206,837
2021-05-19,Tuolumne,109,53932,4008,4074,39,4113,64
2021-05-19,Ventura,111,848112,81311,80747,2990,83737,1019
2021-05-19,Yolo,113,214977,13973,13961,317,14278,211
2021-05-19,Yuba,115,75493,6028,5993,124,6117,49
2021-05-18,Alameda,001,1643700,87925,87816,1960,89776,1254
2021-05-18,Alpine,003,1148,87,88,0,88,0
2021-05-18,Amador,005,37829,3670,3669,33,3702,46
2021-05-18,Butte,007,227075,12475,12164,1813,13977,191
2021-05-18,Calaveras,009,45235,2137,2131,14,2145,54
2021-05-18,Colusa,011,21464,1942,1943,305,2248,14
2021-05-18,Contra Costa,013,1133247,69356,68750,1269,70019,808
2021-05-18,Del Norte,015,27424,1405,1371,12,1383,8
2021-05-18,El Dorado,017,186661,10252,10169,724,10893,112
2021-05-18,Fresno,019,978130,102596,102056,8712,110768,1690
2021-05-18,Glenn,021,27897,2424,2403,561,2964,17
2021-05-18,Humboldt,023,135768,4182,4132,34,4166,42
2021-05-18,Imperial,025,180216,28574,28538,2870,31408,730
2021-05-18,Inyo,027,18085,1403,1401,12,1413,36
2021-05-18,Kern,029,883053,97166,96128,10886,107014,1315
2021-05-18,Kings,031,150075,23145,22916,1092,24008,247
2021-05-18,Lake,033,64148,3512,3495,9,3504,43
2021-05-18,Lassen,035,31185,5200,5157,111,5268,6
2021-05-18,Los Angeles,037,10098052,1203768,1196668,41656,1238324,24133
2021-05-18,Madera,039,155013,16592,16491,934,17425,238
2021-05-18,Marin,041,260295,14073,14026,256,14282,227
2021-05-18,Mariposa,043,17540,429,424,11,435,5
2021-05-18,Mendocino,045,87422,3958,3877,79,3956,47
2021-05-18,Merced,047,269075,30984,31036,989,32025,452
2021-05-18,Modoc,049,8938,375,364,126,490,3
2021-05-18,Mono,051,14174,1256,1265,17,1282,3
2021-05-18,Monterey,053,433212,43172,43001,1879,44880,379
2021-05-18,Napa,055,140530,9896,9905,36,9941,82
2021-05-18,Nevada,057,99092,4796,4762,189,4951,70
2021-05-18,Orange,059,3164182,255177,254041,11334,265375,5031
2021-05-18,Placer,061,380077,23164,22726,1495,24221,291
2021-05-18,Plumas,063,18699,700,682,10,692,4
2021-05-18,Riverside,065,2383286,293907,288354,14017,302371,4438
2021-05-18,Sacramento,067,1510023,105560,105083,1763,106846,1629
2021-05-18,San Benito,069,59416,6061,6065,115,6180,63
2021-05-18,San Bernardino,071,2135413,293061,292014,8983,300997,4722
2021-05-18,San Diego,073,3302833,280091,279254,14870,294124,3742
2021-05-18,San Francisco,075,870044,36641,36818,1289,38107,546
2021-05-18,San Joaquin,077,732212,72913,72282,3557,75839,1368
2021-05-18,San Luis Obispo,079,281455,21369,21080,735,21815,256
2021-05-18,San Mateo,081,765935,42300,42099,470,42569,428
2021-05-18,Santa Barbara,083,443738,34338,34278,1196,35474,459
2021-05-18,Santa Clara,085,1922200,118438,119171,759,119930,2014
2021-05-18,Santa Cruz,087,273765,16197,16137,813,16950,207
2021-05-18,Shasta,089,179085,12229,12197,1554,13751,200
2021-05-18,Sierra,091,2930,56,54,12,66,0
2021-05-18,Siskiyou,093,43540,1906,1799,355,2154,16
2021-05-18,Solano,095,438530,32696,32644,551,33195,253
2021-05-18,Sonoma,097,501317,29952,30054,332,30386,321
2021-05-18,Stanislaus,099,539301,56175,55860,5932,61792,959
2021-05-18,Sutter,101,95872,9476,9453,86,9539,113
2021-05-18,Tehama,103,63373,5056,5020,567,5587,63
2021-05-18,Trinity,105,12862,483,329,91,420,3
2021-05-18,Tulare,107,460477,50173,49142,9038,58180,836
2021-05-18,Tuolumne,109,53932,4006,4073,39,4112,64
2021-05-18,Ventura,111,848112,81295,80726,2987,83713,1017
2021-05-18,Yolo,113,214977,13966,13951,316,14267,211
2021-05-18,Yuba,115,75493,6024,5989,123,6112,49
2021-05-17,Alameda,001,1643700,87872,87766,1957,89723,1253
2021-05-17,Alpine,003,1148,87,88,0,88,0
2021-05-17,Amador,005,37829,3667,3668,33,3701,46
2021-05-17,Butte,007,227075,12467,12144,1813,13957,192
2021-05-17,Calaveras,009,45235,2137,2131,14,2145,53
2021-05-17,Colusa,011,21464,1942,1943,305,2248,14
2021-05-17,Contra Costa,013,1133247,69301,68720,1268,69988,805
2021-05-17,Del Norte,015,27424,1400,1369,12,1381,8
2021-05-17,El Dorado,017,186661,10235,10163,724,10887,112
2021-05-17,Fresno,019,978130,102552,102013,8704,110717,1690
2021-05-17,Glenn,021,27897,2424,2401,561,2962,17
2021-05-17,Humboldt,023,135768,4171,4112,34,4146,42
2021-05-17,Imperial,025,180216,28568,28533,2867,31400,729
2021-05-17,Inyo,027,18085,1403,1401,12,1413,36
2021-05-17,Kern,029,883053,97137,96095,10869,106964,1315
2021-05-17,Kings,031,150075,23142,22918,1092,24010,246
2021-05-17,Lake,033,64148,3507,3489,9,3498,43
2021-05-17,Lassen,035,31185,5197,5156,110,5266,6
2021-05-17,Los Angeles,037,10098052,1203593,1196556,41650,1238206,24123
2021-05-17,Madera,039,155013,16585,16486,934,17420,238
2021-05-17,Marin,041,260295,14067,14021,256,14277,227
2021-05-17,Mariposa,043,17540,428,423,11,434,5
2021-05-17,Mendocino,045,87422,3949,3868,79,3947,46
2021-05-17,Merced,047,269075,30969,31031,989,32020,450
2021-05-17,Modoc,049,8938,374,362,126,488,3
2021-05-17,Mono,051,14174,1252,1265,17,1282,3
2021-05-17,Monterey,053,433212,43165,42995,1879,44874,379
2021-05-17,Napa,055,140530,9895,9894,36,9930,82
2021-05-17,Nevada,057,99092,4792,4761,188,4949,70
2021-05-17,Orange,059,3164182,255130,253993,11327,265320,5031
2021-05-17,Placer,061,380077,23138,22706,1488,24194,289
2021-05-17,Plumas,063,18699,700,682,10,692,4
2021-05-17,Riverside,065,2383286,293838,288304,14013,302317,4433
2021-05-17,Sacramento,067,1510023,105452,105035,1761,106796,1629
2021-05-17,San Benito,069,59416,6058,6067,115,6182,63
2021-05-17,San Bernardino,071,2135413,293012,291989,8975,300964,4724
2021-05-17,San Diego,073,3302833,279959,279146,14848,293994,3742
2021-05-17,San Francisco,075,870044,36629,36816,1287,38103,546
2021-05-17,San Joaquin,077,732212,72875,72234,3554,75788,1359
2021-05-17,San Luis Obispo,079,281455,21360,21079,733,21812,256
2021-05-17,San Mateo,081,765935,42272,42083,470,42553,428
2021-05-17,Santa Barbara,083,443738,34331,34275,1196,35471,459
2021-05-17,Santa Clara,085,1922200,118401,119116,757,119873,2015
2021-05-17,Santa Cruz,087,273765,16194,16151,813,16964,206
2021-05-17,Shasta,089,179085,12207,12163,1553,13716,200
2021-05-17,Sierra,091,2930,56,54,12,66,0
2021-05-17,Siskiyou,093,43540,1897,1795,352,2147,15
2021-05-17,Solano,095,438530,32678,32627,550,33177,253
2021-05-17,Sonoma,097,501317,29929,30043,331,30374,321
2021-05-17,Stanislaus,099,539301,56130,55839,5925,61764,951
2021-05-17,Sutter,101,95872,9469,9447,86,9533,113
2021-05-17,Tehama,103,63373,5052,5016,565,5581,63
2021-05-17,Trinity,105,12862,483,328,91,419,3
2021-05-17,Tulare,107,460477,50151,49107,9032,58139,836
2021-05-17,Tuolumne,109,53932,4006,4071,39,4110,64
2021-05-17,Ventura,111,848112,81275,80699,2987,83686,1017
2021-05-17,Yolo,113,214977,13959,13941,316,14257,211
2021-05-17,Yuba,115,75493,6016,5987,123,6110,49
2021-05-16,Alameda,001,1643700,87808,87743,1957,89700,1253
2021-05-16,Alpine,003,1148,87,88,0,88,0
2021-05-16,Amador,005,37829,3666,3667,33,3700,46
2021-05-16,Butte,007,227075,12453,12140,1813,13953,192
2021-05-16,Calaveras,009,45235,2135,2129,14,2143,53
2021-05-16,Colusa,011,21464,1940,1943,305,2248,14
2021-05-16,Contra Costa,013,1133247,69233,68694,1265,69959,805
2021-05-16,Del Norte,015,27424,1397,1365,12,1377,8
2021-05-16,El Dorado,017,186661,10219,10159,723,10882,112
2021-05-16,Fresno,019,978130,102508,101987,8698,110685,1690
2021-05-16,Glenn,021,27897,2424,2401,560,2961,17
2021-05-16,Humboldt,023,135768,4156,4104,34,4138,42
2021-05-16,Imperial,025,180216,28557,28516,2864,31380,729
2021-05-16,Inyo,027,18085,1403,1401,12,1413,36
2021-05-16,Kern,029,883053,97104,96083,10849,106932,1315
2021-05-16,Kings,031,150075,23138,22918,1089,24007,246
2021-05-16,Lake,033,64148,3504,3489,9,3498,43
2021-05-16,Lassen,035,31185,5196,5156,110,5266,6
2021-05-16,Los Angeles,037,10098052,1203370,1196397,41634,1238031,24120
2021-05-16,Madera,039,155013,16580,16483,931,17414,238
2021-05-16,Marin,041,260295,14064,14015,256,14271,227
2021-05-16,Mariposa,043,17540,428,423,11,434,5
2021-05-16,Mendocino,045,87422,3939,3863,79,3942,46
2021-05-16,Merced,047,269075,30948,31023,987,32010,450
2021-05-16,Modoc,049,8938,374,362,126,488,3
2021-05-16,Mono,051,14174,1252,1265,17,1282,3
2021-05-16,Monterey,053,433212,43160,42991,1879,44870,379
2021-05-16,Napa,055,140530,9892,9891,36,9927,82
2021-05-16,Nevada,057,99092,4788,4755,188,4943,70
2021-05-16,Orange,059,3164182,255098,253962,11324,265286,5031
2021-05-16,Placer,061,380077,23106,22696,1482,24178,289
2021-05-16,Plumas,063,18699,699,682,10,692,4
2021-05-16,Riverside,065,2383286,293762,288259,14005,302264,4433
2021-05-16,Sacramento,067,1510023,105338,105013,1759,106772,1628
2021-05-16,San Benito,069,59416,6057,6067,114,6181,63
2021-05-16,San Bernardino,071,2135413,292940,291940,8973,300913,4724
2021-05-16,San Diego,073,3302833,279841,279099,14835,293934,3742
2021-05-16,San Francisco,075,870044,36607,36808,1286,38094,546
2021-05-16,San Joaquin,077,732212,72826,72218,3549,75767,1359
2021-05-16,San Luis Obispo,079,281455,21352,21072,731,21803,256
2021-05-16,San Mateo,081,765935,42261,42063,469,42532,428
2021-05-16,Santa Barbara,083,443738,34324,34270,1196,35466,459
2021-05-16,Santa Clara,085,1922200,118372,119098,756,119854,2015
2021-05-16,Santa Cruz,087,273765,16192,16143,813,16956,206
2021-05-16,Shasta,089,179085,12191,12156,1549,13705,200
2021-05-16,Sierra,091,2930,56,54,12,66,0
2021-05-16,Siskiyou,093,43540,1893,1790,351,2141,15
2021-05-16,Solano,095,438530,32645,32619,548,33167,253
2021-05-16,Sonoma,097,501317,29910,30033,331,30364,321
2021-05-16,Stanislaus,099,539301,56081,55814,5913,61727,951
2021-05-16,Sutter,101,95872,9462,9445,86,9531,113
2021-05-16,Tehama,103,63373,5048,5013,564,5577,63
2021-05-16,Trinity,105,12862,483,328,91,419,3
2021-05-16,Tulare,107,460477,50134,49091,9029,58120,837
2021-05-16,Tuolumne,109,53932,4002,4070,39,4109,64
2021-05-16,Ventura,111,848112,81244,80689,2987,83676,1017
2021-05-16,Yolo,113,214977,13944,13938,316,14254,211
2021-05-16,Yuba,115,75493,6013,5987,123,6110,49
2021-05-15,Alameda,001,1643700,87782,87677,1956,89633,1252
2021-05-15,Alpine,003,1148,87,88,0,88,0
2021-05-15,Amador,005,37829,3666,3666,33,3699,46
2021-05-15,Butte,007,227075,12446,12095,1812,13907,192
2021-05-15,Calaveras,009,45235,2134,2126,14,2140,53
2021-05-15,Colusa,011,21464,1940,1941,303,2244,14
2021-05-15,Contra Costa,013,1133247,69187,68658,1265,69923,805
2021-05-15,Del Norte,015,27424,1392,1359,12,1371,8
2021-05-15,El Dorado,017,186661,10207,10156,722,10878,112
2021-05-15,Fresno,019,978130,102471,101957,8695,110652,1690
2021-05-15,Glenn,021,27897,2424,2400,560,2960,17
2021-05-15,Humboldt,023,135768,4146,4080,34,4114,42
2021-05-15,Imperial,025,180216,28554,28504,2863,31367,729
2021-05-15,Inyo,027,18085,1403,1402,12,1414,36
2021-05-15,Kern,029,883053,97090,96061,10834,106895,1315
2021-05-15,Kings,031,150075,23137,22913,1089,24002,246
2021-05-15,Lake,033,64148,3503,3485,9,3494,43
2021-05-15,Lassen,035,31185,5193,5156,109,5265,6
2021-05-15,Los Angeles,037,10098052,1203246,1196255,41621,1237876,24115
2021-05-15,Madera,039,155013,16577,16482,931,17413,238
2021-05-15,Marin,041,260295,14060,14012,256,14268,227
2021-05-15,Mariposa,043,17540,428,423,11,434,5
2021-05-15,Mendocino,045,87422,3936,3861,79,3940,46
2021-05-15,Merced,047,269075,30927,31012,987,31999,450
2021-05-15,Modoc,049,8938,374,362,126,488,3
2021-05-15,Mono,051,14174,1252,1265,17,1282,3
2021-05-15,Monterey,053,433212,43156,42982,1879,44861,379
2021-05-15,Napa,055,140530,9889,9887,36,9923,82
2021-05-15,Nevada,057,99092,4787,4755,188,4943,70
2021-05-15,Orange,059,3164182,255071,253919,11317,265236,5030
2021-05-15,Placer,061,380077,23085,22688,1482,24170,289
2021-05-15,Plumas,063,18699,699,681,10,691,4
2021-05-15,Riverside,065,2383286,293720,288203,14000,302203,4433
2021-05-15,Sacramento,067,1510023,105266,104929,1756,106685,1628
2021-05-15,San Benito,069,59416,6057,6066,114,6180,63
2021-05-15,San Bernardino,071,2135413,292898,291892,8971,300863,4724
2021-05-15,San Diego,073,3302833,279770,278991,14820,293811,3737
2021-05-15,San Francisco,075,870044,36591,36795,1284,38079,546
2021-05-15,San Joaquin,077,732212,72800,72197,3547,75744,1359
2021-05-15,San Luis Obispo,079,281455,21349,21061,730,21791,256
2021-05-15,San Mateo,081,765935,42245,42059,469,42528,428
2021-05-15,Santa Barbara,083,443738,34316,34259,1196,35455,459
2021-05-15,Santa Clara,085,1922200,118351,119060,756,119816,2016
2021-05-15,Santa Cruz,087,273765,16188,16137,813,16950,206
2021-05-15,Shasta,089,179085,12179,12152,1546,13698,200
2021-05-15,Sierra,091,2930,56,54,12,66,0
2021-05-15,Siskiyou,093,43540,1887,1788,349,2137,15
2021-05-15,Solano,095,438530,32636,32604,547,33151,253
2021-05-15,Sonoma,097,501317,29891,30020,331,30351,321
2021-05-15,Stanislaus,099,539301,56052,55795,5906,61701,952
2021-05-15,Sutter,101,95872,9460,9436,86,9522,113
2021-05-15,Tehama,103,63373,5044,5012,563,5575,63
2021-05-15,Trinity,105,12862,483,328,91,419,3
2021-05-15,Tulare,107,460477,50124,49080,9025,58105,837
2021-05-15,Tuolumne,109,53932,4000,4064,39,4103,63
2021-05-15,Ventura,111,848112,81233,80662,2987,83649,1017
2021-05-15,Yolo,113,214977,13937,13932,315,14247,211
2021-05-15,Yuba,115,75493,6010,5979,122,6101,49
2021-05-14,Alameda,001,1643700,87748,87621,1953,89574,1249
2021-05-14,Alpine,003,1148,87,88,0,88,0
2021-05-14,Amador,005,37829,3666,3665,33,3698,46
2021-05-14,Butte,007,227075,12437,12076,1809,13885,192
2021-05-14,Calaveras,009,45235,2130,2121,14,2135,53
2021-05-14,Colusa,011,21464,1939,1940,302,2242,14
2021-05-14,Contra Costa,013,1133247,69145,68589,1263,69852,806
2021-05-14,Del Norte,015,27424,1392,1355,12,1367,8
2021-05-14,El Dorado,017,186661,10200,10143,721,10864,113
2021-05-14,Fresno,019,978130,102442,101917,8689,110606,1688
2021-05-14,Glenn,021,27897,2423,2398,560,2958,17
2021-05-14,Humboldt,023,135768,4138,4050,34,4084,37
2021-05-14,Imperial,025,180216,28547,28485,2862,31347,728
2021-05-14,Inyo,027,18085,1403,1400,12,1412,36
2021-05-14,Kern,029,883053,97060,96033,10825,106858,1311
2021-05-14,Kings,031,150075,23136,22910,1089,23999,246
2021-05-14,Lake,033,64148,3499,3483,9,3492,43
2021-05-14,Lassen,035,31185,5193,5154,109,5263,6
2021-05-14,Los Angeles,037,10098052,1203113,1196038,41615,1237653,24101
2021-05-14,Madera,039,155013,16574,16474,931,17405,238
2021-05-14,Marin,041,260295,14056,14010,256,14266,227
2021-05-14,Mariposa,043,17540,428,422,11,433,5
2021-05-14,Mendocino,045,87422,3934,3855,79,3934,46
2021-05-14,Merced,047,269075,30917,31010,987,31997,450
2021-05-14,Modoc,049,8938,374,362,126,488,3
2021-05-14,Mono,051,14174,1251,1265,17,1282,3
2021-05-14,Monterey,053,433212,43151,42973,1879,44852,380
2021-05-14,Napa,055,140530,9886,9883,36,9919,82
2021-05-14,Nevada,057,99092,4782,4745,188,4933,70
2021-05-14,Orange,059,3164182,255037,253855,11310,265165,5028
2021-05-14,Placer,061,380077,23066,22660,1476,24136,287
2021-05-14,Plumas,063,18699,698,680,10,690,4
2021-05-14,Riverside,065,2383286,293670,288140,13997,302137,4433
2021-05-14,Sacramento,067,1510023,105177,104828,1755,106583,1627
2021-05-14,San Benito,069,59416,6057,6064,114,6178,63
2021-05-14,San Bernardino,071,2135413,292850,291834,8971,300805,4721
2021-05-14,San Diego,073,3302833,279697,278853,14809,293662,3732
2021-05-14,San Francisco,075,870044,36582,36771,1280,38051,545
2021-05-14,San Joaquin,077,732212,72768,72160,3540,75700,1359
2021-05-14,San Luis Obispo,079,281455,21345,21051,730,21781,256
2021-05-14,San Mateo,081,765935,42234,42041,469,42510,428
2021-05-14,Santa Barbara,083,443738,34306,34243,1196,35439,456
2021-05-14,Santa Clara,085,1922200,118322,119006,756,119762,2014
2021-05-14,Santa Cruz,087,273765,16183,16130,813,16943,207
2021-05-14,Shasta,089,179085,12173,12130,1541,13671,200
2021-05-14,Sierra,091,2930,56,54,12,66,0
2021-05-14,Siskiyou,093,43540,1880,1779,348,2127,14
2021-05-14,Solano,095,438530,32616,32585,546,33131,252
2021-05-14,Sonoma,097,501317,29873,30007,331,30338,321
2021-05-14,Stanislaus,099,539301,56019,55752,5900,61652,950
2021-05-14,Sutter,101,95872,9451,9433,84,9517,113
2021-05-14,Tehama,103,63373,5037,5005,563,5568,63
2021-05-14,Trinity,105,12862,483,328,91,419,3
2021-05-14,Tulare,107,460477,50107,49060,9020,58080,836
2021-05-14,Tuolumne,109,53932,4000,4060,39,4099,63
2021-05-14,Ventura,111,848112,81219,80628,2987,83615,1014
2021-05-14,Yolo,113,214977,13932,13922,311,14233,210
2021-05-14,Yuba,115,75493,6006,5970,122,6092,47
2021-05-13,Alameda,001,1643700,87703,87557,1952,89509,1250
2021-05-13,Alpine,003,1148,87,88,0,88,0
2021-05-13,Amador,005,37829,3666,3662,33,3695,46
2021-05-13,Butte,007,227075,12424,12051,1808,13859,196
2021-05-13,Calaveras,009,45235,2130,2120,14,2134,53
2021-05-13,Colusa,011,21464,1938,1939,298,2237,14
2021-05-13,Contra Costa,013,1133247,69097,68522,1262,69784,806
2021-05-13,Del Norte,015,27424,1390,1354,12,1366,8
2021-05-13,El Dorado,017,186661,10198,10133,721,10854,112
2021-05-13,Fresno,019,978130,102413,101862,8688,110550,1687
2021-05-13,Glenn,021,27897,2422,2395,560,2955,17
2021-05-13,Humboldt,023,135768,4120,4027,34,4061,37
2021-05-13,Imperial,025,180216,28532,28468,2859,31327,729
2021-05-13,Inyo,027,18085,1403,1400,12,1412,36
2021-05-13,Kern,029,883053,97036,95996,10807,106803,1311
2021-05-13,Kings,031,150075,23135,22904,1089,23993,246
2021-05-13,Lake,033,64148,3497,3479,9,3488,43
2021-05-13,Lassen,035,31185,5193,5152,108,5260,6
2021-05-13,Los Angeles,037,10098052,1202925,1195504,41602,1237106,24083
2021-05-13,Madera,039,155013,16566,16467,931,17398,238
2021-05-13,Marin,041,260295,14051,14004,254,14258,227
2021-05-13,Mariposa,043,17540,428,422,11,433,5
2021-05-13,Mendocino,045,87422,3930,3846,79,3925,46
2021-05-13,Merced,047,269075,30909,30989,987,31976,450
2021-05-13,Modoc,049,8938,374,362,126,488,3
2021-05-13,Mono,051,14174,1251,1265,17,1282,3
2021-05-13,Monterey,053,433212,43136,42966,1879,44845,380
2021-05-13,Napa,055,140530,9879,9877,36,9913,82
2021-05-13,Nevada,057,99092,4778,4743,187,4930,70
2021-05-13,Orange,059,3164182,254992,253778,11308,265086,5026
2021-05-13,Placer,061,380077,23042,22668,1469,24137,288
2021-05-13,Plumas,063,18699,698,680,10,690,4
2021-05-13,Riverside,065,2383286,293604,288067,13992,302059,4433
2021-05-13,Sacramento,067,1510023,105090,104711,1753,106464,1626
2021-05-13,San Benito,069,59416,6055,6062,114,6176,63
2021-05-13,San Bernardino,071,2135413,292784,291765,8971,300736,4722
2021-05-13,San Diego,073,3302833,279583,278592,14792,293384,3729
2021-05-13,San Francisco,075,870044,36558,36741,1278,38019,544
2021-05-13,San Joaquin,077,732212,72726,72096,3536,75632,1357
2021-05-13,San Luis Obispo,079,281455,21330,21043,729,21772,255
2021-05-13,San Mateo,081,765935,42217,42059,469,42528,426
2021-05-13,Santa Barbara,083,443738,34294,34242,1196,35438,456
2021-05-13,Santa Clara,085,1922200,118295,118952,756,119708,2013
2021-05-13,Santa Cruz,087,273765,16177,16129,813,16942,208
2021-05-13,Shasta,089,179085,12153,12111,1537,13648,200
2021-05-13,Sierra,091,2930,56,54,12,66,0
2021-05-13,Siskiyou,093,43540,1873,1769,345,2114,14
2021-05-13,Solano,095,438530,32603,32548,544,33092,252
2021-05-13,Sonoma,097,501317,29848,29991,331,30322,321
2021-05-13,Stanislaus,099,539301,55982,55678,5894,61572,949
2021-05-13,Sutter,101,95872,9446,9431,83,9514,112
2021-05-13,Tehama,103,63373,5032,4997,563,5560,63
2021-05-13,Trinity,105,12862,482,327,90,417,3
2021-05-13,Tulare,107,460477,50081,49032,9012,58044,837
2021-05-13,Tuolumne,109,53932,3999,4059,39,4098,63
2021-05-13,Ventura,111,848112,81189,80615,2986,83601,1012
2021-05-13,Yolo,113,214977,13923,13914,309,14223,210
2021-05-13,Yuba,115,75493,5997,5962,122,6084,47
2021-05-12,Alameda,001,1643700,87670,87482,1950,89432,1261
2021-05-12,Alpine,003,1148,87,88,0,88,0
2021-05-12,Amador,005,37829,3666,3658,33,3691,46
2021-05-12,Butte,007,227075,12414,12026,1808,13834,199
2021-05-12,Calaveras,009,45235,2127,2119,14,2133,53
2021-05-12,Colusa,011,21464,1936,1939,297,2236,14
2021-05-12,Contra Costa,013,1133247,69038,68462,1256,69718,805
2021-05-12,Del Norte,015,27424,1388,1352,12,1364,8
2021-05-12,El Dorado,017,186661,10189,10123,721,10844,112
2021-05-12,Fresno,019,978130,102364,101838,8677,110515,1688
2021-05-12,Glenn,021,27897,2419,2391,560,2951,17
2021-05-12,Humboldt,023,135768,4092,3982,34,4016,37
2021-05-12,Imperial,025,180216,28514,28443,2855,31298,726
2021-05-12,Inyo,027,18085,1403,1400,12,1412,36
2021-05-12,Kern,029,883053,97000,95955,10800,106755,1310
2021-05-12,Kings,031,150075,23133,22896,1089,23985,246
2021-05-12,Lake,033,64148,3495,3476,9,3485,43
2021-05-12,Lassen,035,31185,5191,5151,108,5259,6
2021-05-12,Los Angeles,037,10098052,1202743,1195318,41586,1236904,24067
2021-05-12,Madera,039,155013,16559,16462,930,17392,238
2021-05-12,Marin,041,260295,14046,13997,254,14251,227
2021-05-12,Mariposa,043,17540,428,422,11,433,5
2021-05-12,Mendocino,045,87422,3920,3836,79,3915,46
2021-05-12,Merced,047,269075,30893,30941,987,31928,450
2021-05-12,Modoc,049,8938,373,362,126,488,3
2021-05-12,Mono,051,14174,1251,1265,17,1282,3
2021-05-12,Monterey,053,433212,43124,42950,1878,44828,380
2021-05-12,Napa,055,140530,9873,9870,36,9906,82
2021-05-12,Nevada,057,99092,4774,4738,187,4925,70
2021-05-12,Orange,059,3164182,254941,253587,11305,264892,5024
2021-05-12,Placer,061,380077,23024,22652,1462,24114,288
2021-05-12,Plumas,063,18699,698,681,10,691,4
2021-05-12,Riverside,065,2383286,293534,287830,13988,301818,4431
2021-05-12,Sacramento,067,1510023,104994,104592,1751,106343,1621
2021-05-12,San Benito,069,59416,6055,6062,114,6176,63
2021-05-12,San Bernardino,071,2135413,292736,291505,8966,300471,4715
2021-05-12,San Diego,073,3302833,279479,278402,14771,293173,3729
2021-05-12,San Francisco,075,870044,36539,36720,1277,37997,544
2021-05-12,San Joaquin,077,732212,72672,72043,3532,75575,1356
2021-05-12,San Luis Obispo,079,281455,21320,21021,729,21750,255
2021-05-12,San Mateo,081,765935,42208,42038,467,42505,426
2021-05-12,Santa Barbara,083,443738,34286,34218,1196,35414,456
2021-05-12,Santa Clara,085,1922200,118252,118897,756,119653,2005
2021-05-12,Santa Cruz,087,273765,16171,16123,813,16936,207
2021-05-12,Shasta,089,179085,12133,12092,1535,13627,200
2021-05-12,Sierra,091,2930,56,54,12,66,0
2021-05-12,Siskiyou,093,43540,1869,1760,344,2104,13
2021-05-12,Solano,095,438530,32579,32519,544,33063,252
2021-05-12,Sonoma,097,501317,29836,29976,331,30307,320
2021-05-12,Stanislaus,099,539301,55942,55632,5887,61519,919
2021-05-12,Sutter,101,95872,9443,9427,83,9510,112
2021-05-12,Tehama,103,63373,5027,4989,563,5552,62
2021-05-12,Trinity,105,12862,482,327,90,417,3
2021-05-12,Tulare,107,460477,50065,49001,9004,58005,838
2021-05-12,Tuolumne,109,53932,3998,4056,39,4095,63
2021-05-12,Ventura,111,848112,81170,80577,2986,83563,1010
2021-05-12,Yolo,113,214977,13916,13910,308,14218,210
2021-05-12,Yuba,115,75493,5994,5956,122,6078,47
2021-05-11,Alameda,001,1643700,87606,87413,1946,89359,1290
2021-05-11,Alpine,003,1148,87,88,0,88,0
2021-05-11,Amador,005,37829,3664,3657,33,3690,46
2021-05-11,Butte,007,227075,12399,12008,1805,13813,199
2021-05-11,Calaveras,009,45235,2127,2118,14,2132,52
2021-05-11,Colusa,011,21464,1935,1939,297,2236,14
2021-05-11,Contra Costa,013,1133247,68978,68406,1255,69661,806
2021-05-11,Del Norte,015,27424,1386,1347,12,1359,8
2021-05-11,El Dorado,017,186661,10183,10108,720,10828,112
2021-05-11,Fresno,019,978130,102318,101792,8672,110464,1686
2021-05-11,Glenn,021,27897,2418,2387,559,2946,17
2021-05-11,Humboldt,023,135768,4071,3964,33,3997,37
2021-05-11,Imperial,025,180216,28506,28413,2851,31264,722
2021-05-11,Inyo,027,18085,1402,1402,12,1414,36
2021-05-11,Kern,029,883053,96972,95938,10787,106725,1310
2021-05-11,Kings,031,150075,23125,22887,1089,23976,246
2021-05-11,Lake,033,64148,3495,3473,9,3482,43
2021-05-11,Lassen,035,31185,5189,5148,108,5256,6
2021-05-11,Los Angeles,037,10098052,1202503,1195100,41574,1236674,24048
2021-05-11,Madera,039,155013,16555,16459,929,17388,238
2021-05-11,Marin,041,260295,14039,13987,254,14241,227
2021-05-11,Mariposa,043,17540,428,421,11,432,5
2021-05-11,Mendocino,045,87422,3912,3821,79,3900,46
2021-05-11,Merced,047,269075,30884,30893,987,31880,449
2021-05-11,Modoc,049,8938,373,362,125,487,3
2021-05-11,Mono,051,14174,1251,1265,17,1282,3
2021-05-11,Monterey,053,433212,43116,42934,1877,44811,380
2021-05-11,Napa,055,140530,9866,9870,36,9906,81
2021-05-11,Nevada,057,99092,4770,4737,187,4924,70
2021-05-11,Orange,059,3164182,254878,253545,11297,264842,5017
2021-05-11,Placer,061,380077,23002,22615,1458,24073,287
2021-05-11,Plumas,063,18699,696,679,10,689,4
2021-05-11,Riverside,065,2383286,293472,287757,13983,301740,4429
2021-05-11,Sacramento,067,1510023,104895,104496,1748,106244,1616
2021-05-11,San Benito,069,59416,6052,6058,114,6172,63
2021-05-11,San Bernardino,071,2135413,292676,291421,8964,300385,4707
2021-05-11,San Diego,073,3302833,279344,278308,14752,293060,3725
2021-05-11,San Francisco,075,870044,36519,36707,1277,37984,543
2021-05-11,San Joaquin,077,732212,72624,71999,3529,75528,1356
2021-05-11,San Luis Obispo,079,281455,21313,21008,727,21735,255
2021-05-11,San Mateo,081,765935,42189,41985,466,42451,425
2021-05-11,Santa Barbara,083,443738,34276,34207,1196,35403,456
2021-05-11,Santa Clara,085,1922200,118206,118857,755,119612,2005
2021-05-11,Santa Cruz,087,273765,16167,16113,813,16926,206
2021-05-11,Shasta,089,179085,12110,12050,1529,13579,200
2021-05-11,Sierra,091,2930,56,54,12,66,0
2021-05-11,Siskiyou,093,43540,1859,1756,342,2098,13
2021-05-11,Solano,095,438530,32561,32499,542,33041,250
2021-05-11,Sonoma,097,501317,29821,29966,331,30297,318
2021-05-11,Stanislaus,099,539301,55894,55589,5883,61472,909
2021-05-11,Sutter,101,95872,9436,9417,83,9500,112
2021-05-11,Tehama,103,63373,5023,4985,562,5547,62
2021-05-11,Trinity,105,12862,482,327,89,416,3
2021-05-11,Tulare,107,460477,50038,48974,8990,57964,837
2021-05-11,Tuolumne,109,53932,3997,4056,39,4095,63
2021-05-11,Ventura,111,848112,81146,80544,2983,83527,1008
2021-05-11,Yolo,113,214977,13902,13902,305,14207,210
2021-05-11,Yuba,115,75493,5985,5950,122,6072,46
2021-05-10,Alameda,001,1643700,87536,87366,1945,89311,1284
2021-05-10,Alpine,003,1148,87,88,0,88,0
2021-05-10,Amador,005,37829,3663,3657,33,3690,46
2021-05-10,Butte,007,227075,12383,11993,1801,13794,199
2021-05-10,Calaveras,009,45235,2120,2118,14,2132,52
2021-05-10,Colusa,011,21464,1935,1939,297,2236,14
2021-05-10,Contra Costa,013,1133247,68914,68357,1255,69612,806
2021-05-10,Del Norte,015,27424,1383,1339,12,1351,8
2021-05-10,El Dorado,017,186661,10169,10093,720,10813,113
2021-05-10,Fresno,019,978130,102286,101755,8665,110420,1682
2021-05-10,Glenn,021,27897,2417,2384,557,2941,17
2021-05-10,Humboldt,023,135768,4041,3961,33,3994,36
2021-05-10,Imperial,025,180216,28492,28397,2847,31244,722
2021-05-10,Inyo,027,18085,1402,1401,12,1413,36
2021-05-10,Kern,029,883053,96929,95920,10773,106693,1310
2021-05-10,Kings,031,150075,23114,22884,1088,23972,246
2021-05-10,Lake,033,64148,3487,3471,9,3480,43
2021-05-10,Lassen,035,31185,5185,5148,108,5256,5
2021-05-10,Los Angeles,037,10098052,1202243,1194976,41558,1236534,24030
2021-05-10,Madera,039,155013,16545,16450,929,17379,238
2021-05-10,Marin,041,260295,14036,13981,254,14235,228
2021-05-10,Mariposa,043,17540,427,420,11,431,5
2021-05-10,Mendocino,045,87422,3906,3818,79,3897,46
2021-05-10,Merced,047,269075,30873,30880,987,31867,448
2021-05-10,Modoc,049,8938,373,361,125,486,3
2021-05-10,Mono,051,14174,1251,1265,17,1282,3
2021-05-10,Monterey,053,433212,43110,42927,1872,44799,380
2021-05-10,Napa,055,140530,9864,9860,36,9896,81
2021-05-10,Nevada,057,99092,4763,4735,187,4922,70
2021-05-10,Orange,059,3164182,254824,253484,11291,264775,5008
2021-05-10,Placer,061,380077,22980,22590,1455,24045,286
2021-05-10,Plumas,063,18699,695,679,10,689,4
2021-05-10,Riverside,065,2383286,293403,287689,13977,301666,4427
2021-05-10,Sacramento,067,1510023,104782,104378,1743,106121,1613
2021-05-10,San Benito,069,59416,6051,6058,114,6172,63
2021-05-10,San Bernardino,071,2135413,292624,291360,8963,300323,4707
2021-05-10,San Diego,073,3302833,279179,278183,14725,292908,3725
2021-05-10,San Francisco,075,870044,36500,36683,1277,37960,543
2021-05-10,San Joaquin,077,732212,72587,71954,3514,75468,1356
2021-05-10,San Luis Obispo,079,281455,21295,20993,726,21719,256
2021-05-10,San Mateo,081,765935,42171,41926,466,42392,424
2021-05-10,Santa Barbara,083,443738,34268,34201,1196,35397,456
2021-05-10,Santa Clara,085,1922200,118147,118822,755,119577,2003
2021-05-10,Santa Cruz,087,273765,16162,16114,813,16927,206
2021-05-10,Shasta,089,179085,12096,12036,1525,13561,200
2021-05-10,Sierra,091,2930,56,54,12,66,0
2021-05-10,Siskiyou,093,43540,1849,1752,340,2092,13
2021-05-10,Solano,095,438530,32541,32466,540,33006,250
2021-05-10,Sonoma,097,501317,29806,29955,330,30285,318
2021-05-10,Stanislaus,099,539301,55820,55541,5877,61418,898
2021-05-10,Sutter,101,95872,9430,9412,83,9495,111
2021-05-10,Tehama,103,63373,5019,4980,562,5542,62
2021-05-10,Trinity,105,12862,482,327,87,414,3
2021-05-10,Tulare,107,460477,50014,48956,8984,57940,837
2021-05-10,Tuolumne,109,53932,3993,4054,38,4092,63
2021-05-10,Ventura,111,848112,81130,80501,2981,83482,1008
2021-05-10,Yolo,113,214977,13890,13898,303,14201,209
2021-05-10,Yuba,115,75493,5983,5942,122,6064,46
2021-05-09,Alameda,001,1643700,87465,87292,1942,89234,1284
2021-05-09,Alpine,003,1148,87,88,0,88,0
2021-05-09,Amador,005,37829,3661,3655,33,3688,46
2021-05-09,Butte,007,227075,12364,11985,1797,13782,199
2021-05-09,Calaveras,009,45235,2119,2116,14,2130,52
2021-05-09,Colusa,011,21464,1934,1940,297,2237,14
2021-05-09,Contra Costa,013,1133247,68850,68302,1253,69555,806
2021-05-09,Del Norte,015,27424,1376,1338,12,1350,8
2021-05-09,El Dorado,017,186661,10155,10089,717,10806,113
2021-05-09,Fresno,019,978130,102248,101729,8656,110385,1682
2021-05-09,Glenn,021,27897,2410,2382,554,2936,17
2021-05-09,Humboldt,023,135768,4021,3950,33,3983,36
2021-05-09,Imperial,025,180216,28469,28388,2838,31226,722
2021-05-09,Inyo,027,18085,1402,1401,11,1412,36
2021-05-09,Kern,029,883053,96901,95903,10763,106666,1310
2021-05-09,Kings,031,150075,23105,22878,1088,23966,246
2021-05-09,Lake,033,64148,3483,3471,9,3480,43
2021-05-09,Lassen,035,31185,5183,5147,108,5255,5
2021-05-09,Los Angeles,037,10098052,1201984,1194820,41543,1236363,24026
2021-05-09,Madera,039,155013,16536,16444,923,17367,238
2021-05-09,Marin,041,260295,14025,13979,253,14232,228
2021-05-09,Mariposa,043,17540,424,420,11,431,5
2021-05-09,Mendocino,045,87422,3896,3814,79,3893,46
2021-05-09,Merced,047,269075,30850,30883,987,31870,448
2021-05-09,Modoc,049,8938,373,360,125,485,3
2021-05-09,Mono,051,14174,1251,1264,17,1281,3
2021-05-09,Monterey,053,433212,43092,42918,1872,44790,380
2021-05-09,Napa,055,140530,9853,9857,36,9893,81
2021-05-09,Nevada,057,99092,4756,4727,187,4914,70
2021-05-09,Orange,059,3164182,254770,253451,11283,264734,5008
2021-05-09,Placer,061,380077,22954,22566,1452,24018,286
2021-05-09,Plumas,063,18699,694,679,10,689,4
2021-05-09,Riverside,065,2383286,293323,287644,13971,301615,4427
2021-05-09,Sacramento,067,1510023,104633,104309,1737,106046,1612
2021-05-09,San Benito,069,59416,6049,6056,114,6170,63
2021-05-09,San Bernardino,071,2135413,292541,291337,8957,300294,4707
2021-05-09,San Diego,073,3302833,279012,277950,14703,292653,3725
2021-05-09,San Francisco,075,870044,36474,36669,1275,37944,543
2021-05-09,San Joaquin,077,732212,72541,71927,3513,75440,1356
2021-05-09,San Luis Obispo,079,281455,21284,20999,726,21725,256
2021-05-09,San Mateo,081,765935,42142,41903,466,42369,424
2021-05-09,Santa Barbara,083,443738,34255,34196,1195,35391,456
2021-05-09,Santa Clara,085,1922200,118093,118798,754,119552,2003
2021-05-09,Santa Cruz,087,273765,16156,16094,813,16907,206
2021-05-09,Shasta,089,179085,12066,12034,1520,13554,200
2021-05-09,Sierra,091,2930,56,54,12,66,0
2021-05-09,Siskiyou,093,43540,1843,1741,337,2078,13
2021-05-09,Solano,095,438530,32502,32434,537,32971,250
2021-05-09,Sonoma,097,501317,29792,29953,329,30282,318
2021-05-09,Stanislaus,099,539301,55754,55511,5873,61384,898
2021-05-09,Sutter,101,95872,9424,9413,83,9496,111
2021-05-09,Tehama,103,63373,5014,4979,562,5541,62
2021-05-09,Trinity,105,12862,482,327,87,414,3
2021-05-09,Tulare,107,460477,49987,48948,8979,57927,837
2021-05-09,Tuolumne,109,53932,3992,4053,38,4091,63
2021-05-09,Ventura,111,848112,81115,80487,2980,83467,1008
2021-05-09,Yolo,113,214977,13880,13897,302,14199,209
2021-05-09,Yuba,115,75493,5977,5934,122,6056,46
2021-05-08,Alameda,001,1643700,87423,87213,1938,89151,1284
2021-05-08,Alpine,003,1148,87,88,0,88,0
2021-05-08,Amador,005,37829,3659,3652,33,3685,46
2021-05-08,Butte,007,227075,12352,11962,1796,13758,199
2021-05-08,Calaveras,009,45235,2118,2114,14,2128,52
2021-05-08,Colusa,011,21464,1934,1939,297,2236,14
2021-05-08,Contra Costa,013,1133247,68817,68223,1251,69474,803
2021-05-08,Del Norte,015,27424,1373,1335,12,1347,8
2021-05-08,El Dorado,017,186661,10141,10079,717,10796,113
2021-05-08,Fresno,019,978130,102212,101676,8651,110327,1682
2021-05-08,Glenn,021,27897,2408,2382,552,2934,17
2021-05-08,Humboldt,023,135768,4005,3939,33,3972,36
2021-05-08,Imperial,025,180216,28461,28373,2838,31211,721
2021-05-08,Inyo,027,18085,1402,1402,11,1413,36
2021-05-08,Kern,029,883053,96876,95880,10750,106630,1310
2021-05-08,Kings,031,150075,23102,22872,1087,23959,246
2021-05-08,Lake,033,64148,3482,3470,9,3479,43
2021-05-08,Lassen,035,31185,5182,5145,108,5253,5
2021-05-08,Los Angeles,037,10098052,1201835,1194584,41527,1236111,24022
2021-05-08,Madera,039,155013,16532,16442,923,17365,238
2021-05-08,Marin,041,260295,14022,13974,252,14226,228
2021-05-08,Mariposa,043,17540,424,420,11,431,5
2021-05-08,Mendocino,045,87422,3891,3810,78,3888,46
2021-05-08,Merced,047,269075,30841,30876,987,31863,448
2021-05-08,Modoc,049,8938,373,360,124,484,3
2021-05-08,Mono,051,14174,1251,1262,17,1279,3
2021-05-08,Monterey,053,433212,43087,42914,1871,44785,380
2021-05-08,Napa,055,140530,9846,9853,36,9889,81
2021-05-08,Nevada,057,99092,4753,4716,187,4903,70
2021-05-08,Orange,059,3164182,254736,253412,11280,264692,5006
2021-05-08,Placer,061,380077,22936,22547,1450,23997,286
2021-05-08,Plumas,063,18699,693,679,10,689,4
2021-05-08,Riverside,065,2383286,293280,287574,13969,301543,4427
2021-05-08,Sacramento,067,1510023,104548,104208,1734,105942,1610
2021-05-08,San Benito,069,59416,6048,6048,114,6162,63
2021-05-08,San Bernardino,071,2135413,292498,291296,8957,300253,4707
2021-05-08,San Diego,073,3302833,278928,277760,14685,292445,3725
2021-05-08,San Francisco,075,870044,36451,36642,1275,37917,543
2021-05-08,San Joaquin,077,732212,72512,71869,3504,75373,1356
2021-05-08,San Luis Obispo,079,281455,21273,20992,726,21718,256
2021-05-08,San Mateo,081,765935,42131,41871,466,42337,424
2021-05-08,Santa Barbara,083,443738,34242,34185,1195,35380,456
2021-05-08,Santa Clara,085,1922200,118062,118751,754,119505,2003
2021-05-08,Santa Cruz,087,273765,16153,16089,813,16902,206
2021-05-08,Shasta,089,179085,12056,12030,1516,13546,200
2021-05-08,Sierra,091,2930,56,54,12,66,0
2021-05-08,Siskiyou,093,43540,1842,1741,333,2074,13
2021-05-08,Solano,095,438530,32477,32395,535,32930,249
2021-05-08,Sonoma,097,501317,29779,29942,329,30271,318
2021-05-08,Stanislaus,099,539301,55722,55467,5869,61336,898
2021-05-08,Sutter,101,95872,9421,9413,83,9496,111
2021-05-08,Tehama,103,63373,5012,4977,562,5539,62
2021-05-08,Trinity,105,12862,482,327,87,414,3
2021-05-08,Tulare,107,460477,49973,48929,8969,57898,837
2021-05-08,Tuolumne,109,53932,3991,4050,38,4088,63
2021-05-08,Ventura,111,848112,81104,80481,2977,83458,1008
2021-05-08,Yolo,113,214977,13877,13894,301,14195,209
2021-05-08,Yuba,115,75493,5969,5928,122,6050,46
2021-05-07,Alameda,001,1643700,87369,87128,1937,89065,1280
2021-05-07,Alpine,003,1148,87,88,0,88,0
2021-05-07,Amador,005,37829,3656,3651,33,3684,46
2021-05-07,Butte,007,227075,12332,11943,1793,13736,199
2021-05-07,Calaveras,009,45235,2116,2114,14,2128,52
2021-05-07,Colusa,011,21464,1934,1937,297,2234,14
2021-05-07,Contra Costa,013,1133247,68771,68156,1249,69405,804
2021-05-07,Del Norte,015,27424,1368,1329,12,1341,8
2021-05-07,El Dorado,017,186661,10128,10065,715,10780,112
2021-05-07,Fresno,019,978130,102179,101625,8650,110275,1684
2021-05-07,Glenn,021,27897,2405,2381,551,2932,17
2021-05-07,Humboldt,023,135768,3990,3919,33,3952,36
2021-05-07,Imperial,025,180216,28453,28352,2837,31189,721
2021-05-07,Inyo,027,18085,1402,1402,11,1413,36
2021-05-07,Kern,029,883053,96863,95839,10738,106577,1308
2021-05-07,Kings,031,150075,23101,22857,1086,23943,246
2021-05-07,Lake,033,64148,3480,3467,9,3476,43
2021-05-07,Lassen,035,31185,5181,5144,107,5251,5
2021-05-07,Los Angeles,037,10098052,1201657,1194294,41519,1235813,24008
2021-05-07,Madera,039,155013,16527,16439,922,17361,238
2021-05-07,Marin,041,260295,14018,13968,252,14220,228
2021-05-07,Mariposa,043,17540,423,419,11,430,5
2021-05-07,Mendocino,045,87422,3885,3805,78,3883,46
2021-05-07,Merced,047,269075,30838,30862,987,31849,446
2021-05-07,Modoc,049,8938,373,360,124,484,3
2021-05-07,Mono,051,14174,1250,1261,17,1278,3
2021-05-07,Monterey,053,433212,43081,42909,1869,44778,380
2021-05-07,Napa,055,140530,9845,9849,36,9885,81
2021-05-07,Nevada,057,99092,4749,4704,187,4891,70
2021-05-07,Orange,059,3164182,254696,253338,11271,264609,5000
2021-05-07,Placer,061,380077,22916,22524,1448,23972,286
2021-05-07,Plumas,063,18699,693,678,10,688,4
2021-05-07,Riverside,065,2383286,293222,287479,13968,301447,4426
2021-05-07,Sacramento,067,1510023,104476,104068,1729,105797,1609
2021-05-07,San Benito,069,59416,6047,6048,114,6162,63
2021-05-07,San Bernardino,071,2135413,292456,291185,8952,300137,4697
2021-05-07,San Diego,073,3302833,278843,277534,14670,292204,3718
2021-05-07,San Francisco,075,870044,36438,36616,1274,37890,543
2021-05-07,San Joaquin,077,732212,72472,71804,3502,75306,1351
2021-05-07,San Luis Obispo,079,281455,21266,20979,726,21705,256
2021-05-07,San Mateo,081,765935,42115,41844,466,42310,424
2021-05-07,Santa Barbara,083,443738,34232,34166,1195,35361,453
2021-05-07,Santa Clara,085,1922200,118029,118691,753,119444,2002
2021-05-07,Santa Cruz,087,273765,16150,16074,813,16887,206
2021-05-07,Shasta,089,179085,12034,12005,1514,13519,200
2021-05-07,Sierra,091,2930,56,54,12,66,0
2021-05-07,Siskiyou,093,43540,1839,1723,333,2056,13
2021-05-07,Solano,095,438530,32450,32352,533,32885,249
2021-05-07,Sonoma,097,501317,29761,29925,327,30252,318
2021-05-07,Stanislaus,099,539301,55681,55407,5863,61270,896
2021-05-07,Sutter,101,95872,9421,9407,82,9489,111
2021-05-07,Tehama,103,63373,5005,4974,562,5536,57
2021-05-07,Trinity,105,12862,482,327,87,414,3
2021-05-07,Tulare,107,460477,49956,48913,8964,57877,837
2021-05-07,Tuolumne,109,53932,3989,4048,38,4086,63
2021-05-07,Ventura,111,848112,81080,80444,2977,83421,1008
2021-05-07,Yolo,113,214977,13871,13875,300,14175,209
2021-05-07,Yuba,115,75493,5959,5910,122,6032,46
2021-05-06,Alameda,001,1643700,87292,87028,1934,88962,1278
2021-05-06,Alpine,003,1148,87,88,0,88,0
2021-05-06,Amador,005,37829,3654,3650,33,3683,46
2021-05-06,Butte,007,227075,12312,11929,1788,13717,198
2021-05-06,Calaveras,009,45235,2115,2111,14,2125,52
2021-05-06,Colusa,011,21464,1934,1935,297,2232,14
2021-05-06,Contra Costa,013,1133247,68716,68076,1246,69322,802
2021-05-06,Del Norte,015,27424,1360,1324,12,1336,6
2021-05-06,El Dorado,017,186661,10121,10048,715,10763,112
2021-05-06,Fresno,019,978130,102135,101536,8646,110182,1680
2021-05-06,Glenn,021,27897,2404,2380,550,2930,17
2021-05-06,Humboldt,023,135768,3965,3898,33,3931,36
2021-05-06,Imperial,025,180216,28442,28311,2836,31147,720
2021-05-06,Inyo,027,18085,1402,1401,11,1412,36
2021-05-06,Kern,029,883053,96838,95801,10721,106522,1307
2021-05-06,Kings,031,150075,23094,22848,1085,23933,246
2021-05-06,Lake,033,64148,3479,3465,9,3474,43
2021-05-06,Lassen,035,31185,5180,5143,107,5250,1
2021-05-06,Los Angeles,037,10098052,1201416,1193954,41502,1235456,23991
2021-05-06,Madera,039,155013,16519,16430,922,17352,238
2021-05-06,Marin,041,260295,14014,13956,252,14208,228
2021-05-06,Mariposa,043,17540,422,419,11,430,5
2021-05-06,Mendocino,045,87422,3874,3802,78,3880,46
2021-05-06,Merced,047,269075,30822,30863,986,31849,444
2021-05-06,Modoc,049,8938,373,360,124,484,3
2021-05-06,Mono,051,14174,1248,1261,17,1278,3
2021-05-06,Monterey,053,433212,43066,42899,1869,44768,379
2021-05-06,Napa,055,140530,9839,9843,36,9879,81
2021-05-06,Nevada,057,99092,4748,4687,187,4874,70
2021-05-06,Orange,059,3164182,254628,253286,11265,264551,4991
2021-05-06,Placer,061,380077,22894,22493,1448,23941,286
2021-05-06,Plumas,063,18699,693,678,10,688,4
2021-05-06,Riverside,065,2383286,293149,287399,13963,301362,4422
2021-05-06,Sacramento,067,1510023,104359,103956,1726,105682,1609
2021-05-06,San Benito,069,59416,6046,6045,114,6159,63
2021-05-06,San Bernardino,071,2135413,292386,291085,8951,300036,4683
2021-05-06,San Diego,073,3302833,278719,277324,14647,291971,3716
2021-05-06,San Francisco,075,870044,36423,36599,1274,37873,543
2021-05-06,San Joaquin,077,732212,72417,71729,3499,75228,1350
2021-05-06,San Luis Obispo,079,281455,21254,20965,724,21689,256
2021-05-06,San Mateo,081,765935,42096,41802,465,42267,424
2021-05-06,Santa Barbara,083,443738,34219,34152,1195,35347,453
2021-05-06,Santa Clara,085,1922200,117988,118591,753,119344,2001
2021-05-06,Santa Cruz,087,273765,16143,16050,813,16863,206
2021-05-06,Shasta,089,179085,12012,11983,1508,13491,199
2021-05-06,Sierra,091,2930,56,54,12,66,0
2021-05-06,Siskiyou,093,43540,1829,1711,332,2043,12
2021-05-06,Solano,095,438530,32424,32320,525,32845,249
2021-05-06,Sonoma,097,501317,29753,29911,327,30238,318
2021-05-06,Stanislaus,099,539301,55625,55323,5859,61182,834
2021-05-06,Sutter,101,95872,9415,9396,82,9478,111
2021-05-06,Tehama,103,63373,5000,4970,562,5532,53
2021-05-06,Trinity,105,12862,482,327,87,414,3
2021-05-06,Tulare,107,460477,49931,48890,8949,57839,836
2021-05-06,Tuolumne,109,53932,3985,4047,38,4085,63
2021-05-06,Ventura,111,848112,81049,80411,2974,83385,1005
2021-05-06,Yolo,113,214977,13864,13871,296,14167,209
2021-05-06,Yuba,115,75493,5947,5901,122,6023,46
2021-05-05,Alameda,001,1643700,87230,86950,1932,88882,1278
2021-05-05,Alpine,003,1148,87,88,0,88,0
2021-05-05,Amador,005,37829,3651,3650,33,3683,46
2021-05-05,Butte,007,227075,12294,11907,1785,13692,198
2021-05-05,Calaveras,009,45235,2111,2103,14,2117,52
2021-05-05,Colusa,011,21464,1933,1933,297,2230,14
2021-05-05,Contra Costa,013,1133247,68651,67997,1242,69239,803
2021-05-05,Del Norte,015,27424,1357,1317,12,1329,6
2021-05-05,El Dorado,017,186661,10110,10020,714,10734,111
2021-05-05,Fresno,019,978130,102086,101491,8637,110128,1680
2021-05-05,Glenn,021,27897,2401,2380,549,2929,17
2021-05-05,Humboldt,023,135768,3946,3886,32,3918,36
2021-05-05,Imperial,025,180216,28401,28295,2829,31124,720
2021-05-05,Inyo,027,18085,1401,1401,11,1412,36
2021-05-05,Kern,029,883053,96794,95753,10717,106470,1304
2021-05-05,Kings,031,150075,23088,22840,1084,23924,246
2021-05-05,Lake,033,64148,3476,3458,9,3467,43
2021-05-05,Lassen,035,31185,5180,5143,106,5249,1
2021-05-05,Los Angeles,037,10098052,1201145,1193608,41488,1235096,23977
2021-05-05,Madera,039,155013,16517,16423,922,17345,235
2021-05-05,Marin,041,260295,14006,13950,251,14201,228
2021-05-05,Mariposa,043,17540,422,418,11,429,5
2021-05-05,Mendocino,045,87422,3870,3799,78,3877,46
2021-05-05,Merced,047,269075,30801,30844,986,31830,444
2021-05-05,Modoc,049,8938,372,361,123,484,3
2021-05-05,Mono,051,14174,1248,1260,17,1277,3
2021-05-05,Monterey,053,433212,43052,42870,1866,44736,379
2021-05-05,Napa,055,140530,9833,9833,36,9869,81
2021-05-05,Nevada,057,99092,4745,4666,187,4853,70
2021-05-05,Orange,059,3164182,254570,253237,11260,264497,4978
2021-05-05,Placer,061,380077,22862,22362,1444,23806,287
2021-05-05,Plumas,063,18699,693,677,10,687,4
2021-05-05,Riverside,065,2383286,293054,287353,13953,301306,4414
2021-05-05,Sacramento,067,1510023,104271,103476,1721,105197,1607
2021-05-05,San Benito,069,59416,6037,6046,114,6160,63
2021-05-05,San Bernardino,071,2135413,292311,291008,8947,299955,4677
2021-05-05,San Diego,073,3302833,278582,277098,14627,291725,3716
2021-05-05,San Francisco,075,870044,36409,36577,1273,37850,543
2021-05-05,San Joaquin,077,732212,72364,71638,3496,75134,1345
2021-05-05,San Luis Obispo,079,281455,21246,20958,724,21682,256
2021-05-05,San Mateo,081,765935,42066,41755,464,42219,415
2021-05-05,Santa Barbara,083,443738,34204,34139,1194,35333,453
2021-05-05,Santa Clara,085,1922200,117958,118482,749,119231,1992
2021-05-05,Santa Cruz,087,273765,16137,16013,813,16826,207
2021-05-05,Shasta,089,179085,11996,11939,1504,13443,200
2021-05-05,Sierra,091,2930,56,54,12,66,0
2021-05-05,Siskiyou,093,43540,1812,1706,324,2030,11
2021-05-05,Solano,095,438530,32389,32250,523,32773,249
2021-05-05,Sonoma,097,501317,29740,29879,327,30206,318
2021-05-05,Stanislaus,099,539301,55568,55231,5857,61088,807
2021-05-05,Sutter,101,95872,9409,9387,82,9469,111
2021-05-05,Tehama,103,63373,4996,4968,562,5530,53
2021-05-05,Trinity,105,12862,482,326,87,413,3
2021-05-05,Tulare,107,460477,49907,48875,8942,57817,835
2021-05-05,Tuolumne,109,53932,3982,4040,38,4078,63
2021-05-05,Ventura,111,848112,81021,80372,2970,83342,1005
2021-05-05,Yolo,113,214977,13860,13846,294,14140,209
2021-05-05,Yuba,115,75493,5937,5895,121,6016,44
2021-05-04,Alameda,001,1643700,87138,86894,1932,88826,1277
2021-05-04,Alpine,003,1148,87,88,0,88,0
2021-05-04,Amador,005,37829,3651,3650,33,3683,46
2021-05-04,Butte,007,227075,12270,11883,1784,13667,198
2021-05-04,Calaveras,009,45235,2106,2100,14,2114,52
2021-05-04,Colusa,011,21464,1932,1933,297,2230,14
2021-05-04,Contra Costa,013,1133247,68572,67931,1239,69170,799
2021-05-04,Del Norte,015,27424,1357,1314,12,1326,6
2021-05-04,El Dorado,017,186661,10099,10009,710,10719,110
2021-05-04,Fresno,019,978130,102031,101451,8630,110081,1677
2021-05-04,Glenn,021,27897,2398,2379,546,2925,17
2021-05-04,Humboldt,023,135768,3920,3877,32,3909,36
2021-05-04,Imperial,025,180216,28381,28276,2825,31101,720
2021-05-04,Inyo,027,18085,1401,1399,11,1410,36
2021-05-04,Kern,029,883053,96758,95720,10699,106419,1301
2021-05-04,Kings,031,150075,23074,22822,1081,23903,246
2021-05-04,Lake,033,64148,3475,3454,9,3463,43
2021-05-04,Lassen,035,31185,5179,5142,106,5248,1
2021-05-04,Los Angeles,037,10098052,1200858,1193453,41476,1234929,23957
2021-05-04,Madera,039,155013,16516,16418,922,17340,235
2021-05-04,Marin,041,260295,13998,13935,251,14186,228
2021-05-04,Mariposa,043,17540,422,418,11,429,5
2021-05-04,Mendocino,045,87422,3865,3794,78,3872,46
2021-05-04,Merced,047,269075,30784,30829,986,31815,444
2021-05-04,Modoc,049,8938,371,360,122,482,3
2021-05-04,Mono,051,14174,1248,1260,17,1277,3
2021-05-04,Monterey,053,433212,43040,42845,1865,44710,380
2021-05-04,Napa,055,140530,9824,9824,36,9860,81
2021-05-04,Nevada,057,99092,4738,4656,187,4843,70
2021-05-04,Orange,059,3164182,254503,253177,11250,264427,4977
2021-05-04,Placer,061,380077,22833,22326,1441,23767,287
2021-05-04,Plumas,063,18699,692,675,10,685,4
2021-05-04,Riverside,065,2383286,292970,287285,13946,301231,4411
2021-05-04,Sacramento,067,1510023,104142,103383,1716,105099,1604
2021-05-04,San Benito,069,59416,6036,6039,114,6153,63
2021-05-04,San Bernardino,071,2135413,292234,290934,8940,299874,4668
2021-05-04,San Diego,073,3302833,278416,276879,14610,291489,3713
2021-05-04,San Francisco,075,870044,36391,36550,1273,37823,541
2021-05-04,San Joaquin,077,732212,72303,71582,3491,75073,1342
2021-05-04,San Luis Obispo,079,281455,21240,20923,722,21645,255
2021-05-04,San Mateo,081,765935,42040,41708,464,42172,415
2021-05-04,Santa Barbara,083,443738,34188,34131,1193,35324,453
2021-05-04,Santa Clara,085,1922200,117895,118431,748,119179,1988
2021-05-04,Santa Cruz,087,273765,16131,16005,813,16818,207
2021-05-04,Shasta,089,179085,11976,11923,1498,13421,198
2021-05-04,Sierra,091,2930,56,54,12,66,0
2021-05-04,Siskiyou,093,43540,1805,1694,322,2016,11
2021-05-04,Solano,095,438530,32348,32220,521,32741,249
2021-05-04,Sonoma,097,501317,29720,29867,326,30193,318
2021-05-04,Stanislaus,099,539301,55512,55165,5854,61019,807
2021-05-04,Sutter,101,95872,9404,9375,82,9457,111
2021-05-04,Tehama,103,63373,4993,4959,561,5520,53
2021-05-04,Trinity,105,12862,482,326,87,413,3
2021-05-04,Tulare,107,460477,49880,48857,8933,57790,835
2021-05-04,Tuolumne,109,53932,3980,4041,38,4079,61
2021-05-04,Ventura,111,848112,80992,80351,2968,83319,1005
2021-05-04,Yolo,113,214977,13847,13820,292,14112,208
2021-05-04,Yuba,115,75493,5931,5891,121,6012,44
2021-05-03,Alameda,001,1643700,87062,86845,1926,88771,1272
2021-05-03,Alpine,003,1148,87,88,0,88,0
2021-05-03,Amador,005,37829,3651,3651,33,3684,46
2021-05-03,Butte,007,227075,12260,11864,1781,13645,198
2021-05-03,Calaveras,009,45235,2105,2099,14,2113,50
2021-05-03,Colusa,011,21464,1931,1931,295,2226,14
2021-05-03,Contra Costa,013,1133247,68513,67895,1235,69130,799
2021-05-03,Del Norte,015,27424,1352,1306,11,1317,6
2021-05-03,El Dorado,017,186661,10081,9984,705,10689,110
2021-05-03,Fresno,019,978130,101975,101405,8619,110024,1678
2021-05-03,Glenn,021,27897,2398,2375,545,2920,17
2021-05-03,Humboldt,023,135768,3905,3865,32,3897,36
2021-05-03,Imperial,025,180216,28359,28280,2822,31102,720
2021-05-03,Inyo,027,18085,1400,1398,11,1409,36
2021-05-03,Kern,029,883053,96721,95693,10687,106380,1299
2021-05-03,Kings,031,150075,23065,22821,1081,23902,246
2021-05-03,Lake,033,64148,3473,3446,9,3455,43
2021-05-03,Lassen,035,31185,5178,5142,106,5248,1
2021-05-03,Los Angeles,037,10098052,1200589,1193261,41450,1234711,23942
2021-05-03,Madera,039,155013,16511,16414,921,17335,235
2021-05-03,Marin,041,260295,13992,13927,251,14178,228
2021-05-03,Mariposa,043,17540,422,418,11,429,5
2021-05-03,Mendocino,045,87422,3858,3792,78,3870,46
2021-05-03,Merced,047,269075,30773,30814,984,31798,444
2021-05-03,Modoc,049,8938,371,360,122,482,3
2021-05-03,Mono,051,14174,1248,1259,17,1276,3
2021-05-03,Monterey,053,433212,43028,42837,1863,44700,380
2021-05-03,Napa,055,140530,9819,9815,36,9851,81
2021-05-03,Nevada,057,99092,4730,4650,187,4837,70
2021-05-03,Orange,059,3164182,254444,253107,11241,264348,4968
2021-05-03,Placer,061,380077,22802,22289,1435,23724,287
2021-05-03,Plumas,063,18699,691,675,10,685,4
2021-05-03,Riverside,065,2383286,292896,287233,13945,301178,4412
2021-05-03,Sacramento,067,1510023,103989,103303,1706,105009,1602
2021-05-03,San Benito,069,59416,6035,6038,114,6152,63
2021-05-03,San Bernardino,071,2135413,292166,290886,8937,299823,4659
2021-05-03,San Diego,073,3302833,278253,276693,14585,291278,3712
2021-05-03,San Francisco,075,870044,36365,36538,1273,37811,541
2021-05-03,San Joaquin,077,732212,72253,71504,3488,74992,1325
2021-05-03,San Luis Obispo,079,281455,21224,20915,719,21634,254
2021-05-03,San Mateo,081,765935,42017,41689,463,42152,413
2021-05-03,Santa Barbara,083,443738,34176,34119,1193,35312,453
2021-05-03,Santa Clara,085,1922200,117841,118373,747,119120,1988
2021-05-03,Santa Cruz,087,273765,16128,16000,813,16813,207
2021-05-03,Shasta,089,179085,11953,11890,1493,13383,197
2021-05-03,Sierra,091,2930,56,54,12,66,0
2021-05-03,Siskiyou,093,43540,1799,1683,316,1999,11
2021-05-03,Solano,095,438530,32307,32201,520,32721,249
2021-05-03,Sonoma,097,501317,29708,29855,323,30178,318
2021-05-03,Stanislaus,099,539301,55446,55116,5845,60961,774
2021-05-03,Sutter,101,95872,9392,9370,82,9452,111
2021-05-03,Tehama,103,63373,4984,4952,561,5513,53
2021-05-03,Trinity,105,12862,482,326,87,413,3
2021-05-03,Tulare,107,460477,49863,48844,8923,57767,835
2021-05-03,Tuolumne,109,53932,3979,4038,38,4076,61
2021-05-03,Ventura,111,848112,80970,80291,2968,83259,1005
2021-05-03,Yolo,113,214977,13834,13809,290,14099,208
2021-05-03,Yuba,115,75493,5926,5880,121,6001,44
2021-05-02,Alameda,001,1643700,86977,86784,1925,88709,1272
2021-05-02,Alpine,003,1148,87,88,0,88,0
2021-05-02,Amador,005,37829,3651,3650,33,3683,46
2021-05-02,Butte,007,227075,12236,11859,1778,13637,198
2021-05-02,Calaveras,009,45235,2101,2098,14,2112,50
2021-05-02,Colusa,011,21464,1930,1931,294,2225,14
2021-05-02,Contra Costa,013,1133247,68428,67843,1233,69076,800
2021-05-02,Del Norte,015,27424,1345,1305,11,1316,6
2021-05-02,El Dorado,017,186661,10066,9962,704,10666,110
2021-05-02,Fresno,019,978130,101904,101372,8608,109980,1678
2021-05-02,Glenn,021,27897,2397,2374,543,2917,17
2021-05-02,Humboldt,023,135768,3893,3858,31,3889,36
2021-05-02,Imperial,025,180216,28325,28275,2812,31087,721
2021-05-02,Inyo,027,18085,1398,1398,11,1409,36
2021-05-02,Kern,029,883053,96663,95668,10680,106348,1299
2021-05-02,Kings,031,150075,23047,22816,1080,23896,246
2021-05-02,Lake,033,64148,3471,3443,9,3452,43
2021-05-02,Lassen,035,31185,5177,5142,105,5247,1
2021-05-02,Los Angeles,037,10098052,1200239,1193056,41427,1234483,23943
2021-05-02,Madera,039,155013,16505,16410,921,17331,235
2021-05-02,Marin,041,260295,13982,13917,251,14168,228
2021-05-02,Mariposa,043,17540,422,419,11,430,5
2021-05-02,Mendocino,045,87422,3853,3787,78,3865,46
2021-05-02,Merced,047,269075,30751,30793,982,31775,444
2021-05-02,Modoc,049,8938,370,360,122,482,3
2021-05-02,Mono,051,14174,1247,1259,17,1276,3
2021-05-02,Monterey,053,433212,43014,42837,1862,44699,380
2021-05-02,Napa,055,140530,9815,9805,36,9841,81
2021-05-02,Nevada,057,99092,4714,4635,187,4822,70
2021-05-02,Orange,059,3164182,254370,253025,11227,264252,4968
2021-05-02,Placer,061,380077,22773,22264,1432,23696,287
2021-05-02,Plumas,063,18699,691,675,10,685,4
2021-05-02,Riverside,065,2383286,292796,287197,13935,301132,4412
2021-05-02,Sacramento,067,1510023,103849,103153,1699,104852,1602
2021-05-02,San Benito,069,59416,6030,6037,114,6151,63
2021-05-02,San Bernardino,071,2135413,292067,290859,8935,299794,4655
2021-05-02,San Diego,073,3302833,278056,276521,14558,291079,3712
2021-05-02,San Francisco,075,870044,36339,36522,1273,37795,541
2021-05-02,San Joaquin,077,732212,72189,71447,3481,74928,1325
2021-05-02,San Luis Obispo,079,281455,21203,20910,718,21628,254
2021-05-02,San Mateo,081,765935,42001,41656,462,42118,412
2021-05-02,Santa Barbara,083,443738,34162,34106,1193,35299,453
2021-05-02,Santa Clara,085,1922200,117767,118321,747,119068,1988
2021-05-02,Santa Cruz,087,273765,16123,15995,812,16807,207
2021-05-02,Shasta,089,179085,11937,11885,1485,13370,197
2021-05-02,Sierra,091,2930,56,54,12,66,0
2021-05-02,Siskiyou,093,43540,1788,1661,315,1976,11
2021-05-02,Solano,095,438530,32268,32151,516,32667,249
2021-05-02,Sonoma,097,501317,29686,29842,323,30165,318
2021-05-02,Stanislaus,099,539301,55373,55057,5838,60895,774
2021-05-02,Sutter,101,95872,9385,9363,82,9445,111
2021-05-02,Tehama,103,63373,4979,4950,559,5509,53
2021-05-02,Trinity,105,12862,482,326,87,413,3
2021-05-02,Tulare,107,460477,49845,48834,8915,57749,835
2021-05-02,Tuolumne,109,53932,3976,4038,38,4076,61
2021-05-02,Ventura,111,848112,80933,80284,2967,83251,1005
2021-05-02,Yolo,113,214977,13822,13799,289,14088,208
2021-05-02,Yuba,115,75493,5916,5879,121,6000,44
2021-05-01,Alameda,001,1643700,86934,86704,1922,88626,1270
2021-05-01,Alpine,003,1148,87,88,0,88,0
2021-05-01,Amador,005,37829,3651,3650,33,3683,46
2021-05-01,Butte,007,227075,12222,11845,1773,13618,198
2021-05-01,Calaveras,009,45235,2099,2096,14,2110,50
2021-05-01,Colusa,011,21464,1929,1931,294,2225,14
2021-05-01,Contra Costa,013,1133247,68376,67779,1230,69009,800
2021-05-01,Del Norte,015,27424,1344,1292,11,1303,6
2021-05-01,El Dorado,017,186661,10052,9944,702,10646,110
2021-05-01,Fresno,019,978130,101859,101326,8602,109928,1678
2021-05-01,Glenn,021,27897,2394,2369,542,2911,17
2021-05-01,Humboldt,023,135768,3879,3845,31,3876,36
2021-05-01,Imperial,025,180216,28318,28262,2812,31074,721
2021-05-01,Inyo,027,18085,1398,1397,11,1408,36
2021-05-01,Kern,029,883053,96636,95645,10668,106313,1299
2021-05-01,Kings,031,150075,23044,22797,1079,23876,246
2021-05-01,Lake,033,64148,3469,3441,9,3450,43
2021-05-01,Lassen,035,31185,5175,5142,105,5247,1
2021-05-01,Los Angeles,037,10098052,1200070,1192781,41412,1234193,23946
2021-05-01,Madera,039,155013,16501,16408,921,17329,235
2021-05-01,Marin,041,260295,13975,13902,251,14153,228
2021-05-01,Mariposa,043,17540,422,418,11,429,5
2021-05-01,Mendocino,045,87422,3851,3782,78,3860,46
2021-05-01,Merced,047,269075,30733,30771,982,31753,444
2021-05-01,Modoc,049,8938,370,361,122,483,3
2021-05-01,Mono,051,14174,1247,1258,17,1275,3
2021-05-01,Monterey,053,433212,43008,42828,1862,44690,379
2021-05-01,Napa,055,140530,9812,9800,36,9836,81
2021-05-01,Nevada,057,99092,4709,4625,187,4812,70
2021-05-01,Orange,059,3164182,254327,252969,11216,264185,4964
2021-05-01,Placer,061,380077,22747,22240,1430,23670,287
2021-05-01,Plumas,063,18699,690,675,10,685,4
2021-05-01,Riverside,065,2383286,292757,287129,13933,301062,4412
2021-05-01,Sacramento,067,1510023,103768,103043,1698,104741,1602
2021-05-01,San Benito,069,59416,6027,6030,114,6144,63
2021-05-01,San Bernardino,071,2135413,292024,290802,8933,299735,4652
2021-05-01,San Diego,073,3302833,277932,276367,14537,290904,3706
2021-05-01,San Francisco,075,870044,36324,36496,1273,37769,541
2021-05-01,San Joaquin,077,732212,72140,71389,3479,74868,1325
2021-05-01,San Luis Obispo,079,281455,21198,20896,718,21614,254
2021-05-01,San Mateo,081,765935,41972,41617,461,42078,411
2021-05-01,Santa Barbara,083,443738,34157,34085,1192,35277,453
2021-05-01,Santa Clara,085,1922200,117715,118265,745,119010,1988
2021-05-01,Santa Cruz,087,273765,16120,15984,812,16796,207
2021-05-01,Shasta,089,179085,11917,11878,1477,13355,197
2021-05-01,Sierra,091,2930,56,53,12,65,0
2021-05-01,Siskiyou,093,43540,1780,1653,314,1967,11
2021-05-01,Solano,095,438530,32238,32124,508,32632,249
2021-05-01,Sonoma,097,501317,29683,29835,323,30158,318
2021-05-01,Stanislaus,099,539301,55338,55005,5832,60837,774
2021-05-01,Sutter,101,95872,9382,9358,82,9440,110
2021-05-01,Tehama,103,63373,4978,4950,558,5508,53
2021-05-01,Trinity,105,12862,482,326,86,412,3
2021-05-01,Tulare,107,460477,49838,48818,8909,57727,835
2021-05-01,Tuolumne,109,53932,3970,4035,38,4073,61
2021-05-01,Ventura,111,848112,80915,80268,2967,83235,1005
2021-05-01,Yolo,113,214977,13815,13784,287,14071,208
2021-05-01,Yuba,115,75493,5914,5875,121,5996,44
2021-04-30,Alameda,001,1643700,86873,86602,1919,88521,1268
2021-04-30,Alpine,003,1148,87,88,0,88,0
2021-04-30,Amador,005,37829,3649,3650,33,3683,46
2021-04-30,Butte,007,227075,12203,11812,1769,13581,197
2021-04-30,Calaveras,009,45235,2098,2087,14,2101,50
2021-04-30,Colusa,011,21464,1929,1931,293,2224,14
2021-04-30,Contra Costa,013,1133247,68328,67684,1227,68911,800
2021-04-30,Del Norte,015,27424,1332,1276,11,1287,6
2021-04-30,El Dorado,017,186661,10038,9906,702,10608,110
2021-04-30,Fresno,019,978130,101813,101263,8598,109861,1670
2021-04-30,Glenn,021,27897,2393,2369,542,2911,17
2021-04-30,Humboldt,023,135768,3866,3834,31,3865,36
2021-04-30,Imperial,025,180216,28309,28244,2808,31052,721
2021-04-30,Inyo,027,18085,1398,1397,11,1408,36
2021-04-30,Kern,029,883053,96619,95605,10664,106269,1298
2021-04-30,Kings,031,150075,23041,22793,1078,23871,246
2021-04-30,Lake,033,64148,3465,3440,9,3449,43
2021-04-30,Lassen,035,31185,5174,5140,105,5245,1
2021-04-30,Los Angeles,037,10098052,1199860,1192393,41399,1233792,23919
2021-04-30,Madera,039,155013,16495,16395,921,17316,235
2021-04-30,Marin,041,260295,13967,13895,249,14144,228
2021-04-30,Mariposa,043,17540,422,417,11,428,5
2021-04-30,Mendocino,045,87422,3847,3777,78,3855,46
2021-04-30,Merced,047,269075,30720,30740,981,31721,444
2021-04-30,Modoc,049,8938,369,360,122,482,3
2021-04-30,Mono,051,14174,1247,1258,17,1275,3
2021-04-30,Monterey,053,433212,42994,42810,1861,44671,379
2021-04-30,Napa,055,140530,9808,9792,36,9828,81
2021-04-30,Nevada,057,99092,4701,4608,187,4795,70
2021-04-30,Orange,059,3164182,254270,252883,11210,264093,4956
2021-04-30,Placer,061,380077,22728,22190,1426,23616,287
2021-04-30,Plumas,063,18699,690,677,10,687,4
2021-04-30,Riverside,065,2383286,292699,287030,13926,300956,4412
2021-04-30,Sacramento,067,1510023,103667,102864,1694,104558,1596
2021-04-30,San Benito,069,59416,6023,6024,113,6137,63
2021-04-30,San Bernardino,071,2135413,291963,290704,8932,299636,4640
2021-04-30,San Diego,073,3302833,277837,276157,14526,290683,3702
2021-04-30,San Francisco,075,870044,36313,36453,1272,37725,538
2021-04-30,San Joaquin,077,732212,72088,71311,3476,74787,1306
2021-04-30,San Luis Obispo,079,281455,21192,20884,718,21602,255
2021-04-30,San Mateo,081,765935,41957,41583,460,42043,380
2021-04-30,Santa Barbara,083,443738,34144,34061,1192,35253,451
2021-04-30,Santa Clara,085,1922200,117657,118170,741,118911,1988
2021-04-30,Santa Cruz,087,273765,16115,15975,812,16787,207
2021-04-30,Shasta,089,179085,11896,11848,1474,13322,197
2021-04-30,Sierra,091,2930,56,53,12,65,0
2021-04-30,Siskiyou,093,43540,1769,1628,311,1939,11
2021-04-30,Solano,095,438530,32206,32050,505,32555,249
2021-04-30,Sonoma,097,501317,29673,29816,321,30137,318
2021-04-30,Stanislaus,099,539301,55287,54938,5829,60767,774
2021-04-30,Sutter,101,95872,9380,9353,82,9435,110
2021-04-30,Tehama,103,63373,4976,4944,558,5502,53
2021-04-30,Trinity,105,12862,482,326,86,412,3
2021-04-30,Tulare,107,460477,49828,48797,8893,57690,836
2021-04-30,Tuolumne,109,53932,3969,4033,38,4071,61
2021-04-30,Ventura,111,848112,80875,80232,2962,83194,1004
2021-04-30,Yolo,113,214977,13802,13756,287,14043,208
2021-04-30,Yuba,115,75493,5906,5870,121,5991,44
2021-04-29,Alameda,001,1643700,86807,86490,1918,88408,1263
2021-04-29,Alpine,003,1148,87,88,0,88,0
2021-04-29,Amador,005,37829,3649,3649,33,3682,46
2021-04-29,Butte,007,227075,12188,11787,1767,13554,196
2021-04-29,Calaveras,009,45235,2095,2082,14,2096,50
2021-04-29,Colusa,011,21464,1929,1929,293,2222,14
2021-04-29,Contra Costa,013,1133247,68273,67606,1224,68830,795
2021-04-29,Del Norte,015,27424,1328,1271,11,1282,6
2021-04-29,El Dorado,017,186661,10018,9884,699,10583,107
2021-04-29,Fresno,019,978130,101759,101189,8587,109776,1667
2021-04-29,Glenn,021,27897,2390,2369,542,2911,17
2021-04-29,Humboldt,023,135768,3852,3815,31,3846,36
2021-04-29,Imperial,025,180216,28297,28235,2807,31042,720
2021-04-29,Inyo,027,18085,1398,1396,11,1407,36
2021-04-29,Kern,029,883053,96586,95547,10660,106207,1295
2021-04-29,Kings,031,150075,23031,22777,1073,23850,245
2021-04-29,Lake,033,64148,3457,3438,9,3447,43
2021-04-29,Lassen,035,31185,5174,5140,105,5245,1
2021-04-29,Los Angeles,037,10098052,1199582,1192068,41378,1233446,23899
2021-04-29,Madera,039,155013,16490,16383,920,17303,235
2021-04-29,Marin,041,260295,13963,13884,241,14125,228
2021-04-29,Mariposa,043,17540,421,416,11,427,5
2021-04-29,Mendocino,045,87422,3841,3774,78,3852,46
2021-04-29,Merced,047,269075,30700,30706,981,31687,444
2021-04-29,Modoc,049,8938,369,360,122,482,3
2021-04-29,Mono,051,14174,1245,1259,17,1276,3
2021-04-29,Monterey,053,433212,42977,42797,1860,44657,379
2021-04-29,Napa,055,140530,9794,9789,36,9825,81
2021-04-29,Nevada,057,99092,4690,4590,187,4777,70
2021-04-29,Orange,059,3164182,254200,252823,11195,264018,4934
2021-04-29,Placer,061,380077,22703,22161,1424,23585,286
2021-04-29,Plumas,063,18699,689,676,10,686,4
2021-04-29,Riverside,065,2383286,292631,286947,13923,300870,4409
2021-04-29,Sacramento,067,1510023,103534,102686,1684,104370,1593
2021-04-29,San Benito,069,59416,6022,6023,113,6136,63
2021-04-29,San Bernardino,071,2135413,291891,290606,8927,299533,4609
2021-04-29,San Diego,073,3302833,277687,275961,14509,290470,3700
2021-04-29,San Francisco,075,870044,36287,36412,1272,37684,537
2021-04-29,San Joaquin,077,732212,72022,71225,3471,74696,1301
2021-04-29,San Luis Obispo,079,281455,21181,20876,718,21594,255
2021-04-29,San Mateo,081,765935,41929,41538,459,41997,358
2021-04-29,Santa Barbara,083,443738,34128,34039,1190,35229,448
2021-04-29,Santa Clara,085,1922200,117602,118082,738,118820,1984
2021-04-29,Santa Cruz,087,273765,16109,15961,812,16773,205
2021-04-29,Shasta,089,179085,11865,11836,1466,13302,193
2021-04-29,Sierra,091,2930,56,53,12,65,0
2021-04-29,Siskiyou,093,43540,1760,1615,308,1923,11
2021-04-29,Solano,095,438530,32165,32002,501,32503,248
2021-04-29,Sonoma,097,501317,29658,29785,318,30103,318
2021-04-29,Stanislaus,099,539301,55220,54836,5824,60660,774
2021-04-29,Sutter,101,95872,9373,9346,82,9428,110
2021-04-29,Tehama,103,63373,4968,4939,558,5497,53
2021-04-29,Trinity,105,12862,482,326,86,412,3
2021-04-29,Tulare,107,460477,49810,48785,8881,57666,832
2021-04-29,Tuolumne,109,53932,3968,4030,38,4068,58
2021-04-29,Ventura,111,848112,80841,80188,2960,83148,1002
2021-04-29,Yolo,113,214977,13782,13745,286,14031,205
2021-04-29,Yuba,115,75493,5896,5865,121,5986,44
2021-04-28,Alameda,001,1643700,86735,86390,1914,88304,1260
2021-04-28,Alpine,003,1148,87,88,0,88,0
2021-04-28,Amador,005,37829,3649,3646,33,3679,46
2021-04-28,Butte,007,227075,12168,11762,1762,13524,196
2021-04-28,Calaveras,009,45235,2091,2078,13,2091,50
2021-04-28,Colusa,011,21464,1926,1927,292,2219,14
2021-04-28,Contra Costa,013,1133247,68213,67539,1223,68762,795
2021-04-28,Del Norte,015,27424,1320,1267,11,1278,6
2021-04-28,El Dorado,017,186661,9993,9873,699,10572,107
2021-04-28,Fresno,019,978130,101712,101161,8577,109738,1666
2021-04-28,Glenn,021,27897,2387,2368,542,2910,17
2021-04-28,Humboldt,023,135768,3836,3796,31,3827,36
2021-04-28,Imperial,025,180216,28283,28177,2805,30982,720
2021-04-28,Inyo,027,18085,1398,1396,10,1406,36
2021-04-28,Kern,029,883053,96556,95494,10651,106145,1295
2021-04-28,Kings,031,150075,23019,22767,1071,23838,245
2021-04-28,Lake,033,64148,3454,3433,9,3442,43
2021-04-28,Lassen,035,31185,5174,5138,105,5243,1
2021-04-28,Los Angeles,037,10098052,1199286,1191729,41352,1233081,23858
2021-04-28,Madera,039,155013,16486,16372,920,17292,235
2021-04-28,Marin,041,260295,13952,13866,241,14107,227
2021-04-28,Mariposa,043,17540,418,415,11,426,5
2021-04-28,Mendocino,045,87422,3835,3770,76,3846,46
2021-04-28,Merced,047,269075,30681,30649,981,31630,443
2021-04-28,Modoc,049,8938,369,360,122,482,3
2021-04-28,Mono,051,14174,1245,1258,17,1275,3
2021-04-28,Monterey,053,433212,42972,42776,1860,44636,379
2021-04-28,Napa,055,140530,9783,9777,36,9813,81
2021-04-28,Nevada,057,99092,4670,4570,187,4757,70
2021-04-28,Orange,059,3164182,254120,252747,11182,263929,4931
2021-04-28,Placer,061,380077,22676,22115,1423,23538,285
2021-04-28,Plumas,063,18699,689,676,10,686,4
2021-04-28,Riverside,065,2383286,292575,286868,13917,300785,4407
2021-04-28,Sacramento,067,1510023,103413,102613,1680,104293,1591
2021-04-28,San Benito,069,59416,6020,6021,113,6134,63
2021-04-28,San Bernardino,071,2135413,291812,290548,8917,299465,4582
2021-04-28,San Diego,073,3302833,277532,275821,14495,290316,3698
2021-04-28,San Francisco,075,870044,36257,36382,1271,37653,534
2021-04-28,San Joaquin,077,732212,71942,71171,3463,74634,1301
2021-04-28,San Luis Obispo,079,281455,21173,20851,718,21569,255
2021-04-28,San Mateo,081,765935,41904,41498,457,41955,358
2021-04-28,Santa Barbara,083,443738,34114,34003,1190,35193,448
2021-04-28,Santa Clara,085,1922200,117533,117997,736,118733,1969
2021-04-28,Santa Cruz,087,273765,16105,15943,811,16754,205
2021-04-28,Shasta,089,179085,11849,11815,1459,13274,192
2021-04-28,Sierra,091,2930,56,51,12,63,0
2021-04-28,Siskiyou,093,43540,1747,1603,305,1908,11
2021-04-28,Solano,095,438530,32133,31982,496,32478,248
2021-04-28,Sonoma,097,501317,29644,29773,314,30087,318
2021-04-28,Stanislaus,099,539301,55165,54745,5821,60566,774
2021-04-28,Sutter,101,95872,9368,9343,82,9425,110
2021-04-28,Tehama,103,63373,4963,4930,557,5487,53
2021-04-28,Trinity,105,12862,482,326,86,412,3
2021-04-28,Tulare,107,460477,49792,48754,8866,57620,832
2021-04-28,Tuolumne,109,53932,3965,4029,38,4067,58
2021-04-28,Ventura,111,848112,80806,80172,2958,83130,1000
2021-04-28,Yolo,113,214977,13767,13721,285,14006,205
2021-04-28,Yuba,115,75493,5890,5857,121,5978,44
2021-04-27,Alameda,001,1643700,86644,86301,1908,88209,1260
2021-04-27,Alpine,003,1148,87,88,0,88,0
2021-04-27,Amador,005,37829,3649,3645,33,3678,46
2021-04-27,Butte,007,227075,12143,11738,1756,13494,196
2021-04-27,Calaveras,009,45235,2090,2076,13,2089,50
2021-04-27,Colusa,011,21464,1925,1926,292,2218,14
2021-04-27,Contra Costa,013,1133247,68144,67470,1219,68689,791
2021-04-27,Del Norte,015,27424,1308,1266,11,1277,6
2021-04-27,El Dorado,017,186661,9964,9866,696,10562,106
2021-04-27,Fresno,019,978130,101647,101138,8567,109705,1663
2021-04-27,Glenn,021,27897,2387,2368,542,2910,17
2021-04-27,Humboldt,023,135768,3824,3780,31,3811,35
2021-04-27,Imperial,025,180216,28267,28149,2798,30947,720
2021-04-27,Inyo,027,18085,1398,1396,10,1406,36
2021-04-27,Kern,029,883053,96499,95466,10640,106106,1295
2021-04-27,Kings,031,150075,23004,22759,1069,23828,244
2021-04-27,Lake,033,64148,3453,3431,9,3440,43
2021-04-27,Lassen,035,31185,5174,5137,105,5242,1
2021-04-27,Los Angeles,037,10098052,1198963,1191504,41322,1232826,23825
2021-04-27,Madera,039,155013,16479,16365,920,17285,235
2021-04-27,Marin,041,260295,13930,13855,241,14096,227
2021-04-27,Mariposa,043,17540,417,413,11,424,5
2021-04-27,Mendocino,045,87422,3831,3765,76,3841,46
2021-04-27,Merced,047,269075,30641,30620,981,31601,443
2021-04-27,Modoc,049,8938,368,360,122,482,3
2021-04-27,Mono,051,14174,1245,1257,17,1274,3
2021-04-27,Monterey,053,433212,42954,42752,1857,44609,379
2021-04-27,Napa,055,140530,9776,9774,34,9808,81
2021-04-27,Nevada,057,99092,4655,4557,187,4744,70
2021-04-27,Orange,059,3164182,254051,252667,11177,263844,4925
2021-04-27,Placer,061,380077,22645,22050,1419,23469,285
2021-04-27,Plumas,063,18699,688,675,10,685,4
2021-04-27,Riverside,065,2383286,292499,286820,13913,300733,4405
2021-04-27,Sacramento,067,1510023,103284,102595,1670,104265,1589
2021-04-27,San Benito,069,59416,6015,6016,113,6129,63
2021-04-27,San Bernardino,071,2135413,291744,290461,8912,299373,4575
2021-04-27,San Diego,073,3302833,277375,275685,14475,290160,3692
2021-04-27,San Francisco,075,870044,36229,36358,1270,37628,533
2021-04-27,San Joaquin,077,732212,71889,71104,3457,74561,1301
2021-04-27,San Luis Obispo,079,281455,21166,20841,718,21559,255
2021-04-27,San Mateo,081,765935,41869,41474,456,41930,358
2021-04-27,Santa Barbara,083,443738,34091,33973,1189,35162,448
2021-04-27,Santa Clara,085,1922200,117483,117945,735,118680,1969
2021-04-27,Santa Cruz,087,273765,16098,15905,810,16715,205
2021-04-27,Shasta,089,179085,11821,11802,1452,13254,192
2021-04-27,Sierra,091,2930,56,51,12,63,0
2021-04-27,Siskiyou,093,43540,1732,1597,304,1901,11
2021-04-27,Solano,095,438530,32085,31964,495,32459,248
2021-04-27,Sonoma,097,501317,29626,29761,313,30074,318
2021-04-27,Stanislaus,099,539301,55095,54695,5813,60508,752
2021-04-27,Sutter,101,95872,9363,9342,82,9424,110
2021-04-27,Tehama,103,63373,4960,4922,553,5475,53
2021-04-27,Trinity,105,12862,482,326,86,412,3
2021-04-27,Tulare,107,460477,49776,48744,8857,57601,832
2021-04-27,Tuolumne,109,53932,3962,4028,38,4066,58
2021-04-27,Ventura,111,848112,80777,80152,2956,83108,1000
2021-04-27,Yolo,113,214977,13754,13697,283,13980,205
2021-04-27,Yuba,115,75493,5890,5853,121,5974,44
2021-04-26,Alameda,001,1643700,86551,86230,1905,88135,1256
2021-04-26,Alpine,003,1148,87,88,0,88,0
2021-04-26,Amador,005,37829,3648,3645,33,3678,46
2021-04-26,Butte,007,227075,12119,11720,1752,13472,196
2021-04-26,Calaveras,009,45235,2085,2074,13,2087,50
2021-04-26,Colusa,011,21464,1925,1925,291,2216,14
2021-04-26,Contra Costa,013,1133247,68076,67392,1215,68607,789
2021-04-26,Del Norte,015,27424,1299,1263,11,1274,6
2021-04-26,El Dorado,017,186661,9943,9849,695,10544,106
2021-04-26,Fresno,019,978130,101592,101099,8553,109652,1662
2021-04-26,Glenn,021,27897,2385,2367,542,2909,17
2021-04-26,Humboldt,023,135768,3814,3764,30,3794,35
2021-04-26,Imperial,025,180216,28254,28148,2793,30941,720
2021-04-26,Inyo,027,18085,1397,1396,10,1406,36
2021-04-26,Kern,029,883053,96472,95429,10634,106063,1295
2021-04-26,Kings,031,150075,23001,22756,1066,23822,244
2021-04-26,Lake,033,64148,3448,3428,9,3437,43
2021-04-26,Lassen,035,31185,5174,5138,105,5243,1
2021-04-26,Los Angeles,037,10098052,1198636,1191253,41303,1232556,23802
2021-04-26,Madera,039,155013,16467,16353,919,17272,231
2021-04-26,Marin,041,260295,13915,13849,241,14090,227
2021-04-26,Mariposa,043,17540,416,410,11,421,5
2021-04-26,Mendocino,045,87422,3829,3757,75,3832,46
2021-04-26,Merced,047,269075,30624,30611,978,31589,443
2021-04-26,Modoc,049,8938,368,360,122,482,3
2021-04-26,Mono,051,14174,1245,1258,17,1275,3
2021-04-26,Monterey,053,433212,42938,42740,1856,44596,379
2021-04-26,Napa,055,140530,9764,9769,34,9803,79
2021-04-26,Nevada,057,99092,4634,4548,187,4735,70
2021-04-26,Orange,059,3164182,253967,252592,11166,263758,4919
2021-04-26,Placer,061,380077,22616,22032,1414,23446,285
2021-04-26,Plumas,063,18699,688,670,10,680,4
2021-04-26,Riverside,065,2383286,292437,286724,13905,300629,4401
2021-04-26,Sacramento,067,1510023,103112,102459,1657,104116,1587
2021-04-26,San Benito,069,59416,6013,6013,113,6126,63
2021-04-26,San Bernardino,071,2135413,291693,290394,8911,299305,4572
2021-04-26,San Diego,073,3302833,277201,275541,14447,289988,3692
2021-04-26,San Francisco,075,870044,36201,36330,1269,37599,532
2021-04-26,San Joaquin,077,732212,71823,71050,3449,74499,1301
2021-04-26,San Luis Obispo,079,281455,21158,20830,717,21547,255
2021-04-26,San Mateo,081,765935,41839,41457,456,41913,357
2021-04-26,Santa Barbara,083,443738,34060,33948,1189,35137,448
2021-04-26,Santa Clara,085,1922200,117383,117874,732,118606,1968
2021-04-26,Santa Cruz,087,273765,16089,15877,810,16687,205
2021-04-26,Shasta,089,179085,11804,11787,1446,13233,192
2021-04-26,Sierra,091,2930,55,51,12,63,0
2021-04-26,Siskiyou,093,43540,1722,1592,301,1893,11
2021-04-26,Solano,095,438530,32040,31913,493,32406,247
2021-04-26,Sonoma,097,501317,29603,29755,311,30066,318
2021-04-26,Stanislaus,099,539301,55005,54638,5807,60445,744
2021-04-26,Sutter,101,95872,9358,9328,82,9410,110
2021-04-26,Tehama,103,63373,4955,4920,550,5470,53
2021-04-26,Trinity,105,12862,482,326,86,412,3
2021-04-26,Tulare,107,460477,49756,48735,8848,57583,831
2021-04-26,Tuolumne,109,53932,3961,4024,38,4062,58
2021-04-26,Ventura,111,848112,80752,80137,2953,83090,999
2021-04-26,Yolo,113,214977,13734,13684,280,13964,205
2021-04-26,Yuba,115,75493,5888,5851,121,5972,44
2021-04-25,Alameda,001,1643700,86447,86162,1898,88060,1256
2021-04-25,Alpine,003,1148,87,87,0,87,0
2021-04-25,Amador,005,37829,3647,3643,33,3676,46
2021-04-25,Butte,007,227075,12090,11709,1745,13454,196
2021-04-25,Calaveras,009,45235,2079,2072,12,2084,50
2021-04-25,Colusa,011,21464,1924,1924,291,2215,14
2021-04-25,Contra Costa,013,1133247,67983,67316,1214,68530,789
2021-04-25,Del Norte,015,27424,1293,1259,11,1270,6
2021-04-25,El Dorado,017,186661,9927,9837,693,10530,106
2021-04-25,Fresno,019,978130,101533,101061,8541,109602,1662
2021-04-25,Glenn,021,27897,2385,2366,542,2908,17
2021-04-25,Humboldt,023,135768,3801,3751,30,3781,35
2021-04-25,Imperial,025,180216,28228,28136,2790,30926,720
2021-04-25,Inyo,027,18085,1397,1396,10,1406,36
2021-04-25,Kern,029,883053,96406,95398,10621,106019,1295
2021-04-25,Kings,031,150075,22987,22755,1064,23819,244
2021-04-25,Lake,033,64148,3446,3427,9,3436,43
2021-04-25,Lassen,035,31185,5172,5138,105,5243,1
2021-04-25,Los Angeles,037,10098052,1198302,1190970,41283,1232253,23799
2021-04-25,Madera,039,155013,16455,16346,919,17265,231
2021-04-25,Marin,041,260295,13906,13852,241,14093,227
2021-04-25,Mariposa,043,17540,416,410,11,421,5
2021-04-25,Mendocino,045,87422,3822,3757,75,3832,46
2021-04-25,Merced,047,269075,30589,30586,978,31564,443
2021-04-25,Modoc,049,8938,368,360,122,482,3
2021-04-25,Mono,051,14174,1245,1257,17,1274,3
2021-04-25,Monterey,053,433212,42925,42737,1854,44591,379
2021-04-25,Napa,055,140530,9759,9762,34,9796,79
2021-04-25,Nevada,057,99092,4622,4536,187,4723,70
2021-04-25,Orange,059,3164182,253891,252531,11159,263690,4919
2021-04-25,Placer,061,380077,22569,22011,1406,23417,285
2021-04-25,Plumas,063,18699,687,670,10,680,4
2021-04-25,Riverside,065,2383286,292343,286651,13899,300550,4401
2021-04-25,Sacramento,067,1510023,102944,102319,1647,103966,1587
2021-04-25,San Benito,069,59416,6011,6014,112,6126,63
2021-04-25,San Bernardino,071,2135413,291618,290357,8903,299260,4571
2021-04-25,San Diego,073,3302833,276988,275412,14414,289826,3692
2021-04-25,San Francisco,075,870044,36170,36310,1269,37579,532
2021-04-25,San Joaquin,077,732212,71728,70987,3439,74426,1301
2021-04-25,San Luis Obispo,079,281455,21139,20820,715,21535,255
2021-04-25,San Mateo,081,765935,41804,41465,455,41920,356
2021-04-25,Santa Barbara,083,443738,34034,33931,1189,35120,448
2021-04-25,Santa Clara,085,1922200,117304,117778,730,118508,1968
2021-04-25,Santa Cruz,087,273765,16083,15868,808,16676,205
2021-04-25,Shasta,089,179085,11781,11784,1441,13225,192
2021-04-25,Sierra,091,2930,55,51,12,63,0
2021-04-25,Siskiyou,093,43540,1711,1580,299,1879,11
2021-04-25,Solano,095,438530,31993,31864,485,32349,247
2021-04-25,Sonoma,097,501317,29585,29756,311,30067,318
2021-04-25,Stanislaus,099,539301,54909,54543,5799,60342,744
2021-04-25,Sutter,101,95872,9352,9326,82,9408,110
2021-04-25,Tehama,103,63373,4951,4916,548,5464,53
2021-04-25,Trinity,105,12862,482,326,86,412,3
2021-04-25,Tulare,107,460477,49740,48728,8834,57562,831
2021-04-25,Tuolumne,109,53932,3959,4022,38,4060,58
2021-04-25,Ventura,111,848112,80728,80110,2953,83063,999
2021-04-25,Yolo,113,214977,13711,13667,278,13945,205
2021-04-25,Yuba,115,75493,5885,5849,120,5969,44
2021-04-24,Alameda,001,1643700,86393,86016,1896,87912,1257
2021-04-24,Alpine,003,1148,87,86,0,86,0
2021-04-24,Amador,005,37829,3646,3640,33,3673,46
2021-04-24,Butte,007,227075,12074,11678,1743,13421,196
2021-04-24,Calaveras,009,45235,2075,2067,12,2079,50
2021-04-24,Colusa,011,21464,1923,1921,291,2212,14
2021-04-24,Contra Costa,013,1133247,67913,67222,1212,68434,789
2021-04-24,Del Norte,015,27424,1288,1255,11,1266,6
2021-04-24,El Dorado,017,186661,9916,9814,692,10506,106
2021-04-24,Fresno,019,978130,101502,100991,8535,109526,1662
2021-04-24,Glenn,021,27897,2385,2363,542,2905,17
2021-04-24,Humboldt,023,135768,3787,3722,30,3752,35
2021-04-24,Imperial,025,180216,28221,28124,2789,30913,720
2021-04-24,Inyo,027,18085,1396,1396,10,1406,36
2021-04-24,Kern,029,883053,96387,95365,10611,105976,1295
2021-04-24,Kings,031,150075,22984,22749,1064,23813,244
2021-04-24,Lake,033,64148,3445,3426,9,3435,43
2021-04-24,Lassen,035,31185,5171,5137,105,5242,1
2021-04-24,Los Angeles,037,10098052,1198075,1190603,41267,1231870,23802
2021-04-24,Madera,039,155013,16452,16338,919,17257,231
2021-04-24,Marin,041,260295,13898,13847,241,14088,227
2021-04-24,Mariposa,043,17540,416,409,11,420,5
2021-04-24,Mendocino,045,87422,3820,3754,73,3827,46
2021-04-24,Merced,047,269075,30569,30559,978,31537,443
2021-04-24,Modoc,049,8938,368,360,122,482,3
2021-04-24,Mono,051,14174,1245,1256,17,1273,3
2021-04-24,Monterey,053,433212,42913,42727,1853,44580,379
2021-04-24,Napa,055,140530,9753,9756,34,9790,79
2021-04-24,Nevada,057,99092,4615,4522,187,4709,70
2021-04-24,Orange,059,3164182,253847,252441,11153,263594,4910
2021-04-24,Placer,061,380077,22557,21983,1405,23388,285
2021-04-24,Plumas,063,18699,686,670,10,680,4
2021-04-24,Riverside,065,2383286,292275,286552,13895,300447,4400
2021-04-24,Sacramento,067,1510023,102861,102179,1640,103819,1587
2021-04-24,San Benito,069,59416,6009,6007,112,6119,63
2021-04-24,San Bernardino,071,2135413,291569,290264,8902,299166,4568
2021-04-24,San Diego,073,3302833,276884,275252,14394,289646,3688
2021-04-24,San Francisco,075,870044,36141,36285,1265,37550,532
2021-04-24,San Joaquin,077,732212,71684,70911,3436,74347,1301
2021-04-24,San Luis Obispo,079,281455,21129,20797,714,21511,255
2021-04-24,San Mateo,081,765935,41791,41424,453,41877,355
2021-04-24,Santa Barbara,083,443738,34019,33911,1188,35099,448
2021-04-24,Santa Clara,085,1922200,117249,117674,728,118402,1968
2021-04-24,Santa Cruz,087,273765,16075,15840,808,16648,205
2021-04-24,Shasta,089,179085,11763,11770,1438,13208,192
2021-04-24,Sierra,091,2930,55,51,12,63,0
2021-04-24,Siskiyou,093,43540,1701,1574,298,1872,11
2021-04-24,Solano,095,438530,31970,31821,482,32303,247
2021-04-24,Sonoma,097,501317,29583,29739,311,30050,318
2021-04-24,Stanislaus,099,539301,54860,54455,5796,60251,744
2021-04-24,Sutter,101,95872,9349,9316,82,9398,110
2021-04-24,Tehama,103,63373,4946,4907,548,5455,53
2021-04-24,Trinity,105,12862,482,326,86,412,3
2021-04-24,Tulare,107,460477,49729,48705,8824,57529,830
2021-04-24,Tuolumne,109,53932,3955,4020,38,4058,58
2021-04-24,Ventura,111,848112,80715,80097,2951,83048,999
2021-04-24,Yolo,113,214977,13700,13653,278,13931,205
2021-04-24,Yuba,115,75493,5883,5837,120,5957,44
2021-04-23,Alameda,001,1643700,86319,85935,1893,87828,1256
2021-04-23,Alpine,003,1148,86,86,0,86,0
2021-04-23,Amador,005,37829,3645,3637,33,3670,46
2021-04-23,Butte,007,227075,12053,11672,1738,13410,196
2021-04-23,Calaveras,009,45235,2073,2064,12,2076,50
2021-04-23,Colusa,011,21464,1922,1921,291,2212,14
2021-04-23,Contra Costa,013,1133247,67858,67164,1210,68374,785
2021-04-23,Del Norte,015,27424,1287,1254,11,1265,6
2021-04-23,El Dorado,017,186661,9899,9788,689,10477,106
2021-04-23,Fresno,019,978130,101461,100928,8529,109457,1662
2021-04-23,Glenn,021,27897,2385,2361,541,2902,17
2021-04-23,Humboldt,023,135768,3777,3698,30,3728,35
2021-04-23,Imperial,025,180216,28206,28108,2787,30895,720
2021-04-23,Inyo,027,18085,1396,1395,10,1405,36
2021-04-23,Kern,029,883053,96362,95330,10605,105935,1295
2021-04-23,Kings,031,150075,22981,22735,1064,23799,244
2021-04-23,Lake,033,64148,3443,3425,9,3434,43
2021-04-23,Lassen,035,31185,5171,5141,105,5246,1
2021-04-23,Los Angeles,037,10098052,1197812,1190264,41241,1231505,23785
2021-04-23,Madera,039,155013,16443,16328,919,17247,231
2021-04-23,Marin,041,260295,13893,13838,241,14079,227
2021-04-23,Mariposa,043,17540,415,405,11,416,5
2021-04-23,Mendocino,045,87422,3818,3745,72,3817,46
2021-04-23,Merced,047,269075,30551,30530,978,31508,443
2021-04-23,Modoc,049,8938,368,360,122,482,3
2021-04-23,Mono,051,14174,1243,1256,17,1273,3
2021-04-23,Monterey,053,433212,42907,42722,1853,44575,377
2021-04-23,Napa,055,140530,9748,9752,34,9786,79
2021-04-23,Nevada,057,99092,4606,4510,187,4697,70
2021-04-23,Orange,059,3164182,253803,252399,11146,263545,4904
2021-04-23,Placer,061,380077,22534,21959,1404,23363,282
2021-04-23,Plumas,063,18699,685,670,10,680,4
2021-04-23,Riverside,065,2383286,292216,286456,13890,300346,4399
2021-04-23,Sacramento,067,1510023,102774,102041,1637,103678,1586
2021-04-23,San Benito,069,59416,6007,6005,112,6117,63
2021-04-23,San Bernardino,071,2135413,291518,290189,8901,299090,4568
2021-04-23,San Diego,073,3302833,276746,275097,14371,289468,3684
2021-04-23,San Francisco,075,870044,36124,36252,1264,37516,532
2021-04-23,San Joaquin,077,732212,71628,70840,3433,74273,1295
2021-04-23,San Luis Obispo,079,281455,21120,20781,713,21494,255
2021-04-23,San Mateo,081,765935,41764,41386,453,41839,355
2021-04-23,Santa Barbara,083,443738,34009,33895,1186,35081,447
2021-04-23,Santa Clara,085,1922200,117187,117593,727,118320,1965
2021-04-23,Santa Cruz,087,273765,16068,15802,808,16610,205
2021-04-23,Shasta,089,179085,11756,11759,1437,13196,192
2021-04-23,Sierra,091,2930,55,51,12,63,0
2021-04-23,Siskiyou,093,43540,1689,1567,297,1864,11
2021-04-23,Solano,095,438530,31938,31784,478,32262,247
2021-04-23,Sonoma,097,501317,29569,29727,311,30038,318
2021-04-23,Stanislaus,099,539301,54797,54391,5788,60179,744
2021-04-23,Sutter,101,95872,9347,9312,82,9394,110
2021-04-23,Tehama,103,63373,4943,4906,548,5454,53
2021-04-23,Trinity,105,12862,482,326,86,412,3
2021-04-23,Tulare,107,460477,49712,48694,8816,57510,829
2021-04-23,Tuolumne,109,53932,3954,4020,38,4058,58
2021-04-23,Ventura,111,848112,80696,80095,2951,83046,996
2021-04-23,Yolo,113,214977,13689,13647,277,13924,205
2021-04-23,Yuba,115,75493,5880,5828,120,5948,44
2021-04-22,Alameda,001,1643700,86229,85829,1892,87721,1253
2021-04-22,Alpine,003,1148,86,86,0,86,0
2021-04-22,Amador,005,37829,3644,3633,33,3666,46
2021-04-22,Butte,007,227075,12039,11656,1735,13391,196
2021-04-22,Calaveras,009,45235,2072,2059,12,2071,50
2021-04-22,Colusa,011,21464,1920,1920,289,2209,14
2021-04-22,Contra Costa,013,1133247,67786,67029,1205,68234,782
2021-04-22,Del Norte,015,27424,1282,1252,11,1263,6
2021-04-22,El Dorado,017,186661,9888,9773,686,10459,106
2021-04-22,Fresno,019,978130,101416,100864,8518,109382,1657
2021-04-22,Glenn,021,27897,2384,2361,541,2902,17
2021-04-22,Humboldt,023,135768,3768,3680,30,3710,35
2021-04-22,Imperial,025,180216,28185,28096,2784,30880,720
2021-04-22,Inyo,027,18085,1395,1394,10,1404,36
2021-04-22,Kern,029,883053,96319,95292,10589,105881,1299
2021-04-22,Kings,031,150075,22971,22725,1064,23789,243
2021-04-22,Lake,033,64148,3441,3423,9,3432,43
2021-04-22,Lassen,035,31185,5171,5155,105,5260,1
2021-04-22,Los Angeles,037,10098052,1197492,1189878,41219,1231097,23762
2021-04-22,Madera,039,155013,16424,16316,919,17235,231
2021-04-22,Marin,041,260295,13885,13832,241,14073,227
2021-04-22,Mariposa,043,17540,414,403,11,414,5
2021-04-22,Mendocino,045,87422,3812,3729,72,3801,46
2021-04-22,Merced,047,269075,30516,30490,977,31467,443
2021-04-22,Modoc,049,8938,368,360,122,482,3
2021-04-22,Mono,051,14174,1243,1254,17,1271,3
2021-04-22,Monterey,053,433212,42900,42708,1851,44559,377
2021-04-22,Napa,055,140530,9738,9734,34,9768,79
2021-04-22,Nevada,057,99092,4597,4504,185,4689,70
2021-04-22,Orange,059,3164182,253730,252307,11134,263441,4898
2021-04-22,Placer,061,380077,22504,21916,1400,23316,282
2021-04-22,Plumas,063,18699,684,670,10,680,4
2021-04-22,Riverside,065,2383286,292117,286362,13881,300243,4398
2021-04-22,Sacramento,067,1510023,102625,101870,1628,103498,1585
2021-04-22,San Benito,069,59416,6003,5998,112,6110,63
2021-04-22,San Bernardino,071,2135413,291447,290125,8892,299017,4571
2021-04-22,San Diego,073,3302833,276580,275913,14349,290262,3684
2021-04-22,San Francisco,075,870044,36102,36218,1261,37479,532
2021-04-22,San Joaquin,077,732212,71569,70751,3426,74177,1295
2021-04-22,San Luis Obispo,079,281455,21106,20761,713,21474,255
2021-04-22,San Mateo,081,765935,41737,41345,451,41796,355
2021-04-22,Santa Barbara,083,443738,33986,33870,1185,35055,446
2021-04-22,Santa Clara,085,1922200,117099,117457,723,118180,1954
2021-04-22,Santa Cruz,087,273765,16065,15737,807,16544,205
2021-04-22,Shasta,089,179085,11741,11738,1434,13172,192
2021-04-22,Sierra,091,2930,55,51,12,63,0
2021-04-22,Siskiyou,093,43540,1685,1564,296,1860,11
2021-04-22,Solano,095,438530,31892,31731,475,32206,247
2021-04-22,Sonoma,097,501317,29554,29705,307,30012,318
2021-04-22,Stanislaus,099,539301,54724,54313,5782,60095,744
2021-04-22,Sutter,101,95872,9343,9302,82,9384,110
2021-04-22,Tehama,103,63373,4937,4896,544,5440,53
2021-04-22,Trinity,105,12862,482,326,86,412,3
2021-04-22,Tulare,107,460477,49692,48669,8807,57476,828
2021-04-22,Tuolumne,109,53932,3950,4020,38,4058,58
2021-04-22,Ventura,111,848112,80670,80073,2949,83022,996
2021-04-22,Yolo,113,214977,13668,13616,277,13893,205
2021-04-22,Yuba,115,75493,5870,5825,120,5945,44
2021-04-21,Alameda,001,1643700,86150,85762,1890,87652,1249
2021-04-21,Alpine,003,1148,86,86,0,86,0
2021-04-21,Amador,005,37829,3641,3632,33,3665,46
2021-04-21,Butte,007,227075,12019,11643,1733,13376,196
2021-04-21,Calaveras,009,45235,2065,2057,12,2069,50
2021-04-21,Colusa,011,21464,1918,1920,288,2208,14
2021-04-21,Contra Costa,013,1133247,67720,66981,1204,68185,782
2021-04-21,Del Norte,015,27424,1278,1252,11,1263,6
2021-04-21,El Dorado,017,186661,9871,9760,684,10444,106
2021-04-21,Fresno,019,978130,101360,100838,8512,109350,1654
2021-04-21,Glenn,021,27897,2383,2361,541,2902,17
2021-04-21,Humboldt,023,135768,3748,3642,30,3672,35
2021-04-21,Imperial,025,180216,28173,28052,2782,30834,719
2021-04-21,Inyo,027,18085,1395,1392,10,1402,36
2021-04-21,Kern,029,883053,96273,95257,10579,105836,1297
2021-04-21,Kings,031,150075,22964,22713,1063,23776,243
2021-04-21,Lake,033,64148,3438,3421,9,3430,43
2021-04-21,Lassen,035,31185,5170,5156,105,5261,1
2021-04-21,Los Angeles,037,10098052,1197153,1189530,41198,1230728,23729
2021-04-21,Madera,039,155013,16419,16309,919,17228,231
2021-04-21,Marin,041,260295,13870,13822,241,14063,227
2021-04-21,Mariposa,043,17540,413,402,11,413,5
2021-04-21,Mendocino,045,87422,3810,3729,72,3801,46
2021-04-21,Merced,047,269075,30495,30471,976,31447,442
2021-04-21,Modoc,049,8938,368,360,122,482,3
2021-04-21,Mono,051,14174,1243,1254,17,1271,3
2021-04-21,Monterey,053,433212,42885,42699,1849,44548,377
2021-04-21,Napa,055,140530,9732,9727,34,9761,79
2021-04-21,Nevada,057,99092,4583,4499,185,4684,70
2021-04-21,Orange,059,3164182,253654,252243,11121,263364,4889
2021-04-21,Placer,061,380077,22473,21896,1395,23291,282
2021-04-21,Plumas,063,18699,684,670,10,680,4
2021-04-21,Riverside,065,2383286,292023,286299,13874,300173,4388
2021-04-21,Sacramento,067,1510023,102496,101803,1622,103425,1579
2021-04-21,San Benito,069,59416,6000,5998,112,6110,63
2021-04-21,San Bernardino,071,2135413,291372,290049,8890,298939,4572
2021-04-21,San Diego,073,3302833,276371,275632,14311,289943,3681
2021-04-21,San Francisco,075,870044,36082,36194,1260,37454,529
2021-04-21,San Joaquin,077,732212,71514,70687,3416,74103,1295
2021-04-21,San Luis Obispo,079,281455,21091,20724,712,21436,255
2021-04-21,San Mateo,081,765935,41705,41318,450,41768,355
2021-04-21,Santa Barbara,083,443738,33967,33830,1184,35014,445
2021-04-21,Santa Clara,085,1922200,117021,117318,717,118035,1946
2021-04-21,Santa Cruz,087,273765,16056,15698,807,16505,204
2021-04-21,Shasta,089,179085,11722,11722,1432,13154,192
2021-04-21,Sierra,091,2930,55,51,12,63,0
2021-04-21,Siskiyou,093,43540,1678,1557,296,1853,11
2021-04-21,Solano,095,438530,31853,31712,474,32186,244
2021-04-21,Sonoma,097,501317,29542,29697,305,30002,318
2021-04-21,Stanislaus,099,539301,54663,54290,5776,60066,742
2021-04-21,Sutter,101,95872,9335,9297,82,9379,110
2021-04-21,Tehama,103,63373,4930,4893,543,5436,53
2021-04-21,Trinity,105,12862,482,326,86,412,3
2021-04-21,Tulare,107,460477,49677,48653,8794,57447,828
2021-04-21,Tuolumne,109,53932,3947,4019,38,4057,58
2021-04-21,Ventura,111,848112,80638,80039,2946,82985,996
2021-04-21,Yolo,113,214977,13648,13606,276,13882,200
2021-04-21,Yuba,115,75493,5863,5822,119,5941,44
2021-04-20,Alameda,001,1643700,86055,85652,1888,87540,1248
2021-04-20,Alpine,003,1148,85,85,0,85,0
2021-04-20,Amador,005,37829,3640,3631,33,3664,46
2021-04-20,Butte,007,227075,12000,11619,1731,13350,196
2021-04-20,Calaveras,009,45235,2064,2053,12,2065,50
2021-04-20,Colusa,011,21464,1918,1915,287,2202,14
2021-04-20,Contra Costa,013,1133247,67636,66889,1201,68090,782
2021-04-20,Del Norte,015,27424,1277,1250,11,1261,6
2021-04-20,El Dorado,017,186661,9843,9743,682,10425,106
2021-04-20,Fresno,019,978130,101302,100768,8502,109270,1650
2021-04-20,Glenn,021,27897,2381,2359,540,2899,17
2021-04-20,Humboldt,023,135768,3730,3612,30,3642,35
2021-04-20,Imperial,025,180216,28154,28024,2777,30801,719
2021-04-20,Inyo,027,18085,1395,1393,10,1403,36
2021-04-20,Kern,029,883053,96237,95223,10562,105785,1295
2021-04-20,Kings,031,150075,22958,22693,1060,23753,243
2021-04-20,Lake,033,64148,3436,3418,9,3427,43
2021-04-20,Lassen,035,31185,5170,5155,105,5260,1
2021-04-20,Los Angeles,037,10098052,1196806,1189256,41169,1230425,23694
2021-04-20,Madera,039,155013,16413,16301,919,17220,231
2021-04-20,Marin,041,260295,13856,13807,241,14048,227
2021-04-20,Mariposa,043,17540,412,402,11,413,5
2021-04-20,Mendocino,045,87422,3809,3726,72,3798,46
2021-04-20,Merced,047,269075,30467,30439,976,31415,441
2021-04-20,Modoc,049,8938,368,359,122,481,3
2021-04-20,Mono,051,14174,1242,1254,17,1271,3
2021-04-20,Monterey,053,433212,42874,42663,1846,44509,363
2021-04-20,Napa,055,140530,9728,9711,34,9745,79
2021-04-20,Nevada,057,99092,4565,4485,185,4670,70
2021-04-20,Orange,059,3164182,253564,252134,11109,263243,4887
2021-04-20,Placer,061,380077,22439,21846,1391,23237,282
2021-04-20,Plumas,063,18699,683,670,10,680,4
2021-04-20,Riverside,065,2383286,291926,286194,13869,300063,4388
2021-04-20,Sacramento,067,1510023,102358,101629,1614,103243,1574
2021-04-20,San Benito,069,59416,5997,5988,112,6100,63
2021-04-20,San Bernardino,071,2135413,291292,289905,8888,298793,4569
2021-04-20,San Diego,073,3302833,276140,275369,14278,289647,3674
2021-04-20,San Francisco,075,870044,36063,36117,1259,37376,529
2021-04-20,San Joaquin,077,732212,71441,70590,3407,73997,1289
2021-04-20,San Luis Obispo,079,281455,21068,20691,704,21395,254
2021-04-20,San Mateo,081,765935,41674,41251,450,41701,355
2021-04-20,Santa Barbara,083,443738,33948,33803,1184,34987,445
2021-04-20,Santa Clara,085,1922200,116923,117228,713,117941,1944
2021-04-20,Santa Cruz,087,273765,16044,15647,807,16454,204
2021-04-20,Shasta,089,179085,11706,11677,1429,13106,189
2021-04-20,Sierra,091,2930,55,51,12,63,0
2021-04-20,Siskiyou,093,43540,1670,1551,295,1846,10
2021-04-20,Solano,095,438530,31798,31673,470,32143,243
2021-04-20,Sonoma,097,501317,29533,29676,303,29979,311
2021-04-20,Stanislaus,099,539301,54598,54236,5763,59999,735
2021-04-20,Sutter,101,95872,9331,9279,82,9361,109
2021-04-20,Tehama,103,63373,4925,4887,542,5429,52
2021-04-20,Trinity,105,12862,482,326,86,412,3
2021-04-20,Tulare,107,460477,49654,48650,8786,57436,831
2021-04-20,Tuolumne,109,53932,3947,4014,38,4052,58
2021-04-20,Ventura,111,848112,80610,80018,2944,82962,995
2021-04-20,Yolo,113,214977,13628,13581,275,13856,200
2021-04-20,Yuba,115,75493,5853,5814,119,5933,44
2021-04-19,Alameda,001,1643700,85935,85583,1885,87468,1247
2021-04-19,Alpine,003,1148,85,85,0,85,0
2021-04-19,Amador,005,37829,3639,3629,33,3662,46
2021-04-19,Butte,007,227075,11981,11601,1726,13327,196
2021-04-19,Calaveras,009,45235,2062,2050,12,2062,50
2021-04-19,Colusa,011,21464,1918,1913,286,2199,14
2021-04-19,Contra Costa,013,1133247,67558,66833,1199,68032,782
2021-04-19,Del Norte,015,27424,1275,1247,11,1258,6
2021-04-19,El Dorado,017,186661,9827,9726,677,10403,106
2021-04-19,Fresno,019,978130,101234,100702,8490,109192,1646
2021-04-19,Glenn,021,27897,2381,2358,539,2897,17
2021-04-19,Humboldt,023,135768,3710,3602,28,3630,35
2021-04-19,Imperial,025,180216,28133,27995,2777,30772,719
2021-04-19,Inyo,027,18085,1395,1392,10,1402,36
2021-04-19,Kern,029,883053,96207,95162,10547,105709,1290
2021-04-19,Kings,031,150075,22942,22688,1060,23748,243
2021-04-19,Lake,033,64148,3435,3416,9,3425,43
2021-04-19,Lassen,035,31185,5169,5156,105,5261,1
2021-04-19,Los Angeles,037,10098052,1196429,1188945,41144,1230089,23666
2021-04-19,Madera,039,155013,16402,16289,918,17207,231
2021-04-19,Marin,041,260295,13845,13804,240,14044,226
2021-04-19,Mariposa,043,17540,411,401,11,412,5
2021-04-19,Mendocino,045,87422,3807,3722,72,3794,46
2021-04-19,Merced,047,269075,30438,30422,975,31397,441
2021-04-19,Modoc,049,8938,368,359,122,481,3
2021-04-19,Mono,051,14174,1241,1254,17,1271,3
2021-04-19,Monterey,053,433212,42861,42642,1841,44483,356
2021-04-19,Napa,055,140530,9720,9680,34,9714,79
2021-04-19,Nevada,057,99092,4549,4477,185,4662,70
2021-04-19,Orange,059,3164182,253446,252013,11095,263108,4883
2021-04-19,Placer,061,380077,22416,21814,1387,23201,282
2021-04-19,Plumas,063,18699,683,665,10,675,4
2021-04-19,Riverside,065,2383286,291830,286087,13859,299946,4371
2021-04-19,Sacramento,067,1510023,102223,101482,1604,103086,1572
2021-04-19,San Benito,069,59416,5989,5989,112,6101,63
2021-04-19,San Bernardino,071,2135413,291206,289738,8882,298620,4561
2021-04-19,San Diego,073,3302833,275892,275113,14245,289358,3674
2021-04-19,San Francisco,075,870044,36028,36094,1256,37350,529
2021-04-19,San Joaquin,077,732212,71362,70514,3400,73914,1289
2021-04-19,San Luis Obispo,079,281455,21042,20669,698,21367,254
2021-04-19,San Mateo,081,765935,41641,41226,449,41675,355
2021-04-19,Santa Barbara,083,443738,33934,33786,1184,34970,446
2021-04-19,Santa Clara,085,1922200,116812,117099,709,117808,1944
2021-04-19,Santa Cruz,087,273765,16032,15600,807,16407,204
2021-04-19,Shasta,089,179085,11691,11662,1421,13083,189
2021-04-19,Sierra,091,2930,55,51,12,63,0
2021-04-19,Siskiyou,093,43540,1660,1544,295,1839,10
2021-04-19,Solano,095,438530,31759,31643,465,32108,239
2021-04-19,Sonoma,097,501317,29514,29667,303,29970,311
2021-04-19,Stanislaus,099,539301,54522,54179,5759,59938,728
2021-04-19,Sutter,101,95872,9320,9269,82,9351,109
2021-04-19,Tehama,103,63373,4919,4878,542,5420,52
2021-04-19,Trinity,105,12862,482,326,85,411,3
2021-04-19,Tulare,107,460477,49638,48630,8773,57403,831
2021-04-19,Tuolumne,109,53932,3946,4010,38,4048,58
2021-04-19,Ventura,111,848112,80584,80000,2942,82942,996
2021-04-19,Yolo,113,214977,13616,13572,272,13844,200
2021-04-19,Yuba,115,75493,5846,5804,118,5922,44
2021-04-18,Alameda,001,1643700,85821,85481,1877,87358,1247
2021-04-18,Alpine,003,1148,85,85,0,85,0
2021-04-18,Amador,005,37829,3636,3627,33,3660,46
2021-04-18,Butte,007,227075,11963,11591,1721,13312,196
2021-04-18,Calaveras,009,45235,2054,2047,12,2059,50
2021-04-18,Colusa,011,21464,1914,1912,285,2197,14
2021-04-18,Contra Costa,013,1133247,67455,66750,1195,67945,782
2021-04-18,Del Norte,015,27424,1275,1240,11,1251,6
2021-04-18,El Dorado,017,186661,9804,9710,675,10385,106
2021-04-18,Fresno,019,978130,101176,100621,8484,109105,1646
2021-04-18,Glenn,021,27897,2376,2358,539,2897,17
2021-04-18,Humboldt,023,135768,3682,3590,28,3618,35
2021-04-18,Imperial,025,180216,28118,27991,2769,30760,719
2021-04-18,Inyo,027,18085,1394,1392,10,1402,36
2021-04-18,Kern,029,883053,96171,95129,10531,105660,1290
2021-04-18,Kings,031,150075,22933,22685,1060,23745,243
2021-04-18,Lake,033,64148,3434,3413,9,3422,43
2021-04-18,Lassen,035,31185,5166,5156,105,5261,1
2021-04-18,Los Angeles,037,10098052,1195970,1188620,41121,1229741,23648
2021-04-18,Madera,039,155013,16391,16277,917,17194,231
2021-04-18,Marin,041,260295,13838,13801,239,14040,226
2021-04-18,Mariposa,043,17540,410,400,10,410,5
2021-04-18,Mendocino,045,87422,3804,3722,72,3794,46
2021-04-18,Merced,047,269075,30401,30405,973,31378,441
2021-04-18,Modoc,049,8938,368,359,122,481,3
2021-04-18,Mono,051,14174,1241,1254,17,1271,3
2021-04-18,Monterey,053,433212,42849,42638,1840,44478,356
2021-04-18,Napa,055,140530,9704,9674,34,9708,79
2021-04-18,Nevada,057,99092,4534,4464,185,4649,70
2021-04-18,Orange,059,3164182,253332,251940,11087,263027,4883
2021-04-18,Placer,061,380077,22372,21783,1381,23164,282
2021-04-18,Plumas,063,18699,682,665,10,675,4
2021-04-18,Riverside,065,2383286,291740,286043,13855,299898,4371
2021-04-18,Sacramento,067,1510023,102047,101354,1598,102952,1572
2021-04-18,San Benito,069,59416,5987,5989,112,6101,63
2021-04-18,San Bernardino,071,2135413,291112,289691,8873,298564,4556
2021-04-18,San Diego,073,3302833,275613,274961,14210,289171,3674
2021-04-18,San Francisco,075,870044,35991,36073,1252,37325,525
2021-04-18,San Joaquin,077,732212,71281,70466,3391,73857,1289
2021-04-18,San Luis Obispo,079,281455,21020,20656,692,21348,254
2021-04-18,San Mateo,081,765935,41612,41201,448,41649,352
2021-04-18,Santa Barbara,083,443738,33899,33769,1183,34952,446
2021-04-18,Santa Clara,085,1922200,116644,116996,703,117699,1944
2021-04-18,Santa Cruz,087,273765,16022,15580,806,16386,204
2021-04-18,Shasta,089,179085,11670,11658,1418,13076,189
2021-04-18,Sierra,091,2930,55,51,12,63,0
2021-04-18,Siskiyou,093,43540,1649,1538,293,1831,10
2021-04-18,Solano,095,438530,31709,31606,464,32070,239
2021-04-18,Sonoma,097,501317,29498,29660,301,29961,311
2021-04-18,Stanislaus,099,539301,54440,54132,5752,59884,728
2021-04-18,Sutter,101,95872,9306,9261,82,9343,109
2021-04-18,Tehama,103,63373,4910,4877,541,5418,52
2021-04-18,Trinity,105,12862,482,326,85,411,3
2021-04-18,Tulare,107,460477,49626,48618,8767,57385,829
2021-04-18,Tuolumne,109,53932,3945,4008,37,4045,58
2021-04-18,Ventura,111,848112,80554,79984,2938,82922,996
2021-04-18,Yolo,113,214977,13604,13562,270,13832,200
2021-04-18,Yuba,115,75493,5839,5804,118,5922,44
2021-04-17,Alameda,001,1643700,85748,85367,1873,87240,1247
2021-04-17,Alpine,003,1148,85,85,0,85,0
2021-04-17,Amador,005,37829,3634,3625,33,3658,46
2021-04-17,Butte,007,227075,11943,11573,1717,13290,196
2021-04-17,Calaveras,009,45235,2052,2045,12,2057,50
2021-04-17,Colusa,011,21464,1914,1912,285,2197,14
2021-04-17,Contra Costa,013,1133247,67406,66657,1187,67844,782
2021-04-17,Del Norte,015,27424,1275,1238,11,1249,6
2021-04-17,El Dorado,017,186661,9789,9692,672,10364,106
2021-04-17,Fresno,019,978130,101143,100562,8479,109041,1646
2021-04-17,Glenn,021,27897,2376,2357,539,2896,17
2021-04-17,Humboldt,023,135768,3658,3579,28,3607,35
2021-04-17,Imperial,025,180216,28107,27987,2767,30754,719
2021-04-17,Inyo,027,18085,1391,1392,10,1402,36
2021-04-17,Kern,029,883053,96153,95102,10527,105629,1290
2021-04-17,Kings,031,150075,22928,22678,1059,23737,243
2021-04-17,Lake,033,64148,3433,3409,9,3418,43
2021-04-17,Lassen,035,31185,5166,5154,105,5259,1
2021-04-17,Los Angeles,037,10098052,1195714,1188262,41088,1229350,23653
2021-04-17,Madera,039,155013,16387,16260,916,17176,231
2021-04-17,Marin,041,260295,13834,13797,239,14036,226
2021-04-17,Mariposa,043,17540,409,398,10,408,5
2021-04-17,Mendocino,045,87422,3801,3721,72,3793,46
2021-04-17,Merced,047,269075,30385,30392,972,31364,441
2021-04-17,Modoc,049,8938,368,357,122,479,3
2021-04-17,Mono,051,14174,1241,1253,17,1270,3
2021-04-17,Monterey,053,433212,42840,42630,1838,44468,356
2021-04-17,Napa,055,140530,9700,9666,34,9700,79
2021-04-17,Nevada,057,99092,4526,4457,185,4642,70
2021-04-17,Orange,059,3164182,253263,251873,11075,262948,4878
2021-04-17,Placer,061,380077,22349,21736,1376,23112,282
2021-04-17,Plumas,063,18699,681,666,10,676,4
2021-04-17,Riverside,065,2383286,291671,285963,13847,299810,4371
2021-04-17,Sacramento,067,1510023,101937,101172,1587,102759,1572
2021-04-17,San Benito,069,59416,5981,5986,112,6098,63
2021-04-17,San Bernardino,071,2135413,291057,289624,8870,298494,4555
2021-04-17,San Diego,073,3302833,275466,274812,14176,288988,3674
2021-04-17,San Francisco,075,870044,35970,36032,1249,37281,523
2021-04-17,San Joaquin,077,732212,71241,70372,3381,73753,1288
2021-04-17,San Luis Obispo,079,281455,21007,20642,689,21331,254
2021-04-17,San Mateo,081,765935,41589,41157,448,41605,352
2021-04-17,Santa Barbara,083,443738,33868,33738,1181,34919,446
2021-04-17,Santa Clara,085,1922200,116552,116887,701,117588,1944
2021-04-17,Santa Cruz,087,273765,16016,15571,806,16377,204
2021-04-17,Shasta,089,179085,11655,11647,1417,13064,189
2021-04-17,Sierra,091,2930,55,51,12,63,0
2021-04-17,Siskiyou,093,43540,1644,1539,290,1829,10
2021-04-17,Solano,095,438530,31678,31541,461,32002,239
2021-04-17,Sonoma,097,501317,29491,29637,301,29938,311
2021-04-17,Stanislaus,099,539301,54403,54058,5747,59805,728
2021-04-17,Sutter,101,95872,9300,9252,82,9334,109
2021-04-17,Tehama,103,63373,4904,4875,540,5415,52
2021-04-17,Trinity,105,12862,482,326,85,411,3
2021-04-17,Tulare,107,460477,49614,48603,8763,57366,829
2021-04-17,Tuolumne,109,53932,3943,4005,37,4042,58
2021-04-17,Ventura,111,848112,80533,79964,2938,82902,996
2021-04-17,Yolo,113,214977,13594,13580,270,13850,200
2021-04-17,Yuba,115,75493,5834,5802,117,5919,44
2021-04-16,Alameda,001,1643700,85669,85243,1871,87114,1245
2021-04-16,Alpine,003,1148,85,85,0,85,0
2021-04-16,Amador,005,37829,3629,3621,33,3654,46
2021-04-16,Butte,007,227075,11931,11549,1715,13264,196
2021-04-16,Calaveras,009,45235,2050,2042,12,2054,50
2021-04-16,Colusa,011,21464,1912,1911,285,2196,14
2021-04-16,Contra Costa,013,1133247,67352,66569,1184,67753,782
2021-04-16,Del Norte,015,27424,1274,1237,11,1248,6
2021-04-16,El Dorado,017,186661,9769,9665,668,10333,106
2021-04-16,Fresno,019,978130,101093,100500,8473,108973,1643
2021-04-16,Glenn,021,27897,2376,2355,539,2894,17
2021-04-16,Humboldt,023,135768,3637,3570,27,3597,35
2021-04-16,Imperial,025,180216,28097,27962,2766,30728,719
2021-04-16,Inyo,027,18085,1391,1392,10,1402,36
2021-04-16,Kern,029,883053,96124,95066,10524,105590,1288
2021-04-16,Kings,031,150075,22924,22667,1058,23725,243
2021-04-16,Lake,033,64148,3427,3406,9,3415,43
2021-04-16,Lassen,035,31185,5165,5155,105,5260,1
2021-04-16,Los Angeles,037,10098052,1195413,1187818,41052,1228870,23627
2021-04-16,Madera,039,155013,16381,16250,915,17165,231
2021-04-16,Marin,041,260295,13831,13788,239,14027,226
2021-04-16,Mariposa,043,17540,408,396,9,405,5
2021-04-16,Mendocino,045,87422,3799,3719,72,3791,46
2021-04-16,Merced,047,269075,30370,30355,972,31327,438
2021-04-16,Modoc,049,8938,368,355,122,477,3
2021-04-16,Mono,051,14174,1241,1253,17,1270,3
2021-04-16,Monterey,053,433212,42829,42620,1835,44455,351
2021-04-16,Napa,055,140530,9692,9653,34,9687,79
2021-04-16,Nevada,057,99092,4517,4443,185,4628,70
2021-04-16,Orange,059,3164182,253199,251770,11066,262836,4873
2021-04-16,Placer,061,380077,22322,21680,1371,23051,282
2021-04-16,Plumas,063,18699,680,665,10,675,4
2021-04-16,Riverside,065,2383286,291594,285818,13845,299663,4369
2021-04-16,Sacramento,067,1510023,101840,100993,1582,102575,1572
2021-04-16,San Benito,069,59416,5979,5982,112,6094,63
2021-04-16,San Bernardino,071,2135413,291010,289424,8869,298293,4550
2021-04-16,San Diego,073,3302833,275312,274567,14158,288725,3662
2021-04-16,San Francisco,075,870044,35944,35993,1245,37238,517
2021-04-16,San Joaquin,077,732212,71174,70280,3373,73653,1288
2021-04-16,San Luis Obispo,079,281455,20995,20623,688,21311,253
2021-04-16,San Mateo,081,765935,41560,41107,447,41554,352
2021-04-16,Santa Barbara,083,443738,33850,33703,1181,34884,446
2021-04-16,Santa Clara,085,1922200,116452,116693,698,117391,1941
2021-04-16,Santa Cruz,087,273765,16014,15539,806,16345,204
2021-04-16,Shasta,089,179085,11643,11623,1415,13038,189
2021-04-16,Sierra,091,2930,55,51,12,63,0
2021-04-16,Siskiyou,093,43540,1640,1530,288,1818,10
2021-04-16,Solano,095,438530,31639,31470,458,31928,239
2021-04-16,Sonoma,097,501317,29480,29617,301,29918,311
2021-04-16,Stanislaus,099,539301,54355,53983,5745,59728,728
2021-04-16,Sutter,101,95872,9294,9247,82,9329,109
2021-04-16,Tehama,103,63373,4903,4866,540,5406,52
2021-04-16,Trinity,105,12862,482,326,85,411,3
2021-04-16,Tulare,107,460477,49602,48583,8759,57342,830
2021-04-16,Tuolumne,109,53932,3940,4005,37,4042,58
2021-04-16,Ventura,111,848112,80508,79942,2933,82875,994
2021-04-16,Yolo,113,214977,13581,13559,268,13827,198
2021-04-16,Yuba,115,75493,5831,5795,116,5911,44
2021-04-15,Alameda,001,1643700,85562,85089,1869,86958,1246
2021-04-15,Alpine,003,1148,85,85,0,85,0
2021-04-15,Amador,005,37829,3628,3616,33,3649,46
2021-04-15,Butte,007,227075,11916,11529,1711,13240,196
2021-04-15,Calaveras,009,45235,2049,2039,12,2051,50
2021-04-15,Colusa,011,21464,1910,1909,284,2193,14
2021-04-15,Contra Costa,013,1133247,67278,66480,1180,67660,781
2021-04-15,Del Norte,015,27424,1267,1235,11,1246,6
2021-04-15,El Dorado,017,186661,9756,9639,666,10305,106
2021-04-15,Fresno,019,978130,101031,100431,8467,108898,1642
2021-04-15,Glenn,021,27897,2376,2354,539,2893,17
2021-04-15,Humboldt,023,135768,3616,3561,27,3588,35
2021-04-15,Imperial,025,180216,28069,27920,2763,30683,718
2021-04-15,Inyo,027,18085,1391,1393,10,1403,36
2021-04-15,Kern,029,883053,96091,94989,10510,105499,1289
2021-04-15,Kings,031,150075,22910,22648,1058,23706,242
2021-04-15,Lake,033,64148,3426,3399,9,3408,43
2021-04-15,Lassen,035,31185,5164,5152,105,5257,1
2021-04-15,Los Angeles,037,10098052,1195012,1187274,41016,1228290,23598
2021-04-15,Madera,039,155013,16366,16234,915,17149,231
2021-04-15,Marin,041,260295,13827,13783,238,14021,226
2021-04-15,Mariposa,043,17540,406,395,9,404,5
2021-04-15,Mendocino,045,87422,3798,3714,72,3786,46
2021-04-15,Merced,047,269075,30344,30325,971,31296,437
2021-04-15,Modoc,049,8938,368,355,122,477,3
2021-04-15,Mono,051,14174,1240,1253,17,1270,3
2021-04-15,Monterey,053,433212,42819,42604,1833,44437,347
2021-04-15,Napa,055,140530,9684,9645,34,9679,79
2021-04-15,Nevada,057,99092,4505,4434,184,4618,70
2021-04-15,Orange,059,3164182,253104,251679,11053,262732,4857
2021-04-15,Placer,061,380077,22292,21614,1364,22978,281
2021-04-15,Plumas,063,18699,678,665,10,675,4
2021-04-15,Riverside,065,2383286,291490,285698,13838,299536,4363
2021-04-15,Sacramento,067,1510023,101710,100782,1568,102350,1570
2021-04-15,San Benito,069,59416,5976,5969,111,6080,63
2021-04-15,San Bernardino,071,2135413,290921,289288,8862,298150,4544
2021-04-15,San Diego,073,3302833,275066,274250,14099,288349,3653
2021-04-15,San Francisco,075,870044,35925,35947,1243,37190,510
2021-04-15,San Joaquin,077,732212,71093,70189,3365,73554,1288
2021-04-15,San Luis Obispo,079,281455,20979,20591,685,21276,253
2021-04-15,San Mateo,081,765935,41521,41050,446,41496,352
2021-04-15,Santa Barbara,083,443738,33832,33672,1177,34849,446
2021-04-15,Santa Clara,085,1922200,116346,116602,694,117296,1927
2021-04-15,Santa Cruz,087,273765,16004,15509,806,16315,203
2021-04-15,Shasta,089,179085,11629,11597,1411,13008,191
2021-04-15,Sierra,091,2930,55,51,12,63,0
2021-04-15,Siskiyou,093,43540,1634,1524,287,1811,10
2021-04-15,Solano,095,438530,31601,31394,457,31851,239
2021-04-15,Sonoma,097,501317,29466,29587,301,29888,311
2021-04-15,Stanislaus,099,539301,54301,53918,5736,59654,728
2021-04-15,Sutter,101,95872,9287,9237,82,9319,109
2021-04-15,Tehama,103,63373,4901,4854,539,5393,52
2021-04-15,Trinity,105,12862,482,326,85,411,3
2021-04-15,Tulare,107,460477,49581,48556,8759,57315,829
2021-04-15,Tuolumne,109,53932,3940,4003,37,4040,57
2021-04-15,Ventura,111,848112,80489,79917,2931,82848,989
2021-04-15,Yolo,113,214977,13562,13547,266,13813,198
2021-04-15,Yuba,115,75493,5828,5788,116,5904,44
2021-04-14,Alameda,001,1643700,85465,85009,1868,86877,1247
2021-04-14,Alpine,003,1148,85,85,0,85,0
2021-04-14,Amador,005,37829,3627,3613,33,3646,46
2021-04-14,Butte,007,227075,11903,11513,1710,13223,196
2021-04-14,Calaveras,009,45235,2047,2037,12,2049,50
2021-04-14,Colusa,011,21464,1910,1905,284,2189,14
2021-04-14,Contra Costa,013,1133247,67192,66400,1174,67574,781
2021-04-14,Del Norte,015,27424,1267,1228,11,1239,6
2021-04-14,El Dorado,017,186661,9741,9625,661,10286,106
2021-04-14,Fresno,019,978130,100974,100376,8454,108830,1640
2021-04-14,Glenn,021,27897,2376,2353,539,2892,17
2021-04-14,Humboldt,023,135768,3594,3551,26,3577,35
2021-04-14,Imperial,025,180216,28047,27907,2761,30668,718
2021-04-14,Inyo,027,18085,1391,1392,10,1402,36
2021-04-14,Kern,029,883053,96066,94947,10503,105450,1287
2021-04-14,Kings,031,150075,22901,22641,1056,23697,243
2021-04-14,Lake,033,64148,3421,3396,9,3405,43
2021-04-14,Lassen,035,31185,5163,5151,105,5256,1
2021-04-14,Los Angeles,037,10098052,1194614,1186821,40971,1227792,23579
2021-04-14,Madera,039,155013,16357,16218,915,17133,231
2021-04-14,Marin,041,260295,13825,13768,237,14005,226
2021-04-14,Mariposa,043,17540,405,394,9,403,5
2021-04-14,Mendocino,045,87422,3793,3711,72,3783,46
2021-04-14,Merced,047,269075,30326,30296,971,31267,436
2021-04-14,Modoc,049,8938,368,355,122,477,3
2021-04-14,Mono,051,14174,1240,1252,17,1269,3
2021-04-14,Monterey,053,433212,42803,42595,1829,44424,347
2021-04-14,Napa,055,140530,9673,9643,34,9677,79
2021-04-14,Nevada,057,99092,4498,4421,184,4605,70
2021-04-14,Orange,059,3164182,252999,251568,11033,262601,4849
2021-04-14,Placer,061,380077,22259,21575,1363,22938,280
2021-04-14,Plumas,063,18699,678,665,10,675,4
2021-04-14,Riverside,065,2383286,291380,285583,13832,299415,4358
2021-04-14,Sacramento,067,1510023,101535,100645,1554,102199,1570
2021-04-14,San Benito,069,59416,5974,5960,111,6071,62
2021-04-14,San Bernardino,071,2135413,290854,289078,8859,297937,4523
2021-04-14,San Diego,073,3302833,274855,273969,14070,288039,3648
2021-04-14,San Francisco,075,870044,35887,35898,1242,37140,510
2021-04-14,San Joaquin,077,732212,71023,70095,3359,73454,1288
2021-04-14,San Luis Obispo,079,281455,20956,20561,675,21236,253
2021-04-14,San Mateo,081,765935,41481,40982,443,41425,352
2021-04-14,Santa Barbara,083,443738,33803,33650,1177,34827,445
2021-04-14,Santa Clara,085,1922200,116228,116488,691,117179,1922
2021-04-14,Santa Cruz,087,273765,15994,15481,806,16287,203
2021-04-14,Shasta,089,179085,11603,11581,1409,12990,190
2021-04-14,Sierra,091,2930,55,51,12,63,0
2021-04-14,Siskiyou,093,43540,1626,1518,286,1804,10
2021-04-14,Solano,095,438530,31548,31357,450,31807,239
2021-04-14,Sonoma,097,501317,29458,29572,299,29871,311
2021-04-14,Stanislaus,099,539301,54230,53836,5727,59563,727
2021-04-14,Sutter,101,95872,9279,9230,82,9312,106
2021-04-14,Tehama,103,63373,4895,4853,538,5391,52
2021-04-14,Trinity,105,12862,482,326,85,411,3
2021-04-14,Tulare,107,460477,49555,48527,8756,57283,827
2021-04-14,Tuolumne,109,53932,3939,3997,37,4034,57
2021-04-14,Ventura,111,848112,80453,79891,2929,82820,986
2021-04-14,Yolo,113,214977,13546,13530,264,13794,198
2021-04-14,Yuba,115,75493,5826,5778,116,5894,44
2021-04-13,Alameda,001,1643700,85359,84921,1864,86785,1239
2021-04-13,Alpine,003,1148,85,85,0,85,0
2021-04-13,Amador,005,37829,3624,3609,33,3642,46
2021-04-13,Butte,007,227075,11885,11497,1707,13204,196
2021-04-13,Calaveras,009,45235,2045,2035,12,2047,50
2021-04-13,Colusa,011,21464,1908,1905,282,2187,14
2021-04-13,Contra Costa,013,1133247,67102,66304,1174,67478,778
2021-04-13,Del Norte,015,27424,1262,1221,11,1232,6
2021-04-13,El Dorado,017,186661,9715,9609,658,10267,106
2021-04-13,Fresno,019,978130,100892,100357,8448,108805,1636
2021-04-13,Glenn,021,27897,2375,2351,539,2890,17
2021-04-13,Humboldt,023,135768,3577,3540,26,3566,35
2021-04-13,Imperial,025,180216,28028,27887,2753,30640,718
2021-04-13,Inyo,027,18085,1391,1391,10,1401,36
2021-04-13,Kern,029,883053,96022,94908,10491,105399,1285
2021-04-13,Kings,031,150075,22885,22636,1055,23691,243
2021-04-13,Lake,033,64148,3418,3390,9,3399,43
2021-04-13,Lassen,035,31185,5162,5147,105,5252,1
2021-04-13,Los Angeles,037,10098052,1194159,1186482,40929,1227411,23526
2021-04-13,Madera,039,155013,16347,16207,913,17120,231
2021-04-13,Marin,041,260295,13817,13760,236,13996,224
2021-04-13,Mariposa,043,17540,404,394,6,400,5
2021-04-13,Mendocino,045,87422,3787,3702,72,3774,46
2021-04-13,Merced,047,269075,30295,30276,969,31245,435
2021-04-13,Modoc,049,8938,368,355,122,477,3
2021-04-13,Mono,051,14174,1240,1251,17,1268,3
2021-04-13,Monterey,053,433212,42792,42577,1829,44406,347
2021-04-13,Napa,055,140530,9663,9627,34,9661,79
2021-04-13,Nevada,057,99092,4486,4415,184,4599,69
2021-04-13,Orange,059,3164182,252904,251491,11014,262505,4836
2021-04-13,Placer,061,380077,22222,21534,1360,22894,280
2021-04-13,Plumas,063,18699,677,665,10,675,4
2021-04-13,Riverside,065,2383286,291261,285505,13826,299331,4348
2021-04-13,Sacramento,067,1510023,101360,100551,1549,102100,1569
2021-04-13,San Benito,069,59416,5971,5946,111,6057,62
2021-04-13,San Bernardino,071,2135413,290738,288929,8853,297782,4521
2021-04-13,San Diego,073,3302833,274601,273709,14035,287744,3623
2021-04-13,San Francisco,075,870044,35851,35869,1238,37107,506
2021-04-13,San Joaquin,077,732212,70915,70034,3351,73385,1288
2021-04-13,San Luis Obispo,079,281455,20929,20536,665,21201,253
2021-04-13,San Mateo,081,765935,41436,40955,443,41398,353
2021-04-13,Santa Barbara,083,443738,33781,33613,1174,34787,444
2021-04-13,Santa Clara,085,1922200,116099,116363,690,117053,1923
2021-04-13,Santa Cruz,087,273765,15987,15449,806,16255,203
2021-04-13,Shasta,089,179085,11583,11536,1406,12942,189
2021-04-13,Sierra,091,2930,55,51,12,63,0
2021-04-13,Siskiyou,093,43540,1618,1511,281,1792,10
2021-04-13,Solano,095,438530,31499,31335,446,31781,239
2021-04-13,Sonoma,097,501317,29450,29544,298,29842,311
2021-04-13,Stanislaus,099,539301,54157,53797,5718,59515,722
2021-04-13,Sutter,101,95872,9275,9226,82,9308,106
2021-04-13,Tehama,103,63373,4888,4850,535,5385,52
2021-04-13,Trinity,105,12862,482,326,85,411,3
2021-04-13,Tulare,107,460477,49542,48511,8753,57264,825
2021-04-13,Tuolumne,109,53932,3937,3995,37,4032,57
2021-04-13,Ventura,111,848112,80421,79854,2927,82781,986
2021-04-13,Yolo,113,214977,13534,13516,263,13779,198
2021-04-13,Yuba,115,75493,5817,5776,116,5892,44
2021-04-12,Alameda,001,1643700,85258,84817,1863,86680,1238
2021-04-12,Alpine,003,1148,85,85,0,85,0
2021-04-12,Amador,005,37829,3623,3607,33,3640,46
2021-04-12,Butte,007,227075,11870,11488,1703,13191,193
2021-04-12,Calaveras,009,45235,2044,2033,12,2045,50
2021-04-12,Colusa,011,21464,1906,1904,280,2184,14
2021-04-12,Contra Costa,013,1133247,67020,66176,1174,67350,777
2021-04-12,Del Norte,015,27424,1259,1216,11,1227,6
2021-04-12,El Dorado,017,186661,9698,9588,656,10244,106
2021-04-12,Fresno,019,978130,100831,100277,8424,108701,1633
2021-04-12,Glenn,021,27897,2374,2349,539,2888,17
2021-04-12,Humboldt,023,135768,3563,3533,25,3558,35
2021-04-12,Imperial,025,180216,27998,27851,2747,30598,717
2021-04-12,Inyo,027,18085,1391,1390,10,1400,36
2021-04-12,Kern,029,883053,95985,94861,10480,105341,1283
2021-04-12,Kings,031,150075,22877,22621,1054,23675,241
2021-04-12,Lake,033,64148,3414,3380,9,3389,43
2021-04-12,Lassen,035,31185,5161,5147,105,5252,1
2021-04-12,Los Angeles,037,10098052,1193658,1186145,40889,1227034,23505
2021-04-12,Madera,039,155013,16335,16174,911,17085,231
2021-04-12,Marin,041,260295,13804,13751,234,13985,224
2021-04-12,Mariposa,043,17540,403,394,6,400,5
2021-04-12,Mendocino,045,87422,3786,3699,72,3771,46
2021-04-12,Merced,047,269075,30263,30261,967,31228,435
2021-04-12,Modoc,049,8938,366,352,122,474,3
2021-04-12,Mono,051,14174,1240,1251,17,1268,3
2021-04-12,Monterey,053,433212,42778,42555,1827,44382,346
2021-04-12,Napa,055,140530,9649,9603,34,9637,80
2021-04-12,Nevada,057,99092,4475,4408,184,4592,69
2021-04-12,Orange,059,3164182,252818,251350,10993,262343,4826
2021-04-12,Placer,061,380077,22172,21475,1357,22832,278
2021-04-12,Plumas,063,18699,675,666,10,676,4
2021-04-12,Riverside,065,2383286,291150,285361,13820,299181,4336
2021-04-12,Sacramento,067,1510023,101186,100394,1544,101938,1566
2021-04-12,San Benito,069,59416,5963,5942,110,6052,62
2021-04-12,San Bernardino,071,2135413,290631,288736,8841,297577,4493
2021-04-12,San Diego,073,3302833,274341,273431,14006,287437,3621
2021-04-12,San Francisco,075,870044,35817,35841,1237,37078,506
2021-04-12,San Joaquin,077,732212,70843,69968,3344,73312,1288
2021-04-12,San Luis Obispo,079,281455,20884,20515,652,21167,253
2021-04-12,San Mateo,081,765935,41394,40920,439,41359,353
2021-04-12,Santa Barbara,083,443738,33750,33606,1174,34780,444
2021-04-12,Santa Clara,085,1922200,115971,116252,688,116940,1923
2021-04-12,Santa Cruz,087,273765,15967,15406,806,16212,203
2021-04-12,Shasta,089,179085,11566,11509,1402,12911,189
2021-04-12,Sierra,091,2930,55,51,12,63,0
2021-04-12,Siskiyou,093,43540,1607,1511,278,1789,7
2021-04-12,Solano,095,438530,31457,31305,443,31748,238
2021-04-12,Sonoma,097,501317,29422,29500,298,29798,310
2021-04-12,Stanislaus,099,539301,54091,53722,5711,59433,707
2021-04-12,Sutter,101,95872,9264,9221,82,9303,106
2021-04-12,Tehama,103,63373,4879,4834,531,5365,52
2021-04-12,Trinity,105,12862,482,324,85,409,3
2021-04-12,Tulare,107,460477,49522,48495,8743,57238,824
2021-04-12,Tuolumne,109,53932,3933,3993,37,4030,57
2021-04-12,Ventura,111,848112,80388,79818,2925,82743,985
2021-04-12,Yolo,113,214977,13520,13510,262,13772,198
2021-04-12,Yuba,115,75493,5811,5773,116,5889,43
2021-04-11,Alameda,001,1643700,85121,84756,1857,86613,1238
2021-04-11,Alpine,003,1148,85,85,0,85,0
2021-04-11,Amador,005,37829,3621,3605,33,3638,46
2021-04-11,Butte,007,227075,11835,11487,1699,13186,193
2021-04-11,Calaveras,009,45235,2041,2036,12,2048,50
2021-04-11,Colusa,011,21464,1905,1904,279,2183,14
2021-04-11,Contra Costa,013,1133247,66911,66107,1172,67279,777
2021-04-11,Del Norte,015,27424,1253,1214,11,1225,6
2021-04-11,El Dorado,017,186661,9684,9575,653,10228,106
2021-04-11,Fresno,019,978130,100763,100230,8414,108644,1633
2021-04-11,Glenn,021,27897,2370,2348,539,2887,17
2021-04-11,Humboldt,023,135768,3553,3523,25,3548,35
2021-04-11,Imperial,025,180216,27974,27841,2745,30586,717
2021-04-11,Inyo,027,18085,1391,1390,10,1400,36
2021-04-11,Kern,029,883053,95924,94830,10472,105302,1283
2021-04-11,Kings,031,150075,22868,22618,1051,23669,241
2021-04-11,Lake,033,64148,3410,3377,9,3386,43
2021-04-11,Lassen,035,31185,5157,5147,105,5252,1
2021-04-11,Los Angeles,037,10098052,1193146,1185757,40847,1226604,23503
2021-04-11,Madera,039,155013,16316,16166,910,17076,231
2021-04-11,Marin,041,260295,13797,13741,233,13974,226
2021-04-11,Mariposa,043,17540,403,394,6,400,5
2021-04-11,Mendocino,045,87422,3784,3696,72,3768,46
2021-04-11,Merced,047,269075,30225,30249,966,31215,435
2021-04-11,Modoc,049,8938,365,352,120,472,3
2021-04-11,Mono,051,14174,1239,1250,17,1267,3
2021-04-11,Monterey,053,433212,42771,42547,1820,44367,346
2021-04-11,Napa,055,140530,9638,9592,34,9626,80
2021-04-11,Nevada,057,99092,4461,4394,184,4578,69
2021-04-11,Orange,059,3164182,252691,251233,10982,262215,4826
2021-04-11,Placer,061,380077,22114,21458,1352,22810,278
2021-04-11,Plumas,063,18699,675,666,10,676,4
2021-04-11,Riverside,065,2383286,291017,285269,13810,299079,4336
2021-04-11,Sacramento,067,1510023,101016,100296,1531,101827,1566
2021-04-11,San Benito,069,59416,5955,5941,109,6050,62
2021-04-11,San Bernardino,071,2135413,290522,288686,8835,297521,4492
2021-04-11,San Diego,073,3302833,274043,273287,13947,287234,3621
2021-04-11,San Francisco,075,870044,35781,35815,1234,37049,498
2021-04-11,San Joaquin,077,732212,70757,69939,3333,73272,1288
2021-04-11,San Luis Obispo,079,281455,20858,20501,649,21150,253
2021-04-11,San Mateo,081,765935,41336,40901,438,41339,353
2021-04-11,Santa Barbara,083,443738,33715,33591,1173,34764,444
2021-04-11,Santa Clara,085,1922200,115835,116161,685,116846,1923
2021-04-11,Santa Cruz,087,273765,15955,15382,806,16188,203
2021-04-11,Shasta,089,179085,11522,11504,1401,12905,189
2021-04-11,Sierra,091,2930,55,51,12,63,0
2021-04-11,Siskiyou,093,43540,1600,1509,275,1784,7
2021-04-11,Solano,095,438530,31404,31268,439,31707,238
2021-04-11,Sonoma,097,501317,29396,29496,294,29790,310
2021-04-11,Stanislaus,099,539301,54008,53683,5702,59385,707
2021-04-11,Sutter,101,95872,9255,9222,82,9304,106
2021-04-11,Tehama,103,63373,4876,4832,529,5361,52
2021-04-11,Trinity,105,12862,482,324,85,409,3
2021-04-11,Tulare,107,460477,49508,48479,8736,57215,824
2021-04-11,Tuolumne,109,53932,3931,3993,37,4030,57
2021-04-11,Ventura,111,848112,80340,79800,2919,82719,985
2021-04-11,Yolo,113,214977,13500,13496,260,13756,198
2021-04-11,Yuba,115,75493,5801,5768,116,5884,43
2021-04-10,Alameda,001,1643700,85057,84626,1857,86483,1238
2021-04-10,Alpine,003,1148,85,85,0,85,0
2021-04-10,Amador,005,37829,3619,3603,33,3636,46
2021-04-10,Butte,007,227075,11824,11482,1698,13180,193
2021-04-10,Calaveras,009,45235,2039,2032,12,2044,50
2021-04-10,Colusa,011,21464,1905,1902,279,2181,14
2021-04-10,Contra Costa,013,1133247,66850,66001,1169,67170,778
2021-04-10,Del Norte,015,27424,1250,1212,11,1223,6
2021-04-10,El Dorado,017,186661,9672,9549,650,10199,106
2021-04-10,Fresno,019,978130,100730,100135,8407,108542,1633
2021-04-10,Glenn,021,27897,2370,2343,539,2882,17
2021-04-10,Humboldt,023,135768,3543,3508,25,3533,35
2021-04-10,Imperial,025,180216,27960,27816,2745,30561,717
2021-04-10,Inyo,027,18085,1391,1387,10,1397,36
2021-04-10,Kern,029,883053,95910,94802,10466,105268,1284
2021-04-10,Kings,031,150075,22864,22614,1049,23663,241
2021-04-10,Lake,033,64148,3405,3368,9,3377,43
2021-04-10,Lassen,035,31185,5157,5146,104,5250,1
2021-04-10,Los Angeles,037,10098052,1192873,1185246,40829,1226075,23493
2021-04-10,Madera,039,155013,16308,16143,909,17052,231
2021-04-10,Marin,041,260295,13792,13731,233,13964,226
2021-04-10,Mariposa,043,17540,400,393,6,399,5
2021-04-10,Mendocino,045,87422,3782,3696,72,3768,46
2021-04-10,Merced,047,269075,30205,30225,965,31190,435
2021-04-10,Modoc,049,8938,365,352,120,472,3
2021-04-10,Mono,051,14174,1239,1249,17,1266,3
2021-04-10,Monterey,053,433212,42760,42527,1819,44346,346
2021-04-10,Napa,055,140530,9631,9569,34,9603,79
2021-04-10,Nevada,057,99092,4454,4379,184,4563,69
2021-04-10,Orange,059,3164182,252598,251139,10975,262114,4818
2021-04-10,Placer,061,380077,22083,21402,1346,22748,278
2021-04-10,Plumas,063,18699,675,666,10,676,4
2021-04-10,Riverside,065,2383286,290937,285082,13802,298884,4336
2021-04-10,Sacramento,067,1510023,100913,100048,1529,101577,1566
2021-04-10,San Benito,069,59416,5944,5932,108,6040,62
2021-04-10,San Bernardino,071,2135413,290458,288590,8828,297418,4489
2021-04-10,San Diego,073,3302833,273827,273058,13928,286986,3613
2021-04-10,San Francisco,075,870044,35751,35774,1231,37005,498
2021-04-10,San Joaquin,077,732212,70722,69852,3323,73175,1288
2021-04-10,San Luis Obispo,079,281455,20842,20461,648,21109,253
2021-04-10,San Mateo,081,765935,41303,40878,438,41316,350
2021-04-10,Santa Barbara,083,443738,33687,33541,1171,34712,444
2021-04-10,Santa Clara,085,1922200,115739,116015,684,116699,1923
2021-04-10,Santa Cruz,087,273765,15949,15360,806,16166,203
2021-04-10,Shasta,089,179085,11513,11492,1398,12890,189
2021-04-10,Sierra,091,2930,55,51,12,63,0
2021-04-10,Siskiyou,093,43540,1597,1512,275,1787,7
2021-04-10,Solano,095,438530,31370,31218,435,31653,238
2021-04-10,Sonoma,097,501317,29381,29469,294,29763,310
2021-04-10,Stanislaus,099,539301,53973,53596,5696,59292,707
2021-04-10,Sutter,101,95872,9253,9214,82,9296,106
2021-04-10,Tehama,103,63373,4874,4820,527,5347,52
2021-04-10,Trinity,105,12862,482,324,85,409,3
2021-04-10,Tulare,107,460477,49499,48470,8730,57200,824
2021-04-10,Tuolumne,109,53932,3928,3991,37,4028,57
2021-04-10,Ventura,111,848112,80312,79758,2917,82675,985
2021-04-10,Yolo,113,214977,13492,13494,259,13753,198
2021-04-10,Yuba,115,75493,5798,5757,115,5872,43
2021-04-09,Alameda,001,1643700,84990,84404,1849,86253,1237
2021-04-09,Alpine,003,1148,85,85,0,85,0
2021-04-09,Amador,005,37829,3618,3600,33,3633,46
2021-04-09,Butte,007,227075,11814,11454,1697,13151,193
2021-04-09,Calaveras,009,45235,2038,2028,12,2040,50
2021-04-09,Colusa,011,21464,1905,1898,279,2177,14
2021-04-09,Contra Costa,013,1133247,66757,65857,1163,67020,777
2021-04-09,Del Norte,015,27424,1249,1207,11,1218,6
2021-04-09,El Dorado,017,186661,9649,9528,646,10174,106
2021-04-09,Fresno,019,978130,100696,100027,8402,108429,1630
2021-04-09,Glenn,021,27897,2370,2337,539,2876,17
2021-04-09,Humboldt,023,135768,3534,3496,25,3521,35
2021-04-09,Imperial,025,180216,27945,27764,2743,30507,717
2021-04-09,Inyo,027,18085,1390,1386,10,1396,36
2021-04-09,Kern,029,883053,95872,94675,10464,105139,1282
2021-04-09,Kings,031,150075,22855,22595,1046,23641,242
2021-04-09,Lake,033,64148,3401,3362,9,3371,43
2021-04-09,Lassen,035,31185,5157,5140,104,5244,1
2021-04-09,Los Angeles,037,10098052,1192503,1184501,40800,1225301,23458
2021-04-09,Madera,039,155013,16305,16118,909,17027,231
2021-04-09,Marin,041,260295,13785,13721,233,13954,226
2021-04-09,Mariposa,043,17540,400,393,6,399,5
2021-04-09,Mendocino,045,87422,3780,3693,72,3765,46
2021-04-09,Merced,047,269075,30176,30179,964,31143,435
2021-04-09,Modoc,049,8938,364,352,120,472,3
2021-04-09,Mono,051,14174,1239,1247,17,1264,3
2021-04-09,Monterey,053,433212,42751,42481,1815,44296,344
2021-04-09,Napa,055,140530,9612,9574,34,9608,80
2021-04-09,Nevada,057,99092,4446,4373,184,4557,69
2021-04-09,Orange,059,3164182,252524,250852,10970,261822,4813
2021-04-09,Placer,061,380077,22052,21327,1338,22665,278
2021-04-09,Plumas,063,18699,674,666,10,676,4
2021-04-09,Riverside,065,2383286,290854,284562,13796,298358,4325
2021-04-09,Sacramento,067,1510023,100758,99722,1523,101245,1564
2021-04-09,San Benito,069,59416,5939,5925,107,6032,62
2021-04-09,San Bernardino,071,2135413,290389,288000,8825,296825,4467
2021-04-09,San Diego,073,3302833,273629,272697,13886,286583,3600
2021-04-09,San Francisco,075,870044,35710,35716,1226,36942,497
2021-04-09,San Joaquin,077,732212,70658,69675,3311,72986,1281
2021-04-09,San Luis Obispo,079,281455,20828,20427,648,21075,252
2021-04-09,San Mateo,081,765935,41267,40800,437,41237,350
2021-04-09,Santa Barbara,083,443738,33664,33424,1168,34592,444
2021-04-09,Santa Clara,085,1922200,115655,115749,682,116431,1923
2021-04-09,Santa Cruz,087,273765,15944,15331,806,16137,203
2021-04-09,Shasta,089,179085,11503,11478,1395,12873,188
2021-04-09,Sierra,091,2930,55,51,12,63,0
2021-04-09,Siskiyou,093,43540,1594,1510,274,1784,7
2021-04-09,Solano,095,438530,31337,31166,430,31596,238
2021-04-09,Sonoma,097,501317,29368,29433,294,29727,310
2021-04-09,Stanislaus,099,539301,53918,53504,5687,59191,705
2021-04-09,Sutter,101,95872,9246,9201,82,9283,106
2021-04-09,Tehama,103,63373,4868,4806,527,5333,52
2021-04-09,Trinity,105,12862,481,324,85,409,3
2021-04-09,Tulare,107,460477,49495,48430,8724,57154,824
2021-04-09,Tuolumne,109,53932,3927,3986,37,4023,57
2021-04-09,Ventura,111,848112,80284,79698,2917,82615,987
2021-04-09,Yolo,113,214977,13481,13478,257,13735,198
2021-04-09,Yuba,115,75493,5791,5754,115,5869,43
2021-04-08,Alameda,001,1643700,84884,84213,1846,86059,1232
2021-04-08,Alpine,003,1148,85,85,0,85,0
2021-04-08,Amador,005,37829,3614,3595,33,3628,46
2021-04-08,Butte,007,227075,11803,11414,1696,13110,193
2021-04-08,Calaveras,009,45235,2036,2027,12,2039,50
2021-04-08,Colusa,011,21464,1904,1897,279,2176,14
2021-04-08,Contra Costa,013,1133247,66647,65706,1160,66866,775
2021-04-08,Del Norte,015,27424,1243,1201,11,1212,6
2021-04-08,El Dorado,017,186661,9633,9513,641,10154,106
2021-04-08,Fresno,019,978130,100632,99935,8395,108330,1627
2021-04-08,Glenn,021,27897,2369,2337,539,2876,17
2021-04-08,Humboldt,023,135768,3524,3486,25,3511,35
2021-04-08,Imperial,025,180216,27917,27744,2739,30483,713
2021-04-08,Inyo,027,18085,1389,1386,10,1396,36
2021-04-08,Kern,029,883053,95826,94493,10451,104944,1281
2021-04-08,Kings,031,150075,22848,22589,1044,23633,243
2021-04-08,Lake,033,64148,3394,3360,9,3369,43
2021-04-08,Lassen,035,31185,5156,5136,104,5240,1
2021-04-08,Los Angeles,037,10098052,1192006,1184443,40762,1225205,23416
2021-04-08,Madera,039,155013,16293,16103,909,17012,231
2021-04-08,Marin,041,260295,13778,13704,233,13937,226
2021-04-08,Mariposa,043,17540,399,393,6,399,5
2021-04-08,Mendocino,045,87422,3778,3690,72,3762,45
2021-04-08,Merced,047,269075,30154,30163,964,31127,430
2021-04-08,Modoc,049,8938,364,352,120,472,3
2021-04-08,Mono,051,14174,1237,1247,17,1264,3
2021-04-08,Monterey,053,433212,42729,42437,1810,44247,342
2021-04-08,Napa,055,140530,9595,9569,34,9603,80
2021-04-08,Nevada,057,99092,4435,4367,184,4551,69
2021-04-08,Orange,059,3164182,252414,250529,10955,261484,4797
2021-04-08,Placer,061,380077,22011,21258,1329,22587,277
2021-04-08,Plumas,063,18699,674,665,10,675,4
2021-04-08,Riverside,065,2383286,290740,283853,13791,297644,4296
2021-04-08,Sacramento,067,1510023,100618,99319,1512,100831,1561
2021-04-08,San Benito,069,59416,5936,5914,105,6019,62
2021-04-08,San Bernardino,071,2135413,290291,287190,8822,296012,4445
2021-04-08,San Diego,073,3302833,273399,272495,13850,286345,3592
2021-04-08,San Francisco,075,870044,35687,35657,1225,36882,494
2021-04-08,San Joaquin,077,732212,70586,69479,3305,72784,1279
2021-04-08,San Luis Obispo,079,281455,20808,20402,646,21048,252
2021-04-08,San Mateo,081,765935,41227,40749,437,41186,350
2021-04-08,Santa Barbara,083,443738,33640,33309,1167,34476,444
2021-04-08,Santa Clara,085,1922200,115549,115487,681,116168,1905
2021-04-08,Santa Cruz,087,273765,15938,15296,806,16102,203
2021-04-08,Shasta,089,179085,11493,11466,1391,12857,186
2021-04-08,Sierra,091,2930,55,51,12,63,0
2021-04-08,Siskiyou,093,43540,1591,1511,274,1785,7
2021-04-08,Solano,095,438530,31288,31120,430,31550,238
2021-04-08,Sonoma,097,501317,29348,29410,293,29703,310
2021-04-08,Stanislaus,099,539301,53840,53401,5677,59078,706
2021-04-08,Sutter,101,95872,9242,9195,82,9277,106
2021-04-08,Tehama,103,63373,4864,4802,527,5329,52
2021-04-08,Trinity,105,12862,481,324,85,409,3
2021-04-08,Tulare,107,460477,49482,48409,8714,57123,821
2021-04-08,Tuolumne,109,53932,3927,3986,37,4023,57
2021-04-08,Ventura,111,848112,80247,79626,2913,82539,986
2021-04-08,Yolo,113,214977,13472,13468,256,13724,198
2021-04-08,Yuba,115,75493,5787,5743,115,5858,43
2021-04-07,Alameda,001,1643700,84800,84130,1844,85974,1224
2021-04-07,Alpine,003,1148,85,85,0,85,0
2021-04-07,Amador,005,37829,3611,3590,33,3623,46
2021-04-07,Butte,007,227075,11799,11405,1693,13098,193
2021-04-07,Calaveras,009,45235,2032,2022,12,2034,50
2021-04-07,Colusa,011,21464,1900,1894,278,2172,14
2021-04-07,Contra Costa,013,1133247,66561,65619,1159,66778,775
2021-04-07,Del Norte,015,27424,1241,1198,11,1209,6
2021-04-07,El Dorado,017,186661,9612,9500,636,10136,106
2021-04-07,Fresno,019,978130,100567,99865,8384,108249,1627
2021-04-07,Glenn,021,27897,2367,2337,538,2875,17
2021-04-07,Humboldt,023,135768,3511,3484,25,3509,35
2021-04-07,Imperial,025,180216,27893,27704,2733,30437,713
2021-04-07,Inyo,027,18085,1388,1386,10,1396,36
2021-04-07,Kern,029,883053,95790,94456,10436,104892,1275
2021-04-07,Kings,031,150075,22846,22589,1044,23633,243
2021-04-07,Lake,033,64148,3392,3358,9,3367,43
2021-04-07,Lassen,035,31185,5156,5137,104,5241,1
2021-04-07,Los Angeles,037,10098052,1191571,1183862,40740,1224602,23372
2021-04-07,Madera,039,155013,16274,16090,908,16998,231
2021-04-07,Marin,041,260295,13767,13688,231,13919,225
2021-04-07,Mariposa,043,17540,398,391,6,397,5
2021-04-07,Mendocino,045,87422,3777,3691,72,3763,45
2021-04-07,Merced,047,269075,30130,30132,960,31092,430
2021-04-07,Modoc,049,8938,364,351,120,471,3
2021-04-07,Mono,051,14174,1237,1246,17,1263,3
2021-04-07,Monterey,053,433212,42711,42427,1809,44236,341
2021-04-07,Napa,055,140530,9581,9556,34,9590,80
2021-04-07,Nevada,057,99092,4429,4364,184,4548,69
2021-04-07,Orange,059,3164182,252290,250378,10932,261310,4778
2021-04-07,Placer,061,380077,21966,21227,1321,22548,276
2021-04-07,Plumas,063,18699,674,665,10,675,4
2021-04-07,Riverside,065,2383286,290620,283749,13781,297530,4285
2021-04-07,Sacramento,067,1510023,100450,99202,1506,100708,1544
2021-04-07,San Benito,069,59416,5931,5912,104,6016,62
2021-04-07,San Bernardino,071,2135413,290173,286978,8817,295795,4433
2021-04-07,San Diego,073,3302833,273174,272195,13821,286016,3588
2021-04-07,San Francisco,075,870044,35647,35618,1221,36839,493
2021-04-07,San Joaquin,077,732212,70517,69375,3300,72675,1278
2021-04-07,San Luis Obispo,079,281455,20782,20373,643,21016,252
2021-04-07,San Mateo,081,765935,41183,40693,437,41130,350
2021-04-07,Santa Barbara,083,443738,33614,33289,1164,34453,444
2021-04-07,Santa Clara,085,1922200,115417,115311,679,115990,1900
2021-04-07,Santa Cruz,087,273765,15927,15275,806,16081,203
2021-04-07,Shasta,089,179085,11481,11456,1386,12842,184
2021-04-07,Sierra,091,2930,55,51,12,63,0
2021-04-07,Siskiyou,093,43540,1585,1512,273,1785,7
2021-04-07,Solano,095,438530,31237,31097,429,31526,238
2021-04-07,Sonoma,097,501317,29330,29394,292,29686,310
2021-04-07,Stanislaus,099,539301,53771,53344,5667,59011,686
2021-04-07,Sutter,101,95872,9239,9188,82,9270,106
2021-04-07,Tehama,103,63373,4856,4802,525,5327,52
2021-04-07,Trinity,105,12862,481,322,85,407,3
2021-04-07,Tulare,107,460477,49467,48386,8703,57089,820
2021-04-07,Tuolumne,109,53932,3925,3982,37,4019,57
2021-04-07,Ventura,111,848112,80213,79595,2911,82506,986
2021-04-07,Yolo,113,214977,13457,13450,254,13704,198
2021-04-07,Yuba,115,75493,5783,5737,115,5852,43
2021-04-06,Alameda,001,1643700,84687,84091,1840,85931,1223
2021-04-06,Alpine,003,1148,85,85,0,85,0
2021-04-06,Amador,005,37829,3610,3587,33,3620,45
2021-04-06,Butte,007,227075,11784,11396,1691,13087,193
2021-04-06,Calaveras,009,45235,2029,2021,12,2033,50
2021-04-06,Colusa,011,21464,1898,1894,276,2170,14
2021-04-06,Contra Costa,013,1133247,66483,65575,1158,66733,774
2021-04-06,Del Norte,015,27424,1236,1197,11,1208,6
2021-04-06,El Dorado,017,186661,9582,9489,634,10123,106
2021-04-06,Fresno,019,978130,100503,99814,8378,108192,1626
2021-04-06,Glenn,021,27897,2366,2335,537,2872,17
2021-04-06,Humboldt,023,135768,3502,3477,25,3502,35
2021-04-06,Imperial,025,180216,27859,27661,2723,30384,713
2021-04-06,Inyo,027,18085,1388,1379,10,1389,36
2021-04-06,Kern,029,883053,95746,94422,10430,104852,1259
2021-04-06,Kings,031,150075,22840,22587,1044,23631,240
2021-04-06,Lake,033,64148,3389,3358,9,3367,43
2021-04-06,Lassen,035,31185,5154,5137,104,5241,1
2021-04-06,Los Angeles,037,10098052,1191060,1183499,40700,1224199,23323
2021-04-06,Madera,039,155013,16254,16085,903,16988,230
2021-04-06,Marin,041,260295,13758,13675,228,13903,224
2021-04-06,Mariposa,043,17540,398,390,6,396,5
2021-04-06,Mendocino,045,87422,3775,3686,72,3758,45
2021-04-06,Merced,047,269075,30101,30100,955,31055,430
2021-04-06,Modoc,049,8938,363,351,120,471,3
2021-04-06,Mono,051,14174,1237,1246,17,1263,3
2021-04-06,Monterey,053,433212,42702,42412,1808,44220,341
2021-04-06,Napa,055,140530,9562,9509,34,9543,78
2021-04-06,Nevada,057,99092,4419,4356,182,4538,69
2021-04-06,Orange,059,3164182,252181,250304,10918,261222,4771
2021-04-06,Placer,061,380077,21918,21184,1319,22503,276
2021-04-06,Plumas,063,18699,674,665,10,675,4
2021-04-06,Riverside,065,2383286,290439,283622,13770,297392,4264
2021-04-06,Sacramento,067,1510023,100241,99110,1498,100608,1537
2021-04-06,San Benito,069,59416,5922,5907,104,6011,62
2021-04-06,San Bernardino,071,2135413,290059,286792,8807,295599,4428
2021-04-06,San Diego,073,3302833,272912,271867,13793,285660,3585
2021-04-06,San Francisco,075,870044,35604,35572,1221,36793,488
2021-04-06,San Joaquin,077,732212,70434,69316,3288,72604,1278
2021-04-06,San Luis Obispo,079,281455,20760,20350,640,20990,252
2021-04-06,San Mateo,081,765935,41135,40649,436,41085,350
2021-04-06,Santa Barbara,083,443738,33596,33257,1163,34420,443
2021-04-06,Santa Clara,085,1922200,115246,115184,678,115862,1900
2021-04-06,Santa Cruz,087,273765,15917,15252,806,16058,203
2021-04-06,Shasta,089,179085,11460,11443,1384,12827,184
2021-04-06,Sierra,091,2930,55,51,12,63,0
2021-04-06,Siskiyou,093,43540,1581,1510,272,1782,7
2021-04-06,Solano,095,438530,31190,31078,428,31506,237
2021-04-06,Sonoma,097,501317,29305,29386,290,29676,311
2021-04-06,Stanislaus,099,539301,53714,53304,5661,58965,686
2021-04-06,Sutter,101,95872,9229,9179,82,9261,106
2021-04-06,Tehama,103,63373,4847,4798,525,5323,52
2021-04-06,Trinity,105,12862,481,321,85,406,3
2021-04-06,Tulare,107,460477,49424,48372,8699,57071,819
2021-04-06,Tuolumne,109,53932,3925,3981,37,4018,57
2021-04-06,Ventura,111,848112,80176,79556,2909,82465,983
2021-04-06,Yolo,113,214977,13444,13443,253,13696,198
2021-04-06,Yuba,115,75493,5779,5733,114,5847,43
2021-04-05,Alameda,001,1643700,84571,84007,1836,85843,1219
2021-04-05,Alpine,003,1148,85,85,0,85,0
2021-04-05,Amador,005,37829,3607,3584,33,3617,45
2021-04-05,Butte,007,227075,11769,11384,1690,13074,193
2021-04-05,Calaveras,009,45235,2027,2019,12,2031,50
2021-04-05,Colusa,011,21464,1898,1894,275,2169,14
2021-04-05,Contra Costa,013,1133247,66417,65457,1156,66613,774
2021-04-05,Del Norte,015,27424,1234,1189,11,1200,6
2021-04-05,El Dorado,017,186661,9567,9463,634,10097,106
2021-04-05,Fresno,019,978130,100415,99755,8370,108125,1622
2021-04-05,Glenn,021,27897,2364,2335,537,2872,17
2021-04-05,Humboldt,023,135768,3493,3475,25,3500,35
2021-04-05,Imperial,025,180216,27827,27604,2717,30321,710
2021-04-05,Inyo,027,18085,1385,1377,10,1387,36
2021-04-05,Kern,029,883053,95691,94401,10405,104806,1249
2021-04-05,Kings,031,150075,22836,22580,1044,23624,239
2021-04-05,Lake,033,64148,3381,3359,9,3368,43
2021-04-05,Lassen,035,31185,5154,5138,103,5241,1
2021-04-05,Los Angeles,037,10098052,1190526,1183200,40649,1223849,23302
2021-04-05,Madera,039,155013,16240,16065,902,16967,230
2021-04-05,Marin,041,260295,13744,13666,224,13890,221
2021-04-05,Mariposa,043,17540,398,390,6,396,5
2021-04-05,Mendocino,045,87422,3773,3687,72,3759,45
2021-04-05,Merced,047,269075,30075,30068,953,31021,427
2021-04-05,Modoc,049,8938,361,346,120,466,3
2021-04-05,Mono,051,14174,1237,1246,17,1263,3
2021-04-05,Monterey,053,433212,42689,42396,1804,44200,341
2021-04-05,Napa,055,140530,9539,9492,34,9526,78
2021-04-05,Nevada,057,99092,4408,4346,182,4528,69
2021-04-05,Orange,059,3164182,252066,250177,10894,261071,4759
2021-04-05,Placer,061,380077,21872,21133,1312,22445,276
2021-04-05,Plumas,063,18699,674,666,10,676,4
2021-04-05,Riverside,065,2383286,290302,283549,13758,297307,4237
2021-04-05,Sacramento,067,1510023,100079,98908,1489,100397,1533
2021-04-05,San Benito,069,59416,5916,5904,104,6008,61
2021-04-05,San Bernardino,071,2135413,289949,286597,8804,295401,4425
2021-04-05,San Diego,073,3302833,272663,271655,13752,285407,3583
2021-04-05,San Francisco,075,870044,35573,35538,1221,36759,488
2021-04-05,San Joaquin,077,732212,70345,69214,3279,72493,1268
2021-04-05,San Luis Obispo,079,281455,20723,20333,640,20973,252
2021-04-05,San Mateo,081,765935,41091,40609,435,41044,350
2021-04-05,Santa Barbara,083,443738,33561,33235,1163,34398,443
2021-04-05,Santa Clara,085,1922200,115079,115091,675,115766,1893
2021-04-05,Santa Cruz,087,273765,15910,15228,806,16034,201
2021-04-05,Shasta,089,179085,11439,11435,1381,12816,184
2021-04-05,Sierra,091,2930,55,50,12,62,0
2021-04-05,Siskiyou,093,43540,1578,1509,270,1779,7
2021-04-05,Solano,095,438530,31149,31026,426,31452,237
2021-04-05,Sonoma,097,501317,29273,29361,288,29649,311
2021-04-05,Stanislaus,099,539301,53634,53238,5659,58897,686
2021-04-05,Sutter,101,95872,9222,9169,82,9251,106
2021-04-05,Tehama,103,63373,4841,4794,525,5319,52
2021-04-05,Trinity,105,12862,480,321,85,406,3
2021-04-05,Tulare,107,460477,49412,48356,8692,57048,818
2021-04-05,Tuolumne,109,53932,3924,3980,37,4017,57
2021-04-05,Ventura,111,848112,80145,79549,2906,82455,983
2021-04-05,Yolo,113,214977,13430,13427,252,13679,198
2021-04-05,Yuba,115,75493,5774,5728,113,5841,43
2021-04-04,Alameda,001,1643700,84453,83951,1832,85783,1219
2021-04-04,Alpine,003,1148,85,85,0,85,0
2021-04-04,Amador,005,37829,3601,3582,33,3615,45
2021-04-04,Butte,007,227075,11754,11375,1689,13064,193
2021-04-04,Calaveras,009,45235,2023,2020,12,2032,50
2021-04-04,Colusa,011,21464,1897,1893,275,2168,14
2021-04-04,Contra Costa,013,1133247,66311,65408,1151,66559,774
2021-04-04,Del Norte,015,27424,1226,1186,11,1197,6
2021-04-04,El Dorado,017,186661,9548,9455,630,10085,106
2021-04-04,Fresno,019,978130,100341,99702,8357,108059,1622
2021-04-04,Glenn,021,27897,2361,2335,536,2871,17
2021-04-04,Humboldt,023,135768,3482,3472,25,3497,35
2021-04-04,Imperial,025,180216,27771,27588,2713,30301,710
2021-04-04,Inyo,027,18085,1381,1377,10,1387,36
2021-04-04,Kern,029,883053,95647,94388,10384,104772,1247
2021-04-04,Kings,031,150075,22834,22580,1043,23623,239
2021-04-04,Lake,033,64148,3375,3355,8,3363,43
2021-04-04,Lassen,035,31185,5152,5138,103,5241,1
2021-04-04,Los Angeles,037,10098052,1189983,1182872,40604,1223476,23301
2021-04-04,Madera,039,155013,16214,16052,898,16950,230
2021-04-04,Marin,041,260295,13731,13663,223,13886,221
2021-04-04,Mariposa,043,17540,398,390,6,396,5
2021-04-04,Mendocino,045,87422,3770,3684,72,3756,45
2021-04-04,Merced,047,269075,30032,30048,950,30998,427
2021-04-04,Modoc,049,8938,361,346,120,466,3
2021-04-04,Mono,051,14174,1236,1245,17,1262,3
2021-04-04,Monterey,053,433212,42672,42391,1803,44194,341
2021-04-04,Napa,055,140530,9527,9486,34,9520,78
2021-04-04,Nevada,057,99092,4396,4337,182,4519,69
2021-04-04,Orange,059,3164182,251932,250117,10878,260995,4759
2021-04-04,Placer,061,380077,21827,21104,1294,22398,276
2021-04-04,Plumas,063,18699,674,666,10,676,4
2021-04-04,Riverside,065,2383286,290176,283537,13754,297291,4237
2021-04-04,Sacramento,067,1510023,99880,98821,1479,100300,1531
2021-04-04,San Benito,069,59416,5906,5901,100,6001,61
2021-04-04,San Bernardino,071,2135413,289809,286561,8796,295357,4423
2021-04-04,San Diego,073,3302833,272351,271528,13711,285239,3583
2021-04-04,San Francisco,075,870044,35519,35525,1218,36743,488
2021-04-04,San Joaquin,077,732212,70244,69147,3267,72414,1268
2021-04-04,San Luis Obispo,079,281455,20691,20328,632,20960,252
2021-04-04,San Mateo,081,765935,41048,40587,432,41019,350
2021-04-04,Santa Barbara,083,443738,33525,33213,1163,34376,443
2021-04-04,Santa Clara,085,1922200,114913,114976,668,115644,1893
2021-04-04,Santa Cruz,087,273765,15901,15219,806,16025,201
2021-04-04,Shasta,089,179085,11413,11433,1380,12813,184
2021-04-04,Sierra,091,2930,55,50,12,62,0
2021-04-04,Siskiyou,093,43540,1575,1509,266,1775,7
2021-04-04,Solano,095,438530,31102,31002,424,31426,237
2021-04-04,Sonoma,097,501317,29241,29340,286,29626,311
2021-04-04,Stanislaus,099,539301,53541,53181,5651,58832,686
2021-04-04,Sutter,101,95872,9215,9164,82,9246,106
2021-04-04,Tehama,103,63373,4829,4792,524,5316,52
2021-04-04,Trinity,105,12862,478,321,85,406,3
2021-04-04,Tulare,107,460477,49396,48343,8684,57027,818
2021-04-04,Tuolumne,109,53932,3916,3980,37,4017,57
2021-04-04,Ventura,111,848112,80102,79526,2904,82430,983
2021-04-04,Yolo,113,214977,13409,13425,251,13676,198
2021-04-04,Yuba,115,75493,5767,5722,113,5835,43
2021-04-03,Alameda,001,1643700,84386,83861,1830,85691,1218
2021-04-03,Alpine,003,1148,85,85,0,85,0
2021-04-03,Amador,005,37829,3598,3577,33,3610,45
2021-04-03,Butte,007,227075,11750,11359,1685,13044,193
2021-04-03,Calaveras,009,45235,2020,2019,12,2031,50
2021-04-03,Colusa,011,21464,1897,1891,275,2166,14
2021-04-03,Contra Costa,013,1133247,66239,65338,1151,66489,774
2021-04-03,Del Norte,015,27424,1221,1183,11,1194,6
2021-04-03,El Dorado,017,186661,9539,9448,629,10077,106
2021-04-03,Fresno,019,978130,100284,99602,8351,107953,1622
2021-04-03,Glenn,021,27897,2361,2334,535,2869,17
2021-04-03,Humboldt,023,135768,3480,3467,25,3492,35
2021-04-03,Imperial,025,180216,27755,27572,2709,30281,710
2021-04-03,Inyo,027,18085,1380,1376,10,1386,36
2021-04-03,Kern,029,883053,95621,94369,10368,104737,1243
2021-04-03,Kings,031,150075,22832,22580,1043,23623,239
2021-04-03,Lake,033,64148,3374,3350,8,3358,43
2021-04-03,Lassen,035,31185,5151,5136,103,5239,1
2021-04-03,Los Angeles,037,10098052,1189682,1182402,40586,1222988,23301
2021-04-03,Madera,039,155013,16205,16051,896,16947,230
2021-04-03,Marin,041,260295,13723,13658,222,13880,221
2021-04-03,Mariposa,043,17540,398,390,5,395,5
2021-04-03,Mendocino,045,87422,3769,3684,72,3756,45
2021-04-03,Merced,047,269075,30017,30031,950,30981,427
2021-04-03,Modoc,049,8938,361,346,120,466,3
2021-04-03,Mono,051,14174,1236,1245,17,1262,3
2021-04-03,Monterey,053,433212,42659,42376,1801,44177,341
2021-04-03,Napa,055,140530,9518,9473,34,9507,78
2021-04-03,Nevada,057,99092,4392,4323,182,4505,69
2021-04-03,Orange,059,3164182,251852,249982,10860,260842,4755
2021-04-03,Placer,061,380077,21796,21060,1290,22350,276
2021-04-03,Plumas,063,18699,674,666,10,676,4
2021-04-03,Riverside,065,2383286,290098,283423,13751,297174,4237
2021-04-03,Sacramento,067,1510023,99772,98660,1473,100133,1531
2021-04-03,San Benito,069,59416,5903,5893,99,5992,61
2021-04-03,San Bernardino,071,2135413,289744,286473,8790,295263,4422
2021-04-03,San Diego,073,3302833,272182,271335,13694,285029,3571
2021-04-03,San Francisco,075,870044,35500,35488,1216,36704,489
2021-04-03,San Joaquin,077,732212,70203,69100,3251,72351,1268
2021-04-03,San Luis Obispo,079,281455,20672,20301,632,20933,252
2021-04-03,San Mateo,081,765935,41023,40560,432,40992,350
2021-04-03,Santa Barbara,083,443738,33499,33172,1162,34334,443
2021-04-03,Santa Clara,085,1922200,114805,114865,666,115531,1893
2021-04-03,Santa Cruz,087,273765,15894,15205,806,16011,201
2021-04-03,Shasta,089,179085,11405,11418,1380,12798,184
2021-04-03,Sierra,091,2930,55,50,12,62,0
2021-04-03,Siskiyou,093,43540,1574,1509,266,1775,7
2021-04-03,Solano,095,438530,31081,30970,421,31391,237
2021-04-03,Sonoma,097,501317,29225,29315,285,29600,311
2021-04-03,Stanislaus,099,539301,53506,53137,5645,58782,686
2021-04-03,Sutter,101,95872,9209,9158,82,9240,106
2021-04-03,Tehama,103,63373,4822,4788,524,5312,52
2021-04-03,Trinity,105,12862,478,321,85,406,3
2021-04-03,Tulare,107,460477,49386,48327,8680,57007,818
2021-04-03,Tuolumne,109,53932,3916,3980,37,4017,57
2021-04-03,Ventura,111,848112,80081,79489,2902,82391,983
2021-04-03,Yolo,113,214977,13403,13414,251,13665,198
2021-04-03,Yuba,115,75493,5761,5716,113,5829,43
2021-04-02,Alameda,001,1643700,84312,83776,1827,85603,1217
2021-04-02,Alpine,003,1148,85,85,0,85,0
2021-04-02,Amador,005,37829,3594,3573,32,3605,45
2021-04-02,Butte,007,227075,11741,11350,1685,13035,193
2021-04-02,Calaveras,009,45235,2016,2010,12,2022,50
2021-04-02,Colusa,011,21464,1897,1891,275,2166,14
2021-04-02,Contra Costa,013,1133247,66175,65299,1150,66449,774
2021-04-02,Del Norte,015,27424,1218,1174,11,1185,6
2021-04-02,El Dorado,017,186661,9526,9437,626,10063,106
2021-04-02,Fresno,019,978130,100230,99551,8340,107891,1620
2021-04-02,Glenn,021,27897,2361,2331,535,2866,17
2021-04-02,Humboldt,023,135768,3476,3465,25,3490,35
2021-04-02,Imperial,025,180216,27742,27553,2702,30255,710
2021-04-02,Inyo,027,18085,1380,1377,10,1387,36
2021-04-02,Kern,029,883053,95603,94348,10365,104713,1233
2021-04-02,Kings,031,150075,22832,22571,1040,23611,239
2021-04-02,Lake,033,64148,3372,3348,8,3356,43
2021-04-02,Lassen,035,31185,5151,5134,103,5237,1
2021-04-02,Los Angeles,037,10098052,1189373,1181682,40563,1222245,23264
2021-04-02,Madera,039,155013,16196,16036,895,16931,230
2021-04-02,Marin,041,260295,13715,13649,222,13871,221
2021-04-02,Mariposa,043,17540,396,390,5,395,5
2021-04-02,Mendocino,045,87422,3766,3682,72,3754,45
2021-04-02,Merced,047,269075,29993,29998,950,30948,426
2021-04-02,Modoc,049,8938,358,346,120,466,3
2021-04-02,Mono,051,14174,1236,1246,17,1263,3
2021-04-02,Monterey,053,433212,42649,42359,1798,44157,341
2021-04-02,Napa,055,140530,9503,9453,34,9487,78
2021-04-02,Nevada,057,99092,4388,4323,182,4505,69
2021-04-02,Orange,059,3164182,251756,249891,10847,260738,4748
2021-04-02,Placer,061,380077,21760,21035,1284,22319,275
2021-04-02,Plumas,063,18699,674,666,10,676,4
2021-04-02,Riverside,065,2383286,290012,283328,13742,297070,4213
2021-04-02,Sacramento,067,1510023,99665,98648,1466,100114,1527
2021-04-02,San Benito,069,59416,5901,5888,97,5985,61
2021-04-02,San Bernardino,071,2135413,289671,286308,8786,295094,4417
2021-04-02,San Diego,073,3302833,271996,271036,13668,284704,3568
2021-04-02,San Francisco,075,870044,35465,35451,1214,36665,488
2021-04-02,San Joaquin,077,732212,70138,68996,3236,72232,1268
2021-04-02,San Luis Obispo,079,281455,20655,20271,631,20902,252
2021-04-02,San Mateo,081,765935,40981,40514,432,40946,350
2021-04-02,Santa Barbara,083,443738,33471,33145,1162,34307,443
2021-04-02,Santa Clara,085,1922200,114694,114777,664,115441,1882
2021-04-02,Santa Cruz,087,273765,15886,15216,806,16022,202
2021-04-02,Shasta,089,179085,11400,11377,1372,12749,181
2021-04-02,Sierra,091,2930,55,50,12,62,0
2021-04-02,Siskiyou,093,43540,1574,1508,265,1773,7
2021-04-02,Solano,095,438530,31052,30951,418,31369,237
2021-04-02,Sonoma,097,501317,29204,29288,284,29572,311
2021-04-02,Stanislaus,099,539301,53461,53073,5639,58712,687
2021-04-02,Sutter,101,95872,9201,9131,82,9213,106
2021-04-02,Tehama,103,63373,4815,4775,523,5298,52
2021-04-02,Trinity,105,12862,478,320,85,405,3
2021-04-02,Tulare,107,460477,49380,48306,8674,56980,818
2021-04-02,Tuolumne,109,53932,3913,3980,37,4017,57
2021-04-02,Ventura,111,848112,80053,79434,2900,82334,982
2021-04-02,Yolo,113,214977,13393,13381,251,13632,197
2021-04-02,Yuba,115,75493,5757,5709,113,5822,44
2021-04-01,Alameda,001,1643700,84233,83574,1822,85396,1216
2021-04-01,Alpine,003,1148,85,85,0,85,0
2021-04-01,Amador,005,37829,3590,3558,32,3590,45
2021-04-01,Butte,007,227075,11723,11328,1683,13011,193
2021-04-01,Calaveras,009,45235,2012,2006,12,2018,50
2021-04-01,Colusa,011,21464,1894,1890,275,2165,14
2021-04-01,Contra Costa,013,1133247,66115,65176,1148,66324,771
2021-04-01,Del Norte,015,27424,1213,1138,11,1149,6
2021-04-01,El Dorado,017,186661,9517,9393,622,10015,106
2021-04-01,Fresno,019,978130,100176,99317,8332,107649,1616
2021-04-01,Glenn,021,27897,2361,2322,534,2856,17
2021-04-01,Humboldt,023,135768,3472,3464,25,3489,35
2021-04-01,Imperial,025,180216,27712,27520,2696,30216,710
2021-04-01,Inyo,027,18085,1379,1374,10,1384,36
2021-04-01,Kern,029,883053,95567,94244,10353,104597,1233
2021-04-01,Kings,031,150075,22825,22560,1039,23599,239
2021-04-01,Lake,033,64148,3367,3337,8,3345,43
2021-04-01,Lassen,035,31185,5150,5132,103,5235,1
2021-04-01,Los Angeles,037,10098052,1188884,1181101,40537,1221638,23220
2021-04-01,Madera,039,155013,16180,16023,895,16918,230
2021-04-01,Marin,041,260295,13705,13635,222,13857,221
2021-04-01,Mariposa,043,17540,394,389,5,394,5
2021-04-01,Mendocino,045,87422,3766,3680,72,3752,45
2021-04-01,Merced,047,269075,29959,29820,950,30770,425
2021-04-01,Modoc,049,8938,357,346,120,466,3
2021-04-01,Mono,051,14174,1236,1245,17,1262,3
2021-04-01,Monterey,053,433212,42641,42324,1796,44120,339
2021-04-01,Napa,055,140530,9491,9410,34,9444,78
2021-04-01,Nevada,057,99092,4378,4288,181,4469,68
2021-04-01,Orange,059,3164182,251636,249617,10830,260447,4742
2021-04-01,Placer,061,380077,21721,20909,1272,22181,274
2021-04-01,Plumas,063,18699,674,664,10,674,4
2021-04-01,Riverside,065,2383286,289907,283128,13739,296867,4193
2021-04-01,Sacramento,067,1510023,99521,97952,1452,99404,1521
2021-04-01,San Benito,069,59416,5893,5878,96,5974,61
2021-04-01,San Bernardino,071,2135413,289554,286086,8777,294863,4404
2021-04-01,San Diego,073,3302833,271772,270540,13638,284178,3555
2021-04-01,San Francisco,075,870044,35444,35386,1211,36597,488
2021-04-01,San Joaquin,077,732212,70056,68802,3228,72030,1262
2021-04-01,San Luis Obispo,079,281455,20626,20235,630,20865,252
2021-04-01,San Mateo,081,765935,40940,40454,432,40886,350
2021-04-01,Santa Barbara,083,443738,33425,33096,1157,34253,443
2021-04-01,Santa Clara,085,1922200,114581,114606,663,115269,1874
2021-04-01,Santa Cruz,087,273765,15871,15271,806,16077,202
2021-04-01,Shasta,089,179085,11385,11355,1367,12722,181
2021-04-01,Sierra,091,2930,55,50,12,62,0
2021-04-01,Siskiyou,093,43540,1572,1507,264,1771,7
2021-04-01,Solano,095,438530,31019,30850,415,31265,237
2021-04-01,Sonoma,097,501317,29173,29241,277,29518,311
2021-04-01,Stanislaus,099,539301,53398,52825,5633,58458,687
2021-04-01,Sutter,101,95872,9189,9105,82,9187,106
2021-04-01,Tehama,103,63373,4809,4764,520,5284,52
2021-04-01,Trinity,105,12862,478,319,85,404,3
2021-04-01,Tulare,107,460477,49357,48279,8664,56943,817
2021-04-01,Tuolumne,109,53932,3911,3978,37,4015,57
2021-04-01,Ventura,111,848112,80029,79369,2899,82268,977
2021-04-01,Yolo,113,214977,13380,13342,251,13593,197
2021-04-01,Yuba,115,75493,5752,5694,113,5807,44
2021-03-31,Alameda,001,1643700,84151,83475,1817,85292,1215
2021-03-31,Alpine,003,1148,85,85,0,85,0
2021-03-31,Amador,005,37829,3587,3556,32,3588,45
2021-03-31,Butte,007,227075,11713,11321,1680,13001,193
2021-03-31,Calaveras,009,45235,2010,2005,12,2017,50
2021-03-31,Colusa,011,21464,1894,1890,275,2165,14
2021-03-31,Contra Costa,013,1133247,66030,65109,1147,66256,769
2021-03-31,Del Norte,015,27424,1204,1129,11,1140,6
2021-03-31,El Dorado,017,186661,9500,9390,622,10012,106
2021-03-31,Fresno,019,978130,100083,99240,8315,107555,1616
2021-03-31,Glenn,021,27897,2357,2318,532,2850,17
2021-03-31,Humboldt,023,135768,3466,3460,25,3485,35
2021-03-31,Imperial,025,180216,27692,27506,2693,30199,710
2021-03-31,Inyo,027,18085,1376,1373,9,1382,35
2021-03-31,Kern,029,883053,95524,94205,10343,104548,1229
2021-03-31,Kings,031,150075,22822,22540,1039,23579,239
2021-03-31,Lake,033,64148,3363,3332,8,3340,43
2021-03-31,Lassen,035,31185,5146,5132,103,5235,1
2021-03-31,Los Angeles,037,10098052,1188418,1180538,40497,1221035,23171
2021-03-31,Madera,039,155013,16166,16015,894,16909,229
2021-03-31,Marin,041,260295,13694,13624,222,13846,221
2021-03-31,Mariposa,043,17540,394,389,5,394,5
2021-03-31,Mendocino,045,87422,3760,3675,72,3747,45
2021-03-31,Merced,047,269075,29930,29780,950,30730,423
2021-03-31,Modoc,049,8938,357,346,120,466,3
2021-03-31,Mono,051,14174,1236,1245,17,1262,3
2021-03-31,Monterey,053,433212,42624,42309,1794,44103,338
2021-03-31,Napa,055,140530,9473,9401,34,9435,78
2021-03-31,Nevada,057,99092,4372,4283,181,4464,68
2021-03-31,Orange,059,3164182,251525,249518,10815,260333,4731
2021-03-31,Placer,061,380077,21671,20885,1265,22150,271
2021-03-31,Plumas,063,18699,673,663,10,673,4
2021-03-31,Riverside,065,2383286,289805,283006,13729,296735,4171
2021-03-31,Sacramento,067,1510023,99346,97760,1445,99205,1519
2021-03-31,San Benito,069,59416,5883,5875,96,5971,61
2021-03-31,San Bernardino,071,2135413,289460,285916,8774,294690,4356
2021-03-31,San Diego,073,3302833,271541,270288,13603,283891,3555
2021-03-31,San Francisco,075,870044,35399,35347,1210,36557,474
2021-03-31,San Joaquin,077,732212,69967,68685,3212,71897,1259
2021-03-31,San Luis Obispo,079,281455,20605,20215,629,20844,251
2021-03-31,San Mateo,081,765935,40910,40423,432,40855,350
2021-03-31,Santa Barbara,083,443738,33393,33052,1155,34207,443
2021-03-31,Santa Clara,085,1922200,114454,114499,663,115162,1874
2021-03-31,Santa Cruz,087,273765,15858,15295,805,16100,201
2021-03-31,Shasta,089,179085,11373,11327,1359,12686,179
2021-03-31,Sierra,091,2930,55,50,12,62,0
2021-03-31,Siskiyou,093,43540,1571,1505,264,1769,7
2021-03-31,Solano,095,438530,30973,30824,414,31238,235
2021-03-31,Sonoma,097,501317,29146,29216,277,29493,311
2021-03-31,Stanislaus,099,539301,53330,52782,5621,58403,687
2021-03-31,Sutter,101,95872,9178,9111,82,9193,106
2021-03-31,Tehama,103,63373,4804,4762,517,5279,52
2021-03-31,Trinity,105,12862,478,319,85,404,3
2021-03-31,Tulare,107,460477,49337,48261,8648,56909,816
2021-03-31,Tuolumne,109,53932,3910,3976,37,4013,57
2021-03-31,Ventura,111,848112,79997,79326,2895,82221,969
2021-03-31,Yolo,113,214977,13363,13359,250,13609,197
2021-03-31,Yuba,115,75493,5745,5686,113,5799,44
2021-03-30,Alameda,001,1643700,84051,83395,1814,85209,1211
2021-03-30,Alpine,003,1148,85,85,0,85,0
2021-03-30,Amador,005,37829,3584,3551,32,3583,45
2021-03-30,Butte,007,227075,11701,11296,1677,12973,193
2021-03-30,Calaveras,009,45235,2004,1997,12,2009,50
2021-03-30,Colusa,011,21464,1893,1890,274,2164,14
2021-03-30,Contra Costa,013,1133247,65941,65041,1145,66186,767
2021-03-30,Del Norte,015,27424,1196,1118,10,1128,6
2021-03-30,El Dorado,017,186661,9481,9381,619,10000,105
2021-03-30,Fresno,019,978130,100018,99156,8302,107458,1609
2021-03-30,Glenn,021,27897,2357,2310,531,2841,17
2021-03-30,Humboldt,023,135768,3464,3461,25,3486,35
2021-03-30,Imperial,025,180216,27663,27471,2691,30162,706
2021-03-30,Inyo,027,18085,1376,1374,9,1383,35
2021-03-30,Kern,029,883053,95482,94151,10334,104485,1221
2021-03-30,Kings,031,150075,22818,22530,1037,23567,238
2021-03-30,Lake,033,64148,3357,3330,8,3338,43
2021-03-30,Lassen,035,31185,5146,5132,103,5235,1
2021-03-30,Los Angeles,037,10098052,1187925,1180044,40475,1220519,23136
2021-03-30,Madera,039,155013,16156,16003,890,16893,229
2021-03-30,Marin,041,260295,13685,13611,214,13825,221
2021-03-30,Mariposa,043,17540,394,388,5,393,5
2021-03-30,Mendocino,045,87422,3758,3670,72,3742,45
2021-03-30,Merced,047,269075,29894,29731,950,30681,423
2021-03-30,Modoc,049,8938,356,346,120,466,3
2021-03-30,Mono,051,14174,1235,1245,17,1262,3
2021-03-30,Monterey,053,433212,42598,42308,1791,44099,338
2021-03-30,Napa,055,140530,9458,9391,34,9425,78
2021-03-30,Nevada,057,99092,4360,4266,180,4446,68
2021-03-30,Orange,059,3164182,251396,249412,10788,260200,4727
2021-03-30,Placer,061,380077,21631,20866,1259,22125,271
2021-03-30,Plumas,063,18699,673,661,10,671,4
2021-03-30,Riverside,065,2383286,289680,282930,13720,296650,4154
2021-03-30,Sacramento,067,1510023,99209,97718,1441,99159,1516
2021-03-30,San Benito,069,59416,5877,5870,96,5966,61
2021-03-30,San Bernardino,071,2135413,289352,285758,8765,294523,4343
2021-03-30,San Diego,073,3302833,271303,269998,13565,283563,3555
2021-03-30,San Francisco,075,870044,35349,35325,1209,36534,474
2021-03-30,San Joaquin,077,732212,69879,68613,3202,71815,1232
2021-03-30,San Luis Obispo,079,281455,20585,20194,629,20823,251
2021-03-30,San Mateo,081,765935,40865,40377,432,40809,349
2021-03-30,Santa Barbara,083,443738,33367,33016,1155,34171,441
2021-03-30,Santa Clara,085,1922200,114331,114413,662,115075,1873
2021-03-30,Santa Cruz,087,273765,15852,15278,805,16083,201
2021-03-30,Shasta,089,179085,11365,11316,1358,12674,184
2021-03-30,Sierra,091,2930,55,50,12,62,0
2021-03-30,Siskiyou,093,43540,1570,1501,264,1765,7
2021-03-30,Solano,095,438530,30943,30802,413,31215,232
2021-03-30,Sonoma,097,501317,29114,29198,277,29475,311
2021-03-30,Stanislaus,099,539301,53252,52690,5613,58303,677
2021-03-30,Sutter,101,95872,9174,9107,81,9188,106
2021-03-30,Tehama,103,63373,4795,4748,516,5264,52
2021-03-30,Trinity,105,12862,478,316,85,401,3
2021-03-30,Tulare,107,460477,49322,48249,8639,56888,815
2021-03-30,Tuolumne,109,53932,3905,3972,37,4009,57
2021-03-30,Ventura,111,848112,79953,79282,2892,82174,958
2021-03-30,Yolo,113,214977,13351,13353,250,13603,195
2021-03-30,Yuba,115,75493,5734,5679,107,5786,42
2021-03-29,Alameda,001,1643700,83950,83338,1812,85150,1211
2021-03-29,Alpine,003,1148,85,85,0,85,0
2021-03-29,Amador,005,37829,3578,3549,32,3581,45
2021-03-29,Butte,007,227075,11692,11291,1674,12965,191
2021-03-29,Calaveras,009,45235,2003,1998,12,2010,50
2021-03-29,Colusa,011,21464,1893,1889,273,2162,14
2021-03-29,Contra Costa,013,1133247,65872,64971,1144,66115,767
2021-03-29,Del Norte,015,27424,1191,1116,9,1125,6
2021-03-29,El Dorado,017,186661,9461,9374,613,9987,105
2021-03-29,Fresno,019,978130,99935,99085,8287,107372,1606
2021-03-29,Glenn,021,27897,2350,2310,531,2841,17
2021-03-29,Humboldt,023,135768,3459,3459,25,3484,34
2021-03-29,Imperial,025,180216,27642,27442,2688,30130,704
2021-03-29,Inyo,027,18085,1376,1372,9,1381,35
2021-03-29,Kern,029,883053,95435,94098,10314,104412,1220
2021-03-29,Kings,031,150075,22806,22522,1036,23558,238
2021-03-29,Lake,033,64148,3354,3325,8,3333,43
2021-03-29,Lassen,035,31185,5146,5131,103,5234,1
2021-03-29,Los Angeles,037,10098052,1187430,1179736,40435,1220171,23108
2021-03-29,Madera,039,155013,16136,15987,888,16875,210
2021-03-29,Marin,041,260295,13673,13600,210,13810,220
2021-03-29,Mariposa,043,17540,393,388,5,393,5
2021-03-29,Mendocino,045,87422,3755,3667,72,3739,45
2021-03-29,Merced,047,269075,29870,29699,950,30649,422
2021-03-29,Modoc,049,8938,355,344,120,464,3
2021-03-29,Mono,051,14174,1234,1243,17,1260,3
2021-03-29,Monterey,053,433212,42582,42305,1786,44091,337
2021-03-29,Napa,055,140530,9442,9379,34,9413,78
2021-03-29,Nevada,057,99092,4353,4258,180,4438,68
2021-03-29,Orange,059,3164182,251284,249295,10776,260071,4713
2021-03-29,Placer,061,380077,21596,20827,1252,22079,267
2021-03-29,Plumas,063,18699,672,660,10,670,4
2021-03-29,Riverside,065,2383286,289577,282867,13719,296586,4133
2021-03-29,Sacramento,067,1510023,99015,97577,1433,99010,1514
2021-03-29,San Benito,069,59416,5870,5865,96,5961,61
2021-03-29,San Bernardino,071,2135413,289255,285615,8761,294376,4335
2021-03-29,San Diego,073,3302833,271037,269771,13539,283310,3547
2021-03-29,San Francisco,075,870044,35314,35291,1206,36497,474
2021-03-29,San Joaquin,077,732212,69793,68537,3189,71726,1211
2021-03-29,San Luis Obispo,079,281455,20550,20176,628,20804,250
2021-03-29,San Mateo,081,765935,40823,40357,431,40788,348
2021-03-29,Santa Barbara,083,443738,33333,32983,1154,34137,439
2021-03-29,Santa Clara,085,1922200,114223,114335,657,114992,1871
2021-03-29,Santa Cruz,087,273765,15841,15249,804,16053,201
2021-03-29,Shasta,089,179085,11347,11313,1356,12669,183
2021-03-29,Sierra,091,2930,55,50,12,62,0
2021-03-29,Siskiyou,093,43540,1568,1497,263,1760,6
2021-03-29,Solano,095,438530,30904,30762,411,31173,232
2021-03-29,Sonoma,097,501317,29091,29184,274,29458,310
2021-03-29,Stanislaus,099,539301,53168,52614,5605,58219,677
2021-03-29,Sutter,101,95872,9167,9105,81,9186,106
2021-03-29,Tehama,103,63373,4787,4742,515,5257,52
2021-03-29,Trinity,105,12862,478,314,85,399,3
2021-03-29,Tulare,107,460477,49294,48226,8628,56854,815
2021-03-29,Tuolumne,109,53932,3903,3969,37,4006,57
2021-03-29,Ventura,111,848112,79911,79252,2892,82144,956
2021-03-29,Yolo,113,214977,13333,13346,250,13596,195
2021-03-29,Yuba,115,75493,5727,5671,106,5777,42
2021-03-28,Alameda,001,1643700,83829,83239,1810,85049,1212
2021-03-28,Alpine,003,1148,85,85,0,85,0
2021-03-28,Amador,005,37829,3574,3541,32,3573,45
2021-03-28,Butte,007,227075,11679,11285,1672,12957,191
2021-03-28,Calaveras,009,45235,2001,1995,12,2007,50
2021-03-28,Colusa,011,21464,1892,1889,273,2162,14
2021-03-28,Contra Costa,013,1133247,65798,64878,1140,66018,767
2021-03-28,Del Norte,015,27424,1184,1107,7,1114,6
2021-03-28,El Dorado,017,186661,9446,9371,611,9982,105
2021-03-28,Fresno,019,978130,99853,99004,8275,107279,1606
2021-03-28,Glenn,021,27897,2346,2309,529,2838,17
2021-03-28,Humboldt,023,135768,3456,3452,24,3476,34
2021-03-28,Imperial,025,180216,27615,27426,2685,30111,704
2021-03-28,Inyo,027,18085,1375,1372,9,1381,35
2021-03-28,Kern,029,883053,95390,94084,10303,104387,1219
2021-03-28,Kings,031,150075,22801,22514,1033,23547,238
2021-03-28,Lake,033,64148,3349,3320,8,3328,43
2021-03-28,Lassen,035,31185,5146,5131,102,5233,1
2021-03-28,Los Angeles,037,10098052,1186880,1179316,40376,1219692,23101
2021-03-28,Madera,039,155013,16121,15973,887,16860,210
2021-03-28,Marin,041,260295,13660,13594,208,13802,221
2021-03-28,Mariposa,043,17540,393,388,5,393,5
2021-03-28,Mendocino,045,87422,3753,3666,72,3738,45
2021-03-28,Merced,047,269075,29813,29679,950,30629,422
2021-03-28,Modoc,049,8938,355,344,120,464,3
2021-03-28,Mono,051,14174,1233,1242,17,1259,3
2021-03-28,Monterey,053,433212,42559,42294,1782,44076,337
2021-03-28,Napa,055,140530,9428,9368,34,9402,78
2021-03-28,Nevada,057,99092,4339,4239,180,4419,68
2021-03-28,Orange,059,3164182,251129,249238,10766,260004,4713
2021-03-28,Placer,061,380077,21552,20796,1246,22042,267
2021-03-28,Plumas,063,18699,670,657,10,667,4
2021-03-28,Riverside,065,2383286,289463,282811,13711,296522,4132
2021-03-28,Sacramento,067,1510023,98841,97425,1427,98852,1514
2021-03-28,San Benito,069,59416,5865,5862,96,5958,61
2021-03-28,San Bernardino,071,2135413,289136,285570,8752,294322,4332
2021-03-28,San Diego,073,3302833,270763,269476,13511,282987,3547
2021-03-28,San Francisco,075,870044,35268,35286,1202,36488,474
2021-03-28,San Joaquin,077,732212,69668,68459,3170,71629,1211
2021-03-28,San Luis Obispo,079,281455,20515,20172,625,20797,250
2021-03-28,San Mateo,081,765935,40778,40305,431,40736,348
2021-03-28,Santa Barbara,083,443738,33293,32953,1153,34106,439
2021-03-28,Santa Clara,085,1922200,114123,114232,653,114885,1871
2021-03-28,Santa Cruz,087,273765,15827,15238,803,16041,201
2021-03-28,Shasta,089,179085,11321,11308,1345,12653,183
2021-03-28,Sierra,091,2930,55,50,12,62,0
2021-03-28,Siskiyou,093,43540,1568,1497,262,1759,6
2021-03-28,Solano,095,438530,30867,30719,409,31128,232
2021-03-28,Sonoma,097,501317,29055,29161,272,29433,310
2021-03-28,Stanislaus,099,539301,53080,52567,5590,58157,678
2021-03-28,Sutter,101,95872,9158,9094,81,9175,106
2021-03-28,Tehama,103,63373,4777,4740,513,5253,52
2021-03-28,Trinity,105,12862,476,314,84,398,3
2021-03-28,Tulare,107,460477,49265,48218,8622,56840,815
2021-03-28,Tuolumne,109,53932,3900,3969,36,4005,57
2021-03-28,Ventura,111,848112,79860,79222,2887,82109,956
2021-03-28,Yolo,113,214977,13316,13325,249,13574,194
2021-03-28,Yuba,115,75493,5723,5662,106,5768,42
2021-03-27,Alameda,001,1643700,83758,83169,1806,84975,1211
2021-03-27,Alpine,003,1148,85,85,0,85,0
2021-03-27,Amador,005,37829,3569,3538,32,3570,45
2021-03-27,Butte,007,227075,11672,11278,1671,12949,191
2021-03-27,Calaveras,009,45235,1998,1992,12,2004,50
2021-03-27,Colusa,011,21464,1892,1889,273,2162,14
2021-03-27,Contra Costa,013,1133247,65728,64804,1137,65941,767
2021-03-27,Del Norte,015,27424,1174,1104,7,1111,6
2021-03-27,El Dorado,017,186661,9432,9367,611,9978,105
2021-03-27,Fresno,019,978130,99800,98901,8269,107170,1606
2021-03-27,Glenn,021,27897,2345,2308,529,2837,17
2021-03-27,Humboldt,023,135768,3451,3442,24,3466,34
2021-03-27,Imperial,025,180216,27603,27406,2682,30088,704
2021-03-27,Inyo,027,18085,1373,1372,9,1381,35
2021-03-27,Kern,029,883053,95370,94041,10291,104332,1217
2021-03-27,Kings,031,150075,22798,22502,1033,23535,238
2021-03-27,Lake,033,64148,3347,3317,8,3325,43
2021-03-27,Lassen,035,31185,5146,5129,102,5231,1
2021-03-27,Los Angeles,037,10098052,1186566,1178831,40349,1219180,23103
2021-03-27,Madera,039,155013,16114,15968,885,16853,210
2021-03-27,Marin,041,260295,13655,13579,208,13787,222
2021-03-27,Mariposa,043,17540,393,386,5,391,5
2021-03-27,Mendocino,045,87422,3751,3666,72,3738,45
2021-03-27,Merced,047,269075,29780,29647,948,30595,422
2021-03-27,Modoc,049,8938,355,344,120,464,3
2021-03-27,Mono,051,14174,1231,1241,17,1258,3
2021-03-27,Monterey,053,433212,42549,42271,1782,44053,337
2021-03-27,Napa,055,140530,9416,9360,34,9394,78
2021-03-27,Nevada,057,99092,4329,4231,180,4411,68
2021-03-27,Orange,059,3164182,251036,249160,10750,259910,4698
2021-03-27,Placer,061,380077,21532,20717,1239,21956,267
2021-03-27,Plumas,063,18699,669,655,10,665,4
2021-03-27,Riverside,065,2383286,289401,282707,13703,296410,4132
2021-03-27,Sacramento,067,1510023,98751,97247,1425,98672,1513
2021-03-27,San Benito,069,59416,5863,5862,94,5956,61
2021-03-27,San Bernardino,071,2135413,289074,285480,8750,294230,4325
2021-03-27,San Diego,073,3302833,270593,269271,13489,282760,3540
2021-03-27,San Francisco,075,870044,35244,35244,1200,36444,474
2021-03-27,San Joaquin,077,732212,69608,68365,3162,71527,1211
2021-03-27,San Luis Obispo,079,281455,20504,20153,622,20775,250
2021-03-27,San Mateo,081,765935,40755,40264,431,40695,348
2021-03-27,Santa Barbara,083,443738,33269,32921,1153,34074,439
2021-03-27,Santa Clara,085,1922200,114027,114124,651,114775,1871
2021-03-27,Santa Cruz,087,273765,15821,15215,803,16018,201
2021-03-27,Shasta,089,179085,11310,11288,1343,12631,183
2021-03-27,Sierra,091,2930,55,50,12,62,0
2021-03-27,Siskiyou,093,43540,1568,1497,262,1759,6
2021-03-27,Solano,095,438530,30839,30669,408,31077,232
2021-03-27,Sonoma,097,501317,29040,29133,270,29403,310
2021-03-27,Stanislaus,099,539301,53015,52497,5582,58079,678
2021-03-27,Sutter,101,95872,9150,9093,81,9174,106
2021-03-27,Tehama,103,63373,4771,4738,511,5249,52
2021-03-27,Trinity,105,12862,476,313,84,397,3
2021-03-27,Tulare,107,460477,49249,48203,8614,56817,813
2021-03-27,Tuolumne,109,53932,3897,3968,36,4004,57
2021-03-27,Ventura,111,848112,79833,79184,2885,82069,956
2021-03-27,Yolo,113,214977,13311,13317,248,13565,194
2021-03-27,Yuba,115,75493,5721,5657,106,5763,42
2021-03-26,Alameda,001,1643700,83696,83043,1804,84847,1208
2021-03-26,Alpine,003,1148,85,85,0,85,0
2021-03-26,Amador,005,37829,3564,3532,32,3564,45
2021-03-26,Butte,007,227075,11662,11278,1671,12949,191
2021-03-26,Calaveras,009,45235,1997,1989,12,2001,50
2021-03-26,Colusa,011,21464,1892,1889,273,2162,14
2021-03-26,Contra Costa,013,1133247,65668,64699,1134,65833,761
2021-03-26,Del Norte,015,27424,1171,1101,7,1108,6
2021-03-26,El Dorado,017,186661,9427,9353,611,9964,105
2021-03-26,Fresno,019,978130,99738,98731,8259,106990,1601
2021-03-26,Glenn,021,27897,2345,2307,528,2835,17
2021-03-26,Humboldt,023,135768,3449,3431,24,3455,34
2021-03-26,Imperial,025,180216,27579,27374,2682,30056,701
2021-03-26,Inyo,027,18085,1372,1369,9,1378,35
2021-03-26,Kern,029,883053,95344,93949,10285,104234,1211
2021-03-26,Kings,031,150075,22790,22493,1031,23524,239
2021-03-26,Lake,033,64148,3346,3314,8,3322,43
2021-03-26,Lassen,035,31185,5145,5131,102,5233,1
2021-03-26,Los Angeles,037,10098052,1186230,1178213,40335,1218548,23080
2021-03-26,Madera,039,155013,16104,15952,885,16837,210
2021-03-26,Marin,041,260295,13649,13553,203,13756,221
2021-03-26,Mariposa,043,17540,393,386,5,391,5
2021-03-26,Mendocino,045,87422,3750,3664,72,3736,45
2021-03-26,Merced,047,269075,29757,29613,946,30559,419
2021-03-26,Modoc,049,8938,355,344,120,464,3
2021-03-26,Mono,051,14174,1230,1236,17,1253,3
2021-03-26,Monterey,053,433212,42536,42241,1778,44019,338
2021-03-26,Napa,055,140530,9406,9349,34,9383,78
2021-03-26,Nevada,057,99092,4309,4222,180,4402,83
2021-03-26,Orange,059,3164182,250973,248995,10736,259731,4671
2021-03-26,Placer,061,380077,21506,20679,1238,21917,259
2021-03-26,Plumas,063,18699,668,654,10,664,4
2021-03-26,Riverside,065,2383286,289323,282602,13697,296299,4109
2021-03-26,Sacramento,067,1510023,98651,97040,1420,98460,1509
2021-03-26,San Benito,069,59416,5860,5855,94,5949,61
2021-03-26,San Bernardino,071,2135413,289018,285313,8748,294061,4288
2021-03-26,San Diego,073,3302833,270415,269045,13463,282508,3525
2021-03-26,San Francisco,075,870044,35218,35186,1200,36386,472
2021-03-26,San Joaquin,077,732212,69545,68249,3158,71407,1202
2021-03-26,San Luis Obispo,079,281455,20491,20118,622,20740,250
2021-03-26,San Mateo,081,765935,40720,40199,431,40630,348
2021-03-26,Santa Barbara,083,443738,33239,32895,1152,34047,439
2021-03-26,Santa Clara,085,1922200,113929,113959,650,114609,1868
2021-03-26,Santa Cruz,087,273765,15806,15199,802,16001,201
2021-03-26,Shasta,089,179085,11301,11276,1337,12613,182
2021-03-26,Sierra,091,2930,55,50,12,62,0
2021-03-26,Siskiyou,093,43540,1568,1493,261,1754,6
2021-03-26,Solano,095,438530,30814,30640,408,31048,205
2021-03-26,Sonoma,097,501317,29024,29101,267,29368,310
2021-03-26,Stanislaus,099,539301,52947,52420,5578,57998,678
2021-03-26,Sutter,101,95872,9147,9082,81,9163,104
2021-03-26,Tehama,103,63373,4770,4722,510,5232,51
2021-03-26,Trinity,105,12862,476,311,84,395,3
2021-03-26,Tulare,107,460477,49234,48179,8606,56785,813
2021-03-26,Tuolumne,109,53932,3896,3965,36,4001,57
2021-03-26,Ventura,111,848112,79799,79122,2883,82005,953
2021-03-26,Yolo,113,214977,13304,13299,246,13545,194
2021-03-26,Yuba,115,75493,5711,5653,106,5759,42
2021-03-25,Alameda,001,1643700,83600,82945,1802,84747,1206
2021-03-25,Alpine,003,1148,85,84,0,84,0
2021-03-25,Amador,005,37829,3562,3530,32,3562,45
2021-03-25,Butte,007,227075,11652,11270,1671,12941,188
2021-03-25,Calaveras,009,45235,1996,1982,12,1994,50
2021-03-25,Colusa,011,21464,1892,1888,273,2161,14
2021-03-25,Contra Costa,013,1133247,65601,64606,1130,65736,757
2021-03-25,Del Norte,015,27424,1165,1095,7,1102,6
2021-03-25,El Dorado,017,186661,9417,9331,611,9942,105
2021-03-25,Fresno,019,978130,99620,98602,8246,106848,1593
2021-03-25,Glenn,021,27897,2344,2302,527,2829,17
2021-03-25,Humboldt,023,135768,3444,3423,24,3447,34
2021-03-25,Imperial,025,180216,27562,27352,2680,30032,699
2021-03-25,Inyo,027,18085,1372,1369,9,1378,35
2021-03-25,Kern,029,883053,95312,93857,10280,104137,1206
2021-03-25,Kings,031,150075,22780,22472,1031,23503,237
2021-03-25,Lake,033,64148,3341,3312,8,3320,43
2021-03-25,Lassen,035,31185,5145,5129,102,5231,1
2021-03-25,Los Angeles,037,10098052,1185797,1177490,40300,1217790,23051
2021-03-25,Madera,039,155013,16085,15937,883,16820,210
2021-03-25,Marin,041,260295,13640,13538,200,13738,219
2021-03-25,Mariposa,043,17540,393,386,5,391,5
2021-03-25,Mendocino,045,87422,3749,3664,72,3736,45
2021-03-25,Merced,047,269075,29723,29576,938,30514,416
2021-03-25,Modoc,049,8938,355,343,120,463,3
2021-03-25,Mono,051,14174,1230,1235,17,1252,3
2021-03-25,Monterey,053,433212,42515,42220,1773,43993,336
2021-03-25,Napa,055,140530,9387,9321,34,9355,78
2021-03-25,Nevada,057,99092,4291,4202,178,4380,84
2021-03-25,Orange,059,3164182,250857,248871,10716,259587,4655
2021-03-25,Placer,061,380077,21465,20639,1231,21870,252
2021-03-25,Plumas,063,18699,668,654,10,664,4
2021-03-25,Riverside,065,2383286,289226,282492,13686,296178,4078
2021-03-25,Sacramento,067,1510023,98506,96823,1417,98240,1505
2021-03-25,San Benito,069,59416,5857,5850,94,5944,61
2021-03-25,San Bernardino,071,2135413,288936,285134,8743,293877,4222
2021-03-25,San Diego,073,3302833,270188,268623,13432,282055,3520
2021-03-25,San Francisco,075,870044,35179,35154,1198,36352,468
2021-03-25,San Joaquin,077,732212,69448,68089,3119,71208,1196
2021-03-25,San Luis Obispo,079,281455,20473,20076,622,20698,250
2021-03-25,San Mateo,081,765935,40680,40147,431,40578,348
2021-03-25,Santa Barbara,083,443738,33212,32857,1152,34009,439
2021-03-25,Santa Clara,085,1922200,113825,113877,648,114525,1868
2021-03-25,Santa Cruz,087,273765,15785,15170,802,15972,201
2021-03-25,Shasta,089,179085,11284,11262,1334,12596,181
2021-03-25,Sierra,091,2930,55,50,12,62,0
2021-03-25,Siskiyou,093,43540,1566,1491,260,1751,6
2021-03-25,Solano,095,438530,30753,30583,406,30989,193
2021-03-25,Sonoma,097,501317,28989,29060,263,29323,310
2021-03-25,Stanislaus,099,539301,52880,52321,5571,57892,678
2021-03-25,Sutter,101,95872,9138,9069,81,9150,104
2021-03-25,Tehama,103,63373,4768,4719,509,5228,52
2021-03-25,Trinity,105,12862,476,310,84,394,3
2021-03-25,Tulare,107,460477,49207,48148,8593,56741,811
2021-03-25,Tuolumne,109,53932,3895,3962,36,3998,57
2021-03-25,Ventura,111,848112,79758,79045,2879,81924,952
2021-03-25,Yolo,113,214977,13298,13287,246,13533,194
2021-03-25,Yuba,115,75493,5705,5647,100,5747,42
2021-03-24,Alameda,001,1643700,83506,82871,1799,84670,1199
2021-03-24,Alpine,003,1148,85,84,0,84,0
2021-03-24,Amador,005,37829,3556,3529,32,3561,45
2021-03-24,Butte,007,227075,11642,11252,1667,12919,187
2021-03-24,Calaveras,009,45235,1993,1975,12,1987,50
2021-03-24,Colusa,011,21464,1892,1886,273,2159,14
2021-03-24,Contra Costa,013,1133247,65521,64539,1129,65668,755
2021-03-24,Del Norte,015,27424,1160,1087,7,1094,6
2021-03-24,El Dorado,017,186661,9411,9319,610,9929,105
2021-03-24,Fresno,019,978130,99530,98437,8231,106668,1585
2021-03-24,Glenn,021,27897,2343,2297,526,2823,17
2021-03-24,Humboldt,023,135768,3441,3414,24,3438,34
2021-03-24,Imperial,025,180216,27553,27325,2679,30004,699
2021-03-24,Inyo,027,18085,1372,1368,9,1377,35
2021-03-24,Kern,029,883053,95264,93800,10271,104071,1198
2021-03-24,Kings,031,150075,22765,22456,1029,23485,237
2021-03-24,Lake,033,64148,3337,3307,8,3315,43
2021-03-24,Lassen,035,31185,5143,5130,101,5231,1
2021-03-24,Los Angeles,037,10098052,1185322,1177015,40264,1217279,22993
2021-03-24,Madera,039,155013,16076,15918,882,16800,210
2021-03-24,Marin,041,260295,13626,13526,198,13724,219
2021-03-24,Mariposa,043,17540,393,384,5,389,5
2021-03-24,Mendocino,045,87422,3746,3660,72,3732,45
2021-03-24,Merced,047,269075,29681,29525,938,30463,415
2021-03-24,Modoc,049,8938,354,341,120,461,3
2021-03-24,Mono,051,14174,1229,1243,17,1260,3
2021-03-24,Monterey,053,433212,42493,42201,1770,43971,335
2021-03-24,Napa,055,140530,9367,9310,34,9344,78
2021-03-24,Nevada,057,99092,4277,4191,177,4368,85
2021-03-24,Orange,059,3164182,250742,248775,10698,259473,4638
2021-03-24,Placer,061,380077,21435,20606,1223,21829,250
2021-03-24,Plumas,063,18699,666,652,10,662,4
2021-03-24,Riverside,065,2383286,289142,282410,13683,296093,4058
2021-03-24,Sacramento,067,1510023,98331,96628,1405,98033,1500
2021-03-24,San Benito,069,59416,5856,5847,94,5941,61
2021-03-24,San Bernardino,071,2135413,288850,284983,8741,293724,4170
2021-03-24,San Diego,073,3302833,269973,268413,13404,281817,3509
2021-03-24,San Francisco,075,870044,35151,35103,1195,36298,462
2021-03-24,San Joaquin,077,732212,69377,67978,3107,71085,1196
2021-03-24,San Luis Obispo,079,281455,20443,20021,621,20642,250
2021-03-24,San Mateo,081,765935,40630,40083,431,40514,348
2021-03-24,Santa Barbara,083,443738,33185,32810,1152,33962,438
2021-03-24,Santa Clara,085,1922200,113709,113757,645,114402,1851
2021-03-24,Santa Cruz,087,273765,15771,15138,801,15939,202
2021-03-24,Shasta,089,179085,11265,11243,1332,12575,181
2021-03-24,Sierra,091,2930,55,50,12,62,0
2021-03-24,Siskiyou,093,43540,1564,1490,260,1750,6
2021-03-24,Solano,095,438530,30716,30552,405,30957,178
2021-03-24,Sonoma,097,501317,28969,29034,259,29293,310
2021-03-24,Stanislaus,099,539301,52804,52259,5562,57821,677
2021-03-24,Sutter,101,95872,9122,9049,81,9130,104
2021-03-24,Tehama,103,63373,4762,4719,508,5227,49
2021-03-24,Trinity,105,12862,475,310,84,394,3
2021-03-24,Tulare,107,460477,49196,48109,8580,56689,808
2021-03-24,Tuolumne,109,53932,3894,3961,36,3997,57
2021-03-24,Ventura,111,848112,79706,78993,2872,81865,944
2021-03-24,Yolo,113,214977,13287,13269,246,13515,194
2021-03-24,Yuba,115,75493,5699,5634,97,5731,42
2021-03-23,Alameda,001,1643700,83404,82799,1795,84594,1190
2021-03-23,Alpine,003,1148,85,84,0,84,0
2021-03-23,Amador,005,37829,3550,3524,32,3556,45
2021-03-23,Butte,007,227075,11630,11227,1666,12893,187
2021-03-23,Calaveras,009,45235,1991,1971,12,1983,50
2021-03-23,Colusa,011,21464,1890,1885,272,2157,14
2021-03-23,Contra Costa,013,1133247,65422,64491,1128,65619,750
2021-03-23,Del Norte,015,27424,1155,1082,7,1089,6
2021-03-23,El Dorado,017,186661,9401,9318,608,9926,105
2021-03-23,Fresno,019,978130,99417,98362,8205,106567,1575
2021-03-23,Glenn,021,27897,2338,2293,524,2817,17
2021-03-23,Humboldt,023,135768,3432,3405,24,3429,34
2021-03-23,Imperial,025,180216,27545,27320,2678,29998,699
2021-03-23,Inyo,027,18085,1370,1364,9,1373,35
2021-03-23,Kern,029,883053,95157,93728,10264,103992,1191
2021-03-23,Kings,031,150075,22754,22439,1027,23466,237
2021-03-23,Lake,033,64148,3335,3294,8,3302,43
2021-03-23,Lassen,035,31185,5143,5130,101,5231,1
2021-03-23,Los Angeles,037,10098052,1184802,1176572,40226,1216798,22904
2021-03-23,Madera,039,155013,16060,15908,881,16789,210
2021-03-23,Marin,041,260295,13603,13514,196,13710,221
2021-03-23,Mariposa,043,17540,392,384,5,389,5
2021-03-23,Mendocino,045,87422,3744,3652,72,3724,45
2021-03-23,Merced,047,269075,29648,29485,938,30423,415
2021-03-23,Modoc,049,8938,353,342,120,462,3
2021-03-23,Mono,051,14174,1228,1263,17,1280,3
2021-03-23,Monterey,053,433212,42482,42180,1768,43948,335
2021-03-23,Napa,055,140530,9342,9299,34,9333,78
2021-03-23,Nevada,057,99092,4258,4179,176,4355,89
2021-03-23,Orange,059,3164182,250616,248661,10680,259341,4626
2021-03-23,Placer,061,380077,21400,20567,1219,21786,248
2021-03-23,Plumas,063,18699,666,652,10,662,4
2021-03-23,Riverside,065,2383286,289042,282317,13676,295993,4035
2021-03-23,Sacramento,067,1510023,98139,96521,1399,97920,1496
2021-03-23,San Benito,069,59416,5851,5845,93,5938,61
2021-03-23,San Bernardino,071,2135413,288766,284875,8733,293608,4134
2021-03-23,San Diego,073,3302833,269728,268156,13372,281528,3498
2021-03-23,San Francisco,075,870044,35093,35071,1189,36260,462
2021-03-23,San Joaquin,077,732212,69281,67903,3089,70992,1182
2021-03-23,San Luis Obispo,079,281455,20402,20009,620,20629,250
2021-03-23,San Mateo,081,765935,40574,40032,430,40462,348
2021-03-23,Santa Barbara,083,443738,33147,32771,1151,33922,438
2021-03-23,Santa Clara,085,1922200,113593,113645,642,114287,1848
2021-03-23,Santa Cruz,087,273765,15756,15106,801,15907,201
2021-03-23,Shasta,089,179085,11252,11234,1331,12565,175
2021-03-23,Sierra,091,2930,55,50,12,62,0
2021-03-23,Siskiyou,093,43540,1559,1485,258,1743,6
2021-03-23,Solano,095,438530,30675,30524,404,30928,178
2021-03-23,Sonoma,097,501317,28932,29020,258,29278,310
2021-03-23,Stanislaus,099,539301,52705,52148,5554,57702,677
2021-03-23,Sutter,101,95872,9114,9039,81,9120,104
2021-03-23,Tehama,103,63373,4751,4707,507,5214,46
2021-03-23,Trinity,105,12862,475,310,84,394,3
2021-03-23,Tulare,107,460477,49169,48095,8564,56659,808
2021-03-23,Tuolumne,109,53932,3891,3957,36,3993,57
2021-03-23,Ventura,111,848112,79645,78930,2869,81799,932
2021-03-23,Yolo,113,214977,13276,13255,246,13501,194
2021-03-23,Yuba,115,75493,5694,5628,97,5725,42
2021-03-22,Alameda,001,1643700,83311,82748,1789,84537,1189
2021-03-22,Alpine,003,1148,84,83,0,83,0
2021-03-22,Amador,005,37829,3542,3522,32,3554,44
2021-03-22,Butte,007,227075,11621,11211,1664,12875,185
2021-03-22,Calaveras,009,45235,1987,1963,12,1975,49
2021-03-22,Colusa,011,21464,1888,1885,272,2157,13
2021-03-22,Contra Costa,013,1133247,65327,64432,1126,65558,740
2021-03-22,Del Norte,015,27424,1149,1082,7,1089,6
2021-03-22,El Dorado,017,186661,9385,9310,605,9915,105
2021-03-22,Fresno,019,978130,99319,98276,8192,106468,1556
2021-03-22,Glenn,021,27897,2330,2291,524,2815,17
2021-03-22,Humboldt,023,135768,3427,3403,24,3427,34
2021-03-22,Imperial,025,180216,27530,27302,2674,29976,699
2021-03-22,Inyo,027,18085,1367,1363,9,1372,35
2021-03-22,Kern,029,883053,95086,93675,10247,103922,1178
2021-03-22,Kings,031,150075,22741,22433,1022,23455,236
2021-03-22,Lake,033,64148,3334,3290,8,3298,43
2021-03-22,Lassen,035,31185,5141,5129,101,5230,1
2021-03-22,Los Angeles,037,10098052,1184291,1176205,40193,1216398,22843
2021-03-22,Madera,039,155013,16045,15904,881,16785,210
2021-03-22,Marin,041,260295,13594,13501,195,13696,221
2021-03-22,Mariposa,043,17540,391,381,5,386,5
2021-03-22,Mendocino,045,87422,3742,3653,72,3725,45
2021-03-22,Merced,047,269075,29605,29468,935,30403,413
2021-03-22,Modoc,049,8938,351,342,120,462,3
2021-03-22,Mono,051,14174,1223,1263,17,1280,3
2021-03-22,Monterey,053,433212,42466,42161,1766,43927,335
2021-03-22,Napa,055,140530,9331,9288,34,9322,77
2021-03-22,Nevada,057,99092,4247,4174,172,4346,89
2021-03-22,Orange,059,3164182,250465,248517,10646,259163,4599
2021-03-22,Placer,061,380077,21365,20543,1214,21757,242
2021-03-22,Plumas,063,18699,666,652,10,662,4
2021-03-22,Riverside,065,2383286,288942,282242,13665,295907,4009
2021-03-22,Sacramento,067,1510023,97961,96385,1389,97774,1493
2021-03-22,San Benito,069,59416,5848,5844,92,5936,61
2021-03-22,San Bernardino,071,2135413,288679,284771,8721,293492,4107
2021-03-22,San Diego,073,3302833,269516,267913,13352,281265,3494
2021-03-22,San Francisco,075,870044,35051,35040,1185,36225,462
2021-03-22,San Joaquin,077,732212,69189,67815,3071,70886,1182
2021-03-22,San Luis Obispo,079,281455,20378,20000,619,20619,250
2021-03-22,San Mateo,081,765935,40523,40024,429,40453,348
2021-03-22,Santa Barbara,083,443738,33102,32756,1149,33905,437
2021-03-22,Santa Clara,085,1922200,113473,113575,642,114217,1845
2021-03-22,Santa Cruz,087,273765,15744,15077,800,15877,201
2021-03-22,Shasta,089,179085,11238,11218,1330,12548,150
2021-03-22,Sierra,091,2930,55,50,12,62,0
2021-03-22,Siskiyou,093,43540,1558,1487,257,1744,5
2021-03-22,Solano,095,438530,30635,30490,400,30890,171
2021-03-22,Sonoma,097,501317,28903,29010,254,29264,310
2021-03-22,Stanislaus,099,539301,52621,52083,5549,57632,677
2021-03-22,Sutter,101,95872,9101,9024,81,9105,104
2021-03-22,Tehama,103,63373,4743,4704,507,5211,45
2021-03-22,Trinity,105,12862,475,310,84,394,3
2021-03-22,Tulare,107,460477,49154,48074,8544,56618,807
2021-03-22,Tuolumne,109,53932,3888,3954,36,3990,57
2021-03-22,Ventura,111,848112,79597,78890,2866,81756,927
2021-03-22,Yolo,113,214977,13264,13243,245,13488,190
2021-03-22,Yuba,115,75493,5683,5627,95,5722,42
2021-03-21,Alameda,001,1643700,83220,82684,1786,84470,1187
2021-03-21,Alpine,003,1148,84,83,0,83,0
2021-03-21,Amador,005,37829,3538,3519,32,3551,44
2021-03-21,Butte,007,227075,11605,11208,1659,12867,185
2021-03-21,Calaveras,009,45235,1982,1962,12,1974,49
2021-03-21,Colusa,011,21464,1888,1885,272,2157,13
2021-03-21,Contra Costa,013,1133247,65245,64382,1123,65505,740
2021-03-21,Del Norte,015,27424,1134,1076,7,1083,6
2021-03-21,El Dorado,017,186661,9375,9302,600,9902,105
2021-03-21,Fresno,019,978130,99205,98211,8168,106379,1556
2021-03-21,Glenn,021,27897,2327,2288,523,2811,17
2021-03-21,Humboldt,023,135768,3422,3402,24,3426,34
2021-03-21,Imperial,025,180216,27512,27267,2666,29933,699
2021-03-21,Inyo,027,18085,1367,1363,9,1372,35
2021-03-21,Kern,029,883053,95020,93649,10238,103887,1170
2021-03-21,Kings,031,150075,22724,22422,1021,23443,236
2021-03-21,Lake,033,64148,3330,3286,8,3294,43
2021-03-21,Lassen,035,31185,5141,5129,101,5230,1
2021-03-21,Los Angeles,037,10098052,1183760,1175684,40145,1215829,22834
2021-03-21,Madera,039,155013,16025,15895,879,16774,210
2021-03-21,Marin,041,260295,13578,13495,194,13689,220
2021-03-21,Mariposa,043,17540,391,381,5,386,5
2021-03-21,Mendocino,045,87422,3739,3651,72,3723,45
2021-03-21,Merced,047,269075,29545,29446,929,30375,413
2021-03-21,Modoc,049,8938,351,341,120,461,3
2021-03-21,Mono,051,14174,1218,1263,17,1280,3
2021-03-21,Monterey,053,433212,42441,42153,1763,43916,335
2021-03-21,Napa,055,140530,9311,9282,34,9316,77
2021-03-21,Nevada,057,99092,4234,4169,172,4341,89
2021-03-21,Orange,059,3164182,250331,248442,10620,259062,4598
2021-03-21,Placer,061,380077,21329,20520,1206,21726,242
2021-03-21,Plumas,063,18699,666,653,10,663,4
2021-03-21,Riverside,065,2383286,288835,282187,13654,295841,4009
2021-03-21,Sacramento,067,1510023,97767,96269,1382,97651,1489
2021-03-21,San Benito,069,59416,5842,5842,92,5934,61
2021-03-21,San Bernardino,071,2135413,288590,284732,8715,293447,4094
2021-03-21,San Diego,073,3302833,269256,267724,13326,281050,3494
2021-03-21,San Francisco,075,870044,35005,35012,1178,36190,460
2021-03-21,San Joaquin,077,732212,69067,67729,3053,70782,1182
2021-03-21,San Luis Obispo,079,281455,20346,19979,617,20596,250
2021-03-21,San Mateo,081,765935,40478,39988,428,40416,344
2021-03-21,Santa Barbara,083,443738,33061,32743,1148,33891,437
2021-03-21,Santa Clara,085,1922200,113344,113487,639,114126,1840
2021-03-21,Santa Cruz,087,273765,15737,15064,800,15864,199
2021-03-21,Shasta,089,179085,11218,11215,1329,12544,150
2021-03-21,Sierra,091,2930,55,50,12,62,0
2021-03-21,Siskiyou,093,43540,1558,1486,256,1742,5
2021-03-21,Solano,095,438530,30595,30474,397,30871,171
2021-03-21,Sonoma,097,501317,28874,28986,253,29239,310
2021-03-21,Stanislaus,099,539301,52531,52014,5547,57561,677
2021-03-21,Sutter,101,95872,9088,9021,81,9102,104
2021-03-21,Tehama,103,63373,4739,4701,507,5208,45
2021-03-21,Trinity,105,12862,473,310,84,394,3
2021-03-21,Tulare,107,460477,49138,48060,8532,56592,807
2021-03-21,Tuolumne,109,53932,3886,3953,36,3989,57
2021-03-21,Ventura,111,848112,79533,78863,2861,81724,927
2021-03-21,Yolo,113,214977,13243,13235,245,13480,190
2021-03-21,Yuba,115,75493,5673,5624,95,5719,42
2021-03-20,Alameda,001,1643700,83152,82614,1784,84398,1178
2021-03-20,Alpine,003,1148,84,83,0,83,0
2021-03-20,Amador,005,37829,3536,3518,32,3550,44
2021-03-20,Butte,007,227075,11599,11199,1657,12856,185
2021-03-20,Calaveras,009,45235,1978,1961,12,1973,49
2021-03-20,Colusa,011,21464,1888,1883,272,2155,12
2021-03-20,Contra Costa,013,1133247,65185,64313,1123,65436,713
2021-03-20,Del Norte,015,27424,1133,1075,7,1082,6
2021-03-20,El Dorado,017,186661,9369,9290,600,9890,105
2021-03-20,Fresno,019,978130,99144,98112,8161,106273,1532
2021-03-20,Glenn,021,27897,2326,2288,521,2809,17
2021-03-20,Humboldt,023,135768,3415,3399,24,3423,33
2021-03-20,Imperial,025,180216,27506,27239,2664,29903,695
2021-03-20,Inyo,027,18085,1367,1362,9,1371,35
2021-03-20,Kern,029,883053,94991,93606,10234,103840,1155
2021-03-20,Kings,031,150075,22719,22415,1020,23435,236
2021-03-20,Lake,033,64148,3326,3280,8,3288,43
2021-03-20,Lassen,035,31185,5141,5128,101,5229,1
2021-03-20,Los Angeles,037,10098052,1183459,1175290,40120,1215410,22810
2021-03-20,Madera,039,155013,16017,15891,878,16769,210
2021-03-20,Marin,041,260295,13566,13470,190,13660,220
2021-03-20,Mariposa,043,17540,390,381,5,386,5
2021-03-20,Mendocino,045,87422,3738,3639,72,3711,43
2021-03-20,Merced,047,269075,29514,29411,926,30337,412
2021-03-20,Modoc,049,8938,350,341,120,461,3
2021-03-20,Mono,051,14174,1218,1256,17,1273,3
2021-03-20,Monterey,053,433212,42432,42146,1762,43908,334
2021-03-20,Napa,055,140530,9303,9274,34,9308,77
2021-03-20,Nevada,057,99092,4223,4164,171,4335,89
2021-03-20,Orange,059,3164182,250250,248348,10608,258956,4522
2021-03-20,Placer,061,380077,21306,20505,1204,21709,242
2021-03-20,Plumas,063,18699,663,652,10,662,4
2021-03-20,Riverside,065,2383286,288760,282081,13650,295731,4000
2021-03-20,Sacramento,067,1510023,97656,96126,1379,97505,1488
2021-03-20,San Benito,069,59416,5838,5840,92,5932,61
2021-03-20,San Bernardino,071,2135413,288525,284690,8711,293401,3965
2021-03-20,San Diego,073,3302833,269085,267532,13319,280851,3493
2021-03-20,San Francisco,075,870044,34982,34968,1171,36139,453
2021-03-20,San Joaquin,077,732212,69026,67662,3046,70708,1161
2021-03-20,San Luis Obispo,079,281455,20330,19951,611,20562,250
2021-03-20,San Mateo,081,765935,40444,39958,427,40385,344
2021-03-20,Santa Barbara,083,443738,33037,32723,1147,33870,434
2021-03-20,Santa Clara,085,1922200,113252,113384,638,114022,1799
2021-03-20,Santa Cruz,087,273765,15721,15053,800,15853,199
2021-03-20,Shasta,089,179085,11212,11211,1329,12540,147
2021-03-20,Sierra,091,2930,55,50,12,62,0
2021-03-20,Siskiyou,093,43540,1558,1483,256,1739,5
2021-03-20,Solano,095,438530,30565,30439,397,30836,170
2021-03-20,Sonoma,097,501317,28859,28962,253,29215,309
2021-03-20,Stanislaus,099,539301,52475,51925,5540,57465,673
2021-03-20,Sutter,101,95872,9080,9014,81,9095,103
2021-03-20,Tehama,103,63373,4734,4696,505,5201,33
2021-03-20,Trinity,105,12862,472,310,84,394,3
2021-03-20,Tulare,107,460477,49123,48030,8515,56545,804
2021-03-20,Tuolumne,109,53932,3883,3950,36,3986,57
2021-03-20,Ventura,111,848112,79496,78818,2859,81677,922
2021-03-20,Yolo,113,214977,13239,13226,245,13471,190
2021-03-20,Yuba,115,75493,5670,5621,94,5715,42
2021-03-19,Alameda,001,1643700,83080,82499,1783,84282,1187
2021-03-19,Alpine,003,1148,83,82,0,82,0
2021-03-19,Amador,005,37829,3533,3515,32,3547,44
2021-03-19,Butte,007,227075,11591,11191,1654,12845,185
2021-03-19,Calaveras,009,45235,1977,1957,12,1969,49
2021-03-19,Colusa,011,21464,1887,1883,272,2155,12
2021-03-19,Contra Costa,013,1133247,65126,64195,1120,65315,737
2021-03-19,Del Norte,015,27424,1127,1071,5,1076,6
2021-03-19,El Dorado,017,186661,9360,9274,600,9874,105
2021-03-19,Fresno,019,978130,99060,97969,8147,106116,1527
2021-03-19,Glenn,021,27897,2326,2282,521,2803,17
2021-03-19,Humboldt,023,135768,3406,3388,24,3412,33
2021-03-19,Imperial,025,180216,27494,27218,2660,29878,695
2021-03-19,Inyo,027,18085,1365,1356,9,1365,35
2021-03-19,Kern,029,883053,94958,93534,10221,103755,1152
2021-03-19,Kings,031,150075,22710,22369,1017,23386,235
2021-03-19,Lake,033,64148,3320,3262,8,3270,43
2021-03-19,Lassen,035,31185,5141,5126,101,5227,1
2021-03-19,Los Angeles,037,10098052,1183124,1174818,40103,1214921,22752
2021-03-19,Madera,039,155013,16010,15877,877,16754,210
2021-03-19,Marin,041,260295,13554,13441,190,13631,220
2021-03-19,Mariposa,043,17540,389,380,5,385,5
2021-03-19,Mendocino,045,87422,3737,3639,72,3711,45
2021-03-19,Merced,047,269075,29485,29376,925,30301,412
2021-03-19,Modoc,049,8938,350,341,120,461,3
2021-03-19,Mono,051,14174,1216,1244,17,1261,3
2021-03-19,Monterey,053,433212,42423,42125,1760,43885,335
2021-03-19,Napa,055,140530,9291,9256,34,9290,77
2021-03-19,Nevada,057,99092,4212,4156,171,4327,88
2021-03-19,Orange,059,3164182,250150,248146,10597,258743,4501
2021-03-19,Placer,061,380077,21288,20451,1202,21653,242
2021-03-19,Plumas,063,18699,663,650,10,660,4
2021-03-19,Riverside,065,2383286,288677,281937,13645,295582,3989
2021-03-19,Sacramento,067,1510023,97553,95934,1376,97310,1486
2021-03-19,San Benito,069,59416,5838,5845,92,5937,61
2021-03-19,San Bernardino,071,2135413,288453,284501,8709,293210,4017
2021-03-19,San Diego,073,3302833,268950,267173,13309,280482,3491
2021-03-19,San Francisco,075,870044,34937,34936,1168,36104,461
2021-03-19,San Joaquin,077,732212,68956,67515,3032,70547,1180
2021-03-19,San Luis Obispo,079,281455,20310,19913,609,20522,249
2021-03-19,San Mateo,081,765935,40420,39893,427,40320,344
2021-03-19,Santa Barbara,083,443738,33008,32685,1146,33831,435
2021-03-19,Santa Clara,085,1922200,113177,113232,637,113869,1797
2021-03-19,Santa Cruz,087,273765,15714,15026,800,15826,199
2021-03-19,Shasta,089,179085,11205,11104,1327,12431,103
2021-03-19,Sierra,091,2930,54,49,12,61,0
2021-03-19,Siskiyou,093,43540,1558,1480,255,1735,5
2021-03-19,Solano,095,438530,30535,30395,395,30790,172
2021-03-19,Sonoma,097,501317,28838,28932,251,29183,292
2021-03-19,Stanislaus,099,539301,52417,51755,5537,57292,679
2021-03-19,Sutter,101,95872,9078,9005,81,9086,103
2021-03-19,Tehama,103,63373,4726,4685,505,5190,33
2021-03-19,Trinity,105,12862,472,310,84,394,3
2021-03-19,Tulare,107,460477,49100,47989,8492,56481,805
2021-03-19,Tuolumne,109,53932,3880,3946,36,3982,57
2021-03-19,Ventura,111,848112,79458,78753,2855,81608,920
2021-03-19,Yolo,113,214977,13231,13197,245,13442,189
2021-03-19,Yuba,115,75493,5667,5615,93,5708,42
2021-03-18,Alameda,001,1643700,82999,82419,1780,84199,1189
2021-03-18,Alpine,003,1148,83,82,0,82,0
2021-03-18,Amador,005,37829,3529,3513,32,3545,44
2021-03-18,Butte,007,227075,11580,11179,1652,12831,185
2021-03-18,Calaveras,009,45235,1975,1954,12,1966,49
2021-03-18,Colusa,011,21464,1887,1882,272,2154,12
2021-03-18,Contra Costa,013,1133247,65053,64103,1117,65220,739
2021-03-18,Del Norte,015,27424,1118,1059,5,1064,6
2021-03-18,El Dorado,017,186661,9347,9261,599,9860,105
2021-03-18,Fresno,019,978130,98963,97856,8132,105988,1527
2021-03-18,Glenn,021,27897,2322,2275,520,2795,17
2021-03-18,Humboldt,023,135768,3398,3381,24,3405,34
2021-03-18,Imperial,025,180216,27478,27190,2654,29844,695
2021-03-18,Inyo,027,18085,1362,1354,9,1363,35
2021-03-18,Kern,029,883053,94901,93458,10207,103665,1158
2021-03-18,Kings,031,150075,22703,22354,1016,23370,235
2021-03-18,Lake,033,64148,3317,3260,8,3268,43
2021-03-18,Lassen,035,31185,5140,5126,101,5227,1
2021-03-18,Los Angeles,037,10098052,1182693,1174205,40074,1214279,22689
2021-03-18,Madera,039,155013,15998,15860,874,16734,211
2021-03-18,Marin,041,260295,13536,13435,189,13624,219
2021-03-18,Mariposa,043,17540,387,380,5,385,5
2021-03-18,Mendocino,045,87422,3727,3630,72,3702,45
2021-03-18,Merced,047,269075,29450,29317,925,30242,410
2021-03-18,Modoc,049,8938,350,341,120,461,3
2021-03-18,Mono,051,14174,1212,1215,16,1231,3
2021-03-18,Monterey,053,433212,42411,42105,1760,43865,335
2021-03-18,Napa,055,140530,9282,9243,34,9277,77
2021-03-18,Nevada,057,99092,4205,4154,171,4325,74
2021-03-18,Orange,059,3164182,250046,248050,10585,258635,4514
2021-03-18,Placer,061,380077,21256,20421,1199,21620,243
2021-03-18,Plumas,063,18699,661,648,10,658,4
2021-03-18,Riverside,065,2383286,288596,281789,13638,295427,3957
2021-03-18,Sacramento,067,1510023,97405,95819,1372,97191,1481
2021-03-18,San Benito,069,59416,5836,5842,92,5934,61
2021-03-18,San Bernardino,071,2135413,288372,284294,8679,292973,4076
2021-03-18,San Diego,073,3302833,268798,266752,13299,280051,3478
2021-03-18,San Francisco,075,870044,34898,34904,1167,36071,461
2021-03-18,San Joaquin,077,732212,68856,67301,3020,70321,1169
2021-03-18,San Luis Obispo,079,281455,20281,19894,608,20502,249
2021-03-18,San Mateo,081,765935,40379,39874,427,40301,344
2021-03-18,Santa Barbara,083,443738,32966,32640,1146,33786,434
2021-03-18,Santa Clara,085,1922200,113060,113119,633,113752,1808
2021-03-18,Santa Cruz,087,273765,15704,14998,800,15798,198
2021-03-18,Shasta,089,179085,11191,11059,1325,12384,100
2021-03-18,Sierra,091,2930,54,49,12,61,0
2021-03-18,Siskiyou,093,43540,1555,1480,254,1734,5
2021-03-18,Solano,095,438530,30493,30352,392,30744,172
2021-03-18,Sonoma,097,501317,28816,28915,249,29164,292
2021-03-18,Stanislaus,099,539301,52345,51615,5533,57148,682
2021-03-18,Sutter,101,95872,9066,8999,81,9080,103
2021-03-18,Tehama,103,63373,4720,4683,504,5187,35
2021-03-18,Trinity,105,12862,472,310,84,394,3
2021-03-18,Tulare,107,460477,49081,47964,8477,56441,805
2021-03-18,Tuolumne,109,53932,3880,3942,36,3978,57
2021-03-18,Ventura,111,848112,79401,78697,2855,81552,918
2021-03-18,Yolo,113,214977,13218,13183,244,13427,191
2021-03-18,Yuba,115,75493,5663,5612,93,5705,42
2021-03-17,Alameda,001,1643700,82923,82353,1775,84128,1185
2021-03-17,Alpine,003,1148,83,82,0,82,0
2021-03-17,Amador,005,37829,3527,3511,32,3543,44
2021-03-17,Butte,007,227075,11571,11170,1650,12820,185
2021-03-17,Calaveras,009,45235,1972,1946,12,1958,49
2021-03-17,Colusa,011,21464,1886,1882,272,2154,12
2021-03-17,Contra Costa,013,1133247,64984,64026,1116,65142,737
2021-03-17,Del Norte,015,27424,1114,1053,5,1058,6
2021-03-17,El Dorado,017,186661,9337,9252,599,9851,105
2021-03-17,Fresno,019,978130,98852,97727,8114,105841,1507
2021-03-17,Glenn,021,27897,2315,2269,519,2788,17
2021-03-17,Humboldt,023,135768,3390,3365,24,3389,33
2021-03-17,Imperial,025,180216,27462,27168,2652,29820,691
2021-03-17,Inyo,027,18085,1360,1351,9,1360,35
2021-03-17,Kern,029,883053,94845,93392,10194,103586,1149
2021-03-17,Kings,031,150075,22687,22336,1015,23351,233
2021-03-17,Lake,033,64148,3310,3251,8,3259,43
2021-03-17,Lassen,035,31185,5139,5125,101,5226,1
2021-03-17,Los Angeles,037,10098052,1182240,1173416,40041,1213457,22602
2021-03-17,Madera,039,155013,15991,15835,874,16709,214
2021-03-17,Marin,041,260295,13518,13428,188,13616,218
2021-03-17,Mariposa,043,17540,387,379,5,384,5
2021-03-17,Mendocino,045,87422,3723,3625,72,3697,44
2021-03-17,Merced,047,269075,29422,29250,921,30171,408
2021-03-17,Modoc,049,8938,350,341,120,461,3
2021-03-17,Mono,051,14174,1210,1212,16,1228,3
2021-03-17,Monterey,053,433212,42392,42061,1757,43818,334
2021-03-17,Napa,055,140530,9267,9219,34,9253,76
2021-03-17,Nevada,057,99092,4195,4145,171,4316,74
2021-03-17,Orange,059,3164182,249926,247943,10557,258500,4502
2021-03-17,Placer,061,380077,21229,20369,1197,21566,243
2021-03-17,Plumas,063,18699,660,645,10,655,4
2021-03-17,Riverside,065,2383286,288481,281649,13630,295279,3925
2021-03-17,Sacramento,067,1510023,97277,95650,1367,97017,1477
2021-03-17,San Benito,069,59416,5833,5841,92,5933,61
2021-03-17,San Bernardino,071,2135413,288255,284170,8674,292844,4049
2021-03-17,San Diego,073,3302833,268587,266313,13281,279594,3470
2021-03-17,San Francisco,075,870044,34863,34873,1166,36039,457
2021-03-17,San Joaquin,077,732212,68771,67093,3004,70097,1164
2021-03-17,San Luis Obispo,079,281455,20258,19858,604,20462,249
2021-03-17,San Mateo,081,765935,40349,39838,426,40264,344
2021-03-17,Santa Barbara,083,443738,32946,32585,1145,33730,433
2021-03-17,Santa Clara,085,1922200,112967,112983,632,113615,1805
2021-03-17,Santa Cruz,087,273765,15696,14967,800,15767,199
2021-03-17,Shasta,089,179085,11186,11045,1322,12367,100
2021-03-17,Sierra,091,2930,54,49,12,61,0
2021-03-17,Siskiyou,093,43540,1554,1479,252,1731,5
2021-03-17,Solano,095,438530,30467,30320,390,30710,171
2021-03-17,Sonoma,097,501317,28792,28877,248,29125,292
2021-03-17,Stanislaus,099,539301,52270,51524,5526,57050,682
2021-03-17,Sutter,101,95872,9056,8982,81,9063,103
2021-03-17,Tehama,103,63373,4714,4670,504,5174,34
2021-03-17,Trinity,105,12862,472,308,84,392,3
2021-03-17,Tulare,107,460477,49061,47929,8467,56396,805
2021-03-17,Tuolumne,109,53932,3877,3938,36,3974,57
2021-03-17,Ventura,111,848112,79346,78648,2852,81500,916
2021-03-17,Yolo,113,214977,13201,13169,244,13413,190
2021-03-17,Yuba,115,75493,5660,5603,93,5696,42
2021-03-16,Alameda,001,1643700,82811,82259,1773,84032,1177
2021-03-16,Alpine,003,1148,83,82,0,82,0
2021-03-16,Amador,005,37829,3525,3510,32,3542,44
2021-03-16,Butte,007,227075,11559,11154,1649,12803,184
2021-03-16,Calaveras,009,45235,1967,1945,12,1957,49
2021-03-16,Colusa,011,21464,1885,1882,272,2154,12
2021-03-16,Contra Costa,013,1133247,64901,63951,1113,65064,736
2021-03-16,Del Norte,015,27424,1106,1048,5,1053,6
2021-03-16,El Dorado,017,186661,9321,9249,599,9848,105
2021-03-16,Fresno,019,978130,98714,97638,8092,105730,1498
2021-03-16,Glenn,021,27897,2307,2267,515,2782,17
2021-03-16,Humboldt,023,135768,3386,3351,24,3375,33
2021-03-16,Imperial,025,180216,27451,27143,2650,29793,689
2021-03-16,Inyo,027,18085,1359,1346,9,1355,35
2021-03-16,Kern,029,883053,94779,93340,10179,103519,1144
2021-03-16,Kings,031,150075,22651,22320,1014,23334,233
2021-03-16,Lake,033,64148,3302,3246,8,3254,43
2021-03-16,Lassen,035,31185,5138,5126,101,5227,1
2021-03-16,Los Angeles,037,10098052,1181707,1172676,40003,1212679,22527
2021-03-16,Madera,039,155013,15975,15822,872,16694,214
2021-03-16,Marin,041,260295,13501,13419,188,13607,218
2021-03-16,Mariposa,043,17540,384,379,5,384,5
2021-03-16,Mendocino,045,87422,3718,3623,72,3695,44
2021-03-16,Merced,047,269075,29369,29198,920,30118,407
2021-03-16,Modoc,049,8938,350,341,120,461,3
2021-03-16,Mono,051,14174,1209,1207,16,1223,3
2021-03-16,Monterey,053,433212,42373,42023,1757,43780,334
2021-03-16,Napa,055,140530,9257,9209,34,9243,75
2021-03-16,Nevada,057,99092,4186,4132,170,4302,67
2021-03-16,Orange,059,3164182,249788,247843,10538,258381,4479
2021-03-16,Placer,061,380077,21196,20339,1193,21532,240
2021-03-16,Plumas,063,18699,659,643,10,653,4
2021-03-16,Riverside,065,2383286,288367,281540,13617,295157,3893
2021-03-16,Sacramento,067,1510023,97134,95522,1363,96885,1466
2021-03-16,San Benito,069,59416,5828,5831,92,5923,61
2021-03-16,San Bernardino,071,2135413,288125,283980,8667,292647,4032
2021-03-16,San Diego,073,3302833,268355,265903,13268,279171,3462
2021-03-16,San Francisco,075,870044,34834,34833,1161,35994,456
2021-03-16,San Joaquin,077,732212,68669,66856,2991,69847,1163
2021-03-16,San Luis Obispo,079,281455,20228,19832,602,20434,248
2021-03-16,San Mateo,081,765935,40315,39806,424,40230,344
2021-03-16,Santa Barbara,083,443738,32914,32556,1144,33700,433
2021-03-16,Santa Clara,085,1922200,112849,112845,629,113474,1797
2021-03-16,Santa Cruz,087,273765,15690,14926,800,15726,199
2021-03-16,Shasta,089,179085,11170,11035,1319,12354,100
2021-03-16,Sierra,091,2930,53,49,12,61,0
2021-03-16,Siskiyou,093,43540,1550,1477,252,1729,5
2021-03-16,Solano,095,438530,30433,30298,388,30686,171
2021-03-16,Sonoma,097,501317,28760,28850,246,29096,291
2021-03-16,Stanislaus,099,539301,52190,51410,5519,56929,683
2021-03-16,Sutter,101,95872,9048,8970,81,9051,102
2021-03-16,Tehama,103,63373,4710,4660,503,5163,34
2021-03-16,Trinity,105,12862,472,308,83,391,3
2021-03-16,Tulare,107,460477,49014,47895,8459,56354,803
2021-03-16,Tuolumne,109,53932,3874,3938,36,3974,57
2021-03-16,Ventura,111,848112,79279,78671,2845,81516,916
2021-03-16,Yolo,113,214977,13186,13162,244,13406,190
2021-03-16,Yuba,115,75493,5657,5596,92,5688,42
2021-03-15,Alameda,001,1643700,82723,82159,1773,83932,1167
2021-03-15,Alpine,003,1148,83,82,0,82,0
2021-03-15,Amador,005,37829,3524,3506,32,3538,44
2021-03-15,Butte,007,227075,11546,11141,1645,12786,185
2021-03-15,Calaveras,009,45235,1966,1941,12,1953,49
2021-03-15,Colusa,011,21464,1885,1883,272,2155,12
2021-03-15,Contra Costa,013,1133247,64839,63847,1112,64959,732
2021-03-15,Del Norte,015,27424,1103,1048,5,1053,6
2021-03-15,El Dorado,017,186661,9315,9235,598,9833,103
2021-03-15,Fresno,019,978130,98587,97520,8077,105597,1496
2021-03-15,Glenn,021,27897,2302,2261,512,2773,15
2021-03-15,Humboldt,023,135768,3380,3337,24,3361,32
2021-03-15,Imperial,025,180216,27430,27122,2648,29770,684
2021-03-15,Inyo,027,18085,1359,1346,9,1355,35
2021-03-15,Kern,029,883053,94719,93266,10172,103438,1141
2021-03-15,Kings,031,150075,22634,22294,1009,23303,233
2021-03-15,Lake,033,64148,3290,3237,8,3245,43
2021-03-15,Lassen,035,31185,5138,5125,101,5226,1
2021-03-15,Los Angeles,037,10098052,1181138,1172445,39968,1212413,22477
2021-03-15,Madera,039,155013,15964,15806,870,16676,214
2021-03-15,Marin,041,260295,13495,13408,187,13595,218
2021-03-15,Mariposa,043,17540,384,376,5,381,5
2021-03-15,Mendocino,045,87422,3714,3615,72,3687,44
2021-03-15,Merced,047,269075,29331,29169,918,30087,407
2021-03-15,Modoc,049,8938,350,340,120,460,3
2021-03-15,Mono,051,14174,1208,1206,16,1222,3
2021-03-15,Monterey,053,433212,42345,42011,1754,43765,333
2021-03-15,Napa,055,140530,9246,9196,34,9230,75
2021-03-15,Nevada,057,99092,4181,4123,169,4292,66
2021-03-15,Orange,059,3164182,249675,247697,10517,258214,4481
2021-03-15,Placer,061,380077,21173,20308,1193,21501,238
2021-03-15,Plumas,063,18699,659,642,10,652,4
2021-03-15,Riverside,065,2383286,288214,281367,13607,294974,3856
2021-03-15,Sacramento,067,1510023,96981,95414,1357,96771,1463
2021-03-15,San Benito,069,59416,5825,5831,92,5923,61
2021-03-15,San Bernardino,071,2135413,288032,283815,8659,292474,4004
2021-03-15,San Diego,073,3302833,268106,265646,13252,278898,3452
2021-03-15,San Francisco,075,870044,34799,34820,1157,35977,456
2021-03-15,San Joaquin,077,732212,68565,66622,2978,69600,1140
2021-03-15,San Luis Obispo,079,281455,20197,19813,598,20411,247
2021-03-15,San Mateo,081,765935,40261,39765,424,40189,344
2021-03-15,Santa Barbara,083,443738,32891,32529,1141,33670,431
2021-03-15,Santa Clara,085,1922200,112746,112729,627,113356,1798
2021-03-15,Santa Cruz,087,273765,15684,14899,798,15697,200
2021-03-15,Shasta,089,179085,11154,11019,1314,12333,92
2021-03-15,Sierra,091,2930,53,49,12,61,0
2021-03-15,Siskiyou,093,43540,1550,1475,252,1727,5
2021-03-15,Solano,095,438530,30404,30258,387,30645,171
2021-03-15,Sonoma,097,501317,28742,28814,243,29057,285
2021-03-15,Stanislaus,099,539301,52112,51357,5512,56869,683
2021-03-15,Sutter,101,95872,9042,8962,81,9043,102
2021-03-15,Tehama,103,63373,4700,4650,502,5152,34
2021-03-15,Trinity,105,12862,472,308,83,391,3
2021-03-15,Tulare,107,460477,48984,47857,8444,56301,800
2021-03-15,Tuolumne,109,53932,3872,3937,35,3972,57
2021-03-15,Ventura,111,848112,79225,78626,2844,81470,910
2021-03-15,Yolo,113,214977,13167,13131,242,13373,190
2021-03-15,Yuba,115,75493,5652,5585,91,5676,42
2021-03-14,Alameda,001,1643700,82637,82116,1770,83886,1168
2021-03-14,Alpine,003,1148,83,82,0,82,0
2021-03-14,Amador,005,37829,3519,3504,32,3536,44
2021-03-14,Butte,007,227075,11533,11140,1641,12781,185
2021-03-14,Calaveras,009,45235,1962,1939,12,1951,49
2021-03-14,Colusa,011,21464,1885,1883,272,2155,12
2021-03-14,Contra Costa,013,1133247,64734,63808,1111,64919,731
2021-03-14,Del Norte,015,27424,1089,1048,5,1053,6
2021-03-14,El Dorado,017,186661,9305,9231,598,9829,103
2021-03-14,Fresno,019,978130,98479,97461,8059,105520,1496
2021-03-14,Glenn,021,27897,2297,2260,509,2769,15
2021-03-14,Humboldt,023,135768,3366,3335,24,3359,32
2021-03-14,Imperial,025,180216,27412,27122,2644,29766,685
2021-03-14,Inyo,027,18085,1355,1346,9,1355,35
2021-03-14,Kern,029,883053,94636,93252,10154,103406,1141
2021-03-14,Kings,031,150075,22615,22292,1007,23299,232
2021-03-14,Lake,033,64148,3285,3237,8,3245,43
2021-03-14,Lassen,035,31185,5136,5125,101,5226,1
2021-03-14,Los Angeles,037,10098052,1180568,1172100,39932,1212032,22476
2021-03-14,Madera,039,155013,15939,15804,870,16674,214
2021-03-14,Marin,041,260295,13479,13405,185,13590,218
2021-03-14,Mariposa,043,17540,382,376,5,381,5
2021-03-14,Mendocino,045,87422,3709,3613,72,3685,44
2021-03-14,Merced,047,269075,29263,29149,914,30063,407
2021-03-14,Modoc,049,8938,350,340,120,460,3
2021-03-14,Mono,051,14174,1202,1206,16,1222,3
2021-03-14,Monterey,053,433212,42321,42007,1750,43757,333
2021-03-14,Napa,055,140530,9228,9194,34,9228,75
2021-03-14,Nevada,057,99092,4175,4122,167,4289,66
2021-03-14,Orange,059,3164182,249544,247656,10497,258153,4460
2021-03-14,Placer,061,380077,21138,20288,1185,21473,238
2021-03-14,Plumas,063,18699,657,642,10,652,4
2021-03-14,Riverside,065,2383286,288056,281332,13599,294931,3845
2021-03-14,Sacramento,067,1510023,96803,95343,1352,96695,1462
2021-03-14,San Benito,069,59416,5816,5829,92,5921,61
2021-03-14,San Bernardino,071,2135413,287908,283791,8648,292439,3996
2021-03-14,San Diego,073,3302833,267871,265468,13239,278707,3452
2021-03-14,San Francisco,075,870044,34760,34810,1154,35964,455
2021-03-14,San Joaquin,077,732212,68437,66563,2961,69524,1140
2021-03-14,San Luis Obispo,079,281455,20168,19806,596,20402,247
2021-03-14,San Mateo,081,765935,40222,39744,424,40168,342
2021-03-14,Santa Barbara,083,443738,32847,32514,1139,33653,431
2021-03-14,Santa Clara,085,1922200,112618,112648,626,113274,1796
2021-03-14,Santa Cruz,087,273765,15667,14887,796,15683,200
2021-03-14,Shasta,089,179085,11138,11019,1307,12326,92
2021-03-14,Sierra,091,2930,53,49,12,61,0
2021-03-14,Siskiyou,093,43540,1546,1473,251,1724,5
2021-03-14,Solano,095,438530,30372,30230,382,30612,171
2021-03-14,Sonoma,097,501317,28707,28798,239,29037,284
2021-03-14,Stanislaus,099,539301,51991,51306,5504,56810,690
2021-03-14,Sutter,101,95872,9026,8958,81,9039,102
2021-03-14,Tehama,103,63373,4688,4650,501,5151,34
2021-03-14,Trinity,105,12862,471,308,82,390,3
2021-03-14,Tulare,107,460477,48951,47845,8423,56268,800
2021-03-14,Tuolumne,109,53932,3870,3937,35,3972,57
2021-03-14,Ventura,111,848112,79172,78611,2838,81449,910
2021-03-14,Yolo,113,214977,13145,13128,238,13366,189
2021-03-14,Yuba,115,75493,5642,5583,91,5674,42
2021-03-13,Alameda,001,1643700,82577,82010,1770,83780,1168
2021-03-13,Alpine,003,1148,83,82,0,82,0
2021-03-13,Amador,005,37829,3516,3504,32,3536,44
2021-03-13,Butte,007,227075,11524,11131,1640,12771,185
2021-03-13,Calaveras,009,45235,1962,1939,12,1951,49
2021-03-13,Colusa,011,21464,1885,1882,272,2154,12
2021-03-13,Contra Costa,013,1133247,64673,63689,1111,64800,731
2021-03-13,Del Norte,015,27424,1085,1041,5,1046,6
2021-03-13,El Dorado,017,186661,9297,9221,598,9819,103
2021-03-13,Fresno,019,978130,98420,97324,8039,105363,1495
2021-03-13,Glenn,021,27897,2296,2260,508,2768,15
2021-03-13,Humboldt,023,135768,3359,3325,24,3349,32
2021-03-13,Imperial,025,180216,27407,27099,2639,29738,677
2021-03-13,Inyo,027,18085,1354,1344,9,1353,35
2021-03-13,Kern,029,883053,94597,93197,10148,103345,1140
2021-03-13,Kings,031,150075,22599,22265,1006,23271,232
2021-03-13,Lake,033,64148,3278,3234,7,3241,43
2021-03-13,Lassen,035,31185,5136,5125,101,5226,1
2021-03-13,Los Angeles,037,10098052,1180253,1171505,39889,1211394,22451
2021-03-13,Madera,039,155013,15927,15780,870,16650,214
2021-03-13,Marin,041,260295,13473,13391,183,13574,218
2021-03-13,Mariposa,043,17540,381,376,5,381,5
2021-03-13,Mendocino,045,87422,3705,3611,72,3683,44
2021-03-13,Merced,047,269075,29232,29106,914,30020,406
2021-03-13,Modoc,049,8938,350,340,119,459,3
2021-03-13,Mono,051,14174,1202,1207,16,1223,3
2021-03-13,Monterey,053,433212,42311,41989,1748,43737,332
2021-03-13,Napa,055,140530,9222,9190,34,9224,75
2021-03-13,Nevada,057,99092,4168,4111,166,4277,66
2021-03-13,Orange,059,3164182,249463,247514,10481,257995,4423
2021-03-13,Placer,061,380077,21117,20238,1182,21420,239
2021-03-13,Plumas,063,18699,655,642,10,652,4
2021-03-13,Riverside,065,2383286,287964,281191,13591,294782,3848
2021-03-13,Sacramento,067,1510023,96717,95192,1350,96542,1461
2021-03-13,San Benito,069,59416,5813,5823,92,5915,61
2021-03-13,San Bernardino,071,2135413,287855,283727,8642,292369,3972
2021-03-13,San Diego,073,3302833,267716,265270,13225,278495,3444
2021-03-13,San Francisco,075,870044,34743,34784,1145,35929,455
2021-03-13,San Joaquin,077,732212,68381,66480,2939,69419,1141
2021-03-13,San Luis Obispo,079,281455,20150,19789,595,20384,247
2021-03-13,San Mateo,081,765935,40195,39689,423,40112,341
2021-03-13,Santa Barbara,083,443738,32822,32486,1138,33624,431
2021-03-13,Santa Clara,085,1922200,112533,112531,625,113156,1790
2021-03-13,Santa Cruz,087,273765,15660,14875,796,15671,199
2021-03-13,Shasta,089,179085,11130,11021,1304,12325,108
2021-03-13,Sierra,091,2930,52,49,12,61,0
2021-03-13,Siskiyou,093,43540,1545,1470,251,1721,5
2021-03-13,Solano,095,438530,30355,30198,382,30580,171
2021-03-13,Sonoma,097,501317,28687,28762,235,28997,285
2021-03-13,Stanislaus,099,539301,51940,51257,5499,56756,695
2021-03-13,Sutter,101,95872,9019,8948,81,9029,102
2021-03-13,Tehama,103,63373,4686,4647,501,5148,33
2021-03-13,Trinity,105,12862,471,306,82,388,3
2021-03-13,Tulare,107,460477,48925,47818,8415,56233,798
2021-03-13,Tuolumne,109,53932,3867,3937,35,3972,57
2021-03-13,Ventura,111,848112,79123,78693,2838,81531,906
2021-03-13,Yolo,113,214977,13137,13087,237,13324,189
2021-03-13,Yuba,115,75493,5641,5577,91,5668,42
2021-03-12,Alameda,001,1643700,82501,81898,1769,83667,1164
2021-03-12,Alpine,003,1148,83,82,0,82,0
2021-03-12,Amador,005,37829,3513,3503,32,3535,44
2021-03-12,Butte,007,227075,11514,11126,1638,12764,184
2021-03-12,Calaveras,009,45235,1960,1916,12,1928,49
2021-03-12,Colusa,011,21464,1885,1883,272,2155,12
2021-03-12,Contra Costa,013,1133247,64597,63583,1111,64694,728
2021-03-12,Del Norte,015,27424,1079,1033,5,1038,6
2021-03-12,El Dorado,017,186661,9288,9219,598,9817,103
2021-03-12,Fresno,019,978130,98323,97185,8028,105213,1489
2021-03-12,Glenn,021,27897,2295,2258,507,2765,15
2021-03-12,Humboldt,023,135768,3354,3315,24,3339,32
2021-03-12,Imperial,025,180216,27396,27071,2637,29708,677
2021-03-12,Inyo,027,18085,1352,1339,9,1348,35
2021-03-12,Kern,029,883053,94563,93142,10132,103274,1132
2021-03-12,Kings,031,150075,22580,22233,1006,23239,232
2021-03-12,Lake,033,64148,3272,3226,6,3232,43
2021-03-12,Lassen,035,31185,5136,5125,100,5225,1
2021-03-12,Los Angeles,037,10098052,1179854,1170860,39872,1210732,22409
2021-03-12,Madera,039,155013,15915,15761,867,16628,214
2021-03-12,Marin,041,260295,13466,13375,183,13558,218
2021-03-12,Mariposa,043,17540,379,376,5,381,5
2021-03-12,Mendocino,045,87422,3702,3605,72,3677,43
2021-03-12,Merced,047,269075,29201,29064,914,29978,403
2021-03-12,Modoc,049,8938,350,340,119,459,3
2021-03-12,Mono,051,14174,1201,1206,16,1222,3
2021-03-12,Monterey,053,433212,42297,41964,1743,43707,329
2021-03-12,Napa,055,140530,9213,9180,34,9214,75
2021-03-12,Nevada,057,99092,4158,4101,166,4267,66
2021-03-12,Orange,059,3164182,249370,247388,10470,257858,4401
2021-03-12,Placer,061,380077,21084,20210,1177,21387,239
2021-03-12,Plumas,063,18699,654,641,10,651,4
2021-03-12,Riverside,065,2383286,287865,281037,13583,294620,3854
2021-03-12,Sacramento,067,1510023,96593,95061,1343,96404,1460
2021-03-12,San Benito,069,59416,5810,5817,92,5909,61
2021-03-12,San Bernardino,071,2135413,287798,283558,8637,292195,3917
2021-03-12,San Diego,073,3302833,267553,264886,13217,278103,3434
2021-03-12,San Francisco,075,870044,34722,34758,1142,35900,452
2021-03-12,San Joaquin,077,732212,68310,66482,2930,69412,1144
2021-03-12,San Luis Obispo,079,281455,20136,19769,593,20362,247
2021-03-12,San Mateo,081,765935,40159,39638,421,40059,341
2021-03-12,Santa Barbara,083,443738,32799,32457,1135,33592,429
2021-03-12,Santa Clara,085,1922200,112438,112396,624,113020,1766
2021-03-12,Santa Cruz,087,273765,15648,14846,794,15640,195
2021-03-12,Shasta,089,179085,11121,11143,1302,12445,153
2021-03-12,Sierra,091,2930,52,49,12,61,0
2021-03-12,Siskiyou,093,43540,1545,1468,250,1718,5
2021-03-12,Solano,095,438530,30336,30180,381,30561,171
2021-03-12,Sonoma,097,501317,28660,28714,235,28949,285
2021-03-12,Stanislaus,099,539301,51882,51146,5492,56638,701
2021-03-12,Sutter,101,95872,9013,8940,81,9021,101
2021-03-12,Tehama,103,63373,4682,4638,500,5138,33
2021-03-12,Trinity,105,12862,470,306,81,387,3
2021-03-12,Tulare,107,460477,48900,47772,8409,56181,798
2021-03-12,Tuolumne,109,53932,3866,3936,35,3971,57
2021-03-12,Ventura,111,848112,79080,78698,2834,81532,899
2021-03-12,Yolo,113,214977,13127,13061,230,13291,189
2021-03-12,Yuba,115,75493,5634,5563,90,5653,42
2021-03-11,Alameda,001,1643700,82408,81809,1764,83573,1164
2021-03-11,Alpine,003,1148,83,78,0,78,0
2021-03-11,Amador,005,37829,3512,3498,32,3530,42
2021-03-11,Butte,007,227075,11503,11110,1636,12746,185
2021-03-11,Calaveras,009,45235,1957,1915,12,1927,49
2021-03-11,Colusa,011,21464,1885,1883,272,2155,12
2021-03-11,Contra Costa,013,1133247,64524,63469,1109,64578,728
2021-03-11,Del Norte,015,27424,1074,1027,5,1032,6
2021-03-11,El Dorado,017,186661,9274,9211,598,9809,101
2021-03-11,Fresno,019,978130,98207,97026,7999,105025,1481
2021-03-11,Glenn,021,27897,2292,2255,507,2762,15
2021-03-11,Humboldt,023,135768,3337,3302,24,3326,32
2021-03-11,Imperial,025,180216,27389,27045,2634,29679,675
2021-03-11,Inyo,027,18085,1347,1335,9,1344,35
2021-03-11,Kern,029,883053,94507,93052,10093,103145,1121
2021-03-11,Kings,031,150075,22565,22183,1003,23186,230
2021-03-11,Lake,033,64148,3268,3214,6,3220,42
2021-03-11,Lassen,035,31185,5135,5124,100,5224,1
2021-03-11,Los Angeles,037,10098052,1179322,1170111,39840,1209951,22316
2021-03-11,Madera,039,155013,15904,15725,865,16590,214
2021-03-11,Marin,041,260295,13454,13356,182,13538,217
2021-03-11,Mariposa,043,17540,379,376,5,381,5
2021-03-11,Mendocino,045,87422,3695,3604,72,3676,42
2021-03-11,Merced,047,269075,29152,29001,913,29914,401
2021-03-11,Modoc,049,8938,350,340,119,459,3
2021-03-11,Mono,051,14174,1200,1206,16,1222,3
2021-03-11,Monterey,053,433212,42274,41936,1737,43673,329
2021-03-11,Napa,055,140530,9200,9173,34,9207,75
2021-03-11,Nevada,057,99092,4146,4085,164,4249,66
2021-03-11,Orange,059,3164182,249232,247217,10452,257669,4373
2021-03-11,Placer,061,380077,21041,20178,1173,21351,239
2021-03-11,Plumas,063,18699,653,640,10,650,4
2021-03-11,Riverside,065,2383286,287695,280881,13570,294451,3842
2021-03-11,Sacramento,067,1510023,96452,94912,1340,96252,1455
2021-03-11,San Benito,069,59416,5807,5816,92,5908,61
2021-03-11,San Bernardino,071,2135413,287701,283312,8631,291943,3869
2021-03-11,San Diego,073,3302833,267389,264524,13201,277725,3422
2021-03-11,San Francisco,075,870044,34686,34722,1136,35858,452
2021-03-11,San Joaquin,077,732212,68198,66522,2922,69444,1157
2021-03-11,San Luis Obispo,079,281455,20111,19748,592,20340,247
2021-03-11,San Mateo,081,765935,40122,39590,420,40010,341
2021-03-11,Santa Barbara,083,443738,32772,32408,1130,33538,430
2021-03-11,Santa Clara,085,1922200,112307,112246,621,112867,1765
2021-03-11,Santa Cruz,087,273765,15636,14812,793,15605,193
2021-03-11,Shasta,089,179085,11111,11139,1297,12436,158
2021-03-11,Sierra,091,2930,52,48,12,60,0
2021-03-11,Siskiyou,093,43540,1542,1466,250,1716,5
2021-03-11,Solano,095,438530,30308,30138,380,30518,171
2021-03-11,Sonoma,097,501317,28631,28677,235,28912,285
2021-03-11,Stanislaus,099,539301,51797,51038,5484,56522,707
2021-03-11,Sutter,101,95872,9007,8933,81,9014,101
2021-03-11,Tehama,103,63373,4673,4632,499,5131,33
2021-03-11,Trinity,105,12862,469,304,80,384,3
2021-03-11,Tulare,107,460477,48863,47709,8398,56107,797
2021-03-11,Tuolumne,109,53932,3864,3934,35,3969,57
2021-03-11,Ventura,111,848112,79030,78697,2830,81527,889
2021-03-11,Yolo,113,214977,13110,13041,228,13269,190
2021-03-11,Yuba,115,75493,5630,5553,90,5643,42
2021-03-10,Alameda,001,1643700,82301,81701,1759,83460,1160
2021-03-10,Alpine,003,1148,82,78,0,78,0
2021-03-10,Amador,005,37829,3510,3496,32,3528,42
2021-03-10,Butte,007,227075,11493,11096,1636,12732,185
2021-03-10,Calaveras,009,45235,1951,1913,12,1925,48
2021-03-10,Colusa,011,21464,1885,1882,272,2154,12
2021-03-10,Contra Costa,013,1133247,64425,63372,1105,64477,725
2021-03-10,Del Norte,015,27424,1072,1020,5,1025,5
2021-03-10,El Dorado,017,186661,9261,9203,598,9801,100
2021-03-10,Fresno,019,978130,98100,96866,7983,104849,1471
2021-03-10,Glenn,021,27897,2289,2253,505,2758,15
2021-03-10,Humboldt,023,135768,3327,3296,23,3319,32
2021-03-10,Imperial,025,180216,27374,27051,2634,29685,675
2021-03-10,Inyo,027,18085,1347,1328,9,1337,35
2021-03-10,Kern,029,883053,94441,92965,10072,103037,1102
2021-03-10,Kings,031,150075,22546,22166,1001,23167,226
2021-03-10,Lake,033,64148,3258,3207,6,3213,42
2021-03-10,Lassen,035,31185,5135,5120,100,5220,1
2021-03-10,Los Angeles,037,10098052,1178775,1169079,39813,1208892,22199
2021-03-10,Madera,039,155013,15883,15705,862,16567,212
2021-03-10,Marin,041,260295,13444,13348,181,13529,216
2021-03-10,Mariposa,043,17540,379,376,5,381,5
2021-03-10,Mendocino,045,87422,3690,3602,72,3674,42
2021-03-10,Merced,047,269075,29115,28927,910,29837,401
2021-03-10,Modoc,049,8938,349,338,119,457,3
2021-03-10,Mono,051,14174,1196,1204,16,1220,3
2021-03-10,Monterey,053,433212,42252,41920,1733,43653,329
2021-03-10,Napa,055,140530,9191,9165,34,9199,75
2021-03-10,Nevada,057,99092,4142,4074,164,4238,66
2021-03-10,Orange,059,3164182,249083,247075,10436,257511,4342
2021-03-10,Placer,061,380077,21006,20144,1167,21311,239
2021-03-10,Plumas,063,18699,652,639,10,649,4
2021-03-10,Riverside,065,2383286,287554,280708,13556,294264,3822
2021-03-10,Sacramento,067,1510023,96322,94796,1334,96130,1452
2021-03-10,San Benito,069,59416,5798,5811,92,5903,61
2021-03-10,San Bernardino,071,2135413,287608,283140,8625,291765,3841
2021-03-10,San Diego,073,3302833,267167,264094,13189,277283,3413
2021-03-10,San Francisco,075,870044,34651,34688,1128,35816,450
2021-03-10,San Joaquin,077,732212,68096,66483,2905,69388,1156
2021-03-10,San Luis Obispo,079,281455,20087,19710,588,20298,247
2021-03-10,San Mateo,081,765935,40098,39571,420,39991,338
2021-03-10,Santa Barbara,083,443738,32745,32356,1127,33483,429
2021-03-10,Santa Clara,085,1922200,112200,112103,617,112720,1759
2021-03-10,Santa Cruz,087,273765,15621,14790,792,15582,192
2021-03-10,Shasta,089,179085,11101,11125,1294,12419,155
2021-03-10,Sierra,091,2930,52,48,12,60,0
2021-03-10,Siskiyou,093,43540,1540,1458,250,1708,5
2021-03-10,Solano,095,438530,30278,30111,379,30490,170
2021-03-10,Sonoma,097,501317,28596,28638,234,28872,286
2021-03-10,Stanislaus,099,539301,51708,50968,5465,56433,706
2021-03-10,Sutter,101,95872,8996,8918,81,8999,101
2021-03-10,Tehama,103,63373,4663,4623,499,5122,33
2021-03-10,Trinity,105,12862,469,304,80,384,3
2021-03-10,Tulare,107,460477,48815,47659,8380,56039,793
2021-03-10,Tuolumne,109,53932,3863,3931,35,3966,57
2021-03-10,Ventura,111,848112,78953,78609,2828,81437,878
2021-03-10,Yolo,113,214977,13087,13021,227,13248,189
2021-03-10,Yuba,115,75493,5616,5545,89,5634,42
2021-03-09,Alameda,001,1643700,82214,81618,1759,83377,1151
2021-03-09,Alpine,003,1148,82,78,0,78,0
2021-03-09,Amador,005,37829,3508,3494,32,3526,42
2021-03-09,Butte,007,227075,11480,11092,1634,12726,185
2021-03-09,Calaveras,009,45235,1949,1913,12,1925,48
2021-03-09,Colusa,011,21464,1885,1880,272,2152,11
2021-03-09,Contra Costa,013,1133247,64332,63314,1103,64417,723
2021-03-09,Del Norte,015,27424,1064,1017,5,1022,5
2021-03-09,El Dorado,017,186661,9254,9198,598,9796,98
2021-03-09,Fresno,019,978130,97981,96744,7956,104700,1463
2021-03-09,Glenn,021,27897,2285,2251,503,2754,15
2021-03-09,Humboldt,023,135768,3315,3288,22,3310,32
2021-03-09,Imperial,025,180216,27365,27045,2630,29675,675
2021-03-09,Inyo,027,18085,1345,1324,9,1333,35
2021-03-09,Kern,029,883053,94362,92924,10054,102978,1088
2021-03-09,Kings,031,150075,22521,22143,999,23142,226
2021-03-09,Lake,033,64148,3252,3202,6,3208,42
2021-03-09,Lassen,035,31185,5135,5120,100,5220,1
2021-03-09,Los Angeles,037,10098052,1178178,1167967,39779,1207746,22080
2021-03-09,Madera,039,155013,15872,15701,860,16561,211
2021-03-09,Marin,041,260295,13426,13335,179,13514,214
2021-03-09,Mariposa,043,17540,379,376,5,381,5
2021-03-09,Mendocino,045,87422,3686,3595,72,3667,42
2021-03-09,Merced,047,269075,29053,28876,909,29785,399
2021-03-09,Modoc,049,8938,349,338,118,456,3
2021-03-09,Mono,051,14174,1195,1203,16,1219,3
2021-03-09,Monterey,053,433212,42233,41894,1725,43619,329
2021-03-09,Napa,055,140530,9177,9155,34,9189,75
2021-03-09,Nevada,057,99092,4134,4062,164,4226,66
2021-03-09,Orange,059,3164182,248940,246989,10416,257405,4310
2021-03-09,Placer,061,380077,20964,20122,1162,21284,239
2021-03-09,Plumas,063,18699,649,639,10,649,4
2021-03-09,Riverside,065,2383286,287419,280562,13552,294114,3821
2021-03-09,Sacramento,067,1510023,96154,94720,1328,96048,1442
2021-03-09,San Benito,069,59416,5794,5800,92,5892,61
2021-03-09,San Bernardino,071,2135413,287494,282971,8618,291589,3823
2021-03-09,San Diego,073,3302833,266935,263745,13168,276913,3405
2021-03-09,San Francisco,075,870044,34620,34654,1124,35778,450
2021-03-09,San Joaquin,077,732212,67968,66383,2895,69278,1150
2021-03-09,San Luis Obispo,079,281455,20069,19672,581,20253,245
2021-03-09,San Mateo,081,765935,40051,39535,418,39953,336
2021-03-09,Santa Barbara,083,443738,32704,32314,1125,33439,428
2021-03-09,Santa Clara,085,1922200,112089,111963,612,112575,1756
2021-03-09,Santa Cruz,087,273765,15599,14764,791,15555,188
2021-03-09,Shasta,089,179085,11094,11113,1289,12402,155
2021-03-09,Sierra,091,2930,52,48,12,60,0
2021-03-09,Siskiyou,093,43540,1536,1447,248,1695,5
2021-03-09,Solano,095,438530,30242,30090,377,30467,169
2021-03-09,Sonoma,097,501317,28546,28601,231,28832,284
2021-03-09,Stanislaus,099,539301,51611,50884,5456,56340,703
2021-03-09,Sutter,101,95872,8983,8914,81,8995,101
2021-03-09,Tehama,103,63373,4655,4620,498,5118,33
2021-03-09,Trinity,105,12862,469,304,80,384,3
2021-03-09,Tulare,107,460477,48788,47637,8359,55996,792
2021-03-09,Tuolumne,109,53932,3861,3929,35,3964,56
2021-03-09,Ventura,111,848112,78883,78526,2826,81352,863
2021-03-09,Yolo,113,214977,13076,13015,226,13241,189
2021-03-09,Yuba,115,75493,5609,5539,89,5628,42
2021-03-08,Alameda,001,1643700,82101,81543,1758,83301,1142
2021-03-08,Alpine,003,1148,82,78,0,78,0
2021-03-08,Amador,005,37829,3505,3490,32,3522,42
2021-03-08,Butte,007,227075,11465,11082,1633,12715,185
2021-03-08,Calaveras,009,45235,1945,1909,12,1921,48
2021-03-08,Colusa,011,21464,1885,1877,272,2149,11
2021-03-08,Contra Costa,013,1133247,64237,63240,1103,64343,719
2021-03-08,Del Norte,015,27424,1059,1012,5,1017,5
2021-03-08,El Dorado,017,186661,9251,9188,597,9785,97
2021-03-08,Fresno,019,978130,97882,96665,7935,104600,1442
2021-03-08,Glenn,021,27897,2284,2249,503,2752,15
2021-03-08,Humboldt,023,135768,3301,3278,22,3300,31
2021-03-08,Imperial,025,180216,27358,27033,2626,29659,663
2021-03-08,Inyo,027,18085,1343,1320,9,1329,35
2021-03-08,Kern,029,883053,94295,92857,10034,102891,1087
2021-03-08,Kings,031,150075,22500,22130,997,23127,226
2021-03-08,Lake,033,64148,3240,3195,6,3201,42
2021-03-08,Lassen,035,31185,5135,5119,100,5219,1
2021-03-08,Los Angeles,037,10098052,1177561,1163409,39747,1203156,21868
2021-03-08,Madera,039,155013,15862,15691,858,16549,211
2021-03-08,Marin,041,260295,13406,13328,177,13505,214
2021-03-08,Mariposa,043,17540,379,376,5,381,5
2021-03-08,Mendocino,045,87422,3684,3590,71,3661,42
2021-03-08,Merced,047,269075,28994,28841,908,29749,398
2021-03-08,Modoc,049,8938,349,338,118,456,3
2021-03-08,Mono,051,14174,1194,1200,16,1216,3
2021-03-08,Monterey,053,433212,42212,41863,1724,43587,328
2021-03-08,Napa,055,140530,9174,9146,34,9180,75
2021-03-08,Nevada,057,99092,4126,4059,164,4223,66
2021-03-08,Orange,059,3164182,248766,246900,10384,257284,4243
2021-03-08,Placer,061,380077,20929,20102,1151,21253,239
2021-03-08,Plumas,063,18699,648,635,10,645,4
2021-03-08,Riverside,065,2383286,287267,280463,13542,294005,3783
2021-03-08,Sacramento,067,1510023,95984,94654,1323,95977,1438
2021-03-08,San Benito,069,59416,5791,5797,92,5889,61
2021-03-08,San Bernardino,071,2135413,287385,282894,8611,291505,3811
2021-03-08,San Diego,073,3302833,266694,263272,13153,276425,3390
2021-03-08,San Francisco,075,870044,34593,34634,1120,35754,446
2021-03-08,San Joaquin,077,732212,67851,66307,2886,69193,1139
2021-03-08,San Luis Obispo,079,281455,20026,19656,578,20234,245
2021-03-08,San Mateo,081,765935,40002,39492,416,39908,335
2021-03-08,Santa Barbara,083,443738,32672,32293,1125,33418,427
2021-03-08,Santa Clara,085,1922200,111961,111882,610,112492,1756
2021-03-08,Santa Cruz,087,273765,15579,14729,791,15520,188
2021-03-08,Shasta,089,179085,11086,11088,1284,12372,155
2021-03-08,Sierra,091,2930,52,48,12,60,0
2021-03-08,Siskiyou,093,43540,1535,1440,248,1688,5
2021-03-08,Solano,095,438530,30202,30068,375,30443,169
2021-03-08,Sonoma,097,501317,28502,28571,230,28801,284
2021-03-08,Stanislaus,099,539301,51531,50825,5451,56276,690
2021-03-08,Sutter,101,95872,8980,8905,81,8986,100
2021-03-08,Tehama,103,63373,4652,4615,497,5112,33
2021-03-08,Trinity,105,12862,468,302,80,382,3
2021-03-08,Tulare,107,460477,48747,47587,8334,55921,791
2021-03-08,Tuolumne,109,53932,3860,3921,35,3956,56
2021-03-08,Ventura,111,848112,78812,78526,2818,81344,852
2021-03-08,Yolo,113,214977,13053,13000,225,13225,189
2021-03-08,Yuba,115,75493,5599,5530,89,5619,42
2021-03-07,Alameda,001,1643700,81983,81413,1757,83170,1145
2021-03-07,Alpine,003,1148,82,78,0,78,0
2021-03-07,Amador,005,37829,3502,3489,32,3521,42
2021-03-07,Butte,007,227075,11450,11075,1632,12707,185
2021-03-07,Calaveras,009,45235,1941,1906,12,1918,48
2021-03-07,Colusa,011,21464,1884,1876,272,2148,11
2021-03-07,Contra Costa,013,1133247,64138,63148,1101,64249,719
2021-03-07,Del Norte,015,27424,1054,1010,5,1015,5
2021-03-07,El Dorado,017,186661,9248,9184,596,9780,97
2021-03-07,Fresno,019,978130,97704,96549,7913,104462,1442
2021-03-07,Glenn,021,27897,2282,2244,503,2747,15
2021-03-07,Humboldt,023,135768,3291,3274,22,3296,31
2021-03-07,Imperial,025,180216,27349,27019,2623,29642,658
2021-03-07,Inyo,027,18085,1340,1320,9,1329,35
2021-03-07,Kern,029,883053,94208,92746,10004,102750,1086
2021-03-07,Kings,031,150075,22478,22103,996,23099,224
2021-03-07,Lake,033,64148,3234,3192,6,3198,42
2021-03-07,Lassen,035,31185,5134,5119,100,5219,1
2021-03-07,Los Angeles,037,10098052,1176837,1162749,39710,1202459,21857
2021-03-07,Madera,039,155013,15843,15675,858,16533,211
2021-03-07,Marin,041,260295,13398,13313,175,13488,214
2021-03-07,Mariposa,043,17540,378,376,5,381,5
2021-03-07,Mendocino,045,87422,3680,3581,71,3652,42
2021-03-07,Merced,047,269075,28920,28829,904,29733,399
2021-03-07,Modoc,049,8938,349,338,118,456,3
2021-03-07,Mono,051,14174,1192,1199,16,1215,3
2021-03-07,Monterey,053,433212,42190,41858,1721,43579,328
2021-03-07,Napa,055,140530,9164,9137,34,9171,75
2021-03-07,Nevada,057,99092,4112,4052,163,4215,66
2021-03-07,Orange,059,3164182,248574,246771,10356,257127,4218
2021-03-07,Placer,061,380077,20889,20070,1147,21217,239
2021-03-07,Plumas,063,18699,647,635,10,645,4
2021-03-07,Riverside,065,2383286,287118,280379,13533,293912,3779
2021-03-07,Sacramento,067,1510023,95807,94513,1316,95829,1437
2021-03-07,San Benito,069,59416,5784,5795,92,5887,61
2021-03-07,San Bernardino,071,2135413,287234,282860,8606,291466,3810
2021-03-07,San Diego,073,3302833,266413,262965,13129,276094,3390
2021-03-07,San Francisco,075,870044,34559,34594,1115,35709,445
2021-03-07,San Joaquin,077,732212,67715,66252,2872,69124,1139
2021-03-07,San Luis Obispo,079,281455,19989,19614,576,20190,245
2021-03-07,San Mateo,081,765935,39962,39436,413,39849,329
2021-03-07,Santa Barbara,083,443738,32625,32218,1124,33342,425
2021-03-07,Santa Clara,085,1922200,111816,111745,606,112351,1752
2021-03-07,Santa Cruz,087,273765,15557,14715,790,15505,189
2021-03-07,Shasta,089,179085,11073,11083,1276,12359,156
2021-03-07,Sierra,091,2930,51,48,12,60,0
2021-03-07,Siskiyou,093,43540,1532,1435,244,1679,5
2021-03-07,Solano,095,438530,30165,30027,375,30402,169
2021-03-07,Sonoma,097,501317,28453,28533,228,28761,284
2021-03-07,Stanislaus,099,539301,51399,50783,5434,56217,699
2021-03-07,Sutter,101,95872,8970,8900,81,8981,100
2021-03-07,Tehama,103,63373,4642,4614,494,5108,33
2021-03-07,Trinity,105,12862,468,302,80,382,3
2021-03-07,Tulare,107,460477,48688,47569,8303,55872,790
2021-03-07,Tuolumne,109,53932,3859,3922,34,3956,56
2021-03-07,Ventura,111,848112,78714,78487,2814,81301,851
2021-03-07,Yolo,113,214977,13034,12988,225,13213,189
2021-03-07,Yuba,115,75493,5594,5516,89,5605,42
2021-03-06,Alameda,001,1643700,81928,81310,1756,83066,1143
2021-03-06,Alpine,003,1148,82,78,0,78,0
2021-03-06,Amador,005,37829,3498,3487,32,3519,42
2021-03-06,Butte,007,227075,11447,11065,1631,12696,185
2021-03-06,Calaveras,009,45235,1938,1904,12,1916,48
2021-03-06,Colusa,011,21464,1882,1874,272,2146,11
2021-03-06,Contra Costa,013,1133247,64077,63040,1097,64137,719
2021-03-06,Del Norte,015,27424,1049,1000,5,1005,5
2021-03-06,El Dorado,017,186661,9244,9166,596,9762,97
2021-03-06,Fresno,019,978130,97609,96366,7902,104268,1440
2021-03-06,Glenn,021,27897,2282,2241,503,2744,15
2021-03-06,Humboldt,023,135768,3281,3260,22,3282,31
2021-03-06,Imperial,025,180216,27345,27009,2618,29627,658
2021-03-06,Inyo,027,18085,1337,1312,9,1321,35
2021-03-06,Kern,029,883053,94162,92684,9984,102668,1082
2021-03-06,Kings,031,150075,22463,22094,996,23090,224
2021-03-06,Lake,033,64148,3232,3189,6,3195,42
2021-03-06,Lassen,035,31185,5134,5119,100,5219,1
2021-03-06,Los Angeles,037,10098052,1176399,1161745,39680,1201425,21843
2021-03-06,Madera,039,155013,15834,15646,856,16502,211
2021-03-06,Marin,041,260295,13389,13289,175,13464,213
2021-03-06,Mariposa,043,17540,378,376,5,381,5
2021-03-06,Mendocino,045,87422,3678,3579,71,3650,42
2021-03-06,Merced,047,269075,28878,28771,904,29675,399
2021-03-06,Modoc,049,8938,348,338,118,456,3
2021-03-06,Mono,051,14174,1191,1198,16,1214,3
2021-03-06,Monterey,053,433212,42185,41838,1718,43556,327
2021-03-06,Napa,055,140530,9156,9129,34,9163,75
2021-03-06,Nevada,057,99092,4106,4044,163,4207,66
2021-03-06,Orange,059,3164182,248483,246634,10342,256976,4165
2021-03-06,Placer,061,380077,20866,20030,1145,21175,239
2021-03-06,Plumas,063,18699,647,634,10,644,4
2021-03-06,Riverside,065,2383286,287025,280225,13525,293750,3781
2021-03-06,Sacramento,067,1510023,95719,94332,1307,95639,1436
2021-03-06,San Benito,069,59416,5779,5793,92,5885,61
2021-03-06,San Bernardino,071,2135413,287150,282737,8604,291341,3791
2021-03-06,San Diego,073,3302833,266226,262778,13112,275890,3385
2021-03-06,San Francisco,075,870044,34528,34560,1111,35671,435
2021-03-06,San Joaquin,077,732212,67641,66162,2862,69024,1138
2021-03-06,San Luis Obispo,079,281455,19969,19592,574,20166,245
2021-03-06,San Mateo,081,765935,39937,39384,413,39797,329
2021-03-06,Santa Barbara,083,443738,32594,32176,1123,33299,424
2021-03-06,Santa Clara,085,1922200,111720,111570,604,112174,1749
2021-03-06,Santa Cruz,087,273765,15546,14701,790,15491,188
2021-03-06,Shasta,089,179085,11064,11076,1274,12350,158
2021-03-06,Sierra,091,2930,51,48,12,60,0
2021-03-06,Siskiyou,093,43540,1530,1432,244,1676,5
2021-03-06,Solano,095,438530,30136,30000,374,30374,169
2021-03-06,Sonoma,097,501317,28430,28484,226,28710,284
2021-03-06,Stanislaus,099,539301,51329,50691,5428,56119,711
2021-03-06,Sutter,101,95872,8964,8887,81,8968,100
2021-03-06,Tehama,103,63373,4642,4610,492,5102,33
2021-03-06,Trinity,105,12862,468,302,80,382,3
2021-03-06,Tulare,107,460477,48656,47515,8274,55789,789
2021-03-06,Tuolumne,109,53932,3857,3920,34,3954,56
2021-03-06,Ventura,111,848112,78659,78439,2813,81252,848
2021-03-06,Yolo,113,214977,13028,12951,225,13176,189
2021-03-06,Yuba,115,75493,5585,5504,89,5593,42
2021-03-05,Alameda,001,1643700,81838,81215,1754,82969,1141
2021-03-05,Alpine,003,1148,82,78,0,78,0
2021-03-05,Amador,005,37829,3497,3484,32,3516,42
2021-03-05,Butte,007,227075,11436,11050,1630,12680,185
2021-03-05,Calaveras,009,45235,1934,1902,12,1914,48
2021-03-05,Colusa,011,21464,1882,1874,272,2146,11
2021-03-05,Contra Costa,013,1133247,63997,62886,1094,63980,711
2021-03-05,Del Norte,015,27424,1045,995,5,1000,5
2021-03-05,El Dorado,017,186661,9239,9150,595,9745,97
2021-03-05,Fresno,019,978130,97501,96184,7883,104067,1432
2021-03-05,Glenn,021,27897,2279,2241,502,2743,15
2021-03-05,Humboldt,023,135768,3274,3234,22,3256,31
2021-03-05,Imperial,025,180216,27335,26970,2609,29579,651
2021-03-05,Inyo,027,18085,1333,1309,9,1318,35
2021-03-05,Kern,029,883053,94122,92601,9971,102572,1076
2021-03-05,Kings,031,150075,22445,22063,995,23058,224
2021-03-05,Lake,033,64148,3230,3185,6,3191,42
2021-03-05,Lassen,035,31185,5134,5117,98,5215,1
2021-03-05,Los Angeles,037,10098052,1175910,1160688,39649,1200337,21745
2021-03-05,Madera,039,155013,15824,15624,854,16478,211
2021-03-05,Marin,041,260295,13376,13275,174,13449,215
2021-03-05,Mariposa,043,17540,378,375,5,380,4
2021-03-05,Mendocino,045,87422,3675,3577,71,3648,42
2021-03-05,Merced,047,269075,28845,28734,903,29637,399
2021-03-05,Modoc,049,8938,348,337,118,455,3
2021-03-05,Mono,051,14174,1190,1197,16,1213,3
2021-03-05,Monterey,053,433212,42172,41802,1718,43520,325
2021-03-05,Napa,055,140530,9148,9109,34,9143,75
2021-03-05,Nevada,057,99092,4102,4033,163,4196,66
2021-03-05,Orange,059,3164182,248370,246489,10329,256818,4108
2021-03-05,Placer,061,380077,20840,19973,1141,21114,239
2021-03-05,Plumas,063,18699,647,635,10,645,4
2021-03-05,Riverside,065,2383286,286913,280075,13520,293595,3781
2021-03-05,Sacramento,067,1510023,95623,94182,1300,95482,1430
2021-03-05,San Benito,069,59416,5776,5790,92,5882,61
2021-03-05,San Bernardino,071,2135413,287057,282640,8600,291240,3774
2021-03-05,San Diego,073,3302833,265993,262357,13095,275452,3371
2021-03-05,San Francisco,075,870044,34488,34526,1107,35633,430
2021-03-05,San Joaquin,077,732212,67561,66041,2853,68894,1133
2021-03-05,San Luis Obispo,079,281455,19948,19557,572,20129,244
2021-03-05,San Mateo,081,765935,39905,39305,413,39718,326
2021-03-05,Santa Barbara,083,443738,32557,32139,1118,33257,424
2021-03-05,Santa Clara,085,1922200,111624,111384,604,111988,1745
2021-03-05,Santa Cruz,087,273765,15535,14694,790,15484,188
2021-03-05,Shasta,089,179085,11052,11062,1268,12330,148
2021-03-05,Sierra,091,2930,51,48,12,60,0
2021-03-05,Siskiyou,093,43540,1526,1429,243,1672,5
2021-03-05,Solano,095,438530,30119,29951,372,30323,168
2021-03-05,Sonoma,097,501317,28404,28417,226,28643,279
2021-03-05,Stanislaus,099,539301,51278,50606,5418,56024,721
2021-03-05,Sutter,101,95872,8957,8876,81,8957,100
2021-03-05,Tehama,103,63373,4633,4606,492,5098,33
2021-03-05,Trinity,105,12862,468,302,80,382,3
2021-03-05,Tulare,107,460477,48627,47469,8255,55724,789
2021-03-05,Tuolumne,109,53932,3855,3917,34,3951,56
2021-03-05,Ventura,111,848112,78592,78368,2812,81180,839
2021-03-05,Yolo,113,214977,13016,12920,224,13144,188
2021-03-05,Yuba,115,75493,5573,5496,89,5585,42
2021-03-04,Alameda,001,1643700,81729,81115,1754,82869,1136
2021-03-04,Alpine,003,1148,82,78,0,78,0
2021-03-04,Amador,005,37829,3496,3480,32,3512,42
2021-03-04,Butte,007,227075,11429,11033,1629,12662,185
2021-03-04,Calaveras,009,45235,1933,1896,12,1908,48
2021-03-04,Colusa,011,21464,1880,1873,267,2140,11
2021-03-04,Contra Costa,013,1133247,63898,62789,1092,63881,708
2021-03-04,Del Norte,015,27424,1037,989,5,994,5
2021-03-04,El Dorado,017,186661,9224,9133,595,9728,97
2021-03-04,Fresno,019,978130,97337,96023,7863,103886,1422
2021-03-04,Glenn,021,27897,2272,2236,501,2737,15
2021-03-04,Humboldt,023,135768,3260,3212,22,3234,31
2021-03-04,Imperial,025,180216,27323,26946,2606,29552,646
2021-03-04,Inyo,027,18085,1330,1300,9,1309,35
2021-03-04,Kern,029,883053,94033,92525,9952,102477,1070
2021-03-04,Kings,031,150075,22419,22025,992,23017,224
2021-03-04,Lake,033,64148,3222,3181,6,3187,42
2021-03-04,Lassen,035,31185,5134,5116,98,5214,1
2021-03-04,Los Angeles,037,10098052,1175301,1159405,39601,1199006,21610
2021-03-04,Madera,039,155013,15789,15596,851,16447,208
2021-03-04,Marin,041,260295,13359,13240,171,13411,215
2021-03-04,Mariposa,043,17540,378,376,5,381,4
2021-03-04,Mendocino,045,87422,3672,3569,71,3640,42
2021-03-04,Merced,047,269075,28794,28671,900,29571,396
2021-03-04,Modoc,049,8938,347,336,118,454,3
2021-03-04,Mono,051,14174,1190,1197,16,1213,3
2021-03-04,Monterey,053,433212,42152,41771,1716,43487,325
2021-03-04,Napa,055,140530,9140,9094,34,9128,74
2021-03-04,Nevada,057,99092,4092,4020,163,4183,66
2021-03-04,Orange,059,3164182,248213,246354,10312,256666,4096
2021-03-04,Placer,061,380077,20808,19900,1135,21035,239
2021-03-04,Plumas,063,18699,647,634,10,644,4
2021-03-04,Riverside,065,2383286,286783,279871,13507,293378,3766
2021-03-04,Sacramento,067,1510023,95488,93982,1297,95279,1426
2021-03-04,San Benito,069,59416,5776,5781,92,5873,61
2021-03-04,San Bernardino,071,2135413,286927,282407,8596,291003,3757
2021-03-04,San Diego,073,3302833,265734,261858,13051,274909,3359
2021-03-04,San Francisco,075,870044,34454,34480,1104,35584,426
2021-03-04,San Joaquin,077,732212,67467,65931,2843,68774,1129
2021-03-04,San Luis Obispo,079,281455,19910,19520,570,20090,243
2021-03-04,San Mateo,081,765935,39861,39225,412,39637,322
2021-03-04,Santa Barbara,083,443738,32520,32090,1117,33207,423
2021-03-04,Santa Clara,085,1922200,111490,111194,602,111796,1723
2021-03-04,Santa Cruz,087,273765,15516,14669,790,15459,186
2021-03-04,Shasta,089,179085,11049,11050,1259,12309,150
2021-03-04,Sierra,091,2930,51,48,12,60,0
2021-03-04,Siskiyou,093,43540,1520,1427,243,1670,5
2021-03-04,Solano,095,438530,30092,29905,371,30276,168
2021-03-04,Sonoma,097,501317,28349,28379,225,28604,279
2021-03-04,Stanislaus,099,539301,51189,50521,5410,55931,731
2021-03-04,Sutter,101,95872,8945,8849,81,8930,100
2021-03-04,Tehama,103,63373,4627,4604,492,5096,33
2021-03-04,Trinity,105,12862,468,302,80,382,3
2021-03-04,Tulare,107,460477,48582,47398,8230,55628,784
2021-03-04,Tuolumne,109,53932,3849,3916,34,3950,56
2021-03-04,Ventura,111,848112,78505,78184,2810,80994,831
2021-03-04,Yolo,113,214977,12996,12895,224,13119,189
2021-03-04,Yuba,115,75493,5561,5483,89,5572,41
2021-03-03,Alameda,001,1643700,81608,80972,1753,82725,1127
2021-03-03,Alpine,003,1148,82,77,0,77,0
2021-03-03,Amador,005,37829,3494,3478,31,3509,42
2021-03-03,Butte,007,227075,11422,11014,1628,12642,184
2021-03-03,Calaveras,009,45235,1932,1893,12,1905,48
2021-03-03,Colusa,011,21464,1879,1873,267,2140,11
2021-03-03,Contra Costa,013,1133247,63800,62668,1089,63757,708
2021-03-03,Del Norte,015,27424,1034,988,5,993,5
2021-03-03,El Dorado,017,186661,9214,9121,595,9716,97
2021-03-03,Fresno,019,978130,97193,95893,7845,103738,1415
2021-03-03,Glenn,021,27897,2272,2233,501,2734,15
2021-03-03,Humboldt,023,135768,3249,3196,22,3218,30
2021-03-03,Imperial,025,180216,27306,26939,2601,29540,640
2021-03-03,Inyo,027,18085,1322,1294,9,1303,35
2021-03-03,Kern,029,883053,93957,92434,9935,102369,1063
2021-03-03,Kings,031,150075,22403,22009,991,23000,223
2021-03-03,Lake,033,64148,3215,3175,6,3181,40
2021-03-03,Lassen,035,31185,5134,5115,98,5213,1
2021-03-03,Los Angeles,037,10098052,1174661,1157911,39560,1197471,21500
2021-03-03,Madera,039,155013,15770,15553,845,16398,203
2021-03-03,Marin,041,260295,13346,13216,171,13387,214
2021-03-03,Mariposa,043,17540,377,376,5,381,4
2021-03-03,Mendocino,045,87422,3664,3564,71,3635,42
2021-03-03,Merced,047,269075,28742,28625,900,29525,393
2021-03-03,Modoc,049,8938,347,333,117,450,3
2021-03-03,Mono,051,14174,1190,1191,16,1207,3
2021-03-03,Monterey,053,433212,42119,41731,1713,43444,325
2021-03-03,Napa,055,140530,9132,9090,34,9124,72
2021-03-03,Nevada,057,99092,4082,4009,163,4172,66
2021-03-03,Orange,059,3164182,248068,246120,10297,256417,4072
2021-03-03,Placer,061,380077,20782,19851,1132,20983,239
2021-03-03,Plumas,063,18699,646,631,10,641,4
2021-03-03,Riverside,065,2383286,286650,279626,13501,293127,3735
2021-03-03,Sacramento,067,1510023,95327,93819,1289,95108,1419
2021-03-03,San Benito,069,59416,5775,5774,92,5866,61
2021-03-03,San Bernardino,071,2135413,286785,282138,8589,290727,3664
2021-03-03,San Diego,073,3302833,265471,261350,13020,274370,3342
2021-03-03,San Francisco,075,870044,34422,34443,1101,35544,426
2021-03-03,San Joaquin,077,732212,67355,65855,2836,68691,1115
2021-03-03,San Luis Obispo,079,281455,19884,19479,567,20046,241
2021-03-03,San Mateo,081,765935,39815,39189,411,39600,319
2021-03-03,Santa Barbara,083,443738,32482,32027,1117,33144,421
2021-03-03,Santa Clara,085,1922200,111335,110991,600,111591,1720
2021-03-03,Santa Cruz,087,273765,15505,14645,790,15435,185
2021-03-03,Shasta,089,179085,11039,11023,1252,12275,150
2021-03-03,Sierra,091,2930,51,48,12,60,0
2021-03-03,Siskiyou,093,43540,1518,1424,243,1667,5
2021-03-03,Solano,095,438530,30056,29866,370,30236,167
2021-03-03,Sonoma,097,501317,28310,28307,224,28531,279
2021-03-03,Stanislaus,099,539301,51111,50438,5403,55841,730
2021-03-03,Sutter,101,95872,8936,8840,81,8921,99
2021-03-03,Tehama,103,63373,4624,4601,492,5093,32
2021-03-03,Trinity,105,12862,468,302,80,382,3
2021-03-03,Tulare,107,460477,48531,47348,8199,55547,778
2021-03-03,Tuolumne,109,53932,3847,3914,33,3947,56
2021-03-03,Ventura,111,848112,78422,78057,2804,80861,822
2021-03-03,Yolo,113,214977,12983,12890,224,13114,189
2021-03-03,Yuba,115,75493,5548,5479,89,5568,41
2021-03-02,Alameda,001,1643700,81489,80904,1751,82655,1116
2021-03-02,Alpine,003,1148,82,77,0,77,0
2021-03-02,Amador,005,37829,3492,3474,31,3505,42
2021-03-02,Butte,007,227075,11412,11007,1626,12633,182
2021-03-02,Calaveras,009,45235,1924,1890,12,1902,48
2021-03-02,Colusa,011,21464,1879,1872,266,2138,11
2021-03-02,Contra Costa,013,1133247,63689,62557,1085,63642,694
2021-03-02,Del Norte,015,27424,1027,983,5,988,5
2021-03-02,El Dorado,017,186661,9206,9116,595,9711,98
2021-03-02,Fresno,019,978130,97047,95785,7819,103604,1410
2021-03-02,Glenn,021,27897,2266,2232,500,2732,15
2021-03-02,Humboldt,023,135768,3230,3184,22,3206,30
2021-03-02,Imperial,025,180216,27296,26926,2599,29525,637
2021-03-02,Inyo,027,18085,1318,1292,9,1301,35
2021-03-02,Kern,029,883053,93851,92313,9908,102221,1046
2021-03-02,Kings,031,150075,22351,21999,989,22988,217
2021-03-02,Lake,033,64148,3209,3169,6,3175,40
2021-03-02,Lassen,035,31185,5129,5115,97,5212,1
2021-03-02,Los Angeles,037,10098052,1174024,1156826,39514,1196340,21395
2021-03-02,Madera,039,155013,15750,15523,842,16365,194
2021-03-02,Marin,041,260295,13323,13186,170,13356,214
2021-03-02,Mariposa,043,17540,377,376,5,381,4
2021-03-02,Mendocino,045,87422,3661,3562,70,3632,41
2021-03-02,Merced,047,269075,28685,28598,900,29498,389
2021-03-02,Modoc,049,8938,347,332,117,449,3
2021-03-02,Mono,051,14174,1189,1191,16,1207,3
2021-03-02,Monterey,053,433212,42092,41716,1711,43427,325
2021-03-02,Napa,055,140530,9120,9080,34,9114,71
2021-03-02,Nevada,057,99092,4073,3983,162,4145,66
2021-03-02,Orange,059,3164182,247922,246004,10280,256284,4037
2021-03-02,Placer,061,380077,20729,19828,1129,20957,239
2021-03-02,Plumas,063,18699,643,628,10,638,4
2021-03-02,Riverside,065,2383286,286477,279486,13493,292979,3721
2021-03-02,Sacramento,067,1510023,95160,93690,1287,94977,1411
2021-03-02,San Benito,069,59416,5768,5770,92,5862,60
2021-03-02,San Bernardino,071,2135413,286652,281919,8583,290502,3604
2021-03-02,San Diego,073,3302833,265227,260998,12998,273996,3317
2021-03-02,San Francisco,075,870044,34382,34387,1097,35484,424
2021-03-02,San Joaquin,077,732212,67247,65769,2818,68587,1111
2021-03-02,San Luis Obispo,079,281455,19851,19452,567,20019,241
2021-03-02,San Mateo,081,765935,39763,39148,410,39558,317
2021-03-02,Santa Barbara,083,443738,32433,31964,1113,33077,416
2021-03-02,Santa Clara,085,1922200,111156,110832,599,111431,1706
2021-03-02,Santa Cruz,087,273765,15491,14611,788,15399,185
2021-03-02,Shasta,089,179085,11025,11012,1241,12253,149
2021-03-02,Sierra,091,2930,51,48,12,60,0
2021-03-02,Siskiyou,093,43540,1514,1412,241,1653,5
2021-03-02,Solano,095,438530,30023,29827,368,30195,167
2021-03-02,Sonoma,097,501317,28255,28261,224,28485,279
2021-03-02,Stanislaus,099,539301,51024,50359,5390,55749,724
2021-03-02,Sutter,101,95872,8927,8832,81,8913,99
2021-03-02,Tehama,103,63373,4622,4597,492,5089,32
2021-03-02,Trinity,105,12862,468,301,80,381,3
2021-03-02,Tulare,107,460477,48468,47326,8179,55505,783
2021-03-02,Tuolumne,109,53932,3843,3908,33,3941,53
2021-03-02,Ventura,111,848112,78330,77952,2800,80752,780
2021-03-02,Yolo,113,214977,12966,12867,224,13091,189
2021-03-02,Yuba,115,75493,5540,5475,89,5564,41
2021-03-01,Alameda,001,1643700,81363,80805,1749,82554,1105
2021-03-01,Alpine,003,1148,80,77,0,77,0
2021-03-01,Amador,005,37829,3489,3469,31,3500,42
2021-03-01,Butte,007,227075,11396,10981,1621,12602,180
2021-03-01,Calaveras,009,45235,1920,1885,12,1897,46
2021-03-01,Colusa,011,21464,1878,1871,266,2137,11
2021-03-01,Contra Costa,013,1133247,63579,62458,1084,63542,694
2021-03-01,Del Norte,015,27424,1022,982,5,987,5
2021-03-01,El Dorado,017,186661,9182,9085,595,9680,98
2021-03-01,Fresno,019,978130,96909,95677,7797,103474,1405
2021-03-01,Glenn,021,27897,2261,2232,499,2731,15
2021-03-01,Humboldt,023,135768,3211,3179,22,3201,30
2021-03-01,Imperial,025,180216,27286,26913,2591,29504,636
2021-03-01,Inyo,027,18085,1315,1285,9,1294,35
2021-03-01,Kern,029,883053,93762,92219,9882,102101,1041
2021-03-01,Kings,031,150075,22334,21988,983,22971,217
2021-03-01,Lake,033,64148,3204,3164,6,3170,40
2021-03-01,Lassen,035,31185,5127,5111,97,5208,1
2021-03-01,Los Angeles,037,10098052,1173366,1155984,39472,1195456,21293
2021-03-01,Madera,039,155013,15721,15505,831,16336,194
2021-03-01,Marin,041,260295,13296,13161,169,13330,214
2021-03-01,Mariposa,043,17540,377,375,5,380,4
2021-03-01,Mendocino,045,87422,3654,3561,70,3631,41
2021-03-01,Merced,047,269075,28640,28575,896,29471,385
2021-03-01,Modoc,049,8938,344,331,116,447,3
2021-03-01,Mono,051,14174,1188,1192,16,1208,3
2021-03-01,Monterey,053,433212,42067,41697,1709,43406,324
2021-03-01,Napa,055,140530,9111,9056,34,9090,70
2021-03-01,Nevada,057,99092,4054,3979,162,4141,66
2021-03-01,Orange,059,3164182,247727,245852,10265,256117,3976
2021-03-01,Placer,061,380077,20690,19803,1126,20929,239
2021-03-01,Plumas,063,18699,643,628,10,638,4
2021-03-01,Riverside,065,2383286,286260,279323,13486,292809,3680
2021-03-01,Sacramento,067,1510023,95015,93546,1285,94831,1401
2021-03-01,San Benito,069,59416,5763,5772,92,5864,57
2021-03-01,San Bernardino,071,2135413,286509,281685,8579,290264,3603
2021-03-01,San Diego,073,3302833,264909,260622,12965,273587,3303
2021-03-01,San Francisco,075,870044,34338,34318,1089,35407,424
2021-03-01,San Joaquin,077,732212,67137,65699,2807,68506,1097
2021-03-01,San Luis Obispo,079,281455,19829,19429,565,19994,239
2021-03-01,San Mateo,081,765935,39711,39096,409,39505,314
2021-03-01,Santa Barbara,083,443738,32390,31909,1112,33021,413
2021-03-01,Santa Clara,085,1922200,110998,110684,596,111280,1704
2021-03-01,Santa Cruz,087,273765,15472,14575,787,15362,185
2021-03-01,Shasta,089,179085,11013,10990,1238,12228,149
2021-03-01,Sierra,091,2930,51,48,12,60,0
2021-03-01,Siskiyou,093,43540,1510,1408,239,1647,5
2021-03-01,Solano,095,438530,29980,29779,367,30146,166
2021-03-01,Sonoma,097,501317,28207,28222,222,28444,278
2021-03-01,Stanislaus,099,539301,50949,50293,5384,55677,722
2021-03-01,Sutter,101,95872,8915,8825,81,8906,99
2021-03-01,Tehama,103,63373,4618,4595,492,5087,32
2021-03-01,Trinity,105,12862,468,298,79,377,3
2021-03-01,Tulare,107,460477,48430,47275,8146,55421,781
2021-03-01,Tuolumne,109,53932,3840,3907,33,3940,53
2021-03-01,Ventura,111,848112,78248,77849,2798,80647,775
2021-03-01,Yolo,113,214977,12949,12854,222,13076,188
2021-03-01,Yuba,115,75493,5528,5466,89,5555,41
2021-02-28,Alameda,001,1643700,81242,80727,1747,82474,1105
2021-02-28,Alpine,003,1148,80,77,0,77,0
2021-02-28,Amador,005,37829,3484,3466,30,3496,42
2021-02-28,Butte,007,227075,11381,10970,1621,12591,180
2021-02-28,Calaveras,009,45235,1915,1881,12,1893,46
2021-02-28,Colusa,011,21464,1878,1871,265,2136,11
2021-02-28,Contra Costa,013,1133247,63452,62386,1079,63465,694
2021-02-28,Del Norte,015,27424,1020,981,5,986,5
2021-02-28,El Dorado,017,186661,9171,9082,595,9677,98
2021-02-28,Fresno,019,978130,96727,95548,7763,103311,1405
2021-02-28,Glenn,021,27897,2259,2230,497,2727,15
2021-02-28,Humboldt,023,135768,3188,3179,22,3201,30
2021-02-28,Imperial,025,180216,27259,26909,2584,29493,636
2021-02-28,Inyo,027,18085,1310,1282,9,1291,35
2021-02-28,Kern,029,883053,93647,92169,9861,102030,1012
2021-02-28,Kings,031,150075,22313,21967,982,22949,217
2021-02-28,Lake,033,64148,3199,3164,6,3170,40
2021-02-28,Lassen,035,31185,5126,5106,97,5203,1
2021-02-28,Los Angeles,037,10098052,1172579,1155141,39411,1194552,21261
2021-02-28,Madera,039,155013,15679,15496,828,16324,199
2021-02-28,Marin,041,260295,13273,13152,167,13319,214
2021-02-28,Mariposa,043,17540,377,374,5,379,4
2021-02-28,Mendocino,045,87422,3648,3558,70,3628,41
2021-02-28,Merced,047,269075,28576,28546,895,29441,384
2021-02-28,Modoc,049,8938,344,331,116,447,3
2021-02-28,Mono,051,14174,1185,1192,16,1208,3
2021-02-28,Monterey,053,433212,42035,41683,1708,43391,323
2021-02-28,Napa,055,140530,9092,9053,34,9087,70
2021-02-28,Nevada,057,99092,4041,3972,162,4134,66
2021-02-28,Orange,059,3164182,247528,245706,10258,255964,3970
2021-02-28,Placer,061,380077,20644,19775,1124,20899,239
2021-02-28,Plumas,063,18699,643,628,10,638,4
2021-02-28,Riverside,065,2383286,286027,279214,13475,292689,3661
2021-02-28,Sacramento,067,1510023,94831,93463,1280,94743,1398
2021-02-28,San Benito,069,59416,5752,5772,92,5864,57
2021-02-28,San Bernardino,071,2135413,286368,281620,8567,290187,3595
2021-02-28,San Diego,073,3302833,264613,260353,12931,273284,3303
2021-02-28,San Francisco,075,870044,34296,34291,1083,35374,417
2021-02-28,San Joaquin,077,732212,67029,65662,2798,68460,1097
2021-02-28,San Luis Obispo,079,281455,19793,19422,563,19985,237
2021-02-28,San Mateo,081,765935,39658,39059,408,39467,314
2021-02-28,Santa Barbara,083,443738,32337,31877,1112,32989,413
2021-02-28,Santa Clara,085,1922200,110799,110556,593,111149,1704
2021-02-28,Santa Cruz,087,273765,15443,14571,784,15355,185
2021-02-28,Shasta,089,179085,10992,10990,1234,12224,149
2021-02-28,Sierra,091,2930,51,48,12,60,0
2021-02-28,Siskiyou,093,43540,1502,1408,238,1646,5
2021-02-28,Solano,095,438530,29924,29758,361,30119,166
2021-02-28,Sonoma,097,501317,28144,28193,221,28414,279
2021-02-28,Stanislaus,099,539301,50859,50228,5371,55599,728
2021-02-28,Sutter,101,95872,8900,8825,81,8906,99
2021-02-28,Tehama,103,63373,4611,4590,492,5082,32
2021-02-28,Trinity,105,12862,468,298,79,377,3
2021-02-28,Tulare,107,460477,48368,47258,8115,55373,780
2021-02-28,Tuolumne,109,53932,3835,3905,33,3938,53
2021-02-28,Ventura,111,848112,78137,77749,2795,80544,775
2021-02-28,Yolo,113,214977,12927,12851,222,13073,188
2021-02-28,Yuba,115,75493,5518,5461,89,5550,41
2021-02-27,Alameda,001,1643700,81170,80565,1745,82310,1108
2021-02-27,Alpine,003,1148,80,77,0,77,0
2021-02-27,Amador,005,37829,3482,3463,30,3493,42
2021-02-27,Butte,007,227075,11369,10962,1621,12583,180
2021-02-27,Calaveras,009,45235,1910,1875,12,1887,46
2021-02-27,Colusa,011,21464,1877,1869,265,2134,11
2021-02-27,Contra Costa,013,1133247,63381,62248,1076,63324,693
2021-02-27,Del Norte,015,27424,1018,978,5,983,5
2021-02-27,El Dorado,017,186661,9167,9072,595,9667,98
2021-02-27,Fresno,019,978130,96650,95393,7752,103145,1400
2021-02-27,Glenn,021,27897,2258,2225,496,2721,15
2021-02-27,Humboldt,023,135768,3182,3167,22,3189,30
2021-02-27,Imperial,025,180216,27251,26903,2583,29486,633
2021-02-27,Inyo,027,18085,1307,1275,9,1284,35
2021-02-27,Kern,029,883053,93586,92053,9846,101899,996
2021-02-27,Kings,031,150075,22303,21955,979,22934,216
2021-02-27,Lake,033,64148,3196,3156,6,3162,40
2021-02-27,Lassen,035,31185,5126,5106,97,5203,1
2021-02-27,Los Angeles,037,10098052,1172083,1154275,39384,1193659,21158
2021-02-27,Madera,039,155013,15662,15467,827,16294,199
2021-02-27,Marin,041,260295,13249,13134,167,13301,214
2021-02-27,Mariposa,043,17540,377,374,5,379,4
2021-02-27,Mendocino,045,87422,3645,3555,70,3625,41
2021-02-27,Merced,047,269075,28534,28501,887,29388,384
2021-02-27,Modoc,049,8938,344,331,115,446,3
2021-02-27,Mono,051,14174,1183,1191,16,1207,3
2021-02-27,Monterey,053,433212,42026,41665,1708,43373,322
2021-02-27,Napa,055,140530,9081,9038,34,9072,71
2021-02-27,Nevada,057,99092,4035,3960,162,4122,66
2021-02-27,Orange,059,3164182,247401,245542,10247,255789,3960
2021-02-27,Placer,061,380077,20608,19726,1121,20847,239
2021-02-27,Plumas,063,18699,643,628,10,638,4
2021-02-27,Riverside,065,2383286,285916,279048,13465,292513,3663
2021-02-27,Sacramento,067,1510023,94748,93281,1270,94551,1396
2021-02-27,San Benito,069,59416,5751,5767,91,5858,57
2021-02-27,San Bernardino,071,2135413,286289,281471,8560,290031,3527
2021-02-27,San Diego,073,3302833,264423,260091,12893,272984,3284
2021-02-27,San Francisco,075,870044,34262,34260,1080,35340,413
2021-02-27,San Joaquin,077,732212,66983,65578,2796,68374,1100
2021-02-27,San Luis Obispo,079,281455,19772,19411,562,19973,237
2021-02-27,San Mateo,081,765935,39617,38998,407,39405,313
2021-02-27,Santa Barbara,083,443738,32303,31805,1111,32916,411
2021-02-27,Santa Clara,085,1922200,110651,110361,591,110952,1703
2021-02-27,Santa Cruz,087,273765,15434,14552,783,15335,185
2021-02-27,Shasta,089,179085,10986,10985,1230,12215,149
2021-02-27,Sierra,091,2930,51,48,12,60,0
2021-02-27,Siskiyou,093,43540,1500,1407,237,1644,5
2021-02-27,Solano,095,438530,29896,29718,360,30078,165
2021-02-27,Sonoma,097,501317,28100,28141,215,28356,281
2021-02-27,Stanislaus,099,539301,50804,50147,5361,55508,733
2021-02-27,Sutter,101,95872,8895,8820,81,8901,99
2021-02-27,Tehama,103,63373,4608,4584,492,5076,32
2021-02-27,Trinity,105,12862,468,298,79,377,3
2021-02-27,Tulare,107,460477,48331,47209,8089,55298,770
2021-02-27,Tuolumne,109,53932,3832,3899,33,3932,53
2021-02-27,Ventura,111,848112,78065,77623,2792,80415,771
2021-02-27,Yolo,113,214977,12915,12834,222,13056,188
2021-02-27,Yuba,115,75493,5515,5450,89,5539,39
2021-02-26,Alameda,001,1643700,81075,80387,1740,82127,1106
2021-02-26,Alpine,003,1148,80,77,0,77,0
2021-02-26,Amador,005,37829,3476,3457,30,3487,42
2021-02-26,Butte,007,227075,11358,10941,1621,12562,180
2021-02-26,Calaveras,009,45235,1907,1873,12,1885,46
2021-02-26,Colusa,011,21464,1877,1865,265,2130,11
2021-02-26,Contra Costa,013,1133247,63299,62114,1076,63190,685
2021-02-26,Del Norte,015,27424,1014,968,5,973,5
2021-02-26,El Dorado,017,186661,9162,9038,593,9631,98
2021-02-26,Fresno,019,978130,96547,95202,7744,102946,1391
2021-02-26,Glenn,021,27897,2255,2220,496,2716,15
2021-02-26,Humboldt,023,135768,3176,3152,22,3174,30
2021-02-26,Imperial,025,180216,27243,26888,2581,29469,631
2021-02-26,Inyo,027,18085,1305,1271,9,1280,34
2021-02-26,Kern,029,883053,93507,91884,9830,101714,997
2021-02-26,Kings,031,150075,22287,21917,976,22893,216
2021-02-26,Lake,033,64148,3191,3153,6,3159,40
2021-02-26,Lassen,035,31185,5126,5102,97,5199,1
2021-02-26,Los Angeles,037,10098052,1171508,1153131,39321,1192452,21070
2021-02-26,Madera,039,155013,15646,15436,825,16261,199
2021-02-26,Marin,041,260295,13235,13091,167,13258,214
2021-02-26,Mariposa,043,17540,377,375,5,380,4
2021-02-26,Mendocino,045,87422,3640,3549,70,3619,41
2021-02-26,Merced,047,269075,28499,28455,887,29342,382
2021-02-26,Modoc,049,8938,343,330,115,445,3
2021-02-26,Mono,051,14174,1181,1191,16,1207,3
2021-02-26,Monterey,053,433212,42000,41607,1707,43314,322
2021-02-26,Napa,055,140530,9075,9014,34,9048,70
2021-02-26,Nevada,057,99092,4024,3952,162,4114,66
2021-02-26,Orange,059,3164182,247261,245278,10237,255515,3918
2021-02-26,Placer,061,380077,20582,19712,1115,20827,239
2021-02-26,Plumas,063,18699,643,628,10,638,4
2021-02-26,Riverside,065,2383286,285772,278772,13459,292231,3653
2021-02-26,Sacramento,067,1510023,94625,93180,1267,94447,1390
2021-02-26,San Benito,069,59416,5750,5759,91,5850,57
2021-02-26,San Bernardino,071,2135413,286190,281132,8558,289690,3461
2021-02-26,San Diego,073,3302833,264196,259641,12872,272513,3271
2021-02-26,San Francisco,075,870044,34232,34213,1076,35289,413
2021-02-26,San Joaquin,077,732212,66902,65492,2790,68282,1070
2021-02-26,San Luis Obispo,079,281455,19756,19359,560,19919,234
2021-02-26,San Mateo,081,765935,39571,38922,407,39329,313
2021-02-26,Santa Barbara,083,443738,32259,31724,1110,32834,410
2021-02-26,Santa Clara,085,1922200,110519,110168,589,110757,1700
2021-02-26,Santa Cruz,087,273765,15422,14528,782,15310,185
2021-02-26,Shasta,089,179085,10979,10972,1221,12193,149
2021-02-26,Sierra,091,2930,51,47,12,59,0
2021-02-26,Siskiyou,093,43540,1500,1401,237,1638,5
2021-02-26,Solano,095,438530,29862,29651,359,30010,165
2021-02-26,Sonoma,097,501317,28071,28063,214,28277,280
2021-02-26,Stanislaus,099,539301,50747,50054,5353,55407,737
2021-02-26,Sutter,101,95872,8886,8806,81,8887,99
2021-02-26,Tehama,103,63373,4606,4581,492,5073,32
2021-02-26,Trinity,105,12862,467,298,79,377,3
2021-02-26,Tulare,107,460477,48296,47135,8058,55193,770
2021-02-26,Tuolumne,109,53932,3831,3896,33,3929,53
2021-02-26,Ventura,111,848112,77965,77534,2790,80324,765
2021-02-26,Yolo,113,214977,12908,12816,222,13038,188
2021-02-26,Yuba,115,75493,5510,5438,89,5527,39
2021-02-25,Alameda,001,1643700,80953,80181,1739,81920,1093
2021-02-25,Alpine,003,1148,80,77,0,77,0
2021-02-25,Amador,005,37829,3473,3448,30,3478,41
2021-02-25,Butte,007,227075,11337,10922,1616,12538,178
2021-02-25,Calaveras,009,45235,1899,1868,12,1880,46
2021-02-25,Colusa,011,21464,1874,1863,264,2127,11
2021-02-25,Contra Costa,013,1133247,63197,61910,1076,62986,686
2021-02-25,Del Norte,015,27424,1004,966,5,971,5
2021-02-25,El Dorado,017,186661,9146,9012,593,9605,98
2021-02-25,Fresno,019,978130,96403,95015,7721,102736,1377
2021-02-25,Glenn,021,27897,2252,2219,495,2714,15
2021-02-25,Humboldt,023,135768,3169,3129,22,3151,30
2021-02-25,Imperial,025,180216,27237,26855,2577,29432,628
2021-02-25,Inyo,027,18085,1299,1264,9,1273,33
2021-02-25,Kern,029,883053,93391,91735,9805,101540,992
2021-02-25,Kings,031,150075,22278,21900,973,22873,216
2021-02-25,Lake,033,64148,3182,3141,6,3147,40
2021-02-25,Lassen,035,31185,5125,5097,96,5193,1
2021-02-25,Los Angeles,037,10098052,1170766,1151846,39263,1191109,20931
2021-02-25,Madera,039,155013,15611,15414,821,16235,194
2021-02-25,Marin,041,260295,13211,13067,167,13234,214
2021-02-25,Mariposa,043,17540,377,375,5,380,4
2021-02-25,Mendocino,045,87422,3635,3542,70,3612,41
2021-02-25,Merced,047,269075,28449,28383,886,29269,382
2021-02-25,Modoc,049,8938,343,329,115,444,3
2021-02-25,Mono,051,14174,1180,1190,16,1206,3
2021-02-25,Monterey,053,433212,41975,41564,1702,43266,321
2021-02-25,Napa,055,140530,9049,8998,34,9032,70
2021-02-25,Nevada,057,99092,4007,3940,161,4101,66
2021-02-25,Orange,059,3164182,247089,245000,10227,255227,3882
2021-02-25,Placer,061,380077,20542,19661,1113,20774,239
2021-02-25,Plumas,063,18699,643,626,10,636,4
2021-02-25,Riverside,065,2383286,285584,278544,13438,291982,3646
2021-02-25,Sacramento,067,1510023,94467,92961,1255,94216,1386
2021-02-25,San Benito,069,59416,5745,5752,91,5843,58
2021-02-25,San Bernardino,071,2135413,286056,280946,8550,289496,3409
2021-02-25,San Diego,073,3302833,263902,258979,12842,271821,3260
2021-02-25,San Francisco,075,870044,34189,34138,1073,35211,408
2021-02-25,San Joaquin,077,732212,66818,65389,2778,68167,1047
2021-02-25,San Luis Obispo,079,281455,19735,19335,558,19893,234
2021-02-25,San Mateo,081,765935,39525,38872,407,39279,300
2021-02-25,Santa Barbara,083,443738,32182,31631,1109,32740,408
2021-02-25,Santa Clara,085,1922200,110355,109923,588,110511,1677
2021-02-25,Santa Cruz,087,273765,15403,14492,781,15273,185
2021-02-25,Shasta,089,179085,10967,10947,1216,12163,148
2021-02-25,Sierra,091,2930,51,47,12,59,0
2021-02-25,Siskiyou,093,43540,1496,1390,234,1624,4
2021-02-25,Solano,095,438530,29830,29616,359,29975,161
2021-02-25,Sonoma,097,501317,28017,28004,211,28215,278
2021-02-25,Stanislaus,099,539301,50657,49964,5343,55307,738
2021-02-25,Sutter,101,95872,8872,8789,80,8869,99
2021-02-25,Tehama,103,63373,4602,4578,490,5068,32
2021-02-25,Trinity,105,12862,467,297,79,376,3
2021-02-25,Tulare,107,460477,48246,47052,8032,55084,765
2021-02-25,Tuolumne,109,53932,3828,3894,33,3927,53
2021-02-25,Ventura,111,848112,77860,77395,2784,80179,751
2021-02-25,Yolo,113,214977,12891,12787,222,13009,188
2021-02-25,Yuba,115,75493,5503,5429,89,5518,39
2021-02-24,Alameda,001,1643700,80831,80070,1735,81805,1082
2021-02-24,Alpine,003,1148,79,77,0,77,0
2021-02-24,Amador,005,37829,3468,3444,30,3474,41
2021-02-24,Butte,007,227075,11325,10915,1612,12527,178
2021-02-24,Calaveras,009,45235,1897,1864,12,1876,31
2021-02-24,Colusa,011,21464,1872,1863,264,2127,11
2021-02-24,Contra Costa,013,1133247,63089,61776,1076,62852,663
2021-02-24,Del Norte,015,27424,1003,960,4,964,5
2021-02-24,El Dorado,017,186661,9134,8993,593,9586,98
2021-02-24,Fresno,019,978130,96256,94794,7705,102499,1369
2021-02-24,Glenn,021,27897,2251,2210,495,2705,14
2021-02-24,Humboldt,023,135768,3157,3123,22,3145,29
2021-02-24,Imperial,025,180216,27222,26843,2573,29416,596
2021-02-24,Inyo,027,18085,1294,1253,9,1262,32
2021-02-24,Kern,029,883053,93258,91525,9789,101314,992
2021-02-24,Kings,031,150075,22253,21871,971,22842,216
2021-02-24,Lake,033,64148,3175,3134,6,3140,40
2021-02-24,Lassen,035,31185,5121,5095,95,5190,1
2021-02-24,Los Angeles,037,10098052,1170004,1150322,39219,1189541,20817
2021-02-24,Madera,039,155013,15584,15390,821,16211,194
2021-02-24,Marin,041,260295,13188,13044,166,13210,214
2021-02-24,Mariposa,043,17540,377,374,5,379,4
2021-02-24,Mendocino,045,87422,3628,3540,70,3610,41
2021-02-24,Merced,047,269075,28410,28295,882,29177,383
2021-02-24,Modoc,049,8938,342,329,115,444,3
2021-02-24,Mono,051,14174,1178,1189,16,1205,3
2021-02-24,Monterey,053,433212,41950,41495,1700,43195,320
2021-02-24,Napa,055,140530,9032,8976,33,9009,70
2021-02-24,Nevada,057,99092,3997,3927,161,4088,66
2021-02-24,Orange,059,3164182,246872,244743,10214,254957,3835
2021-02-24,Placer,061,380077,20503,19648,1107,20755,239
2021-02-24,Plumas,063,18699,641,626,10,636,4
2021-02-24,Riverside,065,2383286,285356,278293,13429,291722,3603
2021-02-24,Sacramento,067,1510023,94313,92742,1250,93992,1375
2021-02-24,San Benito,069,59416,5744,5743,91,5834,57
2021-02-24,San Bernardino,071,2135413,285905,280583,8546,289129,3360
2021-02-24,San Diego,073,3302833,263608,258460,12826,271286,3230
2021-02-24,San Francisco,075,870044,34143,34061,1070,35131,406
2021-02-24,San Joaquin,077,732212,66707,65274,2776,68050,1019
2021-02-24,San Luis Obispo,079,281455,19712,19309,556,19865,233
2021-02-24,San Mateo,081,765935,39487,38763,407,39170,300
2021-02-24,Santa Barbara,083,443738,32130,31563,1106,32669,405
2021-02-24,Santa Clara,085,1922200,110204,109671,587,110258,1674
2021-02-24,Santa Cruz,087,273765,15382,14458,781,15239,185
2021-02-24,Shasta,089,179085,10953,10922,1213,12135,148
2021-02-24,Sierra,091,2930,51,47,12,59,0
2021-02-24,Siskiyou,093,43540,1489,1385,230,1615,4
2021-02-24,Solano,095,438530,29791,29577,357,29934,158
2021-02-24,Sonoma,097,501317,27953,27954,207,28161,278
2021-02-24,Stanislaus,099,539301,50586,49851,5335,55186,732
2021-02-24,Sutter,101,95872,8862,8778,80,8858,99
2021-02-24,Tehama,103,63373,4598,4566,490,5056,31
2021-02-24,Trinity,105,12862,467,294,78,372,3
2021-02-24,Tulare,107,460477,48190,46976,8004,54980,759
2021-02-24,Tuolumne,109,53932,3825,3887,33,3920,53
2021-02-24,Ventura,111,848112,77752,77238,2783,80021,718
2021-02-24,Yolo,113,214977,12878,12760,218,12978,188
2021-02-24,Yuba,115,75493,5492,5425,87,5512,39
2021-02-23,Alameda,001,1643700,80692,79948,1732,81680,1070
2021-02-23,Alpine,003,1148,78,77,0,77,0
2021-02-23,Amador,005,37829,3466,3440,30,3470,41
2021-02-23,Butte,007,227075,11310,10887,1608,12495,176
2021-02-23,Calaveras,009,45235,1896,1863,12,1875,21
2021-02-23,Colusa,011,21464,1869,1862,264,2126,11
2021-02-23,Contra Costa,013,1133247,62955,61613,1073,62686,661
2021-02-23,Del Norte,015,27424,1001,953,4,957,3
2021-02-23,El Dorado,017,186661,9121,8969,593,9562,96
2021-02-23,Fresno,019,978130,96095,94741,7691,102432,1356
2021-02-23,Glenn,021,27897,2249,2209,495,2704,14
2021-02-23,Humboldt,023,135768,3140,3108,22,3130,29
2021-02-23,Imperial,025,180216,27202,26816,2568,29384,591
2021-02-23,Inyo,027,18085,1290,1250,9,1259,32
2021-02-23,Kern,029,883053,93119,91390,9761,101151,982
2021-02-23,Kings,031,150075,22238,21839,967,22806,216
2021-02-23,Lake,033,64148,3167,3121,6,3127,40
2021-02-23,Lassen,035,31185,5118,5092,95,5187,1
2021-02-23,Los Angeles,037,10098052,1169135,1148965,39164,1188129,19887
2021-02-23,Madera,039,155013,15570,15352,815,16167,193
2021-02-23,Marin,041,260295,13168,13015,165,13180,214
2021-02-23,Mariposa,043,17540,377,374,5,379,4
2021-02-23,Mendocino,045,87422,3626,3540,69,3609,41
2021-02-23,Merced,047,269075,28325,28209,880,29089,381
2021-02-23,Modoc,049,8938,341,328,114,442,3
2021-02-23,Mono,051,14174,1178,1189,16,1205,3
2021-02-23,Monterey,053,433212,41909,41439,1694,43133,317
2021-02-23,Napa,055,140530,9020,8967,33,9000,70
2021-02-23,Nevada,057,99092,3989,3912,161,4073,66
2021-02-23,Orange,059,3164182,246674,244566,10195,254761,3843
2021-02-23,Placer,061,380077,20478,19608,1103,20711,238
2021-02-23,Plumas,063,18699,640,626,10,636,4
2021-02-23,Riverside,065,2383286,285119,278075,13414,291489,3599
2021-02-23,Sacramento,067,1510023,94156,92632,1244,93876,1370
2021-02-23,San Benito,069,59416,5738,5731,90,5821,57
2021-02-23,San Bernardino,071,2135413,285716,280279,8541,288820,3283
2021-02-23,San Diego,073,3302833,263232,257802,12796,270598,3218
2021-02-23,San Francisco,075,870044,34094,33994,1069,35063,405
2021-02-23,San Joaquin,077,732212,66608,65141,2769,67910,1004
2021-02-23,San Luis Obispo,079,281455,19683,19233,555,19788,230
2021-02-23,San Mateo,081,765935,39426,38662,407,39069,299
2021-02-23,Santa Barbara,083,443738,32075,31483,1104,32587,402
2021-02-23,Santa Clara,085,1922200,110007,109449,584,110033,1661
2021-02-23,Santa Cruz,087,273765,15353,14435,779,15214,178
2021-02-23,Shasta,089,179085,10941,10903,1209,12112,146
2021-02-23,Sierra,091,2930,51,47,12,59,0
2021-02-23,Siskiyou,093,43540,1484,1380,228,1608,4
2021-02-23,Solano,095,438530,29751,29545,354,29899,154
2021-02-23,Sonoma,097,501317,27910,27882,204,28086,278
2021-02-23,Stanislaus,099,539301,50508,49749,5319,55068,722
2021-02-23,Sutter,101,95872,8849,8766,80,8846,98
2021-02-23,Tehama,103,63373,4594,4556,489,5045,30
2021-02-23,Trinity,105,12862,467,292,77,369,3
2021-02-23,Tulare,107,460477,48112,46937,7970,54907,757
2021-02-23,Tuolumne,109,53932,3821,3864,33,3897,53
2021-02-23,Ventura,111,848112,77636,77093,2774,79867,689
2021-02-23,Yolo,113,214977,12849,12729,218,12947,188
2021-02-23,Yuba,115,75493,5479,5417,86,5503,38
2021-02-22,Alameda,001,1643700,80541,79796,1728,81524,1062
2021-02-22,Alpine,003,1148,78,77,0,77,0
2021-02-22,Amador,005,37829,3461,3438,30,3468,39
2021-02-22,Butte,007,227075,11297,10855,1603,12458,176
2021-02-22,Calaveras,009,45235,1894,1862,12,1874,21
2021-02-22,Colusa,011,21464,1869,1860,264,2124,11
2021-02-22,Contra Costa,013,1133247,62820,61478,1071,62549,661
2021-02-22,Del Norte,015,27424,1000,948,4,952,3
2021-02-22,El Dorado,017,186661,9104,8940,593,9533,96
2021-02-22,Fresno,019,978130,95933,94584,7674,102258,1351
2021-02-22,Glenn,021,27897,2244,2207,493,2700,14
2021-02-22,Humboldt,023,135768,3128,3095,22,3117,29
2021-02-22,Imperial,025,180216,27179,26778,2560,29338,590
2021-02-22,Inyo,027,18085,1285,1248,9,1257,32
2021-02-22,Kern,029,883053,93002,91201,9739,100940,982
2021-02-22,Kings,031,150075,22215,21801,964,22765,214
2021-02-22,Lake,033,64148,3161,3107,6,3113,40
2021-02-22,Lassen,035,31185,5118,5088,94,5182,1
2021-02-22,Los Angeles,037,10098052,1168262,1147541,39108,1186649,19730
2021-02-22,Madera,039,155013,15545,15325,811,16136,193
2021-02-22,Marin,041,260295,13144,12991,162,13153,213
2021-02-22,Mariposa,043,17540,376,374,5,379,4
2021-02-22,Mendocino,045,87422,3620,3535,69,3604,41
2021-02-22,Merced,047,269075,28261,28166,878,29044,379
2021-02-22,Modoc,049,8938,341,329,114,443,3
2021-02-22,Mono,051,14174,1174,1189,16,1205,3
2021-02-22,Monterey,053,433212,41859,41397,1688,43085,311
2021-02-22,Napa,055,140530,8993,8950,33,8983,69
2021-02-22,Nevada,057,99092,3980,3900,159,4059,66
2021-02-22,Orange,059,3164182,246438,244118,10177,254295,3843
2021-02-22,Placer,061,380077,20442,19587,1095,20682,238
2021-02-22,Plumas,063,18699,640,625,10,635,4
2021-02-22,Riverside,065,2383286,284855,277730,13406,291136,3567
2021-02-22,Sacramento,067,1510023,93989,92476,1233,93709,1359
2021-02-22,San Benito,069,59416,5736,5723,90,5813,57
2021-02-22,San Bernardino,071,2135413,285534,279984,8528,288512,3259
2021-02-22,San Diego,073,3302833,262822,257348,12763,270111,3189
2021-02-22,San Francisco,075,870044,34034,33947,1064,35011,405
2021-02-22,San Joaquin,077,732212,66509,65060,2756,67816,1001
2021-02-22,San Luis Obispo,079,281455,19646,19198,553,19751,229
2021-02-22,San Mateo,081,765935,39369,38542,404,38946,282
2021-02-22,Santa Barbara,083,443738,32009,31421,1101,32522,399
2021-02-22,Santa Clara,085,1922200,109795,109213,573,109786,1655
2021-02-22,Santa Cruz,087,273765,15327,14417,779,15196,176
2021-02-22,Shasta,089,179085,10926,10872,1204,12076,145
2021-02-22,Sierra,091,2930,51,47,12,59,0
2021-02-22,Siskiyou,093,43540,1478,1373,227,1600,4
2021-02-22,Solano,095,438530,29712,29508,353,29861,150
2021-02-22,Sonoma,097,501317,27865,27845,203,28048,278
2021-02-22,Stanislaus,099,539301,50403,49630,5300,54930,722
2021-02-22,Sutter,101,95872,8841,8698,80,8778,98
2021-02-22,Tehama,103,63373,4585,4550,489,5039,30
2021-02-22,Trinity,105,12862,467,287,76,363,3
2021-02-22,Tulare,107,460477,48050,46879,7938,54817,751
2021-02-22,Tuolumne,109,53932,3817,3856,33,3889,53
2021-02-22,Ventura,111,848112,77508,76947,2769,79716,677
2021-02-22,Yolo,113,214977,12822,12689,218,12907,183
2021-02-22,Yuba,115,75493,5476,5404,85,5489,38
2021-02-21,Alameda,001,1643700,80347,79649,1723,81372,1061
2021-02-21,Alpine,003,1148,78,77,0,77,0
2021-02-21,Amador,005,37829,3453,3435,30,3465,39
2021-02-21,Butte,007,227075,11274,10855,1601,12456,176
2021-02-21,Calaveras,009,45235,1893,1860,12,1872,21
2021-02-21,Colusa,011,21464,1868,1860,260,2120,11
2021-02-21,Contra Costa,013,1133247,62654,61364,1068,62432,661
2021-02-21,Del Norte,015,27424,994,942,4,946,3
2021-02-21,El Dorado,017,186661,9086,8927,592,9519,96
2021-02-21,Fresno,019,978130,95790,94374,7657,102031,1349
2021-02-21,Glenn,021,27897,2241,2201,491,2692,14
2021-02-21,Humboldt,023,135768,3116,3096,22,3118,29
2021-02-21,Imperial,025,180216,27160,26779,2556,29335,590
2021-02-21,Inyo,027,18085,1279,1232,9,1241,32
2021-02-21,Kern,029,883053,92877,91141,9700,100841,980
2021-02-21,Kings,031,150075,22179,21784,962,22746,213
2021-02-21,Lake,033,64148,3153,3100,6,3106,40
2021-02-21,Lassen,035,31185,5110,5077,94,5171,1
2021-02-21,Los Angeles,037,10098052,1167227,1146756,39060,1185816,19711
2021-02-21,Madera,039,155013,15512,15298,808,16106,192
2021-02-21,Marin,041,260295,13114,12968,162,13130,212
2021-02-21,Mariposa,043,17540,376,373,5,378,4
2021-02-21,Mendocino,045,87422,3615,3535,69,3604,41
2021-02-21,Merced,047,269075,28181,28106,866,28972,379
2021-02-21,Modoc,049,8938,338,329,114,443,3
2021-02-21,Mono,051,14174,1174,1189,16,1205,3
2021-02-21,Monterey,053,433212,41802,41373,1680,43053,309
2021-02-21,Napa,055,140530,8979,8929,33,8962,69
2021-02-21,Nevada,057,99092,3967,3895,159,4054,66
2021-02-21,Orange,059,3164182,246137,243985,10160,254145,3801
2021-02-21,Placer,061,380077,20406,19553,1091,20644,238
2021-02-21,Plumas,063,18699,640,625,10,635,4
2021-02-21,Riverside,065,2383286,284619,277555,13393,290948,3564
2021-02-21,Sacramento,067,1510023,93779,92288,1220,93508,1354
2021-02-21,San Benito,069,59416,5726,5716,87,5803,57
2021-02-21,San Bernardino,071,2135413,285287,279870,8514,288384,3247
2021-02-21,San Diego,073,3302833,262388,257027,12717,269744,3190
2021-02-21,San Francisco,075,870044,33970,33891,1060,34951,405
2021-02-21,San Joaquin,077,732212,66360,64997,2744,67741,1001
2021-02-21,San Luis Obispo,079,281455,19613,19178,551,19729,229
2021-02-21,San Mateo,081,765935,39310,38448,400,38848,282
2021-02-21,Santa Barbara,083,443738,31947,31374,1098,32472,399
2021-02-21,Santa Clara,085,1922200,109569,108992,564,109556,1654
2021-02-21,Santa Cruz,087,273765,15304,14401,778,15179,176
2021-02-21,Shasta,089,179085,10911,10867,1199,12066,145
2021-02-21,Sierra,091,2930,51,47,12,59,0
2021-02-21,Siskiyou,093,43540,1472,1371,227,1598,4
2021-02-21,Solano,095,438530,29655,29471,352,29823,150
2021-02-21,Sonoma,097,501317,27799,27793,196,27989,278
2021-02-21,Stanislaus,099,539301,50277,49527,5284,54811,726
2021-02-21,Sutter,101,95872,8823,8687,79,8766,97
2021-02-21,Tehama,103,63373,4573,4547,489,5036,30
2021-02-21,Trinity,105,12862,465,286,76,362,3
2021-02-21,Tulare,107,460477,47982,46830,7903,54733,749
2021-02-21,Tuolumne,109,53932,3803,3828,33,3861,53
2021-02-21,Ventura,111,848112,77360,76862,2755,79617,677
2021-02-21,Yolo,113,214977,12791,12670,218,12888,183
2021-02-21,Yuba,115,75493,5468,5396,84,5480,38
2021-02-20,Alameda,001,1643700,80257,79496,1719,81215,1055
2021-02-20,Alpine,003,1148,78,77,0,77,0
2021-02-20,Amador,005,37829,3451,3432,30,3462,39
2021-02-20,Butte,007,227075,11266,10838,1599,12437,176
2021-02-20,Calaveras,009,45235,1892,1858,12,1870,21
2021-02-20,Colusa,011,21464,1867,1858,260,2118,11
2021-02-20,Contra Costa,013,1133247,62565,61205,1066,62271,663
2021-02-20,Del Norte,015,27424,990,937,4,941,3
2021-02-20,El Dorado,017,186661,9076,8911,592,9503,96
2021-02-20,Fresno,019,978130,95706,94234,7637,101871,1341
2021-02-20,Glenn,021,27897,2237,2199,490,2689,14
2021-02-20,Humboldt,023,135768,3108,3073,22,3095,29
2021-02-20,Imperial,025,180216,27152,26771,2556,29327,590
2021-02-20,Inyo,027,18085,1275,1226,9,1235,32
2021-02-20,Kern,029,883053,92805,91025,9668,100693,968
2021-02-20,Kings,031,150075,22161,21773,961,22734,212
2021-02-20,Lake,033,64148,3146,3089,6,3095,40
2021-02-20,Lassen,035,31185,5108,5067,94,5161,1
2021-02-20,Los Angeles,037,10098052,1166661,1145594,39016,1184610,19630
2021-02-20,Madera,039,155013,15492,15274,807,16081,191
2021-02-20,Marin,041,260295,13093,12945,160,13105,211
2021-02-20,Mariposa,043,17540,376,372,5,377,4
2021-02-20,Mendocino,045,87422,3613,3533,69,3602,40
2021-02-20,Merced,047,269075,28137,28066,864,28930,379
2021-02-20,Modoc,049,8938,338,328,114,442,3
2021-02-20,Mono,051,14174,1173,1187,16,1203,3
2021-02-20,Monterey,053,433212,41782,41313,1678,42991,309
2021-02-20,Napa,055,140530,8970,8910,33,8943,69
2021-02-20,Nevada,057,99092,3957,3887,158,4045,66
2021-02-20,Orange,059,3164182,245968,243761,10147,253908,3755
2021-02-20,Placer,061,380077,20365,19509,1087,20596,236
2021-02-20,Plumas,063,18699,640,626,10,636,4
2021-02-20,Riverside,065,2383286,284464,277267,13383,290650,3559
2021-02-20,Sacramento,067,1510023,93656,92057,1218,93275,1352
2021-02-20,San Benito,069,59416,5714,5709,87,5796,57
2021-02-20,San Bernardino,071,2135413,285186,279608,8509,288117,3203
2021-02-20,San Diego,073,3302833,262146,256510,12688,269198,3188
2021-02-20,San Francisco,075,870044,33928,33820,1051,34871,399
2021-02-20,San Joaquin,077,732212,66287,64916,2739,67655,1001
2021-02-20,San Luis Obispo,079,281455,19589,19138,550,19688,229
2021-02-20,San Mateo,081,765935,39266,38371,399,38770,282
2021-02-20,Santa Barbara,083,443738,31913,31289,1097,32386,396
2021-02-20,Santa Clara,085,1922200,109393,108728,561,109289,1649
2021-02-20,Santa Cruz,087,273765,15293,14378,776,15154,176
2021-02-20,Shasta,089,179085,10897,10850,1194,12044,146
2021-02-20,Sierra,091,2930,51,47,12,59,0
2021-02-20,Siskiyou,093,43540,1469,1366,227,1593,4
2021-02-20,Solano,095,438530,29640,29440,350,29790,150
2021-02-20,Sonoma,097,501317,27770,27703,194,27897,278
2021-02-20,Stanislaus,099,539301,50222,49445,5271,54716,733
2021-02-20,Sutter,101,95872,8817,8681,79,8760,97
2021-02-20,Tehama,103,63373,4572,4545,489,5034,30
2021-02-20,Trinity,105,12862,464,285,75,360,3
2021-02-20,Tulare,107,460477,47946,46769,7881,54650,739
2021-02-20,Tuolumne,109,53932,3798,3823,33,3856,53
2021-02-20,Ventura,111,848112,77264,76757,2752,79509,671
2021-02-20,Yolo,113,214977,12777,12639,217,12856,183
2021-02-20,Yuba,115,75493,5465,5386,84,5470,38
2021-02-19,Alameda,001,1643700,80154,79318,1715,81033,1047
2021-02-19,Alpine,003,1148,78,77,0,77,0
2021-02-19,Amador,005,37829,3447,3427,30,3457,39
2021-02-19,Butte,007,227075,11256,10823,1594,12417,176
2021-02-19,Calaveras,009,45235,1891,1856,12,1868,21
2021-02-19,Colusa,011,21464,1867,1858,260,2118,11
2021-02-19,Contra Costa,013,1133247,62457,61017,1063,62080,651
2021-02-19,Del Norte,015,27424,985,932,4,936,2
2021-02-19,El Dorado,017,186661,9067,8882,591,9473,96
2021-02-19,Fresno,019,978130,95575,93973,7621,101594,1330
2021-02-19,Glenn,021,27897,2232,2199,489,2688,14
2021-02-19,Humboldt,023,135768,3096,3037,22,3059,29
2021-02-19,Imperial,025,180216,27147,26751,2553,29304,589
2021-02-19,Inyo,027,18085,1270,1212,9,1221,32
2021-02-19,Kern,029,883053,92735,90807,9627,100434,963
2021-02-19,Kings,031,150075,22147,21724,959,22683,211
2021-02-19,Lake,033,64148,3140,3078,6,3084,40
2021-02-19,Lassen,035,31185,5107,5057,94,5151,1
2021-02-19,Los Angeles,037,10098052,1165913,1143828,38975,1182803,19498
2021-02-19,Madera,039,155013,15475,15222,805,16027,188
2021-02-19,Marin,041,260295,13069,12919,158,13077,210
2021-02-19,Mariposa,043,17540,376,371,5,376,4
2021-02-19,Mendocino,045,87422,3611,3526,69,3595,39
2021-02-19,Merced,047,269075,28107,27985,861,28846,376
2021-02-19,Modoc,049,8938,338,328,114,442,3
2021-02-19,Mono,051,14174,1173,1186,16,1202,3
2021-02-19,Monterey,053,433212,41754,41209,1674,42883,309
2021-02-19,Napa,055,140530,8957,8899,33,8932,69
2021-02-19,Nevada,057,99092,3951,3863,158,4021,66
2021-02-19,Orange,059,3164182,245787,243397,10134,253531,3715
2021-02-19,Placer,061,380077,20343,19457,1087,20544,236
2021-02-19,Plumas,063,18699,638,624,10,634,4
2021-02-19,Riverside,065,2383286,284293,276941,13366,290307,3541
2021-02-19,Sacramento,067,1510023,93535,91815,1214,93029,1351
2021-02-19,San Benito,069,59416,5709,5699,87,5786,57
2021-02-19,San Bernardino,071,2135413,285059,279209,8504,287713,3117
2021-02-19,San Diego,073,3302833,261855,255799,12665,268464,3169
2021-02-19,San Francisco,075,870044,33880,33746,1045,34791,387
2021-02-19,San Joaquin,077,732212,66215,64774,2730,67504,988
2021-02-19,San Luis Obispo,079,281455,19558,19061,548,19609,230
2021-02-19,San Mateo,081,765935,39208,38256,397,38653,282
2021-02-19,Santa Barbara,083,443738,31849,31204,1096,32300,392
2021-02-19,Santa Clara,085,1922200,109180,108400,559,108959,1634
2021-02-19,Santa Cruz,087,273765,15278,14354,776,15130,176
2021-02-19,Shasta,089,179085,10885,10833,1191,12024,140
2021-02-19,Sierra,091,2930,51,47,12,59,0
2021-02-19,Siskiyou,093,43540,1465,1363,225,1588,4
2021-02-19,Solano,095,438530,29609,29383,349,29732,150
2021-02-19,Sonoma,097,501317,27723,27595,192,27787,280
2021-02-19,Stanislaus,099,539301,50161,49282,5255,54537,739
2021-02-19,Sutter,101,95872,8807,8665,79,8744,96
2021-02-19,Tehama,103,63373,4570,4535,489,5024,30
2021-02-19,Trinity,105,12862,462,282,73,355,3
2021-02-19,Tulare,107,460477,47901,46662,7856,54518,736
2021-02-19,Tuolumne,109,53932,3791,3817,33,3850,52
2021-02-19,Ventura,111,848112,77184,76582,2749,79331,667
2021-02-19,Yolo,113,214977,12761,12606,217,12823,183
2021-02-19,Yuba,115,75493,5455,5376,84,5460,38
2021-02-18,Alameda,001,1643700,80008,79111,1707,80818,1012
2021-02-18,Alpine,003,1148,78,77,0,77,0
2021-02-18,Amador,005,37829,3443,3417,29,3446,38
2021-02-18,Butte,007,227075,11238,10791,1591,12382,175
2021-02-18,Calaveras,009,45235,1886,1873,12,1885,21
2021-02-18,Colusa,011,21464,1865,1856,258,2114,11
2021-02-18,Contra Costa,013,1133247,62346,60868,1062,61930,640
2021-02-18,Del Norte,015,27424,980,929,4,933,2
2021-02-18,El Dorado,017,186661,9052,8850,590,9440,94
2021-02-18,Fresno,019,978130,95405,93734,7596,101330,1323
2021-02-18,Glenn,021,27897,2226,2195,489,2684,14
2021-02-18,Humboldt,023,135768,3084,3023,22,3045,29
2021-02-18,Imperial,025,180216,27121,26731,2548,29279,591
2021-02-18,Inyo,027,18085,1266,1213,8,1221,32
2021-02-18,Kern,029,883053,92577,90655,9596,100251,961
2021-02-18,Kings,031,150075,22123,21648,958,22606,211
2021-02-18,Lake,033,64148,3132,3066,6,3072,40
2021-02-18,Lassen,035,31185,5098,5052,94,5146,1
2021-02-18,Los Angeles,037,10098052,1164953,1141930,38910,1180840,19358
2021-02-18,Madera,039,155013,15453,15175,800,15975,188
2021-02-18,Marin,041,260295,13055,12895,158,13053,209
2021-02-18,Mariposa,043,17540,375,369,5,374,4
2021-02-18,Mendocino,045,87422,3608,3519,68,3587,39
2021-02-18,Merced,047,269075,28058,27870,855,28725,372
2021-02-18,Modoc,049,8938,336,327,113,440,3
2021-02-18,Mono,051,14174,1173,1182,16,1198,3
2021-02-18,Monterey,053,433212,41689,41091,1667,42758,307
2021-02-18,Napa,055,140530,8940,8877,33,8910,68
2021-02-18,Nevada,057,99092,3942,3836,157,3993,66
2021-02-18,Orange,059,3164182,245568,243098,10117,253215,3673
2021-02-18,Placer,061,380077,20316,19429,1086,20515,232
2021-02-18,Plumas,063,18699,638,624,10,634,4
2021-02-18,Riverside,065,2383286,284004,276595,13345,289940,3510
2021-02-18,Sacramento,067,1510023,93373,91476,1208,92684,1334
2021-02-18,San Benito,069,59416,5706,5697,86,5783,58
2021-02-18,San Bernardino,071,2135413,284849,278887,8490,287377,3066
2021-02-18,San Diego,073,3302833,261501,254987,12642,267629,3135
2021-02-18,San Francisco,075,870044,33822,33650,1042,34692,386
2021-02-18,San Joaquin,077,732212,66129,64634,2720,67354,982
2021-02-18,San Luis Obispo,079,281455,19516,18987,545,19532,230
2021-02-18,San Mateo,081,765935,39146,38185,393,38578,282
2021-02-18,Santa Barbara,083,443738,31771,31054,1089,32143,387
2021-02-18,Santa Clara,085,1922200,108953,108210,556,108766,1605
2021-02-18,Santa Cruz,087,273765,15252,14314,776,15090,176
2021-02-18,Shasta,089,179085,10866,10811,1188,11999,139
2021-02-18,Sierra,091,2930,50,47,12,59,0
2021-02-18,Siskiyou,093,43540,1460,1359,224,1583,4
2021-02-18,Solano,095,438530,29582,29349,348,29697,150
2021-02-18,Sonoma,097,501317,27655,27512,191,27703,281
2021-02-18,Stanislaus,099,539301,50063,49150,5240,54390,738
2021-02-18,Sutter,101,95872,8799,8654,79,8733,96
2021-02-18,Tehama,103,63373,4567,4528,488,5016,30
2021-02-18,Trinity,105,12862,461,282,73,355,3
2021-02-18,Tulare,107,460477,47838,46591,7816,54407,728
2021-02-18,Tuolumne,109,53932,3754,3811,33,3844,52
2021-02-18,Ventura,111,848112,77052,76442,2741,79183,659
2021-02-18,Yolo,113,214977,12735,12549,214,12763,183
2021-02-18,Yuba,115,75493,5438,5358,84,5442,38
2021-02-17,Alameda,001,1643700,79846,78895,1705,80600,1002
2021-02-17,Alpine,003,1148,78,77,0,77,0
2021-02-17,Amador,005,37829,3439,3415,29,3444,38
2021-02-17,Butte,007,227075,11220,10770,1588,12358,174
2021-02-17,Calaveras,009,45235,1886,1876,12,1888,21
2021-02-17,Colusa,011,21464,1862,1854,258,2112,10
2021-02-17,Contra Costa,013,1133247,62205,60723,1059,61782,635
2021-02-17,Del Norte,015,27424,973,920,4,924,2
2021-02-17,El Dorado,017,186661,9040,8847,590,9437,94
2021-02-17,Fresno,019,978130,95266,93555,7569,101124,1307
2021-02-17,Glenn,021,27897,2226,2189,488,2677,14
2021-02-17,Humboldt,023,135768,3069,3006,22,3028,29
2021-02-17,Imperial,025,180216,27106,26726,2546,29272,580
2021-02-17,Inyo,027,18085,1258,1197,8,1205,32
2021-02-17,Kern,029,883053,92458,90454,9551,100005,962
2021-02-17,Kings,031,150075,22085,21617,954,22571,211
2021-02-17,Lake,033,64148,3121,3057,2,3059,38
2021-02-17,Lassen,035,31185,5093,5052,93,5145,1
2021-02-17,Los Angeles,037,10098052,1163901,1139786,38847,1178633,19213
2021-02-17,Madera,039,155013,15427,15135,791,15926,177
2021-02-17,Marin,041,260295,13029,12881,158,13039,207
2021-02-17,Mariposa,043,17540,375,368,4,372,4
2021-02-17,Mendocino,045,87422,3606,3494,67,3561,39
2021-02-17,Merced,047,269075,28002,27824,846,28670,372
2021-02-17,Modoc,049,8938,336,327,113,440,3
2021-02-17,Mono,051,14174,1173,1180,16,1196,3
2021-02-17,Monterey,053,433212,41635,41014,1655,42669,304
2021-02-17,Napa,055,140530,8926,8865,33,8898,68
2021-02-17,Nevada,057,99092,3923,3822,154,3976,52
2021-02-17,Orange,059,3164182,245300,242716,10083,252799,3626
2021-02-17,Placer,061,380077,20283,19405,1082,20487,230
2021-02-17,Plumas,063,18699,637,623,10,633,4
2021-02-17,Riverside,065,2383286,283718,276289,13324,289613,3491
2021-02-17,Sacramento,067,1510023,93214,91309,1201,92510,1326
2021-02-17,San Benito,069,59416,5700,5661,86,5747,57
2021-02-17,San Bernardino,071,2135413,284641,278461,8471,286932,3020
2021-02-17,San Diego,073,3302833,261123,254177,12621,266798,3099
2021-02-17,San Francisco,075,870044,33746,33558,1037,34595,379
2021-02-17,San Joaquin,077,732212,66027,64556,2714,67270,979
2021-02-17,San Luis Obispo,079,281455,19470,18964,545,19509,230
2021-02-17,San Mateo,081,765935,39080,38124,392,38516,282
2021-02-17,Santa Barbara,083,443738,31703,30927,1088,32015,384
2021-02-17,Santa Clara,085,1922200,108721,107949,554,108503,1592
2021-02-17,Santa Cruz,087,273765,15219,14268,773,15041,174
2021-02-17,Shasta,089,179085,10846,10770,1187,11957,139
2021-02-17,Sierra,091,2930,50,47,12,59,0
2021-02-17,Siskiyou,093,43540,1454,1352,221,1573,4
2021-02-17,Solano,095,438530,29526,29288,348,29636,149
2021-02-17,Sonoma,097,501317,27581,27408,186,27594,281
2021-02-17,Stanislaus,099,539301,49954,49050,5224,54274,730
2021-02-17,Sutter,101,95872,8789,8681,79,8760,95
2021-02-17,Tehama,103,63373,4563,4511,487,4998,30
2021-02-17,Trinity,105,12862,461,277,71,348,3
2021-02-17,Tulare,107,460477,47773,46495,7789,54284,726
2021-02-17,Tuolumne,109,53932,3745,3806,33,3839,49
2021-02-17,Ventura,111,848112,76927,76234,2735,78969,646
2021-02-17,Yolo,113,214977,12716,12506,212,12718,182
2021-02-17,Yuba,115,75493,5429,5345,84,5429,38
2021-02-16,Alameda,001,1643700,79673,78756,1702,80458,997
2021-02-16,Alpine,003,1148,78,76,0,76,0
2021-02-16,Amador,005,37829,3432,3413,29,3442,39
2021-02-16,Butte,007,227075,11193,10748,1585,12333,164
2021-02-16,Calaveras,009,45235,1884,1872,12,1884,21
2021-02-16,Colusa,011,21464,1859,1852,256,2108,10
2021-02-16,Contra Costa,013,1133247,62057,60564,1054,61618,631
2021-02-16,Del Norte,015,27424,965,913,4,917,2
2021-02-16,El Dorado,017,186661,9030,8836,589,9425,94
2021-02-16,Fresno,019,978130,95102,93363,7539,100902,1293
2021-02-16,Glenn,021,27897,2218,2189,483,2672,14
2021-02-16,Humboldt,023,135768,3046,2994,21,3015,29
2021-02-16,Imperial,025,180216,27093,26711,2542,29253,580
2021-02-16,Inyo,027,18085,1250,1191,8,1199,32
2021-02-16,Kern,029,883053,92323,90267,9522,99789,959
2021-02-16,Kings,031,150075,22039,21583,950,22533,206
2021-02-16,Lake,033,64148,3112,3041,2,3043,38
2021-02-16,Lassen,035,31185,5081,5047,93,5140,1
2021-02-16,Los Angeles,037,10098052,1162649,1138262,38786,1177048,19044
2021-02-16,Madera,039,155013,15388,15120,786,15906,172
2021-02-16,Marin,041,260295,13005,12832,158,12990,205
2021-02-16,Mariposa,043,17540,375,367,4,371,4
2021-02-16,Mendocino,045,87422,3602,3489,67,3556,39
2021-02-16,Merced,047,269075,27922,27724,840,28564,368
2021-02-16,Modoc,049,8938,336,326,113,439,3
2021-02-16,Mono,051,14174,1173,1180,16,1196,3
2021-02-16,Monterey,053,433212,41561,40962,1646,42608,303
2021-02-16,Napa,055,140530,8913,8854,33,8887,66
2021-02-16,Nevada,057,99092,3910,3774,153,3927,47
2021-02-16,Orange,059,3164182,244978,242382,10067,252449,3612
2021-02-16,Placer,061,380077,20250,19367,1079,20446,230
2021-02-16,Plumas,063,18699,637,619,10,629,4
2021-02-16,Riverside,065,2383286,283412,275954,13300,289254,3471
2021-02-16,Sacramento,067,1510023,92959,91246,1195,92441,1305
2021-02-16,San Benito,069,59416,5692,5659,85,5744,56
2021-02-16,San Bernardino,071,2135413,284419,277947,8460,286407,2978
2021-02-16,San Diego,073,3302833,260659,253638,12582,266220,3042
2021-02-16,San Francisco,075,870044,33675,33491,1032,34523,373
2021-02-16,San Joaquin,077,732212,65904,64448,2711,67159,979
2021-02-16,San Luis Obispo,079,281455,19425,18925,542,19467,229
2021-02-16,San Mateo,081,765935,39021,38041,390,38431,277
2021-02-16,Santa Barbara,083,443738,31629,30865,1085,31950,378
2021-02-16,Santa Clara,085,1922200,108469,107754,551,108305,1591
2021-02-16,Santa Cruz,087,273765,15199,14256,772,15028,174
2021-02-16,Shasta,089,179085,10830,10736,1185,11921,139
2021-02-16,Sierra,091,2930,50,47,12,59,0
2021-02-16,Siskiyou,093,43540,1450,1351,221,1572,4
2021-02-16,Solano,095,438530,29486,29246,347,29593,148
2021-02-16,Sonoma,097,501317,27519,27380,180,27560,279
2021-02-16,Stanislaus,099,539301,49833,48927,5210,54137,716
2021-02-16,Sutter,101,95872,8766,8671,79,8750,95
2021-02-16,Tehama,103,63373,4554,4501,486,4987,30
2021-02-16,Trinity,105,12862,457,275,71,346,3
2021-02-16,Tulare,107,460477,47709,46444,7745,54189,716
2021-02-16,Tuolumne,109,53932,3743,3796,33,3829,49
2021-02-16,Ventura,111,848112,76782,76043,2731,78774,631
2021-02-16,Yolo,113,214977,12685,12457,212,12669,175
2021-02-16,Yuba,115,75493,5422,5332,83,5415,38
2021-02-15,Alameda,001,1643700,79475,78647,1691,80338,996
2021-02-15,Alpine,003,1148,78,76,0,76,0
2021-02-15,Amador,005,37829,3428,3409,29,3438,39
2021-02-15,Butte,007,227075,11175,10723,1581,12304,155
2021-02-15,Calaveras,009,45235,1880,1871,12,1883,21
2021-02-15,Colusa,011,21464,1859,1849,252,2101,10
2021-02-15,Contra Costa,013,1133247,61881,60444,1048,61492,631
2021-02-15,Del Norte,015,27424,961,913,4,917,2
2021-02-15,El Dorado,017,186661,9013,8816,589,9405,94
2021-02-15,Fresno,019,978130,94902,93231,7500,100731,1288
2021-02-15,Glenn,021,27897,2215,2185,480,2665,14
2021-02-15,Humboldt,023,135768,3039,2997,21,3018,29
2021-02-15,Imperial,025,180216,27073,26700,2538,29238,580
2021-02-15,Inyo,027,18085,1231,1184,8,1192,32
2021-02-15,Kern,029,883053,92179,90181,9490,99671,959
2021-02-15,Kings,031,150075,21994,21574,946,22520,205
2021-02-15,Lake,033,64148,3098,3030,1,3031,38
2021-02-15,Lassen,035,31185,5079,5047,92,5139,1
2021-02-15,Los Angeles,037,10098052,1161259,1137164,38722,1175886,18925
2021-02-15,Madera,039,155013,15357,15108,784,15892,106
2021-02-15,Marin,041,260295,12985,12810,155,12965,203
2021-02-15,Mariposa,043,17540,373,367,4,371,4
2021-02-15,Mendocino,045,87422,3590,3481,67,3548,39
2021-02-15,Merced,047,269075,27847,27656,833,28489,368
2021-02-15,Modoc,049,8938,336,326,113,439,3
2021-02-15,Mono,051,14174,1170,1178,16,1194,3
2021-02-15,Monterey,053,433212,41500,40911,1633,42544,302
2021-02-15,Napa,055,140530,8899,8837,33,8870,57
2021-02-15,Nevada,057,99092,3893,3767,152,3919,47
2021-02-15,Orange,059,3164182,244658,242176,10039,252215,3586
2021-02-15,Placer,061,380077,20224,19361,1078,20439,230
2021-02-15,Plumas,063,18699,637,620,10,630,4
2021-02-15,Riverside,065,2383286,283055,275771,13282,289053,3468
2021-02-15,Sacramento,067,1510023,92632,91091,1190,92281,1304
2021-02-15,San Benito,069,59416,5683,5649,85,5734,56
2021-02-15,San Bernardino,071,2135413,284162,277869,8452,286321,2945
2021-02-15,San Diego,073,3302833,260144,252940,12551,265491,3037
2021-02-15,San Francisco,075,870044,33601,33454,1026,34480,373
2021-02-15,San Joaquin,077,732212,65740,64382,2704,67086,979
2021-02-15,San Luis Obispo,079,281455,19372,18891,540,19431,227
2021-02-15,San Mateo,081,765935,38943,37969,387,38356,277
2021-02-15,Santa Barbara,083,443738,31526,30810,1082,31892,378
2021-02-15,Santa Clara,085,1922200,108234,107630,549,108179,1588
2021-02-15,Santa Cruz,087,273765,15167,14239,769,15008,175
2021-02-15,Shasta,089,179085,10810,10730,1180,11910,139
2021-02-15,Sierra,091,2930,50,47,12,59,0
2021-02-15,Siskiyou,093,43540,1442,1345,220,1565,4
2021-02-15,Solano,095,438530,29431,29225,347,29572,148
2021-02-15,Sonoma,097,501317,27434,27359,176,27535,276
2021-02-15,Stanislaus,099,539301,49708,48808,5197,54005,716
2021-02-15,Sutter,101,95872,8751,8652,79,8731,95
2021-02-15,Tehama,103,63373,4543,4492,484,4976,30
2021-02-15,Trinity,105,12862,456,274,71,345,3
2021-02-15,Tulare,107,460477,47638,46344,7706,54050,715
2021-02-15,Tuolumne,109,53932,3733,3794,33,3827,49
2021-02-15,Ventura,111,848112,76626,75889,2728,78617,629
2021-02-15,Yolo,113,214977,12648,12412,206,12618,175
2021-02-15,Yuba,115,75493,5405,5320,82,5402,38
2021-02-14,Alameda,001,1643700,79318,78442,1690,80132,995
2021-02-14,Alpine,003,1148,78,76,0,76,0
2021-02-14,Amador,005,37829,3423,3398,29,3427,39
2021-02-14,Butte,007,227075,11151,10717,1576,12293,155
2021-02-14,Calaveras,009,45235,1877,1866,12,1878,21
2021-02-14,Colusa,011,21464,1855,1845,249,2094,10
2021-02-14,Contra Costa,013,1133247,61733,60272,1045,61317,631
2021-02-14,Del Norte,015,27424,957,911,4,915,2
2021-02-14,El Dorado,017,186661,8982,8790,588,9378,94
2021-02-14,Fresno,019,978130,94731,93065,7477,100542,1287
2021-02-14,Glenn,021,27897,2213,2184,480,2664,14
2021-02-14,Humboldt,023,135768,3026,2992,21,3013,29
2021-02-14,Imperial,025,180216,27065,26696,2537,29233,580
2021-02-14,Inyo,027,18085,1225,1177,8,1185,32
2021-02-14,Kern,029,883053,92019,90038,9437,99475,959
2021-02-14,Kings,031,150075,21968,21538,944,22482,205
2021-02-14,Lake,033,64148,3089,3030,1,3031,38
2021-02-14,Lassen,035,31185,5075,5037,92,5129,1
2021-02-14,Los Angeles,037,10098052,1159918,1135450,38636,1174086,18898
2021-02-14,Madera,039,155013,15325,15089,780,15869,106
2021-02-14,Marin,041,260295,12961,12784,155,12939,201
2021-02-14,Mariposa,043,17540,373,365,4,369,4
2021-02-14,Mendocino,045,87422,3584,3475,67,3542,39
2021-02-14,Merced,047,269075,27765,27601,828,28429,368
2021-02-14,Modoc,049,8938,336,326,113,439,3
2021-02-14,Mono,051,14174,1169,1180,16,1196,3
2021-02-14,Monterey,053,433212,41450,40842,1628,42470,302
2021-02-14,Napa,055,140530,8879,8826,33,8859,57
2021-02-14,Nevada,057,99092,3877,3761,152,3913,47
2021-02-14,Orange,059,3164182,244346,241859,10020,251879,3564
2021-02-14,Placer,061,380077,20185,19313,1073,20386,230
2021-02-14,Plumas,063,18699,636,620,10,630,4
2021-02-14,Riverside,065,2383286,282721,275518,13263,288781,3471
2021-02-14,Sacramento,067,1510023,92425,90856,1186,92042,1304
2021-02-14,San Benito,069,59416,5675,5641,84,5725,56
2021-02-14,San Bernardino,071,2135413,283846,277664,8432,286096,2929
2021-02-14,San Diego,073,3302833,259652,252247,12503,264750,3037
2021-02-14,San Francisco,075,870044,33527,33374,1018,34392,372
2021-02-14,San Joaquin,077,732212,65641,64243,2690,66933,979
2021-02-14,San Luis Obispo,079,281455,19334,18868,537,19405,225
2021-02-14,San Mateo,081,765935,38859,37859,387,38246,277
2021-02-14,Santa Barbara,083,443738,31434,30744,1078,31822,377
2021-02-14,Santa Clara,085,1922200,108033,107412,545,107957,1582
2021-02-14,Santa Cruz,087,273765,15139,14225,764,14989,175
2021-02-14,Shasta,089,179085,10779,10720,1175,11895,139
2021-02-14,Sierra,091,2930,50,47,12,59,0
2021-02-14,Siskiyou,093,43540,1438,1340,220,1560,4
2021-02-14,Solano,095,438530,29393,29150,344,29494,148
2021-02-14,Sonoma,097,501317,27360,27266,174,27440,276
2021-02-14,Stanislaus,099,539301,49601,48672,5182,53854,716
2021-02-14,Sutter,101,95872,8728,8642,79,8721,95
2021-02-14,Tehama,103,63373,4535,4490,482,4972,30
2021-02-14,Trinity,105,12862,456,272,71,343,3
2021-02-14,Tulare,107,460477,47553,46263,7657,53920,715
2021-02-14,Tuolumne,109,53932,3732,3764,33,3797,49
2021-02-14,Ventura,111,848112,76451,75742,2717,78459,629
2021-02-14,Yolo,113,214977,12619,12399,205,12604,175
2021-02-14,Yuba,115,75493,5395,5314,82,5396,38
2021-02-13,Alameda,001,1643700,79203,78246,1687,79933,995
2021-02-13,Alpine,003,1148,78,76,0,76,0
2021-02-13,Amador,005,37829,3420,3387,29,3416,38
2021-02-13,Butte,007,227075,11135,10699,1575,12274,155
2021-02-13,Calaveras,009,45235,1873,1863,12,1875,21
2021-02-13,Colusa,011,21464,1855,1837,249,2086,10
2021-02-13,Contra Costa,013,1133247,61613,60100,1045,61145,629
2021-02-13,Del Norte,015,27424,955,908,4,912,2
2021-02-13,El Dorado,017,186661,8971,8758,587,9345,93
2021-02-13,Fresno,019,978130,94617,92807,7455,100262,1287
2021-02-13,Glenn,021,27897,2212,2182,480,2662,14
2021-02-13,Humboldt,023,135768,3013,2974,20,2994,29
2021-02-13,Imperial,025,180216,27058,26680,2535,29215,580
2021-02-13,Inyo,027,18085,1221,1168,8,1176,32
2021-02-13,Kern,029,883053,91930,89915,9411,99326,957
2021-02-13,Kings,031,150075,21953,21513,942,22455,205
2021-02-13,Lake,033,64148,3083,3025,1,3026,37
2021-02-13,Lassen,035,31185,5072,5028,92,5120,1
2021-02-13,Los Angeles,037,10098052,1159059,1133752,38589,1172341,18822
2021-02-13,Madera,039,155013,15316,15053,776,15829,106
2021-02-13,Marin,041,260295,12940,12757,155,12912,201
2021-02-13,Mariposa,043,17540,373,365,4,369,4
2021-02-13,Mendocino,045,87422,3574,3466,67,3533,38
2021-02-13,Merced,047,269075,27721,27541,825,28366,368
2021-02-13,Modoc,049,8938,336,325,113,438,3
2021-02-13,Mono,051,14174,1169,1176,16,1192,3
2021-02-13,Monterey,053,433212,41418,40731,1626,42357,301
2021-02-13,Napa,055,140530,8870,8809,33,8842,57
2021-02-13,Nevada,057,99092,3868,3742,151,3893,47
2021-02-13,Orange,059,3164182,244141,241545,10001,251546,3520
2021-02-13,Placer,061,380077,20165,19214,1073,20287,230
2021-02-13,Plumas,063,18699,636,616,10,626,4
2021-02-13,Riverside,065,2383286,282487,275276,13254,288530,3462
2021-02-13,Sacramento,067,1510023,92258,90401,1183,91584,1302
2021-02-13,San Benito,069,59416,5661,5633,84,5717,56
2021-02-13,San Bernardino,071,2135413,283694,277405,8420,285825,2899
2021-02-13,San Diego,073,3302833,259320,251679,12491,264170,3009
2021-02-13,San Francisco,075,870044,33477,33291,1008,34299,364
2021-02-13,San Joaquin,077,732212,65574,64105,2680,66785,977
2021-02-13,San Luis Obispo,079,281455,19306,18803,531,19334,225
2021-02-13,San Mateo,081,765935,38806,37745,387,38132,277
2021-02-13,Santa Barbara,083,443738,31382,30594,1076,31670,374
2021-02-13,Santa Clara,085,1922200,107848,107125,541,107666,1570
2021-02-13,Santa Cruz,087,273765,15112,14198,763,14961,173
2021-02-13,Shasta,089,179085,10767,10713,1170,11883,139
2021-02-13,Sierra,091,2930,50,47,12,59,0
2021-02-13,Siskiyou,093,43540,1435,1336,220,1556,4
2021-02-13,Solano,095,438530,29356,29084,344,29428,148
2021-02-13,Sonoma,097,501317,27313,27157,172,27329,276
2021-02-13,Stanislaus,099,539301,49532,48568,5176,53744,697
2021-02-13,Sutter,101,95872,8716,8626,79,8705,94
2021-02-13,Tehama,103,63373,4526,4484,481,4965,30
2021-02-13,Trinity,105,12862,455,272,70,342,3
2021-02-13,Tulare,107,460477,47502,46162,7626,53788,709
2021-02-13,Tuolumne,109,53932,3731,3752,33,3785,49
2021-02-13,Ventura,111,848112,76313,75481,2711,78192,618
2021-02-13,Yolo,113,214977,12607,12374,204,12578,175
2021-02-13,Yuba,115,75493,5387,5289,82,5371,38
2021-02-12,Alameda,001,1643700,79067,77958,1681,79639,974
2021-02-12,Alpine,003,1148,78,76,0,76,0
2021-02-12,Amador,005,37829,3416,3381,29,3410,38
2021-02-12,Butte,007,227075,11120,10655,1568,12223,155
2021-02-12,Calaveras,009,45235,1870,1860,12,1872,21
2021-02-12,Colusa,011,21464,1855,1836,249,2085,10
2021-02-12,Contra Costa,013,1133247,61463,59878,1041,60919,620
2021-02-12,Del Norte,015,27424,945,901,4,905,2
2021-02-12,El Dorado,017,186661,8955,8725,584,9309,92
2021-02-12,Fresno,019,978130,94463,92520,7435,99955,1273
2021-02-12,Glenn,021,27897,2209,2175,480,2655,14
2021-02-12,Humboldt,023,135768,3005,2961,20,2981,29
2021-02-12,Imperial,025,180216,27049,26646,2533,29179,585
2021-02-12,Inyo,027,18085,1215,1156,8,1164,32
2021-02-12,Kern,029,883053,91819,89532,9376,98908,949
2021-02-12,Kings,031,150075,21921,21462,937,22399,202
2021-02-12,Lake,033,64148,3079,3012,1,3013,36
2021-02-12,Lassen,035,31185,5070,5015,92,5107,1
2021-02-12,Los Angeles,037,10098052,1157854,1131185,38520,1169705,18637
2021-02-12,Madera,039,155013,15289,15022,773,15795,106
2021-02-12,Marin,041,260295,12914,12720,155,12875,200
2021-02-12,Mariposa,043,17540,372,365,4,369,4
2021-02-12,Mendocino,045,87422,3572,3447,67,3514,38
2021-02-12,Merced,047,269075,27670,27453,822,28275,367
2021-02-12,Modoc,049,8938,336,324,113,437,3
2021-02-12,Mono,051,14174,1168,1172,16,1188,3
2021-02-12,Monterey,053,433212,41371,40633,1617,42250,297
2021-02-12,Napa,055,140530,8858,8785,33,8818,55
2021-02-12,Nevada,057,99092,3863,3728,151,3879,47
2021-02-12,Orange,059,3164182,243903,241075,9987,251062,3505
2021-02-12,Placer,061,380077,20123,19174,1068,20242,230
2021-02-12,Plumas,063,18699,635,614,10,624,4
2021-02-12,Riverside,065,2383286,282210,274792,13236,288028,3438
2021-02-12,Sacramento,067,1510023,92055,90252,1182,91434,1295
2021-02-12,San Benito,069,59416,5645,5622,83,5705,56
2021-02-12,San Bernardino,071,2135413,283501,276890,8409,285299,2827
2021-02-12,San Diego,073,3302833,258938,250788,12465,263253,2979
2021-02-12,San Francisco,075,870044,33418,33179,1004,34183,359
2021-02-12,San Joaquin,077,732212,65480,63966,2672,66638,975
2021-02-12,San Luis Obispo,079,281455,19265,18687,530,19217,224
2021-02-12,San Mateo,081,765935,38734,37560,387,37947,254
2021-02-12,Santa Barbara,083,443738,31311,30454,1071,31525,372
2021-02-12,Santa Clara,085,1922200,107679,106759,538,107297,1543
2021-02-12,Santa Cruz,087,273765,15092,14147,763,14910,170
2021-02-12,Shasta,089,179085,10748,10693,1160,11853,142
2021-02-12,Sierra,091,2930,49,45,12,57,0
2021-02-12,Siskiyou,093,43540,1431,1324,217,1541,4
2021-02-12,Solano,095,438530,29324,28996,341,29337,147
2021-02-12,Sonoma,097,501317,27259,27064,168,27232,275
2021-02-12,Stanislaus,099,539301,49447,48418,5153,53571,697
2021-02-12,Sutter,101,95872,8702,8609,79,8688,93
2021-02-12,Tehama,103,63373,4518,4470,480,4950,27
2021-02-12,Trinity,105,12862,455,269,70,339,3
2021-02-12,Tulare,107,460477,47424,46016,7599,53615,710
2021-02-12,Tuolumne,109,53932,3728,3736,32,3768,49
2021-02-12,Ventura,111,848112,76145,75210,2704,77914,605
2021-02-12,Yolo,113,214977,12587,12340,204,12544,175
2021-02-12,Yuba,115,75493,5379,5274,82,5356,38
2021-02-11,Alameda,001,1643700,78840,77564,1676,79240,960
2021-02-11,Alpine,003,1148,77,76,0,76,0
2021-02-11,Amador,005,37829,3412,3368,29,3397,35
2021-02-11,Butte,007,227075,11096,10624,1566,12190,155
2021-02-11,Calaveras,009,45235,1867,1856,12,1868,21
2021-02-11,Colusa,011,21464,1850,1823,247,2070,10
2021-02-11,Contra Costa,013,1133247,61296,59633,1037,60670,605
2021-02-11,Del Norte,015,27424,940,894,4,898,2
2021-02-11,El Dorado,017,186661,8934,8698,584,9282,92
2021-02-11,Fresno,019,978130,94309,92168,7410,99578,1255
2021-02-11,Glenn,021,27897,2205,2166,479,2645,14
2021-02-11,Humboldt,023,135768,2992,2954,19,2973,29
2021-02-11,Imperial,025,180216,27026,26545,2531,29076,578
2021-02-11,Inyo,027,18085,1206,1144,8,1152,32
2021-02-11,Kern,029,883053,91628,89224,9332,98556,941
2021-02-11,Kings,031,150075,21891,21373,934,22307,202
2021-02-11,Lake,033,64148,3069,3002,1,3003,36
2021-02-11,Lassen,035,31185,5059,5004,89,5093,1
2021-02-11,Los Angeles,037,10098052,1156222,1128437,38451,1166888,18500
2021-02-11,Madera,039,155013,15268,14984,771,15755,106
2021-02-11,Marin,041,260295,12877,12682,155,12837,200
2021-02-11,Mariposa,043,17540,372,361,4,365,4
2021-02-11,Mendocino,045,87422,3565,3420,67,3487,38
2021-02-11,Merced,047,269075,27604,27325,818,28143,363
2021-02-11,Modoc,049,8938,335,317,113,430,3
2021-02-11,Mono,051,14174,1164,1173,16,1189,3
2021-02-11,Monterey,053,433212,41263,40469,1611,42080,295
2021-02-11,Napa,055,140530,8837,8777,33,8810,55
2021-02-11,Nevada,057,99092,3847,3720,151,3871,47
2021-02-11,Orange,059,3164182,243538,240590,9964,250554,3476
2021-02-11,Placer,061,380077,20083,19118,1067,20185,224
2021-02-11,Plumas,063,18699,634,592,10,602,4
2021-02-11,Riverside,065,2383286,281841,274313,13221,287534,3394
2021-02-11,Sacramento,067,1510023,91812,89988,1176,91164,1286
2021-02-11,San Benito,069,59416,5636,5609,83,5692,56
2021-02-11,San Bernardino,071,2135413,283186,276349,8395,284744,2774
2021-02-11,San Diego,073,3302833,258386,249971,12431,262402,2955
2021-02-11,San Francisco,075,870044,33333,33076,995,34071,356
2021-02-11,San Joaquin,077,732212,65310,63719,2662,66381,971
2021-02-11,San Luis Obispo,079,281455,19200,18615,526,19141,219
2021-02-11,San Mateo,081,765935,38643,37439,385,37824,253
2021-02-11,Santa Barbara,083,443738,31215,30375,1066,31441,370
2021-02-11,Santa Clara,085,1922200,107422,106392,532,106924,1507
2021-02-11,Santa Cruz,087,273765,15069,14088,758,14846,165
2021-02-11,Shasta,089,179085,10724,10672,1156,11828,140
2021-02-11,Sierra,091,2930,49,45,12,57,0
2021-02-11,Siskiyou,093,43540,1416,1320,217,1537,4
2021-02-11,Solano,095,438530,29272,28885,341,29226,138
2021-02-11,Sonoma,097,501317,27176,26971,165,27136,272
2021-02-11,Stanislaus,099,539301,49303,48205,5142,53347,697
2021-02-11,Sutter,101,95872,8688,8590,78,8668,93
2021-02-11,Tehama,103,63373,4512,4463,480,4943,26
2021-02-11,Trinity,105,12862,455,269,70,339,3
2021-02-11,Tulare,107,460477,47329,45897,7558,53455,706
2021-02-11,Tuolumne,109,53932,3691,3716,32,3748,48
2021-02-11,Ventura,111,848112,75944,74959,2695,77654,590
2021-02-11,Yolo,113,214977,12564,12303,202,12505,173
2021-02-11,Yuba,115,75493,5365,5261,80,5341,38
2021-02-10,Alameda,001,1643700,78637,77344,1675,79019,944
2021-02-10,Alpine,003,1148,77,76,0,76,0
2021-02-10,Amador,005,37829,3400,3348,29,3377,35
2021-02-10,Butte,007,227075,11070,10594,1565,12159,155
2021-02-10,Calaveras,009,45235,1865,1850,12,1862,21
2021-02-10,Colusa,011,21464,1843,1815,245,2060,10
2021-02-10,Contra Costa,013,1133247,61124,59488,1035,60523,590
2021-02-10,Del Norte,015,27424,934,888,4,892,2
2021-02-10,El Dorado,017,186661,8903,8682,580,9262,87
2021-02-10,Fresno,019,978130,94134,91876,7384,99260,1247
2021-02-10,Glenn,021,27897,2203,2160,476,2636,14
2021-02-10,Humboldt,023,135768,2984,2924,19,2943,29
2021-02-10,Imperial,025,180216,26987,26522,2528,29050,578
2021-02-10,Inyo,027,18085,1194,1138,8,1146,30
2021-02-10,Kern,029,883053,91421,88933,9278,98211,926
2021-02-10,Kings,031,150075,21848,21294,932,22226,197
2021-02-10,Lake,033,64148,3056,2975,1,2976,36
2021-02-10,Lassen,035,31185,5055,4993,89,5082,1
2021-02-10,Los Angeles,037,10098052,1154477,1125437,38322,1163759,18338
2021-02-10,Madera,039,155013,15230,14925,769,15694,105
2021-02-10,Marin,041,260295,12840,12651,155,12806,199
2021-02-10,Mariposa,043,17540,370,360,4,364,4
2021-02-10,Mendocino,045,87422,3550,3395,67,3462,38
2021-02-10,Merced,047,269075,27521,27246,807,28053,359
2021-02-10,Modoc,049,8938,334,315,111,426,3
2021-02-10,Mono,051,14174,1159,1170,16,1186,3
2021-02-10,Monterey,053,433212,41184,40366,1596,41962,288
2021-02-10,Napa,055,140530,8818,8769,33,8802,55
2021-02-10,Nevada,057,99092,3832,3693,149,3842,47
2021-02-10,Orange,059,3164182,243118,239974,9933,249907,3439
2021-02-10,Placer,061,380077,20044,19062,1062,20124,220
2021-02-10,Plumas,063,18699,631,589,10,599,2
2021-02-10,Riverside,065,2383286,281415,273721,13211,286932,3374
2021-02-10,Sacramento,067,1510023,91561,89653,1172,90825,1275
2021-02-10,San Benito,069,59416,5622,5591,83,5674,55
2021-02-10,San Bernardino,071,2135413,282823,275616,8379,283995,2696
2021-02-10,San Diego,073,3302833,257804,248858,12393,261251,2904
2021-02-10,San Francisco,075,870044,33251,32955,992,33947,351
2021-02-10,San Joaquin,077,732212,65169,63484,2648,66132,954
2021-02-10,San Luis Obispo,079,281455,19121,18549,524,19073,216
2021-02-10,San Mateo,081,765935,38553,37323,385,37708,245
2021-02-10,Santa Barbara,083,443738,31123,30216,1061,31277,359
2021-02-10,Santa Clara,085,1922200,107183,106048,529,106577,1489
2021-02-10,Santa Cruz,087,273765,15033,14007,756,14763,165
2021-02-10,Shasta,089,179085,10701,10645,1153,11798,142
2021-02-10,Sierra,091,2930,49,45,12,57,0
2021-02-10,Siskiyou,093,43540,1411,1314,216,1530,4
2021-02-10,Solano,095,438530,29197,28835,339,29174,137
2021-02-10,Sonoma,097,501317,27084,26881,163,27044,271
2021-02-10,Stanislaus,099,539301,49186,48016,5125,53141,696
2021-02-10,Sutter,101,95872,8671,8571,78,8649,93
2021-02-10,Tehama,103,63373,4504,4445,480,4925,23
2021-02-10,Trinity,105,12862,452,268,70,338,3
2021-02-10,Tulare,107,460477,47212,45782,7519,53301,696
2021-02-10,Tuolumne,109,53932,3683,3691,32,3723,48
2021-02-10,Ventura,111,848112,75717,74651,2678,77329,580
2021-02-10,Yolo,113,214977,12540,12276,201,12477,174
2021-02-10,Yuba,115,75493,5347,5241,80,5321,38
2021-02-09,Alameda,001,1643700,78374,77018,1672,78690,936
2021-02-09,Alpine,003,1148,77,76,0,76,0
2021-02-09,Amador,005,37829,3392,3347,29,3376,35
2021-02-09,Butte,007,227075,11043,10563,1563,12126,153
2021-02-09,Calaveras,009,45235,1861,1847,12,1859,21
2021-02-09,Colusa,011,21464,1834,1812,240,2052,10
2021-02-09,Contra Costa,013,1133247,60935,59307,1029,60336,583
2021-02-09,Del Norte,015,27424,928,886,4,890,2
2021-02-09,El Dorado,017,186661,8876,8663,579,9242,87
2021-02-09,Fresno,019,978130,93892,91730,7356,99086,1211
2021-02-09,Glenn,021,27897,2199,2156,475,2631,14
2021-02-09,Humboldt,023,135768,2976,2904,19,2923,29
2021-02-09,Imperial,025,180216,26960,26509,2525,29034,568
2021-02-09,Inyo,027,18085,1186,1137,8,1145,30
2021-02-09,Kern,029,883053,91172,88684,9232,97916,920
2021-02-09,Kings,031,150075,21806,21275,930,22205,196
2021-02-09,Lake,033,64148,3045,2955,1,2956,36
2021-02-09,Lassen,035,31185,5048,4983,89,5072,1
2021-02-09,Los Angeles,037,10098052,1152507,1122745,38236,1160981,18198
2021-02-09,Madera,039,155013,15210,14912,766,15678,105
2021-02-09,Marin,041,260295,12807,12623,154,12777,197
2021-02-09,Mariposa,043,17540,368,355,4,359,4
2021-02-09,Mendocino,045,87422,3532,3369,67,3436,38
2021-02-09,Merced,047,269075,27423,27166,802,27968,354
2021-02-09,Modoc,049,8938,333,316,111,427,3
2021-02-09,Mono,051,14174,1158,1167,16,1183,3
2021-02-09,Monterey,053,433212,41077,40279,1584,41863,285
2021-02-09,Napa,055,140530,8805,8749,33,8782,55
2021-02-09,Nevada,057,99092,3816,3687,149,3836,44
2021-02-09,Orange,059,3164182,242703,239169,9902,249071,3406
2021-02-09,Placer,061,380077,19979,19008,1055,20063,220
2021-02-09,Plumas,063,18699,631,584,10,594,2
2021-02-09,Riverside,065,2383286,280921,273465,13195,286660,3334
2021-02-09,Sacramento,067,1510023,91250,89378,1171,90549,1265
2021-02-09,San Benito,069,59416,5610,5566,82,5648,54
2021-02-09,San Bernardino,071,2135413,282450,274998,8366,283364,2613
2021-02-09,San Diego,073,3302833,257147,248048,12350,260398,2853
2021-02-09,San Francisco,075,870044,33172,32782,982,33764,349
2021-02-09,San Joaquin,077,732212,64995,63341,2643,65984,937
2021-02-09,San Luis Obispo,079,281455,19062,18489,523,19012,216
2021-02-09,San Mateo,081,765935,38422,37227,384,37611,235
2021-02-09,Santa Barbara,083,443738,31012,30118,1055,31173,351
2021-02-09,Santa Clara,085,1922200,106876,105762,526,106288,1463
2021-02-09,Santa Cruz,087,273765,14983,13958,751,14709,162
2021-02-09,Shasta,089,179085,10674,10595,1151,11746,139
2021-02-09,Sierra,091,2930,49,44,12,56,0
2021-02-09,Siskiyou,093,43540,1403,1306,214,1520,4
2021-02-09,Solano,095,438530,29120,28769,336,29105,131
2021-02-09,Sonoma,097,501317,26994,26826,161,26987,267
2021-02-09,Stanislaus,099,539301,49025,47906,5109,53015,679
2021-02-09,Sutter,101,95872,8654,8541,78,8619,92
2021-02-09,Tehama,103,63373,4497,4416,478,4894,22
2021-02-09,Trinity,105,12862,452,266,70,336,3
2021-02-09,Tulare,107,460477,47078,45704,7465,53169,686
2021-02-09,Tuolumne,109,53932,3664,3673,32,3705,48
2021-02-09,Ventura,111,848112,75467,74333,2670,77003,567
2021-02-09,Yolo,113,214977,12499,12220,201,12421,174
2021-02-09,Yuba,115,75493,5338,5235,80,5315,35
2021-02-08,Alameda,001,1643700,78111,76735,1667,78402,924
2021-02-08,Alpine,003,1148,77,73,0,73,0
2021-02-08,Amador,005,37829,3385,3344,28,3372,33
2021-02-08,Butte,007,227075,11021,10524,1560,12084,152
2021-02-08,Calaveras,009,45235,1860,1840,12,1852,21
2021-02-08,Colusa,011,21464,1826,1802,236,2038,10
2021-02-08,Contra Costa,013,1133247,60727,59039,1027,60066,567
2021-02-08,Del Norte,015,27424,925,885,4,889,2
2021-02-08,El Dorado,017,186661,8845,8627,577,9204,86
2021-02-08,Fresno,019,978130,93679,91430,7330,98760,1207
2021-02-08,Glenn,021,27897,2193,2148,473,2621,14
2021-02-08,Humboldt,023,135768,2968,2902,19,2921,29
2021-02-08,Imperial,025,180216,26940,26526,2523,29049,567
2021-02-08,Inyo,027,18085,1173,1126,8,1134,30
2021-02-08,Kern,029,883053,90957,88380,9174,97554,920
2021-02-08,Kings,031,150075,21744,21232,927,22159,195
2021-02-08,Lake,033,64148,3026,2949,1,2950,36
2021-02-08,Lassen,035,31185,5035,4976,89,5065,1
2021-02-08,Los Angeles,037,10098052,1150411,1120179,38116,1158295,17977
2021-02-08,Madera,039,155013,15174,14887,759,15646,93
2021-02-08,Marin,041,260295,12778,12591,154,12745,194
2021-02-08,Mariposa,043,17540,368,355,4,359,4
2021-02-08,Mendocino,045,87422,3518,3355,67,3422,38
2021-02-08,Merced,047,269075,27338,27082,797,27879,346
2021-02-08,Modoc,049,8938,331,318,111,429,3
2021-02-08,Mono,051,14174,1158,1165,16,1181,3
2021-02-08,Monterey,053,433212,40957,40186,1565,41751,283
2021-02-08,Napa,055,140530,8790,8719,33,8752,55
2021-02-08,Nevada,057,99092,3804,3671,149,3820,44
2021-02-08,Orange,059,3164182,242234,238715,9878,248593,3361
2021-02-08,Placer,061,380077,19937,18944,1049,19993,211
2021-02-08,Plumas,063,18699,630,584,10,594,2
2021-02-08,Riverside,065,2383286,280352,272904,13169,286073,3301
2021-02-08,Sacramento,067,1510023,90963,89267,1168,90435,1247
2021-02-08,San Benito,069,59416,5605,5553,81,5634,52
2021-02-08,San Bernardino,071,2135413,282046,274661,8360,283021,2587
2021-02-08,San Diego,073,3302833,256405,247259,12309,259568,2821
2021-02-08,San Francisco,075,870044,33078,32679,974,33653,348
2021-02-08,San Joaquin,077,732212,64834,63148,2633,65781,929
2021-02-08,San Luis Obispo,079,281455,19005,18421,518,18939,214
2021-02-08,San Mateo,081,765935,38313,37084,384,37468,232
2021-02-08,Santa Barbara,083,443738,30897,29978,1048,31026,340
2021-02-08,Santa Clara,085,1922200,106551,105413,518,105931,1456
2021-02-08,Santa Cruz,087,273765,14944,13921,745,14666,161
2021-02-08,Shasta,089,179085,10648,10574,1145,11719,137
2021-02-08,Sierra,091,2930,49,44,12,56,0
2021-02-08,Siskiyou,093,43540,1400,1303,214,1517,4
2021-02-08,Solano,095,438530,29056,28644,334,28978,130
2021-02-08,Sonoma,097,501317,26903,26760,160,26920,259
2021-02-08,Stanislaus,099,539301,48872,47704,5081,52785,679
2021-02-08,Sutter,101,95872,8635,8526,78,8604,92
2021-02-08,Tehama,103,63373,4482,4403,476,4879,22
2021-02-08,Trinity,105,12862,450,266,70,336,3
2021-02-08,Tulare,107,460477,46970,45617,7425,53042,673
2021-02-08,Tuolumne,109,53932,3656,3647,32,3679,48
2021-02-08,Ventura,111,848112,75210,74068,2664,76732,565
2021-02-08,Yolo,113,214977,12467,12169,200,12369,162
2021-02-08,Yuba,115,75493,5322,5215,80,5295,35
2021-02-07,Alameda,001,1643700,77808,76500,1659,78159,924
2021-02-07,Alpine,003,1148,74,72,0,72,0
2021-02-07,Amador,005,37829,3364,3343,28,3371,33
2021-02-07,Butte,007,227075,10988,10513,1550,12063,152
2021-02-07,Calaveras,009,45235,1855,1837,12,1849,21
2021-02-07,Colusa,011,21464,1815,1795,234,2029,10
2021-02-07,Contra Costa,013,1133247,60487,58836,1022,59858,566
2021-02-07,Del Norte,015,27424,921,881,4,885,2
2021-02-07,El Dorado,017,186661,8816,8596,575,9171,86
2021-02-07,Fresno,019,978130,93449,91184,7292,98476,1207
2021-02-07,Glenn,021,27897,2189,2141,470,2611,14
2021-02-07,Humboldt,023,135768,2947,2895,19,2914,28
2021-02-07,Imperial,025,180216,26911,26518,2517,29035,567
2021-02-07,Inyo,027,18085,1162,1124,8,1132,27
2021-02-07,Kern,029,883053,90712,88146,9117,97263,920
2021-02-07,Kings,031,150075,21683,21180,924,22104,192
2021-02-07,Lake,033,64148,3010,2940,1,2941,36
2021-02-07,Lassen,035,31185,5024,4973,89,5062,1
2021-02-07,Los Angeles,037,10098052,1147655,1117551,37988,1155539,17889
2021-02-07,Madera,039,155013,15140,14850,755,15605,93
2021-02-07,Marin,041,260295,12744,12571,152,12723,194
2021-02-07,Mariposa,043,17540,367,355,4,359,4
2021-02-07,Mendocino,045,87422,3501,3348,67,3415,38
2021-02-07,Merced,047,269075,27226,26977,785,27762,346
2021-02-07,Modoc,049,8938,331,317,107,424,3
2021-02-07,Mono,051,14174,1155,1165,16,1181,3
2021-02-07,Monterey,053,433212,40822,40113,1545,41658,283
2021-02-07,Napa,055,140530,8767,8701,33,8734,55
2021-02-07,Nevada,057,99092,3793,3643,149,3792,44
2021-02-07,Orange,059,3164182,241636,238155,9846,248001,3336
2021-02-07,Placer,061,380077,19890,18903,1036,19939,211
2021-02-07,Plumas,063,18699,630,584,10,594,2
2021-02-07,Riverside,065,2383286,279824,272301,13148,285449,3267
2021-02-07,Sacramento,067,1510023,90631,88919,1161,90080,1246
2021-02-07,San Benito,069,59416,5586,5548,80,5628,52
2021-02-07,San Bernardino,071,2135413,281464,274316,8335,282651,2587
2021-02-07,San Diego,073,3302833,255619,246561,12245,258806,2821
2021-02-07,San Francisco,075,870044,32957,32609,962,33571,348
2021-02-07,San Joaquin,077,732212,64560,63051,2618,65669,929
2021-02-07,San Luis Obispo,079,281455,18933,18349,511,18860,214
2021-02-07,San Mateo,081,765935,38179,36984,382,37366,232
2021-02-07,Santa Barbara,083,443738,30757,29815,1037,30852,340
2021-02-07,Santa Clara,085,1922200,106211,105118,508,105626,1450
2021-02-07,Santa Cruz,087,273765,14890,13887,741,14628,161
2021-02-07,Shasta,089,179085,10628,10570,1137,11707,137
2021-02-07,Sierra,091,2930,49,43,12,55,0
2021-02-07,Siskiyou,093,43540,1393,1295,212,1507,4
2021-02-07,Solano,095,438530,28946,28567,333,28900,130
2021-02-07,Sonoma,097,501317,26796,26684,156,26840,257
2021-02-07,Stanislaus,099,539301,48682,47551,5049,52600,679
2021-02-07,Sutter,101,95872,8607,8515,78,8593,92
2021-02-07,Tehama,103,63373,4468,4396,474,4870,22
2021-02-07,Trinity,105,12862,447,264,68,332,3
2021-02-07,Tulare,107,460477,46848,45520,7347,52867,671
2021-02-07,Tuolumne,109,53932,3632,3619,31,3650,48
2021-02-07,Ventura,111,848112,74901,73759,2652,76411,561
2021-02-07,Yolo,113,214977,12422,12135,200,12335,162
2021-02-07,Yuba,115,75493,5307,5198,78,5276,35
2021-02-06,Alameda,001,1643700,77654,76170,1648,77818,922
2021-02-06,Alpine,003,1148,74,72,0,72,0
2021-02-06,Amador,005,37829,3358,3306,28,3334,33
2021-02-06,Butte,007,227075,10971,10480,1546,12026,150
2021-02-06,Calaveras,009,45235,1853,1832,12,1844,21
2021-02-06,Colusa,011,21464,1813,1791,233,2024,10
2021-02-06,Contra Costa,013,1133247,60340,58567,1016,59583,566
2021-02-06,Del Norte,015,27424,917,879,4,883,2
2021-02-06,El Dorado,017,186661,8809,8575,571,9146,86
2021-02-06,Fresno,019,978130,93336,90944,7272,98216,1207
2021-02-06,Glenn,021,27897,2188,2136,469,2605,14
2021-02-06,Humboldt,023,135768,2936,2880,19,2899,28
2021-02-06,Imperial,025,180216,26901,26514,2516,29030,567
2021-02-06,Inyo,027,18085,1159,1113,8,1121,27
2021-02-06,Kern,029,883053,90560,87919,9071,96990,912
2021-02-06,Kings,031,150075,21653,21156,924,22080,190
2021-02-06,Lake,033,64148,3005,2920,1,2921,34
2021-02-06,Lassen,035,31185,5020,4964,88,5052,1
2021-02-06,Los Angeles,037,10098052,1146301,1114718,37890,1152608,17793
2021-02-06,Madera,039,155013,15119,14807,753,15560,93
2021-02-06,Marin,041,260295,12724,12531,152,12683,194
2021-02-06,Mariposa,043,17540,366,355,3,358,4
2021-02-06,Mendocino,045,87422,3483,3316,66,3382,38
2021-02-06,Merced,047,269075,27140,26881,778,27659,346
2021-02-06,Modoc,049,8938,331,313,107,420,3
2021-02-06,Mono,051,14174,1154,1159,16,1175,3
2021-02-06,Monterey,053,433212,40765,39995,1537,41532,282
2021-02-06,Napa,055,140530,8754,8639,33,8672,55
2021-02-06,Nevada,057,99092,3781,3624,149,3773,43
2021-02-06,Orange,059,3164182,241272,237391,9812,247203,3293
2021-02-06,Placer,061,380077,19853,18836,1033,19869,211
2021-02-06,Plumas,063,18699,630,584,10,594,2
2021-02-06,Riverside,065,2383286,279457,271741,13129,284870,3243
2021-02-06,Sacramento,067,1510023,90414,88532,1151,89683,1237
2021-02-06,San Benito,069,59416,5568,5516,80,5596,52
2021-02-06,San Bernardino,071,2135413,281158,273718,8312,282030,2564
2021-02-06,San Diego,073,3302833,255123,245331,12210,257541,2812
2021-02-06,San Francisco,075,870044,32883,32437,952,33389,346
2021-02-06,San Joaquin,077,732212,64481,62840,2607,65447,906
2021-02-06,San Luis Obispo,079,281455,18891,18284,507,18791,214
2021-02-06,San Mateo,081,765935,38111,36824,379,37203,232
2021-02-06,Santa Barbara,083,443738,30681,29645,1035,30680,337
2021-02-06,Santa Clara,085,1922200,105990,104639,503,105142,1439
2021-02-06,Santa Cruz,087,273765,14859,13845,737,14582,161
2021-02-06,Shasta,089,179085,10617,10561,1135,11696,137
2021-02-06,Sierra,091,2930,49,43,12,55,0
2021-02-06,Siskiyou,093,43540,1390,1289,211,1500,4
2021-02-06,Solano,095,438530,28910,28446,332,28778,129
2021-02-06,Sonoma,097,501317,26759,26564,154,26718,257
2021-02-06,Stanislaus,099,539301,48584,47325,5033,52358,679
2021-02-06,Sutter,101,95872,8599,8485,78,8563,92
2021-02-06,Tehama,103,63373,4461,4380,472,4852,22
2021-02-06,Trinity,105,12862,447,263,68,331,3
2021-02-06,Tulare,107,460477,46780,45349,7300,52649,664
2021-02-06,Tuolumne,109,53932,3625,3612,31,3643,48
2021-02-06,Ventura,111,848112,74721,73431,2646,76077,552
2021-02-06,Yolo,113,214977,12399,12061,200,12261,161
2021-02-06,Yuba,115,75493,5297,5177,77,5254,35
2021-02-05,Alameda,001,1643700,77429,75716,1646,77362,916
2021-02-05,Alpine,003,1148,74,72,0,72,0
2021-02-05,Amador,005,37829,3353,3299,27,3326,33
2021-02-05,Butte,007,227075,10953,10421,1540,11961,150
2021-02-05,Calaveras,009,45235,1849,1818,12,1830,21
2021-02-05,Colusa,011,21464,1809,1785,233,2018,10
2021-02-05,Contra Costa,013,1133247,60179,58195,1014,59209,560
2021-02-05,Del Norte,015,27424,916,874,4,878,2
2021-02-05,El Dorado,017,186661,8789,8527,569,9096,86
2021-02-05,Fresno,019,978130,93134,90513,7251,97764,1194
2021-02-05,Glenn,021,27897,2184,2122,463,2585,14
2021-02-05,Humboldt,023,135768,2926,2857,19,2876,28
2021-02-05,Imperial,025,180216,26882,26474,2515,28989,557
2021-02-05,Inyo,027,18085,1155,1104,8,1112,27
2021-02-05,Kern,029,883053,90391,87470,9004,96474,906
2021-02-05,Kings,031,150075,21615,21021,921,21942,190
2021-02-05,Lake,033,64148,2993,2906,1,2907,33
2021-02-05,Lassen,035,31185,5016,4936,88,5024,1
2021-02-05,Los Angeles,037,10098052,1144204,1110384,37754,1148138,17608
2021-02-05,Madera,039,155013,15085,14752,748,15500,95
2021-02-05,Marin,041,260295,12689,12479,152,12631,193
2021-02-05,Mariposa,043,17540,366,352,3,355,4
2021-02-05,Mendocino,045,87422,3469,3272,66,3338,38
2021-02-05,Merced,047,269075,27080,26760,777,27537,345
2021-02-05,Modoc,049,8938,331,312,107,419,3
2021-02-05,Mono,051,14174,1153,1157,16,1173,3
2021-02-05,Monterey,053,433212,40698,39840,1526,41366,281
2021-02-05,Napa,055,140530,8740,8598,33,8631,55
2021-02-05,Nevada,057,99092,3778,3607,149,3756,43
2021-02-05,Orange,059,3164182,240845,236335,9785,246120,3260
2021-02-05,Placer,061,380077,19817,18756,1031,19787,211
2021-02-05,Plumas,063,18699,628,578,10,588,2
2021-02-05,Riverside,065,2383286,279043,270666,13110,283776,3235
2021-02-05,Sacramento,067,1510023,90234,87992,1144,89136,1231
2021-02-05,San Benito,069,59416,5557,5502,80,5582,51
2021-02-05,San Bernardino,071,2135413,280820,272938,8294,281232,2495
2021-02-05,San Diego,073,3302833,254547,244066,12175,256241,2777
2021-02-05,San Francisco,075,870044,32793,32229,941,33170,337
2021-02-05,San Joaquin,077,732212,64331,62565,2599,65164,902
2021-02-05,San Luis Obispo,079,281455,18830,18152,503,18655,213
2021-02-05,San Mateo,081,765935,38027,36582,378,36960,227
2021-02-05,Santa Barbara,083,443738,30584,29455,1022,30477,334
2021-02-05,Santa Clara,085,1922200,105742,104112,501,104613,1421
2021-02-05,Santa Cruz,087,273765,14838,13776,735,14511,161
2021-02-05,Shasta,089,179085,10601,10507,1128,11635,136
2021-02-05,Sierra,091,2930,49,42,12,54,0
2021-02-05,Siskiyou,093,43540,1383,1276,209,1485,4
2021-02-05,Solano,095,438530,28860,28283,332,28615,127
2021-02-05,Sonoma,097,501317,26690,26423,151,26574,252
2021-02-05,Stanislaus,099,539301,48442,47024,5015,52039,678
2021-02-05,Sutter,101,95872,8579,8443,78,8521,92
2021-02-05,Tehama,103,63373,4453,4355,472,4827,22
2021-02-05,Trinity,105,12862,446,260,68,328,3
2021-02-05,Tulare,107,460477,46704,45138,7250,52388,663
2021-02-05,Tuolumne,109,53932,3599,3595,31,3626,45
2021-02-05,Ventura,111,848112,74476,72953,2634,75587,546
2021-02-05,Yolo,113,214977,12380,12025,195,12220,162
2021-02-05,Yuba,115,75493,5280,5145,77,5222,35
2021-02-04,Alameda,001,1643700,77144,75422,1640,77062,899
2021-02-04,Alpine,003,1148,73,72,0,72,0
2021-02-04,Amador,005,37829,3350,3288,27,3315,33
2021-02-04,Butte,007,227075,10920,10386,1532,11918,147
2021-02-04,Calaveras,009,45235,1847,1808,12,1820,21
2021-02-04,Colusa,011,21464,1805,1777,231,2008,10
2021-02-04,Contra Costa,013,1133247,59990,57991,1010,59001,550
2021-02-04,Del Norte,015,27424,910,870,4,874,2
2021-02-04,El Dorado,017,186661,8763,8490,566,9056,86
2021-02-04,Fresno,019,978130,92919,90126,7224,97350,1114
2021-02-04,Glenn,021,27897,2180,2102,462,2564,14
2021-02-04,Humboldt,023,135768,2916,2827,19,2846,28
2021-02-04,Imperial,025,180216,26835,26411,2512,28923,556
2021-02-04,Inyo,027,18085,1143,1084,8,1092,27
2021-02-04,Kern,029,883053,90118,87156,8926,96082,898
2021-02-04,Kings,031,150075,21564,20918,914,21832,187
2021-02-04,Lake,033,64148,2981,2882,1,2883,34
2021-02-04,Lassen,035,31185,5013,4927,88,5015,1
2021-02-04,Los Angeles,037,10098052,1141408,1106323,37627,1143950,17396
2021-02-04,Madera,039,155013,15055,14706,745,15451,95
2021-02-04,Marin,041,260295,12653,12431,152,12583,192
2021-02-04,Mariposa,043,17540,366,348,3,351,4
2021-02-04,Mendocino,045,87422,3451,3240,64,3304,38
2021-02-04,Merced,047,269075,26986,26629,774,27403,345
2021-02-04,Modoc,049,8938,331,309,107,416,3
2021-02-04,Mono,051,14174,1151,1153,16,1169,3
2021-02-04,Monterey,053,433212,40586,39619,1509,41128,279
2021-02-04,Napa,055,140530,8711,8573,33,8606,55
2021-02-04,Nevada,057,99092,3758,3590,148,3738,37
2021-02-04,Orange,059,3164182,240203,235677,9743,245420,3238
2021-02-04,Placer,061,380077,19757,18711,1022,19733,210
2021-02-04,Plumas,063,18699,625,562,10,572,2
2021-02-04,Riverside,065,2383286,278281,269851,13071,282922,3230
2021-02-04,Sacramento,067,1510023,89934,87658,1134,88792,1222
2021-02-04,San Benito,069,59416,5543,5488,79,5567,51
2021-02-04,San Bernardino,071,2135413,280270,272223,8275,280498,2409
2021-02-04,San Diego,073,3302833,253759,242613,12109,254722,2738
2021-02-04,San Francisco,075,870044,32679,32116,932,33048,326
2021-02-04,San Joaquin,077,732212,64106,62374,2591,64965,883
2021-02-04,San Luis Obispo,079,281455,18763,18058,501,18559,211
2021-02-04,San Mateo,081,765935,37907,36437,375,36812,226
2021-02-04,Santa Barbara,083,443738,30449,29344,1005,30349,322
2021-02-04,Santa Clara,085,1922200,105395,103781,498,104279,1404
2021-02-04,Santa Cruz,087,273765,14805,13713,727,14440,156
2021-02-04,Shasta,089,179085,10575,10466,1123,11589,131
2021-02-04,Sierra,091,2930,49,42,12,54,0
2021-02-04,Siskiyou,093,43540,1374,1273,209,1482,4
2021-02-04,Solano,095,438530,28757,28192,331,28523,120
2021-02-04,Sonoma,097,501317,26608,26276,147,26423,249
2021-02-04,Stanislaus,099,539301,48279,46822,4996,51818,678
2021-02-04,Sutter,101,95872,8559,8401,78,8479,92
2021-02-04,Tehama,103,63373,4437,4327,472,4799,21
2021-02-04,Trinity,105,12862,445,260,67,327,3
2021-02-04,Tulare,107,460477,46577,44983,7188,52171,656
2021-02-04,Tuolumne,109,53932,3559,3585,31,3616,45
2021-02-04,Ventura,111,848112,74144,72595,2621,75216,537
2021-02-04,Yolo,113,214977,12346,11982,194,12176,161
2021-02-04,Yuba,115,75493,5254,5135,77,5212,34
2021-02-03,Alameda,001,1643700,76816,74968,1636,76604,880
2021-02-03,Alpine,003,1148,73,72,0,72,0
2021-02-03,Amador,005,37829,3346,3281,27,3308,33
2021-02-03,Butte,007,227075,10883,10355,1525,11880,144
2021-02-03,Calaveras,009,45235,1833,1799,11,1810,21
2021-02-03,Colusa,011,21464,1800,1773,230,2003,10
2021-02-03,Contra Costa,013,1133247,59751,57762,998,58760,537
2021-02-03,Del Norte,015,27424,905,869,4,873,2
2021-02-03,El Dorado,017,186661,8743,8428,565,8993,86
2021-02-03,Fresno,019,978130,92698,89748,7185,96933,1015
2021-02-03,Glenn,021,27897,2170,2098,460,2558,14
2021-02-03,Humboldt,023,135768,2906,2800,19,2819,27
2021-02-03,Imperial,025,180216,26801,26363,2506,28869,547
2021-02-03,Inyo,027,18085,1133,1071,8,1079,27
2021-02-03,Kern,029,883053,89876,86771,8885,95656,877
2021-02-03,Kings,031,150075,21503,20831,912,21743,172
2021-02-03,Lake,033,64148,2964,2869,1,2870,33
2021-02-03,Lassen,035,31185,5001,4910,88,4998,1
2021-02-03,Los Angeles,037,10098052,1138329,1101890,37502,1139392,17163
2021-02-03,Madera,039,155013,15016,14605,743,15348,94
2021-02-03,Marin,041,260295,12619,12406,152,12558,190
2021-02-03,Mariposa,043,17540,365,347,3,350,4
2021-02-03,Mendocino,045,87422,3425,3236,63,3299,38
2021-02-03,Merced,047,269075,26870,26520,769,27289,343
2021-02-03,Modoc,049,8938,330,308,107,415,3
2021-02-03,Mono,051,14174,1144,1146,16,1162,3
2021-02-03,Monterey,053,433212,40459,39500,1491,40991,279
2021-02-03,Napa,055,140530,8676,8534,33,8567,54
2021-02-03,Nevada,057,99092,3744,3572,148,3720,35
2021-02-03,Orange,059,3164182,239461,234738,9711,244449,3189
2021-02-03,Placer,061,380077,19702,18646,1020,19666,210
2021-02-03,Plumas,063,18699,625,559,10,569,2
2021-02-03,Riverside,065,2383286,277542,269019,13040,282059,3195
2021-02-03,Sacramento,067,1510023,89611,87415,1130,88545,1212
2021-02-03,San Benito,069,59416,5525,5463,76,5539,51
2021-02-03,San Bernardino,071,2135413,279788,271477,8252,279729,2308
2021-02-03,San Diego,073,3302833,252858,241015,12062,253077,2683
2021-02-03,San Francisco,075,870044,32549,31983,927,32910,325
2021-02-03,San Joaquin,077,732212,63878,61976,2581,64557,880
2021-02-03,San Luis Obispo,079,281455,18685,17922,498,18420,206
2021-02-03,San Mateo,081,765935,37769,36227,371,36598,225
2021-02-03,Santa Barbara,083,443738,30300,29121,995,30116,315
2021-02-03,Santa Clara,085,1922200,105077,103278,496,103774,1364
2021-02-03,Santa Cruz,087,273765,14750,13611,721,14332,154
2021-02-03,Shasta,089,179085,10532,10422,1118,11540,130
2021-02-03,Sierra,091,2930,49,42,12,54,0
2021-02-03,Siskiyou,093,43540,1363,1268,208,1476,4
2021-02-03,Solano,095,438530,28635,28057,331,28388,119
2021-02-03,Sonoma,097,501317,26524,26155,146,26301,248
2021-02-03,Stanislaus,099,539301,48103,46598,4977,51575,662
2021-02-03,Sutter,101,95872,8534,8379,78,8457,90
2021-02-03,Tehama,103,63373,4415,4309,469,4778,21
2021-02-03,Trinity,105,12862,445,260,66,326,3
2021-02-03,Tulare,107,460477,46406,44838,7132,51970,640
2021-02-03,Tuolumne,109,53932,3548,3568,31,3599,45
2021-02-03,Ventura,111,848112,73808,72124,2610,74734,526
2021-02-03,Yolo,113,214977,12322,11933,193,12126,161
2021-02-03,Yuba,115,75493,5236,5124,77,5201,34
2021-02-02,Alameda,001,1643700,76471,74642,1624,76266,869
2021-02-02,Alpine,003,1148,73,72,0,72,0
2021-02-02,Amador,005,37829,3315,3275,27,3302,33
2021-02-02,Butte,007,227075,10856,10307,1517,11824,141
2021-02-02,Calaveras,009,45235,1824,1786,11,1797,21
2021-02-02,Colusa,011,21464,1792,1769,225,1994,9
2021-02-02,Contra Costa,013,1133247,59471,57551,994,58545,536
2021-02-02,Del Norte,015,27424,899,868,4,872,2
2021-02-02,El Dorado,017,186661,8703,8405,565,8970,84
2021-02-02,Fresno,019,978130,92397,89542,7149,96691,1009
2021-02-02,Glenn,021,27897,2158,2090,457,2547,14
2021-02-02,Humboldt,023,135768,2894,2784,19,2803,25
2021-02-02,Imperial,025,180216,26749,26317,2500,28817,535
2021-02-02,Inyo,027,18085,1130,1074,8,1082,27
2021-02-02,Kern,029,883053,89574,86485,8809,95294,867
2021-02-02,Kings,031,150075,21425,20785,904,21689,172
2021-02-02,Lake,033,64148,2944,2857,1,2858,33
2021-02-02,Lassen,035,31185,4994,4908,88,4996,1
2021-02-02,Los Angeles,037,10098052,1134946,1097573,37337,1134910,16913
2021-02-02,Madera,039,155013,14965,14595,738,15333,94
2021-02-02,Marin,041,260295,12590,12367,152,12519,189
2021-02-02,Mariposa,043,17540,362,345,3,348,4
2021-02-02,Mendocino,045,87422,3392,3210,63,3273,38
2021-02-02,Merced,047,269075,26772,26427,762,27189,340
2021-02-02,Modoc,049,8938,325,306,107,413,3
2021-02-02,Mono,051,14174,1142,1147,16,1163,3
2021-02-02,Monterey,053,433212,40323,39371,1477,40848,278
2021-02-02,Napa,055,140530,8647,8505,33,8538,53
2021-02-02,Nevada,057,99092,3729,3548,148,3696,20
2021-02-02,Orange,059,3164182,238659,233783,9676,243459,3152
2021-02-02,Placer,061,380077,19644,18615,1016,19631,205
2021-02-02,Plumas,063,18699,625,560,10,570,2
2021-02-02,Riverside,065,2383286,276680,267901,13006,280907,3169
2021-02-02,Sacramento,067,1510023,89321,87107,1119,88226,1202
2021-02-02,San Benito,069,59416,5511,5444,75,5519,50
2021-02-02,San Bernardino,071,2135413,279111,270486,8222,278708,2244
2021-02-02,San Diego,073,3302833,251819,240047,11975,252022,2629
2021-02-02,San Francisco,075,870044,32395,31788,917,32705,324
2021-02-02,San Joaquin,077,732212,63659,61708,2567,64275,878
2021-02-02,San Luis Obispo,079,281455,18591,17811,496,18307,201
2021-02-02,San Mateo,081,765935,37605,36004,365,36369,225
2021-02-02,Santa Barbara,083,443738,30129,28951,988,29939,304
2021-02-02,Santa Clara,085,1922200,104613,102872,491,103363,1349
2021-02-02,Santa Cruz,087,273765,14691,13572,717,14289,150
2021-02-02,Shasta,089,179085,10506,10371,1108,11479,128
2021-02-02,Sierra,091,2930,49,42,12,54,0
2021-02-02,Siskiyou,093,43540,1356,1252,205,1457,4
2021-02-02,Solano,095,438530,28539,27963,327,28290,118
2021-02-02,Sonoma,097,501317,26408,26054,146,26200,247
2021-02-02,Stanislaus,099,539301,47883,46306,4945,51251,641
2021-02-02,Sutter,101,95872,8511,8340,78,8418,89
2021-02-02,Tehama,103,63373,4402,4289,468,4757,21
2021-02-02,Trinity,105,12862,445,260,66,326,3
2021-02-02,Tulare,107,460477,46250,44720,7066,51786,625
2021-02-02,Tuolumne,109,53932,3536,3548,31,3579,39
2021-02-02,Ventura,111,848112,73390,71557,2600,74157,514
2021-02-02,Yolo,113,214977,12276,11886,186,12072,158
2021-02-02,Yuba,115,75493,5218,5111,77,5188,34
2021-02-01,Alameda,001,1643700,76116,74374,1619,75993,858
2021-02-01,Alpine,003,1148,73,72,0,72,0
2021-02-01,Amador,005,37829,3304,3234,27,3261,32
2021-02-01,Butte,007,227075,10814,10263,1513,11776,141
2021-02-01,Calaveras,009,45235,1816,1785,11,1796,21
2021-02-01,Colusa,011,21464,1787,1763,216,1979,9
2021-02-01,Contra Costa,013,1133247,59226,57324,993,58317,531
2021-02-01,Del Norte,015,27424,896,865,4,869,2
2021-02-01,El Dorado,017,186661,8664,8337,565,8902,83
2021-02-01,Fresno,019,978130,92065,89272,7114,96386,994
2021-02-01,Glenn,021,27897,2141,2086,449,2535,14
2021-02-01,Humboldt,023,135768,2872,2773,18,2791,25
2021-02-01,Imperial,025,180216,26706,26224,2498,28722,530
2021-02-01,Inyo,027,18085,1120,1072,8,1080,27
2021-02-01,Kern,029,883053,89177,86170,8740,94910,862
2021-02-01,Kings,031,150075,21334,20746,896,21642,172
2021-02-01,Lake,033,64148,2928,2843,1,2844,33
2021-02-01,Lassen,035,31185,4974,4907,88,4995,1
2021-02-01,Los Angeles,037,10098052,1131125,1094341,37167,1131508,16695
2021-02-01,Madera,039,155013,14930,14572,735,15307,94
2021-02-01,Marin,041,260295,12550,12341,151,12492,188
2021-02-01,Mariposa,043,17540,360,344,3,347,4
2021-02-01,Mendocino,045,87422,3359,3192,63,3255,37
2021-02-01,Merced,047,269075,26646,26282,753,27035,337
2021-02-01,Modoc,049,8938,319,303,103,406,1
2021-02-01,Mono,051,14174,1139,1145,16,1161,3
2021-02-01,Monterey,053,433212,40142,39196,1455,40651,278
2021-02-01,Napa,055,140530,8615,8449,33,8482,52
2021-02-01,Nevada,057,99092,3712,3535,147,3682,20
2021-02-01,Orange,059,3164182,237748,233155,9630,242785,3100
2021-02-01,Placer,061,380077,19578,18574,1009,19583,204
2021-02-01,Plumas,063,18699,623,554,10,564,2
2021-02-01,Riverside,065,2383286,275740,267025,12969,279994,3092
2021-02-01,Sacramento,067,1510023,88920,86856,1108,87964,1193
2021-02-01,San Benito,069,59416,5493,5432,75,5507,48
2021-02-01,San Bernardino,071,2135413,278417,270012,8182,278194,2172
2021-02-01,San Diego,073,3302833,250595,239121,11899,251020,2619
2021-02-01,San Francisco,075,870044,32261,31703,905,32608,324
2021-02-01,San Joaquin,077,732212,63454,61542,2556,64098,877
2021-02-01,San Luis Obispo,079,281455,18470,17690,489,18179,199
2021-02-01,San Mateo,081,765935,37456,35843,365,36208,220
2021-02-01,Santa Barbara,083,443738,29960,28837,980,29817,297
2021-02-01,Santa Clara,085,1922200,104198,102462,490,102952,1343
2021-02-01,Santa Cruz,087,273765,14638,13524,715,14239,149
2021-02-01,Shasta,089,179085,10481,10329,1102,11431,112
2021-02-01,Sierra,091,2930,49,42,12,54,0
2021-02-01,Siskiyou,093,43540,1349,1238,202,1440,4
2021-02-01,Solano,095,438530,28434,27844,326,28170,117
2021-02-01,Sonoma,097,501317,26320,26011,145,26156,243
2021-02-01,Stanislaus,099,539301,47624,46112,4917,51029,642
2021-02-01,Sutter,101,95872,8472,8313,78,8391,89
2021-02-01,Tehama,103,63373,4379,4263,468,4731,21
2021-02-01,Trinity,105,12862,443,260,66,326,3
2021-02-01,Tulare,107,460477,46106,44569,6985,51554,618
2021-02-01,Tuolumne,109,53932,3528,3534,31,3565,39
2021-02-01,Ventura,111,848112,72984,71104,2584,73688,502
2021-02-01,Yolo,113,214977,12231,11824,178,12002,151
2021-02-01,Yuba,115,75493,5204,5084,76,5160,33
2021-01-31,Alameda,001,1643700,75691,73979,1611,75590,857
2021-01-31,Alpine,003,1148,73,72,0,72,0
2021-01-31,Amador,005,37829,3294,3212,25,3237,32
2021-01-31,Butte,007,227075,10772,10215,1502,11717,140
2021-01-31,Calaveras,009,45235,1796,1778,11,1789,21
2021-01-31,Colusa,011,21464,1780,1754,211,1965,9
2021-01-31,Contra Costa,013,1133247,58895,57079,993,58072,531
2021-01-31,Del Norte,015,27424,894,865,4,869,2
2021-01-31,El Dorado,017,186661,8628,8317,563,8880,83
2021-01-31,Fresno,019,978130,91753,88852,7060,95912,994
2021-01-31,Glenn,021,27897,2130,2083,448,2531,14
2021-01-31,Humboldt,023,135768,2856,2767,18,2785,25
2021-01-31,Imperial,025,180216,26634,26206,2489,28695,530
2021-01-31,Inyo,027,18085,1107,1072,8,1080,27
2021-01-31,Kern,029,883053,88681,85872,8654,94526,861
2021-01-31,Kings,031,150075,21249,20709,884,21593,172
2021-01-31,Lake,033,64148,2907,2826,1,2827,33
2021-01-31,Lassen,035,31185,4958,4900,88,4988,1
2021-01-31,Los Angeles,037,10098052,1126501,1090304,36963,1127267,16609
2021-01-31,Madera,039,155013,14876,14496,727,15223,94
2021-01-31,Marin,041,260295,12503,12297,147,12444,185
2021-01-31,Mariposa,043,17540,358,344,3,347,4
2021-01-31,Mendocino,045,87422,3336,3181,62,3243,37
2021-01-31,Merced,047,269075,26502,26222,748,26970,337
2021-01-31,Modoc,049,8938,316,304,101,405,1
2021-01-31,Mono,051,14174,1136,1146,16,1162,3
2021-01-31,Monterey,053,433212,39961,39035,1428,40463,278
2021-01-31,Napa,055,140530,8573,8404,33,8437,52
2021-01-31,Nevada,057,99092,3690,3518,145,3663,20
2021-01-31,Orange,059,3164182,236730,232347,9589,241936,3053
2021-01-31,Placer,061,380077,19501,18506,998,19504,204
2021-01-31,Plumas,063,18699,622,554,10,564,2
2021-01-31,Riverside,065,2383286,274728,266145,12922,279067,3074
2021-01-31,Sacramento,067,1510023,88477,86560,1094,87654,1186
2021-01-31,San Benito,069,59416,5471,5425,73,5498,48
2021-01-31,San Bernardino,071,2135413,277388,269533,8151,277684,2156
2021-01-31,San Diego,073,3302833,249282,238039,11785,249824,2619
2021-01-31,San Francisco,075,870044,32070,31563,894,32457,323
2021-01-31,San Joaquin,077,732212,63052,61379,2546,63925,877
2021-01-31,San Luis Obispo,079,281455,18336,17615,484,18099,199
2021-01-31,San Mateo,081,765935,37266,35659,362,36021,219
2021-01-31,Santa Barbara,083,443738,29716,28570,971,29541,297
2021-01-31,Santa Clara,085,1922200,103650,101986,481,102467,1330
2021-01-31,Santa Cruz,087,273765,14543,13469,701,14170,149
2021-01-31,Shasta,089,179085,10436,10313,1093,11406,112
2021-01-31,Sierra,091,2930,48,43,12,55,0
2021-01-31,Siskiyou,093,43540,1339,1238,202,1440,4
2021-01-31,Solano,095,438530,28304,27678,326,28004,118
2021-01-31,Sonoma,097,501317,26217,25925,144,26069,243
2021-01-31,Stanislaus,099,539301,47338,45971,4880,50851,642
2021-01-31,Sutter,101,95872,8427,8289,78,8367,89
2021-01-31,Tehama,103,63373,4359,4256,467,4723,21
2021-01-31,Trinity,105,12862,441,260,66,326,3
2021-01-31,Tulare,107,460477,45939,44440,6904,51344,618
2021-01-31,Tuolumne,109,53932,3490,3519,31,3550,39
2021-01-31,Ventura,111,848112,72389,70635,2571,73206,502
2021-01-31,Yolo,113,214977,12170,11771,172,11943,151
2021-01-31,Yuba,115,75493,5184,5071,75,5146,33
2021-01-30,Alameda,001,1643700,75486,73622,1606,75228,850
2021-01-30,Alpine,003,1148,73,72,0,72,0
2021-01-30,Amador,005,37829,3290,3181,25,3206,32
2021-01-30,Butte,007,227075,10737,10177,1493,11670,139
2021-01-30,Calaveras,009,45235,1782,1763,11,1774,21
2021-01-30,Colusa,011,21464,1778,1748,211,1959,9
2021-01-30,Contra Costa,013,1133247,58711,56763,989,57752,531
2021-01-30,Del Norte,015,27424,893,865,4,869,2
2021-01-30,El Dorado,017,186661,8608,8299,562,8861,83
2021-01-30,Fresno,019,978130,91573,88476,7040,95516,964
2021-01-30,Glenn,021,27897,2127,2074,446,2520,14
2021-01-30,Humboldt,023,135768,2845,2742,18,2760,24
2021-01-30,Imperial,025,180216,26612,26160,2487,28647,530
2021-01-30,Inyo,027,18085,1103,1068,8,1076,27
2021-01-30,Kern,029,883053,88480,85572,8588,94160,848
2021-01-30,Kings,031,150075,21178,20605,879,21484,169
2021-01-30,Lake,033,64148,2901,2809,1,2810,33
2021-01-30,Lassen,035,31185,4954,4890,88,4978,1
2021-01-30,Los Angeles,037,10098052,1124105,1084763,36821,1121584,16484
2021-01-30,Madera,039,155013,14834,14443,722,15165,94
2021-01-30,Marin,041,260295,12475,12225,146,12371,185
2021-01-30,Mariposa,043,17540,356,344,3,347,4
2021-01-30,Mendocino,045,87422,3322,3153,61,3214,36
2021-01-30,Merced,047,269075,26427,26078,747,26825,335
2021-01-30,Modoc,049,8938,316,303,101,404,1
2021-01-30,Mono,051,14174,1136,1143,16,1159,3
2021-01-30,Monterey,053,433212,39901,38847,1425,40272,277
2021-01-30,Napa,055,140530,8557,8342,33,8375,52
2021-01-30,Nevada,057,99092,3671,3499,145,3644,20
2021-01-30,Orange,059,3164182,236186,231358,9552,240910,3013
2021-01-30,Placer,061,380077,19449,18430,992,19422,205
2021-01-30,Plumas,063,18699,620,554,10,564,2
2021-01-30,Riverside,065,2383286,274129,265137,12891,278028,3061
2021-01-30,Sacramento,067,1510023,88284,86388,1089,87477,1184
2021-01-30,San Benito,069,59416,5453,5401,72,5473,48
2021-01-30,San Bernardino,071,2135413,276968,268660,8132,276792,2122
2021-01-30,San Diego,073,3302833,248517,236765,11740,248505,2603
2021-01-30,San Francisco,075,870044,31969,31427,891,32318,316
2021-01-30,San Joaquin,077,732212,62920,61120,2537,63657,864
2021-01-30,San Luis Obispo,079,281455,18256,17522,482,18004,198
2021-01-30,San Mateo,081,765935,37127,35451,361,35812,219
2021-01-30,Santa Barbara,083,443738,29574,28342,969,29311,296
2021-01-30,Santa Clara,085,1922200,103304,101471,478,101949,1307
2021-01-30,Santa Cruz,087,273765,14503,13383,700,14083,149
2021-01-30,Shasta,089,179085,10417,10283,1090,11373,112
2021-01-30,Sierra,091,2930,48,43,12,55,0
2021-01-30,Siskiyou,093,43540,1336,1236,201,1437,4
2021-01-30,Solano,095,438530,28221,27511,324,27835,118
2021-01-30,Sonoma,097,501317,26169,25810,141,25951,243
2021-01-30,Stanislaus,099,539301,47209,45697,4856,50553,642
2021-01-30,Sutter,101,95872,8411,8226,78,8304,87
2021-01-30,Tehama,103,63373,4345,4229,466,4695,21
2021-01-30,Trinity,105,12862,441,259,66,325,3
2021-01-30,Tulare,107,460477,45803,44203,6867,51070,615
2021-01-30,Tuolumne,109,53932,3486,3508,31,3539,36
2021-01-30,Ventura,111,848112,72076,69931,2557,72488,493
2021-01-30,Yolo,113,214977,12156,11698,171,11869,151
2021-01-30,Yuba,115,75493,5174,5042,74,5116,33
2021-01-29,Alameda,001,1643700,75218,73210,1599,74809,841
2021-01-29,Alpine,003,1148,73,72,0,72,0
2021-01-29,Amador,005,37829,3278,3134,24,3158,32
2021-01-29,Butte,007,227075,10706,10122,1483,11605,138
2021-01-29,Calaveras,009,45235,1772,1757,11,1768,21
2021-01-29,Colusa,011,21464,1774,1734,210,1944,8
2021-01-29,Contra Costa,013,1133247,58539,56318,987,57305,529
2021-01-29,Del Norte,015,27424,892,865,4,869,2
2021-01-29,El Dorado,017,186661,8591,8231,561,8792,83
2021-01-29,Fresno,019,978130,91358,87936,7002,94938,962
2021-01-29,Glenn,021,27897,2122,2061,445,2506,14
2021-01-29,Humboldt,023,135768,2832,2707,18,2725,24
2021-01-29,Imperial,025,180216,26597,26045,2484,28529,521
2021-01-29,Inyo,027,18085,1091,1048,8,1056,27
2021-01-29,Kern,029,883053,88253,85044,8536,93580,836
2021-01-29,Kings,031,150075,21139,20466,874,21340,169
2021-01-29,Lake,033,64148,2892,2792,1,2793,32
2021-01-29,Lassen,035,31185,4951,4874,88,4962,1
2021-01-29,Los Angeles,037,10098052,1120616,1078329,36667,1114996,16190
2021-01-29,Madera,039,155013,14783,14377,722,15099,94
2021-01-29,Marin,041,260295,12432,12145,145,12290,185
2021-01-29,Mariposa,043,17540,355,342,3,345,4
2021-01-29,Mendocino,045,87422,3313,3131,60,3191,36
2021-01-29,Merced,047,269075,26352,25865,743,26608,334
2021-01-29,Modoc,049,8938,315,297,101,398,1
2021-01-29,Mono,051,14174,1134,1139,16,1155,3
2021-01-29,Monterey,053,433212,39781,38539,1417,39956,277
2021-01-29,Napa,055,140530,8526,8276,33,8309,52
2021-01-29,Nevada,057,99092,3662,3487,144,3631,20
2021-01-29,Orange,059,3164182,235508,229917,9514,239431,2967
2021-01-29,Placer,061,380077,19396,18367,988,19355,203
2021-01-29,Plumas,063,18699,619,548,10,558,2
2021-01-29,Riverside,065,2383286,273326,263504,12858,276362,3008
2021-01-29,Sacramento,067,1510023,88029,86320,1085,87405,1169
2021-01-29,San Benito,069,59416,5445,5386,72,5458,48
2021-01-29,San Bernardino,071,2135413,276452,267490,8092,275582,2095
2021-01-29,San Diego,073,3302833,247575,234637,11662,246299,2571
2021-01-29,San Francisco,075,870044,31830,31294,883,32177,307
2021-01-29,San Joaquin,077,732212,62775,60899,2522,63421,858
2021-01-29,San Luis Obispo,079,281455,18196,17440,477,17917,193
2021-01-29,San Mateo,081,765935,36993,35223,358,35581,218
2021-01-29,Santa Barbara,083,443738,29440,28105,963,29068,291
2021-01-29,Santa Clara,085,1922200,102941,101010,476,101486,1273
2021-01-29,Santa Cruz,087,273765,14450,13311,697,14008,148
2021-01-29,Shasta,089,179085,10400,10220,1086,11306,112
2021-01-29,Sierra,091,2930,48,43,12,55,0
2021-01-29,Siskiyou,093,43540,1335,1227,201,1428,4
2021-01-29,Solano,095,438530,28136,27352,322,27674,116
2021-01-29,Sonoma,097,501317,26112,25710,140,25850,243
2021-01-29,Stanislaus,099,539301,47061,45466,4837,50303,642
2021-01-29,Sutter,101,95872,8392,8181,78,8259,87
2021-01-29,Tehama,103,63373,4332,4191,464,4655,20
2021-01-29,Trinity,105,12862,441,260,66,326,3
2021-01-29,Tulare,107,460477,45696,43925,6828,50753,606
2021-01-29,Tuolumne,109,53932,3476,3483,31,3514,36
2021-01-29,Ventura,111,848112,71652,69511,2543,72054,484
2021-01-29,Yolo,113,214977,12118,11612,170,11782,151
2021-01-29,Yuba,115,75493,5158,5018,74,5092,32
2021-01-28,Alameda,001,1643700,74792,72758,1591,74349,833
2021-01-28,Alpine,003,1148,73,72,0,72,0
2021-01-28,Amador,005,37829,3241,3124,24,3148,31
2021-01-28,Butte,007,227075,10666,10037,1472,11509,138
2021-01-28,Calaveras,009,45235,1758,1747,10,1757,21
2021-01-28,Colusa,011,21464,1767,1731,206,1937,8
2021-01-28,Contra Costa,013,1133247,58295,55999,977,56976,525
2021-01-28,Del Norte,015,27424,891,862,4,866,2
2021-01-28,El Dorado,017,186661,8577,8198,556,8754,79
2021-01-28,Fresno,019,978130,91070,87401,6953,94354,949
2021-01-28,Glenn,021,27897,2117,2043,439,2482,14
2021-01-28,Humboldt,023,135768,2815,2686,18,2704,24
2021-01-28,Imperial,025,180216,26552,25984,2477,28461,517
2021-01-28,Inyo,027,18085,1086,1039,8,1047,27
2021-01-28,Kern,029,883053,87922,84708,8452,93160,817
2021-01-28,Kings,031,150075,21079,20328,870,21198,167
2021-01-28,Lake,033,64148,2877,2772,1,2773,32
2021-01-28,Lassen,035,31185,4945,4865,88,4953,1
2021-01-28,Los Angeles,037,10098052,1116708,1072412,36479,1108891,15967
2021-01-28,Madera,039,155013,14727,14301,718,15019,94
2021-01-28,Marin,041,260295,12379,12079,144,12223,183
2021-01-28,Mariposa,043,17540,355,334,3,337,4
2021-01-28,Mendocino,045,87422,3296,3110,60,3170,36
2021-01-28,Merced,047,269075,26227,25620,735,26355,328
2021-01-28,Modoc,049,8938,314,297,101,398,0
2021-01-28,Mono,051,14174,1132,1131,16,1147,3
2021-01-28,Monterey,053,433212,39580,38312,1399,39711,274
2021-01-28,Napa,055,140530,8479,8233,33,8266,50
2021-01-28,Nevada,057,99092,3647,3452,143,3595,19
2021-01-28,Orange,059,3164182,234529,228636,9484,238120,2860
2021-01-28,Placer,061,380077,19335,18246,985,19231,198
2021-01-28,Plumas,063,18699,618,547,10,557,2
2021-01-28,Riverside,065,2383286,272545,262342,12810,275152,2981
2021-01-28,Sacramento,067,1510023,87666,85698,1074,86772,1149
2021-01-28,San Benito,069,59416,5427,5344,71,5415,47
2021-01-28,San Bernardino,071,2135413,275756,266456,8071,274527,2057
2021-01-28,San Diego,073,3302833,246423,232967,11573,244540,2534
2021-01-28,San Francisco,075,870044,31693,31193,867,32060,290
2021-01-28,San Joaquin,077,732212,62510,60627,2507,63134,854
2021-01-28,San Luis Obispo,079,281455,18096,17279,475,17754,189
2021-01-28,San Mateo,081,765935,36824,34931,342,35273,218
2021-01-28,Santa Barbara,083,443738,29216,27674,950,28624,284
2021-01-28,Santa Clara,085,1922200,102473,100470,474,100944,1219
2021-01-28,Santa Cruz,087,273765,14361,13188,691,13879,145
2021-01-28,Shasta,089,179085,10366,10176,1078,11254,110
2021-01-28,Sierra,091,2930,48,43,12,55,0
2021-01-28,Siskiyou,093,43540,1328,1218,199,1417,4
2021-01-28,Solano,095,438530,27976,27163,321,27484,114
2021-01-28,Sonoma,097,501317,26021,25564,140,25704,236
2021-01-28,Stanislaus,099,539301,46844,45162,4815,49977,640
2021-01-28,Sutter,101,95872,8344,8136,78,8214,85
2021-01-28,Tehama,103,63373,4312,4163,461,4624,20
2021-01-28,Trinity,105,12862,439,260,66,326,3
2021-01-28,Tulare,107,460477,45539,43742,6750,50492,595
2021-01-28,Tuolumne,109,53932,3462,3472,31,3503,32
2021-01-28,Ventura,111,848112,71139,68896,2526,71422,475
2021-01-28,Yolo,113,214977,12076,11500,165,11665,151
2021-01-28,Yuba,115,75493,5142,4994,73,5067,32
2021-01-27,Alameda,001,1643700,74368,72188,1583,73771,815
2021-01-27,Alpine,003,1148,73,72,0,72,0
2021-01-27,Amador,005,37829,3225,3116,24,3140,31
2021-01-27,Butte,007,227075,10627,9988,1460,11448,138
2021-01-27,Calaveras,009,45235,1749,1737,10,1747,21
2021-01-27,Colusa,011,21464,1761,1724,204,1928,8
2021-01-27,Contra Costa,013,1133247,57996,55578,974,56552,507
2021-01-27,Del Norte,015,27424,890,859,4,863,2
2021-01-27,El Dorado,017,186661,8551,8141,555,8696,76
2021-01-27,Fresno,019,978130,90779,86886,6910,93796,938
2021-01-27,Glenn,021,27897,2113,2042,438,2480,14
2021-01-27,Humboldt,023,135768,2793,2630,18,2648,24
2021-01-27,Imperial,025,180216,26498,25861,2462,28323,504
2021-01-27,Inyo,027,18085,1082,1023,8,1031,27
2021-01-27,Kern,029,883053,87609,84244,8382,92626,809
2021-01-27,Kings,031,150075,20973,20211,862,21073,167
2021-01-27,Lake,033,64148,2857,2750,1,2751,32
2021-01-27,Lassen,035,31185,4939,4851,88,4939,1
2021-01-27,Los Angeles,037,10098052,1111904,1066569,36268,1102837,15757
2021-01-27,Madera,039,155013,14686,14194,713,14907,86
2021-01-27,Marin,041,260295,12342,12028,143,12171,180
2021-01-27,Mariposa,043,17540,355,333,3,336,4
2021-01-27,Mendocino,045,87422,3276,3095,60,3155,36
2021-01-27,Merced,047,269075,26068,25439,724,26163,315
2021-01-27,Modoc,049,8938,314,297,98,395,0
2021-01-27,Mono,051,14174,1130,1131,16,1147,3
2021-01-27,Monterey,053,433212,39375,38139,1380,39519,268
2021-01-27,Napa,055,140530,8406,8187,33,8220,46
2021-01-27,Nevada,057,99092,3625,3431,143,3574,18
2021-01-27,Orange,059,3164182,233409,227110,9430,236540,2832
2021-01-27,Placer,061,380077,19263,18106,974,19080,198
2021-01-27,Plumas,063,18699,618,544,10,554,2
2021-01-27,Riverside,065,2383286,271344,260796,12758,273554,2931
2021-01-27,Sacramento,067,1510023,87305,85428,1063,86491,1142
2021-01-27,San Benito,069,59416,5412,5284,71,5355,47
2021-01-27,San Bernardino,071,2135413,274902,265153,8040,273193,2019
2021-01-27,San Diego,073,3302833,245094,231478,11468,242946,2465
2021-01-27,San Francisco,075,870044,31549,31082,860,31942,287
2021-01-27,San Joaquin,077,732212,62241,60131,2484,62615,853
2021-01-27,San Luis Obispo,079,281455,17989,17119,471,17590,188
2021-01-27,San Mateo,081,765935,36669,34619,339,34958,216
2021-01-27,Santa Barbara,083,443738,29039,27435,944,28379,282
2021-01-27,Santa Clara,085,1922200,102069,99732,470,100202,1184
2021-01-27,Santa Cruz,087,273765,14291,13111,688,13799,143
2021-01-27,Shasta,089,179085,10332,10106,1072,11178,105
2021-01-27,Sierra,091,2930,48,44,12,56,0
2021-01-27,Siskiyou,093,43540,1322,1214,196,1410,4
2021-01-27,Solano,095,438530,27799,26982,314,27296,112
2021-01-27,Sonoma,097,501317,25922,25361,136,25497,237
2021-01-27,Stanislaus,099,539301,46658,44874,4788,49662,624
2021-01-27,Sutter,101,95872,8299,8093,77,8170,83
2021-01-27,Tehama,103,63373,4287,4133,457,4590,20
2021-01-27,Trinity,105,12862,439,260,66,326,3
2021-01-27,Tulare,107,460477,45351,43462,6679,50141,583
2021-01-27,Tuolumne,109,53932,3451,3464,31,3495,32
2021-01-27,Ventura,111,848112,70665,68291,2501,70792,468
2021-01-27,Yolo,113,214977,12029,11427,161,11588,151
2021-01-27,Yuba,115,75493,5126,4968,73,5041,32
2021-01-26,Alameda,001,1643700,73994,71851,1566,73417,789
2021-01-26,Alpine,003,1148,73,72,0,72,0
2021-01-26,Amador,005,37829,3214,3113,24,3137,31
2021-01-26,Butte,007,227075,10585,9943,1454,11397,136
2021-01-26,Calaveras,009,45235,1739,1723,10,1733,21
2021-01-26,Colusa,011,21464,1754,1719,201,1920,8
2021-01-26,Contra Costa,013,1133247,57715,55337,966,56303,491
2021-01-26,Del Norte,015,27424,889,856,4,860,2
2021-01-26,El Dorado,017,186661,8525,8115,552,8667,71
2021-01-26,Fresno,019,978130,90421,86673,6866,93539,923
2021-01-26,Glenn,021,27897,2103,2034,433,2467,13
2021-01-26,Humboldt,023,135768,2772,2612,17,2629,24
2021-01-26,Imperial,025,180216,26426,25812,2448,28260,498
2021-01-26,Inyo,027,18085,1075,1018,8,1026,27
2021-01-26,Kern,029,883053,87184,83868,8304,92172,790
2021-01-26,Kings,031,150075,20915,20156,857,21013,159
2021-01-26,Lake,033,64148,2848,2748,1,2749,32
2021-01-26,Lassen,035,31185,4933,4844,88,4932,1
2021-01-26,Los Angeles,037,10098052,1106621,1060492,36062,1096554,15458
2021-01-26,Madera,039,155013,14629,14130,707,14837,86
2021-01-26,Marin,041,260295,12297,11993,141,12134,179
2021-01-26,Mariposa,043,17540,353,332,3,335,3
2021-01-26,Mendocino,045,87422,3250,3076,59,3135,36
2021-01-26,Merced,047,269075,25928,25359,717,26076,309
2021-01-26,Modoc,049,8938,307,291,97,388,0
2021-01-26,Mono,051,14174,1128,1120,16,1136,3
2021-01-26,Monterey,053,433212,39181,37963,1359,39322,255
2021-01-26,Napa,055,140530,8349,8145,33,8178,43
2021-01-26,Nevada,057,99092,3618,3410,142,3552,18
2021-01-26,Orange,059,3164182,232286,225987,9385,235372,2760
2021-01-26,Placer,061,380077,19187,18016,972,18988,193
2021-01-26,Plumas,063,18699,616,536,10,546,2
2021-01-26,Riverside,065,2383286,269974,259399,12695,272094,2898
2021-01-26,Sacramento,067,1510023,86947,85062,1056,86118,1127
2021-01-26,San Benito,069,59416,5398,5251,70,5321,45
2021-01-26,San Bernardino,071,2135413,273900,263736,7996,271732,1970
2021-01-26,San Diego,073,3302833,243599,230063,11366,241429,2421
2021-01-26,San Francisco,075,870044,31416,30874,841,31715,286
2021-01-26,San Joaquin,077,732212,61987,59889,2468,62357,847
2021-01-26,San Luis Obispo,079,281455,17908,17016,468,17484,186
2021-01-26,San Mateo,081,765935,36475,34441,328,34769,213
2021-01-26,Santa Barbara,083,443738,28865,27321,932,28253,273
2021-01-26,Santa Clara,085,1922200,101591,99215,466,99681,1171
2021-01-26,Santa Cruz,087,273765,14225,13045,682,13727,134
2021-01-26,Shasta,089,179085,10297,10036,1064,11100,103
2021-01-26,Sierra,091,2930,48,43,12,55,0
2021-01-26,Siskiyou,093,43540,1308,1208,194,1402,4
2021-01-26,Solano,095,438530,27643,26858,308,27166,110
2021-01-26,Sonoma,097,501317,25804,25273,134,25407,236
2021-01-26,Stanislaus,099,539301,46473,44703,4747,49450,599
2021-01-26,Sutter,101,95872,8256,8067,77,8144,83
2021-01-26,Tehama,103,63373,4256,4115,457,4572,20
2021-01-26,Trinity,105,12862,439,260,66,326,3
2021-01-26,Tulare,107,460477,45148,43394,6609,50003,579
2021-01-26,Tuolumne,109,53932,3441,3451,31,3482,30
2021-01-26,Ventura,111,848112,70133,67526,2475,70001,448
2021-01-26,Yolo,113,214977,11984,11361,158,11519,148
2021-01-26,Yuba,115,75493,5101,4944,71,5015,31
2021-01-25,Alameda,001,1643700,73563,71255,1556,72811,780
2021-01-25,Alpine,003,1148,73,72,0,72,0
2021-01-25,Amador,005,37829,3174,3074,24,3098,30
2021-01-25,Butte,007,227075,10519,9865,1446,11311,133
2021-01-25,Calaveras,009,45235,1724,1713,10,1723,21
2021-01-25,Colusa,011,21464,1742,1709,197,1906,8
2021-01-25,Contra Costa,013,1133247,57358,54989,959,55948,488
2021-01-25,Del Norte,015,27424,888,855,4,859,2
2021-01-25,El Dorado,017,186661,8500,8060,552,8612,66
2021-01-25,Fresno,019,978130,90050,86336,6834,93170,913
2021-01-25,Glenn,021,27897,2095,2028,433,2461,13
2021-01-25,Humboldt,023,135768,2738,2587,17,2604,24
2021-01-25,Imperial,025,180216,26376,25745,2440,28185,491
2021-01-25,Inyo,027,18085,1069,1015,8,1023,27
2021-01-25,Kern,029,883053,86788,83401,8217,91618,787
2021-01-25,Kings,031,150075,20795,20067,853,20920,159
2021-01-25,Lake,033,64148,2829,2729,1,2730,32
2021-01-25,Lassen,035,31185,4906,4835,88,4923,1
2021-01-25,Los Angeles,037,10098052,1100671,1055181,35833,1091014,15163
2021-01-25,Madera,039,155013,14575,14068,702,14770,86
2021-01-25,Marin,041,260295,12245,11923,137,12060,177
2021-01-25,Mariposa,043,17540,350,331,3,334,3
2021-01-25,Mendocino,045,87422,3239,3054,59,3113,35
2021-01-25,Merced,047,269075,25789,25181,708,25889,305
2021-01-25,Modoc,049,8938,306,288,93,381,0
2021-01-25,Mono,051,14174,1125,1114,15,1129,3
2021-01-25,Monterey,053,433212,38927,37726,1340,39066,255
2021-01-25,Napa,055,140530,8315,8057,32,8089,43
2021-01-25,Nevada,057,99092,3604,3365,142,3507,18
2021-01-25,Orange,059,3164182,231077,225105,9344,234449,2696
2021-01-25,Placer,061,380077,19100,17936,957,18893,193
2021-01-25,Plumas,063,18699,613,533,10,543,2
2021-01-25,Riverside,065,2383286,268227,258082,12639,270721,2789
2021-01-25,Sacramento,067,1510023,86503,84653,1048,85701,1118
2021-01-25,San Benito,069,59416,5362,5238,69,5307,43
2021-01-25,San Bernardino,071,2135413,272951,263174,7960,271134,1947
2021-01-25,San Diego,073,3302833,241985,228630,11294,239924,2375
2021-01-25,San Francisco,075,870044,31267,30734,818,31552,288
2021-01-25,San Joaquin,077,732212,61692,59291,2443,61734,838
2021-01-25,San Luis Obispo,079,281455,17774,16868,463,17331,179
2021-01-25,San Mateo,081,765935,36241,34187,322,34509,213
2021-01-25,Santa Barbara,083,443738,28630,27065,922,27987,269
2021-01-25,Santa Clara,085,1922200,101021,98647,459,99106,1143
2021-01-25,Santa Cruz,087,273765,14138,12973,677,13650,133
2021-01-25,Shasta,089,179085,10256,9991,1053,11044,103
2021-01-25,Sierra,091,2930,48,42,12,54,0
2021-01-25,Siskiyou,093,43540,1300,1205,191,1396,4
2021-01-25,Solano,095,438530,27474,26648,307,26955,109
2021-01-25,Sonoma,097,501317,25697,25160,132,25292,233
2021-01-25,Stanislaus,099,539301,46227,44293,4703,48996,599
2021-01-25,Sutter,101,95872,8212,8023,77,8100,83
2021-01-25,Tehama,103,63373,4229,4082,453,4535,20
2021-01-25,Trinity,105,12862,439,262,66,328,3
2021-01-25,Tulare,107,460477,44933,43124,6504,49628,578
2021-01-25,Tuolumne,109,53932,3432,3422,31,3453,29
2021-01-25,Ventura,111,848112,69490,66910,2458,69368,439
2021-01-25,Yolo,113,214977,11897,11276,157,11433,140
2021-01-25,Yuba,115,75493,5077,4900,69,4969,31
2021-01-24,Alameda,001,1643700,73056,70823,1545,72368,780
2021-01-24,Alpine,003,1148,73,72,0,72,0
2021-01-24,Amador,005,37829,3141,3054,24,3078,30
2021-01-24,Butte,007,227075,10435,9820,1428,11248,133
2021-01-24,Calaveras,009,45235,1710,1704,10,1714,21
2021-01-24,Colusa,011,21464,1731,1689,191,1880,8
2021-01-24,Contra Costa,013,1133247,56966,54694,946,55640,488
2021-01-24,Del Norte,015,27424,884,855,4,859,2
2021-01-24,El Dorado,017,186661,8465,8003,548,8551,66
2021-01-24,Fresno,019,978130,89613,85808,6795,92603,911
2021-01-24,Glenn,021,27897,2087,2026,431,2457,13
2021-01-24,Humboldt,023,135768,2699,2562,17,2579,24
2021-01-24,Imperial,025,180216,26280,25707,2414,28121,488
2021-01-24,Inyo,027,18085,1053,1007,8,1015,27
2021-01-24,Kern,029,883053,86346,83125,8109,91234,785
2021-01-24,Kings,031,150075,20667,19988,837,20825,159
2021-01-24,Lake,033,64148,2811,2724,0,2724,32
2021-01-24,Lassen,035,31185,4895,4828,85,4913,1
2021-01-24,Los Angeles,037,10098052,1094276,1048757,35522,1084279,15119
2021-01-24,Madera,039,155013,14485,14000,696,14696,86
2021-01-24,Marin,041,260295,12178,11872,135,12007,177
2021-01-24,Mariposa,043,17540,346,322,3,325,3
2021-01-24,Mendocino,045,87422,3218,3037,58,3095,33
2021-01-24,Merced,047,269075,25576,25047,700,25747,305
2021-01-24,Modoc,049,8938,306,285,93,378,0
2021-01-24,Mono,051,14174,1118,1113,15,1128,3
2021-01-24,Monterey,053,433212,38649,37527,1308,38835,254
2021-01-24,Napa,055,140530,8273,8005,32,8037,43
2021-01-24,Nevada,057,99092,3562,3349,140,3489,18
2021-01-24,Orange,059,3164182,229646,223853,9274,233127,2632
2021-01-24,Placer,061,380077,18985,17839,937,18776,193
2021-01-24,Plumas,063,18699,610,532,10,542,2
2021-01-24,Riverside,065,2383286,266586,256767,12562,269329,2761
2021-01-24,Sacramento,067,1510023,85934,84110,1040,85150,1112
2021-01-24,San Benito,069,59416,5320,5223,66,5289,43
2021-01-24,San Bernardino,071,2135413,271626,262370,7906,270276,1935
2021-01-24,San Diego,073,3302833,240291,227193,11163,238356,2375
2021-01-24,San Francisco,075,870044,31080,30559,796,31355,275
2021-01-24,San Joaquin,077,732212,61264,59021,2427,61448,838
2021-01-24,San Luis Obispo,079,281455,17651,16758,461,17219,179
2021-01-24,San Mateo,081,765935,35996,33956,317,34273,213
2021-01-24,Santa Barbara,083,443738,28314,26735,912,27647,269
2021-01-24,Santa Clara,085,1922200,100374,98103,454,98557,1109
2021-01-24,Santa Cruz,087,273765,14052,12905,669,13574,133
2021-01-24,Shasta,089,179085,10185,9978,1044,11022,103
2021-01-24,Sierra,091,2930,47,42,12,54,0
2021-01-24,Siskiyou,093,43540,1293,1195,191,1386,4
2021-01-24,Solano,095,438530,27285,26515,303,26818,109
2021-01-24,Sonoma,097,501317,25534,25045,131,25176,233
2021-01-24,Stanislaus,099,539301,45916,44031,4643,48674,599
2021-01-24,Sutter,101,95872,8143,7980,77,8057,83
2021-01-24,Tehama,103,63373,4190,4062,446,4508,20
2021-01-24,Trinity,105,12862,439,262,66,328,3
2021-01-24,Tulare,107,460477,44714,43006,6411,49417,577
2021-01-24,Tuolumne,109,53932,3422,3416,31,3447,29
2021-01-24,Ventura,111,848112,68776,66347,2433,68780,439
2021-01-24,Yolo,113,214977,11812,11210,153,11363,140
2021-01-24,Yuba,115,75493,5037,4875,68,4943,31
2021-01-23,Alameda,001,1643700,72807,70080,1538,71618,780
2021-01-23,Alpine,003,1148,73,72,0,72,0
2021-01-23,Amador,005,37829,3138,3049,24,3073,30
2021-01-23,Butte,007,227075,10405,9757,1423,11180,133
2021-01-23,Calaveras,009,45235,1707,1695,10,1705,21
2021-01-23,Colusa,011,21464,1727,1672,190,1862,8
2021-01-23,Contra Costa,013,1133247,56752,54162,939,55101,487
2021-01-23,Del Norte,015,27424,883,855,4,859,2
2021-01-23,El Dorado,017,186661,8449,7984,546,8530,66
2021-01-23,Fresno,019,978130,89427,85274,6766,92040,910
2021-01-23,Glenn,021,27897,2084,2015,427,2442,13
2021-01-23,Humboldt,023,135768,2680,2493,16,2509,23
2021-01-23,Imperial,025,180216,26247,25581,2405,27986,487
2021-01-23,Inyo,027,18085,1044,987,8,995,27
2021-01-23,Kern,029,883053,86100,82602,8037,90639,783
2021-01-23,Kings,031,150075,20623,19904,835,20739,159
2021-01-23,Lake,033,64148,2803,2673,0,2673,32
2021-01-23,Lassen,035,31185,4894,4816,82,4898,1
2021-01-23,Los Angeles,037,10098052,1091050,1040961,35366,1076327,15034
2021-01-23,Madera,039,155013,14449,13858,693,14551,86
2021-01-23,Marin,041,260295,12122,11796,133,11929,177
2021-01-23,Mariposa,043,17540,346,323,3,326,3
2021-01-23,Mendocino,045,87422,3204,2991,58,3049,32
2021-01-23,Merced,047,269075,25483,24787,687,25474,303
2021-01-23,Modoc,049,8938,306,285,93,378,0
2021-01-23,Mono,051,14174,1116,1111,15,1126,3
2021-01-23,Monterey,053,433212,38566,37165,1303,38468,253
2021-01-23,Napa,055,140530,8248,7893,32,7925,43
2021-01-23,Nevada,057,99092,3551,3332,139,3471,18
2021-01-23,Orange,059,3164182,228877,221722,9234,230956,2618
2021-01-23,Placer,061,380077,18934,17617,932,18549,193
2021-01-23,Plumas,063,18699,609,528,10,538,2
2021-01-23,Riverside,065,2383286,265685,253636,12509,266145,2733
2021-01-23,Sacramento,067,1510023,85705,83408,1037,84445,1108
2021-01-23,San Benito,069,59416,5296,5166,65,5231,43
2021-01-23,San Bernardino,071,2135413,271081,260381,7874,268255,1922
2021-01-23,San Diego,073,3302833,239230,225556,11091,236647,2344
2021-01-23,San Francisco,075,870044,30975,30308,767,31075,268
2021-01-23,San Joaquin,077,732212,61138,58164,2417,60581,836
2021-01-23,San Luis Obispo,079,281455,17587,16652,458,17110,176
2021-01-23,San Mateo,081,765935,35820,33696,306,34002,213
2021-01-23,Santa Barbara,083,443738,28130,26234,903,27137,264
2021-01-23,Santa Clara,085,1922200,100019,97189,453,97642,1086
2021-01-23,Santa Cruz,087,273765,13994,12771,666,13437,127
2021-01-23,Shasta,089,179085,10155,9951,1043,10994,103
2021-01-23,Sierra,091,2930,47,41,12,53,0
2021-01-23,Siskiyou,093,43540,1283,1190,190,1380,4
2021-01-23,Solano,095,438530,27193,26261,301,26562,107
2021-01-23,Sonoma,097,501317,25454,24790,131,24921,232
2021-01-23,Stanislaus,099,539301,45752,43723,4614,48337,599
2021-01-23,Sutter,101,95872,8125,7943,76,8019,80
2021-01-23,Tehama,103,63373,4171,4006,445,4451,20
2021-01-23,Trinity,105,12862,439,262,66,328,3
2021-01-23,Tulare,107,460477,44561,42661,6351,49012,575
2021-01-23,Tuolumne,109,53932,3415,3407,31,3438,29
2021-01-23,Ventura,111,848112,68328,65581,2410,67991,438
2021-01-23,Yolo,113,214977,11770,11087,149,11236,141
2021-01-23,Yuba,115,75493,5025,4831,67,4898,30
2021-01-22,Alameda,001,1643700,72485,69693,1532,71225,751
2021-01-22,Alpine,003,1148,73,71,0,71,0
2021-01-22,Amador,005,37829,3133,3042,24,3066,30
2021-01-22,Butte,007,227075,10356,9711,1410,11121,133
2021-01-22,Calaveras,009,45235,1698,1672,10,1682,21
2021-01-22,Colusa,011,21464,1725,1668,190,1858,7
2021-01-22,Contra Costa,013,1133247,56514,53887,933,54820,485
2021-01-22,Del Norte,015,27424,882,852,4,856,2
2021-01-22,El Dorado,017,186661,8415,7877,543,8420,64
2021-01-22,Fresno,019,978130,89086,84744,6738,91482,892
2021-01-22,Glenn,021,27897,2079,1985,421,2406,13
2021-01-22,Humboldt,023,135768,2656,2452,16,2468,23
2021-01-22,Imperial,025,180216,26212,25562,2390,27952,474
2021-01-22,Inyo,027,18085,1033,961,8,969,26
2021-01-22,Kern,029,883053,85800,82101,7964,90065,771
2021-01-22,Kings,031,150075,20547,19760,831,20591,159
2021-01-22,Lake,033,64148,2791,2681,0,2681,32
2021-01-22,Lassen,035,31185,4885,4765,81,4846,1
2021-01-22,Los Angeles,037,10098052,1086591,1031177,35176,1066353,14777
2021-01-22,Madera,039,155013,14388,13781,692,14473,86
2021-01-22,Marin,041,260295,12085,11769,131,11900,177
2021-01-22,Mariposa,043,17540,346,323,3,326,3
2021-01-22,Mendocino,045,87422,3179,2994,57,3051,32
2021-01-22,Merced,047,269075,25360,24616,679,25295,290
2021-01-22,Modoc,049,8938,306,285,93,378,0
2021-01-22,Mono,051,14174,1116,1108,15,1123,3
2021-01-22,Monterey,053,433212,38412,36909,1298,38207,253
2021-01-22,Napa,055,140530,8202,7828,32,7860,40
2021-01-22,Nevada,057,99092,3526,3296,138,3434,18
2021-01-22,Orange,059,3164182,227924,220384,9187,229571,2542
2021-01-22,Placer,061,380077,18877,17636,917,18553,193
2021-01-22,Plumas,063,18699,607,522,10,532,2
2021-01-22,Riverside,065,2383286,264534,252440,12443,264883,2710
2021-01-22,Sacramento,067,1510023,85379,82861,1029,83890,1094
2021-01-22,San Benito,069,59416,5270,5143,65,5208,43
2021-01-22,San Bernardino,071,2135413,270259,259121,7841,266962,1849
2021-01-22,San Diego,073,3302833,237990,222576,11026,233602,2301
2021-01-22,San Francisco,075,870044,30862,30027,750,30777,266
2021-01-22,San Joaquin,077,732212,60956,58485,2404,60889,812
2021-01-22,San Luis Obispo,079,281455,17498,16336,455,16791,172
2021-01-22,San Mateo,081,765935,35598,33401,303,33704,211
2021-01-22,Santa Barbara,083,443738,27929,25989,892,26881,256
2021-01-22,Santa Clara,085,1922200,99579,96435,450,96885,1062
2021-01-22,Santa Cruz,087,273765,13936,12687,662,13349,123
2021-01-22,Shasta,089,179085,10136,9866,1041,10907,103
2021-01-22,Sierra,091,2930,47,40,12,52,0
2021-01-22,Siskiyou,093,43540,1279,1182,188,1370,4
2021-01-22,Solano,095,438530,27103,26048,299,26347,107
2021-01-22,Sonoma,097,501317,25369,24659,131,24790,232
2021-01-22,Stanislaus,099,539301,45595,43489,4581,48070,599
2021-01-22,Sutter,101,95872,8100,7878,76,7954,80
2021-01-22,Tehama,103,63373,4152,3993,444,4437,19
2021-01-22,Trinity,105,12862,438,263,66,329,3
2021-01-22,Tulare,107,460477,44381,42307,6281,48588,573
2021-01-22,Tuolumne,109,53932,3387,3379,31,3410,29
2021-01-22,Ventura,111,848112,67821,64404,2392,66796,426
2021-01-22,Yolo,113,214977,11736,11014,141,11155,141
2021-01-22,Yuba,115,75493,5001,4789,65,4854,29
2021-01-21,Alameda,001,1643700,72052,69314,1515,70829,739
2021-01-21,Alpine,003,1148,73,71,0,71,0
2021-01-21,Amador,005,37829,3111,3038,24,3062,29
2021-01-21,Butte,007,227075,10286,9643,1403,11046,130
2021-01-21,Calaveras,009,45235,1691,1647,10,1657,21
2021-01-21,Colusa,011,21464,1718,1662,187,1849,7
2021-01-21,Contra Costa,013,1133247,56096,53595,920,54515,478
2021-01-21,Del Norte,015,27424,880,850,3,853,2
2021-01-21,El Dorado,017,186661,8366,7823,540,8363,58
2021-01-21,Fresno,019,978130,88680,84137,6698,90835,889
2021-01-21,Glenn,021,27897,2072,1964,416,2380,13
2021-01-21,Humboldt,023,135768,2633,2423,16,2439,23
2021-01-21,Imperial,025,180216,26120,25509,2376,27885,463
2021-01-21,Inyo,027,18085,1024,946,8,954,26
2021-01-21,Kern,029,883053,85387,81328,7846,89174,769
2021-01-21,Kings,031,150075,20476,19633,813,20446,158
2021-01-21,Lake,033,64148,2775,2669,0,2669,32
2021-01-21,Lassen,035,31185,4878,4763,81,4844,1
2021-01-21,Los Angeles,037,10098052,1079933,1023055,34856,1057911,14537
2021-01-21,Madera,039,155013,14320,13664,684,14348,86
2021-01-21,Marin,041,260295,12029,11732,129,11861,173
2021-01-21,Mariposa,043,17540,342,322,3,325,3
2021-01-21,Mendocino,045,87422,3156,2967,55,3022,32
2021-01-21,Merced,047,269075,25205,24426,673,25099,245
2021-01-21,Modoc,049,8938,303,284,92,376,0
2021-01-21,Mono,051,14174,1111,1104,15,1119,3
2021-01-21,Monterey,053,433212,38135,36149,1288,37437,253
2021-01-21,Napa,055,140530,8138,7774,32,7806,40
2021-01-21,Nevada,057,99092,3497,3274,137,3411,18
2021-01-21,Orange,059,3164182,226547,218867,9132,227999,2540
2021-01-21,Placer,061,380077,18798,17553,913,18466,190
2021-01-21,Plumas,063,18699,603,518,10,528,2
2021-01-21,Riverside,065,2383286,262808,251007,12363,263370,2676
2021-01-21,Sacramento,067,1510023,84900,82303,1008,83311,1084
2021-01-21,San Benito,069,59416,5239,5100,60,5160,43
2021-01-21,San Bernardino,071,2135413,268910,257754,7776,265530,1832
2021-01-21,San Diego,073,3302833,236215,219729,10920,230649,2222
2021-01-21,San Francisco,075,870044,30685,29801,716,30517,266
2021-01-21,San Joaquin,077,732212,60647,58270,2384,60654,806
2021-01-21,San Luis Obispo,079,281455,17412,16153,447,16600,169
2021-01-21,San Mateo,081,765935,35352,33156,290,33446,210
2021-01-21,Santa Barbara,083,443738,27642,25654,879,26533,253
2021-01-21,Santa Clara,085,1922200,98952,96028,443,96471,1062
2021-01-21,Santa Cruz,087,273765,13852,12548,652,13200,119
2021-01-21,Shasta,089,179085,10093,9795,1026,10821,98
2021-01-21,Sierra,091,2930,47,40,12,52,0
2021-01-21,Siskiyou,093,43540,1276,1178,185,1363,4
2021-01-21,Solano,095,438530,26923,25885,295,26180,106
2021-01-21,Sonoma,097,501317,25231,24440,129,24569,230
2021-01-21,Stanislaus,099,539301,45291,43223,4537,47760,599
2021-01-21,Sutter,101,95872,8066,7822,76,7898,80
2021-01-21,Tehama,103,63373,4116,3938,444,4382,19
2021-01-21,Trinity,105,12862,438,261,66,327,3
2021-01-21,Tulare,107,460477,44170,42082,6205,48287,569
2021-01-21,Tuolumne,109,53932,3377,3365,30,3395,29
2021-01-21,Ventura,111,848112,67129,63995,2371,66366,420
2021-01-21,Yolo,113,214977,11648,10940,133,11073,141
2021-01-21,Yuba,115,75493,4970,4757,64,4821,29
2021-01-20,Alameda,001,1643700,71567,68785,1501,70286,702
2021-01-20,Alpine,003,1148,73,71,0,71,0
2021-01-20,Amador,005,37829,3080,3036,24,3060,29
2021-01-20,Butte,007,227075,10230,9582,1393,10975,130
2021-01-20,Calaveras,009,45235,1669,1637,9,1646,21
2021-01-20,Colusa,011,21464,1701,1630,182,1812,7
2021-01-20,Contra Costa,013,1133247,55647,53108,914,54022,461
2021-01-20,Del Norte,015,27424,879,848,3,851,2
2021-01-20,El Dorado,017,186661,8316,7785,537,8322,53
2021-01-20,Fresno,019,978130,88260,83591,6645,90236,872
2021-01-20,Glenn,021,27897,2054,1955,413,2368,13
2021-01-20,Humboldt,023,135768,2590,2390,16,2406,22
2021-01-20,Imperial,025,180216,26048,25380,2341,27721,461
2021-01-20,Inyo,027,18085,1014,901,8,909,26
2021-01-20,Kern,029,883053,84936,80701,7739,88440,754
2021-01-20,Kings,031,150075,20386,19522,805,20327,146
2021-01-20,Lake,033,64148,2753,2646,0,2646,31
2021-01-20,Lassen,035,31185,4870,4758,79,4837,1
2021-01-20,Los Angeles,037,10098052,1072441,1015608,34569,1050177,14299
2021-01-20,Madera,039,155013,14256,13585,679,14264,86
2021-01-20,Marin,041,260295,11975,11684,127,11811,171
2021-01-20,Mariposa,043,17540,340,322,3,325,3
2021-01-20,Mendocino,045,87422,3141,2957,55,3012,32
2021-01-20,Merced,047,269075,25031,24220,653,24873,243
2021-01-20,Modoc,049,8938,302,282,92,374,0
2021-01-20,Mono,051,14174,1104,1105,14,1119,3
2021-01-20,Monterey,053,433212,37818,35960,1266,37226,249
2021-01-20,Napa,055,140530,8069,7731,31,7762,40
2021-01-20,Nevada,057,99092,3465,3238,137,3375,18
2021-01-20,Orange,059,3164182,225008,216893,9071,225964,2500
2021-01-20,Placer,061,380077,18704,17455,895,18350,186
2021-01-20,Plumas,063,18699,601,512,10,522,2
2021-01-20,Riverside,065,2383286,260762,248686,12276,260962,2615
2021-01-20,Sacramento,067,1510023,84337,81687,997,82684,1072
2021-01-20,San Benito,069,59416,5208,5036,59,5095,35
2021-01-20,San Bernardino,071,2135413,267553,255921,7729,263650,1801
2021-01-20,San Diego,073,3302833,234360,218553,10816,229369,2174
2021-01-20,San Francisco,075,870044,30496,29665,696,30361,262
2021-01-20,San Joaquin,077,732212,60244,58025,2375,60400,783
2021-01-20,San Luis Obispo,079,281455,17231,15936,438,16374,164
2021-01-20,San Mateo,081,765935,35125,32929,289,33218,210
2021-01-20,Santa Barbara,083,443738,27325,25312,867,26179,248
2021-01-20,Santa Clara,085,1922200,98272,94995,441,95436,1040
2021-01-20,Santa Cruz,087,273765,13745,12460,639,13099,107
2021-01-20,Shasta,089,179085,10041,9697,1016,10713,98
2021-01-20,Sierra,091,2930,47,40,12,52,0
2021-01-20,Siskiyou,093,43540,1270,1163,184,1347,4
2021-01-20,Solano,095,438530,26730,25659,291,25950,106
2021-01-20,Sonoma,097,501317,25094,24262,127,24389,223
2021-01-20,Stanislaus,099,539301,45002,42955,4491,47446,585
2021-01-20,Sutter,101,95872,8014,7772,74,7846,80
2021-01-20,Tehama,103,63373,4091,3892,443,4335,19
2021-01-20,Trinity,105,12862,438,260,66,326,3
2021-01-20,Tulare,107,460477,43912,41799,6112,47911,559
2021-01-20,Tuolumne,109,53932,3363,3355,29,3384,29
2021-01-20,Ventura,111,848112,66173,63413,2342,65755,395
2021-01-20,Yolo,113,214977,11577,10852,130,10982,141
2021-01-20,Yuba,115,75493,4943,4729,64,4793,29
2021-01-19,Alameda,001,1643700,70910,68434,1491,69925,680
2021-01-19,Alpine,003,1148,73,71,0,71,0
2021-01-19,Amador,005,37829,3071,3024,24,3048,28
2021-01-19,Butte,007,227075,10164,9528,1379,10907,129
2021-01-19,Calaveras,009,45235,1654,1621,8,1629,21
2021-01-19,Colusa,011,21464,1679,1617,174,1791,7
2021-01-19,Contra Costa,013,1133247,55151,52730,903,53633,448
2021-01-19,Del Norte,015,27424,877,843,3,846,2
2021-01-19,El Dorado,017,186661,8256,7743,529,8272,47
2021-01-19,Fresno,019,978130,87738,83200,6593,89793,857
2021-01-19,Glenn,021,27897,2042,1948,408,2356,13
2021-01-19,Humboldt,023,135768,2566,2359,13,2372,22
2021-01-19,Imperial,025,180216,25966,25333,2323,27656,452
2021-01-19,Inyo,027,18085,1007,891,8,899,26
2021-01-19,Kern,029,883053,84349,80272,7632,87904,742
2021-01-19,Kings,031,150075,20247,19375,794,20169,143
2021-01-19,Lake,033,64148,2738,2625,0,2625,31
2021-01-19,Lassen,035,31185,4863,4753,79,4832,1
2021-01-19,Los Angeles,037,10098052,1063769,1010375,34297,1044672,14014
2021-01-19,Madera,039,155013,14140,13528,672,14200,86
2021-01-19,Marin,041,260295,11917,11654,123,11777,169
2021-01-19,Mariposa,043,17540,340,322,3,325,3
2021-01-19,Mendocino,045,87422,3124,2930,55,2985,32
2021-01-19,Merced,047,269075,24817,24108,647,24755,242
2021-01-19,Modoc,049,8938,301,281,92,373,0
2021-01-19,Mono,051,14174,1103,1106,14,1120,3
2021-01-19,Monterey,053,433212,37500,35840,1245,37085,248
2021-01-19,Napa,055,140530,8010,7672,31,7703,38
2021-01-19,Nevada,057,99092,3447,3216,135,3351,18
2021-01-19,Orange,059,3164182,223272,215244,9002,224246,2468
2021-01-19,Placer,061,380077,18606,17348,885,18233,182
2021-01-19,Plumas,063,18699,594,509,10,519,2
2021-01-19,Riverside,065,2383286,258679,246248,12197,258445,2585
2021-01-19,Sacramento,067,1510023,83799,81183,977,82160,1053
2021-01-19,San Benito,069,59416,5162,4988,58,5046,35
2021-01-19,San Bernardino,071,2135413,265809,253651,7671,261322,1777
2021-01-19,San Diego,073,3302833,231940,216833,10718,227551,2109
2021-01-19,San Francisco,075,870044,30278,29502,665,30167,261
2021-01-19,San Joaquin,077,732212,59860,57655,2362,60017,782
2021-01-19,San Luis Obispo,079,281455,16967,15855,435,16290,161
2021-01-19,San Mateo,081,765935,34840,32730,278,33008,208
2021-01-19,Santa Barbara,083,443738,26941,24991,851,25842,236
2021-01-19,Santa Clara,085,1922200,97495,94483,439,94922,1010
2021-01-19,Santa Cruz,087,273765,13628,12410,631,13041,106
2021-01-19,Shasta,089,179085,10005,9614,1006,10620,93
2021-01-19,Sierra,091,2930,47,40,10,50,0
2021-01-19,Siskiyou,093,43540,1262,1149,183,1332,4
2021-01-19,Solano,095,438530,26484,25520,290,25810,106
2021-01-19,Sonoma,097,501317,24914,24133,125,24258,223
2021-01-19,Stanislaus,099,539301,44651,42723,4435,47158,561
2021-01-19,Sutter,101,95872,7963,7709,68,7777,80
2021-01-19,Tehama,103,63373,4056,3876,441,4317,19
2021-01-19,Trinity,105,12862,437,260,66,326,3
2021-01-19,Tulare,107,460477,43634,41559,6016,47575,549
2021-01-19,Tuolumne,109,53932,3335,3328,29,3357,29
2021-01-19,Ventura,111,848112,65495,62656,2315,64971,383
2021-01-19,Yolo,113,214977,11491,10789,130,10919,134
2021-01-19,Yuba,115,75493,4910,4695,63,4758,29
2021-01-18,Alameda,001,1643700,70266,67938,1473,69411,680
2021-01-18,Alpine,003,1148,73,71,0,71,0
2021-01-18,Amador,005,37829,3057,3016,24,3040,28
2021-01-18,Butte,007,227075,10077,9474,1366,10840,129
2021-01-18,Calaveras,009,45235,1633,1617,7,1624,21
2021-01-18,Colusa,011,21464,1662,1608,169,1777,7
2021-01-18,Contra Costa,013,1133247,54634,52323,895,53218,448
2021-01-18,Del Norte,015,27424,876,840,3,843,2
2021-01-18,El Dorado,017,186661,8187,7707,527,8234,47
2021-01-18,Fresno,019,978130,87126,82485,6526,89011,857
2021-01-18,Glenn,021,27897,2025,1935,404,2339,13
2021-01-18,Humboldt,023,135768,2528,2343,13,2356,22
2021-01-18,Imperial,025,180216,25897,25317,2298,27615,452
2021-01-18,Inyo,027,18085,995,872,8,880,26
2021-01-18,Kern,029,883053,83710,79930,7541,87471,740
2021-01-18,Kings,031,150075,20077,19267,782,20049,141
2021-01-18,Lake,033,64148,2721,2591,0,2591,30
2021-01-18,Lassen,035,31185,4827,4749,78,4827,1
2021-01-18,Los Angeles,037,10098052,1054279,1002614,34006,1036620,13828
2021-01-18,Madera,039,155013,14026,13443,664,14107,85
2021-01-18,Marin,041,260295,11869,11607,121,11728,165
2021-01-18,Mariposa,043,17540,337,320,2,322,3
2021-01-18,Mendocino,045,87422,3101,2919,55,2974,31
2021-01-18,Merced,047,269075,24572,23927,631,24558,242
2021-01-18,Modoc,049,8938,298,281,89,370,0
2021-01-18,Mono,051,14174,1100,1101,14,1115,3
2021-01-18,Monterey,053,433212,37046,35549,1228,36777,247
2021-01-18,Napa,055,140530,7936,7601,31,7632,38
2021-01-18,Nevada,057,99092,3409,3199,134,3333,17
2021-01-18,Orange,059,3164182,221370,213866,8946,222812,2405
2021-01-18,Placer,061,380077,18490,17263,876,18139,182
2021-01-18,Plumas,063,18699,590,506,10,516,2
2021-01-18,Riverside,065,2383286,256358,244151,12103,256254,2568
2021-01-18,Sacramento,067,1510023,83120,80546,961,81507,1046
2021-01-18,San Benito,069,59416,5112,4963,56,5019,35
2021-01-18,San Bernardino,071,2135413,264036,252808,7612,260420,1775
2021-01-18,San Diego,073,3302833,229293,214335,10589,224924,2103
2021-01-18,San Francisco,075,870044,30072,29321,641,29962,259
2021-01-18,San Joaquin,077,732212,59342,57405,2340,59745,782
2021-01-18,San Luis Obispo,079,281455,16780,15742,425,16167,158
2021-01-18,San Mateo,081,765935,34526,32515,259,32774,208
2021-01-18,Santa Barbara,083,443738,26563,24638,837,25475,235
2021-01-18,Santa Clara,085,1922200,96601,93688,435,94123,992
2021-01-18,Santa Cruz,087,273765,13495,12298,618,12916,106
2021-01-18,Shasta,089,179085,9966,9600,996,10596,92
2021-01-18,Sierra,091,2930,46,40,10,50,0
2021-01-18,Siskiyou,093,43540,1250,1144,181,1325,4
2021-01-18,Solano,095,438530,26206,25344,285,25629,105
2021-01-18,Sonoma,097,501317,24645,24068,124,24192,223
2021-01-18,Stanislaus,099,539301,44293,42413,4384,46797,562
2021-01-18,Sutter,101,95872,7905,7680,66,7746,78
2021-01-18,Tehama,103,63373,4012,3854,434,4288,19
2021-01-18,Trinity,105,12862,437,260,66,326,3
2021-01-18,Tulare,107,460477,43345,41196,5904,47100,549
2021-01-18,Tuolumne,109,53932,3312,3318,28,3346,28
2021-01-18,Ventura,111,848112,65065,61859,2292,64151,379
2021-01-18,Yolo,113,214977,11361,10620,127,10747,134
2021-01-18,Yuba,115,75493,4882,4671,61,4732,29
2021-01-17,Alameda,001,1643700,69689,67375,1454,68829,676
2021-01-17,Alpine,003,1148,73,71,0,71,0
2021-01-17,Amador,005,37829,3050,3001,24,3025,28
2021-01-17,Butte,007,227075,10005,9411,1344,10755,129
2021-01-17,Calaveras,009,45235,1620,1608,7,1615,21
2021-01-17,Colusa,011,21464,1648,1588,164,1752,7
2021-01-17,Contra Costa,013,1133247,54143,51932,885,52817,447
2021-01-17,Del Norte,015,27424,876,838,3,841,2
2021-01-17,El Dorado,017,186661,8131,7659,515,8174,47
2021-01-17,Fresno,019,978130,86573,82039,6450,88489,857
2021-01-17,Glenn,021,27897,2015,1924,399,2323,9
2021-01-17,Humboldt,023,135768,2490,2322,11,2333,22
2021-01-17,Imperial,025,180216,25827,25253,2254,27507,451
2021-01-17,Inyo,027,18085,989,864,8,872,26
2021-01-17,Kern,029,883053,83162,79489,7455,86944,738
2021-01-17,Kings,031,150075,19941,19201,768,19969,131
2021-01-17,Lake,033,64148,2705,2572,0,2572,30
2021-01-17,Lassen,035,31185,4819,4740,77,4817,1
2021-01-17,Los Angeles,037,10098052,1047639,993028,33605,1026633,13741
2021-01-17,Madera,039,155013,13934,13328,659,13987,85
2021-01-17,Marin,041,260295,11816,11552,119,11671,164
2021-01-17,Mariposa,043,17540,337,319,2,321,3
2021-01-17,Mendocino,045,87422,3073,2912,54,2966,31
2021-01-17,Merced,047,269075,24357,23800,614,24414,242
2021-01-17,Modoc,049,8938,297,279,89,368,0
2021-01-17,Mono,051,14174,1093,1091,13,1104,3
2021-01-17,Monterey,053,433212,36809,35340,1203,36543,244
2021-01-17,Napa,055,140530,7880,7521,31,7552,38
2021-01-17,Nevada,057,99092,3384,3176,132,3308,17
2021-01-17,Orange,059,3164182,219364,212389,8871,221260,2359
2021-01-17,Placer,061,380077,18385,17194,861,18055,181
2021-01-17,Plumas,063,18699,589,505,9,514,2
2021-01-17,Riverside,065,2383286,254246,242206,11984,254190,2534
2021-01-17,Sacramento,067,1510023,82516,80154,948,81102,1045
2021-01-17,San Benito,069,59416,5074,4941,56,4997,35
2021-01-17,San Bernardino,071,2135413,261912,251487,7522,259009,1775
2021-01-17,San Diego,073,3302833,227099,211785,10482,222267,2103
2021-01-17,San Francisco,075,870044,29887,29139,602,29741,255
2021-01-17,San Joaquin,077,732212,58982,57094,2325,59419,780
2021-01-17,San Luis Obispo,079,281455,16658,15658,416,16074,157
2021-01-17,San Mateo,081,765935,34273,32186,236,32422,208
2021-01-17,Santa Barbara,083,443738,26106,24401,821,25222,235
2021-01-17,Santa Clara,085,1922200,95851,92752,432,93184,976
2021-01-17,Santa Cruz,087,273765,13383,12196,615,12811,106
2021-01-17,Shasta,089,179085,9908,9588,988,10576,92
2021-01-17,Sierra,091,2930,46,38,9,47,0
2021-01-17,Siskiyou,093,43540,1243,1136,178,1314,4
2021-01-17,Solano,095,438530,25976,25216,283,25499,105
2021-01-17,Sonoma,097,501317,24471,23871,124,23995,223
2021-01-17,Stanislaus,099,539301,43973,42221,4327,46548,562
2021-01-17,Sutter,101,95872,7841,7604,65,7669,77
2021-01-17,Tehama,103,63373,3982,3837,429,4266,18
2021-01-17,Trinity,105,12862,437,261,66,327,3
2021-01-17,Tulare,107,460477,43053,41016,5788,46804,549
2021-01-17,Tuolumne,109,53932,3295,3287,28,3315,27
2021-01-17,Ventura,111,848112,64221,61257,2245,63502,376
2021-01-17,Yolo,113,214977,11260,10519,125,10644,134
2021-01-17,Yuba,115,75493,4831,4640,59,4699,28
2021-01-16,Alameda,001,1643700,69363,66583,1441,68024,673
2021-01-16,Alpine,003,1148,73,71,0,71,0
2021-01-16,Amador,005,37829,3047,2986,24,3010,28
2021-01-16,Butte,007,227075,9975,9359,1324,10683,129
2021-01-16,Calaveras,009,45235,1607,1596,7,1603,21
2021-01-16,Colusa,011,21464,1636,1578,164,1742,7
2021-01-16,Contra Costa,013,1133247,53878,51363,878,52241,443
2021-01-16,Del Norte,015,27424,871,833,3,836,2
2021-01-16,El Dorado,017,186661,8109,7575,514,8089,47
2021-01-16,Fresno,019,978130,86299,81294,6397,87691,846
2021-01-16,Glenn,021,27897,2011,1894,395,2289,9
2021-01-16,Humboldt,023,135768,2470,2294,9,2303,22
2021-01-16,Imperial,025,180216,25793,25140,2247,27387,451
2021-01-16,Inyo,027,18085,985,845,8,853,25
2021-01-16,Kern,029,883053,82795,78865,7402,86267,733
2021-01-16,Kings,031,150075,19885,19072,765,19837,131
2021-01-16,Lake,033,64148,2695,2504,0,2504,30
2021-01-16,Lassen,035,31185,4807,4719,77,4796,1
2021-01-16,Los Angeles,037,10098052,1043559,982684,33364,1016048,13654
2021-01-16,Madera,039,155013,13868,13193,655,13848,85
2021-01-16,Marin,041,260295,11774,11482,119,11601,164
2021-01-16,Mariposa,043,17540,336,317,2,319,3
2021-01-16,Mendocino,045,87422,3059,2890,51,2941,31
2021-01-16,Merced,047,269075,24270,23478,600,24078,242
2021-01-16,Modoc,049,8938,297,278,89,367,0
2021-01-16,Mono,051,14174,1091,1079,13,1092,3
2021-01-16,Monterey,053,433212,36700,34972,1185,36157,243
2021-01-16,Napa,055,140530,7841,7356,31,7387,39
2021-01-16,Nevada,057,99092,3351,3144,132,3276,17
2021-01-16,Orange,059,3164182,218325,210111,8814,218925,2312
2021-01-16,Placer,061,380077,18321,16995,859,17854,177
2021-01-16,Plumas,063,18699,587,502,9,511,2
2021-01-16,Riverside,065,2383286,252889,239412,11867,251279,2506
2021-01-16,Sacramento,067,1510023,82140,79122,931,80053,1033
2021-01-16,San Benito,069,59416,5042,4875,56,4931,35
2021-01-16,San Bernardino,071,2135413,261131,249401,7456,256857,1755
2021-01-16,San Diego,073,3302833,225801,209895,10386,220281,2065
2021-01-16,San Francisco,075,870044,29760,28853,571,29424,244
2021-01-16,San Joaquin,077,732212,58735,56642,2294,58936,776
2021-01-16,San Luis Obispo,079,281455,16557,15466,414,15880,152
2021-01-16,San Mateo,081,765935,34109,31805,230,32035,208
2021-01-16,Santa Barbara,083,443738,25909,24088,814,24902,229
2021-01-16,Santa Clara,085,1922200,95384,91584,425,92009,954
2021-01-16,Santa Cruz,087,273765,13324,12026,613,12639,106
2021-01-16,Shasta,089,179085,9875,9547,984,10531,92
2021-01-16,Sierra,091,2930,45,38,9,47,0
2021-01-16,Siskiyou,093,43540,1238,1124,178,1302,4
2021-01-16,Solano,095,438530,25867,24732,277,25009,103
2021-01-16,Sonoma,097,501317,24379,23607,123,23730,223
2021-01-16,Stanislaus,099,539301,43783,41809,4276,46085,562
2021-01-16,Sutter,101,95872,7809,7560,65,7625,76
2021-01-16,Tehama,103,63373,3968,3783,429,4212,18
2021-01-16,Trinity,105,12862,437,261,66,327,3
2021-01-16,Tulare,107,460477,42873,40655,5715,46370,542
2021-01-16,Tuolumne,109,53932,3287,3269,28,3297,27
2021-01-16,Ventura,111,848112,63668,60368,2215,62583,369
2021-01-16,Yolo,113,214977,11211,10406,124,10530,134
2021-01-16,Yuba,115,75493,4800,4602,59,4661,27
2021-01-15,Alameda,001,1643700,68923,65416,1431,66847,672
2021-01-15,Alpine,003,1148,73,71,0,71,0
2021-01-15,Amador,005,37829,3040,2953,24,2977,28
2021-01-15,Butte,007,227075,9937,9233,1307,10540,129
2021-01-15,Calaveras,009,45235,1600,1538,7,1545,21
2021-01-15,Colusa,011,21464,1625,1541,160,1701,7
2021-01-15,Contra Costa,013,1133247,53548,50408,871,51279,428
2021-01-15,Del Norte,015,27424,867,828,2,830,2
2021-01-15,El Dorado,017,186661,8060,7439,505,7944,47
2021-01-15,Fresno,019,978130,85761,79950,6364,86314,832
2021-01-15,Glenn,021,27897,2006,1824,393,2217,9
2021-01-15,Humboldt,023,135768,2443,2218,8,2226,22
2021-01-15,Imperial,025,180216,25759,24944,2241,27185,446
2021-01-15,Inyo,027,18085,967,814,8,822,25
2021-01-15,Kern,029,883053,82383,77873,7337,85210,719
2021-01-15,Kings,031,150075,19776,18661,759,19420,131
2021-01-15,Lake,033,64148,2669,2434,0,2434,28
2021-01-15,Lassen,035,31185,4796,4693,75,4768,1
2021-01-15,Los Angeles,037,10098052,1036513,968979,33073,1002052,13404
2021-01-15,Madera,039,155013,13783,12883,652,13535,85
2021-01-15,Marin,041,260295,11723,11310,119,11429,160
2021-01-15,Mariposa,043,17540,334,307,2,309,3
2021-01-15,Mendocino,045,87422,3048,2835,51,2886,31
2021-01-15,Merced,047,269075,24157,23060,596,23656,239
2021-01-15,Modoc,049,8938,297,278,87,365,0
2021-01-15,Mono,051,14174,1088,1057,13,1070,3
2021-01-15,Monterey,053,433212,36488,34460,1126,35586,243
2021-01-15,Napa,055,140530,7779,7231,31,7262,38
2021-01-15,Nevada,057,99092,3338,3099,129,3228,17
2021-01-15,Orange,059,3164182,216967,207129,8762,215891,2254
2021-01-15,Placer,061,380077,18218,16712,850,17562,173
2021-01-15,Plumas,063,18699,584,499,9,508,2
2021-01-15,Riverside,065,2383286,251032,235235,11789,247024,2458
2021-01-15,Sacramento,067,1510023,81722,80279,923,81202,1023
2021-01-15,San Benito,069,59416,5003,4766,54,4820,35
2021-01-15,San Bernardino,071,2135413,259971,246182,7398,253580,1726
2021-01-15,San Diego,073,3302833,224052,206868,10321,217189,2037
2021-01-15,San Francisco,075,870044,29586,28574,551,29125,242
2021-01-15,San Joaquin,077,732212,58501,55885,2280,58165,748
2021-01-15,San Luis Obispo,079,281455,16424,15129,409,15538,148
2021-01-15,San Mateo,081,765935,33864,31291,226,31517,208
2021-01-15,Santa Barbara,083,443738,25631,23487,804,24291,226
2021-01-15,Santa Clara,085,1922200,94734,90103,420,90523,942
2021-01-15,Santa Cruz,087,273765,13215,11776,599,12375,105
2021-01-15,Shasta,089,179085,9836,9459,976,10435,91
2021-01-15,Sierra,091,2930,44,36,8,44,0
2021-01-15,Siskiyou,093,43540,1234,1119,177,1296,4
2021-01-15,Solano,095,438530,25718,24222,274,24496,103
2021-01-15,Sonoma,097,501317,24247,23204,122,23326,222
2021-01-15,Stanislaus,099,539301,43540,41178,4240,45418,562
2021-01-15,Sutter,101,95872,7762,7484,64,7548,75
2021-01-15,Tehama,103,63373,3947,3714,428,4142,17
2021-01-15,Trinity,105,12862,437,262,66,328,3
2021-01-15,Tulare,107,460477,42628,39951,5631,45582,535
2021-01-15,Tuolumne,109,53932,3271,3231,28,3259,27
2021-01-15,Ventura,111,848112,62923,59061,2182,61243,353
2021-01-15,Yolo,113,214977,11156,10240,123,10363,134
2021-01-15,Yuba,115,75493,4779,4549,59,4608,27
2021-01-14,Alameda,001,1643700,68271,64364,1415,65779,686
2021-01-14,Alpine,003,1148,73,71,0,71,0
2021-01-14,Amador,005,37829,3034,2940,24,2964,28
2021-01-14,Butte,007,227075,9852,9127,1286,10413,129
2021-01-14,Calaveras,009,45235,1583,1513,7,1520,21
2021-01-14,Colusa,011,21464,1610,1535,157,1692,7
2021-01-14,Contra Costa,013,1133247,52994,49545,857,50402,415
2021-01-14,Del Norte,015,27424,861,821,2,823,2
2021-01-14,El Dorado,017,186661,7986,7321,497,7818,45
2021-01-14,Fresno,019,978130,85128,79033,6288,85321,814
2021-01-14,Glenn,021,27897,1993,1798,388,2186,9
2021-01-14,Humboldt,023,135768,2400,2169,8,2177,22
2021-01-14,Imperial,025,180216,25650,24882,2205,27087,447
2021-01-14,Inyo,027,18085,960,790,8,798,25
2021-01-14,Kern,029,883053,81715,77070,7236,84306,705
2021-01-14,Kings,031,150075,19646,18405,755,19160,108
2021-01-14,Lake,033,64148,2626,2378,0,2378,27
2021-01-14,Lassen,035,31185,4786,4673,73,4746,1
2021-01-14,Los Angeles,037,10098052,1026506,954652,32693,987345,13147
2021-01-14,Madera,039,155013,13670,12742,641,13383,85
2021-01-14,Marin,041,260295,11649,11155,118,11273,159
2021-01-14,Mariposa,043,17540,331,302,2,304,3
2021-01-14,Mendocino,045,87422,3034,2801,49,2850,31
2021-01-14,Merced,047,269075,23928,22780,587,23367,239
2021-01-14,Modoc,049,8938,297,273,87,360,0
2021-01-14,Mono,051,14174,1080,1020,13,1033,3
2021-01-14,Monterey,053,433212,36073,34105,1106,35211,242
2021-01-14,Napa,055,140530,7694,7117,31,7148,38
2021-01-14,Nevada,057,99092,3311,3075,127,3202,17
2021-01-14,Orange,059,3164182,215038,204442,8676,213118,2162
2021-01-14,Placer,061,380077,18056,16488,843,17331,169
2021-01-14,Plumas,063,18699,576,496,9,505,2
2021-01-14,Riverside,065,2383286,248384,231684,11690,243374,2357
2021-01-14,Sacramento,067,1510023,81084,79137,899,80036,1007
2021-01-14,San Benito,069,59416,4967,4678,53,4731,35
2021-01-14,San Bernardino,071,2135413,258004,243379,7328,250707,1750
2021-01-14,San Diego,073,3302833,221658,204173,10201,214374,2005
2021-01-14,San Francisco,075,870044,29342,28200,503,28703,238
2021-01-14,San Joaquin,077,732212,57987,55058,2266,57324,739
2021-01-14,San Luis Obispo,079,281455,16263,14851,400,15251,146
2021-01-14,San Mateo,081,765935,33495,30694,217,30911,208
2021-01-14,Santa Barbara,083,443738,25219,23126,778,23904,219
2021-01-14,Santa Clara,085,1922200,93797,88505,413,88918,910
2021-01-14,Santa Cruz,087,273765,13068,11583,583,12166,109
2021-01-14,Shasta,089,179085,9786,9334,960,10294,90
2021-01-14,Sierra,091,2930,44,35,7,42,0
2021-01-14,Siskiyou,093,43540,1222,1108,174,1282,3
2021-01-14,Solano,095,438530,25459,23782,270,24052,103
2021-01-14,Sonoma,097,501317,24007,22910,122,23032,202
2021-01-14,Stanislaus,099,539301,43215,40597,4202,44799,574
2021-01-14,Sutter,101,95872,7703,7416,61,7477,74
2021-01-14,Tehama,103,63373,3918,3664,424,4088,17
2021-01-14,Trinity,105,12862,437,261,65,326,3
2021-01-14,Tulare,107,460477,42244,39565,5522,45087,533
2021-01-14,Tuolumne,109,53932,3250,3215,28,3243,28
2021-01-14,Ventura,111,848112,62051,57941,2144,60085,347
2021-01-14,Yolo,113,214977,11045,10097,117,10214,135
2021-01-14,Yuba,115,75493,4747,4496,59,4555,27
2021-01-13,Alameda,001,1643700,67517,63568,1398,64966,690
2021-01-13,Alpine,003,1148,73,71,0,71,0
2021-01-13,Amador,005,37829,3020,2914,24,2938,26
2021-01-13,Butte,007,227075,9773,9013,1272,10285,126
2021-01-13,Calaveras,009,45235,1561,1493,7,1500,21
2021-01-13,Colusa,011,21464,1598,1524,152,1676,7
2021-01-13,Contra Costa,013,1133247,52415,48877,845,49722,403
2021-01-13,Del Norte,015,27424,857,820,2,822,2
2021-01-13,El Dorado,017,186661,7893,7247,489,7736,43
2021-01-13,Fresno,019,978130,84408,78278,6246,84524,804
2021-01-13,Glenn,021,27897,1978,1792,380,2172,9
2021-01-13,Humboldt,023,135768,2367,2114,8,2122,22
2021-01-13,Imperial,025,180216,25526,24717,2171,26888,463
2021-01-13,Inyo,027,18085,948,785,8,793,25
2021-01-13,Kern,029,883053,81054,76049,7146,83195,704
2021-01-13,Kings,031,150075,19479,18121,733,18854,108
2021-01-13,Lake,033,64148,2582,2305,0,2305,27
2021-01-13,Lassen,035,31185,4779,4663,72,4735,1
2021-01-13,Los Angeles,037,10098052,1015730,937985,32283,970268,12873
2021-01-13,Madera,039,155013,13544,12570,636,13206,85
2021-01-13,Marin,041,260295,11593,11039,118,11157,161
2021-01-13,Mariposa,043,17540,329,304,2,306,3
2021-01-13,Mendocino,045,87422,3014,2790,49,2839,31
2021-01-13,Merced,047,269075,23688,22497,572,23069,241
2021-01-13,Modoc,049,8938,296,274,84,358,0
2021-01-13,Mono,051,14174,1076,1017,13,1030,3
2021-01-13,Monterey,053,433212,35653,33748,1082,34830,241
2021-01-13,Napa,055,140530,7580,7028,31,7059,36
2021-01-13,Nevada,057,99092,3287,3037,124,3161,17
2021-01-13,Orange,059,3164182,212949,201158,8607,209765,2172
2021-01-13,Placer,061,380077,17929,16272,829,17101,172
2021-01-13,Plumas,063,18699,574,490,9,499,2
2021-01-13,Riverside,065,2383286,245233,228192,11573,239765,2278
2021-01-13,Sacramento,067,1510023,80422,78268,892,79160,996
2021-01-13,San Benito,069,59416,4910,4583,52,4635,35
2021-01-13,San Bernardino,071,2135413,255631,240191,7256,247447,1759
2021-01-13,San Diego,073,3302833,219044,201578,10098,211676,1952
2021-01-13,San Francisco,075,870044,29102,27863,481,28344,238
2021-01-13,San Joaquin,077,732212,57363,54373,2236,56609,738
2021-01-13,San Luis Obispo,079,281455,16108,14625,389,15014,140
2021-01-13,San Mateo,081,765935,33154,30195,215,30410,207
2021-01-13,Santa Barbara,083,443738,24785,22714,754,23468,216
2021-01-13,Santa Clara,085,1922200,92821,87187,410,87597,911
2021-01-13,Santa Cruz,087,273765,12895,11423,569,11992,110
2021-01-13,Shasta,089,179085,9722,9180,946,10126,93
2021-01-13,Sierra,091,2930,44,33,7,40,0
2021-01-13,Siskiyou,093,43540,1216,1102,170,1272,3
2021-01-13,Solano,095,438530,25174,23503,269,23772,105
2021-01-13,Sonoma,097,501317,23759,22610,121,22731,206
2021-01-13,Stanislaus,099,539301,42813,40167,4148,44315,574
2021-01-13,Sutter,101,95872,7657,7350,60,7410,73
2021-01-13,Tehama,103,63373,3868,3589,419,4008,17
2021-01-13,Trinity,105,12862,437,260,65,325,3
2021-01-13,Tulare,107,460477,41836,39129,5418,44547,522
2021-01-13,Tuolumne,109,53932,3236,3196,28,3224,28
2021-01-13,Ventura,111,848112,61038,56453,2105,58558,338
2021-01-13,Yolo,113,214977,10945,9933,113,10046,135
2021-01-13,Yuba,115,75493,4705,4448,56,4504,27
2021-01-12,Alameda,001,1643700,66694,62642,1378,64020,677
2021-01-12,Alpine,003,1148,73,71,0,71,0
2021-01-12,Amador,005,37829,3003,2897,24,2921,26
2021-01-12,Butte,007,227075,9687,8883,1255,10138,124
2021-01-12,Calaveras,009,45235,1524,1475,7,1482,21
2021-01-12,Colusa,011,21464,1586,1510,148,1658,7
2021-01-12,Contra Costa,013,1133247,51774,48242,831,49073,399
2021-01-12,Del Norte,015,27424,852,816,2,818,2
2021-01-12,El Dorado,017,186661,7810,7156,478,7634,41
2021-01-12,Fresno,019,978130,83536,77651,6177,83828,796
2021-01-12,Glenn,021,27897,1953,1781,375,2156,9
2021-01-12,Humboldt,023,135768,2313,2077,7,2084,22
2021-01-12,Imperial,025,180216,25436,24566,2130,26696,457
2021-01-12,Inyo,027,18085,931,773,8,781,25
2021-01-12,Kern,029,883053,80349,75320,7048,82368,689
2021-01-12,Kings,031,150075,19267,18072,723,18795,108
2021-01-12,Lake,033,64148,2535,2260,0,2260,27
2021-01-12,Lassen,035,31185,4757,4659,70,4729,1
2021-01-12,Los Angeles,037,10098052,1004088,926295,31869,958164,12610
2021-01-12,Madera,039,155013,13403,12485,627,13112,85
2021-01-12,Marin,041,260295,11484,10960,118,11078,157
2021-01-12,Mariposa,043,17540,326,302,2,304,3
2021-01-12,Mendocino,045,87422,2994,2762,45,2807,31
2021-01-12,Merced,047,269075,23437,22172,550,22722,239
2021-01-12,Modoc,049,8938,294,274,84,358,0
2021-01-12,Mono,051,14174,1066,1008,13,1021,3
2021-01-12,Monterey,053,433212,35156,33381,1062,34443,240
2021-01-12,Napa,055,140530,7497,6936,31,6967,36
2021-01-12,Nevada,057,99092,3259,3014,122,3136,17
2021-01-12,Orange,059,3164182,210658,198260,8520,206780,2142
2021-01-12,Placer,061,380077,17759,16087,823,16910,163
2021-01-12,Plumas,063,18699,568,483,9,492,2
2021-01-12,Riverside,065,2383286,242101,225580,11433,237013,2266
2021-01-12,Sacramento,067,1510023,79682,77201,884,78085,985
2021-01-12,San Benito,069,59416,4842,4515,52,4567,35
2021-01-12,San Bernardino,071,2135413,253061,237008,7187,244195,1739
2021-01-12,San Diego,073,3302833,216130,198317,9981,208298,1898
2021-01-12,San Francisco,075,870044,28825,27531,448,27979,238
2021-01-12,San Joaquin,077,732212,56720,53630,2209,55839,725
2021-01-12,San Luis Obispo,079,281455,15860,14367,380,14747,132
2021-01-12,San Mateo,081,765935,32763,29747,203,29950,206
2021-01-12,Santa Barbara,083,443738,24369,22182,726,22908,209
2021-01-12,Santa Clara,085,1922200,91749,86075,402,86477,904
2021-01-12,Santa Cruz,087,273765,12680,11267,553,11820,110
2021-01-12,Shasta,089,179085,9649,9086,933,10019,84
2021-01-12,Sierra,091,2930,43,33,6,39,0
2021-01-12,Siskiyou,093,43540,1206,1091,164,1255,3
2021-01-12,Solano,095,438530,24871,23160,264,23424,102
2021-01-12,Sonoma,097,501317,23451,22403,121,22524,205
2021-01-12,Stanislaus,099,539301,42363,39615,4114,43729,571
2021-01-12,Sutter,101,95872,7594,7276,59,7335,73
2021-01-12,Tehama,103,63373,3832,3567,415,3982,17
2021-01-12,Trinity,105,12862,437,258,65,323,3
2021-01-12,Tulare,107,460477,41377,38797,5302,44099,509
2021-01-12,Tuolumne,109,53932,3203,3178,28,3206,28
2021-01-12,Ventura,111,848112,60066,55342,2072,57414,324
2021-01-12,Yolo,113,214977,10811,9857,103,9960,133
2021-01-12,Yuba,115,75493,4663,4389,56,4445,27
2021-01-11,Alameda,001,1643700,65832,61949,1361,63310,652
2021-01-11,Alpine,003,1148,73,70,0,70,0
2021-01-11,Amador,005,37829,2989,2867,24,2891,24
2021-01-11,Butte,007,227075,9574,8757,1237,9994,119
2021-01-11,Calaveras,009,45235,1505,1460,7,1467,21
2021-01-11,Colusa,011,21464,1568,1494,144,1638,7
2021-01-11,Contra Costa,013,1133247,51095,47728,822,48550,398
2021-01-11,Del Norte,015,27424,848,810,2,812,2
2021-01-11,El Dorado,017,186661,7716,6987,470,7457,36
2021-01-11,Fresno,019,978130,82656,76581,6100,82681,775
2021-01-11,Glenn,021,27897,1925,1763,369,2132,9
2021-01-11,Humboldt,023,135768,2274,2069,7,2076,22
2021-01-11,Imperial,025,180216,25321,24418,2095,26513,453
2021-01-11,Inyo,027,18085,913,763,8,771,25
2021-01-11,Kern,029,883053,79493,74489,6946,81435,682
2021-01-11,Kings,031,150075,19004,17909,715,18624,108
2021-01-11,Lake,033,64148,2483,2205,0,2205,26
2021-01-11,Lassen,035,31185,4734,4647,69,4716,1
2021-01-11,Los Angeles,037,10098052,990881,914434,31397,945831,12304
2021-01-11,Madera,039,155013,13270,12366,616,12982,85
2021-01-11,Marin,041,260295,11388,10814,115,10929,156
2021-01-11,Mariposa,043,17540,319,296,2,298,3
2021-01-11,Mendocino,045,87422,2966,2728,45,2773,31
2021-01-11,Merced,047,269075,23114,21884,536,22420,238
2021-01-11,Modoc,049,8938,293,271,83,354,0
2021-01-11,Mono,051,14174,1060,1006,13,1019,3
2021-01-11,Monterey,053,433212,34618,32858,999,33857,239
2021-01-11,Napa,055,140530,7395,6822,31,6853,36
2021-01-11,Nevada,057,99092,3231,2980,122,3102,17
2021-01-11,Orange,059,3164182,208076,196340,8419,204759,2113
2021-01-11,Placer,061,380077,17579,15919,813,16732,163
2021-01-11,Plumas,063,18699,564,477,9,486,2
2021-01-11,Riverside,065,2383286,238582,222907,11286,234193,2222
2021-01-11,Sacramento,067,1510023,78754,76009,868,76877,974
2021-01-11,San Benito,069,59416,4767,4482,45,4527,34
2021-01-11,San Bernardino,071,2135413,250226,235543,7088,242631,1739
2021-01-11,San Diego,073,3302833,212861,194793,9821,204614,1857
2021-01-11,San Francisco,075,870044,28550,27264,427,27691,238
2021-01-11,San Joaquin,077,732212,56110,53002,2179,55181,725
2021-01-11,San Luis Obispo,079,281455,15490,14213,372,14585,126
2021-01-11,San Mateo,081,765935,32318,29355,191,29546,206
2021-01-11,Santa Barbara,083,443738,23925,21740,709,22449,200
2021-01-11,Santa Clara,085,1922200,90546,84851,393,85244,877
2021-01-11,Santa Cruz,087,273765,12500,11093,529,11622,106
2021-01-11,Shasta,089,179085,9551,8977,920,9897,81
2021-01-11,Sierra,091,2930,41,33,6,39,0
2021-01-11,Siskiyou,093,43540,1197,1087,162,1249,3
2021-01-11,Solano,095,438530,24549,22893,259,23152,101
2021-01-11,Sonoma,097,501317,23204,22191,121,22312,205
2021-01-11,Stanislaus,099,539301,41871,39149,4063,43212,571
2021-01-11,Sutter,101,95872,7535,7204,58,7262,71
2021-01-11,Tehama,103,63373,3768,3524,394,3918,17
2021-01-11,Trinity,105,12862,437,256,65,321,2
2021-01-11,Tulare,107,460477,40962,38380,5223,43603,497
2021-01-11,Tuolumne,109,53932,3192,3165,28,3193,27
2021-01-11,Ventura,111,848112,58929,54202,2049,56251,320
2021-01-11,Yolo,113,214977,10600,9699,101,9800,129
2021-01-11,Yuba,115,75493,4625,4349,49,4398,27
2021-01-10,Alameda,001,1643700,64840,61111,1332,62443,650
2021-01-10,Alpine,003,1148,73,70,0,70,0
2021-01-10,Amador,005,37829,2965,2861,24,2885,24
2021-01-10,Butte,007,227075,9455,8665,1211,9876,119
2021-01-10,Calaveras,009,45235,1481,1449,7,1456,21
2021-01-10,Colusa,011,21464,1544,1478,143,1621,7
2021-01-10,Contra Costa,013,1133247,50308,47109,804,47913,398
2021-01-10,Del Norte,015,27424,845,809,2,811,2
2021-01-10,El Dorado,017,186661,7629,6904,452,7356,36
2021-01-10,Fresno,019,978130,81845,75621,5977,81598,775
2021-01-10,Glenn,021,27897,1904,1746,362,2108,9
2021-01-10,Humboldt,023,135768,2213,2049,7,2056,22
2021-01-10,Imperial,025,180216,25158,24233,2044,26277,453
2021-01-10,Inyo,027,18085,885,748,8,756,25
2021-01-10,Kern,029,883053,78666,73712,6814,80526,679
2021-01-10,Kings,031,150075,18785,17812,708,18520,108
2021-01-10,Lake,033,64148,2430,2174,0,2174,26
2021-01-10,Lassen,035,31185,4712,4642,69,4711,1
2021-01-10,Los Angeles,037,10098052,976298,901783,30768,932551,12170
2021-01-10,Madera,039,155013,13081,12179,601,12780,85
2021-01-10,Marin,041,260295,11267,10737,113,10850,155
2021-01-10,Mariposa,043,17540,319,291,2,293,3
2021-01-10,Mendocino,045,87422,2935,2706,42,2748,31
2021-01-10,Merced,047,269075,22840,21691,526,22217,238
2021-01-10,Modoc,049,8938,293,271,81,352,0
2021-01-10,Mono,051,14174,1042,965,13,978,3
2021-01-10,Monterey,053,433212,34178,32571,967,33538,237
2021-01-10,Napa,055,140530,7291,6687,29,6716,36
2021-01-10,Nevada,057,99092,3212,2959,118,3077,17
2021-01-10,Orange,059,3164182,205311,193766,8295,202061,2104
2021-01-10,Placer,061,380077,17393,15779,793,16572,163
2021-01-10,Plumas,063,18699,554,477,9,486,2
2021-01-10,Riverside,065,2383286,235207,219486,11096,230582,2216
2021-01-10,Sacramento,067,1510023,77792,75394,840,76234,965
2021-01-10,San Benito,069,59416,4668,4434,44,4478,34
2021-01-10,San Bernardino,071,2135413,246638,232171,6984,239155,1736
2021-01-10,San Diego,073,3302833,209195,191886,9654,201540,1857
2021-01-10,San Francisco,075,870044,28166,27054,396,27450,238
2021-01-10,San Joaquin,077,732212,55251,52535,2145,54680,725
2021-01-10,San Luis Obispo,079,281455,15160,13968,360,14328,122
2021-01-10,San Mateo,081,765935,31826,28972,177,29149,206
2021-01-10,Santa Barbara,083,443738,23373,21290,688,21978,200
2021-01-10,Santa Clara,085,1922200,89371,83779,384,84163,858
2021-01-10,Santa Cruz,087,273765,12287,10951,508,11459,106
2021-01-10,Shasta,089,179085,9439,8936,905,9841,81
2021-01-10,Sierra,091,2930,40,32,6,38,0
2021-01-10,Siskiyou,093,43540,1191,1075,159,1234,3
2021-01-10,Solano,095,438530,24148,22621,256,22877,101
2021-01-10,Sonoma,097,501317,22929,21925,120,22045,204
2021-01-10,Stanislaus,099,539301,41309,38809,3983,42792,571
2021-01-10,Sutter,101,95872,7474,7133,55,7188,71
2021-01-10,Tehama,103,63373,3695,3504,381,3885,17
2021-01-10,Trinity,105,12862,437,253,63,316,2
2021-01-10,Tulare,107,460477,40544,38012,5101,43113,497
2021-01-10,Tuolumne,109,53932,3158,3143,27,3170,27
2021-01-10,Ventura,111,848112,57660,53095,2005,55100,319
2021-01-10,Yolo,113,214977,10448,9610,100,9710,129
2021-01-10,Yuba,115,75493,4573,4300,46,4346,27
2021-01-09,Alameda,001,1643700,64315,60125,1316,61441,649
2021-01-09,Alpine,003,1148,73,70,0,70,0
2021-01-09,Amador,005,37829,2958,2809,24,2833,24
2021-01-09,Butte,007,227075,9374,8552,1187,9739,118
2021-01-09,Calaveras,009,45235,1472,1425,7,1432,21
2021-01-09,Colusa,011,21464,1538,1468,142,1610,7
2021-01-09,Contra Costa,013,1133247,49956,46406,789,47195,393
2021-01-09,Del Norte,015,27424,843,802,2,804,2
2021-01-09,El Dorado,017,186661,7597,6800,449,7249,36
2021-01-09,Fresno,019,978130,81436,74816,5937,80753,773
2021-01-09,Glenn,021,27897,1888,1707,358,2065,9
2021-01-09,Humboldt,023,135768,2195,2026,7,2033,22
2021-01-09,Imperial,025,180216,25090,24028,2030,26058,448
2021-01-09,Inyo,027,18085,875,734,8,742,25
2021-01-09,Kern,029,883053,78202,73015,6738,79753,677
2021-01-09,Kings,031,150075,18690,17679,704,18383,108
2021-01-09,Lake,033,64148,2395,2144,0,2144,26
2021-01-09,Lassen,035,31185,4700,4613,68,4681,1
2021-01-09,Los Angeles,037,10098052,970732,887949,30327,918276,12011
2021-01-09,Madera,039,155013,12990,12063,596,12659,85
2021-01-09,Marin,041,260295,11204,10634,112,10746,154
2021-01-09,Mariposa,043,17540,316,287,2,289,3
2021-01-09,Mendocino,045,87422,2917,2664,42,2706,31
2021-01-09,Merced,047,269075,22699,21357,516,21873,237
2021-01-09,Modoc,049,8938,293,271,80,351,0
2021-01-09,Mono,051,14174,1037,964,13,977,3
2021-01-09,Monterey,053,433212,34030,31948,958,32906,235
2021-01-09,Napa,055,140530,7221,6594,26,6620,36
2021-01-09,Nevada,057,99092,3190,2932,115,3047,17
2021-01-09,Orange,059,3164182,203804,191004,8202,199206,2034
2021-01-09,Placer,061,380077,17285,15609,791,16400,162
2021-01-09,Plumas,063,18699,552,477,9,486,2
2021-01-09,Riverside,065,2383286,233455,216076,10959,227035,2201
2021-01-09,Sacramento,067,1510023,77267,74482,835,75317,953
2021-01-09,San Benito,069,59416,4618,4335,44,4379,34
2021-01-09,San Bernardino,071,2135413,245451,228857,6915,235772,1714
2021-01-09,San Diego,073,3302833,207502,188598,9534,198132,1824
2021-01-09,San Francisco,075,870044,27991,26708,353,27061,235
2021-01-09,San Joaquin,077,732212,54902,51927,2125,54052,724
2021-01-09,San Luis Obispo,079,281455,15036,13647,349,13996,121
2021-01-09,San Mateo,081,765935,31529,28512,170,28682,205
2021-01-09,Santa Barbara,083,443738,23165,20971,679,21650,197
2021-01-09,Santa Clara,085,1922200,88529,82269,372,82641,808
2021-01-09,Santa Cruz,087,273765,12191,10717,503,11220,107
2021-01-09,Shasta,089,179085,9406,8893,901,9794,81
2021-01-09,Sierra,091,2930,38,32,6,38,0
2021-01-09,Siskiyou,093,43540,1187,1062,155,1217,3
2021-01-09,Solano,095,438530,23990,22226,255,22481,101
2021-01-09,Sonoma,097,501317,22807,21393,120,21513,202
2021-01-09,Stanislaus,099,539301,41015,38403,3945,42348,567
2021-01-09,Sutter,101,95872,7438,7072,54,7126,69
2021-01-09,Tehama,103,63373,3665,3451,370,3821,15
2021-01-09,Trinity,105,12862,437,252,63,315,2
2021-01-09,Tulare,107,460477,40289,37684,5035,42719,496
2021-01-09,Tuolumne,109,53932,3150,3117,26,3143,26
2021-01-09,Ventura,111,848112,56831,51988,1979,53967,306
2021-01-09,Yolo,113,214977,10376,9524,97,9621,129
2021-01-09,Yuba,115,75493,4545,4265,46,4311,27
2021-01-08,Alameda,001,1643700,63759,59172,1306,60478,646
2021-01-08,Alpine,003,1148,73,70,0,70,0
2021-01-08,Amador,005,37829,2951,2792,24,2816,24
2021-01-08,Butte,007,227075,9314,8430,1172,9602,115
2021-01-08,Calaveras,009,45235,1458,1385,7,1392,21
2021-01-08,Colusa,011,21464,1525,1448,141,1589,7
2021-01-08,Contra Costa,013,1133247,49432,45667,785,46452,381
2021-01-08,Del Norte,015,27424,841,795,2,797,2
2021-01-08,El Dorado,017,186661,7527,6690,437,7127,36
2021-01-08,Fresno,019,978130,80621,73689,5876,79565,771
2021-01-08,Glenn,021,27897,1874,1680,354,2034,9
2021-01-08,Humboldt,023,135768,2171,1988,7,1995,22
2021-01-08,Imperial,025,180216,25024,23751,2015,25766,446
2021-01-08,Inyo,027,18085,861,682,8,690,24
2021-01-08,Kern,029,883053,77639,71978,6665,78643,674
2021-01-08,Kings,031,150075,18562,17441,699,18140,108
2021-01-08,Lake,033,64148,2370,2098,0,2098,26
2021-01-08,Lassen,035,31185,4692,4598,66,4664,1
2021-01-08,Los Angeles,037,10098052,959939,871188,29896,901084,11796
2021-01-08,Madera,039,155013,12839,11846,587,12433,85
2021-01-08,Marin,041,260295,11111,10531,111,10642,153
2021-01-08,Mariposa,043,17540,315,273,2,275,3
2021-01-08,Mendocino,045,87422,2898,2634,39,2673,31
2021-01-08,Merced,047,269075,22504,20862,510,21372,236
2021-01-08,Modoc,049,8938,293,266,80,346,0
2021-01-08,Mono,051,14174,1027,951,13,964,3
2021-01-08,Monterey,053,433212,33772,31543,947,32490,224
2021-01-08,Napa,055,140530,7151,6544,26,6570,32
2021-01-08,Nevada,057,99092,3168,2888,115,3003,17
2021-01-08,Orange,059,3164182,201813,186608,8115,194723,1991
2021-01-08,Placer,061,380077,17154,15401,784,16185,161
2021-01-08,Plumas,063,18699,546,465,9,474,2
2021-01-08,Riverside,065,2383286,231055,212122,10828,222950,2184
2021-01-08,Sacramento,067,1510023,76685,73245,829,74074,939
2021-01-08,San Benito,069,59416,4580,4225,43,4268,33
2021-01-08,San Bernardino,071,2135413,243566,224267,6844,231111,1703
2021-01-08,San Diego,073,3302833,204966,185060,9440,194500,1771
2021-01-08,San Francisco,075,870044,27742,26378,329,26707,207
2021-01-08,San Joaquin,077,732212,54566,50990,2096,53086,710
2021-01-08,San Luis Obispo,079,281455,14902,13286,337,13623,119
2021-01-08,San Mateo,081,765935,31180,28072,167,28239,204
2021-01-08,Santa Barbara,083,443738,22883,20461,670,21131,189
2021-01-08,Santa Clara,085,1922200,87508,80561,369,80930,789
2021-01-08,Santa Cruz,087,273765,12050,10486,494,10980,106
2021-01-08,Shasta,089,179085,9356,8772,886,9658,81
2021-01-08,Sierra,091,2930,38,31,6,37,0
2021-01-08,Siskiyou,093,43540,1184,1027,154,1181,3
2021-01-08,Solano,095,438530,23819,21832,252,22084,100
2021-01-08,Sonoma,097,501317,22666,21178,120,21298,201
2021-01-08,Stanislaus,099,539301,40718,37858,3908,41766,566
2021-01-08,Sutter,101,95872,7388,6982,54,7036,68
2021-01-08,Tehama,103,63373,3642,3406,365,3771,15
2021-01-08,Trinity,105,12862,437,247,63,310,2
2021-01-08,Tulare,107,460477,40017,36946,4934,41880,491
2021-01-08,Tuolumne,109,53932,3142,3099,26,3125,19
2021-01-08,Ventura,111,848112,55965,50553,1955,52508,294
2021-01-08,Yolo,113,214977,10287,9391,93,9484,129
2021-01-08,Yuba,115,75493,4503,4195,45,4240,26
2021-01-07,Alameda,001,1643700,62887,57921,1279,59200,632
2021-01-07,Alpine,003,1148,71,70,0,70,0
2021-01-07,Amador,005,37829,2938,2740,23,2763,24
2021-01-07,Butte,007,227075,9217,8278,1145,9423,112
2021-01-07,Calaveras,009,45235,1441,1342,6,1348,21
2021-01-07,Colusa,011,21464,1513,1420,134,1554,7
2021-01-07,Contra Costa,013,1133247,48650,44756,768,45524,376
2021-01-07,Del Norte,015,27424,839,791,2,793,2
2021-01-07,El Dorado,017,186661,7426,6545,425,6970,36
2021-01-07,Fresno,019,978130,79664,72557,5777,78334,765
2021-01-07,Glenn,021,27897,1856,1639,342,1981,9
2021-01-07,Humboldt,023,135768,2144,1954,7,1961,22
2021-01-07,Imperial,025,180216,24832,23608,1963,25571,431
2021-01-07,Inyo,027,18085,848,656,8,664,20
2021-01-07,Kern,029,883053,76782,70953,6514,77467,660
2021-01-07,Kings,031,150075,18434,17238,690,17928,108
2021-01-07,Lake,033,64148,2315,2054,0,2054,26
2021-01-07,Lassen,035,31185,4687,4581,64,4645,1
2021-01-07,Los Angeles,037,10098052,945057,853187,29352,882539,11480
2021-01-07,Madera,039,155013,12682,11644,576,12220,76
2021-01-07,Marin,041,260295,11021,10364,109,10473,153
2021-01-07,Mariposa,043,17540,313,264,2,266,3
2021-01-07,Mendocino,045,87422,2843,2585,34,2619,30
2021-01-07,Merced,047,269075,22183,20510,495,21005,234
2021-01-07,Modoc,049,8938,293,265,80,345,0
2021-01-07,Mono,051,14174,1016,905,13,918,3
2021-01-07,Monterey,053,433212,33253,30903,922,31825,222
2021-01-07,Napa,055,140530,7041,6408,26,6434,32
2021-01-07,Nevada,057,99092,3134,2847,110,2957,17
2021-01-07,Orange,059,3164182,198971,181922,8017,189939,1974
2021-01-07,Placer,061,380077,16975,15155,755,15910,144
2021-01-07,Plumas,063,18699,544,454,9,463,2
2021-01-07,Riverside,065,2383286,227599,208177,10673,218850,2156
2021-01-07,Sacramento,067,1510023,75781,72342,808,73150,919
2021-01-07,San Benito,069,59416,4519,4112,39,4151,33
2021-01-07,San Bernardino,071,2135413,240025,219691,6762,226453,1666
2021-01-07,San Diego,073,3302833,201660,180510,9261,189771,1738
2021-01-07,San Francisco,075,870044,27409,25885,314,26199,202
2021-01-07,San Joaquin,077,732212,53881,50156,2065,52221,689
2021-01-07,San Luis Obispo,079,281455,14663,12810,324,13134,118
2021-01-07,San Mateo,081,765935,30670,27494,163,27657,201
2021-01-07,Santa Barbara,083,443738,22459,19931,657,20588,187
2021-01-07,Santa Clara,085,1922200,86293,78808,366,79174,775
2021-01-07,Santa Cruz,087,273765,11841,10228,487,10715,104
2021-01-07,Shasta,089,179085,9269,8612,878,9490,81
2021-01-07,Sierra,091,2930,38,31,6,37,0
2021-01-07,Siskiyou,093,43540,1179,1010,152,1162,3
2021-01-07,Solano,095,438530,23427,21384,248,21632,100
2021-01-07,Sonoma,097,501317,22402,20857,119,20976,200
2021-01-07,Stanislaus,099,539301,40293,37296,3857,41153,553
2021-01-07,Sutter,101,95872,7328,6890,53,6943,65
2021-01-07,Tehama,103,63373,3619,3330,358,3688,15
2021-01-07,Trinity,105,12862,437,247,63,310,2
2021-01-07,Tulare,107,460477,39616,36397,4799,41196,482
2021-01-07,Tuolumne,109,53932,3122,3068,25,3093,14
2021-01-07,Ventura,111,848112,54804,49083,1927,51010,288
2021-01-07,Yolo,113,214977,10149,9207,91,9298,128
2021-01-07,Yuba,115,75493,4461,4128,45,4173,25
2021-01-06,Alameda,001,1643700,62032,57081,1248,58329,616
2021-01-06,Alpine,003,1148,71,70,0,70,0
2021-01-06,Amador,005,37829,2917,2717,22,2739,24
2021-01-06,Butte,007,227075,9104,8147,1127,9274,110
2021-01-06,Calaveras,009,45235,1418,1321,6,1327,21
2021-01-06,Colusa,011,21464,1492,1385,129,1514,7
2021-01-06,Contra Costa,013,1133247,47844,44054,752,44806,358
2021-01-06,Del Norte,015,27424,833,780,2,782,2
2021-01-06,El Dorado,017,186661,7314,6397,412,6809,35
2021-01-06,Fresno,019,978130,78821,71404,5673,77077,752
2021-01-06,Glenn,021,27897,1830,1622,337,1959,9
2021-01-06,Humboldt,023,135768,2118,1912,7,1919,22
2021-01-06,Imperial,025,180216,24581,23400,1920,25320,431
2021-01-06,Inyo,027,18085,832,630,8,638,20
2021-01-06,Kern,029,883053,75839,69893,6383,76276,646
2021-01-06,Kings,031,150075,18236,17019,670,17689,108
2021-01-06,Lake,033,64148,2278,2033,0,2033,26
2021-01-06,Lassen,035,31185,4675,4560,60,4620,1
2021-01-06,Los Angeles,037,10098052,929122,835052,28653,863705,11285
2021-01-06,Madera,039,155013,12546,11407,570,11977,67
2021-01-06,Marin,041,260295,10892,10282,108,10390,153
2021-01-06,Mariposa,043,17540,310,259,2,261,3
2021-01-06,Mendocino,045,87422,2813,2561,34,2595,30
2021-01-06,Merced,047,269075,21845,20258,480,20738,232
2021-01-06,Modoc,049,8938,293,263,80,343,0
2021-01-06,Mono,051,14174,985,905,13,918,3
2021-01-06,Monterey,053,433212,32657,30387,889,31276,222
2021-01-06,Napa,055,140530,6911,6342,26,6368,32
2021-01-06,Nevada,057,99092,3114,2805,109,2914,15
2021-01-06,Orange,059,3164182,195516,177686,7875,185561,1935
2021-01-06,Placer,061,380077,16787,14940,737,15677,134
2021-01-06,Plumas,063,18699,536,445,9,454,2
2021-01-06,Riverside,065,2383286,223570,203714,10486,214200,2121
2021-01-06,Sacramento,067,1510023,74758,71572,791,72363,909
2021-01-06,San Benito,069,59416,4443,4031,38,4069,32
2021-01-06,San Bernardino,071,2135413,236300,215286,6654,221940,1634
2021-01-06,San Diego,073,3302833,198162,176660,9091,185751,1691
2021-01-06,San Francisco,075,870044,27038,25424,306,25730,199
2021-01-06,San Joaquin,077,732212,53122,49286,2023,51309,673
2021-01-06,San Luis Obispo,079,281455,14270,12305,317,12622,115
2021-01-06,San Mateo,081,765935,30246,27050,160,27210,200
2021-01-06,Santa Barbara,083,443738,21971,19453,647,20100,177
2021-01-06,Santa Clara,085,1922200,84886,77485,359,77844,746
2021-01-06,Santa Cruz,087,273765,11621,9954,469,10423,97
2021-01-06,Shasta,089,179085,9198,8482,871,9353,78
2021-01-06,Sierra,091,2930,37,31,6,37,0
2021-01-06,Siskiyou,093,43540,1167,998,148,1146,3
2021-01-06,Solano,095,438530,23041,21102,245,21347,99
2021-01-06,Sonoma,097,501317,22096,20558,119,20677,196
2021-01-06,Stanislaus,099,539301,39696,36751,3795,40546,553
2021-01-06,Sutter,101,95872,7246,6839,52,6891,59
2021-01-06,Tehama,103,63373,3591,3306,352,3658,15
2021-01-06,Trinity,105,12862,437,246,63,309,2
2021-01-06,Tulare,107,460477,39059,35882,4702,40584,465
2021-01-06,Tuolumne,109,53932,3102,3008,25,3033,14
2021-01-06,Ventura,111,848112,53560,47428,1903,49331,280
2021-01-06,Yolo,113,214977,9987,9083,88,9171,127
2021-01-06,Yuba,115,75493,4412,4097,45,4142,25
2021-01-05,Alameda,001,1643700,60911,56432,1213,57645,602
2021-01-05,Alpine,003,1148,71,70,0,70,0
2021-01-05,Amador,005,37829,2877,2695,22,2717,24
2021-01-05,Butte,007,227075,8964,8008,1101,9109,107
2021-01-05,Calaveras,009,45235,1372,1292,6,1298,21
2021-01-05,Colusa,011,21464,1467,1376,123,1499,7
2021-01-05,Contra Costa,013,1133247,46958,43442,741,44183,353
2021-01-05,Del Norte,015,27424,826,770,2,772,2
2021-01-05,El Dorado,017,186661,7196,6270,391,6661,32
2021-01-05,Fresno,019,978130,77598,70971,5580,76551,741
2021-01-05,Glenn,021,27897,1807,1608,324,1932,9
2021-01-05,Humboldt,023,135768,2082,1884,7,1891,22
2021-01-05,Imperial,025,180216,24408,23165,1875,25040,421
2021-01-05,Inyo,027,18085,818,627,8,635,20
2021-01-05,Kern,029,883053,74762,68257,6244,74501,624
2021-01-05,Kings,031,150075,18037,16860,647,17507,108
2021-01-05,Lake,033,64148,2231,2015,0,2015,25
2021-01-05,Lassen,035,31185,4660,4554,56,4610,1
2021-01-05,Los Angeles,037,10098052,910404,823783,27978,851761,11028
2021-01-05,Madera,039,155013,12370,11359,557,11916,67
2021-01-05,Marin,041,260295,10738,10214,106,10320,151
2021-01-05,Mariposa,043,17540,304,257,2,259,3
2021-01-05,Mendocino,045,87422,2777,2501,34,2535,30
2021-01-05,Merced,047,269075,21493,20051,469,20520,230
2021-01-05,Modoc,049,8938,293,254,80,334,0
2021-01-05,Mono,051,14174,979,896,13,909,3
2021-01-05,Monterey,053,433212,32091,30045,855,30900,213
2021-01-05,Napa,055,140530,6824,6264,26,6290,29
2021-01-05,Nevada,057,99092,3086,2781,107,2888,15
2021-01-05,Orange,059,3164182,191878,174869,7679,182548,1918
2021-01-05,Placer,061,380077,16564,14723,714,15437,133
2021-01-05,Plumas,063,18699,529,428,9,437,2
2021-01-05,Riverside,065,2383286,219437,200439,10313,210752,2069
2021-01-05,Sacramento,067,1510023,73831,70677,765,71442,888
2021-01-05,San Benito,069,59416,4341,3961,36,3997,28
2021-01-05,San Bernardino,071,2135413,232363,212522,6540,219062,1615
2021-01-05,San Diego,073,3302833,194023,172845,8877,181722,1654
2021-01-05,San Francisco,075,870044,26674,24989,288,25277,196
2021-01-05,San Joaquin,077,732212,52247,48969,1974,50943,663
2021-01-05,San Luis Obispo,079,281455,13870,12027,307,12334,106
2021-01-05,San Mateo,081,765935,29762,26486,158,26644,198
2021-01-05,Santa Barbara,083,443738,21527,19063,637,19700,172
2021-01-05,Santa Clara,085,1922200,83351,76355,346,76701,729
2021-01-05,Santa Cruz,087,273765,11348,9753,445,10198,93
2021-01-05,Shasta,089,179085,9091,8345,853,9198,73
2021-01-05,Sierra,091,2930,37,31,6,37,0
2021-01-05,Siskiyou,093,43540,1155,985,146,1131,3
2021-01-05,Solano,095,438530,22634,20860,240,21100,97
2021-01-05,Sonoma,097,501317,21734,20247,118,20365,194
2021-01-05,Stanislaus,099,539301,39153,36363,3747,40110,553
2021-01-05,Sutter,101,95872,7148,6769,51,6820,59
2021-01-05,Tehama,103,63373,3534,3255,347,3602,9
2021-01-05,Trinity,105,12862,437,246,63,309,2
2021-01-05,Tulare,107,460477,38437,35585,4555,40140,455
2021-01-05,Tuolumne,109,53932,3078,2996,20,3016,13
2021-01-05,Ventura,111,848112,52313,46456,1881,48337,264
2021-01-05,Yolo,113,214977,9811,8980,87,9067,127
2021-01-05,Yuba,115,75493,4353,4053,44,4097,21
2021-01-04,Alameda,001,1643700,59670,55899,1180,57079,583
2021-01-04,Alpine,003,1148,71,68,0,68,0
2021-01-04,Amador,005,37829,2837,2596,22,2618,24
2021-01-04,Butte,007,227075,8805,7893,1077,8970,105
2021-01-04,Calaveras,009,45235,1331,1276,5,1281,21
2021-01-04,Colusa,011,21464,1442,1368,109,1477,7
2021-01-04,Contra Costa,013,1133247,46106,43019,715,43734,353
2021-01-04,Del Norte,015,27424,817,770,2,772,2
2021-01-04,El Dorado,017,186661,7062,6152,375,6527,27
2021-01-04,Fresno,019,978130,76329,69871,5483,75354,726
2021-01-04,Glenn,021,27897,1774,1590,318,1908,9
2021-01-04,Humboldt,023,135768,2046,1845,7,1852,22
2021-01-04,Imperial,025,180216,24254,23035,1822,24857,420
2021-01-04,Inyo,027,18085,791,623,8,631,20
2021-01-04,Kern,029,883053,73677,67418,6047,73465,623
2021-01-04,Kings,031,150075,17760,16801,622,17423,108
2021-01-04,Lake,033,64148,2191,1984,0,1984,25
2021-01-04,Lassen,035,31185,4638,4550,55,4605,1
2021-01-04,Los Angeles,037,10098052,890306,813022,27104,840126,10790
2021-01-04,Madera,039,155013,12150,11204,535,11739,67
2021-01-04,Marin,041,260295,10602,10115,103,10218,151
2021-01-04,Mariposa,043,17540,298,253,2,255,3
2021-01-04,Mendocino,045,87422,2737,2460,30,2490,28
2021-01-04,Merced,047,269075,21078,19804,450,20254,230
2021-01-04,Modoc,049,8938,277,250,78,328,0
2021-01-04,Mono,051,14174,968,895,13,908,3
2021-01-04,Monterey,053,433212,31462,29659,832,30491,212
2021-01-04,Napa,055,140530,6683,6187,26,6213,29
2021-01-04,Nevada,057,99092,3048,2765,104,2869,15
2021-01-04,Orange,059,3164182,187988,172458,7552,180010,1918
2021-01-04,Placer,061,380077,16305,14622,701,15323,133
2021-01-04,Plumas,063,18699,519,419,9,428,1
2021-01-04,Riverside,065,2383286,214890,196809,10122,206931,2066
2021-01-04,Sacramento,067,1510023,72770,70164,755,70919,870
2021-01-04,San Benito,069,59416,4228,3914,36,3950,28
2021-01-04,San Bernardino,071,2135413,228132,210868,6389,217257,1615
2021-01-04,San Diego,073,3302833,189449,171031,8681,179712,1598
2021-01-04,San Francisco,075,870044,26288,24753,282,25035,191
2021-01-04,San Joaquin,077,732212,51347,48644,1933,50577,661
2021-01-04,San Luis Obispo,079,281455,13384,11945,299,12244,96
2021-01-04,San Mateo,081,765935,29198,26150,153,26303,198
2021-01-04,Santa Barbara,083,443738,21006,18735,606,19341,165
2021-01-04,Santa Clara,085,1922200,81604,75297,338,75635,727
2021-01-04,Santa Cruz,087,273765,11060,9680,428,10108,85
2021-01-04,Shasta,089,179085,8986,8224,836,9060,72
2021-01-04,Sierra,091,2930,36,30,6,36,0
2021-01-04,Siskiyou,093,43540,1138,980,143,1123,3
2021-01-04,Solano,095,438530,22131,20588,233,20821,97
2021-01-04,Sonoma,097,501317,21393,20210,117,20327,194
2021-01-04,Stanislaus,099,539301,38590,36141,3692,39833,553
2021-01-04,Sutter,101,95872,7050,6712,50,6762,56
2021-01-04,Tehama,103,63373,3460,3190,342,3532,9
2021-01-04,Trinity,105,12862,434,245,63,308,2
2021-01-04,Tulare,107,460477,37878,35060,4452,39512,455
2021-01-04,Tuolumne,109,53932,3053,2987,20,3007,13
2021-01-04,Ventura,111,848112,50812,45014,1861,46875,255
2021-01-04,Yolo,113,214977,9614,8834,81,8915,121
2021-01-04,Yuba,115,75493,4295,4023,44,4067,21
2021-01-03,Alameda,001,1643700,58418,55082,1150,56232,580
2021-01-03,Alpine,003,1148,69,68,0,68,0
2021-01-03,Amador,005,37829,2773,2565,22,2587,24
2021-01-03,Butte,007,227075,8613,7837,1024,8861,105
2021-01-03,Calaveras,009,45235,1293,1249,3,1252,21
2021-01-03,Colusa,011,21464,1413,1337,103,1440,7
2021-01-03,Contra Costa,013,1133247,45218,42432,690,43122,352
2021-01-03,Del Norte,015,27424,804,768,2,770,2
2021-01-03,El Dorado,017,186661,6934,6034,358,6392,27
2021-01-03,Fresno,019,978130,75177,69326,5363,74689,719
2021-01-03,Glenn,021,27897,1749,1581,310,1891,9
2021-01-03,Humboldt,023,135768,2009,1833,7,1840,21
2021-01-03,Imperial,025,180216,23994,22951,1743,24694,419
2021-01-03,Inyo,027,18085,774,615,8,623,20
2021-01-03,Kern,029,883053,72419,66895,5870,72765,609
2021-01-03,Kings,031,150075,17484,16593,592,17185,108
2021-01-03,Lake,033,64148,2138,1976,0,1976,24
2021-01-03,Lassen,035,31185,4605,4531,54,4585,1
2021-01-03,Los Angeles,037,10098052,868320,792168,26037,818205,10633
2021-01-03,Madera,039,155013,11928,11152,512,11664,67
2021-01-03,Marin,041,260295,10453,10034,98,10132,150
2021-01-03,Mariposa,043,17540,291,248,2,250,3
2021-01-03,Mendocino,045,87422,2697,2445,29,2474,24
2021-01-03,Merced,047,269075,20611,19600,424,20024,230
2021-01-03,Modoc,049,8938,273,245,77,322,0
2021-01-03,Mono,051,14174,943,893,13,906,3
2021-01-03,Monterey,053,433212,30882,29357,798,30155,191
2021-01-03,Napa,055,140530,6582,6094,26,6120,29
2021-01-03,Nevada,057,99092,2987,2742,101,2843,15
2021-01-03,Orange,059,3164182,183798,169881,7359,177240,1919
2021-01-03,Placer,061,380077,16056,14319,677,14996,133
2021-01-03,Plumas,063,18699,506,416,9,425,1
2021-01-03,Riverside,065,2383286,210019,195048,9875,204923,2005
2021-01-03,Sacramento,067,1510023,71563,68558,734,69292,859
2021-01-03,San Benito,069,59416,4131,3882,35,3917,28
2021-01-03,San Bernardino,071,2135413,222867,208294,6216,214510,1592
2021-01-03,San Diego,073,3302833,184189,168018,8453,176471,1592
2021-01-03,San Francisco,075,870044,25791,24588,265,24853,193
2021-01-03,San Joaquin,077,732212,50221,47899,1875,49774,661
2021-01-03,San Luis Obispo,079,281455,12914,11636,290,11926,95
2021-01-03,San Mateo,081,765935,28605,25770,146,25916,196
2021-01-03,Santa Barbara,083,443738,20275,18267,589,18856,164
2021-01-03,Santa Clara,085,1922200,80052,74534,332,74866,720
2021-01-03,Santa Cruz,087,273765,10756,9528,412,9940,84
2021-01-03,Shasta,089,179085,8860,8192,796,8988,72
2021-01-03,Sierra,091,2930,36,30,6,36,0
2021-01-03,Siskiyou,093,43540,1105,976,134,1110,3
2021-01-03,Solano,095,438530,21599,20105,227,20332,97
2021-01-03,Sonoma,097,501317,21005,19982,113,20095,193
2021-01-03,Stanislaus,099,539301,37899,35762,3610,39372,553
2021-01-03,Sutter,101,95872,6953,6664,49,6713,53
2021-01-03,Tehama,103,63373,3404,3176,334,3510,9
2021-01-03,Trinity,105,12862,429,243,61,304,2
2021-01-03,Tulare,107,460477,37316,34747,4304,39051,455
2021-01-03,Tuolumne,109,53932,2993,2978,17,2995,13
2021-01-03,Ventura,111,848112,48989,43748,1843,45591,254
2021-01-03,Yolo,113,214977,9456,8674,77,8751,121
2021-01-03,Yuba,115,75493,4241,3966,43,4009,20
2021-01-02,Alameda,001,1643700,57789,54518,1121,55639,581
2021-01-02,Alpine,003,1148,69,68,0,68,0
2021-01-02,Amador,005,37829,2754,2540,22,2562,24
2021-01-02,Butte,007,227075,8506,7750,1005,8755,105
2021-01-02,Calaveras,009,45235,1273,1230,3,1233,21
2021-01-02,Colusa,011,21464,1403,1332,102,1434,7
2021-01-02,Contra Costa,013,1133247,44696,41993,679,42672,352
2021-01-02,Del Norte,015,27424,802,764,2,766,2
2021-01-02,El Dorado,017,186661,6879,5959,354,6313,27
2021-01-02,Fresno,019,978130,74634,68740,5253,73993,717
2021-01-02,Glenn,021,27897,1732,1546,309,1855,9
2021-01-02,Humboldt,023,135768,1982,1815,7,1822,21
2021-01-02,Imperial,025,180216,23913,22867,1706,24573,420
2021-01-02,Inyo,027,18085,761,609,8,617,20
2021-01-02,Kern,029,883053,71699,66457,5758,72215,610
2021-01-02,Kings,031,150075,17390,16515,588,17103,108
2021-01-02,Lake,033,64148,2100,1925,0,1925,24
2021-01-02,Lassen,035,31185,4594,4457,53,4510,1
2021-01-02,Los Angeles,037,10098052,859960,791892,25337,817229,10633
2021-01-02,Madera,039,155013,11817,11039,501,11540,67
2021-01-02,Marin,041,260295,10407,9924,95,10019,151
2021-01-02,Mariposa,043,17540,284,243,2,245,3
2021-01-02,Mendocino,045,87422,2654,2428,28,2456,24
2021-01-02,Merced,047,269075,20469,19395,408,19803,230
2021-01-02,Modoc,049,8938,272,245,77,322,0
2021-01-02,Mono,051,14174,932,884,13,897,3
2021-01-02,Monterey,053,433212,30679,28991,787,29778,191
2021-01-02,Napa,055,140530,6523,5994,26,6020,29
2021-01-02,Nevada,057,99092,2958,2706,97,2803,15
2021-01-02,Orange,059,3164182,181594,168457,7210,175667,1918
2021-01-02,Placer,061,380077,15883,14182,668,14850,133
2021-01-02,Plumas,063,18699,503,413,9,422,1
2021-01-02,Riverside,065,2383286,207383,192069,9650,201719,2008
2021-01-02,Sacramento,067,1510023,70923,67810,717,68527,858
2021-01-02,San Benito,069,59416,4048,3829,35,3864,28
2021-01-02,San Bernardino,071,2135413,221246,206939,6091,213030,1597
2021-01-02,San Diego,073,3302833,181590,164498,8256,172754,1592
2021-01-02,San Francisco,075,870044,25532,24414,258,24672,194
2021-01-02,San Joaquin,077,732212,49843,47310,1845,49155,662
2021-01-02,San Luis Obispo,079,281455,12778,11467,284,11751,95
2021-01-02,San Mateo,081,765935,28269,25483,138,25621,196
2021-01-02,Santa Barbara,083,443738,19986,18135,586,18721,164
2021-01-02,Santa Clara,085,1922200,78888,73662,325,73987,720
2021-01-02,Santa Cruz,087,273765,10601,9340,403,9743,85
2021-01-02,Shasta,089,179085,8794,8154,785,8939,72
2021-01-02,Sierra,091,2930,36,28,6,34,0
2021-01-02,Siskiyou,093,43540,1094,949,132,1081,3
2021-01-02,Solano,095,438530,21403,19805,217,20022,97
2021-01-02,Sonoma,097,501317,20839,19761,113,19874,194
2021-01-02,Stanislaus,099,539301,37582,35431,3545,38976,553
2021-01-02,Sutter,101,95872,6900,6621,49,6670,53
2021-01-02,Tehama,103,63373,3378,3146,330,3476,9
2021-01-02,Trinity,105,12862,426,243,61,304,2
2021-01-02,Tulare,107,460477,36999,34479,4229,38708,455
2021-01-02,Tuolumne,109,53932,2979,2942,15,2957,13
2021-01-02,Ventura,111,848112,47835,43397,1808,45205,254
2021-01-02,Yolo,113,214977,9360,8571,75,8646,122
2021-01-02,Yuba,115,75493,4202,3930,42,3972,21
2021-01-01,Alameda,001,1643700,57128,53518,1105,54623,579
2021-01-01,Alpine,003,1148,69,68,0,68,0
2021-01-01,Amador,005,37829,2728,2513,20,2533,24
2021-01-01,Butte,007,227075,8405,7589,980,8569,105
2021-01-01,Calaveras,009,45235,1258,1186,3,1189,21
2021-01-01,Colusa,011,21464,1394,1314,100,1414,7
2021-01-01,Contra Costa,013,1133247,44214,41412,660,42072,351
2021-01-01,Del Norte,015,27424,796,758,2,760,2
2021-01-01,El Dorado,017,186661,6787,5832,346,6178,27
2021-01-01,Fresno,019,978130,73561,67484,5167,72651,717
2021-01-01,Glenn,021,27897,1715,1520,303,1823,9
2021-01-01,Humboldt,023,135768,1943,1783,7,1790,21
2021-01-01,Imperial,025,180216,23827,22715,1655,24370,418
2021-01-01,Inyo,027,18085,737,606,8,614,20
2021-01-01,Kern,029,883053,70873,65571,5650,71221,609
2021-01-01,Kings,031,150075,17207,16358,581,16939,108
2021-01-01,Lake,033,64148,2068,1888,0,1888,24
2021-01-01,Lassen,035,31185,4588,4377,53,4430,1
2021-01-01,Los Angeles,037,10098052,845781,775578,24634,800212,10515
2021-01-01,Madera,039,155013,11657,10752,492,11244,66
2021-01-01,Marin,041,260295,10301,9821,95,9916,148
2021-01-01,Mariposa,043,17540,276,236,2,238,3
2021-01-01,Mendocino,045,87422,2600,2400,28,2428,24
2021-01-01,Merced,047,269075,20285,19118,392,19510,229
2021-01-01,Modoc,049,8938,272,241,77,318,0
2021-01-01,Mono,051,14174,914,884,12,896,3
2021-01-01,Monterey,053,433212,30455,28465,779,29244,191
2021-01-01,Napa,055,140530,6437,5899,26,5925,28
2021-01-01,Nevada,057,99092,2934,2663,97,2760,15
2021-01-01,Orange,059,3164182,178796,165440,7066,172506,1893
2021-01-01,Placer,061,380077,15693,13987,652,14639,133
2021-01-01,Plumas,063,18699,498,412,9,421,1
2021-01-01,Riverside,065,2383286,204204,188674,9394,198068,1990
2021-01-01,Sacramento,067,1510023,70325,66956,700,67656,848
2021-01-01,San Benito,069,59416,4010,3773,35,3808,28
2021-01-01,San Bernardino,071,2135413,218441,203651,5959,209610,1590
2021-01-01,San Diego,073,3302833,178517,160071,8077,168148,1592
2021-01-01,San Francisco,075,870044,25257,24145,247,24392,187
2021-01-01,San Joaquin,077,732212,49556,46640,1799,48439,657
2021-01-01,San Luis Obispo,079,281455,12550,11160,276,11436,94
2021-01-01,San Mateo,081,765935,27821,25041,134,25175,194
2021-01-01,Santa Barbara,083,443738,19666,17759,576,18335,164
2021-01-01,Santa Clara,085,1922200,77625,71904,320,72224,680
2021-01-01,Santa Cruz,087,273765,10421,9146,393,9539,84
2021-01-01,Shasta,089,179085,8713,8102,768,8870,72
2021-01-01,Sierra,091,2930,36,26,6,32,0
2021-01-01,Siskiyou,093,43540,1080,944,127,1071,3
2021-01-01,Solano,095,438530,21191,19393,215,19608,97
2021-01-01,Sonoma,097,501317,20648,19513,113,19626,189
2021-01-01,Stanislaus,099,539301,37299,34978,3479,38457,553
2021-01-01,Sutter,101,95872,6843,6553,48,6601,52
2021-01-01,Tehama,103,63373,3320,3079,324,3403,9
2021-01-01,Trinity,105,12862,426,243,61,304,2
2021-01-01,Tulare,107,460477,36595,33994,4134,38128,454
2021-01-01,Tuolumne,109,53932,2963,2909,15,2924,13
2021-01-01,Ventura,111,848112,46342,42026,1781,43807,253
2021-01-01,Yolo,113,214977,9250,8461,72,8533,120
2021-01-01,Yuba,115,75493,4148,3845,41,3886,19
2020-12-31,Alameda,001,1643700,56586,52475,1074,53549,579
2020-12-31,Alpine,003,1148,69,66,0,66,0
2020-12-31,Amador,005,37829,2714,2493,20,2513,24
2020-12-31,Butte,007,227075,8331,7405,961,8366,105
2020-12-31,Calaveras,009,45235,1247,1161,3,1164,21
2020-12-31,Colusa,011,21464,1386,1301,97,1398,7
2020-12-31,Contra Costa,013,1133247,43836,40512,645,41157,336
2020-12-31,Del Norte,015,27424,795,748,2,750,2
2020-12-31,El Dorado,017,186661,6735,5662,337,5999,26
2020-12-31,Fresno,019,978130,73128,66442,5104,71546,711
2020-12-31,Glenn,021,27897,1689,1484,295,1779,9
2020-12-31,Humboldt,023,135768,1926,1713,7,1720,21
2020-12-31,Imperial,025,180216,23762,22494,1639,24133,417
2020-12-31,Inyo,027,18085,729,591,8,599,20
2020-12-31,Kern,029,883053,70403,64904,5558,70462,609
2020-12-31,Kings,031,150075,17132,16077,573,16650,108
2020-12-31,Lake,033,64148,2055,1848,0,1848,23
2020-12-31,Lassen,035,31185,4582,4340,52,4392,1
2020-12-31,Los Angeles,037,10098052,840456,755844,24166,780010,10320
2020-12-31,Madera,039,155013,11584,10609,484,11093,64
2020-12-31,Marin,041,260295,10258,9731,94,9825,148
2020-12-31,Mariposa,043,17540,274,217,2,219,3
2020-12-31,Mendocino,045,87422,2585,2367,24,2391,24
2020-12-31,Merced,047,269075,20195,18808,383,19191,226
2020-12-31,Modoc,049,8938,272,238,77,315,0
2020-12-31,Mono,051,14174,906,868,12,880,3
2020-12-31,Monterey,053,433212,30253,27720,767,28487,188
2020-12-31,Napa,055,140530,6374,5801,26,5827,28
2020-12-31,Nevada,057,99092,2911,2619,95,2714,15
2020-12-31,Orange,059,3164182,176915,161586,6933,168519,1866
2020-12-31,Placer,061,380077,15537,13708,649,14357,126
2020-12-31,Plumas,063,18699,493,401,8,409,1
2020-12-31,Riverside,065,2383286,202543,184193,9261,193454,1958
2020-12-31,Sacramento,067,1510023,69805,65817,689,66506,830
2020-12-31,San Benito,069,59416,3987,3673,35,3708,28
2020-12-31,San Bernardino,071,2135413,216853,199115,5889,205004,1586
2020-12-31,San Diego,073,3302833,176754,155593,7978,163571,1534
2020-12-31,San Francisco,075,870044,25029,23740,240,23980,183
2020-12-31,San Joaquin,077,732212,49244,45764,1761,47525,646
2020-12-31,San Luis Obispo,079,281455,12436,10846,276,11122,89
2020-12-31,San Mateo,081,765935,27492,24570,128,24698,192
2020-12-31,Santa Barbara,083,443738,19422,17434,569,18003,161
2020-12-31,Santa Clara,085,1922200,76843,70032,315,70347,665
2020-12-31,Santa Cruz,087,273765,10303,8909,381,9290,84
2020-12-31,Shasta,089,179085,8647,7996,758,8754,69
2020-12-31,Sierra,091,2930,36,26,6,32,0
2020-12-31,Siskiyou,093,43540,1064,940,124,1064,3
2020-12-31,Solano,095,438530,20962,18942,214,19156,97
2020-12-31,Sonoma,097,501317,20528,19129,112,19241,188
2020-12-31,Stanislaus,099,539301,37002,34398,3426,37824,552
2020-12-31,Sutter,101,95872,6812,6432,48,6480,51
2020-12-31,Tehama,103,63373,3288,3036,323,3359,9
2020-12-31,Trinity,105,12862,425,241,61,302,2
2020-12-31,Tulare,107,460477,36427,33412,4071,37483,446
2020-12-31,Tuolumne,109,53932,2954,2902,15,2917,12
2020-12-31,Ventura,111,848112,45832,40854,1764,42618,251
2020-12-31,Yolo,113,214977,9165,8295,71,8366,117
2020-12-31,Yuba,115,75493,4107,3799,40,3839,18
2020-12-30,Alameda,001,1643700,55823,50158,1023,51181,573
2020-12-30,Alpine,003,1148,69,66,0,66,0
2020-12-30,Amador,005,37829,2694,2418,19,2437,24
2020-12-30,Butte,007,227075,8170,7140,944,8084,103
2020-12-30,Calaveras,009,45235,1222,1135,3,1138,21
2020-12-30,Colusa,011,21464,1370,1289,91,1380,7
2020-12-30,Contra Costa,013,1133247,43253,39601,633,40234,337
2020-12-30,Del Norte,015,27424,790,726,2,728,2
2020-12-30,El Dorado,017,186661,6634,5595,327,5922,27
2020-12-30,Fresno,019,978130,72281,65566,4950,70516,711
2020-12-30,Glenn,021,27897,1658,1471,282,1753,9
2020-12-30,Humboldt,023,135768,1892,1654,7,1661,22
2020-12-30,Imperial,025,180216,23595,22098,1563,23661,412
2020-12-30,Inyo,027,18085,722,572,8,580,20
2020-12-30,Kern,029,883053,69675,63292,5414,68706,604
2020-12-30,Kings,031,150075,17013,15862,565,16427,108
2020-12-30,Lake,033,64148,2032,1731,0,1731,23
2020-12-30,Lassen,035,31185,4573,4300,52,4352,1
2020-12-30,Los Angeles,037,10098052,829566,741907,23468,765375,10046
2020-12-30,Madera,039,155013,11474,10249,473,10722,65
2020-12-30,Marin,041,260295,10168,9569,87,9656,148
2020-12-30,Mariposa,043,17540,270,214,2,216,3
2020-12-30,Mendocino,045,87422,2567,2291,21,2312,24
2020-12-30,Merced,047,269075,19904,18519,373,18892,225
2020-12-30,Modoc,049,8938,269,234,77,311,0
2020-12-30,Mono,051,14174,903,868,12,880,3
2020-12-30,Monterey,053,433212,29623,26977,745,27722,186
2020-12-30,Napa,055,140530,6268,5754,26,5780,28
2020-12-30,Nevada,057,99092,2876,2595,93,2688,15
2020-12-30,Orange,059,3164182,174259,153951,6743,160694,1863
2020-12-30,Placer,061,380077,15307,13540,637,14177,127
2020-12-30,Plumas,063,18699,488,397,8,405,1
2020-12-30,Riverside,065,2383286,199593,176402,9076,185478,1919
2020-12-30,Sacramento,067,1510023,68941,64119,671,64790,847
2020-12-30,San Benito,069,59416,3906,3464,31,3495,29
2020-12-30,San Bernardino,071,2135413,214287,192648,5803,198451,1591
2020-12-30,San Diego,073,3302833,173121,152510,7803,160313,1472
2020-12-30,San Francisco,075,870044,24736,23099,235,23334,182
2020-12-30,San Joaquin,077,732212,48552,44465,1719,46184,634
2020-12-30,San Luis Obispo,079,281455,12168,10542,268,10810,89
2020-12-30,San Mateo,081,765935,27063,24150,124,24274,190
2020-12-30,Santa Barbara,083,443738,19022,16895,547,17442,161
2020-12-30,Santa Clara,085,1922200,75586,67218,311,67529,661
2020-12-30,Santa Cruz,087,273765,10107,8787,372,9159,86
2020-12-30,Shasta,089,179085,8533,7818,744,8562,69
2020-12-30,Sierra,091,2930,36,25,6,31,0
2020-12-30,Siskiyou,093,43540,1057,913,115,1028,3
2020-12-30,Solano,095,438530,20570,18300,211,18511,96
2020-12-30,Sonoma,097,501317,20270,18947,112,19059,191
2020-12-30,Stanislaus,099,539301,36532,33730,3352,37082,526
2020-12-30,Sutter,101,95872,6749,6328,46,6374,51
2020-12-30,Tehama,103,63373,3244,2969,319,3288,9
2020-12-30,Trinity,105,12862,424,231,60,291,2
2020-12-30,Tulare,107,460477,35877,32413,4006,36419,430
2020-12-30,Tuolumne,109,53932,2944,2772,13,2785,12
2020-12-30,Ventura,111,848112,44544,39039,1740,40779,251
2020-12-30,Yolo,113,214977,9057,8067,69,8136,117
2020-12-30,Yuba,115,75493,4036,3612,40,3652,18
2020-12-29,Alameda,001,1643700,54762,50946,988,51934,552
2020-12-29,Alpine,003,1148,69,65,0,65,0
2020-12-29,Amador,005,37829,2642,2388,18,2406,23
2020-12-29,Butte,007,227075,7997,7178,922,8100,98
2020-12-29,Calaveras,009,45235,1177,1111,2,1113,21
2020-12-29,Colusa,011,21464,1349,1272,86,1358,7
2020-12-29,Contra Costa,013,1133247,42450,39225,602,39827,325
2020-12-29,Del Norte,015,27424,783,724,2,726,2
2020-12-29,El Dorado,017,186661,6505,5551,314,5865,22
2020-12-29,Fresno,019,978130,70905,65149,4794,69943,688
2020-12-29,Glenn,021,27897,1624,1454,275,1729,9
2020-12-29,Humboldt,023,135768,1845,1616,7,1623,19
2020-12-29,Imperial,025,180216,23384,22105,1477,23582,407
2020-12-29,Inyo,027,18085,705,571,8,579,19
2020-12-29,Kern,029,883053,68507,63096,5243,68339,589
2020-12-29,Kings,031,150075,16844,15777,553,16330,108
2020-12-29,Lake,033,64148,2000,1805,0,1805,22
2020-12-29,Lassen,035,31185,4558,4288,52,4340,1
2020-12-29,Los Angeles,037,10098052,809385,731907,22603,754510,9786
2020-12-29,Madera,039,155013,11161,10251,458,10709,64
2020-12-29,Marin,041,260295,10016,9595,84,9679,146
2020-12-29,Mariposa,043,17540,262,212,2,214,3
2020-12-29,Mendocino,045,87422,2524,2249,20,2269,24
2020-12-29,Merced,047,269075,19554,18464,358,18822,221
2020-12-29,Modoc,049,8938,266,232,77,309,0
2020-12-29,Mono,051,14174,894,868,12,880,3
2020-12-29,Monterey,053,433212,28971,26894,718,27612,185
2020-12-29,Napa,055,140530,6149,5663,26,5689,28
2020-12-29,Nevada,057,99092,2828,2550,92,2642,15
2020-12-29,Orange,059,3164182,170464,154411,6575,160986,1839
2020-12-29,Placer,061,380077,15096,13392,615,14007,126
2020-12-29,Plumas,063,18699,479,395,8,403,1
2020-12-29,Riverside,065,2383286,194990,177624,8822,186446,1904
2020-12-29,Sacramento,067,1510023,67895,65078,657,65735,820
2020-12-29,San Benito,069,59416,3787,3474,30,3504,25
2020-12-29,San Bernardino,071,2135413,209467,190476,5666,196142,1557
2020-12-29,San Diego,073,3302833,168898,150062,7572,157634,1435
2020-12-29,San Francisco,075,870044,24397,22996,227,23223,178
2020-12-29,San Joaquin,077,732212,47630,44699,1664,46363,622
2020-12-29,San Luis Obispo,079,281455,11872,10387,260,10647,80
2020-12-29,San Mateo,081,765935,26521,23773,112,23885,189
2020-12-29,Santa Barbara,083,443738,18553,16797,521,17318,155
2020-12-29,Santa Clara,085,1922200,74035,67581,308,67889,621
2020-12-29,Santa Cruz,087,273765,9837,8492,363,8855,84
2020-12-29,Shasta,089,179085,8429,7782,729,8511,65
2020-12-29,Sierra,091,2930,34,24,5,29,0
2020-12-29,Siskiyou,093,43540,1042,926,113,1039,3
2020-12-29,Solano,095,438530,20188,18412,206,18618,96
2020-12-29,Sonoma,097,501317,19934,18790,110,18900,187
2020-12-29,Stanislaus,099,539301,36041,33775,3289,37064,508
2020-12-29,Sutter,101,95872,6681,6302,46,6348,50
2020-12-29,Tehama,103,63373,3174,2962,305,3267,9
2020-12-29,Trinity,105,12862,423,241,60,301,2
2020-12-29,Tulare,107,460477,35217,32545,3873,36418,419
2020-12-29,Tuolumne,109,53932,2903,2797,13,2810,12
2020-12-29,Ventura,111,848112,43290,38669,1714,40383,235
2020-12-29,Yolo,113,214977,8928,8124,67,8191,111
2020-12-29,Yuba,115,75493,3954,3723,40,3763,18
2020-12-28,Alameda,001,1643700,53729,50405,967,51372,551
2020-12-28,Alpine,003,1148,68,65,0,65,0
2020-12-28,Amador,005,37829,2572,2255,18,2273,23
2020-12-28,Butte,007,227075,7830,7053,892,7945,86
2020-12-28,Calaveras,009,45235,1154,1102,2,1104,21
2020-12-28,Colusa,011,21464,1324,1255,72,1327,7
2020-12-28,Contra Costa,013,1133247,41512,38872,575,39447,324
2020-12-28,Del Norte,015,27424,773,718,2,720,2
2020-12-28,El Dorado,017,186661,6349,5441,302,5743,18
2020-12-28,Fresno,019,978130,69633,64274,4643,68917,679
2020-12-28,Glenn,021,27897,1590,1435,263,1698,9
2020-12-28,Humboldt,023,135768,1810,1579,7,1586,19
2020-12-28,Imperial,025,180216,23125,22003,1404,23407,405
2020-12-28,Inyo,027,18085,698,569,8,577,19
2020-12-28,Kern,029,883053,67439,62392,5039,67431,579
2020-12-28,Kings,031,150075,16627,15733,536,16269,108
2020-12-28,Lake,033,64148,1959,1785,0,1785,22
2020-12-28,Lassen,035,31185,4451,4284,51,4335,1
2020-12-28,Los Angeles,037,10098052,787047,720699,21789,742488,9544
2020-12-28,Madera,039,155013,10987,10123,435,10558,64
2020-12-28,Marin,041,260295,9908,9546,78,9624,145
2020-12-28,Mariposa,043,17540,238,211,2,213,3
2020-12-28,Mendocino,045,87422,2489,2214,20,2234,23
2020-12-28,Merced,047,269075,19234,18245,340,18585,213
2020-12-28,Modoc,049,8938,261,220,76,296,0
2020-12-28,Mono,051,14174,890,848,12,860,3
2020-12-28,Monterey,053,433212,28122,26529,707,27236,182
2020-12-28,Napa,055,140530,6040,5576,26,5602,26
2020-12-28,Nevada,057,99092,2780,2532,88,2620,15
2020-12-28,Orange,059,3164182,166359,152089,6397,158486,1839
2020-12-28,Placer,061,380077,14757,13234,588,13822,126
2020-12-28,Plumas,063,18699,475,391,8,399,0
2020-12-28,Riverside,065,2383286,190089,174029,8531,182560,1855
2020-12-28,Sacramento,067,1510023,66662,64322,632,64954,813
2020-12-28,San Benito,069,59416,3718,3429,29,3458,24
2020-12-28,San Bernardino,071,2135413,204372,188919,5549,194468,1552
2020-12-28,San Diego,073,3302833,164154,147528,7390,154918,1404
2020-12-28,San Francisco,075,870044,24037,22726,222,22948,178
2020-12-28,San Joaquin,077,732212,46696,44172,1632,45804,618
2020-12-28,San Luis Obispo,079,281455,11519,10260,256,10516,76
2020-12-28,San Mateo,081,765935,26046,23467,108,23575,189
2020-12-28,Santa Barbara,083,443738,18085,16579,509,17088,155
2020-12-28,Santa Clara,085,1922200,72548,66418,301,66719,619
2020-12-28,Santa Cruz,087,273765,9569,8310,353,8663,81
2020-12-28,Shasta,089,179085,8312,7688,716,8404,65
2020-12-28,Sierra,091,2930,32,24,5,29,0
2020-12-28,Siskiyou,093,43540,1026,915,108,1023,3
2020-12-28,Solano,095,438530,19616,18171,200,18371,96
2020-12-28,Sonoma,097,501317,19586,18667,108,18775,185
2020-12-28,Stanislaus,099,539301,35498,33473,3225,36698,507
2020-12-28,Sutter,101,95872,6598,6253,46,6299,49
2020-12-28,Tehama,103,63373,3121,2934,295,3229,9
2020-12-28,Trinity,105,12862,421,240,60,300,2
2020-12-28,Tulare,107,460477,34532,32010,3765,35775,404
2020-12-28,Tuolumne,109,53932,2886,2777,13,2790,12
2020-12-28,Ventura,111,848112,41621,37151,1667,38818,230
2020-12-28,Yolo,113,214977,8773,8031,66,8097,111
2020-12-28,Yuba,115,75493,3893,3679,39,3718,18
2020-12-27,Alameda,001,1643700,52489,49764,941,50705,551
2020-12-27,Alpine,003,1148,66,65,0,65,0
2020-12-27,Amador,005,37829,2451,2218,18,2236,23
2020-12-27,Butte,007,227075,7675,7016,857,7873,86
2020-12-27,Calaveras,009,45235,1107,1097,2,1099,21
2020-12-27,Colusa,011,21464,1299,1253,69,1322,7
2020-12-27,Contra Costa,013,1133247,40580,38428,546,38974,324
2020-12-27,Del Norte,015,27424,750,712,2,714,2
2020-12-27,El Dorado,017,186661,6135,5388,279,5667,18
2020-12-27,Fresno,019,978130,68385,63811,4436,68247,679
2020-12-27,Glenn,021,27897,1562,1434,249,1683,9
2020-12-27,Humboldt,023,135768,1766,1575,7,1582,17
2020-12-27,Imperial,025,180216,22829,21934,1291,23225,405
2020-12-27,Inyo,027,18085,676,565,7,572,18
2020-12-27,Kern,029,883053,66160,61914,4866,66780,568
2020-12-27,Kings,031,150075,16391,15593,502,16095,108
2020-12-27,Lake,033,64148,1903,1769,0,1769,22
2020-12-27,Lassen,035,31185,4374,4230,44,4274,1
2020-12-27,Los Angeles,037,10098052,765571,707260,20895,728155,9476
2020-12-27,Madera,039,155013,10729,10005,425,10430,64
2020-12-27,Marin,041,260295,9785,9477,72,9549,144
2020-12-27,Mariposa,043,17540,231,208,2,210,3
2020-12-27,Mendocino,045,87422,2442,2209,20,2229,23
2020-12-27,Merced,047,269075,18866,18075,324,18399,213
2020-12-27,Modoc,049,8938,252,221,72,293,0
2020-12-27,Mono,051,14174,877,849,12,861,3
2020-12-27,Monterey,053,433212,27564,26322,690,27012,181
2020-12-27,Napa,055,140530,5906,5496,26,5522,26
2020-12-27,Nevada,057,99092,2744,2519,88,2607,15
2020-12-27,Orange,059,3164182,161961,149276,6209,155485,1839
2020-12-27,Placer,061,380077,14461,13017,556,13573,126
2020-12-27,Plumas,063,18699,469,390,8,398,0
2020-12-27,Riverside,065,2383286,185172,171995,8225,180220,1836
2020-12-27,Sacramento,067,1510023,65457,63416,609,64025,811
2020-12-27,San Benito,069,59416,3632,3394,29,3423,24
2020-12-27,San Bernardino,071,2135413,199299,186776,5412,192188,1551
2020-12-27,San Diego,073,3302833,159747,145777,7203,152980,1402
2020-12-27,San Francisco,075,870044,23690,22514,213,22727,178
2020-12-27,San Joaquin,077,732212,45660,43529,1582,45111,618
2020-12-27,San Luis Obispo,079,281455,11111,10154,251,10405,76
2020-12-27,San Mateo,081,765935,25482,23136,104,23240,187
2020-12-27,Santa Barbara,083,443738,17559,16364,482,16846,155
2020-12-27,Santa Clara,085,1922200,70925,65288,296,65584,619
2020-12-27,Santa Cruz,087,273765,9303,8234,344,8578,81
2020-12-27,Shasta,089,179085,8186,7671,694,8365,65
2020-12-27,Sierra,091,2930,32,24,4,28,0
2020-12-27,Siskiyou,093,43540,1016,914,103,1017,3
2020-12-27,Solano,095,438530,19121,17840,194,18034,96
2020-12-27,Sonoma,097,501317,19294,18487,107,18594,185
2020-12-27,Stanislaus,099,539301,34888,33076,3132,36208,506
2020-12-27,Sutter,101,95872,6516,6218,44,6262,48
2020-12-27,Tehama,103,63373,3052,2922,278,3200,9
2020-12-27,Trinity,105,12862,414,240,58,298,2
2020-12-27,Tulare,107,460477,33935,31864,3646,35510,400
2020-12-27,Tuolumne,109,53932,2780,2750,11,2761,12
2020-12-27,Ventura,111,848112,40558,36661,1614,38275,230
2020-12-27,Yolo,113,214977,8582,7919,61,7980,111
2020-12-27,Yuba,115,75493,3829,3665,37,3702,18
2020-12-26,Alameda,001,1643700,51879,49084,928,50012,551
2020-12-26,Alpine,003,1148,66,65,0,65,0
2020-12-26,Amador,005,37829,2437,2189,18,2207,23
2020-12-26,Butte,007,227075,7580,6968,834,7802,86
2020-12-26,Calaveras,009,45235,1101,1084,2,1086,21
2020-12-26,Colusa,011,21464,1289,1240,69,1309,7
2020-12-26,Contra Costa,013,1133247,40116,38008,532,38540,324
2020-12-26,Del Norte,015,27424,744,709,2,711,2
2020-12-26,El Dorado,017,186661,6080,5279,275,5554,18
2020-12-26,Fresno,019,978130,67915,63080,4372,67452,679
2020-12-26,Glenn,021,27897,1541,1413,243,1656,9
2020-12-26,Humboldt,023,135768,1728,1545,7,1552,17
2020-12-26,Imperial,025,180216,22738,21734,1239,22973,405
2020-12-26,Inyo,027,18085,663,554,7,561,18
2020-12-26,Kern,029,883053,65488,61174,4717,65891,564
2020-12-26,Kings,031,150075,16273,15517,498,16015,108
2020-12-26,Lake,033,64148,1861,1710,0,1710,22
2020-12-26,Lassen,035,31185,4353,3981,44,4025,1
2020-12-26,Los Angeles,037,10098052,757020,694149,20391,714540,9424
2020-12-26,Madera,039,155013,10652,9908,413,10321,64
2020-12-26,Marin,041,260295,9750,9413,71,9484,143
2020-12-26,Mariposa,043,17540,230,206,2,208,3
2020-12-26,Mendocino,045,87422,2396,2194,20,2214,23
2020-12-26,Merced,047,269075,18707,17890,319,18209,213
2020-12-26,Modoc,049,8938,249,222,72,294,0
2020-12-26,Mono,051,14174,871,850,12,862,3
2020-12-26,Monterey,053,433212,27427,26010,681,26691,182
2020-12-26,Napa,055,140530,5848,5427,26,5453,26
2020-12-26,Nevada,057,99092,2716,2480,88,2568,15
2020-12-26,Orange,059,3164182,159756,147304,6116,153420,1838
2020-12-26,Placer,061,380077,14291,12816,541,13357,122
2020-12-26,Plumas,063,18699,466,381,8,389,0
2020-12-26,Riverside,065,2383286,182685,169360,8064,177424,1834
2020-12-26,Sacramento,067,1510023,64834,62435,599,63034,807
2020-12-26,San Benito,069,59416,3559,3330,29,3359,24
2020-12-26,San Bernardino,071,2135413,197633,185111,5330,190441,1551
2020-12-26,San Diego,073,3302833,157222,142644,7056,149700,1402
2020-12-26,San Francisco,075,870044,23455,22319,213,22532,177
2020-12-26,San Joaquin,077,732212,45275,42887,1533,44420,618
2020-12-26,San Luis Obispo,079,281455,11024,9945,246,10191,76
2020-12-26,San Mateo,081,765935,25143,22908,99,23007,187
2020-12-26,Santa Barbara,083,443738,17320,16159,476,16635,155
2020-12-26,Santa Clara,085,1922200,69856,64185,294,64479,618
2020-12-26,Santa Cruz,087,273765,9177,8113,335,8448,81
2020-12-26,Shasta,089,179085,8127,7641,681,8322,65
2020-12-26,Sierra,091,2930,32,24,4,28,0
2020-12-26,Siskiyou,093,43540,1009,909,99,1008,2
2020-12-26,Solano,095,438530,18876,17528,194,17722,96
2020-12-26,Sonoma,097,501317,19092,18261,105,18366,184
2020-12-26,Stanislaus,099,539301,34595,32678,3081,35759,505
2020-12-26,Sutter,101,95872,6457,6121,44,6165,48
2020-12-26,Tehama,103,63373,3024,2884,273,3157,9
2020-12-26,Trinity,105,12862,412,237,57,294,2
2020-12-26,Tulare,107,460477,33633,31665,3591,35256,398
2020-12-26,Tuolumne,109,53932,2769,2703,11,2714,12
2020-12-26,Ventura,111,848112,39593,36064,1583,37647,230
2020-12-26,Yolo,113,214977,8480,7785,59,7844,111
2020-12-26,Yuba,115,75493,3801,3599,37,3636,18
2020-12-25,Alameda,001,1643700,51315,48365,913,49278,542
2020-12-25,Alpine,003,1148,66,64,0,64,0
2020-12-25,Amador,005,37829,2394,2172,18,2190,23
2020-12-25,Butte,007,227075,7480,6873,816,7689,85
2020-12-25,Calaveras,009,45235,1098,1062,2,1064,21
2020-12-25,Colusa,011,21464,1277,1219,68,1287,7
2020-12-25,Contra Costa,013,1133247,39647,37480,506,37986,324
2020-12-25,Del Norte,015,27424,741,692,2,694,2
2020-12-25,El Dorado,017,186661,6015,5170,262,5432,16
2020-12-25,Fresno,019,978130,67050,62251,4290,66541,679
2020-12-25,Glenn,021,27897,1525,1390,236,1626,9
2020-12-25,Humboldt,023,135768,1688,1532,7,1539,16
2020-12-25,Imperial,025,180216,22643,21646,1228,22874,405
2020-12-25,Inyo,027,18085,654,546,7,553,18
2020-12-25,Kern,029,883053,64759,60417,4570,64987,562
2020-12-25,Kings,031,150075,16162,15460,494,15954,108
2020-12-25,Lake,033,64148,1842,1669,0,1669,20
2020-12-25,Lassen,035,31185,4338,3926,44,3970,1
2020-12-25,Los Angeles,037,10098052,743378,665600,19710,685310,9292
2020-12-25,Madera,039,155013,10484,9770,406,10176,64
2020-12-25,Marin,041,260295,9701,9375,68,9443,143
2020-12-25,Mariposa,043,17540,224,203,2,205,3
2020-12-25,Mendocino,045,87422,2353,2176,20,2196,23
2020-12-25,Merced,047,269075,18546,17726,312,18038,213
2020-12-25,Modoc,049,8938,248,221,72,293,0
2020-12-25,Mono,051,14174,869,843,12,855,3
2020-12-25,Monterey,053,433212,27150,25788,672,26460,182
2020-12-25,Napa,055,140530,5770,5351,26,5377,26
2020-12-25,Nevada,057,99092,2690,2458,86,2544,15
2020-12-25,Orange,059,3164182,157077,144542,5924,150466,1814
2020-12-25,Placer,061,380077,14106,12660,519,13179,122
2020-12-25,Plumas,063,18699,459,381,8,389,0
2020-12-25,Riverside,065,2383286,179400,166690,7748,174438,1825
2020-12-25,Sacramento,067,1510023,64143,61630,572,62202,796
2020-12-25,San Benito,069,59416,3519,3281,27,3308,24
2020-12-25,San Bernardino,071,2135413,194999,181812,5214,187026,1546
2020-12-25,San Diego,073,3302833,154742,139958,6878,146836,1402
2020-12-25,San Francisco,075,870044,23179,22130,208,22338,175
2020-12-25,San Joaquin,077,732212,44968,42089,1478,43567,614
2020-12-25,San Luis Obispo,079,281455,10841,9749,239,9988,76
2020-12-25,San Mateo,081,765935,24821,22568,97,22665,187
2020-12-25,Santa Barbara,083,443738,17096,15936,469,16405,155
2020-12-25,Santa Clara,085,1922200,68747,63173,285,63458,612
2020-12-25,Santa Cruz,087,273765,9034,8018,313,8331,81
2020-12-25,Shasta,089,179085,8053,7612,658,8270,65
2020-12-25,Sierra,091,2930,32,24,3,27,0
2020-12-25,Siskiyou,093,43540,1003,905,96,1001,2
2020-12-25,Solano,095,438530,18704,17280,192,17472,96
2020-12-25,Sonoma,097,501317,18916,18035,103,18138,184
2020-12-25,Stanislaus,099,539301,34299,32290,3033,35323,498
2020-12-25,Sutter,101,95872,6398,6051,43,6094,47
2020-12-25,Tehama,103,63373,2975,2839,260,3099,9
2020-12-25,Trinity,105,12862,408,236,57,293,2
2020-12-25,Tulare,107,460477,33245,31323,3526,34849,398
2020-12-25,Tuolumne,109,53932,2750,2674,11,2685,12
2020-12-25,Ventura,111,848112,38437,35514,1535,37049,230
2020-12-25,Yolo,113,214977,8384,7700,57,7757,111
2020-12-25,Yuba,115,75493,3765,3549,36,3585,17
2020-12-24,Alameda,001,1643700,50974,47527,894,48421,541
2020-12-24,Alpine,003,1148,66,64,0,64,0
2020-12-24,Amador,005,37829,2382,2145,18,2163,23
2020-12-24,Butte,007,227075,7441,6716,802,7518,84
2020-12-24,Calaveras,009,45235,1095,1032,2,1034,21
2020-12-24,Colusa,011,21464,1272,1188,67,1255,7
2020-12-24,Contra Costa,013,1133247,39402,36623,495,37118,311
2020-12-24,Del Norte,015,27424,741,678,2,680,2
2020-12-24,El Dorado,017,186661,5989,5042,254,5296,16
2020-12-24,Fresno,019,978130,66827,61435,4276,65711,663
2020-12-24,Glenn,021,27897,1514,1363,228,1591,9
2020-12-24,Humboldt,023,135768,1665,1516,7,1523,16
2020-12-24,Imperial,025,180216,22594,21545,1219,22764,402
2020-12-24,Inyo,027,18085,652,532,7,539,17
2020-12-24,Kern,029,883053,64472,59601,4557,64158,556
2020-12-24,Kings,031,150075,16122,15211,493,15704,108
2020-12-24,Lake,033,64148,1827,1629,0,1629,20
2020-12-24,Lassen,035,31185,4325,3894,44,3938,1
2020-12-24,Los Angeles,037,10098052,739211,664840,19451,684291,9288
2020-12-24,Madera,039,155013,10444,9547,399,9946,63
2020-12-24,Marin,041,260295,9667,9287,68,9355,143
2020-12-24,Mariposa,043,17540,220,197,2,199,3
2020-12-24,Mendocino,045,87422,2342,2150,20,2170,23
2020-12-24,Merced,047,269075,18475,17485,308,17793,212
2020-12-24,Modoc,049,8938,248,220,71,291,0
2020-12-24,Mono,051,14174,867,817,12,829,3
2020-12-24,Monterey,053,433212,27038,25131,665,25796,180
2020-12-24,Napa,055,140530,5715,5265,26,5291,26
2020-12-24,Nevada,057,99092,2666,2429,86,2515,15
2020-12-24,Orange,059,3164182,155596,141205,5873,147078,1775
2020-12-24,Placer,061,380077,14017,12457,512,12969,121
2020-12-24,Plumas,063,18699,456,376,8,384,0
2020-12-24,Riverside,065,2383286,178468,162435,7708,170143,1816
2020-12-24,Sacramento,067,1510023,63869,60596,570,61166,788
2020-12-24,San Benito,069,59416,3488,3183,27,3210,24
2020-12-24,San Bernardino,071,2135413,193961,176866,5180,182046,1533
2020-12-24,San Diego,073,3302833,153658,136952,6846,143798,1382
2020-12-24,San Francisco,075,870044,23011,21830,205,22035,175
2020-12-24,San Joaquin,077,732212,44804,41324,1460,42784,611
2020-12-24,San Luis Obispo,079,281455,10772,9504,237,9741,77
2020-12-24,San Mateo,081,765935,24625,22093,97,22190,186
2020-12-24,Santa Barbara,083,443738,16991,15644,461,16105,153
2020-12-24,Santa Clara,085,1922200,68141,61742,278,62020,591
2020-12-24,Santa Cruz,087,273765,8963,7856,301,8157,82
2020-12-24,Shasta,089,179085,8012,7540,641,8181,65
2020-12-24,Sierra,091,2930,29,23,1,24,0
2020-12-24,Siskiyou,093,43540,998,900,90,990,2
2020-12-24,Solano,095,438530,18563,16872,187,17059,96
2020-12-24,Sonoma,097,501317,18818,17710,103,17813,183
2020-12-24,Stanislaus,099,539301,34098,31848,3008,34856,498
2020-12-24,Sutter,101,95872,6357,5960,42,6002,47
2020-12-24,Tehama,103,63373,2959,2779,259,3038,9
2020-12-24,Trinity,105,12862,407,235,57,292,2
2020-12-24,Tulare,107,460477,33125,30827,3500,34327,390
2020-12-24,Tuolumne,109,53932,2742,2653,11,2664,12
2020-12-24,Ventura,111,848112,38157,34400,1528,35928,224
2020-12-24,Yolo,113,214977,8342,7566,57,7623,113
2020-12-24,Yuba,115,75493,3740,3483,36,3519,16
2020-12-23,Alameda,001,1643700,50401,46753,868,47621,537
2020-12-23,Alpine,003,1148,66,64,0,64,0
2020-12-23,Amador,005,37829,2313,2108,17,2125,23
2020-12-23,Butte,007,227075,7353,6588,776,7364,84
2020-12-23,Calaveras,009,45235,1087,1002,1,1003,21
2020-12-23,Colusa,011,21464,1261,1167,67,1234,7
2020-12-23,Contra Costa,013,1133247,39002,36190,482,36672,311
2020-12-23,Del Norte,015,27424,734,670,2,672,2
2020-12-23,El Dorado,017,186661,5914,4967,246,5213,14
2020-12-23,Fresno,019,978130,66219,60488,4210,64698,654
2020-12-23,Glenn,021,27897,1500,1349,224,1573,9
2020-12-23,Humboldt,023,135768,1640,1458,7,1465,16
2020-12-23,Imperial,025,180216,22499,21323,1190,22513,399
2020-12-23,Inyo,027,18085,640,517,7,524,17
2020-12-23,Kern,029,883053,63955,58656,4463,63119,549
2020-12-23,Kings,031,150075,16044,14923,490,15413,105
2020-12-23,Lake,033,64148,1813,1595,0,1595,20
2020-12-23,Lassen,035,31185,4315,3865,41,3906,1
2020-12-23,Los Angeles,037,10098052,730162,651958,18919,670877,9146
2020-12-23,Madera,039,155013,10285,9371,385,9756,63
2020-12-23,Marin,041,260295,9609,9199,65,9264,142
2020-12-23,Mariposa,043,17540,218,194,2,196,3
2020-12-23,Mendocino,045,87422,2330,2121,20,2141,23
2020-12-23,Merced,047,269075,18319,17250,301,17551,203
2020-12-23,Modoc,049,8938,244,197,70,267,0
2020-12-23,Mono,051,14174,864,814,12,826,3
2020-12-23,Monterey,053,433212,26737,24856,659,25515,176
2020-12-23,Napa,055,140530,5647,5172,26,5198,25
2020-12-23,Nevada,057,99092,2621,2406,85,2491,15
2020-12-23,Orange,059,3164182,153147,138050,5706,143756,1771
2020-12-23,Placer,061,380077,13807,12213,504,12717,111
2020-12-23,Plumas,063,18699,449,369,8,377,0
2020-12-23,Riverside,065,2383286,176195,158110,7550,165660,1790
2020-12-23,Sacramento,067,1510023,63221,59661,556,60217,779
2020-12-23,San Benito,069,59416,3434,3073,25,3098,24
2020-12-23,San Bernardino,071,2135413,191922,172888,5111,177999,1509
2020-12-23,San Diego,073,3302833,151232,134695,6709,141404,1350
2020-12-23,San Francisco,075,870044,22789,21498,202,21700,174
2020-12-23,San Joaquin,077,732212,44279,35664,1418,37082,602
2020-12-23,San Luis Obispo,079,281455,10630,9267,232,9499,74
2020-12-23,San Mateo,081,765935,24323,21780,95,21875,186
2020-12-23,Santa Barbara,083,443738,16783,15399,435,15834,152
2020-12-23,Santa Clara,085,1922200,67232,60455,273,60728,579
2020-12-23,Santa Cruz,087,273765,8803,7637,283,7920,75
2020-12-23,Shasta,089,179085,7939,7487,635,8122,66
2020-12-23,Sierra,091,2930,27,23,0,23,0
2020-12-23,Siskiyou,093,43540,977,891,89,980,2
2020-12-23,Solano,095,438530,18355,16626,182,16808,95
2020-12-23,Sonoma,097,501317,18614,17397,103,17500,182
2020-12-23,Stanislaus,099,539301,33752,31492,2955,34447,499
2020-12-23,Sutter,101,95872,6291,5871,42,5913,46
2020-12-23,Tehama,103,63373,2942,2737,255,2992,9
2020-12-23,Trinity,105,12862,407,234,56,290,2
2020-12-23,Tulare,107,460477,32833,30315,3461,33776,385
2020-12-23,Tuolumne,109,53932,2703,2540,11,2551,12
2020-12-23,Ventura,111,848112,37760,33377,1499,34876,216
2020-12-23,Yolo,113,214977,8264,7508,56,7564,112
2020-12-23,Yuba,115,75493,3687,3438,36,3474,14
2020-12-22,Alameda,001,1643700,49515,45751,838,46589,534
2020-12-22,Alpine,003,1148,66,64,0,64,0
2020-12-22,Amador,005,37829,2302,1839,17,1856,23
2020-12-22,Butte,007,227075,7225,6467,761,7228,85
2020-12-22,Calaveras,009,45235,1060,988,0,988,21
2020-12-22,Colusa,011,21464,1238,1150,63,1213,7
2020-12-22,Contra Costa,013,1133247,38375,35681,470,36151,301
2020-12-22,Del Norte,015,27424,727,666,2,668,2
2020-12-22,El Dorado,017,186661,5791,4885,234,5119,12
2020-12-22,Fresno,019,978130,65185,59640,4104,63744,640
2020-12-22,Glenn,021,27897,1477,1337,213,1550,9
2020-12-22,Humboldt,023,135768,1607,1440,7,1447,16
2020-12-22,Imperial,025,180216,22310,21128,1147,22275,398
2020-12-22,Inyo,027,18085,620,506,7,513,17
2020-12-22,Kern,029,883053,63003,57816,4326,62142,547
2020-12-22,Kings,031,150075,15902,14855,484,15339,102
2020-12-22,Lake,033,64148,1789,1569,0,1569,20
2020-12-22,Lassen,035,31185,4173,3848,39,3887,1
2020-12-22,Los Angeles,037,10098052,712917,635931,18231,654162,9013
2020-12-22,Madera,039,155013,10167,9187,369,9556,63
2020-12-22,Marin,041,260295,9545,9115,64,9179,142
2020-12-22,Mariposa,043,17540,215,194,2,196,3
2020-12-22,Mendocino,045,87422,2297,2092,20,2112,23
2020-12-22,Merced,047,269075,18073,17012,296,17308,201
2020-12-22,Modoc,049,8938,236,182,69,251,0
2020-12-22,Mono,051,14174,858,786,12,798,3
2020-12-22,Monterey,053,433212,26068,24152,638,24790,176
2020-12-22,Napa,055,140530,5558,5059,26,5085,23
2020-12-22,Nevada,057,99092,2593,2367,84,2451,14
2020-12-22,Orange,059,3164182,149806,134850,5534,140384,1774
2020-12-22,Placer,061,380077,13563,11943,484,12427,105
2020-12-22,Plumas,063,18699,443,360,8,368,0
2020-12-22,Riverside,065,2383286,172384,155059,7281,162340,1777
2020-12-22,Sacramento,067,1510023,62292,57966,537,58503,772
2020-12-22,San Benito,069,59416,3356,2998,25,3023,24
2020-12-22,San Bernardino,071,2135413,187344,169266,4963,174229,1500
2020-12-22,San Diego,073,3302833,147873,132097,6547,138644,1311
2020-12-22,San Francisco,075,870044,22520,21232,198,21430,174
2020-12-22,San Joaquin,077,732212,43522,39423,1369,40792,592
2020-12-22,San Luis Obispo,079,281455,10285,9174,227,9401,69
2020-12-22,San Mateo,081,765935,23996,21382,79,21461,186
2020-12-22,Santa Barbara,083,443738,16518,15189,425,15614,150
2020-12-22,Santa Clara,085,1922200,66065,59192,265,59457,569
2020-12-22,Santa Cruz,087,273765,8624,7471,257,7728,72
2020-12-22,Shasta,089,179085,7861,7371,618,7989,64
2020-12-22,Sierra,091,2930,27,23,0,23,0
2020-12-22,Siskiyou,093,43540,971,880,88,968,2
2020-12-22,Solano,095,438530,17952,16229,179,16408,95
2020-12-22,Sonoma,097,501317,18296,17216,103,17319,180
2020-12-22,Stanislaus,099,539301,33368,30914,2883,33797,499
2020-12-22,Sutter,101,95872,6230,5791,41,5832,46
2020-12-22,Tehama,103,63373,2892,2688,248,2936,9
2020-12-22,Trinity,105,12862,406,231,56,287,2
2020-12-22,Tulare,107,460477,32368,30025,3393,33418,377
2020-12-22,Tuolumne,109,53932,2652,2526,11,2537,12
2020-12-22,Ventura,111,848112,36995,32488,1456,33944,213
2020-12-22,Yolo,113,214977,8151,7388,55,7443,113
2020-12-22,Yuba,115,75493,3636,3379,36,3415,14
2020-12-21,Alameda,001,1643700,48612,44756,811,45567,518
2020-12-21,Alpine,003,1148,65,64,0,64,0
2020-12-21,Amador,005,37829,2225,1815,17,1832,23
2020-12-21,Butte,007,227075,7070,6335,737,7072,81
2020-12-21,Calaveras,009,45235,1030,963,0,963,21
2020-12-21,Colusa,011,21464,1211,1135,58,1193,7
2020-12-21,Contra Costa,013,1133247,37624,35207,433,35640,300
2020-12-21,Del Norte,015,27424,712,660,2,662,2
2020-12-21,El Dorado,017,186661,5644,4805,221,5026,10
2020-12-21,Fresno,019,978130,64033,58568,3960,62528,634
2020-12-21,Glenn,021,27897,1445,1323,205,1528,9
2020-12-21,Humboldt,023,135768,1584,1419,7,1426,16
2020-12-21,Imperial,025,180216,22041,20994,1102,22096,395
2020-12-21,Inyo,027,18085,599,482,7,489,17
2020-12-21,Kern,029,883053,62113,56836,4189,61025,541
2020-12-21,Kings,031,150075,15652,14760,469,15229,100
2020-12-21,Lake,033,64148,1734,1538,0,1538,20
2020-12-21,Lassen,035,31185,4013,3798,37,3835,1
2020-12-21,Los Angeles,037,10098052,693841,624129,17550,641679,8918
2020-12-21,Madera,039,155013,9973,9069,349,9418,63
2020-12-21,Marin,041,260295,9476,9035,64,9099,142
2020-12-21,Mariposa,043,17540,210,186,2,188,3
2020-12-21,Mendocino,045,87422,2266,2066,20,2086,23
2020-12-21,Merced,047,269075,17824,16710,280,16990,198
2020-12-21,Modoc,049,8938,222,181,68,249,0
2020-12-21,Mono,051,14174,846,781,12,793,3
2020-12-21,Monterey,053,433212,25536,23673,624,24297,174
2020-12-21,Napa,055,140530,5471,4952,26,4978,23
2020-12-21,Nevada,057,99092,2560,2337,84,2421,13
2020-12-21,Orange,059,3164182,146394,130444,5380,135824,1772
2020-12-21,Placer,061,380077,13331,11715,465,12180,105
2020-12-21,Plumas,063,18699,439,353,8,361,0
2020-12-21,Riverside,065,2383286,168159,151713,6955,158668,1743
2020-12-21,Sacramento,067,1510023,61272,57064,519,57583,759
2020-12-21,San Benito,069,59416,3288,2921,25,2946,22
2020-12-21,San Bernardino,071,2135413,182552,165086,4798,169884,1476
2020-12-21,San Diego,073,3302833,144422,129716,6383,136099,1284
2020-12-21,San Francisco,075,870044,22234,21086,196,21282,174
2020-12-21,San Joaquin,077,732212,42726,38811,1318,40129,586
2020-12-21,San Luis Obispo,079,281455,10096,9006,222,9228,64
2020-12-21,San Mateo,081,765935,23591,21035,76,21111,185
2020-12-21,Santa Barbara,083,443738,16244,14988,420,15408,149
2020-12-21,Santa Clara,085,1922200,64872,57699,253,57952,570
2020-12-21,Santa Cruz,087,273765,8412,7315,244,7559,69
2020-12-21,Shasta,089,179085,7796,7299,608,7907,64
2020-12-21,Sierra,091,2930,24,23,0,23,0
2020-12-21,Siskiyou,093,43540,963,878,87,965,2
2020-12-21,Solano,095,438530,17482,15878,174,16052,95
2020-12-21,Sonoma,097,501317,18023,17075,99,17174,176
2020-12-21,Stanislaus,099,539301,32911,30437,2809,33246,499
2020-12-21,Sutter,101,95872,6134,5708,41,5749,46
2020-12-21,Tehama,103,63373,2824,2656,240,2896,9
2020-12-21,Trinity,105,12862,404,226,54,280,2
2020-12-21,Tulare,107,460477,31868,29482,3304,32786,373
2020-12-21,Tuolumne,109,53932,2627,2423,9,2432,12
2020-12-21,Ventura,111,848112,35914,31759,1419,33178,212
2020-12-21,Yolo,113,214977,8006,7266,51,7317,109
2020-12-21,Yuba,115,75493,3577,3329,36,3365,14
2020-12-20,Alameda,001,1643700,47732,44004,788,44792,516
2020-12-20,Alpine,003,1148,65,64,0,64,0
2020-12-20,Amador,005,37829,2167,1771,17,1788,23
2020-12-20,Butte,007,227075,6925,6228,701,6929,81
2020-12-20,Calaveras,009,45235,1006,926,0,926,21
2020-12-20,Colusa,011,21464,1183,1121,52,1173,7
2020-12-20,Contra Costa,013,1133247,37038,34798,416,35214,301
2020-12-20,Del Norte,015,27424,690,652,2,654,2
2020-12-20,El Dorado,017,186661,5519,4697,212,4909,10
2020-12-20,Fresno,019,978130,63042,57616,3823,61439,634
2020-12-20,Glenn,021,27897,1436,1295,198,1493,9
2020-12-20,Humboldt,023,135768,1547,1386,6,1392,15
2020-12-20,Imperial,025,180216,21800,20882,997,21879,395
2020-12-20,Inyo,027,18085,584,476,7,483,17
2020-12-20,Kern,029,883053,61015,55983,4034,60017,540
2020-12-20,Kings,031,150075,15432,14629,452,15081,100
2020-12-20,Lake,033,64148,1688,1463,0,1463,20
2020-12-20,Lassen,035,31185,3959,3669,35,3704,1
2020-12-20,Los Angeles,037,10098052,675766,612975,16810,629785,8862
2020-12-20,Madera,039,155013,9763,8871,340,9211,63
2020-12-20,Marin,041,260295,9378,8948,60,9008,142
2020-12-20,Mariposa,043,17540,209,179,2,181,3
2020-12-20,Mendocino,045,87422,2241,2033,20,2053,23
2020-12-20,Merced,047,269075,17508,16435,273,16708,198
2020-12-20,Modoc,049,8938,222,181,66,247,0
2020-12-20,Mono,051,14174,828,774,12,786,3
2020-12-20,Monterey,053,433212,25052,23250,583,23833,173
2020-12-20,Napa,055,140530,5350,4865,24,4889,23
2020-12-20,Nevada,057,99092,2514,2289,78,2367,13
2020-12-20,Orange,059,3164182,142890,128780,5231,134011,1763
2020-12-20,Placer,061,380077,13105,11496,446,11942,105
2020-12-20,Plumas,063,18699,431,347,8,355,0
2020-12-20,Riverside,065,2383286,163952,148714,6663,155377,1742
2020-12-20,Sacramento,067,1510023,60272,56017,499,56516,755
2020-12-20,San Benito,069,59416,3216,2885,24,2909,21
2020-12-20,San Bernardino,071,2135413,177567,162810,4640,167450,1458
2020-12-20,San Diego,073,3302833,140704,126465,6213,132678,1280
2020-12-20,San Francisco,075,870044,21919,20937,193,21130,174
2020-12-20,San Joaquin,077,732212,41884,38268,1257,39525,587
2020-12-20,San Luis Obispo,079,281455,9803,8881,216,9097,63
2020-12-20,San Mateo,081,765935,23157,20764,72,20836,185
2020-12-20,Santa Barbara,083,443738,15922,14817,400,15217,148
2020-12-20,Santa Clara,085,1922200,63465,56860,247,57107,566
2020-12-20,Santa Cruz,087,273765,8204,7178,231,7409,69
2020-12-20,Shasta,089,179085,7682,7256,594,7850,64
2020-12-20,Sierra,091,2930,24,22,0,22,0
2020-12-20,Siskiyou,093,43540,953,870,86,956,2
2020-12-20,Solano,095,438530,17104,15533,163,15696,95
2020-12-20,Sonoma,097,501317,17748,16802,98,16900,175
2020-12-20,Stanislaus,099,539301,32384,29995,2707,32702,498
2020-12-20,Sutter,101,95872,6047,5601,41,5642,43
2020-12-20,Tehama,103,63373,2774,2602,222,2824,9
2020-12-20,Trinity,105,12862,396,221,53,274,2
2020-12-20,Tulare,107,460477,31351,29078,3208,32286,373
2020-12-20,Tuolumne,109,53932,2517,2152,8,2160,12
2020-12-20,Ventura,111,848112,35212,31335,1386,32721,210
2020-12-20,Yolo,113,214977,7855,7121,48,7169,109
2020-12-20,Yuba,115,75493,3530,3254,34,3288,12
2020-12-19,Alameda,001,1643700,47288,43109,781,43890,516
2020-12-19,Alpine,003,1148,65,64,0,64,0
2020-12-19,Amador,005,37829,2143,1754,17,1771,23
2020-12-19,Butte,007,227075,6825,6118,677,6795,81
2020-12-19,Calaveras,009,45235,989,900,0,900,21
2020-12-19,Colusa,011,21464,1175,1096,50,1146,7
2020-12-19,Contra Costa,013,1133247,36724,34321,402,34723,301
2020-12-19,Del Norte,015,27424,688,641,1,642,2
2020-12-19,El Dorado,017,186661,5452,4588,204,4792,10
2020-12-19,Fresno,019,978130,62717,55428,3755,59183,634
2020-12-19,Glenn,021,27897,1401,1286,197,1483,9
2020-12-19,Humboldt,023,135768,1530,1357,6,1363,15
2020-12-19,Imperial,025,180216,21710,20711,951,21662,395
2020-12-19,Inyo,027,18085,577,475,7,482,17
2020-12-19,Kern,029,883053,60530,55118,3926,59044,540
2020-12-19,Kings,031,150075,15353,14474,450,14924,100
2020-12-19,Lake,033,64148,1653,1438,0,1438,20
2020-12-19,Lassen,035,31185,3931,3595,35,3630,1
2020-12-19,Los Angeles,037,10098052,668669,599888,16274,616162,8804
2020-12-19,Madera,039,155013,9671,8717,328,9045,63
2020-12-19,Marin,041,260295,9339,8864,60,8924,142
2020-12-19,Mariposa,043,17540,207,177,2,179,3
2020-12-19,Mendocino,045,87422,2216,2008,20,2028,23
2020-12-19,Merced,047,269075,17369,16230,265,16495,198
2020-12-19,Modoc,049,8938,219,181,66,247,0
2020-12-19,Mono,051,14174,821,766,12,778,3
2020-12-19,Monterey,053,433212,24937,22799,577,23376,172
2020-12-19,Napa,055,140530,5288,4772,24,4796,23
2020-12-19,Nevada,057,99092,2492,2260,78,2338,13
2020-12-19,Orange,059,3164182,140968,125574,5080,130654,1733
2020-12-19,Placer,061,380077,12950,11246,440,11686,105
2020-12-19,Plumas,063,18699,428,343,8,351,0
2020-12-19,Riverside,065,2383286,161964,146703,6427,153130,1737
2020-12-19,Sacramento,067,1510023,59740,55169,485,55654,746
2020-12-19,San Benito,069,59416,3170,2820,23,2843,21
2020-12-19,San Bernardino,071,2135413,175999,159883,4533,164416,1433
2020-12-19,San Diego,073,3302833,138937,122972,6074,129046,1280
2020-12-19,San Francisco,075,870044,21768,20643,193,20836,174
2020-12-19,San Joaquin,077,732212,41482,37340,1207,38547,586
2020-12-19,San Luis Obispo,079,281455,9732,8788,213,9001,63
2020-12-19,San Mateo,081,765935,22947,20393,65,20458,182
2020-12-19,Santa Barbara,083,443738,15766,14667,394,15061,148
2020-12-19,Santa Clara,085,1922200,62654,55540,243,55783,558
2020-12-19,Santa Cruz,087,273765,8100,7054,226,7280,68
2020-12-19,Shasta,089,179085,7630,7221,582,7803,63
2020-12-19,Sierra,091,2930,24,23,0,23,0
2020-12-19,Siskiyou,093,43540,949,853,85,938,2
2020-12-19,Solano,095,438530,16938,15204,159,15363,95
2020-12-19,Sonoma,097,501317,17640,16553,98,16651,175
2020-12-19,Stanislaus,099,539301,32065,29555,2635,32190,498
2020-12-19,Sutter,101,95872,5990,5506,41,5547,41
2020-12-19,Tehama,103,63373,2723,2574,220,2794,9
2020-12-19,Trinity,105,12862,395,219,53,272,2
2020-12-19,Tulare,107,460477,31129,28734,3142,31876,375
2020-12-19,Tuolumne,109,53932,2504,2107,8,2115,12
2020-12-19,Ventura,111,848112,34931,30843,1356,32199,209
2020-12-19,Yolo,113,214977,7786,7025,47,7072,109
2020-12-19,Yuba,115,75493,3498,3168,34,3202,11
2020-12-18,Alameda,001,1643700,46753,42196,765,42961,515
2020-12-18,Alpine,003,1148,65,64,0,64,0
2020-12-18,Amador,005,37829,2126,1727,15,1742,20
2020-12-18,Butte,007,227075,6740,5891,651,6542,81
2020-12-18,Calaveras,009,45235,979,870,0,870,21
2020-12-18,Colusa,011,21464,1166,1068,50,1118,7
2020-12-18,Contra Costa,013,1133247,36439,33610,390,34000,300
2020-12-18,Del Norte,015,27424,683,627,0,627,2
2020-12-18,El Dorado,017,186661,5390,4494,195,4689,10
2020-12-18,Fresno,019,978130,61889,52643,3691,56334,613
2020-12-18,Glenn,021,27897,1384,1264,192,1456,9
2020-12-18,Humboldt,023,135768,1515,1331,6,1337,15
2020-12-18,Imperial,025,180216,21632,20430,904,21334,393
2020-12-18,Inyo,027,18085,557,454,7,461,17
2020-12-18,Kern,029,883053,59870,54220,3841,58061,533
2020-12-18,Kings,031,150075,15227,14284,444,14728,98
2020-12-18,Lake,033,64148,1642,1397,0,1397,20
2020-12-18,Lassen,035,31185,3923,3486,35,3521,1
2020-12-18,Los Angeles,037,10098052,656532,586413,15772,602185,8744
2020-12-18,Madera,039,155013,9569,8609,323,8932,63
2020-12-18,Marin,041,260295,9255,8799,60,8859,142
2020-12-18,Mariposa,043,17540,204,176,2,178,3
2020-12-18,Mendocino,045,87422,2198,1977,20,1997,24
2020-12-18,Merced,047,269075,17288,15956,262,16218,195
2020-12-18,Modoc,049,8938,219,179,66,245,0
2020-12-18,Mono,051,14174,813,731,12,743,3
2020-12-18,Monterey,053,433212,24643,22336,571,22907,165
2020-12-18,Napa,055,140530,5239,4688,24,4712,23
2020-12-18,Nevada,057,99092,2475,2220,77,2297,13
2020-12-18,Orange,059,3164182,138532,121681,4931,126612,1725
2020-12-18,Placer,061,380077,12779,10995,431,11426,104
2020-12-18,Plumas,063,18699,422,336,8,344,0
2020-12-18,Riverside,065,2383286,159122,142375,6158,148533,1733
2020-12-18,Sacramento,067,1510023,59114,53980,469,54449,736
2020-12-18,San Benito,069,59416,3121,2744,23,2767,21
2020-12-18,San Bernardino,071,2135413,173700,154272,4399,158671,1430
2020-12-18,San Diego,073,3302833,136759,120463,5935,126398,1253
2020-12-18,San Francisco,075,870044,21601,20315,187,20502,173
2020-12-18,San Joaquin,077,732212,41124,36484,1176,37660,559
2020-12-18,San Luis Obispo,079,281455,9633,8598,208,8806,62
2020-12-18,San Mateo,081,765935,22633,19971,61,20032,182
2020-12-18,Santa Barbara,083,443738,15625,14361,381,14742,148
2020-12-18,Santa Clara,085,1922200,61781,53992,234,54226,539
2020-12-18,Santa Cruz,087,273765,7985,6838,218,7056,68
2020-12-18,Shasta,089,179085,7592,7114,571,7685,62
2020-12-18,Sierra,091,2930,24,23,0,23,0
2020-12-18,Siskiyou,093,43540,947,840,85,925,2
2020-12-18,Solano,095,438530,16785,14667,155,14822,95
2020-12-18,Sonoma,097,501317,17520,16261,98,16359,173
2020-12-18,Stanislaus,099,539301,31792,28967,2599,31566,490
2020-12-18,Sutter,101,95872,5906,5399,41,5440,39
2020-12-18,Tehama,103,63373,2707,2523,210,2733,9
2020-12-18,Trinity,105,12862,394,215,53,268,2
2020-12-18,Tulare,107,460477,30852,28322,3063,31385,370
2020-12-18,Tuolumne,109,53932,2493,2067,8,2075,12
2020-12-18,Ventura,111,848112,34427,29907,1313,31220,209
2020-12-18,Yolo,113,214977,7718,6901,46,6947,109
2020-12-18,Yuba,115,75493,3440,3097,34,3131,11
2020-12-17,Alameda,001,1643700,45945,41548,732,42280,508
2020-12-17,Alpine,003,1148,65,64,0,64,0
2020-12-17,Amador,005,37829,2078,1703,13,1716,19
2020-12-17,Butte,007,227075,6614,5746,633,6379,78
2020-12-17,Calaveras,009,45235,956,848,0,848,21
2020-12-17,Colusa,011,21464,1155,1053,48,1101,7
2020-12-17,Contra Costa,013,1133247,35914,33006,356,33362,293
2020-12-17,Del Norte,015,27424,678,583,0,583,1
2020-12-17,El Dorado,017,186661,5245,4327,183,4510,9
2020-12-17,Fresno,019,978130,61026,49918,3565,53483,597
2020-12-17,Glenn,021,27897,1360,1244,185,1429,9
2020-12-17,Humboldt,023,135768,1482,1322,6,1328,14
2020-12-17,Imperial,025,180216,21467,20208,834,21042,391
2020-12-17,Inyo,027,18085,539,450,6,456,16
2020-12-17,Kern,029,883053,58913,53683,3708,57391,526
2020-12-17,Kings,031,150075,15124,14057,429,14486,98
2020-12-17,Lake,033,64148,1617,1374,0,1374,20
2020-12-17,Lassen,035,31185,3887,3417,35,3452,1
2020-12-17,Los Angeles,037,10098052,640881,571093,15220,586313,8657
2020-12-17,Madera,039,155013,9452,8465,319,8784,62
2020-12-17,Marin,041,260295,9191,8721,58,8779,142
2020-12-17,Mariposa,043,17540,200,172,2,174,3
2020-12-17,Mendocino,045,87422,2164,1942,20,1962,23
2020-12-17,Merced,047,269075,17025,15648,254,15902,192
2020-12-17,Modoc,049,8938,216,179,66,245,0
2020-12-17,Mono,051,14174,800,718,12,730,3
2020-12-17,Monterey,053,433212,24124,21951,556,22507,163
2020-12-17,Napa,055,140530,5127,4612,24,4636,23
2020-12-17,Nevada,057,99092,2434,2173,74,2247,13
2020-12-17,Orange,059,3164182,135151,118367,4795,123162,1725
2020-12-17,Placer,061,380077,12505,10756,417,11173,99
2020-12-17,Plumas,063,18699,413,324,8,332,0
2020-12-17,Riverside,065,2383286,155238,139325,5942,145267,1696
2020-12-17,Sacramento,067,1510023,58208,53189,446,53635,721
2020-12-17,San Benito,069,59416,3052,2645,22,2667,20
2020-12-17,San Bernardino,071,2135413,169765,149838,4282,154120,1425
2020-12-17,San Diego,073,3302833,133958,116852,5779,122631,1239
2020-12-17,San Francisco,075,870044,21314,19939,182,20121,170
2020-12-17,San Joaquin,077,732212,40397,35894,1139,37033,554
2020-12-17,San Luis Obispo,079,281455,9513,8365,206,8571,59
2020-12-17,San Mateo,081,765935,22262,19647,61,19708,181
2020-12-17,Santa Barbara,083,443738,15392,14207,374,14581,147
2020-12-17,Santa Clara,085,1922200,60613,52559,228,52787,527
2020-12-17,Santa Cruz,087,273765,7830,6687,204,6891,64
2020-12-17,Shasta,089,179085,7515,7000,552,7552,62
2020-12-17,Sierra,091,2930,23,23,0,23,0
2020-12-17,Siskiyou,093,43540,940,827,84,911,2
2020-12-17,Solano,095,438530,16479,14361,153,14514,96
2020-12-17,Sonoma,097,501317,17248,15993,97,16090,171
2020-12-17,Stanislaus,099,539301,31366,28582,2540,31122,489
2020-12-17,Sutter,101,95872,5807,5309,40,5349,39
2020-12-17,Tehama,103,63373,2659,2480,204,2684,9
2020-12-17,Trinity,105,12862,389,213,53,266,2
2020-12-17,Tulare,107,460477,30458,27852,2985,30837,358
2020-12-17,Tuolumne,109,53932,2202,1992,8,2000,11
2020-12-17,Ventura,111,848112,33817,29404,1276,30680,208
2020-12-17,Yolo,113,214977,7593,6800,45,6845,105
2020-12-17,Yuba,115,75493,3381,3035,32,3067,12
2020-12-16,Alameda,001,1643700,45091,40751,705,41456,497
2020-12-16,Alpine,003,1148,65,64,0,64,0
2020-12-16,Amador,005,37829,2031,1693,12,1705,19
2020-12-16,Butte,007,227075,6425,5659,604,6263,76
2020-12-16,Calaveras,009,45235,921,821,0,821,21
2020-12-16,Colusa,011,21464,1142,1038,43,1081,7
2020-12-16,Contra Costa,013,1133247,35357,32429,336,32765,293
2020-12-16,Del Norte,015,27424,676,575,0,575,1
2020-12-16,El Dorado,017,186661,5124,4237,174,4411,9
2020-12-16,Fresno,019,978130,60068,49173,3469,52642,584
2020-12-16,Glenn,021,27897,1342,1236,174,1410,9
2020-12-16,Humboldt,023,135768,1450,1308,5,1313,12
2020-12-16,Imperial,025,180216,21284,19980,768,20748,388
2020-12-16,Inyo,027,18085,526,444,6,450,16
2020-12-16,Kern,029,883053,58036,52896,3575,56471,522
2020-12-16,Kings,031,150075,14944,13734,412,14146,99
2020-12-16,Lake,033,64148,1577,1363,0,1363,20
2020-12-16,Lassen,035,31185,3854,3396,34,3430,1
2020-12-16,Los Angeles,037,10098052,624356,557907,14535,572442,8561
2020-12-16,Madera,039,155013,9327,8278,311,8589,62
2020-12-16,Marin,041,260295,9120,8641,58,8699,142
2020-12-16,Mariposa,043,17540,197,175,2,177,3
2020-12-16,Mendocino,045,87422,2129,1929,20,1949,23
2020-12-16,Merced,047,269075,16739,15443,250,15693,190
2020-12-16,Modoc,049,8938,213,178,66,244,0
2020-12-16,Mono,051,14174,781,702,12,714,3
2020-12-16,Monterey,053,433212,23565,21107,545,21652,163
2020-12-16,Napa,055,140530,5030,4544,24,4568,23
2020-12-16,Nevada,057,99092,2398,2149,72,2221,13
2020-12-16,Orange,059,3164182,131673,115260,4628,119888,1712
2020-12-16,Placer,061,380077,12268,10554,396,10950,96
2020-12-16,Plumas,063,18699,404,319,8,327,0
2020-12-16,Riverside,065,2383286,151113,135751,5694,141445,1664
2020-12-16,Sacramento,067,1510023,57235,52166,421,52587,715
2020-12-16,San Benito,069,59416,2961,2582,22,2604,20
2020-12-16,San Bernardino,071,2135413,165158,143565,4147,147712,1403
2020-12-16,San Diego,073,3302833,130854,114248,5625,119873,1217
2020-12-16,San Francisco,075,870044,21055,19624,182,19806,170
2020-12-16,San Joaquin,077,732212,39572,35010,1099,36109,547
2020-12-16,San Luis Obispo,079,281455,9317,8252,197,8449,58
2020-12-16,San Mateo,081,765935,21936,19292,57,19349,179
2020-12-16,Santa Barbara,083,443738,15142,13966,362,14328,144
2020-12-16,Santa Clara,085,1922200,59371,51502,225,51727,523
2020-12-16,Santa Cruz,087,273765,7646,6536,193,6729,63
2020-12-16,Shasta,089,179085,7442,6914,530,7444,62
2020-12-16,Sierra,091,2930,23,23,0,23,0
2020-12-16,Siskiyou,093,43540,932,818,84,902,2
2020-12-16,Solano,095,438530,16013,14157,149,14306,96
2020-12-16,Sonoma,097,501317,16992,15768,97,15865,170
2020-12-16,Stanislaus,099,539301,30863,28279,2467,30746,489
2020-12-16,Sutter,101,95872,5727,5223,40,5263,39
2020-12-16,Tehama,103,63373,2628,2441,178,2619,9
2020-12-16,Trinity,105,12862,383,212,53,265,2
2020-12-16,Tulare,107,460477,30035,27500,2885,30385,352
2020-12-16,Tuolumne,109,53932,2160,1941,8,1949,11
2020-12-16,Ventura,111,848112,33043,28566,1233,29799,203
2020-12-16,Yolo,113,214977,7464,6649,44,6693,103
2020-12-16,Yuba,115,75493,3295,2980,31,3011,11
2020-12-15,Alameda,001,1643700,44235,40026,683,40709,492
2020-12-15,Alpine,003,1148,65,64,0,64,0
2020-12-15,Amador,005,37829,1918,1669,10,1679,19
2020-12-15,Butte,007,227075,6287,5565,575,6140,75
2020-12-15,Calaveras,009,45235,889,799,0,799,21
2020-12-15,Colusa,011,21464,1129,1026,42,1068,7
2020-12-15,Contra Costa,013,1133247,34702,31423,322,31745,281
2020-12-15,Del Norte,015,27424,665,564,0,564,1
2020-12-15,El Dorado,017,186661,5016,4113,160,4273,9
2020-12-15,Fresno,019,978130,58694,47316,3335,50651,574
2020-12-15,Glenn,021,27897,1329,1207,158,1365,9
2020-12-15,Humboldt,023,135768,1430,1276,5,1281,12
2020-12-15,Imperial,025,180216,21065,19756,688,20444,380
2020-12-15,Inyo,027,18085,513,394,6,400,16
2020-12-15,Kern,029,883053,57024,52002,3472,55474,511
2020-12-15,Kings,031,150075,14780,13652,393,14045,97
2020-12-15,Lake,033,64148,1553,1341,0,1341,21
2020-12-15,Lassen,035,31185,3682,3378,33,3411,1
2020-12-15,Los Angeles,037,10098052,607989,536258,13899,550157,8429
2020-12-15,Madera,039,155013,9173,8118,304,8422,60
2020-12-15,Marin,041,260295,9012,8528,56,8584,141
2020-12-15,Mariposa,043,17540,193,171,2,173,3
2020-12-15,Mendocino,045,87422,2102,1883,20,1903,24
2020-12-15,Merced,047,269075,16444,15120,247,15367,190
2020-12-15,Modoc,049,8938,211,179,66,245,0
2020-12-15,Mono,051,14174,765,702,12,714,3
2020-12-15,Monterey,053,433212,22966,19905,484,20389,161
2020-12-15,Napa,055,140530,4927,4440,24,4464,23
2020-12-15,Nevada,057,99092,2365,2117,70,2187,11
2020-12-15,Orange,059,3164182,128016,112893,4474,117367,1689
2020-12-15,Placer,061,380077,12034,10301,374,10675,95
2020-12-15,Plumas,063,18699,399,313,8,321,0
2020-12-15,Riverside,065,2383286,147055,131822,5415,137237,1624
2020-12-15,Sacramento,067,1510023,56218,51076,408,51484,703
2020-12-15,San Benito,069,59416,2881,2520,21,2541,19
2020-12-15,San Bernardino,071,2135413,160701,137548,3996,141544,1351
2020-12-15,San Diego,073,3302833,127288,111441,5462,116903,1194
2020-12-15,San Francisco,075,870044,20746,19283,179,19462,171
2020-12-15,San Joaquin,077,732212,38648,33849,1062,34911,537
2020-12-15,San Luis Obispo,079,281455,9208,8074,194,8268,55
2020-12-15,San Mateo,081,765935,21526,18907,55,18962,178
2020-12-15,Santa Barbara,083,443738,14916,13782,354,14136,144
2020-12-15,Santa Clara,085,1922200,57936,50311,222,50533,505
2020-12-15,Santa Cruz,087,273765,7462,6361,178,6539,59
2020-12-15,Shasta,089,179085,7383,6794,505,7299,54
2020-12-15,Sierra,091,2930,23,23,0,23,0
2020-12-15,Siskiyou,093,43540,923,812,83,895,2
2020-12-15,Solano,095,438530,15663,13796,149,13945,95
2020-12-15,Sonoma,097,501317,16771,15406,97,15503,167
2020-12-15,Stanislaus,099,539301,30349,27823,2386,30209,485
2020-12-15,Sutter,101,95872,5629,5080,39,5119,36
2020-12-15,Tehama,103,63373,2591,2392,173,2565,9
2020-12-15,Trinity,105,12862,375,213,51,264,1
2020-12-15,Tulare,107,460477,29546,27026,2795,29821,342
2020-12-15,Tuolumne,109,53932,2130,1874,8,1882,8
2020-12-15,Ventura,111,848112,32421,27936,1186,29122,201
2020-12-15,Yolo,113,214977,7341,6531,42,6573,104
2020-12-15,Yuba,115,75493,3201,2891,30,2921,11
2020-12-14,Alameda,001,1643700,43340,39252,664,39916,487
2020-12-14,Alpine,003,1148,65,63,0,63,0
2020-12-14,Amador,005,37829,1846,1609,10,1619,19
2020-12-14,Butte,007,227075,6119,5202,558,5760,75
2020-12-14,Calaveras,009,45235,851,718,0,718,21
2020-12-14,Colusa,011,21464,1105,949,41,990,7
2020-12-14,Contra Costa,013,1133247,34003,30594,308,30902,281
2020-12-14,Del Norte,015,27424,659,560,0,560,1
2020-12-14,El Dorado,017,186661,4860,4018,144,4162,9
2020-12-14,Fresno,019,978130,57669,44726,3155,47881,560
2020-12-14,Glenn,021,27897,1303,1186,150,1336,9
2020-12-14,Humboldt,023,135768,1417,1256,5,1261,9
2020-12-14,Imperial,025,180216,20827,19608,610,20218,379
2020-12-14,Inyo,027,18085,499,382,6,388,16
2020-12-14,Kern,029,883053,55987,50538,3351,53889,510
2020-12-14,Kings,031,150075,14595,13491,366,13857,97
2020-12-14,Lake,033,64148,1504,1301,0,1301,21
2020-12-14,Lassen,035,31185,3584,2905,30,2935,1
2020-12-14,Los Angeles,037,10098052,590373,524668,13256,537924,8340
2020-12-14,Madera,039,155013,8906,8011,295,8306,60
2020-12-14,Marin,041,260295,8929,8475,55,8530,141
2020-12-14,Mariposa,043,17540,192,171,2,173,3
2020-12-14,Mendocino,045,87422,2081,1845,20,1865,24
2020-12-14,Merced,047,269075,16038,14572,233,14805,189
2020-12-14,Modoc,049,8938,205,180,64,244,0
2020-12-14,Mono,051,14174,757,685,12,697,3
2020-12-14,Monterey,053,433212,22444,19154,478,19632,155
2020-12-14,Napa,055,140530,4834,4289,24,4313,22
2020-12-14,Nevada,057,99092,2326,2070,67,2137,11
2020-12-14,Orange,059,3164182,124125,108602,4338,112940,1688
2020-12-14,Placer,061,380077,11753,9551,363,9914,95
2020-12-14,Plumas,063,18699,387,309,8,317,0
2020-12-14,Riverside,065,2383286,142925,123715,5153,128868,1588
2020-12-14,Sacramento,067,1510023,55111,50304,383,50687,691
2020-12-14,San Benito,069,59416,2815,2467,20,2487,19
2020-12-14,San Bernardino,071,2135413,156256,129151,3868,133019,1347
2020-12-14,San Diego,073,3302833,123552,109578,5277,114855,1162
2020-12-14,San Francisco,075,870044,20370,18904,177,19081,171
2020-12-14,San Joaquin,077,732212,37804,32522,1016,33538,534
2020-12-14,San Luis Obispo,079,281455,8960,7791,190,7981,52
2020-12-14,San Mateo,081,765935,21027,18361,52,18413,178
2020-12-14,Santa Barbara,083,443738,14644,13587,346,13933,144
2020-12-14,Santa Clara,085,1922200,56374,49180,210,49390,502
2020-12-14,Santa Cruz,087,273765,7276,6049,163,6212,54
2020-12-14,Shasta,089,179085,7294,6665,486,7151,54
2020-12-14,Sierra,091,2930,23,21,0,21,0
2020-12-14,Siskiyou,093,43540,900,764,77,841,2
2020-12-14,Solano,095,438530,15301,13352,148,13500,93
2020-12-14,Sonoma,097,501317,16464,14807,96,14903,167
2020-12-14,Stanislaus,099,539301,29814,27311,2337,29648,485
2020-12-14,Sutter,101,95872,5524,5001,32,5033,35
2020-12-14,Tehama,103,63373,2547,2344,170,2514,9
2020-12-14,Trinity,105,12862,371,205,49,254,1
2020-12-14,Tulare,107,460477,29073,25735,2704,28439,341
2020-12-14,Tuolumne,109,53932,2077,1647,8,1655,8
2020-12-14,Ventura,111,848112,31498,27436,1127,28563,202
2020-12-14,Yolo,113,214977,7181,6389,41,6430,95
2020-12-14,Yuba,115,75493,3139,2851,30,2881,11
2020-12-13,Alameda,001,1643700,42146,38064,638,38702,486
2020-12-13,Alpine,003,1148,65,63,0,63,0
2020-12-13,Amador,005,37829,1790,1457,9,1466,19
2020-12-13,Butte,007,227075,5970,5103,516,5619,75
2020-12-13,Calaveras,009,45235,815,710,0,710,21
2020-12-13,Colusa,011,21464,1089,945,37,982,7
2020-12-13,Contra Costa,013,1133247,33275,29667,302,29969,281
2020-12-13,Del Norte,015,27424,606,542,0,542,1
2020-12-13,El Dorado,017,186661,4759,3770,133,3903,9
2020-12-13,Fresno,019,978130,56563,44114,2995,47109,559
2020-12-13,Glenn,021,27897,1290,1171,139,1310,9
2020-12-13,Humboldt,023,135768,1394,1238,4,1242,9
2020-12-13,Imperial,025,180216,20534,19472,482,19954,379
2020-12-13,Inyo,027,18085,478,380,6,386,16
2020-12-13,Kern,029,883053,54956,49051,3197,52248,510
2020-12-13,Kings,031,150075,14315,13357,348,13705,97
2020-12-13,Lake,033,64148,1461,1271,0,1271,21
2020-12-13,Lassen,035,31185,3477,2867,25,2892,1
2020-12-13,Los Angeles,037,10098052,572767,517472,12551,530023,8294
2020-12-13,Madera,039,155013,8724,7909,281,8190,60
2020-12-13,Marin,041,260295,8809,8409,55,8464,141
2020-12-13,Mariposa,043,17540,188,167,2,169,3
2020-12-13,Mendocino,045,87422,2047,1793,20,1813,24
2020-12-13,Merced,047,269075,15688,14384,230,14614,189
2020-12-13,Modoc,049,8938,192,179,58,237,0
2020-12-13,Mono,051,14174,741,675,12,687,3
2020-12-13,Monterey,053,433212,22021,18913,464,19377,153
2020-12-13,Napa,055,140530,4728,4194,24,4218,22
2020-12-13,Nevada,057,99092,2278,2030,65,2095,11
2020-12-13,Orange,059,3164182,120192,104768,4164,108932,1688
2020-12-13,Placer,061,380077,11439,9405,345,9750,95
2020-12-13,Plumas,063,18699,381,291,8,299,0
2020-12-13,Riverside,065,2383286,138795,119691,4890,124581,1581
2020-12-13,Sacramento,067,1510023,53842,49480,353,49833,682
2020-12-13,San Benito,069,59416,2745,2408,19,2427,19
2020-12-13,San Bernardino,071,2135413,151360,126718,3705,130423,1333
2020-12-13,San Diego,073,3302833,119952,107372,5108,112480,1162
2020-12-13,San Francisco,075,870044,20025,18686,168,18854,167
2020-12-13,San Joaquin,077,732212,37000,32170,976,33146,534
2020-12-13,San Luis Obispo,079,281455,8768,7625,182,7807,52
2020-12-13,San Mateo,081,765935,20536,18090,46,18136,177
2020-12-13,Santa Barbara,083,443738,14376,13249,331,13580,144
2020-12-13,Santa Clara,085,1922200,54948,47920,201,48121,499
2020-12-13,Santa Cruz,087,273765,7027,5986,152,6138,54
2020-12-13,Shasta,089,179085,7220,6647,460,7107,54
2020-12-13,Sierra,091,2930,23,21,0,21,0
2020-12-13,Siskiyou,093,43540,888,762,72,834,2
2020-12-13,Solano,095,438530,14862,13276,145,13421,93
2020-12-13,Sonoma,097,501317,16149,14495,95,14590,167
2020-12-13,Stanislaus,099,539301,29250,26569,2275,28844,485
2020-12-13,Sutter,101,95872,5396,4798,28,4826,34
2020-12-13,Tehama,103,63373,2501,2325,155,2480,9
2020-12-13,Trinity,105,12862,365,204,49,253,1
2020-12-13,Tulare,107,460477,28582,25496,2617,28113,340
2020-12-13,Tuolumne,109,53932,2015,1611,8,1619,8
2020-12-13,Ventura,111,848112,30495,26588,1064,27652,202
2020-12-13,Yolo,113,214977,6997,6265,35,6300,95
2020-12-13,Yuba,115,75493,3074,2754,27,2781,11
2020-12-12,Alameda,001,1643700,41703,37027,618,37645,486
2020-12-12,Alpine,003,1148,65,63,0,63,0
2020-12-12,Amador,005,37829,1762,1236,8,1244,19
2020-12-12,Butte,007,227075,5897,4972,504,5476,73
2020-12-12,Calaveras,009,45235,805,708,0,708,21
2020-12-12,Colusa,011,21464,1069,945,35,980,7
2020-12-12,Contra Costa,013,1133247,32932,29506,293,29799,281
2020-12-12,Del Norte,015,27424,598,529,0,529,1
2020-12-12,El Dorado,017,186661,4684,3706,116,3822,9
2020-12-12,Fresno,019,978130,56211,43756,2935,46691,559
2020-12-12,Glenn,021,27897,1282,1143,135,1278,8
2020-12-12,Humboldt,023,135768,1375,1208,4,1212,9
2020-12-12,Imperial,025,180216,20450,18947,424,19371,379
2020-12-12,Inyo,027,18085,474,380,6,386,16
2020-12-12,Kern,029,883053,54436,48194,3109,51303,507
2020-12-12,Kings,031,150075,14226,13205,344,13549,96
2020-12-12,Lake,033,64148,1445,1232,0,1232,21
2020-12-12,Lassen,035,31185,3454,2866,22,2888,1
2020-12-12,Los Angeles,037,10098052,565969,504317,12044,516361,8269
2020-12-12,Madera,039,155013,8597,7765,278,8043,59
2020-12-12,Marin,041,260295,8755,8363,54,8417,141
2020-12-12,Mariposa,043,17540,187,164,2,166,3
2020-12-12,Mendocino,045,87422,2011,1771,20,1791,24
2020-12-12,Merced,047,269075,15597,14181,226,14407,188
2020-12-12,Modoc,049,8938,191,169,55,224,0
2020-12-12,Mono,051,14174,734,640,12,652,3
2020-12-12,Monterey,053,433212,21910,18596,435,19031,151
2020-12-12,Napa,055,140530,4683,4113,24,4137,22
2020-12-12,Nevada,057,99092,2260,1981,63,2044,10
2020-12-12,Orange,059,3164182,118309,100468,4016,104484,1674
2020-12-12,Placer,061,380077,11274,9390,340,9730,95
2020-12-12,Plumas,063,18699,375,291,8,299,0
2020-12-12,Riverside,065,2383286,136738,118335,4685,123020,1579
2020-12-12,Sacramento,067,1510023,53257,48319,340,48659,673
2020-12-12,San Benito,069,59416,2689,2355,19,2374,19
2020-12-12,San Bernardino,071,2135413,149729,125741,3603,129344,1321
2020-12-12,San Diego,073,3302833,118331,104958,5011,109969,1151
2020-12-12,San Francisco,075,870044,19835,18413,164,18577,167
2020-12-12,San Joaquin,077,732212,36673,32200,945,33145,534
2020-12-12,San Luis Obispo,079,281455,8669,7462,176,7638,50
2020-12-12,San Mateo,081,765935,20315,17574,45,17619,177
2020-12-12,Santa Barbara,083,443738,14224,13174,323,13497,144
2020-12-12,Santa Clara,085,1922200,53998,45892,198,46090,498
2020-12-12,Santa Cruz,087,273765,6929,5905,143,6048,54
2020-12-12,Shasta,089,179085,7186,6551,442,6993,54
2020-12-12,Sierra,091,2930,23,21,0,21,0
2020-12-12,Siskiyou,093,43540,886,762,69,831,2
2020-12-12,Solano,095,438530,14664,12748,138,12886,93
2020-12-12,Sonoma,097,501317,16029,14466,95,14561,166
2020-12-12,Stanislaus,099,539301,28949,26246,2223,28469,483
2020-12-12,Sutter,101,95872,5334,4717,28,4745,32
2020-12-12,Tehama,103,63373,2483,2252,150,2402,9
2020-12-12,Trinity,105,12862,363,204,47,251,1
2020-12-12,Tulare,107,460477,28323,25333,2559,27892,341
2020-12-12,Tuolumne,109,53932,1972,1536,8,1544,8
2020-12-12,Ventura,111,848112,30051,25955,1031,26986,202
2020-12-12,Yolo,113,214977,6915,6116,33,6149,95
2020-12-12,Yuba,115,75493,3047,2692,26,2718,10
2020-12-11,Alameda,001,1643700,41137,36281,606,36887,482
2020-12-11,Alpine,003,1148,65,63,0,63,0
2020-12-11,Amador,005,37829,1746,1213,8,1221,19
2020-12-11,Butte,007,227075,5824,4941,486,5427,73
2020-12-11,Calaveras,009,45235,789,697,0,697,21
2020-12-11,Colusa,011,21464,1059,923,33,956,7
2020-12-11,Contra Costa,013,1133247,32508,29036,289,29325,282
2020-12-11,Del Norte,015,27424,592,505,0,505,1
2020-12-11,El Dorado,017,186661,4603,3669,101,3770,9
2020-12-11,Fresno,019,978130,55199,43071,2869,45940,550
2020-12-11,Glenn,021,27897,1266,1135,130,1265,8
2020-12-11,Humboldt,023,135768,1357,1190,4,1194,9
2020-12-11,Imperial,025,180216,20360,18599,380,18979,377
2020-12-11,Inyo,027,18085,462,372,6,378,16
2020-12-11,Kern,029,883053,53758,47664,3047,50711,502
2020-12-11,Kings,031,150075,14082,13118,340,13458,94
2020-12-11,Lake,033,64148,1432,1205,0,1205,21
2020-12-11,Lassen,035,31185,3442,2790,21,2811,1
2020-12-11,Los Angeles,037,10098052,554170,493592,11633,505225,8198
2020-12-11,Madera,039,155013,8506,7648,268,7916,59
2020-12-11,Marin,041,260295,8662,8317,53,8370,141
2020-12-11,Mariposa,043,17540,186,164,2,166,3
2020-12-11,Mendocino,045,87422,1987,1769,20,1789,24
2020-12-11,Merced,047,269075,15477,14038,218,14256,186
2020-12-11,Modoc,049,8938,191,168,54,222,0
2020-12-11,Mono,051,14174,724,631,12,643,3
2020-12-11,Monterey,053,433212,21609,18421,430,18851,150
2020-12-11,Napa,055,140530,4628,4054,24,4078,22
2020-12-11,Nevada,057,99092,2243,1959,60,2019,10
2020-12-11,Orange,059,3164182,116001,98357,3913,102270,1656
2020-12-11,Placer,061,380077,11112,8904,324,9228,93
2020-12-11,Plumas,063,18699,367,286,8,294,0
2020-12-11,Riverside,065,2383286,133670,115329,4465,119794,1573
2020-12-11,Sacramento,067,1510023,52596,47468,332,47800,669
2020-12-11,San Benito,069,59416,2638,2319,19,2338,19
2020-12-11,San Bernardino,071,2135413,147040,123092,3487,126579,1313
2020-12-11,San Diego,073,3302833,116371,102468,4928,107396,1137
2020-12-11,San Francisco,075,870044,19605,18246,163,18409,165
2020-12-11,San Joaquin,077,732212,36327,32044,917,32961,534
2020-12-11,San Luis Obispo,079,281455,8508,7415,174,7589,49
2020-12-11,San Mateo,081,765935,20044,17240,34,17274,177
2020-12-11,Santa Barbara,083,443738,14081,12997,315,13312,144
2020-12-11,Santa Clara,085,1922200,52992,45101,189,45290,494
2020-12-11,Santa Cruz,087,273765,6816,5764,134,5898,50
2020-12-11,Shasta,089,179085,7141,6459,435,6894,54
2020-12-11,Sierra,091,2930,23,19,0,19,0
2020-12-11,Siskiyou,093,43540,879,753,66,819,2
2020-12-11,Solano,095,438530,14478,12554,134,12688,92
2020-12-11,Sonoma,097,501317,15862,14298,93,14391,166
2020-12-11,Stanislaus,099,539301,28681,25928,2180,28108,464
2020-12-11,Sutter,101,95872,5271,4600,27,4627,30
2020-12-11,Tehama,103,63373,2453,2232,146,2378,9
2020-12-11,Trinity,105,12862,360,204,47,251,1
2020-12-11,Tulare,107,460477,27963,24953,2512,27465,338
2020-12-11,Tuolumne,109,53932,1958,1510,8,1518,8
2020-12-11,Ventura,111,848112,29445,24999,1009,26008,202
2020-12-11,Yolo,113,214977,6809,6006,32,6038,95
2020-12-11,Yuba,115,75493,2987,2649,25,2674,10
2020-12-10,Alameda,001,1643700,40366,35686,584,36270,477
2020-12-10,Alpine,003,1148,65,63,0,63,0
2020-12-10,Amador,005,37829,1689,1191,8,1199,18
2020-12-10,Butte,007,227075,5708,4863,459,5322,72
2020-12-10,Calaveras,009,45235,771,684,0,684,21
2020-12-10,Colusa,011,21464,1036,909,28,937,7
2020-12-10,Contra Costa,013,1133247,31827,28413,283,28696,276
2020-12-10,Del Norte,015,27424,582,501,0,501,1
2020-12-10,El Dorado,017,186661,4485,3557,96,3653,9
2020-12-10,Fresno,019,978130,54220,42461,2726,45187,540
2020-12-10,Glenn,021,27897,1246,1126,121,1247,8
2020-12-10,Humboldt,023,135768,1337,1140,4,1144,9
2020-12-10,Imperial,025,180216,20144,18333,302,18635,370
2020-12-10,Inyo,027,18085,441,365,6,371,15
2020-12-10,Kern,029,883053,52774,47176,2881,50057,499
2020-12-10,Kings,031,150075,13924,12993,334,13327,92
2020-12-10,Lake,033,64148,1391,1167,0,1167,21
2020-12-10,Lassen,035,31185,3420,2764,17,2781,0
2020-12-10,Los Angeles,037,10098052,540211,480354,11106,491460,8149
2020-12-10,Madera,039,155013,8400,7445,253,7698,59
2020-12-10,Marin,041,260295,8609,8245,52,8297,140
2020-12-10,Mariposa,043,17540,185,160,2,162,3
2020-12-10,Mendocino,045,87422,1961,1748,17,1765,24
2020-12-10,Merced,047,269075,15231,13756,215,13971,186
2020-12-10,Modoc,049,8938,186,165,52,217,0
2020-12-10,Mono,051,14174,719,601,12,613,3
2020-12-10,Monterey,053,433212,21128,18266,420,18686,145
2020-12-10,Napa,055,140530,4542,3974,23,3997,22
2020-12-10,Nevada,057,99092,2207,1919,60,1979,10
2020-12-10,Orange,059,3164182,112904,95297,3751,99048,1651
2020-12-10,Placer,061,380077,10859,8906,306,9212,90
2020-12-10,Plumas,063,18699,356,281,8,289,0
2020-12-10,Riverside,065,2383286,129984,112794,4196,116990,1552
2020-12-10,Sacramento,067,1510023,51698,46471,311,46782,664
2020-12-10,San Benito,069,59416,2578,2268,18,2286,19
2020-12-10,San Bernardino,071,2135413,142810,120186,3313,123499,1306
2020-12-10,San Diego,073,3302833,113846,99601,4779,104380,1114
2020-12-10,San Francisco,075,870044,19293,17945,155,18100,164
2020-12-10,San Joaquin,077,732212,35692,31228,887,32115,534
2020-12-10,San Luis Obispo,079,281455,8344,7245,163,7408,49
2020-12-10,San Mateo,081,765935,19599,16701,24,16725,177
2020-12-10,Santa Barbara,083,443738,13902,12788,306,13094,143
2020-12-10,Santa Clara,085,1922200,51854,43939,174,44113,491
2020-12-10,Santa Cruz,087,273765,6648,5645,121,5766,48
2020-12-10,Shasta,089,179085,7072,6312,410,6722,53
2020-12-10,Sierra,091,2930,23,18,0,18,0
2020-12-10,Siskiyou,093,43540,869,712,65,777,2
2020-12-10,Solano,095,438530,14111,12017,128,12145,90
2020-12-10,Sonoma,097,501317,15607,14282,91,14373,167
2020-12-10,Stanislaus,099,539301,28217,25582,2111,27693,464
2020-12-10,Sutter,101,95872,5141,4528,25,4553,27
2020-12-10,Tehama,103,63373,2410,2190,136,2326,9
2020-12-10,Trinity,105,12862,356,202,45,247,1
2020-12-10,Tulare,107,460477,27509,24506,2446,26952,337
2020-12-10,Tuolumne,109,53932,1717,1451,8,1459,8
2020-12-10,Ventura,111,848112,28594,24075,965,25040,202
2020-12-10,Yolo,113,214977,6689,5896,31,5927,95
2020-12-10,Yuba,115,75493,2923,2604,24,2628,10
2020-12-09,Alameda,001,1643700,39522,35047,562,35609,470
2020-12-09,Alpine,003,1148,65,58,0,58,0
2020-12-09,Amador,005,37829,1646,1121,8,1129,19
2020-12-09,Butte,007,227075,5565,4733,439,5172,70
2020-12-09,Calaveras,009,45235,744,670,0,670,21
2020-12-09,Colusa,011,21464,1021,896,27,923,7
2020-12-09,Contra Costa,013,1133247,31121,28308,272,28580,273
2020-12-09,Del Norte,015,27424,569,481,0,481,2
2020-12-09,El Dorado,017,186661,4350,3449,88,3537,8
2020-12-09,Fresno,019,978130,53218,41954,2572,44526,533
2020-12-09,Glenn,021,27897,1232,1107,115,1222,8
2020-12-09,Humboldt,023,135768,1305,1086,4,1090,10
2020-12-09,Imperial,025,180216,19890,17757,265,18022,368
2020-12-09,Inyo,027,18085,428,356,6,362,15
2020-12-09,Kern,029,883053,51615,46379,2739,49118,494
2020-12-09,Kings,031,150075,13779,12716,326,13042,92
2020-12-09,Lake,033,64148,1364,1158,0,1158,20
2020-12-09,Lassen,035,31185,3351,2331,15,2346,0
2020-12-09,Los Angeles,037,10098052,526739,467971,10556,478527,8075
2020-12-09,Madera,039,155013,8287,7216,250,7466,59
2020-12-09,Marin,041,260295,8547,8182,51,8233,138
2020-12-09,Mariposa,043,17540,183,154,2,156,3
2020-12-09,Mendocino,045,87422,1935,1703,16,1719,24
2020-12-09,Merced,047,269075,14991,13588,208,13796,183
2020-12-09,Modoc,049,8938,181,146,43,189,0
2020-12-09,Mono,051,14174,707,601,12,613,3
2020-12-09,Monterey,053,433212,20727,17891,412,18303,143
2020-12-09,Napa,055,140530,4456,3858,22,3880,21
2020-12-09,Nevada,057,99092,2154,1864,60,1924,10
2020-12-09,Orange,059,3164182,109813,93763,3579,97342,1629
2020-12-09,Placer,061,380077,10597,8588,292,8880,85
2020-12-09,Plumas,063,18699,348,271,8,279,0
2020-12-09,Riverside,065,2383286,126285,110376,3989,114365,1543
2020-12-09,Sacramento,067,1510023,50635,45284,284,45568,659
2020-12-09,San Benito,069,59416,2505,2217,16,2233,19
2020-12-09,San Bernardino,071,2135413,138531,114516,3120,117636,1305
2020-12-09,San Diego,073,3302833,110866,97551,4640,102191,1103
2020-12-09,San Francisco,075,870044,18992,17628,154,17782,163
2020-12-09,San Joaquin,077,732212,34874,30539,862,31401,531
2020-12-09,San Luis Obispo,079,281455,8125,7105,155,7260,47
2020-12-09,San Mateo,081,765935,19148,16422,23,16445,175
2020-12-09,Santa Barbara,083,443738,13702,12630,296,12926,142
2020-12-09,Santa Clara,085,1922200,50706,42912,158,43070,489
2020-12-09,Santa Cruz,087,273765,6489,5527,106,5633,47
2020-12-09,Shasta,089,179085,7007,6105,395,6500,52
2020-12-09,Sierra,091,2930,23,18,0,18,0
2020-12-09,Siskiyou,093,43540,858,713,64,777,2
2020-12-09,Solano,095,438530,13763,11862,120,11982,90
2020-12-09,Sonoma,097,501317,15351,13994,88,14082,164
2020-12-09,Stanislaus,099,539301,27720,25157,2051,27208,463
2020-12-09,Sutter,101,95872,5023,4418,21,4439,24
2020-12-09,Tehama,103,63373,2374,2102,132,2234,9
2020-12-09,Trinity,105,12862,348,199,42,241,0
2020-12-09,Tulare,107,460477,26913,24124,2368,26492,334
2020-12-09,Tuolumne,109,53932,1684,1319,8,1327,8
2020-12-09,Ventura,111,848112,27731,23830,923,24753,201
2020-12-09,Yolo,113,214977,6565,5760,29,5789,95
2020-12-09,Yuba,115,75493,2855,2513,23,2536,10
2020-12-08,Alameda,001,1643700,38622,34373,546,34919,469
2020-12-08,Alpine,003,1148,64,53,0,53,0
2020-12-08,Amador,005,37829,1360,1043,8,1051,17
2020-12-08,Butte,007,227075,5406,4651,398,5049,70
2020-12-08,Calaveras,009,45235,720,657,0,657,21
2020-12-08,Colusa,011,21464,1005,875,26,901,6
2020-12-08,Contra Costa,013,1133247,30418,27926,255,28181,270
2020-12-08,Del Norte,015,27424,553,465,0,465,2
2020-12-08,El Dorado,017,186661,4226,3296,75,3371,8
2020-12-08,Fresno,019,978130,51955,41574,2414,43988,529
2020-12-08,Glenn,021,27897,1212,1094,107,1201,8
2020-12-08,Humboldt,023,135768,1279,1059,4,1063,10
2020-12-08,Imperial,025,180216,19373,17568,256,17824,363
2020-12-08,Inyo,027,18085,405,333,6,339,15
2020-12-08,Kern,029,883053,50321,45116,2582,47698,487
2020-12-08,Kings,031,150075,13625,12623,317,12940,90
2020-12-08,Lake,033,64148,1322,1127,0,1127,20
2020-12-08,Lassen,035,31185,3195,2165,15,2180,0
2020-12-08,Los Angeles,037,10098052,514056,459738,10072,469810,8004
2020-12-08,Madera,039,155013,8156,7082,237,7319,59
2020-12-08,Marin,041,260295,8467,8099,50,8149,137
2020-12-08,Mariposa,043,17540,179,150,2,152,2
2020-12-08,Mendocino,045,87422,1893,1666,16,1682,23
2020-12-08,Merced,047,269075,14681,13380,207,13587,181
2020-12-08,Modoc,049,8938,173,138,40,178,0
2020-12-08,Mono,051,14174,693,597,12,609,3
2020-12-08,Monterey,053,433212,20154,17752,405,18157,134
2020-12-08,Napa,055,140530,4369,3778,21,3799,22
2020-12-08,Nevada,057,99092,2100,1809,57,1866,11
2020-12-08,Orange,059,3164182,106592,91406,3414,94820,1629
2020-12-08,Placer,061,380077,10329,8224,287,8511,82
2020-12-08,Plumas,063,18699,338,258,8,266,0
2020-12-08,Riverside,065,2383286,122922,107620,3809,111429,1514
2020-12-08,Sacramento,067,1510023,49571,44635,268,44903,649
2020-12-08,San Benito,069,59416,2452,2180,16,2196,18
2020-12-08,San Bernardino,071,2135413,134183,110676,2994,113670,1301
2020-12-08,San Diego,073,3302833,107495,95447,4483,99930,1088
2020-12-08,San Francisco,075,870044,18682,17384,152,17536,162
2020-12-08,San Joaquin,077,732212,33979,30225,829,31054,530
2020-12-08,San Luis Obispo,079,281455,7996,6903,144,7047,45
2020-12-08,San Mateo,081,765935,18748,16305,23,16328,175
2020-12-08,Santa Barbara,083,443738,13518,12516,287,12803,141
2020-12-08,Santa Clara,085,1922200,49399,41309,149,41458,484
2020-12-08,Santa Cruz,087,273765,6311,5374,104,5478,45
2020-12-08,Shasta,089,179085,6898,5946,387,6333,50
2020-12-08,Sierra,091,2930,22,18,0,18,0
2020-12-08,Siskiyou,093,43540,844,704,62,766,2
2020-12-08,Solano,095,438530,13361,11669,118,11787,89
2020-12-08,Sonoma,097,501317,15092,13601,87,13688,164
2020-12-08,Stanislaus,099,539301,27230,24793,1986,26779,461
2020-12-08,Sutter,101,95872,4927,4342,20,4362,24
2020-12-08,Tehama,103,63373,2294,2057,124,2181,9
2020-12-08,Trinity,105,12862,339,198,41,239,0
2020-12-08,Tulare,107,460477,26309,23607,2306,25913,330
2020-12-08,Tuolumne,109,53932,1660,1264,8,1272,7
2020-12-08,Ventura,111,848112,27068,23665,880,24545,195
2020-12-08,Yolo,113,214977,6434,5560,29,5589,90
2020-12-08,Yuba,115,75493,2778,2477,23,2500,10
2020-12-07,Alameda,001,1643700,37756,33887,511,34398,466
2020-12-07,Alpine,003,1148,63,53,0,53,0
2020-12-07,Amador,005,37829,1285,993,7,1000,17
2020-12-07,Butte,007,227075,5271,4604,376,4980,67
2020-12-07,Calaveras,009,45235,688,606,0,606,21
2020-12-07,Colusa,011,21464,980,825,24,849,6
2020-12-07,Contra Costa,013,1133247,29804,27307,242,27549,270
2020-12-07,Del Norte,015,27424,541,424,0,424,2
2020-12-07,El Dorado,017,186661,4047,3275,68,3343,8
2020-12-07,Fresno,019,978130,50481,41098,2292,43390,526
2020-12-07,Glenn,021,27897,1193,1085,101,1186,8
2020-12-07,Humboldt,023,135768,1244,1023,4,1027,9
2020-12-07,Imperial,025,180216,18951,17234,242,17476,364
2020-12-07,Inyo,027,18085,390,333,6,339,15
2020-12-07,Kern,029,883053,49296,44409,2446,46855,486
2020-12-07,Kings,031,150075,13482,12412,307,12719,90
2020-12-07,Lake,033,64148,1293,1090,0,1090,20
2020-12-07,Lassen,035,31185,3098,2167,15,2182,0
2020-12-07,Los Angeles,037,10098052,500398,451052,9630,460682,7937
2020-12-07,Madera,039,155013,7891,6935,232,7167,59
2020-12-07,Marin,041,260295,8409,8049,49,8098,136
2020-12-07,Mariposa,043,17540,176,146,2,148,2
2020-12-07,Mendocino,045,87422,1857,1638,14,1652,23
2020-12-07,Merced,047,269075,14322,13250,197,13447,179
2020-12-07,Modoc,049,8938,166,128,37,165,0
2020-12-07,Mono,051,14174,680,590,12,602,3
2020-12-07,Monterey,053,433212,19673,17746,393,18139,132
2020-12-07,Napa,055,140530,4278,3684,21,3705,21
2020-12-07,Nevada,057,99092,2051,1777,56,1833,11
2020-12-07,Orange,059,3164182,103330,89793,3295,93088,1628
2020-12-07,Placer,061,380077,10002,7911,273,8184,82
2020-12-07,Plumas,063,18699,326,256,5,261,0
2020-12-07,Riverside,065,2383286,119723,102363,3626,105989,1491
2020-12-07,Sacramento,067,1510023,48476,43419,250,43669,638
2020-12-07,San Benito,069,59416,2401,2165,15,2180,18
2020-12-07,San Bernardino,071,2135413,130234,108161,2875,111036,1295
2020-12-07,San Diego,073,3302833,104706,94171,4302,98473,1062
2020-12-07,San Francisco,075,870044,18391,17220,145,17365,161
2020-12-07,San Joaquin,077,732212,33104,28188,802,28990,530
2020-12-07,San Luis Obispo,079,281455,7814,6782,137,6919,45
2020-12-07,San Mateo,081,765935,18307,16029,22,16051,175
2020-12-07,Santa Barbara,083,443738,13277,12362,277,12639,141
2020-12-07,Santa Clara,085,1922200,48011,40621,140,40761,484
2020-12-07,Santa Cruz,087,273765,6144,5152,99,5251,41
2020-12-07,Shasta,089,179085,6774,5742,372,6114,50
2020-12-07,Sierra,091,2930,20,18,0,18,0
2020-12-07,Siskiyou,093,43540,817,652,62,714,2
2020-12-07,Solano,095,438530,13021,11354,114,11468,89
2020-12-07,Sonoma,097,501317,14807,13376,87,13463,164
2020-12-07,Stanislaus,099,539301,26672,24479,1934,26413,454
2020-12-07,Sutter,101,95872,4786,4106,20,4126,24
2020-12-07,Tehama,103,63373,2240,2030,119,2149,9
2020-12-07,Trinity,105,12862,335,194,41,235,0
2020-12-07,Tulare,107,460477,25774,22760,2249,25009,328
2020-12-07,Tuolumne,109,53932,1575,1256,7,1263,7
2020-12-07,Ventura,111,848112,26481,23354,844,24198,191
2020-12-07,Yolo,113,214977,6270,5537,28,5565,90
2020-12-07,Yuba,115,75493,2710,2428,21,2449,10
2020-12-06,Alameda,001,1643700,36769,33477,491,33968,465
2020-12-06,Alpine,003,1148,59,53,0,53,0
2020-12-06,Amador,005,37829,1222,952,6,958,17
2020-12-06,Butte,007,227075,5118,4527,342,4869,67
2020-12-06,Calaveras,009,45235,669,606,0,606,21
2020-12-06,Colusa,011,21464,963,824,21,845,6
2020-12-06,Contra Costa,013,1133247,29198,26566,235,26801,270
2020-12-06,Del Norte,015,27424,486,414,0,414,2
2020-12-06,El Dorado,017,186661,3910,3086,63,3149,8
2020-12-06,Fresno,019,978130,49526,40869,2175,43044,526
2020-12-06,Glenn,021,27897,1183,1067,97,1164,8
2020-12-06,Humboldt,023,135768,1219,1004,4,1008,9
2020-12-06,Imperial,025,180216,18640,16922,232,17154,364
2020-12-06,Inyo,027,18085,377,333,6,339,15
2020-12-06,Kern,029,883053,48307,43899,2276,46175,486
2020-12-06,Kings,031,150075,13210,12056,290,12346,90
2020-12-06,Lake,033,64148,1255,1075,0,1075,20
2020-12-06,Lassen,035,31185,2993,2168,13,2181,0
2020-12-06,Los Angeles,037,10098052,486815,443230,9183,452413,7910
2020-12-06,Madera,039,155013,7720,6826,224,7050,59
2020-12-06,Marin,041,260295,8328,8013,47,8060,136
2020-12-06,Mariposa,043,17540,175,144,2,146,2
2020-12-06,Mendocino,045,87422,1817,1614,14,1628,23
2020-12-06,Merced,047,269075,13987,12928,188,13116,179
2020-12-06,Modoc,049,8938,153,125,29,154,0
2020-12-06,Mono,051,14174,658,586,10,596,3
2020-12-06,Monterey,053,433212,19054,17426,383,17809,130
2020-12-06,Napa,055,140530,4166,3644,21,3665,21
2020-12-06,Nevada,057,99092,1992,1710,53,1763,10
2020-12-06,Orange,059,3164182,100264,87737,3165,90902,1627
2020-12-06,Placer,061,380077,9721,7837,252,8089,82
2020-12-06,Plumas,063,18699,313,254,4,258,0
2020-12-06,Riverside,065,2383286,116629,100088,3402,103490,1482
2020-12-06,Sacramento,067,1510023,47236,42808,234,43042,638
2020-12-06,San Benito,069,59416,2364,2135,15,2150,18
2020-12-06,San Bernardino,071,2135413,126091,106927,2718,109645,1286
2020-12-06,San Diego,073,3302833,101674,92173,4148,96321,1062
2020-12-06,San Francisco,075,870044,18069,17107,137,17244,161
2020-12-06,San Joaquin,077,732212,32270,28188,773,28961,530
2020-12-06,San Luis Obispo,079,281455,7648,6723,132,6855,45
2020-12-06,San Mateo,081,765935,17802,15855,19,15874,175
2020-12-06,Santa Barbara,083,443738,13045,12252,268,12520,141
2020-12-06,Santa Clara,085,1922200,46635,39112,134,39246,482
2020-12-06,Santa Cruz,087,273765,5970,5069,93,5162,40
2020-12-06,Shasta,089,179085,6633,5743,351,6094,49
2020-12-06,Sierra,091,2930,20,17,0,17,0
2020-12-06,Siskiyou,093,43540,799,652,60,712,2
2020-12-06,Solano,095,438530,12734,11354,104,11458,88
2020-12-06,Sonoma,097,501317,14518,13238,86,13324,164
2020-12-06,Stanislaus,099,539301,26120,24036,1870,25906,454
2020-12-06,Sutter,101,95872,4670,4009,19,4028,21
2020-12-06,Tehama,103,63373,2181,1982,111,2093,9
2020-12-06,Trinity,105,12862,328,181,39,220,0
2020-12-06,Tulare,107,460477,25247,22756,2181,24937,327
2020-12-06,Tuolumne,109,53932,1479,1210,7,1217,7
2020-12-06,Ventura,111,848112,25939,23035,817,23852,191
2020-12-06,Yolo,113,214977,6109,5465,23,5488,90
2020-12-06,Yuba,115,75493,2666,2340,20,2360,10
2020-12-05,Alameda,001,1643700,36409,32781,480,33261,465
2020-12-05,Alpine,003,1148,58,53,0,53,0
2020-12-05,Amador,005,37829,1198,847,6,853,17
2020-12-05,Butte,007,227075,5050,4455,323,4778,66
2020-12-05,Calaveras,009,45235,657,606,0,606,21
2020-12-05,Colusa,011,21464,945,825,18,843,6
2020-12-05,Contra Costa,013,1133247,28906,26217,228,26445,270
2020-12-05,Del Norte,015,27424,480,408,0,408,2
2020-12-05,El Dorado,017,186661,3845,3061,58,3119,8
2020-12-05,Fresno,019,978130,49207,40568,2120,42688,525
2020-12-05,Glenn,021,27897,1170,1056,91,1147,8
2020-12-05,Humboldt,023,135768,1186,979,4,983,9
2020-12-05,Imperial,025,180216,18474,16544,230,16774,362
2020-12-05,Inyo,027,18085,372,332,6,338,15
2020-12-05,Kern,029,883053,47843,43332,2190,45522,484
2020-12-05,Kings,031,150075,13129,11898,287,12185,90
2020-12-05,Lake,033,64148,1230,1069,0,1069,20
2020-12-05,Lassen,035,31185,2802,2168,11,2179,0
2020-12-05,Los Angeles,037,10098052,481018,433120,8863,441983,7888
2020-12-05,Madera,039,155013,7627,6619,217,6836,59
2020-12-05,Marin,041,260295,8301,7961,47,8008,136
2020-12-05,Mariposa,043,17540,170,143,2,145,2
2020-12-05,Mendocino,045,87422,1778,1585,14,1599,23
2020-12-05,Merced,047,269075,13880,12747,177,12924,180
2020-12-05,Modoc,049,8938,153,118,28,146,0
2020-12-05,Mono,051,14174,653,554,10,564,3
2020-12-05,Monterey,053,433212,18908,17077,379,17456,127
2020-12-05,Napa,055,140530,4095,3565,21,3586,21
2020-12-05,Nevada,057,99092,1977,1642,51,1693,10
2020-12-05,Orange,059,3164182,98806,85735,3069,88804,1612
2020-12-05,Placer,061,380077,9601,7811,243,8054,78
2020-12-05,Plumas,063,18699,306,246,1,247,0
2020-12-05,Riverside,065,2383286,115017,98612,3224,101836,1477
2020-12-05,Sacramento,067,1510023,46568,41878,219,42097,625
2020-12-05,San Benito,069,59416,2320,2073,15,2088,18
2020-12-05,San Bernardino,071,2135413,124568,105382,2588,107970,1283
2020-12-05,San Diego,073,3302833,100322,90470,4067,94537,1055
2020-12-05,San Francisco,075,870044,17885,16786,133,16919,161
2020-12-05,San Joaquin,077,732212,32006,28105,740,28845,523
2020-12-05,San Luis Obispo,079,281455,7581,6623,129,6752,44
2020-12-05,San Mateo,081,765935,17545,15512,19,15531,175
2020-12-05,Santa Barbara,083,443738,12945,12107,262,12369,141
2020-12-05,Santa Clara,085,1922200,45897,38339,129,38468,474
2020-12-05,Santa Cruz,087,273765,5896,4997,91,5088,40
2020-12-05,Shasta,089,179085,6572,5653,340,5993,49
2020-12-05,Sierra,091,2930,20,17,0,17,0
2020-12-05,Siskiyou,093,43540,791,649,59,708,2
2020-12-05,Solano,095,438530,12565,11351,102,11453,87
2020-12-05,Sonoma,097,501317,14422,13137,86,13223,164
2020-12-05,Stanislaus,099,539301,25808,23662,1835,25497,454
2020-12-05,Sutter,101,95872,4603,3937,19,3956,20
2020-12-05,Tehama,103,63373,2165,1926,109,2035,9
2020-12-05,Trinity,105,12862,327,177,39,216,0
2020-12-05,Tulare,107,460477,25031,22660,2123,24783,324
2020-12-05,Tuolumne,109,53932,1422,1180,7,1187,7
2020-12-05,Ventura,111,848112,25568,22710,803,23513,191
2020-12-05,Yolo,113,214977,6032,5351,22,5373,90
2020-12-05,Yuba,115,75493,2629,2275,20,2295,10
2020-12-04,Alameda,001,1643700,35860,31871,467,32338,465
2020-12-04,Alpine,003,1148,58,53,0,53,0
2020-12-04,Amador,005,37829,1184,766,3,769,16
2020-12-04,Butte,007,227075,4978,4336,303,4639,65
2020-12-04,Calaveras,009,45235,652,585,0,585,21
2020-12-04,Colusa,011,21464,931,790,17,807,6
2020-12-04,Contra Costa,013,1133247,28561,25705,216,25921,264
2020-12-04,Del Norte,015,27424,469,401,0,401,2
2020-12-04,El Dorado,017,186661,3757,2933,55,2988,7
2020-12-04,Fresno,019,978130,48498,40108,2052,42160,522
2020-12-04,Glenn,021,27897,1164,1017,83,1100,8
2020-12-04,Humboldt,023,135768,1168,960,4,964,9
2020-12-04,Imperial,025,180216,18232,16484,230,16714,362
2020-12-04,Inyo,027,18085,364,324,6,330,15
2020-12-04,Kern,029,883053,47292,42497,2087,44584,485
2020-12-04,Kings,031,150075,13036,11767,281,12048,88
2020-12-04,Lake,033,64148,1202,1018,0,1018,20
2020-12-04,Lassen,035,31185,2795,2167,10,2177,0
2020-12-04,Los Angeles,037,10098052,472406,424164,8564,432728,7845
2020-12-04,Madera,039,155013,7536,6479,214,6693,58
2020-12-04,Marin,041,260295,8250,7896,44,7940,136
2020-12-04,Mariposa,043,17540,170,136,2,138,2
2020-12-04,Mendocino,045,87422,1759,1563,13,1576,23
2020-12-04,Merced,047,269075,13765,12474,169,12643,177
2020-12-04,Modoc,049,8938,153,115,28,143,0
2020-12-04,Mono,051,14174,648,549,10,559,3
2020-12-04,Monterey,053,433212,18698,16737,370,17107,127
2020-12-04,Napa,055,140530,4041,3432,21,3453,19
2020-12-04,Nevada,057,99092,1952,1560,48,1608,10
2020-12-04,Orange,059,3164182,96885,83738,3004,86742,1597
2020-12-04,Placer,061,380077,9476,7461,229,7690,76
2020-12-04,Plumas,063,18699,299,232,0,232,0
2020-12-04,Riverside,065,2383286,112818,95255,3067,98322,1475
2020-12-04,Sacramento,067,1510023,45803,41061,202,41263,618
2020-12-04,San Benito,069,59416,2287,2006,15,2021,17
2020-12-04,San Bernardino,071,2135413,122297,102418,2480,104898,1290
2020-12-04,San Diego,073,3302833,98838,88183,3980,92163,1047
2020-12-04,San Francisco,075,870044,17694,16499,133,16632,161
2020-12-04,San Joaquin,077,732212,31569,27806,703,28509,522
2020-12-04,San Luis Obispo,079,281455,7496,6473,126,6599,42
2020-12-04,San Mateo,081,765935,17257,15112,18,15130,173
2020-12-04,Santa Barbara,083,443738,12839,11947,255,12202,141
2020-12-04,Santa Clara,085,1922200,44977,37465,123,37588,468
2020-12-04,Santa Cruz,087,273765,5809,4985,89,5074,32
2020-12-04,Shasta,089,179085,6484,5439,330,5769,49
2020-12-04,Sierra,091,2930,19,17,0,17,0
2020-12-04,Siskiyou,093,43540,784,639,56,695,2
2020-12-04,Solano,095,438530,12419,11037,99,11136,87
2020-12-04,Sonoma,097,501317,14274,12962,85,13047,164
2020-12-04,Stanislaus,099,539301,25538,23206,1790,24996,448
2020-12-04,Sutter,101,95872,4530,3791,14,3805,20
2020-12-04,Tehama,103,63373,2125,1876,104,1980,9
2020-12-04,Trinity,105,12862,325,172,39,211,0
2020-12-04,Tulare,107,460477,24748,22273,2051,24324,322
2020-12-04,Tuolumne,109,53932,1391,1134,7,1141,7
2020-12-04,Ventura,111,848112,25191,22024,786,22810,189
2020-12-04,Yolo,113,214977,5958,5294,21,5315,87
2020-12-04,Yuba,115,75493,2586,2225,19,2244,10
2020-12-03,Alameda,001,1643700,35098,31184,448,31632,465
2020-12-03,Alpine,003,1148,57,53,0,53,0
2020-12-03,Amador,005,37829,1133,653,3,656,16
2020-12-03,Butte,007,227075,4882,4305,284,4589,65
2020-12-03,Calaveras,009,45235,633,572,0,572,21
2020-12-03,Colusa,011,21464,918,774,17,791,6
2020-12-03,Contra Costa,013,1133247,28061,25464,209,25673,265
2020-12-03,Del Norte,015,27424,465,388,0,388,2
2020-12-03,El Dorado,017,186661,3631,2740,53,2793,6
2020-12-03,Fresno,019,978130,47745,39680,1980,41660,516
2020-12-03,Glenn,021,27897,1146,997,75,1072,8
2020-12-03,Humboldt,023,135768,1138,923,4,927,9
2020-12-03,Imperial,025,180216,18026,16436,218,16654,359
2020-12-03,Inyo,027,18085,361,321,6,327,15
2020-12-03,Kern,029,883053,46445,42062,1986,44048,483
2020-12-03,Kings,031,150075,12936,11658,269,11927,87
2020-12-03,Lake,033,64148,1187,991,0,991,20
2020-12-03,Lassen,035,31185,2755,2128,9,2137,0
2020-12-03,Los Angeles,037,10098052,462313,415805,8200,424005,7787
2020-12-03,Madera,039,155013,7413,6398,209,6607,58
2020-12-03,Marin,041,260295,8190,7861,40,7901,136
2020-12-03,Mariposa,043,17540,166,132,2,134,2
2020-12-03,Mendocino,045,87422,1742,1547,10,1557,23
2020-12-03,Merced,047,269075,13520,12310,161,12471,177
2020-12-03,Modoc,049,8938,151,114,28,142,0
2020-12-03,Mono,051,14174,626,527,10,537,3
2020-12-03,Monterey,053,433212,18236,16218,359,16577,125
2020-12-03,Napa,055,140530,3927,3360,21,3381,19
2020-12-03,Nevada,057,99092,1874,1472,47,1519,10
2020-12-03,Orange,059,3164182,94352,82187,2934,85121,1591
2020-12-03,Placer,061,380077,9274,7270,213,7483,73
2020-12-03,Plumas,063,18699,284,223,0,223,0
2020-12-03,Riverside,065,2383286,110055,92489,2905,95394,1461
2020-12-03,Sacramento,067,1510023,44743,40280,187,40467,614
2020-12-03,San Benito,069,59416,2241,1967,15,1982,16
2020-12-03,San Bernardino,071,2135413,118974,100787,2396,103183,1283
2020-12-03,San Diego,073,3302833,97023,86144,3862,90006,1040
2020-12-03,San Francisco,075,870044,17472,16236,132,16368,161
2020-12-03,San Joaquin,077,732212,30846,27239,656,27895,522
2020-12-03,San Luis Obispo,079,281455,7328,6388,125,6513,42
2020-12-03,San Mateo,081,765935,16904,14909,18,14927,173
2020-12-03,Santa Barbara,083,443738,12710,11829,249,12078,141
2020-12-03,Santa Clara,085,1922200,43781,36621,117,36738,465
2020-12-03,Santa Cruz,087,273765,5666,4850,85,4935,28
2020-12-03,Shasta,089,179085,6375,5330,323,5653,48
2020-12-03,Sierra,091,2930,19,17,0,17,0
2020-12-03,Siskiyou,093,43540,769,629,53,682,2
2020-12-03,Solano,095,438530,12205,10857,96,10953,87
2020-12-03,Sonoma,097,501317,14031,12772,84,12856,164
2020-12-03,Stanislaus,099,539301,25129,22821,1742,24563,447
2020-12-03,Sutter,101,95872,4447,3727,14,3741,20
2020-12-03,Tehama,103,63373,2072,1832,95,1927,9
2020-12-03,Trinity,105,12862,322,166,39,205,0
2020-12-03,Tulare,107,460477,24349,21993,1958,23951,321
2020-12-03,Tuolumne,109,53932,1349,1105,7,1112,7
2020-12-03,Ventura,111,848112,24488,21555,773,22328,187
2020-12-03,Yolo,113,214977,5820,5069,21,5090,87
2020-12-03,Yuba,115,75493,2516,2182,18,2200,10
2020-12-02,Alameda,001,1643700,34472,30697,438,31135,463
2020-12-02,Alpine,003,1148,56,52,0,52,0
2020-12-02,Amador,005,37829,1061,585,3,588,16
2020-12-02,Butte,007,227075,4759,4243,274,4517,65
2020-12-02,Calaveras,009,45235,617,553,0,553,21
2020-12-02,Colusa,011,21464,902,756,16,772,6
2020-12-02,Contra Costa,013,1133247,27601,25147,197,25344,264
2020-12-02,Del Norte,015,27424,451,384,0,384,2
2020-12-02,El Dorado,017,186661,3529,2638,49,2687,5
2020-12-02,Fresno,019,978130,46989,39324,1879,41203,507
2020-12-02,Glenn,021,27897,1129,995,67,1062,7
2020-12-02,Humboldt,023,135768,1112,899,4,903,9
2020-12-02,Imperial,025,180216,17602,16360,210,16570,356
2020-12-02,Inyo,027,18085,354,314,6,320,15
2020-12-02,Kern,029,883053,45548,41660,1889,43549,479
2020-12-02,Kings,031,150075,12583,11531,255,11786,86
2020-12-02,Lake,033,64148,1157,971,0,971,20
2020-12-02,Lassen,035,31185,2696,2115,9,2124,0
2020-12-02,Los Angeles,037,10098052,452268,408289,7863,416152,7739
2020-12-02,Madera,039,155013,7289,6370,203,6573,57
2020-12-02,Marin,041,260295,8143,7819,38,7857,136
2020-12-02,Mariposa,043,17540,163,131,2,133,2
2020-12-02,Mendocino,045,87422,1709,1524,10,1534,23
2020-12-02,Merced,047,269075,13277,12168,154,12322,173
2020-12-02,Modoc,049,8938,148,113,28,141,0
2020-12-02,Mono,051,14174,617,520,10,530,3
2020-12-02,Monterey,053,433212,17756,16064,320,16384,121
2020-12-02,Napa,055,140530,3824,3298,20,3318,19
2020-12-02,Nevada,057,99092,1812,1430,46,1476,9
2020-12-02,Orange,059,3164182,92155,81046,2854,83900,1569
2020-12-02,Placer,061,380077,9042,6941,199,7140,73
2020-12-02,Plumas,063,18699,271,218,0,218,0
2020-12-02,Riverside,065,2383286,107335,90089,2724,92813,1451
2020-12-02,Sacramento,067,1510023,43704,39334,176,39510,597
2020-12-02,San Benito,069,59416,2176,1921,15,1936,16
2020-12-02,San Bernardino,071,2135413,115406,98567,2288,100855,1240
2020-12-02,San Diego,073,3302833,95107,84640,3747,88387,1035
2020-12-02,San Francisco,075,870044,17236,16058,130,16188,157
2020-12-02,San Joaquin,077,732212,30225,26740,632,27372,519
2020-12-02,San Luis Obispo,079,281455,7229,6324,123,6447,42
2020-12-02,San Mateo,081,765935,16541,14757,17,14774,170
2020-12-02,Santa Barbara,083,443738,12559,11705,237,11942,140
2020-12-02,Santa Clara,085,1922200,42667,35878,117,35995,458
2020-12-02,Santa Cruz,087,273765,5534,4766,82,4848,27
2020-12-02,Shasta,089,179085,6252,5188,306,5494,47
2020-12-02,Sierra,091,2930,19,17,0,17,0
2020-12-02,Siskiyou,093,43540,753,624,51,675,1
2020-12-02,Solano,095,438530,11959,10701,92,10793,87
2020-12-02,Sonoma,097,501317,13791,12635,83,12718,163
2020-12-02,Stanislaus,099,539301,24626,22615,1687,24302,448
2020-12-02,Sutter,101,95872,4286,3604,14,3618,18
2020-12-02,Tehama,103,63373,2028,1800,80,1880,9
2020-12-02,Trinity,105,12862,312,165,38,203,0
2020-12-02,Tulare,107,460477,23969,21789,1877,23666,321
2020-12-02,Tuolumne,109,53932,1308,1076,7,1083,7
2020-12-02,Ventura,111,848112,24077,21208,755,21963,186
2020-12-02,Yolo,113,214977,5710,5053,20,5073,87
2020-12-02,Yuba,115,75493,2439,2119,17,2136,10
2020-12-01,Alameda,001,1643700,33784,30252,428,30680,460
2020-12-01,Alpine,003,1148,56,41,0,41,0
2020-12-01,Amador,005,37829,914,575,2,577,16
2020-12-01,Butte,007,227075,4653,4177,260,4437,65
2020-12-01,Calaveras,009,45235,599,544,0,544,21
2020-12-01,Colusa,011,21464,885,747,16,763,6
2020-12-01,Contra Costa,013,1133247,27028,24788,189,24977,264
2020-12-01,Del Norte,015,27424,423,357,0,357,2
2020-12-01,El Dorado,017,186661,3384,2542,44,2586,4
2020-12-01,Fresno,019,978130,46087,39004,1801,40805,505
2020-12-01,Glenn,021,27897,1108,989,62,1051,7
2020-12-01,Humboldt,023,135768,1081,886,4,890,9
2020-12-01,Imperial,025,180216,17289,16278,206,16484,356
2020-12-01,Inyo,027,18085,347,304,6,310,15
2020-12-01,Kern,029,883053,44745,41345,1758,43103,478
2020-12-01,Kings,031,150075,12268,11415,241,11656,86
2020-12-01,Lake,033,64148,1139,969,0,969,19
2020-12-01,Lassen,035,31185,2530,2047,8,2055,0
2020-12-01,Los Angeles,037,10098052,441907,403266,7535,410801,7704
2020-12-01,Madera,039,155013,7172,6270,193,6463,57
2020-12-01,Marin,041,260295,8073,7787,37,7824,136
2020-12-01,Mariposa,043,17540,158,128,2,130,2
2020-12-01,Mendocino,045,87422,1675,1497,10,1507,23
2020-12-01,Merced,047,269075,13034,12032,145,12177,172
2020-12-01,Modoc,049,8938,143,113,24,137,0
2020-12-01,Mono,051,14174,604,520,10,530,3
2020-12-01,Monterey,053,433212,17249,15835,309,16144,121
2020-12-01,Napa,055,140530,3740,3124,19,3143,19
2020-12-01,Nevada,057,99092,1750,1411,45,1456,9
2020-12-01,Orange,059,3164182,90057,79468,2766,82234,1567
2020-12-01,Placer,061,380077,8718,6794,192,6986,72
2020-12-01,Plumas,063,18699,259,201,0,201,0
2020-12-01,Riverside,065,2383286,104527,88530,2562,91092,1448
2020-12-01,Sacramento,067,1510023,42656,38966,171,39137,589
2020-12-01,San Benito,069,59416,2121,1888,15,1903,15
2020-12-01,San Bernardino,071,2135413,111934,95854,2164,98018,1220
2020-12-01,San Diego,073,3302833,92850,83423,3637,87060,1019
2020-12-01,San Francisco,075,870044,16955,15797,126,15923,157
2020-12-01,San Joaquin,077,732212,29425,26432,610,27042,514
2020-12-01,San Luis Obispo,079,281455,7087,6264,118,6382,40
2020-12-01,San Mateo,081,765935,16216,14495,17,14512,170
2020-12-01,Santa Barbara,083,443738,12420,11611,227,11838,140
2020-12-01,Santa Clara,085,1922200,41410,35397,111,35508,452
2020-12-01,Santa Cruz,087,273765,5376,4638,74,4712,27
2020-12-01,Shasta,089,179085,6125,5077,286,5363,47
2020-12-01,Sierra,091,2930,19,17,0,17,0
2020-12-01,Siskiyou,093,43540,739,608,47,655,1
2020-12-01,Solano,095,438530,11699,10604,87,10691,87
2020-12-01,Sonoma,097,501317,13586,12491,80,12571,163
2020-12-01,Stanislaus,099,539301,24169,22351,1630,23981,447
2020-12-01,Sutter,101,95872,4145,3538,14,3552,17
2020-12-01,Tehama,103,63373,1965,1773,70,1843,9
2020-12-01,Trinity,105,12862,298,165,32,197,0
2020-12-01,Tulare,107,460477,23514,21645,1807,23452,319
2020-12-01,Tuolumne,109,53932,1272,1052,5,1057,7
2020-12-01,Ventura,111,848112,23464,20604,733,21337,186
2020-12-01,Yolo,113,214977,5569,4928,20,4948,86
2020-12-01,Yuba,115,75493,2373,2088,16,2104,10
2020-11-30,Alameda,001,1643700,32968,29972,411,30383,457
2020-11-30,Alpine,003,1148,54,41,0,41,0
2020-11-30,Amador,005,37829,873,559,2,561,16
2020-11-30,Butte,007,227075,4535,4148,244,4392,65
2020-11-30,Calaveras,009,45235,577,478,0,478,21
2020-11-30,Colusa,011,21464,858,737,12,749,6
2020-11-30,Contra Costa,013,1133247,26447,24365,185,24550,264
2020-11-30,Del Norte,015,27424,400,339,0,339,2
2020-11-30,El Dorado,017,186661,3210,2488,39,2527,4
2020-11-30,Fresno,019,978130,44976,38712,1687,40399,500
2020-11-30,Glenn,021,27897,1085,954,57,1011,5
2020-11-30,Humboldt,023,135768,1034,870,4,874,9
2020-11-30,Imperial,025,180216,17036,16212,185,16397,356
2020-11-30,Inyo,027,18085,342,304,5,309,15
2020-11-30,Kern,029,883053,43982,40941,1622,42563,473
2020-11-30,Kings,031,150075,12120,11346,226,11572,85
2020-11-30,Lake,033,64148,1108,939,0,939,18
2020-11-30,Lassen,035,31185,2437,1793,8,1801,0
2020-11-30,Los Angeles,037,10098052,431247,396202,7203,403405,7658
2020-11-30,Madera,039,155013,7006,6210,179,6389,57
2020-11-30,Marin,041,260295,8030,7764,36,7800,136
2020-11-30,Mariposa,043,17540,151,123,2,125,2
2020-11-30,Mendocino,045,87422,1647,1482,10,1492,23
2020-11-30,Merced,047,269075,12759,11913,134,12047,172
2020-11-30,Modoc,049,8938,133,113,24,137,0
2020-11-30,Mono,051,14174,582,519,10,529,3
2020-11-30,Monterey,053,433212,16818,15837,301,16138,119
2020-11-30,Napa,055,140530,3640,3091,19,3110,18
2020-11-30,Nevada,057,99092,1664,1347,42,1389,9
2020-11-30,Orange,059,3164182,87945,78711,2670,81381,1568
2020-11-30,Placer,061,380077,8423,6575,179,6754,72
2020-11-30,Plumas,063,18699,248,192,0,192,0
2020-11-30,Riverside,065,2383286,101533,87722,2415,90137,1446
2020-11-30,Sacramento,067,1510023,41576,37834,162,37996,586
2020-11-30,San Benito,069,59416,2074,1875,14,1889,15
2020-11-30,San Bernardino,071,2135413,108206,92704,2052,94756,1220
2020-11-30,San Diego,073,3302833,90487,82045,3510,85555,997
2020-11-30,San Francisco,075,870044,16655,15638,123,15761,157
2020-11-30,San Joaquin,077,732212,28719,25742,584,26326,509
2020-11-30,San Luis Obispo,079,281455,6952,6224,116,6340,36
2020-11-30,San Mateo,081,765935,15856,14276,17,14293,170
2020-11-30,Santa Barbara,083,443738,12242,11572,219,11791,140
2020-11-30,Santa Clara,085,1922200,40202,35019,110,35129,451
2020-11-30,Santa Cruz,087,273765,5238,4558,70,4628,26
2020-11-30,Shasta,089,179085,5980,4933,257,5190,44
2020-11-30,Sierra,091,2930,19,16,0,16,0
2020-11-30,Siskiyou,093,43540,730,605,43,648,1
2020-11-30,Solano,095,438530,11437,10392,82,10474,87
2020-11-30,Sonoma,097,501317,13341,12232,76,12308,163
2020-11-30,Stanislaus,099,539301,23707,22110,1586,23696,446
2020-11-30,Sutter,101,95872,3988,3430,13,3443,16
2020-11-30,Tehama,103,63373,1917,1724,64,1788,9
2020-11-30,Trinity,105,12862,292,162,32,194,0
2020-11-30,Tulare,107,460477,23127,20833,1712,22545,319
2020-11-30,Tuolumne,109,53932,1228,1027,5,1032,7
2020-11-30,Ventura,111,848112,22708,20308,717,21025,180
2020-11-30,Yolo,113,214977,5457,4894,20,4914,81
2020-11-30,Yuba,115,75493,2312,2028,14,2042,10
2020-11-29,Alameda,001,1643700,32183,29918,389,30307,457
2020-11-29,Alpine,003,1148,51,41,0,41,0
2020-11-29,Amador,005,37829,722,548,2,550,16
2020-11-29,Butte,007,227075,4433,4008,227,4235,65
2020-11-29,Calaveras,009,45235,545,478,0,478,21
2020-11-29,Colusa,011,21464,829,723,8,731,6
2020-11-29,Contra Costa,013,1133247,25944,24165,179,24344,264
2020-11-29,Del Norte,015,27424,394,339,0,339,2
2020-11-29,El Dorado,017,186661,3079,2447,38,2485,4
2020-11-29,Fresno,019,978130,44023,38568,1615,40183,500
2020-11-29,Glenn,021,27897,1062,951,55,1006,4
2020-11-29,Humboldt,023,135768,1005,856,4,860,9
2020-11-29,Imperial,025,180216,16807,16138,157,16295,356
2020-11-29,Inyo,027,18085,327,289,5,294,15
2020-11-29,Kern,029,883053,43219,40596,1474,42070,473
2020-11-29,Kings,031,150075,11970,11247,208,11455,85
2020-11-29,Lake,033,64148,1084,927,0,927,18
2020-11-29,Lassen,035,31185,2334,1793,8,1801,0
2020-11-29,Los Angeles,037,10098052,420856,391162,6904,398066,7642
2020-11-29,Madera,039,155013,6863,6184,173,6357,57
2020-11-29,Marin,041,260295,7964,7739,33,7772,135
2020-11-29,Mariposa,043,17540,147,123,2,125,2
2020-11-29,Mendocino,045,87422,1613,1473,10,1483,23
2020-11-29,Merced,047,269075,12520,11773,125,11898,172
2020-11-29,Modoc,049,8938,129,105,22,127,0
2020-11-29,Mono,051,14174,559,515,9,524,3
2020-11-29,Monterey,053,433212,16506,15621,294,15915,119
2020-11-29,Napa,055,140530,3535,3090,18,3108,18
2020-11-29,Nevada,057,99092,1583,1311,40,1351,9
2020-11-29,Orange,059,3164182,85925,78057,2623,80680,1567
2020-11-29,Placer,061,380077,8126,6535,167,6702,72
2020-11-29,Plumas,063,18699,243,191,0,191,0
2020-11-29,Riverside,065,2383286,99140,87383,2262,89645,1442
2020-11-29,Sacramento,067,1510023,40497,37415,153,37568,585
2020-11-29,San Benito,069,59416,2030,1860,14,1874,15
2020-11-29,San Bernardino,071,2135413,104857,92052,1936,93988,1223
2020-11-29,San Diego,073,3302833,88076,81086,3357,84443,997
2020-11-29,San Francisco,075,870044,16374,15571,116,15687,153
2020-11-29,San Joaquin,077,732212,27977,25740,578,26318,509
2020-11-29,San Luis Obispo,079,281455,6829,6145,116,6261,36
2020-11-29,San Mateo,081,765935,15523,14177,17,14194,169
2020-11-29,Santa Barbara,083,443738,12087,11520,215,11735,140
2020-11-29,Santa Clara,085,1922200,38996,34234,104,34338,451
2020-11-29,Santa Cruz,087,273765,5079,4490,68,4558,26
2020-11-29,Shasta,089,179085,5806,4935,229,5164,43
2020-11-29,Sierra,091,2930,19,16,0,16,0
2020-11-29,Siskiyou,093,43540,707,590,41,631,1
2020-11-29,Solano,095,438530,11205,10393,78,10471,87
2020-11-29,Sonoma,097,501317,13089,12052,72,12124,163
2020-11-29,Stanislaus,099,539301,23211,21701,1552,23253,446
2020-11-29,Sutter,101,95872,3870,3297,13,3310,16
2020-11-29,Tehama,103,63373,1867,1710,48,1758,9
2020-11-29,Trinity,105,12862,289,159,30,189,0
2020-11-29,Tulare,107,460477,22758,20793,1636,22429,319
2020-11-29,Tuolumne,109,53932,1191,988,5,993,7
2020-11-29,Ventura,111,848112,22023,19952,704,20656,179
2020-11-29,Yolo,113,214977,5319,4830,19,4849,80
2020-11-29,Yuba,115,75493,2256,1959,14,1973,10
2020-11-28,Alameda,001,1643700,31873,29368,384,29752,456
2020-11-28,Alpine,003,1148,51,41,0,41,0
2020-11-28,Amador,005,37829,645,536,2,538,16
2020-11-28,Butte,007,227075,4375,3894,223,4117,65
2020-11-28,Calaveras,009,45235,541,478,0,478,21
2020-11-28,Colusa,011,21464,820,711,6,717,6
2020-11-28,Contra Costa,013,1133247,25611,23798,175,23973,264
2020-11-28,Del Norte,015,27424,384,328,0,328,2
2020-11-28,El Dorado,017,186661,3011,2415,32,2447,4
2020-11-28,Fresno,019,978130,43675,38288,1576,39864,500
2020-11-28,Glenn,021,27897,1051,925,51,976,4
2020-11-28,Humboldt,023,135768,970,844,4,848,9
2020-11-28,Imperial,025,180216,16742,16019,155,16174,356
2020-11-28,Inyo,027,18085,319,289,5,294,15
2020-11-28,Kern,029,883053,42856,40255,1386,41641,473
2020-11-28,Kings,031,150075,11905,11070,201,11271,85
2020-11-28,Lake,033,64148,1069,920,0,920,18
2020-11-28,Lassen,035,31185,2267,1714,8,1722,0
2020-11-28,Los Angeles,037,10098052,415940,386194,6748,392942,7625
2020-11-28,Madera,039,155013,6761,6119,166,6285,57
2020-11-28,Marin,041,260295,7934,7696,29,7725,135
2020-11-28,Mariposa,043,17540,144,120,2,122,2
2020-11-28,Mendocino,045,87422,1582,1458,10,1468,22
2020-11-28,Merced,047,269075,12422,11688,119,11807,172
2020-11-28,Modoc,049,8938,126,103,22,125,0
2020-11-28,Mono,051,14174,553,505,9,514,3
2020-11-28,Monterey,053,433212,16340,15328,290,15618,118
2020-11-28,Napa,055,140530,3483,3033,18,3051,18
2020-11-28,Nevada,057,99092,1555,1272,38,1310,9
2020-11-28,Orange,059,3164182,84828,76882,2576,79458,1568
2020-11-28,Placer,061,380077,7964,6497,164,6661,70
2020-11-28,Plumas,063,18699,236,188,0,188,0
2020-11-28,Riverside,065,2383286,97730,86854,2160,89014,1440
2020-11-28,Sacramento,067,1510023,39919,36905,149,37054,580
2020-11-28,San Benito,069,59416,1983,1835,14,1849,15
2020-11-28,San Bernardino,071,2135413,103458,91183,1838,93021,1224
2020-11-28,San Diego,073,3302833,86822,80020,3273,83293,997
2020-11-28,San Francisco,075,870044,16198,15450,108,15558,153
2020-11-28,San Joaquin,077,732212,27778,25742,563,26305,509
2020-11-28,San Luis Obispo,079,281455,6759,6106,112,6218,36
2020-11-28,San Mateo,081,765935,15332,14040,17,14057,169
2020-11-28,Santa Barbara,083,443738,11985,11481,210,11691,140
2020-11-28,Santa Clara,085,1922200,38252,33701,102,33803,449
2020-11-28,Santa Cruz,087,273765,5002,4426,68,4494,26
2020-11-28,Shasta,089,179085,5729,4882,222,5104,43
2020-11-28,Sierra,091,2930,19,16,0,16,0
2020-11-28,Siskiyou,093,43540,697,558,38,596,1
2020-11-28,Solano,095,438530,11086,10252,76,10328,87
2020-11-28,Sonoma,097,501317,12986,12008,63,12071,162
2020-11-28,Stanislaus,099,539301,22972,21574,1517,23091,446
2020-11-28,Sutter,101,95872,3786,3244,13,3257,15
2020-11-28,Tehama,103,63373,1851,1678,44,1722,9
2020-11-28,Trinity,105,12862,286,157,28,185,0
2020-11-28,Tulare,107,460477,22562,20701,1594,22295,319
2020-11-28,Tuolumne,109,53932,1169,976,5,981,7
2020-11-28,Ventura,111,848112,21725,19510,694,20204,179
2020-11-28,Yolo,113,214977,5245,4739,17,4756,80
2020-11-28,Yuba,115,75493,2203,1912,14,1926,10
2020-11-27,Alameda,001,1643700,31434,29064,373,29437,450
2020-11-27,Alpine,003,1148,51,41,0,41,0
2020-11-27,Amador,005,37829,598,498,1,499,16
2020-11-27,Butte,007,227075,4334,3894,217,4111,65
2020-11-27,Calaveras,009,45235,532,478,0,478,21
2020-11-27,Colusa,011,21464,803,694,4,698,6
2020-11-27,Contra Costa,013,1133247,25351,23463,169,23632,264
2020-11-27,Del Norte,015,27424,378,307,0,307,2
2020-11-27,El Dorado,017,186661,2940,2238,29,2267,4
2020-11-27,Fresno,019,978130,43269,37994,1518,39512,500
2020-11-27,Glenn,021,27897,1038,891,46,937,4
2020-11-27,Humboldt,023,135768,951,795,3,798,9
2020-11-27,Imperial,025,180216,16674,15960,146,16106,356
2020-11-27,Inyo,027,18085,313,289,5,294,15
2020-11-27,Kern,029,883053,42432,39707,1316,41023,473
2020-11-27,Kings,031,150075,11819,10667,183,10850,85
2020-11-27,Lake,033,64148,1033,909,0,909,18
2020-11-27,Lassen,035,31185,2255,1714,8,1722,0
2020-11-27,Los Angeles,037,10098052,409433,382740,6592,389332,7606
2020-11-27,Madera,039,155013,6689,6050,160,6210,57
2020-11-27,Marin,041,260295,7891,7660,29,7689,135
2020-11-27,Mariposa,043,17540,142,118,2,120,2
2020-11-27,Mendocino,045,87422,1568,1387,9,1396,22
2020-11-27,Merced,047,269075,12316,11550,112,11662,172
2020-11-27,Modoc,049,8938,125,100,22,122,0
2020-11-27,Mono,051,14174,549,498,9,507,3
2020-11-27,Monterey,053,433212,16172,14753,290,15043,113
2020-11-27,Napa,055,140530,3443,2988,18,3006,18
2020-11-27,Nevada,057,99092,1525,1184,36,1220,9
2020-11-27,Orange,059,3164182,83538,75151,2537,77688,1568
2020-11-27,Placer,061,380077,7803,6283,154,6437,68
2020-11-27,Plumas,063,18699,233,188,0,188,0
2020-11-27,Riverside,065,2383286,96119,85769,2007,87776,1440
2020-11-27,Sacramento,067,1510023,39297,36579,144,36723,579
2020-11-27,San Benito,069,59416,1949,1805,13,1818,15
2020-11-27,San Bernardino,071,2135413,101947,90254,1757,92011,1224
2020-11-27,San Diego,073,3302833,85628,78161,3184,81345,996
2020-11-27,San Francisco,075,870044,16043,15377,106,15483,153
2020-11-27,San Joaquin,077,732212,27557,25741,543,26284,509
2020-11-27,San Luis Obispo,079,281455,6676,6039,109,6148,36
2020-11-27,San Mateo,081,765935,15129,13872,16,13888,169
2020-11-27,Santa Barbara,083,443738,11892,11340,207,11547,140
2020-11-27,Santa Clara,085,1922200,37577,32935,95,33030,449
2020-11-27,Santa Cruz,087,273765,4931,4358,66,4424,26
2020-11-27,Shasta,089,179085,5652,4710,209,4919,43
2020-11-27,Sierra,091,2930,18,16,0,16,0
2020-11-27,Siskiyou,093,43540,682,554,35,589,1
2020-11-27,Solano,095,438530,10967,10044,73,10117,87
2020-11-27,Sonoma,097,501317,12854,11924,61,11985,162
2020-11-27,Stanislaus,099,539301,22744,21185,1487,22672,446
2020-11-27,Sutter,101,95872,3719,3101,13,3114,15
2020-11-27,Tehama,103,63373,1823,1649,40,1689,9
2020-11-27,Trinity,105,12862,282,151,28,179,0
2020-11-27,Tulare,107,460477,22374,20634,1537,22171,319
2020-11-27,Tuolumne,109,53932,1137,881,5,886,7
2020-11-27,Ventura,111,848112,21401,19379,672,20051,179
2020-11-27,Yolo,113,214977,5196,4737,17,4754,79
2020-11-27,Yuba,115,75493,2174,1864,13,1877,10
2020-11-26,Alameda,001,1643700,31023,28797,354,29151,447
2020-11-26,Alpine,003,1148,51,41,0,41,0
2020-11-26,Amador,005,37829,590,488,1,489,16
2020-11-26,Butte,007,227075,4271,3894,211,4105,65
2020-11-26,Calaveras,009,45235,504,478,0,478,21
2020-11-26,Colusa,011,21464,789,694,4,698,6
2020-11-26,Contra Costa,013,1133247,25017,23468,163,23631,264
2020-11-26,Del Norte,015,27424,367,307,0,307,2
2020-11-26,El Dorado,017,186661,2859,2217,27,2244,4
2020-11-26,Fresno,019,978130,42863,37724,1473,39197,500
2020-11-26,Glenn,021,27897,1022,892,44,936,4
2020-11-26,Humboldt,023,135768,929,795,2,797,9
2020-11-26,Imperial,025,180216,16565,15722,142,15864,355
2020-11-26,Inyo,027,18085,312,289,5,294,15
2020-11-26,Kern,029,883053,41982,39123,1254,40377,471
2020-11-26,Kings,031,150075,11764,10475,171,10646,85
2020-11-26,Lake,033,64148,1020,890,0,890,18
2020-11-26,Lassen,035,31185,2240,1714,8,1722,0
2020-11-26,Los Angeles,037,10098052,404284,378340,6355,384695,7581
2020-11-26,Madera,039,155013,6614,6003,154,6157,57
2020-11-26,Marin,041,260295,7854,7610,29,7639,135
2020-11-26,Mariposa,043,17540,137,116,2,118,2
2020-11-26,Mendocino,045,87422,1554,1387,7,1394,22
2020-11-26,Merced,047,269075,12168,11440,110,11550,172
2020-11-26,Modoc,049,8938,123,100,22,122,0
2020-11-26,Mono,051,14174,541,485,9,494,2
2020-11-26,Monterey,053,433212,15935,14750,282,15032,113
2020-11-26,Napa,055,140530,3379,2988,18,3006,18
2020-11-26,Nevada,057,99092,1479,1184,36,1220,9
2020-11-26,Orange,059,3164182,82150,74264,2475,76739,1563
2020-11-26,Placer,061,380077,7641,6278,145,6423,68
2020-11-26,Plumas,063,18699,225,188,0,188,0
2020-11-26,Riverside,065,2383286,94515,85774,1883,87657,1440
2020-11-26,Sacramento,067,1510023,38655,35854,136,35990,580
2020-11-26,San Benito,069,59416,1922,1769,13,1782,15
2020-11-26,San Bernardino,071,2135413,100297,89727,1665,91392,1223
2020-11-26,San Diego,073,3302833,84018,76359,3080,79439,996
2020-11-26,San Francisco,075,870044,15906,15156,103,15259,153
2020-11-26,San Joaquin,077,732212,27301,25738,531,26269,509
2020-11-26,San Luis Obispo,079,281455,6583,5964,106,6070,36
2020-11-26,San Mateo,081,765935,14940,13715,15,13730,169
2020-11-26,Santa Barbara,083,443738,11811,11277,206,11483,139
2020-11-26,Santa Clara,085,1922200,36935,32411,87,32498,446
2020-11-26,Santa Cruz,087,273765,4800,4269,60,4329,26
2020-11-26,Shasta,089,179085,5569,4712,198,4910,43
2020-11-26,Sierra,091,2930,18,15,0,15,0
2020-11-26,Siskiyou,093,43540,672,526,34,560,1
2020-11-26,Solano,095,438530,10824,9941,71,10012,87
2020-11-26,Sonoma,097,501317,12706,11922,59,11981,162
2020-11-26,Stanislaus,099,539301,22512,21186,1446,22632,445
2020-11-26,Sutter,101,95872,3625,3101,12,3113,15
2020-11-26,Tehama,103,63373,1781,1612,37,1649,9
2020-11-26,Trinity,105,12862,278,139,28,167,0
2020-11-26,Tulare,107,460477,22135,20649,1473,22122,319
2020-11-26,Tuolumne,109,53932,1109,871,5,876,7
2020-11-26,Ventura,111,848112,20905,19058,658,19716,179
2020-11-26,Yolo,113,214977,5107,4566,17,4583,76
2020-11-26,Yuba,115,75493,2114,1865,11,1876,10
2020-11-25,Alameda,001,1643700,30808,28378,346,28724,447
2020-11-25,Alpine,003,1148,51,41,0,41,0
2020-11-25,Amador,005,37829,580,484,1,485,16
2020-11-25,Butte,007,227075,4240,3848,208,4056,64
2020-11-25,Calaveras,009,45235,501,475,0,475,21
2020-11-25,Colusa,011,21464,772,693,4,697,6
2020-11-25,Contra Costa,013,1133247,24862,23307,162,23469,263
2020-11-25,Del Norte,015,27424,366,304,0,304,2
2020-11-25,El Dorado,017,186661,2823,2154,27,2181,4
2020-11-25,Fresno,019,978130,42630,37349,1451,38800,494
2020-11-25,Glenn,021,27897,1005,891,42,933,4
2020-11-25,Humboldt,023,135768,921,777,2,779,9
2020-11-25,Imperial,025,180216,16495,15640,140,15780,355
2020-11-25,Inyo,027,18085,310,289,5,294,15
2020-11-25,Kern,029,883053,41826,38878,1235,40113,467
2020-11-25,Kings,031,150075,11729,10417,167,10584,85
2020-11-25,Lake,033,64148,1003,878,0,878,18
2020-11-25,Lassen,035,31185,2197,1701,8,1709,0
2020-11-25,Los Angeles,037,10098052,401256,373919,6251,380170,7545
2020-11-25,Madera,039,155013,6592,5989,151,6140,57
2020-11-25,Marin,041,260295,7827,7601,28,7629,135
2020-11-25,Mariposa,043,17540,136,114,2,116,2
2020-11-25,Mendocino,045,87422,1535,1373,7,1380,22
2020-11-25,Merced,047,269075,12110,11346,110,11456,172
2020-11-25,Modoc,049,8938,123,96,22,118,0
2020-11-25,Mono,051,14174,536,487,9,496,2
2020-11-25,Monterey,053,433212,15818,14695,280,14975,113
2020-11-25,Napa,055,140530,3346,2945,18,2963,17
2020-11-25,Nevada,057,99092,1461,1170,34,1204,9
2020-11-25,Orange,059,3164182,81396,73014,2455,75469,1551
2020-11-25,Placer,061,380077,7565,6221,144,6365,68
2020-11-25,Plumas,063,18699,220,183,0,183,0
2020-11-25,Riverside,065,2383286,93971,85077,1865,86942,1438
2020-11-25,Sacramento,067,1510023,38319,35687,133,35820,574
2020-11-25,San Benito,069,59416,1899,1764,13,1777,15
2020-11-25,San Bernardino,071,2135413,99457,88469,1637,90106,1225
2020-11-25,San Diego,073,3302833,83361,75307,3044,78351,988
2020-11-25,San Francisco,075,870044,15801,15053,101,15154,153
2020-11-25,San Joaquin,077,732212,27174,25556,519,26075,515
2020-11-25,San Luis Obispo,079,281455,6540,5913,105,6018,34
2020-11-25,San Mateo,081,765935,14825,13614,15,13629,170
2020-11-25,Santa Barbara,083,443738,11761,11183,206,11389,138
2020-11-25,Santa Clara,085,1922200,36488,32032,86,32118,442
2020-11-25,Santa Cruz,087,273765,4748,4202,59,4261,25
2020-11-25,Shasta,089,179085,5523,4588,191,4779,43
2020-11-25,Sierra,091,2930,18,15,0,15,0
2020-11-25,Siskiyou,093,43540,665,499,34,533,1
2020-11-25,Solano,095,438530,10719,9832,70,9902,87
2020-11-25,Sonoma,097,501317,12643,11775,58,11833,162
2020-11-25,Stanislaus,099,539301,22381,21022,1419,22441,445
2020-11-25,Sutter,101,95872,3581,3064,12,3076,14
2020-11-25,Tehama,103,63373,1769,1587,32,1619,9
2020-11-25,Trinity,105,12862,276,135,28,163,0
2020-11-25,Tulare,107,460477,22045,20528,1442,21970,318
2020-11-25,Tuolumne,109,53932,1092,842,5,847,7
2020-11-25,Ventura,111,848112,20810,18914,652,19566,179
2020-11-25,Yolo,113,214977,5071,4527,17,4544,76
2020-11-25,Yuba,115,75493,2088,1840,11,1851,10
2020-11-24,Alameda,001,1643700,30330,28030,335,28365,444
2020-11-24,Alpine,003,1148,51,41,0,41,0
2020-11-24,Amador,005,37829,555,470,1,471,16
2020-11-24,Butte,007,227075,4155,3798,200,3998,63
2020-11-24,Calaveras,009,45235,494,466,0,466,21
2020-11-24,Colusa,011,21464,754,682,4,686,6
2020-11-24,Contra Costa,013,1133247,24509,23072,156,23228,259
2020-11-24,Del Norte,015,27424,357,298,0,298,2
2020-11-24,El Dorado,017,186661,2718,2005,26,2031,4
2020-11-24,Fresno,019,978130,42227,37021,1374,38395,493
2020-11-24,Glenn,021,27897,987,883,38,921,4
2020-11-24,Humboldt,023,135768,902,774,2,776,9
2020-11-24,Imperial,025,180216,16392,15600,134,15734,355
2020-11-24,Inyo,027,18085,309,282,5,287,15
2020-11-24,Kern,029,883053,41352,38551,1157,39708,465
2020-11-24,Kings,031,150075,11462,10338,154,10492,85
2020-11-24,Lake,033,64148,987,872,0,872,18
2020-11-24,Lassen,035,31185,2174,1657,8,1665,0
2020-11-24,Los Angeles,037,10098052,394947,370008,6014,376022,7501
2020-11-24,Madera,039,155013,6507,5881,145,6026,57
2020-11-24,Marin,041,260295,7780,7591,28,7619,135
2020-11-24,Mariposa,043,17540,126,114,1,115,2
2020-11-24,Mendocino,045,87422,1513,1346,6,1352,22
2020-11-24,Merced,047,269075,11921,11268,105,11373,171
2020-11-24,Modoc,049,8938,119,91,22,113,0
2020-11-24,Mono,051,14174,532,483,9,492,2
2020-11-24,Monterey,053,433212,15557,14354,268,14622,113
2020-11-24,Napa,055,140530,3280,2904,18,2922,17
2020-11-24,Nevada,057,99092,1397,1156,32,1188,9
2020-11-24,Orange,059,3164182,79952,71975,2374,74349,1547
2020-11-24,Placer,061,380077,7384,6147,137,6284,67
2020-11-24,Plumas,063,18699,217,180,0,180,0
2020-11-24,Riverside,065,2383286,92212,83685,1736,85421,1420
2020-11-24,Sacramento,067,1510023,37639,35097,126,35223,568
2020-11-24,San Benito,069,59416,1867,1740,12,1752,15
2020-11-24,San Bernardino,071,2135413,97121,86645,1536,88181,1226
2020-11-24,San Diego,073,3302833,81951,74363,2973,77336,984
2020-11-24,San Francisco,075,870044,15606,14874,97,14971,153
2020-11-24,San Joaquin,077,732212,26858,25318,491,25809,517
2020-11-24,San Luis Obispo,079,281455,6477,5805,104,5909,34
2020-11-24,San Mateo,081,765935,14616,13558,14,13572,170
2020-11-24,Santa Barbara,083,443738,11655,11154,204,11358,138
2020-11-24,Santa Clara,085,1922200,35698,31564,82,31646,438
2020-11-24,Santa Cruz,087,273765,4635,4132,58,4190,25
2020-11-24,Shasta,089,179085,5423,4410,172,4582,43
2020-11-24,Sierra,091,2930,18,15,0,15,0
2020-11-24,Siskiyou,093,43540,647,473,31,504,1
2020-11-24,Solano,095,438530,10548,9716,69,9785,86
2020-11-24,Sonoma,097,501317,12463,11644,55,11699,162
2020-11-24,Stanislaus,099,539301,22139,20830,1376,22206,438
2020-11-24,Sutter,101,95872,3475,2974,12,2986,14
2020-11-24,Tehama,103,63373,1719,1565,27,1592,9
2020-11-24,Trinity,105,12862,269,129,27,156,0
2020-11-24,Tulare,107,460477,21796,20319,1378,21697,315
2020-11-24,Tuolumne,109,53932,1063,832,5,837,7
2020-11-24,Ventura,111,848112,20428,18637,642,19279,179
2020-11-24,Yolo,113,214977,4987,4420,17,4437,76
2020-11-24,Yuba,115,75493,2037,1804,9,1813,10
2020-11-23,Alameda,001,1643700,29915,27718,323,28041,444
2020-11-23,Alpine,003,1148,49,41,0,41,0
2020-11-23,Amador,005,37829,514,457,1,458,16
2020-11-23,Butte,007,227075,4091,3765,194,3959,61
2020-11-23,Calaveras,009,45235,477,434,0,434,21
2020-11-23,Colusa,011,21464,740,662,4,666,6
2020-11-23,Contra Costa,013,1133247,24237,22674,151,22825,260
2020-11-23,Del Norte,015,27424,335,296,0,296,2
2020-11-23,El Dorado,017,186661,2598,2005,25,2030,4
2020-11-23,Fresno,019,978130,41778,36688,1311,37999,488
2020-11-23,Glenn,021,27897,961,853,38,891,4
2020-11-23,Humboldt,023,135768,889,746,2,748,9
2020-11-23,Imperial,025,180216,16221,15104,128,15232,355
2020-11-23,Inyo,027,18085,301,279,5,284,15
2020-11-23,Kern,029,883053,40839,38245,1094,39339,463
2020-11-23,Kings,031,150075,11042,10204,147,10351,85
2020-11-23,Lake,033,64148,964,840,0,840,18
2020-11-23,Lassen,035,31185,2094,1271,7,1278,0
2020-11-23,Los Angeles,037,10098052,388856,366374,5765,372139,7447
2020-11-23,Madera,039,155013,6381,5787,141,5928,56
2020-11-23,Marin,041,260295,7738,7543,28,7571,135
2020-11-23,Mariposa,043,17540,125,97,1,98,2
2020-11-23,Mendocino,045,87422,1483,1330,6,1336,22
2020-11-23,Merced,047,269075,11733,11148,102,11250,169
2020-11-23,Modoc,049,8938,105,91,21,112,0
2020-11-23,Mono,051,14174,519,480,9,489,2
2020-11-23,Monterey,053,433212,15278,14265,262,14527,112
2020-11-23,Napa,055,140530,3214,2811,17,2828,17
2020-11-23,Nevada,057,99092,1308,1087,32,1119,9
2020-11-23,Orange,059,3164182,78550,71074,2328,73402,1546
2020-11-23,Placer,061,380077,7182,5999,136,6135,66
2020-11-23,Plumas,063,18699,213,172,0,172,0
2020-11-23,Riverside,065,2383286,90433,82175,1671,83846,1415
2020-11-23,Sacramento,067,1510023,37069,34141,119,34260,556
2020-11-23,San Benito,069,59416,1839,1729,11,1740,15
2020-11-23,San Bernardino,071,2135413,95015,84387,1473,85860,1224
2020-11-23,San Diego,073,3302833,80489,72817,2885,75702,968
2020-11-23,San Francisco,075,870044,15448,14646,95,14741,153
2020-11-23,San Joaquin,077,732212,26509,24622,487,25109,517
2020-11-23,San Luis Obispo,079,281455,6395,5772,102,5874,34
2020-11-23,San Mateo,081,765935,14424,13364,14,13378,170
2020-11-23,Santa Barbara,083,443738,11548,10944,200,11144,137
2020-11-23,Santa Clara,085,1922200,35048,31064,79,31143,435
2020-11-23,Santa Cruz,087,273765,4524,4003,54,4057,25
2020-11-23,Shasta,089,179085,5305,4100,160,4260,43
2020-11-23,Sierra,091,2930,17,15,0,15,0
2020-11-23,Siskiyou,093,43540,620,460,30,490,0
2020-11-23,Solano,095,438530,10391,9394,66,9460,86
2020-11-23,Sonoma,097,501317,12290,11507,51,11558,160
2020-11-23,Stanislaus,099,539301,21846,20487,1343,21830,436
2020-11-23,Sutter,101,95872,3338,2840,11,2851,14
2020-11-23,Tehama,103,63373,1671,1526,24,1550,9
2020-11-23,Trinity,105,12862,260,120,25,145,0
2020-11-23,Tulare,107,460477,21501,19818,1312,21130,315
2020-11-23,Tuolumne,109,53932,1023,774,5,779,7
2020-11-23,Ventura,111,848112,20053,18480,629,19109,179
2020-11-23,Yolo,113,214977,4907,4265,16,4281,75
2020-11-23,Yuba,115,75493,1970,1702,9,1711,10
2020-11-22,Alameda,001,1643700,29479,27472,312,27784,444
2020-11-22,Alpine,003,1148,46,41,0,41,0
2020-11-22,Amador,005,37829,502,450,1,451,16
2020-11-22,Butte,007,227075,4040,3712,187,3899,61
2020-11-22,Calaveras,009,45235,465,434,0,434,21
2020-11-22,Colusa,011,21464,722,642,3,645,6
2020-11-22,Contra Costa,013,1133247,23932,22407,146,22553,260
2020-11-22,Del Norte,015,27424,311,271,0,271,2
2020-11-22,El Dorado,017,186661,2488,1917,22,1939,4
2020-11-22,Fresno,019,978130,41296,36315,1256,37571,488
2020-11-22,Glenn,021,27897,939,832,34,866,4
2020-11-22,Humboldt,023,135768,873,729,2,731,9
2020-11-22,Imperial,025,180216,16016,15109,83,15192,355
2020-11-22,Inyo,027,18085,295,279,5,284,15
2020-11-22,Kern,029,883053,40260,37904,1060,38964,463
2020-11-22,Kings,031,150075,10941,10035,138,10173,85
2020-11-22,Lake,033,64148,942,834,0,834,18
2020-11-22,Lassen,035,31185,1929,1211,6,1217,0
2020-11-22,Los Angeles,037,10098052,382577,360341,5514,365855,7438
2020-11-22,Madera,039,155013,6301,5745,130,5875,56
2020-11-22,Marin,041,260295,7703,7506,27,7533,135
2020-11-22,Mariposa,043,17540,124,95,1,96,2
2020-11-22,Mendocino,045,87422,1459,1285,5,1290,22
2020-11-22,Merced,047,269075,11584,10939,102,11041,169
2020-11-22,Modoc,049,8938,104,87,19,106,0
2020-11-22,Mono,051,14174,504,481,9,490,2
2020-11-22,Monterey,053,433212,15036,13887,256,14143,111
2020-11-22,Napa,055,140530,3133,2778,17,2795,17
2020-11-22,Nevada,057,99092,1250,1052,32,1084,9
2020-11-22,Orange,059,3164182,77138,69913,2289,72202,1546
2020-11-22,Placer,061,380077,6955,5880,126,6006,66
2020-11-22,Plumas,063,18699,200,172,0,172,0
2020-11-22,Riverside,065,2383286,88838,81565,1610,83175,1409
2020-11-22,Sacramento,067,1510023,36337,33421,106,33527,555
2020-11-22,San Benito,069,59416,1810,1704,11,1715,15
2020-11-22,San Bernardino,071,2135413,92671,83505,1403,84908,1224
2020-11-22,San Diego,073,3302833,78752,71649,2810,74459,968
2020-11-22,San Francisco,075,870044,15277,14515,94,14609,153
2020-11-22,San Joaquin,077,732212,26210,24619,475,25094,517
2020-11-22,San Luis Obispo,079,281455,6286,5664,101,5765,34
2020-11-22,San Mateo,081,765935,14219,13228,14,13242,170
2020-11-22,Santa Barbara,083,443738,11413,10946,195,11141,137
2020-11-22,Santa Clara,085,1922200,34370,30633,77,30710,434
2020-11-22,Santa Cruz,087,273765,4442,3896,47,3943,25
2020-11-22,Shasta,089,179085,5148,4100,142,4242,43
2020-11-22,Sierra,091,2930,17,13,0,13,0
2020-11-22,Siskiyou,093,43540,588,411,30,441,0
2020-11-22,Solano,095,438530,10220,9363,62,9425,86
2020-11-22,Sonoma,097,501317,12132,11415,49,11464,159
2020-11-22,Stanislaus,099,539301,21519,20223,1313,21536,436
2020-11-22,Sutter,101,95872,3220,2677,11,2688,13
2020-11-22,Tehama,103,63373,1637,1457,19,1476,9
2020-11-22,Trinity,105,12862,254,114,25,139,0
2020-11-22,Tulare,107,460477,21250,19818,1242,21060,314
2020-11-22,Tuolumne,109,53932,997,689,5,694,7
2020-11-22,Ventura,111,848112,19692,18105,615,18720,179
2020-11-22,Yolo,113,214977,4806,4206,16,4222,75
2020-11-22,Yuba,115,75493,1917,1672,9,1681,10
2020-11-21,Alameda,001,1643700,29292,27424,310,27734,444
2020-11-21,Alpine,003,1148,46,41,0,41,0
2020-11-21,Amador,005,37829,488,450,1,451,16
2020-11-21,Butte,007,227075,3992,3664,184,3848,61
2020-11-21,Calaveras,009,45235,459,434,0,434,21
2020-11-21,Colusa,011,21464,713,642,3,645,6
2020-11-21,Contra Costa,013,1133247,23779,22338,144,22482,260
2020-11-21,Del Norte,015,27424,306,271,0,271,2
2020-11-21,El Dorado,017,186661,2439,1900,21,1921,4
2020-11-21,Fresno,019,978130,41040,35973,1222,37195,482
2020-11-21,Glenn,021,27897,934,829,32,861,4
2020-11-21,Humboldt,023,135768,863,728,2,730,9
2020-11-21,Imperial,025,180216,15939,15053,83,15136,355
2020-11-21,Inyo,027,18085,293,283,5,288,15
2020-11-21,Kern,029,883053,40004,37403,1025,38428,463
2020-11-21,Kings,031,150075,10893,10019,134,10153,85
2020-11-21,Lake,033,64148,929,832,0,832,18
2020-11-21,Lassen,035,31185,1862,1211,6,1217,0
2020-11-21,Los Angeles,037,10098052,379398,357754,5369,363123,7428
2020-11-21,Madera,039,155013,6264,5706,130,5836,56
2020-11-21,Marin,041,260295,7680,7488,26,7514,134
2020-11-21,Mariposa,043,17540,124,92,1,93,2
2020-11-21,Mendocino,045,87422,1428,1282,5,1287,22
2020-11-21,Merced,047,269075,11523,10849,101,10950,169
2020-11-21,Modoc,049,8938,100,87,18,105,0
2020-11-21,Mono,051,14174,499,469,9,478,2
2020-11-21,Monterey,053,433212,14938,13886,251,14137,110
2020-11-21,Napa,055,140530,3099,2757,17,2774,17
2020-11-21,Nevada,057,99092,1238,1018,31,1049,9
2020-11-21,Orange,059,3164182,76335,69021,2259,71280,1543
2020-11-21,Placer,061,380077,6842,5778,123,5901,65
2020-11-21,Plumas,063,18699,195,172,0,172,0
2020-11-21,Riverside,065,2383286,88061,80676,1564,82240,1407
2020-11-21,Sacramento,067,1510023,35942,33133,98,33231,548
2020-11-21,San Benito,069,59416,1791,1691,11,1702,15
2020-11-21,San Bernardino,071,2135413,91794,83206,1327,84533,1222
2020-11-21,San Diego,073,3302833,77973,70711,2755,73466,966
2020-11-21,San Francisco,075,870044,15174,14445,93,14538,153
2020-11-21,San Joaquin,077,732212,26077,24620,460,25080,517
2020-11-21,San Luis Obispo,079,281455,6233,5618,98,5716,34
2020-11-21,San Mateo,081,765935,14117,13138,14,13152,170
2020-11-21,Santa Barbara,083,443738,11362,10922,192,11114,137
2020-11-21,Santa Clara,085,1922200,33986,30377,74,30451,433
2020-11-21,Santa Cruz,087,273765,4385,3898,47,3945,25
2020-11-21,Shasta,089,179085,5074,4095,139,4234,42
2020-11-21,Sierra,091,2930,17,13,0,13,0
2020-11-21,Siskiyou,093,43540,572,403,30,433,0
2020-11-21,Solano,095,438530,10130,9290,59,9349,86
2020-11-21,Sonoma,097,501317,12057,11394,47,11441,158
2020-11-21,Stanislaus,099,539301,21376,20111,1288,21399,435
2020-11-21,Sutter,101,95872,3160,2615,10,2625,13
2020-11-21,Tehama,103,63373,1617,1435,18,1453,9
2020-11-21,Trinity,105,12862,251,110,24,134,0
2020-11-21,Tulare,107,460477,21124,19752,1208,20960,313
2020-11-21,Tuolumne,109,53932,978,690,5,695,7
2020-11-21,Ventura,111,848112,19528,18040,605,18645,177
2020-11-21,Yolo,113,214977,4731,4147,15,4162,75
2020-11-21,Yuba,115,75493,1885,1643,9,1652,10
2020-11-20,Alameda,001,1643700,29077,27221,303,27524,444
2020-11-20,Alpine,003,1148,46,20,0,20,0
2020-11-20,Amador,005,37829,484,446,1,447,16
2020-11-20,Butte,007,227075,3960,3618,180,3798,60
2020-11-20,Calaveras,009,45235,447,424,0,424,21
2020-11-20,Colusa,011,21464,705,631,2,633,6
2020-11-20,Contra Costa,013,1133247,23593,22116,140,22256,260
2020-11-20,Del Norte,015,27424,302,264,0,264,2
2020-11-20,El Dorado,017,186661,2343,1868,19,1887,4
2020-11-20,Fresno,019,978130,40746,35635,1192,36827,480
2020-11-20,Glenn,021,27897,922,826,30,856,4
2020-11-20,Humboldt,023,135768,854,714,1,715,9
2020-11-20,Imperial,025,180216,15877,14864,78,14942,353
2020-11-20,Inyo,027,18085,291,262,5,267,15
2020-11-20,Kern,029,883053,39711,37143,999,38142,462
2020-11-20,Kings,031,150075,10845,9903,133,10036,85
2020-11-20,Lake,033,64148,920,820,0,820,18
2020-11-20,Lassen,035,31185,1777,1212,5,1217,0
2020-11-20,Los Angeles,037,10098052,375516,353554,5205,358759,7398
2020-11-20,Madera,039,155013,6171,5635,129,5764,54
2020-11-20,Marin,041,260295,7656,7467,25,7492,134
2020-11-20,Mariposa,043,17540,116,89,1,90,2
2020-11-20,Mendocino,045,87422,1408,1269,5,1274,22
2020-11-20,Merced,047,269075,11437,10729,101,10830,167
2020-11-20,Modoc,049,8938,100,83,18,101,0
2020-11-20,Mono,051,14174,497,469,9,478,2
2020-11-20,Monterey,053,433212,14813,13738,242,13980,110
2020-11-20,Napa,055,140530,3069,2718,17,2735,17
2020-11-20,Nevada,057,99092,1220,990,30,1020,9
2020-11-20,Orange,059,3164182,75498,68212,2221,70433,1532
2020-11-20,Placer,061,380077,6707,5687,108,5795,66
2020-11-20,Plumas,063,18699,193,163,0,163,0
2020-11-20,Riverside,065,2383286,87050,79613,1501,81114,1405
2020-11-20,Sacramento,067,1510023,35566,32832,89,32921,549
2020-11-20,San Benito,069,59416,1779,1668,11,1679,15
2020-11-20,San Bernardino,071,2135413,90428,81203,1246,82449,1220
2020-11-20,San Diego,073,3302833,76975,69233,2673,71906,960
2020-11-20,San Francisco,075,870044,15070,14327,92,14419,153
2020-11-20,San Joaquin,077,732212,25924,24460,447,24907,515
2020-11-20,San Luis Obispo,079,281455,6177,5524,95,5619,34
2020-11-20,San Mateo,081,765935,13984,12980,13,12993,169
2020-11-20,Santa Barbara,083,443738,11306,10825,186,11011,136
2020-11-20,Santa Clara,085,1922200,33564,30002,69,30071,431
2020-11-20,Santa Cruz,087,273765,4319,3815,47,3862,25
2020-11-20,Shasta,089,179085,5000,3861,134,3995,42
2020-11-20,Sierra,091,2930,17,12,0,12,0
2020-11-20,Siskiyou,093,43540,559,387,29,416,0
2020-11-20,Solano,095,438530,10038,9216,57,9273,85
2020-11-20,Sonoma,097,501317,11973,11316,46,11362,158
2020-11-20,Stanislaus,099,539301,21221,19889,1262,21151,433
2020-11-20,Sutter,101,95872,3110,2580,10,2590,13
2020-11-20,Tehama,103,63373,1602,1410,15,1425,9
2020-11-20,Trinity,105,12862,250,102,24,126,0
2020-11-20,Tulare,107,460477,20991,19568,1169,20737,311
2020-11-20,Tuolumne,109,53932,939,662,5,667,7
2020-11-20,Ventura,111,848112,19360,17741,577,18318,175
2020-11-20,Yolo,113,214977,4653,4081,14,4095,74
2020-11-20,Yuba,115,75493,1857,1611,9,1620,10
2020-11-19,Alameda,001,1643700,28731,26971,295,27266,441
2020-11-19,Alpine,003,1148,43,20,0,20,0
2020-11-19,Amador,005,37829,480,436,1,437,16
2020-11-19,Butte,007,227075,3911,3576,173,3749,60
2020-11-19,Calaveras,009,45235,437,417,0,417,21
2020-11-19,Colusa,011,21464,687,621,2,623,6
2020-11-19,Contra Costa,013,1133247,23321,21886,137,22023,259
2020-11-19,Del Norte,015,27424,294,251,0,251,2
2020-11-19,El Dorado,017,186661,2269,1825,18,1843,4
2020-11-19,Fresno,019,978130,40296,35278,1135,36413,478
2020-11-19,Glenn,021,27897,900,806,29,835,4
2020-11-19,Humboldt,023,135768,834,693,1,694,9
2020-11-19,Imperial,025,180216,15668,14507,77,14584,349
2020-11-19,Inyo,027,18085,289,262,5,267,15
2020-11-19,Kern,029,883053,39290,36779,957,37736,459
2020-11-19,Kings,031,150075,10697,9763,125,9888,85
2020-11-19,Lake,033,64148,906,809,0,809,18
2020-11-19,Lassen,035,31185,1660,1201,3,1204,0
2020-11-19,Los Angeles,037,10098052,370496,349493,5035,354528,7365
2020-11-19,Madera,039,155013,6099,5540,121,5661,54
2020-11-19,Marin,041,260295,7625,7451,25,7476,134
2020-11-19,Mariposa,043,17540,109,88,0,88,2
2020-11-19,Mendocino,045,87422,1387,1237,5,1242,23
2020-11-19,Merced,047,269075,11296,10634,95,10729,167
2020-11-19,Modoc,049,8938,97,82,18,100,0
2020-11-19,Mono,051,14174,489,468,9,477,2
2020-11-19,Monterey,053,433212,14598,13369,230,13599,108
2020-11-19,Napa,055,140530,3015,2641,17,2658,17
2020-11-19,Nevada,057,99092,1179,945,29,974,9
2020-11-19,Orange,059,3164182,74236,66998,2176,69174,1530
2020-11-19,Placer,061,380077,6516,5612,107,5719,65
2020-11-19,Plumas,063,18699,188,158,0,158,0
2020-11-19,Riverside,065,2383286,85565,78535,1430,79965,1402
2020-11-19,Sacramento,067,1510023,35053,32367,87,32454,546
2020-11-19,San Benito,069,59416,1756,1643,11,1654,15
2020-11-19,San Bernardino,071,2135413,88533,79244,1166,80410,1215
2020-11-19,San Diego,073,3302833,75725,68142,2569,70711,952
2020-11-19,San Francisco,075,870044,14913,14178,86,14264,153
2020-11-19,San Joaquin,077,732212,25604,24270,436,24706,516
2020-11-19,San Luis Obispo,079,281455,6100,5410,91,5501,34
2020-11-19,San Mateo,081,765935,13846,12714,13,12727,169
2020-11-19,Santa Barbara,083,443738,11226,10741,183,10924,136
2020-11-19,Santa Clara,085,1922200,33006,29630,68,29698,424
2020-11-19,Santa Cruz,087,273765,4228,3679,45,3724,25
2020-11-19,Shasta,089,179085,4862,3685,124,3809,42
2020-11-19,Sierra,091,2930,17,11,0,11,0
2020-11-19,Siskiyou,093,43540,534,360,28,388,0
2020-11-19,Solano,095,438530,9901,9093,53,9146,84
2020-11-19,Sonoma,097,501317,11803,11205,44,11249,156
2020-11-19,Stanislaus,099,539301,20981,19736,1220,20956,433
2020-11-19,Sutter,101,95872,3011,2509,10,2519,13
2020-11-19,Tehama,103,63373,1569,1373,12,1385,9
2020-11-19,Trinity,105,12862,244,97,24,121,0
2020-11-19,Tulare,107,460477,20769,19384,1104,20488,304
2020-11-19,Tuolumne,109,53932,906,602,5,607,7
2020-11-19,Ventura,111,848112,19007,17300,564,17864,174
2020-11-19,Yolo,113,214977,4557,3973,14,3987,72
2020-11-19,Yuba,115,75493,1817,1568,9,1577,10
2020-11-18,Alameda,001,1643700,28469,26610,290,26900,440
2020-11-18,Alpine,003,1148,42,16,0,16,0
2020-11-18,Amador,005,37829,475,430,1,431,16
2020-11-18,Butte,007,227075,3858,3537,160,3697,59
2020-11-18,Calaveras,009,45235,433,409,0,409,21
2020-11-18,Colusa,011,21464,674,611,2,613,6
2020-11-18,Contra Costa,013,1133247,23054,21685,133,21818,258
2020-11-18,Del Norte,015,27424,281,240,0,240,2
2020-11-18,El Dorado,017,186661,2181,1799,17,1816,4
2020-11-18,Fresno,019,978130,39856,34997,1084,36081,474
2020-11-18,Glenn,021,27897,883,803,27,830,4
2020-11-18,Humboldt,023,135768,820,690,1,691,9
2020-11-18,Imperial,025,180216,15446,14428,76,14504,348
2020-11-18,Inyo,027,18085,287,262,5,267,15
2020-11-18,Kern,029,883053,38901,36537,907,37444,456
2020-11-18,Kings,031,150075,10549,9696,122,9818,85
2020-11-18,Lake,033,64148,893,802,0,802,18
2020-11-18,Lassen,035,31185,1560,1124,3,1127,0
2020-11-18,Los Angeles,037,10098052,365629,344675,4849,349524,7338
2020-11-18,Madera,039,155013,6012,5519,109,5628,54
2020-11-18,Marin,041,260295,7601,7435,25,7460,134
2020-11-18,Mariposa,043,17540,106,88,0,88,2
2020-11-18,Mendocino,045,87422,1367,1237,5,1242,23
2020-11-18,Merced,047,269075,11180,10536,94,10630,166
2020-11-18,Modoc,049,8938,94,77,18,95,0
2020-11-18,Mono,051,14174,484,468,9,477,2
2020-11-18,Monterey,053,433212,14403,13340,216,13556,108
2020-11-18,Napa,055,140530,2968,2607,17,2624,17
2020-11-18,Nevada,057,99092,1139,933,27,960,9
2020-11-18,Orange,059,3164182,73139,66381,2151,68532,1521
2020-11-18,Placer,061,380077,6338,5543,102,5645,64
2020-11-18,Plumas,063,18699,183,143,0,143,0
2020-11-18,Riverside,065,2383286,84100,77739,1327,79066,1387
2020-11-18,Sacramento,067,1510023,34428,31816,79,31895,541
2020-11-18,San Benito,069,59416,1731,1632,10,1642,15
2020-11-18,San Bernardino,071,2135413,86773,77400,1086,78486,1206
2020-11-18,San Diego,073,3302833,74431,67243,2509,69752,945
2020-11-18,San Francisco,075,870044,14769,14057,84,14141,153
2020-11-18,San Joaquin,077,732212,25338,24146,421,24567,517
2020-11-18,San Luis Obispo,079,281455,6024,5322,90,5412,34
2020-11-18,San Mateo,081,765935,13693,12631,12,12643,169
2020-11-18,Santa Barbara,083,443738,11147,10684,176,10860,136
2020-11-18,Santa Clara,085,1922200,32541,29285,63,29348,421
2020-11-18,Santa Cruz,087,273765,4136,3618,43,3661,25
2020-11-18,Shasta,089,179085,4727,3547,120,3667,42
2020-11-18,Sierra,091,2930,17,11,0,11,0
2020-11-18,Siskiyou,093,43540,502,351,27,378,0
2020-11-18,Solano,095,438530,9769,8994,51,9045,84
2020-11-18,Sonoma,097,501317,11696,11129,41,11170,155
2020-11-18,Stanislaus,099,539301,20738,19609,1195,20804,431
2020-11-18,Sutter,101,95872,2893,2442,10,2452,13
2020-11-18,Tehama,103,63373,1531,1338,12,1350,8
2020-11-18,Trinity,105,12862,230,95,23,118,0
2020-11-18,Tulare,107,460477,20559,19286,1053,20339,306
2020-11-18,Tuolumne,109,53932,871,590,5,595,7
2020-11-18,Ventura,111,848112,18682,17169,549,17718,173
2020-11-18,Yolo,113,214977,4483,3929,14,3943,71
2020-11-18,Yuba,115,75493,1763,1540,9,1549,10
2020-11-17,Alameda,001,1643700,28142,26425,280,26705,439
2020-11-17,Alpine,003,1148,40,12,0,12,0
2020-11-17,Amador,005,37829,464,423,1,424,16
2020-11-17,Butte,007,227075,3816,3500,150,3650,59
2020-11-17,Calaveras,009,45235,418,405,0,405,21
2020-11-17,Colusa,011,21464,663,606,1,607,6
2020-11-17,Contra Costa,013,1133247,22781,21557,128,21685,256
2020-11-17,Del Norte,015,27424,275,233,0,233,2
2020-11-17,El Dorado,017,186661,2122,1758,17,1775,4
2020-11-17,Fresno,019,978130,39257,34765,1025,35790,472
2020-11-17,Glenn,021,27897,872,795,26,821,4
2020-11-17,Humboldt,023,135768,798,685,1,686,9
2020-11-17,Imperial,025,180216,15210,14204,74,14278,346
2020-11-17,Inyo,027,18085,286,263,5,268,15
2020-11-17,Kern,029,883053,38451,36164,854,37018,455
2020-11-17,Kings,031,150075,10476,9653,115,9768,85
2020-11-17,Lake,033,64148,873,792,0,792,18
2020-11-17,Lassen,035,31185,1481,1124,3,1127,0
2020-11-17,Los Angeles,037,10098052,360677,340933,4686,345619,7302
2020-11-17,Madera,039,155013,5923,5485,102,5587,54
2020-11-17,Marin,041,260295,7569,7404,24,7428,134
2020-11-17,Mariposa,043,17540,103,87,0,87,2
2020-11-17,Mendocino,045,87422,1346,1216,5,1221,23
2020-11-17,Merced,047,269075,11036,10457,87,10544,162
2020-11-17,Modoc,049,8938,88,71,17,88,0
2020-11-17,Mono,051,14174,479,459,9,468,2
2020-11-17,Monterey,053,433212,14174,13220,206,13426,108
2020-11-17,Napa,055,140530,2914,2568,17,2585,17
2020-11-17,Nevada,057,99092,1098,918,26,944,9
2020-11-17,Orange,059,3164182,71989,65757,2123,67880,1519
2020-11-17,Placer,061,380077,6176,5435,96,5531,63
2020-11-17,Plumas,063,18699,175,142,0,142,0
2020-11-17,Riverside,065,2383286,82713,77079,1236,78315,1379
2020-11-17,Sacramento,067,1510023,33829,31341,75,31416,538
2020-11-17,San Benito,069,59416,1715,1611,4,1615,15
2020-11-17,San Bernardino,071,2135413,84959,76134,997,77131,1188
2020-11-17,San Diego,073,3302833,73178,66321,2453,68774,933
2020-11-17,San Francisco,075,870044,14603,13952,83,14035,153
2020-11-17,San Joaquin,077,732212,25066,23997,401,24398,516
2020-11-17,San Luis Obispo,079,281455,5928,5235,90,5325,34
2020-11-17,San Mateo,081,765935,13531,12491,11,12502,169
2020-11-17,Santa Barbara,083,443738,11061,10597,171,10768,136
2020-11-17,Santa Clara,085,1922200,31994,29013,62,29075,419
2020-11-17,Santa Cruz,087,273765,4052,3548,40,3588,25
2020-11-17,Shasta,089,179085,4567,3457,108,3565,40
2020-11-17,Sierra,091,2930,15,11,0,11,0
2020-11-17,Siskiyou,093,43540,454,333,26,359,0
2020-11-17,Solano,095,438530,9624,8905,50,8955,84
2020-11-17,Sonoma,097,501317,11562,11084,39,11123,155
2020-11-17,Stanislaus,099,539301,20514,19466,1167,20633,425
2020-11-17,Sutter,101,95872,2810,2370,9,2379,12
2020-11-17,Tehama,103,63373,1480,1290,12,1302,7
2020-11-17,Trinity,105,12862,213,83,23,106,0
2020-11-17,Tulare,107,460477,20328,19176,991,20167,305
2020-11-17,Tuolumne,109,53932,833,568,5,573,7
2020-11-17,Ventura,111,848112,18410,16797,531,17328,173
2020-11-17,Yolo,113,214977,4304,3887,13,3900,70
2020-11-17,Yuba,115,75493,1715,1519,9,1528,10
2020-11-16,Alameda,001,1643700,27795,26063,275,26338,436
2020-11-16,Alpine,003,1148,37,12,0,12,0
2020-11-16,Amador,005,37829,456,414,1,415,16
2020-11-16,Butte,007,227075,3777,3490,142,3632,58
2020-11-16,Calaveras,009,45235,410,402,0,402,21
2020-11-16,Colusa,011,21464,654,601,1,602,6
2020-11-16,Contra Costa,013,1133247,22515,21386,123,21509,256
2020-11-16,Del Norte,015,27424,268,225,0,225,2
2020-11-16,El Dorado,017,186661,2062,1694,15,1709,4
2020-11-16,Fresno,019,978130,38767,34593,971,35564,471
2020-11-16,Glenn,021,27897,860,786,25,811,4
2020-11-16,Humboldt,023,135768,782,660,1,661,9
2020-11-16,Imperial,025,180216,14962,14111,74,14185,346
2020-11-16,Inyo,027,18085,283,263,5,268,15
2020-11-16,Kern,029,883053,38057,36049,811,36860,455
2020-11-16,Kings,031,150075,10209,9569,111,9680,85
2020-11-16,Lake,033,64148,861,784,0,784,18
2020-11-16,Lassen,035,31185,1300,1124,3,1127,0
2020-11-16,Los Angeles,037,10098052,355934,338778,4511,343289,7277
2020-11-16,Madera,039,155013,5836,5433,96,5529,54
2020-11-16,Marin,041,260295,7540,7359,24,7383,134
2020-11-16,Mariposa,043,17540,100,86,0,86,2
2020-11-16,Mendocino,045,87422,1321,1209,5,1214,23
2020-11-16,Merced,047,269075,10898,10399,84,10483,162
2020-11-16,Modoc,049,8938,86,71,17,88,0
2020-11-16,Mono,051,14174,477,453,9,462,2
2020-11-16,Monterey,053,433212,13928,13089,196,13285,107
2020-11-16,Napa,055,140530,2838,2536,17,2553,17
2020-11-16,Nevada,057,99092,1055,889,24,913,9
2020-11-16,Orange,059,3164182,70892,65396,2109,67505,1519
2020-11-16,Placer,061,380077,6056,5387,87,5474,63
2020-11-16,Plumas,063,18699,168,127,0,127,0
2020-11-16,Riverside,065,2383286,81338,76449,1171,77620,1379
2020-11-16,Sacramento,067,1510023,33191,30954,69,31023,534
2020-11-16,San Benito,069,59416,1697,1603,3,1606,15
2020-11-16,San Bernardino,071,2135413,83131,74401,928,75329,1186
2020-11-16,San Diego,073,3302833,71867,65603,2381,67984,926
2020-11-16,San Francisco,075,870044,14444,13847,80,13927,153
2020-11-16,San Joaquin,077,732212,24778,23515,392,23907,513
2020-11-16,San Luis Obispo,079,281455,5824,5161,85,5246,34
2020-11-16,San Mateo,081,765935,13371,12398,11,12409,169
2020-11-16,Santa Barbara,083,443738,10997,10565,167,10732,135
2020-11-16,Santa Clara,085,1922200,31428,28673,61,28734,419
2020-11-16,Santa Cruz,087,273765,3979,3520,40,3560,25
2020-11-16,Shasta,089,179085,4418,3284,103,3387,37
2020-11-16,Sierra,091,2930,15,11,0,11,0
2020-11-16,Siskiyou,093,43540,427,294,26,320,0
2020-11-16,Solano,095,438530,9425,8827,50,8877,84
2020-11-16,Sonoma,097,501317,11471,10961,38,10999,155
2020-11-16,Stanislaus,099,539301,20277,19333,1140,20473,425
2020-11-16,Sutter,101,95872,2704,2322,9,2331,12
2020-11-16,Tehama,103,63373,1435,1261,8,1269,7
2020-11-16,Trinity,105,12862,201,67,23,90,0
2020-11-16,Tulare,107,460477,20149,18891,938,19829,305
2020-11-16,Tuolumne,109,53932,797,543,5,548,7
2020-11-16,Ventura,111,848112,18072,16691,523,17214,172
2020-11-16,Yolo,113,214977,4208,3858,13,3871,70
2020-11-16,Yuba,115,75493,1679,1500,8,1508,10
2020-11-15,Alameda,001,1643700,27477,25879,269,26148,436
2020-11-15,Alpine,003,1148,35,12,0,12,0
2020-11-15,Amador,005,37829,444,409,1,410,16
2020-11-15,Butte,007,227075,3723,3452,133,3585,58
2020-11-15,Calaveras,009,45235,396,386,0,386,21
2020-11-15,Colusa,011,21464,645,601,1,602,6
2020-11-15,Contra Costa,013,1133247,22216,21179,122,21301,256
2020-11-15,Del Norte,015,27424,253,224,0,224,2
2020-11-15,El Dorado,017,186661,2000,1683,14,1697,4
2020-11-15,Fresno,019,978130,38254,34297,933,35230,471
2020-11-15,Glenn,021,27897,848,783,24,807,4
2020-11-15,Humboldt,023,135768,753,653,1,654,9
2020-11-15,Imperial,025,180216,14725,13940,74,14014,346
2020-11-15,Inyo,027,18085,273,263,5,268,15
2020-11-15,Kern,029,883053,37652,35911,776,36687,455
2020-11-15,Kings,031,150075,10016,9533,107,9640,85
2020-11-15,Lake,033,64148,852,777,0,777,17
2020-11-15,Lassen,035,31185,1253,1124,3,1127,0
2020-11-15,Los Angeles,037,10098052,350894,336035,4339,340374,7271
2020-11-15,Madera,039,155013,5739,5391,90,5481,54
2020-11-15,Marin,041,260295,7514,7347,24,7371,133
2020-11-15,Mariposa,043,17540,97,86,0,86,2
2020-11-15,Mendocino,045,87422,1302,1197,5,1202,22
2020-11-15,Merced,047,269075,10765,10350,84,10434,162
2020-11-15,Modoc,049,8938,85,68,17,85,0
2020-11-15,Mono,051,14174,475,453,9,462,2
2020-11-15,Monterey,053,433212,13731,12999,183,13182,107
2020-11-15,Napa,055,140530,2779,2509,15,2524,17
2020-11-15,Nevada,057,99092,1000,859,24,883,9
2020-11-15,Orange,059,3164182,69851,65008,2093,67101,1519
2020-11-15,Placer,061,380077,5901,5330,79,5409,63
2020-11-15,Plumas,063,18699,162,127,0,127,0
2020-11-15,Riverside,065,2383286,80014,75531,1112,76643,1374
2020-11-15,Sacramento,067,1510023,32565,30601,65,30666,534
2020-11-15,San Benito,069,59416,1672,1589,2,1591,15
2020-11-15,San Bernardino,071,2135413,80978,73769,853,74622,1185
2020-11-15,San Diego,073,3302833,70366,64770,2324,67094,926
2020-11-15,San Francisco,075,870044,14268,13757,79,13836,153
2020-11-15,San Joaquin,077,732212,24569,23516,376,23892,513
2020-11-15,San Luis Obispo,079,281455,5699,5120,83,5203,34
2020-11-15,San Mateo,081,765935,13194,12348,11,12359,169
2020-11-15,Santa Barbara,083,443738,10902,10516,165,10681,135
2020-11-15,Santa Clara,085,1922200,30974,28289,60,28349,418
2020-11-15,Santa Cruz,087,273765,3841,3439,39,3478,25
2020-11-15,Shasta,089,179085,4244,3290,94,3384,37
2020-11-15,Sierra,091,2930,15,11,0,11,0
2020-11-15,Siskiyou,093,43540,408,294,26,320,0
2020-11-15,Solano,095,438530,9264,8713,47,8760,84
2020-11-15,Sonoma,097,501317,11351,10833,37,10870,154
2020-11-15,Stanislaus,099,539301,20005,19228,1115,20343,425
2020-11-15,Sutter,101,95872,2614,2230,9,2239,12
2020-11-15,Tehama,103,63373,1384,1222,7,1229,7
2020-11-15,Trinity,105,12862,191,67,21,88,0
2020-11-15,Tulare,107,460477,19932,18891,885,19776,305
2020-11-15,Tuolumne,109,53932,755,486,5,491,7
2020-11-15,Ventura,111,848112,17798,16564,515,17079,172
2020-11-15,Yolo,113,214977,4105,3819,12,3831,67
2020-11-15,Yuba,115,75493,1638,1470,7,1477,10
2020-11-14,Alameda,001,1643700,27210,25714,267,25981,435
2020-11-14,Alpine,003,1148,35,12,0,12,0
2020-11-14,Amador,005,37829,435,404,0,404,16
2020-11-14,Butte,007,227075,3687,3434,119,3553,58
2020-11-14,Calaveras,009,45235,395,386,0,386,21
2020-11-14,Colusa,011,21464,633,601,1,602,6
2020-11-14,Contra Costa,013,1133247,22077,20975,115,21090,256
2020-11-14,Del Norte,015,27424,247,219,0,219,2
2020-11-14,El Dorado,017,186661,1956,1648,14,1662,4
2020-11-14,Fresno,019,978130,38004,33969,896,34865,471
2020-11-14,Glenn,021,27897,839,772,21,793,3
2020-11-14,Humboldt,023,135768,738,643,1,644,9
2020-11-14,Imperial,025,180216,14632,13932,73,14005,346
2020-11-14,Inyo,027,18085,272,263,5,268,15
2020-11-14,Kern,029,883053,37443,35626,757,36383,454
2020-11-14,Kings,031,150075,9981,9490,104,9594,85
2020-11-14,Lake,033,64148,843,773,0,773,17
2020-11-14,Lassen,035,31185,1239,833,3,836,0
2020-11-14,Los Angeles,037,10098052,348187,333021,4230,337251,7269
2020-11-14,Madera,039,155013,5709,5371,88,5459,54
2020-11-14,Marin,041,260295,7498,7325,24,7349,133
2020-11-14,Mariposa,043,17540,96,86,0,86,2
2020-11-14,Mendocino,045,87422,1286,1181,5,1186,22
2020-11-14,Merced,047,269075,10709,10286,82,10368,161
2020-11-14,Modoc,049,8938,84,64,16,80,0
2020-11-14,Mono,051,14174,475,453,9,462,2
2020-11-14,Monterey,053,433212,13635,12854,173,13027,105
2020-11-14,Napa,055,140530,2745,2473,15,2488,17
2020-11-14,Nevada,057,99092,984,835,24,859,9
2020-11-14,Orange,059,3164182,69230,64340,2082,66422,1517
2020-11-14,Placer,061,380077,5825,5215,73,5288,63
2020-11-14,Plumas,063,18699,157,128,0,128,0
2020-11-14,Riverside,065,2383286,79273,74910,1072,75982,1373
2020-11-14,Sacramento,067,1510023,32239,30298,65,30363,532
2020-11-14,San Benito,069,59416,1657,1573,2,1575,15
2020-11-14,San Bernardino,071,2135413,80044,72868,821,73689,1184
2020-11-14,San Diego,073,3302833,69601,63715,2272,65987,926
2020-11-14,San Francisco,075,870044,14180,13661,78,13739,153
2020-11-14,San Joaquin,077,732212,24478,23516,368,23884,511
2020-11-14,San Luis Obispo,079,281455,5635,5073,78,5151,34
2020-11-14,San Mateo,081,765935,13086,12293,11,12304,169
2020-11-14,Santa Barbara,083,443738,10848,10482,163,10645,135
2020-11-14,Santa Clara,085,1922200,30689,27962,58,28020,416
2020-11-14,Santa Cruz,087,273765,3786,3402,39,3441,25
2020-11-14,Shasta,089,179085,4161,3195,92,3287,37
2020-11-14,Sierra,091,2930,15,11,0,11,0
2020-11-14,Siskiyou,093,43540,395,292,26,318,0
2020-11-14,Solano,095,438530,9184,8655,46,8701,84
2020-11-14,Sonoma,097,501317,11298,10769,37,10806,154
2020-11-14,Stanislaus,099,539301,19863,19068,1093,20161,424
2020-11-14,Sutter,101,95872,2569,2182,9,2191,12
2020-11-14,Tehama,103,63373,1363,1206,6,1212,7
2020-11-14,Trinity,105,12862,186,67,21,88,0
2020-11-14,Tulare,107,460477,19837,18853,857,19710,305
2020-11-14,Tuolumne,109,53932,727,448,5,453,7
2020-11-14,Ventura,111,848112,17652,16297,504,16801,172
2020-11-14,Yolo,113,214977,4062,3765,10,3775,65
2020-11-14,Yuba,115,75493,1609,1453,7,1460,10
2020-11-13,Alameda,001,1643700,26994,25515,262,25777,434
2020-11-13,Alpine,003,1148,35,12,0,12,0
2020-11-13,Amador,005,37829,432,397,0,397,16
2020-11-13,Butte,007,227075,3663,3402,110,3512,58
2020-11-13,Calaveras,009,45235,391,378,0,378,21
2020-11-13,Colusa,011,21464,625,598,1,599,6
2020-11-13,Contra Costa,013,1133247,21904,20799,115,20914,256
2020-11-13,Del Norte,015,27424,244,208,0,208,2
2020-11-13,El Dorado,017,186661,1911,1611,13,1624,4
2020-11-13,Fresno,019,978130,37757,33693,882,34575,470
2020-11-13,Glenn,021,27897,825,755,17,772,3
2020-11-13,Humboldt,023,135768,723,638,1,639,9
2020-11-13,Imperial,025,180216,14562,13790,72,13862,341
2020-11-13,Inyo,027,18085,271,262,5,267,15
2020-11-13,Kern,029,883053,37241,35431,740,36171,453
2020-11-13,Kings,031,150075,9922,9428,103,9531,85
2020-11-13,Lake,033,64148,837,770,0,770,17
2020-11-13,Lassen,035,31185,1230,832,3,835,0
2020-11-13,Los Angeles,037,10098052,345061,329364,4123,333487,7248
2020-11-13,Madera,039,155013,5669,5340,87,5427,54
2020-11-13,Marin,041,260295,7485,7307,23,7330,133
2020-11-13,Mariposa,043,17540,94,86,0,86,2
2020-11-13,Mendocino,045,87422,1274,1173,5,1178,22
2020-11-13,Merced,047,269075,10653,10185,79,10264,159
2020-11-13,Modoc,049,8938,84,63,14,77,0
2020-11-13,Mono,051,14174,475,448,8,456,2
2020-11-13,Monterey,053,433212,13439,12681,161,12842,104
2020-11-13,Napa,055,140530,2706,2440,15,2455,17
2020-11-13,Nevada,057,99092,965,798,24,822,9
2020-11-13,Orange,059,3164182,68631,63804,2062,65866,1514
2020-11-13,Placer,061,380077,5720,5122,67,5189,63
2020-11-13,Plumas,063,18699,151,125,0,125,0
2020-11-13,Riverside,065,2383286,78534,74138,1043,75181,1372
2020-11-13,Sacramento,067,1510023,31921,29787,60,29847,524
2020-11-13,San Benito,069,59416,1645,1553,1,1554,15
2020-11-13,San Bernardino,071,2135413,78996,71895,800,72695,1184
2020-11-13,San Diego,073,3302833,68754,62978,2234,65212,921
2020-11-13,San Francisco,075,870044,14087,13516,76,13592,146
2020-11-13,San Joaquin,077,732212,24383,23314,362,23676,510
2020-11-13,San Luis Obispo,079,281455,5568,4960,75,5035,34
2020-11-13,San Mateo,081,765935,12992,12182,11,12193,169
2020-11-13,Santa Barbara,083,443738,10796,10405,161,10566,134
2020-11-13,Santa Clara,085,1922200,30362,27609,56,27665,415
2020-11-13,Santa Cruz,087,273765,3713,3343,39,3382,25
2020-11-13,Shasta,089,179085,4077,2983,88,3071,37
2020-11-13,Sierra,091,2930,15,11,0,11,0
2020-11-13,Siskiyou,093,43540,390,280,25,305,0
2020-11-13,Solano,095,438530,9093,8525,46,8571,84
2020-11-13,Sonoma,097,501317,11237,10685,35,10720,151
2020-11-13,Stanislaus,099,539301,19738,18936,1065,20001,422
2020-11-13,Sutter,101,95872,2523,2121,8,2129,12
2020-11-13,Tehama,103,63373,1335,1167,6,1173,7
2020-11-13,Trinity,105,12862,184,64,21,85,0
2020-11-13,Tulare,107,460477,19713,18714,816,19530,305
2020-11-13,Tuolumne,109,53932,694,427,5,432,7
2020-11-13,Ventura,111,848112,17506,16172,490,16662,171
2020-11-13,Yolo,113,214977,4011,3716,10,3726,65
2020-11-13,Yuba,115,75493,1582,1435,7,1442,10
2020-11-12,Alameda,001,1643700,26727,25345,262,25607,432
2020-11-12,Alpine,003,1148,34,12,0,12,0
2020-11-12,Amador,005,37829,431,392,0,392,16
2020-11-12,Butte,007,227075,3614,3347,107,3454,58
2020-11-12,Calaveras,009,45235,386,373,0,373,21
2020-11-12,Colusa,011,21464,620,591,1,592,6
2020-11-12,Contra Costa,013,1133247,21697,20619,113,20732,255
2020-11-12,Del Norte,015,27424,237,203,0,203,2
2020-11-12,El Dorado,017,186661,1865,1573,9,1582,4
2020-11-12,Fresno,019,978130,37408,33459,840,34299,468
2020-11-12,Glenn,021,27897,806,727,17,744,3
2020-11-12,Humboldt,023,135768,710,625,1,626,9
2020-11-12,Imperial,025,180216,14397,13619,72,13691,341
2020-11-12,Inyo,027,18085,270,255,5,260,15
2020-11-12,Kern,029,883053,36976,35207,725,35932,451
2020-11-12,Kings,031,150075,9855,9335,102,9437,85
2020-11-12,Lake,033,64148,828,764,0,764,17
2020-11-12,Lassen,035,31185,1161,832,2,834,0
2020-11-12,Los Angeles,037,10098052,341320,327001,4022,331023,7223
2020-11-12,Madera,039,155013,5634,5273,82,5355,54
2020-11-12,Marin,041,260295,7456,7268,23,7291,133
2020-11-12,Mariposa,043,17540,92,84,0,84,2
2020-11-12,Mendocino,045,87422,1255,1142,5,1147,22
2020-11-12,Merced,047,269075,10539,10107,76,10183,158
2020-11-12,Modoc,049,8938,84,63,14,77,0
2020-11-12,Mono,051,14174,474,442,8,450,2
2020-11-12,Monterey,053,433212,13318,12489,147,12636,100
2020-11-12,Napa,055,140530,2644,2398,15,2413,16
2020-11-12,Nevada,057,99092,942,780,23,803,9
2020-11-12,Orange,059,3164182,67886,63232,2043,65275,1514
2020-11-12,Placer,061,380077,5610,5044,58,5102,62
2020-11-12,Plumas,063,18699,147,121,0,121,0
2020-11-12,Riverside,065,2383286,77601,73381,1000,74381,1362
2020-11-12,Sacramento,067,1510023,31430,29459,53,29512,520
2020-11-12,San Benito,069,59416,1625,1525,1,1526,15
2020-11-12,San Bernardino,071,2135413,77630,70758,761,71519,1183
2020-11-12,San Diego,073,3302833,67774,62336,2183,64519,918
2020-11-12,San Francisco,075,870044,13988,13289,75,13364,146
2020-11-12,San Joaquin,077,732212,24190,23002,341,23343,509
2020-11-12,San Luis Obispo,079,281455,5504,4898,74,4972,33
2020-11-12,San Mateo,081,765935,12868,12086,10,12096,169
2020-11-12,Santa Barbara,083,443738,10734,10325,156,10481,134
2020-11-12,Santa Clara,085,1922200,29986,27261,55,27316,414
2020-11-12,Santa Cruz,087,273765,3630,3317,37,3354,25
2020-11-12,Shasta,089,179085,3939,2825,77,2902,37
2020-11-12,Sierra,091,2930,15,11,0,11,0
2020-11-12,Siskiyou,093,43540,373,275,20,295,0
2020-11-12,Solano,095,438530,8993,8417,45,8462,85
2020-11-12,Sonoma,097,501317,11135,10602,34,10636,151
2020-11-12,Stanislaus,099,539301,19569,18787,1036,19823,422
2020-11-12,Sutter,101,95872,2439,2075,7,2082,12
2020-11-12,Tehama,103,63373,1308,1117,6,1123,7
2020-11-12,Trinity,105,12862,176,62,20,82,0
2020-11-12,Tulare,107,460477,19601,18545,778,19323,305
2020-11-12,Tuolumne,109,53932,655,353,5,358,7
2020-11-12,Ventura,111,848112,17256,16013,484,16497,158
2020-11-12,Yolo,113,214977,3967,3646,10,3656,63
2020-11-12,Yuba,115,75493,1547,1410,7,1417,10
2020-11-11,Alameda,001,1643700,26484,25140,260,25400,429
2020-11-11,Alpine,003,1148,29,12,0,12,0
2020-11-11,Amador,005,37829,424,389,0,389,16
2020-11-11,Butte,007,227075,3588,3348,94,3442,58
2020-11-11,Calaveras,009,45235,376,373,0,373,21
2020-11-11,Colusa,011,21464,614,591,1,592,6
2020-11-11,Contra Costa,013,1133247,21479,20452,111,20563,255
2020-11-11,Del Norte,015,27424,230,203,0,203,2
2020-11-11,El Dorado,017,186661,1819,1564,8,1572,4
2020-11-11,Fresno,019,978130,37088,33287,805,34092,468
2020-11-11,Glenn,021,27897,790,722,16,738,3
2020-11-11,Humboldt,023,135768,696,623,1,624,9
2020-11-11,Imperial,025,180216,14226,13623,70,13693,340
2020-11-11,Inyo,027,18085,268,255,5,260,15
2020-11-11,Kern,029,883053,36701,35014,708,35722,449
2020-11-11,Kings,031,150075,9749,9263,99,9362,85
2020-11-11,Lake,033,64148,818,763,0,763,17
2020-11-11,Lassen,035,31185,1136,831,2,833,0
2020-11-11,Los Angeles,037,10098052,337958,324567,3936,328503,7220
2020-11-11,Madera,039,155013,5599,5248,80,5328,54
2020-11-11,Marin,041,260295,7433,7268,23,7291,133
2020-11-11,Mariposa,043,17540,92,84,0,84,2
2020-11-11,Mendocino,045,87422,1243,1142,5,1147,22
2020-11-11,Merced,047,269075,10468,10074,74,10148,157
2020-11-11,Modoc,049,8938,80,62,13,75,0
2020-11-11,Mono,051,14174,472,443,8,451,2
2020-11-11,Monterey,053,433212,13174,12417,143,12560,100
2020-11-11,Napa,055,140530,2595,2365,12,2377,15
2020-11-11,Nevada,057,99092,900,741,23,764,9
2020-11-11,Orange,059,3164182,67248,62929,2020,64949,1506
2020-11-11,Placer,061,380077,5526,4981,50,5031,60
2020-11-11,Plumas,063,18699,145,111,0,111,0
2020-11-11,Riverside,065,2383286,76697,72953,954,73907,1361
2020-11-11,Sacramento,067,1510023,30973,28968,51,29019,520
2020-11-11,San Benito,069,59416,1611,1512,1,1513,15
2020-11-11,San Bernardino,071,2135413,76343,70374,734,71108,1182
2020-11-11,San Diego,073,3302833,66839,61746,2122,63868,918
2020-11-11,San Francisco,075,870044,13880,13287,74,13361,146
2020-11-11,San Joaquin,077,732212,24030,23001,335,23336,509
2020-11-11,San Luis Obispo,079,281455,5428,4832,71,4903,33
2020-11-11,San Mateo,081,765935,12753,12008,10,12018,169
2020-11-11,Santa Barbara,083,443738,10669,10278,156,10434,134
2020-11-11,Santa Clara,085,1922200,29633,27075,54,27129,413
2020-11-11,Santa Cruz,087,273765,3562,3247,37,3284,25
2020-11-11,Shasta,089,179085,3815,2766,67,2833,36
2020-11-11,Sierra,091,2930,13,11,0,11,0
2020-11-11,Siskiyou,093,43540,342,261,17,278,0
2020-11-11,Solano,095,438530,8875,8353,43,8396,85
2020-11-11,Sonoma,097,501317,11061,10498,34,10532,150
2020-11-11,Stanislaus,099,539301,19432,18671,1006,19677,422
2020-11-11,Sutter,101,95872,2391,2049,6,2055,12
2020-11-11,Tehama,103,63373,1266,1105,5,1110,7
2020-11-11,Trinity,105,12862,165,62,20,82,0
2020-11-11,Tulare,107,460477,19470,18500,747,19247,305
2020-11-11,Tuolumne,109,53932,599,354,4,358,7
2020-11-11,Ventura,111,848112,17041,15801,470,16271,158
2020-11-11,Yolo,113,214977,3916,3606,10,3616,63
2020-11-11,Yuba,115,75493,1532,1400,7,1407,10
2020-11-10,Alameda,001,1643700,26254,25008,257,25265,424
2020-11-10,Alpine,003,1148,29,9,0,9,0
2020-11-10,Amador,005,37829,418,384,0,384,16
2020-11-10,Butte,007,227075,3552,3327,90,3417,58
2020-11-10,Calaveras,009,45235,371,367,0,367,21
2020-11-10,Colusa,011,21464,606,590,1,591,6
2020-11-10,Contra Costa,013,1133247,21272,20326,109,20435,255
2020-11-10,Del Norte,015,27424,224,196,0,196,2
2020-11-10,El Dorado,017,186661,1758,1551,8,1559,4
2020-11-10,Fresno,019,978130,36818,33024,767,33791,465
2020-11-10,Glenn,021,27897,782,719,12,731,3
2020-11-10,Humboldt,023,135768,679,610,1,611,9
2020-11-10,Imperial,025,180216,14097,13570,70,13640,338
2020-11-10,Inyo,027,18085,267,252,5,257,14
2020-11-10,Kern,029,883053,36424,34858,689,35547,448
2020-11-10,Kings,031,150075,9702,9236,92,9328,85
2020-11-10,Lake,033,64148,808,762,0,762,16
2020-11-10,Lassen,035,31185,1121,830,2,832,0
2020-11-10,Los Angeles,037,10098052,334705,322569,3821,326390,7205
2020-11-10,Madera,039,155013,5557,5229,74,5303,54
2020-11-10,Marin,041,260295,7414,7259,23,7282,133
2020-11-10,Mariposa,043,17540,90,84,0,84,2
2020-11-10,Mendocino,045,87422,1235,1137,5,1142,22
2020-11-10,Merced,047,269075,10406,9992,68,10060,157
2020-11-10,Modoc,049,8938,78,61,13,74,0
2020-11-10,Mono,051,14174,470,443,8,451,2
2020-11-10,Monterey,053,433212,13036,12335,135,12470,100
2020-11-10,Napa,055,140530,2557,2341,10,2351,15
2020-11-10,Nevada,057,99092,884,734,23,757,9
2020-11-10,Orange,059,3164182,66697,62597,2010,64607,1504
2020-11-10,Placer,061,380077,5446,4902,49,4951,60
2020-11-10,Plumas,063,18699,141,108,0,108,0
2020-11-10,Riverside,065,2383286,76055,72316,927,73243,1359
2020-11-10,Sacramento,067,1510023,30566,28677,48,28725,519
2020-11-10,San Benito,069,59416,1596,1508,1,1509,15
2020-11-10,San Bernardino,071,2135413,75173,69666,701,70367,1182
2020-11-10,San Diego,073,3302833,65948,61085,2085,63170,915
2020-11-10,San Francisco,075,870044,13763,13210,74,13284,146
2020-11-10,San Joaquin,077,732212,23865,22865,328,23193,508
2020-11-10,San Luis Obispo,079,281455,5364,4780,68,4848,33
2020-11-10,San Mateo,081,765935,12652,11939,10,11949,169
2020-11-10,Santa Barbara,083,443738,10602,10252,152,10404,134
2020-11-10,Santa Clara,085,1922200,29289,26917,53,26970,409
2020-11-10,Santa Cruz,087,273765,3498,3221,37,3258,25
2020-11-10,Shasta,089,179085,3672,2686,59,2745,36
2020-11-10,Sierra,091,2930,12,10,0,10,0
2020-11-10,Siskiyou,093,43540,326,263,16,279,0
2020-11-10,Solano,095,438530,8777,8299,43,8342,85
2020-11-10,Sonoma,097,501317,10974,10414,34,10448,150
2020-11-10,Stanislaus,099,539301,19298,18592,982,19574,420
2020-11-10,Sutter,101,95872,2296,2035,5,2040,12
2020-11-10,Tehama,103,63373,1240,1099,4,1103,7
2020-11-10,Trinity,105,12862,156,62,18,80,0
2020-11-10,Tulare,107,460477,19356,18430,723,19153,305
2020-11-10,Tuolumne,109,53932,551,353,4,357,7
2020-11-10,Ventura,111,848112,16858,15625,468,16093,158
2020-11-10,Yolo,113,214977,3855,3573,10,3583,63
2020-11-10,Yuba,115,75493,1509,1392,7,1399,10
2020-11-09,Alameda,001,1643700,26005,24899,253,25152,424
2020-11-09,Alpine,003,1148,27,6,0,6,0
2020-11-09,Amador,005,37829,409,380,0,380,16
2020-11-09,Butte,007,227075,3507,3301,81,3382,57
2020-11-09,Calaveras,009,45235,367,360,0,360,21
2020-11-09,Colusa,011,21464,600,583,1,584,6
2020-11-09,Contra Costa,013,1133247,21099,20193,107,20300,255
2020-11-09,Del Norte,015,27424,218,195,0,195,2
2020-11-09,El Dorado,017,186661,1717,1515,8,1523,4
2020-11-09,Fresno,019,978130,36507,32755,727,33482,465
2020-11-09,Glenn,021,27897,776,714,9,723,3
2020-11-09,Humboldt,023,135768,666,607,1,608,9
2020-11-09,Imperial,025,180216,13980,13508,68,13576,338
2020-11-09,Inyo,027,18085,267,252,5,257,14
2020-11-09,Kern,029,883053,36193,34764,653,35417,448
2020-11-09,Kings,031,150075,9632,9141,90,9231,84
2020-11-09,Lake,033,64148,799,755,0,755,16
2020-11-09,Lassen,035,31185,1025,799,2,801,0
2020-11-09,Los Angeles,037,10098052,331608,320370,3745,324115,7180
2020-11-09,Madera,039,155013,5511,5209,71,5280,54
2020-11-09,Marin,041,260295,7388,7237,22,7259,131
2020-11-09,Mariposa,043,17540,90,84,0,84,2
2020-11-09,Mendocino,045,87422,1223,1132,5,1137,22
2020-11-09,Merced,047,269075,10303,9922,65,9987,157
2020-11-09,Modoc,049,8938,74,54,12,66,0
2020-11-09,Mono,051,14174,467,352,8,360,2
2020-11-09,Monterey,053,433212,12889,12148,126,12274,98
2020-11-09,Napa,055,140530,2514,2309,10,2319,15
2020-11-09,Nevada,057,99092,847,729,22,751,9
2020-11-09,Orange,059,3164182,66056,62335,1998,64333,1501
2020-11-09,Placer,061,380077,5361,4843,37,4880,60
2020-11-09,Plumas,063,18699,134,102,0,102,0
2020-11-09,Riverside,065,2383286,75272,72059,893,72952,1346
2020-11-09,Sacramento,067,1510023,30095,28200,48,28248,516
2020-11-09,San Benito,069,59416,1587,1506,1,1507,15
2020-11-09,San Bernardino,071,2135413,74118,69015,659,69674,1182
2020-11-09,San Diego,073,3302833,65093,60572,2045,62617,908
2020-11-09,San Francisco,075,870044,13643,12984,71,13055,146
2020-11-09,San Joaquin,077,732212,23700,22512,323,22835,505
2020-11-09,San Luis Obispo,079,281455,5277,4746,66,4812,32
2020-11-09,San Mateo,081,765935,12545,11857,10,11867,169
2020-11-09,Santa Barbara,083,443738,10545,10214,146,10360,134
2020-11-09,Santa Clara,085,1922200,28894,26693,53,26746,409
2020-11-09,Santa Cruz,087,273765,3440,3194,37,3231,25
2020-11-09,Shasta,089,179085,3519,2581,50,2631,36
2020-11-09,Sierra,091,2930,10,10,0,10,0
2020-11-09,Siskiyou,093,43540,315,257,14,271,0
2020-11-09,Solano,095,438530,8661,8254,42,8296,85
2020-11-09,Sonoma,097,501317,10866,10310,34,10344,150
2020-11-09,Stanislaus,099,539301,19145,18482,965,19447,418
2020-11-09,Sutter,101,95872,2229,2010,4,2014,12
2020-11-09,Tehama,103,63373,1204,1071,3,1074,7
2020-11-09,Trinity,105,12862,149,46,18,64,0
2020-11-09,Tulare,107,460477,19236,18272,691,18963,304
2020-11-09,Tuolumne,109,53932,497,346,4,350,7
2020-11-09,Ventura,111,848112,16656,15568,465,16033,156
2020-11-09,Yolo,113,214977,3795,3522,9,3531,62
2020-11-09,Yuba,115,75493,1476,1380,7,1387,10
2020-11-08,Alameda,001,1643700,25775,24731,253,24984,424
2020-11-08,Alpine,003,1148,24,6,0,6,0
2020-11-08,Amador,005,37829,402,376,0,376,16
2020-11-08,Butte,007,227075,3469,3285,74,3359,57
2020-11-08,Calaveras,009,45235,365,360,0,360,21
2020-11-08,Colusa,011,21464,597,583,1,584,6
2020-11-08,Contra Costa,013,1133247,20929,20031,105,20136,254
2020-11-08,Del Norte,015,27424,210,195,0,195,2
2020-11-08,El Dorado,017,186661,1679,1502,8,1510,4
2020-11-08,Fresno,019,978130,36171,32619,689,33308,465
2020-11-08,Glenn,021,27897,770,707,8,715,3
2020-11-08,Humboldt,023,135768,650,605,1,606,9
2020-11-08,Imperial,025,180216,13864,13428,68,13496,338
2020-11-08,Inyo,027,18085,263,252,5,257,14
2020-11-08,Kern,029,883053,35974,34644,636,35280,448
2020-11-08,Kings,031,150075,9498,9026,87,9113,84
2020-11-08,Lake,033,64148,791,754,0,754,16
2020-11-08,Lassen,035,31185,877,799,2,801,0
2020-11-08,Los Angeles,037,10098052,328482,318960,3677,322637,7176
2020-11-08,Madera,039,155013,5442,5196,68,5264,54
2020-11-08,Marin,041,260295,7368,7227,22,7249,131
2020-11-08,Mariposa,043,17540,90,83,0,83,2
2020-11-08,Mendocino,045,87422,1214,1129,5,1134,22
2020-11-08,Merced,047,269075,10228,9885,63,9948,157
2020-11-08,Modoc,049,8938,70,54,12,66,0
2020-11-08,Mono,051,14174,461,352,8,360,2
2020-11-08,Monterey,053,433212,12744,12122,115,12237,98
2020-11-08,Napa,055,140530,2474,2274,10,2284,15
2020-11-08,Nevada,057,99092,831,715,22,737,9
2020-11-08,Orange,059,3164182,65467,62034,1984,64018,1501
2020-11-08,Placer,061,380077,5258,4800,32,4832,60
2020-11-08,Plumas,063,18699,129,102,0,102,0
2020-11-08,Riverside,065,2383286,74617,71442,851,72293,1345
2020-11-08,Sacramento,067,1510023,29535,28059,45,28104,515
2020-11-08,San Benito,069,59416,1572,1496,1,1497,15
2020-11-08,San Bernardino,071,2135413,72867,68412,620,69032,1182
2020-11-08,San Diego,073,3302833,64248,60199,2001,62200,908
2020-11-08,San Francisco,075,870044,13512,12985,66,13051,146
2020-11-08,San Joaquin,077,732212,23506,22514,319,22833,505
2020-11-08,San Luis Obispo,079,281455,5211,4698,61,4759,32
2020-11-08,San Mateo,081,765935,12426,11783,10,11793,169
2020-11-08,Santa Barbara,083,443738,10475,10180,144,10324,134
2020-11-08,Santa Clara,085,1922200,28520,26442,52,26494,410
2020-11-08,Santa Cruz,087,273765,3383,3134,37,3171,25
2020-11-08,Shasta,089,179085,3382,2582,44,2626,36
2020-11-08,Sierra,091,2930,10,7,0,7,0
2020-11-08,Siskiyou,093,43540,303,246,13,259,0
2020-11-08,Solano,095,438530,8540,8132,41,8173,85
2020-11-08,Sonoma,097,501317,10759,10229,34,10263,149
2020-11-08,Stanislaus,099,539301,18969,18413,944,19357,418
2020-11-08,Sutter,101,95872,2171,1980,4,1984,12
2020-11-08,Tehama,103,63373,1180,1054,3,1057,7
2020-11-08,Trinity,105,12862,146,46,17,63,0
2020-11-08,Tulare,107,460477,19093,18272,661,18933,304
2020-11-08,Tuolumne,109,53932,470,341,4,345,7
2020-11-08,Ventura,111,848112,16461,15504,457,15961,156
2020-11-08,Yolo,113,214977,3734,3492,9,3501,61
2020-11-08,Yuba,115,75493,1455,1369,7,1376,10
2020-11-07,Alameda,001,1643700,25665,24578,251,24829,424
2020-11-07,Alpine,003,1148,24,6,0,6,0
2020-11-07,Amador,005,37829,399,375,0,375,16
2020-11-07,Butte,007,227075,3457,3277,69,3346,57
2020-11-07,Calaveras,009,45235,363,360,0,360,21
2020-11-07,Colusa,011,21464,597,583,1,584,6
2020-11-07,Contra Costa,013,1133247,20828,19943,104,20047,254
2020-11-07,Del Norte,015,27424,206,194,0,194,2
2020-11-07,El Dorado,017,186661,1654,1495,7,1502,4
2020-11-07,Fresno,019,978130,36017,32497,666,33163,465
2020-11-07,Glenn,021,27897,762,707,8,715,3
2020-11-07,Humboldt,023,135768,639,590,1,591,9
2020-11-07,Imperial,025,180216,13806,13388,67,13455,338
2020-11-07,Inyo,027,18085,261,252,5,257,14
2020-11-07,Kern,029,883053,35819,34513,626,35139,448
2020-11-07,Kings,031,150075,9465,9005,81,9086,84
2020-11-07,Lake,033,64148,787,751,0,751,16
2020-11-07,Lassen,035,31185,861,799,2,801,0
2020-11-07,Los Angeles,037,10098052,326974,316756,3609,320365,7174
2020-11-07,Madera,039,155013,5420,5177,66,5243,54
2020-11-07,Marin,041,260295,7357,7215,22,7237,131
2020-11-07,Mariposa,043,17540,90,81,0,81,2
2020-11-07,Mendocino,045,87422,1203,1118,5,1123,22
2020-11-07,Merced,047,269075,10196,9855,59,9914,157
2020-11-07,Modoc,049,8938,70,51,12,63,0
2020-11-07,Mono,051,14174,458,352,8,360,2
2020-11-07,Monterey,053,433212,12675,12030,111,12141,98
2020-11-07,Napa,055,140530,2444,2260,9,2269,15
2020-11-07,Nevada,057,99092,814,710,22,732,9
2020-11-07,Orange,059,3164182,65181,62038,1978,64016,1505
2020-11-07,Placer,061,380077,5195,4745,32,4777,60
2020-11-07,Plumas,063,18699,127,94,0,94,0
2020-11-07,Riverside,065,2383286,74222,71153,823,71976,1345
2020-11-07,Sacramento,067,1510023,29284,27773,45,27818,515
2020-11-07,San Benito,069,59416,1560,1489,1,1490,15
2020-11-07,San Bernardino,071,2135413,72352,67935,609,68544,1182
2020-11-07,San Diego,073,3302833,63736,59682,1969,61651,909
2020-11-07,San Francisco,075,870044,13451,12980,65,13045,146
2020-11-07,San Joaquin,077,732212,23397,22517,313,22830,505
2020-11-07,San Luis Obispo,079,281455,5162,4668,58,4726,32
2020-11-07,San Mateo,081,765935,12363,11711,10,11721,169
2020-11-07,Santa Barbara,083,443738,10433,10157,142,10299,134
2020-11-07,Santa Clara,085,1922200,28315,26244,51,26295,410
2020-11-07,Santa Cruz,087,273765,3345,3130,37,3167,25
2020-11-07,Shasta,089,179085,3313,2547,42,2589,36
2020-11-07,Sierra,091,2930,10,7,0,7,0
2020-11-07,Siskiyou,093,43540,299,241,13,254,0
2020-11-07,Solano,095,438530,8488,8066,41,8107,85
2020-11-07,Sonoma,097,501317,10713,10200,34,10234,149
2020-11-07,Stanislaus,099,539301,18860,18386,927,19313,418
2020-11-07,Sutter,101,95872,2131,1973,4,1977,12
2020-11-07,Tehama,103,63373,1156,1043,3,1046,7
2020-11-07,Trinity,105,12862,146,42,16,58,0
2020-11-07,Tulare,107,460477,19037,18229,644,18873,304
2020-11-07,Tuolumne,109,53932,459,327,4,331,7
2020-11-07,Ventura,111,848112,16401,15364,452,15816,156
2020-11-07,Yolo,113,214977,3703,3486,9,3495,61
2020-11-07,Yuba,115,75493,1440,1349,7,1356,10
2020-11-06,Alameda,001,1643700,25533,24389,249,24638,420
2020-11-06,Alpine,003,1148,24,6,0,6,0
2020-11-06,Amador,005,37829,397,369,0,369,16
2020-11-06,Butte,007,227075,3432,3254,61,3315,57
2020-11-06,Calaveras,009,45235,362,359,0,359,21
2020-11-06,Colusa,011,21464,595,580,1,581,6
2020-11-06,Contra Costa,013,1133247,20679,19744,104,19848,252
2020-11-06,Del Norte,015,27424,203,194,0,194,2
2020-11-06,El Dorado,017,186661,1628,1475,7,1482,4
2020-11-06,Fresno,019,978130,35829,32278,649,32927,460
2020-11-06,Glenn,021,27897,756,707,7,714,3
2020-11-06,Humboldt,023,135768,636,587,1,588,9
2020-11-06,Imperial,025,180216,13753,13230,67,13297,338
2020-11-06,Inyo,027,18085,259,246,5,251,14
2020-11-06,Kern,029,883053,35654,34360,608,34968,443
2020-11-06,Kings,031,150075,9441,8883,79,8962,83
2020-11-06,Lake,033,64148,786,741,0,741,16
2020-11-06,Lassen,035,31185,853,794,2,796,0
2020-11-06,Los Angeles,037,10098052,325001,314356,3556,317912,7160
2020-11-06,Madera,039,155013,5404,5136,65,5201,54
2020-11-06,Marin,041,260295,7336,7184,22,7206,131
2020-11-06,Mariposa,043,17540,89,79,0,79,2
2020-11-06,Mendocino,045,87422,1198,1113,5,1118,22
2020-11-06,Merced,047,269075,10156,9778,56,9834,157
2020-11-06,Modoc,049,8938,70,48,12,60,0
2020-11-06,Mono,051,14174,452,308,8,316,1
2020-11-06,Monterey,053,433212,12558,11914,110,12024,96
2020-11-06,Napa,055,140530,2419,2189,9,2198,15
2020-11-06,Nevada,057,99092,801,692,21,713,9
2020-11-06,Orange,059,3164182,64878,61049,1968,63017,1494
2020-11-06,Placer,061,380077,5122,4680,32,4712,60
2020-11-06,Plumas,063,18699,122,90,0,90,0
2020-11-06,Riverside,065,2383286,73772,70409,782,71191,1341
2020-11-06,Sacramento,067,1510023,28992,27489,43,27532,514
2020-11-06,San Benito,069,59416,1551,1479,1,1480,15
2020-11-06,San Bernardino,071,2135413,71756,66740,588,67328,1179
2020-11-06,San Diego,073,3302833,63212,59143,1937,61080,907
2020-11-06,San Francisco,075,870044,13381,12825,64,12889,146
2020-11-06,San Joaquin,077,732212,23312,22424,303,22727,502
2020-11-06,San Luis Obispo,079,281455,5097,4531,52,4583,32
2020-11-06,San Mateo,081,765935,12288,11587,10,11597,168
2020-11-06,Santa Barbara,083,443738,10397,10118,137,10255,133
2020-11-06,Santa Clara,085,1922200,28073,25831,51,25882,402
2020-11-06,Santa Cruz,087,273765,3308,3063,37,3100,25
2020-11-06,Shasta,089,179085,3240,2475,41,2516,35
2020-11-06,Sierra,091,2930,9,7,0,7,0
2020-11-06,Siskiyou,093,43540,286,237,12,249,0
2020-11-06,Solano,095,438530,8423,7959,41,8000,85
2020-11-06,Sonoma,097,501317,10663,10142,34,10176,149
2020-11-06,Stanislaus,099,539301,18772,18250,918,19168,417
2020-11-06,Sutter,101,95872,2104,1937,2,1939,12
2020-11-06,Tehama,103,63373,1135,1024,3,1027,6
2020-11-06,Trinity,105,12862,143,41,16,57,0
2020-11-06,Tulare,107,460477,18973,18136,619,18755,300
2020-11-06,Tuolumne,109,53932,438,316,4,320,5
2020-11-06,Ventura,111,848112,16315,15222,449,15671,154
2020-11-06,Yolo,113,214977,3674,3420,9,3429,62
2020-11-06,Yuba,115,75493,1427,1335,7,1342,10
2020-11-05,Alameda,001,1643700,25355,24270,249,24519,420
2020-11-05,Alpine,003,1148,24,6,0,6,0
2020-11-05,Amador,005,37829,394,363,0,363,16
2020-11-05,Butte,007,227075,3409,3239,55,3294,57
2020-11-05,Calaveras,009,45235,355,333,0,333,19
2020-11-05,Colusa,011,21464,591,574,1,575,6
2020-11-05,Contra Costa,013,1133247,20497,19656,102,19758,252
2020-11-05,Del Norte,015,27424,201,192,0,192,2
2020-11-05,El Dorado,017,186661,1604,1466,7,1473,4
2020-11-05,Fresno,019,978130,35586,32056,624,32680,460
2020-11-05,Glenn,021,27897,736,702,7,709,3
2020-11-05,Humboldt,023,135768,625,581,1,582,9
2020-11-05,Imperial,025,180216,13661,13178,65,13243,337
2020-11-05,Inyo,027,18085,259,247,5,252,14
2020-11-05,Kern,029,883053,35452,34232,594,34826,443
2020-11-05,Kings,031,150075,9286,8846,76,8922,83
2020-11-05,Lake,033,64148,782,739,0,739,16
2020-11-05,Lassen,035,31185,822,782,2,784,0
2020-11-05,Los Angeles,037,10098052,322645,312381,3503,315884,7146
2020-11-05,Madera,039,155013,5365,5129,62,5191,54
2020-11-05,Marin,041,260295,7314,7171,22,7193,131
2020-11-05,Mariposa,043,17540,88,79,0,79,2
2020-11-05,Mendocino,045,87422,1186,1112,5,1117,22
2020-11-05,Merced,047,269075,10097,9753,51,9804,155
2020-11-05,Modoc,049,8938,69,47,11,58,0
2020-11-05,Mono,051,14174,450,307,8,315,1
2020-11-05,Monterey,053,433212,12450,11784,106,11890,96
2020-11-05,Napa,055,140530,2392,2158,9,2167,15
2020-11-05,Nevada,057,99092,779,687,20,707,9
2020-11-05,Orange,059,3164182,64431,60740,1958,62698,1484
2020-11-05,Placer,061,380077,5053,4627,27,4654,60
2020-11-05,Plumas,063,18699,114,90,0,90,0
2020-11-05,Riverside,065,2383286,73061,70094,724,70818,1338
2020-11-05,Sacramento,067,1510023,28611,27232,42,27274,512
2020-11-05,San Benito,069,59416,1536,1477,1,1478,15
2020-11-05,San Bernardino,071,2135413,70928,66407,575,66982,1174
2020-11-05,San Diego,073,3302833,62586,58659,1911,60570,904
2020-11-05,San Francisco,075,870044,13269,12726,63,12789,146
2020-11-05,San Joaquin,077,732212,23148,22318,299,22617,502
2020-11-05,San Luis Obispo,079,281455,5030,4459,50,4509,32
2020-11-05,San Mateo,081,765935,12194,11535,10,11545,168
2020-11-05,Santa Barbara,083,443738,10353,10080,134,10214,133
2020-11-05,Santa Clara,085,1922200,27806,25651,51,25702,402
2020-11-05,Santa Cruz,087,273765,3270,3023,37,3060,25
2020-11-05,Shasta,089,179085,3150,2401,40,2441,34
2020-11-05,Sierra,091,2930,9,6,0,6,0
2020-11-05,Siskiyou,093,43540,275,228,12,240,0
2020-11-05,Solano,095,438530,8340,7842,41,7883,85
2020-11-05,Sonoma,097,501317,10551,10064,33,10097,145
2020-11-05,Stanislaus,099,539301,18658,18194,905,19099,417
2020-11-05,Sutter,101,95872,2072,1925,2,1927,12
2020-11-05,Tehama,103,63373,1113,1015,2,1017,6
2020-11-05,Trinity,105,12862,127,41,15,56,0
2020-11-05,Tulare,107,460477,18885,18049,592,18641,301
2020-11-05,Tuolumne,109,53932,409,312,4,316,5
2020-11-05,Ventura,111,848112,16149,15113,438,15551,155
2020-11-05,Yolo,113,214977,3624,3391,9,3400,61
2020-11-05,Yuba,115,75493,1409,1322,7,1329,10
2020-11-04,Alameda,001,1643700,25178,24172,247,24419,418
2020-11-04,Alpine,003,1148,20,5,0,5,0
2020-11-04,Amador,005,37829,391,362,0,362,16
2020-11-04,Butte,007,227075,3383,3218,52,3270,57
2020-11-04,Calaveras,009,45235,352,290,0,290,19
2020-11-04,Colusa,011,21464,589,571,1,572,6
2020-11-04,Contra Costa,013,1133247,20330,19472,99,19571,251
2020-11-04,Del Norte,015,27424,197,188,0,188,2
2020-11-04,El Dorado,017,186661,1589,1448,4,1452,4
2020-11-04,Fresno,019,978130,35353,31952,596,32548,457
2020-11-04,Glenn,021,27897,732,701,6,707,3
2020-11-04,Humboldt,023,135768,616,571,1,572,9
2020-11-04,Imperial,025,180216,13563,13087,65,13152,335
2020-11-04,Inyo,027,18085,258,247,5,252,14
2020-11-04,Kern,029,883053,35297,34027,583,34610,439
2020-11-04,Kings,031,150075,9252,8817,74,8891,83
2020-11-04,Lake,033,64148,775,735,0,735,16
2020-11-04,Lassen,035,31185,817,781,2,783,0
2020-11-04,Los Angeles,037,10098052,320335,310456,3423,313879,7124
2020-11-04,Madera,039,155013,5345,5083,58,5141,54
2020-11-04,Marin,041,260295,7302,7157,22,7179,131
2020-11-04,Mariposa,043,17540,88,79,0,79,2
2020-11-04,Mendocino,045,87422,1168,1089,5,1094,22
2020-11-04,Merced,047,269075,10047,9717,49,9766,153
2020-11-04,Modoc,049,8938,59,47,11,58,0
2020-11-04,Mono,051,14174,447,237,7,244,1
2020-11-04,Monterey,053,433212,12245,11743,100,11843,96
2020-11-04,Napa,055,140530,2338,2133,9,2142,15
2020-11-04,Nevada,057,99092,760,675,20,695,9
2020-11-04,Orange,059,3164182,63997,60463,1935,62398,1483
2020-11-04,Placer,061,380077,4974,4526,24,4550,60
2020-11-04,Plumas,063,18699,112,88,0,88,0
2020-11-04,Riverside,065,2383286,72444,69562,665,70227,1335
2020-11-04,Sacramento,067,1510023,28260,27005,41,27046,510
2020-11-04,San Benito,069,59416,1521,1464,1,1465,15
2020-11-04,San Bernardino,071,2135413,70131,65891,552,66443,1169
2020-11-04,San Diego,073,3302833,61940,58126,1885,60011,904
2020-11-04,San Francisco,075,870044,13185,12649,60,12709,146
2020-11-04,San Joaquin,077,732212,23011,22197,286,22483,500
2020-11-04,San Luis Obispo,079,281455,4963,4389,48,4437,32
2020-11-04,San Mateo,081,765935,12099,11456,10,11466,168
2020-11-04,Santa Barbara,083,443738,10315,10026,133,10159,132
2020-11-04,Santa Clara,085,1922200,27543,25487,51,25538,393
2020-11-04,Santa Cruz,087,273765,3233,2997,37,3034,25
2020-11-04,Shasta,089,179085,3019,2321,35,2356,34
2020-11-04,Sierra,091,2930,9,6,0,6,0
2020-11-04,Siskiyou,093,43540,266,222,12,234,0
2020-11-04,Solano,095,438530,8241,7733,41,7774,85
2020-11-04,Sonoma,097,501317,10457,9965,33,9998,142
2020-11-04,Stanislaus,099,539301,18541,18114,890,19004,416
2020-11-04,Sutter,101,95872,2038,1916,2,1918,12
2020-11-04,Tehama,103,63373,1088,997,2,999,6
2020-11-04,Trinity,105,12862,123,37,15,52,0
2020-11-04,Tulare,107,460477,18776,17952,564,18516,298
2020-11-04,Tuolumne,109,53932,387,310,4,314,5
2020-11-04,Ventura,111,848112,16008,14936,435,15371,155
2020-11-04,Yolo,113,214977,3583,3361,9,3370,62
2020-11-04,Yuba,115,75493,1388,1312,7,1319,10
2020-11-03,Alameda,001,1643700,24994,24055,245,24300,418
2020-11-03,Alpine,003,1148,19,4,0,4,0
2020-11-03,Amador,005,37829,386,361,0,361,16
2020-11-03,Butte,007,227075,3359,3211,47,3258,57
2020-11-03,Calaveras,009,45235,348,287,0,287,19
2020-11-03,Colusa,011,21464,584,572,1,573,6
2020-11-03,Contra Costa,013,1133247,20175,19416,99,19515,250
2020-11-03,Del Norte,015,27424,196,187,0,187,2
2020-11-03,El Dorado,017,186661,1567,1445,3,1448,4
2020-11-03,Fresno,019,978130,35083,31856,574,32430,457
2020-11-03,Glenn,021,27897,726,698,6,704,3
2020-11-03,Humboldt,023,135768,610,570,1,571,8
2020-11-03,Imperial,025,180216,13474,13044,63,13107,335
2020-11-03,Inyo,027,18085,257,244,5,249,14
2020-11-03,Kern,029,883053,35106,33957,572,34529,439
2020-11-03,Kings,031,150075,9089,8783,69,8852,83
2020-11-03,Lake,033,64148,765,732,0,732,16
2020-11-03,Lassen,035,31185,808,782,2,784,0
2020-11-03,Los Angeles,037,10098052,317879,308812,3355,312167,7104
2020-11-03,Madera,039,155013,5308,5058,57,5115,54
2020-11-03,Marin,041,260295,7282,7147,21,7168,131
2020-11-03,Mariposa,043,17540,87,79,0,79,2
2020-11-03,Mendocino,045,87422,1153,1084,5,1089,22
2020-11-03,Merced,047,269075,9994,9713,48,9761,153
2020-11-03,Modoc,049,8938,57,47,9,56,0
2020-11-03,Mono,051,14174,443,210,7,217,1
2020-11-03,Monterey,053,433212,12176,11703,93,11796,94
2020-11-03,Napa,055,140530,2302,2130,9,2139,15
2020-11-03,Nevada,057,99092,740,670,19,689,9
2020-11-03,Orange,059,3164182,63568,60283,1924,62207,1477
2020-11-03,Placer,061,380077,4900,4514,24,4538,60
2020-11-03,Plumas,063,18699,109,86,0,86,0
2020-11-03,Riverside,065,2383286,71825,69300,640,69940,1325
2020-11-03,Sacramento,067,1510023,27880,26841,40,26881,510
2020-11-03,San Benito,069,59416,1511,1463,1,1464,15
2020-11-03,San Bernardino,071,2135413,69319,65320,544,65864,1159
2020-11-03,San Diego,073,3302833,61264,57722,1841,59563,901
2020-11-03,San Francisco,075,870044,13062,12585,60,12645,146
2020-11-03,San Joaquin,077,732212,22876,22109,280,22389,500
2020-11-03,San Luis Obispo,079,281455,4878,4371,46,4417,32
2020-11-03,San Mateo,081,765935,12004,11406,10,11416,162
2020-11-03,Santa Barbara,083,443738,10261,10008,128,10136,132
2020-11-03,Santa Clara,085,1922200,27271,25386,50,25436,393
2020-11-03,Santa Cruz,087,273765,3183,2980,36,3016,25
2020-11-03,Shasta,089,179085,2925,2288,28,2316,33
2020-11-03,Sierra,091,2930,7,6,0,6,0
2020-11-03,Siskiyou,093,43540,262,219,11,230,0
2020-11-03,Solano,095,438530,8158,7691,41,7732,85
2020-11-03,Sonoma,097,501317,10355,9906,33,9939,142
2020-11-03,Stanislaus,099,539301,18420,18080,879,18959,416
2020-11-03,Sutter,101,95872,2005,1914,2,1916,12
2020-11-03,Tehama,103,63373,1067,988,2,990,6
2020-11-03,Trinity,105,12862,116,36,14,50,0
2020-11-03,Tulare,107,460477,18670,17890,539,18429,297
2020-11-03,Tuolumne,109,53932,364,302,4,306,5
2020-11-03,Ventura,111,848112,15881,14816,428,15244,155
2020-11-03,Yolo,113,214977,3532,3343,9,3352,61
2020-11-03,Yuba,115,75493,1375,1295,7,1302,10
2020-11-02,Alameda,001,1643700,24798,23991,242,24233,419
2020-11-02,Alpine,003,1148,16,4,0,4,0
2020-11-02,Amador,005,37829,378,357,0,357,16
2020-11-02,Butte,007,227075,3339,3198,44,3242,57
2020-11-02,Calaveras,009,45235,348,282,0,282,18
2020-11-02,Colusa,011,21464,579,571,1,572,6
2020-11-02,Contra Costa,013,1133247,20021,19339,98,19437,250
2020-11-02,Del Norte,015,27424,193,175,0,175,2
2020-11-02,El Dorado,017,186661,1543,1405,3,1408,4
2020-11-02,Fresno,019,978130,34814,31738,557,32295,451
2020-11-02,Glenn,021,27897,720,692,5,697,3
2020-11-02,Humboldt,023,135768,601,569,1,570,8
2020-11-02,Imperial,025,180216,13394,13004,61,13065,334
2020-11-02,Inyo,027,18085,254,243,5,248,14
2020-11-02,Kern,029,883053,34948,33834,562,34396,437
2020-11-02,Kings,031,150075,9059,8654,66,8720,82
2020-11-02,Lake,033,64148,759,728,0,728,17
2020-11-02,Lassen,035,31185,800,782,2,784,0
2020-11-02,Los Angeles,037,10098052,315536,307620,3277,310897,7079
2020-11-02,Madera,039,155013,5277,5033,56,5089,54
2020-11-02,Marin,041,260295,7264,7132,20,7152,125
2020-11-02,Mariposa,043,17540,87,79,0,79,2
2020-11-02,Mendocino,045,87422,1139,1076,5,1081,21
2020-11-02,Merced,047,269075,9932,9664,42,9706,152
2020-11-02,Modoc,049,8938,54,45,5,50,0
2020-11-02,Mono,051,14174,441,211,7,218,1
2020-11-02,Monterey,053,433212,12069,11602,90,11692,93
2020-11-02,Napa,055,140530,2260,2081,9,2090,15
2020-11-02,Nevada,057,99092,724,656,19,675,9
2020-11-02,Orange,059,3164182,63163,59996,1908,61904,1474
2020-11-02,Placer,061,380077,4832,4461,22,4483,60
2020-11-02,Plumas,063,18699,101,86,0,86,0
2020-11-02,Riverside,065,2383286,71194,68833,599,69432,1321
2020-11-02,Sacramento,067,1510023,27538,26676,38,26714,508
2020-11-02,San Benito,069,59416,1499,1459,1,1460,15
2020-11-02,San Bernardino,071,2135413,68465,64629,533,65162,1157
2020-11-02,San Diego,073,3302833,60541,57429,1796,59225,891
2020-11-02,San Francisco,075,870044,12965,12436,59,12495,145
2020-11-02,San Joaquin,077,732212,22736,21919,272,22191,500
2020-11-02,San Luis Obispo,079,281455,4778,4303,43,4346,31
2020-11-02,San Mateo,081,765935,11895,11328,10,11338,161
2020-11-02,Santa Barbara,083,443738,10220,9985,123,10108,130
2020-11-02,Santa Clara,085,1922200,26981,25222,50,25272,387
2020-11-02,Santa Cruz,087,273765,3141,2943,36,2979,25
2020-11-02,Shasta,089,179085,2822,2174,24,2198,33
2020-11-02,Sierra,091,2930,7,6,0,6,0
2020-11-02,Siskiyou,093,43540,252,216,11,227,0
2020-11-02,Solano,095,438530,8040,7665,41,7706,84
2020-11-02,Sonoma,097,501317,10272,9796,32,9828,140
2020-11-02,Stanislaus,099,539301,18324,18005,870,18875,412
2020-11-02,Sutter,101,95872,1981,1895,2,1897,12
2020-11-02,Tehama,103,63373,1044,971,2,973,6
2020-11-02,Trinity,105,12862,110,30,14,44,0
2020-11-02,Tulare,107,460477,18577,17774,518,18292,299
2020-11-02,Tuolumne,109,53932,343,302,4,306,5
2020-11-02,Ventura,111,848112,15740,14767,414,15181,156
2020-11-02,Yolo,113,214977,3483,3318,9,3327,61
2020-11-02,Yuba,115,75493,1362,1280,7,1287,10
2020-11-01,Alameda,001,1643700,24635,23892,240,24132,419
2020-11-01,Alpine,003,1148,10,4,0,4,0
2020-11-01,Amador,005,37829,375,352,0,352,16
2020-11-01,Butte,007,227075,3315,3185,43,3228,57
2020-11-01,Calaveras,009,45235,347,282,0,282,18
2020-11-01,Colusa,011,21464,577,567,1,568,6
2020-11-01,Contra Costa,013,1133247,19847,19246,97,19343,250
2020-11-01,Del Norte,015,27424,189,175,0,175,2
2020-11-01,El Dorado,017,186661,1527,1394,3,1397,4
2020-11-01,Fresno,019,978130,34557,31613,537,32150,451
2020-11-01,Glenn,021,27897,711,688,3,691,3
2020-11-01,Humboldt,023,135768,593,568,1,569,8
2020-11-01,Imperial,025,180216,13303,12969,59,13028,334
2020-11-01,Inyo,027,18085,252,241,5,246,14
2020-11-01,Kern,029,883053,34767,33760,467,34227,437
2020-11-01,Kings,031,150075,9021,8641,65,8706,82
2020-11-01,Lake,033,64148,753,727,0,727,17
2020-11-01,Lassen,035,31185,800,782,2,784,0
2020-11-01,Los Angeles,037,10098052,312969,306217,3184,309401,7077
2020-11-01,Madera,039,155013,5229,5019,54,5073,54
2020-11-01,Marin,041,260295,7247,7124,20,7144,125
2020-11-01,Mariposa,043,17540,83,79,0,79,2
2020-11-01,Mendocino,045,87422,1126,1074,5,1079,21
2020-11-01,Merced,047,269075,9871,9626,42,9668,152
2020-11-01,Modoc,049,8938,53,45,5,50,0
2020-11-01,Mono,051,14174,412,211,6,217,1
2020-11-01,Monterey,053,433212,11961,11587,87,11674,93
2020-11-01,Napa,055,140530,2226,2067,9,2076,15
2020-11-01,Nevada,057,99092,708,646,18,664,9
2020-11-01,Orange,059,3164182,62761,59733,1881,61614,1475
2020-11-01,Placer,061,380077,4766,4422,21,4443,58
2020-11-01,Plumas,063,18699,96,86,0,86,0
2020-11-01,Riverside,065,2383286,70564,68493,563,69056,1319
2020-11-01,Sacramento,067,1510023,27217,26442,38,26480,508
2020-11-01,San Benito,069,59416,1484,1451,1,1452,15
2020-11-01,San Bernardino,071,2135413,67622,64339,512,64851,1157
2020-11-01,San Diego,073,3302833,59853,57122,1756,58878,891
2020-11-01,San Francisco,075,870044,12842,12436,54,12490,145
2020-11-01,San Joaquin,077,732212,22608,21919,266,22185,500
2020-11-01,San Luis Obispo,079,281455,4698,4303,42,4345,31
2020-11-01,San Mateo,081,765935,11814,11280,10,11290,160
2020-11-01,Santa Barbara,083,443738,10169,9969,107,10076,130
2020-11-01,Santa Clara,085,1922200,26701,25090,50,25140,386
2020-11-01,Santa Cruz,087,273765,3088,2921,36,2957,25
2020-11-01,Shasta,089,179085,2687,2172,23,2195,33
2020-11-01,Sierra,091,2930,7,6,0,6,0
2020-11-01,Siskiyou,093,43540,247,205,11,216,0
2020-11-01,Solano,095,438530,7950,7591,41,7632,84
2020-11-01,Sonoma,097,501317,10180,9688,32,9720,140
2020-11-01,Stanislaus,099,539301,18223,17961,850,18811,412
2020-11-01,Sutter,101,95872,1955,1888,1,1889,12
2020-11-01,Tehama,103,63373,1027,965,2,967,5
2020-11-01,Trinity,105,12862,108,30,13,43,0
2020-11-01,Tulare,107,460477,18465,17774,487,18261,299
2020-11-01,Tuolumne,109,53932,321,295,4,299,5
2020-11-01,Ventura,111,848112,15591,14686,383,15069,156
2020-11-01,Yolo,113,214977,3435,3303,9,3312,60
2020-11-01,Yuba,115,75493,1345,1273,7,1280,10
2020-10-31,Alameda,001,1643700,24520,23780,236,24016,416
2020-10-31,Alpine,003,1148,10,4,0,4,0
2020-10-31,Amador,005,37829,371,347,0,347,16
2020-10-31,Butte,007,227075,3302,3172,41,3213,57
2020-10-31,Calaveras,009,45235,347,280,0,280,18
2020-10-31,Colusa,011,21464,575,555,1,556,6
2020-10-31,Contra Costa,013,1133247,19741,19161,97,19258,249
2020-10-31,Del Norte,015,27424,188,175,0,175,2
2020-10-31,El Dorado,017,186661,1518,1390,3,1393,4
2020-10-31,Fresno,019,978130,34421,31558,534,32092,451
2020-10-31,Glenn,021,27897,709,678,3,681,3
2020-10-31,Humboldt,023,135768,590,561,1,562,8
2020-10-31,Imperial,025,180216,13261,12912,59,12971,334
2020-10-31,Inyo,027,18085,251,241,5,246,14
2020-10-31,Kern,029,883053,34664,33666,457,34123,437
2020-10-31,Kings,031,150075,9000,8612,64,8676,82
2020-10-31,Lake,033,64148,749,724,0,724,16
2020-10-31,Lassen,035,31185,795,782,2,784,0
2020-10-31,Los Angeles,037,10098052,311597,304704,3140,307844,7073
2020-10-31,Madera,039,155013,5211,5013,51,5064,54
2020-10-31,Marin,041,260295,7231,7112,20,7132,125
2020-10-31,Mariposa,043,17540,83,79,0,79,2
2020-10-31,Mendocino,045,87422,1118,1066,5,1071,21
2020-10-31,Merced,047,269075,9838,9597,41,9638,151
2020-10-31,Modoc,049,8938,52,34,4,38,0
2020-10-31,Mono,051,14174,263,194,5,199,1
2020-10-31,Monterey,053,433212,11893,11539,83,11622,93
2020-10-31,Napa,055,140530,2207,2040,9,2049,15
2020-10-31,Nevada,057,99092,690,644,18,662,9
2020-10-31,Orange,059,3164182,62502,59488,1863,61351,1473
2020-10-31,Placer,061,380077,4716,4374,20,4394,58
2020-10-31,Plumas,063,18699,95,85,0,85,0
2020-10-31,Riverside,065,2383286,70207,68178,540,68718,1319
2020-10-31,Sacramento,067,1510023,27018,26316,36,26352,507
2020-10-31,San Benito,069,59416,1477,1448,1,1449,15
2020-10-31,San Bernardino,071,2135413,67197,64016,502,64518,1157
2020-10-31,San Diego,073,3302833,59400,56769,1728,58497,891
2020-10-31,San Francisco,075,870044,12768,12438,53,12491,145
2020-10-31,San Joaquin,077,732212,22533,21918,257,22175,500
2020-10-31,San Luis Obispo,079,281455,4629,4285,39,4324,31
2020-10-31,San Mateo,081,765935,11762,11253,10,11263,160
2020-10-31,Santa Barbara,083,443738,10140,9957,99,10056,130
2020-10-31,Santa Clara,085,1922200,26533,24957,50,25007,379
2020-10-31,Santa Cruz,087,273765,3053,2895,35,2930,25
2020-10-31,Shasta,089,179085,2633,2122,22,2144,33
2020-10-31,Sierra,091,2930,7,6,0,6,0
2020-10-31,Siskiyou,093,43540,245,200,11,211,0
2020-10-31,Solano,095,438530,7886,7545,41,7586,84
2020-10-31,Sonoma,097,501317,10127,9648,32,9680,140
2020-10-31,Stanislaus,099,539301,18160,17920,834,18754,412
2020-10-31,Sutter,101,95872,1946,1876,1,1877,12
2020-10-31,Tehama,103,63373,1017,953,2,955,5
2020-10-31,Trinity,105,12862,105,30,13,43,0
2020-10-31,Tulare,107,460477,18416,17758,479,18237,299
2020-10-31,Tuolumne,109,53932,314,290,4,294,5
2020-10-31,Ventura,111,848112,15507,14635,365,15000,155
2020-10-31,Yolo,113,214977,3400,3290,9,3299,60
2020-10-31,Yuba,115,75493,1329,1260,6,1266,10
2020-10-30,Alameda,001,1643700,24440,23676,234,23910,401
2020-10-30,Alpine,003,1148,10,4,0,4,0
2020-10-30,Amador,005,37829,371,344,0,344,16
2020-10-30,Butte,007,227075,3297,3160,41,3201,57
2020-10-30,Calaveras,009,45235,346,279,0,279,18
2020-10-30,Colusa,011,21464,573,554,1,555,6
2020-10-30,Contra Costa,013,1133247,19669,19074,97,19171,249
2020-10-30,Del Norte,015,27424,187,175,0,175,2
2020-10-30,El Dorado,017,186661,1505,1386,3,1389,4
2020-10-30,Fresno,019,978130,34299,31409,525,31934,446
2020-10-30,Glenn,021,27897,703,674,2,676,3
2020-10-30,Humboldt,023,135768,589,561,1,562,7
2020-10-30,Imperial,025,180216,13220,12853,59,12912,334
2020-10-30,Inyo,027,18085,250,241,5,246,14
2020-10-30,Kern,029,883053,34571,33583,456,34039,437
2020-10-30,Kings,031,150075,8990,8564,62,8626,82
2020-10-30,Lake,033,64148,749,720,0,720,16
2020-10-30,Lassen,035,31185,789,777,2,779,0
2020-10-30,Los Angeles,037,10098052,310161,303425,3105,306530,7060
2020-10-30,Madera,039,155013,5199,4991,49,5040,54
2020-10-30,Marin,041,260295,7211,7097,20,7117,125
2020-10-30,Mariposa,043,17540,83,78,0,78,2
2020-10-30,Mendocino,045,87422,1116,1062,5,1067,21
2020-10-30,Merced,047,269075,9806,9539,41,9580,150
2020-10-30,Modoc,049,8938,51,34,3,37,0
2020-10-30,Mono,051,14174,262,193,5,198,1
2020-10-30,Monterey,053,433212,11830,11491,78,11569,92
2020-10-30,Napa,055,140530,2189,2028,9,2037,15
2020-10-30,Nevada,057,99092,684,634,18,652,9
2020-10-30,Orange,059,3164182,62260,59334,1851,61185,1469
2020-10-30,Placer,061,380077,4669,4335,20,4355,58
2020-10-30,Plumas,063,18699,92,80,0,80,0
2020-10-30,Riverside,065,2383286,69867,67752,520,68272,1317
2020-10-30,Sacramento,067,1510023,26870,26147,36,26183,505
2020-10-30,San Benito,069,59416,1471,1440,1,1441,15
2020-10-30,San Bernardino,071,2135413,66782,63512,499,64011,1156
2020-10-30,San Diego,073,3302833,58995,56387,1706,58093,888
2020-10-30,San Francisco,075,870044,12713,12384,53,12437,145
2020-10-30,San Joaquin,077,732212,22466,21849,251,22100,500
2020-10-30,San Luis Obispo,079,281455,4586,4256,39,4295,31
2020-10-30,San Mateo,081,765935,11703,11207,10,11217,159
2020-10-30,Santa Barbara,083,443738,10117,9937,99,10036,128
2020-10-30,Santa Clara,085,1922200,26384,24811,50,24861,378
2020-10-30,Santa Cruz,087,273765,3035,2874,35,2909,25
2020-10-30,Shasta,089,179085,2589,2048,21,2069,32
2020-10-30,Sierra,091,2930,7,6,0,6,0
2020-10-30,Siskiyou,093,43540,245,192,11,203,0
2020-10-30,Solano,095,438530,7825,7497,41,7538,84
2020-10-30,Sonoma,097,501317,10052,9602,32,9634,140
2020-10-30,Stanislaus,099,539301,18112,17861,818,18679,410
2020-10-30,Sutter,101,95872,1933,1860,1,1861,12
2020-10-30,Tehama,103,63373,1013,932,2,934,5
2020-10-30,Trinity,105,12862,105,29,13,42,0
2020-10-30,Tulare,107,460477,18371,17682,464,18146,299
2020-10-30,Tuolumne,109,53932,307,286,4,290,4
2020-10-30,Ventura,111,848112,15434,14578,353,14931,154
2020-10-30,Yolo,113,214977,3383,3263,9,3272,60
2020-10-30,Yuba,115,75493,1321,1256,6,1262,10
2020-10-29,Alameda,001,1643700,24276,23530,233,23763,401
2020-10-29,Alpine,003,1148,7,4,0,4,0
2020-10-29,Amador,005,37829,367,338,0,338,16
2020-10-29,Butte,007,227075,3279,3143,40,3183,57
2020-10-29,Calaveras,009,45235,344,278,0,278,13
2020-10-29,Colusa,011,21464,569,552,1,553,6
2020-10-29,Contra Costa,013,1133247,19570,18933,96,19029,249
2020-10-29,Del Norte,015,27424,185,174,0,174,2
2020-10-29,El Dorado,017,186661,1483,1370,3,1373,4
2020-10-29,Fresno,019,978130,34142,31321,518,31839,445
2020-10-29,Glenn,021,27897,701,673,2,675,3
2020-10-29,Humboldt,023,135768,584,559,1,560,7
2020-10-29,Imperial,025,180216,13176,12769,59,12828,334
2020-10-29,Inyo,027,18085,248,238,5,243,14
2020-10-29,Kern,029,883053,34470,33460,452,33912,437
2020-10-29,Kings,031,150075,8836,8502,61,8563,82
2020-10-29,Lake,033,64148,746,702,0,702,16
2020-10-29,Lassen,035,31185,788,772,2,774,0
2020-10-29,Los Angeles,037,10098052,308533,302246,3058,305304,7046
2020-10-29,Madera,039,155013,5169,4970,47,5017,53
2020-10-29,Marin,041,260295,7197,7083,20,7103,125
2020-10-29,Mariposa,043,17540,81,78,0,78,2
2020-10-29,Mendocino,045,87422,1110,1058,5,1063,21
2020-10-29,Merced,047,269075,9753,9496,41,9537,150
2020-10-29,Modoc,049,8938,49,31,3,34,0
2020-10-29,Mono,051,14174,255,176,5,181,1
2020-10-29,Monterey,053,433212,11749,11425,76,11501,92
2020-10-29,Napa,055,140530,2165,2009,9,2018,15
2020-10-29,Nevada,057,99092,677,632,18,650,9
2020-10-29,Orange,059,3164182,61992,59046,1831,60877,1464
2020-10-29,Placer,061,380077,4624,4270,18,4288,58
2020-10-29,Plumas,063,18699,90,69,0,69,0
2020-10-29,Riverside,065,2383286,69490,67268,490,67758,1304
2020-10-29,Sacramento,067,1510023,26658,25978,35,26013,507
2020-10-29,San Benito,069,59416,1466,1431,1,1432,15
2020-10-29,San Bernardino,071,2135413,66214,62968,489,63457,1150
2020-10-29,San Diego,073,3302833,58529,55916,1677,57593,885
2020-10-29,San Francisco,075,870044,12634,12312,53,12365,145
2020-10-29,San Joaquin,077,732212,22382,21736,239,21975,498
2020-10-29,San Luis Obispo,079,281455,4556,4223,38,4261,31
2020-10-29,San Mateo,081,765935,11657,11145,10,11155,157
2020-10-29,Santa Barbara,083,443738,10084,9902,97,9999,128
2020-10-29,Santa Clara,085,1922200,26232,24614,50,24664,377
2020-10-29,Santa Cruz,087,273765,3010,2850,35,2885,24
2020-10-29,Shasta,089,179085,2526,2008,21,2029,32
2020-10-29,Sierra,091,2930,6,6,0,6,0
2020-10-29,Siskiyou,093,43540,229,185,11,196,0
2020-10-29,Solano,095,438530,7763,7453,41,7494,78
2020-10-29,Sonoma,097,501317,9988,9533,32,9565,140
2020-10-29,Stanislaus,099,539301,18059,17790,797,18587,410
2020-10-29,Sutter,101,95872,1925,1852,1,1853,12
2020-10-29,Tehama,103,63373,995,925,2,927,5
2020-10-29,Trinity,105,12862,100,28,12,40,0
2020-10-29,Tulare,107,460477,18293,17627,445,18072,299
2020-10-29,Tuolumne,109,53932,302,279,4,283,4
2020-10-29,Ventura,111,848112,15343,14486,349,14835,154
2020-10-29,Yolo,113,214977,3354,3246,9,3255,60
2020-10-29,Yuba,115,75493,1310,1248,6,1254,10
2020-10-28,Alameda,001,1643700,24176,23468,232,23700,400
2020-10-28,Alpine,003,1148,6,4,0,4,0
2020-10-28,Amador,005,37829,364,337,0,337,16
2020-10-28,Butte,007,227075,3263,3134,37,3171,56
2020-10-28,Calaveras,009,45235,343,278,0,278,13
2020-10-28,Colusa,011,21464,566,551,1,552,6
2020-10-28,Contra Costa,013,1133247,19483,18828,95,18923,246
2020-10-28,Del Norte,015,27424,182,173,0,173,2
2020-10-28,El Dorado,017,186661,1471,1363,3,1366,4
2020-10-28,Fresno,019,978130,34020,31195,512,31707,444
2020-10-28,Glenn,021,27897,697,673,2,675,3
2020-10-28,Humboldt,023,135768,580,559,1,560,7
2020-10-28,Imperial,025,180216,13127,12730,58,12788,333
2020-10-28,Inyo,027,18085,248,238,5,243,14
2020-10-28,Kern,029,883053,34368,33424,433,33857,436
2020-10-28,Kings,031,150075,8814,8486,60,8546,82
2020-10-28,Lake,033,64148,743,700,0,700,15
2020-10-28,Lassen,035,31185,784,771,2,773,0
2020-10-28,Los Angeles,037,10098052,307074,300726,3016,303742,7031
2020-10-28,Madera,039,155013,5152,4954,46,5000,53
2020-10-28,Marin,041,260295,7186,7079,20,7099,126
2020-10-28,Mariposa,043,17540,81,78,0,78,2
2020-10-28,Mendocino,045,87422,1109,1037,5,1042,20
2020-10-28,Merced,047,269075,9727,9480,40,9520,150
2020-10-28,Modoc,049,8938,48,31,2,33,0
2020-10-28,Mono,051,14174,237,176,5,181,1
2020-10-28,Monterey,053,433212,11691,11330,74,11404,89
2020-10-28,Napa,055,140530,2139,1998,8,2006,15
2020-10-28,Nevada,057,99092,669,629,18,647,9
2020-10-28,Orange,059,3164182,61728,58801,1815,60616,1459
2020-10-28,Placer,061,380077,4568,4236,18,4254,57
2020-10-28,Plumas,063,18699,89,67,0,67,0
2020-10-28,Riverside,065,2383286,69092,67003,466,67469,1302
2020-10-28,Sacramento,067,1510023,26462,25838,34,25872,506
2020-10-28,San Benito,069,59416,1458,1429,1,1430,15
2020-10-28,San Bernardino,071,2135413,65754,62778,480,63258,1154
2020-10-28,San Diego,073,3302833,58146,55556,1648,57204,881
2020-10-28,San Francisco,075,870044,12576,12261,52,12313,145
2020-10-28,San Joaquin,077,732212,22298,21707,228,21935,498
2020-10-28,San Luis Obispo,079,281455,4512,4197,35,4232,31
2020-10-28,San Mateo,081,765935,11590,11101,10,11111,157
2020-10-28,Santa Barbara,083,443738,10060,9872,95,9967,127
2020-10-28,Santa Clara,085,1922200,26088,24503,50,24553,375
2020-10-28,Santa Cruz,087,273765,2979,2836,35,2871,24
2020-10-28,Shasta,089,179085,2446,1996,20,2016,31
2020-10-28,Sierra,091,2930,6,6,0,6,0
2020-10-28,Siskiyou,093,43540,226,182,10,192,0
2020-10-28,Solano,095,438530,7704,7362,41,7403,77
2020-10-28,Sonoma,097,501317,9898,9457,27,9484,140
2020-10-28,Stanislaus,099,539301,17994,17765,787,18552,409
2020-10-28,Sutter,101,95872,1916,1840,1,1841,12
2020-10-28,Tehama,103,63373,984,921,2,923,5
2020-10-28,Trinity,105,12862,93,28,11,39,0
2020-10-28,Tulare,107,460477,18236,17569,429,17998,297
2020-10-28,Tuolumne,109,53932,299,277,4,281,4
2020-10-28,Ventura,111,848112,15270,14409,340,14749,153
2020-10-28,Yolo,113,214977,3330,3230,9,3239,60
2020-10-28,Yuba,115,75493,1298,1245,6,1251,10
2020-10-27,Alameda,001,1643700,24061,23365,230,23595,400
2020-10-27,Alpine,003,1148,6,3,0,3,0
2020-10-27,Amador,005,37829,361,335,0,335,16
2020-10-27,Butte,007,227075,3247,3107,34,3141,56
2020-10-27,Calaveras,009,45235,341,277,0,277,13
2020-10-27,Colusa,011,21464,561,549,1,550,6
2020-10-27,Contra Costa,013,1133247,19378,18766,95,18861,246
2020-10-27,Del Norte,015,27424,179,173,0,173,2
2020-10-27,El Dorado,017,186661,1458,1351,3,1354,4
2020-10-27,Fresno,019,978130,33901,31096,507,31603,442
2020-10-27,Glenn,021,27897,695,667,1,668,3
2020-10-27,Humboldt,023,135768,577,559,1,560,7
2020-10-27,Imperial,025,180216,13078,12680,57,12737,333
2020-10-27,Inyo,027,18085,248,231,5,236,14
2020-10-27,Kern,029,883053,34251,33328,429,33757,436
2020-10-27,Kings,031,150075,8783,8411,60,8471,83
2020-10-27,Lake,033,64148,740,700,0,700,15
2020-10-27,Lassen,035,31185,782,764,2,766,0
2020-10-27,Los Angeles,037,10098052,305690,299438,2987,302425,7008
2020-10-27,Madera,039,155013,5122,4942,45,4987,53
2020-10-27,Marin,041,260295,7170,7070,20,7090,126
2020-10-27,Mariposa,043,17540,80,78,0,78,2
2020-10-27,Mendocino,045,87422,1103,1033,4,1037,20
2020-10-27,Merced,047,269075,9687,9449,40,9489,150
2020-10-27,Modoc,049,8938,46,31,2,33,0
2020-10-27,Mono,051,14174,223,169,5,174,1
2020-10-27,Monterey,053,433212,11635,11261,72,11333,88
2020-10-27,Napa,055,140530,2123,1979,8,1987,15
2020-10-27,Nevada,057,99092,663,622,18,640,8
2020-10-27,Orange,059,3164182,61457,58550,1799,60349,1448
2020-10-27,Placer,061,380077,4519,4197,16,4213,57
2020-10-27,Plumas,063,18699,86,63,0,63,0
2020-10-27,Riverside,065,2383286,68739,66699,421,67120,1299
2020-10-27,Sacramento,067,1510023,26275,25701,33,25734,501
2020-10-27,San Benito,069,59416,1453,1428,1,1429,15
2020-10-27,San Bernardino,071,2135413,65291,62357,467,62824,1154
2020-10-27,San Diego,073,3302833,57673,55226,1625,56851,877
2020-10-27,San Francisco,075,870044,12501,12218,51,12269,140
2020-10-27,San Joaquin,077,732212,22207,21637,219,21856,496
2020-10-27,San Luis Obispo,079,281455,4484,4148,31,4179,31
2020-10-27,San Mateo,081,765935,11541,11074,10,11084,156
2020-10-27,Santa Barbara,083,443738,10030,9874,94,9968,125
2020-10-27,Santa Clara,085,1922200,25946,24368,50,24418,367
2020-10-27,Santa Cruz,087,273765,2949,2815,34,2849,24
2020-10-27,Shasta,089,179085,2360,1962,20,1982,29
2020-10-27,Sierra,091,2930,6,6,0,6,0
2020-10-27,Siskiyou,093,43540,217,181,10,191,0
2020-10-27,Solano,095,438530,7635,7298,41,7339,77
2020-10-27,Sonoma,097,501317,9831,9389,27,9416,140
2020-10-27,Stanislaus,099,539301,17926,17720,780,18500,408
2020-10-27,Sutter,101,95872,1903,1832,1,1833,12
2020-10-27,Tehama,103,63373,970,913,2,915,5
2020-10-27,Trinity,105,12862,90,28,11,39,0
2020-10-27,Tulare,107,460477,18173,17520,406,17926,296
2020-10-27,Tuolumne,109,53932,295,275,4,279,4
2020-10-27,Ventura,111,848112,15187,14347,333,14680,153
2020-10-27,Yolo,113,214977,3316,3216,9,3225,58
2020-10-27,Yuba,115,75493,1285,1235,6,1241,10
2020-10-26,Alameda,001,1643700,23948,23284,229,23513,398
2020-10-26,Alpine,003,1148,4,3,0,3,0
2020-10-26,Amador,005,37829,357,331,0,331,16
2020-10-26,Butte,007,227075,3235,3095,32,3127,56
2020-10-26,Calaveras,009,45235,337,274,0,274,13
2020-10-26,Colusa,011,21464,559,548,1,549,6
2020-10-26,Contra Costa,013,1133247,19282,18718,94,18812,245
2020-10-26,Del Norte,015,27424,179,171,0,171,2
2020-10-26,El Dorado,017,186661,1444,1336,3,1339,4
2020-10-26,Fresno,019,978130,33788,30969,500,31469,441
2020-10-26,Glenn,021,27897,688,660,1,661,3
2020-10-26,Humboldt,023,135768,569,554,1,555,7
2020-10-26,Imperial,025,180216,13024,12654,53,12707,333
2020-10-26,Inyo,027,18085,248,226,5,231,14
2020-10-26,Kern,029,883053,34167,33233,424,33657,432
2020-10-26,Kings,031,150075,8761,8264,58,8322,82
2020-10-26,Lake,033,64148,738,697,0,697,15
2020-10-26,Lassen,035,31185,779,764,2,766,0
2020-10-26,Los Angeles,037,10098052,304262,297961,2945,300906,6979
2020-10-26,Madera,039,155013,5101,4922,44,4966,53
2020-10-26,Marin,041,260295,7164,7064,19,7083,104
2020-10-26,Mariposa,043,17540,80,77,0,77,2
2020-10-26,Mendocino,045,87422,1095,1026,4,1030,20
2020-10-26,Merced,047,269075,9640,9375,39,9414,150
2020-10-26,Modoc,049,8938,44,28,0,28,0
2020-10-26,Mono,051,14174,217,167,5,172,1
2020-10-26,Monterey,053,433212,11585,11207,68,11275,87
2020-10-26,Napa,055,140530,2091,1966,8,1974,14
2020-10-26,Nevada,057,99092,656,618,18,636,8
2020-10-26,Orange,059,3164182,61254,58377,1780,60157,1442
2020-10-26,Placer,061,380077,4477,4161,15,4176,57
2020-10-26,Plumas,063,18699,84,63,0,63,0
2020-10-26,Riverside,065,2383286,68287,66475,395,66870,1294
2020-10-26,Sacramento,067,1510023,26092,25555,31,25586,496
2020-10-26,San Benito,069,59416,1445,1424,1,1425,15
2020-10-26,San Bernardino,071,2135413,64821,61871,464,62335,1153
2020-10-26,San Diego,073,3302833,57280,54957,1587,56544,870
2020-10-26,San Francisco,075,870044,12441,12072,51,12123,138
2020-10-26,San Joaquin,077,732212,22124,21459,213,21672,495
2020-10-26,San Luis Obispo,079,281455,4459,4133,31,4164,31
2020-10-26,San Mateo,081,765935,11497,11037,10,11047,156
2020-10-26,Santa Barbara,083,443738,10007,9827,94,9921,122
2020-10-26,Santa Clara,085,1922200,25756,24258,49,24307,365
2020-10-26,Santa Cruz,087,273765,2923,2808,34,2842,24
2020-10-26,Shasta,089,179085,2306,1889,20,1909,29
2020-10-26,Sierra,091,2930,6,6,0,6,0
2020-10-26,Siskiyou,093,43540,209,179,10,189,0
2020-10-26,Solano,095,438530,7555,7271,41,7312,62
2020-10-26,Sonoma,097,501317,9751,9315,27,9342,140
2020-10-26,Stanislaus,099,539301,17876,17666,770,18436,400
2020-10-26,Sutter,101,95872,1895,1817,1,1818,12
2020-10-26,Tehama,103,63373,950,892,2,894,5
2020-10-26,Trinity,105,12862,89,26,11,37,0
2020-10-26,Tulare,107,460477,18096,17432,383,17815,296
2020-10-26,Tuolumne,109,53932,286,271,4,275,4
2020-10-26,Ventura,111,848112,15117,14330,330,14660,154
2020-10-26,Yolo,113,214977,3297,3206,9,3215,58
2020-10-26,Yuba,115,75493,1269,1226,6,1232,10
2020-10-25,Alameda,001,1643700,23842,23192,229,23421,398
2020-10-25,Alpine,003,1148,3,3,0,3,0
2020-10-25,Amador,005,37829,346,330,0,330,16
2020-10-25,Butte,007,227075,3216,3087,32,3119,56
2020-10-25,Calaveras,009,45235,336,274,0,274,13
2020-10-25,Colusa,011,21464,555,548,1,549,6
2020-10-25,Contra Costa,013,1133247,19181,18640,94,18734,245
2020-10-25,Del Norte,015,27424,175,171,0,171,2
2020-10-25,El Dorado,017,186661,1429,1328,3,1331,4
2020-10-25,Fresno,019,978130,33654,30858,487,31345,441
2020-10-25,Glenn,021,27897,685,652,1,653,3
2020-10-25,Humboldt,023,135768,566,554,1,555,7
2020-10-25,Imperial,025,180216,12974,12572,53,12625,333
2020-10-25,Inyo,027,18085,245,226,5,231,14
2020-10-25,Kern,029,883053,34060,33185,420,33605,432
2020-10-25,Kings,031,150075,8728,8246,56,8302,82
2020-10-25,Lake,033,64148,721,695,0,695,15
2020-10-25,Lassen,035,31185,776,764,2,766,0
2020-10-25,Los Angeles,037,10098052,302700,297110,2908,300018,6973
2020-10-25,Madera,039,155013,5071,4909,39,4948,53
2020-10-25,Marin,041,260295,7154,7052,19,7071,102
2020-10-25,Mariposa,043,17540,80,77,0,77,2
2020-10-25,Mendocino,045,87422,1088,1024,4,1028,20
2020-10-25,Merced,047,269075,9575,9352,37,9389,150
2020-10-25,Modoc,049,8938,39,28,0,28,0
2020-10-25,Mono,051,14174,209,167,5,172,1
2020-10-25,Monterey,053,433212,11502,11182,63,11245,87
2020-10-25,Napa,055,140530,2061,1962,8,1970,14
2020-10-25,Nevada,057,99092,648,616,18,634,8
2020-10-25,Orange,059,3164182,60966,58185,1771,59956,1443
2020-10-25,Placer,061,380077,4425,4140,15,4155,57
2020-10-25,Plumas,063,18699,84,63,0,63,0
2020-10-25,Riverside,065,2383286,67835,66192,379,66571,1289
2020-10-25,Sacramento,067,1510023,25876,25445,28,25473,496
2020-10-25,San Benito,069,59416,1438,1423,1,1424,15
2020-10-25,San Bernardino,071,2135413,64280,61551,452,62003,1153
2020-10-25,San Diego,073,3302833,56817,54599,1555,56154,870
2020-10-25,San Francisco,075,870044,12368,12072,51,12123,137
2020-10-25,San Joaquin,077,732212,22016,21459,205,21664,495
2020-10-25,San Luis Obispo,079,281455,4417,4126,29,4155,31
2020-10-25,San Mateo,081,765935,11452,10987,10,10997,156
2020-10-25,Santa Barbara,083,443738,9987,9814,94,9908,122
2020-10-25,Santa Clara,085,1922200,25568,24087,49,24136,365
2020-10-25,Santa Cruz,087,273765,2896,2789,34,2823,24
2020-10-25,Shasta,089,179085,2242,1889,20,1909,29
2020-10-25,Sierra,091,2930,6,6,0,6,0
2020-10-25,Siskiyou,093,43540,206,176,10,186,0
2020-10-25,Solano,095,438530,7477,7197,41,7238,60
2020-10-25,Sonoma,097,501317,9658,9235,26,9261,140
2020-10-25,Stanislaus,099,539301,17819,17641,760,18401,400
2020-10-25,Sutter,101,95872,1877,1811,1,1812,12
2020-10-25,Tehama,103,63373,933,880,2,882,5
2020-10-25,Trinity,105,12862,85,26,11,37,0
2020-10-25,Tulare,107,460477,18023,17431,373,17804,296
2020-10-25,Tuolumne,109,53932,281,271,4,275,4
2020-10-25,Ventura,111,848112,15024,14300,324,14624,154
2020-10-25,Yolo,113,214977,3276,3190,9,3199,58
2020-10-25,Yuba,115,75493,1261,1219,6,1225,10
2020-10-24,Alameda,001,1643700,23771,23099,226,23325,398
2020-10-24,Alpine,003,1148,3,3,0,3,0
2020-10-24,Amador,005,37829,345,328,0,328,16
2020-10-24,Butte,007,227075,3207,3078,32,3110,56
2020-10-24,Calaveras,009,45235,334,274,0,274,13
2020-10-24,Colusa,011,21464,550,548,1,549,6
2020-10-24,Contra Costa,013,1133247,19114,18567,94,18661,244
2020-10-24,Del Norte,015,27424,174,171,0,171,2
2020-10-24,El Dorado,017,186661,1413,1317,3,1320,4
2020-10-24,Fresno,019,978130,33593,30752,482,31234,441
2020-10-24,Glenn,021,27897,682,650,1,651,3
2020-10-24,Humboldt,023,135768,564,553,1,554,7
2020-10-24,Imperial,025,180216,12947,12469,53,12522,333
2020-10-24,Inyo,027,18085,245,226,5,231,14
2020-10-24,Kern,029,883053,34002,33105,414,33519,432
2020-10-24,Kings,031,150075,8718,8228,55,8283,82
2020-10-24,Lake,033,64148,716,696,0,696,15
2020-10-24,Lassen,035,31185,775,764,2,766,0
2020-10-24,Los Angeles,037,10098052,301881,296323,2886,299209,6969
2020-10-24,Madera,039,155013,5058,4898,38,4936,53
2020-10-24,Marin,041,260295,7145,7042,19,7061,102
2020-10-24,Mariposa,043,17540,80,77,0,77,2
2020-10-24,Mendocino,045,87422,1076,1022,4,1026,20
2020-10-24,Merced,047,269075,9551,9351,37,9388,150
2020-10-24,Modoc,049,8938,38,28,0,28,0
2020-10-24,Mono,051,14174,195,167,5,172,1
2020-10-24,Monterey,053,433212,11433,11153,62,11215,87
2020-10-24,Napa,055,140530,2044,1957,8,1965,14
2020-10-24,Nevada,057,99092,644,608,18,626,8
2020-10-24,Orange,059,3164182,60811,57928,1761,59689,1441
2020-10-24,Placer,061,380077,4394,4093,15,4108,57
2020-10-24,Plumas,063,18699,78,63,0,63,0
2020-10-24,Riverside,065,2383286,67627,65902,364,66266,1288
2020-10-24,Sacramento,067,1510023,25795,25372,28,25400,496
2020-10-24,San Benito,069,59416,1433,1417,1,1418,15
2020-10-24,San Bernardino,071,2135413,64040,61351,443,61794,1153
2020-10-24,San Diego,073,3302833,56540,54330,1542,55872,868
2020-10-24,San Francisco,075,870044,12310,12073,50,12123,137
2020-10-24,San Joaquin,077,732212,21964,21458,200,21658,495
2020-10-24,San Luis Obispo,079,281455,4392,4119,28,4147,31
2020-10-24,San Mateo,081,765935,11413,10942,10,10952,155
2020-10-24,Santa Barbara,083,443738,9970,9781,94,9875,122
2020-10-24,Santa Clara,085,1922200,25481,23978,49,24027,365
2020-10-24,Santa Cruz,087,273765,2877,2775,34,2809,24
2020-10-24,Shasta,089,179085,2197,1878,20,1898,29
2020-10-24,Sierra,091,2930,6,6,0,6,0
2020-10-24,Siskiyou,093,43540,205,174,10,184,0
2020-10-24,Solano,095,438530,7424,7189,41,7230,60
2020-10-24,Sonoma,097,501317,9624,9179,26,9205,140
2020-10-24,Stanislaus,099,539301,17775,17574,744,18318,400
2020-10-24,Sutter,101,95872,1868,1804,1,1805,12
2020-10-24,Tehama,103,63373,925,872,2,874,5
2020-10-24,Trinity,105,12862,85,25,11,36,0
2020-10-24,Tulare,107,460477,18000,17406,362,17768,295
2020-10-24,Tuolumne,109,53932,278,269,4,273,4
2020-10-24,Ventura,111,848112,14971,14240,323,14563,154
2020-10-24,Yolo,113,214977,3264,3164,9,3173,57
2020-10-24,Yuba,115,75493,1258,1210,6,1216,10
2020-10-23,Alameda,001,1643700,23699,23047,224,23271,393
2020-10-23,Alpine,003,1148,3,3,0,3,0
2020-10-23,Amador,005,37829,344,324,0,324,16
2020-10-23,Butte,007,227075,3198,3059,32,3091,55
2020-10-23,Calaveras,009,45235,333,273,0,273,13
2020-10-23,Colusa,011,21464,550,547,1,548,6
2020-10-23,Contra Costa,013,1133247,19044,18483,93,18576,244
2020-10-23,Del Norte,015,27424,174,171,0,171,2
2020-10-23,El Dorado,017,186661,1404,1310,3,1313,4
2020-10-23,Fresno,019,978130,33526,30590,478,31068,441
2020-10-23,Glenn,021,27897,679,644,1,645,3
2020-10-23,Humboldt,023,135768,562,553,1,554,7
2020-10-23,Imperial,025,180216,12916,12398,52,12450,333
2020-10-23,Inyo,027,18085,244,226,5,231,14
2020-10-23,Kern,029,883053,33934,33077,409,33486,431
2020-10-23,Kings,031,150075,8709,8218,55,8273,82
2020-10-23,Lake,033,64148,714,689,0,689,15
2020-10-23,Lassen,035,31185,774,764,2,766,0
2020-10-23,Los Angeles,037,10098052,300799,294287,2858,297145,6956
2020-10-23,Madera,039,155013,5053,4888,38,4926,53
2020-10-23,Marin,041,260295,7132,7029,19,7048,102
2020-10-23,Mariposa,043,17540,80,77,0,77,2
2020-10-23,Mendocino,045,87422,1073,1019,4,1023,20
2020-10-23,Merced,047,269075,9537,9327,37,9364,149
2020-10-23,Modoc,049,8938,38,28,0,28,0
2020-10-23,Mono,051,14174,194,159,5,164,1
2020-10-23,Monterey,053,433212,11386,11099,58,11157,86
2020-10-23,Napa,055,140530,2036,1942,8,1950,14
2020-10-23,Nevada,057,99092,641,604,18,622,8
2020-10-23,Orange,059,3164182,60640,57595,1746,59341,1430
2020-10-23,Placer,061,380077,4348,4073,15,4088,57
2020-10-23,Plumas,063,18699,75,63,0,63,0
2020-10-23,Riverside,065,2383286,67388,65512,356,65868,1279
2020-10-23,Sacramento,067,1510023,25689,25224,28,25252,496
2020-10-23,San Benito,069,59416,1431,1412,1,1413,15
2020-10-23,San Bernardino,071,2135413,63753,60854,429,61283,1150
2020-10-23,San Diego,073,3302833,56234,53944,1515,55459,867
2020-10-23,San Francisco,075,870044,12279,12015,50,12065,137
2020-10-23,San Joaquin,077,732212,21908,21361,194,21555,495
2020-10-23,San Luis Obispo,079,281455,4366,4102,28,4130,31
2020-10-23,San Mateo,081,765935,11364,10872,10,10882,155
2020-10-23,Santa Barbara,083,443738,9954,9751,94,9845,121
2020-10-23,Santa Clara,085,1922200,25379,23822,49,23871,364
2020-10-23,Santa Cruz,087,273765,2863,2757,34,2791,24
2020-10-23,Shasta,089,179085,2160,1846,19,1865,29
2020-10-23,Sierra,091,2930,6,6,0,6,0
2020-10-23,Siskiyou,093,43540,201,172,10,182,0
2020-10-23,Solano,095,438530,7393,7174,41,7215,59
2020-10-23,Sonoma,097,501317,9568,9112,26,9138,139
2020-10-23,Stanislaus,099,539301,17738,17496,737,18233,395
2020-10-23,Sutter,101,95872,1861,1797,1,1798,12
2020-10-23,Tehama,103,63373,916,862,2,864,5
2020-10-23,Trinity,105,12862,85,26,11,37,0
2020-10-23,Tulare,107,460477,17955,17334,350,17684,295
2020-10-23,Tuolumne,109,53932,276,254,4,258,4
2020-10-23,Ventura,111,848112,14942,14192,323,14515,155
2020-10-23,Yolo,113,214977,3252,3140,9,3149,57
2020-10-23,Yuba,115,75493,1254,1206,6,1212,10
2020-10-22,Alameda,001,1643700,23596,22915,224,23139,393
2020-10-22,Alpine,003,1148,3,3,0,3,0
2020-10-22,Amador,005,37829,340,317,0,317,16
2020-10-22,Butte,007,227075,3188,3046,30,3076,55
2020-10-22,Calaveras,009,45235,330,273,0,273,13
2020-10-22,Colusa,011,21464,550,547,1,548,6
2020-10-22,Contra Costa,013,1133247,18972,18393,93,18486,243
2020-10-22,Del Norte,015,27424,173,168,0,168,2
2020-10-22,El Dorado,017,186661,1394,1308,3,1311,4
2020-10-22,Fresno,019,978130,33416,30471,470,30941,438
2020-10-22,Glenn,021,27897,672,643,1,644,3
2020-10-22,Humboldt,023,135768,561,548,1,549,7
2020-10-22,Imperial,025,180216,12863,12311,50,12361,333
2020-10-22,Inyo,027,18085,241,220,5,225,14
2020-10-22,Kern,029,883053,33853,32991,406,33397,431
2020-10-22,Kings,031,150075,8458,8201,55,8256,82
2020-10-22,Lake,033,64148,710,678,0,678,15
2020-10-22,Lassen,035,31185,771,764,2,766,0
2020-10-22,Los Angeles,037,10098052,299424,291599,2799,294398,6935
2020-10-22,Madera,039,155013,5032,4847,38,4885,52
2020-10-22,Marin,041,260295,7125,7014,19,7033,102
2020-10-22,Mariposa,043,17540,80,77,0,77,2
2020-10-22,Mendocino,045,87422,1068,1016,4,1020,20
2020-10-22,Merced,047,269075,9509,9323,37,9360,149
2020-10-22,Modoc,049,8938,34,26,0,26,0
2020-10-22,Mono,051,14174,189,156,5,161,1
2020-10-22,Monterey,053,433212,11327,11059,55,11114,84
2020-10-22,Napa,055,140530,2021,1928,8,1936,14
2020-10-22,Nevada,057,99092,635,600,18,618,8
2020-10-22,Orange,059,3164182,60425,57418,1729,59147,1422
2020-10-22,Placer,061,380077,4299,4036,15,4051,57
2020-10-22,Plumas,063,18699,72,62,0,62,0
2020-10-22,Riverside,065,2383286,67054,65104,336,65440,1279
2020-10-22,Sacramento,067,1510023,25549,25054,28,25082,492
2020-10-22,San Benito,069,59416,1427,1403,1,1404,15
2020-10-22,San Bernardino,071,2135413,63351,60402,414,60816,1149
2020-10-22,San Diego,073,3302833,55847,53514,1496,55010,866
2020-10-22,San Francisco,075,870044,12221,11991,48,12039,137
2020-10-22,San Joaquin,077,732212,21835,21282,188,21470,495
2020-10-22,San Luis Obispo,079,281455,4350,4081,28,4109,31
2020-10-22,San Mateo,081,765935,11308,10796,10,10806,155
2020-10-22,Santa Barbara,083,443738,9920,9710,92,9802,120
2020-10-22,Santa Clara,085,1922200,25225,23621,49,23670,363
2020-10-22,Santa Cruz,087,273765,2845,2738,33,2771,24
2020-10-22,Shasta,089,179085,2114,1799,19,1818,29
2020-10-22,Sierra,091,2930,6,6,0,6,0
2020-10-22,Siskiyou,093,43540,201,169,10,179,0
2020-10-22,Solano,095,438530,7347,7116,41,7157,59
2020-10-22,Sonoma,097,501317,9502,9052,25,9077,139
2020-10-22,Stanislaus,099,539301,17684,17440,725,18165,395
2020-10-22,Sutter,101,95872,1847,1794,1,1795,12
2020-10-22,Tehama,103,63373,905,852,2,854,5
2020-10-22,Trinity,105,12862,84,26,11,37,0
2020-10-22,Tulare,107,460477,17889,17265,337,17602,293
2020-10-22,Tuolumne,109,53932,274,252,4,256,4
2020-10-22,Ventura,111,848112,14895,14124,321,14445,154
2020-10-22,Yolo,113,214977,3240,3116,9,3125,58
2020-10-22,Yuba,115,75493,1247,1199,5,1204,10
2020-10-21,Alameda,001,1643700,23508,22853,222,23075,392
2020-10-21,Alpine,003,1148,3,3,0,3,0
2020-10-21,Amador,005,37829,335,313,0,313,16
2020-10-21,Butte,007,227075,3176,3041,30,3071,55
2020-10-21,Calaveras,009,45235,329,272,0,272,13
2020-10-21,Colusa,011,21464,550,546,1,547,6
2020-10-21,Contra Costa,013,1133247,18898,18299,93,18392,243
2020-10-21,Del Norte,015,27424,173,169,0,169,2
2020-10-21,El Dorado,017,186661,1382,1305,2,1307,4
2020-10-21,Fresno,019,978130,33320,30328,465,30793,433
2020-10-21,Glenn,021,27897,667,640,1,641,3
2020-10-21,Humboldt,023,135768,560,548,1,549,7
2020-10-21,Imperial,025,180216,12806,12210,50,12260,331
2020-10-21,Inyo,027,18085,237,220,5,225,14
2020-10-21,Kern,029,883053,33778,32956,405,33361,430
2020-10-21,Kings,031,150075,8431,8186,55,8241,80
2020-10-21,Lake,033,64148,709,676,0,676,15
2020-10-21,Lassen,035,31185,770,764,2,766,0
2020-10-21,Los Angeles,037,10098052,298084,288096,2757,290853,6923
2020-10-21,Madera,039,155013,5007,4831,38,4869,52
2020-10-21,Marin,041,260295,7116,7002,19,7021,102
2020-10-21,Mariposa,043,17540,80,77,0,77,2
2020-10-21,Mendocino,045,87422,1066,1011,4,1015,21
2020-10-21,Merced,047,269075,9485,9319,35,9354,149
2020-10-21,Modoc,049,8938,33,26,0,26,0
2020-10-21,Mono,051,14174,187,156,5,161,1
2020-10-21,Monterey,053,433212,11289,11005,54,11059,83
2020-10-21,Napa,055,140530,2006,1918,8,1926,13
2020-10-21,Nevada,057,99092,629,597,18,615,8
2020-10-21,Orange,059,3164182,60212,57189,1720,58909,1409
2020-10-21,Placer,061,380077,4262,4007,15,4022,56
2020-10-21,Plumas,063,18699,69,58,0,58,0
2020-10-21,Riverside,065,2383286,66758,64778,312,65090,1278
2020-10-21,Sacramento,067,1510023,25355,24908,28,24936,490
2020-10-21,San Benito,069,59416,1426,1401,1,1402,14
2020-10-21,San Bernardino,071,2135413,62943,59948,407,60355,1141
2020-10-21,San Diego,073,3302833,55495,53279,1468,54747,863
2020-10-21,San Francisco,075,870044,12172,11976,47,12023,137
2020-10-21,San Joaquin,077,732212,21759,21201,182,21383,495
2020-10-21,San Luis Obispo,079,281455,4335,4055,26,4081,31
2020-10-21,San Mateo,081,765935,11259,10730,10,10740,155
2020-10-21,Santa Barbara,083,443738,9902,9681,91,9772,121
2020-10-21,Santa Clara,085,1922200,25099,23537,49,23586,361
2020-10-21,Santa Cruz,087,273765,2822,2729,33,2762,24
2020-10-21,Shasta,089,179085,2077,1777,19,1796,27
2020-10-21,Sierra,091,2930,6,6,0,6,0
2020-10-21,Siskiyou,093,43540,197,169,10,179,0
2020-10-21,Solano,095,438530,7301,7088,41,7129,59
2020-10-21,Sonoma,097,501317,9422,8987,25,9012,138
2020-10-21,Stanislaus,099,539301,17634,17419,717,18136,392
2020-10-21,Sutter,101,95872,1832,1786,1,1787,12
2020-10-21,Tehama,103,63373,889,824,2,826,5
2020-10-21,Trinity,105,12862,78,25,10,35,0
2020-10-21,Tulare,107,460477,17851,17204,323,17527,292
2020-10-21,Tuolumne,109,53932,273,251,4,255,4
2020-10-21,Ventura,111,848112,14832,14050,318,14368,153
2020-10-21,Yolo,113,214977,3221,3095,9,3104,58
2020-10-21,Yuba,115,75493,1238,1194,5,1199,10
2020-10-20,Alameda,001,1643700,23405,22750,218,22968,391
2020-10-20,Alpine,003,1148,3,3,0,3,0
2020-10-20,Amador,005,37829,334,313,0,313,16
2020-10-20,Butte,007,227075,3164,3027,30,3057,56
2020-10-20,Calaveras,009,45235,328,273,0,273,13
2020-10-20,Colusa,011,21464,547,546,1,547,6
2020-10-20,Contra Costa,013,1133247,18806,18246,93,18339,241
2020-10-20,Del Norte,015,27424,172,169,0,169,2
2020-10-20,El Dorado,017,186661,1376,1295,2,1297,4
2020-10-20,Fresno,019,978130,33217,30220,459,30679,431
2020-10-20,Glenn,021,27897,662,638,1,639,3
2020-10-20,Humboldt,023,135768,556,545,1,546,7
2020-10-20,Imperial,025,180216,12737,12114,50,12164,330
2020-10-20,Inyo,027,18085,237,218,5,223,14
2020-10-20,Kern,029,883053,33703,32889,392,33281,429
2020-10-20,Kings,031,150075,8413,8178,54,8232,80
2020-10-20,Lake,033,64148,707,675,0,675,15
2020-10-20,Lassen,035,31185,769,757,2,759,0
2020-10-20,Los Angeles,037,10098052,296592,287727,2707,290434,6891
2020-10-20,Madera,039,155013,4990,4823,38,4861,52
2020-10-20,Marin,041,260295,7101,6994,19,7013,101
2020-10-20,Mariposa,043,17540,79,77,0,77,2
2020-10-20,Mendocino,045,87422,1064,1004,4,1008,21
2020-10-20,Merced,047,269075,9463,9323,35,9358,149
2020-10-20,Modoc,049,8938,32,26,0,26,0
2020-10-20,Mono,051,14174,187,156,5,161,1
2020-10-20,Monterey,053,433212,11246,10942,51,10993,81
2020-10-20,Napa,055,140530,1987,1912,8,1920,13
2020-10-20,Nevada,057,99092,619,596,18,614,8
2020-10-20,Orange,059,3164182,59948,56914,1710,58624,1397
2020-10-20,Placer,061,380077,4224,3997,15,4012,56
2020-10-20,Plumas,063,18699,66,53,0,53,0
2020-10-20,Riverside,065,2383286,66378,64452,300,64752,1275
2020-10-20,Sacramento,067,1510023,25228,24767,27,24794,485
2020-10-20,San Benito,069,59416,1423,1398,1,1399,14
2020-10-20,San Bernardino,071,2135413,62560,59571,405,59976,1109
2020-10-20,San Diego,073,3302833,55159,53004,1448,54452,857
2020-10-20,San Francisco,075,870044,12125,12013,46,12059,126
2020-10-20,San Joaquin,077,732212,21680,21173,172,21345,490
2020-10-20,San Luis Obispo,079,281455,4317,4043,25,4068,31
2020-10-20,San Mateo,081,765935,11212,10659,10,10669,155
2020-10-20,Santa Barbara,083,443738,9873,9664,89,9753,121
2020-10-20,Santa Clara,085,1922200,24962,23406,49,23455,358
2020-10-20,Santa Cruz,087,273765,2799,2710,33,2743,23
2020-10-20,Shasta,089,179085,2054,1747,19,1766,20
2020-10-20,Sierra,091,2930,6,6,0,6,0
2020-10-20,Siskiyou,093,43540,189,168,10,178,0
2020-10-20,Solano,095,438530,7252,7044,41,7085,57
2020-10-20,Sonoma,097,501317,9359,8904,23,8927,135
2020-10-20,Stanislaus,099,539301,17580,17367,713,18080,393
2020-10-20,Sutter,101,95872,1823,1783,1,1784,12
2020-10-20,Tehama,103,63373,874,813,2,815,5
2020-10-20,Trinity,105,12862,77,25,10,35,0
2020-10-20,Tulare,107,460477,17784,17156,318,17474,289
2020-10-20,Tuolumne,109,53932,271,250,4,254,4
2020-10-20,Ventura,111,848112,14768,13980,316,14296,152
2020-10-20,Yolo,113,214977,3198,3083,9,3092,56
2020-10-20,Yuba,115,75493,1228,1191,5,1196,10
2020-10-19,Alameda,001,1643700,23293,22647,217,22864,392
2020-10-19,Alpine,003,1148,3,3,0,3,0
2020-10-19,Amador,005,37829,328,313,0,313,16
2020-10-19,Butte,007,227075,3153,3026,30,3056,55
2020-10-19,Calaveras,009,45235,327,268,0,268,13
2020-10-19,Colusa,011,21464,547,544,1,545,6
2020-10-19,Contra Costa,013,1133247,18708,18173,93,18266,239
2020-10-19,Del Norte,015,27424,169,167,0,167,2
2020-10-19,El Dorado,017,186661,1355,1287,2,1289,4
2020-10-19,Fresno,019,978130,33108,30152,453,30605,431
2020-10-19,Glenn,021,27897,657,635,0,635,3
2020-10-19,Humboldt,023,135768,556,543,1,544,7
2020-10-19,Imperial,025,180216,12683,12036,48,12084,330
2020-10-19,Inyo,027,18085,236,218,5,223,14
2020-10-19,Kern,029,883053,33627,32840,389,33229,428
2020-10-19,Kings,031,150075,8395,8173,54,8227,80
2020-10-19,Lake,033,64148,704,673,0,673,15
2020-10-19,Lassen,035,31185,768,757,2,759,0
2020-10-19,Los Angeles,037,10098052,295105,287119,2669,289788,6858
2020-10-19,Madera,039,155013,4975,4787,38,4825,52
2020-10-19,Marin,041,260295,7083,6981,19,7000,100
2020-10-19,Mariposa,043,17540,79,77,0,77,2
2020-10-19,Mendocino,045,87422,1059,1001,4,1005,21
2020-10-19,Merced,047,269075,9438,9305,31,9336,148
2020-10-19,Modoc,049,8938,31,26,0,26,0
2020-10-19,Mono,051,14174,182,156,5,161,1
2020-10-19,Monterey,053,433212,11185,10907,51,10958,80
2020-10-19,Napa,055,140530,1975,1892,8,1900,12
2020-10-19,Nevada,057,99092,616,590,18,608,8
2020-10-19,Orange,059,3164182,59663,56652,1695,58347,1396
2020-10-19,Placer,061,380077,4175,3962,15,3977,49
2020-10-19,Plumas,063,18699,64,52,0,52,0
2020-10-19,Riverside,065,2383286,65947,64016,284,64300,1272
2020-10-19,Sacramento,067,1510023,25089,24542,27,24569,483
2020-10-19,San Benito,069,59416,1416,1395,1,1396,14
2020-10-19,San Bernardino,071,2135413,62110,59265,394,59659,1100
2020-10-19,San Diego,073,3302833,54773,52739,1423,54162,853
2020-10-19,San Francisco,075,870044,12081,11879,46,11925,126
2020-10-19,San Joaquin,077,732212,21605,20930,164,21094,489
2020-10-19,San Luis Obispo,079,281455,4301,4016,25,4041,31
2020-10-19,San Mateo,081,765935,11166,10568,10,10578,154
2020-10-19,Santa Barbara,083,443738,9838,9632,89,9721,121
2020-10-19,Santa Clara,085,1922200,24812,23301,49,23350,352
2020-10-19,Santa Cruz,087,273765,2782,2705,33,2738,19
2020-10-19,Shasta,089,179085,2010,1709,18,1727,20
2020-10-19,Sierra,091,2930,6,6,0,6,0
2020-10-19,Siskiyou,093,43540,182,167,10,177,0
2020-10-19,Solano,095,438530,7211,7003,41,7044,57
2020-10-19,Sonoma,097,501317,9272,8830,23,8853,135
2020-10-19,Stanislaus,099,539301,17529,17342,703,18045,390
2020-10-19,Sutter,101,95872,1818,1773,1,1774,12
2020-10-19,Tehama,103,63373,871,793,2,795,5
2020-10-19,Trinity,105,12862,75,23,10,33,0
2020-10-19,Tulare,107,460477,17734,17047,311,17358,291
2020-10-19,Tuolumne,109,53932,269,247,4,251,4
2020-10-19,Ventura,111,848112,14702,13930,313,14243,152
2020-10-19,Yolo,113,214977,3185,3069,9,3078,56
2020-10-19,Yuba,115,75493,1221,1183,5,1188,10
2020-10-18,Alameda,001,1643700,23189,22546,216,22762,392
2020-10-18,Alpine,003,1148,3,3,0,3,0
2020-10-18,Amador,005,37829,316,313,0,313,16
2020-10-18,Butte,007,227075,3140,3019,30,3049,55
2020-10-18,Calaveras,009,45235,326,267,0,267,13
2020-10-18,Colusa,011,21464,545,544,1,545,6
2020-10-18,Contra Costa,013,1133247,18609,18120,93,18213,237
2020-10-18,Del Norte,015,27424,169,167,0,167,2
2020-10-18,El Dorado,017,186661,1346,1283,2,1285,4
2020-10-18,Fresno,019,978130,32979,30051,445,30496,430
2020-10-18,Glenn,021,27897,655,634,0,634,3
2020-10-18,Humboldt,023,135768,553,540,1,541,7
2020-10-18,Imperial,025,180216,12621,11987,45,12032,330
2020-10-18,Inyo,027,18085,233,215,5,220,14
2020-10-18,Kern,029,883053,33554,32799,382,33181,428
2020-10-18,Kings,031,150075,8380,8159,54,8213,80
2020-10-18,Lake,033,64148,697,670,0,670,15
2020-10-18,Lassen,035,31185,768,757,2,759,0
2020-10-18,Los Angeles,037,10098052,293398,286187,2626,288813,6857
2020-10-18,Madera,039,155013,4950,4770,37,4807,52
2020-10-18,Marin,041,260295,7062,6969,19,6988,99
2020-10-18,Mariposa,043,17540,79,77,0,77,2
2020-10-18,Mendocino,045,87422,1057,988,4,992,21
2020-10-18,Merced,047,269075,9403,9292,31,9323,148
2020-10-18,Modoc,049,8938,30,26,0,26,0
2020-10-18,Mono,051,14174,177,155,5,160,1
2020-10-18,Monterey,053,433212,11132,10872,51,10923,80
2020-10-18,Napa,055,140530,1962,1882,8,1890,12
2020-10-18,Nevada,057,99092,610,582,18,600,8
2020-10-18,Orange,059,3164182,59366,56394,1679,58073,1396
2020-10-18,Placer,061,380077,4127,3938,15,3953,49
2020-10-18,Plumas,063,18699,62,52,0,52,0
2020-10-18,Riverside,065,2383286,65634,63765,263,64028,1270
2020-10-18,Sacramento,067,1510023,24934,24425,27,24452,482
2020-10-18,San Benito,069,59416,1409,1395,1,1396,14
2020-10-18,San Bernardino,071,2135413,61610,58893,386,59279,1098
2020-10-18,San Diego,073,3302833,54384,52359,1402,53761,853
2020-10-18,San Francisco,075,870044,12042,11878,46,11924,126
2020-10-18,San Joaquin,077,732212,21522,20931,151,21082,489
2020-10-18,San Luis Obispo,079,281455,4270,4009,23,4032,31
2020-10-18,San Mateo,081,765935,11107,10503,10,10513,154
2020-10-18,Santa Barbara,083,443738,9799,9608,88,9696,121
2020-10-18,Santa Clara,085,1922200,24639,23169,49,23218,352
2020-10-18,Santa Cruz,087,273765,2768,2692,33,2725,19
2020-10-18,Shasta,089,179085,1985,1708,18,1726,20
2020-10-18,Sierra,091,2930,6,6,0,6,0
2020-10-18,Siskiyou,093,43540,182,167,10,177,0
2020-10-18,Solano,095,438530,7164,6962,41,7003,57
2020-10-18,Sonoma,097,501317,9195,8781,22,8803,134
2020-10-18,Stanislaus,099,539301,17473,17290,694,17984,390
2020-10-18,Sutter,101,95872,1809,1764,1,1765,12
2020-10-18,Tehama,103,63373,839,774,2,776,5
2020-10-18,Trinity,105,12862,75,20,10,30,0
2020-10-18,Tulare,107,460477,17640,17048,302,17350,290
2020-10-18,Tuolumne,109,53932,264,245,4,249,4
2020-10-18,Ventura,111,848112,14622,13901,312,14213,151
2020-10-18,Yolo,113,214977,3146,3059,9,3068,55
2020-10-18,Yuba,115,75493,1210,1176,5,1181,10
2020-10-17,Alameda,001,1643700,23143,22394,214,22608,398
2020-10-17,Alpine,003,1148,3,3,0,3,0
2020-10-17,Amador,005,37829,314,309,0,309,16
2020-10-17,Butte,007,227075,3132,3012,28,3040,55
2020-10-17,Calaveras,009,45235,326,267,0,267,13
2020-10-17,Colusa,011,21464,544,544,1,545,6
2020-10-17,Contra Costa,013,1133247,18556,18005,93,18098,237
2020-10-17,Del Norte,015,27424,169,167,0,167,2
2020-10-17,El Dorado,017,186661,1342,1277,2,1279,4
2020-10-17,Fresno,019,978130,32925,29911,443,30354,430
2020-10-17,Glenn,021,27897,652,633,0,633,3
2020-10-17,Humboldt,023,135768,550,535,1,536,7
2020-10-17,Imperial,025,180216,12593,11962,45,12007,330
2020-10-17,Inyo,027,18085,228,212,5,217,14
2020-10-17,Kern,029,883053,33503,32710,379,33089,428
2020-10-17,Kings,031,150075,8374,8151,53,8204,80
2020-10-17,Lake,033,64148,694,663,0,663,15
2020-10-17,Lassen,035,31185,768,757,2,759,0
2020-10-17,Los Angeles,037,10098052,292645,285858,2599,288457,6844
2020-10-17,Madera,039,155013,4944,4759,37,4796,53
2020-10-17,Marin,041,260295,7059,6958,19,6977,99
2020-10-17,Mariposa,043,17540,78,77,0,77,2
2020-10-17,Mendocino,045,87422,1050,977,4,981,21
2020-10-17,Merced,047,269075,9389,9275,31,9306,148
2020-10-17,Modoc,049,8938,30,26,0,26,0
2020-10-17,Mono,051,14174,176,155,5,160,1
2020-10-17,Monterey,053,433212,11092,10807,50,10857,80
2020-10-17,Napa,055,140530,1953,1866,8,1874,12
2020-10-17,Nevada,057,99092,609,580,18,598,8
2020-10-17,Orange,059,3164182,59224,56197,1672,57869,1396
2020-10-17,Placer,061,380077,4100,3898,15,3913,49
2020-10-17,Plumas,063,18699,62,52,0,52,0
2020-10-17,Riverside,065,2383286,65436,63171,253,63424,1270
2020-10-17,Sacramento,067,1510023,24850,24304,27,24331,482
2020-10-17,San Benito,069,59416,1405,1389,1,1390,14
2020-10-17,San Bernardino,071,2135413,61340,58415,379,58794,1097
2020-10-17,San Diego,073,3302833,54159,51986,1391,53377,853
2020-10-17,San Francisco,075,870044,12014,11877,45,11922,126
2020-10-17,San Joaquin,077,732212,21468,20932,145,21077,489
2020-10-17,San Luis Obispo,079,281455,4255,3979,23,4002,31
2020-10-17,San Mateo,081,765935,11079,10423,10,10433,153
2020-10-17,Santa Barbara,083,443738,9780,9588,86,9674,121
2020-10-17,Santa Clara,085,1922200,24550,22997,49,23046,349
2020-10-17,Santa Cruz,087,273765,2754,2680,33,2713,19
2020-10-17,Shasta,089,179085,1959,1679,18,1697,20
2020-10-17,Sierra,091,2930,6,6,0,6,0
2020-10-17,Siskiyou,093,43540,181,167,10,177,0
2020-10-17,Solano,095,438530,7138,6929,41,6970,57
2020-10-17,Sonoma,097,501317,9152,8725,22,8747,134
2020-10-17,Stanislaus,099,539301,17433,17232,685,17917,390
2020-10-17,Sutter,101,95872,1807,1762,1,1763,12
2020-10-17,Tehama,103,63373,823,764,2,766,5
2020-10-17,Trinity,105,12862,75,20,10,30,0
2020-10-17,Tulare,107,460477,17610,16995,293,17288,290
2020-10-17,Tuolumne,109,53932,264,241,4,245,4
2020-10-17,Ventura,111,848112,14577,13845,309,14154,151
2020-10-17,Yolo,113,214977,3131,3045,7,3052,55
2020-10-17,Yuba,115,75493,1205,1164,5,1169,10
2020-10-16,Alameda,001,1643700,23089,22315,214,22529,397
2020-10-16,Alpine,003,1148,3,3,0,3,0
2020-10-16,Amador,005,37829,314,309,0,309,16
2020-10-16,Butte,007,227075,3121,3004,28,3032,54
2020-10-16,Calaveras,009,45235,326,267,0,267,13
2020-10-16,Colusa,011,21464,543,544,1,545,6
2020-10-16,Contra Costa,013,1133247,18503,17956,93,18049,237
2020-10-16,Del Norte,015,27424,169,166,0,166,2
2020-10-16,El Dorado,017,186661,1336,1273,2,1275,4
2020-10-16,Fresno,019,978130,32849,29796,442,30238,427
2020-10-16,Glenn,021,27897,647,632,0,632,3
2020-10-16,Humboldt,023,135768,550,533,1,534,7
2020-10-16,Imperial,025,180216,12553,11885,45,11930,330
2020-10-16,Inyo,027,18085,224,212,5,217,14
2020-10-16,Kern,029,883053,33460,32660,377,33037,428
2020-10-16,Kings,031,150075,8365,8146,52,8198,80
2020-10-16,Lake,033,64148,692,644,0,644,14
2020-10-16,Lassen,035,31185,768,757,2,759,0
2020-10-16,Los Angeles,037,10098052,291583,284988,2578,287566,6835
2020-10-16,Madera,039,155013,4932,4736,36,4772,53
2020-10-16,Marin,041,260295,7049,6933,19,6952,99
2020-10-16,Mariposa,043,17540,78,76,0,76,2
2020-10-16,Mendocino,045,87422,1043,974,4,978,21
2020-10-16,Merced,047,269075,9372,9246,31,9277,148
2020-10-16,Modoc,049,8938,30,26,0,26,0
2020-10-16,Mono,051,14174,174,155,5,160,1
2020-10-16,Monterey,053,433212,11057,10727,50,10777,79
2020-10-16,Napa,055,140530,1944,1855,8,1863,12
2020-10-16,Nevada,057,99092,607,579,18,597,8
2020-10-16,Orange,059,3164182,59046,56091,1666,57757,1388
2020-10-16,Placer,061,380077,4080,3864,15,3879,49
2020-10-16,Plumas,063,18699,61,52,0,52,0
2020-10-16,Riverside,065,2383286,65211,62986,252,63238,1267
2020-10-16,Sacramento,067,1510023,24756,24144,27,24171,479
2020-10-16,San Benito,069,59416,1402,1388,1,1389,14
2020-10-16,San Bernardino,071,2135413,61070,58233,379,58612,1069
2020-10-16,San Diego,073,3302833,53917,51785,1377,53162,850
2020-10-16,San Francisco,075,870044,11992,11840,44,11884,126
2020-10-16,San Joaquin,077,732212,21423,20910,144,21054,489
2020-10-16,San Luis Obispo,079,281455,4239,3952,23,3975,32
2020-10-16,San Mateo,081,765935,11054,10405,10,10415,153
2020-10-16,Santa Barbara,083,443738,9762,9549,86,9635,119
2020-10-16,Santa Clara,085,1922200,24463,22920,49,22969,345
2020-10-16,Santa Cruz,087,273765,2741,2666,33,2699,20
2020-10-16,Shasta,089,179085,1937,1660,18,1678,20
2020-10-16,Sierra,091,2930,6,6,0,6,0
2020-10-16,Siskiyou,093,43540,179,167,10,177,0
2020-10-16,Solano,095,438530,7115,6879,41,6920,55
2020-10-16,Sonoma,097,501317,9096,8652,22,8674,133
2020-10-16,Stanislaus,099,539301,17399,17201,677,17878,366
2020-10-16,Sutter,101,95872,1799,1756,1,1757,12
2020-10-16,Tehama,103,63373,822,737,2,739,3
2020-10-16,Trinity,105,12862,75,20,10,30,0
2020-10-16,Tulare,107,460477,17578,16965,285,17250,290
2020-10-16,Tuolumne,109,53932,262,237,4,241,4
2020-10-16,Ventura,111,848112,14534,13805,304,14109,152
2020-10-16,Yolo,113,214977,3122,3030,7,3037,55
2020-10-16,Yuba,115,75493,1205,1155,5,1160,10
2020-10-15,Alameda,001,1643700,23021,22267,213,22480,390
2020-10-15,Alpine,003,1148,3,3,0,3,0
2020-10-15,Amador,005,37829,314,309,0,309,16
2020-10-15,Butte,007,227075,3109,3000,27,3027,54
2020-10-15,Calaveras,009,45235,325,267,0,267,13
2020-10-15,Colusa,011,21464,542,543,1,544,6
2020-10-15,Contra Costa,013,1133247,18436,17893,92,17985,237
2020-10-15,Del Norte,015,27424,169,164,0,164,2
2020-10-15,El Dorado,017,186661,1331,1265,2,1267,4
2020-10-15,Fresno,019,978130,32752,29727,439,30166,425
2020-10-15,Glenn,021,27897,642,632,0,632,3
2020-10-15,Humboldt,023,135768,546,531,1,532,7
2020-10-15,Imperial,025,180216,12512,11820,43,11863,330
2020-10-15,Inyo,027,18085,224,210,5,215,14
2020-10-15,Kern,029,883053,33379,32593,374,32967,427
2020-10-15,Kings,031,150075,8350,8134,52,8186,80
2020-10-15,Lake,033,64148,690,642,0,642,14
2020-10-15,Lassen,035,31185,767,752,2,754,0
2020-10-15,Los Angeles,037,10098052,290298,284019,2544,286563,6807
2020-10-15,Madera,039,155013,4920,4723,35,4758,50
2020-10-15,Marin,041,260295,7041,6912,19,6931,99
2020-10-15,Mariposa,043,17540,78,76,0,76,2
2020-10-15,Mendocino,045,87422,1037,963,4,967,21
2020-10-15,Merced,047,269075,9345,9213,31,9244,147
2020-10-15,Modoc,049,8938,30,26,0,26,0
2020-10-15,Mono,051,14174,174,155,5,160,1
2020-10-15,Monterey,053,433212,10990,10677,49,10726,79
2020-10-15,Napa,055,140530,1931,1842,8,1850,12
2020-10-15,Nevada,057,99092,603,575,18,593,8
2020-10-15,Orange,059,3164182,58829,55952,1654,57606,1379
2020-10-15,Placer,061,380077,4051,3848,15,3863,48
2020-10-15,Plumas,063,18699,58,52,0,52,0
2020-10-15,Riverside,065,2383286,64880,62819,249,63068,1266
2020-10-15,Sacramento,067,1510023,24640,24068,27,24095,474
2020-10-15,San Benito,069,59416,1399,1384,1,1385,14
2020-10-15,San Bernardino,071,2135413,60731,58068,376,58444,1067
2020-10-15,San Diego,073,3302833,53633,51472,1361,52833,847
2020-10-15,San Francisco,075,870044,11964,11808,41,11849,126
2020-10-15,San Joaquin,077,732212,21350,20880,138,21018,487
2020-10-15,San Luis Obispo,079,281455,4222,3934,23,3957,32
2020-10-15,San Mateo,081,765935,11014,10340,10,10350,152
2020-10-15,Santa Barbara,083,443738,9738,9526,85,9611,117
2020-10-15,Santa Clara,085,1922200,24347,22808,49,22857,343
2020-10-15,Santa Cruz,087,273765,2727,2656,33,2689,13
2020-10-15,Shasta,089,179085,1926,1635,18,1653,20
2020-10-15,Sierra,091,2930,6,6,0,6,0
2020-10-15,Siskiyou,093,43540,175,166,10,176,0
2020-10-15,Solano,095,438530,7076,6830,41,6871,55
2020-10-15,Sonoma,097,501317,9004,8571,22,8593,133
2020-10-15,Stanislaus,099,539301,17361,17151,663,17814,366
2020-10-15,Sutter,101,95872,1796,1752,1,1753,12
2020-10-15,Tehama,103,63373,795,726,2,728,3
2020-10-15,Trinity,105,12862,75,20,10,30,0
2020-10-15,Tulare,107,460477,17518,16918,270,17188,289
2020-10-15,Tuolumne,109,53932,260,236,4,240,4
2020-10-15,Ventura,111,848112,14478,13750,299,14049,152
2020-10-15,Yolo,113,214977,3102,3014,7,3021,55
2020-10-15,Yuba,115,75493,1198,1151,5,1156,10
2020-10-14,Alameda,001,1643700,22922,22227,212,22439,398
2020-10-14,Alpine,003,1148,3,3,0,3,0
2020-10-14,Amador,005,37829,312,308,0,308,16
2020-10-14,Butte,007,227075,3101,2995,27,3022,54
2020-10-14,Calaveras,009,45235,325,266,0,266,12
2020-10-14,Colusa,011,21464,542,543,1,544,6
2020-10-14,Contra Costa,013,1133247,18379,17820,90,17910,236
2020-10-14,Del Norte,015,27424,168,163,0,163,2
2020-10-14,El Dorado,017,186661,1325,1264,2,1266,4
2020-10-14,Fresno,019,978130,32637,29650,433,30083,424
2020-10-14,Glenn,021,27897,641,629,0,629,3
2020-10-14,Humboldt,023,135768,543,531,1,532,7
2020-10-14,Imperial,025,180216,12475,11765,40,11805,330
2020-10-14,Inyo,027,18085,223,209,4,213,14
2020-10-14,Kern,029,883053,33304,32528,372,32900,425
2020-10-14,Kings,031,150075,8332,8118,52,8170,80
2020-10-14,Lake,033,64148,689,642,0,642,14
2020-10-14,Lassen,035,31185,765,752,2,754,0
2020-10-14,Los Angeles,037,10098052,288985,282918,2500,285418,6786
2020-10-14,Madera,039,155013,4905,4713,34,4747,50
2020-10-14,Marin,041,260295,7035,6907,19,6926,99
2020-10-14,Mariposa,043,17540,77,76,0,76,2
2020-10-14,Mendocino,045,87422,1031,955,4,959,21
2020-10-14,Merced,047,269075,9320,9201,29,9230,147
2020-10-14,Modoc,049,8938,30,27,0,27,0
2020-10-14,Mono,051,14174,174,155,5,160,1
2020-10-14,Monterey,053,433212,10939,10616,49,10665,78
2020-10-14,Napa,055,140530,1914,1837,8,1845,12
2020-10-14,Nevada,057,99092,601,573,18,591,7
2020-10-14,Orange,059,3164182,58615,55756,1645,57401,1348
2020-10-14,Placer,061,380077,4028,3829,15,3844,48
2020-10-14,Plumas,063,18699,54,52,0,52,0
2020-10-14,Riverside,065,2383286,64597,62607,248,62855,1261
2020-10-14,Sacramento,067,1510023,24496,24013,27,24040,472
2020-10-14,San Benito,069,59416,1397,1381,0,1381,14
2020-10-14,San Bernardino,071,2135413,60404,57774,373,58147,1063
2020-10-14,San Diego,073,3302833,53314,51329,1337,52666,844
2020-10-14,San Francisco,075,870044,11932,11783,40,11823,123
2020-10-14,San Joaquin,077,732212,21271,20845,124,20969,487
2020-10-14,San Luis Obispo,079,281455,4199,3901,22,3923,32
2020-10-14,San Mateo,081,765935,10963,10309,10,10319,132
2020-10-14,Santa Barbara,083,443738,9703,9509,85,9594,117
2020-10-14,Santa Clara,085,1922200,24198,22735,49,22784,343
2020-10-14,Santa Cruz,087,273765,2717,2618,33,2651,13
2020-10-14,Shasta,089,179085,1888,1553,18,1571,20
2020-10-14,Sierra,091,2930,6,6,0,6,0
2020-10-14,Siskiyou,093,43540,175,166,10,176,0
2020-10-14,Solano,095,438530,7020,6786,41,6827,55
2020-10-14,Sonoma,097,501317,8951,8514,22,8536,133
2020-10-14,Stanislaus,099,539301,17316,17105,660,17765,365
2020-10-14,Sutter,101,95872,1787,1747,1,1748,12
2020-10-14,Tehama,103,63373,784,721,2,723,3
2020-10-14,Trinity,105,12862,74,20,10,30,0
2020-10-14,Tulare,107,460477,17455,16863,257,17120,287
2020-10-14,Tuolumne,109,53932,259,236,4,240,4
2020-10-14,Ventura,111,848112,14425,13697,295,13992,152
2020-10-14,Yolo,113,214977,3084,3007,7,3014,55
2020-10-14,Yuba,115,75493,1190,1147,5,1152,10
2020-10-13,Alameda,001,1643700,22818,22185,210,22395,389
2020-10-13,Alpine,003,1148,3,3,0,3,0
2020-10-13,Amador,005,37829,310,306,0,306,16
2020-10-13,Butte,007,227075,3092,2992,27,3019,54
2020-10-13,Calaveras,009,45235,321,262,0,262,12
2020-10-13,Colusa,011,21464,542,541,1,542,6
2020-10-13,Contra Costa,013,1133247,18321,17783,90,17873,234
2020-10-13,Del Norte,015,27424,168,163,0,163,2
2020-10-13,El Dorado,017,186661,1316,1262,2,1264,4
2020-10-13,Fresno,019,978130,32515,29579,429,30008,424
2020-10-13,Glenn,021,27897,640,629,0,629,3
2020-10-13,Humboldt,023,135768,541,523,1,524,7
2020-10-13,Imperial,025,180216,12440,11727,39,11766,327
2020-10-13,Inyo,027,18085,220,207,4,211,14
2020-10-13,Kern,029,883053,33229,32497,370,32867,419
2020-10-13,Kings,031,150075,8323,8111,52,8163,80
2020-10-13,Lake,033,64148,686,639,0,639,12
2020-10-13,Lassen,035,31185,763,752,2,754,0
2020-10-13,Los Angeles,037,10098052,287708,281716,2457,284173,6767
2020-10-13,Madera,039,155013,4887,4700,34,4734,50
2020-10-13,Marin,041,260295,7013,6900,18,6918,97
2020-10-13,Mariposa,043,17540,77,76,0,76,2
2020-10-13,Mendocino,045,87422,1022,950,4,954,21
2020-10-13,Merced,047,269075,9303,9181,29,9210,146
2020-10-13,Modoc,049,8938,29,28,0,28,0
2020-10-13,Mono,051,14174,174,155,4,159,1
2020-10-13,Monterey,053,433212,10878,10574,48,10622,78
2020-10-13,Napa,055,140530,1905,1825,8,1833,12
2020-10-13,Nevada,057,99092,594,572,18,590,7
2020-10-13,Orange,059,3164182,58402,55515,1632,57147,1326
2020-10-13,Placer,061,380077,3990,3825,15,3840,48
2020-10-13,Plumas,063,18699,52,51,0,51,0
2020-10-13,Riverside,065,2383286,64277,62279,246,62525,1254
2020-10-13,Sacramento,067,1510023,24419,23930,27,23957,466
2020-10-13,San Benito,069,59416,1389,1380,0,1380,14
2020-10-13,San Bernardino,071,2135413,60064,57411,371,57782,1061
2020-10-13,San Diego,073,3302833,53021,51026,1320,52346,840
2020-10-13,San Francisco,075,870044,11897,11659,40,11699,122
2020-10-13,San Joaquin,077,732212,21210,20822,120,20942,481
2020-10-13,San Luis Obispo,079,281455,4183,3892,21,3913,32
2020-10-13,San Mateo,081,765935,10920,10286,10,10296,130
2020-10-13,Santa Barbara,083,443738,9672,9489,85,9574,117
2020-10-13,Santa Clara,085,1922200,24071,22678,49,22727,343
2020-10-13,Santa Cruz,087,273765,2699,2603,33,2636,13
2020-10-13,Shasta,089,179085,1864,1606,18,1624,20
2020-10-13,Sierra,091,2930,6,6,0,6,0
2020-10-13,Siskiyou,093,43540,174,163,10,173,0
2020-10-13,Solano,095,438530,6985,6761,41,6802,55
2020-10-13,Sonoma,097,501317,8868,8456,22,8478,133
2020-10-13,Stanislaus,099,539301,17271,17082,655,17737,362
2020-10-13,Sutter,101,95872,1778,1748,1,1749,12
2020-10-13,Tehama,103,63373,776,717,2,719,3
2020-10-13,Trinity,105,12862,70,19,9,28,0
2020-10-13,Tulare,107,460477,17396,16822,249,17071,286
2020-10-13,Tuolumne,109,53932,257,235,4,239,4
2020-10-13,Ventura,111,848112,14371,13645,291,13936,151
2020-10-13,Yolo,113,214977,3076,2983,6,2989,55
2020-10-13,Yuba,115,75493,1185,1143,5,1148,10
2020-10-12,Alameda,001,1643700,22738,22126,209,22335,389
2020-10-12,Alpine,003,1148,3,3,0,3,0
2020-10-12,Amador,005,37829,309,305,0,305,16
2020-10-12,Butte,007,227075,3086,2975,27,3002,54
2020-10-12,Calaveras,009,45235,321,262,0,262,12
2020-10-12,Colusa,011,21464,542,541,1,542,6
2020-10-12,Contra Costa,013,1133247,18246,17728,90,17818,233
2020-10-12,Del Norte,015,27424,168,161,0,161,2
2020-10-12,El Dorado,017,186661,1313,1254,2,1256,4
2020-10-12,Fresno,019,978130,32382,29523,425,29948,421
2020-10-12,Glenn,021,27897,639,626,0,626,3
2020-10-12,Humboldt,023,135768,538,522,1,523,7
2020-10-12,Imperial,025,180216,12401,11689,38,11727,328
2020-10-12,Inyo,027,18085,217,201,4,205,14
2020-10-12,Kern,029,883053,33136,32425,367,32792,419
2020-10-12,Kings,031,150075,8317,8106,51,8157,80
2020-10-12,Lake,033,64148,680,633,0,633,12
2020-10-12,Lassen,035,31185,763,752,2,754,0
2020-10-12,Los Angeles,037,10098052,286490,280961,2429,283390,6747
2020-10-12,Madera,039,155013,4868,4689,34,4723,50
2020-10-12,Marin,041,260295,6996,6886,18,6904,97
2020-10-12,Mariposa,043,17540,77,76,0,76,2
2020-10-12,Mendocino,045,87422,1016,947,4,951,21
2020-10-12,Merced,047,269075,9282,9141,29,9170,146
2020-10-12,Modoc,049,8938,29,27,0,27,0
2020-10-12,Mono,051,14174,174,154,4,158,1
2020-10-12,Monterey,053,433212,10812,10473,48,10521,77
2020-10-12,Napa,055,140530,1897,1819,8,1827,11
2020-10-12,Nevada,057,99092,590,570,18,588,7
2020-10-12,Orange,059,3164182,58172,55373,1622,56995,1326
2020-10-12,Placer,061,380077,3958,3808,14,3822,48
2020-10-12,Plumas,063,18699,52,51,0,51,0
2020-10-12,Riverside,065,2383286,63966,62279,242,62521,1254
2020-10-12,Sacramento,067,1510023,24313,23807,27,23834,466
2020-10-12,San Benito,069,59416,1386,1376,0,1376,13
2020-10-12,San Bernardino,071,2135413,59690,57235,370,57605,1061
2020-10-12,San Diego,073,3302833,52731,50748,1293,52041,826
2020-10-12,San Francisco,075,870044,11865,11659,40,11699,122
2020-10-12,San Joaquin,077,732212,21147,20701,114,20815,480
2020-10-12,San Luis Obispo,079,281455,4155,3874,21,3895,32
2020-10-12,San Mateo,081,765935,10872,10262,10,10272,130
2020-10-12,Santa Barbara,083,443738,9634,9462,85,9547,117
2020-10-12,Santa Clara,085,1922200,23956,22578,49,22627,343
2020-10-12,Santa Cruz,087,273765,2682,2590,33,2623,13
2020-10-12,Shasta,089,179085,1839,1515,18,1533,20
2020-10-12,Sierra,091,2930,6,6,0,6,0
2020-10-12,Siskiyou,093,43540,173,162,10,172,0
2020-10-12,Solano,095,438530,6946,6742,41,6783,55
2020-10-12,Sonoma,097,501317,8797,8377,22,8399,133
2020-10-12,Stanislaus,099,539301,17222,17051,646,17697,361
2020-10-12,Sutter,101,95872,1770,1741,1,1742,12
2020-10-12,Tehama,103,63373,760,708,2,710,3
2020-10-12,Trinity,105,12862,69,19,9,28,0
2020-10-12,Tulare,107,460477,17344,16742,242,16984,286
2020-10-12,Tuolumne,109,53932,252,234,4,238,4
2020-10-12,Ventura,111,848112,14309,13617,287,13904,151
2020-10-12,Yolo,113,214977,3061,2964,6,2970,55
2020-10-12,Yuba,115,75493,1174,1141,5,1146,10
2020-10-11,Alameda,001,1643700,22648,22057,205,22262,392
2020-10-11,Alpine,003,1148,3,3,0,3,0
2020-10-11,Amador,005,37829,307,305,0,305,16
2020-10-11,Butte,007,227075,3078,2967,26,2993,54
2020-10-11,Calaveras,009,45235,319,262,0,262,12
2020-10-11,Colusa,011,21464,540,541,1,542,6
2020-10-11,Contra Costa,013,1133247,18162,17678,90,17768,233
2020-10-11,Del Norte,015,27424,166,161,0,161,2
2020-10-11,El Dorado,017,186661,1304,1242,2,1244,4
2020-10-11,Fresno,019,978130,32244,29419,417,29836,421
2020-10-11,Glenn,021,27897,637,625,0,625,3
2020-10-11,Humboldt,023,135768,537,521,1,522,7
2020-10-11,Imperial,025,180216,12341,11614,36,11650,328
2020-10-11,Inyo,027,18085,213,201,4,205,14
2020-10-11,Kern,029,883053,33049,32399,360,32759,418
2020-10-11,Kings,031,150075,8300,8094,50,8144,80
2020-10-11,Lake,033,64148,667,631,0,631,12
2020-10-11,Lassen,035,31185,762,752,2,754,0
2020-10-11,Los Angeles,037,10098052,285051,280190,2387,282577,6745
2020-10-11,Madera,039,155013,4840,4680,33,4713,50
2020-10-11,Marin,041,260295,6987,6870,18,6888,97
2020-10-11,Mariposa,043,17540,77,76,0,76,2
2020-10-11,Mendocino,045,87422,1009,944,4,948,21
2020-10-11,Merced,047,269075,9264,9124,29,9153,146
2020-10-11,Modoc,049,8938,29,27,0,27,0
2020-10-11,Mono,051,14174,174,154,4,158,1
2020-10-11,Monterey,053,433212,10761,10445,46,10491,77
2020-10-11,Napa,055,140530,1881,1811,8,1819,11
2020-10-11,Nevada,057,99092,588,569,18,587,7
2020-10-11,Orange,059,3164182,57942,55202,1616,56818,1326
2020-10-11,Placer,061,380077,3937,3787,14,3801,48
2020-10-11,Plumas,063,18699,52,51,0,51,0
2020-10-11,Riverside,065,2383286,63677,62112,238,62350,1254
2020-10-11,Sacramento,067,1510023,24171,23778,27,23805,466
2020-10-11,San Benito,069,59416,1385,1374,0,1374,13
2020-10-11,San Bernardino,071,2135413,59235,56997,368,57365,1061
2020-10-11,San Diego,073,3302833,52381,50553,1271,51824,826
2020-10-11,San Francisco,075,870044,11822,11659,40,11699,122
2020-10-11,San Joaquin,077,732212,21072,20700,104,20804,480
2020-10-11,San Luis Obispo,079,281455,4138,3874,20,3894,32
2020-10-11,San Mateo,081,765935,10840,10240,10,10250,130
2020-10-11,Santa Barbara,083,443738,9603,9440,84,9524,117
2020-10-11,Santa Clara,085,1922200,23813,22487,48,22535,336
2020-10-11,Santa Cruz,087,273765,2668,2578,33,2611,13
2020-10-11,Shasta,089,179085,1809,1515,17,1532,20
2020-10-11,Sierra,091,2930,6,6,0,6,0
2020-10-11,Siskiyou,093,43540,172,162,10,172,0
2020-10-11,Solano,095,438530,6892,6685,41,6726,53
2020-10-11,Sonoma,097,501317,8740,8319,22,8341,133
2020-10-11,Stanislaus,099,539301,17158,17007,630,17637,360
2020-10-11,Sutter,101,95872,1767,1742,1,1743,12
2020-10-11,Tehama,103,63373,736,702,2,704,3
2020-10-11,Trinity,105,12862,69,19,9,28,0
2020-10-11,Tulare,107,460477,17280,16741,234,16975,286
2020-10-11,Tuolumne,109,53932,247,234,4,238,4
2020-10-11,Ventura,111,848112,14248,13604,282,13886,151
2020-10-11,Yolo,113,214977,3031,2952,6,2958,55
2020-10-11,Yuba,115,75493,1162,1137,5,1142,10
2020-10-10,Alameda,001,1643700,22598,21979,204,22183,398
2020-10-10,Alpine,003,1148,3,3,0,3,0
2020-10-10,Amador,005,37829,306,304,0,304,16
2020-10-10,Butte,007,227075,3073,2962,25,2987,54
2020-10-10,Calaveras,009,45235,318,262,0,262,12
2020-10-10,Colusa,011,21464,540,541,1,542,6
2020-10-10,Contra Costa,013,1133247,18126,17566,89,17655,233
2020-10-10,Del Norte,015,27424,166,161,0,161,2
2020-10-10,El Dorado,017,186661,1302,1240,2,1242,4
2020-10-10,Fresno,019,978130,32180,29286,415,29701,421
2020-10-10,Glenn,021,27897,637,623,0,623,3
2020-10-10,Humboldt,023,135768,534,518,1,519,7
2020-10-10,Imperial,025,180216,12326,11591,36,11627,327
2020-10-10,Inyo,027,18085,210,201,4,205,14
2020-10-10,Kern,029,883053,33012,32338,360,32698,418
2020-10-10,Kings,031,150075,8296,8078,50,8128,80
2020-10-10,Lake,033,64148,666,630,0,630,11
2020-10-10,Lassen,035,31185,762,752,2,754,0
2020-10-10,Los Angeles,037,10098052,284331,279213,2353,281566,6743
2020-10-10,Madera,039,155013,4827,4662,33,4695,50
2020-10-10,Marin,041,260295,6978,6852,18,6870,97
2020-10-10,Mariposa,043,17540,77,76,0,76,2
2020-10-10,Mendocino,045,87422,1002,935,4,939,21
2020-10-10,Merced,047,269075,9258,9105,28,9133,146
2020-10-10,Modoc,049,8938,29,27,0,27,0
2020-10-10,Mono,051,14174,174,154,4,158,1
2020-10-10,Monterey,053,433212,10728,10410,46,10456,75
2020-10-10,Napa,055,140530,1874,1804,8,1812,11
2020-10-10,Nevada,057,99092,585,564,18,582,6
2020-10-10,Orange,059,3164182,57821,54965,1611,56576,1324
2020-10-10,Placer,061,380077,3920,3757,14,3771,48
2020-10-10,Plumas,063,18699,52,51,0,51,0
2020-10-10,Riverside,065,2383286,63473,61845,236,62081,1254
2020-10-10,Sacramento,067,1510023,24104,23689,27,23716,466
2020-10-10,San Benito,069,59416,1383,1370,0,1370,13
2020-10-10,San Bernardino,071,2135413,59073,56683,366,57049,1061
2020-10-10,San Diego,073,3302833,52151,50145,1253,51398,825
2020-10-10,San Francisco,075,870044,11801,11663,40,11703,122
2020-10-10,San Joaquin,077,732212,21044,20700,100,20800,481
2020-10-10,San Luis Obispo,079,281455,4118,3832,20,3852,32
2020-10-10,San Mateo,081,765935,10803,10218,10,10228,130
2020-10-10,Santa Barbara,083,443738,9592,9417,84,9501,116
2020-10-10,Santa Clara,085,1922200,23721,22354,48,22402,330
2020-10-10,Santa Cruz,087,273765,2654,2572,33,2605,13
2020-10-10,Shasta,089,179085,1792,1473,17,1490,20
2020-10-10,Sierra,091,2930,6,6,0,6,0
2020-10-10,Siskiyou,093,43540,172,161,10,171,0
2020-10-10,Solano,095,438530,6866,6655,41,6696,53
2020-10-10,Sonoma,097,501317,8720,8235,22,8257,133
2020-10-10,Stanislaus,099,539301,17123,16960,622,17582,360
2020-10-10,Sutter,101,95872,1764,1735,1,1736,12
2020-10-10,Tehama,103,63373,729,693,2,695,3
2020-10-10,Trinity,105,12862,69,19,9,28,0
2020-10-10,Tulare,107,460477,17245,16709,229,16938,286
2020-10-10,Tuolumne,109,53932,247,233,4,237,4
2020-10-10,Ventura,111,848112,14223,13520,282,13802,151
2020-10-10,Yolo,113,214977,3022,2939,6,2945,55
2020-10-10,Yuba,115,75493,1160,1134,5,1139,10
2020-10-09,Alameda,001,1643700,22550,21924,204,22128,399
2020-10-09,Alpine,003,1148,3,3,0,3,0
2020-10-09,Amador,005,37829,306,303,0,303,16
2020-10-09,Butte,007,227075,3070,2956,25,2981,51
2020-10-09,Calaveras,009,45235,316,262,0,262,11
2020-10-09,Colusa,011,21464,540,541,1,542,6
2020-10-09,Contra Costa,013,1133247,18076,17487,89,17576,229
2020-10-09,Del Norte,015,27424,165,161,0,161,2
2020-10-09,El Dorado,017,186661,1298,1234,2,1236,4
2020-10-09,Fresno,019,978130,32107,29208,413,29621,417
2020-10-09,Glenn,021,27897,632,617,0,617,3
2020-10-09,Humboldt,023,135768,532,516,1,517,7
2020-10-09,Imperial,025,180216,12299,11516,36,11552,330
2020-10-09,Inyo,027,18085,207,200,4,204,14
2020-10-09,Kern,029,883053,32969,32237,358,32595,417
2020-10-09,Kings,031,150075,8289,7993,48,8041,80
2020-10-09,Lake,033,64148,656,610,0,610,11
2020-10-09,Lassen,035,31185,762,751,2,753,0
2020-10-09,Los Angeles,037,10098052,283197,278039,2328,280367,6715
2020-10-09,Madera,039,155013,4817,4646,33,4679,50
2020-10-09,Marin,041,260295,6964,6838,18,6856,96
2020-10-09,Mariposa,043,17540,77,76,0,76,2
2020-10-09,Mendocino,045,87422,992,933,4,937,20
2020-10-09,Merced,047,269075,9244,9095,28,9123,145
2020-10-09,Modoc,049,8938,29,27,0,27,0
2020-10-09,Mono,051,14174,174,154,4,158,1
2020-10-09,Monterey,053,433212,10694,10369,46,10415,75
2020-10-09,Napa,055,140530,1864,1795,8,1803,11
2020-10-09,Nevada,057,99092,580,561,18,579,6
2020-10-09,Orange,059,3164182,57649,54746,1606,56352,1305
2020-10-09,Placer,061,380077,3906,3737,14,3751,48
2020-10-09,Plumas,063,18699,52,50,0,50,0
2020-10-09,Riverside,065,2383286,63237,61529,235,61764,1252
2020-10-09,Sacramento,067,1510023,24034,23606,27,23633,457
2020-10-09,San Benito,069,59416,1378,1367,0,1367,13
2020-10-09,San Bernardino,071,2135413,58833,56434,364,56798,1057
2020-10-09,San Diego,073,3302833,51875,49825,1242,51067,821
2020-10-09,San Francisco,075,870044,11771,11620,40,11660,120
2020-10-09,San Joaquin,077,732212,21014,20648,91,20739,481
2020-10-09,San Luis Obispo,079,281455,4099,3810,20,3830,32
2020-10-09,San Mateo,081,765935,10775,10140,10,10150,130
2020-10-09,Santa Barbara,083,443738,9564,9396,84,9480,116
2020-10-09,Santa Clara,085,1922200,23619,22251,47,22298,328
2020-10-09,Santa Cruz,087,273765,2645,2555,33,2588,13
2020-10-09,Shasta,089,179085,1765,1353,16,1369,20
2020-10-09,Sierra,091,2930,6,6,0,6,0
2020-10-09,Siskiyou,093,43540,170,156,10,166,0
2020-10-09,Solano,095,438530,6827,6614,41,6655,53
2020-10-09,Sonoma,097,501317,8666,8133,22,8155,133
2020-10-09,Stanislaus,099,539301,17099,16904,613,17517,362
2020-10-09,Sutter,101,95872,1760,1732,1,1733,12
2020-10-09,Tehama,103,63373,723,682,2,684,3
2020-10-09,Trinity,105,12862,69,25,9,34,0
2020-10-09,Tulare,107,460477,17205,16644,220,16864,286
2020-10-09,Tuolumne,109,53932,244,230,4,234,4
2020-10-09,Ventura,111,848112,14187,13469,279,13748,151
2020-10-09,Yolo,113,214977,3015,2928,6,2934,55
2020-10-09,Yuba,115,75493,1159,1129,5,1134,10
2020-10-08,Alameda,001,1643700,22469,21826,203,22029,395
2020-10-08,Alpine,003,1148,3,3,0,3,0
2020-10-08,Amador,005,37829,305,302,0,302,16
2020-10-08,Butte,007,227075,3060,2935,25,2960,51
2020-10-08,Calaveras,009,45235,315,262,0,262,11
2020-10-08,Colusa,011,21464,540,539,1,540,6
2020-10-08,Contra Costa,013,1133247,18016,17418,88,17506,228
2020-10-08,Del Norte,015,27424,165,151,0,151,2
2020-10-08,El Dorado,017,186661,1297,1230,2,1232,4
2020-10-08,Fresno,019,978130,32002,29111,413,29524,416
2020-10-08,Glenn,021,27897,629,616,0,616,3
2020-10-08,Humboldt,023,135768,528,515,1,516,7
2020-10-08,Imperial,025,180216,12260,11405,35,11440,330
2020-10-08,Inyo,027,18085,204,199,4,203,14
2020-10-08,Kern,029,883053,32911,32169,353,32522,411
2020-10-08,Kings,031,150075,8283,7968,48,8016,80
2020-10-08,Lake,033,64148,651,604,0,604,11
2020-10-08,Lassen,035,31185,757,751,2,753,0
2020-10-08,Los Angeles,037,10098052,281997,276763,2288,279051,6699
2020-10-08,Madera,039,155013,4798,4637,33,4670,50
2020-10-08,Marin,041,260295,6950,6810,18,6828,96
2020-10-08,Mariposa,043,17540,77,76,0,76,2
2020-10-08,Mendocino,045,87422,987,930,4,934,20
2020-10-08,Merced,047,269075,9224,9069,28,9097,144
2020-10-08,Modoc,049,8938,29,27,0,27,0
2020-10-08,Mono,051,14174,174,153,4,157,1
2020-10-08,Monterey,053,433212,10627,10343,46,10389,75
2020-10-08,Napa,055,140530,1849,1779,8,1787,11
2020-10-08,Nevada,057,99092,577,556,18,574,6
2020-10-08,Orange,059,3164182,57456,54523,1595,56118,1293
2020-10-08,Placer,061,380077,3888,3715,14,3729,48
2020-10-08,Plumas,063,18699,52,50,0,50,0
2020-10-08,Riverside,065,2383286,62968,61105,233,61338,1244
2020-10-08,Sacramento,067,1510023,23926,23482,27,23509,454
2020-10-08,San Benito,069,59416,1373,1367,0,1367,13
2020-10-08,San Bernardino,071,2135413,58468,56152,363,56515,1048
2020-10-08,San Diego,073,3302833,51595,49468,1210,50678,819
2020-10-08,San Francisco,075,870044,11733,11608,40,11648,115
2020-10-08,San Joaquin,077,732212,20962,20576,86,20662,478
2020-10-08,San Luis Obispo,079,281455,4083,3785,20,3805,32
2020-10-08,San Mateo,081,765935,10743,10044,10,10054,130
2020-10-08,Santa Barbara,083,443738,9535,9374,84,9458,116
2020-10-08,Santa Clara,085,1922200,23517,22095,47,22142,323
2020-10-08,Santa Cruz,087,273765,2633,2535,33,2568,13
2020-10-08,Shasta,089,179085,1731,1305,16,1321,20
2020-10-08,Sierra,091,2930,6,6,0,6,0
2020-10-08,Siskiyou,093,43540,170,156,10,166,0
2020-10-08,Solano,095,438530,6803,6556,41,6597,53
2020-10-08,Sonoma,097,501317,8600,8063,22,8085,132
2020-10-08,Stanislaus,099,539301,17053,16821,605,17426,360
2020-10-08,Sutter,101,95872,1760,1725,1,1726,12
2020-10-08,Tehama,103,63373,714,676,2,678,3
2020-10-08,Trinity,105,12862,68,25,9,34,0
2020-10-08,Tulare,107,460477,17144,16573,211,16784,283
2020-10-08,Tuolumne,109,53932,243,230,4,234,4
2020-10-08,Ventura,111,848112,14139,13399,277,13676,151
2020-10-08,Yolo,113,214977,2998,2914,6,2920,55
2020-10-08,Yuba,115,75493,1154,1126,5,1131,10
2020-10-07,Alameda,001,1643700,22392,21736,203,21939,395
2020-10-07,Alpine,003,1148,3,3,0,3,0
2020-10-07,Amador,005,37829,305,302,0,302,16
2020-10-07,Butte,007,227075,3048,2927,25,2952,47
2020-10-07,Calaveras,009,45235,313,262,0,262,11
2020-10-07,Colusa,011,21464,539,539,0,539,6
2020-10-07,Contra Costa,013,1133247,17946,17346,87,17433,225
2020-10-07,Del Norte,015,27424,164,149,0,149,2
2020-10-07,El Dorado,017,186661,1289,1219,2,1221,4
2020-10-07,Fresno,019,978130,31881,29069,408,29477,413
2020-10-07,Glenn,021,27897,629,615,0,615,3
2020-10-07,Humboldt,023,135768,525,512,1,513,7
2020-10-07,Imperial,025,180216,12223,11289,33,11322,330
2020-10-07,Inyo,027,18085,204,199,4,203,14
2020-10-07,Kern,029,883053,32838,32068,352,32420,410
2020-10-07,Kings,031,150075,8268,7948,48,7996,80
2020-10-07,Lake,033,64148,650,599,0,599,11
2020-10-07,Lassen,035,31185,757,751,2,753,0
2020-10-07,Los Angeles,037,10098052,280817,275559,2254,277813,6681
2020-10-07,Madera,039,155013,4778,4618,33,4651,50
2020-10-07,Marin,041,260295,6923,6790,18,6808,95
2020-10-07,Mariposa,043,17540,77,75,0,75,2
2020-10-07,Mendocino,045,87422,981,927,4,931,19
2020-10-07,Merced,047,269075,9187,9045,27,9072,144
2020-10-07,Modoc,049,8938,29,27,0,27,0
2020-10-07,Mono,051,14174,173,153,3,156,1
2020-10-07,Monterey,053,433212,10568,10272,46,10318,75
2020-10-07,Napa,055,140530,1836,1774,8,1782,11
2020-10-07,Nevada,057,99092,573,552,18,570,6
2020-10-07,Orange,059,3164182,57238,54332,1585,55917,1277
2020-10-07,Placer,061,380077,3872,3693,14,3707,48
2020-10-07,Plumas,063,18699,52,50,0,50,0
2020-10-07,Riverside,065,2383286,62621,60857,229,61086,1241
2020-10-07,Sacramento,067,1510023,23829,23380,27,23407,452
2020-10-07,San Benito,069,59416,1370,1363,0,1363,13
2020-10-07,San Bernardino,071,2135413,58120,55738,362,56100,1043
2020-10-07,San Diego,073,3302833,51279,49177,1186,50363,813
2020-10-07,San Francisco,075,870044,11698,11551,40,11591,115
2020-10-07,San Joaquin,077,732212,20910,20527,79,20606,478
2020-10-07,San Luis Obispo,079,281455,4053,3749,20,3769,32
2020-10-07,San Mateo,081,765935,10700,9980,10,9990,130
2020-10-07,Santa Barbara,083,443738,9509,9350,83,9433,116
2020-10-07,Santa Clara,085,1922200,23389,21993,47,22040,320
2020-10-07,Santa Cruz,087,273765,2621,2518,33,2551,14
2020-10-07,Shasta,089,179085,1688,1268,16,1284,20
2020-10-07,Sierra,091,2930,6,6,0,6,0
2020-10-07,Siskiyou,093,43540,168,154,10,164,0
2020-10-07,Solano,095,438530,6768,6526,41,6567,53
2020-10-07,Sonoma,097,501317,8525,7993,21,8014,130
2020-10-07,Stanislaus,099,539301,17018,16786,599,17385,357
2020-10-07,Sutter,101,95872,1756,1723,1,1724,12
2020-10-07,Tehama,103,63373,705,666,2,668,3
2020-10-07,Trinity,105,12862,64,25,8,33,0
2020-10-07,Tulare,107,460477,17101,16483,202,16685,282
2020-10-07,Tuolumne,109,53932,243,227,4,231,3
2020-10-07,Ventura,111,848112,14089,13333,271,13604,150
2020-10-07,Yolo,113,214977,2972,2904,6,2910,55
2020-10-07,Yuba,115,75493,1148,1120,5,1125,10
2020-10-06,Alameda,001,1643700,22301,21698,201,21899,385
2020-10-06,Alpine,003,1148,3,3,0,3,0
2020-10-06,Amador,005,37829,303,301,0,301,16
2020-10-06,Butte,007,227075,3041,2925,25,2950,47
2020-10-06,Calaveras,009,45235,313,261,0,261,11
2020-10-06,Colusa,011,21464,538,538,0,538,6
2020-10-06,Contra Costa,013,1133247,17867,17295,87,17382,219
2020-10-06,Del Norte,015,27424,164,144,0,144,2
2020-10-06,El Dorado,017,186661,1285,1211,2,1213,4
2020-10-06,Fresno,019,978130,31737,29022,405,29427,412
2020-10-06,Glenn,021,27897,626,604,0,604,3
2020-10-06,Humboldt,023,135768,522,508,1,509,7
2020-10-06,Imperial,025,180216,12185,11196,32,11228,327
2020-10-06,Inyo,027,18085,202,198,4,202,14
2020-10-06,Kern,029,883053,32761,32006,350,32356,407
2020-10-06,Kings,031,150075,8252,7943,48,7991,81
2020-10-06,Lake,033,64148,644,596,0,596,11
2020-10-06,Lassen,035,31185,757,743,2,745,0
2020-10-06,Los Angeles,037,10098052,279581,274115,2204,276319,6657
2020-10-06,Madera,039,155013,4766,4608,33,4641,50
2020-10-06,Marin,041,260295,6908,6766,18,6784,91
2020-10-06,Mariposa,043,17540,77,75,0,75,2
2020-10-06,Mendocino,045,87422,974,920,4,924,19
2020-10-06,Merced,047,269075,9151,9034,26,9060,143
2020-10-06,Modoc,049,8938,29,26,0,26,0
2020-10-06,Mono,051,14174,173,153,3,156,1
2020-10-06,Monterey,053,433212,10512,10235,44,10279,72
2020-10-06,Napa,055,140530,1830,1770,8,1778,11
2020-10-06,Nevada,057,99092,571,551,18,569,6
2020-10-06,Orange,059,3164182,57023,54203,1576,55779,1273
2020-10-06,Placer,061,380077,3850,3680,14,3694,48
2020-10-06,Plumas,063,18699,52,49,0,49,0
2020-10-06,Riverside,065,2383286,62356,60593,226,60819,1238
2020-10-06,Sacramento,067,1510023,23742,23322,27,23349,442
2020-10-06,San Benito,069,59416,1369,1358,0,1358,12
2020-10-06,San Bernardino,071,2135413,57804,55416,358,55774,1040
2020-10-06,San Diego,073,3302833,50942,48823,1169,49992,806
2020-10-06,San Francisco,075,870044,11672,11513,39,11552,115
2020-10-06,San Joaquin,077,732212,20870,20481,76,20557,477
2020-10-06,San Luis Obispo,079,281455,4018,3723,20,3743,32
2020-10-06,San Mateo,081,765935,10667,9934,10,9944,129
2020-10-06,Santa Barbara,083,443738,9480,9331,82,9413,116
2020-10-06,Santa Clara,085,1922200,23294,21914,47,21961,320
2020-10-06,Santa Cruz,087,273765,2599,2510,33,2543,12
2020-10-06,Shasta,089,179085,1648,1242,16,1258,18
2020-10-06,Sierra,091,2930,6,6,0,6,0
2020-10-06,Siskiyou,093,43540,168,154,10,164,0
2020-10-06,Solano,095,438530,6722,6506,41,6547,52
2020-10-06,Sonoma,097,501317,8432,7895,21,7916,130
2020-10-06,Stanislaus,099,539301,16973,16759,593,17352,354
2020-10-06,Sutter,101,95872,1754,1722,1,1723,12
2020-10-06,Tehama,103,63373,696,660,2,662,3
2020-10-06,Trinity,105,12862,64,25,8,33,0
2020-10-06,Tulare,107,460477,17059,16456,194,16650,280
2020-10-06,Tuolumne,109,53932,242,227,4,231,2
2020-10-06,Ventura,111,848112,14022,13242,266,13508,150
2020-10-06,Yolo,113,214977,2958,2899,6,2905,56
2020-10-06,Yuba,115,75493,1147,1114,5,1119,10
2020-10-05,Alameda,001,1643700,22213,21637,198,21835,383
2020-10-05,Alpine,003,1148,3,2,0,2,0
2020-10-05,Amador,005,37829,303,299,0,299,16
2020-10-05,Butte,007,227075,3031,2910,25,2935,46
2020-10-05,Calaveras,009,45235,313,259,0,259,11
2020-10-05,Colusa,011,21464,538,537,0,537,6
2020-10-05,Contra Costa,013,1133247,17790,17250,87,17337,216
2020-10-05,Del Norte,015,27424,161,142,0,142,2
2020-10-05,El Dorado,017,186661,1281,1202,2,1204,4
2020-10-05,Fresno,019,978130,31620,29136,405,29541,408
2020-10-05,Glenn,021,27897,624,603,0,603,3
2020-10-05,Humboldt,023,135768,521,506,1,507,6
2020-10-05,Imperial,025,180216,12145,11169,30,11199,327
2020-10-05,Inyo,027,18085,202,197,4,201,14
2020-10-05,Kern,029,883053,32682,31933,346,32279,404
2020-10-05,Kings,031,150075,8155,7932,48,7980,80
2020-10-05,Lake,033,64148,640,592,0,592,10
2020-10-05,Lassen,035,31185,756,743,2,745,0
2020-10-05,Los Angeles,037,10098052,278495,273200,2162,275362,6632
2020-10-05,Madera,039,155013,4758,4598,31,4629,50
2020-10-05,Marin,041,260295,6891,6751,18,6769,91
2020-10-05,Mariposa,043,17540,77,75,0,75,2
2020-10-05,Mendocino,045,87422,966,913,4,917,19
2020-10-05,Merced,047,269075,9132,9021,25,9046,143
2020-10-05,Modoc,049,8938,29,26,0,26,0
2020-10-05,Mono,051,14174,173,152,3,155,1
2020-10-05,Monterey,053,433212,10465,10187,44,10231,72
2020-10-05,Napa,055,140530,1819,1760,8,1768,11
2020-10-05,Nevada,057,99092,568,550,17,567,6
2020-10-05,Orange,059,3164182,56807,54103,1563,55666,1271
2020-10-05,Placer,061,380077,3824,3670,14,3684,46
2020-10-05,Plumas,063,18699,51,49,0,49,0
2020-10-05,Riverside,065,2383286,62036,60454,222,60676,1232
2020-10-05,Sacramento,067,1510023,23638,23207,27,23234,438
2020-10-05,San Benito,069,59416,1366,1356,0,1356,12
2020-10-05,San Bernardino,071,2135413,57496,55100,357,55457,1031
2020-10-05,San Diego,073,3302833,50606,48662,1145,49807,803
2020-10-05,San Francisco,075,870044,11633,11476,36,11512,110
2020-10-05,San Joaquin,077,732212,20799,20319,73,20392,476
2020-10-05,San Luis Obispo,079,281455,3991,3710,20,3730,32
2020-10-05,San Mateo,081,765935,10640,9896,10,9906,128
2020-10-05,Santa Barbara,083,443738,9458,9309,82,9391,116
2020-10-05,Santa Clara,085,1922200,23177,21861,47,21908,319
2020-10-05,Santa Cruz,087,273765,2587,2492,33,2525,9
2020-10-05,Shasta,089,179085,1615,1158,16,1174,18
2020-10-05,Sierra,091,2930,6,6,0,6,0
2020-10-05,Siskiyou,093,43540,168,153,10,163,0
2020-10-05,Solano,095,438530,6683,6475,41,6516,52
2020-10-05,Sonoma,097,501317,8340,7817,21,7838,130
2020-10-05,Stanislaus,099,539301,16938,16730,586,17316,351
2020-10-05,Sutter,101,95872,1746,1719,1,1720,12
2020-10-05,Tehama,103,63373,688,642,2,644,3
2020-10-05,Trinity,105,12862,62,22,8,30,0
2020-10-05,Tulare,107,460477,17000,16343,190,16533,278
2020-10-05,Tuolumne,109,53932,239,226,4,230,2
2020-10-05,Ventura,111,848112,13953,13224,246,13470,149
2020-10-05,Yolo,113,214977,2939,2889,6,2895,56
2020-10-05,Yuba,115,75493,1134,1108,5,1113,9
2020-10-04,Alameda,001,1643700,22117,21597,198,21795,383
2020-10-04,Alpine,003,1148,3,2,0,2,0
2020-10-04,Amador,005,37829,301,297,0,297,16
2020-10-04,Butte,007,227075,3017,2903,25,2928,46
2020-10-04,Calaveras,009,45235,313,259,0,259,11
2020-10-04,Colusa,011,21464,537,537,0,537,6
2020-10-04,Contra Costa,013,1133247,17725,17192,87,17279,214
2020-10-04,Del Norte,015,27424,157,142,0,142,2
2020-10-04,El Dorado,017,186661,1277,1196,2,1198,4
2020-10-04,Fresno,019,978130,31497,29065,405,29470,408
2020-10-04,Glenn,021,27897,622,601,0,601,3
2020-10-04,Humboldt,023,135768,520,506,1,507,6
2020-10-04,Imperial,025,180216,12106,11127,30,11157,327
2020-10-04,Inyo,027,18085,199,195,4,199,14
2020-10-04,Kern,029,883053,32608,31906,343,32249,404
2020-10-04,Kings,031,150075,8140,7919,48,7967,80
2020-10-04,Lake,033,64148,626,589,0,589,10
2020-10-04,Lassen,035,31185,756,743,2,745,0
2020-10-04,Los Angeles,037,10098052,277106,272822,2116,274938,6625
2020-10-04,Madera,039,155013,4742,4587,31,4618,50
2020-10-04,Marin,041,260295,6871,6741,18,6759,91
2020-10-04,Mariposa,043,17540,77,75,0,75,2
2020-10-04,Mendocino,045,87422,953,905,4,909,18
2020-10-04,Merced,047,269075,9107,9006,25,9031,140
2020-10-04,Modoc,049,8938,29,26,0,26,0
2020-10-04,Mono,051,14174,172,152,2,154,1
2020-10-04,Monterey,053,433212,10424,10141,43,10184,72
2020-10-04,Napa,055,140530,1807,1759,8,1767,11
2020-10-04,Nevada,057,99092,564,547,16,563,6
2020-10-04,Orange,059,3164182,56571,53966,1554,55520,1270
2020-10-04,Placer,061,380077,3803,3664,14,3678,46
2020-10-04,Plumas,063,18699,51,49,0,49,0
2020-10-04,Riverside,065,2383286,61750,60251,218,60469,1226
2020-10-04,Sacramento,067,1510023,23525,23162,27,23189,438
2020-10-04,San Benito,069,59416,1366,1355,0,1355,12
2020-10-04,San Bernardino,071,2135413,57049,55100,355,55455,1031
2020-10-04,San Diego,073,3302833,50239,48438,1120,49558,803
2020-10-04,San Francisco,075,870044,11601,11474,34,11508,110
2020-10-04,San Joaquin,077,732212,20722,20320,67,20387,476
2020-10-04,San Luis Obispo,079,281455,3966,3688,20,3708,31
2020-10-04,San Mateo,081,765935,10579,9858,10,9868,128
2020-10-04,Santa Barbara,083,443738,9432,9276,80,9356,116
2020-10-04,Santa Clara,085,1922200,23040,21780,47,21827,316
2020-10-04,Santa Cruz,087,273765,2571,2483,33,2516,9
2020-10-04,Shasta,089,179085,1517,1158,15,1173,18
2020-10-04,Sierra,091,2930,6,6,0,6,0
2020-10-04,Siskiyou,093,43540,168,153,10,163,0
2020-10-04,Solano,095,438530,6632,6445,41,6486,52
2020-10-04,Sonoma,097,501317,8252,7794,21,7815,129
2020-10-04,Stanislaus,099,539301,16888,16711,577,17288,351
2020-10-04,Sutter,101,95872,1742,1711,1,1712,11
2020-10-04,Tehama,103,63373,673,637,2,639,3
2020-10-04,Trinity,105,12862,61,21,8,29,0
2020-10-04,Tulare,107,460477,16923,16343,178,16521,278
2020-10-04,Tuolumne,109,53932,237,226,4,230,2
2020-10-04,Ventura,111,848112,13871,13197,229,13426,149
2020-10-04,Yolo,113,214977,2928,2875,6,2881,56
2020-10-04,Yuba,115,75493,1130,1103,5,1108,9
2020-10-03,Alameda,001,1643700,22071,21510,197,21707,386
2020-10-03,Alpine,003,1148,3,2,0,2,0
2020-10-03,Amador,005,37829,300,296,0,296,16
2020-10-03,Butte,007,227075,3011,2894,25,2919,46
2020-10-03,Calaveras,009,45235,313,259,0,259,11
2020-10-03,Colusa,011,21464,536,537,0,537,6
2020-10-03,Contra Costa,013,1133247,17675,17087,85,17172,213
2020-10-03,Del Norte,015,27424,153,142,0,142,2
2020-10-03,El Dorado,017,186661,1270,1188,2,1190,4
2020-10-03,Fresno,019,978130,31437,28975,404,29379,408
2020-10-03,Glenn,021,27897,620,601,0,601,3
2020-10-03,Humboldt,023,135768,519,504,1,505,6
2020-10-03,Imperial,025,180216,12083,11090,30,11120,327
2020-10-03,Inyo,027,18085,199,194,4,198,14
2020-10-03,Kern,029,883053,32558,31864,340,32204,403
2020-10-03,Kings,031,150075,8136,7887,48,7935,80
2020-10-03,Lake,033,64148,616,588,0,588,10
2020-10-03,Lassen,035,31185,756,743,2,745,0
2020-10-03,Los Angeles,037,10098052,276401,271869,2087,273956,6620
2020-10-03,Madera,039,155013,4725,4565,31,4596,50
2020-10-03,Marin,041,260295,6865,6728,18,6746,91
2020-10-03,Mariposa,043,17540,77,75,0,75,2
2020-10-03,Mendocino,045,87422,951,898,4,902,18
2020-10-03,Merced,047,269075,9094,8986,25,9011,139
2020-10-03,Modoc,049,8938,29,26,0,26,0
2020-10-03,Mono,051,14174,171,152,2,154,1
2020-10-03,Monterey,053,433212,10390,10092,40,10132,72
2020-10-03,Napa,055,140530,1803,1752,8,1760,11
2020-10-03,Nevada,057,99092,563,544,16,560,6
2020-10-03,Orange,059,3164182,56454,53573,1549,55122,1268
2020-10-03,Placer,061,380077,3792,3648,14,3662,47
2020-10-03,Plumas,063,18699,51,48,0,48,0
2020-10-03,Riverside,065,2383286,61598,59991,216,60207,1226
2020-10-03,Sacramento,067,1510023,23474,23076,27,23103,437
2020-10-03,San Benito,069,59416,1366,1351,0,1351,12
2020-10-03,San Bernardino,071,2135413,56876,55004,352,55356,1031
2020-10-03,San Diego,073,3302833,50008,48202,1103,49305,798
2020-10-03,San Francisco,075,870044,11576,11475,32,11507,110
2020-10-03,San Joaquin,077,732212,20696,20322,67,20389,476
2020-10-03,San Luis Obispo,079,281455,3942,3670,20,3690,31
2020-10-03,San Mateo,081,765935,10553,9822,9,9831,128
2020-10-03,Santa Barbara,083,443738,9419,9256,80,9336,116
2020-10-03,Santa Clara,085,1922200,22960,21672,47,21719,309
2020-10-03,Santa Cruz,087,273765,2563,2476,33,2509,9
2020-10-03,Shasta,089,179085,1489,1117,14,1131,18
2020-10-03,Sierra,091,2930,6,6,0,6,0
2020-10-03,Siskiyou,093,43540,168,152,10,162,0
2020-10-03,Solano,095,438530,6606,6419,41,6460,52
2020-10-03,Sonoma,097,501317,8209,7747,21,7768,129
2020-10-03,Stanislaus,099,539301,16855,16645,573,17218,351
2020-10-03,Sutter,101,95872,1738,1705,1,1706,11
2020-10-03,Tehama,103,63373,667,630,2,632,3
2020-10-03,Trinity,105,12862,61,15,8,23,0
2020-10-03,Tulare,107,460477,16879,16322,174,16496,278
2020-10-03,Tuolumne,109,53932,236,224,4,228,2
2020-10-03,Ventura,111,848112,13832,13150,225,13375,148
2020-10-03,Yolo,113,214977,2921,2863,6,2869,56
2020-10-03,Yuba,115,75493,1122,1097,5,1102,8
2020-10-02,Alameda,001,1643700,22016,21404,196,21600,382
2020-10-02,Alpine,003,1148,3,2,0,2,0
2020-10-02,Amador,005,37829,299,296,0,296,16
2020-10-02,Butte,007,227075,3001,2879,25,2904,46
2020-10-02,Calaveras,009,45235,312,259,0,259,11
2020-10-02,Colusa,011,21464,535,537,0,537,6
2020-10-02,Contra Costa,013,1133247,17632,17002,84,17086,213
2020-10-02,Del Norte,015,27424,152,141,0,141,2
2020-10-02,El Dorado,017,186661,1263,1168,2,1170,4
2020-10-02,Fresno,019,978130,31354,28855,404,29259,403
2020-10-02,Glenn,021,27897,615,594,0,594,3
2020-10-02,Humboldt,023,135768,518,503,1,504,6
2020-10-02,Imperial,025,180216,12061,11024,30,11054,327
2020-10-02,Inyo,027,18085,197,191,4,195,14
2020-10-02,Kern,029,883053,32506,31790,338,32128,399
2020-10-02,Kings,031,150075,8127,7716,48,7764,79
2020-10-02,Lake,033,64148,610,579,0,579,10
2020-10-02,Lassen,035,31185,756,742,2,744,0
2020-10-02,Los Angeles,037,10098052,275500,270935,2059,272994,6602
2020-10-02,Madera,039,155013,4716,4537,31,4568,49
2020-10-02,Marin,041,260295,6848,6717,18,6735,91
2020-10-02,Mariposa,043,17540,77,75,0,75,2
2020-10-02,Mendocino,045,87422,946,883,4,887,18
2020-10-02,Merced,047,269075,9084,8961,25,8986,139
2020-10-02,Modoc,049,8938,29,26,0,26,0
2020-10-02,Mono,051,14174,171,150,2,152,1
2020-10-02,Monterey,053,433212,10356,9997,40,10037,71
2020-10-02,Napa,055,140530,1797,1737,8,1745,11
2020-10-02,Nevada,057,99092,560,543,16,559,6
2020-10-02,Orange,059,3164182,56323,53299,1542,54841,1262
2020-10-02,Placer,061,380077,3772,3612,14,3626,46
2020-10-02,Plumas,063,18699,51,48,0,48,0
2020-10-02,Riverside,065,2383286,61377,59673,213,59886,1223
2020-10-02,Sacramento,067,1510023,23409,22818,27,22845,436
2020-10-02,San Benito,069,59416,1362,1347,0,1347,12
2020-10-02,San Bernardino,071,2135413,56688,54613,352,54965,1028
2020-10-02,San Diego,073,3302833,49755,47793,1088,48881,794
2020-10-02,San Francisco,075,870044,11553,11398,32,11430,110
2020-10-02,San Joaquin,077,732212,20662,20235,66,20301,474
2020-10-02,San Luis Obispo,079,281455,3919,3654,20,3674,31
2020-10-02,San Mateo,081,765935,10512,9745,9,9754,128
2020-10-02,Santa Barbara,083,443738,9396,9234,80,9314,116
2020-10-02,Santa Clara,085,1922200,22874,21545,46,21591,305
2020-10-02,Santa Cruz,087,273765,2546,2463,33,2496,9
2020-10-02,Shasta,089,179085,1454,1046,14,1060,18
2020-10-02,Sierra,091,2930,6,6,0,6,0
2020-10-02,Siskiyou,093,43540,168,151,10,161,0
2020-10-02,Solano,095,438530,6576,6385,41,6426,52
2020-10-02,Sonoma,097,501317,8152,7662,21,7683,125
2020-10-02,Stanislaus,099,539301,16814,16609,564,17173,349
2020-10-02,Sutter,101,95872,1737,1693,1,1694,11
2020-10-02,Tehama,103,63373,662,619,2,621,3
2020-10-02,Trinity,105,12862,61,15,8,23,0
2020-10-02,Tulare,107,460477,16838,16245,167,16412,278
2020-10-02,Tuolumne,109,53932,234,225,4,229,2
2020-10-02,Ventura,111,848112,13793,13120,221,13341,146
2020-10-02,Yolo,113,214977,2916,2845,6,2851,55
2020-10-02,Yuba,115,75493,1120,1090,5,1095,8
2020-10-01,Alameda,001,1643700,21955,21349,192,21541,383
2020-10-01,Alpine,003,1148,3,2,0,2,0
2020-10-01,Amador,005,37829,299,294,0,294,16
2020-10-01,Butte,007,227075,2993,2865,25,2890,45
2020-10-01,Calaveras,009,45235,312,257,0,257,11
2020-10-01,Colusa,011,21464,535,536,0,536,6
2020-10-01,Contra Costa,013,1133247,17570,16898,84,16982,211
2020-10-01,Del Norte,015,27424,147,140,0,140,2
2020-10-01,El Dorado,017,186661,1259,1162,1,1163,4
2020-10-01,Fresno,019,978130,31273,28796,402,29198,397
2020-10-01,Glenn,021,27897,611,593,0,593,3
2020-10-01,Humboldt,023,135768,518,499,1,500,6
2020-10-01,Imperial,025,180216,12018,10928,28,10956,325
2020-10-01,Inyo,027,18085,197,191,4,195,14
2020-10-01,Kern,029,883053,32443,31678,333,32011,399
2020-10-01,Kings,031,150075,8116,7688,45,7733,79
2020-10-01,Lake,033,64148,604,572,0,572,11
2020-10-01,Lassen,035,31185,753,742,2,744,0
2020-10-01,Los Angeles,037,10098052,274458,271513,2025,273538,6621
2020-10-01,Madera,039,155013,4693,4508,31,4539,48
2020-10-01,Marin,041,260295,6834,6710,18,6728,92
2020-10-01,Mariposa,043,17540,77,76,0,76,2
2020-10-01,Mendocino,045,87422,941,874,4,878,19
2020-10-01,Merced,047,269075,9056,8942,25,8967,138
2020-10-01,Modoc,049,8938,29,26,0,26,0
2020-10-01,Mono,051,14174,169,150,2,152,1
2020-10-01,Monterey,053,433212,10280,9958,40,9998,71
2020-10-01,Napa,055,140530,1789,1729,8,1737,11
2020-10-01,Nevada,057,99092,559,543,16,559,6
2020-10-01,Orange,059,3164182,56158,53088,1529,54617,1257
2020-10-01,Placer,061,380077,3745,3599,14,3613,45
2020-10-01,Plumas,063,18699,51,48,0,48,0
2020-10-01,Riverside,065,2383286,61125,59293,207,59500,1223
2020-10-01,Sacramento,067,1510023,23297,22714,26,22740,433
2020-10-01,San Benito,069,59416,1360,1346,0,1346,12
2020-10-01,San Bernardino,071,2135413,56394,54350,349,54699,1021
2020-10-01,San Diego,073,3302833,49473,47487,1068,48555,792
2020-10-01,San Francisco,075,870044,11522,11284,30,11314,110
2020-10-01,San Joaquin,077,732212,20615,20204,63,20267,471
2020-10-01,San Luis Obispo,079,281455,3892,3625,20,3645,31
2020-10-01,San Mateo,081,765935,10467,9681,9,9690,128
2020-10-01,Santa Barbara,083,443738,9355,9215,80,9295,118
2020-10-01,Santa Clara,085,1922200,22773,21398,46,21444,305
2020-10-01,Santa Cruz,087,273765,2531,2418,33,2451,10
2020-10-01,Shasta,089,179085,1403,991,14,1005,18
2020-10-01,Sierra,091,2930,6,6,0,6,0
2020-10-01,Siskiyou,093,43540,165,150,10,160,0
2020-10-01,Solano,095,438530,6538,6352,41,6393,52
2020-10-01,Sonoma,097,501317,8085,7569,21,7590,125
2020-10-01,Stanislaus,099,539301,16781,16555,558,17113,346
2020-10-01,Sutter,101,95872,1732,1684,1,1685,11
2020-10-01,Tehama,103,63373,652,606,2,608,3
2020-10-01,Trinity,105,12862,61,15,8,23,0
2020-10-01,Tulare,107,460477,16763,16182,164,16346,275
2020-10-01,Tuolumne,109,53932,234,223,4,227,2
2020-10-01,Ventura,111,848112,13741,13057,207,13264,146
2020-10-01,Yolo,113,214977,2898,2833,6,2839,55
2020-10-01,Yuba,115,75493,1116,1082,5,1087,8
2020-09-30,Alameda,001,1643700,21876,21271,189,21460,380
2020-09-30,Alpine,003,1148,3,2,0,2,0
2020-09-30,Amador,005,37829,299,294,0,294,16
2020-09-30,Butte,007,227075,2985,2858,25,2883,44
2020-09-30,Calaveras,009,45235,311,258,0,258,11
2020-09-30,Colusa,011,21464,534,534,0,534,6
2020-09-30,Contra Costa,013,1133247,17501,16819,84,16903,211
2020-09-30,Del Norte,015,27424,146,140,0,140,2
2020-09-30,El Dorado,017,186661,1247,1157,1,1158,4
2020-09-30,Fresno,019,978130,31182,28706,399,29105,395
2020-09-30,Glenn,021,27897,606,592,0,592,3
2020-09-30,Humboldt,023,135768,516,497,1,498,6
2020-09-30,Imperial,025,180216,11993,10868,27,10895,287
2020-09-30,Inyo,027,18085,196,189,4,193,14
2020-09-30,Kern,029,883053,32368,31601,332,31933,398
2020-09-30,Kings,031,150075,8087,7685,45,7730,79
2020-09-30,Lake,033,64148,598,567,0,567,10
2020-09-30,Lassen,035,31185,750,742,2,744,0
2020-09-30,Los Angeles,037,10098052,273233,270260,1992,272252,6568
2020-09-30,Madera,039,155013,4684,4477,31,4508,47
2020-09-30,Marin,041,260295,6810,6700,17,6717,91
2020-09-30,Mariposa,043,17540,77,76,0,76,2
2020-09-30,Mendocino,045,87422,935,867,4,871,17
2020-09-30,Merced,047,269075,9036,8926,25,8951,136
2020-09-30,Modoc,049,8938,29,26,0,26,0
2020-09-30,Mono,051,14174,169,150,2,152,1
2020-09-30,Monterey,053,433212,10230,9898,39,9937,70
2020-09-30,Napa,055,140530,1775,1728,8,1736,11
2020-09-30,Nevada,057,99092,557,540,16,556,6
2020-09-30,Orange,059,3164182,55967,52916,1513,54429,1251
2020-09-30,Placer,061,380077,3724,3585,14,3599,43
2020-09-30,Plumas,063,18699,51,48,0,48,0
2020-09-30,Riverside,065,2383286,60770,59074,203,59277,1220
2020-09-30,Sacramento,067,1510023,23193,22613,26,22639,429
2020-09-30,San Benito,069,59416,1357,1342,0,1342,12
2020-09-30,San Bernardino,071,2135413,56115,53988,347,54335,1018
2020-09-30,San Diego,073,3302833,49169,47182,1047,48229,783
2020-09-30,San Francisco,075,870044,11492,11247,30,11277,106
2020-09-30,San Joaquin,077,732212,20532,20150,61,20211,461
2020-09-30,San Luis Obispo,079,281455,3867,3597,20,3617,31
2020-09-30,San Mateo,081,765935,10425,9634,9,9643,128
2020-09-30,Santa Barbara,083,443738,9329,9186,80,9266,115
2020-09-30,Santa Clara,085,1922200,22668,21318,46,21364,302
2020-09-30,Santa Cruz,087,273765,2518,2405,33,2438,10
2020-09-30,Shasta,089,179085,1347,976,13,989,17
2020-09-30,Sierra,091,2930,6,6,0,6,0
2020-09-30,Siskiyou,093,43540,163,150,10,160,0
2020-09-30,Solano,095,438530,6496,6315,41,6356,51
2020-09-30,Sonoma,097,501317,7996,7494,21,7515,125
2020-09-30,Stanislaus,099,539301,16734,16531,552,17083,343
2020-09-30,Sutter,101,95872,1716,1680,1,1681,10
2020-09-30,Tehama,103,63373,646,594,2,596,3
2020-09-30,Trinity,105,12862,58,15,8,23,0
2020-09-30,Tulare,107,460477,16697,16117,157,16274,274
2020-09-30,Tuolumne,109,53932,232,224,4,228,2
2020-09-30,Ventura,111,848112,13706,12968,191,13159,145
2020-09-30,Yolo,113,214977,2885,2822,6,2828,55
2020-09-30,Yuba,115,75493,1113,1075,5,1080,8
2020-09-29,Alameda,001,1643700,21799,21241,185,21426,374
2020-09-29,Alpine,003,1148,3,2,0,2,0
2020-09-29,Amador,005,37829,297,294,0,294,16
2020-09-29,Butte,007,227075,2971,2848,25,2873,44
2020-09-29,Calaveras,009,45235,309,261,0,261,11
2020-09-29,Colusa,011,21464,534,534,0,534,6
2020-09-29,Contra Costa,013,1133247,17446,16716,82,16798,209
2020-09-29,Del Norte,015,27424,142,142,0,142,2
2020-09-29,El Dorado,017,186661,1238,1151,1,1152,4
2020-09-29,Fresno,019,978130,31087,28621,398,29019,394
2020-09-29,Glenn,021,27897,602,589,0,589,3
2020-09-29,Humboldt,023,135768,514,497,1,498,6
2020-09-29,Imperial,025,180216,11959,10811,27,10838,283
2020-09-29,Inyo,027,18085,195,188,4,192,14
2020-09-29,Kern,029,883053,32313,31534,331,31865,397
2020-09-29,Kings,031,150075,8031,7681,45,7726,78
2020-09-29,Lake,033,64148,596,566,0,566,11
2020-09-29,Lassen,035,31185,750,741,2,743,0
2020-09-29,Los Angeles,037,10098052,272018,269246,1963,271209,6545
2020-09-29,Madera,039,155013,4660,4453,31,4484,47
2020-09-29,Marin,041,260295,6789,6692,17,6709,91
2020-09-29,Mariposa,043,17540,77,74,0,74,2
2020-09-29,Mendocino,045,87422,925,854,4,858,17
2020-09-29,Merced,047,269075,9023,8892,23,8915,136
2020-09-29,Modoc,049,8938,29,26,0,26,0
2020-09-29,Mono,051,14174,169,149,2,151,1
2020-09-29,Monterey,053,433212,10175,9826,37,9863,70
2020-09-29,Napa,055,140530,1772,1727,8,1735,11
2020-09-29,Nevada,057,99092,552,539,16,555,6
2020-09-29,Orange,059,3164182,55781,52755,1502,54257,1231
2020-09-29,Placer,061,380077,3702,3570,14,3584,42
2020-09-29,Plumas,063,18699,51,48,0,48,0
2020-09-29,Riverside,065,2383286,60440,58863,196,59059,1208
2020-09-29,Sacramento,067,1510023,23072,22547,26,22573,425
2020-09-29,San Benito,069,59416,1352,1341,0,1341,12
2020-09-29,San Bernardino,071,2135413,55806,53753,346,54099,1012
2020-09-29,San Diego,073,3302833,48892,46987,1024,48011,781
2020-09-29,San Francisco,075,870044,11456,11142,30,11172,104
2020-09-29,San Joaquin,077,732212,20466,20094,59,20153,454
2020-09-29,San Luis Obispo,079,281455,3845,3581,20,3601,31
2020-09-29,San Mateo,081,765935,10378,9619,9,9628,127
2020-09-29,Santa Barbara,083,443738,9309,9149,79,9228,114
2020-09-29,Santa Clara,085,1922200,22532,21233,45,21278,302
2020-09-29,Santa Cruz,087,273765,2503,2383,32,2415,10
2020-09-29,Shasta,089,179085,1286,943,13,956,17
2020-09-29,Sierra,091,2930,6,6,0,6,0
2020-09-29,Siskiyou,093,43540,157,150,10,160,0
2020-09-29,Solano,095,438530,6462,6303,41,6344,51
2020-09-29,Sonoma,097,501317,7924,7426,21,7447,125
2020-09-29,Stanislaus,099,539301,16704,16505,546,17051,341
2020-09-29,Sutter,101,95872,1710,1677,1,1678,10
2020-09-29,Tehama,103,63373,628,585,2,587,2
2020-09-29,Trinity,105,12862,56,16,8,24,0
2020-09-29,Tulare,107,460477,16633,16055,150,16205,270
2020-09-29,Tuolumne,109,53932,232,224,4,228,2
2020-09-29,Ventura,111,848112,13649,12875,188,13063,145
2020-09-29,Yolo,113,214977,2872,2818,6,2824,55
2020-09-29,Yuba,115,75493,1111,1071,5,1076,8
2020-09-28,Alameda,001,1643700,21712,21133,185,21318,370
2020-09-28,Alpine,003,1148,3,2,0,2,0
2020-09-28,Amador,005,37829,295,294,0,294,16
2020-09-28,Butte,007,227075,2956,2837,25,2862,44
2020-09-28,Calaveras,009,45235,309,257,0,257,11
2020-09-28,Colusa,011,21464,533,531,0,531,6
2020-09-28,Contra Costa,013,1133247,17381,16653,82,16735,195
2020-09-28,Del Norte,015,27424,142,138,0,138,2
2020-09-28,El Dorado,017,186661,1231,1144,1,1145,4
2020-09-28,Fresno,019,978130,31005,28517,390,28907,389
2020-09-28,Glenn,021,27897,600,585,0,585,3
2020-09-28,Humboldt,023,135768,508,495,1,496,6
2020-09-28,Imperial,025,180216,11924,10777,27,10804,283
2020-09-28,Inyo,027,18085,194,188,4,192,14
2020-09-28,Kern,029,883053,32248,31481,327,31808,395
2020-09-28,Kings,031,150075,7890,7661,43,7704,78
2020-09-28,Lake,033,64148,592,559,0,559,10
2020-09-28,Lassen,035,31185,749,737,2,739,0
2020-09-28,Los Angeles,037,10098052,270912,268404,1933,270337,6508
2020-09-28,Madera,039,155013,4639,4438,31,4469,47
2020-09-28,Marin,041,260295,6773,6676,17,6693,91
2020-09-28,Mariposa,043,17540,77,74,0,74,2
2020-09-28,Mendocino,045,87422,910,850,4,854,17
2020-09-28,Merced,047,269075,8995,8869,23,8892,136
2020-09-28,Modoc,049,8938,29,26,0,26,0
2020-09-28,Mono,051,14174,169,148,2,150,1
2020-09-28,Monterey,053,433212,10110,9780,35,9815,69
2020-09-28,Napa,055,140530,1760,1705,8,1713,11
2020-09-28,Nevada,057,99092,544,538,16,554,6
2020-09-28,Orange,059,3164182,55575,52633,1493,54126,1196
2020-09-28,Placer,061,380077,3681,3572,14,3586,42
2020-09-28,Plumas,063,18699,50,48,0,48,0
2020-09-28,Riverside,065,2383286,60142,58570,186,58756,1198
2020-09-28,Sacramento,067,1510023,22925,22392,26,22418,423
2020-09-28,San Benito,069,59416,1349,1336,0,1336,11
2020-09-28,San Bernardino,071,2135413,55459,53501,346,53847,988
2020-09-28,San Diego,073,3302833,48574,46736,1004,47740,776
2020-09-28,San Francisco,075,870044,11422,11114,30,11144,100
2020-09-28,San Joaquin,077,732212,20417,19982,58,20040,448
2020-09-28,San Luis Obispo,079,281455,3824,3567,20,3587,31
2020-09-28,San Mateo,081,765935,10327,9582,9,9591,127
2020-09-28,Santa Barbara,083,443738,9291,9121,79,9200,114
2020-09-28,Santa Clara,085,1922200,22415,21180,45,21225,271
2020-09-28,Santa Cruz,087,273765,2493,2359,32,2391,9
2020-09-28,Shasta,089,179085,1232,883,10,893,17
2020-09-28,Sierra,091,2930,6,6,0,6,0
2020-09-28,Siskiyou,093,43540,157,149,10,159,0
2020-09-28,Solano,095,438530,6426,6254,41,6295,51
2020-09-28,Sonoma,097,501317,7848,7369,21,7390,125
2020-09-28,Stanislaus,099,539301,16664,16467,539,17006,336
2020-09-28,Sutter,101,95872,1703,1676,1,1677,10
2020-09-28,Tehama,103,63373,620,579,2,581,2
2020-09-28,Trinity,105,12862,56,16,8,24,0
2020-09-28,Tulare,107,460477,16580,15918,145,16063,270
2020-09-28,Tuolumne,109,53932,232,225,4,229,2
2020-09-28,Ventura,111,848112,13571,12812,181,12993,139
2020-09-28,Yolo,113,214977,2855,2809,6,2815,55
2020-09-28,Yuba,115,75493,1108,1062,5,1067,7
2020-09-27,Alameda,001,1643700,21631,21077,181,21258,370
2020-09-27,Alpine,003,1148,3,2,0,2,0
2020-09-27,Amador,005,37829,295,291,0,291,16
2020-09-27,Butte,007,227075,2944,2833,25,2858,44
2020-09-27,Calaveras,009,45235,308,257,0,257,11
2020-09-27,Colusa,011,21464,532,531,0,531,6
2020-09-27,Contra Costa,013,1133247,17279,16596,81,16677,195
2020-09-27,Del Norte,015,27424,142,138,0,138,2
2020-09-27,El Dorado,017,186661,1216,1130,1,1131,4
2020-09-27,Fresno,019,978130,30899,28441,390,28831,389
2020-09-27,Glenn,021,27897,596,576,0,576,3
2020-09-27,Humboldt,023,135768,506,492,1,493,6
2020-09-27,Imperial,025,180216,11890,10743,26,10769,283
2020-09-27,Inyo,027,18085,192,188,4,192,14
2020-09-27,Kern,029,883053,32129,31462,324,31786,395
2020-09-27,Kings,031,150075,7870,7641,43,7684,78
2020-09-27,Lake,033,64148,588,555,0,555,10
2020-09-27,Lassen,035,31185,749,737,2,739,0
2020-09-27,Los Angeles,037,10098052,269737,267754,1912,269666,6507
2020-09-27,Madera,039,155013,4610,4416,31,4447,47
2020-09-27,Marin,041,260295,6763,6663,17,6680,91
2020-09-27,Mariposa,043,17540,77,74,0,74,2
2020-09-27,Mendocino,045,87422,904,846,4,850,17
2020-09-27,Merced,047,269075,8961,8853,23,8876,136
2020-09-27,Modoc,049,8938,29,26,0,26,0
2020-09-27,Mono,051,14174,169,148,2,150,1
2020-09-27,Monterey,053,433212,10050,9724,34,9758,69
2020-09-27,Napa,055,140530,1755,1690,8,1698,11
2020-09-27,Nevada,057,99092,543,537,16,553,6
2020-09-27,Orange,059,3164182,55300,52458,1484,53942,1195
2020-09-27,Placer,061,380077,3668,3562,14,3576,42
2020-09-27,Plumas,063,18699,50,48,0,48,0
2020-09-27,Riverside,065,2383286,59846,58509,178,58687,1191
2020-09-27,Sacramento,067,1510023,22827,22356,26,22382,422
2020-09-27,San Benito,069,59416,1349,1331,0,1331,11
2020-09-27,San Bernardino,071,2135413,55023,53127,346,53473,988
2020-09-27,San Diego,073,3302833,48230,46612,987,47599,776
2020-09-27,San Francisco,075,870044,11370,11114,30,11144,100
2020-09-27,San Joaquin,077,732212,20357,19981,58,20039,448
2020-09-27,San Luis Obispo,079,281455,3803,3562,20,3582,31
2020-09-27,San Mateo,081,765935,10259,9566,9,9575,127
2020-09-27,Santa Barbara,083,443738,9270,9090,78,9168,114
2020-09-27,Santa Clara,085,1922200,22306,21091,45,21136,271
2020-09-27,Santa Cruz,087,273765,2471,2359,32,2391,9
2020-09-27,Shasta,089,179085,1189,883,9,892,17
2020-09-27,Sierra,091,2930,6,6,0,6,0
2020-09-27,Siskiyou,093,43540,156,149,10,159,0
2020-09-27,Solano,095,438530,6391,6211,41,6252,51
2020-09-27,Sonoma,097,501317,7767,7336,21,7357,124
2020-09-27,Stanislaus,099,539301,16613,16448,533,16981,336
2020-09-27,Sutter,101,95872,1696,1672,1,1673,10
2020-09-27,Tehama,103,63373,603,573,2,575,2
2020-09-27,Trinity,105,12862,56,16,8,24,0
2020-09-27,Tulare,107,460477,16502,15918,136,16054,270
2020-09-27,Tuolumne,109,53932,231,224,4,228,2
2020-09-27,Ventura,111,848112,13482,12775,172,12947,139
2020-09-27,Yolo,113,214977,2841,2796,6,2802,55
2020-09-27,Yuba,115,75493,1098,1059,5,1064,7
2020-09-26,Alameda,001,1643700,21573,21019,180,21199,370
2020-09-26,Alpine,003,1148,3,2,0,2,0
2020-09-26,Amador,005,37829,294,291,0,291,16
2020-09-26,Butte,007,227075,2936,2827,25,2852,44
2020-09-26,Calaveras,009,45235,308,257,0,257,11
2020-09-26,Colusa,011,21464,532,529,0,529,6
2020-09-26,Contra Costa,013,1133247,17237,16508,81,16589,194
2020-09-26,Del Norte,015,27424,142,138,0,138,2
2020-09-26,El Dorado,017,186661,1211,1127,1,1128,4
2020-09-26,Fresno,019,978130,30832,28336,390,28726,389
2020-09-26,Glenn,021,27897,596,576,0,576,3
2020-09-26,Humboldt,023,135768,506,491,1,492,6
2020-09-26,Imperial,025,180216,11873,10721,26,10747,283
2020-09-26,Inyo,027,18085,191,187,4,191,14
2020-09-26,Kern,029,883053,32078,31410,324,31734,394
2020-09-26,Kings,031,150075,7858,7537,43,7580,78
2020-09-26,Lake,033,64148,585,549,0,549,10
2020-09-26,Lassen,035,31185,749,737,2,739,0
2020-09-26,Los Angeles,037,10098052,269103,266931,1897,268828,6497
2020-09-26,Madera,039,155013,4594,4410,31,4441,47
2020-09-26,Marin,041,260295,6750,6641,17,6658,91
2020-09-26,Mariposa,043,17540,76,74,0,74,2
2020-09-26,Mendocino,045,87422,899,836,4,840,17
2020-09-26,Merced,047,269075,8949,8841,22,8863,136
2020-09-26,Modoc,049,8938,29,26,0,26,0
2020-09-26,Mono,051,14174,169,148,2,150,1
2020-09-26,Monterey,053,433212,10023,9651,34,9685,68
2020-09-26,Napa,055,140530,1753,1681,8,1689,11
2020-09-26,Nevada,057,99092,543,534,16,550,6
2020-09-26,Orange,059,3164182,55160,52203,1478,53681,1194
2020-09-26,Placer,061,380077,3655,3551,14,3565,42
2020-09-26,Plumas,063,18699,49,48,0,48,0
2020-09-26,Riverside,065,2383286,59711,58076,176,58252,1190
2020-09-26,Sacramento,067,1510023,22771,22269,26,22295,421
2020-09-26,San Benito,069,59416,1347,1325,0,1325,11
2020-09-26,San Bernardino,071,2135413,54889,53122,346,53468,988
2020-09-26,San Diego,073,3302833,48025,46333,973,47306,775
2020-09-26,San Francisco,075,870044,11342,11113,30,11143,100
2020-09-26,San Joaquin,077,732212,20322,19982,56,20038,449
2020-09-26,San Luis Obispo,079,281455,3786,3546,20,3566,31
2020-09-26,San Mateo,081,765935,10225,9509,9,9518,127
2020-09-26,Santa Barbara,083,443738,9259,9061,78,9139,114
2020-09-26,Santa Clara,085,1922200,22235,20967,44,21011,270
2020-09-26,Santa Cruz,087,273765,2463,2336,32,2368,9
2020-09-26,Shasta,089,179085,1139,856,8,864,17
2020-09-26,Sierra,091,2930,6,6,0,6,0
2020-09-26,Siskiyou,093,43540,155,149,10,159,0
2020-09-26,Solano,095,438530,6372,6209,41,6250,51
2020-09-26,Sonoma,097,501317,7742,7285,20,7305,124
2020-09-26,Stanislaus,099,539301,16588,16421,524,16945,336
2020-09-26,Sutter,101,95872,1691,1662,1,1663,10
2020-09-26,Tehama,103,63373,591,560,2,562,2
2020-09-26,Trinity,105,12862,54,16,8,24,0
2020-09-26,Tulare,107,460477,16476,15881,134,16015,270
2020-09-26,Tuolumne,109,53932,231,223,4,227,2
2020-09-26,Ventura,111,848112,13447,12729,171,12900,137
2020-09-26,Yolo,113,214977,2839,2789,6,2795,55
2020-09-26,Yuba,115,75493,1094,1056,5,1061,7
2020-09-25,Alameda,001,1643700,21519,20911,180,21091,367
2020-09-25,Alpine,003,1148,3,2,0,2,0
2020-09-25,Amador,005,37829,294,289,0,289,16
2020-09-25,Butte,007,227075,2931,2819,25,2844,43
2020-09-25,Calaveras,009,45235,308,257,0,257,11
2020-09-25,Colusa,011,21464,532,528,0,528,6
2020-09-25,Contra Costa,013,1133247,17178,16401,81,16482,194
2020-09-25,Del Norte,015,27424,142,138,0,138,2
2020-09-25,El Dorado,017,186661,1207,1104,1,1105,4
2020-09-25,Fresno,019,978130,30772,28199,389,28588,385
2020-09-25,Glenn,021,27897,594,570,0,570,3
2020-09-25,Humboldt,023,135768,505,489,1,490,5
2020-09-25,Imperial,025,180216,11855,10681,26,10707,283
2020-09-25,Inyo,027,18085,189,187,4,191,14
2020-09-25,Kern,029,883053,32025,31333,322,31655,393
2020-09-25,Kings,031,150075,7853,7450,43,7493,77
2020-09-25,Lake,033,64148,584,539,0,539,9
2020-09-25,Lassen,035,31185,749,737,2,739,0
2020-09-25,Los Angeles,037,10098052,268314,265713,1883,267596,6483
2020-09-25,Madera,039,155013,4575,4369,31,4400,48
2020-09-25,Marin,041,260295,6747,6622,17,6639,90
2020-09-25,Mariposa,043,17540,76,74,0,74,2
2020-09-25,Mendocino,045,87422,884,819,3,822,17
2020-09-25,Merced,047,269075,8933,8830,22,8852,135
2020-09-25,Modoc,049,8938,29,26,0,26,0
2020-09-25,Mono,051,14174,169,149,2,151,1
2020-09-25,Monterey,053,433212,9971,9581,34,9615,68
2020-09-25,Napa,055,140530,1751,1669,8,1677,11
2020-09-25,Nevada,057,99092,541,529,16,545,6
2020-09-25,Orange,059,3164182,55033,52031,1470,53501,1184
2020-09-25,Placer,061,380077,3644,3527,14,3541,41
2020-09-25,Plumas,063,18699,49,48,0,48,0
2020-09-25,Riverside,065,2383286,59535,57783,171,57954,1183
2020-09-25,Sacramento,067,1510023,22694,22132,26,22158,418
2020-09-25,San Benito,069,59416,1346,1318,0,1318,11
2020-09-25,San Bernardino,071,2135413,54735,52814,346,53160,987
2020-09-25,San Diego,073,3302833,47823,46003,957,46960,775
2020-09-25,San Francisco,075,870044,11308,11066,29,11095,100
2020-09-25,San Joaquin,077,732212,20270,19909,56,19965,449
2020-09-25,San Luis Obispo,079,281455,3774,3512,20,3532,31
2020-09-25,San Mateo,081,765935,10189,9447,9,9456,127
2020-09-25,Santa Barbara,083,443738,9235,9026,78,9104,114
2020-09-25,Santa Clara,085,1922200,22171,20812,43,20855,265
2020-09-25,Santa Cruz,087,273765,2451,2309,31,2340,9
2020-09-25,Shasta,089,179085,1105,806,8,814,16
2020-09-25,Sierra,091,2930,6,6,0,6,0
2020-09-25,Siskiyou,093,43540,155,149,10,159,0
2020-09-25,Solano,095,438530,6356,6179,41,6220,50
2020-09-25,Sonoma,097,501317,7702,7202,20,7222,124
2020-09-25,Stanislaus,099,539301,16570,16381,522,16903,326
2020-09-25,Sutter,101,95872,1688,1655,1,1656,10
2020-09-25,Tehama,103,63373,583,546,2,548,2
2020-09-25,Trinity,105,12862,54,15,8,23,0
2020-09-25,Tulare,107,460477,16436,15815,132,15947,267
2020-09-25,Tuolumne,109,53932,231,223,4,227,2
2020-09-25,Ventura,111,848112,13404,12664,168,12832,137
2020-09-25,Yolo,113,214977,2831,2784,6,2790,55
2020-09-25,Yuba,115,75493,1089,1049,5,1054,5
2020-09-24,Alameda,001,1643700,21444,20838,177,21015,364
2020-09-24,Alpine,003,1148,3,2,0,2,0
2020-09-24,Amador,005,37829,294,288,0,288,16
2020-09-24,Butte,007,227075,2920,2803,25,2828,43
2020-09-24,Calaveras,009,45235,308,258,0,258,11
2020-09-24,Colusa,011,21464,532,523,0,523,6
2020-09-24,Contra Costa,013,1133247,17096,16252,81,16333,192
2020-09-24,Del Norte,015,27424,138,137,0,137,2
2020-09-24,El Dorado,017,186661,1198,1093,1,1094,4
2020-09-24,Fresno,019,978130,30666,28106,385,28491,375
2020-09-24,Glenn,021,27897,590,567,0,567,3
2020-09-24,Humboldt,023,135768,502,482,1,483,5
2020-09-24,Imperial,025,180216,11831,10622,25,10647,283
2020-09-24,Inyo,027,18085,189,187,4,191,13
2020-09-24,Kern,029,883053,31962,31273,320,31593,388
2020-09-24,Kings,031,150075,7837,7428,43,7471,76
2020-09-24,Lake,033,64148,575,531,0,531,9
2020-09-24,Lassen,035,31185,748,737,2,739,0
2020-09-24,Los Angeles,037,10098052,267273,264374,1865,266239,6452
2020-09-24,Madera,039,155013,4556,4344,31,4375,48
2020-09-24,Marin,041,260295,6719,6588,17,6605,85
2020-09-24,Mariposa,043,17540,76,74,0,74,2
2020-09-24,Mendocino,045,87422,880,810,3,813,17
2020-09-24,Merced,047,269075,8904,8813,21,8834,135
2020-09-24,Modoc,049,8938,29,24,0,24,0
2020-09-24,Mono,051,14174,169,149,2,151,1
2020-09-24,Monterey,053,433212,9905,9544,31,9575,67
2020-09-24,Napa,055,140530,1739,1661,8,1669,11
2020-09-24,Nevada,057,99092,540,527,16,543,6
2020-09-24,Orange,059,3164182,54825,51749,1452,53201,1164
2020-09-24,Placer,061,380077,3629,3514,14,3528,41
2020-09-24,Plumas,063,18699,49,48,0,48,0
2020-09-24,Riverside,065,2383286,59270,57491,165,57656,1172
2020-09-24,Sacramento,067,1510023,22568,21985,25,22010,417
2020-09-24,San Benito,069,59416,1344,1308,0,1308,11
2020-09-24,San Bernardino,071,2135413,54399,52455,345,52800,988
2020-09-24,San Diego,073,3302833,47554,45598,942,46540,773
2020-09-24,San Francisco,075,870044,11261,10992,29,11021,99
2020-09-24,San Joaquin,077,732212,20232,19851,55,19906,444
2020-09-24,San Luis Obispo,079,281455,3758,3480,20,3500,31
2020-09-24,San Mateo,081,765935,10141,9376,9,9385,127
2020-09-24,Santa Barbara,083,443738,9183,8988,77,9065,114
2020-09-24,Santa Clara,085,1922200,22083,20689,43,20732,262
2020-09-24,Santa Cruz,087,273765,2431,2300,29,2329,9
2020-09-24,Shasta,089,179085,1068,773,5,778,14
2020-09-24,Sierra,091,2930,6,6,0,6,0
2020-09-24,Siskiyou,093,43540,155,149,10,159,0
2020-09-24,Solano,095,438530,6323,6137,41,6178,49
2020-09-24,Sonoma,097,501317,7621,7163,20,7183,122
2020-09-24,Stanislaus,099,539301,16533,16326,517,16843,326
2020-09-24,Sutter,101,95872,1685,1646,1,1647,10
2020-09-24,Tehama,103,63373,580,540,2,542,2
2020-09-24,Trinity,105,12862,54,15,8,23,0
2020-09-24,Tulare,107,460477,16371,15754,131,15885,267
2020-09-24,Tuolumne,109,53932,231,224,4,228,2
2020-09-24,Ventura,111,848112,13322,12617,167,12784,138
2020-09-24,Yolo,113,214977,2824,2776,6,2782,55
2020-09-24,Yuba,115,75493,1084,1042,5,1047,5
2020-09-23,Alameda,001,1643700,21376,20718,175,20893,361
2020-09-23,Alpine,003,1148,3,2,0,2,0
2020-09-23,Amador,005,37829,293,288,0,288,16
2020-09-23,Butte,007,227075,2912,2790,25,2815,43
2020-09-23,Calaveras,009,45235,307,258,0,258,11
2020-09-23,Colusa,011,21464,531,521,0,521,6
2020-09-23,Contra Costa,013,1133247,17032,16167,80,16247,192
2020-09-23,Del Norte,015,27424,136,137,0,137,2
2020-09-23,El Dorado,017,186661,1184,1088,1,1089,4
2020-09-23,Fresno,019,978130,30571,28019,383,28402,371
2020-09-23,Glenn,021,27897,583,561,0,561,3
2020-09-23,Humboldt,023,135768,498,477,1,478,5
2020-09-23,Imperial,025,180216,11805,10587,25,10612,284
2020-09-23,Inyo,027,18085,188,177,4,181,13
2020-09-23,Kern,029,883053,31918,31172,318,31490,387
2020-09-23,Kings,031,150075,7815,7406,43,7449,76
2020-09-23,Lake,033,64148,570,519,0,519,9
2020-09-23,Lassen,035,31185,748,736,2,738,0
2020-09-23,Los Angeles,037,10098052,266256,263318,1836,265154,6421
2020-09-23,Madera,039,155013,4541,4311,31,4342,48
2020-09-23,Marin,041,260295,6700,6567,17,6584,85
2020-09-23,Mariposa,043,17540,76,74,0,74,2
2020-09-23,Mendocino,045,87422,879,801,2,803,17
2020-09-23,Merced,047,269075,8883,8785,20,8805,134
2020-09-23,Modoc,049,8938,29,24,0,24,0
2020-09-23,Mono,051,14174,169,149,2,151,1
2020-09-23,Monterey,053,433212,9836,9452,30,9482,67
2020-09-23,Napa,055,140530,1730,1653,8,1661,11
2020-09-23,Nevada,057,99092,539,523,16,539,6
2020-09-23,Orange,059,3164182,54598,51658,1444,53102,1155
2020-09-23,Placer,061,380077,3617,3506,14,3520,41
2020-09-23,Plumas,063,18699,49,48,0,48,0
2020-09-23,Riverside,065,2383286,58963,57257,162,57419,1165
2020-09-23,Sacramento,067,1510023,22491,21821,25,21846,415
2020-09-23,San Benito,069,59416,1338,1305,0,1305,10
2020-09-23,San Bernardino,071,2135413,54104,52132,344,52476,973
2020-09-23,San Diego,073,3302833,47278,45427,923,46350,767
2020-09-23,San Francisco,075,870044,11212,10926,29,10955,95
2020-09-23,San Joaquin,077,732212,20179,19785,55,19840,439
2020-09-23,San Luis Obispo,079,281455,3740,3447,20,3467,31
2020-09-23,San Mateo,081,765935,10101,9351,9,9360,127
2020-09-23,Santa Barbara,083,443738,9154,8952,77,9029,112
2020-09-23,Santa Clara,085,1922200,21972,20575,40,20615,260
2020-09-23,Santa Cruz,087,273765,2412,2283,29,2312,9
2020-09-23,Shasta,089,179085,1029,756,4,760,14
2020-09-23,Sierra,091,2930,6,6,0,6,0
2020-09-23,Siskiyou,093,43540,155,149,10,159,0
2020-09-23,Solano,095,438530,6298,6123,41,6164,50
2020-09-23,Sonoma,097,501317,7545,7091,20,7111,122
2020-09-23,Stanislaus,099,539301,16503,16271,514,16785,317
2020-09-23,Sutter,101,95872,1681,1646,1,1647,10
2020-09-23,Tehama,103,63373,574,533,2,535,2
2020-09-23,Trinity,105,12862,53,15,8,23,0
2020-09-23,Tulare,107,460477,16306,15664,130,15794,266
2020-09-23,Tuolumne,109,53932,231,223,4,227,2
2020-09-23,Ventura,111,848112,13266,12591,164,12755,137
2020-09-23,Yolo,113,214977,2806,2766,6,2772,55
2020-09-23,Yuba,115,75493,1082,1038,5,1043,5
2020-09-22,Alameda,001,1643700,21296,20607,173,20780,355
2020-09-22,Alpine,003,1148,2,2,0,2,0
2020-09-22,Amador,005,37829,292,287,0,287,16
2020-09-22,Butte,007,227075,2907,2776,25,2801,43
2020-09-22,Calaveras,009,45235,307,258,0,258,11
2020-09-22,Colusa,011,21464,529,518,0,518,6
2020-09-22,Contra Costa,013,1133247,16942,16090,80,16170,190
2020-09-22,Del Norte,015,27424,136,137,0,137,2
2020-09-22,El Dorado,017,186661,1165,1076,1,1077,4
2020-09-22,Fresno,019,978130,30476,27944,380,28324,369
2020-09-22,Glenn,021,27897,580,560,0,560,3
2020-09-22,Humboldt,023,135768,497,476,1,477,5
2020-09-22,Imperial,025,180216,11776,10529,25,10554,284
2020-09-22,Inyo,027,18085,188,177,4,181,13
2020-09-22,Kern,029,883053,31850,31110,311,31421,383
2020-09-22,Kings,031,150075,7758,7395,42,7437,76
2020-09-22,Lake,033,64148,562,516,0,516,9
2020-09-22,Lassen,035,31185,747,736,2,738,0
2020-09-22,Los Angeles,037,10098052,265191,262117,1810,263927,6394
2020-09-22,Madera,039,155013,4525,4303,31,4334,47
2020-09-22,Marin,041,260295,6686,6561,17,6578,84
2020-09-22,Mariposa,043,17540,76,74,0,74,2
2020-09-22,Mendocino,045,87422,859,794,1,795,18
2020-09-22,Merced,047,269075,8853,8769,20,8789,132
2020-09-22,Modoc,049,8938,29,24,0,24,0
2020-09-22,Mono,051,14174,168,149,2,151,1
2020-09-22,Monterey,053,433212,9778,9393,30,9423,67
2020-09-22,Napa,055,140530,1713,1652,8,1660,11
2020-09-22,Nevada,057,99092,539,523,16,539,6
2020-09-22,Orange,059,3164182,54348,51528,1436,52964,1132
2020-09-22,Placer,061,380077,3605,3492,14,3506,40
2020-09-22,Plumas,063,18699,49,48,0,48,0
2020-09-22,Riverside,065,2383286,58479,57066,158,57224,1162
2020-09-22,Sacramento,067,1510023,22371,21745,25,21770,410
2020-09-22,San Benito,069,59416,1333,1305,0,1305,10
2020-09-22,San Bernardino,071,2135413,53830,51899,344,52243,971
2020-09-22,San Diego,073,3302833,46971,45149,904,46053,765
2020-09-22,San Francisco,075,870044,11168,10893,28,10921,95
2020-09-22,San Joaquin,077,732212,20132,19755,54,19809,426
2020-09-22,San Luis Obispo,079,281455,3717,3420,20,3440,31
2020-09-22,San Mateo,081,765935,10063,9291,9,9300,127
2020-09-22,Santa Barbara,083,443738,9124,8927,76,9003,111
2020-09-22,Santa Clara,085,1922200,21853,20514,40,20554,253
2020-09-22,Santa Cruz,087,273765,2389,2264,29,2293,8
2020-09-22,Shasta,089,179085,994,723,4,727,14
2020-09-22,Sierra,091,2930,6,6,0,6,0
2020-09-22,Siskiyou,093,43540,155,149,10,159,0
2020-09-22,Solano,095,438530,6267,6107,41,6148,48
2020-09-22,Sonoma,097,501317,7466,7068,19,7087,117
2020-09-22,Stanislaus,099,539301,16480,16231,507,16738,316
2020-09-22,Sutter,101,95872,1675,1638,1,1639,10
2020-09-22,Tehama,103,63373,566,529,2,531,2
2020-09-22,Trinity,105,12862,53,15,8,23,0
2020-09-22,Tulare,107,460477,16239,15616,126,15742,263
2020-09-22,Tuolumne,109,53932,230,224,4,228,1
2020-09-22,Ventura,111,848112,13214,12507,160,12667,136
2020-09-22,Yolo,113,214977,2799,2763,6,2769,54
2020-09-22,Yuba,115,75493,1073,1035,5,1040,5
2020-09-21,Alameda,001,1643700,21217,20501,172,20673,343
2020-09-21,Alpine,003,1148,2,2,0,2,0
2020-09-21,Amador,005,37829,290,286,0,286,16
2020-09-21,Butte,007,227075,2893,2769,25,2794,41
2020-09-21,Calaveras,009,45235,305,256,0,256,10
2020-09-21,Colusa,011,21464,528,517,0,517,6
2020-09-21,Contra Costa,013,1133247,16855,16008,80,16088,189
2020-09-21,Del Norte,015,27424,136,132,0,132,2
2020-09-21,El Dorado,017,186661,1156,1074,1,1075,4
2020-09-21,Fresno,019,978130,30374,27843,373,28216,362
2020-09-21,Glenn,021,27897,576,556,0,556,3
2020-09-21,Humboldt,023,135768,493,473,1,474,5
2020-09-21,Imperial,025,180216,11745,10521,24,10545,284
2020-09-21,Inyo,027,18085,187,177,4,181,12
2020-09-21,Kern,029,883053,31778,31031,309,31340,379
2020-09-21,Kings,031,150075,7645,7297,41,7338,76
2020-09-21,Lake,033,64148,557,508,0,508,8
2020-09-21,Lassen,035,31185,745,735,2,737,0
2020-09-21,Los Angeles,037,10098052,264104,261418,1765,263183,6360
2020-09-21,Madera,039,155013,4514,4275,30,4305,47
2020-09-21,Marin,041,260295,6675,6538,16,6554,84
2020-09-21,Mariposa,043,17540,75,74,0,74,2
2020-09-21,Mendocino,045,87422,844,778,0,778,18
2020-09-21,Merced,047,269075,8834,8749,18,8767,128
2020-09-21,Modoc,049,8938,29,22,0,22,0
2020-09-21,Mono,051,14174,168,147,2,149,1
2020-09-21,Monterey,053,433212,9714,9331,27,9358,66
2020-09-21,Napa,055,140530,1702,1641,8,1649,11
2020-09-21,Nevada,057,99092,537,515,16,531,6
2020-09-21,Orange,059,3164182,54126,51363,1429,52792,1110
2020-09-21,Placer,061,380077,3595,3473,14,3487,40
2020-09-21,Plumas,063,18699,49,47,0,47,0
2020-09-21,Riverside,065,2383286,58206,57001,151,57152,1153
2020-09-21,Sacramento,067,1510023,22190,21568,25,21593,404
2020-09-21,San Benito,069,59416,1331,1298,0,1298,10
2020-09-21,San Bernardino,071,2135413,53544,51654,344,51998,970
2020-09-21,San Diego,073,3302833,46687,44927,883,45810,760
2020-09-21,San Francisco,075,870044,11120,10743,28,10771,95
2020-09-21,San Joaquin,077,732212,20074,19579,54,19633,423
2020-09-21,San Luis Obispo,079,281455,3691,3406,20,3426,27
2020-09-21,San Mateo,081,765935,10011,9239,9,9248,127
2020-09-21,Santa Barbara,083,443738,9096,8911,76,8987,110
2020-09-21,Santa Clara,085,1922200,21752,20432,40,20472,252
2020-09-21,Santa Cruz,087,273765,2372,2257,27,2284,8
2020-09-21,Shasta,089,179085,944,696,4,700,14
2020-09-21,Sierra,091,2930,6,6,0,6,0
2020-09-21,Siskiyou,093,43540,155,146,10,156,0
2020-09-21,Solano,095,438530,6243,6019,41,6060,46
2020-09-21,Sonoma,097,501317,7390,7017,19,7036,117
2020-09-21,Stanislaus,099,539301,16450,16186,507,16693,310
2020-09-21,Sutter,101,95872,1668,1634,1,1635,10
2020-09-21,Tehama,103,63373,547,513,2,515,2
2020-09-21,Trinity,105,12862,53,15,8,23,0
2020-09-21,Tulare,107,460477,16165,15528,117,15645,260
2020-09-21,Tuolumne,109,53932,230,221,4,225,1
2020-09-21,Ventura,111,848112,13130,12477,154,12631,133
2020-09-21,Yolo,113,214977,2793,2752,6,2758,54
2020-09-21,Yuba,115,75493,1069,1033,5,1038,1
2020-09-20,Alameda,001,1643700,21117,20425,169,20594,343
2020-09-20,Alpine,003,1148,2,2,0,2,0
2020-09-20,Amador,005,37829,289,286,0,286,16
2020-09-20,Butte,007,227075,2881,2764,25,2789,39
2020-09-20,Calaveras,009,45235,301,256,0,256,10
2020-09-20,Colusa,011,21464,526,510,0,510,6
2020-09-20,Contra Costa,013,1133247,16721,15917,79,15996,189
2020-09-20,Del Norte,015,27424,134,132,0,132,2
2020-09-20,El Dorado,017,186661,1141,1073,1,1074,4
2020-09-20,Fresno,019,978130,30260,27769,368,28137,362
2020-09-20,Glenn,021,27897,572,550,0,550,3
2020-09-20,Humboldt,023,135768,493,472,1,473,5
2020-09-20,Imperial,025,180216,11718,10496,22,10518,284
2020-09-20,Inyo,027,18085,187,177,4,181,12
2020-09-20,Kern,029,883053,31695,30992,306,31298,379
2020-09-20,Kings,031,150075,7598,7159,40,7199,76
2020-09-20,Lake,033,64148,545,492,0,492,8
2020-09-20,Lassen,035,31185,745,735,2,737,0
2020-09-20,Los Angeles,037,10098052,262875,260770,1739,262509,6347
2020-09-20,Madera,039,155013,4494,4257,30,4287,47
2020-09-20,Marin,041,260295,6649,6533,16,6549,83
2020-09-20,Mariposa,043,17540,75,74,0,74,2
2020-09-20,Mendocino,045,87422,832,765,0,765,18
2020-09-20,Merced,047,269075,8807,8745,18,8763,128
2020-09-20,Modoc,049,8938,27,22,0,22,0
2020-09-20,Mono,051,14174,167,147,2,149,1
2020-09-20,Monterey,053,433212,9636,9312,27,9339,65
2020-09-20,Napa,055,140530,1693,1626,8,1634,11
2020-09-20,Nevada,057,99092,534,511,16,527,6
2020-09-20,Orange,059,3164182,53885,51233,1419,52652,1110
2020-09-20,Placer,061,380077,3580,3452,14,3466,40
2020-09-20,Plumas,063,18699,49,47,0,47,0
2020-09-20,Riverside,065,2383286,58005,56783,145,56928,1147
2020-09-20,Sacramento,067,1510023,22003,21394,24,21418,401
2020-09-20,San Benito,069,59416,1320,1291,0,1291,9
2020-09-20,San Bernardino,071,2135413,53223,51559,342,51901,970
2020-09-20,San Diego,073,3302833,46314,44579,854,45433,760
2020-09-20,San Francisco,075,870044,11066,10743,28,10771,95
2020-09-20,San Joaquin,077,732212,20009,19578,47,19625,423
2020-09-20,San Luis Obispo,079,281455,3663,3393,20,3413,27
2020-09-20,San Mateo,081,765935,9944,9198,9,9207,127
2020-09-20,Santa Barbara,083,443738,9060,8880,75,8955,110
2020-09-20,Santa Clara,085,1922200,21631,20330,39,20369,252
2020-09-20,Santa Cruz,087,273765,2352,2199,27,2226,8
2020-09-20,Shasta,089,179085,903,696,3,699,14
2020-09-20,Sierra,091,2930,6,6,0,6,0
2020-09-20,Siskiyou,093,43540,155,146,10,156,0
2020-09-20,Solano,095,438530,6199,6020,41,6061,46
2020-09-20,Sonoma,097,501317,7286,6954,19,6973,117
2020-09-20,Stanislaus,099,539301,16419,16159,500,16659,310
2020-09-20,Sutter,101,95872,1662,1624,1,1625,10
2020-09-20,Tehama,103,63373,534,509,2,511,2
2020-09-20,Trinity,105,12862,53,15,8,23,0
2020-09-20,Tulare,107,460477,16079,15528,111,15639,260
2020-09-20,Tuolumne,109,53932,230,221,4,225,1
2020-09-20,Ventura,111,848112,13064,12406,150,12556,133
2020-09-20,Yolo,113,214977,2785,2745,6,2751,54
2020-09-20,Yuba,115,75493,1062,1029,5,1034,1
2020-09-19,Alameda,001,1643700,21066,20349,166,20515,343
2020-09-19,Alpine,003,1148,2,2,0,2,0
2020-09-19,Amador,005,37829,289,285,0,285,16
2020-09-19,Butte,007,227075,2875,2748,25,2773,38
2020-09-19,Calaveras,009,45235,301,256,0,256,10
2020-09-19,Colusa,011,21464,526,507,0,507,6
2020-09-19,Contra Costa,013,1133247,16658,15783,79,15862,186
2020-09-19,Del Norte,015,27424,133,132,0,132,2
2020-09-19,El Dorado,017,186661,1135,1068,0,1068,4
2020-09-19,Fresno,019,978130,30187,27668,368,28036,362
2020-09-19,Glenn,021,27897,569,547,0,547,3
2020-09-19,Humboldt,023,135768,492,471,1,472,5
2020-09-19,Imperial,025,180216,11703,10496,22,10518,284
2020-09-19,Inyo,027,18085,187,177,4,181,12
2020-09-19,Kern,029,883053,31641,30886,303,31189,379
2020-09-19,Kings,031,150075,7592,7130,40,7170,76
2020-09-19,Lake,033,64148,545,465,0,465,8
2020-09-19,Lassen,035,31185,745,731,2,733,0
2020-09-19,Los Angeles,037,10098052,262249,259801,1725,261526,6325
2020-09-19,Madera,039,155013,4471,4237,30,4267,47
2020-09-19,Marin,041,260295,6642,6513,15,6528,81
2020-09-19,Mariposa,043,17540,75,74,0,74,2
2020-09-19,Mendocino,045,87422,829,750,0,750,18
2020-09-19,Merced,047,269075,8796,8717,17,8734,128
2020-09-19,Modoc,049,8938,27,22,0,22,0
2020-09-19,Mono,051,14174,167,147,2,149,1
2020-09-19,Monterey,053,433212,9594,9237,27,9264,65
2020-09-19,Napa,055,140530,1685,1614,8,1622,11
2020-09-19,Nevada,057,99092,532,505,16,521,6
2020-09-19,Orange,059,3164182,53756,50999,1412,52411,1105
2020-09-19,Placer,061,380077,3571,3412,14,3426,40
2020-09-19,Plumas,063,18699,49,47,0,47,0
2020-09-19,Riverside,065,2383286,57878,56562,144,56706,1147
2020-09-19,Sacramento,067,1510023,21949,21297,24,21321,396
2020-09-19,San Benito,069,59416,1316,1276,0,1276,9
2020-09-19,San Bernardino,071,2135413,53067,51353,339,51692,971
2020-09-19,San Diego,073,3302833,46086,44295,831,45126,773
2020-09-19,San Francisco,075,870044,11033,10741,28,10769,95
2020-09-19,San Joaquin,077,732212,19972,19580,47,19627,424
2020-09-19,San Luis Obispo,079,281455,3642,3369,20,3389,27
2020-09-19,San Mateo,081,765935,9913,9158,9,9167,127
2020-09-19,Santa Barbara,083,443738,9040,8862,75,8937,106
2020-09-19,Santa Clara,085,1922200,21542,20170,39,20209,251
2020-09-19,Santa Cruz,087,273765,2338,2198,26,2224,8
2020-09-19,Shasta,089,179085,876,687,3,690,14
2020-09-19,Sierra,091,2930,6,6,0,6,0
2020-09-19,Siskiyou,093,43540,155,146,10,156,0
2020-09-19,Solano,095,438530,6183,5998,41,6039,46
2020-09-19,Sonoma,097,501317,7253,6905,19,6924,117
2020-09-19,Stanislaus,099,539301,16379,16109,493,16602,313
2020-09-19,Sutter,101,95872,1661,1602,1,1603,10
2020-09-19,Tehama,103,63373,529,498,2,500,2
2020-09-19,Trinity,105,12862,53,15,8,23,0
2020-09-19,Tulare,107,460477,16030,15485,108,15593,260
2020-09-19,Tuolumne,109,53932,230,217,4,221,1
2020-09-19,Ventura,111,848112,13032,12328,150,12478,133
2020-09-19,Yolo,113,214977,2777,2739,6,2745,54
2020-09-19,Yuba,115,75493,1055,1023,5,1028,1
2020-09-18,Alameda,001,1643700,21001,20222,160,20382,341
2020-09-18,Alpine,003,1148,2,2,0,2,0
2020-09-18,Amador,005,37829,289,285,0,285,16
2020-09-18,Butte,007,227075,2873,2738,25,2763,37
2020-09-18,Calaveras,009,45235,301,255,0,255,9
2020-09-18,Colusa,011,21464,526,504,0,504,6
2020-09-18,Contra Costa,013,1133247,16573,15667,79,15746,185
2020-09-18,Del Norte,015,27424,133,131,0,131,2
2020-09-18,El Dorado,017,186661,1122,1063,0,1063,4
2020-09-18,Fresno,019,978130,30122,27560,368,27928,359
2020-09-18,Glenn,021,27897,566,541,0,541,3
2020-09-18,Humboldt,023,135768,489,470,1,471,5
2020-09-18,Imperial,025,180216,11688,10460,22,10482,283
2020-09-18,Inyo,027,18085,187,177,4,181,12
2020-09-18,Kern,029,883053,31583,30742,300,31042,373
2020-09-18,Kings,031,150075,7582,7062,40,7102,74
2020-09-18,Lake,033,64148,539,458,0,458,8
2020-09-18,Lassen,035,31185,744,731,2,733,0
2020-09-18,Los Angeles,037,10098052,261488,258488,1707,260195,6324
2020-09-18,Madera,039,155013,4459,4211,30,4241,45
2020-09-18,Marin,041,260295,6627,6475,15,6490,81
2020-09-18,Mariposa,043,17540,75,74,0,74,2
2020-09-18,Mendocino,045,87422,821,739,0,739,18
2020-09-18,Merced,047,269075,8784,8691,16,8707,127
2020-09-18,Modoc,049,8938,27,22,0,22,0
2020-09-18,Mono,051,14174,165,147,2,149,1
2020-09-18,Monterey,053,433212,9552,9183,27,9210,64
2020-09-18,Napa,055,140530,1679,1604,8,1612,11
2020-09-18,Nevada,057,99092,529,504,16,520,6
2020-09-18,Orange,059,3164182,53609,50733,1400,52133,1107
2020-09-18,Placer,061,380077,3560,3389,14,3403,40
2020-09-18,Plumas,063,18699,49,45,0,45,0
2020-09-18,Riverside,065,2383286,57757,56248,140,56388,1143
2020-09-18,Sacramento,067,1510023,21866,21105,24,21129,391
2020-09-18,San Benito,069,59416,1308,1257,0,1257,8
2020-09-18,San Bernardino,071,2135413,52923,51106,336,51442,970
2020-09-18,San Diego,073,3302833,45836,44009,826,44835,757
2020-09-18,San Francisco,075,870044,10995,10644,27,10671,95
2020-09-18,San Joaquin,077,732212,19928,19531,46,19577,423
2020-09-18,San Luis Obispo,079,281455,3618,3328,20,3348,27
2020-09-18,San Mateo,081,765935,9873,9062,9,9071,127
2020-09-18,Santa Barbara,083,443738,9019,8824,75,8899,107
2020-09-18,Santa Clara,085,1922200,21444,20058,39,20097,252
2020-09-18,Santa Cruz,087,273765,2317,2180,25,2205,8
2020-09-18,Shasta,089,179085,841,668,3,671,14
2020-09-18,Sierra,091,2930,6,6,0,6,0
2020-09-18,Siskiyou,093,43540,154,146,10,156,0
2020-09-18,Solano,095,438530,6167,5961,41,6002,46
2020-09-18,Sonoma,097,501317,7205,6856,19,6875,114
2020-09-18,Stanislaus,099,539301,16351,16042,487,16529,277
2020-09-18,Sutter,101,95872,1653,1586,1,1587,10
2020-09-18,Tehama,103,63373,529,490,2,492,2
2020-09-18,Trinity,105,12862,53,15,7,22,0
2020-09-18,Tulare,107,460477,15997,15435,104,15539,259
2020-09-18,Tuolumne,109,53932,229,216,4,220,1
2020-09-18,Ventura,111,848112,12971,12236,146,12382,133
2020-09-18,Yolo,113,214977,2771,2732,6,2738,54
2020-09-18,Yuba,115,75493,1051,1020,5,1025,1
2020-09-17,Alameda,001,1643700,20902,20146,160,20306,339
2020-09-17,Alpine,003,1148,2,2,0,2,0
2020-09-17,Amador,005,37829,287,284,0,284,16
2020-09-17,Butte,007,227075,2855,2720,25,2745,38
2020-09-17,Calaveras,009,45235,301,254,0,254,9
2020-09-17,Colusa,011,21464,524,499,0,499,6
2020-09-17,Contra Costa,013,1133247,16483,15576,79,15655,184
2020-09-17,Del Norte,015,27424,133,131,0,131,2
2020-09-17,El Dorado,017,186661,1113,1057,0,1057,4
2020-09-17,Fresno,019,978130,30012,27487,363,27850,355
2020-09-17,Glenn,021,27897,565,541,0,541,3
2020-09-17,Humboldt,023,135768,483,466,1,467,5
2020-09-17,Imperial,025,180216,11671,10436,22,10458,281
2020-09-17,Inyo,027,18085,187,176,4,180,12
2020-09-17,Kern,029,883053,31522,30627,293,30920,372
2020-09-17,Kings,031,150075,7511,7015,40,7055,72
2020-09-17,Lake,033,64148,529,433,0,433,8
2020-09-17,Lassen,035,31185,742,731,2,733,0
2020-09-17,Los Angeles,037,10098052,260548,257246,1693,258939,6318
2020-09-17,Madera,039,155013,4425,4152,30,4182,45
2020-09-17,Marin,041,260295,6606,6457,15,6472,81
2020-09-17,Mariposa,043,17540,75,74,0,74,2
2020-09-17,Mendocino,045,87422,810,737,0,737,18
2020-09-17,Merced,047,269075,8765,8671,16,8687,119
2020-09-17,Modoc,049,8938,27,22,0,22,0
2020-09-17,Mono,051,14174,165,147,2,149,1
2020-09-17,Monterey,053,433212,9490,9113,25,9138,62
2020-09-17,Napa,055,140530,1668,1592,8,1600,11
2020-09-17,Nevada,057,99092,527,494,16,510,6
2020-09-17,Orange,059,3164182,53429,50537,1388,51925,1098
2020-09-17,Placer,061,380077,3539,3368,14,3382,40
2020-09-17,Plumas,063,18699,49,45,0,45,0
2020-09-17,Riverside,065,2383286,57531,56007,139,56146,1134
2020-09-17,Sacramento,067,1510023,21631,20895,24,20919,385
2020-09-17,San Benito,069,59416,1305,1252,0,1252,8
2020-09-17,San Bernardino,071,2135413,52722,50770,336,51106,904
2020-09-17,San Diego,073,3302833,45556,43621,814,44435,754
2020-09-17,San Francisco,075,870044,10900,10564,27,10591,95
2020-09-17,San Joaquin,077,732212,19869,19439,46,19485,416
2020-09-17,San Luis Obispo,079,281455,3588,3299,20,3319,27
2020-09-17,San Mateo,081,765935,9831,8984,9,8993,127
2020-09-17,Santa Barbara,083,443738,8995,8779,75,8854,107
2020-09-17,Santa Clara,085,1922200,21327,19825,39,19864,254
2020-09-17,Santa Cruz,087,273765,2301,2155,25,2180,7
2020-09-17,Shasta,089,179085,802,660,3,663,12
2020-09-17,Sierra,091,2930,6,6,0,6,0
2020-09-17,Siskiyou,093,43540,154,146,10,156,0
2020-09-17,Solano,095,438530,6144,5915,41,5956,44
2020-09-17,Sonoma,097,501317,7141,6754,19,6773,114
2020-09-17,Stanislaus,099,539301,16318,15984,483,16467,277
2020-09-17,Sutter,101,95872,1648,1572,1,1573,10
2020-09-17,Tehama,103,63373,515,487,2,489,2
2020-09-17,Trinity,105,12862,53,15,7,22,0
2020-09-17,Tulare,107,460477,15944,15344,102,15446,258
2020-09-17,Tuolumne,109,53932,228,214,4,218,1
2020-09-17,Ventura,111,848112,12884,12167,142,12309,130
2020-09-17,Yolo,113,214977,2762,2724,6,2730,53
2020-09-17,Yuba,115,75493,1047,1015,5,1020,1
2020-09-16,Alameda,001,1643700,20804,20009,158,20167,333
2020-09-16,Alpine,003,1148,2,2,0,2,0
2020-09-16,Amador,005,37829,287,284,0,284,16
2020-09-16,Butte,007,227075,2845,2704,25,2729,38
2020-09-16,Calaveras,009,45235,301,254,0,254,9
2020-09-16,Colusa,011,21464,522,497,0,497,6
2020-09-16,Contra Costa,013,1133247,16397,15473,79,15552,183
2020-09-16,Del Norte,015,27424,133,131,0,131,2
2020-09-16,El Dorado,017,186661,1105,1049,0,1049,4
2020-09-16,Fresno,019,978130,29905,27381,361,27742,343
2020-09-16,Glenn,021,27897,563,539,0,539,3
2020-09-16,Humboldt,023,135768,482,455,1,456,4
2020-09-16,Imperial,025,180216,11648,10401,22,10423,277
2020-09-16,Inyo,027,18085,186,176,4,180,12
2020-09-16,Kern,029,883053,31462,30570,292,30862,371
2020-09-16,Kings,031,150075,7486,7002,37,7039,71
2020-09-16,Lake,033,64148,518,417,0,417,6
2020-09-16,Lassen,035,31185,741,730,2,732,0
2020-09-16,Los Angeles,037,10098052,259570,256101,1675,257776,6299
2020-09-16,Madera,039,155013,4402,4138,30,4168,45
2020-09-16,Marin,041,260295,6578,6430,15,6445,77
2020-09-16,Mariposa,043,17540,75,74,0,74,2
2020-09-16,Mendocino,045,87422,801,727,0,727,18
2020-09-16,Merced,047,269075,8744,8646,16,8662,118
2020-09-16,Modoc,049,8938,27,22,0,22,0
2020-09-16,Mono,051,14174,165,147,2,149,1
2020-09-16,Monterey,053,433212,9436,8997,25,9022,62
2020-09-16,Napa,055,140530,1654,1587,8,1595,11
2020-09-16,Nevada,057,99092,522,495,15,510,6
2020-09-16,Orange,059,3164182,53229,50414,1379,51793,1096
2020-09-16,Placer,061,380077,3521,3351,14,3365,39
2020-09-16,Plumas,063,18699,49,45,0,45,0
2020-09-16,Riverside,065,2383286,57337,55811,131,55942,1127
2020-09-16,Sacramento,067,1510023,21536,20610,24,20634,377
2020-09-16,San Benito,069,59416,1297,1244,0,1244,8
2020-09-16,San Bernardino,071,2135413,52496,50509,335,50844,907
2020-09-16,San Diego,073,3302833,45264,43447,793,44240,748
2020-09-16,San Francisco,075,870044,10853,10502,27,10529,90
2020-09-16,San Joaquin,077,732212,19815,19377,45,19422,409
2020-09-16,San Luis Obispo,079,281455,3557,3285,20,3305,28
2020-09-16,San Mateo,081,765935,9766,8944,9,8953,127
2020-09-16,Santa Barbara,083,443738,8962,8764,75,8839,107
2020-09-16,Santa Clara,085,1922200,21208,19684,39,19723,253
2020-09-16,Santa Cruz,087,273765,2260,2089,24,2113,7
2020-09-16,Shasta,089,179085,776,635,3,638,11
2020-09-16,Sierra,091,2930,6,6,0,6,0
2020-09-16,Siskiyou,093,43540,153,145,10,155,0
2020-09-16,Solano,095,438530,6114,5899,41,5940,44
2020-09-16,Sonoma,097,501317,7080,6731,19,6750,104
2020-09-16,Stanislaus,099,539301,16270,15897,475,16372,263
2020-09-16,Sutter,101,95872,1635,1567,1,1568,10
2020-09-16,Tehama,103,63373,507,485,2,487,2
2020-09-16,Trinity,105,12862,53,15,7,22,0
2020-09-16,Tulare,107,460477,15900,15314,95,15409,258
2020-09-16,Tuolumne,109,53932,227,210,4,214,1
2020-09-16,Ventura,111,848112,12813,12073,140,12213,130
2020-09-16,Yolo,113,214977,2755,2709,6,2715,53
2020-09-16,Yuba,115,75493,1045,1000,5,1005,1
2020-09-15,Alameda,001,1643700,20697,19931,155,20086,327
2020-09-15,Alpine,003,1148,2,2,0,2,0
2020-09-15,Amador,005,37829,286,282,0,282,16
2020-09-15,Butte,007,227075,2832,2695,23,2718,38
2020-09-15,Calaveras,009,45235,301,248,0,248,5
2020-09-15,Colusa,011,21464,516,497,0,497,6
2020-09-15,Contra Costa,013,1133247,16294,15423,78,15501,180
2020-09-15,Del Norte,015,27424,133,129,0,129,2
2020-09-15,El Dorado,017,186661,1100,1046,0,1046,4
2020-09-15,Fresno,019,978130,29798,27312,356,27668,343
2020-09-15,Glenn,021,27897,562,531,0,531,3
2020-09-15,Humboldt,023,135768,480,456,1,457,4
2020-09-15,Imperial,025,180216,11623,10376,22,10398,277
2020-09-15,Inyo,027,18085,186,176,4,180,12
2020-09-15,Kern,029,883053,31349,30429,289,30718,368
2020-09-15,Kings,031,150075,7328,6977,37,7014,70
2020-09-15,Lake,033,64148,504,416,0,416,4
2020-09-15,Lassen,035,31185,737,719,2,721,0
2020-09-15,Los Angeles,037,10098052,258464,255048,1653,256701,6269
2020-09-15,Madera,039,155013,4383,4122,30,4152,45
2020-09-15,Marin,041,260295,6547,6423,15,6438,77
2020-09-15,Mariposa,043,17540,75,74,0,74,2
2020-09-15,Mendocino,045,87422,783,724,0,724,18
2020-09-15,Merced,047,269075,8714,8633,16,8649,114
2020-09-15,Modoc,049,8938,26,21,0,21,0
2020-09-15,Mono,051,14174,165,147,2,149,1
2020-09-15,Monterey,053,433212,9387,8943,25,8968,62
2020-09-15,Napa,055,140530,1640,1580,8,1588,11
2020-09-15,Nevada,057,99092,517,494,15,509,6
2020-09-15,Orange,059,3164182,53047,50294,1364,51658,1088
2020-09-15,Placer,061,380077,3497,3331,14,3345,38
2020-09-15,Plumas,063,18699,49,44,0,44,0
2020-09-15,Riverside,065,2383286,57043,55569,121,55690,1118
2020-09-15,Sacramento,067,1510023,21393,20487,24,20511,372
2020-09-15,San Benito,069,59416,1290,1237,0,1237,7
2020-09-15,San Bernardino,071,2135413,52280,50333,334,50667,904
2020-09-15,San Diego,073,3302833,44945,43183,773,43956,742
2020-09-15,San Francisco,075,870044,10795,10414,27,10441,90
2020-09-15,San Joaquin,077,732212,19763,19313,45,19358,401
2020-09-15,San Luis Obispo,079,281455,3537,3262,20,3282,28
2020-09-15,San Mateo,081,765935,9696,8895,9,8904,127
2020-09-15,Santa Barbara,083,443738,8937,8724,74,8798,104
2020-09-15,Santa Clara,085,1922200,21072,19610,39,19649,252
2020-09-15,Santa Cruz,087,273765,2234,2079,23,2102,7
2020-09-15,Shasta,089,179085,764,627,3,630,11
2020-09-15,Sierra,091,2930,6,6,0,6,0
2020-09-15,Siskiyou,093,43540,153,143,10,153,0
2020-09-15,Solano,095,438530,6080,5878,41,5919,45
2020-09-15,Sonoma,097,501317,7041,6701,19,6720,104
2020-09-15,Stanislaus,099,539301,16222,15880,473,16353,260
2020-09-15,Sutter,101,95872,1623,1556,1,1557,10
2020-09-15,Tehama,103,63373,495,484,2,486,2
2020-09-15,Trinity,105,12862,53,15,7,22,0
2020-09-15,Tulare,107,460477,15823,15203,93,15296,254
2020-09-15,Tuolumne,109,53932,227,209,4,213,1
2020-09-15,Ventura,111,848112,12760,11932,139,12071,128
2020-09-15,Yolo,113,214977,2751,2708,6,2714,53
2020-09-15,Yuba,115,75493,1039,991,4,995,1
2020-09-14,Alameda,001,1643700,20570,19851,154,20005,306
2020-09-14,Alpine,003,1148,2,2,0,2,0
2020-09-14,Amador,005,37829,284,281,0,281,16
2020-09-14,Butte,007,227075,2815,2642,23,2665,37
2020-09-14,Calaveras,009,45235,301,244,0,244,3
2020-09-14,Colusa,011,21464,515,486,0,486,6
2020-09-14,Contra Costa,013,1133247,16170,15354,77,15431,174
2020-09-14,Del Norte,015,27424,130,116,0,116,2
2020-09-14,El Dorado,017,186661,1096,1039,0,1039,3
2020-09-14,Fresno,019,978130,29713,27232,353,27585,344
2020-09-14,Glenn,021,27897,554,521,0,521,3
2020-09-14,Humboldt,023,135768,477,437,1,438,4
2020-09-14,Imperial,025,180216,11603,10340,22,10362,273
2020-09-14,Inyo,027,18085,186,176,4,180,12
2020-09-14,Kern,029,883053,31261,30344,288,30632,368
2020-09-14,Kings,031,150075,7246,6950,37,6987,70
2020-09-14,Lake,033,64148,484,407,0,407,4
2020-09-14,Lassen,035,31185,737,719,2,721,0
2020-09-14,Los Angeles,037,10098052,257437,254622,1628,256250,6226
2020-09-14,Madera,039,155013,4369,4104,30,4134,45
2020-09-14,Marin,041,260295,6526,6409,15,6424,70
2020-09-14,Mariposa,043,17540,75,74,0,74,2
2020-09-14,Mendocino,045,87422,766,710,0,710,17
2020-09-14,Merced,047,269075,8695,8593,16,8609,112
2020-09-14,Modoc,049,8938,26,21,0,21,0
2020-09-14,Mono,051,14174,165,147,2,149,1
2020-09-14,Monterey,053,433212,9316,8845,24,8869,61
2020-09-14,Napa,055,140530,1623,1576,8,1584,11
2020-09-14,Nevada,057,99092,512,489,15,504,6
2020-09-14,Orange,059,3164182,52886,50149,1348,51497,1079
2020-09-14,Placer,061,380077,3476,3302,14,3316,38
2020-09-14,Plumas,063,18699,48,42,0,42,0
2020-09-14,Riverside,065,2383286,56824,55488,116,55604,1113
2020-09-14,Sacramento,067,1510023,21198,20377,23,20400,367
2020-09-14,San Benito,069,59416,1275,1233,0,1233,7
2020-09-14,San Bernardino,071,2135413,52056,50163,333,50496,895
2020-09-14,San Diego,073,3302833,44634,42889,753,43642,734
2020-09-14,San Francisco,075,870044,10728,10255,25,10280,90
2020-09-14,San Joaquin,077,732212,19689,19111,44,19155,397
2020-09-14,San Luis Obispo,079,281455,3512,3248,20,3268,25
2020-09-14,San Mateo,081,765935,9634,8847,9,8856,127
2020-09-14,Santa Barbara,083,443738,8912,8692,74,8766,104
2020-09-14,Santa Clara,085,1922200,20883,19545,39,19584,247
2020-09-14,Santa Cruz,087,273765,2213,2016,22,2038,7
2020-09-14,Shasta,089,179085,741,584,3,587,10
2020-09-14,Sierra,091,2930,6,6,0,6,0
2020-09-14,Siskiyou,093,43540,152,143,10,153,0
2020-09-14,Solano,095,438530,6045,5834,41,5875,44
2020-09-14,Sonoma,097,501317,6978,6630,19,6649,102
2020-09-14,Stanislaus,099,539301,16177,15812,470,16282,253
2020-09-14,Sutter,101,95872,1612,1549,1,1550,10
2020-09-14,Tehama,103,63373,493,475,2,477,1
2020-09-14,Trinity,105,12862,52,14,7,21,0
2020-09-14,Tulare,107,460477,15753,15096,87,15183,254
2020-09-14,Tuolumne,109,53932,226,208,4,212,1
2020-09-14,Ventura,111,848112,12658,11903,136,12039,125
2020-09-14,Yolo,113,214977,2740,2687,6,2693,53
2020-09-14,Yuba,115,75493,1031,977,4,981,1
2020-09-13,Alameda,001,1643700,20464,19815,151,19966,306
2020-09-13,Alpine,003,1148,2,2,0,2,0
2020-09-13,Amador,005,37829,281,279,0,279,16
2020-09-13,Butte,007,227075,2793,2640,23,2663,37
2020-09-13,Calaveras,009,45235,300,246,0,246,3
2020-09-13,Colusa,011,21464,511,486,0,486,6
2020-09-13,Contra Costa,013,1133247,16062,15284,77,15361,172
2020-09-13,Del Norte,015,27424,127,116,0,116,1
2020-09-13,El Dorado,017,186661,1091,1035,0,1035,2
2020-09-13,Fresno,019,978130,29605,27196,344,27540,345
2020-09-13,Glenn,021,27897,550,517,0,517,3
2020-09-13,Humboldt,023,135768,477,434,1,435,4
2020-09-13,Imperial,025,180216,11566,10304,21,10325,273
2020-09-13,Inyo,027,18085,186,176,4,180,12
2020-09-13,Kern,029,883053,31168,30277,281,30558,368
2020-09-13,Kings,031,150075,7227,6937,37,6974,70
2020-09-13,Lake,033,64148,465,397,0,397,4
2020-09-13,Lassen,035,31185,734,719,2,721,0
2020-09-13,Los Angeles,037,10098052,256290,253950,1612,255562,6203
2020-09-13,Madera,039,155013,4312,4090,30,4120,45
2020-09-13,Marin,041,260295,6505,6395,15,6410,70
2020-09-13,Mariposa,043,17540,75,74,0,74,2
2020-09-13,Mendocino,045,87422,759,707,0,707,17
2020-09-13,Merced,047,269075,8661,8575,15,8590,112
2020-09-13,Modoc,049,8938,26,21,0,21,0
2020-09-13,Mono,051,14174,165,147,2,149,1
2020-09-13,Monterey,053,433212,9234,8826,23,8849,61
2020-09-13,Napa,055,140530,1616,1563,8,1571,11
2020-09-13,Nevada,057,99092,504,486,15,501,6
2020-09-13,Orange,059,3164182,52670,50061,1341,51402,1075
2020-09-13,Placer,061,380077,3446,3291,14,3305,38
2020-09-13,Plumas,063,18699,48,42,0,42,0
2020-09-13,Riverside,065,2383286,56617,55235,105,55340,1108
2020-09-13,Sacramento,067,1510023,20852,20279,23,20302,367
2020-09-13,San Benito,069,59416,1267,1217,0,1217,7
2020-09-13,San Bernardino,071,2135413,51771,49968,331,50299,895
2020-09-13,San Diego,073,3302833,44308,42681,719,43400,734
2020-09-13,San Francisco,075,870044,10650,10254,25,10279,90
2020-09-13,San Joaquin,077,732212,19617,19110,43,19153,396
2020-09-13,San Luis Obispo,079,281455,3475,3240,20,3260,24
2020-09-13,San Mateo,081,765935,9573,8811,9,8820,127
2020-09-13,Santa Barbara,083,443738,8875,8690,74,8764,104
2020-09-13,Santa Clara,085,1922200,20747,19456,38,19494,245
2020-09-13,Santa Cruz,087,273765,2180,2016,20,2036,7
2020-09-13,Shasta,089,179085,729,583,3,586,10
2020-09-13,Sierra,091,2930,6,6,0,6,0
2020-09-13,Siskiyou,093,43540,152,143,9,152,0
2020-09-13,Solano,095,438530,5999,5810,41,5851,43
2020-09-13,Sonoma,097,501317,6913,6592,19,6611,95
2020-09-13,Stanislaus,099,539301,16114,15759,458,16217,253
2020-09-13,Sutter,101,95872,1599,1539,1,1540,10
2020-09-13,Tehama,103,63373,489,476,2,478,1
2020-09-13,Trinity,105,12862,52,14,7,21,0
2020-09-13,Tulare,107,460477,15682,15098,86,15184,254
2020-09-13,Tuolumne,109,53932,223,208,4,212,1
2020-09-13,Ventura,111,848112,12550,11855,135,11990,123
2020-09-13,Yolo,113,214977,2728,2675,6,2681,53
2020-09-13,Yuba,115,75493,1026,967,4,971,1
2020-09-12,Alameda,001,1643700,20405,19758,151,19909,307
2020-09-12,Alpine,003,1148,2,2,0,2,0
2020-09-12,Amador,005,37829,280,278,0,278,16
2020-09-12,Butte,007,227075,2786,2629,22,2651,37
2020-09-12,Calaveras,009,45235,298,246,0,246,3
2020-09-12,Colusa,011,21464,507,486,0,486,6
2020-09-12,Contra Costa,013,1133247,15987,15135,76,15211,174
2020-09-12,Del Norte,015,27424,126,116,0,116,1
2020-09-12,El Dorado,017,186661,1084,1034,0,1034,2
2020-09-12,Fresno,019,978130,29534,27076,344,27420,345
2020-09-12,Glenn,021,27897,549,517,0,517,3
2020-09-12,Humboldt,023,135768,476,430,1,431,4
2020-09-12,Imperial,025,180216,11554,10305,20,10325,273
2020-09-12,Inyo,027,18085,186,177,4,181,12
2020-09-12,Kern,029,883053,31102,30202,281,30483,368
2020-09-12,Kings,031,150075,7217,6895,37,6932,70
2020-09-12,Lake,033,64148,459,393,0,393,4
2020-09-12,Lassen,035,31185,734,719,2,721,0
2020-09-12,Los Angeles,037,10098052,255731,253156,1591,254747,6193
2020-09-12,Madera,039,155013,4301,4058,30,4088,43
2020-09-12,Marin,041,260295,6496,6393,15,6408,69
2020-09-12,Mariposa,043,17540,75,72,0,72,2
2020-09-12,Mendocino,045,87422,756,700,0,700,17
2020-09-12,Merced,047,269075,8652,8533,15,8548,112
2020-09-12,Modoc,049,8938,25,21,0,21,0
2020-09-12,Mono,051,14174,165,147,2,149,1
2020-09-12,Monterey,053,433212,9198,8743,23,8766,61
2020-09-12,Napa,055,140530,1613,1556,8,1564,11
2020-09-12,Nevada,057,99092,503,482,15,497,6
2020-09-12,Orange,059,3164182,52555,49895,1338,51233,1078
2020-09-12,Placer,061,380077,3429,3280,14,3294,38
2020-09-12,Plumas,063,18699,48,42,0,42,0
2020-09-12,Riverside,065,2383286,56488,55058,101,55159,1108
2020-09-12,Sacramento,067,1510023,20783,20184,23,20207,367
2020-09-12,San Benito,069,59416,1264,1208,0,1208,7
2020-09-12,San Bernardino,071,2135413,51680,49945,329,50274,896
2020-09-12,San Diego,073,3302833,44113,42416,710,43126,747
2020-09-12,San Francisco,075,870044,10605,10257,25,10282,90
2020-09-12,San Joaquin,077,732212,19589,19108,43,19151,396
2020-09-12,San Luis Obispo,079,281455,3448,3220,20,3240,24
2020-09-12,San Mateo,081,765935,9528,8759,9,8768,127
2020-09-12,Santa Barbara,083,443738,8861,8642,74,8716,104
2020-09-12,Santa Clara,085,1922200,20663,19330,38,19368,237
2020-09-12,Santa Cruz,087,273765,2168,2016,20,2036,7
2020-09-12,Shasta,089,179085,717,569,3,572,10
2020-09-12,Sierra,091,2930,6,6,0,6,0
2020-09-12,Siskiyou,093,43540,152,141,9,150,0
2020-09-12,Solano,095,438530,5975,5772,41,5813,43
2020-09-12,Sonoma,097,501317,6889,6531,19,6550,95
2020-09-12,Stanislaus,099,539301,16082,15675,455,16130,253
2020-09-12,Sutter,101,95872,1593,1529,1,1530,10
2020-09-12,Tehama,103,63373,486,471,2,473,1
2020-09-12,Trinity,105,12862,52,15,7,22,0
2020-09-12,Tulare,107,460477,15636,15018,85,15103,254
2020-09-12,Tuolumne,109,53932,223,208,4,212,1
2020-09-12,Ventura,111,848112,12499,11759,133,11892,123
2020-09-12,Yolo,113,214977,2721,2646,6,2652,53
2020-09-12,Yuba,115,75493,1022,963,4,967,1
2020-09-11,Alameda,001,1643700,20350,19625,150,19775,298
2020-09-11,Alpine,003,1148,2,2,0,2,0
2020-09-11,Amador,005,37829,280,277,0,277,16
2020-09-11,Butte,007,227075,2775,2605,22,2627,37
2020-09-11,Calaveras,009,45235,297,242,0,242,1
2020-09-11,Colusa,011,21464,506,484,0,484,6
2020-09-11,Contra Costa,013,1133247,15935,15001,73,15074,173
2020-09-11,Del Norte,015,27424,126,115,0,115,1
2020-09-11,El Dorado,017,186661,1081,1024,0,1024,2
2020-09-11,Fresno,019,978130,29454,26917,343,27260,344
2020-09-11,Glenn,021,27897,544,515,0,515,3
2020-09-11,Humboldt,023,135768,474,426,1,427,4
2020-09-11,Imperial,025,180216,11536,10286,20,10306,273
2020-09-11,Inyo,027,18085,186,176,4,180,12
2020-09-11,Kern,029,883053,31034,30059,280,30339,365
2020-09-11,Kings,031,150075,7200,6770,37,6807,70
2020-09-11,Lake,033,64148,452,382,0,382,4
2020-09-11,Lassen,035,31185,734,719,2,721,0
2020-09-11,Los Angeles,037,10098052,255050,252057,1580,253637,6172
2020-09-11,Madera,039,155013,4282,4018,30,4048,43
2020-09-11,Marin,041,260295,6493,6364,15,6379,69
2020-09-11,Mariposa,043,17540,75,72,0,72,2
2020-09-11,Mendocino,045,87422,745,700,0,700,17
2020-09-11,Merced,047,269075,8631,8489,15,8504,109
2020-09-11,Modoc,049,8938,25,21,0,21,0
2020-09-11,Mono,051,14174,165,145,2,147,1
2020-09-11,Monterey,053,433212,9150,8595,23,8618,61
2020-09-11,Napa,055,140530,1602,1543,8,1551,11
2020-09-11,Nevada,057,99092,496,483,15,498,6
2020-09-11,Orange,059,3164182,52426,49755,1326,51081,1068
2020-09-11,Placer,061,380077,3414,3254,14,3268,37
2020-09-11,Plumas,063,18699,48,42,0,42,0
2020-09-11,Riverside,065,2383286,56353,54717,98,54815,1099
2020-09-11,Sacramento,067,1510023,20698,20012,23,20035,358
2020-09-11,San Benito,069,59416,1254,1202,0,1202,7
2020-09-11,San Bernardino,071,2135413,51580,49682,329,50011,871
2020-09-11,San Diego,073,3302833,43893,41971,704,42675,730
2020-09-11,San Francisco,075,870044,10557,10133,24,10157,89
2020-09-11,San Joaquin,077,732212,19541,19019,43,19062,391
2020-09-11,San Luis Obispo,079,281455,3430,3190,20,3210,24
2020-09-11,San Mateo,081,765935,9486,8611,9,8620,127
2020-09-11,Santa Barbara,083,443738,8828,8592,73,8665,103
2020-09-11,Santa Clara,085,1922200,20574,19065,38,19103,234
2020-09-11,Santa Cruz,087,273765,2151,1997,20,2017,7
2020-09-11,Shasta,089,179085,707,568,3,571,10
2020-09-11,Sierra,091,2930,6,6,0,6,0
2020-09-11,Siskiyou,093,43540,151,139,9,148,0
2020-09-11,Solano,095,438530,5958,5742,41,5783,42
2020-09-11,Sonoma,097,501317,6844,6469,19,6488,91
2020-09-11,Stanislaus,099,539301,16044,15613,452,16065,253
2020-09-11,Sutter,101,95872,1583,1505,1,1506,11
2020-09-11,Tehama,103,63373,483,466,2,468,1
2020-09-11,Trinity,105,12862,52,16,7,23,0
2020-09-11,Tulare,107,460477,15605,14932,83,15015,251
2020-09-11,Tuolumne,109,53932,223,208,4,212,1
2020-09-11,Ventura,111,848112,12445,11700,131,11831,123
2020-09-11,Yolo,113,214977,2710,2632,6,2638,53
2020-09-11,Yuba,115,75493,1014,946,4,950,1
2020-09-10,Alameda,001,1643700,20276,19509,150,19659,292
2020-09-10,Alpine,003,1148,2,2,0,2,0
2020-09-10,Amador,005,37829,279,277,0,277,16
2020-09-10,Butte,007,227075,2758,2590,22,2612,37
2020-09-10,Calaveras,009,45235,297,244,0,244,1
2020-09-10,Colusa,011,21464,504,482,0,482,6
2020-09-10,Contra Costa,013,1133247,15865,14909,73,14982,172
2020-09-10,Del Norte,015,27424,125,112,0,112,1
2020-09-10,El Dorado,017,186661,1078,1020,0,1020,2
2020-09-10,Fresno,019,978130,29332,26783,343,27126,338
2020-09-10,Glenn,021,27897,534,511,0,511,3
2020-09-10,Humboldt,023,135768,463,422,1,423,4
2020-09-10,Imperial,025,180216,11520,10251,20,10271,270
2020-09-10,Inyo,027,18085,185,176,4,180,11
2020-09-10,Kern,029,883053,30952,29988,276,30264,363
2020-09-10,Kings,031,150075,7170,6739,37,6776,70
2020-09-10,Lake,033,64148,445,377,0,377,4
2020-09-10,Lassen,035,31185,733,716,2,718,0
2020-09-10,Los Angeles,037,10098052,254078,251003,1558,252561,6132
2020-09-10,Madera,039,155013,4264,3979,30,4009,43
2020-09-10,Marin,041,260295,6481,6344,15,6359,68
2020-09-10,Mariposa,043,17540,75,72,0,72,2
2020-09-10,Mendocino,045,87422,735,697,0,697,16
2020-09-10,Merced,047,269075,8585,8461,15,8476,109
2020-09-10,Modoc,049,8938,25,21,0,21,0
2020-09-10,Mono,051,14174,165,145,2,147,1
2020-09-10,Monterey,053,433212,9080,8570,23,8593,59
2020-09-10,Napa,055,140530,1596,1536,8,1544,11
2020-09-10,Nevada,057,99092,492,478,15,493,6
2020-09-10,Orange,059,3164182,52263,49617,1320,50937,1057
2020-09-10,Placer,061,380077,3395,3233,14,3247,37
2020-09-10,Plumas,063,18699,48,42,0,42,0
2020-09-10,Riverside,065,2383286,56035,54417,95,54512,1091
2020-09-10,Sacramento,067,1510023,20576,19618,22,19640,354
2020-09-10,San Benito,069,59416,1248,1201,0,1201,5
2020-09-10,San Bernardino,071,2135413,51391,49467,327,49794,867
2020-09-10,San Diego,073,3302833,43627,41610,677,42287,725
2020-09-10,San Francisco,075,870044,10480,10082,24,10106,89
2020-09-10,San Joaquin,077,732212,19488,18854,43,18897,389
2020-09-10,San Luis Obispo,079,281455,3416,3161,20,3181,24
2020-09-10,San Mateo,081,765935,9440,8529,9,8538,125
2020-09-10,Santa Barbara,083,443738,8784,8552,73,8625,100
2020-09-10,Santa Clara,085,1922200,20460,18870,38,18908,231
2020-09-10,Santa Cruz,087,273765,2136,1986,18,2004,7
2020-09-10,Shasta,089,179085,696,566,3,569,10
2020-09-10,Sierra,091,2930,6,6,0,6,0
2020-09-10,Siskiyou,093,43540,151,137,9,146,0
2020-09-10,Solano,095,438530,5918,5696,41,5737,42
2020-09-10,Sonoma,097,501317,6795,6424,19,6443,91
2020-09-10,Stanislaus,099,539301,15990,15509,447,15956,243
2020-09-10,Sutter,101,95872,1571,1494,1,1495,11
2020-09-10,Tehama,103,63373,476,466,2,468,1
2020-09-10,Trinity,105,12862,52,15,7,22,0
2020-09-10,Tulare,107,460477,15550,14860,80,14940,250
2020-09-10,Tuolumne,109,53932,222,205,4,209,1
2020-09-10,Ventura,111,848112,12351,11600,124,11724,122
2020-09-10,Yolo,113,214977,2705,2612,6,2618,53
2020-09-10,Yuba,115,75493,1008,941,4,945,1
2020-09-09,Alameda,001,1643700,20197,19399,149,19548,289
2020-09-09,Alpine,003,1148,2,2,0,2,0
2020-09-09,Amador,005,37829,278,276,0,276,16
2020-09-09,Butte,007,227075,2741,2561,22,2583,37
2020-09-09,Calaveras,009,45235,297,242,0,242,1
2020-09-09,Colusa,011,21464,499,479,0,479,6
2020-09-09,Contra Costa,013,1133247,15779,14816,73,14889,171
2020-09-09,Del Norte,015,27424,121,109,0,109,1
2020-09-09,El Dorado,017,186661,1075,1020,0,1020,2
2020-09-09,Fresno,019,978130,29229,26724,338,27062,329
2020-09-09,Glenn,021,27897,531,508,0,508,3
2020-09-09,Humboldt,023,135768,461,420,1,421,4
2020-09-09,Imperial,025,180216,11499,10233,20,10253,268
2020-09-09,Inyo,027,18085,184,173,4,177,2
2020-09-09,Kern,029,883053,30854,29925,273,30198,355
2020-09-09,Kings,031,150075,7152,6721,37,6758,72
2020-09-09,Lake,033,64148,437,371,0,371,4
2020-09-09,Lassen,035,31185,732,714,2,716,0
2020-09-09,Los Angeles,037,10098052,253208,249876,1540,251416,6091
2020-09-09,Madera,039,155013,4238,3926,30,3956,43
2020-09-09,Marin,041,260295,6462,6321,15,6336,68
2020-09-09,Mariposa,043,17540,74,72,0,72,2
2020-09-09,Mendocino,045,87422,727,695,0,695,16
2020-09-09,Merced,047,269075,8559,8441,15,8456,107
2020-09-09,Modoc,049,8938,24,20,0,20,0
2020-09-09,Mono,051,14174,165,145,2,147,1
2020-09-09,Monterey,053,433212,9008,8527,23,8550,59
2020-09-09,Napa,055,140530,1586,1531,8,1539,11
2020-09-09,Nevada,057,99092,488,476,15,491,6
2020-09-09,Orange,059,3164182,52083,49394,1312,50706,1054
2020-09-09,Placer,061,380077,3375,3222,14,3236,36
2020-09-09,Plumas,063,18699,46,42,0,42,0
2020-09-09,Riverside,065,2383286,55805,54320,92,54412,1081
2020-09-09,Sacramento,067,1510023,20470,19474,21,19495,347
2020-09-09,San Benito,069,59416,1244,1199,0,1199,5
2020-09-09,San Bernardino,071,2135413,51193,49264,326,49590,866
2020-09-09,San Diego,073,3302833,43338,41326,665,41991,721
2020-09-09,San Francisco,075,870044,10430,9996,23,10019,86
2020-09-09,San Joaquin,077,732212,19424,18799,42,18841,388
2020-09-09,San Luis Obispo,079,281455,3398,3131,20,3151,24
2020-09-09,San Mateo,081,765935,9379,8478,9,8487,125
2020-09-09,Santa Barbara,083,443738,8741,8528,73,8601,97
2020-09-09,Santa Clara,085,1922200,20328,18759,38,18797,228
2020-09-09,Santa Cruz,087,273765,2113,1967,18,1985,7
2020-09-09,Shasta,089,179085,684,562,3,565,10
2020-09-09,Sierra,091,2930,6,6,0,6,0
2020-09-09,Siskiyou,093,43540,149,137,9,146,0
2020-09-09,Solano,095,438530,5886,5680,41,5721,36
2020-09-09,Sonoma,097,501317,6728,6397,19,6416,92
2020-09-09,Stanislaus,099,539301,15951,15469,436,15905,243
2020-09-09,Sutter,101,95872,1563,1487,1,1488,11
2020-09-09,Tehama,103,63373,473,462,2,464,1
2020-09-09,Trinity,105,12862,52,14,7,21,0
2020-09-09,Tulare,107,460477,15501,14787,75,14862,249
2020-09-09,Tuolumne,109,53932,221,204,3,207,1
2020-09-09,Ventura,111,848112,12260,11497,121,11618,121
2020-09-09,Yolo,113,214977,2694,2604,6,2610,53
2020-09-09,Yuba,115,75493,1003,936,4,940,1
2020-09-08,Alameda,001,1643700,20089,19293,149,19442,288
2020-09-08,Alpine,003,1148,2,2,0,2,0
2020-09-08,Amador,005,37829,278,276,0,276,16
2020-09-08,Butte,007,227075,2723,2453,22,2475,36
2020-09-08,Calaveras,009,45235,295,233,0,233,1
2020-09-08,Colusa,011,21464,497,475,0,475,6
2020-09-08,Contra Costa,013,1133247,15651,14740,70,14810,171
2020-09-08,Del Norte,015,27424,121,109,0,109,2
2020-09-08,El Dorado,017,186661,1072,1011,0,1011,2
2020-09-08,Fresno,019,978130,29109,26640,334,26974,329
2020-09-08,Glenn,021,27897,527,492,0,492,3
2020-09-08,Humboldt,023,135768,459,420,1,421,4
2020-09-08,Imperial,025,180216,11483,10198,20,10218,267
2020-09-08,Inyo,027,18085,184,169,4,173,2
2020-09-08,Kern,029,883053,30768,29850,271,30121,351
2020-09-08,Kings,031,150075,7114,6658,37,6695,72
2020-09-08,Lake,033,64148,427,370,0,370,4
2020-09-08,Lassen,035,31185,732,710,2,712,0
2020-09-08,Los Angeles,037,10098052,252281,249217,1512,250729,6034
2020-09-08,Madera,039,155013,4214,3904,30,3934,43
2020-09-08,Marin,041,260295,6431,6313,15,6328,68
2020-09-08,Mariposa,043,17540,74,72,0,72,2
2020-09-08,Mendocino,045,87422,720,690,0,690,16
2020-09-08,Merced,047,269075,8536,8381,15,8396,104
2020-09-08,Modoc,049,8938,24,20,0,20,0
2020-09-08,Mono,051,14174,165,145,2,147,1
2020-09-08,Monterey,053,433212,8923,8491,23,8514,59
2020-09-08,Napa,055,140530,1582,1518,8,1526,11
2020-09-08,Nevada,057,99092,488,470,15,485,6
2020-09-08,Orange,059,3164182,51942,49214,1308,50522,1044
2020-09-08,Placer,061,380077,3361,3205,14,3219,36
2020-09-08,Plumas,063,18699,46,42,0,42,0
2020-09-08,Riverside,065,2383286,55591,54168,89,54257,1069
2020-09-08,Sacramento,067,1510023,20235,19411,20,19431,347
2020-09-08,San Benito,069,59416,1237,1188,0,1188,5
2020-09-08,San Bernardino,071,2135413,51004,49034,325,49359,856
2020-09-08,San Diego,073,3302833,43022,41079,653,41732,709
2020-09-08,San Francisco,075,870044,10357,9821,23,9844,86
2020-09-08,San Joaquin,077,732212,19346,18550,42,18592,388
2020-09-08,San Luis Obispo,079,281455,3383,3120,20,3140,23
2020-09-08,San Mateo,081,765935,9303,8460,9,8469,125
2020-09-08,Santa Barbara,083,443738,8707,8488,72,8560,96
2020-09-08,Santa Clara,085,1922200,20152,18645,38,18683,228
2020-09-08,Santa Cruz,087,273765,2085,1903,18,1921,7
2020-09-08,Shasta,089,179085,676,556,3,559,10
2020-09-08,Sierra,091,2930,6,6,0,6,0
2020-09-08,Siskiyou,093,43540,147,136,9,145,0
2020-09-08,Solano,095,438530,5849,5654,41,5695,36
2020-09-08,Sonoma,097,501317,6659,6356,19,6375,92
2020-09-08,Stanislaus,099,539301,15887,15415,424,15839,238
2020-09-08,Sutter,101,95872,1548,1473,1,1474,11
2020-09-08,Tehama,103,63373,469,458,2,460,1
2020-09-08,Trinity,105,12862,51,13,7,20,0
2020-09-08,Tulare,107,460477,15421,14635,74,14709,249
2020-09-08,Tuolumne,109,53932,220,197,3,200,1
2020-09-08,Ventura,111,848112,12191,11475,118,11593,118
2020-09-08,Yolo,113,214977,2684,2580,6,2586,53
2020-09-08,Yuba,115,75493,991,923,4,927,1
2020-09-07,Alameda,001,1643700,19967,19188,143,19331,281
2020-09-07,Alpine,003,1148,2,2,0,2,0
2020-09-07,Amador,005,37829,278,276,0,276,16
2020-09-07,Butte,007,227075,2690,2450,21,2471,30
2020-09-07,Calaveras,009,45235,285,234,0,234,1
2020-09-07,Colusa,011,21464,496,475,0,475,6
2020-09-07,Contra Costa,013,1133247,15538,14637,67,14704,172
2020-09-07,Del Norte,015,27424,121,109,0,109,2
2020-09-07,El Dorado,017,186661,1061,1011,0,1011,2
2020-09-07,Fresno,019,978130,29015,26565,331,26896,329
2020-09-07,Glenn,021,27897,522,488,0,488,3
2020-09-07,Humboldt,023,135768,450,416,1,417,4
2020-09-07,Imperial,025,180216,11452,10199,17,10216,267
2020-09-07,Inyo,027,18085,184,169,4,173,2
2020-09-07,Kern,029,883053,30647,29790,266,30056,348
2020-09-07,Kings,031,150075,6989,6630,37,6667,72
2020-09-07,Lake,033,64148,404,367,0,367,2
2020-09-07,Lassen,035,31185,732,709,2,711,0
2020-09-07,Los Angeles,037,10098052,251237,248804,1490,250294,6030
2020-09-07,Madera,039,155013,4183,3889,29,3918,43
2020-09-07,Marin,041,260295,6401,6296,15,6311,67
2020-09-07,Mariposa,043,17540,74,72,0,72,2
2020-09-07,Mendocino,045,87422,712,687,0,687,16
2020-09-07,Merced,047,269075,8489,8381,15,8396,104
2020-09-07,Modoc,049,8938,23,20,0,20,0
2020-09-07,Mono,051,14174,165,145,2,147,1
2020-09-07,Monterey,053,433212,8844,8463,23,8486,57
2020-09-07,Napa,055,140530,1570,1514,8,1522,11
2020-09-07,Nevada,057,99092,486,469,15,484,6
2020-09-07,Orange,059,3164182,51771,49132,1304,50436,1042
2020-09-07,Placer,061,380077,3330,3188,13,3201,36
2020-09-07,Plumas,063,18699,45,42,0,42,0
2020-09-07,Riverside,065,2383286,55316,54178,83,54261,1069
2020-09-07,Sacramento,067,1510023,19992,19292,19,19311,345
2020-09-07,San Benito,069,59416,1231,1180,0,1180,4
2020-09-07,San Bernardino,071,2135413,50776,49043,323,49366,821
2020-09-07,San Diego,073,3302833,42622,40868,626,41494,708
2020-09-07,San Francisco,075,870044,10306,9813,22,9835,85
2020-09-07,San Joaquin,077,732212,19265,18552,40,18592,386
2020-09-07,San Luis Obispo,079,281455,3346,3116,20,3136,23
2020-09-07,San Mateo,081,765935,9221,8409,9,8418,125
2020-09-07,Santa Barbara,083,443738,8663,8479,72,8551,95
2020-09-07,Santa Clara,085,1922200,19994,18596,37,18633,226
2020-09-07,Santa Cruz,087,273765,2057,1902,18,1920,7
2020-09-07,Shasta,089,179085,666,556,3,559,10
2020-09-07,Sierra,091,2930,6,6,0,6,0
2020-09-07,Siskiyou,093,43540,146,133,9,142,0
2020-09-07,Solano,095,438530,5784,5640,41,5681,36
2020-09-07,Sonoma,097,501317,6592,6268,19,6287,85
2020-09-07,Stanislaus,099,539301,15822,15343,412,15755,236
2020-09-07,Sutter,101,95872,1531,1468,1,1469,11
2020-09-07,Tehama,103,63373,466,453,2,455,1
2020-09-07,Trinity,105,12862,51,13,7,20,0
2020-09-07,Tulare,107,460477,15315,14637,72,14709,249
2020-09-07,Tuolumne,109,53932,219,196,3,199,1
2020-09-07,Ventura,111,848112,12096,11463,115,11578,118
2020-09-07,Yolo,113,214977,2667,2565,5,2570,53
2020-09-07,Yuba,115,75493,975,923,3,926,1
2020-09-06,Alameda,001,1643700,19909,19029,141,19170,281
2020-09-06,Alpine,003,1148,2,2,0,2,0
2020-09-06,Amador,005,37829,276,275,0,275,16
2020-09-06,Butte,007,227075,2681,2446,21,2467,30
2020-09-06,Calaveras,009,45235,285,235,0,235,1
2020-09-06,Colusa,011,21464,492,475,0,475,6
2020-09-06,Contra Costa,013,1133247,15458,14565,66,14631,171
2020-09-06,Del Norte,015,27424,121,109,0,109,2
2020-09-06,El Dorado,017,186661,1059,1008,0,1008,2
2020-09-06,Fresno,019,978130,28951,26471,329,26800,329
2020-09-06,Glenn,021,27897,516,474,0,474,3
2020-09-06,Humboldt,023,135768,447,404,1,405,4
2020-09-06,Imperial,025,180216,11435,10152,17,10169,267
2020-09-06,Inyo,027,18085,184,169,4,173,2
2020-09-06,Kern,029,883053,30591,29699,262,29961,348
2020-09-06,Kings,031,150075,6969,6561,36,6597,72
2020-09-06,Lake,033,64148,401,362,0,362,2
2020-09-06,Lassen,035,31185,732,709,2,711,0
2020-09-06,Los Angeles,037,10098052,250607,248316,1476,249792,6004
2020-09-06,Madera,039,155013,4139,3867,29,3896,42
2020-09-06,Marin,041,260295,6389,6276,15,6291,67
2020-09-06,Mariposa,043,17540,74,72,0,72,2
2020-09-06,Mendocino,045,87422,711,672,0,672,16
2020-09-06,Merced,047,269075,8469,8327,15,8342,104
2020-09-06,Modoc,049,8938,23,20,0,20,0
2020-09-06,Mono,051,14174,164,145,2,147,1
2020-09-06,Monterey,053,433212,8804,8403,22,8425,56
2020-09-06,Napa,055,140530,1566,1501,6,1507,11
2020-09-06,Nevada,057,99092,486,467,14,481,6
2020-09-06,Orange,059,3164182,51658,48931,1300,50231,1042
2020-09-06,Placer,061,380077,3313,3169,13,3182,36
2020-09-06,Plumas,063,18699,44,42,0,42,0
2020-09-06,Riverside,065,2383286,55200,53970,81,54051,1069
2020-09-06,Sacramento,067,1510023,19897,19128,19,19147,340
2020-09-06,San Benito,069,59416,1229,1178,0,1178,4
2020-09-06,San Bernardino,071,2135413,50667,48923,323,49246,823
2020-09-06,San Diego,073,3302833,42374,40652,620,41272,707
2020-09-06,San Francisco,075,870044,10232,9813,22,9835,85
2020-09-06,San Joaquin,077,732212,19216,18558,40,18598,386
2020-09-06,San Luis Obispo,079,281455,3335,3101,20,3121,23
2020-09-06,San Mateo,081,765935,9168,8387,9,8396,125
2020-09-06,Santa Barbara,083,443738,8633,8434,72,8506,95
2020-09-06,Santa Clara,085,1922200,19893,18495,37,18532,207
2020-09-06,Santa Cruz,087,273765,2050,1902,18,1920,7
2020-09-06,Shasta,089,179085,660,550,3,553,10
2020-09-06,Sierra,091,2930,6,6,0,6,0
2020-09-06,Siskiyou,093,43540,146,132,9,141,0
2020-09-06,Solano,095,438530,5758,5619,41,5660,37
2020-09-06,Sonoma,097,501317,6563,6212,19,6231,85
2020-09-06,Stanislaus,099,539301,15778,15288,408,15696,236
2020-09-06,Sutter,101,95872,1518,1451,1,1452,11
2020-09-06,Tehama,103,63373,465,455,2,457,1
2020-09-06,Trinity,105,12862,50,13,7,20,0
2020-09-06,Tulare,107,460477,15272,14636,71,14707,249
2020-09-06,Tuolumne,109,53932,216,194,3,197,1
2020-09-06,Ventura,111,848112,12051,11315,115,11430,118
2020-09-06,Yolo,113,214977,2653,2556,5,2561,53
2020-09-06,Yuba,115,75493,966,913,3,916,1
2020-09-05,Alameda,001,1643700,19862,18973,139,19112,279
2020-09-05,Alpine,003,1148,2,2,0,2,0
2020-09-05,Amador,005,37829,276,274,0,274,16
2020-09-05,Butte,007,227075,2665,2406,20,2426,30
2020-09-05,Calaveras,009,45235,285,237,0,237,1
2020-09-05,Colusa,011,21464,488,472,0,472,6
2020-09-05,Contra Costa,013,1133247,15381,14456,64,14520,173
2020-09-05,Del Norte,015,27424,121,109,0,109,2
2020-09-05,El Dorado,017,186661,1059,1007,0,1007,2
2020-09-05,Fresno,019,978130,28883,26325,329,26654,331
2020-09-05,Glenn,021,27897,515,474,0,474,3
2020-09-05,Humboldt,023,135768,445,402,1,403,4
2020-09-05,Imperial,025,180216,11418,10151,17,10168,268
2020-09-05,Inyo,027,18085,184,169,4,173,2
2020-09-05,Kern,029,883053,30531,29645,258,29903,347
2020-09-05,Kings,031,150075,6960,6518,36,6554,66
2020-09-05,Lake,033,64148,398,359,0,359,2
2020-09-05,Lassen,035,31185,732,709,2,711,0
2020-09-05,Los Angeles,037,10098052,250072,247572,1464,249036,6001
2020-09-05,Madera,039,155013,4098,3851,29,3880,42
2020-09-05,Marin,041,260295,6382,6259,15,6274,66
2020-09-05,Mariposa,043,17540,74,72,0,72,2
2020-09-05,Mendocino,045,87422,710,658,0,658,16
2020-09-05,Merced,047,269075,8437,8297,13,8310,104
2020-09-05,Modoc,049,8938,23,19,0,19,0
2020-09-05,Mono,051,14174,164,145,2,147,1
2020-09-05,Monterey,053,433212,8774,8301,22,8323,56
2020-09-05,Napa,055,140530,1560,1484,6,1490,11
2020-09-05,Nevada,057,99092,483,461,14,475,6
2020-09-05,Orange,059,3164182,51556,48726,1295,50021,1039
2020-09-05,Placer,061,380077,3303,3141,13,3154,35
2020-09-05,Plumas,063,18699,44,42,0,42,0
2020-09-05,Riverside,065,2383286,55094,53780,81,53861,1066
2020-09-05,Sacramento,067,1510023,19806,18955,19,18974,339
2020-09-05,San Benito,069,59416,1227,1153,0,1153,4
2020-09-05,San Bernardino,071,2135413,50592,48800,322,49122,825
2020-09-05,San Diego,073,3302833,42181,40344,608,40952,717
2020-09-05,San Francisco,075,870044,10199,9812,21,9833,85
2020-09-05,San Joaquin,077,732212,19188,18557,40,18597,386
2020-09-05,San Luis Obispo,079,281455,3325,3083,20,3103,23
2020-09-05,San Mateo,081,765935,9123,8352,9,8361,124
2020-09-05,Santa Barbara,083,443738,8617,8404,72,8476,96
2020-09-05,Santa Clara,085,1922200,19809,18311,37,18348,207
2020-09-05,Santa Cruz,087,273765,2042,1904,18,1922,7
2020-09-05,Shasta,089,179085,659,544,3,547,10
2020-09-05,Sierra,091,2930,6,6,0,6,0
2020-09-05,Siskiyou,093,43540,145,131,9,140,0
2020-09-05,Solano,095,438530,5746,5579,41,5620,37
2020-09-05,Sonoma,097,501317,6530,6149,19,6168,85
2020-09-05,Stanislaus,099,539301,15730,15198,404,15602,236
2020-09-05,Sutter,101,95872,1511,1445,1,1446,11
2020-09-05,Tehama,103,63373,464,447,2,449,1
2020-09-05,Trinity,105,12862,50,13,7,20,0
2020-09-05,Tulare,107,460477,15215,14576,69,14645,249
2020-09-05,Tuolumne,109,53932,216,194,3,197,1
2020-09-05,Ventura,111,848112,12008,11254,115,11369,118
2020-09-05,Yolo,113,214977,2643,2534,5,2539,53
2020-09-05,Yuba,115,75493,960,902,3,905,1
2020-09-04,Alameda,001,1643700,19794,18843,137,18980,276
2020-09-04,Alpine,003,1148,2,2,0,2,0
2020-09-04,Amador,005,37829,275,274,0,274,16
2020-09-04,Butte,007,227075,2642,2325,20,2345,28
2020-09-04,Calaveras,009,45235,283,237,0,237,1
2020-09-04,Colusa,011,21464,486,467,0,467,6
2020-09-04,Contra Costa,013,1133247,15301,14355,63,14418,164
2020-09-04,Del Norte,015,27424,121,109,0,109,2
2020-09-04,El Dorado,017,186661,1055,992,0,992,2
2020-09-04,Fresno,019,978130,28778,26147,328,26475,321
2020-09-04,Glenn,021,27897,507,463,0,463,3
2020-09-04,Humboldt,023,135768,440,390,1,391,4
2020-09-04,Imperial,025,180216,11409,10136,16,10152,267
2020-09-04,Inyo,027,18085,184,169,4,173,2
2020-09-04,Kern,029,883053,30463,29526,255,29781,345
2020-09-04,Kings,031,150075,6947,6259,36,6295,66
2020-09-04,Lake,033,64148,398,347,0,347,2
2020-09-04,Lassen,035,31185,732,708,2,710,0
2020-09-04,Los Angeles,037,10098052,249506,246396,1444,247840,5977
2020-09-04,Madera,039,155013,4085,3838,29,3867,42
2020-09-04,Marin,041,260295,6370,6251,15,6266,66
2020-09-04,Mariposa,043,17540,74,72,0,72,2
2020-09-04,Mendocino,045,87422,708,646,0,646,16
2020-09-04,Merced,047,269075,8417,8214,13,8227,104
2020-09-04,Modoc,049,8938,23,15,0,15,0
2020-09-04,Mono,051,14174,164,145,2,147,1
2020-09-04,Monterey,053,433212,8729,8208,22,8230,56
2020-09-04,Napa,055,140530,1551,1475,6,1481,11
2020-09-04,Nevada,057,99092,480,455,14,469,6
2020-09-04,Orange,059,3164182,51432,48488,1288,49776,1031
2020-09-04,Placer,061,380077,3291,3101,13,3114,35
2020-09-04,Plumas,063,18699,44,42,0,42,0
2020-09-04,Riverside,065,2383286,54981,53606,76,53682,1066
2020-09-04,Sacramento,067,1510023,19718,18765,19,18784,337
2020-09-04,San Benito,069,59416,1218,1137,0,1137,4
2020-09-04,San Bernardino,071,2135413,50499,48497,320,48817,800
2020-09-04,San Diego,073,3302833,41951,39901,599,40500,701
2020-09-04,San Francisco,075,870044,10159,9694,20,9714,85
2020-09-04,San Joaquin,077,732212,19134,18438,40,18478,376
2020-09-04,San Luis Obispo,079,281455,3310,3049,19,3068,21
2020-09-04,San Mateo,081,765935,9079,8275,9,8284,122
2020-09-04,Santa Barbara,083,443738,8587,8340,72,8412,96
2020-09-04,Santa Clara,085,1922200,19701,18074,37,18111,209
2020-09-04,Santa Cruz,087,273765,2025,1896,17,1913,7
2020-09-04,Shasta,089,179085,656,536,3,539,10
2020-09-04,Sierra,091,2930,6,6,0,6,0
2020-09-04,Siskiyou,093,43540,145,129,9,138,0
2020-09-04,Solano,095,438530,5733,5552,41,5593,37
2020-09-04,Sonoma,097,501317,6465,6050,19,6069,85
2020-09-04,Stanislaus,099,539301,15696,15074,395,15469,233
2020-09-04,Sutter,101,95872,1495,1425,1,1426,11
2020-09-04,Tehama,103,63373,460,442,2,444,1
2020-09-04,Trinity,105,12862,50,13,7,20,0
2020-09-04,Tulare,107,460477,15187,14501,65,14566,247
2020-09-04,Tuolumne,109,53932,216,193,3,196,1
2020-09-04,Ventura,111,848112,11966,11171,115,11286,114
2020-09-04,Yolo,113,214977,2629,2495,5,2500,53
2020-09-04,Yuba,115,75493,955,884,3,887,1
2020-09-03,Alameda,001,1643700,19691,18687,137,18824,275
2020-09-03,Alpine,003,1148,2,2,0,2,0
2020-09-03,Amador,005,37829,275,274,0,274,16
2020-09-03,Butte,007,227075,2597,2274,20,2294,27
2020-09-03,Calaveras,009,45235,282,238,0,238,1
2020-09-03,Colusa,011,21464,484,464,0,464,6
2020-09-03,Contra Costa,013,1133247,15194,14206,60,14266,159
2020-09-03,Del Norte,015,27424,118,109,0,109,2
2020-09-03,El Dorado,017,186661,1051,983,0,983,2
2020-09-03,Fresno,019,978130,28659,25978,323,26301,313
2020-09-03,Glenn,021,27897,503,460,0,460,3
2020-09-03,Humboldt,023,135768,435,390,1,391,4
2020-09-03,Imperial,025,180216,11389,10083,14,10097,255
2020-09-03,Inyo,027,18085,182,171,4,175,3
2020-09-03,Kern,029,883053,30371,29426,241,29667,340
2020-09-03,Kings,031,150075,6867,6200,36,6236,64
2020-09-03,Lake,033,64148,389,347,0,347,2
2020-09-03,Lassen,035,31185,732,707,2,709,0
2020-09-03,Los Angeles,037,10098052,248647,245026,1423,246449,5931
2020-09-03,Madera,039,155013,4066,3780,29,3809,43
2020-09-03,Marin,041,260295,6351,6175,15,6190,66
2020-09-03,Mariposa,043,17540,74,71,0,71,2
2020-09-03,Mendocino,045,87422,699,638,0,638,16
2020-09-03,Merced,047,269075,8375,8136,13,8149,105
2020-09-03,Modoc,049,8938,23,14,0,14,0
2020-09-03,Mono,051,14174,163,144,2,146,1
2020-09-03,Monterey,053,433212,8675,8128,22,8150,56
2020-09-03,Napa,055,140530,1544,1466,6,1472,10
2020-09-03,Nevada,057,99092,477,453,14,467,6
2020-09-03,Orange,059,3164182,51245,48226,1273,49499,1009
2020-09-03,Placer,061,380077,3273,3069,13,3082,34
2020-09-03,Plumas,063,18699,44,39,0,39,0
2020-09-03,Riverside,065,2383286,54801,53341,72,53413,1052
2020-09-03,Sacramento,067,1510023,19590,18553,18,18571,328
2020-09-03,San Benito,069,59416,1207,1121,0,1121,4
2020-09-03,San Bernardino,071,2135413,50333,48165,319,48484,800
2020-09-03,San Diego,073,3302833,41637,39448,583,40031,700
2020-09-03,San Francisco,075,870044,10093,9636,18,9654,84
2020-09-03,San Joaquin,077,732212,19057,18331,40,18371,371
2020-09-03,San Luis Obispo,079,281455,3293,3023,19,3042,21
2020-09-03,San Mateo,081,765935,9005,8211,9,8220,122
2020-09-03,Santa Barbara,083,443738,8539,8277,72,8349,96
2020-09-03,Santa Clara,085,1922200,19521,17879,37,17916,208
2020-09-03,Santa Cruz,087,273765,2010,1870,17,1887,7
2020-09-03,Shasta,089,179085,651,535,3,538,10
2020-09-03,Sierra,091,2930,6,6,0,6,0
2020-09-03,Siskiyou,093,43540,145,128,9,137,0
2020-09-03,Solano,095,438530,5713,5499,40,5539,36
2020-09-03,Sonoma,097,501317,6403,5997,19,6016,62
2020-09-03,Stanislaus,099,539301,15644,14985,391,15376,217
2020-09-03,Sutter,101,95872,1485,1412,1,1413,11
2020-09-03,Tehama,103,63373,456,436,2,438,1
2020-09-03,Trinity,105,12862,48,13,7,20,0
2020-09-03,Tulare,107,460477,15121,14408,64,14472,244
2020-09-03,Tuolumne,109,53932,216,193,3,196,1
2020-09-03,Ventura,111,848112,11848,11109,112,11221,112
2020-09-03,Yolo,113,214977,2613,2475,5,2480,53
2020-09-03,Yuba,115,75493,948,867,3,870,1
2020-09-02,Alameda,001,1643700,19571,18522,134,18656,260
2020-09-02,Alpine,003,1148,2,2,0,2,0
2020-09-02,Amador,005,37829,275,245,0,245,14
2020-09-02,Butte,007,227075,2551,2241,20,2261,27
2020-09-02,Calaveras,009,45235,281,235,0,235,1
2020-09-02,Colusa,011,21464,480,460,0,460,6
2020-09-02,Contra Costa,013,1133247,15105,14097,58,14155,159
2020-09-02,Del Norte,015,27424,117,109,0,109,2
2020-09-02,El Dorado,017,186661,1047,975,0,975,2
2020-09-02,Fresno,019,978130,28511,25785,320,26105,292
2020-09-02,Glenn,021,27897,498,457,0,457,3
2020-09-02,Humboldt,023,135768,432,381,1,382,4
2020-09-02,Imperial,025,180216,11373,9832,14,9846,255
2020-09-02,Inyo,027,18085,182,171,4,175,3
2020-09-02,Kern,029,883053,30279,29288,235,29523,335
2020-09-02,Kings,031,150075,6782,6142,36,6178,64
2020-09-02,Lake,033,64148,385,342,0,342,2
2020-09-02,Lassen,035,31185,730,706,2,708,0
2020-09-02,Los Angeles,037,10098052,247717,243999,1395,245394,5887
2020-09-02,Madera,039,155013,4046,3735,29,3764,41
2020-09-02,Marin,041,260295,6336,6131,15,6146,66
2020-09-02,Mariposa,043,17540,74,71,0,71,2
2020-09-02,Mendocino,045,87422,689,636,0,636,15
2020-09-02,Merced,047,269075,8344,8097,12,8109,103
2020-09-02,Modoc,049,8938,22,11,0,11,0
2020-09-02,Mono,051,14174,163,145,2,147,1
2020-09-02,Monterey,053,433212,8611,8070,22,8092,56
2020-09-02,Napa,055,140530,1532,1454,6,1460,10
2020-09-02,Nevada,057,99092,471,452,13,465,6
2020-09-02,Orange,059,3164182,51064,47871,1263,49134,994
2020-09-02,Placer,061,380077,3248,3047,12,3059,33
2020-09-02,Plumas,063,18699,44,39,0,39,0
2020-09-02,Riverside,065,2383286,54599,52923,69,52992,1032
2020-09-02,Sacramento,067,1510023,19357,18355,17,18372,316
2020-09-02,San Benito,069,59416,1194,1107,0,1107,4
2020-09-02,San Bernardino,071,2135413,50170,47766,316,48082,794
2020-09-02,San Diego,073,3302833,41317,39123,569,39692,695
2020-09-02,San Francisco,075,870044,10024,9587,18,9605,84
2020-09-02,San Joaquin,077,732212,18976,18194,39,18233,352
2020-09-02,San Luis Obispo,079,281455,3267,3002,18,3020,21
2020-09-02,San Mateo,081,765935,8948,8148,9,8157,122
2020-09-02,Santa Barbara,083,443738,8484,8206,71,8277,94
2020-09-02,Santa Clara,085,1922200,19367,17673,37,17710,206
2020-09-02,Santa Cruz,087,273765,1987,1850,17,1867,7
2020-09-02,Shasta,089,179085,650,531,3,534,10
2020-09-02,Sierra,091,2930,6,6,0,6,0
2020-09-02,Siskiyou,093,43540,144,127,9,136,0
2020-09-02,Solano,095,438530,5685,5463,40,5503,36
2020-09-02,Sonoma,097,501317,6341,5846,19,5865,62
2020-09-02,Stanislaus,099,539301,15574,14854,384,15238,220
2020-09-02,Sutter,101,95872,1470,1401,1,1402,10
2020-09-02,Tehama,103,63373,453,429,2,431,1
2020-09-02,Trinity,105,12862,48,13,7,20,0
2020-09-02,Tulare,107,460477,15054,14298,63,14361,244
2020-09-02,Tuolumne,109,53932,216,190,3,193,1
2020-09-02,Ventura,111,848112,11761,11031,111,11142,111
2020-09-02,Yolo,113,214977,2592,2449,5,2454,54
2020-09-02,Yuba,115,75493,941,856,3,859,1
2020-09-01,Alameda,001,1643700,19432,18382,131,18513,248
2020-09-01,Alpine,003,1148,2,2,0,2,0
2020-09-01,Amador,005,37829,274,244,0,244,13
2020-09-01,Butte,007,227075,2494,2146,20,2166,26
2020-09-01,Calaveras,009,45235,273,228,0,228,1
2020-09-01,Colusa,011,21464,476,454,0,454,6
2020-09-01,Contra Costa,013,1133247,15011,13998,56,14054,158
2020-09-01,Del Norte,015,27424,116,108,0,108,2
2020-09-01,El Dorado,017,186661,1039,972,0,972,2
2020-09-01,Fresno,019,978130,28364,25542,317,25859,290
2020-09-01,Glenn,021,27897,491,449,0,449,3
2020-09-01,Humboldt,023,135768,426,378,1,379,4
2020-09-01,Imperial,025,180216,11347,9782,14,9796,250
2020-09-01,Inyo,027,18085,182,171,4,175,3
2020-09-01,Kern,029,883053,30188,29162,230,29392,332
2020-09-01,Kings,031,150075,6751,6088,36,6124,62
2020-09-01,Lake,033,64148,382,341,0,341,2
2020-09-01,Lassen,035,31185,727,706,2,708,0
2020-09-01,Los Angeles,037,10098052,246628,242633,1371,244004,5832
2020-09-01,Madera,039,155013,4017,3703,28,3731,41
2020-09-01,Marin,041,260295,6321,6102,15,6117,67
2020-09-01,Mariposa,043,17540,73,72,0,72,2
2020-09-01,Mendocino,045,87422,674,626,0,626,15
2020-09-01,Merced,047,269075,8291,8046,11,8057,103
2020-09-01,Modoc,049,8938,20,10,0,10,0
2020-09-01,Mono,051,14174,163,145,2,147,1
2020-09-01,Monterey,053,433212,8504,7926,22,7948,56
2020-09-01,Napa,055,140530,1517,1446,6,1452,10
2020-09-01,Nevada,057,99092,465,450,13,463,6
2020-09-01,Orange,059,3164182,50900,47671,1244,48915,976
2020-09-01,Placer,061,380077,3226,3013,12,3025,33
2020-09-01,Plumas,063,18699,44,39,0,39,0
2020-09-01,Riverside,065,2383286,54381,52785,68,52853,1027
2020-09-01,Sacramento,067,1510023,19173,18217,16,18233,305
2020-09-01,San Benito,069,59416,1182,1089,0,1089,4
2020-09-01,San Bernardino,071,2135413,49963,47371,315,47686,786
2020-09-01,San Diego,073,3302833,40959,38873,531,39404,688
2020-09-01,San Francisco,075,870044,9955,9492,18,9510,83
2020-09-01,San Joaquin,077,732212,18894,17915,38,17953,341
2020-09-01,San Luis Obispo,079,281455,3241,2970,18,2988,21
2020-09-01,San Mateo,081,765935,8868,8132,9,8141,122
2020-09-01,Santa Barbara,083,443738,8434,8142,70,8212,93
2020-09-01,Santa Clara,085,1922200,19188,17319,37,17356,204
2020-09-01,Santa Cruz,087,273765,1963,1752,17,1769,7
2020-09-01,Shasta,089,179085,642,527,3,530,9
2020-09-01,Sierra,091,2930,6,6,0,6,0
2020-09-01,Siskiyou,093,43540,141,128,8,136,0
2020-09-01,Solano,095,438530,5659,5438,40,5478,34
2020-09-01,Sonoma,097,501317,6251,5733,19,5752,60
2020-09-01,Stanislaus,099,539301,15498,14784,374,15158,212
2020-09-01,Sutter,101,95872,1459,1389,1,1390,10
2020-09-01,Tehama,103,63373,449,422,2,424,1
2020-09-01,Trinity,105,12862,47,13,6,19,0
2020-09-01,Tulare,107,460477,14971,14156,63,14219,241
2020-09-01,Tuolumne,109,53932,210,183,3,186,1
2020-09-01,Ventura,111,848112,11683,10899,106,11005,108
2020-09-01,Yolo,113,214977,2576,2440,5,2445,51
2020-09-01,Yuba,115,75493,932,841,3,844,1
2020-08-31,Alameda,001,1643700,19287,18148,131,18279,248
2020-08-31,Alpine,003,1148,2,2,0,2,0
2020-08-31,Amador,005,37829,274,243,0,243,13
2020-08-31,Butte,007,227075,2430,2069,20,2089,26
2020-08-31,Calaveras,009,45235,268,212,0,212,1
2020-08-31,Colusa,011,21464,475,443,0,443,6
2020-08-31,Contra Costa,013,1133247,14884,13902,53,13955,153
2020-08-31,Del Norte,015,27424,116,108,0,108,2
2020-08-31,El Dorado,017,186661,1032,965,0,965,2
2020-08-31,Fresno,019,978130,28143,25185,311,25496,290
2020-08-31,Glenn,021,27897,479,437,0,437,3
2020-08-31,Humboldt,023,135768,424,374,1,375,4
2020-08-31,Imperial,025,180216,11316,9759,14,9773,250
2020-08-31,Inyo,027,18085,181,160,4,164,3
2020-08-31,Kern,029,883053,30090,29067,229,29296,318
2020-08-31,Kings,031,150075,6483,6037,36,6073,62
2020-08-31,Lake,033,64148,366,341,0,341,2
2020-08-31,Lassen,035,31185,724,706,2,708,0
2020-08-31,Los Angeles,037,10098052,245526,241793,1343,243136,5787
2020-08-31,Madera,039,155013,3994,3662,27,3689,35
2020-08-31,Marin,041,260295,6285,6074,15,6089,67
2020-08-31,Mariposa,043,17540,73,69,0,69,2
2020-08-31,Mendocino,045,87422,662,618,0,618,15
2020-08-31,Merced,047,269075,8229,7991,11,8002,79
2020-08-31,Modoc,049,8938,18,10,0,10,0
2020-08-31,Mono,051,14174,163,145,2,147,1
2020-08-31,Monterey,053,433212,8397,7839,22,7861,56
2020-08-31,Napa,055,140530,1509,1434,6,1440,10
2020-08-31,Nevada,057,99092,463,447,13,460,6
2020-08-31,Orange,059,3164182,50700,47392,1216,48608,965
2020-08-31,Placer,061,380077,3177,2989,12,3001,33
2020-08-31,Plumas,063,18699,43,39,0,39,0
2020-08-31,Riverside,065,2383286,54159,52508,66,52574,1020
2020-08-31,Sacramento,067,1510023,18936,17999,16,18015,303
2020-08-31,San Benito,069,59416,1166,1080,0,1080,4
2020-08-31,San Bernardino,071,2135413,49752,47370,314,47684,755
2020-08-31,San Diego,073,3302833,40592,38606,498,39104,682
2020-08-31,San Francisco,075,870044,9876,9293,15,9308,83
2020-08-31,San Joaquin,077,732212,18807,17807,37,17844,338
2020-08-31,San Luis Obispo,079,281455,3218,2951,17,2968,21
2020-08-31,San Mateo,081,765935,8798,8065,9,8074,122
2020-08-31,Santa Barbara,083,443738,8388,8124,70,8194,94
2020-08-31,Santa Clara,085,1922200,18999,17211,37,17248,202
2020-08-31,Santa Cruz,087,273765,1938,1742,17,1759,7
2020-08-31,Shasta,089,179085,637,528,3,531,9
2020-08-31,Sierra,091,2930,6,6,0,6,0
2020-08-31,Siskiyou,093,43540,140,127,8,135,0
2020-08-31,Solano,095,438530,5627,5302,39,5341,34
2020-08-31,Sonoma,097,501317,6176,5650,19,5669,60
2020-08-31,Stanislaus,099,539301,15423,14685,365,15050,213
2020-08-31,Sutter,101,95872,1444,1365,1,1366,10
2020-08-31,Tehama,103,63373,446,421,2,423,1
2020-08-31,Trinity,105,12862,47,13,6,19,0
2020-08-31,Tulare,107,460477,14884,13985,61,14046,237
2020-08-31,Tuolumne,109,53932,210,178,3,181,1
2020-08-31,Ventura,111,848112,11595,10866,105,10971,108
2020-08-31,Yolo,113,214977,2558,2423,5,2428,51
2020-08-31,Yuba,115,75493,918,830,3,833,1
2020-08-30,Alameda,001,1643700,19163,18099,129,18228,248
2020-08-30,Alpine,003,1148,2,2,0,2,0
2020-08-30,Amador,005,37829,273,240,0,240,13
2020-08-30,Butte,007,227075,2349,1988,20,2008,26
2020-08-30,Calaveras,009,45235,259,211,0,211,1
2020-08-30,Colusa,011,21464,474,440,0,440,6
2020-08-30,Contra Costa,013,1133247,14746,13780,53,13833,150
2020-08-30,Del Norte,015,27424,115,108,0,108,2
2020-08-30,El Dorado,017,186661,1022,962,0,962,2
2020-08-30,Fresno,019,978130,28016,24963,310,25273,291
2020-08-30,Glenn,021,27897,472,437,0,437,3
2020-08-30,Humboldt,023,135768,413,362,1,363,4
2020-08-30,Imperial,025,180216,11297,9703,13,9716,250
2020-08-30,Inyo,027,18085,181,160,4,164,3
2020-08-30,Kern,029,883053,29997,28987,229,29216,317
2020-08-30,Kings,031,150075,6437,6000,36,6036,62
2020-08-30,Lake,033,64148,361,334,0,334,2
2020-08-30,Lassen,035,31185,722,706,2,708,0
2020-08-30,Los Angeles,037,10098052,244390,240775,1310,242085,5772
2020-08-30,Madera,039,155013,3965,3626,27,3653,33
2020-08-30,Marin,041,260295,6255,6060,15,6075,66
2020-08-30,Mariposa,043,17540,73,69,0,69,2
2020-08-30,Mendocino,045,87422,656,611,0,611,13
2020-08-30,Merced,047,269075,8154,7960,11,7971,79
2020-08-30,Modoc,049,8938,13,10,0,10,0
2020-08-30,Mono,051,14174,163,145,2,147,1
2020-08-30,Monterey,053,433212,8313,7816,22,7838,54
2020-08-30,Napa,055,140530,1497,1423,6,1429,10
2020-08-30,Nevada,057,99092,460,445,13,458,6
2020-08-30,Orange,059,3164182,50505,47283,1202,48485,965
2020-08-30,Placer,061,380077,3144,2961,12,2973,32
2020-08-30,Plumas,063,18699,42,39,0,39,0
2020-08-30,Riverside,065,2383286,53979,52227,64,52291,1017
2020-08-30,Sacramento,067,1510023,18758,17751,16,17767,300
2020-08-30,San Benito,069,59416,1156,1071,0,1071,4
2020-08-30,San Bernardino,071,2135413,49495,47201,314,47515,755
2020-08-30,San Diego,073,3302833,40194,38302,477,38779,682
2020-08-30,San Francisco,075,870044,9778,9294,12,9306,83
2020-08-30,San Joaquin,077,732212,18690,17637,36,17673,338
2020-08-30,San Luis Obispo,079,281455,3193,2934,17,2951,21
2020-08-30,San Mateo,081,765935,8721,8013,8,8021,122
2020-08-30,Santa Barbara,083,443738,8328,8088,70,8158,93
2020-08-30,Santa Clara,085,1922200,18823,17045,37,17082,202
2020-08-30,Santa Cruz,087,273765,1912,1743,17,1760,7
2020-08-30,Shasta,089,179085,634,525,3,528,9
2020-08-30,Sierra,091,2930,6,6,0,6,0
2020-08-30,Siskiyou,093,43540,138,125,8,133,0
2020-08-30,Solano,095,438530,5583,5303,39,5342,34
2020-08-30,Sonoma,097,501317,6118,5590,19,5609,60
2020-08-30,Stanislaus,099,539301,15352,14580,356,14936,209
2020-08-30,Sutter,101,95872,1422,1351,1,1352,10
2020-08-30,Tehama,103,63373,437,419,2,421,1
2020-08-30,Trinity,105,12862,47,13,6,19,0
2020-08-30,Tulare,107,460477,14789,13985,60,14045,236
2020-08-30,Tuolumne,109,53932,206,178,3,181,1
2020-08-30,Ventura,111,848112,11482,10775,100,10875,108
2020-08-30,Yolo,113,214977,2530,2391,4,2395,51
2020-08-30,Yuba,115,75493,904,832,3,835,1
2020-08-29,Alameda,001,1643700,19096,17888,129,18017,250
2020-08-29,Alpine,003,1148,2,2,0,2,0
2020-08-29,Amador,005,37829,273,239,0,239,13
2020-08-29,Butte,007,227075,2318,1948,20,1968,26
2020-08-29,Calaveras,009,45235,255,211,0,211,1
2020-08-29,Colusa,011,21464,471,440,0,440,6
2020-08-29,Contra Costa,013,1133247,14673,13663,52,13715,159
2020-08-29,Del Norte,015,27424,115,108,0,108,1
2020-08-29,El Dorado,017,186661,1019,958,0,958,2
2020-08-29,Fresno,019,978130,27961,24821,310,25131,291
2020-08-29,Glenn,021,27897,466,437,0,437,3
2020-08-29,Humboldt,023,135768,410,363,1,364,4
2020-08-29,Imperial,025,180216,11282,9698,13,9711,250
2020-08-29,Inyo,027,18085,181,160,4,164,3
2020-08-29,Kern,029,883053,29956,28947,228,29175,317
2020-08-29,Kings,031,150075,6422,5906,36,5942,62
2020-08-29,Lake,033,64148,360,329,0,329,2
2020-08-29,Lassen,035,31185,722,706,2,708,0
2020-08-29,Los Angeles,037,10098052,243760,239815,1297,241112,5762
2020-08-29,Madera,039,155013,3956,3605,26,3631,33
2020-08-29,Marin,041,260295,6243,6007,15,6022,64
2020-08-29,Mariposa,043,17540,73,69,0,69,2
2020-08-29,Mendocino,045,87422,651,596,0,596,13
2020-08-29,Merced,047,269075,8124,7867,11,7878,79
2020-08-29,Modoc,049,8938,13,9,0,9,0
2020-08-29,Mono,051,14174,163,145,2,147,1
2020-08-29,Monterey,053,433212,8268,7680,22,7702,53
2020-08-29,Napa,055,140530,1494,1413,6,1419,10
2020-08-29,Nevada,057,99092,460,442,13,455,5
2020-08-29,Orange,059,3164182,50395,47007,1192,48199,960
2020-08-29,Placer,061,380077,3127,2935,12,2947,32
2020-08-29,Plumas,063,18699,41,39,0,39,0
2020-08-29,Riverside,065,2383286,53867,51918,62,51980,1016
2020-08-29,Sacramento,067,1510023,18686,17588,16,17604,291
2020-08-29,San Benito,069,59416,1147,1045,0,1045,4
2020-08-29,San Bernardino,071,2135413,49380,46849,314,47163,755
2020-08-29,San Diego,073,3302833,39928,38049,459,38508,694
2020-08-29,San Francisco,075,870044,9750,9291,11,9302,83
2020-08-29,San Joaquin,077,732212,18646,17493,36,17529,335
2020-08-29,San Luis Obispo,079,281455,3168,2917,17,2934,21
2020-08-29,San Mateo,081,765935,8679,7928,8,7936,122
2020-08-29,Santa Barbara,083,443738,8302,8052,69,8121,93
2020-08-29,Santa Clara,085,1922200,18726,16898,36,16934,202
2020-08-29,Santa Cruz,087,273765,1900,1746,17,1763,7
2020-08-29,Shasta,089,179085,626,522,3,525,9
2020-08-29,Sierra,091,2930,6,6,0,6,0
2020-08-29,Siskiyou,093,43540,138,121,8,129,0
2020-08-29,Solano,095,438530,5562,5303,39,5342,34
2020-08-29,Sonoma,097,501317,6084,5537,19,5556,60
2020-08-29,Stanislaus,099,539301,15303,14479,346,14825,208
2020-08-29,Sutter,101,95872,1417,1333,1,1334,9
2020-08-29,Tehama,103,63373,436,417,2,419,1
2020-08-29,Trinity,105,12862,46,11,6,17,0
2020-08-29,Tulare,107,460477,14751,13890,59,13949,236
2020-08-29,Tuolumne,109,53932,206,178,3,181,1
2020-08-29,Ventura,111,848112,11440,10705,100,10805,108
2020-08-29,Yolo,113,214977,2512,2357,4,2361,51
2020-08-29,Yuba,115,75493,895,822,3,825,1
2020-08-28,Alameda,001,1643700,19013,17729,128,17857,237
2020-08-28,Alpine,003,1148,2,2,0,2,0
2020-08-28,Amador,005,37829,273,234,0,234,13
2020-08-28,Butte,007,227075,2288,1886,20,1906,25
2020-08-28,Calaveras,009,45235,253,207,0,207,1
2020-08-28,Colusa,011,21464,470,441,0,441,6
2020-08-28,Contra Costa,013,1133247,14602,13522,51,13573,158
2020-08-28,Del Norte,015,27424,115,107,0,107,1
2020-08-28,El Dorado,017,186661,1013,949,0,949,2
2020-08-28,Fresno,019,978130,27827,24612,310,24922,282
2020-08-28,Glenn,021,27897,459,429,0,429,3
2020-08-28,Humboldt,023,135768,406,362,1,363,4
2020-08-28,Imperial,025,180216,11268,9656,13,9669,241
2020-08-28,Inyo,027,18085,180,160,4,164,2
2020-08-28,Kern,029,883053,29908,28744,228,28972,306
2020-08-28,Kings,031,150075,6415,5829,35,5864,62
2020-08-28,Lake,033,64148,355,320,0,320,2
2020-08-28,Lassen,035,31185,722,704,2,706,0
2020-08-28,Los Angeles,037,10098052,242950,238544,1273,239817,5740
2020-08-28,Madera,039,155013,3937,3552,26,3578,33
2020-08-28,Marin,041,260295,6221,5991,15,6006,63
2020-08-28,Mariposa,043,17540,73,67,0,67,2
2020-08-28,Mendocino,045,87422,646,588,0,588,11
2020-08-28,Merced,047,269075,8094,7803,11,7814,77
2020-08-28,Modoc,049,8938,13,6,0,6,0
2020-08-28,Mono,051,14174,163,145,2,147,1
2020-08-28,Monterey,053,433212,8211,7591,22,7613,53
2020-08-28,Napa,055,140530,1486,1403,5,1408,10
2020-08-28,Nevada,057,99092,459,438,13,451,5
2020-08-28,Orange,059,3164182,50295,46696,1177,47873,942
2020-08-28,Placer,061,380077,3116,2891,12,2903,32
2020-08-28,Plumas,063,18699,41,39,0,39,0
2020-08-28,Riverside,065,2383286,53736,51510,59,51569,1008
2020-08-28,Sacramento,067,1510023,18589,17119,16,17135,283
2020-08-28,San Benito,069,59416,1131,1016,0,1016,3
2020-08-28,San Bernardino,071,2135413,49262,46553,310,46863,754
2020-08-28,San Diego,073,3302833,39698,37786,444,38230,676
2020-08-28,San Francisco,075,870044,9697,9135,11,9146,83
2020-08-28,San Joaquin,077,732212,18593,17114,35,17149,314
2020-08-28,San Luis Obispo,079,281455,3151,2849,17,2866,20
2020-08-28,San Mateo,081,765935,8632,7783,8,7791,121
2020-08-28,Santa Barbara,083,443738,8270,8001,69,8070,92
2020-08-28,Santa Clara,085,1922200,18595,16696,36,16732,201
2020-08-28,Santa Cruz,087,273765,1888,1747,17,1764,7
2020-08-28,Shasta,089,179085,622,516,3,519,9
2020-08-28,Sierra,091,2930,6,6,0,6,0
2020-08-28,Siskiyou,093,43540,136,119,8,127,0
2020-08-28,Solano,095,438530,5543,5219,39,5258,34
2020-08-28,Sonoma,097,501317,6048,5425,18,5443,58
2020-08-28,Stanislaus,099,539301,15261,14176,342,14518,190
2020-08-28,Sutter,101,95872,1407,1308,1,1309,9
2020-08-28,Tehama,103,63373,431,410,2,412,1
2020-08-28,Trinity,105,12862,46,11,6,17,0
2020-08-28,Tulare,107,460477,14705,13776,59,13835,236
2020-08-28,Tuolumne,109,53932,206,176,3,179,1
2020-08-28,Ventura,111,848112,11404,10606,98,10704,103
2020-08-28,Yolo,113,214977,2503,2323,4,2327,51
2020-08-28,Yuba,115,75493,886,810,3,813,1
2020-08-27,Alameda,001,1643700,18868,17584,125,17709,234
2020-08-27,Alpine,003,1148,2,2,0,2,0
2020-08-27,Amador,005,37829,272,233,0,233,13
2020-08-27,Butte,007,227075,2222,1803,19,1822,25
2020-08-27,Calaveras,009,45235,247,204,0,204,1
2020-08-27,Colusa,011,21464,468,438,0,438,6
2020-08-27,Contra Costa,013,1133247,14501,13379,50,13429,158
2020-08-27,Del Norte,015,27424,115,107,0,107,1
2020-08-27,El Dorado,017,186661,1009,942,0,942,2
2020-08-27,Fresno,019,978130,27644,24367,305,24672,272
2020-08-27,Glenn,021,27897,451,429,0,429,3
2020-08-27,Humboldt,023,135768,398,358,1,359,4
2020-08-27,Imperial,025,180216,11241,9608,13,9621,235
2020-08-27,Inyo,027,18085,180,157,3,160,2
2020-08-27,Kern,029,883053,29836,28635,219,28854,294
2020-08-27,Kings,031,150075,6393,5759,35,5794,62
2020-08-27,Lake,033,64148,353,314,0,314,2
2020-08-27,Lassen,035,31185,722,703,2,705,0
2020-08-27,Los Angeles,037,10098052,241950,237103,1257,238360,5704
2020-08-27,Madera,039,155013,3911,3465,26,3491,33
2020-08-27,Marin,041,260295,6197,5929,15,5944,62
2020-08-27,Mariposa,043,17540,73,67,0,67,2
2020-08-27,Mendocino,045,87422,637,581,0,581,10
2020-08-27,Merced,047,269075,8049,7765,11,7776,75
2020-08-27,Modoc,049,8938,11,5,0,5,0
2020-08-27,Mono,051,14174,163,145,2,147,1
2020-08-27,Monterey,053,433212,8117,7501,22,7523,52
2020-08-27,Napa,055,140530,1480,1397,5,1402,10
2020-08-27,Nevada,057,99092,456,435,13,448,5
2020-08-27,Orange,059,3164182,50138,46449,1166,47615,935
2020-08-27,Placer,061,380077,3085,2869,12,2881,32
2020-08-27,Plumas,063,18699,40,39,0,39,0
2020-08-27,Riverside,065,2383286,53528,51306,56,51362,999
2020-08-27,Sacramento,067,1510023,18391,16875,16,16891,281
2020-08-27,San Benito,069,59416,1115,987,0,987,3
2020-08-27,San Bernardino,071,2135413,49036,46345,303,46648,751
2020-08-27,San Diego,073,3302833,39427,37501,424,37925,673
2020-08-27,San Francisco,075,870044,9631,9014,11,9025,83
2020-08-27,San Joaquin,077,732212,18513,16989,35,17024,314
2020-08-27,San Luis Obispo,079,281455,3126,2808,17,2825,20
2020-08-27,San Mateo,081,765935,8523,7728,8,7736,121
2020-08-27,Santa Barbara,083,443738,8232,7934,69,8003,92
2020-08-27,Santa Clara,085,1922200,18412,16495,36,16531,199
2020-08-27,Santa Cruz,087,273765,1871,1734,17,1751,7
2020-08-27,Shasta,089,179085,616,512,3,515,9
2020-08-27,Sierra,091,2930,6,6,0,6,0
2020-08-27,Siskiyou,093,43540,136,118,8,126,0
2020-08-27,Solano,095,438530,5505,5167,39,5206,34
2020-08-27,Sonoma,097,501317,5936,5357,18,5375,58
2020-08-27,Stanislaus,099,539301,15180,14080,339,14419,186
2020-08-27,Sutter,101,95872,1387,1296,1,1297,9
2020-08-27,Tehama,103,63373,427,398,2,400,1
2020-08-27,Trinity,105,12862,46,11,6,17,0
2020-08-27,Tulare,107,460477,14613,13666,58,13724,231
2020-08-27,Tuolumne,109,53932,201,174,3,177,1
2020-08-27,Ventura,111,848112,11341,10483,94,10577,102
2020-08-27,Yolo,113,214977,2479,2293,4,2297,51
2020-08-27,Yuba,115,75493,875,807,3,810,1
2020-08-26,Alameda,001,1643700,18706,17373,125,17498,233
2020-08-26,Alpine,003,1148,2,2,0,2,0
2020-08-26,Amador,005,37829,272,229,0,229,13
2020-08-26,Butte,007,227075,2155,1765,17,1782,25
2020-08-26,Calaveras,009,45235,240,201,0,201,1
2020-08-26,Colusa,011,21464,462,433,0,433,5
2020-08-26,Contra Costa,013,1133247,14364,13248,50,13298,157
2020-08-26,Del Norte,015,27424,114,86,0,86,1
2020-08-26,El Dorado,017,186661,1007,938,0,938,2
2020-08-26,Fresno,019,978130,27496,24071,303,24374,255
2020-08-26,Glenn,021,27897,449,429,0,429,3
2020-08-26,Humboldt,023,135768,386,357,1,358,4
2020-08-26,Imperial,025,180216,11219,9453,13,9466,227
2020-08-26,Inyo,027,18085,177,157,3,160,2
2020-08-26,Kern,029,883053,29697,28507,216,28723,286
2020-08-26,Kings,031,150075,6372,5720,35,5755,62
2020-08-26,Lake,033,64148,348,308,0,308,2
2020-08-26,Lassen,035,31185,722,702,2,704,0
2020-08-26,Los Angeles,037,10098052,240940,235499,1225,236724,5665
2020-08-26,Madera,039,155013,3882,3458,26,3484,32
2020-08-26,Marin,041,260295,6180,5887,15,5902,56
2020-08-26,Mariposa,043,17540,73,68,0,68,2
2020-08-26,Mendocino,045,87422,626,581,0,581,10
2020-08-26,Merced,047,269075,8016,7720,11,7731,74
2020-08-26,Modoc,049,8938,8,5,0,5,0
2020-08-26,Mono,051,14174,163,141,2,143,1
2020-08-26,Monterey,053,433212,8024,7439,22,7461,51
2020-08-26,Napa,055,140530,1467,1382,5,1387,10
2020-08-26,Nevada,057,99092,453,432,13,445,2
2020-08-26,Orange,059,3164182,49954,46157,1151,47308,905
2020-08-26,Placer,061,380077,3063,2846,10,2856,32
2020-08-26,Plumas,063,18699,39,39,0,39,0
2020-08-26,Riverside,065,2383286,53286,51138,56,51194,987
2020-08-26,Sacramento,067,1510023,18228,16708,16,16724,271
2020-08-26,San Benito,069,59416,1100,978,0,978,3
2020-08-26,San Bernardino,071,2135413,48827,45840,299,46139,743
2020-08-26,San Diego,073,3302833,39089,37224,397,37621,668
2020-08-26,San Francisco,075,870044,9555,8938,11,8949,81
2020-08-26,San Joaquin,077,732212,18424,16845,34,16879,309
2020-08-26,San Luis Obispo,079,281455,3098,2761,17,2778,20
2020-08-26,San Mateo,081,765935,8456,7655,8,7663,121
2020-08-26,Santa Barbara,083,443738,8198,7904,69,7973,90
2020-08-26,Santa Clara,085,1922200,18235,16283,36,16319,198
2020-08-26,Santa Cruz,087,273765,1860,1726,17,1743,7
2020-08-26,Shasta,089,179085,611,511,3,514,9
2020-08-26,Sierra,091,2930,6,6,0,6,0
2020-08-26,Siskiyou,093,43540,133,109,8,117,0
2020-08-26,Solano,095,438530,5481,5131,38,5169,34
2020-08-26,Sonoma,097,501317,5862,5283,18,5301,58
2020-08-26,Stanislaus,099,539301,15103,13964,333,14297,186
2020-08-26,Sutter,101,95872,1369,1275,1,1276,9
2020-08-26,Tehama,103,63373,424,396,2,398,1
2020-08-26,Trinity,105,12862,45,10,6,16,0
2020-08-26,Tulare,107,460477,14546,13568,58,13626,232
2020-08-26,Tuolumne,109,53932,200,172,3,175,1
2020-08-26,Ventura,111,848112,11269,10412,87,10499,100
2020-08-26,Yolo,113,214977,2457,2279,4,2283,49
2020-08-26,Yuba,115,75493,860,779,3,782,1
2020-08-25,Alameda,001,1643700,18549,17278,125,17403,232
2020-08-25,Alpine,003,1148,2,2,0,2,0
2020-08-25,Amador,005,37829,272,227,0,227,13
2020-08-25,Butte,007,227075,2088,1718,17,1735,24
2020-08-25,Calaveras,009,45235,238,196,0,196,1
2020-08-25,Colusa,011,21464,455,430,0,430,5
2020-08-25,Contra Costa,013,1133247,14226,13181,49,13230,156
2020-08-25,Del Norte,015,27424,113,83,0,83,1
2020-08-25,El Dorado,017,186661,1004,928,0,928,2
2020-08-25,Fresno,019,978130,27307,23932,302,24234,250
2020-08-25,Glenn,021,27897,446,429,0,429,3
2020-08-25,Humboldt,023,135768,381,342,1,343,4
2020-08-25,Imperial,025,180216,11191,9381,13,9394,217
2020-08-25,Inyo,027,18085,175,144,3,147,1
2020-08-25,Kern,029,883053,29560,28416,216,28632,285
2020-08-25,Kings,031,150075,6215,5702,35,5737,59
2020-08-25,Lake,033,64148,343,304,0,304,2
2020-08-25,Lassen,035,31185,721,692,2,694,0
2020-08-25,Los Angeles,037,10098052,239646,233961,1175,235136,5612
2020-08-25,Madera,039,155013,3867,3446,25,3471,32
2020-08-25,Marin,041,260295,6142,5860,15,5875,56
2020-08-25,Mariposa,043,17540,73,67,0,67,2
2020-08-25,Mendocino,045,87422,618,571,0,571,10
2020-08-25,Merced,047,269075,7949,7693,10,7703,69
2020-08-25,Modoc,049,8938,8,5,0,5,0
2020-08-25,Mono,051,14174,163,129,2,131,1
2020-08-25,Monterey,053,433212,7944,7333,22,7355,51
2020-08-25,Napa,055,140530,1460,1374,5,1379,10
2020-08-25,Nevada,057,99092,449,430,13,443,2
2020-08-25,Orange,059,3164182,49760,45737,1135,46872,902
2020-08-25,Placer,061,380077,3044,2829,7,2836,31
2020-08-25,Plumas,063,18699,39,39,0,39,0
2020-08-25,Riverside,065,2383286,53055,50889,56,50945,981
2020-08-25,Sacramento,067,1510023,18075,16601,16,16617,265
2020-08-25,San Benito,069,59416,1084,973,0,973,3
2020-08-25,San Bernardino,071,2135413,48592,45544,296,45840,727
2020-08-25,San Diego,073,3302833,38810,36996,375,37371,665
2020-08-25,San Francisco,075,870044,9477,8848,11,8859,81
2020-08-25,San Joaquin,077,732212,18297,16795,34,16829,306
2020-08-25,San Luis Obispo,079,281455,3038,2731,16,2747,20
2020-08-25,San Mateo,081,765935,8396,7636,8,7644,120
2020-08-25,Santa Barbara,083,443738,8146,7854,69,7923,90
2020-08-25,Santa Clara,085,1922200,18062,16199,36,16235,194
2020-08-25,Santa Cruz,087,273765,1841,1708,17,1725,7
2020-08-25,Shasta,089,179085,607,511,3,514,9
2020-08-25,Sierra,091,2930,6,6,0,6,0
2020-08-25,Siskiyou,093,43540,132,109,8,117,0
2020-08-25,Solano,095,438530,5420,5114,38,5152,34
2020-08-25,Sonoma,097,501317,5777,5148,18,5166,56
2020-08-25,Stanislaus,099,539301,14995,13886,322,14208,182
2020-08-25,Sutter,101,95872,1352,1259,1,1260,9
2020-08-25,Tehama,103,63373,421,394,2,396,1
2020-08-25,Trinity,105,12862,44,10,6,16,0
2020-08-25,Tulare,107,460477,14443,13514,57,13571,224
2020-08-25,Tuolumne,109,53932,198,172,3,175,1
2020-08-25,Ventura,111,848112,11184,10313,82,10395,99
2020-08-25,Yolo,113,214977,2444,2254,4,2258,50
2020-08-25,Yuba,115,75493,850,775,3,778,1
2020-08-24,Alameda,001,1643700,18355,16913,124,17037,231
2020-08-24,Alpine,003,1148,2,2,0,2,0
2020-08-24,Amador,005,37829,270,227,0,227,13
2020-08-24,Butte,007,227075,2004,1649,17,1666,23
2020-08-24,Calaveras,009,45235,228,187,0,187,1
2020-08-24,Colusa,011,21464,451,425,0,425,5
2020-08-24,Contra Costa,013,1133247,14111,12906,47,12953,153
2020-08-24,Del Norte,015,27424,113,80,0,80,1
2020-08-24,El Dorado,017,186661,996,908,0,908,2
2020-08-24,Fresno,019,978130,27119,23618,295,23913,235
2020-08-24,Glenn,021,27897,444,421,0,421,2
2020-08-24,Humboldt,023,135768,377,340,1,341,4
2020-08-24,Imperial,025,180216,11157,9323,12,9335,210
2020-08-24,Inyo,027,18085,171,144,3,147,2
2020-08-24,Kern,029,883053,29463,28157,210,28367,277
2020-08-24,Kings,031,150075,6127,5652,35,5687,60
2020-08-24,Lake,033,64148,329,302,0,302,2
2020-08-24,Lassen,035,31185,721,693,2,695,0
2020-08-24,Los Angeles,037,10098052,238285,233036,1156,234192,5562
2020-08-24,Madera,039,155013,3840,3418,25,3443,32
2020-08-24,Marin,041,260295,6079,5834,15,5849,56
2020-08-24,Mariposa,043,17540,71,66,0,66,2
2020-08-24,Mendocino,045,87422,603,550,0,550,10
2020-08-24,Merced,047,269075,7871,7605,10,7615,69
2020-08-24,Modoc,049,8938,8,5,0,5,0
2020-08-24,Mono,051,14174,163,129,2,131,1
2020-08-24,Monterey,053,433212,7835,7212,21,7233,50
2020-08-24,Napa,055,140530,1447,1358,5,1363,10
2020-08-24,Nevada,057,99092,444,423,13,436,2
2020-08-24,Orange,059,3164182,49567,45536,1125,46661,887
2020-08-24,Placer,061,380077,2998,2793,7,2800,31
2020-08-24,Plumas,063,18699,39,37,0,37,0
2020-08-24,Riverside,065,2383286,52777,50496,56,50552,975
2020-08-24,Sacramento,067,1510023,17878,16318,16,16334,249
2020-08-24,San Benito,069,59416,1063,961,0,961,3
2020-08-24,San Bernardino,071,2135413,48329,45199,294,45493,720
2020-08-24,San Diego,073,3302833,38522,36729,347,37076,660
2020-08-24,San Francisco,075,870044,9394,8621,10,8631,81
2020-08-24,San Joaquin,077,732212,18156,16565,33,16598,305
2020-08-24,San Luis Obispo,079,281455,3010,2705,16,2721,20
2020-08-24,San Mateo,081,765935,8329,7502,8,7510,120
2020-08-24,Santa Barbara,083,443738,8105,7784,69,7853,90
2020-08-24,Santa Clara,085,1922200,17858,16049,36,16085,192
2020-08-24,Santa Cruz,087,273765,1821,1627,16,1643,6
2020-08-24,Shasta,089,179085,605,505,3,508,9
2020-08-24,Sierra,091,2930,6,6,0,6,0
2020-08-24,Siskiyou,093,43540,128,107,8,115,0
2020-08-24,Solano,095,438530,5371,4979,36,5015,32
2020-08-24,Sonoma,097,501317,5675,5071,18,5089,56
2020-08-24,Stanislaus,099,539301,14896,13521,308,13829,171
2020-08-24,Sutter,101,95872,1333,1219,1,1220,9
2020-08-24,Tehama,103,63373,416,388,2,390,1
2020-08-24,Trinity,105,12862,44,10,6,16,0
2020-08-24,Tulare,107,460477,14336,13360,56,13416,223
2020-08-24,Tuolumne,109,53932,197,170,3,173,1
2020-08-24,Ventura,111,848112,11104,10261,78,10339,99
2020-08-24,Yolo,113,214977,2410,2239,4,2243,47
2020-08-24,Yuba,115,75493,833,750,3,753,1
2020-08-23,Alameda,001,1643700,18132,16786,123,16909,231
2020-08-23,Alpine,003,1148,2,2,0,2,0
2020-08-23,Amador,005,37829,267,227,0,227,13
2020-08-23,Butte,007,227075,1890,1637,17,1654,23
2020-08-23,Calaveras,009,45235,218,187,0,187,1
2020-08-23,Colusa,011,21464,444,424,0,424,5
2020-08-23,Contra Costa,013,1133247,13951,12642,47,12689,153
2020-08-23,Del Norte,015,27424,113,80,0,80,1
2020-08-23,El Dorado,017,186661,983,901,0,901,2
2020-08-23,Fresno,019,978130,26915,23414,291,23705,235
2020-08-23,Glenn,021,27897,437,421,0,421,2
2020-08-23,Humboldt,023,135768,375,341,1,342,4
2020-08-23,Imperial,025,180216,11129,9243,12,9255,210
2020-08-23,Inyo,027,18085,168,144,3,147,2
2020-08-23,Kern,029,883053,29314,28028,205,28233,277
2020-08-23,Kings,031,150075,6084,5628,35,5663,60
2020-08-23,Lake,033,64148,325,299,0,299,2
2020-08-23,Lassen,035,31185,720,693,2,695,0
2020-08-23,Los Angeles,037,10098052,236692,231833,1086,232919,5549
2020-08-23,Madera,039,155013,3808,3401,24,3425,32
2020-08-23,Marin,041,260295,6040,5807,14,5821,50
2020-08-23,Mariposa,043,17540,71,66,0,66,2
2020-08-23,Mendocino,045,87422,599,550,0,550,10
2020-08-23,Merced,047,269075,7802,7574,9,7583,69
2020-08-23,Modoc,049,8938,7,5,0,5,0
2020-08-23,Mono,051,14174,163,129,2,131,1
2020-08-23,Monterey,053,433212,7745,7173,21,7194,50
2020-08-23,Napa,055,140530,1435,1348,5,1353,10
2020-08-23,Nevada,057,99092,439,421,13,434,2
2020-08-23,Orange,059,3164182,49330,45267,1114,46381,887
2020-08-23,Placer,061,380077,2959,2772,7,2779,31
2020-08-23,Plumas,063,18699,39,37,0,37,0
2020-08-23,Riverside,065,2383286,52507,50293,54,50347,955
2020-08-23,Sacramento,067,1510023,17654,16084,15,16099,243
2020-08-23,San Benito,069,59416,1050,938,0,938,3
2020-08-23,San Bernardino,071,2135413,48060,45010,284,45294,719
2020-08-23,San Diego,073,3302833,38201,36542,320,36862,660
2020-08-23,San Francisco,075,870044,9299,8564,9,8573,80
2020-08-23,San Joaquin,077,732212,18023,16069,32,16101,305
2020-08-23,San Luis Obispo,079,281455,2968,2679,16,2695,20
2020-08-23,San Mateo,081,765935,8234,7450,8,7458,120
2020-08-23,Santa Barbara,083,443738,8037,7725,69,7794,90
2020-08-23,Santa Clara,085,1922200,17663,15912,34,15946,191
2020-08-23,Santa Cruz,087,273765,1795,1627,16,1643,6
2020-08-23,Shasta,089,179085,600,501,3,504,9
2020-08-23,Sierra,091,2930,6,6,0,6,0
2020-08-23,Siskiyou,093,43540,123,107,8,115,0
2020-08-23,Solano,095,438530,5313,4977,34,5011,32
2020-08-23,Sonoma,097,501317,5587,5018,18,5036,56
2020-08-23,Stanislaus,099,539301,14761,13483,285,13768,171
2020-08-23,Sutter,101,95872,1311,1203,1,1204,9
2020-08-23,Tehama,103,63373,406,381,2,383,1
2020-08-23,Trinity,105,12862,44,10,6,16,0
2020-08-23,Tulare,107,460477,14204,13303,53,13356,223
2020-08-23,Tuolumne,109,53932,194,164,3,167,1
2020-08-23,Ventura,111,848112,11003,10126,74,10200,99
2020-08-23,Yolo,113,214977,2382,2210,4,2214,47
2020-08-23,Yuba,115,75493,812,750,3,753,1
2020-08-22,Alameda,001,1643700,18038,16648,122,16770,231
2020-08-22,Alpine,003,1148,2,2,0,2,0
2020-08-22,Amador,005,37829,266,224,0,224,13
2020-08-22,Butte,007,227075,1839,1618,17,1635,22
2020-08-22,Calaveras,009,45235,215,187,0,187,1
2020-08-22,Colusa,011,21464,440,419,0,419,5
2020-08-22,Contra Costa,013,1133247,13864,12522,47,12569,153
2020-08-22,Del Norte,015,27424,112,80,0,80,1
2020-08-22,El Dorado,017,186661,981,900,0,900,2
2020-08-22,Fresno,019,978130,26818,23197,290,23487,235
2020-08-22,Glenn,021,27897,436,421,0,421,2
2020-08-22,Humboldt,023,135768,365,334,1,335,4
2020-08-22,Imperial,025,180216,11121,9244,12,9256,210
2020-08-22,Inyo,027,18085,168,144,3,147,1
2020-08-22,Kern,029,883053,29260,27807,205,28012,277
2020-08-22,Kings,031,150075,6075,5447,35,5482,60
2020-08-22,Lake,033,64148,323,291,0,291,2
2020-08-22,Lassen,035,31185,720,693,2,695,0
2020-08-22,Los Angeles,037,10098052,236035,230858,1068,231926,5540
2020-08-22,Madera,039,155013,3789,3330,24,3354,32
2020-08-22,Marin,041,260295,6028,5789,14,5803,49
2020-08-22,Mariposa,043,17540,71,66,0,66,2
2020-08-22,Mendocino,045,87422,596,529,0,529,10
2020-08-22,Merced,047,269075,7774,7493,9,7502,69
2020-08-22,Modoc,049,8938,7,5,0,5,0
2020-08-22,Mono,051,14174,163,129,2,131,1
2020-08-22,Monterey,053,433212,7697,7081,21,7102,50
2020-08-22,Napa,055,140530,1430,1328,5,1333,11
2020-08-22,Nevada,057,99092,439,411,13,424,2
2020-08-22,Orange,059,3164182,49189,45131,1108,46239,885
2020-08-22,Placer,061,380077,2945,2734,7,2741,30
2020-08-22,Plumas,063,18699,39,37,0,37,0
2020-08-22,Riverside,065,2383286,52359,49944,53,49997,953
2020-08-22,Sacramento,067,1510023,17542,15516,15,15531,239
2020-08-22,San Benito,069,59416,1034,912,0,912,3
2020-08-22,San Bernardino,071,2135413,47931,44803,280,45083,719
2020-08-22,San Diego,073,3302833,38019,36205,309,36514,673
2020-08-22,San Francisco,075,870044,9239,8568,9,8577,80
2020-08-22,San Joaquin,077,732212,17967,16068,32,16100,305
2020-08-22,San Luis Obispo,079,281455,2942,2660,16,2676,20
2020-08-22,San Mateo,081,765935,8187,7361,8,7369,120
2020-08-22,Santa Barbara,083,443738,8011,7685,69,7754,90
2020-08-22,Santa Clara,085,1922200,17555,15590,34,15624,190
2020-08-22,Santa Cruz,087,273765,1779,1628,15,1643,6
2020-08-22,Shasta,089,179085,598,493,3,496,9
2020-08-22,Sierra,091,2930,6,6,0,6,0
2020-08-22,Siskiyou,093,43540,123,106,8,114,0
2020-08-22,Solano,095,438530,5283,4944,33,4977,32
2020-08-22,Sonoma,097,501317,5541,4891,18,4909,57
2020-08-22,Stanislaus,099,539301,14711,13380,268,13648,170
2020-08-22,Sutter,101,95872,1304,1189,1,1190,8
2020-08-22,Tehama,103,63373,405,368,2,370,1
2020-08-22,Trinity,105,12862,44,8,6,14,0
2020-08-22,Tulare,107,460477,14137,13196,53,13249,222
2020-08-22,Tuolumne,109,53932,192,162,3,165,1
2020-08-22,Ventura,111,848112,10948,9959,72,10031,99
2020-08-22,Yolo,113,214977,2366,2188,4,2192,47
2020-08-22,Yuba,115,75493,800,738,3,741,1
2020-08-21,Alameda,001,1643700,17946,16413,122,16535,232
2020-08-21,Alpine,003,1148,2,2,0,2,0
2020-08-21,Amador,005,37829,265,223,0,223,11
2020-08-21,Butte,007,227075,1800,1582,17,1599,19
2020-08-21,Calaveras,009,45235,215,182,0,182,1
2020-08-21,Colusa,011,21464,438,418,0,418,5
2020-08-21,Contra Costa,013,1133247,13775,12333,46,12379,149
2020-08-21,Del Norte,015,27424,112,78,0,78,1
2020-08-21,El Dorado,017,186661,977,885,0,885,2
2020-08-21,Fresno,019,978130,26648,22840,289,23129,232
2020-08-21,Glenn,021,27897,432,418,0,418,2
2020-08-21,Humboldt,023,135768,362,331,1,332,4
2020-08-21,Imperial,025,180216,11105,9166,11,9177,204
2020-08-21,Inyo,027,18085,168,144,3,147,1
2020-08-21,Kern,029,883053,29201,27567,203,27770,269
2020-08-21,Kings,031,150075,6053,5391,35,5426,60
2020-08-21,Lake,033,64148,321,281,0,281,2
2020-08-21,Lassen,035,31185,720,693,2,695,0
2020-08-21,Los Angeles,037,10098052,235162,229235,1048,230283,5494
2020-08-21,Madera,039,155013,3759,3271,24,3295,31
2020-08-21,Marin,041,260295,6008,5762,14,5776,49
2020-08-21,Mariposa,043,17540,71,66,0,66,2
2020-08-21,Mendocino,045,87422,586,505,0,505,10
2020-08-21,Merced,047,269075,7745,7357,9,7366,69
2020-08-21,Modoc,049,8938,7,5,0,5,0
2020-08-21,Mono,051,14174,163,128,2,130,1
2020-08-21,Monterey,053,433212,7625,6974,21,6995,49
2020-08-21,Napa,055,140530,1421,1317,5,1322,10
2020-08-21,Nevada,057,99092,438,406,13,419,2
2020-08-21,Orange,059,3164182,49048,44625,1099,45724,875
2020-08-21,Placer,061,380077,2929,2698,6,2704,30
2020-08-21,Plumas,063,18699,39,36,0,36,0
2020-08-21,Riverside,065,2383286,52164,49409,53,49462,932
2020-08-21,Sacramento,067,1510023,17419,15247,15,15262,237
2020-08-21,San Benito,069,59416,1024,891,0,891,3
2020-08-21,San Bernardino,071,2135413,47811,44249,276,44525,668
2020-08-21,San Diego,073,3302833,37815,35914,292,36206,652
2020-08-21,San Francisco,075,870044,9189,8375,9,8384,80
2020-08-21,San Joaquin,077,732212,17884,15888,30,15918,301
2020-08-21,San Luis Obispo,079,281455,2919,2640,16,2656,19
2020-08-21,San Mateo,081,765935,8129,7253,8,7261,120
2020-08-21,Santa Barbara,083,443738,7970,7645,69,7714,86
2020-08-21,Santa Clara,085,1922200,17403,15399,34,15433,190
2020-08-21,Santa Cruz,087,273765,1767,1617,15,1632,6
2020-08-21,Shasta,089,179085,598,486,3,489,9
2020-08-21,Sierra,091,2930,6,6,0,6,0
2020-08-21,Siskiyou,093,43540,123,103,6,109,0
2020-08-21,Solano,095,438530,5260,4891,32,4923,32
2020-08-21,Sonoma,097,501317,5471,4816,18,4834,57
2020-08-21,Stanislaus,099,539301,14642,13282,253,13535,161
2020-08-21,Sutter,101,95872,1291,1173,1,1174,8
2020-08-21,Tehama,103,63373,403,357,2,359,1
2020-08-21,Trinity,105,12862,44,8,6,14,0
2020-08-21,Tulare,107,460477,14065,13002,52,13054,217
2020-08-21,Tuolumne,109,53932,184,161,3,164,1
2020-08-21,Ventura,111,848112,10883,9865,70,9935,98
2020-08-21,Yolo,113,214977,2350,2164,4,2168,46
2020-08-21,Yuba,115,75493,796,717,3,720,1
2020-08-20,Alameda,001,1643700,17787,16174,122,16296,229
2020-08-20,Alpine,003,1148,2,2,0,2,0
2020-08-20,Amador,005,37829,263,222,0,222,11
2020-08-20,Butte,007,227075,1749,1549,17,1566,18
2020-08-20,Calaveras,009,45235,212,179,0,179,1
2020-08-20,Colusa,011,21464,436,415,0,415,5
2020-08-20,Contra Costa,013,1133247,13647,12108,45,12153,144
2020-08-20,Del Norte,015,27424,112,78,0,78,1
2020-08-20,El Dorado,017,186661,973,881,0,881,2
2020-08-20,Fresno,019,978130,26466,22535,284,22819,228
2020-08-20,Glenn,021,27897,427,414,0,414,2
2020-08-20,Humboldt,023,135768,357,318,1,319,4
2020-08-20,Imperial,025,180216,11086,9086,11,9097,196
2020-08-20,Inyo,027,18085,167,144,3,147,1
2020-08-20,Kern,029,883053,29033,27337,192,27529,267
2020-08-20,Kings,031,150075,6013,5347,34,5381,59
2020-08-20,Lake,033,64148,316,280,0,280,2
2020-08-20,Lassen,035,31185,719,693,2,695,0
2020-08-20,Los Angeles,037,10098052,233939,227492,1029,228521,5445
2020-08-20,Madera,039,155013,3733,3197,24,3221,31
2020-08-20,Marin,041,260295,5990,5745,14,5759,47
2020-08-20,Mariposa,043,17540,71,67,0,67,2
2020-08-20,Mendocino,045,87422,575,497,0,497,10
2020-08-20,Merced,047,269075,7670,7173,9,7182,68
2020-08-20,Modoc,049,8938,7,5,0,5,0
2020-08-20,Mono,051,14174,163,128,2,130,1
2020-08-20,Monterey,053,433212,7554,6892,21,6913,47
2020-08-20,Napa,055,140530,1413,1306,5,1311,10
2020-08-20,Nevada,057,99092,437,401,13,414,2
2020-08-20,Orange,059,3164182,48821,44299,1088,45387,849
2020-08-20,Placer,061,380077,2913,2681,6,2687,30
2020-08-20,Plumas,063,18699,39,36,0,36,0
2020-08-20,Riverside,065,2383286,51945,48953,52,49005,927
2020-08-20,Sacramento,067,1510023,17177,14992,15,15007,231
2020-08-20,San Benito,069,59416,1011,866,0,866,3
2020-08-20,San Bernardino,071,2135413,47555,43627,272,43899,665
2020-08-20,San Diego,073,3302833,37595,35610,274,35884,644
2020-08-20,San Francisco,075,870044,9103,8262,9,8271,72
2020-08-20,San Joaquin,077,732212,17791,15778,30,15808,297
2020-08-20,San Luis Obispo,079,281455,2899,2590,16,2606,19
2020-08-20,San Mateo,081,765935,8063,7188,8,7196,120
2020-08-20,Santa Barbara,083,443738,7932,7571,69,7640,81
2020-08-20,Santa Clara,085,1922200,17231,15162,34,15196,190
2020-08-20,Santa Cruz,087,273765,1754,1581,15,1596,6
2020-08-20,Shasta,089,179085,597,478,3,481,9
2020-08-20,Sierra,091,2930,6,6,0,6,0
2020-08-20,Siskiyou,093,43540,122,102,1,103,0
2020-08-20,Solano,095,438530,5216,4843,32,4875,31
2020-08-20,Sonoma,097,501317,5399,4737,18,4755,54
2020-08-20,Stanislaus,099,539301,14546,13120,244,13364,161
2020-08-20,Sutter,101,95872,1267,1158,1,1159,8
2020-08-20,Tehama,103,63373,397,350,2,352,1
2020-08-20,Trinity,105,12862,44,8,6,14,0
2020-08-20,Tulare,107,460477,13957,12907,51,12958,217
2020-08-20,Tuolumne,109,53932,180,159,3,162,1
2020-08-20,Ventura,111,848112,10770,9744,69,9813,93
2020-08-20,Yolo,113,214977,2328,2150,4,2154,47
2020-08-20,Yuba,115,75493,779,709,3,712,1
2020-08-19,Alameda,001,1643700,17628,15874,121,15995,226
2020-08-19,Alpine,003,1148,2,2,0,2,0
2020-08-19,Amador,005,37829,262,219,0,219,9
2020-08-19,Butte,007,227075,1706,1517,17,1534,16
2020-08-19,Calaveras,009,45235,209,177,0,177,1
2020-08-19,Colusa,011,21464,435,415,0,415,5
2020-08-19,Contra Costa,013,1133247,13535,11895,43,11938,142
2020-08-19,Del Norte,015,27424,112,78,0,78,1
2020-08-19,El Dorado,017,186661,967,870,0,870,2
2020-08-19,Fresno,019,978130,26277,22167,275,22442,221
2020-08-19,Glenn,021,27897,425,414,0,414,2
2020-08-19,Humboldt,023,135768,354,316,1,317,4
2020-08-19,Imperial,025,180216,11058,9041,10,9051,192
2020-08-19,Inyo,027,18085,165,140,3,143,1
2020-08-19,Kern,029,883053,28916,27142,188,27330,263
2020-08-19,Kings,031,150075,5840,5301,32,5333,59
2020-08-19,Lake,033,64148,313,277,0,277,2
2020-08-19,Lassen,035,31185,711,693,2,695,0
2020-08-19,Los Angeles,037,10098052,232667,226006,989,226995,5399
2020-08-19,Madera,039,155013,3699,3158,22,3180,30
2020-08-19,Marin,041,260295,5966,5723,13,5736,46
2020-08-19,Mariposa,043,17540,71,64,0,64,2
2020-08-19,Mendocino,045,87422,559,495,0,495,8
2020-08-19,Merced,047,269075,7543,7082,6,7088,66
2020-08-19,Modoc,049,8938,7,5,0,5,0
2020-08-19,Mono,051,14174,163,128,2,130,1
2020-08-19,Monterey,053,433212,7452,6693,21,6714,45
2020-08-19,Napa,055,140530,1408,1293,5,1298,10
2020-08-19,Nevada,057,99092,430,398,13,411,2
2020-08-19,Orange,059,3164182,48616,43938,1085,45023,829
2020-08-19,Placer,061,380077,2891,2659,6,2665,28
2020-08-19,Plumas,063,18699,39,36,0,36,0
2020-08-19,Riverside,065,2383286,51696,48741,52,48793,922
2020-08-19,Sacramento,067,1510023,16996,14764,15,14779,229
2020-08-19,San Benito,069,59416,994,853,0,853,3
2020-08-19,San Bernardino,071,2135413,47256,43224,266,43490,661
2020-08-19,San Diego,073,3302833,37346,35378,259,35637,638
2020-08-19,San Francisco,075,870044,9038,8236,9,8245,72
2020-08-19,San Joaquin,077,732212,17665,15677,29,15706,296
2020-08-19,San Luis Obispo,079,281455,2859,2553,16,2569,19
2020-08-19,San Mateo,081,765935,7995,7146,8,7154,119
2020-08-19,Santa Barbara,083,443738,7883,7499,69,7568,80
2020-08-19,Santa Clara,085,1922200,17085,14994,34,15028,189
2020-08-19,Santa Cruz,087,273765,1728,1554,15,1569,6
2020-08-19,Shasta,089,179085,593,475,3,478,9
2020-08-19,Sierra,091,2930,6,6,0,6,0
2020-08-19,Siskiyou,093,43540,121,103,1,104,0
2020-08-19,Solano,095,438530,5175,4807,32,4839,31
2020-08-19,Sonoma,097,501317,5320,4614,18,4632,54
2020-08-19,Stanislaus,099,539301,14443,13084,222,13306,160
2020-08-19,Sutter,101,95872,1233,1146,1,1147,8
2020-08-19,Tehama,103,63373,391,342,2,344,1
2020-08-19,Trinity,105,12862,43,8,6,14,0
2020-08-19,Tulare,107,460477,13859,12756,51,12807,217
2020-08-19,Tuolumne,109,53932,177,159,3,162,1
2020-08-19,Ventura,111,848112,10678,9587,67,9654,91
2020-08-19,Yolo,113,214977,2305,2126,4,2130,47
2020-08-19,Yuba,115,75493,767,701,3,704,1
2020-08-18,Alameda,001,1643700,17451,15627,119,15746,223
2020-08-18,Alpine,003,1148,2,2,0,2,0
2020-08-18,Amador,005,37829,261,215,0,215,9
2020-08-18,Butte,007,227075,1673,1491,17,1508,16
2020-08-18,Calaveras,009,45235,205,174,0,174,1
2020-08-18,Colusa,011,21464,434,415,0,415,5
2020-08-18,Contra Costa,013,1133247,13415,11689,41,11730,141
2020-08-18,Del Norte,015,27424,111,78,0,78,0
2020-08-18,El Dorado,017,186661,962,866,0,866,2
2020-08-18,Fresno,019,978130,26056,21798,269,22067,212
2020-08-18,Glenn,021,27897,425,407,0,407,2
2020-08-18,Humboldt,023,135768,352,315,1,316,4
2020-08-18,Imperial,025,180216,11024,8968,10,8978,189
2020-08-18,Inyo,027,18085,164,140,3,143,1
2020-08-18,Kern,029,883053,28763,26978,184,27162,263
2020-08-18,Kings,031,150075,5805,5269,31,5300,58
2020-08-18,Lake,033,64148,310,274,0,274,2
2020-08-18,Lassen,035,31185,711,693,2,695,0
2020-08-18,Los Angeles,037,10098052,231407,224218,952,225170,5339
2020-08-18,Madera,039,155013,3671,3125,22,3147,28
2020-08-18,Marin,041,260295,5936,5708,13,5721,47
2020-08-18,Mariposa,043,17540,71,61,0,61,2
2020-08-18,Mendocino,045,87422,550,468,0,468,8
2020-08-18,Merced,047,269075,7495,6940,6,6946,66
2020-08-18,Modoc,049,8938,7,5,0,5,0
2020-08-18,Mono,051,14174,162,129,2,131,1
2020-08-18,Monterey,053,433212,7360,6691,20,6711,44
2020-08-18,Napa,055,140530,1405,1274,5,1279,10
2020-08-18,Nevada,057,99092,423,389,13,402,2
2020-08-18,Orange,059,3164182,48391,43659,1070,44729,809
2020-08-18,Placer,061,380077,2865,2644,5,2649,28
2020-08-18,Plumas,063,18699,39,34,0,34,0
2020-08-18,Riverside,065,2383286,51365,48447,52,48499,917
2020-08-18,Sacramento,067,1510023,16767,14610,14,14624,222
2020-08-18,San Benito,069,59416,974,836,0,836,3
2020-08-18,San Bernardino,071,2135413,46974,42827,260,43087,648
2020-08-18,San Diego,073,3302833,37053,35164,227,35391,633
2020-08-18,San Francisco,075,870044,8952,8016,9,8025,72
2020-08-18,San Joaquin,077,732212,17549,15509,28,15537,290
2020-08-18,San Luis Obispo,079,281455,2834,2535,15,2550,18
2020-08-18,San Mateo,081,765935,7933,7074,8,7082,119
2020-08-18,Santa Barbara,083,443738,7841,7472,69,7541,81
2020-08-18,Santa Clara,085,1922200,16912,14786,33,14819,184
2020-08-18,Santa Cruz,087,273765,1715,1509,15,1524,6
2020-08-18,Shasta,089,179085,589,468,3,471,9
2020-08-18,Sierra,091,2930,6,6,0,6,0
2020-08-18,Siskiyou,093,43540,120,103,1,104,0
2020-08-18,Solano,095,438530,5148,4700,32,4732,31
2020-08-18,Sonoma,097,501317,5251,4506,18,4524,48
2020-08-18,Stanislaus,099,539301,14345,12935,206,13141,149
2020-08-18,Sutter,101,95872,1214,1126,1,1127,8
2020-08-18,Tehama,103,63373,381,333,2,335,1
2020-08-18,Trinity,105,12862,41,8,6,14,0
2020-08-18,Tulare,107,460477,13728,12637,48,12685,212
2020-08-18,Tuolumne,109,53932,174,159,3,162,1
2020-08-18,Ventura,111,848112,10588,9536,62,9598,89
2020-08-18,Yolo,113,214977,2282,2102,4,2106,47
2020-08-18,Yuba,115,75493,759,679,3,682,1
2020-08-17,Alameda,001,1643700,17257,15454,118,15572,221
2020-08-17,Alpine,003,1148,2,2,0,2,0
2020-08-17,Amador,005,37829,261,215,0,215,9
2020-08-17,Butte,007,227075,1628,1463,17,1480,15
2020-08-17,Calaveras,009,45235,201,167,0,167,1
2020-08-17,Colusa,011,21464,431,408,0,408,5
2020-08-17,Contra Costa,013,1133247,13278,11442,41,11483,141
2020-08-17,Del Norte,015,27424,107,77,0,77,0
2020-08-17,El Dorado,017,186661,959,846,0,846,2
2020-08-17,Fresno,019,978130,25848,21316,262,21578,211
2020-08-17,Glenn,021,27897,424,402,0,402,2
2020-08-17,Humboldt,023,135768,348,302,1,303,4
2020-08-17,Imperial,025,180216,10983,8897,10,8907,188
2020-08-17,Inyo,027,18085,156,124,3,127,1
2020-08-17,Kern,029,883053,28616,26773,173,26946,249
2020-08-17,Kings,031,150075,5767,5249,31,5280,58
2020-08-17,Lake,033,64148,305,270,0,270,2
2020-08-17,Lassen,035,31185,711,666,2,668,0
2020-08-17,Los Angeles,037,10098052,229895,223418,904,224322,5282
2020-08-17,Madera,039,155013,3628,3050,21,3071,26
2020-08-17,Marin,041,260295,5913,5683,12,5695,46
2020-08-17,Mariposa,043,17540,71,61,0,61,2
2020-08-17,Mendocino,045,87422,532,454,0,454,8
2020-08-17,Merced,047,269075,7400,6814,6,6820,66
2020-08-17,Modoc,049,8938,7,5,0,5,0
2020-08-17,Mono,051,14174,162,126,2,128,1
2020-08-17,Monterey,053,433212,7260,6553,20,6573,44
2020-08-17,Napa,055,140530,1384,1255,5,1260,10
2020-08-17,Nevada,057,99092,418,383,13,396,2
2020-08-17,Orange,059,3164182,48181,43621,1057,44678,804
2020-08-17,Placer,061,380077,2840,2609,5,2614,28
2020-08-17,Plumas,063,18699,39,33,0,33,0
2020-08-17,Riverside,065,2383286,51033,48062,50,48112,916
2020-08-17,Sacramento,067,1510023,16547,14333,14,14347,219
2020-08-17,San Benito,069,59416,959,822,0,822,2
2020-08-17,San Bernardino,071,2135413,46629,42005,252,42257,604
2020-08-17,San Diego,073,3302833,36787,34962,213,35175,626
2020-08-17,San Francisco,075,870044,8881,7600,9,7609,72
2020-08-17,San Joaquin,077,732212,17386,15323,27,15350,280
2020-08-17,San Luis Obispo,079,281455,2801,2527,15,2542,18
2020-08-17,San Mateo,081,765935,7876,6987,7,6994,118
2020-08-17,Santa Barbara,083,443738,7799,7438,69,7507,80
2020-08-17,Santa Clara,085,1922200,16691,14546,33,14579,183
2020-08-17,Santa Cruz,087,273765,1699,1453,14,1467,6
2020-08-17,Shasta,089,179085,583,467,3,470,9
2020-08-17,Sierra,091,2930,6,6,0,6,0
2020-08-17,Siskiyou,093,43540,119,103,0,103,0
2020-08-17,Solano,095,438530,5091,4479,32,4511,31
2020-08-17,Sonoma,097,501317,5162,4402,16,4418,48
2020-08-17,Stanislaus,099,539301,14220,12745,199,12944,148
2020-08-17,Sutter,101,95872,1198,1071,1,1072,8
2020-08-17,Tehama,103,63373,372,324,2,326,1
2020-08-17,Trinity,105,12862,41,8,6,14,0
2020-08-17,Tulare,107,460477,13615,12487,47,12534,210
2020-08-17,Tuolumne,109,53932,171,157,3,160,1
2020-08-17,Ventura,111,848112,10465,9490,57,9547,89
2020-08-17,Yolo,113,214977,2255,2083,4,2087,47
2020-08-17,Yuba,115,75493,744,647,3,650,1
2020-08-16,Alameda,001,1643700,16966,15338,118,15456,221
2020-08-16,Alpine,003,1148,2,2,0,2,0
2020-08-16,Amador,005,37829,258,215,0,215,9
2020-08-16,Butte,007,227075,1590,1432,17,1449,15
2020-08-16,Calaveras,009,45235,194,167,0,167,1
2020-08-16,Colusa,011,21464,429,407,0,407,5
2020-08-16,Contra Costa,013,1133247,13092,11255,41,11296,140
2020-08-16,Del Norte,015,27424,103,77,0,77,0
2020-08-16,El Dorado,017,186661,947,843,0,843,2
2020-08-16,Fresno,019,978130,25627,21010,257,21267,211
2020-08-16,Glenn,021,27897,422,400,0,400,2
2020-08-16,Humboldt,023,135768,346,301,1,302,4
2020-08-16,Imperial,025,180216,10939,8883,10,8893,188
2020-08-16,Inyo,027,18085,149,125,2,127,1
2020-08-16,Kern,029,883053,28415,26520,165,26685,249
2020-08-16,Kings,031,150075,5736,5146,31,5177,58
2020-08-16,Lake,033,64148,301,269,0,269,2
2020-08-16,Lassen,035,31185,711,666,2,668,0
2020-08-16,Los Angeles,037,10098052,228330,222236,874,223110,5263
2020-08-16,Madera,039,155013,3583,3013,21,3034,26
2020-08-16,Marin,041,260295,5887,5664,12,5676,46
2020-08-16,Mariposa,043,17540,71,61,0,61,2
2020-08-16,Mendocino,045,87422,524,451,0,451,8
2020-08-16,Merced,047,269075,7318,6744,6,6750,66
2020-08-16,Modoc,049,8938,7,5,0,5,0
2020-08-16,Mono,051,14174,162,126,2,128,1
2020-08-16,Monterey,053,433212,7162,6516,19,6535,44
2020-08-16,Napa,055,140530,1366,1241,3,1244,10
2020-08-16,Nevada,057,99092,409,379,13,392,2
2020-08-16,Orange,059,3164182,47932,43303,1046,44349,803
2020-08-16,Placer,061,380077,2811,2583,4,2587,28
2020-08-16,Plumas,063,18699,39,33,0,33,0
2020-08-16,Riverside,065,2383286,50702,47669,49,47718,910
2020-08-16,Sacramento,067,1510023,16307,14210,14,14224,219
2020-08-16,San Benito,069,59416,930,815,0,815,2
2020-08-16,San Bernardino,071,2135413,46205,41724,244,41968,603
2020-08-16,San Diego,073,3302833,36523,34680,198,34878,626
2020-08-16,San Francisco,075,870044,8793,7602,9,7611,72
2020-08-16,San Joaquin,077,732212,17183,15288,27,15315,280
2020-08-16,San Luis Obispo,079,281455,2772,2494,15,2509,17
2020-08-16,San Mateo,081,765935,7801,6942,7,6949,118
2020-08-16,Santa Barbara,083,443738,7750,7368,69,7437,79
2020-08-16,Santa Clara,085,1922200,16493,14329,33,14362,183
2020-08-16,Santa Cruz,087,273765,1672,1449,13,1462,6
2020-08-16,Shasta,089,179085,576,465,3,468,9
2020-08-16,Sierra,091,2930,6,6,0,6,0
2020-08-16,Siskiyou,093,43540,118,102,0,102,0
2020-08-16,Solano,095,438530,5031,4479,32,4511,31
2020-08-16,Sonoma,097,501317,5058,4329,16,4345,46
2020-08-16,Stanislaus,099,539301,14062,12668,189,12857,148
2020-08-16,Sutter,101,95872,1180,1071,1,1072,8
2020-08-16,Tehama,103,63373,362,318,2,320,1
2020-08-16,Trinity,105,12862,38,8,6,14,0
2020-08-16,Tulare,107,460477,13483,12334,44,12378,211
2020-08-16,Tuolumne,109,53932,171,156,3,159,1
2020-08-16,Ventura,111,848112,10356,9408,52,9460,89
2020-08-16,Yolo,113,214977,2236,2057,4,2061,47
2020-08-16,Yuba,115,75493,735,647,2,649,1
2020-08-15,Alameda,001,1643700,16889,15165,118,15283,221
2020-08-15,Alpine,003,1148,2,2,0,2,0
2020-08-15,Amador,005,37829,258,210,0,210,9
2020-08-15,Butte,007,227075,1568,1409,17,1426,15
2020-08-15,Calaveras,009,45235,192,167,0,167,1
2020-08-15,Colusa,011,21464,428,401,0,401,5
2020-08-15,Contra Costa,013,1133247,12996,11106,41,11147,138
2020-08-15,Del Norte,015,27424,103,77,0,77,0
2020-08-15,El Dorado,017,186661,942,838,0,838,2
2020-08-15,Fresno,019,978130,25511,20603,255,20858,211
2020-08-15,Glenn,021,27897,422,398,0,398,2
2020-08-15,Humboldt,023,135768,345,301,1,302,4
2020-08-15,Imperial,025,180216,10919,8794,10,8804,188
2020-08-15,Inyo,027,18085,149,123,2,125,1
2020-08-15,Kern,029,883053,28327,26338,165,26503,249
2020-08-15,Kings,031,150075,5718,5039,31,5070,56
2020-08-15,Lake,033,64148,299,268,0,268,2
2020-08-15,Lassen,035,31185,711,666,2,668,0
2020-08-15,Los Angeles,037,10098052,227578,221043,865,221908,5252
2020-08-15,Madera,039,155013,3533,2950,21,2971,26
2020-08-15,Marin,041,260295,5880,5628,12,5640,46
2020-08-15,Mariposa,043,17540,71,61,0,61,2
2020-08-15,Mendocino,045,87422,520,444,0,444,8
2020-08-15,Merced,047,269075,7284,6656,6,6662,66
2020-08-15,Modoc,049,8938,7,5,0,5,0
2020-08-15,Mono,051,14174,162,126,2,128,1
2020-08-15,Monterey,053,433212,7117,6162,19,6181,44
2020-08-15,Napa,055,140530,1356,1232,3,1235,10
2020-08-15,Nevada,057,99092,409,376,13,389,2
2020-08-15,Orange,059,3164182,47819,42811,1035,43846,801
2020-08-15,Placer,061,380077,2790,2551,4,2555,27
2020-08-15,Plumas,063,18699,39,33,0,33,0
2020-08-15,Riverside,065,2383286,50551,46720,49,46769,910
2020-08-15,Sacramento,067,1510023,16197,14018,14,14032,219
2020-08-15,San Benito,069,59416,917,805,0,805,2
2020-08-15,San Bernardino,071,2135413,46053,41231,242,41473,602
2020-08-15,San Diego,073,3302833,36357,34346,184,34530,639
2020-08-15,San Francisco,075,870044,8729,7601,9,7610,69
2020-08-15,San Joaquin,077,732212,17110,15113,27,15140,280
2020-08-15,San Luis Obispo,079,281455,2755,2461,15,2476,17
2020-08-15,San Mateo,081,765935,7764,6860,7,6867,118
2020-08-15,Santa Barbara,083,443738,7722,7338,69,7407,79
2020-08-15,Santa Clara,085,1922200,16397,14105,33,14138,183
2020-08-15,Santa Cruz,087,273765,1651,1449,13,1462,6
2020-08-15,Shasta,089,179085,573,458,3,461,9
2020-08-15,Sierra,091,2930,6,6,0,6,0
2020-08-15,Siskiyou,093,43540,117,100,0,100,0
2020-08-15,Solano,095,438530,5009,4477,32,4509,31
2020-08-15,Sonoma,097,501317,5003,4134,16,4150,45
2020-08-15,Stanislaus,099,539301,13998,12541,188,12729,149
2020-08-15,Sutter,101,95872,1169,1046,1,1047,8
2020-08-15,Tehama,103,63373,361,312,2,314,1
2020-08-15,Trinity,105,12862,36,6,6,12,0
2020-08-15,Tulare,107,460477,13445,12262,44,12306,211
2020-08-15,Tuolumne,109,53932,171,155,3,158,1
2020-08-15,Ventura,111,848112,10297,9379,50,9429,89
2020-08-15,Yolo,113,214977,2224,2031,4,2035,46
2020-08-15,Yuba,115,75493,731,623,2,625,1
2020-08-14,Alameda,001,1643700,16750,14909,118,15027,221
2020-08-14,Alpine,003,1148,2,2,0,2,0
2020-08-14,Amador,005,37829,258,209,0,209,9
2020-08-14,Butte,007,227075,1559,1384,17,1401,15
2020-08-14,Calaveras,009,45235,188,165,0,165,1
2020-08-14,Colusa,011,21464,426,399,0,399,5
2020-08-14,Contra Costa,013,1133247,12884,10893,41,10934,137
2020-08-14,Del Norte,015,27424,103,76,0,76,0
2020-08-14,El Dorado,017,186661,934,827,0,827,2
2020-08-14,Fresno,019,978130,25377,19900,255,20155,208
2020-08-14,Glenn,021,27897,420,395,0,395,2
2020-08-14,Humboldt,023,135768,339,294,1,295,4
2020-08-14,Imperial,025,180216,10895,8756,10,8766,185
2020-08-14,Inyo,027,18085,148,115,2,117,1
2020-08-14,Kern,029,883053,28223,25893,164,26057,249
2020-08-14,Kings,031,150075,5704,4953,31,4984,56
2020-08-14,Lake,033,64148,290,267,0,267,2
2020-08-14,Lassen,035,31185,711,665,2,667,0
2020-08-14,Los Angeles,037,10098052,226411,219083,848,219931,5222
2020-08-14,Madera,039,155013,3503,2876,21,2897,26
2020-08-14,Marin,041,260295,5869,5601,12,5613,46
2020-08-14,Mariposa,043,17540,70,61,0,61,2
2020-08-14,Mendocino,045,87422,511,432,0,432,8
2020-08-14,Merced,047,269075,7254,6466,6,6472,67
2020-08-14,Modoc,049,8938,7,5,0,5,0
2020-08-14,Mono,051,14174,162,126,2,128,1
2020-08-14,Monterey,053,433212,7066,6121,19,6140,41
2020-08-14,Napa,055,140530,1346,1230,3,1233,10
2020-08-14,Nevada,057,99092,405,377,13,390,2
2020-08-14,Orange,059,3164182,47669,42399,1022,43421,798
2020-08-14,Placer,061,380077,2771,2546,4,2550,26
2020-08-14,Plumas,063,18699,38,33,0,33,0
2020-08-14,Riverside,065,2383286,50322,46456,49,46505,891
2020-08-14,Sacramento,067,1510023,16047,13645,14,13659,212
2020-08-14,San Benito,069,59416,900,783,0,783,2
2020-08-14,San Bernardino,071,2135413,45866,40442,239,40681,594
2020-08-14,San Diego,073,3302833,36163,34067,177,34244,622
2020-08-14,San Francisco,075,870044,8670,7467,9,7476,69
2020-08-14,San Joaquin,077,732212,17010,14925,27,14952,276
2020-08-14,San Luis Obispo,079,281455,2740,2422,15,2437,17
2020-08-14,San Mateo,081,765935,7705,6655,7,6662,118
2020-08-14,Santa Barbara,083,443738,7672,7302,69,7371,77
2020-08-14,Santa Clara,085,1922200,16231,13785,32,13817,183
2020-08-14,Santa Cruz,087,273765,1629,1418,12,1430,6
2020-08-14,Shasta,089,179085,568,446,3,449,9
2020-08-14,Sierra,091,2930,6,5,0,5,0
2020-08-14,Siskiyou,093,43540,117,98,0,98,0
2020-08-14,Solano,095,438530,4988,4421,32,4453,31
2020-08-14,Sonoma,097,501317,4944,4087,13,4100,45
2020-08-14,Stanislaus,099,539301,13921,12379,184,12563,140
2020-08-14,Sutter,101,95872,1161,1039,1,1040,8
2020-08-14,Tehama,103,63373,357,305,2,307,1
2020-08-14,Trinity,105,12862,36,6,6,12,0
2020-08-14,Tulare,107,460477,13368,12009,44,12053,211
2020-08-14,Tuolumne,109,53932,170,155,3,158,1
2020-08-14,Ventura,111,848112,10222,9313,50,9363,89
2020-08-14,Yolo,113,214977,2210,1991,4,1995,45
2020-08-14,Yuba,115,75493,715,606,2,608,1
2020-08-13,Alameda,001,1643700,16473,14385,118,14503,218
2020-08-13,Alpine,003,1148,2,2,0,2,0
2020-08-13,Amador,005,37829,258,198,0,198,8
2020-08-13,Butte,007,227075,1534,1345,17,1362,15
2020-08-13,Calaveras,009,45235,186,162,0,162,1
2020-08-13,Colusa,011,21464,426,395,0,395,5
2020-08-13,Contra Costa,013,1133247,12730,10545,40,10585,136
2020-08-13,Del Norte,015,27424,102,74,0,74,0
2020-08-13,El Dorado,017,186661,929,803,0,803,2
2020-08-13,Fresno,019,978130,25150,19157,249,19406,201
2020-08-13,Glenn,021,27897,416,392,0,392,1
2020-08-13,Humboldt,023,135768,331,281,1,282,4
2020-08-13,Imperial,025,180216,10864,8640,10,8650,170
2020-08-13,Inyo,027,18085,144,97,2,99,1
2020-08-13,Kern,029,883053,28056,25472,161,25633,242
2020-08-13,Kings,031,150075,5669,4824,31,4855,52
2020-08-13,Lake,033,64148,285,263,0,263,2
2020-08-13,Lassen,035,31185,711,652,2,654,0
2020-08-13,Los Angeles,037,10098052,225035,216497,827,217324,5179
2020-08-13,Madera,039,155013,3459,2675,20,2695,25
2020-08-13,Marin,041,260295,5853,5503,12,5515,44
2020-08-13,Mariposa,043,17540,69,61,0,61,2
2020-08-13,Mendocino,045,87422,506,401,0,401,8
2020-08-13,Merced,047,269075,7137,5945,6,5951,63
2020-08-13,Modoc,049,8938,7,5,0,5,0
2020-08-13,Mono,051,14174,162,124,2,126,1
2020-08-13,Monterey,053,433212,6983,5925,19,5944,38
2020-08-13,Napa,055,140530,1337,1179,3,1182,10
2020-08-13,Nevada,057,99092,401,362,13,375,1
2020-08-13,Orange,059,3164182,47430,42019,1010,43029,773
2020-08-13,Placer,061,380077,2748,2460,4,2464,26
2020-08-13,Plumas,063,18699,38,32,0,32,0
2020-08-13,Riverside,065,2383286,50026,45327,49,45376,885
2020-08-13,Sacramento,067,1510023,15845,13237,14,13251,197
2020-08-13,San Benito,069,59416,871,757,0,757,2
2020-08-13,San Bernardino,071,2135413,45471,39395,233,39628,591
2020-08-13,San Diego,073,3302833,35927,33661,159,33820,627
2020-08-13,San Francisco,075,870044,8576,7277,9,7286,69
2020-08-13,San Joaquin,077,732212,16855,14537,26,14563,261
2020-08-13,San Luis Obispo,079,281455,2717,2283,15,2298,16
2020-08-13,San Mateo,081,765935,7643,6503,7,6510,117
2020-08-13,Santa Barbara,083,443738,7627,7129,68,7197,74
2020-08-13,Santa Clara,085,1922200,16008,13257,32,13289,182
2020-08-13,Santa Cruz,087,273765,1604,1383,12,1395,6
2020-08-13,Shasta,089,179085,563,428,3,431,9
2020-08-13,Sierra,091,2930,6,5,0,5,0
2020-08-13,Siskiyou,093,43540,117,95,0,95,0
2020-08-13,Solano,095,438530,4951,4305,32,4337,31
2020-08-13,Sonoma,097,501317,4870,3902,13,3915,45
2020-08-13,Stanislaus,099,539301,13791,11953,168,12121,136
2020-08-13,Sutter,101,95872,1139,992,1,993,8
2020-08-13,Tehama,103,63373,348,302,2,304,1
2020-08-13,Trinity,105,12862,35,6,6,12,0
2020-08-13,Tulare,107,460477,13224,11692,41,11733,210
2020-08-13,Tuolumne,109,53932,169,152,3,155,1
2020-08-13,Ventura,111,848112,10133,9114,50,9164,90
2020-08-13,Yolo,113,214977,2183,1938,4,1942,44
2020-08-13,Yuba,115,75493,699,568,2,570,1
2020-08-12,Alameda,001,1643700,16261,14214,118,14332,215
2020-08-12,Alpine,003,1148,2,2,0,2,0
2020-08-12,Amador,005,37829,255,197,0,197,8
2020-08-12,Butte,007,227075,1506,1317,17,1334,15
2020-08-12,Calaveras,009,45235,183,157,0,157,1
2020-08-12,Colusa,011,21464,421,394,0,394,5
2020-08-12,Contra Costa,013,1133247,12585,10304,39,10343,134
2020-08-12,Del Norte,015,27424,101,74,0,74,0
2020-08-12,El Dorado,017,186661,911,794,0,794,2
2020-08-12,Fresno,019,978130,24920,18690,242,18932,194
2020-08-12,Glenn,021,27897,413,388,0,388,1
2020-08-12,Humboldt,023,135768,324,281,1,282,4
2020-08-12,Imperial,025,180216,10841,8566,10,8576,167
2020-08-12,Inyo,027,18085,127,97,2,99,1
2020-08-12,Kern,029,883053,27864,25191,159,25350,232
2020-08-12,Kings,031,150075,5630,4736,31,4767,50
2020-08-12,Lake,033,64148,283,253,0,253,2
2020-08-12,Lassen,035,31185,710,651,2,653,0
2020-08-12,Los Angeles,037,10098052,223644,214542,811,215353,5119
2020-08-12,Madera,039,155013,3425,2681,18,2699,23
2020-08-12,Marin,041,260295,5831,5423,12,5435,44
2020-08-12,Mariposa,043,17540,69,61,0,61,2
2020-08-12,Mendocino,045,87422,487,386,0,386,9
2020-08-12,Merced,047,269075,7075,5777,6,5783,66
2020-08-12,Modoc,049,8938,7,5,0,5,0
2020-08-12,Mono,051,14174,161,124,2,126,1
2020-08-12,Monterey,053,433212,6879,5919,19,5938,38
2020-08-12,Napa,055,140530,1327,1161,3,1164,10
2020-08-12,Nevada,057,99092,396,357,13,370,1
2020-08-12,Orange,059,3164182,47179,41576,986,42562,754
2020-08-12,Placer,061,380077,2716,2417,4,2421,25
2020-08-12,Plumas,063,18699,38,31,0,31,0
2020-08-12,Riverside,065,2383286,49678,44747,49,44796,867
2020-08-12,Sacramento,067,1510023,15633,12528,14,12542,189
2020-08-12,San Benito,069,59416,858,751,0,751,2
2020-08-12,San Bernardino,071,2135413,45128,38811,224,39035,589
2020-08-12,San Diego,073,3302833,35718,33395,139,33534,608
2020-08-12,San Francisco,075,870044,8493,7194,9,7203,66
2020-08-12,San Joaquin,077,732212,16708,14154,26,14180,253
2020-08-12,San Luis Obispo,079,281455,2692,2263,15,2278,15
2020-08-12,San Mateo,081,765935,7564,6427,7,6434,117
2020-08-12,Santa Barbara,083,443738,7567,7049,66,7115,74
2020-08-12,Santa Clara,085,1922200,15832,13002,32,13034,182
2020-08-12,Santa Cruz,087,273765,1575,1382,11,1393,6
2020-08-12,Shasta,089,179085,559,417,3,420,9
2020-08-12,Sierra,091,2930,5,4,0,4,0
2020-08-12,Siskiyou,093,43540,116,90,0,90,0
2020-08-12,Solano,095,438530,4906,4258,32,4290,31
2020-08-12,Sonoma,097,501317,4796,3847,13,3860,47
2020-08-12,Stanislaus,099,539301,13652,11682,160,11842,136
2020-08-12,Sutter,101,95872,1115,987,1,988,7
2020-08-12,Tehama,103,63373,338,289,2,291,1
2020-08-12,Trinity,105,12862,34,6,6,12,0
2020-08-12,Tulare,107,460477,13096,11460,41,11501,211
2020-08-12,Tuolumne,109,53932,168,150,3,153,1
2020-08-12,Ventura,111,848112,10046,9005,50,9055,87
2020-08-12,Yolo,113,214977,2159,1921,4,1925,44
2020-08-12,Yuba,115,75493,677,549,1,550,1
2020-08-11,Alameda,001,1643700,16000,13960,115,14075,204
2020-08-11,Alpine,003,1148,2,2,0,2,0
2020-08-11,Amador,005,37829,249,187,0,187,3
2020-08-11,Butte,007,227075,1479,1296,17,1313,15
2020-08-11,Calaveras,009,45235,181,161,0,161,1
2020-08-11,Colusa,011,21464,416,390,0,390,5
2020-08-11,Contra Costa,013,1133247,12396,10012,37,10049,131
2020-08-11,Del Norte,015,27424,100,73,0,73,0
2020-08-11,El Dorado,017,186661,904,786,0,786,2
2020-08-11,Fresno,019,978130,24598,18344,239,18583,187
2020-08-11,Glenn,021,27897,411,380,0,380,1
2020-08-11,Humboldt,023,135768,319,283,1,284,4
2020-08-11,Imperial,025,180216,10786,8518,10,8528,165
2020-08-11,Inyo,027,18085,122,97,2,99,1
2020-08-11,Kern,029,883053,27529,25042,157,25199,230
2020-08-11,Kings,031,150075,5439,4696,31,4727,50
2020-08-11,Lake,033,64148,280,243,0,243,2
2020-08-11,Lassen,035,31185,704,605,2,607,0
2020-08-11,Los Angeles,037,10098052,222149,212421,787,213208,5065
2020-08-11,Madera,039,155013,3371,2673,18,2691,22
2020-08-11,Marin,041,260295,5803,5287,11,5298,44
2020-08-11,Mariposa,043,17540,68,60,0,60,2
2020-08-11,Mendocino,045,87422,477,385,0,385,9
2020-08-11,Merced,047,269075,6980,5322,5,5327,65
2020-08-11,Modoc,049,8938,7,5,0,5,0
2020-08-11,Mono,051,14174,161,124,2,126,1
2020-08-11,Monterey,053,433212,6771,5624,19,5643,36
2020-08-11,Napa,055,140530,1316,1143,2,1145,11
2020-08-11,Nevada,057,99092,393,358,13,371,1
2020-08-11,Orange,059,3164182,46959,41205,964,42169,742
2020-08-11,Placer,061,380077,2684,2393,4,2397,24
2020-08-11,Plumas,063,18699,38,31,0,31,0
2020-08-11,Riverside,065,2383286,49321,44237,49,44286,836
2020-08-11,Sacramento,067,1510023,15342,12298,14,12312,182
2020-08-11,San Benito,069,59416,846,750,0,750,2
2020-08-11,San Bernardino,071,2135413,44787,38467,217,38684,584
2020-08-11,San Diego,073,3302833,35451,33159,120,33279,602
2020-08-11,San Francisco,075,870044,8397,6988,9,6997,66
2020-08-11,San Joaquin,077,732212,16531,13997,21,14018,251
2020-08-11,San Luis Obispo,079,281455,2635,2234,15,2249,15
2020-08-11,San Mateo,081,765935,7490,6339,7,6346,117
2020-08-11,Santa Barbara,083,443738,7517,6942,66,7008,70
2020-08-11,Santa Clara,085,1922200,15610,12920,32,12952,183
2020-08-11,Santa Cruz,087,273765,1552,1352,11,1363,4
2020-08-11,Shasta,089,179085,555,416,3,419,9
2020-08-11,Sierra,091,2930,5,4,0,4,0
2020-08-11,Siskiyou,093,43540,116,90,0,90,0
2020-08-11,Solano,095,438530,4858,4206,31,4237,31
2020-08-11,Sonoma,097,501317,4702,3752,13,3765,45
2020-08-11,Stanislaus,099,539301,13548,11592,148,11740,128
2020-08-11,Sutter,101,95872,1093,964,1,965,7
2020-08-11,Tehama,103,63373,334,289,2,291,1
2020-08-11,Trinity,105,12862,34,5,6,11,0
2020-08-11,Tulare,107,460477,12971,11392,40,11432,201
2020-08-11,Tuolumne,109,53932,163,146,3,149,1
2020-08-11,Ventura,111,848112,9978,8953,49,9002,88
2020-08-11,Yolo,113,214977,2137,1912,4,1916,44
2020-08-11,Yuba,115,75493,666,540,1,541,1
2020-08-10,Alameda,001,1643700,15760,13420,114,13534,203
2020-08-10,Alpine,003,1148,2,2,0,2,0
2020-08-10,Amador,005,37829,248,172,0,172,2
2020-08-10,Butte,007,227075,1455,1174,15,1189,15
2020-08-10,Calaveras,009,45235,171,121,0,121,1
2020-08-10,Colusa,011,21464,414,387,0,387,4
2020-08-10,Contra Costa,013,1133247,12243,9454,35,9489,130
2020-08-10,Del Norte,015,27424,98,69,0,69,0
2020-08-10,El Dorado,017,186661,892,771,0,771,2
2020-08-10,Fresno,019,978130,24316,17978,238,18216,183
2020-08-10,Glenn,021,27897,408,381,0,381,1
2020-08-10,Humboldt,023,135768,313,277,1,278,4
2020-08-10,Imperial,025,180216,10742,8465,10,8475,165
2020-08-10,Inyo,027,18085,122,97,2,99,1
2020-08-10,Kern,029,883053,27303,24499,156,24655,215
2020-08-10,Kings,031,150075,5333,4588,31,4619,50
2020-08-10,Lake,033,64148,273,239,0,239,2
2020-08-10,Lassen,035,31185,704,588,2,590,0
2020-08-10,Los Angeles,037,10098052,220579,211035,769,211804,5003
2020-08-10,Madera,039,155013,3338,2365,17,2382,22
2020-08-10,Marin,041,260295,5758,5242,10,5252,44
2020-08-10,Mariposa,043,17540,68,57,0,57,2
2020-08-10,Mendocino,045,87422,453,364,0,364,1
2020-08-10,Merced,047,269075,6899,4913,5,4918,51
2020-08-10,Modoc,049,8938,7,5,0,5,0
2020-08-10,Mono,051,14174,161,123,2,125,1
2020-08-10,Monterey,053,433212,6661,5358,19,5377,34
2020-08-10,Napa,055,140530,1298,1084,2,1086,8
2020-08-10,Nevada,057,99092,385,356,13,369,1
2020-08-10,Orange,059,3164182,46689,40445,946,41391,721
2020-08-10,Placer,061,380077,2645,2298,4,2302,21
2020-08-10,Plumas,063,18699,38,27,0,27,0
2020-08-10,Riverside,065,2383286,48936,43296,48,43344,830
2020-08-10,Sacramento,067,1510023,15031,12059,14,12073,168
2020-08-10,San Benito,069,59416,833,743,0,743,2
2020-08-10,San Bernardino,071,2135413,44410,37367,208,37575,579
2020-08-10,San Diego,073,3302833,35185,32977,104,33081,594
2020-08-10,San Francisco,075,870044,8307,6816,8,6824,66
2020-08-10,San Joaquin,077,732212,16349,13308,21,13329,240
2020-08-10,San Luis Obispo,079,281455,2536,2208,14,2222,15
2020-08-10,San Mateo,081,765935,7413,6222,7,6229,117
2020-08-10,Santa Barbara,083,443738,7462,6869,66,6935,66
2020-08-10,Santa Clara,085,1922200,15350,12615,31,12646,182
2020-08-10,Santa Cruz,087,273765,1532,1239,10,1249,4
2020-08-10,Shasta,089,179085,551,384,3,387,9
2020-08-10,Sierra,091,2930,5,3,0,3,0
2020-08-10,Siskiyou,093,43540,113,88,0,88,0
2020-08-10,Solano,095,438530,4798,4101,31,4132,31
2020-08-10,Sonoma,097,501317,4533,3640,9,3649,42
2020-08-10,Stanislaus,099,539301,13366,10855,131,10986,106
2020-08-10,Sutter,101,95872,1068,865,1,866,7
2020-08-10,Tehama,103,63373,327,282,2,284,1
2020-08-10,Trinity,105,12862,31,5,6,11,0
2020-08-10,Tulare,107,460477,12798,10750,38,10788,194
2020-08-10,Tuolumne,109,53932,163,143,2,145,1
2020-08-10,Ventura,111,848112,9894,8851,48,8899,85
2020-08-10,Yolo,113,214977,2114,1840,4,1844,45
2020-08-10,Yuba,115,75493,649,527,1,528,1
2020-08-09,Alameda,001,1643700,15480,13241,112,13353,203
2020-08-09,Alpine,003,1148,2,2,0,2,0
2020-08-09,Amador,005,37829,243,153,0,153,2
2020-08-09,Butte,007,227075,1411,1155,15,1170,15
2020-08-09,Calaveras,009,45235,166,122,0,122,1
2020-08-09,Colusa,011,21464,410,371,0,371,4
2020-08-09,Contra Costa,013,1133247,12015,9214,34,9248,130
2020-08-09,Del Norte,015,27424,98,69,0,69,0
2020-08-09,El Dorado,017,186661,884,748,0,748,2
2020-08-09,Fresno,019,978130,24007,17846,234,18080,183
2020-08-09,Glenn,021,27897,406,354,0,354,1
2020-08-09,Humboldt,023,135768,307,279,1,280,4
2020-08-09,Imperial,025,180216,10699,8310,9,8319,165
2020-08-09,Inyo,027,18085,117,86,1,87,1
2020-08-09,Kern,029,883053,27047,23680,156,23836,215
2020-08-09,Kings,031,150075,5290,4446,30,4476,50
2020-08-09,Lake,033,64148,266,225,0,225,2
2020-08-09,Lassen,035,31185,698,589,2,591,0
2020-08-09,Los Angeles,037,10098052,218522,208810,747,209557,4984
2020-08-09,Madera,039,155013,3279,2322,13,2335,22
2020-08-09,Marin,041,260295,5715,5204,10,5214,44
2020-08-09,Mariposa,043,17540,66,56,0,56,2
2020-08-09,Mendocino,045,87422,443,283,0,283,1
2020-08-09,Merced,047,269075,6801,4735,4,4739,51
2020-08-09,Modoc,049,8938,7,4,0,4,0
2020-08-09,Mono,051,14174,160,113,2,115,1
2020-08-09,Monterey,053,433212,6537,5199,19,5218,34
2020-08-09,Napa,055,140530,1279,1062,2,1064,8
2020-08-09,Nevada,057,99092,377,332,13,345,1
2020-08-09,Orange,059,3164182,46390,39244,931,40175,722
2020-08-09,Placer,061,380077,2616,2211,4,2215,20
2020-08-09,Plumas,063,18699,38,27,0,27,0
2020-08-09,Riverside,065,2383286,48590,41894,48,41942,828
2020-08-09,Sacramento,067,1510023,14751,11301,14,11315,167
2020-08-09,San Benito,069,59416,814,687,0,687,2
2020-08-09,San Bernardino,071,2135413,43935,36092,208,36300,579
2020-08-09,San Diego,073,3302833,34894,32749,93,32842,594
2020-08-09,San Francisco,075,870044,8192,6820,8,6828,66
2020-08-09,San Joaquin,077,732212,16144,12933,20,12953,240
2020-08-09,San Luis Obispo,079,281455,2500,2124,14,2138,15
2020-08-09,San Mateo,081,765935,7318,6094,7,6101,117
2020-08-09,Santa Barbara,083,443738,7374,6669,66,6735,66
2020-08-09,Santa Clara,085,1922200,15080,11878,31,11909,181
2020-08-09,Santa Cruz,087,273765,1508,1246,10,1256,4
2020-08-09,Shasta,089,179085,547,361,3,364,9
2020-08-09,Sierra,091,2930,5,3,0,3,0
2020-08-09,Siskiyou,093,43540,112,74,0,74,0
2020-08-09,Solano,095,438530,4745,3954,30,3984,31
2020-08-09,Sonoma,097,501317,4397,3531,7,3538,41
2020-08-09,Stanislaus,099,539301,13158,10264,118,10382,106
2020-08-09,Sutter,101,95872,1034,857,1,858,7
2020-08-09,Tehama,103,63373,319,265,2,267,1
2020-08-09,Trinity,105,12862,31,5,6,11,0
2020-08-09,Tulare,107,460477,12606,10630,35,10665,194
2020-08-09,Tuolumne,109,53932,160,143,2,145,1
2020-08-09,Ventura,111,848112,9746,8633,47,8680,85
2020-08-09,Yolo,113,214977,2083,1765,4,1769,44
2020-08-09,Yuba,115,75493,629,442,1,443,1
2020-08-08,Alameda,001,1643700,15370,13087,112,13199,204
2020-08-08,Alpine,003,1148,2,2,0,2,0
2020-08-08,Amador,005,37829,243,139,0,139,2
2020-08-08,Butte,007,227075,1393,1140,15,1155,15
2020-08-08,Calaveras,009,45235,165,122,0,122,1
2020-08-08,Colusa,011,21464,409,368,0,368,4
2020-08-08,Contra Costa,013,1133247,11906,9104,34,9138,129
2020-08-08,Del Norte,015,27424,97,69,0,69,0
2020-08-08,El Dorado,017,186661,877,734,0,734,2
2020-08-08,Fresno,019,978130,23870,17538,232,17770,183
2020-08-08,Glenn,021,27897,406,344,0,344,1
2020-08-08,Humboldt,023,135768,304,277,1,278,4
2020-08-08,Imperial,025,180216,10684,8213,9,8222,165
2020-08-08,Inyo,027,18085,113,86,1,87,1
2020-08-08,Kern,029,883053,26933,22803,156,22959,215
2020-08-08,Kings,031,150075,5276,4367,30,4397,49
2020-08-08,Lake,033,64148,264,221,0,221,2
2020-08-08,Lassen,035,31185,698,589,2,591,0
2020-08-08,Los Angeles,037,10098052,217636,206971,736,207707,4974
2020-08-08,Madera,039,155013,3248,2275,13,2288,22
2020-08-08,Marin,041,260295,5695,5118,10,5128,44
2020-08-08,Mariposa,043,17540,65,55,0,55,2
2020-08-08,Mendocino,045,87422,441,264,0,264,1
2020-08-08,Merced,047,269075,6761,4570,4,4574,51
2020-08-08,Modoc,049,8938,7,4,0,4,0
2020-08-08,Mono,051,14174,160,113,2,115,1
2020-08-08,Monterey,053,433212,6479,5101,19,5120,33
2020-08-08,Napa,055,140530,1271,1062,2,1064,8
2020-08-08,Nevada,057,99092,375,325,13,338,1
2020-08-08,Orange,059,3164182,46260,38688,922,39610,718
2020-08-08,Placer,061,380077,2599,2153,4,2157,20
2020-08-08,Plumas,063,18699,38,27,0,27,0
2020-08-08,Riverside,065,2383286,48386,41412,48,41460,823
2020-08-08,Sacramento,067,1510023,14622,11144,14,11158,166
2020-08-08,San Benito,069,59416,806,684,0,684,2
2020-08-08,San Bernardino,071,2135413,43739,35691,207,35898,531
2020-08-08,San Diego,073,3302833,34705,32332,84,32416,593
2020-08-08,San Francisco,075,870044,8126,6820,8,6828,66
2020-08-08,San Joaquin,077,732212,16063,12559,19,12578,240
2020-08-08,San Luis Obispo,079,281455,2477,2081,14,2095,15
2020-08-08,San Mateo,081,765935,7260,6021,7,6028,117
2020-08-08,Santa Barbara,083,443738,7336,6598,66,6664,66
2020-08-08,Santa Clara,085,1922200,14928,11615,31,11646,181
2020-08-08,Santa Cruz,087,273765,1494,1247,10,1257,4
2020-08-08,Shasta,089,179085,545,343,3,346,9
2020-08-08,Sierra,091,2930,5,3,0,3,0
2020-08-08,Siskiyou,093,43540,112,73,0,73,0
2020-08-08,Solano,095,438530,4724,3889,29,3918,31
2020-08-08,Sonoma,097,501317,4365,3399,7,3406,41
2020-08-08,Stanislaus,099,539301,13083,9963,113,10076,105
2020-08-08,Sutter,101,95872,1024,830,1,831,7
2020-08-08,Tehama,103,63373,318,251,2,253,1
2020-08-08,Trinity,105,12862,31,5,6,11,0
2020-08-08,Tulare,107,460477,12530,10505,35,10540,192
2020-08-08,Tuolumne,109,53932,160,143,2,145,1
2020-08-08,Ventura,111,848112,9691,8462,46,8508,85
2020-08-08,Yolo,113,214977,2070,1725,4,1729,44
2020-08-08,Yuba,115,75493,620,430,1,431,1
2020-08-07,Alameda,001,1643700,15260,12805,112,12917,204
2020-08-07,Alpine,003,1148,2,2,0,2,0
2020-08-07,Amador,005,37829,241,125,0,125,2
2020-08-07,Butte,007,227075,1375,1092,15,1107,13
2020-08-07,Calaveras,009,45235,165,119,0,119,1
2020-08-07,Colusa,011,21464,408,358,0,358,4
2020-08-07,Contra Costa,013,1133247,11757,8810,34,8844,126
2020-08-07,Del Norte,015,27424,97,69,0,69,0
2020-08-07,El Dorado,017,186661,872,724,0,724,2
2020-08-07,Fresno,019,978130,23710,17290,232,17522,171
2020-08-07,Glenn,021,27897,405,339,0,339,1
2020-08-07,Humboldt,023,135768,300,274,1,275,4
2020-08-07,Imperial,025,180216,10659,8085,9,8094,164
2020-08-07,Inyo,027,18085,112,81,1,82,1
2020-08-07,Kern,029,883053,26807,22143,153,22296,206
2020-08-07,Kings,031,150075,5259,4315,30,4345,48
2020-08-07,Lake,033,64148,262,215,0,215,1
2020-08-07,Lassen,035,31185,697,588,2,590,0
2020-08-07,Los Angeles,037,10098052,216184,204406,724,205130,4924
2020-08-07,Madera,039,155013,3216,2245,13,2258,20
2020-08-07,Marin,041,260295,5666,5094,10,5104,43
2020-08-07,Mariposa,043,17540,65,53,0,53,2
2020-08-07,Mendocino,045,87422,427,262,0,262,1
2020-08-07,Merced,047,269075,6718,4358,4,4362,30
2020-08-07,Modoc,049,8938,7,4,0,4,0
2020-08-07,Mono,051,14174,160,112,2,114,1
2020-08-07,Monterey,053,433212,6404,5041,19,5060,33
2020-08-07,Napa,055,140530,1266,1055,2,1057,8
2020-08-07,Nevada,057,99092,372,324,13,337,1
2020-08-07,Orange,059,3164182,46048,38459,905,39364,701
2020-08-07,Placer,061,380077,2581,2078,4,2082,20
2020-08-07,Plumas,063,18699,38,25,0,25,0
2020-08-07,Riverside,065,2383286,48123,40902,47,40949,810
2020-08-07,Sacramento,067,1510023,14477,10798,14,10812,160
2020-08-07,San Benito,069,59416,800,647,0,647,2
2020-08-07,San Bernardino,071,2135413,43492,35200,206,35406,524
2020-08-07,San Diego,073,3302833,34520,31781,81,31862,586
2020-08-07,San Francisco,075,870044,8048,6765,8,6773,66
2020-08-07,San Joaquin,077,732212,15978,12392,19,12411,223
2020-08-07,San Luis Obispo,079,281455,2446,2050,14,2064,14
2020-08-07,San Mateo,081,765935,7201,5948,7,5955,117
2020-08-07,Santa Barbara,083,443738,7285,6509,66,6575,66
2020-08-07,Santa Clara,085,1922200,14729,11409,31,11440,180
2020-08-07,Santa Cruz,087,273765,1476,1234,10,1244,5
2020-08-07,Shasta,089,179085,540,342,3,345,9
2020-08-07,Sierra,091,2930,5,3,0,3,0
2020-08-07,Siskiyou,093,43540,109,73,0,73,0
2020-08-07,Solano,095,438530,4692,3844,28,3872,31
2020-08-07,Sonoma,097,501317,4301,3329,7,3336,34
2020-08-07,Stanislaus,099,539301,12961,9665,103,9768,98
2020-08-07,Sutter,101,95872,1020,807,1,808,6
2020-08-07,Tehama,103,63373,314,246,2,248,1
2020-08-07,Trinity,105,12862,30,5,6,11,0
2020-08-07,Tulare,107,460477,12453,10292,35,10327,195
2020-08-07,Tuolumne,109,53932,159,136,2,138,1
2020-08-07,Ventura,111,848112,9631,8356,44,8400,84
2020-08-07,Yolo,113,214977,2043,1689,4,1693,37
2020-08-07,Yuba,115,75493,615,413,1,414,1
2020-08-06,Alameda,001,1643700,15037,12474,111,12585,200
2020-08-06,Alpine,003,1148,2,2,0,2,0
2020-08-06,Amador,005,37829,227,125,0,125,0
2020-08-06,Butte,007,227075,1356,1060,15,1075,13
2020-08-06,Calaveras,009,45235,163,117,0,117,1
2020-08-06,Colusa,011,21464,405,358,0,358,3
2020-08-06,Contra Costa,013,1133247,11563,8583,33,8616,124
2020-08-06,Del Norte,015,27424,97,69,0,69,0
2020-08-06,El Dorado,017,186661,861,703,0,703,1
2020-08-06,Fresno,019,978130,23412,17031,225,17256,161
2020-08-06,Glenn,021,27897,400,332,0,332,1
2020-08-06,Humboldt,023,135768,295,266,1,267,4
2020-08-06,Imperial,025,180216,10616,8064,9,8073,163
2020-08-06,Inyo,027,18085,104,83,1,84,1
2020-08-06,Kern,029,883053,26571,21843,152,21995,197
2020-08-06,Kings,031,150075,5197,4264,29,4293,47
2020-08-06,Lake,033,64148,259,209,0,209,1
2020-08-06,Lassen,035,31185,695,588,2,590,0
2020-08-06,Los Angeles,037,10098052,214120,201372,708,202080,4874
2020-08-06,Madera,039,155013,3168,2240,12,2252,19
2020-08-06,Marin,041,260295,5634,5058,10,5068,43
2020-08-06,Mariposa,043,17540,64,52,0,52,2
2020-08-06,Mendocino,045,87422,413,260,0,260,1
2020-08-06,Merced,047,269075,6617,4235,4,4239,30
2020-08-06,Modoc,049,8938,7,4,0,4,0
2020-08-06,Mono,051,14174,159,111,2,113,1
2020-08-06,Monterey,053,433212,6295,5001,18,5019,33
2020-08-06,Napa,055,140530,1252,1032,2,1034,8
2020-08-06,Nevada,057,99092,367,321,13,334,1
2020-08-06,Orange,059,3164182,45756,38399,900,39299,694
2020-08-06,Placer,061,380077,2555,2045,4,2049,20
2020-08-06,Plumas,063,18699,37,25,0,25,0
2020-08-06,Riverside,065,2383286,47728,40269,47,40316,781
2020-08-06,Sacramento,067,1510023,14248,10548,14,10562,153
2020-08-06,San Benito,069,59416,792,626,0,626,2
2020-08-06,San Bernardino,071,2135413,43087,34819,204,35023,516
2020-08-06,San Diego,073,3302833,34253,31129,74,31203,583
2020-08-06,San Francisco,075,870044,7955,6737,7,6744,60
2020-08-06,San Joaquin,077,732212,15819,12269,19,12288,203
2020-08-06,San Luis Obispo,079,281455,2422,2000,13,2013,13
2020-08-06,San Mateo,081,765935,7101,5885,7,5892,117
2020-08-06,Santa Barbara,083,443738,7225,6620,66,6686,65
2020-08-06,Santa Clara,085,1922200,14500,11280,31,11311,178
2020-08-06,Santa Cruz,087,273765,1455,1215,10,1225,4
2020-08-06,Shasta,089,179085,531,343,3,346,9
2020-08-06,Sierra,091,2930,5,3,0,3,0
2020-08-06,Siskiyou,093,43540,109,73,0,73,0
2020-08-06,Solano,095,438530,4649,3784,28,3812,29
2020-08-06,Sonoma,097,501317,4237,3259,7,3266,33
2020-08-06,Stanislaus,099,539301,12811,9566,87,9653,98
2020-08-06,Sutter,101,95872,989,797,1,798,6
2020-08-06,Tehama,103,63373,311,242,2,244,1
2020-08-06,Trinity,105,12862,27,5,6,11,0
2020-08-06,Tulare,107,460477,12294,10169,35,10204,195
2020-08-06,Tuolumne,109,53932,158,136,2,138,1
2020-08-06,Ventura,111,848112,9516,8245,41,8286,80
2020-08-06,Yolo,113,214977,2019,1662,4,1666,36
2020-08-06,Yuba,115,75493,606,407,0,407,1
2020-08-05,Alameda,001,1643700,14823,12140,111,12251,193
2020-08-05,Alpine,003,1148,2,2,0,2,0
2020-08-05,Amador,005,37829,217,123,0,123,0
2020-08-05,Butte,007,227075,1322,1038,14,1052,13
2020-08-05,Calaveras,009,45235,160,116,0,116,1
2020-08-05,Colusa,011,21464,401,354,0,354,3
2020-08-05,Contra Costa,013,1133247,11394,8362,33,8395,122
2020-08-05,Del Norte,015,27424,96,69,0,69,0
2020-08-05,El Dorado,017,186661,853,692,0,692,1
2020-08-05,Fresno,019,978130,23168,16625,220,16845,159
2020-08-05,Glenn,021,27897,397,330,0,330,1
2020-08-05,Humboldt,023,135768,293,249,1,250,4
2020-08-05,Imperial,025,180216,10581,8036,9,8045,163
2020-08-05,Inyo,027,18085,102,62,1,63,1
2020-08-05,Kern,029,883053,26383,21540,147,21687,194
2020-08-05,Kings,031,150075,5152,4192,27,4219,47
2020-08-05,Lake,033,64148,252,209,0,209,1
2020-08-05,Lassen,035,31185,648,557,2,559,0
2020-08-05,Los Angeles,037,10098052,212206,198355,689,199044,4832
2020-08-05,Madera,039,155013,3126,2172,12,2184,19
2020-08-05,Marin,041,260295,5602,5036,10,5046,43
2020-08-05,Mariposa,043,17540,64,52,0,52,2
2020-08-05,Mendocino,045,87422,401,248,0,248,1
2020-08-05,Merced,047,269075,6482,4119,4,4123,30
2020-08-05,Modoc,049,8938,7,3,0,3,0
2020-08-05,Mono,051,14174,159,104,2,106,1
2020-08-05,Monterey,053,433212,6180,4936,18,4954,32
2020-08-05,Napa,055,140530,1240,1020,2,1022,8
2020-08-05,Nevada,057,99092,358,327,13,340,2
2020-08-05,Orange,059,3164182,45447,37907,892,38799,663
2020-08-05,Placer,061,380077,2514,1989,4,1993,18
2020-08-05,Plumas,063,18699,36,25,0,25,0
2020-08-05,Riverside,065,2383286,47336,39454,45,39499,761
2020-08-05,Sacramento,067,1510023,14029,10261,13,10274,151
2020-08-05,San Benito,069,59416,783,613,0,613,2
2020-08-05,San Bernardino,071,2135413,42625,34442,199,34641,504
2020-08-05,San Diego,073,3302833,34029,30866,58,30924,578
2020-08-05,San Francisco,075,870044,7862,6701,7,6708,60
2020-08-05,San Joaquin,077,732212,15656,12148,19,12167,199
2020-08-05,San Luis Obispo,079,281455,2398,1928,13,1941,13
2020-08-05,San Mateo,081,765935,7005,5695,7,5702,116
2020-08-05,Santa Barbara,083,443738,7165,6597,66,6663,63
2020-08-05,Santa Clara,085,1922200,14266,11074,31,11105,176
2020-08-05,Santa Cruz,087,273765,1435,1192,8,1200,4
2020-08-05,Shasta,089,179085,525,338,3,341,9
2020-08-05,Sierra,091,2930,5,3,0,3,0
2020-08-05,Siskiyou,093,43540,105,72,0,72,0
2020-08-05,Solano,095,438530,4598,3750,27,3777,29
2020-08-05,Sonoma,097,501317,4155,3173,7,3180,33
2020-08-05,Stanislaus,099,539301,12652,9408,82,9490,97
2020-08-05,Sutter,101,95872,978,780,1,781,6
2020-08-05,Tehama,103,63373,308,231,2,233,1
2020-08-05,Trinity,105,12862,27,5,6,11,0
2020-08-05,Tulare,107,460477,12154,9924,35,9959,192
2020-08-05,Tuolumne,109,53932,158,137,2,139,0
2020-08-05,Ventura,111,848112,9400,8162,37,8199,75
2020-08-05,Yolo,113,214977,1991,1634,4,1638,36
2020-08-05,Yuba,115,75493,589,400,0,400,1
2020-08-04,Alameda,001,1643700,14606,11983,110,12093,192
2020-08-04,Alpine,003,1148,2,2,0,2,0
2020-08-04,Amador,005,37829,202,123,0,123,0
2020-08-04,Butte,007,227075,1298,1011,14,1025,10
2020-08-04,Calaveras,009,45235,156,116,0,116,1
2020-08-04,Colusa,011,21464,396,354,0,354,3
2020-08-04,Contra Costa,013,1133247,11227,8210,33,8243,122
2020-08-04,Del Norte,015,27424,94,69,0,69,0
2020-08-04,El Dorado,017,186661,843,668,0,668,1
2020-08-04,Fresno,019,978130,22884,16272,212,16484,154
2020-08-04,Glenn,021,27897,396,325,0,325,1
2020-08-04,Humboldt,023,135768,283,241,1,242,4
2020-08-04,Imperial,025,180216,10544,7974,9,7983,163
2020-08-04,Inyo,027,18085,88,59,1,60,1
2020-08-04,Kern,029,883053,26100,21403,147,21550,190
2020-08-04,Kings,031,150075,5087,4163,27,4190,47
2020-08-04,Lake,033,64148,252,206,0,206,1
2020-08-04,Lassen,035,31185,645,556,2,558,0
2020-08-04,Los Angeles,037,10098052,210282,196014,658,196672,4764
2020-08-04,Madera,039,155013,3082,2161,8,2169,19
2020-08-04,Marin,041,260295,5571,5020,9,5029,43
2020-08-04,Mariposa,043,17540,64,51,0,51,2
2020-08-04,Mendocino,045,87422,376,248,0,248,1
2020-08-04,Merced,047,269075,6368,4085,4,4089,30
2020-08-04,Modoc,049,8938,7,3,0,3,0
2020-08-04,Mono,051,14174,158,104,1,105,1
2020-08-04,Monterey,053,433212,6066,4892,18,4910,32
2020-08-04,Napa,055,140530,1227,994,0,994,8
2020-08-04,Nevada,057,99092,357,322,13,335,2
2020-08-04,Orange,059,3164182,45071,37844,886,38730,659
2020-08-04,Placer,061,380077,2477,1964,4,1968,17
2020-08-04,Plumas,063,18699,36,25,0,25,0
2020-08-04,Riverside,065,2383286,46951,38991,44,39035,743
2020-08-04,Sacramento,067,1510023,13811,10205,13,10218,146
2020-08-04,San Benito,069,59416,767,608,0,608,2
2020-08-04,San Bernardino,071,2135413,42076,34215,194,34409,495
2020-08-04,San Diego,073,3302833,33736,30518,46,30564,568
2020-08-04,San Francisco,075,870044,7774,6568,7,6575,60
2020-08-04,San Joaquin,077,732212,15527,12087,16,12103,189
2020-08-04,San Luis Obispo,079,281455,2368,1886,13,1899,13
2020-08-04,San Mateo,081,765935,6899,5690,7,5697,116
2020-08-04,Santa Barbara,083,443738,7105,6591,66,6657,61
2020-08-04,Santa Clara,085,1922200,13965,10986,30,11016,175
2020-08-04,Santa Cruz,087,273765,1416,1202,8,1210,4
2020-08-04,Shasta,089,179085,519,335,3,338,9
2020-08-04,Sierra,091,2930,5,1,0,1,0
2020-08-04,Siskiyou,093,43540,103,71,0,71,0
2020-08-04,Solano,095,438530,4527,3690,27,3717,29
2020-08-04,Sonoma,097,501317,4088,3108,7,3115,33
2020-08-04,Stanislaus,099,539301,12484,9359,74,9433,97
2020-08-04,Sutter,101,95872,964,761,1,762,6
2020-08-04,Tehama,103,63373,301,226,2,228,1
2020-08-04,Trinity,105,12862,27,5,6,11,0
2020-08-04,Tulare,107,460477,11974,9866,35,9901,192
2020-08-04,Tuolumne,109,53932,157,127,2,129,0
2020-08-04,Ventura,111,848112,9286,8134,35,8169,75
2020-08-04,Yolo,113,214977,1965,1626,4,1630,37
2020-08-04,Yuba,115,75493,574,398,0,398,1
2020-08-03,Alameda,001,1643700,14422,11817,106,11923,189
2020-08-03,Alpine,003,1148,2,2,0,2,0
2020-08-03,Amador,005,37829,198,119,0,119,0
2020-08-03,Butte,007,227075,1252,989,13,1002,9
2020-08-03,Calaveras,009,45235,153,117,0,117,1
2020-08-03,Colusa,011,21464,392,336,0,336,2
2020-08-03,Contra Costa,013,1133247,11030,8069,30,8099,120
2020-08-03,Del Norte,015,27424,90,68,0,68,0
2020-08-03,El Dorado,017,186661,832,645,0,645,1
2020-08-03,Fresno,019,978130,22590,15945,206,16151,151
2020-08-03,Glenn,021,27897,389,316,0,316,1
2020-08-03,Humboldt,023,135768,276,234,1,235,4
2020-08-03,Imperial,025,180216,10490,7953,9,7962,161
2020-08-03,Inyo,027,18085,85,57,1,58,1
2020-08-03,Kern,029,883053,25733,21285,140,21425,176
2020-08-03,Kings,031,150075,4975,4107,26,4133,47
2020-08-03,Lake,033,64148,245,201,0,201,1
2020-08-03,Lassen,035,31185,645,555,2,557,0
2020-08-03,Los Angeles,037,10098052,208255,194103,627,194730,4706
2020-08-03,Madera,039,155013,3033,2143,7,2150,18
2020-08-03,Marin,041,260295,5524,5001,9,5010,43
2020-08-03,Mariposa,043,17540,63,52,0,52,2
2020-08-03,Mendocino,045,87422,353,248,0,248,1
2020-08-03,Merced,047,269075,6246,4028,4,4032,29
2020-08-03,Modoc,049,8938,7,2,0,2,0
2020-08-03,Mono,051,14174,158,104,1,105,1
2020-08-03,Monterey,053,433212,5915,4806,15,4821,28
2020-08-03,Napa,055,140530,1213,973,0,973,8
2020-08-03,Nevada,057,99092,352,315,13,328,2
2020-08-03,Orange,059,3164182,44677,37705,876,38581,651
2020-08-03,Placer,061,380077,2422,1947,3,1950,16
2020-08-03,Plumas,063,18699,36,25,0,25,0
2020-08-03,Riverside,065,2383286,46483,38642,44,38686,740
2020-08-03,Sacramento,067,1510023,13616,10143,13,10156,142
2020-08-03,San Benito,069,59416,755,603,0,603,2
2020-08-03,San Bernardino,071,2135413,41549,33979,188,34167,444
2020-08-03,San Diego,073,3302833,33422,30228,36,30264,565
2020-08-03,San Francisco,075,870044,7680,6319,7,6326,60
2020-08-03,San Joaquin,077,732212,15330,12007,15,12022,189
2020-08-03,San Luis Obispo,079,281455,2326,1863,10,1873,14
2020-08-03,San Mateo,081,765935,6818,5661,7,5668,115
2020-08-03,Santa Barbara,083,443738,7061,6580,66,6646,59
2020-08-03,Santa Clara,085,1922200,13689,10747,30,10777,172
2020-08-03,Santa Cruz,087,273765,1396,1154,8,1162,4
2020-08-03,Shasta,089,179085,512,322,3,325,9
2020-08-03,Sierra,091,2930,5,1,0,1,0
2020-08-03,Siskiyou,093,43540,99,67,0,67,0
2020-08-03,Solano,095,438530,4458,3610,26,3636,29
2020-08-03,Sonoma,097,501317,3987,3079,6,3085,33
2020-08-03,Stanislaus,099,539301,12275,9308,66,9374,96
2020-08-03,Sutter,101,95872,940,713,1,714,6
2020-08-03,Tehama,103,63373,293,225,2,227,1
2020-08-03,Trinity,105,12862,27,5,6,11,0
2020-08-03,Tulare,107,460477,11790,9703,35,9738,188
2020-08-03,Tuolumne,109,53932,157,123,2,125,0
2020-08-03,Ventura,111,848112,9195,8084,32,8116,74
2020-08-03,Yolo,113,214977,1930,1598,3,1601,37
2020-08-03,Yuba,115,75493,550,393,0,393,1
2020-08-02,Alameda,001,1643700,14175,11696,94,11790,188
2020-08-02,Alpine,003,1148,2,2,0,2,0
2020-08-02,Amador,005,37829,193,117,0,117,0
2020-08-02,Butte,007,227075,1217,987,13,1000,9
2020-08-02,Calaveras,009,45235,150,116,0,116,1
2020-08-02,Colusa,011,21464,387,335,0,335,2
2020-08-02,Contra Costa,013,1133247,10791,7995,30,8025,118
2020-08-02,Del Norte,015,27424,89,68,0,68,0
2020-08-02,El Dorado,017,186661,822,643,0,643,1
2020-08-02,Fresno,019,978130,22315,15759,200,15959,151
2020-08-02,Glenn,021,27897,388,315,0,315,1
2020-08-02,Humboldt,023,135768,271,232,1,233,4
2020-08-02,Imperial,025,180216,10427,7919,8,7927,157
2020-08-02,Inyo,027,18085,84,45,1,46,1
2020-08-02,Kern,029,883053,25435,21162,138,21300,176
2020-08-02,Kings,031,150075,4913,3964,25,3989,47
2020-08-02,Lake,033,64148,240,201,0,201,1
2020-08-02,Lassen,035,31185,645,555,2,557,0
2020-08-02,Los Angeles,037,10098052,206176,192480,609,193089,4698
2020-08-02,Madera,039,155013,2967,2123,5,2128,18
2020-08-02,Marin,041,260295,5489,4985,9,4994,43
2020-08-02,Mariposa,043,17540,61,52,0,52,2
2020-08-02,Mendocino,045,87422,343,247,0,247,1
2020-08-02,Merced,047,269075,6105,4011,4,4015,29
2020-08-02,Modoc,049,8938,7,2,0,2,0
2020-08-02,Mono,051,14174,151,104,1,105,1
2020-08-02,Monterey,053,433212,5789,4698,15,4713,28
2020-08-02,Napa,055,140530,1198,956,0,956,8
2020-08-02,Nevada,057,99092,349,314,13,327,2
2020-08-02,Orange,059,3164182,44296,37266,865,38131,651
2020-08-02,Placer,061,380077,2383,1920,3,1923,15
2020-08-02,Plumas,063,18699,36,25,0,25,0
2020-08-02,Riverside,065,2383286,46050,38507,43,38550,735
2020-08-02,Sacramento,067,1510023,13337,10099,13,10112,142
2020-08-02,San Benito,069,59416,741,599,0,599,2
2020-08-02,San Bernardino,071,2135413,40948,33643,184,33827,443
2020-08-02,San Diego,073,3302833,33082,29885,27,29912,565
2020-08-02,San Francisco,075,870044,7562,6297,7,6304,60
2020-08-02,San Joaquin,077,732212,15044,11937,13,11950,189
2020-08-02,San Luis Obispo,079,281455,2263,1821,10,1831,14
2020-08-02,San Mateo,081,765935,6703,5618,7,5625,115
2020-08-02,Santa Barbara,083,443738,6971,6532,66,6598,59
2020-08-02,Santa Clara,085,1922200,13471,10577,30,10607,172
2020-08-02,Santa Cruz,087,273765,1376,1162,8,1170,4
2020-08-02,Shasta,089,179085,508,318,3,321,9
2020-08-02,Sierra,091,2930,4,1,0,1,0
2020-08-02,Siskiyou,093,43540,99,65,0,65,0
2020-08-02,Solano,095,438530,4399,3609,26,3635,29
2020-08-02,Sonoma,097,501317,3903,3005,6,3011,33
2020-08-02,Stanislaus,099,539301,12060,9277,61,9338,96
2020-08-02,Sutter,101,95872,905,714,1,715,6
2020-08-02,Tehama,103,63373,287,222,2,224,1
2020-08-02,Trinity,105,12862,27,5,6,11,0
2020-08-02,Tulare,107,460477,11581,9593,35,9628,188
2020-08-02,Tuolumne,109,53932,154,123,2,125,0
2020-08-02,Ventura,111,848112,9048,8014,32,8046,73
2020-08-02,Yolo,113,214977,1905,1588,3,1591,37
2020-08-02,Yuba,115,75493,530,393,0,393,1
2020-08-01,Alameda,001,1643700,14063,11590,94,11684,188
2020-08-01,Alpine,003,1148,2,2,0,2,0
2020-08-01,Amador,005,37829,189,109,0,109,0
2020-08-01,Butte,007,227075,1203,976,13,989,9
2020-08-01,Calaveras,009,45235,146,116,0,116,1
2020-08-01,Colusa,011,21464,386,327,0,327,2
2020-08-01,Contra Costa,013,1133247,10658,7867,29,7896,116
2020-08-01,Del Norte,015,27424,89,68,0,68,0
2020-08-01,El Dorado,017,186661,819,637,0,637,1
2020-08-01,Fresno,019,978130,22178,15448,200,15648,149
2020-08-01,Glenn,021,27897,387,311,0,311,1
2020-08-01,Humboldt,023,135768,270,232,1,233,4
2020-08-01,Imperial,025,180216,10391,7919,8,7927,156
2020-08-01,Inyo,027,18085,82,45,1,46,1
2020-08-01,Kern,029,883053,25277,20796,134,20930,176
2020-08-01,Kings,031,150075,4887,3948,25,3973,47
2020-08-01,Lake,033,64148,238,194,0,194,1
2020-08-01,Lassen,035,31185,644,555,2,557,0
2020-08-01,Los Angeles,037,10098052,205283,191023,582,191605,4674
2020-08-01,Madera,039,155013,2928,2103,5,2108,18
2020-08-01,Marin,041,260295,5474,4945,9,4954,43
2020-08-01,Mariposa,043,17540,61,50,0,50,2
2020-08-01,Mendocino,045,87422,336,243,0,243,1
2020-08-01,Merced,047,269075,6057,3972,4,3976,29
2020-08-01,Modoc,049,8938,7,2,0,2,0
2020-08-01,Mono,051,14174,150,104,1,105,1
2020-08-01,Monterey,053,433212,5722,4611,14,4625,28
2020-08-01,Napa,055,140530,1189,923,0,923,8
2020-08-01,Nevada,057,99092,345,305,13,318,2
2020-08-01,Orange,059,3164182,44069,36703,859,37562,648
2020-08-01,Placer,061,380077,2349,1891,3,1894,14
2020-08-01,Plumas,063,18699,35,25,0,25,0
2020-08-01,Riverside,065,2383286,45838,38216,41,38257,704
2020-08-01,Sacramento,067,1510023,13186,10044,13,10057,141
2020-08-01,San Benito,069,59416,730,579,0,579,2
2020-08-01,San Bernardino,071,2135413,40712,32947,183,33130,440
2020-08-01,San Diego,073,3302833,32865,29579,19,29598,565
2020-08-01,San Francisco,075,870044,7500,6296,7,6303,60
2020-08-01,San Joaquin,077,732212,14971,11807,12,11819,189
2020-08-01,San Luis Obispo,079,281455,2234,1798,10,1808,13
2020-08-01,San Mateo,081,765935,6649,5520,7,5527,115
2020-08-01,Santa Barbara,083,443738,6931,6465,66,6531,59
2020-08-01,Santa Clara,085,1922200,13320,10281,29,10310,171
2020-08-01,Santa Cruz,087,273765,1360,1164,8,1172,4
2020-08-01,Shasta,089,179085,503,312,3,315,9
2020-08-01,Sierra,091,2930,3,1,0,1,0
2020-08-01,Siskiyou,093,43540,99,64,0,64,0
2020-08-01,Solano,095,438530,4365,3591,25,3616,29
2020-08-01,Sonoma,097,501317,3857,2890,6,2896,29
2020-08-01,Stanislaus,099,539301,11942,9221,53,9274,96
2020-08-01,Sutter,101,95872,901,714,1,715,6
2020-08-01,Tehama,103,63373,284,220,2,222,1
2020-08-01,Trinity,105,12862,27,5,6,11,0
2020-08-01,Tulare,107,460477,11513,9520,35,9555,188
2020-08-01,Tuolumne,109,53932,154,123,2,125,0
2020-08-01,Ventura,111,848112,9002,7819,32,7851,73
2020-08-01,Yolo,113,214977,1895,1557,3,1560,37
2020-08-01,Yuba,115,75493,525,387,0,387,1
2020-07-31,Alameda,001,1643700,13932,11441,94,11535,187
2020-07-31,Alpine,003,1148,2,2,0,2,0
2020-07-31,Amador,005,37829,188,98,0,98,0
2020-07-31,Butte,007,227075,1180,925,13,938,7
2020-07-31,Calaveras,009,45235,146,112,0,112,1
2020-07-31,Colusa,011,21464,376,319,0,319,2
2020-07-31,Contra Costa,013,1133247,10510,7697,28,7725,113
2020-07-31,Del Norte,015,27424,88,68,0,68,0
2020-07-31,El Dorado,017,186661,808,616,0,616,1
2020-07-31,Fresno,019,978130,21958,15083,200,15283,133
2020-07-31,Glenn,021,27897,380,304,0,304,1
2020-07-31,Humboldt,023,135768,263,229,1,230,4
2020-07-31,Imperial,025,180216,10359,7886,8,7894,155
2020-07-31,Inyo,027,18085,72,45,1,46,1
2020-07-31,Kern,029,883053,25036,20061,130,20191,173
2020-07-31,Kings,031,150075,4859,3807,25,3832,45
2020-07-31,Lake,033,64148,237,191,0,191,1
2020-07-31,Lassen,035,31185,639,544,2,546,0
2020-07-31,Los Angeles,037,10098052,203682,188688,569,189257,4628
2020-07-31,Madera,039,155013,2881,2036,5,2041,19
2020-07-31,Marin,041,260295,5430,4885,6,4891,43
2020-07-31,Mariposa,043,17540,61,49,0,49,2
2020-07-31,Mendocino,045,87422,321,232,0,232,1
2020-07-31,Merced,047,269075,5974,3789,4,3793,30
2020-07-31,Modoc,049,8938,6,0,0,0,0
2020-07-31,Mono,051,14174,149,104,1,105,1
2020-07-31,Monterey,053,433212,5630,4493,14,4507,24
2020-07-31,Napa,055,140530,1177,897,0,897,7
2020-07-31,Nevada,057,99092,343,302,13,315,2
2020-07-31,Orange,059,3164182,43770,36196,844,37040,620
2020-07-31,Placer,061,380077,2324,1853,3,1856,14
2020-07-31,Plumas,063,18699,34,25,0,25,0
2020-07-31,Riverside,065,2383286,45448,37612,40,37652,694
2020-07-31,Sacramento,067,1510023,13008,9872,13,9885,132
2020-07-31,San Benito,069,59416,722,567,0,567,2
2020-07-31,San Bernardino,071,2135413,40382,32332,182,32514,434
2020-07-31,San Diego,073,3302833,32631,29050,11,29061,561
2020-07-31,San Francisco,075,870044,7401,6126,7,6133,60
2020-07-31,San Joaquin,077,732212,14831,11561,12,11573,177
2020-07-31,San Luis Obispo,079,281455,2165,1746,10,1756,12
2020-07-31,San Mateo,081,765935,6577,5416,7,5423,115
2020-07-31,Santa Barbara,083,443738,6864,6375,66,6441,58
2020-07-31,Santa Clara,085,1922200,13099,9863,29,9892,171
2020-07-31,Santa Cruz,087,273765,1337,1118,8,1126,4
2020-07-31,Shasta,089,179085,493,305,3,308,9
2020-07-31,Sierra,091,2930,3,1,0,1,0
2020-07-31,Siskiyou,093,43540,97,61,0,61,0
2020-07-31,Solano,095,438530,4318,3510,24,3534,29
2020-07-31,Sonoma,097,501317,3799,2745,6,2751,27
2020-07-31,Stanislaus,099,539301,11835,9061,48,9109,94
2020-07-31,Sutter,101,95872,896,714,1,715,6
2020-07-31,Tehama,103,63373,281,213,2,215,1
2020-07-31,Trinity,105,12862,27,5,6,11,0
2020-07-31,Tulare,107,460477,11392,9365,35,9400,184
2020-07-31,Tuolumne,109,53932,154,120,2,122,0
2020-07-31,Ventura,111,848112,8927,7521,32,7553,71
2020-07-31,Yolo,113,214977,1869,1522,3,1525,38
2020-07-31,Yuba,115,75493,516,369,0,369,1
2020-07-30,Alameda,001,1643700,13729,11303,54,11357,185
2020-07-30,Alpine,003,1148,2,2,0,2,0
2020-07-30,Amador,005,37829,170,97,0,97,0
2020-07-30,Butte,007,227075,1164,915,13,928,7
2020-07-30,Calaveras,009,45235,142,111,0,111,1
2020-07-30,Colusa,011,21464,373,315,0,315,2
2020-07-30,Contra Costa,013,1133247,10325,7615,27,7642,112
2020-07-30,Del Norte,015,27424,88,68,0,68,0
2020-07-30,El Dorado,017,186661,801,608,0,608,1
2020-07-30,Fresno,019,978130,21622,14793,194,14987,133
2020-07-30,Glenn,021,27897,373,297,0,297,1
2020-07-30,Humboldt,023,135768,261,228,1,229,4
2020-07-30,Imperial,025,180216,10300,7849,8,7857,151
2020-07-30,Inyo,027,18085,68,44,1,45,1
2020-07-30,Kern,029,883053,24743,19552,126,19678,171
2020-07-30,Kings,031,150075,4755,3785,25,3810,43
2020-07-30,Lake,033,64148,231,181,0,181,1
2020-07-30,Lassen,035,31185,636,544,2,546,0
2020-07-30,Los Angeles,037,10098052,201653,186177,538,186715,4564
2020-07-30,Madera,039,155013,2811,2007,5,2012,18
2020-07-30,Marin,041,260295,5388,4835,5,4840,39
2020-07-30,Mariposa,043,17540,61,49,0,49,1
2020-07-30,Mendocino,045,87422,314,232,0,232,1
2020-07-30,Merced,047,269075,5809,3695,4,3699,30
2020-07-30,Modoc,049,8938,6,0,0,0,0
2020-07-30,Mono,051,14174,148,104,1,105,1
2020-07-30,Monterey,053,433212,5518,4352,14,4366,24
2020-07-30,Napa,055,140530,1160,874,0,874,7
2020-07-30,Nevada,057,99092,338,292,13,305,2
2020-07-30,Orange,059,3164182,43355,36105,819,36924,607
2020-07-30,Placer,061,380077,2273,1821,3,1824,14
2020-07-30,Plumas,063,18699,33,25,0,25,0
2020-07-30,Riverside,065,2383286,44907,37308,40,37348,685
2020-07-30,Sacramento,067,1510023,12789,9704,13,9717,126
2020-07-30,San Benito,069,59416,709,558,0,558,2
2020-07-30,San Bernardino,071,2135413,39858,32010,182,32192,427
2020-07-30,San Diego,073,3302833,32284,28670,9,28679,558
2020-07-30,San Francisco,075,870044,7301,6107,7,6114,59
2020-07-30,San Joaquin,077,732212,14637,11435,12,11447,161
2020-07-30,San Luis Obispo,079,281455,2129,1703,10,1713,12
2020-07-30,San Mateo,081,765935,6482,5369,7,5376,115
2020-07-30,Santa Barbara,083,443738,6784,6273,66,6339,52
2020-07-30,Santa Clara,085,1922200,12863,9708,28,9736,170
2020-07-30,Santa Cruz,087,273765,1309,1087,8,1095,4
2020-07-30,Shasta,089,179085,489,306,3,309,8
2020-07-30,Sierra,091,2930,3,1,0,1,0
2020-07-30,Siskiyou,093,43540,96,60,0,60,0
2020-07-30,Solano,095,438530,4267,3463,24,3487,29
2020-07-30,Sonoma,097,501317,3727,2684,6,2690,25
2020-07-30,Stanislaus,099,539301,11622,8890,40,8930,94
2020-07-30,Sutter,101,95872,877,698,1,699,6
2020-07-30,Tehama,103,63373,278,208,2,210,1
2020-07-30,Trinity,105,12862,26,4,6,10,0
2020-07-30,Tulare,107,460477,11263,9167,35,9202,177
2020-07-30,Tuolumne,109,53932,153,119,2,121,0
2020-07-30,Ventura,111,848112,8815,7304,30,7334,69
2020-07-30,Yolo,113,214977,1849,1511,3,1514,37
2020-07-30,Yuba,115,75493,503,362,0,362,1
2020-07-29,Alameda,001,1643700,13510,11177,49,11226,180
2020-07-29,Alpine,003,1148,2,2,0,2,0
2020-07-29,Amador,005,37829,162,80,0,80,0
2020-07-29,Butte,007,227075,1138,889,11,900,7
2020-07-29,Calaveras,009,45235,136,107,0,107,1
2020-07-29,Colusa,011,21464,369,302,0,302,2
2020-07-29,Contra Costa,013,1133247,10121,7520,27,7547,108
2020-07-29,Del Norte,015,27424,88,68,0,68,0
2020-07-29,El Dorado,017,186661,791,588,0,588,1
2020-07-29,Fresno,019,978130,21330,14312,194,14506,125
2020-07-29,Glenn,021,27897,366,294,0,294,1
2020-07-29,Humboldt,023,135768,258,221,1,222,4
2020-07-29,Imperial,025,180216,10252,7825,8,7833,147
2020-07-29,Inyo,027,18085,63,44,1,45,1
2020-07-29,Kern,029,883053,24405,19073,123,19196,162
2020-07-29,Kings,031,150075,4707,3755,25,3780,43
2020-07-29,Lake,033,64148,229,179,0,179,1
2020-07-29,Lassen,035,31185,621,513,2,515,0
2020-07-29,Los Angeles,037,10098052,199627,183600,521,184121,4523
2020-07-29,Madera,039,155013,2757,1941,5,1946,18
2020-07-29,Marin,041,260295,5350,4747,5,4752,34
2020-07-29,Mariposa,043,17540,60,47,0,47,1
2020-07-29,Mendocino,045,87422,306,228,0,228,0
2020-07-29,Merced,047,269075,5669,3605,4,3609,25
2020-07-29,Modoc,049,8938,5,0,0,0,0
2020-07-29,Mono,051,14174,145,102,1,103,1
2020-07-29,Monterey,053,433212,5419,4252,14,4266,24
2020-07-29,Napa,055,140530,1132,866,0,866,7
2020-07-29,Nevada,057,99092,334,288,13,301,1
2020-07-29,Orange,059,3164182,42921,35339,807,36146,589
2020-07-29,Placer,061,380077,2241,1798,3,1801,14
2020-07-29,Plumas,063,18699,33,25,0,25,0
2020-07-29,Riverside,065,2383286,44315,36968,40,37008,678
2020-07-29,Sacramento,067,1510023,12543,9538,13,9551,122
2020-07-29,San Benito,069,59416,694,537,0,537,2
2020-07-29,San Bernardino,071,2135413,39369,31168,171,31339,417
2020-07-29,San Diego,073,3302833,31959,28289,8,28297,552
2020-07-29,San Francisco,075,870044,7207,6041,7,6048,56
2020-07-29,San Joaquin,077,732212,14389,11249,9,11258,154
2020-07-29,San Luis Obispo,079,281455,2108,1673,10,1683,11
2020-07-29,San Mateo,081,765935,6394,5305,7,5312,114
2020-07-29,Santa Barbara,083,443738,6716,6215,66,6281,31
2020-07-29,Santa Clara,085,1922200,12656,9567,28,9595,165
2020-07-29,Santa Cruz,087,273765,1285,1051,8,1059,4
2020-07-29,Shasta,089,179085,477,297,3,300,8
2020-07-29,Sierra,091,2930,2,1,0,1,0
2020-07-29,Siskiyou,093,43540,94,58,0,58,0
2020-07-29,Solano,095,438530,4213,3380,24,3404,29
2020-07-29,Sonoma,097,501317,3650,2598,6,2604,26
2020-07-29,Stanislaus,099,539301,11401,8745,34,8779,94
2020-07-29,Sutter,101,95872,849,678,1,679,6
2020-07-29,Tehama,103,63373,274,206,2,208,1
2020-07-29,Trinity,105,12862,26,4,6,10,0
2020-07-29,Tulare,107,460477,11092,9028,35,9063,156
2020-07-29,Tuolumne,109,53932,153,118,2,120,0
2020-07-29,Ventura,111,848112,8710,7161,30,7191,68
2020-07-29,Yolo,113,214977,1823,1488,3,1491,36
2020-07-29,Yuba,115,75493,487,350,0,350,1
2020-07-28,Alameda,001,1643700,13282,10875,48,10923,180
2020-07-28,Alpine,003,1148,2,2,0,2,0
2020-07-28,Amador,005,37829,152,77,0,77,0
2020-07-28,Butte,007,227075,1103,857,11,868,7
2020-07-28,Calaveras,009,45235,135,105,0,105,1
2020-07-28,Colusa,011,21464,363,290,0,290,2
2020-07-28,Contra Costa,013,1133247,9899,7426,27,7453,107
2020-07-28,Del Norte,015,27424,87,68,0,68,0
2020-07-28,El Dorado,017,186661,776,558,0,558,1
2020-07-28,Fresno,019,978130,20994,13933,188,14121,125
2020-07-28,Glenn,021,27897,364,289,0,289,1
2020-07-28,Humboldt,023,135768,257,218,1,219,4
2020-07-28,Imperial,025,180216,10216,7804,8,7812,145
2020-07-28,Inyo,027,18085,61,43,1,44,1
2020-07-28,Kern,029,883053,24042,18834,117,18951,155
2020-07-28,Kings,031,150075,4661,3721,25,3746,41
2020-07-28,Lake,033,64148,225,179,0,179,1
2020-07-28,Lassen,035,31185,615,508,2,510,0
2020-07-28,Los Angeles,037,10098052,197398,179107,498,179605,4435
2020-07-28,Madera,039,155013,2691,1889,5,1894,18
2020-07-28,Marin,041,260295,5281,4698,5,4703,23
2020-07-28,Mariposa,043,17540,58,45,0,45,1
2020-07-28,Mendocino,045,87422,295,222,0,222,0
2020-07-28,Merced,047,269075,5524,3446,4,3450,23
2020-07-28,Modoc,049,8938,4,0,0,0,0
2020-07-28,Mono,051,14174,144,102,1,103,1
2020-07-28,Monterey,053,433212,5298,4047,14,4061,22
2020-07-28,Napa,055,140530,1110,824,0,824,6
2020-07-28,Nevada,057,99092,329,278,13,291,1
2020-07-28,Orange,059,3164182,42463,34832,794,35626,582
2020-07-28,Placer,061,380077,2206,1759,3,1762,14
2020-07-28,Plumas,063,18699,33,22,0,22,0
2020-07-28,Riverside,065,2383286,43713,36458,40,36498,668
2020-07-28,Sacramento,067,1510023,12284,9429,12,9441,117
2020-07-28,San Benito,069,59416,684,503,0,503,2
2020-07-28,San Bernardino,071,2135413,38845,30493,167,30660,412
2020-07-28,San Diego,073,3302833,31609,28007,6,28013,547
2020-07-28,San Francisco,075,870044,7094,5888,7,5895,56
2020-07-28,San Joaquin,077,732212,14106,10958,7,10965,141
2020-07-28,San Luis Obispo,079,281455,2075,1636,10,1646,9
2020-07-28,San Mateo,081,765935,6320,5171,7,5178,114
2020-07-28,Santa Barbara,083,443738,6653,6110,64,6174,31
2020-07-28,Santa Clara,085,1922200,12421,9307,28,9335,165
2020-07-28,Santa Cruz,087,273765,1258,1018,8,1026,4
2020-07-28,Shasta,089,179085,465,275,3,278,8
2020-07-28,Sierra,091,2930,2,1,0,1,0
2020-07-28,Siskiyou,093,43540,90,57,0,57,0
2020-07-28,Solano,095,438530,4166,3292,23,3315,29
2020-07-28,Sonoma,097,501317,3577,2553,6,2559,20
2020-07-28,Stanislaus,099,539301,11179,8492,26,8518,92
2020-07-28,Sutter,101,95872,812,653,0,653,2
2020-07-28,Tehama,103,63373,269,199,2,201,1
2020-07-28,Trinity,105,12862,26,3,6,9,0
2020-07-28,Tulare,107,460477,10905,8787,35,8822,96
2020-07-28,Tuolumne,109,53932,152,116,2,118,0
2020-07-28,Ventura,111,848112,8584,7045,29,7074,68
2020-07-28,Yolo,113,214977,1795,1459,3,1462,36
2020-07-28,Yuba,115,75493,470,333,0,333,1
2020-07-27,Alameda,001,1643700,13055,10645,45,10690,176
2020-07-27,Alpine,003,1148,2,2,0,2,0
2020-07-27,Amador,005,37829,147,72,0,72,0
2020-07-27,Butte,007,227075,1076,843,11,854,7
2020-07-27,Calaveras,009,45235,131,103,0,103,1
2020-07-27,Colusa,011,21464,356,271,0,271,2
2020-07-27,Contra Costa,013,1133247,9677,7256,27,7283,104
2020-07-27,Del Norte,015,27424,86,67,0,67,0
2020-07-27,El Dorado,017,186661,764,548,0,548,1
2020-07-27,Fresno,019,978130,20647,13485,182,13667,117
2020-07-27,Glenn,021,27897,362,277,0,277,1
2020-07-27,Humboldt,023,135768,252,218,1,219,4
2020-07-27,Imperial,025,180216,10166,7789,8,7797,144
2020-07-27,Inyo,027,18085,61,43,1,44,1
2020-07-27,Kern,029,883053,23540,17994,111,18105,148
2020-07-27,Kings,031,150075,4412,3685,25,3710,39
2020-07-27,Lake,033,64148,221,176,0,176,1
2020-07-27,Lassen,035,31185,615,503,2,505,0
2020-07-27,Los Angeles,037,10098052,194978,176351,480,176831,4379
2020-07-27,Madera,039,155013,2626,1793,5,1798,17
2020-07-27,Marin,041,260295,5193,4669,5,4674,22
2020-07-27,Mariposa,043,17540,58,43,0,43,1
2020-07-27,Mendocino,045,87422,282,209,0,209,0
2020-07-27,Merced,047,269075,5384,3292,4,3296,23
2020-07-27,Modoc,049,8938,3,0,0,0,0
2020-07-27,Mono,051,14174,140,99,1,100,1
2020-07-27,Monterey,053,433212,5108,3960,14,3974,21
2020-07-27,Napa,055,140530,1095,769,0,769,6
2020-07-27,Nevada,057,99092,325,268,13,281,1
2020-07-27,Orange,059,3164182,42023,34649,778,35427,566
2020-07-27,Placer,061,380077,2156,1679,3,1682,12
2020-07-27,Plumas,063,18699,33,22,0,22,0
2020-07-27,Riverside,065,2383286,43034,35822,40,35862,667
2020-07-27,Sacramento,067,1510023,11991,9091,12,9103,114
2020-07-27,San Benito,069,59416,669,498,0,498,2
2020-07-27,San Bernardino,071,2135413,38252,29928,157,30085,401
2020-07-27,San Diego,073,3302833,31235,27509,5,27514,533
2020-07-27,San Francisco,075,870044,7007,5825,7,5832,55
2020-07-27,San Joaquin,077,732212,13817,10728,7,10735,129
2020-07-27,San Luis Obispo,079,281455,2030,1612,10,1622,9
2020-07-27,San Mateo,081,765935,6211,5108,7,5115,113
2020-07-27,Santa Barbara,083,443738,6572,6026,62,6088,30
2020-07-27,Santa Clara,085,1922200,12152,9157,27,9184,166
2020-07-27,Santa Cruz,087,273765,1235,984,8,992,4
2020-07-27,Shasta,089,179085,458,275,3,278,8
2020-07-27,Sierra,091,2930,2,1,0,1,0
2020-07-27,Siskiyou,093,43540,88,54,0,54,0
2020-07-27,Solano,095,438530,4099,3198,22,3220,29
2020-07-27,Sonoma,097,501317,3486,2504,6,2510,20
2020-07-27,Stanislaus,099,539301,10952,8288,18,8306,84
2020-07-27,Sutter,101,95872,786,620,0,620,2
2020-07-27,Tehama,103,63373,261,192,2,194,1
2020-07-27,Trinity,105,12862,26,3,6,9,0
2020-07-27,Tulare,107,460477,10687,8462,35,8497,172
2020-07-27,Tuolumne,109,53932,149,115,2,117,0
2020-07-27,Ventura,111,848112,8456,6998,28,7026,68
2020-07-27,Yolo,113,214977,1750,1439,3,1442,33
2020-07-27,Yuba,115,75493,450,328,0,328,1
2020-07-26,Alameda,001,1643700,12817,10489,44,10533,176
2020-07-26,Alpine,003,1148,2,2,0,2,0
2020-07-26,Amador,005,37829,141,67,0,67,0
2020-07-26,Butte,007,227075,1039,822,11,833,5
2020-07-26,Calaveras,009,45235,128,103,0,103,1
2020-07-26,Colusa,011,21464,347,270,0,270,2
2020-07-26,Contra Costa,013,1133247,9440,7095,27,7122,104
2020-07-26,Del Norte,015,27424,84,67,0,67,0
2020-07-26,El Dorado,017,186661,746,539,0,539,1
2020-07-26,Fresno,019,978130,20256,13209,174,13383,117
2020-07-26,Glenn,021,27897,354,265,0,265,1
2020-07-26,Humboldt,023,135768,246,214,1,215,4
2020-07-26,Imperial,025,180216,10093,7781,8,7789,144
2020-07-26,Inyo,027,18085,56,43,1,44,1
2020-07-26,Kern,029,883053,23016,17394,108,17502,148
2020-07-26,Kings,031,150075,4353,3591,25,3616,39
2020-07-26,Lake,033,64148,213,174,0,174,1
2020-07-26,Lassen,035,31185,574,503,2,505,0
2020-07-26,Los Angeles,037,10098052,192411,174322,462,174784,4364
2020-07-26,Madera,039,155013,2539,1744,5,1749,17
2020-07-26,Marin,041,260295,5147,4595,5,4600,22
2020-07-26,Mariposa,043,17540,56,43,0,43,1
2020-07-26,Mendocino,045,87422,273,206,0,206,0
2020-07-26,Merced,047,269075,5204,3251,3,3254,23
2020-07-26,Modoc,049,8938,3,0,0,0,0
2020-07-26,Mono,051,14174,136,82,1,83,1
2020-07-26,Monterey,053,433212,4942,3901,14,3915,21
2020-07-26,Napa,055,140530,1076,769,0,769,6
2020-07-26,Nevada,057,99092,322,261,13,274,1
2020-07-26,Orange,059,3164182,41498,34352,747,35099,564
2020-07-26,Placer,061,380077,2092,1628,3,1631,12
2020-07-26,Plumas,063,18699,33,22,0,22,0
2020-07-26,Riverside,065,2383286,42474,35636,40,35676,665
2020-07-26,Sacramento,067,1510023,11686,8972,12,8984,114
2020-07-26,San Benito,069,59416,657,495,0,495,2
2020-07-26,San Bernardino,071,2135413,37611,29545,148,29693,400
2020-07-26,San Diego,073,3302833,30839,26986,4,26990,533
2020-07-26,San Francisco,075,870044,6899,5823,7,5830,55
2020-07-26,San Joaquin,077,732212,13524,10637,7,10644,129
2020-07-26,San Luis Obispo,079,281455,1987,1565,10,1575,8
2020-07-26,San Mateo,081,765935,6105,5078,7,5085,113
2020-07-26,Santa Barbara,083,443738,6470,5939,62,6001,30
2020-07-26,Santa Clara,085,1922200,11923,8986,27,9013,166
2020-07-26,Santa Cruz,087,273765,1208,970,8,978,4
2020-07-26,Shasta,089,179085,451,265,3,268,8
2020-07-26,Sierra,091,2930,2,1,0,1,0
2020-07-26,Siskiyou,093,43540,86,54,0,54,0
2020-07-26,Solano,095,438530,4019,3197,20,3217,29
2020-07-26,Sonoma,097,501317,3397,2503,5,2508,20
2020-07-26,Stanislaus,099,539301,10691,8228,17,8245,84
2020-07-26,Sutter,101,95872,772,612,0,612,2
2020-07-26,Tehama,103,63373,254,175,2,177,1
2020-07-26,Trinity,105,12862,26,3,6,9,0
2020-07-26,Tulare,107,460477,10480,8392,35,8427,172
2020-07-26,Tuolumne,109,53932,144,113,2,115,0
2020-07-26,Ventura,111,848112,8249,6844,28,6872,67
2020-07-26,Yolo,113,214977,1719,1408,3,1411,33
2020-07-26,Yuba,115,75493,431,313,0,313,1
2020-07-25,Alameda,001,1643700,12720,10361,42,10403,176
2020-07-25,Alpine,003,1148,2,2,0,2,0
2020-07-25,Amador,005,37829,138,67,0,67,0
2020-07-25,Butte,007,227075,1030,810,11,821,5
2020-07-25,Calaveras,009,45235,124,103,0,103,1
2020-07-25,Colusa,011,21464,340,265,0,265,2
2020-07-25,Contra Costa,013,1133247,9295,6920,27,6947,104
2020-07-25,Del Norte,015,27424,84,67,0,67,0
2020-07-25,El Dorado,017,186661,735,528,0,528,1
2020-07-25,Fresno,019,978130,20070,12866,174,13040,117
2020-07-25,Glenn,021,27897,352,260,0,260,1
2020-07-25,Humboldt,023,135768,243,212,1,213,4
2020-07-25,Imperial,025,180216,10067,7727,8,7735,144
2020-07-25,Inyo,027,18085,55,43,1,44,1
2020-07-25,Kern,029,883053,22798,16910,107,17017,148
2020-07-25,Kings,031,150075,4336,3516,25,3541,39
2020-07-25,Lake,033,64148,211,173,0,173,1
2020-07-25,Lassen,035,31185,574,503,2,505,0
2020-07-25,Los Angeles,037,10098052,191280,172611,455,173066,4357
2020-07-25,Madera,039,155013,2507,1724,5,1729,17
2020-07-25,Marin,041,260295,5131,4562,5,4567,22
2020-07-25,Mariposa,043,17540,55,43,0,43,1
2020-07-25,Mendocino,045,87422,267,190,0,190,0
2020-07-25,Merced,047,269075,5125,3176,3,3179,23
2020-07-25,Modoc,049,8938,3,0,0,0,0
2020-07-25,Mono,051,14174,136,82,1,83,1
2020-07-25,Monterey,053,433212,4865,3805,14,3819,21
2020-07-25,Napa,055,140530,1063,746,0,746,6
2020-07-25,Nevada,057,99092,320,257,13,270,1
2020-07-25,Orange,059,3164182,41278,33978,726,34704,561
2020-07-25,Placer,061,380077,2076,1596,3,1599,12
2020-07-25,Plumas,063,18699,33,22,0,22,0
2020-07-25,Riverside,065,2383286,42205,34921,40,34961,655
2020-07-25,Sacramento,067,1510023,11540,8674,12,8686,113
2020-07-25,San Benito,069,59416,641,492,0,492,2
2020-07-25,San Bernardino,071,2135413,37332,29265,145,29410,394
2020-07-25,San Diego,073,3302833,30578,26703,3,26706,533
2020-07-25,San Francisco,075,870044,6841,5644,7,5651,55
2020-07-25,San Joaquin,077,732212,13398,10347,6,10353,129
2020-07-25,San Luis Obispo,079,281455,1967,1530,9,1539,8
2020-07-25,San Mateo,081,765935,6042,5023,7,5030,113
2020-07-25,Santa Barbara,083,443738,6435,5880,62,5942,30
2020-07-25,Santa Clara,085,1922200,11789,8767,27,8794,166
2020-07-25,Santa Cruz,087,273765,1191,939,8,947,4
2020-07-25,Shasta,089,179085,446,263,1,264,8
2020-07-25,Sierra,091,2930,2,1,0,1,0
2020-07-25,Siskiyou,093,43540,84,54,0,54,0
2020-07-25,Solano,095,438530,3979,3107,18,3125,29
2020-07-25,Sonoma,097,501317,3358,2412,5,2417,20
2020-07-25,Stanislaus,099,539301,10587,7994,14,8008,84
2020-07-25,Sutter,101,95872,753,603,0,603,2
2020-07-25,Tehama,103,63373,253,169,2,171,1
2020-07-25,Trinity,105,12862,26,3,6,9,0
2020-07-25,Tulare,107,460477,10380,8310,35,8345,172
2020-07-25,Tuolumne,109,53932,143,99,2,101,0
2020-07-25,Ventura,111,848112,8176,6662,28,6690,62
2020-07-25,Yolo,113,214977,1704,1357,3,1360,35
2020-07-25,Yuba,115,75493,425,312,0,312,1
2020-07-24,Alameda,001,1643700,12578,10216,39,10255,176
2020-07-24,Alpine,003,1148,2,2,0,2,0
2020-07-24,Amador,005,37829,136,66,0,66,0
2020-07-24,Butte,007,227075,1018,751,11,762,5
2020-07-24,Calaveras,009,45235,120,102,0,102,0
2020-07-24,Colusa,011,21464,337,255,0,255,2
2020-07-24,Contra Costa,013,1133247,9149,6814,27,6841,100
2020-07-24,Del Norte,015,27424,84,66,0,66,0
2020-07-24,El Dorado,017,186661,713,516,0,516,1
2020-07-24,Fresno,019,978130,19844,12564,174,12738,115
2020-07-24,Glenn,021,27897,349,251,0,251,1
2020-07-24,Humboldt,023,135768,240,210,1,211,4
2020-07-24,Imperial,025,180216,10045,7686,8,7694,141
2020-07-24,Inyo,027,18085,55,41,1,42,1
2020-07-24,Kern,029,883053,22557,16124,107,16231,143
2020-07-24,Kings,031,150075,4306,3471,25,3496,39
2020-07-24,Lake,033,64148,209,167,0,167,1
2020-07-24,Lassen,035,31185,574,503,2,505,0
2020-07-24,Los Angeles,037,10098052,189261,169078,444,169522,4302
2020-07-24,Madera,039,155013,2474,1679,5,1684,16
2020-07-24,Marin,041,260295,5104,4517,5,4522,22
2020-07-24,Mariposa,043,17540,55,41,0,41,1
2020-07-24,Mendocino,045,87422,260,188,0,188,0
2020-07-24,Merced,047,269075,5040,3100,3,3103,23
2020-07-24,Modoc,049,8938,3,0,0,0,0
2020-07-24,Mono,051,14174,135,82,1,83,1
2020-07-24,Monterey,053,433212,4793,3748,14,3762,21
2020-07-24,Napa,055,140530,1050,741,0,741,6
2020-07-24,Nevada,057,99092,317,255,13,268,1
2020-07-24,Orange,059,3164182,40990,33530,710,34240,557
2020-07-24,Placer,061,380077,2045,1551,3,1554,12
2020-07-24,Plumas,063,18699,33,22,0,22,0
2020-07-24,Riverside,065,2383286,41782,34513,39,34552,631
2020-07-24,Sacramento,067,1510023,11352,8570,12,8582,110
2020-07-24,San Benito,069,59416,634,485,0,485,2
2020-07-24,San Bernardino,071,2135413,36958,28990,140,29130,386
2020-07-24,San Diego,073,3302833,30278,26100,3,26103,524
2020-07-24,San Francisco,075,870044,6747,5611,7,5618,55
2020-07-24,San Joaquin,077,732212,13249,10190,6,10196,118
2020-07-24,San Luis Obispo,079,281455,1943,1476,9,1485,8
2020-07-24,San Mateo,081,765935,5979,4954,7,4961,112
2020-07-24,Santa Barbara,083,443738,6381,5776,60,5836,30
2020-07-24,Santa Clara,085,1922200,11624,8658,27,8685,165
2020-07-24,Santa Cruz,087,273765,1171,930,8,938,4
2020-07-24,Shasta,089,179085,438,262,1,263,8
2020-07-24,Sierra,091,2930,2,1,0,1,0
2020-07-24,Siskiyou,093,43540,84,53,0,53,0
2020-07-24,Solano,095,438530,3943,3062,15,3077,29
2020-07-24,Sonoma,097,501317,3306,2345,5,2350,20
2020-07-24,Stanislaus,099,539301,10415,7861,11,7872,82
2020-07-24,Sutter,101,95872,742,593,0,593,2
2020-07-24,Tehama,103,63373,245,170,2,172,1
2020-07-24,Trinity,105,12862,25,3,6,9,0
2020-07-24,Tulare,107,460477,10286,8167,33,8200,167
2020-07-24,Tuolumne,109,53932,137,99,2,101,0
2020-07-24,Ventura,111,848112,8091,6553,28,6581,60
2020-07-24,Yolo,113,214977,1690,1329,3,1332,35
2020-07-24,Yuba,115,75493,410,307,0,307,1
2020-07-23,Alameda,001,1643700,12337,9924,39,9963,171
2020-07-23,Alpine,003,1148,2,2,0,2,0
2020-07-23,Amador,005,37829,119,61,0,61,0
2020-07-23,Butte,007,227075,1003,726,10,736,5
2020-07-23,Calaveras,009,45235,113,102,0,102,0
2020-07-23,Colusa,011,21464,329,242,0,242,2
2020-07-23,Contra Costa,013,1133247,8949,6619,25,6644,98
2020-07-23,Del Norte,015,27424,84,66,0,66,0
2020-07-23,El Dorado,017,186661,702,491,0,491,1
2020-07-23,Fresno,019,978130,19488,12164,171,12335,112
2020-07-23,Glenn,021,27897,344,246,0,246,1
2020-07-23,Humboldt,023,135768,239,208,1,209,4
2020-07-23,Imperial,025,180216,9995,7604,8,7612,138
2020-07-23,Inyo,027,18085,53,38,1,39,1
2020-07-23,Kern,029,883053,22150,14491,103,14594,128
2020-07-23,Kings,031,150075,4194,3371,25,3396,39
2020-07-23,Lake,033,64148,200,160,0,160,1
2020-07-23,Lassen,035,31185,571,503,2,505,0
2020-07-23,Los Angeles,037,10098052,186717,167198,418,167616,4265
2020-07-23,Madera,039,155013,2408,1659,4,1663,13
2020-07-23,Marin,041,260295,5052,4423,5,4428,22
2020-07-23,Mariposa,043,17540,55,40,0,40,1
2020-07-23,Mendocino,045,87422,250,178,0,178,0
2020-07-23,Merced,047,269075,4884,2972,3,2975,22
2020-07-23,Modoc,049,8938,3,0,0,0,0
2020-07-23,Mono,051,14174,131,82,1,83,1
2020-07-23,Monterey,053,433212,4675,3655,14,3669,21
2020-07-23,Napa,055,140530,1026,713,0,713,5
2020-07-23,Nevada,057,99092,314,247,13,260,1
2020-07-23,Orange,059,3164182,40494,32863,680,33543,544
2020-07-23,Placer,061,380077,2002,1519,3,1522,12
2020-07-23,Plumas,063,18699,32,21,0,21,0
2020-07-23,Riverside,065,2383286,41176,33833,39,33872,630
2020-07-23,Sacramento,067,1510023,11121,8222,12,8234,108
2020-07-23,San Benito,069,59416,619,478,0,478,2
2020-07-23,San Bernardino,071,2135413,36438,28121,134,28255,369
2020-07-23,San Diego,073,3302833,29904,25109,3,25112,505
2020-07-23,San Francisco,075,870044,6646,5543,7,5550,55
2020-07-23,San Joaquin,077,732212,13030,9861,6,9867,111
2020-07-23,San Luis Obispo,079,281455,1914,1438,9,1447,7
2020-07-23,San Mateo,081,765935,5874,4895,7,4902,113
2020-07-23,Santa Barbara,083,443738,6307,5628,60,5688,30
2020-07-23,Santa Clara,085,1922200,11406,8458,27,8485,165
2020-07-23,Santa Cruz,087,273765,1135,887,8,895,3
2020-07-23,Shasta,089,179085,427,254,1,255,9
2020-07-23,Sierra,091,2930,2,1,0,1,0
2020-07-23,Siskiyou,093,43540,82,53,0,53,0
2020-07-23,Solano,095,438530,3879,2962,13,2975,29
2020-07-23,Sonoma,097,501317,3230,2289,5,2294,18
2020-07-23,Stanislaus,099,539301,10173,7603,11,7614,71
2020-07-23,Sutter,101,95872,709,570,0,570,2
2020-07-23,Tehama,103,63373,239,158,2,160,1
2020-07-23,Trinity,105,12862,24,3,6,9,0
2020-07-23,Tulare,107,460477,10097,7898,33,7931,168
2020-07-23,Tuolumne,109,53932,137,93,2,95,0
2020-07-23,Ventura,111,848112,7967,6303,28,6331,56
2020-07-23,Yolo,113,214977,1672,1279,3,1282,35
2020-07-23,Yuba,115,75493,390,297,0,297,1
2020-07-22,Alameda,001,1643700,12118,9678,38,9716,169
2020-07-22,Alpine,003,1148,2,2,0,2,0
2020-07-22,Amador,005,37829,117,58,0,58,0
2020-07-22,Butte,007,227075,967,694,10,704,5
2020-07-22,Calaveras,009,45235,113,98,0,98,0
2020-07-22,Colusa,011,21464,322,236,0,236,0
2020-07-22,Contra Costa,013,1133247,8723,6401,25,6426,98
2020-07-22,Del Norte,015,27424,84,66,0,66,0
2020-07-22,El Dorado,017,186661,689,466,0,466,1
2020-07-22,Fresno,019,978130,19125,11756,165,11921,110
2020-07-22,Glenn,021,27897,338,236,0,236,1
2020-07-22,Humboldt,023,135768,237,201,1,202,4
2020-07-22,Imperial,025,180216,9935,7533,8,7541,134
2020-07-22,Inyo,027,18085,49,38,1,39,1
2020-07-22,Kern,029,883053,21717,13513,96,13609,127
2020-07-22,Kings,031,150075,4138,3271,25,3296,38
2020-07-22,Lake,033,64148,197,160,0,160,1
2020-07-22,Lassen,035,31185,568,500,2,502,0
2020-07-22,Los Angeles,037,10098052,184069,165242,395,165637,4218
2020-07-22,Madera,039,155013,2333,1578,4,1582,10
2020-07-22,Marin,041,260295,4996,4373,5,4378,23
2020-07-22,Mariposa,043,17540,55,38,0,38,1
2020-07-22,Mendocino,045,87422,243,166,0,166,0
2020-07-22,Merced,047,269075,4757,2828,3,2831,15
2020-07-22,Modoc,049,8938,3,0,0,0,0
2020-07-22,Mono,051,14174,128,82,1,83,1
2020-07-22,Monterey,053,433212,4574,3533,14,3547,20
2020-07-22,Napa,055,140530,1004,687,0,687,5
2020-07-22,Nevada,057,99092,308,239,12,251,1
2020-07-22,Orange,059,3164182,39995,32047,671,32718,522
2020-07-22,Placer,061,380077,1946,1469,3,1472,12
2020-07-22,Plumas,063,18699,31,20,0,20,0
2020-07-22,Riverside,065,2383286,40540,33093,39,33132,612
2020-07-22,Sacramento,067,1510023,10857,8028,11,8039,106
2020-07-22,San Benito,069,59416,605,465,0,465,2
2020-07-22,San Bernardino,071,2135413,35916,26820,123,26943,348
2020-07-22,San Diego,073,3302833,29516,25109,2,25111,505
2020-07-22,San Francisco,075,870044,6542,5473,6,5479,53
2020-07-22,San Joaquin,077,732212,12754,9628,6,9634,102
2020-07-22,San Luis Obispo,079,281455,1868,1373,9,1382,7
2020-07-22,San Mateo,081,765935,5785,4796,7,4803,112
2020-07-22,Santa Barbara,083,443738,6222,5508,58,5566,29
2020-07-22,Santa Clara,085,1922200,11160,8266,27,8293,166
2020-07-22,Santa Cruz,087,273765,1112,866,8,874,3
2020-07-22,Shasta,089,179085,417,246,1,247,9
2020-07-22,Sierra,091,2930,1,1,0,1,0
2020-07-22,Siskiyou,093,43540,81,52,0,52,0
2020-07-22,Solano,095,438530,3818,2839,12,2851,29
2020-07-22,Sonoma,097,501317,3153,2255,5,2260,17
2020-07-22,Stanislaus,099,539301,10002,7401,11,7412,71
2020-07-22,Sutter,101,95872,685,551,0,551,2
2020-07-22,Tehama,103,63373,231,155,2,157,1
2020-07-22,Trinity,105,12862,23,3,6,9,0
2020-07-22,Tulare,107,460477,9864,7640,33,7673,167
2020-07-22,Tuolumne,109,53932,133,91,2,93,0
2020-07-22,Ventura,111,848112,7839,6223,26,6249,56
2020-07-22,Yolo,113,214977,1629,1233,3,1236,34
2020-07-22,Yuba,115,75493,375,288,0,288,1
2020-07-21,Alameda,001,1643700,11904,9390,38,9428,166
2020-07-21,Alpine,003,1148,2,2,0,2,0
2020-07-21,Amador,005,37829,112,55,0,55,0
2020-07-21,Butte,007,227075,922,659,9,668,5
2020-07-21,Calaveras,009,45235,107,96,0,96,0
2020-07-21,Colusa,011,21464,298,227,0,227,0
2020-07-21,Contra Costa,013,1133247,8481,6210,25,6235,98
2020-07-21,Del Norte,015,27424,84,66,0,66,0
2020-07-21,El Dorado,017,186661,681,440,0,440,1
2020-07-21,Fresno,019,978130,18726,11412,159,11571,107
2020-07-21,Glenn,021,27897,331,229,0,229,1
2020-07-21,Humboldt,023,135768,235,198,1,199,4
2020-07-21,Imperial,025,180216,9886,7458,8,7466,128
2020-07-21,Inyo,027,18085,48,38,1,39,1
2020-07-21,Kern,029,883053,21295,11998,90,12088,119
2020-07-21,Kings,031,150075,4073,3187,24,3211,38
2020-07-21,Lake,033,64148,197,157,0,157,1
2020-07-21,Lassen,035,31185,566,474,2,476,0
2020-07-21,Los Angeles,037,10098052,181086,162205,372,162577,4159
2020-07-21,Madera,039,155013,2268,1508,3,1511,10
2020-07-21,Marin,041,260295,4924,4318,5,4323,21
2020-07-21,Mariposa,043,17540,54,37,0,37,1
2020-07-21,Mendocino,045,87422,232,160,0,160,0
2020-07-21,Merced,047,269075,4578,2725,3,2728,15
2020-07-21,Modoc,049,8938,3,0,0,0,0
2020-07-21,Mono,051,14174,124,79,1,80,1
2020-07-21,Monterey,053,433212,4442,3404,13,3417,20
2020-07-21,Napa,055,140530,977,660,0,660,5
2020-07-21,Nevada,057,99092,306,228,10,238,1
2020-07-21,Orange,059,3164182,39498,31356,639,31995,515
2020-07-21,Placer,061,380077,1905,1413,3,1416,11
2020-07-21,Plumas,063,18699,31,19,0,19,0
2020-07-21,Riverside,065,2383286,39839,32231,39,32270,583
2020-07-21,Sacramento,067,1510023,10585,7789,10,7799,102
2020-07-21,San Benito,069,59416,594,444,0,444,2
2020-07-21,San Bernardino,071,2135413,35267,25323,116,25439,343
2020-07-21,San Diego,073,3302833,29067,24522,2,24524,487
2020-07-21,San Francisco,075,870044,6433,5377,6,5383,53
2020-07-21,San Joaquin,077,732212,12425,9150,6,9156,99
2020-07-21,San Luis Obispo,079,281455,1818,1338,9,1347,7
2020-07-21,San Mateo,081,765935,5693,4733,7,4740,111
2020-07-21,Santa Barbara,083,443738,6142,5422,57,5479,29
2020-07-21,Santa Clara,085,1922200,10897,7989,27,8016,164
2020-07-21,Santa Cruz,087,273765,1079,835,8,843,3
2020-07-21,Shasta,089,179085,409,241,1,242,9
2020-07-21,Sierra,091,2930,1,1,0,1,0
2020-07-21,Siskiyou,093,43540,81,48,0,48,0
2020-07-21,Solano,095,438530,3745,2727,12,2739,27
2020-07-21,Sonoma,097,501317,3096,2200,5,2205,17
2020-07-21,Stanislaus,099,539301,9739,6984,11,6995,69
2020-07-21,Sutter,101,95872,669,533,0,533,2
2020-07-21,Tehama,103,63373,221,150,2,152,1
2020-07-21,Trinity,105,12862,23,2,6,8,0
2020-07-21,Tulare,107,460477,9662,7447,33,7480,167
2020-07-21,Tuolumne,109,53932,131,75,2,77,0
2020-07-21,Ventura,111,848112,7707,6131,26,6157,55
2020-07-21,Yolo,113,214977,1575,1204,3,1207,34
2020-07-21,Yuba,115,75493,369,269,0,269,1
2020-07-20,Alameda,001,1643700,11650,9244,37,9281,162
2020-07-20,Alpine,003,1148,2,2,0,2,0
2020-07-20,Amador,005,37829,109,53,0,53,0
2020-07-20,Butte,007,227075,884,586,9,595,4
2020-07-20,Calaveras,009,45235,104,90,0,90,0
2020-07-20,Colusa,011,21464,287,217,0,217,0
2020-07-20,Contra Costa,013,1133247,8273,5823,25,5848,97
2020-07-20,Del Norte,015,27424,84,61,0,61,0
2020-07-20,El Dorado,017,186661,658,407,0,407,0
2020-07-20,Fresno,019,978130,18285,10891,158,11049,106
2020-07-20,Glenn,021,27897,323,225,0,225,1
2020-07-20,Humboldt,023,135768,228,194,1,195,4
2020-07-20,Imperial,025,180216,9846,7337,8,7345,124
2020-07-20,Inyo,027,18085,46,38,1,39,1
2020-07-20,Kern,029,883053,20785,10908,86,10994,118
2020-07-20,Kings,031,150075,4023,3093,24,3117,37
2020-07-20,Lake,033,64148,194,147,0,147,1
2020-07-20,Lassen,035,31185,564,474,2,476,0
2020-07-20,Los Angeles,037,10098052,178128,159202,345,159547,4108
2020-07-20,Madera,039,155013,2193,1433,3,1436,10
2020-07-20,Marin,041,260295,4842,4255,5,4260,21
2020-07-20,Mariposa,043,17540,53,36,0,36,1
2020-07-20,Mendocino,045,87422,219,153,0,153,0
2020-07-20,Merced,047,269075,4408,2584,3,2587,15
2020-07-20,Modoc,049,8938,3,0,0,0,0
2020-07-20,Mono,051,14174,118,78,1,79,1
2020-07-20,Monterey,053,433212,4336,3205,13,3218,19
2020-07-20,Napa,055,140530,942,632,0,632,5
2020-07-20,Nevada,057,99092,298,218,10,228,1
2020-07-20,Orange,059,3164182,38889,30337,609,30946,507
2020-07-20,Placer,061,380077,1853,1364,3,1367,11
2020-07-20,Plumas,063,18699,30,17,0,17,0
2020-07-20,Riverside,065,2383286,39009,31163,39,31202,581
2020-07-20,Sacramento,067,1510023,10257,7369,10,7379,99
2020-07-20,San Benito,069,59416,576,433,0,433,2
2020-07-20,San Bernardino,071,2135413,34456,24226,112,24338,338
2020-07-20,San Diego,073,3302833,28625,24137,2,24139,478
2020-07-20,San Francisco,075,870044,6312,5090,6,5096,53
2020-07-20,San Joaquin,077,732212,12069,8583,6,8589,97
2020-07-20,San Luis Obispo,079,281455,1776,1282,9,1291,6
2020-07-20,San Mateo,081,765935,5592,4609,7,4616,111
2020-07-20,Santa Barbara,083,443738,6026,5266,55,5321,29
2020-07-20,Santa Clara,085,1922200,10668,7711,26,7737,164
2020-07-20,Santa Cruz,087,273765,1047,758,8,766,3
2020-07-20,Shasta,089,179085,394,233,1,234,9
2020-07-20,Sierra,091,2930,1,1,0,1,0
2020-07-20,Siskiyou,093,43540,77,42,0,42,0
2020-07-20,Solano,095,438530,3662,2537,12,2549,26
2020-07-20,Sonoma,097,501317,2988,2148,5,2153,17
2020-07-20,Stanislaus,099,539301,9456,6835,11,6846,58
2020-07-20,Sutter,101,95872,636,507,0,507,2
2020-07-20,Tehama,103,63373,211,146,2,148,1
2020-07-20,Trinity,105,12862,23,2,6,8,0
2020-07-20,Tulare,107,460477,9428,6974,33,7007,166
2020-07-20,Tuolumne,109,53932,130,75,2,77,0
2020-07-20,Ventura,111,848112,7573,5912,26,5938,52
2020-07-20,Yolo,113,214977,1535,1155,3,1158,30
2020-07-20,Yuba,115,75493,349,258,0,258,1
2020-07-19,Alameda,001,1643700,11411,9227,31,9258,162
2020-07-19,Alpine,003,1148,2,2,0,2,0
2020-07-19,Amador,005,37829,102,51,0,51,0
2020-07-19,Butte,007,227075,859,555,9,564,4
2020-07-19,Calaveras,009,45235,102,89,0,89,0
2020-07-19,Colusa,011,21464,279,187,0,187,0
2020-07-19,Contra Costa,013,1133247,7982,5691,23,5714,95
2020-07-19,Del Norte,015,27424,83,61,0,61,0
2020-07-19,El Dorado,017,186661,640,385,0,385,0
2020-07-19,Fresno,019,978130,17761,10639,146,10785,106
2020-07-19,Glenn,021,27897,309,215,0,215,0
2020-07-19,Humboldt,023,135768,220,195,1,196,4
2020-07-19,Imperial,025,180216,9755,7280,8,7288,124
2020-07-19,Inyo,027,18085,42,38,1,39,1
2020-07-19,Kern,029,883053,20168,10094,79,10173,115
2020-07-19,Kings,031,150075,3937,3035,24,3059,37
2020-07-19,Lake,033,64148,189,144,0,144,1
2020-07-19,Lassen,035,31185,545,474,2,476,0
2020-07-19,Los Angeles,037,10098052,174687,156039,322,156361,4100
2020-07-19,Madera,039,155013,2116,1301,3,1304,10
2020-07-19,Marin,041,260295,4787,4172,5,4177,21
2020-07-19,Mariposa,043,17540,49,35,0,35,1
2020-07-19,Mendocino,045,87422,214,137,0,137,0
2020-07-19,Merced,047,269075,4201,2460,3,2463,15
2020-07-19,Modoc,049,8938,3,0,0,0,0
2020-07-19,Mono,051,14174,107,63,1,64,1
2020-07-19,Monterey,053,433212,4216,3079,13,3092,18
2020-07-19,Napa,055,140530,913,612,0,612,5
2020-07-19,Nevada,057,99092,292,210,10,220,1
2020-07-19,Orange,059,3164182,38325,29941,596,30537,505
2020-07-19,Placer,061,380077,1805,1246,3,1249,11
2020-07-19,Plumas,063,18699,30,17,0,17,0
2020-07-19,Riverside,065,2383286,38304,30340,39,30379,581
2020-07-19,Sacramento,067,1510023,9865,6985,10,6995,97
2020-07-19,San Benito,069,59416,560,412,0,412,2
2020-07-19,San Bernardino,071,2135413,33684,23928,100,24028,337
2020-07-19,San Diego,073,3302833,28124,23684,2,23686,478
2020-07-19,San Francisco,075,870044,6165,5094,6,5100,52
2020-07-19,San Joaquin,077,732212,11662,8308,6,8314,93
2020-07-19,San Luis Obispo,079,281455,1732,1262,8,1270,6
2020-07-19,San Mateo,081,765935,5485,4522,7,4529,110
2020-07-19,Santa Barbara,083,443738,5924,5145,52,5197,29
2020-07-19,Santa Clara,085,1922200,10424,7403,26,7429,164
2020-07-19,Santa Cruz,087,273765,1003,753,8,761,3
2020-07-19,Shasta,089,179085,381,218,1,219,9
2020-07-19,Sierra,091,2930,1,1,0,1,0
2020-07-19,Siskiyou,093,43540,75,42,0,42,0
2020-07-19,Solano,095,438530,3556,2551,12,2563,26
2020-07-19,Sonoma,097,501317,2888,2074,5,2079,17
2020-07-19,Stanislaus,099,539301,9160,6508,11,6519,58
2020-07-19,Sutter,101,95872,605,480,0,480,2
2020-07-19,Tehama,103,63373,207,138,2,140,1
2020-07-19,Trinity,105,12862,23,2,6,8,0
2020-07-19,Tulare,107,460477,9180,6856,33,6889,166
2020-07-19,Tuolumne,109,53932,125,75,2,77,0
2020-07-19,Ventura,111,848112,7383,5706,26,5732,52
2020-07-19,Yolo,113,214977,1495,1127,3,1130,30
2020-07-19,Yuba,115,75493,329,240,0,240,1
2020-07-18,Alameda,001,1643700,11275,9089,30,9119,162
2020-07-18,Alpine,003,1148,2,2,0,2,0
2020-07-18,Amador,005,37829,98,49,0,49,0
2020-07-18,Butte,007,227075,850,551,9,560,4
2020-07-18,Calaveras,009,45235,98,89,0,89,0
2020-07-18,Colusa,011,21464,274,182,0,182,0
2020-07-18,Contra Costa,013,1133247,7847,5617,23,5640,95
2020-07-18,Del Norte,015,27424,83,61,0,61,0
2020-07-18,El Dorado,017,186661,637,385,0,385,0
2020-07-18,Fresno,019,978130,17512,10381,144,10525,106
2020-07-18,Glenn,021,27897,303,212,0,212,0
2020-07-18,Humboldt,023,135768,217,189,1,190,4
2020-07-18,Imperial,025,180216,9724,7268,8,7276,124
2020-07-18,Inyo,027,18085,42,38,1,39,1
2020-07-18,Kern,029,883053,19865,9250,76,9326,114
2020-07-18,Kings,031,150075,3897,2996,23,3019,37
2020-07-18,Lake,033,64148,186,142,0,142,1
2020-07-18,Lassen,035,31185,544,474,2,476,0
2020-07-18,Los Angeles,037,10098052,173243,153265,311,153576,4088
2020-07-18,Madera,039,155013,2070,1260,3,1263,9
2020-07-18,Marin,041,260295,4758,4089,5,4094,21
2020-07-18,Mariposa,043,17540,49,35,0,35,1
2020-07-18,Mendocino,045,87422,208,137,0,137,0
2020-07-18,Merced,047,269075,4082,2424,3,2427,15
2020-07-18,Modoc,049,8938,3,0,0,0,0
2020-07-18,Mono,051,14174,105,54,1,55,1
2020-07-18,Monterey,053,433212,4148,3020,13,3033,17
2020-07-18,Napa,055,140530,902,609,0,609,5
2020-07-18,Nevada,057,99092,288,204,9,213,1
2020-07-18,Orange,059,3164182,38006,29603,575,30178,493
2020-07-18,Placer,061,380077,1782,1233,3,1236,11
2020-07-18,Plumas,063,18699,30,17,0,17,0
2020-07-18,Riverside,065,2383286,37951,30245,38,30283,581
2020-07-18,Sacramento,067,1510023,9620,6739,10,6749,95
2020-07-18,San Benito,069,59416,545,407,0,407,2
2020-07-18,San Bernardino,071,2135413,33223,23680,93,23773,336
2020-07-18,San Diego,073,3302833,27821,23116,2,23118,478
2020-07-18,San Francisco,075,870044,6063,5051,6,5057,52
2020-07-18,San Joaquin,077,732212,11449,8118,6,8124,93
2020-07-18,San Luis Obispo,079,281455,1697,1234,8,1242,6
2020-07-18,San Mateo,081,765935,5425,4488,7,4495,110
2020-07-18,Santa Barbara,083,443738,5864,5110,50,5160,29
2020-07-18,Santa Clara,085,1922200,10274,7255,25,7280,164
2020-07-18,Santa Cruz,087,273765,986,751,8,759,3
2020-07-18,Shasta,089,179085,372,216,1,217,9
2020-07-18,Sierra,091,2930,1,1,0,1,0
2020-07-18,Siskiyou,093,43540,71,42,0,42,0
2020-07-18,Solano,095,438530,3515,2503,12,2515,26
2020-07-18,Sonoma,097,501317,2837,2019,5,2024,15
2020-07-18,Stanislaus,099,539301,9025,6344,11,6355,58
2020-07-18,Sutter,101,95872,599,473,0,473,2
2020-07-18,Tehama,103,63373,202,136,2,138,1
2020-07-18,Trinity,105,12862,23,2,6,8,0
2020-07-18,Tulare,107,460477,9089,6810,32,6842,167
2020-07-18,Tuolumne,109,53932,122,75,2,77,0
2020-07-18,Ventura,111,848112,7301,5630,26,5656,52
2020-07-18,Yolo,113,214977,1467,1077,3,1080,30
2020-07-18,Yuba,115,75493,318,237,0,237,1
2020-07-17,Alameda,001,1643700,11134,8893,29,8922,160
2020-07-17,Alpine,003,1148,2,1,0,1,0
2020-07-17,Amador,005,37829,96,48,0,48,0
2020-07-17,Butte,007,227075,836,497,9,506,4
2020-07-17,Calaveras,009,45235,96,86,0,86,0
2020-07-17,Colusa,011,21464,272,146,0,146,0
2020-07-17,Contra Costa,013,1133247,7699,5483,23,5506,93
2020-07-17,Del Norte,015,27424,82,60,0,60,0
2020-07-17,El Dorado,017,186661,621,368,0,368,0
2020-07-17,Fresno,019,978130,17214,9954,144,10098,104
2020-07-17,Glenn,021,27897,296,203,0,203,0
2020-07-17,Humboldt,023,135768,216,185,1,186,4
2020-07-17,Imperial,025,180216,9702,7193,8,7201,120
2020-07-17,Inyo,027,18085,42,38,1,39,1
2020-07-17,Kern,029,883053,19545,8291,75,8366,113
2020-07-17,Kings,031,150075,3858,2978,23,3001,37
2020-07-17,Lake,033,64148,184,139,0,139,1
2020-07-17,Lassen,035,31185,525,391,2,393,0
2020-07-17,Los Angeles,037,10098052,170870,150481,299,150780,4052
2020-07-17,Madera,039,155013,2026,1214,3,1217,9
2020-07-17,Marin,041,260295,4721,3839,5,3844,21
2020-07-17,Mariposa,043,17540,47,35,0,35,1
2020-07-17,Mendocino,045,87422,200,126,0,126,0
2020-07-17,Merced,047,269075,4006,2328,3,2331,12
2020-07-17,Modoc,049,8938,2,0,0,0,0
2020-07-17,Mono,051,14174,100,54,1,55,1
2020-07-17,Monterey,053,433212,4019,2922,13,2935,18
2020-07-17,Napa,055,140530,888,598,0,598,5
2020-07-17,Nevada,057,99092,281,200,9,209,1
2020-07-17,Orange,059,3164182,37543,28962,542,29504,485
2020-07-17,Placer,061,380077,1753,1207,3,1210,11
2020-07-17,Plumas,063,18699,27,16,0,16,0
2020-07-17,Riverside,065,2383286,37353,29639,38,29677,580
2020-07-17,Sacramento,067,1510023,9376,6563,10,6573,95
2020-07-17,San Benito,069,59416,530,399,0,399,2
2020-07-17,San Bernardino,071,2135413,32703,23057,90,23147,322
2020-07-17,San Diego,073,3302833,27432,22491,2,22493,472
2020-07-17,San Francisco,075,870044,5969,4967,6,4973,52
2020-07-17,San Joaquin,077,732212,11205,7925,6,7931,86
2020-07-17,San Luis Obispo,079,281455,1660,1190,8,1198,6
2020-07-17,San Mateo,081,765935,5329,4407,7,4414,110
2020-07-17,Santa Barbara,083,443738,5792,5001,49,5050,29
2020-07-17,Santa Clara,085,1922200,10056,7080,25,7105,164
2020-07-17,Santa Cruz,087,273765,964,716,8,724,3
2020-07-17,Shasta,089,179085,360,213,1,214,8
2020-07-17,Sierra,091,2930,1,1,0,1,0
2020-07-17,Siskiyou,093,43540,70,40,0,40,0
2020-07-17,Solano,095,438530,3466,2452,12,2464,26
2020-07-17,Sonoma,097,501317,2789,1982,5,1987,15
2020-07-17,Stanislaus,099,539301,8851,6220,11,6231,56
2020-07-17,Sutter,101,95872,586,458,0,458,2
2020-07-17,Tehama,103,63373,198,128,2,130,1
2020-07-17,Trinity,105,12862,23,2,6,8,0
2020-07-17,Tulare,107,460477,8953,6671,32,6703,166
2020-07-17,Tuolumne,109,53932,121,73,2,75,0
2020-07-17,Ventura,111,848112,7217,5451,26,5477,51
2020-07-17,Yolo,113,214977,1443,1055,3,1058,30
2020-07-17,Yuba,115,75493,308,231,0,231,1
2020-07-16,Alameda,001,1643700,10900,8719,24,8743,153
2020-07-16,Alpine,003,1148,2,1,0,1,0
2020-07-16,Amador,005,37829,93,46,0,46,0
2020-07-16,Butte,007,227075,799,465,8,473,4
2020-07-16,Calaveras,009,45235,94,82,0,82,0
2020-07-16,Colusa,011,21464,263,140,0,140,0
2020-07-16,Contra Costa,013,1133247,7487,5338,17,5355,91
2020-07-16,Del Norte,015,27424,82,60,0,60,0
2020-07-16,El Dorado,017,186661,604,357,0,357,0
2020-07-16,Fresno,019,978130,16703,9481,135,9616,101
2020-07-16,Glenn,021,27897,287,190,0,190,0
2020-07-16,Humboldt,023,135768,214,184,1,185,4
2020-07-16,Imperial,025,180216,9607,7148,8,7156,113
2020-07-16,Inyo,027,18085,42,38,1,39,1
2020-07-16,Kern,029,883053,19023,7435,73,7508,112
2020-07-16,Kings,031,150075,3691,2937,23,2960,37
2020-07-16,Lake,033,64148,179,128,0,128,1
2020-07-16,Lassen,035,31185,524,355,2,357,0
2020-07-16,Los Angeles,037,10098052,167653,147759,276,148035,3994
2020-07-16,Madera,039,155013,1962,1192,3,1195,8
2020-07-16,Marin,041,260295,4649,3546,5,3551,21
2020-07-16,Mariposa,043,17540,45,34,0,34,1
2020-07-16,Mendocino,045,87422,195,121,0,121,0
2020-07-16,Merced,047,269075,3844,2228,3,2231,12
2020-07-16,Modoc,049,8938,1,0,0,0,0
2020-07-16,Mono,051,14174,97,53,1,54,1
2020-07-16,Monterey,053,433212,3915,2857,12,2869,18
2020-07-16,Napa,055,140530,859,581,0,581,5
2020-07-16,Nevada,057,99092,278,191,9,200,1
2020-07-16,Orange,059,3164182,36842,28525,506,29031,471
2020-07-16,Placer,061,380077,1705,1168,3,1171,11
2020-07-16,Plumas,063,18699,25,16,0,16,0
2020-07-16,Riverside,065,2383286,36608,28904,36,28940,577
2020-07-16,Sacramento,067,1510023,9063,6440,9,6449,91
2020-07-16,San Benito,069,59416,513,389,0,389,2
2020-07-16,San Bernardino,071,2135413,31842,22355,72,22427,321
2020-07-16,San Diego,073,3302833,26945,21857,2,21859,465
2020-07-16,San Francisco,075,870044,5828,4838,6,4844,52
2020-07-16,San Joaquin,077,732212,10842,7713,6,7719,82
2020-07-16,San Luis Obispo,079,281455,1616,1146,8,1154,6
2020-07-16,San Mateo,081,765935,5225,4336,7,4343,110
2020-07-16,Santa Barbara,083,443738,5697,4872,48,4920,28
2020-07-16,Santa Clara,085,1922200,9776,6990,23,7013,164
2020-07-16,Santa Cruz,087,273765,923,698,8,706,3
2020-07-16,Shasta,089,179085,345,208,1,209,7
2020-07-16,Sierra,091,2930,1,1,0,1,0
2020-07-16,Siskiyou,093,43540,67,39,0,39,0
2020-07-16,Solano,095,438530,3372,2372,12,2384,25
2020-07-16,Sonoma,097,501317,2699,1954,5,1959,14
2020-07-16,Stanislaus,099,539301,8569,6077,10,6087,56
2020-07-16,Sutter,101,95872,570,444,0,444,2
2020-07-16,Tehama,103,63373,188,126,2,128,1
2020-07-16,Trinity,105,12862,23,2,5,7,0
2020-07-16,Tulare,107,460477,8737,6467,31,6498,163
2020-07-16,Tuolumne,109,53932,116,71,2,73,0
2020-07-16,Ventura,111,848112,7055,5231,26,5257,50
2020-07-16,Yolo,113,214977,1402,1034,3,1037,29
2020-07-16,Yuba,115,75493,290,221,0,221,1
2020-07-15,Alameda,001,1643700,10695,8615,19,8634,153
2020-07-15,Alpine,003,1148,2,1,0,1,0
2020-07-15,Amador,005,37829,72,44,0,44,0
2020-07-15,Butte,007,227075,757,420,8,428,4
2020-07-15,Calaveras,009,45235,94,75,0,75,0
2020-07-15,Colusa,011,21464,258,135,0,135,0
2020-07-15,Contra Costa,013,1133247,7256,5246,17,5263,90
2020-07-15,Del Norte,015,27424,81,60,0,60,0
2020-07-15,El Dorado,017,186661,580,339,0,339,0
2020-07-15,Fresno,019,978130,16229,9124,128,9252,101
2020-07-15,Glenn,021,27897,278,184,0,184,0
2020-07-15,Humboldt,023,135768,212,181,1,182,4
2020-07-15,Imperial,025,180216,9540,7110,8,7118,110
2020-07-15,Inyo,027,18085,42,36,1,37,1
2020-07-15,Kern,029,883053,18403,7155,70,7225,108
2020-07-15,Kings,031,150075,3630,2906,23,2929,37
2020-07-15,Lake,033,64148,177,122,0,122,1
2020-07-15,Lassen,035,31185,520,319,2,321,0
2020-07-15,Los Angeles,037,10098052,164190,143343,261,143604,3946
2020-07-15,Madera,039,155013,1893,1147,3,1150,4
2020-07-15,Marin,041,260295,4594,3458,5,3463,21
2020-07-15,Mariposa,043,17540,45,34,0,34,1
2020-07-15,Mendocino,045,87422,192,119,0,119,0
2020-07-15,Merced,047,269075,3694,2156,3,2159,12
2020-07-15,Modoc,049,8938,1,0,0,0,0
2020-07-15,Mono,051,14174,95,52,1,53,1
2020-07-15,Monterey,053,433212,3803,2780,12,2792,18
2020-07-15,Napa,055,140530,833,573,0,573,5
2020-07-15,Nevada,057,99092,274,185,7,192,1
2020-07-15,Orange,059,3164182,36042,27718,472,28190,454
2020-07-15,Placer,061,380077,1647,1145,3,1148,11
2020-07-15,Plumas,063,18699,25,16,0,16,0
2020-07-15,Riverside,065,2383286,35826,28492,34,28526,568
2020-07-15,Sacramento,067,1510023,8682,6217,9,6226,91
2020-07-15,San Benito,069,59416,504,388,0,388,2
2020-07-15,San Bernardino,071,2135413,31052,21508,56,21564,317
2020-07-15,San Diego,073,3302833,26478,21448,2,21450,448
2020-07-15,San Francisco,075,870044,5714,4757,6,4763,50
2020-07-15,San Joaquin,077,732212,10410,7381,5,7386,75
2020-07-15,San Luis Obispo,079,281455,1573,1097,8,1105,6
2020-07-15,San Mateo,081,765935,5112,4258,7,4265,109
2020-07-15,Santa Barbara,083,443738,5581,4733,48,4781,28
2020-07-15,Santa Clara,085,1922200,9472,6900,23,6923,164
2020-07-15,Santa Cruz,087,273765,887,660,7,667,3
2020-07-15,Shasta,089,179085,336,193,1,194,7
2020-07-15,Sierra,091,2930,1,1,0,1,0
2020-07-15,Siskiyou,093,43540,66,38,0,38,0
2020-07-15,Solano,095,438530,3277,2343,12,2355,25
2020-07-15,Sonoma,097,501317,2601,1920,5,1925,14
2020-07-15,Stanislaus,099,539301,8272,5777,10,5787,56
2020-07-15,Sutter,101,95872,544,433,0,433,2
2020-07-15,Tehama,103,63373,180,126,2,128,1
2020-07-15,Trinity,105,12862,22,2,5,7,0
2020-07-15,Tulare,107,460477,8526,6320,30,6350,156
2020-07-15,Tuolumne,109,53932,109,68,2,70,0
2020-07-15,Ventura,111,848112,6878,5087,26,5113,50
2020-07-15,Yolo,113,214977,1370,1002,3,1005,27
2020-07-15,Yuba,115,75493,278,221,0,221,1
2020-07-14,Alameda,001,1643700,10353,8388,13,8401,151
2020-07-14,Alpine,003,1148,2,1,0,1,0
2020-07-14,Amador,005,37829,68,44,0,44,0
2020-07-14,Butte,007,227075,711,382,8,390,4
2020-07-14,Calaveras,009,45235,92,74,0,74,0
2020-07-14,Colusa,011,21464,248,128,0,128,0
2020-07-14,Contra Costa,013,1133247,7019,5110,15,5125,90
2020-07-14,Del Norte,015,27424,80,60,0,60,0
2020-07-14,El Dorado,017,186661,565,324,0,324,0
2020-07-14,Fresno,019,978130,15809,8941,123,9064,98
2020-07-14,Glenn,021,27897,268,177,0,177,0
2020-07-14,Humboldt,023,135768,209,175,1,176,4
2020-07-14,Imperial,025,180216,9412,7095,8,7103,109
2020-07-14,Inyo,027,18085,42,35,1,36,1
2020-07-14,Kern,029,883053,17644,6979,57,7036,107
2020-07-14,Kings,031,150075,3563,2867,22,2889,37
2020-07-14,Lake,033,64148,171,120,0,120,1
2020-07-14,Lassen,035,31185,503,263,2,265,0
2020-07-14,Los Angeles,037,10098052,161057,140632,231,140863,3900
2020-07-14,Madera,039,155013,1819,1118,3,1121,4
2020-07-14,Marin,041,260295,4479,3451,5,3456,21
2020-07-14,Mariposa,043,17540,41,32,0,32,1
2020-07-14,Mendocino,045,87422,184,110,0,110,0
2020-07-14,Merced,047,269075,3515,2084,3,2087,12
2020-07-14,Modoc,049,8938,1,0,0,0,0
2020-07-14,Mono,051,14174,85,48,1,49,1
2020-07-14,Monterey,053,433212,3689,2724,12,2736,18
2020-07-14,Napa,055,140530,777,557,0,557,4
2020-07-14,Nevada,057,99092,257,180,6,186,1
2020-07-14,Orange,059,3164182,35162,26915,425,27340,432
2020-07-14,Placer,061,380077,1589,1122,3,1125,11
2020-07-14,Plumas,063,18699,24,14,0,14,0
2020-07-14,Riverside,065,2383286,35069,27850,33,27883,547
2020-07-14,Sacramento,067,1510023,8328,5978,9,5987,87
2020-07-14,San Benito,069,59416,485,360,0,360,2
2020-07-14,San Bernardino,071,2135413,30201,20489,46,20535,316
2020-07-14,San Diego,073,3302833,25858,20887,2,20889,436
2020-07-14,San Francisco,075,870044,5564,4659,5,4664,50
2020-07-14,San Joaquin,077,732212,9982,7143,5,7148,75
2020-07-14,San Luis Obispo,079,281455,1535,1060,8,1068,5
2020-07-14,San Mateo,081,765935,5019,4173,7,4180,108
2020-07-14,Santa Barbara,083,443738,5457,4641,46,4687,28
2020-07-14,Santa Clara,085,1922200,9144,6686,20,6706,164
2020-07-14,Santa Cruz,087,273765,848,639,7,646,3
2020-07-14,Shasta,089,179085,327,190,1,191,7
2020-07-14,Sierra,091,2930,1,1,0,1,0
2020-07-14,Siskiyou,093,43540,65,38,0,38,0
2020-07-14,Solano,095,438530,3177,2266,10,2276,25
2020-07-14,Sonoma,097,501317,2508,1866,5,1871,14
2020-07-14,Stanislaus,099,539301,7898,5631,9,5640,53
2020-07-14,Sutter,101,95872,525,405,0,405,2
2020-07-14,Tehama,103,63373,168,123,2,125,1
2020-07-14,Trinity,105,12862,21,2,5,7,0
2020-07-14,Tulare,107,460477,8280,6199,30,6229,156
2020-07-14,Tuolumne,109,53932,104,68,2,70,0
2020-07-14,Ventura,111,848112,6717,4950,26,4976,50
2020-07-14,Yolo,113,214977,1322,966,3,969,27
2020-07-14,Yuba,115,75493,261,210,0,210,1
2020-07-13,Alameda,001,1643700,10044,8115,13,8128,148
2020-07-13,Alpine,003,1148,2,1,0,1,0
2020-07-13,Amador,005,37829,64,42,0,42,0
2020-07-13,Butte,007,227075,675,354,8,362,4
2020-07-13,Calaveras,009,45235,84,63,0,63,0
2020-07-13,Colusa,011,21464,242,116,0,116,0
2020-07-13,Contra Costa,013,1133247,6746,4882,13,4895,88
2020-07-13,Del Norte,015,27424,74,59,0,59,0
2020-07-13,El Dorado,017,186661,534,298,0,298,0
2020-07-13,Fresno,019,978130,15378,8666,118,8784,95
2020-07-13,Glenn,021,27897,261,168,0,168,0
2020-07-13,Humboldt,023,135768,204,174,1,175,4
2020-07-13,Imperial,025,180216,9327,7052,8,7060,109
2020-07-13,Inyo,027,18085,41,35,1,36,1
2020-07-13,Kern,029,883053,16959,6808,52,6860,107
2020-07-13,Kings,031,150075,3512,2824,22,2846,37
2020-07-13,Lake,033,64148,166,118,0,118,1
2020-07-13,Lassen,035,31185,498,237,2,239,0
2020-07-13,Los Angeles,037,10098052,157826,136368,217,136585,3829
2020-07-13,Madera,039,155013,1750,1059,3,1062,4
2020-07-13,Marin,041,260295,4375,3402,5,3407,21
2020-07-13,Mariposa,043,17540,40,31,0,31,1
2020-07-13,Mendocino,045,87422,180,87,0,87,0
2020-07-13,Merced,047,269075,3366,2007,3,2010,12
2020-07-13,Modoc,049,8938,1,0,0,0,0
2020-07-13,Mono,051,14174,81,47,0,47,1
2020-07-13,Monterey,053,433212,3566,2613,9,2622,18
2020-07-13,Napa,055,140530,741,534,0,534,4
2020-07-13,Nevada,057,99092,243,172,6,178,1
2020-07-13,Orange,059,3164182,34298,25978,393,26371,423
2020-07-13,Placer,061,380077,1544,1096,3,1099,11
2020-07-13,Plumas,063,18699,22,14,0,14,0
2020-07-13,Riverside,065,2383286,34144,27136,31,27167,545
2020-07-13,Sacramento,067,1510023,8031,5747,9,5756,85
2020-07-13,San Benito,069,59416,472,343,0,343,2
2020-07-13,San Bernardino,071,2135413,29323,19610,40,19650,313
2020-07-13,San Diego,073,3302833,25291,20348,2,20350,422
2020-07-13,San Francisco,075,870044,5436,4534,4,4538,50
2020-07-13,San Joaquin,077,732212,9565,6927,5,6932,71
2020-07-13,San Luis Obispo,079,281455,1504,989,8,997,5
2020-07-13,San Mateo,081,765935,4888,4057,7,4064,108
2020-07-13,Santa Barbara,083,443738,5343,4441,45,4486,28
2020-07-13,Santa Clara,085,1922200,8821,6488,19,6507,164
2020-07-13,Santa Cruz,087,273765,810,574,7,581,3
2020-07-13,Shasta,089,179085,316,185,1,186,6
2020-07-13,Sierra,091,2930,1,1,0,1,0
2020-07-13,Siskiyou,093,43540,61,37,0,37,0
2020-07-13,Solano,095,438530,3065,2046,10,2056,23
2020-07-13,Sonoma,097,501317,2397,1818,5,1823,14
2020-07-13,Stanislaus,099,539301,7595,5324,8,5332,53
2020-07-13,Sutter,101,95872,487,379,0,379,2
2020-07-13,Tehama,103,63373,155,112,2,114,1
2020-07-13,Trinity,105,12862,21,2,5,7,0
2020-07-13,Tulare,107,460477,8019,5930,28,5958,147
2020-07-13,Tuolumne,109,53932,96,56,2,58,0
2020-07-13,Ventura,111,848112,6527,4800,23,4823,50
2020-07-13,Yolo,113,214977,1276,941,3,944,27
2020-07-13,Yuba,115,75493,246,194,0,194,1
2020-07-12,Alameda,001,1643700,9773,8056,13,8069,148
2020-07-12,Alpine,003,1148,2,1,0,1,0
2020-07-12,Amador,005,37829,54,40,0,40,0
2020-07-12,Butte,007,227075,625,341,7,348,4
2020-07-12,Calaveras,009,45235,84,62,0,62,0
2020-07-12,Colusa,011,21464,208,116,0,116,0
2020-07-12,Contra Costa,013,1133247,6475,4708,11,4719,88
2020-07-12,Del Norte,015,27424,63,59,0,59,0
2020-07-12,El Dorado,017,186661,512,290,0,290,0
2020-07-12,Fresno,019,978130,14951,8407,113,8520,95
2020-07-12,Glenn,021,27897,248,166,0,166,0
2020-07-12,Humboldt,023,135768,200,174,1,175,4
2020-07-12,Imperial,025,180216,9208,6999,6,7005,109
2020-07-12,Inyo,027,18085,39,35,1,36,1
2020-07-12,Kern,029,883053,16215,6662,49,6711,105
2020-07-12,Kings,031,150075,3450,2779,22,2801,34
2020-07-12,Lake,033,64148,157,114,0,114,1
2020-07-12,Lassen,035,31185,491,237,2,239,0
2020-07-12,Los Angeles,037,10098052,154410,133830,188,134018,3816
2020-07-12,Madera,039,155013,1695,1025,3,1028,4
2020-07-12,Marin,041,260295,4298,3358,5,3363,21
2020-07-12,Mariposa,043,17540,39,31,0,31,1
2020-07-12,Mendocino,045,87422,161,88,0,88,0
2020-07-12,Merced,047,269075,3236,1908,3,1911,12
2020-07-12,Modoc,049,8938,1,0,0,0,0
2020-07-12,Mono,051,14174,71,45,0,45,1
2020-07-12,Monterey,053,433212,3451,2521,9,2530,18
2020-07-12,Napa,055,140530,709,519,0,519,4
2020-07-12,Nevada,057,99092,233,166,6,172,1
2020-07-12,Orange,059,3164182,33423,25399,384,25783,422
2020-07-12,Placer,061,380077,1488,1058,3,1061,11
2020-07-12,Plumas,063,18699,21,14,0,14,0
2020-07-12,Riverside,065,2383286,33384,26404,31,26435,542
2020-07-12,Sacramento,067,1510023,7719,5515,7,5522,85
2020-07-12,San Benito,069,59416,457,324,0,324,2
2020-07-12,San Bernardino,071,2135413,28411,19042,35,19077,312
2020-07-12,San Diego,073,3302833,24662,19929,2,19931,422
2020-07-12,San Francisco,075,870044,5286,4535,4,4539,50
2020-07-12,San Joaquin,077,732212,9203,6703,5,6708,71
2020-07-12,San Luis Obispo,079,281455,1457,972,7,979,5
2020-07-12,San Mateo,081,765935,4770,3988,7,3995,108
2020-07-12,Santa Barbara,083,443738,5213,4353,44,4397,28
2020-07-12,Santa Clara,085,1922200,8583,6252,18,6270,164
2020-07-12,Santa Cruz,087,273765,768,573,5,578,3
2020-07-12,Shasta,089,179085,310,173,1,174,6
2020-07-12,Sierra,091,2930,1,1,0,1,0
2020-07-12,Siskiyou,093,43540,59,36,0,36,0
2020-07-12,Solano,095,438530,2940,2037,10,2047,23
2020-07-12,Sonoma,097,501317,2303,1743,5,1748,13
2020-07-12,Stanislaus,099,539301,7291,5177,8,5185,53
2020-07-12,Sutter,101,95872,469,362,0,362,2
2020-07-12,Tehama,103,63373,148,111,2,113,1
2020-07-12,Trinity,105,12862,21,2,5,7,0
2020-07-12,Tulare,107,460477,7764,5864,27,5891,146
2020-07-12,Tuolumne,109,53932,88,52,2,54,0
2020-07-12,Ventura,111,848112,6311,4724,22,4746,50
2020-07-12,Yolo,113,214977,1235,889,3,892,27
2020-07-12,Yuba,115,75493,235,188,0,188,1
2020-07-11,Alameda,001,1643700,9671,7845,13,7858,148
2020-07-11,Alpine,003,1148,2,1,0,1,0
2020-07-11,Amador,005,37829,50,37,0,37,0
2020-07-11,Butte,007,227075,609,325,7,332,4
2020-07-11,Calaveras,009,45235,81,62,0,62,0
2020-07-11,Colusa,011,21464,203,110,0,110,0
2020-07-11,Contra Costa,013,1133247,6358,4650,11,4661,87
2020-07-11,Del Norte,015,27424,63,59,0,59,0
2020-07-11,El Dorado,017,186661,501,283,0,283,0
2020-07-11,Fresno,019,978130,14691,8086,111,8197,95
2020-07-11,Glenn,021,27897,240,161,0,161,0
2020-07-11,Humboldt,023,135768,199,174,1,175,4
2020-07-11,Imperial,025,180216,9169,6884,6,6890,109
2020-07-11,Inyo,027,18085,39,35,1,36,1
2020-07-11,Kern,029,883053,15858,6509,48,6557,103
2020-07-11,Kings,031,150075,3423,2753,22,2775,33
2020-07-11,Lake,033,64148,156,110,0,110,1
2020-07-11,Lassen,035,31185,490,237,2,239,0
2020-07-11,Los Angeles,037,10098052,152693,130479,178,130657,3802
2020-07-11,Madera,039,155013,1654,988,3,991,4
2020-07-11,Marin,041,260295,4270,3191,5,3196,21
2020-07-11,Mariposa,043,17540,39,31,0,31,1
2020-07-11,Mendocino,045,87422,157,88,0,88,0
2020-07-11,Merced,047,269075,3155,1851,3,1854,12
2020-07-11,Modoc,049,8938,1,0,0,0,0
2020-07-11,Mono,051,14174,68,45,0,45,1
2020-07-11,Monterey,053,433212,3362,2376,8,2384,18
2020-07-11,Napa,055,140530,697,509,0,509,4
2020-07-11,Nevada,057,99092,224,163,5,168,1
2020-07-11,Orange,059,3164182,33046,24430,370,24800,422
2020-07-11,Placer,061,380077,1453,1029,3,1032,11
2020-07-11,Plumas,063,18699,21,12,0,12,0
2020-07-11,Riverside,065,2383286,32993,25994,31,26025,538
2020-07-11,Sacramento,067,1510023,7545,5367,7,5374,84
2020-07-11,San Benito,069,59416,442,314,0,314,2
2020-07-11,San Bernardino,071,2135413,27974,18907,33,18940,310
2020-07-11,San Diego,073,3302833,24277,19371,2,19373,422
2020-07-11,San Francisco,075,870044,5190,4430,3,4433,50
2020-07-11,San Joaquin,077,732212,9025,6518,5,6523,72
2020-07-11,San Luis Obispo,079,281455,1409,930,7,937,4
2020-07-11,San Mateo,081,765935,4702,3956,7,3963,108
2020-07-11,Santa Barbara,083,443738,5144,4283,43,4326,28
2020-07-11,Santa Clara,085,1922200,8424,5959,18,5977,164
2020-07-11,Santa Cruz,087,273765,737,571,5,576,3
2020-07-11,Shasta,089,179085,303,168,1,169,6
2020-07-11,Sierra,091,2930,1,1,0,1,0
2020-07-11,Siskiyou,093,43540,59,36,0,36,0
2020-07-11,Solano,095,438530,2899,2034,10,2044,23
2020-07-11,Sonoma,097,501317,2266,1690,5,1695,13
2020-07-11,Stanislaus,099,539301,7150,4911,8,4919,51
2020-07-11,Sutter,101,95872,453,352,0,352,2
2020-07-11,Tehama,103,63373,146,111,2,113,1
2020-07-11,Trinity,105,12862,21,2,5,7,0
2020-07-11,Tulare,107,460477,7658,5780,27,5807,149
2020-07-11,Tuolumne,109,53932,86,50,2,52,0
2020-07-11,Ventura,111,848112,6215,4545,21,4566,49
2020-07-11,Yolo,113,214977,1206,833,3,836,27
2020-07-11,Yuba,115,75493,225,175,0,175,1
2020-07-10,Alameda,001,1643700,9514,7551,13,7564,147
2020-07-10,Alpine,003,1148,2,1,0,1,0
2020-07-10,Amador,005,37829,46,37,0,37,0
2020-07-10,Butte,007,227075,598,318,7,325,4
2020-07-10,Calaveras,009,45235,81,61,0,61,0
2020-07-10,Colusa,011,21464,197,103,0,103,0
2020-07-10,Contra Costa,013,1133247,6215,4482,11,4493,86
2020-07-10,Del Norte,015,27424,63,57,0,57,0
2020-07-10,El Dorado,017,186661,483,266,0,266,0
2020-07-10,Fresno,019,978130,14359,7760,108,7868,93
2020-07-10,Glenn,021,27897,235,157,0,157,0
2020-07-10,Humboldt,023,135768,198,168,1,169,4
2020-07-10,Imperial,025,180216,9124,6878,5,6883,98
2020-07-10,Inyo,027,18085,39,35,1,36,1
2020-07-10,Kern,029,883053,15425,6344,47,6391,102
2020-07-10,Kings,031,150075,3387,2707,22,2729,33
2020-07-10,Lake,033,64148,149,104,0,104,1
2020-07-10,Lassen,035,31185,489,235,2,237,0
2020-07-10,Los Angeles,037,10098052,150274,127503,172,127675,3750
2020-07-10,Madera,039,155013,1608,914,3,917,4
2020-07-10,Marin,041,260295,4207,3101,5,3106,21
2020-07-10,Mariposa,043,17540,38,31,0,31,1
2020-07-10,Mendocino,045,87422,149,88,0,88,0
2020-07-10,Merced,047,269075,3076,1802,3,1805,12
2020-07-10,Modoc,049,8938,1,0,0,0,0
2020-07-10,Mono,051,14174,67,45,0,45,1
2020-07-10,Monterey,053,433212,3283,2285,8,2293,18
2020-07-10,Napa,055,140530,686,496,0,496,4
2020-07-10,Nevada,057,99092,219,161,5,166,1
2020-07-10,Orange,059,3164182,32458,23692,367,24059,416
2020-07-10,Placer,061,380077,1412,1002,3,1005,11
2020-07-10,Plumas,063,18699,19,12,0,12,0
2020-07-10,Riverside,065,2383286,32476,25481,31,25512,533
2020-07-10,Sacramento,067,1510023,7290,5181,7,5188,81
2020-07-10,San Benito,069,59416,433,302,0,302,2
2020-07-10,San Bernardino,071,2135413,27448,18242,30,18272,308
2020-07-10,San Diego,073,3302833,23896,18862,2,18864,420
2020-07-10,San Francisco,075,870044,5099,4305,3,4308,50
2020-07-10,San Joaquin,077,732212,8792,6225,5,6230,67
2020-07-10,San Luis Obispo,079,281455,1371,891,7,898,4
2020-07-10,San Mateo,081,765935,4637,3844,7,3851,107
2020-07-10,Santa Barbara,083,443738,5047,4177,42,4219,28
2020-07-10,Santa Clara,085,1922200,8200,5819,18,5837,164
2020-07-10,Santa Cruz,087,273765,710,540,5,545,3
2020-07-10,Shasta,089,179085,299,158,1,159,6
2020-07-10,Sierra,091,2930,1,1,0,1,0
2020-07-10,Siskiyou,093,43540,59,31,0,31,0
2020-07-10,Solano,095,438530,2852,1950,10,1960,23
2020-07-10,Sonoma,097,501317,2219,1606,4,1610,13
2020-07-10,Stanislaus,099,539301,6980,4781,8,4789,46
2020-07-10,Sutter,101,95872,446,338,0,338,2
2020-07-10,Tehama,103,63373,145,107,2,109,1
2020-07-10,Trinity,105,12862,21,2,5,7,0
2020-07-10,Tulare,107,460477,7521,5677,27,5704,150
2020-07-10,Tuolumne,109,53932,85,49,2,51,0
2020-07-10,Ventura,111,848112,6101,4416,21,4437,48
2020-07-10,Yolo,113,214977,1182,794,3,797,27
2020-07-10,Yuba,115,75493,211,164,0,164,1
2020-07-09,Alameda,001,1643700,9278,7433,13,7446,146
2020-07-09,Alpine,003,1148,2,1,0,1,0
2020-07-09,Amador,005,37829,43,36,0,36,0
2020-07-09,Butte,007,227075,566,295,7,302,4
2020-07-09,Calaveras,009,45235,80,59,0,59,0
2020-07-09,Colusa,011,21464,189,97,0,97,0
2020-07-09,Contra Costa,013,1133247,5972,4388,11,4399,86
2020-07-09,Del Norte,015,27424,63,57,0,57,0
2020-07-09,El Dorado,017,186661,458,255,0,255,0
2020-07-09,Fresno,019,978130,13904,7385,105,7490,90
2020-07-09,Glenn,021,27897,225,150,0,150,0
2020-07-09,Humboldt,023,135768,195,166,1,167,4
2020-07-09,Imperial,025,180216,9029,6778,5,6783,87
2020-07-09,Inyo,027,18085,37,35,1,36,1
2020-07-09,Kern,029,883053,14780,6100,45,6145,95
2020-07-09,Kings,031,150075,3323,2686,21,2707,33
2020-07-09,Lake,033,64148,146,99,0,99,1
2020-07-09,Lassen,035,31185,433,221,2,223,0
2020-07-09,Los Angeles,037,10098052,147016,125062,148,125210,3698
2020-07-09,Madera,039,155013,1531,850,3,853,4
2020-07-09,Marin,041,260295,4055,2975,4,2979,20
2020-07-09,Mariposa,043,17540,38,32,0,32,1
2020-07-09,Mendocino,045,87422,145,88,0,88,0
2020-07-09,Merced,047,269075,2943,1728,3,1731,11
2020-07-09,Modoc,049,8938,1,0,0,0,0
2020-07-09,Mono,051,14174,63,45,0,45,1
2020-07-09,Monterey,053,433212,3158,2223,8,2231,17
2020-07-09,Napa,055,140530,669,468,0,468,4
2020-07-09,Nevada,057,99092,213,156,5,161,1
2020-07-09,Orange,059,3164182,31487,22960,349,23309,407
2020-07-09,Placer,061,380077,1369,982,3,985,11
2020-07-09,Plumas,063,18699,19,12,0,12,0
2020-07-09,Riverside,065,2383286,31583,24980,30,25010,529
2020-07-09,Sacramento,067,1510023,6963,4950,7,4957,81
2020-07-09,San Benito,069,59416,417,295,0,295,2
2020-07-09,San Bernardino,071,2135413,26575,17339,24,17363,307
2020-07-09,San Diego,073,3302833,23304,18404,2,18406,415
2020-07-09,San Francisco,075,870044,4967,4143,3,4146,50
2020-07-09,San Joaquin,077,732212,8433,6004,5,6009,66
2020-07-09,San Luis Obispo,079,281455,1331,869,7,876,3
2020-07-09,San Mateo,081,765935,4510,3792,7,3799,106
2020-07-09,Santa Barbara,083,443738,4915,4068,42,4110,28
2020-07-09,Santa Clara,085,1922200,7943,5638,18,5656,164
2020-07-09,Santa Cruz,087,273765,683,526,5,531,3
2020-07-09,Shasta,089,179085,293,155,1,156,5
2020-07-09,Sierra,091,2930,1,1,0,1,0
2020-07-09,Siskiyou,093,43540,55,31,0,31,0
2020-07-09,Solano,095,438530,2754,1892,10,1902,23
2020-07-09,Sonoma,097,501317,2133,1584,4,1588,13
2020-07-09,Stanislaus,099,539301,6664,4633,7,4640,46
2020-07-09,Sutter,101,95872,429,321,0,321,2
2020-07-09,Tehama,103,63373,140,102,2,104,1
2020-07-09,Trinity,105,12862,21,2,5,7,0
2020-07-09,Tulare,107,460477,7302,5501,26,5527,146
2020-07-09,Tuolumne,109,53932,84,47,2,49,0
2020-07-09,Ventura,111,848112,5933,4278,21,4299,47
2020-07-09,Yolo,113,214977,1135,764,3,767,27
2020-07-09,Yuba,115,75493,194,152,0,152,1
2020-07-08,Alameda,001,1643700,8986,7335,13,7348,142
2020-07-08,Alpine,003,1148,2,1,0,1,0
2020-07-08,Amador,005,37829,40,35,0,35,0
2020-07-08,Butte,007,227075,529,281,7,288,3
2020-07-08,Calaveras,009,45235,75,58,0,58,0
2020-07-08,Colusa,011,21464,176,90,0,90,0
2020-07-08,Contra Costa,013,1133247,5726,4268,9,4277,84
2020-07-08,Del Norte,015,27424,61,57,0,57,0
2020-07-08,El Dorado,017,186661,437,248,0,248,0
2020-07-08,Fresno,019,978130,13487,7102,97,7199,86
2020-07-08,Glenn,021,27897,214,146,0,146,0
2020-07-08,Humboldt,023,135768,192,162,1,163,4
2020-07-08,Imperial,025,180216,8942,6727,5,6732,76
2020-07-08,Inyo,027,18085,37,35,1,36,1
2020-07-08,Kern,029,883053,14202,5873,43,5916,91
2020-07-08,Kings,031,150075,3263,2629,18,2647,33
2020-07-08,Lake,033,64148,139,97,0,97,1
2020-07-08,Lassen,035,31185,337,221,2,223,0
2020-07-08,Los Angeles,037,10098052,143816,123462,121,123583,3650
2020-07-08,Madera,039,155013,1461,828,3,831,4
2020-07-08,Marin,041,260295,3956,2756,4,2760,17
2020-07-08,Mariposa,043,17540,38,31,0,31,1
2020-07-08,Mendocino,045,87422,132,84,0,84,0
2020-07-08,Merced,047,269075,2823,1578,3,1581,11
2020-07-08,Modoc,049,8938,1,0,0,0,0
2020-07-08,Mono,051,14174,60,45,0,45,1
2020-07-08,Monterey,053,433212,3040,2182,7,2189,17
2020-07-08,Napa,055,140530,647,468,0,468,4
2020-07-08,Nevada,057,99092,204,156,5,161,1
2020-07-08,Orange,059,3164182,30535,22088,344,22432,378
2020-07-08,Placer,061,380077,1322,948,3,951,11
2020-07-08,Plumas,063,18699,19,12,0,12,0
2020-07-08,Riverside,065,2383286,30619,24042,29,24071,508
2020-07-08,Sacramento,067,1510023,6675,4799,7,4806,80
2020-07-08,San Benito,069,59416,401,282,0,282,2
2020-07-08,San Bernardino,071,2135413,25720,16510,20,16530,296
2020-07-08,San Diego,073,3302833,22737,17844,2,17846,406
2020-07-08,San Francisco,075,870044,4878,4093,3,4096,50
2020-07-08,San Joaquin,077,732212,8090,5759,5,5764,61
2020-07-08,San Luis Obispo,079,281455,1279,825,7,832,2
2020-07-08,San Mateo,081,765935,4389,3733,7,3740,106
2020-07-08,Santa Barbara,083,443738,4796,3985,42,4027,28
2020-07-08,Santa Clara,085,1922200,7710,5510,18,5528,164
2020-07-08,Santa Cruz,087,273765,650,509,4,513,3
2020-07-08,Shasta,089,179085,284,148,1,149,6
2020-07-08,Sierra,091,2930,1,1,0,1,0
2020-07-08,Siskiyou,093,43540,55,31,0,31,0
2020-07-08,Solano,095,438530,2638,1821,10,1831,23
2020-07-08,Sonoma,097,501317,2058,1495,4,1499,9
2020-07-08,Stanislaus,099,539301,6364,4344,7,4351,46
2020-07-08,Sutter,101,95872,404,298,0,298,2
2020-07-08,Tehama,103,63373,134,100,2,102,1
2020-07-08,Trinity,105,12862,20,2,5,7,0
2020-07-08,Tulare,107,460477,7110,5307,21,5328,138
2020-07-08,Tuolumne,109,53932,80,42,2,44,0
2020-07-08,Ventura,111,848112,5768,4139,21,4160,47
2020-07-08,Yolo,113,214977,1092,727,3,730,26
2020-07-08,Yuba,115,75493,181,145,0,145,1
2020-07-07,Alameda,001,1643700,8666,7097,12,7109,141
2020-07-07,Alpine,003,1148,2,1,0,1,0
2020-07-07,Amador,005,37829,40,33,0,33,0
2020-07-07,Butte,007,227075,486,269,7,276,3
2020-07-07,Calaveras,009,45235,73,58,0,58,0
2020-07-07,Colusa,011,21464,143,84,0,84,0
2020-07-07,Contra Costa,013,1133247,5490,4131,8,4139,84
2020-07-07,Del Norte,015,27424,61,57,0,57,0
2020-07-07,El Dorado,017,186661,417,244,0,244,0
2020-07-07,Fresno,019,978130,13034,6738,97,6835,84
2020-07-07,Glenn,021,27897,205,145,0,145,0
2020-07-07,Humboldt,023,135768,189,150,1,151,4
2020-07-07,Imperial,025,180216,8843,6678,5,6683,51
2020-07-07,Inyo,027,18085,36,32,1,33,1
2020-07-07,Kern,029,883053,13503,5645,39,5684,88
2020-07-07,Kings,031,150075,3200,2623,16,2639,33
2020-07-07,Lake,033,64148,129,94,0,94,1
2020-07-07,Lassen,035,31185,266,219,2,221,0
2020-07-07,Los Angeles,037,10098052,140249,121026,113,121139,3588
2020-07-07,Madera,039,155013,1417,794,3,797,4
2020-07-07,Marin,041,260295,3867,2627,4,2631,17
2020-07-07,Mariposa,043,17540,38,31,0,31,1
2020-07-07,Mendocino,045,87422,124,82,0,82,0
2020-07-07,Merced,047,269075,2649,1531,3,1534,10
2020-07-07,Modoc,049,8938,1,0,0,0,0
2020-07-07,Mono,051,14174,59,42,0,42,1
2020-07-07,Monterey,053,433212,2897,2166,7,2173,17
2020-07-07,Napa,055,140530,628,459,0,459,4
2020-07-07,Nevada,057,99092,198,150,5,155,1
2020-07-07,Orange,059,3164182,29524,21741,330,22071,373
2020-07-07,Placer,061,380077,1281,930,3,933,11
2020-07-07,Plumas,063,18699,17,12,0,12,0
2020-07-07,Riverside,065,2383286,29604,23279,29,23308,499
2020-07-07,Sacramento,067,1510023,6331,4592,7,4599,76
2020-07-07,San Benito,069,59416,383,274,0,274,2
2020-07-07,San Bernardino,071,2135413,24849,16004,18,16022,277
2020-07-07,San Diego,073,3302833,22022,17580,2,17582,399
2020-07-07,San Francisco,075,870044,4785,4045,2,4047,50
2020-07-07,San Joaquin,077,732212,7748,5547,5,5552,59
2020-07-07,San Luis Obispo,079,281455,1218,795,7,802,2
2020-07-07,San Mateo,081,765935,4274,3691,7,3698,106
2020-07-07,Santa Barbara,083,443738,4668,3866,41,3907,27
2020-07-07,Santa Clara,085,1922200,7441,5438,18,5456,164
2020-07-07,Santa Cruz,087,273765,616,502,3,505,2
2020-07-07,Shasta,089,179085,271,144,1,145,6
2020-07-07,Sierra,091,2930,1,1,0,1,0
2020-07-07,Siskiyou,093,43540,54,30,0,30,0
2020-07-07,Solano,095,438530,2527,1776,9,1785,22
2020-07-07,Sonoma,097,501317,1987,1473,4,1477,8
2020-07-07,Stanislaus,099,539301,6025,4101,7,4108,46
2020-07-07,Sutter,101,95872,378,273,0,273,2
2020-07-07,Tehama,103,63373,125,95,2,97,1
2020-07-07,Trinity,105,12862,20,2,5,7,0
2020-07-07,Tulare,107,460477,6930,5189,19,5208,137
2020-07-07,Tuolumne,109,53932,74,40,2,42,0
2020-07-07,Ventura,111,848112,5599,3992,19,4011,46
2020-07-07,Yolo,113,214977,1024,706,3,709,26
2020-07-07,Yuba,115,75493,161,138,0,138,1
2020-07-06,Alameda,001,1643700,8428,6970,12,6982,141
2020-07-06,Alpine,003,1148,1,1,0,1,0
2020-07-06,Amador,005,37829,38,33,0,33,0
2020-07-06,Butte,007,227075,430,257,7,264,2
2020-07-06,Calaveras,009,45235,70,45,0,45,0
2020-07-06,Colusa,011,21464,134,80,0,80,0
2020-07-06,Contra Costa,013,1133247,5260,3901,7,3908,83
2020-07-06,Del Norte,015,27424,60,57,0,57,0
2020-07-06,El Dorado,017,186661,402,232,0,232,0
2020-07-06,Fresno,019,978130,12566,6364,91,6455,82
2020-07-06,Glenn,021,27897,197,129,0,129,0
2020-07-06,Humboldt,023,135768,187,148,1,149,3
2020-07-06,Imperial,025,180216,8724,6443,5,6448,47
2020-07-06,Inyo,027,18085,36,32,1,33,1
2020-07-06,Kern,029,883053,12697,5491,37,5528,82
2020-07-06,Kings,031,150075,3149,2583,11,2594,33
2020-07-06,Lake,033,64148,122,93,0,93,1
2020-07-06,Lassen,035,31185,264,219,2,221,0
2020-07-06,Los Angeles,037,10098052,136649,116707,99,116806,3541
2020-07-06,Madera,039,155013,1347,734,3,737,4
2020-07-06,Marin,041,260295,3627,2136,4,2140,17
2020-07-06,Mariposa,043,17540,36,31,0,31,1
2020-07-06,Mendocino,045,87422,107,72,0,72,0
2020-07-06,Merced,047,269075,2498,1396,3,1399,10
2020-07-06,Modoc,049,8938,1,0,0,0,0
2020-07-06,Mono,051,14174,58,40,0,40,1
2020-07-06,Monterey,053,433212,2807,2078,7,2085,15
2020-07-06,Napa,055,140530,610,454,0,454,4
2020-07-06,Nevada,057,99092,192,146,5,151,1
2020-07-06,Orange,059,3164182,28462,20167,293,20460,372
2020-07-06,Placer,061,380077,1219,904,3,907,11
2020-07-06,Plumas,063,18699,17,11,0,11,0
2020-07-06,Riverside,065,2383286,28551,22485,28,22513,477
2020-07-06,Sacramento,067,1510023,5981,4420,7,4427,71
2020-07-06,San Benito,069,59416,368,264,0,264,2
2020-07-06,San Bernardino,071,2135413,23993,15346,15,15361,272
2020-07-06,San Diego,073,3302833,21308,17002,2,17004,387
2020-07-06,San Francisco,075,870044,4664,3861,2,3863,50
2020-07-06,San Joaquin,077,732212,7378,5104,5,5109,57
2020-07-06,San Luis Obispo,079,281455,1160,751,7,758,2
2020-07-06,San Mateo,081,765935,4182,3650,6,3656,106
2020-07-06,Santa Barbara,083,443738,4531,3763,40,3803,27
2020-07-06,Santa Clara,085,1922200,7170,5369,18,5387,165
2020-07-06,Santa Cruz,087,273765,594,466,2,468,2
2020-07-06,Shasta,089,179085,261,143,1,144,6
2020-07-06,Sierra,091,2930,1,1,0,1,0
2020-07-06,Siskiyou,093,43540,50,30,0,30,0
2020-07-06,Solano,095,438530,2394,1668,9,1677,22
2020-07-06,Sonoma,097,501317,1923,1369,4,1373,8
2020-07-06,Stanislaus,099,539301,5623,3983,7,3990,46
2020-07-06,Sutter,101,95872,351,250,0,250,2
2020-07-06,Tehama,103,63373,122,95,2,97,1
2020-07-06,Trinity,105,12862,19,2,5,7,0
2020-07-06,Tulare,107,460477,6725,5039,17,5056,136
2020-07-06,Tuolumne,109,53932,71,30,2,32,0
2020-07-06,Ventura,111,848112,5406,3912,19,3931,44
2020-07-06,Yolo,113,214977,968,685,3,688,26
2020-07-06,Yuba,115,75493,147,124,0,124,1
2020-07-05,Alameda,001,1643700,8176,6861,12,6873,141
2020-07-05,Alpine,003,1148,1,1,0,1,0
2020-07-05,Amador,005,37829,36,31,0,31,0
2020-07-05,Butte,007,227075,395,248,7,255,2
2020-07-05,Calaveras,009,45235,66,45,0,45,0
2020-07-05,Colusa,011,21464,124,79,0,79,0
2020-07-05,Contra Costa,013,1133247,5020,3665,6,3671,80
2020-07-05,Del Norte,015,27424,60,57,0,57,0
2020-07-05,El Dorado,017,186661,384,227,0,227,0
2020-07-05,Fresno,019,978130,11999,6186,89,6275,82
2020-07-05,Glenn,021,27897,194,129,0,129,0
2020-07-05,Humboldt,023,135768,183,147,1,148,3
2020-07-05,Imperial,025,180216,8590,6441,5,6446,47
2020-07-05,Inyo,027,18085,35,32,1,33,1
2020-07-05,Kern,029,883053,11988,5351,37,5388,82
2020-07-05,Kings,031,150075,3066,2546,10,2556,31
2020-07-05,Lake,033,64148,122,92,0,92,1
2020-07-05,Lassen,035,31185,258,219,2,221,0
2020-07-05,Los Angeles,037,10098052,133429,115133,93,115226,3495
2020-07-05,Madera,039,155013,1269,564,3,567,4
2020-07-05,Marin,041,260295,3444,2080,4,2084,17
2020-07-05,Mariposa,043,17540,36,31,0,31,1
2020-07-05,Mendocino,045,87422,104,72,0,72,0
2020-07-05,Merced,047,269075,2353,1340,3,1343,10
2020-07-05,Modoc,049,8938,1,0,0,0,0
2020-07-05,Mono,051,14174,54,39,0,39,1
2020-07-05,Monterey,053,433212,2704,1994,7,2001,15
2020-07-05,Napa,055,140530,580,450,0,450,4
2020-07-05,Nevada,057,99092,186,141,5,146,1
2020-07-05,Orange,059,3164182,27521,19430,280,19710,372
2020-07-05,Placer,061,380077,1162,855,3,858,11
2020-07-05,Plumas,063,18699,16,11,0,11,0
2020-07-05,Riverside,065,2383286,27694,21511,28,21539,474
2020-07-05,Sacramento,067,1510023,5666,4265,6,4271,71
2020-07-05,San Benito,069,59416,349,258,0,258,2
2020-07-05,San Bernardino,071,2135413,23115,15026,15,15041,270
2020-07-05,San Diego,073,3302833,20620,16728,2,16730,387
2020-07-05,San Francisco,075,870044,4546,3861,2,3863,50
2020-07-05,San Joaquin,077,732212,7059,5015,5,5020,57
2020-07-05,San Luis Obispo,079,281455,1081,730,7,737,2
2020-07-05,San Mateo,081,765935,4071,3575,6,3581,106
2020-07-05,Santa Barbara,083,443738,4384,3671,37,3708,27
2020-07-05,Santa Clara,085,1922200,6878,5237,18,5255,162
2020-07-05,Santa Cruz,087,273765,576,467,0,467,2
2020-07-05,Shasta,089,179085,255,138,1,139,6
2020-07-05,Sierra,091,2930,1,1,0,1,0
2020-07-05,Siskiyou,093,43540,46,30,0,30,0
2020-07-05,Solano,095,438530,2274,1547,9,1556,22
2020-07-05,Sonoma,097,501317,1842,1369,4,1373,8
2020-07-05,Stanislaus,099,539301,5292,3777,6,3783,45
2020-07-05,Sutter,101,95872,323,241,0,241,2
2020-07-05,Tehama,103,63373,120,95,2,97,1
2020-07-05,Trinity,105,12862,19,2,5,7,0
2020-07-05,Tulare,107,460477,6466,4981,15,4996,135
2020-07-05,Tuolumne,109,53932,66,30,2,32,0
2020-07-05,Ventura,111,848112,5203,3866,19,3885,44
2020-07-05,Yolo,113,214977,928,644,3,647,26
2020-07-05,Yuba,115,75493,137,115,0,115,1
2020-07-04,Alameda,001,1643700,8064,6737,12,6749,141
2020-07-04,Alpine,003,1148,1,1,0,1,0
2020-07-04,Amador,005,37829,35,31,0,31,0
2020-07-04,Butte,007,227075,377,224,7,231,2
2020-07-04,Calaveras,009,45235,66,45,0,45,0
2020-07-04,Colusa,011,21464,123,76,0,76,0
2020-07-04,Contra Costa,013,1133247,4872,3583,6,3589,80
2020-07-04,Del Norte,015,27424,60,50,0,50,0
2020-07-04,El Dorado,017,186661,365,211,0,211,0
2020-07-04,Fresno,019,978130,11682,5999,87,6086,82
2020-07-04,Glenn,021,27897,187,128,0,128,0
2020-07-04,Humboldt,023,135768,176,144,1,145,3
2020-07-04,Imperial,025,180216,8542,6441,5,6446,47
2020-07-04,Inyo,027,18085,35,32,1,33,1
2020-07-04,Kern,029,883053,11684,5231,37,5268,81
2020-07-04,Kings,031,150075,3023,2509,10,2519,31
2020-07-04,Lake,033,64148,115,86,0,86,1
2020-07-04,Lassen,035,31185,258,219,2,221,0
2020-07-04,Los Angeles,037,10098052,131613,107256,82,107338,3462
2020-07-04,Madera,039,155013,1223,568,3,571,4
2020-07-04,Marin,041,260295,3415,1962,4,1966,17
2020-07-04,Mariposa,043,17540,36,28,0,28,1
2020-07-04,Mendocino,045,87422,104,72,0,72,0
2020-07-04,Merced,047,269075,2250,1252,2,1254,10
2020-07-04,Modoc,049,8938,1,0,0,0,0
2020-07-04,Mono,051,14174,54,37,0,37,1
2020-07-04,Monterey,053,433212,2624,1878,7,1885,15
2020-07-04,Napa,055,140530,571,426,0,426,4
2020-07-04,Nevada,057,99092,183,125,5,130,1
2020-07-04,Orange,059,3164182,27088,19247,267,19514,372
2020-07-04,Placer,061,380077,1127,796,3,799,11
2020-07-04,Plumas,063,18699,16,11,0,11,0
2020-07-04,Riverside,065,2383286,27327,21508,28,21536,474
2020-07-04,Sacramento,067,1510023,5495,4039,6,4045,71
2020-07-04,San Benito,069,59416,336,255,0,255,2
2020-07-04,San Bernardino,071,2135413,22688,14636,13,14649,270
2020-07-04,San Diego,073,3302833,20160,16166,2,16168,387
2020-07-04,San Francisco,075,870044,4454,3861,2,3863,50
2020-07-04,San Joaquin,077,732212,6846,4807,5,4812,57
2020-07-04,San Luis Obispo,079,281455,1041,699,7,706,2
2020-07-04,San Mateo,081,765935,4008,3532,6,3538,106
2020-07-04,Santa Barbara,083,443738,4309,3520,35,3555,27
2020-07-04,Santa Clara,085,1922200,6686,5045,17,5062,161
2020-07-04,Santa Cruz,087,273765,566,466,0,466,2
2020-07-04,Shasta,089,179085,252,135,1,136,6
2020-07-04,Sierra,091,2930,1,1,0,1,0
2020-07-04,Siskiyou,093,43540,39,30,0,30,0
2020-07-04,Solano,095,438530,2238,1548,9,1557,22
2020-07-04,Sonoma,097,501317,1816,1370,4,1374,8
2020-07-04,Stanislaus,099,539301,5134,3572,6,3578,44
2020-07-04,Sutter,101,95872,304,225,0,225,2
2020-07-04,Tehama,103,63373,117,92,2,94,1
2020-07-04,Trinity,105,12862,19,2,5,7,0
2020-07-04,Tulare,107,460477,6354,4802,14,4816,135
2020-07-04,Tuolumne,109,53932,62,30,2,32,0
2020-07-04,Ventura,111,848112,5079,3687,19,3706,44
2020-07-04,Yolo,113,214977,903,615,3,618,26
2020-07-04,Yuba,115,75493,130,102,0,102,1
2020-07-03,Alameda,001,1643700,7943,6486,12,6498,141
2020-07-03,Alpine,003,1148,1,1,0,1,0
2020-07-03,Amador,005,37829,35,25,0,25,0
2020-07-03,Butte,007,227075,365,212,7,219,2
2020-07-03,Calaveras,009,45235,66,44,0,44,0
2020-07-03,Colusa,011,21464,117,70,0,70,0
2020-07-03,Contra Costa,013,1133247,4738,3447,6,3453,78
2020-07-03,Del Norte,015,27424,60,50,0,50,0
2020-07-03,El Dorado,017,186661,353,201,0,201,0
2020-07-03,Fresno,019,978130,11377,5783,85,5868,81
2020-07-03,Glenn,021,27897,182,122,0,122,0
2020-07-03,Humboldt,023,135768,172,143,1,144,3
2020-07-03,Imperial,025,180216,8494,6345,5,6350,47
2020-07-03,Inyo,027,18085,35,32,1,33,1
2020-07-03,Kern,029,883053,11423,5213,37,5250,81
2020-07-03,Kings,031,150075,2987,2492,10,2502,31
2020-07-03,Lake,033,64148,108,83,0,83,0
2020-07-03,Lassen,035,31185,258,219,2,221,0
2020-07-03,Los Angeles,037,10098052,130096,107236,78,107314,3461
2020-07-03,Madera,039,155013,1178,565,3,568,4
2020-07-03,Marin,041,260295,3387,1776,4,1780,17
2020-07-03,Mariposa,043,17540,36,28,0,28,1
2020-07-03,Mendocino,045,87422,103,72,0,72,0
2020-07-03,Merced,047,269075,2184,1188,2,1190,10
2020-07-03,Modoc,049,8938,1,0,0,0,0
2020-07-03,Mono,051,14174,54,37,0,37,1
2020-07-03,Monterey,053,433212,2553,1804,7,1811,15
2020-07-03,Napa,055,140530,553,388,0,388,4
2020-07-03,Nevada,057,99092,182,125,5,130,1
2020-07-03,Orange,059,3164182,26697,18819,259,19078,366
2020-07-03,Placer,061,380077,1100,745,3,748,11
2020-07-03,Plumas,063,18699,16,11,0,11,0
2020-07-03,Riverside,065,2383286,27021,21171,28,21199,472
2020-07-03,Sacramento,067,1510023,5361,3711,6,3717,71
2020-07-03,San Benito,069,59416,329,243,0,243,2
2020-07-03,San Bernardino,071,2135413,22299,14040,13,14053,269
2020-07-03,San Diego,073,3302833,19704,15698,2,15700,387
2020-07-03,San Francisco,075,870044,4407,3781,2,3783,50
2020-07-03,San Joaquin,077,732212,6708,4416,4,4420,56
2020-07-03,San Luis Obispo,079,281455,1006,676,7,683,2
2020-07-03,San Mateo,081,765935,3951,3439,6,3445,106
2020-07-03,Santa Barbara,083,443738,4222,3406,34,3440,27
2020-07-03,Santa Clara,085,1922200,6573,4820,17,4837,161
2020-07-03,Santa Cruz,087,273765,553,436,0,436,2
2020-07-03,Shasta,089,179085,244,113,1,114,6
2020-07-03,Sierra,091,2930,1,1,0,1,0
2020-07-03,Siskiyou,093,43540,36,30,0,30,0
2020-07-03,Solano,095,438530,2194,1496,8,1504,22
2020-07-03,Sonoma,097,501317,1767,1282,4,1286,8
2020-07-03,Stanislaus,099,539301,5009,3021,6,3027,43
2020-07-03,Sutter,101,95872,294,205,0,205,2
2020-07-03,Tehama,103,63373,115,89,2,91,1
2020-07-03,Trinity,105,12862,19,2,5,7,0
2020-07-03,Tulare,107,460477,6239,4656,14,4670,134
2020-07-03,Tuolumne,109,53932,60,27,2,29,0
2020-07-03,Ventura,111,848112,4983,3536,19,3555,44
2020-07-03,Yolo,113,214977,869,586,3,589,25
2020-07-03,Yuba,115,75493,125,96,0,96,1
2020-07-02,Alameda,001,1643700,7817,6386,12,6398,139
2020-07-02,Alpine,003,1148,1,1,0,1,0
2020-07-02,Amador,005,37829,34,23,0,23,0
2020-07-02,Butte,007,227075,348,199,7,206,2
2020-07-02,Calaveras,009,45235,62,42,0,42,0
2020-07-02,Colusa,011,21464,109,60,0,60,0
2020-07-02,Contra Costa,013,1133247,4554,3347,6,3353,77
2020-07-02,Del Norte,015,27424,59,50,0,50,0
2020-07-02,El Dorado,017,186661,342,193,0,193,0
2020-07-02,Fresno,019,978130,10917,5402,85,5487,78
2020-07-02,Glenn,021,27897,176,114,0,114,0
2020-07-02,Humboldt,023,135768,168,138,1,139,3
2020-07-02,Imperial,025,180216,8392,6236,5,6241,47
2020-07-02,Inyo,027,18085,35,29,1,30,1
2020-07-02,Kern,029,883053,10887,5036,35,5071,78
2020-07-02,Kings,031,150075,2936,2419,10,2429,31
2020-07-02,Lake,033,64148,104,81,0,81,0
2020-07-02,Lassen,035,31185,256,218,2,220,0
2020-07-02,Los Angeles,037,10098052,128079,107144,55,107199,3458
2020-07-02,Madera,039,155013,1110,548,3,551,4
2020-07-02,Marin,041,260295,3301,1706,4,1710,17
2020-07-02,Mariposa,043,17540,35,28,0,28,1
2020-07-02,Mendocino,045,87422,99,71,0,71,0
2020-07-02,Merced,047,269075,2087,1122,2,1124,10
2020-07-02,Modoc,049,8938,1,0,0,0,0
2020-07-02,Mono,051,14174,54,37,0,37,1
2020-07-02,Monterey,053,433212,2493,1796,7,1803,15
2020-07-02,Napa,055,140530,536,352,0,352,4
2020-07-02,Nevada,057,99092,176,118,4,122,1
2020-07-02,Orange,059,3164182,25933,17056,246,17302,360
2020-07-02,Placer,061,380077,1076,740,3,743,11
2020-07-02,Plumas,063,18699,15,8,0,8,0
2020-07-02,Riverside,065,2383286,26448,20253,28,20281,458
2020-07-02,Sacramento,067,1510023,5134,3587,6,3593,70
2020-07-02,San Benito,069,59416,321,236,0,236,2
2020-07-02,San Bernardino,071,2135413,21762,13185,13,13198,260
2020-07-02,San Diego,073,3302833,19242,15208,2,15210,377
2020-07-02,San Francisco,075,870044,4312,3676,2,3678,50
2020-07-02,San Joaquin,077,732212,6361,4243,4,4247,56
2020-07-02,San Luis Obispo,079,281455,961,659,7,666,2
2020-07-02,San Mateo,081,765935,3871,3390,6,3396,107
2020-07-02,Santa Barbara,083,443738,4122,3385,32,3417,27
2020-07-02,Santa Clara,085,1922200,6447,4722,17,4739,160
2020-07-02,Santa Cruz,087,273765,530,414,0,414,2
2020-07-02,Shasta,089,179085,241,110,1,111,5
2020-07-02,Sierra,091,2930,1,1,0,1,0
2020-07-02,Siskiyou,093,43540,36,30,0,30,0
2020-07-02,Solano,095,438530,2111,1429,8,1437,21
2020-07-02,Sonoma,097,501317,1709,1244,4,1248,6
2020-07-02,Stanislaus,099,539301,4837,2850,6,2856,41
2020-07-02,Sutter,101,95872,282,195,0,195,2
2020-07-02,Tehama,103,63373,113,86,2,88,1
2020-07-02,Trinity,105,12862,19,2,5,7,0
2020-07-02,Tulare,107,460477,6072,4559,13,4572,132
2020-07-02,Tuolumne,109,53932,57,23,2,25,0
2020-07-02,Ventura,111,848112,4827,3394,19,3413,42
2020-07-02,Yolo,113,214977,837,554,3,557,24
2020-07-02,Yuba,115,75493,115,93,0,93,1
2020-07-01,Alameda,001,1643700,7595,6125,12,6137,137
2020-07-01,Alpine,003,1148,1,1,0,1,0
2020-07-01,Amador,005,37829,33,22,0,22,0
2020-07-01,Butte,007,227075,323,185,7,192,2
2020-07-01,Calaveras,009,45235,60,37,0,37,0
2020-07-01,Colusa,011,21464,103,53,0,53,0
2020-07-01,Contra Costa,013,1133247,4342,3259,6,3265,76
2020-07-01,Del Norte,015,27424,59,50,0,50,0
2020-07-01,El Dorado,017,186661,315,183,0,183,0
2020-07-01,Fresno,019,978130,10483,5111,82,5193,76
2020-07-01,Glenn,021,27897,170,110,0,110,0
2020-07-01,Humboldt,023,135768,163,134,0,134,3
2020-07-01,Imperial,025,180216,8295,6150,5,6155,46
2020-07-01,Inyo,027,18085,34,30,1,31,1
2020-07-01,Kern,029,883053,10254,4853,33,4886,78
2020-07-01,Kings,031,150075,2868,2360,10,2370,30
2020-07-01,Lake,033,64148,103,75,0,75,0
2020-07-01,Lassen,035,31185,255,217,2,219,0
2020-07-01,Los Angeles,037,10098052,124877,105325,46,105371,3408
2020-07-01,Madera,039,155013,1069,519,3,522,4
2020-07-01,Marin,041,260295,3144,1636,4,1640,17
2020-07-01,Mariposa,043,17540,35,29,0,29,1
2020-07-01,Mendocino,045,87422,95,70,0,70,0
2020-07-01,Merced,047,269075,1987,1052,2,1054,10
2020-07-01,Modoc,049,8938,1,0,0,0,0
2020-07-01,Mono,051,14174,51,37,0,37,1
2020-07-01,Monterey,053,433212,2385,1703,6,1709,15
2020-07-01,Napa,055,140530,513,347,0,347,4
2020-07-01,Nevada,057,99092,166,115,4,119,1
2020-07-01,Orange,059,3164182,25048,15662,225,15887,343
2020-07-01,Placer,061,380077,1029,713,3,716,11
2020-07-01,Plumas,063,18699,13,8,0,8,0
2020-07-01,Riverside,065,2383286,25606,19537,27,19564,457
2020-07-01,Sacramento,067,1510023,4879,3425,6,3431,64
2020-07-01,San Benito,069,59416,312,219,0,219,2
2020-07-01,San Bernardino,071,2135413,20865,12712,10,12722,253
2020-07-01,San Diego,073,3302833,18683,14624,2,14626,372
2020-07-01,San Francisco,075,870044,4219,3626,2,3628,50
2020-07-01,San Joaquin,077,732212,6003,3990,4,3994,54
2020-07-01,San Luis Obispo,079,281455,934,613,7,620,1
2020-07-01,San Mateo,081,765935,3809,3326,6,3332,84
2020-07-01,Santa Barbara,083,443738,4002,3268,31,3299,27
2020-07-01,Santa Clara,085,1922200,6260,4547,16,4563,159
2020-07-01,Santa Cruz,087,273765,508,398,0,398,2
2020-07-01,Shasta,089,179085,236,104,1,105,5
2020-07-01,Sierra,091,2930,1,1,0,1,0
2020-07-01,Siskiyou,093,43540,36,28,0,28,0
2020-07-01,Solano,095,438530,2022,1350,8,1358,21
2020-07-01,Sonoma,097,501317,1613,1178,4,1182,6
2020-07-01,Stanislaus,099,539301,4558,2619,6,2625,41
2020-07-01,Sutter,101,95872,269,188,0,188,2
2020-07-01,Tehama,103,63373,106,80,2,82,1
2020-07-01,Trinity,105,12862,19,2,4,6,0
2020-07-01,Tulare,107,460477,5894,4359,13,4372,128
2020-07-01,Tuolumne,109,53932,54,17,2,19,0
2020-07-01,Ventura,111,848112,4684,3224,17,3241,41
2020-07-01,Yolo,113,214977,787,526,3,529,24
2020-07-01,Yuba,115,75493,110,57,0,57,1
2020-06-30,Alameda,001,1643700,7346,5959,10,5969,137
2020-06-30,Alpine,003,1148,1,1,0,1,0
2020-06-30,Amador,005,37829,33,21,0,21,0
2020-06-30,Butte,007,227075,306,163,7,170,2
2020-06-30,Calaveras,009,45235,55,31,0,31,0
2020-06-30,Colusa,011,21464,94,33,0,33,0
2020-06-30,Contra Costa,013,1133247,4135,3140,6,3146,75
2020-06-30,Del Norte,015,27424,59,48,0,48,0
2020-06-30,El Dorado,017,186661,302,175,0,175,0
2020-06-30,Fresno,019,978130,10035,4826,76,4902,75
2020-06-30,Glenn,021,27897,165,96,0,96,0
2020-06-30,Humboldt,023,135768,159,132,0,132,3
2020-06-30,Imperial,025,180216,8198,5968,5,5973,45
2020-06-30,Inyo,027,18085,34,30,1,31,1
2020-06-30,Kern,029,883053,9607,4721,30,4751,75
2020-06-30,Kings,031,150075,2819,2315,7,2322,30
2020-06-30,Lake,033,64148,95,56,0,56,0
2020-06-30,Lassen,035,31185,248,215,2,217,0
2020-06-30,Los Angeles,037,10098052,121299,103640,43,103683,3378
2020-06-30,Madera,039,155013,1012,475,3,478,4
2020-06-30,Marin,041,260295,3073,1614,4,1618,17
2020-06-30,Mariposa,043,17540,34,27,0,27,1
2020-06-30,Mendocino,045,87422,90,65,0,65,0
2020-06-30,Merced,047,269075,1850,970,2,972,10
2020-06-30,Modoc,049,8938,1,0,0,0,0
2020-06-30,Mono,051,14174,49,36,0,36,1
2020-06-30,Monterey,053,433212,2287,1657,6,1663,15
2020-06-30,Napa,055,140530,488,342,0,342,4
2020-06-30,Nevada,057,99092,158,113,4,117,1
2020-06-30,Orange,059,3164182,24117,14354,215,14569,335
2020-06-30,Placer,061,380077,1002,667,3,670,11
2020-06-30,Plumas,063,18699,12,8,0,8,0
2020-06-30,Riverside,065,2383286,24890,18656,26,18682,449
2020-06-30,Sacramento,067,1510023,4590,3246,6,3252,64
2020-06-30,San Benito,069,59416,301,200,0,200,2
2020-06-30,San Bernardino,071,2135413,19881,12375,10,12385,249
2020-06-30,San Diego,073,3302833,17979,14150,2,14152,365
2020-06-30,San Francisco,075,870044,4114,3555,1,3556,50
2020-06-30,San Joaquin,077,732212,5628,3744,4,3748,52
2020-06-30,San Luis Obispo,079,281455,896,583,7,590,1
2020-06-30,San Mateo,081,765935,3731,3268,6,3274,84
2020-06-30,Santa Barbara,083,443738,3886,3102,31,3133,25
2020-06-30,Santa Clara,085,1922200,6058,4346,16,4362,157
2020-06-30,Santa Cruz,087,273765,483,379,0,379,2
2020-06-30,Shasta,089,179085,220,100,1,101,5
2020-06-30,Sierra,091,2930,1,1,0,1,0
2020-06-30,Siskiyou,093,43540,35,26,0,26,0
2020-06-30,Solano,095,438530,1930,1256,8,1264,21
2020-06-30,Sonoma,097,501317,1549,1122,4,1126,6
2020-06-30,Stanislaus,099,539301,4260,2578,6,2584,41
2020-06-30,Sutter,101,95872,246,168,0,168,2
2020-06-30,Tehama,103,63373,104,75,2,77,1
2020-06-30,Trinity,105,12862,19,2,4,6,0
2020-06-30,Tulare,107,460477,5685,4207,13,4220,117
2020-06-30,Tuolumne,109,53932,50,16,2,18,0
2020-06-30,Ventura,111,848112,4550,3030,17,3047,40
2020-06-30,Yolo,113,214977,749,515,3,518,24
2020-06-30,Yuba,115,75493,106,55,0,55,1
2020-06-29,Alameda,001,1643700,7136,5766,10,5776,135
2020-06-29,Alpine,003,1148,1,1,0,1,0
2020-06-29,Amador,005,37829,30,20,0,20,0
2020-06-29,Butte,007,227075,285,157,7,164,2
2020-06-29,Calaveras,009,45235,53,30,0,30,0
2020-06-29,Colusa,011,21464,89,17,0,17,0
2020-06-29,Contra Costa,013,1133247,3972,2976,5,2981,75
2020-06-29,Del Norte,015,27424,59,47,0,47,0
2020-06-29,El Dorado,017,186661,288,163,0,163,0
2020-06-29,Fresno,019,978130,9687,4531,74,4605,74
2020-06-29,Glenn,021,27897,156,77,0,77,0
2020-06-29,Humboldt,023,135768,158,128,0,128,3
2020-06-29,Imperial,025,180216,8067,5512,5,5517,45
2020-06-29,Inyo,027,18085,33,29,0,29,1
2020-06-29,Kern,029,883053,8944,4613,28,4641,73
2020-06-29,Kings,031,150075,2754,2280,7,2287,20
2020-06-29,Lake,033,64148,88,53,0,53,0
2020-06-29,Lassen,035,31185,240,77,2,79,0
2020-06-29,Los Angeles,037,10098052,118260,100846,37,100883,3337
2020-06-29,Madera,039,155013,955,422,3,425,4
2020-06-29,Marin,041,260295,2997,1517,4,1521,17
2020-06-29,Mariposa,043,17540,32,25,0,25,1
2020-06-29,Mendocino,045,87422,87,63,0,63,0
2020-06-29,Merced,047,269075,1744,848,2,850,10
2020-06-29,Modoc,049,8938,1,0,0,0,0
2020-06-29,Mono,051,14174,47,35,0,35,1
2020-06-29,Monterey,053,433212,2215,1614,6,1620,14
2020-06-29,Napa,055,140530,466,317,0,317,4
2020-06-29,Nevada,057,99092,155,107,3,110,1
2020-06-29,Orange,059,3164182,23127,13682,199,13881,324
2020-06-29,Placer,061,380077,966,628,3,631,11
2020-06-29,Plumas,063,18699,12,6,0,6,0
2020-06-29,Riverside,065,2383286,23856,17683,26,17709,432
2020-06-29,Sacramento,067,1510023,4303,2985,6,2991,62
2020-06-29,San Benito,069,59416,286,193,0,193,2
2020-06-29,San Bernardino,071,2135413,18920,11643,10,11653,245
2020-06-29,San Diego,073,3302833,17402,13834,2,13836,361
2020-06-29,San Francisco,075,870044,4037,3389,1,3390,50
2020-06-29,San Joaquin,077,732212,5270,3202,4,3206,52
2020-06-29,San Luis Obispo,079,281455,862,544,7,551,1
2020-06-29,San Mateo,081,765935,3677,3170,6,3176,84
2020-06-29,Santa Barbara,083,443738,3777,2933,30,2963,25
2020-06-29,Santa Clara,085,1922200,5886,4231,16,4247,157
2020-06-29,Santa Cruz,087,273765,465,348,0,348,2
2020-06-29,Shasta,089,179085,212,94,1,95,5
2020-06-29,Sierra,091,2930,1,1,0,1,0
2020-06-29,Siskiyou,093,43540,35,25,0,25,0
2020-06-29,Solano,095,438530,1828,1077,8,1085,21
2020-06-29,Sonoma,097,501317,1477,1103,4,1107,5
2020-06-29,Stanislaus,099,539301,4054,2400,5,2405,36
2020-06-29,Sutter,101,95872,224,152,0,152,2
2020-06-29,Tehama,103,63373,100,63,2,65,1
2020-06-29,Trinity,105,12862,18,2,4,6,0
2020-06-29,Tulare,107,460477,5530,3906,12,3918,117
2020-06-29,Tuolumne,109,53932,46,16,2,18,0
2020-06-29,Ventura,111,848112,4403,2794,17,2811,40
2020-06-29,Yolo,113,214977,716,483,3,486,24
2020-06-29,Yuba,115,75493,93,55,0,55,1
2020-06-28,Alameda,001,1643700,6877,5698,10,5708,135
2020-06-28,Alpine,003,1148,1,1,0,1,0
2020-06-28,Amador,005,37829,28,20,0,20,0
2020-06-28,Butte,007,227075,265,150,7,157,2
2020-06-28,Calaveras,009,45235,48,30,0,30,0
2020-06-28,Colusa,011,21464,74,17,0,17,0
2020-06-28,Contra Costa,013,1133247,3782,2803,4,2807,73
2020-06-28,Del Norte,015,27424,58,47,0,47,0
2020-06-28,El Dorado,017,186661,276,162,0,162,0
2020-06-28,Fresno,019,978130,9326,4365,74,4439,74
2020-06-28,Glenn,021,27897,148,77,0,77,0
2020-06-28,Humboldt,023,135768,155,127,0,127,3
2020-06-28,Imperial,025,180216,7879,5513,4,5517,45
2020-06-28,Inyo,027,18085,33,29,0,29,1
2020-06-28,Kern,029,883053,8393,4541,26,4567,72
2020-06-28,Kings,031,150075,2694,2234,7,2241,18
2020-06-28,Lake,033,64148,84,53,0,53,0
2020-06-28,Lassen,035,31185,240,77,2,79,0
2020-06-28,Los Angeles,037,10098052,115058,98003,33,98036,3316
2020-06-28,Madera,039,155013,907,424,3,427,4
2020-06-28,Marin,041,260295,2651,1473,4,1477,17
2020-06-28,Mariposa,043,17540,32,24,0,24,1
2020-06-28,Mendocino,045,87422,85,63,0,63,0
2020-06-28,Merced,047,269075,1631,814,2,816,10
2020-06-28,Modoc,049,8938,1,0,0,0,0
2020-06-28,Mono,051,14174,47,35,0,35,1
2020-06-28,Monterey,053,433212,2133,1560,6,1566,13
2020-06-28,Napa,055,140530,432,307,0,307,4
2020-06-28,Nevada,057,99092,144,102,3,105,1
2020-06-28,Orange,059,3164182,22153,13213,181,13394,324
2020-06-28,Placer,061,380077,927,618,3,621,11
2020-06-28,Plumas,063,18699,11,6,0,6,0
2020-06-28,Riverside,065,2383286,23029,16848,25,16873,432
2020-06-28,Sacramento,067,1510023,4075,2803,6,2809,63
2020-06-28,San Benito,069,59416,275,190,0,190,2
2020-06-28,San Bernardino,071,2135413,18166,11344,9,11353,245
2020-06-28,San Diego,073,3302833,16857,13333,2,13335,361
2020-06-28,San Francisco,075,870044,3958,3388,1,3389,50
2020-06-28,San Joaquin,077,732212,4933,3201,4,3205,52
2020-06-28,San Luis Obispo,079,281455,822,531,6,537,1
2020-06-28,San Mateo,081,765935,3599,3124,6,3130,84
2020-06-28,Santa Barbara,083,443738,3632,2872,30,2902,25
2020-06-28,Santa Clara,085,1922200,5724,4131,16,4147,156
2020-06-28,Santa Cruz,087,273765,442,349,0,349,2
2020-06-28,Shasta,089,179085,199,89,0,89,5
2020-06-28,Sierra,091,2930,1,1,0,1,0
2020-06-28,Siskiyou,093,43540,35,25,0,25,0
2020-06-28,Solano,095,438530,1753,1077,8,1085,21
2020-06-28,Sonoma,097,501317,1423,1084,4,1088,5
2020-06-28,Stanislaus,099,539301,3848,2376,5,2381,36
2020-06-28,Sutter,101,95872,198,145,0,145,2
2020-06-28,Tehama,103,63373,93,63,2,65,1
2020-06-28,Trinity,105,12862,17,2,4,6,0
2020-06-28,Tulare,107,460477,5362,3812,12,3824,117
2020-06-28,Tuolumne,109,53932,41,14,2,16,0
2020-06-28,Ventura,111,848112,4245,2650,17,2667,40
2020-06-28,Yolo,113,214977,681,468,3,471,24
2020-06-28,Yuba,115,75493,89,39,0,39,1
2020-06-27,Alameda,001,1643700,6781,5581,10,5591,135
2020-06-27,Alpine,003,1148,1,1,0,1,0
2020-06-27,Amador,005,37829,26,20,0,20,0
2020-06-27,Butte,007,227075,257,137,7,144,2
2020-06-27,Calaveras,009,45235,46,30,0,30,0
2020-06-27,Colusa,011,21464,68,17,0,17,0
2020-06-27,Contra Costa,013,1133247,3687,2717,3,2720,72
2020-06-27,Del Norte,015,27424,58,47,0,47,0
2020-06-27,El Dorado,017,186661,270,159,0,159,0
2020-06-27,Fresno,019,978130,9080,4238,74,4312,74
2020-06-27,Glenn,021,27897,144,77,0,77,0
2020-06-27,Humboldt,023,135768,153,127,0,127,3
2020-06-27,Imperial,025,180216,7818,5513,4,5517,45
2020-06-27,Inyo,027,18085,33,29,0,29,1
2020-06-27,Kern,029,883053,8129,4411,25,4436,70
2020-06-27,Kings,031,150075,2668,2187,7,2194,18
2020-06-27,Lake,033,64148,81,42,0,42,0
2020-06-27,Lassen,035,31185,240,33,2,35,0
2020-06-27,Los Angeles,037,10098052,113316,95341,30,95371,3291
2020-06-27,Madera,039,155013,864,427,2,429,4
2020-06-27,Marin,041,260295,2606,1423,4,1427,17
2020-06-27,Mariposa,043,17540,31,22,0,22,1
2020-06-27,Mendocino,045,87422,85,63,0,63,0
2020-06-27,Merced,047,269075,1573,807,1,808,10
2020-06-27,Modoc,049,8938,1,0,0,0,0
2020-06-27,Mono,051,14174,46,35,0,35,1
2020-06-27,Monterey,053,433212,2069,1455,6,1461,12
2020-06-27,Napa,055,140530,422,282,0,282,3
2020-06-27,Nevada,057,99092,140,102,2,104,1
2020-06-27,Orange,059,3164182,21642,12951,176,13127,320
2020-06-27,Placer,061,380077,906,584,3,587,10
2020-06-27,Plumas,063,18699,11,6,0,6,0
2020-06-27,Riverside,065,2383286,22640,16209,25,16234,432
2020-06-27,Sacramento,067,1510023,3958,2685,6,2691,63
2020-06-27,San Benito,069,59416,268,182,0,182,2
2020-06-27,San Bernardino,071,2135413,17787,11238,9,11247,243
2020-06-27,San Diego,073,3302833,16492,12836,2,12838,360
2020-06-27,San Francisco,075,870044,3903,3332,1,3333,49
2020-06-27,San Joaquin,077,732212,4767,2995,4,2999,52
2020-06-27,San Luis Obispo,079,281455,798,505,6,511,1
2020-06-27,San Mateo,081,765935,3542,3083,6,3089,83
2020-06-27,Santa Barbara,083,443738,3560,2799,30,2829,25
2020-06-27,Santa Clara,085,1922200,5618,4006,16,4022,157
2020-06-27,Santa Cruz,087,273765,435,347,0,347,2
2020-06-27,Shasta,089,179085,194,87,0,87,5
2020-06-27,Sierra,091,2930,1,1,0,1,0
2020-06-27,Siskiyou,093,43540,35,25,0,25,0
2020-06-27,Solano,095,438530,1720,1076,8,1084,21
2020-06-27,Sonoma,097,501317,1392,1004,4,1008,5
2020-06-27,Stanislaus,099,539301,3748,2164,5,2169,36
2020-06-27,Sutter,101,95872,191,141,0,141,2
2020-06-27,Tehama,103,63373,90,63,2,65,1
2020-06-27,Trinity,105,12862,17,2,4,6,0
2020-06-27,Tulare,107,460477,5266,3810,12,3822,117
2020-06-27,Tuolumne,109,53932,40,13,2,15,0
2020-06-27,Ventura,111,848112,4145,2471,17,2488,40
2020-06-27,Yolo,113,214977,657,432,3,435,24
2020-06-27,Yuba,115,75493,81,39,0,39,1
2020-06-26,Alameda,001,1643700,6695,5502,9,5511,132
2020-06-26,Alpine,003,1148,1,1,0,1,0
2020-06-26,Amador,005,37829,25,20,0,20,0
2020-06-26,Butte,007,227075,242,135,7,142,2
2020-06-26,Calaveras,009,45235,44,30,0,30,0
2020-06-26,Colusa,011,21464,63,17,0,17,0
2020-06-26,Contra Costa,013,1133247,3574,2676,3,2679,72
2020-06-26,Del Norte,015,27424,57,47,0,47,0
2020-06-26,El Dorado,017,186661,262,159,0,159,0
2020-06-26,Fresno,019,978130,8854,4166,74,4240,74
2020-06-26,Glenn,021,27897,137,71,0,71,0
2020-06-26,Humboldt,023,135768,151,126,0,126,3
2020-06-26,Imperial,025,180216,7755,5400,4,5404,44
2020-06-26,Inyo,027,18085,32,29,0,29,1
2020-06-26,Kern,029,883053,7799,4366,25,4391,70
2020-06-26,Kings,031,150075,2636,2176,6,2182,18
2020-06-26,Lake,033,64148,80,42,0,42,0
2020-06-26,Lassen,035,31185,239,30,2,32,0
2020-06-26,Los Angeles,037,10098052,111150,93328,30,93358,3275
2020-06-26,Madera,039,155013,832,409,2,411,4
2020-06-26,Marin,041,260295,2569,1406,4,1410,17
2020-06-26,Mariposa,043,17540,30,21,0,21,1
2020-06-26,Mendocino,045,87422,82,63,0,63,0
2020-06-26,Merced,047,269075,1527,797,1,798,10
2020-06-26,Modoc,049,8938,1,0,0,0,0
2020-06-26,Mono,051,14174,45,35,0,35,1
2020-06-26,Monterey,053,433212,2017,1449,6,1455,12
2020-06-26,Napa,055,140530,412,277,0,277,3
2020-06-26,Nevada,057,99092,136,101,1,102,1
2020-06-26,Orange,059,3164182,20966,12659,173,12832,320
2020-06-26,Placer,061,380077,877,584,3,587,10
2020-06-26,Plumas,063,18699,11,6,0,6,0
2020-06-26,Riverside,065,2383286,22177,15858,25,15883,430
2020-06-26,Sacramento,067,1510023,3793,2687,6,2693,63
2020-06-26,San Benito,069,59416,264,176,0,176,2
2020-06-26,San Bernardino,071,2135413,17410,11111,9,11120,243
2020-06-26,San Diego,073,3302833,16127,12402,2,12404,358
2020-06-26,San Francisco,075,870044,3847,3330,1,3331,49
2020-06-26,San Joaquin,077,732212,4553,2943,4,2947,52
2020-06-26,San Luis Obispo,079,281455,783,498,6,504,1
2020-06-26,San Mateo,081,765935,3490,3055,6,3061,83
2020-06-26,Santa Barbara,083,443738,3470,2784,28,2812,25
2020-06-26,Santa Clara,085,1922200,5517,3968,16,3984,156
2020-06-26,Santa Cruz,087,273765,428,344,0,344,2
2020-06-26,Shasta,089,179085,187,86,0,86,5
2020-06-26,Sierra,091,2930,1,1,0,1,0
2020-06-26,Siskiyou,093,43540,34,24,0,24,0
2020-06-26,Solano,095,438530,1678,1068,8,1076,21
2020-06-26,Sonoma,097,501317,1360,977,4,981,5
2020-06-26,Stanislaus,099,539301,3635,2157,5,2162,36
2020-06-26,Sutter,101,95872,184,138,0,138,2
2020-06-26,Tehama,103,63373,87,63,2,65,1
2020-06-26,Trinity,105,12862,17,2,4,6,0
2020-06-26,Tulare,107,460477,5177,3720,12,3732,117
2020-06-26,Tuolumne,109,53932,38,10,2,12,0
2020-06-26,Ventura,111,848112,4059,2444,17,2461,40
2020-06-26,Yolo,113,214977,634,418,3,421,24
2020-06-26,Yuba,115,75493,75,38,0,38,1
2020-06-25,Alameda,001,1643700,6506,5398,9,5407,130
2020-06-25,Alpine,003,1148,1,1,0,1,0
2020-06-25,Amador,005,37829,24,18,0,18,0
2020-06-25,Butte,007,227075,237,127,7,134,1
2020-06-25,Calaveras,009,45235,39,26,0,26,0
2020-06-25,Colusa,011,21464,53,14,0,14,0
2020-06-25,Contra Costa,013,1133247,3389,2591,3,2594,71
2020-06-25,Del Norte,015,27424,55,47,0,47,0
2020-06-25,El Dorado,017,186661,254,150,0,150,0
2020-06-25,Fresno,019,978130,8541,3938,73,4011,71
2020-06-25,Glenn,021,27897,132,59,0,59,0
2020-06-25,Humboldt,023,135768,150,121,0,121,3
2020-06-25,Imperial,025,180216,7626,5192,4,5196,44
2020-06-25,Inyo,027,18085,29,27,0,27,1
2020-06-25,Kern,029,883053,7374,4236,22,4258,69
2020-06-25,Kings,031,150075,2584,2110,6,2116,17
2020-06-25,Lake,033,64148,79,42,0,42,0
2020-06-25,Lassen,035,31185,233,13,2,15,0
2020-06-25,Los Angeles,037,10098052,108383,91524,30,91554,3239
2020-06-25,Madera,039,155013,788,380,2,382,4
2020-06-25,Marin,041,260295,2467,1321,4,1325,17
2020-06-25,Mariposa,043,17540,29,20,0,20,1
2020-06-25,Mendocino,045,87422,79,61,0,61,0
2020-06-25,Merced,047,269075,1440,747,1,748,10
2020-06-25,Modoc,049,8938,1,0,0,0,0
2020-06-25,Mono,051,14174,44,35,0,35,1
2020-06-25,Monterey,053,433212,1929,1426,5,1431,12
2020-06-25,Napa,055,140530,394,260,0,260,3
2020-06-25,Nevada,057,99092,128,92,1,93,1
2020-06-25,Orange,059,3164182,20044,12221,171,12392,311
2020-06-25,Placer,061,380077,823,574,3,577,10
2020-06-25,Plumas,063,18699,10,6,0,6,0
2020-06-25,Riverside,065,2383286,21422,15224,25,15249,427
2020-06-25,Sacramento,067,1510023,3570,2519,6,2525,62
2020-06-25,San Benito,069,59416,256,174,0,174,2
2020-06-25,San Bernardino,071,2135413,16659,10590,9,10599,242
2020-06-25,San Diego,073,3302833,15588,11963,2,11965,352
2020-06-25,San Francisco,075,870044,3781,3252,1,3253,48
2020-06-25,San Joaquin,077,732212,4280,2803,4,2807,50
2020-06-25,San Luis Obispo,079,281455,751,473,6,479,1
2020-06-25,San Mateo,081,765935,3422,2996,6,3002,82
2020-06-25,Santa Barbara,083,443738,3364,2622,27,2649,25
2020-06-25,Santa Clara,085,1922200,5368,3871,16,3887,156
2020-06-25,Santa Cruz,087,273765,416,335,0,335,2
2020-06-25,Shasta,089,179085,177,84,0,84,5
2020-06-25,Sierra,091,2930,1,1,0,1,0
2020-06-25,Siskiyou,093,43540,33,24,0,24,0
2020-06-25,Solano,095,438530,1625,1034,8,1042,21
2020-06-25,Sonoma,097,501317,1313,953,3,956,5
2020-06-25,Stanislaus,099,539301,3423,2130,5,2135,36
2020-06-25,Sutter,101,95872,172,126,0,126,2
2020-06-25,Tehama,103,63373,83,59,2,61,1
2020-06-25,Trinity,105,12862,17,2,4,6,0
2020-06-25,Tulare,107,460477,5046,3656,12,3668,117
2020-06-25,Tuolumne,109,53932,37,10,1,11,0
2020-06-25,Ventura,111,848112,3877,2346,16,2362,40
2020-06-25,Yolo,113,214977,605,397,3,400,24
2020-06-25,Yuba,115,75493,64,38,0,38,1
2020-06-24,Alameda,001,1643700,6344,5242,9,5251,123
2020-06-24,Alpine,003,1148,1,1,0,1,0
2020-06-24,Amador,005,37829,22,16,0,16,0
2020-06-24,Butte,007,227075,221,119,7,126,1
2020-06-24,Calaveras,009,45235,37,26,0,26,0
2020-06-24,Colusa,011,21464,44,11,0,11,0
2020-06-24,Contra Costa,013,1133247,3234,2520,3,2523,66
2020-06-24,Del Norte,015,27424,49,47,0,47,0
2020-06-24,El Dorado,017,186661,238,149,0,149,0
2020-06-24,Fresno,019,978130,8210,3765,73,3838,71
2020-06-24,Glenn,021,27897,124,54,0,54,0
2020-06-24,Humboldt,023,135768,150,117,0,117,3
2020-06-24,Imperial,025,180216,7508,5138,4,5142,38
2020-06-24,Inyo,027,18085,29,28,0,28,1
2020-06-24,Kern,029,883053,6981,4155,20,4175,67
2020-06-24,Kings,031,150075,2520,2063,6,2069,16
2020-06-24,Lake,033,64148,66,40,0,40,0
2020-06-24,Lassen,035,31185,232,9,2,11,0
2020-06-24,Los Angeles,037,10098052,105623,89566,30,89596,3186
2020-06-24,Madera,039,155013,766,373,2,375,4
2020-06-24,Marin,041,260295,2239,1261,4,1265,17
2020-06-24,Mariposa,043,17540,28,19,0,19,1
2020-06-24,Mendocino,045,87422,79,60,0,60,0
2020-06-24,Merced,047,269075,1354,696,1,697,8
2020-06-24,Modoc,049,8938,1,0,0,0,0
2020-06-24,Mono,051,14174,42,35,0,35,1
2020-06-24,Monterey,053,433212,1852,1407,5,1412,12
2020-06-24,Napa,055,140530,377,258,0,258,3
2020-06-24,Nevada,057,99092,122,92,1,93,1
2020-06-24,Orange,059,3164182,19047,11804,153,11957,303
2020-06-24,Placer,061,380077,784,548,3,551,10
2020-06-24,Plumas,063,18699,10,6,0,6,0
2020-06-24,Riverside,065,2383286,20575,14946,25,14971,410
2020-06-24,Sacramento,067,1510023,3365,2446,5,2451,62
2020-06-24,San Benito,069,59416,252,171,0,171,2
2020-06-24,San Bernardino,071,2135413,15846,10211,9,10220,239
2020-06-24,San Diego,073,3302833,15085,11628,2,11630,347
2020-06-24,San Francisco,075,870044,3718,3216,1,3217,48
2020-06-24,San Joaquin,077,732212,4059,2680,4,2684,49
2020-06-24,San Luis Obispo,079,281455,719,461,5,466,1
2020-06-24,San Mateo,081,765935,3365,2964,6,2970,82
2020-06-24,Santa Barbara,083,443738,3245,2569,25,2594,22
2020-06-24,Santa Clara,085,1922200,5237,3812,16,3828,155
2020-06-24,Santa Cruz,087,273765,404,329,0,329,2
2020-06-24,Shasta,089,179085,169,83,0,83,5
2020-06-24,Sierra,091,2930,1,1,0,1,0
2020-06-24,Siskiyou,093,43540,32,24,0,24,0
2020-06-24,Solano,095,438530,1535,979,7,986,21
2020-06-24,Sonoma,097,501317,1264,933,3,936,4
2020-06-24,Stanislaus,099,539301,3244,2039,5,2044,36
2020-06-24,Sutter,101,95872,159,118,0,118,2
2020-06-24,Tehama,103,63373,81,55,2,57,1
2020-06-24,Trinity,105,12862,16,2,3,5,0
2020-06-24,Tulare,107,460477,4891,3541,10,3551,116
2020-06-24,Tuolumne,109,53932,32,9,1,10,0
2020-06-24,Ventura,111,848112,3536,2314,16,2330,42
2020-06-24,Yolo,113,214977,570,376,3,379,24
2020-06-24,Yuba,115,75493,58,37,0,37,1
2020-06-23,Alameda,001,1643700,6163,5159,9,5168,121
2020-06-23,Alpine,003,1148,1,1,0,1,0
2020-06-23,Amador,005,37829,21,13,0,13,0
2020-06-23,Butte,007,227075,203,111,7,118,1
2020-06-23,Calaveras,009,45235,37,26,0,26,0
2020-06-23,Colusa,011,21464,40,7,0,7,0
2020-06-23,Contra Costa,013,1133247,3108,2453,3,2456,60
2020-06-23,Del Norte,015,27424,48,46,0,46,0
2020-06-23,El Dorado,017,186661,229,142,0,142,0
2020-06-23,Fresno,019,978130,7559,3569,71,3640,67
2020-06-23,Glenn,021,27897,120,47,0,47,0
2020-06-23,Humboldt,023,135768,150,110,0,110,3
2020-06-23,Imperial,025,180216,7345,5025,4,5029,38
2020-06-23,Inyo,027,18085,29,26,0,26,1
2020-06-23,Kern,029,883053,6613,4087,17,4104,64
2020-06-23,Kings,031,150075,2455,1727,6,1733,16
2020-06-23,Lake,033,64148,60,40,0,40,0
2020-06-23,Lassen,035,31185,228,9,2,11,0
2020-06-23,Los Angeles,037,10098052,102683,88433,29,88462,3152
2020-06-23,Madera,039,155013,727,369,2,371,4
2020-06-23,Marin,041,260295,1970,1139,4,1143,17
2020-06-23,Mariposa,043,17540,26,18,0,18,1
2020-06-23,Mendocino,045,87422,78,61,0,61,0
2020-06-23,Merced,047,269075,1257,656,1,657,8
2020-06-23,Modoc,049,8938,1,0,0,0,0
2020-06-23,Mono,051,14174,42,35,0,35,1
2020-06-23,Monterey,053,433212,1782,1346,5,1351,12
2020-06-23,Napa,055,140530,362,230,0,230,3
2020-06-23,Nevada,057,99092,116,81,1,82,1
2020-06-23,Orange,059,3164182,18079,11071,150,11221,278
2020-06-23,Placer,061,380077,758,525,3,528,10
2020-06-23,Plumas,063,18699,9,6,0,6,0
2020-06-23,Riverside,065,2383286,19555,14469,25,14494,406
2020-06-23,Sacramento,067,1510023,3186,2374,5,2379,62
2020-06-23,San Benito,069,59416,238,167,0,167,2
2020-06-23,San Bernardino,071,2135413,15064,9771,9,9780,229
2020-06-23,San Diego,073,3302833,14565,11296,2,11298,341
2020-06-23,San Francisco,075,870044,3644,3177,1,3178,48
2020-06-23,San Joaquin,077,732212,3800,2502,4,2506,48
2020-06-23,San Luis Obispo,079,281455,688,445,5,450,1
2020-06-23,San Mateo,081,765935,3300,2907,6,2913,81
2020-06-23,Santa Barbara,083,443738,3149,2498,25,2523,22
2020-06-23,Santa Clara,085,1922200,5091,3700,16,3716,155
2020-06-23,Santa Cruz,087,273765,394,313,0,313,2
2020-06-23,Shasta,089,179085,160,81,0,81,5
2020-06-23,Sierra,091,2930,1,1,0,1,0
2020-06-23,Siskiyou,093,43540,30,24,0,24,0
2020-06-23,Solano,095,438530,1478,941,6,947,21
2020-06-23,Sonoma,097,501317,1211,912,3,915,4
2020-06-23,Stanislaus,099,539301,3068,1850,5,1855,35
2020-06-23,Sutter,101,95872,149,112,0,112,2
2020-06-23,Tehama,103,63373,79,50,2,52,1
2020-06-23,Trinity,105,12862,16,2,3,5,0
2020-06-23,Tulare,107,460477,4769,3456,10,3466,111
2020-06-23,Tuolumne,109,53932,27,9,0,9,0
2020-06-23,Ventura,111,848112,3376,2209,15,2224,40
2020-06-23,Yolo,113,214977,544,350,0,350,24
2020-06-23,Yuba,115,75493,55,35,0,35,1
2020-06-22,Alameda,001,1643700,6012,4944,9,4953,121
2020-06-22,Alpine,003,1148,1,1,0,1,0
2020-06-22,Amador,005,37829,18,12,0,12,0
2020-06-22,Butte,007,227075,184,104,7,111,1
2020-06-22,Calaveras,009,45235,35,20,0,20,0
2020-06-22,Colusa,011,21464,37,7,0,7,0
2020-06-22,Contra Costa,013,1133247,2966,2363,3,2366,60
2020-06-22,Del Norte,015,27424,48,46,0,46,0
2020-06-22,El Dorado,017,186661,220,137,0,137,0
2020-06-22,Fresno,019,978130,7027,3425,71,3496,67
2020-06-22,Glenn,021,27897,111,40,0,40,0
2020-06-22,Humboldt,023,135768,147,110,0,110,3
2020-06-22,Imperial,025,180216,7189,4700,4,4704,38
2020-06-22,Inyo,027,18085,29,26,0,26,1
2020-06-22,Kern,029,883053,6261,3982,15,3997,60
2020-06-22,Kings,031,150075,2406,1513,6,1519,13
2020-06-22,Lake,033,64148,54,37,0,37,0
2020-06-22,Lassen,035,31185,118,7,2,9,0
2020-06-22,Los Angeles,037,10098052,99785,85925,27,85952,3117
2020-06-22,Madera,039,155013,702,333,2,335,4
2020-06-22,Marin,041,260295,1712,1029,4,1033,17
2020-06-22,Mariposa,043,17540,25,18,0,18,1
2020-06-22,Mendocino,045,87422,73,48,0,48,0
2020-06-22,Merced,047,269075,1168,619,1,620,8
2020-06-22,Modoc,049,8938,1,0,0,0,0
2020-06-22,Mono,051,14174,42,34,0,34,1
2020-06-22,Monterey,053,433212,1721,1293,5,1298,12
2020-06-22,Napa,055,140530,338,222,0,222,3
2020-06-22,Nevada,057,99092,111,79,1,80,1
2020-06-22,Orange,059,3164182,17147,10711,147,10858,275
2020-06-22,Placer,061,380077,732,512,3,515,9
2020-06-22,Plumas,063,18699,7,6,0,6,0
2020-06-22,Riverside,065,2383286,18583,13948,25,13973,403
2020-06-22,Sacramento,067,1510023,2969,2243,5,2248,62
2020-06-22,San Benito,069,59416,229,164,0,164,2
2020-06-22,San Bernardino,071,2135413,14287,9133,9,9142,229
2020-06-22,San Diego,073,3302833,14073,11098,2,11100,338
2020-06-22,San Francisco,075,870044,3551,3000,1,3001,47
2020-06-22,San Joaquin,077,732212,3552,2332,4,2336,48
2020-06-22,San Luis Obispo,079,281455,655,422,5,427,1
2020-06-22,San Mateo,081,765935,3227,2813,5,2818,81
2020-06-22,Santa Barbara,083,443738,3057,2447,25,2472,21
2020-06-22,Santa Clara,085,1922200,4928,3580,16,3596,155
2020-06-22,Santa Cruz,087,273765,381,290,0,290,3
2020-06-22,Shasta,089,179085,157,77,0,77,5
2020-06-22,Sierra,091,2930,1,1,0,1,0
2020-06-22,Siskiyou,093,43540,30,23,0,23,0
2020-06-22,Solano,095,438530,1400,784,5,789,21
2020-06-22,Sonoma,097,501317,1166,860,1,861,4
2020-06-22,Stanislaus,099,539301,2883,1784,5,1789,35
2020-06-22,Sutter,101,95872,140,100,0,100,2
2020-06-22,Tehama,103,63373,75,38,2,40,1
2020-06-22,Trinity,105,12862,16,2,3,5,0
2020-06-22,Tulare,107,460477,4631,3185,10,3195,111
2020-06-22,Tuolumne,109,53932,18,8,0,8,0
2020-06-22,Ventura,111,848112,3227,2065,15,2080,39
2020-06-22,Yolo,113,214977,518,333,0,333,24
2020-06-22,Yuba,115,75493,50,36,0,36,1
2020-06-21,Alameda,001,1643700,5817,4835,9,4844,121
2020-06-21,Alpine,003,1148,1,1,0,1,0
2020-06-21,Amador,005,37829,13,12,0,12,0
2020-06-21,Butte,007,227075,170,97,7,104,1
2020-06-21,Calaveras,009,45235,35,20,0,20,0
2020-06-21,Colusa,011,21464,29,7,0,7,0
2020-06-21,Contra Costa,013,1133247,2840,2282,3,2285,60
2020-06-21,Del Norte,015,27424,47,46,0,46,0
2020-06-21,El Dorado,017,186661,211,132,0,132,0
2020-06-21,Fresno,019,978130,6456,3296,69,3365,67
2020-06-21,Glenn,021,27897,102,40,0,40,0
2020-06-21,Humboldt,023,135768,142,108,0,108,3
2020-06-21,Imperial,025,180216,7006,4701,4,4705,38
2020-06-21,Inyo,027,18085,27,26,0,26,1
2020-06-21,Kern,029,883053,5969,3918,14,3932,60
2020-06-21,Kings,031,150075,2342,1334,6,1340,11
2020-06-21,Lake,033,64148,49,36,0,36,0
2020-06-21,Lassen,035,31185,25,7,2,9,0
2020-06-21,Los Angeles,037,10098052,96903,83383,26,83409,3101
2020-06-21,Madera,039,155013,668,319,2,321,4
2020-06-21,Marin,041,260295,1555,907,4,911,17
2020-06-21,Mariposa,043,17540,22,18,0,18,1
2020-06-21,Mendocino,045,87422,70,48,0,48,0
2020-06-21,Merced,047,269075,1073,577,1,578,8
2020-06-21,Modoc,049,8938,1,0,0,0,0
2020-06-21,Mono,051,14174,42,34,0,34,1
2020-06-21,Monterey,053,433212,1648,1227,5,1232,12
2020-06-21,Napa,055,140530,323,218,0,218,3
2020-06-21,Nevada,057,99092,108,79,1,80,1
2020-06-21,Orange,059,3164182,16315,10563,143,10706,275
2020-06-21,Placer,061,380077,692,498,3,501,9
2020-06-21,Plumas,063,18699,7,6,0,6,0
2020-06-21,Riverside,065,2383286,17877,13528,24,13552,402
2020-06-21,Sacramento,067,1510023,2768,2156,4,2160,62
2020-06-21,San Benito,069,59416,215,151,0,151,2
2020-06-21,San Bernardino,071,2135413,13512,8925,8,8933,229
2020-06-21,San Diego,073,3302833,13527,10796,2,10798,338
2020-06-21,San Francisco,075,870044,3445,3000,1,3001,47
2020-06-21,San Joaquin,077,732212,3316,2188,4,2192,48
2020-06-21,San Luis Obispo,079,281455,629,418,5,423,1
2020-06-21,San Mateo,081,765935,3169,2781,5,2786,81
2020-06-21,Santa Barbara,083,443738,2950,2430,24,2454,21
2020-06-21,Santa Clara,085,1922200,4790,3514,16,3530,154
2020-06-21,Santa Cruz,087,273765,371,290,0,290,3
2020-06-21,Shasta,089,179085,147,75,0,75,5
2020-06-21,Sierra,091,2930,1,1,0,1,0
2020-06-21,Siskiyou,093,43540,30,23,0,23,0
2020-06-21,Solano,095,438530,1300,783,4,787,21
2020-06-21,Sonoma,097,501317,1116,836,1,837,4
2020-06-21,Stanislaus,099,539301,2697,1688,5,1693,35
2020-06-21,Sutter,101,95872,132,96,0,96,2
2020-06-21,Tehama,103,63373,64,35,2,37,1
2020-06-21,Trinity,105,12862,15,2,3,5,0
2020-06-21,Tulare,107,460477,4462,3173,10,3183,111
2020-06-21,Tuolumne,109,53932,16,8,0,8,0
2020-06-21,Ventura,111,848112,3049,2021,15,2036,39
2020-06-21,Yolo,113,214977,486,323,0,323,24
2020-06-21,Yuba,115,75493,46,35,0,35,1
2020-06-20,Alameda,001,1643700,5755,4758,9,4767,119
2020-06-20,Alpine,003,1148,1,1,0,1,0
2020-06-20,Amador,005,37829,13,12,0,12,0
2020-06-20,Butte,007,227075,163,94,7,101,1
2020-06-20,Calaveras,009,45235,35,20,0,20,0
2020-06-20,Colusa,011,21464,26,7,0,7,0
2020-06-20,Contra Costa,013,1133247,2781,2231,3,2234,54
2020-06-20,Del Norte,015,27424,47,46,0,46,0
2020-06-20,El Dorado,017,186661,206,130,0,130,0
2020-06-20,Fresno,019,978130,6330,3222,66,3288,67
2020-06-20,Glenn,021,27897,97,40,0,40,0
2020-06-20,Humboldt,023,135768,142,108,0,108,3
2020-06-20,Imperial,025,180216,6925,4616,4,4620,37
2020-06-20,Inyo,027,18085,27,26,0,26,1
2020-06-20,Kern,029,883053,5804,3836,14,3850,59
2020-06-20,Kings,031,150075,2318,1331,6,1337,9
2020-06-20,Lake,033,64148,49,37,0,37,0
2020-06-20,Lassen,035,31185,24,7,2,9,0
2020-06-20,Los Angeles,037,10098052,95332,81604,25,81629,3093
2020-06-20,Madera,039,155013,635,321,2,323,4
2020-06-20,Marin,041,260295,1535,879,4,883,17
2020-06-20,Mariposa,043,17540,22,18,0,18,1
2020-06-20,Mendocino,045,87422,69,48,0,48,0
2020-06-20,Merced,047,269075,1033,566,1,567,8
2020-06-20,Modoc,049,8938,1,0,0,0,0
2020-06-20,Mono,051,14174,42,34,0,34,1
2020-06-20,Monterey,053,433212,1612,1181,5,1186,12
2020-06-20,Napa,055,140530,314,212,0,212,3
2020-06-20,Nevada,057,99092,105,73,1,74,1
2020-06-20,Orange,059,3164182,15965,10284,139,10423,273
2020-06-20,Placer,061,380077,667,483,3,486,9
2020-06-20,Plumas,063,18699,6,6,0,6,0
2020-06-20,Riverside,065,2383286,17578,13021,24,13045,402
2020-06-20,Sacramento,067,1510023,2697,2069,4,2073,63
2020-06-20,San Benito,069,59416,211,139,0,139,2
2020-06-20,San Bernardino,071,2135413,13150,8718,8,8726,229
2020-06-20,San Diego,073,3302833,13204,10486,2,10488,338
2020-06-20,San Francisco,075,870044,3401,2999,1,3000,47
2020-06-20,San Joaquin,077,732212,3234,2046,4,2050,48
2020-06-20,San Luis Obispo,079,281455,616,405,5,410,1
2020-06-20,San Mateo,081,765935,3121,2755,5,2760,81
2020-06-20,Santa Barbara,083,443738,2894,2358,23,2381,21
2020-06-20,Santa Clara,085,1922200,4716,3435,16,3451,154
2020-06-20,Santa Cruz,087,273765,369,287,0,287,3
2020-06-20,Shasta,089,179085,141,66,0,66,5
2020-06-20,Sierra,091,2930,1,1,0,1,0
2020-06-20,Siskiyou,093,43540,29,22,0,22,0
2020-06-20,Solano,095,438530,1276,784,4,788,21
2020-06-20,Sonoma,097,501317,1080,806,1,807,4
2020-06-20,Stanislaus,099,539301,2589,1598,5,1603,35
2020-06-20,Sutter,101,95872,130,89,0,89,2
2020-06-20,Tehama,103,63373,62,35,2,37,1
2020-06-20,Trinity,105,12862,15,2,3,5,0
2020-06-20,Tulare,107,460477,4389,3172,10,3182,111
2020-06-20,Tuolumne,109,53932,13,8,0,8,0
2020-06-20,Ventura,111,848112,2984,1946,15,1961,37
2020-06-20,Yolo,113,214977,470,309,0,309,24
2020-06-20,Yuba,115,75493,44,34,0,34,1
2020-06-19,Alameda,001,1643700,5684,4646,9,4655,119
2020-06-19,Alpine,003,1148,1,1,0,1,0
2020-06-19,Amador,005,37829,13,12,0,12,0
2020-06-19,Butte,007,227075,158,91,7,98,1
2020-06-19,Calaveras,009,45235,34,20,0,20,0
2020-06-19,Colusa,011,21464,24,7,0,7,0
2020-06-19,Contra Costa,013,1133247,2701,2106,3,2109,54
2020-06-19,Del Norte,015,27424,47,46,0,46,0
2020-06-19,El Dorado,017,186661,197,124,0,124,0
2020-06-19,Fresno,019,978130,6168,3109,64,3173,61
2020-06-19,Glenn,021,27897,91,40,0,40,0
2020-06-19,Humboldt,023,135768,140,106,0,106,3
2020-06-19,Imperial,025,180216,6834,4504,4,4508,36
2020-06-19,Inyo,027,18085,27,26,0,26,1
2020-06-19,Kern,029,883053,5581,3742,13,3755,57
2020-06-19,Kings,031,150075,2297,1285,6,1291,9
2020-06-19,Lake,033,64148,46,36,0,36,0
2020-06-19,Lassen,035,31185,23,7,2,9,0
2020-06-19,Los Angeles,037,10098052,93353,79572,24,79596,3047
2020-06-19,Madera,039,155013,616,300,2,302,4
2020-06-19,Marin,041,260295,1506,829,4,833,17
2020-06-19,Mariposa,043,17540,21,18,0,18,1
2020-06-19,Mendocino,045,87422,68,48,0,48,0
2020-06-19,Merced,047,269075,988,529,1,530,8
2020-06-19,Modoc,049,8938,1,0,0,0,0
2020-06-19,Mono,051,14174,42,34,0,34,1
2020-06-19,Monterey,053,433212,1583,1159,5,1164,12
2020-06-19,Napa,055,140530,304,209,0,209,3
2020-06-19,Nevada,057,99092,102,71,1,72,1
2020-06-19,Orange,059,3164182,15432,9972,132,10104,260
2020-06-19,Placer,061,380077,649,464,3,467,9
2020-06-19,Plumas,063,18699,6,5,0,5,0
2020-06-19,Riverside,065,2383286,17173,12710,24,12734,398
2020-06-19,Sacramento,067,1510023,2614,1976,4,1980,64
2020-06-19,San Benito,069,59416,210,136,0,136,2
2020-06-19,San Bernardino,071,2135413,12745,8454,7,8461,226
2020-06-19,San Diego,073,3302833,12841,10352,2,10354,332
2020-06-19,San Francisco,075,870044,3346,2968,1,2969,47
2020-06-19,San Joaquin,077,732212,3111,1969,4,1973,48
2020-06-19,San Luis Obispo,079,281455,600,392,5,397,1
2020-06-19,San Mateo,081,765935,3082,2713,5,2718,81
2020-06-19,Santa Barbara,083,443738,2821,2284,21,2305,21
2020-06-19,Santa Clara,085,1922200,4642,3376,16,3392,154
2020-06-19,Santa Cruz,087,273765,359,283,0,283,3
2020-06-19,Shasta,089,179085,137,58,0,58,5
2020-06-19,Sierra,091,2930,1,1,0,1,0
2020-06-19,Siskiyou,093,43540,29,21,0,21,0
2020-06-19,Solano,095,438530,1238,755,4,759,21
2020-06-19,Sonoma,097,501317,1053,803,1,804,4
2020-06-19,Stanislaus,099,539301,2479,1549,5,1554,35
2020-06-19,Sutter,101,95872,129,89,0,89,2
2020-06-19,Tehama,103,63373,61,35,2,37,1
2020-06-19,Trinity,105,12862,15,2,3,5,0
2020-06-19,Tulare,107,460477,4318,3053,10,3063,107
2020-06-19,Tuolumne,109,53932,12,8,0,8,0
2020-06-19,Ventura,111,848112,2900,1865,15,1880,37
2020-06-19,Yolo,113,214977,451,303,0,303,24
2020-06-19,Yuba,115,75493,43,33,0,33,1
2020-06-18,Alameda,001,1643700,5554,4589,9,4598,118
2020-06-18,Alpine,003,1148,1,1,0,1,0
2020-06-18,Amador,005,37829,12,12,0,12,0
2020-06-18,Butte,007,227075,153,88,7,95,1
2020-06-18,Calaveras,009,45235,34,20,0,20,0
2020-06-18,Colusa,011,21464,20,7,0,7,0
2020-06-18,Contra Costa,013,1133247,2595,2072,3,2075,53
2020-06-18,Del Norte,015,27424,47,46,0,46,0
2020-06-18,El Dorado,017,186661,193,121,0,121,0
2020-06-18,Fresno,019,978130,5901,2947,63,3010,57
2020-06-18,Glenn,021,27897,82,35,0,35,0
2020-06-18,Humboldt,023,135768,139,106,0,106,3
2020-06-18,Imperial,025,180216,6685,4366,4,4370,36
2020-06-18,Inyo,027,18085,26,25,0,25,1
2020-06-18,Kern,029,883053,5363,3634,13,3647,57
2020-06-18,Kings,031,150075,2238,1141,6,1147,8
2020-06-18,Lake,033,64148,45,36,0,36,0
2020-06-18,Lassen,035,31185,22,5,2,7,0
2020-06-18,Los Angeles,037,10098052,91084,78244,24,78268,3009
2020-06-18,Madera,039,155013,581,288,2,290,4
2020-06-18,Marin,041,260295,1443,819,4,823,17
2020-06-18,Mariposa,043,17540,19,18,0,18,1
2020-06-18,Mendocino,045,87422,64,45,0,45,0
2020-06-18,Merced,047,269075,935,486,1,487,7
2020-06-18,Modoc,049,8938,1,0,0,0,0
2020-06-18,Mono,051,14174,42,34,0,34,1
2020-06-18,Monterey,053,433212,1515,1127,5,1132,12
2020-06-18,Napa,055,140530,289,205,0,205,3
2020-06-18,Nevada,057,99092,98,68,1,69,1
2020-06-18,Orange,059,3164182,14777,9597,113,9710,255
2020-06-18,Placer,061,380077,626,457,3,460,9
2020-06-18,Plumas,063,18699,6,5,0,5,0
2020-06-18,Riverside,065,2383286,16557,12410,24,12434,392
2020-06-18,Sacramento,067,1510023,2498,1938,4,1942,63
2020-06-18,San Benito,069,59416,204,134,0,134,2
2020-06-18,San Bernardino,071,2135413,12105,8141,7,8148,226
2020-06-18,San Diego,073,3302833,12419,10094,2,10096,331
2020-06-18,San Francisco,075,870044,3297,2951,1,2952,47
2020-06-18,San Joaquin,077,732212,2959,1908,4,1912,47
2020-06-18,San Luis Obispo,079,281455,580,378,5,383,1
2020-06-18,San Mateo,081,765935,3043,2674,5,2679,78
2020-06-18,Santa Barbara,083,443738,2747,2201,21,2222,19
2020-06-18,Santa Clara,085,1922200,4539,3338,16,3354,152
2020-06-18,Santa Cruz,087,273765,342,275,0,275,3
2020-06-18,Shasta,089,179085,126,51,0,51,4
2020-06-18,Sierra,091,2930,1,1,0,1,0
2020-06-18,Siskiyou,093,43540,29,18,0,18,0
2020-06-18,Solano,095,438530,1200,735,4,739,21
2020-06-18,Sonoma,097,501317,1011,789,1,790,4
2020-06-18,Stanislaus,099,539301,2345,1495,5,1500,35
2020-06-18,Sutter,101,95872,125,85,0,85,2
2020-06-18,Tehama,103,63373,56,31,2,33,1
2020-06-18,Trinity,105,12862,15,2,3,5,0
2020-06-18,Tulare,107,460477,4196,3005,10,3015,107
2020-06-18,Tuolumne,109,53932,11,8,0,8,0
2020-06-18,Ventura,111,848112,2774,1781,15,1796,37
2020-06-18,Yolo,113,214977,418,294,0,294,24
2020-06-18,Yuba,115,75493,42,32,0,32,1
2020-06-17,Alameda,001,1643700,5431,4485,9,4494,117
2020-06-17,Alpine,003,1148,1,1,0,1,0
2020-06-17,Amador,005,37829,11,10,0,10,0
2020-06-17,Butte,007,227075,144,81,7,88,1
2020-06-17,Calaveras,009,45235,34,20,0,20,0
2020-06-17,Colusa,011,21464,19,7,0,7,0
2020-06-17,Contra Costa,013,1133247,2498,2020,3,2023,45
2020-06-17,Del Norte,015,27424,47,45,0,45,0
2020-06-17,El Dorado,017,186661,186,116,0,116,0
2020-06-17,Fresno,019,978130,5675,2801,60,2861,56
2020-06-17,Glenn,021,27897,75,31,0,31,0
2020-06-17,Humboldt,023,135768,137,105,0,105,3
2020-06-17,Imperial,025,180216,6512,4108,4,4112,36
2020-06-17,Inyo,027,18085,25,25,0,25,1
2020-06-17,Kern,029,883053,5162,3547,13,3560,56
2020-06-17,Kings,031,150075,2208,1097,6,1103,7
2020-06-17,Lake,033,64148,44,32,0,32,0
2020-06-17,Lassen,035,31185,18,5,2,7,0
2020-06-17,Los Angeles,037,10098052,88776,77166,24,77190,2973
2020-06-17,Madera,039,155013,559,258,2,260,4
2020-06-17,Marin,041,260295,1251,771,3,774,17
2020-06-17,Mariposa,043,17540,18,18,0,18,1
2020-06-17,Mendocino,045,87422,62,42,0,42,0
2020-06-17,Merced,047,269075,863,460,1,461,7
2020-06-17,Modoc,049,8938,1,0,0,0,0
2020-06-17,Mono,051,14174,42,34,0,34,1
2020-06-17,Monterey,053,433212,1463,1077,5,1082,12
2020-06-17,Napa,055,140530,274,202,0,202,3
2020-06-17,Nevada,057,99092,94,57,1,58,1
2020-06-17,Orange,059,3164182,14171,9278,107,9385,230
2020-06-17,Placer,061,380077,606,427,3,430,9
2020-06-17,Plumas,063,18699,6,5,0,5,0
2020-06-17,Riverside,065,2383286,15921,11859,24,11883,370
2020-06-17,Sacramento,067,1510023,2391,1889,4,1893,63
2020-06-17,San Benito,069,59416,199,116,0,116,2
2020-06-17,San Bernardino,071,2135413,11554,7670,7,7677,225
2020-06-17,San Diego,073,3302833,12040,9856,2,9858,327
2020-06-17,San Francisco,075,870044,3258,2906,1,2907,46
2020-06-17,San Joaquin,077,732212,2786,1825,4,1829,46
2020-06-17,San Luis Obispo,079,281455,560,362,5,367,1
2020-06-17,San Mateo,081,765935,2996,2649,5,2654,78
2020-06-17,Santa Barbara,083,443738,2674,2147,19,2166,19
2020-06-17,Santa Clara,085,1922200,4446,3264,15,3279,148
2020-06-17,Santa Cruz,087,273765,336,265,0,265,2
2020-06-17,Shasta,089,179085,124,51,0,51,4
2020-06-17,Sierra,091,2930,1,1,0,1,0
2020-06-17,Siskiyou,093,43540,28,16,0,16,0
2020-06-17,Solano,095,438530,1150,722,4,726,21
2020-06-17,Sonoma,097,501317,985,748,1,749,4
2020-06-17,Stanislaus,099,539301,2222,1387,5,1392,35
2020-06-17,Sutter,101,95872,119,79,0,79,2
2020-06-17,Tehama,103,63373,41,24,2,26,1
2020-06-17,Trinity,105,12862,14,2,3,5,0
2020-06-17,Tulare,107,460477,4086,2882,10,2892,106
2020-06-17,Tuolumne,109,53932,11,7,0,7,0
2020-06-17,Ventura,111,848112,2674,1729,15,1744,37
2020-06-17,Yolo,113,214977,398,277,0,277,24
2020-06-17,Yuba,115,75493,41,30,0,30,1
2020-06-16,Alameda,001,1643700,5313,4428,9,4437,113
2020-06-16,Alpine,003,1148,1,1,0,1,0
2020-06-16,Amador,005,37829,11,10,0,10,0
2020-06-16,Butte,007,227075,140,79,7,86,1
2020-06-16,Calaveras,009,45235,31,19,0,19,0
2020-06-16,Colusa,011,21464,16,7,0,7,0
2020-06-16,Contra Costa,013,1133247,2407,1971,2,1973,45
2020-06-16,Del Norte,015,27424,47,45,0,45,0
2020-06-16,El Dorado,017,186661,180,115,0,115,0
2020-06-16,Fresno,019,978130,5437,2731,58,2789,50
2020-06-16,Glenn,021,27897,71,30,0,30,0
2020-06-16,Humboldt,023,135768,134,105,0,105,3
2020-06-16,Imperial,025,180216,6353,3939,4,3943,36
2020-06-16,Inyo,027,18085,25,24,0,24,1
2020-06-16,Kern,029,883053,4939,3496,13,3509,55
2020-06-16,Kings,031,150075,2162,1044,6,1050,6
2020-06-16,Lake,033,64148,44,31,0,31,0
2020-06-16,Lassen,035,31185,15,5,2,7,0
2020-06-16,Los Angeles,037,10098052,86454,75051,24,75075,2942
2020-06-16,Madera,039,155013,533,239,2,241,3
2020-06-16,Marin,041,260295,1198,725,3,728,17
2020-06-16,Mariposa,043,17540,18,17,0,17,1
2020-06-16,Mendocino,045,87422,61,35,0,35,0
2020-06-16,Merced,047,269075,815,436,1,437,7
2020-06-16,Modoc,049,8938,1,0,0,0,0
2020-06-16,Mono,051,14174,42,34,0,34,1
2020-06-16,Monterey,053,433212,1415,1019,5,1024,12
2020-06-16,Napa,055,140530,259,196,0,196,3
2020-06-16,Nevada,057,99092,91,53,1,54,1
2020-06-16,Orange,059,3164182,13587,9163,103,9266,223
2020-06-16,Placer,061,380077,574,392,3,395,9
2020-06-16,Plumas,063,18699,6,5,0,5,0
2020-06-16,Riverside,065,2383286,15246,11638,24,11662,364
2020-06-16,Sacramento,067,1510023,2282,1825,4,1829,60
2020-06-16,San Benito,069,59416,191,110,0,110,2
2020-06-16,San Bernardino,071,2135413,11011,7463,7,7470,225
2020-06-16,San Diego,073,3302833,11678,9732,1,9733,323
2020-06-16,San Francisco,075,870044,3207,2893,1,2894,46
2020-06-16,San Joaquin,077,732212,2633,1718,4,1722,47
2020-06-16,San Luis Obispo,079,281455,536,343,5,348,1
2020-06-16,San Mateo,081,765935,2942,2618,5,2623,77
2020-06-16,Santa Barbara,083,443738,2607,2090,19,2109,16
2020-06-16,Santa Clara,085,1922200,4335,3228,14,3242,148
2020-06-16,Santa Cruz,087,273765,320,257,0,257,2
2020-06-16,Shasta,089,179085,115,51,0,51,4
2020-06-16,Sierra,091,2930,1,1,0,1,0
2020-06-16,Siskiyou,093,43540,27,15,0,15,0
2020-06-16,Solano,095,438530,1060,694,4,698,19
2020-06-16,Sonoma,097,501317,953,739,1,740,4
2020-06-16,Stanislaus,099,539301,2069,1278,5,1283,36
2020-06-16,Sutter,101,95872,112,73,0,73,2
2020-06-16,Tehama,103,63373,37,24,2,26,1
2020-06-16,Trinity,105,12862,14,2,3,5,0
2020-06-16,Tulare,107,460477,3967,2802,10,2812,96
2020-06-16,Tuolumne,109,53932,11,7,0,7,0
2020-06-16,Ventura,111,848112,2573,1676,15,1691,37
2020-06-16,Yolo,113,214977,375,262,0,262,24
2020-06-16,Yuba,115,75493,39,29,0,29,1
2020-06-15,Alameda,001,1643700,5187,4323,9,4332,112
2020-06-15,Alpine,003,1148,1,1,0,1,0
2020-06-15,Amador,005,37829,11,10,0,10,0
2020-06-15,Butte,007,227075,132,78,7,85,1
2020-06-15,Calaveras,009,45235,31,18,0,18,0
2020-06-15,Colusa,011,21464,14,7,0,7,0
2020-06-15,Contra Costa,013,1133247,2330,1918,2,1920,43
2020-06-15,Del Norte,015,27424,47,45,0,45,0
2020-06-15,El Dorado,017,186661,170,114,0,114,0
2020-06-15,Fresno,019,978130,5225,2616,57,2673,48
2020-06-15,Glenn,021,27897,66,21,0,21,0
2020-06-15,Humboldt,023,135768,132,105,0,105,3
2020-06-15,Imperial,025,180216,6178,3726,4,3730,36
2020-06-15,Inyo,027,18085,25,23,0,23,1
2020-06-15,Kern,029,883053,4715,3417,13,3430,55
2020-06-15,Kings,031,150075,2085,1022,6,1028,6
2020-06-15,Lake,033,64148,44,31,0,31,0
2020-06-15,Lassen,035,31185,15,5,2,7,0
2020-06-15,Los Angeles,037,10098052,84267,73705,24,73729,2908
2020-06-15,Madera,039,155013,511,203,2,205,3
2020-06-15,Marin,041,260295,1031,708,3,711,17
2020-06-15,Mariposa,043,17540,18,17,0,17,1
2020-06-15,Mendocino,045,87422,52,33,0,33,0
2020-06-15,Merced,047,269075,769,414,1,415,7
2020-06-15,Modoc,049,8938,1,0,0,0,0
2020-06-15,Mono,051,14174,42,34,0,34,1
2020-06-15,Monterey,053,433212,1349,998,5,1003,12
2020-06-15,Napa,055,140530,251,187,0,187,3
2020-06-15,Nevada,057,99092,85,52,1,53,1
2020-06-15,Orange,059,3164182,13019,8944,95,9039,212
2020-06-15,Placer,061,380077,552,386,3,389,9
2020-06-15,Plumas,063,18699,6,4,0,4,0
2020-06-15,Riverside,065,2383286,14628,11376,23,11399,364
2020-06-15,Sacramento,067,1510023,2166,1791,4,1795,60
2020-06-15,San Benito,069,59416,185,108,0,108,2
2020-06-15,San Bernardino,071,2135413,10507,7189,7,7196,224
2020-06-15,San Diego,073,3302833,11338,9612,1,9613,320
2020-06-15,San Francisco,075,870044,3163,2833,1,2834,45
2020-06-15,San Joaquin,077,732212,2497,1667,4,1671,43
2020-06-15,San Luis Obispo,079,281455,521,332,5,337,1
2020-06-15,San Mateo,081,765935,2895,2591,5,2596,75
2020-06-15,Santa Barbara,083,443738,2539,2054,19,2073,16
2020-06-15,Santa Clara,085,1922200,4235,3204,14,3218,148
2020-06-15,Santa Cruz,087,273765,309,254,0,254,2
2020-06-15,Shasta,089,179085,109,50,0,50,4
2020-06-15,Sierra,091,2930,1,1,0,1,0
2020-06-15,Siskiyou,093,43540,26,14,0,14,0
2020-06-15,Solano,095,438530,1000,638,4,642,19
2020-06-15,Sonoma,097,501317,924,726,1,727,4
2020-06-15,Stanislaus,099,539301,1952,1253,5,1258,35
2020-06-15,Sutter,101,95872,102,71,0,71,2
2020-06-15,Tehama,103,63373,37,17,2,19,1
2020-06-15,Trinity,105,12862,13,2,3,5,0
2020-06-15,Tulare,107,460477,3853,2662,10,2672,96
2020-06-15,Tuolumne,109,53932,10,7,0,7,0
2020-06-15,Ventura,111,848112,2492,1656,15,1671,37
2020-06-15,Yolo,113,214977,355,255,0,255,24
2020-06-15,Yuba,115,75493,39,28,0,28,1
2020-06-14,Alameda,001,1643700,5042,4271,9,4280,112
2020-06-14,Alpine,003,1148,1,1,0,1,0
2020-06-14,Amador,005,37829,11,10,0,10,0
2020-06-14,Butte,007,227075,124,78,7,85,1
2020-06-14,Calaveras,009,45235,30,18,0,18,0
2020-06-14,Colusa,011,21464,13,7,0,7,0
2020-06-14,Contra Costa,013,1133247,2261,1893,2,1895,43
2020-06-14,Del Norte,015,27424,47,45,0,45,0
2020-06-14,El Dorado,017,186661,166,110,0,110,0
2020-06-14,Fresno,019,978130,5040,2585,56,2641,48
2020-06-14,Glenn,021,27897,51,21,0,21,0
2020-06-14,Humboldt,023,135768,128,105,0,105,3
2020-06-14,Imperial,025,180216,5947,3730,4,3734,36
2020-06-14,Inyo,027,18085,24,23,0,23,1
2020-06-14,Kern,029,883053,4504,3328,13,3341,55
2020-06-14,Kings,031,150075,2034,1022,5,1027,6
2020-06-14,Lake,033,64148,41,31,0,31,0
2020-06-14,Lassen,035,31185,15,5,2,7,0
2020-06-14,Los Angeles,037,10098052,81941,72932,23,72955,2887
2020-06-14,Madera,039,155013,492,203,2,205,3
2020-06-14,Marin,041,260295,866,689,2,691,17
2020-06-14,Mariposa,043,17540,18,16,0,16,1
2020-06-14,Mendocino,045,87422,49,33,0,33,0
2020-06-14,Merced,047,269075,718,403,1,404,7
2020-06-14,Modoc,049,8938,1,0,0,0,0
2020-06-14,Mono,051,14174,42,34,0,34,1
2020-06-14,Monterey,053,433212,1288,949,5,954,12
2020-06-14,Napa,055,140530,229,181,0,181,3
2020-06-14,Nevada,057,99092,81,52,1,53,1
2020-06-14,Orange,059,3164182,12592,8744,90,8834,211
2020-06-14,Placer,061,380077,526,369,3,372,9
2020-06-14,Plumas,063,18699,5,4,0,4,0
2020-06-14,Riverside,065,2383286,14186,11218,23,11241,364
2020-06-14,Sacramento,067,1510023,2079,1750,4,1754,60
2020-06-14,San Benito,069,59416,174,104,0,104,2
2020-06-14,San Bernardino,071,2135413,9966,7015,7,7022,224
2020-06-14,San Diego,073,3302833,10963,9442,1,9443,319
2020-06-14,San Francisco,075,870044,3123,2834,1,2835,45
2020-06-14,San Joaquin,077,732212,2346,1603,4,1607,43
2020-06-14,San Luis Obispo,079,281455,506,330,5,335,1
2020-06-14,San Mateo,081,765935,2837,2571,5,2576,75
2020-06-14,Santa Barbara,083,443738,2462,2049,19,2068,17
2020-06-14,Santa Clara,085,1922200,4140,3178,14,3192,148
2020-06-14,Santa Cruz,087,273765,295,254,0,254,2
2020-06-14,Shasta,089,179085,103,48,0,48,4
2020-06-14,Sierra,091,2930,1,1,0,1,0
2020-06-14,Siskiyou,093,43540,25,13,0,13,0
2020-06-14,Solano,095,438530,951,638,4,642,19
2020-06-14,Sonoma,097,501317,896,724,1,725,4
2020-06-14,Stanislaus,099,539301,1804,1159,5,1164,35
2020-06-14,Sutter,101,95872,97,63,0,63,2
2020-06-14,Tehama,103,63373,34,17,2,19,1
2020-06-14,Trinity,105,12862,13,2,3,5,0
2020-06-14,Tulare,107,460477,3719,2646,10,2656,96
2020-06-14,Tuolumne,109,53932,10,7,0,7,0
2020-06-14,Ventura,111,848112,2393,1610,14,1624,37
2020-06-14,Yolo,113,214977,339,254,0,254,24
2020-06-14,Yuba,115,75493,38,28,0,28,1
2020-06-13,Alameda,001,1643700,4979,4196,9,4205,112
2020-06-13,Alpine,003,1148,1,1,0,1,0
2020-06-13,Amador,005,37829,10,10,0,10,0
2020-06-13,Butte,007,227075,115,72,7,79,1
2020-06-13,Calaveras,009,45235,28,18,0,18,0
2020-06-13,Colusa,011,21464,12,7,0,7,0
2020-06-13,Contra Costa,013,1133247,2225,1868,2,1870,43
2020-06-13,Del Norte,015,27424,47,45,0,45,0
2020-06-13,El Dorado,017,186661,162,110,0,110,0
2020-06-13,Fresno,019,978130,4942,2499,56,2555,48
2020-06-13,Glenn,021,27897,49,21,0,21,0
2020-06-13,Humboldt,023,135768,127,104,0,104,3
2020-06-13,Imperial,025,180216,5874,3646,4,3650,36
2020-06-13,Inyo,027,18085,24,23,0,23,1
2020-06-13,Kern,029,883053,4395,3239,13,3252,55
2020-06-13,Kings,031,150075,2014,1023,5,1028,6
2020-06-13,Lake,033,64148,40,29,0,29,0
2020-06-13,Lassen,035,31185,15,5,2,7,0
2020-06-13,Los Angeles,037,10098052,80903,71938,23,71961,2874
2020-06-13,Madera,039,155013,488,203,2,205,3
2020-06-13,Marin,041,260295,835,677,2,679,17
2020-06-13,Mariposa,043,17540,18,16,0,16,1
2020-06-13,Mendocino,045,87422,49,33,0,33,0
2020-06-13,Merced,047,269075,700,376,1,377,7
2020-06-13,Modoc,049,8938,1,0,0,0,0
2020-06-13,Mono,051,14174,42,35,0,35,1
2020-06-13,Monterey,053,433212,1250,900,5,905,11
2020-06-13,Napa,055,140530,226,171,0,171,3
2020-06-13,Nevada,057,99092,79,52,1,53,1
2020-06-13,Orange,059,3164182,12348,8581,87,8668,211
2020-06-13,Placer,061,380077,509,346,3,349,9
2020-06-13,Plumas,063,18699,5,4,0,4,0
2020-06-13,Riverside,065,2383286,13907,10931,23,10954,364
2020-06-13,Sacramento,067,1510023,2025,1713,4,1717,60
2020-06-13,San Benito,069,59416,167,99,0,99,2
2020-06-13,San Bernardino,071,2135413,9741,6885,7,6892,224
2020-06-13,San Diego,073,3302833,10791,9316,1,9317,319
2020-06-13,San Francisco,075,870044,3103,2834,1,2835,44
2020-06-13,San Joaquin,077,732212,2265,1461,4,1465,43
2020-06-13,San Luis Obispo,079,281455,495,326,5,331,1
2020-06-13,San Mateo,081,765935,2814,2551,5,2556,75
2020-06-13,Santa Barbara,083,443738,2404,1999,19,2018,15
2020-06-13,Santa Clara,085,1922200,4097,3141,14,3155,148
2020-06-13,Santa Cruz,087,273765,289,254,0,254,2
2020-06-13,Shasta,089,179085,101,48,0,48,4
2020-06-13,Sierra,091,2930,1,1,0,1,0
2020-06-13,Siskiyou,093,43540,25,13,0,13,0
2020-06-13,Solano,095,438530,923,637,4,641,19
2020-06-13,Sonoma,097,501317,881,711,1,712,4
2020-06-13,Stanislaus,099,539301,1747,1122,5,1127,33
2020-06-13,Sutter,101,95872,96,62,0,62,2
2020-06-13,Tehama,103,63373,33,17,2,19,1
2020-06-13,Trinity,105,12862,13,2,3,5,0
2020-06-13,Tulare,107,460477,3687,2626,10,2636,96
2020-06-13,Tuolumne,109,53932,9,7,0,7,0
2020-06-13,Ventura,111,848112,2347,1567,14,1581,37
2020-06-13,Yolo,113,214977,318,251,0,251,24
2020-06-13,Yuba,115,75493,38,28,0,28,1
2020-06-12,Alameda,001,1643700,4906,4167,9,4176,109
2020-06-12,Alpine,003,1148,1,1,0,1,0
2020-06-12,Amador,005,37829,10,10,0,10,0
2020-06-12,Butte,007,227075,111,71,7,78,1
2020-06-12,Calaveras,009,45235,25,18,0,18,0
2020-06-12,Colusa,011,21464,12,7,0,7,0
2020-06-12,Contra Costa,013,1133247,2188,1827,2,1829,43
2020-06-12,Del Norte,015,27424,47,45,0,45,0
2020-06-12,El Dorado,017,186661,162,110,0,110,0
2020-06-12,Fresno,019,978130,4804,2428,56,2484,47
2020-06-12,Glenn,021,27897,46,21,0,21,0
2020-06-12,Humboldt,023,135768,125,105,0,105,3
2020-06-12,Imperial,025,180216,5790,3543,4,3547,36
2020-06-12,Inyo,027,18085,24,23,0,23,1
2020-06-12,Kern,029,883053,4278,3152,13,3165,54
2020-06-12,Kings,031,150075,2001,987,5,992,6
2020-06-12,Lake,033,64148,39,29,0,29,0
2020-06-12,Lassen,035,31185,15,5,2,7,0
2020-06-12,Los Angeles,037,10098052,79497,70385,23,70408,2814
2020-06-12,Madera,039,155013,463,187,2,189,3
2020-06-12,Marin,041,260295,832,649,2,651,17
2020-06-12,Mariposa,043,17540,18,16,0,16,1
2020-06-12,Mendocino,045,87422,49,33,0,33,0
2020-06-12,Merced,047,269075,666,372,1,373,7
2020-06-12,Modoc,049,8938,1,0,0,0,0
2020-06-12,Mono,051,14174,39,35,0,35,1
2020-06-12,Monterey,053,433212,1209,864,4,868,11
2020-06-12,Napa,055,140530,223,162,0,162,3
2020-06-12,Nevada,057,99092,73,52,1,53,1
2020-06-12,Orange,059,3164182,12042,8440,86,8526,203
2020-06-12,Placer,061,380077,492,333,3,336,9
2020-06-12,Plumas,063,18699,5,4,0,4,0
2020-06-12,Riverside,065,2383286,13570,10616,23,10639,364
2020-06-12,Sacramento,067,1510023,1970,1702,4,1706,60
2020-06-12,San Benito,069,59416,160,96,0,96,2
2020-06-12,San Bernardino,071,2135413,9473,6707,7,6714,223
2020-06-12,San Diego,073,3302833,10621,9132,1,9133,313
2020-06-12,San Francisco,075,870044,3069,2823,1,2824,44
2020-06-12,San Joaquin,077,732212,2185,1406,4,1410,43
2020-06-12,San Luis Obispo,079,281455,479,321,5,326,1
2020-06-12,San Mateo,081,765935,2779,2533,5,2538,75
2020-06-12,Santa Barbara,083,443738,2350,1969,19,1988,14
2020-06-12,Santa Clara,085,1922200,4053,3099,14,3113,149
2020-06-12,Santa Cruz,087,273765,281,251,0,251,2
2020-06-12,Shasta,089,179085,94,48,0,48,5
2020-06-12,Sierra,091,2930,1,1,0,1,0
2020-06-12,Siskiyou,093,43540,25,13,0,13,0
2020-06-12,Solano,095,438530,909,620,4,624,19
2020-06-12,Sonoma,097,501317,862,696,1,697,4
2020-06-12,Stanislaus,099,539301,1688,1092,5,1097,33
2020-06-12,Sutter,101,95872,95,56,0,56,2
2020-06-12,Tehama,103,63373,32,13,2,15,1
2020-06-12,Trinity,105,12862,13,2,3,5,0
2020-06-12,Tulare,107,460477,3633,2552,10,2562,95
2020-06-12,Tuolumne,109,53932,9,7,0,7,0
2020-06-12,Ventura,111,848112,2295,1534,14,1548,35
2020-06-12,Yolo,113,214977,306,243,0,243,24
2020-06-12,Yuba,115,75493,36,27,0,27,1
2020-06-11,Alameda,001,1643700,4776,4073,8,4081,108
2020-06-11,Alpine,003,1148,1,1,0,1,0
2020-06-11,Amador,005,37829,9,10,0,10,0
2020-06-11,Butte,007,227075,105,72,7,79,1
2020-06-11,Calaveras,009,45235,24,16,0,16,0
2020-06-11,Colusa,011,21464,12,7,0,7,0
2020-06-11,Contra Costa,013,1133247,2135,1797,2,1799,43
2020-06-11,Del Norte,015,27424,47,45,0,45,0
2020-06-11,El Dorado,017,186661,154,109,0,109,0
2020-06-11,Fresno,019,978130,4650,2338,56,2394,45
2020-06-11,Glenn,021,27897,42,21,0,21,0
2020-06-11,Humboldt,023,135768,121,113,0,113,3
2020-06-11,Imperial,025,180216,5634,3463,4,3467,36
2020-06-11,Inyo,027,18085,22,23,0,23,1
2020-06-11,Kern,029,883053,4126,3047,11,3058,54
2020-06-11,Kings,031,150075,1968,963,5,968,6
2020-06-11,Lake,033,64148,39,28,0,28,0
2020-06-11,Lassen,035,31185,15,5,2,7,0
2020-06-11,Los Angeles,037,10098052,77831,68807,22,68829,2800
2020-06-11,Madera,039,155013,445,178,2,180,3
2020-06-11,Marin,041,260295,784,637,2,639,17
2020-06-11,Mariposa,043,17540,18,16,0,16,1
2020-06-11,Mendocino,045,87422,40,35,0,35,0
2020-06-11,Merced,047,269075,626,370,1,371,7
2020-06-11,Modoc,049,8938,1,0,0,0,0
2020-06-11,Mono,051,14174,39,35,0,35,1
2020-06-11,Monterey,053,433212,1162,813,4,817,11
2020-06-11,Napa,055,140530,214,162,0,162,3
2020-06-11,Nevada,057,99092,67,50,1,51,1
2020-06-11,Orange,059,3164182,11734,8304,85,8389,188
2020-06-11,Placer,061,380077,473,321,3,324,9
2020-06-11,Plumas,063,18699,5,4,0,4,0
2020-06-11,Riverside,065,2383286,13217,10014,23,10037,361
2020-06-11,Sacramento,067,1510023,1922,1669,4,1673,60
2020-06-11,San Benito,069,59416,154,94,0,94,2
2020-06-11,San Bernardino,071,2135413,9176,6509,7,6516,221
2020-06-11,San Diego,073,3302833,10391,9000,0,9000,308
2020-06-11,San Francisco,075,870044,3040,2766,1,2767,44
2020-06-11,San Joaquin,077,732212,2073,1351,4,1355,43
2020-06-11,San Luis Obispo,079,281455,465,307,5,312,1
2020-06-11,San Mateo,081,765935,2741,2499,5,2504,74
2020-06-11,Santa Barbara,083,443738,2289,1895,19,1914,14
2020-06-11,Santa Clara,085,1922200,3986,3049,14,3063,149
2020-06-11,Santa Cruz,087,273765,277,247,0,247,2
2020-06-11,Shasta,089,179085,87,47,0,47,5
2020-06-11,Sierra,091,2930,1,1,0,1,0
2020-06-11,Siskiyou,093,43540,25,14,0,14,0
2020-06-11,Solano,095,438530,883,616,4,620,19
2020-06-11,Sonoma,097,501317,839,682,1,683,4
2020-06-11,Stanislaus,099,539301,1597,1062,5,1067,30
2020-06-11,Sutter,101,95872,92,56,0,56,2
2020-06-11,Tehama,103,63373,27,10,2,12,1
2020-06-11,Trinity,105,12862,11,2,3,5,0
2020-06-11,Tulare,107,460477,3534,2473,10,2483,95
2020-06-11,Tuolumne,109,53932,9,7,0,7,0
2020-06-11,Ventura,111,848112,2218,1491,13,1504,34
2020-06-11,Yolo,113,214977,298,230,0,230,24
2020-06-11,Yuba,115,75493,36,27,0,27,1
2020-06-10,Alameda,001,1643700,4676,4027,7,4034,107
2020-06-10,Alpine,003,1148,1,1,0,1,0
2020-06-10,Amador,005,37829,9,10,0,10,0
2020-06-10,Butte,007,227075,102,71,7,78,1
2020-06-10,Calaveras,009,45235,24,16,0,16,0
2020-06-10,Colusa,011,21464,11,7,0,7,0
2020-06-10,Contra Costa,013,1133247,2091,1778,2,1780,43
2020-06-10,Del Norte,015,27424,47,45,0,45,0
2020-06-10,El Dorado,017,186661,151,109,0,109,0
2020-06-10,Fresno,019,978130,4473,2324,56,2380,45
2020-06-10,Glenn,021,27897,39,21,0,21,0
2020-06-10,Humboldt,023,135768,117,112,0,112,3
2020-06-10,Imperial,025,180216,5486,3454,4,3458,36
2020-06-10,Inyo,027,18085,22,23,0,23,1
2020-06-10,Kern,029,883053,4001,3000,10,3010,54
2020-06-10,Kings,031,150075,1922,952,4,956,6
2020-06-10,Lake,033,64148,39,28,0,28,0
2020-06-10,Lassen,035,31185,15,5,2,7,0
2020-06-10,Los Angeles,037,10098052,76311,67018,22,67040,2752
2020-06-10,Madera,039,155013,431,176,1,177,3
2020-06-10,Marin,041,260295,752,633,2,635,17
2020-06-10,Mariposa,043,17540,17,16,0,16,1
2020-06-10,Mendocino,045,87422,39,35,0,35,0
2020-06-10,Merced,047,269075,593,370,1,371,7
2020-06-10,Modoc,049,8938,1,0,0,0,0
2020-06-10,Mono,051,14174,39,35,0,35,1
2020-06-10,Monterey,053,433212,1108,791,4,795,11
2020-06-10,Napa,055,140530,211,159,0,159,3
2020-06-10,Nevada,057,99092,65,50,1,51,1
2020-06-10,Orange,059,3164182,11458,8222,82,8304,184
2020-06-10,Placer,061,380077,448,309,3,312,9
2020-06-10,Plumas,063,18699,5,4,0,4,0
2020-06-10,Riverside,065,2383286,12894,9857,23,9880,361
2020-06-10,Sacramento,067,1510023,1883,1643,2,1645,59
2020-06-10,San Benito,069,59416,145,94,0,94,2
2020-06-10,San Bernardino,071,2135413,8884,6438,7,6445,219
2020-06-10,San Diego,073,3302833,10227,8839,0,8839,305
2020-06-10,San Francisco,075,870044,3015,2774,1,2775,44
2020-06-10,San Joaquin,077,732212,1944,1282,4,1286,41
2020-06-10,San Luis Obispo,079,281455,445,306,5,311,1
2020-06-10,San Mateo,081,765935,2701,2492,5,2497,74
2020-06-10,Santa Barbara,083,443738,2233,1878,19,1897,13
2020-06-10,Santa Clara,085,1922200,3935,3032,14,3046,149
2020-06-10,Santa Cruz,087,273765,273,242,0,242,2
2020-06-10,Shasta,089,179085,82,45,0,45,5
2020-06-10,Sierra,091,2930,1,1,0,1,0
2020-06-10,Siskiyou,093,43540,25,14,0,14,0
2020-06-10,Solano,095,438530,847,608,4,612,19
2020-06-10,Sonoma,097,501317,821,673,1,674,4
2020-06-10,Stanislaus,099,539301,1507,1030,5,1035,29
2020-06-10,Sutter,101,95872,91,56,0,56,2
2020-06-10,Tehama,103,63373,25,10,2,12,1
2020-06-10,Trinity,105,12862,11,2,3,5,0
2020-06-10,Tulare,107,460477,3441,2455,10,2465,95
2020-06-10,Tuolumne,109,53932,9,7,0,7,0
2020-06-10,Ventura,111,848112,2172,1446,12,1458,34
2020-06-10,Yolo,113,214977,290,226,0,226,24
2020-06-10,Yuba,115,75493,35,27,0,27,1
2020-06-09,Alameda,001,1643700,4566,3963,7,3970,103
2020-06-09,Alpine,003,1148,1,1,0,1,0
2020-06-09,Amador,005,37829,9,10,0,10,0
2020-06-09,Butte,007,227075,101,70,6,76,1
2020-06-09,Calaveras,009,45235,24,16,0,16,0
2020-06-09,Colusa,011,21464,10,7,0,7,0
2020-06-09,Contra Costa,013,1133247,2050,1744,2,1746,42
2020-06-09,Del Norte,015,27424,47,45,0,45,0
2020-06-09,El Dorado,017,186661,141,108,0,108,0
2020-06-09,Fresno,019,978130,4321,2278,56,2334,43
2020-06-09,Glenn,021,27897,38,19,0,19,0
2020-06-09,Humboldt,023,135768,115,113,0,113,2
2020-06-09,Imperial,025,180216,5334,3067,4,3071,36
2020-06-09,Inyo,027,18085,22,22,0,22,1
2020-06-09,Kern,029,883053,3873,2920,10,2930,51
2020-06-09,Kings,031,150075,1890,934,4,938,6
2020-06-09,Lake,033,64148,39,28,0,28,0
2020-06-09,Lassen,035,31185,15,5,2,7,0
2020-06-09,Los Angeles,037,10098052,74653,65827,22,65849,2692
2020-06-09,Madera,039,155013,416,172,1,173,3
2020-06-09,Marin,041,260295,716,616,2,618,17
2020-06-09,Mariposa,043,17540,17,16,0,16,1
2020-06-09,Mendocino,045,87422,35,35,0,35,0
2020-06-09,Merced,047,269075,564,349,1,350,7
2020-06-09,Modoc,049,8938,1,0,0,0,0
2020-06-09,Mono,051,14174,39,35,0,35,1
2020-06-09,Monterey,053,433212,1067,772,4,776,11
2020-06-09,Napa,055,140530,201,156,0,156,3
2020-06-09,Nevada,057,99092,57,50,1,51,1
2020-06-09,Orange,059,3164182,11217,7991,80,8071,174
2020-06-09,Placer,061,380077,435,301,3,304,9
2020-06-09,Plumas,063,18699,5,4,0,4,0
2020-06-09,Riverside,065,2383286,12516,9511,23,9534,354
2020-06-09,Sacramento,067,1510023,1829,1625,2,1627,59
2020-06-09,San Benito,069,59416,139,95,0,95,2
2020-06-09,San Bernardino,071,2135413,8560,6268,6,6274,217
2020-06-09,San Diego,073,3302833,10042,8731,0,8731,301
2020-06-09,San Francisco,075,870044,2990,2749,1,2750,44
2020-06-09,San Joaquin,077,732212,1838,1240,4,1244,41
2020-06-09,San Luis Obispo,079,281455,432,301,4,305,1
2020-06-09,San Mateo,081,765935,2670,2463,5,2468,74
2020-06-09,Santa Barbara,083,443738,2177,1854,19,1873,13
2020-06-09,Santa Clara,085,1922200,3867,3006,13,3019,147
2020-06-09,Santa Cruz,087,273765,267,237,0,237,2
2020-06-09,Shasta,089,179085,78,44,0,44,4
2020-06-09,Sierra,091,2930,1,1,0,1,0
2020-06-09,Siskiyou,093,43540,20,10,0,10,0
2020-06-09,Solano,095,438530,812,596,4,600,18
2020-06-09,Sonoma,097,501317,798,661,1,662,4
2020-06-09,Stanislaus,099,539301,1406,993,5,998,25
2020-06-09,Sutter,101,95872,88,56,0,56,2
2020-06-09,Tehama,103,63373,25,9,2,11,1
2020-06-09,Trinity,105,12862,10,2,3,5,0
2020-06-09,Tulare,107,460477,3375,2393,10,2403,91
2020-06-09,Tuolumne,109,53932,9,8,0,8,0
2020-06-09,Ventura,111,848112,2106,1407,12,1419,34
2020-06-09,Yolo,113,214977,279,226,0,226,24
2020-06-09,Yuba,115,75493,34,27,0,27,1
2020-06-08,Alameda,001,1643700,4486,3937,7,3944,103
2020-06-08,Alpine,003,1148,1,1,0,1,0
2020-06-08,Amador,005,37829,9,10,0,10,0
2020-06-08,Butte,007,227075,97,68,6,74,1
2020-06-08,Calaveras,009,45235,24,16,0,16,0
2020-06-08,Colusa,011,21464,9,7,0,7,0
2020-06-08,Contra Costa,013,1133247,2007,1714,2,1716,41
2020-06-08,Del Norte,015,27424,47,45,0,45,0
2020-06-08,El Dorado,017,186661,137,107,0,107,0
2020-06-08,Fresno,019,978130,4197,2194,55,2249,42
2020-06-08,Glenn,021,27897,36,17,0,17,0
2020-06-08,Humboldt,023,135768,115,112,0,112,2
2020-06-08,Imperial,025,180216,5182,3051,4,3055,21
2020-06-08,Inyo,027,18085,22,22,0,22,1
2020-06-08,Kern,029,883053,3742,2853,9,2862,49
2020-06-08,Kings,031,150075,1814,892,4,896,6
2020-06-08,Lake,033,64148,39,28,0,28,0
2020-06-08,Lassen,035,31185,15,4,2,6,0
2020-06-08,Los Angeles,037,10098052,73191,64634,22,64656,2640
2020-06-08,Madera,039,155013,386,154,1,155,3
2020-06-08,Marin,041,260295,675,596,2,598,17
2020-06-08,Mariposa,043,17540,16,16,0,16,1
2020-06-08,Mendocino,045,87422,33,32,0,32,0
2020-06-08,Merced,047,269075,530,331,1,332,7
2020-06-08,Modoc,049,8938,1,0,0,0,0
2020-06-08,Mono,051,14174,39,35,0,35,1
2020-06-08,Monterey,053,433212,1016,751,3,754,10
2020-06-08,Napa,055,140530,185,151,0,151,3
2020-06-08,Nevada,057,99092,56,50,1,51,1
2020-06-08,Orange,059,3164182,10966,7786,78,7864,160
2020-06-08,Placer,061,380077,418,290,3,293,9
2020-06-08,Plumas,063,18699,5,4,0,4,0
2020-06-08,Riverside,065,2383286,12147,9246,23,9269,347
2020-06-08,Sacramento,067,1510023,1779,1591,2,1593,59
2020-06-08,San Benito,069,59416,132,93,0,93,2
2020-06-08,San Bernardino,071,2135413,8239,6122,6,6128,214
2020-06-08,San Diego,073,3302833,9885,8621,0,8621,296
2020-06-08,San Francisco,075,870044,2963,2715,1,2716,43
2020-06-08,San Joaquin,077,732212,1731,1198,4,1202,40
2020-06-08,San Luis Obispo,079,281455,425,300,4,304,1
2020-06-08,San Mateo,081,765935,2639,2431,4,2435,74
2020-06-08,Santa Barbara,083,443738,2122,1824,17,1841,13
2020-06-08,Santa Clara,085,1922200,3821,2971,13,2984,146
2020-06-08,Santa Cruz,087,273765,266,234,0,234,2
2020-06-08,Shasta,089,179085,74,43,0,43,4
2020-06-08,Sierra,091,2930,1,1,0,1,0
2020-06-08,Siskiyou,093,43540,20,8,0,8,0
2020-06-08,Solano,095,438530,785,560,4,564,19
2020-06-08,Sonoma,097,501317,782,654,1,655,4
2020-06-08,Stanislaus,099,539301,1324,956,5,961,28
2020-06-08,Sutter,101,95872,81,55,0,55,2
2020-06-08,Tehama,103,63373,19,8,2,10,1
2020-06-08,Trinity,105,12862,10,2,3,5,0
2020-06-08,Tulare,107,460477,3292,2301,10,2311,91
2020-06-08,Tuolumne,109,53932,8,8,0,8,0
2020-06-08,Ventura,111,848112,2048,1382,12,1394,30
2020-06-08,Yolo,113,214977,268,228,0,228,24
2020-06-08,Yuba,115,75493,32,27,0,27,1
2020-06-07,Alameda,001,1643700,4373,3866,7,3873,102
2020-06-07,Alpine,003,1148,1,1,0,1,0
2020-06-07,Amador,005,37829,9,10,0,10,0
2020-06-07,Butte,007,227075,95,64,5,69,1
2020-06-07,Calaveras,009,45235,22,16,0,16,0
2020-06-07,Colusa,011,21464,9,7,0,7,0
2020-06-07,Contra Costa,013,1133247,1956,1653,1,1654,38
2020-06-07,Del Norte,015,27424,45,45,0,45,0
2020-06-07,El Dorado,017,186661,137,104,0,104,0
2020-06-07,Fresno,019,978130,4067,2144,55,2199,41
2020-06-07,Glenn,021,27897,29,16,0,16,0
2020-06-07,Humboldt,023,135768,115,112,0,112,2
2020-06-07,Imperial,025,180216,5031,3048,4,3052,19
2020-06-07,Inyo,027,18085,22,21,0,21,1
2020-06-07,Kern,029,883053,3611,2771,9,2780,46
2020-06-07,Kings,031,150075,1765,882,4,886,6
2020-06-07,Lake,033,64148,36,28,0,28,0
2020-06-07,Lassen,035,31185,14,4,2,6,0
2020-06-07,Los Angeles,037,10098052,71488,63750,22,63772,2629
2020-06-07,Madera,039,155013,369,149,1,150,3
2020-06-07,Marin,041,260295,661,584,2,586,17
2020-06-07,Mariposa,043,17540,16,16,0,16,1
2020-06-07,Mendocino,045,87422,33,32,0,32,0
2020-06-07,Merced,047,269075,497,318,1,319,7
2020-06-07,Modoc,049,8938,1,0,0,0,0
2020-06-07,Mono,051,14174,39,35,0,35,1
2020-06-07,Monterey,053,433212,969,732,3,735,10
2020-06-07,Napa,055,140530,177,142,0,142,3
2020-06-07,Nevada,057,99092,55,50,1,51,1
2020-06-07,Orange,059,3164182,10709,7643,76,7719,158
2020-06-07,Placer,061,380077,397,273,2,275,9
2020-06-07,Plumas,063,18699,5,4,0,4,0
2020-06-07,Riverside,065,2383286,11851,9105,23,9128,344
2020-06-07,Sacramento,067,1510023,1731,1568,2,1570,59
2020-06-07,San Benito,069,59416,129,92,0,92,2
2020-06-07,San Bernardino,071,2135413,7954,6033,6,6039,214
2020-06-07,San Diego,073,3302833,9706,8478,0,8478,296
2020-06-07,San Francisco,075,870044,2919,2674,0,2674,43
2020-06-07,San Joaquin,077,732212,1630,1126,4,1130,37
2020-06-07,San Luis Obispo,079,281455,415,296,4,300,1
2020-06-07,San Mateo,081,765935,2612,2399,4,2403,73
2020-06-07,Santa Barbara,083,443738,2067,1818,17,1835,13
2020-06-07,Santa Clara,085,1922200,3769,2947,13,2960,146
2020-06-07,Santa Cruz,087,273765,258,230,0,230,2
2020-06-07,Shasta,089,179085,73,41,0,41,4
2020-06-07,Sierra,091,2930,1,1,0,1,0
2020-06-07,Siskiyou,093,43540,20,8,0,8,0
2020-06-07,Solano,095,438530,762,560,4,564,19
2020-06-07,Sonoma,097,501317,751,639,1,640,4
2020-06-07,Stanislaus,099,539301,1244,905,5,910,28
2020-06-07,Sutter,101,95872,73,55,0,55,2
2020-06-07,Tehama,103,63373,16,8,2,10,1
2020-06-07,Trinity,105,12862,8,2,3,5,0
2020-06-07,Tulare,107,460477,3170,2219,10,2229,90
2020-06-07,Tuolumne,109,53932,8,4,0,4,0
2020-06-07,Ventura,111,848112,1982,1337,12,1349,30
2020-06-07,Yolo,113,214977,258,224,0,224,24
2020-06-07,Yuba,115,75493,32,27,0,27,1
2020-06-06,Alameda,001,1643700,4328,3801,7,3808,102
2020-06-06,Alpine,003,1148,1,1,0,1,0
2020-06-06,Amador,005,37829,9,10,0,10,0
2020-06-06,Butte,007,227075,94,63,5,68,1
2020-06-06,Calaveras,009,45235,20,16,0,16,0
2020-06-06,Colusa,011,21464,9,7,0,7,0
2020-06-06,Contra Costa,013,1133247,1935,1619,1,1620,37
2020-06-06,Del Norte,015,27424,45,45,0,45,0
2020-06-06,El Dorado,017,186661,132,104,0,104,0
2020-06-06,Fresno,019,978130,4012,2117,55,2172,41
2020-06-06,Glenn,021,27897,27,16,0,16,0
2020-06-06,Humboldt,023,135768,115,112,0,112,2
2020-06-06,Imperial,025,180216,4955,3047,4,3051,19
2020-06-06,Inyo,027,18085,22,21,0,21,1
2020-06-06,Kern,029,883053,3540,2695,9,2704,46
2020-06-06,Kings,031,150075,1746,882,4,886,6
2020-06-06,Lake,033,64148,36,28,0,28,0
2020-06-06,Lassen,035,31185,14,4,2,6,0
2020-06-06,Los Angeles,037,10098052,70741,62269,22,62291,2607
2020-06-06,Madera,039,155013,360,149,1,150,3
2020-06-06,Marin,041,260295,656,556,2,558,17
2020-06-06,Mariposa,043,17540,16,16,0,16,1
2020-06-06,Mendocino,045,87422,33,32,0,32,0
2020-06-06,Merced,047,269075,495,315,1,316,7
2020-06-06,Modoc,049,8938,1,0,0,0,0
2020-06-06,Mono,051,14174,39,35,0,35,1
2020-06-06,Monterey,053,433212,945,679,3,682,10
2020-06-06,Napa,055,140530,171,136,0,136,3
2020-06-06,Nevada,057,99092,54,50,1,51,1
2020-06-06,Orange,059,3164182,10550,7576,75,7651,157
2020-06-06,Placer,061,380077,385,270,2,272,9
2020-06-06,Plumas,063,18699,5,4,0,4,0
2020-06-06,Riverside,065,2383286,11673,8935,23,8958,345
2020-06-06,Sacramento,067,1510023,1708,1533,2,1535,59
2020-06-06,San Benito,069,59416,119,92,0,92,2
2020-06-06,San Bernardino,071,2135413,7806,5946,6,5952,214
2020-06-06,San Diego,073,3302833,9585,8347,0,8347,296
2020-06-06,San Francisco,075,870044,2904,2674,0,2674,43
2020-06-06,San Joaquin,077,732212,1590,1076,4,1080,37
2020-06-06,San Luis Obispo,079,281455,409,295,4,299,1
2020-06-06,San Mateo,081,765935,2597,2342,4,2346,72
2020-06-06,Santa Barbara,083,443738,2028,1815,17,1832,13
2020-06-06,Santa Clara,085,1922200,3728,2934,13,2947,144
2020-06-06,Santa Cruz,087,273765,256,226,0,226,2
2020-06-06,Shasta,089,179085,73,40,0,40,4
2020-06-06,Sierra,091,2930,1,1,0,1,0
2020-06-06,Siskiyou,093,43540,18,8,0,8,0
2020-06-06,Solano,095,438530,747,560,4,564,19
2020-06-06,Sonoma,097,501317,739,622,1,623,4
2020-06-06,Stanislaus,099,539301,1210,858,5,863,27
2020-06-06,Sutter,101,95872,73,51,0,51,2
2020-06-06,Tehama,103,63373,15,8,2,10,1
2020-06-06,Trinity,105,12862,8,2,2,4,0
2020-06-06,Tulare,107,460477,3137,2213,10,2223,90
2020-06-06,Tuolumne,109,53932,8,4,0,4,0
2020-06-06,Ventura,111,848112,1958,1303,12,1315,30
2020-06-06,Yolo,113,214977,256,223,0,223,24
2020-06-06,Yuba,115,75493,32,27,0,27,1
2020-06-05,Alameda,001,1643700,4277,3734,7,3741,102
2020-06-05,Alpine,003,1148,1,1,0,1,0
2020-06-05,Amador,005,37829,9,10,0,10,0
2020-06-05,Butte,007,227075,91,61,5,66,1
2020-06-05,Calaveras,009,45235,19,16,0,16,0
2020-06-05,Colusa,011,21464,9,7,0,7,0
2020-06-05,Contra Costa,013,1133247,1920,1575,1,1576,37
2020-06-05,Del Norte,015,27424,45,45,0,45,0
2020-06-05,El Dorado,017,186661,130,101,0,101,0
2020-06-05,Fresno,019,978130,3948,2051,54,2105,38
2020-06-05,Glenn,021,27897,25,16,0,16,0
2020-06-05,Humboldt,023,135768,114,111,0,111,2
2020-06-05,Imperial,025,180216,4849,2778,4,2782,19
2020-06-05,Inyo,027,18085,22,21,0,21,1
2020-06-05,Kern,029,883053,3451,2624,9,2633,46
2020-06-05,Kings,031,150075,1731,865,4,869,6
2020-06-05,Lake,033,64148,35,28,0,28,0
2020-06-05,Lassen,035,31185,13,4,2,6,0
2020-06-05,Los Angeles,037,10098052,69594,60955,22,60977,2553
2020-06-05,Madera,039,155013,338,144,1,145,3
2020-06-05,Marin,041,260295,647,546,2,548,17
2020-06-05,Mariposa,043,17540,16,16,0,16,1
2020-06-05,Mendocino,045,87422,33,32,0,32,0
2020-06-05,Merced,047,269075,493,309,1,310,7
2020-06-05,Modoc,049,8938,1,0,0,0,0
2020-06-05,Mono,051,14174,39,35,0,35,1
2020-06-05,Monterey,053,433212,913,649,3,652,10
2020-06-05,Napa,055,140530,168,123,0,123,3
2020-06-05,Nevada,057,99092,54,50,1,51,1
2020-06-05,Orange,059,3164182,10353,7391,73,7464,153
2020-06-05,Placer,061,380077,375,265,2,267,9
2020-06-05,Plumas,063,18699,5,4,0,4,0
2020-06-05,Riverside,065,2383286,11414,8700,23,8723,345
2020-06-05,Sacramento,067,1510023,1686,1514,2,1516,59
2020-06-05,San Benito,069,59416,117,92,0,92,2
2020-06-05,San Bernardino,071,2135413,7624,5869,5,5874,212
2020-06-05,San Diego,073,3302833,9470,8182,0,8182,294
2020-06-05,San Francisco,075,870044,2886,2675,0,2675,43
2020-06-05,San Joaquin,077,732212,1511,1046,4,1050,36
2020-06-05,San Luis Obispo,079,281455,402,293,4,297,1
2020-06-05,San Mateo,081,765935,2572,2331,4,2335,72
2020-06-05,Santa Barbara,083,443738,1997,1795,17,1812,13
2020-06-05,Santa Clara,085,1922200,3693,2902,13,2915,144
2020-06-05,Santa Cruz,087,273765,253,222,0,222,2
2020-06-05,Shasta,089,179085,72,40,0,40,4
2020-06-05,Sierra,091,2930,1,1,0,1,0
2020-06-05,Siskiyou,093,43540,16,8,0,8,0
2020-06-05,Solano,095,438530,740,558,4,562,19
2020-06-05,Sonoma,097,501317,718,618,1,619,4
2020-06-05,Stanislaus,099,539301,1177,842,5,847,27
2020-06-05,Sutter,101,95872,73,49,0,49,2
2020-06-05,Tehama,103,63373,15,7,2,9,1
2020-06-05,Trinity,105,12862,8,1,2,3,0
2020-06-05,Tulare,107,460477,3088,2180,10,2190,90
2020-06-05,Tuolumne,109,53932,8,4,0,4,0
2020-06-05,Ventura,111,848112,1925,1274,12,1286,30
2020-06-05,Yolo,113,214977,255,216,0,216,24
2020-06-05,Yuba,115,75493,32,27,0,27,1
2020-06-04,Alameda,001,1643700,4178,3643,7,3650,99
2020-06-04,Alpine,003,1148,1,1,0,1,0
2020-06-04,Amador,005,37829,9,10,0,10,0
2020-06-04,Butte,007,227075,87,57,4,61,1
2020-06-04,Calaveras,009,45235,19,15,0,15,0
2020-06-04,Colusa,011,21464,9,7,0,7,0
2020-06-04,Contra Costa,013,1133247,1862,1551,1,1552,37
2020-06-04,Del Norte,015,27424,45,45,0,45,0
2020-06-04,El Dorado,017,186661,128,101,0,101,0
2020-06-04,Fresno,019,978130,3842,2007,53,2060,35
2020-06-04,Glenn,021,27897,22,16,0,16,0
2020-06-04,Humboldt,023,135768,114,109,0,109,2
2020-06-04,Imperial,025,180216,4666,2631,4,2635,19
2020-06-04,Inyo,027,18085,22,20,0,20,1
2020-06-04,Kern,029,883053,3335,2530,9,2539,46
2020-06-04,Kings,031,150075,1661,842,4,846,6
2020-06-04,Lake,033,64148,34,27,0,27,0
2020-06-04,Lassen,035,31185,11,4,2,6,0
2020-06-04,Los Angeles,037,10098052,68126,59596,22,59618,2515
2020-06-04,Madera,039,155013,330,127,1,128,3
2020-06-04,Marin,041,260295,625,533,2,535,14
2020-06-04,Mariposa,043,17540,16,16,0,16,1
2020-06-04,Mendocino,045,87422,33,29,0,29,0
2020-06-04,Merced,047,269075,473,304,1,305,7
2020-06-04,Modoc,049,8938,1,0,0,0,0
2020-06-04,Mono,051,14174,39,35,0,35,1
2020-06-04,Monterey,053,433212,878,621,2,623,10
2020-06-04,Napa,055,140530,164,117,0,117,3
2020-06-04,Nevada,057,99092,53,49,1,50,1
2020-06-04,Orange,059,3164182,10099,7192,72,7264,148
2020-06-04,Placer,061,380077,359,256,2,258,9
2020-06-04,Plumas,063,18699,4,4,0,4,0
2020-06-04,Riverside,065,2383286,11136,8473,23,8496,341
2020-06-04,Sacramento,067,1510023,1659,1492,2,1494,58
2020-06-04,San Benito,069,59416,115,88,0,88,2
2020-06-04,San Bernardino,071,2135413,7355,5726,5,5731,207
2020-06-04,San Diego,073,3302833,9307,7942,0,7942,288
2020-06-04,San Francisco,075,870044,2853,2636,0,2636,43
2020-06-04,San Joaquin,077,732212,1449,1016,4,1020,36
2020-06-04,San Luis Obispo,079,281455,391,288,4,292,1
2020-06-04,San Mateo,081,765935,2545,2284,4,2288,72
2020-06-04,Santa Barbara,083,443738,1966,1750,16,1766,13
2020-06-04,Santa Clara,085,1922200,3659,2871,13,2884,144
2020-06-04,Santa Cruz,087,273765,247,218,0,218,2
2020-06-04,Shasta,089,179085,66,40,0,40,4
2020-06-04,Sierra,091,2930,1,1,0,1,0
2020-06-04,Siskiyou,093,43540,15,8,0,8,0
2020-06-04,Solano,095,438530,723,551,4,555,19
2020-06-04,Sonoma,097,501317,699,591,1,592,4
2020-06-04,Stanislaus,099,539301,1101,806,5,811,28
2020-06-04,Sutter,101,95872,68,46,0,46,2
2020-06-04,Tehama,103,63373,14,6,1,7,1
2020-06-04,Trinity,105,12862,8,1,2,3,0
2020-06-04,Tulare,107,460477,2971,2086,10,2096,90
2020-06-04,Tuolumne,109,53932,7,4,0,4,0
2020-06-04,Ventura,111,848112,1881,1236,11,1247,30
2020-06-04,Yolo,113,214977,250,216,0,216,24
2020-06-04,Yuba,115,75493,31,27,0,27,1
2020-06-03,Alameda,001,1643700,4119,3589,6,3595,99
2020-06-03,Alpine,003,1148,1,1,0,1,0
2020-06-03,Amador,005,37829,9,10,0,10,0
2020-06-03,Butte,007,227075,85,53,4,57,1
2020-06-03,Calaveras,009,45235,18,15,0,15,0
2020-06-03,Colusa,011,21464,9,7,0,7,0
2020-06-03,Contra Costa,013,1133247,1814,1511,1,1512,37
2020-06-03,Del Norte,015,27424,45,39,0,39,0
2020-06-03,El Dorado,017,186661,125,90,0,90,0
2020-06-03,Fresno,019,978130,3743,1943,53,1996,35
2020-06-03,Glenn,021,27897,22,16,0,16,0
2020-06-03,Humboldt,023,135768,114,103,0,103,2
2020-06-03,Imperial,025,180216,4493,2540,4,2544,19
2020-06-03,Inyo,027,18085,22,20,0,20,1
2020-06-03,Kern,029,883053,3239,2452,8,2460,44
2020-06-03,Kings,031,150075,1596,744,4,748,6
2020-06-03,Lake,033,64148,32,26,0,26,0
2020-06-03,Lassen,035,31185,11,4,2,6,0
2020-06-03,Los Angeles,037,10098052,66519,58166,22,58188,2472
2020-06-03,Madera,039,155013,322,117,1,118,3
2020-06-03,Marin,041,260295,607,527,2,529,14
2020-06-03,Mariposa,043,17540,16,16,0,16,1
2020-06-03,Mendocino,045,87422,32,29,0,29,0
2020-06-03,Merced,047,269075,459,299,1,300,7
2020-06-03,Modoc,049,8938,1,0,0,0,0
2020-06-03,Mono,051,14174,39,35,0,35,1
2020-06-03,Monterey,053,433212,850,592,2,594,10
2020-06-03,Napa,055,140530,163,116,0,116,3
2020-06-03,Nevada,057,99092,52,43,1,44,1
2020-06-03,Orange,059,3164182,9873,6939,71,7010,145
2020-06-03,Placer,061,380077,339,243,2,245,9
2020-06-03,Plumas,063,18699,4,4,0,4,0
2020-06-03,Riverside,065,2383286,10861,8208,23,8231,335
2020-06-03,Sacramento,067,1510023,1629,1457,2,1459,58
2020-06-03,San Benito,069,59416,109,88,0,88,2
2020-06-03,San Bernardino,071,2135413,7132,5565,5,5570,203
2020-06-03,San Diego,073,3302833,9159,7800,0,7800,283
2020-06-03,San Francisco,075,870044,2822,2608,0,2608,43
2020-06-03,San Joaquin,077,732212,1385,1004,4,1008,35
2020-06-03,San Luis Obispo,079,281455,386,279,4,283,1
2020-06-03,San Mateo,081,765935,2517,2243,4,2247,71
2020-06-03,Santa Barbara,083,443738,1932,1722,15,1737,12
2020-06-03,Santa Clara,085,1922200,3617,2836,13,2849,144
2020-06-03,Santa Cruz,087,273765,241,217,0,217,2
2020-06-03,Shasta,089,179085,63,40,0,40,4
2020-06-03,Sierra,091,2930,1,1,0,1,0
2020-06-03,Siskiyou,093,43540,14,8,0,8,0
2020-06-03,Solano,095,438530,698,543,2,545,18
2020-06-03,Sonoma,097,501317,687,578,1,579,4
2020-06-03,Stanislaus,099,539301,1061,780,5,785,27
2020-06-03,Sutter,101,95872,60,45,0,45,2
2020-06-03,Tehama,103,63373,14,6,1,7,1
2020-06-03,Trinity,105,12862,8,1,2,3,0
2020-06-03,Tulare,107,460477,2902,2041,10,2051,88
2020-06-03,Tuolumne,109,53932,5,4,0,4,0
2020-06-03,Ventura,111,848112,1814,1202,11,1213,30
2020-06-03,Yolo,113,214977,246,213,0,213,24
2020-06-03,Yuba,115,75493,31,27,0,27,1
2020-06-02,Alameda,001,1643700,4043,3517,6,3523,99
2020-06-02,Alpine,003,1148,1,1,0,1,0
2020-06-02,Amador,005,37829,9,10,0,10,0
2020-06-02,Butte,007,227075,81,51,3,54,1
2020-06-02,Calaveras,009,45235,18,15,0,15,0
2020-06-02,Colusa,011,21464,9,7,0,7,0
2020-06-02,Contra Costa,013,1133247,1782,1505,1,1506,37
2020-06-02,Del Norte,015,27424,45,39,0,39,0
2020-06-02,El Dorado,017,186661,124,88,0,88,0
2020-06-02,Fresno,019,978130,3630,1917,53,1970,34
2020-06-02,Glenn,021,27897,21,16,0,16,0
2020-06-02,Humboldt,023,135768,114,101,0,101,2
2020-06-02,Imperial,025,180216,4300,2459,4,2463,19
2020-06-02,Inyo,027,18085,20,20,0,20,1
2020-06-02,Kern,029,883053,3140,2406,6,2412,41
2020-06-02,Kings,031,150075,1568,720,4,724,5
2020-06-02,Lake,033,64148,32,25,0,25,0
2020-06-02,Lassen,035,31185,10,4,2,6,0
2020-06-02,Los Angeles,037,10098052,65117,57144,22,57166,2430
2020-06-02,Madera,039,155013,301,110,1,111,2
2020-06-02,Marin,041,260295,580,509,2,511,14
2020-06-02,Mariposa,043,17540,16,16,0,16,1
2020-06-02,Mendocino,045,87422,32,29,0,29,0
2020-06-02,Merced,047,269075,443,297,1,298,6
2020-06-02,Modoc,049,8938,1,0,0,0,0
2020-06-02,Mono,051,14174,39,35,0,35,1
2020-06-02,Monterey,053,433212,820,582,2,584,10
2020-06-02,Napa,055,140530,154,116,0,116,3
2020-06-02,Nevada,057,99092,51,41,1,42,1
2020-06-02,Orange,059,3164182,9672,6790,70,6860,142
2020-06-02,Placer,061,380077,325,226,2,228,9
2020-06-02,Plumas,063,18699,4,4,0,4,0
2020-06-02,Riverside,065,2383286,10565,8091,21,8112,330
2020-06-02,Sacramento,067,1510023,1600,1428,2,1430,58
2020-06-02,San Benito,069,59416,108,86,0,86,2
2020-06-02,San Bernardino,071,2135413,6924,5438,5,5443,202
2020-06-02,San Diego,073,3302833,9013,7676,0,7676,276
2020-06-02,San Francisco,075,870044,2787,2554,0,2554,43
2020-06-02,San Joaquin,077,732212,1319,985,4,989,35
2020-06-02,San Luis Obispo,079,281455,380,275,4,279,1
2020-06-02,San Mateo,081,765935,2482,2203,4,2207,71
2020-06-02,Santa Barbara,083,443738,1892,1703,15,1718,12
2020-06-02,Santa Clara,085,1922200,3567,2819,13,2832,144
2020-06-02,Santa Cruz,087,273765,236,215,0,215,2
2020-06-02,Shasta,089,179085,62,38,0,38,4
2020-06-02,Sierra,091,2930,1,1,0,1,0
2020-06-02,Siskiyou,093,43540,13,8,0,8,0
2020-06-02,Solano,095,438530,683,537,1,538,18
2020-06-02,Sonoma,097,501317,676,571,1,572,4
2020-06-02,Stanislaus,099,539301,1002,772,5,777,27
2020-06-02,Sutter,101,95872,57,43,0,43,2
2020-06-02,Tehama,103,63373,14,6,1,7,1
2020-06-02,Trinity,105,12862,8,1,2,3,0
2020-06-02,Tulare,107,460477,2822,2012,10,2022,86
2020-06-02,Tuolumne,109,53932,5,4,0,4,0
2020-06-02,Ventura,111,848112,1761,1178,11,1189,30
2020-06-02,Yolo,113,214977,244,213,0,213,24
2020-06-02,Yuba,115,75493,31,27,0,27,1
2020-06-01,Alameda,001,1643700,3977,3460,6,3466,98
2020-06-01,Alpine,003,1148,1,1,0,1,0
2020-06-01,Amador,005,37829,9,10,0,10,0
2020-06-01,Butte,007,227075,80,50,2,52,1
2020-06-01,Calaveras,009,45235,18,15,0,15,0
2020-06-01,Colusa,011,21464,9,7,0,7,0
2020-06-01,Contra Costa,013,1133247,1746,1486,1,1487,37
2020-06-01,Del Norte,015,27424,45,38,0,38,0
2020-06-01,El Dorado,017,186661,122,88,0,88,0
2020-06-01,Fresno,019,978130,3535,1854,51,1905,33
2020-06-01,Glenn,021,27897,21,16,0,16,0
2020-06-01,Humboldt,023,135768,114,98,0,98,2
2020-06-01,Imperial,025,180216,4078,2366,4,2370,14
2020-06-01,Inyo,027,18085,20,20,0,20,1
2020-06-01,Kern,029,883053,3057,2366,6,2372,38
2020-06-01,Kings,031,150075,1300,703,4,707,4
2020-06-01,Lake,033,64148,32,22,0,22,0
2020-06-01,Lassen,035,31185,10,4,2,6,0
2020-06-01,Los Angeles,037,10098052,63654,55899,22,55921,2367
2020-06-01,Madera,039,155013,289,103,1,104,2
2020-06-01,Marin,041,260295,539,495,2,497,14
2020-06-01,Mariposa,043,17540,16,16,0,16,1
2020-06-01,Mendocino,045,87422,32,28,0,28,0
2020-06-01,Merced,047,269075,424,289,1,290,6
2020-06-01,Modoc,049,8938,1,0,0,0,0
2020-06-01,Mono,051,14174,39,35,0,35,1
2020-06-01,Monterey,053,433212,795,554,2,556,10
2020-06-01,Napa,055,140530,151,114,0,114,3
2020-06-01,Nevada,057,99092,51,41,1,42,1
2020-06-01,Orange,059,3164182,9475,6640,69,6709,135
2020-06-01,Placer,061,380077,313,218,2,220,9
2020-06-01,Plumas,063,18699,4,4,0,4,0
2020-06-01,Riverside,065,2383286,10113,7921,20,7941,322
2020-06-01,Sacramento,067,1510023,1561,1415,2,1417,58
2020-06-01,San Benito,069,59416,105,86,0,86,2
2020-06-01,San Bernardino,071,2135413,6718,5310,5,5315,202
2020-06-01,San Diego,073,3302833,8833,7556,0,7556,269
2020-06-01,San Francisco,075,870044,2750,2546,0,2546,43
2020-06-01,San Joaquin,077,732212,1254,957,4,961,35
2020-06-01,San Luis Obispo,079,281455,376,275,4,279,1
2020-06-01,San Mateo,081,765935,2452,2190,4,2194,71
2020-06-01,Santa Barbara,083,443738,1858,1671,14,1685,10
2020-06-01,Santa Clara,085,1922200,3529,2797,12,2809,142
2020-06-01,Santa Cruz,087,273765,232,215,0,215,2
2020-06-01,Shasta,089,179085,62,38,0,38,4
2020-06-01,Sierra,091,2930,1,1,0,1,0
2020-06-01,Siskiyou,093,43540,13,7,0,7,0
2020-06-01,Solano,095,438530,659,529,1,530,17
2020-06-01,Sonoma,097,501317,660,565,1,566,4
2020-06-01,Stanislaus,099,539301,965,758,5,763,27
2020-06-01,Sutter,101,95872,52,43,0,43,2
2020-06-01,Tehama,103,63373,11,5,1,6,1
2020-06-01,Trinity,105,12862,7,1,2,3,0
2020-06-01,Tulare,107,460477,2707,1976,10,1986,84
2020-06-01,Tuolumne,109,53932,4,4,0,4,0
2020-06-01,Ventura,111,848112,1708,1163,11,1174,29
2020-06-01,Yolo,113,214977,241,212,0,212,24
2020-06-01,Yuba,115,75493,30,26,0,26,1
2020-05-31,Alameda,001,1643700,3872,3362,6,3368,98
2020-05-31,Alpine,003,1148,1,1,0,1,0
2020-05-31,Amador,005,37829,9,10,0,10,0
2020-05-31,Butte,007,227075,78,51,2,53,0
2020-05-31,Calaveras,009,45235,15,15,0,15,0
2020-05-31,Colusa,011,21464,9,5,0,5,0
2020-05-31,Contra Costa,013,1133247,1712,1458,1,1459,37
2020-05-31,Del Norte,015,27424,45,37,0,37,0
2020-05-31,El Dorado,017,186661,118,88,0,88,0
2020-05-31,Fresno,019,978130,3370,1780,45,1825,31
2020-05-31,Glenn,021,27897,20,16,0,16,0
2020-05-31,Humboldt,023,135768,112,98,0,98,2
2020-05-31,Imperial,025,180216,3811,2197,4,2201,14
2020-05-31,Inyo,027,18085,20,20,0,20,1
2020-05-31,Kern,029,883053,2922,2300,6,2306,38
2020-05-31,Kings,031,150075,1263,703,4,707,3
2020-05-31,Lake,033,64148,32,19,0,19,0
2020-05-31,Lassen,035,31185,10,4,2,6,0
2020-05-31,Los Angeles,037,10098052,62364,54925,22,54947,2344
2020-05-31,Madera,039,155013,271,101,1,102,2
2020-05-31,Marin,041,260295,529,486,2,488,14
2020-05-31,Mariposa,043,17540,16,16,0,16,1
2020-05-31,Mendocino,045,87422,32,24,0,24,0
2020-05-31,Merced,047,269075,397,288,0,288,6
2020-05-31,Modoc,049,8938,0,0,0,0,0
2020-05-31,Mono,051,14174,39,34,0,34,1
2020-05-31,Monterey,053,433212,721,545,2,547,10
2020-05-31,Napa,055,140530,149,114,0,114,3
2020-05-31,Nevada,057,99092,50,41,1,42,1
2020-05-31,Orange,059,3164182,9265,6532,68,6600,135
2020-05-31,Placer,061,380077,291,215,2,217,9
2020-05-31,Plumas,063,18699,4,4,0,4,0
2020-05-31,Riverside,065,2383286,9857,7704,20,7724,321
2020-05-31,Sacramento,067,1510023,1530,1398,2,1400,57
2020-05-31,San Benito,069,59416,99,85,0,85,2
2020-05-31,San Bernardino,071,2135413,6450,5185,5,5190,198
2020-05-31,San Diego,073,3302833,8639,7483,0,7483,269
2020-05-31,San Francisco,075,870044,2714,2501,0,2501,43
2020-05-31,San Joaquin,077,732212,1189,888,4,892,34
2020-05-31,San Luis Obispo,079,281455,366,271,4,275,1
2020-05-31,San Mateo,081,765935,2406,2169,4,2173,71
2020-05-31,Santa Barbara,083,443738,1807,1662,13,1675,9
2020-05-31,Santa Clara,085,1922200,3485,2785,12,2797,142
2020-05-31,Santa Cruz,087,273765,229,210,0,210,2
2020-05-31,Shasta,089,179085,60,38,0,38,4
2020-05-31,Sierra,091,2930,1,1,0,1,0
2020-05-31,Siskiyou,093,43540,12,7,0,7,0
2020-05-31,Solano,095,438530,633,512,1,513,6
2020-05-31,Sonoma,097,501317,640,555,1,556,4
2020-05-31,Stanislaus,099,539301,911,738,5,743,27
2020-05-31,Sutter,101,95872,50,42,0,42,2
2020-05-31,Tehama,103,63373,10,4,1,5,1
2020-05-31,Trinity,105,12862,7,1,2,3,0
2020-05-31,Tulare,107,460477,2634,1884,10,1894,82
2020-05-31,Tuolumne,109,53932,4,4,0,4,0
2020-05-31,Ventura,111,848112,1647,1151,11,1162,30
2020-05-31,Yolo,113,214977,235,211,0,211,24
2020-05-31,Yuba,115,75493,30,26,0,26,1
2020-05-30,Alameda,001,1643700,3846,3304,6,3310,96
2020-05-30,Alpine,003,1148,1,1,0,1,0
2020-05-30,Amador,005,37829,9,10,0,10,0
2020-05-30,Butte,007,227075,77,44,2,46,0
2020-05-30,Calaveras,009,45235,14,15,0,15,0
2020-05-30,Colusa,011,21464,8,5,0,5,0
2020-05-30,Contra Costa,013,1133247,1696,1429,1,1430,37
2020-05-30,Del Norte,015,27424,45,37,0,37,0
2020-05-30,El Dorado,017,186661,117,86,0,86,0
2020-05-30,Fresno,019,978130,3309,1744,44,1788,31
2020-05-30,Glenn,021,27897,19,16,0,16,0
2020-05-30,Humboldt,023,135768,111,98,0,98,2
2020-05-30,Imperial,025,180216,3721,2091,4,2095,14
2020-05-30,Inyo,027,18085,20,20,0,20,1
2020-05-30,Kern,029,883053,2853,2217,6,2223,38
2020-05-30,Kings,031,150075,1249,703,4,707,3
2020-05-30,Lake,033,64148,31,18,0,18,0
2020-05-30,Lassen,035,31185,10,4,2,6,0
2020-05-30,Los Angeles,037,10098052,61829,53627,22,53649,2319
2020-05-30,Madera,039,155013,266,101,1,102,2
2020-05-30,Marin,041,260295,529,462,2,464,14
2020-05-30,Mariposa,043,17540,16,16,0,16,1
2020-05-30,Mendocino,045,87422,32,24,0,24,0
2020-05-30,Merced,047,269075,396,285,0,285,6
2020-05-30,Modoc,049,8938,0,0,0,0,0
2020-05-30,Mono,051,14174,39,34,0,34,1
2020-05-30,Monterey,053,433212,705,520,2,522,10
2020-05-30,Napa,055,140530,147,113,0,113,3
2020-05-30,Nevada,057,99092,50,41,1,42,1
2020-05-30,Orange,059,3164182,9108,6354,68,6422,134
2020-05-30,Placer,061,380077,283,199,1,200,9
2020-05-30,Plumas,063,18699,4,4,0,4,0
2020-05-30,Riverside,065,2383286,9713,7492,20,7512,316
2020-05-30,Sacramento,067,1510023,1519,1384,2,1386,57
2020-05-30,San Benito,069,59416,98,85,0,85,2
2020-05-30,San Bernardino,071,2135413,6341,5122,5,5127,198
2020-05-30,San Diego,073,3302833,8546,7387,0,7387,269
2020-05-30,San Francisco,075,870044,2689,2496,0,2496,41
2020-05-30,San Joaquin,077,732212,1151,888,4,892,34
2020-05-30,San Luis Obispo,079,281455,361,270,4,274,1
2020-05-30,San Mateo,081,765935,2382,2129,4,2133,71
2020-05-30,Santa Barbara,083,443738,1788,1660,13,1673,9
2020-05-30,Santa Clara,085,1922200,3469,2741,12,2753,141
2020-05-30,Santa Cruz,087,273765,229,206,0,206,2
2020-05-30,Shasta,089,179085,60,36,0,36,4
2020-05-30,Sierra,091,2930,1,1,0,1,0
2020-05-30,Siskiyou,093,43540,11,7,0,7,0
2020-05-30,Solano,095,438530,626,512,1,513,6
2020-05-30,Sonoma,097,501317,630,551,1,552,4
2020-05-30,Stanislaus,099,539301,894,712,5,717,27
2020-05-30,Sutter,101,95872,49,40,0,40,2
2020-05-30,Tehama,103,63373,10,4,1,5,1
2020-05-30,Trinity,105,12862,7,1,2,3,0
2020-05-30,Tulare,107,460477,2597,1879,10,1889,81
2020-05-30,Tuolumne,109,53932,4,4,0,4,0
2020-05-30,Ventura,111,848112,1630,1116,11,1127,30
2020-05-30,Yolo,113,214977,231,210,0,210,24
2020-05-30,Yuba,115,75493,30,25,0,25,1
2020-05-29,Alameda,001,1643700,3811,3209,6,3215,96
2020-05-29,Alpine,003,1148,1,1,0,1,0
2020-05-29,Amador,005,37829,9,10,0,10,0
2020-05-29,Butte,007,227075,72,41,2,43,0
2020-05-29,Calaveras,009,45235,14,15,0,15,0
2020-05-29,Colusa,011,21464,8,5,0,5,0
2020-05-29,Contra Costa,013,1133247,1680,1411,1,1412,37
2020-05-29,Del Norte,015,27424,45,37,0,37,0
2020-05-29,El Dorado,017,186661,116,85,0,85,0
2020-05-29,Fresno,019,978130,3259,1687,44,1731,31
2020-05-29,Glenn,021,27897,19,14,0,14,0
2020-05-29,Humboldt,023,135768,110,98,0,98,2
2020-05-29,Imperial,025,180216,3603,1607,4,1611,14
2020-05-29,Inyo,027,18085,20,20,0,20,1
2020-05-29,Kern,029,883053,2795,2128,6,2134,36
2020-05-29,Kings,031,150075,1238,693,4,697,3
2020-05-29,Lake,033,64148,30,17,0,17,0
2020-05-29,Lassen,035,31185,10,0,2,2,0
2020-05-29,Los Angeles,037,10098052,60874,51578,22,51600,2273
2020-05-29,Madera,039,155013,251,98,1,99,2
2020-05-29,Marin,041,260295,521,448,2,450,14
2020-05-29,Mariposa,043,17540,16,16,0,16,1
2020-05-29,Mendocino,045,87422,30,25,0,25,0
2020-05-29,Merced,047,269075,391,285,0,285,7
2020-05-29,Modoc,049,8938,0,0,0,0,0
2020-05-29,Mono,051,14174,38,34,0,34,1
2020-05-29,Monterey,053,433212,675,479,2,481,10
2020-05-29,Napa,055,140530,144,113,0,113,3
2020-05-29,Nevada,057,99092,50,41,1,42,1
2020-05-29,Orange,059,3164182,8923,6176,66,6242,133
2020-05-29,Placer,061,380077,261,199,1,200,9
2020-05-29,Plumas,063,18699,4,4,0,4,0
2020-05-29,Riverside,065,2383286,9527,7376,20,7396,313
2020-05-29,Sacramento,067,1510023,1496,1360,2,1362,57
2020-05-29,San Benito,069,59416,98,84,0,84,2
2020-05-29,San Bernardino,071,2135413,6233,4983,5,4988,196
2020-05-29,San Diego,073,3302833,8423,7242,0,7242,266
2020-05-29,San Francisco,075,870044,2665,2453,0,2453,41
2020-05-29,San Joaquin,077,732212,1114,855,4,859,34
2020-05-29,San Luis Obispo,079,281455,357,270,4,274,1
2020-05-29,San Mateo,081,765935,2366,2103,4,2107,71
2020-05-29,Santa Barbara,083,443738,1761,1656,13,1669,9
2020-05-29,Santa Clara,085,1922200,3441,2707,12,2719,141
2020-05-29,Santa Cruz,087,273765,226,203,0,203,2
2020-05-29,Shasta,089,179085,60,36,0,36,4
2020-05-29,Sierra,091,2930,1,1,0,1,0
2020-05-29,Siskiyou,093,43540,11,7,0,7,0
2020-05-29,Solano,095,438530,618,498,1,499,6
2020-05-29,Sonoma,097,501317,619,537,1,538,4
2020-05-29,Stanislaus,099,539301,864,698,5,703,27
2020-05-29,Sutter,101,95872,47,40,0,40,2
2020-05-29,Tehama,103,63373,9,4,1,5,1
2020-05-29,Trinity,105,12862,7,1,2,3,0
2020-05-29,Tulare,107,460477,2559,1852,10,1862,80
2020-05-29,Tuolumne,109,53932,4,4,0,4,0
2020-05-29,Ventura,111,848112,1606,1093,11,1104,29
2020-05-29,Yolo,113,214977,227,211,0,211,24
2020-05-29,Yuba,115,75493,29,25,0,25,1
2020-05-28,Alameda,001,1643700,3711,3083,6,3089,94
2020-05-28,Alpine,003,1148,1,1,0,1,0
2020-05-28,Amador,005,37829,9,10,0,10,0
2020-05-28,Butte,007,227075,71,40,2,42,0
2020-05-28,Calaveras,009,45235,13,15,0,15,0
2020-05-28,Colusa,011,21464,8,5,0,5,0
2020-05-28,Contra Costa,013,1133247,1641,1392,1,1393,37
2020-05-28,Del Norte,015,27424,45,37,0,37,0
2020-05-28,El Dorado,017,186661,113,82,0,82,0
2020-05-28,Fresno,019,978130,3178,1653,43,1696,31
2020-05-28,Glenn,021,27897,18,14,0,14,0
2020-05-28,Humboldt,023,135768,109,97,0,97,2
2020-05-28,Imperial,025,180216,3408,1430,4,1434,14
2020-05-28,Inyo,027,18085,20,20,0,20,1
2020-05-28,Kern,029,883053,2717,2069,6,2075,36
2020-05-28,Kings,031,150075,901,626,4,630,3
2020-05-28,Lake,033,64148,29,17,0,17,0
2020-05-28,Lassen,035,31185,10,0,2,2,0
2020-05-28,Los Angeles,037,10098052,59295,49861,22,49883,2222
2020-05-28,Madera,039,155013,233,93,1,94,2
2020-05-28,Marin,041,260295,496,443,2,445,14
2020-05-28,Mariposa,043,17540,16,16,0,16,1
2020-05-28,Mendocino,045,87422,28,24,0,24,0
2020-05-28,Merced,047,269075,382,283,0,283,7
2020-05-28,Modoc,049,8938,0,0,0,0,0
2020-05-28,Mono,051,14174,38,34,0,34,1
2020-05-28,Monterey,053,433212,643,471,2,473,10
2020-05-28,Napa,055,140530,141,113,0,113,3
2020-05-28,Nevada,057,99092,45,41,1,42,1
2020-05-28,Orange,059,3164182,8727,6045,66,6111,130
2020-05-28,Placer,061,380077,254,196,1,197,9
2020-05-28,Plumas,063,18699,4,4,0,4,0
2020-05-28,Riverside,065,2383286,9124,7240,19,7259,304
2020-05-28,Sacramento,067,1510023,1476,1339,2,1341,57
2020-05-28,San Benito,069,59416,97,82,0,82,2
2020-05-28,San Bernardino,071,2135413,6068,4831,5,4836,191
2020-05-28,San Diego,073,3302833,8266,7102,0,7102,260
2020-05-28,San Francisco,075,870044,2631,2417,0,2417,40
2020-05-28,San Joaquin,077,732212,1079,840,4,844,34
2020-05-28,San Luis Obispo,079,281455,354,267,4,271,1
2020-05-28,San Mateo,081,765935,2339,2070,4,2074,71
2020-05-28,Santa Barbara,083,443738,1732,1642,12,1654,9
2020-05-28,Santa Clara,085,1922200,3401,2698,12,2710,140
2020-05-28,Santa Cruz,087,273765,225,201,0,201,2
2020-05-28,Shasta,089,179085,58,36,0,36,4
2020-05-28,Sierra,091,2930,1,1,0,1,0
2020-05-28,Siskiyou,093,43540,9,6,0,6,0
2020-05-28,Solano,095,438530,601,489,1,490,6
2020-05-28,Sonoma,097,501317,597,529,1,530,4
2020-05-28,Stanislaus,099,539301,823,684,5,689,27
2020-05-28,Sutter,101,95872,47,40,0,40,2
2020-05-28,Tehama,103,63373,9,4,1,5,1
2020-05-28,Trinity,105,12862,6,1,2,3,0
2020-05-28,Tulare,107,460477,2523,1832,10,1842,79
2020-05-28,Tuolumne,109,53932,4,4,0,4,0
2020-05-28,Ventura,111,848112,1573,1083,11,1094,29
2020-05-28,Yolo,113,214977,224,206,0,206,22
2020-05-28,Yuba,115,75493,28,24,0,24,1
2020-05-27,Alameda,001,1643700,3627,3037,6,3043,94
2020-05-27,Alpine,003,1148,1,1,0,1,0
2020-05-27,Amador,005,37829,9,10,0,10,0
2020-05-27,Butte,007,227075,68,40,1,41,0
2020-05-27,Calaveras,009,45235,12,15,0,15,0
2020-05-27,Colusa,011,21464,8,5,0,5,0
2020-05-27,Contra Costa,013,1133247,1601,1373,1,1374,37
2020-05-27,Del Norte,015,27424,45,34,0,34,0
2020-05-27,El Dorado,017,186661,112,82,0,82,0
2020-05-27,Fresno,019,978130,3090,1620,43,1663,27
2020-05-27,Glenn,021,27897,18,14,0,14,0
2020-05-27,Humboldt,023,135768,109,86,0,86,2
2020-05-27,Imperial,025,180216,3227,1369,4,1373,14
2020-05-27,Inyo,027,18085,20,20,0,20,1
2020-05-27,Kern,029,883053,2652,1999,6,2005,37
2020-05-27,Kings,031,150075,874,586,4,590,3
2020-05-27,Lake,033,64148,29,13,0,13,0
2020-05-27,Lassen,035,31185,10,0,2,2,0
2020-05-27,Los Angeles,037,10098052,57920,48711,22,48733,2177
2020-05-27,Madera,039,155013,224,91,1,92,2
2020-05-27,Marin,041,260295,467,439,2,441,14
2020-05-27,Mariposa,043,17540,16,16,0,16,1
2020-05-27,Mendocino,045,87422,27,21,0,21,0
2020-05-27,Merced,047,269075,378,278,0,278,7
2020-05-27,Modoc,049,8938,0,0,0,0,0
2020-05-27,Mono,051,14174,38,34,0,34,1
2020-05-27,Monterey,053,433212,603,443,2,445,8
2020-05-27,Napa,055,140530,136,112,0,112,3
2020-05-27,Nevada,057,99092,44,41,1,42,1
2020-05-27,Orange,059,3164182,8572,5849,66,5915,121
2020-05-27,Placer,061,380077,235,196,0,196,9
2020-05-27,Plumas,063,18699,4,4,0,4,0
2020-05-27,Riverside,065,2383286,8745,7156,19,7175,299
2020-05-27,Sacramento,067,1510023,1448,1318,2,1320,50
2020-05-27,San Benito,069,59416,94,74,0,74,2
2020-05-27,San Bernardino,071,2135413,5884,4708,5,4713,183
2020-05-27,San Diego,073,3302833,8115,6985,0,6985,255
2020-05-27,San Francisco,075,870044,2602,2394,0,2394,40
2020-05-27,San Joaquin,077,732212,1038,825,4,829,34
2020-05-27,San Luis Obispo,079,281455,349,266,4,270,1
2020-05-27,San Mateo,081,765935,2299,2045,4,2049,71
2020-05-27,Santa Barbara,083,443738,1717,1629,12,1641,9
2020-05-27,Santa Clara,085,1922200,3368,2680,12,2692,140
2020-05-27,Santa Cruz,087,273765,221,202,0,202,2
2020-05-27,Shasta,089,179085,55,36,0,36,4
2020-05-27,Sierra,091,2930,1,1,0,1,0
2020-05-27,Siskiyou,093,43540,9,6,0,6,0
2020-05-27,Solano,095,438530,581,477,1,478,5
2020-05-27,Sonoma,097,501317,583,521,1,522,4
2020-05-27,Stanislaus,099,539301,798,675,5,680,27
2020-05-27,Sutter,101,95872,46,40,0,40,2
2020-05-27,Tehama,103,63373,9,3,1,4,1
2020-05-27,Trinity,105,12862,6,1,2,3,0
2020-05-27,Tulare,107,460477,2471,1817,10,1827,77
2020-05-27,Tuolumne,109,53932,4,4,0,4,0
2020-05-27,Ventura,111,848112,1548,1065,11,1076,28
2020-05-27,Yolo,113,214977,223,204,0,204,22
2020-05-27,Yuba,115,75493,28,24,0,24,1
2020-05-26,Alameda,001,1643700,3532,2956,6,2962,92
2020-05-26,Alpine,003,1148,1,1,0,1,0
2020-05-26,Amador,005,37829,9,10,0,10,0
2020-05-26,Butte,007,227075,66,37,1,38,0
2020-05-26,Calaveras,009,45235,12,13,0,13,0
2020-05-26,Colusa,011,21464,8,4,0,4,0
2020-05-26,Contra Costa,013,1133247,1566,1352,1,1353,37
2020-05-26,Del Norte,015,27424,44,30,0,30,0
2020-05-26,El Dorado,017,186661,108,79,0,79,0
2020-05-26,Fresno,019,978130,3003,1496,43,1539,22
2020-05-26,Glenn,021,27897,16,12,0,12,0
2020-05-26,Humboldt,023,135768,107,81,0,81,2
2020-05-26,Imperial,025,180216,3011,1369,4,1373,14
2020-05-26,Inyo,027,18085,20,20,0,20,1
2020-05-26,Kern,029,883053,2574,1890,6,1896,31
2020-05-26,Kings,031,150075,806,449,3,452,2
2020-05-26,Lake,033,64148,27,12,0,12,0
2020-05-26,Lassen,035,31185,9,0,2,2,0
2020-05-26,Los Angeles,037,10098052,56453,47760,22,47782,2121
2020-05-26,Madera,039,155013,209,83,1,84,2
2020-05-26,Marin,041,260295,455,424,2,426,14
2020-05-26,Mariposa,043,17540,16,16,0,16,1
2020-05-26,Mendocino,045,87422,25,20,0,20,0
2020-05-26,Merced,047,269075,363,266,0,266,7
2020-05-26,Modoc,049,8938,0,1,0,1,0
2020-05-26,Mono,051,14174,37,34,0,34,1
2020-05-26,Monterey,053,433212,575,424,1,425,8
2020-05-26,Napa,055,140530,131,109,0,109,3
2020-05-26,Nevada,057,99092,43,41,1,42,1
2020-05-26,Orange,059,3164182,8302,5651,65,5716,115
2020-05-26,Placer,061,380077,230,188,0,188,9
2020-05-26,Plumas,063,18699,4,4,0,4,0
2020-05-26,Riverside,065,2383286,8298,6917,19,6936,284
2020-05-26,Sacramento,067,1510023,1422,1298,2,1300,50
2020-05-26,San Benito,069,59416,89,69,0,69,2
2020-05-26,San Bernardino,071,2135413,5716,4430,5,4435,175
2020-05-26,San Diego,073,3302833,7972,6884,0,6884,249
2020-05-26,San Francisco,075,870044,2569,2363,0,2363,40
2020-05-26,San Joaquin,077,732212,991,760,4,764,33
2020-05-26,San Luis Obispo,079,281455,347,260,4,264,1
2020-05-26,San Mateo,081,765935,2261,1967,3,1970,71
2020-05-26,Santa Barbara,083,443738,1700,1590,11,1601,9
2020-05-26,Santa Clara,085,1922200,3335,2659,12,2671,139
2020-05-26,Santa Cruz,087,273765,219,197,0,197,2
2020-05-26,Shasta,089,179085,55,36,0,36,4
2020-05-26,Sierra,091,2930,1,1,0,1,0
2020-05-26,Siskiyou,093,43540,8,6,0,6,0
2020-05-26,Solano,095,438530,563,470,1,471,5
2020-05-26,Sonoma,097,501317,575,509,0,509,4
2020-05-26,Stanislaus,099,539301,777,663,5,668,27
2020-05-26,Sutter,101,95872,45,39,0,39,2
2020-05-26,Tehama,103,63373,8,2,1,3,1
2020-05-26,Trinity,105,12862,6,1,2,3,0
2020-05-26,Tulare,107,460477,2415,1768,10,1778,76
2020-05-26,Tuolumne,109,53932,4,2,0,2,0
2020-05-26,Ventura,111,848112,1511,1033,8,1041,27
2020-05-26,Yolo,113,214977,217,198,0,198,22
2020-05-26,Yuba,115,75493,27,24,0,24,1
2020-05-25,Alameda,001,1643700,3439,2900,5,2905,92
2020-05-25,Alpine,003,1148,1,1,0,1,0
2020-05-25,Amador,005,37829,9,10,0,10,0
2020-05-25,Butte,007,227075,63,37,1,38,0
2020-05-25,Calaveras,009,45235,12,13,0,13,0
2020-05-25,Colusa,011,21464,7,4,0,4,0
2020-05-25,Contra Costa,013,1133247,1533,1348,1,1349,37
2020-05-25,Del Norte,015,27424,44,20,0,20,0
2020-05-25,El Dorado,017,186661,100,78,0,78,0
2020-05-25,Fresno,019,978130,2899,1496,41,1537,22
2020-05-25,Glenn,021,27897,16,12,0,12,0
2020-05-25,Humboldt,023,135768,106,81,0,81,2
2020-05-25,Imperial,025,180216,2800,1369,4,1373,14
2020-05-25,Inyo,027,18085,19,20,0,20,1
2020-05-25,Kern,029,883053,2503,1890,6,1896,31
2020-05-25,Kings,031,150075,776,447,3,450,2
2020-05-25,Lake,033,64148,25,13,0,13,0
2020-05-25,Lassen,035,31185,9,0,2,2,0
2020-05-25,Los Angeles,037,10098052,54642,45952,21,45973,2094
2020-05-25,Madera,039,155013,196,83,1,84,2
2020-05-25,Marin,041,260295,437,415,2,417,14
2020-05-25,Mariposa,043,17540,16,15,0,15,1
2020-05-25,Mendocino,045,87422,22,19,0,19,0
2020-05-25,Merced,047,269075,356,262,0,262,6
2020-05-25,Modoc,049,8938,0,1,0,1,0
2020-05-25,Mono,051,14174,37,34,0,34,1
2020-05-25,Monterey,053,433212,545,418,1,419,8
2020-05-25,Napa,055,140530,131,107,0,107,3
2020-05-25,Nevada,057,99092,43,41,1,42,1
2020-05-25,Orange,059,3164182,8080,5601,64,5665,115
2020-05-25,Placer,061,380077,226,186,0,186,9
2020-05-25,Plumas,063,18699,4,4,0,4,0
2020-05-25,Riverside,065,2383286,8067,6900,19,6919,284
2020-05-25,Sacramento,067,1510023,1402,1290,1,1291,50
2020-05-25,San Benito,069,59416,88,70,0,70,2
2020-05-25,San Bernardino,071,2135413,5526,4393,4,4397,175
2020-05-25,San Diego,073,3302833,7796,6799,0,6799,249
2020-05-25,San Francisco,075,870044,2532,2358,0,2358,40
2020-05-25,San Joaquin,077,732212,965,760,4,764,33
2020-05-25,San Luis Obispo,079,281455,344,260,4,264,1
2020-05-25,San Mateo,081,765935,2225,1938,3,1941,71
2020-05-25,Santa Barbara,083,443738,1690,1590,11,1601,9
2020-05-25,Santa Clara,085,1922200,3302,2647,12,2659,139
2020-05-25,Santa Cruz,087,273765,217,191,0,191,2
2020-05-25,Shasta,089,179085,54,36,0,36,4
2020-05-25,Sierra,091,2930,1,1,0,1,0
2020-05-25,Siskiyou,093,43540,8,6,0,6,0
2020-05-25,Solano,095,438530,549,437,1,438,5
2020-05-25,Sonoma,097,501317,563,496,0,496,4
2020-05-25,Stanislaus,099,539301,747,651,5,656,27
2020-05-25,Sutter,101,95872,45,38,0,38,2
2020-05-25,Tehama,103,63373,7,2,1,3,1
2020-05-25,Trinity,105,12862,6,1,2,3,0
2020-05-25,Tulare,107,460477,2351,1747,10,1757,76
2020-05-25,Tuolumne,109,53932,4,2,0,2,0
2020-05-25,Ventura,111,848112,1470,1020,8,1028,27
2020-05-25,Yolo,113,214977,215,197,0,197,22
2020-05-25,Yuba,115,75493,26,24,0,24,1
2020-05-24,Alameda,001,1643700,3366,2830,5,2835,92
2020-05-24,Alpine,003,1148,1,1,0,1,0
2020-05-24,Amador,005,37829,9,9,0,9,0
2020-05-24,Butte,007,227075,61,35,1,36,0
2020-05-24,Calaveras,009,45235,12,13,0,13,0
2020-05-24,Colusa,011,21464,7,4,0,4,0
2020-05-24,Contra Costa,013,1133247,1505,1325,1,1326,37
2020-05-24,Del Norte,015,27424,43,16,0,16,0
2020-05-24,El Dorado,017,186661,99,76,0,76,0
2020-05-24,Fresno,019,978130,2832,1455,40,1495,22
2020-05-24,Glenn,021,27897,15,12,0,12,0
2020-05-24,Humboldt,023,135768,106,81,0,81,2
2020-05-24,Imperial,025,180216,2674,1369,4,1373,14
2020-05-24,Inyo,027,18085,19,20,0,20,1
2020-05-24,Kern,029,883053,2430,1861,5,1866,31
2020-05-24,Kings,031,150075,765,446,3,449,2
2020-05-24,Lake,033,64148,24,12,0,12,0
2020-05-24,Lassen,035,31185,8,0,2,2,0
2020-05-24,Los Angeles,037,10098052,53628,44954,21,44975,2085
2020-05-24,Madera,039,155013,190,83,1,84,2
2020-05-24,Marin,041,260295,435,401,2,403,14
2020-05-24,Mariposa,043,17540,16,15,0,15,1
2020-05-24,Mendocino,045,87422,21,19,0,19,0
2020-05-24,Merced,047,269075,355,258,0,258,6
2020-05-24,Modoc,049,8938,0,0,0,0,0
2020-05-24,Mono,051,14174,37,34,0,34,1
2020-05-24,Monterey,053,433212,517,405,1,406,8
2020-05-24,Napa,055,140530,129,104,0,104,3
2020-05-24,Nevada,057,99092,43,41,1,42,1
2020-05-24,Orange,059,3164182,7926,5439,63,5502,113
2020-05-24,Placer,061,380077,218,184,0,184,9
2020-05-24,Plumas,063,18699,4,4,0,4,0
2020-05-24,Riverside,065,2383286,7926,6571,19,6590,284
2020-05-24,Sacramento,067,1510023,1386,1283,1,1284,50
2020-05-24,San Benito,069,59416,87,67,0,67,2
2020-05-24,San Bernardino,071,2135413,5418,4262,4,4266,175
2020-05-24,San Diego,073,3302833,7653,6703,0,6703,249
2020-05-24,San Francisco,075,870044,2508,2318,0,2318,40
2020-05-24,San Joaquin,077,732212,946,760,4,764,33
2020-05-24,San Luis Obispo,079,281455,342,257,4,261,1
2020-05-24,San Mateo,081,765935,2190,1925,3,1928,71
2020-05-24,Santa Barbara,083,443738,1678,1573,11,1584,9
2020-05-24,Santa Clara,085,1922200,3282,2623,12,2635,139
2020-05-24,Santa Cruz,087,273765,214,185,0,185,2
2020-05-24,Shasta,089,179085,53,36,0,36,4
2020-05-24,Sierra,091,2930,1,1,0,1,0
2020-05-24,Siskiyou,093,43540,7,6,0,6,0
2020-05-24,Solano,095,438530,541,436,0,436,5
2020-05-24,Sonoma,097,501317,552,485,0,485,4
2020-05-24,Stanislaus,099,539301,727,634,5,639,27
2020-05-24,Sutter,101,95872,45,38,0,38,2
2020-05-24,Tehama,103,63373,5,2,1,3,1
2020-05-24,Trinity,105,12862,6,1,2,3,0
2020-05-24,Tulare,107,460477,2305,1684,10,1694,74
2020-05-24,Tuolumne,109,53932,4,2,0,2,0
2020-05-24,Ventura,111,848112,1458,982,8,990,27
2020-05-24,Yolo,113,214977,213,192,0,192,22
2020-05-24,Yuba,115,75493,26,24,0,24,1
2020-05-23,Alameda,001,1643700,3325,2783,5,2788,91
2020-05-23,Alpine,003,1148,1,1,0,1,0
2020-05-23,Amador,005,37829,9,9,0,9,0
2020-05-23,Butte,007,227075,60,34,1,35,0
2020-05-23,Calaveras,009,45235,12,13,0,13,0
2020-05-23,Colusa,011,21464,7,4,0,4,0
2020-05-23,Contra Costa,013,1133247,1494,1302,1,1303,36
2020-05-23,Del Norte,015,27424,43,10,0,10,0
2020-05-23,El Dorado,017,186661,99,74,0,74,0
2020-05-23,Fresno,019,978130,2812,1447,40,1487,21
2020-05-23,Glenn,021,27897,15,12,0,12,0
2020-05-23,Humboldt,023,135768,104,80,0,80,2
2020-05-23,Imperial,025,180216,2586,1283,4,1287,14
2020-05-23,Inyo,027,18085,19,20,0,20,1
2020-05-23,Kern,029,883053,2387,1806,5,1811,31
2020-05-23,Kings,031,150075,761,444,3,447,2
2020-05-23,Lake,033,64148,23,10,0,10,0
2020-05-23,Lassen,035,31185,8,0,2,2,0
2020-05-23,Los Angeles,037,10098052,53086,44029,21,44050,2069
2020-05-23,Madera,039,155013,186,83,1,84,2
2020-05-23,Marin,041,260295,435,393,1,394,14
2020-05-23,Mariposa,043,17540,16,15,0,15,1
2020-05-23,Mendocino,045,87422,21,13,0,13,0
2020-05-23,Merced,047,269075,352,247,0,247,6
2020-05-23,Modoc,049,8938,0,0,0,0,0
2020-05-23,Mono,051,14174,36,34,0,34,1
2020-05-23,Monterey,053,433212,503,397,1,398,8
2020-05-23,Napa,055,140530,125,101,0,101,3
2020-05-23,Nevada,057,99092,43,41,1,42,1
2020-05-23,Orange,059,3164182,7767,5313,62,5375,113
2020-05-23,Placer,061,380077,212,184,0,184,9
2020-05-23,Plumas,063,18699,4,4,0,4,0
2020-05-23,Riverside,065,2383286,7835,6460,19,6479,284
2020-05-23,Sacramento,067,1510023,1370,1275,1,1276,50
2020-05-23,San Benito,069,59416,82,67,0,67,2
2020-05-23,San Bernardino,071,2135413,5324,4172,4,4176,175
2020-05-23,San Diego,073,3302833,7562,6561,0,6561,249
2020-05-23,San Francisco,075,870044,2489,2312,0,2312,40
2020-05-23,San Joaquin,077,732212,931,759,4,763,33
2020-05-23,San Luis Obispo,079,281455,338,256,4,260,1
2020-05-23,San Mateo,081,765935,2162,1862,3,1865,71
2020-05-23,Santa Barbara,083,443738,1670,1566,11,1577,9
2020-05-23,Santa Clara,085,1922200,3268,2593,11,2604,139
2020-05-23,Santa Cruz,087,273765,212,177,0,177,2
2020-05-23,Shasta,089,179085,53,35,0,35,4
2020-05-23,Sierra,091,2930,1,1,0,1,0
2020-05-23,Siskiyou,093,43540,7,6,0,6,0
2020-05-23,Solano,095,438530,536,435,0,435,5
2020-05-23,Sonoma,097,501317,538,462,0,462,4
2020-05-23,Stanislaus,099,539301,719,625,5,630,27
2020-05-23,Sutter,101,95872,44,38,0,38,2
2020-05-23,Tehama,103,63373,5,2,1,3,1
2020-05-23,Trinity,105,12862,6,1,2,3,0
2020-05-23,Tulare,107,460477,2284,1682,10,1692,73
2020-05-23,Tuolumne,109,53932,4,2,0,2,0
2020-05-23,Ventura,111,848112,1438,961,8,969,27
2020-05-23,Yolo,113,214977,212,188,0,188,22
2020-05-23,Yuba,115,75493,26,24,0,24,1
2020-05-22,Alameda,001,1643700,3271,2722,5,2727,91
2020-05-22,Alpine,003,1148,1,1,0,1,0
2020-05-22,Amador,005,37829,9,9,0,9,0
2020-05-22,Butte,007,227075,58,34,1,35,0
2020-05-22,Calaveras,009,45235,12,13,0,13,0
2020-05-22,Colusa,011,21464,7,4,0,4,0
2020-05-22,Contra Costa,013,1133247,1482,1272,1,1273,36
2020-05-22,Del Norte,015,27424,41,9,0,9,0
2020-05-22,El Dorado,017,186661,96,74,0,74,0
2020-05-22,Fresno,019,978130,2753,1399,39,1438,20
2020-05-22,Glenn,021,27897,15,12,0,12,0
2020-05-22,Humboldt,023,135768,104,80,0,80,2
2020-05-22,Imperial,025,180216,2486,1214,4,1218,14
2020-05-22,Inyo,027,18085,19,20,0,20,1
2020-05-22,Kern,029,883053,2338,1749,5,1754,28
2020-05-22,Kings,031,150075,758,428,3,431,2
2020-05-22,Lake,033,64148,22,10,0,10,0
2020-05-22,Lassen,035,31185,6,0,2,2,0
2020-05-22,Los Angeles,037,10098052,52294,43025,21,43046,2027
2020-05-22,Madera,039,155013,182,82,1,83,2
2020-05-22,Marin,041,260295,431,372,1,373,14
2020-05-22,Mariposa,043,17540,16,15,0,15,1
2020-05-22,Mendocino,045,87422,20,13,0,13,0
2020-05-22,Merced,047,269075,352,233,0,233,6
2020-05-22,Modoc,049,8938,0,0,0,0,0
2020-05-22,Mono,051,14174,36,34,0,34,1
2020-05-22,Monterey,053,433212,492,372,1,373,8
2020-05-22,Napa,055,140530,123,97,0,97,3
2020-05-22,Nevada,057,99092,42,41,1,42,1
2020-05-22,Orange,059,3164182,7570,5144,60,5204,113
2020-05-22,Placer,061,380077,212,181,0,181,9
2020-05-22,Plumas,063,18699,4,4,0,4,0
2020-05-22,Riverside,065,2383286,7720,6351,19,6370,283
2020-05-22,Sacramento,067,1510023,1354,1262,1,1263,50
2020-05-22,San Benito,069,59416,81,64,0,64,2
2020-05-22,San Bernardino,071,2135413,5249,4107,4,4111,173
2020-05-22,San Diego,073,3302833,7476,6436,0,6436,242
2020-05-22,San Francisco,075,870044,2471,2251,0,2251,40
2020-05-22,San Joaquin,077,732212,918,747,4,751,33
2020-05-22,San Luis Obispo,079,281455,338,254,4,258,1
2020-05-22,San Mateo,081,765935,2143,1847,3,1850,71
2020-05-22,Santa Barbara,083,443738,1660,1554,11,1565,9
2020-05-22,Santa Clara,085,1922200,3247,2537,11,2548,139
2020-05-22,Santa Cruz,087,273765,209,171,0,171,2
2020-05-22,Shasta,089,179085,53,34,0,34,4
2020-05-22,Sierra,091,2930,1,0,0,0,0
2020-05-22,Siskiyou,093,43540,7,6,0,6,0
2020-05-22,Solano,095,438530,533,431,0,431,4
2020-05-22,Sonoma,097,501317,534,444,0,444,4
2020-05-22,Stanislaus,099,539301,709,616,5,621,27
2020-05-22,Sutter,101,95872,44,38,0,38,2
2020-05-22,Tehama,103,63373,5,2,0,2,1
2020-05-22,Trinity,105,12862,6,1,2,3,0
2020-05-22,Tulare,107,460477,2254,1662,10,1672,73
2020-05-22,Tuolumne,109,53932,4,2,0,2,0
2020-05-22,Ventura,111,848112,1420,937,8,945,27
2020-05-22,Yolo,113,214977,210,187,0,187,22
2020-05-22,Yuba,115,75493,26,24,0,24,1
2020-05-21,Alameda,001,1643700,3206,2606,5,2611,89
2020-05-21,Alpine,003,1148,1,1,0,1,0
2020-05-21,Amador,005,37829,9,9,0,9,0
2020-05-21,Butte,007,227075,57,31,1,32,0
2020-05-21,Calaveras,009,45235,11,13,0,13,0
2020-05-21,Colusa,011,21464,7,4,0,4,0
2020-05-21,Contra Costa,013,1133247,1446,1243,1,1244,36
2020-05-21,Del Norte,015,27424,38,9,0,9,0
2020-05-21,El Dorado,017,186661,94,67,0,67,0
2020-05-21,Fresno,019,978130,2661,1362,38,1400,20
2020-05-21,Glenn,021,27897,14,12,0,12,0
2020-05-21,Humboldt,023,135768,103,79,0,79,0
2020-05-21,Imperial,025,180216,2327,1096,4,1100,14
2020-05-21,Inyo,027,18085,19,20,0,20,1
2020-05-21,Kern,029,883053,2262,1684,4,1688,27
2020-05-21,Kings,031,150075,737,417,2,419,2
2020-05-21,Lake,033,64148,17,10,0,10,0
2020-05-21,Lassen,035,31185,6,0,2,2,0
2020-05-21,Los Angeles,037,10098052,51260,42063,21,42084,1996
2020-05-21,Madera,039,155013,179,82,1,83,2
2020-05-21,Marin,041,260295,420,359,1,360,14
2020-05-21,Mariposa,043,17540,16,15,0,15,1
2020-05-21,Mendocino,045,87422,20,12,0,12,0
2020-05-21,Merced,047,269075,341,226,0,226,6
2020-05-21,Modoc,049,8938,0,0,0,0,0
2020-05-21,Mono,051,14174,36,33,0,33,1
2020-05-21,Monterey,053,433212,481,363,1,364,8
2020-05-21,Napa,055,140530,121,96,0,96,3
2020-05-21,Nevada,057,99092,42,41,1,42,1
2020-05-21,Orange,059,3164182,7367,4975,59,5034,106
2020-05-21,Placer,061,380077,205,176,0,176,8
2020-05-21,Plumas,063,18699,4,4,0,4,0
2020-05-21,Riverside,065,2383286,7533,6245,19,6264,279
2020-05-21,Sacramento,067,1510023,1341,1258,1,1259,56
2020-05-21,San Benito,069,59416,78,61,0,61,2
2020-05-21,San Bernardino,071,2135413,5102,3950,4,3954,167
2020-05-21,San Diego,073,3302833,7340,6317,0,6317,241
2020-05-21,San Francisco,075,870044,2447,2248,0,2248,37
2020-05-21,San Joaquin,077,732212,882,730,4,734,33
2020-05-21,San Luis Obispo,079,281455,338,251,3,254,1
2020-05-21,San Mateo,081,765935,2106,1791,3,1794,74
2020-05-21,Santa Barbara,083,443738,1645,1541,11,1552,10
2020-05-21,Santa Clara,085,1922200,3225,2520,11,2531,138
2020-05-21,Santa Cruz,087,273765,201,164,0,164,3
2020-05-21,Shasta,089,179085,51,34,0,34,4
2020-05-21,Sierra,091,2930,1,0,0,0,0
2020-05-21,Siskiyou,093,43540,7,6,0,6,0
2020-05-21,Solano,095,438530,524,424,0,424,4
2020-05-21,Sonoma,097,501317,516,427,0,427,4
2020-05-21,Stanislaus,099,539301,698,602,5,607,27
2020-05-21,Sutter,101,95872,43,38,0,38,2
2020-05-21,Tehama,103,63373,4,2,0,2,1
2020-05-21,Trinity,105,12862,5,1,2,3,0
2020-05-21,Tulare,107,460477,2204,1606,8,1614,73
2020-05-21,Tuolumne,109,53932,2,2,0,2,0
2020-05-21,Ventura,111,848112,1371,907,8,915,30
2020-05-21,Yolo,113,214977,207,185,0,185,22
2020-05-21,Yuba,115,75493,26,24,0,24,1
2020-05-20,Alameda,001,1643700,3133,2554,5,2559,89
2020-05-20,Alpine,003,1148,1,1,0,1,0
2020-05-20,Amador,005,37829,9,9,0,9,0
2020-05-20,Butte,007,227075,54,30,1,31,0
2020-05-20,Calaveras,009,45235,11,13,0,13,0
2020-05-20,Colusa,011,21464,7,3,0,3,0
2020-05-20,Contra Costa,013,1133247,1416,1223,1,1224,33
2020-05-20,Del Norte,015,27424,31,9,0,9,0
2020-05-20,El Dorado,017,186661,93,67,0,67,0
2020-05-20,Fresno,019,978130,2588,1329,37,1366,17
2020-05-20,Glenn,021,27897,13,12,0,12,0
2020-05-20,Humboldt,023,135768,100,73,0,73,0
2020-05-20,Imperial,025,180216,2214,1047,4,1051,14
2020-05-20,Inyo,027,18085,19,20,0,20,1
2020-05-20,Kern,029,883053,2199,1639,3,1642,27
2020-05-20,Kings,031,150075,593,403,2,405,2
2020-05-20,Lake,033,64148,17,9,0,9,0
2020-05-20,Lassen,035,31185,5,0,2,2,0
2020-05-20,Los Angeles,037,10098052,50266,40932,21,40953,1955
2020-05-20,Madera,039,155013,177,82,1,83,2
2020-05-20,Marin,041,260295,393,348,1,349,14
2020-05-20,Mariposa,043,17540,16,15,0,15,1
2020-05-20,Mendocino,045,87422,20,12,0,12,0
2020-05-20,Merced,047,269075,334,225,0,225,6
2020-05-20,Modoc,049,8938,0,0,0,0,0
2020-05-20,Mono,051,14174,36,33,0,33,1
2020-05-20,Monterey,053,433212,467,356,1,357,8
2020-05-20,Napa,055,140530,114,93,0,93,3
2020-05-20,Nevada,057,99092,42,41,1,42,1
2020-05-20,Orange,059,3164182,7159,4866,57,4923,96
2020-05-20,Placer,061,380077,203,176,0,176,8
2020-05-20,Plumas,063,18699,4,4,0,4,0
2020-05-20,Riverside,065,2383286,7390,6090,19,6109,265
2020-05-20,Sacramento,067,1510023,1331,1244,1,1245,56
2020-05-20,San Benito,069,59416,77,61,0,61,2
2020-05-20,San Bernardino,071,2135413,4975,3771,4,3775,161
2020-05-20,San Diego,073,3302833,7223,6142,0,6142,230
2020-05-20,San Francisco,075,870044,2424,2199,0,2199,37
2020-05-20,San Joaquin,077,732212,846,713,4,717,33
2020-05-20,San Luis Obispo,079,281455,331,249,3,252,1
2020-05-20,San Mateo,081,765935,2053,1739,3,1742,74
2020-05-20,Santa Barbara,083,443738,1626,1524,11,1535,10
2020-05-20,Santa Clara,085,1922200,3204,2508,10,2518,138
2020-05-20,Santa Cruz,087,273765,198,163,0,163,3
2020-05-20,Shasta,089,179085,51,34,0,34,4
2020-05-20,Sierra,091,2930,1,0,0,0,0
2020-05-20,Siskiyou,093,43540,7,6,0,6,0
2020-05-20,Solano,095,438530,519,418,0,418,4
2020-05-20,Sonoma,097,501317,507,411,0,411,4
2020-05-20,Stanislaus,099,539301,682,584,4,588,25
2020-05-20,Sutter,101,95872,43,38,0,38,2
2020-05-20,Tehama,103,63373,4,2,0,2,1
2020-05-20,Trinity,105,12862,4,1,1,2,0
2020-05-20,Tulare,107,460477,2163,1585,8,1593,71
2020-05-20,Tuolumne,109,53932,2,2,0,2,0
2020-05-20,Ventura,111,848112,1335,879,8,887,29
2020-05-20,Yolo,113,214977,204,184,0,184,22
2020-05-20,Yuba,115,75493,26,23,0,23,1
2020-05-19,Alameda,001,1643700,3056,2493,3,2496,88
2020-05-19,Alpine,003,1148,1,1,0,1,0
2020-05-19,Amador,005,37829,9,9,0,9,0
2020-05-19,Butte,007,227075,52,25,1,26,0
2020-05-19,Calaveras,009,45235,11,13,0,13,0
2020-05-19,Colusa,011,21464,5,3,0,3,0
2020-05-19,Contra Costa,013,1133247,1393,1205,1,1206,33
2020-05-19,Del Norte,015,27424,28,8,0,8,0
2020-05-19,El Dorado,017,186661,90,67,0,67,0
2020-05-19,Fresno,019,978130,2474,1288,36,1324,15
2020-05-19,Glenn,021,27897,13,12,0,12,0
2020-05-19,Humboldt,023,135768,100,72,0,72,0
2020-05-19,Imperial,025,180216,2052,1012,4,1016,14
2020-05-19,Inyo,027,18085,19,20,0,20,1
2020-05-19,Kern,029,883053,2101,1601,3,1604,26
2020-05-19,Kings,031,150075,582,393,2,395,2
2020-05-19,Lake,033,64148,14,11,0,11,0
2020-05-19,Lassen,035,31185,5,0,2,2,0
2020-05-19,Los Angeles,037,10098052,49060,39670,21,39691,1906
2020-05-19,Madera,039,155013,173,80,1,81,2
2020-05-19,Marin,041,260295,369,340,1,341,14
2020-05-19,Mariposa,043,17540,16,15,0,15,1
2020-05-19,Mendocino,045,87422,20,12,0,12,0
2020-05-19,Merced,047,269075,326,222,0,222,5
2020-05-19,Modoc,049,8938,0,0,0,0,0
2020-05-19,Mono,051,14174,36,33,0,33,1
2020-05-19,Monterey,053,433212,455,350,1,351,8
2020-05-19,Napa,055,140530,113,93,0,93,3
2020-05-19,Nevada,057,99092,42,41,1,42,1
2020-05-19,Orange,059,3164182,6965,4746,55,4801,90
2020-05-19,Placer,061,380077,201,177,0,177,8
2020-05-19,Plumas,063,18699,4,5,0,5,0
2020-05-19,Riverside,065,2383286,7230,5963,18,5981,265
2020-05-19,Sacramento,067,1510023,1317,1239,1,1240,57
2020-05-19,San Benito,069,59416,75,59,0,59,2
2020-05-19,San Bernardino,071,2135413,4825,3656,4,3660,158
2020-05-19,San Diego,073,3302833,7079,6028,0,6028,222
2020-05-19,San Francisco,075,870044,2390,2186,0,2186,37
2020-05-19,San Joaquin,077,732212,824,705,4,709,33
2020-05-19,San Luis Obispo,079,281455,330,245,3,248,1
2020-05-19,San Mateo,081,765935,2012,1704,3,1707,71
2020-05-19,Santa Barbara,083,443738,1612,1521,11,1532,10
2020-05-19,Santa Clara,085,1922200,3154,2480,10,2490,138
2020-05-19,Santa Cruz,087,273765,187,161,0,161,3
2020-05-19,Shasta,089,179085,51,34,0,34,4
2020-05-19,Sierra,091,2930,0,0,0,0,0
2020-05-19,Siskiyou,093,43540,7,6,0,6,0
2020-05-19,Solano,095,438530,505,415,0,415,4
2020-05-19,Sonoma,097,501317,496,389,0,389,4
2020-05-19,Stanislaus,099,539301,668,582,4,586,25
2020-05-19,Sutter,101,95872,43,38,0,38,2
2020-05-19,Tehama,103,63373,4,2,0,2,1
2020-05-19,Trinity,105,12862,3,1,0,1,0
2020-05-19,Tulare,107,460477,2115,1551,8,1559,68
2020-05-19,Tuolumne,109,53932,2,2,0,2,0
2020-05-19,Ventura,111,848112,1294,861,7,868,28
2020-05-19,Yolo,113,214977,202,183,0,183,22
2020-05-19,Yuba,115,75493,26,23,0,23,1
2020-05-18,Alameda,001,1643700,2983,2442,3,2445,84
2020-05-18,Alpine,003,1148,1,1,0,1,0
2020-05-18,Amador,005,37829,9,8,0,8,0
2020-05-18,Butte,007,227075,50,24,1,25,0
2020-05-18,Calaveras,009,45235,11,13,0,13,0
2020-05-18,Colusa,011,21464,5,3,0,3,0
2020-05-18,Contra Costa,013,1133247,1362,1173,1,1174,33
2020-05-18,Del Norte,015,27424,23,8,0,8,0
2020-05-18,El Dorado,017,186661,88,67,0,67,0
2020-05-18,Fresno,019,978130,2396,1244,35,1279,14
2020-05-18,Glenn,021,27897,13,11,0,11,0
2020-05-18,Humboldt,023,135768,100,70,0,70,0
2020-05-18,Imperial,025,180216,1899,767,4,771,14
2020-05-18,Inyo,027,18085,19,20,0,20,1
2020-05-18,Kern,029,883053,2052,1566,3,1569,26
2020-05-18,Kings,031,150075,551,381,2,383,2
2020-05-18,Lake,033,64148,13,9,0,9,0
2020-05-18,Lassen,035,31185,5,0,2,2,0
2020-05-18,Los Angeles,037,10098052,48039,38477,21,38498,1825
2020-05-18,Madera,039,155013,167,74,1,75,2
2020-05-18,Marin,041,260295,356,329,1,330,14
2020-05-18,Mariposa,043,17540,16,15,0,15,1
2020-05-18,Mendocino,045,87422,15,12,0,12,0
2020-05-18,Merced,047,269075,316,217,0,217,5
2020-05-18,Modoc,049,8938,0,0,0,0,0
2020-05-18,Mono,051,14174,36,33,0,33,1
2020-05-18,Monterey,053,433212,444,345,1,346,8
2020-05-18,Napa,055,140530,109,92,0,92,3
2020-05-18,Nevada,057,99092,42,41,1,42,1
2020-05-18,Orange,059,3164182,6776,4558,53,4611,88
2020-05-18,Placer,061,380077,199,176,0,176,8
2020-05-18,Plumas,063,18699,4,5,0,5,0
2020-05-18,Riverside,065,2383286,7030,5873,18,5891,253
2020-05-18,Sacramento,067,1510023,1311,1233,0,1233,57
2020-05-18,San Benito,069,59416,73,59,0,59,2
2020-05-18,San Bernardino,071,2135413,4678,3558,4,3562,156
2020-05-18,San Diego,073,3302833,6946,5948,0,5948,211
2020-05-18,San Francisco,075,870044,2367,2183,0,2183,36
2020-05-18,San Joaquin,077,732212,812,697,4,701,33
2020-05-18,San Luis Obispo,079,281455,326,243,3,246,1
2020-05-18,San Mateo,081,765935,1974,1701,3,1704,68
2020-05-18,Santa Barbara,083,443738,1601,1501,11,1512,10
2020-05-18,Santa Clara,085,1922200,3121,2468,10,2478,137
2020-05-18,Santa Cruz,087,273765,185,160,0,160,3
2020-05-18,Shasta,089,179085,50,34,0,34,4
2020-05-18,Sierra,091,2930,0,0,0,0,0
2020-05-18,Siskiyou,093,43540,7,6,0,6,0
2020-05-18,Solano,095,438530,495,398,0,398,4
2020-05-18,Sonoma,097,501317,478,387,0,387,4
2020-05-18,Stanislaus,099,539301,656,572,4,576,25
2020-05-18,Sutter,101,95872,43,38,0,38,2
2020-05-18,Tehama,103,63373,4,2,0,2,1
2020-05-18,Trinity,105,12862,3,1,0,1,0
2020-05-18,Tulare,107,460477,2071,1491,8,1499,63
2020-05-18,Tuolumne,109,53932,2,2,0,2,0
2020-05-18,Ventura,111,848112,1271,850,6,856,27
2020-05-18,Yolo,113,214977,197,183,0,183,22
2020-05-18,Yuba,115,75493,26,23,0,23,1
2020-05-17,Alameda,001,1643700,2888,2389,3,2392,83
2020-05-17,Alpine,003,1148,1,1,0,1,0
2020-05-17,Amador,005,37829,9,8,0,8,0
2020-05-17,Butte,007,227075,49,23,1,24,0
2020-05-17,Calaveras,009,45235,11,13,0,13,0
2020-05-17,Colusa,011,21464,3,3,0,3,0
2020-05-17,Contra Costa,013,1133247,1323,1155,1,1156,33
2020-05-17,Del Norte,015,27424,23,7,0,7,0
2020-05-17,El Dorado,017,186661,88,65,0,65,0
2020-05-17,Fresno,019,978130,2290,1213,32,1245,14
2020-05-17,Glenn,021,27897,13,9,0,9,0
2020-05-17,Humboldt,023,135768,93,70,0,70,0
2020-05-17,Imperial,025,180216,1751,715,4,719,14
2020-05-17,Inyo,027,18085,19,20,0,20,1
2020-05-17,Kern,029,883053,1974,1546,3,1549,26
2020-05-17,Kings,031,150075,504,356,2,358,2
2020-05-17,Lake,033,64148,13,7,0,7,0
2020-05-17,Lassen,035,31185,5,0,2,2,0
2020-05-17,Los Angeles,037,10098052,46801,37996,21,38017,1807
2020-05-17,Madera,039,155013,165,69,1,70,2
2020-05-17,Marin,041,260295,345,315,1,316,14
2020-05-17,Mariposa,043,17540,15,15,0,15,1
2020-05-17,Mendocino,045,87422,14,10,0,10,0
2020-05-17,Merced,047,269075,305,214,0,214,5
2020-05-17,Modoc,049,8938,0,0,0,0,0
2020-05-17,Mono,051,14174,36,32,0,32,1
2020-05-17,Monterey,053,433212,424,342,1,343,8
2020-05-17,Napa,055,140530,105,89,0,89,3
2020-05-17,Nevada,057,99092,42,41,1,42,1
2020-05-17,Orange,059,3164182,6597,4466,52,4518,88
2020-05-17,Placer,061,380077,194,175,0,175,8
2020-05-17,Plumas,063,18699,4,4,0,4,0
2020-05-17,Riverside,065,2383286,6857,5776,18,5794,245
2020-05-17,Sacramento,067,1510023,1300,1224,0,1224,56
2020-05-17,San Benito,069,59416,72,59,0,59,2
2020-05-17,San Bernardino,071,2135413,4528,3467,4,3471,155
2020-05-17,San Diego,073,3302833,6814,5838,0,5838,209
2020-05-17,San Francisco,075,870044,2340,2132,0,2132,36
2020-05-17,San Joaquin,077,732212,782,688,4,692,32
2020-05-17,San Luis Obispo,079,281455,324,242,3,245,1
2020-05-17,San Mateo,081,765935,1937,1680,3,1683,68
2020-05-17,Santa Barbara,083,443738,1580,1457,11,1468,10
2020-05-17,Santa Clara,085,1922200,3083,2453,10,2463,135
2020-05-17,Santa Cruz,087,273765,174,155,0,155,3
2020-05-17,Shasta,089,179085,49,34,0,34,4
2020-05-17,Sierra,091,2930,0,0,0,0,0
2020-05-17,Siskiyou,093,43540,7,6,0,6,0
2020-05-17,Solano,095,438530,483,392,0,392,4
2020-05-17,Sonoma,097,501317,457,376,0,376,4
2020-05-17,Stanislaus,099,539301,645,566,4,570,25
2020-05-17,Sutter,101,95872,42,38,0,38,2
2020-05-17,Tehama,103,63373,3,2,0,2,1
2020-05-17,Trinity,105,12862,2,1,0,1,0
2020-05-17,Tulare,107,460477,1995,1430,7,1437,63
2020-05-17,Tuolumne,109,53932,2,2,0,2,0
2020-05-17,Ventura,111,848112,1226,838,6,844,27
2020-05-17,Yolo,113,214977,195,182,0,182,22
2020-05-17,Yuba,115,75493,26,21,0,21,1
2020-05-16,Alameda,001,1643700,2838,2327,3,2330,83
2020-05-16,Alpine,003,1148,1,1,0,1,0
2020-05-16,Amador,005,37829,9,8,0,8,0
2020-05-16,Butte,007,227075,44,22,1,23,0
2020-05-16,Calaveras,009,45235,11,13,0,13,0
2020-05-16,Colusa,011,21464,3,3,0,3,0
2020-05-16,Contra Costa,013,1133247,1305,1136,1,1137,33
2020-05-16,Del Norte,015,27424,19,4,0,4,0
2020-05-16,El Dorado,017,186661,88,65,0,65,0
2020-05-16,Fresno,019,978130,2233,1177,32,1209,14
2020-05-16,Glenn,021,27897,13,9,0,9,0
2020-05-16,Humboldt,023,135768,91,69,0,69,0
2020-05-16,Imperial,025,180216,1687,712,4,716,14
2020-05-16,Inyo,027,18085,19,20,0,20,1
2020-05-16,Kern,029,883053,1938,1509,3,1512,26
2020-05-16,Kings,031,150075,494,356,2,358,2
2020-05-16,Lake,033,64148,13,7,0,7,0
2020-05-16,Lassen,035,31185,4,0,2,2,0
2020-05-16,Los Angeles,037,10098052,46224,37352,21,37373,1778
2020-05-16,Madera,039,155013,163,70,1,71,2
2020-05-16,Marin,041,260295,341,297,1,298,14
2020-05-16,Mariposa,043,17540,15,15,0,15,1
2020-05-16,Mendocino,045,87422,14,10,0,10,0
2020-05-16,Merced,047,269075,303,201,0,201,5
2020-05-16,Modoc,049,8938,0,0,0,0,0
2020-05-16,Mono,051,14174,36,32,0,32,1
2020-05-16,Monterey,053,433212,409,329,1,330,8
2020-05-16,Napa,055,140530,105,86,0,86,3
2020-05-16,Nevada,057,99092,42,41,1,42,1
2020-05-16,Orange,059,3164182,6521,4396,52,4448,87
2020-05-16,Placer,061,380077,192,174,0,174,8
2020-05-16,Plumas,063,18699,4,4,0,4,0
2020-05-16,Riverside,065,2383286,6772,5633,18,5651,243
2020-05-16,Sacramento,067,1510023,1293,1209,0,1209,55
2020-05-16,San Benito,069,59416,67,58,0,58,2
2020-05-16,San Bernardino,071,2135413,4456,3362,4,3366,155
2020-05-16,San Diego,073,3302833,6728,5664,0,5664,209
2020-05-16,San Francisco,075,870044,2317,2094,0,2094,36
2020-05-16,San Joaquin,077,732212,774,668,4,672,32
2020-05-16,San Luis Obispo,079,281455,323,240,3,243,1
2020-05-16,San Mateo,081,765935,1922,1652,3,1655,68
2020-05-16,Santa Barbara,083,443738,1569,1422,10,1432,10
2020-05-16,Santa Clara,085,1922200,3065,2420,10,2430,135
2020-05-16,Santa Cruz,087,273765,171,154,0,154,3
2020-05-16,Shasta,089,179085,49,33,0,33,4
2020-05-16,Sierra,091,2930,0,0,0,0,0
2020-05-16,Siskiyou,093,43540,7,6,0,6,0
2020-05-16,Solano,095,438530,478,392,0,392,4
2020-05-16,Sonoma,097,501317,444,356,0,356,4
2020-05-16,Stanislaus,099,539301,636,546,4,550,24
2020-05-16,Sutter,101,95872,42,35,0,35,2
2020-05-16,Tehama,103,63373,3,2,0,2,1
2020-05-16,Trinity,105,12862,2,1,0,1,0
2020-05-16,Tulare,107,460477,1977,1426,7,1433,63
2020-05-16,Tuolumne,109,53932,2,2,0,2,0
2020-05-16,Ventura,111,848112,1200,813,6,819,25
2020-05-16,Yolo,113,214977,194,181,0,181,22
2020-05-16,Yuba,115,75493,26,21,0,21,1
2020-05-15,Alameda,001,1643700,2804,2289,3,2292,83
2020-05-15,Alpine,003,1148,1,1,0,1,0
2020-05-15,Amador,005,37829,9,8,0,8,0
2020-05-15,Butte,007,227075,42,22,1,23,0
2020-05-15,Calaveras,009,45235,11,13,0,13,0
2020-05-15,Colusa,011,21464,3,3,0,3,0
2020-05-15,Contra Costa,013,1133247,1287,1106,1,1107,33
2020-05-15,Del Norte,015,27424,14,4,0,4,0
2020-05-15,El Dorado,017,186661,88,64,0,64,0
2020-05-15,Fresno,019,978130,2166,1126,32,1158,14
2020-05-15,Glenn,021,27897,13,9,0,9,0
2020-05-15,Humboldt,023,135768,90,60,0,60,0
2020-05-15,Imperial,025,180216,1603,680,0,680,14
2020-05-15,Inyo,027,18085,19,20,0,20,1
2020-05-15,Kern,029,883053,1882,1472,3,1475,25
2020-05-15,Kings,031,150075,491,347,2,349,2
2020-05-15,Lake,033,64148,13,7,0,7,0
2020-05-15,Lassen,035,31185,4,0,2,2,0
2020-05-15,Los Angeles,037,10098052,45438,36317,21,36338,1734
2020-05-15,Madera,039,155013,162,71,1,72,2
2020-05-15,Marin,041,260295,333,295,1,296,14
2020-05-15,Mariposa,043,17540,15,15,0,15,1
2020-05-15,Mendocino,045,87422,14,10,0,10,0
2020-05-15,Merced,047,269075,300,191,0,191,5
2020-05-15,Modoc,049,8938,0,0,0,0,0
2020-05-15,Mono,051,14174,36,31,0,31,1
2020-05-15,Monterey,053,433212,403,321,1,322,8
2020-05-15,Napa,055,140530,105,83,0,83,3
2020-05-15,Nevada,057,99092,42,41,1,42,1
2020-05-15,Orange,059,3164182,6348,4281,52,4333,87
2020-05-15,Placer,061,380077,190,174,0,174,8
2020-05-15,Plumas,063,18699,4,4,0,4,0
2020-05-15,Riverside,065,2383286,6658,5496,18,5514,233
2020-05-15,Sacramento,067,1510023,1283,1203,0,1203,55
2020-05-15,San Benito,069,59416,64,57,0,57,2
2020-05-15,San Bernardino,071,2135413,4378,3225,4,3229,153
2020-05-15,San Diego,073,3302833,6621,5525,0,5525,208
2020-05-15,San Francisco,075,870044,2301,2062,0,2062,36
2020-05-15,San Joaquin,077,732212,768,656,4,660,32
2020-05-15,San Luis Obispo,079,281455,321,237,3,240,1
2020-05-15,San Mateo,081,765935,1900,1612,3,1615,68
2020-05-15,Santa Barbara,083,443738,1560,1409,9,1418,10
2020-05-15,Santa Clara,085,1922200,3022,2395,9,2404,135
2020-05-15,Santa Cruz,087,273765,170,146,0,146,3
2020-05-15,Shasta,089,179085,48,33,0,33,4
2020-05-15,Sierra,091,2930,0,0,0,0,0
2020-05-15,Siskiyou,093,43540,6,5,0,5,0
2020-05-15,Solano,095,438530,474,388,0,388,4
2020-05-15,Sonoma,097,501317,436,349,0,349,4
2020-05-15,Stanislaus,099,539301,629,540,4,544,23
2020-05-15,Sutter,101,95872,41,35,0,35,2
2020-05-15,Tehama,103,63373,3,1,0,1,1
2020-05-15,Trinity,105,12862,2,1,0,1,0
2020-05-15,Tulare,107,460477,1949,1356,7,1363,61
2020-05-15,Tuolumne,109,53932,2,2,0,2,0
2020-05-15,Ventura,111,848112,1182,789,5,794,25
2020-05-15,Yolo,113,214977,193,182,0,182,22
2020-05-15,Yuba,115,75493,26,21,0,21,1
2020-05-14,Alameda,001,1643700,2711,2255,3,2258,80
2020-05-14,Alpine,003,1148,1,1,0,1,0
2020-05-14,Amador,005,37829,9,8,0,8,0
2020-05-14,Butte,007,227075,40,22,1,23,0
2020-05-14,Calaveras,009,45235,11,13,0,13,0
2020-05-14,Colusa,011,21464,3,3,0,3,0
2020-05-14,Contra Costa,013,1133247,1261,1090,1,1091,32
2020-05-14,Del Norte,015,27424,14,4,0,4,0
2020-05-14,El Dorado,017,186661,79,59,0,59,0
2020-05-14,Fresno,019,978130,2106,1038,28,1066,12
2020-05-14,Glenn,021,27897,12,8,0,8,0
2020-05-14,Humboldt,023,135768,88,59,0,59,0
2020-05-14,Imperial,025,180216,1486,652,0,652,13
2020-05-14,Inyo,027,18085,19,20,0,20,1
2020-05-14,Kern,029,883053,1840,1430,3,1433,21
2020-05-14,Kings,031,150075,475,342,2,344,1
2020-05-14,Lake,033,64148,13,7,0,7,0
2020-05-14,Lassen,035,31185,4,0,2,2,0
2020-05-14,Los Angeles,037,10098052,44263,35427,21,35448,1693
2020-05-14,Madera,039,155013,153,69,1,70,2
2020-05-14,Marin,041,260295,315,283,1,284,14
2020-05-14,Mariposa,043,17540,15,15,0,15,0
2020-05-14,Mendocino,045,87422,13,10,0,10,0
2020-05-14,Merced,047,269075,290,182,0,182,3
2020-05-14,Modoc,049,8938,0,0,0,0,0
2020-05-14,Mono,051,14174,36,31,0,31,1
2020-05-14,Monterey,053,433212,393,317,1,318,7
2020-05-14,Napa,055,140530,103,83,0,83,3
2020-05-14,Nevada,057,99092,41,41,1,42,1
2020-05-14,Orange,059,3164182,6172,4163,50,4213,83
2020-05-14,Placer,061,380077,190,172,0,172,8
2020-05-14,Plumas,063,18699,4,4,0,4,0
2020-05-14,Riverside,065,2383286,6474,5339,18,5357,224
2020-05-14,Sacramento,067,1510023,1271,1181,0,1181,55
2020-05-14,San Benito,069,59416,62,56,0,56,2
2020-05-14,San Bernardino,071,2135413,4199,3149,4,3153,149
2020-05-14,San Diego,073,3302833,6486,5393,0,5393,200
2020-05-14,San Francisco,075,870044,2268,2029,0,2029,36
2020-05-14,San Joaquin,077,732212,753,643,4,647,31
2020-05-14,San Luis Obispo,079,281455,318,236,3,239,1
2020-05-14,San Mateo,081,765935,1868,1588,3,1591,67
2020-05-14,Santa Barbara,083,443738,1548,1395,9,1404,11
2020-05-14,Santa Clara,085,1922200,2999,2380,9,2389,134
2020-05-14,Santa Cruz,087,273765,168,145,0,145,3
2020-05-14,Shasta,089,179085,48,33,0,33,4
2020-05-14,Sierra,091,2930,0,0,0,0,0
2020-05-14,Siskiyou,093,43540,6,5,0,5,0
2020-05-14,Solano,095,438530,465,372,0,372,4
2020-05-14,Sonoma,097,501317,419,333,0,333,4
2020-05-14,Stanislaus,099,539301,610,533,4,537,23
2020-05-14,Sutter,101,95872,41,34,0,34,2
2020-05-14,Tehama,103,63373,3,1,0,1,1
2020-05-14,Trinity,105,12862,2,1,0,1,0
2020-05-14,Tulare,107,460477,1910,1317,7,1324,55
2020-05-14,Tuolumne,109,53932,2,2,0,2,0
2020-05-14,Ventura,111,848112,1151,760,5,765,25
2020-05-14,Yolo,113,214977,193,180,0,180,22
2020-05-14,Yuba,115,75493,26,21,0,21,1
2020-05-13,Alameda,001,1643700,2653,2181,3,2184,78
2020-05-13,Alpine,003,1148,1,1,0,1,0
2020-05-13,Amador,005,37829,9,8,0,8,0
2020-05-13,Butte,007,227075,40,21,1,22,0
2020-05-13,Calaveras,009,45235,11,13,0,13,0
2020-05-13,Colusa,011,21464,3,3,0,3,0
2020-05-13,Contra Costa,013,1133247,1239,1082,1,1083,32
2020-05-13,Del Norte,015,27424,13,4,0,4,0
2020-05-13,El Dorado,017,186661,78,58,0,58,0
2020-05-13,Fresno,019,978130,2010,993,28,1021,10
2020-05-13,Glenn,021,27897,11,6,0,6,0
2020-05-13,Humboldt,023,135768,82,58,0,58,0
2020-05-13,Imperial,025,180216,1416,610,0,610,11
2020-05-13,Inyo,027,18085,19,20,0,20,1
2020-05-13,Kern,029,883053,1794,1390,3,1393,19
2020-05-13,Kings,031,150075,461,314,2,316,1
2020-05-13,Lake,033,64148,13,7,0,7,0
2020-05-13,Lassen,035,31185,4,0,2,2,0
2020-05-13,Los Angeles,037,10098052,42957,34574,21,34595,1643
2020-05-13,Madera,039,155013,144,69,1,70,2
2020-05-13,Marin,041,260295,302,278,1,279,14
2020-05-13,Mariposa,043,17540,15,15,0,15,0
2020-05-13,Mendocino,045,87422,13,10,0,10,0
2020-05-13,Merced,047,269075,287,176,0,176,3
2020-05-13,Modoc,049,8938,0,0,0,0,0
2020-05-13,Mono,051,14174,35,31,0,31,1
2020-05-13,Monterey,053,433212,383,309,1,310,6
2020-05-13,Napa,055,140530,103,81,0,81,3
2020-05-13,Nevada,057,99092,41,41,1,42,1
2020-05-13,Orange,059,3164182,5926,4025,48,4073,79
2020-05-13,Placer,061,380077,189,170,0,170,8
2020-05-13,Plumas,063,18699,4,4,0,4,0
2020-05-13,Riverside,065,2383286,6351,5204,18,5222,216
2020-05-13,Sacramento,067,1510023,1256,1173,0,1173,53
2020-05-13,San Benito,069,59416,62,55,0,55,2
2020-05-13,San Bernardino,071,2135413,3943,3064,3,3067,140
2020-05-13,San Diego,073,3302833,6350,5280,0,5280,194
2020-05-13,San Francisco,075,870044,2240,2004,0,2004,35
2020-05-13,San Joaquin,077,732212,732,639,3,642,31
2020-05-13,San Luis Obispo,079,281455,316,231,3,234,1
2020-05-13,San Mateo,081,765935,1836,1550,3,1553,66
2020-05-13,Santa Barbara,083,443738,1537,1382,9,1391,10
2020-05-13,Santa Clara,085,1922200,2979,2370,9,2379,132
2020-05-13,Santa Cruz,087,273765,164,142,0,142,2
2020-05-13,Shasta,089,179085,48,32,0,32,4
2020-05-13,Sierra,091,2930,0,0,0,0,0
2020-05-13,Siskiyou,093,43540,6,5,0,5,0
2020-05-13,Solano,095,438530,452,368,0,368,4
2020-05-13,Sonoma,097,501317,409,330,0,330,4
2020-05-13,Stanislaus,099,539301,601,521,4,525,15
2020-05-13,Sutter,101,95872,41,33,0,33,2
2020-05-13,Tehama,103,63373,3,1,0,1,1
2020-05-13,Trinity,105,12862,2,2,0,2,0
2020-05-13,Tulare,107,460477,1877,1283,7,1290,54
2020-05-13,Tuolumne,109,53932,2,2,0,2,0
2020-05-13,Ventura,111,848112,1120,742,5,747,25
2020-05-13,Yolo,113,214977,191,178,0,178,22
2020-05-13,Yuba,115,75493,24,19,0,19,1
2020-05-12,Alameda,001,1643700,2588,2146,3,2149,74
2020-05-12,Alpine,003,1148,1,1,0,1,0
2020-05-12,Amador,005,37829,9,8,0,8,0
2020-05-12,Butte,007,227075,38,20,1,21,0
2020-05-12,Calaveras,009,45235,10,13,0,13,0
2020-05-12,Colusa,011,21464,3,3,0,3,0
2020-05-12,Contra Costa,013,1133247,1208,1067,1,1068,32
2020-05-12,Del Norte,015,27424,10,3,0,3,0
2020-05-12,El Dorado,017,186661,75,56,0,56,0
2020-05-12,Fresno,019,978130,1926,978,26,1004,9
2020-05-12,Glenn,021,27897,10,6,0,6,0
2020-05-12,Humboldt,023,135768,79,58,0,58,0
2020-05-12,Imperial,025,180216,1284,602,0,602,9
2020-05-12,Inyo,027,18085,19,20,0,20,1
2020-05-12,Kern,029,883053,1753,1363,3,1366,18
2020-05-12,Kings,031,150075,440,302,2,304,1
2020-05-12,Lake,033,64148,13,7,0,7,0
2020-05-12,Lassen,035,31185,4,0,2,2,0
2020-05-12,Los Angeles,037,10098052,41962,33281,20,33301,1601
2020-05-12,Madera,039,155013,138,69,1,70,2
2020-05-12,Marin,041,260295,297,274,1,275,14
2020-05-12,Mariposa,043,17540,15,15,0,15,0
2020-05-12,Mendocino,045,87422,13,10,0,10,0
2020-05-12,Merced,047,269075,276,175,0,175,3
2020-05-12,Modoc,049,8938,0,0,0,0,0
2020-05-12,Mono,051,14174,35,31,0,31,1
2020-05-12,Monterey,053,433212,376,298,1,299,6
2020-05-12,Napa,055,140530,101,80,0,80,3
2020-05-12,Nevada,057,99092,41,41,1,42,1
2020-05-12,Orange,059,3164182,5743,3843,46,3889,78
2020-05-12,Placer,061,380077,188,170,0,170,8
2020-05-12,Plumas,063,18699,4,4,0,4,0
2020-05-12,Riverside,065,2383286,6229,5134,18,5152,210
2020-05-12,Sacramento,067,1510023,1236,1166,0,1166,52
2020-05-12,San Benito,069,59416,62,55,0,55,2
2020-05-12,San Bernardino,071,2135413,3791,2997,3,3000,131
2020-05-12,San Diego,073,3302833,6206,3,0,3,0
2020-05-12,San Francisco,075,870044,2205,1981,0,1981,35
2020-05-12,San Joaquin,077,732212,717,625,3,628,30
2020-05-12,San Luis Obispo,079,281455,313,226,3,229,1
2020-05-12,San Mateo,081,765935,1810,1533,3,1536,66
2020-05-12,Santa Barbara,083,443738,1506,1377,9,1386,10
2020-05-12,Santa Clara,085,1922200,2949,2362,9,2371,131
2020-05-12,Santa Cruz,087,273765,162,141,0,141,2
2020-05-12,Shasta,089,179085,47,33,0,33,4
2020-05-12,Sierra,091,2930,0,0,0,0,0
2020-05-12,Siskiyou,093,43540,6,5,0,5,0
2020-05-12,Solano,095,438530,444,361,0,361,4
2020-05-12,Sonoma,097,501317,386,308,0,308,4
2020-05-12,Stanislaus,099,539301,594,515,4,519,15
2020-05-12,Sutter,101,95872,41,33,0,33,2
2020-05-12,Tehama,103,63373,3,1,0,1,1
2020-05-12,Trinity,105,12862,2,1,0,1,0
2020-05-12,Tulare,107,460477,1845,1261,7,1268,52
2020-05-12,Tuolumne,109,53932,2,2,0,2,0
2020-05-12,Ventura,111,848112,1064,718,5,723,20
2020-05-12,Yolo,113,214977,190,176,0,176,22
2020-05-12,Yuba,115,75493,24,19,0,19,1
2020-05-11,Alameda,001,1643700,2538,2103,3,2106,71
2020-05-11,Alpine,003,1148,1,1,0,1,0
2020-05-11,Amador,005,37829,9,8,0,8,0
2020-05-11,Butte,007,227075,37,19,1,20,0
2020-05-11,Calaveras,009,45235,10,13,0,13,0
2020-05-11,Colusa,011,21464,3,3,0,3,0
2020-05-11,Contra Costa,013,1133247,1194,1052,1,1053,32
2020-05-11,Del Norte,015,27424,8,3,0,3,0
2020-05-11,El Dorado,017,186661,75,55,0,55,0
2020-05-11,Fresno,019,978130,1835,937,25,962,8
2020-05-11,Glenn,021,27897,10,6,0,6,0
2020-05-11,Humboldt,023,135768,76,56,0,56,0
2020-05-11,Imperial,025,180216,1178,562,0,562,9
2020-05-11,Inyo,027,18085,19,20,0,20,1
2020-05-11,Kern,029,883053,1701,1331,3,1334,17
2020-05-11,Kings,031,150075,417,289,1,290,1
2020-05-11,Lake,033,64148,12,7,0,7,0
2020-05-11,Lassen,035,31185,4,0,2,2,0
2020-05-11,Los Angeles,037,10098052,40783,32279,20,32299,1553
2020-05-11,Madera,039,155013,129,68,1,69,2
2020-05-11,Marin,041,260295,288,271,1,272,14
2020-05-11,Mariposa,043,17540,15,15,0,15,0
2020-05-11,Mendocino,045,87422,13,10,0,10,0
2020-05-11,Merced,047,269075,261,158,0,158,3
2020-05-11,Modoc,049,8938,0,0,0,0,0
2020-05-11,Mono,051,14174,35,30,0,30,1
2020-05-11,Monterey,053,433212,373,286,1,287,6
2020-05-11,Napa,055,140530,95,79,0,79,2
2020-05-11,Nevada,057,99092,41,41,1,42,1
2020-05-11,Orange,059,3164182,5528,3699,39,3738,77
2020-05-11,Placer,061,380077,188,170,0,170,8
2020-05-11,Plumas,063,18699,4,4,0,4,0
2020-05-11,Riverside,065,2383286,6071,5082,17,5099,203
2020-05-11,Sacramento,067,1510023,1221,1160,0,1160,52
2020-05-11,San Benito,069,59416,60,52,0,52,2
2020-05-11,San Bernardino,071,2135413,3681,2945,3,2948,124
2020-05-11,San Diego,073,3302833,6053,5067,0,5067,175
2020-05-11,San Francisco,075,870044,2158,1974,0,1974,35
2020-05-11,San Joaquin,077,732212,707,620,3,623,30
2020-05-11,San Luis Obispo,079,281455,311,224,3,227,1
2020-05-11,San Mateo,081,765935,1784,1499,2,1501,66
2020-05-11,Santa Barbara,083,443738,1494,1372,8,1380,10
2020-05-11,Santa Clara,085,1922200,2932,2340,9,2349,129
2020-05-11,Santa Cruz,087,273765,159,140,0,140,2
2020-05-11,Shasta,089,179085,47,31,0,31,4
2020-05-11,Sierra,091,2930,0,0,0,0,0
2020-05-11,Siskiyou,093,43540,6,5,0,5,0
2020-05-11,Solano,095,438530,439,354,0,354,4
2020-05-11,Sonoma,097,501317,376,303,0,303,3
2020-05-11,Stanislaus,099,539301,584,507,4,511,14
2020-05-11,Sutter,101,95872,40,32,0,32,2
2020-05-11,Tehama,103,63373,3,1,0,1,1
2020-05-11,Trinity,105,12862,2,1,0,1,0
2020-05-11,Tulare,107,460477,1796,1203,7,1210,49
2020-05-11,Tuolumne,109,53932,2,2,0,2,0
2020-05-11,Ventura,111,848112,1003,698,4,702,19
2020-05-11,Yolo,113,214977,190,174,0,174,20
2020-05-11,Yuba,115,75493,24,18,0,18,1
2020-05-10,Alameda,001,1643700,2461,2047,3,2050,71
2020-05-10,Alpine,003,1148,1,1,0,1,0
2020-05-10,Amador,005,37829,9,8,0,8,0
2020-05-10,Butte,007,227075,32,18,1,19,0
2020-05-10,Calaveras,009,45235,10,13,0,13,0
2020-05-10,Colusa,011,21464,3,3,0,3,0
2020-05-10,Contra Costa,013,1133247,1180,1046,0,1046,31
2020-05-10,Del Norte,015,27424,7,3,0,3,0
2020-05-10,El Dorado,017,186661,75,55,0,55,0
2020-05-10,Fresno,019,978130,1749,894,25,919,8
2020-05-10,Glenn,021,27897,10,6,0,6,0
2020-05-10,Humboldt,023,135768,72,56,0,56,0
2020-05-10,Imperial,025,180216,1082,509,0,509,7
2020-05-10,Inyo,027,18085,19,20,0,20,1
2020-05-10,Kern,029,883053,1650,1300,2,1302,16
2020-05-10,Kings,031,150075,404,266,1,267,1
2020-05-10,Lake,033,64148,12,7,0,7,0
2020-05-10,Lassen,035,31185,4,0,2,2,0
2020-05-10,Los Angeles,037,10098052,39524,31711,20,31731,1514
2020-05-10,Madera,039,155013,127,65,1,66,2
2020-05-10,Marin,041,260295,280,267,1,268,14
2020-05-10,Mariposa,043,17540,15,15,0,15,0
2020-05-10,Mendocino,045,87422,12,10,0,10,0
2020-05-10,Merced,047,269075,246,154,0,154,3
2020-05-10,Modoc,049,8938,0,0,0,0,0
2020-05-10,Mono,051,14174,35,27,0,27,1
2020-05-10,Monterey,053,433212,359,282,1,283,6
2020-05-10,Napa,055,140530,89,79,0,79,2
2020-05-10,Nevada,057,99092,41,41,1,42,1
2020-05-10,Orange,059,3164182,5385,3627,39,3666,76
2020-05-10,Placer,061,380077,187,168,0,168,8
2020-05-10,Plumas,063,18699,4,4,0,4,0
2020-05-10,Riverside,065,2383286,5949,4951,17,4968,193
2020-05-10,Sacramento,067,1510023,1205,1152,0,1152,52
2020-05-10,San Benito,069,59416,60,52,0,52,2
2020-05-10,San Bernardino,071,2135413,3583,2910,3,2913,121
2020-05-10,San Diego,073,3302833,5901,4928,0,4928,175
2020-05-10,San Francisco,075,870044,2140,1953,0,1953,35
2020-05-10,San Joaquin,077,732212,692,611,3,614,29
2020-05-10,San Luis Obispo,079,281455,308,218,3,221,1
2020-05-10,San Mateo,081,765935,1762,1463,2,1465,65
2020-05-10,Santa Barbara,083,443738,1483,1323,8,1331,10
2020-05-10,Santa Clara,085,1922200,2905,2331,9,2340,129
2020-05-10,Santa Cruz,087,273765,158,139,0,139,2
2020-05-10,Shasta,089,179085,47,31,0,31,4
2020-05-10,Sierra,091,2930,0,0,0,0,0
2020-05-10,Siskiyou,093,43540,5,5,0,5,0
2020-05-10,Solano,095,438530,429,322,0,322,4
2020-05-10,Sonoma,097,501317,366,290,0,290,3
2020-05-10,Stanislaus,099,539301,577,498,4,502,14
2020-05-10,Sutter,101,95872,37,31,0,31,2
2020-05-10,Tehama,103,63373,3,1,0,1,1
2020-05-10,Trinity,105,12862,2,1,0,1,0
2020-05-10,Tulare,107,460477,1726,1143,7,1150,47
2020-05-10,Tuolumne,109,53932,2,2,0,2,0
2020-05-10,Ventura,111,848112,945,690,2,692,19
2020-05-10,Yolo,113,214977,190,173,0,173,20
2020-05-10,Yuba,115,75493,23,17,0,17,1
2020-05-09,Alameda,001,1643700,2418,2011,3,2014,71
2020-05-09,Alpine,003,1148,1,1,0,1,0
2020-05-09,Amador,005,37829,8,8,0,8,0
2020-05-09,Butte,007,227075,31,18,1,19,0
2020-05-09,Calaveras,009,45235,10,13,0,13,0
2020-05-09,Colusa,011,21464,3,3,0,3,0
2020-05-09,Contra Costa,013,1133247,1166,1039,0,1039,31
2020-05-09,Del Norte,015,27424,7,3,0,3,0
2020-05-09,El Dorado,017,186661,72,54,0,54,0
2020-05-09,Fresno,019,978130,1711,861,24,885,8
2020-05-09,Glenn,021,27897,9,6,0,6,0
2020-05-09,Humboldt,023,135768,70,55,0,55,0
2020-05-09,Imperial,025,180216,1026,474,0,474,7
2020-05-09,Inyo,027,18085,19,20,0,20,1
2020-05-09,Kern,029,883053,1614,1262,1,1263,15
2020-05-09,Kings,031,150075,399,264,1,265,1
2020-05-09,Lake,033,64148,12,7,0,7,0
2020-05-09,Lassen,035,31185,4,0,2,2,0
2020-05-09,Los Angeles,037,10098052,38902,31268,20,31288,1499
2020-05-09,Madera,039,155013,126,61,1,62,2
2020-05-09,Marin,041,260295,279,261,1,262,14
2020-05-09,Mariposa,043,17540,15,15,0,15,0
2020-05-09,Mendocino,045,87422,12,10,0,10,0
2020-05-09,Merced,047,269075,242,153,0,153,3
2020-05-09,Modoc,049,8938,0,0,0,0,0
2020-05-09,Mono,051,14174,35,27,0,27,1
2020-05-09,Monterey,053,433212,352,273,1,274,6
2020-05-09,Napa,055,140530,88,78,0,78,2
2020-05-09,Nevada,057,99092,41,41,1,42,1
2020-05-09,Orange,059,3164182,5303,3506,38,3544,75
2020-05-09,Placer,061,380077,186,168,0,168,8
2020-05-09,Plumas,063,18699,4,4,0,4,0
2020-05-09,Riverside,065,2383286,5854,4871,17,4888,183
2020-05-09,Sacramento,067,1510023,1201,1150,0,1150,52
2020-05-09,San Benito,069,59416,59,52,0,52,2
2020-05-09,San Bernardino,071,2135413,3527,2825,3,2828,121
2020-05-09,San Diego,073,3302833,5789,4778,0,4778,175
2020-05-09,San Francisco,075,870044,2125,1944,0,1944,34
2020-05-09,San Joaquin,077,732212,683,605,3,608,28
2020-05-09,San Luis Obispo,079,281455,304,213,3,216,1
2020-05-09,San Mateo,081,765935,1743,1453,2,1455,65
2020-05-09,Santa Barbara,083,443738,1475,1245,8,1253,10
2020-05-09,Santa Clara,085,1922200,2891,2317,9,2326,128
2020-05-09,Santa Cruz,087,273765,157,138,0,138,2
2020-05-09,Shasta,089,179085,47,31,0,31,4
2020-05-09,Sierra,091,2930,0,0,0,0,0
2020-05-09,Siskiyou,093,43540,5,5,0,5,0
2020-05-09,Solano,095,438530,423,321,0,321,4
2020-05-09,Sonoma,097,501317,362,288,0,288,3
2020-05-09,Stanislaus,099,539301,569,491,4,495,12
2020-05-09,Sutter,101,95872,37,31,0,31,2
2020-05-09,Tehama,103,63373,2,1,0,1,1
2020-05-09,Trinity,105,12862,2,1,0,1,0
2020-05-09,Tulare,107,460477,1698,1083,7,1090,47
2020-05-09,Tuolumne,109,53932,2,2,0,2,0
2020-05-09,Ventura,111,848112,924,679,2,681,19
2020-05-09,Yolo,113,214977,190,172,0,172,18
2020-05-09,Yuba,115,75493,23,17,0,17,1
2020-05-08,Alameda,001,1643700,2375,1955,3,1958,70
2020-05-08,Alpine,003,1148,1,1,0,1,0
2020-05-08,Amador,005,37829,8,8,0,8,0
2020-05-08,Butte,007,227075,31,18,1,19,0
2020-05-08,Calaveras,009,45235,10,13,0,13,0
2020-05-08,Colusa,011,21464,3,3,0,3,0
2020-05-08,Contra Costa,013,1133247,1154,1024,0,1024,29
2020-05-08,Del Norte,015,27424,7,3,0,3,0
2020-05-08,El Dorado,017,186661,71,54,0,54,0
2020-05-08,Fresno,019,978130,1669,838,22,860,8
2020-05-08,Glenn,021,27897,8,6,0,6,0
2020-05-08,Humboldt,023,135768,67,54,0,54,0
2020-05-08,Imperial,025,180216,981,467,0,467,7
2020-05-08,Inyo,027,18085,19,20,0,20,1
2020-05-08,Kern,029,883053,1583,1214,1,1215,13
2020-05-08,Kings,031,150075,390,236,1,237,1
2020-05-08,Lake,033,64148,12,7,0,7,0
2020-05-08,Lassen,035,31185,4,0,2,2,0
2020-05-08,Los Angeles,037,10098052,38170,30357,20,30377,1447
2020-05-08,Madera,039,155013,123,57,1,58,2
2020-05-08,Marin,041,260295,279,257,1,258,14
2020-05-08,Mariposa,043,17540,15,15,0,15,0
2020-05-08,Mendocino,045,87422,12,10,0,10,0
2020-05-08,Merced,047,269075,241,151,0,151,3
2020-05-08,Modoc,049,8938,0,0,0,0,0
2020-05-08,Mono,051,14174,32,27,0,27,1
2020-05-08,Monterey,053,433212,344,265,1,266,6
2020-05-08,Napa,055,140530,87,78,0,78,2
2020-05-08,Nevada,057,99092,41,41,1,42,1
2020-05-08,Orange,059,3164182,5157,3395,38,3433,72
2020-05-08,Placer,061,380077,184,166,0,166,8
2020-05-08,Plumas,063,18699,4,4,0,4,0
2020-05-08,Riverside,065,2383286,5754,4672,16,4688,181
2020-05-08,Sacramento,067,1510023,1196,1145,0,1145,51
2020-05-08,San Benito,069,59416,59,51,0,51,2
2020-05-08,San Bernardino,071,2135413,3479,2631,3,2634,119
2020-05-08,San Diego,073,3302833,5682,4664,0,4664,169
2020-05-08,San Francisco,075,870044,2107,1890,0,1890,33
2020-05-08,San Joaquin,077,732212,676,595,3,598,28
2020-05-08,San Luis Obispo,079,281455,301,210,3,213,1
2020-05-08,San Mateo,081,765935,1658,1423,2,1425,62
2020-05-08,Santa Barbara,083,443738,1466,1054,6,1060,8
2020-05-08,Santa Clara,085,1922200,2868,2285,9,2294,128
2020-05-08,Santa Cruz,087,273765,153,137,0,137,2
2020-05-08,Shasta,089,179085,47,31,0,31,4
2020-05-08,Sierra,091,2930,0,0,0,0,0
2020-05-08,Siskiyou,093,43540,5,5,0,5,0
2020-05-08,Solano,095,438530,418,314,0,314,4
2020-05-08,Sonoma,097,501317,357,285,0,285,3
2020-05-08,Stanislaus,099,539301,555,487,4,491,12
2020-05-08,Sutter,101,95872,37,30,0,30,2
2020-05-08,Tehama,103,63373,2,1,0,1,1
2020-05-08,Trinity,105,12862,2,0,0,0,0
2020-05-08,Tulare,107,460477,1653,1050,6,1056,43
2020-05-08,Tuolumne,109,53932,2,2,0,2,0
2020-05-08,Ventura,111,848112,906,665,2,667,19
2020-05-08,Yolo,113,214977,189,172,0,172,18
2020-05-08,Yuba,115,75493,22,16,0,16,1
2020-05-07,Alameda,001,1643700,2315,1914,3,1917,68
2020-05-07,Alpine,003,1148,1,1,0,1,0
2020-05-07,Amador,005,37829,8,8,0,8,0
2020-05-07,Butte,007,227075,31,19,1,20,0
2020-05-07,Calaveras,009,45235,10,13,0,13,0
2020-05-07,Colusa,011,21464,3,3,0,3,0
2020-05-07,Contra Costa,013,1133247,1140,1005,0,1005,29
2020-05-07,Del Norte,015,27424,6,3,0,3,0
2020-05-07,El Dorado,017,186661,70,54,0,54,0
2020-05-07,Fresno,019,978130,1583,812,21,833,8
2020-05-07,Glenn,021,27897,8,5,0,5,0
2020-05-07,Humboldt,023,135768,66,54,0,54,0
2020-05-07,Imperial,025,180216,918,442,0,442,6
2020-05-07,Inyo,027,18085,19,20,0,20,1
2020-05-07,Kern,029,883053,1539,1176,1,1177,13
2020-05-07,Kings,031,150075,367,219,1,220,1
2020-05-07,Lake,033,64148,11,7,0,7,0
2020-05-07,Lassen,035,31185,4,0,2,2,0
2020-05-07,Los Angeles,037,10098052,37049,29544,20,29564,1399
2020-05-07,Madera,039,155013,119,54,1,55,2
2020-05-07,Marin,041,260295,272,252,1,253,14
2020-05-07,Mariposa,043,17540,15,15,0,15,0
2020-05-07,Mendocino,045,87422,12,10,0,10,0
2020-05-07,Merced,047,269075,233,146,0,146,3
2020-05-07,Modoc,049,8938,0,0,0,0,0
2020-05-07,Mono,051,14174,32,26,0,26,1
2020-05-07,Monterey,053,433212,336,249,1,250,6
2020-05-07,Napa,055,140530,87,78,0,78,2
2020-05-07,Nevada,057,99092,41,41,1,42,1
2020-05-07,Orange,059,3164182,4972,3283,37,3320,69
2020-05-07,Placer,061,380077,184,165,0,165,8
2020-05-07,Plumas,063,18699,4,4,0,4,0
2020-05-07,Riverside,065,2383286,5638,4608,16,4624,170
2020-05-07,Sacramento,067,1510023,1190,1139,0,1139,50
2020-05-07,San Benito,069,59416,59,50,0,50,2
2020-05-07,San Bernardino,071,2135413,3387,2522,3,2525,115
2020-05-07,San Diego,073,3302833,5525,4431,0,4431,165
2020-05-07,San Francisco,075,870044,2076,1852,0,1852,33
2020-05-07,San Joaquin,077,732212,663,583,3,586,28
2020-05-07,San Luis Obispo,079,281455,290,209,3,212,1
2020-05-07,San Mateo,081,765935,1636,1398,2,1400,58
2020-05-07,Santa Barbara,083,443738,1438,720,5,725,8
2020-05-07,Santa Clara,085,1922200,2830,2281,9,2290,127
2020-05-07,Santa Cruz,087,273765,150,136,0,136,2
2020-05-07,Shasta,089,179085,46,31,0,31,4
2020-05-07,Sierra,091,2930,0,0,0,0,0
2020-05-07,Siskiyou,093,43540,5,5,0,5,0
2020-05-07,Solano,095,438530,412,307,0,307,4
2020-05-07,Sonoma,097,501317,345,282,0,282,3
2020-05-07,Stanislaus,099,539301,546,466,4,470,10
2020-05-07,Sutter,101,95872,37,29,0,29,2
2020-05-07,Tehama,103,63373,2,1,0,1,1
2020-05-07,Trinity,105,12862,2,0,0,0,0
2020-05-07,Tulare,107,460477,1585,1001,6,1007,41
2020-05-07,Tuolumne,109,53932,2,2,0,2,0
2020-05-07,Ventura,111,848112,882,647,1,648,19
2020-05-07,Yolo,113,214977,188,172,0,172,18
2020-05-07,Yuba,115,75493,22,16,0,16,1
2020-05-06,Alameda,001,1643700,2277,1864,3,1867,67
2020-05-06,Alpine,003,1148,1,1,0,1,0
2020-05-06,Amador,005,37829,8,8,0,8,0
2020-05-06,Butte,007,227075,30,19,1,20,0
2020-05-06,Calaveras,009,45235,10,13,0,13,0
2020-05-06,Colusa,011,21464,3,3,0,3,0
2020-05-06,Contra Costa,013,1133247,1119,990,0,990,29
2020-05-06,Del Norte,015,27424,6,3,0,3,0
2020-05-06,El Dorado,017,186661,68,53,0,53,0
2020-05-06,Fresno,019,978130,1520,773,19,792,8
2020-05-06,Glenn,021,27897,8,3,0,3,0
2020-05-06,Humboldt,023,135768,65,54,0,54,0
2020-05-06,Imperial,025,180216,850,399,0,399,6
2020-05-06,Inyo,027,18085,19,20,0,20,1
2020-05-06,Kern,029,883053,1483,1112,1,1113,12
2020-05-06,Kings,031,150075,349,208,1,209,1
2020-05-06,Lake,033,64148,11,7,0,7,0
2020-05-06,Lassen,035,31185,4,0,2,2,0
2020-05-06,Los Angeles,037,10098052,36044,28687,20,28707,1347
2020-05-06,Madera,039,155013,117,55,1,56,2
2020-05-06,Marin,041,260295,265,244,1,245,14
2020-05-06,Mariposa,043,17540,15,14,0,14,0
2020-05-06,Mendocino,045,87422,12,10,0,10,0
2020-05-06,Merced,047,269075,226,140,0,140,3
2020-05-06,Modoc,049,8938,0,0,0,0,0
2020-05-06,Mono,051,14174,32,26,0,26,1
2020-05-06,Monterey,053,433212,328,246,1,247,6
2020-05-06,Napa,055,140530,86,78,0,78,2
2020-05-06,Nevada,057,99092,41,41,1,42,1
2020-05-06,Orange,059,3164182,4788,3156,36,3192,66
2020-05-06,Placer,061,380077,181,164,0,164,8
2020-05-06,Plumas,063,18699,4,4,0,4,0
2020-05-06,Riverside,065,2383286,5494,4535,16,4551,163
2020-05-06,Sacramento,067,1510023,1184,1135,0,1135,49
2020-05-06,San Benito,069,59416,58,50,0,50,2
2020-05-06,San Bernardino,071,2135413,3265,2426,2,2428,110
2020-05-06,San Diego,073,3302833,5392,4321,0,4321,158
2020-05-06,San Francisco,075,870044,2051,1804,0,1804,32
2020-05-06,San Joaquin,077,732212,650,581,3,584,28
2020-05-06,San Luis Obispo,079,281455,287,207,3,210,1
2020-05-06,San Mateo,081,765935,1605,1348,2,1350,57
2020-05-06,Santa Barbara,083,443738,1397,565,4,569,8
2020-05-06,Santa Clara,085,1922200,2813,2270,8,2278,127
2020-05-06,Santa Cruz,087,273765,146,135,0,135,2
2020-05-06,Shasta,089,179085,45,31,0,31,4
2020-05-06,Sierra,091,2930,0,0,0,0,0
2020-05-06,Siskiyou,093,43540,5,5,0,5,0
2020-05-06,Solano,095,438530,402,300,0,300,4
2020-05-06,Sonoma,097,501317,329,269,0,269,3
2020-05-06,Stanislaus,099,539301,530,434,4,438,9
2020-05-06,Sutter,101,95872,37,29,0,29,2
2020-05-06,Tehama,103,63373,2,1,0,1,1
2020-05-06,Trinity,105,12862,2,0,0,0,0
2020-05-06,Tulare,107,460477,1537,963,6,969,40
2020-05-06,Tuolumne,109,53932,2,2,0,2,0
2020-05-06,Ventura,111,848112,855,619,1,620,19
2020-05-06,Yolo,113,214977,187,172,0,172,18
2020-05-06,Yuba,115,75493,22,15,0,15,1
2020-05-05,Alameda,001,1643700,2234,1819,3,1822,67
2020-05-05,Alpine,003,1148,1,1,0,1,0
2020-05-05,Amador,005,37829,8,8,0,8,0
2020-05-05,Butte,007,227075,29,19,1,20,0
2020-05-05,Calaveras,009,45235,10,13,0,13,0
2020-05-05,Colusa,011,21464,3,3,0,3,0
2020-05-05,Contra Costa,013,1133247,1101,976,0,976,29
2020-05-05,Del Norte,015,27424,6,3,0,3,0
2020-05-05,El Dorado,017,186661,66,54,0,54,0
2020-05-05,Fresno,019,978130,1447,726,17,743,8
2020-05-05,Glenn,021,27897,8,3,0,3,0
2020-05-05,Humboldt,023,135768,62,54,0,54,0
2020-05-05,Imperial,025,180216,795,389,0,389,6
2020-05-05,Inyo,027,18085,19,20,0,20,1
2020-05-05,Kern,029,883053,1431,1084,1,1085,11
2020-05-05,Kings,031,150075,331,187,1,188,1
2020-05-05,Lake,033,64148,10,7,0,7,0
2020-05-05,Lassen,035,31185,4,0,2,2,0
2020-05-05,Los Angeles,037,10098052,34973,27867,20,27887,1289
2020-05-05,Madera,039,155013,113,53,1,54,2
2020-05-05,Marin,041,260295,259,244,1,245,14
2020-05-05,Mariposa,043,17540,15,14,0,14,0
2020-05-05,Mendocino,045,87422,12,10,0,10,0
2020-05-05,Merced,047,269075,221,141,0,141,3
2020-05-05,Modoc,049,8938,0,0,0,0,0
2020-05-05,Mono,051,14174,32,25,0,25,1
2020-05-05,Monterey,053,433212,314,240,1,241,6
2020-05-05,Napa,055,140530,86,74,0,74,2
2020-05-05,Nevada,057,99092,41,41,1,42,1
2020-05-05,Orange,059,3164182,4664,3041,36,3077,63
2020-05-05,Placer,061,380077,181,162,0,162,8
2020-05-05,Plumas,063,18699,4,4,0,4,0
2020-05-05,Riverside,065,2383286,5384,4309,16,4325,161
2020-05-05,Sacramento,067,1510023,1177,1125,0,1125,48
2020-05-05,San Benito,069,59416,57,50,0,50,2
2020-05-05,San Bernardino,071,2135413,3172,2345,2,2347,104
2020-05-05,San Diego,073,3302833,5249,4162,0,4162,150
2020-05-05,San Francisco,075,870044,2016,1779,0,1779,31
2020-05-05,San Joaquin,077,732212,641,577,3,580,26
2020-05-05,San Luis Obispo,079,281455,285,203,3,206,1
2020-05-05,San Mateo,081,765935,1573,1335,2,1337,56
2020-05-05,Santa Barbara,083,443738,1176,541,4,545,7
2020-05-05,Santa Clara,085,1922200,2767,2249,7,2256,124
2020-05-05,Santa Cruz,087,273765,143,134,0,134,2
2020-05-05,Shasta,089,179085,44,31,0,31,4
2020-05-05,Sierra,091,2930,0,0,0,0,0
2020-05-05,Siskiyou,093,43540,5,5,0,5,0
2020-05-05,Solano,095,438530,386,299,0,299,4
2020-05-05,Sonoma,097,501317,326,263,0,263,3
2020-05-05,Stanislaus,099,539301,518,430,4,434,9
2020-05-05,Sutter,101,95872,36,29,0,29,2
2020-05-05,Tehama,103,63373,2,1,0,1,1
2020-05-05,Trinity,105,12862,2,0,0,0,0
2020-05-05,Tulare,107,460477,1439,869,6,875,40
2020-05-05,Tuolumne,109,53932,2,2,0,2,0
2020-05-05,Ventura,111,848112,831,607,1,608,19
2020-05-05,Yolo,113,214977,185,171,0,171,18
2020-05-05,Yuba,115,75493,22,15,0,15,1
2020-05-04,Alameda,001,1643700,2175,1762,3,1765,65
2020-05-04,Alpine,003,1148,1,1,0,1,0
2020-05-04,Amador,005,37829,7,8,0,8,0
2020-05-04,Butte,007,227075,28,16,1,17,0
2020-05-04,Calaveras,009,45235,10,13,0,13,0
2020-05-04,Colusa,011,21464,3,3,0,3,0
2020-05-04,Contra Costa,013,1133247,1083,949,0,949,28
2020-05-04,Del Norte,015,27424,5,3,0,3,0
2020-05-04,El Dorado,017,186661,65,51,0,51,0
2020-05-04,Fresno,019,978130,1377,680,16,696,8
2020-05-04,Glenn,021,27897,8,4,0,4,0
2020-05-04,Humboldt,023,135768,60,54,0,54,0
2020-05-04,Imperial,025,180216,743,351,0,351,6
2020-05-04,Inyo,027,18085,19,20,0,20,1
2020-05-04,Kern,029,883053,1389,1047,1,1048,8
2020-05-04,Kings,031,150075,314,153,1,154,1
2020-05-04,Lake,033,64148,9,7,0,7,0
2020-05-04,Lassen,035,31185,3,0,2,2,0
2020-05-04,Los Angeles,037,10098052,33675,26243,18,26261,1235
2020-05-04,Madera,039,155013,110,52,1,53,2
2020-05-04,Marin,041,260295,254,244,1,245,13
2020-05-04,Mariposa,043,17540,15,13,0,13,0
2020-05-04,Mendocino,045,87422,12,10,0,10,0
2020-05-04,Merced,047,269075,221,138,0,138,3
2020-05-04,Modoc,049,8938,0,0,0,0,0
2020-05-04,Mono,051,14174,32,25,0,25,1
2020-05-04,Monterey,053,433212,303,237,1,238,6
2020-05-04,Napa,055,140530,86,72,0,72,2
2020-05-04,Nevada,057,99092,41,41,1,42,1
2020-05-04,Orange,059,3164182,4526,2931,33,2964,57
2020-05-04,Placer,061,380077,179,162,0,162,8
2020-05-04,Plumas,063,18699,4,4,0,4,0
2020-05-04,Riverside,065,2383286,5290,4221,16,4237,147
2020-05-04,Sacramento,067,1510023,1167,1119,0,1119,44
2020-05-04,San Benito,069,59416,55,49,0,49,2
2020-05-04,San Bernardino,071,2135413,3031,2184,2,2186,99
2020-05-04,San Diego,073,3302833,5108,4022,0,4022,144
2020-05-04,San Francisco,075,870044,1978,1760,0,1760,31
2020-05-04,San Joaquin,077,732212,627,574,3,577,26
2020-05-04,San Luis Obispo,079,281455,282,202,3,205,1
2020-05-04,San Mateo,081,765935,1548,1313,2,1315,53
2020-05-04,Santa Barbara,083,443738,928,524,4,528,7
2020-05-04,Santa Clara,085,1922200,2752,2238,7,2245,119
2020-05-04,Santa Cruz,087,273765,142,133,0,133,2
2020-05-04,Shasta,089,179085,42,31,0,31,4
2020-05-04,Sierra,091,2930,0,0,0,0,0
2020-05-04,Siskiyou,093,43540,5,5,0,5,0
2020-05-04,Solano,095,438530,372,293,0,293,4
2020-05-04,Sonoma,097,501317,312,256,0,256,4
2020-05-04,Stanislaus,099,539301,512,422,4,426,8
2020-05-04,Sutter,101,95872,33,28,0,28,2
2020-05-04,Tehama,103,63373,2,1,0,1,1
2020-05-04,Trinity,105,12862,1,0,0,0,0
2020-05-04,Tulare,107,460477,1360,760,6,766,40
2020-05-04,Tuolumne,109,53932,2,3,0,3,0
2020-05-04,Ventura,111,848112,810,590,1,591,19
2020-05-04,Yolo,113,214977,184,171,0,171,18
2020-05-04,Yuba,115,75493,19,16,0,16,1
2020-05-03,Alameda,001,1643700,2118,1731,3,1734,64
2020-05-03,Alpine,003,1148,1,1,0,1,0
2020-05-03,Amador,005,37829,7,8,0,8,0
2020-05-03,Butte,007,227075,28,17,1,18,0
2020-05-03,Calaveras,009,45235,10,13,0,13,0
2020-05-03,Colusa,011,21464,3,3,0,3,0
2020-05-03,Contra Costa,013,1133247,1067,945,0,945,28
2020-05-03,Del Norte,015,27424,5,3,0,3,0
2020-05-03,El Dorado,017,186661,63,49,0,49,0
2020-05-03,Fresno,019,978130,1285,646,14,660,8
2020-05-03,Glenn,021,27897,7,5,0,5,0
2020-05-03,Humboldt,023,135768,59,54,0,54,0
2020-05-03,Imperial,025,180216,687,351,0,351,6
2020-05-03,Inyo,027,18085,19,20,0,20,1
2020-05-03,Kern,029,883053,1334,1025,1,1026,8
2020-05-03,Kings,031,150075,294,137,1,138,1
2020-05-03,Lake,033,64148,9,7,0,7,0
2020-05-03,Lassen,035,31185,3,0,2,2,0
2020-05-03,Los Angeles,037,10098052,32691,25708,18,25726,1210
2020-05-03,Madera,039,155013,103,46,1,47,2
2020-05-03,Marin,041,260295,249,243,1,244,13
2020-05-03,Mariposa,043,17540,15,13,0,13,0
2020-05-03,Mendocino,045,87422,12,10,0,10,0
2020-05-03,Merced,047,269075,213,134,0,134,3
2020-05-03,Modoc,049,8938,0,0,0,0,0
2020-05-03,Mono,051,14174,32,25,0,25,1
2020-05-03,Monterey,053,433212,294,235,1,236,6
2020-05-03,Napa,055,140530,86,72,0,72,2
2020-05-03,Nevada,057,99092,41,41,1,42,1
2020-05-03,Orange,059,3164182,4352,2859,32,2891,55
2020-05-03,Placer,061,380077,179,161,0,161,8
2020-05-03,Plumas,063,18699,4,4,0,4,0
2020-05-03,Riverside,065,2383286,5185,4034,16,4050,139
2020-05-03,Sacramento,067,1510023,1158,1109,0,1109,43
2020-05-03,San Benito,069,59416,55,49,0,49,2
2020-05-03,San Bernardino,071,2135413,2970,2123,2,2125,99
2020-05-03,San Diego,073,3302833,4970,3929,0,3929,142
2020-05-03,San Francisco,075,870044,1949,1692,0,1692,30
2020-05-03,San Joaquin,077,732212,620,570,3,573,26
2020-05-03,San Luis Obispo,079,281455,279,200,3,203,1
2020-05-03,San Mateo,081,765935,1520,1277,2,1279,53
2020-05-03,Santa Barbara,083,443738,569,512,4,516,7
2020-05-03,Santa Clara,085,1922200,2715,2235,7,2242,116
2020-05-03,Santa Cruz,087,273765,142,133,0,133,2
2020-05-03,Shasta,089,179085,40,31,0,31,4
2020-05-03,Sierra,091,2930,0,0,0,0,0
2020-05-03,Siskiyou,093,43540,5,5,0,5,0
2020-05-03,Solano,095,438530,362,266,0,266,4
2020-05-03,Sonoma,097,501317,303,254,0,254,4
2020-05-03,Stanislaus,099,539301,484,411,4,415,8
2020-05-03,Sutter,101,95872,31,28,0,28,2
2020-05-03,Tehama,103,63373,2,1,0,1,1
2020-05-03,Trinity,105,12862,1,0,0,0,0
2020-05-03,Tulare,107,460477,1281,736,6,742,40
2020-05-03,Tuolumne,109,53932,2,3,0,3,0
2020-05-03,Ventura,111,848112,776,583,1,584,19
2020-05-03,Yolo,113,214977,183,171,0,171,18
2020-05-03,Yuba,115,75493,19,16,0,16,1
2020-05-02,Alameda,001,1643700,2081,1678,3,1681,63
2020-05-02,Alpine,003,1148,1,1,0,1,0
2020-05-02,Amador,005,37829,7,8,0,8,0
2020-05-02,Butte,007,227075,28,17,1,18,0
2020-05-02,Calaveras,009,45235,10,13,0,13,0
2020-05-02,Colusa,011,21464,3,3,0,3,0
2020-05-02,Contra Costa,013,1133247,1049,929,0,929,28
2020-05-02,Del Norte,015,27424,5,3,0,3,0
2020-05-02,El Dorado,017,186661,63,47,0,47,0
2020-05-02,Fresno,019,978130,1259,629,13,642,8
2020-05-02,Glenn,021,27897,7,5,0,5,0
2020-05-02,Humboldt,023,135768,59,54,0,54,0
2020-05-02,Imperial,025,180216,660,345,0,345,6
2020-05-02,Inyo,027,18085,19,20,0,20,1
2020-05-02,Kern,029,883053,1308,1007,1,1008,8
2020-05-02,Kings,031,150075,291,120,1,121,1
2020-05-02,Lake,033,64148,9,7,0,7,0
2020-05-02,Lassen,035,31185,3,0,2,2,0
2020-05-02,Los Angeles,037,10098052,32162,24955,18,24973,1192
2020-05-02,Madera,039,155013,103,46,1,47,2
2020-05-02,Marin,041,260295,248,243,1,244,13
2020-05-02,Mariposa,043,17540,15,13,0,13,0
2020-05-02,Mendocino,045,87422,12,10,0,10,0
2020-05-02,Merced,047,269075,210,131,0,131,3
2020-05-02,Modoc,049,8938,0,0,0,0,0
2020-05-02,Mono,051,14174,32,25,0,25,1
2020-05-02,Monterey,053,433212,288,225,1,226,5
2020-05-02,Napa,055,140530,86,71,0,71,2
2020-05-02,Nevada,057,99092,41,41,1,42,1
2020-05-02,Orange,059,3164182,4238,2774,32,2806,52
2020-05-02,Placer,061,380077,177,150,0,150,8
2020-05-02,Plumas,063,18699,4,4,0,4,0
2020-05-02,Riverside,065,2383286,5119,3997,16,4013,137
2020-05-02,Sacramento,067,1510023,1155,1097,0,1097,43
2020-05-02,San Benito,069,59416,55,49,0,49,2
2020-05-02,San Bernardino,071,2135413,2931,2124,2,2126,99
2020-05-02,San Diego,073,3302833,4868,3844,0,3844,138
2020-05-02,San Francisco,075,870044,1926,1632,0,1632,29
2020-05-02,San Joaquin,077,732212,612,559,3,562,25
2020-05-02,San Luis Obispo,079,281455,273,193,3,196,1
2020-05-02,San Mateo,081,765935,1504,1272,2,1274,52
2020-05-02,Santa Barbara,083,443738,561,506,4,510,7
2020-05-02,Santa Clara,085,1922200,2705,2203,7,2210,115
2020-05-02,Santa Cruz,087,273765,141,131,0,131,2
2020-05-02,Shasta,089,179085,40,31,0,31,4
2020-05-02,Sierra,091,2930,0,0,0,0,0
2020-05-02,Siskiyou,093,43540,5,5,0,5,0
2020-05-02,Solano,095,438530,355,267,0,267,4
2020-05-02,Sonoma,097,501317,300,250,0,250,3
2020-05-02,Stanislaus,099,539301,476,388,4,392,8
2020-05-02,Sutter,101,95872,31,28,0,28,2
2020-05-02,Tehama,103,63373,2,1,0,1,1
2020-05-02,Trinity,105,12862,1,0,0,0,0
2020-05-02,Tulare,107,460477,1238,711,6,717,35
2020-05-02,Tuolumne,109,53932,2,3,0,3,0
2020-05-02,Ventura,111,848112,762,564,1,565,19
2020-05-02,Yolo,113,214977,183,169,0,169,17
2020-05-02,Yuba,115,75493,19,16,0,16,1
2020-05-01,Alameda,001,1643700,2043,1630,3,1633,63
2020-05-01,Alpine,003,1148,1,1,0,1,0
2020-05-01,Amador,005,37829,7,8,0,8,0
2020-05-01,Butte,007,227075,28,17,1,18,0
2020-05-01,Calaveras,009,45235,10,13,0,13,0
2020-05-01,Colusa,011,21464,3,3,0,3,0
2020-05-01,Contra Costa,013,1133247,1035,915,0,915,28
2020-05-01,Del Norte,015,27424,5,3,0,3,0
2020-05-01,El Dorado,017,186661,63,47,0,47,0
2020-05-01,Fresno,019,978130,1228,617,13,630,7
2020-05-01,Glenn,021,27897,7,4,0,4,0
2020-05-01,Humboldt,023,135768,59,54,0,54,0
2020-05-01,Imperial,025,180216,623,337,0,337,6
2020-05-01,Inyo,027,18085,19,20,0,20,1
2020-05-01,Kern,029,883053,1281,972,1,973,8
2020-05-01,Kings,031,150075,274,112,1,113,1
2020-05-01,Lake,033,64148,9,6,0,6,0
2020-05-01,Lassen,035,31185,3,0,2,2,0
2020-05-01,Los Angeles,037,10098052,31406,24306,18,24324,1155
2020-05-01,Madera,039,155013,99,46,1,47,2
2020-05-01,Marin,041,260295,248,242,1,243,13
2020-05-01,Mariposa,043,17540,15,10,0,10,0
2020-05-01,Mendocino,045,87422,12,11,0,11,0
2020-05-01,Merced,047,269075,207,131,0,131,3
2020-05-01,Modoc,049,8938,0,0,0,0,0
2020-05-01,Mono,051,14174,32,25,0,25,1
2020-05-01,Monterey,053,433212,284,222,1,223,5
2020-05-01,Napa,055,140530,86,69,0,69,2
2020-05-01,Nevada,057,99092,41,41,1,42,1
2020-05-01,Orange,059,3164182,4161,2660,30,2690,51
2020-05-01,Placer,061,380077,176,149,0,149,8
2020-05-01,Plumas,063,18699,4,4,0,4,0
2020-05-01,Riverside,065,2383286,5055,3893,16,3909,132
2020-05-01,Sacramento,067,1510023,1150,1081,0,1081,43
2020-05-01,San Benito,069,59416,55,49,0,49,2
2020-05-01,San Bernardino,071,2135413,2876,2084,2,2086,98
2020-05-01,San Diego,073,3302833,4777,3713,0,3713,134
2020-05-01,San Francisco,075,870044,1882,1552,0,1552,29
2020-05-01,San Joaquin,077,732212,608,554,3,557,25
2020-05-01,San Luis Obispo,079,281455,270,186,3,189,1
2020-05-01,San Mateo,081,765935,1482,1222,2,1224,52
2020-05-01,Santa Barbara,083,443738,555,499,3,502,7
2020-05-01,Santa Clara,085,1922200,2693,2176,7,2183,112
2020-05-01,Santa Cruz,087,273765,141,127,0,127,2
2020-05-01,Shasta,089,179085,40,31,0,31,4
2020-05-01,Sierra,091,2930,0,0,0,0,0
2020-05-01,Siskiyou,093,43540,5,5,0,5,0
2020-05-01,Solano,095,438530,347,266,0,266,4
2020-05-01,Sonoma,097,501317,297,242,0,242,3
2020-05-01,Stanislaus,099,539301,471,384,4,388,8
2020-05-01,Sutter,101,95872,31,28,0,28,2
2020-05-01,Tehama,103,63373,2,1,0,1,1
2020-05-01,Trinity,105,12862,1,0,0,0,0
2020-05-01,Tulare,107,460477,1194,685,6,691,32
2020-05-01,Tuolumne,109,53932,2,3,0,3,0
2020-05-01,Ventura,111,848112,749,556,1,557,18
2020-05-01,Yolo,113,214977,183,165,0,165,18
2020-05-01,Yuba,115,75493,19,16,0,16,1
2020-04-30,Alameda,001,1643700,1983,1599,3,1602,60
2020-04-30,Alpine,003,1148,1,1,0,1,0
2020-04-30,Amador,005,37829,7,8,0,8,0
2020-04-30,Butte,007,227075,28,16,1,17,0
2020-04-30,Calaveras,009,45235,10,13,0,13,0
2020-04-30,Colusa,011,21464,3,3,0,3,0
2020-04-30,Contra Costa,013,1133247,1013,900,0,900,25
2020-04-30,Del Norte,015,27424,4,3,0,3,0
2020-04-30,El Dorado,017,186661,63,44,0,44,0
2020-04-30,Fresno,019,978130,1163,562,10,572,7
2020-04-30,Glenn,021,27897,7,4,0,4,0
2020-04-30,Humboldt,023,135768,59,54,0,54,0
2020-04-30,Imperial,025,180216,577,322,0,322,6
2020-04-30,Inyo,027,18085,19,20,0,20,1
2020-04-30,Kern,029,883053,1249,941,1,942,8
2020-04-30,Kings,031,150075,262,87,1,88,1
2020-04-30,Lake,033,64148,9,6,0,6,0
2020-04-30,Lassen,035,31185,3,0,2,2,0
2020-04-30,Los Angeles,037,10098052,30399,23284,18,23302,1099
2020-04-30,Madera,039,155013,88,46,1,47,2
2020-04-30,Marin,041,260295,248,240,1,241,13
2020-04-30,Mariposa,043,17540,15,3,0,3,0
2020-04-30,Mendocino,045,87422,12,11,0,11,0
2020-04-30,Merced,047,269075,200,122,0,122,3
2020-04-30,Modoc,049,8938,0,0,0,0,0
2020-04-30,Mono,051,14174,31,25,0,25,1
2020-04-30,Monterey,053,433212,274,213,1,214,5
2020-04-30,Napa,055,140530,84,69,0,69,2
2020-04-30,Nevada,057,99092,41,41,1,42,1
2020-04-30,Orange,059,3164182,3938,2591,27,2618,46
2020-04-30,Placer,061,380077,175,148,0,148,8
2020-04-30,Plumas,063,18699,4,4,0,4,0
2020-04-30,Riverside,065,2383286,4955,3820,15,3835,124
2020-04-30,Sacramento,067,1510023,1144,1071,0,1071,43
2020-04-30,San Benito,069,59416,55,48,0,48,2
2020-04-30,San Bernardino,071,2135413,2674,2020,2,2022,96
2020-04-30,San Diego,073,3302833,4606,3566,0,3566,124
2020-04-30,San Francisco,075,870044,1848,1518,0,1518,26
2020-04-30,San Joaquin,077,732212,600,548,3,551,25
2020-04-30,San Luis Obispo,079,281455,267,182,3,185,1
2020-04-30,San Mateo,081,765935,1452,1194,2,1196,52
2020-04-30,Santa Barbara,083,443738,543,490,3,493,7
2020-04-30,Santa Clara,085,1922200,2653,2172,7,2179,111
2020-04-30,Santa Cruz,087,273765,140,126,0,126,2
2020-04-30,Shasta,089,179085,39,31,0,31,4
2020-04-30,Sierra,091,2930,0,0,0,0,0
2020-04-30,Siskiyou,093,43540,5,5,0,5,0
2020-04-30,Solano,095,438530,337,262,0,262,4
2020-04-30,Sonoma,097,501317,288,233,0,233,3
2020-04-30,Stanislaus,099,539301,464,378,4,382,7
2020-04-30,Sutter,101,95872,31,28,0,28,2
2020-04-30,Tehama,103,63373,1,1,0,1,1
2020-04-30,Trinity,105,12862,1,0,0,0,0
2020-04-30,Tulare,107,460477,1128,637,6,643,31
2020-04-30,Tuolumne,109,53932,2,3,0,3,0
2020-04-30,Ventura,111,848112,721,547,1,548,18
2020-04-30,Yolo,113,214977,182,164,0,164,16
2020-04-30,Yuba,115,75493,19,15,0,15,1
2020-04-29,Alameda,001,1643700,1925,1564,2,1566,60
2020-04-29,Alpine,003,1148,1,1,0,1,0
2020-04-29,Amador,005,37829,7,8,0,8,0
2020-04-29,Butte,007,227075,28,16,1,17,0
2020-04-29,Calaveras,009,45235,10,13,0,13,0
2020-04-29,Colusa,011,21464,3,3,0,3,0
2020-04-29,Contra Costa,013,1133247,994,885,0,885,25
2020-04-29,Del Norte,015,27424,4,3,0,3,0
2020-04-29,El Dorado,017,186661,61,44,0,44,0
2020-04-29,Fresno,019,978130,1111,544,10,554,7
2020-04-29,Glenn,021,27897,7,4,0,4,0
2020-04-29,Humboldt,023,135768,59,53,0,53,0
2020-04-29,Imperial,025,180216,547,300,0,300,6
2020-04-29,Inyo,027,18085,19,20,0,20,1
2020-04-29,Kern,029,883053,1206,910,1,911,6
2020-04-29,Kings,031,150075,243,80,1,81,1
2020-04-29,Lake,033,64148,9,6,0,6,0
2020-04-29,Lassen,035,31185,3,0,2,2,0
2020-04-29,Los Angeles,037,10098052,29422,22560,18,22578,1043
2020-04-29,Madera,039,155013,86,45,1,46,2
2020-04-29,Marin,041,260295,245,234,1,235,13
2020-04-29,Mariposa,043,17540,15,1,0,1,0
2020-04-29,Mendocino,045,87422,12,11,0,11,0
2020-04-29,Merced,047,269075,193,116,0,116,3
2020-04-29,Modoc,049,8938,0,0,0,0,0
2020-04-29,Mono,051,14174,31,25,0,25,1
2020-04-29,Monterey,053,433212,266,204,1,205,5
2020-04-29,Napa,055,140530,82,68,0,68,2
2020-04-29,Nevada,057,99092,41,41,1,42,1
2020-04-29,Orange,059,3164182,3802,2421,26,2447,43
2020-04-29,Placer,061,380077,173,145,0,145,8
2020-04-29,Plumas,063,18699,4,4,0,4,0
2020-04-29,Riverside,065,2383286,4879,3700,15,3715,116
2020-04-29,Sacramento,067,1510023,1122,1055,0,1055,41
2020-04-29,San Benito,069,59416,55,48,0,48,2
2020-04-29,San Bernardino,071,2135413,2587,1975,1,1976,91
2020-04-29,San Diego,073,3302833,4464,3434,0,3434,120
2020-04-29,San Francisco,075,870044,1820,1489,0,1489,23
2020-04-29,San Joaquin,077,732212,592,540,3,543,25
2020-04-29,San Luis Obispo,079,281455,265,181,3,184,1
2020-04-29,San Mateo,081,765935,1426,1170,2,1172,50
2020-04-29,Santa Barbara,083,443738,530,477,3,480,7
2020-04-29,Santa Clara,085,1922200,2626,2147,7,2154,108
2020-04-29,Santa Cruz,087,273765,139,124,0,124,2
2020-04-29,Shasta,089,179085,38,31,0,31,4
2020-04-29,Sierra,091,2930,0,0,0,0,0
2020-04-29,Siskiyou,093,43540,5,5,0,5,0
2020-04-29,Solano,095,438530,313,252,0,252,3
2020-04-29,Sonoma,097,501317,280,230,0,230,2
2020-04-29,Stanislaus,099,539301,451,374,4,378,5
2020-04-29,Sutter,101,95872,31,28,0,28,2
2020-04-29,Tehama,103,63373,1,1,0,1,1
2020-04-29,Trinity,105,12862,1,0,0,0,0
2020-04-29,Tulare,107,460477,1055,615,5,620,30
2020-04-29,Tuolumne,109,53932,2,4,0,4,0
2020-04-29,Ventura,111,848112,697,530,1,531,18
2020-04-29,Yolo,113,214977,179,161,0,161,11
2020-04-29,Yuba,115,75493,19,15,0,15,1
2020-04-28,Alameda,001,1643700,1868,1525,2,1527,55
2020-04-28,Alpine,003,1148,1,1,0,1,0
2020-04-28,Amador,005,37829,7,8,0,8,0
2020-04-28,Butte,007,227075,28,16,1,17,0
2020-04-28,Calaveras,009,45235,10,13,0,13,0
2020-04-28,Colusa,011,21464,3,3,0,3,0
2020-04-28,Contra Costa,013,1133247,987,866,0,866,25
2020-04-28,Del Norte,015,27424,4,3,0,3,0
2020-04-28,El Dorado,017,186661,60,43,0,43,0
2020-04-28,Fresno,019,978130,1060,525,8,533,7
2020-04-28,Glenn,021,27897,5,4,0,4,0
2020-04-28,Humboldt,023,135768,58,53,0,53,0
2020-04-28,Imperial,025,180216,513,295,0,295,6
2020-04-28,Inyo,027,18085,19,20,0,20,1
2020-04-28,Kern,029,883053,1163,882,1,883,5
2020-04-28,Kings,031,150075,230,57,1,58,1
2020-04-28,Lake,033,64148,9,6,0,6,0
2020-04-28,Lassen,035,31185,3,0,2,2,0
2020-04-28,Los Angeles,037,10098052,28356,21029,18,21047,984
2020-04-28,Madera,039,155013,86,44,1,45,2
2020-04-28,Marin,041,260295,244,228,1,229,12
2020-04-28,Mariposa,043,17540,15,0,0,0,0
2020-04-28,Mendocino,045,87422,12,10,0,10,0
2020-04-28,Merced,047,269075,186,108,0,108,3
2020-04-28,Modoc,049,8938,0,0,0,0,0
2020-04-28,Mono,051,14174,31,25,0,25,1
2020-04-28,Monterey,053,433212,260,191,1,192,5
2020-04-28,Napa,055,140530,81,67,0,67,2
2020-04-28,Nevada,057,99092,41,41,1,42,1
2020-04-28,Orange,059,3164182,3637,2324,25,2349,42
2020-04-28,Placer,061,380077,163,143,0,143,8
2020-04-28,Plumas,063,18699,4,4,0,4,0
2020-04-28,Riverside,065,2383286,4784,3504,15,3519,113
2020-04-28,Sacramento,067,1510023,1107,1044,0,1044,41
2020-04-28,San Benito,069,59416,53,46,0,46,2
2020-04-28,San Bernardino,071,2135413,2510,1891,1,1892,89
2020-04-28,San Diego,073,3302833,4334,3316,0,3316,118
2020-04-28,San Francisco,075,870044,1785,1471,0,1471,23
2020-04-28,San Joaquin,077,732212,586,532,3,535,25
2020-04-28,San Luis Obispo,079,281455,258,172,3,175,1
2020-04-28,San Mateo,081,765935,1413,1129,2,1131,48
2020-04-28,Santa Barbara,083,443738,525,469,2,471,7
2020-04-28,Santa Clara,085,1922200,2592,2130,7,2137,106
2020-04-28,Santa Cruz,087,273765,139,123,0,123,2
2020-04-28,Shasta,089,179085,38,29,0,29,4
2020-04-28,Sierra,091,2930,0,0,0,0,0
2020-04-28,Siskiyou,093,43540,5,5,0,5,0
2020-04-28,Solano,095,438530,294,246,0,246,3
2020-04-28,Sonoma,097,501317,277,226,0,226,1
2020-04-28,Stanislaus,099,539301,435,330,4,334,5
2020-04-28,Sutter,101,95872,31,25,0,25,2
2020-04-28,Tehama,103,63373,1,1,0,1,1
2020-04-28,Trinity,105,12862,1,0,0,0,0
2020-04-28,Tulare,107,460477,959,579,5,584,30
2020-04-28,Tuolumne,109,53932,2,4,0,4,0
2020-04-28,Ventura,111,848112,677,517,1,518,17
2020-04-28,Yolo,113,214977,179,160,0,160,10
2020-04-28,Yuba,115,75493,19,15,0,15,1
2020-04-27,Alameda,001,1643700,1808,1494,2,1496,53
2020-04-27,Alpine,003,1148,1,1,0,1,0
2020-04-27,Amador,005,37829,7,8,0,8,0
2020-04-27,Butte,007,227075,27,16,1,17,0
2020-04-27,Calaveras,009,45235,10,13,0,13,0
2020-04-27,Colusa,011,21464,3,3,0,3,0
2020-04-27,Contra Costa,013,1133247,975,843,0,843,25
2020-04-27,Del Norte,015,27424,4,3,0,3,0
2020-04-27,El Dorado,017,186661,59,43,0,43,0
2020-04-27,Fresno,019,978130,957,504,7,511,7
2020-04-27,Glenn,021,27897,5,4,0,4,0
2020-04-27,Humboldt,023,135768,58,52,0,52,0
2020-04-27,Imperial,025,180216,483,290,0,290,6
2020-04-27,Inyo,027,18085,19,20,0,20,1
2020-04-27,Kern,029,883053,1124,865,1,866,4
2020-04-27,Kings,031,150075,207,48,1,49,1
2020-04-27,Lake,033,64148,8,6,0,6,0
2020-04-27,Lassen,035,31185,3,0,2,2,0
2020-04-27,Los Angeles,037,10098052,27339,20456,18,20474,931
2020-04-27,Madera,039,155013,84,42,1,43,2
2020-04-27,Marin,041,260295,239,227,1,228,12
2020-04-27,Mariposa,043,17540,14,0,0,0,0
2020-04-27,Mendocino,045,87422,12,10,0,10,0
2020-04-27,Merced,047,269075,183,108,0,108,3
2020-04-27,Modoc,049,8938,0,0,0,0,0
2020-04-27,Mono,051,14174,31,23,0,23,1
2020-04-27,Monterey,053,433212,253,185,1,186,4
2020-04-27,Napa,055,140530,77,64,0,64,2
2020-04-27,Nevada,057,99092,41,39,1,40,1
2020-04-27,Orange,059,3164182,3468,2198,25,2223,42
2020-04-27,Placer,061,380077,163,142,0,142,8
2020-04-27,Plumas,063,18699,4,4,0,4,0
2020-04-27,Riverside,065,2383286,4661,3381,15,3396,100
2020-04-27,Sacramento,067,1510023,1092,1035,0,1035,41
2020-04-27,San Benito,069,59416,51,45,0,45,2
2020-04-27,San Bernardino,071,2135413,2396,1742,1,1743,82
2020-04-27,San Diego,073,3302833,4208,3143,0,3143,113
2020-04-27,San Francisco,075,870044,1731,1453,0,1453,23
2020-04-27,San Joaquin,077,732212,580,522,3,525,25
2020-04-27,San Luis Obispo,079,281455,250,166,3,169,1
2020-04-27,San Mateo,081,765935,1391,1092,2,1094,46
2020-04-27,Santa Barbara,083,443738,517,466,2,468,7
2020-04-27,Santa Clara,085,1922200,2567,2104,6,2110,105
2020-04-27,Santa Cruz,087,273765,139,123,0,123,2
2020-04-27,Shasta,089,179085,38,29,0,29,4
2020-04-27,Sierra,091,2930,0,0,0,0,0
2020-04-27,Siskiyou,093,43540,5,5,0,5,0
2020-04-27,Solano,095,438530,294,222,0,222,3
2020-04-27,Sonoma,097,501317,268,220,0,220,1
2020-04-27,Stanislaus,099,539301,419,316,4,320,5
2020-04-27,Sutter,101,95872,29,26,0,26,2
2020-04-27,Tehama,103,63373,1,1,0,1,1
2020-04-27,Trinity,105,12862,1,0,0,0,0
2020-04-27,Tulare,107,460477,888,535,5,540,28
2020-04-27,Tuolumne,109,53932,2,3,0,3,0
2020-04-27,Ventura,111,848112,658,513,1,514,17
2020-04-27,Yolo,113,214977,176,160,0,160,9
2020-04-27,Yuba,115,75493,19,15,0,15,1
2020-04-26,Alameda,001,1643700,1747,1449,2,1451,52
2020-04-26,Alpine,003,1148,1,1,0,1,0
2020-04-26,Amador,005,37829,7,8,0,8,0
2020-04-26,Butte,007,227075,27,16,1,17,0
2020-04-26,Calaveras,009,45235,10,13,0,13,0
2020-04-26,Colusa,011,21464,3,3,0,3,0
2020-04-26,Contra Costa,013,1133247,959,830,0,830,25
2020-04-26,Del Norte,015,27424,3,3,0,3,0
2020-04-26,El Dorado,017,186661,57,41,0,41,0
2020-04-26,Fresno,019,978130,863,476,7,483,7
2020-04-26,Glenn,021,27897,5,4,0,4,0
2020-04-26,Humboldt,023,135768,58,53,0,53,0
2020-04-26,Imperial,025,180216,449,272,0,272,6
2020-04-26,Inyo,027,18085,19,20,0,20,1
2020-04-26,Kern,029,883053,1074,831,1,832,4
2020-04-26,Kings,031,150075,182,33,1,34,1
2020-04-26,Lake,033,64148,8,6,0,6,0
2020-04-26,Lassen,035,31185,3,0,2,2,0
2020-04-26,Los Angeles,037,10098052,26188,19570,18,19588,901
2020-04-26,Madera,039,155013,82,39,1,40,2
2020-04-26,Marin,041,260295,233,225,1,226,12
2020-04-26,Mariposa,043,17540,14,0,0,0,0
2020-04-26,Mendocino,045,87422,12,5,0,5,0
2020-04-26,Merced,047,269075,166,104,0,104,3
2020-04-26,Modoc,049,8938,0,0,0,0,0
2020-04-26,Mono,051,14174,31,23,0,23,1
2020-04-26,Monterey,053,433212,246,182,1,183,4
2020-04-26,Napa,055,140530,76,62,0,62,2
2020-04-26,Nevada,057,99092,41,37,1,38,1
2020-04-26,Orange,059,3164182,3303,2124,25,2149,40
2020-04-26,Placer,061,380077,162,141,0,141,8
2020-04-26,Plumas,063,18699,4,4,0,4,0
2020-04-26,Riverside,065,2383286,4518,3301,15,3316,95
2020-04-26,Sacramento,067,1510023,1083,1027,0,1027,41
2020-04-26,San Benito,069,59416,51,45,0,45,2
2020-04-26,San Bernardino,071,2135413,2300,1681,1,1682,82
2020-04-26,San Diego,073,3302833,4066,3045,0,3045,111
2020-04-26,San Francisco,075,870044,1692,1403,0,1403,23
2020-04-26,San Joaquin,077,732212,572,514,3,517,25
2020-04-26,San Luis Obispo,079,281455,247,165,3,168,1
2020-04-26,San Mateo,081,765935,1365,1070,2,1072,46
2020-04-26,Santa Barbara,083,443738,510,464,2,466,7
2020-04-26,Santa Clara,085,1922200,2544,2097,5,2102,102
2020-04-26,Santa Cruz,087,273765,139,116,0,116,2
2020-04-26,Shasta,089,179085,35,29,0,29,4
2020-04-26,Sierra,091,2930,0,0,0,0,0
2020-04-26,Siskiyou,093,43540,5,5,0,5,0
2020-04-26,Solano,095,438530,285,205,0,205,3
2020-04-26,Sonoma,097,501317,257,216,0,216,1
2020-04-26,Stanislaus,099,539301,404,294,4,298,4
2020-04-26,Sutter,101,95872,29,26,0,26,2
2020-04-26,Tehama,103,63373,1,1,0,1,1
2020-04-26,Trinity,105,12862,1,0,0,0,0
2020-04-26,Tulare,107,460477,829,497,5,502,28
2020-04-26,Tuolumne,109,53932,2,3,0,3,0
2020-04-26,Ventura,111,848112,640,509,1,510,17
2020-04-26,Yolo,113,214977,175,158,0,158,8
2020-04-26,Yuba,115,75493,18,15,0,15,1
2020-04-25,Alameda,001,1643700,1722,1396,2,1398,52
2020-04-25,Alpine,003,1148,1,1,0,1,0
2020-04-25,Amador,005,37829,7,8,0,8,0
2020-04-25,Butte,007,227075,26,16,1,17,0
2020-04-25,Calaveras,009,45235,10,12,0,12,0
2020-04-25,Colusa,011,21464,3,3,0,3,0
2020-04-25,Contra Costa,013,1133247,945,821,0,821,24
2020-04-25,Del Norte,015,27424,2,2,0,2,0
2020-04-25,El Dorado,017,186661,56,41,0,41,0
2020-04-25,Fresno,019,978130,831,459,6,465,7
2020-04-25,Glenn,021,27897,5,4,0,4,0
2020-04-25,Humboldt,023,135768,58,53,0,53,0
2020-04-25,Imperial,025,180216,432,232,0,232,6
2020-04-25,Inyo,027,18085,19,20,0,20,1
2020-04-25,Kern,029,883053,1043,802,1,803,4
2020-04-25,Kings,031,150075,170,33,1,34,1
2020-04-25,Lake,033,64148,6,6,0,6,0
2020-04-25,Lassen,035,31185,3,0,2,2,0
2020-04-25,Los Angeles,037,10098052,25555,19144,18,19162,881
2020-04-25,Madera,039,155013,79,39,1,40,2
2020-04-25,Marin,041,260295,233,215,1,216,12
2020-04-25,Mariposa,043,17540,14,0,0,0,0
2020-04-25,Mendocino,045,87422,11,5,0,5,0
2020-04-25,Merced,047,269075,166,103,0,103,3
2020-04-25,Modoc,049,8938,0,0,0,0,0
2020-04-25,Mono,051,14174,31,23,0,23,1
2020-04-25,Monterey,053,433212,244,173,1,174,4
2020-04-25,Napa,055,140530,76,60,0,60,2
2020-04-25,Nevada,057,99092,41,37,1,38,1
2020-04-25,Orange,059,3164182,3194,2047,25,2072,40
2020-04-25,Placer,061,380077,162,137,0,137,8
2020-04-25,Plumas,063,18699,4,4,0,4,0
2020-04-25,Riverside,065,2383286,4428,3037,15,3052,93
2020-04-25,Sacramento,067,1510023,1081,1015,0,1015,41
2020-04-25,San Benito,069,59416,51,45,0,45,2
2020-04-25,San Bernardino,071,2135413,2255,1675,1,1676,82
2020-04-25,San Diego,073,3302833,3966,2945,0,2945,111
2020-04-25,San Francisco,075,870044,1667,1341,0,1341,22
2020-04-25,San Joaquin,077,732212,565,497,3,500,24
2020-04-25,San Luis Obispo,079,281455,246,159,3,162,1
2020-04-25,San Mateo,081,765935,1347,1054,2,1056,46
2020-04-25,Santa Barbara,083,443738,503,457,2,459,7
2020-04-25,Santa Clara,085,1922200,2522,2045,4,2049,99
2020-04-25,Santa Cruz,087,273765,139,112,0,112,2
2020-04-25,Shasta,089,179085,35,29,0,29,4
2020-04-25,Sierra,091,2930,0,0,0,0,0
2020-04-25,Siskiyou,093,43540,5,5,0,5,0
2020-04-25,Solano,095,438530,281,203,0,203,3
2020-04-25,Sonoma,097,501317,253,199,0,199,1
2020-04-25,Stanislaus,099,539301,396,276,4,280,4
2020-04-25,Sutter,101,95872,29,24,0,24,2
2020-04-25,Tehama,103,63373,1,1,0,1,1
2020-04-25,Trinity,105,12862,0,0,0,0,0
2020-04-25,Tulare,107,460477,796,478,5,483,28
2020-04-25,Tuolumne,109,53932,2,2,0,2,0
2020-04-25,Ventura,111,848112,626,494,1,495,16
2020-04-25,Yolo,113,214977,175,157,0,157,8
2020-04-25,Yuba,115,75493,17,15,0,15,1
2020-04-24,Alameda,001,1643700,1691,1385,2,1387,50
2020-04-24,Alpine,003,1148,1,1,0,1,0
2020-04-24,Amador,005,37829,7,8,0,8,0
2020-04-24,Butte,007,227075,25,15,1,16,0
2020-04-24,Calaveras,009,45235,10,12,0,12,0
2020-04-24,Colusa,011,21464,3,3,0,3,0
2020-04-24,Contra Costa,013,1133247,936,806,0,806,23
2020-04-24,Del Norte,015,27424,2,2,0,2,0
2020-04-24,El Dorado,017,186661,55,41,0,41,0
2020-04-24,Fresno,019,978130,808,449,6,455,7
2020-04-24,Glenn,021,27897,5,4,0,4,0
2020-04-24,Humboldt,023,135768,58,53,0,53,0
2020-04-24,Imperial,025,180216,416,232,0,232,6
2020-04-24,Inyo,027,18085,19,20,0,20,0
2020-04-24,Kern,029,883053,1019,770,1,771,4
2020-04-24,Kings,031,150075,141,30,1,31,1
2020-04-24,Lake,033,64148,6,6,0,6,0
2020-04-24,Lassen,035,31185,3,0,2,2,0
2020-04-24,Los Angeles,037,10098052,24624,18553,18,18571,836
2020-04-24,Madera,039,155013,79,39,1,40,2
2020-04-24,Marin,041,260295,233,211,1,212,11
2020-04-24,Mariposa,043,17540,8,0,0,0,0
2020-04-24,Mendocino,045,87422,11,5,0,5,0
2020-04-24,Merced,047,269075,163,102,0,102,3
2020-04-24,Modoc,049,8938,0,0,0,0,0
2020-04-24,Mono,051,14174,30,23,0,23,1
2020-04-24,Monterey,053,433212,237,167,1,168,4
2020-04-24,Napa,055,140530,75,59,0,59,2
2020-04-24,Nevada,057,99092,41,36,1,37,1
2020-04-24,Orange,059,3164182,3087,1945,25,1970,39
2020-04-24,Placer,061,380077,160,137,0,137,8
2020-04-24,Plumas,063,18699,4,4,0,4,0
2020-04-24,Riverside,065,2383286,4347,3044,15,3059,87
2020-04-24,Sacramento,067,1510023,1075,1009,0,1009,41
2020-04-24,San Benito,069,59416,51,45,0,45,2
2020-04-24,San Bernardino,071,2135413,2220,1667,1,1668,80
2020-04-24,San Diego,073,3302833,3855,2828,0,2828,102
2020-04-24,San Francisco,075,870044,1609,1345,0,1345,22
2020-04-24,San Joaquin,077,732212,558,484,3,487,24
2020-04-24,San Luis Obispo,079,281455,243,151,3,154,1
2020-04-24,San Mateo,081,765935,1324,1004,2,1006,43
2020-04-24,Santa Barbara,083,443738,497,450,2,452,6
2020-04-24,Santa Clara,085,1922200,2479,2026,4,2030,98
2020-04-24,Santa Cruz,087,273765,135,111,0,111,2
2020-04-24,Shasta,089,179085,35,28,0,28,4
2020-04-24,Sierra,091,2930,0,0,0,0,0
2020-04-24,Siskiyou,093,43540,5,5,0,5,0
2020-04-24,Solano,095,438530,279,203,0,203,3
2020-04-24,Sonoma,097,501317,249,199,0,199,1
2020-04-24,Stanislaus,099,539301,393,273,4,277,4
2020-04-24,Sutter,101,95872,28,24,0,24,2
2020-04-24,Tehama,103,63373,1,1,0,1,1
2020-04-24,Trinity,105,12862,0,0,0,0,0
2020-04-24,Tulare,107,460477,768,459,5,464,27
2020-04-24,Tuolumne,109,53932,2,2,0,2,0
2020-04-24,Ventura,111,848112,616,489,1,490,16
2020-04-24,Yolo,113,214977,174,155,0,155,8
2020-04-24,Yuba,115,75493,16,15,0,15,1
2020-04-23,Alameda,001,1643700,1653,1336,2,1338,46
2020-04-23,Alpine,003,1148,1,1,0,1,0
2020-04-23,Amador,005,37829,7,8,0,8,0
2020-04-23,Butte,007,227075,25,15,1,16,0
2020-04-23,Calaveras,009,45235,10,12,0,12,0
2020-04-23,Colusa,011,21464,3,3,0,3,0
2020-04-23,Contra Costa,013,1133247,915,786,0,786,23
2020-04-23,Del Norte,015,27424,2,2,0,2,0
2020-04-23,El Dorado,017,186661,54,39,0,39,0
2020-04-23,Fresno,019,978130,770,426,6,432,7
2020-04-23,Glenn,021,27897,5,3,0,3,0
2020-04-23,Humboldt,023,135768,58,53,0,53,0
2020-04-23,Imperial,025,180216,395,181,0,181,4
2020-04-23,Inyo,027,18085,19,19,0,19,0
2020-04-23,Kern,029,883053,971,732,1,733,4
2020-04-23,Kings,031,150075,126,28,1,29,1
2020-04-23,Lake,033,64148,6,6,0,6,0
2020-04-23,Lassen,035,31185,3,0,2,2,0
2020-04-23,Los Angeles,037,10098052,23564,17548,17,17565,784
2020-04-23,Madera,039,155013,77,37,1,38,2
2020-04-23,Marin,041,260295,220,209,1,210,11
2020-04-23,Mariposa,043,17540,7,0,0,0,0
2020-04-23,Mendocino,045,87422,9,5,0,5,0
2020-04-23,Merced,047,269075,159,98,0,98,3
2020-04-23,Modoc,049,8938,0,0,0,0,0
2020-04-23,Mono,051,14174,30,23,0,23,1
2020-04-23,Monterey,053,433212,233,161,1,162,4
2020-04-23,Napa,055,140530,68,59,0,59,2
2020-04-23,Nevada,057,99092,41,36,1,37,1
2020-04-23,Orange,059,3164182,2909,1841,24,1865,37
2020-04-23,Placer,061,380077,157,136,0,136,8
2020-04-23,Plumas,063,18699,4,4,0,4,0
2020-04-23,Riverside,065,2383286,4233,2935,14,2949,78
2020-04-23,Sacramento,067,1510023,1063,978,0,978,41
2020-04-23,San Benito,069,59416,48,43,0,43,2
2020-04-23,San Bernardino,071,2135413,2155,1604,1,1605,79
2020-04-23,San Diego,073,3302833,3694,2645,0,2645,100
2020-04-23,San Francisco,075,870044,1584,1312,0,1312,21
2020-04-23,San Joaquin,077,732212,548,479,3,482,20
2020-04-23,San Luis Obispo,079,281455,239,146,3,149,1
2020-04-23,San Mateo,081,765935,1285,970,2,972,42
2020-04-23,Santa Barbara,083,443738,491,445,2,447,6
2020-04-23,Santa Clara,085,1922200,2444,1996,4,2000,95
2020-04-23,Santa Cruz,087,273765,134,110,0,110,2
2020-04-23,Shasta,089,179085,35,27,0,27,3
2020-04-23,Sierra,091,2930,0,0,0,0,0
2020-04-23,Siskiyou,093,43540,5,5,0,5,0
2020-04-23,Solano,095,438530,265,196,0,196,3
2020-04-23,Sonoma,097,501317,237,187,0,187,1
2020-04-23,Stanislaus,099,539301,389,254,4,258,4
2020-04-23,Sutter,101,95872,28,24,0,24,2
2020-04-23,Tehama,103,63373,1,1,0,1,1
2020-04-23,Trinity,105,12862,0,0,0,0,0
2020-04-23,Tulare,107,460477,739,440,5,445,25
2020-04-23,Tuolumne,109,53932,2,2,0,2,0
2020-04-23,Ventura,111,848112,602,479,1,480,16
2020-04-23,Yolo,113,214977,171,151,0,151,8
2020-04-23,Yuba,115,75493,16,15,0,15,1
2020-04-22,Alameda,001,1643700,1604,1275,2,1277,46
2020-04-22,Alpine,003,1148,1,1,0,1,0
2020-04-22,Amador,005,37829,7,7,0,7,0
2020-04-22,Butte,007,227075,24,15,1,16,0
2020-04-22,Calaveras,009,45235,10,12,0,12,0
2020-04-22,Colusa,011,21464,3,3,0,3,0
2020-04-22,Contra Costa,013,1133247,900,772,0,772,22
2020-04-22,Del Norte,015,27424,2,2,0,2,0
2020-04-22,El Dorado,017,186661,54,39,0,39,0
2020-04-22,Fresno,019,978130,730,388,6,394,7
2020-04-22,Glenn,021,27897,5,3,0,3,0
2020-04-22,Humboldt,023,135768,58,53,0,53,0
2020-04-22,Imperial,025,180216,384,170,0,170,3
2020-04-22,Inyo,027,18085,19,18,0,18,0
2020-04-22,Kern,029,883053,949,713,1,714,4
2020-04-22,Kings,031,150075,105,28,1,29,1
2020-04-22,Lake,033,64148,6,6,0,6,0
2020-04-22,Lassen,035,31185,3,0,2,2,0
2020-04-22,Los Angeles,037,10098052,22538,16400,17,16417,715
2020-04-22,Madera,039,155013,75,37,1,38,2
2020-04-22,Marin,041,260295,218,202,1,203,11
2020-04-22,Mariposa,043,17540,6,0,0,0,0
2020-04-22,Mendocino,045,87422,6,5,0,5,0
2020-04-22,Merced,047,269075,147,92,0,92,3
2020-04-22,Modoc,049,8938,0,0,0,0,0
2020-04-22,Mono,051,14174,29,23,0,23,1
2020-04-22,Monterey,053,433212,226,154,1,155,4
2020-04-22,Napa,055,140530,67,58,0,58,2
2020-04-22,Nevada,057,99092,41,36,1,37,1
2020-04-22,Orange,059,3164182,2815,1785,23,1808,36
2020-04-22,Placer,061,380077,155,133,0,133,8
2020-04-22,Plumas,063,18699,4,4,0,4,0
2020-04-22,Riverside,065,2383286,4129,2822,14,2836,76
2020-04-22,Sacramento,067,1510023,1058,959,0,959,36
2020-04-22,San Benito,069,59416,47,43,0,43,2
2020-04-22,San Bernardino,071,2135413,2092,1564,1,1565,74
2020-04-22,San Diego,073,3302833,3566,2493,0,2493,96
2020-04-22,San Francisco,075,870044,1547,1255,0,1255,21
2020-04-22,San Joaquin,077,732212,537,462,3,465,20
2020-04-22,San Luis Obispo,079,281455,230,142,3,145,1
2020-04-22,San Mateo,081,765935,1262,945,2,947,40
2020-04-22,Santa Barbara,083,443738,486,437,2,439,6
2020-04-22,Santa Clara,085,1922200,2428,1969,4,1973,95
2020-04-22,Santa Cruz,087,273765,130,106,0,106,2
2020-04-22,Shasta,089,179085,34,26,0,26,3
2020-04-22,Sierra,091,2930,0,0,0,0,0
2020-04-22,Siskiyou,093,43540,5,5,0,5,0
2020-04-22,Solano,095,438530,246,195,0,195,3
2020-04-22,Sonoma,097,501317,234,185,0,185,1
2020-04-22,Stanislaus,099,539301,332,247,4,251,4
2020-04-22,Sutter,101,95872,28,22,0,22,2
2020-04-22,Tehama,103,63373,1,1,0,1,1
2020-04-22,Trinity,105,12862,0,0,0,0,0
2020-04-22,Tulare,107,460477,705,425,5,430,23
2020-04-22,Tuolumne,109,53932,2,2,0,2,0
2020-04-22,Ventura,111,848112,591,465,1,466,15
2020-04-22,Yolo,113,214977,171,147,0,147,8
2020-04-22,Yuba,115,75493,16,15,0,15,1
2020-04-21,Alameda,001,1643700,1574,1234,2,1236,46
2020-04-21,Alpine,003,1148,1,1,0,1,0
2020-04-21,Amador,005,37829,7,7,0,7,0
2020-04-21,Butte,007,227075,23,15,1,16,0
2020-04-21,Calaveras,009,45235,9,12,0,12,0
2020-04-21,Colusa,011,21464,3,3,0,3,0
2020-04-21,Contra Costa,013,1133247,886,766,0,766,22
2020-04-21,Del Norte,015,27424,2,2,0,2,0
2020-04-21,El Dorado,017,186661,53,36,0,36,0
2020-04-21,Fresno,019,978130,696,372,6,378,7
2020-04-21,Glenn,021,27897,5,3,0,3,0
2020-04-21,Humboldt,023,135768,57,53,0,53,0
2020-04-21,Imperial,025,180216,364,165,0,165,2
2020-04-21,Inyo,027,18085,19,18,0,18,0
2020-04-21,Kern,029,883053,907,676,1,677,4
2020-04-21,Kings,031,150075,91,28,1,29,1
2020-04-21,Lake,033,64148,6,6,0,6,0
2020-04-21,Lassen,035,31185,3,0,2,2,0
2020-04-21,Los Angeles,037,10098052,21678,15096,17,15113,650
2020-04-21,Madera,039,155013,75,37,1,38,2
2020-04-21,Marin,041,260295,212,202,1,203,10
2020-04-21,Mariposa,043,17540,5,0,0,0,0
2020-04-21,Mendocino,045,87422,6,5,0,5,0
2020-04-21,Merced,047,269075,143,89,0,89,3
2020-04-21,Modoc,049,8938,0,0,0,0,0
2020-04-21,Mono,051,14174,29,23,0,23,1
2020-04-21,Monterey,053,433212,223,151,1,152,4
2020-04-21,Napa,055,140530,66,58,0,58,2
2020-04-21,Nevada,057,99092,41,36,1,37,1
2020-04-21,Orange,059,3164182,2692,1717,22,1739,36
2020-04-21,Placer,061,380077,153,133,0,133,8
2020-04-21,Plumas,063,18699,4,4,0,4,0
2020-04-21,Riverside,065,2383286,3997,2631,14,2645,68
2020-04-21,Sacramento,067,1510023,1048,941,0,941,33
2020-04-21,San Benito,069,59416,45,43,0,43,2
2020-04-21,San Bernardino,071,2135413,2031,1499,1,1500,71
2020-04-21,San Diego,073,3302833,3410,2436,0,2436,87
2020-04-21,San Francisco,075,870044,1517,1232,0,1232,20
2020-04-21,San Joaquin,077,732212,527,447,3,450,20
2020-04-21,San Luis Obispo,079,281455,222,134,3,137,1
2020-04-21,San Mateo,081,765935,1216,933,2,935,34
2020-04-21,Santa Barbara,083,443738,477,414,2,416,5
2020-04-21,Santa Clara,085,1922200,2378,1943,4,1947,91
2020-04-21,Santa Cruz,087,273765,128,104,0,104,2
2020-04-21,Shasta,089,179085,33,26,0,26,3
2020-04-21,Sierra,091,2930,0,0,0,0,0
2020-04-21,Siskiyou,093,43540,5,5,0,5,0
2020-04-21,Solano,095,438530,238,193,0,193,3
2020-04-21,Sonoma,097,501317,224,182,0,182,1
2020-04-21,Stanislaus,099,539301,313,235,4,239,4
2020-04-21,Sutter,101,95872,28,22,0,22,2
2020-04-21,Tehama,103,63373,1,1,0,1,1
2020-04-21,Trinity,105,12862,0,0,0,0,0
2020-04-21,Tulare,107,460477,668,410,5,415,23
2020-04-21,Tuolumne,109,53932,2,2,0,2,0
2020-04-21,Ventura,111,848112,579,455,1,456,14
2020-04-21,Yolo,113,214977,169,143,0,143,8
2020-04-21,Yuba,115,75493,16,15,0,15,1
2020-04-20,Alameda,001,1643700,1541,1181,2,1183,42
2020-04-20,Alpine,003,1148,1,1,0,1,0
2020-04-20,Amador,005,37829,7,7,0,7,0
2020-04-20,Butte,007,227075,23,15,1,16,0
2020-04-20,Calaveras,009,45235,9,12,0,12,0
2020-04-20,Colusa,011,21464,3,3,0,3,0
2020-04-20,Contra Costa,013,1133247,876,753,0,753,22
2020-04-20,Del Norte,015,27424,2,2,0,2,0
2020-04-20,El Dorado,017,186661,53,36,0,36,0
2020-04-20,Fresno,019,978130,678,356,6,362,7
2020-04-20,Glenn,021,27897,4,3,0,3,0
2020-04-20,Humboldt,023,135768,57,53,0,53,0
2020-04-20,Imperial,025,180216,345,149,0,149,2
2020-04-20,Inyo,027,18085,19,17,0,17,0
2020-04-20,Kern,029,883053,875,651,1,652,3
2020-04-20,Kings,031,150075,80,19,1,20,1
2020-04-20,Lake,033,64148,6,6,0,6,0
2020-04-20,Lassen,035,31185,3,0,2,2,0
2020-04-20,Los Angeles,037,10098052,20763,13787,17,13804,608
2020-04-20,Madera,039,155013,74,35,1,36,2
2020-04-20,Marin,041,260295,208,200,1,201,10
2020-04-20,Mariposa,043,17540,5,0,0,0,0
2020-04-20,Mendocino,045,87422,6,5,0,5,0
2020-04-20,Merced,047,269075,136,88,0,88,3
2020-04-20,Modoc,049,8938,0,0,0,0,0
2020-04-20,Mono,051,14174,29,23,0,23,1
2020-04-20,Monterey,053,433212,214,147,1,148,4
2020-04-20,Napa,055,140530,66,55,0,55,2
2020-04-20,Nevada,057,99092,41,34,1,35,1
2020-04-20,Orange,059,3164182,2608,1679,22,1701,33
2020-04-20,Placer,061,380077,152,132,0,132,8
2020-04-20,Plumas,063,18699,4,4,0,4,0
2020-04-20,Riverside,065,2383286,3872,2477,14,2491,61
2020-04-20,Sacramento,067,1510023,1038,924,0,924,32
2020-04-20,San Benito,069,59416,45,43,0,43,2
2020-04-20,San Bernardino,071,2135413,1944,1344,1,1345,63
2020-04-20,San Diego,073,3302833,3268,2327,0,2327,72
2020-04-20,San Francisco,075,870044,1485,1223,0,1223,19
2020-04-20,San Joaquin,077,732212,523,422,3,425,17
2020-04-20,San Luis Obispo,079,281455,208,132,3,135,1
2020-04-20,San Mateo,081,765935,1193,890,2,892,31
2020-04-20,Santa Barbara,083,443738,470,388,2,390,4
2020-04-20,Santa Clara,085,1922200,2347,1920,4,1924,84
2020-04-20,Santa Cruz,087,273765,126,102,0,102,2
2020-04-20,Shasta,089,179085,33,26,0,26,3
2020-04-20,Sierra,091,2930,0,0,0,0,0
2020-04-20,Siskiyou,093,43540,5,5,0,5,0
2020-04-20,Solano,095,438530,235,185,0,185,2
2020-04-20,Sonoma,097,501317,216,178,0,178,1
2020-04-20,Stanislaus,099,539301,299,228,4,232,3
2020-04-20,Sutter,101,95872,27,22,0,22,2
2020-04-20,Tehama,103,63373,1,1,0,1,1
2020-04-20,Trinity,105,12862,0,0,0,0,0
2020-04-20,Tulare,107,460477,658,401,5,406,20
2020-04-20,Tuolumne,109,53932,2,2,0,2,0
2020-04-20,Ventura,111,848112,565,426,1,427,13
2020-04-20,Yolo,113,214977,168,125,0,125,5
2020-04-20,Yuba,115,75493,16,15,0,15,1
2020-04-19,Alameda,001,1643700,1491,1134,2,1136,41
2020-04-19,Alpine,003,1148,1,1,0,1,0
2020-04-19,Amador,005,37829,6,7,0,7,0
2020-04-19,Butte,007,227075,22,15,1,16,0
2020-04-19,Calaveras,009,45235,9,12,0,12,0
2020-04-19,Colusa,011,21464,3,3,0,3,0
2020-04-19,Contra Costa,013,1133247,862,731,0,731,20
2020-04-19,Del Norte,015,27424,2,2,0,2,0
2020-04-19,El Dorado,017,186661,53,36,0,36,0
2020-04-19,Fresno,019,978130,642,326,6,332,7
2020-04-19,Glenn,021,27897,4,3,0,3,0
2020-04-19,Humboldt,023,135768,57,53,0,53,0
2020-04-19,Imperial,025,180216,319,144,0,144,2
2020-04-19,Inyo,027,18085,19,17,0,17,0
2020-04-19,Kern,029,883053,850,629,1,630,3
2020-04-19,Kings,031,150075,70,17,1,18,1
2020-04-19,Lake,033,64148,6,6,0,6,0
2020-04-19,Lassen,035,31185,3,0,2,2,0
2020-04-19,Los Angeles,037,10098052,19768,12299,17,12316,589
2020-04-19,Madera,039,155013,72,34,1,35,2
2020-04-19,Marin,041,260295,207,194,1,195,10
2020-04-19,Mariposa,043,17540,2,0,0,0,0
2020-04-19,Mendocino,045,87422,6,4,0,4,0
2020-04-19,Merced,047,269075,131,85,0,85,3
2020-04-19,Modoc,049,8938,0,0,0,0,0
2020-04-19,Mono,051,14174,29,23,0,23,1
2020-04-19,Monterey,053,433212,205,140,1,141,4
2020-04-19,Napa,055,140530,64,49,0,49,2
2020-04-19,Nevada,057,99092,40,34,1,35,1
2020-04-19,Orange,059,3164182,2511,1591,21,1612,32
2020-04-19,Placer,061,380077,151,131,0,131,8
2020-04-19,Plumas,063,18699,4,4,0,4,0
2020-04-19,Riverside,065,2383286,3729,2316,14,2330,56
2020-04-19,Sacramento,067,1510023,1011,912,0,912,32
2020-04-19,San Benito,069,59416,43,40,0,40,2
2020-04-19,San Bernardino,071,2135413,1881,1262,1,1263,58
2020-04-19,San Diego,073,3302833,3101,2270,0,2270,71
2020-04-19,San Francisco,075,870044,1452,1153,0,1153,19
2020-04-19,San Joaquin,077,732212,505,404,3,407,17
2020-04-19,San Luis Obispo,079,281455,203,132,3,135,1
2020-04-19,San Mateo,081,765935,1157,845,2,847,31
2020-04-19,Santa Barbara,083,443738,463,377,2,379,3
2020-04-19,Santa Clara,085,1922200,2302,1878,4,1882,81
2020-04-19,Santa Cruz,087,273765,123,98,0,98,2
2020-04-19,Shasta,089,179085,31,26,0,26,3
2020-04-19,Sierra,091,2930,0,0,0,0,0
2020-04-19,Siskiyou,093,43540,5,5,0,5,0
2020-04-19,Solano,095,438530,227,174,0,174,2
2020-04-19,Sonoma,097,501317,210,172,0,172,1
2020-04-19,Stanislaus,099,539301,291,221,4,225,3
2020-04-19,Sutter,101,95872,26,21,0,21,2
2020-04-19,Tehama,103,63373,1,1,0,1,1
2020-04-19,Trinity,105,12862,0,0,0,0,0
2020-04-19,Tulare,107,460477,612,391,5,396,17
2020-04-19,Tuolumne,109,53932,2,2,0,2,0
2020-04-19,Ventura,111,848112,557,418,1,419,13
2020-04-19,Yolo,113,214977,168,120,0,120,5
2020-04-19,Yuba,115,75493,16,15,0,15,1
2020-04-18,Alameda,001,1643700,1466,1085,2,1087,40
2020-04-18,Alpine,003,1148,1,1,0,1,0
2020-04-18,Amador,005,37829,6,7,0,7,0
2020-04-18,Butte,007,227075,21,15,1,16,0
2020-04-18,Calaveras,009,45235,9,12,0,12,0
2020-04-18,Colusa,011,21464,3,3,0,3,0
2020-04-18,Contra Costa,013,1133247,850,721,0,721,17
2020-04-18,Del Norte,015,27424,2,2,0,2,0
2020-04-18,El Dorado,017,186661,53,36,0,36,0
2020-04-18,Fresno,019,978130,622,319,6,325,7
2020-04-18,Glenn,021,27897,4,3,0,3,0
2020-04-18,Humboldt,023,135768,57,52,0,52,0
2020-04-18,Imperial,025,180216,310,137,0,137,2
2020-04-18,Inyo,027,18085,19,17,0,17,0
2020-04-18,Kern,029,883053,828,626,1,627,3
2020-04-18,Kings,031,150075,69,17,1,18,1
2020-04-18,Lake,033,64148,6,6,0,6,0
2020-04-18,Lassen,035,31185,3,0,2,2,0
2020-04-18,Los Angeles,037,10098052,19243,11984,16,12000,566
2020-04-18,Madera,039,155013,71,34,1,35,2
2020-04-18,Marin,041,260295,205,193,1,194,10
2020-04-18,Mariposa,043,17540,2,0,0,0,0
2020-04-18,Mendocino,045,87422,6,4,0,4,0
2020-04-18,Merced,047,269075,129,82,0,82,3
2020-04-18,Modoc,049,8938,0,0,0,0,0
2020-04-18,Mono,051,14174,29,22,0,22,1
2020-04-18,Monterey,053,433212,201,135,1,136,3
2020-04-18,Napa,055,140530,64,49,0,49,2
2020-04-18,Nevada,057,99092,39,34,1,35,1
2020-04-18,Orange,059,3164182,2447,1569,20,1589,32
2020-04-18,Placer,061,380077,149,130,0,130,8
2020-04-18,Plumas,063,18699,4,4,0,4,0
2020-04-18,Riverside,065,2383286,3654,2257,14,2271,56
2020-04-18,Sacramento,067,1510023,999,901,0,901,32
2020-04-18,San Benito,069,59416,43,40,0,40,2
2020-04-18,San Bernardino,071,2135413,1836,1255,1,1256,58
2020-04-18,San Diego,073,3302833,2999,2215,0,2215,71
2020-04-18,San Francisco,075,870044,1413,1144,0,1144,19
2020-04-18,San Joaquin,077,732212,496,392,3,395,17
2020-04-18,San Luis Obispo,079,281455,199,129,3,132,1
2020-04-18,San Mateo,081,765935,1135,821,2,823,31
2020-04-18,Santa Barbara,083,443738,457,372,2,374,3
2020-04-18,Santa Clara,085,1922200,2269,1862,4,1866,79
2020-04-18,Santa Cruz,087,273765,121,96,0,96,2
2020-04-18,Shasta,089,179085,31,26,0,26,3
2020-04-18,Sierra,091,2930,0,0,0,0,0
2020-04-18,Siskiyou,093,43540,5,5,0,5,0
2020-04-18,Solano,095,438530,224,175,0,175,2
2020-04-18,Sonoma,097,501317,206,168,0,168,1
2020-04-18,Stanislaus,099,539301,283,216,4,220,3
2020-04-18,Sutter,101,95872,26,21,0,21,2
2020-04-18,Tehama,103,63373,1,1,0,1,1
2020-04-18,Trinity,105,12862,0,0,0,0,0
2020-04-18,Tulare,107,460477,601,385,5,390,17
2020-04-18,Tuolumne,109,53932,2,2,0,2,0
2020-04-18,Ventura,111,848112,549,416,1,417,13
2020-04-18,Yolo,113,214977,166,118,0,118,5
2020-04-18,Yuba,115,75493,16,14,0,14,1
2020-04-17,Alameda,001,1643700,1410,1043,1,1044,40
2020-04-17,Alpine,003,1148,1,1,0,1,0
2020-04-17,Amador,005,37829,6,7,0,7,0
2020-04-17,Butte,007,227075,21,15,1,16,0
2020-04-17,Calaveras,009,45235,9,11,0,11,0
2020-04-17,Colusa,011,21464,3,3,0,3,0
2020-04-17,Contra Costa,013,1133247,839,687,0,687,15
2020-04-17,Del Norte,015,27424,2,2,0,2,0
2020-04-17,El Dorado,017,186661,53,35,0,35,0
2020-04-17,Fresno,019,978130,600,315,6,321,7
2020-04-17,Glenn,021,27897,4,3,0,3,0
2020-04-17,Humboldt,023,135768,56,52,0,52,0
2020-04-17,Imperial,025,180216,301,135,0,135,2
2020-04-17,Inyo,027,18085,19,17,0,17,0
2020-04-17,Kern,029,883053,808,612,1,613,3
2020-04-17,Kings,031,150075,67,15,1,16,1
2020-04-17,Lake,033,64148,6,6,0,6,0
2020-04-17,Lassen,035,31185,3,0,2,2,0
2020-04-17,Los Angeles,037,10098052,18600,11354,16,11370,489
2020-04-17,Madera,039,155013,71,34,1,35,2
2020-04-17,Marin,041,260295,202,189,1,190,10
2020-04-17,Mariposa,043,17540,1,0,0,0,0
2020-04-17,Mendocino,045,87422,6,4,0,4,0
2020-04-17,Merced,047,269075,128,80,0,80,3
2020-04-17,Modoc,049,8938,0,0,0,0,0
2020-04-17,Mono,051,14174,29,22,0,22,1
2020-04-17,Monterey,053,433212,196,119,1,120,3
2020-04-17,Napa,055,140530,62,46,0,46,2
2020-04-17,Nevada,057,99092,38,34,1,35,1
2020-04-17,Orange,059,3164182,2396,1496,20,1516,31
2020-04-17,Placer,061,380077,149,130,0,130,8
2020-04-17,Plumas,063,18699,4,4,0,4,0
2020-04-17,Riverside,065,2383286,3527,2080,14,2094,50
2020-04-17,Sacramento,067,1510023,992,882,0,882,32
2020-04-17,San Benito,069,59416,43,38,0,38,2
2020-04-17,San Bernardino,071,2135413,1797,1229,1,1230,57
2020-04-17,San Diego,073,3302833,2909,2160,0,2160,70
2020-04-17,San Francisco,075,870044,1387,1090,0,1090,19
2020-04-17,San Joaquin,077,732212,485,356,3,359,17
2020-04-17,San Luis Obispo,079,281455,192,116,3,119,1
2020-04-17,San Mateo,081,765935,1119,768,2,770,31
2020-04-17,Santa Barbara,083,443738,452,349,2,351,3
2020-04-17,Santa Clara,085,1922200,2233,1834,4,1838,74
2020-04-17,Santa Cruz,087,273765,120,94,0,94,2
2020-04-17,Shasta,089,179085,31,26,0,26,3
2020-04-17,Sierra,091,2930,0,0,0,0,0
2020-04-17,Siskiyou,093,43540,5,5,0,5,0
2020-04-17,Solano,095,438530,223,173,0,173,2
2020-04-17,Sonoma,097,501317,203,167,0,167,1
2020-04-17,Stanislaus,099,539301,281,201,4,205,3
2020-04-17,Sutter,101,95872,26,20,0,20,2
2020-04-17,Tehama,103,63373,1,1,0,1,1
2020-04-17,Trinity,105,12862,0,0,0,0,0
2020-04-17,Tulare,107,460477,594,370,5,375,17
2020-04-17,Tuolumne,109,53932,2,2,0,2,0
2020-04-17,Ventura,111,848112,544,398,1,399,13
2020-04-17,Yolo,113,214977,165,117,0,117,5
2020-04-17,Yuba,115,75493,16,14,0,14,1
2020-04-16,Alameda,001,1643700,1375,981,1,982,39
2020-04-16,Alpine,003,1148,1,1,0,1,0
2020-04-16,Amador,005,37829,6,7,0,7,0
2020-04-16,Butte,007,227075,20,15,1,16,0
2020-04-16,Calaveras,009,45235,9,10,0,10,0
2020-04-16,Colusa,011,21464,3,3,0,3,0
2020-04-16,Contra Costa,013,1133247,825,675,0,675,14
2020-04-16,Del Norte,015,27424,2,2,0,2,0
2020-04-16,El Dorado,017,186661,52,34,0,34,0
2020-04-16,Fresno,019,978130,570,289,6,295,7
2020-04-16,Glenn,021,27897,4,3,0,3,0
2020-04-16,Humboldt,023,135768,56,47,0,47,0
2020-04-16,Imperial,025,180216,287,132,0,132,2
2020-04-16,Inyo,027,18085,17,17,0,17,0
2020-04-16,Kern,029,883053,781,587,1,588,3
2020-04-16,Kings,031,150075,63,12,1,13,1
2020-04-16,Lake,033,64148,6,6,0,6,0
2020-04-16,Lassen,035,31185,3,0,2,2,0
2020-04-16,Los Angeles,037,10098052,17715,10786,16,10802,447
2020-04-16,Madera,039,155013,69,34,1,35,2
2020-04-16,Marin,041,260295,198,170,1,171,10
2020-04-16,Mariposa,043,17540,1,1,0,1,0
2020-04-16,Mendocino,045,87422,6,4,0,4,0
2020-04-16,Merced,047,269075,122,76,0,76,3
2020-04-16,Modoc,049,8938,0,0,0,0,0
2020-04-16,Mono,051,14174,29,22,0,22,1
2020-04-16,Monterey,053,433212,193,116,1,117,3
2020-04-16,Napa,055,140530,59,44,0,44,2
2020-04-16,Nevada,057,99092,38,34,1,35,1
2020-04-16,Orange,059,3164182,2331,1439,19,1458,28
2020-04-16,Placer,061,380077,147,129,0,129,7
2020-04-16,Plumas,063,18699,4,4,0,4,0
2020-04-16,Riverside,065,2383286,3407,1913,14,1927,45
2020-04-16,Sacramento,067,1510023,984,865,0,865,32
2020-04-16,San Benito,069,59416,43,36,0,36,2
2020-04-16,San Bernardino,071,2135413,1715,1143,0,1143,54
2020-04-16,San Diego,073,3302833,2801,2089,0,2089,63
2020-04-16,San Francisco,075,870044,1343,1039,0,1039,16
2020-04-16,San Joaquin,077,732212,470,345,3,348,17
2020-04-16,San Luis Obispo,079,281455,187,113,3,116,1
2020-04-16,San Mateo,081,765935,1090,745,2,747,29
2020-04-16,Santa Barbara,083,443738,441,331,2,333,3
2020-04-16,Santa Clara,085,1922200,2196,1789,4,1793,70
2020-04-16,Santa Cruz,087,273765,118,90,0,90,2
2020-04-16,Shasta,089,179085,31,25,0,25,3
2020-04-16,Sierra,091,2930,0,0,0,0,0
2020-04-16,Siskiyou,093,43540,5,5,0,5,0
2020-04-16,Solano,095,438530,220,162,0,162,2
2020-04-16,Sonoma,097,501317,198,145,0,145,1
2020-04-16,Stanislaus,099,539301,278,185,4,189,3
2020-04-16,Sutter,101,95872,25,21,0,21,2
2020-04-16,Tehama,103,63373,1,1,0,1,1
2020-04-16,Trinity,105,12862,0,0,0,0,0
2020-04-16,Tulare,107,460477,577,305,5,310,16
2020-04-16,Tuolumne,109,53932,2,1,0,1,0
2020-04-16,Ventura,111,848112,532,384,1,385,13
2020-04-16,Yolo,113,214977,163,98,0,98,4
2020-04-16,Yuba,115,75493,15,14,0,14,1
2020-04-15,Alameda,001,1643700,1325,915,1,916,38
2020-04-15,Alpine,003,1148,1,1,0,1,0
2020-04-15,Amador,005,37829,6,7,0,7,0
2020-04-15,Butte,007,227075,20,14,1,15,0
2020-04-15,Calaveras,009,45235,8,9,0,9,0
2020-04-15,Colusa,011,21464,3,3,0,3,0
2020-04-15,Contra Costa,013,1133247,803,645,0,645,14
2020-04-15,Del Norte,015,27424,2,2,0,2,0
2020-04-15,El Dorado,017,186661,50,33,0,33,0
2020-04-15,Fresno,019,978130,544,264,6,270,7
2020-04-15,Glenn,021,27897,4,3,0,3,0
2020-04-15,Humboldt,023,135768,56,47,0,47,0
2020-04-15,Imperial,025,180216,260,115,0,115,2
2020-04-15,Inyo,027,18085,17,12,0,12,0
2020-04-15,Kern,029,883053,759,500,1,501,3
2020-04-15,Kings,031,150075,59,12,1,13,1
2020-04-15,Lake,033,64148,6,4,0,4,0
2020-04-15,Lassen,035,31185,3,0,2,2,0
2020-04-15,Los Angeles,037,10098052,16895,10416,15,10431,394
2020-04-15,Madera,039,155013,69,30,1,31,2
2020-04-15,Marin,041,260295,195,162,1,163,10
2020-04-15,Mariposa,043,17540,0,0,0,0,0
2020-04-15,Mendocino,045,87422,5,4,0,4,0
2020-04-15,Merced,047,269075,120,74,0,74,3
2020-04-15,Modoc,049,8938,0,0,0,0,0
2020-04-15,Mono,051,14174,29,22,0,22,1
2020-04-15,Monterey,053,433212,185,106,1,107,3
2020-04-15,Napa,055,140530,56,34,0,34,2
2020-04-15,Nevada,057,99092,37,34,1,35,1
2020-04-15,Orange,059,3164182,2228,1377,19,1396,24
2020-04-15,Placer,061,380077,146,123,0,123,6
2020-04-15,Plumas,063,18699,4,4,0,4,0
2020-04-15,Riverside,065,2383286,3212,1723,14,1737,42
2020-04-15,Sacramento,067,1510023,975,839,0,839,32
2020-04-15,San Benito,069,59416,43,34,0,34,2
2020-04-15,San Bernardino,071,2135413,1645,1063,0,1063,45
2020-04-15,San Diego,073,3302833,2713,2014,0,2014,60
2020-04-15,San Francisco,075,870044,1307,1006,0,1006,16
2020-04-15,San Joaquin,077,732212,462,329,3,332,17
2020-04-15,San Luis Obispo,079,281455,179,112,3,115,1
2020-04-15,San Mateo,081,765935,1041,707,2,709,28
2020-04-15,Santa Barbara,083,443738,425,317,2,319,2
2020-04-15,Santa Clara,085,1922200,2157,1692,4,1696,69
2020-04-15,Santa Cruz,087,273765,114,92,0,92,2
2020-04-15,Shasta,089,179085,31,25,0,25,3
2020-04-15,Sierra,091,2930,0,0,0,0,0
2020-04-15,Siskiyou,093,43540,5,5,0,5,0
2020-04-15,Solano,095,438530,215,153,0,153,2
2020-04-15,Sonoma,097,501317,196,140,0,140,1
2020-04-15,Stanislaus,099,539301,271,174,4,178,3
2020-04-15,Sutter,101,95872,25,19,0,19,2
2020-04-15,Tehama,103,63373,1,1,0,1,1
2020-04-15,Trinity,105,12862,0,0,0,0,0
2020-04-15,Tulare,107,460477,559,289,5,294,14
2020-04-15,Tuolumne,109,53932,2,1,0,1,0
2020-04-15,Ventura,111,848112,517,365,1,366,13
2020-04-15,Yolo,113,214977,159,93,0,93,3
2020-04-15,Yuba,115,75493,15,15,0,15,1
2020-04-14,Alameda,001,1643700,1280,843,1,844,30
2020-04-14,Alpine,003,1148,1,1,0,1,0
2020-04-14,Amador,005,37829,6,6,0,6,0
2020-04-14,Butte,007,227075,20,13,1,14,0
2020-04-14,Calaveras,009,45235,8,5,0,5,0
2020-04-14,Colusa,011,21464,3,3,0,3,0
2020-04-14,Contra Costa,013,1133247,791,617,0,617,12
2020-04-14,Del Norte,015,27424,2,2,0,2,0
2020-04-14,El Dorado,017,186661,50,30,0,30,0
2020-04-14,Fresno,019,978130,521,244,6,250,6
2020-04-14,Glenn,021,27897,4,3,0,3,0
2020-04-14,Humboldt,023,135768,56,44,0,44,0
2020-04-14,Imperial,025,180216,240,86,0,86,2
2020-04-14,Inyo,027,18085,17,12,0,12,0
2020-04-14,Kern,029,883053,736,453,1,454,3
2020-04-14,Kings,031,150075,58,12,1,13,1
2020-04-14,Lake,033,64148,6,3,0,3,0
2020-04-14,Lassen,035,31185,3,0,2,2,0
2020-04-14,Los Angeles,037,10098052,16001,9948,14,9962,357
2020-04-14,Madera,039,155013,68,29,1,30,2
2020-04-14,Marin,041,260295,191,147,1,148,9
2020-04-14,Mariposa,043,17540,0,0,0,0,0
2020-04-14,Mendocino,045,87422,5,4,0,4,0
2020-04-14,Merced,047,269075,113,61,0,61,3
2020-04-14,Modoc,049,8938,0,0,0,0,0
2020-04-14,Mono,051,14174,29,22,0,22,1
2020-04-14,Monterey,053,433212,180,98,1,99,3
2020-04-14,Napa,055,140530,56,33,0,33,2
2020-04-14,Nevada,057,99092,37,34,1,35,1
2020-04-14,Orange,059,3164182,2126,1362,19,1381,24
2020-04-14,Placer,061,380077,145,117,0,117,5
2020-04-14,Plumas,063,18699,4,3,0,3,0
2020-04-14,Riverside,065,2383286,3077,1467,14,1481,40
2020-04-14,Sacramento,067,1510023,966,737,0,737,29
2020-04-14,San Benito,069,59416,40,34,0,34,2
2020-04-14,San Bernardino,071,2135413,1590,933,0,933,37
2020-04-14,San Diego,073,3302833,2618,1932,0,1932,53
2020-04-14,San Francisco,075,870044,1253,968,0,968,14
2020-04-14,San Joaquin,077,732212,452,280,3,283,17
2020-04-14,San Luis Obispo,079,281455,175,109,3,112,1
2020-04-14,San Mateo,081,765935,1007,681,2,683,28
2020-04-14,Santa Barbara,083,443738,401,292,2,294,2
2020-04-14,Santa Clara,085,1922200,2124,1561,4,1565,63
2020-04-14,Santa Cruz,087,273765,106,84,0,84,2
2020-04-14,Shasta,089,179085,31,24,0,24,3
2020-04-14,Sierra,091,2930,0,0,0,0,0
2020-04-14,Siskiyou,093,43540,5,5,0,5,0
2020-04-14,Solano,095,438530,212,140,0,140,2
2020-04-14,Sonoma,097,501317,192,133,0,133,1
2020-04-14,Stanislaus,099,539301,258,136,4,140,3
2020-04-14,Sutter,101,95872,24,19,0,19,2
2020-04-14,Tehama,103,63373,1,1,0,1,1
2020-04-14,Trinity,105,12862,0,0,0,0,0
2020-04-14,Tulare,107,460477,535,228,5,233,12
2020-04-14,Tuolumne,109,53932,2,0,0,0,0
2020-04-14,Ventura,111,848112,504,328,1,329,11
2020-04-14,Yolo,113,214977,155,81,0,81,3
2020-04-14,Yuba,115,75493,14,14,0,14,1
2020-04-13,Alameda,001,1643700,1241,821,1,822,23
2020-04-13,Alpine,003,1148,1,1,0,1,0
2020-04-13,Amador,005,37829,6,6,0,6,0
2020-04-13,Butte,007,227075,20,13,1,14,0
2020-04-13,Calaveras,009,45235,7,5,0,5,0
2020-04-13,Colusa,011,21464,3,3,0,3,0
2020-04-13,Contra Costa,013,1133247,775,569,0,569,12
2020-04-13,Del Norte,015,27424,2,2,0,2,0
2020-04-13,El Dorado,017,186661,48,29,0,29,0
2020-04-13,Fresno,019,978130,499,205,5,210,4
2020-04-13,Glenn,021,27897,4,3,0,3,0
2020-04-13,Humboldt,023,135768,56,44,0,44,0
2020-04-13,Imperial,025,180216,222,82,0,82,2
2020-04-13,Inyo,027,18085,17,12,0,12,0
2020-04-13,Kern,029,883053,711,346,1,347,3
2020-04-13,Kings,031,150075,54,9,1,10,0
2020-04-13,Lake,033,64148,6,3,0,3,0
2020-04-13,Lassen,035,31185,3,0,2,2,0
2020-04-13,Los Angeles,037,10098052,15287,9367,14,9381,317
2020-04-13,Madera,039,155013,66,29,1,30,2
2020-04-13,Marin,041,260295,187,144,1,145,6
2020-04-13,Mariposa,043,17540,0,0,0,0,0
2020-04-13,Mendocino,045,87422,5,4,0,4,0
2020-04-13,Merced,047,269075,112,60,0,60,3
2020-04-13,Modoc,049,8938,0,0,0,0,0
2020-04-13,Mono,051,14174,29,21,0,21,1
2020-04-13,Monterey,053,433212,173,86,1,87,3
2020-04-13,Napa,055,140530,55,30,0,30,2
2020-04-13,Nevada,057,99092,37,24,1,25,1
2020-04-13,Orange,059,3164182,2053,1313,19,1332,21
2020-04-13,Placer,061,380077,144,116,0,116,5
2020-04-13,Plumas,063,18699,4,3,0,3,0
2020-04-13,Riverside,065,2383286,2935,1460,13,1473,35
2020-04-13,Sacramento,067,1510023,954,723,0,723,25
2020-04-13,San Benito,069,59416,39,33,0,33,2
2020-04-13,San Bernardino,071,2135413,1515,920,0,920,30
2020-04-13,San Diego,073,3302833,2535,1849,0,1849,47
2020-04-13,San Francisco,075,870044,1215,948,0,948,12
2020-04-13,San Joaquin,077,732212,437,255,3,258,16
2020-04-13,San Luis Obispo,079,281455,170,106,3,109,1
2020-04-13,San Mateo,081,765935,967,679,2,681,25
2020-04-13,Santa Barbara,083,443738,382,271,1,272,2
2020-04-13,Santa Clara,085,1922200,2078,1540,4,1544,58
2020-04-13,Santa Cruz,087,273765,100,82,0,82,1
2020-04-13,Shasta,089,179085,30,24,0,24,3
2020-04-13,Sierra,091,2930,0,0,0,0,0
2020-04-13,Siskiyou,093,43540,5,5,0,5,0
2020-04-13,Solano,095,438530,209,136,0,136,2
2020-04-13,Sonoma,097,501317,185,133,0,133,1
2020-04-13,Stanislaus,099,539301,252,130,4,134,1
2020-04-13,Sutter,101,95872,24,18,0,18,2
2020-04-13,Tehama,103,63373,1,1,0,1,0
2020-04-13,Trinity,105,12862,0,0,0,0,0
2020-04-13,Tulare,107,460477,499,185,5,190,11
2020-04-13,Tuolumne,109,53932,2,0,0,0,0
2020-04-13,Ventura,111,848112,483,309,0,309,9
2020-04-13,Yolo,113,214977,149,81,0,81,3
2020-04-13,Yuba,115,75493,14,13,0,13,1
2020-04-12,Alameda,001,1643700,1198,774,1,775,23
2020-04-12,Alpine,003,1148,1,1,0,1,0
2020-04-12,Amador,005,37829,6,6,0,6,0
2020-04-12,Butte,007,227075,20,13,1,14,0
2020-04-12,Calaveras,009,45235,7,5,0,5,0
2020-04-12,Colusa,011,21464,3,3,0,3,0
2020-04-12,Contra Costa,013,1133247,762,553,0,553,12
2020-04-12,Del Norte,015,27424,2,2,0,2,0
2020-04-12,El Dorado,017,186661,48,28,0,28,0
2020-04-12,Fresno,019,978130,470,205,5,210,4
2020-04-12,Glenn,021,27897,4,3,0,3,0
2020-04-12,Humboldt,023,135768,56,43,0,43,0
2020-04-12,Imperial,025,180216,199,78,0,78,2
2020-04-12,Inyo,027,18085,15,12,0,12,0
2020-04-12,Kern,029,883053,679,319,0,319,3
2020-04-12,Kings,031,150075,52,9,1,10,0
2020-04-12,Lake,033,64148,6,3,0,3,0
2020-04-12,Lassen,035,31185,3,0,2,2,0
2020-04-12,Los Angeles,037,10098052,14574,9133,14,9147,294
2020-04-12,Madera,039,155013,65,29,1,30,2
2020-04-12,Marin,041,260295,176,138,1,139,6
2020-04-12,Mariposa,043,17540,0,0,0,0,0
2020-04-12,Mendocino,045,87422,5,4,0,4,0
2020-04-12,Merced,047,269075,106,58,0,58,3
2020-04-12,Modoc,049,8938,0,0,0,0,0
2020-04-12,Mono,051,14174,29,20,0,20,1
2020-04-12,Monterey,053,433212,159,85,1,86,3
2020-04-12,Napa,055,140530,53,29,0,29,2
2020-04-12,Nevada,057,99092,37,24,1,25,1
2020-04-12,Orange,059,3164182,1993,1283,18,1301,21
2020-04-12,Placer,061,380077,143,114,0,114,4
2020-04-12,Plumas,063,18699,4,3,0,3,0
2020-04-12,Riverside,065,2383286,2753,1330,13,1343,34
2020-04-12,Sacramento,067,1510023,917,689,0,689,25
2020-04-12,San Benito,069,59416,37,33,0,33,2
2020-04-12,San Bernardino,071,2135413,1438,827,0,827,30
2020-04-12,San Diego,073,3302833,2445,1806,0,1806,45
2020-04-12,San Francisco,075,870044,1188,886,0,886,11
2020-04-12,San Joaquin,077,732212,419,246,3,249,15
2020-04-12,San Luis Obispo,079,281455,167,102,2,104,1
2020-04-12,San Mateo,081,765935,941,664,2,666,25
2020-04-12,Santa Barbara,083,443738,363,261,1,262,2
2020-04-12,Santa Clara,085,1922200,2050,1461,4,1465,53
2020-04-12,Santa Cruz,087,273765,98,80,0,80,1
2020-04-12,Shasta,089,179085,30,24,0,24,3
2020-04-12,Sierra,091,2930,0,0,0,0,0
2020-04-12,Siskiyou,093,43540,5,5,0,5,0
2020-04-12,Solano,095,438530,203,136,0,136,2
2020-04-12,Sonoma,097,501317,182,131,0,131,1
2020-04-12,Stanislaus,099,539301,244,117,4,121,1
2020-04-12,Sutter,101,95872,23,18,0,18,2
2020-04-12,Tehama,103,63373,1,1,0,1,0
2020-04-12,Trinity,105,12862,0,0,0,0,0
2020-04-12,Tulare,107,460477,487,166,5,171,11
2020-04-12,Tuolumne,109,53932,2,0,0,0,0
2020-04-12,Ventura,111,848112,473,306,0,306,9
2020-04-12,Yolo,113,214977,136,67,0,67,3
2020-04-12,Yuba,115,75493,14,13,0,13,1
2020-04-11,Alameda,001,1643700,1157,751,1,752,23
2020-04-11,Alpine,003,1148,1,1,0,1,0
2020-04-11,Amador,005,37829,6,6,0,6,0
2020-04-11,Butte,007,227075,20,13,1,14,0
2020-04-11,Calaveras,009,45235,7,5,0,5,0
2020-04-11,Colusa,011,21464,3,3,0,3,0
2020-04-11,Contra Costa,013,1133247,753,550,0,550,12
2020-04-11,Del Norte,015,27424,2,2,0,2,0
2020-04-11,El Dorado,017,186661,47,29,0,29,0
2020-04-11,Fresno,019,978130,460,201,5,206,4
2020-04-11,Glenn,021,27897,4,3,0,3,0
2020-04-11,Humboldt,023,135768,56,38,0,38,0
2020-04-11,Imperial,025,180216,189,78,0,78,2
2020-04-11,Inyo,027,18085,15,12,0,12,0
2020-04-11,Kern,029,883053,651,304,0,304,3
2020-04-11,Kings,031,150075,49,9,1,10,0
2020-04-11,Lake,033,64148,6,3,0,3,0
2020-04-11,Lassen,035,31185,3,0,2,2,0
2020-04-11,Los Angeles,037,10098052,14104,8823,14,8837,262
2020-04-11,Madera,039,155013,64,29,1,30,2
2020-04-11,Marin,041,260295,173,136,1,137,6
2020-04-11,Mariposa,043,17540,0,0,0,0,0
2020-04-11,Mendocino,045,87422,5,4,0,4,0
2020-04-11,Merced,047,269075,103,59,0,59,3
2020-04-11,Modoc,049,8938,0,0,0,0,0
2020-04-11,Mono,051,14174,29,20,0,20,1
2020-04-11,Monterey,053,433212,153,78,1,79,3
2020-04-11,Napa,055,140530,53,29,0,29,2
2020-04-11,Nevada,057,99092,37,24,1,25,1
2020-04-11,Orange,059,3164182,1931,1267,18,1285,21
2020-04-11,Placer,061,380077,143,113,0,113,4
2020-04-11,Plumas,063,18699,4,3,0,3,0
2020-04-11,Riverside,065,2383286,2674,1260,13,1273,33
2020-04-11,Sacramento,067,1510023,906,685,0,685,25
2020-04-11,San Benito,069,59416,37,33,0,33,2
2020-04-11,San Bernardino,071,2135413,1402,826,0,826,28
2020-04-11,San Diego,073,3302833,2379,1763,0,1763,45
2020-04-11,San Francisco,075,870044,1166,860,0,860,11
2020-04-11,San Joaquin,077,732212,414,244,3,247,15
2020-04-11,San Luis Obispo,079,281455,167,100,1,101,1
2020-04-11,San Mateo,081,765935,929,662,2,664,25
2020-04-11,Santa Barbara,083,443738,355,258,1,259,2
2020-04-11,Santa Clara,085,1922200,1991,1441,4,1445,51
2020-04-11,Santa Cruz,087,273765,98,79,0,79,1
2020-04-11,Shasta,089,179085,30,24,0,24,3
2020-04-11,Sierra,091,2930,0,0,0,0,0
2020-04-11,Siskiyou,093,43540,5,5,0,5,0
2020-04-11,Solano,095,438530,199,138,0,138,2
2020-04-11,Sonoma,097,501317,180,131,0,131,1
2020-04-11,Stanislaus,099,539301,236,119,3,122,1
2020-04-11,Sutter,101,95872,23,18,0,18,2
2020-04-11,Tehama,103,63373,1,1,0,1,0
2020-04-11,Trinity,105,12862,0,0,0,0,0
2020-04-11,Tulare,107,460477,465,168,5,173,10
2020-04-11,Tuolumne,109,53932,2,0,0,0,0
2020-04-11,Ventura,111,848112,463,304,0,304,9
2020-04-11,Yolo,113,214977,133,67,0,67,3
2020-04-11,Yuba,115,75493,14,13,0,13,1
2020-04-10,Alameda,001,1643700,1116,706,1,707,21
2020-04-10,Alpine,003,1148,1,1,0,1,0
2020-04-10,Amador,005,37829,6,5,0,5,0
2020-04-10,Butte,007,227075,20,13,1,14,0
2020-04-10,Calaveras,009,45235,7,5,0,5,0
2020-04-10,Colusa,011,21464,3,3,0,3,0
2020-04-10,Contra Costa,013,1133247,740,537,0,537,10
2020-04-10,Del Norte,015,27424,2,2,0,2,0
2020-04-10,El Dorado,017,186661,47,26,0,26,0
2020-04-10,Fresno,019,978130,453,186,4,190,3
2020-04-10,Glenn,021,27897,4,3,0,3,0
2020-04-10,Humboldt,023,135768,56,36,0,36,0
2020-04-10,Imperial,025,180216,182,70,0,70,2
2020-04-10,Inyo,027,18085,13,11,0,11,0
2020-04-10,Kern,029,883053,627,272,0,272,3
2020-04-10,Kings,031,150075,46,7,1,8,0
2020-04-10,Lake,033,64148,6,3,0,3,0
2020-04-10,Lassen,035,31185,3,0,2,2,0
2020-04-10,Los Angeles,037,10098052,13590,8384,13,8397,239
2020-04-10,Madera,039,155013,63,29,1,30,2
2020-04-10,Marin,041,260295,168,128,1,129,6
2020-04-10,Mariposa,043,17540,0,0,0,0,0
2020-04-10,Mendocino,045,87422,5,4,0,4,0
2020-04-10,Merced,047,269075,100,56,0,56,3
2020-04-10,Modoc,049,8938,0,0,0,0,0
2020-04-10,Mono,051,14174,29,20,0,20,1
2020-04-10,Monterey,053,433212,142,78,1,79,3
2020-04-10,Napa,055,140530,50,28,0,28,2
2020-04-10,Nevada,057,99092,37,23,1,24,1
2020-04-10,Orange,059,3164182,1884,1167,18,1185,21
2020-04-10,Placer,061,380077,142,112,0,112,4
2020-04-10,Plumas,063,18699,4,3,0,3,0
2020-04-10,Riverside,065,2383286,2608,1162,13,1175,30
2020-04-10,Sacramento,067,1510023,897,642,0,642,24
2020-04-10,San Benito,069,59416,37,32,0,32,2
2020-04-10,San Bernardino,071,2135413,1354,779,0,779,27
2020-04-10,San Diego,073,3302833,2319,1695,0,1695,44
2020-04-10,San Francisco,075,870044,1135,797,0,797,10
2020-04-10,San Joaquin,077,732212,402,234,3,237,14
2020-04-10,San Luis Obispo,079,281455,167,97,1,98,1
2020-04-10,San Mateo,081,765935,913,642,2,644,24
2020-04-10,Santa Barbara,083,443738,347,254,1,255,2
2020-04-10,Santa Clara,085,1922200,1939,1351,4,1355,50
2020-04-10,Santa Cruz,087,273765,97,75,0,75,1
2020-04-10,Shasta,089,179085,30,24,0,24,3
2020-04-10,Sierra,091,2930,0,0,0,0,0
2020-04-10,Siskiyou,093,43540,5,5,0,5,0
2020-04-10,Solano,095,438530,196,129,0,129,2
2020-04-10,Sonoma,097,501317,179,129,0,129,1
2020-04-10,Stanislaus,099,539301,229,101,3,104,0
2020-04-10,Sutter,101,95872,23,18,0,18,2
2020-04-10,Tehama,103,63373,1,1,0,1,0
2020-04-10,Trinity,105,12862,0,0,0,0,0
2020-04-10,Tulare,107,460477,423,163,5,168,10
2020-04-10,Tuolumne,109,53932,2,0,0,0,0
2020-04-10,Ventura,111,848112,454,290,0,290,9
2020-04-10,Yolo,113,214977,131,62,0,62,3
2020-04-10,Yuba,115,75493,14,13,0,13,1
2020-04-09,Alameda,001,1643700,1066,641,1,642,17
2020-04-09,Alpine,003,1148,1,1,0,1,0
2020-04-09,Amador,005,37829,6,2,0,2,0
2020-04-09,Butte,007,227075,19,12,1,13,0
2020-04-09,Calaveras,009,45235,7,5,0,5,0
2020-04-09,Colusa,011,21464,3,3,0,3,0
2020-04-09,Contra Costa,013,1133247,697,505,0,505,7
2020-04-09,Del Norte,015,27424,2,2,0,2,0
2020-04-09,El Dorado,017,186661,46,25,0,25,0
2020-04-09,Fresno,019,978130,428,165,4,169,3
2020-04-09,Glenn,021,27897,4,2,0,2,0
2020-04-09,Humboldt,023,135768,56,36,0,36,0
2020-04-09,Imperial,025,180216,161,67,0,67,2
2020-04-09,Inyo,027,18085,12,11,0,11,0
2020-04-09,Kern,029,883053,591,241,0,241,2
2020-04-09,Kings,031,150075,43,5,1,6,0
2020-04-09,Lake,033,64148,5,1,0,1,0
2020-04-09,Lassen,035,31185,3,0,2,2,0
2020-04-09,Los Angeles,037,10098052,12962,7919,13,7932,220
2020-04-09,Madera,039,155013,63,28,1,29,2
2020-04-09,Marin,041,260295,166,126,1,127,7
2020-04-09,Mariposa,043,17540,0,0,0,0,0
2020-04-09,Mendocino,045,87422,5,4,0,4,0
2020-04-09,Merced,047,269075,97,41,0,41,3
2020-04-09,Modoc,049,8938,0,0,0,0,0
2020-04-09,Mono,051,14174,29,19,0,19,1
2020-04-09,Monterey,053,433212,124,70,1,71,3
2020-04-09,Napa,055,140530,46,27,0,27,2
2020-04-09,Nevada,057,99092,36,23,1,24,1
2020-04-09,Orange,059,3164182,1810,1105,18,1123,19
2020-04-09,Placer,061,380077,141,107,0,107,4
2020-04-09,Plumas,063,18699,4,3,0,3,0
2020-04-09,Riverside,065,2383286,2465,1083,13,1096,29
2020-04-09,Sacramento,067,1510023,874,601,0,601,21
2020-04-09,San Benito,069,59416,37,32,0,32,2
2020-04-09,San Bernardino,071,2135413,1285,717,0,717,27
2020-04-09,San Diego,073,3302833,2223,1630,0,1630,40
2020-04-09,San Francisco,075,870044,1115,748,0,748,8
2020-04-09,San Joaquin,077,732212,381,223,3,226,14
2020-04-09,San Luis Obispo,079,281455,159,93,1,94,1
2020-04-09,San Mateo,081,765935,897,630,2,632,23
2020-04-09,Santa Barbara,083,443738,337,232,1,233,2
2020-04-09,Santa Clara,085,1922200,1869,1301,4,1305,49
2020-04-09,Santa Cruz,087,273765,97,73,0,73,1
2020-04-09,Shasta,089,179085,30,22,0,22,3
2020-04-09,Sierra,091,2930,0,0,0,0,0
2020-04-09,Siskiyou,093,43540,5,4,0,4,0
2020-04-09,Solano,095,438530,187,118,0,118,2
2020-04-09,Sonoma,097,501317,175,113,0,113,1
2020-04-09,Stanislaus,099,539301,217,93,3,96,0
2020-04-09,Sutter,101,95872,23,17,0,17,2
2020-04-09,Tehama,103,63373,1,1,0,1,0
2020-04-09,Trinity,105,12862,0,0,0,0,0
2020-04-09,Tulare,107,460477,394,147,5,152,9
2020-04-09,Tuolumne,109,53932,2,0,0,0,0
2020-04-09,Ventura,111,848112,435,273,0,273,9
2020-04-09,Yolo,113,214977,122,59,0,59,3
2020-04-09,Yuba,115,75493,14,13,0,13,0
2020-04-08,Alameda,001,1643700,1024,594,1,595,15
2020-04-08,Alpine,003,1148,1,1,0,1,0
2020-04-08,Amador,005,37829,6,2,0,2,0
2020-04-08,Butte,007,227075,18,11,1,12,0
2020-04-08,Calaveras,009,45235,7,5,0,5,0
2020-04-08,Colusa,011,21464,3,3,0,3,0
2020-04-08,Contra Costa,013,1133247,684,481,0,481,7
2020-04-08,Del Norte,015,27424,2,2,0,2,0
2020-04-08,El Dorado,017,186661,46,25,0,25,0
2020-04-08,Fresno,019,978130,408,151,4,155,3
2020-04-08,Glenn,021,27897,4,2,0,2,0
2020-04-08,Humboldt,023,135768,56,40,0,40,0
2020-04-08,Imperial,025,180216,150,59,0,59,2
2020-04-08,Inyo,027,18085,12,11,0,11,0
2020-04-08,Kern,029,883053,550,198,0,198,2
2020-04-08,Kings,031,150075,43,5,1,6,0
2020-04-08,Lake,033,64148,5,1,0,1,0
2020-04-08,Lassen,035,31185,3,0,2,2,0
2020-04-08,Los Angeles,037,10098052,12360,7505,13,7518,196
2020-04-08,Madera,039,155013,62,28,1,29,2
2020-04-08,Marin,041,260295,160,125,1,126,7
2020-04-08,Mariposa,043,17540,0,0,0,0,0
2020-04-08,Mendocino,045,87422,5,4,0,4,0
2020-04-08,Merced,047,269075,82,35,0,35,1
2020-04-08,Modoc,049,8938,0,0,0,0,0
2020-04-08,Mono,051,14174,29,19,0,19,1
2020-04-08,Monterey,053,433212,115,68,1,69,3
2020-04-08,Napa,055,140530,44,21,0,21,2
2020-04-08,Nevada,057,99092,36,21,1,22,1
2020-04-08,Orange,059,3164182,1747,1034,18,1052,19
2020-04-08,Placer,061,380077,141,102,0,102,4
2020-04-08,Plumas,063,18699,4,3,0,3,0
2020-04-08,Riverside,065,2383286,2308,974,13,987,28
2020-04-08,Sacramento,067,1510023,840,565,0,565,21
2020-04-08,San Benito,069,59416,37,31,0,31,2
2020-04-08,San Bernardino,071,2135413,1228,635,0,635,22
2020-04-08,San Diego,073,3302833,2149,1532,0,1532,36
2020-04-08,San Francisco,075,870044,1048,687,0,687,7
2020-04-08,San Joaquin,077,732212,364,211,3,214,12
2020-04-08,San Luis Obispo,079,281455,157,90,1,91,1
2020-04-08,San Mateo,081,765935,882,608,2,610,22
2020-04-08,Santa Barbara,083,443738,320,221,1,222,2
2020-04-08,Santa Clara,085,1922200,1824,1257,4,1261,47
2020-04-08,Santa Cruz,087,273765,96,69,0,69,1
2020-04-08,Shasta,089,179085,30,18,0,18,3
2020-04-08,Sierra,091,2930,0,0,0,0,0
2020-04-08,Siskiyou,093,43540,5,4,0,4,0
2020-04-08,Solano,095,438530,174,111,0,111,2
2020-04-08,Sonoma,097,501317,170,107,0,107,1
2020-04-08,Stanislaus,099,539301,201,86,3,89,0
2020-04-08,Sutter,101,95872,22,17,0,17,2
2020-04-08,Tehama,103,63373,1,1,0,1,0
2020-04-08,Trinity,105,12862,0,0,0,0,0
2020-04-08,Tulare,107,460477,363,145,5,150,6
2020-04-08,Tuolumne,109,53932,2,0,0,0,0
2020-04-08,Ventura,111,848112,426,263,0,263,7
2020-04-08,Yolo,113,214977,105,56,0,56,3
2020-04-08,Yuba,115,75493,14,10,0,10,0
2020-04-07,Alameda,001,1643700,989,560,1,561,14
2020-04-07,Alpine,003,1148,1,1,0,1,0
2020-04-07,Amador,005,37829,6,2,0,2,0
2020-04-07,Butte,007,227075,17,11,1,12,0
2020-04-07,Calaveras,009,45235,6,5,0,5,0
2020-04-07,Colusa,011,21464,3,2,0,2,0
2020-04-07,Contra Costa,013,1133247,664,471,0,471,7
2020-04-07,Del Norte,015,27424,2,2,0,2,0
2020-04-07,El Dorado,017,186661,45,22,0,22,0
2020-04-07,Fresno,019,978130,393,138,4,142,3
2020-04-07,Glenn,021,27897,4,2,0,2,0
2020-04-07,Humboldt,023,135768,55,40,0,40,0
2020-04-07,Imperial,025,180216,132,53,0,53,2
2020-04-07,Inyo,027,18085,12,11,0,11,0
2020-04-07,Kern,029,883053,507,134,0,134,2
2020-04-07,Kings,031,150075,40,5,1,6,0
2020-04-07,Lake,033,64148,4,1,0,1,0
2020-04-07,Lassen,035,31185,3,0,2,2,0
2020-04-07,Los Angeles,037,10098052,11711,6885,13,6898,170
2020-04-07,Madera,039,155013,60,28,0,28,2
2020-04-07,Marin,041,260295,158,122,1,123,7
2020-04-07,Mariposa,043,17540,0,0,0,0,0
2020-04-07,Mendocino,045,87422,5,4,0,4,0
2020-04-07,Merced,047,269075,67,27,0,27,1
2020-04-07,Modoc,049,8938,0,0,0,0,0
2020-04-07,Mono,051,14174,28,18,0,18,1
2020-04-07,Monterey,053,433212,107,63,1,64,2
2020-04-07,Napa,055,140530,42,18,0,18,2
2020-04-07,Nevada,057,99092,36,20,1,21,1
2020-04-07,Orange,059,3164182,1700,971,16,987,19
2020-04-07,Placer,061,380077,136,94,0,94,3
2020-04-07,Plumas,063,18699,4,3,0,3,0
2020-04-07,Riverside,065,2383286,2151,905,13,918,25
2020-04-07,Sacramento,067,1510023,810,513,0,513,18
2020-04-07,San Benito,069,59416,37,26,0,26,2
2020-04-07,San Bernardino,071,2135413,1161,554,0,554,19
2020-04-07,San Diego,073,3302833,2072,1456,0,1456,31
2020-04-07,San Francisco,075,870044,988,636,0,636,6
2020-04-07,San Joaquin,077,732212,346,198,3,201,12
2020-04-07,San Luis Obispo,079,281455,150,87,1,88,1
2020-04-07,San Mateo,081,765935,861,573,2,575,22
2020-04-07,Santa Barbara,083,443738,306,209,1,210,2
2020-04-07,Santa Clara,085,1922200,1755,1193,3,1196,46
2020-04-07,Santa Cruz,087,273765,96,67,0,67,1
2020-04-07,Shasta,089,179085,29,16,0,16,3
2020-04-07,Sierra,091,2930,0,0,0,0,0
2020-04-07,Siskiyou,093,43540,5,4,0,4,0
2020-04-07,Solano,095,438530,169,99,0,99,1
2020-04-07,Sonoma,097,501317,167,102,0,102,1
2020-04-07,Stanislaus,099,539301,184,83,3,86,0
2020-04-07,Sutter,101,95872,22,16,0,16,2
2020-04-07,Tehama,103,63373,1,1,0,1,0
2020-04-07,Trinity,105,12862,0,0,0,0,0
2020-04-07,Tulare,107,460477,334,144,5,149,5
2020-04-07,Tuolumne,109,53932,2,1,0,1,0
2020-04-07,Ventura,111,848112,409,247,0,247,6
2020-04-07,Yolo,113,214977,98,51,0,51,2
2020-04-07,Yuba,115,75493,14,10,0,10,0
2020-04-06,Alameda,001,1643700,959,527,1,528,13
2020-04-06,Alpine,003,1148,1,1,0,1,0
2020-04-06,Amador,005,37829,5,2,0,2,0
2020-04-06,Butte,007,227075,16,11,1,12,0
2020-04-06,Calaveras,009,45235,6,4,0,4,0
2020-04-06,Colusa,011,21464,3,1,0,1,0
2020-04-06,Contra Costa,013,1133247,639,447,0,447,7
2020-04-06,Del Norte,015,27424,2,2,0,2,0
2020-04-06,El Dorado,017,186661,43,23,0,23,0
2020-04-06,Fresno,019,978130,371,122,4,126,1
2020-04-06,Glenn,021,27897,4,2,0,2,0
2020-04-06,Humboldt,023,135768,54,37,0,37,0
2020-04-06,Imperial,025,180216,125,47,0,47,1
2020-04-06,Inyo,027,18085,11,11,0,11,0
2020-04-06,Kern,029,883053,470,117,0,117,2
2020-04-06,Kings,031,150075,40,3,1,4,0
2020-04-06,Lake,033,64148,4,1,0,1,0
2020-04-06,Lassen,035,31185,3,0,2,2,0
2020-04-06,Los Angeles,037,10098052,10978,6346,13,6359,145
2020-04-06,Madera,039,155013,58,29,0,29,2
2020-04-06,Marin,041,260295,155,119,1,120,7
2020-04-06,Mariposa,043,17540,0,0,0,0,0
2020-04-06,Mendocino,045,87422,5,4,0,4,0
2020-04-06,Merced,047,269075,60,25,0,25,1
2020-04-06,Modoc,049,8938,0,0,0,0,0
2020-04-06,Mono,051,14174,28,18,0,18,1
2020-04-06,Monterey,053,433212,102,62,1,63,2
2020-04-06,Napa,055,140530,42,18,0,18,2
2020-04-06,Nevada,057,99092,36,19,1,20,1
2020-04-06,Orange,059,3164182,1656,910,15,925,17
2020-04-06,Placer,061,380077,136,90,0,90,3
2020-04-06,Plumas,063,18699,4,2,0,2,0
2020-04-06,Riverside,065,2383286,2025,854,13,867,17
2020-04-06,Sacramento,067,1510023,780,448,0,448,15
2020-04-06,San Benito,069,59416,35,25,0,25,1
2020-04-06,San Bernardino,071,2135413,1102,550,0,550,13
2020-04-06,San Diego,073,3302833,1990,1406,0,1406,19
2020-04-06,San Francisco,075,870044,948,586,0,586,6
2020-04-06,San Joaquin,077,732212,331,191,3,194,10
2020-04-06,San Luis Obispo,079,281455,148,85,1,86,1
2020-04-06,San Mateo,081,765935,843,569,2,571,20
2020-04-06,Santa Barbara,083,443738,297,189,1,190,2
2020-04-06,Santa Clara,085,1922200,1702,1128,3,1131,43
2020-04-06,Santa Cruz,087,273765,94,65,0,65,1
2020-04-06,Shasta,089,179085,29,16,0,16,3
2020-04-06,Sierra,091,2930,0,0,0,0,0
2020-04-06,Siskiyou,093,43540,4,4,0,4,0
2020-04-06,Solano,095,438530,162,95,0,95,1
2020-04-06,Sonoma,097,501317,166,102,0,102,1
2020-04-06,Stanislaus,099,539301,168,72,3,75,0
2020-04-06,Sutter,101,95872,22,14,0,14,2
2020-04-06,Tehama,103,63373,1,1,0,1,0
2020-04-06,Trinity,105,12862,0,0,0,0,0
2020-04-06,Tulare,107,460477,318,126,5,131,5
2020-04-06,Tuolumne,109,53932,2,1,0,1,0
2020-04-06,Ventura,111,848112,391,234,0,234,6
2020-04-06,Yolo,113,214977,94,43,0,43,1
2020-04-06,Yuba,115,75493,14,8,0,8,0
2020-04-05,Alameda,001,1643700,917,475,1,476,12
2020-04-05,Alpine,003,1148,1,1,0,1,0
2020-04-05,Amador,005,37829,5,2,0,2,0
2020-04-05,Butte,007,227075,16,10,1,11,0
2020-04-05,Calaveras,009,45235,6,3,0,3,0
2020-04-05,Colusa,011,21464,3,1,0,1,0
2020-04-05,Contra Costa,013,1133247,622,415,0,415,6
2020-04-05,Del Norte,015,27424,2,1,0,1,0
2020-04-05,El Dorado,017,186661,41,19,0,19,0
2020-04-05,Fresno,019,978130,337,102,4,106,1
2020-04-05,Glenn,021,27897,4,2,0,2,0
2020-04-05,Humboldt,023,135768,54,29,0,29,0
2020-04-05,Imperial,025,180216,117,42,0,42,1
2020-04-05,Inyo,027,18085,11,10,0,10,0
2020-04-05,Kern,029,883053,415,109,0,109,2
2020-04-05,Kings,031,150075,39,4,1,5,0
2020-04-05,Lake,033,64148,4,0,0,0,0
2020-04-05,Lassen,035,31185,3,0,2,2,0
2020-04-05,Los Angeles,037,10098052,10406,5892,13,5905,130
2020-04-05,Madera,039,155013,57,27,0,27,2
2020-04-05,Marin,041,260295,155,113,1,114,6
2020-04-05,Mariposa,043,17540,0,0,0,0,0
2020-04-05,Mendocino,045,87422,5,4,0,4,0
2020-04-05,Merced,047,269075,53,16,0,16,0
2020-04-05,Modoc,049,8938,0,0,0,0,0
2020-04-05,Mono,051,14174,28,18,0,18,1
2020-04-05,Monterey,053,433212,95,61,1,62,2
2020-04-05,Napa,055,140530,40,15,0,15,2
2020-04-05,Nevada,057,99092,36,19,1,20,1
2020-04-05,Orange,059,3164182,1599,820,15,835,15
2020-04-05,Placer,061,380077,133,86,0,86,3
2020-04-05,Plumas,063,18699,3,2,0,2,0
2020-04-05,Riverside,065,2383286,1896,669,13,682,17
2020-04-05,Sacramento,067,1510023,749,393,0,393,11
2020-04-05,San Benito,069,59416,35,22,0,22,1
2020-04-05,San Bernardino,071,2135413,1028,375,0,375,13
2020-04-05,San Diego,073,3302833,1908,1328,0,1328,19
2020-04-05,San Francisco,075,870044,901,559,0,559,6
2020-04-05,San Joaquin,077,732212,316,179,3,182,10
2020-04-05,San Luis Obispo,079,281455,146,83,1,84,1
2020-04-05,San Mateo,081,765935,823,528,2,530,19
2020-04-05,Santa Barbara,083,443738,281,171,1,172,1
2020-04-05,Santa Clara,085,1922200,1654,1052,3,1055,42
2020-04-05,Santa Cruz,087,273765,94,59,0,59,1
2020-04-05,Shasta,089,179085,28,11,0,11,2
2020-04-05,Sierra,091,2930,0,0,0,0,0
2020-04-05,Siskiyou,093,43540,4,3,0,3,0
2020-04-05,Solano,095,438530,158,78,0,78,1
2020-04-05,Sonoma,097,501317,164,88,0,88,1
2020-04-05,Stanislaus,099,539301,154,51,3,54,0
2020-04-05,Sutter,101,95872,22,14,0,14,1
2020-04-05,Tehama,103,63373,1,1,0,1,0
2020-04-05,Trinity,105,12862,0,0,0,0,0
2020-04-05,Tulare,107,460477,281,81,5,86,4
2020-04-05,Tuolumne,109,53932,2,1,0,1,0
2020-04-05,Ventura,111,848112,377,196,0,196,6
2020-04-05,Yolo,113,214977,76,37,0,37,2
2020-04-05,Yuba,115,75493,14,7,0,7,0
2020-04-04,Alameda,001,1643700,894,468,1,469,12
2020-04-04,Alpine,003,1148,1,1,0,1,0
2020-04-04,Amador,005,37829,4,2,0,2,0
2020-04-04,Butte,007,227075,16,10,1,11,0
2020-04-04,Calaveras,009,45235,6,3,0,3,0
2020-04-04,Colusa,011,21464,3,1,0,1,0
2020-04-04,Contra Costa,013,1133247,614,382,0,382,5
2020-04-04,Del Norte,015,27424,2,1,0,1,0
2020-04-04,El Dorado,017,186661,41,19,0,19,0
2020-04-04,Fresno,019,978130,327,102,4,106,1
2020-04-04,Glenn,021,27897,4,2,0,2,0
2020-04-04,Humboldt,023,135768,54,29,0,29,0
2020-04-04,Imperial,025,180216,116,42,0,42,1
2020-04-04,Inyo,027,18085,11,10,0,10,0
2020-04-04,Kern,029,883053,385,103,0,103,2
2020-04-04,Kings,031,150075,39,3,1,4,0
2020-04-04,Lake,033,64148,4,0,0,0,0
2020-04-04,Lassen,035,31185,3,0,2,2,0
2020-04-04,Los Angeles,037,10098052,9790,5275,13,5288,117
2020-04-04,Madera,039,155013,55,27,0,27,2
2020-04-04,Marin,041,260295,153,111,0,111,6
2020-04-04,Mariposa,043,17540,0,0,0,0,0
2020-04-04,Mendocino,045,87422,5,4,0,4,0
2020-04-04,Merced,047,269075,49,11,0,11,0
2020-04-04,Modoc,049,8938,0,0,0,0,0
2020-04-04,Mono,051,14174,28,18,0,18,1
2020-04-04,Monterey,053,433212,91,61,1,62,2
2020-04-04,Napa,055,140530,40,15,0,15,2
2020-04-04,Nevada,057,99092,36,19,1,20,1
2020-04-04,Orange,059,3164182,1557,781,14,795,15
2020-04-04,Placer,061,380077,132,87,0,87,2
2020-04-04,Plumas,063,18699,3,2,0,2,0
2020-04-04,Riverside,065,2383286,1795,652,13,665,15
2020-04-04,Sacramento,067,1510023,731,393,0,393,11
2020-04-04,San Benito,069,59416,35,22,0,22,1
2020-04-04,San Bernardino,071,2135413,980,373,0,373,13
2020-04-04,San Diego,073,3302833,1860,1211,0,1211,18
2020-04-04,San Francisco,075,870044,863,537,0,537,6
2020-04-04,San Joaquin,077,732212,293,171,3,174,10
2020-04-04,San Luis Obispo,079,281455,146,82,1,83,0
2020-04-04,San Mateo,081,765935,812,520,2,522,17
2020-04-04,Santa Barbara,083,443738,272,167,1,168,1
2020-04-04,Santa Clara,085,1922200,1602,1045,3,1048,39
2020-04-04,Santa Cruz,087,273765,94,56,0,56,1
2020-04-04,Shasta,089,179085,27,11,0,11,2
2020-04-04,Sierra,091,2930,0,0,0,0,0
2020-04-04,Siskiyou,093,43540,4,3,0,3,0
2020-04-04,Solano,095,438530,153,79,0,79,1
2020-04-04,Sonoma,097,501317,161,88,0,88,1
2020-04-04,Stanislaus,099,539301,143,51,3,54,0
2020-04-04,Sutter,101,95872,22,14,0,14,1
2020-04-04,Tehama,103,63373,1,1,0,1,0
2020-04-04,Trinity,105,12862,0,0,0,0,0
2020-04-04,Tulare,107,460477,267,79,5,84,4
2020-04-04,Tuolumne,109,53932,2,1,0,1,0
2020-04-04,Ventura,111,848112,364,194,0,194,6
2020-04-04,Yolo,113,214977,74,40,0,40,2
2020-04-04,Yuba,115,75493,13,7,0,7,0
2020-04-03,Alameda,001,1643700,858,395,1,396,11
2020-04-03,Alpine,003,1148,1,1,0,1,0
2020-04-03,Amador,005,37829,4,2,0,2,0
2020-04-03,Butte,007,227075,16,8,1,9,0
2020-04-03,Calaveras,009,45235,6,3,0,3,0
2020-04-03,Colusa,011,21464,3,1,0,1,0
2020-04-03,Contra Costa,013,1133247,591,327,0,327,5
2020-04-03,Del Norte,015,27424,2,1,0,1,0
2020-04-03,El Dorado,017,186661,39,16,0,16,0
2020-04-03,Fresno,019,978130,315,98,4,102,1
2020-04-03,Glenn,021,27897,4,2,0,2,0
2020-04-03,Humboldt,023,135768,54,34,0,34,0
2020-04-03,Imperial,025,180216,107,35,0,35,0
2020-04-03,Inyo,027,18085,11,10,0,10,0
2020-04-03,Kern,029,883053,359,87,0,87,1
2020-04-03,Kings,031,150075,37,3,1,4,0
2020-04-03,Lake,033,64148,3,0,0,0,0
2020-04-03,Lassen,035,31185,3,0,2,2,0
2020-04-03,Los Angeles,037,10098052,9175,4566,13,4579,91
2020-04-03,Madera,039,155013,54,28,0,28,2
2020-04-03,Marin,041,260295,151,106,0,106,6
2020-04-03,Mariposa,043,17540,0,0,0,0,0
2020-04-03,Mendocino,045,87422,5,4,0,4,0
2020-04-03,Merced,047,269075,46,9,0,9,0
2020-04-03,Modoc,049,8938,0,0,0,0,0
2020-04-03,Mono,051,14174,28,18,0,18,1
2020-04-03,Monterey,053,433212,88,58,1,59,2
2020-04-03,Napa,055,140530,39,13,0,13,1
2020-04-03,Nevada,057,99092,36,19,1,20,1
2020-04-03,Orange,059,3164182,1518,713,14,727,13
2020-04-03,Placer,061,380077,128,76,0,76,2
2020-04-03,Plumas,063,18699,3,2,0,2,0
2020-04-03,Riverside,065,2383286,1715,540,13,553,14
2020-04-03,Sacramento,067,1510023,710,363,0,363,11
2020-04-03,San Benito,069,59416,35,22,0,22,1
2020-04-03,San Bernardino,071,2135413,935,356,0,356,11
2020-04-03,San Diego,073,3302833,1800,1114,0,1114,17
2020-04-03,San Francisco,075,870044,839,506,0,506,6
2020-04-03,San Joaquin,077,732212,281,162,3,165,10
2020-04-03,San Luis Obispo,079,281455,145,82,1,83,0
2020-04-03,San Mateo,081,765935,795,474,2,476,13
2020-04-03,Santa Barbara,083,443738,261,154,1,155,1
2020-04-03,Santa Clara,085,1922200,1566,983,3,986,39
2020-04-03,Santa Cruz,087,273765,94,52,0,52,1
2020-04-03,Shasta,089,179085,27,10,0,10,1
2020-04-03,Sierra,091,2930,0,0,0,0,0
2020-04-03,Siskiyou,093,43540,4,3,0,3,0
2020-04-03,Solano,095,438530,145,72,0,72,1
2020-04-03,Sonoma,097,501317,161,84,0,84,1
2020-04-03,Stanislaus,099,539301,137,48,3,51,0
2020-04-03,Sutter,101,95872,22,12,0,12,1
2020-04-03,Tehama,103,63373,1,1,0,1,0
2020-04-03,Trinity,105,12862,0,0,0,0,0
2020-04-03,Tulare,107,460477,253,73,5,78,3
2020-04-03,Tuolumne,109,53932,2,1,0,1,0
2020-04-03,Ventura,111,848112,354,186,0,186,6
2020-04-03,Yolo,113,214977,73,33,0,33,1
2020-04-03,Yuba,115,75493,13,6,0,6,0
2020-04-02,Alameda,001,1643700,807,345,1,346,10
2020-04-02,Alpine,003,1148,1,1,0,1,0
2020-04-02,Amador,005,37829,4,2,0,2,0
2020-04-02,Butte,007,227075,16,7,0,7,0
2020-04-02,Calaveras,009,45235,4,3,0,3,0
2020-04-02,Colusa,011,21464,3,1,0,1,0
2020-04-02,Contra Costa,013,1133247,561,297,0,297,3
2020-04-02,Del Norte,015,27424,2,0,0,0,0
2020-04-02,El Dorado,017,186661,37,16,0,16,0
2020-04-02,Fresno,019,978130,299,92,4,96,0
2020-04-02,Glenn,021,27897,3,2,0,2,0
2020-04-02,Humboldt,023,135768,50,23,0,23,0
2020-04-02,Imperial,025,180216,103,24,0,24,0
2020-04-02,Inyo,027,18085,10,8,0,8,0
2020-04-02,Kern,029,883053,332,74,0,74,0
2020-04-02,Kings,031,150075,37,3,1,4,0
2020-04-02,Lake,033,64148,3,0,0,0,0
2020-04-02,Lassen,035,31185,3,0,2,2,0
2020-04-02,Los Angeles,037,10098052,8343,4040,13,4053,79
2020-04-02,Madera,039,155013,52,25,0,25,1
2020-04-02,Marin,041,260295,145,102,0,102,1
2020-04-02,Mariposa,043,17540,0,0,0,0,0
2020-04-02,Mendocino,045,87422,5,4,0,4,0
2020-04-02,Merced,047,269075,41,9,0,9,0
2020-04-02,Modoc,049,8938,0,0,0,0,0
2020-04-02,Mono,051,14174,28,16,0,16,1
2020-04-02,Monterey,053,433212,86,50,1,51,2
2020-04-02,Napa,055,140530,39,13,0,13,0
2020-04-02,Nevada,057,99092,35,17,1,18,0
2020-04-02,Orange,059,3164182,1466,640,13,653,12
2020-04-02,Placer,061,380077,127,72,0,72,2
2020-04-02,Plumas,063,18699,3,1,0,1,0
2020-04-02,Riverside,065,2383286,1598,438,13,451,13
2020-04-02,Sacramento,067,1510023,692,322,0,322,9
2020-04-02,San Benito,069,59416,33,18,0,18,1
2020-04-02,San Bernardino,071,2135413,880,335,0,335,8
2020-04-02,San Diego,073,3302833,1733,968,0,968,16
2020-04-02,San Francisco,075,870044,812,473,0,473,6
2020-04-02,San Joaquin,077,732212,262,148,3,151,9
2020-04-02,San Luis Obispo,079,281455,140,79,1,80,0
2020-04-02,San Mateo,081,765935,774,423,2,425,13
2020-04-02,Santa Barbara,083,443738,250,125,1,126,1
2020-04-02,Santa Clara,085,1922200,1515,908,3,911,38
2020-04-02,Santa Cruz,087,273765,92,49,0,49,1
2020-04-02,Shasta,089,179085,26,7,0,7,1
2020-04-02,Sierra,091,2930,0,0,0,0,0
2020-04-02,Siskiyou,093,43540,4,3,0,3,0
2020-04-02,Solano,095,438530,135,65,0,65,0
2020-04-02,Sonoma,097,501317,157,76,0,76,1
2020-04-02,Stanislaus,099,539301,126,40,3,43,0
2020-04-02,Sutter,101,95872,21,10,0,10,1
2020-04-02,Tehama,103,63373,1,1,0,1,0
2020-04-02,Trinity,105,12862,0,0,0,0,0
2020-04-02,Tulare,107,460477,219,64,5,69,1
2020-04-02,Tuolumne,109,53932,2,1,0,1,0
2020-04-02,Ventura,111,848112,336,178,0,178,5
2020-04-02,Yolo,113,214977,71,29,0,29,1
2020-04-02,Yuba,115,75493,10,5,0,5,0
2020-04-01,Alameda,001,1643700,780,287,1,288,8
2020-04-01,Alpine,003,1148,1,1,0,1,0
2020-04-01,Amador,005,37829,4,1,0,1,0
2020-04-01,Butte,007,227075,16,6,0,6,0
2020-04-01,Calaveras,009,45235,3,3,0,3,0
2020-04-01,Colusa,011,21464,3,1,0,1,0
2020-04-01,Contra Costa,013,1133247,517,267,0,267,3
2020-04-01,Del Norte,015,27424,2,0,0,0,0
2020-04-01,El Dorado,017,186661,36,14,0,14,0
2020-04-01,Fresno,019,978130,277,75,3,78,0
2020-04-01,Glenn,021,27897,3,2,0,2,0
2020-04-01,Humboldt,023,135768,50,19,0,19,0
2020-04-01,Imperial,025,180216,96,25,0,25,0
2020-04-01,Inyo,027,18085,10,8,0,8,0
2020-04-01,Kern,029,883053,305,53,0,53,0
2020-04-01,Kings,031,150075,35,3,1,4,0
2020-04-01,Lake,033,64148,3,0,0,0,0
2020-04-01,Lassen,035,31185,3,0,2,2,0
2020-04-01,Los Angeles,037,10098052,7693,3502,13,3515,66
2020-04-01,Madera,039,155013,50,17,0,17,1
2020-04-01,Marin,041,260295,141,87,0,87,1
2020-04-01,Mariposa,043,17540,0,0,0,0,0
2020-04-01,Mendocino,045,87422,5,4,0,4,0
2020-04-01,Merced,047,269075,38,7,0,7,0
2020-04-01,Modoc,049,8938,0,0,0,0,0
2020-04-01,Mono,051,14174,28,12,0,12,1
2020-04-01,Monterey,053,433212,85,47,1,48,2
2020-04-01,Napa,055,140530,36,11,0,11,0
2020-04-01,Nevada,057,99092,35,15,1,16,0
2020-04-01,Orange,059,3164182,1414,579,13,592,11
2020-04-01,Placer,061,380077,125,52,0,52,2
2020-04-01,Plumas,063,18699,3,1,0,1,0
2020-04-01,Riverside,065,2383286,1430,306,12,318,11
2020-04-01,Sacramento,067,1510023,659,299,0,299,8
2020-04-01,San Benito,069,59416,30,14,0,14,1
2020-04-01,San Bernardino,071,2135413,831,245,0,245,5
2020-04-01,San Diego,073,3302833,1663,851,0,851,11
2020-04-01,San Francisco,075,870044,784,432,0,432,6
2020-04-01,San Joaquin,077,732212,250,132,3,135,8
2020-04-01,San Luis Obispo,079,281455,134,69,1,70,0
2020-04-01,San Mateo,081,765935,756,354,2,356,13
2020-04-01,Santa Barbara,083,443738,237,103,1,104,0
2020-04-01,Santa Clara,085,1922200,1473,805,3,808,33
2020-04-01,Santa Cruz,087,273765,87,44,0,44,1
2020-04-01,Shasta,089,179085,25,5,0,5,1
2020-04-01,Sierra,091,2930,0,0,0,0,0
2020-04-01,Siskiyou,093,43540,4,3,0,3,0
2020-04-01,Solano,095,438530,130,57,0,57,0
2020-04-01,Sonoma,097,501317,153,60,0,60,1
2020-04-01,Stanislaus,099,539301,115,29,3,32,0
2020-04-01,Sutter,101,95872,21,9,0,9,1
2020-04-01,Tehama,103,63373,1,0,0,0,0
2020-04-01,Trinity,105,12862,0,0,0,0,0
2020-04-01,Tulare,107,460477,181,43,5,48,1
2020-04-01,Tuolumne,109,53932,2,1,0,1,0
2020-04-01,Ventura,111,848112,323,154,0,154,5
2020-04-01,Yolo,113,214977,66,22,0,22,1
2020-04-01,Yuba,115,75493,9,5,0,5,0
2020-03-31,Alameda,001,1643700,712,269,1,270,7
2020-03-31,Alpine,003,1148,1,1,0,1,0
2020-03-31,Amador,005,37829,4,1,0,1,0
2020-03-31,Butte,007,227075,16,6,0,6,0
2020-03-31,Calaveras,009,45235,3,3,0,3,0
2020-03-31,Colusa,011,21464,3,1,0,1,0
2020-03-31,Contra Costa,013,1133247,492,246,0,246,3
2020-03-31,Del Norte,015,27424,1,0,0,0,0
2020-03-31,El Dorado,017,186661,32,14,0,14,0
2020-03-31,Fresno,019,978130,252,59,3,62,0
2020-03-31,Glenn,021,27897,3,2,0,2,0
2020-03-31,Humboldt,023,135768,50,18,0,18,0
2020-03-31,Imperial,025,180216,91,17,0,17,0
2020-03-31,Inyo,027,18085,10,8,0,8,0
2020-03-31,Kern,029,883053,281,47,0,47,0
2020-03-31,Kings,031,150075,33,2,1,3,0
2020-03-31,Lake,033,64148,1,0,0,0,0
2020-03-31,Lassen,035,31185,3,0,2,2,0
2020-03-31,Los Angeles,037,10098052,7028,3001,13,3014,53
2020-03-31,Madera,039,155013,49,17,0,17,1
2020-03-31,Marin,041,260295,132,85,0,85,1
2020-03-31,Mariposa,043,17540,0,0,0,0,0
2020-03-31,Mendocino,045,87422,5,4,0,4,0
2020-03-31,Merced,047,269075,33,6,0,6,0
2020-03-31,Modoc,049,8938,0,0,0,0,0
2020-03-31,Mono,051,14174,26,12,0,12,0
2020-03-31,Monterey,053,433212,83,43,1,44,2
2020-03-31,Napa,055,140530,35,9,0,9,0
2020-03-31,Nevada,057,99092,35,15,1,16,0
2020-03-31,Orange,059,3164182,1344,506,13,519,7
2020-03-31,Placer,061,380077,118,49,0,49,2
2020-03-31,Plumas,063,18699,1,0,0,0,0
2020-03-31,Riverside,065,2383286,1284,284,12,296,8
2020-03-31,Sacramento,067,1510023,607,271,0,271,8
2020-03-31,San Benito,069,59416,30,14,0,14,1
2020-03-31,San Bernardino,071,2135413,746,193,0,193,5
2020-03-31,San Diego,073,3302833,1581,736,0,736,9
2020-03-31,San Francisco,075,870044,749,404,0,404,5
2020-03-31,San Joaquin,077,732212,234,122,3,125,7
2020-03-31,San Luis Obispo,079,281455,130,67,1,68,0
2020-03-31,San Mateo,081,765935,737,297,2,299,12
2020-03-31,Santa Barbara,083,443738,222,89,1,90,0
2020-03-31,Santa Clara,085,1922200,1423,777,3,780,30
2020-03-31,Santa Cruz,087,273765,80,40,0,40,1
2020-03-31,Shasta,089,179085,22,5,0,5,1
2020-03-31,Sierra,091,2930,0,0,0,0,0
2020-03-31,Siskiyou,093,43540,4,3,0,3,0
2020-03-31,Solano,095,438530,116,56,0,56,0
2020-03-31,Sonoma,097,501317,148,58,0,58,1
2020-03-31,Stanislaus,099,539301,100,28,3,31,0
2020-03-31,Sutter,101,95872,21,8,0,8,0
2020-03-31,Tehama,103,63373,1,0,0,0,0
2020-03-31,Trinity,105,12862,0,0,0,0,0
2020-03-31,Tulare,107,460477,158,42,4,46,1
2020-03-31,Tuolumne,109,53932,2,1,0,1,0
2020-03-31,Ventura,111,848112,312,143,0,143,4
2020-03-31,Yolo,113,214977,59,21,0,21,1
2020-03-31,Yuba,115,75493,9,5,0,5,0
2020-03-30,Alameda,001,1643700,672,250,1,251,7
2020-03-30,Alpine,003,1148,1,1,0,1,0
2020-03-30,Amador,005,37829,4,1,0,1,0
2020-03-30,Butte,007,227075,14,5,0,5,0
2020-03-30,Calaveras,009,45235,3,3,0,3,0
2020-03-30,Colusa,011,21464,3,1,0,1,0
2020-03-30,Contra Costa,013,1133247,466,212,0,212,3
2020-03-30,Del Norte,015,27424,0,0,0,0,0
2020-03-30,El Dorado,017,186661,32,11,0,11,0
2020-03-30,Fresno,019,978130,227,46,3,49,0
2020-03-30,Glenn,021,27897,3,2,0,2,0
2020-03-30,Humboldt,023,135768,48,11,0,11,0
2020-03-30,Imperial,025,180216,88,9,0,9,0
2020-03-30,Inyo,027,18085,10,5,0,5,0
2020-03-30,Kern,029,883053,248,30,0,30,0
2020-03-30,Kings,031,150075,33,1,1,2,0
2020-03-30,Lake,033,64148,1,0,0,0,0
2020-03-30,Lassen,035,31185,3,0,1,1,0
2020-03-30,Los Angeles,037,10098052,6373,2467,13,2480,44
2020-03-30,Madera,039,155013,48,14,0,14,1
2020-03-30,Marin,041,260295,125,78,0,78,0
2020-03-30,Mariposa,043,17540,0,0,0,0,0
2020-03-30,Mendocino,045,87422,5,2,0,2,0
2020-03-30,Merced,047,269075,29,6,0,6,0
2020-03-30,Modoc,049,8938,0,0,0,0,0
2020-03-30,Mono,051,14174,26,11,0,11,0
2020-03-30,Monterey,053,433212,78,41,1,42,1
2020-03-30,Napa,055,140530,34,9,0,9,0
2020-03-30,Nevada,057,99092,34,14,1,15,0
2020-03-30,Orange,059,3164182,1278,418,13,431,5
2020-03-30,Placer,061,380077,115,44,0,44,2
2020-03-30,Plumas,063,18699,1,0,0,0,0
2020-03-30,Riverside,065,2383286,1203,204,12,216,7
2020-03-30,Sacramento,067,1510023,583,238,0,238,8
2020-03-30,San Benito,069,59416,30,11,0,11,1
2020-03-30,San Bernardino,071,2135413,702,145,0,145,4
2020-03-30,San Diego,073,3302833,1511,605,0,605,7
2020-03-30,San Francisco,075,870044,709,368,0,368,5
2020-03-30,San Joaquin,077,732212,227,112,3,115,5
2020-03-30,San Luis Obispo,079,281455,127,62,1,63,0
2020-03-30,San Mateo,081,765935,713,257,2,259,11
2020-03-30,Santa Barbara,083,443738,213,79,1,80,0
2020-03-30,Santa Clara,085,1922200,1392,745,3,748,31
2020-03-30,Santa Cruz,087,273765,77,36,0,36,1
2020-03-30,Shasta,089,179085,21,4,0,4,1
2020-03-30,Sierra,091,2930,0,0,0,0,0
2020-03-30,Siskiyou,093,43540,4,2,0,2,0
2020-03-30,Solano,095,438530,110,50,0,50,0
2020-03-30,Sonoma,097,501317,145,57,0,57,1
2020-03-30,Stanislaus,099,539301,93,28,3,31,0
2020-03-30,Sutter,101,95872,20,6,0,6,0
2020-03-30,Tehama,103,63373,1,0,0,0,0
2020-03-30,Trinity,105,12862,0,0,0,0,0
2020-03-30,Tulare,107,460477,146,40,3,43,1
2020-03-30,Tuolumne,109,53932,2,1,0,1,0
2020-03-30,Ventura,111,848112,301,118,0,118,2
2020-03-30,Yolo,113,214977,56,17,0,17,1
2020-03-30,Yuba,115,75493,8,5,0,5,0
2020-03-29,Alameda,001,1643700,638,207,1,208,6
2020-03-29,Alpine,003,1148,1,0,0,0,0
2020-03-29,Amador,005,37829,4,1,0,1,0
2020-03-29,Butte,007,227075,14,4,0,4,0
2020-03-29,Calaveras,009,45235,3,2,0,2,0
2020-03-29,Colusa,011,21464,3,1,0,1,0
2020-03-29,Contra Costa,013,1133247,436,187,0,187,3
2020-03-29,Del Norte,015,27424,0,0,0,0,0
2020-03-29,El Dorado,017,186661,31,9,0,9,0
2020-03-29,Fresno,019,978130,203,31,3,34,0
2020-03-29,Glenn,021,27897,2,1,0,1,0
2020-03-29,Humboldt,023,135768,45,9,0,9,0
2020-03-29,Imperial,025,180216,82,9,0,9,0
2020-03-29,Inyo,027,18085,9,0,0,0,0
2020-03-29,Kern,029,883053,230,20,0,20,0
2020-03-29,Kings,031,150075,30,1,1,2,0
2020-03-29,Lake,033,64148,0,0,0,0,0
2020-03-29,Lassen,035,31185,3,0,1,1,0
2020-03-29,Los Angeles,037,10098052,5728,2119,13,2132,37
2020-03-29,Madera,039,155013,43,11,0,11,1
2020-03-29,Marin,041,260295,120,60,0,60,0
2020-03-29,Mariposa,043,17540,0,0,0,0,0
2020-03-29,Mendocino,045,87422,5,2,0,2,0
2020-03-29,Merced,047,269075,28,4,0,4,0
2020-03-29,Modoc,049,8938,0,0,0,0,0
2020-03-29,Mono,051,14174,26,8,0,8,0
2020-03-29,Monterey,053,433212,73,36,1,37,1
2020-03-29,Napa,055,140530,32,5,0,5,0
2020-03-29,Nevada,057,99092,32,13,1,14,0
2020-03-29,Orange,059,3164182,1205,343,13,356,2
2020-03-29,Placer,061,380077,114,35,0,35,2
2020-03-29,Plumas,063,18699,1,0,0,0,0
2020-03-29,Riverside,065,2383286,1079,122,12,134,7
2020-03-29,Sacramento,067,1510023,543,217,0,217,7
2020-03-29,San Benito,069,59416,29,10,0,10,1
2020-03-29,San Bernardino,071,2135413,650,94,0,94,2
2020-03-29,San Diego,073,3302833,1439,521,0,521,7
2020-03-29,San Francisco,075,870044,665,333,0,333,5
2020-03-29,San Joaquin,077,732212,218,86,3,89,4
2020-03-29,San Luis Obispo,079,281455,120,55,0,55,0
2020-03-29,San Mateo,081,765935,688,234,2,236,12
2020-03-29,Santa Barbara,083,443738,205,52,1,53,0
2020-03-29,Santa Clara,085,1922200,1335,591,3,594,30
2020-03-29,Santa Cruz,087,273765,77,33,0,33,1
2020-03-29,Shasta,089,179085,20,4,0,4,1
2020-03-29,Sierra,091,2930,0,0,0,0,0
2020-03-29,Siskiyou,093,43540,4,2,0,2,0
2020-03-29,Solano,095,438530,102,48,0,48,0
2020-03-29,Sonoma,097,501317,143,35,0,35,1
2020-03-29,Stanislaus,099,539301,88,19,3,22,0
2020-03-29,Sutter,101,95872,17,6,0,6,0
2020-03-29,Tehama,103,63373,1,0,0,0,0
2020-03-29,Trinity,105,12862,0,0,0,0,0
2020-03-29,Tulare,107,460477,121,24,3,27,1
2020-03-29,Tuolumne,109,53932,1,1,0,1,0
2020-03-29,Ventura,111,848112,274,92,0,92,2
2020-03-29,Yolo,113,214977,51,13,0,13,1
2020-03-29,Yuba,115,75493,8,3,0,3,0
2020-03-28,Alameda,001,1643700,611,410,1,411,12
2020-03-28,Alpine,003,1148,1,0,0,0,0
2020-03-28,Amador,005,37829,4,2,0,2,0
2020-03-28,Butte,007,227075,14,8,0,8,0
2020-03-28,Calaveras,009,45235,3,4,0,4,0
2020-03-28,Colusa,011,21464,3,2,0,2,0
2020-03-28,Contra Costa,013,1133247,413,350,0,350,4
2020-03-28,Del Norte,015,27424,0,0,0,0,0
2020-03-28,El Dorado,017,186661,30,18,0,18,0
2020-03-28,Fresno,019,978130,193,62,3,65,0
2020-03-28,Glenn,021,27897,2,2,0,2,0
2020-03-28,Humboldt,023,135768,45,18,0,18,0
2020-03-28,Imperial,025,180216,77,18,0,18,0
2020-03-28,Inyo,027,18085,9,0,0,0,0
2020-03-28,Kern,029,883053,213,40,0,40,0
2020-03-28,Kings,031,150075,29,2,1,3,0
2020-03-28,Lake,033,64148,0,0,0,0,0
2020-03-28,Lassen,035,31185,3,0,1,1,0
2020-03-28,Los Angeles,037,10098052,5342,3600,12,3612,64
2020-03-28,Madera,039,155013,43,22,0,22,2
2020-03-28,Marin,041,260295,115,116,0,116,0
2020-03-28,Mariposa,043,17540,0,0,0,0,0
2020-03-28,Mendocino,045,87422,5,4,0,4,0
2020-03-28,Merced,047,269075,27,8,0,8,0
2020-03-28,Modoc,049,8938,0,0,0,0,0
2020-03-28,Mono,051,14174,24,12,0,12,0
2020-03-28,Monterey,053,433212,72,64,1,65,2
2020-03-28,Napa,055,140530,27,10,0,10,0
2020-03-28,Nevada,057,99092,32,22,1,23,0
2020-03-28,Orange,059,3164182,1169,656,13,669,4
2020-03-28,Placer,061,380077,109,70,0,70,2
2020-03-28,Plumas,063,18699,1,0,0,0,0
2020-03-28,Riverside,065,2383286,1011,242,12,254,14
2020-03-28,Sacramento,067,1510023,525,406,0,406,14
2020-03-28,San Benito,069,59416,29,20,0,20,2
2020-03-28,San Bernardino,071,2135413,602,162,0,162,4
2020-03-28,San Diego,073,3302833,1380,980,0,980,14
2020-03-28,San Francisco,075,870044,641,600,0,600,6
2020-03-28,San Joaquin,077,732212,210,166,3,169,8
2020-03-28,San Luis Obispo,079,281455,118,104,0,104,0
2020-03-28,San Mateo,081,765935,668,462,2,464,17
2020-03-28,Santa Barbara,083,443738,195,98,1,99,0
2020-03-28,Santa Clara,085,1922200,1316,1174,3,1177,54
2020-03-28,Santa Cruz,087,273765,76,62,0,62,0
2020-03-28,Shasta,089,179085,20,8,0,8,2
2020-03-28,Sierra,091,2930,0,0,0,0,0
2020-03-28,Siskiyou,093,43540,4,4,0,4,0
2020-03-28,Solano,095,438530,98,96,0,96,0
2020-03-28,Sonoma,097,501317,141,70,0,70,2
2020-03-28,Stanislaus,099,539301,83,34,3,37,0
2020-03-28,Sutter,101,95872,17,6,0,6,0
2020-03-28,Tehama,103,63373,1,0,0,0,0
2020-03-28,Trinity,105,12862,0,0,0,0,0
2020-03-28,Tulare,107,460477,114,46,3,49,0
2020-03-28,Tuolumne,109,53932,1,2,0,2,0
2020-03-28,Ventura,111,848112,270,178,0,178,4
2020-03-28,Yolo,113,214977,50,26,0,26,2
2020-03-28,Yuba,115,75493,8,6,0,6,0
2020-03-27,Alameda,001,1643700,593,185,1,186,4
2020-03-27,Alpine,003,1148,1,0,0,0,0
2020-03-27,Amador,005,37829,3,1,0,1,0
2020-03-27,Butte,007,227075,12,4,0,4,0
2020-03-27,Calaveras,009,45235,3,2,0,2,0
2020-03-27,Colusa,011,21464,3,0,0,0,0
2020-03-27,Contra Costa,013,1133247,392,161,0,161,2
2020-03-27,Del Norte,015,27424,0,0,0,0,0
2020-03-27,El Dorado,017,186661,28,9,0,9,0
2020-03-27,Fresno,019,978130,181,29,2,31,0
2020-03-27,Glenn,021,27897,2,0,0,0,0
2020-03-27,Humboldt,023,135768,41,9,0,9,0
2020-03-27,Imperial,025,180216,72,9,0,9,0
2020-03-27,Inyo,027,18085,9,0,0,0,0
2020-03-27,Kern,029,883053,200,20,0,20,0
2020-03-27,Kings,031,150075,28,0,1,1,0
2020-03-27,Lake,033,64148,0,0,0,0,0
2020-03-27,Lassen,035,31185,3,0,1,1,0
2020-03-27,Los Angeles,037,10098052,4931,1474,12,1486,26
2020-03-27,Madera,039,155013,41,10,0,10,1
2020-03-27,Marin,041,260295,110,58,0,58,0
2020-03-27,Mariposa,043,17540,0,0,0,0,0
2020-03-27,Mendocino,045,87422,5,2,0,2,0
2020-03-27,Merced,047,269075,26,3,0,3,0
2020-03-27,Modoc,049,8938,0,0,0,0,0
2020-03-27,Mono,051,14174,24,6,0,6,0
2020-03-27,Monterey,053,433212,69,26,1,27,1
2020-03-27,Napa,055,140530,27,5,0,5,0
2020-03-27,Nevada,057,99092,32,6,1,7,0
2020-03-27,Orange,059,3164182,1119,299,13,312,2
2020-03-27,Placer,061,380077,106,33,0,33,1
2020-03-27,Plumas,063,18699,0,0,0,0,0
2020-03-27,Riverside,065,2383286,955,121,12,133,7
2020-03-27,Sacramento,067,1510023,502,163,0,163,6
2020-03-27,San Benito,069,59416,28,9,0,9,1
2020-03-27,San Bernardino,071,2135413,512,77,0,77,2
2020-03-27,San Diego,073,3302833,1323,419,0,419,5
2020-03-27,San Francisco,075,870044,616,285,0,285,2
2020-03-27,San Joaquin,077,732212,199,73,3,76,3
2020-03-27,San Luis Obispo,079,281455,116,46,0,46,0
2020-03-27,San Mateo,081,765935,642,213,2,215,7
2020-03-27,Santa Barbara,083,443738,181,37,1,38,0
2020-03-27,Santa Clara,085,1922200,1278,557,3,560,25
2020-03-27,Santa Cruz,087,273765,75,31,0,31,0
2020-03-27,Shasta,089,179085,17,3,0,3,1
2020-03-27,Sierra,091,2930,0,0,0,0,0
2020-03-27,Siskiyou,093,43540,4,2,0,2,0
2020-03-27,Solano,095,438530,92,48,0,48,0
2020-03-27,Sonoma,097,501317,133,35,0,35,1
2020-03-27,Stanislaus,099,539301,81,16,3,19,0
2020-03-27,Sutter,101,95872,16,2,0,2,0
2020-03-27,Tehama,103,63373,1,0,0,0,0
2020-03-27,Trinity,105,12862,0,0,0,0,0
2020-03-27,Tulare,107,460477,106,15,3,18,0
2020-03-27,Tuolumne,109,53932,1,1,0,1,0
2020-03-27,Ventura,111,848112,261,80,0,80,2
2020-03-27,Yolo,113,214977,49,13,0,13,1
2020-03-27,Yuba,115,75493,7,3,0,3,0
2020-03-26,Alameda,001,1643700,553,172,1,173,4
2020-03-26,Alpine,003,1148,1,0,0,0,0
2020-03-26,Amador,005,37829,3,1,0,1,0
2020-03-26,Butte,007,227075,12,4,0,4,0
2020-03-26,Calaveras,009,45235,3,2,0,2,0
2020-03-26,Colusa,011,21464,3,0,0,0,0
2020-03-26,Contra Costa,013,1133247,382,147,0,147,2
2020-03-26,Del Norte,015,27424,0,0,0,0,0
2020-03-26,El Dorado,017,186661,26,7,0,7,0
2020-03-26,Fresno,019,978130,172,25,2,27,0
2020-03-26,Glenn,021,27897,2,0,0,0,0
2020-03-26,Humboldt,023,135768,37,8,0,8,0
2020-03-26,Imperial,025,180216,68,8,0,8,0
2020-03-26,Inyo,027,18085,8,0,0,0,0
2020-03-26,Kern,029,883053,184,20,0,20,0
2020-03-26,Kings,031,150075,28,0,1,1,0
2020-03-26,Lake,033,64148,0,0,0,0,0
2020-03-26,Lassen,035,31185,3,0,1,1,0
2020-03-26,Los Angeles,037,10098052,4528,1075,12,1087,19
2020-03-26,Madera,039,155013,39,8,0,8,0
2020-03-26,Marin,041,260295,101,56,0,56,0
2020-03-26,Mariposa,043,17540,0,0,0,0,0
2020-03-26,Mendocino,045,87422,4,1,0,1,0
2020-03-26,Merced,047,269075,23,1,0,1,0
2020-03-26,Modoc,049,8938,0,0,0,0,0
2020-03-26,Mono,051,14174,23,5,0,5,0
2020-03-26,Monterey,053,433212,66,25,1,26,1
2020-03-26,Napa,055,140530,26,5,0,5,0
2020-03-26,Nevada,057,99092,32,7,1,8,0
2020-03-26,Orange,059,3164182,1057,279,11,290,1
2020-03-26,Placer,061,380077,103,34,0,34,1
2020-03-26,Plumas,063,18699,0,0,0,0,0
2020-03-26,Riverside,065,2383286,884,118,12,130,7
2020-03-26,Sacramento,067,1510023,469,147,0,147,5
2020-03-26,San Benito,069,59416,28,8,0,8,1
2020-03-26,San Bernardino,071,2135413,446,57,0,57,1
2020-03-26,San Diego,073,3302833,1256,299,0,299,2
2020-03-26,San Francisco,075,870044,589,261,0,261,1
2020-03-26,San Joaquin,077,732212,188,69,3,72,3
2020-03-26,San Luis Obispo,079,281455,111,38,0,38,0
2020-03-26,San Mateo,081,765935,608,122,2,124,5
2020-03-26,Santa Barbara,083,443738,168,33,1,34,0
2020-03-26,Santa Clara,085,1922200,1233,487,2,489,20
2020-03-26,Santa Cruz,087,273765,71,30,0,30,0
2020-03-26,Shasta,089,179085,17,3,0,3,1
2020-03-26,Sierra,091,2930,0,0,0,0,0
2020-03-26,Siskiyou,093,43540,4,2,0,2,0
2020-03-26,Solano,095,438530,84,41,0,41,0
2020-03-26,Sonoma,097,501317,128,33,0,33,1
2020-03-26,Stanislaus,099,539301,79,15,3,18,0
2020-03-26,Sutter,101,95872,12,2,0,2,0
2020-03-26,Tehama,103,63373,1,0,0,0,0
2020-03-26,Trinity,105,12862,0,0,0,0,0
2020-03-26,Tulare,107,460477,97,15,3,18,0
2020-03-26,Tuolumne,109,53932,1,0,0,0,0
2020-03-26,Ventura,111,848112,245,70,0,70,1
2020-03-26,Yolo,113,214977,45,13,0,13,1
2020-03-26,Yuba,115,75493,7,3,0,3,0
2020-03-25,Alameda,001,1643700,532,134,1,135,3
2020-03-25,Alpine,003,1148,1,0,0,0,0
2020-03-25,Amador,005,37829,3,1,0,1,0
2020-03-25,Butte,007,227075,12,4,0,4,0
2020-03-25,Calaveras,009,45235,3,2,0,2,0
2020-03-25,Colusa,011,21464,2,0,0,0,0
2020-03-25,Contra Costa,013,1133247,368,131,0,131,1
2020-03-25,Del Norte,015,27424,0,0,0,0,0
2020-03-25,El Dorado,017,186661,26,5,0,5,0
2020-03-25,Fresno,019,978130,152,21,2,23,0
2020-03-25,Glenn,021,27897,2,0,0,0,0
2020-03-25,Humboldt,023,135768,34,3,0,3,0
2020-03-25,Imperial,025,180216,60,8,0,8,0
2020-03-25,Inyo,027,18085,5,0,0,0,0
2020-03-25,Kern,029,883053,164,13,0,13,0
2020-03-25,Kings,031,150075,26,0,1,1,0
2020-03-25,Lake,033,64148,0,0,0,0,0
2020-03-25,Lassen,035,31185,3,0,1,1,0
2020-03-25,Los Angeles,037,10098052,4133,725,12,737,10
2020-03-25,Madera,039,155013,37,6,0,6,0
2020-03-25,Marin,041,260295,95,47,0,47,0
2020-03-25,Mariposa,043,17540,0,0,0,0,0
2020-03-25,Mendocino,045,87422,3,1,0,1,0
2020-03-25,Merced,047,269075,19,0,0,0,0
2020-03-25,Modoc,049,8938,0,0,0,0,0
2020-03-25,Mono,051,14174,22,4,0,4,0
2020-03-25,Monterey,053,433212,63,23,1,24,1
2020-03-25,Napa,055,140530,26,5,0,5,0
2020-03-25,Nevada,057,99092,31,5,1,6,0
2020-03-25,Orange,059,3164182,999,214,9,223,1
2020-03-25,Placer,061,380077,97,30,0,30,1
2020-03-25,Plumas,063,18699,0,1,0,1,0
2020-03-25,Riverside,065,2383286,813,87,12,99,5
2020-03-25,Sacramento,067,1510023,443,114,0,114,5
2020-03-25,San Benito,069,59416,27,4,0,4,1
2020-03-25,San Bernardino,071,2135413,407,46,0,46,1
2020-03-25,San Diego,073,3302833,1194,238,0,238,2
2020-03-25,San Francisco,075,870044,548,212,0,212,1
2020-03-25,San Joaquin,077,732212,175,64,3,67,2
2020-03-25,San Luis Obispo,079,281455,106,35,0,35,0
2020-03-25,San Mateo,081,765935,573,111,2,113,5
2020-03-25,Santa Barbara,083,443738,158,25,1,26,0
2020-03-25,Santa Clara,085,1922200,1189,452,2,454,20
2020-03-25,Santa Cruz,087,273765,68,26,0,26,0
2020-03-25,Shasta,089,179085,16,3,0,3,1
2020-03-25,Sierra,091,2930,0,0,0,0,0
2020-03-25,Siskiyou,093,43540,4,2,0,2,0
2020-03-25,Solano,095,438530,79,39,0,39,0
2020-03-25,Sonoma,097,501317,123,31,0,31,1
2020-03-25,Stanislaus,099,539301,72,14,3,17,0
2020-03-25,Sutter,101,95872,9,1,0,1,0
2020-03-25,Tehama,103,63373,1,0,0,0,0
2020-03-25,Trinity,105,12862,0,0,0,0,0
2020-03-25,Tulare,107,460477,87,11,3,14,0
2020-03-25,Tuolumne,109,53932,1,0,0,0,0
2020-03-25,Ventura,111,848112,229,53,0,53,1
2020-03-25,Yolo,113,214977,43,9,0,9,1
2020-03-25,Yuba,115,75493,7,2,0,2,0
2020-03-24,Alameda,001,1643700,499,96,1,97,2
2020-03-24,Alpine,003,1148,1,0,0,0,0
2020-03-24,Amador,005,37829,1,1,0,1,0
2020-03-24,Butte,007,227075,11,3,0,3,0
2020-03-24,Calaveras,009,45235,2,2,0,2,0
2020-03-24,Colusa,011,21464,2,0,0,0,0
2020-03-24,Contra Costa,013,1133247,354,108,0,108,1
2020-03-24,Del Norte,015,27424,0,0,0,0,0
2020-03-24,El Dorado,017,186661,26,3,0,3,0
2020-03-24,Fresno,019,978130,133,18,2,20,0
2020-03-24,Glenn,021,27897,2,0,0,0,0
2020-03-24,Humboldt,023,135768,32,2,0,2,0
2020-03-24,Imperial,025,180216,57,3,0,3,0
2020-03-24,Inyo,027,18085,5,0,0,0,0
2020-03-24,Kern,029,883053,144,5,0,5,0
2020-03-24,Kings,031,150075,25,0,1,1,0
2020-03-24,Lake,033,64148,0,0,0,0,0
2020-03-24,Lassen,035,31185,3,0,1,1,0
2020-03-24,Los Angeles,037,10098052,3681,633,12,645,7
2020-03-24,Madera,039,155013,36,6,0,6,0
2020-03-24,Marin,041,260295,84,44,0,44,0
2020-03-24,Mariposa,043,17540,0,0,0,0,0
2020-03-24,Mendocino,045,87422,3,1,0,1,0
2020-03-24,Merced,047,269075,17,0,0,0,0
2020-03-24,Modoc,049,8938,0,0,0,0,0
2020-03-24,Mono,051,14174,21,1,0,1,0
2020-03-24,Monterey,053,433212,59,23,1,24,1
2020-03-24,Napa,055,140530,23,2,0,2,0
2020-03-24,Nevada,057,99092,30,4,1,5,0
2020-03-24,Orange,059,3164182,937,166,9,175,0
2020-03-24,Placer,061,380077,90,22,0,22,1
2020-03-24,Plumas,063,18699,0,1,0,1,0
2020-03-24,Riverside,065,2383286,746,56,12,68,5
2020-03-24,Sacramento,067,1510023,424,93,0,93,4
2020-03-24,San Benito,069,59416,26,4,0,4,1
2020-03-24,San Bernardino,071,2135413,363,27,0,27,0
2020-03-24,San Diego,073,3302833,1127,231,0,231,2
2020-03-24,San Francisco,075,870044,516,181,0,181,1
2020-03-24,San Joaquin,077,732212,164,52,3,55,2
2020-03-24,San Luis Obispo,079,281455,103,32,0,32,0
2020-03-24,San Mateo,081,765935,532,100,2,102,2
2020-03-24,Santa Barbara,083,443738,152,20,1,21,0
2020-03-24,Santa Clara,085,1922200,1120,389,2,391,17
2020-03-24,Santa Cruz,087,273765,63,22,0,22,0
2020-03-24,Shasta,089,179085,15,3,0,3,0
2020-03-24,Sierra,091,2930,0,0,0,0,0
2020-03-24,Siskiyou,093,43540,4,2,0,2,0
2020-03-24,Solano,095,438530,77,34,0,34,0
2020-03-24,Sonoma,097,501317,116,27,0,27,1
2020-03-24,Stanislaus,099,539301,63,13,3,16,0
2020-03-24,Sutter,101,95872,9,0,0,0,0
2020-03-24,Tehama,103,63373,1,0,0,0,0
2020-03-24,Trinity,105,12862,0,0,0,0,0
2020-03-24,Tulare,107,460477,77,10,3,13,0
2020-03-24,Tuolumne,109,53932,1,0,0,0,0
2020-03-24,Ventura,111,848112,213,44,0,44,1
2020-03-24,Yolo,113,214977,39,8,0,8,0
2020-03-24,Yuba,115,75493,7,2,0,2,0
2020-03-23,Alameda,001,1643700,468,88,1,89,1
2020-03-23,Alpine,003,1148,1,0,0,0,0
2020-03-23,Amador,005,37829,1,1,0,1,0
2020-03-23,Butte,007,227075,11,2,0,2,0
2020-03-23,Calaveras,009,45235,2,2,0,2,0
2020-03-23,Colusa,011,21464,1,0,0,0,0
2020-03-23,Contra Costa,013,1133247,334,91,0,91,2
2020-03-23,Del Norte,015,27424,0,0,0,0,0
2020-03-23,El Dorado,017,186661,25,3,0,3,0
2020-03-23,Fresno,019,978130,123,10,2,12,0
2020-03-23,Glenn,021,27897,2,0,0,0,0
2020-03-23,Humboldt,023,135768,30,2,0,2,0
2020-03-23,Imperial,025,180216,53,2,0,2,0
2020-03-23,Inyo,027,18085,3,0,0,0,0
2020-03-23,Kern,029,883053,130,5,0,5,0
2020-03-23,Kings,031,150075,25,0,1,1,0
2020-03-23,Lake,033,64148,0,0,0,0,0
2020-03-23,Lassen,035,31185,3,0,1,1,0
2020-03-23,Los Angeles,037,10098052,3377,389,12,401,4
2020-03-23,Madera,039,155013,36,4,0,4,0
2020-03-23,Marin,041,260295,79,30,0,30,0
2020-03-23,Mariposa,043,17540,0,0,0,0,0
2020-03-23,Mendocino,045,87422,3,1,0,1,0
2020-03-23,Merced,047,269075,11,0,0,0,0
2020-03-23,Modoc,049,8938,0,0,0,0,0
2020-03-23,Mono,051,14174,19,1,0,1,0
2020-03-23,Monterey,053,433212,54,14,1,15,1
2020-03-23,Napa,055,140530,21,1,0,1,0
2020-03-23,Nevada,057,99092,27,2,1,3,0
2020-03-23,Orange,059,3164182,882,138,7,145,0
2020-03-23,Placer,061,380077,87,19,0,19,1
2020-03-23,Plumas,063,18699,0,0,0,0,0
2020-03-23,Riverside,065,2383286,703,39,12,51,5
2020-03-23,Sacramento,067,1510023,391,87,0,87,4
2020-03-23,San Benito,069,59416,25,4,0,4,1
2020-03-23,San Bernardino,071,2135413,333,17,0,17,0
2020-03-23,San Diego,073,3302833,1068,178,0,178,1
2020-03-23,San Francisco,075,870044,487,152,0,152,0
2020-03-23,San Joaquin,077,732212,153,37,3,40,2
2020-03-23,San Luis Obispo,079,281455,97,23,0,23,0
2020-03-23,San Mateo,081,765935,494,88,2,90,1
2020-03-23,Santa Barbara,083,443738,134,18,1,19,0
2020-03-23,Santa Clara,085,1922200,1071,336,2,338,13
2020-03-23,Santa Cruz,087,273765,61,21,0,21,0
2020-03-23,Shasta,089,179085,13,2,0,2,0
2020-03-23,Sierra,091,2930,0,0,0,0,0
2020-03-23,Siskiyou,093,43540,4,2,0,2,0
2020-03-23,Solano,095,438530,73,33,0,33,0
2020-03-23,Sonoma,097,501317,104,19,0,19,1
2020-03-23,Stanislaus,099,539301,55,10,3,13,0
2020-03-23,Sutter,101,95872,9,0,0,0,0
2020-03-23,Tehama,103,63373,1,0,0,0,0
2020-03-23,Trinity,105,12862,0,0,0,0,0
2020-03-23,Tulare,107,460477,68,9,3,12,0
2020-03-23,Tuolumne,109,53932,1,0,0,0,0
2020-03-23,Ventura,111,848112,196,30,0,30,0
2020-03-23,Yolo,113,214977,38,8,0,8,0
2020-03-23,Yuba,115,75493,7,2,0,2,0
2020-03-22,Alameda,001,1643700,429,72,1,73,1
2020-03-22,Alpine,003,1148,1,0,0,0,0
2020-03-22,Amador,005,37829,1,1,0,1,0
2020-03-22,Butte,007,227075,8,1,0,1,0
2020-03-22,Calaveras,009,45235,2,2,0,2,0
2020-03-22,Colusa,011,21464,1,0,0,0,0
2020-03-22,Contra Costa,013,1133247,307,79,0,79,1
2020-03-22,Del Norte,015,27424,0,0,0,0,0
2020-03-22,El Dorado,017,186661,23,1,0,1,0
2020-03-22,Fresno,019,978130,103,8,2,10,0
2020-03-22,Glenn,021,27897,2,0,0,0,0
2020-03-22,Humboldt,023,135768,27,1,0,1,0
2020-03-22,Imperial,025,180216,51,2,0,2,0
2020-03-22,Inyo,027,18085,1,0,0,0,0
2020-03-22,Kern,029,883053,114,3,0,3,0
2020-03-22,Kings,031,150075,22,0,1,1,0
2020-03-22,Lake,033,64148,0,0,0,0,0
2020-03-22,Lassen,035,31185,3,0,1,1,0
2020-03-22,Los Angeles,037,10098052,3056,384,12,396,3
2020-03-22,Madera,039,155013,33,4,0,4,0
2020-03-22,Marin,041,260295,69,30,0,30,0
2020-03-22,Mariposa,043,17540,0,0,0,0,0
2020-03-22,Mendocino,045,87422,3,1,0,1,0
2020-03-22,Merced,047,269075,7,0,0,0,0
2020-03-22,Modoc,049,8938,0,0,0,0,0
2020-03-22,Mono,051,14174,14,1,0,1,0
2020-03-22,Monterey,053,433212,51,14,1,15,1
2020-03-22,Napa,055,140530,17,1,0,1,0
2020-03-22,Nevada,057,99092,23,2,1,3,0
2020-03-22,Orange,059,3164182,810,102,4,106,0
2020-03-22,Placer,061,380077,84,18,0,18,1
2020-03-22,Plumas,063,18699,0,0,0,0,0
2020-03-22,Riverside,065,2383286,613,26,8,34,5
2020-03-22,Sacramento,067,1510023,359,82,0,82,4
2020-03-22,San Benito,069,59416,20,4,0,4,1
2020-03-22,San Bernardino,071,2135413,290,16,0,16,0
2020-03-22,San Diego,073,3302833,980,161,0,161,0
2020-03-22,San Francisco,075,870044,450,134,0,134,0
2020-03-22,San Joaquin,077,732212,139,30,3,33,2
2020-03-22,San Luis Obispo,079,281455,90,19,0,19,0
2020-03-22,San Mateo,081,765935,461,82,2,84,1
2020-03-22,Santa Barbara,083,443738,120,16,1,17,0
2020-03-22,Santa Clara,085,1922200,1007,284,2,286,13
2020-03-22,Santa Cruz,087,273765,60,19,0,19,0
2020-03-22,Shasta,089,179085,13,1,0,1,0
2020-03-22,Sierra,091,2930,0,0,0,0,0
2020-03-22,Siskiyou,093,43540,4,2,0,2,0
2020-03-22,Solano,095,438530,64,30,0,30,0
2020-03-22,Sonoma,097,501317,99,18,0,18,1
2020-03-22,Stanislaus,099,539301,49,8,3,11,0
2020-03-22,Sutter,101,95872,8,0,0,0,0
2020-03-22,Tehama,103,63373,0,0,0,0,0
2020-03-22,Trinity,105,12862,0,0,0,0,0
2020-03-22,Tulare,107,460477,62,5,3,8,0
2020-03-22,Tuolumne,109,53932,1,0,0,0,0
2020-03-22,Ventura,111,848112,174,26,0,26,0
2020-03-22,Yolo,113,214977,32,6,0,6,0
2020-03-22,Yuba,115,75493,7,2,0,2,0
2020-03-21,Alameda,001,1643700,405,62,1,63,0
2020-03-21,Alpine,003,1148,1,0,0,0,0
2020-03-21,Amador,005,37829,1,1,0,1,0
2020-03-21,Butte,007,227075,7,1,0,1,0
2020-03-21,Calaveras,009,45235,2,2,0,2,0
2020-03-21,Colusa,011,21464,1,0,0,0,0
2020-03-21,Contra Costa,013,1133247,296,62,0,62,1
2020-03-21,Del Norte,015,27424,0,0,0,0,0
2020-03-21,El Dorado,017,186661,20,1,0,1,0
2020-03-21,Fresno,019,978130,99,8,2,10,0
2020-03-21,Glenn,021,27897,2,0,0,0,0
2020-03-21,Humboldt,023,135768,25,1,0,1,0
2020-03-21,Imperial,025,180216,47,2,0,2,0
2020-03-21,Inyo,027,18085,1,0,0,0,0
2020-03-21,Kern,029,883053,108,3,0,3,0
2020-03-21,Kings,031,150075,22,0,1,1,0
2020-03-21,Lake,033,64148,0,0,0,0,0
2020-03-21,Lassen,035,31185,3,0,1,1,0
2020-03-21,Los Angeles,037,10098052,2783,322,12,334,2
2020-03-21,Madera,039,155013,33,4,0,4,0
2020-03-21,Marin,041,260295,64,30,0,30,0
2020-03-21,Mariposa,043,17540,0,0,0,0,0
2020-03-21,Mendocino,045,87422,3,1,0,1,0
2020-03-21,Merced,047,269075,6,0,0,0,0
2020-03-21,Modoc,049,8938,0,0,0,0,0
2020-03-21,Mono,051,14174,14,1,0,1,0
2020-03-21,Monterey,053,433212,48,8,1,9,1
2020-03-21,Napa,055,140530,17,0,0,0,0
2020-03-21,Nevada,057,99092,23,2,1,3,0
2020-03-21,Orange,059,3164182,761,85,4,89,0
2020-03-21,Placer,061,380077,75,11,0,11,1
2020-03-21,Plumas,063,18699,0,0,0,0,0
2020-03-21,Riverside,065,2383286,566,20,8,28,3
2020-03-21,Sacramento,067,1510023,332,66,0,66,3
2020-03-21,San Benito,069,59416,18,4,0,4,1
2020-03-21,San Bernardino,071,2135413,270,13,0,13,0
2020-03-21,San Diego,073,3302833,903,121,0,121,0
2020-03-21,San Francisco,075,870044,414,106,0,106,0
2020-03-21,San Joaquin,077,732212,130,26,3,29,2
2020-03-21,San Luis Obispo,079,281455,85,16,0,16,0
2020-03-21,San Mateo,081,765935,423,78,2,80,1
2020-03-21,Santa Barbara,083,443738,109,8,1,9,0
2020-03-21,Santa Clara,085,1922200,946,269,2,271,10
2020-03-21,Santa Cruz,087,273765,58,17,0,17,0
2020-03-21,Shasta,089,179085,12,1,0,1,0
2020-03-21,Sierra,091,2930,0,0,0,0,0
2020-03-21,Siskiyou,093,43540,4,0,0,0,0
2020-03-21,Solano,095,438530,62,30,0,30,0
2020-03-21,Sonoma,097,501317,98,15,0,15,1
2020-03-21,Stanislaus,099,539301,43,7,3,10,0
2020-03-21,Sutter,101,95872,7,0,0,0,0
2020-03-21,Tehama,103,63373,0,0,0,0,0
2020-03-21,Trinity,105,12862,0,0,0,0,0
2020-03-21,Tulare,107,460477,54,5,3,8,0
2020-03-21,Tuolumne,109,53932,1,0,0,0,0
2020-03-21,Ventura,111,848112,166,22,0,22,0
2020-03-21,Yolo,113,214977,32,6,0,6,0
2020-03-21,Yuba,115,75493,7,1,0,1,0
2020-03-20,Alameda,001,1643700,384,42,1,43,0
2020-03-20,Alpine,003,1148,1,0,0,0,0
2020-03-20,Amador,005,37829,0,0,0,0,0
2020-03-20,Butte,007,227075,7,0,0,0,0
2020-03-20,Calaveras,009,45235,2,2,0,2,0
2020-03-20,Colusa,011,21464,1,0,0,0,0
2020-03-20,Contra Costa,013,1133247,266,52,0,52,1
2020-03-20,Del Norte,015,27424,0,0,0,0,0
2020-03-20,El Dorado,017,186661,19,1,0,1,0
2020-03-20,Fresno,019,978130,96,7,2,9,0
2020-03-20,Glenn,021,27897,1,0,0,0,0
2020-03-20,Humboldt,023,135768,25,1,0,1,0
2020-03-20,Imperial,025,180216,46,2,0,2,0
2020-03-20,Inyo,027,18085,0,0,0,0,0
2020-03-20,Kern,029,883053,93,3,0,3,0
2020-03-20,Kings,031,150075,21,0,1,1,0
2020-03-20,Lake,033,64148,0,0,0,0,0
2020-03-20,Lassen,035,31185,3,0,1,1,0
2020-03-20,Los Angeles,037,10098052,2557,267,11,278,1
2020-03-20,Madera,039,155013,32,4,0,4,0
2020-03-20,Marin,041,260295,61,30,0,30,0
2020-03-20,Mariposa,043,17540,0,0,0,0,0
2020-03-20,Mendocino,045,87422,3,1,0,1,0
2020-03-20,Merced,047,269075,6,0,0,0,0
2020-03-20,Modoc,049,8938,0,0,0,0,0
2020-03-20,Mono,051,14174,14,0,0,0,0
2020-03-20,Monterey,053,433212,47,4,1,5,0
2020-03-20,Napa,055,140530,16,0,0,0,0
2020-03-20,Nevada,057,99092,20,2,1,3,0
2020-03-20,Orange,059,3164182,714,71,4,75,2
2020-03-20,Placer,061,380077,69,9,0,9,1
2020-03-20,Plumas,063,18699,0,0,0,0,0
2020-03-20,Riverside,065,2383286,507,19,8,27,3
2020-03-20,Sacramento,067,1510023,311,56,0,56,4
2020-03-20,San Benito,069,59416,18,4,0,4,1
2020-03-20,San Bernardino,071,2135413,243,9,0,9,0
2020-03-20,San Diego,073,3302833,851,98,0,98,0
2020-03-20,San Francisco,075,870044,382,87,0,87,0
2020-03-20,San Joaquin,077,732212,115,18,3,21,2
2020-03-20,San Luis Obispo,079,281455,81,11,0,11,0
2020-03-20,San Mateo,081,765935,393,71,2,73,1
2020-03-20,Santa Barbara,083,443738,97,7,1,8,0
2020-03-20,Santa Clara,085,1922200,909,246,2,248,8
2020-03-20,Santa Cruz,087,273765,56,13,0,13,0
2020-03-20,Shasta,089,179085,11,1,0,1,0
2020-03-20,Sierra,091,2930,0,0,0,0,0
2020-03-20,Siskiyou,093,43540,4,0,0,0,0
2020-03-20,Solano,095,438530,58,29,0,29,0
2020-03-20,Sonoma,097,501317,90,7,0,7,0
2020-03-20,Stanislaus,099,539301,37,7,3,10,0
2020-03-20,Sutter,101,95872,7,0,0,0,0
2020-03-20,Tehama,103,63373,0,0,0,0,0
2020-03-20,Trinity,105,12862,0,0,0,0,0
2020-03-20,Tulare,107,460477,50,4,3,7,0
2020-03-20,Tuolumne,109,53932,1,0,0,0,0
2020-03-20,Ventura,111,848112,156,18,0,18,0
2020-03-20,Yolo,113,214977,30,5,0,5,0
2020-03-20,Yuba,115,75493,6,0,0,0,0
2020-03-19,Alameda,001,1643700,348,36,1,37,0
2020-03-19,Alpine,003,1148,1,0,0,0,0
2020-03-19,Amador,005,37829,0,0,0,0,0
2020-03-19,Butte,007,227075,5,0,0,0,0
2020-03-19,Calaveras,009,45235,2,2,0,2,0
2020-03-19,Colusa,011,21464,0,0,0,0,0
2020-03-19,Contra Costa,013,1133247,250,46,0,46,0
2020-03-19,Del Norte,015,27424,0,0,0,0,0
2020-03-19,El Dorado,017,186661,17,0,0,0,0
2020-03-19,Fresno,019,978130,87,6,2,8,0
2020-03-19,Glenn,021,27897,1,0,0,0,0
2020-03-19,Humboldt,023,135768,23,1,0,1,0
2020-03-19,Imperial,025,180216,39,2,0,2,0
2020-03-19,Inyo,027,18085,0,0,0,0,0
2020-03-19,Kern,029,883053,81,3,0,3,0
2020-03-19,Kings,031,150075,17,0,1,1,0
2020-03-19,Lake,033,64148,0,0,0,0,0
2020-03-19,Lassen,035,31185,2,0,1,1,0
2020-03-19,Los Angeles,037,10098052,2270,233,11,244,0
2020-03-19,Madera,039,155013,31,3,0,3,0
2020-03-19,Marin,041,260295,58,19,0,19,0
2020-03-19,Mariposa,043,17540,0,0,0,0,0
2020-03-19,Mendocino,045,87422,2,1,0,1,0
2020-03-19,Merced,047,269075,5,0,0,0,0
2020-03-19,Modoc,049,8938,0,0,0,0,0
2020-03-19,Mono,051,14174,12,0,0,0,0
2020-03-19,Monterey,053,433212,39,3,1,4,0
2020-03-19,Napa,055,140530,14,0,0,0,0
2020-03-19,Nevada,057,99092,18,2,1,3,0
2020-03-19,Orange,059,3164182,632,59,4,63,0
2020-03-19,Placer,061,380077,61,8,0,8,1
2020-03-19,Plumas,063,18699,0,0,0,0,0
2020-03-19,Riverside,065,2383286,396,14,6,20,3
2020-03-19,Sacramento,067,1510023,278,52,0,52,3
2020-03-19,San Benito,069,59416,15,3,0,3,0
2020-03-19,San Bernardino,071,2135413,213,7,0,7,0
2020-03-19,San Diego,073,3302833,768,68,0,68,0
2020-03-19,San Francisco,075,870044,346,80,0,80,0
2020-03-19,San Joaquin,077,732212,102,15,3,18,2
2020-03-19,San Luis Obispo,079,281455,78,6,0,6,0
2020-03-19,San Mateo,081,765935,358,58,2,60,1
2020-03-19,Santa Barbara,083,443738,85,5,0,5,0
2020-03-19,Santa Clara,085,1922200,842,183,2,185,8
2020-03-19,Santa Cruz,087,273765,53,13,0,13,0
2020-03-19,Shasta,089,179085,10,1,0,1,0
2020-03-19,Sierra,091,2930,0,0,0,0,0
2020-03-19,Siskiyou,093,43540,3,0,0,0,0
2020-03-19,Solano,095,438530,54,26,0,26,0
2020-03-19,Sonoma,097,501317,87,8,0,8,0
2020-03-19,Stanislaus,099,539301,36,7,3,10,0
2020-03-19,Sutter,101,95872,7,0,0,0,0
2020-03-19,Tehama,103,63373,0,0,0,0,0
2020-03-19,Trinity,105,12862,0,0,0,0,0
2020-03-19,Tulare,107,460477,44,3,3,6,0
2020-03-19,Tuolumne,109,53932,1,0,0,0,0
2020-03-19,Ventura,111,848112,134,15,0,15,0
2020-03-19,Yolo,113,214977,26,5,0,5,0
2020-03-19,Yuba,115,75493,5,0,0,0,0
2020-03-18,Alameda,001,1643700,320,29,1,30,0
2020-03-18,Alpine,003,1148,1,0,0,0,0
2020-03-18,Amador,005,37829,0,0,0,0,0
2020-03-18,Butte,007,227075,4,0,0,0,0
2020-03-18,Calaveras,009,45235,2,2,0,2,0
2020-03-18,Colusa,011,21464,0,0,0,0,0
2020-03-18,Contra Costa,013,1133247,228,44,0,44,0
2020-03-18,Del Norte,015,27424,0,0,0,0,0
2020-03-18,El Dorado,017,186661,16,0,0,0,0
2020-03-18,Fresno,019,978130,78,3,1,4,0
2020-03-18,Glenn,021,27897,1,0,0,0,0
2020-03-18,Humboldt,023,135768,19,1,0,1,0
2020-03-18,Imperial,025,180216,33,2,0,2,0
2020-03-18,Inyo,027,18085,0,0,0,0,0
2020-03-18,Kern,029,883053,66,1,0,1,0
2020-03-18,Kings,031,150075,15,0,1,1,0
2020-03-18,Lake,033,64148,0,0,0,0,0
2020-03-18,Lassen,035,31185,1,0,1,1,0
2020-03-18,Los Angeles,037,10098052,2031,47,11,58,0
2020-03-18,Madera,039,155013,30,2,0,2,0
2020-03-18,Marin,041,260295,53,10,0,10,0
2020-03-18,Mariposa,043,17540,0,0,0,0,0
2020-03-18,Mendocino,045,87422,2,0,0,0,0
2020-03-18,Merced,047,269075,5,0,0,0,0
2020-03-18,Modoc,049,8938,0,0,0,0,0
2020-03-18,Mono,051,14174,11,0,0,0,0
2020-03-18,Monterey,053,433212,31,1,0,1,0
2020-03-18,Napa,055,140530,11,0,0,0,0
2020-03-18,Nevada,057,99092,16,2,1,3,0
2020-03-18,Orange,059,3164182,575,38,4,42,0
2020-03-18,Placer,061,380077,54,8,0,8,1
2020-03-18,Plumas,063,18699,0,0,0,0,0
2020-03-18,Riverside,065,2383286,333,11,5,16,2
2020-03-18,Sacramento,067,1510023,255,46,0,46,3
2020-03-18,San Benito,069,59416,14,3,0,3,0
2020-03-18,San Bernardino,071,2135413,191,3,0,3,0
2020-03-18,San Diego,073,3302833,683,40,0,40,0
2020-03-18,San Francisco,075,870044,327,65,0,65,0
2020-03-18,San Joaquin,077,732212,90,14,3,17,2
2020-03-18,San Luis Obispo,079,281455,71,5,0,5,0
2020-03-18,San Mateo,081,765935,337,57,2,59,1
2020-03-18,Santa Barbara,083,443738,77,2,0,2,0
2020-03-18,Santa Clara,085,1922200,791,151,2,153,6
2020-03-18,Santa Cruz,087,273765,51,11,0,11,0
2020-03-18,Shasta,089,179085,9,1,0,1,0
2020-03-18,Sierra,091,2930,0,0,0,0,0
2020-03-18,Siskiyou,093,43540,3,0,0,0,0
2020-03-18,Solano,095,438530,50,26,0,26,0
2020-03-18,Sonoma,097,501317,78,6,0,6,0
2020-03-18,Stanislaus,099,539301,32,5,2,7,0
2020-03-18,Sutter,101,95872,5,0,0,0,0
2020-03-18,Tehama,103,63373,0,0,0,0,0
2020-03-18,Trinity,105,12862,0,0,0,0,0
2020-03-18,Tulare,107,460477,34,3,3,6,0
2020-03-18,Tuolumne,109,53932,1,0,0,0,0
2020-03-18,Ventura,111,848112,115,11,0,11,0
2020-03-18,Yolo,113,214977,23,4,0,4,0
2020-03-18,Yuba,115,75493,4,0,0,0,0
2020-03-17,Alameda,001,1643700,288,19,0,19,0
2020-03-17,Alpine,003,1148,0,0,0,0,0
2020-03-17,Amador,005,37829,0,0,0,0,0
2020-03-17,Butte,007,227075,4,0,0,0,0
2020-03-17,Calaveras,009,45235,2,2,0,2,0
2020-03-17,Colusa,011,21464,0,0,0,0,0
2020-03-17,Contra Costa,013,1133247,206,37,0,37,0
2020-03-17,Del Norte,015,27424,0,0,0,0,0
2020-03-17,El Dorado,017,186661,15,0,0,0,0
2020-03-17,Fresno,019,978130,68,2,1,3,0
2020-03-17,Glenn,021,27897,1,0,0,0,0
2020-03-17,Humboldt,023,135768,17,1,0,1,0
2020-03-17,Imperial,025,180216,27,2,0,2,0
2020-03-17,Inyo,027,18085,0,0,0,0,0
2020-03-17,Kern,029,883053,52,0,0,0,0
2020-03-17,Kings,031,150075,12,0,1,1,0
2020-03-17,Lake,033,64148,0,0,0,0,0
2020-03-17,Lassen,035,31185,1,0,1,1,0
2020-03-17,Los Angeles,037,10098052,1831,41,11,52,0
2020-03-17,Madera,039,155013,22,2,0,2,0
2020-03-17,Marin,041,260295,46,4,0,4,0
2020-03-17,Mariposa,043,17540,0,0,0,0,0
2020-03-17,Mendocino,045,87422,2,0,0,0,0
2020-03-17,Merced,047,269075,5,0,0,0,0
2020-03-17,Modoc,049,8938,0,0,0,0,0
2020-03-17,Mono,051,14174,9,0,0,0,0
2020-03-17,Monterey,053,433212,29,0,0,0,0
2020-03-17,Napa,055,140530,8,0,0,0,0
2020-03-17,Nevada,057,99092,15,1,1,2,0
2020-03-17,Orange,059,3164182,497,24,3,27,0
2020-03-17,Placer,061,380077,44,7,0,7,1
2020-03-17,Plumas,063,18699,0,0,0,0,0
2020-03-17,Riverside,065,2383286,271,11,5,16,0
2020-03-17,Sacramento,067,1510023,235,36,0,36,1
2020-03-17,San Benito,069,59416,12,2,0,2,0
2020-03-17,San Bernardino,071,2135413,163,2,0,2,0
2020-03-17,San Diego,073,3302833,616,17,0,17,0
2020-03-17,San Francisco,075,870044,300,46,0,46,0
2020-03-17,San Joaquin,077,732212,84,11,3,14,0
2020-03-17,San Luis Obispo,079,281455,63,1,0,1,0
2020-03-17,San Mateo,081,765935,305,46,2,48,1
2020-03-17,Santa Barbara,083,443738,65,0,0,0,0
2020-03-17,Santa Clara,085,1922200,733,121,2,123,4
2020-03-17,Santa Cruz,087,273765,48,10,0,10,0
2020-03-17,Shasta,089,179085,5,1,0,1,0
2020-03-17,Sierra,091,2930,0,0,0,0,0
2020-03-17,Siskiyou,093,43540,3,0,0,0,0
2020-03-17,Solano,095,438530,47,27,0,27,0
2020-03-17,Sonoma,097,501317,70,4,0,4,0
2020-03-17,Stanislaus,099,539301,29,4,2,6,0
2020-03-17,Sutter,101,95872,5,0,0,0,0
2020-03-17,Tehama,103,63373,0,0,0,0,0
2020-03-17,Trinity,105,12862,0,0,0,0,0
2020-03-17,Tulare,107,460477,29,2,3,5,0
2020-03-17,Tuolumne,109,53932,1,0,0,0,0
2020-03-17,Ventura,111,848112,98,7,0,7,0
2020-03-17,Yolo,113,214977,19,2,0,2,0
2020-03-17,Yuba,115,75493,4,0,0,0,0
2020-03-16,Alameda,001,1643700,260,17,0,17,0
2020-03-16,Alpine,003,1148,0,0,0,0,0
2020-03-16,Amador,005,37829,0,0,0,0,0
2020-03-16,Butte,007,227075,3,0,0,0,0
2020-03-16,Calaveras,009,45235,2,2,0,2,0
2020-03-16,Colusa,011,21464,0,0,0,0,0
2020-03-16,Contra Costa,013,1133247,184,36,0,36,0
2020-03-16,Del Norte,015,27424,0,0,0,0,0
2020-03-16,El Dorado,017,186661,14,0,0,0,0
2020-03-16,Fresno,019,978130,53,2,1,3,0
2020-03-16,Glenn,021,27897,0,0,0,0,0
2020-03-16,Humboldt,023,135768,13,1,0,1,0
2020-03-16,Imperial,025,180216,22,2,0,2,0
2020-03-16,Inyo,027,18085,0,0,0,0,0
2020-03-16,Kern,029,883053,43,0,0,0,0
2020-03-16,Kings,031,150075,11,0,1,1,0
2020-03-16,Lake,033,64148,0,0,0,0,0
2020-03-16,Lassen,035,31185,1,0,0,0,0
2020-03-16,Los Angeles,037,10098052,1596,43,11,54,0
2020-03-16,Madera,039,155013,21,2,0,2,0
2020-03-16,Marin,041,260295,43,4,0,4,0
2020-03-16,Mariposa,043,17540,0,0,0,0,0
2020-03-16,Mendocino,045,87422,2,0,0,0,0
2020-03-16,Merced,047,269075,5,0,0,0,0
2020-03-16,Modoc,049,8938,0,0,0,0,0
2020-03-16,Mono,051,14174,7,0,0,0,0
2020-03-16,Monterey,053,433212,28,0,0,0,0
2020-03-16,Napa,055,140530,7,0,0,0,0
2020-03-16,Nevada,057,99092,11,1,1,2,0
2020-03-16,Orange,059,3164182,414,18,3,21,0
2020-03-16,Placer,061,380077,36,7,0,7,1
2020-03-16,Plumas,063,18699,0,0,0,0,0
2020-03-16,Riverside,065,2383286,235,10,5,15,0
2020-03-16,Sacramento,067,1510023,208,34,0,34,1
2020-03-16,San Benito,069,59416,8,2,0,2,0
2020-03-16,San Bernardino,071,2135413,143,1,0,1,0
2020-03-16,San Diego,073,3302833,525,17,0,17,0
2020-03-16,San Francisco,075,870044,262,40,0,40,0
2020-03-16,San Joaquin,077,732212,74,9,3,12,0
2020-03-16,San Luis Obispo,079,281455,56,1,0,1,0
2020-03-16,San Mateo,081,765935,269,42,2,44,1
2020-03-16,Santa Barbara,083,443738,55,0,0,0,0
2020-03-16,Santa Clara,085,1922200,657,115,1,116,2
2020-03-16,Santa Cruz,087,273765,44,9,0,9,0
2020-03-16,Shasta,089,179085,5,1,0,1,0
2020-03-16,Sierra,091,2930,0,0,0,0,0
2020-03-16,Siskiyou,093,43540,2,0,0,0,0
2020-03-16,Solano,095,438530,43,27,0,27,0
2020-03-16,Sonoma,097,501317,63,4,0,4,0
2020-03-16,Stanislaus,099,539301,26,2,2,4,0
2020-03-16,Sutter,101,95872,3,0,0,0,0
2020-03-16,Tehama,103,63373,0,0,0,0,0
2020-03-16,Trinity,105,12862,0,0,0,0,0
2020-03-16,Tulare,107,460477,25,2,3,5,0
2020-03-16,Tuolumne,109,53932,1,0,0,0,0
2020-03-16,Ventura,111,848112,88,7,0,7,0
2020-03-16,Yolo,113,214977,18,2,0,2,0
2020-03-16,Yuba,115,75493,3,0,0,0,0
2020-03-15,Alameda,001,1643700,214,17,0,17,0
2020-03-15,Alpine,003,1148,0,0,0,0,0
2020-03-15,Amador,005,37829,0,0,0,0,0
2020-03-15,Butte,007,227075,3,0,0,0,0
2020-03-15,Calaveras,009,45235,2,2,0,2,0
2020-03-15,Colusa,011,21464,0,0,0,0,0
2020-03-15,Contra Costa,013,1133247,161,34,0,34,0
2020-03-15,Del Norte,015,27424,0,0,0,0,0
2020-03-15,El Dorado,017,186661,13,0,0,0,0
2020-03-15,Fresno,019,978130,33,1,1,2,0
2020-03-15,Glenn,021,27897,0,0,0,0,0
2020-03-15,Humboldt,023,135768,11,1,0,1,0
2020-03-15,Imperial,025,180216,17,2,0,2,0
2020-03-15,Inyo,027,18085,0,0,0,0,0
2020-03-15,Kern,029,883053,37,0,0,0,0
2020-03-15,Kings,031,150075,11,0,1,1,0
2020-03-15,Lake,033,64148,0,0,0,0,0
2020-03-15,Lassen,035,31185,1,0,0,0,0
2020-03-15,Los Angeles,037,10098052,1356,41,11,52,0
2020-03-15,Madera,039,155013,20,2,0,2,0
2020-03-15,Marin,041,260295,37,3,0,3,0
2020-03-15,Mariposa,043,17540,0,0,0,0,0
2020-03-15,Mendocino,045,87422,2,0,0,0,0
2020-03-15,Merced,047,269075,3,0,0,0,0
2020-03-15,Modoc,049,8938,0,0,0,0,0
2020-03-15,Mono,051,14174,6,0,0,0,0
2020-03-15,Monterey,053,433212,21,0,0,0,0
2020-03-15,Napa,055,140530,7,0,0,0,0
2020-03-15,Nevada,057,99092,11,0,1,1,0
2020-03-15,Orange,059,3164182,346,16,1,17,0
2020-03-15,Placer,061,380077,31,7,0,7,1
2020-03-15,Plumas,063,18699,0,0,0,0,0
2020-03-15,Riverside,065,2383286,183,10,5,15,0
2020-03-15,Sacramento,067,1510023,172,30,0,30,1
2020-03-15,San Benito,069,59416,8,2,0,2,0
2020-03-15,San Bernardino,071,2135413,121,0,0,0,0
2020-03-15,San Diego,073,3302833,438,16,0,16,0
2020-03-15,San Francisco,075,870044,206,31,0,31,0
2020-03-15,San Joaquin,077,732212,63,6,3,9,0
2020-03-15,San Luis Obispo,079,281455,46,1,0,1,0
2020-03-15,San Mateo,081,765935,236,29,1,30,1
2020-03-15,Santa Barbara,083,443738,46,0,0,0,0
2020-03-15,Santa Clara,085,1922200,585,79,1,80,2
2020-03-15,Santa Cruz,087,273765,38,8,0,8,0
2020-03-15,Shasta,089,179085,5,1,0,1,0
2020-03-15,Sierra,091,2930,0,0,0,0,0
2020-03-15,Siskiyou,093,43540,2,0,0,0,0
2020-03-15,Solano,095,438530,42,26,0,26,0
2020-03-15,Sonoma,097,501317,54,4,0,4,0
2020-03-15,Stanislaus,099,539301,26,2,2,4,0
2020-03-15,Sutter,101,95872,2,0,0,0,0
2020-03-15,Tehama,103,63373,0,0,0,0,0
2020-03-15,Trinity,105,12862,0,0,0,0,0
2020-03-15,Tulare,107,460477,19,2,3,5,0
2020-03-15,Tuolumne,109,53932,1,0,0,0,0
2020-03-15,Ventura,111,848112,77,5,0,5,0
2020-03-15,Yolo,113,214977,15,2,0,2,0
2020-03-15,Yuba,115,75493,2,0,0,0,0
2020-03-14,Alameda,001,1643700,195,11,0,11,0
2020-03-14,Alpine,003,1148,0,0,0,0,0
2020-03-14,Amador,005,37829,0,0,0,0,0
2020-03-14,Butte,007,227075,2,0,0,0,0
2020-03-14,Calaveras,009,45235,2,2,0,2,0
2020-03-14,Colusa,011,21464,0,0,0,0,0
2020-03-14,Contra Costa,013,1133247,139,30,0,30,0
2020-03-14,Del Norte,015,27424,0,0,0,0,0
2020-03-14,El Dorado,017,186661,11,0,0,0,0
2020-03-14,Fresno,019,978130,25,1,1,2,0
2020-03-14,Glenn,021,27897,0,0,0,0,0
2020-03-14,Humboldt,023,135768,7,1,0,1,0
2020-03-14,Imperial,025,180216,13,2,0,2,0
2020-03-14,Inyo,027,18085,0,0,0,0,0
2020-03-14,Kern,029,883053,32,0,0,0,0
2020-03-14,Kings,031,150075,11,0,1,1,0
2020-03-14,Lake,033,64148,0,0,0,0,0
2020-03-14,Lassen,035,31185,1,0,0,0,0
2020-03-14,Los Angeles,037,10098052,1178,35,11,46,0
2020-03-14,Madera,039,155013,19,2,0,2,0
2020-03-14,Marin,041,260295,36,3,0,3,0
2020-03-14,Mariposa,043,17540,0,0,0,0,0
2020-03-14,Mendocino,045,87422,2,0,0,0,0
2020-03-14,Merced,047,269075,3,0,0,0,0
2020-03-14,Modoc,049,8938,0,0,0,0,0
2020-03-14,Mono,051,14174,5,0,0,0,0
2020-03-14,Monterey,053,433212,15,0,0,0,0
2020-03-14,Napa,055,140530,5,0,0,0,0
2020-03-14,Nevada,057,99092,8,0,1,1,0
2020-03-14,Orange,059,3164182,307,14,0,14,0
2020-03-14,Placer,061,380077,28,6,0,6,1
2020-03-14,Plumas,063,18699,0,0,0,0,0
2020-03-14,Riverside,065,2383286,163,10,5,15,0
2020-03-14,Sacramento,067,1510023,151,31,0,31,1
2020-03-14,San Benito,069,59416,8,2,0,2,0
2020-03-14,San Bernardino,071,2135413,102,0,0,0,0
2020-03-14,San Diego,073,3302833,363,10,0,10,0
2020-03-14,San Francisco,075,870044,185,29,0,29,0
2020-03-14,San Joaquin,077,732212,54,6,3,9,0
2020-03-14,San Luis Obispo,079,281455,41,0,0,0,0
2020-03-14,San Mateo,081,765935,213,27,1,28,0
2020-03-14,Santa Barbara,083,443738,37,0,0,0,0
2020-03-14,Santa Clara,085,1922200,529,62,1,63,2
2020-03-14,Santa Cruz,087,273765,33,8,0,8,0
2020-03-14,Shasta,089,179085,5,1,0,1,0
2020-03-14,Sierra,091,2930,0,0,0,0,0
2020-03-14,Siskiyou,093,43540,1,0,0,0,0
2020-03-14,Solano,095,438530,40,26,0,26,0
2020-03-14,Sonoma,097,501317,41,2,0,2,0
2020-03-14,Stanislaus,099,539301,22,2,2,4,0
2020-03-14,Sutter,101,95872,2,0,0,0,0
2020-03-14,Tehama,103,63373,0,0,0,0,0
2020-03-14,Trinity,105,12862,0,0,0,0,0
2020-03-14,Tulare,107,460477,17,2,2,4,0
2020-03-14,Tuolumne,109,53932,1,0,0,0,0
2020-03-14,Ventura,111,848112,68,5,0,5,0
2020-03-14,Yolo,113,214977,15,2,0,2,0
2020-03-14,Yuba,115,75493,1,0,0,0,0
2020-03-13,Alameda,001,1643700,176,12,0,12,0
2020-03-13,Alpine,003,1148,0,0,0,0,0
2020-03-13,Amador,005,37829,0,0,0,0,0
2020-03-13,Butte,007,227075,0,0,0,0,0
2020-03-13,Calaveras,009,45235,2,2,0,2,0
2020-03-13,Colusa,011,21464,0,0,0,0,0
2020-03-13,Contra Costa,013,1133247,126,22,0,22,0
2020-03-13,Del Norte,015,27424,0,0,0,0,0
2020-03-13,El Dorado,017,186661,10,0,0,0,0
2020-03-13,Fresno,019,978130,20,1,1,2,0
2020-03-13,Glenn,021,27897,0,0,0,0,0
2020-03-13,Humboldt,023,135768,7,1,0,1,0
2020-03-13,Imperial,025,180216,12,2,0,2,0
2020-03-13,Inyo,027,18085,0,0,0,0,0
2020-03-13,Kern,029,883053,27,0,0,0,0
2020-03-13,Kings,031,150075,10,0,1,1,0
2020-03-13,Lake,033,64148,0,0,0,0,0
2020-03-13,Lassen,035,31185,1,0,0,0,0
2020-03-13,Los Angeles,037,10098052,1025,30,10,40,0
2020-03-13,Madera,039,155013,18,1,0,1,0
2020-03-13,Marin,041,260295,34,3,0,3,0
2020-03-13,Mariposa,043,17540,0,0,0,0,0
2020-03-13,Mendocino,045,87422,2,0,0,0,0
2020-03-13,Merced,047,269075,2,0,0,0,0
2020-03-13,Modoc,049,8938,0,0,0,0,0
2020-03-13,Mono,051,14174,3,0,0,0,0
2020-03-13,Monterey,053,433212,10,0,0,0,0
2020-03-13,Napa,055,140530,3,0,0,0,0
2020-03-13,Nevada,057,99092,7,0,1,1,0
2020-03-13,Orange,059,3164182,268,10,0,10,0
2020-03-13,Placer,061,380077,27,6,0,6,1
2020-03-13,Plumas,063,18699,0,0,0,0,0
2020-03-13,Riverside,065,2383286,133,5,4,9,0
2020-03-13,Sacramento,067,1510023,129,18,0,18,1
2020-03-13,San Benito,069,59416,6,2,0,2,0
2020-03-13,San Bernardino,071,2135413,95,0,0,0,0
2020-03-13,San Diego,073,3302833,313,8,0,8,0
2020-03-13,San Francisco,075,870044,171,28,0,28,0
2020-03-13,San Joaquin,077,732212,50,6,3,9,0
2020-03-13,San Luis Obispo,079,281455,33,0,0,0,0
2020-03-13,San Mateo,081,765935,192,24,1,25,0
2020-03-13,Santa Barbara,083,443738,33,0,0,0,0
2020-03-13,Santa Clara,085,1922200,467,59,1,60,1
2020-03-13,Santa Cruz,087,273765,32,7,0,7,0
2020-03-13,Shasta,089,179085,3,1,0,1,0
2020-03-13,Sierra,091,2930,0,0,0,0,0
2020-03-13,Siskiyou,093,43540,0,0,0,0,0
2020-03-13,Solano,095,438530,39,26,0,26,0
2020-03-13,Sonoma,097,501317,40,2,0,2,0
2020-03-13,Stanislaus,099,539301,17,2,2,4,0
2020-03-13,Sutter,101,95872,2,0,0,0,0
2020-03-13,Tehama,103,63373,0,0,0,0,0
2020-03-13,Trinity,105,12862,0,0,0,0,0
2020-03-13,Tulare,107,460477,14,2,2,4,0
2020-03-13,Tuolumne,109,53932,1,0,0,0,0
2020-03-13,Ventura,111,848112,54,5,0,5,0
2020-03-13,Yolo,113,214977,15,1,0,1,0
2020-03-13,Yuba,115,75493,1,0,0,0,0
2020-03-12,Alameda,001,1643700,151,9,0,9,0
2020-03-12,Alpine,003,1148,0,0,0,0,0
2020-03-12,Amador,005,37829,0,0,0,0,0
2020-03-12,Butte,007,227075,0,0,0,0,0
2020-03-12,Calaveras,009,45235,2,2,0,2,0
2020-03-12,Colusa,011,21464,0,0,0,0,0
2020-03-12,Contra Costa,013,1133247,109,18,0,18,0
2020-03-12,Del Norte,015,27424,0,0,0,0,0
2020-03-12,El Dorado,017,186661,8,0,0,0,0
2020-03-12,Fresno,019,978130,12,1,1,2,0
2020-03-12,Glenn,021,27897,0,0,0,0,0
2020-03-12,Humboldt,023,135768,6,1,0,1,0
2020-03-12,Imperial,025,180216,11,2,0,2,0
2020-03-12,Inyo,027,18085,0,0,0,0,0
2020-03-12,Kern,029,883053,18,0,0,0,0
2020-03-12,Kings,031,150075,7,0,1,1,0
2020-03-12,Lake,033,64148,0,0,0,0,0
2020-03-12,Lassen,035,31185,1,0,0,0,0
2020-03-12,Los Angeles,037,10098052,866,30,10,40,0
2020-03-12,Madera,039,155013,15,1,0,1,0
2020-03-12,Marin,041,260295,24,1,0,1,0
2020-03-12,Mariposa,043,17540,0,0,0,0,0
2020-03-12,Mendocino,045,87422,2,0,0,0,0
2020-03-12,Merced,047,269075,2,0,0,0,0
2020-03-12,Modoc,049,8938,0,0,0,0,0
2020-03-12,Mono,051,14174,3,0,0,0,0
2020-03-12,Monterey,053,433212,8,0,0,0,0
2020-03-12,Napa,055,140530,3,0,0,0,0
2020-03-12,Nevada,057,99092,4,0,1,1,0
2020-03-12,Orange,059,3164182,231,7,0,7,0
2020-03-12,Placer,061,380077,23,6,0,6,1
2020-03-12,Plumas,063,18699,0,0,0,0,0
2020-03-12,Riverside,065,2383286,107,5,2,7,0
2020-03-12,Sacramento,067,1510023,105,17,0,17,1
2020-03-12,San Benito,069,59416,5,2,0,2,0
2020-03-12,San Bernardino,071,2135413,79,0,0,0,0
2020-03-12,San Diego,073,3302833,258,9,0,9,0
2020-03-12,San Francisco,075,870044,147,20,0,20,0
2020-03-12,San Joaquin,077,732212,44,3,3,6,1
2020-03-12,San Luis Obispo,079,281455,26,0,0,0,0
2020-03-12,San Mateo,081,765935,158,21,1,22,0
2020-03-12,Santa Barbara,083,443738,22,0,0,0,0
2020-03-12,Santa Clara,085,1922200,409,51,1,52,1
2020-03-12,Santa Cruz,087,273765,29,5,0,5,0
2020-03-12,Shasta,089,179085,2,1,0,1,0
2020-03-12,Sierra,091,2930,0,0,0,0,0
2020-03-12,Siskiyou,093,43540,0,0,0,0,0
2020-03-12,Solano,095,438530,34,26,0,26,0
2020-03-12,Sonoma,097,501317,34,2,0,2,0
2020-03-12,Stanislaus,099,539301,15,2,2,4,0
2020-03-12,Sutter,101,95872,0,0,0,0,0
2020-03-12,Tehama,103,63373,0,0,0,0,0
2020-03-12,Trinity,105,12862,0,0,0,0,0
2020-03-12,Tulare,107,460477,12,1,1,2,0
2020-03-12,Tuolumne,109,53932,1,0,0,0,0
2020-03-12,Ventura,111,848112,45,3,0,3,0
2020-03-12,Yolo,113,214977,14,1,0,1,0
2020-03-12,Yuba,115,75493,1,0,0,0,0
2020-03-11,Alameda,001,1643700,120,5,0,5,0
2020-03-11,Alpine,003,1148,0,0,0,0,0
2020-03-11,Amador,005,37829,0,0,0,0,0
2020-03-11,Butte,007,227075,0,0,0,0,0
2020-03-11,Calaveras,009,45235,2,2,0,2,0
2020-03-11,Colusa,011,21464,0,0,0,0,0
2020-03-11,Contra Costa,013,1133247,94,16,0,16,0
2020-03-11,Del Norte,015,27424,0,0,0,0,0
2020-03-11,El Dorado,017,186661,7,0,0,0,0
2020-03-11,Fresno,019,978130,9,1,1,2,0
2020-03-11,Glenn,021,27897,0,0,0,0,0
2020-03-11,Humboldt,023,135768,6,1,0,1,0
2020-03-11,Imperial,025,180216,9,0,0,0,0
2020-03-11,Inyo,027,18085,0,0,0,0,0
2020-03-11,Kern,029,883053,16,0,0,0,0
2020-03-11,Kings,031,150075,5,0,1,1,0
2020-03-11,Lake,033,64148,0,0,0,0,0
2020-03-11,Lassen,035,31185,1,0,0,0,0
2020-03-11,Los Angeles,037,10098052,698,21,10,31,0
2020-03-11,Madera,039,155013,12,1,0,1,0
2020-03-11,Marin,041,260295,17,1,0,1,0
2020-03-11,Mariposa,043,17540,0,0,0,0,0
2020-03-11,Mendocino,045,87422,1,0,0,0,0
2020-03-11,Merced,047,269075,2,0,0,0,0
2020-03-11,Modoc,049,8938,0,0,0,0,0
2020-03-11,Mono,051,14174,3,0,0,0,0
2020-03-11,Monterey,053,433212,7,0,0,0,0
2020-03-11,Napa,055,140530,2,0,0,0,0
2020-03-11,Nevada,057,99092,4,0,1,1,0
2020-03-11,Orange,059,3164182,202,6,0,6,0
2020-03-11,Placer,061,380077,18,6,0,6,1
2020-03-11,Plumas,063,18699,0,0,0,0,0
2020-03-11,Riverside,065,2383286,81,4,1,5,0
2020-03-11,Sacramento,067,1510023,87,9,0,9,1
2020-03-11,San Benito,069,59416,5,2,0,2,0
2020-03-11,San Bernardino,071,2135413,72,0,0,0,0
2020-03-11,San Diego,073,3302833,208,4,0,4,0
2020-03-11,San Francisco,075,870044,124,17,0,17,0
2020-03-11,San Joaquin,077,732212,33,1,3,4,0
2020-03-11,San Luis Obispo,079,281455,23,0,0,0,0
2020-03-11,San Mateo,081,765935,140,16,0,16,0
2020-03-11,Santa Barbara,083,443738,13,0,0,0,0
2020-03-11,Santa Clara,085,1922200,369,48,1,49,1
2020-03-11,Santa Cruz,087,273765,26,2,0,2,0
2020-03-11,Shasta,089,179085,2,1,0,1,0
2020-03-11,Sierra,091,2930,0,0,0,0,0
2020-03-11,Siskiyou,093,43540,0,0,0,0,0
2020-03-11,Solano,095,438530,29,26,0,26,0
2020-03-11,Sonoma,097,501317,30,2,0,2,0
2020-03-11,Stanislaus,099,539301,15,2,2,4,0
2020-03-11,Sutter,101,95872,0,0,0,0,0
2020-03-11,Tehama,103,63373,0,0,0,0,0
2020-03-11,Trinity,105,12862,0,0,0,0,0
2020-03-11,Tulare,107,460477,10,0,1,1,0
2020-03-11,Tuolumne,109,53932,1,0,0,0,0
2020-03-11,Ventura,111,848112,37,3,0,3,0
2020-03-11,Yolo,113,214977,10,1,0,1,0
2020-03-11,Yuba,115,75493,1,0,0,0,0
2020-03-10,Alameda,001,1643700,98,4,0,4,0
2020-03-10,Alpine,003,1148,0,0,0,0,0
2020-03-10,Amador,005,37829,0,0,0,0,0
2020-03-10,Butte,007,227075,0,0,0,0,0
2020-03-10,Calaveras,009,45235,2,2,0,2,0
2020-03-10,Colusa,011,21464,0,0,0,0,0
2020-03-10,Contra Costa,013,1133247,85,11,0,11,0
2020-03-10,Del Norte,015,27424,0,0,0,0,0
2020-03-10,El Dorado,017,186661,6,0,0,0,0
2020-03-10,Fresno,019,978130,7,1,1,2,0
2020-03-10,Glenn,021,27897,0,0,0,0,0
2020-03-10,Humboldt,023,135768,6,1,0,1,0
2020-03-10,Imperial,025,180216,8,0,0,0,0
2020-03-10,Inyo,027,18085,0,0,0,0,0
2020-03-10,Kern,029,883053,11,0,0,0,0
2020-03-10,Kings,031,150075,5,0,1,1,0
2020-03-10,Lake,033,64148,0,0,0,0,0
2020-03-10,Lassen,035,31185,1,0,0,0,0
2020-03-10,Los Angeles,037,10098052,562,20,10,30,0
2020-03-10,Madera,039,155013,7,1,0,1,0
2020-03-10,Marin,041,260295,16,1,0,1,0
2020-03-10,Mariposa,043,17540,0,0,0,0,0
2020-03-10,Mendocino,045,87422,0,0,0,0,0
2020-03-10,Merced,047,269075,2,0,0,0,0
2020-03-10,Modoc,049,8938,0,0,0,0,0
2020-03-10,Mono,051,14174,3,0,0,0,0
2020-03-10,Monterey,053,433212,5,0,0,0,0
2020-03-10,Napa,055,140530,2,0,0,0,0
2020-03-10,Nevada,057,99092,3,0,1,1,0
2020-03-10,Orange,059,3164182,182,5,0,5,1
2020-03-10,Placer,061,380077,14,7,0,7,1
2020-03-10,Plumas,063,18699,0,0,0,0,0
2020-03-10,Riverside,065,2383286,59,4,1,5,0
2020-03-10,Sacramento,067,1510023,78,8,0,8,0
2020-03-10,San Benito,069,59416,5,2,0,2,0
2020-03-10,San Bernardino,071,2135413,64,0,0,0,0
2020-03-10,San Diego,073,3302833,165,3,0,3,0
2020-03-10,San Francisco,075,870044,92,16,0,16,0
2020-03-10,San Joaquin,077,732212,30,1,3,4,0
2020-03-10,San Luis Obispo,079,281455,15,0,0,0,0
2020-03-10,San Mateo,081,765935,124,11,0,11,0
2020-03-10,Santa Barbara,083,443738,10,0,0,0,0
2020-03-10,Santa Clara,085,1922200,321,45,1,46,1
2020-03-10,Santa Cruz,087,273765,22,2,0,2,0
2020-03-10,Shasta,089,179085,2,1,0,1,0
2020-03-10,Sierra,091,2930,0,0,0,0,0
2020-03-10,Siskiyou,093,43540,0,0,0,0,0
2020-03-10,Solano,095,438530,27,26,0,26,0
2020-03-10,Sonoma,097,501317,27,2,0,2,0
2020-03-10,Stanislaus,099,539301,11,0,2,2,0
2020-03-10,Sutter,101,95872,0,0,0,0,0
2020-03-10,Tehama,103,63373,0,0,0,0,0
2020-03-10,Trinity,105,12862,0,0,0,0,0
2020-03-10,Tulare,107,460477,9,0,1,1,0
2020-03-10,Tuolumne,109,53932,1,0,0,0,0
2020-03-10,Ventura,111,848112,29,1,0,1,0
2020-03-10,Yolo,113,214977,7,2,0,2,0
2020-03-10,Yuba,115,75493,1,0,0,0,0
2020-03-09,Alameda,001,1643700,70,4,0,4,0
2020-03-09,Alpine,003,1148,0,0,0,0,0
2020-03-09,Amador,005,37829,0,0,0,0,0
2020-03-09,Butte,007,227075,0,0,0,0,0
2020-03-09,Calaveras,009,45235,2,0,0,0,0
2020-03-09,Colusa,011,21464,0,0,0,0,0
2020-03-09,Contra Costa,013,1133247,72,9,0,9,0
2020-03-09,Del Norte,015,27424,0,0,0,0,0
2020-03-09,El Dorado,017,186661,4,0,0,0,0
2020-03-09,Fresno,019,978130,7,1,1,2,0
2020-03-09,Glenn,021,27897,0,0,0,0,0
2020-03-09,Humboldt,023,135768,5,1,0,1,0
2020-03-09,Imperial,025,180216,8,0,0,0,0
2020-03-09,Inyo,027,18085,0,0,0,0,0
2020-03-09,Kern,029,883053,8,0,0,0,0
2020-03-09,Kings,031,150075,4,0,1,1,0
2020-03-09,Lake,033,64148,0,0,0,0,0
2020-03-09,Lassen,035,31185,1,0,0,0,0
2020-03-09,Los Angeles,037,10098052,460,17,9,26,0
2020-03-09,Madera,039,155013,7,1,0,1,0
2020-03-09,Marin,041,260295,15,1,0,1,0
2020-03-09,Mariposa,043,17540,0,0,0,0,0
2020-03-09,Mendocino,045,87422,0,0,0,0,0
2020-03-09,Merced,047,269075,2,0,0,0,0
2020-03-09,Modoc,049,8938,0,0,0,0,0
2020-03-09,Mono,051,14174,3,0,0,0,0
2020-03-09,Monterey,053,433212,3,0,0,0,0
2020-03-09,Napa,055,140530,2,0,0,0,0
2020-03-09,Nevada,057,99092,2,0,1,1,0
2020-03-09,Orange,059,3164182,154,4,0,4,0
2020-03-09,Placer,061,380077,12,7,0,7,1
2020-03-09,Plumas,063,18699,0,0,0,0,0
2020-03-09,Riverside,065,2383286,49,4,1,5,0
2020-03-09,Sacramento,067,1510023,74,8,0,8,0
2020-03-09,San Benito,069,59416,3,2,0,2,0
2020-03-09,San Bernardino,071,2135413,53,0,0,0,0
2020-03-09,San Diego,073,3302833,126,2,0,2,0
2020-03-09,San Francisco,075,870044,72,14,0,14,0
2020-03-09,San Joaquin,077,732212,21,0,3,3,0
2020-03-09,San Luis Obispo,079,281455,15,0,0,0,0
2020-03-09,San Mateo,081,765935,110,6,0,6,0
2020-03-09,Santa Barbara,083,443738,8,0,0,0,0
2020-03-09,Santa Clara,085,1922200,277,42,1,43,1
2020-03-09,Santa Cruz,087,273765,19,2,0,2,0
2020-03-09,Shasta,089,179085,2,1,0,1,0
2020-03-09,Sierra,091,2930,0,0,0,0,0
2020-03-09,Siskiyou,093,43540,0,0,0,0,0
2020-03-09,Solano,095,438530,25,26,0,26,0
2020-03-09,Sonoma,097,501317,22,2,0,2,0
2020-03-09,Stanislaus,099,539301,11,0,2,2,0
2020-03-09,Sutter,101,95872,0,0,0,0,0
2020-03-09,Tehama,103,63373,0,0,0,0,0
2020-03-09,Trinity,105,12862,0,0,0,0,0
2020-03-09,Tulare,107,460477,9,0,1,1,0
2020-03-09,Tuolumne,109,53932,1,0,0,0,0
2020-03-09,Ventura,111,848112,25,1,0,1,0
2020-03-09,Yolo,113,214977,6,2,0,2,0
2020-03-09,Yuba,115,75493,0,0,0,0,0
2020-03-08,Alameda,001,1643700,45,4,0,4,0
2020-03-08,Alpine,003,1148,0,0,0,0,0
2020-03-08,Amador,005,37829,0,0,0,0,0
2020-03-08,Butte,007,227075,0,0,0,0,0
2020-03-08,Calaveras,009,45235,2,0,0,0,0
2020-03-08,Colusa,011,21464,0,0,0,0,0
2020-03-08,Contra Costa,013,1133247,58,9,0,9,0
2020-03-08,Del Norte,015,27424,0,0,0,0,0
2020-03-08,El Dorado,017,186661,4,0,0,0,0
2020-03-08,Fresno,019,978130,5,1,1,2,0
2020-03-08,Glenn,021,27897,0,0,0,0,0
2020-03-08,Humboldt,023,135768,5,1,0,1,0
2020-03-08,Imperial,025,180216,8,0,0,0,0
2020-03-08,Inyo,027,18085,0,0,0,0,0
2020-03-08,Kern,029,883053,8,0,0,0,0
2020-03-08,Kings,031,150075,3,0,1,1,0
2020-03-08,Lake,033,64148,0,0,0,0,0
2020-03-08,Lassen,035,31185,0,0,0,0,0
2020-03-08,Los Angeles,037,10098052,367,14,9,23,0
2020-03-08,Madera,039,155013,7,1,0,1,0
2020-03-08,Marin,041,260295,13,1,0,1,0
2020-03-08,Mariposa,043,17540,0,0,0,0,0
2020-03-08,Mendocino,045,87422,0,0,0,0,0
2020-03-08,Merced,047,269075,2,0,0,0,0
2020-03-08,Modoc,049,8938,0,0,0,0,0
2020-03-08,Mono,051,14174,3,0,0,0,0
2020-03-08,Monterey,053,433212,3,0,0,0,0
2020-03-08,Napa,055,140530,2,0,0,0,0
2020-03-08,Nevada,057,99092,1,0,1,1,0
2020-03-08,Orange,059,3164182,129,4,0,4,0
2020-03-08,Placer,061,380077,11,7,0,7,1
2020-03-08,Plumas,063,18699,0,0,0,0,0
2020-03-08,Riverside,065,2383286,41,1,1,2,0
2020-03-08,Sacramento,067,1510023,64,5,0,5,0
2020-03-08,San Benito,069,59416,3,2,0,2,0
2020-03-08,San Bernardino,071,2135413,42,0,0,0,0
2020-03-08,San Diego,073,3302833,92,2,0,2,0
2020-03-08,San Francisco,075,870044,53,9,0,9,0
2020-03-08,San Joaquin,077,732212,18,0,3,3,0
2020-03-08,San Luis Obispo,079,281455,9,0,0,0,0
2020-03-08,San Mateo,081,765935,97,4,0,4,0
2020-03-08,Santa Barbara,083,443738,5,0,0,0,0
2020-03-08,Santa Clara,085,1922200,235,36,1,37,0
2020-03-08,Santa Cruz,087,273765,17,1,0,1,0
2020-03-08,Shasta,089,179085,2,0,0,0,0
2020-03-08,Sierra,091,2930,0,0,0,0,0
2020-03-08,Siskiyou,093,43540,0,0,0,0,0
2020-03-08,Solano,095,438530,24,26,0,26,0
2020-03-08,Sonoma,097,501317,17,2,0,2,0
2020-03-08,Stanislaus,099,539301,10,0,2,2,0
2020-03-08,Sutter,101,95872,0,0,0,0,0
2020-03-08,Tehama,103,63373,0,0,0,0,0
2020-03-08,Trinity,105,12862,0,0,0,0,0
2020-03-08,Tulare,107,460477,9,0,0,0,0
2020-03-08,Tuolumne,109,53932,1,0,0,0,0
2020-03-08,Ventura,111,848112,21,1,0,1,0
2020-03-08,Yolo,113,214977,3,2,0,2,0
2020-03-08,Yuba,115,75493,0,0,0,0,0
2020-03-07,Alameda,001,1643700,40,3,0,3,0
2020-03-07,Alpine,003,1148,0,0,0,0,0
2020-03-07,Amador,005,37829,0,0,0,0,0
2020-03-07,Butte,007,227075,0,0,0,0,0
2020-03-07,Calaveras,009,45235,2,0,0,0,0
2020-03-07,Colusa,011,21464,0,0,0,0,0
2020-03-07,Contra Costa,013,1133247,55,4,0,4,0
2020-03-07,Del Norte,015,27424,0,0,0,0,0
2020-03-07,El Dorado,017,186661,3,0,0,0,0
2020-03-07,Fresno,019,978130,4,1,1,2,0
2020-03-07,Glenn,021,27897,0,0,0,0,0
2020-03-07,Humboldt,023,135768,5,1,0,1,0
2020-03-07,Imperial,025,180216,7,0,0,0,0
2020-03-07,Inyo,027,18085,0,0,0,0,0
2020-03-07,Kern,029,883053,7,0,0,0,0
2020-03-07,Kings,031,150075,3,0,1,1,0
2020-03-07,Lake,033,64148,0,0,0,0,0
2020-03-07,Lassen,035,31185,0,0,0,0,0
2020-03-07,Los Angeles,037,10098052,317,14,9,23,0
2020-03-07,Madera,039,155013,6,1,0,1,0
2020-03-07,Marin,041,260295,11,0,0,0,0
2020-03-07,Mariposa,043,17540,0,0,0,0,0
2020-03-07,Mendocino,045,87422,0,0,0,0,0
2020-03-07,Merced,047,269075,2,0,0,0,0
2020-03-07,Modoc,049,8938,0,0,0,0,0
2020-03-07,Mono,051,14174,3,0,0,0,0
2020-03-07,Monterey,053,433212,3,0,0,0,0
2020-03-07,Napa,055,140530,1,0,0,0,0
2020-03-07,Nevada,057,99092,1,0,1,1,0
2020-03-07,Orange,059,3164182,121,4,0,4,0
2020-03-07,Placer,061,380077,11,6,0,6,1
2020-03-07,Plumas,063,18699,0,0,0,0,0
2020-03-07,Riverside,065,2383286,31,0,1,1,0
2020-03-07,Sacramento,067,1510023,51,4,0,4,0
2020-03-07,San Benito,069,59416,3,2,0,2,0
2020-03-07,San Bernardino,071,2135413,40,0,0,0,0
2020-03-07,San Diego,073,3302833,74,2,0,2,0
2020-03-07,San Francisco,075,870044,47,9,0,9,0
2020-03-07,San Joaquin,077,732212,16,0,3,3,0
2020-03-07,San Luis Obispo,079,281455,6,0,0,0,0
2020-03-07,San Mateo,081,765935,87,1,0,1,0
2020-03-07,Santa Barbara,083,443738,5,0,0,0,0
2020-03-07,Santa Clara,085,1922200,205,31,1,32,0
2020-03-07,Santa Cruz,087,273765,17,1,0,1,0
2020-03-07,Shasta,089,179085,2,0,0,0,0
2020-03-07,Sierra,091,2930,0,0,0,0,0
2020-03-07,Siskiyou,093,43540,0,0,0,0,0
2020-03-07,Solano,095,438530,23,25,0,25,0
2020-03-07,Sonoma,097,501317,13,2,0,2,0
2020-03-07,Stanislaus,099,539301,9,0,2,2,0
2020-03-07,Sutter,101,95872,0,0,0,0,0
2020-03-07,Tehama,103,63373,0,0,0,0,0
2020-03-07,Trinity,105,12862,0,0,0,0,0
2020-03-07,Tulare,107,460477,6,0,0,0,0
2020-03-07,Tuolumne,109,53932,1,0,0,0,0
2020-03-07,Ventura,111,848112,18,1,0,1,0
2020-03-07,Yolo,113,214977,3,2,0,2,0
2020-03-07,Yuba,115,75493,0,0,0,0,0
2020-03-06,Alameda,001,1643700,38,3,0,3,0
2020-03-06,Alpine,003,1148,0,0,0,0,0
2020-03-06,Amador,005,37829,0,0,0,0,0
2020-03-06,Butte,007,227075,0,0,0,0,0
2020-03-06,Calaveras,009,45235,2,0,0,0,0
2020-03-06,Colusa,011,21464,0,0,0,0,0
2020-03-06,Contra Costa,013,1133247,46,4,0,4,0
2020-03-06,Del Norte,015,27424,0,0,0,0,0
2020-03-06,El Dorado,017,186661,3,0,0,0,0
2020-03-06,Fresno,019,978130,3,0,1,1,0
2020-03-06,Glenn,021,27897,0,0,0,0,0
2020-03-06,Humboldt,023,135768,4,1,0,1,0
2020-03-06,Imperial,025,180216,6,0,0,0,0
2020-03-06,Inyo,027,18085,0,0,0,0,0
2020-03-06,Kern,029,883053,6,0,0,0,0
2020-03-06,Kings,031,150075,3,0,1,1,0
2020-03-06,Lake,033,64148,0,0,0,0,0
2020-03-06,Lassen,035,31185,0,0,0,0,0
2020-03-06,Los Angeles,037,10098052,274,13,9,22,0
2020-03-06,Madera,039,155013,5,0,0,0,0
2020-03-06,Marin,041,260295,10,0,0,0,0
2020-03-06,Mariposa,043,17540,0,0,0,0,0
2020-03-06,Mendocino,045,87422,0,0,0,0,0
2020-03-06,Merced,047,269075,2,0,0,0,0
2020-03-06,Modoc,049,8938,0,0,0,0,0
2020-03-06,Mono,051,14174,1,0,0,0,0
2020-03-06,Monterey,053,433212,3,0,0,0,0
2020-03-06,Napa,055,140530,1,0,0,0,0
2020-03-06,Nevada,057,99092,1,0,1,1,0
2020-03-06,Orange,059,3164182,95,4,0,4,0
2020-03-06,Placer,061,380077,10,5,0,5,1
2020-03-06,Plumas,063,18699,0,0,0,0,0
2020-03-06,Riverside,065,2383286,30,0,1,1,0
2020-03-06,Sacramento,067,1510023,42,2,0,2,0
2020-03-06,San Benito,069,59416,3,2,0,2,0
2020-03-06,San Bernardino,071,2135413,38,0,0,0,0
2020-03-06,San Diego,073,3302833,61,2,0,2,0
2020-03-06,San Francisco,075,870044,41,2,0,2,0
2020-03-06,San Joaquin,077,732212,13,0,3,3,0
2020-03-06,San Luis Obispo,079,281455,4,0,0,0,0
2020-03-06,San Mateo,081,765935,79,1,0,1,0
2020-03-06,Santa Barbara,083,443738,3,0,0,0,0
2020-03-06,Santa Clara,085,1922200,187,20,1,21,0
2020-03-06,Santa Cruz,087,273765,15,0,0,0,0
2020-03-06,Shasta,089,179085,2,0,0,0,0
2020-03-06,Sierra,091,2930,0,0,0,0,0
2020-03-06,Siskiyou,093,43540,0,0,0,0,0
2020-03-06,Solano,095,438530,22,25,0,25,0
2020-03-06,Sonoma,097,501317,13,2,0,2,0
2020-03-06,Stanislaus,099,539301,5,0,2,2,0
2020-03-06,Sutter,101,95872,0,0,0,0,0
2020-03-06,Tehama,103,63373,0,0,0,0,0
2020-03-06,Trinity,105,12862,0,0,0,0,0
2020-03-06,Tulare,107,460477,6,0,0,0,0
2020-03-06,Tuolumne,109,53932,1,0,0,0,0
2020-03-06,Ventura,111,848112,15,1,0,1,0
2020-03-06,Yolo,113,214977,3,1,0,1,0
2020-03-06,Yuba,115,75493,0,0,0,0,0
2020-03-05,Alameda,001,1643700,33,2,0,2,0
2020-03-05,Alpine,003,1148,0,0,0,0,0
2020-03-05,Amador,005,37829,0,0,0,0,0
2020-03-05,Butte,007,227075,0,0,0,0,0
2020-03-05,Calaveras,009,45235,2,0,0,0,0
2020-03-05,Colusa,011,21464,0,0,0,0,0
2020-03-05,Contra Costa,013,1133247,39,1,0,1,0
2020-03-05,Del Norte,015,27424,0,0,0,0,0
2020-03-05,El Dorado,017,186661,1,0,0,0,0
2020-03-05,Fresno,019,978130,3,0,1,1,0
2020-03-05,Glenn,021,27897,0,0,0,0,0
2020-03-05,Humboldt,023,135768,4,1,0,1,0
2020-03-05,Imperial,025,180216,5,0,0,0,0
2020-03-05,Inyo,027,18085,0,0,0,0,0
2020-03-05,Kern,029,883053,6,0,0,0,0
2020-03-05,Kings,031,150075,3,0,1,1,0
2020-03-05,Lake,033,64148,0,0,0,0,0
2020-03-05,Lassen,035,31185,0,0,0,0,0
2020-03-05,Los Angeles,037,10098052,227,11,9,20,0
2020-03-05,Madera,039,155013,5,0,0,0,0
2020-03-05,Marin,041,260295,10,0,0,0,0
2020-03-05,Mariposa,043,17540,0,0,0,0,0
2020-03-05,Mendocino,045,87422,0,0,0,0,0
2020-03-05,Merced,047,269075,2,0,0,0,0
2020-03-05,Modoc,049,8938,0,0,0,0,0
2020-03-05,Mono,051,14174,1,0,0,0,0
2020-03-05,Monterey,053,433212,3,0,0,0,0
2020-03-05,Napa,055,140530,1,0,0,0,0
2020-03-05,Nevada,057,99092,0,0,1,1,0
2020-03-05,Orange,059,3164182,80,3,0,3,0
2020-03-05,Placer,061,380077,10,2,0,2,1
2020-03-05,Plumas,063,18699,0,0,0,0,0
2020-03-05,Riverside,065,2383286,27,0,1,1,0
2020-03-05,Sacramento,067,1510023,36,2,0,2,0
2020-03-05,San Benito,069,59416,1,2,0,2,0
2020-03-05,San Bernardino,071,2135413,33,0,0,0,0
2020-03-05,San Diego,073,3302833,54,2,0,2,0
2020-03-05,San Francisco,075,870044,31,2,0,2,0
2020-03-05,San Joaquin,077,732212,10,0,3,3,0
2020-03-05,San Luis Obispo,079,281455,4,0,0,0,0
2020-03-05,San Mateo,081,765935,65,1,0,1,0
2020-03-05,Santa Barbara,083,443738,2,0,0,0,0
2020-03-05,Santa Clara,085,1922200,163,14,1,15,0
2020-03-05,Santa Cruz,087,273765,13,0,0,0,0
2020-03-05,Shasta,089,179085,2,0,0,0,0
2020-03-05,Sierra,091,2930,0,0,0,0,0
2020-03-05,Siskiyou,093,43540,0,0,0,0,0
2020-03-05,Solano,095,438530,22,24,0,24,0
2020-03-05,Sonoma,097,501317,12,2,0,2,0
2020-03-05,Stanislaus,099,539301,4,0,2,2,0
2020-03-05,Sutter,101,95872,0,0,0,0,0
2020-03-05,Tehama,103,63373,0,0,0,0,0
2020-03-05,Trinity,105,12862,0,0,0,0,0
2020-03-05,Tulare,107,460477,6,0,0,0,0
2020-03-05,Tuolumne,109,53932,1,0,0,0,0
2020-03-05,Ventura,111,848112,13,0,0,0,0
2020-03-05,Yolo,113,214977,3,0,0,0,0
2020-03-05,Yuba,115,75493,0,0,0,0,0
2020-03-04,Alameda,001,1643700,29,2,0,2,0
2020-03-04,Alpine,003,1148,0,0,0,0,0
2020-03-04,Amador,005,37829,0,0,0,0,0
2020-03-04,Butte,007,227075,0,0,0,0,0
2020-03-04,Calaveras,009,45235,0,0,0,0,0
2020-03-04,Colusa,011,21464,0,0,0,0,0
2020-03-04,Contra Costa,013,1133247,34,1,0,1,0
2020-03-04,Del Norte,015,27424,0,0,0,0,0
2020-03-04,El Dorado,017,186661,1,0,0,0,0
2020-03-04,Fresno,019,978130,3,0,1,1,0
2020-03-04,Glenn,021,27897,0,0,0,0,0
2020-03-04,Humboldt,023,135768,1,1,0,1,0
2020-03-04,Imperial,025,180216,5,0,0,0,0
2020-03-04,Inyo,027,18085,0,0,0,0,0
2020-03-04,Kern,029,883053,6,0,0,0,0
2020-03-04,Kings,031,150075,3,0,1,1,0
2020-03-04,Lake,033,64148,0,0,0,0,0
2020-03-04,Lassen,035,31185,0,0,0,0,0
2020-03-04,Los Angeles,037,10098052,192,7,9,16,0
2020-03-04,Madera,039,155013,5,0,0,0,0
2020-03-04,Marin,041,260295,10,0,0,0,0
2020-03-04,Mariposa,043,17540,0,0,0,0,0
2020-03-04,Mendocino,045,87422,0,0,0,0,0
2020-03-04,Merced,047,269075,2,0,0,0,0
2020-03-04,Modoc,049,8938,0,0,0,0,0
2020-03-04,Mono,051,14174,1,0,0,0,0
2020-03-04,Monterey,053,433212,3,0,0,0,0
2020-03-04,Napa,055,140530,1,0,0,0,0
2020-03-04,Nevada,057,99092,0,0,1,1,0
2020-03-04,Orange,059,3164182,77,3,0,3,0
2020-03-04,Placer,061,380077,9,2,0,2,1
2020-03-04,Plumas,063,18699,0,0,0,0,0
2020-03-04,Riverside,065,2383286,23,0,1,1,0
2020-03-04,Sacramento,067,1510023,31,1,0,1,0
2020-03-04,San Benito,069,59416,1,2,0,2,0
2020-03-04,San Bernardino,071,2135413,30,0,0,0,0
2020-03-04,San Diego,073,3302833,41,2,0,2,0
2020-03-04,San Francisco,075,870044,26,0,0,0,0
2020-03-04,San Joaquin,077,732212,9,0,3,3,0
2020-03-04,San Luis Obispo,079,281455,4,0,0,0,0
2020-03-04,San Mateo,081,765935,60,1,0,1,0
2020-03-04,Santa Barbara,083,443738,2,0,0,0,0
2020-03-04,Santa Clara,085,1922200,146,12,1,13,0
2020-03-04,Santa Cruz,087,273765,13,0,0,0,0
2020-03-04,Shasta,089,179085,2,0,0,0,0
2020-03-04,Sierra,091,2930,0,0,0,0,0
2020-03-04,Siskiyou,093,43540,0,0,0,0,0
2020-03-04,Solano,095,438530,21,24,0,24,0
2020-03-04,Sonoma,097,501317,11,2,0,2,0
2020-03-04,Stanislaus,099,539301,4,0,2,2,0
2020-03-04,Sutter,101,95872,0,0,0,0,0
2020-03-04,Tehama,103,63373,0,0,0,0,0
2020-03-04,Trinity,105,12862,0,0,0,0,0
2020-03-04,Tulare,107,460477,6,0,0,0,0
2020-03-04,Tuolumne,109,53932,0,0,0,0,0
2020-03-04,Ventura,111,848112,12,0,0,0,0
2020-03-04,Yolo,113,214977,3,0,0,0,0
2020-03-04,Yuba,115,75493,0,0,0,0,0
2020-03-03,Alameda,001,1643700,24,2,0,2,0
2020-03-03,Alpine,003,1148,0,0,0,0,0
2020-03-03,Amador,005,37829,0,0,0,0,0
2020-03-03,Butte,007,227075,0,0,0,0,0
2020-03-03,Calaveras,009,45235,0,0,0,0,0
2020-03-03,Colusa,011,21464,0,0,0,0,0
2020-03-03,Contra Costa,013,1133247,30,0,0,0,0
2020-03-03,Del Norte,015,27424,0,0,0,0,0
2020-03-03,El Dorado,017,186661,1,0,0,0,0
2020-03-03,Fresno,019,978130,2,0,1,1,0
2020-03-03,Glenn,021,27897,0,0,0,0,0
2020-03-03,Humboldt,023,135768,1,1,0,1,0
2020-03-03,Imperial,025,180216,5,0,0,0,0
2020-03-03,Inyo,027,18085,0,0,0,0,0
2020-03-03,Kern,029,883053,4,0,0,0,0
2020-03-03,Kings,031,150075,3,0,1,1,0
2020-03-03,Lake,033,64148,0,0,0,0,0
2020-03-03,Lassen,035,31185,0,0,0,0,0
2020-03-03,Los Angeles,037,10098052,173,5,9,14,0
2020-03-03,Madera,039,155013,4,0,0,0,0
2020-03-03,Marin,041,260295,6,0,0,0,0
2020-03-03,Mariposa,043,17540,0,0,0,0,0
2020-03-03,Mendocino,045,87422,0,0,0,0,0
2020-03-03,Merced,047,269075,2,0,0,0,0
2020-03-03,Modoc,049,8938,0,0,0,0,0
2020-03-03,Mono,051,14174,1,0,0,0,0
2020-03-03,Monterey,053,433212,2,0,0,0,0
2020-03-03,Napa,055,140530,1,0,0,0,0
2020-03-03,Nevada,057,99092,0,0,1,1,0
2020-03-03,Orange,059,3164182,69,1,0,1,0
2020-03-03,Placer,061,380077,8,2,0,2,0
2020-03-03,Plumas,063,18699,0,0,0,0,0
2020-03-03,Riverside,065,2383286,20,0,1,1,0
2020-03-03,Sacramento,067,1510023,30,1,0,1,0
2020-03-03,San Benito,069,59416,1,2,0,2,0
2020-03-03,San Bernardino,071,2135413,27,0,0,0,0
2020-03-03,San Diego,073,3302833,34,2,0,2,0
2020-03-03,San Francisco,075,870044,24,0,0,0,0
2020-03-03,San Joaquin,077,732212,8,0,3,3,0
2020-03-03,San Luis Obispo,079,281455,2,0,0,0,0
2020-03-03,San Mateo,081,765935,53,1,0,1,0
2020-03-03,Santa Barbara,083,443738,1,0,0,0,0
2020-03-03,Santa Clara,085,1922200,131,11,1,12,0
2020-03-03,Santa Cruz,087,273765,10,0,0,0,0
2020-03-03,Shasta,089,179085,2,0,0,0,0
2020-03-03,Sierra,091,2930,0,0,0,0,0
2020-03-03,Siskiyou,093,43540,0,0,0,0,0
2020-03-03,Solano,095,438530,20,24,0,24,0
2020-03-03,Sonoma,097,501317,11,1,0,1,0
2020-03-03,Stanislaus,099,539301,4,0,2,2,0
2020-03-03,Sutter,101,95872,0,0,0,0,0
2020-03-03,Tehama,103,63373,0,0,0,0,0
2020-03-03,Trinity,105,12862,0,0,0,0,0
2020-03-03,Tulare,107,460477,6,0,0,0,0
2020-03-03,Tuolumne,109,53932,0,0,0,0,0
2020-03-03,Ventura,111,848112,11,0,0,0,0
2020-03-03,Yolo,113,214977,2,0,0,0,0
2020-03-03,Yuba,115,75493,0,0,0,0,0
2020-03-02,Alameda,001,1643700,21,1,0,1,0
2020-03-02,Alpine,003,1148,0,0,0,0,0
2020-03-02,Amador,005,37829,0,0,0,0,0
2020-03-02,Butte,007,227075,0,0,0,0,0
2020-03-02,Calaveras,009,45235,0,0,0,0,0
2020-03-02,Colusa,011,21464,0,0,0,0,0
2020-03-02,Contra Costa,013,1133247,27,0,0,0,0
2020-03-02,Del Norte,015,27424,0,0,0,0,0
2020-03-02,El Dorado,017,186661,1,0,0,0,0
2020-03-02,Fresno,019,978130,2,0,1,1,0
2020-03-02,Glenn,021,27897,0,0,0,0,0
2020-03-02,Humboldt,023,135768,1,1,0,1,0
2020-03-02,Imperial,025,180216,5,0,0,0,0
2020-03-02,Inyo,027,18085,0,0,0,0,0
2020-03-02,Kern,029,883053,4,0,0,0,0
2020-03-02,Kings,031,150075,3,0,1,1,0
2020-03-02,Lake,033,64148,0,0,0,0,0
2020-03-02,Lassen,035,31185,0,0,0,0,0
2020-03-02,Los Angeles,037,10098052,158,1,9,10,0
2020-03-02,Madera,039,155013,4,0,0,0,0
2020-03-02,Marin,041,260295,6,0,0,0,0
2020-03-02,Mariposa,043,17540,0,0,0,0,0
2020-03-02,Mendocino,045,87422,0,0,0,0,0
2020-03-02,Merced,047,269075,1,0,0,0,0
2020-03-02,Modoc,049,8938,0,0,0,0,0
2020-03-02,Mono,051,14174,1,0,0,0,0
2020-03-02,Monterey,053,433212,2,0,0,0,0
2020-03-02,Napa,055,140530,1,0,0,0,0
2020-03-02,Nevada,057,99092,0,0,1,1,0
2020-03-02,Orange,059,3164182,64,1,0,1,0
2020-03-02,Placer,061,380077,8,1,0,1,0
2020-03-02,Plumas,063,18699,0,0,0,0,0
2020-03-02,Riverside,065,2383286,19,0,1,1,0
2020-03-02,Sacramento,067,1510023,25,1,0,1,0
2020-03-02,San Benito,069,59416,1,2,0,2,0
2020-03-02,San Bernardino,071,2135413,27,0,0,0,0
2020-03-02,San Diego,073,3302833,28,2,0,2,0
2020-03-02,San Francisco,075,870044,17,0,0,0,0
2020-03-02,San Joaquin,077,732212,7,0,3,3,0
2020-03-02,San Luis Obispo,079,281455,2,0,0,0,0
2020-03-02,San Mateo,081,765935,44,1,0,1,0
2020-03-02,Santa Barbara,083,443738,1,0,0,0,0
2020-03-02,Santa Clara,085,1922200,109,7,1,8,0
2020-03-02,Santa Cruz,087,273765,9,0,0,0,0
2020-03-02,Shasta,089,179085,2,0,0,0,0
2020-03-02,Sierra,091,2930,0,0,0,0,0
2020-03-02,Siskiyou,093,43540,0,0,0,0,0
2020-03-02,Solano,095,438530,19,24,0,24,0
2020-03-02,Sonoma,097,501317,10,1,0,1,0
2020-03-02,Stanislaus,099,539301,2,0,2,2,0
2020-03-02,Sutter,101,95872,0,0,0,0,0
2020-03-02,Tehama,103,63373,0,0,0,0,0
2020-03-02,Trinity,105,12862,0,0,0,0,0
2020-03-02,Tulare,107,460477,6,0,0,0,0
2020-03-02,Tuolumne,109,53932,0,0,0,0,0
2020-03-02,Ventura,111,848112,10,0,0,0,0
2020-03-02,Yolo,113,214977,2,0,0,0,0
2020-03-02,Yuba,115,75493,0,0,0,0,0
2020-03-01,Alameda,001,1643700,20,1,0,1,0
2020-03-01,Alpine,003,1148,0,0,0,0,0
2020-03-01,Amador,005,37829,0,0,0,0,0
2020-03-01,Butte,007,227075,0,0,0,0,0
2020-03-01,Calaveras,009,45235,0,0,0,0,0
2020-03-01,Colusa,011,21464,0,0,0,0,0
2020-03-01,Contra Costa,013,1133247,24,0,0,0,0
2020-03-01,Del Norte,015,27424,0,0,0,0,0
2020-03-01,El Dorado,017,186661,1,0,0,0,0
2020-03-01,Fresno,019,978130,1,0,1,1,0
2020-03-01,Glenn,021,27897,0,0,0,0,0
2020-03-01,Humboldt,023,135768,1,1,0,1,0
2020-03-01,Imperial,025,180216,5,0,0,0,0
2020-03-01,Inyo,027,18085,0,0,0,0,0
2020-03-01,Kern,029,883053,2,0,0,0,0
2020-03-01,Kings,031,150075,3,0,1,1,0
2020-03-01,Lake,033,64148,0,0,0,0,0
2020-03-01,Lassen,035,31185,0,0,0,0,0
2020-03-01,Los Angeles,037,10098052,139,1,9,10,0
2020-03-01,Madera,039,155013,2,0,0,0,0
2020-03-01,Marin,041,260295,5,0,0,0,0
2020-03-01,Mariposa,043,17540,0,0,0,0,0
2020-03-01,Mendocino,045,87422,0,0,0,0,0
2020-03-01,Merced,047,269075,1,0,0,0,0
2020-03-01,Modoc,049,8938,0,0,0,0,0
2020-03-01,Mono,051,14174,1,0,0,0,0
2020-03-01,Monterey,053,433212,1,0,0,0,0
2020-03-01,Napa,055,140530,1,0,0,0,0
2020-03-01,Nevada,057,99092,0,0,1,1,0
2020-03-01,Orange,059,3164182,61,1,0,1,0
2020-03-01,Placer,061,380077,8,0,0,0,0
2020-03-01,Plumas,063,18699,0,0,0,0,0
2020-03-01,Riverside,065,2383286,18,0,1,1,0
2020-03-01,Sacramento,067,1510023,21,1,0,1,0
2020-03-01,San Benito,069,59416,0,2,0,2,0
2020-03-01,San Bernardino,071,2135413,25,0,0,0,0
2020-03-01,San Diego,073,3302833,21,2,0,2,0
2020-03-01,San Francisco,075,870044,13,0,0,0,0
2020-03-01,San Joaquin,077,732212,7,0,3,3,0
2020-03-01,San Luis Obispo,079,281455,2,0,0,0,0
2020-03-01,San Mateo,081,765935,36,0,0,0,0
2020-03-01,Santa Barbara,083,443738,1,0,0,0,0
2020-03-01,Santa Clara,085,1922200,96,6,1,7,0
2020-03-01,Santa Cruz,087,273765,8,0,0,0,0
2020-03-01,Shasta,089,179085,2,0,0,0,0
2020-03-01,Sierra,091,2930,0,0,0,0,0
2020-03-01,Siskiyou,093,43540,0,0,0,0,0
2020-03-01,Solano,095,438530,19,24,0,24,0
2020-03-01,Sonoma,097,501317,9,0,0,0,0
2020-03-01,Stanislaus,099,539301,2,0,2,2,0
2020-03-01,Sutter,101,95872,0,0,0,0,0
2020-03-01,Tehama,103,63373,0,0,0,0,0
2020-03-01,Trinity,105,12862,0,0,0,0,0
2020-03-01,Tulare,107,460477,6,0,0,0,0
2020-03-01,Tuolumne,109,53932,0,0,0,0,0
2020-03-01,Ventura,111,848112,8,0,0,0,0
2020-03-01,Yolo,113,214977,2,0,0,0,0
2020-03-01,Yuba,115,75493,0,0,0,0,0
2020-02-29,Alameda,001,1643700,16,0,0,0,0
2020-02-29,Alpine,003,1148,0,0,0,0,0
2020-02-29,Amador,005,37829,0,0,0,0,0
2020-02-29,Butte,007,227075,0,0,0,0,0
2020-02-29,Calaveras,009,45235,0,0,0,0,0
2020-02-29,Colusa,011,21464,0,0,0,0,0
2020-02-29,Contra Costa,013,1133247,20,0,0,0,0
2020-02-29,Del Norte,015,27424,0,0,0,0,0
2020-02-29,El Dorado,017,186661,1,0,0,0,0
2020-02-29,Fresno,019,978130,1,0,0,0,0
2020-02-29,Glenn,021,27897,0,0,0,0,0
2020-02-29,Humboldt,023,135768,1,1,0,1,0
2020-02-29,Imperial,025,180216,3,0,0,0,0
2020-02-29,Inyo,027,18085,0,0,0,0,0
2020-02-29,Kern,029,883053,2,0,0,0,0
2020-02-29,Kings,031,150075,3,0,1,1,0
2020-02-29,Lake,033,64148,0,0,0,0,0
2020-02-29,Lassen,035,31185,0,0,0,0,0
2020-02-29,Los Angeles,037,10098052,111,1,9,10,0
2020-02-29,Madera,039,155013,2,0,0,0,0
2020-02-29,Marin,041,260295,4,0,0,0,0
2020-02-29,Mariposa,043,17540,0,0,0,0,0
2020-02-29,Mendocino,045,87422,0,0,0,0,0
2020-02-29,Merced,047,269075,1,0,0,0,0
2020-02-29,Modoc,049,8938,0,0,0,0,0
2020-02-29,Mono,051,14174,1,0,0,0,0
2020-02-29,Monterey,053,433212,1,0,0,0,0
2020-02-29,Napa,055,140530,1,0,0,0,0
2020-02-29,Nevada,057,99092,0,0,1,1,0
2020-02-29,Orange,059,3164182,56,1,0,1,0
2020-02-29,Placer,061,380077,7,0,0,0,0
2020-02-29,Plumas,063,18699,0,0,0,0,0
2020-02-29,Riverside,065,2383286,15,0,1,1,0
2020-02-29,Sacramento,067,1510023,16,1,0,1,0
2020-02-29,San Benito,069,59416,0,2,0,2,0
2020-02-29,San Bernardino,071,2135413,23,0,0,0,0
2020-02-29,San Diego,073,3302833,16,2,0,2,0
2020-02-29,San Francisco,075,870044,12,0,0,0,0
2020-02-29,San Joaquin,077,732212,6,0,3,3,0
2020-02-29,San Luis Obispo,079,281455,2,0,0,0,0
2020-02-29,San Mateo,081,765935,29,0,0,0,0
2020-02-29,Santa Barbara,083,443738,0,0,0,0,0
2020-02-29,Santa Clara,085,1922200,74,3,1,4,0
2020-02-29,Santa Cruz,087,273765,8,0,0,0,0
2020-02-29,Shasta,089,179085,2,0,0,0,0
2020-02-29,Sierra,091,2930,0,0,0,0,0
2020-02-29,Siskiyou,093,43540,0,0,0,0,0
2020-02-29,Solano,095,438530,18,23,0,23,0
2020-02-29,Sonoma,097,501317,6,0,0,0,0
2020-02-29,Stanislaus,099,539301,2,0,2,2,0
2020-02-29,Sutter,101,95872,0,0,0,0,0
2020-02-29,Tehama,103,63373,0,0,0,0,0
2020-02-29,Trinity,105,12862,0,0,0,0,0
2020-02-29,Tulare,107,460477,4,0,0,0,0
2020-02-29,Tuolumne,109,53932,0,0,0,0,0
2020-02-29,Ventura,111,848112,6,0,0,0,0
2020-02-29,Yolo,113,214977,2,0,0,0,0
2020-02-29,Yuba,115,75493,0,0,0,0,0
2020-02-28,Alameda,001,1643700,14,0,0,0,0
2020-02-28,Alpine,003,1148,0,0,0,0,0
2020-02-28,Amador,005,37829,0,0,0,0,0
2020-02-28,Butte,007,227075,0,0,0,0,0
2020-02-28,Calaveras,009,45235,0,0,0,0,0
2020-02-28,Colusa,011,21464,0,0,0,0,0
2020-02-28,Contra Costa,013,1133247,20,0,0,0,0
2020-02-28,Del Norte,015,27424,0,0,0,0,0
2020-02-28,El Dorado,017,186661,0,0,0,0,0
2020-02-28,Fresno,019,978130,1,0,0,0,0
2020-02-28,Glenn,021,27897,0,0,0,0,0
2020-02-28,Humboldt,023,135768,1,1,0,1,0
2020-02-28,Imperial,025,180216,3,0,0,0,0
2020-02-28,Inyo,027,18085,0,0,0,0,0
2020-02-28,Kern,029,883053,2,0,0,0,0
2020-02-28,Kings,031,150075,3,0,1,1,0
2020-02-28,Lake,033,64148,0,0,0,0,0
2020-02-28,Lassen,035,31185,0,0,0,0,0
2020-02-28,Los Angeles,037,10098052,103,1,9,10,0
2020-02-28,Madera,039,155013,2,0,0,0,0
2020-02-28,Marin,041,260295,2,0,0,0,0
2020-02-28,Mariposa,043,17540,0,0,0,0,0
2020-02-28,Mendocino,045,87422,0,0,0,0,0
2020-02-28,Merced,047,269075,1,0,0,0,0
2020-02-28,Modoc,049,8938,0,0,0,0,0
2020-02-28,Mono,051,14174,0,0,0,0,0
2020-02-28,Monterey,053,433212,1,0,0,0,0
2020-02-28,Napa,055,140530,1,0,0,0,0
2020-02-28,Nevada,057,99092,0,0,1,1,0
2020-02-28,Orange,059,3164182,54,1,0,1,0
2020-02-28,Placer,061,380077,7,0,0,0,0
2020-02-28,Plumas,063,18699,0,0,0,0,0
2020-02-28,Riverside,065,2383286,13,0,1,1,0
2020-02-28,Sacramento,067,1510023,10,1,0,1,0
2020-02-28,San Benito,069,59416,0,2,0,2,0
2020-02-28,San Bernardino,071,2135413,23,0,0,0,0
2020-02-28,San Diego,073,3302833,13,2,0,2,0
2020-02-28,San Francisco,075,870044,10,0,0,0,0
2020-02-28,San Joaquin,077,732212,6,0,3,3,0
2020-02-28,San Luis Obispo,079,281455,2,0,0,0,0
2020-02-28,San Mateo,081,765935,24,0,0,0,0
2020-02-28,Santa Barbara,083,443738,0,0,0,0,0
2020-02-28,Santa Clara,085,1922200,69,3,1,4,0
2020-02-28,Santa Cruz,087,273765,8,0,0,0,0
2020-02-28,Shasta,089,179085,2,0,0,0,0
2020-02-28,Sierra,091,2930,0,0,0,0,0
2020-02-28,Siskiyou,093,43540,0,0,0,0,0
2020-02-28,Solano,095,438530,17,23,0,23,0
2020-02-28,Sonoma,097,501317,6,0,0,0,0
2020-02-28,Stanislaus,099,539301,2,0,2,2,0
2020-02-28,Sutter,101,95872,0,0,0,0,0
2020-02-28,Tehama,103,63373,0,0,0,0,0
2020-02-28,Trinity,105,12862,0,0,0,0,0
2020-02-28,Tulare,107,460477,3,0,0,0,0
2020-02-28,Tuolumne,109,53932,0,0,0,0,0
2020-02-28,Ventura,111,848112,6,0,0,0,0
2020-02-28,Yolo,113,214977,2,0,0,0,0
2020-02-28,Yuba,115,75493,0,0,0,0,0
2020-02-27,Alameda,001,1643700,13,0,0,0,0
2020-02-27,Alpine,003,1148,0,0,0,0,0
2020-02-27,Amador,005,37829,0,0,0,0,0
2020-02-27,Butte,007,227075,0,0,0,0,0
2020-02-27,Calaveras,009,45235,0,0,0,0,0
2020-02-27,Colusa,011,21464,0,0,0,0,0
2020-02-27,Contra Costa,013,1133247,14,0,0,0,0
2020-02-27,Del Norte,015,27424,0,0,0,0,0
2020-02-27,El Dorado,017,186661,0,0,0,0,0
2020-02-27,Fresno,019,978130,1,0,0,0,0
2020-02-27,Glenn,021,27897,0,0,0,0,0
2020-02-27,Humboldt,023,135768,1,1,0,1,0
2020-02-27,Imperial,025,180216,3,0,0,0,0
2020-02-27,Inyo,027,18085,0,0,0,0,0
2020-02-27,Kern,029,883053,2,0,0,0,0
2020-02-27,Kings,031,150075,3,0,1,1,0
2020-02-27,Lake,033,64148,0,0,0,0,0
2020-02-27,Lassen,035,31185,0,0,0,0,0
2020-02-27,Los Angeles,037,10098052,95,1,9,10,0
2020-02-27,Madera,039,155013,2,0,0,0,0
2020-02-27,Marin,041,260295,1,0,0,0,0
2020-02-27,Mariposa,043,17540,0,0,0,0,0
2020-02-27,Mendocino,045,87422,0,0,0,0,0
2020-02-27,Merced,047,269075,1,0,0,0,0
2020-02-27,Modoc,049,8938,0,0,0,0,0
2020-02-27,Mono,051,14174,0,0,0,0,0
2020-02-27,Monterey,053,433212,1,0,0,0,0
2020-02-27,Napa,055,140530,1,0,0,0,0
2020-02-27,Nevada,057,99092,0,0,1,1,0
2020-02-27,Orange,059,3164182,48,1,0,1,0
2020-02-27,Placer,061,380077,6,0,0,0,0
2020-02-27,Plumas,063,18699,0,0,0,0,0
2020-02-27,Riverside,065,2383286,12,0,1,1,0
2020-02-27,Sacramento,067,1510023,10,1,0,1,0
2020-02-27,San Benito,069,59416,0,2,0,2,0
2020-02-27,San Bernardino,071,2135413,23,0,0,0,0
2020-02-27,San Diego,073,3302833,12,2,0,2,0
2020-02-27,San Francisco,075,870044,9,0,0,0,0
2020-02-27,San Joaquin,077,732212,5,0,3,3,0
2020-02-27,San Luis Obispo,079,281455,2,0,0,0,0
2020-02-27,San Mateo,081,765935,20,0,0,0,0
2020-02-27,Santa Barbara,083,443738,0,0,0,0,0
2020-02-27,Santa Clara,085,1922200,58,2,1,3,0
2020-02-27,Santa Cruz,087,273765,6,0,0,0,0
2020-02-27,Shasta,089,179085,0,0,0,0,0
2020-02-27,Sierra,091,2930,0,0,0,0,0
2020-02-27,Siskiyou,093,43540,0,0,0,0,0
2020-02-27,Solano,095,438530,17,23,0,23,0
2020-02-27,Sonoma,097,501317,5,0,0,0,0
2020-02-27,Stanislaus,099,539301,2,0,2,2,0
2020-02-27,Sutter,101,95872,0,0,0,0,0
2020-02-27,Tehama,103,63373,0,0,0,0,0
2020-02-27,Trinity,105,12862,0,0,0,0,0
2020-02-27,Tulare,107,460477,3,0,0,0,0
2020-02-27,Tuolumne,109,53932,0,0,0,0,0
2020-02-27,Ventura,111,848112,4,0,0,0,0
2020-02-27,Yolo,113,214977,2,0,0,0,0
2020-02-27,Yuba,115,75493,0,0,0,0,0
2020-02-26,Alameda,001,1643700,13,0,0,0,0
2020-02-26,Alpine,003,1148,0,0,0,0,0
2020-02-26,Amador,005,37829,0,0,0,0,0
2020-02-26,Butte,007,227075,0,0,0,0,0
2020-02-26,Calaveras,009,45235,0,0,0,0,0
2020-02-26,Colusa,011,21464,0,0,0,0,0
2020-02-26,Contra Costa,013,1133247,13,0,0,0,0
2020-02-26,Del Norte,015,27424,0,0,0,0,0
2020-02-26,El Dorado,017,186661,0,0,0,0,0
2020-02-26,Fresno,019,978130,1,0,0,0,0
2020-02-26,Glenn,021,27897,0,0,0,0,0
2020-02-26,Humboldt,023,135768,1,1,0,1,0
2020-02-26,Imperial,025,180216,3,0,0,0,0
2020-02-26,Inyo,027,18085,0,0,0,0,0
2020-02-26,Kern,029,883053,2,0,0,0,0
2020-02-26,Kings,031,150075,3,0,1,1,0
2020-02-26,Lake,033,64148,0,0,0,0,0
2020-02-26,Lassen,035,31185,0,0,0,0,0
2020-02-26,Los Angeles,037,10098052,89,1,9,10,0
2020-02-26,Madera,039,155013,2,0,0,0,0
2020-02-26,Marin,041,260295,1,0,0,0,0
2020-02-26,Mariposa,043,17540,0,0,0,0,0
2020-02-26,Mendocino,045,87422,0,0,0,0,0
2020-02-26,Merced,047,269075,1,0,0,0,0
2020-02-26,Modoc,049,8938,0,0,0,0,0
2020-02-26,Mono,051,14174,0,0,0,0,0
2020-02-26,Monterey,053,433212,1,0,0,0,0
2020-02-26,Napa,055,140530,0,0,0,0,0
2020-02-26,Nevada,057,99092,0,0,1,1,0
2020-02-26,Orange,059,3164182,47,1,0,1,0
2020-02-26,Placer,061,380077,5,0,0,0,0
2020-02-26,Plumas,063,18699,0,0,0,0,0
2020-02-26,Riverside,065,2383286,10,0,1,1,0
2020-02-26,Sacramento,067,1510023,10,1,0,1,0
2020-02-26,San Benito,069,59416,0,2,0,2,0
2020-02-26,San Bernardino,071,2135413,21,0,0,0,0
2020-02-26,San Diego,073,3302833,11,2,0,2,0
2020-02-26,San Francisco,075,870044,9,0,0,0,0
2020-02-26,San Joaquin,077,732212,5,0,3,3,0
2020-02-26,San Luis Obispo,079,281455,2,0,0,0,0
2020-02-26,San Mateo,081,765935,18,0,0,0,0
2020-02-26,Santa Barbara,083,443738,0,0,0,0,0
2020-02-26,Santa Clara,085,1922200,49,2,1,3,0
2020-02-26,Santa Cruz,087,273765,6,0,0,0,0
2020-02-26,Shasta,089,179085,0,0,0,0,0
2020-02-26,Sierra,091,2930,0,0,0,0,0
2020-02-26,Siskiyou,093,43540,0,0,0,0,0
2020-02-26,Solano,095,438530,17,23,0,23,0
2020-02-26,Sonoma,097,501317,5,0,0,0,0
2020-02-26,Stanislaus,099,539301,2,0,2,2,0
2020-02-26,Sutter,101,95872,0,0,0,0,0
2020-02-26,Tehama,103,63373,0,0,0,0,0
2020-02-26,Trinity,105,12862,0,0,0,0,0
2020-02-26,Tulare,107,460477,3,0,0,0,0
2020-02-26,Tuolumne,109,53932,0,0,0,0,0
2020-02-26,Ventura,111,848112,4,0,0,0,0
2020-02-26,Yolo,113,214977,2,0,0,0,0
2020-02-26,Yuba,115,75493,0,0,0,0,0
2020-02-25,Alameda,001,1643700,13,0,0,0,0
2020-02-25,Alpine,003,1148,0,0,0,0,0
2020-02-25,Amador,005,37829,0,0,0,0,0
2020-02-25,Butte,007,227075,0,0,0,0,0
2020-02-25,Calaveras,009,45235,0,0,0,0,0
2020-02-25,Colusa,011,21464,0,0,0,0,0
2020-02-25,Contra Costa,013,1133247,11,0,0,0,0
2020-02-25,Del Norte,015,27424,0,0,0,0,0
2020-02-25,El Dorado,017,186661,0,0,0,0,0
2020-02-25,Fresno,019,978130,1,0,0,0,0
2020-02-25,Glenn,021,27897,0,0,0,0,0
2020-02-25,Humboldt,023,135768,1,1,0,1,0
2020-02-25,Imperial,025,180216,3,0,0,0,0
2020-02-25,Inyo,027,18085,0,0,0,0,0
2020-02-25,Kern,029,883053,2,0,0,0,0
2020-02-25,Kings,031,150075,3,0,1,1,0
2020-02-25,Lake,033,64148,0,0,0,0,0
2020-02-25,Lassen,035,31185,0,0,0,0,0
2020-02-25,Los Angeles,037,10098052,77,1,9,10,0
2020-02-25,Madera,039,155013,2,0,0,0,0
2020-02-25,Marin,041,260295,1,0,0,0,0
2020-02-25,Mariposa,043,17540,0,0,0,0,0
2020-02-25,Mendocino,045,87422,0,0,0,0,0
2020-02-25,Merced,047,269075,0,0,0,0,0
2020-02-25,Modoc,049,8938,0,0,0,0,0
2020-02-25,Mono,051,14174,0,0,0,0,0
2020-02-25,Monterey,053,433212,1,0,0,0,0
2020-02-25,Napa,055,140530,0,0,0,0,0
2020-02-25,Nevada,057,99092,0,0,1,1,0
2020-02-25,Orange,059,3164182,46,1,0,1,0
2020-02-25,Placer,061,380077,5,0,0,0,0
2020-02-25,Plumas,063,18699,0,0,0,0,0
2020-02-25,Riverside,065,2383286,10,0,1,1,0
2020-02-25,Sacramento,067,1510023,8,1,0,1,0
2020-02-25,San Benito,069,59416,0,2,0,2,0
2020-02-25,San Bernardino,071,2135413,19,0,0,0,0
2020-02-25,San Diego,073,3302833,7,2,0,2,0
2020-02-25,San Francisco,075,870044,7,0,0,0,0
2020-02-25,San Joaquin,077,732212,5,0,2,2,0
2020-02-25,San Luis Obispo,079,281455,2,0,0,0,0
2020-02-25,San Mateo,081,765935,17,0,0,0,0
2020-02-25,Santa Barbara,083,443738,0,0,0,0,0
2020-02-25,Santa Clara,085,1922200,40,2,1,3,0
2020-02-25,Santa Cruz,087,273765,5,0,0,0,0
2020-02-25,Shasta,089,179085,0,0,0,0,0
2020-02-25,Sierra,091,2930,0,0,0,0,0
2020-02-25,Siskiyou,093,43540,0,0,0,0,0
2020-02-25,Solano,095,438530,16,21,0,21,0
2020-02-25,Sonoma,097,501317,5,0,0,0,0
2020-02-25,Stanislaus,099,539301,2,0,2,2,0
2020-02-25,Sutter,101,95872,0,0,0,0,0
2020-02-25,Tehama,103,63373,0,0,0,0,0
2020-02-25,Trinity,105,12862,0,0,0,0,0
2020-02-25,Tulare,107,460477,3,0,0,0,0
2020-02-25,Tuolumne,109,53932,0,0,0,0,0
2020-02-25,Ventura,111,848112,4,0,0,0,0
2020-02-25,Yolo,113,214977,2,0,0,0,0
2020-02-25,Yuba,115,75493,0,0,0,0,0
2020-02-24,Alameda,001,1643700,13,0,0,0,0
2020-02-24,Alpine,003,1148,0,0,0,0,0
2020-02-24,Amador,005,37829,0,0,0,0,0
2020-02-24,Butte,007,227075,0,0,0,0,0
2020-02-24,Calaveras,009,45235,0,0,0,0,0
2020-02-24,Colusa,011,21464,0,0,0,0,0
2020-02-24,Contra Costa,013,1133247,9,0,0,0,0
2020-02-24,Del Norte,015,27424,0,0,0,0,0
2020-02-24,El Dorado,017,186661,0,0,0,0,0
2020-02-24,Fresno,019,978130,1,0,0,0,0
2020-02-24,Glenn,021,27897,0,0,0,0,0
2020-02-24,Humboldt,023,135768,1,1,0,1,0
2020-02-24,Imperial,025,180216,3,0,0,0,0
2020-02-24,Inyo,027,18085,0,0,0,0,0
2020-02-24,Kern,029,883053,2,0,0,0,0
2020-02-24,Kings,031,150075,3,0,1,1,0
2020-02-24,Lake,033,64148,0,0,0,0,0
2020-02-24,Lassen,035,31185,0,0,0,0,0
2020-02-24,Los Angeles,037,10098052,72,1,9,10,0
2020-02-24,Madera,039,155013,1,0,0,0,0
2020-02-24,Marin,041,260295,1,0,0,0,0
2020-02-24,Mariposa,043,17540,0,0,0,0,0
2020-02-24,Mendocino,045,87422,0,0,0,0,0
2020-02-24,Merced,047,269075,0,0,0,0,0
2020-02-24,Modoc,049,8938,0,0,0,0,0
2020-02-24,Mono,051,14174,0,0,0,0,0
2020-02-24,Monterey,053,433212,1,0,0,0,0
2020-02-24,Napa,055,140530,0,0,0,0,0
2020-02-24,Nevada,057,99092,0,0,1,1,0
2020-02-24,Orange,059,3164182,44,1,0,1,0
2020-02-24,Placer,061,380077,3,0,0,0,0
2020-02-24,Plumas,063,18699,0,0,0,0,0
2020-02-24,Riverside,065,2383286,9,0,1,1,0
2020-02-24,Sacramento,067,1510023,7,1,0,1,0
2020-02-24,San Benito,069,59416,0,2,0,2,0
2020-02-24,San Bernardino,071,2135413,19,0,0,0,0
2020-02-24,San Diego,073,3302833,7,2,0,2,0
2020-02-24,San Francisco,075,870044,6,0,0,0,0
2020-02-24,San Joaquin,077,732212,5,0,1,1,0
2020-02-24,San Luis Obispo,079,281455,2,0,0,0,0
2020-02-24,San Mateo,081,765935,13,0,0,0,0
2020-02-24,Santa Barbara,083,443738,0,0,0,0,0
2020-02-24,Santa Clara,085,1922200,38,2,1,3,0
2020-02-24,Santa Cruz,087,273765,5,0,0,0,0
2020-02-24,Shasta,089,179085,0,0,0,0,0
2020-02-24,Sierra,091,2930,0,0,0,0,0
2020-02-24,Siskiyou,093,43540,0,0,0,0,0
2020-02-24,Solano,095,438530,13,15,0,15,0
2020-02-24,Sonoma,097,501317,5,0,0,0,0
2020-02-24,Stanislaus,099,539301,2,0,2,2,0
2020-02-24,Sutter,101,95872,0,0,0,0,0
2020-02-24,Tehama,103,63373,0,0,0,0,0
2020-02-24,Trinity,105,12862,0,0,0,0,0
2020-02-24,Tulare,107,460477,3,0,0,0,0
2020-02-24,Tuolumne,109,53932,0,0,0,0,0
2020-02-24,Ventura,111,848112,4,0,0,0,0
2020-02-24,Yolo,113,214977,2,0,0,0,0
2020-02-24,Yuba,115,75493,0,0,0,0,0
2020-02-23,Alameda,001,1643700,11,0,0,0,0
2020-02-23,Alpine,003,1148,0,0,0,0,0
2020-02-23,Amador,005,37829,0,0,0,0,0
2020-02-23,Butte,007,227075,0,0,0,0,0
2020-02-23,Calaveras,009,45235,0,0,0,0,0
2020-02-23,Colusa,011,21464,0,0,0,0,0
2020-02-23,Contra Costa,013,1133247,6,0,0,0,0
2020-02-23,Del Norte,015,27424,0,0,0,0,0
2020-02-23,El Dorado,017,186661,0,0,0,0,0
2020-02-23,Fresno,019,978130,1,0,0,0,0
2020-02-23,Glenn,021,27897,0,0,0,0,0
2020-02-23,Humboldt,023,135768,1,1,0,1,0
2020-02-23,Imperial,025,180216,3,0,0,0,0
2020-02-23,Inyo,027,18085,0,0,0,0,0
2020-02-23,Kern,029,883053,2,0,0,0,0
2020-02-23,Kings,031,150075,3,0,1,1,0
2020-02-23,Lake,033,64148,0,0,0,0,0
2020-02-23,Lassen,035,31185,0,0,0,0,0
2020-02-23,Los Angeles,037,10098052,64,1,9,10,0
2020-02-23,Madera,039,155013,1,0,0,0,0
2020-02-23,Marin,041,260295,1,0,0,0,0
2020-02-23,Mariposa,043,17540,0,0,0,0,0
2020-02-23,Mendocino,045,87422,0,0,0,0,0
2020-02-23,Merced,047,269075,0,0,0,0,0
2020-02-23,Modoc,049,8938,0,0,0,0,0
2020-02-23,Mono,051,14174,0,0,0,0,0
2020-02-23,Monterey,053,433212,1,0,0,0,0
2020-02-23,Napa,055,140530,0,0,0,0,0
2020-02-23,Nevada,057,99092,0,0,1,1,0
2020-02-23,Orange,059,3164182,44,1,0,1,0
2020-02-23,Placer,061,380077,3,0,0,0,0
2020-02-23,Plumas,063,18699,0,0,0,0,0
2020-02-23,Riverside,065,2383286,9,0,0,0,0
2020-02-23,Sacramento,067,1510023,6,1,0,1,0
2020-02-23,San Benito,069,59416,0,2,0,2,0
2020-02-23,San Bernardino,071,2135413,18,0,0,0,0
2020-02-23,San Diego,073,3302833,6,2,0,2,0
2020-02-23,San Francisco,075,870044,5,0,0,0,0
2020-02-23,San Joaquin,077,732212,4,0,1,1,0
2020-02-23,San Luis Obispo,079,281455,2,0,0,0,0
2020-02-23,San Mateo,081,765935,10,0,0,0,0
2020-02-23,Santa Barbara,083,443738,0,0,0,0,0
2020-02-23,Santa Clara,085,1922200,26,2,1,3,0
2020-02-23,Santa Cruz,087,273765,2,0,0,0,0
2020-02-23,Shasta,089,179085,0,0,0,0,0
2020-02-23,Sierra,091,2930,0,0,0,0,0
2020-02-23,Siskiyou,093,43540,0,0,0,0,0
2020-02-23,Solano,095,438530,11,15,0,15,0
2020-02-23,Sonoma,097,501317,5,0,0,0,0
2020-02-23,Stanislaus,099,539301,2,0,2,2,0
2020-02-23,Sutter,101,95872,0,0,0,0,0
2020-02-23,Tehama,103,63373,0,0,0,0,0
2020-02-23,Trinity,105,12862,0,0,0,0,0
2020-02-23,Tulare,107,460477,2,0,0,0,0
2020-02-23,Tuolumne,109,53932,0,0,0,0,0
2020-02-23,Ventura,111,848112,4,0,0,0,0
2020-02-23,Yolo,113,214977,2,0,0,0,0
2020-02-23,Yuba,115,75493,0,0,0,0,0
2020-02-22,Alameda,001,1643700,10,0,0,0,0
2020-02-22,Alpine,003,1148,0,0,0,0,0
2020-02-22,Amador,005,37829,0,0,0,0,0
2020-02-22,Butte,007,227075,0,0,0,0,0
2020-02-22,Calaveras,009,45235,0,0,0,0,0
2020-02-22,Colusa,011,21464,0,0,0,0,0
2020-02-22,Contra Costa,013,1133247,5,0,0,0,0
2020-02-22,Del Norte,015,27424,0,0,0,0,0
2020-02-22,El Dorado,017,186661,0,0,0,0,0
2020-02-22,Fresno,019,978130,1,0,0,0,0
2020-02-22,Glenn,021,27897,0,0,0,0,0
2020-02-22,Humboldt,023,135768,1,1,0,1,0
2020-02-22,Imperial,025,180216,2,0,0,0,0
2020-02-22,Inyo,027,18085,0,0,0,0,0
2020-02-22,Kern,029,883053,2,0,0,0,0
2020-02-22,Kings,031,150075,3,0,1,1,0
2020-02-22,Lake,033,64148,0,0,0,0,0
2020-02-22,Lassen,035,31185,0,0,0,0,0
2020-02-22,Los Angeles,037,10098052,62,1,9,10,0
2020-02-22,Madera,039,155013,0,0,0,0,0
2020-02-22,Marin,041,260295,1,0,0,0,0
2020-02-22,Mariposa,043,17540,0,0,0,0,0
2020-02-22,Mendocino,045,87422,0,0,0,0,0
2020-02-22,Merced,047,269075,0,0,0,0,0
2020-02-22,Modoc,049,8938,0,0,0,0,0
2020-02-22,Mono,051,14174,0,0,0,0,0
2020-02-22,Monterey,053,433212,1,0,0,0,0
2020-02-22,Napa,055,140530,0,0,0,0,0
2020-02-22,Nevada,057,99092,0,0,1,1,0
2020-02-22,Orange,059,3164182,43,1,0,1,0
2020-02-22,Placer,061,380077,3,0,0,0,0
2020-02-22,Plumas,063,18699,0,0,0,0,0
2020-02-22,Riverside,065,2383286,9,0,0,0,0
2020-02-22,Sacramento,067,1510023,6,1,0,1,0
2020-02-22,San Benito,069,59416,0,2,0,2,0
2020-02-22,San Bernardino,071,2135413,16,0,0,0,0
2020-02-22,San Diego,073,3302833,5,2,0,2,0
2020-02-22,San Francisco,075,870044,3,0,0,0,0
2020-02-22,San Joaquin,077,732212,4,0,1,1,0
2020-02-22,San Luis Obispo,079,281455,2,0,0,0,0
2020-02-22,San Mateo,081,765935,8,0,0,0,0
2020-02-22,Santa Barbara,083,443738,0,0,0,0,0
2020-02-22,Santa Clara,085,1922200,23,2,1,3,0
2020-02-22,Santa Cruz,087,273765,2,0,0,0,0
2020-02-22,Shasta,089,179085,0,0,0,0,0
2020-02-22,Sierra,091,2930,0,0,0,0,0
2020-02-22,Siskiyou,093,43540,0,0,0,0,0
2020-02-22,Solano,095,438530,11,11,0,11,0
2020-02-22,Sonoma,097,501317,4,0,0,0,0
2020-02-22,Stanislaus,099,539301,2,0,2,2,0
2020-02-22,Sutter,101,95872,0,0,0,0,0
2020-02-22,Tehama,103,63373,0,0,0,0,0
2020-02-22,Trinity,105,12862,0,0,0,0,0
2020-02-22,Tulare,107,460477,2,0,0,0,0
2020-02-22,Tuolumne,109,53932,0,0,0,0,0
2020-02-22,Ventura,111,848112,4,0,0,0,0
2020-02-22,Yolo,113,214977,1,0,0,0,0
2020-02-22,Yuba,115,75493,0,0,0,0,0
2020-02-21,Alameda,001,1643700,9,0,0,0,0
2020-02-21,Alpine,003,1148,0,0,0,0,0
2020-02-21,Amador,005,37829,0,0,0,0,0
2020-02-21,Butte,007,227075,0,0,0,0,0
2020-02-21,Calaveras,009,45235,0,0,0,0,0
2020-02-21,Colusa,011,21464,0,0,0,0,0
2020-02-21,Contra Costa,013,1133247,4,0,0,0,0
2020-02-21,Del Norte,015,27424,0,0,0,0,0
2020-02-21,El Dorado,017,186661,0,0,0,0,0
2020-02-21,Fresno,019,978130,1,0,0,0,0
2020-02-21,Glenn,021,27897,0,0,0,0,0
2020-02-21,Humboldt,023,135768,1,1,0,1,0
2020-02-21,Imperial,025,180216,2,0,0,0,0
2020-02-21,Inyo,027,18085,0,0,0,0,0
2020-02-21,Kern,029,883053,2,0,0,0,0
2020-02-21,Kings,031,150075,3,0,1,1,0
2020-02-21,Lake,033,64148,0,0,0,0,0
2020-02-21,Lassen,035,31185,0,0,0,0,0
2020-02-21,Los Angeles,037,10098052,58,1,9,10,0
2020-02-21,Madera,039,155013,0,0,0,0,0
2020-02-21,Marin,041,260295,1,0,0,0,0
2020-02-21,Mariposa,043,17540,0,0,0,0,0
2020-02-21,Mendocino,045,87422,0,0,0,0,0
2020-02-21,Merced,047,269075,0,0,0,0,0
2020-02-21,Modoc,049,8938,0,0,0,0,0
2020-02-21,Mono,051,14174,0,0,0,0,0
2020-02-21,Monterey,053,433212,1,0,0,0,0
2020-02-21,Napa,055,140530,0,0,0,0,0
2020-02-21,Nevada,057,99092,0,0,1,1,0
2020-02-21,Orange,059,3164182,41,1,0,1,0
2020-02-21,Placer,061,380077,2,0,0,0,0
2020-02-21,Plumas,063,18699,0,0,0,0,0
2020-02-21,Riverside,065,2383286,9,0,0,0,0
2020-02-21,Sacramento,067,1510023,5,1,0,1,0
2020-02-21,San Benito,069,59416,0,2,0,2,0
2020-02-21,San Bernardino,071,2135413,15,0,0,0,0
2020-02-21,San Diego,073,3302833,5,2,0,2,0
2020-02-21,San Francisco,075,870044,3,0,0,0,0
2020-02-21,San Joaquin,077,732212,2,0,1,1,0
2020-02-21,San Luis Obispo,079,281455,2,0,0,0,0
2020-02-21,San Mateo,081,765935,8,0,0,0,0
2020-02-21,Santa Barbara,083,443738,0,0,0,0,0
2020-02-21,Santa Clara,085,1922200,21,2,1,3,0
2020-02-21,Santa Cruz,087,273765,2,0,0,0,0
2020-02-21,Shasta,089,179085,0,0,0,0,0
2020-02-21,Sierra,091,2930,0,0,0,0,0
2020-02-21,Siskiyou,093,43540,0,0,0,0,0
2020-02-21,Solano,095,438530,10,11,0,11,0
2020-02-21,Sonoma,097,501317,3,0,0,0,0
2020-02-21,Stanislaus,099,539301,2,0,2,2,0
2020-02-21,Sutter,101,95872,0,0,0,0,0
2020-02-21,Tehama,103,63373,0,0,0,0,0
2020-02-21,Trinity,105,12862,0,0,0,0,0
2020-02-21,Tulare,107,460477,2,0,0,0,0
2020-02-21,Tuolumne,109,53932,0,0,0,0,0
2020-02-21,Ventura,111,848112,4,0,0,0,0
2020-02-21,Yolo,113,214977,1,0,0,0,0
2020-02-21,Yuba,115,75493,0,0,0,0,0
2020-02-20,Alameda,001,1643700,7,0,0,0,0
2020-02-20,Alpine,003,1148,0,0,0,0,0
2020-02-20,Amador,005,37829,0,0,0,0,0
2020-02-20,Butte,007,227075,0,0,0,0,0
2020-02-20,Calaveras,009,45235,0,0,0,0,0
2020-02-20,Colusa,011,21464,0,0,0,0,0
2020-02-20,Contra Costa,013,1133247,3,0,0,0,0
2020-02-20,Del Norte,015,27424,0,0,0,0,0
2020-02-20,El Dorado,017,186661,0,0,0,0,0
2020-02-20,Fresno,019,978130,1,0,0,0,0
2020-02-20,Glenn,021,27897,0,0,0,0,0
2020-02-20,Humboldt,023,135768,1,1,0,1,0
2020-02-20,Imperial,025,180216,2,0,0,0,0
2020-02-20,Inyo,027,18085,0,0,0,0,0
2020-02-20,Kern,029,883053,2,0,0,0,0
2020-02-20,Kings,031,150075,3,0,1,1,0
2020-02-20,Lake,033,64148,0,0,0,0,0
2020-02-20,Lassen,035,31185,0,0,0,0,0
2020-02-20,Los Angeles,037,10098052,57,1,8,9,0
2020-02-20,Madera,039,155013,0,0,0,0,0
2020-02-20,Marin,041,260295,0,0,0,0,0
2020-02-20,Mariposa,043,17540,0,0,0,0,0
2020-02-20,Mendocino,045,87422,0,0,0,0,0
2020-02-20,Merced,047,269075,0,0,0,0,0
2020-02-20,Modoc,049,8938,0,0,0,0,0
2020-02-20,Mono,051,14174,0,0,0,0,0
2020-02-20,Monterey,053,433212,1,0,0,0,0
2020-02-20,Napa,055,140530,0,0,0,0,0
2020-02-20,Nevada,057,99092,0,0,1,1,0
2020-02-20,Orange,059,3164182,41,1,0,1,0
2020-02-20,Placer,061,380077,2,0,0,0,0
2020-02-20,Plumas,063,18699,0,0,0,0,0
2020-02-20,Riverside,065,2383286,7,0,0,0,0
2020-02-20,Sacramento,067,1510023,2,1,0,1,0
2020-02-20,San Benito,069,59416,0,2,0,2,0
2020-02-20,San Bernardino,071,2135413,14,0,0,0,0
2020-02-20,San Diego,073,3302833,5,2,0,2,0
2020-02-20,San Francisco,075,870044,3,0,0,0,0
2020-02-20,San Joaquin,077,732212,2,0,1,1,0
2020-02-20,San Luis Obispo,079,281455,2,0,0,0,0
2020-02-20,San Mateo,081,765935,7,0,0,0,0
2020-02-20,Santa Barbara,083,443738,0,0,0,0,0
2020-02-20,Santa Clara,085,1922200,17,2,1,3,0
2020-02-20,Santa Cruz,087,273765,2,0,0,0,0
2020-02-20,Shasta,089,179085,0,0,0,0,0
2020-02-20,Sierra,091,2930,0,0,0,0,0
2020-02-20,Siskiyou,093,43540,0,0,0,0,0
2020-02-20,Solano,095,438530,8,7,0,7,0
2020-02-20,Sonoma,097,501317,2,0,0,0,0
2020-02-20,Stanislaus,099,539301,2,0,2,2,0
2020-02-20,Sutter,101,95872,0,0,0,0,0
2020-02-20,Tehama,103,63373,0,0,0,0,0
2020-02-20,Trinity,105,12862,0,0,0,0,0
2020-02-20,Tulare,107,460477,2,0,0,0,0
2020-02-20,Tuolumne,109,53932,0,0,0,0,0
2020-02-20,Ventura,111,848112,4,0,0,0,0
2020-02-20,Yolo,113,214977,1,0,0,0,0
2020-02-20,Yuba,115,75493,0,0,0,0,0
2020-02-19,Alameda,001,1643700,6,0,0,0,0
2020-02-19,Alpine,003,1148,0,0,0,0,0
2020-02-19,Amador,005,37829,0,0,0,0,0
2020-02-19,Butte,007,227075,0,0,0,0,0
2020-02-19,Calaveras,009,45235,0,0,0,0,0
2020-02-19,Colusa,011,21464,0,0,0,0,0
2020-02-19,Contra Costa,013,1133247,3,0,0,0,0
2020-02-19,Del Norte,015,27424,0,0,0,0,0
2020-02-19,El Dorado,017,186661,0,0,0,0,0
2020-02-19,Fresno,019,978130,1,0,0,0,0
2020-02-19,Glenn,021,27897,0,0,0,0,0
2020-02-19,Humboldt,023,135768,1,0,0,0,0
2020-02-19,Imperial,025,180216,2,0,0,0,0
2020-02-19,Inyo,027,18085,0,0,0,0,0
2020-02-19,Kern,029,883053,2,0,0,0,0
2020-02-19,Kings,031,150075,3,0,1,1,0
2020-02-19,Lake,033,64148,0,0,0,0,0
2020-02-19,Lassen,035,31185,0,0,0,0,0
2020-02-19,Los Angeles,037,10098052,54,1,8,9,0
2020-02-19,Madera,039,155013,0,0,0,0,0
2020-02-19,Marin,041,260295,0,0,0,0,0
2020-02-19,Mariposa,043,17540,0,0,0,0,0
2020-02-19,Mendocino,045,87422,0,0,0,0,0
2020-02-19,Merced,047,269075,0,0,0,0,0
2020-02-19,Modoc,049,8938,0,0,0,0,0
2020-02-19,Mono,051,14174,0,0,0,0,0
2020-02-19,Monterey,053,433212,1,0,0,0,0
2020-02-19,Napa,055,140530,0,0,0,0,0
2020-02-19,Nevada,057,99092,0,0,1,1,0
2020-02-19,Orange,059,3164182,40,1,0,1,0
2020-02-19,Placer,061,380077,2,0,0,0,0
2020-02-19,Plumas,063,18699,0,0,0,0,0
2020-02-19,Riverside,065,2383286,5,0,0,0,0
2020-02-19,Sacramento,067,1510023,2,0,0,0,0
2020-02-19,San Benito,069,59416,0,2,0,2,0
2020-02-19,San Bernardino,071,2135413,13,0,0,0,0
2020-02-19,San Diego,073,3302833,4,2,0,2,0
2020-02-19,San Francisco,075,870044,2,0,0,0,0
2020-02-19,San Joaquin,077,732212,2,0,1,1,0
2020-02-19,San Luis Obispo,079,281455,2,0,0,0,0
2020-02-19,San Mateo,081,765935,6,0,0,0,0
2020-02-19,Santa Barbara,083,443738,0,0,0,0,0
2020-02-19,Santa Clara,085,1922200,15,2,1,3,0
2020-02-19,Santa Cruz,087,273765,0,0,0,0,0
2020-02-19,Shasta,089,179085,0,0,0,0,0
2020-02-19,Sierra,091,2930,0,0,0,0,0
2020-02-19,Siskiyou,093,43540,0,0,0,0,0
2020-02-19,Solano,095,438530,5,7,0,7,0
2020-02-19,Sonoma,097,501317,2,0,0,0,0
2020-02-19,Stanislaus,099,539301,1,0,2,2,0
2020-02-19,Sutter,101,95872,0,0,0,0,0
2020-02-19,Tehama,103,63373,0,0,0,0,0
2020-02-19,Trinity,105,12862,0,0,0,0,0
2020-02-19,Tulare,107,460477,2,0,0,0,0
2020-02-19,Tuolumne,109,53932,0,0,0,0,0
2020-02-19,Ventura,111,848112,2,0,0,0,0
2020-02-19,Yolo,113,214977,1,0,0,0,0
2020-02-19,Yuba,115,75493,0,0,0,0,0
2020-02-18,Alameda,001,1643700,6,0,0,0,0
2020-02-18,Alpine,003,1148,0,0,0,0,0
2020-02-18,Amador,005,37829,0,0,0,0,0
2020-02-18,Butte,007,227075,0,0,0,0,0
2020-02-18,Calaveras,009,45235,0,0,0,0,0
2020-02-18,Colusa,011,21464,0,0,0,0,0
2020-02-18,Contra Costa,013,1133247,3,0,0,0,0
2020-02-18,Del Norte,015,27424,0,0,0,0,0
2020-02-18,El Dorado,017,186661,0,0,0,0,0
2020-02-18,Fresno,019,978130,0,0,0,0,0
2020-02-18,Glenn,021,27897,0,0,0,0,0
2020-02-18,Humboldt,023,135768,1,0,0,0,0
2020-02-18,Imperial,025,180216,1,0,0,0,0
2020-02-18,Inyo,027,18085,0,0,0,0,0
2020-02-18,Kern,029,883053,2,0,0,0,0
2020-02-18,Kings,031,150075,3,0,1,1,0
2020-02-18,Lake,033,64148,0,0,0,0,0
2020-02-18,Lassen,035,31185,0,0,0,0,0
2020-02-18,Los Angeles,037,10098052,51,1,7,8,0
2020-02-18,Madera,039,155013,0,0,0,0,0
2020-02-18,Marin,041,260295,0,0,0,0,0
2020-02-18,Mariposa,043,17540,0,0,0,0,0
2020-02-18,Mendocino,045,87422,0,0,0,0,0
2020-02-18,Merced,047,269075,0,0,0,0,0
2020-02-18,Modoc,049,8938,0,0,0,0,0
2020-02-18,Mono,051,14174,0,0,0,0,0
2020-02-18,Monterey,053,433212,1,0,0,0,0
2020-02-18,Napa,055,140530,0,0,0,0,0
2020-02-18,Nevada,057,99092,0,0,1,1,0
2020-02-18,Orange,059,3164182,39,1,0,1,0
2020-02-18,Placer,061,380077,0,0,0,0,0
2020-02-18,Plumas,063,18699,0,0,0,0,0
2020-02-18,Riverside,065,2383286,5,0,0,0,0
2020-02-18,Sacramento,067,1510023,2,0,0,0,0
2020-02-18,San Benito,069,59416,0,2,0,2,0
2020-02-18,San Bernardino,071,2135413,13,0,0,0,0
2020-02-18,San Diego,073,3302833,4,2,0,2,0
2020-02-18,San Francisco,075,870044,2,0,0,0,0
2020-02-18,San Joaquin,077,732212,1,0,1,1,0
2020-02-18,San Luis Obispo,079,281455,2,0,0,0,0
2020-02-18,San Mateo,081,765935,5,0,0,0,0
2020-02-18,Santa Barbara,083,443738,0,0,0,0,0
2020-02-18,Santa Clara,085,1922200,14,2,1,3,0
2020-02-18,Santa Cruz,087,273765,0,0,0,0,0
2020-02-18,Shasta,089,179085,0,0,0,0,0
2020-02-18,Sierra,091,2930,0,0,0,0,0
2020-02-18,Siskiyou,093,43540,0,0,0,0,0
2020-02-18,Solano,095,438530,5,7,0,7,0
2020-02-18,Sonoma,097,501317,1,0,0,0,0
2020-02-18,Stanislaus,099,539301,1,0,2,2,0
2020-02-18,Sutter,101,95872,0,0,0,0,0
2020-02-18,Tehama,103,63373,0,0,0,0,0
2020-02-18,Trinity,105,12862,0,0,0,0,0
2020-02-18,Tulare,107,460477,2,0,0,0,0
2020-02-18,Tuolumne,109,53932,0,0,0,0,0
2020-02-18,Ventura,111,848112,2,0,0,0,0
2020-02-18,Yolo,113,214977,1,0,0,0,0
2020-02-18,Yuba,115,75493,0,0,0,0,0
2020-02-17,Alameda,001,1643700,6,0,0,0,0
2020-02-17,Alpine,003,1148,0,0,0,0,0
2020-02-17,Amador,005,37829,0,0,0,0,0
2020-02-17,Butte,007,227075,0,0,0,0,0
2020-02-17,Calaveras,009,45235,0,0,0,0,0
2020-02-17,Colusa,011,21464,0,0,0,0,0
2020-02-17,Contra Costa,013,1133247,3,0,0,0,0
2020-02-17,Del Norte,015,27424,0,0,0,0,0
2020-02-17,El Dorado,017,186661,0,0,0,0,0
2020-02-17,Fresno,019,978130,0,0,0,0,0
2020-02-17,Glenn,021,27897,0,0,0,0,0
2020-02-17,Humboldt,023,135768,1,0,0,0,0
2020-02-17,Imperial,025,180216,1,0,0,0,0
2020-02-17,Inyo,027,18085,0,0,0,0,0
2020-02-17,Kern,029,883053,2,0,0,0,0
2020-02-17,Kings,031,150075,3,0,0,0,0
2020-02-17,Lake,033,64148,0,0,0,0,0
2020-02-17,Lassen,035,31185,0,0,0,0,0
2020-02-17,Los Angeles,037,10098052,48,1,6,7,0
2020-02-17,Madera,039,155013,0,0,0,0,0
2020-02-17,Marin,041,260295,0,0,0,0,0
2020-02-17,Mariposa,043,17540,0,0,0,0,0
2020-02-17,Mendocino,045,87422,0,0,0,0,0
2020-02-17,Merced,047,269075,0,0,0,0,0
2020-02-17,Modoc,049,8938,0,0,0,0,0
2020-02-17,Mono,051,14174,0,0,0,0,0
2020-02-17,Monterey,053,433212,1,0,0,0,0
2020-02-17,Napa,055,140530,0,0,0,0,0
2020-02-17,Nevada,057,99092,0,0,1,1,0
2020-02-17,Orange,059,3164182,39,1,0,1,0
2020-02-17,Placer,061,380077,0,0,0,0,0
2020-02-17,Plumas,063,18699,0,0,0,0,0
2020-02-17,Riverside,065,2383286,5,0,0,0,0
2020-02-17,Sacramento,067,1510023,2,0,0,0,0
2020-02-17,San Benito,069,59416,0,2,0,2,0
2020-02-17,San Bernardino,071,2135413,11,0,0,0,0
2020-02-17,San Diego,073,3302833,4,2,0,2,0
2020-02-17,San Francisco,075,870044,2,0,0,0,0
2020-02-17,San Joaquin,077,732212,1,0,1,1,0
2020-02-17,San Luis Obispo,079,281455,1,0,0,0,0
2020-02-17,San Mateo,081,765935,5,0,0,0,0
2020-02-17,Santa Barbara,083,443738,0,0,0,0,0
2020-02-17,Santa Clara,085,1922200,12,2,1,3,0
2020-02-17,Santa Cruz,087,273765,0,0,0,0,0
2020-02-17,Shasta,089,179085,0,0,0,0,0
2020-02-17,Sierra,091,2930,0,0,0,0,0
2020-02-17,Siskiyou,093,43540,0,0,0,0,0
2020-02-17,Solano,095,438530,3,5,0,5,0
2020-02-17,Sonoma,097,501317,1,0,0,0,0
2020-02-17,Stanislaus,099,539301,1,0,2,2,0
2020-02-17,Sutter,101,95872,0,0,0,0,0
2020-02-17,Tehama,103,63373,0,0,0,0,0
2020-02-17,Trinity,105,12862,0,0,0,0,0
2020-02-17,Tulare,107,460477,2,0,0,0,0
2020-02-17,Tuolumne,109,53932,0,0,0,0,0
2020-02-17,Ventura,111,848112,2,0,0,0,0
2020-02-17,Yolo,113,214977,1,0,0,0,0
2020-02-17,Yuba,115,75493,0,0,0,0,0
2020-02-16,Alameda,001,1643700,5,0,0,0,0
2020-02-16,Alpine,003,1148,0,0,0,0,0
2020-02-16,Amador,005,37829,0,0,0,0,0
2020-02-16,Butte,007,227075,0,0,0,0,0
2020-02-16,Calaveras,009,45235,0,0,0,0,0
2020-02-16,Colusa,011,21464,0,0,0,0,0
2020-02-16,Contra Costa,013,1133247,3,0,0,0,0
2020-02-16,Del Norte,015,27424,0,0,0,0,0
2020-02-16,El Dorado,017,186661,0,0,0,0,0
2020-02-16,Fresno,019,978130,0,0,0,0,0
2020-02-16,Glenn,021,27897,0,0,0,0,0
2020-02-16,Humboldt,023,135768,1,0,0,0,0
2020-02-16,Imperial,025,180216,1,0,0,0,0
2020-02-16,Inyo,027,18085,0,0,0,0,0
2020-02-16,Kern,029,883053,2,0,0,0,0
2020-02-16,Kings,031,150075,3,0,0,0,0
2020-02-16,Lake,033,64148,0,0,0,0,0
2020-02-16,Lassen,035,31185,0,0,0,0,0
2020-02-16,Los Angeles,037,10098052,42,1,6,7,0
2020-02-16,Madera,039,155013,0,0,0,0,0
2020-02-16,Marin,041,260295,0,0,0,0,0
2020-02-16,Mariposa,043,17540,0,0,0,0,0
2020-02-16,Mendocino,045,87422,0,0,0,0,0
2020-02-16,Merced,047,269075,0,0,0,0,0
2020-02-16,Modoc,049,8938,0,0,0,0,0
2020-02-16,Mono,051,14174,0,0,0,0,0
2020-02-16,Monterey,053,433212,1,0,0,0,0
2020-02-16,Napa,055,140530,0,0,0,0,0
2020-02-16,Nevada,057,99092,0,0,0,0,0
2020-02-16,Orange,059,3164182,38,1,0,1,0
2020-02-16,Placer,061,380077,0,0,0,0,0
2020-02-16,Plumas,063,18699,0,0,0,0,0
2020-02-16,Riverside,065,2383286,5,0,0,0,0
2020-02-16,Sacramento,067,1510023,2,0,0,0,0
2020-02-16,San Benito,069,59416,0,2,0,2,0
2020-02-16,San Bernardino,071,2135413,10,0,0,0,0
2020-02-16,San Diego,073,3302833,4,2,0,2,0
2020-02-16,San Francisco,075,870044,2,0,0,0,0
2020-02-16,San Joaquin,077,732212,1,0,1,1,0
2020-02-16,San Luis Obispo,079,281455,1,0,0,0,0
2020-02-16,San Mateo,081,765935,4,0,0,0,0
2020-02-16,Santa Barbara,083,443738,0,0,0,0,0
2020-02-16,Santa Clara,085,1922200,10,2,1,3,0
2020-02-16,Santa Cruz,087,273765,0,0,0,0,0
2020-02-16,Shasta,089,179085,0,0,0,0,0
2020-02-16,Sierra,091,2930,0,0,0,0,0
2020-02-16,Siskiyou,093,43540,0,0,0,0,0
2020-02-16,Solano,095,438530,1,0,0,0,0
2020-02-16,Sonoma,097,501317,1,0,0,0,0
2020-02-16,Stanislaus,099,539301,1,0,2,2,0
2020-02-16,Sutter,101,95872,0,0,0,0,0
2020-02-16,Tehama,103,63373,0,0,0,0,0
2020-02-16,Trinity,105,12862,0,0,0,0,0
2020-02-16,Tulare,107,460477,2,0,0,0,0
2020-02-16,Tuolumne,109,53932,0,0,0,0,0
2020-02-16,Ventura,111,848112,2,0,0,0,0
2020-02-16,Yolo,113,214977,1,0,0,0,0
2020-02-16,Yuba,115,75493,0,0,0,0,0
2020-02-15,Alameda,001,1643700,5,0,0,0,0
2020-02-15,Alpine,003,1148,0,0,0,0,0
2020-02-15,Amador,005,37829,0,0,0,0,0
2020-02-15,Butte,007,227075,0,0,0,0,0
2020-02-15,Calaveras,009,45235,0,0,0,0,0
2020-02-15,Colusa,011,21464,0,0,0,0,0
2020-02-15,Contra Costa,013,1133247,3,0,0,0,0
2020-02-15,Del Norte,015,27424,0,0,0,0,0
2020-02-15,El Dorado,017,186661,0,0,0,0,0
2020-02-15,Fresno,019,978130,0,0,0,0,0
2020-02-15,Glenn,021,27897,0,0,0,0,0
2020-02-15,Humboldt,023,135768,1,0,0,0,0
2020-02-15,Imperial,025,180216,1,0,0,0,0
2020-02-15,Inyo,027,18085,0,0,0,0,0
2020-02-15,Kern,029,883053,2,0,0,0,0
2020-02-15,Kings,031,150075,3,0,0,0,0
2020-02-15,Lake,033,64148,0,0,0,0,0
2020-02-15,Lassen,035,31185,0,0,0,0,0
2020-02-15,Los Angeles,037,10098052,39,1,6,7,0
2020-02-15,Madera,039,155013,0,0,0,0,0
2020-02-15,Marin,041,260295,0,0,0,0,0
2020-02-15,Mariposa,043,17540,0,0,0,0,0
2020-02-15,Mendocino,045,87422,0,0,0,0,0
2020-02-15,Merced,047,269075,0,0,0,0,0
2020-02-15,Modoc,049,8938,0,0,0,0,0
2020-02-15,Mono,051,14174,0,0,0,0,0
2020-02-15,Monterey,053,433212,1,0,0,0,0
2020-02-15,Napa,055,140530,0,0,0,0,0
2020-02-15,Nevada,057,99092,0,0,0,0,0
2020-02-15,Orange,059,3164182,37,1,0,1,0
2020-02-15,Placer,061,380077,0,0,0,0,0
2020-02-15,Plumas,063,18699,0,0,0,0,0
2020-02-15,Riverside,065,2383286,4,0,0,0,0
2020-02-15,Sacramento,067,1510023,2,0,0,0,0
2020-02-15,San Benito,069,59416,0,2,0,2,0
2020-02-15,San Bernardino,071,2135413,9,0,0,0,0
2020-02-15,San Diego,073,3302833,4,2,0,2,0
2020-02-15,San Francisco,075,870044,2,0,0,0,0
2020-02-15,San Joaquin,077,732212,1,0,1,1,0
2020-02-15,San Luis Obispo,079,281455,1,0,0,0,0
2020-02-15,San Mateo,081,765935,4,0,0,0,0
2020-02-15,Santa Barbara,083,443738,0,0,0,0,0
2020-02-15,Santa Clara,085,1922200,10,2,1,3,0
2020-02-15,Santa Cruz,087,273765,0,0,0,0,0
2020-02-15,Shasta,089,179085,0,0,0,0,0
2020-02-15,Sierra,091,2930,0,0,0,0,0
2020-02-15,Siskiyou,093,43540,0,0,0,0,0
2020-02-15,Solano,095,438530,1,0,0,0,0
2020-02-15,Sonoma,097,501317,0,0,0,0,0
2020-02-15,Stanislaus,099,539301,1,0,2,2,0
2020-02-15,Sutter,101,95872,0,0,0,0,0
2020-02-15,Tehama,103,63373,0,0,0,0,0
2020-02-15,Trinity,105,12862,0,0,0,0,0
2020-02-15,Tulare,107,460477,2,0,0,0,0
2020-02-15,Tuolumne,109,53932,0,0,0,0,0
2020-02-15,Ventura,111,848112,2,0,0,0,0
2020-02-15,Yolo,113,214977,1,0,0,0,0
2020-02-15,Yuba,115,75493,0,0,0,0,0
2020-02-14,Alameda,001,1643700,4,0,0,0,0
2020-02-14,Alpine,003,1148,0,0,0,0,0
2020-02-14,Amador,005,37829,0,0,0,0,0
2020-02-14,Butte,007,227075,0,0,0,0,0
2020-02-14,Calaveras,009,45235,0,0,0,0,0
2020-02-14,Colusa,011,21464,0,0,0,0,0
2020-02-14,Contra Costa,013,1133247,3,0,0,0,0
2020-02-14,Del Norte,015,27424,0,0,0,0,0
2020-02-14,El Dorado,017,186661,0,0,0,0,0
2020-02-14,Fresno,019,978130,0,0,0,0,0
2020-02-14,Glenn,021,27897,0,0,0,0,0
2020-02-14,Humboldt,023,135768,1,0,0,0,0
2020-02-14,Imperial,025,180216,1,0,0,0,0
2020-02-14,Inyo,027,18085,0,0,0,0,0
2020-02-14,Kern,029,883053,2,0,0,0,0
2020-02-14,Kings,031,150075,1,0,0,0,0
2020-02-14,Lake,033,64148,0,0,0,0,0
2020-02-14,Lassen,035,31185,0,0,0,0,0
2020-02-14,Los Angeles,037,10098052,34,1,6,7,0
2020-02-14,Madera,039,155013,0,0,0,0,0
2020-02-14,Marin,041,260295,0,0,0,0,0
2020-02-14,Mariposa,043,17540,0,0,0,0,0
2020-02-14,Mendocino,045,87422,0,0,0,0,0
2020-02-14,Merced,047,269075,0,0,0,0,0
2020-02-14,Modoc,049,8938,0,0,0,0,0
2020-02-14,Mono,051,14174,0,0,0,0,0
2020-02-14,Monterey,053,433212,1,0,0,0,0
2020-02-14,Napa,055,140530,0,0,0,0,0
2020-02-14,Nevada,057,99092,0,0,0,0,0
2020-02-14,Orange,059,3164182,37,1,0,1,0
2020-02-14,Placer,061,380077,0,0,0,0,0
2020-02-14,Plumas,063,18699,0,0,0,0,0
2020-02-14,Riverside,065,2383286,4,0,0,0,0
2020-02-14,Sacramento,067,1510023,1,0,0,0,0
2020-02-14,San Benito,069,59416,0,2,0,2,0
2020-02-14,San Bernardino,071,2135413,9,0,0,0,0
2020-02-14,San Diego,073,3302833,3,2,0,2,0
2020-02-14,San Francisco,075,870044,2,0,0,0,0
2020-02-14,San Joaquin,077,732212,1,0,1,1,0
2020-02-14,San Luis Obispo,079,281455,0,0,0,0,0
2020-02-14,San Mateo,081,765935,3,0,0,0,0
2020-02-14,Santa Barbara,083,443738,0,0,0,0,0
2020-02-14,Santa Clara,085,1922200,8,2,1,3,0
2020-02-14,Santa Cruz,087,273765,0,0,0,0,0
2020-02-14,Shasta,089,179085,0,0,0,0,0
2020-02-14,Sierra,091,2930,0,0,0,0,0
2020-02-14,Siskiyou,093,43540,0,0,0,0,0
2020-02-14,Solano,095,438530,1,0,0,0,0
2020-02-14,Sonoma,097,501317,0,0,0,0,0
2020-02-14,Stanislaus,099,539301,1,0,2,2,0
2020-02-14,Sutter,101,95872,0,0,0,0,0
2020-02-14,Tehama,103,63373,0,0,0,0,0
2020-02-14,Trinity,105,12862,0,0,0,0,0
2020-02-14,Tulare,107,460477,2,0,0,0,0
2020-02-14,Tuolumne,109,53932,0,0,0,0,0
2020-02-14,Ventura,111,848112,2,0,0,0,0
2020-02-14,Yolo,113,214977,1,0,0,0,0
2020-02-14,Yuba,115,75493,0,0,0,0,0
2020-02-13,Alameda,001,1643700,4,0,0,0,0
2020-02-13,Alpine,003,1148,0,0,0,0,0
2020-02-13,Amador,005,37829,0,0,0,0,0
2020-02-13,Butte,007,227075,0,0,0,0,0
2020-02-13,Calaveras,009,45235,0,0,0,0,0
2020-02-13,Colusa,011,21464,0,0,0,0,0
2020-02-13,Contra Costa,013,1133247,3,0,0,0,0
2020-02-13,Del Norte,015,27424,0,0,0,0,0
2020-02-13,El Dorado,017,186661,0,0,0,0,0
2020-02-13,Fresno,019,978130,0,0,0,0,0
2020-02-13,Glenn,021,27897,0,0,0,0,0
2020-02-13,Humboldt,023,135768,1,0,0,0,0
2020-02-13,Imperial,025,180216,1,0,0,0,0
2020-02-13,Inyo,027,18085,0,0,0,0,0
2020-02-13,Kern,029,883053,2,0,0,0,0
2020-02-13,Kings,031,150075,1,0,0,0,0
2020-02-13,Lake,033,64148,0,0,0,0,0
2020-02-13,Lassen,035,31185,0,0,0,0,0
2020-02-13,Los Angeles,037,10098052,31,1,5,6,0
2020-02-13,Madera,039,155013,0,0,0,0,0
2020-02-13,Marin,041,260295,0,0,0,0,0
2020-02-13,Mariposa,043,17540,0,0,0,0,0
2020-02-13,Mendocino,045,87422,0,0,0,0,0
2020-02-13,Merced,047,269075,0,0,0,0,0
2020-02-13,Modoc,049,8938,0,0,0,0,0
2020-02-13,Mono,051,14174,0,0,0,0,0
2020-02-13,Monterey,053,433212,1,0,0,0,0
2020-02-13,Napa,055,140530,0,0,0,0,0
2020-02-13,Nevada,057,99092,0,0,0,0,0
2020-02-13,Orange,059,3164182,36,1,0,1,0
2020-02-13,Placer,061,380077,0,0,0,0,0
2020-02-13,Plumas,063,18699,0,0,0,0,0
2020-02-13,Riverside,065,2383286,4,0,0,0,0
2020-02-13,Sacramento,067,1510023,1,0,0,0,0
2020-02-13,San Benito,069,59416,0,2,0,2,0
2020-02-13,San Bernardino,071,2135413,8,0,0,0,0
2020-02-13,San Diego,073,3302833,2,2,0,2,0
2020-02-13,San Francisco,075,870044,2,0,0,0,0
2020-02-13,San Joaquin,077,732212,1,0,1,1,0
2020-02-13,San Luis Obispo,079,281455,0,0,0,0,0
2020-02-13,San Mateo,081,765935,2,0,0,0,0
2020-02-13,Santa Barbara,083,443738,0,0,0,0,0
2020-02-13,Santa Clara,085,1922200,7,2,0,2,0
2020-02-13,Santa Cruz,087,273765,0,0,0,0,0
2020-02-13,Shasta,089,179085,0,0,0,0,0
2020-02-13,Sierra,091,2930,0,0,0,0,0
2020-02-13,Siskiyou,093,43540,0,0,0,0,0
2020-02-13,Solano,095,438530,0,0,0,0,0
2020-02-13,Sonoma,097,501317,0,0,0,0,0
2020-02-13,Stanislaus,099,539301,1,0,1,1,0
2020-02-13,Sutter,101,95872,0,0,0,0,0
2020-02-13,Tehama,103,63373,0,0,0,0,0
2020-02-13,Trinity,105,12862,0,0,0,0,0
2020-02-13,Tulare,107,460477,2,0,0,0,0
2020-02-13,Tuolumne,109,53932,0,0,0,0,0
2020-02-13,Ventura,111,848112,2,0,0,0,0
2020-02-13,Yolo,113,214977,1,0,0,0,0
2020-02-13,Yuba,115,75493,0,0,0,0,0
2020-02-12,Alameda,001,1643700,4,0,0,0,0
2020-02-12,Alpine,003,1148,0,0,0,0,0
2020-02-12,Amador,005,37829,0,0,0,0,0
2020-02-12,Butte,007,227075,0,0,0,0,0
2020-02-12,Calaveras,009,45235,0,0,0,0,0
2020-02-12,Colusa,011,21464,0,0,0,0,0
2020-02-12,Contra Costa,013,1133247,3,0,0,0,0
2020-02-12,Del Norte,015,27424,0,0,0,0,0
2020-02-12,El Dorado,017,186661,0,0,0,0,0
2020-02-12,Fresno,019,978130,0,0,0,0,0
2020-02-12,Glenn,021,27897,0,0,0,0,0
2020-02-12,Humboldt,023,135768,1,0,0,0,0
2020-02-12,Imperial,025,180216,1,0,0,0,0
2020-02-12,Inyo,027,18085,0,0,0,0,0
2020-02-12,Kern,029,883053,2,0,0,0,0
2020-02-12,Kings,031,150075,1,0,0,0,0
2020-02-12,Lake,033,64148,0,0,0,0,0
2020-02-12,Lassen,035,31185,0,0,0,0,0
2020-02-12,Los Angeles,037,10098052,30,1,5,6,0
2020-02-12,Madera,039,155013,0,0,0,0,0
2020-02-12,Marin,041,260295,0,0,0,0,0
2020-02-12,Mariposa,043,17540,0,0,0,0,0
2020-02-12,Mendocino,045,87422,0,0,0,0,0
2020-02-12,Merced,047,269075,0,0,0,0,0
2020-02-12,Modoc,049,8938,0,0,0,0,0
2020-02-12,Mono,051,14174,0,0,0,0,0
2020-02-12,Monterey,053,433212,1,0,0,0,0
2020-02-12,Napa,055,140530,0,0,0,0,0
2020-02-12,Nevada,057,99092,0,0,0,0,0
2020-02-12,Orange,059,3164182,36,1,0,1,0
2020-02-12,Placer,061,380077,0,0,0,0,0
2020-02-12,Plumas,063,18699,0,0,0,0,0
2020-02-12,Riverside,065,2383286,4,0,0,0,0
2020-02-12,Sacramento,067,1510023,1,0,0,0,0
2020-02-12,San Benito,069,59416,0,2,0,2,0
2020-02-12,San Bernardino,071,2135413,8,0,0,0,0
2020-02-12,San Diego,073,3302833,2,2,0,2,0
2020-02-12,San Francisco,075,870044,2,0,0,0,0
2020-02-12,San Joaquin,077,732212,1,0,1,1,0
2020-02-12,San Luis Obispo,079,281455,0,0,0,0,0
2020-02-12,San Mateo,081,765935,2,0,0,0,0
2020-02-12,Santa Barbara,083,443738,0,0,0,0,0
2020-02-12,Santa Clara,085,1922200,6,2,0,2,0
2020-02-12,Santa Cruz,087,273765,0,0,0,0,0
2020-02-12,Shasta,089,179085,0,0,0,0,0
2020-02-12,Sierra,091,2930,0,0,0,0,0
2020-02-12,Siskiyou,093,43540,0,0,0,0,0
2020-02-12,Solano,095,438530,0,0,0,0,0
2020-02-12,Sonoma,097,501317,0,0,0,0,0
2020-02-12,Stanislaus,099,539301,1,0,1,1,0
2020-02-12,Sutter,101,95872,0,0,0,0,0
2020-02-12,Tehama,103,63373,0,0,0,0,0
2020-02-12,Trinity,105,12862,0,0,0,0,0
2020-02-12,Tulare,107,460477,2,0,0,0,0
2020-02-12,Tuolumne,109,53932,0,0,0,0,0
2020-02-12,Ventura,111,848112,2,0,0,0,0
2020-02-12,Yolo,113,214977,1,0,0,0,0
2020-02-12,Yuba,115,75493,0,0,0,0,0
2020-02-11,Alameda,001,1643700,4,0,0,0,0
2020-02-11,Alpine,003,1148,0,0,0,0,0
2020-02-11,Amador,005,37829,0,0,0,0,0
2020-02-11,Butte,007,227075,0,0,0,0,0
2020-02-11,Calaveras,009,45235,0,0,0,0,0
2020-02-11,Colusa,011,21464,0,0,0,0,0
2020-02-11,Contra Costa,013,1133247,3,0,0,0,0
2020-02-11,Del Norte,015,27424,0,0,0,0,0
2020-02-11,El Dorado,017,186661,0,0,0,0,0
2020-02-11,Fresno,019,978130,0,0,0,0,0
2020-02-11,Glenn,021,27897,0,0,0,0,0
2020-02-11,Humboldt,023,135768,1,0,0,0,0
2020-02-11,Imperial,025,180216,1,0,0,0,0
2020-02-11,Inyo,027,18085,0,0,0,0,0
2020-02-11,Kern,029,883053,2,0,0,0,0
2020-02-11,Kings,031,150075,1,0,0,0,0
2020-02-11,Lake,033,64148,0,0,0,0,0
2020-02-11,Lassen,035,31185,0,0,0,0,0
2020-02-11,Los Angeles,037,10098052,30,1,5,6,0
2020-02-11,Madera,039,155013,0,0,0,0,0
2020-02-11,Marin,041,260295,0,0,0,0,0
2020-02-11,Mariposa,043,17540,0,0,0,0,0
2020-02-11,Mendocino,045,87422,0,0,0,0,0
2020-02-11,Merced,047,269075,0,0,0,0,0
2020-02-11,Modoc,049,8938,0,0,0,0,0
2020-02-11,Mono,051,14174,0,0,0,0,0
2020-02-11,Monterey,053,433212,1,0,0,0,0
2020-02-11,Napa,055,140530,0,0,0,0,0
2020-02-11,Nevada,057,99092,0,0,0,0,0
2020-02-11,Orange,059,3164182,35,1,0,1,0
2020-02-11,Placer,061,380077,0,0,0,0,0
2020-02-11,Plumas,063,18699,0,0,0,0,0
2020-02-11,Riverside,065,2383286,4,0,0,0,0
2020-02-11,Sacramento,067,1510023,1,0,0,0,0
2020-02-11,San Benito,069,59416,0,2,0,2,0
2020-02-11,San Bernardino,071,2135413,8,0,0,0,0
2020-02-11,San Diego,073,3302833,2,1,0,1,0
2020-02-11,San Francisco,075,870044,2,0,0,0,0
2020-02-11,San Joaquin,077,732212,0,0,1,1,0
2020-02-11,San Luis Obispo,079,281455,0,0,0,0,0
2020-02-11,San Mateo,081,765935,2,0,0,0,0
2020-02-11,Santa Barbara,083,443738,0,0,0,0,0
2020-02-11,Santa Clara,085,1922200,5,2,0,2,0
2020-02-11,Santa Cruz,087,273765,0,0,0,0,0
2020-02-11,Shasta,089,179085,0,0,0,0,0
2020-02-11,Sierra,091,2930,0,0,0,0,0
2020-02-11,Siskiyou,093,43540,0,0,0,0,0
2020-02-11,Solano,095,438530,0,0,0,0,0
2020-02-11,Sonoma,097,501317,0,0,0,0,0
2020-02-11,Stanislaus,099,539301,1,0,1,1,0
2020-02-11,Sutter,101,95872,0,0,0,0,0
2020-02-11,Tehama,103,63373,0,0,0,0,0
2020-02-11,Trinity,105,12862,0,0,0,0,0
2020-02-11,Tulare,107,460477,2,0,0,0,0
2020-02-11,Tuolumne,109,53932,0,0,0,0,0
2020-02-11,Ventura,111,848112,2,0,0,0,0
2020-02-11,Yolo,113,214977,1,0,0,0,0
2020-02-11,Yuba,115,75493,0,0,0,0,0
2020-02-10,Alameda,001,1643700,4,0,0,0,0
2020-02-10,Alpine,003,1148,0,0,0,0,0
2020-02-10,Amador,005,37829,0,0,0,0,0
2020-02-10,Butte,007,227075,0,0,0,0,0
2020-02-10,Calaveras,009,45235,0,0,0,0,0
2020-02-10,Colusa,011,21464,0,0,0,0,0
2020-02-10,Contra Costa,013,1133247,3,0,0,0,0
2020-02-10,Del Norte,015,27424,0,0,0,0,0
2020-02-10,El Dorado,017,186661,0,0,0,0,0
2020-02-10,Fresno,019,978130,0,0,0,0,0
2020-02-10,Glenn,021,27897,0,0,0,0,0
2020-02-10,Humboldt,023,135768,0,0,0,0,0
2020-02-10,Imperial,025,180216,1,0,0,0,0
2020-02-10,Inyo,027,18085,0,0,0,0,0
2020-02-10,Kern,029,883053,2,0,0,0,0
2020-02-10,Kings,031,150075,1,0,0,0,0
2020-02-10,Lake,033,64148,0,0,0,0,0
2020-02-10,Lassen,035,31185,0,0,0,0,0
2020-02-10,Los Angeles,037,10098052,28,1,5,6,0
2020-02-10,Madera,039,155013,0,0,0,0,0
2020-02-10,Marin,041,260295,0,0,0,0,0
2020-02-10,Mariposa,043,17540,0,0,0,0,0
2020-02-10,Mendocino,045,87422,0,0,0,0,0
2020-02-10,Merced,047,269075,0,0,0,0,0
2020-02-10,Modoc,049,8938,0,0,0,0,0
2020-02-10,Mono,051,14174,0,0,0,0,0
2020-02-10,Monterey,053,433212,1,0,0,0,0
2020-02-10,Napa,055,140530,0,0,0,0,0
2020-02-10,Nevada,057,99092,0,0,0,0,0
2020-02-10,Orange,059,3164182,35,1,0,1,0
2020-02-10,Placer,061,380077,0,0,0,0,0
2020-02-10,Plumas,063,18699,0,0,0,0,0
2020-02-10,Riverside,065,2383286,4,0,0,0,0
2020-02-10,Sacramento,067,1510023,1,0,0,0,0
2020-02-10,San Benito,069,59416,0,2,0,2,0
2020-02-10,San Bernardino,071,2135413,7,0,0,0,0
2020-02-10,San Diego,073,3302833,2,0,0,0,0
2020-02-10,San Francisco,075,870044,2,0,0,0,0
2020-02-10,San Joaquin,077,732212,0,0,1,1,0
2020-02-10,San Luis Obispo,079,281455,0,0,0,0,0
2020-02-10,San Mateo,081,765935,2,0,0,0,0
2020-02-10,Santa Barbara,083,443738,0,0,0,0,0
2020-02-10,Santa Clara,085,1922200,5,2,0,2,0
2020-02-10,Santa Cruz,087,273765,0,0,0,0,0
2020-02-10,Shasta,089,179085,0,0,0,0,0
2020-02-10,Sierra,091,2930,0,0,0,0,0
2020-02-10,Siskiyou,093,43540,0,0,0,0,0
2020-02-10,Solano,095,438530,0,0,0,0,0
2020-02-10,Sonoma,097,501317,0,0,0,0,0
2020-02-10,Stanislaus,099,539301,1,0,0,0,0
2020-02-10,Sutter,101,95872,0,0,0,0,0
2020-02-10,Tehama,103,63373,0,0,0,0,0
2020-02-10,Trinity,105,12862,0,0,0,0,0
2020-02-10,Tulare,107,460477,2,0,0,0,0
2020-02-10,Tuolumne,109,53932,0,0,0,0,0
2020-02-10,Ventura,111,848112,2,0,0,0,0
2020-02-10,Yolo,113,214977,1,0,0,0,0
2020-02-10,Yuba,115,75493,0,0,0,0,0
2020-02-09,Alameda,001,1643700,4,0,0,0,0
2020-02-09,Alpine,003,1148,0,0,0,0,0
2020-02-09,Amador,005,37829,0,0,0,0,0
2020-02-09,Butte,007,227075,0,0,0,0,0
2020-02-09,Calaveras,009,45235,0,0,0,0,0
2020-02-09,Colusa,011,21464,0,0,0,0,0
2020-02-09,Contra Costa,013,1133247,3,0,0,0,0
2020-02-09,Del Norte,015,27424,0,0,0,0,0
2020-02-09,El Dorado,017,186661,0,0,0,0,0
2020-02-09,Fresno,019,978130,0,0,0,0,0
2020-02-09,Glenn,021,27897,0,0,0,0,0
2020-02-09,Humboldt,023,135768,0,0,0,0,0
2020-02-09,Imperial,025,180216,1,0,0,0,0
2020-02-09,Inyo,027,18085,0,0,0,0,0
2020-02-09,Kern,029,883053,2,0,0,0,0
2020-02-09,Kings,031,150075,1,0,0,0,0
2020-02-09,Lake,033,64148,0,0,0,0,0
2020-02-09,Lassen,035,31185,0,0,0,0,0
2020-02-09,Los Angeles,037,10098052,27,1,5,6,0
2020-02-09,Madera,039,155013,0,0,0,0,0
2020-02-09,Marin,041,260295,0,0,0,0,0
2020-02-09,Mariposa,043,17540,0,0,0,0,0
2020-02-09,Mendocino,045,87422,0,0,0,0,0
2020-02-09,Merced,047,269075,0,0,0,0,0
2020-02-09,Modoc,049,8938,0,0,0,0,0
2020-02-09,Mono,051,14174,0,0,0,0,0
2020-02-09,Monterey,053,433212,1,0,0,0,0
2020-02-09,Napa,055,140530,0,0,0,0,0
2020-02-09,Nevada,057,99092,0,0,0,0,0
2020-02-09,Orange,059,3164182,35,1,0,1,0
2020-02-09,Placer,061,380077,0,0,0,0,0
2020-02-09,Plumas,063,18699,0,0,0,0,0
2020-02-09,Riverside,065,2383286,4,0,0,0,0
2020-02-09,Sacramento,067,1510023,0,0,0,0,0
2020-02-09,San Benito,069,59416,0,2,0,2,0
2020-02-09,San Bernardino,071,2135413,7,0,0,0,0
2020-02-09,San Diego,073,3302833,2,0,0,0,0
2020-02-09,San Francisco,075,870044,1,0,0,0,0
2020-02-09,San Joaquin,077,732212,0,0,1,1,0
2020-02-09,San Luis Obispo,079,281455,0,0,0,0,0
2020-02-09,San Mateo,081,765935,2,0,0,0,0
2020-02-09,Santa Barbara,083,443738,0,0,0,0,0
2020-02-09,Santa Clara,085,1922200,4,2,0,2,0
2020-02-09,Santa Cruz,087,273765,0,0,0,0,0
2020-02-09,Shasta,089,179085,0,0,0,0,0
2020-02-09,Sierra,091,2930,0,0,0,0,0
2020-02-09,Siskiyou,093,43540,0,0,0,0,0
2020-02-09,Solano,095,438530,0,0,0,0,0
2020-02-09,Sonoma,097,501317,0,0,0,0,0
2020-02-09,Stanislaus,099,539301,0,0,0,0,0
2020-02-09,Sutter,101,95872,0,0,0,0,0
2020-02-09,Tehama,103,63373,0,0,0,0,0
2020-02-09,Trinity,105,12862,0,0,0,0,0
2020-02-09,Tulare,107,460477,2,0,0,0,0
2020-02-09,Tuolumne,109,53932,0,0,0,0,0
2020-02-09,Ventura,111,848112,1,0,0,0,0
2020-02-09,Yolo,113,214977,1,0,0,0,0
2020-02-09,Yuba,115,75493,0,0,0,0,0
2020-02-08,Alameda,001,1643700,3,0,0,0,0
2020-02-08,Alpine,003,1148,0,0,0,0,0
2020-02-08,Amador,005,37829,0,0,0,0,0
2020-02-08,Butte,007,227075,0,0,0,0,0
2020-02-08,Calaveras,009,45235,0,0,0,0,0
2020-02-08,Colusa,011,21464,0,0,0,0,0
2020-02-08,Contra Costa,013,1133247,2,0,0,0,0
2020-02-08,Del Norte,015,27424,0,0,0,0,0
2020-02-08,El Dorado,017,186661,0,0,0,0,0
2020-02-08,Fresno,019,978130,0,0,0,0,0
2020-02-08,Glenn,021,27897,0,0,0,0,0
2020-02-08,Humboldt,023,135768,0,0,0,0,0
2020-02-08,Imperial,025,180216,1,0,0,0,0
2020-02-08,Inyo,027,18085,0,0,0,0,0
2020-02-08,Kern,029,883053,2,0,0,0,0
2020-02-08,Kings,031,150075,1,0,0,0,0
2020-02-08,Lake,033,64148,0,0,0,0,0
2020-02-08,Lassen,035,31185,0,0,0,0,0
2020-02-08,Los Angeles,037,10098052,23,1,3,4,0
2020-02-08,Madera,039,155013,0,0,0,0,0
2020-02-08,Marin,041,260295,0,0,0,0,0
2020-02-08,Mariposa,043,17540,0,0,0,0,0
2020-02-08,Mendocino,045,87422,0,0,0,0,0
2020-02-08,Merced,047,269075,0,0,0,0,0
2020-02-08,Modoc,049,8938,0,0,0,0,0
2020-02-08,Mono,051,14174,0,0,0,0,0
2020-02-08,Monterey,053,433212,1,0,0,0,0
2020-02-08,Napa,055,140530,0,0,0,0,0
2020-02-08,Nevada,057,99092,0,0,0,0,0
2020-02-08,Orange,059,3164182,35,1,0,1,0
2020-02-08,Placer,061,380077,0,0,0,0,0
2020-02-08,Plumas,063,18699,0,0,0,0,0
2020-02-08,Riverside,065,2383286,4,0,0,0,0
2020-02-08,Sacramento,067,1510023,0,0,0,0,0
2020-02-08,San Benito,069,59416,0,2,0,2,0
2020-02-08,San Bernardino,071,2135413,7,0,0,0,0
2020-02-08,San Diego,073,3302833,1,0,0,0,0
2020-02-08,San Francisco,075,870044,1,0,0,0,0
2020-02-08,San Joaquin,077,732212,0,0,1,1,0
2020-02-08,San Luis Obispo,079,281455,0,0,0,0,0
2020-02-08,San Mateo,081,765935,2,0,0,0,0
2020-02-08,Santa Barbara,083,443738,0,0,0,0,0
2020-02-08,Santa Clara,085,1922200,4,2,0,2,0
2020-02-08,Santa Cruz,087,273765,0,0,0,0,0
2020-02-08,Shasta,089,179085,0,0,0,0,0
2020-02-08,Sierra,091,2930,0,0,0,0,0
2020-02-08,Siskiyou,093,43540,0,0,0,0,0
2020-02-08,Solano,095,438530,0,0,0,0,0
2020-02-08,Sonoma,097,501317,0,0,0,0,0
2020-02-08,Stanislaus,099,539301,0,0,0,0,0
2020-02-08,Sutter,101,95872,0,0,0,0,0
2020-02-08,Tehama,103,63373,0,0,0,0,0
2020-02-08,Trinity,105,12862,0,0,0,0,0
2020-02-08,Tulare,107,460477,2,0,0,0,0
2020-02-08,Tuolumne,109,53932,0,0,0,0,0
2020-02-08,Ventura,111,848112,1,0,0,0,0
2020-02-08,Yolo,113,214977,1,0,0,0,0
2020-02-08,Yuba,115,75493,0,0,0,0,0
2020-02-07,Alameda,001,1643700,3,0,0,0,0
2020-02-07,Alpine,003,1148,0,0,0,0,0
2020-02-07,Amador,005,37829,0,0,0,0,0
2020-02-07,Butte,007,227075,0,0,0,0,0
2020-02-07,Calaveras,009,45235,0,0,0,0,0
2020-02-07,Colusa,011,21464,0,0,0,0,0
2020-02-07,Contra Costa,013,1133247,2,0,0,0,0
2020-02-07,Del Norte,015,27424,0,0,0,0,0
2020-02-07,El Dorado,017,186661,0,0,0,0,0
2020-02-07,Fresno,019,978130,0,0,0,0,0
2020-02-07,Glenn,021,27897,0,0,0,0,0
2020-02-07,Humboldt,023,135768,0,0,0,0,0
2020-02-07,Imperial,025,180216,1,0,0,0,0
2020-02-07,Inyo,027,18085,0,0,0,0,0
2020-02-07,Kern,029,883053,2,0,0,0,0
2020-02-07,Kings,031,150075,1,0,0,0,0
2020-02-07,Lake,033,64148,0,0,0,0,0
2020-02-07,Lassen,035,31185,0,0,0,0,0
2020-02-07,Los Angeles,037,10098052,22,1,2,3,0
2020-02-07,Madera,039,155013,0,0,0,0,0
2020-02-07,Marin,041,260295,0,0,0,0,0
2020-02-07,Mariposa,043,17540,0,0,0,0,0
2020-02-07,Mendocino,045,87422,0,0,0,0,0
2020-02-07,Merced,047,269075,0,0,0,0,0
2020-02-07,Modoc,049,8938,0,0,0,0,0
2020-02-07,Mono,051,14174,0,0,0,0,0
2020-02-07,Monterey,053,433212,1,0,0,0,0
2020-02-07,Napa,055,140530,0,0,0,0,0
2020-02-07,Nevada,057,99092,0,0,0,0,0
2020-02-07,Orange,059,3164182,33,1,0,1,0
2020-02-07,Placer,061,380077,0,0,0,0,0
2020-02-07,Plumas,063,18699,0,0,0,0,0
2020-02-07,Riverside,065,2383286,4,0,0,0,0
2020-02-07,Sacramento,067,1510023,0,0,0,0,0
2020-02-07,San Benito,069,59416,0,2,0,2,0
2020-02-07,San Bernardino,071,2135413,4,0,0,0,0
2020-02-07,San Diego,073,3302833,1,0,0,0,0
2020-02-07,San Francisco,075,870044,1,0,0,0,0
2020-02-07,San Joaquin,077,732212,0,0,1,1,0
2020-02-07,San Luis Obispo,079,281455,0,0,0,0,0
2020-02-07,San Mateo,081,765935,1,0,0,0,0
2020-02-07,Santa Barbara,083,443738,0,0,0,0,0
2020-02-07,Santa Clara,085,1922200,4,2,0,2,0
2020-02-07,Santa Cruz,087,273765,0,0,0,0,0
2020-02-07,Shasta,089,179085,0,0,0,0,0
2020-02-07,Sierra,091,2930,0,0,0,0,0
2020-02-07,Siskiyou,093,43540,0,0,0,0,0
2020-02-07,Solano,095,438530,0,0,0,0,0
2020-02-07,Sonoma,097,501317,0,0,0,0,0
2020-02-07,Stanislaus,099,539301,0,0,0,0,0
2020-02-07,Sutter,101,95872,0,0,0,0,0
2020-02-07,Tehama,103,63373,0,0,0,0,0
2020-02-07,Trinity,105,12862,0,0,0,0,0
2020-02-07,Tulare,107,460477,2,0,0,0,0
2020-02-07,Tuolumne,109,53932,0,0,0,0,0
2020-02-07,Ventura,111,848112,1,0,0,0,0
2020-02-07,Yolo,113,214977,1,0,0,0,0
2020-02-07,Yuba,115,75493,0,0,0,0,0
2020-02-06,Alameda,001,1643700,3,0,0,0,0
2020-02-06,Alpine,003,1148,0,0,0,0,0
2020-02-06,Amador,005,37829,0,0,0,0,0
2020-02-06,Butte,007,227075,0,0,0,0,0
2020-02-06,Calaveras,009,45235,0,0,0,0,0
2020-02-06,Colusa,011,21464,0,0,0,0,0
2020-02-06,Contra Costa,013,1133247,2,0,0,0,0
2020-02-06,Del Norte,015,27424,0,0,0,0,0
2020-02-06,El Dorado,017,186661,0,0,0,0,0
2020-02-06,Fresno,019,978130,0,0,0,0,0
2020-02-06,Glenn,021,27897,0,0,0,0,0
2020-02-06,Humboldt,023,135768,0,0,0,0,0
2020-02-06,Imperial,025,180216,1,0,0,0,0
2020-02-06,Inyo,027,18085,0,0,0,0,0
2020-02-06,Kern,029,883053,2,0,0,0,0
2020-02-06,Kings,031,150075,0,0,0,0,0
2020-02-06,Lake,033,64148,0,0,0,0,0
2020-02-06,Lassen,035,31185,0,0,0,0,0
2020-02-06,Los Angeles,037,10098052,21,1,2,3,0
2020-02-06,Madera,039,155013,0,0,0,0,0
2020-02-06,Marin,041,260295,0,0,0,0,0
2020-02-06,Mariposa,043,17540,0,0,0,0,0
2020-02-06,Mendocino,045,87422,0,0,0,0,0
2020-02-06,Merced,047,269075,0,0,0,0,0
2020-02-06,Modoc,049,8938,0,0,0,0,0
2020-02-06,Mono,051,14174,0,0,0,0,0
2020-02-06,Monterey,053,433212,1,0,0,0,0
2020-02-06,Napa,055,140530,0,0,0,0,0
2020-02-06,Nevada,057,99092,0,0,0,0,0
2020-02-06,Orange,059,3164182,3,1,0,1,0
2020-02-06,Placer,061,380077,0,0,0,0,0
2020-02-06,Plumas,063,18699,0,0,0,0,0
2020-02-06,Riverside,065,2383286,4,0,0,0,0
2020-02-06,Sacramento,067,1510023,0,0,0,0,0
2020-02-06,San Benito,069,59416,0,2,0,2,0
2020-02-06,San Bernardino,071,2135413,4,0,0,0,0
2020-02-06,San Diego,073,3302833,1,0,0,0,0
2020-02-06,San Francisco,075,870044,1,0,0,0,0
2020-02-06,San Joaquin,077,732212,0,0,1,1,0
2020-02-06,San Luis Obispo,079,281455,0,0,0,0,0
2020-02-06,San Mateo,081,765935,1,0,0,0,0
2020-02-06,Santa Barbara,083,443738,0,0,0,0,0
2020-02-06,Santa Clara,085,1922200,4,2,0,2,0
2020-02-06,Santa Cruz,087,273765,0,0,0,0,0
2020-02-06,Shasta,089,179085,0,0,0,0,0
2020-02-06,Sierra,091,2930,0,0,0,0,0
2020-02-06,Siskiyou,093,43540,0,0,0,0,0
2020-02-06,Solano,095,438530,0,0,0,0,0
2020-02-06,Sonoma,097,501317,0,0,0,0,0
2020-02-06,Stanislaus,099,539301,0,0,0,0,0
2020-02-06,Sutter,101,95872,0,0,0,0,0
2020-02-06,Tehama,103,63373,0,0,0,0,0
2020-02-06,Trinity,105,12862,0,0,0,0,0
2020-02-06,Tulare,107,460477,2,0,0,0,0
2020-02-06,Tuolumne,109,53932,0,0,0,0,0
2020-02-06,Ventura,111,848112,1,0,0,0,0
2020-02-06,Yolo,113,214977,1,0,0,0,0
2020-02-06,Yuba,115,75493,0,0,0,0,0
2020-02-05,Alameda,001,1643700,3,0,0,0,0
2020-02-05,Alpine,003,1148,0,0,0,0,0
2020-02-05,Amador,005,37829,0,0,0,0,0
2020-02-05,Butte,007,227075,0,0,0,0,0
2020-02-05,Calaveras,009,45235,0,0,0,0,0
2020-02-05,Colusa,011,21464,0,0,0,0,0
2020-02-05,Contra Costa,013,1133247,2,0,0,0,0
2020-02-05,Del Norte,015,27424,0,0,0,0,0
2020-02-05,El Dorado,017,186661,0,0,0,0,0
2020-02-05,Fresno,019,978130,0,0,0,0,0
2020-02-05,Glenn,021,27897,0,0,0,0,0
2020-02-05,Humboldt,023,135768,0,0,0,0,0
2020-02-05,Imperial,025,180216,1,0,0,0,0
2020-02-05,Inyo,027,18085,0,0,0,0,0
2020-02-05,Kern,029,883053,1,0,0,0,0
2020-02-05,Kings,031,150075,0,0,0,0,0
2020-02-05,Lake,033,64148,0,0,0,0,0
2020-02-05,Lassen,035,31185,0,0,0,0,0
2020-02-05,Los Angeles,037,10098052,21,1,1,2,0
2020-02-05,Madera,039,155013,0,0,0,0,0
2020-02-05,Marin,041,260295,0,0,0,0,0
2020-02-05,Mariposa,043,17540,0,0,0,0,0
2020-02-05,Mendocino,045,87422,0,0,0,0,0
2020-02-05,Merced,047,269075,0,0,0,0,0
2020-02-05,Modoc,049,8938,0,0,0,0,0
2020-02-05,Mono,051,14174,0,0,0,0,0
2020-02-05,Monterey,053,433212,1,0,0,0,0
2020-02-05,Napa,055,140530,0,0,0,0,0
2020-02-05,Nevada,057,99092,0,0,0,0,0
2020-02-05,Orange,059,3164182,1,1,0,1,0
2020-02-05,Placer,061,380077,0,0,0,0,0
2020-02-05,Plumas,063,18699,0,0,0,0,0
2020-02-05,Riverside,065,2383286,4,0,0,0,0
2020-02-05,Sacramento,067,1510023,0,0,0,0,0
2020-02-05,San Benito,069,59416,0,2,0,2,0
2020-02-05,San Bernardino,071,2135413,4,0,0,0,0
2020-02-05,San Diego,073,3302833,0,0,0,0,0
2020-02-05,San Francisco,075,870044,1,0,0,0,0
2020-02-05,San Joaquin,077,732212,0,0,1,1,0
2020-02-05,San Luis Obispo,079,281455,0,0,0,0,0
2020-02-05,San Mateo,081,765935,1,0,0,0,0
2020-02-05,Santa Barbara,083,443738,0,0,0,0,0
2020-02-05,Santa Clara,085,1922200,2,2,0,2,0
2020-02-05,Santa Cruz,087,273765,0,0,0,0,0
2020-02-05,Shasta,089,179085,0,0,0,0,0
2020-02-05,Sierra,091,2930,0,0,0,0,0
2020-02-05,Siskiyou,093,43540,0,0,0,0,0
2020-02-05,Solano,095,438530,0,0,0,0,0
2020-02-05,Sonoma,097,501317,0,0,0,0,0
2020-02-05,Stanislaus,099,539301,0,0,0,0,0
2020-02-05,Sutter,101,95872,0,0,0,0,0
2020-02-05,Tehama,103,63373,0,0,0,0,0
2020-02-05,Trinity,105,12862,0,0,0,0,0
2020-02-05,Tulare,107,460477,2,0,0,0,0
2020-02-05,Tuolumne,109,53932,0,0,0,0,0
2020-02-05,Ventura,111,848112,0,0,0,0,0
2020-02-05,Yolo,113,214977,1,0,0,0,0
2020-02-05,Yuba,115,75493,0,0,0,0,0
2020-02-04,Alameda,001,1643700,3,0,0,0,0
2020-02-04,Alpine,003,1148,0,0,0,0,0
2020-02-04,Amador,005,37829,0,0,0,0,0
2020-02-04,Butte,007,227075,0,0,0,0,0
2020-02-04,Calaveras,009,45235,0,0,0,0,0
2020-02-04,Colusa,011,21464,0,0,0,0,0
2020-02-04,Contra Costa,013,1133247,2,0,0,0,0
2020-02-04,Del Norte,015,27424,0,0,0,0,0
2020-02-04,El Dorado,017,186661,0,0,0,0,0
2020-02-04,Fresno,019,978130,0,0,0,0,0
2020-02-04,Glenn,021,27897,0,0,0,0,0
2020-02-04,Humboldt,023,135768,0,0,0,0,0
2020-02-04,Imperial,025,180216,1,0,0,0,0
2020-02-04,Inyo,027,18085,0,0,0,0,0
2020-02-04,Kern,029,883053,0,0,0,0,0
2020-02-04,Kings,031,150075,0,0,0,0,0
2020-02-04,Lake,033,64148,0,0,0,0,0
2020-02-04,Lassen,035,31185,0,0,0,0,0
2020-02-04,Los Angeles,037,10098052,21,1,1,2,0
2020-02-04,Madera,039,155013,0,0,0,0,0
2020-02-04,Marin,041,260295,0,0,0,0,0
2020-02-04,Mariposa,043,17540,0,0,0,0,0
2020-02-04,Mendocino,045,87422,0,0,0,0,0
2020-02-04,Merced,047,269075,0,0,0,0,0
2020-02-04,Modoc,049,8938,0,0,0,0,0
2020-02-04,Mono,051,14174,0,0,0,0,0
2020-02-04,Monterey,053,433212,1,0,0,0,0
2020-02-04,Napa,055,140530,0,0,0,0,0
2020-02-04,Nevada,057,99092,0,0,0,0,0
2020-02-04,Orange,059,3164182,1,1,0,1,0
2020-02-04,Placer,061,380077,0,0,0,0,0
2020-02-04,Plumas,063,18699,0,0,0,0,0
2020-02-04,Riverside,065,2383286,4,0,0,0,0
2020-02-04,Sacramento,067,1510023,0,0,0,0,0
2020-02-04,San Benito,069,59416,0,2,0,2,0
2020-02-04,San Bernardino,071,2135413,3,0,0,0,0
2020-02-04,San Diego,073,3302833,0,0,0,0,0
2020-02-04,San Francisco,075,870044,1,0,0,0,0
2020-02-04,San Joaquin,077,732212,0,0,1,1,0
2020-02-04,San Luis Obispo,079,281455,0,0,0,0,0
2020-02-04,San Mateo,081,765935,0,0,0,0,0
2020-02-04,Santa Barbara,083,443738,0,0,0,0,0
2020-02-04,Santa Clara,085,1922200,2,2,0,2,0
2020-02-04,Santa Cruz,087,273765,0,0,0,0,0
2020-02-04,Shasta,089,179085,0,0,0,0,0
2020-02-04,Sierra,091,2930,0,0,0,0,0
2020-02-04,Siskiyou,093,43540,0,0,0,0,0
2020-02-04,Solano,095,438530,0,0,0,0,0
2020-02-04,Sonoma,097,501317,0,0,0,0,0
2020-02-04,Stanislaus,099,539301,0,0,0,0,0
2020-02-04,Sutter,101,95872,0,0,0,0,0
2020-02-04,Tehama,103,63373,0,0,0,0,0
2020-02-04,Trinity,105,12862,0,0,0,0,0
2020-02-04,Tulare,107,460477,2,0,0,0,0
2020-02-04,Tuolumne,109,53932,0,0,0,0,0
2020-02-04,Ventura,111,848112,0,0,0,0,0
2020-02-04,Yolo,113,214977,1,0,0,0,0
2020-02-04,Yuba,115,75493,0,0,0,0,0
2020-02-03,Alameda,001,1643700,3,0,0,0,0
2020-02-03,Alpine,003,1148,0,0,0,0,0
2020-02-03,Amador,005,37829,0,0,0,0,0
2020-02-03,Butte,007,227075,0,0,0,0,0
2020-02-03,Calaveras,009,45235,0,0,0,0,0
2020-02-03,Colusa,011,21464,0,0,0,0,0
2020-02-03,Contra Costa,013,1133247,2,0,0,0,0
2020-02-03,Del Norte,015,27424,0,0,0,0,0
2020-02-03,El Dorado,017,186661,0,0,0,0,0
2020-02-03,Fresno,019,978130,0,0,0,0,0
2020-02-03,Glenn,021,27897,0,0,0,0,0
2020-02-03,Humboldt,023,135768,0,0,0,0,0
2020-02-03,Imperial,025,180216,1,0,0,0,0
2020-02-03,Inyo,027,18085,0,0,0,0,0
2020-02-03,Kern,029,883053,0,0,0,0,0
2020-02-03,Kings,031,150075,0,0,0,0,0
2020-02-03,Lake,033,64148,0,0,0,0,0
2020-02-03,Lassen,035,31185,0,0,0,0,0
2020-02-03,Los Angeles,037,10098052,21,1,0,1,0
2020-02-03,Madera,039,155013,0,0,0,0,0
2020-02-03,Marin,041,260295,0,0,0,0,0
2020-02-03,Mariposa,043,17540,0,0,0,0,0
2020-02-03,Mendocino,045,87422,0,0,0,0,0
2020-02-03,Merced,047,269075,0,0,0,0,0
2020-02-03,Modoc,049,8938,0,0,0,0,0
2020-02-03,Mono,051,14174,0,0,0,0,0
2020-02-03,Monterey,053,433212,1,0,0,0,0
2020-02-03,Napa,055,140530,0,0,0,0,0
2020-02-03,Nevada,057,99092,0,0,0,0,0
2020-02-03,Orange,059,3164182,1,1,0,1,0
2020-02-03,Placer,061,380077,0,0,0,0,0
2020-02-03,Plumas,063,18699,0,0,0,0,0
2020-02-03,Riverside,065,2383286,4,0,0,0,0
2020-02-03,Sacramento,067,1510023,0,0,0,0,0
2020-02-03,San Benito,069,59416,0,2,0,2,0
2020-02-03,San Bernardino,071,2135413,3,0,0,0,0
2020-02-03,San Diego,073,3302833,0,0,0,0,0
2020-02-03,San Francisco,075,870044,1,0,0,0,0
2020-02-03,San Joaquin,077,732212,0,0,1,1,0
2020-02-03,San Luis Obispo,079,281455,0,0,0,0,0
2020-02-03,San Mateo,081,765935,0,0,0,0,0
2020-02-03,Santa Barbara,083,443738,0,0,0,0,0
2020-02-03,Santa Clara,085,1922200,2,2,0,2,0
2020-02-03,Santa Cruz,087,273765,0,0,0,0,0
2020-02-03,Shasta,089,179085,0,0,0,0,0
2020-02-03,Sierra,091,2930,0,0,0,0,0
2020-02-03,Siskiyou,093,43540,0,0,0,0,0
2020-02-03,Solano,095,438530,0,0,0,0,0
2020-02-03,Sonoma,097,501317,0,0,0,0,0
2020-02-03,Stanislaus,099,539301,0,0,0,0,0
2020-02-03,Sutter,101,95872,0,0,0,0,0
2020-02-03,Tehama,103,63373,0,0,0,0,0
2020-02-03,Trinity,105,12862,0,0,0,0,0
2020-02-03,Tulare,107,460477,2,0,0,0,0
2020-02-03,Tuolumne,109,53932,0,0,0,0,0
2020-02-03,Ventura,111,848112,0,0,0,0,0
2020-02-03,Yolo,113,214977,1,0,0,0,0
2020-02-03,Yuba,115,75493,0,0,0,0,0
2020-02-02,Alameda,001,1643700,3,0,0,0,0
2020-02-02,Alpine,003,1148,0,0,0,0,0
2020-02-02,Amador,005,37829,0,0,0,0,0
2020-02-02,Butte,007,227075,0,0,0,0,0
2020-02-02,Calaveras,009,45235,0,0,0,0,0
2020-02-02,Colusa,011,21464,0,0,0,0,0
2020-02-02,Contra Costa,013,1133247,1,0,0,0,0
2020-02-02,Del Norte,015,27424,0,0,0,0,0
2020-02-02,El Dorado,017,186661,0,0,0,0,0
2020-02-02,Fresno,019,978130,0,0,0,0,0
2020-02-02,Glenn,021,27897,0,0,0,0,0
2020-02-02,Humboldt,023,135768,0,0,0,0,0
2020-02-02,Imperial,025,180216,1,0,0,0,0
2020-02-02,Inyo,027,18085,0,0,0,0,0
2020-02-02,Kern,029,883053,0,0,0,0,0
2020-02-02,Kings,031,150075,0,0,0,0,0
2020-02-02,Lake,033,64148,0,0,0,0,0
2020-02-02,Lassen,035,31185,0,0,0,0,0
2020-02-02,Los Angeles,037,10098052,17,1,0,1,0
2020-02-02,Madera,039,155013,0,0,0,0,0
2020-02-02,Marin,041,260295,0,0,0,0,0
2020-02-02,Mariposa,043,17540,0,0,0,0,0
2020-02-02,Mendocino,045,87422,0,0,0,0,0
2020-02-02,Merced,047,269075,0,0,0,0,0
2020-02-02,Modoc,049,8938,0,0,0,0,0
2020-02-02,Mono,051,14174,0,0,0,0,0
2020-02-02,Monterey,053,433212,1,0,0,0,0
2020-02-02,Napa,055,140530,0,0,0,0,0
2020-02-02,Nevada,057,99092,0,0,0,0,0
2020-02-02,Orange,059,3164182,1,1,0,1,0
2020-02-02,Placer,061,380077,0,0,0,0,0
2020-02-02,Plumas,063,18699,0,0,0,0,0
2020-02-02,Riverside,065,2383286,3,0,0,0,0
2020-02-02,Sacramento,067,1510023,0,0,0,0,0
2020-02-02,San Benito,069,59416,0,2,0,2,0
2020-02-02,San Bernardino,071,2135413,2,0,0,0,0
2020-02-02,San Diego,073,3302833,0,0,0,0,0
2020-02-02,San Francisco,075,870044,1,0,0,0,0
2020-02-02,San Joaquin,077,732212,0,0,1,1,0
2020-02-02,San Luis Obispo,079,281455,0,0,0,0,0
2020-02-02,San Mateo,081,765935,0,0,0,0,0
2020-02-02,Santa Barbara,083,443738,0,0,0,0,0
2020-02-02,Santa Clara,085,1922200,2,2,0,2,0
2020-02-02,Santa Cruz,087,273765,0,0,0,0,0
2020-02-02,Shasta,089,179085,0,0,0,0,0
2020-02-02,Sierra,091,2930,0,0,0,0,0
2020-02-02,Siskiyou,093,43540,0,0,0,0,0
2020-02-02,Solano,095,438530,0,0,0,0,0
2020-02-02,Sonoma,097,501317,0,0,0,0,0
2020-02-02,Stanislaus,099,539301,0,0,0,0,0
2020-02-02,Sutter,101,95872,0,0,0,0,0
2020-02-02,Tehama,103,63373,0,0,0,0,0
2020-02-02,Trinity,105,12862,0,0,0,0,0
2020-02-02,Tulare,107,460477,2,0,0,0,0
2020-02-02,Tuolumne,109,53932,0,0,0,0,0
2020-02-02,Ventura,111,848112,0,0,0,0,0
2020-02-02,Yolo,113,214977,1,0,0,0,0
2020-02-02,Yuba,115,75493,0,0,0,0,0
2020-02-01,Alameda,001,1643700,3,0,0,0,0
2020-02-01,Alpine,003,1148,0,0,0,0,0
2020-02-01,Amador,005,37829,0,0,0,0,0
2020-02-01,Butte,007,227075,0,0,0,0,0
2020-02-01,Calaveras,009,45235,0,0,0,0,0
2020-02-01,Colusa,011,21464,0,0,0,0,0
2020-02-01,Contra Costa,013,1133247,0,0,0,0,0
2020-02-01,Del Norte,015,27424,0,0,0,0,0
2020-02-01,El Dorado,017,186661,0,0,0,0,0
2020-02-01,Fresno,019,978130,0,0,0,0,0
2020-02-01,Glenn,021,27897,0,0,0,0,0
2020-02-01,Humboldt,023,135768,0,0,0,0,0
2020-02-01,Imperial,025,180216,0,0,0,0,0
2020-02-01,Inyo,027,18085,0,0,0,0,0
2020-02-01,Kern,029,883053,0,0,0,0,0
2020-02-01,Kings,031,150075,0,0,0,0,0
2020-02-01,Lake,033,64148,0,0,0,0,0
2020-02-01,Lassen,035,31185,0,0,0,0,0
2020-02-01,Los Angeles,037,10098052,13,1,0,1,0
2020-02-01,Madera,039,155013,0,0,0,0,0
2020-02-01,Marin,041,260295,0,0,0,0,0
2020-02-01,Mariposa,043,17540,0,0,0,0,0
2020-02-01,Mendocino,045,87422,0,0,0,0,0
2020-02-01,Merced,047,269075,0,0,0,0,0
2020-02-01,Modoc,049,8938,0,0,0,0,0
2020-02-01,Mono,051,14174,0,0,0,0,0
2020-02-01,Monterey,053,433212,0,0,0,0,0
2020-02-01,Napa,055,140530,0,0,0,0,0
2020-02-01,Nevada,057,99092,0,0,0,0,0
2020-02-01,Orange,059,3164182,1,1,0,1,0
2020-02-01,Placer,061,380077,0,0,0,0,0
2020-02-01,Plumas,063,18699,0,0,0,0,0
2020-02-01,Riverside,065,2383286,2,0,0,0,0
2020-02-01,Sacramento,067,1510023,0,0,0,0,0
2020-02-01,San Benito,069,59416,0,0,0,0,0
2020-02-01,San Bernardino,071,2135413,1,0,0,0,0
2020-02-01,San Diego,073,3302833,0,0,0,0,0
2020-02-01,San Francisco,075,870044,1,0,0,0,0
2020-02-01,San Joaquin,077,732212,0,0,1,1,0
2020-02-01,San Luis Obispo,079,281455,0,0,0,0,0
2020-02-01,San Mateo,081,765935,0,0,0,0,0
2020-02-01,Santa Barbara,083,443738,0,0,0,0,0
2020-02-01,Santa Clara,085,1922200,2,1,0,1,0
2020-02-01,Santa Cruz,087,273765,0,0,0,0,0
2020-02-01,Shasta,089,179085,0,0,0,0,0
2020-02-01,Sierra,091,2930,0,0,0,0,0
2020-02-01,Siskiyou,093,43540,0,0,0,0,0
2020-02-01,Solano,095,438530,0,0,0,0,0
2020-02-01,Sonoma,097,501317,0,0,0,0,0
2020-02-01,Stanislaus,099,539301,0,0,0,0,0
2020-02-01,Sutter,101,95872,0,0,0,0,0
2020-02-01,Tehama,103,63373,0,0,0,0,0
2020-02-01,Trinity,105,12862,0,0,0,0,0
2020-02-01,Tulare,107,460477,1,0,0,0,0
2020-02-01,Tuolumne,109,53932,0,0,0,0,0
2020-02-01,Ventura,111,848112,0,0,0,0,0
2020-02-01,Yolo,113,214977,0,0,0,0,0
2020-02-01,Yuba,115,75493,0,0,0,0,0
