date,county,fips,population,confirmed_cases,reported_cases,probable_cases,reported_and_probable_cases,reported_deaths
2022-07-07,Alameda,001,1643700,312643,312651,17989,330640,1912
2022-07-07,Alpine,003,1148,129,129,1,130,0
2022-07-07,Amador,005,37829,9334,9335,783,10118,87
2022-07-07,Butte,007,227075,36165,36165,7777,43942,438
2022-07-07,Calaveras,009,45235,7895,7895,440,8335,125
2022-07-07,Colusa,011,21464,3584,3586,1168,4754,22
2022-07-07,Contra Costa,013,1133247,224716,224718,17438,242156,1351
2022-07-07,Del Norte,015,27424,6666,6666,369,7035,54
2022-07-07,El Dorado,017,186661,30070,30070,3817,33887,218
2022-07-07,Fresno,019,978130,250377,250379,26762,277141,2786
2022-07-07,Glenn,021,27897,5231,5231,1746,6977,48
2022-07-07,Humboldt,023,135768,19674,19677,4049,23726,149
2022-07-07,Imperial,025,180216,59557,59558,12342,71900,944
2022-07-07,Inyo,027,18085,4297,4297,716,5013,56
2022-07-07,Kern,029,883053,204117,204128,51973,256101,2359
2022-07-07,Kings,031,150075,54723,54725,3832,58557,449
2022-07-07,Lake,033,64148,11685,11685,1037,12722,140
2022-07-07,Lassen,035,31185,9362,9362,960,10322,64
2022-07-07,Los Angeles,037,10098052,3001758,3002013,149775,3151788,32151
2022-07-07,Madera,039,155013,40079,40081,6923,47004,372
2022-07-07,Marin,041,260295,41267,41271,4778,46049,302
2022-07-07,Mariposa,043,17540,2805,2805,278,3083,30
2022-07-07,Mendocino,045,87422,14610,14610,3842,18452,128
2022-07-07,Merced,047,269075,66613,66616,9937,76553,832
2022-07-07,Modoc,049,8938,789,789,282,1071,9
2022-07-07,Mono,051,14174,3119,3119,197,3316,7
2022-07-07,Monterey,053,433212,87001,87002,17754,104756,745
2022-07-07,Napa,055,140530,29806,29807,1307,31114,145
2022-07-07,Nevada,057,99092,17688,17693,1516,19209,131
2022-07-07,Orange,059,3164182,610974,610975,51808,662783,7132
2022-07-07,Placer,061,380077,70401,70401,8485,78886,632
2022-07-07,Plumas,063,18699,3339,3339,408,3747,13
2022-07-07,Riverside,065,2383286,638137,638193,31609,669802,6506
2022-07-07,Sacramento,067,1510023,318553,318556,31886,350442,3108
2022-07-07,San Benito,069,59416,14626,14628,743,15371,100
2022-07-07,San Bernardino,071,2135413,610037,610086,27466,637552,7893
2022-07-07,San Diego,073,3302833,844085,844085,62524,906609,5357
2022-07-07,San Francisco,075,870044,161924,161931,10872,172803,914
2022-07-07,San Joaquin,077,732212,181951,181958,12389,194347,2257
2022-07-07,San Luis Obispo,079,281455,58625,58636,5904,64540,498
2022-07-07,San Mateo,081,765935,152317,152319,9740,162059,723
2022-07-07,Santa Barbara,083,443738,96266,96266,5727,101993,697
2022-07-07,Santa Clara,085,1922200,388253,388270,16978,405248,2360
2022-07-07,Santa Cruz,087,273765,56455,56455,2879,59334,266
2022-07-07,Shasta,089,179085,32536,32536,6640,39176,576
2022-07-07,Sierra,091,2930,291,291,58,349,4
2022-07-07,Siskiyou,093,43540,4855,4855,3069,7924,82
2022-07-07,Solano,095,438530,95639,95651,6933,102584,455
2022-07-07,Sonoma,097,501317,98423,98430,4437,102867,496
2022-07-07,Stanislaus,099,539301,126877,126897,19316,146213,1686
2022-07-07,Sutter,101,95872,22160,22165,2396,24561,228
2022-07-07,Tehama,103,63373,12716,12716,2815,15531,205
2022-07-07,Trinity,105,12862,1272,1272,307,1579,20
2022-07-07,Tulare,107,460477,113001,113002,32132,145134,1508
2022-07-07,Tuolumne,109,53932,14019,14019,773,14792,194
2022-07-07,Ventura,111,848112,191460,191462,12333,203795,1518
2022-07-07,Yolo,113,214977,44152,44152,3922,48074,323
2022-07-07,Yuba,115,75493,17342,17345,1513,18858,125
2022-07-06,Alameda,001,1643700,312643,310551,17989,328540,1899
2022-07-06,Alpine,003,1148,129,129,1,130,0
2022-07-06,Amador,005,37829,9334,9301,783,10084,87
2022-07-06,Butte,007,227075,36165,36053,7777,43830,436
2022-07-06,Calaveras,009,45235,7895,7873,440,8313,124
2022-07-06,Colusa,011,21464,3584,3579,1168,4747,22
2022-07-06,Contra Costa,013,1133247,224716,223500,17438,240938,1348
2022-07-06,Del Norte,015,27424,6666,6623,369,6992,54
2022-07-06,El Dorado,017,186661,30070,29953,3817,33770,218
2022-07-06,Fresno,019,978130,250377,249480,26762,276242,2786
2022-07-06,Glenn,021,27897,5231,5222,1746,6968,48
2022-07-06,Humboldt,023,135768,19674,19608,4049,23657,149
2022-07-06,Imperial,025,180216,59557,59184,12342,71526,944
2022-07-06,Inyo,027,18085,4297,4282,716,4998,56
2022-07-06,Kern,029,883053,204117,203587,51973,255560,2353
2022-07-06,Kings,031,150075,54723,54560,3832,58392,449
2022-07-06,Lake,033,64148,11685,11659,1037,12696,140
2022-07-06,Lassen,035,31185,9362,9350,960,10310,64
2022-07-06,Los Angeles,037,10098052,3001758,2991161,149775,3140936,32116
2022-07-06,Madera,039,155013,40079,39952,6923,46875,372
2022-07-06,Marin,041,260295,41267,41036,4778,45814,302
2022-07-06,Mariposa,043,17540,2805,2797,278,3075,30
2022-07-06,Mendocino,045,87422,14610,14540,3842,18382,127
2022-07-06,Merced,047,269075,66613,66420,9937,76357,832
2022-07-06,Modoc,049,8938,789,788,282,1070,8
2022-07-06,Mono,051,14174,3119,3109,197,3306,7
2022-07-06,Monterey,053,433212,87001,86639,17754,104393,744
2022-07-06,Napa,055,140530,29806,29690,1307,30997,144
2022-07-06,Nevada,057,99092,17688,17660,1516,19176,131
2022-07-06,Orange,059,3164182,610974,608084,51808,659892,7125
2022-07-06,Placer,061,380077,70401,70113,8485,78598,632
2022-07-06,Plumas,063,18699,3339,3316,408,3724,13
2022-07-06,Riverside,065,2383286,638137,636209,31609,667818,6505
2022-07-06,Sacramento,067,1510023,318553,317315,31886,349201,3104
2022-07-06,San Benito,069,59416,14626,14556,743,15299,100
2022-07-06,San Bernardino,071,2135413,610037,608119,27466,635585,7870
2022-07-06,San Diego,073,3302833,844085,839970,62524,902494,5349
2022-07-06,San Francisco,075,870044,161924,160612,10872,171484,910
2022-07-06,San Joaquin,077,732212,181951,181448,12389,193837,2256
2022-07-06,San Luis Obispo,079,281455,58625,58488,5904,64392,496
2022-07-06,San Mateo,081,765935,152317,151344,9740,161084,723
2022-07-06,Santa Barbara,083,443738,96266,95918,5727,101645,702
2022-07-06,Santa Clara,085,1922200,388253,385553,16978,402531,2358
2022-07-06,Santa Cruz,087,273765,56455,56307,2879,59186,267
2022-07-06,Shasta,089,179085,32536,32444,6640,39084,570
2022-07-06,Sierra,091,2930,291,290,58,348,4
2022-07-06,Siskiyou,093,43540,4855,4841,3069,7910,82
2022-07-06,Solano,095,438530,95639,95181,6933,102114,455
2022-07-06,Sonoma,097,501317,98423,98031,4437,102468,495
2022-07-06,Stanislaus,099,539301,126877,126492,19316,145808,1682
2022-07-06,Sutter,101,95872,22160,22089,2396,24485,228
2022-07-06,Tehama,103,63373,12716,12680,2815,15495,205
2022-07-06,Trinity,105,12862,1272,1263,307,1570,20
2022-07-06,Tulare,107,460477,113001,112684,32132,144816,1500
2022-07-06,Tuolumne,109,53932,14019,13960,773,14733,189
2022-07-06,Ventura,111,848112,191460,190794,12333,203127,1517
2022-07-06,Yolo,113,214977,44152,43171,3922,47093,324
2022-07-06,Yuba,115,75493,17342,17277,1513,18790,124
2022-07-05,Alameda,001,1643700,312509,310551,17989,328540,1899
2022-07-05,Alpine,003,1148,129,129,1,130,0
2022-07-05,Amador,005,37829,9328,9301,783,10084,87
2022-07-05,Butte,007,227075,36149,36053,7777,43830,436
2022-07-05,Calaveras,009,45235,7892,7873,440,8313,124
2022-07-05,Colusa,011,21464,3584,3579,1166,4745,22
2022-07-05,Contra Costa,013,1133247,224649,223500,17438,240938,1348
2022-07-05,Del Norte,015,27424,6664,6623,369,6992,54
2022-07-05,El Dorado,017,186661,30056,29953,3816,33769,218
2022-07-05,Fresno,019,978130,250292,249480,26762,276242,2786
2022-07-05,Glenn,021,27897,5229,5222,1746,6968,48
2022-07-05,Humboldt,023,135768,19669,19608,4049,23657,149
2022-07-05,Imperial,025,180216,59519,59184,12342,71526,944
2022-07-05,Inyo,027,18085,4293,4282,715,4997,56
2022-07-05,Kern,029,883053,204082,203587,51971,255558,2353
2022-07-05,Kings,031,150075,54674,54560,3832,58392,449
2022-07-05,Lake,033,64148,11679,11659,1037,12696,140
2022-07-05,Lassen,035,31185,9360,9350,960,10310,64
2022-07-05,Los Angeles,037,10098052,3001650,2991161,149749,3140910,32116
2022-07-05,Madera,039,155013,40066,39952,6923,46875,372
2022-07-05,Marin,041,260295,41240,41036,4777,45813,302
2022-07-05,Mariposa,043,17540,2805,2797,278,3075,30
2022-07-05,Mendocino,045,87422,14598,14540,3842,18382,127
2022-07-05,Merced,047,269075,66606,66420,9935,76355,832
2022-07-05,Modoc,049,8938,788,788,282,1070,8
2022-07-05,Mono,051,14174,3117,3109,197,3306,7
2022-07-05,Monterey,053,433212,86963,86639,17752,104391,744
2022-07-05,Napa,055,140530,29795,29690,1307,30997,144
2022-07-05,Nevada,057,99092,17685,17660,1515,19175,131
2022-07-05,Orange,059,3164182,610731,608084,51808,659892,7125
2022-07-05,Placer,061,380077,70375,70113,8484,78597,632
2022-07-05,Plumas,063,18699,3330,3316,408,3724,13
2022-07-05,Riverside,065,2383286,638028,636209,31609,667818,6505
2022-07-05,Sacramento,067,1510023,318487,317315,31886,349201,3104
2022-07-05,San Benito,069,59416,14618,14556,743,15299,100
2022-07-05,San Bernardino,071,2135413,609960,608119,27442,635561,7870
2022-07-05,San Diego,073,3302833,843758,839970,62308,902278,5349
2022-07-05,San Francisco,075,870044,161839,160612,10872,171484,910
2022-07-05,San Joaquin,077,732212,181881,181448,12379,193827,2256
2022-07-05,San Luis Obispo,079,281455,58609,58488,5903,64391,496
2022-07-05,San Mateo,081,765935,152255,151344,9740,161084,723
2022-07-05,Santa Barbara,083,443738,96208,95918,5726,101644,702
2022-07-05,Santa Clara,085,1922200,388136,385553,16978,402531,2358
2022-07-05,Santa Cruz,087,273765,56450,56307,2879,59186,267
2022-07-05,Shasta,089,179085,32536,32444,6640,39084,570
2022-07-05,Sierra,091,2930,291,290,58,348,4
2022-07-05,Siskiyou,093,43540,4852,4841,3065,7906,82
2022-07-05,Solano,095,438530,95621,95181,6933,102114,455
2022-07-05,Sonoma,097,501317,98407,98031,4437,102468,495
2022-07-05,Stanislaus,099,539301,126829,126492,19283,145775,1682
2022-07-05,Sutter,101,95872,22141,22089,2396,24485,228
2022-07-05,Tehama,103,63373,12716,12680,2814,15494,205
2022-07-05,Trinity,105,12862,1271,1263,307,1570,20
2022-07-05,Tulare,107,460477,112958,112684,32124,144808,1500
2022-07-05,Tuolumne,109,53932,14001,13960,773,14733,189
2022-07-05,Ventura,111,848112,191408,190794,12327,203121,1517
2022-07-05,Yolo,113,214977,44140,43171,3922,47093,324
2022-07-05,Yuba,115,75493,17329,17277,1512,18789,124
2022-07-04,Alameda,001,1643700,311716,310551,17988,328539,1899
2022-07-04,Alpine,003,1148,129,129,1,130,0
2022-07-04,Amador,005,37829,9320,9301,782,10083,87
2022-07-04,Butte,007,227075,36091,36053,7777,43830,436
2022-07-04,Calaveras,009,45235,7879,7873,440,8313,124
2022-07-04,Colusa,011,21464,3581,3579,1166,4745,22
2022-07-04,Contra Costa,013,1133247,224173,223500,17438,240938,1348
2022-07-04,Del Norte,015,27424,6648,6623,367,6990,54
2022-07-04,El Dorado,017,186661,30009,29953,3814,33767,218
2022-07-04,Fresno,019,978130,249944,249480,26762,276242,2786
2022-07-04,Glenn,021,27897,5224,5222,1745,6967,48
2022-07-04,Humboldt,023,135768,19638,19608,4049,23657,149
2022-07-04,Imperial,025,180216,59430,59184,12342,71526,944
2022-07-04,Inyo,027,18085,4292,4282,715,4997,56
2022-07-04,Kern,029,883053,203970,203587,51964,255551,2353
2022-07-04,Kings,031,150075,54600,54560,3829,58389,449
2022-07-04,Lake,033,64148,11671,11659,1037,12696,140
2022-07-04,Lassen,035,31185,9357,9350,960,10310,64
2022-07-04,Los Angeles,037,10098052,2999050,2991161,149307,3140468,32116
2022-07-04,Madera,039,155013,40018,39952,6923,46875,372
2022-07-04,Marin,041,260295,41155,41036,4775,45811,302
2022-07-04,Mariposa,043,17540,2800,2797,278,3075,30
2022-07-04,Mendocino,045,87422,14587,14540,3842,18382,127
2022-07-04,Merced,047,269075,66524,66420,9932,76352,832
2022-07-04,Modoc,049,8938,788,788,280,1068,8
2022-07-04,Mono,051,14174,3113,3109,197,3306,7
2022-07-04,Monterey,053,433212,86829,86639,17748,104387,744
2022-07-04,Napa,055,140530,29740,29690,1307,30997,144
2022-07-04,Nevada,057,99092,17671,17660,1515,19175,131
2022-07-04,Orange,059,3164182,609763,608084,51807,659891,7125
2022-07-04,Placer,061,380077,70291,70113,8482,78595,632
2022-07-04,Plumas,063,18699,3318,3316,408,3724,13
2022-07-04,Riverside,065,2383286,637147,636209,31605,667814,6505
2022-07-04,Sacramento,067,1510023,318057,317315,31886,349201,3104
2022-07-04,San Benito,069,59416,14595,14556,743,15299,100
2022-07-04,San Bernardino,071,2135413,609085,608119,27442,635561,7870
2022-07-04,San Diego,073,3302833,842125,839970,61972,901942,5349
2022-07-04,San Francisco,075,870044,161265,160612,10872,171484,910
2022-07-04,San Joaquin,077,732212,181659,181448,12375,193823,2256
2022-07-04,San Luis Obispo,079,281455,58546,58488,5900,64388,496
2022-07-04,San Mateo,081,765935,151853,151344,9740,161084,723
2022-07-04,Santa Barbara,083,443738,96069,95918,5723,101641,702
2022-07-04,Santa Clara,085,1922200,386868,385553,16978,402531,2358
2022-07-04,Santa Cruz,087,273765,56391,56307,2879,59186,267
2022-07-04,Shasta,089,179085,32509,32444,6640,39084,570
2022-07-04,Sierra,091,2930,291,290,58,348,4
2022-07-04,Siskiyou,093,43540,4848,4841,3065,7906,82
2022-07-04,Solano,095,438530,95365,95181,6933,102114,455
2022-07-04,Sonoma,097,501317,98224,98031,4437,102468,495
2022-07-04,Stanislaus,099,539301,126689,126492,19256,145748,1682
2022-07-04,Sutter,101,95872,22105,22089,2396,24485,228
2022-07-04,Tehama,103,63373,12706,12680,2814,15494,205
2022-07-04,Trinity,105,12862,1267,1263,307,1570,20
2022-07-04,Tulare,107,460477,112841,112684,32084,144768,1500
2022-07-04,Tuolumne,109,53932,13979,13960,773,14733,189
2022-07-04,Ventura,111,848112,191165,190794,12307,203101,1517
2022-07-04,Yolo,113,214977,44093,43171,3922,47093,324
2022-07-04,Yuba,115,75493,17293,17277,1512,18789,124
2022-07-03,Alameda,001,1643700,311367,307672,17987,325659,1898
2022-07-03,Alpine,003,1148,129,129,1,130,0
2022-07-03,Amador,005,37829,9318,9243,782,10025,87
2022-07-03,Butte,007,227075,36087,35846,7777,43623,436
2022-07-03,Calaveras,009,45235,7875,7836,440,8276,124
2022-07-03,Colusa,011,21464,3579,3566,1166,4732,22
2022-07-03,Contra Costa,013,1133247,223974,221545,17437,238982,1343
2022-07-03,Del Norte,015,27424,6642,6543,367,6910,53
2022-07-03,El Dorado,017,186661,29993,29764,3814,33578,217
2022-07-03,Fresno,019,978130,249815,247952,26762,274714,2783
2022-07-03,Glenn,021,27897,5224,5211,1745,6956,48
2022-07-03,Humboldt,023,135768,19633,19516,4049,23565,149
2022-07-03,Imperial,025,180216,59396,58768,12342,71110,944
2022-07-03,Inyo,027,18085,4289,4261,715,4976,56
2022-07-03,Kern,029,883053,203909,202502,51952,254454,2352
2022-07-03,Kings,031,150075,54588,54262,3828,58090,449
2022-07-03,Lake,033,64148,11665,11595,1037,12632,140
2022-07-03,Lassen,035,31185,9355,9336,960,10296,64
2022-07-03,Los Angeles,037,10098052,2997767,2969395,149141,3118536,32089
2022-07-03,Madera,039,155013,40006,39738,6923,46661,372
2022-07-03,Marin,041,260295,41114,40653,4771,45424,297
2022-07-03,Mariposa,043,17540,2798,2780,278,3058,30
2022-07-03,Mendocino,045,87422,14578,14464,3842,18306,127
2022-07-03,Merced,047,269075,66502,66093,9930,76023,832
2022-07-03,Modoc,049,8938,788,787,280,1067,8
2022-07-03,Mono,051,14174,3112,3099,197,3296,7
2022-07-03,Monterey,053,433212,86793,86212,17746,103958,744
2022-07-03,Napa,055,140530,29733,29486,1307,30793,145
2022-07-03,Nevada,057,99092,17665,17546,1515,19061,131
2022-07-03,Orange,059,3164182,609292,603511,51806,655317,7114
2022-07-03,Placer,061,380077,70228,69606,8480,78086,631
2022-07-03,Plumas,063,18699,3316,3294,408,3702,13
2022-07-03,Riverside,065,2383286,636964,632038,31605,663643,6502
2022-07-03,Sacramento,067,1510023,317853,315165,31886,347051,3100
2022-07-03,San Benito,069,59416,14588,14420,743,15163,100
2022-07-03,San Bernardino,071,2135413,608856,604093,27442,631535,7860
2022-07-03,San Diego,073,3302833,841510,834116,61927,896043,5341
2022-07-03,San Francisco,075,870044,161005,158871,10872,169743,910
2022-07-03,San Joaquin,077,732212,181574,180368,12372,192740,2256
2022-07-03,San Luis Obispo,079,281455,58525,58079,5896,63975,489
2022-07-03,San Mateo,081,765935,151650,149812,9740,159552,723
2022-07-03,Santa Barbara,083,443738,96017,95214,5722,100936,699
2022-07-03,Santa Clara,085,1922200,386455,381630,16978,398608,2355
2022-07-03,Santa Cruz,087,273765,56364,55757,2879,58636,267
2022-07-03,Shasta,089,179085,32490,32280,6640,38920,570
2022-07-03,Sierra,091,2930,290,283,58,341,4
2022-07-03,Siskiyou,093,43540,4842,4808,3065,7873,82
2022-07-03,Solano,095,438530,95307,94437,6933,101370,455
2022-07-03,Sonoma,097,501317,98179,97379,4437,101816,495
2022-07-03,Stanislaus,099,539301,126633,125788,19246,145034,1681
2022-07-03,Sutter,101,95872,22090,21935,2396,24331,228
2022-07-03,Tehama,103,63373,12696,12615,2814,15429,205
2022-07-03,Trinity,105,12862,1266,1256,307,1563,20
2022-07-03,Tulare,107,460477,112788,112118,32082,144200,1500
2022-07-03,Tuolumne,109,53932,13975,13886,773,14659,189
2022-07-03,Ventura,111,848112,191054,189493,12306,201799,1517
2022-07-03,Yolo,113,214977,44073,42760,3922,46682,324
2022-07-03,Yuba,115,75493,17287,17168,1512,18680,124
2022-07-02,Alameda,001,1643700,311097,307672,17965,325637,1898
2022-07-02,Alpine,003,1148,129,129,1,130,0
2022-07-02,Amador,005,37829,9307,9243,782,10025,87
2022-07-02,Butte,007,227075,36069,35846,7767,43613,436
2022-07-02,Calaveras,009,45235,7871,7836,440,8276,124
2022-07-02,Colusa,011,21464,3576,3566,1166,4732,22
2022-07-02,Contra Costa,013,1133247,223758,221545,17414,238959,1343
2022-07-02,Del Norte,015,27424,6635,6543,366,6909,53
2022-07-02,El Dorado,017,186661,29972,29764,3813,33577,217
2022-07-02,Fresno,019,978130,249680,247952,26758,274710,2783
2022-07-02,Glenn,021,27897,5223,5211,1744,6955,48
2022-07-02,Humboldt,023,135768,19621,19516,4046,23562,149
2022-07-02,Imperial,025,180216,59349,58768,12340,71108,944
2022-07-02,Inyo,027,18085,4288,4261,715,4976,56
2022-07-02,Kern,029,883053,203807,202502,51925,254427,2352
2022-07-02,Kings,031,150075,54552,54262,3827,58089,449
2022-07-02,Lake,033,64148,11658,11595,1036,12631,140
2022-07-02,Lassen,035,31185,9354,9336,959,10295,64
2022-07-02,Los Angeles,037,10098052,2995938,2969395,148841,3118236,32089
2022-07-02,Madera,039,155013,39986,39738,6921,46659,372
2022-07-02,Marin,041,260295,41076,40653,4756,45409,297
2022-07-02,Mariposa,043,17540,2798,2780,278,3058,30
2022-07-02,Mendocino,045,87422,14553,14464,3842,18306,127
2022-07-02,Merced,047,269075,66473,66093,9928,76021,832
2022-07-02,Modoc,049,8938,788,787,280,1067,8
2022-07-02,Mono,051,14174,3110,3099,197,3296,7
2022-07-02,Monterey,053,433212,86740,86212,17730,103942,744
2022-07-02,Napa,055,140530,29720,29486,1306,30792,145
2022-07-02,Nevada,057,99092,17663,17546,1513,19059,131
2022-07-02,Orange,059,3164182,608672,603511,51703,655214,7114
2022-07-02,Placer,061,380077,70167,69606,8475,78081,631
2022-07-02,Plumas,063,18699,3313,3294,407,3701,13
2022-07-02,Riverside,065,2383286,636609,632038,31590,663628,6502
2022-07-02,Sacramento,067,1510023,317620,315165,31881,347046,3100
2022-07-02,San Benito,069,59416,14568,14420,735,15155,100
2022-07-02,San Bernardino,071,2135413,608549,604093,27427,631520,7860
2022-07-02,San Diego,073,3302833,840760,834116,61883,895999,5341
2022-07-02,San Francisco,075,870044,160821,158871,10865,169736,910
2022-07-02,San Joaquin,077,732212,181496,180368,12359,192727,2256
2022-07-02,San Luis Obispo,079,281455,58491,58079,5887,63966,489
2022-07-02,San Mateo,081,765935,151462,149812,9726,159538,723
2022-07-02,Santa Barbara,083,443738,95932,95214,5715,100929,699
2022-07-02,Santa Clara,085,1922200,385941,381630,16971,398601,2355
2022-07-02,Santa Cruz,087,273765,56333,55757,2875,58632,267
2022-07-02,Shasta,089,179085,32479,32280,6639,38919,570
2022-07-02,Sierra,091,2930,290,283,58,341,4
2022-07-02,Siskiyou,093,43540,4838,4808,3065,7873,82
2022-07-02,Solano,095,438530,95253,94437,6929,101366,455
2022-07-02,Sonoma,097,501317,98115,97379,4431,101810,495
2022-07-02,Stanislaus,099,539301,126559,125788,19234,145022,1681
2022-07-02,Sutter,101,95872,22078,21935,2396,24331,228
2022-07-02,Tehama,103,63373,12692,12615,2812,15427,205
2022-07-02,Trinity,105,12862,1266,1256,307,1563,20
2022-07-02,Tulare,107,460477,112725,112118,32053,144171,1500
2022-07-02,Tuolumne,109,53932,13970,13886,772,14658,189
2022-07-02,Ventura,111,848112,190931,189493,12292,201785,1517
2022-07-02,Yolo,113,214977,44044,42760,3920,46680,324
2022-07-02,Yuba,115,75493,17280,17168,1512,18680,124
2022-07-01,Alameda,001,1643700,310703,307672,17936,325608,1898
2022-07-01,Alpine,003,1148,129,129,1,130,0
2022-07-01,Amador,005,37829,9303,9243,782,10025,87
2022-07-01,Butte,007,227075,36046,35846,7753,43599,436
2022-07-01,Calaveras,009,45235,7868,7836,439,8275,124
2022-07-01,Colusa,011,21464,3575,3566,1166,4732,22
2022-07-01,Contra Costa,013,1133247,223550,221545,17387,238932,1343
2022-07-01,Del Norte,015,27424,6621,6543,362,6905,53
2022-07-01,El Dorado,017,186661,29954,29764,3807,33571,217
2022-07-01,Fresno,019,978130,249463,247952,26745,274697,2783
2022-07-01,Glenn,021,27897,5223,5211,1744,6955,48
2022-07-01,Humboldt,023,135768,19607,19516,4041,23557,149
2022-07-01,Imperial,025,180216,59274,58768,12340,71108,944
2022-07-01,Inyo,027,18085,4283,4261,711,4972,56
2022-07-01,Kern,029,883053,203665,202502,51908,254410,2352
2022-07-01,Kings,031,150075,54520,54262,3824,58086,449
2022-07-01,Lake,033,64148,11652,11595,1036,12631,140
2022-07-01,Lassen,035,31185,9352,9336,958,10294,64
2022-07-01,Los Angeles,037,10098052,2992840,2969395,148463,3117858,32089
2022-07-01,Madera,039,155013,39957,39738,6913,46651,372
2022-07-01,Marin,041,260295,41018,40653,4740,45393,297
2022-07-01,Mariposa,043,17540,2797,2780,277,3057,30
2022-07-01,Mendocino,045,87422,14534,14464,3841,18305,127
2022-07-01,Merced,047,269075,66421,66093,9928,76021,832
2022-07-01,Modoc,049,8938,788,787,280,1067,8
2022-07-01,Mono,051,14174,3105,3099,197,3296,7
2022-07-01,Monterey,053,433212,86690,86212,17711,103923,744
2022-07-01,Napa,055,140530,29688,29486,1306,30792,145
2022-07-01,Nevada,057,99092,17653,17546,1509,19055,131
2022-07-01,Orange,059,3164182,607969,603511,51558,655069,7114
2022-07-01,Placer,061,380077,70118,69606,8467,78073,631
2022-07-01,Plumas,063,18699,3312,3294,407,3701,13
2022-07-01,Riverside,065,2383286,636091,632038,31542,663580,6502
2022-07-01,Sacramento,067,1510023,317271,315165,31865,347030,3100
2022-07-01,San Benito,069,59416,14550,14420,735,15155,100
2022-07-01,San Bernardino,071,2135413,608130,604093,27409,631502,7860
2022-07-01,San Diego,073,3302833,839786,834116,61747,895863,5341
2022-07-01,San Francisco,075,870044,160608,158871,10825,169696,910
2022-07-01,San Joaquin,077,732212,181395,180368,12346,192714,2256
2022-07-01,San Luis Obispo,079,281455,58474,58079,5880,63959,489
2022-07-01,San Mateo,081,765935,151251,149812,9708,159520,723
2022-07-01,Santa Barbara,083,443738,95846,95214,5712,100926,699
2022-07-01,Santa Clara,085,1922200,385376,381630,16950,398580,2355
2022-07-01,Santa Cruz,087,273765,56293,55757,2867,58624,267
2022-07-01,Shasta,089,179085,32464,32280,6638,38918,570
2022-07-01,Sierra,091,2930,290,283,58,341,4
2022-07-01,Siskiyou,093,43540,4834,4808,3064,7872,82
2022-07-01,Solano,095,438530,95117,94437,6917,101354,455
2022-07-01,Sonoma,097,501317,98023,97379,4417,101796,495
2022-07-01,Stanislaus,099,539301,126455,125788,19217,145005,1681
2022-07-01,Sutter,101,95872,22050,21935,2396,24331,228
2022-07-01,Tehama,103,63373,12690,12615,2812,15427,205
2022-07-01,Trinity,105,12862,1265,1256,307,1563,20
2022-07-01,Tulare,107,460477,112658,112118,32022,144140,1500
2022-07-01,Tuolumne,109,53932,13958,13886,769,14655,189
2022-07-01,Ventura,111,848112,190781,189493,12262,201755,1517
2022-07-01,Yolo,113,214977,44015,42760,3911,46671,324
2022-07-01,Yuba,115,75493,17264,17168,1512,18680,124
2022-06-30,Alameda,001,1643700,309897,307672,17850,325522,1898
2022-06-30,Alpine,003,1148,129,129,1,130,0
2022-06-30,Amador,005,37829,9296,9243,779,10022,87
2022-06-30,Butte,007,227075,35999,35846,7732,43578,436
2022-06-30,Calaveras,009,45235,7861,7836,438,8274,124
2022-06-30,Colusa,011,21464,3572,3566,1166,4732,22
2022-06-30,Contra Costa,013,1133247,223090,221545,17319,238864,1343
2022-06-30,Del Norte,015,27424,6606,6543,355,6898,53
2022-06-30,El Dorado,017,186661,29914,29764,3801,33565,217
2022-06-30,Fresno,019,978130,249128,247952,26722,274674,2783
2022-06-30,Glenn,021,27897,5221,5211,1742,6953,48
2022-06-30,Humboldt,023,135768,19577,19516,4034,23550,149
2022-06-30,Imperial,025,180216,59174,58768,12312,71080,944
2022-06-30,Inyo,027,18085,4278,4261,711,4972,56
2022-06-30,Kern,029,883053,203403,202502,51855,254357,2352
2022-06-30,Kings,031,150075,54446,54262,3820,58082,449
2022-06-30,Lake,033,64148,11640,11595,1035,12630,140
2022-06-30,Lassen,035,31185,9349,9336,957,10293,64
2022-06-30,Los Angeles,037,10098052,2987805,2969395,148011,3117406,32089
2022-06-30,Madera,039,155013,39899,39738,6890,46628,372
2022-06-30,Marin,041,260295,40953,40653,4735,45388,297
2022-06-30,Mariposa,043,17540,2792,2780,275,3055,30
2022-06-30,Mendocino,045,87422,14524,14464,3836,18300,127
2022-06-30,Merced,047,269075,66343,66093,9914,76007,832
2022-06-30,Modoc,049,8938,788,787,280,1067,8
2022-06-30,Mono,051,14174,3104,3099,194,3293,7
2022-06-30,Monterey,053,433212,86579,86212,17660,103872,744
2022-06-30,Napa,055,140530,29637,29486,1301,30787,145
2022-06-30,Nevada,057,99092,17630,17546,1505,19051,131
2022-06-30,Orange,059,3164182,606807,603511,51368,654879,7114
2022-06-30,Placer,061,380077,69987,69606,8455,78061,631
2022-06-30,Plumas,063,18699,3308,3294,407,3701,13
2022-06-30,Riverside,065,2383286,635188,632038,31472,663510,6502
2022-06-30,Sacramento,067,1510023,316733,315165,31828,346993,3100
2022-06-30,San Benito,069,59416,14513,14420,731,15151,100
2022-06-30,San Bernardino,071,2135413,607291,604093,27373,631466,7860
2022-06-30,San Diego,073,3302833,838324,834116,61573,895689,5341
2022-06-30,San Francisco,075,870044,160243,158871,10798,169669,910
2022-06-30,San Joaquin,077,732212,181164,180368,12321,192689,2256
2022-06-30,San Luis Obispo,079,281455,58390,58079,5850,63929,489
2022-06-30,San Mateo,081,765935,150924,149812,9676,159488,723
2022-06-30,Santa Barbara,083,443738,95670,95214,5704,100918,699
2022-06-30,Santa Clara,085,1922200,384448,381630,16918,398548,2355
2022-06-30,Santa Cruz,087,273765,56197,55757,2861,58618,267
2022-06-30,Shasta,089,179085,32433,32280,6626,38906,570
2022-06-30,Sierra,091,2930,290,283,58,341,4
2022-06-30,Siskiyou,093,43540,4827,4808,3063,7871,82
2022-06-30,Solano,095,438530,94934,94437,6888,101325,455
2022-06-30,Sonoma,097,501317,97897,97379,4399,101778,495
2022-06-30,Stanislaus,099,539301,126292,125788,19199,144987,1681
2022-06-30,Sutter,101,95872,22022,21935,2395,24330,228
2022-06-30,Tehama,103,63373,12671,12615,2809,15424,205
2022-06-30,Trinity,105,12862,1260,1256,306,1562,20
2022-06-30,Tulare,107,460477,112524,112118,31956,144074,1500
2022-06-30,Tuolumne,109,53932,13947,13886,765,14651,189
2022-06-30,Ventura,111,848112,190502,189493,12189,201682,1517
2022-06-30,Yolo,113,214977,43958,42760,3906,46666,324
2022-06-30,Yuba,115,75493,17240,17168,1507,18675,124
2022-06-29,Alameda,001,1643700,309082,305288,17812,323100,1895
2022-06-29,Alpine,003,1148,129,129,1,130,0
2022-06-29,Amador,005,37829,9289,9205,778,9983,87
2022-06-29,Butte,007,227075,35948,35651,7720,43371,434
2022-06-29,Calaveras,009,45235,7848,7798,435,8233,124
2022-06-29,Colusa,011,21464,3571,3548,1164,4712,22
2022-06-29,Contra Costa,013,1133247,222650,219921,17263,237184,1339
2022-06-29,Del Norte,015,27424,6587,6484,349,6833,53
2022-06-29,El Dorado,017,186661,29867,29549,3790,33339,216
2022-06-29,Fresno,019,978130,248761,246740,26664,273404,2777
2022-06-29,Glenn,021,27897,5220,5192,1740,6932,48
2022-06-29,Humboldt,023,135768,19554,19411,4022,23433,149
2022-06-29,Imperial,025,180216,59055,58498,12258,70756,944
2022-06-29,Inyo,027,18085,4276,4243,706,4949,56
2022-06-29,Kern,029,883053,203136,201537,51786,253323,2343
2022-06-29,Kings,031,150075,54359,54031,3819,57850,448
2022-06-29,Lake,033,64148,11614,11548,1031,12579,140
2022-06-29,Lassen,035,31185,9344,9310,957,10267,64
2022-06-29,Los Angeles,037,10098052,2982326,2955489,147518,3103007,32062
2022-06-29,Madera,039,155013,39849,39554,6880,46434,372
2022-06-29,Marin,041,260295,40853,40397,4728,45125,297
2022-06-29,Mariposa,043,17540,2790,2753,275,3028,30
2022-06-29,Mendocino,045,87422,14499,14383,3819,18202,127
2022-06-29,Merced,047,269075,66264,65733,9900,75633,830
2022-06-29,Modoc,049,8938,787,780,279,1059,8
2022-06-29,Mono,051,14174,3103,3081,193,3274,7
2022-06-29,Monterey,053,433212,86470,85711,17609,103320,743
2022-06-29,Napa,055,140530,29590,29285,1296,30581,144
2022-06-29,Nevada,057,99092,17603,17439,1500,18939,129
2022-06-29,Orange,059,3164182,605640,599951,51190,651141,7095
2022-06-29,Placer,061,380077,69870,69244,8447,77691,629
2022-06-29,Plumas,063,18699,3305,3267,406,3673,13
2022-06-29,Riverside,065,2383286,634221,629035,31389,660424,6493
2022-06-29,Sacramento,067,1510023,316182,313224,31774,344998,3082
2022-06-29,San Benito,069,59416,14477,14302,723,15025,100
2022-06-29,San Bernardino,071,2135413,606370,600960,27268,628228,7825
2022-06-29,San Diego,073,3302833,836661,828907,61349,890256,5336
2022-06-29,San Francisco,075,870044,159782,157419,10765,168184,902
2022-06-29,San Joaquin,077,732212,180890,179476,12285,191761,2252
2022-06-29,San Luis Obispo,079,281455,58267,57783,5811,63594,486
2022-06-29,San Mateo,081,765935,150572,148533,9653,158186,723
2022-06-29,Santa Barbara,083,443738,95522,94683,5694,100377,699
2022-06-29,Santa Clara,085,1922200,383528,378000,16874,394874,2348
2022-06-29,Santa Cruz,087,273765,56084,55432,2849,58281,266
2022-06-29,Shasta,089,179085,32394,32106,6615,38721,570
2022-06-29,Sierra,091,2930,286,283,58,341,4
2022-06-29,Siskiyou,093,43540,4820,4773,3063,7836,82
2022-06-29,Solano,095,438530,94726,92975,6871,99846,455
2022-06-29,Sonoma,097,501317,97729,96854,4386,101240,493
2022-06-29,Stanislaus,099,539301,126126,125189,19170,144359,1674
2022-06-29,Sutter,101,95872,21964,21836,2389,24225,227
2022-06-29,Tehama,103,63373,12652,12561,2809,15370,205
2022-06-29,Trinity,105,12862,1260,1245,305,1550,20
2022-06-29,Tulare,107,460477,112409,111707,31881,143588,1499
2022-06-29,Tuolumne,109,53932,13928,13779,753,14532,189
2022-06-29,Ventura,111,848112,190230,188519,12121,200640,1514
2022-06-29,Yolo,113,214977,43857,42410,3897,46307,323
2022-06-29,Yuba,115,75493,17212,17082,1505,18587,124
2022-06-28,Alameda,001,1643700,308293,305288,17770,323058,1895
2022-06-28,Alpine,003,1148,129,129,1,130,0
2022-06-28,Amador,005,37829,9283,9205,777,9982,87
2022-06-28,Butte,007,227075,35885,35651,7703,43354,434
2022-06-28,Calaveras,009,45235,7838,7798,434,8232,124
2022-06-28,Colusa,011,21464,3569,3548,1164,4712,22
2022-06-28,Contra Costa,013,1133247,222080,219921,17197,237118,1339
2022-06-28,Del Norte,015,27424,6556,6484,342,6826,53
2022-06-28,El Dorado,017,186661,29824,29549,3782,33331,216
2022-06-28,Fresno,019,978130,248342,246740,26608,273348,2777
2022-06-28,Glenn,021,27897,5212,5192,1735,6927,48
2022-06-28,Humboldt,023,135768,19534,19411,4013,23424,149
2022-06-28,Imperial,025,180216,58964,58498,12190,70688,944
2022-06-28,Inyo,027,18085,4269,4243,700,4943,56
2022-06-28,Kern,029,883053,202867,201537,51675,253212,2343
2022-06-28,Kings,031,150075,54280,54031,3814,57845,448
2022-06-28,Lake,033,64148,11603,11548,1030,12578,140
2022-06-28,Lassen,035,31185,9337,9310,957,10267,64
2022-06-28,Los Angeles,037,10098052,2976462,2955489,146999,3102488,32062
2022-06-28,Madera,039,155013,39792,39554,6862,46416,372
2022-06-28,Marin,041,260295,40751,40397,4720,45117,297
2022-06-28,Mariposa,043,17540,2784,2753,273,3026,30
2022-06-28,Mendocino,045,87422,14471,14383,3808,18191,127
2022-06-28,Merced,047,269075,66167,65733,9877,75610,830
2022-06-28,Modoc,049,8938,786,780,278,1058,8
2022-06-28,Mono,051,14174,3097,3081,191,3272,7
2022-06-28,Monterey,053,433212,86353,85711,17562,103273,743
2022-06-28,Napa,055,140530,29527,29285,1293,30578,144
2022-06-28,Nevada,057,99092,17581,17439,1496,18935,129
2022-06-28,Orange,059,3164182,604297,599951,51003,650954,7095
2022-06-28,Placer,061,380077,69718,69244,8441,77685,629
2022-06-28,Plumas,063,18699,3305,3267,405,3672,13
2022-06-28,Riverside,065,2383286,633115,629035,31334,660369,6493
2022-06-28,Sacramento,067,1510023,315542,313224,31713,344937,3082
2022-06-28,San Benito,069,59416,14440,14302,721,15023,100
2022-06-28,San Bernardino,071,2135413,605312,600960,27216,628176,7825
2022-06-28,San Diego,073,3302833,834852,828907,61124,890031,5336
2022-06-28,San Francisco,075,870044,159286,157419,10740,168159,902
2022-06-28,San Joaquin,077,732212,180598,179476,12248,191724,2252
2022-06-28,San Luis Obispo,079,281455,58156,57783,5770,63553,486
2022-06-28,San Mateo,081,765935,150138,148533,9627,158160,723
2022-06-28,Santa Barbara,083,443738,95355,94683,5679,100362,699
2022-06-28,Santa Clara,085,1922200,382474,378000,16819,394819,2348
2022-06-28,Santa Cruz,087,273765,55960,55432,2839,58271,266
2022-06-28,Shasta,089,179085,32359,32106,6600,38706,570
2022-06-28,Sierra,091,2930,286,283,58,341,4
2022-06-28,Siskiyou,093,43540,4816,4773,3057,7830,82
2022-06-28,Solano,095,438530,94497,92975,6854,99829,455
2022-06-28,Sonoma,097,501317,97536,96854,4374,101228,493
2022-06-28,Stanislaus,099,539301,125934,125189,19144,144333,1674
2022-06-28,Sutter,101,95872,21929,21836,2387,24223,227
2022-06-28,Tehama,103,63373,12637,12561,2805,15366,205
2022-06-28,Trinity,105,12862,1258,1245,305,1550,20
2022-06-28,Tulare,107,460477,112239,111707,31812,143519,1499
2022-06-28,Tuolumne,109,53932,13903,13779,750,14529,189
2022-06-28,Ventura,111,848112,189937,188519,12034,200553,1514
2022-06-28,Yolo,113,214977,43749,42410,3890,46300,323
2022-06-28,Yuba,115,75493,17179,17082,1501,18583,124
2022-06-27,Alameda,001,1643700,307439,305288,17694,322982,1895
2022-06-27,Alpine,003,1148,129,129,1,130,0
2022-06-27,Amador,005,37829,9272,9205,774,9979,87
2022-06-27,Butte,007,227075,35835,35651,7684,43335,434
2022-06-27,Calaveras,009,45235,7825,7798,434,8232,124
2022-06-27,Colusa,011,21464,3566,3548,1162,4710,22
2022-06-27,Contra Costa,013,1133247,221436,219921,17131,237052,1339
2022-06-27,Del Norte,015,27424,6535,6484,337,6821,53
2022-06-27,El Dorado,017,186661,29766,29549,3770,33319,216
2022-06-27,Fresno,019,978130,247889,246740,26538,273278,2777
2022-06-27,Glenn,021,27897,5208,5192,1729,6921,48
2022-06-27,Humboldt,023,135768,19497,19411,4002,23413,149
2022-06-27,Imperial,025,180216,58823,58498,12111,70609,944
2022-06-27,Inyo,027,18085,4259,4243,689,4932,56
2022-06-27,Kern,029,883053,202548,201537,51547,253084,2343
2022-06-27,Kings,031,150075,54195,54031,3811,57842,448
2022-06-27,Lake,033,64148,11584,11548,1026,12574,140
2022-06-27,Lassen,035,31185,9328,9310,957,10267,64
2022-06-27,Los Angeles,037,10098052,2970334,2955489,146473,3101962,32062
2022-06-27,Madera,039,155013,39729,39554,6846,46400,372
2022-06-27,Marin,041,260295,40650,40397,4710,45107,297
2022-06-27,Mariposa,043,17540,2776,2753,270,3023,30
2022-06-27,Mendocino,045,87422,14445,14383,3797,18180,127
2022-06-27,Merced,047,269075,66067,65733,9842,75575,830
2022-06-27,Modoc,049,8938,782,780,277,1057,8
2022-06-27,Mono,051,14174,3096,3081,191,3272,7
2022-06-27,Monterey,053,433212,86213,85711,17497,103208,743
2022-06-27,Napa,055,140530,29458,29285,1290,30575,144
2022-06-27,Nevada,057,99092,17554,17439,1480,18919,129
2022-06-27,Orange,059,3164182,602973,599951,50760,650711,7095
2022-06-27,Placer,061,380077,69612,69244,8418,77662,629
2022-06-27,Plumas,063,18699,3300,3267,403,3670,13
2022-06-27,Riverside,065,2383286,632036,629035,31263,660298,6493
2022-06-27,Sacramento,067,1510023,314822,313224,31657,344881,3082
2022-06-27,San Benito,069,59416,14385,14302,717,15019,100
2022-06-27,San Bernardino,071,2135413,604255,600960,27164,628124,7825
2022-06-27,San Diego,073,3302833,832955,828907,60897,889804,5336
2022-06-27,San Francisco,075,870044,158770,157419,10711,168130,902
2022-06-27,San Joaquin,077,732212,180272,179476,12212,191688,2252
2022-06-27,San Luis Obispo,079,281455,58047,57783,5733,63516,486
2022-06-27,San Mateo,081,765935,149690,148533,9587,158120,723
2022-06-27,Santa Barbara,083,443738,95180,94683,5662,100345,699
2022-06-27,Santa Clara,085,1922200,381085,378000,16770,394770,2348
2022-06-27,Santa Cruz,087,273765,55797,55432,2831,58263,266
2022-06-27,Shasta,089,179085,32304,32106,6584,38690,570
2022-06-27,Sierra,091,2930,286,283,58,341,4
2022-06-27,Siskiyou,093,43540,4806,4773,3050,7823,82
2022-06-27,Solano,095,438530,94210,92975,6814,99789,455
2022-06-27,Sonoma,097,501317,97350,96854,4364,101218,493
2022-06-27,Stanislaus,099,539301,125710,125189,19121,144310,1674
2022-06-27,Sutter,101,95872,21891,21836,2383,24219,227
2022-06-27,Tehama,103,63373,12617,12561,2801,15362,205
2022-06-27,Trinity,105,12862,1255,1245,304,1549,20
2022-06-27,Tulare,107,460477,112064,111707,31711,143418,1499
2022-06-27,Tuolumne,109,53932,13871,13779,742,14521,189
2022-06-27,Ventura,111,848112,189567,188519,11976,200495,1514
2022-06-27,Yolo,113,214977,43627,42410,3882,46292,323
2022-06-27,Yuba,115,75493,17152,17082,1498,18580,124
2022-06-26,Alameda,001,1643700,306429,302071,17616,319687,1891
2022-06-26,Alpine,003,1148,129,129,1,130,0
2022-06-26,Amador,005,37829,9234,9135,772,9907,87
2022-06-26,Butte,007,227075,35762,35406,7659,43065,433
2022-06-26,Calaveras,009,45235,7812,7754,431,8185,124
2022-06-26,Colusa,011,21464,3557,3540,1157,4697,22
2022-06-26,Contra Costa,013,1133247,220841,218053,17048,235101,1335
2022-06-26,Del Norte,015,27424,6514,6398,332,6730,52
2022-06-26,El Dorado,017,186661,29687,29313,3749,33062,216
2022-06-26,Fresno,019,978130,247358,245118,26474,271592,2777
2022-06-26,Glenn,021,27897,5203,5178,1725,6903,48
2022-06-26,Humboldt,023,135768,19466,19234,3989,23223,149
2022-06-26,Imperial,025,180216,58682,58127,12007,70134,944
2022-06-26,Inyo,027,18085,4250,4228,674,4902,56
2022-06-26,Kern,029,883053,202258,200556,51417,251973,2344
2022-06-26,Kings,031,150075,54090,53783,3805,57588,448
2022-06-26,Lake,033,64148,11568,11471,1022,12493,140
2022-06-26,Lassen,035,31185,9320,9287,954,10241,64
2022-06-26,Los Angeles,037,10098052,2963954,2936815,145857,3082672,32036
2022-06-26,Madera,039,155013,39660,39319,6824,46143,372
2022-06-26,Marin,041,260295,40532,39979,4689,44668,297
2022-06-26,Mariposa,043,17540,2768,2713,270,2983,30
2022-06-26,Mendocino,045,87422,14418,14292,3767,18059,127
2022-06-26,Merced,047,269075,65937,65408,9816,75224,828
2022-06-26,Modoc,049,8938,782,777,275,1052,8
2022-06-26,Mono,051,14174,3086,3076,191,3267,7
2022-06-26,Monterey,053,433212,86049,85275,17432,102707,743
2022-06-26,Napa,055,140530,29381,29054,1288,30342,144
2022-06-26,Nevada,057,99092,17512,17339,1475,18814,129
2022-06-26,Orange,059,3164182,601497,595761,50544,646305,7090
2022-06-26,Placer,061,380077,69485,68785,8398,77183,628
2022-06-26,Plumas,063,18699,3288,3241,403,3644,13
2022-06-26,Riverside,065,2383286,630876,625794,31191,656985,6493
2022-06-26,Sacramento,067,1510023,314026,310837,31573,342410,3077
2022-06-26,San Benito,069,59416,14340,14192,714,14906,99
2022-06-26,San Bernardino,071,2135413,603096,598062,27101,625163,7803
2022-06-26,San Diego,073,3302833,830802,822848,60731,883579,5332
2022-06-26,San Francisco,075,870044,158144,155609,10654,166263,899
2022-06-26,San Joaquin,077,732212,179912,178447,12176,190623,2252
2022-06-26,San Luis Obispo,079,281455,57922,57472,5680,63152,485
2022-06-26,San Mateo,081,765935,149198,146955,9557,156512,723
2022-06-26,Santa Barbara,083,443738,94973,94017,5631,99648,699
2022-06-26,Santa Clara,085,1922200,379743,373961,16698,390659,2338
2022-06-26,Santa Cruz,087,273765,55646,54874,2821,57695,265
2022-06-26,Shasta,089,179085,32229,31921,6558,38479,570
2022-06-26,Sierra,091,2930,285,283,58,341,4
2022-06-26,Siskiyou,093,43540,4788,4744,3046,7790,81
2022-06-26,Solano,095,438530,93959,92248,6777,99025,455
2022-06-26,Sonoma,097,501317,97115,95981,4332,100313,493
2022-06-26,Stanislaus,099,539301,125512,124493,19095,143588,1672
2022-06-26,Sutter,101,95872,21852,21733,2382,24115,227
2022-06-26,Tehama,103,63373,12601,12510,2794,15304,205
2022-06-26,Trinity,105,12862,1250,1233,303,1536,20
2022-06-26,Tulare,107,460477,111886,111188,31619,142807,1496
2022-06-26,Tuolumne,109,53932,13843,13688,735,14423,189
2022-06-26,Ventura,111,848112,189190,187389,11889,199278,1514
2022-06-26,Yolo,113,214977,43519,41932,3870,45802,323
2022-06-26,Yuba,115,75493,17114,16994,1488,18482,124
2022-06-25,Alameda,001,1643700,305998,302071,17594,319665,1891
2022-06-25,Alpine,003,1148,129,129,1,130,0
2022-06-25,Amador,005,37829,9226,9135,771,9906,87
2022-06-25,Butte,007,227075,35723,35406,7639,43045,433
2022-06-25,Calaveras,009,45235,7804,7754,431,8185,124
2022-06-25,Colusa,011,21464,3553,3540,1157,4697,22
2022-06-25,Contra Costa,013,1133247,220501,218053,17003,235056,1335
2022-06-25,Del Norte,015,27424,6502,6398,327,6725,52
2022-06-25,El Dorado,017,186661,29648,29313,3743,33056,216
2022-06-25,Fresno,019,978130,247134,245118,26452,271570,2777
2022-06-25,Glenn,021,27897,5198,5178,1723,6901,48
2022-06-25,Humboldt,023,135768,19447,19234,3980,23214,149
2022-06-25,Imperial,025,180216,58606,58127,11984,70111,944
2022-06-25,Inyo,027,18085,4249,4228,670,4898,56
2022-06-25,Kern,029,883053,202102,200556,51351,251907,2344
2022-06-25,Kings,031,150075,54052,53783,3804,57587,448
2022-06-25,Lake,033,64148,11560,11471,1021,12492,140
2022-06-25,Lassen,035,31185,9315,9287,952,10239,64
2022-06-25,Los Angeles,037,10098052,2961305,2936815,145494,3082309,32036
2022-06-25,Madera,039,155013,39627,39319,6818,46137,372
2022-06-25,Marin,041,260295,40479,39979,4681,44660,297
2022-06-25,Mariposa,043,17540,2766,2713,270,2983,30
2022-06-25,Mendocino,045,87422,14406,14292,3763,18055,127
2022-06-25,Merced,047,269075,65863,65408,9813,75221,828
2022-06-25,Modoc,049,8938,782,777,275,1052,8
2022-06-25,Mono,051,14174,3082,3076,191,3267,7
2022-06-25,Monterey,053,433212,85948,85275,17404,102679,743
2022-06-25,Napa,055,140530,29353,29054,1285,30339,144
2022-06-25,Nevada,057,99092,17492,17339,1471,18810,129
2022-06-25,Orange,059,3164182,600815,595761,50397,646158,7090
2022-06-25,Placer,061,380077,69398,68785,8382,77167,628
2022-06-25,Plumas,063,18699,3284,3241,403,3644,13
2022-06-25,Riverside,065,2383286,630274,625794,31141,656935,6493
2022-06-25,Sacramento,067,1510023,313719,310837,31548,342385,3077
2022-06-25,San Benito,069,59416,14316,14192,712,14904,99
2022-06-25,San Bernardino,071,2135413,602537,598062,27075,625137,7803
2022-06-25,San Diego,073,3302833,829933,822848,60674,883522,5332
2022-06-25,San Francisco,075,870044,157849,155609,10631,166240,899
2022-06-25,San Joaquin,077,732212,179769,178447,12159,190606,2252
2022-06-25,San Luis Obispo,079,281455,57850,57472,5668,63140,485
2022-06-25,San Mateo,081,765935,148930,146955,9533,156488,723
2022-06-25,Santa Barbara,083,443738,94835,94017,5616,99633,699
2022-06-25,Santa Clara,085,1922200,378909,373961,16677,390638,2338
2022-06-25,Santa Cruz,087,273765,55580,54874,2817,57691,265
2022-06-25,Shasta,089,179085,32193,31921,6543,38464,570
2022-06-25,Sierra,091,2930,285,283,58,341,4
2022-06-25,Siskiyou,093,43540,4785,4744,3043,7787,81
2022-06-25,Solano,095,438530,93876,92248,6756,99004,455
2022-06-25,Sonoma,097,501317,97008,95981,4320,100301,493
2022-06-25,Stanislaus,099,539301,125382,124493,19076,143569,1672
2022-06-25,Sutter,101,95872,21829,21733,2381,24114,227
2022-06-25,Tehama,103,63373,12590,12510,2788,15298,205
2022-06-25,Trinity,105,12862,1250,1233,303,1536,20
2022-06-25,Tulare,107,460477,111814,111188,31560,142748,1496
2022-06-25,Tuolumne,109,53932,13826,13688,730,14418,189
2022-06-25,Ventura,111,848112,188990,187389,11858,199247,1514
2022-06-25,Yolo,113,214977,43454,41932,3864,45796,323
2022-06-25,Yuba,115,75493,17093,16994,1487,18481,124
2022-06-24,Alameda,001,1643700,305440,302071,17557,319628,1891
2022-06-24,Alpine,003,1148,129,129,1,130,0
2022-06-24,Amador,005,37829,9220,9135,768,9903,87
2022-06-24,Butte,007,227075,35695,35406,7624,43030,433
2022-06-24,Calaveras,009,45235,7800,7754,429,8183,124
2022-06-24,Colusa,011,21464,3552,3540,1154,4694,22
2022-06-24,Contra Costa,013,1133247,220173,218053,16978,235031,1335
2022-06-24,Del Norte,015,27424,6493,6398,325,6723,52
2022-06-24,El Dorado,017,186661,29606,29313,3739,33052,216
2022-06-24,Fresno,019,978130,246846,245118,26420,271538,2777
2022-06-24,Glenn,021,27897,5196,5178,1723,6901,48
2022-06-24,Humboldt,023,135768,19417,19234,3975,23209,149
2022-06-24,Imperial,025,180216,58541,58127,11949,70076,944
2022-06-24,Inyo,027,18085,4248,4228,666,4894,56
2022-06-24,Kern,029,883053,201935,200556,51290,251846,2344
2022-06-24,Kings,031,150075,54008,53783,3800,57583,448
2022-06-24,Lake,033,64148,11549,11471,1021,12492,140
2022-06-24,Lassen,035,31185,9312,9287,951,10238,64
2022-06-24,Los Angeles,037,10098052,2958178,2936815,145189,3082004,32036
2022-06-24,Madera,039,155013,39582,39319,6811,46130,372
2022-06-24,Marin,041,260295,40405,39979,4667,44646,297
2022-06-24,Mariposa,043,17540,2759,2713,270,2983,30
2022-06-24,Mendocino,045,87422,14399,14292,3760,18052,127
2022-06-24,Merced,047,269075,65828,65408,9803,75211,828
2022-06-24,Modoc,049,8938,782,777,275,1052,8
2022-06-24,Mono,051,14174,3080,3076,190,3266,7
2022-06-24,Monterey,053,433212,85873,85275,17378,102653,743
2022-06-24,Napa,055,140530,29328,29054,1283,30337,144
2022-06-24,Nevada,057,99092,17476,17339,1465,18804,129
2022-06-24,Orange,059,3164182,600131,595761,50251,646012,7090
2022-06-24,Placer,061,380077,69327,68785,8370,77155,628
2022-06-24,Plumas,063,18699,3279,3241,403,3644,13
2022-06-24,Riverside,065,2383286,629640,625794,31091,656885,6493
2022-06-24,Sacramento,067,1510023,313323,310837,31521,342358,3077
2022-06-24,San Benito,069,59416,14303,14192,710,14902,99
2022-06-24,San Bernardino,071,2135413,601968,598062,27047,625109,7803
2022-06-24,San Diego,073,3302833,828921,822848,60599,883447,5332
2022-06-24,San Francisco,075,870044,157543,155609,10604,166213,899
2022-06-24,San Joaquin,077,732212,179592,178447,12134,190581,2252
2022-06-24,San Luis Obispo,079,281455,57804,57472,5662,63134,485
2022-06-24,San Mateo,081,765935,148605,146955,9519,156474,723
2022-06-24,Santa Barbara,083,443738,94706,94017,5611,99628,699
2022-06-24,Santa Clara,085,1922200,378107,373961,16630,390591,2338
2022-06-24,Santa Cruz,087,273765,55479,54874,2805,57679,265
2022-06-24,Shasta,089,179085,32165,31921,6535,38456,570
2022-06-24,Sierra,091,2930,285,283,58,341,4
2022-06-24,Siskiyou,093,43540,4777,4744,3042,7786,81
2022-06-24,Solano,095,438530,93724,92248,6742,98990,455
2022-06-24,Sonoma,097,501317,96873,95981,4309,100290,493
2022-06-24,Stanislaus,099,539301,125256,124493,19051,143544,1672
2022-06-24,Sutter,101,95872,21814,21733,2380,24113,227
2022-06-24,Tehama,103,63373,12576,12510,2783,15293,205
2022-06-24,Trinity,105,12862,1247,1233,303,1536,20
2022-06-24,Tulare,107,460477,111717,111188,31493,142681,1496
2022-06-24,Tuolumne,109,53932,13807,13688,724,14412,189
2022-06-24,Ventura,111,848112,188766,187389,11825,199214,1514
2022-06-24,Yolo,113,214977,43363,41932,3856,45788,323
2022-06-24,Yuba,115,75493,17075,16994,1487,18481,124
2022-06-23,Alameda,001,1643700,304653,302071,17480,319551,1891
2022-06-23,Alpine,003,1148,129,129,1,130,0
2022-06-23,Amador,005,37829,9212,9135,766,9901,87
2022-06-23,Butte,007,227075,35638,35406,7605,43011,433
2022-06-23,Calaveras,009,45235,7789,7754,428,8182,124
2022-06-23,Colusa,011,21464,3546,3540,1152,4692,22
2022-06-23,Contra Costa,013,1133247,219694,218053,16872,234925,1335
2022-06-23,Del Norte,015,27424,6463,6398,323,6721,52
2022-06-23,El Dorado,017,186661,29548,29313,3725,33038,216
2022-06-23,Fresno,019,978130,246447,245118,26359,271477,2777
2022-06-23,Glenn,021,27897,5193,5178,1716,6894,48
2022-06-23,Humboldt,023,135768,19393,19234,3971,23205,149
2022-06-23,Imperial,025,180216,58470,58127,11891,70018,944
2022-06-23,Inyo,027,18085,4245,4228,662,4890,56
2022-06-23,Kern,029,883053,201658,200556,51138,251694,2344
2022-06-23,Kings,031,150075,53949,53783,3797,57580,448
2022-06-23,Lake,033,64148,11528,11471,1021,12492,140
2022-06-23,Lassen,035,31185,9302,9287,950,10237,64
2022-06-23,Los Angeles,037,10098052,2953640,2936815,144689,3081504,32036
2022-06-23,Madera,039,155013,39523,39319,6796,46115,372
2022-06-23,Marin,041,260295,40290,39979,4642,44621,297
2022-06-23,Mariposa,043,17540,2748,2713,269,2982,30
2022-06-23,Mendocino,045,87422,14370,14292,3754,18046,127
2022-06-23,Merced,047,269075,65752,65408,9788,75196,828
2022-06-23,Modoc,049,8938,781,777,275,1052,8
2022-06-23,Mono,051,14174,3078,3076,189,3265,7
2022-06-23,Monterey,053,433212,85729,85275,17317,102592,743
2022-06-23,Napa,055,140530,29273,29054,1281,30335,144
2022-06-23,Nevada,057,99092,17441,17339,1465,18804,129
2022-06-23,Orange,059,3164182,599113,595761,50053,645814,7090
2022-06-23,Placer,061,380077,69193,68785,8353,77138,628
2022-06-23,Plumas,063,18699,3274,3241,401,3642,13
2022-06-23,Riverside,065,2383286,628724,625794,31036,656830,6493
2022-06-23,Sacramento,067,1510023,312720,310837,31475,342312,3077
2022-06-23,San Benito,069,59416,14272,14192,708,14900,99
2022-06-23,San Bernardino,071,2135413,601187,598062,27011,625073,7803
2022-06-23,San Diego,073,3302833,827469,822848,60402,883250,5332
2022-06-23,San Francisco,075,870044,157084,155609,10567,166176,899
2022-06-23,San Joaquin,077,732212,179319,178447,12105,190552,2252
2022-06-23,San Luis Obispo,079,281455,57718,57472,5627,63099,485
2022-06-23,San Mateo,081,765935,148258,146955,9483,156438,723
2022-06-23,Santa Barbara,083,443738,94543,94017,5580,99597,699
2022-06-23,Santa Clara,085,1922200,377145,373961,16579,390540,2338
2022-06-23,Santa Cruz,087,273765,55368,54874,2794,57668,265
2022-06-23,Shasta,089,179085,32125,31921,6522,38443,570
2022-06-23,Sierra,091,2930,284,283,58,341,4
2022-06-23,Siskiyou,093,43540,4771,4744,3034,7778,81
2022-06-23,Solano,095,438530,93486,92248,6695,98943,455
2022-06-23,Sonoma,097,501317,96677,95981,4285,100266,493
2022-06-23,Stanislaus,099,539301,125076,124493,19020,143513,1672
2022-06-23,Sutter,101,95872,21780,21733,2380,24113,227
2022-06-23,Tehama,103,63373,12568,12510,2780,15290,205
2022-06-23,Trinity,105,12862,1245,1233,303,1536,20
2022-06-23,Tulare,107,460477,111589,111188,31410,142598,1496
2022-06-23,Tuolumne,109,53932,13782,13688,708,14396,189
2022-06-23,Ventura,111,848112,188474,187389,11778,199167,1514
2022-06-23,Yolo,113,214977,43260,41932,3844,45776,323
2022-06-23,Yuba,115,75493,17054,16994,1479,18473,124
2022-06-22,Alameda,001,1643700,303834,299567,17394,316961,1888
2022-06-22,Alpine,003,1148,129,129,1,130,0
2022-06-22,Amador,005,37829,9206,9049,765,9814,87
2022-06-22,Butte,007,227075,35573,35203,7586,42789,433
2022-06-22,Calaveras,009,45235,7778,7716,427,8143,122
2022-06-22,Colusa,011,21464,3543,3529,1152,4681,21
2022-06-22,Contra Costa,013,1133247,219189,216355,16814,233169,1328
2022-06-22,Del Norte,015,27424,6445,6367,320,6687,52
2022-06-22,El Dorado,017,186661,29486,29139,3712,32851,215
2022-06-22,Fresno,019,978130,246030,244129,26303,270432,2772
2022-06-22,Glenn,021,27897,5191,5161,1711,6872,48
2022-06-22,Humboldt,023,135768,19342,19111,3951,23062,148
2022-06-22,Imperial,025,180216,58371,57866,11859,69725,944
2022-06-22,Inyo,027,18085,4240,4222,660,4882,56
2022-06-22,Kern,029,883053,201388,199721,51000,250721,2341
2022-06-22,Kings,031,150075,53886,53568,3794,57362,448
2022-06-22,Lake,033,64148,11511,11426,1014,12440,140
2022-06-22,Lassen,035,31185,9294,9259,948,10207,64
2022-06-22,Los Angeles,037,10098052,2948847,2925667,144237,3069904,32015
2022-06-22,Madera,039,155013,39467,39139,6776,45915,372
2022-06-22,Marin,041,260295,40190,39687,4634,44321,297
2022-06-22,Mariposa,043,17540,2743,2695,265,2960,30
2022-06-22,Mendocino,045,87422,14354,14201,3739,17940,127
2022-06-22,Merced,047,269075,65657,65120,9763,74883,827
2022-06-22,Modoc,049,8938,780,773,271,1044,8
2022-06-22,Mono,051,14174,3076,3073,187,3260,7
2022-06-22,Monterey,053,433212,85604,84752,17273,102025,742
2022-06-22,Napa,055,140530,29203,28894,1277,30171,144
2022-06-22,Nevada,057,99092,17420,17280,1457,18737,129
2022-06-22,Orange,059,3164182,597919,592215,49862,642077,7084
2022-06-22,Placer,061,380077,69081,68447,8343,76790,628
2022-06-22,Plumas,063,18699,3264,3220,401,3621,13
2022-06-22,Riverside,065,2383286,627878,623584,30963,654547,6491
2022-06-22,Sacramento,067,1510023,312091,309105,31430,340535,3071
2022-06-22,San Benito,069,59416,14248,14128,703,14831,99
2022-06-22,San Bernardino,071,2135413,600398,595517,26976,622493,7774
2022-06-22,San Diego,073,3302833,825880,815124,60228,875352,5318
2022-06-22,San Francisco,075,870044,156598,154213,10533,164746,897
2022-06-22,San Joaquin,077,732212,179066,177637,12081,189718,2251
2022-06-22,San Luis Obispo,079,281455,57630,57177,5583,62760,485
2022-06-22,San Mateo,081,765935,147855,145781,9460,155241,723
2022-06-22,Santa Barbara,083,443738,94395,93576,5563,99139,700
2022-06-22,Santa Clara,085,1922200,376060,370678,16462,387140,2340
2022-06-22,Santa Cruz,087,273765,55250,54525,2779,57304,265
2022-06-22,Shasta,089,179085,32082,31786,6506,38292,570
2022-06-22,Sierra,091,2930,284,283,58,341,4
2022-06-22,Siskiyou,093,43540,4764,4711,3030,7741,81
2022-06-22,Solano,095,438530,93253,91528,6612,98140,454
2022-06-22,Sonoma,097,501317,96475,95363,4263,99626,493
2022-06-22,Stanislaus,099,539301,124883,124023,18953,142976,1670
2022-06-22,Sutter,101,95872,21749,21649,2378,24027,227
2022-06-22,Tehama,103,63373,12558,12465,2777,15242,205
2022-06-22,Trinity,105,12862,1243,1223,303,1526,20
2022-06-22,Tulare,107,460477,111452,110768,31314,142082,1496
2022-06-22,Tuolumne,109,53932,13764,13596,700,14296,189
2022-06-22,Ventura,111,848112,188177,186601,11723,198324,1514
2022-06-22,Yolo,113,214977,43138,41689,3830,45519,323
2022-06-22,Yuba,115,75493,17035,16912,1473,18385,124
2022-06-21,Alameda,001,1643700,303060,299567,17357,316924,1888
2022-06-21,Alpine,003,1148,129,129,1,130,0
2022-06-21,Amador,005,37829,9200,9049,762,9811,87
2022-06-21,Butte,007,227075,35502,35203,7574,42777,433
2022-06-21,Calaveras,009,45235,7769,7716,426,8142,122
2022-06-21,Colusa,011,21464,3540,3529,1149,4678,21
2022-06-21,Contra Costa,013,1133247,218646,216355,16758,233113,1328
2022-06-21,Del Norte,015,27424,6416,6367,317,6684,52
2022-06-21,El Dorado,017,186661,29413,29139,3708,32847,215
2022-06-21,Fresno,019,978130,245598,244129,26242,270371,2772
2022-06-21,Glenn,021,27897,5184,5161,1709,6870,48
2022-06-21,Humboldt,023,135768,19291,19111,3935,23046,148
2022-06-21,Imperial,025,180216,58282,57866,11816,69682,944
2022-06-21,Inyo,027,18085,4235,4222,652,4874,56
2022-06-21,Kern,029,883053,201066,199721,50809,250530,2341
2022-06-21,Kings,031,150075,53809,53568,3789,57357,448
2022-06-21,Lake,033,64148,11488,11426,1011,12437,140
2022-06-21,Lassen,035,31185,9285,9259,946,10205,64
2022-06-21,Los Angeles,037,10098052,2944279,2925667,143754,3069421,32015
2022-06-21,Madera,039,155013,39380,39139,6765,45904,372
2022-06-21,Marin,041,260295,40099,39687,4621,44308,297
2022-06-21,Mariposa,043,17540,2737,2695,264,2959,30
2022-06-21,Mendocino,045,87422,14325,14201,3729,17930,127
2022-06-21,Merced,047,269075,65556,65120,9729,74849,827
2022-06-21,Modoc,049,8938,777,773,270,1043,8
2022-06-21,Mono,051,14174,3075,3073,184,3257,7
2022-06-21,Monterey,053,433212,85451,84752,17226,101978,742
2022-06-21,Napa,055,140530,29150,28894,1276,30170,144
2022-06-21,Nevada,057,99092,17395,17280,1453,18733,129
2022-06-21,Orange,059,3164182,596726,592215,49711,641926,7084
2022-06-21,Placer,061,380077,68955,68447,8331,76778,628
2022-06-21,Plumas,063,18699,3255,3220,400,3620,13
2022-06-21,Riverside,065,2383286,626921,623584,30893,654477,6491
2022-06-21,Sacramento,067,1510023,311389,309105,31372,340477,3071
2022-06-21,San Benito,069,59416,14212,14128,698,14826,99
2022-06-21,San Bernardino,071,2135413,599574,595517,26926,622443,7774
2022-06-21,San Diego,073,3302833,824216,815124,60034,875158,5318
2022-06-21,San Francisco,075,870044,156109,154213,10497,164710,897
2022-06-21,San Joaquin,077,732212,178752,177637,12050,189687,2251
2022-06-21,San Luis Obispo,079,281455,57522,57177,5531,62708,485
2022-06-21,San Mateo,081,765935,147372,145781,9441,155222,723
2022-06-21,Santa Barbara,083,443738,94228,93576,5548,99124,700
2022-06-21,Santa Clara,085,1922200,374912,370678,16412,387090,2340
2022-06-21,Santa Cruz,087,273765,55122,54525,2769,57294,265
2022-06-21,Shasta,089,179085,32035,31786,6488,38274,570
2022-06-21,Sierra,091,2930,284,283,58,341,4
2022-06-21,Siskiyou,093,43540,4756,4711,3022,7733,81
2022-06-21,Solano,095,438530,92997,91528,6591,98119,454
2022-06-21,Sonoma,097,501317,96245,95363,4242,99605,493
2022-06-21,Stanislaus,099,539301,124690,124023,18925,142948,1670
2022-06-21,Sutter,101,95872,21726,21649,2375,24024,227
2022-06-21,Tehama,103,63373,12545,12465,2776,15241,205
2022-06-21,Trinity,105,12862,1237,1223,303,1526,20
2022-06-21,Tulare,107,460477,111309,110768,31250,142018,1496
2022-06-21,Tuolumne,109,53932,13741,13596,692,14288,189
2022-06-21,Ventura,111,848112,187859,186601,11658,198259,1514
2022-06-21,Yolo,113,214977,43008,41689,3817,45506,323
2022-06-21,Yuba,115,75493,17005,16912,1472,18384,124
2022-06-20,Alameda,001,1643700,302174,299567,17300,316867,1888
2022-06-20,Alpine,003,1148,129,129,1,130,0
2022-06-20,Amador,005,37829,9189,9049,758,9807,87
2022-06-20,Butte,007,227075,35432,35203,7555,42758,433
2022-06-20,Calaveras,009,45235,7762,7716,426,8142,122
2022-06-20,Colusa,011,21464,3539,3529,1148,4677,21
2022-06-20,Contra Costa,013,1133247,218061,216355,16683,233038,1328
2022-06-20,Del Norte,015,27424,6403,6367,311,6678,52
2022-06-20,El Dorado,017,186661,29342,29139,3691,32830,215
2022-06-20,Fresno,019,978130,245113,244129,26171,270300,2772
2022-06-20,Glenn,021,27897,5180,5161,1704,6865,48
2022-06-20,Humboldt,023,135768,19247,19111,3916,23027,148
2022-06-20,Imperial,025,180216,58151,57866,11767,69633,944
2022-06-20,Inyo,027,18085,4231,4222,647,4869,56
2022-06-20,Kern,029,883053,200775,199721,50662,250383,2341
2022-06-20,Kings,031,150075,53729,53568,3785,57353,448
2022-06-20,Lake,033,64148,11466,11426,1008,12434,140
2022-06-20,Lassen,035,31185,9280,9259,945,10204,64
2022-06-20,Los Angeles,037,10098052,2939085,2925667,143307,3068974,32015
2022-06-20,Madera,039,155013,39318,39139,6746,45885,372
2022-06-20,Marin,041,260295,39995,39687,4598,44285,297
2022-06-20,Mariposa,043,17540,2724,2695,264,2959,30
2022-06-20,Mendocino,045,87422,14296,14201,3724,17925,127
2022-06-20,Merced,047,269075,65464,65120,9703,74823,827
2022-06-20,Modoc,049,8938,776,773,269,1042,8
2022-06-20,Mono,051,14174,3074,3073,181,3254,7
2022-06-20,Monterey,053,433212,85300,84752,17156,101908,742
2022-06-20,Napa,055,140530,29077,28894,1273,30167,144
2022-06-20,Nevada,057,99092,17370,17280,1444,18724,129
2022-06-20,Orange,059,3164182,595464,592215,49542,641757,7084
2022-06-20,Placer,061,380077,68842,68447,8320,76767,628
2022-06-20,Plumas,063,18699,3249,3220,400,3620,13
2022-06-20,Riverside,065,2383286,625982,623584,30816,654400,6491
2022-06-20,Sacramento,067,1510023,310687,309105,31300,340405,3071
2022-06-20,San Benito,069,59416,14166,14128,691,14819,99
2022-06-20,San Bernardino,071,2135413,598657,595517,26885,622402,7774
2022-06-20,San Diego,073,3302833,822233,815124,59791,874915,5318
2022-06-20,San Francisco,075,870044,155498,154213,10454,164667,897
2022-06-20,San Joaquin,077,732212,178428,177637,12003,189640,2251
2022-06-20,San Luis Obispo,079,281455,57422,57177,5479,62656,485
2022-06-20,San Mateo,081,765935,146863,145781,9416,155197,723
2022-06-20,Santa Barbara,083,443738,94042,93576,5515,99091,700
2022-06-20,Santa Clara,085,1922200,373704,370678,16354,387032,2340
2022-06-20,Santa Cruz,087,273765,54948,54525,2762,57287,265
2022-06-20,Shasta,089,179085,31977,31786,6473,38259,570
2022-06-20,Sierra,091,2930,284,283,57,340,4
2022-06-20,Siskiyou,093,43540,4743,4711,3007,7718,81
2022-06-20,Solano,095,438530,92676,91528,6571,98099,454
2022-06-20,Sonoma,097,501317,96011,95363,4228,99591,493
2022-06-20,Stanislaus,099,539301,124506,124023,18898,142921,1670
2022-06-20,Sutter,101,95872,21694,21649,2357,24006,227
2022-06-20,Tehama,103,63373,12530,12465,2773,15238,205
2022-06-20,Trinity,105,12862,1232,1223,303,1526,20
2022-06-20,Tulare,107,460477,111167,110768,31167,141935,1496
2022-06-20,Tuolumne,109,53932,13704,13596,692,14288,189
2022-06-20,Ventura,111,848112,187527,186601,11616,198217,1514
2022-06-20,Yolo,113,214977,42850,41689,3797,45486,323
2022-06-20,Yuba,115,75493,16980,16912,1466,18378,124
2022-06-19,Alameda,001,1643700,301252,296062,17269,313331,1883
2022-06-19,Alpine,003,1148,129,129,1,130,0
2022-06-19,Amador,005,37829,9140,8985,745,9730,87
2022-06-19,Butte,007,227075,35371,34920,7530,42450,432
2022-06-19,Calaveras,009,45235,7744,7664,425,8089,122
2022-06-19,Colusa,011,21464,3534,3519,1142,4661,21
2022-06-19,Contra Costa,013,1133247,217400,213994,16605,230599,1323
2022-06-19,Del Norte,015,27424,6386,6307,307,6614,52
2022-06-19,El Dorado,017,186661,29263,28904,3677,32581,215
2022-06-19,Fresno,019,978130,244667,242214,26111,268325,2768
2022-06-19,Glenn,021,27897,5171,5131,1701,6832,48
2022-06-19,Humboldt,023,135768,19203,18885,3889,22774,148
2022-06-19,Imperial,025,180216,58036,57450,11719,69169,944
2022-06-19,Inyo,027,18085,4230,4209,646,4855,56
2022-06-19,Kern,029,883053,200412,198567,50470,249037,2340
2022-06-19,Kings,031,150075,53634,53242,3782,57024,448
2022-06-19,Lake,033,64148,11453,11318,1006,12324,140
2022-06-19,Lassen,035,31185,9267,9225,943,10168,64
2022-06-19,Los Angeles,037,10098052,2934541,2909197,142789,3051986,31999
2022-06-19,Madera,039,155013,39223,38859,6721,45580,372
2022-06-19,Marin,041,260295,39870,39214,4587,43801,294
2022-06-19,Mariposa,043,17540,2717,2662,263,2925,30
2022-06-19,Mendocino,045,87422,14269,14090,3710,17800,127
2022-06-19,Merced,047,269075,65367,64734,9671,74405,827
2022-06-19,Modoc,049,8938,773,771,268,1039,8
2022-06-19,Mono,051,14174,3073,3066,180,3246,6
2022-06-19,Monterey,053,433212,85153,84032,17102,101134,744
2022-06-19,Napa,055,140530,29017,28619,1268,29887,144
2022-06-19,Nevada,057,99092,17342,17134,1434,18568,129
2022-06-19,Orange,059,3164182,594212,587176,49341,636517,7074
2022-06-19,Placer,061,380077,68725,67961,8300,76261,628
2022-06-19,Plumas,063,18699,3241,3201,399,3600,13
2022-06-19,Riverside,065,2383286,625111,619760,30756,650516,6488
2022-06-19,Sacramento,067,1510023,309958,306215,31238,337453,3072
2022-06-19,San Benito,069,59416,14147,13985,689,14674,99
2022-06-19,San Bernardino,071,2135413,597844,591926,26842,618768,7765
2022-06-19,San Diego,073,3302833,820710,815124,59678,874802,5318
2022-06-19,San Francisco,075,870044,154980,151898,10410,162308,897
2022-06-19,San Joaquin,077,732212,178111,176323,11959,188282,2251
2022-06-19,San Luis Obispo,079,281455,57289,56767,5413,62180,485
2022-06-19,San Mateo,081,765935,146415,143879,9382,153261,723
2022-06-19,Santa Barbara,083,443738,93879,92906,5494,98400,699
2022-06-19,Santa Clara,085,1922200,372537,365638,16293,381931,2328
2022-06-19,Santa Cruz,087,273765,54787,53866,2745,56611,264
2022-06-19,Shasta,089,179085,31918,31647,6457,38104,568
2022-06-19,Sierra,091,2930,284,281,57,338,4
2022-06-19,Siskiyou,093,43540,4731,4672,3001,7673,81
2022-06-19,Solano,095,438530,92423,90548,6556,97104,454
2022-06-19,Sonoma,097,501317,95769,94318,4207,98525,493
2022-06-19,Stanislaus,099,539301,124321,123264,18852,142116,1668
2022-06-19,Sutter,101,95872,21659,21501,2349,23850,227
2022-06-19,Tehama,103,63373,12521,12410,2767,15177,205
2022-06-19,Trinity,105,12862,1229,1220,303,1523,20
2022-06-19,Tulare,107,460477,110981,110041,31089,141130,1496
2022-06-19,Tuolumne,109,53932,13677,13487,691,14178,189
2022-06-19,Ventura,111,848112,187182,185219,11564,196783,1513
2022-06-19,Yolo,113,214977,42763,41135,3783,44918,323
2022-06-19,Yuba,115,75493,16949,16786,1463,18249,124
2022-06-18,Alameda,001,1643700,300794,296062,17251,313313,1883
2022-06-18,Alpine,003,1148,129,129,1,130,0
2022-06-18,Amador,005,37829,9134,8985,741,9726,87
2022-06-18,Butte,007,227075,35320,34920,7519,42439,432
2022-06-18,Calaveras,009,45235,7732,7664,425,8089,122
2022-06-18,Colusa,011,21464,3531,3519,1142,4661,21
2022-06-18,Contra Costa,013,1133247,217093,213994,16574,230568,1323
2022-06-18,Del Norte,015,27424,6381,6307,306,6613,52
2022-06-18,El Dorado,017,186661,29234,28904,3674,32578,215
2022-06-18,Fresno,019,978130,244471,242214,26092,268306,2768
2022-06-18,Glenn,021,27897,5168,5131,1699,6830,48
2022-06-18,Humboldt,023,135768,19174,18885,3881,22766,148
2022-06-18,Imperial,025,180216,57967,57450,11705,69155,944
2022-06-18,Inyo,027,18085,4229,4209,645,4854,56
2022-06-18,Kern,029,883053,200290,198567,50370,248937,2340
2022-06-18,Kings,031,150075,53598,53242,3781,57023,448
2022-06-18,Lake,033,64148,11442,11318,1004,12322,140
2022-06-18,Lassen,035,31185,9263,9225,943,10168,64
2022-06-18,Los Angeles,037,10098052,2932284,2909197,142508,3051705,31999
2022-06-18,Madera,039,155013,39198,38859,6715,45574,372
2022-06-18,Marin,041,260295,39805,39214,4577,43791,294
2022-06-18,Mariposa,043,17540,2712,2662,263,2925,30
2022-06-18,Mendocino,045,87422,14248,14090,3705,17795,127
2022-06-18,Merced,047,269075,65305,64734,9660,74394,827
2022-06-18,Modoc,049,8938,773,771,268,1039,8
2022-06-18,Mono,051,14174,3072,3066,180,3246,6
2022-06-18,Monterey,053,433212,85064,84032,17070,101102,744
2022-06-18,Napa,055,140530,28992,28619,1266,29885,144
2022-06-18,Nevada,057,99092,17330,17134,1432,18566,129
2022-06-18,Orange,059,3164182,593596,587176,49226,636402,7074
2022-06-18,Placer,061,380077,68662,67961,8286,76247,628
2022-06-18,Plumas,063,18699,3233,3201,399,3600,13
2022-06-18,Riverside,065,2383286,624576,619760,30734,650494,6488
2022-06-18,Sacramento,067,1510023,309645,306215,31213,337428,3072
2022-06-18,San Benito,069,59416,14132,13985,681,14666,99
2022-06-18,San Bernardino,071,2135413,597415,591926,26820,618746,7765
2022-06-18,San Diego,073,3302833,819996,815124,59636,874760,5318
2022-06-18,San Francisco,075,870044,154651,151898,10388,162286,897
2022-06-18,San Joaquin,077,732212,177949,176323,11947,188270,2251
2022-06-18,San Luis Obispo,079,281455,57244,56767,5405,62172,485
2022-06-18,San Mateo,081,765935,146149,143879,9355,153234,723
2022-06-18,Santa Barbara,083,443738,93769,92906,5482,98388,699
2022-06-18,Santa Clara,085,1922200,371787,365638,16247,381885,2328
2022-06-18,Santa Cruz,087,273765,54711,53866,2729,56595,264
2022-06-18,Shasta,089,179085,31897,31647,6454,38101,568
2022-06-18,Sierra,091,2930,284,281,57,338,4
2022-06-18,Siskiyou,093,43540,4723,4672,2997,7669,81
2022-06-18,Solano,095,438530,92341,90548,6543,97091,454
2022-06-18,Sonoma,097,501317,95635,94318,4188,98506,493
2022-06-18,Stanislaus,099,539301,124215,123264,18834,142098,1668
2022-06-18,Sutter,101,95872,21638,21501,2346,23847,227
2022-06-18,Tehama,103,63373,12513,12410,2762,15172,205
2022-06-18,Trinity,105,12862,1228,1220,303,1523,20
2022-06-18,Tulare,107,460477,110899,110041,31044,141085,1496
2022-06-18,Tuolumne,109,53932,13655,13487,689,14176,189
2022-06-18,Ventura,111,848112,187008,185219,11539,196758,1513
2022-06-18,Yolo,113,214977,42694,41135,3775,44910,323
2022-06-18,Yuba,115,75493,16936,16786,1463,18249,124
2022-06-17,Alameda,001,1643700,300310,296062,17225,313287,1883
2022-06-17,Alpine,003,1148,129,129,1,130,0
2022-06-17,Amador,005,37829,9125,8985,740,9725,87
2022-06-17,Butte,007,227075,35287,34920,7506,42426,432
2022-06-17,Calaveras,009,45235,7724,7664,425,8089,122
2022-06-17,Colusa,011,21464,3530,3519,1138,4657,21
2022-06-17,Contra Costa,013,1133247,216803,213994,16551,230545,1323
2022-06-17,Del Norte,015,27424,6368,6307,305,6612,52
2022-06-17,El Dorado,017,186661,29203,28904,3670,32574,215
2022-06-17,Fresno,019,978130,244234,242214,26056,268270,2768
2022-06-17,Glenn,021,27897,5167,5131,1694,6825,48
2022-06-17,Humboldt,023,135768,19147,18885,3877,22762,148
2022-06-17,Imperial,025,180216,57916,57450,11692,69142,944
2022-06-17,Inyo,027,18085,4225,4209,638,4847,56
2022-06-17,Kern,029,883053,200141,198567,50310,248877,2340
2022-06-17,Kings,031,150075,53571,53242,3780,57022,448
2022-06-17,Lake,033,64148,11434,11318,1003,12321,140
2022-06-17,Lassen,035,31185,9262,9225,942,10167,64
2022-06-17,Los Angeles,037,10098052,2929551,2909197,142224,3051421,31999
2022-06-17,Madera,039,155013,39173,38859,6708,45567,372
2022-06-17,Marin,041,260295,39712,39214,4564,43778,294
2022-06-17,Mariposa,043,17540,2708,2662,263,2925,30
2022-06-17,Mendocino,045,87422,14233,14090,3702,17792,127
2022-06-17,Merced,047,269075,65249,64734,9655,74389,827
2022-06-17,Modoc,049,8938,773,771,268,1039,8
2022-06-17,Mono,051,14174,3072,3066,180,3246,6
2022-06-17,Monterey,053,433212,84974,84032,17033,101065,744
2022-06-17,Napa,055,140530,28954,28619,1265,29884,144
2022-06-17,Nevada,057,99092,17311,17134,1427,18561,129
2022-06-17,Orange,059,3164182,592914,587176,49087,636263,7074
2022-06-17,Placer,061,380077,68607,67961,8275,76236,628
2022-06-17,Plumas,063,18699,3232,3201,398,3599,13
2022-06-17,Riverside,065,2383286,624022,619760,30691,650451,6488
2022-06-17,Sacramento,067,1510023,309254,306215,31191,337406,3072
2022-06-17,San Benito,069,59416,14120,13985,681,14666,99
2022-06-17,San Bernardino,071,2135413,596978,591926,26786,618712,7765
2022-06-17,San Diego,073,3302833,819035,815124,59534,874658,5318
2022-06-17,San Francisco,075,870044,154333,151898,10353,162251,897
2022-06-17,San Joaquin,077,732212,177801,176323,11931,188254,2251
2022-06-17,San Luis Obispo,079,281455,57207,56767,5399,62166,485
2022-06-17,San Mateo,081,765935,145849,143879,9337,153216,723
2022-06-17,Santa Barbara,083,443738,93663,92906,5469,98375,699
2022-06-17,Santa Clara,085,1922200,370967,365638,16214,381852,2328
2022-06-17,Santa Cruz,087,273765,54646,53866,2723,56589,264
2022-06-17,Shasta,089,179085,31872,31647,6446,38093,568
2022-06-17,Sierra,091,2930,284,281,57,338,4
2022-06-17,Siskiyou,093,43540,4716,4672,2997,7669,81
2022-06-17,Solano,095,438530,92195,90548,6530,97078,454
2022-06-17,Sonoma,097,501317,95472,94318,4178,98496,493
2022-06-17,Stanislaus,099,539301,124118,123264,18823,142087,1668
2022-06-17,Sutter,101,95872,21616,21501,2339,23840,227
2022-06-17,Tehama,103,63373,12498,12410,2758,15168,205
2022-06-17,Trinity,105,12862,1228,1220,303,1523,20
2022-06-17,Tulare,107,460477,110817,110041,30996,141037,1496
2022-06-17,Tuolumne,109,53932,13641,13487,688,14175,189
2022-06-17,Ventura,111,848112,186830,185219,11513,196732,1513
2022-06-17,Yolo,113,214977,42613,41135,3762,44897,323
2022-06-17,Yuba,115,75493,16928,16786,1459,18245,124
2022-06-16,Alameda,001,1643700,299510,296062,17159,313221,1883
2022-06-16,Alpine,003,1148,129,129,1,130,0
2022-06-16,Amador,005,37829,9118,8985,735,9720,87
2022-06-16,Butte,007,227075,35212,34920,7490,42410,432
2022-06-16,Calaveras,009,45235,7713,7664,423,8087,122
2022-06-16,Colusa,011,21464,3528,3519,1137,4656,21
2022-06-16,Contra Costa,013,1133247,216348,213994,16499,230493,1323
2022-06-16,Del Norte,015,27424,6355,6307,302,6609,52
2022-06-16,El Dorado,017,186661,29151,28904,3657,32561,215
2022-06-16,Fresno,019,978130,243864,242214,25993,268207,2768
2022-06-16,Glenn,021,27897,5159,5131,1690,6821,48
2022-06-16,Humboldt,023,135768,19117,18885,3862,22747,148
2022-06-16,Imperial,025,180216,57820,57450,11662,69112,944
2022-06-16,Inyo,027,18085,4224,4209,634,4843,56
2022-06-16,Kern,029,883053,199927,198567,50182,248749,2340
2022-06-16,Kings,031,150075,53505,53242,3773,57015,448
2022-06-16,Lake,033,64148,11418,11318,1003,12321,140
2022-06-16,Lassen,035,31185,9255,9225,941,10166,64
2022-06-16,Los Angeles,037,10098052,2925680,2909197,141872,3051069,31999
2022-06-16,Madera,039,155013,39143,38859,6698,45557,372
2022-06-16,Marin,041,260295,39615,39214,4550,43764,294
2022-06-16,Mariposa,043,17540,2700,2662,262,2924,30
2022-06-16,Mendocino,045,87422,14205,14090,3693,17783,127
2022-06-16,Merced,047,269075,65175,64734,9637,74371,827
2022-06-16,Modoc,049,8938,773,771,268,1039,8
2022-06-16,Mono,051,14174,3071,3066,179,3245,6
2022-06-16,Monterey,053,433212,84825,84032,16976,101008,744
2022-06-16,Napa,055,140530,28910,28619,1262,29881,144
2022-06-16,Nevada,057,99092,17289,17134,1422,18556,129
2022-06-16,Orange,059,3164182,591884,587176,48943,636119,7074
2022-06-16,Placer,061,380077,68522,67961,8254,76215,628
2022-06-16,Plumas,063,18699,3226,3201,397,3598,13
2022-06-16,Riverside,065,2383286,623279,619760,30643,650403,6488
2022-06-16,Sacramento,067,1510023,308670,306215,31156,337371,3072
2022-06-16,San Benito,069,59416,14095,13985,678,14663,99
2022-06-16,San Bernardino,071,2135413,596327,591926,26745,618671,7765
2022-06-16,San Diego,073,3302833,817519,815124,59375,874499,5318
2022-06-16,San Francisco,075,870044,153881,151898,10311,162209,897
2022-06-16,San Joaquin,077,732212,177551,176323,11912,188235,2251
2022-06-16,San Luis Obispo,079,281455,57129,56767,5379,62146,485
2022-06-16,San Mateo,081,765935,145489,143879,9322,153201,723
2022-06-16,Santa Barbara,083,443738,93515,92906,5452,98358,699
2022-06-16,Santa Clara,085,1922200,370024,365638,16167,381805,2328
2022-06-16,Santa Cruz,087,273765,54514,53866,2710,56576,264
2022-06-16,Shasta,089,179085,31841,31647,6435,38082,568
2022-06-16,Sierra,091,2930,283,281,57,338,4
2022-06-16,Siskiyou,093,43540,4707,4672,2988,7660,81
2022-06-16,Solano,095,438530,92008,90548,6516,97064,454
2022-06-16,Sonoma,097,501317,95287,94318,4163,98481,493
2022-06-16,Stanislaus,099,539301,123959,123264,18803,142067,1668
2022-06-16,Sutter,101,95872,21591,21501,2337,23838,227
2022-06-16,Tehama,103,63373,12479,12410,2755,15165,205
2022-06-16,Trinity,105,12862,1226,1220,300,1520,20
2022-06-16,Tulare,107,460477,110684,110041,30943,140984,1496
2022-06-16,Tuolumne,109,53932,13617,13487,684,14171,189
2022-06-16,Ventura,111,848112,186559,185219,11464,196683,1513
2022-06-16,Yolo,113,214977,42522,41135,3747,44882,323
2022-06-16,Yuba,115,75493,16905,16786,1455,18241,124
2022-06-15,Alameda,001,1643700,298719,295002,17096,312098,1880
2022-06-15,Alpine,003,1148,129,129,1,130,0
2022-06-15,Amador,005,37829,9110,8972,735,9707,87
2022-06-15,Butte,007,227075,35146,34841,7468,42309,430
2022-06-15,Calaveras,009,45235,7710,7648,420,8068,122
2022-06-15,Colusa,011,21464,3524,3515,1135,4650,21
2022-06-15,Contra Costa,013,1133247,215906,213219,16457,229676,1321
2022-06-15,Del Norte,015,27424,6345,6298,300,6598,52
2022-06-15,El Dorado,017,186661,29098,28829,3643,32472,215
2022-06-15,Fresno,019,978130,243500,241768,25949,267717,2767
2022-06-15,Glenn,021,27897,5154,5128,1682,6810,48
2022-06-15,Humboldt,023,135768,19079,18836,3836,22672,148
2022-06-15,Imperial,025,180216,57738,57373,11634,69007,941
2022-06-15,Inyo,027,18085,4222,4205,633,4838,56
2022-06-15,Kern,029,883053,199667,198216,50065,248281,2338
2022-06-15,Kings,031,150075,53451,53170,3770,56940,448
2022-06-15,Lake,033,64148,11400,11303,998,12301,140
2022-06-15,Lassen,035,31185,9251,9209,940,10149,64
2022-06-15,Los Angeles,037,10098052,2921504,2897298,141522,3038820,31971
2022-06-15,Madera,039,155013,39098,38776,6681,45457,372
2022-06-15,Marin,041,260295,39525,39027,4543,43570,294
2022-06-15,Mariposa,043,17540,2696,2651,260,2911,30
2022-06-15,Mendocino,045,87422,14179,14052,3689,17741,127
2022-06-15,Merced,047,269075,65095,64595,9622,74217,825
2022-06-15,Modoc,049,8938,772,772,268,1040,8
2022-06-15,Mono,051,14174,3071,3060,179,3239,6
2022-06-15,Monterey,053,433212,84688,83837,16928,100765,741
2022-06-15,Napa,055,140530,28850,28518,1255,29773,144
2022-06-15,Nevada,057,99092,17264,17107,1418,18525,127
2022-06-15,Orange,059,3164182,590836,585496,48756,634252,7067
2022-06-15,Placer,061,380077,68402,67805,8242,76047,628
2022-06-15,Plumas,063,18699,3221,3185,395,3580,13
2022-06-15,Riverside,065,2383286,622560,618584,30587,649171,6482
2022-06-15,Sacramento,067,1510023,308079,305361,31103,336464,3059
2022-06-15,San Benito,069,59416,14058,13953,670,14623,99
2022-06-15,San Bernardino,071,2135413,595682,590328,26700,617028,7735
2022-06-15,San Diego,073,3302833,815971,811093,59208,870301,5316
2022-06-15,San Francisco,075,870044,153445,151170,10284,161454,890
2022-06-15,San Joaquin,077,732212,177310,175966,11873,187839,2244
2022-06-15,San Luis Obispo,079,281455,57043,56535,5337,61872,486
2022-06-15,San Mateo,081,765935,145089,143277,9306,152583,722
2022-06-15,Santa Barbara,083,443738,93382,92710,5444,98154,698
2022-06-15,Santa Clara,085,1922200,369027,364014,16133,380147,2323
2022-06-15,Santa Cruz,087,273765,54399,53718,2704,56422,265
2022-06-15,Shasta,089,179085,31801,31598,6427,38025,568
2022-06-15,Sierra,091,2930,281,280,56,336,4
2022-06-15,Siskiyou,093,43540,4696,4656,2977,7633,81
2022-06-15,Solano,095,438530,91798,90265,6507,96772,453
2022-06-15,Sonoma,097,501317,95093,94041,4155,98196,492
2022-06-15,Stanislaus,099,539301,123818,122944,18778,141722,1668
2022-06-15,Sutter,101,95872,21563,21448,2331,23779,227
2022-06-15,Tehama,103,63373,12471,12392,2749,15141,205
2022-06-15,Trinity,105,12862,1225,1217,299,1516,20
2022-06-15,Tulare,107,460477,110578,109930,30902,140832,1495
2022-06-15,Tuolumne,109,53932,13606,13459,684,14143,189
2022-06-15,Ventura,111,848112,186286,184750,11414,196164,1509
2022-06-15,Yolo,113,214977,42417,40756,3732,44488,322
2022-06-15,Yuba,115,75493,16880,16754,1450,18204,124
2022-06-14,Alameda,001,1643700,298018,295002,17037,312039,1880
2022-06-14,Alpine,003,1148,129,129,1,130,0
2022-06-14,Amador,005,37829,9095,8972,729,9701,87
2022-06-14,Butte,007,227075,35092,34841,7450,42291,430
2022-06-14,Calaveras,009,45235,7700,7648,419,8067,122
2022-06-14,Colusa,011,21464,3522,3515,1134,4649,21
2022-06-14,Contra Costa,013,1133247,215383,213219,16394,229613,1321
2022-06-14,Del Norte,015,27424,6337,6298,297,6595,52
2022-06-14,El Dorado,017,186661,29046,28829,3634,32463,215
2022-06-14,Fresno,019,978130,243107,241768,25887,267655,2767
2022-06-14,Glenn,021,27897,5146,5128,1678,6806,48
2022-06-14,Humboldt,023,135768,19030,18836,3817,22653,148
2022-06-14,Imperial,025,180216,57664,57373,11598,68971,941
2022-06-14,Inyo,027,18085,4217,4205,631,4836,56
2022-06-14,Kern,029,883053,199408,198216,49931,248147,2338
2022-06-14,Kings,031,150075,53383,53170,3768,56938,448
2022-06-14,Lake,033,64148,11374,11303,996,12299,140
2022-06-14,Lassen,035,31185,9245,9209,934,10143,64
2022-06-14,Los Angeles,037,10098052,2917091,2897298,141110,3038408,31971
2022-06-14,Madera,039,155013,39043,38776,6672,45448,372
2022-06-14,Marin,041,260295,39417,39027,4532,43559,294
2022-06-14,Mariposa,043,17540,2685,2651,258,2909,30
2022-06-14,Mendocino,045,87422,14151,14052,3675,17727,127
2022-06-14,Merced,047,269075,65015,64595,9593,74188,825
2022-06-14,Modoc,049,8938,772,772,266,1038,8
2022-06-14,Mono,051,14174,3071,3060,178,3238,6
2022-06-14,Monterey,053,433212,84549,83837,16880,100717,741
2022-06-14,Napa,055,140530,28788,28518,1253,29771,144
2022-06-14,Nevada,057,99092,17232,17107,1413,18520,127
2022-06-14,Orange,059,3164182,589703,585496,48583,634079,7067
2022-06-14,Placer,061,380077,68279,67805,8229,76034,628
2022-06-14,Plumas,063,18699,3216,3185,395,3580,13
2022-06-14,Riverside,065,2383286,621779,618584,30546,649130,6482
2022-06-14,Sacramento,067,1510023,307455,305361,31010,336371,3059
2022-06-14,San Benito,069,59416,14023,13953,668,14621,99
2022-06-14,San Bernardino,071,2135413,594979,590328,26654,616982,7735
2022-06-14,San Diego,073,3302833,814270,811093,59060,870153,5316
2022-06-14,San Francisco,075,870044,152958,151170,10257,161427,890
2022-06-14,San Joaquin,077,732212,177042,175966,11839,187805,2244
2022-06-14,San Luis Obispo,079,281455,56936,56535,5282,61817,486
2022-06-14,San Mateo,081,765935,144709,143277,9289,152566,722
2022-06-14,Santa Barbara,083,443738,93246,92710,5430,98140,698
2022-06-14,Santa Clara,085,1922200,367971,364014,16079,380093,2323
2022-06-14,Santa Cruz,087,273765,54275,53718,2692,56410,265
2022-06-14,Shasta,089,179085,31769,31598,6419,38017,568
2022-06-14,Sierra,091,2930,281,280,56,336,4
2022-06-14,Siskiyou,093,43540,4686,4656,2971,7627,81
2022-06-14,Solano,095,438530,91539,90265,6485,96750,453
2022-06-14,Sonoma,097,501317,94882,94041,4143,98184,492
2022-06-14,Stanislaus,099,539301,123639,122944,18748,141692,1668
2022-06-14,Sutter,101,95872,21525,21448,2327,23775,227
2022-06-14,Tehama,103,63373,12453,12392,2746,15138,205
2022-06-14,Trinity,105,12862,1224,1217,299,1516,20
2022-06-14,Tulare,107,460477,110437,109930,30854,140784,1495
2022-06-14,Tuolumne,109,53932,13586,13459,680,14139,189
2022-06-14,Ventura,111,848112,185993,184750,11371,196121,1509
2022-06-14,Yolo,113,214977,42309,40756,3722,44478,322
2022-06-14,Yuba,115,75493,16850,16754,1447,18201,124
2022-06-13,Alameda,001,1643700,297197,295002,16983,311985,1880
2022-06-13,Alpine,003,1148,129,129,1,130,0
2022-06-13,Amador,005,37829,9088,8972,727,9699,87
2022-06-13,Butte,007,227075,35019,34841,7422,42263,430
2022-06-13,Calaveras,009,45235,7681,7648,419,8067,122
2022-06-13,Colusa,011,21464,3522,3515,1131,4646,21
2022-06-13,Contra Costa,013,1133247,214814,213219,16319,229538,1321
2022-06-13,Del Norte,015,27424,6325,6298,293,6591,52
2022-06-13,El Dorado,017,186661,28997,28829,3623,32452,215
2022-06-13,Fresno,019,978130,242687,241768,25824,267592,2767
2022-06-13,Glenn,021,27897,5142,5128,1673,6801,48
2022-06-13,Humboldt,023,135768,18976,18836,3791,22627,148
2022-06-13,Imperial,025,180216,57569,57373,11546,68919,941
2022-06-13,Inyo,027,18085,4213,4205,626,4831,56
2022-06-13,Kern,029,883053,199137,198216,49776,247992,2338
2022-06-13,Kings,031,150075,53318,53170,3764,56934,448
2022-06-13,Lake,033,64148,11349,11303,995,12298,140
2022-06-13,Lassen,035,31185,9237,9209,931,10140,64
2022-06-13,Los Angeles,037,10098052,2912613,2897298,140725,3038023,31971
2022-06-13,Madera,039,155013,38975,38776,6651,45427,372
2022-06-13,Marin,041,260295,39310,39027,4503,43530,294
2022-06-13,Mariposa,043,17540,2672,2651,257,2908,30
2022-06-13,Mendocino,045,87422,14127,14052,3659,17711,127
2022-06-13,Merced,047,269075,64938,64595,9560,74155,825
2022-06-13,Modoc,049,8938,771,772,266,1038,8
2022-06-13,Mono,051,14174,3069,3060,178,3238,6
2022-06-13,Monterey,053,433212,84416,83837,16823,100660,741
2022-06-13,Napa,055,140530,28718,28518,1249,29767,144
2022-06-13,Nevada,057,99092,17201,17107,1410,18517,127
2022-06-13,Orange,059,3164182,588458,585496,48397,633893,7067
2022-06-13,Placer,061,380077,68184,67805,8208,76013,628
2022-06-13,Plumas,063,18699,3211,3185,394,3579,13
2022-06-13,Riverside,065,2383286,621037,618584,30507,649091,6482
2022-06-13,Sacramento,067,1510023,306781,305361,30938,336299,3059
2022-06-13,San Benito,069,59416,13997,13953,662,14615,99
2022-06-13,San Bernardino,071,2135413,594196,590328,26624,616952,7735
2022-06-13,San Diego,073,3302833,812559,811093,58960,870053,5316
2022-06-13,San Francisco,075,870044,152413,151170,10237,161407,890
2022-06-13,San Joaquin,077,732212,176781,175966,11797,187763,2244
2022-06-13,San Luis Obispo,079,281455,56838,56535,5228,61763,486
2022-06-13,San Mateo,081,765935,144278,143277,9260,152537,722
2022-06-13,Santa Barbara,083,443738,93119,92710,5415,98125,698
2022-06-13,Santa Clara,085,1922200,366960,364014,16023,380037,2323
2022-06-13,Santa Cruz,087,273765,54137,53718,2685,56403,265
2022-06-13,Shasta,089,179085,31737,31598,6412,38010,568
2022-06-13,Sierra,091,2930,281,280,56,336,4
2022-06-13,Siskiyou,093,43540,4682,4656,2963,7619,81
2022-06-13,Solano,095,438530,91303,90265,6459,96724,453
2022-06-13,Sonoma,097,501317,94653,94041,4123,98164,492
2022-06-13,Stanislaus,099,539301,123468,122944,18726,141670,1668
2022-06-13,Sutter,101,95872,21497,21448,2322,23770,227
2022-06-13,Tehama,103,63373,12434,12392,2743,15135,205
2022-06-13,Trinity,105,12862,1222,1217,299,1516,20
2022-06-13,Tulare,107,460477,110285,109930,30793,140723,1495
2022-06-13,Tuolumne,109,53932,13565,13459,677,14136,189
2022-06-13,Ventura,111,848112,185703,184750,11315,196065,1509
2022-06-13,Yolo,113,214977,42171,40756,3708,44464,322
2022-06-13,Yuba,115,75493,16832,16754,1441,18195,124
2022-06-12,Alameda,001,1643700,296389,292112,16920,309032,1877
2022-06-12,Alpine,003,1148,129,129,1,130,0
2022-06-12,Amador,005,37829,9065,8869,726,9595,87
2022-06-12,Butte,007,227075,34962,34596,7397,41993,427
2022-06-12,Calaveras,009,45235,7667,7604,415,8019,122
2022-06-12,Colusa,011,21464,3521,3505,1130,4635,21
2022-06-12,Contra Costa,013,1133247,214234,211229,16240,227469,1315
2022-06-12,Del Norte,015,27424,6311,6253,293,6546,52
2022-06-12,El Dorado,017,186661,28936,28641,3603,32244,215
2022-06-12,Fresno,019,978130,242229,240345,25767,266112,2766
2022-06-12,Glenn,021,27897,5138,5104,1671,6775,48
2022-06-12,Humboldt,023,135768,18909,18696,3752,22448,148
2022-06-12,Imperial,025,180216,57499,57129,11496,68625,941
2022-06-12,Inyo,027,18085,4212,4194,624,4818,56
2022-06-12,Kern,029,883053,198856,197353,49635,246988,2338
2022-06-12,Kings,031,150075,53239,52978,3755,56733,447
2022-06-12,Lake,033,64148,11326,11202,994,12196,139
2022-06-12,Lassen,035,31185,9219,9172,928,10100,64
2022-06-12,Los Angeles,037,10098052,2907734,2878981,140260,3019241,31947
2022-06-12,Madera,039,155013,38883,38567,6623,45190,372
2022-06-12,Marin,041,260295,39202,38593,4477,43070,294
2022-06-12,Mariposa,043,17540,2666,2625,256,2881,30
2022-06-12,Mendocino,045,87422,14104,13945,3653,17598,127
2022-06-12,Merced,047,269075,64824,64286,9524,73810,825
2022-06-12,Modoc,049,8938,771,767,266,1033,8
2022-06-12,Mono,051,14174,3065,3052,177,3229,6
2022-06-12,Monterey,053,433212,84260,83391,16736,100127,739
2022-06-12,Napa,055,140530,28657,28202,1240,29442,143
2022-06-12,Nevada,057,99092,17158,16989,1404,18393,127
2022-06-12,Orange,059,3164182,587177,581624,48212,629836,7057
2022-06-12,Placer,061,380077,68072,67306,8183,75489,628
2022-06-12,Plumas,063,18699,3205,3172,393,3565,13
2022-06-12,Riverside,065,2383286,620098,615556,30431,645987,6481
2022-06-12,Sacramento,067,1510023,306049,302721,30832,333553,3058
2022-06-12,San Benito,069,59416,13962,13832,656,14488,99
2022-06-12,San Bernardino,071,2135413,593294,587385,26573,613958,7708
2022-06-12,San Diego,073,3302833,810834,805360,58831,864191,5315
2022-06-12,San Francisco,075,870044,151853,149278,10187,159465,890
2022-06-12,San Joaquin,077,732212,176430,174822,11768,186590,2244
2022-06-12,San Luis Obispo,079,281455,56702,56160,5153,61313,485
2022-06-12,San Mateo,081,765935,143812,141719,9216,150935,715
2022-06-12,Santa Barbara,083,443738,92946,92177,5401,97578,694
2022-06-12,Santa Clara,085,1922200,365783,359925,15972,375897,2322
2022-06-12,Santa Cruz,087,273765,53977,53171,2679,55850,264
2022-06-12,Shasta,089,179085,31691,31483,6398,37881,566
2022-06-12,Sierra,091,2930,281,278,56,334,4
2022-06-12,Siskiyou,093,43540,4674,4633,2958,7591,81
2022-06-12,Solano,095,438530,91014,89424,6435,95859,453
2022-06-12,Sonoma,097,501317,94403,93218,4098,97316,492
2022-06-12,Stanislaus,099,539301,123269,122267,18685,140952,1665
2022-06-12,Sutter,101,95872,21456,21333,2302,23635,227
2022-06-12,Tehama,103,63373,12416,12343,2736,15079,205
2022-06-12,Trinity,105,12862,1219,1213,299,1512,20
2022-06-12,Tulare,107,460477,110080,109467,30716,140183,1495
2022-06-12,Tuolumne,109,53932,13537,13382,674,14056,189
2022-06-12,Ventura,111,848112,185346,183680,11266,194946,1508
2022-06-12,Yolo,113,214977,42052,40202,3699,43901,323
2022-06-12,Yuba,115,75493,16804,16653,1433,18086,123
2022-06-11,Alameda,001,1643700,295976,292112,16895,309007,1877
2022-06-11,Alpine,003,1148,129,129,1,130,0
2022-06-11,Amador,005,37829,9051,8869,726,9595,87
2022-06-11,Butte,007,227075,34927,34596,7377,41973,427
2022-06-11,Calaveras,009,45235,7660,7604,414,8018,122
2022-06-11,Colusa,011,21464,3519,3505,1129,4634,21
2022-06-11,Contra Costa,013,1133247,213925,211229,16203,227432,1315
2022-06-11,Del Norte,015,27424,6303,6253,293,6546,52
2022-06-11,El Dorado,017,186661,28917,28641,3601,32242,215
2022-06-11,Fresno,019,978130,242034,240345,25746,266091,2766
2022-06-11,Glenn,021,27897,5136,5104,1671,6775,48
2022-06-11,Humboldt,023,135768,18887,18696,3741,22437,148
2022-06-11,Imperial,025,180216,57442,57129,11482,68611,941
2022-06-11,Inyo,027,18085,4212,4194,622,4816,56
2022-06-11,Kern,029,883053,198731,197353,49553,246906,2338
2022-06-11,Kings,031,150075,53207,52978,3754,56732,447
2022-06-11,Lake,033,64148,11318,11202,991,12193,139
2022-06-11,Lassen,035,31185,9214,9172,927,10099,64
2022-06-11,Los Angeles,037,10098052,2905425,2878981,139984,3018965,31947
2022-06-11,Madera,039,155013,38862,38567,6621,45188,372
2022-06-11,Marin,041,260295,39125,38593,4442,43035,294
2022-06-11,Mariposa,043,17540,2662,2625,255,2880,30
2022-06-11,Mendocino,045,87422,14093,13945,3650,17595,127
2022-06-11,Merced,047,269075,64775,64286,9519,73805,825
2022-06-11,Modoc,049,8938,771,767,266,1033,8
2022-06-11,Mono,051,14174,3065,3052,177,3229,6
2022-06-11,Monterey,053,433212,84177,83391,16704,100095,739
2022-06-11,Napa,055,140530,28617,28202,1236,29438,143
2022-06-11,Nevada,057,99092,17145,16989,1402,18391,127
2022-06-11,Orange,059,3164182,586530,581624,48071,629695,7057
2022-06-11,Placer,061,380077,67986,67306,8174,75480,628
2022-06-11,Plumas,063,18699,3202,3172,393,3565,13
2022-06-11,Riverside,065,2383286,619568,615556,30400,645956,6481
2022-06-11,Sacramento,067,1510023,305743,302721,30795,333516,3058
2022-06-11,San Benito,069,59416,13952,13832,653,14485,99
2022-06-11,San Bernardino,071,2135413,592885,587385,26551,613936,7708
2022-06-11,San Diego,073,3302833,810135,805360,58788,864148,5315
2022-06-11,San Francisco,075,870044,151533,149278,10165,159443,890
2022-06-11,San Joaquin,077,732212,176276,174822,11748,186570,2244
2022-06-11,San Luis Obispo,079,281455,56668,56160,5143,61303,485
2022-06-11,San Mateo,081,765935,143587,141719,9192,150911,715
2022-06-11,Santa Barbara,083,443738,92879,92177,5387,97564,694
2022-06-11,Santa Clara,085,1922200,365025,359925,15931,375856,2322
2022-06-11,Santa Cruz,087,273765,53922,53171,2663,55834,264
2022-06-11,Shasta,089,179085,31675,31483,6392,37875,566
2022-06-11,Sierra,091,2930,281,278,56,334,4
2022-06-11,Siskiyou,093,43540,4668,4633,2950,7583,81
2022-06-11,Solano,095,438530,90926,89424,6422,95846,453
2022-06-11,Sonoma,097,501317,94296,93218,4073,97291,492
2022-06-11,Stanislaus,099,539301,123166,122267,18664,140931,1665
2022-06-11,Sutter,101,95872,21439,21333,2300,23633,227
2022-06-11,Tehama,103,63373,12409,12343,2735,15078,205
2022-06-11,Trinity,105,12862,1219,1213,299,1512,20
2022-06-11,Tulare,107,460477,109999,109467,30678,140145,1495
2022-06-11,Tuolumne,109,53932,13511,13382,672,14054,189
2022-06-11,Ventura,111,848112,185170,183680,11233,194913,1508
2022-06-11,Yolo,113,214977,41989,40202,3693,43895,323
2022-06-11,Yuba,115,75493,16785,16653,1428,18081,123
2022-06-10,Alameda,001,1643700,295505,292112,16868,308980,1877
2022-06-10,Alpine,003,1148,129,129,1,130,0
2022-06-10,Amador,005,37829,9038,8869,725,9594,87
2022-06-10,Butte,007,227075,34898,34596,7367,41963,427
2022-06-10,Calaveras,009,45235,7655,7604,414,8018,122
2022-06-10,Colusa,011,21464,3514,3505,1127,4632,21
2022-06-10,Contra Costa,013,1133247,213659,211229,16169,227398,1315
2022-06-10,Del Norte,015,27424,6297,6253,292,6545,52
2022-06-10,El Dorado,017,186661,28888,28641,3595,32236,215
2022-06-10,Fresno,019,978130,241806,240345,25720,266065,2766
2022-06-10,Glenn,021,27897,5134,5104,1667,6771,48
2022-06-10,Humboldt,023,135768,18865,18696,3734,22430,148
2022-06-10,Imperial,025,180216,57398,57129,11479,68608,941
2022-06-10,Inyo,027,18085,4211,4194,618,4812,56
2022-06-10,Kern,029,883053,198585,197353,49453,246806,2338
2022-06-10,Kings,031,150075,53187,52978,3753,56731,447
2022-06-10,Lake,033,64148,11303,11202,990,12192,139
2022-06-10,Lassen,035,31185,9211,9172,927,10099,64
2022-06-10,Los Angeles,037,10098052,2902695,2878981,139717,3018698,31947
2022-06-10,Madera,039,155013,38834,38567,6613,45180,372
2022-06-10,Marin,041,260295,39030,38593,4414,43007,294
2022-06-10,Mariposa,043,17540,2658,2625,254,2879,30
2022-06-10,Mendocino,045,87422,14075,13945,3642,17587,127
2022-06-10,Merced,047,269075,64732,64286,9513,73799,825
2022-06-10,Modoc,049,8938,771,767,266,1033,8
2022-06-10,Mono,051,14174,3065,3052,176,3228,6
2022-06-10,Monterey,053,433212,84086,83391,16658,100049,739
2022-06-10,Napa,055,140530,28586,28202,1235,29437,143
2022-06-10,Nevada,057,99092,17133,16989,1401,18390,127
2022-06-10,Orange,059,3164182,585867,581624,47950,629574,7057
2022-06-10,Placer,061,380077,67917,67306,8157,75463,628
2022-06-10,Plumas,063,18699,3198,3172,393,3565,13
2022-06-10,Riverside,065,2383286,619047,615556,30370,645926,6481
2022-06-10,Sacramento,067,1510023,305345,302721,30773,333494,3058
2022-06-10,San Benito,069,59416,13938,13832,652,14484,99
2022-06-10,San Bernardino,071,2135413,592490,587385,26515,613900,7708
2022-06-10,San Diego,073,3302833,809220,805360,58754,864114,5315
2022-06-10,San Francisco,075,870044,151215,149278,10124,159402,890
2022-06-10,San Joaquin,077,732212,176162,174822,11731,186553,2244
2022-06-10,San Luis Obispo,079,281455,56633,56160,5135,61295,485
2022-06-10,San Mateo,081,765935,143334,141719,9177,150896,715
2022-06-10,Santa Barbara,083,443738,92780,92177,5383,97560,694
2022-06-10,Santa Clara,085,1922200,364282,359925,15896,375821,2322
2022-06-10,Santa Cruz,087,273765,53823,53171,2653,55824,264
2022-06-10,Shasta,089,179085,31655,31483,6382,37865,566
2022-06-10,Sierra,091,2930,280,278,56,334,4
2022-06-10,Siskiyou,093,43540,4661,4633,2944,7577,81
2022-06-10,Solano,095,438530,90764,89424,6408,95832,453
2022-06-10,Sonoma,097,501317,94137,93218,4048,97266,492
2022-06-10,Stanislaus,099,539301,123047,122267,18651,140918,1665
2022-06-10,Sutter,101,95872,21424,21333,2298,23631,227
2022-06-10,Tehama,103,63373,12401,12343,2734,15077,205
2022-06-10,Trinity,105,12862,1217,1213,299,1512,20
2022-06-10,Tulare,107,460477,109932,109467,30648,140115,1495
2022-06-10,Tuolumne,109,53932,13498,13382,668,14050,189
2022-06-10,Ventura,111,848112,184982,183680,11199,194879,1508
2022-06-10,Yolo,113,214977,41900,40202,3685,43887,323
2022-06-10,Yuba,115,75493,16764,16653,1425,18078,123
2022-06-09,Alameda,001,1643700,294595,292112,16808,308920,1877
2022-06-09,Alpine,003,1148,129,129,1,130,0
2022-06-09,Amador,005,37829,9027,8869,722,9591,87
2022-06-09,Butte,007,227075,34839,34596,7358,41954,427
2022-06-09,Calaveras,009,45235,7645,7604,414,8018,122
2022-06-09,Colusa,011,21464,3513,3505,1125,4630,21
2022-06-09,Contra Costa,013,1133247,213158,211229,16122,227351,1315
2022-06-09,Del Norte,015,27424,6286,6253,289,6542,52
2022-06-09,El Dorado,017,186661,28831,28641,3586,32227,215
2022-06-09,Fresno,019,978130,241451,240345,25673,266018,2766
2022-06-09,Glenn,021,27897,5129,5104,1665,6769,48
2022-06-09,Humboldt,023,135768,18817,18696,3722,22418,148
2022-06-09,Imperial,025,180216,57343,57129,11458,68587,941
2022-06-09,Inyo,027,18085,4208,4194,613,4807,56
2022-06-09,Kern,029,883053,198384,197353,49348,246701,2338
2022-06-09,Kings,031,150075,53143,52978,3749,56727,447
2022-06-09,Lake,033,64148,11278,11202,989,12191,139
2022-06-09,Lassen,035,31185,9192,9172,925,10097,64
2022-06-09,Los Angeles,037,10098052,2898217,2878981,139331,3018312,31947
2022-06-09,Madera,039,155013,38780,38567,6598,45165,372
2022-06-09,Marin,041,260295,38927,38593,4389,42982,294
2022-06-09,Mariposa,043,17540,2654,2625,253,2878,30
2022-06-09,Mendocino,045,87422,14047,13945,3640,17585,127
2022-06-09,Merced,047,269075,64654,64286,9503,73789,825
2022-06-09,Modoc,049,8938,770,767,266,1033,8
2022-06-09,Mono,051,14174,3060,3052,174,3226,6
2022-06-09,Monterey,053,433212,83966,83391,16586,99977,739
2022-06-09,Napa,055,140530,28527,28202,1233,29435,143
2022-06-09,Nevada,057,99092,17099,16989,1400,18389,127
2022-06-09,Orange,059,3164182,584795,581624,47795,629419,7057
2022-06-09,Placer,061,380077,67797,67306,8144,75450,628
2022-06-09,Plumas,063,18699,3192,3172,393,3565,13
2022-06-09,Riverside,065,2383286,618356,615556,30326,645882,6481
2022-06-09,Sacramento,067,1510023,304767,302721,30687,333408,3058
2022-06-09,San Benito,069,59416,13919,13832,649,14481,99
2022-06-09,San Bernardino,071,2135413,591826,587385,26480,613865,7708
2022-06-09,San Diego,073,3302833,807816,805360,58636,863996,5315
2022-06-09,San Francisco,075,870044,150815,149278,10092,159370,890
2022-06-09,San Joaquin,077,732212,175874,174822,11710,186532,2244
2022-06-09,San Luis Obispo,079,281455,56545,56160,5105,61265,485
2022-06-09,San Mateo,081,765935,142953,141719,9150,150869,715
2022-06-09,Santa Barbara,083,443738,92649,92177,5378,97555,694
2022-06-09,Santa Clara,085,1922200,363319,359925,15827,375752,2322
2022-06-09,Santa Cruz,087,273765,53692,53171,2642,55813,264
2022-06-09,Shasta,089,179085,31624,31483,6372,37855,566
2022-06-09,Sierra,091,2930,280,278,56,334,4
2022-06-09,Siskiyou,093,43540,4654,4633,2930,7563,81
2022-06-09,Solano,095,438530,90519,89424,6393,95817,453
2022-06-09,Sonoma,097,501317,93981,93218,4028,97246,492
2022-06-09,Stanislaus,099,539301,122879,122267,18637,140904,1665
2022-06-09,Sutter,101,95872,21386,21333,2298,23631,227
2022-06-09,Tehama,103,63373,12383,12343,2733,15076,205
2022-06-09,Trinity,105,12862,1216,1213,299,1512,20
2022-06-09,Tulare,107,460477,109814,109467,30604,140071,1495
2022-06-09,Tuolumne,109,53932,13467,13382,665,14047,189
2022-06-09,Ventura,111,848112,184716,183680,11165,194845,1508
2022-06-09,Yolo,113,214977,41789,40202,3669,43871,323
2022-06-09,Yuba,115,75493,16742,16653,1422,18075,123
2022-06-08,Alameda,001,1643700,293835,289661,16766,306427,1873
2022-06-08,Alpine,003,1148,129,128,1,129,0
2022-06-08,Amador,005,37829,9019,8818,720,9538,87
2022-06-08,Butte,007,227075,34774,34380,7340,41720,427
2022-06-08,Calaveras,009,45235,7631,7564,414,7978,122
2022-06-08,Colusa,011,21464,3511,3495,1122,4617,21
2022-06-08,Contra Costa,013,1133247,212661,209384,16079,225463,1310
2022-06-08,Del Norte,015,27424,6265,6229,289,6518,52
2022-06-08,El Dorado,017,186661,28779,28478,3582,32060,215
2022-06-08,Fresno,019,978130,241115,239376,25605,264981,2766
2022-06-08,Glenn,021,27897,5125,5095,1664,6759,48
2022-06-08,Humboldt,023,135768,18787,18598,3695,22293,147
2022-06-08,Imperial,025,180216,57271,56912,11439,68351,941
2022-06-08,Inyo,027,18085,4206,4189,613,4802,56
2022-06-08,Kern,029,883053,198112,196763,49229,245992,2338
2022-06-08,Kings,031,150075,53073,52821,3743,56564,447
2022-06-08,Lake,033,64148,11257,11158,989,12147,137
2022-06-08,Lassen,035,31185,9179,9148,925,10073,64
2022-06-08,Los Angeles,037,10098052,2893572,2865901,138953,3004854,31920
2022-06-08,Madera,039,155013,38735,38408,6590,44998,372
2022-06-08,Marin,041,260295,38834,38338,4372,42710,294
2022-06-08,Mariposa,043,17540,2644,2614,253,2867,30
2022-06-08,Mendocino,045,87422,14027,13859,3633,17492,127
2022-06-08,Merced,047,269075,64589,64080,9487,73567,825
2022-06-08,Modoc,049,8938,766,761,266,1027,8
2022-06-08,Mono,051,14174,3056,3044,174,3218,6
2022-06-08,Monterey,053,433212,83856,83063,16539,99602,740
2022-06-08,Napa,055,140530,28439,27996,1230,29226,143
2022-06-08,Nevada,057,99092,17073,16907,1398,18305,127
2022-06-08,Orange,059,3164182,583696,578530,47598,626128,7044
2022-06-08,Placer,061,380077,67668,66951,8139,75090,627
2022-06-08,Plumas,063,18699,3189,3150,392,3542,13
2022-06-08,Riverside,065,2383286,617675,613469,30292,643761,6480
2022-06-08,Sacramento,067,1510023,304139,300875,30598,331473,3054
2022-06-08,San Benito,069,59416,13886,13734,648,14382,99
2022-06-08,San Bernardino,071,2135413,591138,585029,26440,611469,7685
2022-06-08,San Diego,073,3302833,806326,800840,58491,859331,5308
2022-06-08,San Francisco,075,870044,150393,147960,10066,158026,885
2022-06-08,San Joaquin,077,732212,175600,173887,11682,185569,2241
2022-06-08,San Luis Obispo,079,281455,56389,55822,5039,60861,484
2022-06-08,San Mateo,081,765935,142556,140569,9105,149674,710
2022-06-08,Santa Barbara,083,443738,92510,91747,5375,97122,693
2022-06-08,Santa Clara,085,1922200,362356,356452,15777,372229,2321
2022-06-08,Santa Cruz,087,273765,53552,52753,2628,55381,264
2022-06-08,Shasta,089,179085,31592,31394,6366,37760,565
2022-06-08,Sierra,091,2930,280,278,56,334,4
2022-06-08,Siskiyou,093,43540,4649,4609,2927,7536,81
2022-06-08,Solano,095,438530,90250,88522,6376,94898,453
2022-06-08,Sonoma,097,501317,93797,92644,3994,96638,491
2022-06-08,Stanislaus,099,539301,122695,121787,18613,140400,1662
2022-06-08,Sutter,101,95872,21363,21256,2294,23550,227
2022-06-08,Tehama,103,63373,12376,12306,2731,15037,205
2022-06-08,Trinity,105,12862,1215,1211,298,1509,20
2022-06-08,Tulare,107,460477,109727,109091,30550,139641,1494
2022-06-08,Tuolumne,109,53932,13451,13335,663,13998,189
2022-06-08,Ventura,111,848112,184442,182847,11142,193989,1506
2022-06-08,Yolo,113,214977,41684,39962,3659,43621,321
2022-06-08,Yuba,115,75493,16717,16558,1412,17970,122
2022-06-07,Alameda,001,1643700,293035,289661,16706,306367,1873
2022-06-07,Alpine,003,1148,129,128,1,129,0
2022-06-07,Amador,005,37829,9009,8818,718,9536,87
2022-06-07,Butte,007,227075,34695,34380,7312,41692,427
2022-06-07,Calaveras,009,45235,7623,7564,413,7977,122
2022-06-07,Colusa,011,21464,3511,3495,1118,4613,21
2022-06-07,Contra Costa,013,1133247,212116,209384,16018,225402,1310
2022-06-07,Del Norte,015,27424,6259,6229,285,6514,52
2022-06-07,El Dorado,017,186661,28715,28478,3572,32050,215
2022-06-07,Fresno,019,978130,240730,239376,25534,264910,2766
2022-06-07,Glenn,021,27897,5118,5095,1664,6759,48
2022-06-07,Humboldt,023,135768,18748,18598,3678,22276,147
2022-06-07,Imperial,025,180216,57216,56912,11404,68316,941
2022-06-07,Inyo,027,18085,4205,4189,605,4794,56
2022-06-07,Kern,029,883053,197856,196763,49114,245877,2338
2022-06-07,Kings,031,150075,53016,52821,3736,56557,447
2022-06-07,Lake,033,64148,11232,11158,984,12142,137
2022-06-07,Lassen,035,31185,9170,9148,924,10072,64
2022-06-07,Los Angeles,037,10098052,2888258,2865901,138516,3004417,31920
2022-06-07,Madera,039,155013,38662,38408,6573,44981,372
2022-06-07,Marin,041,260295,38750,38338,4344,42682,294
2022-06-07,Mariposa,043,17540,2637,2614,251,2865,30
2022-06-07,Mendocino,045,87422,13996,13859,3601,17460,127
2022-06-07,Merced,047,269075,64498,64080,9469,73549,825
2022-06-07,Modoc,049,8938,766,761,264,1025,8
2022-06-07,Mono,051,14174,3054,3044,171,3215,6
2022-06-07,Monterey,053,433212,83728,83063,16483,99546,740
2022-06-07,Napa,055,140530,28364,27996,1222,29218,143
2022-06-07,Nevada,057,99092,17046,16907,1391,18298,127
2022-06-07,Orange,059,3164182,582578,578530,47426,625956,7044
2022-06-07,Placer,061,380077,67519,66951,8121,75072,627
2022-06-07,Plumas,063,18699,3184,3150,391,3541,13
2022-06-07,Riverside,065,2383286,616801,613469,30229,643698,6480
2022-06-07,Sacramento,067,1510023,303426,300875,30486,331361,3054
2022-06-07,San Benito,069,59416,13844,13734,643,14377,99
2022-06-07,San Bernardino,071,2135413,590368,585029,26407,611436,7685
2022-06-07,San Diego,073,3302833,804750,800840,58287,859127,5308
2022-06-07,San Francisco,075,870044,149868,147960,10043,158003,885
2022-06-07,San Joaquin,077,732212,175270,173887,11632,185519,2241
2022-06-07,San Luis Obispo,079,281455,56285,55822,4989,60811,484
2022-06-07,San Mateo,081,765935,142138,140569,9047,149616,710
2022-06-07,Santa Barbara,083,443738,92364,91747,5362,97109,693
2022-06-07,Santa Clara,085,1922200,361223,356452,15692,372144,2321
2022-06-07,Santa Cruz,087,273765,53451,52753,2621,55374,264
2022-06-07,Shasta,089,179085,31555,31394,6359,37753,565
2022-06-07,Sierra,091,2930,279,278,56,334,4
2022-06-07,Siskiyou,093,43540,4642,4609,2923,7532,81
2022-06-07,Solano,095,438530,89922,88522,6357,94879,453
2022-06-07,Sonoma,097,501317,93571,92644,3959,96603,491
2022-06-07,Stanislaus,099,539301,122522,121787,18590,140377,1662
2022-06-07,Sutter,101,95872,21335,21256,2292,23548,227
2022-06-07,Tehama,103,63373,12361,12306,2726,15032,205
2022-06-07,Trinity,105,12862,1214,1211,298,1509,20
2022-06-07,Tulare,107,460477,109604,109091,30494,139585,1494
2022-06-07,Tuolumne,109,53932,13438,13335,660,13995,189
2022-06-07,Ventura,111,848112,184088,182847,11094,193941,1506
2022-06-07,Yolo,113,214977,41567,39962,3646,43608,321
2022-06-07,Yuba,115,75493,16688,16558,1410,17968,122
2022-06-06,Alameda,001,1643700,292150,289661,16642,306303,1873
2022-06-06,Alpine,003,1148,129,128,1,129,0
2022-06-06,Amador,005,37829,8958,8818,716,9534,87
2022-06-06,Butte,007,227075,34632,34380,7297,41677,427
2022-06-06,Calaveras,009,45235,7612,7564,413,7977,122
2022-06-06,Colusa,011,21464,3510,3495,1113,4608,21
2022-06-06,Contra Costa,013,1133247,211474,209384,15927,225311,1310
2022-06-06,Del Norte,015,27424,6251,6229,283,6512,52
2022-06-06,El Dorado,017,186661,28667,28478,3560,32038,215
2022-06-06,Fresno,019,978130,240311,239376,25472,264848,2766
2022-06-06,Glenn,021,27897,5111,5095,1660,6755,48
2022-06-06,Humboldt,023,135768,18710,18598,3664,22262,147
2022-06-06,Imperial,025,180216,57144,56912,11363,68275,941
2022-06-06,Inyo,027,18085,4201,4189,602,4791,56
2022-06-06,Kern,029,883053,197576,196763,48967,245730,2338
2022-06-06,Kings,031,150075,52958,52821,3732,56553,447
2022-06-06,Lake,033,64148,11212,11158,977,12135,137
2022-06-06,Lassen,035,31185,9160,9148,923,10071,64
2022-06-06,Los Angeles,037,10098052,2882683,2865901,138103,3004004,31920
2022-06-06,Madera,039,155013,38595,38408,6546,44954,372
2022-06-06,Marin,041,260295,38625,38338,4305,42643,294
2022-06-06,Mariposa,043,17540,2627,2614,248,2862,30
2022-06-06,Mendocino,045,87422,13967,13859,3588,17447,127
2022-06-06,Merced,047,269075,64373,64080,9444,73524,825
2022-06-06,Modoc,049,8938,764,761,262,1023,8
2022-06-06,Mono,051,14174,3051,3044,170,3214,6
2022-06-06,Monterey,053,433212,83586,83063,16414,99477,740
2022-06-06,Napa,055,140530,28285,27996,1211,29207,143
2022-06-06,Nevada,057,99092,17018,16907,1387,18294,127
2022-06-06,Orange,059,3164182,581449,578530,47249,625779,7044
2022-06-06,Placer,061,380077,67406,66951,8099,75050,627
2022-06-06,Plumas,063,18699,3177,3150,390,3540,13
2022-06-06,Riverside,065,2383286,616013,613469,30172,643641,6480
2022-06-06,Sacramento,067,1510023,302657,300875,30376,331251,3054
2022-06-06,San Benito,069,59416,13796,13734,639,14373,99
2022-06-06,San Bernardino,071,2135413,589605,585029,26357,611386,7685
2022-06-06,San Diego,073,3302833,802970,800840,58054,858894,5308
2022-06-06,San Francisco,075,870044,149341,147960,10021,157981,885
2022-06-06,San Joaquin,077,732212,174887,173887,11596,185483,2241
2022-06-06,San Luis Obispo,079,281455,56174,55822,4952,60774,484
2022-06-06,San Mateo,081,765935,141663,140569,9007,149576,710
2022-06-06,Santa Barbara,083,443738,92187,91747,5343,97090,693
2022-06-06,Santa Clara,085,1922200,359960,356452,15605,372057,2321
2022-06-06,Santa Cruz,087,273765,53297,52753,2609,55362,264
2022-06-06,Shasta,089,179085,31520,31394,6345,37739,565
2022-06-06,Sierra,091,2930,279,278,56,334,4
2022-06-06,Siskiyou,093,43540,4632,4609,2912,7521,81
2022-06-06,Solano,095,438530,89632,88522,6336,94858,453
2022-06-06,Sonoma,097,501317,93335,92644,3928,96572,491
2022-06-06,Stanislaus,099,539301,122335,121787,18567,140354,1662
2022-06-06,Sutter,101,95872,21304,21256,2286,23542,227
2022-06-06,Tehama,103,63373,12350,12306,2724,15030,205
2022-06-06,Trinity,105,12862,1212,1211,298,1509,20
2022-06-06,Tulare,107,460477,109468,109091,30431,139522,1494
2022-06-06,Tuolumne,109,53932,13419,13335,659,13994,189
2022-06-06,Ventura,111,848112,183783,182847,11042,193889,1506
2022-06-06,Yolo,113,214977,41410,39962,3632,43594,321
2022-06-06,Yuba,115,75493,16644,16558,1402,17960,122
2022-06-05,Alameda,001,1643700,291100,285785,16577,302362,1873
2022-06-05,Alpine,003,1148,128,128,1,129,0
2022-06-05,Amador,005,37829,8921,8775,713,9488,87
2022-06-05,Butte,007,227075,34552,34129,7278,41407,427
2022-06-05,Calaveras,009,45235,7596,7525,407,7932,121
2022-06-05,Colusa,011,21464,3503,3484,1113,4597,21
2022-06-05,Contra Costa,013,1133247,210768,206711,15803,222514,1310
2022-06-05,Del Norte,015,27424,6241,6206,278,6484,52
2022-06-05,El Dorado,017,186661,28591,28241,3553,31794,214
2022-06-05,Fresno,019,978130,239850,237945,25376,263321,2766
2022-06-05,Glenn,021,27897,5105,5063,1660,6723,48
2022-06-05,Humboldt,023,135768,18660,18433,3640,22073,147
2022-06-05,Imperial,025,180216,57051,56690,11312,68002,941
2022-06-05,Inyo,027,18085,4197,4176,597,4773,56
2022-06-05,Kern,029,883053,197266,195863,48848,244711,2338
2022-06-05,Kings,031,150075,52884,52597,3723,56320,447
2022-06-05,Lake,033,64148,11193,11064,973,12037,137
2022-06-05,Lassen,035,31185,9152,9106,918,10024,64
2022-06-05,Los Angeles,037,10098052,2876823,2846989,137586,2984575,31899
2022-06-05,Madera,039,155013,38534,38188,6529,44717,372
2022-06-05,Marin,041,260295,38512,37879,4270,42149,294
2022-06-05,Mariposa,043,17540,2625,2557,246,2803,30
2022-06-05,Mendocino,045,87422,13931,13738,3538,17276,125
2022-06-05,Merced,047,269075,64281,63756,9407,73163,825
2022-06-05,Modoc,049,8938,763,759,262,1021,8
2022-06-05,Mono,051,14174,3048,3037,168,3205,6
2022-06-05,Monterey,053,433212,83423,82451,16321,98772,738
2022-06-05,Napa,055,140530,28156,27686,1201,28887,143
2022-06-05,Nevada,057,99092,16974,16728,1369,18097,127
2022-06-05,Orange,059,3164182,580183,574146,47055,621201,7038
2022-06-05,Placer,061,380077,67265,66428,8084,74512,627
2022-06-05,Plumas,063,18699,3169,3138,390,3528,13
2022-06-05,Riverside,065,2383286,615079,610369,30102,640471,6481
2022-06-05,Sacramento,067,1510023,301747,297787,30223,328010,3052
2022-06-05,San Benito,069,59416,13750,13572,632,14204,99
2022-06-05,San Bernardino,071,2135413,588631,582305,26307,608612,7664
2022-06-05,San Diego,073,3302833,801072,794822,57868,852690,5303
2022-06-05,San Francisco,075,870044,148748,145876,9961,155837,881
2022-06-05,San Joaquin,077,732212,174456,172621,11547,184168,2242
2022-06-05,San Luis Obispo,079,281455,56013,55333,4874,60207,484
2022-06-05,San Mateo,081,765935,141154,138536,8961,147497,710
2022-06-05,Santa Barbara,083,443738,91995,90911,5322,96233,693
2022-06-05,Santa Clara,085,1922200,358553,351492,15509,367001,2317
2022-06-05,Santa Cruz,087,273765,53105,52333,2595,54928,263
2022-06-05,Shasta,089,179085,31479,31272,6333,37605,565
2022-06-05,Sierra,091,2930,279,278,56,334,4
2022-06-05,Siskiyou,093,43540,4627,4591,2900,7491,81
2022-06-05,Solano,095,438530,89293,87571,6320,93891,452
2022-06-05,Sonoma,097,501317,93056,91518,3895,95413,491
2022-06-05,Stanislaus,099,539301,122135,121001,18534,139535,1661
2022-06-05,Sutter,101,95872,21272,21125,2278,23403,227
2022-06-05,Tehama,103,63373,12331,12262,2721,14983,204
2022-06-05,Trinity,105,12862,1212,1204,298,1502,20
2022-06-05,Tulare,107,460477,109274,108598,30341,138939,1490
2022-06-05,Tuolumne,109,53932,13390,13251,646,13897,189
2022-06-05,Ventura,111,848112,183429,181709,10988,192697,1505
2022-06-05,Yolo,113,214977,41278,39561,3619,43180,321
2022-06-05,Yuba,115,75493,16604,16467,1393,17860,122
2022-06-04,Alameda,001,1643700,290603,285785,16552,302337,1873
2022-06-04,Alpine,003,1148,128,128,1,129,0
2022-06-04,Amador,005,37829,8912,8775,711,9486,87
2022-06-04,Butte,007,227075,34511,34129,7272,41401,427
2022-06-04,Calaveras,009,45235,7582,7525,406,7931,121
2022-06-04,Colusa,011,21464,3500,3484,1108,4592,21
2022-06-04,Contra Costa,013,1133247,210381,206711,15757,222468,1310
2022-06-04,Del Norte,015,27424,6239,6206,278,6484,52
2022-06-04,El Dorado,017,186661,28552,28241,3549,31790,214
2022-06-04,Fresno,019,978130,239680,237945,25360,263305,2766
2022-06-04,Glenn,021,27897,5101,5063,1659,6722,48
2022-06-04,Humboldt,023,135768,18639,18433,3634,22067,147
2022-06-04,Imperial,025,180216,57000,56690,11301,67991,941
2022-06-04,Inyo,027,18085,4197,4176,596,4772,56
2022-06-04,Kern,029,883053,197145,195863,48777,244640,2338
2022-06-04,Kings,031,150075,52841,52597,3723,56320,447
2022-06-04,Lake,033,64148,11178,11064,966,12030,137
2022-06-04,Lassen,035,31185,9147,9106,917,10023,64
2022-06-04,Los Angeles,037,10098052,2874498,2846989,137319,2984308,31899
2022-06-04,Madera,039,155013,38499,38188,6525,44713,372
2022-06-04,Marin,041,260295,38435,37879,4229,42108,294
2022-06-04,Mariposa,043,17540,2622,2557,246,2803,30
2022-06-04,Mendocino,045,87422,13918,13738,3537,17275,125
2022-06-04,Merced,047,269075,64233,63756,9397,73153,825
2022-06-04,Modoc,049,8938,762,759,261,1020,8
2022-06-04,Mono,051,14174,3048,3037,168,3205,6
2022-06-04,Monterey,053,433212,83338,82451,16284,98735,738
2022-06-04,Napa,055,140530,28113,27686,1199,28885,143
2022-06-04,Nevada,057,99092,16961,16728,1367,18095,127
2022-06-04,Orange,059,3164182,579542,574146,46923,621069,7038
2022-06-04,Placer,061,380077,67184,66428,8078,74506,627
2022-06-04,Plumas,063,18699,3165,3138,389,3527,13
2022-06-04,Riverside,065,2383286,614546,610369,30072,640441,6481
2022-06-04,Sacramento,067,1510023,301390,297787,30194,327981,3052
2022-06-04,San Benito,069,59416,13724,13572,629,14201,99
2022-06-04,San Bernardino,071,2135413,588188,582305,26277,608582,7664
2022-06-04,San Diego,073,3302833,800351,794822,57824,852646,5303
2022-06-04,San Francisco,075,870044,148412,145876,9938,155814,881
2022-06-04,San Joaquin,077,732212,174311,172621,11511,184132,2242
2022-06-04,San Luis Obispo,079,281455,55975,55333,4867,60200,484
2022-06-04,San Mateo,081,765935,140853,138536,8932,147468,710
2022-06-04,Santa Barbara,083,443738,91897,90911,5300,96211,693
2022-06-04,Santa Clara,085,1922200,357674,351492,15469,366961,2317
2022-06-04,Santa Cruz,087,273765,53021,52333,2581,54914,263
2022-06-04,Shasta,089,179085,31454,31272,6330,37602,565
2022-06-04,Sierra,091,2930,279,278,56,334,4
2022-06-04,Siskiyou,093,43540,4623,4591,2893,7484,81
2022-06-04,Solano,095,438530,89211,87571,6305,93876,452
2022-06-04,Sonoma,097,501317,92906,91518,3877,95395,491
2022-06-04,Stanislaus,099,539301,121996,121001,18521,139522,1661
2022-06-04,Sutter,101,95872,21246,21125,2274,23399,227
2022-06-04,Tehama,103,63373,12317,12262,2721,14983,204
2022-06-04,Trinity,105,12862,1212,1204,298,1502,20
2022-06-04,Tulare,107,460477,109207,108598,30297,138895,1490
2022-06-04,Tuolumne,109,53932,13380,13251,641,13892,189
2022-06-04,Ventura,111,848112,183245,181709,10971,192680,1505
2022-06-04,Yolo,113,214977,41200,39561,3613,43174,321
2022-06-04,Yuba,115,75493,16588,16467,1389,17856,122
2022-06-03,Alameda,001,1643700,290075,285785,16516,302301,1873
2022-06-03,Alpine,003,1148,128,128,1,129,0
2022-06-03,Amador,005,37829,8907,8775,709,9484,87
2022-06-03,Butte,007,227075,34459,34129,7260,41389,427
2022-06-03,Calaveras,009,45235,7577,7525,406,7931,121
2022-06-03,Colusa,011,21464,3500,3484,1106,4590,21
2022-06-03,Contra Costa,013,1133247,210069,206711,15726,222437,1310
2022-06-03,Del Norte,015,27424,6235,6206,275,6481,52
2022-06-03,El Dorado,017,186661,28523,28241,3546,31787,214
2022-06-03,Fresno,019,978130,239457,237945,25330,263275,2766
2022-06-03,Glenn,021,27897,5095,5063,1656,6719,48
2022-06-03,Humboldt,023,135768,18619,18433,3628,22061,147
2022-06-03,Imperial,025,180216,56955,56690,11289,67979,941
2022-06-03,Inyo,027,18085,4196,4176,596,4772,56
2022-06-03,Kern,029,883053,197006,195863,48707,244570,2338
2022-06-03,Kings,031,150075,52817,52597,3723,56320,447
2022-06-03,Lake,033,64148,11167,11064,963,12027,137
2022-06-03,Lassen,035,31185,9142,9106,917,10023,64
2022-06-03,Los Angeles,037,10098052,2871681,2846989,137045,2984034,31899
2022-06-03,Madera,039,155013,38455,38188,6518,44706,372
2022-06-03,Marin,041,260295,38365,37879,4193,42072,294
2022-06-03,Mariposa,043,17540,2618,2557,246,2803,30
2022-06-03,Mendocino,045,87422,13896,13738,3536,17274,125
2022-06-03,Merced,047,269075,64178,63756,9393,73149,825
2022-06-03,Modoc,049,8938,762,759,261,1020,8
2022-06-03,Mono,051,14174,3045,3037,168,3205,6
2022-06-03,Monterey,053,433212,83239,82451,16230,98681,738
2022-06-03,Napa,055,140530,28063,27686,1191,28877,143
2022-06-03,Nevada,057,99092,16940,16728,1366,18094,127
2022-06-03,Orange,059,3164182,578845,574146,46807,620953,7038
2022-06-03,Placer,061,380077,67102,66428,8063,74491,627
2022-06-03,Plumas,063,18699,3163,3138,388,3526,13
2022-06-03,Riverside,065,2383286,614022,610369,30039,640408,6481
2022-06-03,Sacramento,067,1510023,300924,297787,30158,327945,3052
2022-06-03,San Benito,069,59416,13710,13572,624,14196,99
2022-06-03,San Bernardino,071,2135413,587740,582305,26244,608549,7664
2022-06-03,San Diego,073,3302833,799399,794822,57706,852528,5303
2022-06-03,San Francisco,075,870044,148043,145876,9905,155781,881
2022-06-03,San Joaquin,077,732212,174149,172621,11493,184114,2242
2022-06-03,San Luis Obispo,079,281455,55931,55333,4859,60192,484
2022-06-03,San Mateo,081,765935,140570,138536,8919,147455,710
2022-06-03,Santa Barbara,083,443738,91778,90911,5299,96210,693
2022-06-03,Santa Clara,085,1922200,356770,351492,15422,366914,2317
2022-06-03,Santa Cruz,087,273765,52889,52333,2565,54898,263
2022-06-03,Shasta,089,179085,31442,31272,6329,37601,565
2022-06-03,Sierra,091,2930,279,278,56,334,4
2022-06-03,Siskiyou,093,43540,4619,4591,2892,7483,81
2022-06-03,Solano,095,438530,89097,87571,6296,93867,452
2022-06-03,Sonoma,097,501317,92763,91518,3866,95384,491
2022-06-03,Stanislaus,099,539301,121887,121001,18505,139506,1661
2022-06-03,Sutter,101,95872,21223,21125,2273,23398,227
2022-06-03,Tehama,103,63373,12311,12262,2720,14982,204
2022-06-03,Trinity,105,12862,1210,1204,298,1502,20
2022-06-03,Tulare,107,460477,109140,108598,30257,138855,1490
2022-06-03,Tuolumne,109,53932,13369,13251,638,13889,189
2022-06-03,Ventura,111,848112,183059,181709,10944,192653,1505
2022-06-03,Yolo,113,214977,41137,39561,3598,43159,321
2022-06-03,Yuba,115,75493,16563,16467,1387,17854,122
2022-06-02,Alameda,001,1643700,289176,285785,16439,302224,1873
2022-06-02,Alpine,003,1148,128,128,1,129,0
2022-06-02,Amador,005,37829,8884,8775,707,9482,87
2022-06-02,Butte,007,227075,34383,34129,7241,41370,427
2022-06-02,Calaveras,009,45235,7564,7525,405,7930,121
2022-06-02,Colusa,011,21464,3498,3484,1106,4590,21
2022-06-02,Contra Costa,013,1133247,209482,206711,15633,222344,1310
2022-06-02,Del Norte,015,27424,6226,6206,273,6479,52
2022-06-02,El Dorado,017,186661,28457,28241,3532,31773,214
2022-06-02,Fresno,019,978130,239117,237945,25270,263215,2766
2022-06-02,Glenn,021,27897,5089,5063,1651,6714,48
2022-06-02,Humboldt,023,135768,18578,18433,3606,22039,147
2022-06-02,Imperial,025,180216,56898,56690,11274,67964,941
2022-06-02,Inyo,027,18085,4196,4176,593,4769,56
2022-06-02,Kern,029,883053,196723,195863,48594,244457,2338
2022-06-02,Kings,031,150075,52764,52597,3717,56314,447
2022-06-02,Lake,033,64148,11145,11064,961,12025,137
2022-06-02,Lassen,035,31185,9131,9106,917,10023,64
2022-06-02,Los Angeles,037,10098052,2866849,2846989,136625,2983614,31899
2022-06-02,Madera,039,155013,38402,38188,6504,44692,372
2022-06-02,Marin,041,260295,38266,37879,4165,42044,294
2022-06-02,Mariposa,043,17540,2613,2557,244,2801,30
2022-06-02,Mendocino,045,87422,13867,13738,3528,17266,125
2022-06-02,Merced,047,269075,64101,63756,9384,73140,825
2022-06-02,Modoc,049,8938,761,759,261,1020,8
2022-06-02,Mono,051,14174,3045,3037,167,3204,6
2022-06-02,Monterey,053,433212,83090,82451,16159,98610,738
2022-06-02,Napa,055,140530,27987,27686,1187,28873,143
2022-06-02,Nevada,057,99092,16903,16728,1362,18090,127
2022-06-02,Orange,059,3164182,577809,574146,46654,620800,7038
2022-06-02,Placer,061,380077,66983,66428,8051,74479,627
2022-06-02,Plumas,063,18699,3154,3138,388,3526,13
2022-06-02,Riverside,065,2383286,613340,610369,29976,640345,6481
2022-06-02,Sacramento,067,1510023,300292,297787,30047,327834,3052
2022-06-02,San Benito,069,59416,13678,13572,621,14193,99
2022-06-02,San Bernardino,071,2135413,587070,582305,26194,608499,7664
2022-06-02,San Diego,073,3302833,798034,794822,57543,852365,5303
2022-06-02,San Francisco,075,870044,147618,145876,9849,155725,881
2022-06-02,San Joaquin,077,732212,173839,172621,11463,184084,2242
2022-06-02,San Luis Obispo,079,281455,55800,55333,4822,60155,484
2022-06-02,San Mateo,081,765935,140194,138536,8864,147400,710
2022-06-02,Santa Barbara,083,443738,91604,90911,5282,96193,693
2022-06-02,Santa Clara,085,1922200,355670,351492,15303,366795,2317
2022-06-02,Santa Cruz,087,273765,52774,52333,2552,54885,263
2022-06-02,Shasta,089,179085,31413,31272,6321,37593,565
2022-06-02,Sierra,091,2930,279,278,56,334,4
2022-06-02,Siskiyou,093,43540,4612,4591,2882,7473,81
2022-06-02,Solano,095,438530,88814,87571,6286,93857,452
2022-06-02,Sonoma,097,501317,92539,91518,3838,95356,491
2022-06-02,Stanislaus,099,539301,121727,121001,18478,139479,1661
2022-06-02,Sutter,101,95872,21195,21125,2267,23392,227
2022-06-02,Tehama,103,63373,12300,12262,2713,14975,204
2022-06-02,Trinity,105,12862,1208,1204,298,1502,20
2022-06-02,Tulare,107,460477,109017,108598,30181,138779,1490
2022-06-02,Tuolumne,109,53932,13350,13251,634,13885,189
2022-06-02,Ventura,111,848112,182787,181709,10907,192616,1505
2022-06-02,Yolo,113,214977,41027,39561,3588,43149,321
2022-06-02,Yuba,115,75493,16542,16467,1380,17847,122
2022-06-01,Alameda,001,1643700,288170,284051,16367,300418,1868
2022-06-01,Alpine,003,1148,128,128,1,129,0
2022-06-01,Amador,005,37829,8878,8741,705,9446,87
2022-06-01,Butte,007,227075,34313,34059,7226,41285,427
2022-06-01,Calaveras,009,45235,7559,7502,402,7904,120
2022-06-01,Colusa,011,21464,3495,3476,1106,4582,21
2022-06-01,Contra Costa,013,1133247,208844,205699,15547,221246,1310
2022-06-01,Del Norte,015,27424,6218,6188,269,6457,51
2022-06-01,El Dorado,017,186661,28396,28133,3513,31646,214
2022-06-01,Fresno,019,978130,238762,237367,25214,262581,2765
2022-06-01,Glenn,021,27897,5084,5059,1651,6710,48
2022-06-01,Humboldt,023,135768,18535,18371,3582,21953,147
2022-06-01,Imperial,025,180216,56831,56445,11243,67688,938
2022-06-01,Inyo,027,18085,4192,4171,587,4758,56
2022-06-01,Kern,029,883053,196497,195438,48511,243949,2336
2022-06-01,Kings,031,150075,52708,52491,3711,56202,447
2022-06-01,Lake,033,64148,11124,11024,956,11980,137
2022-06-01,Lassen,035,31185,9118,9083,915,9998,64
2022-06-01,Los Angeles,037,10098052,2861545,2836856,136202,2973058,31882
2022-06-01,Madera,039,155013,38364,38115,6492,44607,372
2022-06-01,Marin,041,260295,38152,37654,4124,41778,293
2022-06-01,Mariposa,043,17540,2598,2549,242,2791,30
2022-06-01,Mendocino,045,87422,13841,13692,3512,17204,125
2022-06-01,Merced,047,269075,64025,63637,9365,73002,824
2022-06-01,Modoc,049,8938,760,755,259,1014,8
2022-06-01,Mono,051,14174,3043,3035,166,3201,6
2022-06-01,Monterey,053,433212,82935,82215,16096,98311,737
2022-06-01,Napa,055,140530,27910,27580,1178,28758,143
2022-06-01,Nevada,057,99092,16864,16693,1351,18044,127
2022-06-01,Orange,059,3164182,576554,571973,46492,618465,7032
2022-06-01,Placer,061,380077,66843,66199,8036,74235,627
2022-06-01,Plumas,063,18699,3147,3117,387,3504,13
2022-06-01,Riverside,065,2383286,612605,608913,29927,638840,6480
2022-06-01,Sacramento,067,1510023,299546,296457,29934,326391,3045
2022-06-01,San Benito,069,59416,13640,13510,610,14120,98
2022-06-01,San Bernardino,071,2135413,586373,580767,26148,606915,7641
2022-06-01,San Diego,073,3302833,796340,791557,57346,848903,5292
2022-06-01,San Francisco,075,870044,147098,144476,9805,154281,879
2022-06-01,San Joaquin,077,732212,173542,172170,11428,183598,2241
2022-06-01,San Luis Obispo,079,281455,55634,55099,4788,59887,482
2022-06-01,San Mateo,081,765935,139713,137566,8786,146352,710
2022-06-01,Santa Barbara,083,443738,91422,90531,5265,95796,693
2022-06-01,Santa Clara,085,1922200,354505,348742,15220,363962,2317
2022-06-01,Santa Cruz,087,273765,52663,52141,2541,54682,263
2022-06-01,Shasta,089,179085,31382,31247,6317,37564,564
2022-06-01,Sierra,091,2930,279,280,56,336,4
2022-06-01,Siskiyou,093,43540,4607,4574,2875,7449,81
2022-06-01,Solano,095,438530,88581,87206,6254,93460,452
2022-06-01,Sonoma,097,501317,92291,91174,3813,94987,491
2022-06-01,Stanislaus,099,539301,121536,120778,18459,139237,1656
2022-06-01,Sutter,101,95872,21164,21065,2262,23327,227
2022-06-01,Tehama,103,63373,12293,12245,2709,14954,204
2022-06-01,Trinity,105,12862,1207,1200,297,1497,20
2022-06-01,Tulare,107,460477,108902,108401,30118,138519,1490
2022-06-01,Tuolumne,109,53932,13336,13221,633,13854,189
2022-06-01,Ventura,111,848112,182503,181163,10872,192035,1503
2022-06-01,Yolo,113,214977,40942,39371,3575,42946,320
2022-06-01,Yuba,115,75493,16518,16406,1372,17778,122
2022-05-31,Alameda,001,1643700,287076,284051,16305,300356,1868
2022-05-31,Alpine,003,1148,128,128,1,129,0
2022-05-31,Amador,005,37829,8860,8741,699,9440,87
2022-05-31,Butte,007,227075,34248,34059,7205,41264,427
2022-05-31,Calaveras,009,45235,7548,7502,402,7904,120
2022-05-31,Colusa,011,21464,3490,3476,1105,4581,21
2022-05-31,Contra Costa,013,1133247,208100,205699,15451,221150,1310
2022-05-31,Del Norte,015,27424,6210,6188,267,6455,51
2022-05-31,El Dorado,017,186661,28334,28133,3492,31625,214
2022-05-31,Fresno,019,978130,238359,237367,25146,262513,2765
2022-05-31,Glenn,021,27897,5076,5059,1649,6708,48
2022-05-31,Humboldt,023,135768,18505,18371,3556,21927,147
2022-05-31,Imperial,025,180216,56767,56445,11218,67663,938
2022-05-31,Inyo,027,18085,4186,4171,585,4756,56
2022-05-31,Kern,029,883053,196252,195438,48415,243853,2336
2022-05-31,Kings,031,150075,52657,52491,3704,56195,447
2022-05-31,Lake,033,64148,11105,11024,952,11976,137
2022-05-31,Lassen,035,31185,9106,9083,914,9997,64
2022-05-31,Los Angeles,037,10098052,2855579,2836856,135750,2972606,31882
2022-05-31,Madera,039,155013,38299,38115,6470,44585,372
2022-05-31,Marin,041,260295,38015,37654,4084,41738,293
2022-05-31,Mariposa,043,17540,2592,2549,237,2786,30
2022-05-31,Mendocino,045,87422,13806,13692,3495,17187,125
2022-05-31,Merced,047,269075,63939,63637,9339,72976,824
2022-05-31,Modoc,049,8938,758,755,259,1014,8
2022-05-31,Mono,051,14174,3039,3035,165,3200,6
2022-05-31,Monterey,053,433212,82778,82215,16024,98239,737
2022-05-31,Napa,055,140530,27818,27580,1173,28753,143
2022-05-31,Nevada,057,99092,16818,16693,1348,18041,127
2022-05-31,Orange,059,3164182,575316,571973,46297,618270,7032
2022-05-31,Placer,061,380077,66684,66199,8018,74217,627
2022-05-31,Plumas,063,18699,3144,3117,386,3503,13
2022-05-31,Riverside,065,2383286,611694,608913,29859,638772,6480
2022-05-31,Sacramento,067,1510023,298683,296457,29783,326240,3045
2022-05-31,San Benito,069,59416,13584,13510,604,14114,98
2022-05-31,San Bernardino,071,2135413,585497,580767,26112,606879,7641
2022-05-31,San Diego,073,3302833,794461,791557,57146,848703,5292
2022-05-31,San Francisco,075,870044,146451,144476,9763,154239,879
2022-05-31,San Joaquin,077,732212,173163,172170,11378,183548,2241
2022-05-31,San Luis Obispo,079,281455,55484,55099,4717,59816,482
2022-05-31,San Mateo,081,765935,139158,137566,8739,146305,710
2022-05-31,Santa Barbara,083,443738,91198,90531,5241,95772,693
2022-05-31,Santa Clara,085,1922200,352999,348742,15141,363883,2317
2022-05-31,Santa Cruz,087,273765,52545,52141,2517,54658,263
2022-05-31,Shasta,089,179085,31345,31247,6306,37553,564
2022-05-31,Sierra,091,2930,278,280,55,335,4
2022-05-31,Siskiyou,093,43540,4602,4574,2868,7442,81
2022-05-31,Solano,095,438530,88251,87206,6231,93437,452
2022-05-31,Sonoma,097,501317,92003,91174,3773,94947,491
2022-05-31,Stanislaus,099,539301,121329,120778,18435,139213,1656
2022-05-31,Sutter,101,95872,21135,21065,2256,23321,227
2022-05-31,Tehama,103,63373,12284,12245,2704,14949,204
2022-05-31,Trinity,105,12862,1206,1200,297,1497,20
2022-05-31,Tulare,107,460477,108764,108401,30053,138454,1490
2022-05-31,Tuolumne,109,53932,13320,13221,630,13851,189
2022-05-31,Ventura,111,848112,182180,181163,10821,191984,1503
2022-05-31,Yolo,113,214977,40770,39371,3562,42933,320
2022-05-31,Yuba,115,75493,16485,16406,1365,17771,122
2022-05-30,Alameda,001,1643700,285702,284051,16212,300263,1868
2022-05-30,Alpine,003,1148,128,128,1,129,0
2022-05-30,Amador,005,37829,8845,8741,698,9439,87
2022-05-30,Butte,007,227075,34172,34059,7181,41240,427
2022-05-30,Calaveras,009,45235,7539,7502,402,7904,120
2022-05-30,Colusa,011,21464,3488,3476,1104,4580,21
2022-05-30,Contra Costa,013,1133247,207255,205699,15298,220997,1310
2022-05-30,Del Norte,015,27424,6195,6188,266,6454,51
2022-05-30,El Dorado,017,186661,28258,28133,3472,31605,214
2022-05-30,Fresno,019,978130,237891,237367,25066,262433,2765
2022-05-30,Glenn,021,27897,5071,5059,1646,6705,48
2022-05-30,Humboldt,023,135768,18451,18371,3525,21896,147
2022-05-30,Imperial,025,180216,56685,56445,11184,67629,938
2022-05-30,Inyo,027,18085,4181,4171,584,4755,56
2022-05-30,Kern,029,883053,195967,195438,48298,243736,2336
2022-05-30,Kings,031,150075,52560,52491,3704,56195,447
2022-05-30,Lake,033,64148,11076,11024,943,11967,137
2022-05-30,Lassen,035,31185,9092,9083,910,9993,64
2022-05-30,Los Angeles,037,10098052,2848329,2836856,135248,2972104,31882
2022-05-30,Madera,039,155013,38244,38115,6427,44542,372
2022-05-30,Marin,041,260295,37890,37654,4042,41696,293
2022-05-30,Mariposa,043,17540,2569,2549,233,2782,30
2022-05-30,Mendocino,045,87422,13758,13692,3477,17169,125
2022-05-30,Merced,047,269075,63845,63637,9299,72936,824
2022-05-30,Modoc,049,8938,755,755,257,1012,8
2022-05-30,Mono,051,14174,3036,3035,165,3200,6
2022-05-30,Monterey,053,433212,82589,82215,15931,98146,737
2022-05-30,Napa,055,140530,27741,27580,1165,28745,143
2022-05-30,Nevada,057,99092,16771,16693,1343,18036,127
2022-05-30,Orange,059,3164182,573843,571973,46077,618050,7032
2022-05-30,Placer,061,380077,66544,66199,7996,74195,627
2022-05-30,Plumas,063,18699,3138,3117,383,3500,13
2022-05-30,Riverside,065,2383286,610686,608913,29770,638683,6480
2022-05-30,Sacramento,067,1510023,297725,296457,29617,326074,3045
2022-05-30,San Benito,069,59416,13523,13510,596,14106,98
2022-05-30,San Bernardino,071,2135413,584512,580767,26068,606835,7641
2022-05-30,San Diego,073,3302833,792178,791557,56842,848399,5292
2022-05-30,San Francisco,075,870044,145789,144476,9707,154183,879
2022-05-30,San Joaquin,077,732212,172768,172170,11332,183502,2241
2022-05-30,San Luis Obispo,079,281455,55281,55099,4642,59741,482
2022-05-30,San Mateo,081,765935,138483,137566,8685,146251,710
2022-05-30,Santa Barbara,083,443738,90942,90531,5202,95733,693
2022-05-30,Santa Clara,085,1922200,351443,348742,15049,363791,2317
2022-05-30,Santa Cruz,087,273765,52406,52141,2504,54645,263
2022-05-30,Shasta,089,179085,31307,31247,6298,37545,564
2022-05-30,Sierra,091,2930,278,280,55,335,4
2022-05-30,Siskiyou,093,43540,4593,4574,2856,7430,81
2022-05-30,Solano,095,438530,87908,87206,6173,93379,452
2022-05-30,Sonoma,097,501317,91719,91174,3727,94901,491
2022-05-30,Stanislaus,099,539301,121138,120778,18404,139182,1656
2022-05-30,Sutter,101,95872,21096,21065,2250,23315,227
2022-05-30,Tehama,103,63373,12268,12245,2700,14945,204
2022-05-30,Trinity,105,12862,1205,1200,297,1497,20
2022-05-30,Tulare,107,460477,108603,108401,29953,138354,1490
2022-05-30,Tuolumne,109,53932,13296,13221,626,13847,189
2022-05-30,Ventura,111,848112,181806,181163,10766,191929,1503
2022-05-30,Yolo,113,214977,40580,39371,3549,42920,320
2022-05-30,Yuba,115,75493,16457,16406,1361,17767,122
2022-05-29,Alameda,001,1643700,285221,280775,16186,296961,1863
2022-05-29,Alpine,003,1148,128,126,1,127,0
2022-05-29,Amador,005,37829,8839,8696,695,9391,86
2022-05-29,Butte,007,227075,34157,33876,7173,41049,426
2022-05-29,Calaveras,009,45235,7528,7469,402,7871,120
2022-05-29,Colusa,011,21464,3487,3474,1103,4577,21
2022-05-29,Contra Costa,013,1133247,206914,203528,15275,218803,1306
2022-05-29,Del Norte,015,27424,6193,6166,264,6430,51
2022-05-29,El Dorado,017,186661,28231,27898,3466,31364,214
2022-05-29,Fresno,019,978130,237763,236250,25046,261296,2764
2022-05-29,Glenn,021,27897,5066,5048,1646,6694,48
2022-05-29,Humboldt,023,135768,18430,18257,3514,21771,147
2022-05-29,Imperial,025,180216,56648,56323,11168,67491,939
2022-05-29,Inyo,027,18085,4180,4161,584,4745,56
2022-05-29,Kern,029,883053,195866,194687,48227,242914,2334
2022-05-29,Kings,031,150075,52534,52292,3703,55995,447
2022-05-29,Lake,033,64148,11067,10958,941,11899,137
2022-05-29,Lassen,035,31185,9088,9049,910,9959,64
2022-05-29,Los Angeles,037,10098052,2846165,2819145,134985,2954130,31862
2022-05-29,Madera,039,155013,38222,37955,6419,44374,371
2022-05-29,Marin,041,260295,37823,37215,4009,41224,293
2022-05-29,Mariposa,043,17540,2564,2526,233,2759,31
2022-05-29,Mendocino,045,87422,13738,13612,3476,17088,124
2022-05-29,Merced,047,269075,63825,63389,9296,72685,824
2022-05-29,Modoc,049,8938,755,751,257,1008,8
2022-05-29,Mono,051,14174,3035,3030,165,3195,6
2022-05-29,Monterey,053,433212,82525,81875,15885,97760,737
2022-05-29,Napa,055,140530,27713,27376,1164,28540,144
2022-05-29,Nevada,057,99092,16756,16568,1341,17909,127
2022-05-29,Orange,059,3164182,573260,568369,45902,614271,7028
2022-05-29,Placer,061,380077,66474,65672,7990,73662,626
2022-05-29,Plumas,063,18699,3131,3096,383,3479,13
2022-05-29,Riverside,065,2383286,610347,606444,29732,636176,6480
2022-05-29,Sacramento,067,1510023,297275,294000,29595,323595,3032
2022-05-29,San Benito,069,59416,13517,13402,594,13996,98
2022-05-29,San Bernardino,071,2135413,584225,578656,26052,604708,7610
2022-05-29,San Diego,073,3302833,791439,786243,56762,843005,5288
2022-05-29,San Francisco,075,870044,145358,142456,9696,152152,879
2022-05-29,San Joaquin,077,732212,172606,171282,11320,182602,2241
2022-05-29,San Luis Obispo,079,281455,55229,54701,4630,59331,481
2022-05-29,San Mateo,081,765935,138235,135746,8672,144418,710
2022-05-29,Santa Barbara,083,443738,90811,89940,5200,95140,693
2022-05-29,Santa Clara,085,1922200,350646,344223,15007,359230,2304
2022-05-29,Santa Cruz,087,273765,52330,51819,2497,54316,263
2022-05-29,Shasta,089,179085,31296,31165,6296,37461,564
2022-05-29,Sierra,091,2930,278,278,55,333,4
2022-05-29,Siskiyou,093,43540,4588,4537,2854,7391,81
2022-05-29,Solano,095,438530,87855,86565,6162,92727,452
2022-05-29,Sonoma,097,501317,91627,90364,3711,94075,490
2022-05-29,Stanislaus,099,539301,121039,120241,18386,138627,1657
2022-05-29,Sutter,101,95872,21076,20976,2250,23226,227
2022-05-29,Tehama,103,63373,12257,12210,2699,14909,204
2022-05-29,Trinity,105,12862,1204,1196,297,1493,20
2022-05-29,Tulare,107,460477,108523,108029,29904,137933,1484
2022-05-29,Tuolumne,109,53932,13281,13141,626,13767,189
2022-05-29,Ventura,111,848112,181665,179953,10756,190709,1503
2022-05-29,Yolo,113,214977,40530,39016,3546,42562,319
2022-05-29,Yuba,115,75493,16441,16314,1356,17670,122
2022-05-28,Alameda,001,1643700,284850,280775,16161,296936,1863
2022-05-28,Alpine,003,1148,128,126,1,127,0
2022-05-28,Amador,005,37829,8830,8696,695,9391,86
2022-05-28,Butte,007,227075,34137,33876,7157,41033,426
2022-05-28,Calaveras,009,45235,7524,7469,402,7871,120
2022-05-28,Colusa,011,21464,3482,3474,1102,4576,21
2022-05-28,Contra Costa,013,1133247,206648,203528,15260,218788,1306
2022-05-28,Del Norte,015,27424,6190,6166,264,6430,51
2022-05-28,El Dorado,017,186661,28201,27898,3465,31363,214
2022-05-28,Fresno,019,978130,237606,236250,25019,261269,2764
2022-05-28,Glenn,021,27897,5063,5048,1646,6694,48
2022-05-28,Humboldt,023,135768,18406,18257,3512,21769,147
2022-05-28,Imperial,025,180216,56622,56323,11157,67480,939
2022-05-28,Inyo,027,18085,4180,4161,581,4742,56
2022-05-28,Kern,029,883053,195764,194687,48174,242861,2334
2022-05-28,Kings,031,150075,52510,52292,3702,55994,447
2022-05-28,Lake,033,64148,11057,10958,940,11898,137
2022-05-28,Lassen,035,31185,9083,9049,910,9959,64
2022-05-28,Los Angeles,037,10098052,2844218,2819145,134721,2953866,31862
2022-05-28,Madera,039,155013,38205,37955,6417,44372,371
2022-05-28,Marin,041,260295,37758,37215,3978,41193,293
2022-05-28,Mariposa,043,17540,2560,2526,233,2759,31
2022-05-28,Mendocino,045,87422,13726,13612,3475,17087,124
2022-05-28,Merced,047,269075,63794,63389,9289,72678,824
2022-05-28,Modoc,049,8938,755,751,257,1008,8
2022-05-28,Mono,051,14174,3035,3030,164,3194,6
2022-05-28,Monterey,053,433212,82459,81875,15854,97729,737
2022-05-28,Napa,055,140530,27668,27376,1162,28538,144
2022-05-28,Nevada,057,99092,16744,16568,1339,17907,127
2022-05-28,Orange,059,3164182,572742,568369,45780,614149,7028
2022-05-28,Placer,061,380077,66400,65672,7977,73649,626
2022-05-28,Plumas,063,18699,3125,3096,382,3478,13
2022-05-28,Riverside,065,2383286,609973,606444,29707,636151,6480
2022-05-28,Sacramento,067,1510023,296999,294000,29578,323578,3032
2022-05-28,San Benito,069,59416,13502,13402,593,13995,98
2022-05-28,San Bernardino,071,2135413,583867,578656,26025,604681,7610
2022-05-28,San Diego,073,3302833,790779,786243,56720,842963,5288
2022-05-28,San Francisco,075,870044,145054,142456,9673,152129,879
2022-05-28,San Joaquin,077,732212,172502,171282,11310,182592,2241
2022-05-28,San Luis Obispo,079,281455,55194,54701,4625,59326,481
2022-05-28,San Mateo,081,765935,137961,135746,8649,144395,710
2022-05-28,Santa Barbara,083,443738,90710,89940,5191,95131,693
2022-05-28,Santa Clara,085,1922200,349859,344223,14979,359202,2304
2022-05-28,Santa Cruz,087,273765,52289,51819,2489,54308,263
2022-05-28,Shasta,089,179085,31285,31165,6291,37456,564
2022-05-28,Sierra,091,2930,278,278,54,332,4
2022-05-28,Siskiyou,093,43540,4580,4537,2849,7386,81
2022-05-28,Solano,095,438530,87783,86565,6153,92718,452
2022-05-28,Sonoma,097,501317,91486,90364,3700,94064,490
2022-05-28,Stanislaus,099,539301,120940,120241,18379,138620,1657
2022-05-28,Sutter,101,95872,21061,20976,2246,23222,227
2022-05-28,Tehama,103,63373,12245,12210,2696,14906,204
2022-05-28,Trinity,105,12862,1203,1196,297,1493,20
2022-05-28,Tulare,107,460477,108465,108029,29869,137898,1484
2022-05-28,Tuolumne,109,53932,13266,13141,625,13766,189
2022-05-28,Ventura,111,848112,181497,179953,10735,190688,1503
2022-05-28,Yolo,113,214977,40476,39016,3540,42556,319
2022-05-28,Yuba,115,75493,16427,16314,1354,17668,122
2022-05-27,Alameda,001,1643700,284382,280775,16135,296910,1863
2022-05-27,Alpine,003,1148,127,126,1,127,0
2022-05-27,Amador,005,37829,8825,8696,695,9391,86
2022-05-27,Butte,007,227075,34113,33876,7142,41018,426
2022-05-27,Calaveras,009,45235,7517,7469,402,7871,120
2022-05-27,Colusa,011,21464,3482,3474,1102,4576,21
2022-05-27,Contra Costa,013,1133247,206365,203528,15241,218769,1306
2022-05-27,Del Norte,015,27424,6184,6166,264,6430,51
2022-05-27,El Dorado,017,186661,28177,27898,3457,31355,214
2022-05-27,Fresno,019,978130,237436,236250,24993,261243,2764
2022-05-27,Glenn,021,27897,5061,5048,1646,6694,48
2022-05-27,Humboldt,023,135768,18396,18257,3507,21764,147
2022-05-27,Imperial,025,180216,56539,56323,11150,67473,939
2022-05-27,Inyo,027,18085,4178,4161,580,4741,56
2022-05-27,Kern,029,883053,195655,194687,48105,242792,2334
2022-05-27,Kings,031,150075,52482,52292,3699,55991,447
2022-05-27,Lake,033,64148,11051,10958,936,11894,137
2022-05-27,Lassen,035,31185,9079,9049,910,9959,64
2022-05-27,Los Angeles,037,10098052,2841903,2819145,134473,2953618,31862
2022-05-27,Madera,039,155013,38171,37955,6412,44367,371
2022-05-27,Marin,041,260295,37693,37215,3943,41158,293
2022-05-27,Mariposa,043,17540,2554,2526,233,2759,31
2022-05-27,Mendocino,045,87422,13710,13612,3470,17082,124
2022-05-27,Merced,047,269075,63751,63389,9283,72672,824
2022-05-27,Modoc,049,8938,755,751,257,1008,8
2022-05-27,Mono,051,14174,3034,3030,164,3194,6
2022-05-27,Monterey,053,433212,82400,81875,15811,97686,737
2022-05-27,Napa,055,140530,27636,27376,1158,28534,144
2022-05-27,Nevada,057,99092,16733,16568,1336,17904,127
2022-05-27,Orange,059,3164182,572182,568369,45663,614032,7028
2022-05-27,Placer,061,380077,66329,65672,7969,73641,626
2022-05-27,Plumas,063,18699,3122,3096,382,3478,13
2022-05-27,Riverside,065,2383286,609564,606444,29677,636121,6480
2022-05-27,Sacramento,067,1510023,296623,294000,29538,323538,3032
2022-05-27,San Benito,069,59416,13491,13402,593,13995,98
2022-05-27,San Bernardino,071,2135413,583539,578656,26011,604667,7610
2022-05-27,San Diego,073,3302833,789906,786243,56666,842909,5288
2022-05-27,San Francisco,075,870044,144720,142456,9631,152087,879
2022-05-27,San Joaquin,077,732212,172373,171282,11289,182571,2241
2022-05-27,San Luis Obispo,079,281455,55134,54701,4611,59312,481
2022-05-27,San Mateo,081,765935,137714,135746,8626,144372,710
2022-05-27,Santa Barbara,083,443738,90621,89940,5189,95129,693
2022-05-27,Santa Clara,085,1922200,349105,344223,14961,359184,2304
2022-05-27,Santa Cruz,087,273765,52234,51819,2480,54299,263
2022-05-27,Shasta,089,179085,31276,31165,6285,37450,564
2022-05-27,Sierra,091,2930,278,278,54,332,4
2022-05-27,Siskiyou,093,43540,4577,4537,2847,7384,81
2022-05-27,Solano,095,438530,87658,86565,6141,92706,452
2022-05-27,Sonoma,097,501317,91339,90364,3688,94052,490
2022-05-27,Stanislaus,099,539301,120856,120241,18365,138606,1657
2022-05-27,Sutter,101,95872,21044,20976,2245,23221,227
2022-05-27,Tehama,103,63373,12242,12210,2695,14905,204
2022-05-27,Trinity,105,12862,1203,1196,297,1493,20
2022-05-27,Tulare,107,460477,108398,108029,29828,137857,1484
2022-05-27,Tuolumne,109,53932,13256,13141,625,13766,189
2022-05-27,Ventura,111,848112,181319,179953,10714,190667,1503
2022-05-27,Yolo,113,214977,40405,39016,3534,42550,319
2022-05-27,Yuba,115,75493,16413,16314,1352,17666,122
2022-05-26,Alameda,001,1643700,283533,280775,16059,296834,1863
2022-05-26,Alpine,003,1148,127,126,1,127,0
2022-05-26,Amador,005,37829,8812,8696,695,9391,86
2022-05-26,Butte,007,227075,34060,33876,7121,40997,426
2022-05-26,Calaveras,009,45235,7507,7469,402,7871,120
2022-05-26,Colusa,011,21464,3479,3474,1098,4572,21
2022-05-26,Contra Costa,013,1133247,205890,203528,15200,218728,1306
2022-05-26,Del Norte,015,27424,6176,6166,260,6426,51
2022-05-26,El Dorado,017,186661,28128,27898,3447,31345,214
2022-05-26,Fresno,019,978130,237179,236250,24948,261198,2764
2022-05-26,Glenn,021,27897,5056,5048,1646,6694,48
2022-05-26,Humboldt,023,135768,18357,18257,3495,21752,147
2022-05-26,Imperial,025,180216,56507,56323,11135,67458,939
2022-05-26,Inyo,027,18085,4177,4161,577,4738,56
2022-05-26,Kern,029,883053,195490,194687,48028,242715,2334
2022-05-26,Kings,031,150075,52432,52292,3695,55987,447
2022-05-26,Lake,033,64148,11036,10958,936,11894,137
2022-05-26,Lassen,035,31185,9070,9049,910,9959,64
2022-05-26,Los Angeles,037,10098052,2837747,2819145,134140,2953285,31862
2022-05-26,Madera,039,155013,38129,37955,6410,44365,371
2022-05-26,Marin,041,260295,37599,37215,3904,41119,293
2022-05-26,Mariposa,043,17540,2549,2526,233,2759,31
2022-05-26,Mendocino,045,87422,13684,13612,3460,17072,124
2022-05-26,Merced,047,269075,63686,63389,9275,72664,824
2022-05-26,Modoc,049,8938,754,751,257,1008,8
2022-05-26,Mono,051,14174,3033,3030,163,3193,6
2022-05-26,Monterey,053,433212,82321,81875,15761,97636,737
2022-05-26,Napa,055,140530,27584,27376,1158,28534,144
2022-05-26,Nevada,057,99092,16702,16568,1332,17900,127
2022-05-26,Orange,059,3164182,571274,568369,45536,613905,7028
2022-05-26,Placer,061,380077,66192,65672,7952,73624,626
2022-05-26,Plumas,063,18699,3118,3096,381,3477,13
2022-05-26,Riverside,065,2383286,608953,606444,29624,636068,6480
2022-05-26,Sacramento,067,1510023,295971,294000,29446,323446,3032
2022-05-26,San Benito,069,59416,13476,13402,591,13993,98
2022-05-26,San Bernardino,071,2135413,583005,578656,25996,604652,7610
2022-05-26,San Diego,073,3302833,788601,786243,56553,842796,5288
2022-05-26,San Francisco,075,870044,144259,142456,9584,152040,879
2022-05-26,San Joaquin,077,732212,172154,171282,11260,182542,2241
2022-05-26,San Luis Obispo,079,281455,55038,54701,4579,59280,481
2022-05-26,San Mateo,081,765935,137325,135746,8587,144333,710
2022-05-26,Santa Barbara,083,443738,90475,89940,5173,95113,693
2022-05-26,Santa Clara,085,1922200,348135,344223,14869,359092,2304
2022-05-26,Santa Cruz,087,273765,52143,51819,2474,54293,263
2022-05-26,Shasta,089,179085,31251,31165,6282,37447,564
2022-05-26,Sierra,091,2930,278,278,54,332,4
2022-05-26,Siskiyou,093,43540,4573,4537,2844,7381,81
2022-05-26,Solano,095,438530,87458,86565,6133,92698,452
2022-05-26,Sonoma,097,501317,91148,90364,3660,94024,490
2022-05-26,Stanislaus,099,539301,120750,120241,18352,138593,1657
2022-05-26,Sutter,101,95872,21024,20976,2242,23218,227
2022-05-26,Tehama,103,63373,12232,12210,2694,14904,204
2022-05-26,Trinity,105,12862,1201,1196,297,1493,20
2022-05-26,Tulare,107,460477,108330,108029,29769,137798,1484
2022-05-26,Tuolumne,109,53932,13236,13141,623,13764,189
2022-05-26,Ventura,111,848112,181055,179953,10681,190634,1503
2022-05-26,Yolo,113,214977,40300,39016,3524,42540,319
2022-05-26,Yuba,115,75493,16397,16314,1350,17664,122
2022-05-25,Alameda,001,1643700,282634,278228,15997,294225,1860
2022-05-25,Alpine,003,1148,126,126,1,127,0
2022-05-25,Amador,005,37829,8796,8654,693,9347,86
2022-05-25,Butte,007,227075,33996,33755,7098,40853,426
2022-05-25,Calaveras,009,45235,7499,7450,400,7850,120
2022-05-25,Colusa,011,21464,3478,3471,1096,4567,21
2022-05-25,Contra Costa,013,1133247,205336,201866,15142,217008,1306
2022-05-25,Del Norte,015,27424,6170,6145,254,6399,50
2022-05-25,El Dorado,017,186661,28076,27715,3440,31155,213
2022-05-25,Fresno,019,978130,236897,235569,24901,260470,2763
2022-05-25,Glenn,021,27897,5051,5030,1644,6674,48
2022-05-25,Humboldt,023,135768,18332,18133,3484,21617,147
2022-05-25,Imperial,025,180216,56450,56203,11124,67327,923
2022-05-25,Inyo,027,18085,4174,4152,577,4729,56
2022-05-25,Kern,029,883053,195296,194251,47939,242190,2336
2022-05-25,Kings,031,150075,52382,52178,3691,55869,447
2022-05-25,Lake,033,64148,11023,10908,935,11843,137
2022-05-25,Lassen,035,31185,9063,9028,910,9938,64
2022-05-25,Los Angeles,037,10098052,2833142,2806770,133775,2940545,31845
2022-05-25,Madera,039,155013,38089,37867,6402,44269,370
2022-05-25,Marin,041,260295,37499,36890,3877,40767,293
2022-05-25,Mariposa,043,17540,2539,2514,232,2746,30
2022-05-25,Mendocino,045,87422,13666,13545,3453,16998,124
2022-05-25,Merced,047,269075,63618,63220,9248,72468,823
2022-05-25,Modoc,049,8938,753,750,256,1006,8
2022-05-25,Mono,051,14174,3033,3024,162,3186,6
2022-05-25,Monterey,053,433212,82255,81592,15716,97308,737
2022-05-25,Napa,055,140530,27534,27240,1151,28391,143
2022-05-25,Nevada,057,99092,16667,16517,1325,17842,127
2022-05-25,Orange,059,3164182,570263,565564,45382,610946,7026
2022-05-25,Placer,061,380077,66043,65309,7935,73244,626
2022-05-25,Plumas,063,18699,3112,3065,380,3445,13
2022-05-25,Riverside,065,2383286,608279,604465,29565,634030,6480
2022-05-25,Sacramento,067,1510023,295328,292211,29332,321543,3028
2022-05-25,San Benito,069,59416,13441,13338,588,13926,98
2022-05-25,San Bernardino,071,2135413,582469,576982,25967,602949,7568
2022-05-25,San Diego,073,3302833,787141,782420,56415,838835,5284
2022-05-25,San Francisco,075,870044,143755,141015,9556,150571,872
2022-05-25,San Joaquin,077,732212,171920,170626,11238,181864,2238
2022-05-25,San Luis Obispo,079,281455,54932,54342,4529,58871,481
2022-05-25,San Mateo,081,765935,136868,134441,8530,142971,710
2022-05-25,Santa Barbara,083,443738,90309,89426,5162,94588,693
2022-05-25,Santa Clara,085,1922200,347063,340868,14752,355620,2304
2022-05-25,Santa Cruz,087,273765,52061,51644,2461,54105,263
2022-05-25,Shasta,089,179085,31224,31072,6273,37345,564
2022-05-25,Sierra,091,2930,278,277,54,331,4
2022-05-25,Siskiyou,093,43540,4563,4516,2841,7357,81
2022-05-25,Solano,095,438530,87249,86024,6115,92139,451
2022-05-25,Sonoma,097,501317,90955,89810,3621,93431,490
2022-05-25,Stanislaus,099,539301,120610,119894,18330,138224,1654
2022-05-25,Sutter,101,95872,21000,20904,2239,23143,226
2022-05-25,Tehama,103,63373,12226,12189,2690,14879,201
2022-05-25,Trinity,105,12862,1201,1194,297,1491,20
2022-05-25,Tulare,107,460477,108248,107790,29723,137513,1482
2022-05-25,Tuolumne,109,53932,13215,13086,620,13706,182
2022-05-25,Ventura,111,848112,180765,179116,10649,189765,1499
2022-05-25,Yolo,113,214977,40207,38782,3514,42296,319
2022-05-25,Yuba,115,75493,16370,16260,1343,17603,122
2022-05-24,Alameda,001,1643700,281760,278228,15941,294169,1860
2022-05-24,Alpine,003,1148,126,126,1,127,0
2022-05-24,Amador,005,37829,8789,8654,692,9346,86
2022-05-24,Butte,007,227075,33950,33755,7077,40832,426
2022-05-24,Calaveras,009,45235,7492,7450,398,7848,120
2022-05-24,Colusa,011,21464,3476,3471,1094,4565,21
2022-05-24,Contra Costa,013,1133247,204684,201866,15057,216923,1306
2022-05-24,Del Norte,015,27424,6165,6145,252,6397,50
2022-05-24,El Dorado,017,186661,28008,27715,3434,31149,213
2022-05-24,Fresno,019,978130,236578,235569,24864,260433,2763
2022-05-24,Glenn,021,27897,5049,5030,1644,6674,48
2022-05-24,Humboldt,023,135768,18300,18133,3468,21601,147
2022-05-24,Imperial,025,180216,56395,56203,11110,67313,923
2022-05-24,Inyo,027,18085,4166,4152,575,4727,56
2022-05-24,Kern,029,883053,195101,194251,47834,242085,2336
2022-05-24,Kings,031,150075,52315,52178,3684,55862,447
2022-05-24,Lake,033,64148,11006,10908,933,11841,137
2022-05-24,Lassen,035,31185,9050,9028,906,9934,64
2022-05-24,Los Angeles,037,10098052,2827879,2806770,133396,2940166,31845
2022-05-24,Madera,039,155013,38040,37867,6393,44260,370
2022-05-24,Marin,041,260295,37394,36890,3825,40715,293
2022-05-24,Mariposa,043,17540,2532,2514,231,2745,30
2022-05-24,Mendocino,045,87422,13642,13545,3445,16990,124
2022-05-24,Merced,047,269075,63556,63220,9217,72437,823
2022-05-24,Modoc,049,8938,752,750,255,1005,8
2022-05-24,Mono,051,14174,3030,3024,162,3186,6
2022-05-24,Monterey,053,433212,82164,81592,15655,97247,737
2022-05-24,Napa,055,140530,27487,27240,1139,28379,143
2022-05-24,Nevada,057,99092,16626,16517,1323,17840,127
2022-05-24,Orange,059,3164182,569225,565564,45207,610771,7026
2022-05-24,Placer,061,380077,65945,65309,7920,73229,626
2022-05-24,Plumas,063,18699,3106,3065,380,3445,13
2022-05-24,Riverside,065,2383286,607586,604465,29518,633983,6480
2022-05-24,Sacramento,067,1510023,294647,292211,29210,321421,3028
2022-05-24,San Benito,069,59416,13407,13338,587,13925,98
2022-05-24,San Bernardino,071,2135413,581855,576982,25934,602916,7568
2022-05-24,San Diego,073,3302833,785494,782420,56247,838667,5284
2022-05-24,San Francisco,075,870044,143211,141015,9536,150551,872
2022-05-24,San Joaquin,077,732212,171658,170626,11204,181830,2238
2022-05-24,San Luis Obispo,079,281455,54783,54342,4470,58812,481
2022-05-24,San Mateo,081,765935,136338,134441,8481,142922,710
2022-05-24,Santa Barbara,083,443738,90146,89426,5140,94566,693
2022-05-24,Santa Clara,085,1922200,345782,340868,14654,355522,2304
2022-05-24,Santa Cruz,087,273765,51985,51644,2451,54095,263
2022-05-24,Shasta,089,179085,31199,31072,6262,37334,564
2022-05-24,Sierra,091,2930,278,277,54,331,4
2022-05-24,Siskiyou,093,43540,4553,4516,2833,7349,81
2022-05-24,Solano,095,438530,87020,86024,6089,92113,451
2022-05-24,Sonoma,097,501317,90749,89810,3586,93396,490
2022-05-24,Stanislaus,099,539301,120471,119894,18298,138192,1654
2022-05-24,Sutter,101,95872,20979,20904,2234,23138,226
2022-05-24,Tehama,103,63373,12217,12189,2688,14877,201
2022-05-24,Trinity,105,12862,1198,1194,297,1491,20
2022-05-24,Tulare,107,460477,108131,107790,29663,137453,1482
2022-05-24,Tuolumne,109,53932,13200,13086,620,13706,182
2022-05-24,Ventura,111,848112,180452,179116,10624,189740,1499
2022-05-24,Yolo,113,214977,40102,38782,3506,42288,319
2022-05-24,Yuba,115,75493,16342,16260,1336,17596,122
2022-05-23,Alameda,001,1643700,280823,278228,15861,294089,1860
2022-05-23,Alpine,003,1148,126,126,1,127,0
2022-05-23,Amador,005,37829,8757,8654,689,9343,86
2022-05-23,Butte,007,227075,33899,33755,7052,40807,426
2022-05-23,Calaveras,009,45235,7485,7450,396,7846,120
2022-05-23,Colusa,011,21464,3475,3471,1091,4562,21
2022-05-23,Contra Costa,013,1133247,203951,201866,14992,216858,1306
2022-05-23,Del Norte,015,27424,6160,6145,248,6393,50
2022-05-23,El Dorado,017,186661,27926,27715,3427,31142,213
2022-05-23,Fresno,019,978130,236232,235569,24801,260370,2763
2022-05-23,Glenn,021,27897,5045,5030,1641,6671,48
2022-05-23,Humboldt,023,135768,18273,18133,3455,21588,147
2022-05-23,Imperial,025,180216,56349,56203,11088,67291,923
2022-05-23,Inyo,027,18085,4163,4152,573,4725,56
2022-05-23,Kern,029,883053,194879,194251,47743,241994,2336
2022-05-23,Kings,031,150075,52268,52178,3678,55856,447
2022-05-23,Lake,033,64148,10987,10908,933,11841,137
2022-05-23,Lassen,035,31185,9042,9028,903,9931,64
2022-05-23,Los Angeles,037,10098052,2822460,2806770,133029,2939799,31845
2022-05-23,Madera,039,155013,38009,37867,6376,44243,370
2022-05-23,Marin,041,260295,37253,36890,3781,40671,293
2022-05-23,Mariposa,043,17540,2530,2514,229,2743,30
2022-05-23,Mendocino,045,87422,13620,13545,3437,16982,124
2022-05-23,Merced,047,269075,63478,63220,9190,72410,823
2022-05-23,Modoc,049,8938,752,750,255,1005,8
2022-05-23,Mono,051,14174,3030,3024,162,3186,6
2022-05-23,Monterey,053,433212,82065,81592,15590,97182,737
2022-05-23,Napa,055,140530,27430,27240,1133,28373,143
2022-05-23,Nevada,057,99092,16591,16517,1322,17839,127
2022-05-23,Orange,059,3164182,568207,565564,45056,610620,7026
2022-05-23,Placer,061,380077,65801,65309,7898,73207,626
2022-05-23,Plumas,063,18699,3103,3065,379,3444,13
2022-05-23,Riverside,065,2383286,606861,604465,29469,633934,6480
2022-05-23,Sacramento,067,1510023,293903,292211,29082,321293,3028
2022-05-23,San Benito,069,59416,13372,13338,584,13922,98
2022-05-23,San Bernardino,071,2135413,581209,576982,25900,602882,7568
2022-05-23,San Diego,073,3302833,783773,782420,56059,838479,5284
2022-05-23,San Francisco,075,870044,142636,141015,9504,150519,872
2022-05-23,San Joaquin,077,732212,171389,170626,11173,181799,2238
2022-05-23,San Luis Obispo,079,281455,54636,54342,4424,58766,481
2022-05-23,San Mateo,081,765935,135769,134441,8445,142886,710
2022-05-23,Santa Barbara,083,443738,89911,89426,5121,94547,693
2022-05-23,Santa Clara,085,1922200,344405,340868,14572,355440,2304
2022-05-23,Santa Cruz,087,273765,51884,51644,2439,54083,263
2022-05-23,Shasta,089,179085,31177,31072,6257,37329,564
2022-05-23,Sierra,091,2930,278,277,54,331,4
2022-05-23,Siskiyou,093,43540,4539,4516,2829,7345,81
2022-05-23,Solano,095,438530,86747,86024,6072,92096,451
2022-05-23,Sonoma,097,501317,90518,89810,3539,93349,490
2022-05-23,Stanislaus,099,539301,120329,119894,18260,138154,1654
2022-05-23,Sutter,101,95872,20939,20904,2230,23134,226
2022-05-23,Tehama,103,63373,12205,12189,2685,14874,201
2022-05-23,Trinity,105,12862,1197,1194,297,1491,20
2022-05-23,Tulare,107,460477,108005,107790,29589,137379,1482
2022-05-23,Tuolumne,109,53932,13176,13086,618,13704,182
2022-05-23,Ventura,111,848112,180116,179116,10605,189721,1499
2022-05-23,Yolo,113,214977,39969,38782,3490,42272,319
2022-05-23,Yuba,115,75493,16313,16260,1332,17592,122
2022-05-22,Alameda,001,1643700,279735,274996,15754,290750,1858
2022-05-22,Alpine,003,1148,126,126,1,127,0
2022-05-22,Amador,005,37829,8740,8628,687,9315,86
2022-05-22,Butte,007,227075,33843,33606,7028,40634,426
2022-05-22,Calaveras,009,45235,7474,7424,391,7815,120
2022-05-22,Colusa,011,21464,3471,3468,1088,4556,21
2022-05-22,Contra Costa,013,1133247,203225,199703,14890,214593,1305
2022-05-22,Del Norte,015,27424,6145,6045,237,6282,50
2022-05-22,El Dorado,017,186661,27850,27517,3418,30935,213
2022-05-22,Fresno,019,978130,235893,234657,24755,259412,2760
2022-05-22,Glenn,021,27897,5035,5020,1641,6661,48
2022-05-22,Humboldt,023,135768,18220,17984,3430,21414,146
2022-05-22,Imperial,025,180216,56279,56014,11074,67088,923
2022-05-22,Inyo,027,18085,4156,4135,571,4706,56
2022-05-22,Kern,029,883053,194642,193705,47643,241348,2334
2022-05-22,Kings,031,150075,52205,52038,3673,55711,447
2022-05-22,Lake,033,64148,10955,10867,933,11800,137
2022-05-22,Lassen,035,31185,9026,9011,900,9911,64
2022-05-22,Los Angeles,037,10098052,2816591,2791671,132594,2924265,31815
2022-05-22,Madera,039,155013,37963,37744,6346,44090,370
2022-05-22,Marin,041,260295,37106,36394,3736,40130,293
2022-05-22,Mariposa,043,17540,2526,2490,227,2717,30
2022-05-22,Mendocino,045,87422,13592,13461,3412,16873,124
2022-05-22,Merced,047,269075,63399,62969,9156,72125,823
2022-05-22,Modoc,049,8938,751,750,255,1005,8
2022-05-22,Mono,051,14174,3029,3012,162,3174,6
2022-05-22,Monterey,053,433212,81907,81224,15488,96712,735
2022-05-22,Napa,055,140530,27360,27034,1126,28160,143
2022-05-22,Nevada,057,99092,16557,16410,1317,17727,127
2022-05-22,Orange,059,3164182,567111,562531,44856,607387,7025
2022-05-22,Placer,061,380077,65643,64802,7868,72670,626
2022-05-22,Plumas,063,18699,3096,3052,377,3429,13
2022-05-22,Riverside,065,2383286,606029,601808,29402,631210,6476
2022-05-22,Sacramento,067,1510023,293105,289972,28923,318895,3027
2022-05-22,San Benito,069,59416,13340,13234,578,13812,98
2022-05-22,San Bernardino,071,2135413,580498,575194,25860,601054,7523
2022-05-22,San Diego,073,3302833,782158,777404,55872,833276,5282
2022-05-22,San Francisco,075,870044,141944,138922,9485,148407,871
2022-05-22,San Joaquin,077,732212,171086,169745,11129,180874,2237
2022-05-22,San Luis Obispo,079,281455,54482,54012,4364,58376,481
2022-05-22,San Mateo,081,765935,135205,132636,8397,141033,711
2022-05-22,Santa Barbara,083,443738,89681,88783,5093,93876,692
2022-05-22,Santa Clara,085,1922200,342967,336488,14492,350980,2301
2022-05-22,Santa Cruz,087,273765,51793,51333,2427,53760,263
2022-05-22,Shasta,089,179085,31128,30966,6243,37209,564
2022-05-22,Sierra,091,2930,278,276,54,330,4
2022-05-22,Siskiyou,093,43540,4530,4501,2827,7328,81
2022-05-22,Solano,095,438530,86466,85038,6046,91084,451
2022-05-22,Sonoma,097,501317,90230,88889,3487,92376,489
2022-05-22,Stanislaus,099,539301,120155,119396,18235,137631,1653
2022-05-22,Sutter,101,95872,20910,20809,2221,23030,226
2022-05-22,Tehama,103,63373,12196,12162,2680,14842,201
2022-05-22,Trinity,105,12862,1197,1191,297,1488,20
2022-05-22,Tulare,107,460477,107900,107485,29508,136993,1477
2022-05-22,Tuolumne,109,53932,13156,12977,618,13595,182
2022-05-22,Ventura,111,848112,179759,178024,10576,188600,1499
2022-05-22,Yolo,113,214977,39842,38377,3465,41842,319
2022-05-22,Yuba,115,75493,16286,16180,1324,17504,122
2022-05-21,Alameda,001,1643700,279282,274996,15730,290726,1858
2022-05-21,Alpine,003,1148,126,126,1,127,0
2022-05-21,Amador,005,37829,8729,8628,686,9314,86
2022-05-21,Butte,007,227075,33824,33606,7016,40622,426
2022-05-21,Calaveras,009,45235,7468,7424,391,7815,120
2022-05-21,Colusa,011,21464,3471,3468,1087,4555,21
2022-05-21,Contra Costa,013,1133247,202867,199703,14874,214577,1305
2022-05-21,Del Norte,015,27424,6140,6045,235,6280,50
2022-05-21,El Dorado,017,186661,27814,27517,3416,30933,213
2022-05-21,Fresno,019,978130,235760,234657,24736,259393,2760
2022-05-21,Glenn,021,27897,5031,5020,1640,6660,48
2022-05-21,Humboldt,023,135768,18195,17984,3428,21412,146
2022-05-21,Imperial,025,180216,56244,56014,11071,67085,923
2022-05-21,Inyo,027,18085,4154,4135,569,4704,56
2022-05-21,Kern,029,883053,194547,193705,47577,241282,2334
2022-05-21,Kings,031,150075,52182,52038,3672,55710,447
2022-05-21,Lake,033,64148,10947,10867,933,11800,137
2022-05-21,Lassen,035,31185,9023,9011,900,9911,64
2022-05-21,Los Angeles,037,10098052,2814296,2791671,132352,2924023,31815
2022-05-21,Madera,039,155013,37945,37744,6341,44085,370
2022-05-21,Marin,041,260295,37012,36394,3691,40085,293
2022-05-21,Mariposa,043,17540,2524,2490,227,2717,30
2022-05-21,Mendocino,045,87422,13581,13461,3407,16868,124
2022-05-21,Merced,047,269075,63364,62969,9150,72119,823
2022-05-21,Modoc,049,8938,750,750,255,1005,8
2022-05-21,Mono,051,14174,3029,3012,162,3174,6
2022-05-21,Monterey,053,433212,81840,81224,15433,96657,735
2022-05-21,Napa,055,140530,27327,27034,1123,28157,143
2022-05-21,Nevada,057,99092,16551,16410,1317,17727,127
2022-05-21,Orange,059,3164182,566598,562531,44749,607280,7025
2022-05-21,Placer,061,380077,65535,64802,7854,72656,626
2022-05-21,Plumas,063,18699,3089,3052,377,3429,13
2022-05-21,Riverside,065,2383286,605558,601808,29375,631183,6476
2022-05-21,Sacramento,067,1510023,292778,289972,28895,318867,3027
2022-05-21,San Benito,069,59416,13328,13234,577,13811,98
2022-05-21,San Bernardino,071,2135413,580162,575194,25836,601030,7523
2022-05-21,San Diego,073,3302833,781468,777404,55817,833221,5282
2022-05-21,San Francisco,075,870044,141633,138922,9472,148394,871
2022-05-21,San Joaquin,077,732212,170968,169745,11110,180855,2237
2022-05-21,San Luis Obispo,079,281455,54403,54012,4351,58363,481
2022-05-21,San Mateo,081,765935,134893,132636,8377,141013,711
2022-05-21,Santa Barbara,083,443738,89589,88783,5090,93873,692
2022-05-21,Santa Clara,085,1922200,342117,336488,14450,350938,2301
2022-05-21,Santa Cruz,087,273765,51748,51333,2420,53753,263
2022-05-21,Shasta,089,179085,31116,30966,6240,37206,564
2022-05-21,Sierra,091,2930,277,276,54,330,4
2022-05-21,Siskiyou,093,43540,4526,4501,2825,7326,81
2022-05-21,Solano,095,438530,86382,85038,6043,91081,451
2022-05-21,Sonoma,097,501317,90104,88889,3481,92370,489
2022-05-21,Stanislaus,099,539301,120076,119396,18214,137610,1653
2022-05-21,Sutter,101,95872,20900,20809,2216,23025,226
2022-05-21,Tehama,103,63373,12194,12162,2679,14841,201
2022-05-21,Trinity,105,12862,1197,1191,297,1488,20
2022-05-21,Tulare,107,460477,107837,107485,29469,136954,1477
2022-05-21,Tuolumne,109,53932,13149,12977,618,13595,182
2022-05-21,Ventura,111,848112,179589,178024,10561,188585,1499
2022-05-21,Yolo,113,214977,39777,38377,3457,41834,319
2022-05-21,Yuba,115,75493,16273,16180,1322,17502,122
2022-05-20,Alameda,001,1643700,278743,274996,15708,290704,1858
2022-05-20,Alpine,003,1148,126,126,1,127,0
2022-05-20,Amador,005,37829,8722,8628,686,9314,86
2022-05-20,Butte,007,227075,33804,33606,7007,40613,426
2022-05-20,Calaveras,009,45235,7460,7424,391,7815,120
2022-05-20,Colusa,011,21464,3471,3468,1087,4555,21
2022-05-20,Contra Costa,013,1133247,202511,199703,14865,214568,1305
2022-05-20,Del Norte,015,27424,6136,6045,234,6279,50
2022-05-20,El Dorado,017,186661,27782,27517,3413,30930,213
2022-05-20,Fresno,019,978130,235602,234657,24712,259369,2760
2022-05-20,Glenn,021,27897,5028,5020,1640,6660,48
2022-05-20,Humboldt,023,135768,18173,17984,3426,21410,146
2022-05-20,Imperial,025,180216,56219,56014,11068,67082,923
2022-05-20,Inyo,027,18085,4151,4135,565,4700,56
2022-05-20,Kern,029,883053,194444,193705,47526,241231,2334
2022-05-20,Kings,031,150075,52167,52038,3671,55709,447
2022-05-20,Lake,033,64148,10930,10867,933,11800,137
2022-05-20,Lassen,035,31185,9021,9011,900,9911,64
2022-05-20,Los Angeles,037,10098052,2811954,2791671,132133,2923804,31815
2022-05-20,Madera,039,155013,37926,37744,6339,44083,370
2022-05-20,Marin,041,260295,36939,36394,3652,40046,293
2022-05-20,Mariposa,043,17540,2519,2490,227,2717,30
2022-05-20,Mendocino,045,87422,13566,13461,3406,16867,124
2022-05-20,Merced,047,269075,63329,62969,9147,72116,823
2022-05-20,Modoc,049,8938,750,750,255,1005,8
2022-05-20,Mono,051,14174,3025,3012,162,3174,6
2022-05-20,Monterey,053,433212,81781,81224,15400,96624,735
2022-05-20,Napa,055,140530,27297,27034,1120,28154,143
2022-05-20,Nevada,057,99092,16543,16410,1315,17725,127
2022-05-20,Orange,059,3164182,566021,562531,44644,607175,7025
2022-05-20,Placer,061,380077,65462,64802,7839,72641,626
2022-05-20,Plumas,063,18699,3087,3052,377,3429,13
2022-05-20,Riverside,065,2383286,605111,601808,29350,631158,6476
2022-05-20,Sacramento,067,1510023,292398,289972,28872,318844,3027
2022-05-20,San Benito,069,59416,13312,13234,577,13811,98
2022-05-20,San Bernardino,071,2135413,579841,575194,25819,601013,7523
2022-05-20,San Diego,073,3302833,780673,777404,55757,833161,5282
2022-05-20,San Francisco,075,870044,141301,138922,9441,148363,871
2022-05-20,San Joaquin,077,732212,170846,169745,11103,180848,2237
2022-05-20,San Luis Obispo,079,281455,54367,54012,4347,58359,481
2022-05-20,San Mateo,081,765935,134577,132636,8356,140992,711
2022-05-20,Santa Barbara,083,443738,89504,88783,5085,93868,692
2022-05-20,Santa Clara,085,1922200,341326,336488,14395,350883,2301
2022-05-20,Santa Cruz,087,273765,51704,51333,2400,53733,263
2022-05-20,Shasta,089,179085,31102,30966,6236,37202,564
2022-05-20,Sierra,091,2930,277,276,54,330,4
2022-05-20,Siskiyou,093,43540,4523,4501,2823,7324,81
2022-05-20,Solano,095,438530,86241,85038,6036,91074,451
2022-05-20,Sonoma,097,501317,89977,88889,3468,92357,489
2022-05-20,Stanislaus,099,539301,119994,119396,18205,137601,1653
2022-05-20,Sutter,101,95872,20891,20809,2216,23025,226
2022-05-20,Tehama,103,63373,12191,12162,2678,14840,201
2022-05-20,Trinity,105,12862,1197,1191,297,1488,20
2022-05-20,Tulare,107,460477,107780,107485,29428,136913,1477
2022-05-20,Tuolumne,109,53932,13130,12977,617,13594,182
2022-05-20,Ventura,111,848112,179393,178024,10551,188575,1499
2022-05-20,Yolo,113,214977,39705,38377,3452,41829,319
2022-05-20,Yuba,115,75493,16258,16180,1318,17498,122
2022-05-19,Alameda,001,1643700,277913,274996,15644,290640,1858
2022-05-19,Alpine,003,1148,126,126,1,127,0
2022-05-19,Amador,005,37829,8714,8628,686,9314,86
2022-05-19,Butte,007,227075,33773,33606,6998,40604,426
2022-05-19,Calaveras,009,45235,7454,7424,388,7812,120
2022-05-19,Colusa,011,21464,3470,3468,1086,4554,21
2022-05-19,Contra Costa,013,1133247,201970,199703,14803,214506,1305
2022-05-19,Del Norte,015,27424,6131,6045,227,6272,50
2022-05-19,El Dorado,017,186661,27730,27517,3406,30923,213
2022-05-19,Fresno,019,978130,235380,234657,24673,259330,2760
2022-05-19,Glenn,021,27897,5027,5020,1636,6656,48
2022-05-19,Humboldt,023,135768,18139,17984,3416,21400,146
2022-05-19,Imperial,025,180216,56173,56014,11066,67080,923
2022-05-19,Inyo,027,18085,4147,4135,564,4699,56
2022-05-19,Kern,029,883053,194301,193705,47445,241150,2334
2022-05-19,Kings,031,150075,52139,52038,3669,55707,447
2022-05-19,Lake,033,64148,10922,10867,932,11799,137
2022-05-19,Lassen,035,31185,9017,9011,899,9910,64
2022-05-19,Los Angeles,037,10098052,2808003,2791671,131803,2923474,31815
2022-05-19,Madera,039,155013,37890,37744,6330,44074,370
2022-05-19,Marin,041,260295,36843,36394,3618,40012,293
2022-05-19,Mariposa,043,17540,2511,2490,227,2717,30
2022-05-19,Mendocino,045,87422,13543,13461,3399,16860,124
2022-05-19,Merced,047,269075,63266,62969,9133,72102,823
2022-05-19,Modoc,049,8938,750,750,255,1005,8
2022-05-19,Mono,051,14174,3024,3012,158,3170,6
2022-05-19,Monterey,053,433212,81701,81224,15333,96557,735
2022-05-19,Napa,055,140530,27240,27034,1117,28151,143
2022-05-19,Nevada,057,99092,16509,16410,1310,17720,127
2022-05-19,Orange,059,3164182,565182,562531,44508,607039,7025
2022-05-19,Placer,061,380077,65343,64802,7826,72628,626
2022-05-19,Plumas,063,18699,3081,3052,376,3428,13
2022-05-19,Riverside,065,2383286,604479,601808,29307,631115,6476
2022-05-19,Sacramento,067,1510023,291841,289972,28785,318757,3027
2022-05-19,San Benito,069,59416,13284,13234,576,13810,98
2022-05-19,San Bernardino,071,2135413,579329,575194,25799,600993,7523
2022-05-19,San Diego,073,3302833,779441,777404,55635,833039,5282
2022-05-19,San Francisco,075,870044,140826,138922,9401,148323,871
2022-05-19,San Joaquin,077,732212,170606,169745,11085,180830,2237
2022-05-19,San Luis Obispo,079,281455,54264,54012,4316,58328,481
2022-05-19,San Mateo,081,765935,134114,132636,8303,140939,711
2022-05-19,Santa Barbara,083,443738,89350,88783,5067,93850,692
2022-05-19,Santa Clara,085,1922200,340231,336488,14298,350786,2301
2022-05-19,Santa Cruz,087,273765,51626,51333,2389,53722,263
2022-05-19,Shasta,089,179085,31073,30966,6229,37195,564
2022-05-19,Sierra,091,2930,277,276,54,330,4
2022-05-19,Siskiyou,093,43540,4520,4501,2821,7322,81
2022-05-19,Solano,095,438530,86059,85038,6015,91053,451
2022-05-19,Sonoma,097,501317,89773,88889,3434,92323,489
2022-05-19,Stanislaus,099,539301,119865,119396,18185,137581,1653
2022-05-19,Sutter,101,95872,20855,20809,2212,23021,226
2022-05-19,Tehama,103,63373,12181,12162,2674,14836,201
2022-05-19,Trinity,105,12862,1196,1191,297,1488,20
2022-05-19,Tulare,107,460477,107689,107485,29380,136865,1477
2022-05-19,Tuolumne,109,53932,13105,12977,616,13593,182
2022-05-19,Ventura,111,848112,179121,178024,10518,188542,1499
2022-05-19,Yolo,113,214977,39614,38377,3446,41823,319
2022-05-19,Yuba,115,75493,16238,16180,1309,17489,122
2022-05-18,Alameda,001,1643700,277064,272530,15580,288110,1859
2022-05-18,Alpine,003,1148,126,126,1,127,0
2022-05-18,Amador,005,37829,8696,8592,686,9278,86
2022-05-18,Butte,007,227075,33733,33486,6984,40470,426
2022-05-18,Calaveras,009,45235,7446,7400,388,7788,120
2022-05-18,Colusa,011,21464,3470,3467,1085,4552,21
2022-05-18,Contra Costa,013,1133247,201414,198207,14742,212949,1303
2022-05-18,Del Norte,015,27424,6124,6001,223,6224,50
2022-05-18,El Dorado,017,186661,27679,27388,3399,30787,212
2022-05-18,Fresno,019,978130,235119,234055,24635,258690,2759
2022-05-18,Glenn,021,27897,5026,5012,1636,6648,48
2022-05-18,Humboldt,023,135768,18114,17868,3404,21272,146
2022-05-18,Imperial,025,180216,56111,55915,11060,66975,918
2022-05-18,Inyo,027,18085,4143,4120,558,4678,56
2022-05-18,Kern,029,883053,194180,193338,47385,240723,2327
2022-05-18,Kings,031,150075,52110,51903,3665,55568,447
2022-05-18,Lake,033,64148,10913,10831,931,11762,137
2022-05-18,Lassen,035,31185,9011,8994,899,9893,65
2022-05-18,Los Angeles,037,10098052,2803664,2780354,131524,2911878,31789
2022-05-18,Madera,039,155013,37853,37644,6323,43967,365
2022-05-18,Marin,041,260295,36752,36024,3578,39602,293
2022-05-18,Mariposa,043,17540,2504,2481,227,2708,30
2022-05-18,Mendocino,045,87422,13522,13403,3383,16786,124
2022-05-18,Merced,047,269075,63201,62802,9104,71906,818
2022-05-18,Modoc,049,8938,750,748,255,1003,8
2022-05-18,Mono,051,14174,3022,3010,156,3166,6
2022-05-18,Monterey,053,433212,81593,80955,15275,96230,735
2022-05-18,Napa,055,140530,27199,26912,1111,28023,143
2022-05-18,Nevada,057,99092,16489,16361,1307,17668,127
2022-05-18,Orange,059,3164182,564368,560094,44392,604486,7021
2022-05-18,Placer,061,380077,65199,64432,7816,72248,626
2022-05-18,Plumas,063,18699,3073,3022,374,3396,13
2022-05-18,Riverside,065,2383286,603836,599947,29255,629202,6471
2022-05-18,Sacramento,067,1510023,291317,288335,28695,317030,3022
2022-05-18,San Benito,069,59416,13261,13186,574,13760,98
2022-05-18,San Bernardino,071,2135413,578859,573790,25774,599564,7455
2022-05-18,San Diego,073,3302833,778004,773934,55500,829434,5277
2022-05-18,San Francisco,075,870044,140297,137341,9378,146719,869
2022-05-18,San Joaquin,077,732212,170372,169045,10993,180038,2236
2022-05-18,San Luis Obispo,079,281455,54167,53756,4278,58034,478
2022-05-18,San Mateo,081,765935,133690,131330,8238,139568,709
2022-05-18,Santa Barbara,083,443738,89189,88317,5049,93366,693
2022-05-18,Santa Clara,085,1922200,339083,333230,14200,347430,2300
2022-05-18,Santa Cruz,087,273765,51534,51020,2376,53396,263
2022-05-18,Shasta,089,179085,31050,30899,6223,37122,558
2022-05-18,Sierra,091,2930,277,275,54,329,4
2022-05-18,Siskiyou,093,43540,4515,4495,2819,7314,81
2022-05-18,Solano,095,438530,85800,84476,5999,90475,451
2022-05-18,Sonoma,097,501317,89575,88195,3400,91595,489
2022-05-18,Stanislaus,099,539301,119756,119025,18156,137181,1645
2022-05-18,Sutter,101,95872,20833,20763,2204,22967,226
2022-05-18,Tehama,103,63373,12175,12133,2671,14804,201
2022-05-18,Trinity,105,12862,1196,1189,297,1486,20
2022-05-18,Tulare,107,460477,107618,107292,29323,136615,1477
2022-05-18,Tuolumne,109,53932,13086,12917,614,13531,182
2022-05-18,Ventura,111,848112,178854,177233,10490,187723,1497
2022-05-18,Yolo,113,214977,39503,38139,3437,41576,316
2022-05-18,Yuba,115,75493,16214,16109,1303,17412,122
2022-05-17,Alameda,001,1643700,276244,272530,15522,288052,1859
2022-05-17,Alpine,003,1148,126,126,1,127,0
2022-05-17,Amador,005,37829,8688,8592,685,9277,86
2022-05-17,Butte,007,227075,33680,33486,6971,40457,426
2022-05-17,Calaveras,009,45235,7439,7400,388,7788,120
2022-05-17,Colusa,011,21464,3469,3467,1084,4551,21
2022-05-17,Contra Costa,013,1133247,200774,198207,14674,212881,1303
2022-05-17,Del Norte,015,27424,6112,6001,222,6223,50
2022-05-17,El Dorado,017,186661,27624,27388,3396,30784,212
2022-05-17,Fresno,019,978130,234867,234055,24608,258663,2759
2022-05-17,Glenn,021,27897,5023,5012,1635,6647,48
2022-05-17,Humboldt,023,135768,18074,17868,3389,21257,146
2022-05-17,Imperial,025,180216,56067,55915,11048,66963,918
2022-05-17,Inyo,027,18085,4141,4120,549,4669,56
2022-05-17,Kern,029,883053,194023,193338,47327,240665,2327
2022-05-17,Kings,031,150075,52067,51903,3661,55564,447
2022-05-17,Lake,033,64148,10898,10831,929,11760,137
2022-05-17,Lassen,035,31185,9006,8994,898,9892,65
2022-05-17,Los Angeles,037,10098052,2799125,2780354,131223,2911577,31789
2022-05-17,Madera,039,155013,37827,37644,6308,43952,365
2022-05-17,Marin,041,260295,36618,36024,3516,39540,293
2022-05-17,Mariposa,043,17540,2499,2481,226,2707,30
2022-05-17,Mendocino,045,87422,13496,13403,3374,16777,124
2022-05-17,Merced,047,269075,63136,62802,9084,71886,818
2022-05-17,Modoc,049,8938,750,748,255,1003,8
2022-05-17,Mono,051,14174,3018,3010,155,3165,6
2022-05-17,Monterey,053,433212,81478,80955,15202,96157,735
2022-05-17,Napa,055,140530,27151,26912,1103,28015,143
2022-05-17,Nevada,057,99092,16460,16361,1301,17662,127
2022-05-17,Orange,059,3164182,563463,560094,44249,604343,7021
2022-05-17,Placer,061,380077,65037,64432,7784,72216,626
2022-05-17,Plumas,063,18699,3067,3022,373,3395,13
2022-05-17,Riverside,065,2383286,603152,599947,29210,629157,6471
2022-05-17,Sacramento,067,1510023,290686,288335,28580,316915,3022
2022-05-17,San Benito,069,59416,13225,13186,574,13760,98
2022-05-17,San Bernardino,071,2135413,578375,573790,25760,599550,7455
2022-05-17,San Diego,073,3302833,776498,773934,55355,829289,5277
2022-05-17,San Francisco,075,870044,139719,137341,9346,146687,869
2022-05-17,San Joaquin,077,732212,170131,169045,10954,179999,2236
2022-05-17,San Luis Obispo,079,281455,54074,53756,4231,57987,478
2022-05-17,San Mateo,081,765935,133198,131330,8199,139529,709
2022-05-17,Santa Barbara,083,443738,88990,88317,5035,93352,693
2022-05-17,Santa Clara,085,1922200,337904,333230,14117,347347,2300
2022-05-17,Santa Cruz,087,273765,51457,51020,2367,53387,263
2022-05-17,Shasta,089,179085,31013,30899,6218,37117,558
2022-05-17,Sierra,091,2930,277,275,54,329,4
2022-05-17,Siskiyou,093,43540,4513,4495,2817,7312,81
2022-05-17,Solano,095,438530,85521,84476,5973,90449,451
2022-05-17,Sonoma,097,501317,89331,88195,3355,91550,489
2022-05-17,Stanislaus,099,539301,119608,119025,18130,137155,1645
2022-05-17,Sutter,101,95872,20813,20763,2201,22964,226
2022-05-17,Tehama,103,63373,12163,12133,2667,14800,201
2022-05-17,Trinity,105,12862,1195,1189,297,1486,20
2022-05-17,Tulare,107,460477,107525,107292,29279,136571,1477
2022-05-17,Tuolumne,109,53932,13071,12917,614,13531,182
2022-05-17,Ventura,111,848112,178532,177233,10449,187682,1497
2022-05-17,Yolo,113,214977,39365,38139,3430,41569,316
2022-05-17,Yuba,115,75493,16190,16109,1300,17409,122
2022-05-16,Alameda,001,1643700,275242,272530,15449,287979,1859
2022-05-16,Alpine,003,1148,126,126,1,127,0
2022-05-16,Amador,005,37829,8678,8592,684,9276,86
2022-05-16,Butte,007,227075,33624,33486,6960,40446,426
2022-05-16,Calaveras,009,45235,7432,7400,386,7786,120
2022-05-16,Colusa,011,21464,3468,3467,1084,4551,21
2022-05-16,Contra Costa,013,1133247,200137,198207,14613,212820,1303
2022-05-16,Del Norte,015,27424,6099,6001,219,6220,50
2022-05-16,El Dorado,017,186661,27568,27388,3389,30777,212
2022-05-16,Fresno,019,978130,234609,234055,24572,258627,2759
2022-05-16,Glenn,021,27897,5019,5012,1632,6644,48
2022-05-16,Humboldt,023,135768,18029,17868,3379,21247,146
2022-05-16,Imperial,025,180216,56003,55915,11036,66951,918
2022-05-16,Inyo,027,18085,4137,4120,546,4666,56
2022-05-16,Kern,029,883053,193870,193338,47259,240597,2327
2022-05-16,Kings,031,150075,52017,51903,3660,55563,447
2022-05-16,Lake,033,64148,10892,10831,928,11759,137
2022-05-16,Lassen,035,31185,9001,8994,895,9889,65
2022-05-16,Los Angeles,037,10098052,2794683,2780354,130942,2911296,31789
2022-05-16,Madera,039,155013,37795,37644,6297,43941,365
2022-05-16,Marin,041,260295,36454,36024,3466,39490,293
2022-05-16,Mariposa,043,17540,2498,2481,225,2706,30
2022-05-16,Mendocino,045,87422,13470,13403,3362,16765,124
2022-05-16,Merced,047,269075,63066,62802,9052,71854,818
2022-05-16,Modoc,049,8938,750,748,255,1003,8
2022-05-16,Mono,051,14174,3016,3010,155,3165,6
2022-05-16,Monterey,053,433212,81367,80955,15113,96068,735
2022-05-16,Napa,055,140530,27099,26912,1100,28012,143
2022-05-16,Nevada,057,99092,16441,16361,1295,17656,127
2022-05-16,Orange,059,3164182,562603,560094,44117,604211,7021
2022-05-16,Placer,061,380077,64930,64432,7756,72188,626
2022-05-16,Plumas,063,18699,3057,3022,373,3395,13
2022-05-16,Riverside,065,2383286,602438,599947,29157,629104,6471
2022-05-16,Sacramento,067,1510023,290025,288335,28482,316817,3022
2022-05-16,San Benito,069,59416,13207,13186,569,13755,98
2022-05-16,San Bernardino,071,2135413,577913,573790,25731,599521,7455
2022-05-16,San Diego,073,3302833,774965,773934,55205,829139,5277
2022-05-16,San Francisco,075,870044,139011,137341,9313,146654,869
2022-05-16,San Joaquin,077,732212,169853,169045,10749,179794,2236
2022-05-16,San Luis Obispo,079,281455,53971,53756,4201,57957,478
2022-05-16,San Mateo,081,765935,132657,131330,8152,139482,709
2022-05-16,Santa Barbara,083,443738,88847,88317,5026,93343,693
2022-05-16,Santa Clara,085,1922200,336577,333230,14039,347269,2300
2022-05-16,Santa Cruz,087,273765,51381,51020,2354,53374,263
2022-05-16,Shasta,089,179085,30980,30899,6209,37108,558
2022-05-16,Sierra,091,2930,277,275,53,328,4
2022-05-16,Siskiyou,093,43540,4510,4495,2810,7305,81
2022-05-16,Solano,095,438530,85260,84476,5950,90426,451
2022-05-16,Sonoma,097,501317,89032,88195,3322,91517,489
2022-05-16,Stanislaus,099,539301,119462,119025,18095,137120,1645
2022-05-16,Sutter,101,95872,20799,20763,2196,22959,226
2022-05-16,Tehama,103,63373,12155,12133,2664,14797,201
2022-05-16,Trinity,105,12862,1194,1189,297,1486,20
2022-05-16,Tulare,107,460477,107450,107292,29223,136515,1477
2022-05-16,Tuolumne,109,53932,13039,12917,612,13529,182
2022-05-16,Ventura,111,848112,178198,177233,10395,187628,1497
2022-05-16,Yolo,113,214977,39229,38139,3421,41560,316
2022-05-16,Yuba,115,75493,16163,16109,1297,17406,122
2022-05-15,Alameda,001,1643700,274183,268944,15384,284328,1857
2022-05-15,Alpine,003,1148,126,125,1,126,0
2022-05-15,Amador,005,37829,8662,8574,683,9257,86
2022-05-15,Butte,007,227075,33570,33377,6936,40313,424
2022-05-15,Calaveras,009,45235,7413,7378,384,7762,120
2022-05-15,Colusa,011,21464,3465,3463,1082,4545,21
2022-05-15,Contra Costa,013,1133247,199381,195925,14544,210469,1301
2022-05-15,Del Norte,015,27424,6027,5919,217,6136,50
2022-05-15,El Dorado,017,186661,27507,27216,3377,30593,212
2022-05-15,Fresno,019,978130,234342,233305,24538,257843,2757
2022-05-15,Glenn,021,27897,5016,5004,1631,6635,48
2022-05-15,Humboldt,023,135768,17979,17633,3344,20977,146
2022-05-15,Imperial,025,180216,55967,55756,11010,66766,917
2022-05-15,Inyo,027,18085,4133,4114,541,4655,56
2022-05-15,Kern,029,883053,193696,192939,47177,240116,2314
2022-05-15,Kings,031,150075,51958,51779,3655,55434,447
2022-05-15,Lake,033,64148,10875,10790,925,11715,137
2022-05-15,Lassen,035,31185,8993,8987,894,9881,65
2022-05-15,Los Angeles,037,10098052,2790078,2768726,130567,2899293,31768
2022-05-15,Madera,039,155013,37753,37520,6282,43802,365
2022-05-15,Marin,041,260295,36283,35486,3426,38912,293
2022-05-15,Mariposa,043,17540,2493,2463,224,2687,30
2022-05-15,Mendocino,045,87422,13451,13349,3335,16684,124
2022-05-15,Merced,047,269075,62981,62627,9006,71633,818
2022-05-15,Modoc,049,8938,749,747,255,1002,8
2022-05-15,Mono,051,14174,3013,3002,153,3155,6
2022-05-15,Monterey,053,433212,81257,80620,15019,95639,735
2022-05-15,Napa,055,140530,27047,26698,1096,27794,143
2022-05-15,Nevada,057,99092,16411,16240,1293,17533,127
2022-05-15,Orange,059,3164182,561652,557134,43976,601110,7017
2022-05-15,Placer,061,380077,64749,63963,7732,71695,626
2022-05-15,Plumas,063,18699,3051,3006,373,3379,13
2022-05-15,Riverside,065,2383286,601721,597914,29087,627001,6471
2022-05-15,Sacramento,067,1510023,289308,286403,28340,314743,3022
2022-05-15,San Benito,069,59416,13182,13106,567,13673,98
2022-05-15,San Bernardino,071,2135413,577367,572057,25702,597759,7423
2022-05-15,San Diego,073,3302833,773467,770323,55019,825342,5271
2022-05-15,San Francisco,075,870044,138293,134916,9276,144192,866
2022-05-15,San Joaquin,077,732212,169610,168174,10673,178847,2236
2022-05-15,San Luis Obispo,079,281455,53844,53502,4156,57658,478
2022-05-15,San Mateo,081,765935,132126,129480,8085,137565,709
2022-05-15,Santa Barbara,083,443738,88616,87773,4994,92767,693
2022-05-15,Santa Clara,085,1922200,335158,328609,13953,342562,2297
2022-05-15,Santa Cruz,087,273765,51277,50268,2338,52606,263
2022-05-15,Shasta,089,179085,30939,30799,6203,37002,557
2022-05-15,Sierra,091,2930,277,275,53,328,4
2022-05-15,Siskiyou,093,43540,4508,4482,2807,7289,81
2022-05-15,Solano,095,438530,84942,83669,5920,89589,451
2022-05-15,Sonoma,097,501317,88709,87070,3297,90367,488
2022-05-15,Stanislaus,099,539301,119293,118586,18062,136648,1645
2022-05-15,Sutter,101,95872,20772,20690,2190,22880,226
2022-05-15,Tehama,103,63373,12137,12115,2658,14773,201
2022-05-15,Trinity,105,12862,1193,1188,297,1485,20
2022-05-15,Tulare,107,460477,107350,107077,29166,136243,1469
2022-05-15,Tuolumne,109,53932,12988,12851,611,13462,182
2022-05-15,Ventura,111,848112,177854,176317,10348,186665,1497
2022-05-15,Yolo,113,214977,39114,37737,3408,41145,316
2022-05-15,Yuba,115,75493,16129,16028,1287,17315,122
2022-05-14,Alameda,001,1643700,273767,268944,15365,284309,1857
2022-05-14,Alpine,003,1148,125,125,1,126,0
2022-05-14,Amador,005,37829,8656,8574,683,9257,86
2022-05-14,Butte,007,227075,33551,33377,6927,40304,424
2022-05-14,Calaveras,009,45235,7411,7378,384,7762,120
2022-05-14,Colusa,011,21464,3465,3463,1082,4545,21
2022-05-14,Contra Costa,013,1133247,199014,195925,14512,210437,1301
2022-05-14,Del Norte,015,27424,6021,5919,215,6134,50
2022-05-14,El Dorado,017,186661,27477,27216,3371,30587,212
2022-05-14,Fresno,019,978130,234219,233305,24530,257835,2757
2022-05-14,Glenn,021,27897,5015,5004,1627,6631,48
2022-05-14,Humboldt,023,135768,17953,17633,3337,20970,146
2022-05-14,Imperial,025,180216,55936,55756,11006,66762,917
2022-05-14,Inyo,027,18085,4128,4114,541,4655,56
2022-05-14,Kern,029,883053,193623,192939,47130,240069,2314
2022-05-14,Kings,031,150075,51931,51779,3655,55434,447
2022-05-14,Lake,033,64148,10865,10790,920,11710,137
2022-05-14,Lassen,035,31185,8991,8987,894,9881,65
2022-05-14,Los Angeles,037,10098052,2788170,2768726,130343,2899069,31768
2022-05-14,Madera,039,155013,37739,37520,6282,43802,365
2022-05-14,Marin,041,260295,36177,35486,3375,38861,293
2022-05-14,Mariposa,043,17540,2492,2463,224,2687,30
2022-05-14,Mendocino,045,87422,13441,13349,3333,16682,124
2022-05-14,Merced,047,269075,62947,62627,9002,71629,818
2022-05-14,Modoc,049,8938,748,747,255,1002,8
2022-05-14,Mono,051,14174,3013,3002,152,3154,6
2022-05-14,Monterey,053,433212,81193,80620,14963,95583,735
2022-05-14,Napa,055,140530,27024,26698,1089,27787,143
2022-05-14,Nevada,057,99092,16396,16240,1292,17532,127
2022-05-14,Orange,059,3164182,561207,557134,43883,601017,7017
2022-05-14,Placer,061,380077,64643,63963,7710,71673,626
2022-05-14,Plumas,063,18699,3047,3006,373,3379,13
2022-05-14,Riverside,065,2383286,601314,597914,29059,626973,6471
2022-05-14,Sacramento,067,1510023,289037,286403,28319,314722,3022
2022-05-14,San Benito,069,59416,13171,13106,565,13671,98
2022-05-14,San Bernardino,071,2135413,577090,572057,25690,597747,7423
2022-05-14,San Diego,073,3302833,772872,770323,54974,825297,5271
2022-05-14,San Francisco,075,870044,137931,134916,9254,144170,866
2022-05-14,San Joaquin,077,732212,169471,168174,10658,178832,2236
2022-05-14,San Luis Obispo,079,281455,53817,53502,4153,57655,478
2022-05-14,San Mateo,081,765935,131801,129480,8063,137543,709
2022-05-14,Santa Barbara,083,443738,88509,87773,4994,92767,693
2022-05-14,Santa Clara,085,1922200,334328,328609,13912,342521,2297
2022-05-14,Santa Cruz,087,273765,51230,50268,2328,52596,263
2022-05-14,Shasta,089,179085,30934,30799,6202,37001,557
2022-05-14,Sierra,091,2930,277,275,53,328,4
2022-05-14,Siskiyou,093,43540,4505,4482,2805,7287,81
2022-05-14,Solano,095,438530,84881,83669,5908,89577,451
2022-05-14,Sonoma,097,501317,88564,87070,3288,90358,488
2022-05-14,Stanislaus,099,539301,119209,118586,18051,136637,1645
2022-05-14,Sutter,101,95872,20764,20690,2189,22879,226
2022-05-14,Tehama,103,63373,12131,12115,2657,14772,201
2022-05-14,Trinity,105,12862,1193,1188,297,1485,20
2022-05-14,Tulare,107,460477,107305,107077,29134,136211,1469
2022-05-14,Tuolumne,109,53932,12976,12851,611,13462,182
2022-05-14,Ventura,111,848112,177691,176317,10326,186643,1497
2022-05-14,Yolo,113,214977,39044,37737,3401,41138,316
2022-05-14,Yuba,115,75493,16122,16028,1286,17314,122
2022-05-13,Alameda,001,1643700,273292,268944,15338,284282,1857
2022-05-13,Alpine,003,1148,125,125,1,126,0
2022-05-13,Amador,005,37829,8651,8574,682,9256,86
2022-05-13,Butte,007,227075,33534,33377,6924,40301,424
2022-05-13,Calaveras,009,45235,7407,7378,384,7762,120
2022-05-13,Colusa,011,21464,3464,3463,1082,4545,21
2022-05-13,Contra Costa,013,1133247,198674,195925,14482,210407,1301
2022-05-13,Del Norte,015,27424,6018,5919,215,6134,50
2022-05-13,El Dorado,017,186661,27449,27216,3371,30587,212
2022-05-13,Fresno,019,978130,234111,233305,24509,257814,2757
2022-05-13,Glenn,021,27897,5013,5004,1626,6630,48
2022-05-13,Humboldt,023,135768,17929,17633,3329,20962,146
2022-05-13,Imperial,025,180216,55917,55756,11005,66761,917
2022-05-13,Inyo,027,18085,4128,4114,540,4654,56
2022-05-13,Kern,029,883053,193548,192939,47099,240038,2314
2022-05-13,Kings,031,150075,51907,51779,3655,55434,447
2022-05-13,Lake,033,64148,10862,10790,920,11710,137
2022-05-13,Lassen,035,31185,8990,8987,894,9881,65
2022-05-13,Los Angeles,037,10098052,2786232,2768726,130152,2898878,31768
2022-05-13,Madera,039,155013,37719,37520,6273,43793,365
2022-05-13,Marin,041,260295,36074,35486,3332,38818,293
2022-05-13,Mariposa,043,17540,2490,2463,224,2687,30
2022-05-13,Mendocino,045,87422,13427,13349,3328,16677,124
2022-05-13,Merced,047,269075,62912,62627,8994,71621,818
2022-05-13,Modoc,049,8938,748,747,255,1002,8
2022-05-13,Mono,051,14174,3011,3002,151,3153,6
2022-05-13,Monterey,053,433212,81137,80620,14919,95539,735
2022-05-13,Napa,055,140530,26988,26698,1087,27785,143
2022-05-13,Nevada,057,99092,16381,16240,1291,17531,127
2022-05-13,Orange,059,3164182,560740,557134,43807,600941,7017
2022-05-13,Placer,061,380077,64564,63963,7700,71663,626
2022-05-13,Plumas,063,18699,3040,3006,373,3379,13
2022-05-13,Riverside,065,2383286,600926,597914,29028,626942,6471
2022-05-13,Sacramento,067,1510023,288699,286403,28300,314703,3022
2022-05-13,San Benito,069,59416,13167,13106,565,13671,98
2022-05-13,San Bernardino,071,2135413,576853,572057,25680,597737,7423
2022-05-13,San Diego,073,3302833,772235,770323,54896,825219,5271
2022-05-13,San Francisco,075,870044,137577,134916,9234,144150,866
2022-05-13,San Joaquin,077,732212,169352,168174,10646,178820,2236
2022-05-13,San Luis Obispo,079,281455,53781,53502,4149,57651,478
2022-05-13,San Mateo,081,765935,131513,129480,8042,137522,709
2022-05-13,Santa Barbara,083,443738,88416,87773,4991,92764,693
2022-05-13,Santa Clara,085,1922200,333528,328609,13880,342489,2297
2022-05-13,Santa Cruz,087,273765,51143,50268,2320,52588,263
2022-05-13,Shasta,089,179085,30931,30799,6202,37001,557
2022-05-13,Sierra,091,2930,276,275,50,325,4
2022-05-13,Siskiyou,093,43540,4504,4482,2804,7286,81
2022-05-13,Solano,095,438530,84759,83669,5901,89570,451
2022-05-13,Sonoma,097,501317,88388,87070,3278,90348,488
2022-05-13,Stanislaus,099,539301,119113,118586,18042,136628,1645
2022-05-13,Sutter,101,95872,20752,20690,2188,22878,226
2022-05-13,Tehama,103,63373,12129,12115,2655,14770,201
2022-05-13,Trinity,105,12862,1192,1188,297,1485,20
2022-05-13,Tulare,107,460477,107260,107077,29095,136172,1469
2022-05-13,Tuolumne,109,53932,12960,12851,611,13462,182
2022-05-13,Ventura,111,848112,177515,176317,10314,186631,1497
2022-05-13,Yolo,113,214977,38982,37737,3397,41134,316
2022-05-13,Yuba,115,75493,16109,16028,1283,17311,122
2022-05-12,Alameda,001,1643700,272549,268944,15283,284227,1857
2022-05-12,Alpine,003,1148,125,125,1,126,0
2022-05-12,Amador,005,37829,8642,8574,682,9256,86
2022-05-12,Butte,007,227075,33509,33377,6911,40288,424
2022-05-12,Calaveras,009,45235,7403,7378,383,7761,120
2022-05-12,Colusa,011,21464,3464,3463,1081,4544,21
2022-05-12,Contra Costa,013,1133247,198152,195925,14417,210342,1301
2022-05-12,Del Norte,015,27424,6001,5919,213,6132,50
2022-05-12,El Dorado,017,186661,27408,27216,3362,30578,212
2022-05-12,Fresno,019,978130,233962,233305,24489,257794,2757
2022-05-12,Glenn,021,27897,5009,5004,1626,6630,48
2022-05-12,Humboldt,023,135768,17886,17633,3314,20947,146
2022-05-12,Imperial,025,180216,55890,55756,10990,66746,917
2022-05-12,Inyo,027,18085,4124,4114,535,4649,56
2022-05-12,Kern,029,883053,193483,192939,47049,239988,2314
2022-05-12,Kings,031,150075,51885,51779,3652,55431,447
2022-05-12,Lake,033,64148,10844,10790,915,11705,137
2022-05-12,Lassen,035,31185,8989,8987,893,9880,65
2022-05-12,Los Angeles,037,10098052,2783023,2768726,129879,2898605,31768
2022-05-12,Madera,039,155013,37693,37520,6262,43782,365
2022-05-12,Marin,041,260295,35974,35486,3309,38795,293
2022-05-12,Mariposa,043,17540,2485,2463,223,2686,30
2022-05-12,Mendocino,045,87422,13410,13349,3315,16664,124
2022-05-12,Merced,047,269075,62879,62627,8979,71606,818
2022-05-12,Modoc,049,8938,747,747,255,1002,8
2022-05-12,Mono,051,14174,3011,3002,150,3152,6
2022-05-12,Monterey,053,433212,81078,80620,14866,95486,735
2022-05-12,Napa,055,140530,26942,26698,1085,27783,143
2022-05-12,Nevada,057,99092,16359,16240,1290,17530,127
2022-05-12,Orange,059,3164182,560101,557134,43696,600830,7017
2022-05-12,Placer,061,380077,64466,63963,7677,71640,626
2022-05-12,Plumas,063,18699,3034,3006,373,3379,13
2022-05-12,Riverside,065,2383286,600468,597914,28993,626907,6471
2022-05-12,Sacramento,067,1510023,288242,286403,28231,314634,3022
2022-05-12,San Benito,069,59416,13152,13106,563,13669,98
2022-05-12,San Bernardino,071,2135413,576506,572057,25658,597715,7423
2022-05-12,San Diego,073,3302833,771281,770323,54808,825131,5271
2022-05-12,San Francisco,075,870044,137195,134916,9191,144107,866
2022-05-12,San Joaquin,077,732212,169173,168174,10610,178784,2236
2022-05-12,San Luis Obispo,079,281455,53722,53502,4120,57622,478
2022-05-12,San Mateo,081,765935,131105,129480,7986,137466,709
2022-05-12,Santa Barbara,083,443738,88310,87773,4980,92753,693
2022-05-12,Santa Clara,085,1922200,332548,328609,13788,342397,2297
2022-05-12,Santa Cruz,087,273765,50999,50268,2315,52583,263
2022-05-12,Shasta,089,179085,30918,30799,6199,36998,557
2022-05-12,Sierra,091,2930,275,275,50,325,4
2022-05-12,Siskiyou,093,43540,4499,4482,2802,7284,81
2022-05-12,Solano,095,438530,84543,83669,5888,89557,451
2022-05-12,Sonoma,097,501317,88171,87070,3254,90324,488
2022-05-12,Stanislaus,099,539301,119012,118586,18015,136601,1645
2022-05-12,Sutter,101,95872,20736,20690,2187,22877,226
2022-05-12,Tehama,103,63373,12122,12115,2653,14768,201
2022-05-12,Trinity,105,12862,1191,1188,296,1484,20
2022-05-12,Tulare,107,460477,107209,107077,29038,136115,1469
2022-05-12,Tuolumne,109,53932,12939,12851,608,13459,182
2022-05-12,Ventura,111,848112,177284,176317,10276,186593,1497
2022-05-12,Yolo,113,214977,38869,37737,3386,41123,316
2022-05-12,Yuba,115,75493,16093,16028,1279,17307,122
2022-05-11,Alameda,001,1643700,271842,267982,15229,283211,1853
2022-05-11,Alpine,003,1148,125,125,1,126,0
2022-05-11,Amador,005,37829,8635,8564,681,9245,86
2022-05-11,Butte,007,227075,33476,33339,6906,40245,423
2022-05-11,Calaveras,009,45235,7398,7368,379,7747,120
2022-05-11,Colusa,011,21464,3463,3462,1081,4543,21
2022-05-11,Contra Costa,013,1133247,197639,195153,14362,209515,1302
2022-05-11,Del Norte,015,27424,5991,5911,213,6124,50
2022-05-11,El Dorado,017,186661,27372,27172,3354,30526,212
2022-05-11,Fresno,019,978130,233798,233021,24460,257481,2754
2022-05-11,Glenn,021,27897,5009,5001,1625,6626,48
2022-05-11,Humboldt,023,135768,17844,17585,3298,20883,146
2022-05-11,Imperial,025,180216,55863,55751,10979,66730,917
2022-05-11,Inyo,027,18085,4123,4093,534,4627,56
2022-05-11,Kern,029,883053,193387,192795,47001,239796,2292
2022-05-11,Kings,031,150075,51857,51752,3650,55402,447
2022-05-11,Lake,033,64148,10831,10786,914,11700,137
2022-05-11,Lassen,035,31185,8988,8984,892,9876,65
2022-05-11,Los Angeles,037,10098052,2779890,2761410,129648,2891058,31747
2022-05-11,Madera,039,155013,37660,37496,6251,43747,365
2022-05-11,Marin,041,260295,35873,35336,3265,38601,292
2022-05-11,Mariposa,043,17540,2480,2461,223,2684,30
2022-05-11,Mendocino,045,87422,13395,13320,3298,16618,124
2022-05-11,Merced,047,269075,62837,62567,8956,71523,818
2022-05-11,Modoc,049,8938,746,747,255,1002,8
2022-05-11,Mono,051,14174,3011,2999,149,3148,6
2022-05-11,Monterey,053,433212,81015,80534,14811,95345,733
2022-05-11,Napa,055,140530,26890,26660,1083,27743,143
2022-05-11,Nevada,057,99092,16343,16230,1285,17515,127
2022-05-11,Orange,059,3164182,559426,556265,43612,599877,7009
2022-05-11,Placer,061,380077,64368,63823,7662,71485,625
2022-05-11,Plumas,063,18699,3026,2998,373,3371,13
2022-05-11,Riverside,065,2383286,600017,597302,28958,626260,6468
2022-05-11,Sacramento,067,1510023,287829,285799,28181,313980,3020
2022-05-11,San Benito,069,59416,13132,13088,563,13651,98
2022-05-11,San Bernardino,071,2135413,576142,571372,25649,597021,7354
2022-05-11,San Diego,073,3302833,770299,768135,54676,822811,5257
2022-05-11,San Francisco,075,870044,136696,134027,9158,143185,864
2022-05-11,San Joaquin,077,732212,168998,167949,10585,178534,2233
2022-05-11,San Luis Obispo,079,281455,53675,53420,4102,57522,478
2022-05-11,San Mateo,081,765935,130709,128821,7937,136758,711
2022-05-11,Santa Barbara,083,443738,88180,87593,4966,92559,693
2022-05-11,Santa Clara,085,1922200,331543,327177,13738,340915,2294
2022-05-11,Santa Cruz,087,273765,50841,50031,2300,52331,263
2022-05-11,Shasta,089,179085,30886,30768,6196,36964,564
2022-05-11,Sierra,091,2930,275,275,50,325,4
2022-05-11,Siskiyou,093,43540,4497,4478,2802,7280,81
2022-05-11,Solano,095,438530,84346,83464,5876,89340,450
2022-05-11,Sonoma,097,501317,87966,86798,3242,90040,488
2022-05-11,Stanislaus,099,539301,118912,118445,17996,136441,1644
2022-05-11,Sutter,101,95872,20721,20668,2186,22854,225
2022-05-11,Tehama,103,63373,12122,12106,2652,14758,201
2022-05-11,Trinity,105,12862,1189,1188,296,1484,20
2022-05-11,Tulare,107,460477,107153,107068,29004,136072,1468
2022-05-11,Tuolumne,109,53932,12920,12829,608,13437,181
2022-05-11,Ventura,111,848112,177087,175955,10234,186189,1491
2022-05-11,Yolo,113,214977,38755,37654,3384,41038,316
2022-05-11,Yuba,115,75493,16074,15997,1270,17267,122
2022-05-10,Alameda,001,1643700,271065,267982,15176,283158,1853
2022-05-10,Alpine,003,1148,125,125,1,126,0
2022-05-10,Amador,005,37829,8631,8564,680,9244,86
2022-05-10,Butte,007,227075,33452,33339,6902,40241,423
2022-05-10,Calaveras,009,45235,7394,7368,377,7745,120
2022-05-10,Colusa,011,21464,3463,3462,1080,4542,21
2022-05-10,Contra Costa,013,1133247,197160,195153,14322,209475,1302
2022-05-10,Del Norte,015,27424,5938,5911,213,6124,50
2022-05-10,El Dorado,017,186661,27335,27172,3348,30520,212
2022-05-10,Fresno,019,978130,233638,233021,24431,257452,2754
2022-05-10,Glenn,021,27897,5006,5001,1625,6626,48
2022-05-10,Humboldt,023,135768,17806,17585,3282,20867,146
2022-05-10,Imperial,025,180216,55828,55751,10960,66711,917
2022-05-10,Inyo,027,18085,4121,4093,527,4620,56
2022-05-10,Kern,029,883053,193285,192795,46961,239756,2292
2022-05-10,Kings,031,150075,51825,51752,3650,55402,447
2022-05-10,Lake,033,64148,10826,10786,914,11700,137
2022-05-10,Lassen,035,31185,8983,8984,892,9876,65
2022-05-10,Los Angeles,037,10098052,2776596,2761410,129414,2890824,31747
2022-05-10,Madera,039,155013,37628,37496,6237,43733,365
2022-05-10,Marin,041,260295,35761,35336,3223,38559,292
2022-05-10,Mariposa,043,17540,2480,2461,223,2684,30
2022-05-10,Mendocino,045,87422,13383,13320,3285,16605,124
2022-05-10,Merced,047,269075,62790,62567,8936,71503,818
2022-05-10,Modoc,049,8938,746,747,255,1002,8
2022-05-10,Mono,051,14174,3007,2999,146,3145,6
2022-05-10,Monterey,053,433212,80949,80534,14765,95299,733
2022-05-10,Napa,055,140530,26851,26660,1081,27741,143
2022-05-10,Nevada,057,99092,16323,16230,1280,17510,127
2022-05-10,Orange,059,3164182,558715,556265,43516,599781,7009
2022-05-10,Placer,061,380077,64255,63823,7647,71470,625
2022-05-10,Plumas,063,18699,3018,2998,372,3370,13
2022-05-10,Riverside,065,2383286,599590,597302,28923,626225,6468
2022-05-10,Sacramento,067,1510023,287328,285799,28109,313908,3020
2022-05-10,San Benito,069,59416,13115,13088,558,13646,98
2022-05-10,San Bernardino,071,2135413,575787,571372,25619,596991,7354
2022-05-10,San Diego,073,3302833,769277,768135,54557,822692,5257
2022-05-10,San Francisco,075,870044,136142,134027,9127,143154,864
2022-05-10,San Joaquin,077,732212,168840,167949,10518,178467,2233
2022-05-10,San Luis Obispo,079,281455,53599,53420,4075,57495,478
2022-05-10,San Mateo,081,765935,130333,128821,7895,136716,711
2022-05-10,Santa Barbara,083,443738,88064,87593,4951,92544,693
2022-05-10,Santa Clara,085,1922200,330517,327177,13653,340830,2294
2022-05-10,Santa Cruz,087,273765,50716,50031,2290,52321,263
2022-05-10,Shasta,089,179085,30866,30768,6195,36963,564
2022-05-10,Sierra,091,2930,275,275,49,324,4
2022-05-10,Siskiyou,093,43540,4493,4478,2801,7279,81
2022-05-10,Solano,095,438530,84162,83464,5852,89316,450
2022-05-10,Sonoma,097,501317,87725,86798,3203,90001,488
2022-05-10,Stanislaus,099,539301,118818,118445,17977,136422,1644
2022-05-10,Sutter,101,95872,20702,20668,2183,22851,225
2022-05-10,Tehama,103,63373,12119,12106,2645,14751,201
2022-05-10,Trinity,105,12862,1189,1188,296,1484,20
2022-05-10,Tulare,107,460477,107111,107068,28972,136040,1468
2022-05-10,Tuolumne,109,53932,12908,12829,608,13437,181
2022-05-10,Ventura,111,848112,176873,175955,10199,186154,1491
2022-05-10,Yolo,113,214977,38653,37654,3373,41027,316
2022-05-10,Yuba,115,75493,16053,15997,1267,17264,122
2022-05-09,Alameda,001,1643700,270298,267982,15129,283111,1853
2022-05-09,Alpine,003,1148,125,125,1,126,0
2022-05-09,Amador,005,37829,8624,8564,680,9244,86
2022-05-09,Butte,007,227075,33426,33339,6894,40233,423
2022-05-09,Calaveras,009,45235,7388,7368,377,7745,120
2022-05-09,Colusa,011,21464,3461,3462,1078,4540,21
2022-05-09,Contra Costa,013,1133247,196690,195153,14260,209413,1302
2022-05-09,Del Norte,015,27424,5929,5911,212,6123,50
2022-05-09,El Dorado,017,186661,27299,27172,3340,30512,212
2022-05-09,Fresno,019,978130,233479,233021,24406,257427,2754
2022-05-09,Glenn,021,27897,5004,5001,1623,6624,48
2022-05-09,Humboldt,023,135768,17755,17585,3259,20844,146
2022-05-09,Imperial,025,180216,55795,55751,10945,66696,917
2022-05-09,Inyo,027,18085,4118,4093,524,4617,56
2022-05-09,Kern,029,883053,193186,192795,46903,239698,2292
2022-05-09,Kings,031,150075,51794,51752,3649,55401,447
2022-05-09,Lake,033,64148,10819,10786,913,11699,137
2022-05-09,Lassen,035,31185,8981,8984,892,9876,65
2022-05-09,Los Angeles,037,10098052,2773242,2761410,129170,2890580,31747
2022-05-09,Madera,039,155013,37598,37496,6227,43723,365
2022-05-09,Marin,041,260295,35644,35336,3186,38522,292
2022-05-09,Mariposa,043,17540,2475,2461,223,2684,30
2022-05-09,Mendocino,045,87422,13372,13320,3274,16594,124
2022-05-09,Merced,047,269075,62749,62567,8916,71483,818
2022-05-09,Modoc,049,8938,746,747,255,1002,8
2022-05-09,Mono,051,14174,3005,2999,144,3143,6
2022-05-09,Monterey,053,433212,80854,80534,14711,95245,733
2022-05-09,Napa,055,140530,26801,26660,1080,27740,143
2022-05-09,Nevada,057,99092,16296,16230,1274,17504,127
2022-05-09,Orange,059,3164182,558042,556265,43430,599695,7009
2022-05-09,Placer,061,380077,64196,63823,7630,71453,625
2022-05-09,Plumas,063,18699,3009,2998,372,3370,13
2022-05-09,Riverside,065,2383286,599103,597302,28883,626185,6468
2022-05-09,Sacramento,067,1510023,286900,285799,28028,313827,3020
2022-05-09,San Benito,069,59416,13097,13088,554,13642,98
2022-05-09,San Bernardino,071,2135413,575457,571372,25602,596974,7354
2022-05-09,San Diego,073,3302833,768300,768135,54414,822549,5257
2022-05-09,San Francisco,075,870044,135591,134027,9102,143129,864
2022-05-09,San Joaquin,077,732212,168656,167949,10490,178439,2233
2022-05-09,San Luis Obispo,079,281455,53547,53420,4055,57475,478
2022-05-09,San Mateo,081,765935,129908,128821,7855,136676,711
2022-05-09,Santa Barbara,083,443738,87936,87593,4939,92532,693
2022-05-09,Santa Clara,085,1922200,329366,327177,13587,340764,2294
2022-05-09,Santa Cruz,087,273765,50579,50031,2282,52313,263
2022-05-09,Shasta,089,179085,30852,30768,6193,36961,564
2022-05-09,Sierra,091,2930,275,275,49,324,4
2022-05-09,Siskiyou,093,43540,4491,4478,2801,7279,81
2022-05-09,Solano,095,438530,84007,83464,5838,89302,450
2022-05-09,Sonoma,097,501317,87465,86798,3176,89974,488
2022-05-09,Stanislaus,099,539301,118722,118445,17959,136404,1644
2022-05-09,Sutter,101,95872,20689,20668,2181,22849,225
2022-05-09,Tehama,103,63373,12117,12106,2643,14749,201
2022-05-09,Trinity,105,12862,1189,1188,296,1484,20
2022-05-09,Tulare,107,460477,107063,107068,28931,135999,1468
2022-05-09,Tuolumne,109,53932,12900,12829,608,13437,181
2022-05-09,Ventura,111,848112,176655,175955,10149,186104,1491
2022-05-09,Yolo,113,214977,38544,37654,3363,41017,316
2022-05-09,Yuba,115,75493,16044,15997,1266,17263,122
2022-05-08,Alameda,001,1643700,269414,265198,15061,280259,1855
2022-05-08,Alpine,003,1148,125,125,1,126,0
2022-05-08,Amador,005,37829,8613,8556,678,9234,86
2022-05-08,Butte,007,227075,33403,33269,6883,40152,421
2022-05-08,Calaveras,009,45235,7381,7353,376,7729,120
2022-05-08,Colusa,011,21464,3460,3459,1077,4536,21
2022-05-08,Contra Costa,013,1133247,196179,193961,14177,208138,1302
2022-05-08,Del Norte,015,27424,5915,5884,212,6096,50
2022-05-08,El Dorado,017,186661,27261,27081,3334,30415,210
2022-05-08,Fresno,019,978130,233312,232655,24382,257037,2754
2022-05-08,Glenn,021,27897,5002,4996,1623,6619,48
2022-05-08,Humboldt,023,135768,17703,17410,3219,20629,146
2022-05-08,Imperial,025,180216,55761,55683,10933,66616,917
2022-05-08,Inyo,027,18085,4111,4087,523,4610,56
2022-05-08,Kern,029,883053,193092,192590,46856,239446,2287
2022-05-08,Kings,031,150075,51777,51702,3649,55351,447
2022-05-08,Lake,033,64148,10812,10766,913,11679,137
2022-05-08,Lassen,035,31185,8977,8978,892,9870,65
2022-05-08,Los Angeles,037,10098052,2769663,2751478,128876,2880354,31738
2022-05-08,Madera,039,155013,37578,37420,6208,43628,365
2022-05-08,Marin,041,260295,35520,34934,3137,38071,292
2022-05-08,Mariposa,043,17540,2468,2438,222,2660,30
2022-05-08,Mendocino,045,87422,13353,13270,3246,16516,124
2022-05-08,Merced,047,269075,62698,62471,8886,71357,818
2022-05-08,Modoc,049,8938,746,745,255,1000,8
2022-05-08,Mono,051,14174,3004,2997,142,3139,6
2022-05-08,Monterey,053,433212,80762,80246,14623,94869,733
2022-05-08,Napa,055,140530,26760,26524,1077,27601,143
2022-05-08,Nevada,057,99092,16272,16171,1272,17443,127
2022-05-08,Orange,059,3164182,557364,554411,43317,597728,7007
2022-05-08,Placer,061,380077,64079,63577,7601,71178,625
2022-05-08,Plumas,063,18699,3005,2996,372,3368,13
2022-05-08,Riverside,065,2383286,598615,596022,28840,624862,6467
2022-05-08,Sacramento,067,1510023,286395,284564,27952,312516,3016
2022-05-08,San Benito,069,59416,13082,13047,550,13597,98
2022-05-08,San Bernardino,071,2135413,575029,570381,25564,595945,7306
2022-05-08,San Diego,073,3302833,767276,765377,54310,819687,5244
2022-05-08,San Francisco,075,870044,134932,132659,9067,141726,861
2022-05-08,San Joaquin,077,732212,168468,167568,10448,178016,2229
2022-05-08,San Luis Obispo,079,281455,53476,53273,4033,57306,477
2022-05-08,San Mateo,081,765935,129446,127615,7800,135415,709
2022-05-08,Santa Barbara,083,443738,87802,87305,4930,92235,692
2022-05-08,Santa Clara,085,1922200,328287,324946,13515,338461,2287
2022-05-08,Santa Cruz,087,273765,50399,49605,2277,51882,262
2022-05-08,Shasta,089,179085,30824,30721,6189,36910,563
2022-05-08,Sierra,091,2930,275,275,49,324,4
2022-05-08,Siskiyou,093,43540,4488,4470,2796,7266,81
2022-05-08,Solano,095,438530,83837,83038,5812,88850,450
2022-05-08,Sonoma,097,501317,87244,86150,3141,89291,488
2022-05-08,Stanislaus,099,539301,118615,118235,17935,136170,1643
2022-05-08,Sutter,101,95872,20668,20694,2176,22870,225
2022-05-08,Tehama,103,63373,12111,12098,2640,14738,201
2022-05-08,Trinity,105,12862,1188,1180,296,1476,20
2022-05-08,Tulare,107,460477,107021,106987,28893,135880,1468
2022-05-08,Tuolumne,109,53932,12887,12793,604,13397,181
2022-05-08,Ventura,111,848112,176419,175454,10095,185549,1491
2022-05-08,Yolo,113,214977,38438,37456,3348,40804,315
2022-05-08,Yuba,115,75493,16022,15964,1262,17226,122
2022-05-07,Alameda,001,1643700,269043,265198,15043,280241,1855
2022-05-07,Alpine,003,1148,125,125,1,126,0
2022-05-07,Amador,005,37829,8611,8556,678,9234,86
2022-05-07,Butte,007,227075,33395,33269,6875,40144,421
2022-05-07,Calaveras,009,45235,7374,7353,376,7729,120
2022-05-07,Colusa,011,21464,3460,3459,1077,4536,21
2022-05-07,Contra Costa,013,1133247,195941,193961,14160,208121,1302
2022-05-07,Del Norte,015,27424,5913,5884,212,6096,50
2022-05-07,El Dorado,017,186661,27243,27081,3333,30414,210
2022-05-07,Fresno,019,978130,233257,232655,24375,257030,2754
2022-05-07,Glenn,021,27897,5001,4996,1623,6619,48
2022-05-07,Humboldt,023,135768,17674,17410,3211,20621,146
2022-05-07,Imperial,025,180216,55738,55683,10924,66607,917
2022-05-07,Inyo,027,18085,4108,4087,523,4610,56
2022-05-07,Kern,029,883053,193057,192590,46834,239424,2287
2022-05-07,Kings,031,150075,51766,51702,3649,55351,447
2022-05-07,Lake,033,64148,10808,10766,913,11679,137
2022-05-07,Lassen,035,31185,8977,8978,892,9870,65
2022-05-07,Los Angeles,037,10098052,2768073,2751478,128707,2880185,31738
2022-05-07,Madera,039,155013,37571,37420,6208,43628,365
2022-05-07,Marin,041,260295,35446,34934,3104,38038,292
2022-05-07,Mariposa,043,17540,2465,2438,222,2660,30
2022-05-07,Mendocino,045,87422,13344,13270,3243,16513,124
2022-05-07,Merced,047,269075,62685,62471,8885,71356,818
2022-05-07,Modoc,049,8938,746,745,255,1000,8
2022-05-07,Mono,051,14174,3003,2997,142,3139,6
2022-05-07,Monterey,053,433212,80702,80246,14597,94843,733
2022-05-07,Napa,055,140530,26730,26524,1076,27600,143
2022-05-07,Nevada,057,99092,16262,16171,1267,17438,127
2022-05-07,Orange,059,3164182,557034,554411,43262,597673,7007
2022-05-07,Placer,061,380077,64016,63577,7595,71172,625
2022-05-07,Plumas,063,18699,3005,2996,371,3367,13
2022-05-07,Riverside,065,2383286,598360,596022,28811,624833,6467
2022-05-07,Sacramento,067,1510023,286201,284564,27938,312502,3016
2022-05-07,San Benito,069,59416,13073,13047,545,13592,98
2022-05-07,San Bernardino,071,2135413,574818,570381,25559,595940,7306
2022-05-07,San Diego,073,3302833,766791,765377,54281,819658,5244
2022-05-07,San Francisco,075,870044,134598,132659,9047,141706,861
2022-05-07,San Joaquin,077,732212,168362,167568,10440,178008,2229
2022-05-07,San Luis Obispo,079,281455,53464,53273,4022,57295,477
2022-05-07,San Mateo,081,765935,129161,127615,7777,135392,709
2022-05-07,Santa Barbara,083,443738,87722,87305,4927,92232,692
2022-05-07,Santa Clara,085,1922200,327668,324946,13493,338439,2287
2022-05-07,Santa Cruz,087,273765,50346,49605,2267,51872,262
2022-05-07,Shasta,089,179085,30816,30721,6189,36910,563
2022-05-07,Sierra,091,2930,275,275,49,324,4
2022-05-07,Siskiyou,093,43540,4486,4470,2795,7265,81
2022-05-07,Solano,095,438530,83782,83038,5807,88845,450
2022-05-07,Sonoma,097,501317,87120,86150,3131,89281,488
2022-05-07,Stanislaus,099,539301,118568,118235,17927,136162,1643
2022-05-07,Sutter,101,95872,20659,20694,2176,22870,225
2022-05-07,Tehama,103,63373,12109,12098,2639,14737,201
2022-05-07,Trinity,105,12862,1188,1180,296,1476,20
2022-05-07,Tulare,107,460477,106997,106987,28880,135867,1468
2022-05-07,Tuolumne,109,53932,12880,12793,604,13397,181
2022-05-07,Ventura,111,848112,176309,175454,10066,185520,1491
2022-05-07,Yolo,113,214977,38393,37456,3346,40802,315
2022-05-07,Yuba,115,75493,16013,15964,1261,17225,122
2022-05-06,Alameda,001,1643700,268664,265198,15020,280218,1855
2022-05-06,Alpine,003,1148,125,125,1,126,0
2022-05-06,Amador,005,37829,8610,8556,677,9233,86
2022-05-06,Butte,007,227075,33386,33269,6873,40142,421
2022-05-06,Calaveras,009,45235,7371,7353,376,7729,120
2022-05-06,Colusa,011,21464,3460,3459,1077,4536,21
2022-05-06,Contra Costa,013,1133247,195715,193961,14147,208108,1302
2022-05-06,Del Norte,015,27424,5904,5884,212,6096,50
2022-05-06,El Dorado,017,186661,27218,27081,3331,30412,210
2022-05-06,Fresno,019,978130,233181,232655,24364,257019,2754
2022-05-06,Glenn,021,27897,5001,4996,1623,6619,48
2022-05-06,Humboldt,023,135768,17647,17410,3204,20614,146
2022-05-06,Imperial,025,180216,55728,55683,10919,66602,917
2022-05-06,Inyo,027,18085,4098,4087,520,4607,56
2022-05-06,Kern,029,883053,193005,192590,46805,239395,2287
2022-05-06,Kings,031,150075,51758,51702,3649,55351,447
2022-05-06,Lake,033,64148,10806,10766,913,11679,137
2022-05-06,Lassen,035,31185,8977,8978,892,9870,65
2022-05-06,Los Angeles,037,10098052,2766251,2751478,128564,2880042,31738
2022-05-06,Madera,039,155013,37557,37420,6205,43625,365
2022-05-06,Marin,041,260295,35368,34934,3056,37990,292
2022-05-06,Mariposa,043,17540,2464,2438,215,2653,30
2022-05-06,Mendocino,045,87422,13332,13270,3240,16510,124
2022-05-06,Merced,047,269075,62668,62471,8884,71355,818
2022-05-06,Modoc,049,8938,746,745,255,1000,8
2022-05-06,Mono,051,14174,3002,2997,142,3139,6
2022-05-06,Monterey,053,433212,80663,80246,14559,94805,733
2022-05-06,Napa,055,140530,26713,26524,1076,27600,143
2022-05-06,Nevada,057,99092,16250,16171,1264,17435,127
2022-05-06,Orange,059,3164182,556688,554411,43192,597603,7007
2022-05-06,Placer,061,380077,63956,63577,7582,71159,625
2022-05-06,Plumas,063,18699,3003,2996,371,3367,13
2022-05-06,Riverside,065,2383286,598131,596022,28789,624811,6467
2022-05-06,Sacramento,067,1510023,285945,284564,27918,312482,3016
2022-05-06,San Benito,069,59416,13069,13047,545,13592,98
2022-05-06,San Bernardino,071,2135413,574643,570381,25552,595933,7306
2022-05-06,San Diego,073,3302833,766280,765377,54245,819622,5244
2022-05-06,San Francisco,075,870044,134272,132659,9020,141679,861
2022-05-06,San Joaquin,077,732212,168272,167568,10427,177995,2229
2022-05-06,San Luis Obispo,079,281455,53440,53273,4017,57290,477
2022-05-06,San Mateo,081,765935,128934,127615,7768,135383,709
2022-05-06,Santa Barbara,083,443738,87668,87305,4925,92230,692
2022-05-06,Santa Clara,085,1922200,327077,324946,13478,338424,2287
2022-05-06,Santa Cruz,087,273765,50282,49605,2263,51868,262
2022-05-06,Shasta,089,179085,30810,30721,6188,36909,563
2022-05-06,Sierra,091,2930,275,275,49,324,4
2022-05-06,Siskiyou,093,43540,4484,4470,2792,7262,81
2022-05-06,Solano,095,438530,83694,83038,5799,88837,450
2022-05-06,Sonoma,097,501317,86998,86150,3116,89266,488
2022-05-06,Stanislaus,099,539301,118512,118235,17920,136155,1643
2022-05-06,Sutter,101,95872,20653,20694,2176,22870,225
2022-05-06,Tehama,103,63373,12104,12098,2639,14737,201
2022-05-06,Trinity,105,12862,1187,1180,296,1476,20
2022-05-06,Tulare,107,460477,106978,106987,28868,135855,1468
2022-05-06,Tuolumne,109,53932,12873,12793,603,13396,181
2022-05-06,Ventura,111,848112,176191,175454,10035,185489,1491
2022-05-06,Yolo,113,214977,38347,37456,3341,40797,315
2022-05-06,Yuba,115,75493,16002,15964,1260,17224,122
2022-05-05,Alameda,001,1643700,268077,265198,14973,280171,1855
2022-05-05,Alpine,003,1148,125,125,1,126,0
2022-05-05,Amador,005,37829,8608,8556,676,9232,86
2022-05-05,Butte,007,227075,33367,33269,6867,40136,421
2022-05-05,Calaveras,009,45235,7368,7353,373,7726,120
2022-05-05,Colusa,011,21464,3460,3459,1074,4533,21
2022-05-05,Contra Costa,013,1133247,195326,193961,14098,208059,1302
2022-05-05,Del Norte,015,27424,5903,5884,212,6096,50
2022-05-05,El Dorado,017,186661,27193,27081,3324,30405,210
2022-05-05,Fresno,019,978130,233080,232655,24340,256995,2754
2022-05-05,Glenn,021,27897,5001,4996,1623,6619,48
2022-05-05,Humboldt,023,135768,17610,17410,3190,20600,146
2022-05-05,Imperial,025,180216,55721,55683,10908,66591,917
2022-05-05,Inyo,027,18085,4094,4087,519,4606,56
2022-05-05,Kern,029,883053,192948,192590,46767,239357,2287
2022-05-05,Kings,031,150075,51750,51702,3649,55351,447
2022-05-05,Lake,033,64148,10802,10766,913,11679,137
2022-05-05,Lassen,035,31185,8977,8978,892,9870,65
2022-05-05,Los Angeles,037,10098052,2763666,2751478,128338,2879816,31738
2022-05-05,Madera,039,155013,37540,37420,6199,43619,365
2022-05-05,Marin,041,260295,35259,34934,3031,37965,292
2022-05-05,Mariposa,043,17540,2462,2438,214,2652,30
2022-05-05,Mendocino,045,87422,13321,13270,3231,16501,124
2022-05-05,Merced,047,269075,62635,62471,8879,71350,818
2022-05-05,Modoc,049,8938,746,745,253,998,8
2022-05-05,Mono,051,14174,3001,2997,141,3138,6
2022-05-05,Monterey,053,433212,80610,80246,14529,94775,733
2022-05-05,Napa,055,140530,26680,26524,1075,27599,143
2022-05-05,Nevada,057,99092,16240,16171,1261,17432,127
2022-05-05,Orange,059,3164182,556175,554411,43132,597543,7007
2022-05-05,Placer,061,380077,63895,63577,7573,71150,625
2022-05-05,Plumas,063,18699,3002,2996,371,3367,13
2022-05-05,Riverside,065,2383286,597791,596022,28759,624781,6467
2022-05-05,Sacramento,067,1510023,285611,284564,27861,312425,3016
2022-05-05,San Benito,069,59416,13058,13047,543,13590,98
2022-05-05,San Bernardino,071,2135413,574357,570381,25535,595916,7306
2022-05-05,San Diego,073,3302833,765542,765377,54175,819552,5244
2022-05-05,San Francisco,075,870044,133859,132659,8983,141642,861
2022-05-05,San Joaquin,077,732212,168180,167568,10395,177963,2229
2022-05-05,San Luis Obispo,079,281455,53404,53273,4000,57273,477
2022-05-05,San Mateo,081,765935,128598,127615,7739,135354,709
2022-05-05,Santa Barbara,083,443738,87593,87305,4920,92225,692
2022-05-05,Santa Clara,085,1922200,326279,324946,13416,338362,2287
2022-05-05,Santa Cruz,087,273765,50184,49605,2259,51864,262
2022-05-05,Shasta,089,179085,30800,30721,6186,36907,563
2022-05-05,Sierra,091,2930,275,275,49,324,4
2022-05-05,Siskiyou,093,43540,4482,4470,2792,7262,81
2022-05-05,Solano,095,438530,83574,83038,5781,88819,450
2022-05-05,Sonoma,097,501317,86825,86150,3097,89247,488
2022-05-05,Stanislaus,099,539301,118455,118235,17904,136139,1643
2022-05-05,Sutter,101,95872,20651,20694,2174,22868,225
2022-05-05,Tehama,103,63373,12100,12098,2637,14735,201
2022-05-05,Trinity,105,12862,1187,1180,296,1476,20
2022-05-05,Tulare,107,460477,106948,106987,28848,135835,1468
2022-05-05,Tuolumne,109,53932,12855,12793,599,13392,181
2022-05-05,Ventura,111,848112,176008,175454,9989,185443,1491
2022-05-05,Yolo,113,214977,38275,37456,3329,40785,315
2022-05-05,Yuba,115,75493,15992,15964,1257,17221,122
2022-05-04,Alameda,001,1643700,267417,263736,14929,278665,1850
2022-05-04,Alpine,003,1148,125,124,1,125,0
2022-05-04,Amador,005,37829,8605,8546,675,9221,86
2022-05-04,Butte,007,227075,33349,33220,6860,40080,417
2022-05-04,Calaveras,009,45235,7363,7344,373,7717,120
2022-05-04,Colusa,011,21464,3459,3460,1074,4534,21
2022-05-04,Contra Costa,013,1133247,194963,193175,14040,207215,1302
2022-05-04,Del Norte,015,27424,5895,5866,212,6078,50
2022-05-04,El Dorado,017,186661,27167,27021,3317,30338,210
2022-05-04,Fresno,019,978130,232963,232332,24327,256659,2751
2022-05-04,Glenn,021,27897,4999,4995,1623,6618,48
2022-05-04,Humboldt,023,135768,17570,17316,3179,20495,146
2022-05-04,Imperial,025,180216,55699,55548,10897,66445,910
2022-05-04,Inyo,027,18085,4094,4085,516,4601,56
2022-05-04,Kern,029,883053,192885,192432,46729,239161,2281
2022-05-04,Kings,031,150075,51733,51663,3647,55310,447
2022-05-04,Lake,033,64148,10797,10758,913,11671,137
2022-05-04,Lassen,035,31185,8976,8972,890,9862,65
2022-05-04,Los Angeles,037,10098052,2760891,2744894,128146,2873040,31722
2022-05-04,Madera,039,155013,37516,37395,6190,43585,365
2022-05-04,Marin,041,260295,35174,34727,3008,37735,291
2022-05-04,Mariposa,043,17540,2456,2435,209,2644,30
2022-05-04,Mendocino,045,87422,13313,13247,3223,16470,123
2022-05-04,Merced,047,269075,62609,62419,8869,71288,818
2022-05-04,Modoc,049,8938,746,746,253,999,8
2022-05-04,Mono,051,14174,3000,2993,138,3131,6
2022-05-04,Monterey,053,433212,80548,80038,14502,94540,732
2022-05-04,Napa,055,140530,26642,26434,1071,27505,143
2022-05-04,Nevada,057,99092,16224,16136,1257,17393,127
2022-05-04,Orange,059,3164182,555589,553177,43055,596232,7006
2022-05-04,Placer,061,380077,63812,63410,7567,70977,625
2022-05-04,Plumas,063,18699,3000,2947,371,3318,13
2022-05-04,Riverside,065,2383286,597455,594981,28729,623710,6457
2022-05-04,Sacramento,067,1510023,285283,283939,27820,311759,3013
2022-05-04,San Benito,069,59416,13048,13019,537,13556,98
2022-05-04,San Bernardino,071,2135413,574097,569570,25521,595091,7240
2022-05-04,San Diego,073,3302833,764795,763453,54083,817536,5239
2022-05-04,San Francisco,075,870044,133449,131599,8962,140561,860
2022-05-04,San Joaquin,077,732212,168075,167280,10363,177643,2225
2022-05-04,San Luis Obispo,079,281455,53360,53156,3989,57145,477
2022-05-04,San Mateo,081,765935,128276,126800,7703,134503,710
2022-05-04,Santa Barbara,083,443738,87489,87058,4905,91963,688
2022-05-04,Santa Clara,085,1922200,325471,322805,13357,336162,2285
2022-05-04,Santa Cruz,087,273765,50070,49230,2256,51486,262
2022-05-04,Shasta,089,179085,30784,30681,6183,36864,556
2022-05-04,Sierra,091,2930,275,275,49,324,4
2022-05-04,Siskiyou,093,43540,4478,4463,2788,7251,81
2022-05-04,Solano,095,438530,83430,82796,5769,88565,449
2022-05-04,Sonoma,097,501317,86649,85694,3073,88767,488
2022-05-04,Stanislaus,099,539301,118394,118123,17893,136016,1643
2022-05-04,Sutter,101,95872,20640,20672,2172,22844,224
2022-05-04,Tehama,103,63373,12098,12090,2634,14724,201
2022-05-04,Trinity,105,12862,1187,1180,296,1476,20
2022-05-04,Tulare,107,460477,106929,106935,28832,135767,1464
2022-05-04,Tuolumne,109,53932,12848,12757,597,13354,181
2022-05-04,Ventura,111,848112,175843,175066,9944,185010,1486
2022-05-04,Yolo,113,214977,38200,37344,3322,40666,315
2022-05-04,Yuba,115,75493,15983,15940,1254,17194,122
2022-05-03,Alameda,001,1643700,266803,263736,14883,278619,1850
2022-05-03,Alpine,003,1148,125,124,1,125,0
2022-05-03,Amador,005,37829,8602,8546,674,9220,86
2022-05-03,Butte,007,227075,33333,33220,6855,40075,417
2022-05-03,Calaveras,009,45235,7356,7344,372,7716,120
2022-05-03,Colusa,011,21464,3458,3460,1074,4534,21
2022-05-03,Contra Costa,013,1133247,194572,193175,13995,207170,1302
2022-05-03,Del Norte,015,27424,5889,5866,210,6076,50
2022-05-03,El Dorado,017,186661,27145,27021,3313,30334,210
2022-05-03,Fresno,019,978130,232853,232332,24307,256639,2751
2022-05-03,Glenn,021,27897,4998,4995,1621,6616,48
2022-05-03,Humboldt,023,135768,17534,17316,3159,20475,146
2022-05-03,Imperial,025,180216,55678,55548,10890,66438,910
2022-05-03,Inyo,027,18085,4092,4085,516,4601,56
2022-05-03,Kern,029,883053,192807,192432,46696,239128,2281
2022-05-03,Kings,031,150075,51721,51663,3647,55310,447
2022-05-03,Lake,033,64148,10792,10758,912,11670,137
2022-05-03,Lassen,035,31185,8976,8972,890,9862,65
2022-05-03,Los Angeles,037,10098052,2757833,2744894,127914,2872808,31722
2022-05-03,Madera,039,155013,37486,37395,6183,43578,365
2022-05-03,Marin,041,260295,35063,34727,2985,37712,291
2022-05-03,Mariposa,043,17540,2448,2435,209,2644,30
2022-05-03,Mendocino,045,87422,13299,13247,3205,16452,123
2022-05-03,Merced,047,269075,62582,62419,8849,71268,818
2022-05-03,Modoc,049,8938,745,746,253,999,8
2022-05-03,Mono,051,14174,2998,2993,137,3130,6
2022-05-03,Monterey,053,433212,80494,80038,14468,94506,732
2022-05-03,Napa,055,140530,26607,26434,1064,27498,143
2022-05-03,Nevada,057,99092,16213,16136,1256,17392,127
2022-05-03,Orange,059,3164182,555061,553177,42976,596153,7006
2022-05-03,Placer,061,380077,63718,63410,7553,70963,625
2022-05-03,Plumas,063,18699,2996,2947,371,3318,13
2022-05-03,Riverside,065,2383286,597086,594981,28703,623684,6457
2022-05-03,Sacramento,067,1510023,284970,283939,27768,311707,3013
2022-05-03,San Benito,069,59416,13034,13019,534,13553,98
2022-05-03,San Bernardino,071,2135413,573832,569570,25505,595075,7240
2022-05-03,San Diego,073,3302833,763952,763453,53985,817438,5239
2022-05-03,San Francisco,075,870044,132972,131599,8928,140527,860
2022-05-03,San Joaquin,077,732212,167991,167280,10332,177612,2225
2022-05-03,San Luis Obispo,079,281455,53312,53156,3979,57135,477
2022-05-03,San Mateo,081,765935,127932,126800,7663,134463,710
2022-05-03,Santa Barbara,083,443738,87397,87058,4902,91960,688
2022-05-03,Santa Clara,085,1922200,324655,322805,13302,336107,2285
2022-05-03,Santa Cruz,087,273765,49980,49230,2251,51481,262
2022-05-03,Shasta,089,179085,30765,30681,6182,36863,556
2022-05-03,Sierra,091,2930,275,275,49,324,4
2022-05-03,Siskiyou,093,43540,4477,4463,2788,7251,81
2022-05-03,Solano,095,438530,83243,82796,5759,88555,449
2022-05-03,Sonoma,097,501317,86470,85694,3048,88742,488
2022-05-03,Stanislaus,099,539301,118340,118123,17883,136006,1643
2022-05-03,Sutter,101,95872,20635,20672,2170,22842,224
2022-05-03,Tehama,103,63373,12094,12090,2633,14723,201
2022-05-03,Trinity,105,12862,1187,1180,296,1476,20
2022-05-03,Tulare,107,460477,106900,106935,28818,135753,1464
2022-05-03,Tuolumne,109,53932,12835,12757,597,13354,181
2022-05-03,Ventura,111,848112,175674,175066,9899,184965,1486
2022-05-03,Yolo,113,214977,38131,37344,3320,40664,315
2022-05-03,Yuba,115,75493,15972,15940,1246,17186,122
2022-05-02,Alameda,001,1643700,266178,263736,14838,278574,1850
2022-05-02,Alpine,003,1148,125,124,1,125,0
2022-05-02,Amador,005,37829,8599,8546,671,9217,86
2022-05-02,Butte,007,227075,33311,33220,6853,40073,417
2022-05-02,Calaveras,009,45235,7355,7344,371,7715,120
2022-05-02,Colusa,011,21464,3458,3460,1074,4534,21
2022-05-02,Contra Costa,013,1133247,194204,193175,13953,207128,1302
2022-05-02,Del Norte,015,27424,5884,5866,204,6070,50
2022-05-02,El Dorado,017,186661,27122,27021,3306,30327,210
2022-05-02,Fresno,019,978130,232743,232332,24277,256609,2751
2022-05-02,Glenn,021,27897,4996,4995,1621,6616,48
2022-05-02,Humboldt,023,135768,17484,17316,3144,20460,146
2022-05-02,Imperial,025,180216,55666,55548,10883,66431,910
2022-05-02,Inyo,027,18085,4091,4085,514,4599,56
2022-05-02,Kern,029,883053,192723,192432,46666,239098,2281
2022-05-02,Kings,031,150075,51705,51663,3647,55310,447
2022-05-02,Lake,033,64148,10788,10758,912,11670,137
2022-05-02,Lassen,035,31185,8975,8972,890,9862,65
2022-05-02,Los Angeles,037,10098052,2754791,2744894,127696,2872590,31722
2022-05-02,Madera,039,155013,37469,37395,6176,43571,365
2022-05-02,Marin,041,260295,34938,34727,2961,37688,291
2022-05-02,Mariposa,043,17540,2443,2435,209,2644,30
2022-05-02,Mendocino,045,87422,13281,13247,3192,16439,123
2022-05-02,Merced,047,269075,62551,62419,8842,71261,818
2022-05-02,Modoc,049,8938,744,746,253,999,8
2022-05-02,Mono,051,14174,2996,2993,135,3128,6
2022-05-02,Monterey,053,433212,80417,80038,14426,94464,732
2022-05-02,Napa,055,140530,26568,26434,1062,27496,143
2022-05-02,Nevada,057,99092,16195,16136,1254,17390,127
2022-05-02,Orange,059,3164182,554518,553177,42882,596059,7006
2022-05-02,Placer,061,380077,63661,63410,7545,70955,625
2022-05-02,Plumas,063,18699,2996,2947,371,3318,13
2022-05-02,Riverside,065,2383286,596696,594981,28670,623651,6457
2022-05-02,Sacramento,067,1510023,284661,283939,27725,311664,3013
2022-05-02,San Benito,069,59416,13022,13019,534,13553,98
2022-05-02,San Bernardino,071,2135413,573546,569570,25484,595054,7240
2022-05-02,San Diego,073,3302833,763088,763453,53891,817344,5239
2022-05-02,San Francisco,075,870044,132535,131599,8895,140494,860
2022-05-02,San Joaquin,077,732212,167874,167280,10320,177600,2225
2022-05-02,San Luis Obispo,079,281455,53259,53156,3967,57123,477
2022-05-02,San Mateo,081,765935,127608,126800,7648,134448,710
2022-05-02,Santa Barbara,083,443738,87296,87058,4898,91956,688
2022-05-02,Santa Clara,085,1922200,323748,322805,13254,336059,2285
2022-05-02,Santa Cruz,087,273765,49852,49230,2247,51477,262
2022-05-02,Shasta,089,179085,30746,30681,6181,36862,556
2022-05-02,Sierra,091,2930,275,275,49,324,4
2022-05-02,Siskiyou,093,43540,4474,4463,2786,7249,81
2022-05-02,Solano,095,438530,83103,82796,5748,88544,449
2022-05-02,Sonoma,097,501317,86288,85694,3028,88722,488
2022-05-02,Stanislaus,099,539301,118267,118123,17869,135992,1643
2022-05-02,Sutter,101,95872,20628,20672,2167,22839,224
2022-05-02,Tehama,103,63373,12089,12090,2630,14720,201
2022-05-02,Trinity,105,12862,1186,1180,296,1476,20
2022-05-02,Tulare,107,460477,106878,106935,28798,135733,1464
2022-05-02,Tuolumne,109,53932,12829,12757,597,13354,181
2022-05-02,Ventura,111,848112,175511,175066,9864,184930,1486
2022-05-02,Yolo,113,214977,38052,37344,3314,40658,315
2022-05-02,Yuba,115,75493,15967,15940,1243,17183,122
2022-05-01,Alameda,001,1643700,265479,262027,14784,276811,1851
2022-05-01,Alpine,003,1148,125,124,1,125,0
2022-05-01,Amador,005,37829,8599,8533,671,9204,86
2022-05-01,Butte,007,227075,33283,33172,6846,40018,418
2022-05-01,Calaveras,009,45235,7351,7328,365,7693,120
2022-05-01,Colusa,011,21464,3458,3457,1074,4531,21
2022-05-01,Contra Costa,013,1133247,193823,192136,13880,206016,1301
2022-05-01,Del Norte,015,27424,5876,5841,204,6045,50
2022-05-01,El Dorado,017,186661,27090,26946,3302,30248,210
2022-05-01,Fresno,019,978130,232638,232067,24256,256323,2748
2022-05-01,Glenn,021,27897,4996,4995,1621,6616,48
2022-05-01,Humboldt,023,135768,17420,17194,3118,20312,145
2022-05-01,Imperial,025,180216,55642,55503,10878,66381,910
2022-05-01,Inyo,027,18085,4090,4084,513,4597,56
2022-05-01,Kern,029,883053,192660,192250,46619,238869,2265
2022-05-01,Kings,031,150075,51683,51640,3643,55283,447
2022-05-01,Lake,033,64148,10781,10742,910,11652,137
2022-05-01,Lassen,035,31185,8975,8966,890,9856,65
2022-05-01,Los Angeles,037,10098052,2751783,2736900,127459,2864359,31712
2022-05-01,Madera,039,155013,37451,37360,6163,43523,365
2022-05-01,Marin,041,260295,34851,34519,2928,37447,291
2022-05-01,Mariposa,043,17540,2442,2430,209,2639,30
2022-05-01,Mendocino,045,87422,13262,13219,3174,16393,123
2022-05-01,Merced,047,269075,62520,62357,8824,71181,818
2022-05-01,Modoc,049,8938,744,745,253,998,8
2022-05-01,Mono,051,14174,2992,2989,132,3121,6
2022-05-01,Monterey,053,433212,80337,79881,14381,94262,731
2022-05-01,Napa,055,140530,26523,26319,1058,27377,143
2022-05-01,Nevada,057,99092,16175,16100,1251,17351,127
2022-05-01,Orange,059,3164182,553961,551822,42783,594605,6998
2022-05-01,Placer,061,380077,63588,63273,7529,70802,625
2022-05-01,Plumas,063,18699,2995,2946,371,3317,13
2022-05-01,Riverside,065,2383286,596234,593965,28632,622597,6457
2022-05-01,Sacramento,067,1510023,284329,283048,27660,310708,3007
2022-05-01,San Benito,069,59416,13014,12988,532,13520,98
2022-05-01,San Bernardino,071,2135413,573229,568758,25463,594221,7191
2022-05-01,San Diego,073,3302833,762206,761253,53801,815054,5238
2022-05-01,San Francisco,075,870044,132041,130241,8866,139107,860
2022-05-01,San Joaquin,077,732212,167732,167028,10284,177312,2225
2022-05-01,San Luis Obispo,079,281455,53188,53040,3949,56989,477
2022-05-01,San Mateo,081,765935,127242,125807,7608,133415,705
2022-05-01,Santa Barbara,083,443738,87191,86768,4888,91656,688
2022-05-01,Santa Clara,085,1922200,322808,320709,13199,333908,2281
2022-05-01,Santa Cruz,087,273765,49700,48798,2239,51037,262
2022-05-01,Shasta,089,179085,30730,30649,6179,36828,554
2022-05-01,Sierra,091,2930,275,274,49,323,4
2022-05-01,Siskiyou,093,43540,4473,4458,2780,7238,81
2022-05-01,Solano,095,438530,82971,82459,5734,88193,449
2022-05-01,Sonoma,097,501317,86068,85290,2998,88288,488
2022-05-01,Stanislaus,099,539301,118211,117943,17853,135796,1643
2022-05-01,Sutter,101,95872,20620,20644,2159,22803,224
2022-05-01,Tehama,103,63373,12088,12078,2629,14707,202
2022-05-01,Trinity,105,12862,1186,1179,296,1475,20
2022-05-01,Tulare,107,460477,106845,106856,28777,135633,1458
2022-05-01,Tuolumne,109,53932,12809,12713,591,13304,181
2022-05-01,Ventura,111,848112,175340,174679,9809,184488,1486
2022-05-01,Yolo,113,214977,37987,37173,3302,40475,314
2022-05-01,Yuba,115,75493,15957,15917,1239,17156,121
2022-04-30,Alameda,001,1643700,265081,262027,14769,276796,1851
2022-04-30,Alpine,003,1148,125,124,1,125,0
2022-04-30,Amador,005,37829,8597,8533,671,9204,86
2022-04-30,Butte,007,227075,33278,33172,6841,40013,418
2022-04-30,Calaveras,009,45235,7348,7328,364,7692,120
2022-04-30,Colusa,011,21464,3457,3457,1074,4531,21
2022-04-30,Contra Costa,013,1133247,193582,192136,13869,206005,1301
2022-04-30,Del Norte,015,27424,5871,5841,204,6045,50
2022-04-30,El Dorado,017,186661,27072,26946,3298,30244,210
2022-04-30,Fresno,019,978130,232593,232067,24247,256314,2748
2022-04-30,Glenn,021,27897,4995,4995,1621,6616,48
2022-04-30,Humboldt,023,135768,17378,17194,3109,20303,145
2022-04-30,Imperial,025,180216,55629,55503,10876,66379,910
2022-04-30,Inyo,027,18085,4090,4084,513,4597,56
2022-04-30,Kern,029,883053,192624,192250,46600,238850,2265
2022-04-30,Kings,031,150075,51678,51640,3642,55282,447
2022-04-30,Lake,033,64148,10778,10742,910,11652,137
2022-04-30,Lassen,035,31185,8975,8966,890,9856,65
2022-04-30,Los Angeles,037,10098052,2750411,2736900,127285,2864185,31712
2022-04-30,Madera,039,155013,37440,37360,6162,43522,365
2022-04-30,Marin,041,260295,34805,34519,2896,37415,291
2022-04-30,Mariposa,043,17540,2440,2430,208,2638,30
2022-04-30,Mendocino,045,87422,13258,13219,3174,16393,123
2022-04-30,Merced,047,269075,62506,62357,8822,71179,818
2022-04-30,Modoc,049,8938,744,745,253,998,8
2022-04-30,Mono,051,14174,2992,2989,131,3120,6
2022-04-30,Monterey,053,433212,80270,79881,14358,94239,731
2022-04-30,Napa,055,140530,26499,26319,1057,27376,143
2022-04-30,Nevada,057,99092,16161,16100,1250,17350,127
2022-04-30,Orange,059,3164182,553694,551822,42743,594565,6998
2022-04-30,Placer,061,380077,63543,63273,7523,70796,625
2022-04-30,Plumas,063,18699,2992,2946,371,3317,13
2022-04-30,Riverside,065,2383286,595990,593965,28611,622576,6457
2022-04-30,Sacramento,067,1510023,284207,283048,27647,310695,3007
2022-04-30,San Benito,069,59416,13011,12988,532,13520,98
2022-04-30,San Bernardino,071,2135413,573056,568758,25451,594209,7191
2022-04-30,San Diego,073,3302833,761832,761253,53773,815026,5238
2022-04-30,San Francisco,075,870044,131756,130241,8843,139084,860
2022-04-30,San Joaquin,077,732212,167677,167028,10278,177306,2225
2022-04-30,San Luis Obispo,079,281455,53177,53040,3946,56986,477
2022-04-30,San Mateo,081,765935,127024,125807,7588,133395,705
2022-04-30,Santa Barbara,083,443738,87135,86768,4884,91652,688
2022-04-30,Santa Clara,085,1922200,322234,320709,13174,333883,2281
2022-04-30,Santa Cruz,087,273765,49653,48798,2239,51037,262
2022-04-30,Shasta,089,179085,30724,30649,6177,36826,554
2022-04-30,Sierra,091,2930,275,274,49,323,4
2022-04-30,Siskiyou,093,43540,4471,4458,2779,7237,81
2022-04-30,Solano,095,438530,82954,82459,5733,88192,449
2022-04-30,Sonoma,097,501317,85951,85290,2986,88276,488
2022-04-30,Stanislaus,099,539301,118179,117943,17846,135789,1643
2022-04-30,Sutter,101,95872,20615,20644,2159,22803,224
2022-04-30,Tehama,103,63373,12084,12078,2627,14705,202
2022-04-30,Trinity,105,12862,1186,1179,296,1475,20
2022-04-30,Tulare,107,460477,106827,106856,28763,135619,1458
2022-04-30,Tuolumne,109,53932,12801,12713,591,13304,181
2022-04-30,Ventura,111,848112,175256,174679,9777,184456,1486
2022-04-30,Yolo,113,214977,37940,37173,3302,40475,314
2022-04-30,Yuba,115,75493,15950,15917,1238,17155,121
2022-04-29,Alameda,001,1643700,264768,262027,14754,276781,1851
2022-04-29,Alpine,003,1148,124,124,1,125,0
2022-04-29,Amador,005,37829,8590,8533,669,9202,86
2022-04-29,Butte,007,227075,33274,33172,6835,40007,418
2022-04-29,Calaveras,009,45235,7346,7328,364,7692,120
2022-04-29,Colusa,011,21464,3456,3457,1074,4531,21
2022-04-29,Contra Costa,013,1133247,193387,192136,13849,205985,1301
2022-04-29,Del Norte,015,27424,5867,5841,204,6045,50
2022-04-29,El Dorado,017,186661,27060,26946,3296,30242,210
2022-04-29,Fresno,019,978130,232542,232067,24238,256305,2748
2022-04-29,Glenn,021,27897,4995,4995,1620,6615,48
2022-04-29,Humboldt,023,135768,17353,17194,3101,20295,145
2022-04-29,Imperial,025,180216,55613,55503,10875,66378,910
2022-04-29,Inyo,027,18085,4090,4084,511,4595,56
2022-04-29,Kern,029,883053,192598,192250,46588,238838,2265
2022-04-29,Kings,031,150075,51673,51640,3642,55282,447
2022-04-29,Lake,033,64148,10777,10742,910,11652,137
2022-04-29,Lassen,035,31185,8974,8966,890,9856,65
2022-04-29,Los Angeles,037,10098052,2749111,2736900,127135,2864035,31712
2022-04-29,Madera,039,155013,37430,37360,6162,43522,365
2022-04-29,Marin,041,260295,34739,34519,2876,37395,291
2022-04-29,Mariposa,043,17540,2438,2430,208,2638,30
2022-04-29,Mendocino,045,87422,13253,13219,3173,16392,123
2022-04-29,Merced,047,269075,62494,62357,8821,71178,818
2022-04-29,Modoc,049,8938,744,745,253,998,8
2022-04-29,Mono,051,14174,2992,2989,131,3120,6
2022-04-29,Monterey,053,433212,80236,79881,14343,94224,731
2022-04-29,Napa,055,140530,26471,26319,1055,27374,143
2022-04-29,Nevada,057,99092,16154,16100,1249,17349,127
2022-04-29,Orange,059,3164182,553430,551822,42696,594518,6998
2022-04-29,Placer,061,380077,63514,63273,7516,70789,625
2022-04-29,Plumas,063,18699,2991,2946,371,3317,13
2022-04-29,Riverside,065,2383286,595770,593965,28590,622555,6457
2022-04-29,Sacramento,067,1510023,284061,283048,27639,310687,3007
2022-04-29,San Benito,069,59416,13006,12988,532,13520,98
2022-04-29,San Bernardino,071,2135413,572899,568758,25441,594199,7191
2022-04-29,San Diego,073,3302833,761413,761253,53748,815001,5238
2022-04-29,San Francisco,075,870044,131535,130241,8821,139062,860
2022-04-29,San Joaquin,077,732212,167621,167028,10273,177301,2225
2022-04-29,San Luis Obispo,079,281455,53162,53040,3941,56981,477
2022-04-29,San Mateo,081,765935,126826,125807,7573,133380,705
2022-04-29,Santa Barbara,083,443738,87095,86768,4882,91650,688
2022-04-29,Santa Clara,085,1922200,321725,320709,13143,333852,2281
2022-04-29,Santa Cruz,087,273765,49597,48798,2235,51033,262
2022-04-29,Shasta,089,179085,30722,30649,6176,36825,554
2022-04-29,Sierra,091,2930,275,274,49,323,4
2022-04-29,Siskiyou,093,43540,4470,4458,2779,7237,81
2022-04-29,Solano,095,438530,82897,82459,5727,88186,449
2022-04-29,Sonoma,097,501317,85843,85290,2971,88261,488
2022-04-29,Stanislaus,099,539301,118156,117943,17841,135784,1643
2022-04-29,Sutter,101,95872,20608,20644,2158,22802,224
2022-04-29,Tehama,103,63373,12082,12078,2627,14705,202
2022-04-29,Trinity,105,12862,1186,1179,296,1475,20
2022-04-29,Tulare,107,460477,106809,106856,28746,135602,1458
2022-04-29,Tuolumne,109,53932,12794,12713,588,13301,181
2022-04-29,Ventura,111,848112,175180,174679,9753,184432,1486
2022-04-29,Yolo,113,214977,37907,37173,3299,40472,314
2022-04-29,Yuba,115,75493,15945,15917,1238,17155,121
2022-04-28,Alameda,001,1643700,264328,262027,14716,276743,1851
2022-04-28,Alpine,003,1148,124,124,1,125,0
2022-04-28,Amador,005,37829,8587,8533,669,9202,86
2022-04-28,Butte,007,227075,33265,33172,6830,40002,418
2022-04-28,Calaveras,009,45235,7342,7328,364,7692,120
2022-04-28,Colusa,011,21464,3455,3457,1074,4531,21
2022-04-28,Contra Costa,013,1133247,193131,192136,13807,205943,1301
2022-04-28,Del Norte,015,27424,5863,5841,204,6045,50
2022-04-28,El Dorado,017,186661,27038,26946,3292,30238,210
2022-04-28,Fresno,019,978130,232483,232067,24228,256295,2748
2022-04-28,Glenn,021,27897,4992,4995,1620,6615,48
2022-04-28,Humboldt,023,135768,17319,17194,3085,20279,145
2022-04-28,Imperial,025,180216,55601,55503,10870,66373,910
2022-04-28,Inyo,027,18085,4090,4084,511,4595,56
2022-04-28,Kern,029,883053,192559,192250,46571,238821,2265
2022-04-28,Kings,031,150075,51667,51640,3642,55282,447
2022-04-28,Lake,033,64148,10773,10742,910,11652,137
2022-04-28,Lassen,035,31185,8974,8966,890,9856,65
2022-04-28,Los Angeles,037,10098052,2747044,2736900,126951,2863851,31712
2022-04-28,Madera,039,155013,37424,37360,6157,43517,365
2022-04-28,Marin,041,260295,34689,34519,2860,37379,291
2022-04-28,Mariposa,043,17540,2438,2430,208,2638,30
2022-04-28,Mendocino,045,87422,13242,13219,3156,16375,123
2022-04-28,Merced,047,269075,62476,62357,8813,71170,818
2022-04-28,Modoc,049,8938,744,745,253,998,8
2022-04-28,Mono,051,14174,2990,2989,131,3120,6
2022-04-28,Monterey,053,433212,80197,79881,14317,94198,731
2022-04-28,Napa,055,140530,26441,26319,1052,27371,143
2022-04-28,Nevada,057,99092,16146,16100,1246,17346,127
2022-04-28,Orange,059,3164182,553069,551822,42633,594455,6998
2022-04-28,Placer,061,380077,63466,63273,7508,70781,625
2022-04-28,Plumas,063,18699,2990,2946,371,3317,13
2022-04-28,Riverside,065,2383286,595487,593965,28564,622529,6457
2022-04-28,Sacramento,067,1510023,283880,283048,27598,310646,3007
2022-04-28,San Benito,069,59416,12997,12988,530,13518,98
2022-04-28,San Bernardino,071,2135413,572699,568758,25433,594191,7191
2022-04-28,San Diego,073,3302833,760871,761253,53685,814938,5238
2022-04-28,San Francisco,075,870044,131235,130241,8787,139028,860
2022-04-28,San Joaquin,077,732212,167551,167028,10258,177286,2225
2022-04-28,San Luis Obispo,079,281455,53134,53040,3923,56963,477
2022-04-28,San Mateo,081,765935,126581,125807,7544,133351,705
2022-04-28,Santa Barbara,083,443738,87042,86768,4879,91647,688
2022-04-28,Santa Clara,085,1922200,321184,320709,13107,333816,2281
2022-04-28,Santa Cruz,087,273765,49502,48798,2229,51027,262
2022-04-28,Shasta,089,179085,30714,30649,6176,36825,554
2022-04-28,Sierra,091,2930,275,274,49,323,4
2022-04-28,Siskiyou,093,43540,4467,4458,2779,7237,81
2022-04-28,Solano,095,438530,82813,82459,5721,88180,449
2022-04-28,Sonoma,097,501317,85728,85290,2958,88248,488
2022-04-28,Stanislaus,099,539301,118118,117943,17833,135776,1643
2022-04-28,Sutter,101,95872,20598,20644,2155,22799,224
2022-04-28,Tehama,103,63373,12081,12078,2626,14704,202
2022-04-28,Trinity,105,12862,1186,1179,296,1475,20
2022-04-28,Tulare,107,460477,106787,106856,28733,135589,1458
2022-04-28,Tuolumne,109,53932,12782,12713,587,13300,181
2022-04-28,Ventura,111,848112,175091,174679,9713,184392,1486
2022-04-28,Yolo,113,214977,37869,37173,3294,40467,314
2022-04-28,Yuba,115,75493,15936,15917,1235,17152,121
2022-04-27,Alameda,001,1643700,263845,260871,14671,275542,1843
2022-04-27,Alpine,003,1148,124,124,1,125,0
2022-04-27,Amador,005,37829,8586,8518,669,9187,86
2022-04-27,Butte,007,227075,33253,33118,6824,39942,411
2022-04-27,Calaveras,009,45235,7339,7307,364,7671,119
2022-04-27,Colusa,011,21464,3454,3457,1074,4531,21
2022-04-27,Contra Costa,013,1133247,192867,191412,13774,205186,1300
2022-04-27,Del Norte,015,27424,5858,5833,204,6037,50
2022-04-27,El Dorado,017,186661,27028,26898,3287,30185,209
2022-04-27,Fresno,019,978130,232418,231951,24213,256164,2744
2022-04-27,Glenn,021,27897,4992,4993,1620,6613,48
2022-04-27,Humboldt,023,135768,17289,17138,3074,20212,145
2022-04-27,Imperial,025,180216,55583,55480,10865,66345,910
2022-04-27,Inyo,027,18085,4089,4080,510,4590,56
2022-04-27,Kern,029,883053,192523,192157,46550,238707,2271
2022-04-27,Kings,031,150075,51662,51617,3641,55258,444
2022-04-27,Lake,033,64148,10769,10732,910,11642,135
2022-04-27,Lassen,035,31185,8973,8965,890,9855,65
2022-04-27,Los Angeles,037,10098052,2744716,2731988,126765,2858753,31691
2022-04-27,Madera,039,155013,37415,37339,6156,43495,354
2022-04-27,Marin,041,260295,34629,34354,2845,37199,288
2022-04-27,Mariposa,043,17540,2436,2427,208,2635,30
2022-04-27,Mendocino,045,87422,13235,13188,3147,16335,123
2022-04-27,Merced,047,269075,62462,62315,8809,71124,815
2022-04-27,Modoc,049,8938,744,745,253,998,8
2022-04-27,Mono,051,14174,2990,2989,131,3120,6
2022-04-27,Monterey,053,433212,80154,79695,14275,93970,729
2022-04-27,Napa,055,140530,26412,26210,1047,27257,143
2022-04-27,Nevada,057,99092,16130,16080,1243,17323,127
2022-04-27,Orange,059,3164182,552695,550859,42573,593432,6991
2022-04-27,Placer,061,380077,63424,63154,7491,70645,623
2022-04-27,Plumas,063,18699,2989,2934,371,3305,13
2022-04-27,Riverside,065,2383286,595222,593397,28543,621940,6453
2022-04-27,Sacramento,067,1510023,283679,281802,27563,309365,3001
2022-04-27,San Benito,069,59416,12984,12989,528,13517,98
2022-04-27,San Bernardino,071,2135413,572501,568018,25423,593441,7105
2022-04-27,San Diego,073,3302833,760299,759873,53623,813496,5236
2022-04-27,San Francisco,075,870044,130884,129284,8762,138046,857
2022-04-27,San Joaquin,077,732212,167478,166848,10241,177089,2225
2022-04-27,San Luis Obispo,079,281455,53089,52911,3911,56822,476
2022-04-27,San Mateo,081,765935,126350,125018,7486,132504,702
2022-04-27,Santa Barbara,083,443738,86978,86557,4872,91429,685
2022-04-27,Santa Clara,085,1922200,320617,319077,13059,332136,2282
2022-04-27,Santa Cruz,087,273765,49420,48500,2221,50721,262
2022-04-27,Shasta,089,179085,30702,30633,6172,36805,554
2022-04-27,Sierra,091,2930,274,276,49,325,4
2022-04-27,Siskiyou,093,43540,4467,4455,2775,7230,81
2022-04-27,Solano,095,438530,82701,82220,5710,87930,448
2022-04-27,Sonoma,097,501317,85618,84983,2936,87919,487
2022-04-27,Stanislaus,099,539301,118074,117841,17821,135662,1643
2022-04-27,Sutter,101,95872,20594,20627,2151,22778,224
2022-04-27,Tehama,103,63373,12081,12073,2626,14699,201
2022-04-27,Trinity,105,12862,1186,1179,296,1475,20
2022-04-27,Tulare,107,460477,106769,106580,28723,135303,1453
2022-04-27,Tuolumne,109,53932,12765,12684,586,13270,181
2022-04-27,Ventura,111,848112,174988,174425,9697,184122,1480
2022-04-27,Yolo,113,214977,37820,37096,3288,40384,314
2022-04-27,Yuba,115,75493,15932,15902,1230,17132,121
2022-04-26,Alameda,001,1643700,263334,260871,14628,275499,1843
2022-04-26,Alpine,003,1148,124,124,1,125,0
2022-04-26,Amador,005,37829,8583,8518,668,9186,86
2022-04-26,Butte,007,227075,33237,33118,6818,39936,411
2022-04-26,Calaveras,009,45235,7335,7307,363,7670,119
2022-04-26,Colusa,011,21464,3454,3457,1074,4531,21
2022-04-26,Contra Costa,013,1133247,192607,191412,13736,205148,1300
2022-04-26,Del Norte,015,27424,5851,5833,204,6037,50
2022-04-26,El Dorado,017,186661,27007,26898,3283,30181,209
2022-04-26,Fresno,019,978130,232339,231951,24203,256154,2744
2022-04-26,Glenn,021,27897,4992,4993,1619,6612,48
2022-04-26,Humboldt,023,135768,17258,17138,3067,20205,145
2022-04-26,Imperial,025,180216,55563,55480,10858,66338,910
2022-04-26,Inyo,027,18085,4089,4080,510,4590,56
2022-04-26,Kern,029,883053,192475,192157,46525,238682,2271
2022-04-26,Kings,031,150075,51656,51617,3641,55258,444
2022-04-26,Lake,033,64148,10762,10732,910,11642,135
2022-04-26,Lassen,035,31185,8968,8965,890,9855,65
2022-04-26,Los Angeles,037,10098052,2742327,2731988,126581,2858569,31691
2022-04-26,Madera,039,155013,37407,37339,6148,43487,354
2022-04-26,Marin,041,260295,34576,34354,2826,37180,288
2022-04-26,Mariposa,043,17540,2436,2427,208,2635,30
2022-04-26,Mendocino,045,87422,13231,13188,3141,16329,123
2022-04-26,Merced,047,269075,62439,62315,8791,71106,815
2022-04-26,Modoc,049,8938,744,745,253,998,8
2022-04-26,Mono,051,14174,2990,2989,130,3119,6
2022-04-26,Monterey,053,433212,80100,79695,14233,93928,729
2022-04-26,Napa,055,140530,26382,26210,1042,27252,143
2022-04-26,Nevada,057,99092,16121,16080,1243,17323,127
2022-04-26,Orange,059,3164182,552286,550859,42513,593372,6991
2022-04-26,Placer,061,380077,63394,63154,7489,70643,623
2022-04-26,Plumas,063,18699,2989,2934,371,3305,13
2022-04-26,Riverside,065,2383286,594915,593397,28515,621912,6453
2022-04-26,Sacramento,067,1510023,283445,281802,27540,309342,3001
2022-04-26,San Benito,069,59416,12980,12989,527,13516,98
2022-04-26,San Bernardino,071,2135413,572292,568018,25404,593422,7105
2022-04-26,San Diego,073,3302833,759641,759873,53521,813394,5236
2022-04-26,San Francisco,075,870044,130485,129284,8740,138024,857
2022-04-26,San Joaquin,077,732212,167416,166848,10228,177076,2225
2022-04-26,San Luis Obispo,079,281455,53059,52911,3899,56810,476
2022-04-26,San Mateo,081,765935,126080,125018,7449,132467,702
2022-04-26,Santa Barbara,083,443738,86917,86557,4866,91423,685
2022-04-26,Santa Clara,085,1922200,320056,319077,13009,332086,2282
2022-04-26,Santa Cruz,087,273765,49320,48500,2218,50718,262
2022-04-26,Shasta,089,179085,30690,30633,6172,36805,554
2022-04-26,Sierra,091,2930,274,276,49,325,4
2022-04-26,Siskiyou,093,43540,4465,4455,2773,7228,81
2022-04-26,Solano,095,438530,82602,82220,5701,87921,448
2022-04-26,Sonoma,097,501317,85512,84983,2917,87900,487
2022-04-26,Stanislaus,099,539301,118038,117841,17809,135650,1643
2022-04-26,Sutter,101,95872,20584,20627,2151,22778,224
2022-04-26,Tehama,103,63373,12072,12073,2626,14699,201
2022-04-26,Trinity,105,12862,1186,1179,296,1475,20
2022-04-26,Tulare,107,460477,106741,106580,28708,135288,1453
2022-04-26,Tuolumne,109,53932,12746,12684,584,13268,181
2022-04-26,Ventura,111,848112,174877,174425,9670,184095,1480
2022-04-26,Yolo,113,214977,37762,37096,3282,40378,314
2022-04-26,Yuba,115,75493,15930,15902,1230,17132,121
2022-04-25,Alameda,001,1643700,262826,260871,14583,275454,1843
2022-04-25,Alpine,003,1148,124,124,1,125,0
2022-04-25,Amador,005,37829,8580,8518,668,9186,86
2022-04-25,Butte,007,227075,33222,33118,6809,39927,411
2022-04-25,Calaveras,009,45235,7332,7307,363,7670,119
2022-04-25,Colusa,011,21464,3454,3457,1074,4531,21
2022-04-25,Contra Costa,013,1133247,192340,191412,13697,205109,1300
2022-04-25,Del Norte,015,27424,5845,5833,202,6035,50
2022-04-25,El Dorado,017,186661,26986,26898,3281,30179,209
2022-04-25,Fresno,019,978130,232249,231951,24187,256138,2744
2022-04-25,Glenn,021,27897,4991,4993,1619,6612,48
2022-04-25,Humboldt,023,135768,17216,17138,3059,20197,145
2022-04-25,Imperial,025,180216,55543,55480,10853,66333,910
2022-04-25,Inyo,027,18085,4089,4080,510,4590,56
2022-04-25,Kern,029,883053,192431,192157,46505,238662,2271
2022-04-25,Kings,031,150075,51647,51617,3640,55257,444
2022-04-25,Lake,033,64148,10759,10732,909,11641,135
2022-04-25,Lassen,035,31185,8967,8965,890,9855,65
2022-04-25,Los Angeles,037,10098052,2739941,2731988,126416,2858404,31691
2022-04-25,Madera,039,155013,37394,37339,6144,43483,354
2022-04-25,Marin,041,260295,34511,34354,2802,37156,288
2022-04-25,Mariposa,043,17540,2436,2427,207,2634,30
2022-04-25,Mendocino,045,87422,13221,13188,3123,16311,123
2022-04-25,Merced,047,269075,62426,62315,8788,71103,815
2022-04-25,Modoc,049,8938,744,745,253,998,8
2022-04-25,Mono,051,14174,2989,2989,130,3119,6
2022-04-25,Monterey,053,433212,80062,79695,14205,93900,729
2022-04-25,Napa,055,140530,26342,26210,1040,27250,143
2022-04-25,Nevada,057,99092,16115,16080,1241,17321,127
2022-04-25,Orange,059,3164182,551878,550859,42450,593309,6991
2022-04-25,Placer,061,380077,63358,63154,7484,70638,623
2022-04-25,Plumas,063,18699,2987,2934,371,3305,13
2022-04-25,Riverside,065,2383286,594650,593397,28496,621893,6453
2022-04-25,Sacramento,067,1510023,283281,281802,27504,309306,3001
2022-04-25,San Benito,069,59416,12973,12989,526,13515,98
2022-04-25,San Bernardino,071,2135413,572066,568018,25387,593405,7105
2022-04-25,San Diego,073,3302833,758962,759873,53449,813322,5236
2022-04-25,San Francisco,075,870044,130126,129284,8722,138006,857
2022-04-25,San Joaquin,077,732212,167332,166848,10211,177059,2225
2022-04-25,San Luis Obispo,079,281455,53010,52911,3891,56802,476
2022-04-25,San Mateo,081,765935,125808,125018,7428,132446,702
2022-04-25,Santa Barbara,083,443738,86856,86557,4860,91417,685
2022-04-25,Santa Clara,085,1922200,319411,319077,12963,332040,2282
2022-04-25,Santa Cruz,087,273765,49180,48500,2209,50709,262
2022-04-25,Shasta,089,179085,30678,30633,6169,36802,554
2022-04-25,Sierra,091,2930,274,276,49,325,4
2022-04-25,Siskiyou,093,43540,4465,4455,2772,7227,81
2022-04-25,Solano,095,438530,82484,82220,5690,87910,448
2022-04-25,Sonoma,097,501317,85389,84983,2897,87880,487
2022-04-25,Stanislaus,099,539301,117991,117841,17802,135643,1643
2022-04-25,Sutter,101,95872,20581,20627,2151,22778,224
2022-04-25,Tehama,103,63373,12072,12073,2626,14699,201
2022-04-25,Trinity,105,12862,1185,1179,296,1475,20
2022-04-25,Tulare,107,460477,106716,106580,28695,135275,1453
2022-04-25,Tuolumne,109,53932,12737,12684,584,13268,181
2022-04-25,Ventura,111,848112,174767,174425,9647,184072,1480
2022-04-25,Yolo,113,214977,37699,37096,3277,40373,314
2022-04-25,Yuba,115,75493,15920,15902,1229,17131,121
2022-04-24,Alameda,001,1643700,262242,259619,14535,274154,1837
2022-04-24,Alpine,003,1148,124,124,1,125,0
2022-04-24,Amador,005,37829,8571,8509,667,9176,86
2022-04-24,Butte,007,227075,33200,33105,6801,39906,411
2022-04-24,Calaveras,009,45235,7323,7296,361,7657,119
2022-04-24,Colusa,011,21464,3453,3453,1074,4527,21
2022-04-24,Contra Costa,013,1133247,192034,190611,13662,204273,1298
2022-04-24,Del Norte,015,27424,5836,5827,200,6027,50
2022-04-24,El Dorado,017,186661,26968,26837,3279,30116,209
2022-04-24,Fresno,019,978130,232168,231751,24172,255923,2744
2022-04-24,Glenn,021,27897,4991,4989,1617,6606,48
2022-04-24,Humboldt,023,135768,17191,17033,3044,20077,145
2022-04-24,Imperial,025,180216,55531,55434,10844,66278,910
2022-04-24,Inyo,027,18085,4085,4079,509,4588,56
2022-04-24,Kern,029,883053,192379,192012,46490,238502,2267
2022-04-24,Kings,031,150075,51638,51588,3640,55228,444
2022-04-24,Lake,033,64148,10751,10720,906,11626,134
2022-04-24,Lassen,035,31185,8966,8966,890,9856,65
2022-04-24,Los Angeles,037,10098052,2737593,2725630,126269,2851899,31667
2022-04-24,Madera,039,155013,37379,37333,6137,43470,354
2022-04-24,Marin,041,260295,34457,34150,2768,36918,288
2022-04-24,Mariposa,043,17540,2433,2422,207,2629,30
2022-04-24,Mendocino,045,87422,13216,13158,3111,16269,122
2022-04-24,Merced,047,269075,62402,62286,8778,71064,815
2022-04-24,Modoc,049,8938,744,745,253,998,8
2022-04-24,Mono,051,14174,2988,2986,130,3116,6
2022-04-24,Monterey,053,433212,80009,79560,14172,93732,729
2022-04-24,Napa,055,140530,26306,26093,1039,27132,143
2022-04-24,Nevada,057,99092,16099,16052,1239,17291,127
2022-04-24,Orange,059,3164182,551455,549765,42385,592150,6989
2022-04-24,Placer,061,380077,63304,63037,7476,70513,622
2022-04-24,Plumas,063,18699,2985,2934,371,3305,13
2022-04-24,Riverside,065,2383286,594374,592683,28454,621137,6450
2022-04-24,Sacramento,067,1510023,283075,280551,27467,308018,2993
2022-04-24,San Benito,069,59416,12968,12966,526,13492,98
2022-04-24,San Bernardino,071,2135413,571833,566806,25362,592168,7047
2022-04-24,San Diego,073,3302833,758332,758311,53388,811699,5233
2022-04-24,San Francisco,075,870044,129680,128323,8697,137020,857
2022-04-24,San Joaquin,077,732212,167244,166626,10168,176794,2224
2022-04-24,San Luis Obispo,079,281455,52934,52826,3880,56706,476
2022-04-24,San Mateo,081,765935,125500,124106,7394,131500,703
2022-04-24,Santa Barbara,083,443738,86787,86376,4858,91234,685
2022-04-24,Santa Clara,085,1922200,318726,317487,12908,330395,2277
2022-04-24,Santa Cruz,087,273765,49068,48255,2203,50458,261
2022-04-24,Shasta,089,179085,30666,30607,6167,36774,557
2022-04-24,Sierra,091,2930,274,276,49,325,4
2022-04-24,Siskiyou,093,43540,4463,4453,2770,7223,81
2022-04-24,Solano,095,438530,82377,81982,5681,87663,448
2022-04-24,Sonoma,097,501317,85254,84581,2875,87456,486
2022-04-24,Stanislaus,099,539301,117940,117737,17796,135533,1632
2022-04-24,Sutter,101,95872,20572,20605,2148,22753,224
2022-04-24,Tehama,103,63373,12068,12064,2626,14690,201
2022-04-24,Trinity,105,12862,1185,1177,296,1473,20
2022-04-24,Tulare,107,460477,106689,106354,28684,135038,1446
2022-04-24,Tuolumne,109,53932,12724,12664,583,13247,181
2022-04-24,Ventura,111,848112,174655,174091,9626,183717,1479
2022-04-24,Yolo,113,214977,37659,36990,3274,40264,314
2022-04-24,Yuba,115,75493,15916,15888,1228,17116,121
2022-04-23,Alameda,001,1643700,261997,259619,14522,274141,1837
2022-04-23,Alpine,003,1148,124,124,1,125,0
2022-04-23,Amador,005,37829,8565,8509,667,9176,86
2022-04-23,Butte,007,227075,33191,33105,6798,39903,411
2022-04-23,Calaveras,009,45235,7315,7296,361,7657,119
2022-04-23,Colusa,011,21464,3453,3453,1074,4527,21
2022-04-23,Contra Costa,013,1133247,191878,190611,13643,204254,1298
2022-04-23,Del Norte,015,27424,5834,5827,199,6026,50
2022-04-23,El Dorado,017,186661,26958,26837,3278,30115,209
2022-04-23,Fresno,019,978130,232135,231751,24166,255917,2744
2022-04-23,Glenn,021,27897,4991,4989,1617,6606,48
2022-04-23,Humboldt,023,135768,17175,17033,3041,20074,145
2022-04-23,Imperial,025,180216,55521,55434,10842,66276,910
2022-04-23,Inyo,027,18085,4085,4079,508,4587,56
2022-04-23,Kern,029,883053,192351,192012,46475,238487,2267
2022-04-23,Kings,031,150075,51633,51588,3639,55227,444
2022-04-23,Lake,033,64148,10750,10720,906,11626,134
2022-04-23,Lassen,035,31185,8966,8966,890,9856,65
2022-04-23,Los Angeles,037,10098052,2736654,2725630,126172,2851802,31667
2022-04-23,Madera,039,155013,37372,37333,6136,43469,354
2022-04-23,Marin,041,260295,34422,34150,2722,36872,288
2022-04-23,Mariposa,043,17540,2433,2422,207,2629,30
2022-04-23,Mendocino,045,87422,13209,13158,3111,16269,122
2022-04-23,Merced,047,269075,62392,62286,8778,71064,815
2022-04-23,Modoc,049,8938,744,745,253,998,8
2022-04-23,Mono,051,14174,2988,2986,130,3116,6
2022-04-23,Monterey,053,433212,79940,79560,14158,93718,729
2022-04-23,Napa,055,140530,26285,26093,1037,27130,143
2022-04-23,Nevada,057,99092,16093,16052,1237,17289,127
2022-04-23,Orange,059,3164182,551239,549765,42334,592099,6989
2022-04-23,Placer,061,380077,63274,63037,7476,70513,622
2022-04-23,Plumas,063,18699,2985,2934,371,3305,13
2022-04-23,Riverside,065,2383286,594236,592683,28443,621126,6450
2022-04-23,Sacramento,067,1510023,282977,280551,27464,308015,2993
2022-04-23,San Benito,069,59416,12967,12966,526,13492,98
2022-04-23,San Bernardino,071,2135413,571716,566806,25357,592163,7047
2022-04-23,San Diego,073,3302833,758070,758311,53370,811681,5233
2022-04-23,San Francisco,075,870044,129477,128323,8672,136995,857
2022-04-23,San Joaquin,077,732212,167203,166626,10160,176786,2224
2022-04-23,San Luis Obispo,079,281455,52919,52826,3876,56702,476
2022-04-23,San Mateo,081,765935,125342,124106,7384,131490,703
2022-04-23,Santa Barbara,083,443738,86751,86376,4857,91233,685
2022-04-23,Santa Clara,085,1922200,318349,317487,12881,330368,2277
2022-04-23,Santa Cruz,087,273765,49018,48255,2201,50456,261
2022-04-23,Shasta,089,179085,30663,30607,6167,36774,557
2022-04-23,Sierra,091,2930,274,276,49,325,4
2022-04-23,Siskiyou,093,43540,4461,4453,2769,7222,81
2022-04-23,Solano,095,438530,82350,81982,5678,87660,448
2022-04-23,Sonoma,097,501317,85186,84581,2865,87446,486
2022-04-23,Stanislaus,099,539301,117904,117737,17793,135530,1632
2022-04-23,Sutter,101,95872,20566,20605,2148,22753,224
2022-04-23,Tehama,103,63373,12067,12064,2626,14690,201
2022-04-23,Trinity,105,12862,1185,1177,296,1473,20
2022-04-23,Tulare,107,460477,106681,106354,28674,135028,1446
2022-04-23,Tuolumne,109,53932,12719,12664,583,13247,181
2022-04-23,Ventura,111,848112,174593,174091,9618,183709,1479
2022-04-23,Yolo,113,214977,37631,36990,3270,40260,314
2022-04-23,Yuba,115,75493,15914,15888,1228,17116,121
2022-04-22,Alameda,001,1643700,261759,259619,14503,274122,1837
2022-04-22,Alpine,003,1148,124,124,1,125,0
2022-04-22,Amador,005,37829,8564,8509,665,9174,86
2022-04-22,Butte,007,227075,33184,33105,6796,39901,411
2022-04-22,Calaveras,009,45235,7314,7296,361,7657,119
2022-04-22,Colusa,011,21464,3453,3453,1074,4527,21
2022-04-22,Contra Costa,013,1133247,191742,190611,13624,204235,1298
2022-04-22,Del Norte,015,27424,5834,5827,199,6026,50
2022-04-22,El Dorado,017,186661,26945,26837,3273,30110,209
2022-04-22,Fresno,019,978130,232105,231751,24161,255912,2744
2022-04-22,Glenn,021,27897,4990,4989,1617,6606,48
2022-04-22,Humboldt,023,135768,17159,17033,3034,20067,145
2022-04-22,Imperial,025,180216,55515,55434,10842,66276,910
2022-04-22,Inyo,027,18085,4085,4079,507,4586,56
2022-04-22,Kern,029,883053,192331,192012,46471,238483,2267
2022-04-22,Kings,031,150075,51629,51588,3638,55226,444
2022-04-22,Lake,033,64148,10749,10720,906,11626,134
2022-04-22,Lassen,035,31185,8966,8966,890,9856,65
2022-04-22,Los Angeles,037,10098052,2735559,2725630,126112,2851742,31667
2022-04-22,Madera,039,155013,37367,37333,6135,43468,354
2022-04-22,Marin,041,260295,34385,34150,2711,36861,288
2022-04-22,Mariposa,043,17540,2432,2422,207,2629,30
2022-04-22,Mendocino,045,87422,13204,13158,3106,16264,122
2022-04-22,Merced,047,269075,62385,62286,8766,71052,815
2022-04-22,Modoc,049,8938,744,745,253,998,8
2022-04-22,Mono,051,14174,2988,2986,129,3115,6
2022-04-22,Monterey,053,433212,79905,79560,14144,93704,729
2022-04-22,Napa,055,140530,26268,26093,1035,27128,143
2022-04-22,Nevada,057,99092,16093,16052,1237,17289,127
2022-04-22,Orange,059,3164182,551053,549765,42283,592048,6989
2022-04-22,Placer,061,380077,63251,63037,7473,70510,622
2022-04-22,Plumas,063,18699,2985,2934,371,3305,13
2022-04-22,Riverside,065,2383286,594093,592683,28427,621110,6450
2022-04-22,Sacramento,067,1510023,282889,280551,27451,308002,2993
2022-04-22,San Benito,069,59416,12962,12966,526,13492,98
2022-04-22,San Bernardino,071,2135413,571603,566806,25348,592154,7047
2022-04-22,San Diego,073,3302833,757750,758311,53342,811653,5233
2022-04-22,San Francisco,075,870044,129314,128323,8645,136968,857
2022-04-22,San Joaquin,077,732212,167173,166626,10159,176785,2224
2022-04-22,San Luis Obispo,079,281455,52913,52826,3875,56701,476
2022-04-22,San Mateo,081,765935,125180,124106,7370,131476,703
2022-04-22,Santa Barbara,083,443738,86704,86376,4856,91232,685
2022-04-22,Santa Clara,085,1922200,318000,317487,12864,330351,2277
2022-04-22,Santa Cruz,087,273765,48980,48255,2200,50455,261
2022-04-22,Shasta,089,179085,30658,30607,6166,36773,557
2022-04-22,Sierra,091,2930,274,276,48,324,4
2022-04-22,Siskiyou,093,43540,4461,4453,2769,7222,81
2022-04-22,Solano,095,438530,82293,81982,5676,87658,448
2022-04-22,Sonoma,097,501317,85122,84581,2861,87442,486
2022-04-22,Stanislaus,099,539301,117882,117737,17788,135525,1632
2022-04-22,Sutter,101,95872,20560,20605,2148,22753,224
2022-04-22,Tehama,103,63373,12062,12064,2625,14689,201
2022-04-22,Trinity,105,12862,1185,1177,295,1472,20
2022-04-22,Tulare,107,460477,106671,106354,28665,135019,1446
2022-04-22,Tuolumne,109,53932,12712,12664,581,13245,181
2022-04-22,Ventura,111,848112,174517,174091,9607,183698,1479
2022-04-22,Yolo,113,214977,37610,36990,3267,40257,314
2022-04-22,Yuba,115,75493,15911,15888,1227,17115,121
2022-04-21,Alameda,001,1643700,261400,259619,14461,274080,1837
2022-04-21,Alpine,003,1148,124,124,1,125,0
2022-04-21,Amador,005,37829,8561,8509,665,9174,86
2022-04-21,Butte,007,227075,33176,33105,6789,39894,411
2022-04-21,Calaveras,009,45235,7311,7296,361,7657,119
2022-04-21,Colusa,011,21464,3452,3453,1074,4527,21
2022-04-21,Contra Costa,013,1133247,191546,190611,13597,204208,1298
2022-04-21,Del Norte,015,27424,5833,5827,199,6026,50
2022-04-21,El Dorado,017,186661,26929,26837,3272,30109,209
2022-04-21,Fresno,019,978130,232063,231751,24153,255904,2744
2022-04-21,Glenn,021,27897,4990,4989,1616,6605,48
2022-04-21,Humboldt,023,135768,17136,17033,3025,20058,145
2022-04-21,Imperial,025,180216,55506,55434,10842,66276,910
2022-04-21,Inyo,027,18085,4085,4079,507,4586,56
2022-04-21,Kern,029,883053,192298,192012,46456,238468,2267
2022-04-21,Kings,031,150075,51621,51588,3638,55226,444
2022-04-21,Lake,033,64148,10746,10720,905,11625,134
2022-04-21,Lassen,035,31185,8966,8966,890,9856,65
2022-04-21,Los Angeles,037,10098052,2733915,2725630,125998,2851628,31667
2022-04-21,Madera,039,155013,37364,37333,6134,43467,354
2022-04-21,Marin,041,260295,34337,34150,2701,36851,288
2022-04-21,Mariposa,043,17540,2431,2422,207,2629,30
2022-04-21,Mendocino,045,87422,13197,13158,3102,16260,122
2022-04-21,Merced,047,269075,62367,62286,8763,71049,815
2022-04-21,Modoc,049,8938,744,745,253,998,8
2022-04-21,Mono,051,14174,2987,2986,128,3114,6
2022-04-21,Monterey,053,433212,79878,79560,14129,93689,729
2022-04-21,Napa,055,140530,26237,26093,1034,27127,143
2022-04-21,Nevada,057,99092,16089,16052,1237,17289,127
2022-04-21,Orange,059,3164182,550796,549765,42242,592007,6989
2022-04-21,Placer,061,380077,63213,63037,7467,70504,622
2022-04-21,Plumas,063,18699,2985,2934,371,3305,13
2022-04-21,Riverside,065,2383286,593933,592683,28408,621091,6450
2022-04-21,Sacramento,067,1510023,282741,280551,27427,307978,2993
2022-04-21,San Benito,069,59416,12956,12966,526,13492,98
2022-04-21,San Bernardino,071,2135413,571413,566806,25334,592140,7047
2022-04-21,San Diego,073,3302833,757325,758311,53298,811609,5233
2022-04-21,San Francisco,075,870044,129091,128323,8617,136940,857
2022-04-21,San Joaquin,077,732212,167120,166626,10153,176779,2224
2022-04-21,San Luis Obispo,079,281455,52893,52826,3868,56694,476
2022-04-21,San Mateo,081,765935,124979,124106,7349,131455,703
2022-04-21,Santa Barbara,083,443738,86645,86376,4852,91228,685
2022-04-21,Santa Clara,085,1922200,317549,317487,12842,330329,2277
2022-04-21,Santa Cruz,087,273765,48935,48255,2197,50452,261
2022-04-21,Shasta,089,179085,30650,30607,6166,36773,557
2022-04-21,Sierra,091,2930,274,276,48,324,4
2022-04-21,Siskiyou,093,43540,4461,4453,2769,7222,81
2022-04-21,Solano,095,438530,82231,81982,5669,87651,448
2022-04-21,Sonoma,097,501317,85008,84581,2841,87422,486
2022-04-21,Stanislaus,099,539301,117844,117737,17780,135517,1632
2022-04-21,Sutter,101,95872,20551,20605,2146,22751,224
2022-04-21,Tehama,103,63373,12062,12064,2625,14689,201
2022-04-21,Trinity,105,12862,1185,1177,295,1472,20
2022-04-21,Tulare,107,460477,106664,106354,28661,135015,1446
2022-04-21,Tuolumne,109,53932,12707,12664,580,13244,181
2022-04-21,Ventura,111,848112,174434,174091,9601,183692,1479
2022-04-21,Yolo,113,214977,37581,36990,3267,40257,314
2022-04-21,Yuba,115,75493,15909,15888,1227,17115,121
2022-04-20,Alameda,001,1643700,261036,258734,14431,273165,1832
2022-04-20,Alpine,003,1148,124,124,1,125,0
2022-04-20,Amador,005,37829,8559,8494,665,9159,86
2022-04-20,Butte,007,227075,33167,33083,6782,39865,408
2022-04-20,Calaveras,009,45235,7305,7288,360,7648,119
2022-04-20,Colusa,011,21464,3452,3453,1074,4527,21
2022-04-20,Contra Costa,013,1133247,191312,190042,13572,203614,1299
2022-04-20,Del Norte,015,27424,5828,5814,199,6013,50
2022-04-20,El Dorado,017,186661,26914,26821,3267,30088,209
2022-04-20,Fresno,019,978130,232013,231568,24151,255719,2740
2022-04-20,Glenn,021,27897,4989,4988,1613,6601,48
2022-04-20,Humboldt,023,135768,17114,16976,3020,19996,145
2022-04-20,Imperial,025,180216,55498,55405,10839,66244,910
2022-04-20,Inyo,027,18085,4085,4075,506,4581,56
2022-04-20,Kern,029,883053,192263,191915,46439,238354,2262
2022-04-20,Kings,031,150075,51612,51571,3636,55207,445
2022-04-20,Lake,033,64148,10746,10711,905,11616,134
2022-04-20,Lassen,035,31185,8966,8951,890,9841,65
2022-04-20,Los Angeles,037,10098052,2732177,2721699,125877,2847576,31630
2022-04-20,Madera,039,155013,37361,37333,6131,43464,354
2022-04-20,Marin,041,260295,34296,33985,2677,36662,288
2022-04-20,Mariposa,043,17540,2429,2412,207,2619,30
2022-04-20,Mendocino,045,87422,13191,13128,3090,16218,122
2022-04-20,Merced,047,269075,62357,62322,8748,71070,813
2022-04-20,Modoc,049,8938,744,744,253,997,8
2022-04-20,Mono,051,14174,2986,2984,128,3112,6
2022-04-20,Monterey,053,433212,79833,79419,14107,93526,727
2022-04-20,Napa,055,140530,26203,26016,1029,27045,143
2022-04-20,Nevada,057,99092,16079,16034,1234,17268,127
2022-04-20,Orange,059,3164182,550469,549136,42193,591329,6963
2022-04-20,Placer,061,380077,63188,62928,7462,70390,619
2022-04-20,Plumas,063,18699,2985,2932,371,3303,13
2022-04-20,Riverside,065,2383286,593739,592224,28385,620609,6447
2022-04-20,Sacramento,067,1510023,282598,279326,27408,306734,2987
2022-04-20,San Benito,069,59416,12950,12971,523,13494,98
2022-04-20,San Bernardino,071,2135413,571206,565405,25313,590718,6977
2022-04-20,San Diego,073,3302833,756881,757138,53238,810376,5231
2022-04-20,San Francisco,075,870044,128785,127594,8597,136191,854
2022-04-20,San Joaquin,077,732212,167049,166531,10144,176675,2222
2022-04-20,San Luis Obispo,079,281455,52866,52740,3860,56600,476
2022-04-20,San Mateo,081,765935,124761,123279,7316,130595,701
2022-04-20,Santa Barbara,083,443738,86608,86214,4845,91059,685
2022-04-20,Santa Clara,085,1922200,317139,316355,12803,329158,2274
2022-04-20,Santa Cruz,087,273765,48872,47997,2193,50190,261
2022-04-20,Shasta,089,179085,30646,30590,6165,36755,554
2022-04-20,Sierra,091,2930,274,276,48,324,4
2022-04-20,Siskiyou,093,43540,4460,4446,2768,7214,80
2022-04-20,Solano,095,438530,82159,81841,5667,87508,447
2022-04-20,Sonoma,097,501317,84920,84429,2817,87246,485
2022-04-20,Stanislaus,099,539301,117809,117540,17767,135307,1630
2022-04-20,Sutter,101,95872,20544,20632,2146,22778,224
2022-04-20,Tehama,103,63373,12059,12061,2624,14685,199
2022-04-20,Trinity,105,12862,1185,1178,295,1473,20
2022-04-20,Tulare,107,460477,106656,105974,28650,134624,1439
2022-04-20,Tuolumne,109,53932,12702,12648,579,13227,180
2022-04-20,Ventura,111,848112,174346,173904,9592,183496,1475
2022-04-20,Yolo,113,214977,37532,36785,3263,40048,311
2022-04-20,Yuba,115,75493,15905,15868,1225,17093,121
2022-04-19,Alameda,001,1643700,260681,258734,14396,273130,1832
2022-04-19,Alpine,003,1148,124,124,1,125,0
2022-04-19,Amador,005,37829,8555,8494,662,9156,86
2022-04-19,Butte,007,227075,33160,33083,6778,39861,408
2022-04-19,Calaveras,009,45235,7302,7288,360,7648,119
2022-04-19,Colusa,011,21464,3452,3453,1074,4527,21
2022-04-19,Contra Costa,013,1133247,191065,190042,13553,203595,1299
2022-04-19,Del Norte,015,27424,5826,5814,197,6011,50
2022-04-19,El Dorado,017,186661,26899,26821,3264,30085,209
2022-04-19,Fresno,019,978130,231959,231568,24140,255708,2740
2022-04-19,Glenn,021,27897,4988,4988,1613,6601,48
2022-04-19,Humboldt,023,135768,17076,16976,3009,19985,145
2022-04-19,Imperial,025,180216,55491,55405,10835,66240,910
2022-04-19,Inyo,027,18085,4082,4075,506,4581,56
2022-04-19,Kern,029,883053,192227,191915,46427,238342,2262
2022-04-19,Kings,031,150075,51598,51571,3635,55206,445
2022-04-19,Lake,033,64148,10742,10711,904,11615,134
2022-04-19,Lassen,035,31185,8966,8951,890,9841,65
2022-04-19,Los Angeles,037,10098052,2730380,2721699,125749,2847448,31630
2022-04-19,Madera,039,155013,37358,37333,6129,43462,354
2022-04-19,Marin,041,260295,34245,33985,2660,36645,288
2022-04-19,Mariposa,043,17540,2429,2412,206,2618,30
2022-04-19,Mendocino,045,87422,13183,13128,3079,16207,122
2022-04-19,Merced,047,269075,62338,62322,8743,71065,813
2022-04-19,Modoc,049,8938,744,744,253,997,8
2022-04-19,Mono,051,14174,2986,2984,128,3112,6
2022-04-19,Monterey,053,433212,79812,79419,14093,93512,727
2022-04-19,Napa,055,140530,26180,26016,1020,27036,143
2022-04-19,Nevada,057,99092,16073,16034,1232,17266,127
2022-04-19,Orange,059,3164182,550190,549136,42148,591284,6963
2022-04-19,Placer,061,380077,63156,62928,7457,70385,619
2022-04-19,Plumas,063,18699,2985,2932,371,3303,13
2022-04-19,Riverside,065,2383286,593556,592224,28370,620594,6447
2022-04-19,Sacramento,067,1510023,282423,279326,27384,306710,2987
2022-04-19,San Benito,069,59416,12944,12971,522,13493,98
2022-04-19,San Bernardino,071,2135413,570990,565405,25290,590695,6977
2022-04-19,San Diego,073,3302833,756417,757138,53175,810313,5231
2022-04-19,San Francisco,075,870044,128451,127594,8579,136173,854
2022-04-19,San Joaquin,077,732212,166998,166531,10137,176668,2222
2022-04-19,San Luis Obispo,079,281455,52831,52740,3852,56592,476
2022-04-19,San Mateo,081,765935,124531,123279,7293,130572,701
2022-04-19,Santa Barbara,083,443738,86554,86214,4837,91051,685
2022-04-19,Santa Clara,085,1922200,316717,316355,12773,329128,2274
2022-04-19,Santa Cruz,087,273765,48817,47997,2191,50188,261
2022-04-19,Shasta,089,179085,30634,30590,6164,36754,554
2022-04-19,Sierra,091,2930,274,276,48,324,4
2022-04-19,Siskiyou,093,43540,4459,4446,2766,7212,80
2022-04-19,Solano,095,438530,82081,81841,5662,87503,447
2022-04-19,Sonoma,097,501317,84817,84429,2789,87218,485
2022-04-19,Stanislaus,099,539301,117783,117540,17762,135302,1630
2022-04-19,Sutter,101,95872,20544,20632,2146,22778,224
2022-04-19,Tehama,103,63373,12058,12061,2624,14685,199
2022-04-19,Trinity,105,12862,1184,1178,295,1473,20
2022-04-19,Tulare,107,460477,106640,105974,28644,134618,1439
2022-04-19,Tuolumne,109,53932,12700,12648,579,13227,180
2022-04-19,Ventura,111,848112,174252,173904,9579,183483,1475
2022-04-19,Yolo,113,214977,37487,36785,3261,40046,311
2022-04-19,Yuba,115,75493,15898,15868,1225,17093,121
2022-04-18,Alameda,001,1643700,260295,258734,14374,273108,1832
2022-04-18,Alpine,003,1148,124,124,1,125,0
2022-04-18,Amador,005,37829,8554,8494,661,9155,86
2022-04-18,Butte,007,227075,33156,33083,6773,39856,408
2022-04-18,Calaveras,009,45235,7298,7288,359,7647,119
2022-04-18,Colusa,011,21464,3451,3453,1074,4527,21
2022-04-18,Contra Costa,013,1133247,190829,190042,13526,203568,1299
2022-04-18,Del Norte,015,27424,5821,5814,197,6011,50
2022-04-18,El Dorado,017,186661,26882,26821,3261,30082,209
2022-04-18,Fresno,019,978130,231914,231568,24129,255697,2740
2022-04-18,Glenn,021,27897,4987,4988,1612,6600,48
2022-04-18,Humboldt,023,135768,17045,16976,3006,19982,145
2022-04-18,Imperial,025,180216,55479,55405,10833,66238,910
2022-04-18,Inyo,027,18085,4082,4075,506,4581,56
2022-04-18,Kern,029,883053,192182,191915,46415,238330,2262
2022-04-18,Kings,031,150075,51593,51571,3635,55206,445
2022-04-18,Lake,033,64148,10738,10711,903,11614,134
2022-04-18,Lassen,035,31185,8966,8951,890,9841,65
2022-04-18,Los Angeles,037,10098052,2728546,2721699,125633,2847332,31630
2022-04-18,Madera,039,155013,37350,37333,6128,43461,354
2022-04-18,Marin,041,260295,34181,33985,2637,36622,288
2022-04-18,Mariposa,043,17540,2427,2412,206,2618,30
2022-04-18,Mendocino,045,87422,13166,13128,3073,16201,122
2022-04-18,Merced,047,269075,62326,62322,8737,71059,813
2022-04-18,Modoc,049,8938,743,744,253,997,8
2022-04-18,Mono,051,14174,2985,2984,128,3112,6
2022-04-18,Monterey,053,433212,79738,79419,14076,93495,727
2022-04-18,Napa,055,140530,26144,26016,1019,27035,143
2022-04-18,Nevada,057,99092,16063,16034,1230,17264,127
2022-04-18,Orange,059,3164182,549899,549136,42114,591250,6963
2022-04-18,Placer,061,380077,63123,62928,7455,70383,619
2022-04-18,Plumas,063,18699,2985,2932,371,3303,13
2022-04-18,Riverside,065,2383286,593348,592224,28349,620573,6447
2022-04-18,Sacramento,067,1510023,282266,279326,27371,306697,2987
2022-04-18,San Benito,069,59416,12938,12971,522,13493,98
2022-04-18,San Bernardino,071,2135413,570780,565405,25266,590671,6977
2022-04-18,San Diego,073,3302833,755948,757138,53115,810253,5231
2022-04-18,San Francisco,075,870044,128132,127594,8567,136161,854
2022-04-18,San Joaquin,077,732212,166939,166531,10130,176661,2222
2022-04-18,San Luis Obispo,079,281455,52803,52740,3847,56587,476
2022-04-18,San Mateo,081,765935,124299,123279,7270,130549,701
2022-04-18,Santa Barbara,083,443738,86483,86214,4832,91046,685
2022-04-18,Santa Clara,085,1922200,316269,316355,12748,329103,2274
2022-04-18,Santa Cruz,087,273765,48712,47997,2186,50183,261
2022-04-18,Shasta,089,179085,30628,30590,6161,36751,554
2022-04-18,Sierra,091,2930,274,276,48,324,4
2022-04-18,Siskiyou,093,43540,4458,4446,2765,7211,80
2022-04-18,Solano,095,438530,82020,81841,5656,87497,447
2022-04-18,Sonoma,097,501317,84718,84429,2773,87202,485
2022-04-18,Stanislaus,099,539301,117753,117540,17758,135298,1630
2022-04-18,Sutter,101,95872,20542,20632,2143,22775,224
2022-04-18,Tehama,103,63373,12054,12061,2624,14685,199
2022-04-18,Trinity,105,12862,1184,1178,295,1473,20
2022-04-18,Tulare,107,460477,106626,105974,28633,134607,1439
2022-04-18,Tuolumne,109,53932,12693,12648,578,13226,180
2022-04-18,Ventura,111,848112,174160,173904,9569,183473,1475
2022-04-18,Yolo,113,214977,37430,36785,3261,40046,311
2022-04-18,Yuba,115,75493,15889,15868,1222,17090,121
2022-04-17,Alameda,001,1643700,259905,257897,14346,272243,1829
2022-04-17,Alpine,003,1148,124,124,1,125,0
2022-04-17,Amador,005,37829,8549,8491,659,9150,86
2022-04-17,Butte,007,227075,33153,33053,6770,39823,405
2022-04-17,Calaveras,009,45235,7295,7275,357,7632,119
2022-04-17,Colusa,011,21464,3450,3450,1074,4524,21
2022-04-17,Contra Costa,013,1133247,190601,189742,13486,203228,1298
2022-04-17,Del Norte,015,27424,5817,5809,197,6006,50
2022-04-17,El Dorado,017,186661,26869,26796,3259,30055,209
2022-04-17,Fresno,019,978130,231836,231455,24122,255577,2739
2022-04-17,Glenn,021,27897,4987,4991,1612,6603,48
2022-04-17,Humboldt,023,135768,17011,16929,3000,19929,143
2022-04-17,Imperial,025,180216,55470,55371,10831,66202,910
2022-04-17,Inyo,027,18085,4080,4075,506,4581,56
2022-04-17,Kern,029,883053,192147,191866,46400,238266,2258
2022-04-17,Kings,031,150075,51582,51544,3633,55177,445
2022-04-17,Lake,033,64148,10737,10702,903,11605,134
2022-04-17,Lassen,035,31185,8966,8950,890,9840,65
2022-04-17,Los Angeles,037,10098052,2726552,2717479,125511,2842990,31598
2022-04-17,Madera,039,155013,37344,37362,6128,43490,354
2022-04-17,Marin,041,260295,34114,33829,2607,36436,288
2022-04-17,Mariposa,043,17540,2419,2406,206,2612,30
2022-04-17,Mendocino,045,87422,13151,13107,3069,16176,122
2022-04-17,Merced,047,269075,62306,62295,8730,71025,813
2022-04-17,Modoc,049,8938,743,743,253,996,8
2022-04-17,Mono,051,14174,2984,2977,128,3105,6
2022-04-17,Monterey,053,433212,79706,79311,14055,93366,727
2022-04-17,Napa,055,140530,26100,25929,1013,26942,143
2022-04-17,Nevada,057,99092,16047,16014,1225,17239,123
2022-04-17,Orange,059,3164182,549532,548311,42062,590373,6945
2022-04-17,Placer,061,380077,63083,62882,7448,70330,618
2022-04-17,Plumas,063,18699,2985,2929,371,3300,13
2022-04-17,Riverside,065,2383286,593130,591772,28326,620098,6443
2022-04-17,Sacramento,067,1510023,282104,278523,27345,305868,2978
2022-04-17,San Benito,069,59416,12935,12926,521,13447,98
2022-04-17,San Bernardino,071,2135413,570540,564397,25248,589645,6948
2022-04-17,San Diego,073,3302833,755457,756165,53047,809212,5229
2022-04-17,San Francisco,075,870044,127814,126976,8551,135527,854
2022-04-17,San Joaquin,077,732212,166889,166645,10123,176768,2220
2022-04-17,San Luis Obispo,079,281455,52734,52698,3842,56540,476
2022-04-17,San Mateo,081,765935,124063,122652,7254,129906,699
2022-04-17,Santa Barbara,083,443738,86425,86030,4826,90856,684
2022-04-17,Santa Clara,085,1922200,315772,315296,12719,328015,2268
2022-04-17,Santa Cruz,087,273765,48590,47895,2183,50078,261
2022-04-17,Shasta,089,179085,30617,30578,6157,36735,554
2022-04-17,Sierra,091,2930,274,276,48,324,4
2022-04-17,Siskiyou,093,43540,4453,4444,2764,7208,80
2022-04-17,Solano,095,438530,81957,81781,5652,87433,447
2022-04-17,Sonoma,097,501317,84606,84172,2765,86937,485
2022-04-17,Stanislaus,099,539301,117723,117567,17750,135317,1619
2022-04-17,Sutter,101,95872,20537,20621,2142,22763,224
2022-04-17,Tehama,103,63373,12053,12061,2624,14685,199
2022-04-17,Trinity,105,12862,1183,1178,295,1473,20
2022-04-17,Tulare,107,460477,106612,105757,28623,134380,1428
2022-04-17,Tuolumne,109,53932,12687,12640,578,13218,180
2022-04-17,Ventura,111,848112,174064,173665,9550,183215,1474
2022-04-17,Yolo,113,214977,37382,36752,3259,40011,311
2022-04-17,Yuba,115,75493,15883,15857,1222,17079,121
2022-04-16,Alameda,001,1643700,259750,257897,14336,272233,1829
2022-04-16,Alpine,003,1148,124,124,1,125,0
2022-04-16,Amador,005,37829,8547,8491,659,9150,86
2022-04-16,Butte,007,227075,33150,33053,6768,39821,405
2022-04-16,Calaveras,009,45235,7293,7275,357,7632,119
2022-04-16,Colusa,011,21464,3450,3450,1074,4524,21
2022-04-16,Contra Costa,013,1133247,190510,189742,13480,203222,1298
2022-04-16,Del Norte,015,27424,5817,5809,197,6006,50
2022-04-16,El Dorado,017,186661,26858,26796,3259,30055,209
2022-04-16,Fresno,019,978130,231808,231455,24121,255576,2739
2022-04-16,Glenn,021,27897,4987,4991,1612,6603,48
2022-04-16,Humboldt,023,135768,17003,16929,2995,19924,143
2022-04-16,Imperial,025,180216,55464,55371,10830,66201,910
2022-04-16,Inyo,027,18085,4080,4075,506,4581,56
2022-04-16,Kern,029,883053,192136,191866,46387,238253,2258
2022-04-16,Kings,031,150075,51579,51544,3633,55177,445
2022-04-16,Lake,033,64148,10735,10702,903,11605,134
2022-04-16,Lassen,035,31185,8966,8950,890,9840,65
2022-04-16,Los Angeles,037,10098052,2725846,2717479,125461,2842940,31598
2022-04-16,Madera,039,155013,37342,37362,6128,43490,354
2022-04-16,Marin,041,260295,34076,33829,2580,36409,288
2022-04-16,Mariposa,043,17540,2418,2406,206,2612,30
2022-04-16,Mendocino,045,87422,13145,13107,3069,16176,122
2022-04-16,Merced,047,269075,62303,62295,8730,71025,813
2022-04-16,Modoc,049,8938,743,743,253,996,8
2022-04-16,Mono,051,14174,2984,2977,128,3105,6
2022-04-16,Monterey,053,433212,79690,79311,14046,93357,727
2022-04-16,Napa,055,140530,26077,25929,1010,26939,143
2022-04-16,Nevada,057,99092,16044,16014,1224,17238,123
2022-04-16,Orange,059,3164182,549417,548311,42033,590344,6945
2022-04-16,Placer,061,380077,63067,62882,7446,70328,618
2022-04-16,Plumas,063,18699,2983,2929,371,3300,13
2022-04-16,Riverside,065,2383286,593050,591772,28320,620092,6443
2022-04-16,Sacramento,067,1510023,282053,278523,27337,305860,2978
2022-04-16,San Benito,069,59416,12934,12926,521,13447,98
2022-04-16,San Bernardino,071,2135413,570441,564397,25244,589641,6948
2022-04-16,San Diego,073,3302833,755310,756165,53035,809200,5229
2022-04-16,San Francisco,075,870044,127658,126976,8542,135518,854
2022-04-16,San Joaquin,077,732212,166849,166645,10119,176764,2220
2022-04-16,San Luis Obispo,079,281455,52728,52698,3841,56539,476
2022-04-16,San Mateo,081,765935,123967,122652,7247,129899,699
2022-04-16,Santa Barbara,083,443738,86395,86030,4826,90856,684
2022-04-16,Santa Clara,085,1922200,315531,315296,12710,328006,2268
2022-04-16,Santa Cruz,087,273765,48563,47895,2183,50078,261
2022-04-16,Shasta,089,179085,30613,30578,6157,36735,554
2022-04-16,Sierra,091,2930,274,276,48,324,4
2022-04-16,Siskiyou,093,43540,4453,4444,2764,7208,80
2022-04-16,Solano,095,438530,81942,81781,5649,87430,447
2022-04-16,Sonoma,097,501317,84556,84172,2755,86927,485
2022-04-16,Stanislaus,099,539301,117703,117567,17745,135312,1619
2022-04-16,Sutter,101,95872,20533,20621,2142,22763,224
2022-04-16,Tehama,103,63373,12052,12061,2624,14685,199
2022-04-16,Trinity,105,12862,1183,1178,295,1473,20
2022-04-16,Tulare,107,460477,106601,105757,28620,134377,1428
2022-04-16,Tuolumne,109,53932,12686,12640,578,13218,180
2022-04-16,Ventura,111,848112,174035,173665,9546,183211,1474
2022-04-16,Yolo,113,214977,37373,36752,3258,40010,311
2022-04-16,Yuba,115,75493,15879,15857,1222,17079,121
2022-04-15,Alameda,001,1643700,259566,257897,14328,272225,1829
2022-04-15,Alpine,003,1148,124,124,1,125,0
2022-04-15,Amador,005,37829,8546,8491,657,9148,86
2022-04-15,Butte,007,227075,33148,33053,6765,39818,405
2022-04-15,Calaveras,009,45235,7291,7275,357,7632,119
2022-04-15,Colusa,011,21464,3450,3450,1074,4524,21
2022-04-15,Contra Costa,013,1133247,190393,189742,13473,203215,1298
2022-04-15,Del Norte,015,27424,5817,5809,197,6006,50
2022-04-15,El Dorado,017,186661,26844,26796,3258,30054,209
2022-04-15,Fresno,019,978130,231779,231455,24121,255576,2739
2022-04-15,Glenn,021,27897,4987,4991,1612,6603,48
2022-04-15,Humboldt,023,135768,16991,16929,2994,19923,143
2022-04-15,Imperial,025,180216,55462,55371,10830,66201,910
2022-04-15,Inyo,027,18085,4080,4075,505,4580,56
2022-04-15,Kern,029,883053,192121,191866,46376,238242,2258
2022-04-15,Kings,031,150075,51575,51544,3633,55177,445
2022-04-15,Lake,033,64148,10730,10702,903,11605,134
2022-04-15,Lassen,035,31185,8966,8950,890,9840,65
2022-04-15,Los Angeles,037,10098052,2725072,2717479,125394,2842873,31598
2022-04-15,Madera,039,155013,37340,37362,6128,43490,354
2022-04-15,Marin,041,260295,34042,33829,2559,36388,288
2022-04-15,Mariposa,043,17540,2417,2406,206,2612,30
2022-04-15,Mendocino,045,87422,13139,13107,3067,16174,122
2022-04-15,Merced,047,269075,62299,62295,8730,71025,813
2022-04-15,Modoc,049,8938,743,743,253,996,8
2022-04-15,Mono,051,14174,2980,2977,127,3104,6
2022-04-15,Monterey,053,433212,79663,79311,14040,93351,727
2022-04-15,Napa,055,140530,26060,25929,1008,26937,143
2022-04-15,Nevada,057,99092,16042,16014,1223,17237,123
2022-04-15,Orange,059,3164182,549296,548311,42003,590314,6945
2022-04-15,Placer,061,380077,63052,62882,7445,70327,618
2022-04-15,Plumas,063,18699,2983,2929,371,3300,13
2022-04-15,Riverside,065,2383286,592949,591772,28314,620086,6443
2022-04-15,Sacramento,067,1510023,281974,278523,27333,305856,2978
2022-04-15,San Benito,069,59416,12932,12926,520,13446,98
2022-04-15,San Bernardino,071,2135413,570359,564397,25240,589637,6948
2022-04-15,San Diego,073,3302833,755119,756165,53016,809181,5229
2022-04-15,San Francisco,075,870044,127507,126976,8528,135504,854
2022-04-15,San Joaquin,077,732212,166827,166645,10116,176761,2220
2022-04-15,San Luis Obispo,079,281455,52720,52698,3841,56539,476
2022-04-15,San Mateo,081,765935,123836,122652,7236,129888,699
2022-04-15,Santa Barbara,083,443738,86362,86030,4825,90855,684
2022-04-15,Santa Clara,085,1922200,315238,315296,12702,327998,2268
2022-04-15,Santa Cruz,087,273765,48535,47895,2182,50077,261
2022-04-15,Shasta,089,179085,30604,30578,6157,36735,554
2022-04-15,Sierra,091,2930,274,276,48,324,4
2022-04-15,Siskiyou,093,43540,4451,4444,2763,7207,80
2022-04-15,Solano,095,438530,81917,81781,5649,87430,447
2022-04-15,Sonoma,097,501317,84504,84172,2739,86911,485
2022-04-15,Stanislaus,099,539301,117684,117567,17743,135310,1619
2022-04-15,Sutter,101,95872,20530,20621,2142,22763,224
2022-04-15,Tehama,103,63373,12052,12061,2624,14685,199
2022-04-15,Trinity,105,12862,1183,1178,295,1473,20
2022-04-15,Tulare,107,460477,106595,105757,28614,134371,1428
2022-04-15,Tuolumne,109,53932,12683,12640,575,13215,180
2022-04-15,Ventura,111,848112,174006,173665,9539,183204,1474
2022-04-15,Yolo,113,214977,37356,36752,3258,40010,311
2022-04-15,Yuba,115,75493,15876,15857,1222,17079,121
2022-04-14,Alameda,001,1643700,259297,257897,14317,272214,1829
2022-04-14,Alpine,003,1148,124,124,1,125,0
2022-04-14,Amador,005,37829,8546,8491,657,9148,86
2022-04-14,Butte,007,227075,33143,33053,6759,39812,405
2022-04-14,Calaveras,009,45235,7290,7275,357,7632,119
2022-04-14,Colusa,011,21464,3450,3450,1074,4524,21
2022-04-14,Contra Costa,013,1133247,190239,189742,13460,203202,1298
2022-04-14,Del Norte,015,27424,5815,5809,197,6006,50
2022-04-14,El Dorado,017,186661,26841,26796,3256,30052,209
2022-04-14,Fresno,019,978130,231753,231455,24120,255575,2739
2022-04-14,Glenn,021,27897,4986,4991,1610,6601,48
2022-04-14,Humboldt,023,135768,16976,16929,2992,19921,143
2022-04-14,Imperial,025,180216,55452,55371,10830,66201,910
2022-04-14,Inyo,027,18085,4080,4075,504,4579,56
2022-04-14,Kern,029,883053,192102,191866,46368,238234,2258
2022-04-14,Kings,031,150075,51567,51544,3633,55177,445
2022-04-14,Lake,033,64148,10729,10702,903,11605,134
2022-04-14,Lassen,035,31185,8966,8950,889,9839,65
2022-04-14,Los Angeles,037,10098052,2723986,2717479,125303,2842782,31598
2022-04-14,Madera,039,155013,37338,37362,6128,43490,354
2022-04-14,Marin,041,260295,34008,33829,2531,36360,288
2022-04-14,Mariposa,043,17540,2416,2406,206,2612,30
2022-04-14,Mendocino,045,87422,13134,13107,3067,16174,122
2022-04-14,Merced,047,269075,62294,62295,8729,71024,813
2022-04-14,Modoc,049,8938,742,743,253,996,8
2022-04-14,Mono,051,14174,2980,2977,126,3103,6
2022-04-14,Monterey,053,433212,79638,79311,14034,93345,727
2022-04-14,Napa,055,140530,26038,25929,1007,26936,143
2022-04-14,Nevada,057,99092,16035,16014,1222,17236,123
2022-04-14,Orange,059,3164182,549107,548311,41975,590286,6945
2022-04-14,Placer,061,380077,63034,62882,7440,70322,618
2022-04-14,Plumas,063,18699,2983,2929,371,3300,13
2022-04-14,Riverside,065,2383286,592833,591772,28303,620075,6443
2022-04-14,Sacramento,067,1510023,281854,278523,27318,305841,2978
2022-04-14,San Benito,069,59416,12926,12926,520,13446,98
2022-04-14,San Bernardino,071,2135413,570188,564397,25234,589631,6948
2022-04-14,San Diego,073,3302833,754841,756165,52978,809143,5229
2022-04-14,San Francisco,075,870044,127306,126976,8517,135493,854
2022-04-14,San Joaquin,077,732212,166796,166645,10113,176758,2220
2022-04-14,San Luis Obispo,079,281455,52704,52698,3837,56535,476
2022-04-14,San Mateo,081,765935,123681,122652,7217,129869,699
2022-04-14,Santa Barbara,083,443738,86317,86030,4823,90853,684
2022-04-14,Santa Clara,085,1922200,314936,315296,12693,327989,2268
2022-04-14,Santa Cruz,087,273765,48505,47895,2181,50076,261
2022-04-14,Shasta,089,179085,30602,30578,6156,36734,554
2022-04-14,Sierra,091,2930,274,276,48,324,4
2022-04-14,Siskiyou,093,43540,4451,4444,2762,7206,80
2022-04-14,Solano,095,438530,81878,81781,5642,87423,447
2022-04-14,Sonoma,097,501317,84412,84172,2734,86906,485
2022-04-14,Stanislaus,099,539301,117664,117567,17740,135307,1619
2022-04-14,Sutter,101,95872,20528,20621,2133,22754,224
2022-04-14,Tehama,103,63373,12051,12061,2623,14684,199
2022-04-14,Trinity,105,12862,1183,1178,295,1473,20
2022-04-14,Tulare,107,460477,106581,105757,28610,134367,1428
2022-04-14,Tuolumne,109,53932,12679,12640,574,13214,180
2022-04-14,Ventura,111,848112,173957,173665,9532,183197,1474
2022-04-14,Yolo,113,214977,37330,36752,3254,40006,311
2022-04-14,Yuba,115,75493,15873,15857,1222,17079,121
2022-04-13,Alameda,001,1643700,259046,257440,14297,271737,1833
2022-04-13,Alpine,003,1148,124,124,1,125,0
2022-04-13,Amador,005,37829,8544,8490,657,9147,86
2022-04-13,Butte,007,227075,33135,33044,6759,39803,402
2022-04-13,Calaveras,009,45235,7289,7270,357,7627,119
2022-04-13,Colusa,011,21464,3450,3451,1074,4525,21
2022-04-13,Contra Costa,013,1133247,190106,189471,13443,202914,1298
2022-04-13,Del Norte,015,27424,5813,5812,197,6009,50
2022-04-13,El Dorado,017,186661,26837,26794,3256,30050,208
2022-04-13,Fresno,019,978130,231721,231325,24107,255432,2738
2022-04-13,Glenn,021,27897,4985,4989,1610,6599,48
2022-04-13,Humboldt,023,135768,16962,16922,2991,19913,143
2022-04-13,Imperial,025,180216,55439,55353,10826,66179,910
2022-04-13,Inyo,027,18085,4080,4074,501,4575,56
2022-04-13,Kern,029,883053,192077,191859,46362,238221,2249
2022-04-13,Kings,031,150075,51561,51535,3633,55168,443
2022-04-13,Lake,033,64148,10727,10695,903,11598,134
2022-04-13,Lassen,035,31185,8965,8949,889,9838,65
2022-04-13,Los Angeles,037,10098052,2722728,2715722,125226,2840948,31578
2022-04-13,Madera,039,155013,37335,37361,6127,43488,354
2022-04-13,Marin,041,260295,33969,33747,2501,36248,288
2022-04-13,Mariposa,043,17540,2410,2402,206,2608,29
2022-04-13,Mendocino,045,87422,13125,13101,3065,16166,120
2022-04-13,Merced,047,269075,62284,62276,8728,71004,811
2022-04-13,Modoc,049,8938,742,743,253,996,8
2022-04-13,Mono,051,14174,2978,2971,126,3097,6
2022-04-13,Monterey,053,433212,79624,79179,14025,93204,727
2022-04-13,Napa,055,140530,26021,25892,1004,26896,143
2022-04-13,Nevada,057,99092,16029,16002,1222,17224,123
2022-04-13,Orange,059,3164182,548904,547783,41948,589731,6935
2022-04-13,Placer,061,380077,63007,62851,7436,70287,615
2022-04-13,Plumas,063,18699,2982,2923,371,3294,13
2022-04-13,Riverside,065,2383286,592694,591659,28295,619954,6437
2022-04-13,Sacramento,067,1510023,281769,277866,27315,305181,2974
2022-04-13,San Benito,069,59416,12920,12927,520,13447,98
2022-04-13,San Bernardino,071,2135413,570044,563709,25226,588935,6905
2022-04-13,San Diego,073,3302833,754555,755584,52946,808530,5223
2022-04-13,San Francisco,075,870044,127137,126608,8498,135106,850
2022-04-13,San Joaquin,077,732212,166761,166654,10111,176765,2219
2022-04-13,San Luis Obispo,079,281455,52680,52660,3837,56497,476
2022-04-13,San Mateo,081,765935,123530,122167,7191,129358,699
2022-04-13,Santa Barbara,083,443738,86279,85938,4818,90756,684
2022-04-13,Santa Clara,085,1922200,314667,314863,12675,327538,2267
2022-04-13,Santa Cruz,087,273765,48451,47765,2179,49944,260
2022-04-13,Shasta,089,179085,30600,30569,6156,36725,551
2022-04-13,Sierra,091,2930,274,276,48,324,4
2022-04-13,Siskiyou,093,43540,4450,4444,2761,7205,80
2022-04-13,Solano,095,438530,81840,81843,5639,87482,448
2022-04-13,Sonoma,097,501317,84343,84033,2719,86752,485
2022-04-13,Stanislaus,099,539301,117646,117573,17735,135308,1577
2022-04-13,Sutter,101,95872,20524,20610,2133,22743,223
2022-04-13,Tehama,103,63373,12050,12062,2622,14684,200
2022-04-13,Trinity,105,12862,1183,1177,295,1472,20
2022-04-13,Tulare,107,460477,106574,105519,28605,134124,1426
2022-04-13,Tuolumne,109,53932,12673,12639,574,13213,180
2022-04-13,Ventura,111,848112,173899,173558,9525,183083,1474
2022-04-13,Yolo,113,214977,37293,36684,3252,39936,311
2022-04-13,Yuba,115,75493,15869,15851,1222,17073,121
2022-04-12,Alameda,001,1643700,258802,257440,14287,271727,1833
2022-04-12,Alpine,003,1148,124,124,1,125,0
2022-04-12,Amador,005,37829,8543,8490,657,9147,86
2022-04-12,Butte,007,227075,33123,33044,6752,39796,402
2022-04-12,Calaveras,009,45235,7285,7270,356,7626,119
2022-04-12,Colusa,011,21464,3450,3451,1074,4525,21
2022-04-12,Contra Costa,013,1133247,189948,189471,13429,202900,1298
2022-04-12,Del Norte,015,27424,5811,5812,197,6009,50
2022-04-12,El Dorado,017,186661,26825,26794,3256,30050,208
2022-04-12,Fresno,019,978130,231691,231325,24100,255425,2738
2022-04-12,Glenn,021,27897,4985,4989,1610,6599,48
2022-04-12,Humboldt,023,135768,16954,16922,2989,19911,143
2022-04-12,Imperial,025,180216,55435,55353,10817,66170,910
2022-04-12,Inyo,027,18085,4080,4074,500,4574,56
2022-04-12,Kern,029,883053,192057,191859,46353,238212,2249
2022-04-12,Kings,031,150075,51553,51535,3631,55166,443
2022-04-12,Lake,033,64148,10723,10695,902,11597,134
2022-04-12,Lassen,035,31185,8965,8949,889,9838,65
2022-04-12,Los Angeles,037,10098052,2721482,2715722,125125,2840847,31578
2022-04-12,Madera,039,155013,37334,37361,6127,43488,354
2022-04-12,Marin,041,260295,33924,33747,2474,36221,288
2022-04-12,Mariposa,043,17540,2410,2402,206,2608,29
2022-04-12,Mendocino,045,87422,13117,13101,3059,16160,120
2022-04-12,Merced,047,269075,62270,62276,8725,71001,811
2022-04-12,Modoc,049,8938,742,743,252,995,8
2022-04-12,Mono,051,14174,2978,2971,126,3097,6
2022-04-12,Monterey,053,433212,79600,79179,14018,93197,727
2022-04-12,Napa,055,140530,25998,25892,994,26886,143
2022-04-12,Nevada,057,99092,16026,16002,1221,17223,123
2022-04-12,Orange,059,3164182,548650,547783,41915,589698,6935
2022-04-12,Placer,061,380077,62984,62851,7431,70282,615
2022-04-12,Plumas,063,18699,2981,2923,371,3294,13
2022-04-12,Riverside,065,2383286,592548,591659,28273,619932,6437
2022-04-12,Sacramento,067,1510023,281653,277866,27313,305179,2974
2022-04-12,San Benito,069,59416,12916,12927,519,13446,98
2022-04-12,San Bernardino,071,2135413,569871,563709,25220,588929,6905
2022-04-12,San Diego,073,3302833,754222,755584,52904,808488,5223
2022-04-12,San Francisco,075,870044,126927,126608,8482,135090,850
2022-04-12,San Joaquin,077,732212,166731,166654,10109,176763,2219
2022-04-12,San Luis Obispo,079,281455,52647,52660,3831,56491,476
2022-04-12,San Mateo,081,765935,123373,122167,7166,129333,699
2022-04-12,Santa Barbara,083,443738,86233,85938,4814,90752,684
2022-04-12,Santa Clara,085,1922200,314375,314863,12664,327527,2267
2022-04-12,Santa Cruz,087,273765,48372,47765,2176,49941,260
2022-04-12,Shasta,089,179085,30600,30569,6155,36724,551
2022-04-12,Sierra,091,2930,274,276,48,324,4
2022-04-12,Siskiyou,093,43540,4450,4444,2759,7203,80
2022-04-12,Solano,095,438530,81800,81843,5637,87480,448
2022-04-12,Sonoma,097,501317,84285,84033,2713,86746,485
2022-04-12,Stanislaus,099,539301,117626,117573,17729,135302,1577
2022-04-12,Sutter,101,95872,20521,20610,2133,22743,223
2022-04-12,Tehama,103,63373,12048,12062,2622,14684,200
2022-04-12,Trinity,105,12862,1183,1177,295,1472,20
2022-04-12,Tulare,107,460477,106559,105519,28600,134119,1426
2022-04-12,Tuolumne,109,53932,12671,12639,572,13211,180
2022-04-12,Ventura,111,848112,173850,173558,9519,183077,1474
2022-04-12,Yolo,113,214977,37254,36684,3245,39929,311
2022-04-12,Yuba,115,75493,15864,15851,1222,17073,121
2022-04-11,Alameda,001,1643700,258509,256649,14270,270919,1826
2022-04-11,Alpine,003,1148,124,124,1,125,0
2022-04-11,Amador,005,37829,8542,8489,657,9146,86
2022-04-11,Butte,007,227075,33110,33031,6748,39779,399
2022-04-11,Calaveras,009,45235,7282,7260,356,7616,119
2022-04-11,Colusa,011,21464,3448,3449,1074,4523,21
2022-04-11,Contra Costa,013,1133247,189781,189154,13412,202566,1296
2022-04-11,Del Norte,015,27424,5810,5811,197,6008,50
2022-04-11,El Dorado,017,186661,26813,26757,3255,30012,207
2022-04-11,Fresno,019,978130,231670,231090,24099,255189,2731
2022-04-11,Glenn,021,27897,4984,4988,1609,6597,47
2022-04-11,Humboldt,023,135768,16939,16913,2987,19900,141
2022-04-11,Imperial,025,180216,55430,55267,10815,66082,910
2022-04-11,Inyo,027,18085,4079,4071,500,4571,56
2022-04-11,Kern,029,883053,192032,191542,46348,237890,2244
2022-04-11,Kings,031,150075,51549,51519,3631,55150,443
2022-04-11,Lake,033,64148,10722,10690,901,11591,134
2022-04-11,Lassen,035,31185,8965,8948,889,9837,65
2022-04-11,Los Angeles,037,10098052,2720224,2709735,125054,2834789,31509
2022-04-11,Madera,039,155013,37327,37356,6127,43483,354
2022-04-11,Marin,041,260295,33868,33648,2455,36103,288
2022-04-11,Mariposa,043,17540,2409,2394,206,2600,29
2022-04-11,Mendocino,045,87422,13113,13087,3057,16144,120
2022-04-11,Merced,047,269075,62261,62231,8723,70954,811
2022-04-11,Modoc,049,8938,742,743,252,995,8
2022-04-11,Mono,051,14174,2977,2967,125,3092,6
2022-04-11,Monterey,053,433212,79580,79103,14007,93110,727
2022-04-11,Napa,055,140530,25981,25824,992,26816,144
2022-04-11,Nevada,057,99092,16022,15976,1221,17197,123
2022-04-11,Orange,059,3164182,548442,546983,41879,588862,6912
2022-04-11,Placer,061,380077,62962,62831,7429,70260,616
2022-04-11,Plumas,063,18699,2979,2887,371,3258,13
2022-04-11,Riverside,065,2383286,592421,591268,28254,619522,6429
2022-04-11,Sacramento,067,1510023,281552,277125,27310,304435,2972
2022-04-11,San Benito,069,59416,12914,12917,519,13436,98
2022-04-11,San Bernardino,071,2135413,569719,562571,25211,587782,6892
2022-04-11,San Diego,073,3302833,753895,754281,52865,807146,5210
2022-04-11,San Francisco,075,870044,126696,125963,8469,134432,844
2022-04-11,San Joaquin,077,732212,166693,166547,10103,176650,2212
2022-04-11,San Luis Obispo,079,281455,52624,52609,3830,56439,476
2022-04-11,San Mateo,081,765935,123187,121514,7152,128666,698
2022-04-11,Santa Barbara,083,443738,86185,85754,4809,90563,680
2022-04-11,Santa Clara,085,1922200,314032,313965,12649,326614,2266
2022-04-11,Santa Cruz,087,273765,48278,47624,2167,49791,259
2022-04-11,Shasta,089,179085,30595,30586,6154,36740,549
2022-04-11,Sierra,091,2930,274,272,48,320,4
2022-04-11,Siskiyou,093,43540,4450,4444,2757,7201,80
2022-04-11,Solano,095,438530,81772,81886,5636,87522,448
2022-04-11,Sonoma,097,501317,84217,83600,2702,86302,485
2022-04-11,Stanislaus,099,539301,117592,117528,17721,135249,1578
2022-04-11,Sutter,101,95872,20518,20591,2133,22724,223
2022-04-11,Tehama,103,63373,12047,12059,2621,14680,201
2022-04-11,Trinity,105,12862,1183,1177,295,1472,20
2022-04-11,Tulare,107,460477,106548,105278,28592,133870,1415
2022-04-11,Tuolumne,109,53932,12668,12632,572,13204,180
2022-04-11,Ventura,111,848112,173792,173343,9517,182860,1467
2022-04-11,Yolo,113,214977,37217,36587,3243,39830,312
2022-04-11,Yuba,115,75493,15861,15848,1221,17069,121
2022-04-10,Alameda,001,1643700,258172,256649,14257,270906,1826
2022-04-10,Alpine,003,1148,124,124,1,125,0
2022-04-10,Amador,005,37829,8540,8489,657,9146,86
2022-04-10,Butte,007,227075,33106,33031,6743,39774,399
2022-04-10,Calaveras,009,45235,7279,7260,356,7616,119
2022-04-10,Colusa,011,21464,3447,3449,1074,4523,21
2022-04-10,Contra Costa,013,1133247,189621,189154,13390,202544,1296
2022-04-10,Del Norte,015,27424,5807,5811,197,6008,50
2022-04-10,El Dorado,017,186661,26806,26757,3253,30010,207
2022-04-10,Fresno,019,978130,231632,231090,24097,255187,2731
2022-04-10,Glenn,021,27897,4984,4988,1609,6597,47
2022-04-10,Humboldt,023,135768,16929,16913,2985,19898,141
2022-04-10,Imperial,025,180216,55426,55267,10811,66078,910
2022-04-10,Inyo,027,18085,4079,4071,498,4569,56
2022-04-10,Kern,029,883053,192013,191542,46343,237885,2244
2022-04-10,Kings,031,150075,51547,51519,3631,55150,443
2022-04-10,Lake,033,64148,10718,10690,899,11589,134
2022-04-10,Lassen,035,31185,8964,8948,889,9837,65
2022-04-10,Los Angeles,037,10098052,2718895,2709735,124961,2834696,31509
2022-04-10,Madera,039,155013,37322,37356,6126,43482,354
2022-04-10,Marin,041,260295,33828,33648,2426,36074,288
2022-04-10,Mariposa,043,17540,2407,2394,206,2600,29
2022-04-10,Mendocino,045,87422,13105,13087,3056,16143,120
2022-04-10,Merced,047,269075,62249,62231,8720,70951,811
2022-04-10,Modoc,049,8938,742,743,252,995,8
2022-04-10,Mono,051,14174,2974,2967,125,3092,6
2022-04-10,Monterey,053,433212,79564,79103,13997,93100,727
2022-04-10,Napa,055,140530,25959,25824,990,26814,144
2022-04-10,Nevada,057,99092,16005,15976,1221,17197,123
2022-04-10,Orange,059,3164182,548190,546983,41838,588821,6912
2022-04-10,Placer,061,380077,62929,62831,7428,70259,616
2022-04-10,Plumas,063,18699,2976,2887,371,3258,13
2022-04-10,Riverside,065,2383286,592270,591268,28241,619509,6429
2022-04-10,Sacramento,067,1510023,281455,277125,27299,304424,2972
2022-04-10,San Benito,069,59416,12911,12917,519,13436,98
2022-04-10,San Bernardino,071,2135413,569484,562571,25200,587771,6892
2022-04-10,San Diego,073,3302833,753569,754281,52820,807101,5210
2022-04-10,San Francisco,075,870044,126458,125963,8453,134416,844
2022-04-10,San Joaquin,077,732212,166645,166547,10096,176643,2212
2022-04-10,San Luis Obispo,079,281455,52590,52609,3827,56436,476
2022-04-10,San Mateo,081,765935,123021,121514,7134,128648,698
2022-04-10,Santa Barbara,083,443738,86101,85754,4799,90553,680
2022-04-10,Santa Clara,085,1922200,313703,313965,12635,326600,2266
2022-04-10,Santa Cruz,087,273765,48188,47624,2164,49788,259
2022-04-10,Shasta,089,179085,30588,30586,6154,36740,549
2022-04-10,Sierra,091,2930,274,272,48,320,4
2022-04-10,Siskiyou,093,43540,4450,4444,2755,7199,80
2022-04-10,Solano,095,438530,81725,81886,5631,87517,448
2022-04-10,Sonoma,097,501317,84116,83600,2697,86297,485
2022-04-10,Stanislaus,099,539301,117569,117528,17714,135242,1578
2022-04-10,Sutter,101,95872,20514,20591,2129,22720,223
2022-04-10,Tehama,103,63373,12045,12059,2621,14680,201
2022-04-10,Trinity,105,12862,1183,1177,295,1472,20
2022-04-10,Tulare,107,460477,106533,105278,28585,133863,1415
2022-04-10,Tuolumne,109,53932,12661,12632,572,13204,180
2022-04-10,Ventura,111,848112,173713,173343,9511,182854,1467
2022-04-10,Yolo,113,214977,37186,36587,3237,39824,312
2022-04-10,Yuba,115,75493,15860,15848,1221,17069,121
2022-04-09,Alameda,001,1643700,257998,256649,14252,270901,1826
2022-04-09,Alpine,003,1148,124,124,1,125,0
2022-04-09,Amador,005,37829,8540,8489,656,9145,86
2022-04-09,Butte,007,227075,33103,33031,6743,39774,399
2022-04-09,Calaveras,009,45235,7278,7260,356,7616,119
2022-04-09,Colusa,011,21464,3446,3449,1074,4523,21
2022-04-09,Contra Costa,013,1133247,189524,189154,13381,202535,1296
2022-04-09,Del Norte,015,27424,5806,5811,197,6008,50
2022-04-09,El Dorado,017,186661,26799,26757,3253,30010,207
2022-04-09,Fresno,019,978130,231611,231090,24097,255187,2731
2022-04-09,Glenn,021,27897,4984,4988,1609,6597,47
2022-04-09,Humboldt,023,135768,16922,16913,2985,19898,141
2022-04-09,Imperial,025,180216,55421,55267,10811,66078,910
2022-04-09,Inyo,027,18085,4079,4071,498,4569,56
2022-04-09,Kern,029,883053,192004,191542,46338,237880,2244
2022-04-09,Kings,031,150075,51541,51519,3631,55150,443
2022-04-09,Lake,033,64148,10716,10690,899,11589,134
2022-04-09,Lassen,035,31185,8964,8948,889,9837,65
2022-04-09,Los Angeles,037,10098052,2718220,2709735,124888,2834623,31509
2022-04-09,Madera,039,155013,37319,37356,6126,43482,354
2022-04-09,Marin,041,260295,33795,33648,2383,36031,288
2022-04-09,Mariposa,043,17540,2407,2394,206,2600,29
2022-04-09,Mendocino,045,87422,13103,13087,3056,16143,120
2022-04-09,Merced,047,269075,62233,62231,8718,70949,811
2022-04-09,Modoc,049,8938,742,743,252,995,8
2022-04-09,Mono,051,14174,2973,2967,124,3091,6
2022-04-09,Monterey,053,433212,79555,79103,13993,93096,727
2022-04-09,Napa,055,140530,25935,25824,990,26814,144
2022-04-09,Nevada,057,99092,16002,15976,1221,17197,123
2022-04-09,Orange,059,3164182,548066,546983,41817,588800,6912
2022-04-09,Placer,061,380077,62913,62831,7426,70257,616
2022-04-09,Plumas,063,18699,2976,2887,371,3258,13
2022-04-09,Riverside,065,2383286,592179,591268,28231,619499,6429
2022-04-09,Sacramento,067,1510023,281408,277125,27297,304422,2972
2022-04-09,San Benito,069,59416,12910,12917,518,13435,98
2022-04-09,San Bernardino,071,2135413,569418,562571,25195,587766,6892
2022-04-09,San Diego,073,3302833,753421,754281,52806,807087,5210
2022-04-09,San Francisco,075,870044,126334,125963,8447,134410,844
2022-04-09,San Joaquin,077,732212,166629,166547,10093,176640,2212
2022-04-09,San Luis Obispo,079,281455,52590,52609,3824,56433,476
2022-04-09,San Mateo,081,765935,122931,121514,7127,128641,698
2022-04-09,Santa Barbara,083,443738,86068,85754,4799,90553,680
2022-04-09,Santa Clara,085,1922200,313507,313965,12632,326597,2266
2022-04-09,Santa Cruz,087,273765,48155,47624,2162,49786,259
2022-04-09,Shasta,089,179085,30586,30586,6154,36740,549
2022-04-09,Sierra,091,2930,274,272,48,320,4
2022-04-09,Siskiyou,093,43540,4449,4444,2754,7198,80
2022-04-09,Solano,095,438530,81707,81886,5630,87516,448
2022-04-09,Sonoma,097,501317,84077,83600,2693,86293,485
2022-04-09,Stanislaus,099,539301,117556,117528,17711,135239,1578
2022-04-09,Sutter,101,95872,20514,20591,2129,22720,223
2022-04-09,Tehama,103,63373,12045,12059,2621,14680,201
2022-04-09,Trinity,105,12862,1183,1177,295,1472,20
2022-04-09,Tulare,107,460477,106530,105278,28583,133861,1415
2022-04-09,Tuolumne,109,53932,12659,12632,572,13204,180
2022-04-09,Ventura,111,848112,173676,173343,9508,182851,1467
2022-04-09,Yolo,113,214977,37168,36587,3237,39824,312
2022-04-09,Yuba,115,75493,15859,15848,1221,17069,121
2022-04-08,Alameda,001,1643700,257842,256649,14246,270895,1826
2022-04-08,Alpine,003,1148,124,124,1,125,0
2022-04-08,Amador,005,37829,8538,8489,655,9144,86
2022-04-08,Butte,007,227075,33097,33031,6740,39771,399
2022-04-08,Calaveras,009,45235,7276,7260,356,7616,119
2022-04-08,Colusa,011,21464,3446,3449,1074,4523,21
2022-04-08,Contra Costa,013,1133247,189446,189154,13368,202522,1296
2022-04-08,Del Norte,015,27424,5804,5811,197,6008,50
2022-04-08,El Dorado,017,186661,26797,26757,3253,30010,207
2022-04-08,Fresno,019,978130,231591,231090,24094,255184,2731
2022-04-08,Glenn,021,27897,4984,4988,1609,6597,47
2022-04-08,Humboldt,023,135768,16918,16913,2983,19896,141
2022-04-08,Imperial,025,180216,55417,55267,10811,66078,910
2022-04-08,Inyo,027,18085,4077,4071,497,4568,56
2022-04-08,Kern,029,883053,191985,191542,46337,237879,2244
2022-04-08,Kings,031,150075,51536,51519,3631,55150,443
2022-04-08,Lake,033,64148,10716,10690,899,11589,134
2022-04-08,Lassen,035,31185,8964,8948,889,9837,65
2022-04-08,Los Angeles,037,10098052,2717590,2709735,124832,2834567,31509
2022-04-08,Madera,039,155013,37317,37356,6124,43480,354
2022-04-08,Marin,041,260295,33775,33648,2367,36015,288
2022-04-08,Mariposa,043,17540,2407,2394,205,2599,29
2022-04-08,Mendocino,045,87422,13101,13087,3056,16143,120
2022-04-08,Merced,047,269075,62226,62231,8716,70947,811
2022-04-08,Modoc,049,8938,742,743,252,995,8
2022-04-08,Mono,051,14174,2971,2967,124,3091,6
2022-04-08,Monterey,053,433212,79545,79103,13992,93095,727
2022-04-08,Napa,055,140530,25923,25824,982,26806,144
2022-04-08,Nevada,057,99092,15999,15976,1220,17196,123
2022-04-08,Orange,059,3164182,547947,546983,41802,588785,6912
2022-04-08,Placer,061,380077,62895,62831,7424,70255,616
2022-04-08,Plumas,063,18699,2973,2887,371,3258,13
2022-04-08,Riverside,065,2383286,592103,591268,28228,619496,6429
2022-04-08,Sacramento,067,1510023,281361,277125,27295,304420,2972
2022-04-08,San Benito,069,59416,12910,12917,518,13435,98
2022-04-08,San Bernardino,071,2135413,569365,562571,25192,587763,6892
2022-04-08,San Diego,073,3302833,753251,754281,52796,807077,5210
2022-04-08,San Francisco,075,870044,126238,125963,8443,134406,844
2022-04-08,San Joaquin,077,732212,166611,166547,10091,176638,2212
2022-04-08,San Luis Obispo,079,281455,52585,52609,3824,56433,476
2022-04-08,San Mateo,081,765935,122825,121514,7122,128636,698
2022-04-08,Santa Barbara,083,443738,86047,85754,4799,90553,680
2022-04-08,Santa Clara,085,1922200,313321,313965,12624,326589,2266
2022-04-08,Santa Cruz,087,273765,48138,47624,2159,49783,259
2022-04-08,Shasta,089,179085,30583,30586,6154,36740,549
2022-04-08,Sierra,091,2930,274,272,48,320,4
2022-04-08,Siskiyou,093,43540,4449,4444,2754,7198,80
2022-04-08,Solano,095,438530,81687,81886,5629,87515,448
2022-04-08,Sonoma,097,501317,84026,83600,2688,86288,485
2022-04-08,Stanislaus,099,539301,117541,117528,17710,135238,1578
2022-04-08,Sutter,101,95872,20514,20591,2129,22720,223
2022-04-08,Tehama,103,63373,12045,12059,2621,14680,201
2022-04-08,Trinity,105,12862,1183,1177,295,1472,20
2022-04-08,Tulare,107,460477,106525,105278,28579,133857,1415
2022-04-08,Tuolumne,109,53932,12658,12632,571,13203,180
2022-04-08,Ventura,111,848112,173647,173343,9506,182849,1467
2022-04-08,Yolo,113,214977,37159,36587,3236,39823,312
2022-04-08,Yuba,115,75493,15858,15848,1221,17069,121
2022-04-07,Alameda,001,1643700,257647,256649,14237,270886,1826
2022-04-07,Alpine,003,1148,124,124,1,125,0
2022-04-07,Amador,005,37829,8537,8489,653,9142,86
2022-04-07,Butte,007,227075,33093,33031,6739,39770,399
2022-04-07,Calaveras,009,45235,7274,7260,356,7616,119
2022-04-07,Colusa,011,21464,3445,3449,1074,4523,21
2022-04-07,Contra Costa,013,1133247,189326,189154,13355,202509,1296
2022-04-07,Del Norte,015,27424,5803,5811,197,6008,50
2022-04-07,El Dorado,017,186661,26785,26757,3251,30008,207
2022-04-07,Fresno,019,978130,231565,231090,24092,255182,2731
2022-04-07,Glenn,021,27897,4982,4988,1608,6596,47
2022-04-07,Humboldt,023,135768,16911,16913,2981,19894,141
2022-04-07,Imperial,025,180216,55415,55267,10808,66075,910
2022-04-07,Inyo,027,18085,4077,4071,497,4568,56
2022-04-07,Kern,029,883053,191961,191542,46334,237876,2244
2022-04-07,Kings,031,150075,51528,51519,3631,55150,443
2022-04-07,Lake,033,64148,10712,10690,899,11589,134
2022-04-07,Lassen,035,31185,8964,8948,889,9837,65
2022-04-07,Los Angeles,037,10098052,2716675,2709735,124755,2834490,31509
2022-04-07,Madera,039,155013,37312,37356,6124,43480,354
2022-04-07,Marin,041,260295,33757,33648,2347,35995,288
2022-04-07,Mariposa,043,17540,2404,2394,204,2598,29
2022-04-07,Mendocino,045,87422,13097,13087,3055,16142,120
2022-04-07,Merced,047,269075,62217,62231,8712,70943,811
2022-04-07,Modoc,049,8938,742,743,252,995,8
2022-04-07,Mono,051,14174,2970,2967,123,3090,6
2022-04-07,Monterey,053,433212,79524,79103,13988,93091,727
2022-04-07,Napa,055,140530,25907,25824,978,26802,144
2022-04-07,Nevada,057,99092,15991,15976,1219,17195,123
2022-04-07,Orange,059,3164182,547788,546983,41772,588755,6912
2022-04-07,Placer,061,380077,62878,62831,7421,70252,616
2022-04-07,Plumas,063,18699,2973,2887,371,3258,13
2022-04-07,Riverside,065,2383286,592001,591268,28214,619482,6429
2022-04-07,Sacramento,067,1510023,281295,277125,27288,304413,2972
2022-04-07,San Benito,069,59416,12909,12917,518,13435,98
2022-04-07,San Bernardino,071,2135413,569202,562571,25179,587750,6892
2022-04-07,San Diego,073,3302833,752984,754281,52764,807045,5210
2022-04-07,San Francisco,075,870044,126081,125963,8428,134391,844
2022-04-07,San Joaquin,077,732212,166572,166547,10088,176635,2212
2022-04-07,San Luis Obispo,079,281455,52567,52609,3822,56431,476
2022-04-07,San Mateo,081,765935,122703,121514,7105,128619,698
2022-04-07,Santa Barbara,083,443738,86003,85754,4796,90550,680
2022-04-07,Santa Clara,085,1922200,313098,313965,12611,326576,2266
2022-04-07,Santa Cruz,087,273765,48119,47624,2155,49779,259
2022-04-07,Shasta,089,179085,30581,30586,6154,36740,549
2022-04-07,Sierra,091,2930,274,272,48,320,4
2022-04-07,Siskiyou,093,43540,4449,4444,2752,7196,80
2022-04-07,Solano,095,438530,81657,81886,5628,87514,448
2022-04-07,Sonoma,097,501317,83983,83600,2682,86282,485
2022-04-07,Stanislaus,099,539301,117519,117528,17706,135234,1578
2022-04-07,Sutter,101,95872,20510,20591,2128,22719,223
2022-04-07,Tehama,103,63373,12043,12059,2621,14680,201
2022-04-07,Trinity,105,12862,1183,1177,295,1472,20
2022-04-07,Tulare,107,460477,106519,105278,28577,133855,1415
2022-04-07,Tuolumne,109,53932,12656,12632,570,13202,180
2022-04-07,Ventura,111,848112,173618,173343,9504,182847,1467
2022-04-07,Yolo,113,214977,37141,36587,3236,39823,312
2022-04-07,Yuba,115,75493,15856,15848,1221,17069,121
2022-04-06,Alameda,001,1643700,257460,256143,14230,270373,1814
2022-04-06,Alpine,003,1148,124,124,1,125,0
2022-04-06,Amador,005,37829,8536,8488,653,9141,86
2022-04-06,Butte,007,227075,33088,32997,6737,39734,396
2022-04-06,Calaveras,009,45235,7272,7258,356,7614,120
2022-04-06,Colusa,011,21464,3445,3447,1074,4521,21
2022-04-06,Contra Costa,013,1133247,189259,188850,13339,202189,1296
2022-04-06,Del Norte,015,27424,5802,5809,197,6006,50
2022-04-06,El Dorado,017,186661,26782,26744,3251,29995,205
2022-04-06,Fresno,019,978130,231530,230942,24087,255029,2725
2022-04-06,Glenn,021,27897,4982,4986,1607,6593,47
2022-04-06,Humboldt,023,135768,16907,16904,2980,19884,140
2022-04-06,Imperial,025,180216,55409,55294,10808,66102,908
2022-04-06,Inyo,027,18085,4076,4068,495,4563,56
2022-04-06,Kern,029,883053,191939,191449,46331,237780,2234
2022-04-06,Kings,031,150075,51527,51491,3630,55121,443
2022-04-06,Lake,033,64148,10708,10679,899,11578,136
2022-04-06,Lassen,035,31185,8964,8945,889,9834,65
2022-04-06,Los Angeles,037,10098052,2715629,2707306,124690,2831996,31465
2022-04-06,Madera,039,155013,37307,37349,6124,43473,354
2022-04-06,Marin,041,260295,33737,33566,2339,35905,288
2022-04-06,Mariposa,043,17540,2403,2392,204,2596,29
2022-04-06,Mendocino,045,87422,13093,13074,3054,16128,119
2022-04-06,Merced,047,269075,62208,62195,8709,70904,810
2022-04-06,Modoc,049,8938,742,741,252,993,8
2022-04-06,Mono,051,14174,2969,2967,123,3090,6
2022-04-06,Monterey,053,433212,79511,79019,13978,92997,727
2022-04-06,Napa,055,140530,25888,25790,974,26764,143
2022-04-06,Nevada,057,99092,15989,15974,1219,17193,123
2022-04-06,Orange,059,3164182,547618,546491,41745,588236,6887
2022-04-06,Placer,061,380077,62872,62787,7420,70207,615
2022-04-06,Plumas,063,18699,2973,2850,371,3221,13
2022-04-06,Riverside,065,2383286,591904,590826,28209,619035,6424
2022-04-06,Sacramento,067,1510023,281218,276567,27284,303851,2953
2022-04-06,San Benito,069,59416,12908,12908,518,13426,98
2022-04-06,San Bernardino,071,2135413,569071,561648,25177,586825,6883
2022-04-06,San Diego,073,3302833,752689,753402,52726,806128,5192
2022-04-06,San Francisco,075,870044,125922,125536,8421,133957,843
2022-04-06,San Joaquin,077,732212,166541,166415,10084,176499,2207
2022-04-06,San Luis Obispo,079,281455,52545,52557,3820,56377,475
2022-04-06,San Mateo,081,765935,122595,121041,7093,128134,693
2022-04-06,Santa Barbara,083,443738,85964,85630,4792,90422,679
2022-04-06,Santa Clara,085,1922200,312899,313278,12588,325866,2265
2022-04-06,Santa Cruz,087,273765,48064,47446,2149,49595,259
2022-04-06,Shasta,089,179085,30580,30565,6154,36719,529
2022-04-06,Sierra,091,2930,274,272,48,320,4
2022-04-06,Siskiyou,093,43540,4449,4442,2752,7194,80
2022-04-06,Solano,095,438530,81623,81789,5623,87412,447
2022-04-06,Sonoma,097,501317,83919,83361,2675,86036,485
2022-04-06,Stanislaus,099,539301,117503,117534,17700,135234,1578
2022-04-06,Sutter,101,95872,20505,20581,2128,22709,222
2022-04-06,Tehama,103,63373,12042,12049,2621,14670,198
2022-04-06,Trinity,105,12862,1183,1173,295,1468,20
2022-04-06,Tulare,107,460477,106513,104826,28572,133398,1414
2022-04-06,Tuolumne,109,53932,12654,12621,570,13191,180
2022-04-06,Ventura,111,848112,173564,173179,9499,182678,1460
2022-04-06,Yolo,113,214977,37116,36393,3235,39628,314
2022-04-06,Yuba,115,75493,15851,15839,1221,17060,121
2022-04-05,Alameda,001,1643700,257246,256143,14221,270364,1814
2022-04-05,Alpine,003,1148,124,124,1,125,0
2022-04-05,Amador,005,37829,8534,8488,653,9141,86
2022-04-05,Butte,007,227075,33082,32997,6733,39730,396
2022-04-05,Calaveras,009,45235,7268,7258,356,7614,120
2022-04-05,Colusa,011,21464,3443,3447,1073,4520,21
2022-04-05,Contra Costa,013,1133247,189163,188850,13332,202182,1296
2022-04-05,Del Norte,015,27424,5800,5809,197,6006,50
2022-04-05,El Dorado,017,186661,26770,26744,3251,29995,205
2022-04-05,Fresno,019,978130,231494,230942,24079,255021,2725
2022-04-05,Glenn,021,27897,4982,4986,1606,6592,47
2022-04-05,Humboldt,023,135768,16901,16904,2980,19884,140
2022-04-05,Imperial,025,180216,55407,55294,10808,66102,908
2022-04-05,Inyo,027,18085,4075,4068,494,4562,56
2022-04-05,Kern,029,883053,191919,191449,46328,237777,2234
2022-04-05,Kings,031,150075,51524,51491,3630,55121,443
2022-04-05,Lake,033,64148,10705,10679,899,11578,136
2022-04-05,Lassen,035,31185,8964,8945,889,9834,65
2022-04-05,Los Angeles,037,10098052,2714570,2707306,124615,2831921,31465
2022-04-05,Madera,039,155013,37300,37349,6122,43471,354
2022-04-05,Marin,041,260295,33682,33566,2324,35890,288
2022-04-05,Mariposa,043,17540,2403,2392,204,2596,29
2022-04-05,Mendocino,045,87422,13087,13074,3053,16127,119
2022-04-05,Merced,047,269075,62197,62195,8702,70897,810
2022-04-05,Modoc,049,8938,742,741,252,993,8
2022-04-05,Mono,051,14174,2968,2967,123,3090,6
2022-04-05,Monterey,053,433212,79488,79019,13966,92985,727
2022-04-05,Napa,055,140530,25879,25790,969,26759,143
2022-04-05,Nevada,057,99092,15981,15974,1219,17193,123
2022-04-05,Orange,059,3164182,547432,546491,41716,588207,6887
2022-04-05,Placer,061,380077,62846,62787,7420,70207,615
2022-04-05,Plumas,063,18699,2973,2850,371,3221,13
2022-04-05,Riverside,065,2383286,591783,590826,28197,619023,6424
2022-04-05,Sacramento,067,1510023,281139,276567,27279,303846,2953
2022-04-05,San Benito,069,59416,12900,12908,518,13426,98
2022-04-05,San Bernardino,071,2135413,568945,561648,25165,586813,6883
2022-04-05,San Diego,073,3302833,752382,753402,52681,806083,5192
2022-04-05,San Francisco,075,870044,125719,125536,8413,133949,843
2022-04-05,San Joaquin,077,732212,166499,166415,10081,176496,2207
2022-04-05,San Luis Obispo,079,281455,52528,52557,3815,56372,475
2022-04-05,San Mateo,081,765935,122478,121041,7082,128123,693
2022-04-05,Santa Barbara,083,443738,85928,85630,4790,90420,679
2022-04-05,Santa Clara,085,1922200,312639,313278,12575,325853,2265
2022-04-05,Santa Cruz,087,273765,47997,47446,2146,49592,259
2022-04-05,Shasta,089,179085,30580,30565,6152,36717,529
2022-04-05,Sierra,091,2930,274,272,48,320,4
2022-04-05,Siskiyou,093,43540,4449,4442,2752,7194,80
2022-04-05,Solano,095,438530,81573,81789,5620,87409,447
2022-04-05,Sonoma,097,501317,83855,83361,2666,86027,485
2022-04-05,Stanislaus,099,539301,117489,117534,17690,135224,1578
2022-04-05,Sutter,101,95872,20501,20581,2127,22708,222
2022-04-05,Tehama,103,63373,12040,12049,2620,14669,198
2022-04-05,Trinity,105,12862,1183,1173,295,1468,20
2022-04-05,Tulare,107,460477,106502,104826,28569,133395,1414
2022-04-05,Tuolumne,109,53932,12653,12621,570,13191,180
2022-04-05,Ventura,111,848112,173507,173179,9491,182670,1460
2022-04-05,Yolo,113,214977,37101,36393,3232,39625,314
2022-04-05,Yuba,115,75493,15849,15839,1221,17060,121
2022-04-04,Alameda,001,1643700,257013,256143,14207,270350,1814
2022-04-04,Alpine,003,1148,124,124,1,125,0
2022-04-04,Amador,005,37829,8533,8488,652,9140,86
2022-04-04,Butte,007,227075,33077,32997,6730,39727,396
2022-04-04,Calaveras,009,45235,7268,7258,356,7614,120
2022-04-04,Colusa,011,21464,3442,3447,1073,4520,21
2022-04-04,Contra Costa,013,1133247,189063,188850,13324,202174,1296
2022-04-04,Del Norte,015,27424,5800,5809,197,6006,50
2022-04-04,El Dorado,017,186661,26765,26744,3249,29993,205
2022-04-04,Fresno,019,978130,231476,230942,24074,255016,2725
2022-04-04,Glenn,021,27897,4981,4986,1606,6592,47
2022-04-04,Humboldt,023,135768,16893,16904,2975,19879,140
2022-04-04,Imperial,025,180216,55402,55294,10808,66102,908
2022-04-04,Inyo,027,18085,4075,4068,492,4560,56
2022-04-04,Kern,029,883053,191897,191449,46322,237771,2234
2022-04-04,Kings,031,150075,51517,51491,3630,55121,443
2022-04-04,Lake,033,64148,10700,10679,899,11578,136
2022-04-04,Lassen,035,31185,8964,8945,889,9834,65
2022-04-04,Los Angeles,037,10098052,2713470,2707306,124568,2831874,31465
2022-04-04,Madera,039,155013,37296,37349,6122,43471,354
2022-04-04,Marin,041,260295,33665,33566,2315,35881,288
2022-04-04,Mariposa,043,17540,2402,2392,204,2596,29
2022-04-04,Mendocino,045,87422,13081,13074,3051,16125,119
2022-04-04,Merced,047,269075,62187,62195,8697,70892,810
2022-04-04,Modoc,049,8938,742,741,252,993,8
2022-04-04,Mono,051,14174,2968,2967,123,3090,6
2022-04-04,Monterey,053,433212,79472,79019,13960,92979,727
2022-04-04,Napa,055,140530,25862,25790,968,26758,143
2022-04-04,Nevada,057,99092,15977,15974,1218,17192,123
2022-04-04,Orange,059,3164182,547265,546491,41690,588181,6887
2022-04-04,Placer,061,380077,62836,62787,7419,70206,615
2022-04-04,Plumas,063,18699,2972,2850,371,3221,13
2022-04-04,Riverside,065,2383286,591691,590826,28185,619011,6424
2022-04-04,Sacramento,067,1510023,281047,276567,27269,303836,2953
2022-04-04,San Benito,069,59416,12897,12908,518,13426,98
2022-04-04,San Bernardino,071,2135413,568812,561648,25157,586805,6883
2022-04-04,San Diego,073,3302833,752063,753402,52644,806046,5192
2022-04-04,San Francisco,075,870044,125522,125536,8404,133940,843
2022-04-04,San Joaquin,077,732212,166473,166415,10078,176493,2207
2022-04-04,San Luis Obispo,079,281455,52505,52557,3813,56370,475
2022-04-04,San Mateo,081,765935,122342,121041,7068,128109,693
2022-04-04,Santa Barbara,083,443738,85883,85630,4789,90419,679
2022-04-04,Santa Clara,085,1922200,312370,313278,12563,325841,2265
2022-04-04,Santa Cruz,087,273765,47950,47446,2145,49591,259
2022-04-04,Shasta,089,179085,30577,30565,6151,36716,529
2022-04-04,Sierra,091,2930,274,272,48,320,4
2022-04-04,Siskiyou,093,43540,4449,4442,2752,7194,80
2022-04-04,Solano,095,438530,81528,81789,5617,87406,447
2022-04-04,Sonoma,097,501317,83800,83361,2659,86020,485
2022-04-04,Stanislaus,099,539301,117468,117534,17682,135216,1578
2022-04-04,Sutter,101,95872,20498,20581,2127,22708,222
2022-04-04,Tehama,103,63373,12038,12049,2620,14669,198
2022-04-04,Trinity,105,12862,1183,1173,295,1468,20
2022-04-04,Tulare,107,460477,106493,104826,28565,133391,1414
2022-04-04,Tuolumne,109,53932,12646,12621,570,13191,180
2022-04-04,Ventura,111,848112,173467,173179,9489,182668,1460
2022-04-04,Yolo,113,214977,37087,36393,3230,39623,314
2022-04-04,Yuba,115,75493,15847,15839,1221,17060,121
2022-04-03,Alameda,001,1643700,256753,255650,14205,269855,1813
2022-04-03,Alpine,003,1148,124,124,1,125,0
2022-04-03,Amador,005,37829,8532,8485,652,9137,86
2022-04-03,Butte,007,227075,33070,32981,6728,39709,396
2022-04-03,Calaveras,009,45235,7268,7254,356,7610,119
2022-04-03,Colusa,011,21464,3442,3445,1073,4518,21
2022-04-03,Contra Costa,013,1133247,188957,188658,13314,201972,1291
2022-04-03,Del Norte,015,27424,5800,5812,197,6009,50
2022-04-03,El Dorado,017,186661,26751,26732,3247,29979,200
2022-04-03,Fresno,019,978130,231443,230559,24072,254631,2722
2022-04-03,Glenn,021,27897,4981,4982,1606,6588,47
2022-04-03,Humboldt,023,135768,16888,16898,2975,19873,140
2022-04-03,Imperial,025,180216,55400,55266,10805,66071,908
2022-04-03,Inyo,027,18085,4073,4063,492,4555,56
2022-04-03,Kern,029,883053,191872,191384,46317,237701,2224
2022-04-03,Kings,031,150075,51511,51470,3628,55098,443
2022-04-03,Lake,033,64148,10698,10674,899,11573,136
2022-04-03,Lassen,035,31185,8963,8943,889,9832,65
2022-04-03,Los Angeles,037,10098052,2712276,2703576,124483,2828059,31410
2022-04-03,Madera,039,155013,37294,37333,6120,43453,354
2022-04-03,Marin,041,260295,33630,33493,2306,35799,287
2022-04-03,Mariposa,043,17540,2401,2391,204,2595,29
2022-04-03,Mendocino,045,87422,13075,13058,3049,16107,119
2022-04-03,Merced,047,269075,62172,62149,8693,70842,808
2022-04-03,Modoc,049,8938,741,741,252,993,8
2022-04-03,Mono,051,14174,2968,2967,123,3090,6
2022-04-03,Monterey,053,433212,79454,78964,13935,92899,726
2022-04-03,Napa,055,140530,25842,25757,967,26724,143
2022-04-03,Nevada,057,99092,15971,15962,1217,17179,123
2022-04-03,Orange,059,3164182,547063,546047,41664,587711,6880
2022-04-03,Placer,061,380077,62810,62740,7414,70154,614
2022-04-03,Plumas,063,18699,2971,2803,371,3174,14
2022-04-03,Riverside,065,2383286,591534,590563,28168,618731,6418
2022-04-03,Sacramento,067,1510023,280971,276218,27255,303473,2950
2022-04-03,San Benito,069,59416,12893,12901,518,13419,98
2022-04-03,San Bernardino,071,2135413,568666,561362,25152,586514,6865
2022-04-03,San Diego,073,3302833,751732,752281,52607,804888,5178
2022-04-03,San Francisco,075,870044,125292,125075,8398,133473,843
2022-04-03,San Joaquin,077,732212,166416,166336,10073,176409,2202
2022-04-03,San Luis Obispo,079,281455,52486,52512,3813,56325,475
2022-04-03,San Mateo,081,765935,122202,120717,7061,127778,693
2022-04-03,Santa Barbara,083,443738,85838,85611,4787,90398,678
2022-04-03,Santa Clara,085,1922200,312071,312517,12553,325070,2258
2022-04-03,Santa Cruz,087,273765,47896,47371,2143,49514,259
2022-04-03,Shasta,089,179085,30567,30556,6150,36706,530
2022-04-03,Sierra,091,2930,274,273,48,321,4
2022-04-03,Siskiyou,093,43540,4449,4439,2752,7191,80
2022-04-03,Solano,095,438530,81487,81848,5612,87460,446
2022-04-03,Sonoma,097,501317,83722,83235,2651,85886,485
2022-04-03,Stanislaus,099,539301,117437,117536,17676,135212,1581
2022-04-03,Sutter,101,95872,20495,20570,2127,22697,222
2022-04-03,Tehama,103,63373,12035,12046,2620,14666,198
2022-04-03,Trinity,105,12862,1183,1173,295,1468,20
2022-04-03,Tulare,107,460477,106486,104736,28556,133292,1410
2022-04-03,Tuolumne,109,53932,12645,12618,570,13188,180
2022-04-03,Ventura,111,848112,173414,173044,9485,182529,1460
2022-04-03,Yolo,113,214977,37066,36347,3228,39575,313
2022-04-03,Yuba,115,75493,15845,15835,1221,17056,120
2022-04-02,Alameda,001,1643700,256649,255650,14204,269854,1813
2022-04-02,Alpine,003,1148,124,124,1,125,0
2022-04-02,Amador,005,37829,8532,8485,652,9137,86
2022-04-02,Butte,007,227075,33066,32981,6728,39709,396
2022-04-02,Calaveras,009,45235,7268,7254,356,7610,119
2022-04-02,Colusa,011,21464,3442,3445,1073,4518,21
2022-04-02,Contra Costa,013,1133247,188898,188658,13311,201969,1291
2022-04-02,Del Norte,015,27424,5799,5812,197,6009,50
2022-04-02,El Dorado,017,186661,26748,26732,3247,29979,200
2022-04-02,Fresno,019,978130,231415,230559,24071,254630,2722
2022-04-02,Glenn,021,27897,4981,4982,1606,6588,47
2022-04-02,Humboldt,023,135768,16884,16898,2975,19873,140
2022-04-02,Imperial,025,180216,55396,55266,10805,66071,908
2022-04-02,Inyo,027,18085,4073,4063,492,4555,56
2022-04-02,Kern,029,883053,191858,191384,46313,237697,2224
2022-04-02,Kings,031,150075,51508,51470,3628,55098,443
2022-04-02,Lake,033,64148,10697,10674,899,11573,136
2022-04-02,Lassen,035,31185,8963,8943,889,9832,65
2022-04-02,Los Angeles,037,10098052,2711768,2703576,124443,2828019,31410
2022-04-02,Madera,039,155013,37291,37333,6120,43453,354
2022-04-02,Marin,041,260295,33607,33493,2298,35791,287
2022-04-02,Mariposa,043,17540,2400,2391,204,2595,29
2022-04-02,Mendocino,045,87422,13073,13058,3049,16107,119
2022-04-02,Merced,047,269075,62169,62149,8693,70842,808
2022-04-02,Modoc,049,8938,741,741,252,993,8
2022-04-02,Mono,051,14174,2968,2967,122,3089,6
2022-04-02,Monterey,053,433212,79441,78964,13929,92893,726
2022-04-02,Napa,055,140530,25828,25757,966,26723,143
2022-04-02,Nevada,057,99092,15967,15962,1216,17178,123
2022-04-02,Orange,059,3164182,546957,546047,41651,587698,6880
2022-04-02,Placer,061,380077,62799,62740,7412,70152,614
2022-04-02,Plumas,063,18699,2971,2803,371,3174,14
2022-04-02,Riverside,065,2383286,591460,590563,28163,618726,6418
2022-04-02,Sacramento,067,1510023,280933,276218,27254,303472,2950
2022-04-02,San Benito,069,59416,12892,12901,518,13419,98
2022-04-02,San Bernardino,071,2135413,568614,561362,25148,586510,6865
2022-04-02,San Diego,073,3302833,751607,752281,52598,804879,5178
2022-04-02,San Francisco,075,870044,125188,125075,8389,133464,843
2022-04-02,San Joaquin,077,732212,166395,166336,10071,176407,2202
2022-04-02,San Luis Obispo,079,281455,52481,52512,3813,56325,475
2022-04-02,San Mateo,081,765935,122107,120717,7052,127769,693
2022-04-02,Santa Barbara,083,443738,85819,85611,4786,90397,678
2022-04-02,Santa Clara,085,1922200,311905,312517,12549,325066,2258
2022-04-02,Santa Cruz,087,273765,47884,47371,2142,49513,259
2022-04-02,Shasta,089,179085,30566,30556,6150,36706,530
2022-04-02,Sierra,091,2930,274,273,48,321,4
2022-04-02,Siskiyou,093,43540,4448,4439,2751,7190,80
2022-04-02,Solano,095,438530,81472,81848,5612,87460,446
2022-04-02,Sonoma,097,501317,83674,83235,2645,85880,485
2022-04-02,Stanislaus,099,539301,117428,117536,17674,135210,1581
2022-04-02,Sutter,101,95872,20490,20570,2127,22697,222
2022-04-02,Tehama,103,63373,12035,12046,2620,14666,198
2022-04-02,Trinity,105,12862,1183,1173,295,1468,20
2022-04-02,Tulare,107,460477,106483,104736,28556,133292,1410
2022-04-02,Tuolumne,109,53932,12643,12618,570,13188,180
2022-04-02,Ventura,111,848112,173374,173044,9485,182529,1460
2022-04-02,Yolo,113,214977,37054,36347,3225,39572,313
2022-04-02,Yuba,115,75493,15844,15835,1221,17056,120
2022-04-01,Alameda,001,1643700,256534,255650,14200,269850,1813
2022-04-01,Alpine,003,1148,124,124,1,125,0
2022-04-01,Amador,005,37829,8532,8485,652,9137,86
2022-04-01,Butte,007,227075,33062,32981,6724,39705,396
2022-04-01,Calaveras,009,45235,7266,7254,356,7610,119
2022-04-01,Colusa,011,21464,3441,3445,1073,4518,21
2022-04-01,Contra Costa,013,1133247,188845,188658,13310,201968,1291
2022-04-01,Del Norte,015,27424,5797,5812,197,6009,50
2022-04-01,El Dorado,017,186661,26745,26732,3246,29978,200
2022-04-01,Fresno,019,978130,231389,230559,24069,254628,2722
2022-04-01,Glenn,021,27897,4981,4982,1606,6588,47
2022-04-01,Humboldt,023,135768,16882,16898,2975,19873,140
2022-04-01,Imperial,025,180216,55394,55266,10805,66071,908
2022-04-01,Inyo,027,18085,4071,4063,491,4554,56
2022-04-01,Kern,029,883053,191847,191384,46310,237694,2224
2022-04-01,Kings,031,150075,51505,51470,3628,55098,443
2022-04-01,Lake,033,64148,10695,10674,899,11573,136
2022-04-01,Lassen,035,31185,8962,8943,889,9832,65
2022-04-01,Los Angeles,037,10098052,2711270,2703576,124400,2827976,31410
2022-04-01,Madera,039,155013,37290,37333,6120,43453,354
2022-04-01,Marin,041,260295,33589,33493,2291,35784,287
2022-04-01,Mariposa,043,17540,2397,2391,204,2595,29
2022-04-01,Mendocino,045,87422,13070,13058,3048,16106,119
2022-04-01,Merced,047,269075,62162,62149,8691,70840,808
2022-04-01,Modoc,049,8938,741,741,252,993,8
2022-04-01,Mono,051,14174,2968,2967,122,3089,6
2022-04-01,Monterey,053,433212,79423,78964,13926,92890,726
2022-04-01,Napa,055,140530,25819,25757,966,26723,143
2022-04-01,Nevada,057,99092,15967,15962,1215,17177,123
2022-04-01,Orange,059,3164182,546849,546047,41641,587688,6880
2022-04-01,Placer,061,380077,62785,62740,7412,70152,614
2022-04-01,Plumas,063,18699,2971,2803,370,3173,14
2022-04-01,Riverside,065,2383286,591394,590563,28149,618712,6418
2022-04-01,Sacramento,067,1510023,280894,276218,27250,303468,2950
2022-04-01,San Benito,069,59416,12891,12901,518,13419,98
2022-04-01,San Bernardino,071,2135413,568558,561362,25144,586506,6865
2022-04-01,San Diego,073,3302833,751459,752281,52583,804864,5178
2022-04-01,San Francisco,075,870044,125077,125075,8382,133457,843
2022-04-01,San Joaquin,077,732212,166375,166336,10069,176405,2202
2022-04-01,San Luis Obispo,079,281455,52475,52512,3812,56324,475
2022-04-01,San Mateo,081,765935,122045,120717,7046,127763,693
2022-04-01,Santa Barbara,083,443738,85799,85611,4786,90397,678
2022-04-01,Santa Clara,085,1922200,311755,312517,12548,325065,2258
2022-04-01,Santa Cruz,087,273765,47869,47371,2140,49511,259
2022-04-01,Shasta,089,179085,30565,30556,6150,36706,530
2022-04-01,Sierra,091,2930,274,273,48,321,4
2022-04-01,Siskiyou,093,43540,4448,4439,2750,7189,80
2022-04-01,Solano,095,438530,81457,81848,5612,87460,446
2022-04-01,Sonoma,097,501317,83630,83235,2644,85879,485
2022-04-01,Stanislaus,099,539301,117417,117536,17671,135207,1581
2022-04-01,Sutter,101,95872,20490,20570,2127,22697,222
2022-04-01,Tehama,103,63373,12035,12046,2620,14666,198
2022-04-01,Trinity,105,12862,1183,1173,295,1468,20
2022-04-01,Tulare,107,460477,106478,104736,28552,133288,1410
2022-04-01,Tuolumne,109,53932,12642,12618,570,13188,180
2022-04-01,Ventura,111,848112,173343,173044,9481,182525,1460
2022-04-01,Yolo,113,214977,37039,36347,3224,39571,313
2022-04-01,Yuba,115,75493,15843,15835,1221,17056,120
2022-03-31,Alameda,001,1643700,256359,255650,14187,269837,1813
2022-03-31,Alpine,003,1148,124,124,1,125,0
2022-03-31,Amador,005,37829,8532,8485,652,9137,86
2022-03-31,Butte,007,227075,33058,32981,6721,39702,396
2022-03-31,Calaveras,009,45235,7263,7254,356,7610,119
2022-03-31,Colusa,011,21464,3440,3445,1073,4518,21
2022-03-31,Contra Costa,013,1133247,188749,188658,13304,201962,1291
2022-03-31,Del Norte,015,27424,5796,5812,197,6009,50
2022-03-31,El Dorado,017,186661,26738,26732,3246,29978,200
2022-03-31,Fresno,019,978130,231353,230559,24044,254603,2722
2022-03-31,Glenn,021,27897,4979,4982,1606,6588,47
2022-03-31,Humboldt,023,135768,16878,16898,2975,19873,140
2022-03-31,Imperial,025,180216,55391,55266,10804,66070,908
2022-03-31,Inyo,027,18085,4070,4063,488,4551,56
2022-03-31,Kern,029,883053,191831,191384,46301,237685,2224
2022-03-31,Kings,031,150075,51496,51470,3628,55098,443
2022-03-31,Lake,033,64148,10694,10674,898,11572,136
2022-03-31,Lassen,035,31185,8960,8943,889,9832,65
2022-03-31,Los Angeles,037,10098052,2710524,2703576,124347,2827923,31410
2022-03-31,Madera,039,155013,37287,37333,6120,43453,354
2022-03-31,Marin,041,260295,33563,33493,2279,35772,287
2022-03-31,Mariposa,043,17540,2396,2391,203,2594,29
2022-03-31,Mendocino,045,87422,13066,13058,3048,16106,119
2022-03-31,Merced,047,269075,62157,62149,8688,70837,808
2022-03-31,Modoc,049,8938,741,741,252,993,8
2022-03-31,Mono,051,14174,2968,2967,122,3089,6
2022-03-31,Monterey,053,433212,79406,78964,13914,92878,726
2022-03-31,Napa,055,140530,25810,25757,964,26721,143
2022-03-31,Nevada,057,99092,15960,15962,1214,17176,123
2022-03-31,Orange,059,3164182,546701,546047,41626,587673,6880
2022-03-31,Placer,061,380077,62760,62740,7409,70149,614
2022-03-31,Plumas,063,18699,2971,2803,369,3172,14
2022-03-31,Riverside,065,2383286,591283,590563,28145,618708,6418
2022-03-31,Sacramento,067,1510023,280821,276218,27242,303460,2950
2022-03-31,San Benito,069,59416,12890,12901,518,13419,98
2022-03-31,San Bernardino,071,2135413,568461,561362,25132,586494,6865
2022-03-31,San Diego,073,3302833,751223,752281,52556,804837,5178
2022-03-31,San Francisco,075,870044,124918,125075,8369,133444,843
2022-03-31,San Joaquin,077,732212,166341,166336,10055,176391,2202
2022-03-31,San Luis Obispo,079,281455,52461,52512,3811,56323,475
2022-03-31,San Mateo,081,765935,121935,120717,7044,127761,693
2022-03-31,Santa Barbara,083,443738,85770,85611,4786,90397,678
2022-03-31,Santa Clara,085,1922200,311527,312517,12534,325051,2258
2022-03-31,Santa Cruz,087,273765,47850,47371,2138,49509,259
2022-03-31,Shasta,089,179085,30559,30556,6150,36706,530
2022-03-31,Sierra,091,2930,271,273,48,321,4
2022-03-31,Siskiyou,093,43540,4446,4439,2750,7189,80
2022-03-31,Solano,095,438530,81428,81848,5609,87457,446
2022-03-31,Sonoma,097,501317,83587,83235,2638,85873,485
2022-03-31,Stanislaus,099,539301,117399,117536,17666,135202,1581
2022-03-31,Sutter,101,95872,20487,20570,2126,22696,222
2022-03-31,Tehama,103,63373,12035,12046,2619,14665,198
2022-03-31,Trinity,105,12862,1183,1173,295,1468,20
2022-03-31,Tulare,107,460477,106469,104736,28544,133280,1410
2022-03-31,Tuolumne,109,53932,12641,12618,570,13188,180
2022-03-31,Ventura,111,848112,173303,173044,9478,182522,1460
2022-03-31,Yolo,113,214977,37021,36347,3224,39571,313
2022-03-31,Yuba,115,75493,15843,15835,1218,17053,120
2022-03-30,Alameda,001,1643700,256228,255467,14179,269646,1812
2022-03-30,Alpine,003,1148,124,124,1,125,0
2022-03-30,Amador,005,37829,8532,8485,652,9137,86
2022-03-30,Butte,007,227075,33053,32968,6714,39682,396
2022-03-30,Calaveras,009,45235,7261,7253,355,7608,119
2022-03-30,Colusa,011,21464,3440,3445,1073,4518,21
2022-03-30,Contra Costa,013,1133247,188687,188496,13292,201788,1291
2022-03-30,Del Norte,015,27424,5794,5808,197,6005,50
2022-03-30,El Dorado,017,186661,26730,26722,3246,29968,200
2022-03-30,Fresno,019,978130,231342,230448,24038,254486,2720
2022-03-30,Glenn,021,27897,4978,4982,1606,6588,47
2022-03-30,Humboldt,023,135768,16875,16894,2975,19869,140
2022-03-30,Imperial,025,180216,55387,55252,10801,66053,908
2022-03-30,Inyo,027,18085,4069,4062,486,4548,56
2022-03-30,Kern,029,883053,191803,191363,46296,237659,2219
2022-03-30,Kings,031,150075,51490,51446,3626,55072,443
2022-03-30,Lake,033,64148,10692,10674,898,11572,136
2022-03-30,Lassen,035,31185,8960,8943,889,9832,65
2022-03-30,Los Angeles,037,10098052,2709699,2702536,124293,2826829,31384
2022-03-30,Madera,039,155013,37282,37330,6119,43449,354
2022-03-30,Marin,041,260295,33543,33453,2260,35713,287
2022-03-30,Mariposa,043,17540,2396,2390,203,2593,27
2022-03-30,Mendocino,045,87422,13062,13055,3045,16100,118
2022-03-30,Merced,047,269075,62151,62136,8682,70818,808
2022-03-30,Modoc,049,8938,741,739,252,991,8
2022-03-30,Mono,051,14174,2967,2967,122,3089,6
2022-03-30,Monterey,053,433212,79389,78911,13907,92818,726
2022-03-30,Napa,055,140530,25798,25745,963,26708,141
2022-03-30,Nevada,057,99092,15957,15960,1212,17172,123
2022-03-30,Orange,059,3164182,546547,545895,41603,587498,6876
2022-03-30,Placer,061,380077,62745,62705,7405,70110,614
2022-03-30,Plumas,063,18699,2971,2762,367,3129,13
2022-03-30,Riverside,065,2383286,591200,590437,28131,618568,6411
2022-03-30,Sacramento,067,1510023,280753,276081,27235,303316,2949
2022-03-30,San Benito,069,59416,12886,12898,518,13416,98
2022-03-30,San Bernardino,071,2135413,568376,561153,25127,586280,6863
2022-03-30,San Diego,073,3302833,750991,751684,52530,804214,5169
2022-03-30,San Francisco,075,870044,124813,124930,8358,133288,841
2022-03-30,San Joaquin,077,732212,166313,166299,10049,176348,2201
2022-03-30,San Luis Obispo,079,281455,52448,52484,3807,56291,475
2022-03-30,San Mateo,081,765935,121833,120548,7044,127592,693
2022-03-30,Santa Barbara,083,443738,85748,85488,4783,90271,677
2022-03-30,Santa Clara,085,1922200,311345,312253,12514,324767,2258
2022-03-30,Santa Cruz,087,273765,47794,47340,2138,49478,259
2022-03-30,Shasta,089,179085,30556,30555,6150,36705,530
2022-03-30,Sierra,091,2930,271,273,48,321,4
2022-03-30,Siskiyou,093,43540,4446,4439,2750,7189,80
2022-03-30,Solano,095,438530,81409,81816,5605,87421,443
2022-03-30,Sonoma,097,501317,83550,83163,2637,85800,485
2022-03-30,Stanislaus,099,539301,117386,117593,17663,135256,1559
2022-03-30,Sutter,101,95872,20482,20565,2126,22691,222
2022-03-30,Tehama,103,63373,12034,12045,2618,14663,198
2022-03-30,Trinity,105,12862,1182,1173,295,1468,20
2022-03-30,Tulare,107,460477,106463,104667,28538,133205,1410
2022-03-30,Tuolumne,109,53932,12639,12616,570,13186,180
2022-03-30,Ventura,111,848112,173262,172984,9470,182454,1460
2022-03-30,Yolo,113,214977,37011,36325,3221,39546,313
2022-03-30,Yuba,115,75493,15841,15830,1218,17048,120
2022-03-29,Alameda,001,1643700,256102,255261,14169,269430,1810
2022-03-29,Alpine,003,1148,124,124,1,125,0
2022-03-29,Amador,005,37829,8532,8483,652,9135,86
2022-03-29,Butte,007,227075,33050,32954,6713,39667,396
2022-03-29,Calaveras,009,45235,7260,7250,354,7604,119
2022-03-29,Colusa,011,21464,3440,3445,1073,4518,21
2022-03-29,Contra Costa,013,1133247,188599,188359,13284,201643,1290
2022-03-29,Del Norte,015,27424,5794,5806,196,6002,50
2022-03-29,El Dorado,017,186661,26725,26706,3246,29952,200
2022-03-29,Fresno,019,978130,231314,230256,24032,254288,2718
2022-03-29,Glenn,021,27897,4977,4983,1606,6589,47
2022-03-29,Humboldt,023,135768,16872,16892,2972,19864,140
2022-03-29,Imperial,025,180216,55373,55233,10800,66033,908
2022-03-29,Inyo,027,18085,4067,4062,485,4547,56
2022-03-29,Kern,029,883053,191771,191338,46289,237627,2220
2022-03-29,Kings,031,150075,51482,51416,3625,55041,443
2022-03-29,Lake,033,64148,10688,10674,898,11572,136
2022-03-29,Lassen,035,31185,8959,8943,889,9832,65
2022-03-29,Los Angeles,037,10098052,2708871,2702005,124246,2826251,31378
2022-03-29,Madera,039,155013,37274,37325,6116,43441,354
2022-03-29,Marin,041,260295,33523,33431,2255,35686,287
2022-03-29,Mariposa,043,17540,2396,2388,202,2590,23
2022-03-29,Mendocino,045,87422,13058,13053,3044,16097,119
2022-03-29,Merced,047,269075,62139,62123,8681,70804,806
2022-03-29,Modoc,049,8938,739,737,252,989,8
2022-03-29,Mono,051,14174,2967,2966,122,3088,5
2022-03-29,Monterey,053,433212,79376,78774,13899,92673,725
2022-03-29,Napa,055,140530,25791,25732,963,26695,141
2022-03-29,Nevada,057,99092,15949,15956,1212,17168,123
2022-03-29,Orange,059,3164182,546399,545832,41587,587419,6871
2022-03-29,Placer,061,380077,62727,62687,7400,70087,614
2022-03-29,Plumas,063,18699,2969,2761,367,3128,13
2022-03-29,Riverside,065,2383286,591100,590359,28123,618482,6403
2022-03-29,Sacramento,067,1510023,280687,276040,27222,303262,2946
2022-03-29,San Benito,069,59416,12884,12892,518,13410,97
2022-03-29,San Bernardino,071,2135413,568280,561026,25117,586143,6860
2022-03-29,San Diego,073,3302833,750747,751240,52508,803748,5159
2022-03-29,San Francisco,075,870044,124662,124789,8352,133141,840
2022-03-29,San Joaquin,077,732212,166276,166241,10041,176282,2198
2022-03-29,San Luis Obispo,079,281455,52432,52455,3803,56258,472
2022-03-29,San Mateo,081,765935,121739,120435,7041,127476,686
2022-03-29,Santa Barbara,083,443738,85725,85464,4783,90247,676
2022-03-29,Santa Clara,085,1922200,311105,312067,12496,324563,2259
2022-03-29,Santa Cruz,087,273765,47774,47323,2137,49460,259
2022-03-29,Shasta,089,179085,30549,30552,6147,36699,529
2022-03-29,Sierra,091,2930,271,273,48,321,4
2022-03-29,Siskiyou,093,43540,4446,4439,2749,7188,80
2022-03-29,Solano,095,438530,81386,81713,5602,87315,441
2022-03-29,Sonoma,097,501317,83516,83130,2631,85761,485
2022-03-29,Stanislaus,099,539301,117367,117683,17657,135340,1559
2022-03-29,Sutter,101,95872,20480,20556,2125,22681,221
2022-03-29,Tehama,103,63373,12032,12045,2618,14663,198
2022-03-29,Trinity,105,12862,1182,1173,295,1468,20
2022-03-29,Tulare,107,460477,106458,104622,28532,133154,1406
2022-03-29,Tuolumne,109,53932,12636,12615,570,13185,180
2022-03-29,Ventura,111,848112,173207,172946,9469,182415,1460
2022-03-29,Yolo,113,214977,36998,36296,3220,39516,313
2022-03-29,Yuba,115,75493,15837,15824,1217,17041,117
2022-03-28,Alameda,001,1643700,255950,255192,14158,269350,1808
2022-03-28,Alpine,003,1148,124,124,1,125,0
2022-03-28,Amador,005,37829,8531,8480,652,9132,86
2022-03-28,Butte,007,227075,33033,32947,6712,39659,392
2022-03-28,Calaveras,009,45235,7260,7247,354,7601,119
2022-03-28,Colusa,011,21464,3440,3445,1073,4518,21
2022-03-28,Contra Costa,013,1133247,188518,188305,13279,201584,1290
2022-03-28,Del Norte,015,27424,5792,5834,196,6030,50
2022-03-28,El Dorado,017,186661,26718,26703,3244,29947,200
2022-03-28,Fresno,019,978130,231286,230144,24015,254159,2717
2022-03-28,Glenn,021,27897,4977,4983,1606,6589,47
2022-03-28,Humboldt,023,135768,16871,16916,2972,19888,140
2022-03-28,Imperial,025,180216,55362,55245,10800,66045,909
2022-03-28,Inyo,027,18085,4066,4062,485,4547,56
2022-03-28,Kern,029,883053,191747,191333,46279,237612,2212
2022-03-28,Kings,031,150075,51469,51405,3625,55030,443
2022-03-28,Lake,033,64148,10686,10673,898,11571,136
2022-03-28,Lassen,035,31185,8959,8946,889,9835,63
2022-03-28,Los Angeles,037,10098052,2707988,2700997,124207,2825204,31349
2022-03-28,Madera,039,155013,37270,37324,6116,43440,354
2022-03-28,Marin,041,260295,33498,33391,2250,35641,287
2022-03-28,Mariposa,043,17540,2395,2388,202,2590,23
2022-03-28,Mendocino,045,87422,13056,13046,3043,16089,118
2022-03-28,Merced,047,269075,62129,62116,8676,70792,805
2022-03-28,Modoc,049,8938,738,736,252,988,7
2022-03-28,Mono,051,14174,2967,2966,122,3088,5
2022-03-28,Monterey,053,433212,79343,78784,13894,92678,724
2022-03-28,Napa,055,140530,25785,25723,962,26685,140
2022-03-28,Nevada,057,99092,15947,15969,1212,17181,123
2022-03-28,Orange,059,3164182,546267,545700,41559,587259,6860
2022-03-28,Placer,061,380077,62706,62687,7399,70086,613
2022-03-28,Plumas,063,18699,2968,2760,367,3127,13
2022-03-28,Riverside,065,2383286,591001,590298,28113,618411,6397
2022-03-28,Sacramento,067,1510023,280618,275889,27210,303099,2946
2022-03-28,San Benito,069,59416,12884,12889,518,13407,97
2022-03-28,San Bernardino,071,2135413,568197,560836,25104,585940,6858
2022-03-28,San Diego,073,3302833,750507,750659,52474,803133,5155
2022-03-28,San Francisco,075,870044,124522,124678,8341,133019,839
2022-03-28,San Joaquin,077,732212,166244,166247,10037,176284,2196
2022-03-28,San Luis Obispo,079,281455,52407,52434,3799,56233,470
2022-03-28,San Mateo,081,765935,121625,120337,7034,127371,686
2022-03-28,Santa Barbara,083,443738,85697,85442,4781,90223,675
2022-03-28,Santa Clara,085,1922200,310876,311953,12486,324439,2257
2022-03-28,Santa Cruz,087,273765,47741,47324,2137,49461,259
2022-03-28,Shasta,089,179085,30548,30550,6146,36696,527
2022-03-28,Sierra,091,2930,271,273,48,321,4
2022-03-28,Siskiyou,093,43540,4445,4438,2749,7187,80
2022-03-28,Solano,095,438530,81358,81704,5597,87301,441
2022-03-28,Sonoma,097,501317,83472,83105,2626,85731,485
2022-03-28,Stanislaus,099,539301,117355,117783,17652,135435,1562
2022-03-28,Sutter,101,95872,20475,20549,2125,22674,221
2022-03-28,Tehama,103,63373,12032,12041,2617,14658,200
2022-03-28,Trinity,105,12862,1182,1173,295,1468,20
2022-03-28,Tulare,107,460477,106446,104576,28525,133101,1404
2022-03-28,Tuolumne,109,53932,12636,12627,570,13197,180
2022-03-28,Ventura,111,848112,173167,172867,9468,182335,1455
2022-03-28,Yolo,113,214977,36980,36282,3218,39500,312
2022-03-28,Yuba,115,75493,15836,15821,1215,17036,117
2022-03-27,Alameda,001,1643700,255766,255132,14149,269281,1809
2022-03-27,Alpine,003,1148,124,124,1,125,0
2022-03-27,Amador,005,37829,8528,8480,652,9132,86
2022-03-27,Butte,007,227075,33020,32943,6705,39648,392
2022-03-27,Calaveras,009,45235,7258,7245,354,7599,119
2022-03-27,Colusa,011,21464,3440,3445,1072,4517,21
2022-03-27,Contra Costa,013,1133247,188403,188251,13260,201511,1290
2022-03-27,Del Norte,015,27424,5791,5836,196,6032,50
2022-03-27,El Dorado,017,186661,26704,26699,3241,29940,200
2022-03-27,Fresno,019,978130,231239,230049,23997,254046,2717
2022-03-27,Glenn,021,27897,4976,4983,1606,6589,47
2022-03-27,Humboldt,023,135768,16867,16920,2972,19892,140
2022-03-27,Imperial,025,180216,55349,55240,10797,66037,909
2022-03-27,Inyo,027,18085,4065,4062,483,4545,56
2022-03-27,Kern,029,883053,191709,191332,46273,237605,2213
2022-03-27,Kings,031,150075,51460,51400,3625,55025,443
2022-03-27,Lake,033,64148,10685,10672,897,11569,136
2022-03-27,Lassen,035,31185,8959,8946,889,9835,63
2022-03-27,Los Angeles,037,10098052,2707180,2700983,124159,2825142,31348
2022-03-27,Madera,039,155013,37266,37323,6114,43437,354
2022-03-27,Marin,041,260295,33461,33391,2240,35631,287
2022-03-27,Mariposa,043,17540,2395,2390,202,2592,23
2022-03-27,Mendocino,045,87422,13052,13046,3041,16087,118
2022-03-27,Merced,047,269075,62119,62110,8674,70784,805
2022-03-27,Modoc,049,8938,737,736,250,986,7
2022-03-27,Mono,051,14174,2967,2966,122,3088,5
2022-03-27,Monterey,053,433212,79322,78778,13882,92660,724
2022-03-27,Napa,055,140530,25771,25723,962,26685,140
2022-03-27,Nevada,057,99092,15943,15967,1210,17177,123
2022-03-27,Orange,059,3164182,546133,545644,41524,587168,6860
2022-03-27,Placer,061,380077,62687,62680,7398,70078,613
2022-03-27,Plumas,063,18699,2967,2760,365,3125,13
2022-03-27,Riverside,065,2383286,590915,590251,28102,618353,6395
2022-03-27,Sacramento,067,1510023,280537,275854,27203,303057,2941
2022-03-27,San Benito,069,59416,12879,12889,517,13406,97
2022-03-27,San Bernardino,071,2135413,568081,560853,25100,585953,6862
2022-03-27,San Diego,073,3302833,750252,750659,52451,803110,5155
2022-03-27,San Francisco,075,870044,124336,124619,8329,132948,839
2022-03-27,San Joaquin,077,732212,166208,166238,10033,176271,2196
2022-03-27,San Luis Obispo,079,281455,52386,52430,3797,56227,470
2022-03-27,San Mateo,081,765935,121521,120324,7028,127352,686
2022-03-27,Santa Barbara,083,443738,85661,85434,4779,90213,675
2022-03-27,Santa Clara,085,1922200,310664,311822,12479,324301,2257
2022-03-27,Santa Cruz,087,273765,47708,47321,2132,49453,259
2022-03-27,Shasta,089,179085,30544,30550,6144,36694,527
2022-03-27,Sierra,091,2930,271,273,48,321,4
2022-03-27,Siskiyou,093,43540,4445,4436,2748,7184,80
2022-03-27,Solano,095,438530,81317,81691,5594,87285,441
2022-03-27,Sonoma,097,501317,83419,83088,2622,85710,485
2022-03-27,Stanislaus,099,539301,117335,117778,17649,135427,1562
2022-03-27,Sutter,101,95872,20469,20545,2125,22670,221
2022-03-27,Tehama,103,63373,12032,12040,2617,14657,200
2022-03-27,Trinity,105,12862,1182,1173,295,1468,20
2022-03-27,Tulare,107,460477,106437,104582,28515,133097,1404
2022-03-27,Tuolumne,109,53932,12634,12628,570,13198,180
2022-03-27,Ventura,111,848112,173122,172831,9466,182297,1455
2022-03-27,Yolo,113,214977,36958,36232,3215,39447,312
2022-03-27,Yuba,115,75493,15833,15821,1208,17029,117
2022-03-26,Alameda,001,1643700,255686,254691,14148,268839,1803
2022-03-26,Alpine,003,1148,124,124,1,125,0
2022-03-26,Amador,005,37829,8528,8476,652,9128,86
2022-03-26,Butte,007,227075,33016,32929,6703,39632,391
2022-03-26,Calaveras,009,45235,7256,7240,354,7594,120
2022-03-26,Colusa,011,21464,3438,3445,1072,4517,21
2022-03-26,Contra Costa,013,1133247,188349,187990,13256,201246,1285
2022-03-26,Del Norte,015,27424,5789,5831,196,6027,50
2022-03-26,El Dorado,017,186661,26696,26674,3239,29913,200
2022-03-26,Fresno,019,978130,231216,229799,23996,253795,2710
2022-03-26,Glenn,021,27897,4976,4978,1606,6584,47
2022-03-26,Humboldt,023,135768,16863,16911,2972,19883,139
2022-03-26,Imperial,025,180216,55343,55230,10796,66026,913
2022-03-26,Inyo,027,18085,4065,4060,482,4542,56
2022-03-26,Kern,029,883053,191695,191288,46268,237556,2201
2022-03-26,Kings,031,150075,51459,51397,3625,55022,444
2022-03-26,Lake,033,64148,10685,10659,897,11556,136
2022-03-26,Lassen,035,31185,8959,8944,889,9833,63
2022-03-26,Los Angeles,037,10098052,2706722,2698028,124117,2822145,31291
2022-03-26,Madera,039,155013,37263,37321,6112,43433,354
2022-03-26,Marin,041,260295,33451,33317,2236,35553,287
2022-03-26,Mariposa,043,17540,2395,2386,202,2588,23
2022-03-26,Mendocino,045,87422,13048,13038,3041,16079,118
2022-03-26,Merced,047,269075,62113,62083,8672,70755,805
2022-03-26,Modoc,049,8938,737,736,250,986,7
2022-03-26,Mono,051,14174,2967,2966,122,3088,5
2022-03-26,Monterey,053,433212,79315,78688,13880,92568,724
2022-03-26,Napa,055,140530,25768,25701,962,26663,139
2022-03-26,Nevada,057,99092,15939,15960,1210,17170,123
2022-03-26,Orange,059,3164182,546056,545294,41513,586807,6853
2022-03-26,Placer,061,380077,62675,62634,7394,70028,613
2022-03-26,Plumas,063,18699,2967,2758,364,3122,13
2022-03-26,Riverside,065,2383286,590845,590060,28101,618161,6397
2022-03-26,Sacramento,067,1510023,280504,275529,27201,302730,2935
2022-03-26,San Benito,069,59416,12879,12885,517,13402,97
2022-03-26,San Bernardino,071,2135413,568022,560742,25096,585838,6840
2022-03-26,San Diego,073,3302833,750128,750170,52444,802614,5146
2022-03-26,San Francisco,075,870044,124230,124265,8320,132585,839
2022-03-26,San Joaquin,077,732212,166187,166079,10032,176111,2195
2022-03-26,San Luis Obispo,079,281455,52380,52369,3797,56166,469
2022-03-26,San Mateo,081,765935,121462,120165,7020,127185,684
2022-03-26,Santa Barbara,083,443738,85641,85477,4777,90254,674
2022-03-26,Santa Clara,085,1922200,310506,311189,12470,323659,2250
2022-03-26,Santa Cruz,087,273765,47697,47329,2132,49461,259
2022-03-26,Shasta,089,179085,30543,30542,6143,36685,527
2022-03-26,Sierra,091,2930,271,273,48,321,4
2022-03-26,Siskiyou,093,43540,4444,4433,2748,7181,80
2022-03-26,Solano,095,438530,81308,81659,5594,87253,441
2022-03-26,Sonoma,097,501317,83389,83113,2617,85730,485
2022-03-26,Stanislaus,099,539301,117328,117962,17648,135610,1565
2022-03-26,Sutter,101,95872,20467,20536,2125,22661,221
2022-03-26,Tehama,103,63373,12032,12036,2616,14652,195
2022-03-26,Trinity,105,12862,1182,1174,295,1469,20
2022-03-26,Tulare,107,460477,106430,104538,28514,133052,1400
2022-03-26,Tuolumne,109,53932,12632,12628,570,13198,180
2022-03-26,Ventura,111,848112,173081,172690,9462,182152,1455
2022-03-26,Yolo,113,214977,36949,36234,3215,39449,311
2022-03-26,Yuba,115,75493,15832,15807,1208,17015,117
2022-03-25,Alameda,001,1643700,255621,254691,14146,268837,1803
2022-03-25,Alpine,003,1148,124,124,1,125,0
2022-03-25,Amador,005,37829,8527,8476,652,9128,86
2022-03-25,Butte,007,227075,33011,32929,6702,39631,391
2022-03-25,Calaveras,009,45235,7255,7240,354,7594,120
2022-03-25,Colusa,011,21464,3438,3445,1072,4517,21
2022-03-25,Contra Costa,013,1133247,188301,187990,13252,201242,1285
2022-03-25,Del Norte,015,27424,5789,5831,196,6027,50
2022-03-25,El Dorado,017,186661,26692,26674,3239,29913,200
2022-03-25,Fresno,019,978130,231188,229799,23987,253786,2710
2022-03-25,Glenn,021,27897,4976,4978,1606,6584,47
2022-03-25,Humboldt,023,135768,16863,16911,2972,19883,139
2022-03-25,Imperial,025,180216,55338,55230,10795,66025,913
2022-03-25,Inyo,027,18085,4064,4060,482,4542,56
2022-03-25,Kern,029,883053,191685,191288,46267,237555,2201
2022-03-25,Kings,031,150075,51458,51397,3625,55022,444
2022-03-25,Lake,033,64148,10685,10659,897,11556,136
2022-03-25,Lassen,035,31185,8958,8944,889,9833,63
2022-03-25,Los Angeles,037,10098052,2706304,2698028,124086,2822114,31291
2022-03-25,Madera,039,155013,37262,37321,6111,43432,354
2022-03-25,Marin,041,260295,33436,33317,2227,35544,287
2022-03-25,Mariposa,043,17540,2395,2386,202,2588,23
2022-03-25,Mendocino,045,87422,13048,13038,3041,16079,118
2022-03-25,Merced,047,269075,62106,62083,8671,70754,805
2022-03-25,Modoc,049,8938,737,736,250,986,7
2022-03-25,Mono,051,14174,2966,2966,122,3088,5
2022-03-25,Monterey,053,433212,79304,78688,13877,92565,724
2022-03-25,Napa,055,140530,25761,25701,962,26663,139
2022-03-25,Nevada,057,99092,15938,15960,1210,17170,123
2022-03-25,Orange,059,3164182,545981,545294,41496,586790,6853
2022-03-25,Placer,061,380077,62669,62634,7391,70025,613
2022-03-25,Plumas,063,18699,2966,2758,364,3122,13
2022-03-25,Riverside,065,2383286,590786,590060,28090,618150,6397
2022-03-25,Sacramento,067,1510023,280463,275529,27199,302728,2935
2022-03-25,San Benito,069,59416,12879,12885,517,13402,97
2022-03-25,San Bernardino,071,2135413,567983,560742,25093,585835,6840
2022-03-25,San Diego,073,3302833,750006,750170,52434,802604,5146
2022-03-25,San Francisco,075,870044,124149,124265,8306,132571,839
2022-03-25,San Joaquin,077,732212,166173,166079,10029,176108,2195
2022-03-25,San Luis Obispo,079,281455,52377,52369,3796,56165,469
2022-03-25,San Mateo,081,765935,121410,120165,7020,127185,684
2022-03-25,Santa Barbara,083,443738,85626,85477,4775,90252,674
2022-03-25,Santa Clara,085,1922200,310355,311189,12465,323654,2250
2022-03-25,Santa Cruz,087,273765,47689,47329,2132,49461,259
2022-03-25,Shasta,089,179085,30539,30542,6142,36684,527
2022-03-25,Sierra,091,2930,271,273,48,321,4
2022-03-25,Siskiyou,093,43540,4442,4433,2746,7179,80
2022-03-25,Solano,095,438530,81294,81659,5592,87251,441
2022-03-25,Sonoma,097,501317,83352,83113,2617,85730,485
2022-03-25,Stanislaus,099,539301,117314,117962,17647,135609,1565
2022-03-25,Sutter,101,95872,20462,20536,2125,22661,221
2022-03-25,Tehama,103,63373,12030,12036,2616,14652,195
2022-03-25,Trinity,105,12862,1182,1174,295,1469,20
2022-03-25,Tulare,107,460477,106426,104538,28511,133049,1400
2022-03-25,Tuolumne,109,53932,12631,12628,570,13198,180
2022-03-25,Ventura,111,848112,173043,172690,9462,182152,1455
2022-03-25,Yolo,113,214977,36937,36234,3215,39449,311
2022-03-25,Yuba,115,75493,15827,15807,1207,17014,117
2022-03-24,Alameda,001,1643700,255504,254691,14129,268820,1803
2022-03-24,Alpine,003,1148,124,124,1,125,0
2022-03-24,Amador,005,37829,8527,8476,652,9128,86
2022-03-24,Butte,007,227075,33005,32929,6702,39631,391
2022-03-24,Calaveras,009,45235,7252,7240,354,7594,120
2022-03-24,Colusa,011,21464,3438,3445,1072,4517,21
2022-03-24,Contra Costa,013,1133247,188222,187990,13249,201239,1285
2022-03-24,Del Norte,015,27424,5785,5831,196,6027,50
2022-03-24,El Dorado,017,186661,26681,26674,3239,29913,200
2022-03-24,Fresno,019,978130,231147,229799,23975,253774,2710
2022-03-24,Glenn,021,27897,4975,4978,1606,6584,47
2022-03-24,Humboldt,023,135768,16858,16911,2970,19881,139
2022-03-24,Imperial,025,180216,55331,55230,10795,66025,913
2022-03-24,Inyo,027,18085,4063,4060,482,4542,56
2022-03-24,Kern,029,883053,191675,191288,46264,237552,2201
2022-03-24,Kings,031,150075,51449,51397,3623,55020,444
2022-03-24,Lake,033,64148,10684,10659,897,11556,136
2022-03-24,Lassen,035,31185,8957,8944,889,9833,63
2022-03-24,Los Angeles,037,10098052,2705742,2698028,124041,2822069,31291
2022-03-24,Madera,039,155013,37260,37321,6109,43430,354
2022-03-24,Marin,041,260295,33414,33317,2218,35535,287
2022-03-24,Mariposa,043,17540,2395,2386,202,2588,23
2022-03-24,Mendocino,045,87422,13042,13038,3038,16076,118
2022-03-24,Merced,047,269075,62099,62083,8670,70753,805
2022-03-24,Modoc,049,8938,737,736,250,986,7
2022-03-24,Mono,051,14174,2966,2966,122,3088,5
2022-03-24,Monterey,053,433212,79278,78688,13863,92551,724
2022-03-24,Napa,055,140530,25752,25701,962,26663,139
2022-03-24,Nevada,057,99092,15934,15960,1209,17169,123
2022-03-24,Orange,059,3164182,545879,545294,41479,586773,6853
2022-03-24,Placer,061,380077,62649,62634,7390,70024,613
2022-03-24,Plumas,063,18699,2966,2758,364,3122,13
2022-03-24,Riverside,065,2383286,590710,590060,28081,618141,6397
2022-03-24,Sacramento,067,1510023,280394,275529,27194,302723,2935
2022-03-24,San Benito,069,59416,12878,12885,516,13401,97
2022-03-24,San Bernardino,071,2135413,567899,560742,25089,585831,6840
2022-03-24,San Diego,073,3302833,749797,750170,52421,802591,5146
2022-03-24,San Francisco,075,870044,124068,124265,8300,132565,839
2022-03-24,San Joaquin,077,732212,166146,166079,10028,176107,2195
2022-03-24,San Luis Obispo,079,281455,52362,52369,3795,56164,469
2022-03-24,San Mateo,081,765935,121362,120165,7015,127180,684
2022-03-24,Santa Barbara,083,443738,85611,85477,4772,90249,674
2022-03-24,Santa Clara,085,1922200,310209,311189,12447,323636,2250
2022-03-24,Santa Cruz,087,273765,47672,47329,2131,49460,259
2022-03-24,Shasta,089,179085,30531,30542,6142,36684,527
2022-03-24,Sierra,091,2930,271,273,48,321,4
2022-03-24,Siskiyou,093,43540,4439,4433,2746,7179,80
2022-03-24,Solano,095,438530,81275,81659,5591,87250,441
2022-03-24,Sonoma,097,501317,83317,83113,2615,85728,485
2022-03-24,Stanislaus,099,539301,117304,117962,17644,135606,1565
2022-03-24,Sutter,101,95872,20457,20536,2125,22661,221
2022-03-24,Tehama,103,63373,12028,12036,2614,14650,195
2022-03-24,Trinity,105,12862,1182,1174,295,1469,20
2022-03-24,Tulare,107,460477,106415,104538,28505,133043,1400
2022-03-24,Tuolumne,109,53932,12629,12628,570,13198,180
2022-03-24,Ventura,111,848112,173000,172690,9461,182151,1455
2022-03-24,Yolo,113,214977,36931,36234,3211,39445,311
2022-03-24,Yuba,115,75493,15823,15807,1204,17011,117
2022-03-23,Alameda,001,1643700,255370,254559,14118,268677,1802
2022-03-23,Alpine,003,1148,124,124,1,125,0
2022-03-23,Amador,005,37829,8527,8475,652,9127,86
2022-03-23,Butte,007,227075,32991,32920,6701,39621,387
2022-03-23,Calaveras,009,45235,7247,7237,354,7591,120
2022-03-23,Colusa,011,21464,3437,3444,1072,4516,21
2022-03-23,Contra Costa,013,1133247,188123,187898,13237,201135,1279
2022-03-23,Del Norte,015,27424,5783,5830,196,6026,50
2022-03-23,El Dorado,017,186661,26675,26670,3239,29909,200
2022-03-23,Fresno,019,978130,231111,229656,23961,253617,2710
2022-03-23,Glenn,021,27897,4975,4975,1606,6581,47
2022-03-23,Humboldt,023,135768,16857,16908,2968,19876,139
2022-03-23,Imperial,025,180216,55325,55211,10794,66005,909
2022-03-23,Inyo,027,18085,4063,4060,482,4542,56
2022-03-23,Kern,029,883053,191658,191241,46259,237500,2196
2022-03-23,Kings,031,150075,51438,51384,3622,55006,442
2022-03-23,Lake,033,64148,10680,10658,896,11554,135
2022-03-23,Lassen,035,31185,8956,8944,888,9832,63
2022-03-23,Los Angeles,037,10098052,2705066,2697227,124009,2821236,31267
2022-03-23,Madera,039,155013,37255,37317,6105,43422,354
2022-03-23,Marin,041,260295,33388,33274,2213,35487,287
2022-03-23,Mariposa,043,17540,2393,2382,201,2583,11
2022-03-23,Mendocino,045,87422,13038,13033,3037,16070,118
2022-03-23,Merced,047,269075,62089,62056,8666,70722,805
2022-03-23,Modoc,049,8938,737,736,250,986,7
2022-03-23,Mono,051,14174,2966,2966,122,3088,5
2022-03-23,Monterey,053,433212,79261,78655,13838,92493,724
2022-03-23,Napa,055,140530,25739,25691,960,26651,139
2022-03-23,Nevada,057,99092,15932,15958,1209,17167,123
2022-03-23,Orange,059,3164182,545749,545158,41466,586624,6852
2022-03-23,Placer,061,380077,62630,62622,7388,70010,613
2022-03-23,Plumas,063,18699,2966,2747,364,3111,13
2022-03-23,Riverside,065,2383286,590636,589947,28076,618023,6388
2022-03-23,Sacramento,067,1510023,280332,275398,27187,302585,2934
2022-03-23,San Benito,069,59416,12877,12884,516,13400,97
2022-03-23,San Bernardino,071,2135413,567825,560550,25084,585634,6828
2022-03-23,San Diego,073,3302833,749603,749871,52398,802269,5143
2022-03-23,San Francisco,075,870044,123955,124110,8294,132404,838
2022-03-23,San Joaquin,077,732212,166108,166041,10021,176062,2187
2022-03-23,San Luis Obispo,079,281455,52345,52344,3789,56133,469
2022-03-23,San Mateo,081,765935,121278,120080,7005,127085,685
2022-03-23,Santa Barbara,083,443738,85594,85464,4771,90235,673
2022-03-23,Santa Clara,085,1922200,310045,310956,12435,323391,2250
2022-03-23,Santa Cruz,087,273765,47653,47314,2125,49439,259
2022-03-23,Shasta,089,179085,30527,30524,6141,36665,526
2022-03-23,Sierra,091,2930,271,273,48,321,4
2022-03-23,Siskiyou,093,43540,4438,4433,2746,7179,80
2022-03-23,Solano,095,438530,81241,81615,5590,87205,441
2022-03-23,Sonoma,097,501317,83283,83074,2612,85686,482
2022-03-23,Stanislaus,099,539301,117287,118041,17641,135682,1568
2022-03-23,Sutter,101,95872,20454,20532,2125,22657,218
2022-03-23,Tehama,103,63373,12025,12035,2614,14649,195
2022-03-23,Trinity,105,12862,1182,1174,295,1469,20
2022-03-23,Tulare,107,460477,106398,104489,28499,132988,1394
2022-03-23,Tuolumne,109,53932,12628,12629,570,13199,180
2022-03-23,Ventura,111,848112,172952,172647,9459,182106,1455
2022-03-23,Yolo,113,214977,36911,36197,3209,39406,308
2022-03-23,Yuba,115,75493,15816,15801,1203,17004,117
2022-03-22,Alameda,001,1643700,255247,254467,13744,268211,1802
2022-03-22,Alpine,003,1148,124,122,1,123,0
2022-03-22,Amador,005,37829,8526,8462,651,9113,86
2022-03-22,Butte,007,227075,32981,32907,6697,39604,387
2022-03-22,Calaveras,009,45235,7245,7237,354,7591,120
2022-03-22,Colusa,011,21464,3436,3445,1072,4517,21
2022-03-22,Contra Costa,013,1133247,188047,187813,13215,201028,1279
2022-03-22,Del Norte,015,27424,5778,5824,196,6020,50
2022-03-22,El Dorado,017,186661,26668,26661,3239,29900,200
2022-03-22,Fresno,019,978130,231062,229551,23951,253502,2708
2022-03-22,Glenn,021,27897,4972,4971,1606,6577,47
2022-03-22,Humboldt,023,135768,16854,16911,2968,19879,139
2022-03-22,Imperial,025,180216,55314,55170,10791,65961,908
2022-03-22,Inyo,027,18085,4063,4060,482,4542,56
2022-03-22,Kern,029,883053,191635,191213,46250,237463,2195
2022-03-22,Kings,031,150075,51426,51369,3621,54990,442
2022-03-22,Lake,033,64148,10678,10657,895,11552,135
2022-03-22,Lassen,035,31185,8956,8940,887,9827,63
2022-03-22,Los Angeles,037,10098052,2704403,2696746,123960,2820706,31250
2022-03-22,Madera,039,155013,37251,37304,6102,43406,354
2022-03-22,Marin,041,260295,33363,33253,2209,35462,287
2022-03-22,Mariposa,043,17540,2391,2382,201,2583,6
2022-03-22,Mendocino,045,87422,13033,13030,3035,16065,118
2022-03-22,Merced,047,269075,62079,62056,8662,70718,805
2022-03-22,Modoc,049,8938,737,735,250,985,7
2022-03-22,Mono,051,14174,2966,2963,122,3085,5
2022-03-22,Monterey,053,433212,79244,78614,13827,92441,724
2022-03-22,Napa,055,140530,25729,25688,959,26647,139
2022-03-22,Nevada,057,99092,15924,15950,1209,17159,123
2022-03-22,Orange,059,3164182,545605,545075,41446,586521,6843
2022-03-22,Placer,061,380077,62617,62604,7386,69990,610
2022-03-22,Plumas,063,18699,2965,2744,364,3108,13
2022-03-22,Riverside,065,2383286,590561,589816,28073,617889,6383
2022-03-22,Sacramento,067,1510023,280256,275374,27176,302550,2927
2022-03-22,San Benito,069,59416,12876,12884,515,13399,97
2022-03-22,San Bernardino,071,2135413,567743,560371,25064,585435,6811
2022-03-22,San Diego,073,3302833,749402,749647,52378,802025,5141
2022-03-22,San Francisco,075,870044,123848,123998,8288,132286,838
2022-03-22,San Joaquin,077,732212,166080,165992,10017,176009,2187
2022-03-22,San Luis Obispo,079,281455,52337,52257,3789,56046,465
2022-03-22,San Mateo,081,765935,121204,119975,7001,126976,686
2022-03-22,Santa Barbara,083,443738,85577,85457,4770,90227,672
2022-03-22,Santa Clara,085,1922200,309876,310787,12423,323210,2249
2022-03-22,Santa Cruz,087,273765,47633,47287,2124,49411,259
2022-03-22,Shasta,089,179085,30521,30528,6140,36668,525
2022-03-22,Sierra,091,2930,271,273,48,321,4
2022-03-22,Siskiyou,093,43540,4438,4429,2745,7174,80
2022-03-22,Solano,095,438530,81218,81587,5589,87176,440
2022-03-22,Sonoma,097,501317,83254,83042,2608,85650,482
2022-03-22,Stanislaus,099,539301,117270,118025,17638,135663,1568
2022-03-22,Sutter,101,95872,20453,20525,2121,22646,218
2022-03-22,Tehama,103,63373,12023,12034,2614,14648,162
2022-03-22,Trinity,105,12862,1182,1174,295,1469,20
2022-03-22,Tulare,107,460477,106386,104431,28490,132921,1391
2022-03-22,Tuolumne,109,53932,12628,12628,570,13198,180
2022-03-22,Ventura,111,848112,172903,172590,9457,182047,1455
2022-03-22,Yolo,113,214977,36891,36184,3208,39392,308
2022-03-22,Yuba,115,75493,15813,15795,1202,16997,117
2022-03-21,Alameda,001,1643700,255030,254354,13735,268089,1799
2022-03-21,Alpine,003,1148,124,122,1,123,0
2022-03-21,Amador,005,37829,8523,8461,650,9111,85
2022-03-21,Butte,007,227075,32970,32895,6693,39588,385
2022-03-21,Calaveras,009,45235,7244,7237,354,7591,119
2022-03-21,Colusa,011,21464,3436,3445,1072,4517,21
2022-03-21,Contra Costa,013,1133247,187983,187509,13198,200707,1276
2022-03-21,Del Norte,015,27424,5777,5824,196,6020,50
2022-03-21,El Dorado,017,186661,26657,26610,3238,29848,199
2022-03-21,Fresno,019,978130,231013,229374,23942,253316,2707
2022-03-21,Glenn,021,27897,4970,4972,1600,6572,46
2022-03-21,Humboldt,023,135768,16844,16912,2955,19867,139
2022-03-21,Imperial,025,180216,55301,55133,10790,65923,908
2022-03-21,Inyo,027,18085,4062,4060,482,4542,56
2022-03-21,Kern,029,883053,191602,191184,46244,237428,2187
2022-03-21,Kings,031,150075,51412,51366,3619,54985,441
2022-03-21,Lake,033,64148,10676,10655,895,11550,135
2022-03-21,Lassen,035,31185,8955,8939,887,9826,63
2022-03-21,Los Angeles,037,10098052,2703538,2694711,123911,2818622,31218
2022-03-21,Madera,039,155013,37246,37288,6098,43386,354
2022-03-21,Marin,041,260295,33319,33242,2204,35446,287
2022-03-21,Mariposa,043,17540,2390,2383,200,2583,6
2022-03-21,Mendocino,045,87422,13025,13028,3033,16061,118
2022-03-21,Merced,047,269075,62065,62048,8657,70705,803
2022-03-21,Modoc,049,8938,735,734,250,984,7
2022-03-21,Mono,051,14174,2966,2962,122,3084,5
2022-03-21,Monterey,053,433212,79195,78572,13813,92385,724
2022-03-21,Napa,055,140530,25721,25684,957,26641,138
2022-03-21,Nevada,057,99092,15920,15963,1208,17171,123
2022-03-21,Orange,059,3164182,545451,544943,41429,586372,6841
2022-03-21,Placer,061,380077,62598,62550,7385,69935,610
2022-03-21,Plumas,063,18699,2965,2744,364,3108,13
2022-03-21,Riverside,065,2383286,590480,589707,28067,617774,6376
2022-03-21,Sacramento,067,1510023,280165,275334,27162,302496,2925
2022-03-21,San Benito,069,59416,12870,12872,515,13387,97
2022-03-21,San Bernardino,071,2135413,567654,560210,25051,585261,6807
2022-03-21,San Diego,073,3302833,749179,748833,52358,801191,5138
2022-03-21,San Francisco,075,870044,123681,123912,8279,132191,835
2022-03-21,San Joaquin,077,732212,166054,165939,10014,175953,2185
2022-03-21,San Luis Obispo,079,281455,52312,52219,3784,56003,463
2022-03-21,San Mateo,081,765935,121045,119899,6999,126898,684
2022-03-21,Santa Barbara,083,443738,85562,85416,4768,90184,672
2022-03-21,Santa Clara,085,1922200,309615,310509,12420,322929,2245
2022-03-21,Santa Cruz,087,273765,47597,47267,2123,49390,259
2022-03-21,Shasta,089,179085,30515,30523,6138,36661,525
2022-03-21,Sierra,091,2930,271,273,48,321,4
2022-03-21,Siskiyou,093,43540,4438,4426,2745,7171,80
2022-03-21,Solano,095,438530,81190,81399,5589,86988,441
2022-03-21,Sonoma,097,501317,83215,82979,2603,85582,482
2022-03-21,Stanislaus,099,539301,117237,118144,17635,135779,1571
2022-03-21,Sutter,101,95872,20450,20523,2108,22631,218
2022-03-21,Tehama,103,63373,12019,12030,2614,14644,160
2022-03-21,Trinity,105,12862,1182,1174,295,1469,20
2022-03-21,Tulare,107,460477,106366,104350,28485,132835,1389
2022-03-21,Tuolumne,109,53932,12628,12620,570,13190,180
2022-03-21,Ventura,111,848112,172833,172537,9453,181990,1452
2022-03-21,Yolo,113,214977,36875,36141,3206,39347,307
2022-03-21,Yuba,115,75493,15810,15790,1201,16991,117
2022-03-20,Alameda,001,1643700,254895,254293,13724,268017,1801
2022-03-20,Alpine,003,1148,122,122,1,123,0
2022-03-20,Amador,005,37829,8520,8460,650,9110,85
2022-03-20,Butte,007,227075,32955,32892,6689,39581,385
2022-03-20,Calaveras,009,45235,7243,7233,351,7584,119
2022-03-20,Colusa,011,21464,3436,3446,1072,4518,21
2022-03-20,Contra Costa,013,1133247,187879,187467,13187,200654,1276
2022-03-20,Del Norte,015,27424,5775,5821,196,6017,50
2022-03-20,El Dorado,017,186661,26649,26608,3238,29846,199
2022-03-20,Fresno,019,978130,230936,229297,23931,253228,2707
2022-03-20,Glenn,021,27897,4969,4972,1600,6572,46
2022-03-20,Humboldt,023,135768,16842,16913,2953,19866,139
2022-03-20,Imperial,025,180216,55290,55133,10789,65922,908
2022-03-20,Inyo,027,18085,4062,4060,482,4542,56
2022-03-20,Kern,029,883053,191558,191170,46239,237409,2187
2022-03-20,Kings,031,150075,51401,51360,3619,54979,441
2022-03-20,Lake,033,64148,10672,10652,895,11547,135
2022-03-20,Lassen,035,31185,8953,8938,887,9825,63
2022-03-20,Los Angeles,037,10098052,2702742,2694698,123865,2818563,31219
2022-03-20,Madera,039,155013,37241,37284,6094,43378,354
2022-03-20,Marin,041,260295,33303,33232,2203,35435,275
2022-03-20,Mariposa,043,17540,2390,2383,200,2583,6
2022-03-20,Mendocino,045,87422,13018,13027,3028,16055,118
2022-03-20,Merced,047,269075,62054,62041,8651,70692,803
2022-03-20,Modoc,049,8938,735,734,250,984,7
2022-03-20,Mono,051,14174,2964,2962,122,3084,5
2022-03-20,Monterey,053,433212,79162,78566,13802,92368,723
2022-03-20,Napa,055,140530,25709,25682,956,26638,138
2022-03-20,Nevada,057,99092,15916,15964,1208,17172,123
2022-03-20,Orange,059,3164182,545330,544862,41409,586271,6841
2022-03-20,Placer,061,380077,62578,62525,7385,69910,610
2022-03-20,Plumas,063,18699,2965,2744,364,3108,13
2022-03-20,Riverside,065,2383286,590383,589657,28062,617719,6376
2022-03-20,Sacramento,067,1510023,280087,275317,27146,302463,2927
2022-03-20,San Benito,069,59416,12870,12869,514,13383,97
2022-03-20,San Bernardino,071,2135413,567573,560220,25042,585262,6805
2022-03-20,San Diego,073,3302833,748943,748833,52325,801158,5138
2022-03-20,San Francisco,075,870044,123531,123858,8267,132125,835
2022-03-20,San Joaquin,077,732212,166021,165927,10010,175937,2185
2022-03-20,San Luis Obispo,079,281455,52288,52217,3781,55998,463
2022-03-20,San Mateo,081,765935,120985,119901,6993,126894,684
2022-03-20,Santa Barbara,083,443738,85537,85412,4766,90178,672
2022-03-20,Santa Clara,085,1922200,309406,310412,12412,322824,2243
2022-03-20,Santa Cruz,087,273765,47570,47265,2122,49387,259
2022-03-20,Shasta,089,179085,30505,30522,6137,36659,525
2022-03-20,Sierra,091,2930,271,273,48,321,4
2022-03-20,Siskiyou,093,43540,4437,4426,2745,7171,80
2022-03-20,Solano,095,438530,81160,81393,5587,86980,441
2022-03-20,Sonoma,097,501317,83172,82965,2602,85567,481
2022-03-20,Stanislaus,099,539301,117211,118146,17631,135777,1572
2022-03-20,Sutter,101,95872,20443,20519,2098,22617,218
2022-03-20,Tehama,103,63373,12017,12030,2614,14644,160
2022-03-20,Trinity,105,12862,1182,1174,295,1469,20
2022-03-20,Tulare,107,460477,106345,104353,28471,132824,1389
2022-03-20,Tuolumne,109,53932,12623,12617,570,13187,180
2022-03-20,Ventura,111,848112,172783,172514,9448,181962,1451
2022-03-20,Yolo,113,214977,36856,36135,3205,39340,307
2022-03-20,Yuba,115,75493,15801,15787,1199,16986,117
2022-03-19,Alameda,001,1643700,254816,253936,13722,267658,1797
2022-03-19,Alpine,003,1148,122,122,1,123,0
2022-03-19,Amador,005,37829,8517,8456,650,9106,85
2022-03-19,Butte,007,227075,32947,32856,6689,39545,385
2022-03-19,Calaveras,009,45235,7243,7229,351,7580,119
2022-03-19,Colusa,011,21464,3434,3445,1072,4517,21
2022-03-19,Contra Costa,013,1133247,187843,187225,13186,200411,1276
2022-03-19,Del Norte,015,27424,5772,5815,196,6011,48
2022-03-19,El Dorado,017,186661,26645,26618,3238,29856,199
2022-03-19,Fresno,019,978130,230913,228965,23930,252895,2694
2022-03-19,Glenn,021,27897,4969,4971,1600,6571,44
2022-03-19,Humboldt,023,135768,16836,16901,2953,19854,138
2022-03-19,Imperial,025,180216,55289,55038,10788,65826,898
2022-03-19,Inyo,027,18085,4062,4061,482,4543,56
2022-03-19,Kern,029,883053,191543,190943,46231,237174,2184
2022-03-19,Kings,031,150075,51396,51334,3619,54953,441
2022-03-19,Lake,033,64148,10672,10641,895,11536,135
2022-03-19,Lassen,035,31185,8953,8925,887,9812,63
2022-03-19,Los Angeles,037,10098052,2702368,2686759,123831,2810590,31133
2022-03-19,Madera,039,155013,37241,37273,6094,43367,354
2022-03-19,Marin,041,260295,33285,33163,2199,35362,272
2022-03-19,Mariposa,043,17540,2389,2378,200,2578,6
2022-03-19,Mendocino,045,87422,13018,13012,3028,16040,117
2022-03-19,Merced,047,269075,62048,61985,8649,70634,800
2022-03-19,Modoc,049,8938,735,734,250,984,7
2022-03-19,Mono,051,14174,2964,2961,122,3083,5
2022-03-19,Monterey,053,433212,79151,78483,13795,92278,720
2022-03-19,Napa,055,140530,25706,25654,956,26610,138
2022-03-19,Nevada,057,99092,15914,15960,1208,17168,123
2022-03-19,Orange,059,3164182,545258,543907,41393,585300,6817
2022-03-19,Placer,061,380077,62564,62483,7385,69868,605
2022-03-19,Plumas,063,18699,2965,2724,364,3088,13
2022-03-19,Riverside,065,2383286,590332,589017,28054,617071,6359
2022-03-19,Sacramento,067,1510023,280046,274855,27142,301997,2913
2022-03-19,San Benito,069,59416,12869,12859,514,13373,97
2022-03-19,San Bernardino,071,2135413,567527,559935,25040,584975,6778
2022-03-19,San Diego,073,3302833,748843,747344,52313,799657,5133
2022-03-19,San Francisco,075,870044,123461,123587,8264,131851,833
2022-03-19,San Joaquin,077,732212,165996,165765,10007,175772,2181
2022-03-19,San Luis Obispo,079,281455,52282,52174,3781,55955,463
2022-03-19,San Mateo,081,765935,120948,119782,6992,126774,667
2022-03-19,Santa Barbara,083,443738,85523,85336,4765,90101,671
2022-03-19,Santa Clara,085,1922200,309284,309918,12403,322321,2225
2022-03-19,Santa Cruz,087,273765,47562,47203,2118,49321,256
2022-03-19,Shasta,089,179085,30501,30495,6137,36632,525
2022-03-19,Sierra,091,2930,271,273,48,321,4
2022-03-19,Siskiyou,093,43540,4436,4422,2745,7167,76
2022-03-19,Solano,095,438530,81151,81340,5584,86924,441
2022-03-19,Sonoma,097,501317,83155,82838,2599,85437,472
2022-03-19,Stanislaus,099,539301,117201,118138,17629,135767,1568
2022-03-19,Sutter,101,95872,20440,20503,2098,22601,218
2022-03-19,Tehama,103,63373,12017,12007,2614,14621,160
2022-03-19,Trinity,105,12862,1182,1173,295,1468,20
2022-03-19,Tulare,107,460477,106336,104290,28466,132756,1384
2022-03-19,Tuolumne,109,53932,12622,12617,570,13187,180
2022-03-19,Ventura,111,848112,172752,172380,9447,181827,1451
2022-03-19,Yolo,113,214977,36847,36086,3205,39291,306
2022-03-19,Yuba,115,75493,15797,15768,1198,16966,117
2022-03-18,Alameda,001,1643700,254757,253936,13718,267654,1797
2022-03-18,Alpine,003,1148,122,122,1,123,0
2022-03-18,Amador,005,37829,8517,8456,650,9106,85
2022-03-18,Butte,007,227075,32942,32856,6687,39543,385
2022-03-18,Calaveras,009,45235,7243,7229,351,7580,119
2022-03-18,Colusa,011,21464,3434,3445,1072,4517,21
2022-03-18,Contra Costa,013,1133247,187811,187225,13184,200409,1276
2022-03-18,Del Norte,015,27424,5770,5815,195,6010,48
2022-03-18,El Dorado,017,186661,26640,26618,3236,29854,199
2022-03-18,Fresno,019,978130,230881,228965,23930,252895,2694
2022-03-18,Glenn,021,27897,4969,4971,1600,6571,44
2022-03-18,Humboldt,023,135768,16833,16901,2952,19853,138
2022-03-18,Imperial,025,180216,55287,55038,10788,65826,898
2022-03-18,Inyo,027,18085,4062,4061,482,4543,56
2022-03-18,Kern,029,883053,191532,190943,46228,237171,2184
2022-03-18,Kings,031,150075,51388,51334,3619,54953,441
2022-03-18,Lake,033,64148,10670,10641,894,11535,135
2022-03-18,Lassen,035,31185,8952,8925,887,9812,63
2022-03-18,Los Angeles,037,10098052,2702018,2686759,123805,2810564,31133
2022-03-18,Madera,039,155013,37236,37273,6094,43367,354
2022-03-18,Marin,041,260295,33271,33163,2199,35362,272
2022-03-18,Mariposa,043,17540,2388,2378,200,2578,6
2022-03-18,Mendocino,045,87422,13014,13012,3028,16040,117
2022-03-18,Merced,047,269075,62037,61985,8649,70634,800
2022-03-18,Modoc,049,8938,735,734,250,984,7
2022-03-18,Mono,051,14174,2963,2961,122,3083,5
2022-03-18,Monterey,053,433212,79133,78483,13792,92275,720
2022-03-18,Napa,055,140530,25703,25654,956,26610,138
2022-03-18,Nevada,057,99092,15911,15960,1207,17167,123
2022-03-18,Orange,059,3164182,545192,543907,41384,585291,6817
2022-03-18,Placer,061,380077,62555,62483,7385,69868,605
2022-03-18,Plumas,063,18699,2965,2724,364,3088,13
2022-03-18,Riverside,065,2383286,590272,589017,28050,617067,6359
2022-03-18,Sacramento,067,1510023,280009,274855,27137,301992,2913
2022-03-18,San Benito,069,59416,12867,12859,514,13373,97
2022-03-18,San Bernardino,071,2135413,567489,559935,25038,584973,6778
2022-03-18,San Diego,073,3302833,748735,747344,52298,799642,5133
2022-03-18,San Francisco,075,870044,123382,123587,8257,131844,833
2022-03-18,San Joaquin,077,732212,165981,165765,10002,175767,2181
2022-03-18,San Luis Obispo,079,281455,52276,52174,3781,55955,463
2022-03-18,San Mateo,081,765935,120913,119782,6989,126771,667
2022-03-18,Santa Barbara,083,443738,85513,85336,4764,90100,671
2022-03-18,Santa Clara,085,1922200,309180,309918,12400,322318,2225
2022-03-18,Santa Cruz,087,273765,47550,47203,2117,49320,256
2022-03-18,Shasta,089,179085,30500,30495,6137,36632,525
2022-03-18,Sierra,091,2930,271,273,48,321,4
2022-03-18,Siskiyou,093,43540,4436,4422,2745,7167,76
2022-03-18,Solano,095,438530,81140,81340,5578,86918,441
2022-03-18,Sonoma,097,501317,83134,82838,2598,85436,472
2022-03-18,Stanislaus,099,539301,117188,118138,17629,135767,1568
2022-03-18,Sutter,101,95872,20437,20503,2098,22601,218
2022-03-18,Tehama,103,63373,12016,12007,2614,14621,160
2022-03-18,Trinity,105,12862,1182,1173,295,1468,20
2022-03-18,Tulare,107,460477,106330,104290,28460,132750,1384
2022-03-18,Tuolumne,109,53932,12621,12617,570,13187,180
2022-03-18,Ventura,111,848112,172732,172380,9442,181822,1451
2022-03-18,Yolo,113,214977,36836,36086,3205,39291,306
2022-03-18,Yuba,115,75493,15795,15768,1198,16966,117
2022-03-17,Alameda,001,1643700,254657,253936,13712,267648,1797
2022-03-17,Alpine,003,1148,122,122,1,123,0
2022-03-17,Amador,005,37829,8510,8456,650,9106,85
2022-03-17,Butte,007,227075,32928,32856,6685,39541,385
2022-03-17,Calaveras,009,45235,7240,7229,351,7580,119
2022-03-17,Colusa,011,21464,3434,3445,1072,4517,21
2022-03-17,Contra Costa,013,1133247,187747,187225,13173,200398,1276
2022-03-17,Del Norte,015,27424,5768,5815,195,6010,48
2022-03-17,El Dorado,017,186661,26634,26618,3236,29854,199
2022-03-17,Fresno,019,978130,230831,228965,23925,252890,2694
2022-03-17,Glenn,021,27897,4969,4971,1600,6571,44
2022-03-17,Humboldt,023,135768,16829,16901,2950,19851,138
2022-03-17,Imperial,025,180216,55276,55038,10788,65826,898
2022-03-17,Inyo,027,18085,4062,4061,482,4543,56
2022-03-17,Kern,029,883053,191503,190943,46225,237168,2184
2022-03-17,Kings,031,150075,51385,51334,3618,54952,441
2022-03-17,Lake,033,64148,10667,10641,894,11535,135
2022-03-17,Lassen,035,31185,8950,8925,887,9812,63
2022-03-17,Los Angeles,037,10098052,2701356,2686759,123768,2810527,31133
2022-03-17,Madera,039,155013,37232,37273,6093,43366,354
2022-03-17,Marin,041,260295,33259,33163,2198,35361,272
2022-03-17,Mariposa,043,17540,2388,2378,200,2578,6
2022-03-17,Mendocino,045,87422,13010,13012,3025,16037,117
2022-03-17,Merced,047,269075,62031,61985,8647,70632,800
2022-03-17,Modoc,049,8938,735,734,250,984,7
2022-03-17,Mono,051,14174,2963,2961,121,3082,5
2022-03-17,Monterey,053,433212,79110,78483,13786,92269,720
2022-03-17,Napa,055,140530,25698,25654,956,26610,138
2022-03-17,Nevada,057,99092,15908,15960,1207,17167,123
2022-03-17,Orange,059,3164182,545098,543907,41374,585281,6817
2022-03-17,Placer,061,380077,62540,62483,7383,69866,605
2022-03-17,Plumas,063,18699,2964,2724,364,3088,13
2022-03-17,Riverside,065,2383286,590192,589017,28043,617060,6359
2022-03-17,Sacramento,067,1510023,279942,274855,27129,301984,2913
2022-03-17,San Benito,069,59416,12866,12859,514,13373,97
2022-03-17,San Bernardino,071,2135413,567425,559935,25035,584970,6778
2022-03-17,San Diego,073,3302833,748559,747344,52284,799628,5133
2022-03-17,San Francisco,075,870044,123301,123587,8252,131839,833
2022-03-17,San Joaquin,077,732212,165961,165765,10000,175765,2181
2022-03-17,San Luis Obispo,079,281455,52262,52174,3779,55953,463
2022-03-17,San Mateo,081,765935,120866,119782,6985,126767,667
2022-03-17,Santa Barbara,083,443738,85497,85336,4764,90100,671
2022-03-17,Santa Clara,085,1922200,309059,309918,12395,322313,2225
2022-03-17,Santa Cruz,087,273765,47534,47203,2115,49318,256
2022-03-17,Shasta,089,179085,30496,30495,6135,36630,525
2022-03-17,Sierra,091,2930,271,273,48,321,4
2022-03-17,Siskiyou,093,43540,4435,4422,2745,7167,76
2022-03-17,Solano,095,438530,81111,81340,5575,86915,441
2022-03-17,Sonoma,097,501317,83105,82838,2596,85434,472
2022-03-17,Stanislaus,099,539301,117174,118138,17624,135762,1568
2022-03-17,Sutter,101,95872,20427,20503,2084,22587,218
2022-03-17,Tehama,103,63373,12016,12007,2613,14620,160
2022-03-17,Trinity,105,12862,1182,1173,295,1468,20
2022-03-17,Tulare,107,460477,106314,104290,28449,132739,1384
2022-03-17,Tuolumne,109,53932,12618,12617,569,13186,180
2022-03-17,Ventura,111,848112,172683,172380,9440,181820,1451
2022-03-17,Yolo,113,214977,36822,36086,3205,39291,306
2022-03-17,Yuba,115,75493,15793,15768,1197,16965,117
2022-03-16,Alameda,001,1643700,254557,253792,13708,267500,1794
2022-03-16,Alpine,003,1148,122,122,1,123,0
2022-03-16,Amador,005,37829,8502,8449,650,9099,85
2022-03-16,Butte,007,227075,32917,32837,6680,39517,385
2022-03-16,Calaveras,009,45235,7238,7229,351,7580,120
2022-03-16,Colusa,011,21464,3434,3445,1072,4517,22
2022-03-16,Contra Costa,013,1133247,187689,187100,13162,200262,1266
2022-03-16,Del Norte,015,27424,5767,5811,193,6004,48
2022-03-16,El Dorado,017,186661,26621,26602,3235,29837,199
2022-03-16,Fresno,019,978130,230784,228786,23914,252700,2689
2022-03-16,Glenn,021,27897,4969,4969,1599,6568,44
2022-03-16,Humboldt,023,135768,16826,16893,2950,19843,138
2022-03-16,Imperial,025,180216,55264,55002,10787,65789,897
2022-03-16,Inyo,027,18085,4061,4061,482,4543,56
2022-03-16,Kern,029,883053,191461,190835,46218,237053,2170
2022-03-16,Kings,031,150075,51370,51321,3618,54939,437
2022-03-16,Lake,033,64148,10665,10633,893,11526,133
2022-03-16,Lassen,035,31185,8947,8924,887,9811,62
2022-03-16,Los Angeles,037,10098052,2700728,2685789,123727,2809516,31102
2022-03-16,Madera,039,155013,37222,37262,6092,43354,354
2022-03-16,Marin,041,260295,33238,33136,2196,35332,272
2022-03-16,Mariposa,043,17540,2386,2376,200,2576,6
2022-03-16,Mendocino,045,87422,13007,13011,3024,16035,117
2022-03-16,Merced,047,269075,62016,61959,8641,70600,798
2022-03-16,Modoc,049,8938,734,734,250,984,7
2022-03-16,Mono,051,14174,2963,2960,121,3081,5
2022-03-16,Monterey,053,433212,79088,78416,13781,92197,720
2022-03-16,Napa,055,140530,25689,25638,955,26593,138
2022-03-16,Nevada,057,99092,15906,15960,1207,17167,123
2022-03-16,Orange,059,3164182,544975,543326,41350,584676,6791
2022-03-16,Placer,061,380077,62524,62435,7381,69816,605
2022-03-16,Plumas,063,18699,2964,2723,364,3087,13
2022-03-16,Riverside,065,2383286,590095,588761,28040,616801,6351
2022-03-16,Sacramento,067,1510023,279876,274709,27122,301831,2910
2022-03-16,San Benito,069,59416,12861,12854,514,13368,97
2022-03-16,San Bernardino,071,2135413,567345,559746,25028,584774,6775
2022-03-16,San Diego,073,3302833,748354,746970,52260,799230,5126
2022-03-16,San Francisco,075,870044,123201,123446,8244,131690,831
2022-03-16,San Joaquin,077,732212,165914,165703,9997,175700,2169
2022-03-16,San Luis Obispo,079,281455,52244,52132,3775,55907,462
2022-03-16,San Mateo,081,765935,120803,119680,6976,126656,660
2022-03-16,Santa Barbara,083,443738,85464,85322,4759,90081,670
2022-03-16,Santa Clara,085,1922200,308873,309689,12380,322069,2224
2022-03-16,Santa Cruz,087,273765,47505,47161,2115,49276,255
2022-03-16,Shasta,089,179085,30487,30489,6131,36620,527
2022-03-16,Sierra,091,2930,271,273,48,321,4
2022-03-16,Siskiyou,093,43540,4432,4419,2743,7162,76
2022-03-16,Solano,095,438530,81088,81277,5573,86850,440
2022-03-16,Sonoma,097,501317,83062,82791,2587,85378,472
2022-03-16,Stanislaus,099,539301,117149,118072,17622,135694,1567
2022-03-16,Sutter,101,95872,20425,20494,2083,22577,218
2022-03-16,Tehama,103,63373,12014,11999,2613,14612,160
2022-03-16,Trinity,105,12862,1182,1173,295,1468,20
2022-03-16,Tulare,107,460477,106300,104217,28443,132660,1377
2022-03-16,Tuolumne,109,53932,12613,12610,569,13179,180
2022-03-16,Ventura,111,848112,172642,172212,9436,181648,1451
2022-03-16,Yolo,113,214977,36799,36079,3202,39281,307
2022-03-16,Yuba,115,75493,15788,15758,1197,16955,117
2022-03-15,Alameda,001,1643700,254425,253694,13698,267392,1793
2022-03-15,Alpine,003,1148,122,122,1,123,0
2022-03-15,Amador,005,37829,8499,8448,650,9098,85
2022-03-15,Butte,007,227075,32904,32822,6678,39500,385
2022-03-15,Calaveras,009,45235,7236,7236,351,7587,118
2022-03-15,Colusa,011,21464,3434,3445,1072,4517,21
2022-03-15,Contra Costa,013,1133247,187608,187021,13153,200174,1265
2022-03-15,Del Norte,015,27424,5764,5806,190,5996,48
2022-03-15,El Dorado,017,186661,26618,26596,3234,29830,199
2022-03-15,Fresno,019,978130,230741,228631,23904,252535,2689
2022-03-15,Glenn,021,27897,4967,4966,1599,6565,44
2022-03-15,Humboldt,023,135768,16820,16889,2949,19838,138
2022-03-15,Imperial,025,180216,55254,54981,10783,65764,896
2022-03-15,Inyo,027,18085,4061,4062,481,4543,56
2022-03-15,Kern,029,883053,191432,190645,46208,236853,2168
2022-03-15,Kings,031,150075,51351,51317,3614,54931,437
2022-03-15,Lake,033,64148,10661,10631,893,11524,131
2022-03-15,Lassen,035,31185,8945,8926,886,9812,62
2022-03-15,Los Angeles,037,10098052,2700050,2685071,123667,2808738,31077
2022-03-15,Madera,039,155013,37213,37258,6091,43349,354
2022-03-15,Marin,041,260295,33215,33111,2195,35306,272
2022-03-15,Mariposa,043,17540,2384,2377,200,2577,6
2022-03-15,Mendocino,045,87422,13002,13005,3023,16028,117
2022-03-15,Merced,047,269075,61999,61916,8632,70548,798
2022-03-15,Modoc,049,8938,734,733,250,983,7
2022-03-15,Mono,051,14174,2963,2961,121,3082,5
2022-03-15,Monterey,053,433212,79058,78400,13773,92173,718
2022-03-15,Napa,055,140530,25681,25657,953,26610,138
2022-03-15,Nevada,057,99092,15904,15960,1205,17165,123
2022-03-15,Orange,059,3164182,544834,543197,41343,584540,6780
2022-03-15,Placer,061,380077,62507,62398,7377,69775,604
2022-03-15,Plumas,063,18699,2963,2722,364,3086,13
2022-03-15,Riverside,065,2383286,589994,588622,28032,616654,6333
2022-03-15,Sacramento,067,1510023,279791,274633,27115,301748,2907
2022-03-15,San Benito,069,59416,12857,12849,514,13363,95
2022-03-15,San Bernardino,071,2135413,567270,559605,25023,584628,6770
2022-03-15,San Diego,073,3302833,748110,746474,52238,798712,5116
2022-03-15,San Francisco,075,870044,123085,123526,8235,131761,831
2022-03-15,San Joaquin,077,732212,165871,165664,9991,175655,2161
2022-03-15,San Luis Obispo,079,281455,52234,52060,3771,55831,458
2022-03-15,San Mateo,081,765935,120752,119586,6970,126556,649
2022-03-15,Santa Barbara,083,443738,85439,85353,4755,90108,668
2022-03-15,Santa Clara,085,1922200,308712,309535,12368,321903,2224
2022-03-15,Santa Cruz,087,273765,47452,47117,2115,49232,255
2022-03-15,Shasta,089,179085,30478,30476,6128,36604,524
2022-03-15,Sierra,091,2930,271,273,48,321,4
2022-03-15,Siskiyou,093,43540,4432,4420,2743,7163,76
2022-03-15,Solano,095,438530,81053,81260,5572,86832,440
2022-03-15,Sonoma,097,501317,83021,82737,2587,85324,472
2022-03-15,Stanislaus,099,539301,117131,118085,17618,135703,1567
2022-03-15,Sutter,101,95872,20422,20480,2073,22553,217
2022-03-15,Tehama,103,63373,12011,11997,2612,14609,160
2022-03-15,Trinity,105,12862,1182,1173,295,1468,20
2022-03-15,Tulare,107,460477,106281,104153,28431,132584,1375
2022-03-15,Tuolumne,109,53932,12609,12602,569,13171,180
2022-03-15,Ventura,111,848112,172597,172150,9432,181582,1451
2022-03-15,Yolo,113,214977,36783,36079,3196,39275,308
2022-03-15,Yuba,115,75493,15780,15756,1197,16953,116
2022-03-14,Alameda,001,1643700,254311,253629,13693,267322,1791
2022-03-14,Alpine,003,1148,122,122,1,123,0
2022-03-14,Amador,005,37829,8494,8448,650,9098,85
2022-03-14,Butte,007,227075,32886,32812,6677,39489,385
2022-03-14,Calaveras,009,45235,7235,7245,351,7596,118
2022-03-14,Colusa,011,21464,3433,3445,1072,4517,21
2022-03-14,Contra Costa,013,1133247,187515,186969,13144,200113,1265
2022-03-14,Del Norte,015,27424,5758,5807,190,5997,48
2022-03-14,El Dorado,017,186661,26613,26570,3234,29804,199
2022-03-14,Fresno,019,978130,230667,228470,23894,252364,2682
2022-03-14,Glenn,021,27897,4965,4966,1598,6564,44
2022-03-14,Humboldt,023,135768,16813,16890,2947,19837,137
2022-03-14,Imperial,025,180216,55243,54933,10782,65715,897
2022-03-14,Inyo,027,18085,4061,4062,481,4543,56
2022-03-14,Kern,029,883053,191397,190526,46197,236723,2166
2022-03-14,Kings,031,150075,51333,51293,3613,54906,437
2022-03-14,Lake,033,64148,10658,10631,893,11524,131
2022-03-14,Lassen,035,31185,8945,8927,885,9812,62
2022-03-14,Los Angeles,037,10098052,2699419,2683369,123600,2806969,31034
2022-03-14,Madera,039,155013,37206,37255,6090,43345,354
2022-03-14,Marin,041,260295,33186,33099,2195,35294,272
2022-03-14,Mariposa,043,17540,2383,2376,200,2576,6
2022-03-14,Mendocino,045,87422,12997,12992,3016,16008,117
2022-03-14,Merced,047,269075,61980,61905,8630,70535,795
2022-03-14,Modoc,049,8938,733,731,250,981,7
2022-03-14,Mono,051,14174,2962,2961,121,3082,5
2022-03-14,Monterey,053,433212,79043,78376,13737,92113,718
2022-03-14,Napa,055,140530,25667,25649,953,26602,138
2022-03-14,Nevada,057,99092,15902,15954,1205,17159,123
2022-03-14,Orange,059,3164182,544696,543099,41335,584434,6775
2022-03-14,Placer,061,380077,62489,62389,7375,69764,601
2022-03-14,Plumas,063,18699,2963,2711,364,3075,13
2022-03-14,Riverside,065,2383286,589859,588531,28020,616551,6332
2022-03-14,Sacramento,067,1510023,279711,274682,27110,301792,2899
2022-03-14,San Benito,069,59416,12852,12846,513,13359,95
2022-03-14,San Bernardino,071,2135413,567183,559505,25018,584523,6767
2022-03-14,San Diego,073,3302833,747807,745515,52210,797725,5108
2022-03-14,San Francisco,075,870044,122994,123575,8229,131804,824
2022-03-14,San Joaquin,077,732212,165832,165662,9990,175652,2142
2022-03-14,San Luis Obispo,079,281455,52207,52046,3768,55814,458
2022-03-14,San Mateo,081,765935,120679,119564,6967,126531,649
2022-03-14,Santa Barbara,083,443738,85402,85396,4754,90150,667
2022-03-14,Santa Clara,085,1922200,308528,309600,12363,321963,2223
2022-03-14,Santa Cruz,087,273765,47414,47107,2112,49219,255
2022-03-14,Shasta,089,179085,30473,30462,6125,36587,520
2022-03-14,Sierra,091,2930,271,273,48,321,4
2022-03-14,Siskiyou,093,43540,4427,4419,2742,7161,76
2022-03-14,Solano,095,438530,81005,81233,5567,86800,440
2022-03-14,Sonoma,097,501317,82985,82731,2583,85314,473
2022-03-14,Stanislaus,099,539301,117095,118088,17614,135702,1567
2022-03-14,Sutter,101,95872,20415,20478,2073,22551,217
2022-03-14,Tehama,103,63373,12009,11996,2612,14608,160
2022-03-14,Trinity,105,12862,1182,1172,295,1467,20
2022-03-14,Tulare,107,460477,106252,104121,28423,132544,1365
2022-03-14,Tuolumne,109,53932,12608,12567,568,13135,180
2022-03-14,Ventura,111,848112,172544,172107,9430,181537,1442
2022-03-14,Yolo,113,214977,36767,36059,3194,39253,308
2022-03-14,Yuba,115,75493,15768,15748,1197,16945,116
2022-03-13,Alameda,001,1643700,254185,253547,13684,267231,1792
2022-03-13,Alpine,003,1148,122,122,1,123,0
2022-03-13,Amador,005,37829,8492,8444,650,9094,85
2022-03-13,Butte,007,227075,32866,32806,6673,39479,384
2022-03-13,Calaveras,009,45235,7230,7253,351,7604,118
2022-03-13,Colusa,011,21464,3433,3444,1070,4514,21
2022-03-13,Contra Costa,013,1133247,187420,186911,13129,200040,1265
2022-03-13,Del Norte,015,27424,5754,5808,190,5998,48
2022-03-13,El Dorado,017,186661,26608,26563,3233,29796,199
2022-03-13,Fresno,019,978130,230587,228421,23880,252301,2683
2022-03-13,Glenn,021,27897,4961,4966,1597,6563,44
2022-03-13,Humboldt,023,135768,16805,16883,2947,19830,137
2022-03-13,Imperial,025,180216,55232,54934,10780,65714,897
2022-03-13,Inyo,027,18085,4061,4062,480,4542,56
2022-03-13,Kern,029,883053,191343,190495,46183,236678,2166
2022-03-13,Kings,031,150075,51325,51273,3612,54885,437
2022-03-13,Lake,033,64148,10655,10626,893,11519,131
2022-03-13,Lassen,035,31185,8944,8929,884,9813,62
2022-03-13,Los Angeles,037,10098052,2698696,2683351,123556,2806907,31034
2022-03-13,Madera,039,155013,37198,37248,6090,43338,354
2022-03-13,Marin,041,260295,33162,33083,2193,35276,272
2022-03-13,Mariposa,043,17540,2381,2376,200,2576,6
2022-03-13,Mendocino,045,87422,12991,12987,3011,15998,117
2022-03-13,Merced,047,269075,61957,61895,8619,70514,795
2022-03-13,Modoc,049,8938,733,731,250,981,7
2022-03-13,Mono,051,14174,2962,2961,121,3082,5
2022-03-13,Monterey,053,433212,79007,78366,13687,92053,718
2022-03-13,Napa,055,140530,25653,25639,952,26591,138
2022-03-13,Nevada,057,99092,15895,15959,1205,17164,123
2022-03-13,Orange,059,3164182,544574,543036,41311,584347,6774
2022-03-13,Placer,061,380077,62462,62372,7372,69744,601
2022-03-13,Plumas,063,18699,2963,2711,364,3075,13
2022-03-13,Riverside,065,2383286,589726,588487,28014,616501,6332
2022-03-13,Sacramento,067,1510023,279612,274715,27098,301813,2899
2022-03-13,San Benito,069,59416,12846,12844,511,13355,95
2022-03-13,San Bernardino,071,2135413,567091,559450,25007,584457,6767
2022-03-13,San Diego,073,3302833,747465,745515,52176,797691,5108
2022-03-13,San Francisco,075,870044,122873,123622,8223,131845,824
2022-03-13,San Joaquin,077,732212,165783,165641,9988,175629,2142
2022-03-13,San Luis Obispo,079,281455,52177,52040,3765,55805,458
2022-03-13,San Mateo,081,765935,120601,119521,6958,126479,649
2022-03-13,Santa Barbara,083,443738,85362,85453,4752,90205,667
2022-03-13,Santa Clara,085,1922200,308357,309493,12354,321847,2225
2022-03-13,Santa Cruz,087,273765,47363,47087,2111,49198,255
2022-03-13,Shasta,089,179085,30456,30457,6123,36580,520
2022-03-13,Sierra,091,2930,271,273,48,321,4
2022-03-13,Siskiyou,093,43540,4427,4418,2742,7160,76
2022-03-13,Solano,095,438530,80970,81217,5563,86780,440
2022-03-13,Sonoma,097,501317,82950,82711,2580,85291,473
2022-03-13,Stanislaus,099,539301,117061,118075,17611,135686,1567
2022-03-13,Sutter,101,95872,20411,20474,2072,22546,217
2022-03-13,Tehama,103,63373,12008,11997,2611,14608,160
2022-03-13,Trinity,105,12862,1182,1172,295,1467,20
2022-03-13,Tulare,107,460477,106219,104119,28414,132533,1365
2022-03-13,Tuolumne,109,53932,12605,12565,568,13133,180
2022-03-13,Ventura,111,848112,172486,172080,9423,181503,1442
2022-03-13,Yolo,113,214977,36748,36019,3190,39209,308
2022-03-13,Yuba,115,75493,15763,15741,1197,16938,116
2022-03-12,Alameda,001,1643700,254118,253079,13679,266758,1783
2022-03-12,Alpine,003,1148,122,122,1,123,0
2022-03-12,Amador,005,37829,8488,8427,650,9077,84
2022-03-12,Butte,007,227075,32862,32774,6671,39445,380
2022-03-12,Calaveras,009,45235,7229,7253,351,7604,118
2022-03-12,Colusa,011,21464,3433,3440,1070,4510,21
2022-03-12,Contra Costa,013,1133247,187377,186618,13128,199746,1256
2022-03-12,Del Norte,015,27424,5753,5791,190,5981,48
2022-03-12,El Dorado,017,186661,26604,26538,3233,29771,199
2022-03-12,Fresno,019,978130,230565,228041,23880,251921,2653
2022-03-12,Glenn,021,27897,4961,4955,1597,6552,44
2022-03-12,Humboldt,023,135768,16801,16862,2946,19808,137
2022-03-12,Imperial,025,180216,55227,54837,10776,65613,896
2022-03-12,Inyo,027,18085,4061,4056,480,4536,56
2022-03-12,Kern,029,883053,191326,190330,46178,236508,2162
2022-03-12,Kings,031,150075,51319,51145,3612,54757,436
2022-03-12,Lake,033,64148,10653,10594,892,11486,131
2022-03-12,Lassen,035,31185,8943,8915,884,9799,62
2022-03-12,Los Angeles,037,10098052,2698369,2678858,123536,2802394,30901
2022-03-12,Madera,039,155013,37193,37223,6090,43313,354
2022-03-12,Marin,041,260295,33138,33015,2192,35207,272
2022-03-12,Mariposa,043,17540,2381,2372,200,2572,6
2022-03-12,Mendocino,045,87422,12987,12965,3011,15976,117
2022-03-12,Merced,047,269075,61950,61840,8618,70458,795
2022-03-12,Modoc,049,8938,733,730,250,980,7
2022-03-12,Mono,051,14174,2962,2960,120,3080,5
2022-03-12,Monterey,053,433212,79000,78285,13685,91970,716
2022-03-12,Napa,055,140530,25643,25584,951,26535,138
2022-03-12,Nevada,057,99092,15889,15947,1205,17152,123
2022-03-12,Orange,059,3164182,544508,542354,41302,583656,6718
2022-03-12,Placer,061,380077,62453,62282,7372,69654,598
2022-03-12,Plumas,063,18699,2963,2707,364,3071,13
2022-03-12,Riverside,065,2383286,589661,588022,28009,616031,6317
2022-03-12,Sacramento,067,1510023,279573,274519,27094,301613,2886
2022-03-12,San Benito,069,59416,12843,12868,511,13379,95
2022-03-12,San Bernardino,071,2135413,567047,559013,25006,584019,6734
2022-03-12,San Diego,073,3302833,747343,744386,52154,796540,5090
2022-03-12,San Francisco,075,870044,122808,123610,8217,131827,823
2022-03-12,San Joaquin,077,732212,165766,165516,9985,175501,2117
2022-03-12,San Luis Obispo,079,281455,52168,51947,3762,55709,457
2022-03-12,San Mateo,081,765935,120565,119288,6957,126245,641
2022-03-12,Santa Barbara,083,443738,85343,85421,4752,90173,664
2022-03-12,Santa Clara,085,1922200,308259,308989,12348,321337,2208
2022-03-12,Santa Cruz,087,273765,47350,46982,2110,49092,254
2022-03-12,Shasta,089,179085,30444,30419,6121,36540,517
2022-03-12,Sierra,091,2930,271,273,48,321,4
2022-03-12,Siskiyou,093,43540,4427,4405,2742,7147,75
2022-03-12,Solano,095,438530,80956,81058,5563,86621,436
2022-03-12,Sonoma,097,501317,82933,82622,2578,85200,473
2022-03-12,Stanislaus,099,539301,117047,117884,17610,135494,1564
2022-03-12,Sutter,101,95872,20410,20429,2072,22501,217
2022-03-12,Tehama,103,63373,12008,11983,2611,14594,159
2022-03-12,Trinity,105,12862,1181,1172,295,1467,20
2022-03-12,Tulare,107,460477,106214,103994,28408,132402,1358
2022-03-12,Tuolumne,109,53932,12604,12476,568,13044,180
2022-03-12,Ventura,111,848112,172461,171932,9421,181353,1442
2022-03-12,Yolo,113,214977,36741,35982,3188,39170,308
2022-03-12,Yuba,115,75493,15763,15722,1197,16919,116
2022-03-11,Alameda,001,1643700,254053,253079,13679,266758,1783
2022-03-11,Alpine,003,1148,122,122,1,123,0
2022-03-11,Amador,005,37829,8486,8427,650,9077,84
2022-03-11,Butte,007,227075,32858,32774,6670,39444,380
2022-03-11,Calaveras,009,45235,7229,7253,351,7604,118
2022-03-11,Colusa,011,21464,3433,3440,1070,4510,21
2022-03-11,Contra Costa,013,1133247,187329,186618,13126,199744,1256
2022-03-11,Del Norte,015,27424,5749,5791,190,5981,48
2022-03-11,El Dorado,017,186661,26600,26538,3233,29771,199
2022-03-11,Fresno,019,978130,230509,228041,23876,251917,2653
2022-03-11,Glenn,021,27897,4961,4955,1597,6552,44
2022-03-11,Humboldt,023,135768,16796,16862,2944,19806,137
2022-03-11,Imperial,025,180216,55221,54837,10775,65612,896
2022-03-11,Inyo,027,18085,4061,4056,480,4536,56
2022-03-11,Kern,029,883053,191305,190330,46173,236503,2162
2022-03-11,Kings,031,150075,51299,51145,3612,54757,436
2022-03-11,Lake,033,64148,10649,10594,892,11486,131
2022-03-11,Lassen,035,31185,8942,8915,884,9799,62
2022-03-11,Los Angeles,037,10098052,2698049,2678858,123511,2802369,30901
2022-03-11,Madera,039,155013,37188,37223,6090,43313,354
2022-03-11,Marin,041,260295,33122,33015,2191,35206,272
2022-03-11,Mariposa,043,17540,2380,2372,200,2572,6
2022-03-11,Mendocino,045,87422,12981,12965,3011,15976,117
2022-03-11,Merced,047,269075,61940,61840,8616,70456,795
2022-03-11,Modoc,049,8938,733,730,250,980,7
2022-03-11,Mono,051,14174,2961,2960,120,3080,5
2022-03-11,Monterey,053,433212,78987,78285,13679,91964,716
2022-03-11,Napa,055,140530,25632,25584,951,26535,138
2022-03-11,Nevada,057,99092,15886,15947,1205,17152,123
2022-03-11,Orange,059,3164182,544438,542354,41288,583642,6718
2022-03-11,Placer,061,380077,62442,62282,7371,69653,598
2022-03-11,Plumas,063,18699,2961,2707,364,3071,13
2022-03-11,Riverside,065,2383286,589583,588022,28005,616027,6317
2022-03-11,Sacramento,067,1510023,279505,274519,27091,301610,2886
2022-03-11,San Benito,069,59416,12842,12868,511,13379,95
2022-03-11,San Bernardino,071,2135413,566990,559013,25000,584013,6734
2022-03-11,San Diego,073,3302833,747177,744386,52140,796526,5090
2022-03-11,San Francisco,075,870044,122757,123610,8213,131823,823
2022-03-11,San Joaquin,077,732212,165732,165516,9982,175498,2117
2022-03-11,San Luis Obispo,079,281455,52160,51947,3761,55708,457
2022-03-11,San Mateo,081,765935,120516,119288,6954,126242,641
2022-03-11,Santa Barbara,083,443738,85323,85421,4751,90172,664
2022-03-11,Santa Clara,085,1922200,308159,308989,12344,321333,2208
2022-03-11,Santa Cruz,087,273765,47335,46982,2110,49092,254
2022-03-11,Shasta,089,179085,30439,30419,6118,36537,517
2022-03-11,Sierra,091,2930,271,273,48,321,4
2022-03-11,Siskiyou,093,43540,4425,4405,2740,7145,75
2022-03-11,Solano,095,438530,80942,81058,5562,86620,436
2022-03-11,Sonoma,097,501317,82908,82622,2576,85198,473
2022-03-11,Stanislaus,099,539301,117033,117884,17609,135493,1564
2022-03-11,Sutter,101,95872,20408,20429,2072,22501,217
2022-03-11,Tehama,103,63373,12006,11983,2611,14594,159
2022-03-11,Trinity,105,12862,1181,1172,295,1467,20
2022-03-11,Tulare,107,460477,106200,103994,28402,132396,1358
2022-03-11,Tuolumne,109,53932,12602,12476,568,13044,180
2022-03-11,Ventura,111,848112,172425,171932,9416,181348,1442
2022-03-11,Yolo,113,214977,36730,35982,3188,39170,308
2022-03-11,Yuba,115,75493,15760,15722,1197,16919,116
2022-03-10,Alameda,001,1643700,253943,253079,13672,266751,1783
2022-03-10,Alpine,003,1148,122,122,1,123,0
2022-03-10,Amador,005,37829,8485,8427,650,9077,84
2022-03-10,Butte,007,227075,32844,32774,6668,39442,380
2022-03-10,Calaveras,009,45235,7228,7253,350,7603,118
2022-03-10,Colusa,011,21464,3433,3440,1070,4510,21
2022-03-10,Contra Costa,013,1133247,187245,186618,13116,199734,1256
2022-03-10,Del Norte,015,27424,5740,5791,190,5981,48
2022-03-10,El Dorado,017,186661,26588,26538,3232,29770,199
2022-03-10,Fresno,019,978130,230435,228041,23866,251907,2653
2022-03-10,Glenn,021,27897,4959,4955,1597,6552,44
2022-03-10,Humboldt,023,135768,16787,16862,2943,19805,137
2022-03-10,Imperial,025,180216,55211,54837,10774,65611,896
2022-03-10,Inyo,027,18085,4060,4056,480,4536,56
2022-03-10,Kern,029,883053,191272,190330,46158,236488,2162
2022-03-10,Kings,031,150075,51270,51145,3611,54756,436
2022-03-10,Lake,033,64148,10639,10594,891,11485,131
2022-03-10,Lassen,035,31185,8942,8915,884,9799,62
2022-03-10,Los Angeles,037,10098052,2697495,2678858,123472,2802330,30901
2022-03-10,Madera,039,155013,37182,37223,6083,43306,354
2022-03-10,Marin,041,260295,33109,33015,2187,35202,272
2022-03-10,Mariposa,043,17540,2380,2372,200,2572,6
2022-03-10,Mendocino,045,87422,12977,12965,3011,15976,117
2022-03-10,Merced,047,269075,61924,61840,8610,70450,795
2022-03-10,Modoc,049,8938,732,730,250,980,7
2022-03-10,Mono,051,14174,2961,2960,120,3080,5
2022-03-10,Monterey,053,433212,78964,78285,13653,91938,716
2022-03-10,Napa,055,140530,25623,25584,950,26534,138
2022-03-10,Nevada,057,99092,15879,15947,1205,17152,123
2022-03-10,Orange,059,3164182,544313,542354,41271,583625,6718
2022-03-10,Placer,061,380077,62420,62282,7365,69647,598
2022-03-10,Plumas,063,18699,2960,2707,364,3071,13
2022-03-10,Riverside,065,2383286,589468,588022,27998,616020,6317
2022-03-10,Sacramento,067,1510023,279428,274519,27085,301604,2886
2022-03-10,San Benito,069,59416,12841,12868,510,13378,95
2022-03-10,San Bernardino,071,2135413,566917,559013,24993,584006,6734
2022-03-10,San Diego,073,3302833,746921,744386,52109,796495,5090
2022-03-10,San Francisco,075,870044,122689,123610,8206,131816,823
2022-03-10,San Joaquin,077,732212,165701,165516,9980,175496,2117
2022-03-10,San Luis Obispo,079,281455,52137,51947,3758,55705,457
2022-03-10,San Mateo,081,765935,120453,119288,6951,126239,641
2022-03-10,Santa Barbara,083,443738,85291,85421,4750,90171,664
2022-03-10,Santa Clara,085,1922200,308033,308989,12335,321324,2208
2022-03-10,Santa Cruz,087,273765,47303,46982,2110,49092,254
2022-03-10,Shasta,089,179085,30430,30419,6116,36535,517
2022-03-10,Sierra,091,2930,271,273,48,321,4
2022-03-10,Siskiyou,093,43540,4425,4405,2740,7145,75
2022-03-10,Solano,095,438530,80906,81058,5557,86615,436
2022-03-10,Sonoma,097,501317,82881,82622,2576,85198,473
2022-03-10,Stanislaus,099,539301,116997,117884,17607,135491,1564
2022-03-10,Sutter,101,95872,20404,20429,2072,22501,217
2022-03-10,Tehama,103,63373,12005,11983,2611,14594,159
2022-03-10,Trinity,105,12862,1181,1172,295,1467,20
2022-03-10,Tulare,107,460477,106181,103994,28396,132390,1358
2022-03-10,Tuolumne,109,53932,12599,12476,568,13044,180
2022-03-10,Ventura,111,848112,172384,171932,9413,181345,1442
2022-03-10,Yolo,113,214977,36717,35982,3187,39169,308
2022-03-10,Yuba,115,75493,15750,15722,1196,16918,116
2022-03-09,Alameda,001,1643700,253821,252893,13665,266558,1781
2022-03-09,Alpine,003,1148,122,125,1,126,0
2022-03-09,Amador,005,37829,8479,8409,650,9059,84
2022-03-09,Butte,007,227075,32835,32767,6663,39430,380
2022-03-09,Calaveras,009,45235,7226,7249,350,7599,117
2022-03-09,Colusa,011,21464,3432,3439,1070,4509,21
2022-03-09,Contra Costa,013,1133247,187150,186483,13100,199583,1256
2022-03-09,Del Norte,015,27424,5736,5765,190,5955,48
2022-03-09,El Dorado,017,186661,26583,26515,3232,29747,198
2022-03-09,Fresno,019,978130,230337,227885,23858,251743,2653
2022-03-09,Glenn,021,27897,4957,4953,1596,6549,44
2022-03-09,Humboldt,023,135768,16782,16854,2940,19794,137
2022-03-09,Imperial,025,180216,55206,54764,10772,65536,894
2022-03-09,Inyo,027,18085,4060,4056,480,4536,56
2022-03-09,Kern,029,883053,191224,190254,46145,236399,2159
2022-03-09,Kings,031,150075,51249,51122,3611,54733,435
2022-03-09,Lake,033,64148,10632,10586,891,11477,130
2022-03-09,Lassen,035,31185,8942,8901,884,9785,62
2022-03-09,Los Angeles,037,10098052,2696847,2677901,123433,2801334,30842
2022-03-09,Madera,039,155013,37175,37207,6082,43289,354
2022-03-09,Marin,041,260295,33091,32967,2187,35154,272
2022-03-09,Mariposa,043,17540,2377,2372,200,2572,6
2022-03-09,Mendocino,045,87422,12973,12957,3006,15963,117
2022-03-09,Merced,047,269075,61909,61792,8604,70396,792
2022-03-09,Modoc,049,8938,731,730,249,979,7
2022-03-09,Mono,051,14174,2961,2962,120,3082,5
2022-03-09,Monterey,053,433212,78940,78258,13606,91864,716
2022-03-09,Napa,055,140530,25602,25561,949,26510,138
2022-03-09,Nevada,057,99092,15870,15938,1204,17142,123
2022-03-09,Orange,059,3164182,544181,542278,41258,583536,6700
2022-03-09,Placer,061,380077,62398,62242,7361,69603,598
2022-03-09,Plumas,063,18699,2959,2708,364,3072,13
2022-03-09,Riverside,065,2383286,589371,587833,27988,615821,6305
2022-03-09,Sacramento,067,1510023,279343,274373,27068,301441,2877
2022-03-09,San Benito,069,59416,12838,12864,510,13374,95
2022-03-09,San Bernardino,071,2135413,566823,558795,24981,583776,6723
2022-03-09,San Diego,073,3302833,746650,743956,52082,796038,5083
2022-03-09,San Francisco,075,870044,122599,123676,8202,131878,812
2022-03-09,San Joaquin,077,732212,165661,165444,9974,175418,2113
2022-03-09,San Luis Obispo,079,281455,52118,51923,3755,55678,457
2022-03-09,San Mateo,081,765935,120395,119194,6939,126133,639
2022-03-09,Santa Barbara,083,443738,85275,85382,4748,90130,661
2022-03-09,Santa Clara,085,1922200,307896,308765,12324,321089,2206
2022-03-09,Santa Cruz,087,273765,47263,46917,2109,49026,254
2022-03-09,Shasta,089,179085,30408,30407,6115,36522,493
2022-03-09,Sierra,091,2930,271,273,48,321,4
2022-03-09,Siskiyou,093,43540,4423,4403,2739,7142,75
2022-03-09,Solano,095,438530,80870,80984,5555,86539,436
2022-03-09,Sonoma,097,501317,82848,82574,2574,85148,473
2022-03-09,Stanislaus,099,539301,116960,117827,17602,135429,1541
2022-03-09,Sutter,101,95872,20393,20409,2068,22477,217
2022-03-09,Tehama,103,63373,12001,11980,2611,14591,159
2022-03-09,Trinity,105,12862,1181,1174,295,1469,20
2022-03-09,Tulare,107,460477,106153,103932,28381,132313,1350
2022-03-09,Tuolumne,109,53932,12597,12444,568,13012,180
2022-03-09,Ventura,111,848112,172334,171852,9410,181262,1448
2022-03-09,Yolo,113,214977,36698,35973,3172,39145,308
2022-03-09,Yuba,115,75493,15745,15714,1195,16909,115
2022-03-08,Alameda,001,1643700,253667,252744,13653,266397,1769
2022-03-08,Alpine,003,1148,122,125,1,126,0
2022-03-08,Amador,005,37829,8465,8407,650,9057,84
2022-03-08,Butte,007,227075,32822,32759,6658,39417,380
2022-03-08,Calaveras,009,45235,7222,7245,350,7595,117
2022-03-08,Colusa,011,21464,3429,3439,1069,4508,21
2022-03-08,Contra Costa,013,1133247,187064,186396,13086,199482,1256
2022-03-08,Del Norte,015,27424,5731,5763,190,5953,48
2022-03-08,El Dorado,017,186661,26573,26503,3225,29728,197
2022-03-08,Fresno,019,978130,230238,227808,23849,251657,2653
2022-03-08,Glenn,021,27897,4956,4944,1595,6539,43
2022-03-08,Humboldt,023,135768,16770,16837,2927,19764,137
2022-03-08,Imperial,025,180216,55191,54721,10770,65491,890
2022-03-08,Inyo,027,18085,4057,4056,480,4536,56
2022-03-08,Kern,029,883053,191160,190208,46130,236338,2154
2022-03-08,Kings,031,150075,51207,51089,3608,54697,434
2022-03-08,Lake,033,64148,10622,10571,891,11462,130
2022-03-08,Lassen,035,31185,8941,8897,884,9781,62
2022-03-08,Los Angeles,037,10098052,2696153,2677166,123394,2800560,30803
2022-03-08,Madera,039,155013,37165,37185,6081,43266,354
2022-03-08,Marin,041,260295,33054,32943,2186,35129,272
2022-03-08,Mariposa,043,17540,2375,2371,200,2571,6
2022-03-08,Mendocino,045,87422,12969,12950,3005,15955,117
2022-03-08,Merced,047,269075,61889,61767,8593,70360,791
2022-03-08,Modoc,049,8938,730,729,249,978,7
2022-03-08,Mono,051,14174,2960,2961,120,3081,5
2022-03-08,Monterey,053,433212,78920,78247,13567,91814,711
2022-03-08,Napa,055,140530,25576,25528,948,26476,137
2022-03-08,Nevada,057,99092,15859,15939,1203,17142,122
2022-03-08,Orange,059,3164182,544031,542164,41237,583401,6692
2022-03-08,Placer,061,380077,62371,62221,7360,69581,594
2022-03-08,Plumas,063,18699,2959,2703,364,3067,13
2022-03-08,Riverside,065,2383286,589261,587686,27980,615666,6294
2022-03-08,Sacramento,067,1510023,279249,274276,27049,301325,2872
2022-03-08,San Benito,069,59416,12836,12855,510,13365,94
2022-03-08,San Bernardino,071,2135413,566730,558512,24971,583483,6715
2022-03-08,San Diego,073,3302833,746305,743604,52065,795669,5077
2022-03-08,San Francisco,075,870044,122510,123675,8197,131872,807
2022-03-08,San Joaquin,077,732212,165626,165381,9970,175351,2104
2022-03-08,San Luis Obispo,079,281455,52092,51900,3752,55652,451
2022-03-08,San Mateo,081,765935,120314,119103,6929,126032,638
2022-03-08,Santa Barbara,083,443738,85243,85363,4748,90111,659
2022-03-08,Santa Clara,085,1922200,307687,308528,12315,320843,2206
2022-03-08,Santa Cruz,087,273765,47227,46875,2108,48983,254
2022-03-08,Shasta,089,179085,30389,30372,6112,36484,493
2022-03-08,Sierra,091,2930,271,273,48,321,4
2022-03-08,Siskiyou,093,43540,4419,4404,2739,7143,74
2022-03-08,Solano,095,438530,80842,80924,5551,86475,434
2022-03-08,Sonoma,097,501317,82800,82571,2573,85144,473
2022-03-08,Stanislaus,099,539301,116916,117782,17593,135375,1541
2022-03-08,Sutter,101,95872,20385,20403,2068,22471,217
2022-03-08,Tehama,103,63373,11997,11972,2610,14582,158
2022-03-08,Trinity,105,12862,1181,1174,295,1469,20
2022-03-08,Tulare,107,460477,106114,103893,28369,132262,1334
2022-03-08,Tuolumne,109,53932,12592,12427,566,12993,180
2022-03-08,Ventura,111,848112,172270,171806,9403,181209,1447
2022-03-08,Yolo,113,214977,36672,35946,3171,39117,306
2022-03-08,Yuba,115,75493,15739,15705,1194,16899,115
2022-03-07,Alameda,001,1643700,253463,252578,13638,266216,1766
2022-03-07,Alpine,003,1148,122,125,1,126,0
2022-03-07,Amador,005,37829,8462,8368,650,9018,84
2022-03-07,Butte,007,227075,32807,32734,6655,39389,378
2022-03-07,Calaveras,009,45235,7218,7242,350,7592,116
2022-03-07,Colusa,011,21464,3427,3437,1069,4506,21
2022-03-07,Contra Costa,013,1133247,186965,186087,13062,199149,1256
2022-03-07,Del Norte,015,27424,5727,5758,190,5948,48
2022-03-07,El Dorado,017,186661,26567,26487,3224,29711,196
2022-03-07,Fresno,019,978130,230148,227670,23825,251495,2653
2022-03-07,Glenn,021,27897,4950,4939,1595,6534,43
2022-03-07,Humboldt,023,135768,16757,16829,2922,19751,137
2022-03-07,Imperial,025,180216,55169,54712,10765,65477,890
2022-03-07,Inyo,027,18085,4055,4054,480,4534,56
2022-03-07,Kern,029,883053,191102,190163,46105,236268,2152
2022-03-07,Kings,031,150075,51177,51065,3602,54667,433
2022-03-07,Lake,033,64148,10610,10562,890,11452,130
2022-03-07,Lassen,035,31185,8940,8896,884,9780,62
2022-03-07,Los Angeles,037,10098052,2695341,2675497,123354,2798851,30759
2022-03-07,Madera,039,155013,37155,37164,6078,43242,354
2022-03-07,Marin,041,260295,33016,32919,2183,35102,272
2022-03-07,Mariposa,043,17540,2374,2369,200,2569,6
2022-03-07,Mendocino,045,87422,12962,12940,3004,15944,117
2022-03-07,Merced,047,269075,61849,61751,8586,70337,791
2022-03-07,Modoc,049,8938,730,729,249,978,7
2022-03-07,Mono,051,14174,2960,2960,120,3080,5
2022-03-07,Monterey,053,433212,78886,78161,13518,91679,706
2022-03-07,Napa,055,140530,25546,25500,948,26448,136
2022-03-07,Nevada,057,99092,15852,15935,1197,17132,122
2022-03-07,Orange,059,3164182,543856,542028,41211,583239,6687
2022-03-07,Placer,061,380077,62342,62215,7358,69573,591
2022-03-07,Plumas,063,18699,2959,2702,364,3066,13
2022-03-07,Riverside,065,2383286,589130,587537,27972,615509,6279
2022-03-07,Sacramento,067,1510023,279148,274079,27036,301115,2866
2022-03-07,San Benito,069,59416,12830,12843,510,13353,94
2022-03-07,San Bernardino,071,2135413,566626,558265,24959,583224,6703
2022-03-07,San Diego,073,3302833,745963,742287,52022,794309,5068
2022-03-07,San Francisco,075,870044,122407,123655,8191,131846,807
2022-03-07,San Joaquin,077,732212,165575,165343,9962,175305,2091
2022-03-07,San Luis Obispo,079,281455,52050,51874,3747,55621,448
2022-03-07,San Mateo,081,765935,120238,119035,6922,125957,630
2022-03-07,Santa Barbara,083,443738,85205,85345,4747,90092,659
2022-03-07,Santa Clara,085,1922200,307500,308517,12309,320826,2202
2022-03-07,Santa Cruz,087,273765,47177,46823,2107,48930,254
2022-03-07,Shasta,089,179085,30376,30352,6109,36461,493
2022-03-07,Sierra,091,2930,271,273,48,321,4
2022-03-07,Siskiyou,093,43540,4415,4398,2738,7136,74
2022-03-07,Solano,095,438530,80785,80886,5549,86435,435
2022-03-07,Sonoma,097,501317,82757,82530,2572,85102,473
2022-03-07,Stanislaus,099,539301,116877,117713,17585,135298,1537
2022-03-07,Sutter,101,95872,20374,20400,2067,22467,217
2022-03-07,Tehama,103,63373,11991,11966,2607,14573,158
2022-03-07,Trinity,105,12862,1179,1173,295,1468,20
2022-03-07,Tulare,107,460477,106077,103834,28359,132193,1316
2022-03-07,Tuolumne,109,53932,12586,12408,565,12973,179
2022-03-07,Ventura,111,848112,172219,171886,9401,181287,1436
2022-03-07,Yolo,113,214977,36649,35934,3165,39099,306
2022-03-07,Yuba,115,75493,15732,15701,1193,16894,115
2022-03-06,Alameda,001,1643700,253276,252460,13629,266089,1766
2022-03-06,Alpine,003,1148,122,125,1,126,0
2022-03-06,Amador,005,37829,8459,8367,648,9015,84
2022-03-06,Butte,007,227075,32797,32714,6651,39365,376
2022-03-06,Calaveras,009,45235,7216,7236,349,7585,116
2022-03-06,Colusa,011,21464,3427,3435,1068,4503,21
2022-03-06,Contra Costa,013,1133247,186851,185974,13037,199011,1256
2022-03-06,Del Norte,015,27424,5711,5744,188,5932,48
2022-03-06,El Dorado,017,186661,26558,26478,3222,29700,196
2022-03-06,Fresno,019,978130,230005,227514,23814,251328,2653
2022-03-06,Glenn,021,27897,4946,4939,1595,6534,43
2022-03-06,Humboldt,023,135768,16746,16813,2919,19732,137
2022-03-06,Imperial,025,180216,55151,54719,10753,65472,890
2022-03-06,Inyo,027,18085,4053,4053,480,4533,56
2022-03-06,Kern,029,883053,191047,190088,46083,236171,2152
2022-03-06,Kings,031,150075,51108,51050,3599,54649,432
2022-03-06,Lake,033,64148,10596,10539,889,11428,130
2022-03-06,Lassen,035,31185,8927,8887,883,9770,62
2022-03-06,Los Angeles,037,10098052,2694408,2675456,123297,2798753,30759
2022-03-06,Madera,039,155013,37125,37135,6070,43205,354
2022-03-06,Marin,041,260295,32990,32879,2182,35061,272
2022-03-06,Mariposa,043,17540,2373,2365,199,2564,6
2022-03-06,Mendocino,045,87422,12950,12923,3000,15923,116
2022-03-06,Merced,047,269075,61817,61722,8569,70291,791
2022-03-06,Modoc,049,8938,730,729,249,978,7
2022-03-06,Mono,051,14174,2960,2959,120,3079,5
2022-03-06,Monterey,053,433212,78840,78154,13486,91640,706
2022-03-06,Napa,055,140530,25511,25457,946,26403,136
2022-03-06,Nevada,057,99092,15841,15924,1196,17120,122
2022-03-06,Orange,059,3164182,543697,541903,41163,583066,6688
2022-03-06,Placer,061,380077,62309,62185,7354,69539,591
2022-03-06,Plumas,063,18699,2954,2704,364,3068,13
2022-03-06,Riverside,065,2383286,588968,587388,27951,615339,6279
2022-03-06,Sacramento,067,1510023,279013,273935,27012,300947,2869
2022-03-06,San Benito,069,59416,12819,12835,509,13344,94
2022-03-06,San Bernardino,071,2135413,566503,558139,24945,583084,6701
2022-03-06,San Diego,073,3302833,745568,742287,51973,794260,5068
2022-03-06,San Francisco,075,870044,122286,123742,8188,131930,806
2022-03-06,San Joaquin,077,732212,165493,165252,9956,175208,2091
2022-03-06,San Luis Obispo,079,281455,52012,51828,3744,55572,448
2022-03-06,San Mateo,081,765935,120155,118916,6913,125829,630
2022-03-06,Santa Barbara,083,443738,85165,85317,4742,90059,659
2022-03-06,Santa Clara,085,1922200,307241,308250,12307,320557,2201
2022-03-06,Santa Cruz,087,273765,47126,46755,2106,48861,254
2022-03-06,Shasta,089,179085,30353,30332,6092,36424,493
2022-03-06,Sierra,091,2930,271,273,48,321,4
2022-03-06,Siskiyou,093,43540,4411,4398,2736,7134,74
2022-03-06,Solano,095,438530,80729,80833,5543,86376,435
2022-03-06,Sonoma,097,501317,82722,82458,2567,85025,473
2022-03-06,Stanislaus,099,539301,116831,117680,17575,135255,1536
2022-03-06,Sutter,101,95872,20363,20390,2063,22453,217
2022-03-06,Tehama,103,63373,11983,11963,2607,14570,158
2022-03-06,Trinity,105,12862,1179,1172,294,1466,20
2022-03-06,Tulare,107,460477,106019,103794,28344,132138,1316
2022-03-06,Tuolumne,109,53932,12580,12379,563,12942,179
2022-03-06,Ventura,111,848112,172150,171819,9399,181218,1436
2022-03-06,Yolo,113,214977,36623,35882,3161,39043,306
2022-03-06,Yuba,115,75493,15728,15694,1192,16886,115
2022-03-05,Alameda,001,1643700,253161,251988,13624,265612,1760
2022-03-05,Alpine,003,1148,122,125,1,126,0
2022-03-05,Amador,005,37829,8456,8344,648,8992,83
2022-03-05,Butte,007,227075,32790,32663,6646,39309,372
2022-03-05,Calaveras,009,45235,7213,7236,349,7585,116
2022-03-05,Colusa,011,21464,3427,3433,1068,4501,21
2022-03-05,Contra Costa,013,1133247,186788,185734,13031,198765,1235
2022-03-05,Del Norte,015,27424,5708,5725,188,5913,48
2022-03-05,El Dorado,017,186661,26552,26446,3219,29665,193
2022-03-05,Fresno,019,978130,229953,227154,23812,250966,2640
2022-03-05,Glenn,021,27897,4944,4927,1595,6522,43
2022-03-05,Humboldt,023,135768,16740,16781,2917,19698,136
2022-03-05,Imperial,025,180216,55141,54650,10751,65401,880
2022-03-05,Inyo,027,18085,4052,4043,479,4522,56
2022-03-05,Kern,029,883053,191015,189817,46065,235882,2141
2022-03-05,Kings,031,150075,51101,50926,3597,54523,431
2022-03-05,Lake,033,64148,10588,10512,888,11400,130
2022-03-05,Lassen,035,31185,8918,8818,883,9701,62
2022-03-05,Los Angeles,037,10098052,2694051,2671564,123260,2794824,30608
2022-03-05,Madera,039,155013,37110,37100,6070,43170,354
2022-03-05,Marin,041,260295,32978,32829,2182,35011,272
2022-03-05,Mariposa,043,17540,2373,2363,199,2562,6
2022-03-05,Mendocino,045,87422,12947,12845,2999,15844,113
2022-03-05,Merced,047,269075,61807,61653,8569,70222,789
2022-03-05,Modoc,049,8938,730,729,249,978,7
2022-03-05,Mono,051,14174,2960,2961,120,3081,5
2022-03-05,Monterey,053,433212,78821,78028,13479,91507,704
2022-03-05,Napa,055,140530,25493,25405,946,26351,134
2022-03-05,Nevada,057,99092,15837,15907,1196,17103,122
2022-03-05,Orange,059,3164182,543572,541463,41152,582615,6638
2022-03-05,Placer,061,380077,62295,62117,7347,69464,591
2022-03-05,Plumas,063,18699,2953,2701,364,3065,13
2022-03-05,Riverside,065,2383286,588877,586785,27947,614732,6239
2022-03-05,Sacramento,067,1510023,278949,273487,27007,300494,2847
2022-03-05,San Benito,069,59416,12817,12820,509,13329,94
2022-03-05,San Bernardino,071,2135413,566445,557421,24939,582360,6641
2022-03-05,San Diego,073,3302833,745378,740747,51962,792709,5045
2022-03-05,San Francisco,075,870044,122222,123537,8183,131720,798
2022-03-05,San Joaquin,077,732212,165452,165085,9947,175032,2069
2022-03-05,San Luis Obispo,079,281455,52004,51739,3742,55481,446
2022-03-05,San Mateo,081,765935,120100,118646,6910,125556,621
2022-03-05,Santa Barbara,083,443738,85150,85249,4742,89991,655
2022-03-05,Santa Clara,085,1922200,307124,307689,12304,319993,2195
2022-03-05,Santa Cruz,087,273765,47106,46622,2106,48728,253
2022-03-05,Shasta,089,179085,30341,30282,6091,36373,492
2022-03-05,Sierra,091,2930,271,273,47,320,4
2022-03-05,Siskiyou,093,43540,4410,4389,2735,7124,74
2022-03-05,Solano,095,438530,80712,80690,5543,86233,435
2022-03-05,Sonoma,097,501317,82700,82313,2567,84880,473
2022-03-05,Stanislaus,099,539301,116805,117501,17572,135073,1531
2022-03-05,Sutter,101,95872,20355,20346,2063,22409,217
2022-03-05,Tehama,103,63373,11981,11939,2607,14546,158
2022-03-05,Trinity,105,12862,1179,1170,292,1462,20
2022-03-05,Tulare,107,460477,106006,103534,28335,131869,1305
2022-03-05,Tuolumne,109,53932,12576,12325,562,12887,178
2022-03-05,Ventura,111,848112,172109,171666,9397,181063,1436
2022-03-05,Yolo,113,214977,36609,35856,3161,39017,306
2022-03-05,Yuba,115,75493,15720,15666,1192,16858,115
2022-03-04,Alameda,001,1643700,253066,251988,13616,265604,1760
2022-03-04,Alpine,003,1148,122,125,1,126,0
2022-03-04,Amador,005,37829,8455,8344,648,8992,83
2022-03-04,Butte,007,227075,32784,32663,6640,39303,372
2022-03-04,Calaveras,009,45235,7212,7236,349,7585,116
2022-03-04,Colusa,011,21464,3425,3433,1068,4501,21
2022-03-04,Contra Costa,013,1133247,186720,185734,13028,198762,1235
2022-03-04,Del Norte,015,27424,5698,5725,188,5913,48
2022-03-04,El Dorado,017,186661,26548,26446,3219,29665,193
2022-03-04,Fresno,019,978130,229890,227154,23805,250959,2640
2022-03-04,Glenn,021,27897,4943,4927,1595,6522,43
2022-03-04,Humboldt,023,135768,16736,16781,2917,19698,136
2022-03-04,Imperial,025,180216,55134,54650,10747,65397,880
2022-03-04,Inyo,027,18085,4052,4043,479,4522,56
2022-03-04,Kern,029,883053,190974,189817,46053,235870,2141
2022-03-04,Kings,031,150075,51088,50926,3597,54523,431
2022-03-04,Lake,033,64148,10587,10512,888,11400,130
2022-03-04,Lassen,035,31185,8916,8818,883,9701,62
2022-03-04,Los Angeles,037,10098052,2693526,2671564,123230,2794794,30608
2022-03-04,Madera,039,155013,37101,37100,6070,43170,354
2022-03-04,Marin,041,260295,32956,32829,2180,35009,272
2022-03-04,Mariposa,043,17540,2368,2363,199,2562,6
2022-03-04,Mendocino,045,87422,12941,12845,2999,15844,113
2022-03-04,Merced,047,269075,61795,61653,8567,70220,789
2022-03-04,Modoc,049,8938,730,729,249,978,7
2022-03-04,Mono,051,14174,2960,2961,120,3081,5
2022-03-04,Monterey,053,433212,78801,78028,13472,91500,704
2022-03-04,Napa,055,140530,25478,25405,945,26350,134
2022-03-04,Nevada,057,99092,15832,15907,1196,17103,122
2022-03-04,Orange,059,3164182,543453,541463,41133,582596,6638
2022-03-04,Placer,061,380077,62282,62117,7344,69461,591
2022-03-04,Plumas,063,18699,2953,2701,363,3064,13
2022-03-04,Riverside,065,2383286,588790,586785,27946,614731,6239
2022-03-04,Sacramento,067,1510023,278876,273487,27003,300490,2847
2022-03-04,San Benito,069,59416,12813,12820,509,13329,94
2022-03-04,San Bernardino,071,2135413,566362,557421,24938,582359,6641
2022-03-04,San Diego,073,3302833,745139,740747,51945,792692,5045
2022-03-04,San Francisco,075,870044,122162,123537,8176,131713,798
2022-03-04,San Joaquin,077,732212,165420,165085,9946,175031,2069
2022-03-04,San Luis Obispo,079,281455,51996,51739,3741,55480,446
2022-03-04,San Mateo,081,765935,120042,118646,6908,125554,621
2022-03-04,Santa Barbara,083,443738,85128,85249,4742,89991,655
2022-03-04,Santa Clara,085,1922200,306974,307689,12301,319990,2195
2022-03-04,Santa Cruz,087,273765,47083,46622,2106,48728,253
2022-03-04,Shasta,089,179085,30333,30282,6088,36370,492
2022-03-04,Sierra,091,2930,271,273,47,320,4
2022-03-04,Siskiyou,093,43540,4408,4389,2731,7120,74
2022-03-04,Solano,095,438530,80679,80690,5540,86230,435
2022-03-04,Sonoma,097,501317,82669,82313,2566,84879,473
2022-03-04,Stanislaus,099,539301,116786,117501,17570,135071,1531
2022-03-04,Sutter,101,95872,20351,20346,2063,22409,217
2022-03-04,Tehama,103,63373,11978,11939,2607,14546,158
2022-03-04,Trinity,105,12862,1179,1170,292,1462,20
2022-03-04,Tulare,107,460477,105987,103534,28330,131864,1305
2022-03-04,Tuolumne,109,53932,12571,12325,562,12887,178
2022-03-04,Ventura,111,848112,172062,171666,9394,181060,1436
2022-03-04,Yolo,113,214977,36592,35856,3161,39017,306
2022-03-04,Yuba,115,75493,15715,15666,1191,16857,115
2022-03-03,Alameda,001,1643700,252947,251988,13604,265592,1760
2022-03-03,Alpine,003,1148,122,125,1,126,0
2022-03-03,Amador,005,37829,8454,8344,648,8992,83
2022-03-03,Butte,007,227075,32767,32663,6634,39297,372
2022-03-03,Calaveras,009,45235,7200,7236,349,7585,116
2022-03-03,Colusa,011,21464,3425,3433,1068,4501,21
2022-03-03,Contra Costa,013,1133247,186645,185734,13013,198747,1235
2022-03-03,Del Norte,015,27424,5691,5725,188,5913,48
2022-03-03,El Dorado,017,186661,26530,26446,3218,29664,193
2022-03-03,Fresno,019,978130,229763,227154,23797,250951,2640
2022-03-03,Glenn,021,27897,4941,4927,1594,6521,43
2022-03-03,Humboldt,023,135768,16721,16781,2916,19697,136
2022-03-03,Imperial,025,180216,55118,54650,10745,65395,880
2022-03-03,Inyo,027,18085,4051,4043,479,4522,56
2022-03-03,Kern,029,883053,190906,189817,46034,235851,2141
2022-03-03,Kings,031,150075,51065,50926,3594,54520,431
2022-03-03,Lake,033,64148,10582,10512,886,11398,130
2022-03-03,Lassen,035,31185,8908,8818,883,9701,62
2022-03-03,Los Angeles,037,10098052,2692801,2671564,123189,2794753,30608
2022-03-03,Madera,039,155013,37085,37100,6065,43165,354
2022-03-03,Marin,041,260295,32930,32829,2179,35008,272
2022-03-03,Mariposa,043,17540,2367,2363,199,2562,6
2022-03-03,Mendocino,045,87422,12930,12845,2996,15841,113
2022-03-03,Merced,047,269075,61776,61653,8561,70214,789
2022-03-03,Modoc,049,8938,730,729,249,978,7
2022-03-03,Mono,051,14174,2959,2961,120,3081,5
2022-03-03,Monterey,053,433212,78771,78028,13454,91482,704
2022-03-03,Napa,055,140530,25454,25405,944,26349,134
2022-03-03,Nevada,057,99092,15827,15907,1191,17098,122
2022-03-03,Orange,059,3164182,543276,541463,41107,582570,6638
2022-03-03,Placer,061,380077,62260,62117,7340,69457,591
2022-03-03,Plumas,063,18699,2952,2701,363,3064,13
2022-03-03,Riverside,065,2383286,588656,586785,27941,614726,6239
2022-03-03,Sacramento,067,1510023,278769,273487,26985,300472,2847
2022-03-03,San Benito,069,59416,12810,12820,509,13329,94
2022-03-03,San Bernardino,071,2135413,566256,557421,24932,582353,6641
2022-03-03,San Diego,073,3302833,744796,740747,51927,792674,5045
2022-03-03,San Francisco,075,870044,122089,123537,8165,131702,798
2022-03-03,San Joaquin,077,732212,165346,165085,9943,175028,2069
2022-03-03,San Luis Obispo,079,281455,51941,51739,3733,55472,446
2022-03-03,San Mateo,081,765935,119967,118646,6898,125544,621
2022-03-03,Santa Barbara,083,443738,85109,85249,4733,89982,655
2022-03-03,Santa Clara,085,1922200,306792,307689,12286,319975,2195
2022-03-03,Santa Cruz,087,273765,47035,46622,2104,48726,253
2022-03-03,Shasta,089,179085,30315,30282,6084,36366,492
2022-03-03,Sierra,091,2930,271,273,47,320,4
2022-03-03,Siskiyou,093,43540,4405,4389,2731,7120,74
2022-03-03,Solano,095,438530,80630,80690,5538,86228,435
2022-03-03,Sonoma,097,501317,82623,82313,2561,84874,473
2022-03-03,Stanislaus,099,539301,116753,117501,17562,135063,1531
2022-03-03,Sutter,101,95872,20343,20346,2063,22409,217
2022-03-03,Tehama,103,63373,11975,11939,2607,14546,158
2022-03-03,Trinity,105,12862,1178,1170,292,1462,20
2022-03-03,Tulare,107,460477,105944,103534,28320,131854,1305
2022-03-03,Tuolumne,109,53932,12560,12325,562,12887,178
2022-03-03,Ventura,111,848112,172009,171666,9392,181058,1436
2022-03-03,Yolo,113,214977,36568,35856,3154,39010,306
2022-03-03,Yuba,115,75493,15709,15666,1186,16852,115
2022-03-02,Alameda,001,1643700,252769,251886,13587,265473,1759
2022-03-02,Alpine,003,1148,122,125,1,126,0
2022-03-02,Amador,005,37829,8442,8341,648,8989,83
2022-03-02,Butte,007,227075,32755,32636,6629,39265,372
2022-03-02,Calaveras,009,45235,7199,7225,349,7574,116
2022-03-02,Colusa,011,21464,3422,3428,1068,4496,21
2022-03-02,Contra Costa,013,1133247,186552,185589,12994,198583,1236
2022-03-02,Del Norte,015,27424,5684,5708,186,5894,47
2022-03-02,El Dorado,017,186661,26519,26433,3215,29648,192
2022-03-02,Fresno,019,978130,229631,226932,23786,250718,2629
2022-03-02,Glenn,021,27897,4941,4922,1593,6515,43
2022-03-02,Humboldt,023,135768,16711,16747,2909,19656,135
2022-03-02,Imperial,025,180216,55092,54629,10740,65369,878
2022-03-02,Inyo,027,18085,4049,4041,478,4519,56
2022-03-02,Kern,029,883053,190840,189656,46014,235670,2136
2022-03-02,Kings,031,150075,51039,50819,3591,54410,431
2022-03-02,Lake,033,64148,10569,10495,884,11379,130
2022-03-02,Lassen,035,31185,8905,8811,882,9693,62
2022-03-02,Los Angeles,037,10098052,2691920,2670287,123142,2793429,30535
2022-03-02,Madera,039,155013,37068,37077,6063,43140,354
2022-03-02,Marin,041,260295,32912,32794,2178,34972,272
2022-03-02,Mariposa,043,17540,2367,2359,199,2558,6
2022-03-02,Mendocino,045,87422,12917,12832,2991,15823,112
2022-03-02,Merced,047,269075,61750,61606,8551,70157,785
2022-03-02,Modoc,049,8938,730,729,249,978,7
2022-03-02,Mono,051,14174,2959,2961,120,3081,5
2022-03-02,Monterey,053,433212,78735,77963,13431,91394,703
2022-03-02,Napa,055,140530,25405,25382,943,26325,134
2022-03-02,Nevada,057,99092,15816,15920,1190,17110,122
2022-03-02,Orange,059,3164182,543070,541230,41080,582310,6623
2022-03-02,Placer,061,380077,62238,62066,7337,69403,589
2022-03-02,Plumas,063,18699,2952,2700,362,3062,13
2022-03-02,Riverside,065,2383286,588506,586513,27930,614443,6229
2022-03-02,Sacramento,067,1510023,278652,273291,26974,300265,2837
2022-03-02,San Benito,069,59416,12799,12814,509,13323,94
2022-03-02,San Bernardino,071,2135413,566147,557082,24926,582008,6619
2022-03-02,San Diego,073,3302833,744436,739803,51879,791682,5034
2022-03-02,San Francisco,075,870044,121994,123442,8163,131605,792
2022-03-02,San Joaquin,077,732212,165287,164968,9938,174906,2063
2022-03-02,San Luis Obispo,079,281455,51903,51686,3728,55414,446
2022-03-02,San Mateo,081,765935,119880,118518,6882,125400,617
2022-03-02,Santa Barbara,083,443738,85084,85183,4732,89915,655
2022-03-02,Santa Clara,085,1922200,306577,307354,12272,319626,2184
2022-03-02,Santa Cruz,087,273765,46965,46534,2103,48637,253
2022-03-02,Shasta,089,179085,30290,30253,6074,36327,490
2022-03-02,Sierra,091,2930,271,273,47,320,4
2022-03-02,Siskiyou,093,43540,4403,4384,2728,7112,74
2022-03-02,Solano,095,438530,80564,80626,5535,86161,433
2022-03-02,Sonoma,097,501317,82577,82208,2557,84765,473
2022-03-02,Stanislaus,099,539301,116717,117411,17536,134947,1519
2022-03-02,Sutter,101,95872,20321,20317,2045,22362,216
2022-03-02,Tehama,103,63373,11970,11930,2606,14536,158
2022-03-02,Trinity,105,12862,1176,1160,292,1452,20
2022-03-02,Tulare,107,460477,105902,103451,28303,131754,1302
2022-03-02,Tuolumne,109,53932,12555,12297,562,12859,179
2022-03-02,Ventura,111,848112,171956,171770,9388,181158,1427
2022-03-02,Yolo,113,214977,36550,35799,3148,38947,305
2022-03-02,Yuba,115,75493,15696,15653,1181,16834,115
2022-03-01,Alameda,001,1643700,252604,251830,13576,265406,1749
2022-03-01,Alpine,003,1148,122,125,1,126,0
2022-03-01,Amador,005,37829,8394,8334,646,8980,83
2022-03-01,Butte,007,227075,32731,32575,6625,39200,372
2022-03-01,Calaveras,009,45235,7196,7223,348,7571,116
2022-03-01,Colusa,011,21464,3421,3423,1068,4491,21
2022-03-01,Contra Costa,013,1133247,186442,185378,12979,198357,1231
2022-03-01,Del Norte,015,27424,5681,5701,184,5885,45
2022-03-01,El Dorado,017,186661,26500,26413,3213,29626,192
2022-03-01,Fresno,019,978130,229491,226594,23773,250367,2628
2022-03-01,Glenn,021,27897,4940,4919,1591,6510,40
2022-03-01,Humboldt,023,135768,16690,16727,2902,19629,135
2022-03-01,Imperial,025,180216,55075,54570,10734,65304,875
2022-03-01,Inyo,027,18085,4045,4041,477,4518,56
2022-03-01,Kern,029,883053,190766,189365,45990,235355,2120
2022-03-01,Kings,031,150075,51017,50763,3587,54350,427
2022-03-01,Lake,033,64148,10558,10471,882,11353,128
2022-03-01,Lassen,035,31185,8901,8801,882,9683,61
2022-03-01,Los Angeles,037,10098052,2690971,2669489,123084,2792573,30486
2022-03-01,Madera,039,155013,37048,37046,6056,43102,354
2022-03-01,Marin,041,260295,32887,32764,2176,34940,272
2022-03-01,Mariposa,043,17540,2366,2357,198,2555,6
2022-03-01,Mendocino,045,87422,12906,12818,2989,15807,112
2022-03-01,Merced,047,269075,61722,61549,8536,70085,781
2022-03-01,Modoc,049,8938,730,729,249,978,7
2022-03-01,Mono,051,14174,2958,2960,120,3080,6
2022-03-01,Monterey,053,433212,78709,77911,13419,91330,696
2022-03-01,Napa,055,140530,25373,25344,943,26287,134
2022-03-01,Nevada,057,99092,15808,15916,1187,17103,121
2022-03-01,Orange,059,3164182,542850,541054,41044,582098,6612
2022-03-01,Placer,061,380077,62210,62021,7331,69352,583
2022-03-01,Plumas,063,18699,2952,2694,362,3056,13
2022-03-01,Riverside,065,2383286,588340,586184,27929,614113,6198
2022-03-01,Sacramento,067,1510023,278521,273089,26960,300049,2831
2022-03-01,San Benito,069,59416,12795,12806,509,13315,94
2022-03-01,San Bernardino,071,2135413,566017,556743,24923,581666,6588
2022-03-01,San Diego,073,3302833,744010,739136,51837,790973,5029
2022-03-01,San Francisco,075,870044,121892,123481,8157,131638,792
2022-03-01,San Joaquin,077,732212,165220,164894,9933,174827,2062
2022-03-01,San Luis Obispo,079,281455,51867,51592,3724,55316,445
2022-03-01,San Mateo,081,765935,119803,118358,6875,125233,613
2022-03-01,Santa Barbara,083,443738,85046,85134,4728,89862,654
2022-03-01,Santa Clara,085,1922200,306326,306978,12260,319238,2190
2022-03-01,Santa Cruz,087,273765,46915,46471,2100,48571,253
2022-03-01,Shasta,089,179085,30261,30227,6071,36298,489
2022-03-01,Sierra,091,2930,271,274,47,321,5
2022-03-01,Siskiyou,093,43540,4399,4384,2723,7107,74
2022-03-01,Solano,095,438530,80502,80556,5532,86088,434
2022-03-01,Sonoma,097,501317,82507,82103,2551,84654,477
2022-03-01,Stanislaus,099,539301,116665,117308,17511,134819,1521
2022-03-01,Sutter,101,95872,20307,20288,2041,22329,217
2022-03-01,Tehama,103,63373,11964,11923,2603,14526,158
2022-03-01,Trinity,105,12862,1175,1159,292,1451,20
2022-03-01,Tulare,107,460477,105820,103371,28283,131654,1302
2022-03-01,Tuolumne,109,53932,12548,12276,560,12836,175
2022-03-01,Ventura,111,848112,171886,171672,9381,181053,1427
2022-03-01,Yolo,113,214977,36525,35801,3142,38943,299
2022-03-01,Yuba,115,75493,15688,15637,1181,16818,116
2022-02-28,Alameda,001,1643700,252386,251714,13561,265275,1742
2022-02-28,Alpine,003,1148,122,125,1,126,0
2022-02-28,Amador,005,37829,8388,8308,645,8953,83
2022-02-28,Butte,007,227075,32708,32550,6620,39170,368
2022-02-28,Calaveras,009,45235,7193,7220,347,7567,110
2022-02-28,Colusa,011,21464,3418,3422,1066,4488,21
2022-02-28,Contra Costa,013,1133247,186335,185272,12959,198231,1231
2022-02-28,Del Norte,015,27424,5677,5699,183,5882,45
2022-02-28,El Dorado,017,186661,26490,26409,3208,29617,191
2022-02-28,Fresno,019,978130,229290,226519,23751,250270,2622
2022-02-28,Glenn,021,27897,4936,4918,1591,6509,40
2022-02-28,Humboldt,023,135768,16675,16717,2898,19615,135
2022-02-28,Imperial,025,180216,55049,54517,10729,65246,875
2022-02-28,Inyo,027,18085,4045,4041,476,4517,56
2022-02-28,Kern,029,883053,190676,189245,45959,235204,2115
2022-02-28,Kings,031,150075,50978,50741,3586,54327,427
2022-02-28,Lake,033,64148,10546,10468,878,11346,128
2022-02-28,Lassen,035,31185,8844,8794,882,9676,55
2022-02-28,Los Angeles,037,10098052,2689798,2666804,122988,2789792,30410
2022-02-28,Madera,039,155013,37021,37023,6040,43063,354
2022-02-28,Marin,041,260295,32862,32775,2176,34951,272
2022-02-28,Mariposa,043,17540,2363,2354,196,2550,6
2022-02-28,Mendocino,045,87422,12897,12800,2981,15781,112
2022-02-28,Merced,047,269075,61678,61519,8518,70037,781
2022-02-28,Modoc,049,8938,730,727,249,976,7
2022-02-28,Mono,051,14174,2958,2961,120,3081,5
2022-02-28,Monterey,053,433212,78642,77865,13396,91261,693
2022-02-28,Napa,055,140530,25346,25317,943,26260,129
2022-02-28,Nevada,057,99092,15802,15908,1181,17089,121
2022-02-28,Orange,059,3164182,542597,540839,41030,581869,6605
2022-02-28,Placer,061,380077,62178,61976,7325,69301,577
2022-02-28,Plumas,063,18699,2952,2691,361,3052,13
2022-02-28,Riverside,065,2383286,588144,585891,27896,613787,6179
2022-02-28,Sacramento,067,1510023,278383,273038,26935,299973,2825
2022-02-28,San Benito,069,59416,12791,12798,509,13307,94
2022-02-28,San Bernardino,071,2135413,565829,556540,24909,581449,6576
2022-02-28,San Diego,073,3302833,743622,737760,51807,789567,5018
2022-02-28,San Francisco,075,870044,121732,123402,8149,131551,792
2022-02-28,San Joaquin,077,732212,165134,164833,9923,174756,2060
2022-02-28,San Luis Obispo,079,281455,51808,51565,3716,55281,440
2022-02-28,San Mateo,081,765935,119703,118301,6869,125170,611
2022-02-28,Santa Barbara,083,443738,85003,85076,4723,89799,653
2022-02-28,Santa Clara,085,1922200,306050,306930,12238,319168,2180
2022-02-28,Santa Cruz,087,273765,46845,46447,2099,48546,253
2022-02-28,Shasta,089,179085,30236,30213,6067,36280,488
2022-02-28,Sierra,091,2930,271,273,47,320,4
2022-02-28,Siskiyou,093,43540,4396,4382,2717,7099,74
2022-02-28,Solano,095,438530,80436,80544,5521,86065,430
2022-02-28,Sonoma,097,501317,82439,82058,2548,84606,477
2022-02-28,Stanislaus,099,539301,116601,117231,17495,134726,1521
2022-02-28,Sutter,101,95872,20294,20285,2038,22323,214
2022-02-28,Tehama,103,63373,11951,11917,2602,14519,158
2022-02-28,Trinity,105,12862,1175,1160,292,1452,20
2022-02-28,Tulare,107,460477,105770,103304,28265,131569,1300
2022-02-28,Tuolumne,109,53932,12538,12247,559,12806,175
2022-02-28,Ventura,111,848112,171802,171614,9380,180994,1423
2022-02-28,Yolo,113,214977,36489,35754,3135,38889,299
2022-02-28,Yuba,115,75493,15673,15625,1180,16805,115
2022-02-27,Alameda,001,1643700,252108,251624,13552,265176,1744
2022-02-27,Alpine,003,1148,122,125,1,126,0
2022-02-27,Amador,005,37829,8384,8305,642,8947,83
2022-02-27,Butte,007,227075,32671,32551,6607,39158,368
2022-02-27,Calaveras,009,45235,7186,7214,347,7561,110
2022-02-27,Colusa,011,21464,3417,3422,1066,4488,21
2022-02-27,Contra Costa,013,1133247,186209,185185,12939,198124,1230
2022-02-27,Del Norte,015,27424,5659,5691,181,5872,45
2022-02-27,El Dorado,017,186661,26472,26410,3206,29616,191
2022-02-27,Fresno,019,978130,229092,226397,23723,250120,2621
2022-02-27,Glenn,021,27897,4934,4915,1591,6506,40
2022-02-27,Humboldt,023,135768,16653,16713,2891,19604,135
2022-02-27,Imperial,025,180216,55001,54509,10711,65220,875
2022-02-27,Inyo,027,18085,4044,4041,472,4513,56
2022-02-27,Kern,029,883053,190557,189219,45919,235138,2115
2022-02-27,Kings,031,150075,50950,50733,3584,54317,428
2022-02-27,Lake,033,64148,10527,10463,878,11341,128
2022-02-27,Lassen,035,31185,8836,8786,882,9668,55
2022-02-27,Los Angeles,037,10098052,2688491,2666789,122905,2789694,30410
2022-02-27,Madera,039,155013,36995,37009,6032,43041,354
2022-02-27,Marin,041,260295,32824,32756,2174,34930,272
2022-02-27,Mariposa,043,17540,2360,2352,196,2548,6
2022-02-27,Mendocino,045,87422,12881,12798,2968,15766,112
2022-02-27,Merced,047,269075,61626,61491,8501,69992,779
2022-02-27,Modoc,049,8938,729,727,249,976,7
2022-02-27,Mono,051,14174,2957,2960,120,3080,5
2022-02-27,Monterey,053,433212,78584,77851,13370,91221,693
2022-02-27,Napa,055,140530,25308,25316,943,26259,129
2022-02-27,Nevada,057,99092,15794,15900,1177,17077,121
2022-02-27,Orange,059,3164182,542350,540659,41000,581659,6605
2022-02-27,Placer,061,380077,62136,61965,7321,69286,577
2022-02-27,Plumas,063,18699,2949,2691,361,3052,13
2022-02-27,Riverside,065,2383286,587902,585833,27870,613703,6179
2022-02-27,Sacramento,067,1510023,278197,272927,26903,299830,2822
2022-02-27,San Benito,069,59416,12784,12798,509,13307,94
2022-02-27,San Bernardino,071,2135413,565645,556457,24899,581356,6572
2022-02-27,San Diego,073,3302833,743149,737760,51762,789522,5018
2022-02-27,San Francisco,075,870044,121609,123327,8138,131465,791
2022-02-27,San Joaquin,077,732212,165030,164814,9919,174733,2060
2022-02-27,San Luis Obispo,079,281455,51716,51564,3709,55273,439
2022-02-27,San Mateo,081,765935,119590,118244,6864,125108,611
2022-02-27,Santa Barbara,083,443738,84965,85050,4719,89769,653
2022-02-27,Santa Clara,085,1922200,305762,306756,12209,318965,2180
2022-02-27,Santa Cruz,087,273765,46785,46411,2098,48509,253
2022-02-27,Shasta,089,179085,30204,30206,6061,36267,488
2022-02-27,Sierra,091,2930,271,273,47,320,4
2022-02-27,Siskiyou,093,43540,4391,4378,2704,7082,74
2022-02-27,Solano,095,438530,80360,80515,5510,86025,430
2022-02-27,Sonoma,097,501317,82357,82041,2542,84583,476
2022-02-27,Stanislaus,099,539301,116534,117200,17476,134676,1522
2022-02-27,Sutter,101,95872,20277,20280,2032,22312,214
2022-02-27,Tehama,103,63373,11938,11915,2601,14516,158
2022-02-27,Trinity,105,12862,1174,1158,292,1450,20
2022-02-27,Tulare,107,460477,105701,103270,28214,131484,1300
2022-02-27,Tuolumne,109,53932,12525,12243,558,12801,175
2022-02-27,Ventura,111,848112,171727,171660,9377,181037,1423
2022-02-27,Yolo,113,214977,36461,35744,3130,38874,299
2022-02-27,Yuba,115,75493,15663,15619,1178,16797,113
2022-02-26,Alameda,001,1643700,252001,250867,13547,264414,1716
2022-02-26,Alpine,003,1148,122,125,1,126,0
2022-02-26,Amador,005,37829,8382,8282,641,8923,83
2022-02-26,Butte,007,227075,32657,32466,6605,39071,368
2022-02-26,Calaveras,009,45235,7185,7192,347,7539,110
2022-02-26,Colusa,011,21464,3417,3414,1066,4480,21
2022-02-26,Contra Costa,013,1133247,186140,184686,12920,197606,1209
2022-02-26,Del Norte,015,27424,5654,5639,181,5820,45
2022-02-26,El Dorado,017,186661,26461,26355,3202,29557,191
2022-02-26,Fresno,019,978130,229002,225679,23723,249402,2597
2022-02-26,Glenn,021,27897,4932,4909,1590,6499,40
2022-02-26,Humboldt,023,135768,16628,16619,2890,19509,133
2022-02-26,Imperial,025,180216,54974,54367,10709,65076,871
2022-02-26,Inyo,027,18085,4043,4034,467,4501,56
2022-02-26,Kern,029,883053,190504,188584,45900,234484,2106
2022-02-26,Kings,031,150075,50937,50579,3584,54163,423
2022-02-26,Lake,033,64148,10522,10383,878,11261,128
2022-02-26,Lassen,035,31185,8835,8761,882,9643,55
2022-02-26,Los Angeles,037,10098052,2687917,2660973,122865,2783838,30202
2022-02-26,Madera,039,155013,36980,36933,6030,42963,330
2022-02-26,Marin,041,260295,32808,32651,2172,34823,267
2022-02-26,Mariposa,043,17540,2359,2332,196,2528,6
2022-02-26,Mendocino,045,87422,12874,12762,2968,15730,111
2022-02-26,Merced,047,269075,61605,61348,8500,69848,775
2022-02-26,Modoc,049,8938,729,726,249,975,7
2022-02-26,Mono,051,14174,2957,2959,119,3078,5
2022-02-26,Monterey,053,433212,78553,77610,13364,90974,692
2022-02-26,Napa,055,140530,25293,25221,942,26163,130
2022-02-26,Nevada,057,99092,15790,15850,1175,17025,121
2022-02-26,Orange,059,3164182,542239,539992,40983,580975,6540
2022-02-26,Placer,061,380077,62117,61803,7318,69121,573
2022-02-26,Plumas,063,18699,2949,2673,361,3034,13
2022-02-26,Riverside,065,2383286,587782,584835,27861,612696,6143
2022-02-26,Sacramento,067,1510023,278103,272339,26890,299229,2793
2022-02-26,San Benito,069,59416,12780,12770,509,13279,92
2022-02-26,San Bernardino,071,2135413,565554,555668,24893,580561,6505
2022-02-26,San Diego,073,3302833,742926,736049,51740,787789,5002
2022-02-26,San Francisco,075,870044,121539,123079,8130,131209,769
2022-02-26,San Joaquin,077,732212,164996,164418,9918,174336,2048
2022-02-26,San Luis Obispo,079,281455,51703,51358,3706,55064,438
2022-02-26,San Mateo,081,765935,119536,117860,6863,124723,603
2022-02-26,Santa Barbara,083,443738,84934,84830,4719,89549,652
2022-02-26,Santa Clara,085,1922200,305613,305895,12206,318101,2166
2022-02-26,Santa Cruz,087,273765,46762,46186,2098,48284,251
2022-02-26,Shasta,089,179085,30195,30108,6055,36163,485
2022-02-26,Sierra,091,2930,271,270,47,317,1
2022-02-26,Siskiyou,093,43540,4391,4359,2702,7061,72
2022-02-26,Solano,095,438530,80326,80225,5507,85732,428
2022-02-26,Sonoma,097,501317,82323,81702,2540,84242,432
2022-02-26,Stanislaus,099,539301,116496,116896,17471,134367,1503
2022-02-26,Sutter,101,95872,20268,20230,2032,22262,214
2022-02-26,Tehama,103,63373,11932,11878,2599,14477,158
2022-02-26,Trinity,105,12862,1173,1156,292,1448,20
2022-02-26,Tulare,107,460477,105665,102983,28199,131182,1295
2022-02-26,Tuolumne,109,53932,12522,12169,558,12727,175
2022-02-26,Ventura,111,848112,171695,171292,9374,180666,1411
2022-02-26,Yolo,113,214977,36440,35615,3127,38742,296
2022-02-26,Yuba,115,75493,15651,15587,1178,16765,113
2022-02-25,Alameda,001,1643700,251878,250867,13537,264404,1716
2022-02-25,Alpine,003,1148,122,125,1,126,0
2022-02-25,Amador,005,37829,8371,8282,641,8923,83
2022-02-25,Butte,007,227075,32645,32466,6602,39068,368
2022-02-25,Calaveras,009,45235,7183,7192,347,7539,110
2022-02-25,Colusa,011,21464,3417,3414,1066,4480,21
2022-02-25,Contra Costa,013,1133247,186056,184686,12898,197584,1209
2022-02-25,Del Norte,015,27424,5645,5639,181,5820,45
2022-02-25,El Dorado,017,186661,26452,26355,3202,29557,191
2022-02-25,Fresno,019,978130,228904,225679,23716,249395,2597
2022-02-25,Glenn,021,27897,4930,4909,1590,6499,40
2022-02-25,Humboldt,023,135768,16617,16619,2890,19509,133
2022-02-25,Imperial,025,180216,54956,54367,10708,65075,871
2022-02-25,Inyo,027,18085,4042,4034,467,4501,56
2022-02-25,Kern,029,883053,190439,188584,45887,234471,2106
2022-02-25,Kings,031,150075,50923,50579,3582,54161,423
2022-02-25,Lake,033,64148,10504,10383,878,11261,128
2022-02-25,Lassen,035,31185,8832,8761,882,9643,55
2022-02-25,Los Angeles,037,10098052,2687328,2660973,122836,2783809,30202
2022-02-25,Madera,039,155013,36960,36933,6029,42962,330
2022-02-25,Marin,041,260295,32794,32651,2172,34823,267
2022-02-25,Mariposa,043,17540,2356,2332,196,2528,6
2022-02-25,Mendocino,045,87422,12872,12762,2968,15730,111
2022-02-25,Merced,047,269075,61574,61348,8495,69843,775
2022-02-25,Modoc,049,8938,729,726,249,975,7
2022-02-25,Mono,051,14174,2956,2959,119,3078,5
2022-02-25,Monterey,053,433212,78525,77610,13358,90968,692
2022-02-25,Napa,055,140530,25284,25221,942,26163,130
2022-02-25,Nevada,057,99092,15779,15850,1172,17022,121
2022-02-25,Orange,059,3164182,542104,539992,40960,580952,6540
2022-02-25,Placer,061,380077,62101,61803,7312,69115,573
2022-02-25,Plumas,063,18699,2947,2673,361,3034,13
2022-02-25,Riverside,065,2383286,587627,584835,27849,612684,6143
2022-02-25,Sacramento,067,1510023,278001,272339,26885,299224,2793
2022-02-25,San Benito,069,59416,12778,12770,509,13279,92
2022-02-25,San Bernardino,071,2135413,565447,555668,24886,580554,6505
2022-02-25,San Diego,073,3302833,742644,736049,51721,787770,5002
2022-02-25,San Francisco,075,870044,121459,123079,8127,131206,769
2022-02-25,San Joaquin,077,732212,164955,164418,9913,174331,2048
2022-02-25,San Luis Obispo,079,281455,51699,51358,3697,55055,438
2022-02-25,San Mateo,081,765935,119474,117860,6859,124719,603
2022-02-25,Santa Barbara,083,443738,84897,84830,4719,89549,652
2022-02-25,Santa Clara,085,1922200,305427,305895,12203,318098,2166
2022-02-25,Santa Cruz,087,273765,46728,46186,2096,48282,251
2022-02-25,Shasta,089,179085,30186,30108,6053,36161,485
2022-02-25,Sierra,091,2930,271,270,47,317,1
2022-02-25,Siskiyou,093,43540,4391,4359,2701,7060,72
2022-02-25,Solano,095,438530,80297,80225,5506,85731,428
2022-02-25,Sonoma,097,501317,82272,81702,2538,84240,432
2022-02-25,Stanislaus,099,539301,116468,116896,17467,134363,1503
2022-02-25,Sutter,101,95872,20259,20230,2032,22262,214
2022-02-25,Tehama,103,63373,11930,11878,2599,14477,158
2022-02-25,Trinity,105,12862,1173,1156,292,1448,20
2022-02-25,Tulare,107,460477,105630,102983,28177,131160,1295
2022-02-25,Tuolumne,109,53932,12519,12169,558,12727,175
2022-02-25,Ventura,111,848112,171644,171292,9373,180665,1411
2022-02-25,Yolo,113,214977,36425,35615,3127,38742,296
2022-02-25,Yuba,115,75493,15644,15587,1178,16765,113
2022-02-24,Alameda,001,1643700,251673,250867,13528,264395,1716
2022-02-24,Alpine,003,1148,122,125,1,126,0
2022-02-24,Amador,005,37829,8366,8282,640,8922,83
2022-02-24,Butte,007,227075,32624,32466,6598,39064,368
2022-02-24,Calaveras,009,45235,7181,7192,345,7537,110
2022-02-24,Colusa,011,21464,3416,3414,1065,4479,21
2022-02-24,Contra Costa,013,1133247,185925,184686,12890,197576,1209
2022-02-24,Del Norte,015,27424,5630,5639,180,5819,45
2022-02-24,El Dorado,017,186661,26437,26355,3202,29557,191
2022-02-24,Fresno,019,978130,228708,225679,23701,249380,2597
2022-02-24,Glenn,021,27897,4928,4909,1589,6498,40
2022-02-24,Humboldt,023,135768,16600,16619,2889,19508,133
2022-02-24,Imperial,025,180216,54916,54367,10698,65065,871
2022-02-24,Inyo,027,18085,4041,4034,466,4500,56
2022-02-24,Kern,029,883053,190298,188584,45853,234437,2106
2022-02-24,Kings,031,150075,50893,50579,3577,54156,423
2022-02-24,Lake,033,64148,10486,10383,878,11261,128
2022-02-24,Lassen,035,31185,8828,8761,881,9642,55
2022-02-24,Los Angeles,037,10098052,2686168,2660973,122780,2783753,30202
2022-02-24,Madera,039,155013,36934,36933,6027,42960,330
2022-02-24,Marin,041,260295,32774,32651,2171,34822,267
2022-02-24,Mariposa,043,17540,2350,2332,195,2527,6
2022-02-24,Mendocino,045,87422,12865,12762,2964,15726,111
2022-02-24,Merced,047,269075,61544,61348,8486,69834,775
2022-02-24,Modoc,049,8938,728,726,249,975,7
2022-02-24,Mono,051,14174,2955,2959,119,3078,5
2022-02-24,Monterey,053,433212,78473,77610,13349,90959,692
2022-02-24,Napa,055,140530,25244,25221,938,26159,130
2022-02-24,Nevada,057,99092,15765,15850,1172,17022,121
2022-02-24,Orange,059,3164182,541854,539992,40926,580918,6540
2022-02-24,Placer,061,380077,62064,61803,7310,69113,573
2022-02-24,Plumas,063,18699,2942,2673,359,3032,13
2022-02-24,Riverside,065,2383286,587375,584835,27822,612657,6143
2022-02-24,Sacramento,067,1510023,277827,272339,26867,299206,2793
2022-02-24,San Benito,069,59416,12767,12770,508,13278,92
2022-02-24,San Bernardino,071,2135413,565255,555668,24873,580541,6505
2022-02-24,San Diego,073,3302833,742231,736049,51674,787723,5002
2022-02-24,San Francisco,075,870044,121337,123079,8120,131199,769
2022-02-24,San Joaquin,077,732212,164826,164418,9908,174326,2048
2022-02-24,San Luis Obispo,079,281455,51653,51358,3695,55053,438
2022-02-24,San Mateo,081,765935,119382,117860,6852,124712,603
2022-02-24,Santa Barbara,083,443738,84832,84830,4718,89548,652
2022-02-24,Santa Clara,085,1922200,305192,305895,12189,318084,2166
2022-02-24,Santa Cruz,087,273765,46647,46186,2094,48280,251
2022-02-24,Shasta,089,179085,30167,30108,6047,36155,485
2022-02-24,Sierra,091,2930,271,270,47,317,1
2022-02-24,Siskiyou,093,43540,4388,4359,2697,7056,72
2022-02-24,Solano,095,438530,80218,80225,5503,85728,428
2022-02-24,Sonoma,097,501317,82218,81702,2533,84235,432
2022-02-24,Stanislaus,099,539301,116392,116896,17458,134354,1503
2022-02-24,Sutter,101,95872,20245,20230,2016,22246,214
2022-02-24,Tehama,103,63373,11924,11878,2598,14476,158
2022-02-24,Trinity,105,12862,1171,1156,292,1448,20
2022-02-24,Tulare,107,460477,105573,102983,28144,131127,1295
2022-02-24,Tuolumne,109,53932,12509,12169,556,12725,175
2022-02-24,Ventura,111,848112,171565,171292,9370,180662,1411
2022-02-24,Yolo,113,214977,36399,35615,3125,38740,296
2022-02-24,Yuba,115,75493,15630,15587,1178,16765,113
2022-02-23,Alameda,001,1643700,251448,247686,13509,261195,1713
2022-02-23,Alpine,003,1148,122,125,1,126,0
2022-02-23,Amador,005,37829,8348,8274,640,8914,79
2022-02-23,Butte,007,227075,32597,32417,6595,39012,367
2022-02-23,Calaveras,009,45235,7171,7182,344,7526,107
2022-02-23,Colusa,011,21464,3412,3411,1065,4476,21
2022-02-23,Contra Costa,013,1133247,185781,184013,12875,196888,1209
2022-02-23,Del Norte,015,27424,5619,5625,179,5804,45
2022-02-23,El Dorado,017,186661,26421,26317,3198,29515,189
2022-02-23,Fresno,019,978130,228519,225308,23679,248987,2596
2022-02-23,Glenn,021,27897,4924,4909,1587,6496,40
2022-02-23,Humboldt,023,135768,16584,16601,2886,19487,132
2022-02-23,Imperial,025,180216,54877,54292,10684,64976,871
2022-02-23,Inyo,027,18085,4040,4031,463,4494,54
2022-02-23,Kern,029,883053,190195,188432,45803,234235,2106
2022-02-23,Kings,031,150075,50860,50416,3575,53991,423
2022-02-23,Lake,033,64148,10468,10368,877,11245,126
2022-02-23,Lassen,035,31185,8812,8749,881,9630,55
2022-02-23,Los Angeles,037,10098052,2684796,2659569,122734,2782303,30167
2022-02-23,Madera,039,155013,36902,36876,6017,42893,330
2022-02-23,Marin,041,260295,32751,32625,2170,34795,267
2022-02-23,Mariposa,043,17540,2345,2325,194,2519,6
2022-02-23,Mendocino,045,87422,12855,12747,2960,15707,111
2022-02-23,Merced,047,269075,61514,61295,8481,69776,772
2022-02-23,Modoc,049,8938,728,723,248,971,7
2022-02-23,Mono,051,14174,2954,2960,119,3079,5
2022-02-23,Monterey,053,433212,78435,77472,13326,90798,691
2022-02-23,Napa,055,140530,25220,25185,933,26118,128
2022-02-23,Nevada,057,99092,15759,15825,1169,16994,121
2022-02-23,Orange,059,3164182,541547,539631,40903,580534,6520
2022-02-23,Placer,061,380077,62017,61758,7302,69060,573
2022-02-23,Plumas,063,18699,2938,2663,359,3022,13
2022-02-23,Riverside,065,2383286,587084,584381,27785,612166,6119
2022-02-23,Sacramento,067,1510023,277669,272057,26844,298901,2796
2022-02-23,San Benito,069,59416,12760,12756,507,13263,92
2022-02-23,San Bernardino,071,2135413,565094,555238,24855,580093,6479
2022-02-23,San Diego,073,3302833,741728,735406,51625,787031,4988
2022-02-23,San Francisco,075,870044,121210,122127,8118,130245,769
2022-02-23,San Joaquin,077,732212,164733,164257,9903,174160,2042
2022-02-23,San Luis Obispo,079,281455,51605,51264,3693,54957,434
2022-02-23,San Mateo,081,765935,119291,117585,6843,124428,603
2022-02-23,Santa Barbara,083,443738,84771,84760,4714,89474,651
2022-02-23,Santa Clara,085,1922200,304936,305484,12180,317664,2157
2022-02-23,Santa Cruz,087,273765,46577,46059,2093,48152,251
2022-02-23,Shasta,089,179085,30140,30066,6044,36110,481
2022-02-23,Sierra,091,2930,271,270,47,317,1
2022-02-23,Siskiyou,093,43540,4385,4356,2695,7051,71
2022-02-23,Solano,095,438530,80128,80103,5501,85604,427
2022-02-23,Sonoma,097,501317,82164,81594,2531,84125,432
2022-02-23,Stanislaus,099,539301,116315,116789,17449,134238,1482
2022-02-23,Sutter,101,95872,20228,20194,2012,22206,213
2022-02-23,Tehama,103,63373,11914,11863,2598,14461,154
2022-02-23,Trinity,105,12862,1171,1156,292,1448,20
2022-02-23,Tulare,107,460477,105507,102812,28118,130930,1290
2022-02-23,Tuolumne,109,53932,12500,12158,555,12713,175
2022-02-23,Ventura,111,848112,171478,171163,9363,180526,1401
2022-02-23,Yolo,113,214977,36362,35590,3118,38708,296
2022-02-23,Yuba,115,75493,15627,15571,1176,16747,113
2022-02-22,Alameda,001,1643700,251204,247434,13494,260928,1706
2022-02-22,Alpine,003,1148,122,124,1,125,0
2022-02-22,Amador,005,37829,8338,8243,640,8883,79
2022-02-22,Butte,007,227075,32563,32359,6588,38947,366
2022-02-22,Calaveras,009,45235,7162,7178,344,7522,107
2022-02-22,Colusa,011,21464,3412,3402,1063,4465,21
2022-02-22,Contra Costa,013,1133247,185628,183812,12856,196668,1201
2022-02-22,Del Norte,015,27424,5610,5611,178,5789,45
2022-02-22,El Dorado,017,186661,26411,26289,3198,29487,189
2022-02-22,Fresno,019,978130,228292,225104,23650,248754,2592
2022-02-22,Glenn,021,27897,4923,4900,1586,6486,40
2022-02-22,Humboldt,023,135768,16562,16559,2882,19441,132
2022-02-22,Imperial,025,180216,54845,54227,10680,64907,864
2022-02-22,Inyo,027,18085,4038,4026,461,4487,54
2022-02-22,Kern,029,883053,190074,188237,45766,234003,2102
2022-02-22,Kings,031,150075,50798,50359,3572,53931,423
2022-02-22,Lake,033,64148,10457,10353,875,11228,126
2022-02-22,Lassen,035,31185,8808,8730,881,9611,55
2022-02-22,Los Angeles,037,10098052,2683331,2658230,122646,2780876,30129
2022-02-22,Madera,039,155013,36869,36833,6007,42840,330
2022-02-22,Marin,041,260295,32726,32591,2169,34760,267
2022-02-22,Mariposa,043,17540,2337,2322,194,2516,6
2022-02-22,Mendocino,045,87422,12841,12714,2950,15664,110
2022-02-22,Merced,047,269075,61454,61241,8474,69715,770
2022-02-22,Modoc,049,8938,725,720,248,968,6
2022-02-22,Mono,051,14174,2954,2961,119,3080,5
2022-02-22,Monterey,053,433212,78382,77359,13306,90665,690
2022-02-22,Napa,055,140530,25191,25151,932,26083,128
2022-02-22,Nevada,057,99092,15743,15815,1168,16983,121
2022-02-22,Orange,059,3164182,541259,539390,40870,580260,6502
2022-02-22,Placer,061,380077,61979,61709,7297,69006,572
2022-02-22,Plumas,063,18699,2932,2659,357,3016,13
2022-02-22,Riverside,065,2383286,586828,583969,27763,611732,6097
2022-02-22,Sacramento,067,1510023,277480,271789,26820,298609,2775
2022-02-22,San Benito,069,59416,12749,12742,506,13248,92
2022-02-22,San Bernardino,071,2135413,564892,554903,24836,579739,6451
2022-02-22,San Diego,073,3302833,741202,734536,51570,786106,4974
2022-02-22,San Francisco,075,870044,121081,121954,8114,130068,769
2022-02-22,San Joaquin,077,732212,164609,164111,9892,174003,2040
2022-02-22,San Luis Obispo,079,281455,51520,51193,3687,54880,431
2022-02-22,San Mateo,081,765935,119197,117418,6838,124256,603
2022-02-22,Santa Barbara,083,443738,84709,84701,4708,89409,650
2022-02-22,Santa Clara,085,1922200,304654,305045,12174,317219,2155
2022-02-22,Santa Cruz,087,273765,46512,45958,2093,48051,251
2022-02-22,Shasta,089,179085,30115,30024,6039,36063,479
2022-02-22,Sierra,091,2930,271,269,46,315,0
2022-02-22,Siskiyou,093,43540,4382,4350,2690,7040,70
2022-02-22,Solano,095,438530,80052,79968,5499,85467,425
2022-02-22,Sonoma,097,501317,82098,81412,2527,83939,431
2022-02-22,Stanislaus,099,539301,116233,116676,17431,134107,1475
2022-02-22,Sutter,101,95872,20212,20164,2010,22174,210
2022-02-22,Tehama,103,63373,11905,11852,2597,14449,152
2022-02-22,Trinity,105,12862,1171,1147,291,1438,20
2022-02-22,Tulare,107,460477,105400,102717,28084,130801,1287
2022-02-22,Tuolumne,109,53932,12481,12136,554,12690,175
2022-02-22,Ventura,111,848112,171393,171064,9357,180421,1401
2022-02-22,Yolo,113,214977,36325,35527,3112,38639,292
2022-02-22,Yuba,115,75493,15617,15550,1175,16725,110
2022-02-21,Alameda,001,1643700,250919,247434,13478,260912,1704
2022-02-21,Alpine,003,1148,122,124,1,125,0
2022-02-21,Amador,005,37829,8332,8246,640,8886,79
2022-02-21,Butte,007,227075,32523,32356,6564,38920,366
2022-02-21,Calaveras,009,45235,7154,7175,344,7519,107
2022-02-21,Colusa,011,21464,3410,3401,1061,4462,21
2022-02-21,Contra Costa,013,1133247,185402,183701,12842,196543,1201
2022-02-21,Del Norte,015,27424,5592,5601,177,5778,45
2022-02-21,El Dorado,017,186661,26384,26273,3193,29466,189
2022-02-21,Fresno,019,978130,227978,224923,23594,248517,2592
2022-02-21,Glenn,021,27897,4918,4897,1586,6483,40
2022-02-21,Humboldt,023,135768,16518,16548,2874,19422,132
2022-02-21,Imperial,025,180216,54785,54208,10663,64871,864
2022-02-21,Inyo,027,18085,4035,4023,461,4484,54
2022-02-21,Kern,029,883053,189881,188188,45713,233901,2102
2022-02-21,Kings,031,150075,50732,50188,3569,53757,422
2022-02-21,Lake,033,64148,10435,10334,873,11207,126
2022-02-21,Lassen,035,31185,8800,8705,876,9581,55
2022-02-21,Los Angeles,037,10098052,2681552,2656873,122547,2779420,30108
2022-02-21,Madera,039,155013,36831,36796,5986,42782,330
2022-02-21,Marin,041,260295,32703,32570,2169,34739,258
2022-02-21,Mariposa,043,17540,2334,2321,194,2515,6
2022-02-21,Mendocino,045,87422,12815,12706,2938,15644,110
2022-02-21,Merced,047,269075,61397,61209,8457,69666,770
2022-02-21,Modoc,049,8938,724,718,248,966,6
2022-02-21,Mono,051,14174,2953,2960,119,3079,5
2022-02-21,Monterey,053,433212,78288,77354,13264,90618,690
2022-02-21,Napa,055,140530,25152,25126,932,26058,128
2022-02-21,Nevada,057,99092,15732,15810,1165,16975,121
2022-02-21,Orange,059,3164182,540906,539068,40845,579913,6502
2022-02-21,Placer,061,380077,61925,61727,7293,69020,572
2022-02-21,Plumas,063,18699,2928,2657,352,3009,13
2022-02-21,Riverside,065,2383286,586460,583712,27715,611427,6097
2022-02-21,Sacramento,067,1510023,277226,271588,26787,298375,2769
2022-02-21,San Benito,069,59416,12736,12731,506,13237,92
2022-02-21,San Bernardino,071,2135413,564654,554662,24814,579476,6441
2022-02-21,San Diego,073,3302833,740584,732298,51492,783790,4974
2022-02-21,San Francisco,075,870044,120900,121865,8110,129975,769
2022-02-21,San Joaquin,077,732212,164465,164036,9881,173917,2040
2022-02-21,San Luis Obispo,079,281455,51429,51184,3680,54864,429
2022-02-21,San Mateo,081,765935,119104,117259,6830,124089,605
2022-02-21,Santa Barbara,083,443738,84632,84626,4700,89326,650
2022-02-21,Santa Clara,085,1922200,304326,304858,12168,317026,2158
2022-02-21,Santa Cruz,087,273765,46386,45941,2092,48033,251
2022-02-21,Shasta,089,179085,30069,30004,6031,36035,479
2022-02-21,Sierra,091,2930,271,269,46,315,0
2022-02-21,Siskiyou,093,43540,4370,4337,2685,7022,70
2022-02-21,Solano,095,438530,79959,79906,5494,85400,425
2022-02-21,Sonoma,097,501317,81984,81361,2521,83882,431
2022-02-21,Stanislaus,099,539301,116121,116597,17407,134004,1475
2022-02-21,Sutter,101,95872,20186,20152,2008,22160,210
2022-02-21,Tehama,103,63373,11892,11842,2596,14438,152
2022-02-21,Trinity,105,12862,1170,1147,291,1438,20
2022-02-21,Tulare,107,460477,105303,102614,28037,130651,1287
2022-02-21,Tuolumne,109,53932,12470,12126,551,12677,175
2022-02-21,Ventura,111,848112,171254,170939,9348,180287,1401
2022-02-21,Yolo,113,214977,36282,35518,3103,38621,292
2022-02-21,Yuba,115,75493,15598,15546,1166,16712,110
2022-02-20,Alameda,001,1643700,250689,246028,13469,259497,1700
2022-02-20,Alpine,003,1148,122,124,1,125,0
2022-02-20,Amador,005,37829,8321,8203,640,8843,79
2022-02-20,Butte,007,227075,32494,32173,6559,38732,364
2022-02-20,Calaveras,009,45235,7151,7136,343,7479,107
2022-02-20,Colusa,011,21464,3407,3389,1060,4449,21
2022-02-20,Contra Costa,013,1133247,185274,182797,12837,195634,1190
2022-02-20,Del Norte,015,27424,5577,5511,177,5688,45
2022-02-20,El Dorado,017,186661,26363,26101,3192,29293,189
2022-02-20,Fresno,019,978130,227787,223594,23578,247172,2544
2022-02-20,Glenn,021,27897,4915,4881,1586,6467,39
2022-02-20,Humboldt,023,135768,16506,16393,2870,19263,132
2022-02-20,Imperial,025,180216,54720,53967,10650,64617,862
2022-02-20,Inyo,027,18085,4035,4018,460,4478,52
2022-02-20,Kern,029,883053,189746,187158,45669,232827,2095
2022-02-20,Kings,031,150075,50704,49724,3565,53289,421
2022-02-20,Lake,033,64148,10402,10184,872,11056,126
2022-02-20,Lassen,035,31185,8788,8640,876,9516,55
2022-02-20,Los Angeles,037,10098052,2680226,2642878,122461,2765339,29842
2022-02-20,Madera,039,155013,36800,36526,5982,42508,330
2022-02-20,Marin,041,260295,32686,32441,2168,34609,258
2022-02-20,Mariposa,043,17540,2328,2310,192,2502,6
2022-02-20,Mendocino,045,87422,12805,12625,2935,15560,110
2022-02-20,Merced,047,269075,61369,60886,8455,69341,769
2022-02-20,Modoc,049,8938,723,714,248,962,6
2022-02-20,Mono,051,14174,2953,2956,119,3075,5
2022-02-20,Monterey,053,433212,78228,76765,13250,90015,682
2022-02-20,Napa,055,140530,25130,24970,930,25900,127
2022-02-20,Nevada,057,99092,15721,15715,1164,16879,121
2022-02-20,Orange,059,3164182,540587,538019,40809,578828,6416
2022-02-20,Placer,061,380077,61893,61417,7285,68702,560
2022-02-20,Plumas,063,18699,2924,2646,350,2996,13
2022-02-20,Riverside,065,2383286,586192,581788,27687,609475,6087
2022-02-20,Sacramento,067,1510023,277047,270080,26762,296842,2747
2022-02-20,San Benito,069,59416,12733,12665,506,13171,92
2022-02-20,San Bernardino,071,2135413,564446,553151,24796,577947,6400
2022-02-20,San Diego,073,3302833,740012,729549,51429,780978,4947
2022-02-20,San Francisco,075,870044,120760,121197,8100,129297,756
2022-02-20,San Joaquin,077,732212,164346,163083,9870,172953,2033
2022-02-20,San Luis Obispo,079,281455,51400,50823,3676,54499,424
2022-02-20,San Mateo,081,765935,119030,116648,6822,123470,598
2022-02-20,Santa Barbara,083,443738,84588,83988,4698,88686,642
2022-02-20,Santa Clara,085,1922200,304046,303077,12160,315237,2138
2022-02-20,Santa Cruz,087,273765,46320,45532,2089,47621,250
2022-02-20,Shasta,089,179085,30039,29847,6024,35871,479
2022-02-20,Sierra,091,2930,271,269,46,315,0
2022-02-20,Siskiyou,093,43540,4365,4307,2684,6991,70
2022-02-20,Solano,095,438530,79884,78914,5489,84403,424
2022-02-20,Sonoma,097,501317,81909,80843,2518,83361,431
2022-02-20,Stanislaus,099,539301,116054,115976,17390,133366,1454
2022-02-20,Sutter,101,95872,20174,20060,2005,22065,210
2022-02-20,Tehama,103,63373,11880,11760,2593,14353,152
2022-02-20,Trinity,105,12862,1169,1130,291,1421,20
2022-02-20,Tulare,107,460477,105215,101996,28010,130006,1286
2022-02-20,Tuolumne,109,53932,12449,12036,550,12586,175
2022-02-20,Ventura,111,848112,171158,170331,9342,179673,1384
2022-02-20,Yolo,113,214977,36256,35363,3100,38463,293
2022-02-20,Yuba,115,75493,15583,15449,1165,16614,112
2022-02-19,Alameda,001,1643700,250514,246028,13466,259494,1700
2022-02-19,Alpine,003,1148,122,124,1,125,0
2022-02-19,Amador,005,37829,8317,8203,640,8843,79
2022-02-19,Butte,007,227075,32470,32173,6556,38729,364
2022-02-19,Calaveras,009,45235,7151,7136,343,7479,107
2022-02-19,Colusa,011,21464,3406,3389,1058,4447,21
2022-02-19,Contra Costa,013,1133247,185177,182797,12836,195633,1190
2022-02-19,Del Norte,015,27424,5567,5511,176,5687,45
2022-02-19,El Dorado,017,186661,26345,26101,3190,29291,189
2022-02-19,Fresno,019,978130,227671,223594,23569,247163,2544
2022-02-19,Glenn,021,27897,4911,4881,1586,6467,39
2022-02-19,Humboldt,023,135768,16491,16393,2870,19263,132
2022-02-19,Imperial,025,180216,54704,53967,10644,64611,862
2022-02-19,Inyo,027,18085,4034,4018,459,4477,52
2022-02-19,Kern,029,883053,189643,187158,45644,232802,2095
2022-02-19,Kings,031,150075,50681,49724,3563,53287,421
2022-02-19,Lake,033,64148,10393,10184,872,11056,126
2022-02-19,Lassen,035,31185,8776,8640,875,9515,55
2022-02-19,Los Angeles,037,10098052,2679431,2642878,122420,2765298,29842
2022-02-19,Madera,039,155013,36778,36526,5981,42507,330
2022-02-19,Marin,041,260295,32663,32441,2167,34608,258
2022-02-19,Mariposa,043,17540,2325,2310,192,2502,6
2022-02-19,Mendocino,045,87422,12795,12625,2935,15560,110
2022-02-19,Merced,047,269075,61324,60886,8451,69337,769
2022-02-19,Modoc,049,8938,723,714,247,961,6
2022-02-19,Mono,051,14174,2952,2956,119,3075,5
2022-02-19,Monterey,053,433212,78139,76765,13239,90004,682
2022-02-19,Napa,055,140530,25120,24970,930,25900,127
2022-02-19,Nevada,057,99092,15713,15715,1164,16879,121
2022-02-19,Orange,059,3164182,540385,538019,40784,578803,6416
2022-02-19,Placer,061,380077,61846,61417,7284,68701,560
2022-02-19,Plumas,063,18699,2923,2646,350,2996,13
2022-02-19,Riverside,065,2383286,586009,581788,27674,609462,6087
2022-02-19,Sacramento,067,1510023,276905,270080,26751,296831,2747
2022-02-19,San Benito,069,59416,12720,12665,505,13170,92
2022-02-19,San Bernardino,071,2135413,564283,553151,24789,577940,6400
2022-02-19,San Diego,073,3302833,739666,729549,51382,780931,4947
2022-02-19,San Francisco,075,870044,120674,121197,8096,129293,756
2022-02-19,San Joaquin,077,732212,164272,163083,9859,172942,2033
2022-02-19,San Luis Obispo,079,281455,51387,50823,3672,54495,424
2022-02-19,San Mateo,081,765935,118989,116648,6820,123468,598
2022-02-19,Santa Barbara,083,443738,84521,83988,4697,88685,642
2022-02-19,Santa Clara,085,1922200,303852,303077,12158,315235,2138
2022-02-19,Santa Cruz,087,273765,46282,45532,2087,47619,250
2022-02-19,Shasta,089,179085,30025,29847,6021,35868,479
2022-02-19,Sierra,091,2930,271,269,46,315,0
2022-02-19,Siskiyou,093,43540,4362,4307,2684,6991,70
2022-02-19,Solano,095,438530,79842,78914,5488,84402,424
2022-02-19,Sonoma,097,501317,81867,80843,2518,83361,431
2022-02-19,Stanislaus,099,539301,115983,115976,17384,133360,1454
2022-02-19,Sutter,101,95872,20166,20060,2005,22065,210
2022-02-19,Tehama,103,63373,11873,11760,2593,14353,152
2022-02-19,Trinity,105,12862,1167,1130,291,1421,20
2022-02-19,Tulare,107,460477,105167,101996,27984,129980,1286
2022-02-19,Tuolumne,109,53932,12440,12036,550,12586,175
2022-02-19,Ventura,111,848112,171083,170331,9338,179669,1384
2022-02-19,Yolo,113,214977,36225,35363,3096,38459,293
2022-02-19,Yuba,115,75493,15574,15449,1165,16614,112
2022-02-18,Alameda,001,1643700,250347,246028,13458,259486,1700
2022-02-18,Alpine,003,1148,121,124,1,125,0
2022-02-18,Amador,005,37829,8310,8203,638,8841,79
2022-02-18,Butte,007,227075,32449,32173,6550,38723,364
2022-02-18,Calaveras,009,45235,7146,7136,342,7478,107
2022-02-18,Colusa,011,21464,3404,3389,1058,4447,21
2022-02-18,Contra Costa,013,1133247,185070,182797,12830,195627,1190
2022-02-18,Del Norte,015,27424,5555,5511,176,5687,45
2022-02-18,El Dorado,017,186661,26334,26101,3190,29291,189
2022-02-18,Fresno,019,978130,227483,223594,23557,247151,2544
2022-02-18,Glenn,021,27897,4910,4881,1585,6466,39
2022-02-18,Humboldt,023,135768,16474,16393,2865,19258,132
2022-02-18,Imperial,025,180216,54678,53967,10633,64600,862
2022-02-18,Inyo,027,18085,4032,4018,459,4477,52
2022-02-18,Kern,029,883053,189531,187158,45599,232757,2095
2022-02-18,Kings,031,150075,50594,49724,3563,53287,421
2022-02-18,Lake,033,64148,10376,10184,870,11054,126
2022-02-18,Lassen,035,31185,8756,8640,874,9514,55
2022-02-18,Los Angeles,037,10098052,2678446,2642878,122365,2765243,29842
2022-02-18,Madera,039,155013,36755,36526,5979,42505,330
2022-02-18,Marin,041,260295,32645,32441,2165,34606,258
2022-02-18,Mariposa,043,17540,2323,2310,192,2502,6
2022-02-18,Mendocino,045,87422,12785,12625,2935,15560,110
2022-02-18,Merced,047,269075,61282,60886,8441,69327,769
2022-02-18,Modoc,049,8938,723,714,247,961,6
2022-02-18,Mono,051,14174,2952,2956,119,3075,5
2022-02-18,Monterey,053,433212,78066,76765,13231,89996,682
2022-02-18,Napa,055,140530,25102,24970,930,25900,127
2022-02-18,Nevada,057,99092,15705,15715,1164,16879,121
2022-02-18,Orange,059,3164182,540147,538019,40745,578764,6416
2022-02-18,Placer,061,380077,61817,61417,7276,68693,560
2022-02-18,Plumas,063,18699,2920,2646,350,2996,13
2022-02-18,Riverside,065,2383286,585828,581788,27665,609453,6087
2022-02-18,Sacramento,067,1510023,276714,270080,26743,296823,2747
2022-02-18,San Benito,069,59416,12712,12665,505,13170,92
2022-02-18,San Bernardino,071,2135413,564105,553151,24784,577935,6400
2022-02-18,San Diego,073,3302833,739242,729549,51357,780906,4947
2022-02-18,San Francisco,075,870044,120586,121197,8088,129285,756
2022-02-18,San Joaquin,077,732212,164202,163083,9851,172934,2033
2022-02-18,San Luis Obispo,079,281455,51371,50823,3669,54492,424
2022-02-18,San Mateo,081,765935,118924,116648,6817,123465,598
2022-02-18,Santa Barbara,083,443738,84481,83988,4695,88683,642
2022-02-18,Santa Clara,085,1922200,303616,303077,12157,315234,2138
2022-02-18,Santa Cruz,087,273765,46248,45532,2086,47618,250
2022-02-18,Shasta,089,179085,30012,29847,6020,35867,479
2022-02-18,Sierra,091,2930,271,269,46,315,0
2022-02-18,Siskiyou,093,43540,4359,4307,2682,6989,70
2022-02-18,Solano,095,438530,79772,78914,5487,84401,424
2022-02-18,Sonoma,097,501317,81811,80843,2517,83360,431
2022-02-18,Stanislaus,099,539301,115933,115976,17370,133346,1454
2022-02-18,Sutter,101,95872,20154,20060,2005,22065,210
2022-02-18,Tehama,103,63373,11862,11760,2593,14353,152
2022-02-18,Trinity,105,12862,1166,1130,290,1420,20
2022-02-18,Tulare,107,460477,105117,101996,27941,129937,1286
2022-02-18,Tuolumne,109,53932,12434,12036,549,12585,175
2022-02-18,Ventura,111,848112,170993,170331,9333,179664,1384
2022-02-18,Yolo,113,214977,36197,35363,3094,38457,293
2022-02-18,Yuba,115,75493,15559,15449,1165,16614,112
2022-02-17,Alameda,001,1643700,250085,246028,13437,259465,1700
2022-02-17,Alpine,003,1148,121,124,1,125,0
2022-02-17,Amador,005,37829,8306,8203,636,8839,79
2022-02-17,Butte,007,227075,32411,32173,6545,38718,364
2022-02-17,Calaveras,009,45235,7137,7136,339,7475,107
2022-02-17,Colusa,011,21464,3401,3389,1058,4447,21
2022-02-17,Contra Costa,013,1133247,184874,182797,12796,195593,1190
2022-02-17,Del Norte,015,27424,5534,5511,176,5687,45
2022-02-17,El Dorado,017,186661,26309,26101,3180,29281,189
2022-02-17,Fresno,019,978130,227190,223594,23526,247120,2544
2022-02-17,Glenn,021,27897,4908,4881,1582,6463,39
2022-02-17,Humboldt,023,135768,16434,16393,2864,19257,132
2022-02-17,Imperial,025,180216,54606,53967,10616,64583,862
2022-02-17,Inyo,027,18085,4030,4018,458,4476,52
2022-02-17,Kern,029,883053,189377,187158,45549,232707,2095
2022-02-17,Kings,031,150075,50530,49724,3557,53281,421
2022-02-17,Lake,033,64148,10346,10184,866,11050,126
2022-02-17,Lassen,035,31185,8746,8640,872,9512,55
2022-02-17,Los Angeles,037,10098052,2676607,2642878,122284,2765162,29842
2022-02-17,Madera,039,155013,36712,36526,5972,42498,330
2022-02-17,Marin,041,260295,32619,32441,2163,34604,258
2022-02-17,Mariposa,043,17540,2321,2310,191,2501,6
2022-02-17,Mendocino,045,87422,12768,12625,2932,15557,110
2022-02-17,Merced,047,269075,61208,60886,8423,69309,769
2022-02-17,Modoc,049,8938,722,714,247,961,6
2022-02-17,Mono,051,14174,2950,2956,119,3075,5
2022-02-17,Monterey,053,433212,77954,76765,13189,89954,682
2022-02-17,Napa,055,140530,25070,24970,928,25898,127
2022-02-17,Nevada,057,99092,15693,15715,1163,16878,121
2022-02-17,Orange,059,3164182,539809,538019,40717,578736,6416
2022-02-17,Placer,061,380077,61775,61417,7268,68685,560
2022-02-17,Plumas,063,18699,2917,2646,350,2996,13
2022-02-17,Riverside,065,2383286,585449,581788,27638,609426,6087
2022-02-17,Sacramento,067,1510023,276429,270080,26695,296775,2747
2022-02-17,San Benito,069,59416,12701,12665,505,13170,92
2022-02-17,San Bernardino,071,2135413,563805,553151,24770,577921,6400
2022-02-17,San Diego,073,3302833,738645,729549,51307,780856,4947
2022-02-17,San Francisco,075,870044,120452,121197,8077,129274,756
2022-02-17,San Joaquin,077,732212,164038,163083,9837,172920,2033
2022-02-17,San Luis Obispo,079,281455,51266,50823,3661,54484,424
2022-02-17,San Mateo,081,765935,118830,116648,6808,123456,598
2022-02-17,Santa Barbara,083,443738,84381,83988,4687,88675,642
2022-02-17,Santa Clara,085,1922200,303251,303077,12142,315219,2138
2022-02-17,Santa Cruz,087,273765,46167,45532,2084,47616,250
2022-02-17,Shasta,089,179085,29985,29847,6017,35864,479
2022-02-17,Sierra,091,2930,271,269,46,315,0
2022-02-17,Siskiyou,093,43540,4350,4307,2678,6985,70
2022-02-17,Solano,095,438530,79691,78914,5479,84393,424
2022-02-17,Sonoma,097,501317,81745,80843,2510,83353,431
2022-02-17,Stanislaus,099,539301,115830,115976,17353,133329,1454
2022-02-17,Sutter,101,95872,20139,20060,1997,22057,210
2022-02-17,Tehama,103,63373,11854,11760,2592,14352,152
2022-02-17,Trinity,105,12862,1164,1130,288,1418,20
2022-02-17,Tulare,107,460477,105006,101996,27915,129911,1286
2022-02-17,Tuolumne,109,53932,12423,12036,549,12585,175
2022-02-17,Ventura,111,848112,170853,170331,9332,179663,1384
2022-02-17,Yolo,113,214977,36159,35363,3093,38456,293
2022-02-17,Yuba,115,75493,15544,15449,1165,16614,112
2022-02-16,Alameda,001,1643700,249774,245662,13398,259060,1691
2022-02-16,Alpine,003,1148,121,124,1,125,0
2022-02-16,Amador,005,37829,8288,8197,634,8831,77
2022-02-16,Butte,007,227075,32368,32095,6533,38628,363
2022-02-16,Calaveras,009,45235,7133,7129,336,7465,107
2022-02-16,Colusa,011,21464,3396,3384,1058,4442,21
2022-02-16,Contra Costa,013,1133247,184638,182423,12759,195182,1179
2022-02-16,Del Norte,015,27424,5515,5473,172,5645,45
2022-02-16,El Dorado,017,186661,26282,26061,3176,29237,189
2022-02-16,Fresno,019,978130,226829,223056,23475,246531,2542
2022-02-16,Glenn,021,27897,4904,4873,1577,6450,39
2022-02-16,Humboldt,023,135768,16410,16342,2853,19195,132
2022-02-16,Imperial,025,180216,54528,53901,10586,64487,861
2022-02-16,Inyo,027,18085,4027,4013,455,4468,52
2022-02-16,Kern,029,883053,189159,186740,45458,232198,2084
2022-02-16,Kings,031,150075,50477,49575,3548,53123,420
2022-02-16,Lake,033,64148,10320,10145,866,11011,125
2022-02-16,Lassen,035,31185,8713,8618,872,9490,55
2022-02-16,Los Angeles,037,10098052,2674514,2640005,122173,2762178,29749
2022-02-16,Madera,039,155013,36644,36382,5957,42339,330
2022-02-16,Marin,041,260295,32583,32381,2160,34541,257
2022-02-16,Mariposa,043,17540,2319,2305,191,2496,6
2022-02-16,Mendocino,045,87422,12746,12605,2922,15527,108
2022-02-16,Merced,047,269075,61142,60776,8390,69166,767
2022-02-16,Modoc,049,8938,722,711,243,954,6
2022-02-16,Mono,051,14174,2948,2953,119,3072,5
2022-02-16,Monterey,053,433212,77806,76624,13148,89772,682
2022-02-16,Napa,055,140530,25031,24897,925,25822,128
2022-02-16,Nevada,057,99092,15676,15677,1159,16836,121
2022-02-16,Orange,059,3164182,539407,537934,40672,578606,6392
2022-02-16,Placer,061,380077,61731,61278,7255,68533,556
2022-02-16,Plumas,063,18699,2914,2644,348,2992,13
2022-02-16,Riverside,065,2383286,585050,580828,27591,608419,6064
2022-02-16,Sacramento,067,1510023,276104,269416,26639,296055,2736
2022-02-16,San Benito,069,59416,12674,12644,505,13149,92
2022-02-16,San Bernardino,071,2135413,563532,552353,24745,577098,6379
2022-02-16,San Diego,073,3302833,737885,728610,51232,779842,4931
2022-02-16,San Francisco,075,870044,120279,120987,8072,129059,756
2022-02-16,San Joaquin,077,732212,163869,162752,9827,172579,2032
2022-02-16,San Luis Obispo,079,281455,51194,50704,3648,54352,425
2022-02-16,San Mateo,081,765935,118712,116438,6790,123228,595
2022-02-16,Santa Barbara,083,443738,84305,83968,4674,88642,642
2022-02-16,Santa Clara,085,1922200,302866,302439,12107,314546,2130
2022-02-16,Santa Cruz,087,273765,46077,45274,2082,47356,250
2022-02-16,Shasta,089,179085,29947,29767,6005,35772,477
2022-02-16,Sierra,091,2930,270,269,46,315,0
2022-02-16,Siskiyou,093,43540,4343,4302,2672,6974,71
2022-02-16,Solano,095,438530,79576,78742,5472,84214,422
2022-02-16,Sonoma,097,501317,81617,80642,2500,83142,431
2022-02-16,Stanislaus,099,539301,115711,115751,17322,133073,1443
2022-02-16,Sutter,101,95872,20122,20020,1994,22014,210
2022-02-16,Tehama,103,63373,11837,11738,2590,14328,152
2022-02-16,Trinity,105,12862,1164,1130,287,1417,20
2022-02-16,Tulare,107,460477,104886,101817,27862,129679,1281
2022-02-16,Tuolumne,109,53932,12411,11991,548,12539,171
2022-02-16,Ventura,111,848112,170716,170117,9324,179441,1372
2022-02-16,Yolo,113,214977,36108,35284,3090,38374,292
2022-02-16,Yuba,115,75493,15522,15405,1162,16567,110
2022-02-15,Alameda,001,1643700,249422,245265,13367,258632,1683
2022-02-15,Alpine,003,1148,121,124,1,125,0
2022-02-15,Amador,005,37829,8278,8183,633,8816,77
2022-02-15,Butte,007,227075,32319,32011,6519,38530,361
2022-02-15,Calaveras,009,45235,7123,7115,336,7451,106
2022-02-15,Colusa,011,21464,3388,3374,1057,4431,21
2022-02-15,Contra Costa,013,1133247,184380,182041,12727,194768,1179
2022-02-15,Del Norte,015,27424,5488,5439,170,5609,45
2022-02-15,El Dorado,017,186661,26263,25988,3171,29159,189
2022-02-15,Fresno,019,978130,226453,222673,23410,246083,2543
2022-02-15,Glenn,021,27897,4895,4862,1576,6438,39
2022-02-15,Humboldt,023,135768,16366,16297,2838,19135,132
2022-02-15,Imperial,025,180216,54465,53813,10571,64384,860
2022-02-15,Inyo,027,18085,4026,4009,454,4463,52
2022-02-15,Kern,029,883053,188938,186324,45367,231691,2072
2022-02-15,Kings,031,150075,50384,49473,3539,53012,418
2022-02-15,Lake,033,64148,10288,10112,860,10972,123
2022-02-15,Lassen,035,31185,8699,8587,870,9457,55
2022-02-15,Los Angeles,037,10098052,2672256,2638266,122039,2760305,29691
2022-02-15,Madera,039,155013,36577,36260,5936,42196,330
2022-02-15,Marin,041,260295,32541,32355,2158,34513,255
2022-02-15,Mariposa,043,17540,2318,2302,191,2493,6
2022-02-15,Mendocino,045,87422,12729,12580,2903,15483,108
2022-02-15,Merced,047,269075,61059,60674,8359,69033,763
2022-02-15,Modoc,049,8938,720,710,240,950,6
2022-02-15,Mono,051,14174,2947,2952,119,3071,5
2022-02-15,Monterey,053,433212,77680,75530,13088,88618,682
2022-02-15,Napa,055,140530,24981,24832,918,25750,127
2022-02-15,Nevada,057,99092,15650,15643,1158,16801,121
2022-02-15,Orange,059,3164182,538949,537478,40628,578106,6374
2022-02-15,Placer,061,380077,61670,61170,7244,68414,554
2022-02-15,Plumas,063,18699,2910,2638,348,2986,13
2022-02-15,Riverside,065,2383286,584563,579940,27531,607471,6049
2022-02-15,Sacramento,067,1510023,275715,268950,26559,295509,2721
2022-02-15,San Benito,069,59416,12655,12616,505,13121,91
2022-02-15,San Bernardino,071,2135413,563168,551803,24723,576526,6372
2022-02-15,San Diego,073,3302833,736923,727486,51134,778620,4914
2022-02-15,San Francisco,075,870044,120108,120759,8060,128819,756
2022-02-15,San Joaquin,077,732212,163650,162518,9813,172331,2021
2022-02-15,San Luis Obispo,079,281455,51097,50534,3633,54167,419
2022-02-15,San Mateo,081,765935,118576,116253,6768,123021,595
2022-02-15,Santa Barbara,083,443738,84170,83734,4660,88394,640
2022-02-15,Santa Clara,085,1922200,302374,301831,12068,313899,2130
2022-02-15,Santa Cruz,087,273765,45973,45171,2077,47248,250
2022-02-15,Shasta,089,179085,29896,29684,5991,35675,477
2022-02-15,Sierra,091,2930,270,269,46,315,0
2022-02-15,Siskiyou,093,43540,4336,4288,2665,6953,70
2022-02-15,Solano,095,438530,79443,78626,5465,84091,426
2022-02-15,Sonoma,097,501317,81496,80433,2494,82927,431
2022-02-15,Stanislaus,099,539301,115570,115549,17289,132838,1429
2022-02-15,Sutter,101,95872,20094,19980,1989,21969,208
2022-02-15,Tehama,103,63373,11819,11717,2588,14305,151
2022-02-15,Trinity,105,12862,1158,1125,284,1409,20
2022-02-15,Tulare,107,460477,104732,101645,27803,129448,1278
2022-02-15,Tuolumne,109,53932,12392,11945,546,12491,171
2022-02-15,Ventura,111,848112,170542,169942,9316,179258,1372
2022-02-15,Yolo,113,214977,36057,35241,3080,38321,289
2022-02-15,Yuba,115,75493,15494,15372,1157,16529,109
2022-02-14,Alameda,001,1643700,248987,244315,13334,257649,1677
2022-02-14,Alpine,003,1148,121,125,1,126,0
2022-02-14,Amador,005,37829,8263,8164,630,8794,77
2022-02-14,Butte,007,227075,32262,31946,6504,38450,360
2022-02-14,Calaveras,009,45235,7110,7097,334,7431,106
2022-02-14,Colusa,011,21464,3385,3367,1053,4420,21
2022-02-14,Contra Costa,013,1133247,184095,181753,12688,194441,1167
2022-02-14,Del Norte,015,27424,5466,5426,169,5595,45
2022-02-14,El Dorado,017,186661,26228,25915,3162,29077,188
2022-02-14,Fresno,019,978130,225973,222360,23320,245680,2538
2022-02-14,Glenn,021,27897,4889,4854,1576,6430,39
2022-02-14,Humboldt,023,135768,16326,16264,2813,19077,132
2022-02-14,Imperial,025,180216,54394,53765,10542,64307,860
2022-02-14,Inyo,027,18085,4025,4010,453,4463,52
2022-02-14,Kern,029,883053,188595,186037,45258,231295,2063
2022-02-14,Kings,031,150075,50278,49395,3530,52925,419
2022-02-14,Lake,033,64148,10251,10090,857,10947,123
2022-02-14,Lassen,035,31185,8689,8539,868,9407,55
2022-02-14,Los Angeles,037,10098052,2669676,2636064,121910,2757974,29650
2022-02-14,Madera,039,155013,36512,36194,5913,42107,330
2022-02-14,Marin,041,260295,32505,32304,2155,34459,255
2022-02-14,Mariposa,043,17540,2311,2295,191,2486,6
2022-02-14,Mendocino,045,87422,12702,12541,2871,15412,108
2022-02-14,Merced,047,269075,60970,60591,8314,68905,758
2022-02-14,Modoc,049,8938,715,707,240,947,6
2022-02-14,Mono,051,14174,2946,2954,119,3073,5
2022-02-14,Monterey,053,433212,77508,75407,13004,88411,678
2022-02-14,Napa,055,140530,24922,24776,918,25694,127
2022-02-14,Nevada,057,99092,15631,15629,1157,16786,121
2022-02-14,Orange,059,3164182,538443,536924,40562,577486,6355
2022-02-14,Placer,061,380077,61600,61123,7229,68352,554
2022-02-14,Plumas,063,18699,2908,2631,348,2979,13
2022-02-14,Riverside,065,2383286,584017,579174,27461,606635,5994
2022-02-14,Sacramento,067,1510023,275275,268547,26445,294992,2717
2022-02-14,San Benito,069,59416,12631,12598,504,13102,91
2022-02-14,San Bernardino,071,2135413,562753,551338,24703,576041,6372
2022-02-14,San Diego,073,3302833,735955,723902,51035,774937,4894
2022-02-14,San Francisco,075,870044,119918,120581,8050,128631,756
2022-02-14,San Joaquin,077,732212,163410,162363,9790,172153,2018
2022-02-14,San Luis Obispo,079,281455,50988,50465,3623,54088,416
2022-02-14,San Mateo,081,765935,118411,116129,6759,122888,592
2022-02-14,Santa Barbara,083,443738,84024,83697,4650,88347,636
2022-02-14,Santa Clara,085,1922200,301838,301319,12044,313363,2127
2022-02-14,Santa Cruz,087,273765,45810,45042,2073,47115,250
2022-02-14,Shasta,089,179085,29810,29595,5973,35568,474
2022-02-14,Sierra,091,2930,270,269,46,315,0
2022-02-14,Siskiyou,093,43540,4323,4278,2651,6929,69
2022-02-14,Solano,095,438530,79264,78533,5453,83986,427
2022-02-14,Sonoma,097,501317,81355,80336,2483,82819,431
2022-02-14,Stanislaus,099,539301,115393,115426,17243,132669,1406
2022-02-14,Sutter,101,95872,20066,19957,1983,21940,209
2022-02-14,Tehama,103,63373,11796,11686,2587,14273,151
2022-02-14,Trinity,105,12862,1155,1123,284,1407,20
2022-02-14,Tulare,107,460477,104525,101448,27702,129150,1276
2022-02-14,Tuolumne,109,53932,12363,11920,543,12463,170
2022-02-14,Ventura,111,848112,170365,169725,9304,179029,1361
2022-02-14,Yolo,113,214977,36000,35112,3070,38182,286
2022-02-14,Yuba,115,75493,15464,15375,1153,16528,108
2022-02-13,Alameda,001,1643700,248495,243681,13299,256980,1677
2022-02-13,Alpine,003,1148,121,125,1,126,0
2022-02-13,Amador,005,37829,8234,8146,627,8773,77
2022-02-13,Butte,007,227075,32190,31865,6480,38345,360
2022-02-13,Calaveras,009,45235,7103,7083,331,7414,106
2022-02-13,Colusa,011,21464,3382,3366,1051,4417,21
2022-02-13,Contra Costa,013,1133247,183730,181313,12623,193936,1159
2022-02-13,Del Norte,015,27424,5433,5379,169,5548,45
2022-02-13,El Dorado,017,186661,26191,25871,3154,29025,188
2022-02-13,Fresno,019,978130,225433,221686,23253,244939,2537
2022-02-13,Glenn,021,27897,4879,4847,1573,6420,39
2022-02-13,Humboldt,023,135768,16279,16210,2785,18995,132
2022-02-13,Imperial,025,180216,54296,53658,10504,64162,860
2022-02-13,Inyo,027,18085,4022,4006,451,4457,52
2022-02-13,Kern,029,883053,188343,185640,45171,230811,2063
2022-02-13,Kings,031,150075,50151,49243,3516,52759,416
2022-02-13,Lake,033,64148,10188,10042,849,10891,123
2022-02-13,Lassen,035,31185,8664,8503,866,9369,55
2022-02-13,Los Angeles,037,10098052,2666507,2631267,121767,2753034,29595
2022-02-13,Madera,039,155013,36394,36054,5884,41938,330
2022-02-13,Marin,041,260295,32434,32222,2148,34370,255
2022-02-13,Mariposa,043,17540,2305,2292,189,2481,6
2022-02-13,Mendocino,045,87422,12673,12521,2830,15351,108
2022-02-13,Merced,047,269075,60828,60460,8260,68720,758
2022-02-13,Modoc,049,8938,713,704,233,937,6
2022-02-13,Mono,051,14174,2945,2949,119,3068,5
2022-02-13,Monterey,053,433212,77301,75295,12929,88224,678
2022-02-13,Napa,055,140530,24845,24743,915,25658,127
2022-02-13,Nevada,057,99092,15597,15590,1150,16740,121
2022-02-13,Orange,059,3164182,537815,536134,40500,576634,6355
2022-02-13,Placer,061,380077,61523,61020,7205,68225,554
2022-02-13,Plumas,063,18699,2900,2626,345,2971,13
2022-02-13,Riverside,065,2383286,583425,578363,27416,605779,5995
2022-02-13,Sacramento,067,1510023,274766,267947,26312,294259,2699
2022-02-13,San Benito,069,59416,12598,12578,503,13081,91
2022-02-13,San Bernardino,071,2135413,562265,550632,24669,575301,6367
2022-02-13,San Diego,073,3302833,734817,723902,50916,774818,4894
2022-02-13,San Francisco,075,870044,119666,120295,8038,128333,756
2022-02-13,San Joaquin,077,732212,163104,162028,9761,171789,2018
2022-02-13,San Luis Obispo,079,281455,50843,50384,3615,53999,415
2022-02-13,San Mateo,081,765935,118190,115876,6734,122610,592
2022-02-13,Santa Barbara,083,443738,83860,83547,4642,88189,635
2022-02-13,Santa Clara,085,1922200,301198,300412,12007,312419,2114
2022-02-13,Santa Cruz,087,273765,45655,44887,2071,46958,240
2022-02-13,Shasta,089,179085,29731,29531,5948,35479,474
2022-02-13,Sierra,091,2930,270,269,46,315,0
2022-02-13,Siskiyou,093,43540,4316,4264,2635,6899,69
2022-02-13,Solano,095,438530,79108,78424,5428,83852,426
2022-02-13,Sonoma,097,501317,81189,80172,2471,82643,431
2022-02-13,Stanislaus,099,539301,115197,115156,17202,132358,1406
2022-02-13,Sutter,101,95872,20027,19900,1983,21883,209
2022-02-13,Tehama,103,63373,11770,11644,2582,14226,151
2022-02-13,Trinity,105,12862,1152,1120,281,1401,20
2022-02-13,Tulare,107,460477,104307,101135,27608,128743,1276
2022-02-13,Tuolumne,109,53932,12338,11891,538,12429,170
2022-02-13,Ventura,111,848112,170171,169422,9283,178705,1361
2022-02-13,Yolo,113,214977,35933,35057,3058,38115,286
2022-02-13,Yuba,115,75493,15430,15346,1151,16497,107
2022-02-12,Alameda,001,1643700,248275,242137,13285,255422,1668
2022-02-12,Alpine,003,1148,121,124,1,125,0
2022-02-12,Amador,005,37829,8228,8091,627,8718,76
2022-02-12,Butte,007,227075,32163,31601,6473,38074,360
2022-02-12,Calaveras,009,45235,7100,7022,330,7352,106
2022-02-12,Colusa,011,21464,3379,3345,1051,4396,21
2022-02-12,Contra Costa,013,1133247,183539,180270,12616,192886,1141
2022-02-12,Del Norte,015,27424,5413,5262,169,5431,45
2022-02-12,El Dorado,017,186661,26175,25692,3154,28846,188
2022-02-12,Fresno,019,978130,225219,219909,23236,243145,2509
2022-02-12,Glenn,021,27897,4878,4818,1572,6390,39
2022-02-12,Humboldt,023,135768,16256,16058,2781,18839,132
2022-02-12,Imperial,025,180216,54252,53304,10493,63797,860
2022-02-12,Inyo,027,18085,4020,3991,451,4442,52
2022-02-12,Kern,029,883053,188232,184639,45134,229773,2037
2022-02-12,Kings,031,150075,50111,48893,3509,52402,415
2022-02-12,Lake,033,64148,10167,9926,844,10770,123
2022-02-12,Lassen,035,31185,8641,8477,865,9342,55
2022-02-12,Los Angeles,037,10098052,2665346,2616426,121691,2738117,29364
2022-02-12,Madera,039,155013,36360,35710,5877,41587,330
2022-02-12,Marin,041,260295,32402,32048,2145,34193,255
2022-02-12,Mariposa,043,17540,2305,2286,189,2475,6
2022-02-12,Mendocino,045,87422,12657,12439,2830,15269,107
2022-02-12,Merced,047,269075,60774,60187,8255,68442,758
2022-02-12,Modoc,049,8938,713,697,233,930,6
2022-02-12,Mono,051,14174,2944,2939,119,3058,5
2022-02-12,Monterey,053,433212,77240,74842,12904,87746,672
2022-02-12,Napa,055,140530,24817,24530,915,25445,124
2022-02-12,Nevada,057,99092,15584,15499,1148,16647,119
2022-02-12,Orange,059,3164182,537526,534503,40464,574967,6305
2022-02-12,Placer,061,380077,61465,60636,7202,67838,554
2022-02-12,Plumas,063,18699,2899,2617,344,2961,13
2022-02-12,Riverside,065,2383286,583063,575566,27392,602958,5961
2022-02-12,Sacramento,067,1510023,274529,266347,26303,292650,2686
2022-02-12,San Benito,069,59416,12586,12526,503,13029,91
2022-02-12,San Bernardino,071,2135413,562032,548822,24656,573478,6360
2022-02-12,San Diego,073,3302833,734319,720287,50867,771154,4854
2022-02-12,San Francisco,075,870044,119544,119113,8027,127140,740
2022-02-12,San Joaquin,077,732212,162974,161234,9755,170989,2014
2022-02-12,San Luis Obispo,079,281455,50807,50064,3612,53676,416
2022-02-12,San Mateo,081,765935,118102,115235,6726,121961,589
2022-02-12,Santa Barbara,083,443738,83774,83390,4632,88022,631
2022-02-12,Santa Clara,085,1922200,300860,298176,11999,310175,2093
2022-02-12,Santa Cruz,087,273765,45619,44447,2069,46516,239
2022-02-12,Shasta,089,179085,29702,29370,5944,35314,473
2022-02-12,Sierra,091,2930,270,268,46,314,0
2022-02-12,Siskiyou,093,43540,4309,4231,2632,6863,68
2022-02-12,Solano,095,438530,79066,77865,5423,83288,424
2022-02-12,Sonoma,097,501317,81085,79533,2469,82002,431
2022-02-12,Stanislaus,099,539301,115072,114531,17190,131721,1406
2022-02-12,Sutter,101,95872,20012,19800,1983,21783,211
2022-02-12,Tehama,103,63373,11755,11580,2582,14162,151
2022-02-12,Trinity,105,12862,1151,1115,281,1396,20
2022-02-12,Tulare,107,460477,104212,100434,27569,128003,1273
2022-02-12,Tuolumne,109,53932,12320,11754,538,12292,125
2022-02-12,Ventura,111,848112,170063,168736,9278,178014,1340
2022-02-12,Yolo,113,214977,35892,34773,3055,37828,286
2022-02-12,Yuba,115,75493,15416,15242,1150,16392,107
2022-02-11,Alameda,001,1643700,247995,242137,13271,255408,1668
2022-02-11,Alpine,003,1148,121,124,1,125,0
2022-02-11,Amador,005,37829,8216,8091,627,8718,76
2022-02-11,Butte,007,227075,32119,31601,6462,38063,360
2022-02-11,Calaveras,009,45235,7097,7022,330,7352,106
2022-02-11,Colusa,011,21464,3377,3345,1050,4395,21
2022-02-11,Contra Costa,013,1133247,183335,180270,12597,192867,1141
2022-02-11,Del Norte,015,27424,5398,5262,168,5430,45
2022-02-11,El Dorado,017,186661,26156,25692,3153,28845,188
2022-02-11,Fresno,019,978130,224923,219909,23218,243127,2509
2022-02-11,Glenn,021,27897,4874,4818,1572,6390,39
2022-02-11,Humboldt,023,135768,16227,16058,2776,18834,132
2022-02-11,Imperial,025,180216,54222,53304,10482,63786,860
2022-02-11,Inyo,027,18085,4016,3991,446,4437,52
2022-02-11,Kern,029,883053,188074,184639,45080,229719,2037
2022-02-11,Kings,031,150075,50071,48893,3508,52401,415
2022-02-11,Lake,033,64148,10142,9926,842,10768,123
2022-02-11,Lassen,035,31185,8601,8477,865,9342,55
2022-02-11,Los Angeles,037,10098052,2663718,2616426,121602,2738028,29364
2022-02-11,Madera,039,155013,36318,35710,5871,41581,330
2022-02-11,Marin,041,260295,32370,32048,2142,34190,255
2022-02-11,Mariposa,043,17540,2300,2286,189,2475,6
2022-02-11,Mendocino,045,87422,12641,12439,2830,15269,107
2022-02-11,Merced,047,269075,60724,60187,8248,68435,758
2022-02-11,Modoc,049,8938,711,697,233,930,6
2022-02-11,Mono,051,14174,2943,2939,119,3058,5
2022-02-11,Monterey,053,433212,77124,74842,12890,87732,672
2022-02-11,Napa,055,140530,24790,24530,915,25445,124
2022-02-11,Nevada,057,99092,15570,15499,1145,16644,119
2022-02-11,Orange,059,3164182,537175,534503,40400,574903,6305
2022-02-11,Placer,061,380077,61413,60636,7200,67836,554
2022-02-11,Plumas,063,18699,2895,2617,342,2959,13
2022-02-11,Riverside,065,2383286,582644,575566,27376,602942,5961
2022-02-11,Sacramento,067,1510023,274264,266347,26291,292638,2686
2022-02-11,San Benito,069,59416,12581,12526,503,13029,91
2022-02-11,San Bernardino,071,2135413,561716,548822,24641,573463,6360
2022-02-11,San Diego,073,3302833,733617,720287,50808,771095,4854
2022-02-11,San Francisco,075,870044,119423,119113,8011,127124,740
2022-02-11,San Joaquin,077,732212,162806,161234,9743,170977,2014
2022-02-11,San Luis Obispo,079,281455,50770,50064,3608,53672,416
2022-02-11,San Mateo,081,765935,117984,115235,6717,121952,589
2022-02-11,Santa Barbara,083,443738,83690,83390,4631,88021,631
2022-02-11,Santa Clara,085,1922200,300434,298176,11979,310155,2093
2022-02-11,Santa Cruz,087,273765,45528,44447,2069,46516,239
2022-02-11,Shasta,089,179085,29671,29370,5936,35306,473
2022-02-11,Sierra,091,2930,269,268,45,313,0
2022-02-11,Siskiyou,093,43540,4298,4231,2626,6857,68
2022-02-11,Solano,095,438530,78940,77865,5417,83282,424
2022-02-11,Sonoma,097,501317,80997,79533,2464,81997,431
2022-02-11,Stanislaus,099,539301,114970,114531,17176,131707,1406
2022-02-11,Sutter,101,95872,19989,19800,1981,21781,211
2022-02-11,Tehama,103,63373,11742,11580,2581,14161,151
2022-02-11,Trinity,105,12862,1150,1115,280,1395,20
2022-02-11,Tulare,107,460477,104093,100434,27515,127949,1273
2022-02-11,Tuolumne,109,53932,12305,11754,536,12290,125
2022-02-11,Ventura,111,848112,169924,168736,9273,178009,1340
2022-02-11,Yolo,113,214977,35859,34773,3053,37826,286
2022-02-11,Yuba,115,75493,15399,15242,1149,16391,107
2022-02-10,Alameda,001,1643700,247470,242137,13224,255361,1668
2022-02-10,Alpine,003,1148,121,124,1,125,0
2022-02-10,Amador,005,37829,8204,8091,620,8711,76
2022-02-10,Butte,007,227075,32067,31601,6450,38051,360
2022-02-10,Calaveras,009,45235,7085,7022,328,7350,106
2022-02-10,Colusa,011,21464,3371,3345,1048,4393,21
2022-02-10,Contra Costa,013,1133247,182973,180270,12532,192802,1141
2022-02-10,Del Norte,015,27424,5369,5262,166,5428,45
2022-02-10,El Dorado,017,186661,26111,25692,3146,28838,188
2022-02-10,Fresno,019,978130,224343,219909,23130,243039,2509
2022-02-10,Glenn,021,27897,4870,4818,1570,6388,39
2022-02-10,Humboldt,023,135768,16177,16058,2754,18812,132
2022-02-10,Imperial,025,180216,54152,53304,10438,63742,860
2022-02-10,Inyo,027,18085,4012,3991,446,4437,52
2022-02-10,Kern,029,883053,187765,184639,44967,229606,2037
2022-02-10,Kings,031,150075,49960,48893,3497,52390,415
2022-02-10,Lake,033,64148,10111,9926,840,10766,123
2022-02-10,Lassen,035,31185,8587,8477,863,9340,55
2022-02-10,Los Angeles,037,10098052,2660567,2616426,121414,2737840,29364
2022-02-10,Madera,039,155013,36220,35710,5839,41549,330
2022-02-10,Marin,041,260295,32312,32048,2130,34178,255
2022-02-10,Mariposa,043,17540,2296,2286,188,2474,6
2022-02-10,Mendocino,045,87422,12619,12439,2806,15245,107
2022-02-10,Merced,047,269075,60599,60187,8192,68379,758
2022-02-10,Modoc,049,8938,710,697,232,929,6
2022-02-10,Mono,051,14174,2941,2939,118,3057,5
2022-02-10,Monterey,053,433212,76942,74842,12803,87645,672
2022-02-10,Napa,055,140530,24725,24530,913,25443,124
2022-02-10,Nevada,057,99092,15545,15499,1144,16643,119
2022-02-10,Orange,059,3164182,536524,534503,40330,574833,6305
2022-02-10,Placer,061,380077,61332,60636,7191,67827,554
2022-02-10,Plumas,063,18699,2892,2617,335,2952,13
2022-02-10,Riverside,065,2383286,581916,575566,27318,602884,5961
2022-02-10,Sacramento,067,1510023,273784,266347,26199,292546,2686
2022-02-10,San Benito,069,59416,12560,12526,501,13027,91
2022-02-10,San Bernardino,071,2135413,561173,548822,24609,573431,6360
2022-02-10,San Diego,073,3302833,732509,720287,50688,770975,4854
2022-02-10,San Francisco,075,870044,119210,119113,7993,127106,740
2022-02-10,San Joaquin,077,732212,162493,161234,9735,170969,2014
2022-02-10,San Luis Obispo,079,281455,50671,50064,3597,53661,416
2022-02-10,San Mateo,081,765935,117759,115235,6700,121935,589
2022-02-10,Santa Barbara,083,443738,83506,83390,4624,88014,631
2022-02-10,Santa Clara,085,1922200,299764,298176,11921,310097,2093
2022-02-10,Santa Cruz,087,273765,45384,44447,2068,46515,239
2022-02-10,Shasta,089,179085,29609,29370,5916,35286,473
2022-02-10,Sierra,091,2930,269,268,45,313,0
2022-02-10,Siskiyou,093,43540,4293,4231,2613,6844,68
2022-02-10,Solano,095,438530,78748,77865,5399,83264,424
2022-02-10,Sonoma,097,501317,80861,79533,2448,81981,431
2022-02-10,Stanislaus,099,539301,114791,114531,17132,131663,1406
2022-02-10,Sutter,101,95872,19950,19800,1966,21766,211
2022-02-10,Tehama,103,63373,11712,11580,2578,14158,151
2022-02-10,Trinity,105,12862,1147,1115,279,1394,20
2022-02-10,Tulare,107,460477,103905,100434,27434,127868,1273
2022-02-10,Tuolumne,109,53932,12283,11754,531,12285,125
2022-02-10,Ventura,111,848112,169643,168736,9258,177994,1340
2022-02-10,Yolo,113,214977,35781,34773,3047,37820,286
2022-02-10,Yuba,115,75493,15367,15242,1143,16385,107
2022-02-09,Alameda,001,1643700,246938,241141,13165,254306,1668
2022-02-09,Alpine,003,1148,120,124,1,125,0
2022-02-09,Amador,005,37829,8190,8069,615,8684,76
2022-02-09,Butte,007,227075,31974,31433,6434,37867,359
2022-02-09,Calaveras,009,45235,7070,7005,324,7329,106
2022-02-09,Colusa,011,21464,3368,3331,1047,4378,21
2022-02-09,Contra Costa,013,1133247,182620,179695,12485,192180,1132
2022-02-09,Del Norte,015,27424,5321,5204,165,5369,45
2022-02-09,El Dorado,017,186661,26074,25572,3134,28706,186
2022-02-09,Fresno,019,978130,223728,218989,23039,242028,2502
2022-02-09,Glenn,021,27897,4857,4804,1569,6373,39
2022-02-09,Humboldt,023,135768,16129,15929,2729,18658,131
2022-02-09,Imperial,025,180216,54049,53102,10365,63467,858
2022-02-09,Inyo,027,18085,4006,3989,445,4434,52
2022-02-09,Kern,029,883053,187388,184068,44852,228920,2021
2022-02-09,Kings,031,150075,49849,48718,3491,52209,410
2022-02-09,Lake,033,64148,10071,9880,835,10715,124
2022-02-09,Lassen,035,31185,8562,8459,862,9321,55
2022-02-09,Los Angeles,037,10098052,2656882,2611611,121279,2732890,29263
2022-02-09,Madera,039,155013,36122,35559,5806,41365,330
2022-02-09,Marin,041,260295,32262,31965,2123,34088,255
2022-02-09,Mariposa,043,17540,2293,2279,188,2467,6
2022-02-09,Mendocino,045,87422,12585,12378,2777,15155,107
2022-02-09,Merced,047,269075,60469,59952,8140,68092,755
2022-02-09,Modoc,049,8938,707,691,231,922,6
2022-02-09,Mono,051,14174,2939,2937,118,3055,5
2022-02-09,Monterey,053,433212,76740,74500,12713,87213,670
2022-02-09,Napa,055,140530,24679,24429,908,25337,123
2022-02-09,Nevada,057,99092,15524,15446,1142,16588,119
2022-02-09,Orange,059,3164182,535893,534316,40250,574566,6263
2022-02-09,Placer,061,380077,61237,60490,7171,67661,553
2022-02-09,Plumas,063,18699,2887,2609,331,2940,13
2022-02-09,Riverside,065,2383286,581170,573907,27271,601178,5911
2022-02-09,Sacramento,067,1510023,273217,265624,26080,291704,2673
2022-02-09,San Benito,069,59416,12536,12492,501,12993,91
2022-02-09,San Bernardino,071,2135413,560564,547768,24581,572349,6349
2022-02-09,San Diego,073,3302833,731159,717896,50578,768474,4832
2022-02-09,San Francisco,075,870044,118961,118550,7982,126532,731
2022-02-09,San Joaquin,077,732212,162189,160618,9725,170343,2014
2022-02-09,San Luis Obispo,079,281455,50525,49833,3592,53425,414
2022-02-09,San Mateo,081,765935,117571,114890,6659,121549,589
2022-02-09,Santa Barbara,083,443738,83324,82830,4618,87448,629
2022-02-09,Santa Clara,085,1922200,299046,297157,11863,309020,2090
2022-02-09,Santa Cruz,087,273765,45202,44200,2061,46261,239
2022-02-09,Shasta,089,179085,29540,29215,5895,35110,471
2022-02-09,Sierra,091,2930,268,268,44,312,0
2022-02-09,Siskiyou,093,43540,4279,4217,2607,6824,68
2022-02-09,Solano,095,438530,78557,77299,5387,82686,423
2022-02-09,Sonoma,097,501317,80688,79165,2441,81606,431
2022-02-09,Stanislaus,099,539301,114542,114039,16885,130924,1406
2022-02-09,Sutter,101,95872,19908,19758,1953,21711,207
2022-02-09,Tehama,103,63373,11685,11542,2574,14116,149
2022-02-09,Trinity,105,12862,1143,1110,278,1388,20
2022-02-09,Tulare,107,460477,103690,100049,27337,127386,1271
2022-02-09,Tuolumne,109,53932,12245,11702,528,12230,95
2022-02-09,Ventura,111,848112,169406,168253,9246,177499,1325
2022-02-09,Yolo,113,214977,35710,34588,3031,37619,285
2022-02-09,Yuba,115,75493,15336,15187,1131,16318,105
2022-02-08,Alameda,001,1643700,246300,240587,13091,253678,1651
2022-02-08,Alpine,003,1148,120,124,1,125,0
2022-02-08,Amador,005,37829,8182,8050,608,8658,76
2022-02-08,Butte,007,227075,31889,31353,6410,37763,359
2022-02-08,Calaveras,009,45235,7053,6981,322,7303,101
2022-02-08,Colusa,011,21464,3360,3320,1046,4366,21
2022-02-08,Contra Costa,013,1133247,182189,179078,12407,191485,1132
2022-02-08,Del Norte,015,27424,5295,5156,160,5316,44
2022-02-08,El Dorado,017,186661,26029,25446,3123,28569,186
2022-02-08,Fresno,019,978130,222981,218416,22933,241349,2502
2022-02-08,Glenn,021,27897,4840,4784,1565,6349,39
2022-02-08,Humboldt,023,135768,16068,15865,2696,18561,130
2022-02-08,Imperial,025,180216,53920,52977,10321,63298,855
2022-02-08,Inyo,027,18085,4001,3983,445,4428,52
2022-02-08,Kern,029,883053,187052,183519,44719,228238,2010
2022-02-08,Kings,031,150075,49689,48479,3479,51958,411
2022-02-08,Lake,033,64148,10041,9806,829,10635,125
2022-02-08,Lassen,035,31185,8553,8423,858,9281,55
2022-02-08,Los Angeles,037,10098052,2652546,2611204,121089,2732293,29259
2022-02-08,Madera,039,155013,36015,35381,5750,41131,330
2022-02-08,Marin,041,260295,32188,31878,2118,33996,255
2022-02-08,Mariposa,043,17540,2291,2266,180,2446,6
2022-02-08,Mendocino,045,87422,12553,12336,2746,15082,107
2022-02-08,Merced,047,269075,60360,59789,8081,67870,751
2022-02-08,Modoc,049,8938,703,684,231,915,6
2022-02-08,Mono,051,14174,2938,2932,118,3050,5
2022-02-08,Monterey,053,433212,76533,74316,12619,86935,670
2022-02-08,Napa,055,140530,24606,24346,901,25247,121
2022-02-08,Nevada,057,99092,15497,15383,1139,16522,117
2022-02-08,Orange,059,3164182,535206,533507,40162,573669,6205
2022-02-08,Placer,061,380077,61129,60301,7158,67459,553
2022-02-08,Plumas,063,18699,2876,2596,324,2920,13
2022-02-08,Riverside,065,2383286,580339,571892,27195,599087,5908
2022-02-08,Sacramento,067,1510023,272546,264479,25897,290376,2664
2022-02-08,San Benito,069,59416,12512,12434,499,12933,91
2022-02-08,San Bernardino,071,2135413,559854,544658,24536,569194,6335
2022-02-08,San Diego,073,3302833,729589,717896,50447,768343,4832
2022-02-08,San Francisco,075,870044,118648,117942,7973,125915,731
2022-02-08,San Joaquin,077,732212,161806,160147,9706,169853,2005
2022-02-08,San Luis Obispo,079,281455,50355,49556,3560,53116,410
2022-02-08,San Mateo,081,765935,117353,114541,6629,121170,589
2022-02-08,Santa Barbara,083,443738,83155,82461,4592,87053,627
2022-02-08,Santa Clara,085,1922200,298166,295679,11813,307492,2091
2022-02-08,Santa Cruz,087,273765,45047,43884,2056,45940,239
2022-02-08,Shasta,089,179085,29457,29084,5866,34950,470
2022-02-08,Sierra,091,2930,268,267,44,311,0
2022-02-08,Siskiyou,093,43540,4269,4191,2597,6788,68
2022-02-08,Solano,095,438530,78326,77031,5373,82404,421
2022-02-08,Sonoma,097,501317,80474,78798,2419,81217,431
2022-02-08,Stanislaus,099,539301,114289,113733,16809,130542,1406
2022-02-08,Sutter,101,95872,19870,19717,1941,21658,203
2022-02-08,Tehama,103,63373,11658,11491,2566,14057,149
2022-02-08,Trinity,105,12862,1137,1110,278,1388,20
2022-02-08,Tulare,107,460477,103398,99694,27201,126895,1267
2022-02-08,Tuolumne,109,53932,12221,11665,526,12191,92
2022-02-08,Ventura,111,848112,169169,167830,9230,177060,1325
2022-02-08,Yolo,113,214977,35628,34462,3017,37479,281
2022-02-08,Yuba,115,75493,15291,15126,1109,16235,107
2022-02-07,Alameda,001,1643700,245589,238678,13023,251701,1643
2022-02-07,Alpine,003,1148,120,124,1,125,0
2022-02-07,Amador,005,37829,8154,7980,600,8580,75
2022-02-07,Butte,007,227075,31801,31184,6384,37568,355
2022-02-07,Calaveras,009,45235,7031,6910,321,7231,100
2022-02-07,Colusa,011,21464,3349,3283,1040,4323,21
2022-02-07,Contra Costa,013,1133247,181728,177767,12335,190102,1130
2022-02-07,Del Norte,015,27424,5255,5093,155,5248,44
2022-02-07,El Dorado,017,186661,25966,25257,3111,28368,185
2022-02-07,Fresno,019,978130,222128,216495,22787,239282,2493
2022-02-07,Glenn,021,27897,4833,4762,1561,6323,39
2022-02-07,Humboldt,023,135768,15993,15764,2671,18435,129
2022-02-07,Imperial,025,180216,53806,52689,10252,62941,853
2022-02-07,Inyo,027,18085,3996,3976,439,4415,51
2022-02-07,Kern,029,883053,186579,182047,44548,226595,1998
2022-02-07,Kings,031,150075,49505,48147,3462,51609,403
2022-02-07,Lake,033,64148,9995,9519,821,10340,125
2022-02-07,Lassen,035,31185,8535,8362,852,9214,55
2022-02-07,Los Angeles,037,10098052,2648092,2607438,120877,2728315,29210
2022-02-07,Madera,039,155013,35891,35083,5700,40783,330
2022-02-07,Marin,041,260295,32122,31670,2107,33777,255
2022-02-07,Mariposa,043,17540,2286,2253,176,2429,6
2022-02-07,Mendocino,045,87422,12495,12237,2708,14945,107
2022-02-07,Merced,047,269075,60233,59472,7988,67460,748
2022-02-07,Modoc,049,8938,699,679,231,910,6
2022-02-07,Mono,051,14174,2936,2917,118,3035,5
2022-02-07,Monterey,053,433212,76279,69433,12510,81943,670
2022-02-07,Napa,055,140530,24520,23237,891,24128,120
2022-02-07,Nevada,057,99092,15462,15268,1133,16401,113
2022-02-07,Orange,059,3164182,534442,531442,40079,571521,6179
2022-02-07,Placer,061,380077,61005,59894,7143,67037,546
2022-02-07,Plumas,063,18699,2865,2573,315,2888,13
2022-02-07,Riverside,065,2383286,579395,568874,27109,595983,5868
2022-02-07,Sacramento,067,1510023,271867,262834,25705,288539,2631
2022-02-07,San Benito,069,59416,12474,12285,497,12782,90
2022-02-07,San Bernardino,071,2135413,559056,542846,24497,567343,6335
2022-02-07,San Diego,073,3302833,727869,716244,50264,766508,4811
2022-02-07,San Francisco,075,870044,118309,113945,7948,121893,727
2022-02-07,San Joaquin,077,732212,161424,159358,9686,169044,1998
2022-02-07,San Luis Obispo,079,281455,50185,48994,3539,52533,406
2022-02-07,San Mateo,081,765935,117068,107060,6600,113660,589
2022-02-07,Santa Barbara,083,443738,82967,81608,4577,86185,624
2022-02-07,Santa Clara,085,1922200,297213,293360,11765,305125,2085
2022-02-07,Santa Cruz,087,273765,44831,43244,2052,45296,239
2022-02-07,Shasta,089,179085,29366,28900,5839,34739,468
2022-02-07,Sierra,091,2930,268,265,44,309,0
2022-02-07,Siskiyou,093,43540,4258,4157,2581,6738,68
2022-02-07,Solano,095,438530,78069,73934,5347,79281,420
2022-02-07,Sonoma,097,501317,80217,78296,2406,80702,431
2022-02-07,Stanislaus,099,539301,114031,113029,16652,129681,1406
2022-02-07,Sutter,101,95872,19838,19599,1913,21512,203
2022-02-07,Tehama,103,63373,11617,11418,2558,13976,146
2022-02-07,Trinity,105,12862,1133,1109,275,1384,20
2022-02-07,Tulare,107,460477,103039,98774,27058,125832,1263
2022-02-07,Tuolumne,109,53932,12173,11578,522,12100,92
2022-02-07,Ventura,111,848112,168851,166904,9215,176119,1324
2022-02-07,Yolo,113,214977,35517,34007,3002,37009,281
2022-02-07,Yuba,115,75493,15244,14998,1102,16100,105
2022-02-06,Alameda,001,1643700,244677,237188,12938,250126,1643
2022-02-06,Alpine,003,1148,120,123,1,124,0
2022-02-06,Amador,005,37829,8124,7922,588,8510,73
2022-02-06,Butte,007,227075,31674,31021,6338,37359,355
2022-02-06,Calaveras,009,45235,7004,6870,316,7186,99
2022-02-06,Colusa,011,21464,3339,3282,1039,4321,21
2022-02-06,Contra Costa,013,1133247,181102,176863,12176,189039,1128
2022-02-06,Del Norte,015,27424,5199,5038,153,5191,44
2022-02-06,El Dorado,017,186661,25903,25165,3099,28264,185
2022-02-06,Fresno,019,978130,221283,214726,22526,237252,2489
2022-02-06,Glenn,021,27897,4820,4738,1551,6289,39
2022-02-06,Humboldt,023,135768,15909,15658,2631,18289,128
2022-02-06,Imperial,025,180216,53619,52396,10204,62600,853
2022-02-06,Inyo,027,18085,3994,3970,436,4406,51
2022-02-06,Kern,029,883053,186027,181188,44307,225495,1996
2022-02-06,Kings,031,150075,49282,47669,3436,51105,401
2022-02-06,Lake,033,64148,9926,9468,803,10271,125
2022-02-06,Lassen,035,31185,8515,8326,847,9173,55
2022-02-06,Los Angeles,037,10098052,2642560,2602620,120612,2723232,29180
2022-02-06,Madera,039,155013,35707,34901,5606,40507,330
2022-02-06,Marin,041,260295,32025,31488,2094,33582,255
2022-02-06,Mariposa,043,17540,2278,2244,165,2409,6
2022-02-06,Mendocino,045,87422,12452,12169,2638,14807,107
2022-02-06,Merced,047,269075,60015,59112,7825,66937,748
2022-02-06,Modoc,049,8938,694,675,230,905,6
2022-02-06,Mono,051,14174,2931,2901,116,3017,5
2022-02-06,Monterey,053,433212,75913,67912,12345,80257,670
2022-02-06,Napa,055,140530,24401,23230,883,24113,120
2022-02-06,Nevada,057,99092,15397,15192,1120,16312,113
2022-02-06,Orange,059,3164182,533489,527906,39977,567883,6171
2022-02-06,Placer,061,380077,60829,59507,7117,66624,544
2022-02-06,Plumas,063,18699,2851,2559,306,2865,13
2022-02-06,Riverside,065,2383286,578252,568276,27030,595306,5865
2022-02-06,Sacramento,067,1510023,270996,261353,25433,286786,2631
2022-02-06,San Benito,069,59416,12419,12186,489,12675,90
2022-02-06,San Bernardino,071,2135413,558073,541103,24426,565529,6334
2022-02-06,San Diego,073,3302833,725808,709938,50025,759963,4786
2022-02-06,San Francisco,075,870044,117926,113115,7921,121036,728
2022-02-06,San Joaquin,077,732212,160859,158510,9646,168156,1997
2022-02-06,San Luis Obispo,079,281455,49961,48843,3482,52325,405
2022-02-06,San Mateo,081,765935,116729,105556,6560,112116,587
2022-02-06,Santa Barbara,083,443738,82649,81118,4538,85656,623
2022-02-06,Santa Clara,085,1922200,296106,291732,11645,303377,2075
2022-02-06,Santa Cruz,087,273765,44518,42952,2037,44989,239
2022-02-06,Shasta,089,179085,29243,28762,5789,34551,468
2022-02-06,Sierra,091,2930,268,265,44,309,0
2022-02-06,Siskiyou,093,43540,4237,4118,2555,6673,68
2022-02-06,Solano,095,438530,77771,73475,5305,78780,419
2022-02-06,Sonoma,097,501317,79880,77887,2391,80278,431
2022-02-06,Stanislaus,099,539301,113634,112521,16504,129025,1406
2022-02-06,Sutter,101,95872,19795,19523,1870,21393,203
2022-02-06,Tehama,103,63373,11577,11366,2538,13904,146
2022-02-06,Trinity,105,12862,1132,1102,274,1376,20
2022-02-06,Tulare,107,460477,102602,98260,26854,125114,1262
2022-02-06,Tuolumne,109,53932,12121,11507,505,12012,92
2022-02-06,Ventura,111,848112,168475,166235,9204,175439,1323
2022-02-06,Yolo,113,214977,35378,33784,2986,36770,281
2022-02-06,Yuba,115,75493,15198,14917,1093,16010,104
2022-02-05,Alameda,001,1643700,244263,235698,12929,248627,1638
2022-02-05,Alpine,003,1148,120,124,1,125,0
2022-02-05,Amador,005,37829,8115,7855,585,8440,71
2022-02-05,Butte,007,227075,31620,30733,6324,37057,355
2022-02-05,Calaveras,009,45235,6988,6789,316,7105,99
2022-02-05,Colusa,011,21464,3332,3234,1037,4271,21
2022-02-05,Contra Costa,013,1133247,180833,175871,12160,188031,1115
2022-02-05,Del Norte,015,27424,5159,4978,151,5129,44
2022-02-05,El Dorado,017,186661,25872,24813,3097,27910,185
2022-02-05,Fresno,019,978130,220939,213539,22504,236043,2477
2022-02-05,Glenn,021,27897,4818,4691,1544,6235,39
2022-02-05,Humboldt,023,135768,15861,15514,2627,18141,127
2022-02-05,Imperial,025,180216,53556,52153,10191,62344,853
2022-02-05,Inyo,027,18085,3991,3948,436,4384,51
2022-02-05,Kern,029,883053,185818,180296,44202,224498,1987
2022-02-05,Kings,031,150075,49195,47538,3429,50967,402
2022-02-05,Lake,033,64148,9907,9289,796,10085,124
2022-02-05,Lassen,035,31185,8504,8288,845,9133,55
2022-02-05,Los Angeles,037,10098052,2640377,2572702,120485,2693187,28947
2022-02-05,Madera,039,155013,35654,34471,5594,40065,329
2022-02-05,Marin,041,260295,31978,31299,2090,33389,255
2022-02-05,Mariposa,043,17540,2277,2222,164,2386,6
2022-02-05,Mendocino,045,87422,12424,12066,2636,14702,107
2022-02-05,Merced,047,269075,59922,58908,7817,66725,744
2022-02-05,Modoc,049,8938,693,664,230,894,6
2022-02-05,Mono,051,14174,2930,2904,116,3020,5
2022-02-05,Monterey,053,433212,75797,67342,12301,79643,666
2022-02-05,Napa,055,140530,24345,22973,882,23855,118
2022-02-05,Nevada,057,99092,15376,15002,1115,16117,113
2022-02-05,Orange,059,3164182,533047,527516,39886,567402,6134
2022-02-05,Placer,061,380077,60704,59043,7103,66146,533
2022-02-05,Plumas,063,18699,2850,2550,305,2855,13
2022-02-05,Riverside,065,2383286,577648,563991,26959,590950,5827
2022-02-05,Sacramento,067,1510023,270601,259437,25395,284832,2610
2022-02-05,San Benito,069,59416,12374,12142,489,12631,90
2022-02-05,San Bernardino,071,2135413,557559,539312,24404,563716,6322
2022-02-05,San Diego,073,3302833,724948,703957,49952,753909,4735
2022-02-05,San Francisco,075,870044,117717,112481,7892,120373,720
2022-02-05,San Joaquin,077,732212,160673,157420,9635,167055,1989
2022-02-05,San Luis Obispo,079,281455,49924,48361,3480,51841,404
2022-02-05,San Mateo,081,765935,116541,104810,6552,111362,587
2022-02-05,Santa Barbara,083,443738,82486,80478,4526,85004,617
2022-02-05,Santa Clara,085,1922200,295451,289262,11629,300891,2067
2022-02-05,Santa Cruz,087,273765,44444,42553,2034,44587,239
2022-02-05,Shasta,089,179085,29200,28604,5779,34383,466
2022-02-05,Sierra,091,2930,268,262,44,306,0
2022-02-05,Siskiyou,093,43540,4230,4106,2542,6648,67
2022-02-05,Solano,095,438530,77696,73112,5297,78409,415
2022-02-05,Sonoma,097,501317,79713,77213,2387,79600,431
2022-02-05,Stanislaus,099,539301,113431,111783,16484,128267,1406
2022-02-05,Sutter,101,95872,19765,19406,1864,21270,203
2022-02-05,Tehama,103,63373,11558,11259,2531,13790,146
2022-02-05,Trinity,105,12862,1130,1085,274,1359,20
2022-02-05,Tulare,107,460477,102433,97414,26771,124185,1254
2022-02-05,Tuolumne,109,53932,12096,11409,502,11911,91
2022-02-05,Ventura,111,848112,168249,165532,9188,174720,1308
2022-02-05,Yolo,113,214977,35293,33614,2972,36586,281
2022-02-05,Yuba,115,75493,15167,14801,1085,15886,105
2022-02-04,Alameda,001,1643700,243775,235698,12919,248617,1638
2022-02-04,Alpine,003,1148,120,124,1,125,0
2022-02-04,Amador,005,37829,8099,7855,581,8436,71
2022-02-04,Butte,007,227075,31560,30733,6313,37046,355
2022-02-04,Calaveras,009,45235,6978,6789,314,7103,99
2022-02-04,Colusa,011,21464,3327,3234,1035,4269,21
2022-02-04,Contra Costa,013,1133247,180510,175871,12131,188002,1115
2022-02-04,Del Norte,015,27424,5139,4978,151,5129,44
2022-02-04,El Dorado,017,186661,25836,24813,3092,27905,185
2022-02-04,Fresno,019,978130,220458,213539,22472,236011,2477
2022-02-04,Glenn,021,27897,4809,4691,1541,6232,39
2022-02-04,Humboldt,023,135768,15834,15514,2624,18138,127
2022-02-04,Imperial,025,180216,53479,52153,10174,62327,853
2022-02-04,Inyo,027,18085,3988,3948,435,4383,51
2022-02-04,Kern,029,883053,185593,180296,44074,224370,1987
2022-02-04,Kings,031,150075,49119,47538,3422,50960,402
2022-02-04,Lake,033,64148,9885,9289,793,10082,124
2022-02-04,Lassen,035,31185,8481,8288,845,9133,55
2022-02-04,Los Angeles,037,10098052,2637740,2572702,120356,2693058,28947
2022-02-04,Madera,039,155013,35571,34471,5586,40057,329
2022-02-04,Marin,041,260295,31914,31299,2081,33380,255
2022-02-04,Mariposa,043,17540,2275,2222,162,2384,6
2022-02-04,Mendocino,045,87422,12393,12066,2634,14700,107
2022-02-04,Merced,047,269075,59841,58908,7807,66715,744
2022-02-04,Modoc,049,8938,693,664,230,894,6
2022-02-04,Mono,051,14174,2928,2904,116,3020,5
2022-02-04,Monterey,053,433212,75607,67342,12258,79600,666
2022-02-04,Napa,055,140530,24298,22973,878,23851,118
2022-02-04,Nevada,057,99092,15342,15002,1111,16113,113
2022-02-04,Orange,059,3164182,532497,527516,39829,567345,6134
2022-02-04,Placer,061,380077,60601,59043,7092,66135,533
2022-02-04,Plumas,063,18699,2843,2550,304,2854,13
2022-02-04,Riverside,065,2383286,576936,563991,26946,590937,5827
2022-02-04,Sacramento,067,1510023,270098,259437,25372,284809,2610
2022-02-04,San Benito,069,59416,12355,12142,487,12629,90
2022-02-04,San Bernardino,071,2135413,556978,539312,24382,563694,6322
2022-02-04,San Diego,073,3302833,723812,703957,49878,753835,4735
2022-02-04,San Francisco,075,870044,117475,112481,7867,120348,720
2022-02-04,San Joaquin,077,732212,160443,157420,9623,167043,1989
2022-02-04,San Luis Obispo,079,281455,49863,48361,3473,51834,404
2022-02-04,San Mateo,081,765935,116311,104810,6538,111348,587
2022-02-04,Santa Barbara,083,443738,82336,80478,4525,85003,617
2022-02-04,Santa Clara,085,1922200,294783,289262,11608,300870,2067
2022-02-04,Santa Cruz,087,273765,44239,42553,2030,44583,239
2022-02-04,Shasta,089,179085,29147,28604,5768,34372,466
2022-02-04,Sierra,091,2930,268,262,44,306,0
2022-02-04,Siskiyou,093,43540,4222,4106,2535,6641,67
2022-02-04,Solano,095,438530,77504,73112,5261,78373,415
2022-02-04,Sonoma,097,501317,79554,77213,2306,79519,431
2022-02-04,Stanislaus,099,539301,113250,111783,16457,128240,1406
2022-02-04,Sutter,101,95872,19741,19406,1857,21263,203
2022-02-04,Tehama,103,63373,11543,11259,2530,13789,146
2022-02-04,Trinity,105,12862,1129,1085,273,1358,20
2022-02-04,Tulare,107,460477,102247,97414,26688,124102,1254
2022-02-04,Tuolumne,109,53932,12083,11409,501,11910,91
2022-02-04,Ventura,111,848112,167980,165532,9180,174712,1308
2022-02-04,Yolo,113,214977,35199,33614,2965,36579,281
2022-02-04,Yuba,115,75493,15149,14801,1085,15886,105
2022-02-03,Alameda,001,1643700,243005,235698,12856,248554,1638
2022-02-03,Alpine,003,1148,120,124,1,125,0
2022-02-03,Amador,005,37829,8079,7855,576,8431,71
2022-02-03,Butte,007,227075,31452,30733,6285,37018,355
2022-02-03,Calaveras,009,45235,6948,6789,310,7099,99
2022-02-03,Colusa,011,21464,3314,3234,1033,4267,21
2022-02-03,Contra Costa,013,1133247,179916,175871,12030,187901,1115
2022-02-03,Del Norte,015,27424,5098,4978,148,5126,44
2022-02-03,El Dorado,017,186661,25764,24813,3086,27899,185
2022-02-03,Fresno,019,978130,219528,213539,22302,235841,2477
2022-02-03,Glenn,021,27897,4792,4691,1523,6214,39
2022-02-03,Humboldt,023,135768,15758,15514,2588,18102,127
2022-02-03,Imperial,025,180216,53335,52153,10123,62276,853
2022-02-03,Inyo,027,18085,3985,3948,431,4379,51
2022-02-03,Kern,029,883053,185130,180296,43858,224154,1987
2022-02-03,Kings,031,150075,48962,47538,3414,50952,402
2022-02-03,Lake,033,64148,9831,9289,787,10076,124
2022-02-03,Lassen,035,31185,8457,8288,844,9132,55
2022-02-03,Los Angeles,037,10098052,2632302,2572702,120091,2692793,28947
2022-02-03,Madera,039,155013,35434,34471,5540,40011,329
2022-02-03,Marin,041,260295,31818,31299,2076,33375,255
2022-02-03,Mariposa,043,17540,2263,2222,159,2381,6
2022-02-03,Mendocino,045,87422,12349,12066,2610,14676,107
2022-02-03,Merced,047,269075,59690,58908,7711,66619,744
2022-02-03,Modoc,049,8938,690,664,230,894,6
2022-02-03,Mono,051,14174,2923,2904,115,3019,5
2022-02-03,Monterey,053,433212,75320,67342,12060,79402,666
2022-02-03,Napa,055,140530,24164,22973,878,23851,118
2022-02-03,Nevada,057,99092,15301,15002,1100,16102,113
2022-02-03,Orange,059,3164182,531573,527516,39736,567252,6134
2022-02-03,Placer,061,380077,60404,59043,7069,66112,533
2022-02-03,Plumas,063,18699,2829,2550,300,2850,13
2022-02-03,Riverside,065,2383286,575737,563991,26874,590865,5827
2022-02-03,Sacramento,067,1510023,269142,259437,25179,284616,2610
2022-02-03,San Benito,069,59416,12328,12142,484,12626,90
2022-02-03,San Bernardino,071,2135413,555962,539312,24342,563654,6322
2022-02-03,San Diego,073,3302833,721842,703957,49716,753673,4735
2022-02-03,San Francisco,075,870044,117140,112481,7836,120317,720
2022-02-03,San Joaquin,077,732212,159961,157420,9594,167014,1989
2022-02-03,San Luis Obispo,079,281455,49666,48361,3456,51817,404
2022-02-03,San Mateo,081,765935,115959,104810,6504,111314,587
2022-02-03,Santa Barbara,083,443738,81978,80478,4496,84974,617
2022-02-03,Santa Clara,085,1922200,293619,289262,11497,300759,2067
2022-02-03,Santa Cruz,087,273765,43899,42553,2023,44576,239
2022-02-03,Shasta,089,179085,29042,28604,5740,34344,466
2022-02-03,Sierra,091,2930,268,262,44,306,0
2022-02-03,Siskiyou,093,43540,4207,4106,2518,6624,67
2022-02-03,Solano,095,438530,77175,73112,5243,78355,415
2022-02-03,Sonoma,097,501317,79257,77213,2299,79512,431
2022-02-03,Stanislaus,099,539301,112872,111783,16370,128153,1406
2022-02-03,Sutter,101,95872,19689,19406,1838,21244,203
2022-02-03,Tehama,103,63373,11512,11259,2522,13781,146
2022-02-03,Trinity,105,12862,1127,1085,272,1357,20
2022-02-03,Tulare,107,460477,101838,97414,26541,123955,1254
2022-02-03,Tuolumne,109,53932,12042,11409,489,11898,91
2022-02-03,Ventura,111,848112,167595,165532,9169,174701,1308
2022-02-03,Yolo,113,214977,35090,33614,2952,36566,281
2022-02-03,Yuba,115,75493,15099,14801,1069,15870,105
2022-02-02,Alameda,001,1643700,242059,234300,12752,247052,1632
2022-02-02,Alpine,003,1148,120,123,1,124,0
2022-02-02,Amador,005,37829,8049,7781,566,8347,71
2022-02-02,Butte,007,227075,31343,30550,6254,36804,355
2022-02-02,Calaveras,009,45235,6922,6753,306,7059,99
2022-02-02,Colusa,011,21464,3299,3211,1032,4243,21
2022-02-02,Contra Costa,013,1133247,179326,174876,11933,186809,1113
2022-02-02,Del Norte,015,27424,5058,4924,143,5067,44
2022-02-02,El Dorado,017,186661,25697,24690,3067,27757,185
2022-02-02,Fresno,019,978130,218515,211976,22169,234145,2463
2022-02-02,Glenn,021,27897,4768,4667,1513,6180,39
2022-02-02,Humboldt,023,135768,15697,15392,2549,17941,127
2022-02-02,Imperial,025,180216,53139,51875,9995,61870,853
2022-02-02,Inyo,027,18085,3979,3944,430,4374,51
2022-02-02,Kern,029,883053,184532,179386,43639,223025,1974
2022-02-02,Kings,031,150075,48771,47061,3388,50449,401
2022-02-02,Lake,033,64148,9773,9235,780,10015,120
2022-02-02,Lassen,035,31185,8444,8258,835,9093,55
2022-02-02,Los Angeles,037,10098052,2626079,2561902,119702,2681604,28850
2022-02-02,Madera,039,155013,35266,34265,5466,39731,329
2022-02-02,Marin,041,260295,31715,31149,2066,33215,255
2022-02-02,Mariposa,043,17540,2252,2215,155,2370,6
2022-02-02,Mendocino,045,87422,12296,11996,2570,14566,105
2022-02-02,Merced,047,269075,59517,58532,7624,66156,744
2022-02-02,Modoc,049,8938,684,662,230,892,6
2022-02-02,Mono,051,14174,2912,2887,115,3002,5
2022-02-02,Monterey,053,433212,74929,66852,11872,78724,666
2022-02-02,Napa,055,140530,24043,22859,865,23724,117
2022-02-02,Nevada,057,99092,15243,14895,1076,15971,112
2022-02-02,Orange,059,3164182,530517,524418,39642,564060,6127
2022-02-02,Placer,061,380077,60211,58654,7038,65692,533
2022-02-02,Plumas,063,18699,2813,2540,296,2836,12
2022-02-02,Riverside,065,2383286,574458,561220,26826,588046,5827
2022-02-02,Sacramento,067,1510023,268133,258078,24965,283043,2602
2022-02-02,San Benito,069,59416,12289,12058,480,12538,90
2022-02-02,San Bernardino,071,2135413,554952,537485,24276,561761,6317
2022-02-02,San Diego,073,3302833,719642,703957,49535,753492,4735
2022-02-02,San Francisco,075,870044,116771,112008,7820,119828,714
2022-02-02,San Joaquin,077,732212,159385,156537,9570,166107,1986
2022-02-02,San Luis Obispo,079,281455,49468,48119,3443,51562,403
2022-02-02,San Mateo,081,765935,115587,104201,6436,110637,587
2022-02-02,Santa Barbara,083,443738,81635,79979,4465,84444,612
2022-02-02,Santa Clara,085,1922200,292474,287443,11382,298825,2051
2022-02-02,Santa Cruz,087,273765,43609,42127,2012,44139,239
2022-02-02,Shasta,089,179085,28940,28429,5695,34124,465
2022-02-02,Sierra,091,2930,268,262,44,306,0
2022-02-02,Siskiyou,093,43540,4197,4078,2491,6569,67
2022-02-02,Solano,095,438530,76821,72711,5219,77930,414
2022-02-02,Sonoma,097,501317,78945,76681,2286,78967,431
2022-02-02,Stanislaus,099,539301,112477,111167,16237,127404,1403
2022-02-02,Sutter,101,95872,19624,19290,1809,21099,203
2022-02-02,Tehama,103,63373,11456,11193,2503,13696,146
2022-02-02,Trinity,105,12862,1124,1074,270,1344,20
2022-02-02,Tulare,107,460477,101446,96820,26367,123187,1249
2022-02-02,Tuolumne,109,53932,11965,11342,486,11828,91
2022-02-02,Ventura,111,848112,167196,164905,9150,174055,1292
2022-02-02,Yolo,113,214977,34968,33332,2929,36261,281
2022-02-02,Yuba,115,75493,15034,14720,1061,15781,104
2022-02-01,Alameda,001,1643700,240981,233782,12647,246429,1620
2022-02-01,Alpine,003,1148,120,123,1,124,0
2022-02-01,Amador,005,37829,8003,7783,560,8343,73
2022-02-01,Butte,007,227075,31205,30496,6216,36712,355
2022-02-01,Calaveras,009,45235,6885,6749,302,7051,98
2022-02-01,Colusa,011,21464,3283,3202,1010,4212,21
2022-02-01,Contra Costa,013,1133247,178592,174379,11792,186171,1115
2022-02-01,Del Norte,015,27424,5012,4907,140,5047,44
2022-02-01,El Dorado,017,186661,25638,24664,3050,27714,184
2022-02-01,Fresno,019,978130,217352,211352,22006,233358,2464
2022-02-01,Glenn,021,27897,4754,4649,1503,6152,39
2022-02-01,Humboldt,023,135768,15615,15354,2519,17873,127
2022-02-01,Imperial,025,180216,52924,51675,9928,61603,846
2022-02-01,Inyo,027,18085,3969,3928,427,4355,51
2022-02-01,Kern,029,883053,183885,178987,43392,222379,1967
2022-02-01,Kings,031,150075,48512,46959,3364,50323,400
2022-02-01,Lake,033,64148,9716,9211,773,9984,119
2022-02-01,Lassen,035,31185,8426,8231,830,9061,55
2022-02-01,Los Angeles,037,10098052,2618890,2548794,119323,2668117,28752
2022-02-01,Madera,039,155013,35045,34124,5385,39509,329
2022-02-01,Marin,041,260295,31593,31099,2050,33149,255
2022-02-01,Mariposa,043,17540,2245,2210,154,2364,6
2022-02-01,Mendocino,045,87422,12234,11978,2533,14511,105
2022-02-01,Merced,047,269075,59332,58362,7499,65861,743
2022-02-01,Modoc,049,8938,677,664,230,894,6
2022-02-01,Mono,051,14174,2906,2888,115,3003,5
2022-02-01,Monterey,053,433212,74508,66553,11670,78223,665
2022-02-01,Napa,055,140530,23944,22795,849,23644,116
2022-02-01,Nevada,057,99092,15182,14863,1063,15926,112
2022-02-01,Orange,059,3164182,529367,523741,39498,563239,6108
2022-02-01,Placer,061,380077,59964,58486,6998,65484,532
2022-02-01,Plumas,063,18699,2798,2526,293,2819,12
2022-02-01,Riverside,065,2383286,573068,560010,26777,586787,5825
2022-02-01,Sacramento,067,1510023,267079,257504,24687,282191,2593
2022-02-01,San Benito,069,59416,12223,12053,477,12530,90
2022-02-01,San Bernardino,071,2135413,553692,536591,24210,560801,6311
2022-02-01,San Diego,073,3302833,717123,701009,49317,750326,4710
2022-02-01,San Francisco,075,870044,116305,111606,7801,119407,713
2022-02-01,San Joaquin,077,732212,158855,156300,9547,165847,1987
2022-02-01,San Luis Obispo,079,281455,49239,47842,3381,51223,403
2022-02-01,San Mateo,081,765935,115119,103868,6394,110262,589
2022-02-01,Santa Barbara,083,443738,81190,79659,4429,84088,608
2022-02-01,Santa Clara,085,1922200,290953,286109,11276,297385,2070
2022-02-01,Santa Cruz,087,273765,43310,41782,1996,43778,239
2022-02-01,Shasta,089,179085,28821,28382,5642,34024,465
2022-02-01,Sierra,091,2930,266,262,44,306,0
2022-02-01,Siskiyou,093,43540,4183,4072,2464,6536,66
2022-02-01,Solano,095,438530,76549,72494,5202,77696,415
2022-02-01,Sonoma,097,501317,78584,76379,2262,78641,431
2022-02-01,Stanislaus,099,539301,112065,110925,16132,127057,1403
2022-02-01,Sutter,101,95872,19556,19256,1776,21032,202
2022-02-01,Tehama,103,63373,11399,11165,2489,13654,146
2022-02-01,Trinity,105,12862,1120,1073,270,1343,19
2022-02-01,Tulare,107,460477,100954,96467,26147,122614,1247
2022-02-01,Tuolumne,109,53932,11915,11318,477,11795,91
2022-02-01,Ventura,111,848112,166691,164721,9126,173847,1293
2022-02-01,Yolo,113,214977,34819,33257,2900,36157,275
2022-02-01,Yuba,115,75493,14973,14693,1054,15747,103
2022-01-31,Alameda,001,1643700,239630,232743,12528,245271,1607
2022-01-31,Alpine,003,1148,119,123,1,124,0
2022-01-31,Amador,005,37829,7949,7682,543,8225,73
2022-01-31,Butte,007,227075,31043,30371,6177,36548,354
2022-01-31,Calaveras,009,45235,6850,6700,291,6991,96
2022-01-31,Colusa,011,21464,3271,3187,1001,4188,21
2022-01-31,Contra Costa,013,1133247,177794,173466,11664,185130,1115
2022-01-31,Del Norte,015,27424,4979,4879,136,5015,43
2022-01-31,El Dorado,017,186661,25535,24545,3020,27565,184
2022-01-31,Fresno,019,978130,215867,210589,21800,232389,2464
2022-01-31,Glenn,021,27897,4718,4641,1491,6132,39
2022-01-31,Humboldt,023,135768,15526,15308,2486,17794,126
2022-01-31,Imperial,025,180216,52708,51472,9812,61284,846
2022-01-31,Inyo,027,18085,3958,3922,421,4343,50
2022-01-31,Kern,029,883053,183104,178375,43065,221440,1967
2022-01-31,Kings,031,150075,48155,46845,3330,50175,398
2022-01-31,Lake,033,64148,9643,9141,761,9902,119
2022-01-31,Lassen,035,31185,8395,8162,824,8986,55
2022-01-31,Los Angeles,037,10098052,2610637,2541189,118915,2660104,28718
2022-01-31,Madera,039,155013,34829,33886,5289,39175,329
2022-01-31,Marin,041,260295,31468,31023,2033,33056,253
2022-01-31,Mariposa,043,17540,2235,2203,145,2348,6
2022-01-31,Mendocino,045,87422,12168,11896,2490,14386,104
2022-01-31,Merced,047,269075,59054,58198,7307,65505,740
2022-01-31,Modoc,049,8938,674,661,230,891,6
2022-01-31,Mono,051,14174,2892,2889,115,3004,5
2022-01-31,Monterey,053,433212,74057,66117,11448,77565,661
2022-01-31,Napa,055,140530,23776,22707,832,23539,113
2022-01-31,Nevada,057,99092,15106,14813,1050,15863,112
2022-01-31,Orange,059,3164182,528043,522358,39362,561720,6098
2022-01-31,Placer,061,380077,59716,58252,6965,65217,523
2022-01-31,Plumas,063,18699,2785,2513,291,2804,12
2022-01-31,Riverside,065,2383286,571251,558166,26710,584876,5785
2022-01-31,Sacramento,067,1510023,265784,256594,24425,281019,2571
2022-01-31,San Benito,069,59416,12164,11976,476,12452,90
2022-01-31,San Bernardino,071,2135413,552053,535276,24122,559398,6302
2022-01-31,San Diego,073,3302833,714216,698571,49056,747627,4686
2022-01-31,San Francisco,075,870044,115896,111119,7767,118886,712
2022-01-31,San Joaquin,077,732212,158097,155736,9514,165250,1985
2022-01-31,San Luis Obispo,079,281455,48985,47656,3322,50978,395
2022-01-31,San Mateo,081,765935,114607,103313,6334,109647,589
2022-01-31,Santa Barbara,083,443738,80682,79267,4387,83654,606
2022-01-31,Santa Clara,085,1922200,289277,284562,11168,295730,2041
2022-01-31,Santa Cruz,087,273765,42931,41630,1989,43619,239
2022-01-31,Shasta,089,179085,28690,28190,5601,33791,462
2022-01-31,Sierra,091,2930,266,261,44,305,0
2022-01-31,Siskiyou,093,43540,4167,4054,2448,6502,66
2022-01-31,Solano,095,438530,75843,72258,5156,77414,414
2022-01-31,Sonoma,097,501317,78130,76199,2229,78428,431
2022-01-31,Stanislaus,099,539301,111538,110493,15961,126454,1403
2022-01-31,Sutter,101,95872,19476,19189,1723,20912,202
2022-01-31,Tehama,103,63373,11337,11112,2459,13571,145
2022-01-31,Trinity,105,12862,1115,1071,267,1338,19
2022-01-31,Tulare,107,460477,100311,96053,25891,121944,1245
2022-01-31,Tuolumne,109,53932,11824,11278,470,11748,91
2022-01-31,Ventura,111,848112,166155,164060,9099,173159,1286
2022-01-31,Yolo,113,214977,34659,33175,2875,36050,274
2022-01-31,Yuba,115,75493,14910,14652,1034,15686,103
2022-01-30,Alameda,001,1643700,238084,231838,12376,244214,1607
2022-01-30,Alpine,003,1148,119,123,1,124,0
2022-01-30,Amador,005,37829,7898,7644,519,8163,73
2022-01-30,Butte,007,227075,30841,30255,6110,36365,354
2022-01-30,Calaveras,009,45235,6795,6676,277,6953,96
2022-01-30,Colusa,011,21464,3251,3168,989,4157,21
2022-01-30,Contra Costa,013,1133247,176845,172902,11459,184361,1102
2022-01-30,Del Norte,015,27424,4938,4833,133,4966,43
2022-01-30,El Dorado,017,186661,25414,24491,2993,27484,184
2022-01-30,Fresno,019,978130,214305,209645,21538,231183,2463
2022-01-30,Glenn,021,27897,4687,4619,1481,6100,39
2022-01-30,Humboldt,023,135768,15414,15247,2429,17676,126
2022-01-30,Imperial,025,180216,52382,51415,9637,61052,846
2022-01-30,Inyo,027,18085,3941,3921,418,4339,50
2022-01-30,Kern,029,883053,182238,177924,42740,220664,1967
2022-01-30,Kings,031,150075,47803,46654,3271,49925,398
2022-01-30,Lake,033,64148,9554,9080,740,9820,119
2022-01-30,Lassen,035,31185,8371,8158,816,8974,55
2022-01-30,Los Angeles,037,10098052,2600497,2530739,118432,2649171,28678
2022-01-30,Madera,039,155013,34529,33752,5101,38853,329
2022-01-30,Marin,041,260295,31320,30875,2019,32894,253
2022-01-30,Mariposa,043,17540,2223,2177,139,2316,6
2022-01-30,Mendocino,045,87422,12095,11860,2384,14244,104
2022-01-30,Merced,047,269075,58689,58006,7012,65018,740
2022-01-30,Modoc,049,8938,671,661,230,891,6
2022-01-30,Mono,051,14174,2886,2888,115,3003,5
2022-01-30,Monterey,053,433212,73470,65996,11163,77159,661
2022-01-30,Napa,055,140530,23608,22588,815,23403,114
2022-01-30,Nevada,057,99092,15018,14741,1034,15775,112
2022-01-30,Orange,059,3164182,526411,521334,39214,560548,6098
2022-01-30,Placer,061,380077,59386,58030,6924,64954,523
2022-01-30,Plumas,063,18699,2760,2510,277,2787,12
2022-01-30,Riverside,065,2383286,569184,557088,26608,583696,5767
2022-01-30,Sacramento,067,1510023,264323,255715,23919,279634,2572
2022-01-30,San Benito,069,59416,12098,11945,471,12416,90
2022-01-30,San Bernardino,071,2135413,550317,534050,24012,558062,6302
2022-01-30,San Diego,073,3302833,710678,687145,48632,735777,4665
2022-01-30,San Francisco,075,870044,115348,110772,7732,118504,712
2022-01-30,San Joaquin,077,732212,157112,155165,9479,164644,1985
2022-01-30,San Luis Obispo,079,281455,48587,47599,3284,50883,394
2022-01-30,San Mateo,081,765935,114032,102979,6287,109266,589
2022-01-30,Santa Barbara,083,443738,80005,79072,4326,83398,606
2022-01-30,Santa Clara,085,1922200,287315,282846,11037,293883,2035
2022-01-30,Santa Cruz,087,273765,42472,41330,1979,43309,239
2022-01-30,Shasta,089,179085,28530,28105,5515,33620,462
2022-01-30,Sierra,091,2930,266,261,44,305,0
2022-01-30,Siskiyou,093,43540,4137,4039,2401,6440,66
2022-01-30,Solano,095,438530,75319,71857,5108,76965,414
2022-01-30,Sonoma,097,501317,77612,75890,2201,78091,431
2022-01-30,Stanislaus,099,539301,110881,110111,15759,125870,1403
2022-01-30,Sutter,101,95872,19384,19108,1626,20734,202
2022-01-30,Tehama,103,63373,11265,11071,2429,13500,145
2022-01-30,Trinity,105,12862,1109,1068,267,1335,19
2022-01-30,Tulare,107,460477,99566,95676,25597,121273,1245
2022-01-30,Tuolumne,109,53932,11717,11242,433,11675,91
2022-01-30,Ventura,111,848112,165575,163521,9069,172590,1286
2022-01-30,Yolo,113,214977,34441,33043,2842,35885,274
2022-01-30,Yuba,115,75493,14820,14584,1014,15598,103
2022-01-29,Alameda,001,1643700,237409,225602,12359,237961,1605
2022-01-29,Alpine,003,1148,119,123,1,124,0
2022-01-29,Amador,005,37829,7876,7505,516,8021,73
2022-01-29,Butte,007,227075,30756,29557,6085,35642,353
2022-01-29,Calaveras,009,45235,6776,6484,277,6761,96
2022-01-29,Colusa,011,21464,3246,3107,985,4092,21
2022-01-29,Contra Costa,013,1133247,176322,168003,11429,179432,1101
2022-01-29,Del Norte,015,27424,4920,4589,130,4719,43
2022-01-29,El Dorado,017,186661,25371,24008,2986,26994,184
2022-01-29,Fresno,019,978130,213848,202691,21496,224187,2457
2022-01-29,Glenn,021,27897,4680,4516,1474,5990,39
2022-01-29,Humboldt,023,135768,15367,14812,2422,17234,126
2022-01-29,Imperial,025,180216,52266,50153,9581,59734,845
2022-01-29,Inyo,027,18085,3939,3895,410,4305,50
2022-01-29,Kern,029,883053,181898,174456,42573,217029,1962
2022-01-29,Kings,031,150075,47685,45047,3264,48311,397
2022-01-29,Lake,033,64148,9521,8747,736,9483,119
2022-01-29,Lassen,035,31185,8350,7961,813,8774,55
2022-01-29,Los Angeles,037,10098052,2596570,2473332,118164,2591496,28467
2022-01-29,Madera,039,155013,34419,32753,5071,37824,329
2022-01-29,Marin,041,260295,31255,30137,2017,32154,253
2022-01-29,Mariposa,043,17540,2221,2117,137,2254,6
2022-01-29,Mendocino,045,87422,12071,11591,2368,13959,104
2022-01-29,Merced,047,269075,58582,56472,7007,63479,735
2022-01-29,Modoc,049,8938,671,654,230,884,6
2022-01-29,Mono,051,14174,2884,2860,115,2975,5
2022-01-29,Monterey,053,433212,73315,64090,11098,75188,658
2022-01-29,Napa,055,140530,23551,22121,813,22934,113
2022-01-29,Nevada,057,99092,14984,14337,1031,15368,112
2022-01-29,Orange,059,3164182,525706,511255,39107,550362,6038
2022-01-29,Placer,061,380077,59193,56562,6908,63470,523
2022-01-29,Plumas,063,18699,2750,2463,273,2736,12
2022-01-29,Riverside,065,2383286,568161,548121,26566,574687,5726
2022-01-29,Sacramento,067,1510023,263677,249130,23872,273002,2558
2022-01-29,San Benito,069,59416,12041,11670,470,12140,90
2022-01-29,San Bernardino,071,2135413,549566,525249,23968,549217,6297
2022-01-29,San Diego,073,3302833,709345,683027,48534,731561,4643
2022-01-29,San Francisco,075,870044,115073,108265,7684,115949,712
2022-01-29,San Joaquin,077,732212,156867,150849,9457,160306,1971
2022-01-29,San Luis Obispo,079,281455,48497,46374,3280,49654,391
2022-01-29,San Mateo,081,765935,113695,100306,6264,106570,586
2022-01-29,Santa Barbara,083,443738,79783,76546,4320,80866,604
2022-01-29,Santa Clara,085,1922200,286378,273879,11009,284888,2019
2022-01-29,Santa Cruz,087,273765,42341,39228,1977,41205,240
2022-01-29,Shasta,089,179085,28470,27504,5501,33005,452
2022-01-29,Sierra,091,2930,266,260,43,303,0
2022-01-29,Siskiyou,093,43540,4127,3987,2394,6381,66
2022-01-29,Solano,095,438530,75176,69862,5096,74958,407
2022-01-29,Sonoma,097,501317,77398,73439,2196,75635,427
2022-01-29,Stanislaus,099,539301,110633,107668,15712,123380,1403
2022-01-29,Sutter,101,95872,19336,18797,1609,20406,202
2022-01-29,Tehama,103,63373,11230,10880,2420,13300,145
2022-01-29,Trinity,105,12862,1106,1033,266,1299,19
2022-01-29,Tulare,107,460477,99310,93154,25519,118673,1237
2022-01-29,Tuolumne,109,53932,11692,10806,425,11231,91
2022-01-29,Ventura,111,848112,165245,160466,9050,169516,1271
2022-01-29,Yolo,113,214977,34327,32123,2826,34949,275
2022-01-29,Yuba,115,75493,14779,14295,1012,15307,103
2022-01-28,Alameda,001,1643700,236462,225602,12341,237943,1605
2022-01-28,Alpine,003,1148,119,123,1,124,0
2022-01-28,Amador,005,37829,7850,7505,515,8020,73
2022-01-28,Butte,007,227075,30680,29557,6066,35623,353
2022-01-28,Calaveras,009,45235,6758,6484,276,6760,96
2022-01-28,Colusa,011,21464,3241,3107,983,4090,21
2022-01-28,Contra Costa,013,1133247,175800,168003,11392,179395,1101
2022-01-28,Del Norte,015,27424,4896,4589,129,4718,43
2022-01-28,El Dorado,017,186661,25324,24008,2980,26988,184
2022-01-28,Fresno,019,978130,212978,202691,21439,224130,2457
2022-01-28,Glenn,021,27897,4667,4516,1472,5988,39
2022-01-28,Humboldt,023,135768,15331,14812,2412,17224,126
2022-01-28,Imperial,025,180216,52137,50153,9549,59702,845
2022-01-28,Inyo,027,18085,3935,3895,407,4302,50
2022-01-28,Kern,029,883053,181487,174456,42414,216870,1962
2022-01-28,Kings,031,150075,47554,45047,3254,48301,397
2022-01-28,Lake,033,64148,9489,8747,734,9481,119
2022-01-28,Lassen,035,31185,8280,7961,811,8772,55
2022-01-28,Los Angeles,037,10098052,2590837,2473332,117949,2591281,28467
2022-01-28,Madera,039,155013,34291,32753,5054,37807,329
2022-01-28,Marin,041,260295,31162,30137,1995,32132,253
2022-01-28,Mariposa,043,17540,2211,2117,135,2252,6
2022-01-28,Mendocino,045,87422,12027,11591,2366,13957,104
2022-01-28,Merced,047,269075,58485,56472,6992,63464,735
2022-01-28,Modoc,049,8938,670,654,230,884,6
2022-01-28,Mono,051,14174,2879,2860,114,2974,5
2022-01-28,Monterey,053,433212,73113,64090,11049,75139,658
2022-01-28,Napa,055,140530,23473,22121,811,22932,113
2022-01-28,Nevada,057,99092,14947,14337,1029,15366,112
2022-01-28,Orange,059,3164182,524637,511255,39017,550272,6038
2022-01-28,Placer,061,380077,58989,56562,6885,63447,523
2022-01-28,Plumas,063,18699,2742,2463,271,2734,12
2022-01-28,Riverside,065,2383286,566838,548121,26525,574646,5726
2022-01-28,Sacramento,067,1510023,262896,249130,23818,272948,2558
2022-01-28,San Benito,069,59416,12019,11670,465,12135,90
2022-01-28,San Bernardino,071,2135413,548529,525249,23929,549178,6297
2022-01-28,San Diego,073,3302833,707523,683027,48458,731485,4643
2022-01-28,San Francisco,075,870044,114718,108265,7635,115900,712
2022-01-28,San Joaquin,077,732212,156578,150849,9443,160292,1971
2022-01-28,San Luis Obispo,079,281455,48413,46374,3272,49646,391
2022-01-28,San Mateo,081,765935,113343,100306,6242,106548,586
2022-01-28,Santa Barbara,083,443738,79534,76546,4318,80864,604
2022-01-28,Santa Clara,085,1922200,285194,273879,10960,284839,2019
2022-01-28,Santa Cruz,087,273765,42149,39228,1964,41192,240
2022-01-28,Shasta,089,179085,28410,27504,5487,32991,452
2022-01-28,Sierra,091,2930,266,260,43,303,0
2022-01-28,Siskiyou,093,43540,4117,3987,2390,6377,66
2022-01-28,Solano,095,438530,74623,69862,5029,74891,407
2022-01-28,Sonoma,097,501317,77192,73439,2187,75626,427
2022-01-28,Stanislaus,099,539301,110361,107668,15670,123338,1403
2022-01-28,Sutter,101,95872,19291,18797,1607,20404,202
2022-01-28,Tehama,103,63373,11198,10880,2413,13293,145
2022-01-28,Trinity,105,12862,1097,1033,266,1299,19
2022-01-28,Tulare,107,460477,99034,93154,25410,118564,1237
2022-01-28,Tuolumne,109,53932,11659,10806,421,11227,91
2022-01-28,Ventura,111,848112,164790,160466,9029,169495,1271
2022-01-28,Yolo,113,214977,34222,32123,2818,34941,275
2022-01-28,Yuba,115,75493,14740,14295,1007,15302,103
2022-01-27,Alameda,001,1643700,234881,225602,12205,237807,1605
2022-01-27,Alpine,003,1148,119,123,1,124,0
2022-01-27,Amador,005,37829,7803,7505,503,8008,73
2022-01-27,Butte,007,227075,30528,29557,6014,35571,353
2022-01-27,Calaveras,009,45235,6732,6484,260,6744,96
2022-01-27,Colusa,011,21464,3226,3107,979,4086,21
2022-01-27,Contra Costa,013,1133247,174794,168003,11218,179221,1101
2022-01-27,Del Norte,015,27424,4852,4589,125,4714,43
2022-01-27,El Dorado,017,186661,25213,24008,2960,26968,184
2022-01-27,Fresno,019,978130,211349,202691,21222,223913,2457
2022-01-27,Glenn,021,27897,4636,4516,1464,5980,39
2022-01-27,Humboldt,023,135768,15243,14812,2375,17187,126
2022-01-27,Imperial,025,180216,51868,50153,9435,59588,845
2022-01-27,Inyo,027,18085,3928,3895,397,4292,50
2022-01-27,Kern,029,883053,180707,174456,42049,216505,1962
2022-01-27,Kings,031,150075,47211,45047,3215,48262,397
2022-01-27,Lake,033,64148,9436,8747,717,9464,119
2022-01-27,Lassen,035,31185,8239,7961,805,8766,55
2022-01-27,Los Angeles,037,10098052,2579681,2473332,117433,2590765,28467
2022-01-27,Madera,039,155013,34081,32753,4947,37700,329
2022-01-27,Marin,041,260295,30999,30137,1980,32117,253
2022-01-27,Mariposa,043,17540,2188,2117,132,2249,6
2022-01-27,Mendocino,045,87422,11976,11591,2317,13908,104
2022-01-27,Merced,047,269075,58224,56472,6827,63299,735
2022-01-27,Modoc,049,8938,668,654,229,883,6
2022-01-27,Mono,051,14174,2874,2860,114,2974,5
2022-01-27,Monterey,053,433212,72492,64090,10794,74884,658
2022-01-27,Napa,055,140530,23316,22121,783,22904,113
2022-01-27,Nevada,057,99092,14874,14337,1001,15338,112
2022-01-27,Orange,059,3164182,522911,511255,38881,550136,6038
2022-01-27,Placer,061,380077,58672,56562,6831,63393,523
2022-01-27,Plumas,063,18699,2731,2463,259,2722,12
2022-01-27,Riverside,065,2383286,564663,548121,26454,574575,5726
2022-01-27,Sacramento,067,1510023,261616,249130,23486,272616,2558
2022-01-27,San Benito,069,59416,11964,11670,460,12130,90
2022-01-27,San Bernardino,071,2135413,546634,525249,23828,549077,6297
2022-01-27,San Diego,073,3302833,704177,683027,48103,731130,4643
2022-01-27,San Francisco,075,870044,114213,108265,7574,115839,712
2022-01-27,San Joaquin,077,732212,155720,150849,9374,160223,1971
2022-01-27,San Luis Obispo,079,281455,48142,46374,3234,49608,391
2022-01-27,San Mateo,081,765935,112760,100306,6173,106479,586
2022-01-27,Santa Barbara,083,443738,79055,76546,4262,80808,604
2022-01-27,Santa Clara,085,1922200,283133,273879,10811,284690,2019
2022-01-27,Santa Cruz,087,273765,41484,39228,1945,41173,240
2022-01-27,Shasta,089,179085,28284,27504,5438,32942,452
2022-01-27,Sierra,091,2930,265,260,42,302,0
2022-01-27,Siskiyou,093,43540,4096,3987,2353,6340,66
2022-01-27,Solano,095,438530,73985,69862,4978,74840,407
2022-01-27,Sonoma,097,501317,76725,73439,2174,75613,427
2022-01-27,Stanislaus,099,539301,109834,107668,15523,123191,1403
2022-01-27,Sutter,101,95872,19186,18797,1582,20379,202
2022-01-27,Tehama,103,63373,11145,10880,2397,13277,145
2022-01-27,Trinity,105,12862,1093,1033,265,1298,19
2022-01-27,Tulare,107,460477,98367,93154,25127,118281,1237
2022-01-27,Tuolumne,109,53932,11605,10806,412,11218,91
2022-01-27,Ventura,111,848112,164138,160466,8994,169460,1271
2022-01-27,Yolo,113,214977,34078,32123,2800,34923,275
2022-01-27,Yuba,115,75493,14662,14295,991,15286,103
2022-01-26,Alameda,001,1643700,232986,222680,12034,234714,1596
2022-01-26,Alpine,003,1148,119,123,1,124,0
2022-01-26,Amador,005,37829,7729,7427,488,7915,73
2022-01-26,Butte,007,227075,30330,29229,5958,35187,353
2022-01-26,Calaveras,009,45235,6694,6387,253,6640,96
2022-01-26,Colusa,011,21464,3208,3094,972,4066,21
2022-01-26,Contra Costa,013,1133247,173663,165972,11054,177026,1095
2022-01-26,Del Norte,015,27424,4795,4542,124,4666,43
2022-01-26,El Dorado,017,186661,25093,23819,2937,26756,181
2022-01-26,Fresno,019,978130,209497,199689,21004,220693,2452
2022-01-26,Glenn,021,27897,4603,4472,1459,5931,39
2022-01-26,Humboldt,023,135768,15144,14715,2331,17046,126
2022-01-26,Imperial,025,180216,51511,49477,9287,58764,839
2022-01-26,Inyo,027,18085,3925,3889,366,4255,50
2022-01-26,Kern,029,883053,179768,173052,41704,214756,1953
2022-01-26,Kings,031,150075,46806,44367,3185,47552,396
2022-01-26,Lake,033,64148,9354,8645,707,9352,119
2022-01-26,Lassen,035,31185,8199,7888,805,8693,55
2022-01-26,Los Angeles,037,10098052,2567457,2450620,116983,2567603,28382
2022-01-26,Madera,039,155013,33842,32323,4810,37133,329
2022-01-26,Marin,041,260295,30817,29813,1963,31776,253
2022-01-26,Mariposa,043,17540,2171,2108,125,2233,6
2022-01-26,Mendocino,045,87422,11929,11453,2266,13719,103
2022-01-26,Merced,047,269075,57855,56060,6649,62709,733
2022-01-26,Modoc,049,8938,667,652,228,880,6
2022-01-26,Mono,051,14174,2871,2852,114,2966,4
2022-01-26,Monterey,053,433212,71935,63264,10498,73762,659
2022-01-26,Napa,055,140530,23160,21864,772,22636,112
2022-01-26,Nevada,057,99092,14780,14128,990,15118,112
2022-01-26,Orange,059,3164182,520923,506419,38717,545136,6007
2022-01-26,Placer,061,380077,58333,55892,6767,62659,524
2022-01-26,Plumas,063,18699,2704,2425,257,2682,12
2022-01-26,Riverside,065,2383286,562138,543788,26335,570123,5701
2022-01-26,Sacramento,067,1510023,259923,246416,23144,269560,2559
2022-01-26,San Benito,069,59416,11893,11563,448,12011,90
2022-01-26,San Bernardino,071,2135413,544404,521699,23719,545418,6291
2022-01-26,San Diego,073,3302833,699962,676392,47745,724137,4622
2022-01-26,San Francisco,075,870044,113577,107174,7540,114714,704
2022-01-26,San Joaquin,077,732212,154732,148770,9320,158090,1971
2022-01-26,San Luis Obispo,079,281455,47838,45716,3207,48923,391
2022-01-26,San Mateo,081,765935,112093,99016,6044,105060,586
2022-01-26,Santa Barbara,083,443738,78526,75548,4201,79749,600
2022-01-26,Santa Clara,085,1922200,281043,270470,10635,281105,2015
2022-01-26,Santa Cruz,087,273765,40964,38298,1931,40229,239
2022-01-26,Shasta,089,179085,28136,27255,5391,32646,452
2022-01-26,Sierra,091,2930,264,260,41,301,0
2022-01-26,Siskiyou,093,43540,4080,3971,2328,6299,66
2022-01-26,Solano,095,438530,73290,69150,4911,74061,401
2022-01-26,Sonoma,097,501317,76165,72509,2139,74648,423
2022-01-26,Stanislaus,099,539301,109277,106582,15303,121885,1396
2022-01-26,Sutter,101,95872,19076,18670,1536,20206,202
2022-01-26,Tehama,103,63373,11091,10749,2380,13129,145
2022-01-26,Trinity,105,12862,1088,1008,265,1273,19
2022-01-26,Tulare,107,460477,97557,91904,24882,116786,1234
2022-01-26,Tuolumne,109,53932,11422,10699,401,11100,91
2022-01-26,Ventura,111,848112,163426,159077,8952,168029,1263
2022-01-26,Yolo,113,214977,33862,31913,2761,34674,275
2022-01-26,Yuba,115,75493,14577,14171,969,15140,103
2022-01-25,Alameda,001,1643700,231095,219753,11852,231605,1589
2022-01-25,Alpine,003,1148,119,122,1,123,0
2022-01-25,Amador,005,37829,7652,7352,477,7829,73
2022-01-25,Butte,007,227075,30122,28887,5885,34772,351
2022-01-25,Calaveras,009,45235,6636,6266,239,6505,95
2022-01-25,Colusa,011,21464,3188,3074,970,4044,21
2022-01-25,Contra Costa,013,1133247,172344,163792,10836,174628,1092
2022-01-25,Del Norte,015,27424,4725,4514,118,4632,43
2022-01-25,El Dorado,017,186661,24957,23339,2911,26250,179
2022-01-25,Fresno,019,978130,207355,198262,20719,218981,2434
2022-01-25,Glenn,021,27897,4571,4418,1443,5861,39
2022-01-25,Humboldt,023,135768,15053,14574,2305,16879,126
2022-01-25,Imperial,025,180216,51055,48913,9061,57974,832
2022-01-25,Inyo,027,18085,3910,3857,321,4178,50
2022-01-25,Kern,029,883053,178762,171695,41244,212939,1947
2022-01-25,Kings,031,150075,46336,43853,3139,46992,396
2022-01-25,Lake,033,64148,9275,8543,695,9238,118
2022-01-25,Lassen,035,31185,8168,7834,794,8628,55
2022-01-25,Los Angeles,037,10098052,2552517,2433516,116343,2549859,28293
2022-01-25,Madera,039,155013,33520,31794,4674,36468,329
2022-01-25,Marin,041,260295,30639,29589,1950,31539,253
2022-01-25,Mariposa,043,17540,2159,2069,119,2188,6
2022-01-25,Mendocino,045,87422,11809,11280,2163,13443,103
2022-01-25,Merced,047,269075,57473,55555,6508,62063,733
2022-01-25,Modoc,049,8938,665,652,228,880,6
2022-01-25,Mono,051,14174,2861,2826,113,2939,4
2022-01-25,Monterey,053,433212,71361,62498,10090,72588,654
2022-01-25,Napa,055,140530,22965,21668,737,22405,111
2022-01-25,Nevada,057,99092,14667,13944,966,14910,112
2022-01-25,Orange,059,3164182,518643,504274,38524,542798,5980
2022-01-25,Placer,061,380077,57932,55465,6694,62159,518
2022-01-25,Plumas,063,18699,2679,2397,253,2650,12
2022-01-25,Riverside,065,2383286,559044,540723,26167,566890,5686
2022-01-25,Sacramento,067,1510023,257982,244468,22599,267067,2545
2022-01-25,San Benito,069,59416,11793,11446,444,11890,88
2022-01-25,San Bernardino,071,2135413,541849,519150,23603,542753,6288
2022-01-25,San Diego,073,3302833,694967,670110,47294,717404,4604
2022-01-25,San Francisco,075,870044,112815,106254,7496,113750,703
2022-01-25,San Joaquin,077,732212,153741,147271,9255,156526,1972
2022-01-25,San Luis Obispo,079,281455,47476,45130,3159,48289,391
2022-01-25,San Mateo,081,765935,111260,98010,5933,103943,586
2022-01-25,Santa Barbara,083,443738,77858,74686,4119,78805,594
2022-01-25,Santa Clara,085,1922200,278431,268031,10430,278461,2006
2022-01-25,Santa Cruz,087,273765,40293,37850,1915,39765,237
2022-01-25,Shasta,089,179085,27974,27090,5324,32414,452
2022-01-25,Sierra,091,2930,264,260,37,297,0
2022-01-25,Siskiyou,093,43540,4056,3958,2293,6251,65
2022-01-25,Solano,095,438530,72722,68657,4854,73511,399
2022-01-25,Sonoma,097,501317,75473,71633,2099,73732,423
2022-01-25,Stanislaus,099,539301,108605,105965,15079,121044,1396
2022-01-25,Sutter,101,95872,18973,18508,1494,20002,200
2022-01-25,Tehama,103,63373,11028,10669,2354,13023,145
2022-01-25,Trinity,105,12862,1081,999,263,1262,19
2022-01-25,Tulare,107,460477,96686,91237,24538,115775,1229
2022-01-25,Tuolumne,109,53932,11241,10516,377,10893,91
2022-01-25,Ventura,111,848112,162571,157971,8904,166875,1263
2022-01-25,Yolo,113,214977,33602,31677,2715,34392,274
2022-01-25,Yuba,115,75493,14492,14038,941,14979,103
2022-01-24,Alameda,001,1643700,228640,216252,11583,227835,1581
2022-01-24,Alpine,003,1148,119,120,1,121,0
2022-01-24,Amador,005,37829,7601,7166,439,7605,73
2022-01-24,Butte,007,227075,29895,28607,5822,34429,350
2022-01-24,Calaveras,009,45235,6587,6172,225,6397,95
2022-01-24,Colusa,011,21464,3169,3052,954,4006,21
2022-01-24,Contra Costa,013,1133247,170857,162161,10619,172780,1092
2022-01-24,Del Norte,015,27424,4665,4460,118,4578,43
2022-01-24,El Dorado,017,186661,24790,23128,2882,26010,179
2022-01-24,Fresno,019,978130,205051,196092,20413,216505,2430
2022-01-24,Glenn,021,27897,4530,4367,1433,5800,39
2022-01-24,Humboldt,023,135768,14941,14416,2259,16675,126
2022-01-24,Imperial,025,180216,50513,48228,8773,57001,824
2022-01-24,Inyo,027,18085,3904,3805,296,4101,50
2022-01-24,Kern,029,883053,177452,169892,40766,210658,1946
2022-01-24,Kings,031,150075,45762,43260,3066,46326,396
2022-01-24,Lake,033,64148,9166,8423,680,9103,118
2022-01-24,Lassen,035,31185,8084,7732,775,8507,55
2022-01-24,Los Angeles,037,10098052,2535993,2391045,115563,2506608,28230
2022-01-24,Madera,039,155013,33082,31339,4486,35825,329
2022-01-24,Marin,041,260295,30408,29301,1913,31214,253
2022-01-24,Mariposa,043,17540,2134,2033,115,2148,6
2022-01-24,Mendocino,045,87422,11705,11002,2082,13084,103
2022-01-24,Merced,047,269075,56981,54970,6224,61194,730
2022-01-24,Modoc,049,8938,662,648,227,875,6
2022-01-24,Mono,051,14174,2851,2802,112,2914,4
2022-01-24,Monterey,053,433212,70499,61975,9727,71702,654
2022-01-24,Napa,055,140530,22785,21494,724,22218,111
2022-01-24,Nevada,057,99092,14540,13774,943,14717,112
2022-01-24,Orange,059,3164182,516070,501634,38262,539896,5969
2022-01-24,Placer,061,380077,57454,54933,6643,61576,518
2022-01-24,Plumas,063,18699,2648,2370,239,2609,12
2022-01-24,Riverside,065,2383286,555315,535962,25957,561919,5661
2022-01-24,Sacramento,067,1510023,255615,241522,22017,263539,2526
2022-01-24,San Benito,069,59416,11696,11331,431,11762,88
2022-01-24,San Bernardino,071,2135413,538927,515604,23440,539044,6285
2022-01-24,San Diego,073,3302833,689315,663580,46743,710323,4586
2022-01-24,San Francisco,075,870044,111855,105418,7400,112818,703
2022-01-24,San Joaquin,077,732212,152429,145984,9179,155163,1959
2022-01-24,San Luis Obispo,079,281455,47004,44616,3104,47720,387
2022-01-24,San Mateo,081,765935,110298,96968,5816,102784,586
2022-01-24,Santa Barbara,083,443738,77047,73866,4023,77889,591
2022-01-24,Santa Clara,085,1922200,275557,265341,10218,275559,2006
2022-01-24,Santa Cruz,087,273765,39495,37188,1893,39081,237
2022-01-24,Shasta,089,179085,27791,26871,5236,32107,452
2022-01-24,Sierra,091,2930,264,258,37,295,0
2022-01-24,Siskiyou,093,43540,4047,3934,2254,6188,64
2022-01-24,Solano,095,438530,72039,68094,4775,72869,400
2022-01-24,Sonoma,097,501317,74558,70733,2067,72800,423
2022-01-24,Stanislaus,099,539301,107848,104933,14803,119736,1395
2022-01-24,Sutter,101,95872,18857,18336,1405,19741,200
2022-01-24,Tehama,103,63373,10958,10567,2334,12901,145
2022-01-24,Trinity,105,12862,1072,978,261,1239,19
2022-01-24,Tulare,107,460477,95616,90089,24137,114226,1219
2022-01-24,Tuolumne,109,53932,11120,10374,368,10742,91
2022-01-24,Ventura,111,848112,161548,156551,8857,165408,1261
2022-01-24,Yolo,113,214977,33310,31480,2678,34158,273
2022-01-24,Yuba,115,75493,14385,13862,900,14762,103
2022-01-23,Alameda,001,1643700,225936,214003,11251,225254,1583
2022-01-23,Alpine,003,1148,119,120,1,121,0
2022-01-23,Amador,005,37829,7545,7090,399,7489,73
2022-01-23,Butte,007,227075,29600,28340,5715,34055,350
2022-01-23,Calaveras,009,45235,6522,6095,202,6297,95
2022-01-23,Colusa,011,21464,3145,3040,947,3987,21
2022-01-23,Contra Costa,013,1133247,169010,160798,10256,171054,1092
2022-01-23,Del Norte,015,27424,4599,4419,112,4531,43
2022-01-23,El Dorado,017,186661,24599,22925,2833,25758,179
2022-01-23,Fresno,019,978130,202580,193642,19935,213577,2430
2022-01-23,Glenn,021,27897,4479,4340,1409,5749,39
2022-01-23,Humboldt,023,135768,14819,14296,2177,16473,126
2022-01-23,Imperial,025,180216,49915,47935,8485,56420,824
2022-01-23,Inyo,027,18085,3877,3781,282,4063,50
2022-01-23,Kern,029,883053,176089,168585,40236,208821,1946
2022-01-23,Kings,031,150075,45127,42622,2962,45584,397
2022-01-23,Lake,033,64148,8996,8363,653,9016,118
2022-01-23,Lassen,035,31185,8035,7710,751,8461,55
2022-01-23,Los Angeles,037,10098052,2515699,2390590,114405,2504995,28231
2022-01-23,Madera,039,155013,32723,30962,4244,35206,329
2022-01-23,Marin,041,260295,30155,29025,1875,30900,253
2022-01-23,Mariposa,043,17540,2119,2011,112,2123,6
2022-01-23,Mendocino,045,87422,11580,10889,1950,12839,103
2022-01-23,Merced,047,269075,56427,54644,5777,60421,730
2022-01-23,Modoc,049,8938,660,645,224,869,6
2022-01-23,Mono,051,14174,2843,2788,110,2898,4
2022-01-23,Monterey,053,433212,69661,61522,9283,70805,654
2022-01-23,Napa,055,140530,22523,21281,711,21992,111
2022-01-23,Nevada,057,99092,14375,13629,915,14544,112
2022-01-23,Orange,059,3164182,512970,498968,37968,536936,5970
2022-01-23,Placer,061,380077,56883,54568,6553,61121,518
2022-01-23,Plumas,063,18699,2615,2368,210,2578,12
2022-01-23,Riverside,065,2383286,550869,532273,25650,557923,5661
2022-01-23,Sacramento,067,1510023,252975,239589,21047,260636,2530
2022-01-23,San Benito,069,59416,11574,11225,420,11645,88
2022-01-23,San Bernardino,071,2135413,535488,512657,23159,535816,6281
2022-01-23,San Diego,073,3302833,682703,640215,45942,686157,4566
2022-01-23,San Francisco,075,870044,110788,104485,7292,111777,704
2022-01-23,San Joaquin,077,732212,150812,144621,9096,153717,1959
2022-01-23,San Luis Obispo,079,281455,46310,44183,3025,47208,386
2022-01-23,San Mateo,081,765935,109181,95940,5668,101608,586
2022-01-23,Santa Barbara,083,443738,75924,73041,3897,76938,590
2022-01-23,Santa Clara,085,1922200,272258,261991,9892,271883,2005
2022-01-23,Santa Cruz,087,273765,38963,36547,1861,38408,237
2022-01-23,Shasta,089,179085,27511,26732,5114,31846,452
2022-01-23,Sierra,091,2930,263,252,37,289,0
2022-01-23,Siskiyou,093,43540,4021,3916,2196,6112,64
2022-01-23,Solano,095,438530,71242,67457,4679,72136,400
2022-01-23,Sonoma,097,501317,73601,69791,2011,71802,423
2022-01-23,Stanislaus,099,539301,106989,104067,14521,118588,1395
2022-01-23,Sutter,101,95872,18700,18175,1290,19465,200
2022-01-23,Tehama,103,63373,10860,10481,2302,12783,145
2022-01-23,Trinity,105,12862,1069,961,259,1220,19
2022-01-23,Tulare,107,460477,94356,89120,23699,112819,1219
2022-01-23,Tuolumne,109,53932,10928,10243,350,10593,91
2022-01-23,Ventura,111,848112,160366,155052,8780,163832,1261
2022-01-23,Yolo,113,214977,32932,30908,2636,33544,273
2022-01-23,Yuba,115,75493,14261,13762,845,14607,103
2022-01-22,Alameda,001,1643700,224845,203927,11217,215144,1575
2022-01-22,Alpine,003,1148,118,119,1,120,0
2022-01-22,Amador,005,37829,7511,6845,394,7239,73
2022-01-22,Butte,007,227075,29482,27232,5691,32923,350
2022-01-22,Calaveras,009,45235,6492,5835,201,6036,95
2022-01-22,Colusa,011,21464,3128,2954,944,3898,21
2022-01-22,Contra Costa,013,1133247,168079,154111,10226,164337,1091
2022-01-22,Del Norte,015,27424,4562,4269,108,4377,43
2022-01-22,El Dorado,017,186661,24530,22273,2823,25096,179
2022-01-22,Fresno,019,978130,201761,185292,19866,205158,2429
2022-01-22,Glenn,021,27897,4473,4174,1406,5580,39
2022-01-22,Humboldt,023,135768,14752,13628,2164,15792,125
2022-01-22,Imperial,025,180216,49725,45741,8425,54166,820
2022-01-22,Inyo,027,18085,3873,3706,258,3964,50
2022-01-22,Kern,029,883053,175463,162902,39931,202833,1946
2022-01-22,Kings,031,150075,44919,40580,2949,43529,396
2022-01-22,Lake,033,64148,8962,8056,645,8701,118
2022-01-22,Lassen,035,31185,8001,7545,744,8289,55
2022-01-22,Los Angeles,037,10098052,2508298,2286280,113895,2400175,28038
2022-01-22,Madera,039,155013,32604,29595,4229,33824,329
2022-01-22,Marin,041,260295,30029,27893,1870,29763,253
2022-01-22,Mariposa,043,17540,2115,1920,112,2032,6
2022-01-22,Mendocino,045,87422,11530,10395,1928,12323,103
2022-01-22,Merced,047,269075,56275,53025,5768,58793,727
2022-01-22,Modoc,049,8938,659,639,224,863,6
2022-01-22,Mono,051,14174,2842,2723,106,2829,4
2022-01-22,Monterey,053,433212,69454,59038,9239,68277,651
2022-01-22,Napa,055,140530,22428,20402,701,21103,111
2022-01-22,Nevada,057,99092,14307,12957,907,13864,112
2022-01-22,Orange,059,3164182,511365,480329,37719,518048,5946
2022-01-22,Placer,061,380077,56613,52557,6514,59071,512
2022-01-22,Plumas,063,18699,2598,2289,206,2495,12
2022-01-22,Riverside,065,2383286,548953,513567,25577,539144,5623
2022-01-22,Sacramento,067,1510023,251925,230206,20942,251148,2510
2022-01-22,San Benito,069,59416,11516,10743,415,11158,88
2022-01-22,San Bernardino,071,2135413,533984,495209,23064,518273,6267
2022-01-22,San Diego,073,3302833,680212,628904,45728,674632,4559
2022-01-22,San Francisco,075,870044,110131,100238,7143,107381,702
2022-01-22,San Joaquin,077,732212,150373,138264,9053,147317,1960
2022-01-22,San Luis Obispo,079,281455,46192,42154,3018,45172,385
2022-01-22,San Mateo,081,765935,108596,91440,5605,97045,585
2022-01-22,Santa Barbara,083,443738,75502,69555,3891,73446,589
2022-01-22,Santa Clara,085,1922200,270579,249205,9825,259030,1993
2022-01-22,Santa Cruz,087,273765,38781,33741,1854,35595,237
2022-01-22,Shasta,089,179085,27415,25919,5092,31011,450
2022-01-22,Sierra,091,2930,263,248,36,284,0
2022-01-22,Siskiyou,093,43540,4003,3845,2175,6020,62
2022-01-22,Solano,095,438530,71019,63882,4640,68522,391
2022-01-22,Sonoma,097,501317,73178,66013,2001,68014,422
2022-01-22,Stanislaus,099,539301,106531,100092,14430,114522,1393
2022-01-22,Sutter,101,95872,18632,17616,1277,18893,199
2022-01-22,Tehama,103,63373,10825,10171,2292,12463,142
2022-01-22,Trinity,105,12862,1067,925,259,1184,19
2022-01-22,Tulare,107,460477,93973,85223,23570,108793,1211
2022-01-22,Tuolumne,109,53932,10860,9731,344,10075,91
2022-01-22,Ventura,111,848112,159675,148742,8741,157483,1250
2022-01-22,Yolo,113,214977,32754,30061,2619,32680,273
2022-01-22,Yuba,115,75493,14172,13288,840,14128,103
2022-01-21,Alameda,001,1643700,223270,203927,11185,215112,1575
2022-01-21,Alpine,003,1148,118,119,1,120,0
2022-01-21,Amador,005,37829,7454,6845,391,7236,73
2022-01-21,Butte,007,227075,29354,27232,5649,32881,350
2022-01-21,Calaveras,009,45235,6446,5835,201,6036,95
2022-01-21,Colusa,011,21464,3121,2954,939,3893,21
2022-01-21,Contra Costa,013,1133247,167027,154111,10147,164258,1091
2022-01-21,Del Norte,015,27424,4521,4269,108,4377,43
2022-01-21,El Dorado,017,186661,24447,22273,2806,25079,179
2022-01-21,Fresno,019,978130,200517,185292,19764,205056,2429
2022-01-21,Glenn,021,27897,4454,4174,1401,5575,39
2022-01-21,Humboldt,023,135768,14683,13628,2145,15773,125
2022-01-21,Imperial,025,180216,49535,45741,8347,54088,820
2022-01-21,Inyo,027,18085,3860,3706,253,3959,50
2022-01-21,Kern,029,883053,174745,162902,39556,202458,1946
2022-01-21,Kings,031,150075,44722,40580,2941,43521,396
2022-01-21,Lake,033,64148,8905,8056,632,8688,118
2022-01-21,Lassen,035,31185,7952,7545,740,8285,55
2022-01-21,Los Angeles,037,10098052,2496993,2286280,113436,2399716,28038
2022-01-21,Madera,039,155013,32312,29595,4201,33796,329
2022-01-21,Marin,041,260295,29852,27893,1850,29743,253
2022-01-21,Mariposa,043,17540,2103,1920,111,2031,6
2022-01-21,Mendocino,045,87422,11449,10395,1925,12320,103
2022-01-21,Merced,047,269075,56115,53025,5764,58789,727
2022-01-21,Modoc,049,8938,658,639,224,863,6
2022-01-21,Mono,051,14174,2828,2723,103,2826,4
2022-01-21,Monterey,053,433212,68982,59038,9107,68145,651
2022-01-21,Napa,055,140530,22308,20402,693,21095,111
2022-01-21,Nevada,057,99092,14211,12957,903,13860,112
2022-01-21,Orange,059,3164182,509127,480329,37473,517802,5946
2022-01-21,Placer,061,380077,56220,52557,6452,59009,512
2022-01-21,Plumas,063,18699,2586,2289,201,2490,12
2022-01-21,Riverside,065,2383286,546295,513567,25498,539065,5623
2022-01-21,Sacramento,067,1510023,250480,230206,20839,251045,2510
2022-01-21,San Benito,069,59416,11481,10743,412,11155,88
2022-01-21,San Bernardino,071,2135413,531951,495209,22988,518197,6267
2022-01-21,San Diego,073,3302833,676044,628904,45551,674455,4559
2022-01-21,San Francisco,075,870044,109371,100238,7055,107293,702
2022-01-21,San Joaquin,077,732212,149779,138264,8992,147256,1960
2022-01-21,San Luis Obispo,079,281455,46066,42154,3015,45169,385
2022-01-21,San Mateo,081,765935,107924,91440,5564,97004,585
2022-01-21,Santa Barbara,083,443738,75000,69555,3881,73436,589
2022-01-21,Santa Clara,085,1922200,268754,249205,9717,258922,1993
2022-01-21,Santa Cruz,087,273765,38062,33741,1841,35582,237
2022-01-21,Shasta,089,179085,27326,25919,5045,30964,450
2022-01-21,Sierra,091,2930,261,248,35,283,0
2022-01-21,Siskiyou,093,43540,3994,3845,2157,6002,62
2022-01-21,Solano,095,438530,70608,63882,4558,68440,391
2022-01-21,Sonoma,097,501317,72653,66013,1991,68004,422
2022-01-21,Stanislaus,099,539301,106028,100092,14370,114462,1393
2022-01-21,Sutter,101,95872,18545,17616,1263,18879,199
2022-01-21,Tehama,103,63373,10789,10171,2290,12461,142
2022-01-21,Trinity,105,12862,1061,925,258,1183,19
2022-01-21,Tulare,107,460477,93494,85223,23407,108630,1211
2022-01-21,Tuolumne,109,53932,10777,9731,336,10067,91
2022-01-21,Ventura,111,848112,158866,148742,8710,157452,1250
2022-01-21,Yolo,113,214977,32590,30061,2596,32657,273
2022-01-21,Yuba,115,75493,14100,13288,833,14121,103
2022-01-20,Alameda,001,1643700,220205,203927,10945,214872,1575
2022-01-20,Alpine,003,1148,118,119,1,120,0
2022-01-20,Amador,005,37829,7390,6845,373,7218,73
2022-01-20,Butte,007,227075,29099,27232,5570,32802,350
2022-01-20,Calaveras,009,45235,6341,5835,192,6027,95
2022-01-20,Colusa,011,21464,3091,2954,927,3881,21
2022-01-20,Contra Costa,013,1133247,165065,154111,9881,163992,1091
2022-01-20,Del Norte,015,27424,4481,4269,105,4374,43
2022-01-20,El Dorado,017,186661,24243,22273,2763,25036,179
2022-01-20,Fresno,019,978130,197917,185292,19395,204687,2429
2022-01-20,Glenn,021,27897,4419,4174,1392,5566,39
2022-01-20,Humboldt,023,135768,14554,13628,2093,15721,125
2022-01-20,Imperial,025,180216,49015,45741,8168,53909,820
2022-01-20,Inyo,027,18085,3848,3706,242,3948,50
2022-01-20,Kern,029,883053,173219,162902,39009,201911,1946
2022-01-20,Kings,031,150075,44166,40580,2898,43478,396
2022-01-20,Lake,033,64148,8809,8056,604,8660,118
2022-01-20,Lassen,035,31185,7899,7545,725,8270,55
2022-01-20,Los Angeles,037,10098052,2472272,2286280,112452,2398732,28038
2022-01-20,Madera,039,155013,31924,29595,4074,33669,329
2022-01-20,Marin,041,260295,29559,27893,1813,29706,253
2022-01-20,Mariposa,043,17540,2076,1920,108,2028,6
2022-01-20,Mendocino,045,87422,11351,10395,1847,12242,103
2022-01-20,Merced,047,269075,55686,53025,5535,58560,727
2022-01-20,Modoc,049,8938,656,639,224,863,6
2022-01-20,Mono,051,14174,2820,2723,102,2825,4
2022-01-20,Monterey,053,433212,68216,59038,8688,67726,651
2022-01-20,Napa,055,140530,22042,20402,654,21056,111
2022-01-20,Nevada,057,99092,14063,12957,880,13837,112
2022-01-20,Orange,059,3164182,505184,480329,37101,517430,5946
2022-01-20,Placer,061,380077,55732,52557,6392,58949,512
2022-01-20,Plumas,063,18699,2559,2289,197,2486,12
2022-01-20,Riverside,065,2383286,541718,513567,25261,538828,5623
2022-01-20,Sacramento,067,1510023,248189,230206,20188,250394,2510
2022-01-20,San Benito,069,59416,11370,10743,399,11142,88
2022-01-20,San Bernardino,071,2135413,527802,495209,22703,517912,6267
2022-01-20,San Diego,073,3302833,668942,628904,44848,673752,4559
2022-01-20,San Francisco,075,870044,108218,100238,6914,107152,702
2022-01-20,San Joaquin,077,732212,148141,138264,8865,147129,1960
2022-01-20,San Luis Obispo,079,281455,45555,42154,2981,45135,385
2022-01-20,San Mateo,081,765935,106697,91440,5358,96798,585
2022-01-20,Santa Barbara,083,443738,74102,69555,3768,73323,589
2022-01-20,Santa Clara,085,1922200,265444,249205,9388,258593,1993
2022-01-20,Santa Cruz,087,273765,37178,33741,1818,35559,237
2022-01-20,Shasta,089,179085,27136,25919,4978,30897,450
2022-01-20,Sierra,091,2930,261,248,33,281,0
2022-01-20,Siskiyou,093,43540,3982,3845,2124,5969,62
2022-01-20,Solano,095,438530,69661,63882,4469,68351,391
2022-01-20,Sonoma,097,501317,71626,66013,1941,67954,422
2022-01-20,Stanislaus,099,539301,105071,100092,14163,114255,1393
2022-01-20,Sutter,101,95872,18380,17616,1234,18850,199
2022-01-20,Tehama,103,63373,10716,10171,2272,12443,142
2022-01-20,Trinity,105,12862,1047,925,257,1182,19
2022-01-20,Tulare,107,460477,92437,85223,23099,108322,1211
2022-01-20,Tuolumne,109,53932,10635,9731,324,10055,91
2022-01-20,Ventura,111,848112,157481,148742,8634,157376,1250
2022-01-20,Yolo,113,214977,32302,30061,2563,32624,273
2022-01-20,Yuba,115,75493,13994,13288,800,14088,103
2022-01-19,Alameda,001,1643700,216809,199739,10609,210348,1571
2022-01-19,Alpine,003,1148,117,119,1,120,0
2022-01-19,Amador,005,37829,7309,6789,331,7120,73
2022-01-19,Butte,007,227075,28797,26839,5494,32333,351
2022-01-19,Calaveras,009,45235,6251,5765,183,5948,95
2022-01-19,Colusa,011,21464,3066,2938,920,3858,21
2022-01-19,Contra Costa,013,1133247,162754,151543,9640,161183,1091
2022-01-19,Del Norte,015,27424,4442,4240,104,4344,43
2022-01-19,El Dorado,017,186661,23988,21953,2721,24674,177
2022-01-19,Fresno,019,978130,195014,181526,19065,200591,2430
2022-01-19,Glenn,021,27897,4368,4127,1382,5509,39
2022-01-19,Humboldt,023,135768,14395,13391,2040,15431,125
2022-01-19,Imperial,025,180216,48282,45156,7964,53120,820
2022-01-19,Inyo,027,18085,3825,3680,203,3883,49
2022-01-19,Kern,029,883053,171456,160747,38324,199071,1946
2022-01-19,Kings,031,150075,43470,40027,2819,42846,395
2022-01-19,Lake,033,64148,8682,7972,591,8563,118
2022-01-19,Lassen,035,31185,7842,7507,703,8210,55
2022-01-19,Los Angeles,037,10098052,2443890,2251718,111018,2362736,27934
2022-01-19,Madera,039,155013,31542,29021,3901,32922,329
2022-01-19,Marin,041,260295,29263,27375,1770,29145,251
2022-01-19,Mariposa,043,17540,2051,1896,102,1998,6
2022-01-19,Mendocino,045,87422,11180,10252,1753,12005,103
2022-01-19,Merced,047,269075,55140,52355,5179,57534,724
2022-01-19,Modoc,049,8938,654,635,223,858,6
2022-01-19,Mono,051,14174,2798,2677,100,2777,4
2022-01-19,Monterey,053,433212,67307,58426,8225,66651,651
2022-01-19,Napa,055,140530,21789,20090,627,20717,110
2022-01-19,Nevada,057,99092,13906,12703,851,13554,112
2022-01-19,Orange,059,3164182,500699,468460,36729,505189,5943
2022-01-19,Placer,061,380077,55168,51545,6321,57866,511
2022-01-19,Plumas,063,18699,2519,2239,190,2429,12
2022-01-19,Riverside,065,2383286,536190,503575,25021,528596,5604
2022-01-19,Sacramento,067,1510023,245296,226035,19446,245481,2512
2022-01-19,San Benito,069,59416,11229,10639,387,11026,88
2022-01-19,San Bernardino,071,2135413,523162,487846,22321,510167,6265
2022-01-19,San Diego,073,3302833,660164,614709,44116,658825,4553
2022-01-19,San Francisco,075,870044,106846,98652,6835,105487,694
2022-01-19,San Joaquin,077,732212,146247,135953,8733,144686,1959
2022-01-19,San Luis Obispo,079,281455,44956,41374,2915,44289,382
2022-01-19,San Mateo,081,765935,105281,89715,5091,94806,585
2022-01-19,Santa Barbara,083,443738,73105,68531,3667,72198,586
2022-01-19,Santa Clara,085,1922200,261715,244922,9023,253945,1991
2022-01-19,Santa Cruz,087,273765,35874,33026,1793,34819,237
2022-01-19,Shasta,089,179085,26868,25355,4906,30261,450
2022-01-19,Sierra,091,2930,261,245,32,277,0
2022-01-19,Siskiyou,093,43540,3958,3821,2068,5889,62
2022-01-19,Solano,095,438530,68819,63003,4341,67344,392
2022-01-19,Sonoma,097,501317,70525,64689,1896,66585,420
2022-01-19,Stanislaus,099,539301,104020,98952,13871,112823,1381
2022-01-19,Sutter,101,95872,18213,17436,1142,18578,199
2022-01-19,Tehama,103,63373,10602,10064,2223,12287,142
2022-01-19,Trinity,105,12862,1035,916,256,1172,19
2022-01-19,Tulare,107,460477,91145,83743,22613,106356,1200
2022-01-19,Tuolumne,109,53932,10477,9613,300,9913,91
2022-01-19,Ventura,111,848112,155965,144738,8560,153298,1234
2022-01-19,Yolo,113,214977,31937,29392,2527,31919,273
2022-01-19,Yuba,115,75493,13831,13114,787,13901,104
2022-01-18,Alameda,001,1643700,213449,195728,10292,206020,1566
2022-01-18,Alpine,003,1148,117,118,1,119,0
2022-01-18,Amador,005,37829,7171,6691,294,6985,73
2022-01-18,Butte,007,227075,28407,26514,5417,31931,347
2022-01-18,Calaveras,009,45235,6162,5684,168,5852,94
2022-01-18,Colusa,011,21464,3022,2903,915,3818,21
2022-01-18,Contra Costa,013,1133247,160745,149446,9272,158718,1085
2022-01-18,Del Norte,015,27424,4372,4229,99,4328,43
2022-01-18,El Dorado,017,186661,23607,21707,2675,24382,175
2022-01-18,Fresno,019,978130,191518,178922,18624,197546,2425
2022-01-18,Glenn,021,27897,4335,4070,1370,5440,39
2022-01-18,Humboldt,023,135768,14228,13218,1968,15186,125
2022-01-18,Imperial,025,180216,47586,44742,7778,52520,819
2022-01-18,Inyo,027,18085,3784,3654,192,3846,49
2022-01-18,Kern,029,883053,169433,158864,37560,196424,1943
2022-01-18,Kings,031,150075,42595,39440,2737,42177,392
2022-01-18,Lake,033,64148,8569,7919,571,8490,117
2022-01-18,Lassen,035,31185,7759,7461,664,8125,55
2022-01-18,Los Angeles,037,10098052,2410482,2227360,109576,2336936,27871
2022-01-18,Madera,039,155013,31020,28717,3707,32424,329
2022-01-18,Marin,041,260295,28960,27036,1727,28763,251
2022-01-18,Mariposa,043,17540,2026,1872,98,1970,6
2022-01-18,Mendocino,045,87422,11011,10114,1665,11779,103
2022-01-18,Merced,047,269075,54527,51746,4891,56637,718
2022-01-18,Modoc,049,8938,652,633,218,851,6
2022-01-18,Mono,051,14174,2777,2643,99,2742,4
2022-01-18,Monterey,053,433212,66531,57846,7742,65588,650
2022-01-18,Napa,055,140530,21456,19911,610,20521,109
2022-01-18,Nevada,057,99092,13721,12584,808,13392,111
2022-01-18,Orange,059,3164182,495352,461324,36218,497542,5938
2022-01-18,Placer,061,380077,54526,50983,6245,57228,508
2022-01-18,Plumas,063,18699,2481,2218,184,2402,12
2022-01-18,Riverside,065,2383286,530210,497278,24712,521990,5599
2022-01-18,Sacramento,067,1510023,242206,223745,18437,242182,2496
2022-01-18,San Benito,069,59416,11088,10520,373,10893,88
2022-01-18,San Bernardino,071,2135413,517803,483753,21888,505641,6258
2022-01-18,San Diego,073,3302833,649959,605137,43078,648215,4547
2022-01-18,San Francisco,075,870044,105382,96505,6719,103224,694
2022-01-18,San Joaquin,077,732212,144304,134365,8515,142880,1957
2022-01-18,San Luis Obispo,079,281455,44274,40848,2828,43676,381
2022-01-18,San Mateo,081,765935,103769,88225,4893,93118,585
2022-01-18,Santa Barbara,083,443738,71883,67216,3494,70710,581
2022-01-18,Santa Clara,085,1922200,257598,240281,8622,248903,1986
2022-01-18,Santa Cruz,087,273765,35223,32203,1758,33961,237
2022-01-18,Shasta,089,179085,26586,25162,4812,29974,448
2022-01-18,Sierra,091,2930,257,244,32,276,0
2022-01-18,Siskiyou,093,43540,3925,3799,2014,5813,62
2022-01-18,Solano,095,438530,67970,62204,4232,66436,391
2022-01-18,Sonoma,097,501317,69137,63714,1840,65554,419
2022-01-18,Stanislaus,099,539301,102803,98000,13503,111503,1379
2022-01-18,Sutter,101,95872,18022,17295,1070,18365,198
2022-01-18,Tehama,103,63373,10506,9975,2170,12145,142
2022-01-18,Trinity,105,12862,1022,907,255,1162,19
2022-01-18,Tulare,107,460477,89678,82667,22185,104852,1196
2022-01-18,Tuolumne,109,53932,10309,9528,288,9816,91
2022-01-18,Ventura,111,848112,154251,143384,8476,151860,1233
2022-01-18,Yolo,113,214977,31539,28786,2476,31262,270
2022-01-18,Yuba,115,75493,13670,12971,761,13732,101
2022-01-17,Alameda,001,1643700,208740,193276,9700,202976,1565
2022-01-17,Alpine,003,1148,116,118,0,118,0
2022-01-17,Amador,005,37829,7056,6640,236,6876,73
2022-01-17,Butte,007,227075,28024,26303,5312,31615,348
2022-01-17,Calaveras,009,45235,6031,5584,140,5724,94
2022-01-17,Colusa,011,21464,2998,2905,908,3813,21
2022-01-17,Contra Costa,013,1133247,157983,147993,8787,156780,1086
2022-01-17,Del Norte,015,27424,4321,4209,92,4301,43
2022-01-17,El Dorado,017,186661,23359,21540,2593,24133,175
2022-01-17,Fresno,019,978130,187810,176959,18119,195078,2426
2022-01-17,Glenn,021,27897,4282,4055,1356,5411,39
2022-01-17,Humboldt,023,135768,14024,13120,1802,14922,125
2022-01-17,Imperial,025,180216,46899,44412,7606,52018,821
2022-01-17,Inyo,027,18085,3762,3650,166,3816,49
2022-01-17,Kern,029,883053,166889,157645,36676,194321,1944
2022-01-17,Kings,031,150075,41462,39143,2615,41758,392
2022-01-17,Lake,033,64148,8420,7864,531,8395,117
2022-01-17,Lassen,035,31185,7666,7417,626,8043,55
2022-01-17,Los Angeles,037,10098052,2371297,2205740,107608,2313348,27832
2022-01-17,Madera,039,155013,30367,28568,3521,32089,329
2022-01-17,Marin,041,260295,28554,26633,1671,28304,251
2022-01-17,Mariposa,043,17540,2000,1862,92,1954,6
2022-01-17,Mendocino,045,87422,10787,10030,1523,11553,103
2022-01-17,Merced,047,269075,53847,51227,4329,55556,718
2022-01-17,Modoc,049,8938,648,630,218,848,6
2022-01-17,Mono,051,14174,2754,2642,98,2740,4
2022-01-17,Monterey,053,433212,65412,57318,7319,64637,647
2022-01-17,Napa,055,140530,21111,19647,587,20234,109
2022-01-17,Nevada,057,99092,13536,12414,770,13184,111
2022-01-17,Orange,059,3164182,489392,457418,35741,493159,5933
2022-01-17,Placer,061,380077,53795,50511,6100,56611,508
2022-01-17,Plumas,063,18699,2435,2205,152,2357,12
2022-01-17,Riverside,065,2383286,523397,491322,24254,515576,5600
2022-01-17,Sacramento,067,1510023,238124,221143,17056,238199,2497
2022-01-17,San Benito,069,59416,10921,10432,345,10777,88
2022-01-17,San Bernardino,071,2135413,511474,480243,21328,501571,6259
2022-01-17,San Diego,073,3302833,637742,569241,41872,611113,4545
2022-01-17,San Francisco,075,870044,103755,95292,6525,101817,694
2022-01-17,San Joaquin,077,732212,141470,133414,8324,141738,1958
2022-01-17,San Luis Obispo,079,281455,43445,40425,2726,43151,379
2022-01-17,San Mateo,081,765935,101801,87013,4635,91648,585
2022-01-17,Santa Barbara,083,443738,70560,66704,3293,69997,581
2022-01-17,Santa Clara,085,1922200,253111,237934,8179,246113,1985
2022-01-17,Santa Cruz,087,273765,34452,31714,1720,33434,237
2022-01-17,Shasta,089,179085,26306,25025,4690,29715,448
2022-01-17,Sierra,091,2930,256,242,32,274,0
2022-01-17,Siskiyou,093,43540,3886,3764,1934,5698,62
2022-01-17,Solano,095,438530,66932,61497,3970,65467,391
2022-01-17,Sonoma,097,501317,67633,62763,1776,64539,419
2022-01-17,Stanislaus,099,539301,101490,96951,13016,109967,1379
2022-01-17,Sutter,101,95872,17813,17159,932,18091,198
2022-01-17,Tehama,103,63373,10383,9912,2111,12023,142
2022-01-17,Trinity,105,12862,1009,906,251,1157,19
2022-01-17,Tulare,107,460477,87920,81741,21617,103358,1199
2022-01-17,Tuolumne,109,53932,10174,9416,254,9670,91
2022-01-17,Ventura,111,848112,152134,142070,8360,150430,1234
2022-01-17,Yolo,113,214977,31009,28638,2409,31047,270
2022-01-17,Yuba,115,75493,13474,12871,704,13575,101
2022-01-16,Alameda,001,1643700,205667,190691,9435,200126,1564
2022-01-16,Alpine,003,1148,116,118,0,118,0
2022-01-16,Amador,005,37829,6983,6618,228,6846,73
2022-01-16,Butte,007,227075,27681,26139,5263,31402,348
2022-01-16,Calaveras,009,45235,5930,5537,136,5673,94
2022-01-16,Colusa,011,21464,2981,2886,896,3782,21
2022-01-16,Contra Costa,013,1133247,156072,146307,8585,154892,1086
2022-01-16,Del Norte,015,27424,4279,4177,90,4267,43
2022-01-16,El Dorado,017,186661,23084,21303,2554,23857,175
2022-01-16,Fresno,019,978130,185097,174818,17762,192580,2425
2022-01-16,Glenn,021,27897,4227,4049,1334,5383,39
2022-01-16,Humboldt,023,135768,13877,13075,1783,14858,125
2022-01-16,Imperial,025,180216,46327,44035,7437,51472,821
2022-01-16,Inyo,027,18085,3725,3602,144,3746,49
2022-01-16,Kern,029,883053,165617,156655,35885,192540,1944
2022-01-16,Kings,031,150075,41089,38861,2586,41447,392
2022-01-16,Lake,033,64148,8316,7823,497,8320,117
2022-01-16,Lassen,035,31185,7621,7391,612,8003,55
2022-01-16,Los Angeles,037,10098052,2348129,2174403,106075,2280478,27805
2022-01-16,Madera,039,155013,29997,28313,3469,31782,329
2022-01-16,Marin,041,260295,28260,26292,1657,27949,251
2022-01-16,Mariposa,043,17540,1973,1851,87,1938,6
2022-01-16,Mendocino,045,87422,10640,9992,1406,11398,102
2022-01-16,Merced,047,269075,53257,50882,4304,55186,718
2022-01-16,Modoc,049,8938,645,629,218,847,6
2022-01-16,Mono,051,14174,2750,2614,96,2710,4
2022-01-16,Monterey,053,433212,64646,57012,7169,64181,647
2022-01-16,Napa,055,140530,20844,19521,576,20097,109
2022-01-16,Nevada,057,99092,13321,12307,751,13058,111
2022-01-16,Orange,059,3164182,483994,451962,35187,487149,5932
2022-01-16,Placer,061,380077,53088,50076,5987,56063,508
2022-01-16,Plumas,063,18699,2400,2204,142,2346,12
2022-01-16,Riverside,065,2383286,517893,485191,24027,509218,5600
2022-01-16,Sacramento,067,1510023,235165,218819,16315,235134,2491
2022-01-16,San Benito,069,59416,10763,10377,343,10720,88
2022-01-16,San Bernardino,071,2135413,507571,474425,21070,495495,6259
2022-01-16,San Diego,073,3302833,630154,569241,41435,610676,4545
2022-01-16,San Francisco,075,870044,102239,94139,6386,100525,694
2022-01-16,San Joaquin,077,732212,139686,132214,8180,140394,1958
2022-01-16,San Luis Obispo,079,281455,42788,40113,2686,42799,379
2022-01-16,San Mateo,081,765935,100273,85966,4540,90506,585
2022-01-16,Santa Barbara,083,443738,69533,66111,3253,69364,582
2022-01-16,Santa Clara,085,1922200,249446,234293,8025,242318,1984
2022-01-16,Santa Cruz,087,273765,33823,31469,1697,33166,237
2022-01-16,Shasta,089,179085,26050,24980,4622,29602,449
2022-01-16,Sierra,091,2930,252,238,31,269,0
2022-01-16,Siskiyou,093,43540,3858,3748,1894,5642,62
2022-01-16,Solano,095,438530,66258,60885,3838,64723,391
2022-01-16,Sonoma,097,501317,66554,61842,1757,63599,419
2022-01-16,Stanislaus,099,539301,100426,96370,12862,109232,1379
2022-01-16,Sutter,101,95872,17613,16996,909,17905,198
2022-01-16,Tehama,103,63373,10299,9868,2089,11957,142
2022-01-16,Trinity,105,12862,1004,889,249,1138,19
2022-01-16,Tulare,107,460477,86600,80867,21345,102212,1199
2022-01-16,Tuolumne,109,53932,10069,9369,245,9614,91
2022-01-16,Ventura,111,848112,150560,140715,8280,148995,1234
2022-01-16,Yolo,113,214977,30617,28481,2355,30836,270
2022-01-16,Yuba,115,75493,13296,12760,698,13458,101
2022-01-15,Alameda,001,1643700,204298,177768,9382,187150,1561
2022-01-15,Alpine,003,1148,116,117,0,117,0
2022-01-15,Amador,005,37829,6951,6434,214,6648,72
2022-01-15,Butte,007,227075,27526,25032,5214,30246,348
2022-01-15,Calaveras,009,45235,5898,5258,136,5394,93
2022-01-15,Colusa,011,21464,2967,2796,888,3684,21
2022-01-15,Contra Costa,013,1133247,154862,137643,8541,146184,1082
2022-01-15,Del Norte,015,27424,4264,4065,88,4153,43
2022-01-15,El Dorado,017,186661,22986,20434,2537,22971,175
2022-01-15,Fresno,019,978130,184167,167361,17674,185035,2415
2022-01-15,Glenn,021,27897,4220,3906,1327,5233,39
2022-01-15,Humboldt,023,135768,13774,12419,1767,14186,123
2022-01-15,Imperial,025,180216,46189,42508,7325,49833,817
2022-01-15,Inyo,027,18085,3715,3395,144,3539,49
2022-01-15,Kern,029,883053,164773,150085,35493,185578,1938
2022-01-15,Kings,031,150075,40840,37221,2574,39795,391
2022-01-15,Lake,033,64148,8277,7641,484,8125,117
2022-01-15,Lassen,035,31185,7580,7274,606,7880,55
2022-01-15,Los Angeles,037,10098052,2336603,2047927,105121,2153048,27641
2022-01-15,Madera,039,155013,29850,27294,3446,30740,329
2022-01-15,Marin,041,260295,28074,25248,1650,26898,251
2022-01-15,Mariposa,043,17540,1966,1762,87,1849,6
2022-01-15,Mendocino,045,87422,10567,9534,1400,10934,102
2022-01-15,Merced,047,269075,53091,48904,4293,53197,715
2022-01-15,Modoc,049,8938,643,628,218,846,6
2022-01-15,Mono,051,14174,2745,2508,95,2603,4
2022-01-15,Monterey,053,433212,64132,55315,7101,62416,647
2022-01-15,Napa,055,140530,20723,17648,571,18219,109
2022-01-15,Nevada,057,99092,13262,11773,737,12510,111
2022-01-15,Orange,059,3164182,481400,433141,34911,468052,5914
2022-01-15,Placer,061,380077,52798,47780,5953,53733,501
2022-01-15,Plumas,063,18699,2379,2158,136,2294,12
2022-01-15,Riverside,065,2383286,515210,466381,23892,490273,5578
2022-01-15,Sacramento,067,1510023,234007,208156,16211,224367,2491
2022-01-15,San Benito,069,59416,10664,9868,337,10205,87
2022-01-15,San Bernardino,071,2135413,505259,454395,20917,475312,6233
2022-01-15,San Diego,073,3302833,626362,559385,41179,600564,4540
2022-01-15,San Francisco,075,870044,101246,88004,6251,94255,692
2022-01-15,San Joaquin,077,732212,139122,125136,8080,133216,1954
2022-01-15,San Luis Obispo,079,281455,42599,38231,2673,40904,374
2022-01-15,San Mateo,081,765935,99317,80494,4499,84993,582
2022-01-15,Santa Barbara,083,443738,68935,62312,3242,65554,579
2022-01-15,Santa Clara,085,1922200,247243,218986,7900,226886,1974
2022-01-15,Santa Cruz,087,273765,33469,29414,1689,31103,235
2022-01-15,Shasta,089,179085,25959,24482,4590,29072,445
2022-01-15,Sierra,091,2930,251,232,30,262,0
2022-01-15,Siskiyou,093,43540,3846,3661,1883,5544,62
2022-01-15,Solano,095,438530,65979,58061,3787,61848,389
2022-01-15,Sonoma,097,501317,65966,58181,1751,59932,418
2022-01-15,Stanislaus,099,539301,99842,92986,12764,105750,1379
2022-01-15,Sutter,101,95872,17522,16345,899,17244,197
2022-01-15,Tehama,103,63373,10249,9572,2070,11642,141
2022-01-15,Trinity,105,12862,1001,872,249,1121,19
2022-01-15,Tulare,107,460477,86152,77769,21221,98990,1192
2022-01-15,Tuolumne,109,53932,9970,9042,240,9282,91
2022-01-15,Ventura,111,848112,149785,134736,8242,142978,1227
2022-01-15,Yolo,113,214977,30437,27311,2335,29646,270
2022-01-15,Yuba,115,75493,13233,12200,694,12894,101
2022-01-14,Alameda,001,1643700,202255,177768,9329,187097,1561
2022-01-14,Alpine,003,1148,116,117,0,117,0
2022-01-14,Amador,005,37829,6875,6434,205,6639,72
2022-01-14,Butte,007,227075,27345,25032,5185,30217,348
2022-01-14,Calaveras,009,45235,5861,5258,135,5393,93
2022-01-14,Colusa,011,21464,2958,2796,878,3674,21
2022-01-14,Contra Costa,013,1133247,153418,137643,8441,146084,1082
2022-01-14,Del Norte,015,27424,4239,4065,87,4152,43
2022-01-14,El Dorado,017,186661,22831,20434,2519,22953,175
2022-01-14,Fresno,019,978130,182514,167361,17598,184959,2415
2022-01-14,Glenn,021,27897,4198,3906,1318,5224,39
2022-01-14,Humboldt,023,135768,13667,12419,1734,14153,123
2022-01-14,Imperial,025,180216,46017,42508,7305,49813,817
2022-01-14,Inyo,027,18085,3690,3395,140,3535,49
2022-01-14,Kern,029,883053,163774,150085,35056,185141,1938
2022-01-14,Kings,031,150075,40589,37221,2565,39786,391
2022-01-14,Lake,033,64148,8220,7641,471,8112,117
2022-01-14,Lassen,035,31185,7546,7274,594,7868,55
2022-01-14,Los Angeles,037,10098052,2317289,2047927,104078,2152005,27641
2022-01-14,Madera,039,155013,29613,27294,3421,30715,329
2022-01-14,Marin,041,260295,27815,25248,1615,26863,251
2022-01-14,Mariposa,043,17540,1951,1762,87,1849,6
2022-01-14,Mendocino,045,87422,10455,9534,1387,10921,102
2022-01-14,Merced,047,269075,52906,48904,4278,53182,715
2022-01-14,Modoc,049,8938,642,628,218,846,6
2022-01-14,Mono,051,14174,2724,2508,93,2601,4
2022-01-14,Monterey,053,433212,63435,55315,7009,62324,647
2022-01-14,Napa,055,140530,20553,17648,565,18213,109
2022-01-14,Nevada,057,99092,13139,11773,724,12497,111
2022-01-14,Orange,059,3164182,477666,433141,34590,467731,5914
2022-01-14,Placer,061,380077,52361,47780,5867,53647,501
2022-01-14,Plumas,063,18699,2371,2158,129,2287,12
2022-01-14,Riverside,065,2383286,511683,466381,23748,490129,5578
2022-01-14,Sacramento,067,1510023,232062,208156,16054,224210,2491
2022-01-14,San Benito,069,59416,10612,9868,336,10204,87
2022-01-14,San Bernardino,071,2135413,502130,454395,20728,475123,6233
2022-01-14,San Diego,073,3302833,620710,559385,40869,600254,4540
2022-01-14,San Francisco,075,870044,100074,88004,6074,94078,692
2022-01-14,San Joaquin,077,732212,138273,125136,7998,133134,1954
2022-01-14,San Luis Obispo,079,281455,42433,38231,2650,40881,374
2022-01-14,San Mateo,081,765935,98090,80494,4470,84964,582
2022-01-14,Santa Barbara,083,443738,68416,62312,3232,65544,579
2022-01-14,Santa Clara,085,1922200,244670,218986,7793,226779,1974
2022-01-14,Santa Cruz,087,273765,33092,29414,1679,31093,235
2022-01-14,Shasta,089,179085,25838,24482,4556,29038,445
2022-01-14,Sierra,091,2930,249,232,28,260,0
2022-01-14,Siskiyou,093,43540,3835,3661,1870,5531,62
2022-01-14,Solano,095,438530,65136,58061,3697,61758,389
2022-01-14,Sonoma,097,501317,65427,58181,1724,59905,418
2022-01-14,Stanislaus,099,539301,99236,92986,12663,105649,1379
2022-01-14,Sutter,101,95872,17396,16345,890,17235,197
2022-01-14,Tehama,103,63373,10196,9572,2057,11629,141
2022-01-14,Trinity,105,12862,996,872,247,1119,19
2022-01-14,Tulare,107,460477,85618,77769,21047,98816,1192
2022-01-14,Tuolumne,109,53932,9847,9042,235,9277,91
2022-01-14,Ventura,111,848112,148678,134736,8182,142918,1227
2022-01-14,Yolo,113,214977,30195,27311,2305,29616,270
2022-01-14,Yuba,115,75493,13130,12200,689,12889,101
2022-01-13,Alameda,001,1643700,197931,177768,8980,186748,1561
2022-01-13,Alpine,003,1148,115,117,0,117,0
2022-01-13,Amador,005,37829,6815,6434,184,6618,72
2022-01-13,Butte,007,227075,27044,25032,5073,30105,348
2022-01-13,Calaveras,009,45235,5770,5258,131,5389,93
2022-01-13,Colusa,011,21464,2926,2796,868,3664,21
2022-01-13,Contra Costa,013,1133247,150895,137643,7986,145629,1082
2022-01-13,Del Norte,015,27424,4203,4065,86,4151,43
2022-01-13,El Dorado,017,186661,22583,20434,2473,22907,175
2022-01-13,Fresno,019,978130,179711,167361,17233,184594,2415
2022-01-13,Glenn,021,27897,4151,3906,1292,5198,39
2022-01-13,Humboldt,023,135768,13513,12419,1672,14091,123
2022-01-13,Imperial,025,180216,45473,42508,7084,49592,817
2022-01-13,Inyo,027,18085,3634,3395,123,3518,49
2022-01-13,Kern,029,883053,162189,150085,34459,184544,1938
2022-01-13,Kings,031,150075,40108,37221,2520,39741,391
2022-01-13,Lake,033,64148,8119,7641,450,8091,117
2022-01-13,Lassen,035,31185,7512,7274,578,7852,55
2022-01-13,Los Angeles,037,10098052,2280831,2047927,102291,2150218,27641
2022-01-13,Madera,039,155013,29146,27294,3327,30621,329
2022-01-13,Marin,041,260295,27470,25248,1571,26819,251
2022-01-13,Mariposa,043,17540,1928,1762,84,1846,6
2022-01-13,Mendocino,045,87422,10364,9534,1319,10853,102
2022-01-13,Merced,047,269075,52247,48904,4016,52920,715
2022-01-13,Modoc,049,8938,639,628,218,846,6
2022-01-13,Mono,051,14174,2701,2508,90,2598,4
2022-01-13,Monterey,053,433212,62499,55315,6720,62035,647
2022-01-13,Napa,055,140530,20255,17648,555,18203,109
2022-01-13,Nevada,057,99092,12948,11773,694,12467,111
2022-01-13,Orange,059,3164182,471224,433141,34135,467276,5914
2022-01-13,Placer,061,380077,51730,47780,5752,53532,501
2022-01-13,Plumas,063,18699,2351,2158,119,2277,12
2022-01-13,Riverside,065,2383286,505385,466381,23417,489798,5578
2022-01-13,Sacramento,067,1510023,228963,208156,15249,223405,2491
2022-01-13,San Benito,069,59416,10508,9868,328,10196,87
2022-01-13,San Bernardino,071,2135413,496402,454395,20253,474648,6233
2022-01-13,San Diego,073,3302833,612189,559385,39994,599379,4540
2022-01-13,San Francisco,075,870044,98338,88004,5878,93882,692
2022-01-13,San Joaquin,077,732212,136208,125136,7848,132984,1954
2022-01-13,San Luis Obispo,079,281455,41830,38231,2545,40776,374
2022-01-13,San Mateo,081,765935,96308,80494,4229,84723,582
2022-01-13,Santa Barbara,083,443738,67418,62312,3046,65358,579
2022-01-13,Santa Clara,085,1922200,240418,218986,7456,226442,1974
2022-01-13,Santa Cruz,087,273765,32276,29414,1657,31071,235
2022-01-13,Shasta,089,179085,25629,24482,4483,28965,445
2022-01-13,Sierra,091,2930,248,232,28,260,0
2022-01-13,Siskiyou,093,43540,3813,3661,1829,5490,62
2022-01-13,Solano,095,438530,64005,58061,3585,61646,389
2022-01-13,Sonoma,097,501317,64359,58181,1666,59847,418
2022-01-13,Stanislaus,099,539301,98119,92986,12381,105367,1379
2022-01-13,Sutter,101,95872,17200,16345,825,17170,197
2022-01-13,Tehama,103,63373,10097,9572,2008,11580,141
2022-01-13,Trinity,105,12862,988,872,247,1119,19
2022-01-13,Tulare,107,460477,84335,77769,20732,98501,1192
2022-01-13,Tuolumne,109,53932,9708,9042,217,9259,91
2022-01-13,Ventura,111,848112,146895,134736,8088,142824,1227
2022-01-13,Yolo,113,214977,29782,27311,2259,29570,270
2022-01-13,Yuba,115,75493,12995,12200,660,12860,101
2022-01-12,Alameda,001,1643700,193299,173001,8519,181520,1563
2022-01-12,Alpine,003,1148,115,117,0,117,0
2022-01-12,Amador,005,37829,6767,6354,170,6524,71
2022-01-12,Butte,007,227075,26719,24631,4983,29614,348
2022-01-12,Calaveras,009,45235,5691,5151,125,5276,93
2022-01-12,Colusa,011,21464,2887,2772,855,3627,21
2022-01-12,Contra Costa,013,1133247,148349,134579,7623,142202,1077
2022-01-12,Del Norte,015,27424,4176,4019,84,4103,43
2022-01-12,El Dorado,017,186661,22260,20092,2432,22524,175
2022-01-12,Fresno,019,978130,176978,165316,16816,182132,2413
2022-01-12,Glenn,021,27897,4099,3859,1270,5129,39
2022-01-12,Humboldt,023,135768,13341,12081,1590,13671,122
2022-01-12,Imperial,025,180216,44817,41985,6770,48755,814
2022-01-12,Inyo,027,18085,3588,3334,107,3441,49
2022-01-12,Kern,029,883053,160050,148435,33721,182156,1933
2022-01-12,Kings,031,150075,39476,36780,2476,39256,391
2022-01-12,Lake,033,64148,8003,7535,406,7941,117
2022-01-12,Lassen,035,31185,7470,7223,551,7774,55
2022-01-12,Los Angeles,037,10098052,2241115,2005065,100043,2105108,27601
2022-01-12,Madera,039,155013,28829,26952,3229,30181,329
2022-01-12,Marin,041,260295,26980,24704,1520,26224,251
2022-01-12,Mariposa,043,17540,1899,1725,82,1807,6
2022-01-12,Mendocino,045,87422,10200,9379,1219,10598,103
2022-01-12,Merced,047,269075,51547,48441,3740,52181,710
2022-01-12,Modoc,049,8938,637,627,218,845,6
2022-01-12,Mono,051,14174,2665,2466,86,2552,4
2022-01-12,Monterey,053,433212,61513,54524,6357,60881,647
2022-01-12,Napa,055,140530,19997,17347,532,17879,109
2022-01-12,Nevada,057,99092,12734,11552,646,12198,111
2022-01-12,Orange,059,3164182,464438,425737,33545,459282,5912
2022-01-12,Placer,061,380077,51074,47004,5639,52643,501
2022-01-12,Plumas,063,18699,2311,2135,108,2243,12
2022-01-12,Riverside,065,2383286,498173,458881,23072,481953,5565
2022-01-12,Sacramento,067,1510023,225376,204696,14350,219046,2479
2022-01-12,San Benito,069,59416,10377,9737,316,10053,87
2022-01-12,San Bernardino,071,2135413,490070,447869,19629,467498,6222
2022-01-12,San Diego,073,3302833,601680,551669,39135,590804,4529
2022-01-12,San Francisco,075,870044,96502,85700,5765,91465,691
2022-01-12,San Joaquin,077,732212,133925,122850,7719,130569,1948
2022-01-12,San Luis Obispo,079,281455,41102,37727,2462,40189,373
2022-01-12,San Mateo,081,765935,94276,78476,3851,82327,582
2022-01-12,Santa Barbara,083,443738,66274,60815,2941,63756,578
2022-01-12,Santa Clara,085,1922200,235925,213177,7073,220250,1971
2022-01-12,Santa Cruz,087,273765,31621,28463,1608,30071,235
2022-01-12,Shasta,089,179085,25416,24324,4417,28741,446
2022-01-12,Sierra,091,2930,247,228,28,256,0
2022-01-12,Siskiyou,093,43540,3785,3639,1782,5421,62
2022-01-12,Solano,095,438530,62959,57052,3463,60515,386
2022-01-12,Sonoma,097,501317,63072,56394,1582,57976,417
2022-01-12,Stanislaus,099,539301,96887,91738,12038,103776,1373
2022-01-12,Sutter,101,95872,17005,16135,792,16927,197
2022-01-12,Tehama,103,63373,10008,9475,1947,11422,141
2022-01-12,Trinity,105,12862,984,868,246,1114,19
2022-01-12,Tulare,107,460477,83207,76943,20321,97264,1192
2022-01-12,Tuolumne,109,53932,9577,8870,199,9069,91
2022-01-12,Ventura,111,848112,144984,132180,8004,140184,1220
2022-01-12,Yolo,113,214977,29369,26888,2181,29069,270
2022-01-12,Yuba,115,75493,12835,12015,633,12648,101
2022-01-11,Alameda,001,1643700,188768,169181,8118,177299,1561
2022-01-11,Alpine,003,1148,115,116,0,116,0
2022-01-11,Amador,005,37829,6683,6317,155,6472,71
2022-01-11,Butte,007,227075,26326,24479,4893,29372,347
2022-01-11,Calaveras,009,45235,5560,5083,111,5194,93
2022-01-11,Colusa,011,21464,2864,2766,841,3607,21
2022-01-11,Contra Costa,013,1133247,145379,132410,7139,139549,1077
2022-01-11,Del Norte,015,27424,4143,4006,82,4088,43
2022-01-11,El Dorado,017,186661,21914,19842,2359,22201,174
2022-01-11,Fresno,019,978130,173932,163509,16472,179981,2404
2022-01-11,Glenn,021,27897,4037,3844,1225,5069,39
2022-01-11,Humboldt,023,135768,13120,11960,1497,13457,122
2022-01-11,Imperial,025,180216,44212,41444,6564,48008,813
2022-01-11,Inyo,027,18085,3490,3278,100,3378,49
2022-01-11,Kern,029,883053,157766,146942,32889,179831,1929
2022-01-11,Kings,031,150075,38888,36524,2445,38969,389
2022-01-11,Lake,033,64148,7925,7494,390,7884,117
2022-01-11,Lassen,035,31185,7420,7210,537,7747,55
2022-01-11,Los Angeles,037,10098052,2198693,1966319,97813,2064132,27563
2022-01-11,Madera,039,155013,28413,26688,3149,29837,329
2022-01-11,Marin,041,260295,26622,24387,1475,25862,251
2022-01-11,Mariposa,043,17540,1877,1718,78,1796,6
2022-01-11,Mendocino,045,87422,10039,9301,1121,10422,102
2022-01-11,Merced,047,269075,50782,48068,3557,51625,708
2022-01-11,Modoc,049,8938,636,626,217,843,6
2022-01-11,Mono,051,14174,2622,2425,85,2510,4
2022-01-11,Monterey,053,433212,60470,53911,6006,59917,646
2022-01-11,Napa,055,140530,19556,17020,485,17505,109
2022-01-11,Nevada,057,99092,12508,11467,611,12078,110
2022-01-11,Orange,059,3164182,456766,417703,32909,450612,5909
2022-01-11,Placer,061,380077,50320,46459,5495,51954,500
2022-01-11,Plumas,063,18699,2276,2099,100,2199,12
2022-01-11,Riverside,065,2383286,490445,453766,22755,476521,5551
2022-01-11,Sacramento,067,1510023,221192,201058,13299,214357,2489
2022-01-11,San Benito,069,59416,10240,9624,303,9927,83
2022-01-11,San Bernardino,071,2135413,482320,442960,19020,461980,6198
2022-01-11,San Diego,073,3302833,589675,536954,38026,574980,4520
2022-01-11,San Francisco,075,870044,94299,83678,5605,89283,691
2022-01-11,San Joaquin,077,732212,131549,121139,7547,128686,1944
2022-01-11,San Luis Obispo,079,281455,40327,37183,2343,39526,372
2022-01-11,San Mateo,081,765935,91981,76756,3629,80385,582
2022-01-11,Santa Barbara,083,443738,64969,59758,2802,62560,578
2022-01-11,Santa Clara,085,1922200,230542,208425,6616,215041,1971
2022-01-11,Santa Cruz,087,273765,31113,27709,1557,29266,232
2022-01-11,Shasta,089,179085,25157,24132,4323,28455,446
2022-01-11,Sierra,091,2930,245,228,28,256,0
2022-01-11,Siskiyou,093,43540,3761,3621,1732,5353,62
2022-01-11,Solano,095,438530,61563,56349,3307,59656,388
2022-01-11,Sonoma,097,501317,61554,55411,1502,56913,416
2022-01-11,Stanislaus,099,539301,95520,90998,11673,102671,1372
2022-01-11,Sutter,101,95872,16804,15993,736,16729,197
2022-01-11,Tehama,103,63373,9879,9406,1899,11305,140
2022-01-11,Trinity,105,12862,972,858,244,1102,19
2022-01-11,Tulare,107,460477,81901,76267,19912,96179,1188
2022-01-11,Tuolumne,109,53932,9418,8811,192,9003,91
2022-01-11,Ventura,111,848112,142753,129548,7858,137406,1220
2022-01-11,Yolo,113,214977,28793,26482,2117,28599,270
2022-01-11,Yuba,115,75493,12661,11912,612,12524,101
2022-01-10,Alameda,001,1643700,183652,165657,7591,173248,1559
2022-01-10,Alpine,003,1148,115,116,0,116,0
2022-01-10,Amador,005,37829,6580,6279,139,6418,71
2022-01-10,Butte,007,227075,25986,24217,4804,29021,347
2022-01-10,Calaveras,009,45235,5461,5025,105,5130,93
2022-01-10,Colusa,011,21464,2835,2758,832,3590,21
2022-01-10,Contra Costa,013,1133247,142648,129951,6627,136578,1077
2022-01-10,Del Norte,015,27424,4120,3970,82,4052,43
2022-01-10,El Dorado,017,186661,21348,19606,2302,21908,172
2022-01-10,Fresno,019,978130,170888,161593,16072,177665,2404
2022-01-10,Glenn,021,27897,3978,3807,1211,5018,39
2022-01-10,Humboldt,023,135768,12877,11778,1364,13142,121
2022-01-10,Imperial,025,180216,43486,41080,6342,47422,811
2022-01-10,Inyo,027,18085,3435,3227,88,3315,49
2022-01-10,Kern,029,883053,155194,145744,32136,177880,1929
2022-01-10,Kings,031,150075,38269,36286,2408,38694,389
2022-01-10,Lake,033,64148,7836,7416,366,7782,117
2022-01-10,Lassen,035,31185,7382,7192,514,7706,55
2022-01-10,Los Angeles,037,10098052,2153177,1932475,95323,2027798,27546
2022-01-10,Madera,039,155013,27960,26501,3047,29548,328
2022-01-10,Marin,041,260295,26133,24023,1401,25424,251
2022-01-10,Mariposa,043,17540,1837,1684,72,1756,6
2022-01-10,Mendocino,045,87422,9866,9163,1033,10196,101
2022-01-10,Merced,047,269075,49973,47632,3276,50908,707
2022-01-10,Modoc,049,8938,635,622,215,837,6
2022-01-10,Mono,051,14174,2556,2415,80,2495,4
2022-01-10,Monterey,053,433212,59513,53485,5689,59174,645
2022-01-10,Napa,055,140530,19179,16775,470,17245,109
2022-01-10,Nevada,057,99092,12284,11300,573,11873,110
2022-01-10,Orange,059,3164182,448072,406170,32055,438225,5906
2022-01-10,Placer,061,380077,49470,45642,5333,50975,498
2022-01-10,Plumas,063,18699,2241,2086,98,2184,12
2022-01-10,Riverside,065,2383286,482190,445536,22301,467837,5546
2022-01-10,Sacramento,067,1510023,216686,198023,12227,210250,2474
2022-01-10,San Benito,069,59416,10069,9467,293,9760,83
2022-01-10,San Bernardino,071,2135413,474086,437207,18294,455501,6184
2022-01-10,San Diego,073,3302833,576975,530506,36887,567393,4500
2022-01-10,San Francisco,075,870044,92504,82209,5344,87553,690
2022-01-10,San Joaquin,077,732212,128885,119587,7261,126848,1927
2022-01-10,San Luis Obispo,079,281455,39510,36618,2245,38863,371
2022-01-10,San Mateo,081,765935,89333,75210,3371,78581,582
2022-01-10,Santa Barbara,083,443738,63709,58957,2612,61569,578
2022-01-10,Santa Clara,085,1922200,224761,203540,6130,209670,1971
2022-01-10,Santa Cruz,087,273765,30272,26906,1518,28424,232
2022-01-10,Shasta,089,179085,24960,23983,4245,28228,446
2022-01-10,Sierra,091,2930,242,223,28,251,0
2022-01-10,Siskiyou,093,43540,3728,3592,1688,5280,62
2022-01-10,Solano,095,438530,60524,55663,3098,58761,385
2022-01-10,Sonoma,097,501317,60006,54478,1455,55933,412
2022-01-10,Stanislaus,099,539301,94186,89997,11344,101341,1372
2022-01-10,Sutter,101,95872,16560,15823,689,16512,196
2022-01-10,Tehama,103,63373,9767,9360,1844,11204,140
2022-01-10,Trinity,105,12862,968,849,242,1091,19
2022-01-10,Tulare,107,460477,80402,75498,19499,94997,1186
2022-01-10,Tuolumne,109,53932,9292,8685,180,8865,91
2022-01-10,Ventura,111,848112,140145,126240,7708,133948,1217
2022-01-10,Yolo,113,214977,28196,26065,2062,28127,270
2022-01-10,Yuba,115,75493,12413,11776,577,12353,101
2022-01-09,Alameda,001,1643700,179133,162701,6918,169619,1561
2022-01-09,Alpine,003,1148,115,116,0,116,0
2022-01-09,Amador,005,37829,6492,6215,127,6342,71
2022-01-09,Butte,007,227075,25598,24018,4687,28705,347
2022-01-09,Calaveras,009,45235,5332,4976,96,5072,93
2022-01-09,Colusa,011,21464,2808,2750,809,3559,21
2022-01-09,Contra Costa,013,1133247,139786,128050,5973,134023,1077
2022-01-09,Del Norte,015,27424,4080,3950,78,4028,43
2022-01-09,El Dorado,017,186661,20986,19430,2236,21666,172
2022-01-09,Fresno,019,978130,168306,159989,15689,175678,2405
2022-01-09,Glenn,021,27897,3923,3797,1190,4987,39
2022-01-09,Humboldt,023,135768,12633,11582,1241,12823,121
2022-01-09,Imperial,025,180216,42647,40608,6073,46681,811
2022-01-09,Inyo,027,18085,3332,3149,79,3228,49
2022-01-09,Kern,029,883053,152735,144819,31387,176206,1927
2022-01-09,Kings,031,150075,37591,36041,2370,38411,389
2022-01-09,Lake,033,64148,7725,7393,321,7714,117
2022-01-09,Lassen,035,31185,7318,7172,485,7657,55
2022-01-09,Los Angeles,037,10098052,2105164,1887830,92320,1980150,27532
2022-01-09,Madera,039,155013,27578,26325,2946,29271,328
2022-01-09,Marin,041,260295,25683,23708,1310,25018,251
2022-01-09,Mariposa,043,17540,1787,1660,71,1731,6
2022-01-09,Mendocino,045,87422,9659,9097,921,10018,101
2022-01-09,Merced,047,269075,49102,47294,3004,50298,706
2022-01-09,Modoc,049,8938,633,619,215,834,6
2022-01-09,Mono,051,14174,2521,2390,73,2463,4
2022-01-09,Monterey,053,433212,58451,53251,5420,58671,645
2022-01-09,Napa,055,140530,18684,16614,454,17068,109
2022-01-09,Nevada,057,99092,12029,11152,512,11664,110
2022-01-09,Orange,059,3164182,438077,400563,31096,431659,5905
2022-01-09,Placer,061,380077,48479,45081,5182,50263,498
2022-01-09,Plumas,063,18699,2202,2081,78,2159,12
2022-01-09,Riverside,065,2383286,473203,440413,21753,462166,5546
2022-01-09,Sacramento,067,1510023,211885,195444,11077,206521,2475
2022-01-09,San Benito,069,59416,9883,9363,265,9628,83
2022-01-09,San Bernardino,071,2135413,465868,430257,17474,447731,6180
2022-01-09,San Diego,073,3302833,563819,478206,35031,513237,4500
2022-01-09,San Francisco,075,870044,90639,80463,5096,85559,690
2022-01-09,San Joaquin,077,732212,125808,118422,7094,125516,1927
2022-01-09,San Luis Obispo,079,281455,38703,36291,2137,38428,371
2022-01-09,San Mateo,081,765935,86824,73867,3040,76907,582
2022-01-09,Santa Barbara,083,443738,62025,58280,2349,60629,578
2022-01-09,Santa Clara,085,1922200,218711,199889,5584,205473,1976
2022-01-09,Santa Cruz,087,273765,29522,26513,1486,27999,232
2022-01-09,Shasta,089,179085,24719,23926,4157,28083,446
2022-01-09,Sierra,091,2930,239,223,26,249,0
2022-01-09,Siskiyou,093,43540,3699,3580,1627,5207,62
2022-01-09,Solano,095,438530,59367,54985,2810,57795,384
2022-01-09,Sonoma,097,501317,58330,53543,1417,54960,412
2022-01-09,Stanislaus,099,539301,92817,89248,11083,100331,1372
2022-01-09,Sutter,101,95872,16272,15695,609,16304,196
2022-01-09,Tehama,103,63373,9649,9306,1792,11098,140
2022-01-09,Trinity,105,12862,964,848,240,1088,19
2022-01-09,Tulare,107,460477,78985,75085,19105,94190,1186
2022-01-09,Tuolumne,109,53932,9135,8595,161,8756,91
2022-01-09,Ventura,111,848112,137092,124269,7464,131733,1217
2022-01-09,Yolo,113,214977,27589,25632,2015,27647,270
2022-01-09,Yuba,115,75493,12215,11666,546,12212,101
2022-01-08,Alameda,001,1643700,177239,148560,6774,155334,1558
2022-01-08,Alpine,003,1148,115,114,0,114,0
2022-01-08,Amador,005,37829,6461,6091,122,6213,71
2022-01-08,Butte,007,227075,25414,23429,4648,28077,347
2022-01-08,Calaveras,009,45235,5287,4823,92,4915,93
2022-01-08,Colusa,011,21464,2800,2713,806,3519,21
2022-01-08,Contra Costa,013,1133247,138279,119907,5893,125800,1077
2022-01-08,Del Norte,015,27424,4063,3902,78,3980,43
2022-01-08,El Dorado,017,186661,20805,18599,2202,20801,172
2022-01-08,Fresno,019,978130,167421,155394,15554,170948,2393
2022-01-08,Glenn,021,27897,3915,3732,1185,4917,39
2022-01-08,Humboldt,023,135768,12512,11149,1215,12364,121
2022-01-08,Imperial,025,180216,42459,39429,5928,45357,800
2022-01-08,Inyo,027,18085,3318,3020,76,3096,49
2022-01-08,Kern,029,883053,151599,140410,30953,171363,1921
2022-01-08,Kings,031,150075,37350,35275,2352,37627,390
2022-01-08,Lake,033,64148,7685,7209,313,7522,117
2022-01-08,Lassen,035,31185,7288,7127,469,7596,55
2022-01-08,Los Angeles,037,10098052,2086790,1765787,90573,1856360,27476
2022-01-08,Madera,039,155013,27411,25767,2909,28676,328
2022-01-08,Marin,041,260295,25401,22377,1299,23676,251
2022-01-08,Mariposa,043,17540,1777,1588,71,1659,6
2022-01-08,Mendocino,045,87422,9585,8792,919,9711,101
2022-01-08,Merced,047,269075,48929,46094,2984,49078,703
2022-01-08,Modoc,049,8938,633,610,215,825,6
2022-01-08,Mono,051,14174,2510,2240,68,2308,4
2022-01-08,Monterey,053,433212,58063,51721,5327,57048,644
2022-01-08,Napa,055,140530,18530,15819,428,16247,109
2022-01-08,Nevada,057,99092,11942,10765,499,11264,110
2022-01-08,Orange,059,3164182,434282,375124,30241,405365,5903
2022-01-08,Placer,061,380077,48035,43172,5140,48312,495
2022-01-08,Plumas,063,18699,2192,2053,73,2126,12
2022-01-08,Riverside,065,2383286,469687,422591,21480,444071,5535
2022-01-08,Sacramento,067,1510023,210453,185118,10912,196030,2470
2022-01-08,San Benito,069,59416,9721,9016,262,9278,83
2022-01-08,San Bernardino,071,2135413,462500,411724,17076,428800,6122
2022-01-08,San Diego,073,3302833,558916,472273,34488,506761,4495
2022-01-08,San Francisco,075,870044,89440,73660,4815,78475,690
2022-01-08,San Joaquin,077,732212,124841,112514,6993,119507,1916
2022-01-08,San Luis Obispo,079,281455,38501,34489,2094,36583,369
2022-01-08,San Mateo,081,765935,85441,67918,2953,70871,582
2022-01-08,Santa Barbara,083,443738,61330,54617,2315,56932,575
2022-01-08,Santa Clara,085,1922200,215671,183842,5376,189218,1966
2022-01-08,Santa Cruz,087,273765,29096,24678,1465,26143,230
2022-01-08,Shasta,089,179085,24628,23585,4125,27710,445
2022-01-08,Sierra,091,2930,235,215,25,240,0
2022-01-08,Siskiyou,093,43540,3687,3545,1613,5158,62
2022-01-08,Solano,095,438530,58959,52452,2735,55187,383
2022-01-08,Sonoma,097,501317,57806,50130,1383,51513,411
2022-01-08,Stanislaus,099,539301,92177,87049,10974,98023,1372
2022-01-08,Sutter,101,95872,16153,15261,596,15857,195
2022-01-08,Tehama,103,63373,9618,9109,1784,10893,140
2022-01-08,Trinity,105,12862,958,836,240,1076,19
2022-01-08,Tulare,107,460477,78592,73600,18968,92568,1185
2022-01-08,Tuolumne,109,53932,9029,8360,158,8518,91
2022-01-08,Ventura,111,848112,135922,117229,7329,124558,1216
2022-01-08,Yolo,113,214977,27295,24006,1985,25991,270
2022-01-08,Yuba,115,75493,12128,11277,543,11820,101
2022-01-07,Alameda,001,1643700,174548,148560,6663,155223,1558
2022-01-07,Alpine,003,1148,115,114,0,114,0
2022-01-07,Amador,005,37829,6412,6091,119,6210,71
2022-01-07,Butte,007,227075,25210,23429,4614,28043,347
2022-01-07,Calaveras,009,45235,5248,4823,92,4915,93
2022-01-07,Colusa,011,21464,2791,2713,795,3508,21
2022-01-07,Contra Costa,013,1133247,136414,119907,5772,125679,1077
2022-01-07,Del Norte,015,27424,4047,3902,77,3979,43
2022-01-07,El Dorado,017,186661,20642,18599,2188,20787,172
2022-01-07,Fresno,019,978130,166061,155394,15456,170850,2393
2022-01-07,Glenn,021,27897,3895,3732,1182,4914,39
2022-01-07,Humboldt,023,135768,12369,11149,1187,12336,121
2022-01-07,Imperial,025,180216,42300,39429,5844,45273,800
2022-01-07,Inyo,027,18085,3299,3020,74,3094,49
2022-01-07,Kern,029,883053,150629,140410,30508,170918,1921
2022-01-07,Kings,031,150075,37169,35275,2338,37613,390
2022-01-07,Lake,033,64148,7637,7209,287,7496,117
2022-01-07,Lassen,035,31185,7272,7127,466,7593,55
2022-01-07,Los Angeles,037,10098052,2055617,1765787,89107,1854894,27476
2022-01-07,Madera,039,155013,27229,25767,2874,28641,328
2022-01-07,Marin,041,260295,25020,22377,1281,23658,251
2022-01-07,Mariposa,043,17540,1761,1588,71,1659,6
2022-01-07,Mendocino,045,87422,9492,8792,918,9710,101
2022-01-07,Merced,047,269075,48763,46094,2960,49054,703
2022-01-07,Modoc,049,8938,632,610,215,825,6
2022-01-07,Mono,051,14174,2472,2240,62,2302,4
2022-01-07,Monterey,053,433212,57643,51721,5232,56953,644
2022-01-07,Napa,055,140530,18303,15819,407,16226,109
2022-01-07,Nevada,057,99092,11813,10765,478,11243,110
2022-01-07,Orange,059,3164182,429468,375124,29621,404745,5903
2022-01-07,Placer,061,380077,47528,43172,5091,48263,495
2022-01-07,Plumas,063,18699,2183,2053,72,2125,12
2022-01-07,Riverside,065,2383286,465858,422591,21250,443841,5535
2022-01-07,Sacramento,067,1510023,208175,185118,10752,195870,2470
2022-01-07,San Benito,069,59416,9676,9016,261,9277,83
2022-01-07,San Bernardino,071,2135413,458536,411724,16843,428567,6122
2022-01-07,San Diego,073,3302833,551790,472273,33941,506214,4495
2022-01-07,San Francisco,075,870044,87999,73660,4555,78215,690
2022-01-07,San Joaquin,077,732212,123891,112514,6931,119445,1916
2022-01-07,San Luis Obispo,079,281455,38286,34489,2039,36528,369
2022-01-07,San Mateo,081,765935,83974,67918,2894,70812,582
2022-01-07,Santa Barbara,083,443738,60634,54617,2293,56910,575
2022-01-07,Santa Clara,085,1922200,212424,183842,5266,189108,1966
2022-01-07,Santa Cruz,087,273765,28616,24678,1449,26127,230
2022-01-07,Shasta,089,179085,24529,23585,4091,27676,445
2022-01-07,Sierra,091,2930,232,215,25,240,0
2022-01-07,Siskiyou,093,43540,3676,3545,1601,5146,62
2022-01-07,Solano,095,438530,58278,52452,2690,55142,383
2022-01-07,Sonoma,097,501317,57203,50130,1295,51425,411
2022-01-07,Stanislaus,099,539301,91649,87049,10886,97935,1372
2022-01-07,Sutter,101,95872,16002,15261,583,15844,195
2022-01-07,Tehama,103,63373,9582,9109,1771,10880,140
2022-01-07,Trinity,105,12862,951,836,239,1075,19
2022-01-07,Tulare,107,460477,78160,73600,18821,92421,1185
2022-01-07,Tuolumne,109,53932,8941,8360,154,8514,91
2022-01-07,Ventura,111,848112,134293,117229,7194,124423,1216
2022-01-07,Yolo,113,214977,26921,24006,1966,25972,270
2022-01-07,Yuba,115,75493,12023,11277,538,11815,101
2022-01-06,Alameda,001,1643700,169173,148560,6249,154809,1558
2022-01-06,Alpine,003,1148,114,114,0,114,0
2022-01-06,Amador,005,37829,6361,6091,114,6205,71
2022-01-06,Butte,007,227075,24916,23429,4529,27958,347
2022-01-06,Calaveras,009,45235,5131,4823,90,4913,93
2022-01-06,Colusa,011,21464,2771,2713,786,3499,21
2022-01-06,Contra Costa,013,1133247,133543,119907,5357,125264,1077
2022-01-06,Del Norte,015,27424,4013,3902,75,3977,43
2022-01-06,El Dorado,017,186661,20310,18599,2148,20747,172
2022-01-06,Fresno,019,978130,163933,155394,15190,170584,2393
2022-01-06,Glenn,021,27897,3868,3732,1156,4888,39
2022-01-06,Humboldt,023,135768,12143,11149,1146,12295,121
2022-01-06,Imperial,025,180216,41715,39429,5642,45071,800
2022-01-06,Inyo,027,18085,3261,3020,74,3094,49
2022-01-06,Kern,029,883053,148960,140410,29831,170241,1921
2022-01-06,Kings,031,150075,36844,35275,2312,37587,390
2022-01-06,Lake,033,64148,7564,7209,275,7484,117
2022-01-06,Lassen,035,31185,7249,7127,460,7587,55
2022-01-06,Los Angeles,037,10098052,2001482,1765787,86744,1852531,27476
2022-01-06,Madera,039,155013,26924,25767,2817,28584,328
2022-01-06,Marin,041,260295,24619,22377,1248,23625,251
2022-01-06,Mariposa,043,17540,1742,1588,70,1658,6
2022-01-06,Mendocino,045,87422,9395,8792,877,9669,101
2022-01-06,Merced,047,269075,48214,46094,2820,48914,703
2022-01-06,Modoc,049,8938,631,610,215,825,6
2022-01-06,Mono,051,14174,2449,2240,59,2299,4
2022-01-06,Monterey,053,433212,56922,51721,4978,56699,644
2022-01-06,Napa,055,140530,17905,15819,398,16217,109
2022-01-06,Nevada,057,99092,11618,10765,466,11231,110
2022-01-06,Orange,059,3164182,420019,375124,28874,403998,5903
2022-01-06,Placer,061,380077,46782,43172,5003,48175,495
2022-01-06,Plumas,063,18699,2165,2053,64,2117,12
2022-01-06,Riverside,065,2383286,458384,422591,20955,443546,5535
2022-01-06,Sacramento,067,1510023,204117,185118,9989,195107,2470
2022-01-06,San Benito,069,59416,9575,9016,254,9270,83
2022-01-06,San Bernardino,071,2135413,451106,411724,16350,428074,6122
2022-01-06,San Diego,073,3302833,540149,472273,32938,505211,4495
2022-01-06,San Francisco,075,870044,85687,73660,4301,77961,690
2022-01-06,San Joaquin,077,732212,121727,112514,6846,119360,1916
2022-01-06,San Luis Obispo,079,281455,37586,34489,1968,36457,369
2022-01-06,San Mateo,081,765935,81552,67918,2713,70631,582
2022-01-06,Santa Barbara,083,443738,59466,54617,2231,56848,575
2022-01-06,Santa Clara,085,1922200,207531,183842,4875,188717,1966
2022-01-06,Santa Cruz,087,273765,28056,24678,1425,26103,230
2022-01-06,Shasta,089,179085,24382,23585,4041,27626,445
2022-01-06,Sierra,091,2930,229,215,25,240,0
2022-01-06,Siskiyou,093,43540,3660,3545,1555,5100,62
2022-01-06,Solano,095,438530,57266,52452,2504,54956,383
2022-01-06,Sonoma,097,501317,55811,50130,1262,51392,411
2022-01-06,Stanislaus,099,539301,90499,87049,10721,97770,1372
2022-01-06,Sutter,101,95872,15825,15261,554,15815,195
2022-01-06,Tehama,103,63373,9504,9109,1744,10853,140
2022-01-06,Trinity,105,12862,944,836,238,1074,19
2022-01-06,Tulare,107,460477,77453,73600,18648,92248,1185
2022-01-06,Tuolumne,109,53932,8831,8360,148,8508,91
2022-01-06,Ventura,111,848112,131597,117229,7034,124263,1216
2022-01-06,Yolo,113,214977,26365,24006,1923,25929,270
2022-01-06,Yuba,115,75493,11887,11277,521,11798,101
2022-01-05,Alameda,001,1643700,164005,144824,5826,150650,1548
2022-01-05,Alpine,003,1148,114,112,0,112,0
2022-01-05,Amador,005,37829,6318,6012,111,6123,70
2022-01-05,Butte,007,227075,24612,23134,4471,27605,343
2022-01-05,Calaveras,009,45235,5074,4758,88,4846,90
2022-01-05,Colusa,011,21464,2759,2704,775,3479,21
2022-01-05,Contra Costa,013,1133247,130533,117188,4908,122096,1071
2022-01-05,Del Norte,015,27424,3992,3862,73,3935,43
2022-01-05,El Dorado,017,186661,19924,18367,2118,20485,171
2022-01-05,Fresno,019,978130,161921,153033,14918,167951,2377
2022-01-05,Glenn,021,27897,3820,3700,1146,4846,39
2022-01-05,Humboldt,023,135768,11939,10938,1098,12036,120
2022-01-05,Imperial,025,180216,41086,38789,5486,44275,800
2022-01-05,Inyo,027,18085,3179,2939,70,3009,49
2022-01-05,Kern,029,883053,147182,138186,29254,167440,1913
2022-01-05,Kings,031,150075,36501,34893,2293,37186,387
2022-01-05,Lake,033,64148,7481,7129,259,7388,117
2022-01-05,Lassen,035,31185,7229,7077,452,7529,55
2022-01-05,Los Angeles,037,10098052,1945217,1729640,84347,1813987,27443
2022-01-05,Madera,039,155013,26684,25392,2725,28117,327
2022-01-05,Marin,041,260295,24273,21829,1196,23025,251
2022-01-05,Mariposa,043,17540,1716,1564,69,1633,6
2022-01-05,Mendocino,045,87422,9264,8625,842,9467,101
2022-01-05,Merced,047,269075,47638,45721,2688,48409,700
2022-01-05,Modoc,049,8938,628,603,215,818,6
2022-01-05,Mono,051,14174,2430,2201,55,2256,4
2022-01-05,Monterey,053,433212,56099,51241,4778,56019,639
2022-01-05,Napa,055,140530,17541,15494,366,15860,108
2022-01-05,Nevada,057,99092,11423,10624,449,11073,110
2022-01-05,Orange,059,3164182,409978,366139,27821,393960,5869
2022-01-05,Placer,061,380077,45905,42456,4907,47363,492
2022-01-05,Plumas,063,18699,2145,2020,62,2082,12
2022-01-05,Riverside,065,2383286,450927,415253,20600,435853,5502
2022-01-05,Sacramento,067,1510023,199335,181488,9002,190490,2455
2022-01-05,San Benito,069,59416,9382,8829,242,9071,83
2022-01-05,San Bernardino,071,2135413,442719,405323,15791,421114,6085
2022-01-05,San Diego,073,3302833,526550,466602,31957,498559,4495
2022-01-05,San Francisco,075,870044,83127,71405,4163,75568,686
2022-01-05,San Joaquin,077,732212,119203,110497,6766,117263,1903
2022-01-05,San Luis Obispo,079,281455,36789,34066,1891,35957,369
2022-01-05,San Mateo,081,765935,79389,66018,2514,68532,578
2022-01-05,Santa Barbara,083,443738,58160,53082,2151,55233,570
2022-01-05,Santa Clara,085,1922200,201776,178629,4457,183086,1961
2022-01-05,Santa Cruz,087,273765,27302,24394,1402,25796,229
2022-01-05,Shasta,089,179085,24226,23361,4012,27373,441
2022-01-05,Sierra,091,2930,226,210,23,233,0
2022-01-05,Siskiyou,093,43540,3650,3513,1526,5039,60
2022-01-05,Solano,095,438530,56220,51505,2368,53873,380
2022-01-05,Sonoma,097,501317,54546,49120,1100,50220,412
2022-01-05,Stanislaus,099,539301,89516,86248,10564,96812,1360
2022-01-05,Sutter,101,95872,15623,15117,514,15631,193
2022-01-05,Tehama,103,63373,9407,9011,1713,10724,140
2022-01-05,Trinity,105,12862,940,822,236,1058,19
2022-01-05,Tulare,107,460477,76673,72718,18473,91191,1173
2022-01-05,Tuolumne,109,53932,8739,8223,141,8364,90
2022-01-05,Ventura,111,848112,128845,114752,6825,121577,1211
2022-01-05,Yolo,113,214977,25753,23401,1879,25280,269
2022-01-05,Yuba,115,75493,11705,11138,495,11633,100
2022-01-04,Alameda,001,1643700,158519,143360,5420,148780,1532
2022-01-04,Alpine,003,1148,114,113,0,113,0
2022-01-04,Amador,005,37829,6251,6025,105,6130,71
2022-01-04,Butte,007,227075,24316,23094,4403,27497,346
2022-01-04,Calaveras,009,45235,4998,4767,85,4852,93
2022-01-04,Colusa,011,21464,2742,2689,768,3457,21
2022-01-04,Contra Costa,013,1133247,127432,116005,4549,120554,1075
2022-01-04,Del Norte,015,27424,3960,3882,70,3952,43
2022-01-04,El Dorado,017,186661,19566,18339,2097,20436,172
2022-01-04,Fresno,019,978130,159768,153244,14665,167909,2380
2022-01-04,Glenn,021,27897,3790,3705,1132,4837,39
2022-01-04,Humboldt,023,135768,11689,10865,1047,11912,120
2022-01-04,Imperial,025,180216,40485,38596,5223,43819,800
2022-01-04,Inyo,027,18085,3096,2870,69,2939,49
2022-01-04,Kern,029,883053,145250,138245,28666,166911,1916
2022-01-04,Kings,031,150075,36179,34931,2277,37208,388
2022-01-04,Lake,033,64148,7440,7152,249,7401,117
2022-01-04,Lassen,035,31185,7206,7111,448,7559,55
2022-01-04,Los Angeles,037,10098052,1885271,1705253,82002,1787255,27419
2022-01-04,Madera,039,155013,26340,25425,2657,28082,328
2022-01-04,Marin,041,260295,23792,21675,1136,22811,251
2022-01-04,Mariposa,043,17540,1680,1564,68,1632,6
2022-01-04,Mendocino,045,87422,9141,8636,818,9454,101
2022-01-04,Merced,047,269075,47027,45583,2557,48140,700
2022-01-04,Modoc,049,8938,625,611,215,826,6
2022-01-04,Mono,051,14174,2381,2190,45,2235,4
2022-01-04,Monterey,053,433212,55365,51176,4554,55730,643
2022-01-04,Napa,055,140530,17037,15370,336,15706,107
2022-01-04,Nevada,057,99092,11265,10608,437,11045,110
2022-01-04,Orange,059,3164182,399226,362051,26680,388731,5897
2022-01-04,Placer,061,380077,45068,42285,4789,47074,494
2022-01-04,Plumas,063,18699,2119,2014,60,2074,12
2022-01-04,Riverside,065,2383286,442394,413366,20249,433615,5504
2022-01-04,Sacramento,067,1510023,194358,181271,8245,189516,2453
2022-01-04,San Benito,069,59416,9194,8763,234,8997,79
2022-01-04,San Bernardino,071,2135413,433892,404409,15254,419663,6060
2022-01-04,San Diego,073,3302833,510190,458499,30990,489489,4487
2022-01-04,San Francisco,075,870044,80285,70666,4017,74683,688
2022-01-04,San Joaquin,077,732212,116788,110374,6612,116986,1911
2022-01-04,San Luis Obispo,079,281455,35981,33788,1803,35591,371
2022-01-04,San Mateo,081,765935,77085,65157,2324,67481,582
2022-01-04,Santa Barbara,083,443738,56636,52449,2073,54522,574
2022-01-04,Santa Clara,085,1922200,195811,176854,3989,180843,1964
2022-01-04,Santa Cruz,087,273765,26539,23904,1366,25270,228
2022-01-04,Shasta,089,179085,24081,23366,3958,27324,442
2022-01-04,Sierra,091,2930,225,214,22,236,0
2022-01-04,Siskiyou,093,43540,3634,3509,1507,5016,61
2022-01-04,Solano,095,438530,54917,51300,2171,53471,383
2022-01-04,Sonoma,097,501317,52838,48653,977,49630,410
2022-01-04,Stanislaus,099,539301,88456,86107,10403,96510,1361
2022-01-04,Sutter,101,95872,15470,15032,490,15522,193
2022-01-04,Tehama,103,63373,9328,9020,1690,10710,140
2022-01-04,Trinity,105,12862,935,833,232,1065,18
2022-01-04,Tulare,107,460477,75881,72893,18268,91161,1172
2022-01-04,Tuolumne,109,53932,8629,8235,136,8371,91
2022-01-04,Ventura,111,848112,125779,114079,6589,120668,1213
2022-01-04,Yolo,113,214977,25102,22938,1834,24772,270
2022-01-04,Yuba,115,75493,11525,11104,480,11584,101
2022-01-03,Alameda,001,1643700,152577,142090,4984,147074,1529
2022-01-03,Alpine,003,1148,113,113,0,113,0
2022-01-03,Amador,005,37829,6189,6004,100,6104,71
2022-01-03,Butte,007,227075,24024,22924,4351,27275,345
2022-01-03,Calaveras,009,45235,4939,4742,80,4822,93
2022-01-03,Colusa,011,21464,2733,2683,761,3444,21
2022-01-03,Contra Costa,013,1133247,124137,114966,3961,118927,1073
2022-01-03,Del Norte,015,27424,3940,3873,66,3939,43
2022-01-03,El Dorado,017,186661,19173,18183,2070,20253,172
2022-01-03,Fresno,019,978130,157785,152674,14466,167140,2379
2022-01-03,Glenn,021,27897,3761,3703,1097,4800,39
2022-01-03,Humboldt,023,135768,11481,10784,999,11783,119
2022-01-03,Imperial,025,180216,39853,38411,5042,43453,800
2022-01-03,Inyo,027,18085,3027,2845,65,2910,49
2022-01-03,Kern,029,883053,143254,137773,28069,165842,1916
2022-01-03,Kings,031,150075,35856,34817,2248,37065,387
2022-01-03,Lake,033,64148,7338,7134,231,7365,117
2022-01-03,Lassen,035,31185,7188,7103,445,7548,55
2022-01-03,Los Angeles,037,10098052,1824501,1686203,79234,1765437,27394
2022-01-03,Madera,039,155013,26047,25323,2613,27936,320
2022-01-03,Marin,041,260295,23199,21532,1097,22629,251
2022-01-03,Mariposa,043,17540,1638,1559,68,1627,6
2022-01-03,Mendocino,045,87422,8993,8573,768,9341,101
2022-01-03,Merced,047,269075,46432,45459,2449,47908,696
2022-01-03,Modoc,049,8938,622,602,215,817,6
2022-01-03,Mono,051,14174,2303,2172,40,2212,4
2022-01-03,Monterey,053,433212,54537,51047,4345,55392,644
2022-01-03,Napa,055,140530,16529,15260,303,15563,107
2022-01-03,Nevada,057,99092,11100,10572,428,11000,110
2022-01-03,Orange,059,3164182,388052,358052,25485,383537,5894
2022-01-03,Placer,061,380077,44245,42054,4725,46779,489
2022-01-03,Plumas,063,18699,2099,2005,60,2065,12
2022-01-03,Riverside,065,2383286,433916,410155,19752,429907,5504
2022-01-03,Sacramento,067,1510023,189196,179992,7678,187670,2452
2022-01-03,San Benito,069,59416,9030,8688,227,8915,79
2022-01-03,San Bernardino,071,2135413,425329,401938,14792,416730,6056
2022-01-03,San Diego,073,3302833,494073,451154,30026,481180,4476
2022-01-03,San Francisco,075,870044,77485,69315,3767,73082,686
2022-01-03,San Joaquin,077,732212,114478,109757,6476,116233,1903
2022-01-03,San Luis Obispo,079,281455,35171,33667,1710,35377,367
2022-01-03,San Mateo,081,765935,74378,64470,2167,66637,582
2022-01-03,Santa Barbara,083,443738,55175,51912,1978,53890,571
2022-01-03,Santa Clara,085,1922200,189875,174215,3512,177727,1963
2022-01-03,Santa Cruz,087,273765,25731,23765,1333,25098,228
2022-01-03,Shasta,089,179085,23903,23301,3931,27232,440
2022-01-03,Sierra,091,2930,218,213,21,234,0
2022-01-03,Siskiyou,093,43540,3608,3500,1485,4985,61
2022-01-03,Solano,095,438530,53618,51030,1979,53009,380
2022-01-03,Sonoma,097,501317,51137,48391,879,49270,410
2022-01-03,Stanislaus,099,539301,87465,85793,10228,96021,1332
2022-01-03,Sutter,101,95872,15313,14973,469,15442,193
2022-01-03,Tehama,103,63373,9253,9005,1664,10669,140
2022-01-03,Trinity,105,12862,930,833,231,1064,18
2022-01-03,Tulare,107,460477,75182,72664,18046,90710,1167
2022-01-03,Tuolumne,109,53932,8492,8179,132,8311,91
2022-01-03,Ventura,111,848112,122606,112762,6346,119108,1211
2022-01-03,Yolo,113,214977,24420,22563,1771,24334,270
2022-01-03,Yuba,115,75493,11392,11037,461,11498,99
2022-01-02,Alameda,001,1643700,148168,133486,4504,137990,1528
2022-01-02,Alpine,003,1148,111,113,0,113,0
2022-01-02,Amador,005,37829,6121,5913,95,6008,70
2022-01-02,Butte,007,227075,23687,22469,4291,26760,341
2022-01-02,Calaveras,009,45235,4870,4668,72,4740,93
2022-01-02,Colusa,011,21464,2727,2659,750,3409,21
2022-01-02,Contra Costa,013,1133247,120576,109593,3521,113114,1073
2022-01-02,Del Norte,015,27424,3908,3841,64,3905,43
2022-01-02,El Dorado,017,186661,18836,17621,2018,19639,172
2022-01-02,Fresno,019,978130,156065,149927,14235,164162,2379
2022-01-02,Glenn,021,27897,3742,3663,1088,4751,39
2022-01-02,Humboldt,023,135768,11238,10381,921,11302,119
2022-01-02,Imperial,025,180216,39197,37672,4831,42503,800
2022-01-02,Inyo,027,18085,2958,2726,54,2780,49
2022-01-02,Kern,029,883053,141334,136123,27470,163593,1917
2022-01-02,Kings,031,150075,35532,34318,2213,36531,386
2022-01-02,Lake,033,64148,7267,7060,217,7277,117
2022-01-02,Lassen,035,31185,7172,7089,443,7532,55
2022-01-02,Los Angeles,037,10098052,1773363,1596123,76344,1672467,27371
2022-01-02,Madera,039,155013,25794,25002,2554,27556,320
2022-01-02,Marin,041,260295,22635,20475,1026,21501,249
2022-01-02,Mariposa,043,17540,1607,1509,66,1575,6
2022-01-02,Mendocino,045,87422,8869,8422,750,9172,101
2022-01-02,Merced,047,269075,45894,44769,2353,47122,694
2022-01-02,Modoc,049,8938,620,601,214,815,6
2022-01-02,Mono,051,14174,2274,2101,35,2136,4
2022-01-02,Monterey,053,433212,53912,50251,4134,54385,643
2022-01-02,Napa,055,140530,15987,14439,292,14731,107
2022-01-02,Nevada,057,99092,10911,10299,411,10710,110
2022-01-02,Orange,059,3164182,377042,339526,24332,363858,5890
2022-01-02,Placer,061,380077,43520,40857,4638,45495,489
2022-01-02,Plumas,063,18699,2084,1994,56,2050,12
2022-01-02,Riverside,065,2383286,425574,397124,19231,416355,5501
2022-01-02,Sacramento,067,1510023,185112,173562,6817,180379,2448
2022-01-02,San Benito,069,59416,8848,8320,212,8532,79
2022-01-02,San Bernardino,071,2135413,417504,386278,14231,400509,6051
2022-01-02,San Diego,073,3302833,479039,427087,28847,455934,4469
2022-01-02,San Francisco,075,870044,74550,64498,3527,68025,682
2022-01-02,San Joaquin,077,732212,112605,106640,6327,112967,1902
2022-01-02,San Luis Obispo,079,281455,34436,32342,1627,33969,365
2022-01-02,San Mateo,081,765935,71809,60504,1925,62429,581
2022-01-02,Santa Barbara,083,443738,53741,49555,1915,51470,568
2022-01-02,Santa Clara,085,1922200,183729,164547,3111,167658,1969
2022-01-02,Santa Cruz,087,273765,25061,22980,1300,24280,228
2022-01-02,Shasta,089,179085,23710,23161,3882,27043,435
2022-01-02,Sierra,091,2930,217,206,21,227,0
2022-01-02,Siskiyou,093,43540,3583,3474,1462,4936,61
2022-01-02,Solano,095,438530,52678,48957,1814,50771,379
2022-01-02,Sonoma,097,501317,49819,46040,842,46882,410
2022-01-02,Stanislaus,099,539301,86611,84367,10096,94463,1332
2022-01-02,Sutter,101,95872,15140,14741,450,15191,193
2022-01-02,Tehama,103,63373,9190,8944,1641,10585,139
2022-01-02,Trinity,105,12862,928,832,230,1062,17
2022-01-02,Tulare,107,460477,74524,71941,17852,89793,1160
2022-01-02,Tuolumne,109,53932,8386,8044,127,8171,91
2022-01-02,Ventura,111,848112,119682,107992,6123,114115,1211
2022-01-02,Yolo,113,214977,23745,21747,1701,23448,270
2022-01-02,Yuba,115,75493,11267,10844,444,11288,99
2022-01-01,Alameda,001,1643700,146361,133486,4252,137738,1528
2022-01-01,Alpine,003,1148,111,113,0,113,0
2022-01-01,Amador,005,37829,6085,5913,90,6003,70
2022-01-01,Butte,007,227075,23491,22469,4259,26728,341
2022-01-01,Calaveras,009,45235,4833,4668,70,4738,93
2022-01-01,Colusa,011,21464,2723,2659,739,3398,21
2022-01-01,Contra Costa,013,1133247,119215,109593,3393,112986,1073
2022-01-01,Del Norte,015,27424,3902,3841,64,3905,43
2022-01-01,El Dorado,017,186661,18688,17621,2003,19624,172
2022-01-01,Fresno,019,978130,155399,149927,14157,164084,2379
2022-01-01,Glenn,021,27897,3735,3663,1088,4751,39
2022-01-01,Humboldt,023,135768,11101,10381,900,11281,119
2022-01-01,Imperial,025,180216,39049,37672,4783,42455,800
2022-01-01,Inyo,027,18085,2929,2726,52,2778,49
2022-01-01,Kern,029,883053,140634,136123,27160,163283,1917
2022-01-01,Kings,031,150075,35391,34318,2186,36504,386
2022-01-01,Lake,033,64148,7229,7060,212,7272,117
2022-01-01,Lassen,035,31185,7166,7089,438,7527,55
2022-01-01,Los Angeles,037,10098052,1753253,1596123,74379,1670502,27371
2022-01-01,Madera,039,155013,25710,25002,2540,27542,320
2022-01-01,Marin,041,260295,22322,20475,985,21460,249
2022-01-01,Mariposa,043,17540,1596,1509,66,1575,6
2022-01-01,Mendocino,045,87422,8777,8422,744,9166,101
2022-01-01,Merced,047,269075,45761,44769,2342,47111,694
2022-01-01,Modoc,049,8938,617,601,214,815,6
2022-01-01,Mono,051,14174,2250,2101,30,2131,4
2022-01-01,Monterey,053,433212,53602,50251,4047,54298,643
2022-01-01,Napa,055,140530,15837,14439,277,14716,107
2022-01-01,Nevada,057,99092,10836,10299,404,10703,110
2022-01-01,Orange,059,3164182,372821,339526,23622,363148,5890
2022-01-01,Placer,061,380077,43217,40857,4573,45430,489
2022-01-01,Plumas,063,18699,2072,1994,56,2050,12
2022-01-01,Riverside,065,2383286,422083,397124,19027,416151,5501
2022-01-01,Sacramento,067,1510023,183839,173562,6549,180111,2448
2022-01-01,San Benito,069,59416,8758,8320,212,8532,79
2022-01-01,San Bernardino,071,2135413,414334,386278,13941,400219,6051
2022-01-01,San Diego,073,3302833,473103,427087,28328,455415,4469
2022-01-01,San Francisco,075,870044,73153,64498,3315,67813,682
2022-01-01,San Joaquin,077,732212,111901,106640,6253,112893,1902
2022-01-01,San Luis Obispo,079,281455,34234,32342,1617,33959,365
2022-01-01,San Mateo,081,765935,70341,60504,1774,62278,581
2022-01-01,Santa Barbara,083,443738,53001,49555,1879,51434,568
2022-01-01,Santa Clara,085,1922200,180693,164547,2913,167460,1969
2022-01-01,Santa Cruz,087,273765,24741,22980,1282,24262,228
2022-01-01,Shasta,089,179085,23626,23161,3864,27025,435
2022-01-01,Sierra,091,2930,216,206,21,227,0
2022-01-01,Siskiyou,093,43540,3580,3474,1452,4926,61
2022-01-01,Solano,095,438530,52411,48957,1756,50713,379
2022-01-01,Sonoma,097,501317,49425,46040,810,46850,410
2022-01-01,Stanislaus,099,539301,86204,84367,10022,94389,1332
2022-01-01,Sutter,101,95872,15063,14741,448,15189,193
2022-01-01,Tehama,103,63373,9157,8944,1629,10573,139
2022-01-01,Trinity,105,12862,925,832,230,1062,17
2022-01-01,Tulare,107,460477,74277,71941,17747,89688,1160
2022-01-01,Tuolumne,109,53932,8326,8044,124,8168,91
2022-01-01,Ventura,111,848112,118295,107992,5993,113985,1211
2022-01-01,Yolo,113,214977,23325,21747,1661,23408,270
2022-01-01,Yuba,115,75493,11201,10844,438,11282,99
2021-12-31,Alameda,001,1643700,145620,133486,4157,137643,1528
2021-12-31,Alpine,003,1148,111,113,0,113,0
2021-12-31,Amador,005,37829,6061,5913,89,6002,70
2021-12-31,Butte,007,227075,23386,22469,4228,26697,341
2021-12-31,Calaveras,009,45235,4800,4668,70,4738,93
2021-12-31,Colusa,011,21464,2714,2659,733,3392,21
2021-12-31,Contra Costa,013,1133247,118335,109593,3314,112907,1073
2021-12-31,Del Norte,015,27424,3893,3841,62,3903,43
2021-12-31,El Dorado,017,186661,18607,17621,1985,19606,172
2021-12-31,Fresno,019,978130,155094,149927,14135,164062,2379
2021-12-31,Glenn,021,27897,3734,3663,1086,4749,39
2021-12-31,Humboldt,023,135768,11014,10381,881,11262,119
2021-12-31,Imperial,025,180216,38918,37672,4767,42439,800
2021-12-31,Inyo,027,18085,2902,2726,52,2778,49
2021-12-31,Kern,029,883053,140129,136123,27021,163144,1917
2021-12-31,Kings,031,150075,35281,34318,2176,36494,386
2021-12-31,Lake,033,64148,7206,7060,207,7267,117
2021-12-31,Lassen,035,31185,7152,7089,438,7527,55
2021-12-31,Los Angeles,037,10098052,1742492,1596123,73622,1669745,27371
2021-12-31,Madera,039,155013,25641,25002,2523,27525,320
2021-12-31,Marin,041,260295,22166,20475,954,21429,249
2021-12-31,Mariposa,043,17540,1589,1509,65,1574,6
2021-12-31,Mendocino,045,87422,8744,8422,741,9163,101
2021-12-31,Merced,047,269075,45677,44769,2324,47093,694
2021-12-31,Modoc,049,8938,613,601,212,813,6
2021-12-31,Mono,051,14174,2238,2101,29,2130,4
2021-12-31,Monterey,053,433212,53476,50251,3981,54232,643
2021-12-31,Napa,055,140530,15725,14439,267,14706,107
2021-12-31,Nevada,057,99092,10769,10299,398,10697,110
2021-12-31,Orange,059,3164182,370312,339526,23198,362724,5890
2021-12-31,Placer,061,380077,42983,40857,4507,45364,489
2021-12-31,Plumas,063,18699,2067,1994,56,2050,12
2021-12-31,Riverside,065,2383286,420394,397124,18871,415995,5501
2021-12-31,Sacramento,067,1510023,182975,173562,6443,180005,2448
2021-12-31,San Benito,069,59416,8744,8320,211,8531,79
2021-12-31,San Bernardino,071,2135413,412102,386278,13749,400027,6051
2021-12-31,San Diego,073,3302833,469890,427087,28010,455097,4469
2021-12-31,San Francisco,075,870044,72230,64498,3259,67757,682
2021-12-31,San Joaquin,077,732212,111274,106640,6187,112827,1902
2021-12-31,San Luis Obispo,079,281455,34126,32342,1604,33946,365
2021-12-31,San Mateo,081,765935,69463,60504,1720,62224,581
2021-12-31,Santa Barbara,083,443738,52602,49555,1865,51420,568
2021-12-31,Santa Clara,085,1922200,178740,164547,2771,167318,1969
2021-12-31,Santa Cruz,087,273765,24503,22980,1260,24240,228
2021-12-31,Shasta,089,179085,23563,23161,3843,27004,435
2021-12-31,Sierra,091,2930,216,206,21,227,0
2021-12-31,Siskiyou,093,43540,3573,3474,1441,4915,61
2021-12-31,Solano,095,438530,52253,48957,1730,50687,379
2021-12-31,Sonoma,097,501317,49173,46040,797,46837,410
2021-12-31,Stanislaus,099,539301,85877,84367,9969,94336,1332
2021-12-31,Sutter,101,95872,15002,14741,442,15183,193
2021-12-31,Tehama,103,63373,9125,8944,1620,10564,139
2021-12-31,Trinity,105,12862,924,832,230,1062,17
2021-12-31,Tulare,107,460477,74072,71941,17659,89600,1160
2021-12-31,Tuolumne,109,53932,8282,8044,123,8167,91
2021-12-31,Ventura,111,848112,117321,107992,5911,113903,1211
2021-12-31,Yolo,113,214977,23104,21747,1638,23385,270
2021-12-31,Yuba,115,75493,11144,10844,432,11276,99
2021-12-30,Alameda,001,1643700,144354,133486,4027,137513,1528
2021-12-30,Alpine,003,1148,110,113,0,113,0
2021-12-30,Amador,005,37829,6042,5913,88,6001,70
2021-12-30,Butte,007,227075,23257,22469,4204,26673,341
2021-12-30,Calaveras,009,45235,4781,4668,70,4738,93
2021-12-30,Colusa,011,21464,2713,2659,731,3390,21
2021-12-30,Contra Costa,013,1133247,117244,109593,3203,112796,1073
2021-12-30,Del Norte,015,27424,3882,3841,61,3902,43
2021-12-30,El Dorado,017,186661,18502,17621,1964,19585,172
2021-12-30,Fresno,019,978130,154566,149927,14060,163987,2379
2021-12-30,Glenn,021,27897,3729,3663,1083,4746,39
2021-12-30,Humboldt,023,135768,10945,10381,869,11250,119
2021-12-30,Imperial,025,180216,38750,37672,4653,42325,800
2021-12-30,Inyo,027,18085,2883,2726,50,2776,49
2021-12-30,Kern,029,883053,139595,136123,26720,162843,1917
2021-12-30,Kings,031,150075,35163,34318,2161,36479,386
2021-12-30,Lake,033,64148,7191,7060,202,7262,117
2021-12-30,Lassen,035,31185,7146,7089,438,7527,55
2021-12-30,Los Angeles,037,10098052,1719184,1596123,72362,1668485,27371
2021-12-30,Madera,039,155013,25563,25002,2503,27505,320
2021-12-30,Marin,041,260295,21988,20475,930,21405,249
2021-12-30,Mariposa,043,17540,1583,1509,65,1574,6
2021-12-30,Mendocino,045,87422,8727,8422,730,9152,101
2021-12-30,Merced,047,269075,45575,44769,2309,47078,694
2021-12-30,Modoc,049,8938,612,601,212,813,6
2021-12-30,Mono,051,14174,2233,2101,28,2129,4
2021-12-30,Monterey,053,433212,53164,50251,3920,54171,643
2021-12-30,Napa,055,140530,15581,14439,258,14697,107
2021-12-30,Nevada,057,99092,10705,10299,389,10688,110
2021-12-30,Orange,059,3164182,365223,339526,22640,362166,5890
2021-12-30,Placer,061,380077,42708,40857,4459,45316,489
2021-12-30,Plumas,063,18699,2063,1994,55,2049,12
2021-12-30,Riverside,065,2383286,417120,397124,18715,415839,5501
2021-12-30,Sacramento,067,1510023,181717,173562,6295,179857,2448
2021-12-30,San Benito,069,59416,8699,8320,208,8528,79
2021-12-30,San Bernardino,071,2135413,409558,386278,13600,399878,6051
2021-12-30,San Diego,073,3302833,464750,427087,27499,454586,4469
2021-12-30,San Francisco,075,870044,71142,64498,3186,67684,682
2021-12-30,San Joaquin,077,732212,110679,106640,6142,112782,1902
2021-12-30,San Luis Obispo,079,281455,34007,32342,1590,33932,365
2021-12-30,San Mateo,081,765935,68418,60504,1588,62092,581
2021-12-30,Santa Barbara,083,443738,52124,49555,1845,51400,568
2021-12-30,Santa Clara,085,1922200,176463,164547,2647,167194,1969
2021-12-30,Santa Cruz,087,273765,24265,22980,1225,24205,228
2021-12-30,Shasta,089,179085,23510,23161,3837,26998,435
2021-12-30,Sierra,091,2930,216,206,21,227,0
2021-12-30,Siskiyou,093,43540,3564,3474,1439,4913,61
2021-12-30,Solano,095,438530,51904,48957,1683,50640,379
2021-12-30,Sonoma,097,501317,48837,46040,787,46827,410
2021-12-30,Stanislaus,099,539301,85563,84367,9915,94282,1332
2021-12-30,Sutter,101,95872,14940,14741,441,15182,193
2021-12-30,Tehama,103,63373,9097,8944,1614,10558,139
2021-12-30,Trinity,105,12862,921,832,230,1062,17
2021-12-30,Tulare,107,460477,73890,71941,17577,89518,1160
2021-12-30,Tuolumne,109,53932,8243,8044,122,8166,91
2021-12-30,Ventura,111,848112,116062,107992,5808,113800,1211
2021-12-30,Yolo,113,214977,22966,21747,1613,23360,270
2021-12-30,Yuba,115,75493,11097,10844,430,11274,99
2021-12-29,Alameda,001,1643700,141189,131586,3871,135457,1529
2021-12-29,Alpine,003,1148,110,113,0,113,0
2021-12-29,Amador,005,37829,6019,5905,85,5990,70
2021-12-29,Butte,007,227075,23117,22353,4167,26520,338
2021-12-29,Calaveras,009,45235,4753,4646,68,4714,93
2021-12-29,Colusa,011,21464,2703,2657,726,3383,21
2021-12-29,Contra Costa,013,1133247,115149,108165,3077,111242,1072
2021-12-29,Del Norte,015,27424,3868,3826,59,3885,43
2021-12-29,El Dorado,017,186661,18278,17489,1946,19435,172
2021-12-29,Fresno,019,978130,153436,149318,13945,163263,2364
2021-12-29,Glenn,021,27897,3719,3653,1081,4734,39
2021-12-29,Humboldt,023,135768,10836,10249,847,11096,119
2021-12-29,Imperial,025,180216,38514,37460,4585,42045,800
2021-12-29,Inyo,027,18085,2850,2703,50,2753,49
2021-12-29,Kern,029,883053,138792,135648,26331,161979,1913
2021-12-29,Kings,031,150075,35048,34216,2155,36371,386
2021-12-29,Lake,033,64148,7160,7048,200,7248,117
2021-12-29,Lassen,035,31185,7142,7085,437,7522,55
2021-12-29,Los Angeles,037,10098052,1689197,1576414,70637,1647051,27349
2021-12-29,Madera,039,155013,25459,24923,2492,27415,320
2021-12-29,Marin,041,260295,21632,20025,909,20934,249
2021-12-29,Mariposa,043,17540,1561,1507,65,1572,6
2021-12-29,Mendocino,045,87422,8668,8386,726,9112,99
2021-12-29,Merced,047,269075,45359,44548,2295,46843,693
2021-12-29,Modoc,049,8938,609,600,212,812,6
2021-12-29,Mono,051,14174,2209,2056,27,2083,4
2021-12-29,Monterey,053,433212,52753,50097,3815,53912,641
2021-12-29,Napa,055,140530,15257,14247,239,14486,107
2021-12-29,Nevada,057,99092,10613,10274,388,10662,110
2021-12-29,Orange,059,3164182,357685,334557,21962,356519,5887
2021-12-29,Placer,061,380077,42220,40545,4384,44929,489
2021-12-29,Plumas,063,18699,2051,1990,55,2045,12
2021-12-29,Riverside,065,2383286,411698,392989,18504,411493,5486
2021-12-29,Sacramento,067,1510023,179386,172145,6129,178274,2437
2021-12-29,San Benito,069,59416,8556,8239,207,8446,79
2021-12-29,San Bernardino,071,2135413,404180,382872,13386,396258,6049
2021-12-29,San Diego,073,3302833,453923,421045,26781,447826,4461
2021-12-29,San Francisco,075,870044,69446,63117,3114,66231,684
2021-12-29,San Joaquin,077,732212,109498,106063,6066,112129,1891
2021-12-29,San Luis Obispo,079,281455,33613,31936,1541,33477,365
2021-12-29,San Mateo,081,765935,66804,59478,1478,60956,581
2021-12-29,Santa Barbara,083,443738,51283,49003,1820,50823,568
2021-12-29,Santa Clara,085,1922200,173311,162008,2514,164522,1962
2021-12-29,Santa Cruz,087,273765,23986,22669,1193,23862,228
2021-12-29,Shasta,089,179085,23435,23083,3825,26908,435
2021-12-29,Sierra,091,2930,215,206,21,227,0
2021-12-29,Siskiyou,093,43540,3552,3472,1428,4900,61
2021-12-29,Solano,095,438530,51199,48562,1627,50189,379
2021-12-29,Sonoma,097,501317,48035,45479,763,46242,410
2021-12-29,Stanislaus,099,539301,85081,84083,9858,93941,1332
2021-12-29,Sutter,101,95872,14871,14688,439,15127,193
2021-12-29,Tehama,103,63373,9072,8914,1601,10515,138
2021-12-29,Trinity,105,12862,919,832,230,1062,17
2021-12-29,Tulare,107,460477,73601,71752,17460,89212,1160
2021-12-29,Tuolumne,109,53932,8190,8012,121,8133,91
2021-12-29,Ventura,111,848112,114120,106974,5628,112602,1207
2021-12-29,Yolo,113,214977,22727,21564,1582,23146,270
2021-12-29,Yuba,115,75493,11036,10808,426,11234,99
2021-12-28,Alameda,001,1643700,138098,130427,3712,134139,1522
2021-12-28,Alpine,003,1148,110,113,0,113,0
2021-12-28,Amador,005,37829,5999,5900,84,5984,70
2021-12-28,Butte,007,227075,22974,22285,4150,26435,338
2021-12-28,Calaveras,009,45235,4736,4641,67,4708,91
2021-12-28,Colusa,011,21464,2697,2653,724,3377,21
2021-12-28,Contra Costa,013,1133247,112847,107160,2959,110119,1072
2021-12-28,Del Norte,015,27424,3862,3815,59,3874,43
2021-12-28,El Dorado,017,186661,18053,17419,1935,19354,172
2021-12-28,Fresno,019,978130,152356,148987,13861,162848,2365
2021-12-28,Glenn,021,27897,3693,3639,1077,4716,39
2021-12-28,Humboldt,023,135768,10715,10198,823,11021,119
2021-12-28,Imperial,025,180216,38217,37223,4481,41704,800
2021-12-28,Inyo,027,18085,2792,2676,49,2725,48
2021-12-28,Kern,029,883053,138071,135346,25976,161322,1909
2021-12-28,Kings,031,150075,34912,34165,2140,36305,386
2021-12-28,Lake,033,64148,7141,7044,194,7238,116
2021-12-28,Lassen,035,31185,7133,7083,437,7520,55
2021-12-28,Los Angeles,037,10098052,1656971,1561791,68972,1630763,27323
2021-12-28,Madera,039,155013,25333,24865,2472,27337,320
2021-12-28,Marin,041,260295,21221,19739,879,20618,249
2021-12-28,Mariposa,043,17540,1550,1499,64,1563,6
2021-12-28,Mendocino,045,87422,8608,8366,718,9084,98
2021-12-28,Merced,047,269075,45119,44434,2285,46719,691
2021-12-28,Modoc,049,8938,609,599,211,810,6
2021-12-28,Mono,051,14174,2186,2045,25,2070,4
2021-12-28,Monterey,053,433212,52377,49973,3742,53715,639
2021-12-28,Napa,055,140530,14940,14131,212,14343,107
2021-12-28,Nevada,057,99092,10522,10250,385,10635,110
2021-12-28,Orange,059,3164182,350011,331279,21221,352500,5882
2021-12-28,Placer,061,380077,41753,40410,4314,44724,489
2021-12-28,Plumas,063,18699,2048,1989,55,2044,12
2021-12-28,Riverside,065,2383286,406456,390343,18257,408600,5470
2021-12-28,Sacramento,067,1510023,177100,171290,5996,177286,2426
2021-12-28,San Benito,069,59416,8413,8170,205,8375,79
2021-12-28,San Bernardino,071,2135413,398537,381316,13172,394488,6047
2021-12-28,San Diego,073,3302833,443237,417383,26224,443607,4450
2021-12-28,San Francisco,075,870044,67829,61745,3055,64800,682
2021-12-28,San Joaquin,077,732212,108444,105572,6021,111593,1884
2021-12-28,San Luis Obispo,079,281455,33153,31759,1525,33284,365
2021-12-28,San Mateo,081,765935,65290,58712,1389,60101,582
2021-12-28,Santa Barbara,083,443738,50638,48493,1800,50293,568
2021-12-28,Santa Clara,085,1922200,170176,160811,2418,163229,1962
2021-12-28,Santa Cruz,087,273765,23612,22513,1154,23667,228
2021-12-28,Shasta,089,179085,23365,23035,3820,26855,434
2021-12-28,Sierra,091,2930,212,206,21,227,0
2021-12-28,Siskiyou,093,43540,3543,3468,1423,4891,60
2021-12-28,Solano,095,438530,50284,48318,1573,49891,378
2021-12-28,Sonoma,097,501317,47175,45086,737,45823,410
2021-12-28,Stanislaus,099,539301,84601,83946,9796,93742,1331
2021-12-28,Sutter,101,95872,14822,14662,436,15098,193
2021-12-28,Tehama,103,63373,9055,8893,1599,10492,138
2021-12-28,Trinity,105,12862,917,831,229,1060,17
2021-12-28,Tulare,107,460477,73321,71630,17335,88965,1156
2021-12-28,Tuolumne,109,53932,8147,8006,121,8127,91
2021-12-28,Ventura,111,848112,112010,105883,5497,111380,1207
2021-12-28,Yolo,113,214977,22390,21320,1530,22850,270
2021-12-28,Yuba,115,75493,10980,10778,423,11201,99
2021-12-27,Alameda,001,1643700,135519,129910,3575,133485,1530
2021-12-27,Alpine,003,1148,110,113,0,113,0
2021-12-27,Amador,005,37829,5971,5891,84,5975,70
2021-12-27,Butte,007,227075,22839,22234,4127,26361,335
2021-12-27,Calaveras,009,45235,4711,4630,66,4696,91
2021-12-27,Colusa,011,21464,2686,2652,718,3370,21
2021-12-27,Contra Costa,013,1133247,110684,106692,2878,109570,1071
2021-12-27,Del Norte,015,27424,3853,3802,58,3860,43
2021-12-27,El Dorado,017,186661,17894,17361,1922,19283,172
2021-12-27,Fresno,019,978130,151395,148826,13780,162606,2364
2021-12-27,Glenn,021,27897,3685,3634,1071,4705,39
2021-12-27,Humboldt,023,135768,10602,10164,801,10965,119
2021-12-27,Imperial,025,180216,37976,37180,4383,41563,800
2021-12-27,Inyo,027,18085,2763,2662,47,2709,48
2021-12-27,Kern,029,883053,137420,135119,25672,160791,1907
2021-12-27,Kings,031,150075,34763,34126,2127,36253,382
2021-12-27,Lake,033,64148,7118,7037,184,7221,116
2021-12-27,Lassen,035,31185,7127,7080,437,7517,55
2021-12-27,Los Angeles,037,10098052,1620651,1554074,67213,1621287,27300
2021-12-27,Madera,039,155013,25213,24840,2453,27293,320
2021-12-27,Marin,041,260295,20831,19601,852,20453,249
2021-12-27,Mariposa,043,17540,1535,1495,64,1559,6
2021-12-27,Mendocino,045,87422,8541,8351,713,9064,98
2021-12-27,Merced,047,269075,44889,44383,2268,46651,690
2021-12-27,Modoc,049,8938,607,599,211,810,6
2021-12-27,Mono,051,14174,2123,2026,25,2051,4
2021-12-27,Monterey,053,433212,52076,49918,3691,53609,639
2021-12-27,Napa,055,140530,14670,14083,203,14286,107
2021-12-27,Nevada,057,99092,10453,10239,377,10616,110
2021-12-27,Orange,059,3164182,342532,329222,20412,349634,5875
2021-12-27,Placer,061,380077,41376,40263,4265,44528,489
2021-12-27,Plumas,063,18699,2046,1988,53,2041,12
2021-12-27,Riverside,065,2383286,401867,389096,17998,407094,5470
2021-12-27,Sacramento,067,1510023,175072,170858,5824,176682,2422
2021-12-27,San Benito,069,59416,8296,8133,201,8334,79
2021-12-27,San Bernardino,071,2135413,392760,380526,12971,393497,6047
2021-12-27,San Diego,073,3302833,433041,414968,25734,440702,4445
2021-12-27,San Francisco,075,870044,66088,60920,2989,63909,682
2021-12-27,San Joaquin,077,732212,107524,105413,5957,111370,1876
2021-12-27,San Luis Obispo,079,281455,32710,31671,1503,33174,365
2021-12-27,San Mateo,081,765935,63765,58397,1289,59686,581
2021-12-27,Santa Barbara,083,443738,49852,48209,1779,49988,568
2021-12-27,Santa Clara,085,1922200,167206,159904,2291,162195,1961
2021-12-27,Santa Cruz,087,273765,23323,22456,1136,23592,228
2021-12-27,Shasta,089,179085,23303,23015,3809,26824,432
2021-12-27,Sierra,091,2930,212,206,21,227,0
2021-12-27,Siskiyou,093,43540,3534,3466,1418,4884,60
2021-12-27,Solano,095,438530,49551,48172,1525,49697,378
2021-12-27,Sonoma,097,501317,46599,44990,718,45708,410
2021-12-27,Stanislaus,099,539301,84152,83833,9755,93588,1331
2021-12-27,Sutter,101,95872,14766,14642,431,15073,191
2021-12-27,Tehama,103,63373,9040,8887,1592,10479,136
2021-12-27,Trinity,105,12862,917,827,229,1056,17
2021-12-27,Tulare,107,460477,73055,71562,17238,88800,1146
2021-12-27,Tuolumne,109,53932,8109,7978,120,8098,91
2021-12-27,Ventura,111,848112,109922,105212,5361,110573,1206
2021-12-27,Yolo,113,214977,22097,21300,1495,22795,270
2021-12-27,Yuba,115,75493,10919,10759,422,11181,98
2021-12-26,Alameda,001,1643700,133452,127221,3501,130722,1525
2021-12-26,Alpine,003,1148,110,113,0,113,0
2021-12-26,Amador,005,37829,5955,5861,82,5943,70
2021-12-26,Butte,007,227075,22684,22087,4104,26191,330
2021-12-26,Calaveras,009,45235,4689,4591,66,4657,91
2021-12-26,Colusa,011,21464,2675,2647,712,3359,21
2021-12-26,Contra Costa,013,1133247,108922,105022,2779,107801,1071
2021-12-26,Del Norte,015,27424,3848,3795,58,3853,43
2021-12-26,El Dorado,017,186661,17739,17188,1913,19101,172
2021-12-26,Fresno,019,978130,150690,148027,13699,161726,2358
2021-12-26,Glenn,021,27897,3677,3611,1060,4671,39
2021-12-26,Humboldt,023,135768,10459,10052,778,10830,119
2021-12-26,Imperial,025,180216,37673,36878,4291,41169,800
2021-12-26,Inyo,027,18085,2739,2636,44,2680,47
2021-12-26,Kern,029,883053,136698,134591,25415,160006,1908
2021-12-26,Kings,031,150075,34610,34009,2121,36130,379
2021-12-26,Lake,033,64148,7096,7019,181,7200,116
2021-12-26,Lassen,035,31185,7121,7072,436,7508,55
2021-12-26,Los Angeles,037,10098052,1590811,1515469,65411,1580880,27257
2021-12-26,Madera,039,155013,25094,24741,2437,27178,320
2021-12-26,Marin,041,260295,20452,19085,792,19877,249
2021-12-26,Mariposa,043,17540,1529,1480,64,1544,6
2021-12-26,Mendocino,045,87422,8490,8314,711,9025,98
2021-12-26,Merced,047,269075,44638,44208,2257,46465,690
2021-12-26,Modoc,049,8938,606,597,209,806,6
2021-12-26,Mono,051,14174,2097,2000,25,2025,4
2021-12-26,Monterey,053,433212,51795,49709,3642,53351,638
2021-12-26,Napa,055,140530,14433,13809,198,14007,107
2021-12-26,Nevada,057,99092,10393,10153,370,10523,110
2021-12-26,Orange,059,3164182,336197,322991,19609,342600,5863
2021-12-26,Placer,061,380077,41025,39852,4194,44046,489
2021-12-26,Plumas,063,18699,2038,1987,52,2039,12
2021-12-26,Riverside,065,2383286,397681,384567,17828,402395,5470
2021-12-26,Sacramento,067,1510023,173347,169144,5674,174818,2418
2021-12-26,San Benito,069,59416,8207,7991,197,8188,79
2021-12-26,San Bernardino,071,2135413,388068,376052,12792,388844,6043
2021-12-26,San Diego,073,3302833,424050,406616,25241,431857,4442
2021-12-26,San Francisco,075,870044,64516,58229,2927,61156,682
2021-12-26,San Joaquin,077,732212,106708,104590,5904,110494,1872
2021-12-26,San Luis Obispo,079,281455,32270,31290,1485,32775,365
2021-12-26,San Mateo,081,765935,62365,56973,1241,58214,581
2021-12-26,Santa Barbara,083,443738,49176,47553,1749,49302,567
2021-12-26,Santa Clara,085,1922200,164506,156872,2158,159030,1967
2021-12-26,Santa Cruz,087,273765,23038,22176,1122,23298,228
2021-12-26,Shasta,089,179085,23220,22959,3797,26756,432
2021-12-26,Sierra,091,2930,212,202,21,223,0
2021-12-26,Siskiyou,093,43540,3526,3460,1409,4869,60
2021-12-26,Solano,095,438530,49048,47646,1487,49133,377
2021-12-26,Sonoma,097,501317,46101,44358,686,45044,408
2021-12-26,Stanislaus,099,539301,83780,83368,9713,93081,1331
2021-12-26,Sutter,101,95872,14701,14533,428,14961,191
2021-12-26,Tehama,103,63373,9007,8861,1589,10450,136
2021-12-26,Trinity,105,12862,917,826,228,1054,17
2021-12-26,Tulare,107,460477,72805,71292,17127,88419,1137
2021-12-26,Tuolumne,109,53932,8071,7919,120,8039,91
2021-12-26,Ventura,111,848112,108085,103498,5211,108709,1206
2021-12-26,Yolo,113,214977,21811,21084,1455,22539,270
2021-12-26,Yuba,115,75493,10868,10694,420,11114,98
2021-12-25,Alameda,001,1643700,132379,127221,3436,130657,1525
2021-12-25,Alpine,003,1148,110,113,0,113,0
2021-12-25,Amador,005,37829,5936,5861,82,5943,70
2021-12-25,Butte,007,227075,22587,22087,4088,26175,330
2021-12-25,Calaveras,009,45235,4660,4591,65,4656,91
2021-12-25,Colusa,011,21464,2670,2647,706,3353,21
2021-12-25,Contra Costa,013,1133247,108100,105022,2725,107747,1071
2021-12-25,Del Norte,015,27424,3841,3795,57,3852,43
2021-12-25,El Dorado,017,186661,17686,17188,1902,19090,172
2021-12-25,Fresno,019,978130,150377,148027,13651,161678,2358
2021-12-25,Glenn,021,27897,3666,3611,1056,4667,39
2021-12-25,Humboldt,023,135768,10378,10052,771,10823,119
2021-12-25,Imperial,025,180216,37551,36878,4268,41146,800
2021-12-25,Inyo,027,18085,2719,2636,44,2680,47
2021-12-25,Kern,029,883053,136351,134591,25289,159880,1908
2021-12-25,Kings,031,150075,34520,34009,2114,36123,379
2021-12-25,Lake,033,64148,7084,7019,179,7198,116
2021-12-25,Lassen,035,31185,7119,7072,436,7508,55
2021-12-25,Los Angeles,037,10098052,1578002,1515469,64085,1579554,27257
2021-12-25,Madera,039,155013,25044,24741,2431,27172,320
2021-12-25,Marin,041,260295,20110,19085,743,19828,249
2021-12-25,Mariposa,043,17540,1523,1480,64,1544,6
2021-12-25,Mendocino,045,87422,8452,8314,711,9025,98
2021-12-25,Merced,047,269075,44538,44208,2255,46463,690
2021-12-25,Modoc,049,8938,606,597,209,806,6
2021-12-25,Mono,051,14174,2080,2000,25,2025,4
2021-12-25,Monterey,053,433212,51627,49709,3607,53316,638
2021-12-25,Napa,055,140530,14318,13809,190,13999,107
2021-12-25,Nevada,057,99092,10364,10153,370,10523,110
2021-12-25,Orange,059,3164182,333328,322991,19034,342025,5863
2021-12-25,Placer,061,380077,40841,39852,4158,44010,489
2021-12-25,Plumas,063,18699,2036,1987,52,2039,12
2021-12-25,Riverside,065,2383286,395400,384567,17708,402275,5470
2021-12-25,Sacramento,067,1510023,172533,169144,5566,174710,2418
2021-12-25,San Benito,069,59416,8142,7991,197,8188,79
2021-12-25,San Bernardino,071,2135413,385864,376052,12652,388704,6043
2021-12-25,San Diego,073,3302833,419983,406616,24971,431587,4442
2021-12-25,San Francisco,075,870044,63492,58229,2891,61120,682
2021-12-25,San Joaquin,077,732212,106373,104590,5872,110462,1872
2021-12-25,San Luis Obispo,079,281455,32115,31290,1476,32766,365
2021-12-25,San Mateo,081,765935,61334,56973,1198,58171,581
2021-12-25,Santa Barbara,083,443738,48812,47553,1737,49290,567
2021-12-25,Santa Clara,085,1922200,163028,156872,2091,158963,1967
2021-12-25,Santa Cruz,087,273765,22878,22176,1116,23292,228
2021-12-25,Shasta,089,179085,23187,22959,3791,26750,432
2021-12-25,Sierra,091,2930,212,202,21,223,0
2021-12-25,Siskiyou,093,43540,3523,3460,1403,4863,60
2021-12-25,Solano,095,438530,48923,47646,1469,49115,377
2021-12-25,Sonoma,097,501317,45716,44358,660,45018,408
2021-12-25,Stanislaus,099,539301,83567,83368,9687,93055,1331
2021-12-25,Sutter,101,95872,14660,14533,426,14959,191
2021-12-25,Tehama,103,63373,8987,8861,1585,10446,136
2021-12-25,Trinity,105,12862,916,826,228,1054,17
2021-12-25,Tulare,107,460477,72669,71292,17047,88339,1137
2021-12-25,Tuolumne,109,53932,8040,7919,120,8039,91
2021-12-25,Ventura,111,848112,106912,103498,5102,108600,1206
2021-12-25,Yolo,113,214977,21700,21084,1433,22517,270
2021-12-25,Yuba,115,75493,10841,10694,419,11113,98
2021-12-24,Alameda,001,1643700,131766,127221,3419,130640,1525
2021-12-24,Alpine,003,1148,110,113,0,113,0
2021-12-24,Amador,005,37829,5928,5861,81,5942,70
2021-12-24,Butte,007,227075,22532,22087,4074,26161,330
2021-12-24,Calaveras,009,45235,4654,4591,65,4656,91
2021-12-24,Colusa,011,21464,2668,2647,705,3352,21
2021-12-24,Contra Costa,013,1133247,107782,105022,2693,107715,1071
2021-12-24,Del Norte,015,27424,3834,3795,57,3852,43
2021-12-24,El Dorado,017,186661,17633,17188,1897,19085,172
2021-12-24,Fresno,019,978130,150211,148027,13637,161664,2358
2021-12-24,Glenn,021,27897,3665,3611,1056,4667,39
2021-12-24,Humboldt,023,135768,10322,10052,765,10817,119
2021-12-24,Imperial,025,180216,37468,36878,4264,41142,800
2021-12-24,Inyo,027,18085,2699,2636,44,2680,47
2021-12-24,Kern,029,883053,136228,134591,25247,159838,1908
2021-12-24,Kings,031,150075,34452,34009,2113,36122,379
2021-12-24,Lake,033,64148,7080,7019,179,7198,116
2021-12-24,Lassen,035,31185,7116,7072,436,7508,55
2021-12-24,Los Angeles,037,10098052,1573144,1515469,63555,1579024,27257
2021-12-24,Madera,039,155013,25009,24741,2426,27167,320
2021-12-24,Marin,041,260295,19964,19085,712,19797,249
2021-12-24,Mariposa,043,17540,1521,1480,64,1544,6
2021-12-24,Mendocino,045,87422,8435,8314,711,9025,98
2021-12-24,Merced,047,269075,44488,44208,2253,46461,690
2021-12-24,Modoc,049,8938,606,597,209,806,6
2021-12-24,Mono,051,14174,2067,2000,25,2025,4
2021-12-24,Monterey,053,433212,51530,49709,3581,53290,638
2021-12-24,Napa,055,140530,14252,13809,186,13995,107
2021-12-24,Nevada,057,99092,10338,10153,368,10521,110
2021-12-24,Orange,059,3164182,332276,322991,18874,341865,5863
2021-12-24,Placer,061,380077,40721,39852,4142,43994,489
2021-12-24,Plumas,063,18699,2035,1987,52,2039,12
2021-12-24,Riverside,065,2383286,394403,384567,17617,402184,5470
2021-12-24,Sacramento,067,1510023,172218,169144,5530,174674,2418
2021-12-24,San Benito,069,59416,8133,7991,196,8187,79
2021-12-24,San Bernardino,071,2135413,384747,376052,12580,388632,6043
2021-12-24,San Diego,073,3302833,418861,406616,24844,431460,4442
2021-12-24,San Francisco,075,870044,62983,58229,2873,61102,682
2021-12-24,San Joaquin,077,732212,106178,104590,5864,110454,1872
2021-12-24,San Luis Obispo,079,281455,32053,31290,1466,32756,365
2021-12-24,San Mateo,081,765935,60902,56973,1175,58148,581
2021-12-24,Santa Barbara,083,443738,48607,47553,1730,49283,567
2021-12-24,Santa Clara,085,1922200,162204,156872,2057,158929,1967
2021-12-24,Santa Cruz,087,273765,22795,22176,1113,23289,228
2021-12-24,Shasta,089,179085,23153,22959,3787,26746,432
2021-12-24,Sierra,091,2930,211,202,21,223,0
2021-12-24,Siskiyou,093,43540,3518,3460,1399,4859,60
2021-12-24,Solano,095,438530,48871,47646,1467,49113,377
2021-12-24,Sonoma,097,501317,45551,44358,652,45010,408
2021-12-24,Stanislaus,099,539301,83455,83368,9664,93032,1331
2021-12-24,Sutter,101,95872,14640,14533,423,14956,191
2021-12-24,Tehama,103,63373,8978,8861,1582,10443,136
2021-12-24,Trinity,105,12862,914,826,228,1054,17
2021-12-24,Tulare,107,460477,72602,71292,17004,88296,1137
2021-12-24,Tuolumne,109,53932,8015,7919,120,8039,91
2021-12-24,Ventura,111,848112,106465,103498,5046,108544,1206
2021-12-24,Yolo,113,214977,21626,21084,1415,22499,270
2021-12-24,Yuba,115,75493,10818,10694,418,11112,98
2021-12-23,Alameda,001,1643700,131065,127221,3385,130606,1525
2021-12-23,Alpine,003,1148,110,113,0,113,0
2021-12-23,Amador,005,37829,5916,5861,79,5940,70
2021-12-23,Butte,007,227075,22481,22087,4062,26149,330
2021-12-23,Calaveras,009,45235,4643,4591,65,4656,91
2021-12-23,Colusa,011,21464,2662,2647,701,3348,21
2021-12-23,Contra Costa,013,1133247,107352,105022,2648,107670,1071
2021-12-23,Del Norte,015,27424,3831,3795,57,3852,43
2021-12-23,El Dorado,017,186661,17570,17188,1891,19079,172
2021-12-23,Fresno,019,978130,150006,148027,13616,161643,2358
2021-12-23,Glenn,021,27897,3661,3611,1056,4667,39
2021-12-23,Humboldt,023,135768,10269,10052,762,10814,119
2021-12-23,Imperial,025,180216,37394,36878,4236,41114,800
2021-12-23,Inyo,027,18085,2686,2636,44,2680,47
2021-12-23,Kern,029,883053,136077,134591,25149,159740,1908
2021-12-23,Kings,031,150075,34411,34009,2112,36121,379
2021-12-23,Lake,033,64148,7068,7019,177,7196,116
2021-12-23,Lassen,035,31185,7115,7072,436,7508,55
2021-12-23,Los Angeles,037,10098052,1563614,1515469,62457,1577926,27257
2021-12-23,Madera,039,155013,24976,24741,2421,27162,320
2021-12-23,Marin,041,260295,19830,19085,695,19780,249
2021-12-23,Mariposa,043,17540,1516,1480,64,1544,6
2021-12-23,Mendocino,045,87422,8426,8314,711,9025,98
2021-12-23,Merced,047,269075,44439,44208,2251,46459,690
2021-12-23,Modoc,049,8938,606,597,209,806,6
2021-12-23,Mono,051,14174,2046,2000,24,2024,4
2021-12-23,Monterey,053,433212,51408,49709,3560,53269,638
2021-12-23,Napa,055,140530,14171,13809,181,13990,107
2021-12-23,Nevada,057,99092,10314,10153,367,10520,110
2021-12-23,Orange,059,3164182,330586,322991,18541,341532,5863
2021-12-23,Placer,061,380077,40598,39852,4126,43978,489
2021-12-23,Plumas,063,18699,2035,1987,52,2039,12
2021-12-23,Riverside,065,2383286,393186,384567,17548,402115,5470
2021-12-23,Sacramento,067,1510023,171761,169144,5482,174626,2418
2021-12-23,San Benito,069,59416,8114,7991,194,8185,79
2021-12-23,San Bernardino,071,2135413,383575,376052,12473,388525,6043
2021-12-23,San Diego,073,3302833,417013,406616,24644,431260,4442
2021-12-23,San Francisco,075,870044,62255,58229,2845,61074,682
2021-12-23,San Joaquin,077,732212,105960,104590,5851,110441,1872
2021-12-23,San Luis Obispo,079,281455,31981,31290,1462,32752,365
2021-12-23,San Mateo,081,765935,60340,56973,1154,58127,581
2021-12-23,Santa Barbara,083,443738,48408,47553,1728,49281,567
2021-12-23,Santa Clara,085,1922200,161298,156872,1998,158870,1967
2021-12-23,Santa Cruz,087,273765,22680,22176,1101,23277,228
2021-12-23,Shasta,089,179085,23123,22959,3784,26743,432
2021-12-23,Sierra,091,2930,208,202,21,223,0
2021-12-23,Siskiyou,093,43540,3518,3460,1397,4857,60
2021-12-23,Solano,095,438530,48765,47646,1451,49097,377
2021-12-23,Sonoma,097,501317,45374,44358,649,45007,408
2021-12-23,Stanislaus,099,539301,83326,83368,9643,93011,1331
2021-12-23,Sutter,101,95872,14623,14533,422,14955,191
2021-12-23,Tehama,103,63373,8966,8861,1578,10439,136
2021-12-23,Trinity,105,12862,914,826,228,1054,17
2021-12-23,Tulare,107,460477,72527,71292,16959,88251,1137
2021-12-23,Tuolumne,109,53932,7997,7919,119,8038,91
2021-12-23,Ventura,111,848112,105929,103498,4979,108477,1206
2021-12-23,Yolo,113,214977,21554,21084,1397,22481,270
2021-12-23,Yuba,115,75493,10805,10694,418,11112,98
2021-12-22,Alameda,001,1643700,130141,126533,3300,129833,1522
2021-12-22,Alpine,003,1148,110,112,0,112,0
2021-12-22,Amador,005,37829,5903,5850,78,5928,70
2021-12-22,Butte,007,227075,22431,22070,4050,26120,330
2021-12-22,Calaveras,009,45235,4634,4580,65,4645,91
2021-12-22,Colusa,011,21464,2662,2645,698,3343,21
2021-12-22,Contra Costa,013,1133247,106715,104559,2605,107164,1070
2021-12-22,Del Norte,015,27424,3831,3794,57,3851,43
2021-12-22,El Dorado,017,186661,17509,17140,1882,19022,172
2021-12-22,Fresno,019,978130,149724,147838,13582,161420,2349
2021-12-22,Glenn,021,27897,3656,3604,1056,4660,39
2021-12-22,Humboldt,023,135768,10208,10022,757,10779,119
2021-12-22,Imperial,025,180216,37308,36755,4199,40954,798
2021-12-22,Inyo,027,18085,2668,2632,44,2676,47
2021-12-22,Kern,029,883053,135842,134433,25064,159497,1900
2021-12-22,Kings,031,150075,34361,33953,2105,36058,376
2021-12-22,Lake,033,64148,7061,7008,175,7183,116
2021-12-22,Lassen,035,31185,7110,7069,435,7504,55
2021-12-22,Los Angeles,037,10098052,1550081,1507110,61281,1568391,27234
2021-12-22,Madera,039,155013,24938,24702,2417,27119,320
2021-12-22,Marin,041,260295,19609,18927,672,19599,249
2021-12-22,Mariposa,043,17540,1509,1480,64,1544,6
2021-12-22,Mendocino,045,87422,8417,8299,711,9010,99
2021-12-22,Merced,047,269075,44368,44137,2249,46386,689
2021-12-22,Modoc,049,8938,606,595,209,804,6
2021-12-22,Mono,051,14174,2042,1979,24,2003,4
2021-12-22,Monterey,053,433212,51251,49650,3543,53193,639
2021-12-22,Napa,055,140530,14044,13746,171,13917,107
2021-12-22,Nevada,057,99092,10286,10101,362,10463,110
2021-12-22,Orange,059,3164182,328291,321765,18109,339874,5858
2021-12-22,Placer,061,380077,40414,39758,4089,43847,489
2021-12-22,Plumas,063,18699,2031,1986,52,2038,12
2021-12-22,Riverside,065,2383286,391354,383319,17433,400752,5472
2021-12-22,Sacramento,067,1510023,171102,168695,5413,174108,2422
2021-12-22,San Benito,069,59416,8062,7971,192,8163,79
2021-12-22,San Bernardino,071,2135413,381906,375044,12388,387432,6039
2021-12-22,San Diego,073,3302833,412895,404269,24315,428584,4434
2021-12-22,San Francisco,075,870044,61266,57520,2800,60320,682
2021-12-22,San Joaquin,077,732212,105690,104385,5837,110222,1870
2021-12-22,San Luis Obispo,079,281455,31840,31175,1442,32617,365
2021-12-22,San Mateo,081,765935,59655,56604,1125,57729,581
2021-12-22,Santa Barbara,083,443738,48152,47372,1712,49084,566
2021-12-22,Santa Clara,085,1922200,160178,156258,1957,158215,1954
2021-12-22,Santa Cruz,087,273765,22573,22075,1095,23170,228
2021-12-22,Shasta,089,179085,23094,22937,3779,26716,432
2021-12-22,Sierra,091,2930,208,202,21,223,0
2021-12-22,Siskiyou,093,43540,3515,3458,1394,4852,59
2021-12-22,Solano,095,438530,48536,47531,1437,48968,375
2021-12-22,Sonoma,097,501317,45099,44201,638,44839,408
2021-12-22,Stanislaus,099,539301,83185,83245,9622,92867,1331
2021-12-22,Sutter,101,95872,14587,14513,419,14932,191
2021-12-22,Tehama,103,63373,8953,8853,1575,10428,136
2021-12-22,Trinity,105,12862,914,826,228,1054,17
2021-12-22,Tulare,107,460477,72426,71226,16907,88133,1137
2021-12-22,Tuolumne,109,53932,7976,7903,119,8022,91
2021-12-22,Ventura,111,848112,105323,103089,4872,107961,1206
2021-12-22,Yolo,113,214977,21478,21012,1381,22393,270
2021-12-22,Yuba,115,75493,10788,10681,418,11099,98
2021-12-21,Alameda,001,1643700,129144,126007,3244,129251,1518
2021-12-21,Alpine,003,1148,110,112,0,112,0
2021-12-21,Amador,005,37829,5893,5845,78,5923,70
2021-12-21,Butte,007,227075,22368,22041,4036,26077,330
2021-12-21,Calaveras,009,45235,4621,4575,65,4640,91
2021-12-21,Colusa,011,21464,2660,2643,697,3340,21
2021-12-21,Contra Costa,013,1133247,106083,104255,2539,106794,1068
2021-12-21,Del Norte,015,27424,3830,3793,57,3850,43
2021-12-21,El Dorado,017,186661,17444,17098,1870,18968,172
2021-12-21,Fresno,019,978130,149437,147707,13547,161254,2341
2021-12-21,Glenn,021,27897,3642,3602,1056,4658,39
2021-12-21,Humboldt,023,135768,10143,9989,752,10741,118
2021-12-21,Imperial,025,180216,37210,36580,4157,40737,792
2021-12-21,Inyo,027,18085,2657,2627,44,2671,47
2021-12-21,Kern,029,883053,135633,134321,24958,159279,1892
2021-12-21,Kings,031,150075,34300,33914,2104,36018,376
2021-12-21,Lake,033,64148,7056,7004,173,7177,116
2021-12-21,Lassen,035,31185,7108,7069,435,7504,55
2021-12-21,Los Angeles,037,10098052,1536198,1501169,60249,1561418,27220
2021-12-21,Madera,039,155013,24901,24688,2410,27098,320
2021-12-21,Marin,041,260295,19439,18828,637,19465,249
2021-12-21,Mariposa,043,17540,1508,1480,63,1543,6
2021-12-21,Mendocino,045,87422,8401,8282,709,8991,97
2021-12-21,Merced,047,269075,44296,44096,2246,46342,688
2021-12-21,Modoc,049,8938,604,595,207,802,6
2021-12-21,Mono,051,14174,2023,1979,24,2003,4
2021-12-21,Monterey,053,433212,51159,49586,3526,53112,638
2021-12-21,Napa,055,140530,13943,13703,160,13863,107
2021-12-21,Nevada,057,99092,10257,10095,362,10457,110
2021-12-21,Orange,059,3164182,326165,320705,17655,338360,5855
2021-12-21,Placer,061,380077,40273,39649,4060,43709,487
2021-12-21,Plumas,063,18699,2031,1975,52,2027,12
2021-12-21,Riverside,065,2383286,389628,382415,17312,399727,5465
2021-12-21,Sacramento,067,1510023,170451,168422,5357,173779,2419
2021-12-21,San Benito,069,59416,8023,7950,189,8139,79
2021-12-21,San Bernardino,071,2135413,380273,374219,12280,386499,6026
2021-12-21,San Diego,073,3302833,409169,402386,23978,426364,4424
2021-12-21,San Francisco,075,870044,60315,56950,2767,59717,681
2021-12-21,San Joaquin,077,732212,105403,104238,5818,110056,1870
2021-12-21,San Luis Obispo,079,281455,31676,31103,1430,32533,365
2021-12-21,San Mateo,081,765935,59038,56381,1101,57482,581
2021-12-21,Santa Barbara,083,443738,47924,47194,1697,48891,564
2021-12-21,Santa Clara,085,1922200,159154,155769,1915,157684,1951
2021-12-21,Santa Cruz,087,273765,22456,22028,1084,23112,228
2021-12-21,Shasta,089,179085,23063,22920,3775,26695,429
2021-12-21,Sierra,091,2930,206,201,21,222,0
2021-12-21,Siskiyou,093,43540,3514,3455,1394,4849,59
2021-12-21,Solano,095,438530,48382,47474,1430,48904,372
2021-12-21,Sonoma,097,501317,44876,44051,628,44679,408
2021-12-21,Stanislaus,099,539301,83030,83167,9591,92758,1331
2021-12-21,Sutter,101,95872,14564,14492,418,14910,190
2021-12-21,Tehama,103,63373,8945,8849,1570,10419,136
2021-12-21,Trinity,105,12862,913,826,228,1054,17
2021-12-21,Tulare,107,460477,72333,71166,16865,88031,1137
2021-12-21,Tuolumne,109,53932,7952,7893,119,8012,91
2021-12-21,Ventura,111,848112,104704,102631,4759,107390,1205
2021-12-21,Yolo,113,214977,21369,20944,1377,22321,267
2021-12-21,Yuba,115,75493,10771,10668,418,11086,98
2021-12-20,Alameda,001,1643700,128211,125762,3176,128938,1515
2021-12-20,Alpine,003,1148,110,112,0,112,0
2021-12-20,Amador,005,37829,5879,5838,78,5916,70
2021-12-20,Butte,007,227075,22306,22030,4027,26057,329
2021-12-20,Calaveras,009,45235,4611,4569,65,4634,91
2021-12-20,Colusa,011,21464,2659,2644,697,3341,21
2021-12-20,Contra Costa,013,1133247,105548,104051,2492,106543,1068
2021-12-20,Del Norte,015,27424,3828,3792,57,3849,43
2021-12-20,El Dorado,017,186661,17383,17083,1861,18944,172
2021-12-20,Fresno,019,978130,149194,147605,13518,161123,2341
2021-12-20,Glenn,021,27897,3636,3597,1056,4653,39
2021-12-20,Humboldt,023,135768,10101,9973,748,10721,118
2021-12-20,Imperial,025,180216,37094,36532,4127,40659,792
2021-12-20,Inyo,027,18085,2654,2615,44,2659,47
2021-12-20,Kern,029,883053,135434,134203,24898,159101,1883
2021-12-20,Kings,031,150075,34258,33898,2103,36001,376
2021-12-20,Lake,033,64148,7051,6999,173,7172,116
2021-12-20,Lassen,035,31185,7106,7065,434,7499,55
2021-12-20,Los Angeles,037,10098052,1524727,1495251,59519,1554770,27188
2021-12-20,Madera,039,155013,24872,24668,2406,27074,313
2021-12-20,Marin,041,260295,19225,18747,619,19366,249
2021-12-20,Mariposa,043,17540,1499,1479,63,1542,6
2021-12-20,Mendocino,045,87422,8389,8264,707,8971,96
2021-12-20,Merced,047,269075,44239,44071,2241,46312,687
2021-12-20,Modoc,049,8938,604,595,204,799,6
2021-12-20,Mono,051,14174,2000,1973,24,1997,4
2021-12-20,Monterey,053,433212,51062,49556,3506,53062,636
2021-12-20,Napa,055,140530,13858,13672,150,13822,107
2021-12-20,Nevada,057,99092,10217,10079,361,10440,109
2021-12-20,Orange,059,3164182,324558,320235,17336,337571,5852
2021-12-20,Placer,061,380077,40144,39579,4030,43609,485
2021-12-20,Plumas,063,18699,2028,1971,50,2021,12
2021-12-20,Riverside,065,2383286,388179,381841,17222,399063,5452
2021-12-20,Sacramento,067,1510023,169881,168153,5314,173467,2414
2021-12-20,San Benito,069,59416,7979,7934,187,8121,79
2021-12-20,San Bernardino,071,2135413,378776,373881,12194,386075,6023
2021-12-20,San Diego,073,3302833,405958,401483,23738,425221,4412
2021-12-20,San Francisco,075,870044,59261,56661,2707,59368,681
2021-12-20,San Joaquin,077,732212,105160,104188,5809,109997,1865
2021-12-20,San Luis Obispo,079,281455,31563,31075,1422,32497,365
2021-12-20,San Mateo,081,765935,58490,56247,1082,57329,581
2021-12-20,Santa Barbara,083,443738,47714,47131,1692,48823,562
2021-12-20,Santa Clara,085,1922200,158193,155427,1866,157293,1950
2021-12-20,Santa Cruz,087,273765,22375,21989,1079,23068,227
2021-12-20,Shasta,089,179085,23042,22888,3770,26658,429
2021-12-20,Sierra,091,2930,205,201,21,222,0
2021-12-20,Siskiyou,093,43540,3513,3453,1392,4845,59
2021-12-20,Solano,095,438530,48254,47394,1422,48816,370
2021-12-20,Sonoma,097,501317,44684,43982,620,44602,408
2021-12-20,Stanislaus,099,539301,82906,83110,9562,92672,1331
2021-12-20,Sutter,101,95872,14541,14480,418,14898,190
2021-12-20,Tehama,103,63373,8937,8840,1567,10407,136
2021-12-20,Trinity,105,12862,913,826,228,1054,17
2021-12-20,Tulare,107,460477,72239,71124,16805,87929,1129
2021-12-20,Tuolumne,109,53932,7938,7867,115,7982,91
2021-12-20,Ventura,111,848112,104196,102452,4681,107133,1203
2021-12-20,Yolo,113,214977,21276,20903,1365,22268,267
2021-12-20,Yuba,115,75493,10755,10656,415,11071,97
2021-12-19,Alameda,001,1643700,127326,125464,3133,128597,1519
2021-12-19,Alpine,003,1148,110,112,0,112,0
2021-12-19,Amador,005,37829,5867,5832,77,5909,70
2021-12-19,Butte,007,227075,22252,22022,4021,26043,329
2021-12-19,Calaveras,009,45235,4595,4563,64,4627,91
2021-12-19,Colusa,011,21464,2659,2643,694,3337,21
2021-12-19,Contra Costa,013,1133247,105057,103906,2457,106363,1068
2021-12-19,Del Norte,015,27424,3824,3797,57,3854,43
2021-12-19,El Dorado,017,186661,17326,17067,1859,18926,172
2021-12-19,Fresno,019,978130,148953,147505,13492,160997,2341
2021-12-19,Glenn,021,27897,3632,3596,1055,4651,39
2021-12-19,Humboldt,023,135768,10059,9957,743,10700,118
2021-12-19,Imperial,025,180216,36965,36501,4083,40584,792
2021-12-19,Inyo,027,18085,2645,2613,44,2657,47
2021-12-19,Kern,029,883053,135235,134136,24827,158963,1883
2021-12-19,Kings,031,150075,34200,33874,2099,35973,378
2021-12-19,Lake,033,64148,7042,6999,170,7169,116
2021-12-19,Lassen,035,31185,7102,7065,434,7499,55
2021-12-19,Los Angeles,037,10098052,1515746,1495082,58909,1553991,27189
2021-12-19,Madera,039,155013,24848,24642,2400,27042,313
2021-12-19,Marin,041,260295,19049,18707,596,19303,249
2021-12-19,Mariposa,043,17540,1493,1475,63,1538,6
2021-12-19,Mendocino,045,87422,8372,8257,704,8961,96
2021-12-19,Merced,047,269075,44144,44045,2234,46279,687
2021-12-19,Modoc,049,8938,603,595,204,799,6
2021-12-19,Mono,051,14174,1989,1968,23,1991,4
2021-12-19,Monterey,053,433212,50960,49516,3484,53000,636
2021-12-19,Napa,055,140530,13785,13659,141,13800,107
2021-12-19,Nevada,057,99092,10181,10057,358,10415,109
2021-12-19,Orange,059,3164182,323153,319615,17109,336724,5852
2021-12-19,Placer,061,380077,40022,39525,4013,43538,485
2021-12-19,Plumas,063,18699,2025,1971,50,2021,12
2021-12-19,Riverside,065,2383286,386735,381305,17146,398451,5452
2021-12-19,Sacramento,067,1510023,169386,167933,5285,173218,2415
2021-12-19,San Benito,069,59416,7953,7929,186,8115,79
2021-12-19,San Bernardino,071,2135413,377477,373480,12153,385633,6023
2021-12-19,San Diego,073,3302833,403481,398197,23542,421739,4406
2021-12-19,San Francisco,075,870044,58388,56358,2651,59009,681
2021-12-19,San Joaquin,077,732212,104903,104125,5795,109920,1865
2021-12-19,San Luis Obispo,079,281455,31440,31035,1410,32445,366
2021-12-19,San Mateo,081,765935,58025,56132,1067,57199,581
2021-12-19,Santa Barbara,083,443738,47491,47070,1685,48755,562
2021-12-19,Santa Clara,085,1922200,157307,155049,1838,156887,1950
2021-12-19,Santa Cruz,087,273765,22276,21960,1074,23034,227
2021-12-19,Shasta,089,179085,23005,22875,3766,26641,429
2021-12-19,Sierra,091,2930,204,201,21,222,0
2021-12-19,Siskiyou,093,43540,3510,3452,1392,4844,59
2021-12-19,Solano,095,438530,48132,47341,1416,48757,370
2021-12-19,Sonoma,097,501317,44500,43944,618,44562,408
2021-12-19,Stanislaus,099,539301,82768,83040,9530,92570,1331
2021-12-19,Sutter,101,95872,14501,14475,417,14892,190
2021-12-19,Tehama,103,63373,8929,8840,1567,10407,136
2021-12-19,Trinity,105,12862,913,826,228,1054,17
2021-12-19,Tulare,107,460477,72146,71085,16763,87848,1129
2021-12-19,Tuolumne,109,53932,7921,7865,114,7979,91
2021-12-19,Ventura,111,848112,103616,102170,4616,106786,1203
2021-12-19,Yolo,113,214977,21195,20887,1345,22232,267
2021-12-19,Yuba,115,75493,10738,10646,413,11059,97
2021-12-18,Alameda,001,1643700,126921,124583,3108,127691,1512
2021-12-18,Alpine,003,1148,110,110,0,110,0
2021-12-18,Amador,005,37829,5861,5821,77,5898,69
2021-12-18,Butte,007,227075,22236,21956,4016,25972,328
2021-12-18,Calaveras,009,45235,4588,4534,64,4598,91
2021-12-18,Colusa,011,21464,2655,2635,692,3327,21
2021-12-18,Contra Costa,013,1133247,104843,103380,2443,105823,1065
2021-12-18,Del Norte,015,27424,3821,3791,57,3848,43
2021-12-18,El Dorado,017,186661,17298,16968,1856,18824,171
2021-12-18,Fresno,019,978130,148850,147038,13478,160516,2335
2021-12-18,Glenn,021,27897,3629,3590,1055,4645,39
2021-12-18,Humboldt,023,135768,10043,9889,743,10632,118
2021-12-18,Imperial,025,180216,36892,36280,4071,40351,790
2021-12-18,Inyo,027,18085,2639,2607,44,2651,47
2021-12-18,Kern,029,883053,135145,133754,24780,158534,1873
2021-12-18,Kings,031,150075,34167,33783,2095,35878,374
2021-12-18,Lake,033,64148,7041,6976,170,7146,115
2021-12-18,Lassen,035,31185,7100,7061,433,7494,55
2021-12-18,Los Angeles,037,10098052,1511662,1484840,58594,1543434,27135
2021-12-18,Madera,039,155013,24833,24575,2398,26973,313
2021-12-18,Marin,041,260295,18948,18537,584,19121,249
2021-12-18,Mariposa,043,17540,1492,1468,63,1531,6
2021-12-18,Mendocino,045,87422,8366,8219,704,8923,95
2021-12-18,Merced,047,269075,44110,43929,2232,46161,686
2021-12-18,Modoc,049,8938,601,595,204,799,6
2021-12-18,Mono,051,14174,1987,1956,23,1979,4
2021-12-18,Monterey,053,433212,50902,49343,3479,52822,635
2021-12-18,Napa,055,140530,13759,13581,139,13720,107
2021-12-18,Nevada,057,99092,10159,9991,356,10347,108
2021-12-18,Orange,059,3164182,322489,318149,16970,335119,5844
2021-12-18,Placer,061,380077,39921,39336,3999,43335,485
2021-12-18,Plumas,063,18699,2025,1964,50,2014,13
2021-12-18,Riverside,065,2383286,386037,379354,17104,396458,5439
2021-12-18,Sacramento,067,1510023,169149,167046,5265,172311,2404
2021-12-18,San Benito,069,59416,7938,7894,186,8080,79
2021-12-18,San Bernardino,071,2135413,376819,371658,12125,383783,6017
2021-12-18,San Diego,073,3302833,402516,397130,23490,420620,4399
2021-12-18,San Francisco,075,870044,57894,55562,2621,58183,679
2021-12-18,San Joaquin,077,732212,104816,103698,5785,109483,1858
2021-12-18,San Luis Obispo,079,281455,31397,30873,1404,32277,365
2021-12-18,San Mateo,081,765935,57785,55730,1062,56792,580
2021-12-18,Santa Barbara,083,443738,47395,46776,1683,48459,562
2021-12-18,Santa Clara,085,1922200,156851,154243,1825,156068,1946
2021-12-18,Santa Cruz,087,273765,22224,21805,1072,22877,225
2021-12-18,Shasta,089,179085,22984,22811,3766,26577,429
2021-12-18,Sierra,091,2930,204,199,21,220,0
2021-12-18,Siskiyou,093,43540,3508,3441,1391,4832,58
2021-12-18,Solano,095,438530,48086,47174,1414,48588,369
2021-12-18,Sonoma,097,501317,44390,43658,614,44272,407
2021-12-18,Stanislaus,099,539301,82686,82736,9518,92254,1330
2021-12-18,Sutter,101,95872,14483,14435,417,14852,190
2021-12-18,Tehama,103,63373,8923,8814,1566,10380,136
2021-12-18,Trinity,105,12862,913,823,228,1051,17
2021-12-18,Tulare,107,460477,72108,70922,16738,87660,1120
2021-12-18,Tuolumne,109,53932,7907,7834,114,7948,91
2021-12-18,Ventura,111,848112,103331,101612,4592,106204,1201
2021-12-18,Yolo,113,214977,21154,20793,1339,22132,267
2021-12-18,Yuba,115,75493,10727,10599,413,11012,96
2021-12-17,Alameda,001,1643700,126587,124583,3089,127672,1512
2021-12-17,Alpine,003,1148,110,110,0,110,0
2021-12-17,Amador,005,37829,5854,5821,77,5898,69
2021-12-17,Butte,007,227075,22216,21956,4010,25966,328
2021-12-17,Calaveras,009,45235,4584,4534,64,4598,91
2021-12-17,Colusa,011,21464,2654,2635,691,3326,21
2021-12-17,Contra Costa,013,1133247,104641,103380,2439,105819,1065
2021-12-17,Del Norte,015,27424,3820,3791,57,3848,43
2021-12-17,El Dorado,017,186661,17269,16968,1853,18821,171
2021-12-17,Fresno,019,978130,148747,147038,13478,160516,2335
2021-12-17,Glenn,021,27897,3622,3590,1055,4645,39
2021-12-17,Humboldt,023,135768,10023,9889,741,10630,118
2021-12-17,Imperial,025,180216,36829,36280,4053,40333,790
2021-12-17,Inyo,027,18085,2634,2607,44,2651,47
2021-12-17,Kern,029,883053,135054,133754,24738,158492,1873
2021-12-17,Kings,031,150075,34148,33783,2095,35878,374
2021-12-17,Lake,033,64148,7037,6976,170,7146,115
2021-12-17,Lassen,035,31185,7100,7061,432,7493,55
2021-12-17,Los Angeles,037,10098052,1507721,1484840,58352,1543192,27135
2021-12-17,Madera,039,155013,24817,24575,2393,26968,313
2021-12-17,Marin,041,260295,18872,18537,580,19117,249
2021-12-17,Mariposa,043,17540,1488,1468,63,1531,6
2021-12-17,Mendocino,045,87422,8355,8219,704,8923,95
2021-12-17,Merced,047,269075,44083,43929,2231,46160,686
2021-12-17,Modoc,049,8938,601,595,204,799,6
2021-12-17,Mono,051,14174,1984,1956,23,1979,4
2021-12-17,Monterey,053,433212,50844,49343,3474,52817,635
2021-12-17,Napa,055,140530,13732,13581,138,13719,107
2021-12-17,Nevada,057,99092,10148,9991,356,10347,108
2021-12-17,Orange,059,3164182,321925,318149,16902,335051,5844
2021-12-17,Placer,061,380077,39866,39336,3993,43329,485
2021-12-17,Plumas,063,18699,2024,1964,50,2014,13
2021-12-17,Riverside,065,2383286,385385,379354,17093,396447,5439
2021-12-17,Sacramento,067,1510023,168917,167046,5252,172298,2404
2021-12-17,San Benito,069,59416,7936,7894,186,8080,79
2021-12-17,San Bernardino,071,2135413,376271,371658,12108,383766,6017
2021-12-17,San Diego,073,3302833,401588,397130,23442,420572,4399
2021-12-17,San Francisco,075,870044,57568,55562,2591,58153,679
2021-12-17,San Joaquin,077,732212,104742,103698,5767,109465,1858
2021-12-17,San Luis Obispo,079,281455,31369,30873,1400,32273,365
2021-12-17,San Mateo,081,765935,57596,55730,1055,56785,580
2021-12-17,Santa Barbara,083,443738,47318,46776,1677,48453,562
2021-12-17,Santa Clara,085,1922200,156479,154243,1810,156053,1946
2021-12-17,Santa Cruz,087,273765,22177,21805,1069,22874,225
2021-12-17,Shasta,089,179085,22972,22811,3764,26575,429
2021-12-17,Sierra,091,2930,203,199,21,220,0
2021-12-17,Siskiyou,093,43540,3504,3441,1389,4830,58
2021-12-17,Solano,095,438530,48018,47174,1410,48584,369
2021-12-17,Sonoma,097,501317,44293,43658,611,44269,407
2021-12-17,Stanislaus,099,539301,82635,82736,9511,92247,1330
2021-12-17,Sutter,101,95872,14471,14435,415,14850,190
2021-12-17,Tehama,103,63373,8916,8814,1565,10379,136
2021-12-17,Trinity,105,12862,913,823,228,1051,17
2021-12-17,Tulare,107,460477,72066,70922,16708,87630,1120
2021-12-17,Tuolumne,109,53932,7895,7834,114,7948,91
2021-12-17,Ventura,111,848112,103081,101612,4580,106192,1201
2021-12-17,Yolo,113,214977,21121,20793,1333,22126,267
2021-12-17,Yuba,115,75493,10716,10599,410,11009,96
2021-12-16,Alameda,001,1643700,126214,124583,3074,127657,1512
2021-12-16,Alpine,003,1148,108,110,0,110,0
2021-12-16,Amador,005,37829,5846,5821,77,5898,69
2021-12-16,Butte,007,227075,22196,21956,4007,25963,328
2021-12-16,Calaveras,009,45235,4577,4534,64,4598,91
2021-12-16,Colusa,011,21464,2654,2635,691,3326,21
2021-12-16,Contra Costa,013,1133247,104418,103380,2426,105806,1065
2021-12-16,Del Norte,015,27424,3817,3791,57,3848,43
2021-12-16,El Dorado,017,186661,17234,16968,1848,18816,171
2021-12-16,Fresno,019,978130,148587,147038,13471,160509,2335
2021-12-16,Glenn,021,27897,3621,3590,1052,4642,39
2021-12-16,Humboldt,023,135768,9999,9889,731,10620,118
2021-12-16,Imperial,025,180216,36745,36280,4023,40303,790
2021-12-16,Inyo,027,18085,2630,2607,43,2650,47
2021-12-16,Kern,029,883053,134910,133754,24687,158441,1873
2021-12-16,Kings,031,150075,34124,33783,2094,35877,374
2021-12-16,Lake,033,64148,7033,6976,170,7146,115
2021-12-16,Lassen,035,31185,7097,7061,431,7492,55
2021-12-16,Los Angeles,037,10098052,1503505,1484840,58084,1542924,27135
2021-12-16,Madera,039,155013,24788,24575,2389,26964,313
2021-12-16,Marin,041,260295,18826,18537,573,19110,249
2021-12-16,Mariposa,043,17540,1486,1468,63,1531,6
2021-12-16,Mendocino,045,87422,8344,8219,699,8918,95
2021-12-16,Merced,047,269075,44044,43929,2230,46159,686
2021-12-16,Modoc,049,8938,601,595,204,799,6
2021-12-16,Mono,051,14174,1981,1956,23,1979,4
2021-12-16,Monterey,053,433212,50773,49343,3457,52800,635
2021-12-16,Napa,055,140530,13700,13581,138,13719,107
2021-12-16,Nevada,057,99092,10122,9991,356,10347,108
2021-12-16,Orange,059,3164182,321317,318149,16823,334972,5844
2021-12-16,Placer,061,380077,39789,39336,3988,43324,485
2021-12-16,Plumas,063,18699,2024,1964,50,2014,13
2021-12-16,Riverside,065,2383286,384579,379354,17079,396433,5439
2021-12-16,Sacramento,067,1510023,168631,167046,5227,172273,2404
2021-12-16,San Benito,069,59416,7929,7894,186,8080,79
2021-12-16,San Bernardino,071,2135413,375620,371658,12089,383747,6017
2021-12-16,San Diego,073,3302833,400421,397130,23376,420506,4399
2021-12-16,San Francisco,075,870044,57193,55562,2569,58131,679
2021-12-16,San Joaquin,077,732212,104618,103698,5760,109458,1858
2021-12-16,San Luis Obispo,079,281455,31299,30873,1394,32267,365
2021-12-16,San Mateo,081,765935,57396,55730,1052,56782,580
2021-12-16,Santa Barbara,083,443738,47197,46776,1673,48449,562
2021-12-16,Santa Clara,085,1922200,156149,154243,1800,156043,1946
2021-12-16,Santa Cruz,087,273765,22131,21805,1068,22873,225
2021-12-16,Shasta,089,179085,22942,22811,3762,26573,429
2021-12-16,Sierra,091,2930,203,199,21,220,0
2021-12-16,Siskiyou,093,43540,3503,3441,1385,4826,58
2021-12-16,Solano,095,438530,47950,47174,1403,48577,369
2021-12-16,Sonoma,097,501317,44194,43658,609,44267,407
2021-12-16,Stanislaus,099,539301,82548,82736,9497,92233,1330
2021-12-16,Sutter,101,95872,14457,14435,414,14849,190
2021-12-16,Tehama,103,63373,8909,8814,1564,10378,136
2021-12-16,Trinity,105,12862,913,823,228,1051,17
2021-12-16,Tulare,107,460477,72018,70922,16683,87605,1120
2021-12-16,Tuolumne,109,53932,7876,7834,114,7948,91
2021-12-16,Ventura,111,848112,102813,101612,4573,106185,1201
2021-12-16,Yolo,113,214977,21070,20793,1328,22121,267
2021-12-16,Yuba,115,75493,10700,10599,409,11008,96
2021-12-15,Alameda,001,1643700,125886,124342,3062,127404,1509
2021-12-15,Alpine,003,1148,108,109,0,109,0
2021-12-15,Amador,005,37829,5840,5810,77,5887,69
2021-12-15,Butte,007,227075,22174,21922,4006,25928,327
2021-12-15,Calaveras,009,45235,4571,4523,64,4587,89
2021-12-15,Colusa,011,21464,2653,2632,690,3322,21
2021-12-15,Contra Costa,013,1133247,104199,103236,2423,105659,1064
2021-12-15,Del Norte,015,27424,3816,3789,56,3845,43
2021-12-15,El Dorado,017,186661,17202,16936,1842,18778,171
2021-12-15,Fresno,019,978130,148459,146859,13456,160315,2319
2021-12-15,Glenn,021,27897,3621,3589,1052,4641,39
2021-12-15,Humboldt,023,135768,9979,9854,730,10584,118
2021-12-15,Imperial,025,180216,36666,36187,3979,40166,789
2021-12-15,Inyo,027,18085,2625,2606,43,2649,47
2021-12-15,Kern,029,883053,134771,133590,24640,158230,1866
2021-12-15,Kings,031,150075,34095,33716,2090,35806,374
2021-12-15,Lake,033,64148,7025,6968,169,7137,115
2021-12-15,Lassen,035,31185,7097,7062,431,7493,55
2021-12-15,Los Angeles,037,10098052,1499616,1482735,57888,1540623,27116
2021-12-15,Madera,039,155013,24770,24549,2383,26932,313
2021-12-15,Marin,041,260295,18767,18514,568,19082,249
2021-12-15,Mariposa,043,17540,1483,1463,63,1526,6
2021-12-15,Mendocino,045,87422,8339,8209,696,8905,95
2021-12-15,Merced,047,269075,44002,43890,2218,46108,685
2021-12-15,Modoc,049,8938,601,595,204,799,6
2021-12-15,Mono,051,14174,1977,1955,23,1978,4
2021-12-15,Monterey,053,433212,50718,49279,3439,52718,635
2021-12-15,Napa,055,140530,13671,13557,136,13693,107
2021-12-15,Nevada,057,99092,10101,9958,356,10314,107
2021-12-15,Orange,059,3164182,320736,317808,16781,334589,5838
2021-12-15,Placer,061,380077,39733,39264,3978,43242,485
2021-12-15,Plumas,063,18699,2020,1957,50,2007,12
2021-12-15,Riverside,065,2383286,383859,378769,17067,395836,5438
2021-12-15,Sacramento,067,1510023,168321,166793,5206,171999,2401
2021-12-15,San Benito,069,59416,7914,7877,186,8063,79
2021-12-15,San Bernardino,071,2135413,375070,371122,12057,383179,6013
2021-12-15,San Diego,073,3302833,399227,396546,23306,419852,4395
2021-12-15,San Francisco,075,870044,56875,55414,2551,57965,679
2021-12-15,San Joaquin,077,732212,104461,103579,5750,109329,1853
2021-12-15,San Luis Obispo,079,281455,31250,30784,1387,32171,365
2021-12-15,San Mateo,081,765935,57254,55657,1042,56699,580
2021-12-15,Santa Barbara,083,443738,47116,46681,1671,48352,562
2021-12-15,Santa Clara,085,1922200,155838,153928,1779,155707,1944
2021-12-15,Santa Cruz,087,273765,22091,21753,1061,22814,225
2021-12-15,Shasta,089,179085,22927,22778,3758,26536,427
2021-12-15,Sierra,091,2930,203,199,21,220,0
2021-12-15,Siskiyou,093,43540,3502,3434,1384,4818,58
2021-12-15,Solano,095,438530,47879,47098,1396,48494,367
2021-12-15,Sonoma,097,501317,44112,43580,604,44184,407
2021-12-15,Stanislaus,099,539301,82442,82628,9489,92117,1298
2021-12-15,Sutter,101,95872,14437,14428,413,14841,189
2021-12-15,Tehama,103,63373,8902,8806,1563,10369,136
2021-12-15,Trinity,105,12862,912,822,228,1050,17
2021-12-15,Tulare,107,460477,71967,70846,16654,87500,1120
2021-12-15,Tuolumne,109,53932,7867,7818,113,7931,91
2021-12-15,Ventura,111,848112,102598,101447,4567,106014,1199
2021-12-15,Yolo,113,214977,21042,20749,1323,22072,267
2021-12-15,Yuba,115,75493,10689,10587,408,10995,96
2021-12-14,Alameda,001,1643700,125558,124272,3049,127321,1506
2021-12-14,Alpine,003,1148,107,109,0,109,0
2021-12-14,Amador,005,37829,5834,5808,76,5884,69
2021-12-14,Butte,007,227075,22141,21901,4004,25905,326
2021-12-14,Calaveras,009,45235,4559,4517,64,4581,89
2021-12-14,Colusa,011,21464,2651,2628,690,3318,21
2021-12-14,Contra Costa,013,1133247,104015,103135,2419,105554,1064
2021-12-14,Del Norte,015,27424,3813,3788,56,3844,43
2021-12-14,El Dorado,017,186661,17168,16915,1840,18755,170
2021-12-14,Fresno,019,978130,148289,146756,13448,160204,2316
2021-12-14,Glenn,021,27897,3620,3589,1052,4641,39
2021-12-14,Humboldt,023,135768,9967,9836,722,10558,118
2021-12-14,Imperial,025,180216,36593,36049,3936,39985,789
2021-12-14,Inyo,027,18085,2624,2601,43,2644,46
2021-12-14,Kern,029,883053,134633,133498,24591,158089,1863
2021-12-14,Kings,031,150075,34058,33693,2087,35780,373
2021-12-14,Lake,033,64148,7016,6961,169,7130,115
2021-12-14,Lassen,035,31185,7096,7061,431,7492,55
2021-12-14,Los Angeles,037,10098052,1495958,1481131,57707,1538838,27099
2021-12-14,Madera,039,155013,24743,24535,2375,26910,313
2021-12-14,Marin,041,260295,18719,18491,566,19057,249
2021-12-14,Mariposa,043,17540,1480,1463,62,1525,6
2021-12-14,Mendocino,045,87422,8311,8206,694,8900,95
2021-12-14,Merced,047,269075,43956,43870,2216,46086,684
2021-12-14,Modoc,049,8938,600,595,204,799,6
2021-12-14,Mono,051,14174,1970,1955,23,1978,4
2021-12-14,Monterey,053,433212,50634,49237,3428,52665,635
2021-12-14,Napa,055,140530,13642,13528,136,13664,107
2021-12-14,Nevada,057,99092,10075,9956,355,10311,106
2021-12-14,Orange,059,3164182,320182,317465,16727,334192,5827
2021-12-14,Placer,061,380077,39658,39221,3973,43194,482
2021-12-14,Plumas,063,18699,2016,1950,48,1998,12
2021-12-14,Riverside,065,2383286,383167,378227,17050,395277,5427
2021-12-14,Sacramento,067,1510023,168010,166605,5183,171788,2394
2021-12-14,San Benito,069,59416,7895,7871,186,8057,79
2021-12-14,San Bernardino,071,2135413,374445,370604,12026,382630,6013
2021-12-14,San Diego,073,3302833,398088,395876,23255,419131,4393
2021-12-14,San Francisco,075,870044,56562,55278,2539,57817,679
2021-12-14,San Joaquin,077,732212,104315,103488,5732,109220,1848
2021-12-14,San Luis Obispo,079,281455,31190,30753,1383,32136,363
2021-12-14,San Mateo,081,765935,57090,55601,1035,56636,580
2021-12-14,Santa Barbara,083,443738,47013,46648,1666,48314,560
2021-12-14,Santa Clara,085,1922200,155515,153814,1766,155580,1945
2021-12-14,Santa Cruz,087,273765,22026,21737,1056,22793,225
2021-12-14,Shasta,089,179085,22900,22756,3757,26513,427
2021-12-14,Sierra,091,2930,201,199,21,220,0
2021-12-14,Siskiyou,093,43540,3497,3430,1383,4813,58
2021-12-14,Solano,095,438530,47832,47065,1390,48455,367
2021-12-14,Sonoma,097,501317,44029,43538,602,44140,407
2021-12-14,Stanislaus,099,539301,82356,82581,9473,92054,1293
2021-12-14,Sutter,101,95872,14425,14421,412,14833,189
2021-12-14,Tehama,103,63373,8898,8805,1563,10368,134
2021-12-14,Trinity,105,12862,912,821,228,1049,17
2021-12-14,Tulare,107,460477,71895,70803,16623,87426,1120
2021-12-14,Tuolumne,109,53932,7854,7815,113,7928,91
2021-12-14,Ventura,111,848112,102373,101343,4560,105903,1199
2021-12-14,Yolo,113,214977,21008,20734,1310,22044,267
2021-12-14,Yuba,115,75493,10672,10574,408,10982,92
2021-12-13,Alameda,001,1643700,125274,124174,3032,127206,1501
2021-12-13,Alpine,003,1148,107,109,0,109,0
2021-12-13,Amador,005,37829,5830,5797,76,5873,69
2021-12-13,Butte,007,227075,22117,21889,4000,25889,326
2021-12-13,Calaveras,009,45235,4552,4507,63,4570,89
2021-12-13,Colusa,011,21464,2649,2627,690,3317,21
2021-12-13,Contra Costa,013,1133247,103864,103041,2408,105449,1064
2021-12-13,Del Norte,015,27424,3809,3787,56,3843,42
2021-12-13,El Dorado,017,186661,17145,16896,1838,18734,170
2021-12-13,Fresno,019,978130,148138,146641,13438,160079,2312
2021-12-13,Glenn,021,27897,3615,3589,1050,4639,37
2021-12-13,Humboldt,023,135768,9938,9821,718,10539,118
2021-12-13,Imperial,025,180216,36509,35974,3915,39889,787
2021-12-13,Inyo,027,18085,2623,2592,43,2635,46
2021-12-13,Kern,029,883053,134507,133381,24538,157919,1863
2021-12-13,Kings,031,150075,34015,33680,2082,35762,372
2021-12-13,Lake,033,64148,7014,6958,167,7125,115
2021-12-13,Lassen,035,31185,7095,7057,431,7488,55
2021-12-13,Los Angeles,037,10098052,1493178,1480195,57541,1537736,27085
2021-12-13,Madera,039,155013,24714,24527,2370,26897,311
2021-12-13,Marin,041,260295,18659,18471,563,19034,249
2021-12-13,Mariposa,043,17540,1478,1462,62,1524,6
2021-12-13,Mendocino,045,87422,8298,8196,692,8888,95
2021-12-13,Merced,047,269075,43917,43848,2212,46060,682
2021-12-13,Modoc,049,8938,599,595,204,799,6
2021-12-13,Mono,051,14174,1963,1952,23,1975,4
2021-12-13,Monterey,053,433212,50582,49222,3408,52630,631
2021-12-13,Napa,055,140530,13629,13518,136,13654,107
2021-12-13,Nevada,057,99092,10056,9946,354,10300,106
2021-12-13,Orange,059,3164182,319712,317112,16673,333785,5824
2021-12-13,Placer,061,380077,39597,39168,3962,43130,481
2021-12-13,Plumas,063,18699,2012,1943,48,1991,12
2021-12-13,Riverside,065,2383286,382584,377728,17035,394763,5414
2021-12-13,Sacramento,067,1510023,167732,166439,5151,171590,2392
2021-12-13,San Benito,069,59416,7886,7856,186,8042,79
2021-12-13,San Bernardino,071,2135413,373867,370274,12018,382292,6011
2021-12-13,San Diego,073,3302833,397282,395266,23202,418468,4389
2021-12-13,San Francisco,075,870044,56291,55245,2526,57771,678
2021-12-13,San Joaquin,077,732212,104199,103449,5723,109172,1846
2021-12-13,San Luis Obispo,079,281455,31140,30746,1379,32125,363
2021-12-13,San Mateo,081,765935,56931,55569,1026,56595,580
2021-12-13,Santa Barbara,083,443738,46925,46608,1661,48269,560
2021-12-13,Santa Clara,085,1922200,155250,153672,1755,155427,1944
2021-12-13,Santa Cruz,087,273765,21971,21698,1053,22751,225
2021-12-13,Shasta,089,179085,22879,22731,3755,26486,426
2021-12-13,Sierra,091,2930,201,199,21,220,0
2021-12-13,Siskiyou,093,43540,3493,3426,1380,4806,57
2021-12-13,Solano,095,438530,47758,47045,1385,48430,365
2021-12-13,Sonoma,097,501317,43933,43492,600,44092,407
2021-12-13,Stanislaus,099,539301,82240,82507,9450,91957,1282
2021-12-13,Sutter,101,95872,14418,14408,412,14820,188
2021-12-13,Tehama,103,63373,8885,8800,1563,10363,134
2021-12-13,Trinity,105,12862,912,820,228,1048,17
2021-12-13,Tulare,107,460477,71837,70758,16599,87357,1114
2021-12-13,Tuolumne,109,53932,7843,7804,113,7917,91
2021-12-13,Ventura,111,848112,102148,101180,4549,105729,1197
2021-12-13,Yolo,113,214977,20959,20706,1305,22011,267
2021-12-13,Yuba,115,75493,10655,10570,408,10978,92
2021-12-12,Alameda,001,1643700,124987,124075,3019,127094,1503
2021-12-12,Alpine,003,1148,107,109,0,109,0
2021-12-12,Amador,005,37829,5822,5797,75,5872,69
2021-12-12,Butte,007,227075,22093,21874,3997,25871,326
2021-12-12,Calaveras,009,45235,4541,4501,63,4564,89
2021-12-12,Colusa,011,21464,2644,2627,687,3314,21
2021-12-12,Contra Costa,013,1133247,103675,102976,2406,105382,1065
2021-12-12,Del Norte,015,27424,3806,3793,56,3849,42
2021-12-12,El Dorado,017,186661,17109,16890,1830,18720,170
2021-12-12,Fresno,019,978130,147976,146518,13422,159940,2310
2021-12-12,Glenn,021,27897,3612,3589,1050,4639,37
2021-12-12,Humboldt,023,135768,9914,9804,711,10515,118
2021-12-12,Imperial,025,180216,36375,35926,3883,39809,787
2021-12-12,Inyo,027,18085,2618,2592,43,2635,46
2021-12-12,Kern,029,883053,134341,133314,24497,157811,1861
2021-12-12,Kings,031,150075,33964,33661,2080,35741,372
2021-12-12,Lake,033,64148,7007,6955,165,7120,115
2021-12-12,Lassen,035,31185,7094,7057,431,7488,55
2021-12-12,Los Angeles,037,10098052,1490275,1479054,57358,1536412,27074
2021-12-12,Madera,039,155013,24685,24493,2363,26856,311
2021-12-12,Marin,041,260295,18606,18451,559,19010,249
2021-12-12,Mariposa,043,17540,1477,1461,62,1523,6
2021-12-12,Mendocino,045,87422,8285,8190,691,8881,95
2021-12-12,Merced,047,269075,43883,43821,2205,46026,682
2021-12-12,Modoc,049,8938,599,595,203,798,6
2021-12-12,Mono,051,14174,1959,1947,23,1970,4
2021-12-12,Monterey,053,433212,50529,49192,3382,52574,631
2021-12-12,Napa,055,140530,13586,13508,134,13642,107
2021-12-12,Nevada,057,99092,10029,9938,353,10291,106
2021-12-12,Orange,059,3164182,319206,316918,16608,333526,5825
2021-12-12,Placer,061,380077,39532,39139,3956,43095,481
2021-12-12,Plumas,063,18699,2008,1942,46,1988,12
2021-12-12,Riverside,065,2383286,381908,377467,17009,394476,5414
2021-12-12,Sacramento,067,1510023,167466,166291,5130,171421,2392
2021-12-12,San Benito,069,59416,7866,7853,186,8039,79
2021-12-12,San Bernardino,071,2135413,373224,369977,11994,381971,6011
2021-12-12,San Diego,073,3302833,396388,393307,23164,416471,4378
2021-12-12,San Francisco,075,870044,56037,55180,2514,57694,678
2021-12-12,San Joaquin,077,732212,104060,103405,5713,109118,1846
2021-12-12,San Luis Obispo,079,281455,31087,30719,1377,32096,363
2021-12-12,San Mateo,081,765935,56816,55505,1022,56527,580
2021-12-12,Santa Barbara,083,443738,46850,46586,1659,48245,560
2021-12-12,Santa Clara,085,1922200,154970,153452,1741,155193,1945
2021-12-12,Santa Cruz,087,273765,21922,21671,1051,22722,225
2021-12-12,Shasta,089,179085,22851,22732,3754,26486,426
2021-12-12,Sierra,091,2930,201,199,21,220,0
2021-12-12,Siskiyou,093,43540,3493,3424,1380,4804,57
2021-12-12,Solano,095,438530,47692,47021,1380,48401,365
2021-12-12,Sonoma,097,501317,43840,43424,597,44021,407
2021-12-12,Stanislaus,099,539301,82142,82460,9437,91897,1282
2021-12-12,Sutter,101,95872,14407,14396,412,14808,189
2021-12-12,Tehama,103,63373,8874,8796,1561,10357,134
2021-12-12,Trinity,105,12862,910,820,228,1048,17
2021-12-12,Tulare,107,460477,71760,70733,16557,87290,1115
2021-12-12,Tuolumne,109,53932,7826,7794,113,7907,91
2021-12-12,Ventura,111,848112,101954,101105,4535,105640,1197
2021-12-12,Yolo,113,214977,20909,20685,1294,21979,267
2021-12-12,Yuba,115,75493,10641,10565,405,10970,92
2021-12-11,Alameda,001,1643700,124850,123572,3017,126589,1496
2021-12-11,Alpine,003,1148,107,109,0,109,0
2021-12-11,Amador,005,37829,5817,5787,75,5862,69
2021-12-11,Butte,007,227075,22079,21819,3996,25815,326
2021-12-11,Calaveras,009,45235,4533,4469,62,4531,89
2021-12-11,Colusa,011,21464,2640,2619,686,3305,21
2021-12-11,Contra Costa,013,1133247,103589,102618,2404,105022,1061
2021-12-11,Del Norte,015,27424,3806,3778,56,3834,42
2021-12-11,El Dorado,017,186661,17089,16796,1829,18625,170
2021-12-11,Fresno,019,978130,147888,145988,13413,159401,2294
2021-12-11,Glenn,021,27897,3611,3585,1050,4635,37
2021-12-11,Humboldt,023,135768,9897,9721,708,10429,118
2021-12-11,Imperial,025,180216,36316,35635,3873,39508,782
2021-12-11,Inyo,027,18085,2613,2576,43,2619,46
2021-12-11,Kern,029,883053,134272,132852,24462,157314,1854
2021-12-11,Kings,031,150075,33951,33530,2078,35608,371
2021-12-11,Lake,033,64148,7006,6932,163,7095,114
2021-12-11,Lassen,035,31185,7093,7049,431,7480,55
2021-12-11,Los Angeles,037,10098052,1489060,1474030,57266,1531296,27031
2021-12-11,Madera,039,155013,24679,24417,2362,26779,311
2021-12-11,Marin,041,260295,18573,18339,556,18895,249
2021-12-11,Mariposa,043,17540,1476,1450,62,1512,6
2021-12-11,Mendocino,045,87422,8278,8130,691,8821,95
2021-12-11,Merced,047,269075,43864,43690,2204,45894,681
2021-12-11,Modoc,049,8938,599,594,203,797,6
2021-12-11,Mono,051,14174,1955,1926,23,1949,4
2021-12-11,Monterey,053,433212,50501,49008,3379,52387,631
2021-12-11,Napa,055,140530,13569,13459,134,13593,107
2021-12-11,Nevada,057,99092,10016,9880,353,10233,106
2021-12-11,Orange,059,3164182,318954,315759,16581,332340,5805
2021-12-11,Placer,061,380077,39474,38959,3949,42908,481
2021-12-11,Plumas,063,18699,2002,1934,46,1980,12
2021-12-11,Riverside,065,2383286,381488,375649,16994,392643,5408
2021-12-11,Sacramento,067,1510023,167336,165530,5120,170650,2386
2021-12-11,San Benito,069,59416,7852,7808,186,7994,79
2021-12-11,San Bernardino,071,2135413,372864,368145,11984,380129,6007
2021-12-11,San Diego,073,3302833,395968,392274,23126,415400,4374
2021-12-11,San Francisco,075,870044,55884,54869,2509,57378,678
2021-12-11,San Joaquin,077,732212,103999,103013,5709,108722,1842
2021-12-11,San Luis Obispo,079,281455,31065,30567,1373,31940,362
2021-12-11,San Mateo,081,765935,56737,55284,1020,56304,580
2021-12-11,Santa Barbara,083,443738,46815,46309,1659,47968,559
2021-12-11,Santa Clara,085,1922200,154772,152846,1729,154575,1941
2021-12-11,Santa Cruz,087,273765,21898,21557,1051,22608,225
2021-12-11,Shasta,089,179085,22836,22660,3750,26410,419
2021-12-11,Sierra,091,2930,201,199,21,220,0
2021-12-11,Siskiyou,093,43540,3487,3418,1377,4795,57
2021-12-11,Solano,095,438530,47663,46891,1375,48266,365
2021-12-11,Sonoma,097,501317,43792,43227,597,43824,407
2021-12-11,Stanislaus,099,539301,82093,82133,9428,91561,1264
2021-12-11,Sutter,101,95872,14398,14354,412,14766,187
2021-12-11,Tehama,103,63373,8871,8776,1559,10335,134
2021-12-11,Trinity,105,12862,910,819,228,1047,17
2021-12-11,Tulare,107,460477,71716,70523,16547,87070,1103
2021-12-11,Tuolumne,109,53932,7817,7760,113,7873,91
2021-12-11,Ventura,111,848112,101879,100711,4528,105239,1195
2021-12-11,Yolo,113,214977,20890,20608,1290,21898,267
2021-12-11,Yuba,115,75493,10629,10519,404,10923,92
2021-12-10,Alameda,001,1643700,124724,123572,3010,126582,1496
2021-12-10,Alpine,003,1148,106,109,0,109,0
2021-12-10,Amador,005,37829,5810,5787,75,5862,69
2021-12-10,Butte,007,227075,22066,21819,3994,25813,326
2021-12-10,Calaveras,009,45235,4530,4469,62,4531,89
2021-12-10,Colusa,011,21464,2639,2619,686,3305,21
2021-12-10,Contra Costa,013,1133247,103493,102618,2403,105021,1061
2021-12-10,Del Norte,015,27424,3806,3778,56,3834,42
2021-12-10,El Dorado,017,186661,17076,16796,1829,18625,170
2021-12-10,Fresno,019,978130,147800,145988,13402,159390,2294
2021-12-10,Glenn,021,27897,3611,3585,1050,4635,37
2021-12-10,Humboldt,023,135768,9880,9721,706,10427,118
2021-12-10,Imperial,025,180216,36261,35635,3858,39493,782
2021-12-10,Inyo,027,18085,2610,2576,43,2619,46
2021-12-10,Kern,029,883053,134183,132852,24438,157290,1854
2021-12-10,Kings,031,150075,33936,33530,2076,35606,371
2021-12-10,Lake,033,64148,6999,6932,163,7095,114
2021-12-10,Lassen,035,31185,7092,7049,431,7480,55
2021-12-10,Los Angeles,037,10098052,1487968,1474030,57178,1531208,27031
2021-12-10,Madera,039,155013,24661,24417,2360,26777,311
2021-12-10,Marin,041,260295,18551,18339,556,18895,249
2021-12-10,Mariposa,043,17540,1473,1450,62,1512,6
2021-12-10,Mendocino,045,87422,8271,8130,690,8820,95
2021-12-10,Merced,047,269075,43846,43690,2202,45892,681
2021-12-10,Modoc,049,8938,599,594,203,797,6
2021-12-10,Mono,051,14174,1952,1926,23,1949,4
2021-12-10,Monterey,053,433212,50464,49008,3373,52381,631
2021-12-10,Napa,055,140530,13557,13459,133,13592,107
2021-12-10,Nevada,057,99092,10007,9880,353,10233,106
2021-12-10,Orange,059,3164182,318682,315759,16549,332308,5805
2021-12-10,Placer,061,380077,39431,38959,3946,42905,481
2021-12-10,Plumas,063,18699,2000,1934,46,1980,12
2021-12-10,Riverside,065,2383286,381081,375649,16983,392632,5408
2021-12-10,Sacramento,067,1510023,167183,165530,5118,170648,2386
2021-12-10,San Benito,069,59416,7848,7808,186,7994,79
2021-12-10,San Bernardino,071,2135413,372492,368145,11961,380106,6007
2021-12-10,San Diego,073,3302833,395488,392274,23112,415386,4374
2021-12-10,San Francisco,075,870044,55799,54869,2503,57372,678
2021-12-10,San Joaquin,077,732212,103944,103013,5705,108718,1842
2021-12-10,San Luis Obispo,079,281455,31055,30567,1370,31937,362
2021-12-10,San Mateo,081,765935,56680,55284,1017,56301,580
2021-12-10,Santa Barbara,083,443738,46779,46309,1658,47967,559
2021-12-10,Santa Clara,085,1922200,154602,152846,1716,154562,1941
2021-12-10,Santa Cruz,087,273765,21878,21557,1050,22607,225
2021-12-10,Shasta,089,179085,22825,22660,3747,26407,419
2021-12-10,Sierra,091,2930,201,199,21,220,0
2021-12-10,Siskiyou,093,43540,3480,3418,1377,4795,57
2021-12-10,Solano,095,438530,47621,46891,1371,48262,365
2021-12-10,Sonoma,097,501317,43758,43227,596,43823,407
2021-12-10,Stanislaus,099,539301,82027,82133,9422,91555,1264
2021-12-10,Sutter,101,95872,14390,14354,412,14766,187
2021-12-10,Tehama,103,63373,8869,8776,1557,10333,134
2021-12-10,Trinity,105,12862,910,819,228,1047,17
2021-12-10,Tulare,107,460477,71687,70523,16522,87045,1103
2021-12-10,Tuolumne,109,53932,7811,7760,113,7873,91
2021-12-10,Ventura,111,848112,101775,100711,4525,105236,1195
2021-12-10,Yolo,113,214977,20876,20608,1288,21896,267
2021-12-10,Yuba,115,75493,10617,10519,403,10922,92
2021-12-09,Alameda,001,1643700,124579,123572,3005,126577,1496
2021-12-09,Alpine,003,1148,106,109,0,109,0
2021-12-09,Amador,005,37829,5807,5787,74,5861,69
2021-12-09,Butte,007,227075,22046,21819,3990,25809,326
2021-12-09,Calaveras,009,45235,4521,4469,62,4531,89
2021-12-09,Colusa,011,21464,2637,2619,686,3305,21
2021-12-09,Contra Costa,013,1133247,103374,102618,2397,105015,1061
2021-12-09,Del Norte,015,27424,3805,3778,56,3834,42
2021-12-09,El Dorado,017,186661,17048,16796,1824,18620,170
2021-12-09,Fresno,019,978130,147654,145988,13390,159378,2294
2021-12-09,Glenn,021,27897,3611,3585,1050,4635,37
2021-12-09,Humboldt,023,135768,9857,9721,705,10426,118
2021-12-09,Imperial,025,180216,36190,35635,3828,39463,782
2021-12-09,Inyo,027,18085,2608,2576,43,2619,46
2021-12-09,Kern,029,883053,134057,132852,24405,157257,1854
2021-12-09,Kings,031,150075,33908,33530,2073,35603,371
2021-12-09,Lake,033,64148,6991,6932,163,7095,114
2021-12-09,Lassen,035,31185,7090,7049,431,7480,55
2021-12-09,Los Angeles,037,10098052,1486432,1474030,57092,1531122,27031
2021-12-09,Madera,039,155013,24636,24417,2357,26774,311
2021-12-09,Marin,041,260295,18537,18339,554,18893,249
2021-12-09,Mariposa,043,17540,1472,1450,62,1512,6
2021-12-09,Mendocino,045,87422,8258,8130,687,8817,95
2021-12-09,Merced,047,269075,43808,43690,2190,45880,681
2021-12-09,Modoc,049,8938,599,594,203,797,6
2021-12-09,Mono,051,14174,1948,1926,23,1949,4
2021-12-09,Monterey,053,433212,50417,49008,3362,52370,631
2021-12-09,Napa,055,140530,13537,13459,129,13588,107
2021-12-09,Nevada,057,99092,9988,9880,353,10233,106
2021-12-09,Orange,059,3164182,318349,315759,16510,332269,5805
2021-12-09,Placer,061,380077,39387,38959,3933,42892,481
2021-12-09,Plumas,063,18699,1992,1934,46,1980,12
2021-12-09,Riverside,065,2383286,380531,375649,16967,392616,5408
2021-12-09,Sacramento,067,1510023,166964,165530,5103,170633,2386
2021-12-09,San Benito,069,59416,7836,7808,185,7993,79
2021-12-09,San Bernardino,071,2135413,371984,368145,11937,380082,6007
2021-12-09,San Diego,073,3302833,394843,392274,23082,415356,4374
2021-12-09,San Francisco,075,870044,55714,54869,2496,57365,678
2021-12-09,San Joaquin,077,732212,103852,103013,5699,108712,1842
2021-12-09,San Luis Obispo,079,281455,31027,30567,1368,31935,362
2021-12-09,San Mateo,081,765935,56592,55284,1015,56299,580
2021-12-09,Santa Barbara,083,443738,46699,46309,1651,47960,559
2021-12-09,Santa Clara,085,1922200,154387,152846,1705,154551,1941
2021-12-09,Santa Cruz,087,273765,21850,21557,1050,22607,225
2021-12-09,Shasta,089,179085,22809,22660,3746,26406,419
2021-12-09,Sierra,091,2930,201,199,21,220,0
2021-12-09,Siskiyou,093,43540,3476,3418,1376,4794,57
2021-12-09,Solano,095,438530,47584,46891,1369,48260,365
2021-12-09,Sonoma,097,501317,43701,43227,595,43822,407
2021-12-09,Stanislaus,099,539301,81957,82133,9407,91540,1264
2021-12-09,Sutter,101,95872,14375,14354,412,14766,187
2021-12-09,Tehama,103,63373,8862,8776,1555,10331,134
2021-12-09,Trinity,105,12862,910,819,228,1047,17
2021-12-09,Tulare,107,460477,71631,70523,16493,87016,1103
2021-12-09,Tuolumne,109,53932,7800,7760,113,7873,91
2021-12-09,Ventura,111,848112,101630,100711,4513,105224,1195
2021-12-09,Yolo,113,214977,20853,20608,1280,21888,267
2021-12-09,Yuba,115,75493,10609,10519,400,10919,92
2021-12-08,Alameda,001,1643700,124430,123438,2995,126433,1496
2021-12-08,Alpine,003,1148,106,108,0,108,0
2021-12-08,Amador,005,37829,5802,5781,74,5855,69
2021-12-08,Butte,007,227075,22029,21780,3987,25767,326
2021-12-08,Calaveras,009,45235,4513,4455,62,4517,89
2021-12-08,Colusa,011,21464,2634,2619,685,3304,21
2021-12-08,Contra Costa,013,1133247,103245,102506,2396,104902,1058
2021-12-08,Del Norte,015,27424,3804,3767,56,3823,42
2021-12-08,El Dorado,017,186661,17016,16757,1824,18581,170
2021-12-08,Fresno,019,978130,147493,145830,13376,159206,2293
2021-12-08,Glenn,021,27897,3611,3584,1046,4630,37
2021-12-08,Humboldt,023,135768,9835,9704,703,10407,117
2021-12-08,Imperial,025,180216,36110,35537,3797,39334,782
2021-12-08,Inyo,027,18085,2605,2570,43,2613,46
2021-12-08,Kern,029,883053,133934,132709,24357,157066,1846
2021-12-08,Kings,031,150075,33873,33468,2072,35540,371
2021-12-08,Lake,033,64148,6985,6927,162,7089,114
2021-12-08,Lassen,035,31185,7089,7041,429,7470,55
2021-12-08,Los Angeles,037,10098052,1484881,1472410,56980,1529390,27018
2021-12-08,Madera,039,155013,24615,24396,2350,26746,311
2021-12-08,Marin,041,260295,18516,18305,551,18856,249
2021-12-08,Mariposa,043,17540,1469,1447,62,1509,6
2021-12-08,Mendocino,045,87422,8245,8118,686,8804,95
2021-12-08,Merced,047,269075,43776,43631,2183,45814,680
2021-12-08,Modoc,049,8938,599,594,203,797,6
2021-12-08,Mono,051,14174,1942,1924,23,1947,4
2021-12-08,Monterey,053,433212,50352,48957,3347,52304,631
2021-12-08,Napa,055,140530,13523,13421,129,13550,107
2021-12-08,Nevada,057,99092,9972,9862,353,10215,106
2021-12-08,Orange,059,3164182,318000,315421,16473,331894,5795
2021-12-08,Placer,061,380077,39336,38934,3928,42862,478
2021-12-08,Plumas,063,18699,1990,1924,46,1970,12
2021-12-08,Riverside,065,2383286,380017,375099,16944,392043,5404
2021-12-08,Sacramento,067,1510023,166710,165278,5075,170353,2373
2021-12-08,San Benito,069,59416,7827,7793,185,7978,79
2021-12-08,San Bernardino,071,2135413,371506,367516,11909,379425,6006
2021-12-08,San Diego,073,3302833,394194,391676,23050,414726,4369
2021-12-08,San Francisco,075,870044,55627,54792,2488,57280,677
2021-12-08,San Joaquin,077,732212,103750,102877,5690,108567,1841
2021-12-08,San Luis Obispo,079,281455,30979,30519,1363,31882,361
2021-12-08,San Mateo,081,765935,56525,55220,1009,56229,580
2021-12-08,Santa Barbara,083,443738,46644,46250,1648,47898,558
2021-12-08,Santa Clara,085,1922200,154223,152674,1694,154368,1937
2021-12-08,Santa Cruz,087,273765,21804,21505,1048,22553,224
2021-12-08,Shasta,089,179085,22789,22616,3740,26356,419
2021-12-08,Sierra,091,2930,201,199,21,220,0
2021-12-08,Siskiyou,093,43540,3475,3415,1374,4789,57
2021-12-08,Solano,095,438530,47554,46837,1368,48205,365
2021-12-08,Sonoma,097,501317,43639,43179,594,43773,405
2021-12-08,Stanislaus,099,539301,81875,82038,9394,91432,1264
2021-12-08,Sutter,101,95872,14359,14336,410,14746,187
2021-12-08,Tehama,103,63373,8853,8768,1555,10323,133
2021-12-08,Trinity,105,12862,910,818,228,1046,17
2021-12-08,Tulare,107,460477,71568,70472,16468,86940,1102
2021-12-08,Tuolumne,109,53932,7787,7749,113,7862,91
2021-12-08,Ventura,111,848112,101501,100647,4510,105157,1194
2021-12-08,Yolo,113,214977,20827,20575,1274,21849,267
2021-12-08,Yuba,115,75493,10595,10499,397,10896,92
2021-12-07,Alameda,001,1643700,124255,123325,2986,126311,1497
2021-12-07,Alpine,003,1148,106,108,0,108,0
2021-12-07,Amador,005,37829,5799,5778,73,5851,69
2021-12-07,Butte,007,227075,22004,21761,3982,25743,324
2021-12-07,Calaveras,009,45235,4496,4445,62,4507,88
2021-12-07,Colusa,011,21464,2632,2619,685,3304,21
2021-12-07,Contra Costa,013,1133247,103125,102421,2387,104808,1058
2021-12-07,Del Norte,015,27424,3803,3766,56,3822,42
2021-12-07,El Dorado,017,186661,16991,16742,1821,18563,170
2021-12-07,Fresno,019,978130,147345,145715,13361,159076,2289
2021-12-07,Glenn,021,27897,3610,3579,1046,4625,36
2021-12-07,Humboldt,023,135768,9810,9693,698,10391,117
2021-12-07,Imperial,025,180216,36032,35502,3776,39278,778
2021-12-07,Inyo,027,18085,2602,2567,43,2610,46
2021-12-07,Kern,029,883053,133774,132564,24304,156868,1838
2021-12-07,Kings,031,150075,33841,33441,2069,35510,372
2021-12-07,Lake,033,64148,6980,6925,162,7087,113
2021-12-07,Lassen,035,31185,7087,7040,428,7468,55
2021-12-07,Los Angeles,037,10098052,1483096,1470904,56878,1527782,27007
2021-12-07,Madera,039,155013,24592,24367,2343,26710,311
2021-12-07,Marin,041,260295,18483,18284,545,18829,249
2021-12-07,Mariposa,043,17540,1467,1446,62,1508,6
2021-12-07,Mendocino,045,87422,8226,8107,686,8793,95
2021-12-07,Merced,047,269075,43735,43600,2176,45776,675
2021-12-07,Modoc,049,8938,599,594,202,796,6
2021-12-07,Mono,051,14174,1940,1921,23,1944,4
2021-12-07,Monterey,053,433212,50269,48880,3330,52210,631
2021-12-07,Napa,055,140530,13505,13409,129,13538,107
2021-12-07,Nevada,057,99092,9957,9858,352,10210,105
2021-12-07,Orange,059,3164182,317667,315138,16424,331562,5784
2021-12-07,Placer,061,380077,39259,38860,3924,42784,474
2021-12-07,Plumas,063,18699,1986,1915,46,1961,12
2021-12-07,Riverside,065,2383286,379484,374552,16928,391480,5397
2021-12-07,Sacramento,067,1510023,166463,165148,5061,170209,2375
2021-12-07,San Benito,069,59416,7810,7776,185,7961,78
2021-12-07,San Bernardino,071,2135413,370924,366981,11890,378871,6007
2021-12-07,San Diego,073,3302833,393352,391110,23012,414122,4357
2021-12-07,San Francisco,075,870044,55517,54729,2483,57212,676
2021-12-07,San Joaquin,077,732212,103632,102797,5678,108475,1839
2021-12-07,San Luis Obispo,079,281455,30939,30495,1361,31856,361
2021-12-07,San Mateo,081,765935,56433,55163,1003,56166,580
2021-12-07,Santa Barbara,083,443738,46572,46205,1646,47851,556
2021-12-07,Santa Clara,085,1922200,154037,152465,1685,154150,1941
2021-12-07,Santa Cruz,087,273765,21757,21493,1048,22541,224
2021-12-07,Shasta,089,179085,22767,22594,3737,26331,418
2021-12-07,Sierra,091,2930,201,199,21,220,0
2021-12-07,Siskiyou,093,43540,3473,3412,1374,4786,57
2021-12-07,Solano,095,438530,47514,46812,1366,48178,365
2021-12-07,Sonoma,097,501317,43565,43154,593,43747,405
2021-12-07,Stanislaus,099,539301,81798,81980,9383,91363,1258
2021-12-07,Sutter,101,95872,14351,14322,409,14731,186
2021-12-07,Tehama,103,63373,8845,8765,1554,10319,133
2021-12-07,Trinity,105,12862,910,818,228,1046,17
2021-12-07,Tulare,107,460477,71512,70411,16439,86850,1103
2021-12-07,Tuolumne,109,53932,7779,7743,113,7856,91
2021-12-07,Ventura,111,848112,101404,100569,4500,105069,1194
2021-12-07,Yolo,113,214977,20801,20560,1271,21831,263
2021-12-07,Yuba,115,75493,10577,10491,396,10887,91
2021-12-06,Alameda,001,1643700,124089,123227,2983,126210,1496
2021-12-06,Alpine,003,1148,106,108,0,108,0
2021-12-06,Amador,005,37829,5792,5769,72,5841,67
2021-12-06,Butte,007,227075,21986,21732,3979,25711,321
2021-12-06,Calaveras,009,45235,4489,4443,62,4505,88
2021-12-06,Colusa,011,21464,2631,2615,681,3296,21
2021-12-06,Contra Costa,013,1133247,103004,102327,2383,104710,1058
2021-12-06,Del Norte,015,27424,3801,3744,56,3800,42
2021-12-06,El Dorado,017,186661,16966,16726,1819,18545,168
2021-12-06,Fresno,019,978130,147147,145539,13351,158890,2285
2021-12-06,Glenn,021,27897,3607,3577,1045,4622,36
2021-12-06,Humboldt,023,135768,9790,9671,691,10362,117
2021-12-06,Imperial,025,180216,35951,35453,3758,39211,778
2021-12-06,Inyo,027,18085,2596,2562,42,2604,46
2021-12-06,Kern,029,883053,133587,132366,24246,156612,1835
2021-12-06,Kings,031,150075,33808,33399,2064,35463,368
2021-12-06,Lake,033,64148,6976,6922,162,7084,113
2021-12-06,Lassen,035,31185,7082,7032,426,7458,51
2021-12-06,Los Angeles,037,10098052,1481431,1470059,56786,1526845,26993
2021-12-06,Madera,039,155013,24565,24334,2340,26674,307
2021-12-06,Marin,041,260295,18455,18252,543,18795,249
2021-12-06,Mariposa,043,17540,1464,1443,62,1505,6
2021-12-06,Mendocino,045,87422,8213,8079,682,8761,95
2021-12-06,Merced,047,269075,43695,43549,2166,45715,672
2021-12-06,Modoc,049,8938,599,593,202,795,6
2021-12-06,Mono,051,14174,1935,1913,23,1936,4
2021-12-06,Monterey,053,433212,50192,48831,3311,52142,626
2021-12-06,Napa,055,140530,13482,13387,127,13514,107
2021-12-06,Nevada,057,99092,9929,9847,351,10198,105
2021-12-06,Orange,059,3164182,317286,314859,16382,331241,5771
2021-12-06,Placer,061,380077,39201,38785,3919,42704,473
2021-12-06,Plumas,063,18699,1978,1913,46,1959,10
2021-12-06,Riverside,065,2383286,378959,374116,16914,391030,5388
2021-12-06,Sacramento,067,1510023,166186,164926,5040,169966,2367
2021-12-06,San Benito,069,59416,7794,7755,185,7940,78
2021-12-06,San Bernardino,071,2135413,370368,366606,11862,378468,5998
2021-12-06,San Diego,073,3302833,392507,390389,22967,413356,4352
2021-12-06,San Francisco,075,870044,55410,54659,2478,57137,674
2021-12-06,San Joaquin,077,732212,103504,102728,5671,108399,1837
2021-12-06,San Luis Obispo,079,281455,30902,30464,1359,31823,361
2021-12-06,San Mateo,081,765935,56359,55112,1000,56112,580
2021-12-06,Santa Barbara,083,443738,46479,46146,1645,47791,556
2021-12-06,Santa Clara,085,1922200,153828,152310,1668,153978,1937
2021-12-06,Santa Cruz,087,273765,21722,21450,1045,22495,224
2021-12-06,Shasta,089,179085,22744,22556,3729,26285,416
2021-12-06,Sierra,091,2930,200,198,21,219,0
2021-12-06,Siskiyou,093,43540,3471,3409,1369,4778,57
2021-12-06,Solano,095,438530,47469,46748,1365,48113,360
2021-12-06,Sonoma,097,501317,43495,43114,585,43699,405
2021-12-06,Stanislaus,099,539301,81704,81889,9349,91238,1241
2021-12-06,Sutter,101,95872,14339,14319,409,14728,186
2021-12-06,Tehama,103,63373,8837,8760,1554,10314,133
2021-12-06,Trinity,105,12862,910,815,227,1042,17
2021-12-06,Tulare,107,460477,71435,70285,16400,86685,1101
2021-12-06,Tuolumne,109,53932,7765,7726,113,7839,91
2021-12-06,Ventura,111,848112,101302,100426,4492,104918,1194
2021-12-06,Yolo,113,214977,20777,20548,1270,21818,263
2021-12-06,Yuba,115,75493,10562,10480,391,10871,91
2021-12-05,Alameda,001,1643700,123905,123104,2975,126079,1496
2021-12-05,Alpine,003,1148,105,108,0,108,0
2021-12-05,Amador,005,37829,5789,5761,72,5833,67
2021-12-05,Butte,007,227075,21953,21720,3972,25692,320
2021-12-05,Calaveras,009,45235,4472,4434,62,4496,88
2021-12-05,Colusa,011,21464,2630,2615,680,3295,21
2021-12-05,Contra Costa,013,1133247,102873,102251,2373,104624,1058
2021-12-05,Del Norte,015,27424,3799,3751,56,3807,42
2021-12-05,El Dorado,017,186661,16929,16717,1813,18530,168
2021-12-05,Fresno,019,978130,146973,145452,13330,158782,2284
2021-12-05,Glenn,021,27897,3605,3577,1044,4621,36
2021-12-05,Humboldt,023,135768,9760,9662,688,10350,117
2021-12-05,Imperial,025,180216,35857,35422,3729,39151,778
2021-12-05,Inyo,027,18085,2589,2559,42,2601,46
2021-12-05,Kern,029,883053,133423,132286,24194,156480,1833
2021-12-05,Kings,031,150075,33745,33360,2064,35424,369
2021-12-05,Lake,033,64148,6971,6919,161,7080,113
2021-12-05,Lassen,035,31185,7080,7031,426,7457,51
2021-12-05,Los Angeles,037,10098052,1479586,1468937,56645,1525582,26991
2021-12-05,Madera,039,155013,24524,24311,2337,26648,307
2021-12-05,Marin,041,260295,18408,18216,535,18751,249
2021-12-05,Mariposa,043,17540,1461,1440,61,1501,6
2021-12-05,Mendocino,045,87422,8194,8069,676,8745,95
2021-12-05,Merced,047,269075,43650,43534,2157,45691,672
2021-12-05,Modoc,049,8938,599,593,202,795,6
2021-12-05,Mono,051,14174,1928,1907,23,1930,4
2021-12-05,Monterey,053,433212,50120,48813,3279,52092,626
2021-12-05,Napa,055,140530,13456,13382,124,13506,107
2021-12-05,Nevada,057,99092,9908,9827,351,10178,105
2021-12-05,Orange,059,3164182,316851,314560,16339,330899,5771
2021-12-05,Placer,061,380077,39143,38738,3910,42648,473
2021-12-05,Plumas,063,18699,1974,1913,45,1958,9
2021-12-05,Riverside,065,2383286,378302,373827,16884,390711,5388
2021-12-05,Sacramento,067,1510023,165881,164721,5022,169743,2367
2021-12-05,San Benito,069,59416,7777,7748,184,7932,78
2021-12-05,San Bernardino,071,2135413,369666,366282,11815,378097,5998
2021-12-05,San Diego,073,3302833,391713,387979,22918,410897,4351
2021-12-05,San Francisco,075,870044,55309,54603,2476,57079,674
2021-12-05,San Joaquin,077,732212,103363,102698,5666,108364,1837
2021-12-05,San Luis Obispo,079,281455,30832,30454,1356,31810,360
2021-12-05,San Mateo,081,765935,56270,55050,990,56040,580
2021-12-05,Santa Barbara,083,443738,46396,46097,1637,47734,555
2021-12-05,Santa Clara,085,1922200,153575,152114,1648,153762,1933
2021-12-05,Santa Cruz,087,273765,21672,21424,1045,22469,224
2021-12-05,Shasta,089,179085,22687,22550,3728,26278,416
2021-12-05,Sierra,091,2930,200,198,21,219,0
2021-12-05,Siskiyou,093,43540,3469,3409,1368,4777,57
2021-12-05,Solano,095,438530,47406,46715,1363,48078,360
2021-12-05,Sonoma,097,501317,43418,43038,580,43618,405
2021-12-05,Stanislaus,099,539301,81571,81847,9339,91186,1241
2021-12-05,Sutter,101,95872,14315,14303,404,14707,186
2021-12-05,Tehama,103,63373,8829,8755,1553,10308,133
2021-12-05,Trinity,105,12862,909,815,227,1042,17
2021-12-05,Tulare,107,460477,71354,70254,16352,86606,1102
2021-12-05,Tuolumne,109,53932,7752,7718,113,7831,91
2021-12-05,Ventura,111,848112,101166,100367,4479,104846,1194
2021-12-05,Yolo,113,214977,20735,20512,1268,21780,263
2021-12-05,Yuba,115,75493,10549,10467,384,10851,91
2021-12-04,Alameda,001,1643700,123790,122508,2971,125479,1494
2021-12-04,Alpine,003,1148,105,108,0,108,0
2021-12-04,Amador,005,37829,5786,5729,72,5801,67
2021-12-04,Butte,007,227075,21934,21638,3968,25606,318
2021-12-04,Calaveras,009,45235,4464,4392,61,4453,88
2021-12-04,Colusa,011,21464,2630,2600,678,3278,21
2021-12-04,Contra Costa,013,1133247,102801,101824,2367,104191,1056
2021-12-04,Del Norte,015,27424,3796,3726,56,3782,42
2021-12-04,El Dorado,017,186661,16920,16621,1812,18433,168
2021-12-04,Fresno,019,978130,146884,144734,13321,158055,2270
2021-12-04,Glenn,021,27897,3605,3559,1044,4603,36
2021-12-04,Humboldt,023,135768,9745,9596,684,10280,117
2021-12-04,Imperial,025,180216,35803,35206,3716,38922,776
2021-12-04,Inyo,027,18085,2584,2538,42,2580,46
2021-12-04,Kern,029,883053,133343,131771,24171,155942,1817
2021-12-04,Kings,031,150075,33721,33183,2063,35246,367
2021-12-04,Lake,033,64148,6962,6903,161,7064,113
2021-12-04,Lassen,035,31185,7079,7014,424,7438,51
2021-12-04,Los Angeles,037,10098052,1478709,1463270,56568,1519838,26952
2021-12-04,Madera,039,155013,24510,24188,2333,26521,307
2021-12-04,Marin,041,260295,18387,18075,534,18609,249
2021-12-04,Mariposa,043,17540,1457,1421,61,1482,6
2021-12-04,Mendocino,045,87422,8189,7981,676,8657,91
2021-12-04,Merced,047,269075,43623,43337,2155,45492,671
2021-12-04,Modoc,049,8938,599,591,202,793,6
2021-12-04,Mono,051,14174,1928,1883,23,1906,4
2021-12-04,Monterey,053,433212,50088,48682,3272,51954,626
2021-12-04,Napa,055,140530,13446,13327,123,13450,106
2021-12-04,Nevada,057,99092,9900,9752,351,10103,105
2021-12-04,Orange,059,3164182,316620,313112,16313,329425,5748
2021-12-04,Placer,061,380077,39103,38460,3904,42364,473
2021-12-04,Plumas,063,18699,1971,1903,45,1948,7
2021-12-04,Riverside,065,2383286,377943,371768,16878,388646,5381
2021-12-04,Sacramento,067,1510023,165737,163900,5014,168914,2365
2021-12-04,San Benito,069,59416,7751,7688,184,7872,78
2021-12-04,San Bernardino,071,2135413,369277,364154,11801,375955,5983
2021-12-04,San Diego,073,3302833,391233,386710,22888,409598,4350
2021-12-04,San Francisco,075,870044,55241,54286,2473,56759,674
2021-12-04,San Joaquin,077,732212,103309,102286,5664,107950,1835
2021-12-04,San Luis Obispo,079,281455,30811,30318,1352,31670,360
2021-12-04,San Mateo,081,765935,56221,54774,987,55761,579
2021-12-04,Santa Barbara,083,443738,46351,45774,1637,47411,555
2021-12-04,Santa Clara,085,1922200,153420,151275,1634,152909,1928
2021-12-04,Santa Cruz,087,273765,21646,21286,1044,22330,224
2021-12-04,Shasta,089,179085,22670,22418,3726,26144,414
2021-12-04,Sierra,091,2930,200,196,21,217,0
2021-12-04,Siskiyou,093,43540,3467,3398,1368,4766,57
2021-12-04,Solano,095,438530,47386,46529,1362,47891,360
2021-12-04,Sonoma,097,501317,43373,42778,577,43355,405
2021-12-04,Stanislaus,099,539301,81500,81462,9332,90794,1231
2021-12-04,Sutter,101,95872,14307,14258,403,14661,186
2021-12-04,Tehama,103,63373,8827,8742,1553,10295,131
2021-12-04,Trinity,105,12862,908,801,227,1028,17
2021-12-04,Tulare,107,460477,71316,70014,16324,86338,1100
2021-12-04,Tuolumne,109,53932,7747,7676,113,7789,91
2021-12-04,Ventura,111,848112,101075,99751,4475,104226,1192
2021-12-04,Yolo,113,214977,20712,20442,1265,21707,261
2021-12-04,Yuba,115,75493,10538,10418,383,10801,91
2021-12-03,Alameda,001,1643700,123698,122508,2961,125469,1494
2021-12-03,Alpine,003,1148,105,108,0,108,0
2021-12-03,Amador,005,37829,5781,5729,71,5800,67
2021-12-03,Butte,007,227075,21921,21638,3963,25601,318
2021-12-03,Calaveras,009,45235,4455,4392,61,4453,88
2021-12-03,Colusa,011,21464,2628,2600,678,3278,21
2021-12-03,Contra Costa,013,1133247,102728,101824,2362,104186,1056
2021-12-03,Del Norte,015,27424,3794,3726,56,3782,42
2021-12-03,El Dorado,017,186661,16890,16621,1810,18431,168
2021-12-03,Fresno,019,978130,146770,144734,13318,158052,2270
2021-12-03,Glenn,021,27897,3604,3559,1043,4602,36
2021-12-03,Humboldt,023,135768,9728,9596,682,10278,117
2021-12-03,Imperial,025,180216,35761,35206,3686,38892,776
2021-12-03,Inyo,027,18085,2577,2538,42,2580,46
2021-12-03,Kern,029,883053,133271,131771,24136,155907,1817
2021-12-03,Kings,031,150075,33694,33183,2063,35246,367
2021-12-03,Lake,033,64148,6962,6903,161,7064,113
2021-12-03,Lassen,035,31185,7077,7014,423,7437,51
2021-12-03,Los Angeles,037,10098052,1477767,1463270,56488,1519758,26952
2021-12-03,Madera,039,155013,24484,24188,2329,26517,307
2021-12-03,Marin,041,260295,18354,18075,530,18605,249
2021-12-03,Mariposa,043,17540,1455,1421,61,1482,6
2021-12-03,Mendocino,045,87422,8182,7981,676,8657,91
2021-12-03,Merced,047,269075,43600,43337,2152,45489,671
2021-12-03,Modoc,049,8938,599,591,202,793,6
2021-12-03,Mono,051,14174,1922,1883,23,1906,4
2021-12-03,Monterey,053,433212,50049,48682,3261,51943,626
2021-12-03,Napa,055,140530,13434,13327,123,13450,106
2021-12-03,Nevada,057,99092,9889,9752,351,10103,105
2021-12-03,Orange,059,3164182,316349,313112,16281,329393,5748
2021-12-03,Placer,061,380077,39066,38460,3897,42357,473
2021-12-03,Plumas,063,18699,1968,1903,45,1948,7
2021-12-03,Riverside,065,2383286,377550,371768,16872,388640,5381
2021-12-03,Sacramento,067,1510023,165557,163900,5000,168900,2365
2021-12-03,San Benito,069,59416,7744,7688,184,7872,78
2021-12-03,San Bernardino,071,2135413,368830,364154,11790,375944,5983
2021-12-03,San Diego,073,3302833,390758,386710,22864,409574,4350
2021-12-03,San Francisco,075,870044,55172,54286,2469,56755,674
2021-12-03,San Joaquin,077,732212,103252,102286,5663,107949,1835
2021-12-03,San Luis Obispo,079,281455,30785,30318,1349,31667,360
2021-12-03,San Mateo,081,765935,56156,54774,984,55758,579
2021-12-03,Santa Barbara,083,443738,46315,45774,1637,47411,555
2021-12-03,Santa Clara,085,1922200,153238,151275,1619,152894,1928
2021-12-03,Santa Cruz,087,273765,21619,21286,1044,22330,224
2021-12-03,Shasta,089,179085,22655,22418,3726,26144,414
2021-12-03,Sierra,091,2930,200,196,21,217,0
2021-12-03,Siskiyou,093,43540,3464,3398,1366,4764,57
2021-12-03,Solano,095,438530,47344,46529,1361,47890,360
2021-12-03,Sonoma,097,501317,43337,42778,575,43353,405
2021-12-03,Stanislaus,099,539301,81443,81462,9323,90785,1231
2021-12-03,Sutter,101,95872,14294,14258,401,14659,186
2021-12-03,Tehama,103,63373,8826,8742,1552,10294,131
2021-12-03,Trinity,105,12862,908,801,227,1028,17
2021-12-03,Tulare,107,460477,71277,70014,16292,86306,1100
2021-12-03,Tuolumne,109,53932,7738,7676,113,7789,91
2021-12-03,Ventura,111,848112,100989,99751,4468,104219,1192
2021-12-03,Yolo,113,214977,20695,20442,1264,21706,261
2021-12-03,Yuba,115,75493,10530,10418,383,10801,91
2021-12-02,Alameda,001,1643700,123541,122508,2953,125461,1494
2021-12-02,Alpine,003,1148,105,108,0,108,0
2021-12-02,Amador,005,37829,5776,5729,70,5799,67
2021-12-02,Butte,007,227075,21896,21638,3960,25598,318
2021-12-02,Calaveras,009,45235,4445,4392,60,4452,88
2021-12-02,Colusa,011,21464,2627,2600,678,3278,21
2021-12-02,Contra Costa,013,1133247,102613,101824,2358,104182,1056
2021-12-02,Del Norte,015,27424,3786,3726,56,3782,42
2021-12-02,El Dorado,017,186661,16869,16621,1808,18429,168
2021-12-02,Fresno,019,978130,146601,144734,13306,158040,2270
2021-12-02,Glenn,021,27897,3604,3559,1040,4599,36
2021-12-02,Humboldt,023,135768,9709,9596,681,10277,117
2021-12-02,Imperial,025,180216,35693,35206,3663,38869,776
2021-12-02,Inyo,027,18085,2572,2538,42,2580,46
2021-12-02,Kern,029,883053,133100,131771,24083,155854,1817
2021-12-02,Kings,031,150075,33641,33183,2061,35244,367
2021-12-02,Lake,033,64148,6958,6903,161,7064,113
2021-12-02,Lassen,035,31185,7073,7014,423,7437,51
2021-12-02,Los Angeles,037,10098052,1476248,1463270,56397,1519667,26952
2021-12-02,Madera,039,155013,24447,24188,2320,26508,307
2021-12-02,Marin,041,260295,18323,18075,526,18601,249
2021-12-02,Mariposa,043,17540,1453,1421,61,1482,6
2021-12-02,Mendocino,045,87422,8166,7981,675,8656,91
2021-12-02,Merced,047,269075,43554,43337,2147,45484,671
2021-12-02,Modoc,049,8938,598,591,202,793,6
2021-12-02,Mono,051,14174,1916,1883,23,1906,4
2021-12-02,Monterey,053,433212,49972,48682,3239,51921,626
2021-12-02,Napa,055,140530,13421,13327,123,13450,106
2021-12-02,Nevada,057,99092,9871,9752,350,10102,105
2021-12-02,Orange,059,3164182,316006,313112,16244,329356,5748
2021-12-02,Placer,061,380077,39001,38460,3892,42352,473
2021-12-02,Plumas,063,18699,1965,1903,45,1948,7
2021-12-02,Riverside,065,2383286,377023,371768,16862,388630,5381
2021-12-02,Sacramento,067,1510023,165329,163900,4990,168890,2365
2021-12-02,San Benito,069,59416,7724,7688,184,7872,78
2021-12-02,San Bernardino,071,2135413,368284,364154,11771,375925,5983
2021-12-02,San Diego,073,3302833,390117,386710,22809,409519,4350
2021-12-02,San Francisco,075,870044,55077,54286,2464,56750,674
2021-12-02,San Joaquin,077,732212,103138,102286,5658,107944,1835
2021-12-02,San Luis Obispo,079,281455,30751,30318,1342,31660,360
2021-12-02,San Mateo,081,765935,56075,54774,976,55750,579
2021-12-02,Santa Barbara,083,443738,46234,45774,1634,47408,555
2021-12-02,Santa Clara,085,1922200,152992,151275,1602,152877,1928
2021-12-02,Santa Cruz,087,273765,21568,21286,1043,22329,224
2021-12-02,Shasta,089,179085,22622,22418,3725,26143,414
2021-12-02,Sierra,091,2930,200,196,21,217,0
2021-12-02,Siskiyou,093,43540,3463,3398,1359,4757,57
2021-12-02,Solano,095,438530,47294,46529,1359,47888,360
2021-12-02,Sonoma,097,501317,43263,42778,575,43353,405
2021-12-02,Stanislaus,099,539301,81351,81462,9315,90777,1231
2021-12-02,Sutter,101,95872,14281,14258,398,14656,186
2021-12-02,Tehama,103,63373,8819,8742,1550,10292,131
2021-12-02,Trinity,105,12862,908,801,227,1028,17
2021-12-02,Tulare,107,460477,71190,70014,16242,86256,1100
2021-12-02,Tuolumne,109,53932,7723,7676,112,7788,91
2021-12-02,Ventura,111,848112,100864,99751,4466,104217,1192
2021-12-02,Yolo,113,214977,20671,20442,1260,21702,261
2021-12-02,Yuba,115,75493,10514,10418,380,10798,91
2021-12-01,Alameda,001,1643700,123390,122298,2943,125241,1492
2021-12-01,Alpine,003,1148,105,108,0,108,0
2021-12-01,Amador,005,37829,5769,5723,70,5793,67
2021-12-01,Butte,007,227075,21877,21600,3954,25554,318
2021-12-01,Calaveras,009,45235,4440,4371,60,4431,88
2021-12-01,Colusa,011,21464,2620,2595,675,3270,20
2021-12-01,Contra Costa,013,1133247,102505,101651,2347,103998,1048
2021-12-01,Del Norte,015,27424,3784,3722,56,3778,42
2021-12-01,El Dorado,017,186661,16848,16575,1806,18381,166
2021-12-01,Fresno,019,978130,146393,144507,13298,157805,2264
2021-12-01,Glenn,021,27897,3597,3556,1039,4595,36
2021-12-01,Humboldt,023,135768,9685,9573,676,10249,117
2021-12-01,Imperial,025,180216,35613,35085,3636,38721,776
2021-12-01,Inyo,027,18085,2568,2533,42,2575,46
2021-12-01,Kern,029,883053,132953,131580,24028,155608,1804
2021-12-01,Kings,031,150075,33591,33112,2060,35172,364
2021-12-01,Lake,033,64148,6950,6896,160,7056,112
2021-12-01,Lassen,035,31185,7068,7008,421,7429,51
2021-12-01,Los Angeles,037,10098052,1474657,1461394,56302,1517696,26928
2021-12-01,Madera,039,155013,24416,24134,2311,26445,307
2021-12-01,Marin,041,260295,18285,18038,520,18558,249
2021-12-01,Mariposa,043,17540,1449,1415,61,1476,6
2021-12-01,Mendocino,045,87422,8152,7966,670,8636,90
2021-12-01,Merced,047,269075,43498,43259,2126,45385,670
2021-12-01,Modoc,049,8938,598,576,202,778,5
2021-12-01,Mono,051,14174,1911,1876,23,1899,4
2021-12-01,Monterey,053,433212,49923,48611,3230,51841,626
2021-12-01,Napa,055,140530,13404,13319,120,13439,107
2021-12-01,Nevada,057,99092,9858,9706,350,10056,105
2021-12-01,Orange,059,3164182,315641,312772,16206,328978,5735
2021-12-01,Placer,061,380077,38946,38373,3886,42259,472
2021-12-01,Plumas,063,18699,1961,1893,45,1938,7
2021-12-01,Riverside,065,2383286,376498,371189,16845,388034,5369
2021-12-01,Sacramento,067,1510023,165116,163616,4971,168587,2360
2021-12-01,San Benito,069,59416,7710,7669,184,7853,78
2021-12-01,San Bernardino,071,2135413,367694,363368,11744,375112,5973
2021-12-01,San Diego,073,3302833,389321,386056,22754,408810,4346
2021-12-01,San Francisco,075,870044,54995,54199,2457,56656,672
2021-12-01,San Joaquin,077,732212,103031,102109,5657,107766,1834
2021-12-01,San Luis Obispo,079,281455,30709,30238,1338,31576,360
2021-12-01,San Mateo,081,765935,55994,54711,973,55684,579
2021-12-01,Santa Barbara,083,443738,46164,45681,1632,47313,554
2021-12-01,Santa Clara,085,1922200,152772,150961,1585,152546,1925
2021-12-01,Santa Cruz,087,273765,21539,21191,1042,22233,224
2021-12-01,Shasta,089,179085,22590,22375,3719,26094,410
2021-12-01,Sierra,091,2930,200,195,21,216,0
2021-12-01,Siskiyou,093,43540,3460,3391,1359,4750,55
2021-12-01,Solano,095,438530,47249,46485,1359,47844,360
2021-12-01,Sonoma,097,501317,43187,42713,574,43287,405
2021-12-01,Stanislaus,099,539301,81258,81330,9302,90632,1231
2021-12-01,Sutter,101,95872,14266,14229,397,14626,186
2021-12-01,Tehama,103,63373,8809,8728,1550,10278,130
2021-12-01,Trinity,105,12862,903,801,227,1028,17
2021-12-01,Tulare,107,460477,71113,69953,16202,86155,1098
2021-12-01,Tuolumne,109,53932,7715,7655,112,7767,91
2021-12-01,Ventura,111,848112,100758,99680,4455,104135,1191
2021-12-01,Yolo,113,214977,20643,20393,1260,21653,260
2021-12-01,Yuba,115,75493,10503,10401,380,10781,89
2021-11-30,Alameda,001,1643700,123218,122196,2934,125130,1489
2021-11-30,Alpine,003,1148,105,108,0,108,0
2021-11-30,Amador,005,37829,5761,5716,70,5786,66
2021-11-30,Butte,007,227075,21848,21565,3944,25509,318
2021-11-30,Calaveras,009,45235,4422,4360,60,4420,88
2021-11-30,Colusa,011,21464,2619,2592,675,3267,21
2021-11-30,Contra Costa,013,1133247,102369,101538,2340,103878,1046
2021-11-30,Del Norte,015,27424,3778,3718,56,3774,42
2021-11-30,El Dorado,017,186661,16820,16558,1800,18358,166
2021-11-30,Fresno,019,978130,146192,144384,13290,157674,2259
2021-11-30,Glenn,021,27897,3592,3555,1038,4593,36
2021-11-30,Humboldt,023,135768,9654,9539,670,10209,116
2021-11-30,Imperial,025,180216,35505,34999,3608,38607,773
2021-11-30,Inyo,027,18085,2559,2530,42,2572,46
2021-11-30,Kern,029,883053,132781,131451,23971,155422,1799
2021-11-30,Kings,031,150075,33539,33074,2056,35130,362
2021-11-30,Lake,033,64148,6944,6892,158,7050,110
2021-11-30,Lassen,035,31185,7064,7003,420,7423,51
2021-11-30,Los Angeles,037,10098052,1472866,1460177,56200,1516377,26913
2021-11-30,Madera,039,155013,24382,24108,2306,26414,307
2021-11-30,Marin,041,260295,18241,18010,518,18528,249
2021-11-30,Mariposa,043,17540,1443,1412,61,1473,6
2021-11-30,Mendocino,045,87422,8123,7960,664,8624,89
2021-11-30,Merced,047,269075,43430,43200,2118,45318,668
2021-11-30,Modoc,049,8938,597,576,202,778,5
2021-11-30,Mono,051,14174,1908,1873,23,1896,4
2021-11-30,Monterey,053,433212,49860,48581,3220,51801,626
2021-11-30,Napa,055,140530,13384,13308,120,13428,105
2021-11-30,Nevada,057,99092,9842,9699,349,10048,105
2021-11-30,Orange,059,3164182,315220,312451,16164,328615,5724
2021-11-30,Placer,061,380077,38843,38324,3878,42202,470
2021-11-30,Plumas,063,18699,1956,1887,44,1931,7
2021-11-30,Riverside,065,2383286,375812,370739,16820,387559,5358
2021-11-30,Sacramento,067,1510023,164836,163420,4949,168369,2353
2021-11-30,San Benito,069,59416,7688,7645,183,7828,78
2021-11-30,San Bernardino,071,2135413,367019,363006,11722,374728,5967
2021-11-30,San Diego,073,3302833,388392,385405,22707,408112,4340
2021-11-30,San Francisco,075,870044,54888,54147,2449,56596,672
2021-11-30,San Joaquin,077,732212,102905,101972,5649,107621,1834
2021-11-30,San Luis Obispo,079,281455,30684,30200,1335,31535,360
2021-11-30,San Mateo,081,765935,55889,54656,963,55619,579
2021-11-30,Santa Barbara,083,443738,46068,45628,1626,47254,553
2021-11-30,Santa Clara,085,1922200,152513,150799,1567,152366,1929
2021-11-30,Santa Cruz,087,273765,21481,21169,1038,22207,224
2021-11-30,Shasta,089,179085,22560,22347,3716,26063,401
2021-11-30,Sierra,091,2930,197,195,21,216,0
2021-11-30,Siskiyou,093,43540,3456,3385,1356,4741,55
2021-11-30,Solano,095,438530,47186,46434,1353,47787,358
2021-11-30,Sonoma,097,501317,43108,42663,572,43235,405
2021-11-30,Stanislaus,099,539301,81157,81276,9275,90551,1227
2021-11-30,Sutter,101,95872,14255,14210,394,14604,186
2021-11-30,Tehama,103,63373,8802,8727,1549,10276,130
2021-11-30,Trinity,105,12862,902,799,227,1026,17
2021-11-30,Tulare,107,460477,71026,69900,16153,86053,1099
2021-11-30,Tuolumne,109,53932,7700,7643,112,7755,91
2021-11-30,Ventura,111,848112,100604,99601,4443,104044,1191
2021-11-30,Yolo,113,214977,20601,20376,1254,21630,260
2021-11-30,Yuba,115,75493,10484,10398,375,10773,89
2021-11-29,Alameda,001,1643700,123061,122136,2925,125061,1489
2021-11-29,Alpine,003,1148,105,108,0,108,0
2021-11-29,Amador,005,37829,5754,5706,70,5776,66
2021-11-29,Butte,007,227075,21817,21544,3938,25482,314
2021-11-29,Calaveras,009,45235,4406,4353,60,4413,88
2021-11-29,Colusa,011,21464,2617,2585,672,3257,20
2021-11-29,Contra Costa,013,1133247,102220,101441,2332,103773,1046
2021-11-29,Del Norte,015,27424,3775,3704,56,3760,42
2021-11-29,El Dorado,017,186661,16802,16534,1795,18329,166
2021-11-29,Fresno,019,978130,145986,144282,13267,157549,2254
2021-11-29,Glenn,021,27897,3589,3555,1037,4592,36
2021-11-29,Humboldt,023,135768,9637,9514,663,10177,115
2021-11-29,Imperial,025,180216,35440,34960,3587,38547,773
2021-11-29,Inyo,027,18085,2554,2529,42,2571,46
2021-11-29,Kern,029,883053,132597,131362,23929,155291,1789
2021-11-29,Kings,031,150075,33486,33059,2052,35111,363
2021-11-29,Lake,033,64148,6932,6889,158,7047,110
2021-11-29,Lassen,035,31185,7061,7003,418,7421,51
2021-11-29,Los Angeles,037,10098052,1471020,1459446,56114,1515560,26889
2021-11-29,Madera,039,155013,24346,24069,2298,26367,307
2021-11-29,Marin,041,260295,18194,17980,513,18493,249
2021-11-29,Mariposa,043,17540,1435,1409,61,1470,6
2021-11-29,Mendocino,045,87422,8106,7954,660,8614,89
2021-11-29,Merced,047,269075,43356,43167,2110,45277,667
2021-11-29,Modoc,049,8938,596,569,202,771,5
2021-11-29,Mono,051,14174,1891,1859,23,1882,4
2021-11-29,Monterey,053,433212,49799,48548,3204,51752,626
2021-11-29,Napa,055,140530,13374,13304,120,13424,104
2021-11-29,Nevada,057,99092,9828,9689,349,10038,105
2021-11-29,Orange,059,3164182,314817,312203,16118,328321,5709
2021-11-29,Placer,061,380077,38778,38261,3873,42134,470
2021-11-29,Plumas,063,18699,1953,1884,44,1928,7
2021-11-29,Riverside,065,2383286,375274,370334,16809,387143,5358
2021-11-29,Sacramento,067,1510023,164589,163282,4916,168198,2342
2021-11-29,San Benito,069,59416,7669,7631,182,7813,77
2021-11-29,San Bernardino,071,2135413,366411,362694,11688,374382,5962
2021-11-29,San Diego,073,3302833,387504,384853,22673,407526,4335
2021-11-29,San Francisco,075,870044,54790,54125,2445,56570,669
2021-11-29,San Joaquin,077,732212,102766,101927,5642,107569,1834
2021-11-29,San Luis Obispo,079,281455,30650,30165,1331,31496,359
2021-11-29,San Mateo,081,765935,55786,54622,959,55581,579
2021-11-29,Santa Barbara,083,443738,45971,45576,1622,47198,549
2021-11-29,Santa Clara,085,1922200,152239,150620,1561,152181,1925
2021-11-29,Santa Cruz,087,273765,21443,21149,1037,22186,224
2021-11-29,Shasta,089,179085,22525,22315,3712,26027,399
2021-11-29,Sierra,091,2930,197,195,21,216,0
2021-11-29,Siskiyou,093,43540,3453,3374,1349,4723,55
2021-11-29,Solano,095,438530,47134,46412,1351,47763,357
2021-11-29,Sonoma,097,501317,43031,42624,569,43193,405
2021-11-29,Stanislaus,099,539301,81076,81227,9257,90484,1223
2021-11-29,Sutter,101,95872,14239,14204,391,14595,186
2021-11-29,Tehama,103,63373,8797,8720,1544,10264,130
2021-11-29,Trinity,105,12862,897,798,227,1025,17
2021-11-29,Tulare,107,460477,70947,69850,16119,85969,1096
2021-11-29,Tuolumne,109,53932,7687,7627,112,7739,90
2021-11-29,Ventura,111,848112,100484,99520,4433,103953,1190
2021-11-29,Yolo,113,214977,20556,20344,1252,21596,257
2021-11-29,Yuba,115,75493,10467,10395,374,10769,89
2021-11-28,Alameda,001,1643700,122841,122082,2919,125001,1491
2021-11-28,Alpine,003,1148,105,108,0,108,0
2021-11-28,Amador,005,37829,5744,5703,70,5773,66
2021-11-28,Butte,007,227075,21778,21530,3935,25465,313
2021-11-28,Calaveras,009,45235,4385,4350,60,4410,88
2021-11-28,Colusa,011,21464,2613,2586,671,3257,19
2021-11-28,Contra Costa,013,1133247,102047,101355,2322,103677,1046
2021-11-28,Del Norte,015,27424,3770,3703,56,3759,42
2021-11-28,El Dorado,017,186661,16761,16527,1793,18320,166
2021-11-28,Fresno,019,978130,145740,144164,13241,157405,2252
2021-11-28,Glenn,021,27897,3586,3547,1035,4582,36
2021-11-28,Humboldt,023,135768,9605,9499,659,10158,115
2021-11-28,Imperial,025,180216,35332,34929,3563,38492,773
2021-11-28,Inyo,027,18085,2547,2531,42,2573,46
2021-11-28,Kern,029,883053,132390,131279,23872,155151,1789
2021-11-28,Kings,031,150075,33413,33057,2045,35102,364
2021-11-28,Lake,033,64148,6922,6885,157,7042,110
2021-11-28,Lassen,035,31185,7052,7002,414,7416,51
2021-11-28,Los Angeles,037,10098052,1468847,1458646,56026,1514672,26878
2021-11-28,Madera,039,155013,24298,24055,2291,26346,307
2021-11-28,Marin,041,260295,18146,17962,509,18471,249
2021-11-28,Mariposa,043,17540,1431,1406,61,1467,6
2021-11-28,Mendocino,045,87422,8076,7943,655,8598,89
2021-11-28,Merced,047,269075,43290,43166,2095,45261,667
2021-11-28,Modoc,049,8938,595,569,202,771,5
2021-11-28,Mono,051,14174,1885,1841,23,1864,4
2021-11-28,Monterey,053,433212,49734,48537,3185,51722,626
2021-11-28,Napa,055,140530,13361,13303,120,13423,104
2021-11-28,Nevada,057,99092,9802,9684,348,10032,105
2021-11-28,Orange,059,3164182,314431,312028,16075,328103,5693
2021-11-28,Placer,061,380077,38696,38240,3854,42094,470
2021-11-28,Plumas,063,18699,1947,1884,43,1927,7
2021-11-28,Riverside,065,2383286,374613,370051,16787,386838,5358
2021-11-28,Sacramento,067,1510023,164232,163170,4893,168063,2335
2021-11-28,San Benito,069,59416,7650,7623,181,7804,77
2021-11-28,San Bernardino,071,2135413,365683,362407,11660,374067,5958
2021-11-28,San Diego,073,3302833,386615,383025,22609,405634,4325
2021-11-28,San Francisco,075,870044,54714,54082,2440,56522,669
2021-11-28,San Joaquin,077,732212,102585,101895,5625,107520,1834
2021-11-28,San Luis Obispo,079,281455,30586,30152,1327,31479,358
2021-11-28,San Mateo,081,765935,55692,54567,955,55522,579
2021-11-28,Santa Barbara,083,443738,45892,45551,1611,47162,549
2021-11-28,Santa Clara,085,1922200,151938,150436,1546,151982,1920
2021-11-28,Santa Cruz,087,273765,21372,21110,1036,22146,224
2021-11-28,Shasta,089,179085,22486,22316,3710,26026,400
2021-11-28,Sierra,091,2930,197,195,21,216,0
2021-11-28,Siskiyou,093,43540,3447,3372,1345,4717,55
2021-11-28,Solano,095,438530,47072,46385,1350,47735,356
2021-11-28,Sonoma,097,501317,42945,42583,566,43149,405
2021-11-28,Stanislaus,099,539301,80957,81181,9235,90416,1223
2021-11-28,Sutter,101,95872,14217,14192,385,14577,186
2021-11-28,Tehama,103,63373,8789,8720,1540,10260,130
2021-11-28,Trinity,105,12862,896,797,227,1024,17
2021-11-28,Tulare,107,460477,70849,69833,16066,85899,1095
2021-11-28,Tuolumne,109,53932,7666,7620,112,7732,90
2021-11-28,Ventura,111,848112,100328,99486,4422,103908,1190
2021-11-28,Yolo,113,214977,20513,20333,1251,21584,257
2021-11-28,Yuba,115,75493,10449,10391,372,10763,89
2021-11-27,Alameda,001,1643700,122743,121618,2916,124534,1477
2021-11-27,Alpine,003,1148,105,106,0,106,0
2021-11-27,Amador,005,37829,5743,5670,70,5740,66
2021-11-27,Butte,007,227075,21755,21384,3930,25314,309
2021-11-27,Calaveras,009,45235,4379,4294,60,4354,85
2021-11-27,Colusa,011,21464,2612,2568,669,3237,19
2021-11-27,Contra Costa,013,1133247,101962,100961,2321,103282,1045
2021-11-27,Del Norte,015,27424,3763,3661,56,3717,42
2021-11-27,El Dorado,017,186661,16726,16399,1792,18191,161
2021-11-27,Fresno,019,978130,145628,143386,13235,156621,2246
2021-11-27,Glenn,021,27897,3582,3532,1034,4566,36
2021-11-27,Humboldt,023,135768,9577,9399,657,10056,115
2021-11-27,Imperial,025,180216,35250,34611,3547,38158,769
2021-11-27,Inyo,027,18085,2544,2506,42,2548,45
2021-11-27,Kern,029,883053,132306,130245,23843,154088,1773
2021-11-27,Kings,031,150075,33391,32891,2042,34933,358
2021-11-27,Lake,033,64148,6919,6836,156,6992,110
2021-11-27,Lassen,035,31185,7050,6959,413,7372,47
2021-11-27,Los Angeles,037,10098052,1467841,1454495,55956,1510451,26817
2021-11-27,Madera,039,155013,24277,23880,2286,26166,296
2021-11-27,Marin,041,260295,18107,17857,504,18361,248
2021-11-27,Mariposa,043,17540,1429,1374,61,1435,6
2021-11-27,Mendocino,045,87422,8057,7871,655,8526,89
2021-11-27,Merced,047,269075,43255,42921,2092,45013,664
2021-11-27,Modoc,049,8938,593,551,202,753,5
2021-11-27,Mono,051,14174,1883,1810,23,1833,4
2021-11-27,Monterey,053,433212,49701,48400,3171,51571,625
2021-11-27,Napa,055,140530,13347,13256,120,13376,104
2021-11-27,Nevada,057,99092,9780,9584,347,9931,103
2021-11-27,Orange,059,3164182,314180,310809,16038,326847,5665
2021-11-27,Placer,061,380077,38635,38001,3848,41849,468
2021-11-27,Plumas,063,18699,1943,1860,43,1903,7
2021-11-27,Riverside,065,2383286,374255,367601,16780,384381,5306
2021-11-27,Sacramento,067,1510023,164074,162328,4890,167218,2335
2021-11-27,San Benito,069,59416,7634,7575,181,7756,77
2021-11-27,San Bernardino,071,2135413,365251,360033,11651,371684,5932
2021-11-27,San Diego,073,3302833,386120,382634,22583,405217,4319
2021-11-27,San Francisco,075,870044,54664,53830,2437,56267,669
2021-11-27,San Joaquin,077,732212,102518,101368,5622,106990,1833
2021-11-27,San Luis Obispo,079,281455,30551,29983,1323,31306,358
2021-11-27,San Mateo,081,765935,55635,54360,952,55312,577
2021-11-27,Santa Barbara,083,443738,45838,45318,1609,46927,548
2021-11-27,Santa Clara,085,1922200,151731,149700,1539,151239,1922
2021-11-27,Santa Cruz,087,273765,21332,20929,1033,21962,222
2021-11-27,Shasta,089,179085,22463,22151,3709,25860,396
2021-11-27,Sierra,091,2930,196,194,21,215,0
2021-11-27,Siskiyou,093,43540,3444,3336,1343,4679,54
2021-11-27,Solano,095,438530,47036,46163,1347,47510,356
2021-11-27,Sonoma,097,501317,42882,42368,566,42934,405
2021-11-27,Stanislaus,099,539301,80889,80782,9217,89999,1220
2021-11-27,Sutter,101,95872,14209,14127,384,14511,181
2021-11-27,Tehama,103,63373,8787,8675,1539,10214,129
2021-11-27,Trinity,105,12862,896,789,227,1016,17
2021-11-27,Tulare,107,460477,70797,69377,16050,85427,1082
2021-11-27,Tuolumne,109,53932,7653,7574,112,7686,90
2021-11-27,Ventura,111,848112,100255,99163,4415,103578,1188
2021-11-27,Yolo,113,214977,20492,20237,1242,21479,257
2021-11-27,Yuba,115,75493,10438,10335,372,10707,88
2021-11-26,Alameda,001,1643700,122632,121618,2914,124532,1477
2021-11-26,Alpine,003,1148,105,106,0,106,0
2021-11-26,Amador,005,37829,5739,5670,70,5740,66
2021-11-26,Butte,007,227075,21731,21384,3925,25309,309
2021-11-26,Calaveras,009,45235,4370,4294,60,4354,85
2021-11-26,Colusa,011,21464,2610,2568,668,3236,19
2021-11-26,Contra Costa,013,1133247,101874,100961,2317,103278,1045
2021-11-26,Del Norte,015,27424,3760,3661,56,3717,42
2021-11-26,El Dorado,017,186661,16709,16399,1789,18188,161
2021-11-26,Fresno,019,978130,145496,143386,13225,156611,2246
2021-11-26,Glenn,021,27897,3580,3532,1034,4566,36
2021-11-26,Humboldt,023,135768,9558,9399,653,10052,115
2021-11-26,Imperial,025,180216,35193,34611,3534,38145,769
2021-11-26,Inyo,027,18085,2544,2506,42,2548,45
2021-11-26,Kern,029,883053,132223,130245,23799,154044,1773
2021-11-26,Kings,031,150075,33367,32891,2040,34931,358
2021-11-26,Lake,033,64148,6917,6836,156,6992,110
2021-11-26,Lassen,035,31185,7044,6959,413,7372,47
2021-11-26,Los Angeles,037,10098052,1466997,1454495,55895,1510390,26817
2021-11-26,Madera,039,155013,24250,23880,2284,26164,296
2021-11-26,Marin,041,260295,18078,17857,504,18361,248
2021-11-26,Mariposa,043,17540,1423,1374,60,1434,6
2021-11-26,Mendocino,045,87422,8047,7871,655,8526,89
2021-11-26,Merced,047,269075,43225,42921,2087,45008,664
2021-11-26,Modoc,049,8938,591,551,202,753,5
2021-11-26,Mono,051,14174,1872,1810,23,1833,4
2021-11-26,Monterey,053,433212,49657,48400,3164,51564,625
2021-11-26,Napa,055,140530,13331,13256,120,13376,104
2021-11-26,Nevada,057,99092,9768,9584,347,9931,103
2021-11-26,Orange,059,3164182,313911,310809,16006,326815,5665
2021-11-26,Placer,061,380077,38590,38001,3840,41841,468
2021-11-26,Plumas,063,18699,1938,1860,43,1903,7
2021-11-26,Riverside,065,2383286,373854,367601,16773,384374,5306
2021-11-26,Sacramento,067,1510023,163961,162328,4885,167213,2335
2021-11-26,San Benito,069,59416,7626,7575,181,7756,77
2021-11-26,San Bernardino,071,2135413,364825,360033,11644,371677,5932
2021-11-26,San Diego,073,3302833,385575,382634,22571,405205,4319
2021-11-26,San Francisco,075,870044,54617,53830,2435,56265,669
2021-11-26,San Joaquin,077,732212,102461,101368,5621,106989,1833
2021-11-26,San Luis Obispo,079,281455,30509,29983,1320,31303,358
2021-11-26,San Mateo,081,765935,55572,54360,951,55311,577
2021-11-26,Santa Barbara,083,443738,45791,45318,1608,46926,548
2021-11-26,Santa Clara,085,1922200,151562,149700,1531,151231,1922
2021-11-26,Santa Cruz,087,273765,21292,20929,1033,21962,222
2021-11-26,Shasta,089,179085,22443,22151,3707,25858,396
2021-11-26,Sierra,091,2930,196,194,21,215,0
2021-11-26,Siskiyou,093,43540,3441,3336,1342,4678,54
2021-11-26,Solano,095,438530,46995,46163,1346,47509,356
2021-11-26,Sonoma,097,501317,42832,42368,564,42932,405
2021-11-26,Stanislaus,099,539301,80816,80782,9206,89988,1220
2021-11-26,Sutter,101,95872,14196,14127,383,14510,181
2021-11-26,Tehama,103,63373,8785,8675,1538,10213,129
2021-11-26,Trinity,105,12862,895,789,227,1016,17
2021-11-26,Tulare,107,460477,70751,69377,16018,85395,1082
2021-11-26,Tuolumne,109,53932,7643,7574,112,7686,90
2021-11-26,Ventura,111,848112,100175,99163,4410,103573,1188
2021-11-26,Yolo,113,214977,20473,20237,1234,21471,257
2021-11-26,Yuba,115,75493,10432,10335,372,10707,88
2021-11-25,Alameda,001,1643700,122524,121618,2909,124527,1477
2021-11-25,Alpine,003,1148,105,106,0,106,0
2021-11-25,Amador,005,37829,5731,5670,70,5740,66
2021-11-25,Butte,007,227075,21713,21384,3923,25307,309
2021-11-25,Calaveras,009,45235,4365,4294,60,4354,85
2021-11-25,Colusa,011,21464,2607,2568,666,3234,19
2021-11-25,Contra Costa,013,1133247,101770,100961,2313,103274,1045
2021-11-25,Del Norte,015,27424,3755,3661,56,3717,42
2021-11-25,El Dorado,017,186661,16690,16399,1788,18187,161
2021-11-25,Fresno,019,978130,145362,143386,13216,156602,2246
2021-11-25,Glenn,021,27897,3579,3532,1033,4565,36
2021-11-25,Humboldt,023,135768,9539,9399,650,10049,115
2021-11-25,Imperial,025,180216,35148,34611,3523,38134,769
2021-11-25,Inyo,027,18085,2542,2506,42,2548,45
2021-11-25,Kern,029,883053,132125,130245,23753,153998,1773
2021-11-25,Kings,031,150075,33339,32891,2039,34930,358
2021-11-25,Lake,033,64148,6910,6836,156,6992,110
2021-11-25,Lassen,035,31185,7042,6959,412,7371,47
2021-11-25,Los Angeles,037,10098052,1466031,1454495,55838,1510333,26817
2021-11-25,Madera,039,155013,24214,23880,2283,26163,296
2021-11-25,Marin,041,260295,18051,17857,498,18355,248
2021-11-25,Mariposa,043,17540,1420,1374,60,1434,6
2021-11-25,Mendocino,045,87422,8029,7871,655,8526,89
2021-11-25,Merced,047,269075,43186,42921,2081,45002,664
2021-11-25,Modoc,049,8938,590,551,202,753,5
2021-11-25,Mono,051,14174,1861,1810,23,1833,4
2021-11-25,Monterey,053,433212,49613,48400,3155,51555,625
2021-11-25,Napa,055,140530,13323,13256,120,13376,104
2021-11-25,Nevada,057,99092,9749,9584,344,9928,103
2021-11-25,Orange,059,3164182,313649,310809,15974,326783,5665
2021-11-25,Placer,061,380077,38544,38001,3834,41835,468
2021-11-25,Plumas,063,18699,1936,1860,43,1903,7
2021-11-25,Riverside,065,2383286,373439,367601,16766,384367,5306
2021-11-25,Sacramento,067,1510023,163782,162328,4879,167207,2335
2021-11-25,San Benito,069,59416,7619,7575,181,7756,77
2021-11-25,San Bernardino,071,2135413,364431,360033,11627,371660,5932
2021-11-25,San Diego,073,3302833,385134,382634,22552,405186,4319
2021-11-25,San Francisco,075,870044,54567,53830,2432,56262,669
2021-11-25,San Joaquin,077,732212,102378,101368,5617,106985,1833
2021-11-25,San Luis Obispo,079,281455,30479,29983,1318,31301,358
2021-11-25,San Mateo,081,765935,55523,54360,949,55309,577
2021-11-25,Santa Barbara,083,443738,45752,45318,1606,46924,548
2021-11-25,Santa Clara,085,1922200,151405,149700,1526,151226,1922
2021-11-25,Santa Cruz,087,273765,21259,20929,1033,21962,222
2021-11-25,Shasta,089,179085,22417,22151,3707,25858,396
2021-11-25,Sierra,091,2930,196,194,21,215,0
2021-11-25,Siskiyou,093,43540,3438,3336,1342,4678,54
2021-11-25,Solano,095,438530,46958,46163,1345,47508,356
2021-11-25,Sonoma,097,501317,42775,42368,560,42928,405
2021-11-25,Stanislaus,099,539301,80751,80782,9192,89974,1220
2021-11-25,Sutter,101,95872,14180,14127,382,14509,181
2021-11-25,Tehama,103,63373,8777,8675,1538,10213,129
2021-11-25,Trinity,105,12862,895,789,227,1016,17
2021-11-25,Tulare,107,460477,70683,69377,15991,85368,1082
2021-11-25,Tuolumne,109,53932,7631,7574,112,7686,90
2021-11-25,Ventura,111,848112,100109,99163,4407,103570,1188
2021-11-25,Yolo,113,214977,20443,20237,1229,21466,257
2021-11-25,Yuba,115,75493,10423,10335,371,10706,88
2021-11-24,Alameda,001,1643700,122460,121618,2905,124523,1477
2021-11-24,Alpine,003,1148,105,106,0,106,0
2021-11-24,Amador,005,37829,5721,5670,70,5740,66
2021-11-24,Butte,007,227075,21697,21384,3922,25306,309
2021-11-24,Calaveras,009,45235,4358,4294,60,4354,85
2021-11-24,Colusa,011,21464,2607,2568,665,3233,19
2021-11-24,Contra Costa,013,1133247,101732,100961,2310,103271,1045
2021-11-24,Del Norte,015,27424,3752,3661,56,3717,42
2021-11-24,El Dorado,017,186661,16679,16399,1787,18186,161
2021-11-24,Fresno,019,978130,145307,143386,13215,156601,2246
2021-11-24,Glenn,021,27897,3574,3532,1032,4564,36
2021-11-24,Humboldt,023,135768,9524,9399,650,10049,115
2021-11-24,Imperial,025,180216,35119,34611,3517,38128,769
2021-11-24,Inyo,027,18085,2539,2506,42,2548,45
2021-11-24,Kern,029,883053,132063,130245,23741,153986,1773
2021-11-24,Kings,031,150075,33325,32891,2038,34929,358
2021-11-24,Lake,033,64148,6906,6836,156,6992,110
2021-11-24,Lassen,035,31185,7042,6959,412,7371,47
2021-11-24,Los Angeles,037,10098052,1465545,1454495,55795,1510290,26817
2021-11-24,Madera,039,155013,24191,23880,2277,26157,296
2021-11-24,Marin,041,260295,18039,17857,496,18353,248
2021-11-24,Mariposa,043,17540,1420,1374,60,1434,6
2021-11-24,Mendocino,045,87422,8017,7871,655,8526,89
2021-11-24,Merced,047,269075,43154,42921,2078,44999,664
2021-11-24,Modoc,049,8938,590,551,202,753,5
2021-11-24,Mono,051,14174,1858,1810,23,1833,4
2021-11-24,Monterey,053,433212,49600,48400,3153,51553,625
2021-11-24,Napa,055,140530,13319,13256,120,13376,104
2021-11-24,Nevada,057,99092,9734,9584,344,9928,103
2021-11-24,Orange,059,3164182,313494,310809,15959,326768,5665
2021-11-24,Placer,061,380077,38511,38001,3832,41833,468
2021-11-24,Plumas,063,18699,1934,1860,43,1903,7
2021-11-24,Riverside,065,2383286,373259,367601,16760,384361,5306
2021-11-24,Sacramento,067,1510023,163710,162328,4879,167207,2335
2021-11-24,San Benito,069,59416,7617,7575,181,7756,77
2021-11-24,San Bernardino,071,2135413,364219,360033,11617,371650,5932
2021-11-24,San Diego,073,3302833,384876,382634,22539,405173,4319
2021-11-24,San Francisco,075,870044,54536,53830,2430,56260,669
2021-11-24,San Joaquin,077,732212,102337,101368,5614,106982,1833
2021-11-24,San Luis Obispo,079,281455,30460,29983,1318,31301,358
2021-11-24,San Mateo,081,765935,55493,54360,948,55308,577
2021-11-24,Santa Barbara,083,443738,45725,45318,1606,46924,548
2021-11-24,Santa Clara,085,1922200,151309,149700,1525,151225,1922
2021-11-24,Santa Cruz,087,273765,21236,20929,1032,21961,222
2021-11-24,Shasta,089,179085,22406,22151,3704,25855,396
2021-11-24,Sierra,091,2930,196,194,21,215,0
2021-11-24,Siskiyou,093,43540,3435,3336,1342,4678,54
2021-11-24,Solano,095,438530,46930,46163,1343,47506,356
2021-11-24,Sonoma,097,501317,42743,42368,558,42926,405
2021-11-24,Stanislaus,099,539301,80714,80782,9187,89969,1220
2021-11-24,Sutter,101,95872,14167,14127,380,14507,181
2021-11-24,Tehama,103,63373,8774,8675,1537,10212,129
2021-11-24,Trinity,105,12862,895,789,227,1016,17
2021-11-24,Tulare,107,460477,70659,69377,15972,85349,1082
2021-11-24,Tuolumne,109,53932,7627,7574,112,7686,90
2021-11-24,Ventura,111,848112,100074,99163,4403,103566,1188
2021-11-24,Yolo,113,214977,20435,20237,1228,21465,257
2021-11-24,Yuba,115,75493,10419,10335,370,10705,88
2021-11-23,Alameda,001,1643700,122341,121618,2898,124516,1477
2021-11-23,Alpine,003,1148,105,106,0,106,0
2021-11-23,Amador,005,37829,5714,5670,70,5740,66
2021-11-23,Butte,007,227075,21668,21384,3918,25302,309
2021-11-23,Calaveras,009,45235,4352,4294,59,4353,85
2021-11-23,Colusa,011,21464,2603,2568,663,3231,19
2021-11-23,Contra Costa,013,1133247,101625,100961,2308,103269,1045
2021-11-23,Del Norte,015,27424,3749,3661,56,3717,42
2021-11-23,El Dorado,017,186661,16647,16399,1784,18183,161
2021-11-23,Fresno,019,978130,145169,143386,13206,156592,2246
2021-11-23,Glenn,021,27897,3569,3532,1032,4564,36
2021-11-23,Humboldt,023,135768,9502,9399,647,10046,115
2021-11-23,Imperial,025,180216,35050,34611,3498,38109,769
2021-11-23,Inyo,027,18085,2535,2506,42,2548,45
2021-11-23,Kern,029,883053,131954,130245,23692,153937,1773
2021-11-23,Kings,031,150075,33283,32891,2037,34928,358
2021-11-23,Lake,033,64148,6901,6836,156,6992,110
2021-11-23,Lassen,035,31185,7039,6959,409,7368,47
2021-11-23,Los Angeles,037,10098052,1464530,1454495,55727,1510222,26817
2021-11-23,Madera,039,155013,24165,23880,2275,26155,296
2021-11-23,Marin,041,260295,18008,17857,493,18350,248
2021-11-23,Mariposa,043,17540,1417,1374,60,1434,6
2021-11-23,Mendocino,045,87422,7996,7871,652,8523,89
2021-11-23,Merced,047,269075,43116,42921,2077,44998,664
2021-11-23,Modoc,049,8938,588,551,202,753,5
2021-11-23,Mono,051,14174,1844,1810,23,1833,4
2021-11-23,Monterey,053,433212,49564,48400,3147,51547,625
2021-11-23,Napa,055,140530,13310,13256,120,13376,104
2021-11-23,Nevada,057,99092,9705,9584,343,9927,103
2021-11-23,Orange,059,3164182,313244,310809,15923,326732,5665
2021-11-23,Placer,061,380077,38452,38001,3815,41816,468
2021-11-23,Plumas,063,18699,1930,1860,43,1903,7
2021-11-23,Riverside,065,2383286,372876,367601,16747,384348,5306
2021-11-23,Sacramento,067,1510023,163524,162328,4868,167196,2335
2021-11-23,San Benito,069,59416,7608,7575,179,7754,77
2021-11-23,San Bernardino,071,2135413,363802,360033,11602,371635,5932
2021-11-23,San Diego,073,3302833,384393,382634,22516,405150,4319
2021-11-23,San Francisco,075,870044,54477,53830,2427,56257,669
2021-11-23,San Joaquin,077,732212,102228,101368,5603,106971,1833
2021-11-23,San Luis Obispo,079,281455,30425,29983,1315,31298,358
2021-11-23,San Mateo,081,765935,55444,54360,947,55307,577
2021-11-23,Santa Barbara,083,443738,45672,45318,1606,46924,548
2021-11-23,Santa Clara,085,1922200,151098,149700,1513,151213,1922
2021-11-23,Santa Cruz,087,273765,21198,20929,1032,21961,222
2021-11-23,Shasta,089,179085,22370,22151,3702,25853,396
2021-11-23,Sierra,091,2930,196,194,21,215,0
2021-11-23,Siskiyou,093,43540,3430,3336,1341,4677,54
2021-11-23,Solano,095,438530,46876,46163,1339,47502,356
2021-11-23,Sonoma,097,501317,42692,42368,555,42923,405
2021-11-23,Stanislaus,099,539301,80645,80782,9174,89956,1220
2021-11-23,Sutter,101,95872,14151,14127,379,14506,181
2021-11-23,Tehama,103,63373,8761,8675,1536,10211,129
2021-11-23,Trinity,105,12862,894,789,227,1016,17
2021-11-23,Tulare,107,460477,70612,69377,15942,85319,1082
2021-11-23,Tuolumne,109,53932,7615,7574,111,7685,90
2021-11-23,Ventura,111,848112,99991,99163,4397,103560,1188
2021-11-23,Yolo,113,214977,20414,20237,1220,21457,257
2021-11-23,Yuba,115,75493,10407,10335,370,10705,88
2021-11-22,Alameda,001,1643700,122228,121566,2896,124462,1475
2021-11-22,Alpine,003,1148,105,106,0,106,0
2021-11-22,Amador,005,37829,5701,5670,70,5740,66
2021-11-22,Butte,007,227075,21630,21363,3912,25275,305
2021-11-22,Calaveras,009,45235,4340,4294,59,4353,84
2021-11-22,Colusa,011,21464,2600,2565,663,3228,19
2021-11-22,Contra Costa,013,1133247,101537,100877,2303,103180,1045
2021-11-22,Del Norte,015,27424,3746,3659,56,3715,42
2021-11-22,El Dorado,017,186661,16624,16378,1781,18159,161
2021-11-22,Fresno,019,978130,145036,143290,13198,156488,2243
2021-11-22,Glenn,021,27897,3564,3530,1031,4561,36
2021-11-22,Humboldt,023,135768,9476,9389,642,10031,115
2021-11-22,Imperial,025,180216,34989,34562,3484,38046,766
2021-11-22,Inyo,027,18085,2529,2501,42,2543,44
2021-11-22,Kern,029,883053,131793,130091,23641,153732,1762
2021-11-22,Kings,031,150075,33246,32867,2032,34899,358
2021-11-22,Lake,033,64148,6896,6837,156,6993,110
2021-11-22,Lassen,035,31185,7037,6954,408,7362,47
2021-11-22,Los Angeles,037,10098052,1463467,1453945,55644,1509589,26800
2021-11-22,Madera,039,155013,24131,23872,2267,26139,296
2021-11-22,Marin,041,260295,17977,17842,491,18333,248
2021-11-22,Mariposa,043,17540,1413,1372,60,1432,6
2021-11-22,Mendocino,045,87422,7980,7859,651,8510,89
2021-11-22,Merced,047,269075,43065,42898,2066,44964,660
2021-11-22,Modoc,049,8938,587,551,202,753,5
2021-11-22,Mono,051,14174,1837,1809,23,1832,4
2021-11-22,Monterey,053,433212,49536,48374,3143,51517,611
2021-11-22,Napa,055,140530,13302,13255,119,13374,104
2021-11-22,Nevada,057,99092,9688,9575,341,9916,96
2021-11-22,Orange,059,3164182,313003,310654,15897,326551,5663
2021-11-22,Placer,061,380077,38407,37956,3807,41763,465
2021-11-22,Plumas,063,18699,1927,1858,43,1901,7
2021-11-22,Riverside,065,2383286,372439,367301,16738,384039,5283
2021-11-22,Sacramento,067,1510023,163332,162222,4859,167081,2328
2021-11-22,San Benito,069,59416,7588,7567,179,7746,77
2021-11-22,San Bernardino,071,2135413,363388,359851,11592,371443,5916
2021-11-22,San Diego,073,3302833,383899,382132,22492,404624,4317
2021-11-22,San Francisco,075,870044,54385,53778,2421,56199,669
2021-11-22,San Joaquin,077,732212,102103,101299,5598,106897,1833
2021-11-22,San Luis Obispo,079,281455,30399,29963,1312,31275,358
2021-11-22,San Mateo,081,765935,55387,54330,945,55275,577
2021-11-22,Santa Barbara,083,443738,45596,45279,1606,46885,546
2021-11-22,Santa Clara,085,1922200,150914,149541,1503,151044,1919
2021-11-22,Santa Cruz,087,273765,21157,20891,1032,21923,222
2021-11-22,Shasta,089,179085,22356,22116,3697,25813,393
2021-11-22,Sierra,091,2930,196,193,21,214,0
2021-11-22,Siskiyou,093,43540,3425,3336,1339,4675,54
2021-11-22,Solano,095,438530,46827,46153,1337,47490,356
2021-11-22,Sonoma,097,501317,42631,42344,554,42898,404
2021-11-22,Stanislaus,099,539301,80557,80718,9164,89882,1209
2021-11-22,Sutter,101,95872,14135,14125,377,14502,181
2021-11-22,Tehama,103,63373,8754,8669,1531,10200,127
2021-11-22,Trinity,105,12862,893,785,227,1012,17
2021-11-22,Tulare,107,460477,70550,69314,15905,85219,1075
2021-11-22,Tuolumne,109,53932,7600,7567,111,7678,90
2021-11-22,Ventura,111,848112,99925,99114,4394,103508,1186
2021-11-22,Yolo,113,214977,20391,20227,1218,21445,257
2021-11-22,Yuba,115,75493,10398,10332,369,10701,88
2021-11-21,Alameda,001,1643700,122096,121443,2892,124335,1475
2021-11-21,Alpine,003,1148,103,106,0,106,0
2021-11-21,Amador,005,37829,5696,5662,69,5731,66
2021-11-21,Butte,007,227075,21588,21342,3907,25249,306
2021-11-21,Calaveras,009,45235,4331,4287,59,4346,84
2021-11-21,Colusa,011,21464,2596,2562,662,3224,19
2021-11-21,Contra Costa,013,1133247,101435,100807,2297,103104,1045
2021-11-21,Del Norte,015,27424,3742,3659,56,3715,42
2021-11-21,El Dorado,017,186661,16597,16370,1775,18145,161
2021-11-21,Fresno,019,978130,144864,143203,13178,156381,2242
2021-11-21,Glenn,021,27897,3560,3529,1031,4560,36
2021-11-21,Humboldt,023,135768,9453,9378,641,10019,115
2021-11-21,Imperial,025,180216,34901,34527,3474,38001,766
2021-11-21,Inyo,027,18085,2522,2501,42,2543,44
2021-11-21,Kern,029,883053,131630,130020,23595,153615,1762
2021-11-21,Kings,031,150075,33208,32843,2028,34871,356
2021-11-21,Lake,033,64148,6889,6834,156,6990,110
2021-11-21,Lassen,035,31185,7028,6953,408,7361,47
2021-11-21,Los Angeles,037,10098052,1462397,1453181,55588,1508769,26793
2021-11-21,Madera,039,155013,24106,23856,2262,26118,296
2021-11-21,Marin,041,260295,17948,17829,488,18317,248
2021-11-21,Mariposa,043,17540,1412,1371,59,1430,6
2021-11-21,Mendocino,045,87422,7974,7846,648,8494,89
2021-11-21,Merced,047,269075,43010,42881,2062,44943,660
2021-11-21,Modoc,049,8938,583,551,202,753,5
2021-11-21,Mono,051,14174,1827,1799,22,1821,4
2021-11-21,Monterey,053,433212,49490,48358,3134,51492,611
2021-11-21,Napa,055,140530,13289,13250,119,13369,104
2021-11-21,Nevada,057,99092,9662,9556,340,9896,96
2021-11-21,Orange,059,3164182,312746,310477,15865,326342,5663
2021-11-21,Placer,061,380077,38325,37929,3806,41735,465
2021-11-21,Plumas,063,18699,1922,1858,43,1901,7
2021-11-21,Riverside,065,2383286,371947,367093,16730,383823,5283
2021-11-21,Sacramento,067,1510023,163115,162087,4849,166936,2327
2021-11-21,San Benito,069,59416,7574,7563,178,7741,77
2021-11-21,San Bernardino,071,2135413,362896,359621,11555,371176,5912
2021-11-21,San Diego,073,3302833,383368,380747,22467,403214,4317
2021-11-21,San Francisco,075,870044,54316,53741,2416,56157,669
2021-11-21,San Joaquin,077,732212,101997,101264,5585,106849,1833
2021-11-21,San Luis Obispo,079,281455,30361,29948,1312,31260,358
2021-11-21,San Mateo,081,765935,55335,54290,943,55233,577
2021-11-21,Santa Barbara,083,443738,45535,45237,1603,46840,546
2021-11-21,Santa Clara,085,1922200,150709,149387,1483,150870,1918
2021-11-21,Santa Cruz,087,273765,21113,20866,1030,21896,222
2021-11-21,Shasta,089,179085,22326,22112,3695,25807,393
2021-11-21,Sierra,091,2930,196,193,21,214,0
2021-11-21,Siskiyou,093,43540,3420,3333,1338,4671,54
2021-11-21,Solano,095,438530,46771,46122,1330,47452,356
2021-11-21,Sonoma,097,501317,42571,42298,553,42851,404
2021-11-21,Stanislaus,099,539301,80462,80687,9149,89836,1209
2021-11-21,Sutter,101,95872,14121,14111,377,14488,181
2021-11-21,Tehama,103,63373,8748,8669,1530,10199,127
2021-11-21,Trinity,105,12862,891,784,225,1009,17
2021-11-21,Tulare,107,460477,70466,69285,15866,85151,1075
2021-11-21,Tuolumne,109,53932,7592,7560,110,7670,90
2021-11-21,Ventura,111,848112,99834,99081,4390,103471,1186
2021-11-21,Yolo,113,214977,20363,20209,1215,21424,257
2021-11-21,Yuba,115,75493,10389,10326,369,10695,88
2021-11-20,Alameda,001,1643700,122003,121059,2885,123944,1473
2021-11-20,Alpine,003,1148,103,105,0,105,0
2021-11-20,Amador,005,37829,5690,5652,68,5720,66
2021-11-20,Butte,007,227075,21573,21265,3903,25168,300
2021-11-20,Calaveras,009,45235,4321,4268,59,4327,84
2021-11-20,Colusa,011,21464,2595,2549,661,3210,19
2021-11-20,Contra Costa,013,1133247,101358,100491,2293,102784,1043
2021-11-20,Del Norte,015,27424,3739,3637,56,3693,42
2021-11-20,El Dorado,017,186661,16576,16308,1773,18081,161
2021-11-20,Fresno,019,978130,144794,142579,13169,155748,2233
2021-11-20,Glenn,021,27897,3559,3526,1030,4556,35
2021-11-20,Humboldt,023,135768,9440,9302,639,9941,115
2021-11-20,Imperial,025,180216,34849,34312,3468,37780,766
2021-11-20,Inyo,027,18085,2521,2467,42,2509,44
2021-11-20,Kern,029,883053,131529,129488,23558,153046,1750
2021-11-20,Kings,031,150075,33198,32720,2028,34748,354
2021-11-20,Lake,033,64148,6886,6808,156,6964,110
2021-11-20,Lassen,035,31185,7027,6931,408,7339,47
2021-11-20,Los Angeles,037,10098052,1461777,1448963,55540,1504503,26741
2021-11-20,Madera,039,155013,24092,23720,2258,25978,296
2021-11-20,Marin,041,260295,17933,17774,488,18262,248
2021-11-20,Mariposa,043,17540,1411,1354,59,1413,6
2021-11-20,Mendocino,045,87422,7966,7773,648,8421,89
2021-11-20,Merced,047,269075,42984,42692,2062,44754,656
2021-11-20,Modoc,049,8938,582,550,202,752,5
2021-11-20,Mono,051,14174,1821,1767,22,1789,4
2021-11-20,Monterey,053,433212,49477,48260,3126,51386,609
2021-11-20,Napa,055,140530,13286,13184,119,13303,103
2021-11-20,Nevada,057,99092,9646,9480,340,9820,92
2021-11-20,Orange,059,3164182,312547,309672,15848,325520,5658
2021-11-20,Placer,061,380077,38285,37800,3801,41601,462
2021-11-20,Plumas,063,18699,1918,1841,43,1884,7
2021-11-20,Riverside,065,2383286,371674,365809,16718,382527,5265
2021-11-20,Sacramento,067,1510023,163011,161533,4845,166378,2316
2021-11-20,San Benito,069,59416,7570,7533,178,7711,77
2021-11-20,San Bernardino,071,2135413,362622,358322,11544,369866,5897
2021-11-20,San Diego,073,3302833,383043,380147,22441,402588,4311
2021-11-20,San Francisco,075,870044,54277,53525,2415,55940,669
2021-11-20,San Joaquin,077,732212,101947,100922,5580,106502,1832
2021-11-20,San Luis Obispo,079,281455,30347,29815,1311,31126,355
2021-11-20,San Mateo,081,765935,55301,54132,942,55074,577
2021-11-20,Santa Barbara,083,443738,45503,45074,1603,46677,544
2021-11-20,Santa Clara,085,1922200,150602,148829,1482,150311,1917
2021-11-20,Santa Cruz,087,273765,21095,20756,1030,21786,222
2021-11-20,Shasta,089,179085,22302,21968,3694,25662,383
2021-11-20,Sierra,091,2930,196,191,21,212,0
2021-11-20,Siskiyou,093,43540,3417,3313,1338,4651,54
2021-11-20,Solano,095,438530,46750,46006,1330,47336,356
2021-11-20,Sonoma,097,501317,42540,42151,553,42704,403
2021-11-20,Stanislaus,099,539301,80416,80412,9145,89557,1205
2021-11-20,Sutter,101,95872,14113,14074,377,14451,181
2021-11-20,Tehama,103,63373,8743,8648,1530,10178,125
2021-11-20,Trinity,105,12862,887,771,225,996,17
2021-11-20,Tulare,107,460477,70427,69074,15845,84919,1054
2021-11-20,Tuolumne,109,53932,7584,7511,110,7621,90
2021-11-20,Ventura,111,848112,99785,98893,4383,103276,1186
2021-11-20,Yolo,113,214977,20355,20139,1211,21350,257
2021-11-20,Yuba,115,75493,10383,10290,368,10658,88
2021-11-19,Alameda,001,1643700,121927,121059,2882,123941,1473
2021-11-19,Alpine,003,1148,103,105,0,105,0
2021-11-19,Amador,005,37829,5680,5652,68,5720,66
2021-11-19,Butte,007,227075,21550,21265,3897,25162,300
2021-11-19,Calaveras,009,45235,4314,4268,59,4327,84
2021-11-19,Colusa,011,21464,2593,2549,660,3209,19
2021-11-19,Contra Costa,013,1133247,101301,100491,2288,102779,1043
2021-11-19,Del Norte,015,27424,3734,3637,56,3693,42
2021-11-19,El Dorado,017,186661,16554,16308,1771,18079,161
2021-11-19,Fresno,019,978130,144676,142579,13160,155739,2233
2021-11-19,Glenn,021,27897,3558,3526,1029,4555,35
2021-11-19,Humboldt,023,135768,9427,9302,636,9938,115
2021-11-19,Imperial,025,180216,34812,34312,3461,37773,766
2021-11-19,Inyo,027,18085,2517,2467,42,2509,44
2021-11-19,Kern,029,883053,131426,129488,23515,153003,1750
2021-11-19,Kings,031,150075,33173,32720,2026,34746,354
2021-11-19,Lake,033,64148,6883,6808,156,6964,110
2021-11-19,Lassen,035,31185,7022,6931,407,7338,47
2021-11-19,Los Angeles,037,10098052,1461091,1448963,55486,1504449,26741
2021-11-19,Madera,039,155013,24071,23720,2253,25973,296
2021-11-19,Marin,041,260295,17915,17774,486,18260,248
2021-11-19,Mariposa,043,17540,1409,1354,59,1413,6
2021-11-19,Mendocino,045,87422,7946,7773,648,8421,89
2021-11-19,Merced,047,269075,42958,42692,2061,44753,656
2021-11-19,Modoc,049,8938,581,550,202,752,5
2021-11-19,Mono,051,14174,1810,1767,22,1789,4
2021-11-19,Monterey,053,433212,49455,48260,3126,51386,609
2021-11-19,Napa,055,140530,13276,13184,118,13302,103
2021-11-19,Nevada,057,99092,9633,9480,340,9820,92
2021-11-19,Orange,059,3164182,312393,309672,15823,325495,5658
2021-11-19,Placer,061,380077,38248,37800,3797,41597,462
2021-11-19,Plumas,063,18699,1914,1841,43,1884,7
2021-11-19,Riverside,065,2383286,371400,365809,16714,382523,5265
2021-11-19,Sacramento,067,1510023,162886,161533,4841,166374,2316
2021-11-19,San Benito,069,59416,7564,7533,176,7709,77
2021-11-19,San Bernardino,071,2135413,362300,358322,11535,369857,5897
2021-11-19,San Diego,073,3302833,382652,380147,22415,402562,4311
2021-11-19,San Francisco,075,870044,54239,53525,2415,55940,669
2021-11-19,San Joaquin,077,732212,101890,100922,5576,106498,1832
2021-11-19,San Luis Obispo,079,281455,30329,29815,1309,31124,355
2021-11-19,San Mateo,081,765935,55253,54132,938,55070,577
2021-11-19,Santa Barbara,083,443738,45466,45074,1603,46677,544
2021-11-19,Santa Clara,085,1922200,150453,148829,1479,150308,1917
2021-11-19,Santa Cruz,087,273765,21068,20756,1027,21783,222
2021-11-19,Shasta,089,179085,22290,21968,3693,25661,383
2021-11-19,Sierra,091,2930,196,191,21,212,0
2021-11-19,Siskiyou,093,43540,3414,3313,1338,4651,54
2021-11-19,Solano,095,438530,46720,46006,1326,47332,356
2021-11-19,Sonoma,097,501317,42507,42151,550,42701,403
2021-11-19,Stanislaus,099,539301,80359,80412,9135,89547,1205
2021-11-19,Sutter,101,95872,14111,14074,377,14451,181
2021-11-19,Tehama,103,63373,8740,8648,1530,10178,125
2021-11-19,Trinity,105,12862,885,771,225,996,17
2021-11-19,Tulare,107,460477,70386,69074,15817,84891,1054
2021-11-19,Tuolumne,109,53932,7573,7511,110,7621,90
2021-11-19,Ventura,111,848112,99720,98893,4379,103272,1186
2021-11-19,Yolo,113,214977,20344,20139,1209,21348,257
2021-11-19,Yuba,115,75493,10380,10290,368,10658,88
2021-11-18,Alameda,001,1643700,121802,121059,2875,123934,1473
2021-11-18,Alpine,003,1148,103,105,0,105,0
2021-11-18,Amador,005,37829,5678,5652,68,5720,66
2021-11-18,Butte,007,227075,21533,21265,3889,25154,300
2021-11-18,Calaveras,009,45235,4307,4268,58,4326,84
2021-11-18,Colusa,011,21464,2585,2549,660,3209,19
2021-11-18,Contra Costa,013,1133247,101199,100491,2280,102771,1043
2021-11-18,Del Norte,015,27424,3731,3637,56,3693,42
2021-11-18,El Dorado,017,186661,16535,16308,1768,18076,161
2021-11-18,Fresno,019,978130,144536,142579,13150,155729,2233
2021-11-18,Glenn,021,27897,3557,3526,1028,4554,35
2021-11-18,Humboldt,023,135768,9411,9302,631,9933,115
2021-11-18,Imperial,025,180216,34757,34312,3445,37757,766
2021-11-18,Inyo,027,18085,2509,2467,42,2509,44
2021-11-18,Kern,029,883053,131280,129488,23467,152955,1750
2021-11-18,Kings,031,150075,33136,32720,2023,34743,354
2021-11-18,Lake,033,64148,6878,6808,156,6964,110
2021-11-18,Lassen,035,31185,7019,6931,402,7333,47
2021-11-18,Los Angeles,037,10098052,1460100,1448963,55424,1504387,26741
2021-11-18,Madera,039,155013,24046,23720,2249,25969,296
2021-11-18,Marin,041,260295,17898,17774,482,18256,248
2021-11-18,Mariposa,043,17540,1406,1354,59,1413,6
2021-11-18,Mendocino,045,87422,7924,7773,639,8412,89
2021-11-18,Merced,047,269075,42901,42692,2059,44751,656
2021-11-18,Modoc,049,8938,569,550,202,752,5
2021-11-18,Mono,051,14174,1802,1767,22,1789,4
2021-11-18,Monterey,053,433212,49430,48260,3121,51381,609
2021-11-18,Napa,055,140530,13264,13184,117,13301,103
2021-11-18,Nevada,057,99092,9609,9480,340,9820,92
2021-11-18,Orange,059,3164182,312156,309672,15803,325475,5658
2021-11-18,Placer,061,380077,38205,37800,3786,41586,462
2021-11-18,Plumas,063,18699,1913,1841,43,1884,7
2021-11-18,Riverside,065,2383286,371027,365809,16701,382510,5265
2021-11-18,Sacramento,067,1510023,162658,161533,4826,166359,2316
2021-11-18,San Benito,069,59416,7554,7533,176,7709,77
2021-11-18,San Bernardino,071,2135413,361864,358322,11516,369838,5897
2021-11-18,San Diego,073,3302833,382154,380147,22399,402546,4311
2021-11-18,San Francisco,075,870044,54187,53525,2411,55936,669
2021-11-18,San Joaquin,077,732212,101797,100922,5567,106489,1832
2021-11-18,San Luis Obispo,079,281455,30299,29815,1308,31123,355
2021-11-18,San Mateo,081,765935,55194,54132,935,55067,577
2021-11-18,Santa Barbara,083,443738,45420,45074,1596,46670,544
2021-11-18,Santa Clara,085,1922200,150266,148829,1471,150300,1917
2021-11-18,Santa Cruz,087,273765,21017,20756,1026,21782,222
2021-11-18,Shasta,089,179085,22254,21968,3688,25656,383
2021-11-18,Sierra,091,2930,195,191,21,212,0
2021-11-18,Siskiyou,093,43540,3414,3313,1334,4647,54
2021-11-18,Solano,095,438530,46678,46006,1323,47329,356
2021-11-18,Sonoma,097,501317,42458,42151,548,42699,403
2021-11-18,Stanislaus,099,539301,80292,80412,9127,89539,1205
2021-11-18,Sutter,101,95872,14100,14074,376,14450,181
2021-11-18,Tehama,103,63373,8735,8648,1530,10178,125
2021-11-18,Trinity,105,12862,884,771,225,996,17
2021-11-18,Tulare,107,460477,70313,69074,15769,84843,1054
2021-11-18,Tuolumne,109,53932,7563,7511,110,7621,90
2021-11-18,Ventura,111,848112,99643,98893,4375,103268,1186
2021-11-18,Yolo,113,214977,20327,20139,1205,21344,257
2021-11-18,Yuba,115,75493,10374,10290,368,10658,88
2021-11-17,Alameda,001,1643700,121680,120913,2874,123787,1472
2021-11-17,Alpine,003,1148,103,105,0,105,0
2021-11-17,Amador,005,37829,5672,5646,68,5714,66
2021-11-17,Butte,007,227075,21507,21230,3886,25116,300
2021-11-17,Calaveras,009,45235,4300,4259,58,4317,84
2021-11-17,Colusa,011,21464,2582,2546,659,3205,19
2021-11-17,Contra Costa,013,1133247,101107,100387,2276,102663,1039
2021-11-17,Del Norte,015,27424,3728,3630,56,3686,42
2021-11-17,El Dorado,017,186661,16516,16269,1767,18036,161
2021-11-17,Fresno,019,978130,144353,142366,13137,155503,2230
2021-11-17,Glenn,021,27897,3555,3527,1027,4554,34
2021-11-17,Humboldt,023,135768,9400,9270,628,9898,115
2021-11-17,Imperial,025,180216,34701,34256,3423,37679,766
2021-11-17,Inyo,027,18085,2503,2457,42,2499,44
2021-11-17,Kern,029,883053,131107,129307,23425,152732,1743
2021-11-17,Kings,031,150075,33109,32669,2019,34688,352
2021-11-17,Lake,033,64148,6874,6795,155,6950,110
2021-11-17,Lassen,035,31185,7017,6918,402,7320,47
2021-11-17,Los Angeles,037,10098052,1459000,1447947,55358,1503305,26721
2021-11-17,Madera,039,155013,24013,23673,2247,25920,287
2021-11-17,Marin,041,260295,17878,17757,480,18237,248
2021-11-17,Mariposa,043,17540,1402,1353,59,1412,6
2021-11-17,Mendocino,045,87422,7916,7735,638,8373,89
2021-11-17,Merced,047,269075,42842,42612,2054,44666,654
2021-11-17,Modoc,049,8938,565,540,202,742,5
2021-11-17,Mono,051,14174,1798,1765,22,1787,5
2021-11-17,Monterey,053,433212,49382,48221,3110,51331,609
2021-11-17,Napa,055,140530,13240,13167,117,13284,103
2021-11-17,Nevada,057,99092,9596,9447,340,9787,92
2021-11-17,Orange,059,3164182,311909,309396,15769,325165,5651
2021-11-17,Placer,061,380077,38157,37725,3777,41502,460
2021-11-17,Plumas,063,18699,1908,1833,43,1876,7
2021-11-17,Riverside,065,2383286,370616,365406,16688,382094,5229
2021-11-17,Sacramento,067,1510023,162488,161269,4819,166088,2302
2021-11-17,San Benito,069,59416,7547,7524,176,7700,77
2021-11-17,San Bernardino,071,2135413,361496,357947,11499,369446,5893
2021-11-17,San Diego,073,3302833,381664,379769,22373,402142,4301
2021-11-17,San Francisco,075,870044,54132,53469,2408,55877,667
2021-11-17,San Joaquin,077,732212,101695,100764,5562,106326,1828
2021-11-17,San Luis Obispo,079,281455,30273,29731,1305,31036,354
2021-11-17,San Mateo,081,765935,55126,54092,932,55024,577
2021-11-17,Santa Barbara,083,443738,45382,45000,1596,46596,542
2021-11-17,Santa Clara,085,1922200,150102,148626,1463,150089,1915
2021-11-17,Santa Cruz,087,273765,20982,20700,1026,21726,222
2021-11-17,Shasta,089,179085,22221,21883,3686,25569,382
2021-11-17,Sierra,091,2930,194,189,21,210,0
2021-11-17,Siskiyou,093,43540,3410,3307,1331,4638,54
2021-11-17,Solano,095,438530,46645,45948,1322,47270,353
2021-11-17,Sonoma,097,501317,42412,42093,545,42638,403
2021-11-17,Stanislaus,099,539301,80203,80276,9117,89393,1199
2021-11-17,Sutter,101,95872,14086,14064,374,14438,181
2021-11-17,Tehama,103,63373,8725,8633,1527,10160,125
2021-11-17,Trinity,105,12862,883,765,225,990,17
2021-11-17,Tulare,107,460477,70241,68977,15742,84719,1047
2021-11-17,Tuolumne,109,53932,7546,7485,110,7595,90
2021-11-17,Ventura,111,848112,99581,98812,4369,103181,1183
2021-11-17,Yolo,113,214977,20308,20100,1201,21301,257
2021-11-17,Yuba,115,75493,10362,10275,364,10639,88
2021-11-16,Alameda,001,1643700,121570,120809,2870,123679,1467
2021-11-16,Alpine,003,1148,103,105,0,105,0
2021-11-16,Amador,005,37829,5666,5644,68,5712,66
2021-11-16,Butte,007,227075,21482,21208,3881,25089,297
2021-11-16,Calaveras,009,45235,4291,4249,58,4307,83
2021-11-16,Colusa,011,21464,2576,2538,659,3197,19
2021-11-16,Contra Costa,013,1133247,100986,100320,2273,102593,1038
2021-11-16,Del Norte,015,27424,3722,3630,56,3686,42
2021-11-16,El Dorado,017,186661,16491,16248,1765,18013,159
2021-11-16,Fresno,019,978130,144166,142200,13115,155315,2218
2021-11-16,Glenn,021,27897,3554,3527,1024,4551,34
2021-11-16,Humboldt,023,135768,9379,9252,624,9876,115
2021-11-16,Imperial,025,180216,34617,34177,3409,37586,766
2021-11-16,Inyo,027,18085,2496,2449,42,2491,42
2021-11-16,Kern,029,883053,130947,129136,23364,152500,1735
2021-11-16,Kings,031,150075,33056,32614,2012,34626,350
2021-11-16,Lake,033,64148,6869,6789,155,6944,110
2021-11-16,Lassen,035,31185,7007,6915,402,7317,47
2021-11-16,Los Angeles,037,10098052,1457828,1446815,55286,1502101,26703
2021-11-16,Madera,039,155013,23975,23642,2241,25883,287
2021-11-16,Marin,041,260295,17859,17736,479,18215,248
2021-11-16,Mariposa,043,17540,1394,1349,58,1407,6
2021-11-16,Mendocino,045,87422,7874,7723,634,8357,89
2021-11-16,Merced,047,269075,42805,42578,2047,44625,653
2021-11-16,Modoc,049,8938,564,539,201,740,5
2021-11-16,Mono,051,14174,1789,1767,22,1789,4
2021-11-16,Monterey,053,433212,49352,48195,3096,51291,609
2021-11-16,Napa,055,140530,13229,13151,117,13268,103
2021-11-16,Nevada,057,99092,9579,9435,339,9774,92
2021-11-16,Orange,059,3164182,311642,309170,15734,324904,5651
2021-11-16,Placer,061,380077,38115,37676,3771,41447,459
2021-11-16,Plumas,063,18699,1899,1832,43,1875,7
2021-11-16,Riverside,065,2383286,370194,365078,16666,381744,5208
2021-11-16,Sacramento,067,1510023,162308,161102,4807,165909,2299
2021-11-16,San Benito,069,59416,7533,7513,176,7689,77
2021-11-16,San Bernardino,071,2135413,361081,357528,11447,368975,5901
2021-11-16,San Diego,073,3302833,381112,379435,22346,401781,4287
2021-11-16,San Francisco,075,870044,54059,53415,2400,55815,667
2021-11-16,San Joaquin,077,732212,101555,100637,5546,106183,1807
2021-11-16,San Luis Obispo,079,281455,30241,29703,1302,31005,356
2021-11-16,San Mateo,081,765935,55064,54034,930,54964,577
2021-11-16,Santa Barbara,083,443738,45314,44932,1593,46525,539
2021-11-16,Santa Clara,085,1922200,149921,148452,1451,149903,1916
2021-11-16,Santa Cruz,087,273765,20937,20684,1024,21708,222
2021-11-16,Shasta,089,179085,22182,21853,3682,25535,379
2021-11-16,Sierra,091,2930,194,189,21,210,0
2021-11-16,Siskiyou,093,43540,3407,3304,1329,4633,54
2021-11-16,Solano,095,438530,46605,45908,1321,47229,351
2021-11-16,Sonoma,097,501317,42363,42056,544,42600,401
2021-11-16,Stanislaus,099,539301,80108,80214,9093,89307,1196
2021-11-16,Sutter,101,95872,14074,14058,373,14431,181
2021-11-16,Tehama,103,63373,8718,8621,1520,10141,125
2021-11-16,Trinity,105,12862,883,762,224,986,17
2021-11-16,Tulare,107,460477,70161,68881,15705,84586,1039
2021-11-16,Tuolumne,109,53932,7536,7478,110,7588,90
2021-11-16,Ventura,111,848112,99506,98731,4366,103097,1183
2021-11-16,Yolo,113,214977,20269,20077,1199,21276,257
2021-11-16,Yuba,115,75493,10354,10262,362,10624,85
2021-11-15,Alameda,001,1643700,121414,120731,2865,123596,1464
2021-11-15,Alpine,003,1148,103,105,0,105,0
2021-11-15,Amador,005,37829,5661,5637,68,5705,66
2021-11-15,Butte,007,227075,21457,21182,3877,25059,296
2021-11-15,Calaveras,009,45235,4277,4237,58,4295,83
2021-11-15,Colusa,011,21464,2569,2535,656,3191,19
2021-11-15,Contra Costa,013,1133247,100879,100251,2270,102521,1038
2021-11-15,Del Norte,015,27424,3717,3630,55,3685,42
2021-11-15,El Dorado,017,186661,16467,16236,1761,17997,159
2021-11-15,Fresno,019,978130,143943,142015,13093,155108,2210
2021-11-15,Glenn,021,27897,3552,3526,1024,4550,34
2021-11-15,Humboldt,023,135768,9356,9230,616,9846,115
2021-11-15,Imperial,025,180216,34544,34130,3393,37523,766
2021-11-15,Inyo,027,18085,2491,2442,42,2484,42
2021-11-15,Kern,029,883053,130738,128928,23293,152221,1730
2021-11-15,Kings,031,150075,33022,32584,2007,34591,348
2021-11-15,Lake,033,64148,6865,6784,155,6939,109
2021-11-15,Lassen,035,31185,6996,6915,400,7315,47
2021-11-15,Los Angeles,037,10098052,1456641,1446114,55223,1501337,26677
2021-11-15,Madera,039,155013,23937,23605,2230,25835,287
2021-11-15,Marin,041,260295,17842,17723,478,18201,248
2021-11-15,Mariposa,043,17540,1393,1347,56,1403,6
2021-11-15,Mendocino,045,87422,7854,7694,628,8322,89
2021-11-15,Merced,047,269075,42748,42552,2036,44588,648
2021-11-15,Modoc,049,8938,563,538,200,738,5
2021-11-15,Mono,051,14174,1784,1763,22,1785,4
2021-11-15,Monterey,053,433212,49320,48154,3090,51244,609
2021-11-15,Napa,055,140530,13221,13143,117,13260,103
2021-11-15,Nevada,057,99092,9550,9420,338,9758,92
2021-11-15,Orange,059,3164182,311365,308859,15709,324568,5646
2021-11-15,Placer,061,380077,38051,37610,3767,41377,452
2021-11-15,Plumas,063,18699,1892,1829,43,1872,7
2021-11-15,Riverside,065,2383286,369747,364750,16647,381397,5199
2021-11-15,Sacramento,067,1510023,162088,160937,4795,165732,2293
2021-11-15,San Benito,069,59416,7528,7511,175,7686,77
2021-11-15,San Bernardino,071,2135413,360662,357306,11427,368733,5898
2021-11-15,San Diego,073,3302833,380576,378845,22321,401166,4284
2021-11-15,San Francisco,075,870044,53991,53374,2397,55771,667
2021-11-15,San Joaquin,077,732212,101401,100587,5535,106122,1799
2021-11-15,San Luis Obispo,079,281455,30198,29669,1290,30959,351
2021-11-15,San Mateo,081,765935,55011,54010,928,54938,576
2021-11-15,Santa Barbara,083,443738,45258,44879,1587,46466,539
2021-11-15,Santa Clara,085,1922200,149704,148313,1444,149757,1914
2021-11-15,Santa Cruz,087,273765,20895,20630,1023,21653,223
2021-11-15,Shasta,089,179085,22137,21779,3677,25456,374
2021-11-15,Sierra,091,2930,194,189,21,210,0
2021-11-15,Siskiyou,093,43540,3400,3302,1327,4629,54
2021-11-15,Solano,095,438530,46566,45885,1316,47201,351
2021-11-15,Sonoma,097,501317,42312,42021,543,42564,401
2021-11-15,Stanislaus,099,539301,80023,80129,9079,89208,1174
2021-11-15,Sutter,101,95872,14061,14043,372,14415,181
2021-11-15,Tehama,103,63373,8712,8615,1519,10134,125
2021-11-15,Trinity,105,12862,881,757,222,979,17
2021-11-15,Tulare,107,460477,70074,68826,15659,84485,1039
2021-11-15,Tuolumne,109,53932,7525,7461,110,7571,90
2021-11-15,Ventura,111,848112,99422,98605,4361,102966,1183
2021-11-15,Yolo,113,214977,20239,20065,1194,21259,255
2021-11-15,Yuba,115,75493,10335,10254,358,10612,85
2021-11-14,Alameda,001,1643700,121239,120629,2861,123490,1461
2021-11-14,Alpine,003,1148,102,105,0,105,0
2021-11-14,Amador,005,37829,5654,5632,67,5699,66
2021-11-14,Butte,007,227075,21426,21146,3868,25014,296
2021-11-14,Calaveras,009,45235,4266,4222,58,4280,83
2021-11-14,Colusa,011,21464,2567,2532,653,3185,19
2021-11-14,Contra Costa,013,1133247,100771,100188,2268,102456,1038
2021-11-14,Del Norte,015,27424,3714,3629,55,3684,42
2021-11-14,El Dorado,017,186661,16425,16212,1756,17968,159
2021-11-14,Fresno,019,978130,143660,141869,13060,154929,2209
2021-11-14,Glenn,021,27897,3550,3521,1024,4545,34
2021-11-14,Humboldt,023,135768,9326,9215,606,9821,115
2021-11-14,Imperial,025,180216,34441,34078,3378,37456,766
2021-11-14,Inyo,027,18085,2479,2441,42,2483,42
2021-11-14,Kern,029,883053,130498,128842,23223,152065,1730
2021-11-14,Kings,031,150075,32965,32545,2000,34545,349
2021-11-14,Lake,033,64148,6857,6777,155,6932,109
2021-11-14,Lassen,035,31185,6986,6911,399,7310,47
2021-11-14,Los Angeles,037,10098052,1455277,1445284,55147,1500431,26667
2021-11-14,Madera,039,155013,23887,23566,2221,25787,287
2021-11-14,Marin,041,260295,17827,17712,478,18190,247
2021-11-14,Mariposa,043,17540,1383,1337,52,1389,6
2021-11-14,Mendocino,045,87422,7821,7684,623,8307,89
2021-11-14,Merced,047,269075,42658,42513,2030,44543,648
2021-11-14,Modoc,049,8938,561,538,200,738,5
2021-11-14,Mono,051,14174,1772,1760,22,1782,4
2021-11-14,Monterey,053,433212,49265,48135,3072,51207,609
2021-11-14,Napa,055,140530,13203,13132,117,13249,103
2021-11-14,Nevada,057,99092,9522,9408,338,9746,92
2021-11-14,Orange,059,3164182,311045,308699,15688,324387,5646
2021-11-14,Placer,061,380077,37971,37569,3757,41326,452
2021-11-14,Plumas,063,18699,1889,1829,42,1871,7
2021-11-14,Riverside,065,2383286,369249,364490,16630,381120,5199
2021-11-14,Sacramento,067,1510023,161851,160761,4778,165539,2295
2021-11-14,San Benito,069,59416,7517,7507,174,7681,77
2021-11-14,San Bernardino,071,2135413,360082,357014,11410,368424,5897
2021-11-14,San Diego,073,3302833,379980,377633,22290,399923,4280
2021-11-14,San Francisco,075,870044,53916,53338,2392,55730,667
2021-11-14,San Joaquin,077,732212,101273,100518,5530,106048,1799
2021-11-14,San Luis Obispo,079,281455,30116,29645,1286,30931,352
2021-11-14,San Mateo,081,765935,54958,53978,926,54904,576
2021-11-14,Santa Barbara,083,443738,45179,44842,1584,46426,539
2021-11-14,Santa Clara,085,1922200,149506,148152,1436,149588,1913
2021-11-14,Santa Cruz,087,273765,20841,20609,1021,21630,223
2021-11-14,Shasta,089,179085,22085,21771,3664,25435,373
2021-11-14,Sierra,091,2930,194,189,21,210,0
2021-11-14,Siskiyou,093,43540,3391,3302,1326,4628,54
2021-11-14,Solano,095,438530,46510,45860,1309,47169,351
2021-11-14,Sonoma,097,501317,42246,41974,541,42515,401
2021-11-14,Stanislaus,099,539301,79888,80076,9061,89137,1174
2021-11-14,Sutter,101,95872,14044,14031,367,14398,181
2021-11-14,Tehama,103,63373,8702,8607,1517,10124,125
2021-11-14,Trinity,105,12862,878,754,220,974,17
2021-11-14,Tulare,107,460477,69956,68772,15601,84373,1037
2021-11-14,Tuolumne,109,53932,7507,7439,109,7548,90
2021-11-14,Ventura,111,848112,99307,98550,4360,102910,1183
2021-11-14,Yolo,113,214977,20212,20040,1188,21228,255
2021-11-14,Yuba,115,75493,10328,10238,357,10595,85
2021-11-13,Alameda,001,1643700,121167,120407,2859,123266,1454
2021-11-13,Alpine,003,1148,102,105,0,105,0
2021-11-13,Amador,005,37829,5653,5614,67,5681,66
2021-11-13,Butte,007,227075,21406,21104,3865,24969,296
2021-11-13,Calaveras,009,45235,4255,4203,58,4261,83
2021-11-13,Colusa,011,21464,2565,2522,653,3175,19
2021-11-13,Contra Costa,013,1133247,100699,100004,2262,102266,1028
2021-11-13,Del Norte,015,27424,3714,3629,55,3684,42
2021-11-13,El Dorado,017,186661,16413,16163,1753,17916,159
2021-11-13,Fresno,019,978130,143553,141452,13046,154498,2205
2021-11-13,Glenn,021,27897,3550,3514,1023,4537,34
2021-11-13,Humboldt,023,135768,9310,9177,601,9778,115
2021-11-13,Imperial,025,180216,34391,33990,3361,37351,766
2021-11-13,Inyo,027,18085,2473,2436,42,2478,42
2021-11-13,Kern,029,883053,130396,128472,23179,151651,1719
2021-11-13,Kings,031,150075,32948,32452,1999,34451,347
2021-11-13,Lake,033,64148,6852,6769,155,6924,109
2021-11-13,Lassen,035,31185,6981,6897,399,7296,47
2021-11-13,Los Angeles,037,10098052,1454619,1443088,55106,1498194,26649
2021-11-13,Madera,039,155013,23856,23462,2216,25678,287
2021-11-13,Marin,041,260295,17814,17684,476,18160,247
2021-11-13,Mariposa,043,17540,1380,1323,52,1375,6
2021-11-13,Mendocino,045,87422,7802,7652,622,8274,89
2021-11-13,Merced,047,269075,42620,42411,2027,44438,644
2021-11-13,Modoc,049,8938,560,536,200,736,5
2021-11-13,Mono,051,14174,1768,1750,22,1772,4
2021-11-13,Monterey,053,433212,49239,48087,3070,51157,609
2021-11-13,Napa,055,140530,13195,13110,117,13227,103
2021-11-13,Nevada,057,99092,9502,9369,336,9705,92
2021-11-13,Orange,059,3164182,310879,308211,15660,323871,5641
2021-11-13,Placer,061,380077,37921,37453,3754,41207,445
2021-11-13,Plumas,063,18699,1886,1828,42,1870,8
2021-11-13,Riverside,065,2383286,368943,363801,16623,380424,5187
2021-11-13,Sacramento,067,1510023,161714,160397,4765,165162,2291
2021-11-13,San Benito,069,59416,7504,7491,173,7664,77
2021-11-13,San Bernardino,071,2135413,359830,356325,11403,367728,5873
2021-11-13,San Diego,073,3302833,379650,377633,22262,399895,4280
2021-11-13,San Francisco,075,870044,53884,53195,2391,55586,667
2021-11-13,San Joaquin,077,732212,101216,100263,5521,105784,1799
2021-11-13,San Luis Obispo,079,281455,30086,29589,1284,30873,351
2021-11-13,San Mateo,081,765935,54920,53853,925,54778,574
2021-11-13,Santa Barbara,083,443738,45146,44734,1584,46318,537
2021-11-13,Santa Clara,085,1922200,149386,147821,1431,149252,1905
2021-11-13,Santa Cruz,087,273765,20826,20565,1020,21585,223
2021-11-13,Shasta,089,179085,22054,21713,3660,25373,366
2021-11-13,Sierra,091,2930,193,188,21,209,0
2021-11-13,Siskiyou,093,43540,3382,3299,1325,4624,54
2021-11-13,Solano,095,438530,46481,45774,1305,47079,350
2021-11-13,Sonoma,097,501317,42212,41882,540,42422,399
2021-11-13,Stanislaus,099,539301,79813,79872,9047,88919,1174
2021-11-13,Sutter,101,95872,14034,14017,366,14383,181
2021-11-13,Tehama,103,63373,8696,8592,1513,10105,125
2021-11-13,Trinity,105,12862,877,749,220,969,17
2021-11-13,Tulare,107,460477,69890,68619,15578,84197,1033
2021-11-13,Tuolumne,109,53932,7489,7392,109,7501,90
2021-11-13,Ventura,111,848112,99249,98452,4357,102809,1183
2021-11-13,Yolo,113,214977,20198,20009,1183,21192,255
2021-11-13,Yuba,115,75493,10318,10218,355,10573,85
2021-11-12,Alameda,001,1643700,121084,120407,2856,123263,1454
2021-11-12,Alpine,003,1148,102,105,0,105,0
2021-11-12,Amador,005,37829,5649,5614,66,5680,66
2021-11-12,Butte,007,227075,21389,21104,3861,24965,296
2021-11-12,Calaveras,009,45235,4244,4203,58,4261,83
2021-11-12,Colusa,011,21464,2561,2522,652,3174,19
2021-11-12,Contra Costa,013,1133247,100644,100004,2261,102265,1028
2021-11-12,Del Norte,015,27424,3714,3629,55,3684,42
2021-11-12,El Dorado,017,186661,16394,16163,1752,17915,159
2021-11-12,Fresno,019,978130,143410,141452,13032,154484,2205
2021-11-12,Glenn,021,27897,3547,3514,1022,4536,34
2021-11-12,Humboldt,023,135768,9303,9177,599,9776,115
2021-11-12,Imperial,025,180216,34365,33990,3351,37341,766
2021-11-12,Inyo,027,18085,2469,2436,42,2478,42
2021-11-12,Kern,029,883053,130259,128472,23147,151619,1719
2021-11-12,Kings,031,150075,32922,32452,1997,34449,347
2021-11-12,Lake,033,64148,6848,6769,155,6924,109
2021-11-12,Lassen,035,31185,6977,6897,398,7295,47
2021-11-12,Los Angeles,037,10098052,1453892,1443088,55061,1498149,26649
2021-11-12,Madera,039,155013,23827,23462,2211,25673,287
2021-11-12,Marin,041,260295,17798,17684,475,18159,247
2021-11-12,Mariposa,043,17540,1373,1323,52,1375,6
2021-11-12,Mendocino,045,87422,7790,7652,619,8271,89
2021-11-12,Merced,047,269075,42591,42411,2025,44436,644
2021-11-12,Modoc,049,8938,559,536,200,736,5
2021-11-12,Mono,051,14174,1766,1750,22,1772,4
2021-11-12,Monterey,053,433212,49207,48087,3064,51151,609
2021-11-12,Napa,055,140530,13186,13110,117,13227,103
2021-11-12,Nevada,057,99092,9488,9369,335,9704,92
2021-11-12,Orange,059,3164182,310691,308211,15642,323853,5641
2021-11-12,Placer,061,380077,37882,37453,3751,41204,445
2021-11-12,Plumas,063,18699,1880,1828,42,1870,8
2021-11-12,Riverside,065,2383286,368676,363801,16619,380420,5187
2021-11-12,Sacramento,067,1510023,161555,160397,4760,165157,2291
2021-11-12,San Benito,069,59416,7504,7491,173,7664,77
2021-11-12,San Bernardino,071,2135413,359523,356325,11392,367717,5873
2021-11-12,San Diego,073,3302833,379285,377633,22240,399873,4280
2021-11-12,San Francisco,075,870044,53849,53195,2387,55582,667
2021-11-12,San Joaquin,077,732212,101171,100263,5515,105778,1799
2021-11-12,San Luis Obispo,079,281455,30057,29589,1283,30872,351
2021-11-12,San Mateo,081,765935,54870,53853,922,54775,574
2021-11-12,Santa Barbara,083,443738,45091,44734,1583,46317,537
2021-11-12,Santa Clara,085,1922200,149244,147821,1426,149247,1905
2021-11-12,Santa Cruz,087,273765,20798,20565,1018,21583,223
2021-11-12,Shasta,089,179085,22021,21713,3657,25370,366
2021-11-12,Sierra,091,2930,192,188,21,209,0
2021-11-12,Siskiyou,093,43540,3381,3299,1323,4622,54
2021-11-12,Solano,095,438530,46454,45774,1301,47075,350
2021-11-12,Sonoma,097,501317,42172,41882,540,42422,399
2021-11-12,Stanislaus,099,539301,79761,79872,9039,88911,1174
2021-11-12,Sutter,101,95872,14027,14017,366,14383,181
2021-11-12,Tehama,103,63373,8692,8592,1512,10104,125
2021-11-12,Trinity,105,12862,870,749,220,969,17
2021-11-12,Tulare,107,460477,69848,68619,15543,84162,1033
2021-11-12,Tuolumne,109,53932,7476,7392,108,7500,90
2021-11-12,Ventura,111,848112,99184,98452,4356,102808,1183
2021-11-12,Yolo,113,214977,20184,20009,1177,21186,255
2021-11-12,Yuba,115,75493,10309,10218,354,10572,85
2021-11-11,Alameda,001,1643700,120968,120147,2848,122995,1453
2021-11-11,Alpine,003,1148,102,105,0,105,0
2021-11-11,Amador,005,37829,5646,5603,65,5668,66
2021-11-11,Butte,007,227075,21346,21047,3855,24902,293
2021-11-11,Calaveras,009,45235,4226,4179,58,4237,83
2021-11-11,Colusa,011,21464,2553,2518,650,3168,19
2021-11-11,Contra Costa,013,1133247,100539,99808,2256,102064,1028
2021-11-11,Del Norte,015,27424,3712,3622,55,3677,42
2021-11-11,El Dorado,017,186661,16360,16085,1749,17834,159
2021-11-11,Fresno,019,978130,143205,140833,12998,153831,2202
2021-11-11,Glenn,021,27897,3545,3503,1022,4525,34
2021-11-11,Humboldt,023,135768,9280,9125,596,9721,115
2021-11-11,Imperial,025,180216,34296,33844,3329,37173,766
2021-11-11,Inyo,027,18085,2464,2428,42,2470,42
2021-11-11,Kern,029,883053,130074,128023,23083,151106,1709
2021-11-11,Kings,031,150075,32872,32318,1995,34313,345
2021-11-11,Lake,033,64148,6841,6745,155,6900,107
2021-11-11,Lassen,035,31185,6971,6875,398,7273,47
2021-11-11,Los Angeles,037,10098052,1452796,1440436,55002,1495438,26614
2021-11-11,Madera,039,155013,23779,23316,2203,25519,287
2021-11-11,Marin,041,260295,17788,17639,475,18114,247
2021-11-11,Mariposa,043,17540,1363,1317,52,1369,6
2021-11-11,Mendocino,045,87422,7775,7612,610,8222,89
2021-11-11,Merced,047,269075,42535,42292,2022,44314,643
2021-11-11,Modoc,049,8938,557,536,200,736,5
2021-11-11,Mono,051,14174,1762,1743,22,1765,4
2021-11-11,Monterey,053,433212,49172,48008,3052,51060,609
2021-11-11,Napa,055,140530,13178,13075,117,13192,103
2021-11-11,Nevada,057,99092,9466,9308,335,9643,92
2021-11-11,Orange,059,3164182,310417,307674,15604,323278,5633
2021-11-11,Placer,061,380077,37831,37333,3743,41076,440
2021-11-11,Plumas,063,18699,1876,1814,42,1856,7
2021-11-11,Riverside,065,2383286,368242,362930,16601,379531,5175
2021-11-11,Sacramento,067,1510023,161342,159962,4741,164703,2289
2021-11-11,San Benito,069,59416,7496,7473,173,7646,76
2021-11-11,San Bernardino,071,2135413,359094,355413,11379,366792,5849
2021-11-11,San Diego,073,3302833,378777,376428,22217,398645,4272
2021-11-11,San Francisco,075,870044,53790,53063,2385,55448,666
2021-11-11,San Joaquin,077,732212,101076,99937,5500,105437,1799
2021-11-11,San Luis Obispo,079,281455,30006,29532,1281,30813,351
2021-11-11,San Mateo,081,765935,54821,53722,917,54639,574
2021-11-11,Santa Barbara,083,443738,45033,44603,1580,46183,534
2021-11-11,Santa Clara,085,1922200,149062,147458,1420,148878,1901
2021-11-11,Santa Cruz,087,273765,20753,20479,1018,21497,222
2021-11-11,Shasta,089,179085,21974,21600,3655,25255,364
2021-11-11,Sierra,091,2930,191,186,21,207,0
2021-11-11,Siskiyou,093,43540,3375,3297,1322,4619,53
2021-11-11,Solano,095,438530,46417,45679,1300,46979,350
2021-11-11,Sonoma,097,501317,42135,41774,540,42314,395
2021-11-11,Stanislaus,099,539301,79679,79570,9023,88593,1166
2021-11-11,Sutter,101,95872,14013,13993,365,14358,181
2021-11-11,Tehama,103,63373,8680,8565,1510,10075,125
2021-11-11,Trinity,105,12862,869,748,220,968,17
2021-11-11,Tulare,107,460477,69755,68367,15507,83874,1028
2021-11-11,Tuolumne,109,53932,7463,7354,108,7462,90
2021-11-11,Ventura,111,848112,99106,98297,4349,102646,1182
2021-11-11,Yolo,113,214977,20157,19946,1175,21121,255
2021-11-11,Yuba,115,75493,10293,10191,354,10545,85
2021-11-10,Alameda,001,1643700,120859,120147,2838,122985,1453
2021-11-10,Alpine,003,1148,102,105,0,105,0
2021-11-10,Amador,005,37829,5640,5603,65,5668,66
2021-11-10,Butte,007,227075,21320,21047,3851,24898,293
2021-11-10,Calaveras,009,45235,4215,4179,58,4237,83
2021-11-10,Colusa,011,21464,2547,2518,650,3168,19
2021-11-10,Contra Costa,013,1133247,100456,99808,2252,102060,1028
2021-11-10,Del Norte,015,27424,3711,3622,55,3677,42
2021-11-10,El Dorado,017,186661,16344,16085,1748,17833,159
2021-11-10,Fresno,019,978130,143027,140833,12984,153817,2202
2021-11-10,Glenn,021,27897,3545,3503,1021,4524,34
2021-11-10,Humboldt,023,135768,9262,9125,596,9721,115
2021-11-10,Imperial,025,180216,34248,33844,3310,37154,766
2021-11-10,Inyo,027,18085,2457,2428,42,2470,42
2021-11-10,Kern,029,883053,129924,128023,23027,151050,1709
2021-11-10,Kings,031,150075,32839,32318,1993,34311,345
2021-11-10,Lake,033,64148,6831,6745,155,6900,107
2021-11-10,Lassen,035,31185,6966,6875,398,7273,47
2021-11-10,Los Angeles,037,10098052,1451844,1440436,54944,1495380,26614
2021-11-10,Madera,039,155013,23729,23316,2197,25513,287
2021-11-10,Marin,041,260295,17775,17639,473,18112,247
2021-11-10,Mariposa,043,17540,1357,1317,52,1369,6
2021-11-10,Mendocino,045,87422,7763,7612,609,8221,89
2021-11-10,Merced,047,269075,42500,42292,2020,44312,643
2021-11-10,Modoc,049,8938,556,536,199,735,5
2021-11-10,Mono,051,14174,1760,1743,22,1765,4
2021-11-10,Monterey,053,433212,49138,48008,3041,51049,609
2021-11-10,Napa,055,140530,13164,13075,116,13191,103
2021-11-10,Nevada,057,99092,9459,9308,333,9641,92
2021-11-10,Orange,059,3164182,310154,307674,15572,323246,5633
2021-11-10,Placer,061,380077,37785,37333,3736,41069,440
2021-11-10,Plumas,063,18699,1870,1814,41,1855,7
2021-11-10,Riverside,065,2383286,367861,362930,16595,379525,5175
2021-11-10,Sacramento,067,1510023,161187,159962,4731,164693,2289
2021-11-10,San Benito,069,59416,7488,7473,173,7646,76
2021-11-10,San Bernardino,071,2135413,358756,355413,11372,366785,5849
2021-11-10,San Diego,073,3302833,378374,376428,22195,398623,4272
2021-11-10,San Francisco,075,870044,53729,53063,2382,55445,666
2021-11-10,San Joaquin,077,732212,100970,99937,5494,105431,1799
2021-11-10,San Luis Obispo,079,281455,29975,29532,1280,30812,351
2021-11-10,San Mateo,081,765935,54767,53722,916,54638,574
2021-11-10,Santa Barbara,083,443738,44995,44603,1579,46182,534
2021-11-10,Santa Clara,085,1922200,148915,147458,1414,148872,1901
2021-11-10,Santa Cruz,087,273765,20726,20479,1017,21496,222
2021-11-10,Shasta,089,179085,21938,21600,3653,25253,364
2021-11-10,Sierra,091,2930,190,186,21,207,0
2021-11-10,Siskiyou,093,43540,3373,3297,1322,4619,53
2021-11-10,Solano,095,438530,46387,45679,1298,46977,350
2021-11-10,Sonoma,097,501317,42084,41774,540,42314,395
2021-11-10,Stanislaus,099,539301,79577,79570,9007,88577,1166
2021-11-10,Sutter,101,95872,14005,13993,365,14358,181
2021-11-10,Tehama,103,63373,8668,8565,1504,10069,125
2021-11-10,Trinity,105,12862,865,748,219,967,17
2021-11-10,Tulare,107,460477,69695,68367,15466,83833,1028
2021-11-10,Tuolumne,109,53932,7439,7354,108,7462,90
2021-11-10,Ventura,111,848112,99035,98297,4349,102646,1182
2021-11-10,Yolo,113,214977,20138,19946,1174,21120,255
2021-11-10,Yuba,115,75493,10284,10191,354,10545,85
2021-11-09,Alameda,001,1643700,120722,120051,2828,122879,1450
2021-11-09,Alpine,003,1148,102,105,0,105,0
2021-11-09,Amador,005,37829,5634,5596,65,5661,66
2021-11-09,Butte,007,227075,21298,21022,3848,24870,291
2021-11-09,Calaveras,009,45235,4211,4174,58,4232,84
2021-11-09,Colusa,011,21464,2542,2517,649,3166,19
2021-11-09,Contra Costa,013,1133247,100361,99732,2244,101976,1028
2021-11-09,Del Norte,015,27424,3710,3620,55,3675,42
2021-11-09,El Dorado,017,186661,16306,16073,1743,17816,160
2021-11-09,Fresno,019,978130,142781,140666,12969,153635,2188
2021-11-09,Glenn,021,27897,3540,3499,1021,4520,34
2021-11-09,Humboldt,023,135768,9241,9112,591,9703,115
2021-11-09,Imperial,025,180216,34195,33751,3296,37047,766
2021-11-09,Inyo,027,18085,2453,2404,42,2446,42
2021-11-09,Kern,029,883053,129678,127901,22965,150866,1694
2021-11-09,Kings,031,150075,32772,32279,1989,34268,344
2021-11-09,Lake,033,64148,6822,6743,155,6898,106
2021-11-09,Lassen,035,31185,6954,6846,398,7244,47
2021-11-09,Los Angeles,037,10098052,1450580,1439125,54881,1494006,26581
2021-11-09,Madera,039,155013,23679,23285,2188,25473,287
2021-11-09,Marin,041,260295,17756,17630,471,18101,247
2021-11-09,Mariposa,043,17540,1349,1317,51,1368,5
2021-11-09,Mendocino,045,87422,7740,7598,603,8201,85
2021-11-09,Merced,047,269075,42459,42251,2014,44265,613
2021-11-09,Modoc,049,8938,555,536,197,733,5
2021-11-09,Mono,051,14174,1755,1738,22,1760,4
2021-11-09,Monterey,053,433212,49102,47975,3017,50992,609
2021-11-09,Napa,055,140530,13146,13051,116,13167,103
2021-11-09,Nevada,057,99092,9440,9288,333,9621,92
2021-11-09,Orange,059,3164182,309870,307412,15544,322956,5621
2021-11-09,Placer,061,380077,37730,37291,3719,41010,440
2021-11-09,Plumas,063,18699,1868,1802,41,1843,7
2021-11-09,Riverside,065,2383286,367395,362557,16580,379137,5160
2021-11-09,Sacramento,067,1510023,160946,159856,4722,164578,2286
2021-11-09,San Benito,069,59416,7478,7471,172,7643,76
2021-11-09,San Bernardino,071,2135413,358307,354972,11355,366327,5839
2021-11-09,San Diego,073,3302833,377879,375997,22169,398166,4272
2021-11-09,San Francisco,075,870044,53655,52996,2376,55372,666
2021-11-09,San Joaquin,077,732212,100795,99848,5481,105329,1794
2021-11-09,San Luis Obispo,079,281455,29932,29488,1279,30767,350
2021-11-09,San Mateo,081,765935,54720,53697,906,54603,574
2021-11-09,Santa Barbara,083,443738,44928,44579,1572,46151,533
2021-11-09,Santa Clara,085,1922200,148709,147281,1407,148688,1901
2021-11-09,Santa Cruz,087,273765,20692,20463,1016,21479,222
2021-11-09,Shasta,089,179085,21883,21558,3648,25206,364
2021-11-09,Sierra,091,2930,190,186,21,207,0
2021-11-09,Siskiyou,093,43540,3371,3295,1320,4615,52
2021-11-09,Solano,095,438530,46332,45639,1297,46936,350
2021-11-09,Sonoma,097,501317,42027,41727,538,42265,395
2021-11-09,Stanislaus,099,539301,79471,79505,8990,88495,1165
2021-11-09,Sutter,101,95872,13990,13988,363,14351,180
2021-11-09,Tehama,103,63373,8650,8555,1502,10057,125
2021-11-09,Trinity,105,12862,864,746,219,965,17
2021-11-09,Tulare,107,460477,69589,68298,15426,83724,1024
2021-11-09,Tuolumne,109,53932,7419,7347,108,7455,90
2021-11-09,Ventura,111,848112,98957,98202,4344,102546,1182
2021-11-09,Yolo,113,214977,20114,19931,1170,21101,255
2021-11-09,Yuba,115,75493,10267,10175,348,10523,85
2021-11-08,Alameda,001,1643700,120579,119983,2822,122805,1447
2021-11-08,Alpine,003,1148,102,105,0,105,0
2021-11-08,Amador,005,37829,5628,5590,65,5655,66
2021-11-08,Butte,007,227075,21270,21000,3840,24840,288
2021-11-08,Calaveras,009,45235,4203,4166,58,4224,82
2021-11-08,Colusa,011,21464,2541,2514,648,3162,19
2021-11-08,Contra Costa,013,1133247,100257,99669,2240,101909,1028
2021-11-08,Del Norte,015,27424,3706,3619,55,3674,42
2021-11-08,El Dorado,017,186661,16287,16055,1738,17793,156
2021-11-08,Fresno,019,978130,142480,140466,12947,153413,2179
2021-11-08,Glenn,021,27897,3538,3496,1017,4513,34
2021-11-08,Humboldt,023,135768,9214,9095,581,9676,109
2021-11-08,Imperial,025,180216,34115,33690,3278,36968,766
2021-11-08,Inyo,027,18085,2446,2398,42,2440,41
2021-11-08,Kern,029,883053,129442,127722,22882,150604,1692
2021-11-08,Kings,031,150075,32726,32248,1988,34236,344
2021-11-08,Lake,033,64148,6816,6737,155,6892,106
2021-11-08,Lassen,035,31185,6947,6830,396,7226,46
2021-11-08,Los Angeles,037,10098052,1449235,1438322,54822,1493144,26575
2021-11-08,Madera,039,155013,23630,23253,2177,25430,287
2021-11-08,Marin,041,260295,17739,17617,468,18085,247
2021-11-08,Mariposa,043,17540,1341,1316,50,1366,5
2021-11-08,Mendocino,045,87422,7727,7581,597,8178,85
2021-11-08,Merced,047,269075,42389,42224,2004,44228,607
2021-11-08,Modoc,049,8938,554,529,197,726,5
2021-11-08,Mono,051,14174,1751,1739,22,1761,4
2021-11-08,Monterey,053,433212,49061,47942,2996,50938,602
2021-11-08,Napa,055,140530,13132,13045,116,13161,103
2021-11-08,Nevada,057,99092,9421,9278,331,9609,92
2021-11-08,Orange,059,3164182,309597,307156,15513,322669,5616
2021-11-08,Placer,061,380077,37676,37250,3716,40966,439
2021-11-08,Plumas,063,18699,1867,1788,40,1828,7
2021-11-08,Riverside,065,2383286,366940,362201,16566,378767,5152
2021-11-08,Sacramento,067,1510023,160730,159735,4702,164437,2275
2021-11-08,San Benito,069,59416,7476,7461,172,7633,75
2021-11-08,San Bernardino,071,2135413,357797,354741,11337,366078,5836
2021-11-08,San Diego,073,3302833,377317,375557,22122,397679,4259
2021-11-08,San Francisco,075,870044,53602,52942,2370,55312,666
2021-11-08,San Joaquin,077,732212,100681,99736,5479,105215,1794
2021-11-08,San Luis Obispo,079,281455,29880,29464,1274,30738,350
2021-11-08,San Mateo,081,765935,54647,53658,901,54559,574
2021-11-08,Santa Barbara,083,443738,44874,44548,1571,46119,532
2021-11-08,Santa Clara,085,1922200,148482,147183,1401,148584,1899
2021-11-08,Santa Cruz,087,273765,20663,20435,1016,21451,222
2021-11-08,Shasta,089,179085,21836,21504,3642,25146,354
2021-11-08,Sierra,091,2930,190,183,21,204,0
2021-11-08,Siskiyou,093,43540,3367,3290,1309,4599,50
2021-11-08,Solano,095,438530,46291,45613,1293,46906,350
2021-11-08,Sonoma,097,501317,41959,41669,536,42205,395
2021-11-08,Stanislaus,099,539301,79319,79417,8976,88393,1150
2021-11-08,Sutter,101,95872,13982,13976,359,14335,180
2021-11-08,Tehama,103,63373,8641,8534,1502,10036,123
2021-11-08,Trinity,105,12862,864,743,218,961,13
2021-11-08,Tulare,107,460477,69472,68199,15388,83587,1020
2021-11-08,Tuolumne,109,53932,7400,7328,107,7435,90
2021-11-08,Ventura,111,848112,98864,98144,4342,102486,1182
2021-11-08,Yolo,113,214977,20076,19916,1165,21081,255
2021-11-08,Yuba,115,75493,10256,10172,345,10517,83
2021-11-07,Alameda,001,1643700,120422,119902,2816,122718,1444
2021-11-07,Alpine,003,1148,102,105,0,105,0
2021-11-07,Amador,005,37829,5620,5580,63,5643,66
2021-11-07,Butte,007,227075,21229,20969,3831,24800,288
2021-11-07,Calaveras,009,45235,4176,4158,57,4215,82
2021-11-07,Colusa,011,21464,2535,2511,646,3157,19
2021-11-07,Contra Costa,013,1133247,100146,99596,2231,101827,1028
2021-11-07,Del Norte,015,27424,3704,3617,55,3672,42
2021-11-07,El Dorado,017,186661,16250,16040,1735,17775,156
2021-11-07,Fresno,019,978130,142138,140263,12919,153182,2179
2021-11-07,Glenn,021,27897,3531,3493,1016,4509,34
2021-11-07,Humboldt,023,135768,9189,9074,577,9651,109
2021-11-07,Imperial,025,180216,34042,33674,3258,36932,766
2021-11-07,Inyo,027,18085,2433,2394,42,2436,41
2021-11-07,Kern,029,883053,129170,127583,22790,150373,1692
2021-11-07,Kings,031,150075,32635,32221,1985,34206,343
2021-11-07,Lake,033,64148,6800,6734,154,6888,106
2021-11-07,Lassen,035,31185,6939,6819,392,7211,46
2021-11-07,Los Angeles,037,10098052,1447738,1437314,54746,1492060,26573
2021-11-07,Madera,039,155013,23585,23225,2169,25394,287
2021-11-07,Marin,041,260295,17719,17594,467,18061,247
2021-11-07,Mariposa,043,17540,1339,1306,50,1356,5
2021-11-07,Mendocino,045,87422,7699,7567,593,8160,85
2021-11-07,Merced,047,269075,42311,42186,1973,44159,607
2021-11-07,Modoc,049,8938,551,528,196,724,5
2021-11-07,Mono,051,14174,1745,1739,22,1761,4
2021-11-07,Monterey,053,433212,49009,47924,2991,50915,602
2021-11-07,Napa,055,140530,13111,13041,116,13157,103
2021-11-07,Nevada,057,99092,9373,9254,331,9585,92
2021-11-07,Orange,059,3164182,309273,306954,15475,322429,5616
2021-11-07,Placer,061,380077,37600,37202,3701,40903,439
2021-11-07,Plumas,063,18699,1860,1787,39,1826,7
2021-11-07,Riverside,065,2383286,366403,361960,16546,378506,5152
2021-11-07,Sacramento,067,1510023,160498,159549,4685,164234,2277
2021-11-07,San Benito,069,59416,7463,7460,172,7632,75
2021-11-07,San Bernardino,071,2135413,357289,354488,11314,365802,5832
2021-11-07,San Diego,073,3302833,376736,375165,22089,397254,4250
2021-11-07,San Francisco,075,870044,53518,52868,2364,55232,666
2021-11-07,San Joaquin,077,732212,100496,99696,5473,105169,1794
2021-11-07,San Luis Obispo,079,281455,29830,29454,1270,30724,350
2021-11-07,San Mateo,081,765935,54588,53600,899,54499,574
2021-11-07,Santa Barbara,083,443738,44811,44501,1570,46071,532
2021-11-07,Santa Clara,085,1922200,148278,147054,1388,148442,1898
2021-11-07,Santa Cruz,087,273765,20605,20397,1015,21412,222
2021-11-07,Shasta,089,179085,21788,21479,3636,25115,354
2021-11-07,Sierra,091,2930,188,183,21,204,0
2021-11-07,Siskiyou,093,43540,3361,3289,1307,4596,51
2021-11-07,Solano,095,438530,46236,45582,1286,46868,350
2021-11-07,Sonoma,097,501317,41909,41630,535,42165,395
2021-11-07,Stanislaus,099,539301,79164,79351,8954,88305,1150
2021-11-07,Sutter,101,95872,13969,13964,356,14320,180
2021-11-07,Tehama,103,63373,8617,8528,1500,10028,121
2021-11-07,Trinity,105,12862,863,742,217,959,13
2021-11-07,Tulare,107,460477,69319,68145,15345,83490,1020
2021-11-07,Tuolumne,109,53932,7382,7300,105,7405,90
2021-11-07,Ventura,111,848112,98773,98085,4340,102425,1182
2021-11-07,Yolo,113,214977,20055,19899,1160,21059,255
2021-11-07,Yuba,115,75493,10239,10162,340,10502,83
2021-11-06,Alameda,001,1643700,120358,119499,2813,122312,1436
2021-11-06,Alpine,003,1148,102,105,0,105,0
2021-11-06,Amador,005,37829,5614,5557,63,5620,66
2021-11-06,Butte,007,227075,21209,20796,3827,24623,288
2021-11-06,Calaveras,009,45235,4168,4105,57,4162,82
2021-11-06,Colusa,011,21464,2534,2501,645,3146,19
2021-11-06,Contra Costa,013,1133247,100091,99282,2229,101511,1025
2021-11-06,Del Norte,015,27424,3701,3607,55,3662,42
2021-11-06,El Dorado,017,186661,16233,15958,1735,17693,156
2021-11-06,Fresno,019,978130,142020,139249,12914,152163,2170
2021-11-06,Glenn,021,27897,3528,3479,1016,4495,33
2021-11-06,Humboldt,023,135768,9177,8972,573,9545,109
2021-11-06,Imperial,025,180216,33998,33471,3252,36723,766
2021-11-06,Inyo,027,18085,2427,2353,42,2395,41
2021-11-06,Kern,029,883053,129036,126848,22737,149585,1684
2021-11-06,Kings,031,150075,32602,32018,1980,33998,342
2021-11-06,Lake,033,64148,6798,6695,154,6849,106
2021-11-06,Lassen,035,31185,6934,6796,391,7187,46
2021-11-06,Los Angeles,037,10098052,1446963,1433081,54704,1487785,26533
2021-11-06,Madera,039,155013,23549,22994,2159,25153,287
2021-11-06,Marin,041,260295,17700,17520,464,17984,247
2021-11-06,Mariposa,043,17540,1337,1282,50,1332,5
2021-11-06,Mendocino,045,87422,7677,7486,593,8079,85
2021-11-06,Merced,047,269075,42287,41958,1965,43923,604
2021-11-06,Modoc,049,8938,550,523,196,719,5
2021-11-06,Mono,051,14174,1743,1725,22,1747,4
2021-11-06,Monterey,053,433212,48977,47830,2981,50811,602
2021-11-06,Napa,055,140530,13101,12950,116,13066,103
2021-11-06,Nevada,057,99092,9351,9169,330,9499,91
2021-11-06,Orange,059,3164182,309066,306049,15449,321498,5611
2021-11-06,Placer,061,380077,37559,36967,3698,40665,438
2021-11-06,Plumas,063,18699,1856,1755,38,1793,7
2021-11-06,Riverside,065,2383286,366085,360584,16537,377121,5138
2021-11-06,Sacramento,067,1510023,160405,158766,4680,163446,2263
2021-11-06,San Benito,069,59416,7456,7429,172,7601,75
2021-11-06,San Bernardino,071,2135413,357017,353142,11310,364452,5813
2021-11-06,San Diego,073,3302833,376400,373423,22071,395494,4246
2021-11-06,San Francisco,075,870044,53465,52556,2361,54917,666
2021-11-06,San Joaquin,077,732212,100438,99372,5472,104844,1782
2021-11-06,San Luis Obispo,079,281455,29802,29335,1266,30601,350
2021-11-06,San Mateo,081,765935,54554,53442,898,54340,574
2021-11-06,Santa Barbara,083,443738,44775,44301,1569,45870,532
2021-11-06,Santa Clara,085,1922200,148133,146519,1383,147902,1894
2021-11-06,Santa Cruz,087,273765,20586,20311,1013,21324,222
2021-11-06,Shasta,089,179085,21769,21281,3631,24912,349
2021-11-06,Sierra,091,2930,188,181,21,202,0
2021-11-06,Siskiyou,093,43540,3361,3279,1305,4584,48
2021-11-06,Solano,095,438530,46206,45465,1285,46750,350
2021-11-06,Sonoma,097,501317,41859,41398,534,41932,395
2021-11-06,Stanislaus,099,539301,79096,78902,8946,87848,1193
2021-11-06,Sutter,101,95872,13965,13908,355,14263,180
2021-11-06,Tehama,103,63373,8606,8474,1498,9972,120
2021-11-06,Trinity,105,12862,860,732,217,949,11
2021-11-06,Tulare,107,460477,69269,67767,15316,83083,1010
2021-11-06,Tuolumne,109,53932,7370,7245,105,7350,90
2021-11-06,Ventura,111,848112,98706,97770,4335,102105,1180
2021-11-06,Yolo,113,214977,20038,19827,1156,20983,255
2021-11-06,Yuba,115,75493,10225,10107,340,10447,83
2021-11-05,Alameda,001,1643700,120274,119499,2811,122310,1436
2021-11-05,Alpine,003,1148,102,105,0,105,0
2021-11-05,Amador,005,37829,5609,5557,63,5620,66
2021-11-05,Butte,007,227075,21196,20796,3826,24622,288
2021-11-05,Calaveras,009,45235,4163,4105,57,4162,82
2021-11-05,Colusa,011,21464,2534,2501,644,3145,19
2021-11-05,Contra Costa,013,1133247,100026,99282,2227,101509,1025
2021-11-05,Del Norte,015,27424,3699,3607,55,3662,42
2021-11-05,El Dorado,017,186661,16214,15958,1729,17687,156
2021-11-05,Fresno,019,978130,141842,139249,12904,152153,2170
2021-11-05,Glenn,021,27897,3528,3479,1015,4494,33
2021-11-05,Humboldt,023,135768,9163,8972,573,9545,109
2021-11-05,Imperial,025,180216,33962,33471,3249,36720,766
2021-11-05,Inyo,027,18085,2419,2353,42,2395,41
2021-11-05,Kern,029,883053,128909,126848,22681,149529,1684
2021-11-05,Kings,031,150075,32578,32018,1979,33997,342
2021-11-05,Lake,033,64148,6792,6695,154,6849,106
2021-11-05,Lassen,035,31185,6930,6796,390,7186,46
2021-11-05,Los Angeles,037,10098052,1446144,1433081,54666,1487747,26533
2021-11-05,Madera,039,155013,23511,22994,2157,25151,287
2021-11-05,Marin,041,260295,17678,17520,463,17983,247
2021-11-05,Mariposa,043,17540,1334,1282,49,1331,5
2021-11-05,Mendocino,045,87422,7666,7486,592,8078,85
2021-11-05,Merced,047,269075,42261,41958,1956,43914,604
2021-11-05,Modoc,049,8938,550,523,196,719,5
2021-11-05,Mono,051,14174,1742,1725,22,1747,4
2021-11-05,Monterey,053,433212,48947,47830,2979,50809,602
2021-11-05,Napa,055,140530,13079,12950,116,13066,103
2021-11-05,Nevada,057,99092,9338,9169,330,9499,91
2021-11-05,Orange,059,3164182,308869,306049,15427,321476,5611
2021-11-05,Placer,061,380077,37532,36967,3689,40656,438
2021-11-05,Plumas,063,18699,1848,1755,38,1793,7
2021-11-05,Riverside,065,2383286,365744,360584,16527,377111,5138
2021-11-05,Sacramento,067,1510023,160283,158766,4674,163440,2263
2021-11-05,San Benito,069,59416,7454,7429,171,7600,75
2021-11-05,San Bernardino,071,2135413,356686,353142,11299,364441,5813
2021-11-05,San Diego,073,3302833,376047,373423,22059,395482,4246
2021-11-05,San Francisco,075,870044,53414,52556,2358,54914,666
2021-11-05,San Joaquin,077,732212,100385,99372,5463,104835,1782
2021-11-05,San Luis Obispo,079,281455,29779,29335,1266,30601,350
2021-11-05,San Mateo,081,765935,54512,53442,896,54338,574
2021-11-05,Santa Barbara,083,443738,44730,44301,1568,45869,532
2021-11-05,Santa Clara,085,1922200,147996,146519,1382,147901,1894
2021-11-05,Santa Cruz,087,273765,20562,20311,1012,21323,222
2021-11-05,Shasta,089,179085,21737,21281,3626,24907,349
2021-11-05,Sierra,091,2930,188,181,21,202,0
2021-11-05,Siskiyou,093,43540,3356,3279,1304,4583,48
2021-11-05,Solano,095,438530,46161,45465,1282,46747,350
2021-11-05,Sonoma,097,501317,41819,41398,534,41932,395
2021-11-05,Stanislaus,099,539301,79038,78902,8934,87836,1193
2021-11-05,Sutter,101,95872,13957,13908,354,14262,180
2021-11-05,Tehama,103,63373,8599,8474,1497,9971,120
2021-11-05,Trinity,105,12862,860,732,217,949,11
2021-11-05,Tulare,107,460477,69196,67767,15280,83047,1010
2021-11-05,Tuolumne,109,53932,7353,7245,104,7349,90
2021-11-05,Ventura,111,848112,98666,97770,4332,102102,1180
2021-11-05,Yolo,113,214977,20027,19827,1155,20982,255
2021-11-05,Yuba,115,75493,10212,10107,338,10445,83
2021-11-04,Alameda,001,1643700,120157,119499,2805,122304,1436
2021-11-04,Alpine,003,1148,102,105,0,105,0
2021-11-04,Amador,005,37829,5601,5557,63,5620,66
2021-11-04,Butte,007,227075,21154,20796,3815,24611,288
2021-11-04,Calaveras,009,45235,4149,4105,55,4160,82
2021-11-04,Colusa,011,21464,2528,2501,643,3144,19
2021-11-04,Contra Costa,013,1133247,99935,99282,2222,101504,1025
2021-11-04,Del Norte,015,27424,3696,3607,55,3662,42
2021-11-04,El Dorado,017,186661,16188,15958,1725,17683,156
2021-11-04,Fresno,019,978130,141560,139249,12895,152144,2170
2021-11-04,Glenn,021,27897,3523,3479,1014,4493,33
2021-11-04,Humboldt,023,135768,9138,8972,570,9542,109
2021-11-04,Imperial,025,180216,33905,33471,3240,36711,766
2021-11-04,Inyo,027,18085,2411,2353,42,2395,41
2021-11-04,Kern,029,883053,128677,126848,22613,149461,1684
2021-11-04,Kings,031,150075,32499,32018,1969,33987,342
2021-11-04,Lake,033,64148,6782,6695,152,6847,106
2021-11-04,Lassen,035,31185,6920,6796,385,7181,46
2021-11-04,Los Angeles,037,10098052,1444835,1433081,54584,1487665,26533
2021-11-04,Madera,039,155013,23456,22994,2146,25140,287
2021-11-04,Marin,041,260295,17666,17520,461,17981,247
2021-11-04,Mariposa,043,17540,1327,1282,49,1331,5
2021-11-04,Mendocino,045,87422,7653,7486,586,8072,85
2021-11-04,Merced,047,269075,42206,41958,1952,43910,604
2021-11-04,Modoc,049,8938,549,523,196,719,5
2021-11-04,Mono,051,14174,1737,1725,22,1747,4
2021-11-04,Monterey,053,433212,48903,47830,2963,50793,602
2021-11-04,Napa,055,140530,13058,12950,116,13066,103
2021-11-04,Nevada,057,99092,9307,9169,329,9498,91
2021-11-04,Orange,059,3164182,308621,306049,15408,321457,5611
2021-11-04,Placer,061,380077,37460,36967,3680,40647,438
2021-11-04,Plumas,063,18699,1840,1755,34,1789,7
2021-11-04,Riverside,065,2383286,365346,360584,16518,377102,5138
2021-11-04,Sacramento,067,1510023,160049,158766,4654,163420,2263
2021-11-04,San Benito,069,59416,7448,7429,171,7600,75
2021-11-04,San Bernardino,071,2135413,356252,353142,11291,364433,5813
2021-11-04,San Diego,073,3302833,375578,373423,22038,395461,4246
2021-11-04,San Francisco,075,870044,53333,52556,2354,54910,666
2021-11-04,San Joaquin,077,732212,100278,99372,5451,104823,1782
2021-11-04,San Luis Obispo,079,281455,29755,29335,1260,30595,350
2021-11-04,San Mateo,081,765935,54453,53442,890,54332,574
2021-11-04,Santa Barbara,083,443738,44674,44301,1568,45869,532
2021-11-04,Santa Clara,085,1922200,147842,146519,1378,147897,1894
2021-11-04,Santa Cruz,087,273765,20527,20311,1012,21323,222
2021-11-04,Shasta,089,179085,21679,21281,3620,24901,349
2021-11-04,Sierra,091,2930,186,181,21,202,0
2021-11-04,Siskiyou,093,43540,3353,3279,1297,4576,48
2021-11-04,Solano,095,438530,46119,45465,1281,46746,350
2021-11-04,Sonoma,097,501317,41759,41398,534,41932,395
2021-11-04,Stanislaus,099,539301,78900,78902,8926,87828,1193
2021-11-04,Sutter,101,95872,13946,13908,352,14260,180
2021-11-04,Tehama,103,63373,8590,8474,1493,9967,120
2021-11-04,Trinity,105,12862,859,732,217,949,11
2021-11-04,Tulare,107,460477,69081,67767,15234,83001,1010
2021-11-04,Tuolumne,109,53932,7331,7245,102,7347,90
2021-11-04,Ventura,111,848112,98578,97770,4329,102099,1180
2021-11-04,Yolo,113,214977,20002,19827,1149,20976,255
2021-11-04,Yuba,115,75493,10198,10107,336,10443,83
2021-11-03,Alameda,001,1643700,120016,119356,2801,122157,1428
2021-11-03,Alpine,003,1148,102,105,0,105,0
2021-11-03,Amador,005,37829,5595,5545,62,5607,66
2021-11-03,Butte,007,227075,21109,20769,3806,24575,284
2021-11-03,Calaveras,009,45235,4131,4087,54,4141,82
2021-11-03,Colusa,011,21464,2522,2499,643,3142,20
2021-11-03,Contra Costa,013,1133247,99835,99168,2217,101385,1025
2021-11-03,Del Norte,015,27424,3694,3600,54,3654,42
2021-11-03,El Dorado,017,186661,16161,15915,1721,17636,156
2021-11-03,Fresno,019,978130,141198,138873,12871,151744,2166
2021-11-03,Glenn,021,27897,3519,3470,1014,4484,33
2021-11-03,Humboldt,023,135768,9121,8949,565,9514,109
2021-11-03,Imperial,025,180216,33833,33402,3230,36632,766
2021-11-03,Inyo,027,18085,2390,2344,42,2386,41
2021-11-03,Kern,029,883053,128417,126523,22511,149034,1681
2021-11-03,Kings,031,150075,32444,31923,1962,33885,341
2021-11-03,Lake,033,64148,6766,6685,152,6837,106
2021-11-03,Lassen,035,31185,6903,6782,380,7162,46
2021-11-03,Los Angeles,037,10098052,1443482,1431209,54499,1485708,26517
2021-11-03,Madera,039,155013,23388,22893,2137,25030,287
2021-11-03,Marin,041,260295,17645,17491,457,17948,247
2021-11-03,Mariposa,043,17540,1317,1276,49,1325,5
2021-11-03,Mendocino,045,87422,7637,7457,578,8035,84
2021-11-03,Merced,047,269075,42145,41849,1942,43791,597
2021-11-03,Modoc,049,8938,549,521,194,715,5
2021-11-03,Mono,051,14174,1733,1719,22,1741,4
2021-11-03,Monterey,053,433212,48853,47794,2950,50744,601
2021-11-03,Napa,055,140530,13046,12937,115,13052,103
2021-11-03,Nevada,057,99092,9280,9131,328,9459,91
2021-11-03,Orange,059,3164182,308310,305661,15375,321036,5607
2021-11-03,Placer,061,380077,37390,36868,3675,40543,438
2021-11-03,Plumas,063,18699,1829,1739,33,1772,7
2021-11-03,Riverside,065,2383286,364888,360060,16514,376574,5131
2021-11-03,Sacramento,067,1510023,159825,158311,4643,162954,2259
2021-11-03,San Benito,069,59416,7440,7419,171,7590,75
2021-11-03,San Bernardino,071,2135413,355777,352225,11271,363496,5813
2021-11-03,San Diego,073,3302833,375078,372951,22015,394966,4241
2021-11-03,San Francisco,075,870044,53240,52493,2349,54842,663
2021-11-03,San Joaquin,077,732212,100166,99188,5440,104628,1776
2021-11-03,San Luis Obispo,079,281455,29713,29276,1254,30530,348
2021-11-03,San Mateo,081,765935,54389,53396,884,54280,571
2021-11-03,Santa Barbara,083,443738,44617,44220,1565,45785,531
2021-11-03,Santa Clara,085,1922200,147672,146259,1371,147630,1897
2021-11-03,Santa Cruz,087,273765,20492,20275,1012,21287,222
2021-11-03,Shasta,089,179085,21621,21215,3613,24828,346
2021-11-03,Sierra,091,2930,184,180,21,201,0
2021-11-03,Siskiyou,093,43540,3349,3276,1295,4571,46
2021-11-03,Solano,095,438530,46092,45411,1279,46690,351
2021-11-03,Sonoma,097,501317,41682,41326,532,41858,395
2021-11-03,Stanislaus,099,539301,78769,78736,8910,87646,1193
2021-11-03,Sutter,101,95872,13933,13876,350,14226,179
2021-11-03,Tehama,103,63373,8578,8438,1493,9931,118
2021-11-03,Trinity,105,12862,858,730,217,947,11
2021-11-03,Tulare,107,460477,68953,67588,15192,82780,1007
2021-11-03,Tuolumne,109,53932,7313,7218,100,7318,90
2021-11-03,Ventura,111,848112,98469,97682,4325,102007,1178
2021-11-03,Yolo,113,214977,19984,19758,1141,20899,250
2021-11-03,Yuba,115,75493,10186,10092,336,10428,83
2021-11-02,Alameda,001,1643700,119871,119241,2795,122036,1425
2021-11-02,Alpine,003,1148,101,105,0,105,0
2021-11-02,Amador,005,37829,5590,5535,62,5597,66
2021-11-02,Butte,007,227075,21065,20744,3795,24539,282
2021-11-02,Calaveras,009,45235,4108,4075,54,4129,82
2021-11-02,Colusa,011,21464,2517,2497,642,3139,19
2021-11-02,Contra Costa,013,1133247,99731,99080,2205,101285,1025
2021-11-02,Del Norte,015,27424,3692,3596,54,3650,42
2021-11-02,El Dorado,017,186661,16132,15883,1721,17604,154
2021-11-02,Fresno,019,978130,140874,138644,12840,151484,2158
2021-11-02,Glenn,021,27897,3511,3469,1011,4480,33
2021-11-02,Humboldt,023,135768,9079,8937,564,9501,109
2021-11-02,Imperial,025,180216,33760,33371,3218,36589,766
2021-11-02,Inyo,027,18085,2383,2324,42,2366,41
2021-11-02,Kern,029,883053,128162,126311,22389,148700,1665
2021-11-02,Kings,031,150075,32385,31896,1957,33853,339
2021-11-02,Lake,033,64148,6761,6681,151,6832,106
2021-11-02,Lassen,035,31185,6891,6777,377,7154,45
2021-11-02,Los Angeles,037,10098052,1442032,1429601,54422,1484023,26496
2021-11-02,Madera,039,155013,23307,22837,2126,24963,287
2021-11-02,Marin,041,260295,17617,17482,457,17939,247
2021-11-02,Mariposa,043,17540,1306,1270,48,1318,5
2021-11-02,Mendocino,045,87422,7613,7447,566,8013,84
2021-11-02,Merced,047,269075,42078,41785,1934,43719,596
2021-11-02,Modoc,049,8938,546,520,193,713,5
2021-11-02,Mono,051,14174,1729,1718,22,1740,4
2021-11-02,Monterey,053,433212,48802,47775,2932,50707,599
2021-11-02,Napa,055,140530,13028,12930,115,13045,104
2021-11-02,Nevada,057,99092,9250,9122,327,9449,91
2021-11-02,Orange,059,3164182,307994,305369,15328,320697,5600
2021-11-02,Placer,061,380077,37318,36817,3660,40477,438
2021-11-02,Plumas,063,18699,1818,1721,33,1754,7
2021-11-02,Riverside,065,2383286,364434,359586,16494,376080,5116
2021-11-02,Sacramento,067,1510023,159569,158112,4620,162732,2250
2021-11-02,San Benito,069,59416,7424,7407,171,7578,75
2021-11-02,San Bernardino,071,2135413,355303,351832,11217,363049,5813
2021-11-02,San Diego,073,3302833,374493,372440,21985,394425,4232
2021-11-02,San Francisco,075,870044,53121,52450,2345,54795,663
2021-11-02,San Joaquin,077,732212,100032,99076,5429,104505,1772
2021-11-02,San Luis Obispo,079,281455,29680,29224,1250,30474,348
2021-11-02,San Mateo,081,765935,54317,53351,881,54232,571
2021-11-02,Santa Barbara,083,443738,44561,44177,1562,45739,531
2021-11-02,Santa Clara,085,1922200,147478,146115,1364,147479,1896
2021-11-02,Santa Cruz,087,273765,20459,20266,1011,21277,222
2021-11-02,Shasta,089,179085,21547,21127,3603,24730,344
2021-11-02,Sierra,091,2930,184,180,20,200,0
2021-11-02,Siskiyou,093,43540,3347,3272,1292,4564,46
2021-11-02,Solano,095,438530,46052,45378,1273,46651,350
2021-11-02,Sonoma,097,501317,41601,41288,531,41819,395
2021-11-02,Stanislaus,099,539301,78614,78629,8890,87519,1193
2021-11-02,Sutter,101,95872,13913,13868,350,14218,179
2021-11-02,Tehama,103,63373,8562,8422,1490,9912,116
2021-11-02,Trinity,105,12862,858,729,217,946,11
2021-11-02,Tulare,107,460477,68828,67502,15143,82645,1002
2021-11-02,Tuolumne,109,53932,7292,7204,98,7302,90
2021-11-02,Ventura,111,848112,98364,97574,4321,101895,1178
2021-11-02,Yolo,113,214977,19954,19736,1139,20875,250
2021-11-02,Yuba,115,75493,10163,10080,334,10414,83
2021-11-01,Alameda,001,1643700,119731,119159,2792,121951,1421
2021-11-01,Alpine,003,1148,101,105,0,105,0
2021-11-01,Amador,005,37829,5588,5532,62,5594,64
2021-11-01,Butte,007,227075,21015,20710,3790,24500,281
2021-11-01,Calaveras,009,45235,4098,4059,53,4112,82
2021-11-01,Colusa,011,21464,2515,2494,639,3133,19
2021-11-01,Contra Costa,013,1133247,99606,99011,2197,101208,1025
2021-11-01,Del Norte,015,27424,3690,3594,54,3648,42
2021-11-01,El Dorado,017,186661,16108,15858,1715,17573,154
2021-11-01,Fresno,019,978130,140498,138421,12803,151224,2149
2021-11-01,Glenn,021,27897,3503,3461,1009,4470,33
2021-11-01,Humboldt,023,135768,9051,8929,560,9489,108
2021-11-01,Imperial,025,180216,33710,33342,3209,36551,766
2021-11-01,Inyo,027,18085,2371,2307,42,2349,41
2021-11-01,Kern,029,883053,127862,126092,22274,148366,1660
2021-11-01,Kings,031,150075,32332,31866,1953,33819,337
2021-11-01,Lake,033,64148,6750,6676,150,6826,106
2021-11-01,Lassen,035,31185,6876,6775,374,7149,42
2021-11-01,Los Angeles,037,10098052,1440647,1428891,54331,1483222,26483
2021-11-01,Madera,039,155013,23228,22801,2121,24922,283
2021-11-01,Marin,041,260295,17597,17460,455,17915,247
2021-11-01,Mariposa,043,17540,1298,1266,47,1313,5
2021-11-01,Mendocino,045,87422,7580,7422,548,7970,84
2021-11-01,Merced,047,269075,41987,41740,1932,43672,594
2021-11-01,Modoc,049,8938,541,520,191,711,5
2021-11-01,Mono,051,14174,1725,1714,22,1736,3
2021-11-01,Monterey,053,433212,48759,47756,2920,50676,597
2021-11-01,Napa,055,140530,13001,12916,114,13030,101
2021-11-01,Nevada,057,99092,9227,9108,326,9434,91
2021-11-01,Orange,059,3164182,307652,305192,15285,320477,5596
2021-11-01,Placer,061,380077,37235,36747,3648,40395,435
2021-11-01,Plumas,063,18699,1799,1719,33,1752,7
2021-11-01,Riverside,065,2383286,363932,359263,16472,375735,5115
2021-11-01,Sacramento,067,1510023,159297,157893,4596,162489,2239
2021-11-01,San Benito,069,59416,7414,7406,170,7576,73
2021-11-01,San Bernardino,071,2135413,354815,351620,11196,362816,5815
2021-11-01,San Diego,073,3302833,373930,372043,21967,394010,4232
2021-11-01,San Francisco,075,870044,53036,52418,2338,54756,661
2021-11-01,San Joaquin,077,732212,99869,98969,5422,104391,1772
2021-11-01,San Luis Obispo,079,281455,29636,29199,1245,30444,343
2021-11-01,San Mateo,081,765935,54250,53314,877,54191,571
2021-11-01,Santa Barbara,083,443738,44494,44146,1558,45704,529
2021-11-01,Santa Clara,085,1922200,147281,145978,1359,147337,1907
2021-11-01,Santa Cruz,087,273765,20424,20238,1011,21249,221
2021-11-01,Shasta,089,179085,21494,21104,3596,24700,338
2021-11-01,Sierra,091,2930,184,180,20,200,0
2021-11-01,Siskiyou,093,43540,3340,3272,1287,4559,46
2021-11-01,Solano,095,438530,45998,45358,1273,46631,350
2021-11-01,Sonoma,097,501317,41528,41234,530,41764,395
2021-11-01,Stanislaus,099,539301,78485,78534,8875,87409,1193
2021-11-01,Sutter,101,95872,13889,13852,348,14200,179
2021-11-01,Tehama,103,63373,8534,8412,1487,9899,116
2021-11-01,Trinity,105,12862,856,727,217,944,11
2021-11-01,Tulare,107,460477,68684,67388,15091,82479,1002
2021-11-01,Tuolumne,109,53932,7276,7175,97,7272,90
2021-11-01,Ventura,111,848112,98274,97507,4319,101826,1178
2021-11-01,Yolo,113,214977,19934,19708,1132,20840,250
2021-11-01,Yuba,115,75493,10145,10066,332,10398,83
2021-10-31,Alameda,001,1643700,119586,119071,2789,121860,1419
2021-10-31,Alpine,003,1148,101,105,0,105,0
2021-10-31,Amador,005,37829,5577,5518,62,5580,64
2021-10-31,Butte,007,227075,20954,20689,3779,24468,281
2021-10-31,Calaveras,009,45235,4080,4052,52,4104,82
2021-10-31,Colusa,011,21464,2513,2493,636,3129,18
2021-10-31,Contra Costa,013,1133247,99478,98936,2194,101130,1025
2021-10-31,Del Norte,015,27424,3684,3591,54,3645,42
2021-10-31,El Dorado,017,186661,16062,15841,1712,17553,154
2021-10-31,Fresno,019,978130,140091,138165,12766,150931,2147
2021-10-31,Glenn,021,27897,3498,3459,1009,4468,33
2021-10-31,Humboldt,023,135768,9003,8919,554,9473,108
2021-10-31,Imperial,025,180216,33635,33334,3197,36531,766
2021-10-31,Inyo,027,18085,2352,2309,42,2351,41
2021-10-31,Kern,029,883053,127493,125917,22150,148067,1666
2021-10-31,Kings,031,150075,32246,31814,1941,33755,338
2021-10-31,Lake,033,64148,6739,6665,148,6813,106
2021-10-31,Lassen,035,31185,6861,6768,369,7137,42
2021-10-31,Los Angeles,037,10098052,1439101,1427933,54246,1482179,26474
2021-10-31,Madera,039,155013,23132,22744,2108,24852,283
2021-10-31,Marin,041,260295,17569,17443,454,17897,247
2021-10-31,Mariposa,043,17540,1292,1257,46,1303,5
2021-10-31,Mendocino,045,87422,7539,7403,531,7934,84
2021-10-31,Merced,047,269075,41894,41699,1912,43611,589
2021-10-31,Modoc,049,8938,535,517,188,705,5
2021-10-31,Mono,051,14174,1721,1711,22,1733,3
2021-10-31,Monterey,053,433212,48718,47744,2902,50646,596
2021-10-31,Napa,055,140530,12984,12906,112,13018,101
2021-10-31,Nevada,057,99092,9190,9084,321,9405,91
2021-10-31,Orange,059,3164182,307303,305032,15202,320234,5596
2021-10-31,Placer,061,380077,37138,36698,3634,40332,435
2021-10-31,Plumas,063,18699,1781,1716,33,1749,7
2021-10-31,Riverside,065,2383286,363353,359005,16458,375463,5104
2021-10-31,Sacramento,067,1510023,158945,157667,4581,162248,2243
2021-10-31,San Benito,069,59416,7405,7397,168,7565,73
2021-10-31,San Bernardino,071,2135413,354282,351411,11182,362593,5810
2021-10-31,San Diego,073,3302833,373378,371603,21936,393539,4218
2021-10-31,San Francisco,075,870044,52928,52370,2332,54702,661
2021-10-31,San Joaquin,077,732212,99704,98893,5408,104301,1772
2021-10-31,San Luis Obispo,079,281455,29582,29176,1244,30420,343
2021-10-31,San Mateo,081,765935,54191,53284,875,54159,571
2021-10-31,Santa Barbara,083,443738,44424,44113,1553,45666,529
2021-10-31,Santa Clara,085,1922200,147066,145829,1345,147174,1908
2021-10-31,Santa Cruz,087,273765,20389,20218,1010,21228,221
2021-10-31,Shasta,089,179085,21411,21086,3584,24670,338
2021-10-31,Sierra,091,2930,184,180,20,200,0
2021-10-31,Siskiyou,093,43540,3334,3271,1286,4557,46
2021-10-31,Solano,095,438530,45950,45310,1266,46576,350
2021-10-31,Sonoma,097,501317,41458,41183,527,41710,395
2021-10-31,Stanislaus,099,539301,78296,78426,8858,87284,1193
2021-10-31,Sutter,101,95872,13870,13838,345,14183,179
2021-10-31,Tehama,103,63373,8503,8391,1483,9874,116
2021-10-31,Trinity,105,12862,856,724,217,941,11
2021-10-31,Tulare,107,460477,68490,67310,15000,82310,1002
2021-10-31,Tuolumne,109,53932,7247,7141,96,7237,90
2021-10-31,Ventura,111,848112,98152,97460,4314,101774,1178
2021-10-31,Yolo,113,214977,19890,19662,1126,20788,250
2021-10-31,Yuba,115,75493,10127,10051,322,10373,83
2021-10-30,Alameda,001,1643700,119526,118632,2786,121418,1419
2021-10-30,Alpine,003,1148,101,105,0,105,0
2021-10-30,Amador,005,37829,5568,5480,61,5541,64
2021-10-30,Butte,007,227075,20939,20516,3773,24289,277
2021-10-30,Calaveras,009,45235,4073,3992,52,4044,82
2021-10-30,Colusa,011,21464,2513,2484,635,3119,19
2021-10-30,Contra Costa,013,1133247,99416,98562,2193,100755,1024
2021-10-30,Del Norte,015,27424,3681,3574,54,3628,42
2021-10-30,El Dorado,017,186661,16046,15752,1707,17459,154
2021-10-30,Fresno,019,978130,139945,136901,12754,149655,2131
2021-10-30,Glenn,021,27897,3494,3442,1009,4451,33
2021-10-30,Humboldt,023,135768,8988,8871,552,9423,105
2021-10-30,Imperial,025,180216,33589,33156,3193,36349,766
2021-10-30,Inyo,027,18085,2349,2249,42,2291,41
2021-10-30,Kern,029,883053,127340,124892,22079,146971,1653
2021-10-30,Kings,031,150075,32212,31578,1937,33515,337
2021-10-30,Lake,033,64148,6734,6610,148,6758,106
2021-10-30,Lassen,035,31185,6855,6719,367,7086,42
2021-10-30,Los Angeles,037,10098052,1438377,1424257,54193,1478450,26625
2021-10-30,Madera,039,155013,23088,22524,2103,24627,283
2021-10-30,Marin,041,260295,17554,17380,452,17832,247
2021-10-30,Mariposa,043,17540,1289,1228,46,1274,5
2021-10-30,Mendocino,045,87422,7516,7338,529,7867,84
2021-10-30,Merced,047,269075,41854,41428,1910,43338,586
2021-10-30,Modoc,049,8938,533,513,187,700,5
2021-10-30,Mono,051,14174,1721,1684,22,1706,3
2021-10-30,Monterey,053,433212,48701,47649,2896,50545,588
2021-10-30,Napa,055,140530,12970,12863,111,12974,101
2021-10-30,Nevada,057,99092,9171,9015,321,9336,91
2021-10-30,Orange,059,3164182,307124,304120,15180,319300,5588
2021-10-30,Placer,061,380077,37092,36400,3628,40028,434
2021-10-30,Plumas,063,18699,1776,1695,33,1728,7
2021-10-30,Riverside,065,2383286,363051,357645,16449,374094,5088
2021-10-30,Sacramento,067,1510023,158786,157125,4572,161697,2233
2021-10-30,San Benito,069,59416,7398,7362,168,7530,71
2021-10-30,San Bernardino,071,2135413,354005,350076,11168,361244,5777
2021-10-30,San Diego,073,3302833,373015,370006,21914,391920,4213
2021-10-30,San Francisco,075,870044,52899,52161,2330,54491,661
2021-10-30,San Joaquin,077,732212,99648,98314,5407,103721,1768
2021-10-30,San Luis Obispo,079,281455,29550,29053,1241,30294,341
2021-10-30,San Mateo,081,765935,54152,53083,875,53958,571
2021-10-30,Santa Barbara,083,443738,44389,43972,1552,45524,528
2021-10-30,Santa Clara,085,1922200,146961,145262,1341,146603,1903
2021-10-30,Santa Cruz,087,273765,20371,20134,1008,21142,221
2021-10-30,Shasta,089,179085,21367,20878,3578,24456,332
2021-10-30,Sierra,091,2930,184,175,20,195,0
2021-10-30,Siskiyou,093,43540,3333,3257,1283,4540,46
2021-10-30,Solano,095,438530,45929,45146,1264,46410,346
2021-10-30,Sonoma,097,501317,41419,40924,527,41451,393
2021-10-30,Stanislaus,099,539301,78226,77871,8851,86722,1191
2021-10-30,Sutter,101,95872,13856,13773,345,14118,178
2021-10-30,Tehama,103,63373,8492,8307,1478,9785,114
2021-10-30,Trinity,105,12862,854,708,216,924,11
2021-10-30,Tulare,107,460477,68419,66745,14954,81699,995
2021-10-30,Tuolumne,109,53932,7223,7050,95,7145,90
2021-10-30,Ventura,111,848112,98103,97182,4311,101493,1174
2021-10-30,Yolo,113,214977,19871,19568,1124,20692,250
2021-10-30,Yuba,115,75493,10116,9969,322,10291,82
2021-10-29,Alameda,001,1643700,119446,118632,2781,121413,1419
2021-10-29,Alpine,003,1148,101,105,0,105,0
2021-10-29,Amador,005,37829,5557,5480,61,5541,64
2021-10-29,Butte,007,227075,20915,20516,3763,24279,277
2021-10-29,Calaveras,009,45235,4066,3992,52,4044,82
2021-10-29,Colusa,011,21464,2513,2484,633,3117,19
2021-10-29,Contra Costa,013,1133247,99348,98562,2191,100753,1024
2021-10-29,Del Norte,015,27424,3674,3574,54,3628,42
2021-10-29,El Dorado,017,186661,16032,15752,1707,17459,154
2021-10-29,Fresno,019,978130,139730,136901,12739,149640,2131
2021-10-29,Glenn,021,27897,3493,3442,1008,4450,33
2021-10-29,Humboldt,023,135768,8983,8871,551,9422,105
2021-10-29,Imperial,025,180216,33562,33156,3190,36346,766
2021-10-29,Inyo,027,18085,2346,2249,42,2291,41
2021-10-29,Kern,029,883053,127163,124892,21989,146881,1653
2021-10-29,Kings,031,150075,32178,31578,1935,33513,337
2021-10-29,Lake,033,64148,6725,6610,145,6755,106
2021-10-29,Lassen,035,31185,6846,6719,364,7083,42
2021-10-29,Los Angeles,037,10098052,1437532,1424257,54149,1478406,26625
2021-10-29,Madera,039,155013,23036,22524,2098,24622,283
2021-10-29,Marin,041,260295,17538,17380,451,17831,247
2021-10-29,Mariposa,043,17540,1285,1228,46,1274,5
2021-10-29,Mendocino,045,87422,7508,7338,529,7867,84
2021-10-29,Merced,047,269075,41804,41428,1904,43332,586
2021-10-29,Modoc,049,8938,531,513,186,699,5
2021-10-29,Mono,051,14174,1719,1684,22,1706,3
2021-10-29,Monterey,053,433212,48678,47649,2896,50545,588
2021-10-29,Napa,055,140530,12949,12863,111,12974,101
2021-10-29,Nevada,057,99092,9159,9015,321,9336,91
2021-10-29,Orange,059,3164182,306899,304120,15160,319280,5588
2021-10-29,Placer,061,380077,37056,36400,3617,40017,434
2021-10-29,Plumas,063,18699,1770,1695,33,1728,7
2021-10-29,Riverside,065,2383286,362717,357645,16444,374089,5088
2021-10-29,Sacramento,067,1510023,158597,157125,4563,161688,2233
2021-10-29,San Benito,069,59416,7395,7362,168,7530,71
2021-10-29,San Bernardino,071,2135413,353706,350076,11157,361233,5777
2021-10-29,San Diego,073,3302833,372645,370006,21886,391892,4213
2021-10-29,San Francisco,075,870044,52839,52161,2324,54485,661
2021-10-29,San Joaquin,077,732212,99591,98314,5402,103716,1768
2021-10-29,San Luis Obispo,079,281455,29524,29053,1239,30292,341
2021-10-29,San Mateo,081,765935,54109,53083,873,53956,571
2021-10-29,Santa Barbara,083,443738,44349,43972,1549,45521,528
2021-10-29,Santa Clara,085,1922200,146846,145262,1334,146596,1903
2021-10-29,Santa Cruz,087,273765,20364,20134,1007,21141,221
2021-10-29,Shasta,089,179085,21329,20878,3572,24450,332
2021-10-29,Sierra,091,2930,182,175,20,195,0
2021-10-29,Siskiyou,093,43540,3333,3257,1282,4539,46
2021-10-29,Solano,095,438530,45892,45146,1263,46409,346
2021-10-29,Sonoma,097,501317,41398,40924,527,41451,393
2021-10-29,Stanislaus,099,539301,78141,77871,8839,86710,1191
2021-10-29,Sutter,101,95872,13837,13773,345,14118,178
2021-10-29,Tehama,103,63373,8479,8307,1477,9784,114
2021-10-29,Trinity,105,12862,853,708,216,924,11
2021-10-29,Tulare,107,460477,68314,66745,14909,81654,995
2021-10-29,Tuolumne,109,53932,7210,7050,95,7145,90
2021-10-29,Ventura,111,848112,98048,97182,4307,101489,1174
2021-10-29,Yolo,113,214977,19853,19568,1119,20687,250
2021-10-29,Yuba,115,75493,10108,9969,318,10287,82
2021-10-28,Alameda,001,1643700,119325,118632,2774,121406,1419
2021-10-28,Alpine,003,1148,101,105,0,105,0
2021-10-28,Amador,005,37829,5544,5480,61,5541,64
2021-10-28,Butte,007,227075,20872,20516,3754,24270,277
2021-10-28,Calaveras,009,45235,4053,3992,52,4044,82
2021-10-28,Colusa,011,21464,2510,2484,632,3116,19
2021-10-28,Contra Costa,013,1133247,99218,98562,2187,100749,1024
2021-10-28,Del Norte,015,27424,3673,3574,54,3628,42
2021-10-28,El Dorado,017,186661,16006,15752,1704,17456,154
2021-10-28,Fresno,019,978130,139397,136901,12706,149607,2131
2021-10-28,Glenn,021,27897,3490,3442,1006,4448,33
2021-10-28,Humboldt,023,135768,8967,8871,546,9417,105
2021-10-28,Imperial,025,180216,33496,33156,3183,36339,766
2021-10-28,Inyo,027,18085,2329,2249,42,2291,41
2021-10-28,Kern,029,883053,126916,124892,21875,146767,1653
2021-10-28,Kings,031,150075,32109,31578,1930,33508,337
2021-10-28,Lake,033,64148,6715,6610,145,6755,106
2021-10-28,Lassen,035,31185,6836,6719,360,7079,42
2021-10-28,Los Angeles,037,10098052,1436393,1424257,54076,1478333,26625
2021-10-28,Madera,039,155013,22982,22524,2087,24611,283
2021-10-28,Marin,041,260295,17520,17380,450,17830,247
2021-10-28,Mariposa,043,17540,1281,1228,46,1274,5
2021-10-28,Mendocino,045,87422,7495,7338,518,7856,84
2021-10-28,Merced,047,269075,41719,41428,1892,43320,586
2021-10-28,Modoc,049,8938,530,513,186,699,5
2021-10-28,Mono,051,14174,1713,1684,22,1706,3
2021-10-28,Monterey,053,433212,48647,47649,2879,50528,588
2021-10-28,Napa,055,140530,12940,12863,110,12973,101
2021-10-28,Nevada,057,99092,9141,9015,321,9336,91
2021-10-28,Orange,059,3164182,306611,304120,15095,319215,5588
2021-10-28,Placer,061,380077,36977,36400,3608,40008,434
2021-10-28,Plumas,063,18699,1762,1695,33,1728,7
2021-10-28,Riverside,065,2383286,362279,357645,16420,374065,5088
2021-10-28,Sacramento,067,1510023,158331,157125,4551,161676,2233
2021-10-28,San Benito,069,59416,7387,7362,168,7530,71
2021-10-28,San Bernardino,071,2135413,353291,350076,11135,361211,5777
2021-10-28,San Diego,073,3302833,372189,370006,21863,391869,4213
2021-10-28,San Francisco,075,870044,52793,52161,2317,54478,661
2021-10-28,San Joaquin,077,732212,99463,98314,5401,103715,1768
2021-10-28,San Luis Obispo,079,281455,29495,29053,1236,30289,341
2021-10-28,San Mateo,081,765935,54064,53083,871,53954,571
2021-10-28,Santa Barbara,083,443738,44310,43972,1547,45519,528
2021-10-28,Santa Clara,085,1922200,146689,145262,1329,146591,1903
2021-10-28,Santa Cruz,087,273765,20340,20134,1007,21141,221
2021-10-28,Shasta,089,179085,21255,20878,3565,24443,332
2021-10-28,Sierra,091,2930,181,175,20,195,0
2021-10-28,Siskiyou,093,43540,3332,3257,1282,4539,46
2021-10-28,Solano,095,438530,45853,45146,1262,46408,346
2021-10-28,Sonoma,097,501317,41330,40924,526,41450,393
2021-10-28,Stanislaus,099,539301,77988,77871,8823,86694,1191
2021-10-28,Sutter,101,95872,13824,13773,341,14114,178
2021-10-28,Tehama,103,63373,8442,8307,1474,9781,114
2021-10-28,Trinity,105,12862,850,708,216,924,11
2021-10-28,Tulare,107,460477,68175,66745,14853,81598,995
2021-10-28,Tuolumne,109,53932,7179,7050,95,7145,90
2021-10-28,Ventura,111,848112,97963,97182,4304,101486,1174
2021-10-28,Yolo,113,214977,19815,19568,1114,20682,250
2021-10-28,Yuba,115,75493,10079,9969,315,10284,82
2021-10-27,Alameda,001,1643700,119203,118487,2772,121259,1414
2021-10-27,Alpine,003,1148,101,105,0,105,0
2021-10-27,Amador,005,37829,5532,5470,60,5530,64
2021-10-27,Butte,007,227075,20828,20446,3739,24185,274
2021-10-27,Calaveras,009,45235,4035,3970,51,4021,82
2021-10-27,Colusa,011,21464,2509,2480,631,3111,18
2021-10-27,Contra Costa,013,1133247,99110,98442,2175,100617,1018
2021-10-27,Del Norte,015,27424,3666,3571,53,3624,42
2021-10-27,El Dorado,017,186661,15975,15723,1699,17422,154
2021-10-27,Fresno,019,978130,139015,136447,12672,149119,2128
2021-10-27,Glenn,021,27897,3488,3435,1005,4440,33
2021-10-27,Humboldt,023,135768,8947,8851,544,9395,105
2021-10-27,Imperial,025,180216,33456,33068,3178,36246,766
2021-10-27,Inyo,027,18085,2309,2236,42,2278,41
2021-10-27,Kern,029,883053,126647,124557,21775,146332,1647
2021-10-27,Kings,031,150075,32043,31437,1924,33361,335
2021-10-27,Lake,033,64148,6689,6589,145,6734,105
2021-10-27,Lassen,035,31185,6823,6706,358,7064,42
2021-10-27,Los Angeles,037,10098052,1435159,1422615,54018,1476633,26604
2021-10-27,Madera,039,155013,22897,22413,2063,24476,283
2021-10-27,Marin,041,260295,17505,17362,450,17812,247
2021-10-27,Mariposa,043,17540,1268,1228,46,1274,5
2021-10-27,Mendocino,045,87422,7481,7321,511,7832,84
2021-10-27,Merced,047,269075,41622,41310,1878,43188,583
2021-10-27,Modoc,049,8938,526,513,186,699,5
2021-10-27,Mono,051,14174,1710,1682,22,1704,3
2021-10-27,Monterey,053,433212,48610,47610,2858,50468,588
2021-10-27,Napa,055,140530,12925,12856,109,12965,101
2021-10-27,Nevada,057,99092,9123,8987,320,9307,90
2021-10-27,Orange,059,3164182,306289,303825,15045,318870,5584
2021-10-27,Placer,061,380077,36912,36296,3601,39897,434
2021-10-27,Plumas,063,18699,1754,1686,33,1719,7
2021-10-27,Riverside,065,2383286,361849,357152,16412,373564,5081
2021-10-27,Sacramento,067,1510023,158063,156830,4530,161360,2230
2021-10-27,San Benito,069,59416,7380,7337,168,7505,71
2021-10-27,San Bernardino,071,2135413,352867,349624,11113,360737,5770
2021-10-27,San Diego,073,3302833,371632,369579,21839,391418,4207
2021-10-27,San Francisco,075,870044,52742,52108,2313,54421,655
2021-10-27,San Joaquin,077,732212,99305,98168,5386,103554,1753
2021-10-27,San Luis Obispo,079,281455,29456,29002,1234,30236,341
2021-10-27,San Mateo,081,765935,54009,53032,863,53895,571
2021-10-27,Santa Barbara,083,443738,44257,43901,1544,45445,527
2021-10-27,Santa Clara,085,1922200,146512,145081,1321,146402,1902
2021-10-27,Santa Cruz,087,273765,20313,20091,1005,21096,221
2021-10-27,Shasta,089,179085,21179,20813,3557,24370,331
2021-10-27,Sierra,091,2930,180,176,20,196,0
2021-10-27,Siskiyou,093,43540,3329,3256,1278,4534,46
2021-10-27,Solano,095,438530,45808,45089,1254,46343,346
2021-10-27,Sonoma,097,501317,41254,40829,524,41353,393
2021-10-27,Stanislaus,099,539301,77828,77687,8808,86495,1191
2021-10-27,Sutter,101,95872,13810,13754,341,14095,177
2021-10-27,Tehama,103,63373,8420,8265,1472,9737,113
2021-10-27,Trinity,105,12862,850,706,215,921,11
2021-10-27,Tulare,107,460477,68021,66568,14795,81363,991
2021-10-27,Tuolumne,109,53932,7152,7009,94,7103,90
2021-10-27,Ventura,111,848112,97871,97108,4299,101407,1172
2021-10-27,Yolo,113,214977,19786,19517,1107,20624,250
2021-10-27,Yuba,115,75493,10058,9945,313,10258,82
2021-10-26,Alameda,001,1643700,119067,118360,2770,121130,1407
2021-10-26,Alpine,003,1148,101,105,0,105,0
2021-10-26,Amador,005,37829,5524,5465,59,5524,64
2021-10-26,Butte,007,227075,20769,20387,3722,24109,274
2021-10-26,Calaveras,009,45235,4024,3966,51,4017,81
2021-10-26,Colusa,011,21464,2507,2478,630,3108,18
2021-10-26,Contra Costa,013,1133247,98988,98352,2164,100516,1017
2021-10-26,Del Norte,015,27424,3661,3563,53,3616,42
2021-10-26,El Dorado,017,186661,15947,15690,1690,17380,153
2021-10-26,Fresno,019,978130,138566,136211,12627,148838,2122
2021-10-26,Glenn,021,27897,3473,3431,1002,4433,33
2021-10-26,Humboldt,023,135768,8929,8830,538,9368,105
2021-10-26,Imperial,025,180216,33391,33012,3173,36185,766
2021-10-26,Inyo,027,18085,2294,2200,42,2242,41
2021-10-26,Kern,029,883053,126304,124351,21655,146006,1645
2021-10-26,Kings,031,150075,31976,31382,1917,33299,336
2021-10-26,Lake,033,64148,6679,6584,143,6727,105
2021-10-26,Lassen,035,31185,6802,6689,356,7045,42
2021-10-26,Los Angeles,037,10098052,1433818,1421795,53948,1475743,26599
2021-10-26,Madera,039,155013,22807,22363,2052,24415,283
2021-10-26,Marin,041,260295,17488,17354,449,17803,244
2021-10-26,Mariposa,043,17540,1263,1225,45,1270,5
2021-10-26,Mendocino,045,87422,7452,7308,495,7803,83
2021-10-26,Merced,047,269075,41544,41267,1870,43137,583
2021-10-26,Modoc,049,8938,526,513,186,699,5
2021-10-26,Mono,051,14174,1705,1680,22,1702,3
2021-10-26,Monterey,053,433212,48571,47572,2848,50420,588
2021-10-26,Napa,055,140530,12913,12849,109,12958,101
2021-10-26,Nevada,057,99092,9092,8971,319,9290,90
2021-10-26,Orange,059,3164182,306019,303533,15006,318539,5580
2021-10-26,Placer,061,380077,36815,36245,3595,39840,434
2021-10-26,Plumas,063,18699,1745,1645,33,1678,7
2021-10-26,Riverside,065,2383286,361359,356775,16402,373177,5068
2021-10-26,Sacramento,067,1510023,157762,156643,4513,161156,2228
2021-10-26,San Benito,069,59416,7357,7325,168,7493,71
2021-10-26,San Bernardino,071,2135413,352444,349346,11098,360444,5764
2021-10-26,San Diego,073,3302833,371116,369043,21809,390852,4198
2021-10-26,San Francisco,075,870044,52667,52063,2310,54373,655
2021-10-26,San Joaquin,077,732212,99126,98036,5371,103407,1748
2021-10-26,San Luis Obispo,079,281455,29417,28928,1228,30156,337
2021-10-26,San Mateo,081,765935,53937,52974,860,53834,571
2021-10-26,Santa Barbara,083,443738,44211,43835,1543,45378,525
2021-10-26,Santa Clara,085,1922200,146313,144932,1315,146247,1903
2021-10-26,Santa Cruz,087,273765,20282,20067,1004,21071,221
2021-10-26,Shasta,089,179085,21118,20725,3539,24264,330
2021-10-26,Sierra,091,2930,180,169,20,189,0
2021-10-26,Siskiyou,093,43540,3323,3254,1276,4530,46
2021-10-26,Solano,095,438530,45752,45044,1253,46297,344
2021-10-26,Sonoma,097,501317,41172,40794,522,41316,393
2021-10-26,Stanislaus,099,539301,77654,77552,8783,86335,1157
2021-10-26,Sutter,101,95872,13781,13739,340,14079,176
2021-10-26,Tehama,103,63373,8392,8247,1466,9713,112
2021-10-26,Trinity,105,12862,846,705,215,920,11
2021-10-26,Tulare,107,460477,67861,66476,14734,81210,991
2021-10-26,Tuolumne,109,53932,7126,6995,92,7087,90
2021-10-26,Ventura,111,848112,97762,97014,4295,101309,1170
2021-10-26,Yolo,113,214977,19757,19490,1104,20594,248
2021-10-26,Yuba,115,75493,10040,9927,308,10235,82
2021-10-25,Alameda,001,1643700,118922,118319,2769,121088,1404
2021-10-25,Alpine,003,1148,101,105,0,105,0
2021-10-25,Amador,005,37829,5510,5455,59,5514,64
2021-10-25,Butte,007,227075,20696,20331,3714,24045,273
2021-10-25,Calaveras,009,45235,3994,3942,50,3992,82
2021-10-25,Colusa,011,21464,2505,2471,628,3099,18
2021-10-25,Contra Costa,013,1133247,98871,98267,2160,100427,1017
2021-10-25,Del Norte,015,27424,3654,3562,53,3615,42
2021-10-25,El Dorado,017,186661,15912,15663,1688,17351,149
2021-10-25,Fresno,019,978130,138131,135974,12588,148562,2112
2021-10-25,Glenn,021,27897,3470,3421,1001,4422,33
2021-10-25,Humboldt,023,135768,8906,8825,533,9358,105
2021-10-25,Imperial,025,180216,33330,32968,3162,36130,766
2021-10-25,Inyo,027,18085,2276,2183,42,2225,41
2021-10-25,Kern,029,883053,125952,124078,21516,145594,1649
2021-10-25,Kings,031,150075,31887,31329,1908,33237,335
2021-10-25,Lake,033,64148,6666,6571,143,6714,105
2021-10-25,Lassen,035,31185,6791,6688,354,7042,42
2021-10-25,Los Angeles,037,10098052,1432458,1421061,53881,1474942,26579
2021-10-25,Madera,039,155013,22753,22325,2045,24370,281
2021-10-25,Marin,041,260295,17466,17334,447,17781,244
2021-10-25,Mariposa,043,17540,1249,1220,45,1265,5
2021-10-25,Mendocino,045,87422,7422,7296,491,7787,82
2021-10-25,Merced,047,269075,41476,41207,1843,43050,583
2021-10-25,Modoc,049,8938,524,512,184,696,5
2021-10-25,Mono,051,14174,1697,1677,22,1699,3
2021-10-25,Monterey,053,433212,48538,47547,2846,50393,587
2021-10-25,Napa,055,140530,12900,12841,109,12950,100
2021-10-25,Nevada,057,99092,9066,8958,319,9277,90
2021-10-25,Orange,059,3164182,305722,303279,14968,318247,5574
2021-10-25,Placer,061,380077,36707,36153,3585,39738,431
2021-10-25,Plumas,063,18699,1733,1641,33,1674,7
2021-10-25,Riverside,065,2383286,360932,356381,16387,372768,5056
2021-10-25,Sacramento,067,1510023,157459,156516,4487,161003,2235
2021-10-25,San Benito,069,59416,7344,7314,167,7481,71
2021-10-25,San Bernardino,071,2135413,351948,349075,11086,360161,5748
2021-10-25,San Diego,073,3302833,370548,368386,21781,390167,4196
2021-10-25,San Francisco,075,870044,52594,52041,2303,54344,649
2021-10-25,San Joaquin,077,732212,98924,97980,5362,103342,1740
2021-10-25,San Luis Obispo,079,281455,29369,28907,1223,30130,336
2021-10-25,San Mateo,081,765935,53877,52927,856,53783,571
2021-10-25,Santa Barbara,083,443738,44152,43775,1543,45318,525
2021-10-25,Santa Clara,085,1922200,146122,144895,1310,146205,1901
2021-10-25,Santa Cruz,087,273765,20253,20053,1003,21056,221
2021-10-25,Shasta,089,179085,21046,20666,3532,24198,326
2021-10-25,Sierra,091,2930,180,168,20,188,0
2021-10-25,Siskiyou,093,43540,3319,3248,1271,4519,46
2021-10-25,Solano,095,438530,45691,45022,1251,46273,344
2021-10-25,Sonoma,097,501317,41099,40746,520,41266,393
2021-10-25,Stanislaus,099,539301,77462,77452,8754,86206,1145
2021-10-25,Sutter,101,95872,13768,13721,337,14058,176
2021-10-25,Tehama,103,63373,8365,8224,1462,9686,111
2021-10-25,Trinity,105,12862,841,699,214,913,11
2021-10-25,Tulare,107,460477,67666,66357,14672,81029,986
2021-10-25,Tuolumne,109,53932,7092,6952,90,7042,90
2021-10-25,Ventura,111,848112,97671,96932,4292,101224,1167
2021-10-25,Yolo,113,214977,19708,19457,1100,20557,248
2021-10-25,Yuba,115,75493,10024,9924,304,10228,82
2021-10-24,Alameda,001,1643700,118791,117816,2764,120580,1397
2021-10-24,Alpine,003,1148,101,105,0,105,0
2021-10-24,Amador,005,37829,5505,5412,59,5471,64
2021-10-24,Butte,007,227075,20623,20101,3702,23803,273
2021-10-24,Calaveras,009,45235,3975,3865,49,3914,81
2021-10-24,Colusa,011,21464,2501,2458,625,3083,18
2021-10-24,Contra Costa,013,1133247,98753,97855,2151,100006,1008
2021-10-24,Del Norte,015,27424,3650,3540,53,3593,42
2021-10-24,El Dorado,017,186661,15876,15540,1684,17224,149
2021-10-24,Fresno,019,978130,137695,134466,12539,147005,2094
2021-10-24,Glenn,021,27897,3463,3399,999,4398,33
2021-10-24,Humboldt,023,135768,8893,8753,527,9280,105
2021-10-24,Imperial,025,180216,33252,32777,3156,35933,766
2021-10-24,Inyo,027,18085,2244,2108,42,2150,41
2021-10-24,Kern,029,883053,125618,122939,21398,144337,1636
2021-10-24,Kings,031,150075,31758,30942,1892,32834,325
2021-10-24,Lake,033,64148,6643,6501,142,6643,105
2021-10-24,Lassen,035,31185,6774,6632,353,6985,27
2021-10-24,Los Angeles,037,10098052,1431020,1415919,53813,1469732,26527
2021-10-24,Madera,039,155013,22676,22062,2032,24094,281
2021-10-24,Marin,041,260295,17450,17264,446,17710,244
2021-10-24,Mariposa,043,17540,1246,1184,45,1229,5
2021-10-24,Mendocino,045,87422,7398,7220,481,7701,82
2021-10-24,Merced,047,269075,41355,40808,1837,42645,581
2021-10-24,Modoc,049,8938,523,507,184,691,5
2021-10-24,Mono,051,14174,1692,1655,22,1677,3
2021-10-24,Monterey,053,433212,48490,47456,2835,50291,586
2021-10-24,Napa,055,140530,12889,12789,109,12898,100
2021-10-24,Nevada,057,99092,9043,8861,316,9177,90
2021-10-24,Orange,059,3164182,305371,302237,14930,317167,5546
2021-10-24,Placer,061,380077,36603,35822,3571,39393,426
2021-10-24,Plumas,063,18699,1723,1623,32,1655,7
2021-10-24,Riverside,065,2383286,360458,354688,16367,371055,5041
2021-10-24,Sacramento,067,1510023,157118,155125,4464,159589,2232
2021-10-24,San Benito,069,59416,7324,7280,167,7447,71
2021-10-24,San Bernardino,071,2135413,351395,347681,11074,358755,5688
2021-10-24,San Diego,073,3302833,369965,366085,21750,387835,4183
2021-10-24,San Francisco,075,870044,52531,51820,2297,54117,649
2021-10-24,San Joaquin,077,732212,98751,97440,5356,102796,1721
2021-10-24,San Luis Obispo,079,281455,29308,28755,1216,29971,333
2021-10-24,San Mateo,081,765935,53805,52719,856,53575,571
2021-10-24,Santa Barbara,083,443738,44085,43552,1541,45093,523
2021-10-24,Santa Clara,085,1922200,145931,144276,1300,145576,1897
2021-10-24,Santa Cruz,087,273765,20215,19967,1002,20969,221
2021-10-24,Shasta,089,179085,20947,20386,3526,23912,321
2021-10-24,Sierra,091,2930,180,168,20,188,0
2021-10-24,Siskiyou,093,43540,3312,3231,1267,4498,46
2021-10-24,Solano,095,438530,45641,44861,1246,46107,341
2021-10-24,Sonoma,097,501317,41016,40476,520,40996,393
2021-10-24,Stanislaus,099,539301,77271,76812,8742,85554,1145
2021-10-24,Sutter,101,95872,13741,13616,329,13945,175
2021-10-24,Tehama,103,63373,8317,8105,1450,9555,110
2021-10-24,Trinity,105,12862,837,696,211,907,11
2021-10-24,Tulare,107,460477,67494,65585,14599,80184,978
2021-10-24,Tuolumne,109,53932,7052,6840,88,6928,90
2021-10-24,Ventura,111,848112,97564,96664,4291,100955,1167
2021-10-24,Yolo,113,214977,19659,19280,1097,20377,248
2021-10-24,Yuba,115,75493,9999,9838,303,10141,82
2021-10-23,Alameda,001,1643700,118703,117816,2759,120575,1397
2021-10-23,Alpine,003,1148,101,105,0,105,0
2021-10-23,Amador,005,37829,5498,5412,59,5471,64
2021-10-23,Butte,007,227075,20586,20101,3693,23794,273
2021-10-23,Calaveras,009,45235,3968,3865,48,3913,81
2021-10-23,Colusa,011,21464,2499,2458,624,3082,18
2021-10-23,Contra Costa,013,1133247,98701,97855,2147,100002,1008
2021-10-23,Del Norte,015,27424,3648,3540,53,3593,42
2021-10-23,El Dorado,017,186661,15850,15540,1682,17222,149
2021-10-23,Fresno,019,978130,137517,134466,12526,146992,2094
2021-10-23,Glenn,021,27897,3461,3399,998,4397,33
2021-10-23,Humboldt,023,135768,8879,8753,522,9275,105
2021-10-23,Imperial,025,180216,33205,32777,3152,35929,766
2021-10-23,Inyo,027,18085,2233,2108,42,2150,41
2021-10-23,Kern,029,883053,125458,122939,21310,144249,1636
2021-10-23,Kings,031,150075,31712,30942,1890,32832,325
2021-10-23,Lake,033,64148,6638,6501,142,6643,105
2021-10-23,Lassen,035,31185,6771,6632,351,6983,27
2021-10-23,Los Angeles,037,10098052,1430340,1415919,53758,1469677,26527
2021-10-23,Madera,039,155013,22627,22062,2024,24086,281
2021-10-23,Marin,041,260295,17433,17264,445,17709,244
2021-10-23,Mariposa,043,17540,1243,1184,44,1228,5
2021-10-23,Mendocino,045,87422,7391,7220,480,7700,82
2021-10-23,Merced,047,269075,41314,40808,1832,42640,581
2021-10-23,Modoc,049,8938,521,507,184,691,5
2021-10-23,Mono,051,14174,1686,1655,22,1677,3
2021-10-23,Monterey,053,433212,48473,47456,2831,50287,586
2021-10-23,Napa,055,140530,12884,12789,109,12898,100
2021-10-23,Nevada,057,99092,9032,8861,314,9175,90
2021-10-23,Orange,059,3164182,305185,302237,14914,317151,5546
2021-10-23,Placer,061,380077,36541,35822,3565,39387,426
2021-10-23,Plumas,063,18699,1722,1623,32,1655,7
2021-10-23,Riverside,065,2383286,360137,354688,16360,371048,5041
2021-10-23,Sacramento,067,1510023,156989,155125,4455,159580,2232
2021-10-23,San Benito,069,59416,7314,7280,167,7447,71
2021-10-23,San Bernardino,071,2135413,351125,347681,11067,358748,5688
2021-10-23,San Diego,073,3302833,369624,366085,21719,387804,4183
2021-10-23,San Francisco,075,870044,52496,51820,2296,54116,649
2021-10-23,San Joaquin,077,732212,98683,97440,5347,102787,1721
2021-10-23,San Luis Obispo,079,281455,29271,28755,1214,29969,333
2021-10-23,San Mateo,081,765935,53767,52719,855,53574,571
2021-10-23,Santa Barbara,083,443738,44054,43552,1539,45091,523
2021-10-23,Santa Clara,085,1922200,145823,144276,1296,145572,1897
2021-10-23,Santa Cruz,087,273765,20203,19967,1002,20969,221
2021-10-23,Shasta,089,179085,20911,20386,3514,23900,321
2021-10-23,Sierra,091,2930,179,168,20,188,0
2021-10-23,Siskiyou,093,43540,3310,3231,1267,4498,46
2021-10-23,Solano,095,438530,45616,44861,1243,46104,341
2021-10-23,Sonoma,097,501317,40976,40476,520,40996,393
2021-10-23,Stanislaus,099,539301,77182,76812,8722,85534,1145
2021-10-23,Sutter,101,95872,13735,13616,328,13944,175
2021-10-23,Tehama,103,63373,8305,8105,1449,9554,110
2021-10-23,Trinity,105,12862,836,696,211,907,11
2021-10-23,Tulare,107,460477,67406,65585,14540,80125,978
2021-10-23,Tuolumne,109,53932,7031,6840,88,6928,90
2021-10-23,Ventura,111,848112,97503,96664,4291,100955,1167
2021-10-23,Yolo,113,214977,19642,19280,1094,20374,248
2021-10-23,Yuba,115,75493,9991,9838,303,10141,82
2021-10-22,Alameda,001,1643700,118619,117816,2756,120572,1397
2021-10-22,Alpine,003,1148,101,105,0,105,0
2021-10-22,Amador,005,37829,5487,5412,59,5471,64
2021-10-22,Butte,007,227075,20554,20101,3689,23790,273
2021-10-22,Calaveras,009,45235,3960,3865,48,3913,81
2021-10-22,Colusa,011,21464,2496,2458,624,3082,18
2021-10-22,Contra Costa,013,1133247,98610,97855,2145,100000,1008
2021-10-22,Del Norte,015,27424,3644,3540,53,3593,42
2021-10-22,El Dorado,017,186661,15837,15540,1680,17220,149
2021-10-22,Fresno,019,978130,137301,134466,12504,146970,2094
2021-10-22,Glenn,021,27897,3451,3399,998,4397,33
2021-10-22,Humboldt,023,135768,8865,8753,521,9274,105
2021-10-22,Imperial,025,180216,33162,32777,3152,35929,766
2021-10-22,Inyo,027,18085,2220,2108,42,2150,41
2021-10-22,Kern,029,883053,125271,122939,21237,144176,1636
2021-10-22,Kings,031,150075,31677,30942,1889,32831,325
2021-10-22,Lake,033,64148,6628,6501,142,6643,105
2021-10-22,Lassen,035,31185,6764,6632,348,6980,27
2021-10-22,Los Angeles,037,10098052,1429587,1415919,53699,1469618,26527
2021-10-22,Madera,039,155013,22577,22062,2011,24073,281
2021-10-22,Marin,041,260295,17421,17264,445,17709,244
2021-10-22,Mariposa,043,17540,1240,1184,44,1228,5
2021-10-22,Mendocino,045,87422,7377,7220,479,7699,82
2021-10-22,Merced,047,269075,41277,40808,1825,42633,581
2021-10-22,Modoc,049,8938,521,507,184,691,5
2021-10-22,Mono,051,14174,1684,1655,22,1677,3
2021-10-22,Monterey,053,433212,48440,47456,2829,50285,586
2021-10-22,Napa,055,140530,12878,12789,109,12898,100
2021-10-22,Nevada,057,99092,9015,8861,313,9174,90
2021-10-22,Orange,059,3164182,304969,302237,14883,317120,5546
2021-10-22,Placer,061,380077,36513,35822,3556,39378,426
2021-10-22,Plumas,063,18699,1716,1623,32,1655,7
2021-10-22,Riverside,065,2383286,359826,354688,16355,371043,5041
2021-10-22,Sacramento,067,1510023,156803,155125,4445,159570,2232
2021-10-22,San Benito,069,59416,7309,7280,167,7447,71
2021-10-22,San Bernardino,071,2135413,350795,347681,11051,358732,5688
2021-10-22,San Diego,073,3302833,369226,366085,21701,387786,4183
2021-10-22,San Francisco,075,870044,52461,51820,2289,54109,649
2021-10-22,San Joaquin,077,732212,98624,97440,5344,102784,1721
2021-10-22,San Luis Obispo,079,281455,29241,28755,1214,29969,333
2021-10-22,San Mateo,081,765935,53715,52719,848,53567,571
2021-10-22,Santa Barbara,083,443738,44013,43552,1539,45091,523
2021-10-22,Santa Clara,085,1922200,145667,144276,1289,145565,1897
2021-10-22,Santa Cruz,087,273765,20181,19967,1002,20969,221
2021-10-22,Shasta,089,179085,20878,20386,3511,23897,321
2021-10-22,Sierra,091,2930,178,168,19,187,0
2021-10-22,Siskiyou,093,43540,3308,3231,1264,4495,46
2021-10-22,Solano,095,438530,45581,44861,1239,46100,341
2021-10-22,Sonoma,097,501317,40919,40476,520,40996,393
2021-10-22,Stanislaus,099,539301,77079,76812,8704,85516,1145
2021-10-22,Sutter,101,95872,13720,13616,328,13944,175
2021-10-22,Tehama,103,63373,8283,8105,1444,9549,110
2021-10-22,Trinity,105,12862,835,696,211,907,11
2021-10-22,Tulare,107,460477,67320,65585,14486,80071,978
2021-10-22,Tuolumne,109,53932,6996,6840,88,6928,90
2021-10-22,Ventura,111,848112,97450,96664,4285,100949,1167
2021-10-22,Yolo,113,214977,19615,19280,1092,20372,248
2021-10-22,Yuba,115,75493,9977,9838,301,10139,82
2021-10-21,Alameda,001,1643700,118503,117816,2751,120567,1397
2021-10-21,Alpine,003,1148,101,105,0,105,0
2021-10-21,Amador,005,37829,5479,5412,59,5471,64
2021-10-21,Butte,007,227075,20470,20101,3676,23777,273
2021-10-21,Calaveras,009,45235,3941,3865,48,3913,81
2021-10-21,Colusa,011,21464,2492,2458,620,3078,18
2021-10-21,Contra Costa,013,1133247,98495,97855,2139,99994,1008
2021-10-21,Del Norte,015,27424,3638,3540,52,3592,42
2021-10-21,El Dorado,017,186661,15809,15540,1673,17213,149
2021-10-21,Fresno,019,978130,136951,134466,12460,146926,2094
2021-10-21,Glenn,021,27897,3447,3399,995,4394,33
2021-10-21,Humboldt,023,135768,8851,8753,517,9270,105
2021-10-21,Imperial,025,180216,33107,32777,3148,35925,766
2021-10-21,Inyo,027,18085,2198,2108,42,2150,41
2021-10-21,Kern,029,883053,125023,122939,21126,144065,1636
2021-10-21,Kings,031,150075,31579,30942,1883,32825,325
2021-10-21,Lake,033,64148,6614,6501,141,6642,105
2021-10-21,Lassen,035,31185,6751,6632,344,6976,27
2021-10-21,Los Angeles,037,10098052,1428473,1415919,53649,1469568,26527
2021-10-21,Madera,039,155013,22519,22062,2001,24063,281
2021-10-21,Marin,041,260295,17403,17264,445,17709,244
2021-10-21,Mariposa,043,17540,1234,1184,43,1227,5
2021-10-21,Mendocino,045,87422,7359,7220,472,7692,82
2021-10-21,Merced,047,269075,41180,40808,1814,42622,581
2021-10-21,Modoc,049,8938,521,507,184,691,5
2021-10-21,Mono,051,14174,1675,1655,22,1677,3
2021-10-21,Monterey,053,433212,48406,47456,2817,50273,586
2021-10-21,Napa,055,140530,12866,12789,109,12898,100
2021-10-21,Nevada,057,99092,8990,8861,313,9174,90
2021-10-21,Orange,059,3164182,304697,302237,14847,317084,5546
2021-10-21,Placer,061,380077,36424,35822,3543,39365,426
2021-10-21,Plumas,063,18699,1702,1623,32,1655,7
2021-10-21,Riverside,065,2383286,359381,354688,16344,371032,5041
2021-10-21,Sacramento,067,1510023,156484,155125,4419,159544,2232
2021-10-21,San Benito,069,59416,7302,7280,165,7445,71
2021-10-21,San Bernardino,071,2135413,350415,347681,11016,358697,5688
2021-10-21,San Diego,073,3302833,368715,366085,21671,387756,4183
2021-10-21,San Francisco,075,870044,52406,51820,2288,54108,649
2021-10-21,San Joaquin,077,732212,98485,97440,5337,102777,1721
2021-10-21,San Luis Obispo,079,281455,29199,28755,1212,29967,333
2021-10-21,San Mateo,081,765935,53668,52719,847,53566,571
2021-10-21,Santa Barbara,083,443738,43947,43552,1537,45089,523
2021-10-21,Santa Clara,085,1922200,145496,144276,1285,145561,1897
2021-10-21,Santa Cruz,087,273765,20157,19967,1000,20967,221
2021-10-21,Shasta,089,179085,20817,20386,3496,23882,321
2021-10-21,Sierra,091,2930,177,168,18,186,0
2021-10-21,Siskiyou,093,43540,3303,3231,1262,4493,46
2021-10-21,Solano,095,438530,45529,44861,1237,46098,341
2021-10-21,Sonoma,097,501317,40850,40476,518,40994,393
2021-10-21,Stanislaus,099,539301,76910,76812,8693,85505,1145
2021-10-21,Sutter,101,95872,13692,13616,324,13940,175
2021-10-21,Tehama,103,63373,8256,8105,1437,9542,110
2021-10-21,Trinity,105,12862,833,696,211,907,11
2021-10-21,Tulare,107,460477,67130,65585,14415,80000,978
2021-10-21,Tuolumne,109,53932,6958,6840,87,6927,90
2021-10-21,Ventura,111,848112,97359,96664,4283,100947,1167
2021-10-21,Yolo,113,214977,19568,19280,1090,20370,248
2021-10-21,Yuba,115,75493,9953,9838,300,10138,82
2021-10-20,Alameda,001,1643700,118383,117654,2751,120405,1390
2021-10-20,Alpine,003,1148,101,103,0,103,0
2021-10-20,Amador,005,37829,5471,5379,59,5438,64
2021-10-20,Butte,007,227075,20416,20021,3661,23682,270
2021-10-20,Calaveras,009,45235,3921,3844,47,3891,81
2021-10-20,Colusa,011,21464,2488,2454,618,3072,18
2021-10-20,Contra Costa,013,1133247,98379,97721,2135,99856,1008
2021-10-20,Del Norte,015,27424,3634,3536,52,3588,42
2021-10-20,El Dorado,017,186661,15779,15502,1670,17172,149
2021-10-20,Fresno,019,978130,136549,134025,12423,146448,2084
2021-10-20,Glenn,021,27897,3439,3382,994,4376,33
2021-10-20,Humboldt,023,135768,8829,8727,515,9242,105
2021-10-20,Imperial,025,180216,33033,32705,3140,35845,766
2021-10-20,Inyo,027,18085,2178,2077,41,2118,40
2021-10-20,Kern,029,883053,124729,122630,21005,143635,1623
2021-10-20,Kings,031,150075,31502,30805,1873,32678,322
2021-10-20,Lake,033,64148,6592,6475,140,6615,104
2021-10-20,Lassen,035,31185,6736,6622,344,6966,27
2021-10-20,Los Angeles,037,10098052,1427362,1414931,53578,1468509,26506
2021-10-20,Madera,039,155013,22449,21983,1992,23975,281
2021-10-20,Marin,041,260295,17382,17250,443,17693,244
2021-10-20,Mariposa,043,17540,1227,1174,43,1217,5
2021-10-20,Mendocino,045,87422,7331,7189,469,7658,82
2021-10-20,Merced,047,269075,41099,40685,1797,42482,581
2021-10-20,Modoc,049,8938,521,504,184,688,5
2021-10-20,Mono,051,14174,1675,1653,22,1675,3
2021-10-20,Monterey,053,433212,48374,47430,2808,50238,587
2021-10-20,Napa,055,140530,12852,12773,108,12881,100
2021-10-20,Nevada,057,99092,8962,8836,313,9149,90
2021-10-20,Orange,059,3164182,304411,301957,14825,316782,5534
2021-10-20,Placer,061,380077,36334,35729,3534,39263,425
2021-10-20,Plumas,063,18699,1695,1604,32,1636,7
2021-10-20,Riverside,065,2383286,358937,354311,16327,370638,5030
2021-10-20,Sacramento,067,1510023,156184,154822,4396,159218,2222
2021-10-20,San Benito,069,59416,7299,7275,163,7438,71
2021-10-20,San Bernardino,071,2135413,350013,347217,10985,358202,5663
2021-10-20,San Diego,073,3302833,368207,365698,21652,387350,4178
2021-10-20,San Francisco,075,870044,52357,51755,2287,54042,646
2021-10-20,San Joaquin,077,732212,98340,97246,5329,102575,1721
2021-10-20,San Luis Obispo,079,281455,29154,28727,1208,29935,332
2021-10-20,San Mateo,081,765935,53597,52663,839,53502,571
2021-10-20,Santa Barbara,083,443738,43884,43489,1536,45025,523
2021-10-20,Santa Clara,085,1922200,145361,144124,1280,145404,1896
2021-10-20,Santa Cruz,087,273765,20144,19951,1000,20951,219
2021-10-20,Shasta,089,179085,20755,20313,3469,23782,320
2021-10-20,Sierra,091,2930,177,168,18,186,0
2021-10-20,Siskiyou,093,43540,3303,3224,1256,4480,46
2021-10-20,Solano,095,438530,45497,44819,1235,46054,341
2021-10-20,Sonoma,097,501317,40803,40404,518,40922,393
2021-10-20,Stanislaus,099,539301,76760,76631,8674,85305,1145
2021-10-20,Sutter,101,95872,13668,13592,318,13910,175
2021-10-20,Tehama,103,63373,8225,8081,1426,9507,110
2021-10-20,Trinity,105,12862,833,693,210,903,11
2021-10-20,Tulare,107,460477,66956,65413,14369,79782,967
2021-10-20,Tuolumne,109,53932,6935,6803,87,6890,89
2021-10-20,Ventura,111,848112,97277,96610,4279,100889,1166
2021-10-20,Yolo,113,214977,19524,19236,1087,20323,248
2021-10-20,Yuba,115,75493,9936,9808,297,10105,82
2021-10-19,Alameda,001,1643700,118262,117542,2745,120287,1383
2021-10-19,Alpine,003,1148,101,103,0,103,0
2021-10-19,Amador,005,37829,5455,5367,59,5426,64
2021-10-19,Butte,007,227075,20363,19974,3653,23627,268
2021-10-19,Calaveras,009,45235,3904,3826,46,3872,80
2021-10-19,Colusa,011,21464,2485,2447,616,3063,18
2021-10-19,Contra Costa,013,1133247,98288,97613,2130,99743,1004
2021-10-19,Del Norte,015,27424,3627,3531,52,3583,42
2021-10-19,El Dorado,017,186661,15754,15478,1665,17143,149
2021-10-19,Fresno,019,978130,136185,133813,12375,146188,2073
2021-10-19,Glenn,021,27897,3436,3380,992,4372,33
2021-10-19,Humboldt,023,135768,8805,8714,509,9223,105
2021-10-19,Imperial,025,180216,32967,32632,3136,35768,764
2021-10-19,Inyo,027,18085,2147,2045,41,2086,40
2021-10-19,Kern,029,883053,124412,122391,20881,143272,1613
2021-10-19,Kings,031,150075,31408,30757,1866,32623,322
2021-10-19,Lake,033,64148,6588,6465,140,6605,104
2021-10-19,Lassen,035,31185,6730,6612,340,6952,27
2021-10-19,Los Angeles,037,10098052,1426120,1413882,53502,1467384,26473
2021-10-19,Madera,039,155013,22386,21950,1984,23934,281
2021-10-19,Marin,041,260295,17368,17241,440,17681,244
2021-10-19,Mariposa,043,17540,1221,1171,41,1212,5
2021-10-19,Mendocino,045,87422,7316,7172,466,7638,82
2021-10-19,Merced,047,269075,40984,40628,1776,42404,580
2021-10-19,Modoc,049,8938,519,502,184,686,5
2021-10-19,Mono,051,14174,1671,1651,22,1673,3
2021-10-19,Monterey,053,433212,48337,47412,2797,50209,583
2021-10-19,Napa,055,140530,12845,12769,108,12877,100
2021-10-19,Nevada,057,99092,8941,8829,312,9141,90
2021-10-19,Orange,059,3164182,304154,301700,14791,316491,5527
2021-10-19,Placer,061,380077,36213,35663,3519,39182,422
2021-10-19,Plumas,063,18699,1677,1586,32,1618,8
2021-10-19,Riverside,065,2383286,358515,353891,16319,370210,5020
2021-10-19,Sacramento,067,1510023,155878,154570,4370,158940,2227
2021-10-19,San Benito,069,59416,7283,7264,163,7427,71
2021-10-19,San Bernardino,071,2135413,349611,346814,10956,357770,5627
2021-10-19,San Diego,073,3302833,367626,365285,21621,386906,4170
2021-10-19,San Francisco,075,870044,52294,51704,2285,53989,645
2021-10-19,San Joaquin,077,732212,98173,97105,5318,102423,1721
2021-10-19,San Luis Obispo,079,281455,29106,28670,1205,29875,332
2021-10-19,San Mateo,081,765935,53539,52617,837,53454,571
2021-10-19,Santa Barbara,083,443738,43817,43413,1534,44947,522
2021-10-19,Santa Clara,085,1922200,145188,143989,1272,145261,1898
2021-10-19,Santa Cruz,087,273765,20120,19895,998,20893,218
2021-10-19,Shasta,089,179085,20679,20209,3461,23670,319
2021-10-19,Sierra,091,2930,174,168,18,186,0
2021-10-19,Siskiyou,093,43540,3299,3216,1251,4467,46
2021-10-19,Solano,095,438530,45455,44782,1229,46011,341
2021-10-19,Sonoma,097,501317,40729,40379,517,40896,392
2021-10-19,Stanislaus,099,539301,76618,76526,8662,85188,1145
2021-10-19,Sutter,101,95872,13644,13569,317,13886,174
2021-10-19,Tehama,103,63373,8195,8057,1410,9467,108
2021-10-19,Trinity,105,12862,826,691,210,901,11
2021-10-19,Tulare,107,460477,66768,65253,14300,79553,958
2021-10-19,Tuolumne,109,53932,6906,6782,86,6868,89
2021-10-19,Ventura,111,848112,97201,96539,4274,100813,1166
2021-10-19,Yolo,113,214977,19479,19206,1082,20288,248
2021-10-19,Yuba,115,75493,9918,9796,296,10092,82
2021-10-18,Alameda,001,1643700,118125,117506,2736,120242,1381
2021-10-18,Alpine,003,1148,101,103,0,103,0
2021-10-18,Amador,005,37829,5444,5345,59,5404,64
2021-10-18,Butte,007,227075,20312,19921,3645,23566,265
2021-10-18,Calaveras,009,45235,3879,3819,45,3864,80
2021-10-18,Colusa,011,21464,2484,2444,614,3058,18
2021-10-18,Contra Costa,013,1133247,98177,97585,2126,99711,995
2021-10-18,Del Norte,015,27424,3620,3529,52,3581,41
2021-10-18,El Dorado,017,186661,15723,15452,1663,17115,149
2021-10-18,Fresno,019,978130,135783,133688,12332,146020,2063
2021-10-18,Glenn,021,27897,3432,3370,988,4358,32
2021-10-18,Humboldt,023,135768,8786,8699,501,9200,104
2021-10-18,Imperial,025,180216,32876,32558,3136,35694,764
2021-10-18,Inyo,027,18085,2129,2020,41,2061,40
2021-10-18,Kern,029,883053,124113,122231,20786,143017,1605
2021-10-18,Kings,031,150075,31293,30698,1853,32551,320
2021-10-18,Lake,033,64148,6569,6455,136,6591,104
2021-10-18,Lassen,035,31185,6710,6607,337,6944,26
2021-10-18,Los Angeles,037,10098052,1424878,1413291,53426,1466717,26446
2021-10-18,Madera,039,155013,22332,21909,1971,23880,277
2021-10-18,Marin,041,260295,17348,17232,437,17669,244
2021-10-18,Mariposa,043,17540,1213,1160,41,1201,5
2021-10-18,Mendocino,045,87422,7297,7156,458,7614,82
2021-10-18,Merced,047,269075,40861,40573,1765,42338,579
2021-10-18,Modoc,049,8938,519,498,184,682,5
2021-10-18,Mono,051,14174,1665,1648,21,1669,3
2021-10-18,Monterey,053,433212,48315,47389,2792,50181,583
2021-10-18,Napa,055,140530,12830,12762,108,12870,100
2021-10-18,Nevada,057,99092,8922,8816,312,9128,90
2021-10-18,Orange,059,3164182,303814,301573,14757,316330,5524
2021-10-18,Placer,061,380077,36136,35598,3515,39113,420
2021-10-18,Plumas,063,18699,1669,1579,32,1611,6
2021-10-18,Riverside,065,2383286,358100,353699,16305,370004,5008
2021-10-18,Sacramento,067,1510023,155573,154428,4338,158766,2203
2021-10-18,San Benito,069,59416,7271,7253,163,7416,71
2021-10-18,San Bernardino,071,2135413,349189,346742,10941,357683,5606
2021-10-18,San Diego,073,3302833,367071,364948,21583,386531,4169
2021-10-18,San Francisco,075,870044,52231,51671,2279,53950,644
2021-10-18,San Joaquin,077,732212,98007,97041,5308,102349,1721
2021-10-18,San Luis Obispo,079,281455,29067,28644,1202,29846,331
2021-10-18,San Mateo,081,765935,53474,52594,836,53430,571
2021-10-18,Santa Barbara,083,443738,43758,43386,1532,44918,522
2021-10-18,Santa Clara,085,1922200,145033,143891,1263,145154,1895
2021-10-18,Santa Cruz,087,273765,20106,19876,996,20872,218
2021-10-18,Shasta,089,179085,20599,20146,3450,23596,313
2021-10-18,Sierra,091,2930,174,166,18,184,0
2021-10-18,Siskiyou,093,43540,3296,3210,1243,4453,42
2021-10-18,Solano,095,438530,45411,44758,1226,45984,339
2021-10-18,Sonoma,097,501317,40665,40349,514,40863,392
2021-10-18,Stanislaus,099,539301,76454,76466,8648,85114,1145
2021-10-18,Sutter,101,95872,13610,13557,315,13872,172
2021-10-18,Tehama,103,63373,8160,8042,1398,9440,107
2021-10-18,Trinity,105,12862,825,688,210,898,11
2021-10-18,Tulare,107,460477,66591,65171,14235,79406,958
2021-10-18,Tuolumne,109,53932,6877,6755,86,6841,89
2021-10-18,Ventura,111,848112,97106,96506,4271,100777,1165
2021-10-18,Yolo,113,214977,19441,19197,1079,20276,248
2021-10-18,Yuba,115,75493,9891,9782,294,10076,82
2021-10-17,Alameda,001,1643700,117972,117423,2731,120154,1376
2021-10-17,Alpine,003,1148,101,103,0,103,0
2021-10-17,Amador,005,37829,5421,5341,58,5399,64
2021-10-17,Butte,007,227075,20227,19897,3635,23532,265
2021-10-17,Calaveras,009,45235,3863,3805,45,3850,80
2021-10-17,Colusa,011,21464,2479,2442,607,3049,18
2021-10-17,Contra Costa,013,1133247,98055,97485,2115,99600,995
2021-10-17,Del Norte,015,27424,3615,3526,52,3578,41
2021-10-17,El Dorado,017,186661,15665,15438,1656,17094,149
2021-10-17,Fresno,019,978130,135316,133429,12289,145718,2063
2021-10-17,Glenn,021,27897,3422,3364,983,4347,32
2021-10-17,Humboldt,023,135768,8766,8690,498,9188,104
2021-10-17,Imperial,025,180216,32793,32520,3129,35649,764
2021-10-17,Inyo,027,18085,2101,2000,41,2041,40
2021-10-17,Kern,029,883053,123763,122085,20686,142771,1603
2021-10-17,Kings,031,150075,31180,30636,1844,32480,315
2021-10-17,Lake,033,64148,6553,6437,136,6573,104
2021-10-17,Lassen,035,31185,6698,6605,333,6938,26
2021-10-17,Los Angeles,037,10098052,1423540,1412371,53350,1465721,26443
2021-10-17,Madera,039,155013,22270,21869,1960,23829,277
2021-10-17,Marin,041,260295,17326,17211,437,17648,243
2021-10-17,Mariposa,043,17540,1206,1150,41,1191,5
2021-10-17,Mendocino,045,87422,7268,7148,452,7600,82
2021-10-17,Merced,047,269075,40735,40531,1749,42280,579
2021-10-17,Modoc,049,8938,516,498,182,680,5
2021-10-17,Mono,051,14174,1663,1640,20,1660,3
2021-10-17,Monterey,053,433212,48274,47369,2782,50151,583
2021-10-17,Napa,055,140530,12815,12753,105,12858,100
2021-10-17,Nevada,057,99092,8905,8794,311,9105,90
2021-10-17,Orange,059,3164182,303499,301414,14724,316138,5524
2021-10-17,Placer,061,380077,36036,35559,3500,39059,420
2021-10-17,Plumas,063,18699,1645,1571,31,1602,6
2021-10-17,Riverside,065,2383286,357616,353500,16291,369791,5008
2021-10-17,Sacramento,067,1510023,155173,154080,4320,158400,2213
2021-10-17,San Benito,069,59416,7262,7250,162,7412,71
2021-10-17,San Bernardino,071,2135413,348756,346524,10921,357445,5597
2021-10-17,San Diego,073,3302833,366480,364675,21555,386230,4163
2021-10-17,San Francisco,075,870044,52159,51625,2270,53895,644
2021-10-17,San Joaquin,077,732212,97834,96950,5299,102249,1721
2021-10-17,San Luis Obispo,079,281455,29015,28604,1194,29798,331
2021-10-17,San Mateo,081,765935,53422,52541,832,53373,571
2021-10-17,Santa Barbara,083,443738,43695,43344,1531,44875,522
2021-10-17,Santa Clara,085,1922200,144856,143768,1254,145022,1895
2021-10-17,Santa Cruz,087,273765,20078,19861,994,20855,218
2021-10-17,Shasta,089,179085,20509,20116,3440,23556,312
2021-10-17,Sierra,091,2930,172,165,18,183,0
2021-10-17,Siskiyou,093,43540,3288,3204,1240,4444,42
2021-10-17,Solano,095,438530,45354,44722,1225,45947,340
2021-10-17,Sonoma,097,501317,40589,40306,513,40819,392
2021-10-17,Stanislaus,099,539301,76257,76354,8633,84987,1145
2021-10-17,Sutter,101,95872,13593,13543,313,13856,172
2021-10-17,Tehama,103,63373,8128,8015,1381,9396,107
2021-10-17,Trinity,105,12862,822,686,209,895,11
2021-10-17,Tulare,107,460477,66406,65057,14161,79218,958
2021-10-17,Tuolumne,109,53932,6843,6735,85,6820,89
2021-10-17,Ventura,111,848112,97006,96458,4268,100726,1165
2021-10-17,Yolo,113,214977,19399,19171,1070,20241,248
2021-10-17,Yuba,115,75493,9865,9771,292,10063,82
2021-10-16,Alameda,001,1643700,117882,117027,2729,119756,1365
2021-10-16,Alpine,003,1148,100,102,0,102,0
2021-10-16,Amador,005,37829,5414,5310,58,5368,64
2021-10-16,Butte,007,227075,20196,19612,3628,23240,260
2021-10-16,Calaveras,009,45235,3856,3771,45,3816,80
2021-10-16,Colusa,011,21464,2475,2431,604,3035,18
2021-10-16,Contra Costa,013,1133247,97963,97107,2108,99215,982
2021-10-16,Del Norte,015,27424,3612,3516,52,3568,41
2021-10-16,El Dorado,017,186661,15644,15315,1654,16969,149
2021-10-16,Fresno,019,978130,135163,132433,12272,144705,2051
2021-10-16,Glenn,021,27897,3416,3331,983,4314,26
2021-10-16,Humboldt,023,135768,8754,8621,493,9114,104
2021-10-16,Imperial,025,180216,32778,32368,3127,35495,764
2021-10-16,Inyo,027,18085,2087,1932,41,1973,39
2021-10-16,Kern,029,883053,123607,121354,20604,141958,1590
2021-10-16,Kings,031,150075,31134,30418,1841,32259,314
2021-10-16,Lake,033,64148,6542,6378,136,6514,104
2021-10-16,Lassen,035,31185,6689,6559,328,6887,26
2021-10-16,Los Angeles,037,10098052,1422884,1409418,53296,1462714,26398
2021-10-16,Madera,039,155013,22226,21707,1956,23663,277
2021-10-16,Marin,041,260295,17316,17148,437,17585,243
2021-10-16,Mariposa,043,17540,1203,1096,41,1137,5
2021-10-16,Mendocino,045,87422,7257,7099,452,7551,82
2021-10-16,Merced,047,269075,40703,40265,1747,42012,577
2021-10-16,Modoc,049,8938,513,492,182,674,5
2021-10-16,Mono,051,14174,1659,1628,20,1648,3
2021-10-16,Monterey,053,433212,48257,47293,2774,50067,582
2021-10-16,Napa,055,140530,12804,12706,105,12811,100
2021-10-16,Nevada,057,99092,8885,8739,311,9050,90
2021-10-16,Orange,059,3164182,303323,300722,14699,315421,5509
2021-10-16,Placer,061,380077,35952,35343,3494,38837,412
2021-10-16,Plumas,063,18699,1640,1542,30,1572,6
2021-10-16,Riverside,065,2383286,357346,352435,16279,368714,4990
2021-10-16,Sacramento,067,1510023,154973,153264,4316,157580,2192
2021-10-16,San Benito,069,59416,7249,7210,161,7371,71
2021-10-16,San Bernardino,071,2135413,348548,345418,10913,356331,5566
2021-10-16,San Diego,073,3302833,366164,363109,21539,384648,4151
2021-10-16,San Francisco,075,870044,52112,51436,2266,53702,645
2021-10-16,San Joaquin,077,732212,97762,96507,5296,101803,1708
2021-10-16,San Luis Obispo,079,281455,28989,28460,1193,29653,329
2021-10-16,San Mateo,081,765935,53373,52399,831,53230,569
2021-10-16,Santa Barbara,083,443738,43659,43175,1530,44705,521
2021-10-16,Santa Clara,085,1922200,144756,143282,1246,144528,1890
2021-10-16,Santa Cruz,087,273765,20063,19794,993,20787,218
2021-10-16,Shasta,089,179085,20459,19932,3429,23361,309
2021-10-16,Sierra,091,2930,170,160,18,178,0
2021-10-16,Siskiyou,093,43540,3286,3173,1233,4406,42
2021-10-16,Solano,095,438530,45328,44585,1221,45806,334
2021-10-16,Sonoma,097,501317,40549,40195,513,40708,390
2021-10-16,Stanislaus,099,539301,76171,75868,8623,84491,1142
2021-10-16,Sutter,101,95872,13574,13471,312,13783,169
2021-10-16,Tehama,103,63373,8115,7907,1376,9283,104
2021-10-16,Trinity,105,12862,822,679,209,888,11
2021-10-16,Tulare,107,460477,66268,64489,14129,78618,951
2021-10-16,Tuolumne,109,53932,6811,6666,85,6751,89
2021-10-16,Ventura,111,848112,96974,96181,4263,100444,1164
2021-10-16,Yolo,113,214977,19372,19078,1064,20142,247
2021-10-16,Yuba,115,75493,9841,9705,289,9994,82
2021-10-15,Alameda,001,1643700,117810,117027,2725,119752,1365
2021-10-15,Alpine,003,1148,100,102,0,102,0
2021-10-15,Amador,005,37829,5390,5310,58,5368,64
2021-10-15,Butte,007,227075,20160,19612,3621,23233,260
2021-10-15,Calaveras,009,45235,3850,3771,45,3816,80
2021-10-15,Colusa,011,21464,2473,2431,601,3032,18
2021-10-15,Contra Costa,013,1133247,97881,97107,2104,99211,982
2021-10-15,Del Norte,015,27424,3610,3516,52,3568,41
2021-10-15,El Dorado,017,186661,15624,15315,1649,16964,149
2021-10-15,Fresno,019,978130,134909,132433,12263,144696,2051
2021-10-15,Glenn,021,27897,3410,3331,982,4313,26
2021-10-15,Humboldt,023,135768,8745,8621,491,9112,104
2021-10-15,Imperial,025,180216,32731,32368,3123,35491,764
2021-10-15,Inyo,027,18085,2069,1932,41,1973,39
2021-10-15,Kern,029,883053,123471,121354,20529,141883,1590
2021-10-15,Kings,031,150075,31079,30418,1837,32255,314
2021-10-15,Lake,033,64148,6533,6378,136,6514,104
2021-10-15,Lassen,035,31185,6677,6559,327,6886,26
2021-10-15,Los Angeles,037,10098052,1422190,1409418,53247,1462665,26398
2021-10-15,Madera,039,155013,22182,21707,1948,23655,277
2021-10-15,Marin,041,260295,17305,17148,437,17585,243
2021-10-15,Mariposa,043,17540,1195,1096,41,1137,5
2021-10-15,Mendocino,045,87422,7242,7099,452,7551,82
2021-10-15,Merced,047,269075,40673,40265,1744,42009,577
2021-10-15,Modoc,049,8938,512,492,182,674,5
2021-10-15,Mono,051,14174,1656,1628,20,1648,3
2021-10-15,Monterey,053,433212,48235,47293,2772,50065,582
2021-10-15,Napa,055,140530,12800,12706,105,12811,100
2021-10-15,Nevada,057,99092,8870,8739,311,9050,90
2021-10-15,Orange,059,3164182,303155,300722,14681,315403,5509
2021-10-15,Placer,061,380077,35898,35343,3488,38831,412
2021-10-15,Plumas,063,18699,1632,1542,30,1572,6
2021-10-15,Riverside,065,2383286,357104,352435,16274,368709,4990
2021-10-15,Sacramento,067,1510023,154786,153264,4306,157570,2192
2021-10-15,San Benito,069,59416,7246,7210,161,7371,71
2021-10-15,San Bernardino,071,2135413,348314,345418,10910,356328,5566
2021-10-15,San Diego,073,3302833,365804,363109,21514,384623,4151
2021-10-15,San Francisco,075,870044,52071,51436,2259,53695,645
2021-10-15,San Joaquin,077,732212,97684,96507,5289,101796,1708
2021-10-15,San Luis Obispo,079,281455,28968,28460,1191,29651,329
2021-10-15,San Mateo,081,765935,53329,52399,830,53229,569
2021-10-15,Santa Barbara,083,443738,43621,43175,1530,44705,521
2021-10-15,Santa Clara,085,1922200,144633,143282,1238,144520,1890
2021-10-15,Santa Cruz,087,273765,20052,19794,993,20787,218
2021-10-15,Shasta,089,179085,20402,19932,3421,23353,309
2021-10-15,Sierra,091,2930,170,160,18,178,0
2021-10-15,Siskiyou,093,43540,3285,3173,1230,4403,42
2021-10-15,Solano,095,438530,45302,44585,1221,45806,334
2021-10-15,Sonoma,097,501317,40515,40195,512,40707,390
2021-10-15,Stanislaus,099,539301,76091,75868,8607,84475,1142
2021-10-15,Sutter,101,95872,13557,13471,310,13781,169
2021-10-15,Tehama,103,63373,8094,7907,1370,9277,104
2021-10-15,Trinity,105,12862,822,679,209,888,11
2021-10-15,Tulare,107,460477,66189,64489,14092,78581,951
2021-10-15,Tuolumne,109,53932,6788,6666,83,6749,89
2021-10-15,Ventura,111,848112,96932,96181,4260,100441,1164
2021-10-15,Yolo,113,214977,19357,19078,1060,20138,247
2021-10-15,Yuba,115,75493,9831,9705,288,9993,82
2021-10-14,Alameda,001,1643700,117700,117027,2720,119747,1365
2021-10-14,Alpine,003,1148,100,102,0,102,0
2021-10-14,Amador,005,37829,5379,5310,58,5368,64
2021-10-14,Butte,007,227075,20108,19612,3615,23227,260
2021-10-14,Calaveras,009,45235,3837,3771,44,3815,80
2021-10-14,Colusa,011,21464,2471,2431,599,3030,18
2021-10-14,Contra Costa,013,1133247,97746,97107,2096,99203,982
2021-10-14,Del Norte,015,27424,3604,3516,52,3568,41
2021-10-14,El Dorado,017,186661,15586,15315,1646,16961,149
2021-10-14,Fresno,019,978130,134614,132433,12233,144666,2051
2021-10-14,Glenn,021,27897,3405,3331,981,4312,26
2021-10-14,Humboldt,023,135768,8728,8621,488,9109,104
2021-10-14,Imperial,025,180216,32668,32368,3116,35484,764
2021-10-14,Inyo,027,18085,2050,1932,41,1973,39
2021-10-14,Kern,029,883053,123199,121354,20429,141783,1590
2021-10-14,Kings,031,150075,31014,30418,1829,32247,314
2021-10-14,Lake,033,64148,6512,6378,135,6513,104
2021-10-14,Lassen,035,31185,6671,6559,326,6885,26
2021-10-14,Los Angeles,037,10098052,1421204,1409418,53195,1462613,26398
2021-10-14,Madera,039,155013,22117,21707,1942,23649,277
2021-10-14,Marin,041,260295,17300,17148,435,17583,243
2021-10-14,Mariposa,043,17540,1182,1096,40,1136,5
2021-10-14,Mendocino,045,87422,7228,7099,450,7549,82
2021-10-14,Merced,047,269075,40585,40265,1730,41995,577
2021-10-14,Modoc,049,8938,512,492,182,674,5
2021-10-14,Mono,051,14174,1649,1628,20,1648,3
2021-10-14,Monterey,053,433212,48209,47293,2767,50060,582
2021-10-14,Napa,055,140530,12785,12706,105,12811,100
2021-10-14,Nevada,057,99092,8843,8739,309,9048,90
2021-10-14,Orange,059,3164182,302947,300722,14664,315386,5509
2021-10-14,Placer,061,380077,35831,35343,3474,38817,412
2021-10-14,Plumas,063,18699,1617,1542,30,1572,6
2021-10-14,Riverside,065,2383286,356707,352435,16263,368698,4990
2021-10-14,Sacramento,067,1510023,154534,153264,4284,157548,2192
2021-10-14,San Benito,069,59416,7235,7210,161,7371,71
2021-10-14,San Bernardino,071,2135413,347956,345418,10904,356322,5566
2021-10-14,San Diego,073,3302833,365365,363109,21487,384596,4151
2021-10-14,San Francisco,075,870044,52015,51436,2255,53691,645
2021-10-14,San Joaquin,077,732212,97555,96507,5280,101787,1708
2021-10-14,San Luis Obispo,079,281455,28924,28460,1187,29647,329
2021-10-14,San Mateo,081,765935,53281,52399,829,53228,569
2021-10-14,Santa Barbara,083,443738,43565,43175,1525,44700,521
2021-10-14,Santa Clara,085,1922200,144492,143282,1232,144514,1890
2021-10-14,Santa Cruz,087,273765,20029,19794,993,20787,218
2021-10-14,Shasta,089,179085,20345,19932,3409,23341,309
2021-10-14,Sierra,091,2930,169,160,18,178,0
2021-10-14,Siskiyou,093,43540,3282,3173,1222,4395,42
2021-10-14,Solano,095,438530,45252,44585,1213,45798,334
2021-10-14,Sonoma,097,501317,40464,40195,509,40704,390
2021-10-14,Stanislaus,099,539301,75945,75868,8594,84462,1142
2021-10-14,Sutter,101,95872,13537,13471,309,13780,169
2021-10-14,Tehama,103,63373,8063,7907,1363,9270,104
2021-10-14,Trinity,105,12862,821,679,208,887,11
2021-10-14,Tulare,107,460477,66005,64489,14044,78533,951
2021-10-14,Tuolumne,109,53932,6757,6666,82,6748,89
2021-10-14,Ventura,111,848112,96864,96181,4254,100435,1164
2021-10-14,Yolo,113,214977,19324,19078,1053,20131,247
2021-10-14,Yuba,115,75493,9817,9705,279,9984,82
2021-10-13,Alameda,001,1643700,117594,116914,2714,119628,1360
2021-10-13,Alpine,003,1148,100,102,0,102,0
2021-10-13,Amador,005,37829,5365,5305,58,5363,63
2021-10-13,Butte,007,227075,20033,19546,3610,23156,257
2021-10-13,Calaveras,009,45235,3816,3756,42,3798,79
2021-10-13,Colusa,011,21464,2464,2430,595,3025,18
2021-10-13,Contra Costa,013,1133247,97630,96975,2095,99070,969
2021-10-13,Del Norte,015,27424,3599,3512,52,3564,39
2021-10-13,El Dorado,017,186661,15562,15302,1641,16943,149
2021-10-13,Fresno,019,978130,134280,132055,12200,144255,2048
2021-10-13,Glenn,021,27897,3400,3327,977,4304,26
2021-10-13,Humboldt,023,135768,8717,8604,484,9088,102
2021-10-13,Imperial,025,180216,32608,32317,3113,35430,762
2021-10-13,Inyo,027,18085,2013,1907,41,1948,39
2021-10-13,Kern,029,883053,122955,120956,20334,141290,1586
2021-10-13,Kings,031,150075,30933,30246,1822,32068,312
2021-10-13,Lake,033,64148,6492,6371,135,6506,103
2021-10-13,Lassen,035,31185,6660,6535,320,6855,25
2021-10-13,Los Angeles,037,10098052,1420152,1408384,53137,1461521,26379
2021-10-13,Madera,039,155013,22064,21609,1928,23537,277
2021-10-13,Marin,041,260295,17276,17137,434,17571,243
2021-10-13,Mariposa,043,17540,1168,1090,40,1130,5
2021-10-13,Mendocino,045,87422,7212,7088,442,7530,82
2021-10-13,Merced,047,269075,40500,40164,1719,41883,577
2021-10-13,Modoc,049,8938,510,490,180,670,5
2021-10-13,Mono,051,14174,1649,1612,20,1632,3
2021-10-13,Monterey,053,433212,48190,47273,2760,50033,582
2021-10-13,Napa,055,140530,12774,12695,103,12798,100
2021-10-13,Nevada,057,99092,8821,8725,309,9034,90
2021-10-13,Orange,059,3164182,302739,300468,14648,315116,5503
2021-10-13,Placer,061,380077,35764,35254,3465,38719,412
2021-10-13,Plumas,063,18699,1603,1514,30,1544,6
2021-10-13,Riverside,065,2383286,356377,352044,16250,368294,4978
2021-10-13,Sacramento,067,1510023,154285,153141,4262,157403,2182
2021-10-13,San Benito,069,59416,7229,7196,160,7356,71
2021-10-13,San Bernardino,071,2135413,347631,344951,10887,355838,5562
2021-10-13,San Diego,073,3302833,364934,362564,21465,384029,4141
2021-10-13,San Francisco,075,870044,51973,51379,2251,53630,644
2021-10-13,San Joaquin,077,732212,97412,96343,5275,101618,1696
2021-10-13,San Luis Obispo,079,281455,28886,28397,1184,29581,330
2021-10-13,San Mateo,081,765935,53230,52352,825,53177,569
2021-10-13,Santa Barbara,083,443738,43513,43109,1525,44634,518
2021-10-13,Santa Clara,085,1922200,144354,143064,1231,144295,1886
2021-10-13,Santa Cruz,087,273765,20003,19763,992,20755,217
2021-10-13,Shasta,089,179085,20275,19802,3388,23190,307
2021-10-13,Sierra,091,2930,169,155,18,173,0
2021-10-13,Siskiyou,093,43540,3274,3173,1221,4394,42
2021-10-13,Solano,095,438530,45213,44558,1210,45768,334
2021-10-13,Sonoma,097,501317,40408,40122,509,40631,390
2021-10-13,Stanislaus,099,539301,75803,75698,8584,84282,1136
2021-10-13,Sutter,101,95872,13507,13458,307,13765,169
2021-10-13,Tehama,103,63373,8027,7849,1357,9206,103
2021-10-13,Trinity,105,12862,818,677,208,885,11
2021-10-13,Tulare,107,460477,65825,64297,13988,78285,945
2021-10-13,Tuolumne,109,53932,6743,6644,81,6725,89
2021-10-13,Ventura,111,848112,96790,96099,4248,100347,1162
2021-10-13,Yolo,113,214977,19295,19023,1051,20074,247
2021-10-13,Yuba,115,75493,9792,9690,265,9955,80
2021-10-12,Alameda,001,1643700,117491,116813,2710,119523,1357
2021-10-12,Alpine,003,1148,100,102,0,102,0
2021-10-12,Amador,005,37829,5354,5301,58,5359,63
2021-10-12,Butte,007,227075,19963,19506,3598,23104,256
2021-10-12,Calaveras,009,45235,3801,3750,42,3792,75
2021-10-12,Colusa,011,21464,2461,2428,593,3021,18
2021-10-12,Contra Costa,013,1133247,97517,96894,2086,98980,960
2021-10-12,Del Norte,015,27424,3593,3511,52,3563,39
2021-10-12,El Dorado,017,186661,15528,15287,1639,16926,148
2021-10-12,Fresno,019,978130,133918,131848,12169,144017,2042
2021-10-12,Glenn,021,27897,3386,3321,976,4297,26
2021-10-12,Humboldt,023,135768,8690,8587,478,9065,102
2021-10-12,Imperial,025,180216,32556,32267,3111,35378,762
2021-10-12,Inyo,027,18085,1981,1889,41,1930,39
2021-10-12,Kern,029,883053,122668,120826,20223,141049,1580
2021-10-12,Kings,031,150075,30859,30200,1811,32011,312
2021-10-12,Lake,033,64148,6477,6372,133,6505,97
2021-10-12,Lassen,035,31185,6650,6526,319,6845,25
2021-10-12,Los Angeles,037,10098052,1419088,1407462,53089,1460551,26362
2021-10-12,Madera,039,155013,21993,21574,1915,23489,277
2021-10-12,Marin,041,260295,17253,17126,434,17560,242
2021-10-12,Mariposa,043,17540,1154,1088,40,1128,5
2021-10-12,Mendocino,045,87422,7183,7077,439,7516,82
2021-10-12,Merced,047,269075,40421,40113,1713,41826,567
2021-10-12,Modoc,049,8938,505,485,179,664,5
2021-10-12,Mono,051,14174,1647,1608,20,1628,3
2021-10-12,Monterey,053,433212,48159,47254,2752,50006,582
2021-10-12,Napa,055,140530,12760,12671,103,12774,97
2021-10-12,Nevada,057,99092,8809,8720,308,9028,89
2021-10-12,Orange,059,3164182,302484,300256,14622,314878,5499
2021-10-12,Placer,061,380077,35701,35214,3457,38671,404
2021-10-12,Plumas,063,18699,1589,1488,29,1517,6
2021-10-12,Riverside,065,2383286,356051,351771,16236,368007,4973
2021-10-12,Sacramento,067,1510023,153980,152935,4237,157172,2170
2021-10-12,San Benito,069,59416,7215,7193,160,7353,71
2021-10-12,San Bernardino,071,2135413,347317,344788,10877,355665,5563
2021-10-12,San Diego,073,3302833,364421,362256,21436,383692,4137
2021-10-12,San Francisco,075,870044,51909,51301,2250,53551,643
2021-10-12,San Joaquin,077,732212,97275,96237,5270,101507,1690
2021-10-12,San Luis Obispo,079,281455,28839,28379,1183,29562,327
2021-10-12,San Mateo,081,765935,53180,52328,824,53152,569
2021-10-12,Santa Barbara,083,443738,43452,43076,1525,44601,515
2021-10-12,Santa Clara,085,1922200,144201,142954,1229,144183,1882
2021-10-12,Santa Cruz,087,273765,19978,19757,992,20749,218
2021-10-12,Shasta,089,179085,20201,19731,3367,23098,304
2021-10-12,Sierra,091,2930,169,153,18,171,0
2021-10-12,Siskiyou,093,43540,3263,3166,1215,4381,42
2021-10-12,Solano,095,438530,45171,44516,1204,45720,329
2021-10-12,Sonoma,097,501317,40367,40105,508,40613,390
2021-10-12,Stanislaus,099,539301,75651,75589,8571,84160,1126
2021-10-12,Sutter,101,95872,13484,13436,303,13739,168
2021-10-12,Tehama,103,63373,7995,7820,1353,9173,103
2021-10-12,Trinity,105,12862,815,676,208,884,11
2021-10-12,Tulare,107,460477,65640,64216,13931,78147,944
2021-10-12,Tuolumne,109,53932,6726,6637,80,6717,89
2021-10-12,Ventura,111,848112,96689,96022,4243,100265,1160
2021-10-12,Yolo,113,214977,19268,18987,1043,20030,247
2021-10-12,Yuba,115,75493,9777,9676,261,9937,70
2021-10-11,Alameda,001,1643700,117349,116759,2709,119468,1358
2021-10-11,Alpine,003,1148,100,102,0,102,0
2021-10-11,Amador,005,37829,5342,5286,58,5344,62
2021-10-11,Butte,007,227075,19904,19452,3593,23045,253
2021-10-11,Calaveras,009,45235,3780,3750,42,3792,75
2021-10-11,Colusa,011,21464,2457,2427,585,3012,18
2021-10-11,Contra Costa,013,1133247,97381,96832,2081,98913,960
2021-10-11,Del Norte,015,27424,3590,3510,48,3558,39
2021-10-11,El Dorado,017,186661,15499,15273,1635,16908,146
2021-10-11,Fresno,019,978130,133588,131703,12134,143837,2036
2021-10-11,Glenn,021,27897,3369,3308,973,4281,26
2021-10-11,Humboldt,023,135768,8665,8571,471,9042,101
2021-10-11,Imperial,025,180216,32506,32207,3105,35312,762
2021-10-11,Inyo,027,18085,1958,1862,40,1902,39
2021-10-11,Kern,029,883053,122432,120684,20127,140811,1575
2021-10-11,Kings,031,150075,30770,30180,1801,31981,309
2021-10-11,Lake,033,64148,6461,6361,129,6490,97
2021-10-11,Lassen,035,31185,6630,6499,316,6815,25
2021-10-11,Los Angeles,037,10098052,1418045,1406826,53038,1459864,26346
2021-10-11,Madera,039,155013,21935,21555,1898,23453,272
2021-10-11,Marin,041,260295,17235,17121,430,17551,242
2021-10-11,Mariposa,043,17540,1124,1083,39,1122,5
2021-10-11,Mendocino,045,87422,7167,7064,435,7499,82
2021-10-11,Merced,047,269075,40305,40064,1688,41752,566
2021-10-11,Modoc,049,8938,502,482,176,658,5
2021-10-11,Mono,051,14174,1637,1604,20,1624,3
2021-10-11,Monterey,053,433212,48130,47241,2745,49986,580
2021-10-11,Napa,055,140530,12737,12654,101,12755,96
2021-10-11,Nevada,057,99092,8789,8716,307,9023,90
2021-10-11,Orange,059,3164182,302254,299941,14592,314533,5499
2021-10-11,Placer,061,380077,35632,35173,3440,38613,404
2021-10-11,Plumas,063,18699,1571,1469,27,1496,6
2021-10-11,Riverside,065,2383286,355706,351444,16231,367675,4973
2021-10-11,Sacramento,067,1510023,153691,152681,4206,156887,2169
2021-10-11,San Benito,069,59416,7194,7184,158,7342,71
2021-10-11,San Bernardino,071,2135413,346931,344594,10869,355463,5549
2021-10-11,San Diego,073,3302833,363909,361712,21404,383116,4124
2021-10-11,San Francisco,075,870044,51838,51275,2246,53521,643
2021-10-11,San Joaquin,077,732212,97121,96152,5259,101411,1681
2021-10-11,San Luis Obispo,079,281455,28792,28355,1178,29533,327
2021-10-11,San Mateo,081,765935,53132,52298,823,53121,569
2021-10-11,Santa Barbara,083,443738,43405,43018,1524,44542,515
2021-10-11,Santa Clara,085,1922200,144039,142836,1225,144061,1882
2021-10-11,Santa Cruz,087,273765,19954,19745,991,20736,217
2021-10-11,Shasta,089,179085,20122,19662,3351,23013,295
2021-10-11,Sierra,091,2930,166,147,17,164,0
2021-10-11,Siskiyou,093,43540,3256,3159,1211,4370,42
2021-10-11,Solano,095,438530,45122,44474,1201,45675,329
2021-10-11,Sonoma,097,501317,40322,40067,508,40575,390
2021-10-11,Stanislaus,099,539301,75479,75478,8550,84028,1118
2021-10-11,Sutter,101,95872,13465,13427,301,13728,165
2021-10-11,Tehama,103,63373,7954,7795,1344,9139,102
2021-10-11,Trinity,105,12862,809,675,207,882,11
2021-10-11,Tulare,107,460477,65460,64094,13864,77958,942
2021-10-11,Tuolumne,109,53932,6688,6602,80,6682,89
2021-10-11,Ventura,111,848112,96592,95876,4236,100112,1160
2021-10-11,Yolo,113,214977,19222,18977,1040,20017,247
2021-10-11,Yuba,115,75493,9760,9657,249,9906,69
2021-10-10,Alameda,001,1643700,117230,116679,2705,119384,1358
2021-10-10,Alpine,003,1148,100,102,0,102,0
2021-10-10,Amador,005,37829,5328,5278,58,5336,62
2021-10-10,Butte,007,227075,19839,19430,3578,23008,253
2021-10-10,Calaveras,009,45235,3768,3747,42,3789,75
2021-10-10,Colusa,011,21464,2456,2425,584,3009,18
2021-10-10,Contra Costa,013,1133247,97282,96760,2075,98835,960
2021-10-10,Del Norte,015,27424,3586,3507,48,3555,39
2021-10-10,El Dorado,017,186661,15469,15250,1629,16879,146
2021-10-10,Fresno,019,978130,133258,131434,12103,143537,2035
2021-10-10,Glenn,021,27897,3364,3297,971,4268,26
2021-10-10,Humboldt,023,135768,8643,8554,467,9021,101
2021-10-10,Imperial,025,180216,32432,32167,3104,35271,762
2021-10-10,Inyo,027,18085,1937,1857,40,1897,39
2021-10-10,Kern,029,883053,122106,120552,20023,140575,1573
2021-10-10,Kings,031,150075,30681,30122,1791,31913,308
2021-10-10,Lake,033,64148,6445,6349,128,6477,97
2021-10-10,Lassen,035,31185,6610,6495,315,6810,26
2021-10-10,Los Angeles,037,10098052,1416860,1406034,52964,1458998,26338
2021-10-10,Madera,039,155013,21889,21486,1889,23375,272
2021-10-10,Marin,041,260295,17218,17112,430,17542,242
2021-10-10,Mariposa,043,17540,1121,1074,39,1113,5
2021-10-10,Mendocino,045,87422,7152,7060,427,7487,81
2021-10-10,Merced,047,269075,40220,40036,1669,41705,566
2021-10-10,Modoc,049,8938,502,482,176,658,5
2021-10-10,Mono,051,14174,1636,1596,20,1616,3
2021-10-10,Monterey,053,433212,48100,47228,2744,49972,580
2021-10-10,Napa,055,140530,12714,12641,101,12742,96
2021-10-10,Nevada,057,99092,8777,8689,307,8996,90
2021-10-10,Orange,059,3164182,301992,299787,14564,314351,5499
2021-10-10,Placer,061,380077,35539,35128,3428,38556,404
2021-10-10,Plumas,063,18699,1555,1468,25,1493,6
2021-10-10,Riverside,065,2383286,355332,351248,16212,367460,4973
2021-10-10,Sacramento,067,1510023,153424,152405,4189,156594,2178
2021-10-10,San Benito,069,59416,7189,7180,157,7337,71
2021-10-10,San Bernardino,071,2135413,346625,344423,10861,355284,5551
2021-10-10,San Diego,073,3302833,363393,361038,21357,382395,4113
2021-10-10,San Francisco,075,870044,51791,51216,2243,53459,643
2021-10-10,San Joaquin,077,732212,96950,96084,5242,101326,1681
2021-10-10,San Luis Obispo,079,281455,28748,28343,1178,29521,326
2021-10-10,San Mateo,081,765935,53090,52273,822,53095,569
2021-10-10,Santa Barbara,083,443738,43358,42987,1523,44510,515
2021-10-10,Santa Clara,085,1922200,143874,142768,1218,143986,1881
2021-10-10,Santa Cruz,087,273765,19934,19727,991,20718,217
2021-10-10,Shasta,089,179085,20034,19635,3342,22977,296
2021-10-10,Sierra,091,2930,164,147,17,164,0
2021-10-10,Siskiyou,093,43540,3242,3155,1204,4359,42
2021-10-10,Solano,095,438530,45066,44431,1201,45632,329
2021-10-10,Sonoma,097,501317,40270,40027,508,40535,390
2021-10-10,Stanislaus,099,539301,75302,75403,8536,83939,1118
2021-10-10,Sutter,101,95872,13441,13412,296,13708,165
2021-10-10,Tehama,103,63373,7916,7764,1335,9099,102
2021-10-10,Trinity,105,12862,808,669,206,875,11
2021-10-10,Tulare,107,460477,65288,63930,13814,77744,940
2021-10-10,Tuolumne,109,53932,6664,6580,79,6659,89
2021-10-10,Ventura,111,848112,96503,95829,4236,100065,1160
2021-10-10,Yolo,113,214977,19190,18952,1035,19987,247
2021-10-10,Yuba,115,75493,9744,9641,244,9885,69
2021-10-09,Alameda,001,1643700,117131,116253,2703,118956,1356
2021-10-09,Alpine,003,1148,99,102,0,102,0
2021-10-09,Amador,005,37829,5326,5237,57,5294,62
2021-10-09,Butte,007,227075,19808,19277,3574,22851,250
2021-10-09,Calaveras,009,45235,3764,3716,42,3758,75
2021-10-09,Colusa,011,21464,2452,2419,583,3002,18
2021-10-09,Contra Costa,013,1133247,97212,96378,2069,98447,958
2021-10-09,Del Norte,015,27424,3585,3495,48,3543,39
2021-10-09,El Dorado,017,186661,15451,15153,1626,16779,144
2021-10-09,Fresno,019,978130,133126,130508,12084,142592,2018
2021-10-09,Glenn,021,27897,3360,3277,969,4246,26
2021-10-09,Humboldt,023,135768,8629,8448,465,8913,97
2021-10-09,Imperial,025,180216,32398,31989,3102,35091,760
2021-10-09,Inyo,027,18085,1928,1808,40,1848,39
2021-10-09,Kern,029,883053,121965,119795,19996,139791,1559
2021-10-09,Kings,031,150075,30632,29894,1789,31683,308
2021-10-09,Lake,033,64148,6426,6283,127,6410,97
2021-10-09,Lassen,035,31185,6605,6442,314,6756,25
2021-10-09,Los Angeles,037,10098052,1416270,1402810,52925,1455735,26280
2021-10-09,Madera,039,155013,21856,21313,1875,23188,271
2021-10-09,Marin,041,260295,17213,17049,428,17477,242
2021-10-09,Mariposa,043,17540,1114,1042,38,1080,5
2021-10-09,Mendocino,045,87422,7145,7011,426,7437,82
2021-10-09,Merced,047,269075,40177,39784,1669,41453,565
2021-10-09,Modoc,049,8938,500,477,175,652,5
2021-10-09,Mono,051,14174,1633,1577,20,1597,3
2021-10-09,Monterey,053,433212,48088,47168,2741,49909,577
2021-10-09,Napa,055,140530,12710,12586,101,12687,96
2021-10-09,Nevada,057,99092,8766,8613,306,8919,90
2021-10-09,Orange,059,3164182,301811,299089,14545,313634,5457
2021-10-09,Placer,061,380077,35501,34877,3421,38298,393
2021-10-09,Plumas,063,18699,1544,1418,25,1443,6
2021-10-09,Riverside,065,2383286,355080,350082,16195,366277,4965
2021-10-09,Sacramento,067,1510023,153214,151566,4176,155742,2160
2021-10-09,San Benito,069,59416,7181,7123,157,7280,71
2021-10-09,San Bernardino,071,2135413,346440,343452,10857,354309,5556
2021-10-09,San Diego,073,3302833,363087,359909,21352,381261,4111
2021-10-09,San Francisco,075,870044,51743,50960,2236,53196,643
2021-10-09,San Joaquin,077,732212,96884,95606,5237,100843,1669
2021-10-09,San Luis Obispo,079,281455,28731,28197,1176,29373,324
2021-10-09,San Mateo,081,765935,53058,52121,821,52942,569
2021-10-09,Santa Barbara,083,443738,43331,42735,1523,44258,514
2021-10-09,Santa Clara,085,1922200,143750,142298,1212,143510,1873
2021-10-09,Santa Cruz,087,273765,19924,19635,990,20625,217
2021-10-09,Shasta,089,179085,19984,19437,3337,22774,290
2021-10-09,Sierra,091,2930,161,141,17,158,0
2021-10-09,Siskiyou,093,43540,3241,3124,1203,4327,42
2021-10-09,Solano,095,438530,45049,44265,1200,45465,329
2021-10-09,Sonoma,097,501317,40226,39848,507,40355,387
2021-10-09,Stanislaus,099,539301,75212,74899,8525,83424,1114
2021-10-09,Sutter,101,95872,13432,13314,294,13608,165
2021-10-09,Tehama,103,63373,7905,7670,1330,9000,99
2021-10-09,Trinity,105,12862,807,660,206,866,11
2021-10-09,Tulare,107,460477,65180,63398,13792,77190,932
2021-10-09,Tuolumne,109,53932,6645,6521,79,6600,89
2021-10-09,Ventura,111,848112,96449,95542,4233,99775,1158
2021-10-09,Yolo,113,214977,19168,18850,1032,19882,247
2021-10-09,Yuba,115,75493,9732,9551,242,9793,69
2021-10-08,Alameda,001,1643700,117050,116253,2699,118952,1356
2021-10-08,Alpine,003,1148,99,102,0,102,0
2021-10-08,Amador,005,37829,5313,5237,57,5294,62
2021-10-08,Butte,007,227075,19779,19277,3570,22847,250
2021-10-08,Calaveras,009,45235,3759,3716,42,3758,75
2021-10-08,Colusa,011,21464,2450,2419,583,3002,18
2021-10-08,Contra Costa,013,1133247,97168,96378,2064,98442,958
2021-10-08,Del Norte,015,27424,3584,3495,48,3543,39
2021-10-08,El Dorado,017,186661,15431,15153,1622,16775,144
2021-10-08,Fresno,019,978130,132930,130508,12063,142571,2018
2021-10-08,Glenn,021,27897,3352,3277,967,4244,26
2021-10-08,Humboldt,023,135768,8618,8448,462,8910,97
2021-10-08,Imperial,025,180216,32368,31989,3098,35087,760
2021-10-08,Inyo,027,18085,1910,1808,40,1848,39
2021-10-08,Kern,029,883053,121828,119795,19954,139749,1559
2021-10-08,Kings,031,150075,30538,29894,1788,31682,308
2021-10-08,Lake,033,64148,6418,6283,127,6410,97
2021-10-08,Lassen,035,31185,6591,6442,311,6753,25
2021-10-08,Los Angeles,037,10098052,1415609,1402810,52888,1455698,26280
2021-10-08,Madera,039,155013,21797,21313,1868,23181,271
2021-10-08,Marin,041,260295,17202,17049,427,17476,242
2021-10-08,Mariposa,043,17540,1107,1042,36,1078,5
2021-10-08,Mendocino,045,87422,7132,7011,426,7437,82
2021-10-08,Merced,047,269075,40145,39784,1666,41450,565
2021-10-08,Modoc,049,8938,498,477,175,652,5
2021-10-08,Mono,051,14174,1630,1577,20,1597,3
2021-10-08,Monterey,053,433212,48061,47168,2739,49907,577
2021-10-08,Napa,055,140530,12694,12586,101,12687,96
2021-10-08,Nevada,057,99092,8753,8613,306,8919,90
2021-10-08,Orange,059,3164182,301664,299089,14525,313614,5457
2021-10-08,Placer,061,380077,35463,34877,3414,38291,393
2021-10-08,Plumas,063,18699,1532,1418,25,1443,6
2021-10-08,Riverside,065,2383286,354811,350082,16184,366266,4965
2021-10-08,Sacramento,067,1510023,153049,151566,4162,155728,2160
2021-10-08,San Benito,069,59416,7177,7123,155,7278,71
2021-10-08,San Bernardino,071,2135413,346231,343452,10849,354301,5556
2021-10-08,San Diego,073,3302833,362761,359909,21333,381242,4111
2021-10-08,San Francisco,075,870044,51696,50960,2227,53187,643
2021-10-08,San Joaquin,077,732212,96816,95606,5231,100837,1669
2021-10-08,San Luis Obispo,079,281455,28704,28197,1175,29372,324
2021-10-08,San Mateo,081,765935,53030,52121,821,52942,569
2021-10-08,Santa Barbara,083,443738,43296,42735,1522,44257,514
2021-10-08,Santa Clara,085,1922200,143637,142298,1207,143505,1873
2021-10-08,Santa Cruz,087,273765,19909,19635,990,20625,217
2021-10-08,Shasta,089,179085,19942,19437,3331,22768,290
2021-10-08,Sierra,091,2930,159,141,15,156,0
2021-10-08,Siskiyou,093,43540,3233,3124,1202,4326,42
2021-10-08,Solano,095,438530,45010,44265,1199,45464,329
2021-10-08,Sonoma,097,501317,40190,39848,507,40355,387
2021-10-08,Stanislaus,099,539301,75143,74899,8516,83415,1114
2021-10-08,Sutter,101,95872,13418,13314,292,13606,165
2021-10-08,Tehama,103,63373,7888,7670,1328,8998,99
2021-10-08,Trinity,105,12862,806,660,206,866,11
2021-10-08,Tulare,107,460477,65062,63398,13760,77158,932
2021-10-08,Tuolumne,109,53932,6622,6521,79,6600,89
2021-10-08,Ventura,111,848112,96398,95542,4227,99769,1158
2021-10-08,Yolo,113,214977,19155,18850,1028,19878,247
2021-10-08,Yuba,115,75493,9712,9551,241,9792,69
2021-10-07,Alameda,001,1643700,116930,116253,2698,118951,1356
2021-10-07,Alpine,003,1148,99,102,0,102,0
2021-10-07,Amador,005,37829,5306,5237,57,5294,62
2021-10-07,Butte,007,227075,19730,19277,3559,22836,250
2021-10-07,Calaveras,009,45235,3747,3716,42,3758,75
2021-10-07,Colusa,011,21464,2447,2419,577,2996,18
2021-10-07,Contra Costa,013,1133247,97045,96378,2060,98438,958
2021-10-07,Del Norte,015,27424,3581,3495,48,3543,39
2021-10-07,El Dorado,017,186661,15395,15153,1618,16771,144
2021-10-07,Fresno,019,978130,132655,130508,12039,142547,2018
2021-10-07,Glenn,021,27897,3345,3277,965,4242,26
2021-10-07,Humboldt,023,135768,8592,8448,459,8907,97
2021-10-07,Imperial,025,180216,32297,31989,3085,35074,760
2021-10-07,Inyo,027,18085,1891,1808,40,1848,39
2021-10-07,Kern,029,883053,121597,119795,19888,139683,1559
2021-10-07,Kings,031,150075,30473,29894,1782,31676,308
2021-10-07,Lake,033,64148,6407,6283,127,6410,97
2021-10-07,Lassen,035,31185,6573,6442,309,6751,25
2021-10-07,Los Angeles,037,10098052,1414654,1402810,52844,1455654,26280
2021-10-07,Madera,039,155013,21724,21313,1854,23167,271
2021-10-07,Marin,041,260295,17184,17049,427,17476,242
2021-10-07,Mariposa,043,17540,1099,1042,36,1078,5
2021-10-07,Mendocino,045,87422,7122,7011,422,7433,82
2021-10-07,Merced,047,269075,40078,39784,1649,41433,565
2021-10-07,Modoc,049,8938,495,477,174,651,5
2021-10-07,Mono,051,14174,1622,1577,20,1597,3
2021-10-07,Monterey,053,433212,48036,47168,2730,49898,577
2021-10-07,Napa,055,140530,12679,12586,101,12687,96
2021-10-07,Nevada,057,99092,8725,8613,306,8919,90
2021-10-07,Orange,059,3164182,301438,299089,14511,313600,5457
2021-10-07,Placer,061,380077,35401,34877,3407,38284,393
2021-10-07,Plumas,063,18699,1515,1418,25,1443,6
2021-10-07,Riverside,065,2383286,354478,350082,16172,366254,4965
2021-10-07,Sacramento,067,1510023,152767,151566,4135,155701,2160
2021-10-07,San Benito,069,59416,7161,7123,153,7276,71
2021-10-07,San Bernardino,071,2135413,345959,343452,10841,354293,5556
2021-10-07,San Diego,073,3302833,362366,359909,21312,381221,4111
2021-10-07,San Francisco,075,870044,51626,50960,2224,53184,643
2021-10-07,San Joaquin,077,732212,96662,95606,5223,100829,1669
2021-10-07,San Luis Obispo,079,281455,28653,28197,1173,29370,324
2021-10-07,San Mateo,081,765935,52990,52121,820,52941,569
2021-10-07,Santa Barbara,083,443738,43228,42735,1516,44251,514
2021-10-07,Santa Clara,085,1922200,143488,142298,1201,143499,1873
2021-10-07,Santa Cruz,087,273765,19889,19635,989,20624,217
2021-10-07,Shasta,089,179085,19853,19437,3316,22753,290
2021-10-07,Sierra,091,2930,158,141,15,156,0
2021-10-07,Siskiyou,093,43540,3229,3124,1197,4321,42
2021-10-07,Solano,095,438530,44965,44265,1195,45460,329
2021-10-07,Sonoma,097,501317,40153,39848,505,40353,387
2021-10-07,Stanislaus,099,539301,74981,74899,8491,83390,1114
2021-10-07,Sutter,101,95872,13396,13314,289,13603,165
2021-10-07,Tehama,103,63373,7855,7670,1322,8992,99
2021-10-07,Trinity,105,12862,804,660,206,866,11
2021-10-07,Tulare,107,460477,64895,63398,13722,77120,932
2021-10-07,Tuolumne,109,53932,6600,6521,79,6600,89
2021-10-07,Ventura,111,848112,96325,95542,4224,99766,1158
2021-10-07,Yolo,113,214977,19122,18850,1023,19873,247
2021-10-07,Yuba,115,75493,9686,9551,234,9785,69
2021-10-06,Alameda,001,1643700,116792,116058,2692,118750,1353
2021-10-06,Alpine,003,1148,99,102,0,102,0
2021-10-06,Amador,005,37829,5303,5205,57,5262,62
2021-10-06,Butte,007,227075,19668,19208,3552,22760,247
2021-10-06,Calaveras,009,45235,3738,3669,42,3711,75
2021-10-06,Colusa,011,21464,2445,2414,570,2984,18
2021-10-06,Contra Costa,013,1133247,96920,96184,2056,98240,953
2021-10-06,Del Norte,015,27424,3578,3490,45,3535,39
2021-10-06,El Dorado,017,186661,15370,15078,1615,16693,140
2021-10-06,Fresno,019,978130,132365,130074,12014,142088,2008
2021-10-06,Glenn,021,27897,3336,3270,963,4233,26
2021-10-06,Humboldt,023,135768,8577,8416,452,8868,94
2021-10-06,Imperial,025,180216,32244,31930,3074,35004,760
2021-10-06,Inyo,027,18085,1876,1806,40,1846,39
2021-10-06,Kern,029,883053,121340,119491,19795,139286,1552
2021-10-06,Kings,031,150075,30407,29785,1774,31559,308
2021-10-06,Lake,033,64148,6393,6271,127,6398,97
2021-10-06,Lassen,035,31185,6557,6429,308,6737,25
2021-10-06,Los Angeles,037,10098052,1413695,1401675,52796,1454471,26252
2021-10-06,Madera,039,155013,21669,21230,1844,23074,269
2021-10-06,Marin,041,260295,17175,17042,424,17466,242
2021-10-06,Mariposa,043,17540,1092,1036,36,1072,5
2021-10-06,Mendocino,045,87422,7113,6986,420,7406,81
2021-10-06,Merced,047,269075,40003,39666,1637,41303,563
2021-10-06,Modoc,049,8938,495,477,172,649,5
2021-10-06,Mono,051,14174,1610,1568,20,1588,3
2021-10-06,Monterey,053,433212,48003,47136,2725,49861,577
2021-10-06,Napa,055,140530,12655,12552,100,12652,96
2021-10-06,Nevada,057,99092,8709,8582,305,8887,90
2021-10-06,Orange,059,3164182,301200,298785,14498,313283,5448
2021-10-06,Placer,061,380077,35350,34764,3401,38165,390
2021-10-06,Plumas,063,18699,1492,1383,25,1408,6
2021-10-06,Riverside,065,2383286,354122,349645,16151,365796,4953
2021-10-06,Sacramento,067,1510023,152514,151164,4104,155268,2141
2021-10-06,San Benito,069,59416,7146,7108,153,7261,69
2021-10-06,San Bernardino,071,2135413,345666,343022,10834,353856,5551
2021-10-06,San Diego,073,3302833,361874,359564,21284,380848,4104
2021-10-06,San Francisco,075,870044,51563,50894,2221,53115,641
2021-10-06,San Joaquin,077,732212,96528,95418,5211,100629,1658
2021-10-06,San Luis Obispo,079,281455,28603,28170,1167,29337,323
2021-10-06,San Mateo,081,765935,52940,52056,815,52871,569
2021-10-06,Santa Barbara,083,443738,43145,42687,1514,44201,513
2021-10-06,Santa Clara,085,1922200,143337,142124,1196,143320,1872
2021-10-06,Santa Cruz,087,273765,19860,19604,987,20591,217
2021-10-06,Shasta,089,179085,19778,19325,3303,22628,287
2021-10-06,Sierra,091,2930,156,138,15,153,0
2021-10-06,Siskiyou,093,43540,3219,3116,1190,4306,42
2021-10-06,Solano,095,438530,44931,44185,1194,45379,328
2021-10-06,Sonoma,097,501317,40103,39787,504,40291,383
2021-10-06,Stanislaus,099,539301,74839,74699,8478,83177,1114
2021-10-06,Sutter,101,95872,13375,13284,287,13571,164
2021-10-06,Tehama,103,63373,7819,7629,1315,8944,99
2021-10-06,Trinity,105,12862,801,656,206,862,11
2021-10-06,Tulare,107,460477,64716,63198,13664,76862,926
2021-10-06,Tuolumne,109,53932,6575,6486,79,6565,89
2021-10-06,Ventura,111,848112,96234,95449,4216,99665,1158
2021-10-06,Yolo,113,214977,19090,18815,1018,19833,247
2021-10-06,Yuba,115,75493,9662,9520,233,9753,69
2021-10-05,Alameda,001,1643700,116648,115968,2687,118655,1350
2021-10-05,Alpine,003,1148,99,102,0,102,0
2021-10-05,Amador,005,37829,5282,5194,56,5250,61
2021-10-05,Butte,007,227075,19619,19137,3541,22678,246
2021-10-05,Calaveras,009,45235,3722,3657,42,3699,73
2021-10-05,Colusa,011,21464,2438,2414,569,2983,18
2021-10-05,Contra Costa,013,1133247,96803,96108,2050,98158,941
2021-10-05,Del Norte,015,27424,3576,3485,44,3529,39
2021-10-05,El Dorado,017,186661,15331,15052,1612,16664,140
2021-10-05,Fresno,019,978130,132025,129957,11977,141934,1987
2021-10-05,Glenn,021,27897,3326,3270,959,4229,26
2021-10-05,Humboldt,023,135768,8546,8398,448,8846,94
2021-10-05,Imperial,025,180216,32197,31909,3069,34978,759
2021-10-05,Inyo,027,18085,1859,1800,40,1840,39
2021-10-05,Kern,029,883053,121075,119260,19693,138953,1540
2021-10-05,Kings,031,150075,30332,29749,1768,31517,301
2021-10-05,Lake,033,64148,6372,6264,126,6390,97
2021-10-05,Lassen,035,31185,6538,6417,306,6723,25
2021-10-05,Los Angeles,037,10098052,1412551,1400300,52743,1453043,26223
2021-10-05,Madera,039,155013,21611,21183,1831,23014,269
2021-10-05,Marin,041,260295,17163,17024,424,17448,242
2021-10-05,Mariposa,043,17540,1073,1033,33,1066,5
2021-10-05,Mendocino,045,87422,7097,6972,413,7385,79
2021-10-05,Merced,047,269075,39937,39608,1629,41237,562
2021-10-05,Modoc,049,8938,491,475,171,646,5
2021-10-05,Mono,051,14174,1602,1565,20,1585,3
2021-10-05,Monterey,053,433212,47986,47087,2715,49802,573
2021-10-05,Napa,055,140530,12631,12533,100,12633,96
2021-10-05,Nevada,057,99092,8679,8576,305,8881,90
2021-10-05,Orange,059,3164182,300923,298589,14466,313055,5441
2021-10-05,Placer,061,380077,35270,34728,3394,38122,382
2021-10-05,Plumas,063,18699,1467,1357,25,1382,6
2021-10-05,Riverside,065,2383286,353762,349365,16136,365501,4942
2021-10-05,Sacramento,067,1510023,152240,151111,4076,155187,2126
2021-10-05,San Benito,069,59416,7128,7103,151,7254,69
2021-10-05,San Bernardino,071,2135413,345339,342711,10827,353538,5557
2021-10-05,San Diego,073,3302833,361299,359194,21257,380451,4092
2021-10-05,San Francisco,075,870044,51466,50826,2218,53044,641
2021-10-05,San Joaquin,077,732212,96375,95276,5185,100461,1651
2021-10-05,San Luis Obispo,079,281455,28559,28113,1165,29278,324
2021-10-05,San Mateo,081,765935,52893,52008,815,52823,569
2021-10-05,Santa Barbara,083,443738,43067,42595,1510,44105,511
2021-10-05,Santa Clara,085,1922200,143177,141971,1189,143160,1873
2021-10-05,Santa Cruz,087,273765,19818,19582,987,20569,216
2021-10-05,Shasta,089,179085,19704,19285,3290,22575,286
2021-10-05,Sierra,091,2930,152,136,15,151,0
2021-10-05,Siskiyou,093,43540,3205,3107,1190,4297,42
2021-10-05,Solano,095,438530,44860,44149,1192,45341,325
2021-10-05,Sonoma,097,501317,40048,39756,499,40255,383
2021-10-05,Stanislaus,099,539301,74677,74599,8461,83060,1114
2021-10-05,Sutter,101,95872,13347,13270,286,13556,164
2021-10-05,Tehama,103,63373,7789,7607,1306,8913,98
2021-10-05,Trinity,105,12862,798,655,206,861,11
2021-10-05,Tulare,107,460477,64509,63093,13611,76704,920
2021-10-05,Tuolumne,109,53932,6560,6473,78,6551,89
2021-10-05,Ventura,111,848112,96128,95351,4215,99566,1155
2021-10-05,Yolo,113,214977,19054,18782,1012,19794,245
2021-10-05,Yuba,115,75493,9630,9504,230,9734,69
2021-10-04,Alameda,001,1643700,116485,115845,2684,118529,1347
2021-10-04,Alpine,003,1148,99,102,0,102,0
2021-10-04,Amador,005,37829,5272,5163,55,5218,61
2021-10-04,Butte,007,227075,19542,19081,3529,22610,245
2021-10-04,Calaveras,009,45235,3713,3641,42,3683,73
2021-10-04,Colusa,011,21464,2437,2414,567,2981,18
2021-10-04,Contra Costa,013,1133247,96662,95958,2045,98003,937
2021-10-04,Del Norte,015,27424,3574,3485,40,3525,39
2021-10-04,El Dorado,017,186661,15284,15031,1605,16636,138
2021-10-04,Fresno,019,978130,131715,129665,11947,141612,1978
2021-10-04,Glenn,021,27897,3319,3270,956,4226,26
2021-10-04,Humboldt,023,135768,8514,8355,440,8795,94
2021-10-04,Imperial,025,180216,32148,31866,3062,34928,757
2021-10-04,Inyo,027,18085,1847,1792,37,1829,39
2021-10-04,Kern,029,883053,120784,118984,19572,138556,1531
2021-10-04,Kings,031,150075,30239,29702,1765,31467,303
2021-10-04,Lake,033,64148,6359,6248,126,6374,97
2021-10-04,Lassen,035,31185,6521,6405,306,6711,25
2021-10-04,Los Angeles,037,10098052,1411435,1399604,52684,1452288,26186
2021-10-04,Madera,039,155013,21547,21126,1819,22945,266
2021-10-04,Marin,041,260295,17147,17008,423,17431,242
2021-10-04,Mariposa,043,17540,1061,1024,33,1057,5
2021-10-04,Mendocino,045,87422,7079,6947,410,7357,79
2021-10-04,Merced,047,269075,39821,39565,1613,41178,558
2021-10-04,Modoc,049,8938,488,473,171,644,5
2021-10-04,Mono,051,14174,1594,1561,20,1581,3
2021-10-04,Monterey,053,433212,47965,47058,2708,49766,571
2021-10-04,Napa,055,140530,12607,12506,100,12606,96
2021-10-04,Nevada,057,99092,8659,8563,305,8868,90
2021-10-04,Orange,059,3164182,300627,298165,14434,312599,5438
2021-10-04,Placer,061,380077,35188,34630,3366,37996,379
2021-10-04,Plumas,063,18699,1445,1329,25,1354,6
2021-10-04,Riverside,065,2383286,353382,348828,16126,364954,4923
2021-10-04,Sacramento,067,1510023,151916,150887,4049,154936,2115
2021-10-04,San Benito,069,59416,7115,7099,151,7250,69
2021-10-04,San Bernardino,071,2135413,344980,342418,10815,353233,5551
2021-10-04,San Diego,073,3302833,360733,358525,21226,379751,4090
2021-10-04,San Francisco,075,870044,51371,50798,2214,53012,638
2021-10-04,San Joaquin,077,732212,96178,95198,5165,100363,1649
2021-10-04,San Luis Obispo,079,281455,28514,28090,1159,29249,323
2021-10-04,San Mateo,081,765935,52833,51958,814,52772,569
2021-10-04,Santa Barbara,083,443738,42982,42585,1509,44094,511
2021-10-04,Santa Clara,085,1922200,143032,141840,1183,143023,1869
2021-10-04,Santa Cruz,087,273765,19789,19559,986,20545,216
2021-10-04,Shasta,089,179085,19597,19170,3276,22446,279
2021-10-04,Sierra,091,2930,145,136,14,150,0
2021-10-04,Siskiyou,093,43540,3196,3103,1175,4278,42
2021-10-04,Solano,095,438530,44801,44092,1188,45280,322
2021-10-04,Sonoma,097,501317,39982,39720,499,40219,381
2021-10-04,Stanislaus,099,539301,74526,74444,8442,82886,1106
2021-10-04,Sutter,101,95872,13318,13261,285,13546,164
2021-10-04,Tehama,103,63373,7748,7585,1300,8885,95
2021-10-04,Trinity,105,12862,797,649,205,854,11
2021-10-04,Tulare,107,460477,64321,62957,13542,76499,920
2021-10-04,Tuolumne,109,53932,6534,6442,78,6520,89
2021-10-04,Ventura,111,848112,96036,95170,4209,99379,1153
2021-10-04,Yolo,113,214977,19010,18761,1008,19769,242
2021-10-04,Yuba,115,75493,9591,9481,228,9709,68
2021-10-03,Alameda,001,1643700,116343,115751,2674,118425,1349
2021-10-03,Alpine,003,1148,99,102,0,102,0
2021-10-03,Amador,005,37829,5254,5160,53,5213,61
2021-10-03,Butte,007,227075,19469,19066,3512,22578,245
2021-10-03,Calaveras,009,45235,3696,3632,42,3674,73
2021-10-03,Colusa,011,21464,2436,2413,564,2977,18
2021-10-03,Contra Costa,013,1133247,96530,95890,2038,97928,937
2021-10-03,Del Norte,015,27424,3568,3483,39,3522,39
2021-10-03,El Dorado,017,186661,15225,15014,1598,16612,139
2021-10-03,Fresno,019,978130,131334,129365,11905,141270,1978
2021-10-03,Glenn,021,27897,3312,3266,948,4214,26
2021-10-03,Humboldt,023,135768,8469,8352,436,8788,94
2021-10-03,Imperial,025,180216,32081,31844,3054,34898,757
2021-10-03,Inyo,027,18085,1826,1788,37,1825,39
2021-10-03,Kern,029,883053,120479,118851,19450,138301,1535
2021-10-03,Kings,031,150075,30138,29623,1758,31381,300
2021-10-03,Lake,033,64148,6333,6239,126,6365,97
2021-10-03,Lassen,035,31185,6499,6400,304,6704,25
2021-10-03,Los Angeles,037,10098052,1410169,1398790,52629,1451419,26179
2021-10-03,Madera,039,155013,21475,21066,1809,22875,266
2021-10-03,Marin,041,260295,17124,16995,418,17413,242
2021-10-03,Mariposa,043,17540,1054,1011,33,1044,5
2021-10-03,Mendocino,045,87422,7059,6939,401,7340,79
2021-10-03,Merced,047,269075,39714,39516,1593,41109,558
2021-10-03,Modoc,049,8938,487,472,170,642,5
2021-10-03,Mono,051,14174,1590,1554,20,1574,3
2021-10-03,Monterey,053,433212,47940,47049,2697,49746,571
2021-10-03,Napa,055,140530,12579,12489,98,12587,96
2021-10-03,Nevada,057,99092,8624,8545,305,8850,90
2021-10-03,Orange,059,3164182,300345,298027,14414,312441,5447
2021-10-03,Placer,061,380077,35049,34596,3349,37945,379
2021-10-03,Plumas,063,18699,1417,1328,25,1353,6
2021-10-03,Riverside,065,2383286,352951,348593,16105,364698,4924
2021-10-03,Sacramento,067,1510023,151627,150664,4020,154684,2120
2021-10-03,San Benito,069,59416,7106,7095,151,7246,69
2021-10-03,San Bernardino,071,2135413,344567,342302,10808,353110,5555
2021-10-03,San Diego,073,3302833,360154,358153,21194,379347,4081
2021-10-03,San Francisco,075,870044,51283,50733,2211,52944,638
2021-10-03,San Joaquin,077,732212,95989,95133,5157,100290,1649
2021-10-03,San Luis Obispo,079,281455,28447,28065,1154,29219,325
2021-10-03,San Mateo,081,765935,52766,51923,813,52736,569
2021-10-03,Santa Barbara,083,443738,42886,42550,1501,44051,511
2021-10-03,Santa Clara,085,1922200,142862,141737,1175,142912,1869
2021-10-03,Santa Cruz,087,273765,19749,19548,984,20532,216
2021-10-03,Shasta,089,179085,19492,19132,3248,22380,279
2021-10-03,Sierra,091,2930,142,136,14,150,0
2021-10-03,Siskiyou,093,43540,3183,3096,1164,4260,42
2021-10-03,Solano,095,438530,44737,44051,1185,45236,322
2021-10-03,Sonoma,097,501317,39916,39679,499,40178,381
2021-10-03,Stanislaus,099,539301,74338,74366,8424,82790,1106
2021-10-03,Sutter,101,95872,13303,13248,281,13529,164
2021-10-03,Tehama,103,63373,7705,7564,1295,8859,94
2021-10-03,Trinity,105,12862,793,647,203,850,11
2021-10-03,Tulare,107,460477,64117,62860,13469,76329,924
2021-10-03,Tuolumne,109,53932,6505,6430,76,6506,89
2021-10-03,Ventura,111,848112,95931,95108,4206,99314,1153
2021-10-03,Yolo,113,214977,18981,18720,1000,19720,242
2021-10-03,Yuba,115,75493,9573,9462,227,9689,68
2021-10-02,Alameda,001,1643700,116235,115185,2670,117855,1343
2021-10-02,Alpine,003,1148,99,102,0,102,0
2021-10-02,Amador,005,37829,5245,5105,53,5158,61
2021-10-02,Butte,007,227075,19438,18911,3504,22415,243
2021-10-02,Calaveras,009,45235,3689,3585,42,3627,72
2021-10-02,Colusa,011,21464,2435,2403,562,2965,18
2021-10-02,Contra Costa,013,1133247,96459,95369,2034,97403,933
2021-10-02,Del Norte,015,27424,3563,3468,39,3507,39
2021-10-02,El Dorado,017,186661,15199,14887,1597,16484,136
2021-10-02,Fresno,019,978130,131163,128450,11892,140342,1964
2021-10-02,Glenn,021,27897,3307,3234,948,4182,26
2021-10-02,Humboldt,023,135768,8450,8244,436,8680,94
2021-10-02,Imperial,025,180216,32046,31674,3051,34725,757
2021-10-02,Inyo,027,18085,1817,1746,37,1783,39
2021-10-02,Kern,029,883053,120346,117962,19368,137330,1524
2021-10-02,Kings,031,150075,30089,29339,1754,31093,301
2021-10-02,Lake,033,64148,6324,6191,126,6317,97
2021-10-02,Lassen,035,31185,6494,6360,304,6664,25
2021-10-02,Los Angeles,037,10098052,1409562,1395070,52592,1447662,26126
2021-10-02,Madera,039,155013,21450,20931,1800,22731,266
2021-10-02,Marin,041,260295,17119,16936,415,17351,242
2021-10-02,Mariposa,043,17540,1052,967,33,1000,5
2021-10-02,Mendocino,045,87422,7049,6869,401,7270,78
2021-10-02,Merced,047,269075,39687,39196,1589,40785,552
2021-10-02,Modoc,049,8938,485,468,170,638,5
2021-10-02,Mono,051,14174,1588,1540,20,1560,3
2021-10-02,Monterey,053,433212,47885,46964,2696,49660,571
2021-10-02,Napa,055,140530,12568,12433,98,12531,96
2021-10-02,Nevada,057,99092,8613,8474,304,8778,87
2021-10-02,Orange,059,3164182,300180,297307,14394,311701,5435
2021-10-02,Placer,061,380077,34983,34377,3340,37717,381
2021-10-02,Plumas,063,18699,1406,1298,25,1323,6
2021-10-02,Riverside,065,2383286,352710,347227,16094,363321,4895
2021-10-02,Sacramento,067,1510023,151453,149897,4012,153909,2099
2021-10-02,San Benito,069,59416,7099,7055,151,7206,69
2021-10-02,San Bernardino,071,2135413,344383,341212,10756,351968,5540
2021-10-02,San Diego,073,3302833,359837,356454,21172,377626,4078
2021-10-02,San Francisco,075,870044,51234,50393,2206,52599,634
2021-10-02,San Joaquin,077,732212,95924,94599,5151,99750,1646
2021-10-02,San Luis Obispo,079,281455,28423,27915,1154,29069,323
2021-10-02,San Mateo,081,765935,52725,51767,809,52576,573
2021-10-02,Santa Barbara,083,443738,42846,42423,1501,43924,508
2021-10-02,Santa Clara,085,1922200,142748,141231,1171,142402,1862
2021-10-02,Santa Cruz,087,273765,19732,19461,983,20444,214
2021-10-02,Shasta,089,179085,19446,18912,3242,22154,270
2021-10-02,Sierra,091,2930,141,131,14,145,0
2021-10-02,Siskiyou,093,43540,3182,3053,1161,4214,42
2021-10-02,Solano,095,438530,44692,43800,1184,44984,321
2021-10-02,Sonoma,097,501317,39882,39497,498,39995,382
2021-10-02,Stanislaus,099,539301,74252,73859,8411,82270,1099
2021-10-02,Sutter,101,95872,13294,13160,280,13440,160
2021-10-02,Tehama,103,63373,7690,7453,1295,8748,93
2021-10-02,Trinity,105,12862,790,625,203,828,10
2021-10-02,Tulare,107,460477,64041,62247,13442,75689,908
2021-10-02,Tuolumne,109,53932,6491,6369,76,6445,89
2021-10-02,Ventura,111,848112,95859,94854,4201,99055,1148
2021-10-02,Yolo,113,214977,18956,18640,996,19636,242
2021-10-02,Yuba,115,75493,9554,9370,226,9596,66
2021-10-01,Alameda,001,1643700,116159,115185,2663,117848,1343
2021-10-01,Alpine,003,1148,99,102,0,102,0
2021-10-01,Amador,005,37829,5225,5105,53,5158,61
2021-10-01,Butte,007,227075,19397,18911,3497,22408,243
2021-10-01,Calaveras,009,45235,3679,3585,42,3627,72
2021-10-01,Colusa,011,21464,2433,2403,562,2965,18
2021-10-01,Contra Costa,013,1133247,96362,95369,2030,97399,933
2021-10-01,Del Norte,015,27424,3560,3468,38,3506,39
2021-10-01,El Dorado,017,186661,15182,14887,1593,16480,136
2021-10-01,Fresno,019,978130,130975,128450,11882,140332,1964
2021-10-01,Glenn,021,27897,3305,3234,947,4181,26
2021-10-01,Humboldt,023,135768,8433,8244,436,8680,94
2021-10-01,Imperial,025,180216,32027,31674,3042,34716,757
2021-10-01,Inyo,027,18085,1808,1746,37,1783,39
2021-10-01,Kern,029,883053,120193,117962,19310,137272,1524
2021-10-01,Kings,031,150075,30055,29339,1748,31087,301
2021-10-01,Lake,033,64148,6314,6191,126,6317,97
2021-10-01,Lassen,035,31185,6483,6360,303,6663,25
2021-10-01,Los Angeles,037,10098052,1408801,1395070,52547,1447617,26126
2021-10-01,Madera,039,155013,21400,20931,1791,22722,266
2021-10-01,Marin,041,260295,17104,16936,414,17350,242
2021-10-01,Mariposa,043,17540,1045,967,33,1000,5
2021-10-01,Mendocino,045,87422,7037,6869,401,7270,78
2021-10-01,Merced,047,269075,39643,39196,1580,40776,552
2021-10-01,Modoc,049,8938,484,468,170,638,5
2021-10-01,Mono,051,14174,1585,1540,20,1560,3
2021-10-01,Monterey,053,433212,47864,46964,2693,49657,571
2021-10-01,Napa,055,140530,12558,12433,97,12530,96
2021-10-01,Nevada,057,99092,8599,8474,303,8777,87
2021-10-01,Orange,059,3164182,299996,297307,14374,311681,5435
2021-10-01,Placer,061,380077,34949,34377,3336,37713,381
2021-10-01,Plumas,063,18699,1397,1298,25,1323,6
2021-10-01,Riverside,065,2383286,352417,347227,16086,363313,4895
2021-10-01,Sacramento,067,1510023,151301,149897,4001,153898,2099
2021-10-01,San Benito,069,59416,7097,7055,149,7204,69
2021-10-01,San Bernardino,071,2135413,344183,341212,10753,351965,5540
2021-10-01,San Diego,073,3302833,359477,356454,21151,377605,4078
2021-10-01,San Francisco,075,870044,51193,50393,2204,52597,634
2021-10-01,San Joaquin,077,732212,95854,94599,5147,99746,1646
2021-10-01,San Luis Obispo,079,281455,28399,27915,1151,29066,323
2021-10-01,San Mateo,081,765935,52685,51767,806,52573,573
2021-10-01,Santa Barbara,083,443738,42810,42423,1501,43924,508
2021-10-01,Santa Clara,085,1922200,142655,141231,1166,142397,1862
2021-10-01,Santa Cruz,087,273765,19712,19461,982,20443,214
2021-10-01,Shasta,089,179085,19392,18912,3234,22146,270
2021-10-01,Sierra,091,2930,141,131,14,145,0
2021-10-01,Siskiyou,093,43540,3181,3053,1158,4211,42
2021-10-01,Solano,095,438530,44640,43800,1178,44978,321
2021-10-01,Sonoma,097,501317,39850,39497,497,39994,382
2021-10-01,Stanislaus,099,539301,74168,73859,8400,82259,1099
2021-10-01,Sutter,101,95872,13278,13160,278,13438,160
2021-10-01,Tehama,103,63373,7678,7453,1293,8746,93
2021-10-01,Trinity,105,12862,788,625,203,828,10
2021-10-01,Tulare,107,460477,63938,62247,13407,75654,908
2021-10-01,Tuolumne,109,53932,6474,6369,76,6445,89
2021-10-01,Ventura,111,848112,95792,94854,4196,99050,1148
2021-10-01,Yolo,113,214977,18932,18640,992,19632,242
2021-10-01,Yuba,115,75493,9532,9370,226,9596,66
2021-09-30,Alameda,001,1643700,116013,115185,2660,117845,1343
2021-09-30,Alpine,003,1148,99,102,0,102,0
2021-09-30,Amador,005,37829,5213,5105,53,5158,61
2021-09-30,Butte,007,227075,19348,18911,3488,22399,243
2021-09-30,Calaveras,009,45235,3665,3585,42,3627,72
2021-09-30,Colusa,011,21464,2430,2403,561,2964,18
2021-09-30,Contra Costa,013,1133247,96257,95369,2024,97393,933
2021-09-30,Del Norte,015,27424,3556,3468,35,3503,39
2021-09-30,El Dorado,017,186661,15156,14887,1585,16472,136
2021-09-30,Fresno,019,978130,130699,128450,11848,140298,1964
2021-09-30,Glenn,021,27897,3295,3234,945,4179,26
2021-09-30,Humboldt,023,135768,8401,8244,430,8674,94
2021-09-30,Imperial,025,180216,31975,31674,3040,34714,757
2021-09-30,Inyo,027,18085,1798,1746,37,1783,39
2021-09-30,Kern,029,883053,119949,117962,19228,137190,1524
2021-09-30,Kings,031,150075,29965,29339,1744,31083,301
2021-09-30,Lake,033,64148,6296,6191,126,6317,97
2021-09-30,Lassen,035,31185,6469,6360,303,6663,25
2021-09-30,Los Angeles,037,10098052,1407597,1395070,52487,1447557,26126
2021-09-30,Madera,039,155013,21317,20931,1776,22707,266
2021-09-30,Marin,041,260295,17084,16936,413,17349,242
2021-09-30,Mariposa,043,17540,1023,967,33,1000,5
2021-09-30,Mendocino,045,87422,7028,6869,392,7261,78
2021-09-30,Merced,047,269075,39546,39196,1576,40772,552
2021-09-30,Modoc,049,8938,484,468,169,637,5
2021-09-30,Mono,051,14174,1577,1540,20,1560,3
2021-09-30,Monterey,053,433212,47834,46964,2681,49645,571
2021-09-30,Napa,055,140530,12538,12433,97,12530,96
2021-09-30,Nevada,057,99092,8582,8474,302,8776,87
2021-09-30,Orange,059,3164182,299724,297307,14335,311642,5435
2021-09-30,Placer,061,380077,34895,34377,3316,37693,381
2021-09-30,Plumas,063,18699,1379,1298,25,1323,6
2021-09-30,Riverside,065,2383286,351984,347227,16065,363292,4895
2021-09-30,Sacramento,067,1510023,151040,149897,3975,153872,2099
2021-09-30,San Benito,069,59416,7091,7055,149,7204,69
2021-09-30,San Bernardino,071,2135413,343872,341212,10739,351951,5540
2021-09-30,San Diego,073,3302833,358996,356454,21125,377579,4078
2021-09-30,San Francisco,075,870044,51116,50393,2200,52593,634
2021-09-30,San Joaquin,077,732212,95724,94599,5139,99738,1646
2021-09-30,San Luis Obispo,079,281455,28351,27915,1147,29062,323
2021-09-30,San Mateo,081,765935,52636,51767,803,52570,573
2021-09-30,Santa Barbara,083,443738,42753,42423,1500,43923,508
2021-09-30,Santa Clara,085,1922200,142505,141231,1163,142394,1862
2021-09-30,Santa Cruz,087,273765,19672,19461,981,20442,214
2021-09-30,Shasta,089,179085,19330,18912,3219,22131,270
2021-09-30,Sierra,091,2930,140,131,14,145,0
2021-09-30,Siskiyou,093,43540,3173,3053,1153,4206,42
2021-09-30,Solano,095,438530,44586,43800,1175,44975,321
2021-09-30,Sonoma,097,501317,39801,39497,497,39994,382
2021-09-30,Stanislaus,099,539301,74008,73859,8381,82240,1099
2021-09-30,Sutter,101,95872,13257,13160,278,13438,160
2021-09-30,Tehama,103,63373,7641,7453,1281,8734,93
2021-09-30,Trinity,105,12862,784,625,203,828,10
2021-09-30,Tulare,107,460477,63762,62247,13349,75596,908
2021-09-30,Tuolumne,109,53932,6451,6369,76,6445,89
2021-09-30,Ventura,111,848112,95687,94854,4189,99043,1148
2021-09-30,Yolo,113,214977,18893,18640,989,19629,242
2021-09-30,Yuba,115,75493,9509,9370,225,9595,66
2021-09-29,Alameda,001,1643700,115869,114998,2657,117655,1339
2021-09-29,Alpine,003,1148,99,101,0,101,0
2021-09-29,Amador,005,37829,5191,5058,53,5111,61
2021-09-29,Butte,007,227075,19294,18835,3481,22316,242
2021-09-29,Calaveras,009,45235,3648,3553,41,3594,72
2021-09-29,Colusa,011,21464,2428,2401,561,2962,18
2021-09-29,Contra Costa,013,1133247,96143,95213,2016,97229,929
2021-09-29,Del Norte,015,27424,3550,3467,35,3502,39
2021-09-29,El Dorado,017,186661,15122,14834,1578,16412,136
2021-09-29,Fresno,019,978130,130399,128068,11827,139895,1957
2021-09-29,Glenn,021,27897,3290,3213,943,4156,26
2021-09-29,Humboldt,023,135768,8377,8203,429,8632,94
2021-09-29,Imperial,025,180216,31908,31600,3035,34635,757
2021-09-29,Inyo,027,18085,1788,1740,36,1776,39
2021-09-29,Kern,029,883053,119714,117605,19152,136757,1513
2021-09-29,Kings,031,150075,29883,29195,1729,30924,299
2021-09-29,Lake,033,64148,6276,6164,126,6290,97
2021-09-29,Lassen,035,31185,6455,6347,303,6650,25
2021-09-29,Los Angeles,037,10098052,1406385,1393617,52415,1446032,26098
2021-09-29,Madera,039,155013,21272,20818,1760,22578,266
2021-09-29,Marin,041,260295,17066,16921,411,17332,242
2021-09-29,Mariposa,043,17540,1008,963,33,996,5
2021-09-29,Mendocino,045,87422,7016,6821,384,7205,78
2021-09-29,Merced,047,269075,39452,39026,1565,40591,552
2021-09-29,Modoc,049,8938,482,468,169,637,5
2021-09-29,Mono,051,14174,1575,1527,20,1547,3
2021-09-29,Monterey,053,433212,47796,46917,2667,49584,571
2021-09-29,Napa,055,140530,12518,12416,93,12509,96
2021-09-29,Nevada,057,99092,8569,8434,302,8736,87
2021-09-29,Orange,059,3164182,299456,296936,14299,311235,5429
2021-09-29,Placer,061,380077,34831,34271,3293,37564,379
2021-09-29,Plumas,063,18699,1360,1289,25,1314,6
2021-09-29,Riverside,065,2383286,351550,346558,16052,362610,4886
2021-09-29,Sacramento,067,1510023,150789,149686,3965,153651,2099
2021-09-29,San Benito,069,59416,7080,7039,149,7188,69
2021-09-29,San Bernardino,071,2135413,343550,340672,10725,351397,5539
2021-09-29,San Diego,073,3302833,358509,355899,21095,376994,4066
2021-09-29,San Francisco,075,870044,51031,50286,2196,52482,629
2021-09-29,San Joaquin,077,732212,95566,94356,5117,99473,1645
2021-09-29,San Luis Obispo,079,281455,28305,27800,1141,28941,323
2021-09-29,San Mateo,081,765935,52576,51673,801,52474,573
2021-09-29,Santa Barbara,083,443738,42681,42328,1497,43825,507
2021-09-29,Santa Clara,085,1922200,142370,141036,1157,142193,1861
2021-09-29,Santa Cruz,087,273765,19654,19425,980,20405,214
2021-09-29,Shasta,089,179085,19264,18805,3207,22012,271
2021-09-29,Sierra,091,2930,136,130,14,144,0
2021-09-29,Siskiyou,093,43540,3160,3043,1146,4189,42
2021-09-29,Solano,095,438530,44530,43724,1168,44892,321
2021-09-29,Sonoma,097,501317,39740,39426,495,39921,370
2021-09-29,Stanislaus,099,539301,73877,73634,8370,82004,1096
2021-09-29,Sutter,101,95872,13230,13135,275,13410,155
2021-09-29,Tehama,103,63373,7611,7409,1266,8675,88
2021-09-29,Trinity,105,12862,780,616,203,819,10
2021-09-29,Tulare,107,460477,63589,62046,13290,75336,908
2021-09-29,Tuolumne,109,53932,6434,6336,76,6412,89
2021-09-29,Ventura,111,848112,95597,94753,4185,98938,1144
2021-09-29,Yolo,113,214977,18860,18587,984,19571,239
2021-09-29,Yuba,115,75493,9478,9351,221,9572,66
2021-09-28,Alameda,001,1643700,115711,114869,2651,117520,1333
2021-09-28,Alpine,003,1148,99,101,0,101,0
2021-09-28,Amador,005,37829,5169,5049,53,5102,61
2021-09-28,Butte,007,227075,19245,18764,3468,22232,241
2021-09-28,Calaveras,009,45235,3628,3530,41,3571,72
2021-09-28,Colusa,011,21464,2425,2399,559,2958,18
2021-09-28,Contra Costa,013,1133247,96002,95115,2011,97126,929
2021-09-28,Del Norte,015,27424,3547,3462,35,3497,39
2021-09-28,El Dorado,017,186661,15076,14793,1574,16367,133
2021-09-28,Fresno,019,978130,130054,127877,11793,139670,1948
2021-09-28,Glenn,021,27897,3285,3205,942,4147,26
2021-09-28,Humboldt,023,135768,8336,8159,426,8585,91
2021-09-28,Imperial,025,180216,31863,31543,3031,34574,757
2021-09-28,Inyo,027,18085,1774,1708,35,1743,39
2021-09-28,Kern,029,883053,119445,117420,19057,136477,1506
2021-09-28,Kings,031,150075,29781,29141,1721,30862,295
2021-09-28,Lake,033,64148,6261,6155,126,6281,95
2021-09-28,Lassen,035,31185,6449,6340,299,6639,25
2021-09-28,Los Angeles,037,10098052,1405091,1392445,52346,1444791,26068
2021-09-28,Madera,039,155013,21218,20764,1744,22508,266
2021-09-28,Marin,041,260295,17047,16887,409,17296,242
2021-09-28,Mariposa,043,17540,1003,952,33,985,5
2021-09-28,Mendocino,045,87422,6994,6804,382,7186,78
2021-09-28,Merced,047,269075,39365,38953,1552,40505,551
2021-09-28,Modoc,049,8938,481,467,169,636,5
2021-09-28,Mono,051,14174,1565,1527,20,1547,3
2021-09-28,Monterey,053,433212,47759,46859,2658,49517,571
2021-09-28,Napa,055,140530,12501,12388,92,12480,96
2021-09-28,Nevada,057,99092,8546,8409,301,8710,84
2021-09-28,Orange,059,3164182,299203,296596,14271,310867,5421
2021-09-28,Placer,061,380077,34766,34187,3275,37462,370
2021-09-28,Plumas,063,18699,1351,1276,25,1301,6
2021-09-28,Riverside,065,2383286,351091,346096,16031,362127,4874
2021-09-28,Sacramento,067,1510023,150499,149310,3943,153253,2086
2021-09-28,San Benito,069,59416,7063,7028,148,7176,69
2021-09-28,San Bernardino,071,2135413,343202,340342,10708,351050,5540
2021-09-28,San Diego,073,3302833,357962,355373,21063,376436,4054
2021-09-28,San Francisco,075,870044,50930,50234,2195,52429,627
2021-09-28,San Joaquin,077,732212,95412,94194,5104,99298,1639
2021-09-28,San Luis Obispo,079,281455,28271,27755,1136,28891,321
2021-09-28,San Mateo,081,765935,52531,51620,800,52420,571
2021-09-28,Santa Barbara,083,443738,42608,42226,1496,43722,506
2021-09-28,Santa Clara,085,1922200,142209,140886,1148,142034,1858
2021-09-28,Santa Cruz,087,273765,19613,19324,979,20303,214
2021-09-28,Shasta,089,179085,19203,18701,3193,21894,267
2021-09-28,Sierra,091,2930,135,130,13,143,0
2021-09-28,Siskiyou,093,43540,3148,3032,1143,4175,42
2021-09-28,Solano,095,438530,44457,43652,1165,44817,316
2021-09-28,Sonoma,097,501317,39693,39395,494,39889,370
2021-09-28,Stanislaus,099,539301,73706,73528,8358,81886,1094
2021-09-28,Sutter,101,95872,13211,13102,271,13373,155
2021-09-28,Tehama,103,63373,7593,7382,1251,8633,88
2021-09-28,Trinity,105,12862,777,613,203,816,10
2021-09-28,Tulare,107,460477,63429,61916,13231,75147,905
2021-09-28,Tuolumne,109,53932,6408,6308,76,6384,89
2021-09-28,Ventura,111,848112,95471,94632,4182,98814,1143
2021-09-28,Yolo,113,214977,18834,18564,981,19545,239
2021-09-28,Yuba,115,75493,9459,9323,220,9543,66
2021-09-27,Alameda,001,1643700,115517,114731,2642,117373,1327
2021-09-27,Alpine,003,1148,99,101,0,101,0
2021-09-27,Amador,005,37829,5155,5017,53,5070,59
2021-09-27,Butte,007,227075,19186,18687,3452,22139,239
2021-09-27,Calaveras,009,45235,3608,3514,40,3554,70
2021-09-27,Colusa,011,21464,2424,2393,558,2951,18
2021-09-27,Contra Costa,013,1133247,95871,94979,2002,96981,924
2021-09-27,Del Norte,015,27424,3545,3468,33,3501,37
2021-09-27,El Dorado,017,186661,15037,14764,1567,16331,132
2021-09-27,Fresno,019,978130,129733,127475,11759,139234,1942
2021-09-27,Glenn,021,27897,3272,3189,938,4127,26
2021-09-27,Humboldt,023,135768,8296,8118,426,8544,91
2021-09-27,Imperial,025,180216,31800,31491,3024,34515,756
2021-09-27,Inyo,027,18085,1762,1698,35,1733,39
2021-09-27,Kern,029,883053,119170,117064,18959,136023,1503
2021-09-27,Kings,031,150075,29683,28998,1709,30707,297
2021-09-27,Lake,033,64148,6241,6126,124,6250,95
2021-09-27,Lassen,035,31185,6434,6327,295,6622,25
2021-09-27,Los Angeles,037,10098052,1403759,1391538,52277,1443815,26040
2021-09-27,Madera,039,155013,21153,20691,1736,22427,262
2021-09-27,Marin,041,260295,17026,16861,408,17269,242
2021-09-27,Mariposa,043,17540,993,931,33,964,5
2021-09-27,Mendocino,045,87422,6968,6761,375,7136,74
2021-09-27,Merced,047,269075,39265,38840,1546,40386,548
2021-09-27,Modoc,049,8938,480,465,167,632,5
2021-09-27,Mono,051,14174,1553,1525,20,1545,3
2021-09-27,Monterey,053,433212,47716,46811,2646,49457,571
2021-09-27,Napa,055,140530,12477,12354,91,12445,95
2021-09-27,Nevada,057,99092,8522,8379,298,8677,84
2021-09-27,Orange,059,3164182,298898,296334,14240,310574,5409
2021-09-27,Placer,061,380077,34679,34087,3270,37357,370
2021-09-27,Plumas,063,18699,1341,1269,25,1294,6
2021-09-27,Riverside,065,2383286,350649,345529,16021,361550,4864
2021-09-27,Sacramento,067,1510023,150182,149096,3921,153017,2076
2021-09-27,San Benito,069,59416,7046,7017,148,7165,67
2021-09-27,San Bernardino,071,2135413,342790,339952,10683,350635,5544
2021-09-27,San Diego,073,3302833,357310,354755,21038,375793,4054
2021-09-27,San Francisco,075,870044,50846,50157,2191,52348,622
2021-09-27,San Joaquin,077,732212,95228,94085,5101,99186,1633
2021-09-27,San Luis Obispo,079,281455,28216,27674,1133,28807,320
2021-09-27,San Mateo,081,765935,52455,51552,800,52352,571
2021-09-27,Santa Barbara,083,443738,42541,42012,1492,43504,505
2021-09-27,Santa Clara,085,1922200,142028,140802,1138,141940,1853
2021-09-27,Santa Cruz,087,273765,19589,19292,978,20270,214
2021-09-27,Shasta,089,179085,19122,18599,3166,21765,267
2021-09-27,Sierra,091,2930,135,128,13,141,0
2021-09-27,Siskiyou,093,43540,3136,3015,1138,4153,42
2021-09-27,Solano,095,438530,44382,43582,1159,44741,314
2021-09-27,Sonoma,097,501317,39639,39347,494,39841,370
2021-09-27,Stanislaus,099,539301,73552,73370,8338,81708,1091
2021-09-27,Sutter,101,95872,13180,13082,268,13350,155
2021-09-27,Tehama,103,63373,7552,7345,1242,8587,88
2021-09-27,Trinity,105,12862,766,605,202,807,9
2021-09-27,Tulare,107,460477,63229,61708,13160,74868,904
2021-09-27,Tuolumne,109,53932,6387,6264,76,6340,89
2021-09-27,Ventura,111,848112,95346,94477,4178,98655,1138
2021-09-27,Yolo,113,214977,18801,18524,980,19504,239
2021-09-27,Yuba,115,75493,9422,9292,216,9508,64
2021-09-26,Alameda,001,1643700,115322,114601,2635,117236,1326
2021-09-26,Alpine,003,1148,99,101,0,101,0
2021-09-26,Amador,005,37829,5123,5001,52,5053,59
2021-09-26,Butte,007,227075,19111,18634,3435,22069,238
2021-09-26,Calaveras,009,45235,3586,3505,40,3545,70
2021-09-26,Colusa,011,21464,2419,2392,556,2948,18
2021-09-26,Contra Costa,013,1133247,95696,94877,1989,96866,924
2021-09-26,Del Norte,015,27424,3540,3466,32,3498,37
2021-09-26,El Dorado,017,186661,14995,14738,1559,16297,132
2021-09-26,Fresno,019,978130,129375,127235,11713,138948,1939
2021-09-26,Glenn,021,27897,3264,3182,934,4116,26
2021-09-26,Humboldt,023,135768,8261,8098,425,8523,91
2021-09-26,Imperial,025,180216,31739,31462,3023,34485,756
2021-09-26,Inyo,027,18085,1747,1685,35,1720,39
2021-09-26,Kern,029,883053,118832,116927,18849,135776,1502
2021-09-26,Kings,031,150075,29582,28930,1698,30628,293
2021-09-26,Lake,033,64148,6224,6113,124,6237,95
2021-09-26,Lassen,035,31185,6424,6319,290,6609,25
2021-09-26,Los Angeles,037,10098052,1402272,1390577,52206,1442783,26035
2021-09-26,Madera,039,155013,21078,20629,1717,22346,262
2021-09-26,Marin,041,260295,17003,16860,408,17268,242
2021-09-26,Mariposa,043,17540,987,929,33,962,5
2021-09-26,Mendocino,045,87422,6934,6744,360,7104,74
2021-09-26,Merced,047,269075,39104,38717,1538,40255,548
2021-09-26,Modoc,049,8938,480,465,166,631,5
2021-09-26,Mono,051,14174,1549,1516,20,1536,3
2021-09-26,Monterey,053,433212,47669,46792,2632,49424,571
2021-09-26,Napa,055,140530,12453,12340,90,12430,95
2021-09-26,Nevada,057,99092,8491,8356,293,8649,84
2021-09-26,Orange,059,3164182,298559,296085,14207,310292,5409
2021-09-26,Placer,061,380077,34585,34043,3260,37303,370
2021-09-26,Plumas,063,18699,1323,1268,25,1293,6
2021-09-26,Riverside,065,2383286,350117,345257,16007,361264,4864
2021-09-26,Sacramento,067,1510023,149776,148745,3902,152647,2071
2021-09-26,San Benito,069,59416,7029,7012,147,7159,67
2021-09-26,San Bernardino,071,2135413,342332,339771,10668,350439,5545
2021-09-26,San Diego,073,3302833,356688,354414,20997,375411,4051
2021-09-26,San Francisco,075,870044,50720,50092,2182,52274,622
2021-09-26,San Joaquin,077,732212,95025,93935,5087,99022,1633
2021-09-26,San Luis Obispo,079,281455,28142,27624,1128,28752,319
2021-09-26,San Mateo,081,765935,52386,51496,798,52294,571
2021-09-26,Santa Barbara,083,443738,42454,41946,1489,43435,505
2021-09-26,Santa Clara,085,1922200,141827,140667,1134,141801,1852
2021-09-26,Santa Cruz,087,273765,19564,19279,978,20257,214
2021-09-26,Shasta,089,179085,19013,18566,3143,21709,266
2021-09-26,Sierra,091,2930,135,128,13,141,0
2021-09-26,Siskiyou,093,43540,3122,2998,1128,4126,42
2021-09-26,Solano,095,438530,44315,43537,1158,44695,314
2021-09-26,Sonoma,097,501317,39580,39302,494,39796,370
2021-09-26,Stanislaus,099,539301,73352,73243,8310,81553,1091
2021-09-26,Sutter,101,95872,13143,13045,267,13312,155
2021-09-26,Tehama,103,63373,7495,7323,1231,8554,88
2021-09-26,Trinity,105,12862,763,591,202,793,9
2021-09-26,Tulare,107,460477,63008,61560,13082,74642,904
2021-09-26,Tuolumne,109,53932,6359,6236,74,6310,89
2021-09-26,Ventura,111,848112,95232,94391,4171,98562,1138
2021-09-26,Yolo,113,214977,18764,18496,972,19468,239
2021-09-26,Yuba,115,75493,9395,9275,216,9491,64
2021-09-25,Alameda,001,1643700,115243,114014,2632,116646,1324
2021-09-25,Alpine,003,1148,99,101,0,101,0
2021-09-25,Amador,005,37829,5109,4934,52,4986,59
2021-09-25,Butte,007,227075,19082,18396,3427,21823,236
2021-09-25,Calaveras,009,45235,3583,3461,40,3501,70
2021-09-25,Colusa,011,21464,2416,2387,554,2941,16
2021-09-25,Contra Costa,013,1133247,95625,94337,1985,96322,924
2021-09-25,Del Norte,015,27424,3539,3404,32,3436,35
2021-09-25,El Dorado,017,186661,14972,14641,1555,16196,130
2021-09-25,Fresno,019,978130,129230,126299,11697,137996,1927
2021-09-25,Glenn,021,27897,3259,3144,933,4077,25
2021-09-25,Humboldt,023,135768,8242,8014,423,8437,88
2021-09-25,Imperial,025,180216,31712,31280,3023,34303,755
2021-09-25,Inyo,027,18085,1739,1657,35,1692,39
2021-09-25,Kern,029,883053,118677,116021,18781,134802,1485
2021-09-25,Kings,031,150075,29531,28636,1695,30331,293
2021-09-25,Lake,033,64148,6219,6046,122,6168,92
2021-09-25,Lassen,035,31185,6412,6248,289,6537,25
2021-09-25,Los Angeles,037,10098052,1401559,1386417,52166,1438583,25964
2021-09-25,Madera,039,155013,21053,20432,1711,22143,262
2021-09-25,Marin,041,260295,16994,16802,406,17208,242
2021-09-25,Mariposa,043,17540,982,906,33,939,5
2021-09-25,Mendocino,045,87422,6915,6657,359,7016,74
2021-09-25,Merced,047,269075,39058,38393,1536,39929,546
2021-09-25,Modoc,049,8938,480,460,166,626,5
2021-09-25,Mono,051,14174,1546,1501,20,1521,3
2021-09-25,Monterey,053,433212,47639,46653,2630,49283,567
2021-09-25,Napa,055,140530,12433,12266,90,12356,95
2021-09-25,Nevada,057,99092,8474,8285,293,8578,84
2021-09-25,Orange,059,3164182,298386,294514,14189,308703,5374
2021-09-25,Placer,061,380077,34521,33764,3258,37022,367
2021-09-25,Plumas,063,18699,1319,1238,25,1263,6
2021-09-25,Riverside,065,2383286,349794,343463,15999,359462,4843
2021-09-25,Sacramento,067,1510023,149601,147728,3893,151621,2049
2021-09-25,San Benito,069,59416,7024,6965,147,7112,67
2021-09-25,San Bernardino,071,2135413,342096,338413,10654,349067,5540
2021-09-25,San Diego,073,3302833,356343,352017,20971,372988,4039
2021-09-25,San Francisco,075,870044,50676,49840,2181,52021,615
2021-09-25,San Joaquin,077,732212,94939,93273,5085,98358,1628
2021-09-25,San Luis Obispo,079,281455,28104,27447,1124,28571,318
2021-09-25,San Mateo,081,765935,52322,51266,796,52062,568
2021-09-25,Santa Barbara,083,443738,42396,41728,1489,43217,505
2021-09-25,Santa Clara,085,1922200,141721,140023,1132,141155,1844
2021-09-25,Santa Cruz,087,273765,19548,19200,976,20176,214
2021-09-25,Shasta,089,179085,18962,18256,3134,21390,262
2021-09-25,Sierra,091,2930,134,127,13,140,0
2021-09-25,Siskiyou,093,43540,3115,2956,1118,4074,41
2021-09-25,Solano,095,438530,44274,43331,1155,44486,312
2021-09-25,Sonoma,097,501317,39539,39112,494,39606,369
2021-09-25,Stanislaus,099,539301,73242,72628,8296,80924,1091
2021-09-25,Sutter,101,95872,13125,12976,264,13240,154
2021-09-25,Tehama,103,63373,7479,7200,1229,8429,86
2021-09-25,Trinity,105,12862,763,576,202,778,9
2021-09-25,Tulare,107,460477,62926,60909,13038,73947,898
2021-09-25,Tuolumne,109,53932,6347,6168,74,6242,89
2021-09-25,Ventura,111,848112,95165,94059,4167,98226,1129
2021-09-25,Yolo,113,214977,18742,18393,971,19364,239
2021-09-25,Yuba,115,75493,9375,9191,216,9407,61
2021-09-24,Alameda,001,1643700,115139,114014,2628,116642,1324
2021-09-24,Alpine,003,1148,99,101,0,101,0
2021-09-24,Amador,005,37829,5079,4934,52,4986,59
2021-09-24,Butte,007,227075,19030,18396,3417,21813,236
2021-09-24,Calaveras,009,45235,3576,3461,39,3500,70
2021-09-24,Colusa,011,21464,2413,2387,553,2940,16
2021-09-24,Contra Costa,013,1133247,95515,94337,1981,96318,924
2021-09-24,Del Norte,015,27424,3536,3404,32,3436,35
2021-09-24,El Dorado,017,186661,14954,14641,1551,16192,130
2021-09-24,Fresno,019,978130,129032,126299,11685,137984,1927
2021-09-24,Glenn,021,27897,3251,3144,933,4077,25
2021-09-24,Humboldt,023,135768,8223,8014,420,8434,88
2021-09-24,Imperial,025,180216,31674,31280,3021,34301,755
2021-09-24,Inyo,027,18085,1730,1657,35,1692,39
2021-09-24,Kern,029,883053,118541,116021,18715,134736,1485
2021-09-24,Kings,031,150075,29490,28636,1690,30326,293
2021-09-24,Lake,033,64148,6211,6046,122,6168,92
2021-09-24,Lassen,035,31185,6404,6248,288,6536,25
2021-09-24,Los Angeles,037,10098052,1400677,1386417,52124,1438541,25964
2021-09-24,Madera,039,155013,21022,20432,1702,22134,262
2021-09-24,Marin,041,260295,16980,16802,405,17207,242
2021-09-24,Mariposa,043,17540,970,906,33,939,5
2021-09-24,Mendocino,045,87422,6902,6657,359,7016,74
2021-09-24,Merced,047,269075,39014,38393,1536,39929,546
2021-09-24,Modoc,049,8938,480,460,165,625,5
2021-09-24,Mono,051,14174,1541,1501,20,1521,3
2021-09-24,Monterey,053,433212,47618,46653,2622,49275,567
2021-09-24,Napa,055,140530,12414,12266,90,12356,95
2021-09-24,Nevada,057,99092,8460,8285,290,8575,84
2021-09-24,Orange,059,3164182,298179,294514,14171,308685,5374
2021-09-24,Placer,061,380077,34466,33764,3246,37010,367
2021-09-24,Plumas,063,18699,1315,1238,25,1263,6
2021-09-24,Riverside,065,2383286,349460,343463,15990,359453,4843
2021-09-24,Sacramento,067,1510023,149416,147728,3889,151617,2049
2021-09-24,San Benito,069,59416,7018,6965,147,7112,67
2021-09-24,San Bernardino,071,2135413,341828,338413,10644,349057,5540
2021-09-24,San Diego,073,3302833,355992,352017,20956,372973,4039
2021-09-24,San Francisco,075,870044,50612,49840,2173,52013,615
2021-09-24,San Joaquin,077,732212,94826,93273,5083,98356,1628
2021-09-24,San Luis Obispo,079,281455,28073,27447,1119,28566,318
2021-09-24,San Mateo,081,765935,52262,51266,795,52061,568
2021-09-24,Santa Barbara,083,443738,42356,41728,1488,43216,505
2021-09-24,Santa Clara,085,1922200,141609,140023,1131,141154,1844
2021-09-24,Santa Cruz,087,273765,19525,19200,975,20175,214
2021-09-24,Shasta,089,179085,18908,18256,3120,21376,262
2021-09-24,Sierra,091,2930,133,127,13,140,0
2021-09-24,Siskiyou,093,43540,3106,2956,1112,4068,41
2021-09-24,Solano,095,438530,44237,43331,1153,44484,312
2021-09-24,Sonoma,097,501317,39506,39112,494,39606,369
2021-09-24,Stanislaus,099,539301,73126,72628,8281,80909,1091
2021-09-24,Sutter,101,95872,13106,12976,263,13239,154
2021-09-24,Tehama,103,63373,7467,7200,1224,8424,86
2021-09-24,Trinity,105,12862,760,576,202,778,9
2021-09-24,Tulare,107,460477,62835,60909,12996,73905,898
2021-09-24,Tuolumne,109,53932,6318,6168,74,6242,89
2021-09-24,Ventura,111,848112,95087,94059,4160,98219,1129
2021-09-24,Yolo,113,214977,18710,18393,968,19361,239
2021-09-24,Yuba,115,75493,9356,9191,216,9407,61
2021-09-23,Alameda,001,1643700,114982,114014,2622,116636,1324
2021-09-23,Alpine,003,1148,99,101,0,101,0
2021-09-23,Amador,005,37829,5066,4934,52,4986,59
2021-09-23,Butte,007,227075,18968,18396,3393,21789,236
2021-09-23,Calaveras,009,45235,3555,3461,39,3500,70
2021-09-23,Colusa,011,21464,2411,2387,550,2937,16
2021-09-23,Contra Costa,013,1133247,95374,94337,1974,96311,924
2021-09-23,Del Norte,015,27424,3527,3404,31,3435,35
2021-09-23,El Dorado,017,186661,14928,14641,1545,16186,130
2021-09-23,Fresno,019,978130,128735,126299,11666,137965,1927
2021-09-23,Glenn,021,27897,3237,3144,930,4074,25
2021-09-23,Humboldt,023,135768,8198,8014,418,8432,88
2021-09-23,Imperial,025,180216,31638,31280,3021,34301,755
2021-09-23,Inyo,027,18085,1716,1657,35,1692,39
2021-09-23,Kern,029,883053,118283,116021,18634,134655,1485
2021-09-23,Kings,031,150075,29386,28636,1681,30317,293
2021-09-23,Lake,033,64148,6201,6046,122,6168,92
2021-09-23,Lassen,035,31185,6395,6248,283,6531,25
2021-09-23,Los Angeles,037,10098052,1399481,1386417,52060,1438477,25964
2021-09-23,Madera,039,155013,20940,20432,1698,22130,262
2021-09-23,Marin,041,260295,16965,16802,402,17204,242
2021-09-23,Mariposa,043,17540,957,906,33,939,5
2021-09-23,Mendocino,045,87422,6880,6657,354,7011,74
2021-09-23,Merced,047,269075,38911,38393,1529,39922,546
2021-09-23,Modoc,049,8938,479,460,165,625,5
2021-09-23,Mono,051,14174,1538,1501,20,1521,3
2021-09-23,Monterey,053,433212,47569,46653,2610,49263,567
2021-09-23,Napa,055,140530,12397,12266,90,12356,95
2021-09-23,Nevada,057,99092,8433,8285,290,8575,84
2021-09-23,Orange,059,3164182,297882,294514,14147,308661,5374
2021-09-23,Placer,061,380077,34390,33764,3239,37003,367
2021-09-23,Plumas,063,18699,1298,1238,24,1262,6
2021-09-23,Riverside,065,2383286,349007,343463,15983,359446,4843
2021-09-23,Sacramento,067,1510023,149086,147728,3869,151597,2049
2021-09-23,San Benito,069,59416,7007,6965,147,7112,67
2021-09-23,San Bernardino,071,2135413,341464,338413,10629,349042,5540
2021-09-23,San Diego,073,3302833,355536,352017,20917,372934,4039
2021-09-23,San Francisco,075,870044,50539,49840,2171,52011,615
2021-09-23,San Joaquin,077,732212,94653,93273,5068,98341,1628
2021-09-23,San Luis Obispo,079,281455,28030,27447,1117,28564,318
2021-09-23,San Mateo,081,765935,52187,51266,794,52060,568
2021-09-23,Santa Barbara,083,443738,42278,41728,1485,43213,505
2021-09-23,Santa Clara,085,1922200,141458,140023,1124,141147,1844
2021-09-23,Santa Cruz,087,273765,19494,19200,975,20175,214
2021-09-23,Shasta,089,179085,18828,18256,3103,21359,262
2021-09-23,Sierra,091,2930,133,127,13,140,0
2021-09-23,Siskiyou,093,43540,3102,2956,1101,4057,41
2021-09-23,Solano,095,438530,44169,43331,1150,44481,312
2021-09-23,Sonoma,097,501317,39447,39112,491,39603,369
2021-09-23,Stanislaus,099,539301,72970,72628,8249,80877,1091
2021-09-23,Sutter,101,95872,13077,12976,263,13239,154
2021-09-23,Tehama,103,63373,7426,7200,1219,8419,86
2021-09-23,Trinity,105,12862,746,576,201,777,9
2021-09-23,Tulare,107,460477,62658,60909,12942,73851,898
2021-09-23,Tuolumne,109,53932,6293,6168,73,6241,89
2021-09-23,Ventura,111,848112,94983,94059,4153,98212,1129
2021-09-23,Yolo,113,214977,18679,18393,963,19356,239
2021-09-23,Yuba,115,75493,9328,9191,215,9406,61
2021-09-22,Alameda,001,1643700,114827,113862,2618,116480,1322
2021-09-22,Alpine,003,1148,99,100,0,100,0
2021-09-22,Amador,005,37829,5050,4915,52,4967,59
2021-09-22,Butte,007,227075,18907,18337,3377,21714,235
2021-09-22,Calaveras,009,45235,3539,3448,39,3487,70
2021-09-22,Colusa,011,21464,2406,2384,549,2933,16
2021-09-22,Contra Costa,013,1133247,95189,94209,1965,96174,924
2021-09-22,Del Norte,015,27424,3516,3386,30,3416,35
2021-09-22,El Dorado,017,186661,14892,14605,1538,16143,127
2021-09-22,Fresno,019,978130,128478,126006,11651,137657,1908
2021-09-22,Glenn,021,27897,3230,3138,929,4067,25
2021-09-22,Humboldt,023,135768,8176,7998,410,8408,80
2021-09-22,Imperial,025,180216,31586,31243,3014,34257,755
2021-09-22,Inyo,027,18085,1706,1651,35,1686,39
2021-09-22,Kern,029,883053,118042,115757,18512,134269,1477
2021-09-22,Kings,031,150075,29301,28589,1675,30264,292
2021-09-22,Lake,033,64148,6189,6035,122,6157,93
2021-09-22,Lassen,035,31185,6375,6209,279,6488,25
2021-09-22,Los Angeles,037,10098052,1398157,1384719,52005,1436724,25930
2021-09-22,Madera,039,155013,20883,20382,1688,22070,262
2021-09-22,Marin,041,260295,16954,16782,399,17181,242
2021-09-22,Mariposa,043,17540,951,901,33,934,5
2021-09-22,Mendocino,045,87422,6853,6624,348,6972,70
2021-09-22,Merced,047,269075,38778,38305,1527,39832,541
2021-09-22,Modoc,049,8938,476,458,165,623,5
2021-09-22,Mono,051,14174,1529,1496,19,1515,3
2021-09-22,Monterey,053,433212,47518,46615,2603,49218,566
2021-09-22,Napa,055,140530,12374,12248,89,12337,95
2021-09-22,Nevada,057,99092,8410,8273,287,8560,84
2021-09-22,Orange,059,3164182,297606,294214,14129,308343,5366
2021-09-22,Placer,061,380077,34302,33661,3226,36887,367
2021-09-22,Plumas,063,18699,1285,1230,24,1254,6
2021-09-22,Riverside,065,2383286,348472,342946,15958,358904,4830
2021-09-22,Sacramento,067,1510023,148772,147533,3838,151371,2043
2021-09-22,San Benito,069,59416,6996,6961,145,7106,67
2021-09-22,San Bernardino,071,2135413,341070,337938,10620,348558,5528
2021-09-22,San Diego,073,3302833,355085,351132,20893,372025,4027
2021-09-22,San Francisco,075,870044,50454,49734,2166,51900,610
2021-09-22,San Joaquin,077,732212,94421,93010,5043,98053,1626
2021-09-22,San Luis Obispo,079,281455,27982,27398,1113,28511,315
2021-09-22,San Mateo,081,765935,52114,51197,790,51987,568
2021-09-22,Santa Barbara,083,443738,42215,41678,1484,43162,504
2021-09-22,Santa Clara,085,1922200,141294,139803,1117,140920,1844
2021-09-22,Santa Cruz,087,273765,19456,19177,975,20152,214
2021-09-22,Shasta,089,179085,18738,18153,3092,21245,260
2021-09-22,Sierra,091,2930,133,127,13,140,0
2021-09-22,Siskiyou,093,43540,3085,2947,1091,4038,41
2021-09-22,Solano,095,438530,44104,43269,1149,44418,312
2021-09-22,Sonoma,097,501317,39394,39063,490,39553,369
2021-09-22,Stanislaus,099,539301,72805,72355,8230,80585,1091
2021-09-22,Sutter,101,95872,13057,12960,260,13220,153
2021-09-22,Tehama,103,63373,7399,7173,1216,8389,86
2021-09-22,Trinity,105,12862,745,572,201,773,9
2021-09-22,Tulare,107,460477,62449,60776,12872,73648,896
2021-09-22,Tuolumne,109,53932,6272,6155,72,6227,89
2021-09-22,Ventura,111,848112,94878,93978,4147,98125,1122
2021-09-22,Yolo,113,214977,18640,18342,956,19298,239
2021-09-22,Yuba,115,75493,9299,9169,210,9379,61
2021-09-21,Alameda,001,1643700,114673,113765,2618,116383,1321
2021-09-21,Alpine,003,1148,99,100,0,100,0
2021-09-21,Amador,005,37829,5028,4897,52,4949,59
2021-09-21,Butte,007,227075,18810,18229,3339,21568,232
2021-09-21,Calaveras,009,45235,3522,3437,39,3476,70
2021-09-21,Colusa,011,21464,2403,2378,548,2926,16
2021-09-21,Contra Costa,013,1133247,94995,94101,1951,96052,924
2021-09-21,Del Norte,015,27424,3504,3378,30,3408,34
2021-09-21,El Dorado,017,186661,14862,14578,1531,16109,127
2021-09-21,Fresno,019,978130,128127,125789,11624,137413,1892
2021-09-21,Glenn,021,27897,3223,3134,925,4059,25
2021-09-21,Humboldt,023,135768,8144,7955,405,8360,80
2021-09-21,Imperial,025,180216,31529,31185,3012,34197,755
2021-09-21,Inyo,027,18085,1696,1646,35,1681,39
2021-09-21,Kern,029,883053,117750,115534,18398,133932,1467
2021-09-21,Kings,031,150075,29213,28545,1667,30212,291
2021-09-21,Lake,033,64148,6166,6013,122,6135,90
2021-09-21,Lassen,035,31185,6357,6159,275,6434,25
2021-09-21,Los Angeles,037,10098052,1396702,1383277,51948,1435225,25893
2021-09-21,Madera,039,155013,20823,20317,1678,21995,262
2021-09-21,Marin,041,260295,16939,16748,398,17146,242
2021-09-21,Mariposa,043,17540,946,894,32,926,5
2021-09-21,Mendocino,045,87422,6815,6580,337,6917,68
2021-09-21,Merced,047,269075,38656,38225,1523,39748,539
2021-09-21,Modoc,049,8938,473,458,165,623,5
2021-09-21,Mono,051,14174,1527,1495,18,1513,3
2021-09-21,Monterey,053,433212,47449,46583,2591,49174,565
2021-09-21,Napa,055,140530,12353,12238,89,12327,95
2021-09-21,Nevada,057,99092,8383,8259,278,8537,84
2021-09-21,Orange,059,3164182,297275,293898,14099,307997,5357
2021-09-21,Placer,061,380077,34201,33609,3215,36824,365
2021-09-21,Plumas,063,18699,1278,1225,24,1249,5
2021-09-21,Riverside,065,2383286,347912,342460,15934,358394,4817
2021-09-21,Sacramento,067,1510023,148390,147378,3810,151188,2027
2021-09-21,San Benito,069,59416,6985,6950,144,7094,67
2021-09-21,San Bernardino,071,2135413,340632,337387,10603,347990,5520
2021-09-21,San Diego,073,3302833,354479,350265,20867,371132,4021
2021-09-21,San Francisco,075,870044,50358,49653,2162,51815,609
2021-09-21,San Joaquin,077,732212,94187,92762,5032,97794,1621
2021-09-21,San Luis Obispo,079,281455,27923,27318,1109,28427,314
2021-09-21,San Mateo,081,765935,52045,51136,790,51926,568
2021-09-21,Santa Barbara,083,443738,42146,41644,1480,43124,503
2021-09-21,Santa Clara,085,1922200,141077,139657,1113,140770,1843
2021-09-21,Santa Cruz,087,273765,19426,19140,974,20114,212
2021-09-21,Shasta,089,179085,18610,18027,3068,21095,258
2021-09-21,Sierra,091,2930,133,127,13,140,0
2021-09-21,Siskiyou,093,43540,3071,2927,1077,4004,36
2021-09-21,Solano,095,438530,44028,43220,1149,44369,311
2021-09-21,Sonoma,097,501317,39341,39042,490,39532,369
2021-09-21,Stanislaus,099,539301,72621,72211,8208,80419,1091
2021-09-21,Sutter,101,95872,13034,12930,257,13187,153
2021-09-21,Tehama,103,63373,7353,7151,1212,8363,85
2021-09-21,Trinity,105,12862,734,572,199,771,9
2021-09-21,Tulare,107,460477,62235,60607,12811,73418,896
2021-09-21,Tuolumne,109,53932,6240,6139,72,6211,89
2021-09-21,Ventura,111,848112,94773,93818,4139,97957,1120
2021-09-21,Yolo,113,214977,18604,18313,953,19266,239
2021-09-21,Yuba,115,75493,9271,9135,210,9345,61
2021-09-20,Alameda,001,1643700,114491,113637,2614,116251,1320
2021-09-20,Alpine,003,1148,99,100,0,100,0
2021-09-20,Amador,005,37829,5010,4883,51,4934,59
2021-09-20,Butte,007,227075,18728,18135,3323,21458,231
2021-09-20,Calaveras,009,45235,3500,3395,38,3433,66
2021-09-20,Colusa,011,21464,2401,2376,545,2921,16
2021-09-20,Contra Costa,013,1133247,94845,93919,1945,95864,924
2021-09-20,Del Norte,015,27424,3496,3374,29,3403,34
2021-09-20,El Dorado,017,186661,14829,14545,1519,16064,127
2021-09-20,Fresno,019,978130,127714,125287,11596,136883,1889
2021-09-20,Glenn,021,27897,3212,3112,922,4034,25
2021-09-20,Humboldt,023,135768,8108,7938,400,8338,80
2021-09-20,Imperial,025,180216,31446,31146,3011,34157,755
2021-09-20,Inyo,027,18085,1688,1641,34,1675,39
2021-09-20,Kern,029,883053,117411,115271,18266,133537,1459
2021-09-20,Kings,031,150075,29126,28471,1661,30132,285
2021-09-20,Lake,033,64148,6151,5984,121,6105,87
2021-09-20,Lassen,035,31185,6327,6132,275,6407,25
2021-09-20,Los Angeles,037,10098052,1395181,1382206,51868,1434074,25858
2021-09-20,Madera,039,155013,20770,20203,1671,21874,257
2021-09-20,Marin,041,260295,16914,16732,396,17128,242
2021-09-20,Mariposa,043,17540,935,887,32,919,5
2021-09-20,Mendocino,045,87422,6781,6568,331,6899,67
2021-09-20,Merced,047,269075,38545,38144,1512,39656,536
2021-09-20,Modoc,049,8938,472,457,163,620,5
2021-09-20,Mono,051,14174,1521,1480,18,1498,3
2021-09-20,Monterey,053,433212,47407,46506,2573,49079,565
2021-09-20,Napa,055,140530,12328,12209,88,12297,95
2021-09-20,Nevada,057,99092,8363,8228,276,8504,84
2021-09-20,Orange,059,3164182,296932,293642,14072,307714,5354
2021-09-20,Placer,061,380077,34111,33531,3200,36731,364
2021-09-20,Plumas,063,18699,1273,1211,24,1235,5
2021-09-20,Riverside,065,2383286,347412,341961,15921,357882,4802
2021-09-20,Sacramento,067,1510023,148017,147016,3776,150792,2016
2021-09-20,San Benito,069,59416,6976,6947,143,7090,67
2021-09-20,San Bernardino,071,2135413,340235,337059,10587,347646,5507
2021-09-20,San Diego,073,3302833,353807,349579,20830,370409,4009
2021-09-20,San Francisco,075,870044,50251,49559,2161,51720,605
2021-09-20,San Joaquin,077,732212,93943,92614,5019,97633,1615
2021-09-20,San Luis Obispo,079,281455,27847,27259,1101,28360,313
2021-09-20,San Mateo,081,765935,51958,51100,787,51887,567
2021-09-20,Santa Barbara,083,443738,42047,41589,1476,43065,500
2021-09-20,Santa Clara,085,1922200,140877,139578,1111,140689,1841
2021-09-20,Santa Cruz,087,273765,19394,19121,974,20095,211
2021-09-20,Shasta,089,179085,18511,17893,3037,20930,258
2021-09-20,Sierra,091,2930,131,126,13,139,0
2021-09-20,Siskiyou,093,43540,3049,2902,1064,3966,35
2021-09-20,Solano,095,438530,43960,43152,1141,44293,312
2021-09-20,Sonoma,097,501317,39295,38991,490,39481,369
2021-09-20,Stanislaus,099,539301,72422,72031,8189,80220,1091
2021-09-20,Sutter,101,95872,12998,12896,252,13148,153
2021-09-20,Tehama,103,63373,7321,7121,1200,8321,84
2021-09-20,Trinity,105,12862,728,568,198,766,7
2021-09-20,Tulare,107,460477,62033,60302,12756,73058,896
2021-09-20,Tuolumne,109,53932,6214,6113,72,6185,89
2021-09-20,Ventura,111,848112,94660,93700,4132,97832,1120
2021-09-20,Yolo,113,214977,18558,18287,951,19238,239
2021-09-20,Yuba,115,75493,9236,9107,208,9315,61
2021-09-19,Alameda,001,1643700,114276,113446,2609,116055,1320
2021-09-19,Alpine,003,1148,99,100,0,100,0
2021-09-19,Amador,005,37829,4970,4875,50,4925,59
2021-09-19,Butte,007,227075,18635,18063,3296,21359,230
2021-09-19,Calaveras,009,45235,3476,3390,35,3425,66
2021-09-19,Colusa,011,21464,2399,2375,543,2918,16
2021-09-19,Contra Costa,013,1133247,94660,93788,1935,95723,924
2021-09-19,Del Norte,015,27424,3470,3344,28,3372,34
2021-09-19,El Dorado,017,186661,14776,14512,1513,16025,127
2021-09-19,Fresno,019,978130,127308,124985,11551,136536,1888
2021-09-19,Glenn,021,27897,3203,3102,919,4021,25
2021-09-19,Humboldt,023,135768,8063,7914,398,8312,80
2021-09-19,Imperial,025,180216,31377,31122,3008,34130,755
2021-09-19,Inyo,027,18085,1679,1639,34,1673,39
2021-09-19,Kern,029,883053,117099,115074,18160,133234,1459
2021-09-19,Kings,031,150075,28998,28416,1652,30068,284
2021-09-19,Lake,033,64148,6120,5962,121,6083,87
2021-09-19,Lassen,035,31185,6307,6129,269,6398,25
2021-09-19,Los Angeles,037,10098052,1393205,1381200,51771,1432971,25852
2021-09-19,Madera,039,155013,20691,20161,1660,21821,257
2021-09-19,Marin,041,260295,16885,16711,394,17105,242
2021-09-19,Mariposa,043,17540,927,881,32,913,5
2021-09-19,Mendocino,045,87422,6736,6538,325,6863,67
2021-09-19,Merced,047,269075,38388,38068,1503,39571,535
2021-09-19,Modoc,049,8938,469,457,161,618,5
2021-09-19,Mono,051,14174,1516,1480,18,1498,3
2021-09-19,Monterey,053,433212,47352,46486,2570,49056,565
2021-09-19,Napa,055,140530,12307,12190,86,12276,95
2021-09-19,Nevada,057,99092,8335,8203,274,8477,84
2021-09-19,Orange,059,3164182,296564,293258,14050,307308,5354
2021-09-19,Placer,061,380077,33998,33406,3182,36588,364
2021-09-19,Plumas,063,18699,1265,1211,24,1235,5
2021-09-19,Riverside,065,2383286,346819,341566,15912,357478,4804
2021-09-19,Sacramento,067,1510023,147657,146603,3730,150333,2012
2021-09-19,San Benito,069,59416,6957,6942,143,7085,67
2021-09-19,San Bernardino,071,2135413,339745,336688,10576,347264,5506
2021-09-19,San Diego,073,3302833,353104,349225,20793,370018,4006
2021-09-19,San Francisco,075,870044,50143,49458,2152,51610,605
2021-09-19,San Joaquin,077,732212,93646,92467,5008,97475,1615
2021-09-19,San Luis Obispo,079,281455,27746,27208,1092,28300,313
2021-09-19,San Mateo,081,765935,51860,51028,786,51814,567
2021-09-19,Santa Barbara,083,443738,41941,41512,1476,42988,500
2021-09-19,Santa Clara,085,1922200,140690,139410,1106,140516,1841
2021-09-19,Santa Cruz,087,273765,19355,19096,974,20070,211
2021-09-19,Shasta,089,179085,18397,17813,3002,20815,258
2021-09-19,Sierra,091,2930,130,126,13,139,0
2021-09-19,Siskiyou,093,43540,3023,2882,1055,3937,35
2021-09-19,Solano,095,438530,43871,43056,1136,44192,312
2021-09-19,Sonoma,097,501317,39223,38956,486,39442,369
2021-09-19,Stanislaus,099,539301,72178,71830,8164,79994,1091
2021-09-19,Sutter,101,95872,12971,12868,245,13113,153
2021-09-19,Tehama,103,63373,7267,7081,1191,8272,84
2021-09-19,Trinity,105,12862,717,562,196,758,7
2021-09-19,Tulare,107,460477,61772,60160,12661,72821,896
2021-09-19,Tuolumne,109,53932,6172,6097,72,6169,89
2021-09-19,Ventura,111,848112,94498,93491,4123,97614,1120
2021-09-19,Yolo,113,214977,18509,18238,945,19183,239
2021-09-19,Yuba,115,75493,9210,9087,207,9294,61
2021-09-18,Alameda,001,1643700,114175,113300,2608,115908,1320
2021-09-18,Alpine,003,1148,99,100,0,100,0
2021-09-18,Amador,005,37829,4960,4850,50,4900,59
2021-09-18,Butte,007,227075,18598,17961,3282,21243,230
2021-09-18,Calaveras,009,45235,3471,3361,34,3395,66
2021-09-18,Colusa,011,21464,2399,2373,542,2915,16
2021-09-18,Contra Costa,013,1133247,94570,93656,1931,95587,924
2021-09-18,Del Norte,015,27424,3462,3326,26,3352,34
2021-09-18,El Dorado,017,186661,14753,14472,1510,15982,127
2021-09-18,Fresno,019,978130,127166,124771,11533,136304,1889
2021-09-18,Glenn,021,27897,3194,3086,916,4002,25
2021-09-18,Humboldt,023,135768,8049,7881,397,8278,80
2021-09-18,Imperial,025,180216,31353,31096,3007,34103,755
2021-09-18,Inyo,027,18085,1673,1636,34,1670,39
2021-09-18,Kern,029,883053,116944,114781,18096,132877,1459
2021-09-18,Kings,031,150075,28950,28330,1647,29977,285
2021-09-18,Lake,033,64148,6103,5936,121,6057,87
2021-09-18,Lassen,035,31185,6297,6121,267,6388,25
2021-09-18,Los Angeles,037,10098052,1392446,1379880,51720,1431600,25849
2021-09-18,Madera,039,155013,20647,20126,1650,21776,257
2021-09-18,Marin,041,260295,16868,16685,393,17078,242
2021-09-18,Mariposa,043,17540,924,871,32,903,5
2021-09-18,Mendocino,045,87422,6715,6523,325,6848,67
2021-09-18,Merced,047,269075,38351,37977,1497,39474,535
2021-09-18,Modoc,049,8938,469,457,160,617,5
2021-09-18,Mono,051,14174,1513,1480,18,1498,3
2021-09-18,Monterey,053,433212,47314,46466,2567,49033,565
2021-09-18,Napa,055,140530,12295,12168,86,12254,95
2021-09-18,Nevada,057,99092,8318,8183,274,8457,84
2021-09-18,Orange,059,3164182,296370,293005,14036,307041,5354
2021-09-18,Placer,061,380077,33926,33309,3179,36488,364
2021-09-18,Plumas,063,18699,1264,1204,24,1228,5
2021-09-18,Riverside,065,2383286,346435,341136,15897,357033,4802
2021-09-18,Sacramento,067,1510023,147475,146162,3721,149883,2016
2021-09-18,San Benito,069,59416,6953,6937,143,7080,67
2021-09-18,San Bernardino,071,2135413,339472,336380,10563,346943,5501
2021-09-18,San Diego,073,3302833,352713,348848,20780,369628,4006
2021-09-18,San Francisco,075,870044,50080,49359,2147,51506,605
2021-09-18,San Joaquin,077,732212,93536,92242,4996,97238,1615
2021-09-18,San Luis Obispo,079,281455,27709,27181,1089,28270,313
2021-09-18,San Mateo,081,765935,51809,50961,784,51745,567
2021-09-18,Santa Barbara,083,443738,41876,41465,1476,42941,500
2021-09-18,Santa Clara,085,1922200,140570,139233,1103,140336,1841
2021-09-18,Santa Cruz,087,273765,19335,19079,974,20053,211
2021-09-18,Shasta,089,179085,18334,17777,2986,20763,258
2021-09-18,Sierra,091,2930,129,125,13,138,0
2021-09-18,Siskiyou,093,43540,3020,2875,1049,3924,35
2021-09-18,Solano,095,438530,43831,42966,1133,44099,312
2021-09-18,Sonoma,097,501317,39188,38891,484,39375,369
2021-09-18,Stanislaus,099,539301,72033,71587,8139,79726,1091
2021-09-18,Sutter,101,95872,12957,12829,245,13074,153
2021-09-18,Tehama,103,63373,7253,7055,1184,8239,84
2021-09-18,Trinity,105,12862,715,561,196,757,7
2021-09-18,Tulare,107,460477,61696,60003,12609,72612,896
2021-09-18,Tuolumne,109,53932,6157,6069,72,6141,89
2021-09-18,Ventura,111,848112,94430,93424,4118,97542,1120
2021-09-18,Yolo,113,214977,18482,18213,940,19153,239
2021-09-18,Yuba,115,75493,9196,9061,206,9267,61
2021-09-17,Alameda,001,1643700,114049,113070,2606,115676,1320
2021-09-17,Alpine,003,1148,99,99,0,99,0
2021-09-17,Amador,005,37829,4944,4835,49,4884,58
2021-09-17,Butte,007,227075,18546,17870,3273,21143,230
2021-09-17,Calaveras,009,45235,3459,3338,33,3371,66
2021-09-17,Colusa,011,21464,2398,2369,537,2906,16
2021-09-17,Contra Costa,013,1133247,94468,93485,1928,95413,924
2021-09-17,Del Norte,015,27424,3457,3311,24,3335,34
2021-09-17,El Dorado,017,186661,14734,14421,1508,15929,127
2021-09-17,Fresno,019,978130,126947,124296,11517,135813,1882
2021-09-17,Glenn,021,27897,3177,3072,912,3984,25
2021-09-17,Humboldt,023,135768,8028,7850,397,8247,80
2021-09-17,Imperial,025,180216,31327,31031,3006,34037,755
2021-09-17,Inyo,027,18085,1665,1634,34,1668,39
2021-09-17,Kern,029,883053,116753,114303,17999,132302,1456
2021-09-17,Kings,031,150075,28885,28240,1645,29885,281
2021-09-17,Lake,033,64148,6090,5915,121,6036,87
2021-09-17,Lassen,035,31185,6282,6080,265,6345,25
2021-09-17,Los Angeles,037,10098052,1391469,1377905,51653,1429558,25820
2021-09-17,Madera,039,155013,20596,20040,1638,21678,257
2021-09-17,Marin,041,260295,16855,16658,391,17049,242
2021-09-17,Mariposa,043,17540,922,869,32,901,5
2021-09-17,Mendocino,045,87422,6696,6498,325,6823,67
2021-09-17,Merced,047,269075,38304,37803,1495,39298,533
2021-09-17,Modoc,049,8938,469,456,160,616,5
2021-09-17,Mono,051,14174,1509,1457,18,1475,3
2021-09-17,Monterey,053,433212,47291,46421,2566,48987,564
2021-09-17,Napa,055,140530,12274,12153,86,12239,95
2021-09-17,Nevada,057,99092,8303,8157,274,8431,84
2021-09-17,Orange,059,3164182,296151,292685,14018,306703,5346
2021-09-17,Placer,061,380077,33866,33188,3169,36357,362
2021-09-17,Plumas,063,18699,1255,1192,23,1215,5
2021-09-17,Riverside,065,2383286,346035,340445,15886,356331,4792
2021-09-17,Sacramento,067,1510023,147276,145985,3710,149695,1999
2021-09-17,San Benito,069,59416,6950,6929,143,7072,67
2021-09-17,San Bernardino,071,2135413,339116,335810,10556,346366,5488
2021-09-17,San Diego,073,3302833,352289,348098,20763,368861,4002
2021-09-17,San Francisco,075,870044,50028,49249,2142,51391,605
2021-09-17,San Joaquin,077,732212,93398,91977,4985,96962,1610
2021-09-17,San Luis Obispo,079,281455,27675,27102,1078,28180,311
2021-09-17,San Mateo,081,765935,51756,50854,783,51637,564
2021-09-17,Santa Barbara,083,443738,41813,41354,1475,42829,498
2021-09-17,Santa Clara,085,1922200,140421,138939,1101,140040,1838
2021-09-17,Santa Cruz,087,273765,19311,19039,974,20013,211
2021-09-17,Shasta,089,179085,18264,17617,2973,20590,254
2021-09-17,Sierra,091,2930,129,124,13,137,0
2021-09-17,Siskiyou,093,43540,3005,2852,1049,3901,35
2021-09-17,Solano,095,438530,43768,42898,1129,44027,312
2021-09-17,Sonoma,097,501317,39151,38808,483,39291,369
2021-09-17,Stanislaus,099,539301,71926,71408,8121,79529,1091
2021-09-17,Sutter,101,95872,12941,12799,242,13041,153
2021-09-17,Tehama,103,63373,7230,7020,1172,8192,84
2021-09-17,Trinity,105,12862,710,556,195,751,7
2021-09-17,Tulare,107,460477,61581,59689,12574,72263,895
2021-09-17,Tuolumne,109,53932,6138,6047,72,6119,89
2021-09-17,Ventura,111,848112,94318,93273,4116,97389,1116
2021-09-17,Yolo,113,214977,18451,18177,936,19113,239
2021-09-17,Yuba,115,75493,9169,9019,205,9224,61
2021-09-16,Alameda,001,1643700,113871,112770,2603,115373,1318
2021-09-16,Alpine,003,1148,99,99,0,99,0
2021-09-16,Amador,005,37829,4924,4819,49,4868,58
2021-09-16,Butte,007,227075,18471,17750,3257,21007,230
2021-09-16,Calaveras,009,45235,3428,3313,33,3346,66
2021-09-16,Colusa,011,21464,2396,2363,535,2898,16
2021-09-16,Contra Costa,013,1133247,94296,93213,1920,95133,917
2021-09-16,Del Norte,015,27424,3439,3285,24,3309,34
2021-09-16,El Dorado,017,186661,14693,14372,1500,15872,127
2021-09-16,Fresno,019,978130,126590,123853,11474,135327,1868
2021-09-16,Glenn,021,27897,3167,3068,910,3978,24
2021-09-16,Humboldt,023,135768,7994,7809,389,8198,80
2021-09-16,Imperial,025,180216,31284,30966,2998,33964,753
2021-09-16,Inyo,027,18085,1663,1623,34,1657,39
2021-09-16,Kern,029,883053,116482,113828,17931,131759,1448
2021-09-16,Kings,031,150075,28799,28114,1636,29750,280
2021-09-16,Lake,033,64148,6066,5890,118,6008,87
2021-09-16,Lassen,035,31185,6247,6028,260,6288,25
2021-09-16,Los Angeles,037,10098052,1390079,1376277,51588,1427865,25796
2021-09-16,Madera,039,155013,20518,19974,1632,21606,257
2021-09-16,Marin,041,260295,16828,16625,390,17015,242
2021-09-16,Mariposa,043,17540,916,849,32,881,6
2021-09-16,Mendocino,045,87422,6658,6445,314,6759,67
2021-09-16,Merced,047,269075,38197,37675,1492,39167,532
2021-09-16,Modoc,049,8938,467,455,160,615,5
2021-09-16,Mono,051,14174,1503,1449,18,1467,3
2021-09-16,Monterey,053,433212,47237,46342,2560,48902,562
2021-09-16,Napa,055,140530,12249,12115,82,12197,95
2021-09-16,Nevada,057,99092,8276,8121,273,8394,84
2021-09-16,Orange,059,3164182,295805,292183,13998,306181,5340
2021-09-16,Placer,061,380077,33770,33037,3149,36186,354
2021-09-16,Plumas,063,18699,1246,1178,23,1201,5
2021-09-16,Riverside,065,2383286,345504,339770,15872,355642,4786
2021-09-16,Sacramento,067,1510023,146920,145754,3678,149432,1996
2021-09-16,San Benito,069,59416,6938,6913,142,7055,67
2021-09-16,San Bernardino,071,2135413,338688,335129,10549,345678,5474
2021-09-16,San Diego,073,3302833,351675,347472,20724,368196,3994
2021-09-16,San Francisco,075,870044,49942,49133,2133,51266,605
2021-09-16,San Joaquin,077,732212,93160,91650,4941,96591,1608
2021-09-16,San Luis Obispo,079,281455,27602,27044,1074,28118,310
2021-09-16,San Mateo,081,765935,51679,50773,781,51554,564
2021-09-16,Santa Barbara,083,443738,41747,41272,1472,42744,497
2021-09-16,Santa Clara,085,1922200,140267,138685,1097,139782,1835
2021-09-16,Santa Cruz,087,273765,19284,19011,974,19985,211
2021-09-16,Shasta,089,179085,18139,17438,2939,20377,251
2021-09-16,Sierra,091,2930,129,123,13,136,0
2021-09-16,Siskiyou,093,43540,2985,2819,1042,3861,35
2021-09-16,Solano,095,438530,43696,42792,1120,43912,312
2021-09-16,Sonoma,097,501317,39088,38707,482,39189,369
2021-09-16,Stanislaus,099,539301,71693,71105,8104,79209,1091
2021-09-16,Sutter,101,95872,12897,12729,236,12965,152
2021-09-16,Tehama,103,63373,7190,6953,1161,8114,83
2021-09-16,Trinity,105,12862,707,547,194,741,7
2021-09-16,Tulare,107,460477,61359,59459,12499,71958,894
2021-09-16,Tuolumne,109,53932,6118,5999,71,6070,89
2021-09-16,Ventura,111,848112,94178,93087,4112,97199,1110
2021-09-16,Yolo,113,214977,18419,18135,934,19069,239
2021-09-16,Yuba,115,75493,9135,8981,202,9183,61
2021-09-15,Alameda,001,1643700,113705,112498,2596,115094,1317
2021-09-15,Alpine,003,1148,99,99,0,99,0
2021-09-15,Amador,005,37829,4916,4792,49,4841,58
2021-09-15,Butte,007,227075,18372,17664,3238,20902,228
2021-09-15,Calaveras,009,45235,3399,3293,31,3324,66
2021-09-15,Colusa,011,21464,2394,2352,532,2884,16
2021-09-15,Contra Costa,013,1133247,94116,92989,1908,94897,913
2021-09-15,Del Norte,015,27424,3426,3271,22,3293,34
2021-09-15,El Dorado,017,186661,14667,14309,1492,15801,127
2021-09-15,Fresno,019,978130,126211,123370,11416,134786,1867
2021-09-15,Glenn,021,27897,3155,3051,905,3956,20
2021-09-15,Humboldt,023,135768,7959,7754,384,8138,52
2021-09-15,Imperial,025,180216,31229,30891,2993,33884,753
2021-09-15,Inyo,027,18085,1659,1614,34,1648,39
2021-09-15,Kern,029,883053,116135,113546,17832,131378,1434
2021-09-15,Kings,031,150075,28720,27991,1627,29618,279
2021-09-15,Lake,033,64148,6034,5852,117,5969,85
2021-09-15,Lassen,035,31185,6187,6018,255,6273,25
2021-09-15,Los Angeles,037,10098052,1388578,1374307,51519,1425826,25767
2021-09-15,Madera,039,155013,20443,19880,1624,21504,257
2021-09-15,Marin,041,260295,16793,16592,385,16977,242
2021-09-15,Mariposa,043,17540,904,843,32,875,5
2021-09-15,Mendocino,045,87422,6628,6399,309,6708,66
2021-09-15,Merced,047,269075,38089,37508,1490,38998,529
2021-09-15,Modoc,049,8938,467,454,160,614,5
2021-09-15,Mono,051,14174,1497,1445,18,1463,3
2021-09-15,Monterey,053,433212,47167,46317,2548,48865,562
2021-09-15,Napa,055,140530,12228,12082,82,12164,95
2021-09-15,Nevada,057,99092,8254,8081,270,8351,84
2021-09-15,Orange,059,3164182,295481,291834,13979,305813,5328
2021-09-15,Placer,061,380077,33658,32860,3128,35988,352
2021-09-15,Plumas,063,18699,1241,1164,22,1186,5
2021-09-15,Riverside,065,2383286,344921,339077,15848,354925,4769
2021-09-15,Sacramento,067,1510023,146493,145202,3647,148849,1981
2021-09-15,San Benito,069,59416,6935,6902,142,7044,67
2021-09-15,San Bernardino,071,2135413,338223,334556,10535,345091,5470
2021-09-15,San Diego,073,3302833,351056,346933,20696,367629,3983
2021-09-15,San Francisco,075,870044,49831,48999,2128,51127,605
2021-09-15,San Joaquin,077,732212,92884,91322,4900,96222,1607
2021-09-15,San Luis Obispo,079,281455,27519,26943,1068,28011,306
2021-09-15,San Mateo,081,765935,51597,50691,778,51469,564
2021-09-15,Santa Barbara,083,443738,41644,41077,1467,42544,497
2021-09-15,Santa Clara,085,1922200,140093,138410,1092,139502,1833
2021-09-15,Santa Cruz,087,273765,19246,18984,972,19956,210
2021-09-15,Shasta,089,179085,18028,17317,2918,20235,250
2021-09-15,Sierra,091,2930,129,123,13,136,0
2021-09-15,Siskiyou,093,43540,2965,2804,1012,3816,35
2021-09-15,Solano,095,438530,43624,42682,1115,43797,312
2021-09-15,Sonoma,097,501317,39030,38629,481,39110,369
2021-09-15,Stanislaus,099,539301,71469,70852,8082,78934,1091
2021-09-15,Sutter,101,95872,12864,12699,231,12930,151
2021-09-15,Tehama,103,63373,7149,6894,1152,8046,79
2021-09-15,Trinity,105,12862,705,541,192,733,7
2021-09-15,Tulare,107,460477,61100,59149,12438,71587,890
2021-09-15,Tuolumne,109,53932,6092,5969,71,6040,89
2021-09-15,Ventura,111,848112,94035,92960,4105,97065,1109
2021-09-15,Yolo,113,214977,18385,18064,927,18991,239
2021-09-15,Yuba,115,75493,9101,8953,202,9155,61
2021-09-14,Alameda,001,1643700,113499,112329,2591,114920,1316
2021-09-14,Alpine,003,1148,99,98,0,98,0
2021-09-14,Amador,005,37829,4896,4790,49,4839,57
2021-09-14,Butte,007,227075,18237,17516,3215,20731,226
2021-09-14,Calaveras,009,45235,3379,3280,28,3308,66
2021-09-14,Colusa,011,21464,2390,2344,528,2872,16
2021-09-14,Contra Costa,013,1133247,93918,92822,1900,94722,908
2021-09-14,Del Norte,015,27424,3410,3252,21,3273,32
2021-09-14,El Dorado,017,186661,14614,14247,1484,15731,123
2021-09-14,Fresno,019,978130,125736,123151,11363,134514,1856
2021-09-14,Glenn,021,27897,3138,3045,901,3946,20
2021-09-14,Humboldt,023,135768,7925,7717,379,8096,52
2021-09-14,Imperial,025,180216,31180,30845,2990,33835,752
2021-09-14,Inyo,027,18085,1650,1605,33,1638,39
2021-09-14,Kern,029,883053,115752,113250,17706,130956,1428
2021-09-14,Kings,031,150075,28644,27955,1619,29574,278
2021-09-14,Lake,033,64148,6002,5845,117,5962,83
2021-09-14,Lassen,035,31185,6173,5977,250,6227,25
2021-09-14,Los Angeles,037,10098052,1386740,1372831,51437,1424268,25729
2021-09-14,Madera,039,155013,20361,19800,1613,21413,254
2021-09-14,Marin,041,260295,16765,16584,383,16967,242
2021-09-14,Mariposa,043,17540,893,834,31,865,5
2021-09-14,Mendocino,045,87422,6592,6372,297,6669,65
2021-09-14,Merced,047,269075,37939,37430,1486,38916,526
2021-09-14,Modoc,049,8938,466,453,160,613,5
2021-09-14,Mono,051,14174,1493,1440,18,1458,4
2021-09-14,Monterey,053,433212,47126,46224,2536,48760,558
2021-09-14,Napa,055,140530,12195,12070,81,12151,91
2021-09-14,Nevada,057,99092,8220,8056,270,8326,83
2021-09-14,Orange,059,3164182,295088,291423,13955,305378,5319
2021-09-14,Placer,061,380077,33526,32735,3108,35843,350
2021-09-14,Plumas,063,18699,1226,1148,22,1170,5
2021-09-14,Riverside,065,2383286,344280,338534,15817,354351,4748
2021-09-14,Sacramento,067,1510023,146108,145051,3599,148650,1977
2021-09-14,San Benito,069,59416,6925,6887,142,7029,64
2021-09-14,San Bernardino,071,2135413,337727,333968,10510,344478,5465
2021-09-14,San Diego,073,3302833,350396,346204,20645,366849,3966
2021-09-14,San Francisco,075,870044,49697,48998,2126,51124,603
2021-09-14,San Joaquin,077,732212,92645,91128,4890,96018,1596
2021-09-14,San Luis Obispo,079,281455,27446,26845,1063,27908,304
2021-09-14,San Mateo,081,765935,51499,50602,775,51377,564
2021-09-14,Santa Barbara,083,443738,41548,40783,1458,42241,495
2021-09-14,Santa Clara,085,1922200,139858,138321,1089,139410,1828
2021-09-14,Santa Cruz,087,273765,19206,18965,970,19935,210
2021-09-14,Shasta,089,179085,17897,17152,2897,20049,246
2021-09-14,Sierra,091,2930,129,123,13,136,0
2021-09-14,Siskiyou,093,43540,2941,2756,995,3751,35
2021-09-14,Solano,095,438530,43541,42599,1112,43711,307
2021-09-14,Sonoma,097,501317,38961,38595,477,39072,369
2021-09-14,Stanislaus,099,539301,71210,70697,8054,78751,1091
2021-09-14,Sutter,101,95872,12822,12670,224,12894,149
2021-09-14,Tehama,103,63373,7095,6859,1144,8003,80
2021-09-14,Trinity,105,12862,699,538,191,729,7
2021-09-14,Tulare,107,460477,60847,58961,12366,71327,888
2021-09-14,Tuolumne,109,53932,6071,5951,69,6020,89
2021-09-14,Ventura,111,848112,93850,92841,4088,96929,1107
2021-09-14,Yolo,113,214977,18341,18039,922,18961,239
2021-09-14,Yuba,115,75493,9065,8928,202,9130,61
2021-09-13,Alameda,001,1643700,113285,112159,2586,114745,1309
2021-09-13,Alpine,003,1148,98,98,0,98,0
2021-09-13,Amador,005,37829,4878,4761,49,4810,56
2021-09-13,Butte,007,227075,18112,17393,3188,20581,225
2021-09-13,Calaveras,009,45235,3353,3253,27,3280,65
2021-09-13,Colusa,011,21464,2381,2346,524,2870,16
2021-09-13,Contra Costa,013,1133247,93672,92658,1895,94553,908
2021-09-13,Del Norte,015,27424,3374,3232,21,3253,28
2021-09-13,El Dorado,017,186661,14553,14194,1475,15669,119
2021-09-13,Fresno,019,978130,125269,122650,11297,133947,1853
2021-09-13,Glenn,021,27897,3124,3026,895,3921,20
2021-09-13,Humboldt,023,135768,7893,7659,376,8035,52
2021-09-13,Imperial,025,180216,31127,30802,2987,33789,751
2021-09-13,Inyo,027,18085,1643,1602,33,1635,39
2021-09-13,Kern,029,883053,115369,112930,17584,130514,1424
2021-09-13,Kings,031,150075,28534,27858,1607,29465,275
2021-09-13,Lake,033,64148,5980,5809,117,5926,82
2021-09-13,Lassen,035,31185,6138,5953,249,6202,25
2021-09-13,Los Angeles,037,10098052,1384876,1371423,51369,1422792,25703
2021-09-13,Madera,039,155013,20291,19735,1598,21333,252
2021-09-13,Marin,041,260295,16729,16557,382,16939,242
2021-09-13,Mariposa,043,17540,879,825,31,856,5
2021-09-13,Mendocino,045,87422,6557,6323,288,6611,61
2021-09-13,Merced,047,269075,37788,37291,1481,38772,521
2021-09-13,Modoc,049,8938,465,451,160,611,5
2021-09-13,Mono,051,14174,1487,1435,18,1453,3
2021-09-13,Monterey,053,433212,47035,46188,2523,48711,558
2021-09-13,Napa,055,140530,12177,12039,81,12120,91
2021-09-13,Nevada,057,99092,8194,8021,268,8289,83
2021-09-13,Orange,059,3164182,294656,291128,13934,305062,5312
2021-09-13,Placer,061,380077,33361,32617,3091,35708,343
2021-09-13,Plumas,063,18699,1217,1142,22,1164,5
2021-09-13,Riverside,065,2383286,343635,337876,15799,353675,4731
2021-09-13,Sacramento,067,1510023,145621,144537,3565,148102,1956
2021-09-13,San Benito,069,59416,6910,6867,141,7008,64
2021-09-13,San Bernardino,071,2135413,337236,333613,10485,344098,5441
2021-09-13,San Diego,073,3302833,349609,345647,20593,366240,3961
2021-09-13,San Francisco,075,870044,49568,48914,2120,51034,603
2021-09-13,San Joaquin,077,732212,92360,90966,4872,95838,1581
2021-09-13,San Luis Obispo,079,281455,27349,26805,1060,27865,300
2021-09-13,San Mateo,081,765935,51409,50525,770,51295,564
2021-09-13,Santa Barbara,083,443738,41429,40661,1451,42112,494
2021-09-13,Santa Clara,085,1922200,139612,138152,1084,139236,1820
2021-09-13,Santa Cruz,087,273765,19166,18917,969,19886,210
2021-09-13,Shasta,089,179085,17767,17033,2856,19889,243
2021-09-13,Sierra,091,2930,129,123,13,136,0
2021-09-13,Siskiyou,093,43540,2926,2745,983,3728,35
2021-09-13,Solano,095,438530,43437,42501,1109,43610,306
2021-09-13,Sonoma,097,501317,38894,38513,474,38987,368
2021-09-13,Stanislaus,099,539301,70956,70477,8018,78495,1091
2021-09-13,Sutter,101,95872,12764,12624,220,12844,145
2021-09-13,Tehama,103,63373,7032,6803,1132,7935,79
2021-09-13,Trinity,105,12862,697,533,189,722,7
2021-09-13,Tulare,107,460477,60563,58768,12306,71074,887
2021-09-13,Tuolumne,109,53932,6040,5909,69,5978,89
2021-09-13,Ventura,111,848112,93688,92679,4080,96759,1107
2021-09-13,Yolo,113,214977,18296,17974,916,18890,239
2021-09-13,Yuba,115,75493,9020,8884,201,9085,61
2021-09-12,Alameda,001,1643700,113022,111961,2583,114544,1309
2021-09-12,Alpine,003,1148,98,98,0,98,0
2021-09-12,Amador,005,37829,4857,4752,49,4801,56
2021-09-12,Butte,007,227075,17967,17257,3143,20400,221
2021-09-12,Calaveras,009,45235,3322,3236,23,3259,65
2021-09-12,Colusa,011,21464,2378,2344,523,2867,16
2021-09-12,Contra Costa,013,1133247,93404,92498,1883,94381,908
2021-09-12,Del Norte,015,27424,3339,3200,21,3221,28
2021-09-12,El Dorado,017,186661,14480,14167,1459,15626,119
2021-09-12,Fresno,019,978130,124749,122407,11240,133647,1853
2021-09-12,Glenn,021,27897,3107,3016,890,3906,20
2021-09-12,Humboldt,023,135768,7823,7636,365,8001,52
2021-09-12,Imperial,025,180216,31064,30790,2982,33772,751
2021-09-12,Inyo,027,18085,1633,1596,31,1627,39
2021-09-12,Kern,029,883053,114957,112602,17425,130027,1424
2021-09-12,Kings,031,150075,28423,27764,1590,29354,274
2021-09-12,Lake,033,64148,5940,5781,115,5896,82
2021-09-12,Lassen,035,31185,6101,5943,239,6182,25
2021-09-12,Los Angeles,037,10098052,1382820,1365968,51294,1417262,25630
2021-09-12,Madera,039,155013,20204,19691,1585,21276,252
2021-09-12,Marin,041,260295,16706,16526,382,16908,242
2021-09-12,Mariposa,043,17540,868,811,29,840,5
2021-09-12,Mendocino,045,87422,6517,6283,279,6562,61
2021-09-12,Merced,047,269075,37616,37172,1470,38642,521
2021-09-12,Modoc,049,8938,465,451,159,610,5
2021-09-12,Mono,051,14174,1480,1431,18,1449,3
2021-09-12,Monterey,053,433212,46936,46167,2513,48680,558
2021-09-12,Napa,055,140530,12147,12011,81,12092,91
2021-09-12,Nevada,057,99092,8154,7987,267,8254,83
2021-09-12,Orange,059,3164182,294192,290718,13913,304631,5312
2021-09-12,Placer,061,380077,33212,32520,3067,35587,343
2021-09-12,Plumas,063,18699,1198,1138,22,1160,5
2021-09-12,Riverside,065,2383286,342952,337332,15765,353097,4731
2021-09-12,Sacramento,067,1510023,145115,144030,3525,147555,1959
2021-09-12,San Benito,069,59416,6891,6852,140,6992,64
2021-09-12,San Bernardino,071,2135413,336621,333049,10472,343521,5439
2021-09-12,San Diego,073,3302833,348799,345058,20517,365575,3942
2021-09-12,San Francisco,075,870044,49457,48819,2113,50932,603
2021-09-12,San Joaquin,077,732212,92031,90730,4864,95594,1581
2021-09-12,San Luis Obispo,079,281455,27230,26729,1047,27776,299
2021-09-12,San Mateo,081,765935,51301,50432,766,51198,564
2021-09-12,Santa Barbara,083,443738,41317,40600,1444,42044,494
2021-09-12,Santa Clara,085,1922200,139355,137899,1081,138980,1820
2021-09-12,Santa Cruz,087,273765,19133,18892,968,19860,210
2021-09-12,Shasta,089,179085,17602,16957,2798,19755,243
2021-09-12,Sierra,091,2930,129,123,13,136,0
2021-09-12,Siskiyou,093,43540,2898,2730,968,3698,35
2021-09-12,Solano,095,438530,43331,42409,1104,43513,306
2021-09-12,Sonoma,097,501317,38814,38456,472,38928,368
2021-09-12,Stanislaus,099,539301,70657,70184,7979,78163,1091
2021-09-12,Sutter,101,95872,12722,12589,214,12803,145
2021-09-12,Tehama,103,63373,6968,6732,1120,7852,79
2021-09-12,Trinity,105,12862,693,529,187,716,7
2021-09-12,Tulare,107,460477,60210,58582,12246,70828,887
2021-09-12,Tuolumne,109,53932,6007,5888,69,5957,89
2021-09-12,Ventura,111,848112,93561,92496,4074,96570,1107
2021-09-12,Yolo,113,214977,18230,17943,908,18851,239
2021-09-12,Yuba,115,75493,8985,8842,201,9043,61
2021-09-11,Alameda,001,1643700,112898,111715,2581,114296,1309
2021-09-11,Alpine,003,1148,98,98,0,98,0
2021-09-11,Amador,005,37829,4844,4728,48,4776,56
2021-09-11,Butte,007,227075,17885,17218,3116,20334,221
2021-09-11,Calaveras,009,45235,3314,3208,22,3230,65
2021-09-11,Colusa,011,21464,2377,2338,520,2858,16
2021-09-11,Contra Costa,013,1133247,93285,92269,1878,94147,908
2021-09-11,Del Norte,015,27424,3323,3184,21,3205,28
2021-09-11,El Dorado,017,186661,14461,14117,1453,15570,119
2021-09-11,Fresno,019,978130,124569,122224,11215,133439,1853
2021-09-11,Glenn,021,27897,3097,3007,887,3894,20
2021-09-11,Humboldt,023,135768,7801,7615,362,7977,52
2021-09-11,Imperial,025,180216,31039,30760,2978,33738,751
2021-09-11,Inyo,027,18085,1630,1590,31,1621,39
2021-09-11,Kern,029,883053,114707,112205,17309,129514,1424
2021-09-11,Kings,031,150075,28374,27631,1584,29215,275
2021-09-11,Lake,033,64148,5919,5761,115,5876,82
2021-09-11,Lassen,035,31185,6086,5930,235,6165,25
2021-09-11,Los Angeles,037,10098052,1381854,1365831,51229,1417060,25630
2021-09-11,Madera,039,155013,20151,19648,1580,21228,252
2021-09-11,Marin,041,260295,16678,16496,381,16877,242
2021-09-11,Mariposa,043,17540,863,799,29,828,5
2021-09-11,Mendocino,045,87422,6493,6257,279,6536,61
2021-09-11,Merced,047,269075,37562,37042,1467,38509,521
2021-09-11,Modoc,049,8938,465,449,159,608,5
2021-09-11,Mono,051,14174,1474,1431,18,1449,3
2021-09-11,Monterey,053,433212,46899,46140,2510,48650,558
2021-09-11,Napa,055,140530,12124,11991,81,12072,91
2021-09-11,Nevada,057,99092,8139,7967,267,8234,83
2021-09-11,Orange,059,3164182,293890,290429,13897,304326,5306
2021-09-11,Placer,061,380077,33129,32414,3056,35470,344
2021-09-11,Plumas,063,18699,1191,1112,22,1134,5
2021-09-11,Riverside,065,2383286,342514,336585,15751,352336,4731
2021-09-11,Sacramento,067,1510023,144814,143557,3513,147070,1955
2021-09-11,San Benito,069,59416,6878,6844,140,6984,64
2021-09-11,San Bernardino,071,2135413,336279,332512,10458,342970,5430
2021-09-11,San Diego,073,3302833,348315,344355,20493,364848,3942
2021-09-11,San Francisco,075,870044,49402,48660,2108,50768,603
2021-09-11,San Joaquin,077,732212,91887,90482,4857,95339,1581
2021-09-11,San Luis Obispo,079,281455,27184,26651,1046,27697,299
2021-09-11,San Mateo,081,765935,51229,50341,765,51106,564
2021-09-11,Santa Barbara,083,443738,41244,40451,1444,41895,494
2021-09-11,Santa Clara,085,1922200,139203,137659,1078,138737,1820
2021-09-11,Santa Cruz,087,273765,19104,18865,968,19833,210
2021-09-11,Shasta,089,179085,17508,16877,2778,19655,243
2021-09-11,Sierra,091,2930,129,123,13,136,0
2021-09-11,Siskiyou,093,43540,2881,2717,965,3682,35
2021-09-11,Solano,095,438530,43280,42344,1101,43445,306
2021-09-11,Sonoma,097,501317,38767,38399,470,38869,368
2021-09-11,Stanislaus,099,539301,70532,69974,7966,77940,1091
2021-09-11,Sutter,101,95872,12696,12538,211,12749,145
2021-09-11,Tehama,103,63373,6947,6703,1112,7815,79
2021-09-11,Trinity,105,12862,686,526,187,713,7
2021-09-11,Tulare,107,460477,60098,58321,12199,70520,889
2021-09-11,Tuolumne,109,53932,5988,5879,66,5945,89
2021-09-11,Ventura,111,848112,93479,92328,4069,96397,1107
2021-09-11,Yolo,113,214977,18206,17906,903,18809,239
2021-09-11,Yuba,115,75493,8960,8813,201,9014,61
2021-09-10,Alameda,001,1643700,112708,111386,2580,113966,1306
2021-09-10,Alpine,003,1148,97,97,0,97,0
2021-09-10,Amador,005,37829,4832,4706,48,4754,56
2021-09-10,Butte,007,227075,17810,17051,3099,20150,222
2021-09-10,Calaveras,009,45235,3306,3183,22,3205,65
2021-09-10,Colusa,011,21464,2373,2327,517,2844,16
2021-09-10,Contra Costa,013,1133247,93162,92024,1876,93900,908
2021-09-10,Del Norte,015,27424,3308,3128,20,3148,28
2021-09-10,El Dorado,017,186661,14431,14051,1449,15500,119
2021-09-10,Fresno,019,978130,124246,121659,11185,132844,1846
2021-09-10,Glenn,021,27897,3090,2977,886,3863,20
2021-09-10,Humboldt,023,135768,7769,7543,358,7901,52
2021-09-10,Imperial,025,180216,31016,30716,2976,33692,751
2021-09-10,Inyo,027,18085,1626,1590,31,1621,39
2021-09-10,Kern,029,883053,114453,111832,17193,129025,1419
2021-09-10,Kings,031,150075,28300,27473,1575,29048,274
2021-09-10,Lake,033,64148,5903,5713,113,5826,79
2021-09-10,Lassen,035,31185,6078,5914,232,6146,25
2021-09-10,Los Angeles,037,10098052,1380646,1365709,51162,1416871,25630
2021-09-10,Madera,039,155013,20105,19520,1573,21093,252
2021-09-10,Marin,041,260295,16658,16458,378,16836,242
2021-09-10,Mariposa,043,17540,858,795,29,824,5
2021-09-10,Mendocino,045,87422,6461,6184,278,6462,61
2021-09-10,Merced,047,269075,37510,36884,1466,38350,521
2021-09-10,Modoc,049,8938,465,448,159,607,5
2021-09-10,Mono,051,14174,1469,1422,18,1440,3
2021-09-10,Monterey,053,433212,46855,46084,2508,48592,557
2021-09-10,Napa,055,140530,12099,11948,81,12029,90
2021-09-10,Nevada,057,99092,8121,7932,266,8198,83
2021-09-10,Orange,059,3164182,293582,290022,13887,303909,5302
2021-09-10,Placer,061,380077,33027,32264,3043,35307,343
2021-09-10,Plumas,063,18699,1183,1111,22,1133,5
2021-09-10,Riverside,065,2383286,342041,335988,15744,351732,4720
2021-09-10,Sacramento,067,1510023,144471,143244,3505,146749,1950
2021-09-10,San Benito,069,59416,6874,6824,140,6964,64
2021-09-10,San Bernardino,071,2135413,335860,331894,10449,342343,5422
2021-09-10,San Diego,073,3302833,347768,343173,20456,363629,3941
2021-09-10,San Francisco,075,870044,49323,48518,2101,50619,602
2021-09-10,San Joaquin,077,732212,91707,90208,4851,95059,1573
2021-09-10,San Luis Obispo,079,281455,27151,26526,1044,27570,299
2021-09-10,San Mateo,081,765935,51162,50251,764,51015,564
2021-09-10,Santa Barbara,083,443738,41191,40321,1441,41762,492
2021-09-10,Santa Clara,085,1922200,139019,137337,1077,138414,1817
2021-09-10,Santa Cruz,087,273765,19085,18785,967,19752,210
2021-09-10,Shasta,089,179085,17414,16667,2750,19417,242
2021-09-10,Sierra,091,2930,129,117,13,130,0
2021-09-10,Siskiyou,093,43540,2869,2702,961,3663,35
2021-09-10,Solano,095,438530,43206,42230,1094,43324,305
2021-09-10,Sonoma,097,501317,38709,38271,469,38740,368
2021-09-10,Stanislaus,099,539301,70376,69617,7942,77559,1091
2021-09-10,Sutter,101,95872,12662,12468,211,12679,145
2021-09-10,Tehama,103,63373,6914,6652,1106,7758,77
2021-09-10,Trinity,105,12862,682,524,187,711,7
2021-09-10,Tulare,107,460477,59950,57930,12152,70082,883
2021-09-10,Tuolumne,109,53932,5969,5842,65,5907,89
2021-09-10,Ventura,111,848112,93382,92145,4065,96210,1104
2021-09-10,Yolo,113,214977,18181,17825,898,18723,239
2021-09-10,Yuba,115,75493,8941,8760,200,8960,62
2021-09-09,Alameda,001,1643700,112489,111014,2576,113590,1306
2021-09-09,Alpine,003,1148,97,94,0,94,0
2021-09-09,Amador,005,37829,4811,4698,47,4745,56
2021-09-09,Butte,007,227075,17663,16874,3073,19947,221
2021-09-09,Calaveras,009,45235,3272,3165,22,3187,65
2021-09-09,Colusa,011,21464,2366,2321,516,2837,16
2021-09-09,Contra Costa,013,1133247,92952,91687,1871,93558,904
2021-09-09,Del Norte,015,27424,3285,3102,20,3122,28
2021-09-09,El Dorado,017,186661,14374,13970,1439,15409,119
2021-09-09,Fresno,019,978130,123771,121040,11138,132178,1838
2021-09-09,Glenn,021,27897,3078,2947,882,3829,20
2021-09-09,Humboldt,023,135768,7719,7471,352,7823,52
2021-09-09,Imperial,025,180216,30978,30661,2973,33634,751
2021-09-09,Inyo,027,18085,1619,1586,31,1617,39
2021-09-09,Kern,029,883053,114106,111390,17036,128426,1414
2021-09-09,Kings,031,150075,28199,27282,1564,28846,273
2021-09-09,Lake,033,64148,5879,5638,111,5749,79
2021-09-09,Lassen,035,31185,6028,5860,226,6086,25
2021-09-09,Los Angeles,037,10098052,1378781,1363735,51087,1414822,25583
2021-09-09,Madera,039,155013,20032,19401,1560,20961,252
2021-09-09,Marin,041,260295,16635,16416,375,16791,242
2021-09-09,Mariposa,043,17540,845,779,28,807,5
2021-09-09,Mendocino,045,87422,6427,6089,269,6358,61
2021-09-09,Merced,047,269075,37356,36634,1453,38087,516
2021-09-09,Modoc,049,8938,465,448,159,607,5
2021-09-09,Mono,051,14174,1459,1420,18,1438,3
2021-09-09,Monterey,053,433212,46801,45991,2497,48488,556
2021-09-09,Napa,055,140530,12067,11878,81,11959,90
2021-09-09,Nevada,057,99092,8083,7855,266,8121,82
2021-09-09,Orange,059,3164182,293173,289109,13856,302965,5299
2021-09-09,Placer,061,380077,32909,32048,3028,35076,342
2021-09-09,Plumas,063,18699,1172,1098,22,1120,5
2021-09-09,Riverside,065,2383286,341402,334774,15726,350500,4701
2021-09-09,Sacramento,067,1510023,143991,142728,3459,146187,1929
2021-09-09,San Benito,069,59416,6864,6820,139,6959,64
2021-09-09,San Bernardino,071,2135413,335293,331040,10436,341476,5417
2021-09-09,San Diego,073,3302833,347054,342149,20399,362548,3929
2021-09-09,San Francisco,075,870044,49209,48404,2092,50496,597
2021-09-09,San Joaquin,077,732212,91432,89874,4833,94707,1570
2021-09-09,San Luis Obispo,079,281455,27069,26472,1041,27513,296
2021-09-09,San Mateo,081,765935,51040,50143,761,50904,561
2021-09-09,Santa Barbara,083,443738,41085,40180,1437,41617,490
2021-09-09,Santa Clara,085,1922200,138796,137017,1072,138089,1816
2021-09-09,Santa Cruz,087,273765,19039,18728,967,19695,210
2021-09-09,Shasta,089,179085,17268,16401,2708,19109,238
2021-09-09,Sierra,091,2930,129,115,13,128,0
2021-09-09,Siskiyou,093,43540,2846,2683,947,3630,35
2021-09-09,Solano,095,438530,43090,42081,1090,43171,303
2021-09-09,Sonoma,097,501317,38641,38171,468,38639,360
2021-09-09,Stanislaus,099,539301,70097,69178,7909,77087,1074
2021-09-09,Sutter,101,95872,12607,12396,209,12605,144
2021-09-09,Tehama,103,63373,6860,6554,1101,7655,75
2021-09-09,Trinity,105,12862,676,523,185,708,6
2021-09-09,Tulare,107,460477,59708,57564,12093,69657,879
2021-09-09,Tuolumne,109,53932,5941,5802,64,5866,89
2021-09-09,Ventura,111,848112,93237,91610,4056,95666,1098
2021-09-09,Yolo,113,214977,18123,17724,895,18619,239
2021-09-09,Yuba,115,75493,8896,8707,197,8904,55
2021-09-08,Alameda,001,1643700,112243,110781,2573,113354,1305
2021-09-08,Alpine,003,1148,97,94,0,94,0
2021-09-08,Amador,005,37829,4799,4693,47,4740,56
2021-09-08,Butte,007,227075,17529,16775,3055,19830,220
2021-09-08,Calaveras,009,45235,3254,3157,22,3179,63
2021-09-08,Colusa,011,21464,2364,2308,516,2824,16
2021-09-08,Contra Costa,013,1133247,92672,91471,1866,93337,900
2021-09-08,Del Norte,015,27424,3262,3085,20,3105,25
2021-09-08,El Dorado,017,186661,14294,13928,1418,15346,119
2021-09-08,Fresno,019,978130,123273,120644,11073,131717,1831
2021-09-08,Glenn,021,27897,3063,2942,873,3815,20
2021-09-08,Humboldt,023,135768,7675,7438,344,7782,52
2021-09-08,Imperial,025,180216,30945,30609,2960,33569,751
2021-09-08,Inyo,027,18085,1608,1580,31,1611,39
2021-09-08,Kern,029,883053,113708,110933,16896,127829,1409
2021-09-08,Kings,031,150075,28070,27235,1549,28784,267
2021-09-08,Lake,033,64148,5849,5618,109,5727,79
2021-09-08,Lassen,035,31185,6010,5848,219,6067,25
2021-09-08,Los Angeles,037,10098052,1376714,1362029,50998,1413027,25533
2021-09-08,Madera,039,155013,19972,19352,1546,20898,252
2021-09-08,Marin,041,260295,16607,16386,374,16760,242
2021-09-08,Mariposa,043,17540,833,777,27,804,5
2021-09-08,Mendocino,045,87422,6383,6069,260,6329,61
2021-09-08,Merced,047,269075,37195,36500,1441,37941,516
2021-09-08,Modoc,049,8938,465,448,159,607,5
2021-09-08,Mono,051,14174,1453,1418,18,1436,3
2021-09-08,Monterey,053,433212,46752,45959,2491,48450,554
2021-09-08,Napa,055,140530,12032,11842,79,11921,90
2021-09-08,Nevada,057,99092,8048,7843,265,8108,82
2021-09-08,Orange,059,3164182,292764,288511,13832,302343,5290
2021-09-08,Placer,061,380077,32772,31852,3011,34863,337
2021-09-08,Plumas,063,18699,1165,1072,22,1094,5
2021-09-08,Riverside,065,2383286,340643,334037,15701,349738,4683
2021-09-08,Sacramento,067,1510023,143512,142448,3410,145858,1921
2021-09-08,San Benito,069,59416,6846,6800,139,6939,64
2021-09-08,San Bernardino,071,2135413,334691,330279,10419,340698,5411
2021-09-08,San Diego,073,3302833,346138,341437,20348,361785,3926
2021-09-08,San Francisco,075,870044,49071,48263,2088,50351,589
2021-09-08,San Joaquin,077,732212,91152,89631,4809,94440,1561
2021-09-08,San Luis Obispo,079,281455,26975,26303,1036,27339,294
2021-09-08,San Mateo,081,765935,50936,50051,761,50812,561
2021-09-08,Santa Barbara,083,443738,40973,40000,1433,41433,490
2021-09-08,Santa Clara,085,1922200,138563,136836,1068,137904,1810
2021-09-08,Santa Cruz,087,273765,19002,18699,967,19666,210
2021-09-08,Shasta,089,179085,17113,16227,2661,18888,234
2021-09-08,Sierra,091,2930,129,113,13,126,0
2021-09-08,Siskiyou,093,43540,2813,2643,936,3579,35
2021-09-08,Solano,095,438530,42998,41971,1087,43058,302
2021-09-08,Sonoma,097,501317,38557,38075,467,38542,360
2021-09-08,Stanislaus,099,539301,69866,68945,7870,76815,1074
2021-09-08,Sutter,101,95872,12542,12349,206,12555,144
2021-09-08,Tehama,103,63373,6793,6520,1084,7604,75
2021-09-08,Trinity,105,12862,673,520,181,701,6
2021-09-08,Tulare,107,460477,59384,57425,12037,69462,876
2021-09-08,Tuolumne,109,53932,5909,5783,62,5845,89
2021-09-08,Ventura,111,848112,93085,91345,4038,95383,1096
2021-09-08,Yolo,113,214977,18041,17680,890,18570,239
2021-09-08,Yuba,115,75493,8854,8675,195,8870,55
2021-09-07,Alameda,001,1643700,111942,110550,2566,113116,1301
2021-09-07,Alpine,003,1148,96,94,0,94,0
2021-09-07,Amador,005,37829,4772,4679,47,4726,53
2021-09-07,Butte,007,227075,17373,16723,3018,19741,220
2021-09-07,Calaveras,009,45235,3213,3140,20,3160,63
2021-09-07,Colusa,011,21464,2354,2306,514,2820,16
2021-09-07,Contra Costa,013,1133247,92409,91167,1860,93027,891
2021-09-07,Del Norte,015,27424,3248,3081,20,3101,24
2021-09-07,El Dorado,017,186661,14222,13892,1403,15295,119
2021-09-07,Fresno,019,978130,122715,120268,10978,131246,1828
2021-09-07,Glenn,021,27897,3051,2937,867,3804,20
2021-09-07,Humboldt,023,135768,7615,7397,327,7724,52
2021-09-07,Imperial,025,180216,30905,30584,2952,33536,751
2021-09-07,Inyo,027,18085,1602,1579,30,1609,39
2021-09-07,Kern,029,883053,113276,110674,16735,127409,1408
2021-09-07,Kings,031,150075,27946,27169,1531,28700,267
2021-09-07,Lake,033,64148,5806,5597,101,5698,78
2021-09-07,Lassen,035,31185,5992,5842,213,6055,21
2021-09-07,Los Angeles,037,10098052,1374482,1360407,50906,1411313,25486
2021-09-07,Madera,039,155013,19885,19316,1538,20854,249
2021-09-07,Marin,041,260295,16568,16363,374,16737,242
2021-09-07,Mariposa,043,17540,817,771,27,798,5
2021-09-07,Mendocino,045,87422,6323,6036,250,6286,61
2021-09-07,Merced,047,269075,37021,36400,1435,37835,513
2021-09-07,Modoc,049,8938,463,449,159,608,5
2021-09-07,Mono,051,14174,1444,1416,18,1434,3
2021-09-07,Monterey,053,433212,46669,45911,2479,48390,543
2021-09-07,Napa,055,140530,11991,11814,79,11893,90
2021-09-07,Nevada,057,99092,8021,7829,265,8094,82
2021-09-07,Orange,059,3164182,292335,288225,13801,302026,5274
2021-09-07,Placer,061,380077,32619,31710,2983,34693,337
2021-09-07,Plumas,063,18699,1150,1071,22,1093,5
2021-09-07,Riverside,065,2383286,339856,333390,15682,349072,4666
2021-09-07,Sacramento,067,1510023,142972,142364,3364,145728,1905
2021-09-07,San Benito,069,59416,6828,6786,139,6925,64
2021-09-07,San Bernardino,071,2135413,333941,329962,10394,340356,5407
2021-09-07,San Diego,073,3302833,345141,340709,20282,360991,3922
2021-09-07,San Francisco,075,870044,48931,48175,2083,50258,589
2021-09-07,San Joaquin,077,732212,90817,89468,4795,94263,1548
2021-09-07,San Luis Obispo,079,281455,26857,26253,1027,27280,287
2021-09-07,San Mateo,081,765935,50843,49913,760,50673,561
2021-09-07,Santa Barbara,083,443738,40847,39957,1428,41385,489
2021-09-07,Santa Clara,085,1922200,138276,136631,1063,137694,1807
2021-09-07,Santa Cruz,087,273765,18953,18669,965,19634,210
2021-09-07,Shasta,089,179085,16957,16096,2608,18704,226
2021-09-07,Sierra,091,2930,129,111,13,124,0
2021-09-07,Siskiyou,093,43540,2787,2607,919,3526,34
2021-09-07,Solano,095,438530,42868,41862,1083,42945,300
2021-09-07,Sonoma,097,501317,38473,38013,465,38478,358
2021-09-07,Stanislaus,099,539301,69595,68831,7842,76673,1074
2021-09-07,Sutter,101,95872,12468,12310,200,12510,138
2021-09-07,Tehama,103,63373,6741,6482,1064,7546,74
2021-09-07,Trinity,105,12862,667,517,181,698,6
2021-09-07,Tulare,107,460477,59034,57228,11958,69186,874
2021-09-07,Tuolumne,109,53932,5872,5759,62,5821,88
2021-09-07,Ventura,111,848112,92874,91246,4028,95274,1093
2021-09-07,Yolo,113,214977,17972,17653,885,18538,235
2021-09-07,Yuba,115,75493,8811,8642,190,8832,55
2021-09-06,Alameda,001,1643700,111628,110357,2558,112915,1301
2021-09-06,Alpine,003,1148,94,94,0,94,0
2021-09-06,Amador,005,37829,4756,4648,46,4694,53
2021-09-06,Butte,007,227075,17180,16588,2975,19563,218
2021-09-06,Calaveras,009,45235,3191,3122,20,3142,63
2021-09-06,Colusa,011,21464,2347,2306,510,2816,16
2021-09-06,Contra Costa,013,1133247,92114,90971,1850,92821,891
2021-09-06,Del Norte,015,27424,3207,3037,19,3056,24
2021-09-06,El Dorado,017,186661,14153,13848,1387,15235,119
2021-09-06,Fresno,019,978130,122142,119738,10903,130641,1828
2021-09-06,Glenn,021,27897,3022,2912,859,3771,20
2021-09-06,Humboldt,023,135768,7539,7320,309,7629,52
2021-09-06,Imperial,025,180216,30842,30576,2946,33522,751
2021-09-06,Inyo,027,18085,1593,1578,18,1596,39
2021-09-06,Kern,029,883053,112764,110347,16547,126894,1408
2021-09-06,Kings,031,150075,27803,27094,1516,28610,264
2021-09-06,Lake,033,64148,5742,5548,94,5642,78
2021-09-06,Lassen,035,31185,5966,5822,203,6025,21
2021-09-06,Los Angeles,037,10098052,1372105,1359348,50790,1410138,25477
2021-09-06,Madera,039,155013,19782,19191,1515,20706,249
2021-09-06,Marin,041,260295,16528,16356,374,16730,242
2021-09-06,Mariposa,043,17540,805,764,27,791,5
2021-09-06,Mendocino,045,87422,6253,5984,237,6221,61
2021-09-06,Merced,047,269075,36807,36300,1421,37721,513
2021-09-06,Modoc,049,8938,460,449,159,608,5
2021-09-06,Mono,051,14174,1440,1416,18,1434,3
2021-09-06,Monterey,053,433212,46575,45833,2462,48295,541
2021-09-06,Napa,055,140530,11948,11792,78,11870,90
2021-09-06,Nevada,057,99092,7973,7748,263,8011,82
2021-09-06,Orange,059,3164182,291841,287948,13748,301696,5274
2021-09-06,Placer,061,380077,32442,31595,2945,34540,337
2021-09-06,Plumas,063,18699,1129,1068,19,1087,5
2021-09-06,Riverside,065,2383286,339041,333052,15662,348714,4666
2021-09-06,Sacramento,067,1510023,142331,141730,3296,145026,1905
2021-09-06,San Benito,069,59416,6805,6777,136,6913,64
2021-09-06,San Bernardino,071,2135413,333056,329693,10363,340056,5398
2021-09-06,San Diego,073,3302833,344142,340222,20185,360407,3922
2021-09-06,San Francisco,075,870044,48797,48120,2076,50196,589
2021-09-06,San Joaquin,077,732212,90471,89293,4769,94062,1548
2021-09-06,San Luis Obispo,079,281455,26728,26183,1023,27206,286
2021-09-06,San Mateo,081,765935,50714,49859,758,50617,561
2021-09-06,Santa Barbara,083,443738,40717,39876,1419,41295,489
2021-09-06,Santa Clara,085,1922200,137984,136458,1061,137519,1807
2021-09-06,Santa Cruz,087,273765,18904,18615,962,19577,210
2021-09-06,Shasta,089,179085,16776,15985,2554,18539,226
2021-09-06,Sierra,091,2930,129,109,13,122,0
2021-09-06,Siskiyou,093,43540,2743,2595,885,3480,34
2021-09-06,Solano,095,438530,42720,41774,1076,42850,300
2021-09-06,Sonoma,097,501317,38352,37929,464,38393,358
2021-09-06,Stanislaus,099,539301,69254,68596,7798,76394,1074
2021-09-06,Sutter,101,95872,12406,12238,191,12429,138
2021-09-06,Tehama,103,63373,6679,6413,1037,7450,74
2021-09-06,Trinity,105,12862,664,515,179,694,6
2021-09-06,Tulare,107,460477,58676,57068,11878,68946,874
2021-09-06,Tuolumne,109,53932,5836,5697,62,5759,88
2021-09-06,Ventura,111,848112,92697,91132,4016,95148,1093
2021-09-06,Yolo,113,214977,17887,17576,879,18455,235
2021-09-06,Yuba,115,75493,8761,8584,186,8770,55
2021-09-05,Alameda,001,1643700,111436,110173,2555,112728,1301
2021-09-05,Alpine,003,1148,94,94,0,94,0
2021-09-05,Amador,005,37829,4744,4642,46,4688,53
2021-09-05,Butte,007,227075,17090,16504,2947,19451,218
2021-09-05,Calaveras,009,45235,3185,3106,20,3126,63
2021-09-05,Colusa,011,21464,2339,2305,508,2813,16
2021-09-05,Contra Costa,013,1133247,91929,90862,1845,92707,891
2021-09-05,Del Norte,015,27424,3187,3023,19,3042,24
2021-09-05,El Dorado,017,186661,14124,13827,1373,15200,119
2021-09-05,Fresno,019,978130,121843,119384,10861,130245,1828
2021-09-05,Glenn,021,27897,3008,2899,857,3756,20
2021-09-05,Humboldt,023,135768,7506,7312,306,7618,52
2021-09-05,Imperial,025,180216,30813,30548,2944,33492,751
2021-09-05,Inyo,027,18085,1590,1572,18,1590,39
2021-09-05,Kern,029,883053,112464,110073,16388,126461,1408
2021-09-05,Kings,031,150075,27726,26989,1512,28501,264
2021-09-05,Lake,033,64148,5722,5525,94,5619,78
2021-09-05,Lassen,035,31185,5944,5820,199,6019,21
2021-09-05,Los Angeles,037,10098052,1370816,1357748,50720,1408468,25465
2021-09-05,Madera,039,155013,19741,19155,1504,20659,249
2021-09-05,Marin,041,260295,16509,16342,373,16715,242
2021-09-05,Mariposa,043,17540,801,761,27,788,5
2021-09-05,Mendocino,045,87422,6219,5965,237,6202,61
2021-09-05,Merced,047,269075,36732,36243,1419,37662,513
2021-09-05,Modoc,049,8938,460,447,159,606,5
2021-09-05,Mono,051,14174,1440,1416,18,1434,3
2021-09-05,Monterey,053,433212,46547,45795,2453,48248,540
2021-09-05,Napa,055,140530,11923,11770,78,11848,90
2021-09-05,Nevada,057,99092,7951,7722,262,7984,82
2021-09-05,Orange,059,3164182,291553,287614,13731,301345,5274
2021-09-05,Placer,061,380077,32314,31487,2931,34418,337
2021-09-05,Plumas,063,18699,1122,1067,19,1086,5
2021-09-05,Riverside,065,2383286,338586,332604,15650,348254,4654
2021-09-05,Sacramento,067,1510023,141893,141276,3278,144554,1905
2021-09-05,San Benito,069,59416,6804,6764,136,6900,64
2021-09-05,San Bernardino,071,2135413,332674,329062,10348,339410,5392
2021-09-05,San Diego,073,3302833,343590,339427,20144,359571,3914
2021-09-05,San Francisco,075,870044,48719,48035,2072,50107,589
2021-09-05,San Joaquin,077,732212,90305,89121,4752,93873,1548
2021-09-05,San Luis Obispo,079,281455,26679,26098,1022,27120,285
2021-09-05,San Mateo,081,765935,50646,49809,754,50563,561
2021-09-05,Santa Barbara,083,443738,40650,39762,1417,41179,489
2021-09-05,Santa Clara,085,1922200,137774,136146,1059,137205,1807
2021-09-05,Santa Cruz,087,273765,18884,18588,960,19548,210
2021-09-05,Shasta,089,179085,16693,15960,2528,18488,226
2021-09-05,Sierra,091,2930,128,109,13,122,0
2021-09-05,Siskiyou,093,43540,2726,2585,871,3456,34
2021-09-05,Solano,095,438530,42625,41687,1071,42758,300
2021-09-05,Sonoma,097,501317,38267,37881,463,38344,358
2021-09-05,Stanislaus,099,539301,69115,68434,7773,76207,1074
2021-09-05,Sutter,101,95872,12376,12179,185,12364,138
2021-09-05,Tehama,103,63373,6653,6400,1031,7431,74
2021-09-05,Trinity,105,12862,658,505,178,683,6
2021-09-05,Tulare,107,460477,58506,56915,11834,68749,874
2021-09-05,Tuolumne,109,53932,5824,5688,62,5750,88
2021-09-05,Ventura,111,848112,92561,91004,4012,95016,1093
2021-09-05,Yolo,113,214977,17850,17557,873,18430,235
2021-09-05,Yuba,115,75493,8734,8521,184,8705,55
2021-09-04,Alameda,001,1643700,111313,109944,2548,112492,1301
2021-09-04,Alpine,003,1148,94,94,0,94,0
2021-09-04,Amador,005,37829,4726,4637,45,4682,53
2021-09-04,Butte,007,227075,17032,16403,2932,19335,218
2021-09-04,Calaveras,009,45235,3173,3087,19,3106,63
2021-09-04,Colusa,011,21464,2337,2301,508,2809,16
2021-09-04,Contra Costa,013,1133247,91812,90623,1842,92465,891
2021-09-04,Del Norte,015,27424,3176,2984,19,3003,24
2021-09-04,El Dorado,017,186661,14098,13782,1364,15146,119
2021-09-04,Fresno,019,978130,121647,119033,10840,129873,1828
2021-09-04,Glenn,021,27897,2998,2878,851,3729,20
2021-09-04,Humboldt,023,135768,7475,7298,300,7598,52
2021-09-04,Imperial,025,180216,30790,30526,2942,33468,751
2021-09-04,Inyo,027,18085,1588,1571,18,1589,39
2021-09-04,Kern,029,883053,112220,109751,16257,126008,1408
2021-09-04,Kings,031,150075,27639,26896,1506,28402,263
2021-09-04,Lake,033,64148,5704,5507,94,5601,78
2021-09-04,Lassen,035,31185,5929,5814,191,6005,21
2021-09-04,Los Angeles,037,10098052,1369866,1355634,50661,1406295,25454
2021-09-04,Madera,039,155013,19708,19112,1497,20609,249
2021-09-04,Marin,041,260295,16493,16319,372,16691,242
2021-09-04,Mariposa,043,17540,796,759,27,786,5
2021-09-04,Mendocino,045,87422,6183,5933,237,6170,61
2021-09-04,Merced,047,269075,36688,36083,1414,37497,513
2021-09-04,Modoc,049,8938,460,447,159,606,5
2021-09-04,Mono,051,14174,1437,1417,18,1435,3
2021-09-04,Monterey,053,433212,46516,45756,2449,48205,540
2021-09-04,Napa,055,140530,11898,11760,76,11836,90
2021-09-04,Nevada,057,99092,7936,7691,261,7952,82
2021-09-04,Orange,059,3164182,291290,287244,13710,300954,5274
2021-09-04,Placer,061,380077,32210,31374,2914,34288,337
2021-09-04,Plumas,063,18699,1114,1067,19,1086,5
2021-09-04,Riverside,065,2383286,338116,331958,15638,347596,4654
2021-09-04,Sacramento,067,1510023,141600,140735,3270,144005,1896
2021-09-04,San Benito,069,59416,6795,6758,136,6894,64
2021-09-04,San Bernardino,071,2135413,332342,328425,10334,338759,5393
2021-09-04,San Diego,073,3302833,343155,338748,20122,358870,3914
2021-09-04,San Francisco,075,870044,48644,47937,2063,50000,589
2021-09-04,San Joaquin,077,732212,90189,88846,4744,93590,1548
2021-09-04,San Luis Obispo,079,281455,26647,26020,1022,27042,285
2021-09-04,San Mateo,081,765935,50592,49721,754,50475,560
2021-09-04,Santa Barbara,083,443738,40584,39667,1415,41082,489
2021-09-04,Santa Clara,085,1922200,137589,135845,1056,136901,1806
2021-09-04,Santa Cruz,087,273765,18866,18579,956,19535,210
2021-09-04,Shasta,089,179085,16616,15924,2502,18426,226
2021-09-04,Sierra,091,2930,126,108,13,121,0
2021-09-04,Siskiyou,093,43540,2700,2563,860,3423,34
2021-09-04,Solano,095,438530,42552,41614,1069,42683,300
2021-09-04,Sonoma,097,501317,38234,37809,463,38272,358
2021-09-04,Stanislaus,099,539301,68968,68210,7748,75958,1074
2021-09-04,Sutter,101,95872,12335,12137,184,12321,138
2021-09-04,Tehama,103,63373,6628,6367,1013,7380,74
2021-09-04,Trinity,105,12862,656,497,178,675,6
2021-09-04,Tulare,107,460477,58398,56719,11791,68510,874
2021-09-04,Tuolumne,109,53932,5806,5667,60,5727,88
2021-09-04,Ventura,111,848112,92426,90904,4009,94913,1090
2021-09-04,Yolo,113,214977,17814,17522,869,18391,235
2021-09-04,Yuba,115,75493,8705,8475,183,8658,55
2021-09-03,Alameda,001,1643700,111158,109636,2545,112181,1301
2021-09-03,Alpine,003,1148,94,94,0,94,0
2021-09-03,Amador,005,37829,4704,4614,45,4659,53
2021-09-03,Butte,007,227075,16942,16259,2906,19165,215
2021-09-03,Calaveras,009,45235,3163,3069,19,3088,63
2021-09-03,Colusa,011,21464,2332,2295,507,2802,16
2021-09-03,Contra Costa,013,1133247,91660,90299,1839,92138,886
2021-09-03,Del Norte,015,27424,3148,2943,18,2961,24
2021-09-03,El Dorado,017,186661,14065,13710,1360,15070,119
2021-09-03,Fresno,019,978130,121312,118508,10818,129326,1822
2021-09-03,Glenn,021,27897,2989,2867,844,3711,20
2021-09-03,Humboldt,023,135768,7450,7194,295,7489,52
2021-09-03,Imperial,025,180216,30767,30475,2937,33412,751
2021-09-03,Inyo,027,18085,1583,1567,18,1585,39
2021-09-03,Kern,029,883053,112004,109296,16146,125442,1407
2021-09-03,Kings,031,150075,27555,26753,1503,28256,263
2021-09-03,Lake,033,64148,5684,5479,92,5571,78
2021-09-03,Lassen,035,31185,5912,5789,186,5975,21
2021-09-03,Los Angeles,037,10098052,1368537,1351185,50595,1401780,25384
2021-09-03,Madera,039,155013,19623,19021,1491,20512,247
2021-09-03,Marin,041,260295,16471,16293,371,16664,242
2021-09-03,Mariposa,043,17540,789,753,25,778,5
2021-09-03,Mendocino,045,87422,6148,5891,237,6128,61
2021-09-03,Merced,047,269075,36634,35941,1405,37346,512
2021-09-03,Modoc,049,8938,460,445,159,604,5
2021-09-03,Mono,051,14174,1436,1410,18,1428,3
2021-09-03,Monterey,053,433212,46478,45707,2445,48152,540
2021-09-03,Napa,055,140530,11877,11733,76,11809,89
2021-09-03,Nevada,057,99092,7902,7632,261,7893,82
2021-09-03,Orange,059,3164182,290973,286818,13682,300500,5253
2021-09-03,Placer,061,380077,32103,31238,2890,34128,335
2021-09-03,Plumas,063,18699,1103,1057,19,1076,5
2021-09-03,Riverside,065,2383286,337584,331011,15622,346633,4653
2021-09-03,Sacramento,067,1510023,141231,139982,3251,143233,1886
2021-09-03,San Benito,069,59416,6789,6746,136,6882,64
2021-09-03,San Bernardino,071,2135413,331926,327599,10323,337922,5381
2021-09-03,San Diego,073,3302833,342536,337627,20089,357716,3911
2021-09-03,San Francisco,075,870044,48568,47822,2057,49879,589
2021-09-03,San Joaquin,077,732212,90036,88366,4736,93102,1540
2021-09-03,San Luis Obispo,079,281455,26571,25917,1020,26937,283
2021-09-03,San Mateo,081,765935,50497,49617,752,50369,560
2021-09-03,Santa Barbara,083,443738,40517,39507,1412,40919,489
2021-09-03,Santa Clara,085,1922200,137387,135522,1052,136574,1801
2021-09-03,Santa Cruz,087,273765,18841,18532,956,19488,210
2021-09-03,Shasta,089,179085,16540,15778,2478,18256,226
2021-09-03,Sierra,091,2930,124,105,13,118,0
2021-09-03,Siskiyou,093,43540,2688,2529,847,3376,34
2021-09-03,Solano,095,438530,42456,41457,1066,42523,300
2021-09-03,Sonoma,097,501317,38171,37699,463,38162,358
2021-09-03,Stanislaus,099,539301,68793,67887,7722,75609,1074
2021-09-03,Sutter,101,95872,12296,12073,183,12256,139
2021-09-03,Tehama,103,63373,6589,6334,1006,7340,72
2021-09-03,Trinity,105,12862,654,490,173,663,6
2021-09-03,Tulare,107,460477,58272,56401,11738,68139,872
2021-09-03,Tuolumne,109,53932,5764,5630,60,5690,88
2021-09-03,Ventura,111,848112,92292,90742,4005,94747,1088
2021-09-03,Yolo,113,214977,17791,17446,863,18309,235
2021-09-03,Yuba,115,75493,8674,8412,183,8595,55
2021-09-02,Alameda,001,1643700,110899,109377,2542,111919,1301
2021-09-02,Alpine,003,1148,93,92,0,92,0
2021-09-02,Amador,005,37829,4688,4606,45,4651,53
2021-09-02,Butte,007,227075,16816,16154,2887,19041,215
2021-09-02,Calaveras,009,45235,3150,3042,19,3061,62
2021-09-02,Colusa,011,21464,2328,2290,507,2797,16
2021-09-02,Contra Costa,013,1133247,91477,90038,1828,91866,886
2021-09-02,Del Norte,015,27424,3117,2891,18,2909,24
2021-09-02,El Dorado,017,186661,14006,13641,1335,14976,119
2021-09-02,Fresno,019,978130,120824,117974,10763,128737,1804
2021-09-02,Glenn,021,27897,2973,2855,838,3693,20
2021-09-02,Humboldt,023,135768,7403,7141,284,7425,52
2021-09-02,Imperial,025,180216,30723,30449,2932,33381,751
2021-09-02,Inyo,027,18085,1578,1564,17,1581,39
2021-09-02,Kern,029,883053,111592,108930,16002,124932,1404
2021-09-02,Kings,031,150075,27462,26638,1493,28131,263
2021-09-02,Lake,033,64148,5654,5432,88,5520,78
2021-09-02,Lassen,035,31185,5898,5747,179,5926,21
2021-09-02,Los Angeles,037,10098052,1366677,1351105,50501,1401606,25382
2021-09-02,Madera,039,155013,19532,18937,1472,20409,247
2021-09-02,Marin,041,260295,16458,16244,369,16613,242
2021-09-02,Mariposa,043,17540,782,745,22,767,5
2021-09-02,Mendocino,045,87422,6106,5848,234,6082,61
2021-09-02,Merced,047,269075,36471,35820,1398,37218,508
2021-09-02,Modoc,049,8938,460,437,159,596,5
2021-09-02,Mono,051,14174,1436,1409,18,1427,3
2021-09-02,Monterey,053,433212,46412,45648,2430,48078,539
2021-09-02,Napa,055,140530,11848,11684,76,11760,88
2021-09-02,Nevada,057,99092,7850,7575,260,7835,82
2021-09-02,Orange,059,3164182,290513,286326,13648,299974,5240
2021-09-02,Placer,061,380077,31966,31067,2861,33928,330
2021-09-02,Plumas,063,18699,1092,1045,18,1063,5
2021-09-02,Riverside,065,2383286,336869,330190,15598,345788,4644
2021-09-02,Sacramento,067,1510023,140648,139274,3212,142486,1882
2021-09-02,San Benito,069,59416,6784,6734,135,6869,64
2021-09-02,San Bernardino,071,2135413,331319,326940,10250,337190,5369
2021-09-02,San Diego,073,3302833,341578,336382,20036,356418,3909
2021-09-02,San Francisco,075,870044,48460,47674,2053,49727,587
2021-09-02,San Joaquin,077,732212,89752,88056,4712,92768,1540
2021-09-02,San Luis Obispo,079,281455,26486,25851,1015,26866,283
2021-09-02,San Mateo,081,765935,50398,49490,749,50239,558
2021-09-02,Santa Barbara,083,443738,40427,39386,1399,40785,486
2021-09-02,Santa Clara,085,1922200,137086,135216,1046,136262,1799
2021-09-02,Santa Cruz,087,273765,18807,18473,953,19426,210
2021-09-02,Shasta,089,179085,16402,15670,2449,18119,224
2021-09-02,Sierra,091,2930,124,105,13,118,0
2021-09-02,Siskiyou,093,43540,2667,2513,819,3332,34
2021-09-02,Solano,095,438530,42350,41293,1063,42356,294
2021-09-02,Sonoma,097,501317,38090,37558,463,38021,352
2021-09-02,Stanislaus,099,539301,68552,67576,7700,75276,1074
2021-09-02,Sutter,101,95872,12227,11995,179,12174,138
2021-09-02,Tehama,103,63373,6531,6265,987,7252,72
2021-09-02,Trinity,105,12862,650,484,171,655,6
2021-09-02,Tulare,107,460477,58042,56105,11686,67791,872
2021-09-02,Tuolumne,109,53932,5708,5578,60,5638,88
2021-09-02,Ventura,111,848112,92109,90610,4000,94610,1084
2021-09-02,Yolo,113,214977,17721,17357,852,18209,235
2021-09-02,Yuba,115,75493,8614,8363,183,8546,55
2021-09-01,Alameda,001,1643700,110632,109075,2537,111612,1299
2021-09-01,Alpine,003,1148,93,92,0,92,0
2021-09-01,Amador,005,37829,4672,4599,44,4643,53
2021-09-01,Butte,007,227075,16701,16046,2859,18905,215
2021-09-01,Calaveras,009,45235,3138,3023,19,3042,59
2021-09-01,Colusa,011,21464,2323,2281,506,2787,16
2021-09-01,Contra Costa,013,1133247,91242,89834,1821,91655,877
2021-09-01,Del Norte,015,27424,3084,2860,18,2878,24
2021-09-01,El Dorado,017,186661,13950,13577,1306,14883,119
2021-09-01,Fresno,019,978130,120333,117492,10693,128185,1800
2021-09-01,Glenn,021,27897,2948,2846,830,3676,20
2021-09-01,Humboldt,023,135768,7356,7090,277,7367,52
2021-09-01,Imperial,025,180216,30685,30393,2927,33320,750
2021-09-01,Inyo,027,18085,1574,1561,16,1577,39
2021-09-01,Kern,029,883053,111161,108449,15860,124309,1400
2021-09-01,Kings,031,150075,27349,26443,1482,27925,263
2021-09-01,Lake,033,64148,5613,5396,83,5479,77
2021-09-01,Lassen,035,31185,5876,5731,175,5906,21
2021-09-01,Los Angeles,037,10098052,1364412,1348589,50398,1398987,25341
2021-09-01,Madera,039,155013,19454,18852,1457,20309,247
2021-09-01,Marin,041,260295,16436,16224,364,16588,240
2021-09-01,Mariposa,043,17540,774,735,22,757,5
2021-09-01,Mendocino,045,87422,6063,5821,229,6050,59
2021-09-01,Merced,047,269075,36294,35686,1388,37074,500
2021-09-01,Modoc,049,8938,454,436,157,593,5
2021-09-01,Mono,051,14174,1436,1400,18,1418,3
2021-09-01,Monterey,053,433212,46332,45590,2415,48005,539
2021-09-01,Napa,055,140530,11815,11653,76,11729,88
2021-09-01,Nevada,057,99092,7797,7508,259,7767,82
2021-09-01,Orange,059,3164182,290039,285840,13610,299450,5233
2021-09-01,Placer,061,380077,31811,30902,2847,33749,330
2021-09-01,Plumas,063,18699,1084,1033,18,1051,5
2021-09-01,Riverside,065,2383286,336053,329388,15568,344956,4634
2021-09-01,Sacramento,067,1510023,140039,138499,3166,141665,1875
2021-09-01,San Benito,069,59416,6767,6716,135,6851,64
2021-09-01,San Bernardino,071,2135413,330668,326250,10221,336471,5364
2021-09-01,San Diego,073,3302833,340556,335302,19980,355282,3908
2021-09-01,San Francisco,075,870044,48351,47538,2046,49584,584
2021-09-01,San Joaquin,077,732212,89430,87640,4689,92329,1540
2021-09-01,San Luis Obispo,079,281455,26390,25691,1010,26701,283
2021-09-01,San Mateo,081,765935,50278,49394,743,50137,558
2021-09-01,Santa Barbara,083,443738,40310,39263,1383,40646,483
2021-09-01,Santa Clara,085,1922200,136818,134855,1039,135894,1796
2021-09-01,Santa Cruz,087,273765,18760,18453,951,19404,210
2021-09-01,Shasta,089,179085,16270,15552,2408,17960,221
2021-09-01,Sierra,091,2930,123,98,13,111,0
2021-09-01,Siskiyou,093,43540,2637,2482,799,3281,34
2021-09-01,Solano,095,438530,42199,41194,1057,42251,293
2021-09-01,Sonoma,097,501317,37996,37454,462,37916,352
2021-09-01,Stanislaus,099,539301,68267,67287,7669,74956,1075
2021-09-01,Sutter,101,95872,12163,11945,172,12117,136
2021-09-01,Tehama,103,63373,6497,6228,970,7198,72
2021-09-01,Trinity,105,12862,649,482,168,650,5
2021-09-01,Tulare,107,460477,57759,55768,11649,67417,870
2021-09-01,Tuolumne,109,53932,5669,5553,60,5613,88
2021-09-01,Ventura,111,848112,91894,90471,3984,94455,1089
2021-09-01,Yolo,113,214977,17665,17264,846,18110,235
2021-09-01,Yuba,115,75493,8552,8308,183,8491,55
2021-08-31,Alameda,001,1643700,110339,108837,2530,111367,1297
2021-08-31,Alpine,003,1148,91,92,0,92,0
2021-08-31,Amador,005,37829,4651,4555,44,4599,53
2021-08-31,Butte,007,227075,16558,15896,2817,18713,216
2021-08-31,Calaveras,009,45235,3098,3008,19,3027,59
2021-08-31,Colusa,011,21464,2321,2275,504,2779,16
2021-08-31,Contra Costa,013,1133247,90947,89546,1809,91355,871
2021-08-31,Del Norte,015,27424,3048,2830,18,2848,19
2021-08-31,El Dorado,017,186661,13879,13539,1288,14827,119
2021-08-31,Fresno,019,978130,119757,117155,10614,127769,1801
2021-08-31,Glenn,021,27897,2932,2829,820,3649,20
2021-08-31,Humboldt,023,135768,7281,7030,264,7294,52
2021-08-31,Imperial,025,180216,30648,30348,2919,33267,750
2021-08-31,Inyo,027,18085,1570,1550,16,1566,39
2021-08-31,Kern,029,883053,110659,108151,15681,123832,1393
2021-08-31,Kings,031,150075,27207,26405,1468,27873,260
2021-08-31,Lake,033,64148,5569,5359,80,5439,74
2021-08-31,Lassen,035,31185,5850,5702,172,5874,21
2021-08-31,Los Angeles,037,10098052,1361824,1346686,50319,1397005,25303
2021-08-31,Madera,039,155013,19364,18811,1439,20250,247
2021-08-31,Marin,041,260295,16407,16215,361,16576,240
2021-08-31,Mariposa,043,17540,766,732,22,754,5
2021-08-31,Mendocino,045,87422,6021,5777,227,6004,59
2021-08-31,Merced,047,269075,36124,35512,1383,36895,498
2021-08-31,Modoc,049,8938,453,436,157,593,5
2021-08-31,Mono,051,14174,1424,1398,18,1416,3
2021-08-31,Monterey,053,433212,46248,45550,2402,47952,539
2021-08-31,Napa,055,140530,11768,11618,76,11694,88
2021-08-31,Nevada,057,99092,7730,7460,259,7719,82
2021-08-31,Orange,059,3164182,289441,285310,13576,298886,5229
2021-08-31,Placer,061,380077,31621,30745,2809,33554,325
2021-08-31,Plumas,063,18699,1080,1018,17,1035,5
2021-08-31,Riverside,065,2383286,335079,328556,15535,344091,4627
2021-08-31,Sacramento,067,1510023,139354,137879,3134,141013,1863
2021-08-31,San Benito,069,59416,6755,6694,133,6827,64
2021-08-31,San Bernardino,071,2135413,329922,325446,10201,335647,5350
2021-08-31,San Diego,073,3302833,339303,334377,19922,354299,3888
2021-08-31,San Francisco,075,870044,48200,47440,2035,49475,581
2021-08-31,San Joaquin,077,732212,88984,87365,4674,92039,1540
2021-08-31,San Luis Obispo,079,281455,26267,25518,1006,26524,282
2021-08-31,San Mateo,081,765935,50166,49299,743,50042,556
2021-08-31,Santa Barbara,083,443738,40159,39091,1377,40468,481
2021-08-31,Santa Clara,085,1922200,136467,134637,1032,135669,1793
2021-08-31,Santa Cruz,087,273765,18722,18419,948,19367,210
2021-08-31,Shasta,089,179085,16118,15368,2381,17749,220
2021-08-31,Sierra,091,2930,120,95,13,108,0
2021-08-31,Siskiyou,093,43540,2617,2435,783,3218,33
2021-08-31,Solano,095,438530,42060,41067,1050,42117,289
2021-08-31,Sonoma,097,501317,37900,37379,460,37839,352
2021-08-31,Stanislaus,099,539301,67912,67004,7634,74638,1075
2021-08-31,Sutter,101,95872,12098,11901,168,12069,136
2021-08-31,Tehama,103,63373,6436,6169,939,7108,72
2021-08-31,Trinity,105,12862,643,480,168,648,3
2021-08-31,Tulare,107,460477,57425,55567,11578,67145,870
2021-08-31,Tuolumne,109,53932,5633,5516,60,5576,88
2021-08-31,Ventura,111,848112,91675,90292,3972,94264,1081
2021-08-31,Yolo,113,214977,17584,17205,837,18042,234
2021-08-31,Yuba,115,75493,8498,8253,183,8436,54
2021-08-30,Alameda,001,1643700,110015,107734,2519,110253,1296
2021-08-30,Alpine,003,1148,91,92,0,92,0
2021-08-30,Amador,005,37829,4640,4507,44,4551,53
2021-08-30,Butte,007,227075,16407,15719,2784,18503,214
2021-08-30,Calaveras,009,45235,3083,2975,19,2994,59
2021-08-30,Colusa,011,21464,2312,2271,501,2772,16
2021-08-30,Contra Costa,013,1133247,90688,87679,1799,89478,872
2021-08-30,Del Norte,015,27424,3006,2796,17,2813,11
2021-08-30,El Dorado,017,186661,13810,13217,1271,14488,119
2021-08-30,Fresno,019,978130,119184,115867,10542,126409,1790
2021-08-30,Glenn,021,27897,2921,2804,814,3618,20
2021-08-30,Humboldt,023,135768,7227,6930,258,7188,52
2021-08-30,Imperial,025,180216,30610,30311,2914,33225,750
2021-08-30,Inyo,027,18085,1565,1544,16,1560,39
2021-08-30,Kern,029,883053,110180,107615,15517,123132,1389
2021-08-30,Kings,031,150075,27091,26236,1453,27689,259
2021-08-30,Lake,033,64148,5534,5323,77,5400,74
2021-08-30,Lassen,035,31185,5828,5667,166,5833,21
2021-08-30,Los Angeles,037,10098052,1359363,1344949,50234,1395183,25269
2021-08-30,Madera,039,155013,19282,18622,1419,20041,247
2021-08-30,Marin,041,260295,16376,16160,361,16521,240
2021-08-30,Mariposa,043,17540,760,715,21,736,5
2021-08-30,Mendocino,045,87422,5987,5721,223,5944,55
2021-08-30,Merced,047,269075,35996,35335,1379,36714,497
2021-08-30,Modoc,049,8938,451,436,156,592,5
2021-08-30,Mono,051,14174,1423,1390,18,1408,3
2021-08-30,Monterey,053,433212,46186,45463,2385,47848,539
2021-08-30,Napa,055,140530,11719,11579,74,11653,87
2021-08-30,Nevada,057,99092,7671,7356,256,7612,82
2021-08-30,Orange,059,3164182,288860,284750,13527,298277,5223
2021-08-30,Placer,061,380077,31456,29825,2786,32611,319
2021-08-30,Plumas,063,18699,1063,998,17,1015,5
2021-08-30,Riverside,065,2383286,334182,327593,15504,343097,4623
2021-08-30,Sacramento,067,1510023,138696,134571,3088,137659,1847
2021-08-30,San Benito,069,59416,6746,6663,133,6796,64
2021-08-30,San Bernardino,071,2135413,329244,324870,10171,335041,5348
2021-08-30,San Diego,073,3302833,338032,333011,19842,352853,3885
2021-08-30,San Francisco,075,870044,48061,46966,2021,48987,581
2021-08-30,San Joaquin,077,732212,88653,86203,4653,90856,1528
2021-08-30,San Luis Obispo,079,281455,26142,25422,999,26421,280
2021-08-30,San Mateo,081,765935,50040,48839,737,49576,554
2021-08-30,Santa Barbara,083,443738,40007,38998,1372,40370,481
2021-08-30,Santa Clara,085,1922200,136146,133281,1025,134306,1789
2021-08-30,Santa Cruz,087,273765,18668,18326,944,19270,210
2021-08-30,Shasta,089,179085,15989,15238,2340,17578,217
2021-08-30,Sierra,091,2930,118,91,13,104,0
2021-08-30,Siskiyou,093,43540,2604,2411,772,3183,33
2021-08-30,Solano,095,438530,41899,39986,1046,41032,290
2021-08-30,Sonoma,097,501317,37794,36764,460,37224,352
2021-08-30,Stanislaus,099,539301,67573,66173,7603,73776,1074
2021-08-30,Sutter,101,95872,12028,11791,161,11952,136
2021-08-30,Tehama,103,63373,6357,6085,915,7000,71
2021-08-30,Trinity,105,12862,632,468,165,633,3
2021-08-30,Tulare,107,460477,57113,55140,11502,66642,870
2021-08-30,Tuolumne,109,53932,5587,5492,60,5552,74
2021-08-30,Ventura,111,848112,91459,90149,3960,94109,1082
2021-08-30,Yolo,113,214977,17522,17071,833,17904,231
2021-08-30,Yuba,115,75493,8424,8129,182,8311,54
2021-08-29,Alameda,001,1643700,109670,107494,2508,110002,1296
2021-08-29,Alpine,003,1148,91,92,0,92,0
2021-08-29,Amador,005,37829,4626,4501,44,4545,53
2021-08-29,Butte,007,227075,16236,15602,2747,18349,214
2021-08-29,Calaveras,009,45235,3051,2970,19,2989,59
2021-08-29,Colusa,011,21464,2305,2260,495,2755,16
2021-08-29,Contra Costa,013,1133247,90391,87439,1794,89233,872
2021-08-29,Del Norte,015,27424,2963,2752,17,2769,11
2021-08-29,El Dorado,017,186661,13754,13166,1260,14426,119
2021-08-29,Fresno,019,978130,118587,115502,10472,125974,1790
2021-08-29,Glenn,021,27897,2903,2778,807,3585,20
2021-08-29,Humboldt,023,135768,7183,6922,243,7165,52
2021-08-29,Imperial,025,180216,30549,30293,2903,33196,750
2021-08-29,Inyo,027,18085,1555,1543,15,1558,39
2021-08-29,Kern,029,883053,109729,107324,15347,122671,1389
2021-08-29,Kings,031,150075,26938,26143,1438,27581,259
2021-08-29,Lake,033,64148,5494,5293,67,5360,74
2021-08-29,Lassen,035,31185,5805,5666,162,5828,21
2021-08-29,Los Angeles,037,10098052,1356604,1342541,50122,1392663,25263
2021-08-29,Madera,039,155013,19195,18594,1403,19997,247
2021-08-29,Marin,041,260295,16345,16134,359,16493,240
2021-08-29,Mariposa,043,17540,754,709,19,728,5
2021-08-29,Mendocino,045,87422,5929,5689,210,5899,55
2021-08-29,Merced,047,269075,35757,35250,1367,36617,497
2021-08-29,Modoc,049,8938,448,436,156,592,5
2021-08-29,Mono,051,14174,1416,1387,18,1405,3
2021-08-29,Monterey,053,433212,46080,45424,2361,47785,539
2021-08-29,Napa,055,140530,11688,11552,74,11626,87
2021-08-29,Nevada,057,99092,7614,7294,255,7549,82
2021-08-29,Orange,059,3164182,288231,284432,13484,297916,5223
2021-08-29,Placer,061,380077,31284,29674,2745,32419,319
2021-08-29,Plumas,063,18699,1052,996,17,1013,5
2021-08-29,Riverside,065,2383286,333325,326987,15483,342470,4623
2021-08-29,Sacramento,067,1510023,137943,133981,3039,137020,1843
2021-08-29,San Benito,069,59416,6721,6646,133,6779,64
2021-08-29,San Bernardino,071,2135413,328459,324266,10137,334403,5347
2021-08-29,San Diego,073,3302833,336926,332014,19746,351760,3880
2021-08-29,San Francisco,075,870044,47926,46885,2009,48894,581
2021-08-29,San Joaquin,077,732212,88206,85922,4632,90554,1528
2021-08-29,San Luis Obispo,079,281455,25944,25288,991,26279,280
2021-08-29,San Mateo,081,765935,49927,48737,732,49469,554
2021-08-29,Santa Barbara,083,443738,39841,38900,1368,40268,481
2021-08-29,Santa Clara,085,1922200,135793,132979,1019,133998,1789
2021-08-29,Santa Cruz,087,273765,18621,18285,942,19227,210
2021-08-29,Shasta,089,179085,15835,15198,2313,17511,217
2021-08-29,Sierra,091,2930,116,91,13,104,0
2021-08-29,Siskiyou,093,43540,2557,2407,752,3159,33
2021-08-29,Solano,095,438530,41745,39887,1039,40926,290
2021-08-29,Sonoma,097,501317,37658,36650,456,37106,352
2021-08-29,Stanislaus,099,539301,67228,65956,7567,73523,1074
2021-08-29,Sutter,101,95872,11969,11719,154,11873,136
2021-08-29,Tehama,103,63373,6286,6040,892,6932,71
2021-08-29,Trinity,105,12862,629,468,161,629,3
2021-08-29,Tulare,107,460477,56780,54974,11418,66392,870
2021-08-29,Tuolumne,109,53932,5562,5478,59,5537,74
2021-08-29,Ventura,111,848112,91201,90114,3951,94065,1082
2021-08-29,Yolo,113,214977,17422,17015,821,17836,231
2021-08-29,Yuba,115,75493,8360,8042,182,8224,54
2021-08-28,Alameda,001,1643700,109505,107007,2499,109506,1296
2021-08-28,Alpine,003,1148,91,92,0,92,0
2021-08-28,Amador,005,37829,4607,4484,43,4527,53
2021-08-28,Butte,007,227075,16177,15487,2720,18207,214
2021-08-28,Calaveras,009,45235,3041,2926,19,2945,59
2021-08-28,Colusa,011,21464,2301,2252,493,2745,16
2021-08-28,Contra Costa,013,1133247,90179,86938,1791,88729,872
2021-08-28,Del Norte,015,27424,2936,2734,16,2750,11
2021-08-28,El Dorado,017,186661,13714,13089,1254,14343,119
2021-08-28,Fresno,019,978130,118346,115079,10441,125520,1792
2021-08-28,Glenn,021,27897,2894,2773,800,3573,20
2021-08-28,Humboldt,023,135768,7148,6887,238,7125,52
2021-08-28,Imperial,025,180216,30522,30260,2900,33160,750
2021-08-28,Inyo,027,18085,1553,1539,15,1554,39
2021-08-28,Kern,029,883053,109491,107012,15205,122217,1389
2021-08-28,Kings,031,150075,26871,26059,1435,27494,257
2021-08-28,Lake,033,64148,5471,5267,63,5330,74
2021-08-28,Lassen,035,31185,5790,5665,161,5826,21
2021-08-28,Los Angeles,037,10098052,1355393,1337097,50049,1387146,25234
2021-08-28,Madera,039,155013,19144,18553,1389,19942,247
2021-08-28,Marin,041,260295,16330,16106,359,16465,240
2021-08-28,Mariposa,043,17540,752,704,19,723,5
2021-08-28,Mendocino,045,87422,5904,5658,210,5868,55
2021-08-28,Merced,047,269075,35705,35108,1364,36472,497
2021-08-28,Modoc,049,8938,448,436,155,591,5
2021-08-28,Mono,051,14174,1413,1385,18,1403,3
2021-08-28,Monterey,053,433212,46038,45394,2356,47750,539
2021-08-28,Napa,055,140530,11665,11512,73,11585,88
2021-08-28,Nevada,057,99092,7590,7238,253,7491,82
2021-08-28,Orange,059,3164182,287873,283953,13435,297388,5222
2021-08-28,Placer,061,380077,31175,29428,2732,32160,319
2021-08-28,Plumas,063,18699,1045,991,17,1008,5
2021-08-28,Riverside,065,2383286,332737,326222,15473,341695,4623
2021-08-28,Sacramento,067,1510023,137552,132985,3023,136008,1844
2021-08-28,San Benito,069,59416,6714,6636,133,6769,64
2021-08-28,San Bernardino,071,2135413,328011,323672,10129,333801,5348
2021-08-28,San Diego,073,3302833,336342,331330,19710,351040,3880
2021-08-28,San Francisco,075,870044,47854,46654,2002,48656,581
2021-08-28,San Joaquin,077,732212,88037,85481,4623,90104,1527
2021-08-28,San Luis Obispo,079,281455,25877,25138,986,26124,280
2021-08-28,San Mateo,081,765935,49853,48575,728,49303,554
2021-08-28,Santa Barbara,083,443738,39770,38780,1367,40147,481
2021-08-28,Santa Clara,085,1922200,135586,132488,1017,133505,1789
2021-08-28,Santa Cruz,087,273765,18603,18240,939,19179,210
2021-08-28,Shasta,089,179085,15732,15147,2294,17441,217
2021-08-28,Sierra,091,2930,112,91,13,104,0
2021-08-28,Siskiyou,093,43540,2549,2402,741,3143,33
2021-08-28,Solano,095,438530,41696,39610,1038,40648,290
2021-08-28,Sonoma,097,501317,37585,36466,454,36920,352
2021-08-28,Stanislaus,099,539301,67070,65670,7550,73220,1074
2021-08-28,Sutter,101,95872,11948,11669,153,11822,136
2021-08-28,Tehama,103,63373,6261,6004,879,6883,71
2021-08-28,Trinity,105,12862,625,463,160,623,3
2021-08-28,Tulare,107,460477,56650,54746,11376,66122,870
2021-08-28,Tuolumne,109,53932,5546,5469,59,5528,74
2021-08-28,Ventura,111,848112,91083,89934,3949,93883,1081
2021-08-28,Yolo,113,214977,17386,16907,814,17721,231
2021-08-28,Yuba,115,75493,8329,7985,181,8166,55
2021-08-27,Alameda,001,1643700,109294,106622,2497,109119,1296
2021-08-27,Alpine,003,1148,91,92,0,92,0
2021-08-27,Amador,005,37829,4591,4458,42,4500,53
2021-08-27,Butte,007,227075,16097,15277,2701,17978,214
2021-08-27,Calaveras,009,45235,3027,2903,19,2922,59
2021-08-27,Colusa,011,21464,2295,2240,491,2731,16
2021-08-27,Contra Costa,013,1133247,89981,86386,1788,88174,872
2021-08-27,Del Norte,015,27424,2904,2695,16,2711,11
2021-08-27,El Dorado,017,186661,13675,12968,1250,14218,119
2021-08-27,Fresno,019,978130,117912,114481,10418,124899,1774
2021-08-27,Glenn,021,27897,2876,2754,791,3545,20
2021-08-27,Humboldt,023,135768,7115,6782,235,7017,52
2021-08-27,Imperial,025,180216,30502,30201,2897,33098,750
2021-08-27,Inyo,027,18085,1552,1529,15,1544,39
2021-08-27,Kern,029,883053,109197,106570,15095,121665,1385
2021-08-27,Kings,031,150075,26792,25957,1433,27390,257
2021-08-27,Lake,033,64148,5446,5228,62,5290,74
2021-08-27,Lassen,035,31185,5774,5646,156,5802,21
2021-08-27,Los Angeles,037,10098052,1353863,1337006,49985,1386991,25230
2021-08-27,Madera,039,155013,19088,18476,1376,19852,247
2021-08-27,Marin,041,260295,16314,16055,357,16412,240
2021-08-27,Mariposa,043,17540,746,690,19,709,5
2021-08-27,Mendocino,045,87422,5873,5602,209,5811,55
2021-08-27,Merced,047,269075,35651,34906,1355,36261,495
2021-08-27,Modoc,049,8938,448,434,155,589,5
2021-08-27,Mono,051,14174,1408,1385,18,1403,3
2021-08-27,Monterey,053,433212,45989,45337,2348,47685,539
2021-08-27,Napa,055,140530,11631,11460,73,11533,87
2021-08-27,Nevada,057,99092,7550,7169,251,7420,82
2021-08-27,Orange,059,3164182,287512,283407,13396,296803,5206
2021-08-27,Placer,061,380077,31045,29157,2712,31869,320
2021-08-27,Plumas,063,18699,1039,984,17,1001,5
2021-08-27,Riverside,065,2383286,332219,325379,15458,340837,4622
2021-08-27,Sacramento,067,1510023,137117,131921,3010,134931,1838
2021-08-27,San Benito,069,59416,6708,6622,133,6755,64
2021-08-27,San Bernardino,071,2135413,327486,322893,10111,333004,5342
2021-08-27,San Diego,073,3302833,335562,330162,19656,349818,3877
2021-08-27,San Francisco,075,870044,47778,46456,1984,48440,581
2021-08-27,San Joaquin,077,732212,87854,84949,4604,89553,1524
2021-08-27,San Luis Obispo,079,281455,25829,24952,983,25935,280
2021-08-27,San Mateo,081,765935,49778,48424,724,49148,553
2021-08-27,Santa Barbara,083,443738,39678,38675,1365,40040,480
2021-08-27,Santa Clara,085,1922200,135356,132011,1014,133025,1783
2021-08-27,Santa Cruz,087,273765,18564,18163,935,19098,210
2021-08-27,Shasta,089,179085,15652,14996,2278,17274,217
2021-08-27,Sierra,091,2930,111,91,13,104,0
2021-08-27,Siskiyou,093,43540,2534,2358,727,3085,33
2021-08-27,Solano,095,438530,41582,39347,1034,40381,287
2021-08-27,Sonoma,097,501317,37513,36326,453,36779,342
2021-08-27,Stanislaus,099,539301,66860,65167,7512,72679,1061
2021-08-27,Sutter,101,95872,11902,11590,151,11741,135
2021-08-27,Tehama,103,63373,6228,5964,864,6828,71
2021-08-27,Trinity,105,12862,625,458,159,617,3
2021-08-27,Tulare,107,460477,56515,54443,11331,65774,870
2021-08-27,Tuolumne,109,53932,5514,5438,59,5497,74
2021-08-27,Ventura,111,848112,90954,89774,3945,93719,1076
2021-08-27,Yolo,113,214977,17343,16805,809,17614,231
2021-08-27,Yuba,115,75493,8272,7926,181,8107,54
2021-08-26,Alameda,001,1643700,109019,106146,2488,108634,1296
2021-08-26,Alpine,003,1148,91,92,0,92,0
2021-08-26,Amador,005,37829,4576,4442,41,4483,53
2021-08-26,Butte,007,227075,15964,15159,2665,17824,214
2021-08-26,Calaveras,009,45235,3016,2873,19,2892,59
2021-08-26,Colusa,011,21464,2288,2234,487,2721,16
2021-08-26,Contra Costa,013,1133247,89622,85808,1782,87590,866
2021-08-26,Del Norte,015,27424,2868,2625,16,2641,8
2021-08-26,El Dorado,017,186661,13606,12863,1236,14099,118
2021-08-26,Fresno,019,978130,117410,113854,10364,124218,1770
2021-08-26,Glenn,021,27897,2858,2740,782,3522,20
2021-08-26,Humboldt,023,135768,7057,6695,225,6920,53
2021-08-26,Imperial,025,180216,30453,30121,2889,33010,748
2021-08-26,Inyo,027,18085,1542,1521,14,1535,39
2021-08-26,Kern,029,883053,108769,106051,14952,121003,1380
2021-08-26,Kings,031,150075,26669,25838,1425,27263,260
2021-08-26,Lake,033,64148,5400,5196,59,5255,74
2021-08-26,Lassen,035,31185,5762,5626,154,5780,21
2021-08-26,Los Angeles,037,10098052,1351591,1334372,49890,1384262,25199
2021-08-26,Madera,039,155013,19018,18393,1363,19756,247
2021-08-26,Marin,041,260295,16285,15983,354,16337,240
2021-08-26,Mariposa,043,17540,736,677,19,696,5
2021-08-26,Mendocino,045,87422,5835,5533,204,5737,55
2021-08-26,Merced,047,269075,35484,34755,1334,36089,495
2021-08-26,Modoc,049,8938,448,433,155,588,5
2021-08-26,Mono,051,14174,1404,1385,18,1403,3
2021-08-26,Monterey,053,433212,45916,45265,2337,47602,539
2021-08-26,Napa,055,140530,11609,11394,72,11466,87
2021-08-26,Nevada,057,99092,7491,7086,248,7334,80
2021-08-26,Orange,059,3164182,287020,282814,13372,296186,5200
2021-08-26,Placer,061,380077,30876,28898,2686,31584,319
2021-08-26,Plumas,063,18699,1032,971,16,987,5
2021-08-26,Riverside,065,2383286,331427,324486,15437,339923,4615
2021-08-26,Sacramento,067,1510023,136584,130977,2969,133946,1827
2021-08-26,San Benito,069,59416,6698,6604,133,6737,64
2021-08-26,San Bernardino,071,2135413,326828,322100,10087,332187,5339
2021-08-26,San Diego,073,3302833,334535,328276,19590,347866,3869
2021-08-26,San Francisco,075,870044,47651,46288,1979,48267,581
2021-08-26,San Joaquin,077,732212,87476,84429,4582,89011,1513
2021-08-26,San Luis Obispo,079,281455,25680,24831,976,25807,278
2021-08-26,San Mateo,081,765935,49650,48263,722,48985,553
2021-08-26,Santa Barbara,083,443738,39594,38566,1364,39930,479
2021-08-26,Santa Clara,085,1922200,135030,131443,1010,132453,1782
2021-08-26,Santa Cruz,087,273765,18504,18072,933,19005,210
2021-08-26,Shasta,089,179085,15530,14891,2250,17141,217
2021-08-26,Sierra,091,2930,109,90,13,103,0
2021-08-26,Siskiyou,093,43540,2512,2342,714,3056,33
2021-08-26,Solano,095,438530,41433,39027,1026,40053,286
2021-08-26,Sonoma,097,501317,37424,36102,453,36555,337
2021-08-26,Stanislaus,099,539301,66562,64785,7471,72256,1061
2021-08-26,Sutter,101,95872,11842,11499,148,11647,135
2021-08-26,Tehama,103,63373,6170,5913,851,6764,68
2021-08-26,Trinity,105,12862,620,450,157,607,3
2021-08-26,Tulare,107,460477,56258,54157,11285,65442,870
2021-08-26,Tuolumne,109,53932,5494,5387,59,5446,74
2021-08-26,Ventura,111,848112,90768,89595,3936,93531,1080
2021-08-26,Yolo,113,214977,17279,16727,798,17525,231
2021-08-26,Yuba,115,75493,8199,7834,179,8013,54
2021-08-25,Alameda,001,1643700,108695,105636,2481,108117,1296
2021-08-25,Alpine,003,1148,91,92,0,92,0
2021-08-25,Amador,005,37829,4561,4415,41,4456,53
2021-08-25,Butte,007,227075,15857,15039,2623,17662,214
2021-08-25,Calaveras,009,45235,2997,2851,19,2870,59
2021-08-25,Colusa,011,21464,2281,2227,478,2705,16
2021-08-25,Contra Costa,013,1133247,89238,85322,1776,87098,863
2021-08-25,Del Norte,015,27424,2823,2573,16,2589,8
2021-08-25,El Dorado,017,186661,13547,12787,1220,14007,118
2021-08-25,Fresno,019,978130,116869,113384,10322,123706,1761
2021-08-25,Glenn,021,27897,2840,2728,767,3495,20
2021-08-25,Humboldt,023,135768,6988,6653,215,6868,52
2021-08-25,Imperial,025,180216,30416,30085,2883,32968,748
2021-08-25,Inyo,027,18085,1538,1518,14,1532,39
2021-08-25,Kern,029,883053,108338,105687,14796,120483,1379
2021-08-25,Kings,031,150075,26562,25676,1418,27094,258
2021-08-25,Lake,033,64148,5370,5163,56,5219,74
2021-08-25,Lassen,035,31185,5745,5583,153,5736,21
2021-08-25,Los Angeles,037,10098052,1348987,1331400,49792,1381192,25170
2021-08-25,Madera,039,155013,18954,18311,1340,19651,247
2021-08-25,Marin,041,260295,16263,15938,348,16286,240
2021-08-25,Mariposa,043,17540,730,676,19,695,5
2021-08-25,Mendocino,045,87422,5800,5486,198,5684,53
2021-08-25,Merced,047,269075,35352,34600,1321,35921,492
2021-08-25,Modoc,049,8938,448,433,155,588,5
2021-08-25,Mono,051,14174,1400,1382,18,1400,3
2021-08-25,Monterey,053,433212,45842,45196,2322,47518,539
2021-08-25,Napa,055,140530,11575,11348,71,11419,87
2021-08-25,Nevada,057,99092,7425,7000,247,7247,77
2021-08-25,Orange,059,3164182,286494,282061,13338,295399,5193
2021-08-25,Placer,061,380077,30700,28740,2654,31394,319
2021-08-25,Plumas,063,18699,1017,962,16,978,5
2021-08-25,Riverside,065,2383286,330582,323548,15415,338963,4610
2021-08-25,Sacramento,067,1510023,135904,130046,2930,132976,1827
2021-08-25,San Benito,069,59416,6677,6587,132,6719,64
2021-08-25,San Bernardino,071,2135413,326134,321228,10066,331294,5337
2021-08-25,San Diego,073,3302833,333267,327166,19505,346671,3859
2021-08-25,San Francisco,075,870044,47502,46107,1974,48081,578
2021-08-25,San Joaquin,077,732212,87091,84002,4566,88568,1510
2021-08-25,San Luis Obispo,079,281455,25488,24607,972,25579,276
2021-08-25,San Mateo,081,765935,49527,48153,719,48872,553
2021-08-25,Santa Barbara,083,443738,39465,38450,1364,39814,479
2021-08-25,Santa Clara,085,1922200,134661,130995,1007,132002,1783
2021-08-25,Santa Cruz,087,273765,18444,17987,930,18917,210
2021-08-25,Shasta,089,179085,15403,14752,2218,16970,217
2021-08-25,Sierra,091,2930,106,90,13,103,0
2021-08-25,Siskiyou,093,43540,2467,2322,695,3017,33
2021-08-25,Solano,095,438530,41262,38848,1014,39862,286
2021-08-25,Sonoma,097,501317,37300,35986,450,36436,336
2021-08-25,Stanislaus,099,539301,66281,64441,7439,71880,1061
2021-08-25,Sutter,101,95872,11774,11451,144,11595,134
2021-08-25,Tehama,103,63373,6111,5861,834,6695,68
2021-08-25,Trinity,105,12862,614,450,156,606,3
2021-08-25,Tulare,107,460477,55974,53877,11214,65091,866
2021-08-25,Tuolumne,109,53932,5468,5354,59,5413,74
2021-08-25,Ventura,111,848112,90584,89379,3922,93301,1068
2021-08-25,Yolo,113,214977,17214,16667,788,17455,231
2021-08-25,Yuba,115,75493,8133,7771,178,7949,54
2021-08-24,Alameda,001,1643700,108378,105319,2469,107788,1296
2021-08-24,Alpine,003,1148,91,92,0,92,0
2021-08-24,Amador,005,37829,4542,4380,41,4421,50
2021-08-24,Butte,007,227075,15702,14964,2589,17553,214
2021-08-24,Calaveras,009,45235,2958,2811,19,2830,59
2021-08-24,Colusa,011,21464,2273,2221,473,2694,16
2021-08-24,Contra Costa,013,1133247,88875,84963,1770,86733,857
2021-08-24,Del Norte,015,27424,2796,2543,16,2559,8
2021-08-24,El Dorado,017,186661,13470,12732,1204,13936,118
2021-08-24,Fresno,019,978130,116263,113024,10258,123282,1761
2021-08-24,Glenn,021,27897,2824,2717,760,3477,20
2021-08-24,Humboldt,023,135768,6925,6585,202,6787,52
2021-08-24,Imperial,025,180216,30355,30045,2877,32922,748
2021-08-24,Inyo,027,18085,1533,1512,14,1526,39
2021-08-24,Kern,029,883053,107874,105399,14628,120027,1375
2021-08-24,Kings,031,150075,26441,25629,1402,27031,258
2021-08-24,Lake,033,64148,5335,5135,56,5191,72
2021-08-24,Lassen,035,31185,5729,5576,151,5727,21
2021-08-24,Los Angeles,037,10098052,1346119,1328777,49683,1378460,25135
2021-08-24,Madera,039,155013,18878,18251,1323,19574,247
2021-08-24,Marin,041,260295,16227,15900,344,16244,240
2021-08-24,Mariposa,043,17540,723,670,19,689,5
2021-08-24,Mendocino,045,87422,5757,5416,191,5607,52
2021-08-24,Merced,047,269075,35184,34490,1310,35800,491
2021-08-24,Modoc,049,8938,448,432,155,587,5
2021-08-24,Mono,051,14174,1398,1382,18,1400,3
2021-08-24,Monterey,053,433212,45776,45126,2304,47430,539
2021-08-24,Napa,055,140530,11542,11299,70,11369,85
2021-08-24,Nevada,057,99092,7355,6981,245,7226,77
2021-08-24,Orange,059,3164182,285895,281461,13312,294773,5187
2021-08-24,Placer,061,380077,30497,28618,2615,31233,318
2021-08-24,Plumas,063,18699,1007,953,16,969,5
2021-08-24,Riverside,065,2383286,329709,322620,15384,338004,4605
2021-08-24,Sacramento,067,1510023,135220,129542,2882,132424,1812
2021-08-24,San Benito,069,59416,6664,6576,132,6708,64
2021-08-24,San Bernardino,071,2135413,325379,320300,10036,330336,5328
2021-08-24,San Diego,073,3302833,331824,325823,19396,345219,3851
2021-08-24,San Francisco,075,870044,47327,46010,1963,47973,574
2021-08-24,San Joaquin,077,732212,86651,83684,4528,88212,1508
2021-08-24,San Luis Obispo,079,281455,25311,24443,961,25404,274
2021-08-24,San Mateo,081,765935,49378,48050,717,48767,553
2021-08-24,Santa Barbara,083,443738,39334,38307,1363,39670,478
2021-08-24,Santa Clara,085,1922200,134237,130763,1003,131766,1779
2021-08-24,Santa Cruz,087,273765,18369,17928,924,18852,209
2021-08-24,Shasta,089,179085,15295,14664,2186,16850,217
2021-08-24,Sierra,091,2930,103,90,13,103,0
2021-08-24,Siskiyou,093,43540,2445,2294,680,2974,33
2021-08-24,Solano,095,438530,41053,38724,1002,39726,283
2021-08-24,Sonoma,097,501317,37172,35849,448,36297,336
2021-08-24,Stanislaus,099,539301,65952,64195,7385,71580,1058
2021-08-24,Sutter,101,95872,11707,11384,141,11525,134
2021-08-24,Tehama,103,63373,6065,5826,820,6646,67
2021-08-24,Trinity,105,12862,603,446,148,594,3
2021-08-24,Tulare,107,460477,55622,53702,11124,64826,856
2021-08-24,Tuolumne,109,53932,5437,5287,59,5346,74
2021-08-24,Ventura,111,848112,90400,89167,3911,93078,1068
2021-08-24,Yolo,113,214977,17137,16492,775,17267,231
2021-08-24,Yuba,115,75493,8050,7723,176,7899,54
2021-08-23,Alameda,001,1643700,107965,104922,2456,107378,1294
2021-08-23,Alpine,003,1148,91,91,0,91,0
2021-08-23,Amador,005,37829,4528,4369,41,4410,50
2021-08-23,Butte,007,227075,15557,14847,2552,17399,211
2021-08-23,Calaveras,009,45235,2931,2803,19,2822,59
2021-08-23,Colusa,011,21464,2269,2206,470,2676,16
2021-08-23,Contra Costa,013,1133247,88496,84651,1763,86414,857
2021-08-23,Del Norte,015,27424,2750,2499,16,2515,8
2021-08-23,El Dorado,017,186661,13367,12684,1182,13866,118
2021-08-23,Fresno,019,978130,115701,112445,10208,122653,1759
2021-08-23,Glenn,021,27897,2808,2696,750,3446,20
2021-08-23,Humboldt,023,135768,6852,6498,188,6686,52
2021-08-23,Imperial,025,180216,30304,30011,2874,32885,748
2021-08-23,Inyo,027,18085,1526,1509,14,1523,39
2021-08-23,Kern,029,883053,107419,104995,14473,119468,1375
2021-08-23,Kings,031,150075,26310,25465,1396,26861,257
2021-08-23,Lake,033,64148,5295,5099,54,5153,69
2021-08-23,Lassen,035,31185,5717,5562,151,5713,21
2021-08-23,Los Angeles,037,10098052,1343152,1326412,49552,1375964,25096
2021-08-23,Madera,039,155013,18792,18155,1308,19463,246
2021-08-23,Marin,041,260295,16179,15856,340,16196,240
2021-08-23,Mariposa,043,17540,712,645,19,664,5
2021-08-23,Mendocino,045,87422,5690,5374,184,5558,51
2021-08-23,Merced,047,269075,35002,34322,1305,35627,488
2021-08-23,Modoc,049,8938,445,431,154,585,6
2021-08-23,Mono,051,14174,1394,1384,18,1402,3
2021-08-23,Monterey,053,433212,45676,45047,2293,47340,538
2021-08-23,Napa,055,140530,11504,11257,70,11327,85
2021-08-23,Nevada,057,99092,7274,6930,243,7173,77
2021-08-23,Orange,059,3164182,285262,280891,13277,294168,5181
2021-08-23,Placer,061,380077,30297,28540,2577,31117,314
2021-08-23,Plumas,063,18699,999,934,16,950,5
2021-08-23,Riverside,065,2383286,328796,321650,15358,337008,4598
2021-08-23,Sacramento,067,1510023,134433,128969,2815,131784,1807
2021-08-23,San Benito,069,59416,6646,6562,130,6692,64
2021-08-23,San Bernardino,071,2135413,324573,319577,9997,329574,5324
2021-08-23,San Diego,073,3302833,330391,324536,19273,343809,3848
2021-08-23,San Francisco,075,870044,47172,45945,1954,47899,573
2021-08-23,San Joaquin,077,732212,86218,83466,4495,87961,1499
2021-08-23,San Luis Obispo,079,281455,25129,24317,959,25276,274
2021-08-23,San Mateo,081,765935,49240,47935,714,48649,553
2021-08-23,Santa Barbara,083,443738,39155,38181,1361,39542,478
2021-08-23,Santa Clara,085,1922200,133837,130489,999,131488,1778
2021-08-23,Santa Cruz,087,273765,18312,17871,922,18793,209
2021-08-23,Shasta,089,179085,15168,14537,2147,16684,216
2021-08-23,Sierra,091,2930,103,90,13,103,0
2021-08-23,Siskiyou,093,43540,2424,2274,659,2933,33
2021-08-23,Solano,095,438530,40900,38612,993,39605,283
2021-08-23,Sonoma,097,501317,37052,35769,447,36216,336
2021-08-23,Stanislaus,099,539301,65617,63922,7346,71268,1058
2021-08-23,Sutter,101,95872,11618,11314,133,11447,133
2021-08-23,Tehama,103,63373,6011,5805,802,6607,67
2021-08-23,Trinity,105,12862,600,435,145,580,3
2021-08-23,Tulare,107,460477,55315,53370,11052,64422,856
2021-08-23,Tuolumne,109,53932,5395,5240,59,5299,73
2021-08-23,Ventura,111,848112,90181,88960,3899,92859,1063
2021-08-23,Yolo,113,214977,17049,16445,760,17205,226
2021-08-23,Yuba,115,75493,7979,7653,174,7827,54
2021-08-22,Alameda,001,1643700,107517,104539,2428,106967,1294
2021-08-22,Alpine,003,1148,91,91,0,91,0
2021-08-22,Amador,005,37829,4498,4349,41,4390,50
2021-08-22,Butte,007,227075,15417,14791,2516,17307,211
2021-08-22,Calaveras,009,45235,2893,2771,19,2790,59
2021-08-22,Colusa,011,21464,2262,2201,464,2665,16
2021-08-22,Contra Costa,013,1133247,87955,84371,1750,86121,857
2021-08-22,Del Norte,015,27424,2690,2455,16,2471,8
2021-08-22,El Dorado,017,186661,13263,12629,1161,13790,118
2021-08-22,Fresno,019,978130,115102,112057,10139,122196,1759
2021-08-22,Glenn,021,27897,2780,2678,737,3415,20
2021-08-22,Humboldt,023,135768,6774,6483,170,6653,52
2021-08-22,Imperial,025,180216,30246,29993,2869,32862,748
2021-08-22,Inyo,027,18085,1520,1505,14,1519,39
2021-08-22,Kern,029,883053,106893,104691,14319,119010,1375
2021-08-22,Kings,031,150075,26152,25391,1379,26770,257
2021-08-22,Lake,033,64148,5250,5069,51,5120,69
2021-08-22,Lassen,035,31185,5685,5556,147,5703,21
2021-08-22,Los Angeles,037,10098052,1339844,1324151,49417,1373568,25089
2021-08-22,Madera,039,155013,18673,18120,1293,19413,246
2021-08-22,Marin,041,260295,16127,15822,332,16154,240
2021-08-22,Mariposa,043,17540,702,638,17,655,5
2021-08-22,Mendocino,045,87422,5631,5336,184,5520,51
2021-08-22,Merced,047,269075,34799,34234,1292,35526,488
2021-08-22,Modoc,049,8938,443,431,154,585,6
2021-08-22,Mono,051,14174,1392,1378,18,1396,3
2021-08-22,Monterey,053,433212,45577,45017,2279,47296,538
2021-08-22,Napa,055,140530,11459,11231,70,11301,85
2021-08-22,Nevada,057,99092,7200,6864,241,7105,77
2021-08-22,Orange,059,3164182,284568,280390,13232,293622,5181
2021-08-22,Placer,061,380077,30088,28395,2541,30936,314
2021-08-22,Plumas,063,18699,981,923,15,938,5
2021-08-22,Riverside,065,2383286,327775,320836,15310,336146,4594
2021-08-22,Sacramento,067,1510023,133657,128231,2775,131006,1802
2021-08-22,San Benito,069,59416,6630,6550,130,6680,64
2021-08-22,San Bernardino,071,2135413,323605,318839,9962,328801,5324
2021-08-22,San Diego,073,3302833,329070,323591,19167,342758,3848
2021-08-22,San Francisco,075,870044,47006,45831,1944,47775,573
2021-08-22,San Joaquin,077,732212,85758,83121,4460,87581,1498
2021-08-22,San Luis Obispo,079,281455,24923,24250,952,25202,274
2021-08-22,San Mateo,081,765935,49064,47821,709,48530,553
2021-08-22,Santa Barbara,083,443738,38974,38099,1353,39452,478
2021-08-22,Santa Clara,085,1922200,133420,130189,992,131181,1778
2021-08-22,Santa Cruz,087,273765,18254,17823,917,18740,209
2021-08-22,Shasta,089,179085,15031,14478,2111,16589,216
2021-08-22,Sierra,091,2930,103,87,13,100,0
2021-08-22,Siskiyou,093,43540,2395,2261,641,2902,33
2021-08-22,Solano,095,438530,40702,38489,980,39469,283
2021-08-22,Sonoma,097,501317,36896,35676,444,36120,336
2021-08-22,Stanislaus,099,539301,65265,63683,7256,70939,1058
2021-08-22,Sutter,101,95872,11536,11251,129,11380,133
2021-08-22,Tehama,103,63373,5965,5791,783,6574,67
2021-08-22,Trinity,105,12862,593,433,143,576,3
2021-08-22,Tulare,107,460477,54996,53220,10967,64187,856
2021-08-22,Tuolumne,109,53932,5352,5214,59,5273,73
2021-08-22,Ventura,111,848112,89972,88791,3882,92673,1063
2021-08-22,Yolo,113,214977,16946,16374,751,17125,226
2021-08-22,Yuba,115,75493,7906,7626,173,7799,54
2021-08-21,Alameda,001,1643700,107313,104281,2421,106702,1294
2021-08-21,Alpine,003,1148,91,91,0,91,0
2021-08-21,Amador,005,37829,4488,4338,39,4377,50
2021-08-21,Butte,007,227075,15349,14714,2496,17210,211
2021-08-21,Calaveras,009,45235,2877,2744,19,2763,59
2021-08-21,Colusa,011,21464,2256,2192,460,2652,16
2021-08-21,Contra Costa,013,1133247,87696,84136,1742,85878,857
2021-08-21,Del Norte,015,27424,2667,2409,16,2425,8
2021-08-21,El Dorado,017,186661,13219,12590,1157,13747,118
2021-08-21,Fresno,019,978130,114902,111765,10126,121891,1759
2021-08-21,Glenn,021,27897,2767,2654,729,3383,20
2021-08-21,Humboldt,023,135768,6736,6446,164,6610,52
2021-08-21,Imperial,025,180216,30203,29976,2866,32842,748
2021-08-21,Inyo,027,18085,1517,1500,14,1514,39
2021-08-21,Kern,029,883053,106638,104443,14195,118638,1375
2021-08-21,Kings,031,150075,26081,25313,1374,26687,257
2021-08-21,Lake,033,64148,5230,5055,49,5104,69
2021-08-21,Lassen,035,31185,5671,5553,147,5700,21
2021-08-21,Los Angeles,037,10098052,1338544,1321308,49323,1370631,25080
2021-08-21,Madera,039,155013,18635,18067,1287,19354,246
2021-08-21,Marin,041,260295,16093,15775,330,16105,240
2021-08-21,Mariposa,043,17540,692,634,17,651,5
2021-08-21,Mendocino,045,87422,5585,5307,183,5490,51
2021-08-21,Merced,047,269075,34694,34148,1287,35435,488
2021-08-21,Modoc,049,8938,443,430,154,584,6
2021-08-21,Mono,051,14174,1392,1378,18,1396,3
2021-08-21,Monterey,053,433212,45530,44969,2272,47241,538
2021-08-21,Napa,055,140530,11424,11211,70,11281,85
2021-08-21,Nevada,057,99092,7156,6810,239,7049,77
2021-08-21,Orange,059,3164182,284116,279855,13198,293053,5181
2021-08-21,Placer,061,380077,29950,28289,2516,30805,314
2021-08-21,Plumas,063,18699,977,916,14,930,5
2021-08-21,Riverside,065,2383286,327195,320086,15297,335383,4594
2021-08-21,Sacramento,067,1510023,133162,127751,2764,130515,1809
2021-08-21,San Benito,069,59416,6620,6542,129,6671,64
2021-08-21,San Bernardino,071,2135413,323154,318293,9941,328234,5324
2021-08-21,San Diego,073,3302833,328414,322620,19118,341738,3848
2021-08-21,San Francisco,075,870044,46904,45637,1937,47574,573
2021-08-21,San Joaquin,077,732212,85541,82825,4446,87271,1498
2021-08-21,San Luis Obispo,079,281455,24865,24169,952,25121,273
2021-08-21,San Mateo,081,765935,48969,47685,709,48394,553
2021-08-21,Santa Barbara,083,443738,38892,37951,1349,39300,478
2021-08-21,Santa Clara,085,1922200,133155,129911,988,130899,1778
2021-08-21,Santa Cruz,087,273765,18217,17763,912,18675,209
2021-08-21,Shasta,089,179085,14957,14417,2097,16514,217
2021-08-21,Sierra,091,2930,98,85,13,98,0
2021-08-21,Siskiyou,093,43540,2381,2246,630,2876,33
2021-08-21,Solano,095,438530,40591,38423,970,39393,281
2021-08-21,Sonoma,097,501317,36809,35582,443,36025,336
2021-08-21,Stanislaus,099,539301,65083,63512,7238,70750,1058
2021-08-21,Sutter,101,95872,11491,11204,127,11331,133
2021-08-21,Tehama,103,63373,5940,5757,776,6533,67
2021-08-21,Trinity,105,12862,588,431,141,572,3
2021-08-21,Tulare,107,460477,54853,53045,10923,63968,857
2021-08-21,Tuolumne,109,53932,5321,5193,59,5252,73
2021-08-21,Ventura,111,848112,89827,88558,3867,92425,1063
2021-08-21,Yolo,113,214977,16899,16322,745,17067,226
2021-08-21,Yuba,115,75493,7860,7580,172,7752,54
2021-08-20,Alameda,001,1643700,107073,103812,2413,106225,1294
2021-08-20,Alpine,003,1148,91,91,0,91,0
2021-08-20,Amador,005,37829,4462,4323,39,4362,50
2021-08-20,Butte,007,227075,15276,14617,2475,17092,211
2021-08-20,Calaveras,009,45235,2857,2717,19,2736,59
2021-08-20,Colusa,011,21464,2251,2178,458,2636,16
2021-08-20,Contra Costa,013,1133247,87421,83721,1735,85456,857
2021-08-20,Del Norte,015,27424,2635,2316,16,2332,8
2021-08-20,El Dorado,017,186661,13181,12495,1149,13644,118
2021-08-20,Fresno,019,978130,114546,111315,10092,121407,1759
2021-08-20,Glenn,021,27897,2760,2642,719,3361,20
2021-08-20,Humboldt,023,135768,6684,6349,159,6508,52
2021-08-20,Imperial,025,180216,30180,29934,2866,32800,747
2021-08-20,Inyo,027,18085,1511,1495,14,1509,39
2021-08-20,Kern,029,883053,106354,104048,14067,118115,1373
2021-08-20,Kings,031,150075,26015,25241,1372,26613,256
2021-08-20,Lake,033,64148,5215,5024,46,5070,69
2021-08-20,Lassen,035,31185,5651,5539,147,5686,21
2021-08-20,Los Angeles,037,10098052,1336663,1317541,49222,1366763,25049
2021-08-20,Madera,039,155013,18586,18018,1272,19290,246
2021-08-20,Marin,041,260295,16075,15727,326,16053,240
2021-08-20,Mariposa,043,17540,687,630,17,647,5
2021-08-20,Mendocino,045,87422,5539,5241,182,5423,51
2021-08-20,Merced,047,269075,34630,34035,1277,35312,486
2021-08-20,Modoc,049,8938,443,429,154,583,6
2021-08-20,Mono,051,14174,1391,1368,18,1386,3
2021-08-20,Monterey,053,433212,45492,44890,2265,47155,538
2021-08-20,Napa,055,140530,11392,11152,70,11222,83
2021-08-20,Nevada,057,99092,7114,6753,233,6986,77
2021-08-20,Orange,059,3164182,283671,279193,13177,292370,5179
2021-08-20,Placer,061,380077,29855,28156,2487,30643,313
2021-08-20,Plumas,063,18699,967,908,14,922,5
2021-08-20,Riverside,065,2383286,326499,319072,15266,334338,4594
2021-08-20,Sacramento,067,1510023,132686,127226,2747,129973,1797
2021-08-20,San Benito,069,59416,6606,6508,129,6637,64
2021-08-20,San Bernardino,071,2135413,322541,317372,9912,327284,5322
2021-08-20,San Diego,073,3302833,327505,321102,19048,340150,3846
2021-08-20,San Francisco,075,870044,46807,45432,1922,47354,573
2021-08-20,San Joaquin,077,732212,85311,82419,4428,86847,1496
2021-08-20,San Luis Obispo,079,281455,24787,23986,948,24934,273
2021-08-20,San Mateo,081,765935,48856,47561,706,48267,551
2021-08-20,Santa Barbara,083,443738,38807,37794,1344,39138,477
2021-08-20,Santa Clara,085,1922200,132872,129510,983,130493,1774
2021-08-20,Santa Cruz,087,273765,18177,17701,909,18610,209
2021-08-20,Shasta,089,179085,14877,14277,2078,16355,215
2021-08-20,Sierra,091,2930,97,83,13,96,0
2021-08-20,Siskiyou,093,43540,2365,2226,625,2851,33
2021-08-20,Solano,095,438530,40451,38214,959,39173,277
2021-08-20,Sonoma,097,501317,36741,35416,442,35858,336
2021-08-20,Stanislaus,099,539301,64894,63219,7214,70433,1047
2021-08-20,Sutter,101,95872,11435,11136,126,11262,133
2021-08-20,Tehama,103,63373,5924,5730,764,6494,66
2021-08-20,Trinity,105,12862,588,422,140,562,3
2021-08-20,Tulare,107,460477,54723,52855,10880,63735,856
2021-08-20,Tuolumne,109,53932,5297,5153,58,5211,73
2021-08-20,Ventura,111,848112,89659,88285,3864,92149,1061
2021-08-20,Yolo,113,214977,16845,16236,739,16975,225
2021-08-20,Yuba,115,75493,7819,7523,172,7695,54
2021-08-19,Alameda,001,1643700,106623,103276,2391,105667,1294
2021-08-19,Alpine,003,1148,91,91,0,91,0
2021-08-19,Amador,005,37829,4455,4317,39,4356,50
2021-08-19,Butte,007,227075,15142,14518,2446,16964,211
2021-08-19,Calaveras,009,45235,2835,2673,19,2692,59
2021-08-19,Colusa,011,21464,2242,2167,453,2620,16
2021-08-19,Contra Costa,013,1133247,86983,83296,1721,85017,852
2021-08-19,Del Norte,015,27424,2585,2257,16,2273,8
2021-08-19,El Dorado,017,186661,13095,12410,1130,13540,118
2021-08-19,Fresno,019,978130,114107,110947,10038,120985,1759
2021-08-19,Glenn,021,27897,2742,2629,712,3341,20
2021-08-19,Humboldt,023,135768,6623,6246,153,6399,52
2021-08-19,Imperial,025,180216,30134,29865,2861,32726,747
2021-08-19,Inyo,027,18085,1504,1494,14,1508,39
2021-08-19,Kern,029,883053,105958,103731,13926,117657,1371
2021-08-19,Kings,031,150075,25884,25128,1360,26488,256
2021-08-19,Lake,033,64148,5183,4991,42,5033,69
2021-08-19,Lassen,035,31185,5633,5520,146,5666,21
2021-08-19,Los Angeles,037,10098052,1333681,1314453,49079,1363532,25020
2021-08-19,Madera,039,155013,18524,17947,1257,19204,246
2021-08-19,Marin,041,260295,16042,15672,323,15995,240
2021-08-19,Mariposa,043,17540,672,618,17,635,5
2021-08-19,Mendocino,045,87422,5506,5167,179,5346,51
2021-08-19,Merced,047,269075,34495,33851,1264,35115,486
2021-08-19,Modoc,049,8938,443,427,154,581,6
2021-08-19,Mono,051,14174,1387,1349,18,1367,3
2021-08-19,Monterey,053,433212,45419,44821,2255,47076,538
2021-08-19,Napa,055,140530,11340,11104,70,11174,83
2021-08-19,Nevada,057,99092,7050,6695,231,6926,77
2021-08-19,Orange,059,3164182,283035,278562,13126,291688,5172
2021-08-19,Placer,061,380077,29675,27953,2469,30422,313
2021-08-19,Plumas,063,18699,954,896,14,910,5
2021-08-19,Riverside,065,2383286,325471,318056,15237,333293,4589
2021-08-19,Sacramento,067,1510023,131982,126720,2712,129432,1801
2021-08-19,San Benito,069,59416,6588,6493,128,6621,64
2021-08-19,San Bernardino,071,2135413,321718,316398,9889,326287,5318
2021-08-19,San Diego,073,3302833,326254,319582,18950,338532,3839
2021-08-19,San Francisco,075,870044,46644,45220,1909,47129,571
2021-08-19,San Joaquin,077,732212,84866,82047,4377,86424,1491
2021-08-19,San Luis Obispo,079,281455,24649,23878,941,24819,271
2021-08-19,San Mateo,081,765935,48724,47431,704,48135,551
2021-08-19,Santa Barbara,083,443738,38662,37693,1341,39034,477
2021-08-19,Santa Clara,085,1922200,132482,129133,976,130109,1774
2021-08-19,Santa Cruz,087,273765,18114,17644,902,18546,209
2021-08-19,Shasta,089,179085,14753,14200,2055,16255,214
2021-08-19,Sierra,091,2930,93,83,13,96,0
2021-08-19,Siskiyou,093,43540,2350,2218,613,2831,33
2021-08-19,Solano,095,438530,40293,38025,947,38972,273
2021-08-19,Sonoma,097,501317,36653,35233,441,35674,336
2021-08-19,Stanislaus,099,539301,64552,62928,7170,70098,1047
2021-08-19,Sutter,101,95872,11350,11057,125,11182,133
2021-08-19,Tehama,103,63373,5888,5683,737,6420,66
2021-08-19,Trinity,105,12862,584,414,138,552,3
2021-08-19,Tulare,107,460477,54491,52685,10816,63501,856
2021-08-19,Tuolumne,109,53932,5261,5112,57,5169,64
2021-08-19,Ventura,111,848112,89456,88073,3849,91922,1060
2021-08-19,Yolo,113,214977,16760,16153,731,16884,225
2021-08-19,Yuba,115,75493,7766,7458,171,7629,51
2021-08-18,Alameda,001,1643700,106209,102696,2369,105065,1294
2021-08-18,Alpine,003,1148,90,91,0,91,0
2021-08-18,Amador,005,37829,4438,4279,38,4317,50
2021-08-18,Butte,007,227075,15032,14426,2419,16845,208
2021-08-18,Calaveras,009,45235,2798,2643,18,2661,59
2021-08-18,Colusa,011,21464,2234,2160,449,2609,16
2021-08-18,Contra Costa,013,1133247,86482,82767,1715,84482,851
2021-08-18,Del Norte,015,27424,2528,2219,16,2235,8
2021-08-18,El Dorado,017,186661,13005,12306,1116,13422,118
2021-08-18,Fresno,019,978130,113653,110523,9975,120498,1759
2021-08-18,Glenn,021,27897,2710,2623,704,3327,20
2021-08-18,Humboldt,023,135768,6552,6195,148,6343,52
2021-08-18,Imperial,025,180216,30101,29821,2859,32680,746
2021-08-18,Inyo,027,18085,1501,1494,14,1508,39
2021-08-18,Kern,029,883053,105611,103440,13831,117271,1370
2021-08-18,Kings,031,150075,25775,24984,1352,26336,256
2021-08-18,Lake,033,64148,5142,4957,41,4998,69
2021-08-18,Lassen,035,31185,5614,5506,145,5651,21
2021-08-18,Los Angeles,037,10098052,1330530,1311477,48947,1360424,24984
2021-08-18,Madera,039,155013,18464,17871,1244,19115,246
2021-08-18,Marin,041,260295,16004,15610,320,15930,240
2021-08-18,Mariposa,043,17540,659,615,16,631,5
2021-08-18,Mendocino,045,87422,5455,5129,177,5306,51
2021-08-18,Merced,047,269075,34330,33708,1253,34961,484
2021-08-18,Modoc,049,8938,443,427,153,580,6
2021-08-18,Mono,051,14174,1384,1344,18,1362,3
2021-08-18,Monterey,053,433212,45335,44735,2238,46973,532
2021-08-18,Napa,055,140530,11301,11060,69,11129,83
2021-08-18,Nevada,057,99092,6984,6633,231,6864,76
2021-08-18,Orange,059,3164182,282398,277795,13071,290866,5168
2021-08-18,Placer,061,380077,29448,27741,2441,30182,312
2021-08-18,Plumas,063,18699,945,874,14,888,5
2021-08-18,Riverside,065,2383286,324471,317107,15203,332310,4585
2021-08-18,Sacramento,067,1510023,131222,125599,2680,128279,1781
2021-08-18,San Benito,069,59416,6577,6481,127,6608,64
2021-08-18,San Bernardino,071,2135413,320918,315477,9870,325347,5304
2021-08-18,San Diego,073,3302833,324914,318152,18884,337036,3834
2021-08-18,San Francisco,075,870044,46441,44957,1899,46856,568
2021-08-18,San Joaquin,077,732212,84414,81601,4346,85947,1491
2021-08-18,San Luis Obispo,079,281455,24499,23726,928,24654,270
2021-08-18,San Mateo,081,765935,48560,47255,703,47958,551
2021-08-18,Santa Barbara,083,443738,38531,37599,1335,38934,475
2021-08-18,Santa Clara,085,1922200,132118,128563,973,129536,1773
2021-08-18,Santa Cruz,087,273765,18059,17566,898,18464,209
2021-08-18,Shasta,089,179085,14654,14087,2036,16123,213
2021-08-18,Sierra,091,2930,92,83,13,96,0
2021-08-18,Siskiyou,093,43540,2321,2204,601,2805,33
2021-08-18,Solano,095,438530,40087,37812,932,38744,271
2021-08-18,Sonoma,097,501317,36509,35063,440,35503,333
2021-08-18,Stanislaus,099,539301,64222,62613,7126,69739,1047
2021-08-18,Sutter,101,95872,11278,11004,120,11124,130
2021-08-18,Tehama,103,63373,5853,5653,727,6380,66
2021-08-18,Trinity,105,12862,577,409,135,544,3
2021-08-18,Tulare,107,460477,54251,52486,10747,63233,856
2021-08-18,Tuolumne,109,53932,5225,5081,55,5136,64
2021-08-18,Ventura,111,848112,89224,87835,3839,91674,1055
2021-08-18,Yolo,113,214977,16677,16047,712,16759,225
2021-08-18,Yuba,115,75493,7701,7391,171,7562,51
2021-08-17,Alameda,001,1643700,105809,102379,2354,104733,1290
2021-08-17,Alpine,003,1148,90,91,0,91,0
2021-08-17,Amador,005,37829,4409,4266,38,4304,50
2021-08-17,Butte,007,227075,14925,14357,2385,16742,206
2021-08-17,Calaveras,009,45235,2764,2624,18,2642,59
2021-08-17,Colusa,011,21464,2225,2156,445,2601,16
2021-08-17,Contra Costa,013,1133247,86036,82482,1704,84186,848
2021-08-17,Del Norte,015,27424,2474,2188,16,2204,8
2021-08-17,El Dorado,017,186661,12918,12242,1102,13344,118
2021-08-17,Fresno,019,978130,113169,110263,9910,120173,1755
2021-08-17,Glenn,021,27897,2696,2608,695,3303,20
2021-08-17,Humboldt,023,135768,6472,6155,146,6301,52
2021-08-17,Imperial,025,180216,30050,29768,2855,32623,746
2021-08-17,Inyo,027,18085,1498,1492,14,1506,39
2021-08-17,Kern,029,883053,105217,103048,13707,116755,1367
2021-08-17,Kings,031,150075,25669,24930,1341,26271,254
2021-08-17,Lake,033,64148,5099,4930,35,4965,68
2021-08-17,Lassen,035,31185,5597,5499,143,5642,21
2021-08-17,Los Angeles,037,10098052,1326976,1307999,48817,1356816,24952
2021-08-17,Madera,039,155013,18390,17838,1226,19064,246
2021-08-17,Marin,041,260295,15948,15570,320,15890,240
2021-08-17,Mariposa,043,17540,651,609,15,624,5
2021-08-17,Mendocino,045,87422,5400,5097,177,5274,51
2021-08-17,Merced,047,269075,34180,33508,1243,34751,482
2021-08-17,Modoc,049,8938,440,424,151,575,6
2021-08-17,Mono,051,14174,1379,1341,18,1359,3
2021-08-17,Monterey,053,433212,45251,44672,2228,46900,528
2021-08-17,Napa,055,140530,11260,11007,68,11075,83
2021-08-17,Nevada,057,99092,6909,6605,229,6834,75
2021-08-17,Orange,059,3164182,281751,277121,13035,290156,5164
2021-08-17,Placer,061,380077,29233,27634,2412,30046,312
2021-08-17,Plumas,063,18699,933,860,14,874,5
2021-08-17,Riverside,065,2383286,323459,316051,15160,331211,4582
2021-08-17,Sacramento,067,1510023,130428,125151,2637,127788,1774
2021-08-17,San Benito,069,59416,6558,6470,127,6597,64
2021-08-17,San Bernardino,071,2135413,319980,314402,9830,324232,5302
2021-08-17,San Diego,073,3302833,323304,317058,18786,335844,3824
2021-08-17,San Francisco,075,870044,46241,44820,1893,46713,567
2021-08-17,San Joaquin,077,732212,83945,81300,4313,85613,1489
2021-08-17,San Luis Obispo,079,281455,24343,23556,925,24481,268
2021-08-17,San Mateo,081,765935,48405,47127,698,47825,551
2021-08-17,Santa Barbara,083,443738,38372,37478,1328,38806,475
2021-08-17,Santa Clara,085,1922200,131715,128354,966,129320,1773
2021-08-17,Santa Cruz,087,273765,17974,17528,897,18425,209
2021-08-17,Shasta,089,179085,14523,14012,2017,16029,214
2021-08-17,Sierra,091,2930,91,82,13,95,0
2021-08-17,Siskiyou,093,43540,2305,2183,588,2771,33
2021-08-17,Solano,095,438530,39858,37662,919,38581,269
2021-08-17,Sonoma,097,501317,36361,34943,436,35379,333
2021-08-17,Stanislaus,099,539301,63882,62385,7066,69451,1047
2021-08-17,Sutter,101,95872,11206,10973,120,11093,130
2021-08-17,Tehama,103,63373,5819,5612,705,6317,66
2021-08-17,Trinity,105,12862,572,406,132,538,3
2021-08-17,Tulare,107,460477,53983,52362,10682,63044,856
2021-08-17,Tuolumne,109,53932,5182,5042,54,5096,64
2021-08-17,Ventura,111,848112,88986,87601,3818,91419,1053
2021-08-17,Yolo,113,214977,16588,15975,698,16673,225
2021-08-17,Yuba,115,75493,7630,7355,171,7526,51
2021-08-16,Alameda,001,1643700,105307,102052,2345,104397,1287
2021-08-16,Alpine,003,1148,90,91,0,91,0
2021-08-16,Amador,005,37829,4399,4235,38,4273,50
2021-08-16,Butte,007,227075,14807,14283,2350,16633,206
2021-08-16,Calaveras,009,45235,2704,2609,17,2626,57
2021-08-16,Colusa,011,21464,2214,2147,441,2588,16
2021-08-16,Contra Costa,013,1133247,85493,82070,1694,83764,848
2021-08-16,Del Norte,015,27424,2397,2125,16,2141,8
2021-08-16,El Dorado,017,186661,12817,12139,1089,13228,118
2021-08-16,Fresno,019,978130,112671,109623,9858,119481,1753
2021-08-16,Glenn,021,27897,2677,2593,689,3282,20
2021-08-16,Humboldt,023,135768,6401,6064,125,6189,52
2021-08-16,Imperial,025,180216,30009,29737,2840,32577,746
2021-08-16,Inyo,027,18085,1495,1490,14,1504,39
2021-08-16,Kern,029,883053,104842,102690,13591,116281,1367
2021-08-16,Kings,031,150075,25566,24817,1331,26148,254
2021-08-16,Lake,033,64148,5072,4898,34,4932,68
2021-08-16,Lassen,035,31185,5581,5481,135,5616,21
2021-08-16,Los Angeles,037,10098052,1323593,1305330,48672,1354002,24923
2021-08-16,Madera,039,155013,18315,17756,1205,18961,246
2021-08-16,Marin,041,260295,15889,15497,319,15816,239
2021-08-16,Mariposa,043,17540,634,597,15,612,5
2021-08-16,Mendocino,045,87422,5344,5037,175,5212,49
2021-08-16,Merced,047,269075,33979,33364,1230,34594,481
2021-08-16,Modoc,049,8938,438,421,150,571,5
2021-08-16,Mono,051,14174,1374,1339,18,1357,3
2021-08-16,Monterey,053,433212,45172,44595,2216,46811,527
2021-08-16,Napa,055,140530,11231,10946,68,11014,83
2021-08-16,Nevada,057,99092,6854,6535,228,6763,74
2021-08-16,Orange,059,3164182,280957,275985,12989,288974,5161
2021-08-16,Placer,061,380077,29050,27384,2380,29764,306
2021-08-16,Plumas,063,18699,922,851,14,865,5
2021-08-16,Riverside,065,2383286,322368,314774,15123,329897,4582
2021-08-16,Sacramento,067,1510023,129618,124554,2594,127148,1762
2021-08-16,San Benito,069,59416,6534,6452,127,6579,64
2021-08-16,San Bernardino,071,2135413,319016,313617,9803,323420,5301
2021-08-16,San Diego,073,3302833,321706,315348,18646,333994,3824
2021-08-16,San Francisco,075,870044,46037,44681,1885,46566,567
2021-08-16,San Joaquin,077,732212,83442,81087,4286,85373,1488
2021-08-16,San Luis Obispo,079,281455,24193,23452,917,24369,265
2021-08-16,San Mateo,081,765935,48222,47024,691,47715,548
2021-08-16,Santa Barbara,083,443738,38201,37358,1323,38681,475
2021-08-16,Santa Clara,085,1922200,131251,127978,962,128940,1773
2021-08-16,Santa Cruz,087,273765,17910,17491,891,18382,209
2021-08-16,Shasta,089,179085,14434,13862,2001,15863,211
2021-08-16,Sierra,091,2930,88,82,13,95,0
2021-08-16,Siskiyou,093,43540,2288,2169,568,2737,33
2021-08-16,Solano,095,438530,39577,37436,906,38342,263
2021-08-16,Sonoma,097,501317,36193,34844,434,35278,333
2021-08-16,Stanislaus,099,539301,63543,62033,7014,69047,1039
2021-08-16,Sutter,101,95872,11137,10902,119,11021,130
2021-08-16,Tehama,103,63373,5756,5565,700,6265,66
2021-08-16,Trinity,105,12862,566,400,131,531,3
2021-08-16,Tulare,107,460477,53740,52162,10612,62774,856
2021-08-16,Tuolumne,109,53932,5143,4984,53,5037,64
2021-08-16,Ventura,111,848112,88741,86954,3800,90754,1052
2021-08-16,Yolo,113,214977,16487,15922,690,16612,225
2021-08-16,Yuba,115,75493,7546,7314,170,7484,51
2021-08-15,Alameda,001,1643700,104815,101660,2328,103988,1287
2021-08-15,Alpine,003,1148,90,91,0,91,0
2021-08-15,Amador,005,37829,4371,4231,38,4269,49
2021-08-15,Butte,007,227075,14683,14263,2327,16590,206
2021-08-15,Calaveras,009,45235,2662,2599,17,2616,57
2021-08-15,Colusa,011,21464,2202,2140,431,2571,16
2021-08-15,Contra Costa,013,1133247,85011,81781,1679,83460,848
2021-08-15,Del Norte,015,27424,2330,2060,16,2076,8
2021-08-15,El Dorado,017,186661,12682,12057,1072,13129,118
2021-08-15,Fresno,019,978130,112191,109382,9792,119174,1753
2021-08-15,Glenn,021,27897,2654,2592,677,3269,20
2021-08-15,Humboldt,023,135768,6327,6024,119,6143,52
2021-08-15,Imperial,025,180216,29943,29711,2836,32547,746
2021-08-15,Inyo,027,18085,1494,1489,14,1503,39
2021-08-15,Kern,029,883053,104398,102524,13478,116002,1367
2021-08-15,Kings,031,150075,25421,24736,1321,26057,254
2021-08-15,Lake,033,64148,5013,4886,33,4919,68
2021-08-15,Lassen,035,31185,5564,5482,134,5616,21
2021-08-15,Los Angeles,037,10098052,1320061,1302882,48500,1351382,24918
2021-08-15,Madera,039,155013,18227,17714,1189,18903,246
2021-08-15,Marin,041,260295,15830,15461,317,15778,239
2021-08-15,Mariposa,043,17540,627,591,14,605,5
2021-08-15,Mendocino,045,87422,5287,5022,169,5191,49
2021-08-15,Merced,047,269075,33735,33305,1219,34524,481
2021-08-15,Modoc,049,8938,436,421,150,571,5
2021-08-15,Mono,051,14174,1370,1334,18,1352,3
2021-08-15,Monterey,053,433212,45050,44567,2194,46761,527
2021-08-15,Napa,055,140530,11176,10919,68,10987,83
2021-08-15,Nevada,057,99092,6769,6486,228,6714,74
2021-08-15,Orange,059,3164182,280186,275447,12948,288395,5161
2021-08-15,Placer,061,380077,28828,27220,2332,29552,306
2021-08-15,Plumas,063,18699,910,850,14,864,5
2021-08-15,Riverside,065,2383286,321230,314133,15096,329229,4582
2021-08-15,Sacramento,067,1510023,128801,123924,2562,126486,1761
2021-08-15,San Benito,069,59416,6516,6446,126,6572,64
2021-08-15,San Bernardino,071,2135413,317940,313120,9773,322893,5301
2021-08-15,San Diego,073,3302833,320236,314247,18519,332766,3824
2021-08-15,San Francisco,075,870044,45813,44531,1868,46399,567
2021-08-15,San Joaquin,077,732212,82954,80832,4247,85079,1488
2021-08-15,San Luis Obispo,079,281455,23996,23404,907,24311,265
2021-08-15,San Mateo,081,765935,48034,46897,685,47582,548
2021-08-15,Santa Barbara,083,443738,38029,37276,1316,38592,475
2021-08-15,Santa Clara,085,1922200,130818,127715,956,128671,1773
2021-08-15,Santa Cruz,087,273765,17840,17440,884,18324,209
2021-08-15,Shasta,089,179085,14331,13835,1976,15811,211
2021-08-15,Sierra,091,2930,87,82,12,94,0
2021-08-15,Siskiyou,093,43540,2267,2169,554,2723,33
2021-08-15,Solano,095,438530,39321,37320,895,38215,263
2021-08-15,Sonoma,097,501317,35997,34706,426,35132,333
2021-08-15,Stanislaus,099,539301,63175,61795,6935,68730,1039
2021-08-15,Sutter,101,95872,11046,10863,119,10982,130
2021-08-15,Tehama,103,63373,5707,5550,694,6244,66
2021-08-15,Trinity,105,12862,562,400,130,530,3
2021-08-15,Tulare,107,460477,53483,52046,10552,62598,856
2021-08-15,Tuolumne,109,53932,5105,4934,51,4985,64
2021-08-15,Ventura,111,848112,88436,86797,3786,90583,1052
2021-08-15,Yolo,113,214977,16391,15873,680,16553,225
2021-08-15,Yuba,115,75493,7469,7265,169,7434,51
2021-08-14,Alameda,001,1643700,104599,101305,2324,103629,1287
2021-08-14,Alpine,003,1148,90,91,0,91,0
2021-08-14,Amador,005,37829,4353,4206,38,4244,49
2021-08-14,Butte,007,227075,14647,14192,2311,16503,206
2021-08-14,Calaveras,009,45235,2655,2579,17,2596,57
2021-08-14,Colusa,011,21464,2191,2134,427,2561,16
2021-08-14,Contra Costa,013,1133247,84762,81458,1671,83129,848
2021-08-14,Del Norte,015,27424,2303,2015,16,2031,8
2021-08-14,El Dorado,017,186661,12646,12019,1064,13083,118
2021-08-14,Fresno,019,978130,112030,109056,9762,118818,1753
2021-08-14,Glenn,021,27897,2643,2583,674,3257,20
2021-08-14,Humboldt,023,135768,6274,5998,115,6113,52
2021-08-14,Imperial,025,180216,29916,29671,2836,32507,746
2021-08-14,Inyo,027,18085,1492,1487,14,1501,39
2021-08-14,Kern,029,883053,104203,102306,13382,115688,1367
2021-08-14,Kings,031,150075,25323,24647,1312,25959,254
2021-08-14,Lake,033,64148,4996,4850,32,4882,68
2021-08-14,Lassen,035,31185,5557,5475,133,5608,21
2021-08-14,Los Angeles,037,10098052,1318287,1299346,48361,1347707,24911
2021-08-14,Madera,039,155013,18180,17691,1184,18875,246
2021-08-14,Marin,041,260295,15796,15441,317,15758,239
2021-08-14,Mariposa,043,17540,623,584,14,598,5
2021-08-14,Mendocino,045,87422,5251,4977,166,5143,49
2021-08-14,Merced,047,269075,33671,33234,1213,34447,481
2021-08-14,Modoc,049,8938,436,421,150,571,5
2021-08-14,Mono,051,14174,1365,1332,18,1350,3
2021-08-14,Monterey,053,433212,45005,44514,2191,46705,527
2021-08-14,Napa,055,140530,11146,10878,67,10945,83
2021-08-14,Nevada,057,99092,6734,6419,227,6646,74
2021-08-14,Orange,059,3164182,279752,274732,12920,287652,5161
2021-08-14,Placer,061,380077,28682,27115,2308,29423,306
2021-08-14,Plumas,063,18699,900,849,14,863,5
2021-08-14,Riverside,065,2383286,320514,313264,15075,328339,4582
2021-08-14,Sacramento,067,1510023,128307,123438,2544,125982,1758
2021-08-14,San Benito,069,59416,6503,6428,126,6554,64
2021-08-14,San Bernardino,071,2135413,317390,312142,9752,321894,5301
2021-08-14,San Diego,073,3302833,319565,313589,18451,332040,3824
2021-08-14,San Francisco,075,870044,45684,44353,1849,46202,567
2021-08-14,San Joaquin,077,732212,82738,80585,4232,84817,1488
2021-08-14,San Luis Obispo,079,281455,23935,23328,904,24232,265
2021-08-14,San Mateo,081,765935,47915,46792,681,47473,548
2021-08-14,Santa Barbara,083,443738,37935,37118,1313,38431,475
2021-08-14,Santa Clara,085,1922200,130539,127432,953,128385,1772
2021-08-14,Santa Cruz,087,273765,17801,17384,883,18267,209
2021-08-14,Shasta,089,179085,14256,13813,1955,15768,211
2021-08-14,Sierra,091,2930,86,81,12,93,0
2021-08-14,Siskiyou,093,43540,2257,2160,544,2704,33
2021-08-14,Solano,095,438530,39234,37237,883,38120,263
2021-08-14,Sonoma,097,501317,35874,34606,424,35030,333
2021-08-14,Stanislaus,099,539301,63001,61564,6890,68454,1039
2021-08-14,Sutter,101,95872,11001,10808,118,10926,130
2021-08-14,Tehama,103,63373,5683,5530,690,6220,66
2021-08-14,Trinity,105,12862,556,399,130,529,3
2021-08-14,Tulare,107,460477,53347,51951,10506,62457,856
2021-08-14,Tuolumne,109,53932,5070,4924,51,4975,64
2021-08-14,Ventura,111,848112,88280,86569,3766,90335,1052
2021-08-14,Yolo,113,214977,16346,15815,670,16485,225
2021-08-14,Yuba,115,75493,7420,7223,169,7392,51
2021-08-13,Alameda,001,1643700,104302,100930,2316,103246,1284
2021-08-13,Alpine,003,1148,90,91,0,91,0
2021-08-13,Amador,005,37829,4325,4169,38,4207,49
2021-08-13,Butte,007,227075,14577,14100,2295,16395,206
2021-08-13,Calaveras,009,45235,2649,2564,17,2581,57
2021-08-13,Colusa,011,21464,2184,2123,422,2545,16
2021-08-13,Contra Costa,013,1133247,84451,81046,1663,82709,848
2021-08-13,Del Norte,015,27424,2262,1973,16,1989,8
2021-08-13,El Dorado,017,186661,12606,11951,1052,13003,118
2021-08-13,Fresno,019,978130,111738,108638,9738,118376,1753
2021-08-13,Glenn,021,27897,2632,2574,670,3244,20
2021-08-13,Humboldt,023,135768,6227,5882,112,5994,52
2021-08-13,Imperial,025,180216,29889,29654,2835,32489,745
2021-08-13,Inyo,027,18085,1491,1484,14,1498,39
2021-08-13,Kern,029,883053,103994,102029,13273,115302,1364
2021-08-13,Kings,031,150075,25238,24531,1305,25836,253
2021-08-13,Lake,033,64148,4973,4811,31,4842,68
2021-08-13,Lassen,035,31185,5549,5455,132,5587,21
2021-08-13,Los Angeles,037,10098052,1315964,1295406,48224,1343630,24891
2021-08-13,Madera,039,155013,18131,17614,1175,18789,246
2021-08-13,Marin,041,260295,15765,15380,317,15697,239
2021-08-13,Mariposa,043,17540,617,577,14,591,5
2021-08-13,Mendocino,045,87422,5198,4924,164,5088,49
2021-08-13,Merced,047,269075,33624,33111,1207,34318,480
2021-08-13,Modoc,049,8938,435,421,149,570,5
2021-08-13,Mono,051,14174,1362,1331,18,1349,3
2021-08-13,Monterey,053,433212,44945,44450,2189,46639,527
2021-08-13,Napa,055,140530,11110,10830,67,10897,83
2021-08-13,Nevada,057,99092,6693,6356,226,6582,74
2021-08-13,Orange,059,3164182,279257,274004,12871,286875,5159
2021-08-13,Placer,061,380077,28582,26987,2281,29268,306
2021-08-13,Plumas,063,18699,886,842,14,856,5
2021-08-13,Riverside,065,2383286,319775,312408,15050,327458,4581
2021-08-13,Sacramento,067,1510023,127837,122868,2517,125385,1758
2021-08-13,San Benito,069,59416,6497,6422,124,6546,64
2021-08-13,San Bernardino,071,2135413,316722,311378,9733,321111,5301
2021-08-13,San Diego,073,3302833,318519,312293,18372,330665,3821
2021-08-13,San Francisco,075,870044,45548,44196,1826,46022,567
2021-08-13,San Joaquin,077,732212,82521,80232,4216,84448,1481
2021-08-13,San Luis Obispo,079,281455,23872,23226,901,24127,265
2021-08-13,San Mateo,081,765935,47796,46660,680,47340,548
2021-08-13,Santa Barbara,083,443738,37850,37023,1309,38332,474
2021-08-13,Santa Clara,085,1922200,130252,126958,947,127905,1769
2021-08-13,Santa Cruz,087,273765,17761,17332,876,18208,209
2021-08-13,Shasta,089,179085,14193,13698,1941,15639,211
2021-08-13,Sierra,091,2930,85,81,12,93,0
2021-08-13,Siskiyou,093,43540,2248,2147,540,2687,33
2021-08-13,Solano,095,438530,39100,37104,875,37979,264
2021-08-13,Sonoma,097,501317,35769,34464,424,34888,333
2021-08-13,Stanislaus,099,539301,62830,61294,6847,68141,1039
2021-08-13,Sutter,101,95872,10957,10751,117,10868,130
2021-08-13,Tehama,103,63373,5659,5496,688,6184,66
2021-08-13,Trinity,105,12862,552,392,130,522,3
2021-08-13,Tulare,107,460477,53243,51770,10432,62202,856
2021-08-13,Tuolumne,109,53932,5037,4899,50,4949,64
2021-08-13,Ventura,111,848112,88122,86368,3753,90121,1052
2021-08-13,Yolo,113,214977,16292,15761,660,16421,225
2021-08-13,Yuba,115,75493,7382,7184,169,7353,51
2021-08-12,Alameda,001,1643700,103809,100472,2303,102775,1284
2021-08-12,Alpine,003,1148,90,91,0,91,0
2021-08-12,Amador,005,37829,4295,4161,37,4198,49
2021-08-12,Butte,007,227075,14507,14006,2277,16283,206
2021-08-12,Calaveras,009,45235,2634,2531,17,2548,57
2021-08-12,Colusa,011,21464,2179,2111,421,2532,17
2021-08-12,Contra Costa,013,1133247,83969,80738,1648,82386,846
2021-08-12,Del Norte,015,27424,2190,1923,16,1939,8
2021-08-12,El Dorado,017,186661,12492,11880,1043,12923,118
2021-08-12,Fresno,019,978130,111316,108193,9670,117863,1753
2021-08-12,Glenn,021,27897,2624,2559,658,3217,20
2021-08-12,Humboldt,023,135768,6158,5845,108,5953,52
2021-08-12,Imperial,025,180216,29833,29585,2829,32414,745
2021-08-12,Inyo,027,18085,1489,1483,14,1497,39
2021-08-12,Kern,029,883053,103705,101698,13193,114891,1364
2021-08-12,Kings,031,150075,25138,24423,1296,25719,252
2021-08-12,Lake,033,64148,4947,4774,31,4805,68
2021-08-12,Lassen,035,31185,5527,5428,131,5559,21
2021-08-12,Los Angeles,037,10098052,1312776,1291875,48090,1339965,24874
2021-08-12,Madera,039,155013,18067,17564,1163,18727,246
2021-08-12,Marin,041,260295,15716,15277,314,15591,239
2021-08-12,Mariposa,043,17540,608,568,13,581,5
2021-08-12,Mendocino,045,87422,5168,4873,158,5031,49
2021-08-12,Merced,047,269075,33500,32960,1200,34160,480
2021-08-12,Modoc,049,8938,434,423,149,572,5
2021-08-12,Mono,051,14174,1357,1325,18,1343,3
2021-08-12,Monterey,053,433212,44869,44383,2172,46555,527
2021-08-12,Napa,055,140530,11061,10780,66,10846,83
2021-08-12,Nevada,057,99092,6632,6283,226,6509,74
2021-08-12,Orange,059,3164182,278579,273167,12813,285980,5158
2021-08-12,Placer,061,380077,28384,26856,2258,29114,306
2021-08-12,Plumas,063,18699,878,829,14,843,5
2021-08-12,Riverside,065,2383286,318765,311304,15017,326321,4575
2021-08-12,Sacramento,067,1510023,127066,122222,2487,124709,1758
2021-08-12,San Benito,069,59416,6480,6398,122,6520,64
2021-08-12,San Bernardino,071,2135413,315846,310420,9704,320124,5297
2021-08-12,San Diego,073,3302833,317149,310596,18283,328879,3821
2021-08-12,San Francisco,075,870044,45341,43774,1813,45587,564
2021-08-12,San Joaquin,077,732212,82125,79945,4193,84138,1479
2021-08-12,San Luis Obispo,079,281455,23772,23101,887,23988,264
2021-08-12,San Mateo,081,765935,47652,46435,677,47112,548
2021-08-12,Santa Barbara,083,443738,37713,36881,1301,38182,473
2021-08-12,Santa Clara,085,1922200,129803,126614,941,127555,1769
2021-08-12,Santa Cruz,087,273765,17697,17261,875,18136,209
2021-08-12,Shasta,089,179085,14107,13621,1914,15535,211
2021-08-12,Sierra,091,2930,85,81,12,93,0
2021-08-12,Siskiyou,093,43540,2241,2134,530,2664,33
2021-08-12,Solano,095,438530,38871,36980,866,37846,262
2021-08-12,Sonoma,097,501317,35621,34299,421,34720,333
2021-08-12,Stanislaus,099,539301,62566,61026,6788,67814,1039
2021-08-12,Sutter,101,95872,10896,10695,115,10810,130
2021-08-12,Tehama,103,63373,5629,5462,679,6141,66
2021-08-12,Trinity,105,12862,548,386,129,515,3
2021-08-12,Tulare,107,460477,53097,51632,10383,62015,856
2021-08-12,Tuolumne,109,53932,4990,4845,48,4893,64
2021-08-12,Ventura,111,848112,87884,86106,3729,89835,1052
2021-08-12,Yolo,113,214977,16220,15686,647,16333,224
2021-08-12,Yuba,115,75493,7334,7128,168,7296,51
2021-08-11,Alameda,001,1643700,103296,100040,2299,102339,1281
2021-08-11,Alpine,003,1148,90,91,0,91,0
2021-08-11,Amador,005,37829,4271,4127,37,4164,49
2021-08-11,Butte,007,227075,14407,13905,2252,16157,206
2021-08-11,Calaveras,009,45235,2612,2505,17,2522,57
2021-08-11,Colusa,011,21464,2169,2101,419,2520,16
2021-08-11,Contra Costa,013,1133247,83469,80275,1630,81905,843
2021-08-11,Del Norte,015,27424,2131,1893,16,1909,8
2021-08-11,El Dorado,017,186661,12381,11799,1031,12830,119
2021-08-11,Fresno,019,978130,110862,107773,9623,117396,1751
2021-08-11,Glenn,021,27897,2615,2547,648,3195,20
2021-08-11,Humboldt,023,135768,6111,5765,107,5872,52
2021-08-11,Imperial,025,180216,29790,29565,2825,32390,745
2021-08-11,Inyo,027,18085,1489,1483,14,1497,39
2021-08-11,Kern,029,883053,103391,101448,13083,114531,1363
2021-08-11,Kings,031,150075,25025,24304,1287,25591,250
2021-08-11,Lake,033,64148,4910,4713,30,4743,68
2021-08-11,Lassen,035,31185,5518,5408,129,5537,21
2021-08-11,Los Angeles,037,10098052,1309450,1288238,47903,1336141,24851
2021-08-11,Madera,039,155013,18017,17511,1152,18663,245
2021-08-11,Marin,041,260295,15667,15235,314,15549,239
2021-08-11,Mariposa,043,17540,598,554,12,566,5
2021-08-11,Mendocino,045,87422,5099,4796,149,4945,49
2021-08-11,Merced,047,269075,33367,32802,1196,33998,479
2021-08-11,Modoc,049,8938,434,421,149,570,5
2021-08-11,Mono,051,14174,1352,1320,18,1338,3
2021-08-11,Monterey,053,433212,44770,44314,2154,46468,527
2021-08-11,Napa,055,140530,11020,10732,66,10798,83
2021-08-11,Nevada,057,99092,6579,6172,223,6395,74
2021-08-11,Orange,059,3164182,277722,272212,12766,284978,5155
2021-08-11,Placer,061,380077,28172,26687,2232,28919,305
2021-08-11,Plumas,063,18699,869,824,14,838,5
2021-08-11,Riverside,065,2383286,317772,310265,14982,325247,4570
2021-08-11,Sacramento,067,1510023,126273,121603,2448,124051,1757
2021-08-11,San Benito,069,59416,6467,6381,122,6503,64
2021-08-11,San Bernardino,071,2135413,314951,309498,9683,319181,5296
2021-08-11,San Diego,073,3302833,315679,309406,18179,327585,3818
2021-08-11,San Francisco,075,870044,45116,43555,1805,45360,564
2021-08-11,San Joaquin,077,732212,81718,79641,4166,83807,1478
2021-08-11,San Luis Obispo,079,281455,23668,22920,880,23800,264
2021-08-11,San Mateo,081,765935,47484,46300,674,46974,548
2021-08-11,Santa Barbara,083,443738,37550,36699,1292,37991,472
2021-08-11,Santa Clara,085,1922200,129322,126301,933,127234,1769
2021-08-11,Santa Cruz,087,273765,17632,17191,872,18063,209
2021-08-11,Shasta,089,179085,14033,13546,1898,15444,211
2021-08-11,Sierra,091,2930,84,81,12,93,0
2021-08-11,Siskiyou,093,43540,2227,2124,523,2647,33
2021-08-11,Solano,095,438530,38636,36862,852,37714,262
2021-08-11,Sonoma,097,501317,35442,34188,416,34604,333
2021-08-11,Stanislaus,099,539301,62236,60767,6758,67525,1037
2021-08-11,Sutter,101,95872,10824,10628,115,10743,130
2021-08-11,Tehama,103,63373,5600,5410,662,6072,66
2021-08-11,Trinity,105,12862,546,385,129,514,3
2021-08-11,Tulare,107,460477,52929,51464,10338,61802,854
2021-08-11,Tuolumne,109,53932,4958,4794,48,4842,64
2021-08-11,Ventura,111,848112,87632,85863,3708,89571,1051
2021-08-11,Yolo,113,214977,16145,15593,631,16224,218
2021-08-11,Yuba,115,75493,7275,7063,167,7230,53
2021-08-10,Alameda,001,1643700,102817,99771,2291,102062,1281
2021-08-10,Alpine,003,1148,90,91,0,91,0
2021-08-10,Amador,005,37829,4255,4093,37,4130,49
2021-08-10,Butte,007,227075,14324,13853,2231,16084,205
2021-08-10,Calaveras,009,45235,2587,2491,15,2506,57
2021-08-10,Colusa,011,21464,2156,2088,410,2498,16
2021-08-10,Contra Costa,013,1133247,82925,80018,1620,81638,840
2021-08-10,Del Norte,015,27424,2087,1870,16,1886,8
2021-08-10,El Dorado,017,186661,12280,11734,1020,12754,117
2021-08-10,Fresno,019,978130,110406,107616,9567,117183,1747
2021-08-10,Glenn,021,27897,2602,2538,638,3176,20
2021-08-10,Humboldt,023,135768,6057,5718,104,5822,52
2021-08-10,Imperial,025,180216,29755,29522,2819,32341,745
2021-08-10,Inyo,027,18085,1489,1482,14,1496,39
2021-08-10,Kern,029,883053,103062,101254,12987,114241,1359
2021-08-10,Kings,031,150075,24899,24252,1271,25523,251
2021-08-10,Lake,033,64148,4869,4700,30,4730,67
2021-08-10,Lassen,035,31185,5500,5401,129,5530,21
2021-08-10,Los Angeles,037,10098052,1305699,1285140,47731,1332871,24821
2021-08-10,Madera,039,155013,17944,17481,1142,18623,245
2021-08-10,Marin,041,260295,15620,15194,314,15508,239
2021-08-10,Mariposa,043,17540,585,550,12,562,5
2021-08-10,Mendocino,045,87422,5054,4775,145,4920,49
2021-08-10,Merced,047,269075,33220,32721,1187,33908,477
2021-08-10,Modoc,049,8938,433,421,149,570,5
2021-08-10,Mono,051,14174,1347,1320,18,1338,3
2021-08-10,Monterey,053,433212,44708,44259,2139,46398,527
2021-08-10,Napa,055,140530,10964,10703,65,10768,83
2021-08-10,Nevada,057,99092,6514,6151,222,6373,73
2021-08-10,Orange,059,3164182,276843,271688,12718,284406,5155
2021-08-10,Placer,061,380077,27953,26561,2190,28751,305
2021-08-10,Plumas,063,18699,860,816,14,830,5
2021-08-10,Riverside,065,2383286,316657,309529,14956,324485,4564
2021-08-10,Sacramento,067,1510023,125420,121159,2418,123577,1755
2021-08-10,San Benito,069,59416,6453,6371,122,6493,64
2021-08-10,San Bernardino,071,2135413,314028,308672,9665,318337,5295
2021-08-10,San Diego,073,3302833,314038,308288,18087,326375,3815
2021-08-10,San Francisco,075,870044,44863,43389,1790,45179,564
2021-08-10,San Joaquin,077,732212,81320,79391,4148,83539,1478
2021-08-10,San Luis Obispo,079,281455,23542,22776,878,23654,264
2021-08-10,San Mateo,081,765935,47312,46184,672,46856,548
2021-08-10,Santa Barbara,083,443738,37385,36574,1285,37859,472
2021-08-10,Santa Clara,085,1922200,128859,126019,926,126945,1770
2021-08-10,Santa Cruz,087,273765,17549,17142,870,18012,209
2021-08-10,Shasta,089,179085,13955,13461,1874,15335,211
2021-08-10,Sierra,091,2930,84,76,12,88,0
2021-08-10,Siskiyou,093,43540,2218,2088,516,2604,33
2021-08-10,Solano,095,438530,38390,36767,841,37608,262
2021-08-10,Sonoma,097,501317,35297,34054,413,34467,333
2021-08-10,Stanislaus,099,539301,61890,60605,6721,67326,1037
2021-08-10,Sutter,101,95872,10759,10569,115,10684,130
2021-08-10,Tehama,103,63373,5571,5392,657,6049,66
2021-08-10,Trinity,105,12862,546,384,129,513,3
2021-08-10,Tulare,107,460477,52764,51390,10286,61676,854
2021-08-10,Tuolumne,109,53932,4929,4780,46,4826,64
2021-08-10,Ventura,111,848112,87342,85714,3687,89401,1051
2021-08-10,Yolo,113,214977,16058,15568,621,16189,218
2021-08-10,Yuba,115,75493,7225,7028,167,7195,50
2021-08-09,Alameda,001,1643700,102263,99496,2287,101783,1276
2021-08-09,Alpine,003,1148,90,91,0,91,0
2021-08-09,Amador,005,37829,4229,4078,37,4115,48
2021-08-09,Butte,007,227075,14225,13813,2203,16016,205
2021-08-09,Calaveras,009,45235,2561,2472,15,2487,57
2021-08-09,Colusa,011,21464,2146,2075,402,2477,16
2021-08-09,Contra Costa,013,1133247,82381,79740,1608,81348,840
2021-08-09,Del Norte,015,27424,2019,1848,16,1864,8
2021-08-09,El Dorado,017,186661,12173,11672,1006,12678,117
2021-08-09,Fresno,019,978130,109912,107310,9529,116839,1747
2021-08-09,Glenn,021,27897,2591,2532,626,3158,20
2021-08-09,Humboldt,023,135768,5966,5632,102,5734,52
2021-08-09,Imperial,025,180216,29710,29512,2815,32327,745
2021-08-09,Inyo,027,18085,1489,1481,14,1495,39
2021-08-09,Kern,029,883053,102750,101069,12901,113970,1359
2021-08-09,Kings,031,150075,24792,24155,1256,25411,250
2021-08-09,Lake,033,64148,4834,4670,28,4698,66
2021-08-09,Lassen,035,31185,5478,5393,128,5521,21
2021-08-09,Los Angeles,037,10098052,1301684,1282891,47525,1330416,24798
2021-08-09,Madera,039,155013,17885,17429,1122,18551,245
2021-08-09,Marin,041,260295,15567,15154,313,15467,239
2021-08-09,Mariposa,043,17540,572,545,12,557,5
2021-08-09,Mendocino,045,87422,5003,4732,137,4869,49
2021-08-09,Merced,047,269075,33074,32666,1180,33846,477
2021-08-09,Modoc,049,8938,433,419,149,568,5
2021-08-09,Mono,051,14174,1344,1337,18,1355,3
2021-08-09,Monterey,053,433212,44636,44190,2123,46313,527
2021-08-09,Napa,055,140530,10917,10679,65,10744,83
2021-08-09,Nevada,057,99092,6442,6088,221,6309,73
2021-08-09,Orange,059,3164182,275806,271036,12662,283698,5153
2021-08-09,Placer,061,380077,27730,26457,2159,28616,305
2021-08-09,Plumas,063,18699,843,803,14,817,5
2021-08-09,Riverside,065,2383286,315581,308678,14936,323614,4562
2021-08-09,Sacramento,067,1510023,124585,120812,2393,123205,1748
2021-08-09,San Benito,069,59416,6433,6359,120,6479,63
2021-08-09,San Bernardino,071,2135413,313043,308038,9643,317681,5295
2021-08-09,San Diego,073,3302833,312378,306855,17988,324843,3811
2021-08-09,San Francisco,075,870044,44617,43261,1772,45033,564
2021-08-09,San Joaquin,077,732212,80938,79198,4130,83328,1469
2021-08-09,San Luis Obispo,079,281455,23403,22695,869,23564,264
2021-08-09,San Mateo,081,765935,47140,46040,668,46708,548
2021-08-09,Santa Barbara,083,443738,37201,36474,1277,37751,470
2021-08-09,Santa Clara,085,1922200,128356,125791,917,126708,2187
2021-08-09,Santa Cruz,087,273765,17487,17082,870,17952,209
2021-08-09,Shasta,089,179085,13838,13397,1863,15260,210
2021-08-09,Sierra,091,2930,83,75,12,87,0
2021-08-09,Siskiyou,093,43540,2206,2047,500,2547,32
2021-08-09,Solano,095,438530,38114,36653,839,37492,262
2021-08-09,Sonoma,097,501317,35116,33933,411,34344,333
2021-08-09,Stanislaus,099,539301,61613,60410,6670,67080,1037
2021-08-09,Sutter,101,95872,10710,10525,112,10637,129
2021-08-09,Tehama,103,63373,5528,5373,655,6028,66
2021-08-09,Trinity,105,12862,544,378,127,505,3
2021-08-09,Tulare,107,460477,52603,51274,10221,61495,854
2021-08-09,Tuolumne,109,53932,4887,4745,46,4791,64
2021-08-09,Ventura,111,848112,87070,85514,3676,89190,1047
2021-08-09,Yolo,113,214977,15980,15521,600,16121,218
2021-08-09,Yuba,115,75493,7166,6994,167,7161,50
2021-08-08,Alameda,001,1643700,101709,99135,2281,101416,1276
2021-08-08,Alpine,003,1148,90,91,0,91,0
2021-08-08,Amador,005,37829,4195,4057,36,4093,48
2021-08-08,Butte,007,227075,14143,13791,2185,15976,205
2021-08-08,Calaveras,009,45235,2528,2462,15,2477,57
2021-08-08,Colusa,011,21464,2129,2070,395,2465,16
2021-08-08,Contra Costa,013,1133247,81857,79454,1601,81055,840
2021-08-08,Del Norte,015,27424,1973,1810,16,1826,8
2021-08-08,El Dorado,017,186661,12052,11631,995,12626,117
2021-08-08,Fresno,019,978130,109469,107078,9492,116570,1747
2021-08-08,Glenn,021,27897,2583,2527,619,3146,20
2021-08-08,Humboldt,023,135768,5877,5571,102,5673,52
2021-08-08,Imperial,025,180216,29686,29485,2805,32290,745
2021-08-08,Inyo,027,18085,1489,1481,14,1495,39
2021-08-08,Kern,029,883053,102430,100909,12789,113698,1359
2021-08-08,Kings,031,150075,24678,24095,1247,25342,250
2021-08-08,Lake,033,64148,4784,4636,27,4663,66
2021-08-08,Lassen,035,31185,5463,5391,127,5518,21
2021-08-08,Los Angeles,037,10098052,1297428,1279982,47340,1327322,24793
2021-08-08,Madera,039,155013,17806,17398,1105,18503,245
2021-08-08,Marin,041,260295,15514,15124,311,15435,239
2021-08-08,Mariposa,043,17540,568,538,12,550,5
2021-08-08,Mendocino,045,87422,4941,4702,124,4826,49
2021-08-08,Merced,047,269075,32927,32634,1171,33805,477
2021-08-08,Modoc,049,8938,432,419,148,567,5
2021-08-08,Mono,051,14174,1340,1336,18,1354,3
2021-08-08,Monterey,053,433212,44566,44171,2112,46283,527
2021-08-08,Napa,055,140530,10881,10668,65,10733,83
2021-08-08,Nevada,057,99092,6358,6009,219,6228,73
2021-08-08,Orange,059,3164182,274892,270532,12620,283152,5153
2021-08-08,Placer,061,380077,27521,26332,2118,28450,305
2021-08-08,Plumas,063,18699,834,803,14,817,5
2021-08-08,Riverside,065,2383286,314460,308042,14912,322954,4562
2021-08-08,Sacramento,067,1510023,123757,120109,2381,122490,1744
2021-08-08,San Benito,069,59416,6416,6350,119,6469,63
2021-08-08,San Bernardino,071,2135413,311896,307378,9613,316991,5295
2021-08-08,San Diego,073,3302833,311038,305983,17890,323873,3811
2021-08-08,San Francisco,075,870044,44357,43098,1749,44847,564
2021-08-08,San Joaquin,077,732212,80488,79002,4114,83116,1469
2021-08-08,San Luis Obispo,079,281455,23229,22668,861,23529,263
2021-08-08,San Mateo,081,765935,46950,45927,665,46592,548
2021-08-08,Santa Barbara,083,443738,37024,36417,1270,37687,470
2021-08-08,Santa Clara,085,1922200,127904,125553,912,126465,2187
2021-08-08,Santa Cruz,087,273765,17416,17035,865,17900,209
2021-08-08,Shasta,089,179085,13753,13381,1852,15233,210
2021-08-08,Sierra,091,2930,83,74,12,86,0
2021-08-08,Siskiyou,093,43540,2190,2041,495,2536,32
2021-08-08,Solano,095,438530,37862,36551,835,37386,262
2021-08-08,Sonoma,097,501317,34872,33805,410,34215,333
2021-08-08,Stanislaus,099,539301,61290,60269,6625,66894,1037
2021-08-08,Sutter,101,95872,10650,10481,111,10592,129
2021-08-08,Tehama,103,63373,5490,5359,652,6011,66
2021-08-08,Trinity,105,12862,539,378,127,505,3
2021-08-08,Tulare,107,460477,52423,51220,10161,61381,854
2021-08-08,Tuolumne,109,53932,4848,4731,46,4777,64
2021-08-08,Ventura,111,848112,86779,85382,3666,89048,1047
2021-08-08,Yolo,113,214977,15888,15477,593,16070,218
2021-08-08,Yuba,115,75493,7127,6967,167,7134,50
2021-08-07,Alameda,001,1643700,101461,98812,2275,101087,1276
2021-08-07,Alpine,003,1148,90,91,0,91,0
2021-08-07,Amador,005,37829,4178,4041,35,4076,48
2021-08-07,Butte,007,227075,14091,13714,2173,15887,205
2021-08-07,Calaveras,009,45235,2518,2446,15,2461,57
2021-08-07,Colusa,011,21464,2124,2067,386,2453,16
2021-08-07,Contra Costa,013,1133247,81561,79168,1598,80766,840
2021-08-07,Del Norte,015,27424,1941,1791,16,1807,8
2021-08-07,El Dorado,017,186661,12003,11575,988,12563,117
2021-08-07,Fresno,019,978130,109264,106861,9465,116326,1747
2021-08-07,Glenn,021,27897,2575,2515,618,3133,20
2021-08-07,Humboldt,023,135768,5827,5510,99,5609,52
2021-08-07,Imperial,025,180216,29667,29470,2805,32275,745
2021-08-07,Inyo,027,18085,1487,1476,14,1490,39
2021-08-07,Kern,029,883053,102272,100693,12734,113427,1359
2021-08-07,Kings,031,150075,24617,24048,1241,25289,250
2021-08-07,Lake,033,64148,4763,4613,27,4640,66
2021-08-07,Lassen,035,31185,5459,5386,127,5513,21
2021-08-07,Los Angeles,037,10098052,1295399,1276853,47191,1324044,24786
2021-08-07,Madera,039,155013,17771,17366,1100,18466,245
2021-08-07,Marin,041,260295,15480,15085,310,15395,239
2021-08-07,Mariposa,043,17540,565,530,12,542,5
2021-08-07,Mendocino,045,87422,4905,4690,122,4812,49
2021-08-07,Merced,047,269075,32863,32569,1168,33737,477
2021-08-07,Modoc,049,8938,432,419,148,567,5
2021-08-07,Mono,051,14174,1337,1329,18,1347,3
2021-08-07,Monterey,053,433212,44514,44124,2107,46231,527
2021-08-07,Napa,055,140530,10860,10658,64,10722,83
2021-08-07,Nevada,057,99092,6308,5967,217,6184,73
2021-08-07,Orange,059,3164182,274299,269900,12589,282489,5153
2021-08-07,Placer,061,380077,27332,26244,2110,28354,305
2021-08-07,Plumas,063,18699,829,801,14,815,5
2021-08-07,Riverside,065,2383286,313788,307326,14905,322231,4562
2021-08-07,Sacramento,067,1510023,123256,119636,2377,122013,1744
2021-08-07,San Benito,069,59416,6406,6332,119,6451,63
2021-08-07,San Bernardino,071,2135413,311307,306663,9596,316259,5295
2021-08-07,San Diego,073,3302833,310283,304974,17855,322829,3811
2021-08-07,San Francisco,075,870044,44186,42926,1731,44657,564
2021-08-07,San Joaquin,077,732212,80324,78769,4100,82869,1469
2021-08-07,San Luis Obispo,079,281455,23160,22579,860,23439,263
2021-08-07,San Mateo,081,765935,46822,45804,663,46467,548
2021-08-07,Santa Barbara,083,443738,36928,36303,1264,37567,470
2021-08-07,Santa Clara,085,1922200,127633,125196,907,126103,2188
2021-08-07,Santa Cruz,087,273765,17373,16994,863,17857,209
2021-08-07,Shasta,089,179085,13697,13361,1844,15205,210
2021-08-07,Sierra,091,2930,83,74,12,86,0
2021-08-07,Siskiyou,093,43540,2178,2039,493,2532,32
2021-08-07,Solano,095,438530,37746,36458,827,37285,262
2021-08-07,Sonoma,097,501317,34750,33716,410,34126,333
2021-08-07,Stanislaus,099,539301,61121,60093,6595,66688,1037
2021-08-07,Sutter,101,95872,10613,10447,111,10558,129
2021-08-07,Tehama,103,63373,5480,5343,647,5990,66
2021-08-07,Trinity,105,12862,535,377,126,503,3
2021-08-07,Tulare,107,460477,52336,51133,10123,61256,854
2021-08-07,Tuolumne,109,53932,4818,4721,46,4767,64
2021-08-07,Ventura,111,848112,86599,85232,3651,88883,1047
2021-08-07,Yolo,113,214977,15844,15423,586,16009,218
2021-08-07,Yuba,115,75493,7102,6937,165,7102,50
2021-08-06,Alameda,001,1643700,101132,98487,2269,100756,1275
2021-08-06,Alpine,003,1148,90,91,0,91,0
2021-08-06,Amador,005,37829,4157,4002,35,4037,48
2021-08-06,Butte,007,227075,14041,13626,2158,15784,205
2021-08-06,Calaveras,009,45235,2507,2419,15,2434,57
2021-08-06,Colusa,011,21464,2117,2045,380,2425,16
2021-08-06,Contra Costa,013,1133247,81266,78796,1592,80388,840
2021-08-06,Del Norte,015,27424,1914,1755,15,1770,8
2021-08-06,El Dorado,017,186661,11953,11498,976,12474,117
2021-08-06,Fresno,019,978130,109000,106542,9438,115980,1747
2021-08-06,Glenn,021,27897,2560,2504,615,3119,20
2021-08-06,Humboldt,023,135768,5776,5421,96,5517,52
2021-08-06,Imperial,025,180216,29656,29404,2801,32205,745
2021-08-06,Inyo,027,18085,1484,1471,14,1485,39
2021-08-06,Kern,029,883053,102095,100427,12649,113076,1359
2021-08-06,Kings,031,150075,24562,23974,1237,25211,250
2021-08-06,Lake,033,64148,4740,4557,27,4584,66
2021-08-06,Lassen,035,31185,5437,5368,127,5495,21
2021-08-06,Los Angeles,037,10098052,1292911,1273081,47039,1320120,24772
2021-08-06,Madera,039,155013,17732,17324,1091,18415,245
2021-08-06,Marin,041,260295,15447,15051,310,15361,239
2021-08-06,Mariposa,043,17540,556,511,12,523,5
2021-08-06,Mendocino,045,87422,4863,4649,121,4770,49
2021-08-06,Merced,047,269075,32803,32456,1165,33621,477
2021-08-06,Modoc,049,8938,432,419,148,567,5
2021-08-06,Mono,051,14174,1336,1328,18,1346,3
2021-08-06,Monterey,053,433212,44446,44058,2094,46152,527
2021-08-06,Napa,055,140530,10833,10620,64,10684,83
2021-08-06,Nevada,057,99092,6252,5874,217,6091,73
2021-08-06,Orange,059,3164182,273734,269077,12572,281649,5151
2021-08-06,Placer,061,380077,27209,26086,2088,28174,305
2021-08-06,Plumas,063,18699,820,795,14,809,5
2021-08-06,Riverside,065,2383286,313078,306304,14894,321198,4562
2021-08-06,Sacramento,067,1510023,122764,119169,2357,121526,1740
2021-08-06,San Benito,069,59416,6389,6315,119,6434,63
2021-08-06,San Bernardino,071,2135413,310606,305806,9587,315393,5286
2021-08-06,San Diego,073,3302833,309244,303691,17806,321497,3810
2021-08-06,San Francisco,075,870044,44029,42659,1713,44372,565
2021-08-06,San Joaquin,077,732212,80175,78405,4088,82493,1469
2021-08-06,San Luis Obispo,079,281455,23092,22472,855,23327,263
2021-08-06,San Mateo,081,765935,46669,45665,658,46323,548
2021-08-06,Santa Barbara,083,443738,36839,36208,1260,37468,470
2021-08-06,Santa Clara,085,1922200,127343,124767,901,125668,2185
2021-08-06,Santa Cruz,087,273765,17329,16924,859,17783,207
2021-08-06,Shasta,089,179085,13631,13284,1838,15122,210
2021-08-06,Sierra,091,2930,83,73,12,85,0
2021-08-06,Siskiyou,093,43540,2168,2030,489,2519,32
2021-08-06,Solano,095,438530,37636,36351,818,37169,262
2021-08-06,Sonoma,097,501317,34664,33594,409,34003,333
2021-08-06,Stanislaus,099,539301,60983,59854,6574,66428,1037
2021-08-06,Sutter,101,95872,10570,10391,111,10502,128
2021-08-06,Tehama,103,63373,5456,5325,645,5970,66
2021-08-06,Trinity,105,12862,534,371,125,496,3
2021-08-06,Tulare,107,460477,52235,51018,10076,61094,854
2021-08-06,Tuolumne,109,53932,4791,4674,46,4720,64
2021-08-06,Ventura,111,848112,86428,85046,3639,88685,1047
2021-08-06,Yolo,113,214977,15791,15299,581,15880,218
2021-08-06,Yuba,115,75493,7079,6904,165,7069,50
2021-08-05,Alameda,001,1643700,100647,98052,2264,100316,1275
2021-08-05,Alpine,003,1148,90,91,0,91,0
2021-08-05,Amador,005,37829,4137,3992,35,4027,48
2021-08-05,Butte,007,227075,13980,13564,2135,15699,206
2021-08-05,Calaveras,009,45235,2488,2397,15,2412,57
2021-08-05,Colusa,011,21464,2105,2036,376,2412,16
2021-08-05,Contra Costa,013,1133247,80838,78514,1585,80099,840
2021-08-05,Del Norte,015,27424,1887,1731,15,1746,8
2021-08-05,El Dorado,017,186661,11868,11408,966,12374,117
2021-08-05,Fresno,019,978130,108629,106219,9400,115619,1747
2021-08-05,Glenn,021,27897,2554,2494,612,3106,20
2021-08-05,Humboldt,023,135768,5702,5328,95,5423,52
2021-08-05,Imperial,025,180216,29625,29383,2797,32180,745
2021-08-05,Inyo,027,18085,1480,1468,14,1482,38
2021-08-05,Kern,029,883053,101873,100091,12564,112655,1358
2021-08-05,Kings,031,150075,24478,23906,1231,25137,249
2021-08-05,Lake,033,64148,4701,4490,25,4515,66
2021-08-05,Lassen,035,31185,5429,5344,127,5471,21
2021-08-05,Los Angeles,037,10098052,1289689,1269445,46905,1316350,24756
2021-08-05,Madera,039,155013,17691,17301,1083,18384,245
2021-08-05,Marin,041,260295,15403,15005,306,15311,239
2021-08-05,Mariposa,043,17540,545,504,11,515,5
2021-08-05,Mendocino,045,87422,4820,4597,112,4709,49
2021-08-05,Merced,047,269075,32736,32381,1154,33535,477
2021-08-05,Modoc,049,8938,431,418,148,566,5
2021-08-05,Mono,051,14174,1328,1309,18,1327,3
2021-08-05,Monterey,053,433212,44389,43992,2076,46068,527
2021-08-05,Napa,055,140530,10797,10591,62,10653,83
2021-08-05,Nevada,057,99092,6170,5778,214,5992,73
2021-08-05,Orange,059,3164182,272953,268329,12546,280875,5149
2021-08-05,Placer,061,380077,27009,25965,2061,28026,305
2021-08-05,Plumas,063,18699,811,787,14,801,5
2021-08-05,Riverside,065,2383286,312161,305415,14867,320282,4562
2021-08-05,Sacramento,067,1510023,122054,118590,2344,120934,1739
2021-08-05,San Benito,069,59416,6371,6305,119,6424,63
2021-08-05,San Bernardino,071,2135413,309769,304956,9566,314522,5284
2021-08-05,San Diego,073,3302833,307972,302220,17724,319944,3806
2021-08-05,San Francisco,075,870044,43819,42301,1704,44005,564
2021-08-05,San Joaquin,077,732212,79813,78151,4070,82221,1468
2021-08-05,San Luis Obispo,079,281455,22977,22362,849,23211,263
2021-08-05,San Mateo,081,765935,46496,45554,656,46210,548
2021-08-05,Santa Barbara,083,443738,36732,36112,1257,37369,470
2021-08-05,Santa Clara,085,1922200,127010,124490,901,125391,2185
2021-08-05,Santa Cruz,087,273765,17285,16867,856,17723,207
2021-08-05,Shasta,089,179085,13573,13217,1830,15047,210
2021-08-05,Sierra,091,2930,78,73,12,85,0
2021-08-05,Siskiyou,093,43540,2147,2024,479,2503,32
2021-08-05,Solano,095,438530,37455,36250,811,37061,262
2021-08-05,Sonoma,097,501317,34529,33455,408,33863,330
2021-08-05,Stanislaus,099,539301,60765,59692,6535,66227,1037
2021-08-05,Sutter,101,95872,10515,10349,111,10460,127
2021-08-05,Tehama,103,63373,5438,5305,642,5947,66
2021-08-05,Trinity,105,12862,528,367,125,492,3
2021-08-05,Tulare,107,460477,52118,50889,10021,60910,854
2021-08-05,Tuolumne,109,53932,4761,4619,46,4665,64
2021-08-05,Ventura,111,848112,86177,84837,3625,88462,1047
2021-08-05,Yolo,113,214977,15724,15250,571,15821,218
2021-08-05,Yuba,115,75493,7036,6872,163,7035,50
2021-08-04,Alameda,001,1643700,100145,97477,2253,99730,1274
2021-08-04,Alpine,003,1148,90,91,0,91,0
2021-08-04,Amador,005,37829,4107,3962,34,3996,48
2021-08-04,Butte,007,227075,13912,13509,2118,15627,205
2021-08-04,Calaveras,009,45235,2463,2374,15,2389,57
2021-08-04,Colusa,011,21464,2093,2025,370,2395,16
2021-08-04,Contra Costa,013,1133247,80322,77966,1580,79546,840
2021-08-04,Del Norte,015,27424,1864,1701,15,1716,8
2021-08-04,El Dorado,017,186661,11789,11319,955,12274,117
2021-08-04,Fresno,019,978130,108261,105899,9359,115258,1747
2021-08-04,Glenn,021,27897,2546,2487,610,3097,20
2021-08-04,Humboldt,023,135768,5626,5271,94,5365,52
2021-08-04,Imperial,025,180216,29577,29375,2795,32170,745
2021-08-04,Inyo,027,18085,1479,1465,14,1479,38
2021-08-04,Kern,029,883053,101623,99868,12479,112347,1358
2021-08-04,Kings,031,150075,24406,23840,1223,25063,250
2021-08-04,Lake,033,64148,4671,4423,20,4443,65
2021-08-04,Lassen,035,31185,5421,5340,127,5467,21
2021-08-04,Los Angeles,037,10098052,1286201,1265788,46743,1312531,24737
2021-08-04,Madera,039,155013,17656,17251,1076,18327,245
2021-08-04,Marin,041,260295,15356,14950,304,15254,239
2021-08-04,Mariposa,043,17540,530,497,11,508,5
2021-08-04,Mendocino,045,87422,4796,4560,108,4668,49
2021-08-04,Merced,047,269075,32598,32274,1149,33423,476
2021-08-04,Modoc,049,8938,431,416,148,564,5
2021-08-04,Mono,051,14174,1324,1307,18,1325,3
2021-08-04,Monterey,053,433212,44324,43926,2065,45991,526
2021-08-04,Napa,055,140530,10760,10544,62,10606,82
2021-08-04,Nevada,057,99092,6106,5702,213,5915,73
2021-08-04,Orange,059,3164182,272079,267199,12507,279706,5146
2021-08-04,Placer,061,380077,26792,25688,2041,27729,305
2021-08-04,Plumas,063,18699,805,784,14,798,5
2021-08-04,Riverside,065,2383286,311236,304272,14841,319113,4562
2021-08-04,Sacramento,067,1510023,121296,117882,2318,120200,1736
2021-08-04,San Benito,069,59416,6356,6300,119,6419,63
2021-08-04,San Bernardino,071,2135413,308913,304164,9547,313711,5285
2021-08-04,San Diego,073,3302833,306459,301100,17657,318757,3805
2021-08-04,San Francisco,075,870044,43565,41913,1691,43604,562
2021-08-04,San Joaquin,077,732212,79456,77846,4058,81904,1466
2021-08-04,San Luis Obispo,079,281455,22869,22245,843,23088,262
2021-08-04,San Mateo,081,765935,46324,45392,655,46047,548
2021-08-04,Santa Barbara,083,443738,36603,36013,1249,37262,470
2021-08-04,Santa Clara,085,1922200,126619,124127,894,125021,2183
2021-08-04,Santa Cruz,087,273765,17223,16820,849,17669,208
2021-08-04,Shasta,089,179085,13522,13134,1819,14953,211
2021-08-04,Sierra,091,2930,78,73,12,85,0
2021-08-04,Siskiyou,093,43540,2127,2010,474,2484,32
2021-08-04,Solano,095,438530,37255,36025,802,36827,262
2021-08-04,Sonoma,097,501317,34357,33311,406,33717,330
2021-08-04,Stanislaus,099,539301,60541,59396,6497,65893,1037
2021-08-04,Sutter,101,95872,10478,10294,111,10405,127
2021-08-04,Tehama,103,63373,5412,5281,637,5918,66
2021-08-04,Trinity,105,12862,526,362,122,484,3
2021-08-04,Tulare,107,460477,52008,50797,9977,60774,855
2021-08-04,Tuolumne,109,53932,4736,4584,46,4630,64
2021-08-04,Ventura,111,848112,85919,84406,3603,88009,1047
2021-08-04,Yolo,113,214977,15645,15189,558,15747,215
2021-08-04,Yuba,115,75493,6996,6827,161,6988,50
2021-08-03,Alameda,001,1643700,99698,97275,2248,99523,1270
2021-08-03,Alpine,003,1148,90,91,0,91,0
2021-08-03,Amador,005,37829,4071,3953,34,3987,48
2021-08-03,Butte,007,227075,13844,13468,2103,15571,205
2021-08-03,Calaveras,009,45235,2441,2356,15,2371,57
2021-08-03,Colusa,011,21464,2080,2023,364,2387,16
2021-08-03,Contra Costa,013,1133247,79840,77739,1573,79312,836
2021-08-03,Del Norte,015,27424,1832,1691,14,1705,8
2021-08-03,El Dorado,017,186661,11699,11255,945,12200,117
2021-08-03,Fresno,019,978130,107899,105732,9327,115059,1746
2021-08-03,Glenn,021,27897,2539,2481,604,3085,20
2021-08-03,Humboldt,023,135768,5561,5199,89,5288,52
2021-08-03,Imperial,025,180216,29555,29333,2788,32121,745
2021-08-03,Inyo,027,18085,1476,1459,14,1473,38
2021-08-03,Kern,029,883053,101361,99708,12400,112108,1358
2021-08-03,Kings,031,150075,24318,23780,1216,24996,249
2021-08-03,Lake,033,64148,4615,4408,16,4424,66
2021-08-03,Lassen,035,31185,5411,5341,127,5468,21
2021-08-03,Los Angeles,037,10098052,1282459,1262678,46564,1309242,24721
2021-08-03,Madera,039,155013,17615,17220,1061,18281,245
2021-08-03,Marin,041,260295,15307,14906,301,15207,243
2021-08-03,Mariposa,043,17540,519,495,11,506,5
2021-08-03,Mendocino,045,87422,4747,4546,107,4653,49
2021-08-03,Merced,047,269075,32515,32197,1147,33344,476
2021-08-03,Modoc,049,8938,431,416,148,564,5
2021-08-03,Mono,051,14174,1319,1303,18,1321,3
2021-08-03,Monterey,053,433212,44260,43872,2052,45924,525
2021-08-03,Napa,055,140530,10717,10527,61,10588,82
2021-08-03,Nevada,057,99092,6025,5685,212,5897,73
2021-08-03,Orange,059,3164182,271340,266649,12477,279126,5146
2021-08-03,Placer,061,380077,26591,25624,2017,27641,305
2021-08-03,Plumas,063,18699,798,779,14,793,5
2021-08-03,Riverside,065,2383286,310312,303499,14814,318313,4562
2021-08-03,Sacramento,067,1510023,120551,117591,2297,119888,1732
2021-08-03,San Benito,069,59416,6341,6284,118,6402,63
2021-08-03,San Bernardino,071,2135413,307992,303386,9527,312913,5265
2021-08-03,San Diego,073,3302833,305020,300189,17547,317736,3803
2021-08-03,San Francisco,075,870044,43283,41758,1671,43429,562
2021-08-03,San Joaquin,077,732212,79107,77615,4037,81652,1461
2021-08-03,San Luis Obispo,079,281455,22729,22166,836,23002,264
2021-08-03,San Mateo,081,765935,46132,45255,650,45905,548
2021-08-03,Santa Barbara,083,443738,36484,35912,1243,37155,469
2021-08-03,Santa Clara,085,1922200,126198,123914,888,124802,2183
2021-08-03,Santa Cruz,087,273765,17157,16778,846,17624,207
2021-08-03,Shasta,089,179085,13448,13091,1808,14899,211
2021-08-03,Sierra,091,2930,78,72,12,84,0
2021-08-03,Siskiyou,093,43540,2116,1998,469,2467,32
2021-08-03,Solano,095,438530,37035,35953,790,36743,261
2021-08-03,Sonoma,097,501317,34176,33243,405,33648,330
2021-08-03,Stanislaus,099,539301,60320,59282,6478,65760,1037
2021-08-03,Sutter,101,95872,10438,10263,110,10373,127
2021-08-03,Tehama,103,63373,5387,5269,632,5901,66
2021-08-03,Trinity,105,12862,523,361,119,480,3
2021-08-03,Tulare,107,460477,51913,50729,9931,60660,854
2021-08-03,Tuolumne,109,53932,4701,4563,46,4609,64
2021-08-03,Ventura,111,848112,85675,84270,3582,87852,1046
2021-08-03,Yolo,113,214977,15553,15149,544,15693,215
2021-08-03,Yuba,115,75493,6959,6781,159,6940,50
2021-08-02,Alameda,001,1643700,99141,96954,2243,99197,1270
2021-08-02,Alpine,003,1148,90,91,0,91,0
2021-08-02,Amador,005,37829,4051,3927,34,3961,48
2021-08-02,Butte,007,227075,13764,13442,2084,15526,205
2021-08-02,Calaveras,009,45235,2416,2347,15,2362,57
2021-08-02,Colusa,011,21464,2068,2019,361,2380,16
2021-08-02,Contra Costa,013,1133247,79331,77516,1559,79075,836
2021-08-02,Del Norte,015,27424,1802,1653,14,1667,8
2021-08-02,El Dorado,017,186661,11595,11226,931,12157,116
2021-08-02,Fresno,019,978130,107552,105471,9290,114761,1744
2021-08-02,Glenn,021,27897,2531,2477,601,3078,20
2021-08-02,Humboldt,023,135768,5478,5161,87,5248,52
2021-08-02,Imperial,025,180216,29522,29302,2785,32087,743
2021-08-02,Inyo,027,18085,1470,1455,14,1469,38
2021-08-02,Kern,029,883053,101106,99556,12307,111863,1357
2021-08-02,Kings,031,150075,24248,23722,1210,24932,249
2021-08-02,Lake,033,64148,4572,4375,16,4391,66
2021-08-02,Lassen,035,31185,5388,5338,125,5463,21
2021-08-02,Los Angeles,037,10098052,1278738,1260807,46355,1307162,24705
2021-08-02,Madera,039,155013,17571,17158,1048,18206,245
2021-08-02,Marin,041,260295,15264,14859,299,15158,239
2021-08-02,Mariposa,043,17540,510,490,11,501,5
2021-08-02,Mendocino,045,87422,4707,4512,104,4616,49
2021-08-02,Merced,047,269075,32417,32163,1140,33303,474
2021-08-02,Modoc,049,8938,431,415,148,563,5
2021-08-02,Mono,051,14174,1312,1296,18,1314,3
2021-08-02,Monterey,053,433212,44200,43842,2044,45886,525
2021-08-02,Napa,055,140530,10674,10490,58,10548,82
2021-08-02,Nevada,057,99092,5954,5611,211,5822,73
2021-08-02,Orange,059,3164182,270426,266050,12431,278481,5146
2021-08-02,Placer,061,380077,26444,25516,1983,27499,306
2021-08-02,Plumas,063,18699,791,762,14,776,5
2021-08-02,Riverside,065,2383286,309374,302756,14799,317555,4562
2021-08-02,Sacramento,067,1510023,119854,117183,2276,119459,1728
2021-08-02,San Benito,069,59416,6322,6276,117,6393,63
2021-08-02,San Bernardino,071,2135413,307116,303000,9495,312495,5253
2021-08-02,San Diego,073,3302833,303540,299021,17467,316488,3798
2021-08-02,San Francisco,075,870044,42997,41553,1647,43200,562
2021-08-02,San Joaquin,077,732212,78764,77447,4010,81457,1461
2021-08-02,San Luis Obispo,079,281455,22635,22093,829,22922,261
2021-08-02,San Mateo,081,765935,45955,45154,637,45791,548
2021-08-02,Santa Barbara,083,443738,36345,35851,1237,37088,469
2021-08-02,Santa Clara,085,1922200,125728,123655,880,124535,2183
2021-08-02,Santa Cruz,087,273765,17099,16746,842,17588,207
2021-08-02,Shasta,089,179085,13385,13049,1794,14843,212
2021-08-02,Sierra,091,2930,78,71,12,83,0
2021-08-02,Siskiyou,093,43540,2105,1992,455,2447,31
2021-08-02,Solano,095,438530,36787,35852,777,36629,260
2021-08-02,Sonoma,097,501317,33950,33132,400,33532,330
2021-08-02,Stanislaus,099,539301,60101,59160,6450,65610,1037
2021-08-02,Sutter,101,95872,10392,10220,110,10330,127
2021-08-02,Tehama,103,63373,5363,5260,628,5888,66
2021-08-02,Trinity,105,12862,518,359,118,477,3
2021-08-02,Tulare,107,460477,51811,50640,9858,60498,854
2021-08-02,Tuolumne,109,53932,4634,4524,46,4570,64
2021-08-02,Ventura,111,848112,85490,84143,3559,87702,1044
2021-08-02,Yolo,113,214977,15455,15072,526,15598,215
2021-08-02,Yuba,115,75493,6917,6743,156,6899,50
2021-08-01,Alameda,001,1643700,98609,96775,2237,99012,1270
2021-08-01,Alpine,003,1148,90,91,0,91,0
2021-08-01,Amador,005,37829,4013,3923,34,3957,48
2021-08-01,Butte,007,227075,13683,13406,2067,15473,205
2021-08-01,Calaveras,009,45235,2392,2341,15,2356,57
2021-08-01,Colusa,011,21464,2057,2014,359,2373,16
2021-08-01,Contra Costa,013,1133247,78896,77360,1551,78911,836
2021-08-01,Del Norte,015,27424,1770,1642,14,1656,8
2021-08-01,El Dorado,017,186661,11494,11189,920,12109,116
2021-08-01,Fresno,019,978130,107226,105339,9243,114582,1744
2021-08-01,Glenn,021,27897,2525,2476,598,3074,20
2021-08-01,Humboldt,023,135768,5401,5118,83,5201,52
2021-08-01,Imperial,025,180216,29487,29297,2780,32077,743
2021-08-01,Inyo,027,18085,1468,1454,14,1468,38
2021-08-01,Kern,029,883053,100828,99396,12233,111629,1357
2021-08-01,Kings,031,150075,24161,23700,1205,24905,249
2021-08-01,Lake,033,64148,4493,4356,16,4372,66
2021-08-01,Lassen,035,31185,5375,5336,123,5459,21
2021-08-01,Los Angeles,037,10098052,1275051,1258461,46130,1304591,24700
2021-08-01,Madera,039,155013,17514,17146,1043,18189,245
2021-08-01,Marin,041,260295,15187,14844,298,15142,239
2021-08-01,Mariposa,043,17540,503,482,11,493,5
2021-08-01,Mendocino,045,87422,4661,4476,100,4576,49
2021-08-01,Merced,047,269075,32326,32144,1134,33278,474
2021-08-01,Modoc,049,8938,429,413,148,561,5
2021-08-01,Mono,051,14174,1309,1294,18,1312,3
2021-08-01,Monterey,053,433212,44153,43808,2031,45839,525
2021-08-01,Napa,055,140530,10626,10473,56,10529,82
2021-08-01,Nevada,057,99092,5867,5561,210,5771,73
2021-08-01,Orange,059,3164182,269613,265467,12388,277855,5146
2021-08-01,Placer,061,380077,26229,25464,1953,27417,306
2021-08-01,Plumas,063,18699,785,761,14,775,5
2021-08-01,Riverside,065,2383286,308441,302256,14781,317037,4562
2021-08-01,Sacramento,067,1510023,119118,116923,2260,119183,1727
2021-08-01,San Benito,069,59416,6305,6271,117,6388,63
2021-08-01,San Bernardino,071,2135413,306181,302542,9485,312027,5248
2021-08-01,San Diego,073,3302833,302354,298002,17402,315404,3798
2021-08-01,San Francisco,075,870044,42659,41432,1634,43066,562
2021-08-01,San Joaquin,077,732212,78397,77338,3983,81321,1461
2021-08-01,San Luis Obispo,079,281455,22532,22083,824,22907,261
2021-08-01,San Mateo,081,765935,45773,45036,629,45665,548
2021-08-01,Santa Barbara,083,443738,36221,35809,1233,37042,469
2021-08-01,Santa Clara,085,1922200,125316,123511,872,124383,2183
2021-08-01,Santa Cruz,087,273765,17020,16709,835,17544,207
2021-08-01,Shasta,089,179085,13314,13036,1785,14821,212
2021-08-01,Sierra,091,2930,76,71,12,83,0
2021-08-01,Siskiyou,093,43540,2099,1989,449,2438,31
2021-08-01,Solano,095,438530,36552,35800,768,36568,260
2021-08-01,Sonoma,097,501317,33758,33076,397,33473,330
2021-08-01,Stanislaus,099,539301,59864,59078,6418,65496,1037
2021-08-01,Sutter,101,95872,10337,10198,107,10305,127
2021-08-01,Tehama,103,63373,5346,5252,624,5876,66
2021-08-01,Trinity,105,12862,515,359,117,476,3
2021-08-01,Tulare,107,460477,51654,50600,9797,60397,854
2021-08-01,Tuolumne,109,53932,4596,4489,46,4535,64
2021-08-01,Ventura,111,848112,85260,84040,3544,87584,1044
2021-08-01,Yolo,113,214977,15383,15042,517,15559,215
2021-08-01,Yuba,115,75493,6880,6721,155,6876,50
2021-07-31,Alameda,001,1643700,98277,95279,2232,97511,1265
2021-07-31,Alpine,003,1148,90,89,0,89,0
2021-07-31,Amador,005,37829,3993,3877,34,3911,48
2021-07-31,Butte,007,227075,13650,13235,2047,15282,205
2021-07-31,Calaveras,009,45235,2383,2294,15,2309,57
2021-07-31,Colusa,011,21464,2051,2006,357,2363,16
2021-07-31,Contra Costa,013,1133247,78617,75866,1549,77415,832
2021-07-31,Del Norte,015,27424,1744,1576,14,1590,8
2021-07-31,El Dorado,017,186661,11441,11017,914,11931,116
2021-07-31,Fresno,019,978130,107067,104639,9229,113868,1744
2021-07-31,Glenn,021,27897,2520,2465,593,3058,20
2021-07-31,Humboldt,023,135768,5346,4978,82,5060,52
2021-07-31,Imperial,025,180216,29470,29164,2777,31941,743
2021-07-31,Inyo,027,18085,1465,1442,14,1456,38
2021-07-31,Kern,029,883053,100663,98903,12174,111077,1357
2021-07-31,Kings,031,150075,24108,23548,1200,24748,248
2021-07-31,Lake,033,64148,4468,4238,16,4254,66
2021-07-31,Lassen,035,31185,5368,5320,123,5443,21
2021-07-31,Los Angeles,037,10098052,1272853,1248545,45984,1294529,24691
2021-07-31,Madera,039,155013,17481,17058,1037,18095,245
2021-07-31,Marin,041,260295,15143,14701,297,14998,239
2021-07-31,Mariposa,043,17540,494,470,11,481,5
2021-07-31,Mendocino,045,87422,4636,4400,97,4497,49
2021-07-31,Merced,047,269075,32278,31959,1129,33088,474
2021-07-31,Modoc,049,8938,429,413,148,561,5
2021-07-31,Mono,051,14174,1307,1287,18,1305,3
2021-07-31,Monterey,053,433212,44113,43720,2021,45741,525
2021-07-31,Napa,055,140530,10606,10401,55,10456,82
2021-07-31,Nevada,057,99092,5828,5373,209,5582,72
2021-07-31,Orange,059,3164182,269039,263446,12369,275815,5144
2021-07-31,Placer,061,380077,26096,25104,1946,27050,306
2021-07-31,Plumas,063,18699,782,743,14,757,5
2021-07-31,Riverside,065,2383286,307825,300315,14771,315086,4554
2021-07-31,Sacramento,067,1510023,118706,115259,2254,117513,1720
2021-07-31,San Benito,069,59416,6294,6251,117,6368,63
2021-07-31,San Bernardino,071,2135413,305610,300726,9482,310208,5240
2021-07-31,San Diego,073,3302833,301681,295054,17356,312410,3798
2021-07-31,San Francisco,075,870044,42431,40412,1614,42026,562
2021-07-31,San Joaquin,077,732212,78232,76575,3970,80545,1443
2021-07-31,San Luis Obispo,079,281455,22478,21922,822,22744,260
2021-07-31,San Mateo,081,765935,45616,44622,624,45246,548
2021-07-31,Santa Barbara,083,443738,36140,35531,1232,36763,467
2021-07-31,Santa Clara,085,1922200,125061,122614,870,123484,2099
2021-07-31,Santa Cruz,087,273765,16981,16576,834,17410,207
2021-07-31,Shasta,089,179085,13277,12918,1777,14695,212
2021-07-31,Sierra,091,2930,76,68,12,80,0
2021-07-31,Siskiyou,093,43540,2090,1976,443,2419,31
2021-07-31,Solano,095,438530,36451,35340,760,36100,263
2021-07-31,Sonoma,097,501317,33632,32601,397,32998,329
2021-07-31,Stanislaus,099,539301,59705,58586,6395,64981,1035
2021-07-31,Sutter,101,95872,10303,10068,106,10174,127
2021-07-31,Tehama,103,63373,5331,5216,621,5837,66
2021-07-31,Trinity,105,12862,514,354,116,470,3
2021-07-31,Tulare,107,460477,51565,50409,9744,60153,854
2021-07-31,Tuolumne,109,53932,4557,4362,46,4408,64
2021-07-31,Ventura,111,848112,85099,83509,3527,87036,1044
2021-07-31,Yolo,113,214977,15335,14863,506,15369,215
2021-07-31,Yuba,115,75493,6857,6615,151,6766,50
2021-07-30,Alameda,001,1643700,97943,95279,2228,97507,1265
2021-07-30,Alpine,003,1148,90,89,0,89,0
2021-07-30,Amador,005,37829,3970,3877,34,3911,48
2021-07-30,Butte,007,227075,13595,13235,2034,15269,205
2021-07-30,Calaveras,009,45235,2373,2294,15,2309,57
2021-07-30,Colusa,011,21464,2047,2006,355,2361,16
2021-07-30,Contra Costa,013,1133247,78373,75866,1545,77411,832
2021-07-30,Del Norte,015,27424,1726,1576,14,1590,8
2021-07-30,El Dorado,017,186661,11407,11017,908,11925,116
2021-07-30,Fresno,019,978130,106873,104639,9217,113856,1744
2021-07-30,Glenn,021,27897,2515,2465,592,3057,20
2021-07-30,Humboldt,023,135768,5283,4978,79,5057,52
2021-07-30,Imperial,025,180216,29456,29164,2774,31938,743
2021-07-30,Inyo,027,18085,1464,1442,14,1456,38
2021-07-30,Kern,029,883053,100539,98903,12127,111030,1357
2021-07-30,Kings,031,150075,24068,23548,1196,24744,248
2021-07-30,Lake,033,64148,4440,4238,16,4254,66
2021-07-30,Lassen,035,31185,5364,5320,123,5443,21
2021-07-30,Los Angeles,037,10098052,1270532,1248545,45833,1294378,24691
2021-07-30,Madera,039,155013,17439,17058,1034,18092,245
2021-07-30,Marin,041,260295,15109,14701,297,14998,239
2021-07-30,Mariposa,043,17540,490,470,11,481,5
2021-07-30,Mendocino,045,87422,4606,4400,96,4496,49
2021-07-30,Merced,047,269075,32237,31959,1125,33084,474
2021-07-30,Modoc,049,8938,427,413,148,561,5
2021-07-30,Mono,051,14174,1302,1287,18,1305,3
2021-07-30,Monterey,053,433212,44079,43720,2012,45732,525
2021-07-30,Napa,055,140530,10584,10401,54,10455,82
2021-07-30,Nevada,057,99092,5771,5373,209,5582,72
2021-07-30,Orange,059,3164182,268413,263446,12343,275789,5144
2021-07-30,Placer,061,380077,26007,25104,1928,27032,306
2021-07-30,Plumas,063,18699,777,743,14,757,5
2021-07-30,Riverside,065,2383286,307187,300315,14761,315076,4554
2021-07-30,Sacramento,067,1510023,118255,115259,2250,117509,1720
2021-07-30,San Benito,069,59416,6287,6251,117,6368,63
2021-07-30,San Bernardino,071,2135413,305097,300726,9476,310202,5240
2021-07-30,San Diego,073,3302833,300907,295054,17298,312352,3798
2021-07-30,San Francisco,075,870044,42218,40412,1599,42011,562
2021-07-30,San Joaquin,077,732212,78078,76575,3965,80540,1443
2021-07-30,San Luis Obispo,079,281455,22440,21922,818,22740,260
2021-07-30,San Mateo,081,765935,45491,44622,611,45233,548
2021-07-30,Santa Barbara,083,443738,36071,35531,1226,36757,467
2021-07-30,Santa Clara,085,1922200,124838,122614,868,123482,2099
2021-07-30,Santa Cruz,087,273765,16955,16576,832,17408,207
2021-07-30,Shasta,089,179085,13232,12918,1777,14695,212
2021-07-30,Sierra,091,2930,75,68,12,80,0
2021-07-30,Siskiyou,093,43540,2081,1976,442,2418,31
2021-07-30,Solano,095,438530,36360,35340,744,36084,263
2021-07-30,Sonoma,097,501317,33537,32601,397,32998,329
2021-07-30,Stanislaus,099,539301,59559,58586,6375,64961,1035
2021-07-30,Sutter,101,95872,10268,10068,106,10174,127
2021-07-30,Tehama,103,63373,5320,5216,621,5837,66
2021-07-30,Trinity,105,12862,514,354,116,470,3
2021-07-30,Tulare,107,460477,51522,50409,9709,60118,854
2021-07-30,Tuolumne,109,53932,4539,4362,46,4408,64
2021-07-30,Ventura,111,848112,84935,83509,3512,87021,1044
2021-07-30,Yolo,113,214977,15274,14863,502,15365,215
2021-07-30,Yuba,115,75493,6821,6615,150,6765,50
2021-07-29,Alameda,001,1643700,97525,95279,2222,97501,1265
2021-07-29,Alpine,003,1148,90,89,0,89,0
2021-07-29,Amador,005,37829,3951,3877,34,3911,48
2021-07-29,Butte,007,227075,13548,13235,2026,15261,205
2021-07-29,Calaveras,009,45235,2358,2294,15,2309,57
2021-07-29,Colusa,011,21464,2040,2006,355,2361,16
2021-07-29,Contra Costa,013,1133247,77934,75866,1541,77407,832
2021-07-29,Del Norte,015,27424,1702,1576,14,1590,8
2021-07-29,El Dorado,017,186661,11343,11017,896,11913,116
2021-07-29,Fresno,019,978130,106608,104639,9189,113828,1744
2021-07-29,Glenn,021,27897,2505,2465,591,3056,20
2021-07-29,Humboldt,023,135768,5223,4978,77,5055,52
2021-07-29,Imperial,025,180216,29411,29164,2772,31936,743
2021-07-29,Inyo,027,18085,1460,1442,14,1456,38
2021-07-29,Kern,029,883053,100332,98903,12049,110952,1357
2021-07-29,Kings,031,150075,24022,23548,1192,24740,248
2021-07-29,Lake,033,64148,4405,4238,16,4254,66
2021-07-29,Lassen,035,31185,5356,5320,120,5440,21
2021-07-29,Los Angeles,037,10098052,1267439,1248545,45649,1294194,24691
2021-07-29,Madera,039,155013,17392,17058,1030,18088,245
2021-07-29,Marin,041,260295,15066,14701,297,14998,239
2021-07-29,Mariposa,043,17540,486,470,11,481,5
2021-07-29,Mendocino,045,87422,4583,4400,94,4494,49
2021-07-29,Merced,047,269075,32182,31959,1125,33084,474
2021-07-29,Modoc,049,8938,427,413,148,561,5
2021-07-29,Mono,051,14174,1300,1287,18,1305,3
2021-07-29,Monterey,053,433212,44030,43720,2002,45722,525
2021-07-29,Napa,055,140530,10552,10401,52,10453,82
2021-07-29,Nevada,057,99092,5719,5373,208,5581,72
2021-07-29,Orange,059,3164182,267701,263446,12311,275757,5144
2021-07-29,Placer,061,380077,25884,25104,1913,27017,306
2021-07-29,Plumas,063,18699,769,743,14,757,5
2021-07-29,Riverside,065,2383286,306482,300315,14737,315052,4554
2021-07-29,Sacramento,067,1510023,117700,115259,2237,117496,1720
2021-07-29,San Benito,069,59416,6276,6251,117,6368,63
2021-07-29,San Bernardino,071,2135413,304459,300726,9466,310192,5240
2021-07-29,San Diego,073,3302833,299850,295054,17230,312284,3798
2021-07-29,San Francisco,075,870044,41971,40412,1578,41990,562
2021-07-29,San Joaquin,077,732212,77822,76575,3957,80532,1443
2021-07-29,San Luis Obispo,079,281455,22386,21922,816,22738,260
2021-07-29,San Mateo,081,765935,45364,44622,601,45223,548
2021-07-29,Santa Barbara,083,443738,35985,35531,1225,36756,467
2021-07-29,Santa Clara,085,1922200,124541,122614,865,123479,2099
2021-07-29,Santa Cruz,087,273765,16902,16576,830,17406,207
2021-07-29,Shasta,089,179085,13178,12918,1768,14686,212
2021-07-29,Sierra,091,2930,75,68,12,80,0
2021-07-29,Siskiyou,093,43540,2076,1976,440,2416,31
2021-07-29,Solano,095,438530,36200,35340,734,36074,263
2021-07-29,Sonoma,097,501317,33363,32601,395,32996,329
2021-07-29,Stanislaus,099,539301,59387,58586,6360,64946,1035
2021-07-29,Sutter,101,95872,10222,10068,105,10173,127
2021-07-29,Tehama,103,63373,5308,5216,615,5831,66
2021-07-29,Trinity,105,12862,512,354,115,469,3
2021-07-29,Tulare,107,460477,51432,50409,9669,60078,854
2021-07-29,Tuolumne,109,53932,4499,4362,45,4407,64
2021-07-29,Ventura,111,848112,84769,83509,3505,87014,1044
2021-07-29,Yolo,113,214977,15205,14863,488,15351,215
2021-07-29,Yuba,115,75493,6772,6615,147,6762,50
2021-07-28,Alameda,001,1643700,97058,94965,2215,97180,1262
2021-07-28,Alpine,003,1148,90,89,0,89,0
2021-07-28,Amador,005,37829,3937,3870,34,3904,48
2021-07-28,Butte,007,227075,13491,13184,2013,15197,205
2021-07-28,Calaveras,009,45235,2337,2289,15,2304,57
2021-07-28,Colusa,011,21464,2037,2001,354,2355,16
2021-07-28,Contra Costa,013,1133247,77447,75487,1533,77020,832
2021-07-28,Del Norte,015,27424,1669,1545,14,1559,8
2021-07-28,El Dorado,017,186661,11294,10967,887,11854,116
2021-07-28,Fresno,019,978130,106360,104458,9168,113626,1744
2021-07-28,Glenn,021,27897,2502,2464,588,3052,20
2021-07-28,Humboldt,023,135768,5172,4946,76,5022,52
2021-07-28,Imperial,025,180216,29364,29096,2772,31868,743
2021-07-28,Inyo,027,18085,1454,1439,13,1452,38
2021-07-28,Kern,029,883053,100176,98781,12003,110784,1352
2021-07-28,Kings,031,150075,23958,23503,1182,24685,248
2021-07-28,Lake,033,64148,4359,4191,15,4206,65
2021-07-28,Lassen,035,31185,5348,5318,120,5438,21
2021-07-28,Los Angeles,037,10098052,1264265,1245485,45462,1290947,24673
2021-07-28,Madera,039,155013,17351,17024,1024,18048,245
2021-07-28,Marin,041,260295,15011,14652,297,14949,239
2021-07-28,Mariposa,043,17540,479,469,11,480,5
2021-07-28,Mendocino,045,87422,4555,4377,94,4471,49
2021-07-28,Merced,047,269075,32126,31886,1121,33007,474
2021-07-28,Modoc,049,8938,425,413,148,561,5
2021-07-28,Mono,051,14174,1299,1286,18,1304,3
2021-07-28,Monterey,053,433212,43983,43668,1992,45660,524
2021-07-28,Napa,055,140530,10512,10376,50,10426,82
2021-07-28,Nevada,057,99092,5665,5320,208,5528,72
2021-07-28,Orange,059,3164182,266908,262735,12281,275016,5143
2021-07-28,Placer,061,380077,25737,24978,1897,26875,306
2021-07-28,Plumas,063,18699,764,754,14,768,5
2021-07-28,Riverside,065,2383286,305715,299611,14718,314329,4554
2021-07-28,Sacramento,067,1510023,117049,114665,2217,116882,1714
2021-07-28,San Benito,069,59416,6265,6236,117,6353,63
2021-07-28,San Bernardino,071,2135413,303838,300121,9454,309575,5236
2021-07-28,San Diego,073,3302833,298577,294176,17157,311333,3798
2021-07-28,San Francisco,075,870044,41668,40144,1552,41696,561
2021-07-28,San Joaquin,077,732212,77571,76312,3927,80239,1443
2021-07-28,San Luis Obispo,079,281455,22327,21865,815,22680,260
2021-07-28,San Mateo,081,765935,45214,44477,592,45069,547
2021-07-28,Santa Barbara,083,443738,35910,35431,1220,36651,467
2021-07-28,Santa Clara,085,1922200,124280,122345,863,123208,2099
2021-07-28,Santa Cruz,087,273765,16864,16551,829,17380,207
2021-07-28,Shasta,089,179085,13133,12882,1758,14640,212
2021-07-28,Sierra,091,2930,71,67,12,79,0
2021-07-28,Siskiyou,093,43540,2067,1971,437,2408,31
2021-07-28,Solano,095,438530,36026,35204,727,35931,262
2021-07-28,Sonoma,097,501317,33220,32434,392,32826,328
2021-07-28,Stanislaus,099,539301,59190,58427,6344,64771,1035
2021-07-28,Sutter,101,95872,10190,10033,104,10137,126
2021-07-28,Tehama,103,63373,5296,5209,612,5821,66
2021-07-28,Trinity,105,12862,511,352,115,467,3
2021-07-28,Tulare,107,460477,51344,50363,9622,59985,854
2021-07-28,Tuolumne,109,53932,4460,4313,45,4358,64
2021-07-28,Ventura,111,848112,84573,83360,3489,86849,1043
2021-07-28,Yolo,113,214977,15133,14801,479,15280,215
2021-07-28,Yuba,115,75493,6739,6591,146,6737,51
2021-07-27,Alameda,001,1643700,96653,94682,2206,96888,1256
2021-07-27,Alpine,003,1148,90,89,0,89,0
2021-07-27,Amador,005,37829,3921,3861,34,3895,48
2021-07-27,Butte,007,227075,13443,13127,2002,15129,205
2021-07-27,Calaveras,009,45235,2326,2280,15,2295,57
2021-07-27,Colusa,011,21464,2028,1999,353,2352,16
2021-07-27,Contra Costa,013,1133247,76962,75227,1529,76756,830
2021-07-27,Del Norte,015,27424,1649,1538,14,1552,8
2021-07-27,El Dorado,017,186661,11234,10941,877,11818,116
2021-07-27,Fresno,019,978130,106067,104288,9145,113433,1746
2021-07-27,Glenn,021,27897,2494,2460,586,3046,20
2021-07-27,Humboldt,023,135768,5118,4925,75,5000,52
2021-07-27,Imperial,025,180216,29319,29048,2771,31819,743
2021-07-27,Inyo,027,18085,1452,1430,13,1443,38
2021-07-27,Kern,029,883053,100006,98724,11947,110671,1352
2021-07-27,Kings,031,150075,23901,23463,1172,24635,248
2021-07-27,Lake,033,64148,4320,4157,15,4172,65
2021-07-27,Lassen,035,31185,5342,5315,120,5435,21
2021-07-27,Los Angeles,037,10098052,1260805,1243336,45252,1288588,24658
2021-07-27,Madera,039,155013,17298,16998,1018,18016,245
2021-07-27,Marin,041,260295,14963,14631,294,14925,239
2021-07-27,Mariposa,043,17540,476,468,11,479,5
2021-07-27,Mendocino,045,87422,4532,4371,94,4465,49
2021-07-27,Merced,047,269075,32059,31825,1118,32943,473
2021-07-27,Modoc,049,8938,424,413,148,561,5
2021-07-27,Mono,051,14174,1295,1288,18,1306,3
2021-07-27,Monterey,053,433212,43943,43646,1981,45627,523
2021-07-27,Napa,055,140530,10482,10354,50,10404,82
2021-07-27,Nevada,057,99092,5588,5305,206,5511,72
2021-07-27,Orange,059,3164182,266164,262193,12255,274448,5143
2021-07-27,Placer,061,380077,25578,24916,1871,26787,306
2021-07-27,Plumas,063,18699,761,752,14,766,5
2021-07-27,Riverside,065,2383286,304986,299160,14699,313859,4554
2021-07-27,Sacramento,067,1510023,116446,114413,2208,116621,1710
2021-07-27,San Benito,069,59416,6256,6229,117,6346,63
2021-07-27,San Bernardino,071,2135413,303151,299593,9432,309025,5236
2021-07-27,San Diego,073,3302833,297488,293408,17078,310486,3798
2021-07-27,San Francisco,075,870044,41312,39939,1534,41473,561
2021-07-27,San Joaquin,077,732212,77308,76166,3908,80074,1442
2021-07-27,San Luis Obispo,079,281455,22272,21803,806,22609,260
2021-07-27,San Mateo,081,765935,45063,44378,589,44967,547
2021-07-27,Santa Barbara,083,443738,35815,35355,1218,36573,467
2021-07-27,Santa Clara,085,1922200,123986,122154,861,123015,2099
2021-07-27,Santa Cruz,087,273765,16818,16523,828,17351,207
2021-07-27,Shasta,089,179085,13083,12846,1745,14591,212
2021-07-27,Sierra,091,2930,71,65,12,77,0
2021-07-27,Siskiyou,093,43540,2062,1964,434,2398,31
2021-07-27,Solano,095,438530,35894,35093,717,35810,261
2021-07-27,Sonoma,097,501317,33076,32367,390,32757,328
2021-07-27,Stanislaus,099,539301,59022,58333,6316,64649,1033
2021-07-27,Sutter,101,95872,10149,9998,104,10102,115
2021-07-27,Tehama,103,63373,5275,5192,610,5802,66
2021-07-27,Trinity,105,12862,510,351,115,466,3
2021-07-27,Tulare,107,460477,51278,50324,9591,59915,854
2021-07-27,Tuolumne,109,53932,4408,4282,45,4327,64
2021-07-27,Ventura,111,848112,84365,83189,3477,86666,1043
2021-07-27,Yolo,113,214977,15059,14759,474,15233,215
2021-07-27,Yuba,115,75493,6717,6564,144,6708,51
2021-07-26,Alameda,001,1643700,96208,94436,2202,96638,1259
2021-07-26,Alpine,003,1148,90,89,0,89,0
2021-07-26,Amador,005,37829,3911,3854,34,3888,48
2021-07-26,Butte,007,227075,13388,13082,1991,15073,203
2021-07-26,Calaveras,009,45235,2320,2276,15,2291,57
2021-07-26,Colusa,011,21464,2021,1996,351,2347,16
2021-07-26,Contra Costa,013,1133247,76465,74854,1522,76376,830
2021-07-26,Del Norte,015,27424,1628,1530,14,1544,8
2021-07-26,El Dorado,017,186661,11170,10899,874,11773,116
2021-07-26,Fresno,019,978130,105863,104143,9122,113265,1742
2021-07-26,Glenn,021,27897,2492,2461,585,3046,20
2021-07-26,Humboldt,023,135768,5079,4906,73,4979,52
2021-07-26,Imperial,025,180216,29279,29034,2771,31805,743
2021-07-26,Inyo,027,18085,1447,1429,13,1442,38
2021-07-26,Kern,029,883053,99840,98633,11882,110515,1351
2021-07-26,Kings,031,150075,23852,23426,1168,24594,247
2021-07-26,Lake,033,64148,4299,4133,15,4148,65
2021-07-26,Lassen,035,31185,5338,5314,120,5434,21
2021-07-26,Los Angeles,037,10098052,1257466,1241527,45079,1286606,24647
2021-07-26,Madera,039,155013,17270,16971,1011,17982,245
2021-07-26,Marin,041,260295,14906,14579,293,14872,239
2021-07-26,Mariposa,043,17540,475,467,11,478,5
2021-07-26,Mendocino,045,87422,4511,4354,94,4448,49
2021-07-26,Merced,047,269075,31968,31774,1114,32888,473
2021-07-26,Modoc,049,8938,424,413,148,561,5
2021-07-26,Mono,051,14174,1294,1286,18,1304,3
2021-07-26,Monterey,053,433212,43900,43595,1969,45564,521
2021-07-26,Napa,055,140530,10459,10332,50,10382,82
2021-07-26,Nevada,057,99092,5502,5280,206,5486,72
2021-07-26,Orange,059,3164182,265525,261803,12234,274037,5142
2021-07-26,Placer,061,380077,25442,24842,1850,26692,304
2021-07-26,Plumas,063,18699,757,750,14,764,5
2021-07-26,Riverside,065,2383286,304293,298626,14685,313311,4553
2021-07-26,Sacramento,067,1510023,115847,113986,2192,116178,1705
2021-07-26,San Benito,069,59416,6250,6222,117,6339,63
2021-07-26,San Bernardino,071,2135413,302535,299238,9420,308658,5237
2021-07-26,San Diego,073,3302833,296381,292688,16996,309684,3793
2021-07-26,San Francisco,075,870044,40951,39800,1508,41308,561
2021-07-26,San Joaquin,077,732212,77073,76033,3904,79937,1440
2021-07-26,San Luis Obispo,079,281455,22223,21752,803,22555,260
2021-07-26,San Mateo,081,765935,44915,44297,580,44877,547
2021-07-26,Santa Barbara,083,443738,35742,35311,1206,36517,467
2021-07-26,Santa Clara,085,1922200,123677,121978,852,122830,2099
2021-07-26,Santa Cruz,087,273765,16778,16493,825,17318,207
2021-07-26,Shasta,089,179085,13034,12819,1732,14551,211
2021-07-26,Sierra,091,2930,70,65,12,77,0
2021-07-26,Siskiyou,093,43540,2059,1962,432,2394,31
2021-07-26,Solano,095,438530,35739,34990,709,35699,259
2021-07-26,Sonoma,097,501317,32940,32283,388,32671,328
2021-07-26,Stanislaus,099,539301,58877,58219,6296,64515,1033
2021-07-26,Sutter,101,95872,10109,9963,101,10064,115
2021-07-26,Tehama,103,63373,5265,5183,606,5789,66
2021-07-26,Trinity,105,12862,510,351,114,465,3
2021-07-26,Tulare,107,460477,51212,50265,9560,59825,854
2021-07-26,Tuolumne,109,53932,4377,4271,45,4316,64
2021-07-26,Ventura,111,848112,84192,83072,3462,86534,1041
2021-07-26,Yolo,113,214977,14998,14727,462,15189,215
2021-07-26,Yuba,115,75493,6683,6538,142,6680,51
2021-07-25,Alameda,001,1643700,95715,94146,2196,96342,1259
2021-07-25,Alpine,003,1148,88,89,0,89,0
2021-07-25,Amador,005,37829,3896,3848,34,3882,48
2021-07-25,Butte,007,227075,13349,13074,1981,15055,203
2021-07-25,Calaveras,009,45235,2310,2275,15,2290,57
2021-07-25,Colusa,011,21464,2012,1996,347,2343,16
2021-07-25,Contra Costa,013,1133247,75980,74634,1508,76142,830
2021-07-25,Del Norte,015,27424,1607,1526,14,1540,8
2021-07-25,El Dorado,017,186661,11113,10878,870,11748,116
2021-07-25,Fresno,019,978130,105622,104019,9106,113125,1742
2021-07-25,Glenn,021,27897,2483,2461,583,3044,20
2021-07-25,Humboldt,023,135768,5020,4892,72,4964,52
2021-07-25,Imperial,025,180216,29242,29037,2771,31808,743
2021-07-25,Inyo,027,18085,1442,1427,13,1440,38
2021-07-25,Kern,029,883053,99668,98503,11811,110314,1351
2021-07-25,Kings,031,150075,23798,23396,1164,24560,247
2021-07-25,Lake,033,64148,4246,4109,14,4123,65
2021-07-25,Lassen,035,31185,5333,5314,120,5434,21
2021-07-25,Los Angeles,037,10098052,1254048,1239596,44883,1284479,24643
2021-07-25,Madera,039,155013,17233,16947,1004,17951,245
2021-07-25,Marin,041,260295,14856,14558,290,14848,239
2021-07-25,Mariposa,043,17540,472,465,11,476,5
2021-07-25,Mendocino,045,87422,4482,4335,92,4427,49
2021-07-25,Merced,047,269075,31895,31760,1112,32872,473
2021-07-25,Modoc,049,8938,424,413,148,561,5
2021-07-25,Mono,051,14174,1291,1286,18,1304,3
2021-07-25,Monterey,053,433212,43862,43590,1961,45551,521
2021-07-25,Napa,055,140530,10423,10316,49,10365,82
2021-07-25,Nevada,057,99092,5437,5256,203,5459,72
2021-07-25,Orange,059,3164182,264817,261351,12211,273562,5142
2021-07-25,Placer,061,380077,25320,24755,1829,26584,304
2021-07-25,Plumas,063,18699,755,750,14,764,5
2021-07-25,Riverside,065,2383286,303528,298181,14667,312848,4553
2021-07-25,Sacramento,067,1510023,115297,113611,2176,115787,1704
2021-07-25,San Benito,069,59416,6243,6217,117,6334,63
2021-07-25,San Bernardino,071,2135413,301874,298982,9414,308396,5237
2021-07-25,San Diego,073,3302833,295319,290626,16922,307548,3793
2021-07-25,San Francisco,075,870044,40601,39663,1482,41145,561
2021-07-25,San Joaquin,077,732212,76818,75926,3885,79811,1440
2021-07-25,San Luis Obispo,079,281455,22150,21741,800,22541,260
2021-07-25,San Mateo,081,765935,44752,44189,574,44763,547
2021-07-25,Santa Barbara,083,443738,35662,35261,1203,36464,467
2021-07-25,Santa Clara,085,1922200,123347,121800,847,122647,2099
2021-07-25,Santa Cruz,087,273765,16731,16474,824,17298,207
2021-07-25,Shasta,089,179085,12987,12815,1727,14542,211
2021-07-25,Sierra,091,2930,70,65,12,77,0
2021-07-25,Siskiyou,093,43540,2051,1963,429,2392,31
2021-07-25,Solano,095,438530,35547,34863,706,35569,259
2021-07-25,Sonoma,097,501317,32815,32202,385,32587,328
2021-07-25,Stanislaus,099,539301,58711,58154,6291,64445,1033
2021-07-25,Sutter,101,95872,10056,9937,99,10036,115
2021-07-25,Tehama,103,63373,5249,5181,605,5786,66
2021-07-25,Trinity,105,12862,508,351,112,463,3
2021-07-25,Tulare,107,460477,51137,50221,9522,59743,854
2021-07-25,Tuolumne,109,53932,4325,4267,45,4312,64
2021-07-25,Ventura,111,848112,83978,82986,3439,86425,1041
2021-07-25,Yolo,113,214977,14937,14693,448,15141,215
2021-07-25,Yuba,115,75493,6650,6519,142,6661,51
2021-07-24,Alameda,001,1643700,95436,93170,2192,95362,1259
2021-07-24,Alpine,003,1148,88,89,0,89,0
2021-07-24,Amador,005,37829,3887,3816,34,3850,48
2021-07-24,Butte,007,227075,13320,12982,1979,14961,203
2021-07-24,Calaveras,009,45235,2305,2267,15,2282,57
2021-07-24,Colusa,011,21464,2011,1992,345,2337,16
2021-07-24,Contra Costa,013,1133247,75752,73682,1505,75187,830
2021-07-24,Del Norte,015,27424,1596,1497,14,1511,8
2021-07-24,El Dorado,017,186661,11079,10773,867,11640,116
2021-07-24,Fresno,019,978130,105504,103637,9096,112733,1736
2021-07-24,Glenn,021,27897,2481,2457,583,3040,20
2021-07-24,Humboldt,023,135768,4985,4780,71,4851,52
2021-07-24,Imperial,025,180216,29222,28996,2771,31767,742
2021-07-24,Inyo,027,18085,1439,1424,13,1437,38
2021-07-24,Kern,029,883053,99590,98261,11789,110050,1350
2021-07-24,Kings,031,150075,23767,23304,1161,24465,246
2021-07-24,Lake,033,64148,4223,3963,14,3977,64
2021-07-24,Lassen,035,31185,5332,5311,120,5431,21
2021-07-24,Los Angeles,037,10098052,1252268,1232164,44753,1276917,24623
2021-07-24,Madera,039,155013,17209,16885,1002,17887,245
2021-07-24,Marin,041,260295,14817,14454,290,14744,238
2021-07-24,Mariposa,043,17540,472,453,11,464,5
2021-07-24,Mendocino,045,87422,4457,4293,92,4385,49
2021-07-24,Merced,047,269075,31873,31661,1111,32772,473
2021-07-24,Modoc,049,8938,424,413,148,561,5
2021-07-24,Mono,051,14174,1289,1284,18,1302,3
2021-07-24,Monterey,053,433212,43837,43525,1954,45479,521
2021-07-24,Napa,055,140530,10407,10230,49,10279,81
2021-07-24,Nevada,057,99092,5405,5183,203,5386,72
2021-07-24,Orange,059,3164182,264352,259973,12199,272172,5141
2021-07-24,Placer,061,380077,25237,24530,1824,26354,303
2021-07-24,Plumas,063,18699,754,737,14,751,4
2021-07-24,Riverside,065,2383286,303060,296912,14657,311569,4552
2021-07-24,Sacramento,067,1510023,114982,112438,2172,114610,1698
2021-07-24,San Benito,069,59416,6239,6200,116,6316,63
2021-07-24,San Bernardino,071,2135413,301483,297899,9405,307304,5236
2021-07-24,San Diego,073,3302833,294853,289368,16894,306262,3788
2021-07-24,San Francisco,075,870044,40427,38954,1466,40420,561
2021-07-24,San Joaquin,077,732212,76690,75461,3874,79335,1436
2021-07-24,San Luis Obispo,079,281455,22119,21616,798,22414,260
2021-07-24,San Mateo,081,765935,44635,43880,568,44448,542
2021-07-24,Santa Barbara,083,443738,35603,35071,1199,36270,465
2021-07-24,Santa Clara,085,1922200,123135,121092,846,121938,2099
2021-07-24,Santa Cruz,087,273765,16708,16416,824,17240,207
2021-07-24,Shasta,089,179085,12959,12759,1724,14483,211
2021-07-24,Sierra,091,2930,69,64,12,76,0
2021-07-24,Siskiyou,093,43540,2051,1951,429,2380,31
2021-07-24,Solano,095,438530,35455,34499,697,35196,259
2021-07-24,Sonoma,097,501317,32690,31928,383,32311,327
2021-07-24,Stanislaus,099,539301,58619,57879,6281,64160,1030
2021-07-24,Sutter,101,95872,10029,9890,99,9989,115
2021-07-24,Tehama,103,63373,5242,5166,603,5769,65
2021-07-24,Trinity,105,12862,508,345,112,457,3
2021-07-24,Tulare,107,460477,51094,50104,9505,59609,854
2021-07-24,Tuolumne,109,53932,4299,4216,45,4261,64
2021-07-24,Ventura,111,848112,83851,82687,3422,86109,1041
2021-07-24,Yolo,113,214977,14899,14557,445,15002,214
2021-07-24,Yuba,115,75493,6631,6449,142,6591,51
2021-07-23,Alameda,001,1643700,95183,93170,2187,95357,1259
2021-07-23,Alpine,003,1148,88,89,0,89,0
2021-07-23,Amador,005,37829,3880,3816,34,3850,48
2021-07-23,Butte,007,227075,13291,12982,1971,14953,203
2021-07-23,Calaveras,009,45235,2295,2267,15,2282,57
2021-07-23,Colusa,011,21464,2010,1992,345,2337,16
2021-07-23,Contra Costa,013,1133247,75492,73682,1495,75177,830
2021-07-23,Del Norte,015,27424,1588,1497,14,1511,8
2021-07-23,El Dorado,017,186661,11050,10773,863,11636,116
2021-07-23,Fresno,019,978130,105372,103637,9086,112723,1736
2021-07-23,Glenn,021,27897,2479,2457,580,3037,20
2021-07-23,Humboldt,023,135768,4963,4780,68,4848,52
2021-07-23,Imperial,025,180216,29210,28996,2771,31767,742
2021-07-23,Inyo,027,18085,1436,1424,13,1437,38
2021-07-23,Kern,029,883053,99508,98261,11763,110024,1350
2021-07-23,Kings,031,150075,23736,23304,1158,24462,246
2021-07-23,Lake,033,64148,4194,3963,14,3977,64
2021-07-23,Lassen,035,31185,5330,5311,120,5431,21
2021-07-23,Los Angeles,037,10098052,1250331,1232164,44643,1276807,24623
2021-07-23,Madera,039,155013,17179,16885,997,17882,245
2021-07-23,Marin,041,260295,14780,14454,288,14742,238
2021-07-23,Mariposa,043,17540,469,453,11,464,5
2021-07-23,Mendocino,045,87422,4444,4293,92,4385,49
2021-07-23,Merced,047,269075,31848,31661,1111,32772,473
2021-07-23,Modoc,049,8938,424,413,148,561,5
2021-07-23,Mono,051,14174,1288,1284,18,1302,3
2021-07-23,Monterey,053,433212,43811,43525,1954,45479,521
2021-07-23,Napa,055,140530,10386,10230,49,10279,81
2021-07-23,Nevada,057,99092,5361,5183,203,5386,72
2021-07-23,Orange,059,3164182,263902,259973,12176,272149,5141
2021-07-23,Placer,061,380077,25157,24530,1808,26338,303
2021-07-23,Plumas,063,18699,752,737,14,751,4
2021-07-23,Riverside,065,2383286,302594,296912,14645,311557,4552
2021-07-23,Sacramento,067,1510023,114628,112438,2170,114608,1698
2021-07-23,San Benito,069,59416,6233,6200,116,6316,63
2021-07-23,San Bernardino,071,2135413,301102,297899,9396,307295,5236
2021-07-23,San Diego,073,3302833,294246,289368,16846,306214,3788
2021-07-23,San Francisco,075,870044,40240,38954,1453,40407,561
2021-07-23,San Joaquin,077,732212,76586,75461,3859,79320,1436
2021-07-23,San Luis Obispo,079,281455,22080,21616,798,22414,260
2021-07-23,San Mateo,081,765935,44532,43880,563,44443,542
2021-07-23,Santa Barbara,083,443738,35538,35071,1198,36269,465
2021-07-23,Santa Clara,085,1922200,122916,121092,843,121935,2099
2021-07-23,Santa Cruz,087,273765,16683,16416,824,17240,207
2021-07-23,Shasta,089,179085,12932,12759,1721,14480,211
2021-07-23,Sierra,091,2930,69,64,12,76,0
2021-07-23,Siskiyou,093,43540,2049,1951,429,2380,31
2021-07-23,Solano,095,438530,35363,34499,693,35192,259
2021-07-23,Sonoma,097,501317,32595,31928,382,32310,327
2021-07-23,Stanislaus,099,539301,58543,57879,6272,64151,1030
2021-07-23,Sutter,101,95872,10000,9890,99,9989,115
2021-07-23,Tehama,103,63373,5233,5166,603,5769,65
2021-07-23,Trinity,105,12862,507,345,111,456,3
2021-07-23,Tulare,107,460477,51048,50104,9480,59584,854
2021-07-23,Tuolumne,109,53932,4277,4216,45,4261,64
2021-07-23,Ventura,111,848112,83689,82687,3404,86091,1041
2021-07-23,Yolo,113,214977,14862,14557,438,14995,214
2021-07-23,Yuba,115,75493,6605,6449,141,6590,51
2021-07-22,Alameda,001,1643700,94828,93170,2183,95353,1259
2021-07-22,Alpine,003,1148,88,89,0,89,0
2021-07-22,Amador,005,37829,3871,3816,34,3850,48
2021-07-22,Butte,007,227075,13257,12982,1962,14944,203
2021-07-22,Calaveras,009,45235,2285,2267,15,2282,57
2021-07-22,Colusa,011,21464,2008,1992,342,2334,16
2021-07-22,Contra Costa,013,1133247,75152,73682,1490,75172,830
2021-07-22,Del Norte,015,27424,1571,1497,14,1511,8
2021-07-22,El Dorado,017,186661,11015,10773,855,11628,116
2021-07-22,Fresno,019,978130,105243,103637,9076,112713,1736
2021-07-22,Glenn,021,27897,2475,2457,580,3037,20
2021-07-22,Humboldt,023,135768,4932,4780,66,4846,52
2021-07-22,Imperial,025,180216,29180,28996,2771,31767,742
2021-07-22,Inyo,027,18085,1434,1424,13,1437,38
2021-07-22,Kern,029,883053,99393,98261,11722,109983,1350
2021-07-22,Kings,031,150075,23697,23304,1156,24460,246
2021-07-22,Lake,033,64148,4143,3963,14,3977,64
2021-07-22,Lassen,035,31185,5327,5311,120,5431,21
2021-07-22,Los Angeles,037,10098052,1247902,1232164,44460,1276624,24623
2021-07-22,Madera,039,155013,17144,16885,995,17880,245
2021-07-22,Marin,041,260295,14739,14454,287,14741,238
2021-07-22,Mariposa,043,17540,462,453,11,464,5
2021-07-22,Mendocino,045,87422,4431,4293,91,4384,49
2021-07-22,Merced,047,269075,31806,31661,1109,32770,473
2021-07-22,Modoc,049,8938,424,413,148,561,5
2021-07-22,Mono,051,14174,1287,1284,18,1302,3
2021-07-22,Monterey,053,433212,43783,43525,1948,45473,521
2021-07-22,Napa,055,140530,10368,10230,49,10279,81
2021-07-22,Nevada,057,99092,5335,5183,202,5385,72
2021-07-22,Orange,059,3164182,263349,259973,12167,272140,5141
2021-07-22,Placer,061,380077,25063,24530,1797,26327,303
2021-07-22,Plumas,063,18699,751,737,14,751,4
2021-07-22,Riverside,065,2383286,302085,296912,14624,311536,4552
2021-07-22,Sacramento,067,1510023,114190,112438,2161,114599,1698
2021-07-22,San Benito,069,59416,6226,6200,116,6316,63
2021-07-22,San Bernardino,071,2135413,300699,297899,9380,307279,5236
2021-07-22,San Diego,073,3302833,293516,289368,16786,306154,3788
2021-07-22,San Francisco,075,870044,40027,38954,1441,40395,561
2021-07-22,San Joaquin,077,732212,76443,75461,3846,79307,1436
2021-07-22,San Luis Obispo,079,281455,22042,21616,794,22410,260
2021-07-22,San Mateo,081,765935,44420,43880,558,44438,542
2021-07-22,Santa Barbara,083,443738,35472,35071,1196,36267,465
2021-07-22,Santa Clara,085,1922200,122674,121092,840,121932,2099
2021-07-22,Santa Cruz,087,273765,16646,16416,823,17239,207
2021-07-22,Shasta,089,179085,12908,12759,1717,14476,211
2021-07-22,Sierra,091,2930,67,64,12,76,0
2021-07-22,Siskiyou,093,43540,2046,1951,429,2380,31
2021-07-22,Solano,095,438530,35217,34499,686,35185,259
2021-07-22,Sonoma,097,501317,32485,31928,380,32308,327
2021-07-22,Stanislaus,099,539301,58415,57879,6260,64139,1030
2021-07-22,Sutter,101,95872,9979,9890,99,9989,115
2021-07-22,Tehama,103,63373,5227,5166,603,5769,65
2021-07-22,Trinity,105,12862,507,345,111,456,3
2021-07-22,Tulare,107,460477,51005,50104,9452,59556,854
2021-07-22,Tuolumne,109,53932,4265,4216,45,4261,64
2021-07-22,Ventura,111,848112,83555,82687,3391,86078,1041
2021-07-22,Yolo,113,214977,14824,14557,437,14994,214
2021-07-22,Yuba,115,75493,6574,6449,138,6587,51
2021-07-21,Alameda,001,1643700,94507,92840,2180,95020,1256
2021-07-21,Alpine,003,1148,88,89,0,89,0
2021-07-21,Amador,005,37829,3858,3813,34,3847,48
2021-07-21,Butte,007,227075,13216,12939,1957,14896,203
2021-07-21,Calaveras,009,45235,2281,2257,15,2272,57
2021-07-21,Colusa,011,21464,2004,1988,341,2329,16
2021-07-21,Contra Costa,013,1133247,74888,73320,1481,74801,827
2021-07-21,Del Norte,015,27424,1561,1492,14,1506,8
2021-07-21,El Dorado,017,186661,10979,10742,851,11593,116
2021-07-21,Fresno,019,978130,105095,103504,9067,112571,1736
2021-07-21,Glenn,021,27897,2473,2455,579,3034,20
2021-07-21,Humboldt,023,135768,4900,4763,64,4827,52
2021-07-21,Imperial,025,180216,29168,28964,2768,31732,742
2021-07-21,Inyo,027,18085,1434,1423,13,1436,38
2021-07-21,Kern,029,883053,99275,98152,11681,109833,1350
2021-07-21,Kings,031,150075,23669,23270,1152,24422,246
2021-07-21,Lake,033,64148,4077,3896,14,3910,64
2021-07-21,Lassen,035,31185,5324,5310,120,5430,21
2021-07-21,Los Angeles,037,10098052,1245391,1229598,44323,1273921,24609
2021-07-21,Madera,039,155013,17120,16858,992,17850,245
2021-07-21,Marin,041,260295,14690,14427,287,14714,238
2021-07-21,Mariposa,043,17540,458,449,11,460,5
2021-07-21,Mendocino,045,87422,4413,4274,91,4365,49
2021-07-21,Merced,047,269075,31767,31607,1105,32712,473
2021-07-21,Modoc,049,8938,424,413,148,561,5
2021-07-21,Mono,051,14174,1284,1282,18,1300,3
2021-07-21,Monterey,053,433212,43753,43502,1944,45446,515
2021-07-21,Napa,055,140530,10342,10209,49,10258,81
2021-07-21,Nevada,057,99092,5300,5152,202,5354,72
2021-07-21,Orange,059,3164182,262796,259615,12136,271751,5139
2021-07-21,Placer,061,380077,24954,24441,1786,26227,303
2021-07-21,Plumas,063,18699,751,736,14,750,4
2021-07-21,Riverside,065,2383286,301572,296419,14607,311026,4552
2021-07-21,Sacramento,067,1510023,113768,112043,2150,114193,1696
2021-07-21,San Benito,069,59416,6216,6196,116,6312,63
2021-07-21,San Bernardino,071,2135413,300247,297519,9372,306891,5230
2021-07-21,San Diego,073,3302833,292666,288682,16723,305405,3787
2021-07-21,San Francisco,075,870044,39802,38699,1436,40135,559
2021-07-21,San Joaquin,077,732212,76254,75288,3834,79122,1434
2021-07-21,San Luis Obispo,079,281455,22005,21579,791,22370,260
2021-07-21,San Mateo,081,765935,44328,43755,554,44309,542
2021-07-21,Santa Barbara,083,443738,35413,34998,1180,36178,465
2021-07-21,Santa Clara,085,1922200,122464,120838,838,121676,2099
2021-07-21,Santa Cruz,087,273765,16612,16407,823,17230,207
2021-07-21,Shasta,089,179085,12875,12751,1714,14465,211
2021-07-21,Sierra,091,2930,67,64,12,76,0
2021-07-21,Siskiyou,093,43540,2044,1943,427,2370,31
2021-07-21,Solano,095,438530,35059,34374,681,35055,258
2021-07-21,Sonoma,097,501317,32369,31789,380,32169,327
2021-07-21,Stanislaus,099,539301,58313,57774,6250,64024,1028
2021-07-21,Sutter,101,95872,9955,9862,99,9961,113
2021-07-21,Tehama,103,63373,5223,5161,603,5764,65
2021-07-21,Trinity,105,12862,505,345,110,455,3
2021-07-21,Tulare,107,460477,50945,50066,9426,59492,854
2021-07-21,Tuolumne,109,53932,4228,4156,45,4201,64
2021-07-21,Ventura,111,848112,83433,82573,3379,85952,1041
2021-07-21,Yolo,113,214977,14782,14525,436,14961,213
2021-07-21,Yuba,115,75493,6546,6425,138,6563,52
2021-07-20,Alameda,001,1643700,94134,92625,2166,94791,1256
2021-07-20,Alpine,003,1148,88,89,0,89,0
2021-07-20,Amador,005,37829,3847,3807,34,3841,48
2021-07-20,Butte,007,227075,13179,12916,1952,14868,203
2021-07-20,Calaveras,009,45235,2278,2249,15,2264,57
2021-07-20,Colusa,011,21464,2004,1985,341,2326,16
2021-07-20,Contra Costa,013,1133247,74604,73143,1463,74606,825
2021-07-20,Del Norte,015,27424,1551,1490,14,1504,8
2021-07-20,El Dorado,017,186661,10939,10727,847,11574,116
2021-07-20,Fresno,019,978130,104959,103438,9048,112486,1736
2021-07-20,Glenn,021,27897,2473,2453,579,3032,20
2021-07-20,Humboldt,023,135768,4855,4735,62,4797,52
2021-07-20,Imperial,025,180216,29148,28933,2768,31701,742
2021-07-20,Inyo,027,18085,1430,1420,13,1433,36
2021-07-20,Kern,029,883053,99163,98082,11653,109735,1350
2021-07-20,Kings,031,150075,23628,23254,1148,24402,246
2021-07-20,Lake,033,64148,4052,3871,14,3885,64
2021-07-20,Lassen,035,31185,5324,5306,120,5426,21
2021-07-20,Los Angeles,037,10098052,1242596,1227404,44156,1271560,24603
2021-07-20,Madera,039,155013,17099,16856,988,17844,245
2021-07-20,Marin,041,260295,14654,14396,284,14680,234
2021-07-20,Mariposa,043,17540,456,448,11,459,5
2021-07-20,Mendocino,045,87422,4396,4259,91,4350,49
2021-07-20,Merced,047,269075,31728,31578,1098,32676,473
2021-07-20,Modoc,049,8938,424,413,148,561,5
2021-07-20,Mono,051,14174,1280,1281,18,1299,3
2021-07-20,Monterey,053,433212,43722,43481,1941,45422,515
2021-07-20,Napa,055,140530,10319,10191,49,10240,81
2021-07-20,Nevada,057,99092,5281,5148,201,5349,72
2021-07-20,Orange,059,3164182,262239,259303,12104,271407,5139
2021-07-20,Placer,061,380077,24862,24408,1763,26171,303
2021-07-20,Plumas,063,18699,749,736,14,750,4
2021-07-20,Riverside,065,2383286,301037,296118,14593,310711,4543
2021-07-20,Sacramento,067,1510023,113328,111796,2120,113916,1695
2021-07-20,San Benito,069,59416,6209,6196,116,6312,63
2021-07-20,San Bernardino,071,2135413,299836,297222,9347,306569,5231
2021-07-20,San Diego,073,3302833,291740,288209,16627,304836,3786
2021-07-20,San Francisco,075,870044,39544,38536,1425,39961,558
2021-07-20,San Joaquin,077,732212,76082,75198,3821,79019,1433
2021-07-20,San Luis Obispo,079,281455,21959,21556,790,22346,259
2021-07-20,San Mateo,081,765935,44209,43670,553,44223,542
2021-07-20,Santa Barbara,083,443738,35343,34935,1174,36109,462
2021-07-20,Santa Clara,085,1922200,122207,120704,835,121539,2098
2021-07-20,Santa Cruz,087,273765,16583,16399,823,17222,207
2021-07-20,Shasta,089,179085,12849,12734,1710,14444,211
2021-07-20,Sierra,091,2930,67,64,12,76,0
2021-07-20,Siskiyou,093,43540,2040,1931,426,2357,31
2021-07-20,Solano,095,438530,34924,34337,674,35011,258
2021-07-20,Sonoma,097,501317,32250,31763,379,32142,326
2021-07-20,Stanislaus,099,539301,58198,57706,6244,63950,1028
2021-07-20,Sutter,101,95872,9928,9854,96,9950,114
2021-07-20,Tehama,103,63373,5221,5153,603,5756,65
2021-07-20,Trinity,105,12862,503,344,109,453,3
2021-07-20,Tulare,107,460477,50903,50047,9409,59456,854
2021-07-20,Tuolumne,109,53932,4209,4156,45,4201,64
2021-07-20,Ventura,111,848112,83280,82504,3362,85866,1041
2021-07-20,Yolo,113,214977,14717,14495,433,14928,213
2021-07-20,Yuba,115,75493,6521,6393,135,6528,52
2021-07-19,Alameda,001,1643700,93759,92357,2150,94507,1256
2021-07-19,Alpine,003,1148,88,89,0,89,0
2021-07-19,Amador,005,37829,3843,3802,34,3836,48
2021-07-19,Butte,007,227075,13135,12901,1946,14847,202
2021-07-19,Calaveras,009,45235,2274,2245,15,2260,57
2021-07-19,Colusa,011,21464,2002,1981,340,2321,16
2021-07-19,Contra Costa,013,1133247,74292,72935,1443,74378,825
2021-07-19,Del Norte,015,27424,1538,1484,14,1498,8
2021-07-19,El Dorado,017,186661,10909,10703,839,11542,114
2021-07-19,Fresno,019,978130,104829,103350,9035,112385,1731
2021-07-19,Glenn,021,27897,2473,2452,578,3030,20
2021-07-19,Humboldt,023,135768,4825,4719,60,4779,52
2021-07-19,Imperial,025,180216,29121,28888,2767,31655,742
2021-07-19,Inyo,027,18085,1429,1417,13,1430,36
2021-07-19,Kern,029,883053,99049,97999,11619,109618,1349
2021-07-19,Kings,031,150075,23598,23221,1142,24363,246
2021-07-19,Lake,033,64148,4016,3848,14,3862,64
2021-07-19,Lassen,035,31185,5323,5305,120,5425,21
2021-07-19,Los Angeles,037,10098052,1239993,1225946,43965,1269911,24600
2021-07-19,Madera,039,155013,17076,16846,985,17831,244
2021-07-19,Marin,041,260295,14619,14369,281,14650,234
2021-07-19,Mariposa,043,17540,450,447,11,458,5
2021-07-19,Mendocino,045,87422,4378,4251,91,4342,49
2021-07-19,Merced,047,269075,31664,31565,1091,32656,472
2021-07-19,Modoc,049,8938,423,413,148,561,5
2021-07-19,Mono,051,14174,1278,1280,18,1298,3
2021-07-19,Monterey,053,433212,43698,43436,1940,45376,515
2021-07-19,Napa,055,140530,10294,10180,47,10227,81
2021-07-19,Nevada,057,99092,5253,5133,200,5333,72
2021-07-19,Orange,059,3164182,261716,258927,12072,270999,5138
2021-07-19,Placer,061,380077,24763,24359,1741,26100,303
2021-07-19,Plumas,063,18699,749,730,14,744,4
2021-07-19,Riverside,065,2383286,300547,295736,14555,310291,4543
2021-07-19,Sacramento,067,1510023,112964,111470,2096,113566,1696
2021-07-19,San Benito,069,59416,6206,6193,116,6309,63
2021-07-19,San Bernardino,071,2135413,299464,296929,9329,306258,5235
2021-07-19,San Diego,073,3302833,290840,287695,16522,304217,3786
2021-07-19,San Francisco,075,870044,39272,38463,1412,39875,560
2021-07-19,San Joaquin,077,732212,75917,75086,3815,78901,1431
2021-07-19,San Luis Obispo,079,281455,21914,21531,786,22317,259
2021-07-19,San Mateo,081,765935,44067,43563,544,44107,542
2021-07-19,Santa Barbara,083,443738,35271,34904,1172,36076,461
2021-07-19,Santa Clara,085,1922200,121949,120554,834,121388,2098
2021-07-19,Santa Cruz,087,273765,16567,16387,823,17210,207
2021-07-19,Shasta,089,179085,12831,12723,1708,14431,209
2021-07-19,Sierra,091,2930,66,64,12,76,0
2021-07-19,Siskiyou,093,43540,2035,1927,424,2351,31
2021-07-19,Solano,095,438530,34749,34262,663,34925,261
2021-07-19,Sonoma,097,501317,32129,31713,378,32091,325
2021-07-19,Stanislaus,099,539301,58097,57644,6234,63878,1027
2021-07-19,Sutter,101,95872,9912,9834,96,9930,114
2021-07-19,Tehama,103,63373,5215,5152,601,5753,65
2021-07-19,Trinity,105,12862,503,344,108,452,3
2021-07-19,Tulare,107,460477,50856,49994,9392,59386,855
2021-07-19,Tuolumne,109,53932,4199,4151,45,4196,64
2021-07-19,Ventura,111,848112,83184,82409,3340,85749,1041
2021-07-19,Yolo,113,214977,14685,14439,431,14870,213
2021-07-19,Yuba,115,75493,6497,6370,135,6505,52
2021-07-18,Alameda,001,1643700,93402,92162,2137,94299,1256
2021-07-18,Alpine,003,1148,88,89,0,89,0
2021-07-18,Amador,005,37829,3832,3799,34,3833,48
2021-07-18,Butte,007,227075,13092,12888,1941,14829,202
2021-07-18,Calaveras,009,45235,2271,2243,15,2258,57
2021-07-18,Colusa,011,21464,2002,1981,339,2320,16
2021-07-18,Contra Costa,013,1133247,73976,72849,1425,74274,825
2021-07-18,Del Norte,015,27424,1529,1482,14,1496,8
2021-07-18,El Dorado,017,186661,10871,10687,831,11518,114
2021-07-18,Fresno,019,978130,104675,103298,9017,112315,1731
2021-07-18,Glenn,021,27897,2472,2452,577,3029,20
2021-07-18,Humboldt,023,135768,4789,4714,60,4774,52
2021-07-18,Imperial,025,180216,29084,28877,2766,31643,742
2021-07-18,Inyo,027,18085,1425,1417,13,1430,36
2021-07-18,Kern,029,883053,98923,97963,11577,109540,1349
2021-07-18,Kings,031,150075,23577,23203,1138,24341,246
2021-07-18,Lake,033,64148,3980,3825,14,3839,64
2021-07-18,Lassen,035,31185,5323,5305,120,5425,21
2021-07-18,Los Angeles,037,10098052,1237303,1224691,43774,1268465,24598
2021-07-18,Madera,039,155013,17051,16838,981,17819,244
2021-07-18,Marin,041,260295,14583,14358,279,14637,234
2021-07-18,Mariposa,043,17540,449,447,11,458,5
2021-07-18,Mendocino,045,87422,4357,4246,91,4337,49
2021-07-18,Merced,047,269075,31633,31537,1089,32626,471
2021-07-18,Modoc,049,8938,423,413,148,561,5
2021-07-18,Mono,051,14174,1277,1280,18,1298,3
2021-07-18,Monterey,053,433212,43680,43422,1931,45353,515
2021-07-18,Napa,055,140530,10277,10174,44,10218,81
2021-07-18,Nevada,057,99092,5227,5124,200,5324,72
2021-07-18,Orange,059,3164182,261231,258724,12042,270766,5138
2021-07-18,Placer,061,380077,24696,24313,1714,26027,303
2021-07-18,Plumas,063,18699,749,730,14,744,4
2021-07-18,Riverside,065,2383286,300055,295522,14513,310035,4543
2021-07-18,Sacramento,067,1510023,112532,111255,2064,113319,1696
2021-07-18,San Benito,069,59416,6198,6191,116,6307,63
2021-07-18,San Bernardino,071,2135413,298990,296739,9314,306053,5233
2021-07-18,San Diego,073,3302833,290024,286287,16438,302725,3786
2021-07-18,San Francisco,075,870044,39037,38367,1401,39768,560
2021-07-18,San Joaquin,077,732212,75740,74997,3802,78799,1431
2021-07-18,San Luis Obispo,079,281455,21879,21527,783,22310,259
2021-07-18,San Mateo,081,765935,43954,43506,538,44044,542
2021-07-18,Santa Barbara,083,443738,35206,34880,1170,36050,461
2021-07-18,Santa Clara,085,1922200,121735,120438,827,121265,2098
2021-07-18,Santa Cruz,087,273765,16535,16372,822,17194,207
2021-07-18,Shasta,089,179085,12806,12714,1704,14418,209
2021-07-18,Sierra,091,2930,66,64,12,76,0
2021-07-18,Siskiyou,093,43540,2029,1927,419,2346,31
2021-07-18,Solano,095,438530,34621,34215,659,34874,261
2021-07-18,Sonoma,097,501317,32024,31675,377,32052,325
2021-07-18,Stanislaus,099,539301,57986,57600,6209,63809,1028
2021-07-18,Sutter,101,95872,9880,9826,96,9922,114
2021-07-18,Tehama,103,63373,5212,5150,600,5750,65
2021-07-18,Trinity,105,12862,503,344,108,452,3
2021-07-18,Tulare,107,460477,50803,49985,9369,59354,855
2021-07-18,Tuolumne,109,53932,4181,4149,45,4194,64
2021-07-18,Ventura,111,848112,83070,82361,3316,85677,1041
2021-07-18,Yolo,113,214977,14626,14425,425,14850,213
2021-07-18,Yuba,115,75493,6456,6357,135,6492,52
2021-07-17,Alameda,001,1643700,93185,91346,2125,93471,1255
2021-07-17,Alpine,003,1148,88,89,0,89,0
2021-07-17,Amador,005,37829,3823,3785,34,3819,48
2021-07-17,Butte,007,227075,13078,12824,1936,14760,202
2021-07-17,Calaveras,009,45235,2265,2237,15,2252,57
2021-07-17,Colusa,011,21464,1999,1976,339,2315,16
2021-07-17,Contra Costa,013,1133247,73794,72254,1412,73666,824
2021-07-17,Del Norte,015,27424,1521,1475,14,1489,8
2021-07-17,El Dorado,017,186661,10844,10622,827,11449,114
2021-07-17,Fresno,019,978130,104602,103055,9003,112058,1730
2021-07-17,Glenn,021,27897,2471,2451,577,3028,20
2021-07-17,Humboldt,023,135768,4776,4654,59,4713,52
2021-07-17,Imperial,025,180216,29068,28840,2766,31606,742
2021-07-17,Inyo,027,18085,1425,1416,13,1429,36
2021-07-17,Kern,029,883053,98866,97796,11540,109336,1348
2021-07-17,Kings,031,150075,23557,23163,1137,24300,246
2021-07-17,Lake,033,64148,3955,3760,14,3774,64
2021-07-17,Lassen,035,31185,5323,5302,120,5422,21
2021-07-17,Los Angeles,037,10098052,1235774,1219733,43631,1263364,24582
2021-07-17,Madera,039,155013,17043,16804,981,17785,240
2021-07-17,Marin,041,260295,14565,14297,277,14574,234
2021-07-17,Mariposa,043,17540,449,445,11,456,5
2021-07-17,Mendocino,045,87422,4345,4209,91,4300,49
2021-07-17,Merced,047,269075,31612,31451,1085,32536,471
2021-07-17,Modoc,049,8938,423,412,148,560,5
2021-07-17,Mono,051,14174,1275,1277,18,1295,3
2021-07-17,Monterey,053,433212,43657,43367,1926,45293,515
2021-07-17,Napa,055,140530,10261,10129,44,10173,81
2021-07-17,Nevada,057,99092,5212,5066,200,5266,72
2021-07-17,Orange,059,3164182,260924,257805,12003,269808,5136
2021-07-17,Placer,061,380077,24629,24169,1700,25869,303
2021-07-17,Plumas,063,18699,744,721,14,735,4
2021-07-17,Riverside,065,2383286,299748,294751,14481,309232,4542
2021-07-17,Sacramento,067,1510023,112297,110432,2042,112474,1694
2021-07-17,San Benito,069,59416,6192,6181,116,6297,63
2021-07-17,San Bernardino,071,2135413,298754,296048,9295,305343,5218
2021-07-17,San Diego,073,3302833,289617,285698,16370,302068,3786
2021-07-17,San Francisco,075,870044,38915,37978,1397,39375,560
2021-07-17,San Joaquin,077,732212,75653,74695,3796,78491,1430
2021-07-17,San Luis Obispo,079,281455,21852,21462,783,22245,258
2021-07-17,San Mateo,081,765935,43883,43324,537,43861,542
2021-07-17,Santa Barbara,083,443738,35165,34769,1167,35936,461
2021-07-17,Santa Clara,085,1922200,121563,119980,824,120804,2097
2021-07-17,Santa Cruz,087,273765,16528,16337,822,17159,207
2021-07-17,Shasta,089,179085,12791,12683,1699,14382,210
2021-07-17,Sierra,091,2930,66,62,12,74,0
2021-07-17,Siskiyou,093,43540,2024,1922,416,2338,29
2021-07-17,Solano,095,438530,34556,34015,651,34666,263
2021-07-17,Sonoma,097,501317,31956,31536,376,31912,322
2021-07-17,Stanislaus,099,539301,57909,57400,6195,63595,1028
2021-07-17,Sutter,101,95872,9870,9778,96,9874,114
2021-07-17,Tehama,103,63373,5209,5145,600,5745,64
2021-07-17,Trinity,105,12862,502,341,108,449,3
2021-07-17,Tulare,107,460477,50782,49937,9357,59294,854
2021-07-17,Tuolumne,109,53932,4171,4131,45,4176,64
2021-07-17,Ventura,111,848112,83001,82125,3305,85430,1041
2021-07-17,Yolo,113,214977,14594,14356,418,14774,213
2021-07-17,Yuba,115,75493,6445,6309,135,6444,52
2021-07-16,Alameda,001,1643700,92945,91346,2113,93459,1255
2021-07-16,Alpine,003,1148,88,89,0,89,0
2021-07-16,Amador,005,37829,3820,3785,34,3819,48
2021-07-16,Butte,007,227075,13053,12824,1933,14757,202
2021-07-16,Calaveras,009,45235,2264,2237,15,2252,57
2021-07-16,Colusa,011,21464,1997,1976,338,2314,16
2021-07-16,Contra Costa,013,1133247,73605,72254,1408,73662,824
2021-07-16,Del Norte,015,27424,1519,1475,14,1489,8
2021-07-16,El Dorado,017,186661,10825,10622,826,11448,114
2021-07-16,Fresno,019,978130,104550,103055,8983,112038,1730
2021-07-16,Glenn,021,27897,2471,2451,577,3028,20
2021-07-16,Humboldt,023,135768,4754,4654,59,4713,52
2021-07-16,Imperial,025,180216,29056,28840,2766,31606,742
2021-07-16,Inyo,027,18085,1423,1416,13,1429,36
2021-07-16,Kern,029,883053,98804,97796,11500,109296,1348
2021-07-16,Kings,031,150075,23532,23163,1135,24298,246
2021-07-16,Lake,033,64148,3928,3760,14,3774,64
2021-07-16,Lassen,035,31185,5322,5302,120,5422,21
2021-07-16,Los Angeles,037,10098052,1234271,1219733,43486,1263219,24582
2021-07-16,Madera,039,155013,17025,16804,981,17785,240
2021-07-16,Marin,041,260295,14541,14297,274,14571,234
2021-07-16,Mariposa,043,17540,449,445,11,456,5
2021-07-16,Mendocino,045,87422,4336,4209,90,4299,49
2021-07-16,Merced,047,269075,31590,31451,1083,32534,471
2021-07-16,Modoc,049,8938,423,412,148,560,5
2021-07-16,Mono,051,14174,1274,1277,18,1295,3
2021-07-16,Monterey,053,433212,43635,43367,1925,45292,515
2021-07-16,Napa,055,140530,10237,10129,43,10172,81
2021-07-16,Nevada,057,99092,5202,5066,200,5266,72
2021-07-16,Orange,059,3164182,260652,257805,11963,269768,5136
2021-07-16,Placer,061,380077,24576,24169,1695,25864,303
2021-07-16,Plumas,063,18699,743,721,14,735,4
2021-07-16,Riverside,065,2383286,299472,294751,14455,309206,4542
2021-07-16,Sacramento,067,1510023,112080,110432,2029,112461,1694
2021-07-16,San Benito,069,59416,6190,6181,116,6297,63
2021-07-16,San Bernardino,071,2135413,298476,296048,9278,305326,5218
2021-07-16,San Diego,073,3302833,289175,285698,16323,302021,3786
2021-07-16,San Francisco,075,870044,38798,37978,1392,39370,560
2021-07-16,San Joaquin,077,732212,75558,74695,3793,78488,1430
2021-07-16,San Luis Obispo,079,281455,21835,21462,783,22245,258
2021-07-16,San Mateo,081,765935,43830,43324,536,43860,542
2021-07-16,Santa Barbara,083,443738,35127,34769,1167,35936,461
2021-07-16,Santa Clara,085,1922200,121416,119980,816,120796,2097
2021-07-16,Santa Cruz,087,273765,16515,16337,822,17159,207
2021-07-16,Shasta,089,179085,12781,12683,1698,14381,210
2021-07-16,Sierra,091,2930,66,62,12,74,0
2021-07-16,Siskiyou,093,43540,2022,1922,414,2336,29
2021-07-16,Solano,095,438530,34489,34015,643,34658,263
2021-07-16,Sonoma,097,501317,31904,31536,373,31909,322
2021-07-16,Stanislaus,099,539301,57859,57400,6185,63585,1028
2021-07-16,Sutter,101,95872,9858,9778,96,9874,114
2021-07-16,Tehama,103,63373,5207,5145,600,5745,64
2021-07-16,Trinity,105,12862,502,341,107,448,3
2021-07-16,Tulare,107,460477,50758,49937,9347,59284,854
2021-07-16,Tuolumne,109,53932,4165,4131,45,4176,64
2021-07-16,Ventura,111,848112,82936,82125,3298,85423,1041
2021-07-16,Yolo,113,214977,14568,14356,414,14770,213
2021-07-16,Yuba,115,75493,6423,6309,134,6443,52
2021-07-15,Alameda,001,1643700,92648,91346,2103,93449,1255
2021-07-15,Alpine,003,1148,88,89,0,89,0
2021-07-15,Amador,005,37829,3817,3785,34,3819,48
2021-07-15,Butte,007,227075,13027,12824,1931,14755,202
2021-07-15,Calaveras,009,45235,2261,2237,15,2252,57
2021-07-15,Colusa,011,21464,1996,1976,337,2313,16
2021-07-15,Contra Costa,013,1133247,73392,72254,1401,73655,824
2021-07-15,Del Norte,015,27424,1516,1475,14,1489,8
2021-07-15,El Dorado,017,186661,10798,10622,824,11446,114
2021-07-15,Fresno,019,978130,104453,103055,8963,112018,1730
2021-07-15,Glenn,021,27897,2471,2451,577,3028,20
2021-07-15,Humboldt,023,135768,4736,4654,58,4712,52
2021-07-15,Imperial,025,180216,29033,28840,2766,31606,742
2021-07-15,Inyo,027,18085,1423,1416,13,1429,36
2021-07-15,Kern,029,883053,98734,97796,11472,109268,1348
2021-07-15,Kings,031,150075,23494,23163,1132,24295,246
2021-07-15,Lake,033,64148,3889,3760,14,3774,64
2021-07-15,Lassen,035,31185,5321,5302,120,5422,21
2021-07-15,Los Angeles,037,10098052,1232291,1219733,43327,1263060,24582
2021-07-15,Madera,039,155013,17003,16804,977,17781,240
2021-07-15,Marin,041,260295,14516,14297,274,14571,234
2021-07-15,Mariposa,043,17540,449,445,11,456,5
2021-07-15,Mendocino,045,87422,4328,4209,89,4298,49
2021-07-15,Merced,047,269075,31560,31451,1083,32534,471
2021-07-15,Modoc,049,8938,423,412,148,560,5
2021-07-15,Mono,051,14174,1274,1277,18,1295,3
2021-07-15,Monterey,053,433212,43606,43367,1922,45289,515
2021-07-15,Napa,055,140530,10212,10129,42,10171,81
2021-07-15,Nevada,057,99092,5185,5066,199,5265,72
2021-07-15,Orange,059,3164182,260301,257805,11932,269737,5136
2021-07-15,Placer,061,380077,24516,24169,1678,25847,303
2021-07-15,Plumas,063,18699,742,721,14,735,4
2021-07-15,Riverside,065,2383286,299150,294751,14440,309191,4542
2021-07-15,Sacramento,067,1510023,111776,110432,2012,112444,1694
2021-07-15,San Benito,069,59416,6188,6181,116,6297,63
2021-07-15,San Bernardino,071,2135413,298171,296048,9263,305311,5218
2021-07-15,San Diego,073,3302833,288537,285698,16245,301943,3786
2021-07-15,San Francisco,075,870044,38646,37978,1384,39362,560
2021-07-15,San Joaquin,077,732212,75441,74695,3788,78483,1430
2021-07-15,San Luis Obispo,079,281455,21803,21462,783,22245,258
2021-07-15,San Mateo,081,765935,43726,43324,531,43855,542
2021-07-15,Santa Barbara,083,443738,35071,34769,1166,35935,461
2021-07-15,Santa Clara,085,1922200,121294,119980,813,120793,2097
2021-07-15,Santa Cruz,087,273765,16502,16337,822,17159,207
2021-07-15,Shasta,089,179085,12773,12683,1694,14377,210
2021-07-15,Sierra,091,2930,66,62,12,74,0
2021-07-15,Siskiyou,093,43540,2021,1922,414,2336,29
2021-07-15,Solano,095,438530,34414,34015,637,34652,263
2021-07-15,Sonoma,097,501317,31843,31536,373,31909,322
2021-07-15,Stanislaus,099,539301,57790,57400,6172,63572,1028
2021-07-15,Sutter,101,95872,9838,9778,95,9873,114
2021-07-15,Tehama,103,63373,5201,5145,599,5744,64
2021-07-15,Trinity,105,12862,502,341,107,448,3
2021-07-15,Tulare,107,460477,50738,49937,9330,59267,854
2021-07-15,Tuolumne,109,53932,4153,4131,45,4176,64
2021-07-15,Ventura,111,848112,82859,82125,3293,85418,1041
2021-07-15,Yolo,113,214977,14541,14356,413,14769,213
2021-07-15,Yuba,115,75493,6408,6309,133,6442,52
2021-07-14,Alameda,001,1643700,92388,91092,2086,93178,1255
2021-07-14,Alpine,003,1148,88,89,0,89,0
2021-07-14,Amador,005,37829,3809,3784,34,3818,48
2021-07-14,Butte,007,227075,13000,12813,1924,14737,202
2021-07-14,Calaveras,009,45235,2254,2234,15,2249,57
2021-07-14,Colusa,011,21464,1993,1974,337,2311,16
2021-07-14,Contra Costa,013,1133247,73164,72091,1389,73480,823
2021-07-14,Del Norte,015,27424,1515,1472,14,1486,8
2021-07-14,El Dorado,017,186661,10772,10598,821,11419,114
2021-07-14,Fresno,019,978130,104373,102966,8952,111918,1728
2021-07-14,Glenn,021,27897,2471,2449,577,3026,20
2021-07-14,Humboldt,023,135768,4713,4644,56,4700,52
2021-07-14,Imperial,025,180216,29004,28822,2766,31588,742
2021-07-14,Inyo,027,18085,1422,1415,13,1428,36
2021-07-14,Kern,029,883053,98670,97736,11447,109183,1346
2021-07-14,Kings,031,150075,23481,23142,1132,24274,246
2021-07-14,Lake,033,64148,3856,3739,14,3753,63
2021-07-14,Lassen,035,31185,5320,5298,120,5418,21
2021-07-14,Los Angeles,037,10098052,1230275,1218265,43185,1261450,24578
2021-07-14,Madera,039,155013,16991,16786,975,17761,240
2021-07-14,Marin,041,260295,14482,14269,272,14541,233
2021-07-14,Mariposa,043,17540,447,445,11,456,5
2021-07-14,Mendocino,045,87422,4315,4193,89,4282,49
2021-07-14,Merced,047,269075,31523,31412,1079,32491,471
2021-07-14,Modoc,049,8938,423,412,148,560,4
2021-07-14,Mono,051,14174,1274,1278,18,1296,3
2021-07-14,Monterey,053,433212,43582,43347,1920,45267,504
2021-07-14,Napa,055,140530,10190,10121,42,10163,81
2021-07-14,Nevada,057,99092,5165,5058,199,5257,72
2021-07-14,Orange,059,3164182,259984,257558,11902,269460,5137
2021-07-14,Placer,061,380077,24463,24125,1666,25791,303
2021-07-14,Plumas,063,18699,735,719,14,733,4
2021-07-14,Riverside,065,2383286,298826,294511,14424,308935,4542
2021-07-14,Sacramento,067,1510023,111448,110193,1988,112181,1688
2021-07-14,San Benito,069,59416,6185,6177,116,6293,63
2021-07-14,San Bernardino,071,2135413,297871,295820,9248,305068,5193
2021-07-14,San Diego,073,3302833,287965,285269,16165,301434,3786
2021-07-14,San Francisco,075,870044,38507,37836,1378,39214,559
2021-07-14,San Joaquin,077,732212,75349,74599,3779,78378,1416
2021-07-14,San Luis Obispo,079,281455,21781,21444,781,22225,258
2021-07-14,San Mateo,081,765935,43627,43249,527,43776,542
2021-07-14,Santa Barbara,083,443738,35029,34719,1164,35883,461
2021-07-14,Santa Clara,085,1922200,121144,119844,810,120654,2098
2021-07-14,Santa Cruz,087,273765,16490,16326,822,17148,207
2021-07-14,Shasta,089,179085,12753,12669,1691,14360,209
2021-07-14,Sierra,091,2930,66,62,12,74,0
2021-07-14,Siskiyou,093,43540,2014,1922,411,2333,29
2021-07-14,Solano,095,438530,34341,33948,637,34585,268
2021-07-14,Sonoma,097,501317,31791,31470,373,31843,322
2021-07-14,Stanislaus,099,539301,57715,57340,6160,63500,1028
2021-07-14,Sutter,101,95872,9816,9766,95,9861,114
2021-07-14,Tehama,103,63373,5199,5142,599,5741,64
2021-07-14,Trinity,105,12862,502,341,107,448,3
2021-07-14,Tulare,107,460477,50721,49908,9316,59224,853
2021-07-14,Tuolumne,109,53932,4150,4128,44,4172,64
2021-07-14,Ventura,111,848112,82765,82041,3282,85323,1040
2021-07-14,Yolo,113,214977,14508,14332,410,14742,213
2021-07-14,Yuba,115,75493,6390,6294,133,6427,52
2021-07-13,Alameda,001,1643700,92123,90874,2076,92950,1255
2021-07-13,Alpine,003,1148,88,89,0,89,0
2021-07-13,Amador,005,37829,3802,3783,34,3817,48
2021-07-13,Butte,007,227075,12986,12802,1923,14725,202
2021-07-13,Calaveras,009,45235,2250,2230,15,2245,57
2021-07-13,Colusa,011,21464,1991,1972,333,2305,16
2021-07-13,Contra Costa,013,1133247,72939,71963,1380,73343,823
2021-07-13,Del Norte,015,27424,1511,1471,14,1485,8
2021-07-13,El Dorado,017,186661,10754,10581,818,11399,114
2021-07-13,Fresno,019,978130,104297,102909,8942,111851,1727
2021-07-13,Glenn,021,27897,2469,2448,577,3025,20
2021-07-13,Humboldt,023,135768,4698,4634,56,4690,51
2021-07-13,Imperial,025,180216,28993,28792,2766,31558,741
2021-07-13,Inyo,027,18085,1421,1415,13,1428,36
2021-07-13,Kern,029,883053,98581,97698,11408,109106,1346
2021-07-13,Kings,031,150075,23463,23132,1132,24264,246
2021-07-13,Lake,033,64148,3829,3719,13,3732,63
2021-07-13,Lassen,035,31185,5318,5292,120,5412,21
2021-07-13,Los Angeles,037,10098052,1228423,1217184,43017,1260201,24569
2021-07-13,Madera,039,155013,16981,16773,971,17744,240
2021-07-13,Marin,041,260295,14453,14254,271,14525,233
2021-07-13,Mariposa,043,17540,446,443,11,454,5
2021-07-13,Mendocino,045,87422,4308,4185,89,4274,49
2021-07-13,Merced,047,269075,31502,31379,1076,32455,471
2021-07-13,Modoc,049,8938,423,411,148,559,4
2021-07-13,Mono,051,14174,1273,1277,18,1295,3
2021-07-13,Monterey,053,433212,43564,43333,1916,45249,504
2021-07-13,Napa,055,140530,10169,10118,42,10160,81
2021-07-13,Nevada,057,99092,5140,5053,199,5252,72
2021-07-13,Orange,059,3164182,259654,257339,11873,269212,5136
2021-07-13,Placer,061,380077,24417,24091,1653,25744,303
2021-07-13,Plumas,063,18699,734,716,14,730,4
2021-07-13,Riverside,065,2383286,298503,294302,14397,308699,4541
2021-07-13,Sacramento,067,1510023,111138,109990,1965,111955,1687
2021-07-13,San Benito,069,59416,6183,6173,116,6289,63
2021-07-13,San Bernardino,071,2135413,297595,295596,9226,304822,5183
2021-07-13,San Diego,073,3302833,287417,284997,16086,301083,3785
2021-07-13,San Francisco,075,870044,38363,37725,1372,39097,559
2021-07-13,San Joaquin,077,732212,75233,74500,3776,78276,1417
2021-07-13,San Luis Obispo,079,281455,21755,21423,778,22201,258
2021-07-13,San Mateo,081,765935,43558,43180,526,43706,542
2021-07-13,Santa Barbara,083,443738,34980,34679,1161,35840,461
2021-07-13,Santa Clara,085,1922200,120991,119727,806,120533,2098
2021-07-13,Santa Cruz,087,273765,16481,16315,820,17135,207
2021-07-13,Shasta,089,179085,12740,12659,1684,14343,209
2021-07-13,Sierra,091,2930,66,62,12,74,0
2021-07-13,Siskiyou,093,43540,2013,1916,409,2325,29
2021-07-13,Solano,095,438530,34276,33918,631,34549,268
2021-07-13,Sonoma,097,501317,31732,31431,373,31804,322
2021-07-13,Stanislaus,099,539301,57645,57282,6145,63427,1028
2021-07-13,Sutter,101,95872,9798,9752,94,9846,114
2021-07-13,Tehama,103,63373,5192,5144,599,5743,64
2021-07-13,Trinity,105,12862,502,341,106,447,3
2021-07-13,Tulare,107,460477,50696,49891,9300,59191,853
2021-07-13,Tuolumne,109,53932,4142,4122,43,4165,64
2021-07-13,Ventura,111,848112,82680,81982,3257,85239,1040
2021-07-13,Yolo,113,214977,14480,14320,403,14723,213
2021-07-13,Yuba,115,75493,6373,6279,133,6412,52
2021-07-12,Alameda,001,1643700,91864,90720,2069,92789,1254
2021-07-12,Alpine,003,1148,88,89,0,89,0
2021-07-12,Amador,005,37829,3795,3781,34,3815,47
2021-07-12,Butte,007,227075,12966,12796,1921,14717,202
2021-07-12,Calaveras,009,45235,2248,2228,15,2243,57
2021-07-12,Colusa,011,21464,1987,1971,332,2303,16
2021-07-12,Contra Costa,013,1133247,72738,71833,1375,73208,823
2021-07-12,Del Norte,015,27424,1508,1469,14,1483,8
2021-07-12,El Dorado,017,186661,10726,10569,816,11385,114
2021-07-12,Fresno,019,978130,104203,102853,8929,111782,1728
2021-07-12,Glenn,021,27897,2469,2446,577,3023,20
2021-07-12,Humboldt,023,135768,4682,4621,56,4677,51
2021-07-12,Imperial,025,180216,28963,28789,2766,31555,741
2021-07-12,Inyo,027,18085,1421,1415,13,1428,36
2021-07-12,Kern,029,883053,98512,97660,11383,109043,1346
2021-07-12,Kings,031,150075,23443,23124,1130,24254,246
2021-07-12,Lake,033,64148,3808,3706,13,3719,63
2021-07-12,Lassen,035,31185,5317,5292,120,5412,21
2021-07-12,Los Angeles,037,10098052,1226632,1216230,42882,1259112,24559
2021-07-12,Madera,039,155013,16970,16772,971,17743,240
2021-07-12,Marin,041,260295,14428,14238,270,14508,233
2021-07-12,Mariposa,043,17540,446,442,11,453,5
2021-07-12,Mendocino,045,87422,4297,4175,89,4264,49
2021-07-12,Merced,047,269075,31471,31374,1075,32449,471
2021-07-12,Modoc,049,8938,422,411,148,559,4
2021-07-12,Mono,051,14174,1271,1275,18,1293,3
2021-07-12,Monterey,053,433212,43543,43315,1912,45227,504
2021-07-12,Napa,055,140530,10151,10104,41,10145,81
2021-07-12,Nevada,057,99092,5117,5046,199,5245,72
2021-07-12,Orange,059,3164182,259301,257171,11848,269019,5136
2021-07-12,Placer,061,380077,24366,24052,1647,25699,302
2021-07-12,Plumas,063,18699,734,716,14,730,4
2021-07-12,Riverside,065,2383286,298195,294108,14367,308475,4541
2021-07-12,Sacramento,067,1510023,110923,109849,1939,111788,1685
2021-07-12,San Benito,069,59416,6180,6166,116,6282,63
2021-07-12,San Bernardino,071,2135413,297324,295447,9212,304659,5171
2021-07-12,San Diego,073,3302833,286948,284648,16010,300658,3785
2021-07-12,San Francisco,075,870044,38216,37656,1369,39025,559
2021-07-12,San Joaquin,077,732212,75139,74424,3766,78190,1415
2021-07-12,San Luis Obispo,079,281455,21736,21408,777,22185,258
2021-07-12,San Mateo,081,765935,43465,43138,519,43657,542
2021-07-12,Santa Barbara,083,443738,34937,34664,1159,35823,461
2021-07-12,Santa Clara,085,1922200,120826,119634,803,120437,2098
2021-07-12,Santa Cruz,087,273765,16456,16310,819,17129,207
2021-07-12,Shasta,089,179085,12733,12648,1681,14329,208
2021-07-12,Sierra,091,2930,66,62,12,74,0
2021-07-12,Siskiyou,093,43540,2008,1916,404,2320,29
2021-07-12,Solano,095,438530,34186,33859,622,34481,268
2021-07-12,Sonoma,097,501317,31684,31377,372,31749,322
2021-07-12,Stanislaus,099,539301,57576,57243,6138,63381,1028
2021-07-12,Sutter,101,95872,9781,9736,93,9829,114
2021-07-12,Tehama,103,63373,5187,5138,598,5736,63
2021-07-12,Trinity,105,12862,498,340,104,444,3
2021-07-12,Tulare,107,460477,50668,49882,9287,59169,853
2021-07-12,Tuolumne,109,53932,4138,4116,43,4159,64
2021-07-12,Ventura,111,848112,82579,81919,3236,85155,1040
2021-07-12,Yolo,113,214977,14452,14303,399,14702,213
2021-07-12,Yuba,115,75493,6358,6266,133,6399,52
2021-07-11,Alameda,001,1643700,91533,90597,2056,92653,1254
2021-07-11,Alpine,003,1148,88,89,0,89,0
2021-07-11,Amador,005,37829,3793,3779,34,3813,47
2021-07-11,Butte,007,227075,12944,12794,1915,14709,202
2021-07-11,Calaveras,009,45235,2246,2226,14,2240,57
2021-07-11,Colusa,011,21464,1986,1971,331,2302,16
2021-07-11,Contra Costa,013,1133247,72528,71744,1368,73112,823
2021-07-11,Del Norte,015,27424,1504,1467,13,1480,8
2021-07-11,El Dorado,017,186661,10697,10554,814,11368,114
2021-07-11,Fresno,019,978130,104108,102813,8909,111722,1728
2021-07-11,Glenn,021,27897,2468,2446,577,3023,20
2021-07-11,Humboldt,023,135768,4669,4611,55,4666,51
2021-07-11,Imperial,025,180216,28945,28787,2765,31552,741
2021-07-11,Inyo,027,18085,1419,1415,13,1428,36
2021-07-11,Kern,029,883053,98439,97637,11367,109004,1346
2021-07-11,Kings,031,150075,23412,23116,1127,24243,246
2021-07-11,Lake,033,64148,3777,3699,13,3712,63
2021-07-11,Lassen,035,31185,5314,5291,120,5411,21
2021-07-11,Los Angeles,037,10098052,1224880,1215182,42724,1257906,24558
2021-07-11,Madera,039,155013,16951,16766,970,17736,240
2021-07-11,Marin,041,260295,14402,14231,270,14501,233
2021-07-11,Mariposa,043,17540,445,442,11,453,5
2021-07-11,Mendocino,045,87422,4277,4167,89,4256,49
2021-07-11,Merced,047,269075,31447,31366,1070,32436,471
2021-07-11,Modoc,049,8938,421,411,148,559,4
2021-07-11,Mono,051,14174,1271,1275,18,1293,3
2021-07-11,Monterey,053,433212,43524,43307,1908,45215,504
2021-07-11,Napa,055,140530,10147,10100,41,10141,81
2021-07-11,Nevada,057,99092,5106,5035,198,5233,72
2021-07-11,Orange,059,3164182,258988,257009,11819,268828,5136
2021-07-11,Placer,061,380077,24309,24017,1635,25652,302
2021-07-11,Plumas,063,18699,734,716,14,730,4
2021-07-11,Riverside,065,2383286,297931,293969,14349,308318,4541
2021-07-11,Sacramento,067,1510023,110644,109696,1929,111625,1685
2021-07-11,San Benito,069,59416,6175,6163,116,6279,63
2021-07-11,San Bernardino,071,2135413,297017,295342,9187,304529,5167
2021-07-11,San Diego,073,3302833,286534,283819,15924,299743,3784
2021-07-11,San Francisco,075,870044,38087,37596,1363,38959,559
2021-07-11,San Joaquin,077,732212,75022,74376,3749,78125,1415
2021-07-11,San Luis Obispo,079,281455,21703,21403,776,22179,258
2021-07-11,San Mateo,081,765935,43386,43107,512,43619,542
2021-07-11,Santa Barbara,083,443738,34890,34646,1159,35805,461
2021-07-11,Santa Clara,085,1922200,120672,119549,802,120351,2098
2021-07-11,Santa Cruz,087,273765,16440,16303,819,17122,207
2021-07-11,Shasta,089,179085,12716,12647,1679,14326,208
2021-07-11,Sierra,091,2930,66,62,12,74,0
2021-07-11,Siskiyou,093,43540,2004,1915,402,2317,29
2021-07-11,Solano,095,438530,34104,33837,618,34455,268
2021-07-11,Sonoma,097,501317,31602,31352,372,31724,322
2021-07-11,Stanislaus,099,539301,57511,57230,6127,63357,1028
2021-07-11,Sutter,101,95872,9767,9728,93,9821,114
2021-07-11,Tehama,103,63373,5184,5138,598,5736,63
2021-07-11,Trinity,105,12862,497,340,104,444,3
2021-07-11,Tulare,107,460477,50643,49877,9269,59146,853
2021-07-11,Tuolumne,109,53932,4132,4116,43,4159,64
2021-07-11,Ventura,111,848112,82506,81875,3216,85091,1040
2021-07-11,Yolo,113,214977,14426,14285,393,14678,213
2021-07-11,Yuba,115,75493,6347,6260,133,6393,52
2021-07-10,Alameda,001,1643700,91382,90090,2052,92142,1252
2021-07-10,Alpine,003,1148,88,89,0,89,0
2021-07-10,Amador,005,37829,3787,3773,34,3807,47
2021-07-10,Butte,007,227075,12933,12764,1912,14676,202
2021-07-10,Calaveras,009,45235,2245,2214,14,2228,57
2021-07-10,Colusa,011,21464,1984,1969,331,2300,16
2021-07-10,Contra Costa,013,1133247,72428,71376,1367,72743,821
2021-07-10,Del Norte,015,27424,1502,1451,13,1464,8
2021-07-10,El Dorado,017,186661,10681,10508,810,11318,114
2021-07-10,Fresno,019,978130,104075,102675,8902,111577,1730
2021-07-10,Glenn,021,27897,2465,2440,576,3016,20
2021-07-10,Humboldt,023,135768,4660,4574,55,4629,51
2021-07-10,Imperial,025,180216,28932,28729,2765,31494,741
2021-07-10,Inyo,027,18085,1418,1415,13,1428,36
2021-07-10,Kern,029,883053,98399,97538,11350,108888,1346
2021-07-10,Kings,031,150075,23405,23090,1126,24216,246
2021-07-10,Lake,033,64148,3760,3667,13,3680,63
2021-07-10,Lassen,035,31185,5314,5290,120,5410,21
2021-07-10,Los Angeles,037,10098052,1223858,1212043,42621,1254664,24542
2021-07-10,Madera,039,155013,16945,16744,967,17711,241
2021-07-10,Marin,041,260295,14388,14194,270,14464,233
2021-07-10,Mariposa,043,17540,445,442,11,453,5
2021-07-10,Mendocino,045,87422,4270,4153,88,4241,49
2021-07-10,Merced,047,269075,31434,31328,1070,32398,470
2021-07-10,Modoc,049,8938,421,410,148,558,4
2021-07-10,Mono,051,14174,1271,1275,18,1293,3
2021-07-10,Monterey,053,433212,43510,43251,1906,45157,499
2021-07-10,Napa,055,140530,10135,10077,41,10118,81
2021-07-10,Nevada,057,99092,5097,5000,198,5198,72
2021-07-10,Orange,059,3164182,258810,256438,11803,268241,5135
2021-07-10,Placer,061,380077,24280,23916,1625,25541,302
2021-07-10,Plumas,063,18699,733,717,14,731,4
2021-07-10,Riverside,065,2383286,297741,293474,14335,307809,4541
2021-07-10,Sacramento,067,1510023,110495,109091,1924,111015,1682
2021-07-10,San Benito,069,59416,6170,6141,116,6257,63
2021-07-10,San Bernardino,071,2135413,296829,294932,9175,304107,5117
2021-07-10,San Diego,073,3302833,286244,283577,15871,299448,3783
2021-07-10,San Francisco,075,870044,38004,37338,1360,38698,559
2021-07-10,San Joaquin,077,732212,74965,74150,3743,77893,1412
2021-07-10,San Luis Obispo,079,281455,21692,21375,775,22150,258
2021-07-10,San Mateo,081,765935,43334,42948,510,43458,542
2021-07-10,Santa Barbara,083,443738,34863,34595,1159,35754,460
2021-07-10,Santa Clara,085,1922200,120569,119330,799,120129,2094
2021-07-10,Santa Cruz,087,273765,16433,16286,819,17105,207
2021-07-10,Shasta,089,179085,12703,12623,1674,14297,206
2021-07-10,Sierra,091,2930,66,61,12,73,0
2021-07-10,Siskiyou,093,43540,2002,1909,399,2308,29
2021-07-10,Solano,095,438530,34062,33678,612,34290,268
2021-07-10,Sonoma,097,501317,31551,31231,372,31603,317
2021-07-10,Stanislaus,099,539301,57475,57104,6117,63221,1026
2021-07-10,Sutter,101,95872,9755,9692,93,9785,114
2021-07-10,Tehama,103,63373,5181,5131,598,5729,63
2021-07-10,Trinity,105,12862,497,341,104,445,3
2021-07-10,Tulare,107,460477,50633,49850,9263,59113,853
2021-07-10,Tuolumne,109,53932,4130,4114,43,4157,64
2021-07-10,Ventura,111,848112,82461,81713,3198,84911,1039
2021-07-10,Yolo,113,214977,14405,14250,390,14640,213
2021-07-10,Yuba,115,75493,6337,6238,133,6371,52
2021-07-09,Alameda,001,1643700,91222,90090,2047,92137,1252
2021-07-09,Alpine,003,1148,88,89,0,89,0
2021-07-09,Amador,005,37829,3786,3773,34,3807,47
2021-07-09,Butte,007,227075,12922,12764,1910,14674,202
2021-07-09,Calaveras,009,45235,2243,2214,14,2228,57
2021-07-09,Colusa,011,21464,1983,1969,331,2300,16
2021-07-09,Contra Costa,013,1133247,72303,71376,1365,72741,821
2021-07-09,Del Norte,015,27424,1497,1451,13,1464,8
2021-07-09,El Dorado,017,186661,10666,10508,809,11317,114
2021-07-09,Fresno,019,978130,104019,102675,8895,111570,1730
2021-07-09,Glenn,021,27897,2464,2440,574,3014,20
2021-07-09,Humboldt,023,135768,4641,4574,55,4629,51
2021-07-09,Imperial,025,180216,28924,28729,2764,31493,741
2021-07-09,Inyo,027,18085,1417,1415,13,1428,36
2021-07-09,Kern,029,883053,98361,97538,11338,108876,1346
2021-07-09,Kings,031,150075,23394,23090,1125,24215,246
2021-07-09,Lake,033,64148,3746,3667,13,3680,63
2021-07-09,Lassen,035,31185,5312,5290,119,5409,21
2021-07-09,Los Angeles,037,10098052,1222853,1212043,42549,1254592,24542
2021-07-09,Madera,039,155013,16935,16744,966,17710,241
2021-07-09,Marin,041,260295,14367,14194,269,14463,233
2021-07-09,Mariposa,043,17540,445,442,11,453,5
2021-07-09,Mendocino,045,87422,4263,4153,88,4241,49
2021-07-09,Merced,047,269075,31419,31328,1070,32398,470
2021-07-09,Modoc,049,8938,421,410,148,558,4
2021-07-09,Mono,051,14174,1271,1275,18,1293,3
2021-07-09,Monterey,053,433212,43501,43251,1906,45157,499
2021-07-09,Napa,055,140530,10128,10077,41,10118,81
2021-07-09,Nevada,057,99092,5088,5000,198,5198,72
2021-07-09,Orange,059,3164182,258605,256438,11789,268227,5135
2021-07-09,Placer,061,380077,24258,23916,1619,25535,302
2021-07-09,Plumas,063,18699,731,717,14,731,4
2021-07-09,Riverside,065,2383286,297555,293474,14322,307796,4541
2021-07-09,Sacramento,067,1510023,110341,109091,1915,111006,1682
2021-07-09,San Benito,069,59416,6168,6141,116,6257,63
2021-07-09,San Bernardino,071,2135413,296677,294932,9168,304100,5117
2021-07-09,San Diego,073,3302833,285955,283577,15823,299400,3783
2021-07-09,San Francisco,075,870044,37924,37338,1353,38691,559
2021-07-09,San Joaquin,077,732212,74891,74150,3736,77886,1412
2021-07-09,San Luis Obispo,079,281455,21680,21375,775,22150,258
2021-07-09,San Mateo,081,765935,43290,42948,506,43454,542
2021-07-09,Santa Barbara,083,443738,34842,34595,1158,35753,460
2021-07-09,Santa Clara,085,1922200,120459,119330,799,120129,2094
2021-07-09,Santa Cruz,087,273765,16430,16286,819,17105,207
2021-07-09,Shasta,089,179085,12697,12623,1669,14292,206
2021-07-09,Sierra,091,2930,66,61,12,73,0
2021-07-09,Siskiyou,093,43540,2000,1909,398,2307,29
2021-07-09,Solano,095,438530,34026,33678,608,34286,268
2021-07-09,Sonoma,097,501317,31515,31231,372,31603,317
2021-07-09,Stanislaus,099,539301,57446,57104,6115,63219,1026
2021-07-09,Sutter,101,95872,9746,9692,93,9785,114
2021-07-09,Tehama,103,63373,5179,5131,598,5729,63
2021-07-09,Trinity,105,12862,496,341,101,442,3
2021-07-09,Tulare,107,460477,50620,49850,9257,59107,853
2021-07-09,Tuolumne,109,53932,4126,4114,43,4157,64
2021-07-09,Ventura,111,848112,82406,81713,3189,84902,1039
2021-07-09,Yolo,113,214977,14390,14250,386,14636,213
2021-07-09,Yuba,115,75493,6324,6238,133,6371,52
2021-07-08,Alameda,001,1643700,91015,90090,2044,92134,1252
2021-07-08,Alpine,003,1148,88,89,0,89,0
2021-07-08,Amador,005,37829,3784,3773,34,3807,47
2021-07-08,Butte,007,227075,12909,12764,1907,14671,202
2021-07-08,Calaveras,009,45235,2240,2214,13,2227,57
2021-07-08,Colusa,011,21464,1983,1969,331,2300,16
2021-07-08,Contra Costa,013,1133247,72175,71376,1360,72736,821
2021-07-08,Del Norte,015,27424,1495,1451,13,1464,8
2021-07-08,El Dorado,017,186661,10649,10508,804,11312,114
2021-07-08,Fresno,019,978130,103957,102675,8884,111559,1730
2021-07-08,Glenn,021,27897,2464,2440,574,3014,20
2021-07-08,Humboldt,023,135768,4625,4574,54,4628,51
2021-07-08,Imperial,025,180216,28912,28729,2763,31492,741
2021-07-08,Inyo,027,18085,1417,1415,13,1428,36
2021-07-08,Kern,029,883053,98313,97538,11323,108861,1346
2021-07-08,Kings,031,150075,23385,23090,1125,24215,246
2021-07-08,Lake,033,64148,3732,3667,13,3680,63
2021-07-08,Lassen,035,31185,5309,5290,119,5409,21
2021-07-08,Los Angeles,037,10098052,1221639,1212043,42454,1254497,24542
2021-07-08,Madera,039,155013,16919,16744,966,17710,241
2021-07-08,Marin,041,260295,14353,14194,269,14463,233
2021-07-08,Mariposa,043,17540,444,442,11,453,5
2021-07-08,Mendocino,045,87422,4260,4153,88,4241,49
2021-07-08,Merced,047,269075,31405,31328,1068,32396,470
2021-07-08,Modoc,049,8938,421,410,148,558,4
2021-07-08,Mono,051,14174,1271,1275,18,1293,3
2021-07-08,Monterey,053,433212,43481,43251,1900,45151,499
2021-07-08,Napa,055,140530,10124,10077,41,10118,81
2021-07-08,Nevada,057,99092,5082,5000,198,5198,72
2021-07-08,Orange,059,3164182,258410,256438,11767,268205,5135
2021-07-08,Placer,061,380077,24219,23916,1611,25527,302
2021-07-08,Plumas,063,18699,730,717,14,731,4
2021-07-08,Riverside,065,2383286,297354,293474,14306,307780,4541
2021-07-08,Sacramento,067,1510023,110119,109091,1908,110999,1682
2021-07-08,San Benito,069,59416,6165,6141,116,6257,63
2021-07-08,San Bernardino,071,2135413,296502,294932,9159,304091,5117
2021-07-08,San Diego,073,3302833,285628,283577,15775,299352,3783
2021-07-08,San Francisco,075,870044,37844,37338,1349,38687,559
2021-07-08,San Joaquin,077,732212,74803,74150,3723,77873,1412
2021-07-08,San Luis Obispo,079,281455,21668,21375,772,22147,258
2021-07-08,San Mateo,081,765935,43239,42948,505,43453,542
2021-07-08,Santa Barbara,083,443738,34815,34595,1156,35751,460
2021-07-08,Santa Clara,085,1922200,120366,119330,798,120128,2094
2021-07-08,Santa Cruz,087,273765,16424,16286,819,17105,207
2021-07-08,Shasta,089,179085,12691,12623,1665,14288,206
2021-07-08,Sierra,091,2930,66,61,12,73,0
2021-07-08,Siskiyou,093,43540,1995,1909,395,2304,29
2021-07-08,Solano,095,438530,33971,33678,602,34280,268
2021-07-08,Sonoma,097,501317,31484,31231,371,31602,317
2021-07-08,Stanislaus,099,539301,57420,57104,6111,63215,1026
2021-07-08,Sutter,101,95872,9732,9692,91,9783,114
2021-07-08,Tehama,103,63373,5176,5131,597,5728,63
2021-07-08,Trinity,105,12862,496,341,101,442,3
2021-07-08,Tulare,107,460477,50602,49850,9249,59099,853
2021-07-08,Tuolumne,109,53932,4124,4114,43,4157,64
2021-07-08,Ventura,111,848112,82342,81713,3173,84886,1039
2021-07-08,Yolo,113,214977,14371,14250,384,14634,213
2021-07-08,Yuba,115,75493,6316,6238,133,6371,52
2021-07-07,Alameda,001,1643700,90830,89995,2038,92033,1253
2021-07-07,Alpine,003,1148,88,89,0,89,0
2021-07-07,Amador,005,37829,3779,3770,34,3804,47
2021-07-07,Butte,007,227075,12896,12750,1902,14652,202
2021-07-07,Calaveras,009,45235,2233,2212,13,2225,57
2021-07-07,Colusa,011,21464,1979,1969,331,2300,16
2021-07-07,Contra Costa,013,1133247,72028,71308,1358,72666,821
2021-07-07,Del Norte,015,27424,1490,1446,13,1459,8
2021-07-07,El Dorado,017,186661,10629,10494,802,11296,114
2021-07-07,Fresno,019,978130,103907,102639,8877,111516,1729
2021-07-07,Glenn,021,27897,2464,2441,574,3015,20
2021-07-07,Humboldt,023,135768,4611,4566,54,4620,51
2021-07-07,Imperial,025,180216,28905,28701,2763,31464,740
2021-07-07,Inyo,027,18085,1416,1415,13,1428,36
2021-07-07,Kern,029,883053,98269,97507,11308,108815,1348
2021-07-07,Kings,031,150075,23372,23085,1122,24207,245
2021-07-07,Lake,033,64148,3713,3660,13,3673,63
2021-07-07,Lassen,035,31185,5309,5286,119,5405,21
2021-07-07,Los Angeles,037,10098052,1220458,1211316,42350,1253666,24531
2021-07-07,Madera,039,155013,16908,16733,964,17697,241
2021-07-07,Marin,041,260295,14334,14183,268,14451,233
2021-07-07,Mariposa,043,17540,442,442,11,453,5
2021-07-07,Mendocino,045,87422,4251,4145,88,4233,49
2021-07-07,Merced,047,269075,31390,31317,1068,32385,470
2021-07-07,Modoc,049,8938,421,410,148,558,4
2021-07-07,Mono,051,14174,1270,1274,18,1292,3
2021-07-07,Monterey,053,433212,43456,43233,1898,45131,494
2021-07-07,Napa,055,140530,10113,10078,41,10119,81
2021-07-07,Nevada,057,99092,5075,4996,198,5194,72
2021-07-07,Orange,059,3164182,258184,256301,11745,268046,5132
2021-07-07,Placer,061,380077,24183,23901,1601,25502,302
2021-07-07,Plumas,063,18699,730,710,14,724,4
2021-07-07,Riverside,065,2383286,297140,293331,14296,307627,4538
2021-07-07,Sacramento,067,1510023,109929,108954,1900,110854,1682
2021-07-07,San Benito,069,59416,6160,6137,116,6253,63
2021-07-07,San Bernardino,071,2135413,296333,294787,9152,303939,5087
2021-07-07,San Diego,073,3302833,285308,283377,15735,299112,3782
2021-07-07,San Francisco,075,870044,37752,37284,1346,38630,558
2021-07-07,San Joaquin,077,732212,74727,74095,3708,77803,1410
2021-07-07,San Luis Obispo,079,281455,21659,21360,770,22130,258
2021-07-07,San Mateo,081,765935,43185,42908,502,43410,542
2021-07-07,Santa Barbara,083,443738,34789,34582,1156,35738,460
2021-07-07,Santa Clara,085,1922200,120268,119250,797,120047,2094
2021-07-07,Santa Cruz,087,273765,16415,16279,818,17097,207
2021-07-07,Shasta,089,179085,12683,12613,1662,14275,206
2021-07-07,Sierra,091,2930,66,60,12,72,0
2021-07-07,Siskiyou,093,43540,1989,1908,391,2299,29
2021-07-07,Solano,095,438530,33922,33659,595,34254,268
2021-07-07,Sonoma,097,501317,31438,31172,371,31543,316
2021-07-07,Stanislaus,099,539301,57388,57102,6106,63208,1028
2021-07-07,Sutter,101,95872,9722,9683,91,9774,114
2021-07-07,Tehama,103,63373,5175,5129,597,5726,63
2021-07-07,Trinity,105,12862,496,341,101,442,3
2021-07-07,Tulare,107,460477,50598,49835,9240,59075,853
2021-07-07,Tuolumne,109,53932,4120,4115,42,4157,64
2021-07-07,Ventura,111,848112,82298,81608,3159,84767,1036
2021-07-07,Yolo,113,214977,14361,14236,381,14617,213
2021-07-07,Yuba,115,75493,6300,6233,133,6366,51
2021-07-06,Alameda,001,1643700,90633,89918,2030,91948,1253
2021-07-06,Alpine,003,1148,88,89,0,89,0
2021-07-06,Amador,005,37829,3778,3768,33,3801,47
2021-07-06,Butte,007,227075,12883,12744,1899,14643,201
2021-07-06,Calaveras,009,45235,2233,2211,13,2224,55
2021-07-06,Colusa,011,21464,1978,1967,328,2295,16
2021-07-06,Contra Costa,013,1133247,71900,71262,1355,72617,820
2021-07-06,Del Norte,015,27424,1486,1445,13,1458,8
2021-07-06,El Dorado,017,186661,10611,10484,801,11285,113
2021-07-06,Fresno,019,978130,103855,102616,8865,111481,1727
2021-07-06,Glenn,021,27897,2463,2438,574,3012,20
2021-07-06,Humboldt,023,135768,4597,4565,53,4618,49
2021-07-06,Imperial,025,180216,28890,28693,2761,31454,739
2021-07-06,Inyo,027,18085,1416,1412,13,1425,36
2021-07-06,Kern,029,883053,98227,97491,11297,108788,1346
2021-07-06,Kings,031,150075,23364,23077,1121,24198,245
2021-07-06,Lake,033,64148,3703,3659,13,3672,63
2021-07-06,Lassen,035,31185,5308,5288,118,5406,21
2021-07-06,Los Angeles,037,10098052,1219238,1210965,42251,1253216,24525
2021-07-06,Madera,039,155013,16896,16730,964,17694,241
2021-07-06,Marin,041,260295,14320,14181,268,14449,233
2021-07-06,Mariposa,043,17540,442,442,11,453,5
2021-07-06,Mendocino,045,87422,4244,4143,88,4231,49
2021-07-06,Merced,047,269075,31373,31317,1067,32384,470
2021-07-06,Modoc,049,8938,421,411,148,559,4
2021-07-06,Mono,051,14174,1269,1274,18,1292,3
2021-07-06,Monterey,053,433212,43433,43224,1897,45121,494
2021-07-06,Napa,055,140530,10102,10081,41,10122,81
2021-07-06,Nevada,057,99092,5066,4988,198,5186,72
2021-07-06,Orange,059,3164182,257940,256227,11728,267955,5129
2021-07-06,Placer,061,380077,24142,23876,1595,25471,302
2021-07-06,Plumas,063,18699,729,708,14,722,4
2021-07-06,Riverside,065,2383286,296938,293227,14278,307505,4539
2021-07-06,Sacramento,067,1510023,109718,108850,1892,110742,1679
2021-07-06,San Benito,069,59416,6156,6137,116,6253,63
2021-07-06,San Bernardino,071,2135413,296154,294712,9139,303851,5056
2021-07-06,San Diego,073,3302833,284950,283278,15676,298954,3782
2021-07-06,San Francisco,075,870044,37635,37251,1345,38596,558
2021-07-06,San Joaquin,077,732212,74657,74019,3696,77715,1410
2021-07-06,San Luis Obispo,079,281455,21642,21354,769,22123,257
2021-07-06,San Mateo,081,765935,43110,42895,502,43397,541
2021-07-06,Santa Barbara,083,443738,34770,34572,1154,35726,460
2021-07-06,Santa Clara,085,1922200,120150,119194,794,119988,2095
2021-07-06,Santa Cruz,087,273765,16410,16274,817,17091,207
2021-07-06,Shasta,089,179085,12673,12606,1660,14266,205
2021-07-06,Sierra,091,2930,65,60,12,72,0
2021-07-06,Siskiyou,093,43540,1986,1905,387,2292,29
2021-07-06,Solano,095,438530,33871,33619,592,34211,268
2021-07-06,Sonoma,097,501317,31375,31130,370,31500,316
2021-07-06,Stanislaus,099,539301,57340,57120,6095,63215,1029
2021-07-06,Sutter,101,95872,9713,9674,90,9764,114
2021-07-06,Tehama,103,63373,5172,5126,596,5722,63
2021-07-06,Trinity,105,12862,496,341,101,442,3
2021-07-06,Tulare,107,460477,50583,49826,9229,59055,853
2021-07-06,Tuolumne,109,53932,4118,4113,42,4155,64
2021-07-06,Ventura,111,848112,82258,81534,3133,84667,1033
2021-07-06,Yolo,113,214977,14339,14227,378,14605,213
2021-07-06,Yuba,115,75493,6289,6231,133,6364,51
2021-07-05,Alameda,001,1643700,90455,89892,2025,91917,1253
2021-07-05,Alpine,003,1148,88,89,0,89,0
2021-07-05,Amador,005,37829,3776,3768,33,3801,47
2021-07-05,Butte,007,227075,12875,12740,1889,14629,201
2021-07-05,Calaveras,009,45235,2231,2211,13,2224,55
2021-07-05,Colusa,011,21464,1976,1966,327,2293,16
2021-07-05,Contra Costa,013,1133247,71772,71235,1355,72590,820
2021-07-05,Del Norte,015,27424,1482,1446,13,1459,8
2021-07-05,El Dorado,017,186661,10586,10481,801,11282,113
2021-07-05,Fresno,019,978130,103796,102592,8850,111442,1727
2021-07-05,Glenn,021,27897,2460,2438,573,3011,20
2021-07-05,Humboldt,023,135768,4583,4563,53,4616,49
2021-07-05,Imperial,025,180216,28871,28689,2761,31450,739
2021-07-05,Inyo,027,18085,1416,1412,13,1425,36
2021-07-05,Kern,029,883053,98179,97479,11276,108755,1346
2021-07-05,Kings,031,150075,23356,23065,1118,24183,245
2021-07-05,Lake,033,64148,3685,3645,13,3658,63
2021-07-05,Lassen,035,31185,5305,5288,117,5405,21
2021-07-05,Los Angeles,037,10098052,1218044,1210653,42150,1252803,24522
2021-07-05,Madera,039,155013,16885,16722,963,17685,241
2021-07-05,Marin,041,260295,14299,14178,268,14446,233
2021-07-05,Mariposa,043,17540,442,441,11,452,5
2021-07-05,Mendocino,045,87422,4239,4139,87,4226,49
2021-07-05,Merced,047,269075,31353,31312,1067,32379,470
2021-07-05,Modoc,049,8938,421,410,148,558,4
2021-07-05,Mono,051,14174,1269,1273,18,1291,3
2021-07-05,Monterey,053,433212,43413,43218,1892,45110,494
2021-07-05,Napa,055,140530,10096,10074,41,10115,81
2021-07-05,Nevada,057,99092,5048,4980,197,5177,72
2021-07-05,Orange,059,3164182,257739,256173,11710,267883,5129
2021-07-05,Placer,061,380077,24095,23867,1587,25454,302
2021-07-05,Plumas,063,18699,728,708,14,722,4
2021-07-05,Riverside,065,2383286,296747,293193,14266,307459,4539
2021-07-05,Sacramento,067,1510023,109536,108758,1883,110641,1679
2021-07-05,San Benito,069,59416,6149,6137,116,6253,63
2021-07-05,San Bernardino,071,2135413,295991,294647,9132,303779,5037
2021-07-05,San Diego,073,3302833,284587,282834,15632,298466,3782
2021-07-05,San Francisco,075,870044,37548,37237,1340,38577,558
2021-07-05,San Joaquin,077,732212,74587,73999,3691,77690,1410
2021-07-05,San Luis Obispo,079,281455,21629,21351,768,22119,257
2021-07-05,San Mateo,081,765935,43058,42876,499,43375,541
2021-07-05,Santa Barbara,083,443738,34750,34569,1154,35723,460
2021-07-05,Santa Clara,085,1922200,120044,119184,792,119976,2095
2021-07-05,Santa Cruz,087,273765,16401,16273,816,17089,208
2021-07-05,Shasta,089,179085,12664,12603,1658,14261,205
2021-07-05,Sierra,091,2930,65,60,12,72,0
2021-07-05,Siskiyou,093,43540,1984,1904,386,2290,29
2021-07-05,Solano,095,438530,33801,33612,586,34198,268
2021-07-05,Sonoma,097,501317,31322,31116,370,31486,316
2021-07-05,Stanislaus,099,539301,57310,57109,6084,63193,1029
2021-07-05,Sutter,101,95872,9701,9667,90,9757,114
2021-07-05,Tehama,103,63373,5171,5125,596,5721,63
2021-07-05,Trinity,105,12862,495,341,100,441,3
2021-07-05,Tulare,107,460477,50565,49818,9226,59044,853
2021-07-05,Tuolumne,109,53932,4114,4112,42,4154,64
2021-07-05,Ventura,111,848112,82207,81519,3114,84633,1033
2021-07-05,Yolo,113,214977,14319,14225,370,14595,213
2021-07-05,Yuba,115,75493,6281,6223,133,6356,51
2021-07-04,Alameda,001,1643700,90290,89683,2022,91705,1253
2021-07-04,Alpine,003,1148,88,89,0,89,0
2021-07-04,Amador,005,37829,3775,3758,33,3791,46
2021-07-04,Butte,007,227075,12865,12684,1889,14573,201
2021-07-04,Calaveras,009,45235,2227,2200,13,2213,55
2021-07-04,Colusa,011,21464,1976,1969,327,2296,15
2021-07-04,Contra Costa,013,1133247,71666,70941,1350,72291,818
2021-07-04,Del Norte,015,27424,1479,1439,13,1452,8
2021-07-04,El Dorado,017,186661,10577,10433,800,11233,113
2021-07-04,Fresno,019,978130,103750,102512,8833,111345,1727
2021-07-04,Glenn,021,27897,2458,2442,572,3014,20
2021-07-04,Humboldt,023,135768,4575,4530,53,4583,49
2021-07-04,Imperial,025,180216,28865,28661,2761,31422,739
2021-07-04,Inyo,027,18085,1416,1412,13,1425,35
2021-07-04,Kern,029,883053,98160,97421,11267,108688,1347
2021-07-04,Kings,031,150075,23348,23051,1118,24169,245
2021-07-04,Lake,033,64148,3675,3623,13,3636,62
2021-07-04,Lassen,035,31185,5304,5277,117,5394,20
2021-07-04,Los Angeles,037,10098052,1217184,1208705,42065,1250770,24506
2021-07-04,Madera,039,155013,16873,16696,961,17657,240
2021-07-04,Marin,041,260295,14284,14143,268,14411,233
2021-07-04,Mariposa,043,17540,442,441,11,452,5
2021-07-04,Mendocino,045,87422,4229,4122,87,4209,49
2021-07-04,Merced,047,269075,31342,31297,1067,32364,469
2021-07-04,Modoc,049,8938,421,410,148,558,4
2021-07-04,Mono,051,14174,1269,1275,18,1293,3
2021-07-04,Monterey,053,433212,43397,43212,1891,45103,492
2021-07-04,Napa,055,140530,10088,10045,40,10085,81
2021-07-04,Nevada,057,99092,5038,4966,197,5163,72
2021-07-04,Orange,059,3164182,257564,255823,11689,267512,5126
2021-07-04,Placer,061,380077,24058,23764,1580,25344,299
2021-07-04,Plumas,063,18699,728,707,14,721,4
2021-07-04,Riverside,065,2383286,296587,293260,14260,307520,4536
2021-07-04,Sacramento,067,1510023,109366,108257,1877,110134,1676
2021-07-04,San Benito,069,59416,6142,6108,116,6224,63
2021-07-04,San Bernardino,071,2135413,295824,294294,9125,303419,5003
2021-07-04,San Diego,073,3302833,284363,282692,15594,298286,3780
2021-07-04,San Francisco,075,870044,37489,37107,1334,38441,558
2021-07-04,San Joaquin,077,732212,74521,73841,3683,77524,1409
2021-07-04,San Luis Obispo,079,281455,21623,21330,767,22097,256
2021-07-04,San Mateo,081,765935,43024,42691,499,43190,541
2021-07-04,Santa Barbara,083,443738,34727,34526,1153,35679,456
2021-07-04,Santa Clara,085,1922200,119954,118966,791,119757,2090
2021-07-04,Santa Cruz,087,273765,16390,16254,816,17070,208
2021-07-04,Shasta,089,179085,12660,12582,1657,14239,204
2021-07-04,Sierra,091,2930,64,60,12,72,0
2021-07-04,Siskiyou,093,43540,1980,1899,385,2284,29
2021-07-04,Solano,095,438530,33760,33486,584,34070,268
2021-07-04,Sonoma,097,501317,31292,31000,369,31369,316
2021-07-04,Stanislaus,099,539301,57295,57018,6078,63096,1018
2021-07-04,Sutter,101,95872,9690,9644,90,9734,114
2021-07-04,Tehama,103,63373,5167,5124,596,5720,63
2021-07-04,Trinity,105,12862,494,341,100,441,3
2021-07-04,Tulare,107,460477,50555,49789,9223,59012,853
2021-07-04,Tuolumne,109,53932,4106,4113,42,4155,64
2021-07-04,Ventura,111,848112,82149,81425,3103,84528,1033
2021-07-04,Yolo,113,214977,14299,14188,367,14555,213
2021-07-04,Yuba,115,75493,6273,6197,133,6330,51
2021-07-03,Alameda,001,1643700,90202,89683,2014,91697,1253
2021-07-03,Alpine,003,1148,88,89,0,89,0
2021-07-03,Amador,005,37829,3775,3758,33,3791,46
2021-07-03,Butte,007,227075,12861,12684,1888,14572,201
2021-07-03,Calaveras,009,45235,2225,2200,13,2213,55
2021-07-03,Colusa,011,21464,1975,1969,327,2296,15
2021-07-03,Contra Costa,013,1133247,71607,70941,1347,72288,818
2021-07-03,Del Norte,015,27424,1476,1439,13,1452,8
2021-07-03,El Dorado,017,186661,10570,10433,798,11231,113
2021-07-03,Fresno,019,978130,103726,102512,8824,111336,1727
2021-07-03,Glenn,021,27897,2458,2442,572,3014,20
2021-07-03,Humboldt,023,135768,4570,4530,53,4583,49
2021-07-03,Imperial,025,180216,28855,28661,2761,31422,739
2021-07-03,Inyo,027,18085,1416,1412,13,1425,35
2021-07-03,Kern,029,883053,98140,97421,11259,108680,1347
2021-07-03,Kings,031,150075,23348,23051,1117,24168,245
2021-07-03,Lake,033,64148,3665,3623,13,3636,62
2021-07-03,Lassen,035,31185,5303,5277,117,5394,20
2021-07-03,Los Angeles,037,10098052,1216755,1208705,42034,1250739,24506
2021-07-03,Madera,039,155013,16864,16696,958,17654,240
2021-07-03,Marin,041,260295,14280,14143,268,14411,233
2021-07-03,Mariposa,043,17540,442,441,11,452,5
2021-07-03,Mendocino,045,87422,4228,4122,87,4209,49
2021-07-03,Merced,047,269075,31329,31297,1066,32363,469
2021-07-03,Modoc,049,8938,420,410,148,558,4
2021-07-03,Mono,051,14174,1268,1275,18,1293,3
2021-07-03,Monterey,053,433212,43385,43212,1888,45100,492
2021-07-03,Napa,055,140530,10083,10045,40,10085,81
2021-07-03,Nevada,057,99092,5024,4966,197,5163,72
2021-07-03,Orange,059,3164182,257480,255823,11682,267505,5126
2021-07-03,Placer,061,380077,24039,23764,1577,25341,299
2021-07-03,Plumas,063,18699,728,707,14,721,4
2021-07-03,Riverside,065,2383286,296495,293260,14256,307516,4536
2021-07-03,Sacramento,067,1510023,109292,108257,1874,110131,1676
2021-07-03,San Benito,069,59416,6135,6108,116,6224,63
2021-07-03,San Bernardino,071,2135413,295734,294294,9122,303416,5003
2021-07-03,San Diego,073,3302833,284232,282692,15575,298267,3780
2021-07-03,San Francisco,075,870044,37448,37107,1331,38438,558
2021-07-03,San Joaquin,077,732212,74485,73841,3678,77519,1409
2021-07-03,San Luis Obispo,079,281455,21611,21330,767,22097,256
2021-07-03,San Mateo,081,765935,42999,42691,498,43189,541
2021-07-03,Santa Barbara,083,443738,34718,34526,1152,35678,456
2021-07-03,Santa Clara,085,1922200,119907,118966,791,119757,2090
2021-07-03,Santa Cruz,087,273765,16383,16254,816,17070,208
2021-07-03,Shasta,089,179085,12656,12582,1655,14237,204
2021-07-03,Sierra,091,2930,64,60,12,72,0
2021-07-03,Siskiyou,093,43540,1979,1899,384,2283,29
2021-07-03,Solano,095,438530,33716,33486,584,34070,268
2021-07-03,Sonoma,097,501317,31258,31000,369,31369,316
2021-07-03,Stanislaus,099,539301,57284,57018,6070,63088,1018
2021-07-03,Sutter,101,95872,9680,9644,90,9734,114
2021-07-03,Tehama,103,63373,5165,5124,596,5720,63
2021-07-03,Trinity,105,12862,494,341,100,441,3
2021-07-03,Tulare,107,460477,50549,49789,9217,59006,853
2021-07-03,Tuolumne,109,53932,4105,4113,42,4155,64
2021-07-03,Ventura,111,848112,82119,81425,3095,84520,1033
2021-07-03,Yolo,113,214977,14289,14188,364,14552,213
2021-07-03,Yuba,115,75493,6267,6197,133,6330,51
2021-07-02,Alameda,001,1643700,90120,89683,2013,91696,1253
2021-07-02,Alpine,003,1148,88,89,0,89,0
2021-07-02,Amador,005,37829,3773,3758,33,3791,46
2021-07-02,Butte,007,227075,12854,12684,1888,14572,201
2021-07-02,Calaveras,009,45235,2223,2200,13,2213,55
2021-07-02,Colusa,011,21464,1974,1969,326,2295,15
2021-07-02,Contra Costa,013,1133247,71537,70941,1343,72284,818
2021-07-02,Del Norte,015,27424,1476,1439,13,1452,8
2021-07-02,El Dorado,017,186661,10562,10433,798,11231,113
2021-07-02,Fresno,019,978130,103697,102512,8818,111330,1727
2021-07-02,Glenn,021,27897,2457,2442,571,3013,20
2021-07-02,Humboldt,023,135768,4567,4530,52,4582,49
2021-07-02,Imperial,025,180216,28849,28661,2760,31421,739
2021-07-02,Inyo,027,18085,1416,1412,13,1425,35
2021-07-02,Kern,029,883053,98122,97421,11250,108671,1347
2021-07-02,Kings,031,150075,23338,23051,1117,24168,245
2021-07-02,Lake,033,64148,3659,3623,13,3636,62
2021-07-02,Lassen,035,31185,5303,5277,117,5394,20
2021-07-02,Los Angeles,037,10098052,1216279,1208705,41997,1250702,24506
2021-07-02,Madera,039,155013,16855,16696,957,17653,240
2021-07-02,Marin,041,260295,14276,14143,268,14411,233
2021-07-02,Mariposa,043,17540,442,441,11,452,5
2021-07-02,Mendocino,045,87422,4224,4122,86,4208,49
2021-07-02,Merced,047,269075,31320,31297,1066,32363,469
2021-07-02,Modoc,049,8938,420,410,148,558,4
2021-07-02,Mono,051,14174,1267,1275,18,1293,3
2021-07-02,Monterey,053,433212,43377,43212,1887,45099,492
2021-07-02,Napa,055,140530,10078,10045,40,10085,81
2021-07-02,Nevada,057,99092,5015,4966,197,5163,72
2021-07-02,Orange,059,3164182,257369,255823,11675,267498,5126
2021-07-02,Placer,061,380077,24022,23764,1570,25334,299
2021-07-02,Plumas,063,18699,728,707,14,721,4
2021-07-02,Riverside,065,2383286,296397,293260,14251,307511,4536
2021-07-02,Sacramento,067,1510023,109214,108257,1873,110130,1676
2021-07-02,San Benito,069,59416,6132,6108,116,6224,63
2021-07-02,San Bernardino,071,2135413,295647,294294,9120,303414,5003
2021-07-02,San Diego,073,3302833,284087,282692,15549,298241,3780
2021-07-02,San Francisco,075,870044,37399,37107,1329,38436,558
2021-07-02,San Joaquin,077,732212,74452,73841,3672,77513,1409
2021-07-02,San Luis Obispo,079,281455,21605,21330,766,22096,256
2021-07-02,San Mateo,081,765935,42963,42691,498,43189,541
2021-07-02,Santa Barbara,083,443738,34708,34526,1152,35678,456
2021-07-02,Santa Clara,085,1922200,119829,118966,791,119757,2090
2021-07-02,Santa Cruz,087,273765,16379,16254,816,17070,208
2021-07-02,Shasta,089,179085,12652,12582,1655,14237,204
2021-07-02,Sierra,091,2930,63,60,12,72,0
2021-07-02,Siskiyou,093,43540,1976,1899,383,2282,29
2021-07-02,Solano,095,438530,33691,33486,584,34070,268
2021-07-02,Sonoma,097,501317,31235,31000,369,31369,316
2021-07-02,Stanislaus,099,539301,57267,57018,6069,63087,1018
2021-07-02,Sutter,101,95872,9676,9644,90,9734,114
2021-07-02,Tehama,103,63373,5163,5124,594,5718,63
2021-07-02,Trinity,105,12862,494,341,100,441,3
2021-07-02,Tulare,107,460477,50539,49789,9209,58998,853
2021-07-02,Tuolumne,109,53932,4102,4113,42,4155,64
2021-07-02,Ventura,111,848112,82076,81425,3087,84512,1033
2021-07-02,Yolo,113,214977,14273,14188,362,14550,213
2021-07-02,Yuba,115,75493,6259,6197,133,6330,51
2021-07-01,Alameda,001,1643700,90020,89683,2011,91694,1253
2021-07-01,Alpine,003,1148,88,89,0,89,0
2021-07-01,Amador,005,37829,3772,3758,33,3791,46
2021-07-01,Butte,007,227075,12842,12684,1886,14570,201
2021-07-01,Calaveras,009,45235,2221,2200,13,2213,55
2021-07-01,Colusa,011,21464,1974,1969,324,2293,15
2021-07-01,Contra Costa,013,1133247,71465,70941,1343,72284,818
2021-07-01,Del Norte,015,27424,1475,1439,13,1452,8
2021-07-01,El Dorado,017,186661,10550,10433,798,11231,113
2021-07-01,Fresno,019,978130,103658,102512,8813,111325,1727
2021-07-01,Glenn,021,27897,2457,2442,571,3013,20
2021-07-01,Humboldt,023,135768,4565,4530,52,4582,49
2021-07-01,Imperial,025,180216,28832,28661,2760,31421,739
2021-07-01,Inyo,027,18085,1416,1412,13,1425,35
2021-07-01,Kern,029,883053,98096,97421,11240,108661,1347
2021-07-01,Kings,031,150075,23324,23051,1117,24168,245
2021-07-01,Lake,033,64148,3656,3623,13,3636,62
2021-07-01,Lassen,035,31185,5301,5277,117,5394,20
2021-07-01,Los Angeles,037,10098052,1215680,1208705,41942,1250647,24506
2021-07-01,Madera,039,155013,16846,16696,956,17652,240
2021-07-01,Marin,041,260295,14272,14143,268,14411,233
2021-07-01,Mariposa,043,17540,442,441,11,452,5
2021-07-01,Mendocino,045,87422,4220,4122,85,4207,49
2021-07-01,Merced,047,269075,31314,31297,1066,32363,469
2021-07-01,Modoc,049,8938,420,410,148,558,4
2021-07-01,Mono,051,14174,1266,1275,18,1293,3
2021-07-01,Monterey,053,433212,43369,43212,1883,45095,492
2021-07-01,Napa,055,140530,10071,10045,40,10085,81
2021-07-01,Nevada,057,99092,5010,4966,197,5163,72
2021-07-01,Orange,059,3164182,257248,255823,11656,267479,5126
2021-07-01,Placer,061,380077,24003,23764,1567,25331,299
2021-07-01,Plumas,063,18699,725,707,12,719,4
2021-07-01,Riverside,065,2383286,296288,293260,14243,307503,4536
2021-07-01,Sacramento,067,1510023,109088,108257,1866,110123,1676
2021-07-01,San Benito,069,59416,6128,6108,116,6224,63
2021-07-01,San Bernardino,071,2135413,295527,294294,9115,303409,5003
2021-07-01,San Diego,073,3302833,283909,282692,15512,298204,3780
2021-07-01,San Francisco,075,870044,37363,37107,1327,38434,558
2021-07-01,San Joaquin,077,732212,74401,73841,3668,77509,1409
2021-07-01,San Luis Obispo,079,281455,21590,21330,765,22095,256
2021-07-01,San Mateo,081,765935,42935,42691,497,43188,541
2021-07-01,Santa Barbara,083,443738,34695,34526,1152,35678,456
2021-07-01,Santa Clara,085,1922200,119780,118966,791,119757,2090
2021-07-01,Santa Cruz,087,273765,16374,16254,816,17070,208
2021-07-01,Shasta,089,179085,12644,12582,1654,14236,204
2021-07-01,Sierra,091,2930,63,60,12,72,0
2021-07-01,Siskiyou,093,43540,1976,1899,383,2282,29
2021-07-01,Solano,095,438530,33650,33486,583,34069,268
2021-07-01,Sonoma,097,501317,31191,31000,369,31369,316
2021-07-01,Stanislaus,099,539301,57249,57018,6065,63083,1018
2021-07-01,Sutter,101,95872,9667,9644,90,9734,114
2021-07-01,Tehama,103,63373,5163,5124,593,5717,63
2021-07-01,Trinity,105,12862,494,341,100,441,3
2021-07-01,Tulare,107,460477,50530,49789,9202,58991,853
2021-07-01,Tuolumne,109,53932,4095,4113,42,4155,64
2021-07-01,Ventura,111,848112,82045,81425,3076,84501,1033
2021-07-01,Yolo,113,214977,14257,14188,360,14548,213
2021-07-01,Yuba,115,75493,6252,6197,133,6330,51
2021-06-30,Alameda,001,1643700,89941,89597,2007,91604,1256
2021-06-30,Alpine,003,1148,88,89,0,89,0
2021-06-30,Amador,005,37829,3770,3756,33,3789,46
2021-06-30,Butte,007,227075,12835,12676,1877,14553,201
2021-06-30,Calaveras,009,45235,2215,2198,13,2211,55
2021-06-30,Colusa,011,21464,1972,1967,321,2288,15
2021-06-30,Contra Costa,013,1133247,71400,70869,1340,72209,818
2021-06-30,Del Norte,015,27424,1470,1435,13,1448,8
2021-06-30,El Dorado,017,186661,10531,10420,798,11218,113
2021-06-30,Fresno,019,978130,103621,102490,8810,111300,1727
2021-06-30,Glenn,021,27897,2455,2440,571,3011,20
2021-06-30,Humboldt,023,135768,4549,4522,50,4572,49
2021-06-30,Imperial,025,180216,28824,28651,2760,31411,739
2021-06-30,Inyo,027,18085,1416,1409,13,1422,35
2021-06-30,Kern,029,883053,98055,97267,11228,108495,1348
2021-06-30,Kings,031,150075,23319,23038,1116,24154,245
2021-06-30,Lake,033,64148,3643,3601,13,3614,56
2021-06-30,Lassen,035,31185,5296,5269,117,5386,20
2021-06-30,Los Angeles,037,10098052,1215008,1208246,41896,1250142,24499
2021-06-30,Madera,039,155013,16838,16688,954,17642,240
2021-06-30,Marin,041,260295,14263,14133,267,14400,232
2021-06-30,Mariposa,043,17540,441,441,11,452,5
2021-06-30,Mendocino,045,87422,4210,4115,85,4200,49
2021-06-30,Merced,047,269075,31304,31286,1066,32352,469
2021-06-30,Modoc,049,8938,420,410,148,558,4
2021-06-30,Mono,051,14174,1266,1275,18,1293,3
2021-06-30,Monterey,053,433212,43364,43209,1881,45090,492
2021-06-30,Napa,055,140530,10063,10039,40,10079,81
2021-06-30,Nevada,057,99092,4999,4958,197,5155,72
2021-06-30,Orange,059,3164182,257121,255764,11645,267409,5125
2021-06-30,Placer,061,380077,23979,23721,1564,25285,299
2021-06-30,Plumas,063,18699,725,705,12,717,4
2021-06-30,Riverside,065,2383286,296174,293280,14233,307513,4535
2021-06-30,Sacramento,067,1510023,108949,108137,1862,109999,1676
2021-06-30,San Benito,069,59416,6124,6105,116,6221,63
2021-06-30,San Bernardino,071,2135413,295367,294211,9110,303321,4975
2021-06-30,San Diego,073,3302833,283773,282583,15484,298067,3780
2021-06-30,San Francisco,075,870044,37314,37065,1322,38387,558
2021-06-30,San Joaquin,077,732212,74339,73777,3667,77444,1409
2021-06-30,San Luis Obispo,079,281455,21577,21326,764,22090,256
2021-06-30,San Mateo,081,765935,42898,42599,496,43095,537
2021-06-30,Santa Barbara,083,443738,34679,34521,1152,35673,456
2021-06-30,Santa Clara,085,1922200,119733,118930,788,119718,2090
2021-06-30,Santa Cruz,087,273765,16368,16250,816,17066,208
2021-06-30,Shasta,089,179085,12638,12564,1654,14218,204
2021-06-30,Sierra,091,2930,63,60,12,72,0
2021-06-30,Siskiyou,093,43540,1974,1900,380,2280,29
2021-06-30,Solano,095,438530,33611,33453,581,34034,268
2021-06-30,Sonoma,097,501317,31161,30947,369,31316,316
2021-06-30,Stanislaus,099,539301,57232,56997,6064,63061,1018
2021-06-30,Sutter,101,95872,9657,9638,90,9728,114
2021-06-30,Tehama,103,63373,5161,5124,593,5717,63
2021-06-30,Trinity,105,12862,494,341,100,441,3
2021-06-30,Tulare,107,460477,50519,49764,9191,58955,853
2021-06-30,Tuolumne,109,53932,4092,4112,42,4154,64
2021-06-30,Ventura,111,848112,82002,81392,3071,84463,1032
2021-06-30,Yolo,113,214977,14251,14178,357,14535,213
2021-06-30,Yuba,115,75493,6245,6191,133,6324,51
2021-06-29,Alameda,001,1643700,89834,89519,2005,91524,1257
2021-06-29,Alpine,003,1148,88,89,0,89,0
2021-06-29,Amador,005,37829,3766,3754,33,3787,46
2021-06-29,Butte,007,227075,12827,12669,1877,14546,201
2021-06-29,Calaveras,009,45235,2209,2198,13,2211,55
2021-06-29,Colusa,011,21464,1970,1967,321,2288,15
2021-06-29,Contra Costa,013,1133247,71326,70775,1339,72114,817
2021-06-29,Del Norte,015,27424,1469,1435,13,1448,8
2021-06-29,El Dorado,017,186661,10518,10403,794,11197,113
2021-06-29,Fresno,019,978130,103588,102464,8807,111271,1725
2021-06-29,Glenn,021,27897,2454,2439,571,3010,20
2021-06-29,Humboldt,023,135768,4545,4514,49,4563,49
2021-06-29,Imperial,025,180216,28815,28645,2759,31404,737
2021-06-29,Inyo,027,18085,1416,1408,13,1421,35
2021-06-29,Kern,029,883053,98034,97173,11222,108395,1347
2021-06-29,Kings,031,150075,23310,23035,1115,24150,245
2021-06-29,Lake,033,64148,3637,3594,13,3607,56
2021-06-29,Lassen,035,31185,5289,5268,117,5385,20
2021-06-29,Los Angeles,037,10098052,1214397,1207895,41866,1249761,24498
2021-06-29,Madera,039,155013,16834,16680,953,17633,240
2021-06-29,Marin,041,260295,14251,14127,267,14394,232
2021-06-29,Mariposa,043,17540,441,441,11,452,5
2021-06-29,Mendocino,045,87422,4206,4107,84,4191,49
2021-06-29,Merced,047,269075,31292,31277,1066,32343,469
2021-06-29,Modoc,049,8938,419,408,148,556,3
2021-06-29,Mono,051,14174,1266,1275,18,1293,3
2021-06-29,Monterey,053,433212,43354,43196,1879,45075,471
2021-06-29,Napa,055,140530,10057,10033,40,10073,81
2021-06-29,Nevada,057,99092,4992,4952,197,5149,72
2021-06-29,Orange,059,3164182,257021,255686,11630,267316,5124
2021-06-29,Placer,061,380077,23959,23693,1562,25255,299
2021-06-29,Plumas,063,18699,725,704,12,716,4
2021-06-29,Riverside,065,2383286,296075,292962,14226,307188,4524
2021-06-29,Sacramento,067,1510023,108797,108067,1859,109926,1677
2021-06-29,San Benito,069,59416,6113,6099,116,6215,63
2021-06-29,San Bernardino,071,2135413,295255,294118,9108,303226,4940
2021-06-29,San Diego,073,3302833,283617,282499,15457,297956,3780
2021-06-29,San Francisco,075,870044,37276,37041,1319,38360,558
2021-06-29,San Joaquin,077,732212,74291,73724,3664,77388,1409
2021-06-29,San Luis Obispo,079,281455,21567,21324,763,22087,256
2021-06-29,San Mateo,081,765935,42864,42540,496,43036,540
2021-06-29,Santa Barbara,083,443738,34669,34507,1151,35658,455
2021-06-29,Santa Clara,085,1922200,119679,118893,787,119680,2090
2021-06-29,Santa Cruz,087,273765,16362,16249,816,17065,208
2021-06-29,Shasta,089,179085,12626,12564,1653,14217,204
2021-06-29,Sierra,091,2930,63,59,12,71,0
2021-06-29,Siskiyou,093,43540,1971,1897,376,2273,29
2021-06-29,Solano,095,438530,33578,33440,579,34019,268
2021-06-29,Sonoma,097,501317,31119,30950,367,31317,316
2021-06-29,Stanislaus,099,539301,57211,56980,6057,63037,1018
2021-06-29,Sutter,101,95872,9646,9634,90,9724,114
2021-06-29,Tehama,103,63373,5161,5124,593,5717,63
2021-06-29,Trinity,105,12862,494,341,100,441,3
2021-06-29,Tulare,107,460477,50506,49751,9186,58937,852
2021-06-29,Tuolumne,109,53932,4090,4111,42,4153,64
2021-06-29,Ventura,111,848112,81964,81363,3065,84428,1032
2021-06-29,Yolo,113,214977,14239,14171,356,14527,213
2021-06-29,Yuba,115,75493,6235,6188,133,6321,51
2021-06-28,Alameda,001,1643700,89740,89638,2002,91640,1259
2021-06-28,Alpine,003,1148,88,89,0,89,0
2021-06-28,Amador,005,37829,3765,3753,33,3786,46
2021-06-28,Butte,007,227075,12818,12697,1875,14572,198
2021-06-28,Calaveras,009,45235,2206,2203,13,2216,55
2021-06-28,Colusa,011,21464,1968,1974,321,2295,15
2021-06-28,Contra Costa,013,1133247,71252,70807,1337,72144,816
2021-06-28,Del Norte,015,27424,1469,1436,13,1449,8
2021-06-28,El Dorado,017,186661,10508,10422,790,11212,115
2021-06-28,Fresno,019,978130,103557,103121,8805,111926,1727
2021-06-28,Glenn,021,27897,2454,2439,571,3010,20
2021-06-28,Humboldt,023,135768,4538,4520,48,4568,49
2021-06-28,Imperial,025,180216,28807,28981,2758,31739,741
2021-06-28,Inyo,027,18085,1413,1407,13,1420,35
2021-06-28,Kern,029,883053,98015,97252,11217,108469,1348
2021-06-28,Kings,031,150075,23304,23134,1115,24249,246
2021-06-28,Lake,033,64148,3629,3591,13,3604,56
2021-06-28,Lassen,035,31185,5287,5268,117,5385,20
2021-06-28,Los Angeles,037,10098052,1213878,1207714,41831,1249545,24496
2021-06-28,Madera,039,155013,16823,16683,952,17635,240
2021-06-28,Marin,041,260295,14236,14186,267,14453,232
2021-06-28,Mariposa,043,17540,441,440,11,451,5
2021-06-28,Mendocino,045,87422,4197,4102,83,4185,49
2021-06-28,Merced,047,269075,31280,31277,1066,32343,469
2021-06-28,Modoc,049,8938,419,411,147,558,3
2021-06-28,Mono,051,14174,1266,1276,18,1294,3
2021-06-28,Monterey,053,433212,43350,43202,1878,45080,462
2021-06-28,Napa,055,140530,10048,10050,39,10089,81
2021-06-28,Nevada,057,99092,4988,4951,197,5148,72
2021-06-28,Orange,059,3164182,256931,255755,11616,267371,5123
2021-06-28,Placer,061,380077,23939,23756,1558,25314,299
2021-06-28,Plumas,063,18699,723,704,12,716,4
2021-06-28,Riverside,065,2383286,295949,292647,14213,306860,4507
2021-06-28,Sacramento,067,1510023,108665,108342,1854,110196,1675
2021-06-28,San Benito,069,59416,6111,6101,116,6217,63
2021-06-28,San Bernardino,071,2135413,295154,294151,9103,303254,4928
2021-06-28,San Diego,073,3302833,283453,282417,15428,297845,3780
2021-06-28,San Francisco,075,870044,37240,37372,1317,38689,559
2021-06-28,San Joaquin,077,732212,74244,73973,3660,77633,1411
2021-06-28,San Luis Obispo,079,281455,21563,21340,762,22102,256
2021-06-28,San Mateo,081,765935,42830,42927,495,43422,540
2021-06-28,Santa Barbara,083,443738,34662,34534,1149,35683,455
2021-06-28,Santa Clara,085,1922200,119615,120377,786,121163,2103
2021-06-28,Santa Cruz,087,273765,16357,16245,816,17061,208
2021-06-28,Shasta,089,179085,12622,12642,1651,14293,203
2021-06-28,Sierra,091,2930,63,58,12,70,0
2021-06-28,Siskiyou,093,43540,1970,1896,376,2272,29
2021-06-28,Solano,095,438530,33542,33524,577,34101,267
2021-06-28,Sonoma,097,501317,31082,31137,366,31503,315
2021-06-28,Stanislaus,099,539301,57193,57047,6053,63100,1018
2021-06-28,Sutter,101,95872,9642,9682,90,9772,114
2021-06-28,Tehama,103,63373,5159,5122,593,5715,63
2021-06-28,Trinity,105,12862,494,341,100,441,3
2021-06-28,Tulare,107,460477,50496,49751,9182,58933,850
2021-06-28,Tuolumne,109,53932,4083,4121,42,4163,64
2021-06-28,Ventura,111,848112,81907,81393,3060,84453,1032
2021-06-28,Yolo,113,214977,14230,14199,353,14552,213
2021-06-28,Yuba,115,75493,6230,6207,133,6340,51
2021-06-27,Alameda,001,1643700,89653,89611,1998,91609,1259
2021-06-27,Alpine,003,1148,88,89,0,89,0
2021-06-27,Amador,005,37829,3764,3752,33,3785,46
2021-06-27,Butte,007,227075,12809,12696,1874,14570,198
2021-06-27,Calaveras,009,45235,2205,2203,13,2216,55
2021-06-27,Colusa,011,21464,1968,1974,321,2295,15
2021-06-27,Contra Costa,013,1133247,71166,70762,1333,72095,816
2021-06-27,Del Norte,015,27424,1466,1436,13,1449,8
2021-06-27,El Dorado,017,186661,10496,10418,787,11205,115
2021-06-27,Fresno,019,978130,103528,103110,8803,111913,1727
2021-06-27,Glenn,021,27897,2453,2439,570,3009,20
2021-06-27,Humboldt,023,135768,4526,4513,45,4558,49
2021-06-27,Imperial,025,180216,28793,28987,2758,31745,741
2021-06-27,Inyo,027,18085,1413,1407,13,1420,35
2021-06-27,Kern,029,883053,97989,97249,11210,108459,1348
2021-06-27,Kings,031,150075,23294,23132,1115,24247,246
2021-06-27,Lake,033,64148,3622,3581,13,3594,56
2021-06-27,Lassen,035,31185,5286,5265,117,5382,20
2021-06-27,Los Angeles,037,10098052,1213331,1207461,41791,1249252,24493
2021-06-27,Madera,039,155013,16815,16680,952,17632,240
2021-06-27,Marin,041,260295,14227,14182,267,14449,232
2021-06-27,Mariposa,043,17540,441,440,11,451,5
2021-06-27,Mendocino,045,87422,4190,4100,83,4183,49
2021-06-27,Merced,047,269075,31268,31266,1066,32332,469
2021-06-27,Modoc,049,8938,419,411,147,558,3
2021-06-27,Mono,051,14174,1266,1279,18,1297,3
2021-06-27,Monterey,053,433212,43337,43199,1878,45077,462
2021-06-27,Napa,055,140530,10042,10046,39,10085,81
2021-06-27,Nevada,057,99092,4982,4946,197,5143,72
2021-06-27,Orange,059,3164182,256817,255710,11605,267315,5123
2021-06-27,Placer,061,380077,23906,23731,1555,25286,299
2021-06-27,Plumas,063,18699,723,704,12,716,4
2021-06-27,Riverside,065,2383286,295847,292641,14206,306847,4507
2021-06-27,Sacramento,067,1510023,108530,108279,1850,110129,1675
2021-06-27,San Benito,069,59416,6105,6101,116,6217,63
2021-06-27,San Bernardino,071,2135413,295041,294115,9101,303216,4927
2021-06-27,San Diego,073,3302833,283313,282359,15402,297761,3780
2021-06-27,San Francisco,075,870044,37203,37360,1316,38676,559
2021-06-27,San Joaquin,077,732212,74208,73960,3658,77618,1411
2021-06-27,San Luis Obispo,079,281455,21556,21340,761,22101,256
2021-06-27,San Mateo,081,765935,42801,42925,492,43417,539
2021-06-27,Santa Barbara,083,443738,34648,34533,1147,35680,455
2021-06-27,Santa Clara,085,1922200,119564,120352,785,121137,2103
2021-06-27,Santa Cruz,087,273765,16348,16241,816,17057,208
2021-06-27,Shasta,089,179085,12616,12640,1650,14290,203
2021-06-27,Sierra,091,2930,63,58,12,70,0
2021-06-27,Siskiyou,093,43540,1968,1896,375,2271,29
2021-06-27,Solano,095,438530,33514,33516,577,34093,267
2021-06-27,Sonoma,097,501317,31044,31129,366,31495,315
2021-06-27,Stanislaus,099,539301,57153,57021,6050,63071,1018
2021-06-27,Sutter,101,95872,9636,9678,90,9768,114
2021-06-27,Tehama,103,63373,5155,5122,593,5715,63
2021-06-27,Trinity,105,12862,494,341,99,440,3
2021-06-27,Tulare,107,460477,50483,49749,9175,58924,850
2021-06-27,Tuolumne,109,53932,4081,4121,42,4163,64
2021-06-27,Ventura,111,848112,81873,81361,3051,84412,1032
2021-06-27,Yolo,113,214977,14215,14194,349,14543,213
2021-06-27,Yuba,115,75493,6224,6205,133,6338,51
2021-06-26,Alameda,001,1643700,89596,89560,1996,91556,1259
2021-06-26,Alpine,003,1148,88,89,0,89,0
2021-06-26,Amador,005,37829,3764,3748,33,3781,46
2021-06-26,Butte,007,227075,12805,12693,1871,14564,198
2021-06-26,Calaveras,009,45235,2203,2202,13,2215,55
2021-06-26,Colusa,011,21464,1968,1973,321,2294,15
2021-06-26,Contra Costa,013,1133247,71123,70712,1332,72044,816
2021-06-26,Del Norte,015,27424,1465,1432,13,1445,8
2021-06-26,El Dorado,017,186661,10488,10414,785,11199,115
2021-06-26,Fresno,019,978130,103508,103091,8801,111892,1727
2021-06-26,Glenn,021,27897,2451,2441,570,3011,20
2021-06-26,Humboldt,023,135768,4523,4509,45,4554,49
2021-06-26,Imperial,025,180216,28789,28970,2758,31728,741
2021-06-26,Inyo,027,18085,1413,1407,13,1420,35
2021-06-26,Kern,029,883053,97963,97239,11201,108440,1348
2021-06-26,Kings,031,150075,23290,23128,1114,24242,246
2021-06-26,Lake,033,64148,3611,3576,13,3589,56
2021-06-26,Lassen,035,31185,5283,5263,117,5380,20
2021-06-26,Los Angeles,037,10098052,1213023,1207198,41758,1248956,24490
2021-06-26,Madera,039,155013,16808,16679,951,17630,240
2021-06-26,Marin,041,260295,14218,14180,267,14447,232
2021-06-26,Mariposa,043,17540,441,440,11,451,5
2021-06-26,Mendocino,045,87422,4188,4096,83,4179,49
2021-06-26,Merced,047,269075,31262,31259,1065,32324,469
2021-06-26,Modoc,049,8938,419,411,147,558,3
2021-06-26,Mono,051,14174,1266,1279,18,1297,3
2021-06-26,Monterey,053,433212,43334,43192,1878,45070,462
2021-06-26,Napa,055,140530,10035,10043,39,10082,81
2021-06-26,Nevada,057,99092,4977,4939,197,5136,72
2021-06-26,Orange,059,3164182,256738,255640,11598,267238,5123
2021-06-26,Placer,061,380077,23892,23702,1553,25255,299
2021-06-26,Plumas,063,18699,723,704,12,716,4
2021-06-26,Riverside,065,2383286,295789,292480,14200,306680,4505
2021-06-26,Sacramento,067,1510023,108459,108179,1848,110027,1675
2021-06-26,San Benito,069,59416,6101,6100,116,6216,63
2021-06-26,San Bernardino,071,2135413,294946,294034,9096,303130,4928
2021-06-26,San Diego,073,3302833,283228,282263,15384,297647,3780
2021-06-26,San Francisco,075,870044,37171,37348,1315,38663,559
2021-06-26,San Joaquin,077,732212,74179,73928,3657,77585,1411
2021-06-26,San Luis Obispo,079,281455,21555,21330,760,22090,256
2021-06-26,San Mateo,081,765935,42781,42898,492,43390,539
2021-06-26,Santa Barbara,083,443738,34639,34525,1147,35672,455
2021-06-26,Santa Clara,085,1922200,119531,120321,785,121106,2103
2021-06-26,Santa Cruz,087,273765,16345,16239,816,17055,208
2021-06-26,Shasta,089,179085,12612,12635,1646,14281,203
2021-06-26,Sierra,091,2930,63,58,12,70,0
2021-06-26,Siskiyou,093,43540,1967,1896,374,2270,29
2021-06-26,Solano,095,438530,33496,33489,575,34064,267
2021-06-26,Sonoma,097,501317,31018,31088,366,31454,315
2021-06-26,Stanislaus,099,539301,57137,57006,6047,63053,1018
2021-06-26,Sutter,101,95872,9635,9669,90,9759,114
2021-06-26,Tehama,103,63373,5155,5119,593,5712,63
2021-06-26,Trinity,105,12862,494,341,99,440,3
2021-06-26,Tulare,107,460477,50477,49745,9175,58920,850
2021-06-26,Tuolumne,109,53932,4081,4121,42,4163,64
2021-06-26,Ventura,111,848112,81849,81352,3050,84402,1032
2021-06-26,Yolo,113,214977,14207,14184,349,14533,213
2021-06-26,Yuba,115,75493,6221,6200,133,6333,51
2021-06-25,Alameda,001,1643700,89529,89453,1994,91447,1271
2021-06-25,Alpine,003,1148,88,89,0,89,0
2021-06-25,Amador,005,37829,3763,3746,33,3779,46
2021-06-25,Butte,007,227075,12800,12682,1868,14550,198
2021-06-25,Calaveras,009,45235,2202,2201,13,2214,55
2021-06-25,Colusa,011,21464,1968,1972,321,2293,15
2021-06-25,Contra Costa,013,1133247,71087,70659,1332,71991,815
2021-06-25,Del Norte,015,27424,1465,1426,13,1439,8
2021-06-25,El Dorado,017,186661,10480,10406,782,11188,115
2021-06-25,Fresno,019,978130,103490,103073,8797,111870,1727
2021-06-25,Glenn,021,27897,2451,2441,570,3011,20
2021-06-25,Humboldt,023,135768,4517,4503,43,4546,49
2021-06-25,Imperial,025,180216,28786,28968,2758,31726,740
2021-06-25,Inyo,027,18085,1412,1406,13,1419,35
2021-06-25,Kern,029,883053,97944,97182,11197,108379,1347
2021-06-25,Kings,031,150075,23284,23118,1114,24232,246
2021-06-25,Lake,033,64148,3605,3571,13,3584,56
2021-06-25,Lassen,035,31185,5282,5259,117,5376,20
2021-06-25,Los Angeles,037,10098052,1212738,1206909,41741,1248650,24483
2021-06-25,Madera,039,155013,16805,16670,951,17621,240
2021-06-25,Marin,041,260295,14215,14179,267,14446,232
2021-06-25,Mariposa,043,17540,441,440,11,451,5
2021-06-25,Mendocino,045,87422,4185,4089,83,4172,49
2021-06-25,Merced,047,269075,31254,31256,1065,32321,467
2021-06-25,Modoc,049,8938,419,411,147,558,3
2021-06-25,Mono,051,14174,1266,1279,18,1297,3
2021-06-25,Monterey,053,433212,43329,43184,1877,45061,462
2021-06-25,Napa,055,140530,10030,10037,39,10076,81
2021-06-25,Nevada,057,99092,4974,4932,197,5129,72
2021-06-25,Orange,059,3164182,256667,255574,11596,267170,5119
2021-06-25,Placer,061,380077,23873,23672,1552,25224,299
2021-06-25,Plumas,063,18699,723,702,11,713,4
2021-06-25,Riverside,065,2383286,295721,291663,14193,305856,4490
2021-06-25,Sacramento,067,1510023,108387,108034,1845,109879,1673
2021-06-25,San Benito,069,59416,6097,6098,116,6214,63
2021-06-25,San Bernardino,071,2135413,294891,293941,9094,303035,4911
2021-06-25,San Diego,073,3302833,283168,282157,15371,297528,3779
2021-06-25,San Francisco,075,870044,37148,37338,1314,38652,559
2021-06-25,San Joaquin,077,732212,74146,73860,3655,77515,1410
2021-06-25,San Luis Obispo,079,281455,21552,21325,759,22084,256
2021-06-25,San Mateo,081,765935,42763,42849,492,43341,537
2021-06-25,Santa Barbara,083,443738,34630,34518,1146,35664,454
2021-06-25,Santa Clara,085,1922200,119511,120272,785,121057,2103
2021-06-25,Santa Cruz,087,273765,16342,16230,814,17044,208
2021-06-25,Shasta,089,179085,12602,12633,1645,14278,202
2021-06-25,Sierra,091,2930,63,58,12,70,0
2021-06-25,Siskiyou,093,43540,1966,1894,374,2268,29
2021-06-25,Solano,095,438530,33476,33449,575,34024,267
2021-06-25,Sonoma,097,501317,30995,31043,366,31409,314
2021-06-25,Stanislaus,099,539301,57121,56973,6040,63013,1018
2021-06-25,Sutter,101,95872,9628,9664,90,9754,114
2021-06-25,Tehama,103,63373,5154,5119,593,5712,63
2021-06-25,Trinity,105,12862,494,338,99,437,3
2021-06-25,Tulare,107,460477,50470,49731,9172,58903,850
2021-06-25,Tuolumne,109,53932,4080,4121,42,4163,64
2021-06-25,Ventura,111,848112,81820,81342,3044,84386,1032
2021-06-25,Yolo,113,214977,14201,14172,349,14521,213
2021-06-25,Yuba,115,75493,6217,6195,133,6328,51
2021-06-24,Alameda,001,1643700,89458,89358,1991,91349,1268
2021-06-24,Alpine,003,1148,88,89,0,89,0
2021-06-24,Amador,005,37829,3759,3745,33,3778,46
2021-06-24,Butte,007,227075,12794,12673,1866,14539,198
2021-06-24,Calaveras,009,45235,2199,2202,13,2215,55
2021-06-24,Colusa,011,21464,1967,1972,321,2293,15
2021-06-24,Contra Costa,013,1133247,71028,70590,1332,71922,813
2021-06-24,Del Norte,015,27424,1464,1421,13,1434,8
2021-06-24,El Dorado,017,186661,10473,10402,782,11184,115
2021-06-24,Fresno,019,978130,103470,103061,8795,111856,1727
2021-06-24,Glenn,021,27897,2450,2439,570,3009,20
2021-06-24,Humboldt,023,135768,4512,4493,43,4536,49
2021-06-24,Imperial,025,180216,28783,28981,2758,31739,740
2021-06-24,Inyo,027,18085,1411,1406,13,1419,35
2021-06-24,Kern,029,883053,97925,97129,11184,108313,1346
2021-06-24,Kings,031,150075,23280,23114,1112,24226,246
2021-06-24,Lake,033,64148,3599,3571,13,3584,56
2021-06-24,Lassen,035,31185,5281,5258,117,5375,20
2021-06-24,Los Angeles,037,10098052,1212414,1206590,41718,1248308,24480
2021-06-24,Madera,039,155013,16794,16662,950,17612,240
2021-06-24,Marin,041,260295,14211,14180,267,14447,232
2021-06-24,Mariposa,043,17540,441,440,11,451,5
2021-06-24,Mendocino,045,87422,4177,4085,83,4168,49
2021-06-24,Merced,047,269075,31244,31248,1064,32312,466
2021-06-24,Modoc,049,8938,419,411,147,558,3
2021-06-24,Mono,051,14174,1266,1276,18,1294,3
2021-06-24,Monterey,053,433212,43322,43180,1877,45057,451
2021-06-24,Napa,055,140530,10028,10036,39,10075,80
2021-06-24,Nevada,057,99092,4972,4927,197,5124,72
2021-06-24,Orange,059,3164182,256603,255520,11588,267108,5117
2021-06-24,Placer,061,380077,23848,23659,1550,25209,299
2021-06-24,Plumas,063,18699,722,702,11,713,4
2021-06-24,Riverside,065,2383286,295641,291067,14182,305249,4473
2021-06-24,Sacramento,067,1510023,108299,107965,1843,109808,1672
2021-06-24,San Benito,069,59416,6094,6098,116,6214,63
2021-06-24,San Bernardino,071,2135413,294821,293895,9089,302984,4898
2021-06-24,San Diego,073,3302833,283064,282053,15358,297411,3778
2021-06-24,San Francisco,075,870044,37126,37320,1312,38632,559
2021-06-24,San Joaquin,077,732212,74098,73814,3655,77469,1408
2021-06-24,San Luis Obispo,079,281455,21546,21326,759,22085,256
2021-06-24,San Mateo,081,765935,42737,42814,491,43305,542
2021-06-24,Santa Barbara,083,443738,34624,34512,1145,35657,454
2021-06-24,Santa Clara,085,1922200,119480,120274,784,121058,2103
2021-06-24,Santa Cruz,087,273765,16341,16227,814,17041,208
2021-06-24,Shasta,089,179085,12597,12629,1641,14270,202
2021-06-24,Sierra,091,2930,63,58,12,70,0
2021-06-24,Siskiyou,093,43540,1966,1892,374,2266,28
2021-06-24,Solano,095,438530,33453,33432,573,34005,267
2021-06-24,Sonoma,097,501317,30966,31020,366,31386,314
2021-06-24,Stanislaus,099,539301,57095,56946,6040,62986,1018
2021-06-24,Sutter,101,95872,9621,9660,90,9750,113
2021-06-24,Tehama,103,63373,5151,5115,593,5708,63
2021-06-24,Trinity,105,12862,493,338,99,437,3
2021-06-24,Tulare,107,460477,50459,49730,9170,58900,850
2021-06-24,Tuolumne,109,53932,4078,4120,42,4162,64
2021-06-24,Ventura,111,848112,81792,81332,3043,84375,1032
2021-06-24,Yolo,113,214977,14192,14169,346,14515,213
2021-06-24,Yuba,115,75493,6212,6195,133,6328,51
2021-06-23,Alameda,001,1643700,89386,89338,1990,91328,1266
2021-06-23,Alpine,003,1148,88,88,0,88,0
2021-06-23,Amador,005,37829,3757,3743,33,3776,46
2021-06-23,Butte,007,227075,12787,12666,1866,14532,198
2021-06-23,Calaveras,009,45235,2198,2199,13,2212,55
2021-06-23,Colusa,011,21464,1966,1972,321,2293,15
2021-06-23,Contra Costa,013,1133247,70963,70526,1331,71857,813
2021-06-23,Del Norte,015,27424,1460,1418,13,1431,8
2021-06-23,El Dorado,017,186661,10464,10395,779,11174,115
2021-06-23,Fresno,019,978130,103441,103020,8793,111813,1724
2021-06-23,Glenn,021,27897,2450,2437,569,3006,20
2021-06-23,Humboldt,023,135768,4503,4490,43,4533,48
2021-06-23,Imperial,025,180216,28776,28908,2758,31666,740
2021-06-23,Inyo,027,18085,1411,1406,13,1419,35
2021-06-23,Kern,029,883053,97897,97078,11171,108249,1345
2021-06-23,Kings,031,150075,23273,23105,1110,24215,245
2021-06-23,Lake,033,64148,3590,3566,13,3579,53
2021-06-23,Lassen,035,31185,5278,5257,117,5374,20
2021-06-23,Los Angeles,037,10098052,1212076,1206358,41708,1248066,24472
2021-06-23,Madera,039,155013,16787,16660,950,17610,240
2021-06-23,Marin,041,260295,14205,14177,267,14444,230
2021-06-23,Mariposa,043,17540,441,439,11,450,5
2021-06-23,Mendocino,045,87422,4173,4078,83,4161,49
2021-06-23,Merced,047,269075,31235,31260,1064,32324,465
2021-06-23,Modoc,049,8938,417,407,147,554,3
2021-06-23,Mono,051,14174,1266,1279,18,1297,3
2021-06-23,Monterey,053,433212,43313,43166,1877,45043,439
2021-06-23,Napa,055,140530,10019,10032,39,10071,80
2021-06-23,Nevada,057,99092,4969,4924,197,5121,72
2021-06-23,Orange,059,3164182,256537,255479,11580,267059,5116
2021-06-23,Placer,061,380077,23819,23630,1545,25175,299
2021-06-23,Plumas,063,18699,721,701,11,712,4
2021-06-23,Riverside,065,2383286,295558,290343,14180,304523,4462
2021-06-23,Sacramento,067,1510023,108207,107868,1838,109706,1671
2021-06-23,San Benito,069,59416,6090,6097,116,6213,63
2021-06-23,San Bernardino,071,2135413,294742,293816,9084,302900,4886
2021-06-23,San Diego,073,3302833,282964,281937,15337,297274,3777
2021-06-23,San Francisco,075,870044,37102,37304,1310,38614,559
2021-06-23,San Joaquin,077,732212,74059,73764,3653,77417,1405
2021-06-23,San Luis Obispo,079,281455,21542,21323,758,22081,257
2021-06-23,San Mateo,081,765935,42721,42756,491,43247,542
2021-06-23,Santa Barbara,083,443738,34614,34505,1145,35650,454
2021-06-23,Santa Clara,085,1922200,119451,120233,784,121017,2098
2021-06-23,Santa Cruz,087,273765,16337,16215,814,17029,209
2021-06-23,Shasta,089,179085,12590,12604,1639,14243,202
2021-06-23,Sierra,091,2930,63,57,12,69,0
2021-06-23,Siskiyou,093,43540,1964,1892,374,2266,28
2021-06-23,Solano,095,438530,33409,33408,573,33981,267
2021-06-23,Sonoma,097,501317,30926,30959,364,31323,314
2021-06-23,Stanislaus,099,539301,57065,56926,6039,62965,1017
2021-06-23,Sutter,101,95872,9615,9653,90,9743,113
2021-06-23,Tehama,103,63373,5151,5119,592,5711,63
2021-06-23,Trinity,105,12862,493,338,99,437,3
2021-06-23,Tulare,107,460477,50452,49711,9166,58877,850
2021-06-23,Tuolumne,109,53932,4075,4120,42,4162,64
2021-06-23,Ventura,111,848112,81769,81312,3040,84352,1032
2021-06-23,Yolo,113,214977,14182,14161,346,14507,212
2021-06-23,Yuba,115,75493,6209,6190,133,6323,51
2021-06-22,Alameda,001,1643700,89319,89308,1990,91298,1263
2021-06-22,Alpine,003,1148,88,88,0,88,0
2021-06-22,Amador,005,37829,3754,3743,33,3776,46
2021-06-22,Butte,007,227075,12783,12662,1863,14525,198
2021-06-22,Calaveras,009,45235,2197,2198,13,2211,55
2021-06-22,Colusa,011,21464,1965,1971,321,2292,15
2021-06-22,Contra Costa,013,1133247,70907,70480,1330,71810,813
2021-06-22,Del Norte,015,27424,1457,1417,13,1430,8
2021-06-22,El Dorado,017,186661,10459,10380,778,11158,113
2021-06-22,Fresno,019,978130,103422,102996,8789,111785,1724
2021-06-22,Glenn,021,27897,2449,2435,567,3002,19
2021-06-22,Humboldt,023,135768,4493,4483,43,4526,42
2021-06-22,Imperial,025,180216,28771,28880,2758,31638,740
2021-06-22,Inyo,027,18085,1411,1405,13,1418,35
2021-06-22,Kern,029,883053,97884,97013,11167,108180,1342
2021-06-22,Kings,031,150075,23265,23098,1109,24207,245
2021-06-22,Lake,033,64148,3588,3564,13,3577,45
2021-06-22,Lassen,035,31185,5273,5254,117,5371,20
2021-06-22,Los Angeles,037,10098052,1211762,1206146,41696,1247842,24461
2021-06-22,Madera,039,155013,16782,16652,950,17602,240
2021-06-22,Marin,041,260295,14203,14174,267,14441,230
2021-06-22,Mariposa,043,17540,441,439,11,450,5
2021-06-22,Mendocino,045,87422,4167,4072,83,4155,49
2021-06-22,Merced,047,269075,31224,31267,1064,32331,464
2021-06-22,Modoc,049,8938,415,405,146,551,3
2021-06-22,Mono,051,14174,1266,1277,18,1295,3
2021-06-22,Monterey,053,433212,43310,43162,1876,45038,427
2021-06-22,Napa,055,140530,10015,10029,39,10068,80
2021-06-22,Nevada,057,99092,4963,4923,197,5120,72
2021-06-22,Orange,059,3164182,256468,255452,11569,267021,5114
2021-06-22,Placer,061,380077,23797,23603,1545,25148,299
2021-06-22,Plumas,063,18699,721,697,11,708,4
2021-06-22,Riverside,065,2383286,295497,289839,14176,304015,4456
2021-06-22,Sacramento,067,1510023,108106,107801,1833,109634,1670
2021-06-22,San Benito,069,59416,6089,6098,116,6214,63
2021-06-22,San Bernardino,071,2135413,294667,293770,9078,302848,4873
2021-06-22,San Diego,073,3302833,282860,281867,15314,297181,3771
2021-06-22,San Francisco,075,870044,37088,37287,1310,38597,556
2021-06-22,San Joaquin,077,732212,74029,73723,3651,77374,1405
2021-06-22,San Luis Obispo,079,281455,21539,21321,757,22078,257
2021-06-22,San Mateo,081,765935,42707,42725,486,43211,542
2021-06-22,Santa Barbara,083,443738,34603,34500,1144,35644,454
2021-06-22,Santa Clara,085,1922200,119419,120194,784,120978,2095
2021-06-22,Santa Cruz,087,273765,16332,16218,814,17032,209
2021-06-22,Shasta,089,179085,12579,12616,1636,14252,202
2021-06-22,Sierra,091,2930,62,57,12,69,0
2021-06-22,Siskiyou,093,43540,1964,1892,374,2266,28
2021-06-22,Solano,095,438530,33391,33397,572,33969,267
2021-06-22,Sonoma,097,501317,30886,30933,364,31297,314
2021-06-22,Stanislaus,099,539301,57049,56915,6037,62952,1017
2021-06-22,Sutter,101,95872,9608,9649,90,9739,113
2021-06-22,Tehama,103,63373,5149,5118,591,5709,63
2021-06-22,Trinity,105,12862,491,337,99,436,3
2021-06-22,Tulare,107,460477,50442,49706,9161,58867,850
2021-06-22,Tuolumne,109,53932,4073,4119,42,4161,64
2021-06-22,Ventura,111,848112,81755,81300,3039,84339,1032
2021-06-22,Yolo,113,214977,14177,14157,344,14501,212
2021-06-22,Yuba,115,75493,6205,6181,133,6314,51
2021-06-21,Alameda,001,1643700,89262,89281,1989,91270,1262
2021-06-21,Alpine,003,1148,88,88,0,88,0
2021-06-21,Amador,005,37829,3748,3742,33,3775,46
2021-06-21,Butte,007,227075,12777,12668,1861,14529,195
2021-06-21,Calaveras,009,45235,2195,2194,13,2207,55
2021-06-21,Colusa,011,21464,1964,1970,320,2290,15
2021-06-21,Contra Costa,013,1133247,70836,70439,1328,71767,813
2021-06-21,Del Norte,015,27424,1453,1416,13,1429,8
2021-06-21,El Dorado,017,186661,10453,10375,777,11152,113
2021-06-21,Fresno,019,978130,103402,102971,8786,111757,1724
2021-06-21,Glenn,021,27897,2448,2433,567,3000,19
2021-06-21,Humboldt,023,135768,4484,4478,42,4520,42
2021-06-21,Imperial,025,180216,28767,28855,2758,31613,740
2021-06-21,Inyo,027,18085,1410,1405,13,1418,35
2021-06-21,Kern,029,883053,97855,96995,11158,108153,1342
2021-06-21,Kings,031,150075,23258,23091,1106,24197,245
2021-06-21,Lake,033,64148,3582,3563,13,3576,45
2021-06-21,Lassen,035,31185,5271,5233,117,5350,19
2021-06-21,Los Angeles,037,10098052,1211469,1205994,41674,1247668,24459
2021-06-21,Madera,039,155013,16773,16647,950,17597,240
2021-06-21,Marin,041,260295,14199,14173,267,14440,230
2021-06-21,Mariposa,043,17540,441,439,11,450,5
2021-06-21,Mendocino,045,87422,4164,4085,83,4168,49
2021-06-21,Merced,047,269075,31214,31264,1063,32327,465
2021-06-21,Modoc,049,8938,415,405,146,551,3
2021-06-21,Mono,051,14174,1266,1277,18,1295,3
2021-06-21,Monterey,053,433212,43307,43157,1876,45033,427
2021-06-21,Napa,055,140530,10010,10028,39,10067,80
2021-06-21,Nevada,057,99092,4959,4921,197,5118,72
2021-06-21,Orange,059,3164182,256395,255400,11562,266962,5113
2021-06-21,Placer,061,380077,23773,23577,1545,25122,298
2021-06-21,Plumas,063,18699,719,697,11,708,4
2021-06-21,Riverside,065,2383286,295421,289797,14171,303968,4456
2021-06-21,Sacramento,067,1510023,107995,107757,1832,109589,1669
2021-06-21,San Benito,069,59416,6085,6098,116,6214,63
2021-06-21,San Bernardino,071,2135413,294580,293736,9074,302810,4850
2021-06-21,San Diego,073,3302833,282755,281811,15294,297105,3771
2021-06-21,San Francisco,075,870044,37072,37275,1309,38584,556
2021-06-21,San Joaquin,077,732212,73988,73687,3650,77337,1405
2021-06-21,San Luis Obispo,079,281455,21530,21316,757,22073,257
2021-06-21,San Mateo,081,765935,42691,42685,485,43170,542
2021-06-21,Santa Barbara,083,443738,34598,34492,1144,35636,455
2021-06-21,Santa Clara,085,1922200,119386,120192,783,120975,2093
2021-06-21,Santa Cruz,087,273765,16330,16212,814,17026,208
2021-06-21,Shasta,089,179085,12566,12617,1633,14250,201
2021-06-21,Sierra,091,2930,62,57,12,69,0
2021-06-21,Siskiyou,093,43540,1964,1892,374,2266,27
2021-06-21,Solano,095,438530,33368,33383,571,33954,266
2021-06-21,Sonoma,097,501317,30863,30912,364,31276,314
2021-06-21,Stanislaus,099,539301,57019,56891,6032,62923,1017
2021-06-21,Sutter,101,95872,9605,9649,90,9739,113
2021-06-21,Tehama,103,63373,5149,5115,590,5705,63
2021-06-21,Trinity,105,12862,491,337,99,436,3
2021-06-21,Tulare,107,460477,50431,49689,9157,58846,849
2021-06-21,Tuolumne,109,53932,4069,4119,42,4161,63
2021-06-21,Ventura,111,848112,81727,81291,3035,84326,1031
2021-06-21,Yolo,113,214977,14171,14165,344,14509,212
2021-06-21,Yuba,115,75493,6204,6172,133,6305,51
2021-06-20,Alameda,001,1643700,89197,89255,1988,91243,1263
2021-06-20,Alpine,003,1148,88,88,0,88,0
2021-06-20,Amador,005,37829,3745,3740,33,3773,46
2021-06-20,Butte,007,227075,12770,12668,1860,14528,194
2021-06-20,Calaveras,009,45235,2194,2193,13,2206,55
2021-06-20,Colusa,011,21464,1964,1970,320,2290,15
2021-06-20,Contra Costa,013,1133247,70779,70401,1326,71727,813
2021-06-20,Del Norte,015,27424,1449,1416,13,1429,8
2021-06-20,El Dorado,017,186661,10439,10372,774,11146,113
2021-06-20,Fresno,019,978130,103361,102947,8782,111729,1724
2021-06-20,Glenn,021,27897,2448,2434,567,3001,19
2021-06-20,Humboldt,023,135768,4478,4472,42,4514,42
2021-06-20,Imperial,025,180216,28758,28855,2758,31613,740
2021-06-20,Inyo,027,18085,1409,1405,13,1418,35
2021-06-20,Kern,029,883053,97834,96985,11147,108132,1342
2021-06-20,Kings,031,150075,23253,23088,1104,24192,245
2021-06-20,Lake,033,64148,3580,3563,13,3576,45
2021-06-20,Lassen,035,31185,5268,5230,117,5347,19
2021-06-20,Los Angeles,037,10098052,1211166,1205874,41666,1247540,24456
2021-06-20,Madera,039,155013,16765,16638,948,17586,240
2021-06-20,Marin,041,260295,14196,14166,267,14433,230
2021-06-20,Mariposa,043,17540,439,439,11,450,5
2021-06-20,Mendocino,045,87422,4157,4080,83,4163,49
2021-06-20,Merced,047,269075,31201,31265,1063,32328,465
2021-06-20,Modoc,049,8938,415,405,146,551,3
2021-06-20,Mono,051,14174,1266,1275,18,1293,3
2021-06-20,Monterey,053,433212,43298,43156,1875,45031,427
2021-06-20,Napa,055,140530,10003,10026,38,10064,80
2021-06-20,Nevada,057,99092,4952,4919,197,5116,72
2021-06-20,Orange,059,3164182,256331,255377,11551,266928,5113
2021-06-20,Placer,061,380077,23739,23562,1541,25103,298
2021-06-20,Plumas,063,18699,718,697,11,708,4
2021-06-20,Riverside,065,2383286,295342,289770,14160,303930,4456
2021-06-20,Sacramento,067,1510023,107884,107700,1829,109529,1669
2021-06-20,San Benito,069,59416,6085,6098,116,6214,63
2021-06-20,San Bernardino,071,2135413,294480,293713,9070,302783,4845
2021-06-20,San Diego,073,3302833,282649,281750,15272,297022,3771
2021-06-20,San Francisco,075,870044,37049,37269,1309,38578,556
2021-06-20,San Joaquin,077,732212,73943,73676,3641,77317,1405
2021-06-20,San Luis Obispo,079,281455,21528,21313,757,22070,257
2021-06-20,San Mateo,081,765935,42662,42681,485,43166,542
2021-06-20,Santa Barbara,083,443738,34589,34487,1144,35631,455
2021-06-20,Santa Clara,085,1922200,119351,120163,783,120946,2093
2021-06-20,Santa Cruz,087,273765,16324,16210,814,17024,208
2021-06-20,Shasta,089,179085,12561,12617,1631,14248,201
2021-06-20,Sierra,091,2930,62,57,12,69,0
2021-06-20,Siskiyou,093,43540,1963,1891,374,2265,27
2021-06-20,Solano,095,438530,33346,33361,569,33930,266
2021-06-20,Sonoma,097,501317,30816,30884,361,31245,314
2021-06-20,Stanislaus,099,539301,56987,56868,6031,62899,1017
2021-06-20,Sutter,101,95872,9602,9645,90,9735,113
2021-06-20,Tehama,103,63373,5145,5115,590,5705,63
2021-06-20,Trinity,105,12862,491,337,99,436,3
2021-06-20,Tulare,107,460477,50422,49685,9155,58840,849
2021-06-20,Tuolumne,109,53932,4066,4117,42,4159,63
2021-06-20,Ventura,111,848112,81711,81282,3033,84315,1031
2021-06-20,Yolo,113,214977,14164,14160,344,14504,212
2021-06-20,Yuba,115,75493,6197,6167,133,6300,51
2021-06-19,Alameda,001,1643700,89162,89202,1988,91190,1263
2021-06-19,Alpine,003,1148,88,88,0,88,0
2021-06-19,Amador,005,37829,3743,3739,33,3772,46
2021-06-19,Butte,007,227075,12766,12659,1860,14519,194
2021-06-19,Calaveras,009,45235,2194,2192,13,2205,55
2021-06-19,Colusa,011,21464,1964,1969,320,2289,15
2021-06-19,Contra Costa,013,1133247,70748,70334,1325,71659,813
2021-06-19,Del Norte,015,27424,1448,1416,13,1429,8
2021-06-19,El Dorado,017,186661,10438,10363,773,11136,113
2021-06-19,Fresno,019,978130,103348,102922,8779,111701,1724
2021-06-19,Glenn,021,27897,2447,2434,566,3000,19
2021-06-19,Humboldt,023,135768,4467,4463,42,4505,42
2021-06-19,Imperial,025,180216,28757,28813,2758,31571,740
2021-06-19,Inyo,027,18085,1409,1405,13,1418,35
2021-06-19,Kern,029,883053,97818,96966,11143,108109,1342
2021-06-19,Kings,031,150075,23250,23086,1104,24190,245
2021-06-19,Lake,033,64148,3576,3563,13,3576,45
2021-06-19,Lassen,035,31185,5267,5225,117,5342,19
2021-06-19,Los Angeles,037,10098052,1210962,1205602,41650,1247252,24454
2021-06-19,Madera,039,155013,16763,16632,948,17580,240
2021-06-19,Marin,041,260295,14188,14152,267,14419,230
2021-06-19,Mariposa,043,17540,439,439,11,450,5
2021-06-19,Mendocino,045,87422,4151,4077,83,4160,49
2021-06-19,Merced,047,269075,31199,31256,1063,32319,465
2021-06-19,Modoc,049,8938,414,402,146,548,3
2021-06-19,Mono,051,14174,1266,1275,18,1293,3
2021-06-19,Monterey,053,433212,43292,43153,1875,45028,427
2021-06-19,Napa,055,140530,9999,10025,38,10063,80
2021-06-19,Nevada,057,99092,4947,4910,197,5107,72
2021-06-19,Orange,059,3164182,256284,255329,11548,266877,5112
2021-06-19,Placer,061,380077,23723,23537,1538,25075,298
2021-06-19,Plumas,063,18699,717,697,11,708,4
2021-06-19,Riverside,065,2383286,295296,289720,14160,303880,4456
2021-06-19,Sacramento,067,1510023,107838,107631,1826,109457,1669
2021-06-19,San Benito,069,59416,6084,6098,116,6214,63
2021-06-19,San Bernardino,071,2135413,294436,293673,9067,302740,4844
2021-06-19,San Diego,073,3302833,282589,281682,15258,296940,3771
2021-06-19,San Francisco,075,870044,37036,37256,1309,38565,556
2021-06-19,San Joaquin,077,732212,73927,73652,3637,77289,1405
2021-06-19,San Luis Obispo,079,281455,21526,21308,755,22063,257
2021-06-19,San Mateo,081,765935,42644,42646,483,43129,542
2021-06-19,Santa Barbara,083,443738,34587,34472,1144,35616,455
2021-06-19,Santa Clara,085,1922200,119328,120110,782,120892,2093
2021-06-19,Santa Cruz,087,273765,16319,16206,814,17020,208
2021-06-19,Shasta,089,179085,12559,12615,1630,14245,201
2021-06-19,Sierra,091,2930,62,57,12,69,0
2021-06-19,Siskiyou,093,43540,1963,1891,374,2265,27
2021-06-19,Solano,095,438530,33336,33341,568,33909,266
2021-06-19,Sonoma,097,501317,30775,30841,360,31201,314
2021-06-19,Stanislaus,099,539301,56968,56847,6028,62875,1017
2021-06-19,Sutter,101,95872,9599,9645,90,9735,113
2021-06-19,Tehama,103,63373,5144,5115,590,5705,63
2021-06-19,Trinity,105,12862,491,337,99,436,3
2021-06-19,Tulare,107,460477,50415,49681,9150,58831,849
2021-06-19,Tuolumne,109,53932,4066,4117,42,4159,63
2021-06-19,Ventura,111,848112,81698,81270,3032,84302,1031
2021-06-19,Yolo,113,214977,14160,14156,343,14499,212
2021-06-19,Yuba,115,75493,6196,6157,133,6290,51
2021-06-18,Alameda,001,1643700,89125,89123,1988,91111,1263
2021-06-18,Alpine,003,1148,88,88,0,88,0
2021-06-18,Amador,005,37829,3743,3739,33,3772,46
2021-06-18,Butte,007,227075,12763,12653,1857,14510,194
2021-06-18,Calaveras,009,45235,2194,2191,13,2204,55
2021-06-18,Colusa,011,21464,1963,1969,320,2289,15
2021-06-18,Contra Costa,013,1133247,70706,70271,1323,71594,813
2021-06-18,Del Norte,015,27424,1448,1415,13,1428,8
2021-06-18,El Dorado,017,186661,10435,10348,771,11119,113
2021-06-18,Fresno,019,978130,103332,102894,8777,111671,1722
2021-06-18,Glenn,021,27897,2446,2430,566,2996,19
2021-06-18,Humboldt,023,135768,4459,4450,42,4492,42
2021-06-18,Imperial,025,180216,28755,28809,2758,31567,740
2021-06-18,Inyo,027,18085,1409,1405,13,1418,35
2021-06-18,Kern,029,883053,97807,96948,11137,108085,1341
2021-06-18,Kings,031,150075,23245,23082,1104,24186,245
2021-06-18,Lake,033,64148,3572,3563,13,3576,45
2021-06-18,Lassen,035,31185,5266,5224,117,5341,19
2021-06-18,Los Angeles,037,10098052,1210803,1205472,41633,1247105,24451
2021-06-18,Madera,039,155013,16757,16625,948,17573,241
2021-06-18,Marin,041,260295,14185,14147,267,14414,230
2021-06-18,Mariposa,043,17540,439,439,11,450,5
2021-06-18,Mendocino,045,87422,4146,4068,83,4151,49
2021-06-18,Merced,047,269075,31197,31262,1063,32325,464
2021-06-18,Modoc,049,8938,414,402,146,548,3
2021-06-18,Mono,051,14174,1265,1275,17,1292,3
2021-06-18,Monterey,053,433212,43289,43148,1875,45023,427
2021-06-18,Napa,055,140530,9995,10021,38,10059,80
2021-06-18,Nevada,057,99092,4939,4903,197,5100,72
2021-06-18,Orange,059,3164182,256247,255274,11545,266819,5108
2021-06-18,Placer,061,380077,23715,23500,1535,25035,298
2021-06-18,Plumas,063,18699,717,697,11,708,4
2021-06-18,Riverside,065,2383286,295248,289676,14159,303835,4457
2021-06-18,Sacramento,067,1510023,107790,107570,1826,109396,1669
2021-06-18,San Benito,069,59416,6083,6097,116,6213,63
2021-06-18,San Bernardino,071,2135413,294391,293629,9063,302692,4826
2021-06-18,San Diego,073,3302833,282513,281608,15247,296855,3771
2021-06-18,San Francisco,075,870044,37027,37246,1309,38555,556
2021-06-18,San Joaquin,077,732212,73909,73623,3635,77258,1403
2021-06-18,San Luis Obispo,079,281455,21522,21301,754,22055,257
2021-06-18,San Mateo,081,765935,42633,42630,482,43112,542
2021-06-18,Santa Barbara,083,443738,34577,34469,1144,35613,455
2021-06-18,Santa Clara,085,1922200,119307,120081,780,120861,2093
2021-06-18,Santa Cruz,087,273765,16315,16202,814,17016,208
2021-06-18,Shasta,089,179085,12555,12607,1628,14235,201
2021-06-18,Sierra,091,2930,61,57,12,69,0
2021-06-18,Siskiyou,093,43540,1963,1890,374,2264,27
2021-06-18,Solano,095,438530,33322,33323,568,33891,266
2021-06-18,Sonoma,097,501317,30757,30816,359,31175,313
2021-06-18,Stanislaus,099,539301,56953,56803,6026,62829,1012
2021-06-18,Sutter,101,95872,9596,9643,90,9733,113
2021-06-18,Tehama,103,63373,5142,5114,590,5704,63
2021-06-18,Trinity,105,12862,491,337,98,435,3
2021-06-18,Tulare,107,460477,50413,49664,9143,58807,849
2021-06-18,Tuolumne,109,53932,4064,4116,42,4158,63
2021-06-18,Ventura,111,848112,81688,81256,3027,84283,1031
2021-06-18,Yolo,113,214977,14157,14148,341,14489,212
2021-06-18,Yuba,115,75493,6190,6150,133,6283,51
2021-06-17,Alameda,001,1643700,89078,89087,1988,91075,1262
2021-06-17,Alpine,003,1148,88,88,0,88,0
2021-06-17,Amador,005,37829,3741,3731,33,3764,46
2021-06-17,Butte,007,227075,12753,12644,1856,14500,194
2021-06-17,Calaveras,009,45235,2193,2189,13,2202,55
2021-06-17,Colusa,011,21464,1962,1969,320,2289,15
2021-06-17,Contra Costa,013,1133247,70667,70190,1319,71509,810
2021-06-17,Del Norte,015,27424,1446,1413,13,1426,8
2021-06-17,El Dorado,017,186661,10425,10341,771,11112,113
2021-06-17,Fresno,019,978130,103306,102867,8773,111640,1722
2021-06-17,Glenn,021,27897,2446,2430,566,2996,19
2021-06-17,Humboldt,023,135768,4450,4438,42,4480,42
2021-06-17,Imperial,025,180216,28747,28801,2758,31559,741
2021-06-17,Inyo,027,18085,1409,1405,13,1418,35
2021-06-17,Kern,029,883053,97792,96840,11131,107971,1340
2021-06-17,Kings,031,150075,23241,23078,1103,24181,245
2021-06-17,Lake,033,64148,3569,3563,9,3572,45
2021-06-17,Lassen,035,31185,5262,5223,117,5340,19
2021-06-17,Los Angeles,037,10098052,1210590,1205301,41604,1246905,24444
2021-06-17,Madera,039,155013,16752,16618,948,17566,241
2021-06-17,Marin,041,260295,14185,14141,267,14408,229
2021-06-17,Mariposa,043,17540,439,439,11,450,5
2021-06-17,Mendocino,045,87422,4139,4054,83,4137,49
2021-06-17,Merced,047,269075,31192,31262,1063,32325,464
2021-06-17,Modoc,049,8938,413,401,146,547,3
2021-06-17,Mono,051,14174,1264,1275,17,1292,3
2021-06-17,Monterey,053,433212,43281,43140,1875,45015,416
2021-06-17,Napa,055,140530,9995,10014,38,10052,80
2021-06-17,Nevada,057,99092,4935,4898,197,5095,72
2021-06-17,Orange,059,3164182,256201,255240,11534,266774,5109
2021-06-17,Placer,061,380077,23699,23461,1533,24994,298
2021-06-17,Plumas,063,18699,716,697,11,708,4
2021-06-17,Riverside,065,2383286,295194,289627,14157,303784,4458
2021-06-17,Sacramento,067,1510023,107726,107492,1824,109316,1666
2021-06-17,San Benito,069,59416,6083,6097,116,6213,63
2021-06-17,San Bernardino,071,2135413,294350,293560,9063,302623,4811
2021-06-17,San Diego,073,3302833,282437,281531,15233,296764,3771
2021-06-17,San Francisco,075,870044,37016,37243,1308,38551,556
2021-06-17,San Joaquin,077,732212,73886,73560,3630,77190,1403
2021-06-17,San Luis Obispo,079,281455,21520,21297,754,22051,257
2021-06-17,San Mateo,081,765935,42627,42615,482,43097,542
2021-06-17,Santa Barbara,083,443738,34571,34466,1144,35610,453
2021-06-17,Santa Clara,085,1922200,119282,120032,779,120811,2093
2021-06-17,Santa Cruz,087,273765,16311,16197,814,17011,208
2021-06-17,Shasta,089,179085,12547,12597,1628,14225,201
2021-06-17,Sierra,091,2930,61,56,12,68,0
2021-06-17,Siskiyou,093,43540,1962,1889,374,2263,27
2021-06-17,Solano,095,438530,33301,33296,567,33863,266
2021-06-17,Sonoma,097,501317,30727,30793,359,31152,323
2021-06-17,Stanislaus,099,539301,56922,56752,6021,62773,1012
2021-06-17,Sutter,101,95872,9593,9629,90,9719,113
2021-06-17,Tehama,103,63373,5141,5112,588,5700,63
2021-06-17,Trinity,105,12862,490,337,98,435,3
2021-06-17,Tulare,107,460477,50408,49649,9135,58784,849
2021-06-17,Tuolumne,109,53932,4063,4116,42,4158,63
2021-06-17,Ventura,111,848112,81679,81248,3024,84272,1030
2021-06-17,Yolo,113,214977,14149,14141,341,14482,212
2021-06-17,Yuba,115,75493,6181,6140,133,6273,51
2021-06-16,Alameda,001,1643700,89029,89045,1987,91032,1265
2021-06-16,Alpine,003,1148,88,88,0,88,0
2021-06-16,Amador,005,37829,3740,3730,33,3763,46
2021-06-16,Butte,007,227075,12751,12635,1854,14489,194
2021-06-16,Calaveras,009,45235,2191,2188,13,2201,55
2021-06-16,Colusa,011,21464,1962,1967,320,2287,15
2021-06-16,Contra Costa,013,1133247,70615,70136,1318,71454,810
2021-06-16,Del Norte,015,27424,1443,1413,13,1426,8
2021-06-16,El Dorado,017,186661,10419,10334,770,11104,113
2021-06-16,Fresno,019,978130,103276,102842,8769,111611,1722
2021-06-16,Glenn,021,27897,2446,2430,566,2996,19
2021-06-16,Humboldt,023,135768,4441,4427,41,4468,42
2021-06-16,Imperial,025,180216,28744,28796,2758,31554,741
2021-06-16,Inyo,027,18085,1408,1405,13,1418,35
2021-06-16,Kern,029,883053,97770,96789,11124,107913,1339
2021-06-16,Kings,031,150075,23240,23072,1102,24174,245
2021-06-16,Lake,033,64148,3569,3562,9,3571,45
2021-06-16,Lassen,035,31185,5259,5216,117,5333,19
2021-06-16,Los Angeles,037,10098052,1210365,1205102,41594,1246696,24439
2021-06-16,Madera,039,155013,16748,16603,948,17551,240
2021-06-16,Marin,041,260295,14183,14137,267,14404,229
2021-06-16,Mariposa,043,17540,439,437,11,448,5
2021-06-16,Mendocino,045,87422,4131,4041,83,4124,49
2021-06-16,Merced,047,269075,31184,31250,1063,32313,463
2021-06-16,Modoc,049,8938,412,383,145,528,3
2021-06-16,Mono,051,14174,1264,1275,17,1292,3
2021-06-16,Monterey,053,433212,43278,43122,1875,44997,416
2021-06-16,Napa,055,140530,9991,10011,38,10049,80
2021-06-16,Nevada,057,99092,4930,4894,197,5091,72
2021-06-16,Orange,059,3164182,256147,255188,11526,266714,5109
2021-06-16,Placer,061,380077,23689,23425,1529,24954,298
2021-06-16,Plumas,063,18699,716,697,11,708,4
2021-06-16,Riverside,065,2383286,295133,289539,14155,303694,4457
2021-06-16,Sacramento,067,1510023,107656,107422,1820,109242,1665
2021-06-16,San Benito,069,59416,6083,6090,116,6206,63
2021-06-16,San Bernardino,071,2135413,294301,293499,9061,302560,4797
2021-06-16,San Diego,073,3302833,282358,281423,15220,296643,3770
2021-06-16,San Francisco,075,870044,37003,37222,1306,38528,555
2021-06-16,San Joaquin,077,732212,73847,73530,3626,77156,1399
2021-06-16,San Luis Obispo,079,281455,21515,21294,754,22048,257
2021-06-16,San Mateo,081,765935,42611,42601,482,43083,542
2021-06-16,Santa Barbara,083,443738,34565,34459,1144,35603,460
2021-06-16,Santa Clara,085,1922200,119250,119982,779,120761,2087
2021-06-16,Santa Cruz,087,273765,16308,16187,814,17001,208
2021-06-16,Shasta,089,179085,12542,12592,1627,14219,200
2021-06-16,Sierra,091,2930,61,56,12,68,0
2021-06-16,Siskiyou,093,43540,1961,1886,374,2260,26
2021-06-16,Solano,095,438530,33273,33276,567,33843,266
2021-06-16,Sonoma,097,501317,30691,30741,359,31100,323
2021-06-16,Stanislaus,099,539301,56891,56738,6019,62757,984
2021-06-16,Sutter,101,95872,9589,9620,90,9710,113
2021-06-16,Tehama,103,63373,5139,5106,588,5694,63
2021-06-16,Trinity,105,12862,489,332,98,430,3
2021-06-16,Tulare,107,460477,50403,49578,9131,58709,849
2021-06-16,Tuolumne,109,53932,4063,4110,42,4152,63
2021-06-16,Ventura,111,848112,81665,81229,3022,84251,1029
2021-06-16,Yolo,113,214977,14140,14135,340,14475,212
2021-06-16,Yuba,115,75493,6171,6134,133,6267,51
2021-06-15,Alameda,001,1643700,88987,89008,1987,90995,1262
2021-06-15,Alpine,003,1148,88,88,0,88,0
2021-06-15,Amador,005,37829,3737,3723,33,3756,46
2021-06-15,Butte,007,227075,12743,12620,1853,14473,194
2021-06-15,Calaveras,009,45235,2190,2188,13,2201,55
2021-06-15,Colusa,011,21464,1962,1967,318,2285,15
2021-06-15,Contra Costa,013,1133247,70553,70101,1318,71419,810
2021-06-15,Del Norte,015,27424,1442,1411,13,1424,8
2021-06-15,El Dorado,017,186661,10410,10330,770,11100,113
2021-06-15,Fresno,019,978130,103244,102828,8768,111596,1722
2021-06-15,Glenn,021,27897,2445,2426,566,2992,19
2021-06-15,Humboldt,023,135768,4432,4414,40,4454,42
2021-06-15,Imperial,025,180216,28738,28789,2758,31547,741
2021-06-15,Inyo,027,18085,1408,1405,13,1418,35
2021-06-15,Kern,029,883053,97742,96782,11116,107898,1338
2021-06-15,Kings,031,150075,23234,23070,1100,24170,245
2021-06-15,Lake,033,64148,3568,3559,9,3568,45
2021-06-15,Lassen,035,31185,5258,5211,117,5328,19
2021-06-15,Los Angeles,037,10098052,1210132,1204926,41586,1246512,24435
2021-06-15,Madera,039,155013,16741,16600,947,17547,240
2021-06-15,Marin,041,260295,14175,14135,267,14402,229
2021-06-15,Mariposa,043,17540,439,437,11,448,5
2021-06-15,Mendocino,045,87422,4124,4034,83,4117,49
2021-06-15,Merced,047,269075,31178,31244,1063,32307,461
2021-06-15,Modoc,049,8938,411,383,145,528,3
2021-06-15,Mono,051,14174,1264,1275,17,1292,3
2021-06-15,Monterey,053,433212,43272,43118,1875,44993,416
2021-06-15,Napa,055,140530,9989,10010,38,10048,80
2021-06-15,Nevada,057,99092,4927,4888,197,5085,72
2021-06-15,Orange,059,3164182,256106,255127,11517,266644,5105
2021-06-15,Placer,061,380077,23667,23396,1528,24924,298
2021-06-15,Plumas,063,18699,715,697,11,708,4
2021-06-15,Riverside,065,2383286,295073,289508,14151,303659,4455
2021-06-15,Sacramento,067,1510023,107581,107370,1814,109184,1662
2021-06-15,San Benito,069,59416,6082,6089,116,6205,63
2021-06-15,San Bernardino,071,2135413,294251,293463,9055,302518,4790
2021-06-15,San Diego,073,3302833,282274,281375,15205,296580,3770
2021-06-15,San Francisco,075,870044,36994,37210,1305,38515,555
2021-06-15,San Joaquin,077,732212,73807,73494,3621,77115,1399
2021-06-15,San Luis Obispo,079,281455,21510,21293,753,22046,257
2021-06-15,San Mateo,081,765935,42598,42593,482,43075,543
2021-06-15,Santa Barbara,083,443738,34560,34451,1144,35595,460
2021-06-15,Santa Clara,085,1922200,119212,119963,779,120742,2086
2021-06-15,Santa Cruz,087,273765,16302,16180,813,16993,208
2021-06-15,Shasta,089,179085,12536,12583,1627,14210,201
2021-06-15,Sierra,091,2930,60,55,12,67,0
2021-06-15,Siskiyou,093,43540,1960,1887,374,2261,26
2021-06-15,Solano,095,438530,33254,33264,567,33831,266
2021-06-15,Sonoma,097,501317,30652,30707,358,31065,323
2021-06-15,Stanislaus,099,539301,56863,56724,6016,62740,979
2021-06-15,Sutter,101,95872,9580,9616,90,9706,113
2021-06-15,Tehama,103,63373,5137,5102,588,5690,63
2021-06-15,Trinity,105,12862,488,332,97,429,3
2021-06-15,Tulare,107,460477,50396,49561,9128,58689,848
2021-06-15,Tuolumne,109,53932,4063,4111,42,4153,63
2021-06-15,Ventura,111,848112,81654,81215,3019,84234,1029
2021-06-15,Yolo,113,214977,14136,14127,338,14465,212
2021-06-15,Yuba,115,75493,6160,6130,133,6263,51
2021-06-14,Alameda,001,1643700,88938,88966,1987,90953,1264
2021-06-14,Alpine,003,1148,88,88,0,88,0
2021-06-14,Amador,005,37829,3736,3722,33,3755,46
2021-06-14,Butte,007,227075,12732,12613,1849,14462,194
2021-06-14,Calaveras,009,45235,2189,2190,13,2203,55
2021-06-14,Colusa,011,21464,1961,1966,318,2284,15
2021-06-14,Contra Costa,013,1133247,70500,70069,1316,71385,810
2021-06-14,Del Norte,015,27424,1442,1411,13,1424,8
2021-06-14,El Dorado,017,186661,10401,10327,768,11095,113
2021-06-14,Fresno,019,978130,103222,102812,8766,111578,1719
2021-06-14,Glenn,021,27897,2445,2426,566,2992,19
2021-06-14,Humboldt,023,135768,4424,4407,39,4446,42
2021-06-14,Imperial,025,180216,28726,28836,2758,31594,741
2021-06-14,Inyo,027,18085,1407,1405,13,1418,35
2021-06-14,Kern,029,883053,97722,96760,11106,107866,1337
2021-06-14,Kings,031,150075,23231,23071,1099,24170,245
2021-06-14,Lake,033,64148,3567,3557,9,3566,45
2021-06-14,Lassen,035,31185,5255,5209,116,5325,19
2021-06-14,Los Angeles,037,10098052,1209894,1204748,41576,1246324,24434
2021-06-14,Madera,039,155013,16735,16597,946,17543,240
2021-06-14,Marin,041,260295,14173,14133,267,14400,229
2021-06-14,Mariposa,043,17540,438,437,11,448,5
2021-06-14,Mendocino,045,87422,4118,4028,83,4111,49
2021-06-14,Merced,047,269075,31169,31241,1062,32303,461
2021-06-14,Modoc,049,8938,402,382,143,525,3
2021-06-14,Mono,051,14174,1264,1275,17,1292,3
2021-06-14,Monterey,053,433212,43269,43110,1875,44985,415
2021-06-14,Napa,055,140530,9985,10000,38,10038,80
2021-06-14,Nevada,057,99092,4920,4885,197,5082,72
2021-06-14,Orange,059,3164182,256068,255069,11512,266581,5103
2021-06-14,Placer,061,380077,23642,23379,1527,24906,298
2021-06-14,Plumas,063,18699,715,696,11,707,4
2021-06-14,Riverside,065,2383286,295019,289476,14151,303627,4453
2021-06-14,Sacramento,067,1510023,107527,107334,1809,109143,1661
2021-06-14,San Benito,069,59416,6082,6087,116,6203,63
2021-06-14,San Bernardino,071,2135413,294195,293446,9051,302497,4790
2021-06-14,San Diego,073,3302833,282168,281314,15185,296499,3770
2021-06-14,San Francisco,075,870044,36981,37206,1305,38511,555
2021-06-14,San Joaquin,077,732212,73778,73453,3621,77074,1398
2021-06-14,San Luis Obispo,079,281455,21508,21302,753,22055,256
2021-06-14,San Mateo,081,765935,42585,42619,481,43100,543
2021-06-14,Santa Barbara,083,443738,34557,34449,1144,35593,460
2021-06-14,Santa Clara,085,1922200,119181,119957,778,120735,2085
2021-06-14,Santa Cruz,087,273765,16299,16175,813,16988,208
2021-06-14,Shasta,089,179085,12525,12561,1624,14185,201
2021-06-14,Sierra,091,2930,59,55,12,67,0
2021-06-14,Siskiyou,093,43540,1960,1886,374,2260,26
2021-06-14,Solano,095,438530,33237,33243,566,33809,266
2021-06-14,Sonoma,097,501317,30620,30679,357,31036,323
2021-06-14,Stanislaus,099,539301,56827,56689,6013,62702,975
2021-06-14,Sutter,101,95872,9577,9607,90,9697,112
2021-06-14,Tehama,103,63373,5135,5102,588,5690,63
2021-06-14,Trinity,105,12862,488,332,97,429,3
2021-06-14,Tulare,107,460477,50391,49538,9125,58663,848
2021-06-14,Tuolumne,109,53932,4060,4108,42,4150,63
2021-06-14,Ventura,111,848112,81644,81209,3019,84228,1028
2021-06-14,Yolo,113,214977,14128,14123,338,14461,212
2021-06-14,Yuba,115,75493,6153,6127,133,6260,50
2021-06-13,Alameda,001,1643700,88881,88947,1986,90933,1264
2021-06-13,Alpine,003,1148,87,88,0,88,0
2021-06-13,Amador,005,37829,3732,3721,33,3754,46
2021-06-13,Butte,007,227075,12721,12586,1846,14432,194
2021-06-13,Calaveras,009,45235,2189,2189,13,2202,55
2021-06-13,Colusa,011,21464,1961,1965,317,2282,15
2021-06-13,Contra Costa,013,1133247,70446,70040,1314,71354,810
2021-06-13,Del Norte,015,27424,1440,1412,13,1425,8
2021-06-13,El Dorado,017,186661,10392,10324,768,11092,113
2021-06-13,Fresno,019,978130,103191,102795,8761,111556,1719
2021-06-13,Glenn,021,27897,2444,2425,564,2989,19
2021-06-13,Humboldt,023,135768,4411,4401,39,4440,42
2021-06-13,Imperial,025,180216,28717,28800,2758,31558,741
2021-06-13,Inyo,027,18085,1407,1405,13,1418,35
2021-06-13,Kern,029,883053,97698,96743,11094,107837,1337
2021-06-13,Kings,031,150075,23226,23069,1098,24167,245
2021-06-13,Lake,033,64148,3567,3556,9,3565,45
2021-06-13,Lassen,035,31185,5250,5209,116,5325,19
2021-06-13,Los Angeles,037,10098052,1209630,1204614,41563,1246177,24433
2021-06-13,Madera,039,155013,16721,16590,946,17536,240
2021-06-13,Marin,041,260295,14167,14126,267,14393,229
2021-06-13,Mariposa,043,17540,438,434,11,445,5
2021-06-13,Mendocino,045,87422,4111,4026,83,4109,49
2021-06-13,Merced,047,269075,31163,31240,1061,32301,461
2021-06-13,Modoc,049,8938,400,382,141,523,3
2021-06-13,Mono,051,14174,1264,1275,17,1292,3
2021-06-13,Monterey,053,433212,43261,43108,1875,44983,415
2021-06-13,Napa,055,140530,9979,9995,38,10033,80
2021-06-13,Nevada,057,99092,4915,4883,197,5080,72
2021-06-13,Orange,059,3164182,256013,255043,11509,266552,5103
2021-06-13,Placer,061,380077,23616,23365,1525,24890,295
2021-06-13,Plumas,063,18699,714,696,11,707,4
2021-06-13,Riverside,065,2383286,294952,289447,14148,303595,4453
2021-06-13,Sacramento,067,1510023,107451,107289,1806,109095,1658
2021-06-13,San Benito,069,59416,6082,6086,116,6202,63
2021-06-13,San Bernardino,071,2135413,294143,293416,9046,302462,4788
2021-06-13,San Diego,073,3302833,282089,281268,15169,296437,3770
2021-06-13,San Francisco,075,870044,36968,37197,1305,38502,555
2021-06-13,San Joaquin,077,732212,73742,73438,3619,77057,1398
2021-06-13,San Luis Obispo,079,281455,21502,21298,752,22050,256
2021-06-13,San Mateo,081,765935,42572,42611,481,43092,542
2021-06-13,Santa Barbara,083,443738,34546,34449,1143,35592,460
2021-06-13,Santa Clara,085,1922200,119157,119946,778,120724,2085
2021-06-13,Santa Cruz,087,273765,16292,16172,813,16985,208
2021-06-13,Shasta,089,179085,12516,12560,1623,14183,201
2021-06-13,Sierra,091,2930,59,55,12,67,0
2021-06-13,Siskiyou,093,43540,1959,1885,374,2259,26
2021-06-13,Solano,095,438530,33216,33234,566,33800,266
2021-06-13,Sonoma,097,501317,30585,30663,355,31018,323
2021-06-13,Stanislaus,099,539301,56801,56671,6010,62681,975
2021-06-13,Sutter,101,95872,9570,9603,90,9693,112
2021-06-13,Tehama,103,63373,5133,5100,588,5688,63
2021-06-13,Trinity,105,12862,487,332,97,429,3
2021-06-13,Tulare,107,460477,50382,49537,9120,58657,848
2021-06-13,Tuolumne,109,53932,4058,4107,41,4148,63
2021-06-13,Ventura,111,848112,81630,81201,3019,84220,1028
2021-06-13,Yolo,113,214977,14119,14120,336,14456,212
2021-06-13,Yuba,115,75493,6146,6125,133,6258,50
2021-06-12,Alameda,001,1643700,88854,88901,1986,90887,1271
2021-06-12,Alpine,003,1148,87,88,0,88,0
2021-06-12,Amador,005,37829,3731,3721,33,3754,46
2021-06-12,Butte,007,227075,12717,12576,1846,14422,194
2021-06-12,Calaveras,009,45235,2189,2189,13,2202,55
2021-06-12,Colusa,011,21464,1961,1965,317,2282,15
2021-06-12,Contra Costa,013,1133247,70415,69989,1311,71300,810
2021-06-12,Del Norte,015,27424,1440,1412,13,1425,8
2021-06-12,El Dorado,017,186661,10387,10320,767,11087,113
2021-06-12,Fresno,019,978130,103181,102783,8760,111543,1720
2021-06-12,Glenn,021,27897,2442,2425,564,2989,19
2021-06-12,Humboldt,023,135768,4403,4396,39,4435,42
2021-06-12,Imperial,025,180216,28714,28799,2758,31557,741
2021-06-12,Inyo,027,18085,1407,1405,13,1418,35
2021-06-12,Kern,029,883053,97683,96731,11090,107821,1337
2021-06-12,Kings,031,150075,23224,23067,1098,24165,245
2021-06-12,Lake,033,64148,3566,3552,9,3561,45
2021-06-12,Lassen,035,31185,5250,5208,116,5324,19
2021-06-12,Los Angeles,037,10098052,1209490,1204439,41557,1245996,24434
2021-06-12,Madera,039,155013,16717,16586,946,17532,240
2021-06-12,Marin,041,260295,14164,14121,267,14388,229
2021-06-12,Mariposa,043,17540,438,434,11,445,5
2021-06-12,Mendocino,045,87422,4108,4024,83,4107,49
2021-06-12,Merced,047,269075,31160,31236,1061,32297,461
2021-06-12,Modoc,049,8938,399,382,141,523,3
2021-06-12,Mono,051,14174,1264,1275,17,1292,3
2021-06-12,Monterey,053,433212,43256,43103,1875,44978,415
2021-06-12,Napa,055,140530,9975,9986,38,10024,80
2021-06-12,Nevada,057,99092,4909,4878,197,5075,72
2021-06-12,Orange,059,3164182,255980,255004,11507,266511,5103
2021-06-12,Placer,061,380077,23597,23345,1525,24870,295
2021-06-12,Plumas,063,18699,714,696,11,707,4
2021-06-12,Riverside,065,2383286,294910,289413,14145,303558,4453
2021-06-12,Sacramento,067,1510023,107392,107199,1803,109002,1658
2021-06-12,San Benito,069,59416,6080,6083,116,6199,63
2021-06-12,San Bernardino,071,2135413,294108,293375,9044,302419,4788
2021-06-12,San Diego,073,3302833,282032,281203,15160,296363,3770
2021-06-12,San Francisco,075,870044,36958,37189,1305,38494,555
2021-06-12,San Joaquin,077,732212,73723,73413,3618,77031,1398
2021-06-12,San Luis Obispo,079,281455,21499,21293,752,22045,256
2021-06-12,San Mateo,081,765935,42566,42604,481,43085,542
2021-06-12,Santa Barbara,083,443738,34541,34450,1143,35593,460
2021-06-12,Santa Clara,085,1922200,119117,119894,778,120672,2085
2021-06-12,Santa Cruz,087,273765,16284,16170,813,16983,208
2021-06-12,Shasta,089,179085,12513,12556,1622,14178,201
2021-06-12,Sierra,091,2930,59,55,12,67,0
2021-06-12,Siskiyou,093,43540,1958,1884,374,2258,25
2021-06-12,Solano,095,438530,33207,33219,566,33785,266
2021-06-12,Sonoma,097,501317,30556,30647,355,31002,323
2021-06-12,Stanislaus,099,539301,56784,56649,6009,62658,974
2021-06-12,Sutter,101,95872,9566,9603,90,9693,112
2021-06-12,Tehama,103,63373,5133,5099,587,5686,63
2021-06-12,Trinity,105,12862,487,332,97,429,3
2021-06-12,Tulare,107,460477,50377,49533,9113,58646,848
2021-06-12,Tuolumne,109,53932,4057,4105,41,4146,63
2021-06-12,Ventura,111,848112,81618,81197,3019,84216,1028
2021-06-12,Yolo,113,214977,14116,14118,335,14453,212
2021-06-12,Yuba,115,75493,6141,6120,133,6253,50
2021-06-11,Alameda,001,1643700,88826,88844,1986,90830,1278
2021-06-11,Alpine,003,1148,87,88,0,88,0
2021-06-11,Amador,005,37829,3730,3710,33,3743,46
2021-06-11,Butte,007,227075,12713,12576,1844,14420,194
2021-06-11,Calaveras,009,45235,2189,2188,13,2201,55
2021-06-11,Colusa,011,21464,1960,1964,317,2281,15
2021-06-11,Contra Costa,013,1133247,70382,69940,1309,71249,808
2021-06-11,Del Norte,015,27424,1440,1409,13,1422,8
2021-06-11,El Dorado,017,186661,10384,10316,767,11083,113
2021-06-11,Fresno,019,978130,103162,102770,8759,111529,1720
2021-06-11,Glenn,021,27897,2442,2425,564,2989,19
2021-06-11,Humboldt,023,135768,4399,4389,39,4428,42
2021-06-11,Imperial,025,180216,28709,28793,2758,31551,741
2021-06-11,Inyo,027,18085,1407,1405,13,1418,35
2021-06-11,Kern,029,883053,97671,96718,11087,107805,1340
2021-06-11,Kings,031,150075,23220,23069,1097,24166,245
2021-06-11,Lake,033,64148,3565,3550,9,3559,45
2021-06-11,Lassen,035,31185,5249,5204,116,5320,18
2021-06-11,Los Angeles,037,10098052,1209342,1204259,41542,1245801,24434
2021-06-11,Madera,039,155013,16714,16582,946,17528,240
2021-06-11,Marin,041,260295,14161,14116,267,14383,229
2021-06-11,Mariposa,043,17540,438,434,11,445,5
2021-06-11,Mendocino,045,87422,4105,4022,83,4105,49
2021-06-11,Merced,047,269075,31155,31231,1061,32292,461
2021-06-11,Modoc,049,8938,399,382,140,522,3
2021-06-11,Mono,051,14174,1264,1274,17,1291,3
2021-06-11,Monterey,053,433212,43252,43097,1875,44972,415
2021-06-11,Napa,055,140530,9972,9977,38,10015,80
2021-06-11,Nevada,057,99092,4907,4873,197,5070,72
2021-06-11,Orange,059,3164182,255946,254975,11504,266479,5101
2021-06-11,Placer,061,380077,23592,23330,1525,24855,294
2021-06-11,Plumas,063,18699,714,696,11,707,4
2021-06-11,Riverside,065,2383286,294872,289376,14140,303516,4451
2021-06-11,Sacramento,067,1510023,107332,107119,1802,108921,1659
2021-06-11,San Benito,069,59416,6079,6082,116,6198,63
2021-06-11,San Bernardino,071,2135413,294072,293335,9040,302375,4788
2021-06-11,San Diego,073,3302833,281992,281144,15153,296297,3768
2021-06-11,San Francisco,075,870044,36953,37177,1305,38482,555
2021-06-11,San Joaquin,077,732212,73706,73347,3615,76962,1397
2021-06-11,San Luis Obispo,079,281455,21498,21288,752,22040,256
2021-06-11,San Mateo,081,765935,42552,42585,481,43066,542
2021-06-11,Santa Barbara,083,443738,34538,34438,1143,35581,460
2021-06-11,Santa Clara,085,1922200,119097,119860,778,120638,2083
2021-06-11,Santa Cruz,087,273765,16276,16164,813,16977,208
2021-06-11,Shasta,089,179085,12505,12550,1620,14170,201
2021-06-11,Sierra,091,2930,59,55,12,67,0
2021-06-11,Siskiyou,093,43540,1957,1882,374,2256,25
2021-06-11,Solano,095,438530,33187,33179,565,33744,266
2021-06-11,Sonoma,097,501317,30538,30624,355,30979,323
2021-06-11,Stanislaus,099,539301,56758,56617,6005,62622,974
2021-06-11,Sutter,101,95872,9563,9600,89,9689,112
2021-06-11,Tehama,103,63373,5132,5099,587,5686,63
2021-06-11,Trinity,105,12862,487,331,97,428,3
2021-06-11,Tulare,107,460477,50371,49516,9112,58628,848
2021-06-11,Tuolumne,109,53932,4054,4104,41,4145,63
2021-06-11,Ventura,111,848112,81608,81189,3019,84208,1026
2021-06-11,Yolo,113,214977,14109,14111,331,14442,212
2021-06-11,Yuba,115,75493,6137,6113,133,6246,50
2021-06-10,Alameda,001,1643700,88782,88806,1985,90791,1275
2021-06-10,Alpine,003,1148,87,88,0,88,0
2021-06-10,Amador,005,37829,3726,3709,33,3742,46
2021-06-10,Butte,007,227075,12696,12565,1844,14409,194
2021-06-10,Calaveras,009,45235,2188,2188,13,2201,55
2021-06-10,Colusa,011,21464,1958,1964,317,2281,15
2021-06-10,Contra Costa,013,1133247,70328,69876,1309,71185,807
2021-06-10,Del Norte,015,27424,1440,1405,13,1418,8
2021-06-10,El Dorado,017,186661,10377,10314,763,11077,113
2021-06-10,Fresno,019,978130,103136,102724,8758,111482,1717
2021-06-10,Glenn,021,27897,2442,2425,564,2989,19
2021-06-10,Humboldt,023,135768,4391,4384,39,4423,42
2021-06-10,Imperial,025,180216,28703,28779,2758,31537,739
2021-06-10,Inyo,027,18085,1407,1405,13,1418,35
2021-06-10,Kern,029,883053,97657,96706,11082,107788,1336
2021-06-10,Kings,031,150075,23219,23067,1097,24164,245
2021-06-10,Lake,033,64148,3560,3550,9,3559,45
2021-06-10,Lassen,035,31185,5247,5201,116,5317,18
2021-06-10,Los Angeles,037,10098052,1209176,1204110,41525,1245635,24440
2021-06-10,Madera,039,155013,16707,16581,945,17526,240
2021-06-10,Marin,041,260295,14158,14118,267,14385,229
2021-06-10,Mariposa,043,17540,436,434,11,445,5
2021-06-10,Mendocino,045,87422,4100,4016,83,4099,48
2021-06-10,Merced,047,269075,31147,31231,1058,32289,461
2021-06-10,Modoc,049,8938,398,381,140,521,3
2021-06-10,Mono,051,14174,1263,1274,17,1291,3
2021-06-10,Monterey,053,433212,43246,43090,1875,44965,415
2021-06-10,Napa,055,140530,9971,9974,38,10012,80
2021-06-10,Nevada,057,99092,4902,4866,197,5063,72
2021-06-10,Orange,059,3164182,255916,254950,11497,266447,5097
2021-06-10,Placer,061,380077,23579,23296,1525,24821,293
2021-06-10,Plumas,063,18699,714,696,11,707,4
2021-06-10,Riverside,065,2383286,294830,289335,14135,303470,4450
2021-06-10,Sacramento,067,1510023,107270,107049,1802,108851,1658
2021-06-10,San Benito,069,59416,6079,6079,116,6195,63
2021-06-10,San Bernardino,071,2135413,294031,293281,9037,302318,4782
2021-06-10,San Diego,073,3302833,281934,281052,15136,296188,3766
2021-06-10,San Francisco,075,870044,36943,37159,1303,38462,552
2021-06-10,San Joaquin,077,732212,73672,73276,3614,76890,1393
2021-06-10,San Luis Obispo,079,281455,21495,21280,752,22032,256
2021-06-10,San Mateo,081,765935,42545,42562,481,43043,666
2021-06-10,Santa Barbara,083,443738,34534,34434,1143,35577,460
2021-06-10,Santa Clara,085,1922200,119062,119832,777,120609,2075
2021-06-10,Santa Cruz,087,273765,16275,16159,813,16972,208
2021-06-10,Shasta,089,179085,12495,12536,1619,14155,201
2021-06-10,Sierra,091,2930,58,55,12,67,0
2021-06-10,Siskiyou,093,43540,1957,1881,374,2255,25
2021-06-10,Solano,095,438530,33170,33150,564,33714,265
2021-06-10,Sonoma,097,501317,30502,30571,353,30924,323
2021-06-10,Stanislaus,099,539301,56737,56588,6001,62589,974
2021-06-10,Sutter,101,95872,9556,9594,89,9683,112
2021-06-10,Tehama,103,63373,5132,5096,587,5683,63
2021-06-10,Trinity,105,12862,487,331,97,428,3
2021-06-10,Tulare,107,460477,50363,49503,9112,58615,848
2021-06-10,Tuolumne,109,53932,4054,4100,41,4141,63
2021-06-10,Ventura,111,848112,81597,81172,3018,84190,1026
2021-06-10,Yolo,113,214977,14106,14107,331,14438,212
2021-06-10,Yuba,115,75493,6133,6112,133,6245,50
2021-06-09,Alameda,001,1643700,88739,88762,1984,90746,1271
2021-06-09,Alpine,003,1148,87,88,0,88,0
2021-06-09,Amador,005,37829,3722,3706,33,3739,46
2021-06-09,Butte,007,227075,12690,12555,1842,14397,194
2021-06-09,Calaveras,009,45235,2186,2184,13,2197,55
2021-06-09,Colusa,011,21464,1958,1962,316,2278,15
2021-06-09,Contra Costa,013,1133247,70291,69829,1308,71137,803
2021-06-09,Del Norte,015,27424,1436,1403,13,1416,8
2021-06-09,El Dorado,017,186661,10374,10312,762,11074,113
2021-06-09,Fresno,019,978130,103116,102690,8754,111444,1717
2021-06-09,Glenn,021,27897,2441,2424,564,2988,19
2021-06-09,Humboldt,023,135768,4386,4379,38,4417,42
2021-06-09,Imperial,025,180216,28700,28754,2758,31512,739
2021-06-09,Inyo,027,18085,1407,1405,13,1418,35
2021-06-09,Kern,029,883053,97643,96697,11073,107770,1328
2021-06-09,Kings,031,150075,23217,23061,1097,24158,245
2021-06-09,Lake,033,64148,3557,3541,9,3550,45
2021-06-09,Lassen,035,31185,5246,5200,116,5316,18
2021-06-09,Los Angeles,037,10098052,1208990,1203955,41512,1245467,24432
2021-06-09,Madera,039,155013,16702,16580,945,17525,240
2021-06-09,Marin,041,260295,14153,14114,267,14381,229
2021-06-09,Mariposa,043,17540,436,434,11,445,5
2021-06-09,Mendocino,045,87422,4094,4008,83,4091,47
2021-06-09,Merced,047,269075,31143,31225,1058,32283,461
2021-06-09,Modoc,049,8938,396,377,139,516,3
2021-06-09,Mono,051,14174,1263,1274,17,1291,3
2021-06-09,Monterey,053,433212,43239,43082,1875,44957,415
2021-06-09,Napa,055,140530,9965,9971,38,10009,80
2021-06-09,Nevada,057,99092,4892,4863,196,5059,72
2021-06-09,Orange,059,3164182,255872,254893,11492,266385,5080
2021-06-09,Placer,061,380077,23560,23237,1525,24762,293
2021-06-09,Plumas,063,18699,713,697,11,708,4
2021-06-09,Riverside,065,2383286,294784,289299,14133,303432,4450
2021-06-09,Sacramento,067,1510023,107207,106971,1799,108770,1657
2021-06-09,San Benito,069,59416,6076,6078,116,6194,63
2021-06-09,San Bernardino,071,2135413,293989,293222,9037,302259,4782
2021-06-09,San Diego,073,3302833,281870,280941,15124,296065,3765
2021-06-09,San Francisco,075,870044,36930,37143,1302,38445,552
2021-06-09,San Joaquin,077,732212,73646,73232,3613,76845,1392
2021-06-09,San Luis Obispo,079,281455,21494,21259,752,22011,256
2021-06-09,San Mateo,081,765935,42529,42502,479,42981,666
2021-06-09,Santa Barbara,083,443738,34523,34422,1143,35565,460
2021-06-09,Santa Clara,085,1922200,119024,119793,776,120569,2068
2021-06-09,Santa Cruz,087,273765,16272,16155,813,16968,208
2021-06-09,Shasta,089,179085,12485,12521,1617,14138,201
2021-06-09,Sierra,091,2930,57,55,12,67,0
2021-06-09,Siskiyou,093,43540,1956,1871,374,2245,25
2021-06-09,Solano,095,438530,33154,33137,563,33700,264
2021-06-09,Sonoma,097,501317,30480,30540,353,30893,323
2021-06-09,Stanislaus,099,539301,56717,56560,5998,62558,974
2021-06-09,Sutter,101,95872,9547,9586,88,9674,111
2021-06-09,Tehama,103,63373,5131,5093,587,5680,63
2021-06-09,Trinity,105,12862,486,331,97,428,3
2021-06-09,Tulare,107,460477,50359,49496,9110,58606,847
2021-06-09,Tuolumne,109,53932,4051,4100,41,4141,63
2021-06-09,Ventura,111,848112,81587,81154,3017,84171,1026
2021-06-09,Yolo,113,214977,14104,14102,330,14432,212
2021-06-09,Yuba,115,75493,6129,6109,133,6242,50
2021-06-08,Alameda,001,1643700,88691,88731,1984,90715,1267
2021-06-08,Alpine,003,1148,87,88,0,88,0
2021-06-08,Amador,005,37829,3721,3704,33,3737,46
2021-06-08,Butte,007,227075,12684,12540,1840,14380,194
2021-06-08,Calaveras,009,45235,2185,2181,13,2194,55
2021-06-08,Colusa,011,21464,1958,1961,316,2277,15
2021-06-08,Contra Costa,013,1133247,70243,69762,1307,71069,803
2021-06-08,Del Norte,015,27424,1434,1402,13,1415,8
2021-06-08,El Dorado,017,186661,10369,10306,760,11066,113
2021-06-08,Fresno,019,978130,103091,102680,8752,111432,1717
2021-06-08,Glenn,021,27897,2440,2423,564,2987,19
2021-06-08,Humboldt,023,135768,4381,4363,38,4401,42
2021-06-08,Imperial,025,180216,28691,28752,2758,31510,738
2021-06-08,Inyo,027,18085,1407,1405,13,1418,35
2021-06-08,Kern,029,883053,97624,96671,11066,107737,1325
2021-06-08,Kings,031,150075,23216,23036,1097,24133,245
2021-06-08,Lake,033,64148,3556,3540,9,3549,45
2021-06-08,Lassen,035,31185,5246,5200,116,5316,18
2021-06-08,Los Angeles,037,10098052,1208792,1203794,41500,1245294,24426
2021-06-08,Madera,039,155013,16696,16579,944,17523,240
2021-06-08,Marin,041,260295,14151,14111,266,14377,229
2021-06-08,Mariposa,043,17540,436,434,11,445,5
2021-06-08,Mendocino,045,87422,4087,4002,83,4085,47
2021-06-08,Merced,047,269075,31135,31225,1058,32283,461
2021-06-08,Modoc,049,8938,390,377,138,515,3
2021-06-08,Mono,051,14174,1263,1274,17,1291,3
2021-06-08,Monterey,053,433212,43233,43078,1874,44952,415
2021-06-08,Napa,055,140530,9961,9962,38,10000,80
2021-06-08,Nevada,057,99092,4887,4861,196,5057,72
2021-06-08,Orange,059,3164182,255830,254852,11485,266337,5078
2021-06-08,Placer,061,380077,23542,23209,1521,24730,293
2021-06-08,Plumas,063,18699,713,692,11,703,4
2021-06-08,Riverside,065,2383286,294748,289268,14125,303393,4452
2021-06-08,Sacramento,067,1510023,107145,106901,1796,108697,1654
2021-06-08,San Benito,069,59416,6074,6076,116,6192,63
2021-06-08,San Bernardino,071,2135413,293940,293186,9033,302219,4778
2021-06-08,San Diego,073,3302833,281807,280879,15115,295994,3764
2021-06-08,San Francisco,075,870044,36915,37134,1301,38435,552
2021-06-08,San Joaquin,077,732212,73602,73186,3608,76794,1390
2021-06-08,San Luis Obispo,079,281455,21488,21251,751,22002,255
2021-06-08,San Mateo,081,765935,42516,42488,479,42967,663
2021-06-08,Santa Barbara,083,443738,34519,34418,1143,35561,459
2021-06-08,Santa Clara,085,1922200,119003,119770,775,120545,2068
2021-06-08,Santa Cruz,087,273765,16269,16160,813,16973,208
2021-06-08,Shasta,089,179085,12470,12498,1617,14115,201
2021-06-08,Sierra,091,2930,57,55,12,67,0
2021-06-08,Siskiyou,093,43540,1954,1870,372,2242,21
2021-06-08,Solano,095,438530,33133,33130,563,33693,259
2021-06-08,Sonoma,097,501317,30453,30523,351,30874,323
2021-06-08,Stanislaus,099,539301,56690,56548,5996,62544,973
2021-06-08,Sutter,101,95872,9544,9581,88,9669,111
2021-06-08,Tehama,103,63373,5128,5093,587,5680,63
2021-06-08,Trinity,105,12862,486,330,96,426,3
2021-06-08,Tulare,107,460477,50347,49485,9105,58590,847
2021-06-08,Tuolumne,109,53932,4048,4099,41,4140,63
2021-06-08,Ventura,111,848112,81571,81142,3016,84158,1026
2021-06-08,Yolo,113,214977,14099,14099,329,14428,212
2021-06-08,Yuba,115,75493,6127,6103,133,6236,50
2021-06-07,Alameda,001,1643700,88634,88688,1984,90672,1267
2021-06-07,Alpine,003,1148,87,88,0,88,0
2021-06-07,Amador,005,37829,3711,3697,33,3730,46
2021-06-07,Butte,007,227075,12677,12533,1839,14372,194
2021-06-07,Calaveras,009,45235,2184,2181,13,2194,55
2021-06-07,Colusa,011,21464,1957,1960,316,2276,15
2021-06-07,Contra Costa,013,1133247,70186,69718,1306,71024,817
2021-06-07,Del Norte,015,27424,1434,1401,13,1414,8
2021-06-07,El Dorado,017,186661,10364,10305,760,11065,113
2021-06-07,Fresno,019,978130,103060,102659,8744,111403,1717
2021-06-07,Glenn,021,27897,2440,2423,564,2987,19
2021-06-07,Humboldt,023,135768,4373,4354,38,4392,42
2021-06-07,Imperial,025,180216,28689,28754,2758,31512,738
2021-06-07,Inyo,027,18085,1407,1404,13,1417,35
2021-06-07,Kern,029,883053,97608,96645,11059,107704,1324
2021-06-07,Kings,031,150075,23212,23023,1097,24120,244
2021-06-07,Lake,033,64148,3554,3540,9,3549,45
2021-06-07,Lassen,035,31185,5241,5198,116,5314,18
2021-06-07,Los Angeles,037,10098052,1208568,1203664,41485,1245149,24413
2021-06-07,Madera,039,155013,16689,16572,944,17516,240
2021-06-07,Marin,041,260295,14147,14108,265,14373,229
2021-06-07,Mariposa,043,17540,436,434,11,445,5
2021-06-07,Mendocino,045,87422,4081,3998,83,4081,47
2021-06-07,Merced,047,269075,31123,31212,1057,32269,459
2021-06-07,Modoc,049,8938,389,375,135,510,3
2021-06-07,Mono,051,14174,1263,1275,17,1292,3
2021-06-07,Monterey,053,433212,43226,43077,1874,44951,415
2021-06-07,Napa,055,140530,9953,9962,38,10000,80
2021-06-07,Nevada,057,99092,4885,4860,196,5056,72
2021-06-07,Orange,059,3164182,255790,254808,11477,266285,5073
2021-06-07,Placer,061,380077,23523,23176,1519,24695,293
2021-06-07,Plumas,063,18699,713,692,11,703,4
2021-06-07,Riverside,065,2383286,294705,289232,14121,303353,4451
2021-06-07,Sacramento,067,1510023,107069,106841,1793,108634,1655
2021-06-07,San Benito,069,59416,6073,6074,116,6190,63
2021-06-07,San Bernardino,071,2135413,293902,293129,9032,302161,4775
2021-06-07,San Diego,073,3302833,281725,280808,15102,295910,3764
2021-06-07,San Francisco,075,870044,36899,37122,1301,38423,552
2021-06-07,San Joaquin,077,732212,73557,73130,3601,76731,1388
2021-06-07,San Luis Obispo,079,281455,21475,21252,751,22003,255
2021-06-07,San Mateo,081,765935,42500,42479,479,42958,664
2021-06-07,Santa Barbara,083,443738,34513,34407,1143,35550,459
2021-06-07,Santa Clara,085,1922200,118971,119743,775,120518,2066
2021-06-07,Santa Cruz,087,273765,16268,16159,813,16972,208
2021-06-07,Shasta,089,179085,12456,12483,1612,14095,200
2021-06-07,Sierra,091,2930,57,55,12,67,0
2021-06-07,Siskiyou,093,43540,1954,1869,372,2241,21
2021-06-07,Solano,095,438530,33111,33124,562,33686,258
2021-06-07,Sonoma,097,501317,30417,30504,350,30854,323
2021-06-07,Stanislaus,099,539301,56657,56521,5994,62515,972
2021-06-07,Sutter,101,95872,9540,9571,88,9659,111
2021-06-07,Tehama,103,63373,5124,5092,585,5677,63
2021-06-07,Trinity,105,12862,486,329,96,425,3
2021-06-07,Tulare,107,460477,50341,49471,9105,58576,847
2021-06-07,Tuolumne,109,53932,4047,4098,41,4139,63
2021-06-07,Ventura,111,848112,81554,81137,3014,84151,1025
2021-06-07,Yolo,113,214977,14094,14097,328,14425,211
2021-06-07,Yuba,115,75493,6125,6099,130,6229,49
2021-06-06,Alameda,001,1643700,88596,88636,1983,90619,1267
2021-06-06,Alpine,003,1148,87,88,0,88,0
2021-06-06,Amador,005,37829,3708,3696,33,3729,46
2021-06-06,Butte,007,227075,12666,12527,1838,14365,194
2021-06-06,Calaveras,009,45235,2183,2181,13,2194,55
2021-06-06,Colusa,011,21464,1955,1959,316,2275,15
2021-06-06,Contra Costa,013,1133247,70121,69659,1304,70963,817
2021-06-06,Del Norte,015,27424,1429,1401,13,1414,8
2021-06-06,El Dorado,017,186661,10357,10294,760,11054,113
2021-06-06,Fresno,019,978130,103027,102642,8741,111383,1717
2021-06-06,Glenn,021,27897,2439,2423,564,2987,19
2021-06-06,Humboldt,023,135768,4362,4353,38,4391,42
2021-06-06,Imperial,025,180216,28683,28762,2758,31520,738
2021-06-06,Inyo,027,18085,1406,1404,13,1417,35
2021-06-06,Kern,029,883053,97590,96623,11052,107675,1324
2021-06-06,Kings,031,150075,23206,23021,1097,24118,244
2021-06-06,Lake,033,64148,3554,3535,9,3544,45
2021-06-06,Lassen,035,31185,5239,5191,116,5307,18
2021-06-06,Los Angeles,037,10098052,1208366,1203539,41471,1245010,24410
2021-06-06,Madera,039,155013,16682,16567,944,17511,240
2021-06-06,Marin,041,260295,14141,14106,264,14370,229
2021-06-06,Mariposa,043,17540,435,435,11,446,5
2021-06-06,Mendocino,045,87422,4077,3993,83,4076,47
2021-06-06,Merced,047,269075,31117,31215,1056,32271,459
2021-06-06,Modoc,049,8938,389,375,134,509,3
2021-06-06,Mono,051,14174,1263,1275,17,1292,3
2021-06-06,Monterey,053,433212,43221,43078,1874,44952,415
2021-06-06,Napa,055,140530,9947,9963,38,10001,80
2021-06-06,Nevada,057,99092,4878,4854,195,5049,72
2021-06-06,Orange,059,3164182,255754,254782,11472,266254,5073
2021-06-06,Placer,061,380077,23498,23156,1516,24672,293
2021-06-06,Plumas,063,18699,713,692,11,703,4
2021-06-06,Riverside,065,2383286,294666,289201,14115,303316,4451
2021-06-06,Sacramento,067,1510023,106983,106749,1792,108541,1655
2021-06-06,San Benito,069,59416,6067,6074,116,6190,63
2021-06-06,San Bernardino,071,2135413,293845,293117,9023,302140,4773
2021-06-06,San Diego,073,3302833,281645,280743,15085,295828,3764
2021-06-06,San Francisco,075,870044,36886,37118,1299,38417,552
2021-06-06,San Joaquin,077,732212,73525,73105,3597,76702,1388
2021-06-06,San Luis Obispo,079,281455,21472,21246,751,21997,255
2021-06-06,San Mateo,081,765935,42483,42457,479,42936,664
2021-06-06,Santa Barbara,083,443738,34509,34403,1142,35545,459
2021-06-06,Santa Clara,085,1922200,118949,119711,775,120486,2066
2021-06-06,Santa Cruz,087,273765,16267,16158,813,16971,208
2021-06-06,Shasta,089,179085,12441,12478,1609,14087,200
2021-06-06,Sierra,091,2930,57,55,12,67,0
2021-06-06,Siskiyou,093,43540,1951,1869,372,2241,21
2021-06-06,Solano,095,438530,33084,33093,562,33655,258
2021-06-06,Sonoma,097,501317,30386,30478,349,30827,323
2021-06-06,Stanislaus,099,539301,56621,56486,5991,62477,972
2021-06-06,Sutter,101,95872,9533,9567,88,9655,111
2021-06-06,Tehama,103,63373,5114,5092,583,5675,63
2021-06-06,Trinity,105,12862,486,328,96,424,3
2021-06-06,Tulare,107,460477,50333,49466,9100,58566,847
2021-06-06,Tuolumne,109,53932,4045,4097,41,4138,63
2021-06-06,Ventura,111,848112,81543,81130,3011,84141,1025
2021-06-06,Yolo,113,214977,14086,14089,327,14416,210
2021-06-06,Yuba,115,75493,6117,6096,130,6226,49
2021-06-05,Alameda,001,1643700,88563,88612,1983,90595,1268
2021-06-05,Alpine,003,1148,87,88,0,88,0
2021-06-05,Amador,005,37829,3708,3694,33,3727,46
2021-06-05,Butte,007,227075,12660,12514,1837,14351,194
2021-06-05,Calaveras,009,45235,2183,2181,13,2194,55
2021-06-05,Colusa,011,21464,1955,1959,316,2275,15
2021-06-05,Contra Costa,013,1133247,70092,69601,1304,70905,817
2021-06-05,Del Norte,015,27424,1429,1400,13,1413,8
2021-06-05,El Dorado,017,186661,10355,10288,759,11047,113
2021-06-05,Fresno,019,978130,103018,102626,8741,111367,1717
2021-06-05,Glenn,021,27897,2438,2423,564,2987,19
2021-06-05,Humboldt,023,135768,4357,4346,38,4384,42
2021-06-05,Imperial,025,180216,28680,28764,2758,31522,738
2021-06-05,Inyo,027,18085,1406,1405,13,1418,35
2021-06-05,Kern,029,883053,97577,96597,11048,107645,1324
2021-06-05,Kings,031,150075,23203,23017,1097,24114,244
2021-06-05,Lake,033,64148,3551,3534,9,3543,45
2021-06-05,Lassen,035,31185,5238,5191,116,5307,18
2021-06-05,Los Angeles,037,10098052,1208238,1203338,41460,1244798,24411
2021-06-05,Madera,039,155013,16678,16563,944,17507,240
2021-06-05,Marin,041,260295,14139,14101,264,14365,229
2021-06-05,Mariposa,043,17540,435,435,11,446,5
2021-06-05,Mendocino,045,87422,4074,3989,83,4072,47
2021-06-05,Merced,047,269075,31115,31212,1055,32267,459
2021-06-05,Modoc,049,8938,389,375,133,508,3
2021-06-05,Mono,051,14174,1263,1274,17,1291,3
2021-06-05,Monterey,053,433212,43217,43071,1873,44944,415
2021-06-05,Napa,055,140530,9942,9960,38,9998,80
2021-06-05,Nevada,057,99092,4876,4849,195,5044,72
2021-06-05,Orange,059,3164182,255730,254752,11469,266221,5069
2021-06-05,Placer,061,380077,23482,23133,1516,24649,293
2021-06-05,Plumas,063,18699,713,692,11,703,4
2021-06-05,Riverside,065,2383286,294631,289157,14111,303268,4451
2021-06-05,Sacramento,067,1510023,106931,106688,1790,108478,1655
2021-06-05,San Benito,069,59416,6065,6074,116,6190,63
2021-06-05,San Bernardino,071,2135413,293812,293081,9021,302102,4772
2021-06-05,San Diego,073,3302833,281604,280676,15072,295748,3764
2021-06-05,San Francisco,075,870044,36877,37111,1299,38410,552
2021-06-05,San Joaquin,077,732212,73509,73078,3591,76669,1388
2021-06-05,San Luis Obispo,079,281455,21469,21236,751,21987,255
2021-06-05,San Mateo,081,765935,42473,42433,479,42912,664
2021-06-05,Santa Barbara,083,443738,34506,34399,1141,35540,459
2021-06-05,Santa Clara,085,1922200,118927,119676,773,120449,2066
2021-06-05,Santa Cruz,087,273765,16267,16154,813,16967,208
2021-06-05,Shasta,089,179085,12431,12472,1608,14080,200
2021-06-05,Sierra,091,2930,57,55,12,67,0
2021-06-05,Siskiyou,093,43540,1951,1867,372,2239,21
2021-06-05,Solano,095,438530,33069,33074,562,33636,257
2021-06-05,Sonoma,097,501317,30359,30450,347,30797,323
2021-06-05,Stanislaus,099,539301,56613,56463,5989,62452,973
2021-06-05,Sutter,101,95872,9530,9559,88,9647,111
2021-06-05,Tehama,103,63373,5113,5092,582,5674,63
2021-06-05,Trinity,105,12862,486,328,96,424,3
2021-06-05,Tulare,107,460477,50327,49463,9100,58563,847
2021-06-05,Tuolumne,109,53932,4043,4098,41,4139,63
2021-06-05,Ventura,111,848112,81534,81119,3009,84128,1025
2021-06-05,Yolo,113,214977,14084,14088,327,14415,210
2021-06-05,Yuba,115,75493,6116,6087,130,6217,49
2021-06-04,Alameda,001,1643700,88536,88585,1980,90565,1263
2021-06-04,Alpine,003,1148,87,88,0,88,0
2021-06-04,Amador,005,37829,3708,3690,33,3723,46
2021-06-04,Butte,007,227075,12649,12494,1834,14328,193
2021-06-04,Calaveras,009,45235,2183,2179,13,2192,55
2021-06-04,Colusa,011,21464,1955,1959,316,2275,15
2021-06-04,Contra Costa,013,1133247,70057,69540,1301,70841,816
2021-06-04,Del Norte,015,27424,1429,1398,13,1411,8
2021-06-04,El Dorado,017,186661,10351,10284,757,11041,112
2021-06-04,Fresno,019,978130,103002,102601,8741,111342,1712
2021-06-04,Glenn,021,27897,2438,2423,563,2986,19
2021-06-04,Humboldt,023,135768,4352,4327,38,4365,42
2021-06-04,Imperial,025,180216,28676,28753,2758,31511,738
2021-06-04,Inyo,027,18085,1406,1404,13,1417,35
2021-06-04,Kern,029,883053,97559,96573,11046,107619,1327
2021-06-04,Kings,031,150075,23202,23002,1097,24099,244
2021-06-04,Lake,033,64148,3549,3528,9,3537,45
2021-06-04,Lassen,035,31185,5238,5180,116,5296,18
2021-06-04,Los Angeles,037,10098052,1208114,1203106,41451,1244557,24400
2021-06-04,Madera,039,155013,16676,16557,944,17501,240
2021-06-04,Marin,041,260295,14138,14099,263,14362,229
2021-06-04,Mariposa,043,17540,435,435,11,446,5
2021-06-04,Mendocino,045,87422,4065,3983,83,4066,47
2021-06-04,Merced,047,269075,31110,31204,1054,32258,459
2021-06-04,Modoc,049,8938,387,375,133,508,3
2021-06-04,Mono,051,14174,1263,1275,17,1292,3
2021-06-04,Monterey,053,433212,43213,43068,1873,44941,415
2021-06-04,Napa,055,140530,9938,9958,38,9996,80
2021-06-04,Nevada,057,99092,4872,4844,195,5039,72
2021-06-04,Orange,059,3164182,255693,254730,11465,266195,5059
2021-06-04,Placer,061,380077,23466,23110,1515,24625,293
2021-06-04,Plumas,063,18699,713,691,11,702,4
2021-06-04,Riverside,065,2383286,294605,289098,14107,303205,4452
2021-06-04,Sacramento,067,1510023,106877,106616,1789,108405,1654
2021-06-04,San Benito,069,59416,6063,6073,116,6189,63
2021-06-04,San Bernardino,071,2135413,293788,293056,9019,302075,4768
2021-06-04,San Diego,073,3302833,281561,280556,15065,295621,3763
2021-06-04,San Francisco,075,870044,36872,37079,1298,38377,551
2021-06-04,San Joaquin,077,732212,73490,73039,3589,76628,1388
2021-06-04,San Luis Obispo,079,281455,21466,21234,750,21984,255
2021-06-04,San Mateo,081,765935,42461,42413,479,42892,478
2021-06-04,Santa Barbara,083,443738,34500,34402,1140,35542,459
2021-06-04,Santa Clara,085,1922200,118897,119619,773,120392,2065
2021-06-04,Santa Cruz,087,273765,16264,16150,813,16963,207
2021-06-04,Shasta,089,179085,12425,12458,1603,14061,200
2021-06-04,Sierra,091,2930,57,55,12,67,0
2021-06-04,Siskiyou,093,43540,1950,1865,372,2237,21
2021-06-04,Solano,095,438530,33058,33058,562,33620,256
2021-06-04,Sonoma,097,501317,30338,30411,347,30758,323
2021-06-04,Stanislaus,099,539301,56598,56442,5987,62429,973
2021-06-04,Sutter,101,95872,9525,9554,88,9642,111
2021-06-04,Tehama,103,63373,5108,5090,582,5672,63
2021-06-04,Trinity,105,12862,486,328,96,424,3
2021-06-04,Tulare,107,460477,50318,49452,9098,58550,847
2021-06-04,Tuolumne,109,53932,4042,4095,41,4136,63
2021-06-04,Ventura,111,848112,81527,81104,3007,84111,1023
2021-06-04,Yolo,113,214977,14082,14083,327,14410,210
2021-06-04,Yuba,115,75493,6113,6084,130,6214,49
2021-06-03,Alameda,001,1643700,88498,88555,1977,90532,1257
2021-06-03,Alpine,003,1148,87,88,0,88,0
2021-06-03,Amador,005,37829,3700,3688,33,3721,46
2021-06-03,Butte,007,227075,12645,12478,1833,14311,193
2021-06-03,Calaveras,009,45235,2183,2179,13,2192,55
2021-06-03,Colusa,011,21464,1955,1957,316,2273,15
2021-06-03,Contra Costa,013,1133247,70003,69500,1296,70796,816
2021-06-03,Del Norte,015,27424,1427,1397,13,1410,8
2021-06-03,El Dorado,017,186661,10345,10284,754,11038,112
2021-06-03,Fresno,019,978130,102985,102566,8741,111307,1709
2021-06-03,Glenn,021,27897,2438,2421,563,2984,19
2021-06-03,Humboldt,023,135768,4344,4314,38,4352,42
2021-06-03,Imperial,025,180216,28665,28737,2758,31495,738
2021-06-03,Inyo,027,18085,1406,1404,13,1417,35
2021-06-03,Kern,029,883053,97532,96507,11032,107539,1326
2021-06-03,Kings,031,150075,23198,22982,1097,24079,244
2021-06-03,Lake,033,64148,3547,3526,9,3535,45
2021-06-03,Lassen,035,31185,5229,5177,116,5293,12
2021-06-03,Los Angeles,037,10098052,1207938,1202923,41443,1244366,24386
2021-06-03,Madera,039,155013,16669,16554,944,17498,240
2021-06-03,Marin,041,260295,14133,14095,263,14358,230
2021-06-03,Mariposa,043,17540,435,435,11,446,5
2021-06-03,Mendocino,045,87422,4058,3978,83,4061,47
2021-06-03,Merced,047,269075,31107,31199,1054,32253,459
2021-06-03,Modoc,049,8938,386,376,132,508,3
2021-06-03,Mono,051,14174,1263,1275,17,1292,3
2021-06-03,Monterey,053,433212,43210,43063,1873,44936,415
2021-06-03,Napa,055,140530,9931,9957,38,9995,81
2021-06-03,Nevada,057,99092,4868,4837,195,5032,72
2021-06-03,Orange,059,3164182,255665,254676,11455,266131,5056
2021-06-03,Placer,061,380077,23457,23100,1514,24614,293
2021-06-03,Plumas,063,18699,713,691,11,702,4
2021-06-03,Riverside,065,2383286,294550,289035,14103,303138,4447
2021-06-03,Sacramento,067,1510023,106798,106526,1787,108313,1654
2021-06-03,San Benito,069,59416,6063,6073,116,6189,63
2021-06-03,San Bernardino,071,2135413,293756,293021,9019,302040,4762
2021-06-03,San Diego,073,3302833,281497,280430,15055,295485,3761
2021-06-03,San Francisco,075,870044,36866,37072,1298,38370,551
2021-06-03,San Joaquin,077,732212,73462,72989,3585,76574,1388
2021-06-03,San Luis Obispo,079,281455,21461,21224,750,21974,255
2021-06-03,San Mateo,081,765935,42448,42396,479,42875,467
2021-06-03,Santa Barbara,083,443738,34497,34391,1140,35531,459
2021-06-03,Santa Clara,085,1922200,118875,119592,771,120363,2058
2021-06-03,Santa Cruz,087,273765,16262,16144,813,16957,207
2021-06-03,Shasta,089,179085,12410,12441,1600,14041,199
2021-06-03,Sierra,091,2930,57,55,12,67,0
2021-06-03,Siskiyou,093,43540,1950,1862,371,2233,21
2021-06-03,Solano,095,438530,33044,33019,562,33581,256
2021-06-03,Sonoma,097,501317,30316,30383,346,30729,322
2021-06-03,Stanislaus,099,539301,56579,56401,5981,62382,973
2021-06-03,Sutter,101,95872,9516,9539,88,9627,111
2021-06-03,Tehama,103,63373,5108,5087,582,5669,63
2021-06-03,Trinity,105,12862,486,328,96,424,3
2021-06-03,Tulare,107,460477,50315,49442,9094,58536,848
2021-06-03,Tuolumne,109,53932,4040,4095,41,4136,63
2021-06-03,Ventura,111,848112,81515,81078,3005,84083,1023
2021-06-03,Yolo,113,214977,14078,14078,324,14402,210
2021-06-03,Yuba,115,75493,6106,6077,130,6207,49
2021-06-02,Alameda,001,1643700,88453,88525,1975,90500,1254
2021-06-02,Alpine,003,1148,87,88,0,88,0
2021-06-02,Amador,005,37829,3698,3687,33,3720,46
2021-06-02,Butte,007,227075,12625,12432,1830,14262,193
2021-06-02,Calaveras,009,45235,2180,2174,13,2187,55
2021-06-02,Colusa,011,21464,1954,1957,316,2273,15
2021-06-02,Contra Costa,013,1133247,69952,69455,1294,70749,814
2021-06-02,Del Norte,015,27424,1425,1395,13,1408,8
2021-06-02,El Dorado,017,186661,10341,10275,754,11029,110
2021-06-02,Fresno,019,978130,102961,102547,8738,111285,1707
2021-06-02,Glenn,021,27897,2438,2421,563,2984,19
2021-06-02,Humboldt,023,135768,4329,4302,38,4340,42
2021-06-02,Imperial,025,180216,28659,28737,2757,31494,738
2021-06-02,Inyo,027,18085,1405,1403,13,1416,35
2021-06-02,Kern,029,883053,97505,96481,11025,107506,1326
2021-06-02,Kings,031,150075,23196,22981,1096,24077,244
2021-06-02,Lake,033,64148,3542,3522,9,3531,45
2021-06-02,Lassen,035,31185,5228,5177,116,5293,6
2021-06-02,Los Angeles,037,10098052,1207734,1202760,41434,1244194,24375
2021-06-02,Madera,039,155013,16661,16550,944,17494,240
2021-06-02,Marin,041,260295,14131,14091,262,14353,229
2021-06-02,Mariposa,043,17540,435,434,11,445,5
2021-06-02,Mendocino,045,87422,4052,3970,83,4053,47
2021-06-02,Merced,047,269075,31094,31195,1053,32248,458
2021-06-02,Modoc,049,8938,385,375,131,506,3
2021-06-02,Mono,051,14174,1263,1275,17,1292,3
2021-06-02,Monterey,053,433212,43208,43056,1873,44929,380
2021-06-02,Napa,055,140530,9930,9953,38,9991,82
2021-06-02,Nevada,057,99092,4865,4833,195,5028,72
2021-06-02,Orange,059,3164182,255616,254637,11448,266085,5055
2021-06-02,Placer,061,380077,23436,23058,1512,24570,293
2021-06-02,Plumas,063,18699,713,690,11,701,4
2021-06-02,Riverside,065,2383286,294492,289012,14093,303105,4445
2021-06-02,Sacramento,067,1510023,106733,106435,1781,108216,1649
2021-06-02,San Benito,069,59416,6062,6073,116,6189,63
2021-06-02,San Bernardino,071,2135413,293708,293004,9014,302018,4760
2021-06-02,San Diego,073,3302833,281417,280347,15034,295381,3760
2021-06-02,San Francisco,075,870044,36846,37050,1297,38347,550
2021-06-02,San Joaquin,077,732212,73431,72893,3582,76475,1387
2021-06-02,San Luis Obispo,079,281455,21454,21214,749,21963,255
2021-06-02,San Mateo,081,765935,42438,42383,478,42861,464
2021-06-02,Santa Barbara,083,443738,34490,34381,1140,35521,456
2021-06-02,Santa Clara,085,1922200,118847,119553,770,120323,2058
2021-06-02,Santa Cruz,087,273765,16259,16144,813,16957,207
2021-06-02,Shasta,089,179085,12392,12426,1595,14021,199
2021-06-02,Sierra,091,2930,57,55,12,67,0
2021-06-02,Siskiyou,093,43540,1950,1861,369,2230,21
2021-06-02,Solano,095,438530,33032,33007,561,33568,256
2021-06-02,Sonoma,097,501317,30297,30359,341,30700,322
2021-06-02,Stanislaus,099,539301,56561,56377,5976,62353,973
2021-06-02,Sutter,101,95872,9513,9533,88,9621,111
2021-06-02,Tehama,103,63373,5105,5081,582,5663,63
2021-06-02,Trinity,105,12862,484,328,96,424,3
2021-06-02,Tulare,107,460477,50306,49434,9090,58524,846
2021-06-02,Tuolumne,109,53932,4039,4095,41,4136,63
2021-06-02,Ventura,111,848112,81490,81033,3005,84038,1020
2021-06-02,Yolo,113,214977,14075,14074,323,14397,210
2021-06-02,Yuba,115,75493,6100,6072,130,6202,48
2021-06-01,Alameda,001,1643700,88418,88472,1973,90445,1253
2021-06-01,Alpine,003,1148,87,88,0,88,0
2021-06-01,Amador,005,37829,3696,3687,33,3720,46
2021-06-01,Butte,007,227075,12611,12427,1829,14256,193
2021-06-01,Calaveras,009,45235,2178,2173,13,2186,55
2021-06-01,Colusa,011,21464,1953,1955,315,2270,15
2021-06-01,Contra Costa,013,1133247,69894,69404,1294,70698,813
2021-06-01,Del Norte,015,27424,1424,1394,13,1407,8
2021-06-01,El Dorado,017,186661,10335,10271,754,11025,110
2021-06-01,Fresno,019,978130,102937,102534,8735,111269,1706
2021-06-01,Glenn,021,27897,2438,2422,563,2985,18
2021-06-01,Humboldt,023,135768,4319,4299,38,4337,42
2021-06-01,Imperial,025,180216,28655,28722,2755,31477,736
2021-06-01,Inyo,027,18085,1405,1403,13,1416,35
2021-06-01,Kern,029,883053,97478,96477,11017,107494,1319
2021-06-01,Kings,031,150075,23192,22977,1096,24073,244
2021-06-01,Lake,033,64148,3541,3523,9,3532,45
2021-06-01,Lassen,035,31185,5221,5172,116,5288,6
2021-06-01,Los Angeles,037,10098052,1207499,1202673,41421,1244094,24367
2021-06-01,Madera,039,155013,16652,16549,943,17492,240
2021-06-01,Marin,041,260295,14129,14081,262,14343,229
2021-06-01,Mariposa,043,17540,435,431,11,442,5
2021-06-01,Mendocino,045,87422,4045,3966,83,4049,47
2021-06-01,Merced,047,269075,31084,31195,1053,32248,456
2021-06-01,Modoc,049,8938,383,375,131,506,3
2021-06-01,Mono,051,14174,1263,1275,17,1292,3
2021-06-01,Monterey,053,433212,43202,43051,1873,44924,379
2021-06-01,Napa,055,140530,9928,9949,38,9987,82
2021-06-01,Nevada,057,99092,4860,4825,194,5019,72
2021-06-01,Orange,059,3164182,255580,254603,11440,266043,5051
2021-06-01,Placer,061,380077,23406,23021,1510,24531,293
2021-06-01,Plumas,063,18699,712,690,11,701,4
2021-06-01,Riverside,065,2383286,294439,288996,14087,303083,4442
2021-06-01,Sacramento,067,1510023,106661,106330,1779,108109,1644
2021-06-01,San Benito,069,59416,6061,6073,115,6188,63
2021-06-01,San Bernardino,071,2135413,293683,292990,9013,302003,4758
2021-06-01,San Diego,073,3302833,281313,280305,15017,295322,3756
2021-06-01,San Francisco,075,870044,36830,37031,1297,38328,550
2021-06-01,San Joaquin,077,732212,73399,72858,3580,76438,1383
2021-06-01,San Luis Obispo,079,281455,21449,21217,749,21966,256
2021-06-01,San Mateo,081,765935,42422,42383,477,42860,462
2021-06-01,Santa Barbara,083,443738,34486,34374,1140,35514,456
2021-06-01,Santa Clara,085,1922200,118819,119528,770,120298,2057
2021-06-01,Santa Cruz,087,273765,16255,16143,812,16955,207
2021-06-01,Shasta,089,179085,12383,12409,1590,13999,199
2021-06-01,Sierra,091,2930,57,55,12,67,0
2021-06-01,Siskiyou,093,43540,1943,1860,368,2228,21
2021-06-01,Solano,095,438530,33007,32974,560,33534,256
2021-06-01,Sonoma,097,501317,30258,30324,340,30664,322
2021-06-01,Stanislaus,099,539301,56545,56348,5974,62322,973
2021-06-01,Sutter,101,95872,9506,9528,88,9616,111
2021-06-01,Tehama,103,63373,5103,5079,582,5661,63
2021-06-01,Trinity,105,12862,483,328,95,423,3
2021-06-01,Tulare,107,460477,50298,49419,9086,58505,845
2021-06-01,Tuolumne,109,53932,4039,4094,41,4135,63
2021-06-01,Ventura,111,848112,81474,81018,3004,84022,1021
2021-06-01,Yolo,113,214977,14069,14067,323,14390,210
2021-06-01,Yuba,115,75493,6096,6067,130,6197,48
2021-05-31,Alameda,001,1643700,88382,88458,1969,90427,1253
2021-05-31,Alpine,003,1148,87,88,0,88,0
2021-05-31,Amador,005,37829,3690,3687,33,3720,46
2021-05-31,Butte,007,227075,12598,12429,1829,14258,193
2021-05-31,Calaveras,009,45235,2177,2171,13,2184,55
2021-05-31,Colusa,011,21464,1953,1956,314,2270,15
2021-05-31,Contra Costa,013,1133247,69857,69390,1292,70682,813
2021-05-31,Del Norte,015,27424,1421,1394,13,1407,8
2021-05-31,El Dorado,017,186661,10329,10271,752,11023,110
2021-05-31,Fresno,019,978130,102900,102507,8735,111242,1706
2021-05-31,Glenn,021,27897,2437,2422,562,2984,18
2021-05-31,Humboldt,023,135768,4307,4295,38,4333,42
2021-05-31,Imperial,025,180216,28649,28732,2752,31484,736
2021-05-31,Inyo,027,18085,1404,1403,13,1416,35
2021-05-31,Kern,029,883053,97442,96457,11008,107465,1319
2021-05-31,Kings,031,150075,23188,22977,1096,24073,244
2021-05-31,Lake,033,64148,3536,3523,9,3532,45
2021-05-31,Lassen,035,31185,5219,5172,115,5287,6
2021-05-31,Los Angeles,037,10098052,1207254,1202567,41413,1243980,24364
2021-05-31,Madera,039,155013,16651,16543,942,17485,240
2021-05-31,Marin,041,260295,14127,14080,262,14342,229
2021-05-31,Mariposa,043,17540,435,430,11,441,5
2021-05-31,Mendocino,045,87422,4035,3961,83,4044,47
2021-05-31,Merced,047,269075,31079,31194,1053,32247,456
2021-05-31,Modoc,049,8938,382,374,131,505,3
2021-05-31,Mono,051,14174,1263,1275,17,1292,3
2021-05-31,Monterey,053,433212,43198,43051,1873,44924,379
2021-05-31,Napa,055,140530,9921,9948,38,9986,82
2021-05-31,Nevada,057,99092,4850,4823,193,5016,72
2021-05-31,Orange,059,3164182,255552,254572,11432,266004,5051
2021-05-31,Placer,061,380077,23379,23019,1506,24525,293
2021-05-31,Plumas,063,18699,711,690,11,701,4
2021-05-31,Riverside,065,2383286,294382,288970,14075,303045,4442
2021-05-31,Sacramento,067,1510023,106564,106278,1773,108051,1644
2021-05-31,San Benito,069,59416,6061,6072,115,6187,63
2021-05-31,San Bernardino,071,2135413,293635,292973,9012,301985,4758
2021-05-31,San Diego,073,3302833,281209,280254,15005,295259,3756
2021-05-31,San Francisco,075,870044,36815,37022,1296,38318,550
2021-05-31,San Joaquin,077,732212,73350,72856,3574,76430,1383
2021-05-31,San Luis Obispo,079,281455,21441,21215,749,21964,256
2021-05-31,San Mateo,081,765935,42406,42389,477,42866,442
2021-05-31,Santa Barbara,083,443738,34473,34369,1138,35507,456
2021-05-31,Santa Clara,085,1922200,118775,119515,770,120285,2057
2021-05-31,Santa Cruz,087,273765,16252,16139,812,16951,207
2021-05-31,Shasta,089,179085,12367,12408,1587,13995,199
2021-05-31,Sierra,091,2930,57,55,12,67,0
2021-05-31,Siskiyou,093,43540,1942,1856,367,2223,21
2021-05-31,Solano,095,438530,32957,32973,560,33533,256
2021-05-31,Sonoma,097,501317,30215,30314,340,30654,322
2021-05-31,Stanislaus,099,539301,56503,56335,5971,62306,973
2021-05-31,Sutter,101,95872,9487,9523,88,9611,111
2021-05-31,Tehama,103,63373,5100,5076,581,5657,63
2021-05-31,Trinity,105,12862,483,328,95,423,3
2021-05-31,Tulare,107,460477,50287,49404,9081,58485,845
2021-05-31,Tuolumne,109,53932,4037,4095,41,4136,63
2021-05-31,Ventura,111,848112,81459,81017,3001,84018,1021
2021-05-31,Yolo,113,214977,14065,14064,323,14387,210
2021-05-31,Yuba,115,75493,6090,6063,127,6190,48
2021-05-30,Alameda,001,1643700,88359,88429,1969,90398,1253
2021-05-30,Alpine,003,1148,87,88,0,88,0
2021-05-30,Amador,005,37829,3686,3685,33,3718,46
2021-05-30,Butte,007,227075,12588,12427,1827,14254,190
2021-05-30,Calaveras,009,45235,2173,2166,13,2179,55
2021-05-30,Colusa,011,21464,1953,1954,314,2268,15
2021-05-30,Contra Costa,013,1133247,69823,69381,1290,70671,813
2021-05-30,Del Norte,015,27424,1420,1393,13,1406,8
2021-05-30,El Dorado,017,186661,10326,10271,752,11023,110
2021-05-30,Fresno,019,978130,102883,102499,8731,111230,1706
2021-05-30,Glenn,021,27897,2437,2422,561,2983,18
2021-05-30,Humboldt,023,135768,4299,4291,38,4329,42
2021-05-30,Imperial,025,180216,28645,28732,2751,31483,736
2021-05-30,Inyo,027,18085,1404,1403,13,1416,35
2021-05-30,Kern,029,883053,97426,96443,11005,107448,1319
2021-05-30,Kings,031,150075,23187,22974,1095,24069,244
2021-05-30,Lake,033,64148,3536,3517,9,3526,45
2021-05-30,Lassen,035,31185,5217,5171,115,5286,6
2021-05-30,Los Angeles,037,10098052,1207142,1202425,41406,1243831,24360
2021-05-30,Madera,039,155013,16647,16538,942,17480,240
2021-05-30,Marin,041,260295,14123,14083,261,14344,229
2021-05-30,Mariposa,043,17540,435,430,11,441,5
2021-05-30,Mendocino,045,87422,4028,3955,83,4038,47
2021-05-30,Merced,047,269075,31075,31189,1052,32241,456
2021-05-30,Modoc,049,8938,382,374,131,505,3
2021-05-30,Mono,051,14174,1263,1275,17,1292,3
2021-05-30,Monterey,053,433212,43195,43049,1873,44922,379
2021-05-30,Napa,055,140530,9920,9948,38,9986,82
2021-05-30,Nevada,057,99092,4844,4818,193,5011,72
2021-05-30,Orange,059,3164182,255529,254559,11431,265990,5051
2021-05-30,Placer,061,380077,23373,23016,1506,24522,293
2021-05-30,Plumas,063,18699,709,690,11,701,4
2021-05-30,Riverside,065,2383286,294361,288961,14073,303034,4442
2021-05-30,Sacramento,067,1510023,106519,106252,1771,108023,1644
2021-05-30,San Benito,069,59416,6061,6072,115,6187,63
2021-05-30,San Bernardino,071,2135413,293609,292981,9011,301992,4758
2021-05-30,San Diego,073,3302833,281153,280209,15000,295209,3756
2021-05-30,San Francisco,075,870044,36796,37016,1296,38312,550
2021-05-30,San Joaquin,077,732212,73333,72853,3573,76426,1383
2021-05-30,San Luis Obispo,079,281455,21432,21211,748,21959,256
2021-05-30,San Mateo,081,765935,42398,42386,477,42863,439
2021-05-30,Santa Barbara,083,443738,34469,34369,1138,35507,456
2021-05-30,Santa Clara,085,1922200,118753,119510,766,120276,2057
2021-05-30,Santa Cruz,087,273765,16250,16140,812,16952,207
2021-05-30,Shasta,089,179085,12365,12408,1584,13992,199
2021-05-30,Sierra,091,2930,57,55,12,67,0
2021-05-30,Siskiyou,093,43540,1942,1856,367,2223,21
2021-05-30,Solano,095,438530,32946,32952,559,33511,256
2021-05-30,Sonoma,097,501317,30198,30310,339,30649,322
2021-05-30,Stanislaus,099,539301,56492,56323,5970,62293,973
2021-05-30,Sutter,101,95872,9486,9519,87,9606,111
2021-05-30,Tehama,103,63373,5100,5073,581,5654,63
2021-05-30,Trinity,105,12862,483,328,95,423,3
2021-05-30,Tulare,107,460477,50280,49397,9073,58470,845
2021-05-30,Tuolumne,109,53932,4037,4094,41,4135,63
2021-05-30,Ventura,111,848112,81455,81012,3000,84012,1021
2021-05-30,Yolo,113,214977,14060,14059,322,14381,210
2021-05-30,Yuba,115,75493,6083,6063,126,6189,48
2021-05-29,Alameda,001,1643700,88336,88433,1967,90400,1253
2021-05-29,Alpine,003,1148,87,88,0,88,0
2021-05-29,Amador,005,37829,3685,3683,33,3716,46
2021-05-29,Butte,007,227075,12582,12425,1827,14252,190
2021-05-29,Calaveras,009,45235,2172,2166,13,2179,55
2021-05-29,Colusa,011,21464,1950,1954,314,2268,15
2021-05-29,Contra Costa,013,1133247,69790,69351,1290,70641,813
2021-05-29,Del Norte,015,27424,1420,1391,13,1404,8
2021-05-29,El Dorado,017,186661,10325,10269,750,11019,110
2021-05-29,Fresno,019,978130,102871,102470,8728,111198,1706
2021-05-29,Glenn,021,27897,2437,2422,560,2982,18
2021-05-29,Humboldt,023,135768,4293,4283,38,4321,42
2021-05-29,Imperial,025,180216,28642,28729,2750,31479,736
2021-05-29,Inyo,027,18085,1404,1404,13,1417,35
2021-05-29,Kern,029,883053,97415,96424,10992,107416,1319
2021-05-29,Kings,031,150075,23186,22970,1094,24064,244
2021-05-29,Lake,033,64148,3536,3515,9,3524,45
2021-05-29,Lassen,035,31185,5217,5171,115,5286,6
2021-05-29,Los Angeles,037,10098052,1207019,1202264,41402,1243666,24359
2021-05-29,Madera,039,155013,16645,16535,942,17477,240
2021-05-29,Marin,041,260295,14119,14071,260,14331,229
2021-05-29,Mariposa,043,17540,434,428,11,439,5
2021-05-29,Mendocino,045,87422,4022,3952,83,4035,47
2021-05-29,Merced,047,269075,31063,31187,1052,32239,456
2021-05-29,Modoc,049,8938,382,374,131,505,3
2021-05-29,Mono,051,14174,1263,1275,17,1292,3
2021-05-29,Monterey,053,433212,43193,43042,1873,44915,379
2021-05-29,Napa,055,140530,9917,9948,38,9986,82
2021-05-29,Nevada,057,99092,4843,4816,193,5009,72
2021-05-29,Orange,059,3164182,255507,254537,11421,265958,5049
2021-05-29,Placer,061,380077,23358,23009,1505,24514,293
2021-05-29,Plumas,063,18699,709,689,11,700,4
2021-05-29,Riverside,065,2383286,294341,288908,14072,302980,4442
2021-05-29,Sacramento,067,1510023,106489,106218,1770,107988,1643
2021-05-29,San Benito,069,59416,6060,6072,115,6187,63
2021-05-29,San Bernardino,071,2135413,293577,292961,9010,301971,4757
2021-05-29,San Diego,073,3302833,281094,280151,14995,295146,3756
2021-05-29,San Francisco,075,870044,36787,37008,1296,38304,550
2021-05-29,San Joaquin,077,732212,73317,72827,3571,76398,1383
2021-05-29,San Luis Obispo,079,281455,21430,21201,748,21949,256
2021-05-29,San Mateo,081,765935,42390,42375,476,42851,439
2021-05-29,Santa Barbara,083,443738,34465,34367,1138,35505,456
2021-05-29,Santa Clara,085,1922200,118729,119498,765,120263,2056
2021-05-29,Santa Cruz,087,273765,16249,16137,812,16949,207
2021-05-29,Shasta,089,179085,12357,12401,1583,13984,199
2021-05-29,Sierra,091,2930,57,55,12,67,0
2021-05-29,Siskiyou,093,43540,1937,1856,367,2223,21
2021-05-29,Solano,095,438530,32937,32917,559,33476,256
2021-05-29,Sonoma,097,501317,30175,30298,338,30636,322
2021-05-29,Stanislaus,099,539301,56474,56305,5968,62273,974
2021-05-29,Sutter,101,95872,9482,9516,87,9603,111
2021-05-29,Tehama,103,63373,5099,5070,581,5651,63
2021-05-29,Trinity,105,12862,483,328,95,423,3
2021-05-29,Tulare,107,460477,50270,49392,9069,58461,845
2021-05-29,Tuolumne,109,53932,4037,4093,41,4134,63
2021-05-29,Ventura,111,848112,81447,81008,3000,84008,1021
2021-05-29,Yolo,113,214977,14059,14055,322,14377,210
2021-05-29,Yuba,115,75493,6083,6059,126,6185,48
2021-05-28,Alameda,001,1643700,88312,88391,1963,90354,1261
2021-05-28,Alpine,003,1148,87,88,0,88,0
2021-05-28,Amador,005,37829,3685,3680,33,3713,46
2021-05-28,Butte,007,227075,12579,12407,1826,14233,190
2021-05-28,Calaveras,009,45235,2171,2165,13,2178,55
2021-05-28,Colusa,011,21464,1950,1954,312,2266,15
2021-05-28,Contra Costa,013,1133247,69754,69290,1289,70579,813
2021-05-28,Del Norte,015,27424,1419,1390,13,1403,8
2021-05-28,El Dorado,017,186661,10322,10265,750,11015,110
2021-05-28,Fresno,019,978130,102856,102437,8728,111165,1705
2021-05-28,Glenn,021,27897,2437,2419,560,2979,18
2021-05-28,Humboldt,023,135768,4286,4265,38,4303,42
2021-05-28,Imperial,025,180216,28639,28722,2750,31472,736
2021-05-28,Inyo,027,18085,1404,1404,13,1417,35
2021-05-28,Kern,029,883053,97398,96396,10984,107380,1320
2021-05-28,Kings,031,150075,23184,22962,1094,24056,244
2021-05-28,Lake,033,64148,3534,3515,9,3524,45
2021-05-28,Lassen,035,31185,5217,5169,115,5284,6
2021-05-28,Los Angeles,037,10098052,1206909,1202103,41391,1243494,24357
2021-05-28,Madera,039,155013,16643,16530,942,17472,240
2021-05-28,Marin,041,260295,14118,14063,259,14322,229
2021-05-28,Mariposa,043,17540,434,428,11,439,5
2021-05-28,Mendocino,045,87422,4017,3947,83,4030,47
2021-05-28,Merced,047,269075,31060,31176,1052,32228,455
2021-05-28,Modoc,049,8938,382,374,131,505,3
2021-05-28,Mono,051,14174,1263,1274,17,1291,3
2021-05-28,Monterey,053,433212,43192,43036,1873,44909,379
2021-05-28,Napa,055,140530,9917,9941,38,9979,82
2021-05-28,Nevada,057,99092,4841,4813,193,5006,71
2021-05-28,Orange,059,3164182,255487,254494,11419,265913,5047
2021-05-28,Placer,061,380077,23348,22987,1503,24490,293
2021-05-28,Plumas,063,18699,707,688,11,699,4
2021-05-28,Riverside,065,2383286,294319,288872,14070,302942,4442
2021-05-28,Sacramento,067,1510023,106433,106131,1768,107899,1642
2021-05-28,San Benito,069,59416,6060,6074,115,6189,63
2021-05-28,San Bernardino,071,2135413,293554,292905,9010,301915,4757
2021-05-28,San Diego,073,3302833,281031,280043,14984,295027,3756
2021-05-28,San Francisco,075,870044,36781,36987,1296,38283,546
2021-05-28,San Joaquin,077,732212,73287,72793,3569,76362,1383
2021-05-28,San Luis Obispo,079,281455,21425,21190,746,21936,256
2021-05-28,San Mateo,081,765935,42384,42364,476,42840,439
2021-05-28,Santa Barbara,083,443738,34464,34371,1138,35509,455
2021-05-28,Santa Clara,085,1922200,118705,119462,765,120227,2056
2021-05-28,Santa Cruz,087,273765,16248,16129,812,16941,207
2021-05-28,Shasta,089,179085,12348,12383,1581,13964,198
2021-05-28,Sierra,091,2930,57,54,12,66,0
2021-05-28,Siskiyou,093,43540,1935,1850,367,2217,19
2021-05-28,Solano,095,438530,32922,32892,559,33451,256
2021-05-28,Sonoma,097,501317,30156,30270,338,30608,321
2021-05-28,Stanislaus,099,539301,56456,56278,5965,62243,974
2021-05-28,Sutter,101,95872,9478,9511,87,9598,111
2021-05-28,Tehama,103,63373,5093,5064,581,5645,63
2021-05-28,Trinity,105,12862,483,328,95,423,3
2021-05-28,Tulare,107,460477,50265,49375,9060,58435,846
2021-05-28,Tuolumne,109,53932,4037,4090,41,4131,63
2021-05-28,Ventura,111,848112,81436,80985,2999,83984,1021
2021-05-28,Yolo,113,214977,14056,14050,321,14371,210
2021-05-28,Yuba,115,75493,6081,6050,125,6175,48
2021-05-27,Alameda,001,1643700,88277,88342,1962,90304,1274
2021-05-27,Alpine,003,1148,87,88,0,88,0
2021-05-27,Amador,005,37829,3682,3680,33,3713,46
2021-05-27,Butte,007,227075,12574,12401,1825,14226,190
2021-05-27,Calaveras,009,45235,2170,2163,13,2176,55
2021-05-27,Colusa,011,21464,1947,1952,312,2264,15
2021-05-27,Contra Costa,013,1133247,69712,69245,1287,70532,813
2021-05-27,Del Norte,015,27424,1419,1388,13,1401,8
2021-05-27,El Dorado,017,186661,10321,10248,750,10998,112
2021-05-27,Fresno,019,978130,102840,102413,8725,111138,1704
2021-05-27,Glenn,021,27897,2437,2415,560,2975,18
2021-05-27,Humboldt,023,135768,4278,4260,38,4298,42
2021-05-27,Imperial,025,180216,28628,28728,2750,31478,736
2021-05-27,Inyo,027,18085,1404,1404,13,1417,35
2021-05-27,Kern,029,883053,97382,96364,10976,107340,1322
2021-05-27,Kings,031,150075,23181,22953,1094,24047,245
2021-05-27,Lake,033,64148,3529,3509,9,3518,45
2021-05-27,Lassen,035,31185,5216,5170,114,5284,6
2021-05-27,Los Angeles,037,10098052,1206744,1201927,41376,1243303,24348
2021-05-27,Madera,039,155013,16634,16527,942,17469,240
2021-05-27,Marin,041,260295,14114,14061,259,14320,229
2021-05-27,Mariposa,043,17540,432,427,11,438,5
2021-05-27,Mendocino,045,87422,4011,3945,83,4028,47
2021-05-27,Merced,047,269075,31048,31161,1052,32213,455
2021-05-27,Modoc,049,8938,381,374,131,505,3
2021-05-27,Mono,051,14174,1263,1276,17,1293,3
2021-05-27,Monterey,053,433212,43186,43032,1873,44905,379
2021-05-27,Napa,055,140530,9916,9934,38,9972,82
2021-05-27,Nevada,057,99092,4837,4807,191,4998,71
2021-05-27,Orange,059,3164182,255450,254438,11415,265853,5059
2021-05-27,Placer,061,380077,23339,22966,1503,24469,293
2021-05-27,Plumas,063,18699,707,687,11,698,4
2021-05-27,Riverside,065,2383286,294283,288835,14065,302900,4443
2021-05-27,Sacramento,067,1510023,106358,106015,1766,107781,1642
2021-05-27,San Benito,069,59416,6059,6074,115,6189,63
2021-05-27,San Bernardino,071,2135413,293517,292755,9008,301763,4756
2021-05-27,San Diego,073,3302833,280957,279960,14970,294930,3756
2021-05-27,San Francisco,075,870044,36775,36980,1293,38273,546
2021-05-27,San Joaquin,077,732212,73255,72714,3565,76279,1388
2021-05-27,San Luis Obispo,079,281455,21420,21171,746,21917,256
2021-05-27,San Mateo,081,765935,42375,42345,476,42821,436
2021-05-27,Santa Barbara,083,443738,34459,34355,1138,35493,456
2021-05-27,Santa Clara,085,1922200,118684,119452,765,120217,2053
2021-05-27,Santa Cruz,087,273765,16246,16134,812,16946,207
2021-05-27,Shasta,089,179085,12338,12380,1581,13961,202
2021-05-27,Sierra,091,2930,57,54,12,66,0
2021-05-27,Siskiyou,093,43540,1932,1846,367,2213,18
2021-05-27,Solano,095,438530,32881,32855,558,33413,257
2021-05-27,Sonoma,097,501317,30129,30253,334,30587,321
2021-05-27,Stanislaus,099,539301,56431,56207,5964,62171,974
2021-05-27,Sutter,101,95872,9474,9501,87,9588,111
2021-05-27,Tehama,103,63373,5090,5064,580,5644,63
2021-05-27,Trinity,105,12862,483,328,95,423,3
2021-05-27,Tulare,107,460477,50251,49366,9051,58417,840
2021-05-27,Tuolumne,109,53932,4036,4090,41,4131,66
2021-05-27,Ventura,111,848112,81423,80965,2996,83961,1023
2021-05-27,Yolo,113,214977,14053,14036,321,14357,213
2021-05-27,Yuba,115,75493,6076,6040,124,6164,48
2021-05-26,Alameda,001,1643700,88248,88297,1962,90259,1266
2021-05-26,Alpine,003,1148,87,88,0,88,0
2021-05-26,Amador,005,37829,3682,3679,33,3712,46
2021-05-26,Butte,007,227075,12565,12332,1824,14156,190
2021-05-26,Calaveras,009,45235,2169,2154,13,2167,55
2021-05-26,Colusa,011,21464,1946,1952,312,2264,15
2021-05-26,Contra Costa,013,1133247,69675,69210,1287,70497,812
2021-05-26,Del Norte,015,27424,1419,1386,12,1398,8
2021-05-26,El Dorado,017,186661,10317,10242,749,10991,112
2021-05-26,Fresno,019,978130,102807,102374,8720,111094,1702
2021-05-26,Glenn,021,27897,2436,2415,560,2975,18
2021-05-26,Humboldt,023,135768,4273,4246,38,4284,42
2021-05-26,Imperial,025,180216,28623,28712,2748,31460,734
2021-05-26,Inyo,027,18085,1404,1403,13,1416,36
2021-05-26,Kern,029,883053,97357,96343,10969,107312,1320
2021-05-26,Kings,031,150075,23177,22950,1093,24043,245
2021-05-26,Lake,033,64148,3528,3508,9,3517,45
2021-05-26,Lassen,035,31185,5215,5164,114,5278,6
2021-05-26,Los Angeles,037,10098052,1206577,1198100,41360,1239460,24221
2021-05-26,Madera,039,155013,16631,16520,942,17462,240
2021-05-26,Marin,041,260295,14111,14061,258,14319,227
2021-05-26,Mariposa,043,17540,432,427,11,438,5
2021-05-26,Mendocino,045,87422,4005,3938,83,4021,47
2021-05-26,Merced,047,269075,31039,31139,1052,32191,455
2021-05-26,Modoc,049,8938,381,371,130,501,3
2021-05-26,Mono,051,14174,1263,1274,17,1291,3
2021-05-26,Monterey,053,433212,43180,43018,1872,44890,379
2021-05-26,Napa,055,140530,9909,9932,36,9968,82
2021-05-26,Nevada,057,99092,4832,4803,191,4994,70
2021-05-26,Orange,059,3164182,255414,254368,11412,265780,5058
2021-05-26,Placer,061,380077,23315,22940,1503,24443,293
2021-05-26,Plumas,063,18699,706,685,11,696,4
2021-05-26,Riverside,065,2383286,294237,288782,14058,302840,4443
2021-05-26,Sacramento,067,1510023,106272,105919,1762,107681,1637
2021-05-26,San Benito,069,59416,6059,6074,115,6189,63
2021-05-26,San Bernardino,071,2135413,293481,292662,9007,301669,4755
2021-05-26,San Diego,073,3302833,280882,279859,14960,294819,3755
2021-05-26,San Francisco,075,870044,36763,36954,1293,38247,546
2021-05-26,San Joaquin,077,732212,73213,72681,3562,76243,1388
2021-05-26,San Luis Obispo,079,281455,21414,21163,746,21909,256
2021-05-26,San Mateo,081,765935,42367,42331,476,42807,436
2021-05-26,Santa Barbara,083,443738,34450,34348,1138,35486,459
2021-05-26,Santa Clara,085,1922200,118657,119421,764,120185,2031
2021-05-26,Santa Cruz,087,273765,16245,16139,812,16951,207
2021-05-26,Shasta,089,179085,12323,12357,1578,13935,202
2021-05-26,Sierra,091,2930,57,54,12,66,0
2021-05-26,Siskiyou,093,43540,1930,1847,365,2212,18
2021-05-26,Solano,095,438530,32845,32831,558,33389,257
2021-05-26,Sonoma,097,501317,30102,30230,334,30564,321
2021-05-26,Stanislaus,099,539301,56409,56193,5962,62155,974
2021-05-26,Sutter,101,95872,9469,9495,87,9582,112
2021-05-26,Tehama,103,63373,5089,5054,577,5631,63
2021-05-26,Trinity,105,12862,483,328,95,423,3
2021-05-26,Tulare,107,460477,50244,49352,9047,58399,839
2021-05-26,Tuolumne,109,53932,4032,4088,40,4128,66
2021-05-26,Ventura,111,848112,81400,80944,2994,83938,1023
2021-05-26,Yolo,113,214977,14050,14025,321,14346,213
2021-05-26,Yuba,115,75493,6071,6036,124,6160,49
2021-05-25,Alameda,001,1643700,88218,88237,1962,90199,1263
2021-05-25,Alpine,003,1148,87,88,0,88,0
2021-05-25,Amador,005,37829,3677,3676,33,3709,46
2021-05-25,Butte,007,227075,12554,12295,1823,14118,189
2021-05-25,Calaveras,009,45235,2167,2148,13,2161,55
2021-05-25,Colusa,011,21464,1945,1949,312,2261,15
2021-05-25,Contra Costa,013,1133247,69623,69167,1282,70449,809
2021-05-25,Del Norte,015,27424,1419,1385,12,1397,8
2021-05-25,El Dorado,017,186661,10310,10240,748,10988,112
2021-05-25,Fresno,019,978130,102786,102329,8718,111047,1701
2021-05-25,Glenn,021,27897,2435,2414,559,2973,17
2021-05-25,Humboldt,023,135768,4266,4231,36,4267,42
2021-05-25,Imperial,025,180216,28616,28586,2748,31334,735
2021-05-25,Inyo,027,18085,1404,1402,13,1415,36
2021-05-25,Kern,029,883053,97326,96319,10955,107274,1319
2021-05-25,Kings,031,150075,23170,22944,1093,24037,245
2021-05-25,Lake,033,64148,3527,3508,9,3517,44
2021-05-25,Lassen,035,31185,5211,5164,114,5278,6
2021-05-25,Los Angeles,037,10098052,1206395,1197940,41341,1239281,24212
2021-05-25,Madera,039,155013,16626,16519,941,17460,240
2021-05-25,Marin,041,260295,14105,14053,258,14311,227
2021-05-25,Mariposa,043,17540,431,427,11,438,5
2021-05-25,Mendocino,045,87422,4000,3928,83,4011,47
2021-05-25,Merced,047,269075,31018,31132,1052,32184,455
2021-05-25,Modoc,049,8938,380,367,130,497,3
2021-05-25,Mono,051,14174,1263,1274,17,1291,3
2021-05-25,Monterey,053,433212,43176,43012,1871,44883,379
2021-05-25,Napa,055,140530,9907,9926,36,9962,82
2021-05-25,Nevada,057,99092,4826,4795,191,4986,70
2021-05-25,Orange,059,3164182,255385,254321,11411,265732,5057
2021-05-25,Placer,061,380077,23304,22920,1501,24421,292
2021-05-25,Plumas,063,18699,706,684,11,695,4
2021-05-25,Riverside,065,2383286,294198,288725,14055,302780,4443
2021-05-25,Sacramento,067,1510023,106191,105828,1758,107586,1633
2021-05-25,San Benito,069,59416,6059,6073,115,6188,63
2021-05-25,San Bernardino,071,2135413,293421,292485,9005,301490,4755
2021-05-25,San Diego,073,3302833,280800,279786,14955,294741,3753
2021-05-25,San Francisco,075,870044,36740,36939,1293,38232,546
2021-05-25,San Joaquin,077,732212,73171,72628,3559,76187,1387
2021-05-25,San Luis Obispo,079,281455,21411,21153,746,21899,256
2021-05-25,San Mateo,081,765935,42357,42268,476,42744,435
2021-05-25,Santa Barbara,083,443738,34447,34337,1138,35475,459
2021-05-25,Santa Clara,085,1922200,118633,119393,763,120156,2032
2021-05-25,Santa Cruz,087,273765,16240,16141,812,16953,207
2021-05-25,Shasta,089,179085,12314,12328,1576,13904,202
2021-05-25,Sierra,091,2930,56,54,12,66,0
2021-05-25,Siskiyou,093,43540,1929,1845,364,2209,18
2021-05-25,Solano,095,438530,32826,32817,557,33374,256
2021-05-25,Sonoma,097,501317,30073,30207,333,30540,321
2021-05-25,Stanislaus,099,539301,56373,56168,5959,62127,974
2021-05-25,Sutter,101,95872,9465,9495,87,9582,112
2021-05-25,Tehama,103,63373,5087,5048,576,5624,63
2021-05-25,Trinity,105,12862,483,328,94,422,3
2021-05-25,Tulare,107,460477,50234,49326,9039,58365,838
2021-05-25,Tuolumne,109,53932,4032,4084,40,4124,66
2021-05-25,Ventura,111,848112,81382,80905,2994,83899,1022
2021-05-25,Yolo,113,214977,14042,14018,319,14337,213
2021-05-25,Yuba,115,75493,6064,6028,124,6152,49
2021-05-24,Alameda,001,1643700,88178,88182,1961,90143,1263
2021-05-24,Alpine,003,1148,87,88,0,88,0
2021-05-24,Amador,005,37829,3675,3675,33,3708,46
2021-05-24,Butte,007,227075,12541,12279,1820,14099,189
2021-05-24,Calaveras,009,45235,2165,2146,13,2159,54
2021-05-24,Colusa,011,21464,1945,1949,312,2261,15
2021-05-24,Contra Costa,013,1133247,69582,69107,1278,70385,809
2021-05-24,Del Norte,015,27424,1418,1384,12,1396,8
2021-05-24,El Dorado,017,186661,10300,10227,747,10974,112
2021-05-24,Fresno,019,978130,102744,102289,8717,111006,1698
2021-05-24,Glenn,021,27897,2435,2413,559,2972,17
2021-05-24,Humboldt,023,135768,4259,4225,36,4261,42
2021-05-24,Imperial,025,180216,28614,28575,2748,31323,735
2021-05-24,Inyo,027,18085,1404,1402,13,1415,36
2021-05-24,Kern,029,883053,97299,96296,10950,107246,1319
2021-05-24,Kings,031,150075,23166,22940,1093,24033,246
2021-05-24,Lake,033,64148,3525,3506,9,3515,43
2021-05-24,Lassen,035,31185,5207,5163,114,5277,6
2021-05-24,Los Angeles,037,10098052,1206220,1197782,41327,1239109,24201
2021-05-24,Madera,039,155013,16622,16513,940,17453,239
2021-05-24,Marin,041,260295,14103,14051,258,14309,227
2021-05-24,Mariposa,043,17540,430,427,11,438,5
2021-05-24,Mendocino,045,87422,3998,3919,83,4002,47
2021-05-24,Merced,047,269075,31008,31128,1051,32179,455
2021-05-24,Modoc,049,8938,380,366,129,495,3
2021-05-24,Mono,051,14174,1263,1270,17,1287,3
2021-05-24,Monterey,053,433212,43171,43005,1870,44875,379
2021-05-24,Napa,055,140530,9907,9924,36,9960,82
2021-05-24,Nevada,057,99092,4823,4790,191,4981,70
2021-05-24,Orange,059,3164182,255351,254287,11401,265688,5056
2021-05-24,Placer,061,380077,23285,22895,1500,24395,292
2021-05-24,Plumas,063,18699,705,683,11,694,4
2021-05-24,Riverside,065,2383286,294141,288669,14045,302714,4442
2021-05-24,Sacramento,067,1510023,106076,105716,1757,107473,1632
2021-05-24,San Benito,069,59416,6059,6072,115,6187,63
2021-05-24,San Bernardino,071,2135413,293381,292343,9004,301347,4747
2021-05-24,San Diego,073,3302833,280692,279715,14945,294660,3749
2021-05-24,San Francisco,075,870044,36720,36934,1291,38225,547
2021-05-24,San Joaquin,077,732212,73139,72586,3558,76144,1371
2021-05-24,San Luis Obispo,079,281455,21393,21146,745,21891,256
2021-05-24,San Mateo,081,765935,42347,42249,476,42725,433
2021-05-24,Santa Barbara,083,443738,34442,34322,1138,35460,459
2021-05-24,Santa Clara,085,1922200,118601,119358,763,120121,2030
2021-05-24,Santa Cruz,087,273765,16234,16135,812,16947,207
2021-05-24,Shasta,089,179085,12297,12315,1573,13888,201
2021-05-24,Sierra,091,2930,56,54,12,66,0
2021-05-24,Siskiyou,093,43540,1926,1840,364,2204,17
2021-05-24,Solano,095,438530,32801,32792,556,33348,254
2021-05-24,Sonoma,097,501317,30058,30187,333,30520,321
2021-05-24,Stanislaus,099,539301,56339,56128,5955,62083,974
2021-05-24,Sutter,101,95872,9459,9486,87,9573,113
2021-05-24,Tehama,103,63373,5084,5043,574,5617,63
2021-05-24,Trinity,105,12862,483,328,94,422,3
2021-05-24,Tulare,107,460477,50227,49318,9035,58353,838
2021-05-24,Tuolumne,109,53932,4032,4083,40,4123,65
2021-05-24,Ventura,111,848112,81369,80876,2992,83868,1022
2021-05-24,Yolo,113,214977,14025,14012,317,14329,213
2021-05-24,Yuba,115,75493,6055,6022,124,6146,49
2021-05-23,Alameda,001,1643700,88115,88157,1958,90115,1263
2021-05-23,Alpine,003,1148,87,88,0,88,0
2021-05-23,Amador,005,37829,3674,3673,33,3706,46
2021-05-23,Butte,007,227075,12527,12271,1819,14090,189
2021-05-23,Calaveras,009,45235,2157,2144,13,2157,54
2021-05-23,Colusa,011,21464,1945,1949,310,2259,15
2021-05-23,Contra Costa,013,1133247,69538,69075,1276,70351,809
2021-05-23,Del Norte,015,27424,1414,1383,12,1395,8
2021-05-23,El Dorado,017,186661,10294,10222,747,10969,112
2021-05-23,Fresno,019,978130,102699,102270,8712,110982,1698
2021-05-23,Glenn,021,27897,2433,2413,559,2972,17
2021-05-23,Humboldt,023,135768,4242,4216,36,4252,42
2021-05-23,Imperial,025,180216,28608,28569,2747,31316,735
2021-05-23,Inyo,027,18085,1404,1402,13,1415,36
2021-05-23,Kern,029,883053,97275,96282,10942,107224,1319
2021-05-23,Kings,031,150075,23153,22939,1091,24030,246
2021-05-23,Lake,033,64148,3522,3504,9,3513,43
2021-05-23,Lassen,035,31185,5203,5163,113,5276,6
2021-05-23,Los Angeles,037,10098052,1206031,1197633,41316,1238949,24197
2021-05-23,Madera,039,155013,16616,16504,940,17444,239
2021-05-23,Marin,041,260295,14094,14048,257,14305,227
2021-05-23,Mariposa,043,17540,430,427,11,438,5
2021-05-23,Mendocino,045,87422,3992,3913,82,3995,47
2021-05-23,Merced,047,269075,30998,31118,1051,32169,455
2021-05-23,Modoc,049,8938,376,366,129,495,3
2021-05-23,Mono,051,14174,1262,1270,17,1287,3
2021-05-23,Monterey,053,433212,43161,43003,1870,44873,379
2021-05-23,Napa,055,140530,9903,9923,36,9959,82
2021-05-23,Nevada,057,99092,4813,4790,191,4981,70
2021-05-23,Orange,059,3164182,255313,254277,11395,265672,5050
2021-05-23,Placer,061,380077,23265,22888,1500,24388,292
2021-05-23,Plumas,063,18699,704,683,11,694,4
2021-05-23,Riverside,065,2383286,294072,288641,14041,302682,4442
2021-05-23,Sacramento,067,1510023,105960,105663,1754,107417,1632
2021-05-23,San Benito,069,59416,6058,6072,115,6187,63
2021-05-23,San Bernardino,071,2135413,293330,292327,9003,301330,4747
2021-05-23,San Diego,073,3302833,280602,279690,14934,294624,3751
2021-05-23,San Francisco,075,870044,36709,36927,1290,38217,547
2021-05-23,San Joaquin,077,732212,73090,72571,3555,76126,1371
2021-05-23,San Luis Obispo,079,281455,21383,21141,744,21885,256
2021-05-23,San Mateo,081,765935,42330,42248,476,42724,433
2021-05-23,Santa Barbara,083,443738,34435,34319,1138,35457,459
2021-05-23,Santa Clara,085,1922200,118577,119333,763,120096,2030
2021-05-23,Santa Cruz,087,273765,16231,16130,812,16942,207
2021-05-23,Shasta,089,179085,12280,12313,1569,13882,201
2021-05-23,Sierra,091,2930,56,54,12,66,0
2021-05-23,Siskiyou,093,43540,1921,1826,357,2183,17
2021-05-23,Solano,095,438530,32783,32780,555,33335,254
2021-05-23,Sonoma,097,501317,30029,30168,332,30500,321
2021-05-23,Stanislaus,099,539301,56291,56104,5952,62056,974
2021-05-23,Sutter,101,95872,9450,9479,87,9566,113
2021-05-23,Tehama,103,63373,5077,5041,572,5613,63
2021-05-23,Trinity,105,12862,483,328,94,422,3
2021-05-23,Tulare,107,460477,50213,49310,9031,58341,838
2021-05-23,Tuolumne,109,53932,4029,4081,40,4121,65
2021-05-23,Ventura,111,848112,81339,80872,2991,83863,1022
2021-05-23,Yolo,113,214977,14013,14004,314,14318,213
2021-05-23,Yuba,115,75493,6050,6017,124,6141,49
2021-05-22,Alameda,001,1643700,88088,88101,1958,90059,1263
2021-05-22,Alpine,003,1148,87,88,0,88,0
2021-05-22,Amador,005,37829,3673,3672,33,3705,46
2021-05-22,Butte,007,227075,12515,12265,1818,14083,189
2021-05-22,Calaveras,009,45235,2153,2141,13,2154,54
2021-05-22,Colusa,011,21464,1941,1949,309,2258,15
2021-05-22,Contra Costa,013,1133247,69505,69004,1275,70279,809
2021-05-22,Del Norte,015,27424,1413,1381,12,1393,8
2021-05-22,El Dorado,017,186661,10289,10215,746,10961,112
2021-05-22,Fresno,019,978130,102685,102238,8710,110948,1698
2021-05-22,Glenn,021,27897,2433,2412,559,2971,17
2021-05-22,Humboldt,023,135768,4233,4194,35,4229,42
2021-05-22,Imperial,025,180216,28599,28574,2747,31321,735
2021-05-22,Inyo,027,18085,1404,1402,13,1415,36
2021-05-22,Kern,029,883053,97263,96260,10935,107195,1319
2021-05-22,Kings,031,150075,23153,22936,1091,24027,246
2021-05-22,Lake,033,64148,3519,3502,9,3511,43
2021-05-22,Lassen,035,31185,5203,5163,113,5276,6
2021-05-22,Los Angeles,037,10098052,1205920,1197454,41308,1238762,24192
2021-05-22,Madera,039,155013,16613,16503,940,17443,239
2021-05-22,Marin,041,260295,14091,14043,257,14300,227
2021-05-22,Mariposa,043,17540,430,427,11,438,5
2021-05-22,Mendocino,045,87422,3986,3908,82,3990,47
2021-05-22,Merced,047,269075,30988,31099,1051,32150,455
2021-05-22,Modoc,049,8938,376,366,129,495,3
2021-05-22,Mono,051,14174,1260,1270,17,1287,3
2021-05-22,Monterey,053,433212,43155,42998,1870,44868,379
2021-05-22,Napa,055,140530,9901,9918,36,9954,82
2021-05-22,Nevada,057,99092,4806,4787,190,4977,70
2021-05-22,Orange,059,3164182,255292,254238,11389,265627,5048
2021-05-22,Placer,061,380077,23251,22865,1499,24364,292
2021-05-22,Plumas,063,18699,703,683,11,694,4
2021-05-22,Riverside,065,2383286,294040,288580,14040,302620,4442
2021-05-22,Sacramento,067,1510023,105885,105551,1751,107302,1632
2021-05-22,San Benito,069,59416,6058,6071,115,6186,63
2021-05-22,San Bernardino,071,2135413,293305,292292,9003,301295,4747
2021-05-22,San Diego,073,3302833,280543,279614,14926,294540,3751
2021-05-22,San Francisco,075,870044,36699,36906,1288,38194,547
2021-05-22,San Joaquin,077,732212,73068,72528,3552,76080,1371
2021-05-22,San Luis Obispo,079,281455,21375,21134,743,21877,256
2021-05-22,San Mateo,081,765935,42320,42218,476,42694,433
2021-05-22,Santa Barbara,083,443738,34431,34313,1137,35450,459
2021-05-22,Santa Clara,085,1922200,118553,119292,763,120055,2030
2021-05-22,Santa Cruz,087,273765,16231,16125,812,16937,207
2021-05-22,Shasta,089,179085,12273,12307,1566,13873,201
2021-05-22,Sierra,091,2930,56,54,12,66,0
2021-05-22,Siskiyou,093,43540,1920,1824,356,2180,17
2021-05-22,Solano,095,438530,32770,32753,555,33308,254
2021-05-22,Sonoma,097,501317,30017,30154,332,30486,321
2021-05-22,Stanislaus,099,539301,56268,56069,5950,62019,974
2021-05-22,Sutter,101,95872,9445,9476,87,9563,113
2021-05-22,Tehama,103,63373,5076,5036,572,5608,63
2021-05-22,Trinity,105,12862,483,328,94,422,3
2021-05-22,Tulare,107,460477,50208,49299,9026,58325,838
2021-05-22,Tuolumne,109,53932,4029,4078,40,4118,65
2021-05-22,Ventura,111,848112,81335,80859,2991,83850,1022
2021-05-22,Yolo,113,214977,14011,13997,314,14311,213
2021-05-22,Yuba,115,75493,6047,6010,124,6134,49
2021-05-21,Alameda,001,1643700,88062,88041,1957,89998,1263
2021-05-21,Alpine,003,1148,87,88,0,88,0
2021-05-21,Amador,005,37829,3670,3672,33,3705,46
2021-05-21,Butte,007,227075,12509,12236,1816,14052,188
2021-05-21,Calaveras,009,45235,2151,2138,13,2151,54
2021-05-21,Colusa,011,21464,1941,1947,309,2256,15
2021-05-21,Contra Costa,013,1133247,69462,68965,1274,70239,810
2021-05-21,Del Norte,015,27424,1412,1376,12,1388,8
2021-05-21,El Dorado,017,186661,10285,10204,746,10950,112
2021-05-21,Fresno,019,978130,102657,102189,8708,110897,1698
2021-05-21,Glenn,021,27897,2432,2408,559,2967,17
2021-05-21,Humboldt,023,135768,4226,4175,35,4210,42
2021-05-21,Imperial,025,180216,28592,28572,2746,31318,732
2021-05-21,Inyo,027,18085,1404,1402,13,1415,36
2021-05-21,Kern,029,883053,97249,96233,10928,107161,1318
2021-05-21,Kings,031,150075,23153,22927,1091,24018,246
2021-05-21,Lake,033,64148,3517,3500,9,3509,43
2021-05-21,Lassen,035,31185,5202,5161,113,5274,6
2021-05-21,Los Angeles,037,10098052,1205808,1197263,41299,1238562,24180
2021-05-21,Madera,039,155013,16612,16500,939,17439,238
2021-05-21,Marin,041,260295,14086,14042,257,14299,227
2021-05-21,Mariposa,043,17540,429,427,11,438,5
2021-05-21,Mendocino,045,87422,3981,3897,82,3979,47
2021-05-21,Merced,047,269075,30980,31076,1051,32127,455
2021-05-21,Modoc,049,8938,376,365,129,494,3
2021-05-21,Mono,051,14174,1260,1269,17,1286,3
2021-05-21,Monterey,053,433212,43153,42995,1870,44865,379
2021-05-21,Napa,055,140530,9897,9913,36,9949,82
2021-05-21,Nevada,057,99092,4805,4779,190,4969,70
2021-05-21,Orange,059,3164182,255273,254171,11387,265558,5042
2021-05-21,Placer,061,380077,23242,22853,1499,24352,292
2021-05-21,Plumas,063,18699,703,683,10,693,4
2021-05-21,Riverside,065,2383286,294013,288499,14033,302532,4442
2021-05-21,Sacramento,067,1510023,105818,105476,1748,107224,1632
2021-05-21,San Benito,069,59416,6058,6068,115,6183,63
2021-05-21,San Bernardino,071,2135413,293273,292205,9000,301205,4744
2021-05-21,San Diego,073,3302833,280470,279554,14916,294470,3748
2021-05-21,San Francisco,075,870044,36694,36879,1288,38167,546
2021-05-21,San Joaquin,077,732212,73048,72467,3550,76017,1371
2021-05-21,San Luis Obispo,079,281455,21369,21128,740,21868,256
2021-05-21,San Mateo,081,765935,42307,42163,475,42638,432
2021-05-21,Santa Barbara,083,443738,34426,34302,1137,35439,459
2021-05-21,Santa Clara,085,1922200,118526,119247,763,120010,2029
2021-05-21,Santa Cruz,087,273765,16227,16120,812,16932,207
2021-05-21,Shasta,089,179085,12256,12289,1564,13853,201
2021-05-21,Sierra,091,2930,56,54,12,66,0
2021-05-21,Siskiyou,093,43540,1919,1815,356,2171,16
2021-05-21,Solano,095,438530,32755,32742,555,33297,254
2021-05-21,Sonoma,097,501317,30004,30126,332,30458,321
2021-05-21,Stanislaus,099,539301,56239,56036,5948,61984,975
2021-05-21,Sutter,101,95872,9443,9470,87,9557,113
2021-05-21,Tehama,103,63373,5070,5030,572,5602,63
2021-05-21,Trinity,105,12862,483,329,93,422,3
2021-05-21,Tulare,107,460477,50203,49271,9024,58295,838
2021-05-21,Tuolumne,109,53932,4027,4079,40,4119,65
2021-05-21,Ventura,111,848112,81327,80821,2988,83809,1021
2021-05-21,Yolo,113,214977,14005,13983,314,14297,213
2021-05-21,Yuba,115,75493,6041,6006,124,6130,49
2021-05-20,Alameda,001,1643700,88018,87975,1956,89931,1264
2021-05-20,Alpine,003,1148,87,88,0,88,0
2021-05-20,Amador,005,37829,3669,3671,33,3704,46
2021-05-20,Butte,007,227075,12502,12220,1813,14033,188
2021-05-20,Calaveras,009,45235,2147,2138,13,2151,54
2021-05-20,Colusa,011,21464,1940,1946,307,2253,15
2021-05-20,Contra Costa,013,1133247,69417,68913,1272,70185,809
2021-05-20,Del Norte,015,27424,1412,1373,12,1385,8
2021-05-20,El Dorado,017,186661,10275,10188,746,10934,112
2021-05-20,Fresno,019,978130,102635,102135,8706,110841,1696
2021-05-20,Glenn,021,27897,2429,2406,559,2965,17
2021-05-20,Humboldt,023,135768,4209,4162,34,4196,42
2021-05-20,Imperial,025,180216,28587,28551,2746,31297,732
2021-05-20,Inyo,027,18085,1404,1402,13,1415,36
2021-05-20,Kern,029,883053,97228,96204,10921,107125,1317
2021-05-20,Kings,031,150075,23151,22922,1091,24013,246
2021-05-20,Lake,033,64148,3514,3500,9,3509,43
2021-05-20,Lassen,035,31185,5200,5160,112,5272,6
2021-05-20,Los Angeles,037,10098052,1205652,1197073,41289,1238362,24168
2021-05-20,Madera,039,155013,16606,16499,937,17436,238
2021-05-20,Marin,041,260295,14082,14036,256,14292,227
2021-05-20,Mariposa,043,17540,429,426,11,437,5
2021-05-20,Mendocino,045,87422,3974,3897,82,3979,47
2021-05-20,Merced,047,269075,30967,31046,1050,32096,454
2021-05-20,Modoc,049,8938,376,365,129,494,3
2021-05-20,Mono,051,14174,1259,1269,17,1286,3
2021-05-20,Monterey,053,433212,43147,42984,1869,44853,379
2021-05-20,Napa,055,140530,9894,9913,36,9949,82
2021-05-20,Nevada,057,99092,4804,4775,190,4965,70
2021-05-20,Orange,059,3164182,255230,254127,11384,265511,5038
2021-05-20,Placer,061,380077,23229,22823,1498,24321,292
2021-05-20,Plumas,063,18699,701,682,10,692,4
2021-05-20,Riverside,065,2383286,293965,288453,14028,302481,4442
2021-05-20,Sacramento,067,1510023,105722,105414,1745,107159,1629
2021-05-20,San Benito,069,59416,6057,6067,115,6182,63
2021-05-20,San Bernardino,071,2135413,293227,292153,8999,301152,4728
2021-05-20,San Diego,073,3302833,280382,279490,14904,294394,3749
2021-05-20,San Francisco,075,870044,36685,36860,1288,38148,546
2021-05-20,San Joaquin,077,732212,73010,72388,3548,75936,1371
2021-05-20,San Luis Obispo,079,281455,21357,21095,738,21833,256
2021-05-20,San Mateo,081,765935,42293,42152,473,42625,432
2021-05-20,Santa Barbara,083,443738,34422,34293,1137,35430,459
2021-05-20,Santa Clara,085,1922200,118505,119222,763,119985,2029
2021-05-20,Santa Cruz,087,273765,16222,16119,812,16931,207
2021-05-20,Shasta,089,179085,12243,12266,1561,13827,200
2021-05-20,Sierra,091,2930,56,54,12,66,0
2021-05-20,Siskiyou,093,43540,1912,1811,355,2166,16
2021-05-20,Solano,095,438530,32740,32725,555,33280,253
2021-05-20,Sonoma,097,501317,29987,30107,331,30438,321
2021-05-20,Stanislaus,099,539301,56214,55979,5946,61925,970
2021-05-20,Sutter,101,95872,9439,9467,87,9554,113
2021-05-20,Tehama,103,63373,5068,5029,572,5601,63
2021-05-20,Trinity,105,12862,483,329,92,421,3
2021-05-20,Tulare,107,460477,50192,49217,9021,58238,837
2021-05-20,Tuolumne,109,53932,4026,4077,40,4117,65
2021-05-20,Ventura,111,848112,81316,80800,2988,83788,1019
2021-05-20,Yolo,113,214977,14000,13973,314,14287,211
2021-05-20,Yuba,115,75493,6032,6002,124,6126,49
2021-05-19,Alameda,001,1643700,87978,87889,1954,89843,1260
2021-05-19,Alpine,003,1148,87,88,0,88,0
2021-05-19,Amador,005,37829,3669,3669,33,3702,46
2021-05-19,Butte,007,227075,12492,12198,1813,14011,188
2021-05-19,Calaveras,009,45235,2143,2132,13,2145,54
2021-05-19,Colusa,011,21464,1940,1945,305,2250,15
2021-05-19,Contra Costa,013,1133247,69370,68836,1272,70108,808
2021-05-19,Del Norte,015,27424,1410,1371,12,1383,8
2021-05-19,El Dorado,017,186661,10270,10179,745,10924,112
2021-05-19,Fresno,019,978130,102605,102085,8703,110788,1693
2021-05-19,Glenn,021,27897,2429,2404,559,2963,17
2021-05-19,Humboldt,023,135768,4199,4143,34,4177,42
2021-05-19,Imperial,025,180216,28578,28550,2746,31296,732
2021-05-19,Inyo,027,18085,1404,1402,13,1415,36
2021-05-19,Kern,029,883053,97199,96173,10913,107086,1316
2021-05-19,Kings,031,150075,23145,22919,1091,24010,246
2021-05-19,Lake,033,64148,3514,3497,9,3506,43
2021-05-19,Lassen,035,31185,5199,5157,112,5269,6
2021-05-19,Los Angeles,037,10098052,1205456,1196856,41275,1238131,24143
2021-05-19,Madera,039,155013,16603,16496,937,17433,238
2021-05-19,Marin,041,260295,14078,14033,254,14287,227
2021-05-19,Mariposa,043,17540,429,425,11,436,5
2021-05-19,Mendocino,045,87422,3970,3886,82,3968,47
2021-05-19,Merced,047,269075,30951,31044,1050,32094,452
2021-05-19,Modoc,049,8938,376,364,126,490,3
2021-05-19,Mono,051,14174,1259,1266,17,1283,3
2021-05-19,Monterey,053,433212,43142,42973,1868,44841,379
2021-05-19,Napa,055,140530,9891,9906,36,9942,82
2021-05-19,Nevada,057,99092,4802,4769,190,4959,70
2021-05-19,Orange,059,3164182,255193,254087,11374,265461,5035
2021-05-19,Placer,061,380077,23210,22784,1493,24277,291
2021-05-19,Plumas,063,18699,701,682,10,692,4
2021-05-19,Riverside,065,2383286,293918,288398,14026,302424,4442
2021-05-19,Sacramento,067,1510023,105645,105225,1744,106969,1629
2021-05-19,San Benito,069,59416,6056,6064,115,6179,63
2021-05-19,San Bernardino,071,2135413,293183,292078,8996,301074,4725
2021-05-19,San Diego,073,3302833,280297,279345,14883,294228,3746
2021-05-19,San Francisco,075,870044,36672,36835,1287,38122,546
2021-05-19,San Joaquin,077,732212,72967,72338,3543,75881,1369
2021-05-19,San Luis Obispo,079,281455,21349,21085,737,21822,256
2021-05-19,San Mateo,081,765935,42286,42126,473,42599,429
2021-05-19,Santa Barbara,083,443738,34414,34292,1137,35429,459
2021-05-19,Santa Clara,085,1922200,118465,119176,762,119938,2015
2021-05-19,Santa Cruz,087,273765,16218,16121,811,16932,207
2021-05-19,Shasta,089,179085,12225,12233,1558,13791,200
2021-05-19,Sierra,091,2930,56,54,12,66,0
2021-05-19,Siskiyou,093,43540,1909,1803,354,2157,16
2021-05-19,Solano,095,438530,32713,32678,553,33231,253
2021-05-19,Sonoma,097,501317,29972,30080,331,30411,321
2021-05-19,Stanislaus,099,539301,56196,55912,5941,61853,967
2021-05-19,Sutter,101,95872,9432,9459,86,9545,113
2021-05-19,Tehama,103,63373,5059,5026,567,5593,63
2021-05-19,Trinity,105,12862,483,329,92,421,3
2021-05-19,Tulare,107,460477,50179,49163,9016,58179,837
2021-05-19,Tuolumne,109,53932,4026,4074,40,4114,64
2021-05-19,Ventura,111,848112,81301,80747,2987,83734,1019
2021-05-19,Yolo,113,214977,13993,13961,313,14274,211
2021-05-19,Yuba,115,75493,6028,5993,124,6117,49
2021-05-18,Alameda,001,1643700,87904,87816,1954,89770,1254
2021-05-18,Alpine,003,1148,87,88,0,88,0
2021-05-18,Amador,005,37829,3669,3669,33,3702,46
2021-05-18,Butte,007,227075,12479,12164,1810,13974,191
2021-05-18,Calaveras,009,45235,2139,2131,13,2144,54
2021-05-18,Colusa,011,21464,1940,1943,305,2248,14
2021-05-18,Contra Costa,013,1133247,69313,68750,1271,70021,808
2021-05-18,Del Norte,015,27424,1407,1371,12,1383,8
2021-05-18,El Dorado,017,186661,10259,10169,744,10913,112
2021-05-18,Fresno,019,978130,102569,102056,8700,110756,1690
2021-05-18,Glenn,021,27897,2423,2403,558,2961,17
2021-05-18,Humboldt,023,135768,4180,4132,34,4166,42
2021-05-18,Imperial,025,180216,28573,28538,2744,31282,730
2021-05-18,Inyo,027,18085,1404,1401,13,1414,36
2021-05-18,Kern,029,883053,97165,96128,10899,107027,1315
2021-05-18,Kings,031,150075,23139,22916,1091,24007,247
2021-05-18,Lake,033,64148,3512,3495,9,3504,43
2021-05-18,Lassen,035,31185,5198,5157,111,5268,6
2021-05-18,Los Angeles,037,10098052,1205276,1196668,41264,1237932,24133
2021-05-18,Madera,039,155013,16593,16491,936,17427,238
2021-05-18,Marin,041,260295,14075,14026,254,14280,227
2021-05-18,Mariposa,043,17540,429,424,11,435,5
2021-05-18,Mendocino,045,87422,3958,3877,81,3958,47
2021-05-18,Merced,047,269075,30932,31036,1050,32086,452
2021-05-18,Modoc,049,8938,375,364,125,489,3
2021-05-18,Mono,051,14174,1258,1265,17,1282,3
2021-05-18,Monterey,053,433212,43136,43001,1868,44869,379
2021-05-18,Napa,055,140530,9891,9905,36,9941,82
2021-05-18,Nevada,057,99092,4795,4762,190,4952,70
2021-05-18,Orange,059,3164182,255152,254041,11364,265405,5031
2021-05-18,Placer,061,380077,23177,22726,1489,24215,291
2021-05-18,Plumas,063,18699,701,682,10,692,4
2021-05-18,Riverside,065,2383286,293863,288354,14019,302373,4438
2021-05-18,Sacramento,067,1510023,105543,105083,1742,106825,1629
2021-05-18,San Benito,069,59416,6055,6065,115,6180,63
2021-05-18,San Bernardino,071,2135413,293124,292014,8991,301005,4722
2021-05-18,San Diego,073,3302833,280189,279254,14874,294128,3742
2021-05-18,San Francisco,075,870044,36652,36818,1287,38105,546
2021-05-18,San Joaquin,077,732212,72920,72282,3539,75821,1368
2021-05-18,San Luis Obispo,079,281455,21339,21080,735,21815,256
2021-05-18,San Mateo,081,765935,42274,42099,472,42571,428
2021-05-18,Santa Barbara,083,443738,34405,34278,1137,35415,459
2021-05-18,Santa Clara,085,1922200,118438,119171,762,119933,2014
2021-05-18,Santa Cruz,087,273765,16210,16137,811,16948,207
2021-05-18,Shasta,089,179085,12207,12197,1552,13749,200
2021-05-18,Sierra,091,2930,56,54,12,66,0
2021-05-18,Siskiyou,093,43540,1908,1799,354,2153,16
2021-05-18,Solano,095,438530,32688,32644,553,33197,253
2021-05-18,Sonoma,097,501317,29952,30054,330,30384,321
2021-05-18,Stanislaus,099,539301,56161,55860,5941,61801,959
2021-05-18,Sutter,101,95872,9424,9453,86,9539,113
2021-05-18,Tehama,103,63373,5053,5020,565,5585,63
2021-05-18,Trinity,105,12862,483,329,91,420,3
2021-05-18,Tulare,107,460477,50171,49142,9011,58153,836
2021-05-18,Tuolumne,109,53932,4024,4073,40,4113,64
2021-05-18,Ventura,111,848112,81285,80726,2984,83710,1017
2021-05-18,Yolo,113,214977,13986,13951,312,14263,211
2021-05-18,Yuba,115,75493,6024,5989,123,6112,49
2021-05-17,Alameda,001,1643700,87851,87766,1951,89717,1253
2021-05-17,Alpine,003,1148,87,88,0,88,0
2021-05-17,Amador,005,37829,3666,3668,33,3701,46
2021-05-17,Butte,007,227075,12471,12144,1810,13954,192
2021-05-17,Calaveras,009,45235,2139,2131,13,2144,53
2021-05-17,Colusa,011,21464,1940,1943,305,2248,14
2021-05-17,Contra Costa,013,1133247,69258,68720,1270,69990,805
2021-05-17,Del Norte,015,27424,1402,1369,12,1381,8
2021-05-17,El Dorado,017,186661,10242,10163,744,10907,112
2021-05-17,Fresno,019,978130,102525,102013,8692,110705,1690
2021-05-17,Glenn,021,27897,2423,2401,558,2959,17
2021-05-17,Humboldt,023,135768,4169,4112,34,4146,42
2021-05-17,Imperial,025,180216,28567,28533,2742,31275,729
2021-05-17,Inyo,027,18085,1404,1401,13,1414,36
2021-05-17,Kern,029,883053,97136,96095,10882,106977,1315
2021-05-17,Kings,031,150075,23136,22918,1091,24009,246
2021-05-17,Lake,033,64148,3507,3489,9,3498,43
2021-05-17,Lassen,035,31185,5195,5156,110,5266,6
2021-05-17,Los Angeles,037,10098052,1205097,1196556,41258,1237814,24123
2021-05-17,Madera,039,155013,16586,16486,936,17422,238
2021-05-17,Marin,041,260295,14069,14021,254,14275,227
2021-05-17,Mariposa,043,17540,428,423,11,434,5
2021-05-17,Mendocino,045,87422,3949,3868,81,3949,46
2021-05-17,Merced,047,269075,30917,31031,1050,32081,450
2021-05-17,Modoc,049,8938,374,362,125,487,3
2021-05-17,Mono,051,14174,1254,1265,17,1282,3
2021-05-17,Monterey,053,433212,43129,42995,1868,44863,379
2021-05-17,Napa,055,140530,9890,9894,36,9930,82
2021-05-17,Nevada,057,99092,4791,4761,189,4950,70
2021-05-17,Orange,059,3164182,255105,253993,11357,265350,5031
2021-05-17,Placer,061,380077,23154,22706,1482,24188,289
2021-05-17,Plumas,063,18699,701,682,10,692,4
2021-05-17,Riverside,065,2383286,293794,288304,14015,302319,4433
2021-05-17,Sacramento,067,1510023,105435,105035,1740,106775,1629
2021-05-17,San Benito,069,59416,6052,6067,115,6182,63
2021-05-17,San Bernardino,071,2135413,293075,291989,8983,300972,4724
2021-05-17,San Diego,073,3302833,280057,279146,14852,293998,3742
2021-05-17,San Francisco,075,870044,36640,36816,1285,38101,546
2021-05-17,San Joaquin,077,732212,72882,72234,3536,75770,1359
2021-05-17,San Luis Obispo,079,281455,21330,21079,733,21812,256
2021-05-17,San Mateo,081,765935,42246,42083,472,42555,428
2021-05-17,Santa Barbara,083,443738,34398,34275,1137,35412,459
2021-05-17,Santa Clara,085,1922200,118401,119116,760,119876,2015
2021-05-17,Santa Cruz,087,273765,16207,16151,811,16962,206
2021-05-17,Shasta,089,179085,12185,12163,1551,13714,200
2021-05-17,Sierra,091,2930,56,54,12,66,0
2021-05-17,Siskiyou,093,43540,1899,1795,351,2146,15
2021-05-17,Solano,095,438530,32670,32627,552,33179,253
2021-05-17,Sonoma,097,501317,29929,30043,329,30372,321
2021-05-17,Stanislaus,099,539301,56115,55839,5934,61773,951
2021-05-17,Sutter,101,95872,9417,9447,86,9533,113
2021-05-17,Tehama,103,63373,5049,5016,564,5580,63
2021-05-17,Trinity,105,12862,483,328,91,419,3
2021-05-17,Tulare,107,460477,50149,49107,9006,58113,836
2021-05-17,Tuolumne,109,53932,4024,4071,40,4111,64
2021-05-17,Ventura,111,848112,81265,80699,2984,83683,1017
2021-05-17,Yolo,113,214977,13979,13941,312,14253,211
2021-05-17,Yuba,115,75493,6016,5987,123,6110,49
2021-05-16,Alameda,001,1643700,87787,87743,1951,89694,1253
2021-05-16,Alpine,003,1148,87,88,0,88,0
2021-05-16,Amador,005,37829,3665,3667,33,3700,46
2021-05-16,Butte,007,227075,12457,12140,1809,13949,192
2021-05-16,Calaveras,009,45235,2137,2129,13,2142,53
2021-05-16,Colusa,011,21464,1938,1943,305,2248,14
2021-05-16,Contra Costa,013,1133247,69190,68694,1267,69961,805
2021-05-16,Del Norte,015,27424,1399,1365,12,1377,8
2021-05-16,El Dorado,017,186661,10226,10159,743,10902,112
2021-05-16,Fresno,019,978130,102481,101987,8686,110673,1690
2021-05-16,Glenn,021,27897,2423,2401,557,2958,17
2021-05-16,Humboldt,023,135768,4154,4104,34,4138,42
2021-05-16,Imperial,025,180216,28556,28516,2741,31257,729
2021-05-16,Inyo,027,18085,1404,1401,13,1414,36
2021-05-16,Kern,029,883053,97103,96083,10862,106945,1315
2021-05-16,Kings,031,150075,23132,22918,1088,24006,246
2021-05-16,Lake,033,64148,3504,3489,9,3498,43
2021-05-16,Lassen,035,31185,5194,5156,110,5266,6
2021-05-16,Los Angeles,037,10098052,1204873,1196397,41242,1237639,24120
2021-05-16,Madera,039,155013,16581,16483,933,17416,238
2021-05-16,Marin,041,260295,14066,14015,254,14269,227
2021-05-16,Mariposa,043,17540,428,423,11,434,5
2021-05-16,Mendocino,045,87422,3939,3863,81,3944,46
2021-05-16,Merced,047,269075,30896,31023,1048,32071,450
2021-05-16,Modoc,049,8938,374,362,125,487,3
2021-05-16,Mono,051,14174,1254,1265,17,1282,3
2021-05-16,Monterey,053,433212,43124,42991,1868,44859,379
2021-05-16,Napa,055,140530,9887,9891,36,9927,82
2021-05-16,Nevada,057,99092,4787,4755,189,4944,70
2021-05-16,Orange,059,3164182,255073,253962,11354,265316,5031
2021-05-16,Placer,061,380077,23122,22696,1476,24172,289
2021-05-16,Plumas,063,18699,700,682,10,692,4
2021-05-16,Riverside,065,2383286,293718,288259,14007,302266,4433
2021-05-16,Sacramento,067,1510023,105321,105013,1738,106751,1628
2021-05-16,San Benito,069,59416,6051,6067,114,6181,63
2021-05-16,San Bernardino,071,2135413,293003,291940,8981,300921,4724
2021-05-16,San Diego,073,3302833,279939,279099,14839,293938,3742
2021-05-16,San Francisco,075,870044,36617,36808,1284,38092,546
2021-05-16,San Joaquin,077,732212,72833,72218,3531,75749,1359
2021-05-16,San Luis Obispo,079,281455,21322,21072,731,21803,256
2021-05-16,San Mateo,081,765935,42235,42063,471,42534,428
2021-05-16,Santa Barbara,083,443738,34391,34270,1137,35407,459
2021-05-16,Santa Clara,085,1922200,118372,119098,759,119857,2015
2021-05-16,Santa Cruz,087,273765,16205,16143,811,16954,206
2021-05-16,Shasta,089,179085,12169,12156,1547,13703,200
2021-05-16,Sierra,091,2930,56,54,12,66,0
2021-05-16,Siskiyou,093,43540,1895,1790,350,2140,15
2021-05-16,Solano,095,438530,32637,32619,550,33169,253
2021-05-16,Sonoma,097,501317,29910,30033,329,30362,321
2021-05-16,Stanislaus,099,539301,56066,55814,5922,61736,951
2021-05-16,Sutter,101,95872,9410,9445,86,9531,113
2021-05-16,Tehama,103,63373,5045,5013,563,5576,63
2021-05-16,Trinity,105,12862,483,328,91,419,3
2021-05-16,Tulare,107,460477,50132,49091,9003,58094,837
2021-05-16,Tuolumne,109,53932,4020,4070,40,4110,64
2021-05-16,Ventura,111,848112,81234,80689,2984,83673,1017
2021-05-16,Yolo,113,214977,13964,13938,312,14250,211
2021-05-16,Yuba,115,75493,6013,5987,123,6110,49
2021-05-15,Alameda,001,1643700,87761,87677,1950,89627,1252
2021-05-15,Alpine,003,1148,87,88,0,88,0
2021-05-15,Amador,005,37829,3665,3666,33,3699,46
2021-05-15,Butte,007,227075,12450,12095,1808,13903,192
2021-05-15,Calaveras,009,45235,2136,2126,13,2139,53
2021-05-15,Colusa,011,21464,1938,1941,303,2244,14
2021-05-15,Contra Costa,013,1133247,69144,68658,1267,69925,805
2021-05-15,Del Norte,015,27424,1394,1359,12,1371,8
2021-05-15,El Dorado,017,186661,10214,10156,742,10898,112
2021-05-15,Fresno,019,978130,102444,101957,8683,110640,1690
2021-05-15,Glenn,021,27897,2423,2400,557,2957,17
2021-05-15,Humboldt,023,135768,4144,4080,34,4114,42
2021-05-15,Imperial,025,180216,28553,28504,2740,31244,729
2021-05-15,Inyo,027,18085,1404,1402,13,1415,36
2021-05-15,Kern,029,883053,97089,96061,10847,106908,1315
2021-05-15,Kings,031,150075,23131,22913,1088,24001,246
2021-05-15,Lake,033,64148,3503,3485,9,3494,43
2021-05-15,Lassen,035,31185,5191,5156,109,5265,6
2021-05-15,Los Angeles,037,10098052,1204749,1196255,41229,1237484,24115
2021-05-15,Madera,039,155013,16578,16482,933,17415,238
2021-05-15,Marin,041,260295,14062,14012,254,14266,227
2021-05-15,Mariposa,043,17540,428,423,11,434,5
2021-05-15,Mendocino,045,87422,3936,3861,81,3942,46
2021-05-15,Merced,047,269075,30875,31012,1048,32060,450
2021-05-15,Modoc,049,8938,374,362,125,487,3
2021-05-15,Mono,051,14174,1254,1265,17,1282,3
2021-05-15,Monterey,053,433212,43120,42982,1868,44850,379
2021-05-15,Napa,055,140530,9884,9887,36,9923,82
2021-05-15,Nevada,057,99092,4786,4755,189,4944,70
2021-05-15,Orange,059,3164182,255046,253919,11347,265266,5030
2021-05-15,Placer,061,380077,23101,22688,1476,24164,289
2021-05-15,Plumas,063,18699,700,681,10,691,4
2021-05-15,Riverside,065,2383286,293676,288203,14002,302205,4433
2021-05-15,Sacramento,067,1510023,105249,104929,1735,106664,1628
2021-05-15,San Benito,069,59416,6051,6066,114,6180,63
2021-05-15,San Bernardino,071,2135413,292961,291892,8979,300871,4724
2021-05-15,San Diego,073,3302833,279868,278991,14824,293815,3737
2021-05-15,San Francisco,075,870044,36601,36795,1282,38077,546
2021-05-15,San Joaquin,077,732212,72807,72197,3529,75726,1359
2021-05-15,San Luis Obispo,079,281455,21319,21061,730,21791,256
2021-05-15,San Mateo,081,765935,42219,42059,471,42530,428
2021-05-15,Santa Barbara,083,443738,34383,34259,1137,35396,459
2021-05-15,Santa Clara,085,1922200,118351,119060,759,119819,2016
2021-05-15,Santa Cruz,087,273765,16201,16137,811,16948,206
2021-05-15,Shasta,089,179085,12157,12152,1544,13696,200
2021-05-15,Sierra,091,2930,56,54,12,66,0
2021-05-15,Siskiyou,093,43540,1889,1788,348,2136,15
2021-05-15,Solano,095,438530,32628,32604,549,33153,253
2021-05-15,Sonoma,097,501317,29891,30020,329,30349,321
2021-05-15,Stanislaus,099,539301,56035,55795,5915,61710,952
2021-05-15,Sutter,101,95872,9408,9436,86,9522,113
2021-05-15,Tehama,103,63373,5041,5012,562,5574,63
2021-05-15,Trinity,105,12862,483,328,91,419,3
2021-05-15,Tulare,107,460477,50122,49080,8999,58079,837
2021-05-15,Tuolumne,109,53932,4018,4064,40,4104,63
2021-05-15,Ventura,111,848112,81223,80662,2984,83646,1017
2021-05-15,Yolo,113,214977,13957,13932,311,14243,211
2021-05-15,Yuba,115,75493,6010,5979,122,6101,49
2021-05-14,Alameda,001,1643700,87727,87621,1947,89568,1249
2021-05-14,Alpine,003,1148,87,88,0,88,0
2021-05-14,Amador,005,37829,3665,3665,33,3698,46
2021-05-14,Butte,007,227075,12441,12076,1805,13881,192
2021-05-14,Calaveras,009,45235,2132,2121,13,2134,53
2021-05-14,Colusa,011,21464,1937,1940,302,2242,14
2021-05-14,Contra Costa,013,1133247,69102,68589,1265,69854,806
2021-05-14,Del Norte,015,27424,1394,1355,12,1367,8
2021-05-14,El Dorado,017,186661,10207,10143,741,10884,113
2021-05-14,Fresno,019,978130,102415,101917,8677,110594,1688
2021-05-14,Glenn,021,27897,2422,2398,557,2955,17
2021-05-14,Humboldt,023,135768,4137,4050,34,4084,37
2021-05-14,Imperial,025,180216,28546,28485,2739,31224,728
2021-05-14,Inyo,027,18085,1404,1400,13,1413,36
2021-05-14,Kern,029,883053,97059,96033,10838,106871,1311
2021-05-14,Kings,031,150075,23130,22910,1088,23998,246
2021-05-14,Lake,033,64148,3499,3483,9,3492,43
2021-05-14,Lassen,035,31185,5191,5154,109,5263,6
2021-05-14,Los Angeles,037,10098052,1204615,1196038,41224,1237262,24101
2021-05-14,Madera,039,155013,16575,16474,933,17407,238
2021-05-14,Marin,041,260295,14058,14010,254,14264,227
2021-05-14,Mariposa,043,17540,428,422,11,433,5
2021-05-14,Mendocino,045,87422,3934,3855,81,3936,46
2021-05-14,Merced,047,269075,30865,31010,1048,32058,450
2021-05-14,Modoc,049,8938,374,362,125,487,3
2021-05-14,Mono,051,14174,1253,1265,17,1282,3
2021-05-14,Monterey,053,433212,43115,42973,1868,44841,380
2021-05-14,Napa,055,140530,9881,9883,36,9919,82
2021-05-14,Nevada,057,99092,4781,4745,189,4934,70
2021-05-14,Orange,059,3164182,255012,253855,11340,265195,5028
2021-05-14,Placer,061,380077,23082,22660,1470,24130,287
2021-05-14,Plumas,063,18699,699,680,10,690,4
2021-05-14,Riverside,065,2383286,293626,288140,13999,302139,4433
2021-05-14,Sacramento,067,1510023,105160,104828,1734,106562,1627
2021-05-14,San Benito,069,59416,6051,6064,114,6178,63
2021-05-14,San Bernardino,071,2135413,292913,291834,8979,300813,4721
2021-05-14,San Diego,073,3302833,279795,278853,14813,293666,3732
2021-05-14,San Francisco,075,870044,36592,36771,1278,38049,545
2021-05-14,San Joaquin,077,732212,72775,72160,3522,75682,1359
2021-05-14,San Luis Obispo,079,281455,21315,21051,730,21781,256
2021-05-14,San Mateo,081,765935,42209,42041,471,42512,428
2021-05-14,Santa Barbara,083,443738,34373,34243,1137,35380,456
2021-05-14,Santa Clara,085,1922200,118322,119006,759,119765,2014
2021-05-14,Santa Cruz,087,273765,16196,16130,811,16941,207
2021-05-14,Shasta,089,179085,12151,12130,1539,13669,200
2021-05-14,Sierra,091,2930,56,54,12,66,0
2021-05-14,Siskiyou,093,43540,1882,1779,347,2126,14
2021-05-14,Solano,095,438530,32608,32585,548,33133,252
2021-05-14,Sonoma,097,501317,29872,30007,329,30336,321
2021-05-14,Stanislaus,099,539301,56002,55752,5909,61661,950
2021-05-14,Sutter,101,95872,9399,9433,84,9517,113
2021-05-14,Tehama,103,63373,5034,5005,562,5567,63
2021-05-14,Trinity,105,12862,483,328,91,419,3
2021-05-14,Tulare,107,460477,50105,49060,8994,58054,836
2021-05-14,Tuolumne,109,53932,4018,4060,40,4100,63
2021-05-14,Ventura,111,848112,81209,80628,2984,83612,1014
2021-05-14,Yolo,113,214977,13952,13922,307,14229,210
2021-05-14,Yuba,115,75493,6006,5970,122,6092,47
2021-05-13,Alameda,001,1643700,87684,87557,1946,89503,1250
2021-05-13,Alpine,003,1148,87,88,0,88,0
2021-05-13,Amador,005,37829,3665,3662,33,3695,46
2021-05-13,Butte,007,227075,12426,12051,1804,13855,196
2021-05-13,Calaveras,009,45235,2132,2120,13,2133,53
2021-05-13,Colusa,011,21464,1936,1939,298,2237,14
2021-05-13,Contra Costa,013,1133247,69054,68522,1264,69786,806
2021-05-13,Del Norte,015,27424,1392,1354,12,1366,8
2021-05-13,El Dorado,017,186661,10204,10133,741,10874,112
2021-05-13,Fresno,019,978130,102386,101862,8676,110538,1687
2021-05-13,Glenn,021,27897,2421,2395,557,2952,17
2021-05-13,Humboldt,023,135768,4119,4027,34,4061,37
2021-05-13,Imperial,025,180216,28531,28468,2737,31205,729
2021-05-13,Inyo,027,18085,1404,1400,13,1413,36
2021-05-13,Kern,029,883053,97035,95996,10820,106816,1311
2021-05-13,Kings,031,150075,23129,22904,1088,23992,246
2021-05-13,Lake,033,64148,3498,3479,9,3488,43
2021-05-13,Lassen,035,31185,5191,5152,108,5260,6
2021-05-13,Los Angeles,037,10098052,1204426,1195504,41210,1236714,24083
2021-05-13,Madera,039,155013,16567,16467,933,17400,238
2021-05-13,Marin,041,260295,14053,14004,252,14256,227
2021-05-13,Mariposa,043,17540,428,422,11,433,5
2021-05-13,Mendocino,045,87422,3930,3846,81,3927,46
2021-05-13,Merced,047,269075,30858,30989,1047,32036,450
2021-05-13,Modoc,049,8938,374,362,125,487,3
2021-05-13,Mono,051,14174,1253,1265,17,1282,3
2021-05-13,Monterey,053,433212,43100,42966,1868,44834,380
2021-05-13,Napa,055,140530,9874,9877,36,9913,82
2021-05-13,Nevada,057,99092,4777,4743,188,4931,70
2021-05-13,Orange,059,3164182,254967,253778,11338,265116,5026
2021-05-13,Placer,061,380077,23055,22668,1463,24131,288
2021-05-13,Plumas,063,18699,699,680,10,690,4
2021-05-13,Riverside,065,2383286,293560,288067,13994,302061,4433
2021-05-13,Sacramento,067,1510023,105074,104711,1732,106443,1626
2021-05-13,San Benito,069,59416,6049,6062,114,6176,63
2021-05-13,San Bernardino,071,2135413,292847,291765,8979,300744,4722
2021-05-13,San Diego,073,3302833,279681,278592,14796,293388,3729
2021-05-13,San Francisco,075,870044,36568,36741,1276,38017,544
2021-05-13,San Joaquin,077,732212,72733,72096,3518,75614,1357
2021-05-13,San Luis Obispo,079,281455,21300,21043,729,21772,255
2021-05-13,San Mateo,081,765935,42192,42059,471,42530,426
2021-05-13,Santa Barbara,083,443738,34361,34242,1137,35379,456
2021-05-13,Santa Clara,085,1922200,118295,118952,759,119711,2013
2021-05-13,Santa Cruz,087,273765,16190,16129,811,16940,208
2021-05-13,Shasta,089,179085,12131,12111,1535,13646,200
2021-05-13,Sierra,091,2930,56,54,12,66,0
2021-05-13,Siskiyou,093,43540,1875,1769,344,2113,14
2021-05-13,Solano,095,438530,32595,32548,546,33094,252
2021-05-13,Sonoma,097,501317,29847,29991,329,30320,321
2021-05-13,Stanislaus,099,539301,55965,55678,5903,61581,949
2021-05-13,Sutter,101,95872,9394,9431,83,9514,112
2021-05-13,Tehama,103,63373,5029,4997,562,5559,63
2021-05-13,Trinity,105,12862,482,327,90,417,3
2021-05-13,Tulare,107,460477,50079,49032,8986,58018,837
2021-05-13,Tuolumne,109,53932,4017,4059,40,4099,63
2021-05-13,Ventura,111,848112,81179,80615,2983,83598,1012
2021-05-13,Yolo,113,214977,13943,13914,305,14219,210
2021-05-13,Yuba,115,75493,5997,5962,122,6084,47
2021-05-12,Alameda,001,1643700,87652,87482,1944,89426,1261
2021-05-12,Alpine,003,1148,87,88,0,88,0
2021-05-12,Amador,005,37829,3665,3658,33,3691,46
2021-05-12,Butte,007,227075,12416,12026,1804,13830,199
2021-05-12,Calaveras,009,45235,2129,2119,13,2132,53
2021-05-12,Colusa,011,21464,1934,1939,297,2236,14
2021-05-12,Contra Costa,013,1133247,68995,68462,1258,69720,805
2021-05-12,Del Norte,015,27424,1390,1352,12,1364,8
2021-05-12,El Dorado,017,186661,10195,10123,741,10864,112
2021-05-12,Fresno,019,978130,102337,101838,8665,110503,1688
2021-05-12,Glenn,021,27897,2418,2391,557,2948,17
2021-05-12,Humboldt,023,135768,4091,3982,34,4016,37
2021-05-12,Imperial,025,180216,28513,28443,2734,31177,726
2021-05-12,Inyo,027,18085,1404,1400,13,1413,36
2021-05-12,Kern,029,883053,96999,95955,10813,106768,1310
2021-05-12,Kings,031,150075,23127,22896,1088,23984,246
2021-05-12,Lake,033,64148,3496,3476,9,3485,43
2021-05-12,Lassen,035,31185,5189,5151,108,5259,6
2021-05-12,Los Angeles,037,10098052,1204243,1195318,41193,1236511,24067
2021-05-12,Madera,039,155013,16560,16462,932,17394,238
2021-05-12,Marin,041,260295,14048,13997,252,14249,227
2021-05-12,Mariposa,043,17540,428,422,11,433,5
2021-05-12,Mendocino,045,87422,3920,3836,81,3917,46
2021-05-12,Merced,047,269075,30842,30941,1047,31988,450
2021-05-12,Modoc,049,8938,373,362,125,487,3
2021-05-12,Mono,051,14174,1253,1265,17,1282,3
2021-05-12,Monterey,053,433212,43088,42950,1867,44817,380
2021-05-12,Napa,055,140530,9868,9870,36,9906,82
2021-05-12,Nevada,057,99092,4773,4738,188,4926,70
2021-05-12,Orange,059,3164182,254916,253587,11334,264921,5024
2021-05-12,Placer,061,380077,23037,22652,1456,24108,288
2021-05-12,Plumas,063,18699,699,681,10,691,4
2021-05-12,Riverside,065,2383286,293490,287830,13990,301820,4431
2021-05-12,Sacramento,067,1510023,104978,104592,1730,106322,1621
2021-05-12,San Benito,069,59416,6049,6062,114,6176,63
2021-05-12,San Bernardino,071,2135413,292799,291505,8974,300479,4715
2021-05-12,San Diego,073,3302833,279577,278402,14775,293177,3729
2021-05-12,San Francisco,075,870044,36548,36720,1275,37995,544
2021-05-12,San Joaquin,077,732212,72679,72043,3514,75557,1356
2021-05-12,San Luis Obispo,079,281455,21290,21021,729,21750,255
2021-05-12,San Mateo,081,765935,42183,42038,469,42507,426
2021-05-12,Santa Barbara,083,443738,34353,34218,1137,35355,456
2021-05-12,Santa Clara,085,1922200,118251,118897,759,119656,2005
2021-05-12,Santa Cruz,087,273765,16184,16123,811,16934,207
2021-05-12,Shasta,089,179085,12111,12092,1533,13625,200
2021-05-12,Sierra,091,2930,56,54,12,66,0
2021-05-12,Siskiyou,093,43540,1871,1760,343,2103,13
2021-05-12,Solano,095,438530,32571,32519,546,33065,252
2021-05-12,Sonoma,097,501317,29835,29976,329,30305,320
2021-05-12,Stanislaus,099,539301,55925,55632,5896,61528,919
2021-05-12,Sutter,101,95872,9391,9427,83,9510,112
2021-05-12,Tehama,103,63373,5024,4989,562,5551,62
2021-05-12,Trinity,105,12862,482,327,90,417,3
2021-05-12,Tulare,107,460477,50063,49001,8978,57979,838
2021-05-12,Tuolumne,109,53932,4016,4056,40,4096,63
2021-05-12,Ventura,111,848112,81160,80577,2983,83560,1010
2021-05-12,Yolo,113,214977,13935,13910,304,14214,210
2021-05-12,Yuba,115,75493,5994,5956,122,6078,47
2021-05-11,Alameda,001,1643700,87587,87413,1940,89353,1290
2021-05-11,Alpine,003,1148,87,88,0,88,0
2021-05-11,Amador,005,37829,3663,3657,33,3690,46
2021-05-11,Butte,007,227075,12401,12008,1801,13809,199
2021-05-11,Calaveras,009,45235,2129,2118,13,2131,52
2021-05-11,Colusa,011,21464,1933,1939,297,2236,14
2021-05-11,Contra Costa,013,1133247,68935,68406,1257,69663,806
2021-05-11,Del Norte,015,27424,1388,1347,12,1359,8
2021-05-11,El Dorado,017,186661,10189,10108,740,10848,112
2021-05-11,Fresno,019,978130,102291,101792,8660,110452,1686
2021-05-11,Glenn,021,27897,2417,2387,556,2943,17
2021-05-11,Humboldt,023,135768,4070,3964,33,3997,37
2021-05-11,Imperial,025,180216,28505,28413,2730,31143,722
2021-05-11,Inyo,027,18085,1403,1402,13,1415,36
2021-05-11,Kern,029,883053,96971,95938,10800,106738,1310
2021-05-11,Kings,031,150075,23119,22887,1088,23975,246
2021-05-11,Lake,033,64148,3496,3473,9,3482,43
2021-05-11,Lassen,035,31185,5187,5148,108,5256,6
2021-05-11,Los Angeles,037,10098052,1204002,1195100,41176,1236276,24048
2021-05-11,Madera,039,155013,16556,16459,931,17390,238
2021-05-11,Marin,041,260295,14041,13987,252,14239,227
2021-05-11,Mariposa,043,17540,428,421,11,432,5
2021-05-11,Mendocino,045,87422,3912,3821,81,3902,46
2021-05-11,Merced,047,269075,30833,30893,1047,31940,449
2021-05-11,Modoc,049,8938,373,362,124,486,3
2021-05-11,Mono,051,14174,1253,1265,17,1282,3
2021-05-11,Monterey,053,433212,43080,42934,1866,44800,380
2021-05-11,Napa,055,140530,9861,9870,36,9906,81
2021-05-11,Nevada,057,99092,4769,4737,188,4925,70
2021-05-11,Orange,059,3164182,254853,253545,11326,264871,5017
2021-05-11,Placer,061,380077,23015,22615,1452,24067,287
2021-05-11,Plumas,063,18699,697,679,10,689,4
2021-05-11,Riverside,065,2383286,293428,287757,13985,301742,4429
2021-05-11,Sacramento,067,1510023,104879,104496,1727,106223,1616
2021-05-11,San Benito,069,59416,6046,6058,114,6172,63
2021-05-11,San Bernardino,071,2135413,292739,291421,8972,300393,4707
2021-05-11,San Diego,073,3302833,279442,278308,14756,293064,3725
2021-05-11,San Francisco,075,870044,36528,36707,1275,37982,543
2021-05-11,San Joaquin,077,732212,72631,71999,3511,75510,1356
2021-05-11,San Luis Obispo,079,281455,21283,21008,727,21735,255
2021-05-11,San Mateo,081,765935,42164,41985,468,42453,425
2021-05-11,Santa Barbara,083,443738,34343,34207,1137,35344,456
2021-05-11,Santa Clara,085,1922200,118204,118857,758,119615,2005
2021-05-11,Santa Cruz,087,273765,16180,16113,811,16924,206
2021-05-11,Shasta,089,179085,12088,12050,1527,13577,200
2021-05-11,Sierra,091,2930,56,54,12,66,0
2021-05-11,Siskiyou,093,43540,1861,1756,341,2097,13
2021-05-11,Solano,095,438530,32553,32499,544,33043,250
2021-05-11,Sonoma,097,501317,29820,29966,329,30295,318
2021-05-11,Stanislaus,099,539301,55878,55589,5892,61481,909
2021-05-11,Sutter,101,95872,9384,9417,83,9500,112
2021-05-11,Tehama,103,63373,5020,4985,561,5546,62
2021-05-11,Trinity,105,12862,482,327,89,416,3
2021-05-11,Tulare,107,460477,50035,48974,8964,57938,837
2021-05-11,Tuolumne,109,53932,4015,4056,40,4096,63
2021-05-11,Ventura,111,848112,81136,80544,2980,83524,1008
2021-05-11,Yolo,113,214977,13921,13902,301,14203,210
2021-05-11,Yuba,115,75493,5985,5950,122,6072,46
2021-05-10,Alameda,001,1643700,87517,87366,1939,89305,1284
2021-05-10,Alpine,003,1148,87,88,0,88,0
2021-05-10,Amador,005,37829,3662,3657,33,3690,46
2021-05-10,Butte,007,227075,12385,11993,1797,13790,199
2021-05-10,Calaveras,009,45235,2122,2118,13,2131,52
2021-05-10,Colusa,011,21464,1933,1939,297,2236,14
2021-05-10,Contra Costa,013,1133247,68871,68357,1257,69614,806
2021-05-10,Del Norte,015,27424,1385,1339,12,1351,8
2021-05-10,El Dorado,017,186661,10175,10093,740,10833,113
2021-05-10,Fresno,019,978130,102259,101755,8653,110408,1682
2021-05-10,Glenn,021,27897,2416,2384,555,2939,17
2021-05-10,Humboldt,023,135768,4040,3961,33,3994,36
2021-05-10,Imperial,025,180216,28491,28397,2726,31123,722
2021-05-10,Inyo,027,18085,1403,1401,13,1414,36
2021-05-10,Kern,029,883053,96927,95920,10786,106706,1310
2021-05-10,Kings,031,150075,23108,22884,1087,23971,246
2021-05-10,Lake,033,64148,3488,3471,9,3480,43
2021-05-10,Lassen,035,31185,5183,5148,108,5256,5
2021-05-10,Los Angeles,037,10098052,1203736,1194976,41160,1236136,24030
2021-05-10,Madera,039,155013,16546,16450,931,17381,238
2021-05-10,Marin,041,260295,14038,13981,252,14233,228
2021-05-10,Mariposa,043,17540,427,420,11,431,5
2021-05-10,Mendocino,045,87422,3906,3818,81,3899,46
2021-05-10,Merced,047,269075,30823,30880,1047,31927,448
2021-05-10,Modoc,049,8938,373,361,124,485,3
2021-05-10,Mono,051,14174,1253,1265,17,1282,3
2021-05-10,Monterey,053,433212,43074,42927,1861,44788,380
2021-05-10,Napa,055,140530,9859,9860,36,9896,81
2021-05-10,Nevada,057,99092,4762,4735,188,4923,70
2021-05-10,Orange,059,3164182,254800,253484,11320,264804,5008
2021-05-10,Placer,061,380077,22993,22590,1449,24039,286
2021-05-10,Plumas,063,18699,696,679,10,689,4
2021-05-10,Riverside,065,2383286,293359,287689,13979,301668,4427
2021-05-10,Sacramento,067,1510023,104766,104378,1722,106100,1613
2021-05-10,San Benito,069,59416,6045,6058,114,6172,63
2021-05-10,San Bernardino,071,2135413,292687,291360,8971,300331,4707
2021-05-10,San Diego,073,3302833,279278,278183,14729,292912,3725
2021-05-10,San Francisco,075,870044,36509,36683,1275,37958,543
2021-05-10,San Joaquin,077,732212,72594,71954,3496,75450,1356
2021-05-10,San Luis Obispo,079,281455,21265,20993,726,21719,256
2021-05-10,San Mateo,081,765935,42147,41926,468,42394,424
2021-05-10,Santa Barbara,083,443738,34335,34201,1137,35338,456
2021-05-10,Santa Clara,085,1922200,118145,118822,758,119580,2003
2021-05-10,Santa Cruz,087,273765,16175,16114,811,16925,206
2021-05-10,Shasta,089,179085,12074,12036,1523,13559,200
2021-05-10,Sierra,091,2930,56,54,12,66,0
2021-05-10,Siskiyou,093,43540,1851,1752,339,2091,13
2021-05-10,Solano,095,438530,32533,32466,542,33008,250
2021-05-10,Sonoma,097,501317,29805,29955,328,30283,318
2021-05-10,Stanislaus,099,539301,55803,55541,5886,61427,898
2021-05-10,Sutter,101,95872,9378,9412,83,9495,111
2021-05-10,Tehama,103,63373,5016,4980,561,5541,62
2021-05-10,Trinity,105,12862,482,327,87,414,3
2021-05-10,Tulare,107,460477,50012,48956,8958,57914,837
2021-05-10,Tuolumne,109,53932,4011,4054,39,4093,63
2021-05-10,Ventura,111,848112,81120,80501,2978,83479,1008
2021-05-10,Yolo,113,214977,13909,13898,299,14197,209
2021-05-10,Yuba,115,75493,5983,5942,122,6064,46
2021-05-09,Alameda,001,1643700,87446,87292,1936,89228,1284
2021-05-09,Alpine,003,1148,87,88,0,88,0
2021-05-09,Amador,005,37829,3660,3655,33,3688,46
2021-05-09,Butte,007,227075,12367,11985,1793,13778,199
2021-05-09,Calaveras,009,45235,2121,2116,13,2129,52
2021-05-09,Colusa,011,21464,1932,1940,297,2237,14
2021-05-09,Contra Costa,013,1133247,68808,68302,1255,69557,806
2021-05-09,Del Norte,015,27424,1378,1338,12,1350,8
2021-05-09,El Dorado,017,186661,10161,10089,737,10826,113
2021-05-09,Fresno,019,978130,102221,101729,8644,110373,1682
2021-05-09,Glenn,021,27897,2409,2382,552,2934,17
2021-05-09,Humboldt,023,135768,4020,3950,33,3983,36
2021-05-09,Imperial,025,180216,28468,28388,2718,31106,722
2021-05-09,Inyo,027,18085,1403,1401,12,1413,36
2021-05-09,Kern,029,883053,96899,95903,10776,106679,1310
2021-05-09,Kings,031,150075,23099,22878,1087,23965,246
2021-05-09,Lake,033,64148,3484,3471,9,3480,43
2021-05-09,Lassen,035,31185,5181,5147,108,5255,5
2021-05-09,Los Angeles,037,10098052,1203475,1194820,41144,1235964,24026
2021-05-09,Madera,039,155013,16537,16444,925,17369,238
2021-05-09,Marin,041,260295,14027,13979,251,14230,228
2021-05-09,Mariposa,043,17540,424,420,11,431,5
2021-05-09,Mendocino,045,87422,3896,3814,81,3895,46
2021-05-09,Merced,047,269075,30800,30883,1047,31930,448
2021-05-09,Modoc,049,8938,373,360,124,484,3
2021-05-09,Mono,051,14174,1253,1264,17,1281,3
2021-05-09,Monterey,053,433212,43056,42918,1861,44779,380
2021-05-09,Napa,055,140530,9848,9857,36,9893,81
2021-05-09,Nevada,057,99092,4755,4727,188,4915,70
2021-05-09,Orange,059,3164182,254746,253451,11312,264763,5008
2021-05-09,Placer,061,380077,22967,22566,1446,24012,286
2021-05-09,Plumas,063,18699,695,679,10,689,4
2021-05-09,Riverside,065,2383286,293279,287644,13973,301617,4427
2021-05-09,Sacramento,067,1510023,104617,104309,1716,106025,1612
2021-05-09,San Benito,069,59416,6043,6056,114,6170,63
2021-05-09,San Bernardino,071,2135413,292604,291337,8965,300302,4707
2021-05-09,San Diego,073,3302833,279111,277950,14707,292657,3725
2021-05-09,San Francisco,075,870044,36483,36669,1273,37942,543
2021-05-09,San Joaquin,077,732212,72548,71927,3495,75422,1356
2021-05-09,San Luis Obispo,079,281455,21254,20999,726,21725,256
2021-05-09,San Mateo,081,765935,42118,41903,468,42371,424
2021-05-09,Santa Barbara,083,443738,34322,34196,1136,35332,456
2021-05-09,Santa Clara,085,1922200,118091,118798,757,119555,2003
2021-05-09,Santa Cruz,087,273765,16169,16094,811,16905,206
2021-05-09,Shasta,089,179085,12044,12034,1518,13552,200
2021-05-09,Sierra,091,2930,56,54,12,66,0
2021-05-09,Siskiyou,093,43540,1844,1741,336,2077,13
2021-05-09,Solano,095,438530,32494,32434,539,32973,250
2021-05-09,Sonoma,097,501317,29791,29953,327,30280,318
2021-05-09,Stanislaus,099,539301,55737,55511,5882,61393,898
2021-05-09,Sutter,101,95872,9372,9413,83,9496,111
2021-05-09,Tehama,103,63373,5011,4979,561,5540,62
2021-05-09,Trinity,105,12862,482,327,87,414,3
2021-05-09,Tulare,107,460477,49985,48948,8953,57901,837
2021-05-09,Tuolumne,109,53932,4009,4053,39,4092,63
2021-05-09,Ventura,111,848112,81105,80487,2977,83464,1008
2021-05-09,Yolo,113,214977,13899,13897,298,14195,209
2021-05-09,Yuba,115,75493,5977,5934,122,6056,46
2021-05-08,Alameda,001,1643700,87404,87213,1932,89145,1284
2021-05-08,Alpine,003,1148,87,88,0,88,0
2021-05-08,Amador,005,37829,3658,3652,33,3685,46
2021-05-08,Butte,007,227075,12355,11962,1792,13754,199
2021-05-08,Calaveras,009,45235,2120,2114,13,2127,52
2021-05-08,Colusa,011,21464,1932,1939,297,2236,14
2021-05-08,Contra Costa,013,1133247,68775,68223,1253,69476,803
2021-05-08,Del Norte,015,27424,1375,1335,12,1347,8
2021-05-08,El Dorado,017,186661,10147,10079,737,10816,113
2021-05-08,Fresno,019,978130,102185,101676,8639,110315,1682
2021-05-08,Glenn,021,27897,2407,2382,550,2932,17
2021-05-08,Humboldt,023,135768,4004,3939,33,3972,36
2021-05-08,Imperial,025,180216,28460,28373,2718,31091,721
2021-05-08,Inyo,027,18085,1403,1402,12,1414,36
2021-05-08,Kern,029,883053,96874,95880,10763,106643,1310
2021-05-08,Kings,031,150075,23096,22872,1086,23958,246
2021-05-08,Lake,033,64148,3483,3470,9,3479,43
2021-05-08,Lassen,035,31185,5180,5145,108,5253,5
2021-05-08,Los Angeles,037,10098052,1203323,1194584,41128,1235712,24022
2021-05-08,Madera,039,155013,16533,16442,925,17367,238
2021-05-08,Marin,041,260295,14024,13974,250,14224,228
2021-05-08,Mariposa,043,17540,424,420,11,431,5
2021-05-08,Mendocino,045,87422,3891,3810,80,3890,46
2021-05-08,Merced,047,269075,30791,30876,1047,31923,448
2021-05-08,Modoc,049,8938,373,360,123,483,3
2021-05-08,Mono,051,14174,1253,1262,17,1279,3
2021-05-08,Monterey,053,433212,43051,42914,1860,44774,380
2021-05-08,Napa,055,140530,9841,9853,36,9889,81
2021-05-08,Nevada,057,99092,4752,4716,188,4904,70
2021-05-08,Orange,059,3164182,254712,253412,11309,264721,5006
2021-05-08,Placer,061,380077,22949,22547,1444,23991,286
2021-05-08,Plumas,063,18699,694,679,10,689,4
2021-05-08,Riverside,065,2383286,293236,287574,13971,301545,4427
2021-05-08,Sacramento,067,1510023,104532,104208,1713,105921,1610
2021-05-08,San Benito,069,59416,6042,6048,114,6162,63
2021-05-08,San Bernardino,071,2135413,292561,291296,8965,300261,4707
2021-05-08,San Diego,073,3302833,279028,277760,14689,292449,3725
2021-05-08,San Francisco,075,870044,36460,36642,1273,37915,543
2021-05-08,San Joaquin,077,732212,72519,71869,3486,75355,1356
2021-05-08,San Luis Obispo,079,281455,21243,20992,726,21718,256
2021-05-08,San Mateo,081,765935,42107,41871,468,42339,424
2021-05-08,Santa Barbara,083,443738,34309,34185,1136,35321,456
2021-05-08,Santa Clara,085,1922200,118060,118751,757,119508,2003
2021-05-08,Santa Cruz,087,273765,16166,16089,811,16900,206
2021-05-08,Shasta,089,179085,12034,12030,1514,13544,200
2021-05-08,Sierra,091,2930,56,54,12,66,0
2021-05-08,Siskiyou,093,43540,1843,1741,332,2073,13
2021-05-08,Solano,095,438530,32470,32395,537,32932,249
2021-05-08,Sonoma,097,501317,29778,29942,327,30269,318
2021-05-08,Stanislaus,099,539301,55706,55467,5878,61345,898
2021-05-08,Sutter,101,95872,9369,9413,83,9496,111
2021-05-08,Tehama,103,63373,5009,4977,561,5538,62
2021-05-08,Trinity,105,12862,482,327,87,414,3
2021-05-08,Tulare,107,460477,49971,48929,8943,57872,837
2021-05-08,Tuolumne,109,53932,4008,4050,39,4089,63
2021-05-08,Ventura,111,848112,81094,80481,2974,83455,1008
2021-05-08,Yolo,113,214977,13896,13894,297,14191,209
2021-05-08,Yuba,115,75493,5969,5928,122,6050,46
2021-05-07,Alameda,001,1643700,87350,87128,1931,89059,1280
2021-05-07,Alpine,003,1148,87,88,0,88,0
2021-05-07,Amador,005,37829,3655,3651,33,3684,46
2021-05-07,Butte,007,227075,12334,11943,1789,13732,199
2021-05-07,Calaveras,009,45235,2118,2114,13,2127,52
2021-05-07,Colusa,011,21464,1932,1937,297,2234,14
2021-05-07,Contra Costa,013,1133247,68728,68156,1251,69407,804
2021-05-07,Del Norte,015,27424,1370,1329,12,1341,8
2021-05-07,El Dorado,017,186661,10134,10065,735,10800,112
2021-05-07,Fresno,019,978130,102152,101625,8638,110263,1684
2021-05-07,Glenn,021,27897,2404,2381,549,2930,17
2021-05-07,Humboldt,023,135768,3989,3919,33,3952,36
2021-05-07,Imperial,025,180216,28452,28352,2718,31070,721
2021-05-07,Inyo,027,18085,1403,1402,12,1414,36
2021-05-07,Kern,029,883053,96861,95839,10751,106590,1308
2021-05-07,Kings,031,150075,23095,22857,1085,23942,246
2021-05-07,Lake,033,64148,3481,3467,9,3476,43
2021-05-07,Lassen,035,31185,5179,5144,107,5251,5
2021-05-07,Los Angeles,037,10098052,1203144,1194294,41121,1235415,24008
2021-05-07,Madera,039,155013,16528,16439,924,17363,238
2021-05-07,Marin,041,260295,14020,13968,250,14218,228
2021-05-07,Mariposa,043,17540,423,419,11,430,5
2021-05-07,Mendocino,045,87422,3885,3805,80,3885,46
2021-05-07,Merced,047,269075,30788,30862,1047,31909,446
2021-05-07,Modoc,049,8938,373,360,123,483,3
2021-05-07,Mono,051,14174,1252,1261,17,1278,3
2021-05-07,Monterey,053,433212,43045,42909,1858,44767,380
2021-05-07,Napa,055,140530,9840,9849,36,9885,81
2021-05-07,Nevada,057,99092,4748,4704,188,4892,70
2021-05-07,Orange,059,3164182,254672,253338,11300,264638,5000
2021-05-07,Placer,061,380077,22929,22524,1442,23966,286
2021-05-07,Plumas,063,18699,694,678,10,688,4
2021-05-07,Riverside,065,2383286,293178,287479,13970,301449,4426
2021-05-07,Sacramento,067,1510023,104460,104068,1708,105776,1609
2021-05-07,San Benito,069,59416,6041,6048,114,6162,63
2021-05-07,San Bernardino,071,2135413,292519,291185,8960,300145,4697
2021-05-07,San Diego,073,3302833,278942,277534,14673,292207,3718
2021-05-07,San Francisco,075,870044,36447,36616,1272,37888,543
2021-05-07,San Joaquin,077,732212,72479,71804,3484,75288,1351
2021-05-07,San Luis Obispo,079,281455,21236,20979,726,21705,256
2021-05-07,San Mateo,081,765935,42092,41844,468,42312,424
2021-05-07,Santa Barbara,083,443738,34299,34166,1136,35302,453
2021-05-07,Santa Clara,085,1922200,118027,118691,756,119447,2002
2021-05-07,Santa Cruz,087,273765,16163,16074,811,16885,206
2021-05-07,Shasta,089,179085,12012,12005,1512,13517,200
2021-05-07,Sierra,091,2930,56,54,12,66,0
2021-05-07,Siskiyou,093,43540,1840,1723,332,2055,13
2021-05-07,Solano,095,438530,32442,32352,535,32887,249
2021-05-07,Sonoma,097,501317,29760,29925,325,30250,318
2021-05-07,Stanislaus,099,539301,55665,55407,5873,61280,896
2021-05-07,Sutter,101,95872,9369,9407,83,9490,111
2021-05-07,Tehama,103,63373,5002,4974,561,5535,57
2021-05-07,Trinity,105,12862,482,327,87,414,3
2021-05-07,Tulare,107,460477,49954,48913,8938,57851,837
2021-05-07,Tuolumne,109,53932,4006,4048,39,4087,63
2021-05-07,Ventura,111,848112,81070,80444,2974,83418,1008
2021-05-07,Yolo,113,214977,13890,13875,296,14171,209
2021-05-07,Yuba,115,75493,5959,5910,122,6032,46
2021-05-06,Alameda,001,1643700,87274,87028,1928,88956,1278
2021-05-06,Alpine,003,1148,87,88,0,88,0
2021-05-06,Amador,005,37829,3653,3650,33,3683,46
2021-05-06,Butte,007,227075,12314,11929,1784,13713,198
2021-05-06,Calaveras,009,45235,2117,2111,13,2124,52
2021-05-06,Colusa,011,21464,1932,1935,297,2232,14
2021-05-06,Contra Costa,013,1133247,68673,68076,1248,69324,802
2021-05-06,Del Norte,015,27424,1362,1324,12,1336,6
2021-05-06,El Dorado,017,186661,10127,10048,735,10783,112
2021-05-06,Fresno,019,978130,102108,101536,8634,110170,1680
2021-05-06,Glenn,021,27897,2403,2380,548,2928,17
2021-05-06,Humboldt,023,135768,3964,3898,33,3931,36
2021-05-06,Imperial,025,180216,28441,28311,2717,31028,720
2021-05-06,Inyo,027,18085,1403,1401,12,1413,36
2021-05-06,Kern,029,883053,96836,95801,10734,106535,1307
2021-05-06,Kings,031,150075,23088,22848,1084,23932,246
2021-05-06,Lake,033,64148,3480,3465,9,3474,43
2021-05-06,Lassen,035,31185,5178,5143,107,5250,1
2021-05-06,Los Angeles,037,10098052,1202902,1193954,41105,1235059,23991
2021-05-06,Madera,039,155013,16520,16430,924,17354,238
2021-05-06,Marin,041,260295,14016,13956,250,14206,228
2021-05-06,Mariposa,043,17540,422,419,11,430,5
2021-05-06,Mendocino,045,87422,3874,3802,80,3882,46
2021-05-06,Merced,047,269075,30773,30863,1046,31909,444
2021-05-06,Modoc,049,8938,373,360,123,483,3
2021-05-06,Mono,051,14174,1250,1261,17,1278,3
2021-05-06,Monterey,053,433212,43030,42899,1858,44757,379
2021-05-06,Napa,055,140530,9834,9843,36,9879,81
2021-05-06,Nevada,057,99092,4747,4687,188,4875,70
2021-05-06,Orange,059,3164182,254604,253286,11294,264580,4991
2021-05-06,Placer,061,380077,22907,22493,1442,23935,286
2021-05-06,Plumas,063,18699,694,678,10,688,4
2021-05-06,Riverside,065,2383286,293105,287399,13965,301364,4422
2021-05-06,Sacramento,067,1510023,104343,103956,1705,105661,1609
2021-05-06,San Benito,069,59416,6040,6045,114,6159,63
2021-05-06,San Bernardino,071,2135413,292449,291085,8959,300044,4683
2021-05-06,San Diego,073,3302833,278815,277324,14650,291974,3716
2021-05-06,San Francisco,075,870044,36432,36599,1272,37871,543
2021-05-06,San Joaquin,077,732212,72424,71729,3481,75210,1350
2021-05-06,San Luis Obispo,079,281455,21224,20965,724,21689,256
2021-05-06,San Mateo,081,765935,42073,41802,467,42269,424
2021-05-06,Santa Barbara,083,443738,34286,34152,1136,35288,453
2021-05-06,Santa Clara,085,1922200,117986,118591,756,119347,2001
2021-05-06,Santa Cruz,087,273765,16156,16050,811,16861,206
2021-05-06,Shasta,089,179085,11990,11983,1506,13489,199
2021-05-06,Sierra,091,2930,56,54,12,66,0
2021-05-06,Siskiyou,093,43540,1830,1711,331,2042,12
2021-05-06,Solano,095,438530,32416,32320,527,32847,249
2021-05-06,Sonoma,097,501317,29752,29911,325,30236,318
2021-05-06,Stanislaus,099,539301,55609,55323,5868,61191,834
2021-05-06,Sutter,101,95872,9363,9396,83,9479,111
2021-05-06,Tehama,103,63373,4997,4970,561,5531,53
2021-05-06,Trinity,105,12862,482,327,87,414,3
2021-05-06,Tulare,107,460477,49929,48890,8923,57813,836
2021-05-06,Tuolumne,109,53932,4002,4047,39,4086,63
2021-05-06,Ventura,111,848112,81039,80411,2971,83382,1005
2021-05-06,Yolo,113,214977,13883,13871,292,14163,209
2021-05-06,Yuba,115,75493,5947,5901,122,6023,46
2021-05-05,Alameda,001,1643700,87212,86950,1926,88876,1278
2021-05-05,Alpine,003,1148,87,88,0,88,0
2021-05-05,Amador,005,37829,3650,3650,33,3683,46
2021-05-05,Butte,007,227075,12296,11907,1781,13688,198
2021-05-05,Calaveras,009,45235,2113,2103,13,2116,52
2021-05-05,Colusa,011,21464,1931,1933,297,2230,14
2021-05-05,Contra Costa,013,1133247,68608,67997,1244,69241,803
2021-05-05,Del Norte,015,27424,1359,1317,12,1329,6
2021-05-05,El Dorado,017,186661,10116,10020,734,10754,111
2021-05-05,Fresno,019,978130,102059,101491,8625,110116,1680
2021-05-05,Glenn,021,27897,2400,2380,547,2927,17
2021-05-05,Humboldt,023,135768,3945,3886,32,3918,36
2021-05-05,Imperial,025,180216,28400,28295,2710,31005,720
2021-05-05,Inyo,027,18085,1402,1401,12,1413,36
2021-05-05,Kern,029,883053,96792,95753,10730,106483,1304
2021-05-05,Kings,031,150075,23082,22840,1083,23923,246
2021-05-05,Lake,033,64148,3477,3458,9,3467,43
2021-05-05,Lassen,035,31185,5178,5143,106,5249,1
2021-05-05,Los Angeles,037,10098052,1202631,1193608,41091,1234699,23977
2021-05-05,Madera,039,155013,16518,16423,924,17347,235
2021-05-05,Marin,041,260295,14008,13950,249,14199,228
2021-05-05,Mariposa,043,17540,422,418,11,429,5
2021-05-05,Mendocino,045,87422,3870,3799,80,3879,46
2021-05-05,Merced,047,269075,30752,30844,1046,31890,444
2021-05-05,Modoc,049,8938,372,361,122,483,3
2021-05-05,Mono,051,14174,1250,1260,17,1277,3
2021-05-05,Monterey,053,433212,43017,42870,1855,44725,379
2021-05-05,Napa,055,140530,9828,9833,36,9869,81
2021-05-05,Nevada,057,99092,4744,4666,188,4854,70
2021-05-05,Orange,059,3164182,254546,253237,11289,264526,4978
2021-05-05,Placer,061,380077,22875,22362,1438,23800,287
2021-05-05,Plumas,063,18699,694,677,10,687,4
2021-05-05,Riverside,065,2383286,293010,287353,13955,301308,4414
2021-05-05,Sacramento,067,1510023,104255,103476,1700,105176,1607
2021-05-05,San Benito,069,59416,6031,6046,114,6160,63
2021-05-05,San Bernardino,071,2135413,292374,291008,8955,299963,4677
2021-05-05,San Diego,073,3302833,278678,277098,14631,291729,3716
2021-05-05,San Francisco,075,870044,36418,36577,1271,37848,543
2021-05-05,San Joaquin,077,732212,72371,71638,3478,75116,1345
2021-05-05,San Luis Obispo,079,281455,21216,20958,724,21682,256
2021-05-05,San Mateo,081,765935,42044,41755,466,42221,415
2021-05-05,Santa Barbara,083,443738,34271,34139,1135,35274,453
2021-05-05,Santa Clara,085,1922200,117956,118482,752,119234,1992
2021-05-05,Santa Cruz,087,273765,16150,16013,811,16824,207
2021-05-05,Shasta,089,179085,11974,11939,1502,13441,200
2021-05-05,Sierra,091,2930,56,54,12,66,0
2021-05-05,Siskiyou,093,43540,1813,1706,323,2029,11
2021-05-05,Solano,095,438530,32381,32250,525,32775,249
2021-05-05,Sonoma,097,501317,29739,29879,325,30204,318
2021-05-05,Stanislaus,099,539301,55552,55231,5866,61097,807
2021-05-05,Sutter,101,95872,9357,9387,83,9470,111
2021-05-05,Tehama,103,63373,4993,4968,561,5529,53
2021-05-05,Trinity,105,12862,482,326,87,413,3
2021-05-05,Tulare,107,460477,49905,48875,8916,57791,835
2021-05-05,Tuolumne,109,53932,3999,4040,39,4079,63
2021-05-05,Ventura,111,848112,81011,80372,2967,83339,1005
2021-05-05,Yolo,113,214977,13879,13846,290,14136,209
2021-05-05,Yuba,115,75493,5937,5895,121,6016,44
2021-05-04,Alameda,001,1643700,87120,86894,1926,88820,1277
2021-05-04,Alpine,003,1148,87,88,0,88,0
2021-05-04,Amador,005,37829,3650,3650,33,3683,46
2021-05-04,Butte,007,227075,12272,11883,1780,13663,198
2021-05-04,Calaveras,009,45235,2108,2100,13,2113,52
2021-05-04,Colusa,011,21464,1930,1933,297,2230,14
2021-05-04,Contra Costa,013,1133247,68528,67931,1242,69173,799
2021-05-04,Del Norte,015,27424,1359,1314,12,1326,6
2021-05-04,El Dorado,017,186661,10105,10009,730,10739,110
2021-05-04,Fresno,019,978130,102004,101451,8618,110069,1677
2021-05-04,Glenn,021,27897,2397,2379,544,2923,17
2021-05-04,Humboldt,023,135768,3919,3877,32,3909,36
2021-05-04,Imperial,025,180216,28380,28276,2706,30982,720
2021-05-04,Inyo,027,18085,1402,1399,12,1411,36
2021-05-04,Kern,029,883053,96756,95720,10712,106432,1301
2021-05-04,Kings,031,150075,23068,22822,1080,23902,246
2021-05-04,Lake,033,64148,3476,3454,9,3463,43
2021-05-04,Lassen,035,31185,5177,5142,106,5248,1
2021-05-04,Los Angeles,037,10098052,1202342,1193453,41079,1234532,23957
2021-05-04,Madera,039,155013,16517,16418,924,17342,235
2021-05-04,Marin,041,260295,14000,13935,249,14184,228
2021-05-04,Mariposa,043,17540,422,418,11,429,5
2021-05-04,Mendocino,045,87422,3865,3794,80,3874,46
2021-05-04,Merced,047,269075,30735,30829,1046,31875,444
2021-05-04,Modoc,049,8938,371,360,121,481,3
2021-05-04,Mono,051,14174,1250,1260,17,1277,3
2021-05-04,Monterey,053,433212,43005,42845,1854,44699,380
2021-05-04,Napa,055,140530,9819,9824,36,9860,81
2021-05-04,Nevada,057,99092,4737,4656,188,4844,70
2021-05-04,Orange,059,3164182,254478,253177,11279,264456,4977
2021-05-04,Placer,061,380077,22846,22326,1435,23761,287
2021-05-04,Plumas,063,18699,693,675,10,685,4
2021-05-04,Riverside,065,2383286,292926,287285,13948,301233,4411
2021-05-04,Sacramento,067,1510023,104126,103383,1695,105078,1604
2021-05-04,San Benito,069,59416,6030,6039,114,6153,63
2021-05-04,San Bernardino,071,2135413,292297,290934,8948,299882,4668
2021-05-04,San Diego,073,3302833,278511,276879,14614,291493,3713
2021-05-04,San Francisco,075,870044,36400,36550,1271,37821,541
2021-05-04,San Joaquin,077,732212,72310,71582,3473,75055,1342
2021-05-04,San Luis Obispo,079,281455,21210,20923,722,21645,255
2021-05-04,San Mateo,081,765935,42018,41708,466,42174,415
2021-05-04,Santa Barbara,083,443738,34256,34131,1134,35265,453
2021-05-04,Santa Clara,085,1922200,117893,118431,751,119182,1988
2021-05-04,Santa Cruz,087,273765,16144,16005,811,16816,207
2021-05-04,Shasta,089,179085,11954,11923,1496,13419,198
2021-05-04,Sierra,091,2930,56,54,12,66,0
2021-05-04,Siskiyou,093,43540,1806,1694,321,2015,11
2021-05-04,Solano,095,438530,32340,32220,523,32743,249
2021-05-04,Sonoma,097,501317,29719,29867,324,30191,318
2021-05-04,Stanislaus,099,539301,55496,55165,5863,61028,807
2021-05-04,Sutter,101,95872,9352,9375,83,9458,111
2021-05-04,Tehama,103,63373,4990,4959,560,5519,53
2021-05-04,Trinity,105,12862,482,326,87,413,3
2021-05-04,Tulare,107,460477,49878,48857,8907,57764,835
2021-05-04,Tuolumne,109,53932,3997,4041,39,4080,61
2021-05-04,Ventura,111,848112,80982,80351,2965,83316,1005
2021-05-04,Yolo,113,214977,13866,13820,288,14108,208
2021-05-04,Yuba,115,75493,5931,5891,121,6012,44
2021-05-03,Alameda,001,1643700,87044,86845,1920,88765,1272
2021-05-03,Alpine,003,1148,87,88,0,88,0
2021-05-03,Amador,005,37829,3650,3651,33,3684,46
2021-05-03,Butte,007,227075,12262,11864,1777,13641,198
2021-05-03,Calaveras,009,45235,2106,2099,13,2112,50
2021-05-03,Colusa,011,21464,1929,1931,295,2226,14
2021-05-03,Contra Costa,013,1133247,68469,67895,1238,69133,799
2021-05-03,Del Norte,015,27424,1354,1306,11,1317,6
2021-05-03,El Dorado,017,186661,10087,9984,725,10709,110
2021-05-03,Fresno,019,978130,101948,101405,8607,110012,1678
2021-05-03,Glenn,021,27897,2397,2375,543,2918,17
2021-05-03,Humboldt,023,135768,3904,3865,32,3897,36
2021-05-03,Imperial,025,180216,28358,28280,2703,30983,720
2021-05-03,Inyo,027,18085,1401,1398,12,1410,36
2021-05-03,Kern,029,883053,96719,95693,10700,106393,1299
2021-05-03,Kings,031,150075,23059,22821,1080,23901,246
2021-05-03,Lake,033,64148,3474,3446,9,3455,43
2021-05-03,Lassen,035,31185,5176,5142,106,5248,1
2021-05-03,Los Angeles,037,10098052,1202073,1193261,41053,1234314,23942
2021-05-03,Madera,039,155013,16512,16414,923,17337,235
2021-05-03,Marin,041,260295,13994,13927,249,14176,228
2021-05-03,Mariposa,043,17540,422,418,11,429,5
2021-05-03,Mendocino,045,87422,3858,3792,80,3872,46
2021-05-03,Merced,047,269075,30724,30814,1044,31858,444
2021-05-03,Modoc,049,8938,371,360,121,481,3
2021-05-03,Mono,051,14174,1250,1259,17,1276,3
2021-05-03,Monterey,053,433212,42993,42837,1852,44689,380
2021-05-03,Napa,055,140530,9814,9815,36,9851,81
2021-05-03,Nevada,057,99092,4729,4650,188,4838,70
2021-05-03,Orange,059,3164182,254419,253107,11270,264377,4968
2021-05-03,Placer,061,380077,22815,22289,1429,23718,287
2021-05-03,Plumas,063,18699,692,675,10,685,4
2021-05-03,Riverside,065,2383286,292852,287233,13947,301180,4412
2021-05-03,Sacramento,067,1510023,103973,103303,1685,104988,1602
2021-05-03,San Benito,069,59416,6029,6038,114,6152,63
2021-05-03,San Bernardino,071,2135413,292229,290886,8945,299831,4659
2021-05-03,San Diego,073,3302833,278348,276693,14589,291282,3712
2021-05-03,San Francisco,075,870044,36374,36538,1271,37809,541
2021-05-03,San Joaquin,077,732212,72260,71504,3470,74974,1325
2021-05-03,San Luis Obispo,079,281455,21194,20915,719,21634,254
2021-05-03,San Mateo,081,765935,41995,41689,465,42154,413
2021-05-03,Santa Barbara,083,443738,34244,34119,1134,35253,453
2021-05-03,Santa Clara,085,1922200,117839,118373,750,119123,1988
2021-05-03,Santa Cruz,087,273765,16141,16000,811,16811,207
2021-05-03,Shasta,089,179085,11931,11890,1491,13381,197
2021-05-03,Sierra,091,2930,56,54,12,66,0
2021-05-03,Siskiyou,093,43540,1800,1683,315,1998,11
2021-05-03,Solano,095,438530,32299,32201,522,32723,249
2021-05-03,Sonoma,097,501317,29707,29855,321,30176,318
2021-05-03,Stanislaus,099,539301,55430,55116,5854,60970,774
2021-05-03,Sutter,101,95872,9340,9370,83,9453,111
2021-05-03,Tehama,103,63373,4982,4952,560,5512,53
2021-05-03,Trinity,105,12862,482,326,87,413,3
2021-05-03,Tulare,107,460477,49860,48844,8897,57741,835
2021-05-03,Tuolumne,109,53932,3996,4038,39,4077,61
2021-05-03,Ventura,111,848112,80960,80291,2965,83256,1005
2021-05-03,Yolo,113,214977,13853,13809,286,14095,208
2021-05-03,Yuba,115,75493,5926,5880,121,6001,44
2021-05-02,Alameda,001,1643700,86959,86784,1919,88703,1272
2021-05-02,Alpine,003,1148,87,88,0,88,0
2021-05-02,Amador,005,37829,3650,3650,33,3683,46
2021-05-02,Butte,007,227075,12238,11859,1774,13633,198
2021-05-02,Calaveras,009,45235,2102,2098,13,2111,50
2021-05-02,Colusa,011,21464,1928,1931,294,2225,14
2021-05-02,Contra Costa,013,1133247,68384,67843,1236,69079,800
2021-05-02,Del Norte,015,27424,1347,1305,11,1316,6
2021-05-02,El Dorado,017,186661,10072,9962,724,10686,110
2021-05-02,Fresno,019,978130,101876,101372,8596,109968,1678
2021-05-02,Glenn,021,27897,2396,2374,541,2915,17
2021-05-02,Humboldt,023,135768,3892,3858,31,3889,36
2021-05-02,Imperial,025,180216,28324,28275,2694,30969,721
2021-05-02,Inyo,027,18085,1399,1398,12,1410,36
2021-05-02,Kern,029,883053,96661,95668,10693,106361,1299
2021-05-02,Kings,031,150075,23041,22816,1079,23895,246
2021-05-02,Lake,033,64148,3472,3443,9,3452,43
2021-05-02,Lassen,035,31185,5175,5142,105,5247,1
2021-05-02,Los Angeles,037,10098052,1201723,1193056,41030,1234086,23943
2021-05-02,Madera,039,155013,16506,16410,923,17333,235
2021-05-02,Marin,041,260295,13984,13917,249,14166,228
2021-05-02,Mariposa,043,17540,422,419,11,430,5
2021-05-02,Mendocino,045,87422,3853,3787,80,3867,46
2021-05-02,Merced,047,269075,30704,30793,1040,31833,444
2021-05-02,Modoc,049,8938,370,360,121,481,3
2021-05-02,Mono,051,14174,1249,1259,17,1276,3
2021-05-02,Monterey,053,433212,42979,42837,1851,44688,380
2021-05-02,Napa,055,140530,9810,9805,36,9841,81
2021-05-02,Nevada,057,99092,4713,4635,188,4823,70
2021-05-02,Orange,059,3164182,254345,253025,11256,264281,4968
2021-05-02,Placer,061,380077,22786,22264,1426,23690,287
2021-05-02,Plumas,063,18699,692,675,10,685,4
2021-05-02,Riverside,065,2383286,292752,287197,13937,301134,4412
2021-05-02,Sacramento,067,1510023,103833,103153,1678,104831,1602
2021-05-02,San Benito,069,59416,6024,6037,114,6151,63
2021-05-02,San Bernardino,071,2135413,292130,290859,8943,299802,4655
2021-05-02,San Diego,073,3302833,278152,276521,14562,291083,3712
2021-05-02,San Francisco,075,870044,36348,36522,1271,37793,541
2021-05-02,San Joaquin,077,732212,72196,71447,3463,74910,1325
2021-05-02,San Luis Obispo,079,281455,21173,20910,718,21628,254
2021-05-02,San Mateo,081,765935,41979,41656,464,42120,412
2021-05-02,Santa Barbara,083,443738,34230,34106,1134,35240,453
2021-05-02,Santa Clara,085,1922200,117765,118321,750,119071,1988
2021-05-02,Santa Cruz,087,273765,16136,15995,810,16805,207
2021-05-02,Shasta,089,179085,11915,11885,1483,13368,197
2021-05-02,Sierra,091,2930,56,54,12,66,0
2021-05-02,Siskiyou,093,43540,1789,1661,314,1975,11
2021-05-02,Solano,095,438530,32260,32151,518,32669,249
2021-05-02,Sonoma,097,501317,29685,29842,321,30163,318
2021-05-02,Stanislaus,099,539301,55356,55057,5847,60904,774
2021-05-02,Sutter,101,95872,9334,9363,83,9446,111
2021-05-02,Tehama,103,63373,4977,4950,558,5508,53
2021-05-02,Trinity,105,12862,482,326,87,413,3
2021-05-02,Tulare,107,460477,49842,48834,8889,57723,835
2021-05-02,Tuolumne,109,53932,3993,4038,39,4077,61
2021-05-02,Ventura,111,848112,80922,80284,2964,83248,1005
2021-05-02,Yolo,113,214977,13841,13799,285,14084,208
2021-05-02,Yuba,115,75493,5916,5879,121,6000,44
2021-05-01,Alameda,001,1643700,86916,86704,1916,88620,1270
2021-05-01,Alpine,003,1148,87,88,0,88,0
2021-05-01,Amador,005,37829,3650,3650,33,3683,46
2021-05-01,Butte,007,227075,12224,11845,1769,13614,198
2021-05-01,Calaveras,009,45235,2100,2096,13,2109,50
2021-05-01,Colusa,011,21464,1927,1931,294,2225,14
2021-05-01,Contra Costa,013,1133247,68332,67779,1233,69012,800
2021-05-01,Del Norte,015,27424,1346,1292,11,1303,6
2021-05-01,El Dorado,017,186661,10058,9944,722,10666,110
2021-05-01,Fresno,019,978130,101831,101326,8590,109916,1678
2021-05-01,Glenn,021,27897,2393,2369,540,2909,17
2021-05-01,Humboldt,023,135768,3878,3845,31,3876,36
2021-05-01,Imperial,025,180216,28317,28262,2694,30956,721
2021-05-01,Inyo,027,18085,1399,1397,12,1409,36
2021-05-01,Kern,029,883053,96634,95645,10682,106327,1299
2021-05-01,Kings,031,150075,23038,22797,1078,23875,246
2021-05-01,Lake,033,64148,3470,3441,9,3450,43
2021-05-01,Lassen,035,31185,5173,5142,105,5247,1
2021-05-01,Los Angeles,037,10098052,1201554,1192781,41015,1233796,23946
2021-05-01,Madera,039,155013,16502,16408,923,17331,235
2021-05-01,Marin,041,260295,13977,13902,249,14151,228
2021-05-01,Mariposa,043,17540,422,418,11,429,5
2021-05-01,Mendocino,045,87422,3851,3782,80,3862,46
2021-05-01,Merced,047,269075,30687,30771,1039,31810,444
2021-05-01,Modoc,049,8938,370,361,121,482,3
2021-05-01,Mono,051,14174,1249,1258,17,1275,3
2021-05-01,Monterey,053,433212,42973,42828,1851,44679,379
2021-05-01,Napa,055,140530,9807,9800,36,9836,81
2021-05-01,Nevada,057,99092,4708,4625,188,4813,70
2021-05-01,Orange,059,3164182,254302,252969,11245,264214,4964
2021-05-01,Placer,061,380077,22760,22240,1424,23664,287
2021-05-01,Plumas,063,18699,691,675,10,685,4
2021-05-01,Riverside,065,2383286,292713,287129,13935,301064,4412
2021-05-01,Sacramento,067,1510023,103752,103043,1677,104720,1602
2021-05-01,San Benito,069,59416,6021,6030,114,6144,63
2021-05-01,San Bernardino,071,2135413,292087,290802,8941,299743,4652
2021-05-01,San Diego,073,3302833,278028,276367,14541,290908,3706
2021-05-01,San Francisco,075,870044,36333,36496,1271,37767,541
2021-05-01,San Joaquin,077,732212,72147,71389,3461,74850,1325
2021-05-01,San Luis Obispo,079,281455,21168,20896,718,21614,254
2021-05-01,San Mateo,081,765935,41950,41617,463,42080,411
2021-05-01,Santa Barbara,083,443738,34225,34085,1133,35218,453
2021-05-01,Santa Clara,085,1922200,117713,118265,748,119013,1988
2021-05-01,Santa Cruz,087,273765,16133,15984,810,16794,207
2021-05-01,Shasta,089,179085,11895,11878,1475,13353,197
2021-05-01,Sierra,091,2930,56,53,12,65,0
2021-05-01,Siskiyou,093,43540,1781,1653,313,1966,11
2021-05-01,Solano,095,438530,32230,32124,510,32634,249
2021-05-01,Sonoma,097,501317,29682,29835,321,30156,318
2021-05-01,Stanislaus,099,539301,55321,55005,5841,60846,774
2021-05-01,Sutter,101,95872,9331,9358,83,9441,110
2021-05-01,Tehama,103,63373,4976,4950,557,5507,53
2021-05-01,Trinity,105,12862,482,326,86,412,3
2021-05-01,Tulare,107,460477,49835,48818,8883,57701,835
2021-05-01,Tuolumne,109,53932,3987,4035,39,4074,61
2021-05-01,Ventura,111,848112,80904,80268,2964,83232,1005
2021-05-01,Yolo,113,214977,13834,13784,283,14067,208
2021-05-01,Yuba,115,75493,5914,5875,121,5996,44
2021-04-30,Alameda,001,1643700,86855,86602,1913,88515,1268
2021-04-30,Alpine,003,1148,87,88,0,88,0
2021-04-30,Amador,005,37829,3648,3650,33,3683,46
2021-04-30,Butte,007,227075,12205,11812,1765,13577,197
2021-04-30,Calaveras,009,45235,2099,2087,13,2100,50
2021-04-30,Colusa,011,21464,1927,1931,293,2224,14
2021-04-30,Contra Costa,013,1133247,68284,67684,1230,68914,800
2021-04-30,Del Norte,015,27424,1334,1276,11,1287,6
2021-04-30,El Dorado,017,186661,10044,9906,722,10628,110
2021-04-30,Fresno,019,978130,101785,101263,8586,109849,1670
2021-04-30,Glenn,021,27897,2392,2369,540,2909,17
2021-04-30,Humboldt,023,135768,3865,3834,31,3865,36
2021-04-30,Imperial,025,180216,28308,28244,2691,30935,721
2021-04-30,Inyo,027,18085,1399,1397,12,1409,36
2021-04-30,Kern,029,883053,96617,95605,10678,106283,1298
2021-04-30,Kings,031,150075,23035,22793,1077,23870,246
2021-04-30,Lake,033,64148,3466,3440,9,3449,43
2021-04-30,Lassen,035,31185,5172,5140,105,5245,1
2021-04-30,Los Angeles,037,10098052,1201343,1192393,41002,1233395,23919
2021-04-30,Madera,039,155013,16496,16395,923,17318,235
2021-04-30,Marin,041,260295,13969,13895,247,14142,228
2021-04-30,Mariposa,043,17540,422,417,11,428,5
2021-04-30,Mendocino,045,87422,3847,3777,80,3857,46
2021-04-30,Merced,047,269075,30674,30740,1038,31778,444
2021-04-30,Modoc,049,8938,369,360,121,481,3
2021-04-30,Mono,051,14174,1249,1258,17,1275,3
2021-04-30,Monterey,053,433212,42959,42810,1850,44660,379
2021-04-30,Napa,055,140530,9803,9792,36,9828,81
2021-04-30,Nevada,057,99092,4700,4608,188,4796,70
2021-04-30,Orange,059,3164182,254245,252883,11239,264122,4956
2021-04-30,Placer,061,380077,22741,22190,1420,23610,287
2021-04-30,Plumas,063,18699,691,677,10,687,4
2021-04-30,Riverside,065,2383286,292655,287030,13928,300958,4412
2021-04-30,Sacramento,067,1510023,103651,102864,1673,104537,1596
2021-04-30,San Benito,069,59416,6017,6024,113,6137,63
2021-04-30,San Bernardino,071,2135413,292026,290704,8940,299644,4640
2021-04-30,San Diego,073,3302833,277932,276157,14530,290687,3702
2021-04-30,San Francisco,075,870044,36322,36453,1270,37723,538
2021-04-30,San Joaquin,077,732212,72095,71311,3458,74769,1306
2021-04-30,San Luis Obispo,079,281455,21162,20884,718,21602,255
2021-04-30,San Mateo,081,765935,41936,41583,462,42045,380
2021-04-30,Santa Barbara,083,443738,34212,34061,1133,35194,451
2021-04-30,Santa Clara,085,1922200,117655,118170,744,118914,1988
2021-04-30,Santa Cruz,087,273765,16128,15975,810,16785,207
2021-04-30,Shasta,089,179085,11874,11848,1472,13320,197
2021-04-30,Sierra,091,2930,56,53,12,65,0
2021-04-30,Siskiyou,093,43540,1770,1628,310,1938,11
2021-04-30,Solano,095,438530,32198,32050,507,32557,249
2021-04-30,Sonoma,097,501317,29672,29816,319,30135,318
2021-04-30,Stanislaus,099,539301,55270,54938,5838,60776,774
2021-04-30,Sutter,101,95872,9329,9353,83,9436,110
2021-04-30,Tehama,103,63373,4973,4944,557,5501,53
2021-04-30,Trinity,105,12862,482,326,86,412,3
2021-04-30,Tulare,107,460477,49825,48797,8867,57664,836
2021-04-30,Tuolumne,109,53932,3986,4033,39,4072,61
2021-04-30,Ventura,111,848112,80864,80232,2959,83191,1004
2021-04-30,Yolo,113,214977,13822,13756,283,14039,208
2021-04-30,Yuba,115,75493,5906,5870,121,5991,44
2021-04-29,Alameda,001,1643700,86789,86490,1912,88402,1263
2021-04-29,Alpine,003,1148,87,88,0,88,0
2021-04-29,Amador,005,37829,3648,3649,33,3682,46
2021-04-29,Butte,007,227075,12190,11787,1763,13550,196
2021-04-29,Calaveras,009,45235,2096,2082,13,2095,50
2021-04-29,Colusa,011,21464,1927,1929,293,2222,14
2021-04-29,Contra Costa,013,1133247,68229,67606,1227,68833,795
2021-04-29,Del Norte,015,27424,1330,1271,11,1282,6
2021-04-29,El Dorado,017,186661,10024,9884,719,10603,107
2021-04-29,Fresno,019,978130,101731,101189,8575,109764,1667
2021-04-29,Glenn,021,27897,2389,2369,540,2909,17
2021-04-29,Humboldt,023,135768,3851,3815,31,3846,36
2021-04-29,Imperial,025,180216,28296,28235,2690,30925,720
2021-04-29,Inyo,027,18085,1399,1396,12,1408,36
2021-04-29,Kern,029,883053,96584,95547,10674,106221,1295
2021-04-29,Kings,031,150075,23025,22777,1072,23849,245
2021-04-29,Lake,033,64148,3458,3438,9,3447,43
2021-04-29,Lassen,035,31185,5172,5140,105,5245,1
2021-04-29,Los Angeles,037,10098052,1201064,1192068,40982,1233050,23899
2021-04-29,Madera,039,155013,16491,16383,922,17305,235
2021-04-29,Marin,041,260295,13965,13884,239,14123,228
2021-04-29,Mariposa,043,17540,421,416,11,427,5
2021-04-29,Mendocino,045,87422,3841,3774,80,3854,46
2021-04-29,Merced,047,269075,30655,30706,1037,31743,444
2021-04-29,Modoc,049,8938,369,360,121,481,3
2021-04-29,Mono,051,14174,1246,1259,17,1276,3
2021-04-29,Monterey,053,433212,42942,42797,1849,44646,379
2021-04-29,Napa,055,140530,9789,9789,36,9825,81
2021-04-29,Nevada,057,99092,4689,4590,188,4778,70
2021-04-29,Orange,059,3164182,254175,252823,11224,264047,4934
2021-04-29,Placer,061,380077,22716,22161,1418,23579,286
2021-04-29,Plumas,063,18699,690,676,10,686,4
2021-04-29,Riverside,065,2383286,292587,286947,13925,300872,4409
2021-04-29,Sacramento,067,1510023,103518,102686,1663,104349,1593
2021-04-29,San Benito,069,59416,6016,6023,113,6136,63
2021-04-29,San Bernardino,071,2135413,291954,290606,8935,299541,4609
2021-04-29,San Diego,073,3302833,277781,275961,14513,290474,3700
2021-04-29,San Francisco,075,870044,36296,36412,1270,37682,537
2021-04-29,San Joaquin,077,732212,72029,71225,3453,74678,1301
2021-04-29,San Luis Obispo,079,281455,21151,20876,718,21594,255
2021-04-29,San Mateo,081,765935,41908,41538,461,41999,358
2021-04-29,Santa Barbara,083,443738,34196,34039,1131,35170,448
2021-04-29,Santa Clara,085,1922200,117600,118082,741,118823,1984
2021-04-29,Santa Cruz,087,273765,16122,15961,810,16771,205
2021-04-29,Shasta,089,179085,11843,11836,1464,13300,193
2021-04-29,Sierra,091,2930,56,53,12,65,0
2021-04-29,Siskiyou,093,43540,1761,1615,307,1922,11
2021-04-29,Solano,095,438530,32157,32002,503,32505,248
2021-04-29,Sonoma,097,501317,29657,29785,316,30101,318
2021-04-29,Stanislaus,099,539301,55203,54836,5833,60669,774
2021-04-29,Sutter,101,95872,9322,9346,83,9429,110
2021-04-29,Tehama,103,63373,4965,4939,557,5496,53
2021-04-29,Trinity,105,12862,482,326,86,412,3
2021-04-29,Tulare,107,460477,49807,48785,8855,57640,832
2021-04-29,Tuolumne,109,53932,3985,4030,39,4069,58
2021-04-29,Ventura,111,848112,80830,80188,2957,83145,1002
2021-04-29,Yolo,113,214977,13802,13745,282,14027,205
2021-04-29,Yuba,115,75493,5896,5865,121,5986,44
2021-04-28,Alameda,001,1643700,86717,86390,1908,88298,1260
2021-04-28,Alpine,003,1148,87,88,0,88,0
2021-04-28,Amador,005,37829,3648,3646,33,3679,46
2021-04-28,Butte,007,227075,12170,11762,1758,13520,196
2021-04-28,Calaveras,009,45235,2092,2078,12,2090,50
2021-04-28,Colusa,011,21464,1924,1927,292,2219,14
2021-04-28,Contra Costa,013,1133247,68169,67539,1225,68764,795
2021-04-28,Del Norte,015,27424,1322,1267,11,1278,6
2021-04-28,El Dorado,017,186661,9999,9873,719,10592,107
2021-04-28,Fresno,019,978130,101684,101161,8565,109726,1666
2021-04-28,Glenn,021,27897,2386,2368,540,2908,17
2021-04-28,Humboldt,023,135768,3835,3796,31,3827,36
2021-04-28,Imperial,025,180216,28282,28177,2689,30866,720
2021-04-28,Inyo,027,18085,1399,1396,11,1407,36
2021-04-28,Kern,029,883053,96555,95494,10665,106159,1295
2021-04-28,Kings,031,150075,23013,22767,1070,23837,245
2021-04-28,Lake,033,64148,3455,3433,9,3442,43
2021-04-28,Lassen,035,31185,5172,5138,105,5243,1
2021-04-28,Los Angeles,037,10098052,1200765,1191729,40955,1232684,23858
2021-04-28,Madera,039,155013,16487,16372,922,17294,235
2021-04-28,Marin,041,260295,13954,13866,239,14105,227
2021-04-28,Mariposa,043,17540,418,415,11,426,5
2021-04-28,Mendocino,045,87422,3835,3770,78,3848,46
2021-04-28,Merced,047,269075,30637,30649,1037,31686,443
2021-04-28,Modoc,049,8938,369,360,121,481,3
2021-04-28,Mono,051,14174,1246,1258,17,1275,3
2021-04-28,Monterey,053,433212,42937,42776,1849,44625,379
2021-04-28,Napa,055,140530,9778,9777,36,9813,81
2021-04-28,Nevada,057,99092,4669,4570,188,4758,70
2021-04-28,Orange,059,3164182,254095,252747,11211,263958,4931
2021-04-28,Placer,061,380077,22689,22115,1417,23532,285
2021-04-28,Plumas,063,18699,690,676,10,686,4
2021-04-28,Riverside,065,2383286,292531,286868,13919,300787,4407
2021-04-28,Sacramento,067,1510023,103396,102613,1659,104272,1591
2021-04-28,San Benito,069,59416,6014,6021,113,6134,63
2021-04-28,San Bernardino,071,2135413,291875,290548,8925,299473,4582
2021-04-28,San Diego,073,3302833,277627,275821,14499,290320,3698
2021-04-28,San Francisco,075,870044,36266,36382,1269,37651,534
2021-04-28,San Joaquin,077,732212,71949,71171,3445,74616,1301
2021-04-28,San Luis Obispo,079,281455,21143,20851,718,21569,255
2021-04-28,San Mateo,081,765935,41883,41498,459,41957,358
2021-04-28,Santa Barbara,083,443738,34182,34003,1131,35134,448
2021-04-28,Santa Clara,085,1922200,117531,117997,739,118736,1969
2021-04-28,Santa Cruz,087,273765,16118,15943,809,16752,205
2021-04-28,Shasta,089,179085,11827,11815,1457,13272,192
2021-04-28,Sierra,091,2930,56,51,12,63,0
2021-04-28,Siskiyou,093,43540,1748,1603,304,1907,11
2021-04-28,Solano,095,438530,32125,31982,498,32480,248
2021-04-28,Sonoma,097,501317,29643,29773,312,30085,318
2021-04-28,Stanislaus,099,539301,55148,54745,5830,60575,774
2021-04-28,Sutter,101,95872,9317,9343,83,9426,110
2021-04-28,Tehama,103,63373,4960,4930,556,5486,53
2021-04-28,Trinity,105,12862,482,326,86,412,3
2021-04-28,Tulare,107,460477,49789,48754,8840,57594,832
2021-04-28,Tuolumne,109,53932,3982,4029,39,4068,58
2021-04-28,Ventura,111,848112,80795,80172,2955,83127,1000
2021-04-28,Yolo,113,214977,13788,13721,281,14002,205
2021-04-28,Yuba,115,75493,5890,5857,121,5978,44
2021-04-27,Alameda,001,1643700,86627,86301,1902,88203,1260
2021-04-27,Alpine,003,1148,87,88,0,88,0
2021-04-27,Amador,005,37829,3648,3645,33,3678,46
2021-04-27,Butte,007,227075,12145,11738,1752,13490,196
2021-04-27,Calaveras,009,45235,2090,2076,12,2088,50
2021-04-27,Colusa,011,21464,1923,1926,292,2218,14
2021-04-27,Contra Costa,013,1133247,68100,67470,1221,68691,791
2021-04-27,Del Norte,015,27424,1310,1266,11,1277,6
2021-04-27,El Dorado,017,186661,9970,9866,716,10582,106
2021-04-27,Fresno,019,978130,101619,101138,8555,109693,1663
2021-04-27,Glenn,021,27897,2386,2368,540,2908,17
2021-04-27,Humboldt,023,135768,3823,3780,31,3811,35
2021-04-27,Imperial,025,180216,28266,28149,2683,30832,720
2021-04-27,Inyo,027,18085,1399,1396,11,1407,36
2021-04-27,Kern,029,883053,96498,95466,10654,106120,1295
2021-04-27,Kings,031,150075,22998,22759,1068,23827,244
2021-04-27,Lake,033,64148,3454,3431,9,3440,43
2021-04-27,Lassen,035,31185,5172,5137,105,5242,1
2021-04-27,Los Angeles,037,10098052,1200440,1191504,40925,1232429,23825
2021-04-27,Madera,039,155013,16480,16365,922,17287,235
2021-04-27,Marin,041,260295,13932,13855,239,14094,227
2021-04-27,Mariposa,043,17540,417,413,11,424,5
2021-04-27,Mendocino,045,87422,3831,3765,78,3843,46
2021-04-27,Merced,047,269075,30596,30620,1037,31657,443
2021-04-27,Modoc,049,8938,368,360,121,481,3
2021-04-27,Mono,051,14174,1246,1257,17,1274,3
2021-04-27,Monterey,053,433212,42919,42752,1846,44598,379
2021-04-27,Napa,055,140530,9771,9774,34,9808,81
2021-04-27,Nevada,057,99092,4654,4557,188,4745,70
2021-04-27,Orange,059,3164182,254025,252667,11206,263873,4925
2021-04-27,Placer,061,380077,22660,22050,1413,23463,285
2021-04-27,Plumas,063,18699,689,675,10,685,4
2021-04-27,Riverside,065,2383286,292455,286820,13915,300735,4405
2021-04-27,Sacramento,067,1510023,103267,102595,1649,104244,1589
2021-04-27,San Benito,069,59416,6009,6016,113,6129,63
2021-04-27,San Bernardino,071,2135413,291806,290461,8920,299381,4575
2021-04-27,San Diego,073,3302833,277470,275685,14479,290164,3692
2021-04-27,San Francisco,075,870044,36238,36358,1268,37626,533
2021-04-27,San Joaquin,077,732212,71896,71104,3439,74543,1301
2021-04-27,San Luis Obispo,079,281455,21136,20841,718,21559,255
2021-04-27,San Mateo,081,765935,41848,41474,458,41932,358
2021-04-27,Santa Barbara,083,443738,34158,33973,1130,35103,448
2021-04-27,Santa Clara,085,1922200,117481,117945,738,118683,1969
2021-04-27,Santa Cruz,087,273765,16111,15905,808,16713,205
2021-04-27,Shasta,089,179085,11799,11802,1450,13252,192
2021-04-27,Sierra,091,2930,56,51,12,63,0
2021-04-27,Siskiyou,093,43540,1733,1597,303,1900,11
2021-04-27,Solano,095,438530,32077,31964,497,32461,248
2021-04-27,Sonoma,097,501317,29625,29761,311,30072,318
2021-04-27,Stanislaus,099,539301,55078,54695,5822,60517,752
2021-04-27,Sutter,101,95872,9312,9342,83,9425,110
2021-04-27,Tehama,103,63373,4957,4922,552,5474,53
2021-04-27,Trinity,105,12862,482,326,86,412,3
2021-04-27,Tulare,107,460477,49773,48744,8831,57575,832
2021-04-27,Tuolumne,109,53932,3979,4028,39,4067,58
2021-04-27,Ventura,111,848112,80766,80152,2953,83105,1000
2021-04-27,Yolo,113,214977,13775,13697,279,13976,205
2021-04-27,Yuba,115,75493,5890,5853,121,5974,44
2021-04-26,Alameda,001,1643700,86533,86230,1899,88129,1256
2021-04-26,Alpine,003,1148,87,88,0,88,0
2021-04-26,Amador,005,37829,3647,3645,33,3678,46
2021-04-26,Butte,007,227075,12121,11720,1748,13468,196
2021-04-26,Calaveras,009,45235,2084,2074,12,2086,50
2021-04-26,Colusa,011,21464,1923,1925,291,2216,14
2021-04-26,Contra Costa,013,1133247,68033,67392,1217,68609,789
2021-04-26,Del Norte,015,27424,1301,1263,11,1274,6
2021-04-26,El Dorado,017,186661,9949,9849,715,10564,106
2021-04-26,Fresno,019,978130,101564,101099,8541,109640,1662
2021-04-26,Glenn,021,27897,2384,2367,540,2907,17
2021-04-26,Humboldt,023,135768,3813,3764,30,3794,35
2021-04-26,Imperial,025,180216,28253,28148,2680,30828,720
2021-04-26,Inyo,027,18085,1398,1396,11,1407,36
2021-04-26,Kern,029,883053,96471,95429,10648,106077,1295
2021-04-26,Kings,031,150075,22995,22756,1065,23821,244
2021-04-26,Lake,033,64148,3449,3428,9,3437,43
2021-04-26,Lassen,035,31185,5172,5138,105,5243,1
2021-04-26,Los Angeles,037,10098052,1200110,1191253,40906,1232159,23802
2021-04-26,Madera,039,155013,16468,16353,921,17274,231
2021-04-26,Marin,041,260295,13917,13849,239,14088,227
2021-04-26,Mariposa,043,17540,416,410,11,421,5
2021-04-26,Mendocino,045,87422,3829,3757,77,3834,46
2021-04-26,Merced,047,269075,30579,30611,1034,31645,443
2021-04-26,Modoc,049,8938,368,360,121,481,3
2021-04-26,Mono,051,14174,1246,1258,17,1275,3
2021-04-26,Monterey,053,433212,42903,42740,1845,44585,379
2021-04-26,Napa,055,140530,9759,9769,34,9803,79
2021-04-26,Nevada,057,99092,4633,4548,188,4736,70
2021-04-26,Orange,059,3164182,253941,252592,11195,263787,4919
2021-04-26,Placer,061,380077,22632,22032,1408,23440,285
2021-04-26,Plumas,063,18699,689,670,10,680,4
2021-04-26,Riverside,065,2383286,292393,286724,13907,300631,4401
2021-04-26,Sacramento,067,1510023,103095,102459,1636,104095,1587
2021-04-26,San Benito,069,59416,6007,6013,113,6126,63
2021-04-26,San Bernardino,071,2135413,291755,290394,8919,299313,4572
2021-04-26,San Diego,073,3302833,277295,275541,14451,289992,3692
2021-04-26,San Francisco,075,870044,36210,36330,1267,37597,532
2021-04-26,San Joaquin,077,732212,71830,71050,3431,74481,1301
2021-04-26,San Luis Obispo,079,281455,21128,20830,717,21547,255
2021-04-26,San Mateo,081,765935,41818,41457,458,41915,357
2021-04-26,Santa Barbara,083,443738,34127,33948,1130,35078,448
2021-04-26,Santa Clara,085,1922200,117381,117874,735,118609,1968
2021-04-26,Santa Cruz,087,273765,16102,15877,808,16685,205
2021-04-26,Shasta,089,179085,11782,11787,1444,13231,192
2021-04-26,Sierra,091,2930,55,51,12,63,0
2021-04-26,Siskiyou,093,43540,1723,1592,300,1892,11
2021-04-26,Solano,095,438530,32032,31913,495,32408,247
2021-04-26,Sonoma,097,501317,29602,29755,309,30064,318
2021-04-26,Stanislaus,099,539301,54988,54638,5816,60454,744
2021-04-26,Sutter,101,95872,9307,9328,83,9411,110
2021-04-26,Tehama,103,63373,4952,4920,549,5469,53
2021-04-26,Trinity,105,12862,482,326,86,412,3
2021-04-26,Tulare,107,460477,49753,48735,8822,57557,831
2021-04-26,Tuolumne,109,53932,3978,4024,39,4063,58
2021-04-26,Ventura,111,848112,80741,80137,2950,83087,999
2021-04-26,Yolo,113,214977,13755,13684,276,13960,205
2021-04-26,Yuba,115,75493,5888,5851,121,5972,44
2021-04-25,Alameda,001,1643700,86432,86162,1892,88054,1256
2021-04-25,Alpine,003,1148,87,87,0,87,0
2021-04-25,Amador,005,37829,3646,3643,33,3676,46
2021-04-25,Butte,007,227075,12092,11709,1741,13450,196
2021-04-25,Calaveras,009,45235,2079,2072,11,2083,50
2021-04-25,Colusa,011,21464,1922,1924,291,2215,14
2021-04-25,Contra Costa,013,1133247,67941,67316,1216,68532,789
2021-04-25,Del Norte,015,27424,1295,1259,11,1270,6
2021-04-25,El Dorado,017,186661,9932,9837,713,10550,106
2021-04-25,Fresno,019,978130,101505,101061,8529,109590,1662
2021-04-25,Glenn,021,27897,2384,2366,540,2906,17
2021-04-25,Humboldt,023,135768,3800,3751,30,3781,35
2021-04-25,Imperial,025,180216,28227,28136,2677,30813,720
2021-04-25,Inyo,027,18085,1398,1396,11,1407,36
2021-04-25,Kern,029,883053,96405,95398,10635,106033,1295
2021-04-25,Kings,031,150075,22981,22755,1063,23818,244
2021-04-25,Lake,033,64148,3447,3427,9,3436,43
2021-04-25,Lassen,035,31185,5170,5138,105,5243,1
2021-04-25,Los Angeles,037,10098052,1199773,1190970,40886,1231856,23799
2021-04-25,Madera,039,155013,16456,16346,921,17267,231
2021-04-25,Marin,041,260295,13908,13852,239,14091,227
2021-04-25,Mariposa,043,17540,416,410,11,421,5
2021-04-25,Mendocino,045,87422,3822,3757,77,3834,46
2021-04-25,Merced,047,269075,30545,30586,1033,31619,443
2021-04-25,Modoc,049,8938,368,360,121,481,3
2021-04-25,Mono,051,14174,1246,1257,17,1274,3
2021-04-25,Monterey,053,433212,42890,42737,1843,44580,379
2021-04-25,Napa,055,140530,9754,9762,34,9796,79
2021-04-25,Nevada,057,99092,4621,4536,188,4724,70
2021-04-25,Orange,059,3164182,253865,252531,11188,263719,4919
2021-04-25,Placer,061,380077,22586,22011,1400,23411,285
2021-04-25,Plumas,063,18699,688,670,10,680,4
2021-04-25,Riverside,065,2383286,292299,286651,13901,300552,4401
2021-04-25,Sacramento,067,1510023,102927,102319,1626,103945,1587
2021-04-25,San Benito,069,59416,6005,6014,112,6126,63
2021-04-25,San Bernardino,071,2135413,291680,290357,8911,299268,4571
2021-04-25,San Diego,073,3302833,277082,275412,14418,289830,3692
2021-04-25,San Francisco,075,870044,36179,36310,1267,37577,532
2021-04-25,San Joaquin,077,732212,71735,70987,3421,74408,1301
2021-04-25,San Luis Obispo,079,281455,21109,20820,715,21535,255
2021-04-25,San Mateo,081,765935,41783,41465,457,41922,356
2021-04-25,Santa Barbara,083,443738,34101,33931,1130,35061,448
2021-04-25,Santa Clara,085,1922200,117302,117778,733,118511,1968
2021-04-25,Santa Cruz,087,273765,16096,15868,806,16674,205
2021-04-25,Shasta,089,179085,11759,11784,1439,13223,192
2021-04-25,Sierra,091,2930,55,51,12,63,0
2021-04-25,Siskiyou,093,43540,1712,1580,298,1878,11
2021-04-25,Solano,095,438530,31985,31864,487,32351,247
2021-04-25,Sonoma,097,501317,29584,29756,309,30065,318
2021-04-25,Stanislaus,099,539301,54892,54543,5808,60351,744
2021-04-25,Sutter,101,95872,9301,9326,83,9409,110
2021-04-25,Tehama,103,63373,4948,4916,547,5463,53
2021-04-25,Trinity,105,12862,482,326,86,412,3
2021-04-25,Tulare,107,460477,49737,48728,8808,57536,831
2021-04-25,Tuolumne,109,53932,3976,4022,39,4061,58
2021-04-25,Ventura,111,848112,80717,80110,2950,83060,999
2021-04-25,Yolo,113,214977,13730,13667,274,13941,205
2021-04-25,Yuba,115,75493,5885,5849,120,5969,44
2021-04-24,Alameda,001,1643700,86377,86016,1890,87906,1257
2021-04-24,Alpine,003,1148,87,86,0,86,0
2021-04-24,Amador,005,37829,3645,3640,33,3673,46
2021-04-24,Butte,007,227075,12076,11678,1739,13417,196
2021-04-24,Calaveras,009,45235,2075,2067,11,2078,50
2021-04-24,Colusa,011,21464,1921,1921,291,2212,14
2021-04-24,Contra Costa,013,1133247,67871,67222,1214,68436,789
2021-04-24,Del Norte,015,27424,1290,1255,11,1266,6
2021-04-24,El Dorado,017,186661,9921,9814,712,10526,106
2021-04-24,Fresno,019,978130,101474,100991,8523,109514,1662
2021-04-24,Glenn,021,27897,2384,2363,540,2903,17
2021-04-24,Humboldt,023,135768,3786,3722,30,3752,35
2021-04-24,Imperial,025,180216,28220,28124,2676,30800,720
2021-04-24,Inyo,027,18085,1397,1396,11,1407,36
2021-04-24,Kern,029,883053,96386,95365,10625,105990,1295
2021-04-24,Kings,031,150075,22978,22749,1063,23812,244
2021-04-24,Lake,033,64148,3446,3426,9,3435,43
2021-04-24,Lassen,035,31185,5169,5137,105,5242,1
2021-04-24,Los Angeles,037,10098052,1199543,1190603,40870,1231473,23802
2021-04-24,Madera,039,155013,16453,16338,921,17259,231
2021-04-24,Marin,041,260295,13900,13847,239,14086,227
2021-04-24,Mariposa,043,17540,416,409,11,420,5
2021-04-24,Mendocino,045,87422,3820,3754,75,3829,46
2021-04-24,Merced,047,269075,30525,30559,1033,31592,443
2021-04-24,Modoc,049,8938,368,360,121,481,3
2021-04-24,Mono,051,14174,1246,1256,17,1273,3
2021-04-24,Monterey,053,433212,42878,42727,1842,44569,379
2021-04-24,Napa,055,140530,9748,9756,34,9790,79
2021-04-24,Nevada,057,99092,4614,4522,188,4710,70
2021-04-24,Orange,059,3164182,253821,252441,11182,263623,4910
2021-04-24,Placer,061,380077,22573,21983,1399,23382,285
2021-04-24,Plumas,063,18699,687,670,10,680,4
2021-04-24,Riverside,065,2383286,292231,286552,13897,300449,4400
2021-04-24,Sacramento,067,1510023,102844,102179,1619,103798,1587
2021-04-24,San Benito,069,59416,6003,6007,112,6119,63
2021-04-24,San Bernardino,071,2135413,291631,290264,8910,299174,4568
2021-04-24,San Diego,073,3302833,276979,275252,14398,289650,3688
2021-04-24,San Francisco,075,870044,36150,36285,1263,37548,532
2021-04-24,San Joaquin,077,732212,71692,70911,3418,74329,1301
2021-04-24,San Luis Obispo,079,281455,21099,20797,714,21511,255
2021-04-24,San Mateo,081,765935,41770,41424,455,41879,355
2021-04-24,Santa Barbara,083,443738,34086,33911,1129,35040,448
2021-04-24,Santa Clara,085,1922200,117247,117674,731,118405,1968
2021-04-24,Santa Cruz,087,273765,16088,15840,806,16646,205
2021-04-24,Shasta,089,179085,11741,11770,1436,13206,192
2021-04-24,Sierra,091,2930,55,51,12,63,0
2021-04-24,Siskiyou,093,43540,1702,1574,297,1871,11
2021-04-24,Solano,095,438530,31962,31821,484,32305,247
2021-04-24,Sonoma,097,501317,29582,29739,309,30048,318
2021-04-24,Stanislaus,099,539301,54843,54455,5805,60260,744
2021-04-24,Sutter,101,95872,9298,9316,83,9399,110
2021-04-24,Tehama,103,63373,4943,4907,547,5454,53
2021-04-24,Trinity,105,12862,482,326,86,412,3
2021-04-24,Tulare,107,460477,49726,48705,8798,57503,830
2021-04-24,Tuolumne,109,53932,3972,4020,39,4059,58
2021-04-24,Ventura,111,848112,80704,80097,2948,83045,999
2021-04-24,Yolo,113,214977,13719,13653,274,13927,205
2021-04-24,Yuba,115,75493,5883,5837,120,5957,44
2021-04-23,Alameda,001,1643700,86303,85935,1887,87822,1256
2021-04-23,Alpine,003,1148,86,86,0,86,0
2021-04-23,Amador,005,37829,3644,3637,33,3670,46
2021-04-23,Butte,007,227075,12055,11672,1734,13406,196
2021-04-23,Calaveras,009,45235,2072,2064,11,2075,50
2021-04-23,Colusa,011,21464,1920,1921,291,2212,14
2021-04-23,Contra Costa,013,1133247,67817,67164,1212,68376,785
2021-04-23,Del Norte,015,27424,1289,1254,11,1265,6
2021-04-23,El Dorado,017,186661,9903,9788,709,10497,106
2021-04-23,Fresno,019,978130,101433,100928,8517,109445,1662
2021-04-23,Glenn,021,27897,2384,2361,539,2900,17
2021-04-23,Humboldt,023,135768,3776,3698,30,3728,35
2021-04-23,Imperial,025,180216,28205,28108,2675,30783,720
2021-04-23,Inyo,027,18085,1397,1395,11,1406,36
2021-04-23,Kern,029,883053,96361,95330,10619,105949,1295
2021-04-23,Kings,031,150075,22975,22735,1063,23798,244
2021-04-23,Lake,033,64148,3444,3425,9,3434,43
2021-04-23,Lassen,035,31185,5169,5141,105,5246,1
2021-04-23,Los Angeles,037,10098052,1199277,1190264,40845,1231109,23785
2021-04-23,Madera,039,155013,16444,16328,921,17249,231
2021-04-23,Marin,041,260295,13895,13838,239,14077,227
2021-04-23,Mariposa,043,17540,415,405,11,416,5
2021-04-23,Mendocino,045,87422,3818,3745,74,3819,46
2021-04-23,Merced,047,269075,30508,30530,1032,31562,443
2021-04-23,Modoc,049,8938,368,360,121,481,3
2021-04-23,Mono,051,14174,1244,1256,17,1273,3
2021-04-23,Monterey,053,433212,42872,42722,1842,44564,377
2021-04-23,Napa,055,140530,9743,9752,34,9786,79
2021-04-23,Nevada,057,99092,4605,4510,188,4698,70
2021-04-23,Orange,059,3164182,253777,252399,11175,263574,4904
2021-04-23,Placer,061,380077,22550,21959,1398,23357,282
2021-04-23,Plumas,063,18699,686,670,10,680,4
2021-04-23,Riverside,065,2383286,292172,286456,13892,300348,4399
2021-04-23,Sacramento,067,1510023,102757,102041,1616,103657,1586
2021-04-23,San Benito,069,59416,6001,6005,112,6117,63
2021-04-23,San Bernardino,071,2135413,291580,290189,8909,299098,4568
2021-04-23,San Diego,073,3302833,276840,275097,14375,289472,3684
2021-04-23,San Francisco,075,870044,36134,36252,1262,37514,532
2021-04-23,San Joaquin,077,732212,71636,70840,3415,74255,1295
2021-04-23,San Luis Obispo,079,281455,21090,20781,713,21494,255
2021-04-23,San Mateo,081,765935,41744,41386,455,41841,355
2021-04-23,Santa Barbara,083,443738,34076,33895,1127,35022,447
2021-04-23,Santa Clara,085,1922200,117185,117593,730,118323,1965
2021-04-23,Santa Cruz,087,273765,16081,15802,806,16608,205
2021-04-23,Shasta,089,179085,11734,11759,1435,13194,192
2021-04-23,Sierra,091,2930,55,51,12,63,0
2021-04-23,Siskiyou,093,43540,1690,1567,296,1863,11
2021-04-23,Solano,095,438530,31930,31784,480,32264,247
2021-04-23,Sonoma,097,501317,29568,29727,309,30036,318
2021-04-23,Stanislaus,099,539301,54781,54391,5797,60188,744
2021-04-23,Sutter,101,95872,9296,9312,83,9395,110
2021-04-23,Tehama,103,63373,4940,4906,547,5453,53
2021-04-23,Trinity,105,12862,482,326,86,412,3
2021-04-23,Tulare,107,460477,49709,48694,8790,57484,829
2021-04-23,Tuolumne,109,53932,3971,4020,39,4059,58
2021-04-23,Ventura,111,848112,80685,80095,2948,83043,996
2021-04-23,Yolo,113,214977,13708,13647,273,13920,205
2021-04-23,Yuba,115,75493,5880,5828,120,5948,44
2021-04-22,Alameda,001,1643700,86213,85829,1886,87715,1253
2021-04-22,Alpine,003,1148,86,86,0,86,0
2021-04-22,Amador,005,37829,3643,3633,33,3666,46
2021-04-22,Butte,007,227075,12041,11656,1731,13387,196
2021-04-22,Calaveras,009,45235,2070,2059,11,2070,50
2021-04-22,Colusa,011,21464,1918,1920,289,2209,14
2021-04-22,Contra Costa,013,1133247,67745,67029,1207,68236,782
2021-04-22,Del Norte,015,27424,1284,1252,11,1263,6
2021-04-22,El Dorado,017,186661,9891,9773,706,10479,106
2021-04-22,Fresno,019,978130,101388,100864,8506,109370,1657
2021-04-22,Glenn,021,27897,2383,2361,539,2900,17
2021-04-22,Humboldt,023,135768,3767,3680,30,3710,35
2021-04-22,Imperial,025,180216,28184,28096,2672,30768,720
2021-04-22,Inyo,027,18085,1396,1394,11,1405,36
2021-04-22,Kern,029,883053,96318,95292,10603,105895,1299
2021-04-22,Kings,031,150075,22965,22725,1063,23788,243
2021-04-22,Lake,033,64148,3442,3423,9,3432,43
2021-04-22,Lassen,035,31185,5169,5155,105,5260,1
2021-04-22,Los Angeles,037,10098052,1198956,1189878,40824,1230702,23762
2021-04-22,Madera,039,155013,16425,16316,921,17237,231
2021-04-22,Marin,041,260295,13887,13832,239,14071,227
2021-04-22,Mariposa,043,17540,414,403,11,414,5
2021-04-22,Mendocino,045,87422,3812,3729,74,3803,46
2021-04-22,Merced,047,269075,30473,30490,1031,31521,443
2021-04-22,Modoc,049,8938,368,360,121,481,3
2021-04-22,Mono,051,14174,1244,1254,17,1271,3
2021-04-22,Monterey,053,433212,42865,42708,1840,44548,377
2021-04-22,Napa,055,140530,9733,9734,34,9768,79
2021-04-22,Nevada,057,99092,4595,4504,186,4690,70
2021-04-22,Orange,059,3164182,253704,252307,11162,263469,4898
2021-04-22,Placer,061,380077,22519,21916,1394,23310,282
2021-04-22,Plumas,063,18699,685,670,10,680,4
2021-04-22,Riverside,065,2383286,292073,286362,13883,300245,4398
2021-04-22,Sacramento,067,1510023,102608,101870,1607,103477,1585
2021-04-22,San Benito,069,59416,5997,5998,112,6110,63
2021-04-22,San Bernardino,071,2135413,291510,290125,8900,299025,4571
2021-04-22,San Diego,073,3302833,276674,275913,14353,290266,3684
2021-04-22,San Francisco,075,870044,36111,36218,1259,37477,532
2021-04-22,San Joaquin,077,732212,71577,70751,3408,74159,1295
2021-04-22,San Luis Obispo,079,281455,21076,20761,713,21474,255
2021-04-22,San Mateo,081,765935,41718,41345,453,41798,355
2021-04-22,Santa Barbara,083,443738,34053,33870,1126,34996,446
2021-04-22,Santa Clara,085,1922200,117097,117457,726,118183,1954
2021-04-22,Santa Cruz,087,273765,16078,15737,805,16542,205
2021-04-22,Shasta,089,179085,11719,11738,1433,13171,192
2021-04-22,Sierra,091,2930,55,51,12,63,0
2021-04-22,Siskiyou,093,43540,1686,1564,295,1859,11
2021-04-22,Solano,095,438530,31884,31731,477,32208,247
2021-04-22,Sonoma,097,501317,29553,29705,305,30010,318
2021-04-22,Stanislaus,099,539301,54708,54313,5791,60104,744
2021-04-22,Sutter,101,95872,9292,9302,83,9385,110
2021-04-22,Tehama,103,63373,4934,4896,543,5439,53
2021-04-22,Trinity,105,12862,482,326,86,412,3
2021-04-22,Tulare,107,460477,49689,48669,8781,57450,828
2021-04-22,Tuolumne,109,53932,3967,4020,39,4059,58
2021-04-22,Ventura,111,848112,80659,80073,2946,83019,996
2021-04-22,Yolo,113,214977,13687,13616,273,13889,205
2021-04-22,Yuba,115,75493,5870,5825,120,5945,44
2021-04-21,Alameda,001,1643700,86134,85762,1884,87646,1249
2021-04-21,Alpine,003,1148,86,86,0,86,0
2021-04-21,Amador,005,37829,3640,3632,33,3665,46
2021-04-21,Butte,007,227075,12021,11643,1729,13372,196
2021-04-21,Calaveras,009,45235,2062,2057,11,2068,50
2021-04-21,Colusa,011,21464,1916,1920,288,2208,14
2021-04-21,Contra Costa,013,1133247,67679,66981,1206,68187,782
2021-04-21,Del Norte,015,27424,1280,1252,11,1263,6
2021-04-21,El Dorado,017,186661,9874,9760,703,10463,106
2021-04-21,Fresno,019,978130,101332,100838,8500,109338,1654
2021-04-21,Glenn,021,27897,2382,2361,539,2900,17
2021-04-21,Humboldt,023,135768,3748,3642,30,3672,35
2021-04-21,Imperial,025,180216,28172,28052,2671,30723,719
2021-04-21,Inyo,027,18085,1396,1392,11,1403,36
2021-04-21,Kern,029,883053,96272,95257,10593,105850,1297
2021-04-21,Kings,031,150075,22958,22713,1062,23775,243
2021-04-21,Lake,033,64148,3439,3421,9,3430,43
2021-04-21,Lassen,035,31185,5168,5156,105,5261,1
2021-04-21,Los Angeles,037,10098052,1198615,1189530,40804,1230334,23729
2021-04-21,Madera,039,155013,16420,16309,921,17230,231
2021-04-21,Marin,041,260295,13872,13822,239,14061,227
2021-04-21,Mariposa,043,17540,413,402,11,413,5
2021-04-21,Mendocino,045,87422,3810,3729,74,3803,46
2021-04-21,Merced,047,269075,30453,30471,1029,31500,442
2021-04-21,Modoc,049,8938,368,360,121,481,3
2021-04-21,Mono,051,14174,1244,1254,17,1271,3
2021-04-21,Monterey,053,433212,42850,42699,1838,44537,377
2021-04-21,Napa,055,140530,9727,9727,34,9761,79
2021-04-21,Nevada,057,99092,4581,4499,186,4685,70
2021-04-21,Orange,059,3164182,253628,252243,11149,263392,4889
2021-04-21,Placer,061,380077,22488,21896,1389,23285,282
2021-04-21,Plumas,063,18699,685,670,10,680,4
2021-04-21,Riverside,065,2383286,291979,286299,13876,300175,4388
2021-04-21,Sacramento,067,1510023,102479,101803,1601,103404,1579
2021-04-21,San Benito,069,59416,5994,5998,112,6110,63
2021-04-21,San Bernardino,071,2135413,291434,290049,8898,298947,4572
2021-04-21,San Diego,073,3302833,276465,275632,14315,289947,3681
2021-04-21,San Francisco,075,870044,36091,36194,1258,37452,529
2021-04-21,San Joaquin,077,732212,71522,70687,3398,74085,1295
2021-04-21,San Luis Obispo,079,281455,21061,20724,712,21436,255
2021-04-21,San Mateo,081,765935,41687,41318,452,41770,355
2021-04-21,Santa Barbara,083,443738,34034,33830,1125,34955,445
2021-04-21,Santa Clara,085,1922200,117019,117318,720,118038,1946
2021-04-21,Santa Cruz,087,273765,16069,15698,805,16503,204
2021-04-21,Shasta,089,179085,11700,11722,1431,13153,192
2021-04-21,Sierra,091,2930,55,51,12,63,0
2021-04-21,Siskiyou,093,43540,1679,1557,295,1852,11
2021-04-21,Solano,095,438530,31845,31712,476,32188,244
2021-04-21,Sonoma,097,501317,29541,29697,303,30000,318
2021-04-21,Stanislaus,099,539301,54647,54290,5785,60075,742
2021-04-21,Sutter,101,95872,9284,9297,83,9380,110
2021-04-21,Tehama,103,63373,4927,4893,542,5435,53
2021-04-21,Trinity,105,12862,482,326,86,412,3
2021-04-21,Tulare,107,460477,49674,48653,8768,57421,828
2021-04-21,Tuolumne,109,53932,3964,4019,39,4058,58
2021-04-21,Ventura,111,848112,80627,80039,2943,82982,996
2021-04-21,Yolo,113,214977,13667,13606,272,13878,200
2021-04-21,Yuba,115,75493,5863,5822,119,5941,44
2021-04-20,Alameda,001,1643700,86039,85652,1882,87534,1248
2021-04-20,Alpine,003,1148,85,85,0,85,0
2021-04-20,Amador,005,37829,3639,3631,33,3664,46
2021-04-20,Butte,007,227075,12002,11619,1727,13346,196
2021-04-20,Calaveras,009,45235,2061,2053,11,2064,50
2021-04-20,Colusa,011,21464,1916,1915,287,2202,14
2021-04-20,Contra Costa,013,1133247,67595,66889,1203,68092,782
2021-04-20,Del Norte,015,27424,1279,1250,11,1261,6
2021-04-20,El Dorado,017,186661,9846,9743,701,10444,106
2021-04-20,Fresno,019,978130,101274,100768,8490,109258,1650
2021-04-20,Glenn,021,27897,2380,2359,538,2897,17
2021-04-20,Humboldt,023,135768,3730,3612,30,3642,35
2021-04-20,Imperial,025,180216,28153,28024,2667,30691,719
2021-04-20,Inyo,027,18085,1396,1393,11,1404,36
2021-04-20,Kern,029,883053,96236,95223,10576,105799,1295
2021-04-20,Kings,031,150075,22952,22693,1059,23752,243
2021-04-20,Lake,033,64148,3437,3418,9,3427,43
2021-04-20,Lassen,035,31185,5168,5155,105,5260,1
2021-04-20,Los Angeles,037,10098052,1198268,1189256,40774,1230030,23694
2021-04-20,Madera,039,155013,16414,16301,921,17222,231
2021-04-20,Marin,041,260295,13858,13807,239,14046,227
2021-04-20,Mariposa,043,17540,412,402,11,413,5
2021-04-20,Mendocino,045,87422,3809,3726,74,3800,46
2021-04-20,Merced,047,269075,30426,30439,1028,31467,441
2021-04-20,Modoc,049,8938,368,359,121,480,3
2021-04-20,Mono,051,14174,1243,1254,17,1271,3
2021-04-20,Monterey,053,433212,42839,42663,1835,44498,363
2021-04-20,Napa,055,140530,9723,9711,34,9745,79
2021-04-20,Nevada,057,99092,4563,4485,186,4671,70
2021-04-20,Orange,059,3164182,253538,252134,11137,263271,4887
2021-04-20,Placer,061,380077,22454,21846,1385,23231,282
2021-04-20,Plumas,063,18699,684,670,10,680,4
2021-04-20,Riverside,065,2383286,291882,286194,13871,300065,4388
2021-04-20,Sacramento,067,1510023,102341,101629,1593,103222,1574
2021-04-20,San Benito,069,59416,5991,5988,112,6100,63
2021-04-20,San Bernardino,071,2135413,291354,289905,8896,298801,4569
2021-04-20,San Diego,073,3302833,276234,275369,14282,289651,3674
2021-04-20,San Francisco,075,870044,36072,36117,1257,37374,529
2021-04-20,San Joaquin,077,732212,71449,70590,3389,73979,1289
2021-04-20,San Luis Obispo,079,281455,21038,20691,704,21395,254
2021-04-20,San Mateo,081,765935,41656,41251,452,41703,355
2021-04-20,Santa Barbara,083,443738,34015,33803,1125,34928,445
2021-04-20,Santa Clara,085,1922200,116921,117228,716,117944,1944
2021-04-20,Santa Cruz,087,273765,16057,15647,805,16452,204
2021-04-20,Shasta,089,179085,11684,11677,1428,13105,189
2021-04-20,Sierra,091,2930,55,51,12,63,0
2021-04-20,Siskiyou,093,43540,1671,1551,294,1845,10
2021-04-20,Solano,095,438530,31790,31673,472,32145,243
2021-04-20,Sonoma,097,501317,29532,29676,301,29977,311
2021-04-20,Stanislaus,099,539301,54582,54236,5772,60008,735
2021-04-20,Sutter,101,95872,9280,9279,83,9362,109
2021-04-20,Tehama,103,63373,4922,4887,541,5428,52
2021-04-20,Trinity,105,12862,482,326,86,412,3
2021-04-20,Tulare,107,460477,49651,48650,8760,57410,831
2021-04-20,Tuolumne,109,53932,3964,4014,39,4053,58
2021-04-20,Ventura,111,848112,80599,80018,2941,82959,995
2021-04-20,Yolo,113,214977,13647,13581,271,13852,200
2021-04-20,Yuba,115,75493,5853,5814,119,5933,44
2021-04-19,Alameda,001,1643700,85919,85583,1879,87462,1247
2021-04-19,Alpine,003,1148,85,85,0,85,0
2021-04-19,Amador,005,37829,3638,3629,33,3662,46
2021-04-19,Butte,007,227075,11984,11601,1722,13323,196
2021-04-19,Calaveras,009,45235,2059,2050,11,2061,50
2021-04-19,Colusa,011,21464,1916,1913,286,2199,14
2021-04-19,Contra Costa,013,1133247,67517,66833,1201,68034,782
2021-04-19,Del Norte,015,27424,1277,1247,11,1258,6
2021-04-19,El Dorado,017,186661,9830,9726,696,10422,106
2021-04-19,Fresno,019,978130,101206,100702,8478,109180,1646
2021-04-19,Glenn,021,27897,2380,2358,537,2895,17
2021-04-19,Humboldt,023,135768,3710,3602,28,3630,35
2021-04-19,Imperial,025,180216,28132,27995,2667,30662,719
2021-04-19,Inyo,027,18085,1396,1392,11,1403,36
2021-04-19,Kern,029,883053,96206,95162,10561,105723,1290
2021-04-19,Kings,031,150075,22937,22688,1059,23747,243
2021-04-19,Lake,033,64148,3436,3416,9,3425,43
2021-04-19,Lassen,035,31185,5167,5156,105,5261,1
2021-04-19,Los Angeles,037,10098052,1197890,1188945,40749,1229694,23666
2021-04-19,Madera,039,155013,16403,16289,920,17209,231
2021-04-19,Marin,041,260295,13847,13804,238,14042,226
2021-04-19,Mariposa,043,17540,411,401,11,412,5
2021-04-19,Mendocino,045,87422,3807,3722,74,3796,46
2021-04-19,Merced,047,269075,30397,30422,1027,31449,441
2021-04-19,Modoc,049,8938,368,359,121,480,3
2021-04-19,Mono,051,14174,1242,1254,17,1271,3
2021-04-19,Monterey,053,433212,42826,42642,1830,44472,356
2021-04-19,Napa,055,140530,9715,9680,34,9714,79
2021-04-19,Nevada,057,99092,4547,4477,186,4663,70
2021-04-19,Orange,059,3164182,253420,252013,11122,263135,4883
2021-04-19,Placer,061,380077,22431,21814,1381,23195,282
2021-04-19,Plumas,063,18699,684,665,10,675,4
2021-04-19,Riverside,065,2383286,291787,286087,13861,299948,4371
2021-04-19,Sacramento,067,1510023,102205,101482,1583,103065,1572
2021-04-19,San Benito,069,59416,5983,5989,112,6101,63
2021-04-19,San Bernardino,071,2135413,291268,289738,8890,298628,4561
2021-04-19,San Diego,073,3302833,275986,275113,14249,289362,3674
2021-04-19,San Francisco,075,870044,36036,36094,1254,37348,529
2021-04-19,San Joaquin,077,732212,71369,70514,3382,73896,1289
2021-04-19,San Luis Obispo,079,281455,21012,20669,698,21367,254
2021-04-19,San Mateo,081,765935,41623,41226,451,41677,355
2021-04-19,Santa Barbara,083,443738,34001,33786,1125,34911,446
2021-04-19,Santa Clara,085,1922200,116810,117099,712,117811,1944
2021-04-19,Santa Cruz,087,273765,16045,15600,805,16405,204
2021-04-19,Shasta,089,179085,11669,11662,1420,13082,189
2021-04-19,Sierra,091,2930,55,51,12,63,0
2021-04-19,Siskiyou,093,43540,1661,1544,294,1838,10
2021-04-19,Solano,095,438530,31751,31643,467,32110,239
2021-04-19,Sonoma,097,501317,29513,29667,301,29968,311
2021-04-19,Stanislaus,099,539301,54506,54179,5768,59947,728
2021-04-19,Sutter,101,95872,9269,9269,83,9352,109
2021-04-19,Tehama,103,63373,4916,4878,541,5419,52
2021-04-19,Trinity,105,12862,482,326,85,411,3
2021-04-19,Tulare,107,460477,49635,48630,8747,57377,831
2021-04-19,Tuolumne,109,53932,3963,4010,39,4049,58
2021-04-19,Ventura,111,848112,80573,80000,2939,82939,996
2021-04-19,Yolo,113,214977,13635,13572,268,13840,200
2021-04-19,Yuba,115,75493,5846,5804,118,5922,44
2021-04-18,Alameda,001,1643700,85805,85481,1871,87352,1247
2021-04-18,Alpine,003,1148,85,85,0,85,0
2021-04-18,Amador,005,37829,3635,3627,33,3660,46
2021-04-18,Butte,007,227075,11966,11591,1717,13308,196
2021-04-18,Calaveras,009,45235,2053,2047,11,2058,50
2021-04-18,Colusa,011,21464,1912,1912,285,2197,14
2021-04-18,Contra Costa,013,1133247,67414,66750,1197,67947,782
2021-04-18,Del Norte,015,27424,1277,1240,11,1251,6
2021-04-18,El Dorado,017,186661,9807,9710,694,10404,106
2021-04-18,Fresno,019,978130,101148,100621,8472,109093,1646
2021-04-18,Glenn,021,27897,2375,2358,537,2895,17
2021-04-18,Humboldt,023,135768,3682,3590,28,3618,35
2021-04-18,Imperial,025,180216,28117,27991,2662,30653,719
2021-04-18,Inyo,027,18085,1395,1392,11,1403,36
2021-04-18,Kern,029,883053,96170,95129,10545,105674,1290
2021-04-18,Kings,031,150075,22928,22685,1059,23744,243
2021-04-18,Lake,033,64148,3435,3413,9,3422,43
2021-04-18,Lassen,035,31185,5164,5156,105,5261,1
2021-04-18,Los Angeles,037,10098052,1197429,1188620,40726,1229346,23648
2021-04-18,Madera,039,155013,16392,16277,919,17196,231
2021-04-18,Marin,041,260295,13840,13801,237,14038,226
2021-04-18,Mariposa,043,17540,410,400,10,410,5
2021-04-18,Mendocino,045,87422,3804,3722,74,3796,46
2021-04-18,Merced,047,269075,30360,30405,1025,31430,441
2021-04-18,Modoc,049,8938,368,359,121,480,3
2021-04-18,Mono,051,14174,1242,1254,17,1271,3
2021-04-18,Monterey,053,433212,42814,42638,1829,44467,356
2021-04-18,Napa,055,140530,9699,9674,34,9708,79
2021-04-18,Nevada,057,99092,4532,4464,186,4650,70
2021-04-18,Orange,059,3164182,253306,251940,11115,263055,4883
2021-04-18,Placer,061,380077,22388,21783,1375,23158,282
2021-04-18,Plumas,063,18699,683,665,10,675,4
2021-04-18,Riverside,065,2383286,291697,286043,13857,299900,4371
2021-04-18,Sacramento,067,1510023,102030,101354,1577,102931,1572
2021-04-18,San Benito,069,59416,5981,5989,112,6101,63
2021-04-18,San Bernardino,071,2135413,291175,289691,8881,298572,4556
2021-04-18,San Diego,073,3302833,275707,274961,14214,289175,3674
2021-04-18,San Francisco,075,870044,35999,36073,1250,37323,525
2021-04-18,San Joaquin,077,732212,71288,70466,3373,73839,1289
2021-04-18,San Luis Obispo,079,281455,20990,20656,692,21348,254
2021-04-18,San Mateo,081,765935,41594,41201,450,41651,352
2021-04-18,Santa Barbara,083,443738,33966,33769,1124,34893,446
2021-04-18,Santa Clara,085,1922200,116642,116996,706,117702,1944
2021-04-18,Santa Cruz,087,273765,16035,15580,804,16384,204
2021-04-18,Shasta,089,179085,11648,11658,1417,13075,189
2021-04-18,Sierra,091,2930,55,51,12,63,0
2021-04-18,Siskiyou,093,43540,1650,1538,293,1831,10
2021-04-18,Solano,095,438530,31701,31606,466,32072,239
2021-04-18,Sonoma,097,501317,29497,29660,299,29959,311
2021-04-18,Stanislaus,099,539301,54424,54132,5761,59893,728
2021-04-18,Sutter,101,95872,9255,9261,83,9344,109
2021-04-18,Tehama,103,63373,4907,4877,540,5417,52
2021-04-18,Trinity,105,12862,482,326,85,411,3
2021-04-18,Tulare,107,460477,49623,48618,8741,57359,829
2021-04-18,Tuolumne,109,53932,3962,4008,38,4046,58
2021-04-18,Ventura,111,848112,80542,79984,2935,82919,996
2021-04-18,Yolo,113,214977,13623,13562,266,13828,200
2021-04-18,Yuba,115,75493,5839,5804,118,5922,44
2021-04-17,Alameda,001,1643700,85730,85367,1869,87236,1247
2021-04-17,Alpine,003,1148,85,85,0,85,0
2021-04-17,Amador,005,37829,3633,3625,33,3658,46
2021-04-17,Butte,007,227075,11946,11573,1713,13286,196
2021-04-17,Calaveras,009,45235,2051,2045,11,2056,50
2021-04-17,Colusa,011,21464,1912,1912,285,2197,14
2021-04-17,Contra Costa,013,1133247,67366,66657,1189,67846,782
2021-04-17,Del Norte,015,27424,1277,1238,11,1249,6
2021-04-17,El Dorado,017,186661,9792,9692,691,10383,106
2021-04-17,Fresno,019,978130,101115,100562,8467,109029,1646
2021-04-17,Glenn,021,27897,2375,2357,537,2894,17
2021-04-17,Humboldt,023,135768,3658,3579,28,3607,35
2021-04-17,Imperial,025,180216,28106,27987,2662,30649,719
2021-04-17,Inyo,027,18085,1392,1392,11,1403,36
2021-04-17,Kern,029,883053,96152,95102,10541,105643,1290
2021-04-17,Kings,031,150075,22923,22678,1058,23736,243
2021-04-17,Lake,033,64148,3434,3409,9,3418,43
2021-04-17,Lassen,035,31185,5164,5154,105,5259,1
2021-04-17,Los Angeles,037,10098052,1197172,1188262,40694,1228956,23653
2021-04-17,Madera,039,155013,16388,16260,918,17178,231
2021-04-17,Marin,041,260295,13836,13797,237,14034,226
2021-04-17,Mariposa,043,17540,409,398,10,408,5
2021-04-17,Mendocino,045,87422,3801,3721,74,3795,46
2021-04-17,Merced,047,269075,30344,30392,1024,31416,441
2021-04-17,Modoc,049,8938,368,357,121,478,3
2021-04-17,Mono,051,14174,1242,1253,17,1270,3
2021-04-17,Monterey,053,433212,42805,42630,1827,44457,356
2021-04-17,Napa,055,140530,9695,9666,34,9700,79
2021-04-17,Nevada,057,99092,4524,4457,186,4643,70
2021-04-17,Orange,059,3164182,253237,251873,11103,262976,4878
2021-04-17,Placer,061,380077,22365,21736,1370,23106,282
2021-04-17,Plumas,063,18699,682,666,10,676,4
2021-04-17,Riverside,065,2383286,291628,285963,13849,299812,4371
2021-04-17,Sacramento,067,1510023,101920,101172,1566,102738,1572
2021-04-17,San Benito,069,59416,5975,5986,112,6098,63
2021-04-17,San Bernardino,071,2135413,291120,289624,8878,298502,4555
2021-04-17,San Diego,073,3302833,275560,274812,14180,288992,3674
2021-04-17,San Francisco,075,870044,35977,36032,1247,37279,523
2021-04-17,San Joaquin,077,732212,71248,70372,3363,73735,1288
2021-04-17,San Luis Obispo,079,281455,20977,20642,689,21331,254
2021-04-17,San Mateo,081,765935,41571,41157,450,41607,352
2021-04-17,Santa Barbara,083,443738,33935,33738,1122,34860,446
2021-04-17,Santa Clara,085,1922200,116550,116887,704,117591,1944
2021-04-17,Santa Cruz,087,273765,16029,15571,804,16375,204
2021-04-17,Shasta,089,179085,11633,11647,1416,13063,189
2021-04-17,Sierra,091,2930,55,51,12,63,0
2021-04-17,Siskiyou,093,43540,1645,1539,290,1829,10
2021-04-17,Solano,095,438530,31670,31541,463,32004,239
2021-04-17,Sonoma,097,501317,29490,29637,299,29936,311
2021-04-17,Stanislaus,099,539301,54387,54058,5756,59814,728
2021-04-17,Sutter,101,95872,9249,9252,83,9335,109
2021-04-17,Tehama,103,63373,4901,4875,539,5414,52
2021-04-17,Trinity,105,12862,482,326,85,411,3
2021-04-17,Tulare,107,460477,49611,48603,8737,57340,829
2021-04-17,Tuolumne,109,53932,3960,4005,38,4043,58
2021-04-17,Ventura,111,848112,80521,79964,2935,82899,996
2021-04-17,Yolo,113,214977,13613,13580,266,13846,200
2021-04-17,Yuba,115,75493,5834,5802,117,5919,44
2021-04-16,Alameda,001,1643700,85651,85243,1867,87110,1245
2021-04-16,Alpine,003,1148,85,85,0,85,0
2021-04-16,Amador,005,37829,3628,3621,33,3654,46
2021-04-16,Butte,007,227075,11934,11549,1711,13260,196
2021-04-16,Calaveras,009,45235,2049,2042,11,2053,50
2021-04-16,Colusa,011,21464,1910,1911,285,2196,14
2021-04-16,Contra Costa,013,1133247,67312,66569,1186,67755,782
2021-04-16,Del Norte,015,27424,1276,1237,11,1248,6
2021-04-16,El Dorado,017,186661,9772,9665,687,10352,106
2021-04-16,Fresno,019,978130,101065,100500,8461,108961,1643
2021-04-16,Glenn,021,27897,2375,2355,537,2892,17
2021-04-16,Humboldt,023,135768,3637,3570,27,3597,35
2021-04-16,Imperial,025,180216,28096,27962,2662,30624,719
2021-04-16,Inyo,027,18085,1392,1392,11,1403,36
2021-04-16,Kern,029,883053,96123,95066,10538,105604,1288
2021-04-16,Kings,031,150075,22919,22667,1057,23724,243
2021-04-16,Lake,033,64148,3428,3406,9,3415,43
2021-04-16,Lassen,035,31185,5163,5155,105,5260,1
2021-04-16,Los Angeles,037,10098052,1196871,1187818,40658,1228476,23627
2021-04-16,Madera,039,155013,16382,16250,917,17167,231
2021-04-16,Marin,041,260295,13833,13788,237,14025,226
2021-04-16,Mariposa,043,17540,408,396,9,405,5
2021-04-16,Mendocino,045,87422,3799,3719,74,3793,46
2021-04-16,Merced,047,269075,30329,30355,1024,31379,438
2021-04-16,Modoc,049,8938,368,355,121,476,3
2021-04-16,Mono,051,14174,1242,1253,17,1270,3
2021-04-16,Monterey,053,433212,42794,42620,1824,44444,351
2021-04-16,Napa,055,140530,9687,9653,34,9687,79
2021-04-16,Nevada,057,99092,4515,4443,186,4629,70
2021-04-16,Orange,059,3164182,253173,251770,11094,262864,4873
2021-04-16,Placer,061,380077,22338,21680,1365,23045,282
2021-04-16,Plumas,063,18699,681,665,10,675,4
2021-04-16,Riverside,065,2383286,291551,285818,13847,299665,4369
2021-04-16,Sacramento,067,1510023,101823,100993,1561,102554,1572
2021-04-16,San Benito,069,59416,5973,5982,112,6094,63
2021-04-16,San Bernardino,071,2135413,291073,289424,8877,298301,4550
2021-04-16,San Diego,073,3302833,275406,274567,14162,288729,3662
2021-04-16,San Francisco,075,870044,35951,35993,1243,37236,517
2021-04-16,San Joaquin,077,732212,71181,70280,3355,73635,1288
2021-04-16,San Luis Obispo,079,281455,20965,20623,688,21311,253
2021-04-16,San Mateo,081,765935,41542,41107,449,41556,352
2021-04-16,Santa Barbara,083,443738,33917,33703,1122,34825,446
2021-04-16,Santa Clara,085,1922200,116450,116693,701,117394,1941
2021-04-16,Santa Cruz,087,273765,16027,15539,804,16343,204
2021-04-16,Shasta,089,179085,11621,11623,1414,13037,189
2021-04-16,Sierra,091,2930,55,51,12,63,0
2021-04-16,Siskiyou,093,43540,1641,1530,288,1818,10
2021-04-16,Solano,095,438530,31631,31470,460,31930,239
2021-04-16,Sonoma,097,501317,29479,29617,299,29916,311
2021-04-16,Stanislaus,099,539301,54339,53983,5754,59737,728
2021-04-16,Sutter,101,95872,9243,9247,83,9330,109
2021-04-16,Tehama,103,63373,4900,4866,539,5405,52
2021-04-16,Trinity,105,12862,482,326,85,411,3
2021-04-16,Tulare,107,460477,49599,48583,8733,57316,830
2021-04-16,Tuolumne,109,53932,3957,4005,38,4043,58
2021-04-16,Ventura,111,848112,80496,79942,2930,82872,994
2021-04-16,Yolo,113,214977,13600,13559,264,13823,198
2021-04-16,Yuba,115,75493,5831,5795,116,5911,44
2021-04-15,Alameda,001,1643700,85544,85089,1865,86954,1246
2021-04-15,Alpine,003,1148,85,85,0,85,0
2021-04-15,Amador,005,37829,3627,3616,33,3649,46
2021-04-15,Butte,007,227075,11919,11529,1707,13236,196
2021-04-15,Calaveras,009,45235,2048,2039,11,2050,50
2021-04-15,Colusa,011,21464,1908,1909,284,2193,14
2021-04-15,Contra Costa,013,1133247,67239,66480,1182,67662,781
2021-04-15,Del Norte,015,27424,1269,1235,11,1246,6
2021-04-15,El Dorado,017,186661,9759,9639,685,10324,106
2021-04-15,Fresno,019,978130,101003,100431,8455,108886,1642
2021-04-15,Glenn,021,27897,2375,2354,537,2891,17
2021-04-15,Humboldt,023,135768,3616,3561,27,3588,35
2021-04-15,Imperial,025,180216,28068,27920,2659,30579,718
2021-04-15,Inyo,027,18085,1392,1393,11,1404,36
2021-04-15,Kern,029,883053,96090,94989,10524,105513,1289
2021-04-15,Kings,031,150075,22905,22648,1057,23705,242
2021-04-15,Lake,033,64148,3427,3399,9,3408,43
2021-04-15,Lassen,035,31185,5162,5152,105,5257,1
2021-04-15,Los Angeles,037,10098052,1196468,1187274,40622,1227896,23598
2021-04-15,Madera,039,155013,16367,16234,917,17151,231
2021-04-15,Marin,041,260295,13829,13783,236,14019,226
2021-04-15,Mariposa,043,17540,406,395,9,404,5
2021-04-15,Mendocino,045,87422,3798,3714,74,3788,46
2021-04-15,Merced,047,269075,30303,30325,1023,31348,437
2021-04-15,Modoc,049,8938,368,355,121,476,3
2021-04-15,Mono,051,14174,1241,1253,17,1270,3
2021-04-15,Monterey,053,433212,42784,42604,1822,44426,347
2021-04-15,Napa,055,140530,9679,9645,34,9679,79
2021-04-15,Nevada,057,99092,4503,4434,185,4619,70
2021-04-15,Orange,059,3164182,253078,251679,11081,262760,4857
2021-04-15,Placer,061,380077,22307,21614,1358,22972,281
2021-04-15,Plumas,063,18699,679,665,10,675,4
2021-04-15,Riverside,065,2383286,291447,285698,13840,299538,4363
2021-04-15,Sacramento,067,1510023,101693,100782,1547,102329,1570
2021-04-15,San Benito,069,59416,5970,5969,111,6080,63
2021-04-15,San Bernardino,071,2135413,290984,289288,8870,298158,4544
2021-04-15,San Diego,073,3302833,275159,274250,14103,288353,3653
2021-04-15,San Francisco,075,870044,35932,35947,1241,37188,510
2021-04-15,San Joaquin,077,732212,71100,70189,3347,73536,1288
2021-04-15,San Luis Obispo,079,281455,20949,20591,685,21276,253
2021-04-15,San Mateo,081,765935,41503,41050,448,41498,352
2021-04-15,Santa Barbara,083,443738,33899,33672,1118,34790,446
2021-04-15,Santa Clara,085,1922200,116344,116602,697,117299,1927
2021-04-15,Santa Cruz,087,273765,16017,15509,804,16313,203
2021-04-15,Shasta,089,179085,11607,11597,1410,13007,191
2021-04-15,Sierra,091,2930,55,51,12,63,0
2021-04-15,Siskiyou,093,43540,1635,1524,287,1811,10
2021-04-15,Solano,095,438530,31593,31394,459,31853,239
2021-04-15,Sonoma,097,501317,29465,29587,299,29886,311
2021-04-15,Stanislaus,099,539301,54285,53918,5745,59663,728
2021-04-15,Sutter,101,95872,9236,9237,83,9320,109
2021-04-15,Tehama,103,63373,4899,4854,538,5392,52
2021-04-15,Trinity,105,12862,482,326,85,411,3
2021-04-15,Tulare,107,460477,49578,48556,8733,57289,829
2021-04-15,Tuolumne,109,53932,3957,4003,38,4041,57
2021-04-15,Ventura,111,848112,80477,79917,2928,82845,989
2021-04-15,Yolo,113,214977,13581,13547,262,13809,198
2021-04-15,Yuba,115,75493,5828,5788,116,5904,44
2021-04-14,Alameda,001,1643700,85447,85009,1864,86873,1247
2021-04-14,Alpine,003,1148,85,85,0,85,0
2021-04-14,Amador,005,37829,3626,3613,33,3646,46
2021-04-14,Butte,007,227075,11906,11513,1706,13219,196
2021-04-14,Calaveras,009,45235,2047,2037,11,2048,50
2021-04-14,Colusa,011,21464,1908,1905,284,2189,14
2021-04-14,Contra Costa,013,1133247,67153,66400,1176,67576,781
2021-04-14,Del Norte,015,27424,1269,1228,11,1239,6
2021-04-14,El Dorado,017,186661,9744,9625,680,10305,106
2021-04-14,Fresno,019,978130,100946,100376,8442,108818,1640
2021-04-14,Glenn,021,27897,2375,2353,537,2890,17
2021-04-14,Humboldt,023,135768,3594,3551,26,3577,35
2021-04-14,Imperial,025,180216,28046,27907,2657,30564,718
2021-04-14,Inyo,027,18085,1392,1392,11,1403,36
2021-04-14,Kern,029,883053,96065,94947,10517,105464,1287
2021-04-14,Kings,031,150075,22896,22641,1055,23696,243
2021-04-14,Lake,033,64148,3422,3396,9,3405,43
2021-04-14,Lassen,035,31185,5161,5151,105,5256,1
2021-04-14,Los Angeles,037,10098052,1196069,1186821,40577,1227398,23579
2021-04-14,Madera,039,155013,16358,16218,917,17135,231
2021-04-14,Marin,041,260295,13827,13768,235,14003,226
2021-04-14,Mariposa,043,17540,405,394,9,403,5
2021-04-14,Mendocino,045,87422,3793,3711,74,3785,46
2021-04-14,Merced,047,269075,30287,30296,1021,31317,436
2021-04-14,Modoc,049,8938,368,355,121,476,3
2021-04-14,Mono,051,14174,1240,1252,17,1269,3
2021-04-14,Monterey,053,433212,42768,42595,1818,44413,347
2021-04-14,Napa,055,140530,9668,9643,34,9677,79
2021-04-14,Nevada,057,99092,4496,4421,185,4606,70
2021-04-14,Orange,059,3164182,252973,251568,11061,262629,4849
2021-04-14,Placer,061,380077,22274,21575,1357,22932,280
2021-04-14,Plumas,063,18699,679,665,10,675,4
2021-04-14,Riverside,065,2383286,291337,285583,13834,299417,4358
2021-04-14,Sacramento,067,1510023,101518,100645,1533,102178,1570
2021-04-14,San Benito,069,59416,5968,5960,111,6071,62
2021-04-14,San Bernardino,071,2135413,290917,289078,8867,297945,4523
2021-04-14,San Diego,073,3302833,274948,273969,14074,288043,3648
2021-04-14,San Francisco,075,870044,35894,35898,1240,37138,510
2021-04-14,San Joaquin,077,732212,71030,70095,3341,73436,1288
2021-04-14,San Luis Obispo,079,281455,20926,20561,675,21236,253
2021-04-14,San Mateo,081,765935,41463,40982,445,41427,352
2021-04-14,Santa Barbara,083,443738,33870,33650,1118,34768,445
2021-04-14,Santa Clara,085,1922200,116227,116488,694,117182,1922
2021-04-14,Santa Cruz,087,273765,16007,15481,804,16285,203
2021-04-14,Shasta,089,179085,11581,11581,1408,12989,190
2021-04-14,Sierra,091,2930,55,51,12,63,0
2021-04-14,Siskiyou,093,43540,1627,1518,286,1804,10
2021-04-14,Solano,095,438530,31540,31357,452,31809,239
2021-04-14,Sonoma,097,501317,29457,29572,297,29869,311
2021-04-14,Stanislaus,099,539301,54214,53836,5736,59572,727
2021-04-14,Sutter,101,95872,9228,9230,83,9313,106
2021-04-14,Tehama,103,63373,4893,4853,537,5390,52
2021-04-14,Trinity,105,12862,482,326,85,411,3
2021-04-14,Tulare,107,460477,49552,48527,8730,57257,827
2021-04-14,Tuolumne,109,53932,3956,3997,38,4035,57
2021-04-14,Ventura,111,848112,80441,79891,2926,82817,986
2021-04-14,Yolo,113,214977,13565,13530,260,13790,198
2021-04-14,Yuba,115,75493,5826,5778,116,5894,44
2021-04-13,Alameda,001,1643700,85340,84921,1861,86782,1239
2021-04-13,Alpine,003,1148,85,85,0,85,0
2021-04-13,Amador,005,37829,3623,3609,33,3642,46
2021-04-13,Butte,007,227075,11888,11497,1703,13200,196
2021-04-13,Calaveras,009,45235,2045,2035,11,2046,50
2021-04-13,Colusa,011,21464,1906,1905,282,2187,14
2021-04-13,Contra Costa,013,1133247,67065,66304,1176,67480,778
2021-04-13,Del Norte,015,27424,1264,1221,11,1232,6
2021-04-13,El Dorado,017,186661,9718,9609,677,10286,106
2021-04-13,Fresno,019,978130,100864,100357,8436,108793,1636
2021-04-13,Glenn,021,27897,2374,2351,537,2888,17
2021-04-13,Humboldt,023,135768,3577,3540,26,3566,35
2021-04-13,Imperial,025,180216,28027,27887,2649,30536,718
2021-04-13,Inyo,027,18085,1392,1391,11,1402,36
2021-04-13,Kern,029,883053,96021,94908,10505,105413,1285
2021-04-13,Kings,031,150075,22880,22636,1054,23690,243
2021-04-13,Lake,033,64148,3419,3390,9,3399,43
2021-04-13,Lassen,035,31185,5160,5147,105,5252,1
2021-04-13,Los Angeles,037,10098052,1195613,1186482,40535,1227017,23526
2021-04-13,Madera,039,155013,16348,16207,915,17122,231
2021-04-13,Marin,041,260295,13819,13760,234,13994,224
2021-04-13,Mariposa,043,17540,404,394,6,400,5
2021-04-13,Mendocino,045,87422,3787,3702,74,3776,46
2021-04-13,Merced,047,269075,30257,30276,1018,31294,435
2021-04-13,Modoc,049,8938,368,355,121,476,3
2021-04-13,Mono,051,14174,1240,1251,17,1268,3
2021-04-13,Monterey,053,433212,42757,42577,1818,44395,347
2021-04-13,Napa,055,140530,9658,9627,34,9661,79
2021-04-13,Nevada,057,99092,4484,4415,185,4600,69
2021-04-13,Orange,059,3164182,252878,251491,11043,262534,4836
2021-04-13,Placer,061,380077,22237,21534,1354,22888,280
2021-04-13,Plumas,063,18699,678,665,10,675,4
2021-04-13,Riverside,065,2383286,291218,285505,13828,299333,4348
2021-04-13,Sacramento,067,1510023,101343,100551,1528,102079,1569
2021-04-13,San Benito,069,59416,5965,5946,111,6057,62
2021-04-13,San Bernardino,071,2135413,290801,288929,8861,297790,4521
2021-04-13,San Diego,073,3302833,274694,273709,14039,287748,3623
2021-04-13,San Francisco,075,870044,35858,35869,1236,37105,506
2021-04-13,San Joaquin,077,732212,70922,70034,3333,73367,1288
2021-04-13,San Luis Obispo,079,281455,20899,20536,665,21201,253
2021-04-13,San Mateo,081,765935,41418,40955,445,41400,353
2021-04-13,Santa Barbara,083,443738,33847,33613,1115,34728,444
2021-04-13,Santa Clara,085,1922200,116098,116363,693,117056,1923
2021-04-13,Santa Cruz,087,273765,16000,15449,804,16253,203
2021-04-13,Shasta,089,179085,11561,11536,1405,12941,189
2021-04-13,Sierra,091,2930,55,51,12,63,0
2021-04-13,Siskiyou,093,43540,1619,1511,281,1792,10
2021-04-13,Solano,095,438530,31491,31335,448,31783,239
2021-04-13,Sonoma,097,501317,29449,29544,296,29840,311
2021-04-13,Stanislaus,099,539301,54142,53797,5727,59524,722
2021-04-13,Sutter,101,95872,9224,9226,83,9309,106
2021-04-13,Tehama,103,63373,4886,4850,534,5384,52
2021-04-13,Trinity,105,12862,482,326,85,411,3
2021-04-13,Tulare,107,460477,49539,48511,8727,57238,825
2021-04-13,Tuolumne,109,53932,3954,3995,38,4033,57
2021-04-13,Ventura,111,848112,80409,79854,2924,82778,986
2021-04-13,Yolo,113,214977,13553,13516,259,13775,198
2021-04-13,Yuba,115,75493,5817,5776,116,5892,44
2021-04-12,Alameda,001,1643700,85238,84817,1860,86677,1238
2021-04-12,Alpine,003,1148,85,85,0,85,0
2021-04-12,Amador,005,37829,3622,3607,33,3640,46
2021-04-12,Butte,007,227075,11873,11488,1699,13187,193
2021-04-12,Calaveras,009,45235,2041,2033,11,2044,50
2021-04-12,Colusa,011,21464,1904,1904,280,2184,14
2021-04-12,Contra Costa,013,1133247,66985,66176,1176,67352,777
2021-04-12,Del Norte,015,27424,1261,1216,11,1227,6
2021-04-12,El Dorado,017,186661,9701,9588,675,10263,106
2021-04-12,Fresno,019,978130,100803,100277,8413,108690,1633
2021-04-12,Glenn,021,27897,2373,2349,537,2886,17
2021-04-12,Humboldt,023,135768,3563,3533,25,3558,35
2021-04-12,Imperial,025,180216,27997,27851,2644,30495,717
2021-04-12,Inyo,027,18085,1392,1390,11,1401,36
2021-04-12,Kern,029,883053,95984,94861,10494,105355,1283
2021-04-12,Kings,031,150075,22872,22621,1053,23674,241
2021-04-12,Lake,033,64148,3415,3380,9,3389,43
2021-04-12,Lassen,035,31185,5159,5147,105,5252,1
2021-04-12,Los Angeles,037,10098052,1195107,1186145,40498,1226643,23505
2021-04-12,Madera,039,155013,16336,16174,913,17087,231
2021-04-12,Marin,041,260295,13806,13751,232,13983,224
2021-04-12,Mariposa,043,17540,403,394,6,400,5
2021-04-12,Mendocino,045,87422,3786,3699,74,3773,46
2021-04-12,Merced,047,269075,30226,30261,1015,31276,435
2021-04-12,Modoc,049,8938,366,352,121,473,3
2021-04-12,Mono,051,14174,1240,1251,17,1268,3
2021-04-12,Monterey,053,433212,42743,42555,1816,44371,346
2021-04-12,Napa,055,140530,9644,9603,34,9637,80
2021-04-12,Nevada,057,99092,4473,4408,185,4593,69
2021-04-12,Orange,059,3164182,252792,251350,11021,262371,4826
2021-04-12,Placer,061,380077,22186,21475,1351,22826,278
2021-04-12,Plumas,063,18699,676,666,10,676,4
2021-04-12,Riverside,065,2383286,291107,285361,13822,299183,4336
2021-04-12,Sacramento,067,1510023,101169,100394,1523,101917,1566
2021-04-12,San Benito,069,59416,5957,5942,110,6052,62
2021-04-12,San Bernardino,071,2135413,290694,288736,8849,297585,4493
2021-04-12,San Diego,073,3302833,274433,273431,14010,287441,3621
2021-04-12,San Francisco,075,870044,35824,35841,1235,37076,506
2021-04-12,San Joaquin,077,732212,70850,69968,3326,73294,1288
2021-04-12,San Luis Obispo,079,281455,20854,20515,652,21167,253
2021-04-12,San Mateo,081,765935,41376,40920,441,41361,353
2021-04-12,Santa Barbara,083,443738,33815,33606,1115,34721,444
2021-04-12,Santa Clara,085,1922200,115970,116252,691,116943,1923
2021-04-12,Santa Cruz,087,273765,15980,15406,804,16210,203
2021-04-12,Shasta,089,179085,11544,11509,1401,12910,189
2021-04-12,Sierra,091,2930,55,51,12,63,0
2021-04-12,Siskiyou,093,43540,1608,1511,278,1789,7
2021-04-12,Solano,095,438530,31449,31305,445,31750,238
2021-04-12,Sonoma,097,501317,29421,29500,296,29796,310
2021-04-12,Stanislaus,099,539301,54076,53722,5720,59442,707
2021-04-12,Sutter,101,95872,9213,9221,83,9304,106
2021-04-12,Tehama,103,63373,4877,4834,530,5364,52
2021-04-12,Trinity,105,12862,482,324,85,409,3
2021-04-12,Tulare,107,460477,49519,48495,8717,57212,824
2021-04-12,Tuolumne,109,53932,3950,3993,38,4031,57
2021-04-12,Ventura,111,848112,80376,79818,2922,82740,985
2021-04-12,Yolo,113,214977,13539,13510,258,13768,198
2021-04-12,Yuba,115,75493,5811,5773,116,5889,43
2021-04-11,Alameda,001,1643700,85101,84756,1854,86610,1238
2021-04-11,Alpine,003,1148,85,85,0,85,0
2021-04-11,Amador,005,37829,3620,3605,33,3638,46
2021-04-11,Butte,007,227075,11839,11487,1695,13182,193
2021-04-11,Calaveras,009,45235,2037,2036,11,2047,50
2021-04-11,Colusa,011,21464,1903,1904,279,2183,14
2021-04-11,Contra Costa,013,1133247,66876,66107,1174,67281,777
2021-04-11,Del Norte,015,27424,1255,1214,11,1225,6
2021-04-11,El Dorado,017,186661,9687,9575,672,10247,106
2021-04-11,Fresno,019,978130,100735,100230,8403,108633,1633
2021-04-11,Glenn,021,27897,2368,2348,537,2885,17
2021-04-11,Humboldt,023,135768,3553,3523,25,3548,35
2021-04-11,Imperial,025,180216,27973,27841,2642,30483,717
2021-04-11,Inyo,027,18085,1392,1390,11,1401,36
2021-04-11,Kern,029,883053,95923,94830,10486,105316,1283
2021-04-11,Kings,031,150075,22863,22618,1050,23668,241
2021-04-11,Lake,033,64148,3411,3377,9,3386,43
2021-04-11,Lassen,035,31185,5155,5147,105,5252,1
2021-04-11,Los Angeles,037,10098052,1194595,1185757,40456,1226213,23503
2021-04-11,Madera,039,155013,16317,16166,912,17078,231
2021-04-11,Marin,041,260295,13799,13741,231,13972,226
2021-04-11,Mariposa,043,17540,403,394,6,400,5
2021-04-11,Mendocino,045,87422,3784,3696,74,3770,46
2021-04-11,Merced,047,269075,30188,30249,1014,31263,435
2021-04-11,Modoc,049,8938,365,352,119,471,3
2021-04-11,Mono,051,14174,1239,1250,17,1267,3
2021-04-11,Monterey,053,433212,42737,42547,1809,44356,346
2021-04-11,Napa,055,140530,9633,9592,34,9626,80
2021-04-11,Nevada,057,99092,4459,4394,185,4579,69
2021-04-11,Orange,059,3164182,252665,251233,11010,262243,4826
2021-04-11,Placer,061,380077,22129,21458,1346,22804,278
2021-04-11,Plumas,063,18699,676,666,10,676,4
2021-04-11,Riverside,065,2383286,290973,285269,13812,299081,4336
2021-04-11,Sacramento,067,1510023,100999,100296,1511,101807,1566
2021-04-11,San Benito,069,59416,5949,5941,109,6050,62
2021-04-11,San Bernardino,071,2135413,290586,288686,8843,297529,4492
2021-04-11,San Diego,073,3302833,274135,273287,13951,287238,3621
2021-04-11,San Francisco,075,870044,35788,35815,1232,37047,498
2021-04-11,San Joaquin,077,732212,70764,69939,3315,73254,1288
2021-04-11,San Luis Obispo,079,281455,20828,20501,649,21150,253
2021-04-11,San Mateo,081,765935,41318,40901,440,41341,353
2021-04-11,Santa Barbara,083,443738,33780,33591,1114,34705,444
2021-04-11,Santa Clara,085,1922200,115834,116161,688,116849,1923
2021-04-11,Santa Cruz,087,273765,15968,15382,804,16186,203
2021-04-11,Shasta,089,179085,11500,11504,1400,12904,189
2021-04-11,Sierra,091,2930,55,51,12,63,0
2021-04-11,Siskiyou,093,43540,1601,1509,275,1784,7
2021-04-11,Solano,095,438530,31396,31268,441,31709,238
2021-04-11,Sonoma,097,501317,29395,29496,292,29788,310
2021-04-11,Stanislaus,099,539301,53993,53683,5711,59394,707
2021-04-11,Sutter,101,95872,9204,9222,83,9305,106
2021-04-11,Tehama,103,63373,4874,4832,528,5360,52
2021-04-11,Trinity,105,12862,482,324,85,409,3
2021-04-11,Tulare,107,460477,49505,48479,8710,57189,824
2021-04-11,Tuolumne,109,53932,3948,3993,38,4031,57
2021-04-11,Ventura,111,848112,80328,79800,2916,82716,985
2021-04-11,Yolo,113,214977,13519,13496,256,13752,198
2021-04-11,Yuba,115,75493,5801,5768,116,5884,43
2021-04-10,Alameda,001,1643700,85037,84626,1854,86480,1238
2021-04-10,Alpine,003,1148,85,85,0,85,0
2021-04-10,Amador,005,37829,3618,3603,33,3636,46
2021-04-10,Butte,007,227075,11828,11482,1694,13176,193
2021-04-10,Calaveras,009,45235,2035,2032,11,2043,50
2021-04-10,Colusa,011,21464,1903,1902,279,2181,14
2021-04-10,Contra Costa,013,1133247,66815,66001,1171,67172,778
2021-04-10,Del Norte,015,27424,1252,1212,11,1223,6
2021-04-10,El Dorado,017,186661,9675,9549,669,10218,106
2021-04-10,Fresno,019,978130,100702,100135,8396,108531,1633
2021-04-10,Glenn,021,27897,2368,2343,537,2880,17
2021-04-10,Humboldt,023,135768,3543,3508,25,3533,35
2021-04-10,Imperial,025,180216,27959,27816,2642,30458,717
2021-04-10,Inyo,027,18085,1392,1387,11,1398,36
2021-04-10,Kern,029,883053,95909,94802,10480,105282,1284
2021-04-10,Kings,031,150075,22859,22614,1048,23662,241
2021-04-10,Lake,033,64148,3406,3368,9,3377,43
2021-04-10,Lassen,035,31185,5155,5146,104,5250,1
2021-04-10,Los Angeles,037,10098052,1194320,1185246,40439,1225685,23493
2021-04-10,Madera,039,155013,16309,16143,911,17054,231
2021-04-10,Marin,041,260295,13794,13731,231,13962,226
2021-04-10,Mariposa,043,17540,400,393,6,399,5
2021-04-10,Mendocino,045,87422,3782,3696,74,3770,46
2021-04-10,Merced,047,269075,30168,30225,1013,31238,435
2021-04-10,Modoc,049,8938,365,352,119,471,3
2021-04-10,Mono,051,14174,1239,1249,17,1266,3
2021-04-10,Monterey,053,433212,42726,42527,1808,44335,346
2021-04-10,Napa,055,140530,9626,9569,34,9603,79
2021-04-10,Nevada,057,99092,4452,4379,185,4564,69
2021-04-10,Orange,059,3164182,252572,251139,11003,262142,4818
2021-04-10,Placer,061,380077,22098,21402,1340,22742,278
2021-04-10,Plumas,063,18699,676,666,10,676,4
2021-04-10,Riverside,065,2383286,290893,285082,13804,298886,4336
2021-04-10,Sacramento,067,1510023,100896,100048,1509,101557,1566
2021-04-10,San Benito,069,59416,5938,5932,108,6040,62
2021-04-10,San Bernardino,071,2135413,290522,288590,8836,297426,4489
2021-04-10,San Diego,073,3302833,273919,273058,13931,286989,3613
2021-04-10,San Francisco,075,870044,35758,35774,1229,37003,498
2021-04-10,San Joaquin,077,732212,70729,69852,3305,73157,1288
2021-04-10,San Luis Obispo,079,281455,20812,20461,648,21109,253
2021-04-10,San Mateo,081,765935,41285,40878,440,41318,350
2021-04-10,Santa Barbara,083,443738,33752,33541,1112,34653,444
2021-04-10,Santa Clara,085,1922200,115738,116015,687,116702,1923
2021-04-10,Santa Cruz,087,273765,15962,15360,804,16164,203
2021-04-10,Shasta,089,179085,11491,11492,1397,12889,189
2021-04-10,Sierra,091,2930,55,51,12,63,0
2021-04-10,Siskiyou,093,43540,1598,1512,275,1787,7
2021-04-10,Solano,095,438530,31362,31218,437,31655,238
2021-04-10,Sonoma,097,501317,29380,29469,292,29761,310
2021-04-10,Stanislaus,099,539301,53958,53596,5705,59301,707
2021-04-10,Sutter,101,95872,9202,9214,83,9297,106
2021-04-10,Tehama,103,63373,4872,4820,526,5346,52
2021-04-10,Trinity,105,12862,482,324,85,409,3
2021-04-10,Tulare,107,460477,49496,48470,8704,57174,824
2021-04-10,Tuolumne,109,53932,3945,3991,38,4029,57
2021-04-10,Ventura,111,848112,80300,79758,2914,82672,985
2021-04-10,Yolo,113,214977,13511,13494,255,13749,198
2021-04-10,Yuba,115,75493,5798,5757,115,5872,43
2021-04-09,Alameda,001,1643700,84970,84404,1846,86250,1237
2021-04-09,Alpine,003,1148,85,85,0,85,0
2021-04-09,Amador,005,37829,3617,3600,33,3633,46
2021-04-09,Butte,007,227075,11818,11454,1693,13147,193
2021-04-09,Calaveras,009,45235,2034,2028,11,2039,50
2021-04-09,Colusa,011,21464,1903,1898,279,2177,14
2021-04-09,Contra Costa,013,1133247,66722,65857,1165,67022,777
2021-04-09,Del Norte,015,27424,1251,1207,11,1218,6
2021-04-09,El Dorado,017,186661,9652,9528,665,10193,106
2021-04-09,Fresno,019,978130,100668,100027,8391,108418,1630
2021-04-09,Glenn,021,27897,2368,2337,537,2874,17
2021-04-09,Humboldt,023,135768,3534,3496,25,3521,35
2021-04-09,Imperial,025,180216,27944,27764,2640,30404,717
2021-04-09,Inyo,027,18085,1391,1386,11,1397,36
2021-04-09,Kern,029,883053,95871,94675,10478,105153,1282
2021-04-09,Kings,031,150075,22850,22595,1045,23640,242
2021-04-09,Lake,033,64148,3402,3362,9,3371,43
2021-04-09,Lassen,035,31185,5155,5140,104,5244,1
2021-04-09,Los Angeles,037,10098052,1193949,1184501,40411,1224912,23458
2021-04-09,Madera,039,155013,16306,16118,911,17029,231
2021-04-09,Marin,041,260295,13787,13721,231,13952,226
2021-04-09,Mariposa,043,17540,400,393,6,399,5
2021-04-09,Mendocino,045,87422,3780,3693,74,3767,46
2021-04-09,Merced,047,269075,30139,30179,1012,31191,435
2021-04-09,Modoc,049,8938,364,352,119,471,3
2021-04-09,Mono,051,14174,1239,1247,17,1264,3
2021-04-09,Monterey,053,433212,42717,42481,1804,44285,344
2021-04-09,Napa,055,140530,9607,9574,34,9608,80
2021-04-09,Nevada,057,99092,4444,4373,185,4558,69
2021-04-09,Orange,059,3164182,252498,250852,10998,261850,4813
2021-04-09,Placer,061,380077,22067,21327,1332,22659,278
2021-04-09,Plumas,063,18699,675,666,10,676,4
2021-04-09,Riverside,065,2383286,290810,284562,13798,298360,4325
2021-04-09,Sacramento,067,1510023,100741,99722,1503,101225,1564
2021-04-09,San Benito,069,59416,5933,5925,107,6032,62
2021-04-09,San Bernardino,071,2135413,290453,288000,8833,296833,4467
2021-04-09,San Diego,073,3302833,273721,272697,13889,286586,3600
2021-04-09,San Francisco,075,870044,35717,35716,1224,36940,497
2021-04-09,San Joaquin,077,732212,70665,69675,3293,72968,1281
2021-04-09,San Luis Obispo,079,281455,20797,20427,648,21075,252
2021-04-09,San Mateo,081,765935,41249,40800,439,41239,350
2021-04-09,Santa Barbara,083,443738,33729,33424,1109,34533,444
2021-04-09,Santa Clara,085,1922200,115654,115749,685,116434,1923
2021-04-09,Santa Cruz,087,273765,15957,15331,804,16135,203
2021-04-09,Shasta,089,179085,11481,11478,1394,12872,188
2021-04-09,Sierra,091,2930,55,51,12,63,0
2021-04-09,Siskiyou,093,43540,1595,1510,274,1784,7
2021-04-09,Solano,095,438530,31329,31166,432,31598,238
2021-04-09,Sonoma,097,501317,29367,29433,292,29725,310
2021-04-09,Stanislaus,099,539301,53903,53504,5696,59200,705
2021-04-09,Sutter,101,95872,9195,9201,83,9284,106
2021-04-09,Tehama,103,63373,4866,4806,526,5332,52
2021-04-09,Trinity,105,12862,481,324,85,409,3
2021-04-09,Tulare,107,460477,49492,48430,8698,57128,824
2021-04-09,Tuolumne,109,53932,3944,3986,38,4024,57
2021-04-09,Ventura,111,848112,80272,79698,2914,82612,987
2021-04-09,Yolo,113,214977,13499,13478,253,13731,198
2021-04-09,Yuba,115,75493,5791,5754,115,5869,43
2021-04-08,Alameda,001,1643700,84864,84213,1843,86056,1232
2021-04-08,Alpine,003,1148,85,85,0,85,0
2021-04-08,Amador,005,37829,3613,3595,33,3628,46
2021-04-08,Butte,007,227075,11807,11414,1692,13106,193
2021-04-08,Calaveras,009,45235,2032,2027,11,2038,50
2021-04-08,Colusa,011,21464,1902,1897,279,2176,14
2021-04-08,Contra Costa,013,1133247,66612,65706,1162,66868,775
2021-04-08,Del Norte,015,27424,1245,1201,11,1212,6
2021-04-08,El Dorado,017,186661,9636,9513,660,10173,106
2021-04-08,Fresno,019,978130,100605,99935,8384,108319,1627
2021-04-08,Glenn,021,27897,2367,2337,537,2874,17
2021-04-08,Humboldt,023,135768,3524,3486,25,3511,35
2021-04-08,Imperial,025,180216,27916,27744,2636,30380,713
2021-04-08,Inyo,027,18085,1390,1386,11,1397,36
2021-04-08,Kern,029,883053,95825,94493,10465,104958,1281
2021-04-08,Kings,031,150075,22843,22589,1043,23632,243
2021-04-08,Lake,033,64148,3395,3360,9,3369,43
2021-04-08,Lassen,035,31185,5154,5136,104,5240,1
2021-04-08,Los Angeles,037,10098052,1193452,1184443,40373,1224816,23416
2021-04-08,Madera,039,155013,16294,16103,911,17014,231
2021-04-08,Marin,041,260295,13780,13704,231,13935,226
2021-04-08,Mariposa,043,17540,399,393,6,399,5
2021-04-08,Mendocino,045,87422,3778,3690,74,3764,45
2021-04-08,Merced,047,269075,30117,30163,1012,31175,430
2021-04-08,Modoc,049,8938,364,352,119,471,3
2021-04-08,Mono,051,14174,1237,1247,17,1264,3
2021-04-08,Monterey,053,433212,42695,42437,1799,44236,342
2021-04-08,Napa,055,140530,9590,9569,34,9603,80
2021-04-08,Nevada,057,99092,4433,4367,185,4552,69
2021-04-08,Orange,059,3164182,252388,250529,10983,261512,4797
2021-04-08,Placer,061,380077,22025,21258,1323,22581,277
2021-04-08,Plumas,063,18699,675,665,10,675,4
2021-04-08,Riverside,065,2383286,290696,283853,13793,297646,4296
2021-04-08,Sacramento,067,1510023,100601,99319,1492,100811,1561
2021-04-08,San Benito,069,59416,5930,5914,105,6019,62
2021-04-08,San Bernardino,071,2135413,290356,287190,8830,296020,4445
2021-04-08,San Diego,073,3302833,273491,272495,13853,286348,3592
2021-04-08,San Francisco,075,870044,35694,35657,1223,36880,494
2021-04-08,San Joaquin,077,732212,70593,69479,3287,72766,1279
2021-04-08,San Luis Obispo,079,281455,20778,20402,646,21048,252
2021-04-08,San Mateo,081,765935,41209,40749,439,41188,350
2021-04-08,Santa Barbara,083,443738,33705,33309,1108,34417,444
2021-04-08,Santa Clara,085,1922200,115548,115487,684,116171,1905
2021-04-08,Santa Cruz,087,273765,15950,15296,804,16100,203
2021-04-08,Shasta,089,179085,11471,11466,1390,12856,186
2021-04-08,Sierra,091,2930,55,51,12,63,0
2021-04-08,Siskiyou,093,43540,1592,1511,274,1785,7
2021-04-08,Solano,095,438530,31280,31120,432,31552,238
2021-04-08,Sonoma,097,501317,29347,29410,291,29701,310
2021-04-08,Stanislaus,099,539301,53825,53401,5686,59087,706
2021-04-08,Sutter,101,95872,9191,9195,83,9278,106
2021-04-08,Tehama,103,63373,4862,4802,526,5328,52
2021-04-08,Trinity,105,12862,481,324,85,409,3
2021-04-08,Tulare,107,460477,49479,48409,8688,57097,821
2021-04-08,Tuolumne,109,53932,3944,3986,38,4024,57
2021-04-08,Ventura,111,848112,80235,79626,2910,82536,986
2021-04-08,Yolo,113,214977,13490,13468,252,13720,198
2021-04-08,Yuba,115,75493,5787,5743,115,5858,43
2021-04-07,Alameda,001,1643700,84780,84130,1841,85971,1224
2021-04-07,Alpine,003,1148,85,85,0,85,0
2021-04-07,Amador,005,37829,3610,3590,33,3623,46
2021-04-07,Butte,007,227075,11803,11405,1689,13094,193
2021-04-07,Calaveras,009,45235,2031,2022,11,2033,50
2021-04-07,Colusa,011,21464,1898,1894,278,2172,14
2021-04-07,Contra Costa,013,1133247,66526,65619,1161,66780,775
2021-04-07,Del Norte,015,27424,1243,1198,11,1209,6
2021-04-07,El Dorado,017,186661,9615,9500,654,10154,106
2021-04-07,Fresno,019,978130,100540,99865,8373,108238,1627
2021-04-07,Glenn,021,27897,2365,2337,536,2873,17
2021-04-07,Humboldt,023,135768,3511,3484,25,3509,35
2021-04-07,Imperial,025,180216,27892,27704,2630,30334,713
2021-04-07,Inyo,027,18085,1389,1386,11,1397,36
2021-04-07,Kern,029,883053,95789,94456,10450,104906,1275
2021-04-07,Kings,031,150075,22841,22589,1043,23632,243
2021-04-07,Lake,033,64148,3393,3358,9,3367,43
2021-04-07,Lassen,035,31185,5154,5137,104,5241,1
2021-04-07,Los Angeles,037,10098052,1193015,1183862,40352,1224214,23372
2021-04-07,Madera,039,155013,16275,16090,910,17000,231
2021-04-07,Marin,041,260295,13769,13688,229,13917,225
2021-04-07,Mariposa,043,17540,398,391,6,397,5
2021-04-07,Mendocino,045,87422,3777,3691,74,3765,45
2021-04-07,Merced,047,269075,30094,30132,1007,31139,430
2021-04-07,Modoc,049,8938,364,351,119,470,3
2021-04-07,Mono,051,14174,1237,1246,17,1263,3
2021-04-07,Monterey,053,433212,42677,42427,1798,44225,341
2021-04-07,Napa,055,140530,9576,9556,34,9590,80
2021-04-07,Nevada,057,99092,4427,4364,185,4549,69
2021-04-07,Orange,059,3164182,252264,250378,10961,261339,4778
2021-04-07,Placer,061,380077,21981,21227,1315,22542,276
2021-04-07,Plumas,063,18699,675,665,10,675,4
2021-04-07,Riverside,065,2383286,290576,283749,13783,297532,4285
2021-04-07,Sacramento,067,1510023,100433,99202,1486,100688,1544
2021-04-07,San Benito,069,59416,5925,5912,104,6016,62
2021-04-07,San Bernardino,071,2135413,290238,286978,8825,295803,4433
2021-04-07,San Diego,073,3302833,273265,272195,13824,286019,3588
2021-04-07,San Francisco,075,870044,35654,35618,1219,36837,493
2021-04-07,San Joaquin,077,732212,70523,69375,3282,72657,1278
2021-04-07,San Luis Obispo,079,281455,20752,20373,643,21016,252
2021-04-07,San Mateo,081,765935,41165,40693,439,41132,350
2021-04-07,Santa Barbara,083,443738,33679,33289,1105,34394,444
2021-04-07,Santa Clara,085,1922200,115416,115311,682,115993,1900
2021-04-07,Santa Cruz,087,273765,15939,15275,804,16079,203
2021-04-07,Shasta,089,179085,11459,11456,1385,12841,184
2021-04-07,Sierra,091,2930,55,51,12,63,0
2021-04-07,Siskiyou,093,43540,1586,1512,273,1785,7
2021-04-07,Solano,095,438530,31229,31097,431,31528,238
2021-04-07,Sonoma,097,501317,29329,29394,290,29684,310
2021-04-07,Stanislaus,099,539301,53756,53344,5676,59020,686
2021-04-07,Sutter,101,95872,9188,9188,83,9271,106
2021-04-07,Tehama,103,63373,4854,4802,524,5326,52
2021-04-07,Trinity,105,12862,481,322,85,407,3
2021-04-07,Tulare,107,460477,49464,48386,8678,57064,820
2021-04-07,Tuolumne,109,53932,3942,3982,38,4020,57
2021-04-07,Ventura,111,848112,80201,79595,2908,82503,986
2021-04-07,Yolo,113,214977,13475,13450,250,13700,198
2021-04-07,Yuba,115,75493,5783,5737,115,5852,43
2021-04-06,Alameda,001,1643700,84667,84091,1838,85929,1223
2021-04-06,Alpine,003,1148,85,85,0,85,0
2021-04-06,Amador,005,37829,3609,3587,33,3620,45
2021-04-06,Butte,007,227075,11788,11396,1687,13083,193
2021-04-06,Calaveras,009,45235,2027,2021,11,2032,50
2021-04-06,Colusa,011,21464,1896,1894,276,2170,14
2021-04-06,Contra Costa,013,1133247,66448,65575,1160,66735,774
2021-04-06,Del Norte,015,27424,1238,1197,11,1208,6
2021-04-06,El Dorado,017,186661,9585,9489,652,10141,106
2021-04-06,Fresno,019,978130,100476,99814,8367,108181,1626
2021-04-06,Glenn,021,27897,2364,2335,535,2870,17
2021-04-06,Humboldt,023,135768,3502,3477,25,3502,35
2021-04-06,Imperial,025,180216,27858,27661,2620,30281,713
2021-04-06,Inyo,027,18085,1389,1379,11,1390,36
2021-04-06,Kern,029,883053,95745,94422,10444,104866,1259
2021-04-06,Kings,031,150075,22835,22587,1043,23630,240
2021-04-06,Lake,033,64148,3390,3358,9,3367,43
2021-04-06,Lassen,035,31185,5152,5137,104,5241,1
2021-04-06,Los Angeles,037,10098052,1192502,1183499,40313,1223812,23323
2021-04-06,Madera,039,155013,16255,16085,905,16990,230
2021-04-06,Marin,041,260295,13760,13675,225,13900,224
2021-04-06,Mariposa,043,17540,398,390,6,396,5
2021-04-06,Mendocino,045,87422,3775,3686,74,3760,45
2021-04-06,Merced,047,269075,30065,30100,1002,31102,430
2021-04-06,Modoc,049,8938,363,351,119,470,3
2021-04-06,Mono,051,14174,1237,1246,17,1263,3
2021-04-06,Monterey,053,433212,42668,42412,1797,44209,341
2021-04-06,Napa,055,140530,9557,9509,34,9543,78
2021-04-06,Nevada,057,99092,4417,4356,183,4539,69
2021-04-06,Orange,059,3164182,252155,250304,10947,261251,4771
2021-04-06,Placer,061,380077,21933,21184,1313,22497,276
2021-04-06,Plumas,063,18699,675,665,10,675,4
2021-04-06,Riverside,065,2383286,290395,283622,13772,297394,4264
2021-04-06,Sacramento,067,1510023,100224,99110,1480,100590,1537
2021-04-06,San Benito,069,59416,5916,5907,104,6011,62
2021-04-06,San Bernardino,071,2135413,290124,286792,8815,295607,4428
2021-04-06,San Diego,073,3302833,273003,271867,13796,285663,3585
2021-04-06,San Francisco,075,870044,35611,35572,1219,36791,488
2021-04-06,San Joaquin,077,732212,70440,69316,3270,72586,1278
2021-04-06,San Luis Obispo,079,281455,20730,20350,640,20990,252
2021-04-06,San Mateo,081,765935,41117,40649,438,41087,350
2021-04-06,Santa Barbara,083,443738,33661,33257,1104,34361,443
2021-04-06,Santa Clara,085,1922200,115245,115184,681,115865,1900
2021-04-06,Santa Cruz,087,273765,15929,15252,804,16056,203
2021-04-06,Shasta,089,179085,11438,11443,1383,12826,184
2021-04-06,Sierra,091,2930,55,51,12,63,0
2021-04-06,Siskiyou,093,43540,1582,1510,272,1782,7
2021-04-06,Solano,095,438530,31182,31078,430,31508,237
2021-04-06,Sonoma,097,501317,29304,29386,288,29674,311
2021-04-06,Stanislaus,099,539301,53699,53304,5670,58974,686
2021-04-06,Sutter,101,95872,9178,9179,83,9262,106
2021-04-06,Tehama,103,63373,4845,4798,524,5322,52
2021-04-06,Trinity,105,12862,481,321,85,406,3
2021-04-06,Tulare,107,460477,49421,48372,8674,57046,819
2021-04-06,Tuolumne,109,53932,3942,3981,38,4019,57
2021-04-06,Ventura,111,848112,80164,79556,2906,82462,983
2021-04-06,Yolo,113,214977,13462,13443,249,13692,198
2021-04-06,Yuba,115,75493,5779,5733,114,5847,43
2021-04-05,Alameda,001,1643700,84551,84007,1834,85841,1219
2021-04-05,Alpine,003,1148,85,85,0,85,0
2021-04-05,Amador,005,37829,3606,3584,33,3617,45
2021-04-05,Butte,007,227075,11773,11384,1686,13070,193
2021-04-05,Calaveras,009,45235,2025,2019,11,2030,50
2021-04-05,Colusa,011,21464,1896,1894,275,2169,14
2021-04-05,Contra Costa,013,1133247,66382,65457,1158,66615,774
2021-04-05,Del Norte,015,27424,1236,1189,11,1200,6
2021-04-05,El Dorado,017,186661,9570,9463,652,10115,106
2021-04-05,Fresno,019,978130,100388,99755,8359,108114,1622
2021-04-05,Glenn,021,27897,2363,2335,535,2870,17
2021-04-05,Humboldt,023,135768,3493,3475,25,3500,35
2021-04-05,Imperial,025,180216,27826,27604,2615,30219,710
2021-04-05,Inyo,027,18085,1386,1377,11,1388,36
2021-04-05,Kern,029,883053,95690,94401,10419,104820,1249
2021-04-05,Kings,031,150075,22831,22580,1043,23623,239
2021-04-05,Lake,033,64148,3382,3359,9,3368,43
2021-04-05,Lassen,035,31185,5152,5138,103,5241,1
2021-04-05,Los Angeles,037,10098052,1191966,1183200,40263,1223463,23302
2021-04-05,Madera,039,155013,16241,16065,904,16969,230
2021-04-05,Marin,041,260295,13746,13666,221,13887,221
2021-04-05,Mariposa,043,17540,398,390,6,396,5
2021-04-05,Mendocino,045,87422,3773,3687,74,3761,45
2021-04-05,Merced,047,269075,30039,30068,1000,31068,427
2021-04-05,Modoc,049,8938,361,346,119,465,3
2021-04-05,Mono,051,14174,1237,1246,17,1263,3
2021-04-05,Monterey,053,433212,42655,42396,1793,44189,341
2021-04-05,Napa,055,140530,9534,9492,34,9526,78
2021-04-05,Nevada,057,99092,4406,4346,183,4529,69
2021-04-05,Orange,059,3164182,252040,250177,10923,261100,4759
2021-04-05,Placer,061,380077,21887,21133,1306,22439,276
2021-04-05,Plumas,063,18699,675,666,10,676,4
2021-04-05,Riverside,065,2383286,290258,283549,13760,297309,4237
2021-04-05,Sacramento,067,1510023,100062,98908,1472,100380,1533
2021-04-05,San Benito,069,59416,5910,5904,104,6008,61
2021-04-05,San Bernardino,071,2135413,290014,286597,8812,295409,4425
2021-04-05,San Diego,073,3302833,272754,271655,13755,285410,3583
2021-04-05,San Francisco,075,870044,35580,35538,1219,36757,488
2021-04-05,San Joaquin,077,732212,70351,69214,3261,72475,1268
2021-04-05,San Luis Obispo,079,281455,20693,20333,640,20973,252
2021-04-05,San Mateo,081,765935,41073,40609,437,41046,350
2021-04-05,Santa Barbara,083,443738,33626,33235,1104,34339,443
2021-04-05,Santa Clara,085,1922200,115078,115091,678,115769,1893
2021-04-05,Santa Cruz,087,273765,15922,15228,804,16032,201
2021-04-05,Shasta,089,179085,11417,11435,1380,12815,184
2021-04-05,Sierra,091,2930,55,50,12,62,0
2021-04-05,Siskiyou,093,43540,1579,1509,270,1779,7
2021-04-05,Solano,095,438530,31141,31026,428,31454,237
2021-04-05,Sonoma,097,501317,29272,29361,286,29647,311
2021-04-05,Stanislaus,099,539301,53619,53238,5667,58905,686
2021-04-05,Sutter,101,95872,9171,9169,83,9252,106
2021-04-05,Tehama,103,63373,4839,4794,524,5318,52
2021-04-05,Trinity,105,12862,480,321,85,406,3
2021-04-05,Tulare,107,460477,49409,48356,8667,57023,818
2021-04-05,Tuolumne,109,53932,3941,3980,38,4018,57
2021-04-05,Ventura,111,848112,80133,79549,2903,82452,983
2021-04-05,Yolo,113,214977,13448,13427,248,13675,198
2021-04-05,Yuba,115,75493,5774,5728,113,5841,43
2021-04-04,Alameda,001,1643700,84433,83951,1830,85781,1219
2021-04-04,Alpine,003,1148,85,85,0,85,0
2021-04-04,Amador,005,37829,3600,3582,33,3615,45
2021-04-04,Butte,007,227075,11758,11375,1685,13060,193
2021-04-04,Calaveras,009,45235,2021,2020,11,2031,50
2021-04-04,Colusa,011,21464,1895,1893,275,2168,14
2021-04-04,Contra Costa,013,1133247,66276,65408,1153,66561,774
2021-04-04,Del Norte,015,27424,1228,1186,11,1197,6
2021-04-04,El Dorado,017,186661,9551,9455,648,10103,106
2021-04-04,Fresno,019,978130,100314,99702,8346,108048,1622
2021-04-04,Glenn,021,27897,2360,2335,534,2869,17
2021-04-04,Humboldt,023,135768,3482,3472,25,3497,35
2021-04-04,Imperial,025,180216,27770,27588,2613,30201,710
2021-04-04,Inyo,027,18085,1382,1377,11,1388,36
2021-04-04,Kern,029,883053,95646,94388,10398,104786,1247
2021-04-04,Kings,031,150075,22829,22580,1042,23622,239
2021-04-04,Lake,033,64148,3376,3355,8,3363,43
2021-04-04,Lassen,035,31185,5150,5138,103,5241,1
2021-04-04,Los Angeles,037,10098052,1191421,1182872,40219,1223091,23301
2021-04-04,Madera,039,155013,16215,16052,900,16952,230
2021-04-04,Marin,041,260295,13733,13663,220,13883,221
2021-04-04,Mariposa,043,17540,398,390,6,396,5
2021-04-04,Mendocino,045,87422,3770,3684,74,3758,45
2021-04-04,Merced,047,269075,29996,30048,997,31045,427
2021-04-04,Modoc,049,8938,361,346,119,465,3
2021-04-04,Mono,051,14174,1236,1245,17,1262,3
2021-04-04,Monterey,053,433212,42638,42391,1792,44183,341
2021-04-04,Napa,055,140530,9522,9486,34,9520,78
2021-04-04,Nevada,057,99092,4394,4337,183,4520,69
2021-04-04,Orange,059,3164182,251906,250117,10907,261024,4759
2021-04-04,Placer,061,380077,21840,21104,1288,22392,276
2021-04-04,Plumas,063,18699,675,666,10,676,4
2021-04-04,Riverside,065,2383286,290132,283537,13756,297293,4237
2021-04-04,Sacramento,067,1510023,99863,98821,1463,100284,1531
2021-04-04,San Benito,069,59416,5900,5901,100,6001,61
2021-04-04,San Bernardino,071,2135413,289874,286561,8804,295365,4423
2021-04-04,San Diego,073,3302833,272442,271528,13714,285242,3583
2021-04-04,San Francisco,075,870044,35526,35525,1216,36741,488
2021-04-04,San Joaquin,077,732212,70250,69147,3249,72396,1268
2021-04-04,San Luis Obispo,079,281455,20661,20328,632,20960,252
2021-04-04,San Mateo,081,765935,41030,40587,434,41021,350
2021-04-04,Santa Barbara,083,443738,33590,33213,1104,34317,443
2021-04-04,Santa Clara,085,1922200,114912,114976,671,115647,1893
2021-04-04,Santa Cruz,087,273765,15913,15219,804,16023,201
2021-04-04,Shasta,089,179085,11391,11433,1379,12812,184
2021-04-04,Sierra,091,2930,55,50,12,62,0
2021-04-04,Siskiyou,093,43540,1576,1509,266,1775,7
2021-04-04,Solano,095,438530,31094,31002,426,31428,237
2021-04-04,Sonoma,097,501317,29240,29340,284,29624,311
2021-04-04,Stanislaus,099,539301,53526,53181,5659,58840,686
2021-04-04,Sutter,101,95872,9164,9164,83,9247,106
2021-04-04,Tehama,103,63373,4827,4792,523,5315,52
2021-04-04,Trinity,105,12862,478,321,85,406,3
2021-04-04,Tulare,107,460477,49393,48343,8659,57002,818
2021-04-04,Tuolumne,109,53932,3933,3980,38,4018,57
2021-04-04,Ventura,111,848112,80090,79526,2901,82427,983
2021-04-04,Yolo,113,214977,13427,13425,247,13672,198
2021-04-04,Yuba,115,75493,5767,5722,113,5835,43
2021-04-03,Alameda,001,1643700,84366,83861,1828,85689,1218
2021-04-03,Alpine,003,1148,85,85,0,85,0
2021-04-03,Amador,005,37829,3597,3577,33,3610,45
2021-04-03,Butte,007,227075,11754,11359,1681,13040,193
2021-04-03,Calaveras,009,45235,2019,2019,11,2030,50
2021-04-03,Colusa,011,21464,1895,1891,275,2166,14
2021-04-03,Contra Costa,013,1133247,66204,65338,1153,66491,774
2021-04-03,Del Norte,015,27424,1223,1183,11,1194,6
2021-04-03,El Dorado,017,186661,9542,9448,647,10095,106
2021-04-03,Fresno,019,978130,100257,99602,8340,107942,1622
2021-04-03,Glenn,021,27897,2359,2334,533,2867,17
2021-04-03,Humboldt,023,135768,3480,3467,25,3492,35
2021-04-03,Imperial,025,180216,27754,27572,2610,30182,710
2021-04-03,Inyo,027,18085,1381,1376,11,1387,36
2021-04-03,Kern,029,883053,95620,94369,10382,104751,1243
2021-04-03,Kings,031,150075,22827,22580,1042,23622,239
2021-04-03,Lake,033,64148,3375,3350,8,3358,43
2021-04-03,Lassen,035,31185,5149,5136,103,5239,1
2021-04-03,Los Angeles,037,10098052,1191117,1182402,40202,1222604,23301
2021-04-03,Madera,039,155013,16206,16051,898,16949,230
2021-04-03,Marin,041,260295,13725,13658,219,13877,221
2021-04-03,Mariposa,043,17540,398,390,5,395,5
2021-04-03,Mendocino,045,87422,3769,3684,74,3758,45
2021-04-03,Merced,047,269075,29981,30031,997,31028,427
2021-04-03,Modoc,049,8938,361,346,119,465,3
2021-04-03,Mono,051,14174,1236,1245,17,1262,3
2021-04-03,Monterey,053,433212,42625,42376,1790,44166,341
2021-04-03,Napa,055,140530,9513,9473,34,9507,78
2021-04-03,Nevada,057,99092,4390,4323,183,4506,69
2021-04-03,Orange,059,3164182,251826,249982,10889,260871,4755
2021-04-03,Placer,061,380077,21809,21060,1284,22344,276
2021-04-03,Plumas,063,18699,675,666,10,676,4
2021-04-03,Riverside,065,2383286,290054,283423,13753,297176,4237
2021-04-03,Sacramento,067,1510023,99755,98660,1457,100117,1531
2021-04-03,San Benito,069,59416,5897,5893,99,5992,61
2021-04-03,San Bernardino,071,2135413,289809,286473,8798,295271,4422
2021-04-03,San Diego,073,3302833,272273,271335,13697,285032,3571
2021-04-03,San Francisco,075,870044,35507,35488,1214,36702,489
2021-04-03,San Joaquin,077,732212,70209,69100,3233,72333,1268
2021-04-03,San Luis Obispo,079,281455,20642,20301,632,20933,252
2021-04-03,San Mateo,081,765935,41005,40560,434,40994,350
2021-04-03,Santa Barbara,083,443738,33564,33172,1103,34275,443
2021-04-03,Santa Clara,085,1922200,114804,114865,669,115534,1893
2021-04-03,Santa Cruz,087,273765,15906,15205,804,16009,201
2021-04-03,Shasta,089,179085,11383,11418,1379,12797,184
2021-04-03,Sierra,091,2930,55,50,12,62,0
2021-04-03,Siskiyou,093,43540,1575,1509,266,1775,7
2021-04-03,Solano,095,438530,31073,30970,423,31393,237
2021-04-03,Sonoma,097,501317,29224,29315,283,29598,311
2021-04-03,Stanislaus,099,539301,53491,53137,5653,58790,686
2021-04-03,Sutter,101,95872,9158,9158,83,9241,106
2021-04-03,Tehama,103,63373,4819,4788,523,5311,52
2021-04-03,Trinity,105,12862,478,321,85,406,3
2021-04-03,Tulare,107,460477,49383,48327,8655,56982,818
2021-04-03,Tuolumne,109,53932,3933,3980,38,4018,57
2021-04-03,Ventura,111,848112,80069,79489,2899,82388,983
2021-04-03,Yolo,113,214977,13421,13414,247,13661,198
2021-04-03,Yuba,115,75493,5761,5716,113,5829,43
2021-04-02,Alameda,001,1643700,84293,83776,1825,85601,1217
2021-04-02,Alpine,003,1148,85,85,0,85,0
2021-04-02,Amador,005,37829,3593,3573,32,3605,45
2021-04-02,Butte,007,227075,11746,11350,1681,13031,193
2021-04-02,Calaveras,009,45235,2017,2010,11,2021,50
2021-04-02,Colusa,011,21464,1895,1891,275,2166,14
2021-04-02,Contra Costa,013,1133247,66140,65299,1152,66451,774
2021-04-02,Del Norte,015,27424,1220,1174,11,1185,6
2021-04-02,El Dorado,017,186661,9529,9437,644,10081,106
2021-04-02,Fresno,019,978130,100203,99551,8329,107880,1620
2021-04-02,Glenn,021,27897,2359,2331,533,2864,17
2021-04-02,Humboldt,023,135768,3476,3465,25,3490,35
2021-04-02,Imperial,025,180216,27742,27553,2604,30157,710
2021-04-02,Inyo,027,18085,1381,1377,11,1388,36
2021-04-02,Kern,029,883053,95602,94348,10379,104727,1233
2021-04-02,Kings,031,150075,22827,22571,1039,23610,239
2021-04-02,Lake,033,64148,3373,3348,8,3356,43
2021-04-02,Lassen,035,31185,5149,5134,103,5237,1
2021-04-02,Los Angeles,037,10098052,1190808,1181682,40179,1221861,23264
2021-04-02,Madera,039,155013,16197,16036,897,16933,230
2021-04-02,Marin,041,260295,13717,13649,219,13868,221
2021-04-02,Mariposa,043,17540,396,390,5,395,5
2021-04-02,Mendocino,045,87422,3766,3682,74,3756,45
2021-04-02,Merced,047,269075,29956,29998,997,30995,426
2021-04-02,Modoc,049,8938,358,346,119,465,3
2021-04-02,Mono,051,14174,1236,1246,17,1263,3
2021-04-02,Monterey,053,433212,42615,42359,1787,44146,341
2021-04-02,Napa,055,140530,9498,9453,34,9487,78
2021-04-02,Nevada,057,99092,4386,4323,183,4506,69
2021-04-02,Orange,059,3164182,251730,249891,10876,260767,4748
2021-04-02,Placer,061,380077,21773,21035,1278,22313,275
2021-04-02,Plumas,063,18699,675,666,10,676,4
2021-04-02,Riverside,065,2383286,289968,283328,13744,297072,4213
2021-04-02,Sacramento,067,1510023,99648,98648,1450,100098,1527
2021-04-02,San Benito,069,59416,5895,5888,97,5985,61
2021-04-02,San Bernardino,071,2135413,289736,286308,8794,295102,4417
2021-04-02,San Diego,073,3302833,272086,271036,13671,284707,3568
2021-04-02,San Francisco,075,870044,35472,35451,1212,36663,488
2021-04-02,San Joaquin,077,732212,70144,68996,3218,72214,1268
2021-04-02,San Luis Obispo,079,281455,20625,20271,631,20902,252
2021-04-02,San Mateo,081,765935,40963,40514,434,40948,350
2021-04-02,Santa Barbara,083,443738,33536,33145,1103,34248,443
2021-04-02,Santa Clara,085,1922200,114693,114777,667,115444,1882
2021-04-02,Santa Cruz,087,273765,15898,15216,804,16020,202
2021-04-02,Shasta,089,179085,11378,11377,1371,12748,181
2021-04-02,Sierra,091,2930,55,50,12,62,0
2021-04-02,Siskiyou,093,43540,1575,1508,265,1773,7
2021-04-02,Solano,095,438530,31044,30951,420,31371,237
2021-04-02,Sonoma,097,501317,29203,29288,282,29570,311
2021-04-02,Stanislaus,099,539301,53446,53073,5647,58720,687
2021-04-02,Sutter,101,95872,9150,9131,83,9214,106
2021-04-02,Tehama,103,63373,4812,4775,522,5297,52
2021-04-02,Trinity,105,12862,478,320,85,405,3
2021-04-02,Tulare,107,460477,49377,48306,8649,56955,818
2021-04-02,Tuolumne,109,53932,3930,3980,38,4018,57
2021-04-02,Ventura,111,848112,80041,79434,2897,82331,982
2021-04-02,Yolo,113,214977,13411,13381,247,13628,197
2021-04-02,Yuba,115,75493,5757,5709,113,5822,44
2021-04-01,Alameda,001,1643700,84214,83574,1820,85394,1216
2021-04-01,Alpine,003,1148,85,85,0,85,0
2021-04-01,Amador,005,37829,3589,3558,32,3590,45
2021-04-01,Butte,007,227075,11728,11328,1679,13007,193
2021-04-01,Calaveras,009,45235,2014,2006,11,2017,50
2021-04-01,Colusa,011,21464,1892,1890,275,2165,14
2021-04-01,Contra Costa,013,1133247,66080,65176,1150,66326,771
2021-04-01,Del Norte,015,27424,1215,1138,11,1149,6
2021-04-01,El Dorado,017,186661,9520,9393,640,10033,106
2021-04-01,Fresno,019,978130,100150,99317,8321,107638,1616
2021-04-01,Glenn,021,27897,2359,2322,532,2854,17
2021-04-01,Humboldt,023,135768,3472,3464,25,3489,35
2021-04-01,Imperial,025,180216,27712,27520,2598,30118,710
2021-04-01,Inyo,027,18085,1380,1374,11,1385,36
2021-04-01,Kern,029,883053,95566,94244,10367,104611,1233
2021-04-01,Kings,031,150075,22820,22560,1038,23598,239
2021-04-01,Lake,033,64148,3368,3337,8,3345,43
2021-04-01,Lassen,035,31185,5148,5132,103,5235,1
2021-04-01,Los Angeles,037,10098052,1190316,1181101,40150,1221251,23220
2021-04-01,Madera,039,155013,16181,16023,897,16920,230
2021-04-01,Marin,041,260295,13707,13635,219,13854,221
2021-04-01,Mariposa,043,17540,394,389,5,394,5
2021-04-01,Mendocino,045,87422,3766,3680,74,3754,45
2021-04-01,Merced,047,269075,29923,29820,997,30817,425
2021-04-01,Modoc,049,8938,357,346,119,465,3
2021-04-01,Mono,051,14174,1236,1245,17,1262,3
2021-04-01,Monterey,053,433212,42607,42324,1785,44109,339
2021-04-01,Napa,055,140530,9486,9410,34,9444,78
2021-04-01,Nevada,057,99092,4376,4288,182,4470,68
2021-04-01,Orange,059,3164182,251610,249617,10859,260476,4742
2021-04-01,Placer,061,380077,21734,20909,1266,22175,274
2021-04-01,Plumas,063,18699,675,664,10,674,4
2021-04-01,Riverside,065,2383286,289863,283128,13741,296869,4193
2021-04-01,Sacramento,067,1510023,99504,97952,1436,99388,1521
2021-04-01,San Benito,069,59416,5887,5878,96,5974,61
2021-04-01,San Bernardino,071,2135413,289619,286086,8785,294871,4404
2021-04-01,San Diego,073,3302833,271863,270540,13641,284181,3555
2021-04-01,San Francisco,075,870044,35451,35386,1209,36595,488
2021-04-01,San Joaquin,077,732212,70062,68802,3210,72012,1262
2021-04-01,San Luis Obispo,079,281455,20596,20235,630,20865,252
2021-04-01,San Mateo,081,765935,40922,40454,434,40888,350
2021-04-01,Santa Barbara,083,443738,33489,33096,1098,34194,443
2021-04-01,Santa Clara,085,1922200,114580,114606,666,115272,1874
2021-04-01,Santa Cruz,087,273765,15883,15271,804,16075,202
2021-04-01,Shasta,089,179085,11363,11355,1366,12721,181
2021-04-01,Sierra,091,2930,55,50,12,62,0
2021-04-01,Siskiyou,093,43540,1573,1507,264,1771,7
2021-04-01,Solano,095,438530,31011,30850,417,31267,237
2021-04-01,Sonoma,097,501317,29172,29241,275,29516,311
2021-04-01,Stanislaus,099,539301,53383,52825,5641,58466,687
2021-04-01,Sutter,101,95872,9138,9105,83,9188,106
2021-04-01,Tehama,103,63373,4806,4764,519,5283,52
2021-04-01,Trinity,105,12862,478,319,85,404,3
2021-04-01,Tulare,107,460477,49354,48279,8639,56918,817
2021-04-01,Tuolumne,109,53932,3928,3978,38,4016,57
2021-04-01,Ventura,111,848112,80017,79369,2896,82265,977
2021-04-01,Yolo,113,214977,13398,13342,247,13589,197
2021-04-01,Yuba,115,75493,5752,5694,113,5807,44
2021-03-31,Alameda,001,1643700,84132,83475,1815,85290,1215
2021-03-31,Alpine,003,1148,85,85,0,85,0
2021-03-31,Amador,005,37829,3586,3556,32,3588,45
2021-03-31,Butte,007,227075,11718,11321,1676,12997,193
2021-03-31,Calaveras,009,45235,2012,2005,11,2016,50
2021-03-31,Colusa,011,21464,1892,1890,275,2165,14
2021-03-31,Contra Costa,013,1133247,65995,65109,1149,66258,769
2021-03-31,Del Norte,015,27424,1206,1129,11,1140,6
2021-03-31,El Dorado,017,186661,9503,9390,640,10030,106
2021-03-31,Fresno,019,978130,100057,99240,8304,107544,1616
2021-03-31,Glenn,021,27897,2355,2318,530,2848,17
2021-03-31,Humboldt,023,135768,3466,3460,25,3485,35
2021-03-31,Imperial,025,180216,27692,27506,2597,30103,710
2021-03-31,Inyo,027,18085,1377,1373,10,1383,35
2021-03-31,Kern,029,883053,95523,94205,10358,104563,1229
2021-03-31,Kings,031,150075,22817,22540,1038,23578,239
2021-03-31,Lake,033,64148,3364,3332,8,3340,43
2021-03-31,Lassen,035,31185,5144,5132,103,5235,1
2021-03-31,Los Angeles,037,10098052,1189847,1180538,40111,1220649,23171
2021-03-31,Madera,039,155013,16167,16015,896,16911,229
2021-03-31,Marin,041,260295,13696,13624,219,13843,221
2021-03-31,Mariposa,043,17540,394,389,5,394,5
2021-03-31,Mendocino,045,87422,3760,3675,74,3749,45
2021-03-31,Merced,047,269075,29894,29780,997,30777,423
2021-03-31,Modoc,049,8938,357,346,119,465,3
2021-03-31,Mono,051,14174,1236,1245,17,1262,3
2021-03-31,Monterey,053,433212,42590,42309,1783,44092,338
2021-03-31,Napa,055,140530,9468,9401,34,9435,78
2021-03-31,Nevada,057,99092,4370,4283,182,4465,68
2021-03-31,Orange,059,3164182,251499,249518,10844,260362,4731
2021-03-31,Placer,061,380077,21684,20885,1259,22144,271
2021-03-31,Plumas,063,18699,674,663,10,673,4
2021-03-31,Riverside,065,2383286,289761,283006,13731,296737,4171
2021-03-31,Sacramento,067,1510023,99329,97760,1429,99189,1519
2021-03-31,San Benito,069,59416,5877,5875,96,5971,61
2021-03-31,San Bernardino,071,2135413,289525,285916,8782,294698,4356
2021-03-31,San Diego,073,3302833,271631,270288,13606,283894,3555
2021-03-31,San Francisco,075,870044,35406,35347,1208,36555,474
2021-03-31,San Joaquin,077,732212,69973,68685,3194,71879,1259
2021-03-31,San Luis Obispo,079,281455,20574,20215,629,20844,251
2021-03-31,San Mateo,081,765935,40892,40423,434,40857,350
2021-03-31,Santa Barbara,083,443738,33457,33052,1096,34148,443
2021-03-31,Santa Clara,085,1922200,114453,114499,666,115165,1874
2021-03-31,Santa Cruz,087,273765,15870,15295,803,16098,201
2021-03-31,Shasta,089,179085,11351,11327,1358,12685,179
2021-03-31,Sierra,091,2930,55,50,12,62,0
2021-03-31,Siskiyou,093,43540,1572,1505,264,1769,7
2021-03-31,Solano,095,438530,30965,30824,416,31240,235
2021-03-31,Sonoma,097,501317,29145,29216,275,29491,311
2021-03-31,Stanislaus,099,539301,53315,52782,5629,58411,687
2021-03-31,Sutter,101,95872,9127,9111,83,9194,106
2021-03-31,Tehama,103,63373,4801,4762,517,5279,52
2021-03-31,Trinity,105,12862,478,319,85,404,3
2021-03-31,Tulare,107,460477,49334,48261,8623,56884,816
2021-03-31,Tuolumne,109,53932,3927,3976,38,4014,57
2021-03-31,Ventura,111,848112,79985,79326,2892,82218,969
2021-03-31,Yolo,113,214977,13381,13359,246,13605,197
2021-03-31,Yuba,115,75493,5745,5686,113,5799,44
2021-03-30,Alameda,001,1643700,84032,83395,1812,85207,1211
2021-03-30,Alpine,003,1148,85,85,0,85,0
2021-03-30,Amador,005,37829,3583,3551,32,3583,45
2021-03-30,Butte,007,227075,11706,11296,1673,12969,193
2021-03-30,Calaveras,009,45235,2008,1997,11,2008,50
2021-03-30,Colusa,011,21464,1891,1890,274,2164,14
2021-03-30,Contra Costa,013,1133247,65906,65041,1147,66188,767
2021-03-30,Del Norte,015,27424,1198,1118,10,1128,6
2021-03-30,El Dorado,017,186661,9484,9381,637,10018,105
2021-03-30,Fresno,019,978130,99992,99156,8291,107447,1609
2021-03-30,Glenn,021,27897,2355,2310,529,2839,17
2021-03-30,Humboldt,023,135768,3464,3461,25,3486,35
2021-03-30,Imperial,025,180216,27664,27471,2595,30066,706
2021-03-30,Inyo,027,18085,1377,1374,10,1384,35
2021-03-30,Kern,029,883053,95481,94151,10349,104500,1221
2021-03-30,Kings,031,150075,22813,22530,1036,23566,238
2021-03-30,Lake,033,64148,3358,3330,8,3338,43
2021-03-30,Lassen,035,31185,5144,5132,103,5235,1
2021-03-30,Los Angeles,037,10098052,1189351,1180044,40088,1220132,23136
2021-03-30,Madera,039,155013,16157,16003,892,16895,229
2021-03-30,Marin,041,260295,13687,13611,211,13822,221
2021-03-30,Mariposa,043,17540,394,388,5,393,5
2021-03-30,Mendocino,045,87422,3758,3670,74,3744,45
2021-03-30,Merced,047,269075,29857,29731,997,30728,423
2021-03-30,Modoc,049,8938,356,346,119,465,3
2021-03-30,Mono,051,14174,1235,1245,17,1262,3
2021-03-30,Monterey,053,433212,42564,42308,1781,44089,338
2021-03-30,Napa,055,140530,9453,9391,34,9425,78
2021-03-30,Nevada,057,99092,4358,4266,181,4447,68
2021-03-30,Orange,059,3164182,251370,249412,10817,260229,4727
2021-03-30,Placer,061,380077,21644,20866,1253,22119,271
2021-03-30,Plumas,063,18699,674,661,10,671,4
2021-03-30,Riverside,065,2383286,289636,282930,13722,296652,4154
2021-03-30,Sacramento,067,1510023,99192,97718,1425,99143,1516
2021-03-30,San Benito,069,59416,5871,5870,96,5966,61
2021-03-30,San Bernardino,071,2135413,289416,285758,8773,294531,4343
2021-03-30,San Diego,073,3302833,271392,269998,13568,283566,3555
2021-03-30,San Francisco,075,870044,35356,35325,1207,36532,474
2021-03-30,San Joaquin,077,732212,69885,68613,3184,71797,1232
2021-03-30,San Luis Obispo,079,281455,20554,20194,629,20823,251
2021-03-30,San Mateo,081,765935,40848,40377,434,40811,349
2021-03-30,Santa Barbara,083,443738,33432,33016,1096,34112,441
2021-03-30,Santa Clara,085,1922200,114330,114413,665,115078,1873
2021-03-30,Santa Cruz,087,273765,15864,15278,803,16081,201
2021-03-30,Shasta,089,179085,11343,11316,1357,12673,184
2021-03-30,Sierra,091,2930,55,50,12,62,0
2021-03-30,Siskiyou,093,43540,1571,1501,264,1765,7
2021-03-30,Solano,095,438530,30935,30802,415,31217,232
2021-03-30,Sonoma,097,501317,29113,29198,275,29473,311
2021-03-30,Stanislaus,099,539301,53237,52690,5621,58311,677
2021-03-30,Sutter,101,95872,9123,9107,82,9189,106
2021-03-30,Tehama,103,63373,4792,4748,516,5264,52
2021-03-30,Trinity,105,12862,478,316,85,401,3
2021-03-30,Tulare,107,460477,49319,48249,8614,56863,815
2021-03-30,Tuolumne,109,53932,3922,3972,38,4010,57
2021-03-30,Ventura,111,848112,79941,79282,2889,82171,958
2021-03-30,Yolo,113,214977,13368,13353,246,13599,195
2021-03-30,Yuba,115,75493,5734,5679,107,5786,42
2021-03-29,Alameda,001,1643700,83930,83338,1810,85148,1211
2021-03-29,Alpine,003,1148,85,85,0,85,0
2021-03-29,Amador,005,37829,3577,3549,32,3581,45
2021-03-29,Butte,007,227075,11697,11291,1670,12961,191
2021-03-29,Calaveras,009,45235,2006,1998,11,2009,50
2021-03-29,Colusa,011,21464,1891,1889,273,2162,14
2021-03-29,Contra Costa,013,1133247,65837,64971,1146,66117,767
2021-03-29,Del Norte,015,27424,1193,1116,9,1125,6
2021-03-29,El Dorado,017,186661,9464,9374,631,10005,105
2021-03-29,Fresno,019,978130,99909,99085,8276,107361,1606
2021-03-29,Glenn,021,27897,2348,2310,529,2839,17
2021-03-29,Humboldt,023,135768,3459,3459,25,3484,34
2021-03-29,Imperial,025,180216,27643,27442,2593,30035,704
2021-03-29,Inyo,027,18085,1377,1372,10,1382,35
2021-03-29,Kern,029,883053,95434,94098,10329,104427,1220
2021-03-29,Kings,031,150075,22801,22522,1035,23557,238
2021-03-29,Lake,033,64148,3355,3325,8,3333,43
2021-03-29,Lassen,035,31185,5144,5131,103,5234,1
2021-03-29,Los Angeles,037,10098052,1188855,1179736,40047,1219783,23108
2021-03-29,Madera,039,155013,16137,15987,890,16877,210
2021-03-29,Marin,041,260295,13675,13600,207,13807,220
2021-03-29,Mariposa,043,17540,393,388,5,393,5
2021-03-29,Mendocino,045,87422,3755,3667,74,3741,45
2021-03-29,Merced,047,269075,29833,29699,997,30696,422
2021-03-29,Modoc,049,8938,355,344,119,463,3
2021-03-29,Mono,051,14174,1234,1243,17,1260,3
2021-03-29,Monterey,053,433212,42548,42305,1776,44081,337
2021-03-29,Napa,055,140530,9437,9379,34,9413,78
2021-03-29,Nevada,057,99092,4351,4258,181,4439,68
2021-03-29,Orange,059,3164182,251258,249295,10805,260100,4713
2021-03-29,Placer,061,380077,21609,20827,1246,22073,267
2021-03-29,Plumas,063,18699,673,660,10,670,4
2021-03-29,Riverside,065,2383286,289533,282867,13721,296588,4133
2021-03-29,Sacramento,067,1510023,98998,97577,1417,98994,1514
2021-03-29,San Benito,069,59416,5864,5865,96,5961,61
2021-03-29,San Bernardino,071,2135413,289319,285615,8769,294384,4335
2021-03-29,San Diego,073,3302833,271126,269771,13542,283313,3547
2021-03-29,San Francisco,075,870044,35321,35291,1204,36495,474
2021-03-29,San Joaquin,077,732212,69799,68537,3171,71708,1211
2021-03-29,San Luis Obispo,079,281455,20519,20176,628,20804,250
2021-03-29,San Mateo,081,765935,40806,40357,433,40790,348
2021-03-29,Santa Barbara,083,443738,33398,32983,1095,34078,439
2021-03-29,Santa Clara,085,1922200,114222,114335,660,114995,1871
2021-03-29,Santa Cruz,087,273765,15853,15249,802,16051,201
2021-03-29,Shasta,089,179085,11325,11313,1355,12668,183
2021-03-29,Sierra,091,2930,55,50,12,62,0
2021-03-29,Siskiyou,093,43540,1569,1497,263,1760,6
2021-03-29,Solano,095,438530,30896,30762,413,31175,232
2021-03-29,Sonoma,097,501317,29090,29184,272,29456,310
2021-03-29,Stanislaus,099,539301,53154,52614,5613,58227,677
2021-03-29,Sutter,101,95872,9116,9105,82,9187,106
2021-03-29,Tehama,103,63373,4784,4742,515,5257,52
2021-03-29,Trinity,105,12862,478,314,85,399,3
2021-03-29,Tulare,107,460477,49291,48226,8603,56829,815
2021-03-29,Tuolumne,109,53932,3920,3969,38,4007,57
2021-03-29,Ventura,111,848112,79899,79252,2889,82141,956
2021-03-29,Yolo,113,214977,13349,13346,246,13592,195
2021-03-29,Yuba,115,75493,5727,5671,106,5777,42
2021-03-28,Alameda,001,1643700,83809,83239,1808,85047,1212
2021-03-28,Alpine,003,1148,85,85,0,85,0
2021-03-28,Amador,005,37829,3573,3541,32,3573,45
2021-03-28,Butte,007,227075,11684,11285,1668,12953,191
2021-03-28,Calaveras,009,45235,2004,1995,11,2006,50
2021-03-28,Colusa,011,21464,1890,1889,273,2162,14
2021-03-28,Contra Costa,013,1133247,65763,64878,1142,66020,767
2021-03-28,Del Norte,015,27424,1186,1107,7,1114,6
2021-03-28,El Dorado,017,186661,9449,9371,629,10000,105
2021-03-28,Fresno,019,978130,99827,99004,8264,107268,1606
2021-03-28,Glenn,021,27897,2344,2309,527,2836,17
2021-03-28,Humboldt,023,135768,3456,3452,24,3476,34
2021-03-28,Imperial,025,180216,27616,27426,2590,30016,704
2021-03-28,Inyo,027,18085,1376,1372,10,1382,35
2021-03-28,Kern,029,883053,95389,94084,10318,104402,1219
2021-03-28,Kings,031,150075,22796,22514,1032,23546,238
2021-03-28,Lake,033,64148,3350,3320,8,3328,43
2021-03-28,Lassen,035,31185,5144,5131,102,5233,1
2021-03-28,Los Angeles,037,10098052,1188303,1179316,39989,1219305,23101
2021-03-28,Madera,039,155013,16122,15973,889,16862,210
2021-03-28,Marin,041,260295,13662,13594,205,13799,221
2021-03-28,Mariposa,043,17540,393,388,5,393,5
2021-03-28,Mendocino,045,87422,3753,3666,74,3740,45
2021-03-28,Merced,047,269075,29776,29679,997,30676,422
2021-03-28,Modoc,049,8938,355,344,119,463,3
2021-03-28,Mono,051,14174,1233,1242,17,1259,3
2021-03-28,Monterey,053,433212,42525,42294,1772,44066,337
2021-03-28,Napa,055,140530,9423,9368,34,9402,78
2021-03-28,Nevada,057,99092,4337,4239,181,4420,68
2021-03-28,Orange,059,3164182,251103,249238,10795,260033,4713
2021-03-28,Placer,061,380077,21565,20796,1240,22036,267
2021-03-28,Plumas,063,18699,671,657,10,667,4
2021-03-28,Riverside,065,2383286,289419,282811,13712,296523,4132
2021-03-28,Sacramento,067,1510023,98824,97425,1411,98836,1514
2021-03-28,San Benito,069,59416,5859,5862,96,5958,61
2021-03-28,San Bernardino,071,2135413,289199,285570,8760,294330,4332
2021-03-28,San Diego,073,3302833,270850,269476,13513,282989,3547
2021-03-28,San Francisco,075,870044,35275,35286,1200,36486,474
2021-03-28,San Joaquin,077,732212,69674,68459,3152,71611,1211
2021-03-28,San Luis Obispo,079,281455,20484,20172,625,20797,250
2021-03-28,San Mateo,081,765935,40761,40305,433,40738,348
2021-03-28,Santa Barbara,083,443738,33356,32953,1094,34047,439
2021-03-28,Santa Clara,085,1922200,114122,114232,656,114888,1871
2021-03-28,Santa Cruz,087,273765,15838,15238,801,16039,201
2021-03-28,Shasta,089,179085,11299,11308,1344,12652,183
2021-03-28,Sierra,091,2930,55,50,12,62,0
2021-03-28,Siskiyou,093,43540,1569,1497,262,1759,6
2021-03-28,Solano,095,438530,30859,30719,411,31130,232
2021-03-28,Sonoma,097,501317,29054,29161,270,29431,310
2021-03-28,Stanislaus,099,539301,53066,52567,5598,58165,678
2021-03-28,Sutter,101,95872,9107,9094,82,9176,106
2021-03-28,Tehama,103,63373,4774,4740,513,5253,52
2021-03-28,Trinity,105,12862,476,314,84,398,3
2021-03-28,Tulare,107,460477,49262,48218,8597,56815,815
2021-03-28,Tuolumne,109,53932,3917,3969,37,4006,57
2021-03-28,Ventura,111,848112,79848,79222,2884,82106,956
2021-03-28,Yolo,113,214977,13332,13325,245,13570,194
2021-03-28,Yuba,115,75493,5723,5662,106,5768,42
2021-03-27,Alameda,001,1643700,83738,83169,1804,84973,1211
2021-03-27,Alpine,003,1148,85,85,0,85,0
2021-03-27,Amador,005,37829,3568,3538,32,3570,45
2021-03-27,Butte,007,227075,11677,11278,1667,12945,191
2021-03-27,Calaveras,009,45235,2001,1992,11,2003,50
2021-03-27,Colusa,011,21464,1890,1889,273,2162,14
2021-03-27,Contra Costa,013,1133247,65693,64804,1139,65943,767
2021-03-27,Del Norte,015,27424,1176,1104,7,1111,6
2021-03-27,El Dorado,017,186661,9435,9367,629,9996,105
2021-03-27,Fresno,019,978130,99774,98901,8258,107159,1606
2021-03-27,Glenn,021,27897,2343,2308,527,2835,17
2021-03-27,Humboldt,023,135768,3451,3442,24,3466,34
2021-03-27,Imperial,025,180216,27604,27406,2587,29993,704
2021-03-27,Inyo,027,18085,1374,1372,10,1382,35
2021-03-27,Kern,029,883053,95369,94041,10306,104347,1217
2021-03-27,Kings,031,150075,22793,22502,1032,23534,238
2021-03-27,Lake,033,64148,3348,3317,8,3325,43
2021-03-27,Lassen,035,31185,5144,5129,102,5231,1
2021-03-27,Los Angeles,037,10098052,1187988,1178831,39963,1218794,23103
2021-03-27,Madera,039,155013,16115,15968,887,16855,210
2021-03-27,Marin,041,260295,13657,13579,205,13784,222
2021-03-27,Mariposa,043,17540,393,386,5,391,5
2021-03-27,Mendocino,045,87422,3751,3666,74,3740,45
2021-03-27,Merced,047,269075,29743,29647,995,30642,422
2021-03-27,Modoc,049,8938,355,344,119,463,3
2021-03-27,Mono,051,14174,1231,1241,17,1258,3
2021-03-27,Monterey,053,433212,42515,42271,1772,44043,337
2021-03-27,Napa,055,140530,9411,9360,34,9394,78
2021-03-27,Nevada,057,99092,4327,4231,181,4412,68
2021-03-27,Orange,059,3164182,251010,249160,10779,259939,4698
2021-03-27,Placer,061,380077,21545,20717,1233,21950,267
2021-03-27,Plumas,063,18699,670,655,10,665,4
2021-03-27,Riverside,065,2383286,289357,282707,13704,296411,4132
2021-03-27,Sacramento,067,1510023,98734,97247,1409,98656,1513
2021-03-27,San Benito,069,59416,5857,5862,94,5956,61
2021-03-27,San Bernardino,071,2135413,289136,285480,8758,294238,4325
2021-03-27,San Diego,073,3302833,270679,269271,13491,282762,3540
2021-03-27,San Francisco,075,870044,35252,35244,1198,36442,474
2021-03-27,San Joaquin,077,732212,69614,68365,3144,71509,1211
2021-03-27,San Luis Obispo,079,281455,20473,20153,622,20775,250
2021-03-27,San Mateo,081,765935,40738,40264,433,40697,348
2021-03-27,Santa Barbara,083,443738,33333,32921,1094,34015,439
2021-03-27,Santa Clara,085,1922200,114026,114124,654,114778,1871
2021-03-27,Santa Cruz,087,273765,15832,15215,801,16016,201
2021-03-27,Shasta,089,179085,11288,11288,1342,12630,183
2021-03-27,Sierra,091,2930,55,50,12,62,0
2021-03-27,Siskiyou,093,43540,1569,1497,262,1759,6
2021-03-27,Solano,095,438530,30831,30669,410,31079,232
2021-03-27,Sonoma,097,501317,29039,29133,268,29401,310
2021-03-27,Stanislaus,099,539301,53001,52497,5590,58087,678
2021-03-27,Sutter,101,95872,9100,9093,82,9175,106
2021-03-27,Tehama,103,63373,4768,4738,511,5249,52
2021-03-27,Trinity,105,12862,476,313,84,397,3
2021-03-27,Tulare,107,460477,49246,48203,8589,56792,813
2021-03-27,Tuolumne,109,53932,3914,3968,37,4005,57
2021-03-27,Ventura,111,848112,79821,79184,2882,82066,956
2021-03-27,Yolo,113,214977,13327,13317,244,13561,194
2021-03-27,Yuba,115,75493,5721,5657,106,5763,42
2021-03-26,Alameda,001,1643700,83676,83043,1802,84845,1208
2021-03-26,Alpine,003,1148,85,85,0,85,0
2021-03-26,Amador,005,37829,3563,3532,32,3564,45
2021-03-26,Butte,007,227075,11667,11278,1667,12945,191
2021-03-26,Calaveras,009,45235,1998,1989,11,2000,50
2021-03-26,Colusa,011,21464,1890,1889,273,2162,14
2021-03-26,Contra Costa,013,1133247,65633,64699,1136,65835,761
2021-03-26,Del Norte,015,27424,1173,1101,7,1108,6
2021-03-26,El Dorado,017,186661,9430,9353,629,9982,105
2021-03-26,Fresno,019,978130,99712,98731,8248,106979,1601
2021-03-26,Glenn,021,27897,2343,2307,526,2833,17
2021-03-26,Humboldt,023,135768,3449,3431,24,3455,34
2021-03-26,Imperial,025,180216,27580,27374,2587,29961,701
2021-03-26,Inyo,027,18085,1373,1369,10,1379,35
2021-03-26,Kern,029,883053,95343,93949,10300,104249,1211
2021-03-26,Kings,031,150075,22785,22493,1030,23523,239
2021-03-26,Lake,033,64148,3347,3314,8,3322,43
2021-03-26,Lassen,035,31185,5143,5131,102,5233,1
2021-03-26,Los Angeles,037,10098052,1187650,1178213,39950,1218163,23080
2021-03-26,Madera,039,155013,16105,15952,887,16839,210
2021-03-26,Marin,041,260295,13651,13553,200,13753,221
2021-03-26,Mariposa,043,17540,393,386,5,391,5
2021-03-26,Mendocino,045,87422,3750,3664,74,3738,45
2021-03-26,Merced,047,269075,29720,29613,993,30606,419
2021-03-26,Modoc,049,8938,355,344,119,463,3
2021-03-26,Mono,051,14174,1230,1236,17,1253,3
2021-03-26,Monterey,053,433212,42502,42241,1768,44009,338
2021-03-26,Napa,055,140530,9401,9349,34,9383,78
2021-03-26,Nevada,057,99092,4307,4222,181,4403,83
2021-03-26,Orange,059,3164182,250947,248995,10765,259760,4671
2021-03-26,Placer,061,380077,21519,20679,1232,21911,259
2021-03-26,Plumas,063,18699,669,654,10,664,4
2021-03-26,Riverside,065,2383286,289279,282602,13698,296300,4109
2021-03-26,Sacramento,067,1510023,98634,97040,1404,98444,1509
2021-03-26,San Benito,069,59416,5854,5855,94,5949,61
2021-03-26,San Bernardino,071,2135413,289080,285313,8756,294069,4288
2021-03-26,San Diego,073,3302833,270501,269045,13465,282510,3525
2021-03-26,San Francisco,075,870044,35226,35186,1198,36384,472
2021-03-26,San Joaquin,077,732212,69551,68249,3140,71389,1202
2021-03-26,San Luis Obispo,079,281455,20460,20118,622,20740,250
2021-03-26,San Mateo,081,765935,40703,40199,433,40632,348
2021-03-26,Santa Barbara,083,443738,33303,32895,1093,33988,439
2021-03-26,Santa Clara,085,1922200,113928,113959,653,114612,1868
2021-03-26,Santa Cruz,087,273765,15817,15199,800,15999,201
2021-03-26,Shasta,089,179085,11279,11276,1336,12612,182
2021-03-26,Sierra,091,2930,55,50,12,62,0
2021-03-26,Siskiyou,093,43540,1569,1493,261,1754,6
2021-03-26,Solano,095,438530,30806,30640,410,31050,205
2021-03-26,Sonoma,097,501317,29023,29101,265,29366,310
2021-03-26,Stanislaus,099,539301,52933,52420,5586,58006,678
2021-03-26,Sutter,101,95872,9097,9082,82,9164,104
2021-03-26,Tehama,103,63373,4767,4722,510,5232,51
2021-03-26,Trinity,105,12862,476,311,84,395,3
2021-03-26,Tulare,107,460477,49231,48179,8581,56760,813
2021-03-26,Tuolumne,109,53932,3913,3965,37,4002,57
2021-03-26,Ventura,111,848112,79787,79122,2880,82002,953
2021-03-26,Yolo,113,214977,13320,13299,242,13541,194
2021-03-26,Yuba,115,75493,5711,5653,106,5759,42
2021-03-25,Alameda,001,1643700,83581,82945,1800,84745,1206
2021-03-25,Alpine,003,1148,85,84,0,84,0
2021-03-25,Amador,005,37829,3561,3530,32,3562,45
2021-03-25,Butte,007,227075,11657,11270,1667,12937,188
2021-03-25,Calaveras,009,45235,1997,1982,11,1993,50
2021-03-25,Colusa,011,21464,1890,1888,273,2161,14
2021-03-25,Contra Costa,013,1133247,65566,64606,1132,65738,757
2021-03-25,Del Norte,015,27424,1167,1095,7,1102,6
2021-03-25,El Dorado,017,186661,9420,9331,629,9960,105
2021-03-25,Fresno,019,978130,99594,98602,8235,106837,1593
2021-03-25,Glenn,021,27897,2342,2302,525,2827,17
2021-03-25,Humboldt,023,135768,3444,3423,24,3447,34
2021-03-25,Imperial,025,180216,27564,27352,2586,29938,699
2021-03-25,Inyo,027,18085,1373,1369,10,1379,35
2021-03-25,Kern,029,883053,95311,93857,10295,104152,1206
2021-03-25,Kings,031,150075,22775,22472,1030,23502,237
2021-03-25,Lake,033,64148,3342,3312,8,3320,43
2021-03-25,Lassen,035,31185,5143,5129,102,5231,1
2021-03-25,Los Angeles,037,10098052,1187213,1177490,39915,1217405,23051
2021-03-25,Madera,039,155013,16086,15937,885,16822,210
2021-03-25,Marin,041,260295,13641,13538,197,13735,219
2021-03-25,Mariposa,043,17540,393,386,5,391,5
2021-03-25,Mendocino,045,87422,3749,3664,74,3738,45
2021-03-25,Merced,047,269075,29686,29576,986,30562,416
2021-03-25,Modoc,049,8938,355,343,119,462,3
2021-03-25,Mono,051,14174,1230,1235,17,1252,3
2021-03-25,Monterey,053,433212,42481,42220,1763,43983,336
2021-03-25,Napa,055,140530,9382,9321,34,9355,78
2021-03-25,Nevada,057,99092,4289,4202,179,4381,84
2021-03-25,Orange,059,3164182,250831,248871,10745,259616,4655
2021-03-25,Placer,061,380077,21478,20639,1225,21864,252
2021-03-25,Plumas,063,18699,669,654,10,664,4
2021-03-25,Riverside,065,2383286,289182,282492,13687,296179,4078
2021-03-25,Sacramento,067,1510023,98489,96823,1401,98224,1505
2021-03-25,San Benito,069,59416,5851,5850,94,5944,61
2021-03-25,San Bernardino,071,2135413,288999,285134,8751,293885,4222
2021-03-25,San Diego,073,3302833,270273,268623,13434,282057,3520
2021-03-25,San Francisco,075,870044,35187,35154,1196,36350,468
2021-03-25,San Joaquin,077,732212,69454,68089,3101,71190,1196
2021-03-25,San Luis Obispo,079,281455,20442,20076,622,20698,250
2021-03-25,San Mateo,081,765935,40663,40147,433,40580,348
2021-03-25,Santa Barbara,083,443738,33276,32857,1093,33950,439
2021-03-25,Santa Clara,085,1922200,113824,113877,651,114528,1868
2021-03-25,Santa Cruz,087,273765,15796,15170,800,15970,201
2021-03-25,Shasta,089,179085,11262,11262,1333,12595,181
2021-03-25,Sierra,091,2930,55,50,12,62,0
2021-03-25,Siskiyou,093,43540,1567,1491,260,1751,6
2021-03-25,Solano,095,438530,30745,30583,408,30991,193
2021-03-25,Sonoma,097,501317,28989,29060,261,29321,310
2021-03-25,Stanislaus,099,539301,52866,52321,5579,57900,678
2021-03-25,Sutter,101,95872,9088,9069,82,9151,104
2021-03-25,Tehama,103,63373,4765,4719,509,5228,52
2021-03-25,Trinity,105,12862,476,310,84,394,3
2021-03-25,Tulare,107,460477,49204,48148,8568,56716,811
2021-03-25,Tuolumne,109,53932,3912,3962,37,3999,57
2021-03-25,Ventura,111,848112,79746,79045,2876,81921,952
2021-03-25,Yolo,113,214977,13314,13287,242,13529,194
2021-03-25,Yuba,115,75493,5705,5647,100,5747,42
2021-03-24,Alameda,001,1643700,83487,82871,1797,84668,1199
2021-03-24,Alpine,003,1148,85,84,0,84,0
2021-03-24,Amador,005,37829,3555,3529,32,3561,45
2021-03-24,Butte,007,227075,11647,11252,1663,12915,187
2021-03-24,Calaveras,009,45235,1994,1975,11,1986,50
2021-03-24,Colusa,011,21464,1890,1886,273,2159,14
2021-03-24,Contra Costa,013,1133247,65486,64539,1131,65670,755
2021-03-24,Del Norte,015,27424,1162,1087,7,1094,6
2021-03-24,El Dorado,017,186661,9414,9319,628,9947,105
2021-03-24,Fresno,019,978130,99504,98437,8220,106657,1585
2021-03-24,Glenn,021,27897,2341,2297,524,2821,17
2021-03-24,Humboldt,023,135768,3441,3414,24,3438,34
2021-03-24,Imperial,025,180216,27555,27325,2586,29911,699
2021-03-24,Inyo,027,18085,1373,1368,10,1378,35
2021-03-24,Kern,029,883053,95263,93800,10286,104086,1198
2021-03-24,Kings,031,150075,22760,22456,1028,23484,237
2021-03-24,Lake,033,64148,3338,3307,8,3315,43
2021-03-24,Lassen,035,31185,5141,5130,101,5231,1
2021-03-24,Los Angeles,037,10098052,1186730,1177015,39881,1216896,22993
2021-03-24,Madera,039,155013,16077,15918,884,16802,210
2021-03-24,Marin,041,260295,13627,13526,195,13721,219
2021-03-24,Mariposa,043,17540,393,384,5,389,5
2021-03-24,Mendocino,045,87422,3746,3660,74,3734,45
2021-03-24,Merced,047,269075,29645,29525,986,30511,415
2021-03-24,Modoc,049,8938,354,341,119,460,3
2021-03-24,Mono,051,14174,1229,1243,17,1260,3
2021-03-24,Monterey,053,433212,42459,42201,1760,43961,335
2021-03-24,Napa,055,140530,9362,9310,34,9344,78
2021-03-24,Nevada,057,99092,4274,4191,178,4369,85
2021-03-24,Orange,059,3164182,250717,248775,10727,259502,4638
2021-03-24,Placer,061,380077,21448,20606,1217,21823,250
2021-03-24,Plumas,063,18699,667,652,10,662,4
2021-03-24,Riverside,065,2383286,289098,282410,13684,296094,4058
2021-03-24,Sacramento,067,1510023,98314,96628,1389,98017,1500
2021-03-24,San Benito,069,59416,5850,5847,94,5941,61
2021-03-24,San Bernardino,071,2135413,288913,284983,8749,293732,4170
2021-03-24,San Diego,073,3302833,270059,268413,13406,281819,3509
2021-03-24,San Francisco,075,870044,35159,35103,1193,36296,462
2021-03-24,San Joaquin,077,732212,69383,67978,3089,71067,1196
2021-03-24,San Luis Obispo,079,281455,20412,20021,621,20642,250
2021-03-24,San Mateo,081,765935,40613,40083,433,40516,348
2021-03-24,Santa Barbara,083,443738,33248,32810,1093,33903,438
2021-03-24,Santa Clara,085,1922200,113708,113757,648,114405,1851
2021-03-24,Santa Cruz,087,273765,15782,15138,799,15937,202
2021-03-24,Shasta,089,179085,11243,11243,1331,12574,181
2021-03-24,Sierra,091,2930,55,50,12,62,0
2021-03-24,Siskiyou,093,43540,1565,1490,260,1750,6
2021-03-24,Solano,095,438530,30708,30552,407,30959,178
2021-03-24,Sonoma,097,501317,28969,29034,257,29291,310
2021-03-24,Stanislaus,099,539301,52790,52259,5570,57829,677
2021-03-24,Sutter,101,95872,9072,9049,82,9131,104
2021-03-24,Tehama,103,63373,4759,4719,508,5227,49
2021-03-24,Trinity,105,12862,475,310,84,394,3
2021-03-24,Tulare,107,460477,49193,48109,8555,56664,808
2021-03-24,Tuolumne,109,53932,3911,3961,37,3998,57
2021-03-24,Ventura,111,848112,79694,78993,2869,81862,944
2021-03-24,Yolo,113,214977,13302,13269,242,13511,194
2021-03-24,Yuba,115,75493,5699,5634,97,5731,42
2021-03-23,Alameda,001,1643700,83384,82799,1793,84592,1190
2021-03-23,Alpine,003,1148,85,84,0,84,0
2021-03-23,Amador,005,37829,3549,3524,32,3556,45
2021-03-23,Butte,007,227075,11635,11227,1662,12889,187
2021-03-23,Calaveras,009,45235,1992,1971,11,1982,50
2021-03-23,Colusa,011,21464,1888,1885,272,2157,14
2021-03-23,Contra Costa,013,1133247,65387,64491,1130,65621,750
2021-03-23,Del Norte,015,27424,1157,1082,7,1089,6
2021-03-23,El Dorado,017,186661,9404,9318,625,9943,105
2021-03-23,Fresno,019,978130,99390,98362,8194,106556,1575
2021-03-23,Glenn,021,27897,2336,2293,522,2815,17
2021-03-23,Humboldt,023,135768,3432,3405,24,3429,34
2021-03-23,Imperial,025,180216,27547,27320,2586,29906,699
2021-03-23,Inyo,027,18085,1371,1364,10,1374,35
2021-03-23,Kern,029,883053,95156,93728,10279,104007,1191
2021-03-23,Kings,031,150075,22749,22439,1026,23465,237
2021-03-23,Lake,033,64148,3336,3294,8,3302,43
2021-03-23,Lassen,035,31185,5141,5130,101,5231,1
2021-03-23,Los Angeles,037,10098052,1186210,1176572,39843,1216415,22904
2021-03-23,Madera,039,155013,16061,15908,883,16791,210
2021-03-23,Marin,041,260295,13604,13514,193,13707,221
2021-03-23,Mariposa,043,17540,392,384,5,389,5
2021-03-23,Mendocino,045,87422,3744,3652,74,3726,45
2021-03-23,Merced,047,269075,29612,29485,986,30471,415
2021-03-23,Modoc,049,8938,353,342,119,461,3
2021-03-23,Mono,051,14174,1228,1263,17,1280,3
2021-03-23,Monterey,053,433212,42448,42180,1758,43938,335
2021-03-23,Napa,055,140530,9337,9299,34,9333,78
2021-03-23,Nevada,057,99092,4255,4179,177,4356,89
2021-03-23,Orange,059,3164182,250591,248661,10709,259370,4626
2021-03-23,Placer,061,380077,21413,20567,1213,21780,248
2021-03-23,Plumas,063,18699,667,652,10,662,4
2021-03-23,Riverside,065,2383286,288998,282317,13677,295994,4035
2021-03-23,Sacramento,067,1510023,98122,96521,1383,97904,1496
2021-03-23,San Benito,069,59416,5845,5845,93,5938,61
2021-03-23,San Bernardino,071,2135413,288827,284875,8741,293616,4134
2021-03-23,San Diego,073,3302833,269814,268156,13374,281530,3498
2021-03-23,San Francisco,075,870044,35101,35071,1187,36258,462
2021-03-23,San Joaquin,077,732212,69287,67903,3071,70974,1182
2021-03-23,San Luis Obispo,079,281455,20371,20009,620,20629,250
2021-03-23,San Mateo,081,765935,40557,40032,432,40464,348
2021-03-23,Santa Barbara,083,443738,33210,32771,1092,33863,438
2021-03-23,Santa Clara,085,1922200,113592,113645,645,114290,1848
2021-03-23,Santa Cruz,087,273765,15767,15106,799,15905,201
2021-03-23,Shasta,089,179085,11230,11234,1330,12564,175
2021-03-23,Sierra,091,2930,55,50,12,62,0
2021-03-23,Siskiyou,093,43540,1560,1485,258,1743,6
2021-03-23,Solano,095,438530,30667,30524,406,30930,178
2021-03-23,Sonoma,097,501317,28932,29020,256,29276,310
2021-03-23,Stanislaus,099,539301,52691,52148,5562,57710,677
2021-03-23,Sutter,101,95872,9064,9039,82,9121,104
2021-03-23,Tehama,103,63373,4750,4707,507,5214,46
2021-03-23,Trinity,105,12862,475,310,84,394,3
2021-03-23,Tulare,107,460477,49166,48095,8539,56634,808
2021-03-23,Tuolumne,109,53932,3908,3957,37,3994,57
2021-03-23,Ventura,111,848112,79633,78930,2866,81796,932
2021-03-23,Yolo,113,214977,13291,13255,242,13497,194
2021-03-23,Yuba,115,75493,5694,5628,97,5725,42
2021-03-22,Alameda,001,1643700,83291,82748,1787,84535,1189
2021-03-22,Alpine,003,1148,84,83,0,83,0
2021-03-22,Amador,005,37829,3541,3522,32,3554,44
2021-03-22,Butte,007,227075,11626,11211,1660,12871,185
2021-03-22,Calaveras,009,45235,1988,1963,11,1974,49
2021-03-22,Colusa,011,21464,1886,1885,272,2157,13
2021-03-22,Contra Costa,013,1133247,65292,64432,1128,65560,740
2021-03-22,Del Norte,015,27424,1151,1082,7,1089,6
2021-03-22,El Dorado,017,186661,9388,9310,622,9932,105
2021-03-22,Fresno,019,978130,99292,98276,8181,106457,1556
2021-03-22,Glenn,021,27897,2328,2291,522,2813,17
2021-03-22,Humboldt,023,135768,3427,3403,24,3427,34
2021-03-22,Imperial,025,180216,27532,27302,2582,29884,699
2021-03-22,Inyo,027,18085,1368,1363,10,1373,35
2021-03-22,Kern,029,883053,95085,93675,10262,103937,1178
2021-03-22,Kings,031,150075,22736,22433,1021,23454,236
2021-03-22,Lake,033,64148,3335,3290,8,3298,43
2021-03-22,Lassen,035,31185,5139,5129,101,5230,1
2021-03-22,Los Angeles,037,10098052,1185691,1176205,39812,1216017,22843
2021-03-22,Madera,039,155013,16046,15904,883,16787,210
2021-03-22,Marin,041,260295,13595,13501,192,13693,221
2021-03-22,Mariposa,043,17540,391,381,5,386,5
2021-03-22,Mendocino,045,87422,3742,3653,74,3727,45
2021-03-22,Merced,047,269075,29569,29468,983,30451,413
2021-03-22,Modoc,049,8938,351,342,119,461,3
2021-03-22,Mono,051,14174,1223,1263,17,1280,3
2021-03-22,Monterey,053,433212,42432,42161,1756,43917,335
2021-03-22,Napa,055,140530,9326,9288,34,9322,77
2021-03-22,Nevada,057,99092,4245,4174,173,4347,89
2021-03-22,Orange,059,3164182,250440,248517,10675,259192,4599
2021-03-22,Placer,061,380077,21378,20543,1208,21751,242
2021-03-22,Plumas,063,18699,667,652,10,662,4
2021-03-22,Riverside,065,2383286,288898,282242,13666,295908,4009
2021-03-22,Sacramento,067,1510023,97944,96385,1374,97759,1493
2021-03-22,San Benito,069,59416,5842,5844,92,5936,61
2021-03-22,San Bernardino,071,2135413,288739,284771,8729,293500,4107
2021-03-22,San Diego,073,3302833,269602,267913,13354,281267,3494
2021-03-22,San Francisco,075,870044,35059,35040,1183,36223,462
2021-03-22,San Joaquin,077,732212,69195,67815,3053,70868,1182
2021-03-22,San Luis Obispo,079,281455,20347,20000,619,20619,250
2021-03-22,San Mateo,081,765935,40506,40024,431,40455,348
2021-03-22,Santa Barbara,083,443738,33166,32756,1090,33846,437
2021-03-22,Santa Clara,085,1922200,113472,113575,645,114220,1845
2021-03-22,Santa Cruz,087,273765,15755,15077,798,15875,201
2021-03-22,Shasta,089,179085,11216,11218,1329,12547,150
2021-03-22,Sierra,091,2930,55,50,12,62,0
2021-03-22,Siskiyou,093,43540,1559,1487,257,1744,5
2021-03-22,Solano,095,438530,30627,30490,402,30892,171
2021-03-22,Sonoma,097,501317,28903,29010,252,29262,310
2021-03-22,Stanislaus,099,539301,52607,52083,5557,57640,677
2021-03-22,Sutter,101,95872,9051,9024,82,9106,104
2021-03-22,Tehama,103,63373,4742,4704,507,5211,45
2021-03-22,Trinity,105,12862,475,310,84,394,3
2021-03-22,Tulare,107,460477,49151,48074,8519,56593,807
2021-03-22,Tuolumne,109,53932,3905,3954,37,3991,57
2021-03-22,Ventura,111,848112,79587,78890,2863,81753,927
2021-03-22,Yolo,113,214977,13279,13243,241,13484,190
2021-03-22,Yuba,115,75493,5683,5627,95,5722,42
2021-03-21,Alameda,001,1643700,83201,82684,1784,84468,1187
2021-03-21,Alpine,003,1148,84,83,0,83,0
2021-03-21,Amador,005,37829,3537,3519,32,3551,44
2021-03-21,Butte,007,227075,11610,11208,1655,12863,185
2021-03-21,Calaveras,009,45235,1982,1962,11,1973,49
2021-03-21,Colusa,011,21464,1886,1885,272,2157,13
2021-03-21,Contra Costa,013,1133247,65210,64382,1124,65506,740
2021-03-21,Del Norte,015,27424,1136,1076,7,1083,6
2021-03-21,El Dorado,017,186661,9378,9302,617,9919,105
2021-03-21,Fresno,019,978130,99178,98211,8157,106368,1556
2021-03-21,Glenn,021,27897,2325,2288,521,2809,17
2021-03-21,Humboldt,023,135768,3422,3402,24,3426,34
2021-03-21,Imperial,025,180216,27515,27267,2577,29844,699
2021-03-21,Inyo,027,18085,1368,1363,10,1373,35
2021-03-21,Kern,029,883053,95019,93649,10253,103902,1170
2021-03-21,Kings,031,150075,22719,22422,1021,23443,236
2021-03-21,Lake,033,64148,3331,3286,8,3294,43
2021-03-21,Lassen,035,31185,5139,5129,101,5230,1
2021-03-21,Los Angeles,037,10098052,1185155,1175684,39765,1215449,22834
2021-03-21,Madera,039,155013,16026,15895,881,16776,210
2021-03-21,Marin,041,260295,13579,13495,191,13686,220
2021-03-21,Mariposa,043,17540,391,381,5,386,5
2021-03-21,Mendocino,045,87422,3739,3651,74,3725,45
2021-03-21,Merced,047,269075,29509,29446,977,30423,413
2021-03-21,Modoc,049,8938,351,341,119,460,3
2021-03-21,Mono,051,14174,1218,1263,17,1280,3
2021-03-21,Monterey,053,433212,42407,42153,1753,43906,335
2021-03-21,Napa,055,140530,9306,9282,34,9316,77
2021-03-21,Nevada,057,99092,4232,4169,173,4342,89
2021-03-21,Orange,059,3164182,250307,248442,10648,259090,4598
2021-03-21,Placer,061,380077,21342,20520,1200,21720,242
2021-03-21,Plumas,063,18699,667,653,10,663,4
2021-03-21,Riverside,065,2383286,288791,282187,13655,295842,4009
2021-03-21,Sacramento,067,1510023,97750,96269,1367,97636,1489
2021-03-21,San Benito,069,59416,5836,5842,92,5934,61
2021-03-21,San Bernardino,071,2135413,288648,284732,8723,293455,4094
2021-03-21,San Diego,073,3302833,269342,267724,13328,281052,3494
2021-03-21,San Francisco,075,870044,35012,35012,1176,36188,460
2021-03-21,San Joaquin,077,732212,69073,67729,3035,70764,1182
2021-03-21,San Luis Obispo,079,281455,20315,19979,617,20596,250
2021-03-21,San Mateo,081,765935,40461,39988,430,40418,344
2021-03-21,Santa Barbara,083,443738,33127,32743,1089,33832,437
2021-03-21,Santa Clara,085,1922200,113343,113487,642,114129,1840
2021-03-21,Santa Cruz,087,273765,15748,15064,798,15862,199
2021-03-21,Shasta,089,179085,11196,11215,1328,12543,150
2021-03-21,Sierra,091,2930,55,50,12,62,0
2021-03-21,Siskiyou,093,43540,1559,1486,256,1742,5
2021-03-21,Solano,095,438530,30587,30474,399,30873,171
2021-03-21,Sonoma,097,501317,28874,28986,251,29237,310
2021-03-21,Stanislaus,099,539301,52517,52014,5555,57569,677
2021-03-21,Sutter,101,95872,9038,9021,82,9103,104
2021-03-21,Tehama,103,63373,4738,4701,507,5208,45
2021-03-21,Trinity,105,12862,473,310,84,394,3
2021-03-21,Tulare,107,460477,49135,48060,8507,56567,807
2021-03-21,Tuolumne,109,53932,3903,3953,37,3990,57
2021-03-21,Ventura,111,848112,79524,78863,2858,81721,927
2021-03-21,Yolo,113,214977,13257,13235,241,13476,190
2021-03-21,Yuba,115,75493,5673,5624,95,5719,42
2021-03-20,Alameda,001,1643700,83133,82614,1782,84396,1178
2021-03-20,Alpine,003,1148,84,83,0,83,0
2021-03-20,Amador,005,37829,3535,3518,32,3550,44
2021-03-20,Butte,007,227075,11604,11199,1653,12852,185
2021-03-20,Calaveras,009,45235,1978,1961,11,1972,49
2021-03-20,Colusa,011,21464,1886,1883,272,2155,12
2021-03-20,Contra Costa,013,1133247,65150,64313,1124,65437,713
2021-03-20,Del Norte,015,27424,1135,1075,7,1082,6
2021-03-20,El Dorado,017,186661,9372,9290,617,9907,105
2021-03-20,Fresno,019,978130,99118,98112,8150,106262,1532
2021-03-20,Glenn,021,27897,2324,2288,519,2807,17
2021-03-20,Humboldt,023,135768,3415,3399,24,3423,33
2021-03-20,Imperial,025,180216,27509,27239,2575,29814,695
2021-03-20,Inyo,027,18085,1368,1362,10,1372,35
2021-03-20,Kern,029,883053,94990,93606,10249,103855,1155
2021-03-20,Kings,031,150075,22714,22415,1020,23435,236
2021-03-20,Lake,033,64148,3327,3280,8,3288,43
2021-03-20,Lassen,035,31185,5139,5128,101,5229,1
2021-03-20,Los Angeles,037,10098052,1184853,1175290,39741,1215031,22810
2021-03-20,Madera,039,155013,16018,15891,880,16771,210
2021-03-20,Marin,041,260295,13567,13470,187,13657,220
2021-03-20,Mariposa,043,17540,390,381,5,386,5
2021-03-20,Mendocino,045,87422,3738,3639,74,3713,43
2021-03-20,Merced,047,269075,29478,29411,974,30385,412
2021-03-20,Modoc,049,8938,350,341,119,460,3
2021-03-20,Mono,051,14174,1218,1256,17,1273,3
2021-03-20,Monterey,053,433212,42398,42146,1752,43898,334
2021-03-20,Napa,055,140530,9298,9274,34,9308,77
2021-03-20,Nevada,057,99092,4221,4164,172,4336,89
2021-03-20,Orange,059,3164182,250226,248348,10637,258985,4522
2021-03-20,Placer,061,380077,21319,20505,1198,21703,242
2021-03-20,Plumas,063,18699,664,652,10,662,4
2021-03-20,Riverside,065,2383286,288716,282081,13651,295732,4000
2021-03-20,Sacramento,067,1510023,97639,96126,1364,97490,1488
2021-03-20,San Benito,069,59416,5832,5840,92,5932,61
2021-03-20,San Bernardino,071,2135413,288583,284690,8719,293409,3965
2021-03-20,San Diego,073,3302833,269171,267532,13321,280853,3493
2021-03-20,San Francisco,075,870044,34989,34968,1169,36137,453
2021-03-20,San Joaquin,077,732212,69032,67662,3028,70690,1161
2021-03-20,San Luis Obispo,079,281455,20299,19951,611,20562,250
2021-03-20,San Mateo,081,765935,40427,39958,429,40387,344
2021-03-20,Santa Barbara,083,443738,33102,32723,1088,33811,434
2021-03-20,Santa Clara,085,1922200,113251,113384,641,114025,1799
2021-03-20,Santa Cruz,087,273765,15732,15053,798,15851,199
2021-03-20,Shasta,089,179085,11190,11211,1328,12539,147
2021-03-20,Sierra,091,2930,55,50,12,62,0
2021-03-20,Siskiyou,093,43540,1559,1483,256,1739,5
2021-03-20,Solano,095,438530,30557,30439,399,30838,170
2021-03-20,Sonoma,097,501317,28859,28962,251,29213,309
2021-03-20,Stanislaus,099,539301,52461,51925,5548,57473,673
2021-03-20,Sutter,101,95872,9030,9014,82,9096,103
2021-03-20,Tehama,103,63373,4733,4696,505,5201,33
2021-03-20,Trinity,105,12862,472,310,84,394,3
2021-03-20,Tulare,107,460477,49120,48030,8490,56520,804
2021-03-20,Tuolumne,109,53932,3900,3950,37,3987,57
2021-03-20,Ventura,111,848112,79489,78818,2856,81674,922
2021-03-20,Yolo,113,214977,13253,13226,241,13467,190
2021-03-20,Yuba,115,75493,5670,5621,94,5715,42
2021-03-19,Alameda,001,1643700,83061,82499,1781,84280,1187
2021-03-19,Alpine,003,1148,83,82,0,82,0
2021-03-19,Amador,005,37829,3532,3515,32,3547,44
2021-03-19,Butte,007,227075,11596,11191,1650,12841,185
2021-03-19,Calaveras,009,45235,1977,1957,11,1968,49
2021-03-19,Colusa,011,21464,1885,1883,272,2155,12
2021-03-19,Contra Costa,013,1133247,65091,64195,1121,65316,737
2021-03-19,Del Norte,015,27424,1129,1071,5,1076,6
2021-03-19,El Dorado,017,186661,9363,9274,617,9891,105
2021-03-19,Fresno,019,978130,99034,97969,8136,106105,1527
2021-03-19,Glenn,021,27897,2324,2282,519,2801,17
2021-03-19,Humboldt,023,135768,3406,3388,24,3412,33
2021-03-19,Imperial,025,180216,27497,27218,2571,29789,695
2021-03-19,Inyo,027,18085,1366,1356,10,1366,35
2021-03-19,Kern,029,883053,94957,93534,10236,103770,1152
2021-03-19,Kings,031,150075,22705,22369,1017,23386,235
2021-03-19,Lake,033,64148,3321,3262,8,3270,43
2021-03-19,Lassen,035,31185,5139,5126,101,5227,1
2021-03-19,Los Angeles,037,10098052,1184515,1174818,39724,1214542,22752
2021-03-19,Madera,039,155013,16011,15877,879,16756,210
2021-03-19,Marin,041,260295,13555,13441,187,13628,220
2021-03-19,Mariposa,043,17540,389,380,5,385,5
2021-03-19,Mendocino,045,87422,3737,3639,74,3713,45
2021-03-19,Merced,047,269075,29451,29376,971,30347,412
2021-03-19,Modoc,049,8938,350,341,119,460,3
2021-03-19,Mono,051,14174,1216,1244,17,1261,3
2021-03-19,Monterey,053,433212,42389,42125,1750,43875,335
2021-03-19,Napa,055,140530,9286,9256,34,9290,77
2021-03-19,Nevada,057,99092,4210,4156,172,4328,88
2021-03-19,Orange,059,3164182,250126,248146,10627,258773,4501
2021-03-19,Placer,061,380077,21301,20451,1196,21647,242
2021-03-19,Plumas,063,18699,664,650,10,660,4
2021-03-19,Riverside,065,2383286,288633,281937,13646,295583,3989
2021-03-19,Sacramento,067,1510023,97536,95934,1361,97295,1486
2021-03-19,San Benito,069,59416,5832,5845,92,5937,61
2021-03-19,San Bernardino,071,2135413,288510,284501,8717,293218,4017
2021-03-19,San Diego,073,3302833,269036,267173,13311,280484,3491
2021-03-19,San Francisco,075,870044,34944,34936,1166,36102,461
2021-03-19,San Joaquin,077,732212,68962,67515,3014,70529,1180
2021-03-19,San Luis Obispo,079,281455,20279,19913,609,20522,249
2021-03-19,San Mateo,081,765935,40403,39893,429,40322,344
2021-03-19,Santa Barbara,083,443738,33072,32685,1087,33772,435
2021-03-19,Santa Clara,085,1922200,113176,113232,640,113872,1797
2021-03-19,Santa Cruz,087,273765,15725,15026,798,15824,199
2021-03-19,Shasta,089,179085,11183,11104,1326,12430,103
2021-03-19,Sierra,091,2930,54,49,12,61,0
2021-03-19,Siskiyou,093,43540,1559,1480,255,1735,5
2021-03-19,Solano,095,438530,30527,30395,397,30792,172
2021-03-19,Sonoma,097,501317,28838,28932,249,29181,292
2021-03-19,Stanislaus,099,539301,52403,51755,5545,57300,679
2021-03-19,Sutter,101,95872,9028,9005,82,9087,103
2021-03-19,Tehama,103,63373,4726,4685,505,5190,33
2021-03-19,Trinity,105,12862,472,310,84,394,3
2021-03-19,Tulare,107,460477,49097,47989,8467,56456,805
2021-03-19,Tuolumne,109,53932,3897,3946,37,3983,57
2021-03-19,Ventura,111,848112,79456,78753,2852,81605,920
2021-03-19,Yolo,113,214977,13245,13197,241,13438,189
2021-03-19,Yuba,115,75493,5667,5615,93,5708,42
2021-03-18,Alameda,001,1643700,82981,82419,1778,84197,1189
2021-03-18,Alpine,003,1148,83,82,0,82,0
2021-03-18,Amador,005,37829,3528,3513,32,3545,44
2021-03-18,Butte,007,227075,11585,11179,1648,12827,185
2021-03-18,Calaveras,009,45235,1975,1954,11,1965,49
2021-03-18,Colusa,011,21464,1885,1882,272,2154,12
2021-03-18,Contra Costa,013,1133247,65018,64103,1118,65221,739
2021-03-18,Del Norte,015,27424,1120,1059,5,1064,6
2021-03-18,El Dorado,017,186661,9350,9261,616,9877,105
2021-03-18,Fresno,019,978130,98937,97856,8121,105977,1527
2021-03-18,Glenn,021,27897,2320,2275,518,2793,17
2021-03-18,Humboldt,023,135768,3398,3381,24,3405,34
2021-03-18,Imperial,025,180216,27482,27190,2566,29756,695
2021-03-18,Inyo,027,18085,1363,1354,10,1364,35
2021-03-18,Kern,029,883053,94900,93458,10222,103680,1158
2021-03-18,Kings,031,150075,22698,22354,1016,23370,235
2021-03-18,Lake,033,64148,3318,3260,8,3268,43
2021-03-18,Lassen,035,31185,5138,5126,101,5227,1
2021-03-18,Los Angeles,037,10098052,1184082,1174205,39695,1213900,22689
2021-03-18,Madera,039,155013,15999,15860,876,16736,211
2021-03-18,Marin,041,260295,13537,13435,186,13621,219
2021-03-18,Mariposa,043,17540,387,380,5,385,5
2021-03-18,Mendocino,045,87422,3727,3630,74,3704,45
2021-03-18,Merced,047,269075,29416,29317,971,30288,410
2021-03-18,Modoc,049,8938,350,341,119,460,3
2021-03-18,Mono,051,14174,1212,1215,16,1231,3
2021-03-18,Monterey,053,433212,42377,42105,1750,43855,335
2021-03-18,Napa,055,140530,9277,9243,34,9277,77
2021-03-18,Nevada,057,99092,4203,4154,172,4326,74
2021-03-18,Orange,059,3164182,250023,248050,10614,258664,4514
2021-03-18,Placer,061,380077,21269,20421,1193,21614,243
2021-03-18,Plumas,063,18699,662,648,10,658,4
2021-03-18,Riverside,065,2383286,288552,281789,13639,295428,3957
2021-03-18,Sacramento,067,1510023,97388,95819,1357,97176,1481
2021-03-18,San Benito,069,59416,5830,5842,92,5934,61
2021-03-18,San Bernardino,071,2135413,288429,284294,8687,292981,4076
2021-03-18,San Diego,073,3302833,268883,266752,13301,280053,3478
2021-03-18,San Francisco,075,870044,34905,34904,1165,36069,461
2021-03-18,San Joaquin,077,732212,68862,67301,3002,70303,1169
2021-03-18,San Luis Obispo,079,281455,20250,19894,608,20502,249
2021-03-18,San Mateo,081,765935,40362,39874,429,40303,344
2021-03-18,Santa Barbara,083,443738,33031,32640,1087,33727,434
2021-03-18,Santa Clara,085,1922200,113059,113119,636,113755,1808
2021-03-18,Santa Cruz,087,273765,15715,14998,798,15796,198
2021-03-18,Shasta,089,179085,11169,11059,1324,12383,100
2021-03-18,Sierra,091,2930,54,49,12,61,0
2021-03-18,Siskiyou,093,43540,1556,1480,254,1734,5
2021-03-18,Solano,095,438530,30485,30352,394,30746,172
2021-03-18,Sonoma,097,501317,28817,28915,247,29162,292
2021-03-18,Stanislaus,099,539301,52331,51615,5541,57156,682
2021-03-18,Sutter,101,95872,9016,8999,82,9081,103
2021-03-18,Tehama,103,63373,4720,4683,504,5187,35
2021-03-18,Trinity,105,12862,472,310,84,394,3
2021-03-18,Tulare,107,460477,49078,47964,8452,56416,805
2021-03-18,Tuolumne,109,53932,3896,3942,37,3979,57
2021-03-18,Ventura,111,848112,79396,78697,2852,81549,918
2021-03-18,Yolo,113,214977,13232,13183,241,13424,191
2021-03-18,Yuba,115,75493,5663,5612,93,5705,42
2021-03-17,Alameda,001,1643700,82905,82353,1773,84126,1185
2021-03-17,Alpine,003,1148,83,82,0,82,0
2021-03-17,Amador,005,37829,3526,3511,32,3543,44
2021-03-17,Butte,007,227075,11576,11170,1646,12816,185
2021-03-17,Calaveras,009,45235,1972,1946,11,1957,49
2021-03-17,Colusa,011,21464,1884,1882,272,2154,12
2021-03-17,Contra Costa,013,1133247,64949,64026,1117,65143,737
2021-03-17,Del Norte,015,27424,1116,1053,5,1058,6
2021-03-17,El Dorado,017,186661,9340,9252,616,9868,105
2021-03-17,Fresno,019,978130,98826,97727,8103,105830,1507
2021-03-17,Glenn,021,27897,2313,2269,517,2786,17
2021-03-17,Humboldt,023,135768,3390,3365,24,3389,33
2021-03-17,Imperial,025,180216,27465,27168,2563,29731,691
2021-03-17,Inyo,027,18085,1361,1351,10,1361,35
2021-03-17,Kern,029,883053,94844,93392,10209,103601,1149
2021-03-17,Kings,031,150075,22682,22336,1015,23351,233
2021-03-17,Lake,033,64148,3311,3251,8,3259,43
2021-03-17,Lassen,035,31185,5137,5125,101,5226,1
2021-03-17,Los Angeles,037,10098052,1183629,1173416,39662,1213078,22602
2021-03-17,Madera,039,155013,15992,15835,876,16711,214
2021-03-17,Marin,041,260295,13520,13428,185,13613,218
2021-03-17,Mariposa,043,17540,387,379,5,384,5
2021-03-17,Mendocino,045,87422,3723,3625,74,3699,44
2021-03-17,Merced,047,269075,29388,29250,967,30217,408
2021-03-17,Modoc,049,8938,350,341,119,460,3
2021-03-17,Mono,051,14174,1210,1212,16,1228,3
2021-03-17,Monterey,053,433212,42359,42061,1747,43808,334
2021-03-17,Napa,055,140530,9262,9219,34,9253,76
2021-03-17,Nevada,057,99092,4193,4145,172,4317,74
2021-03-17,Orange,059,3164182,249904,247943,10586,258529,4502
2021-03-17,Placer,061,380077,21241,20369,1191,21560,243
2021-03-17,Plumas,063,18699,661,645,10,655,4
2021-03-17,Riverside,065,2383286,288436,281649,13631,295280,3925
2021-03-17,Sacramento,067,1510023,97260,95650,1352,97002,1477
2021-03-17,San Benito,069,59416,5827,5841,92,5933,61
2021-03-17,San Bernardino,071,2135413,288312,284170,8682,292852,4049
2021-03-17,San Diego,073,3302833,268672,266313,13283,279596,3470
2021-03-17,San Francisco,075,870044,34870,34873,1164,36037,457
2021-03-17,San Joaquin,077,732212,68777,67093,2986,70079,1164
2021-03-17,San Luis Obispo,079,281455,20227,19858,604,20462,249
2021-03-17,San Mateo,081,765935,40332,39838,428,40266,344
2021-03-17,Santa Barbara,083,443738,33009,32585,1086,33671,433
2021-03-17,Santa Clara,085,1922200,112966,112983,635,113618,1805
2021-03-17,Santa Cruz,087,273765,15707,14967,798,15765,199
2021-03-17,Shasta,089,179085,11164,11045,1321,12366,100
2021-03-17,Sierra,091,2930,54,49,12,61,0
2021-03-17,Siskiyou,093,43540,1555,1479,252,1731,5
2021-03-17,Solano,095,438530,30459,30320,392,30712,171
2021-03-17,Sonoma,097,501317,28793,28877,246,29123,292
2021-03-17,Stanislaus,099,539301,52256,51524,5534,57058,682
2021-03-17,Sutter,101,95872,9006,8982,82,9064,103
2021-03-17,Tehama,103,63373,4715,4670,504,5174,34
2021-03-17,Trinity,105,12862,472,308,84,392,3
2021-03-17,Tulare,107,460477,49058,47929,8442,56371,805
2021-03-17,Tuolumne,109,53932,3893,3938,37,3975,57
2021-03-17,Ventura,111,848112,79340,78648,2849,81497,916
2021-03-17,Yolo,113,214977,13215,13169,241,13410,190
2021-03-17,Yuba,115,75493,5660,5603,93,5696,42
2021-03-16,Alameda,001,1643700,82793,82259,1771,84030,1177
2021-03-16,Alpine,003,1148,83,82,0,82,0
2021-03-16,Amador,005,37829,3524,3510,32,3542,44
2021-03-16,Butte,007,227075,11564,11154,1645,12799,184
2021-03-16,Calaveras,009,45235,1967,1945,11,1956,49
2021-03-16,Colusa,011,21464,1883,1882,272,2154,12
2021-03-16,Contra Costa,013,1133247,64866,63951,1114,65065,736
2021-03-16,Del Norte,015,27424,1108,1048,5,1053,6
2021-03-16,El Dorado,017,186661,9325,9249,616,9865,105
2021-03-16,Fresno,019,978130,98688,97638,8082,105720,1498
2021-03-16,Glenn,021,27897,2305,2267,513,2780,17
2021-03-16,Humboldt,023,135768,3386,3351,24,3375,33
2021-03-16,Imperial,025,180216,27454,27143,2560,29703,689
2021-03-16,Inyo,027,18085,1360,1346,10,1356,35
2021-03-16,Kern,029,883053,94778,93340,10194,103534,1144
2021-03-16,Kings,031,150075,22646,22320,1014,23334,233
2021-03-16,Lake,033,64148,3303,3246,8,3254,43
2021-03-16,Lassen,035,31185,5136,5126,101,5227,1
2021-03-16,Los Angeles,037,10098052,1183096,1172676,39624,1212300,22527
2021-03-16,Madera,039,155013,15976,15822,874,16696,214
2021-03-16,Marin,041,260295,13502,13419,185,13604,218
2021-03-16,Mariposa,043,17540,384,379,5,384,5
2021-03-16,Mendocino,045,87422,3718,3623,74,3697,44
2021-03-16,Merced,047,269075,29335,29198,966,30164,407
2021-03-16,Modoc,049,8938,350,341,119,460,3
2021-03-16,Mono,051,14174,1209,1207,16,1223,3
2021-03-16,Monterey,053,433212,42340,42023,1747,43770,334
2021-03-16,Napa,055,140530,9252,9209,34,9243,75
2021-03-16,Nevada,057,99092,4184,4132,171,4303,67
2021-03-16,Orange,059,3164182,249765,247843,10567,258410,4479
2021-03-16,Placer,061,380077,21209,20339,1187,21526,240
2021-03-16,Plumas,063,18699,660,643,10,653,4
2021-03-16,Riverside,065,2383286,288322,281540,13618,295158,3893
2021-03-16,Sacramento,067,1510023,97117,95522,1348,96870,1466
2021-03-16,San Benito,069,59416,5822,5831,92,5923,61
2021-03-16,San Bernardino,071,2135413,288182,283980,8675,292655,4032
2021-03-16,San Diego,073,3302833,268440,265903,13270,279173,3462
2021-03-16,San Francisco,075,870044,34841,34833,1159,35992,456
2021-03-16,San Joaquin,077,732212,68675,66856,2973,69829,1163
2021-03-16,San Luis Obispo,079,281455,20197,19832,602,20434,248
2021-03-16,San Mateo,081,765935,40298,39806,426,40232,344
2021-03-16,Santa Barbara,083,443738,32977,32556,1085,33641,433
2021-03-16,Santa Clara,085,1922200,112848,112845,632,113477,1797
2021-03-16,Santa Cruz,087,273765,15701,14926,798,15724,199
2021-03-16,Shasta,089,179085,11148,11035,1318,12353,100
2021-03-16,Sierra,091,2930,53,49,12,61,0
2021-03-16,Siskiyou,093,43540,1552,1477,252,1729,5
2021-03-16,Solano,095,438530,30425,30298,390,30688,171
2021-03-16,Sonoma,097,501317,28760,28850,244,29094,291
2021-03-16,Stanislaus,099,539301,52176,51410,5527,56937,683
2021-03-16,Sutter,101,95872,8998,8970,82,9052,102
2021-03-16,Tehama,103,63373,4712,4660,503,5163,34
2021-03-16,Trinity,105,12862,472,308,83,391,3
2021-03-16,Tulare,107,460477,49010,47895,8434,56329,803
2021-03-16,Tuolumne,109,53932,3890,3938,37,3975,57
2021-03-16,Ventura,111,848112,79274,78671,2842,81513,916
2021-03-16,Yolo,113,214977,13200,13162,241,13403,190
2021-03-16,Yuba,115,75493,5657,5596,92,5688,42
2021-03-15,Alameda,001,1643700,82704,82159,1771,83930,1167
2021-03-15,Alpine,003,1148,83,82,0,82,0
2021-03-15,Amador,005,37829,3523,3506,32,3538,44
2021-03-15,Butte,007,227075,11551,11141,1641,12782,185
2021-03-15,Calaveras,009,45235,1966,1941,11,1952,49
2021-03-15,Colusa,011,21464,1883,1883,272,2155,12
2021-03-15,Contra Costa,013,1133247,64804,63847,1113,64960,732
2021-03-15,Del Norte,015,27424,1105,1048,5,1053,6
2021-03-15,El Dorado,017,186661,9319,9235,615,9850,103
2021-03-15,Fresno,019,978130,98561,97520,8067,105587,1496
2021-03-15,Glenn,021,27897,2300,2261,510,2771,15
2021-03-15,Humboldt,023,135768,3380,3337,24,3361,32
2021-03-15,Imperial,025,180216,27434,27122,2557,29679,684
2021-03-15,Inyo,027,18085,1360,1346,10,1356,35
2021-03-15,Kern,029,883053,94718,93266,10187,103453,1141
2021-03-15,Kings,031,150075,22629,22294,1008,23302,233
2021-03-15,Lake,033,64148,3291,3237,8,3245,43
2021-03-15,Lassen,035,31185,5136,5125,101,5226,1
2021-03-15,Los Angeles,037,10098052,1182524,1172445,39592,1212037,22477
2021-03-15,Madera,039,155013,15965,15806,872,16678,214
2021-03-15,Marin,041,260295,13496,13408,184,13592,218
2021-03-15,Mariposa,043,17540,384,376,5,381,5
2021-03-15,Mendocino,045,87422,3714,3615,74,3689,44
2021-03-15,Merced,047,269075,29297,29169,964,30133,407
2021-03-15,Modoc,049,8938,350,340,119,459,3
2021-03-15,Mono,051,14174,1208,1206,16,1222,3
2021-03-15,Monterey,053,433212,42312,42011,1744,43755,333
2021-03-15,Napa,055,140530,9241,9196,34,9230,75
2021-03-15,Nevada,057,99092,4179,4123,170,4293,66
2021-03-15,Orange,059,3164182,249652,247697,10547,258244,4481
2021-03-15,Placer,061,380077,21186,20308,1187,21495,238
2021-03-15,Plumas,063,18699,660,642,10,652,4
2021-03-15,Riverside,065,2383286,288170,281367,13608,294975,3856
2021-03-15,Sacramento,067,1510023,96964,95414,1342,96756,1463
2021-03-15,San Benito,069,59416,5819,5831,92,5923,61
2021-03-15,San Bernardino,071,2135413,288090,283815,8667,292482,4004
2021-03-15,San Diego,073,3302833,268191,265646,13254,278900,3452
2021-03-15,San Francisco,075,870044,34806,34820,1155,35975,456
2021-03-15,San Joaquin,077,732212,68571,66622,2960,69582,1140
2021-03-15,San Luis Obispo,079,281455,20166,19813,598,20411,247
2021-03-15,San Mateo,081,765935,40244,39765,426,40191,344
2021-03-15,Santa Barbara,083,443738,32954,32529,1082,33611,431
2021-03-15,Santa Clara,085,1922200,112747,112729,630,113359,1798
2021-03-15,Santa Cruz,087,273765,15695,14899,796,15695,200
2021-03-15,Shasta,089,179085,11132,11019,1313,12332,92
2021-03-15,Sierra,091,2930,53,49,12,61,0
2021-03-15,Siskiyou,093,43540,1552,1475,252,1727,5
2021-03-15,Solano,095,438530,30396,30258,389,30647,171
2021-03-15,Sonoma,097,501317,28742,28814,241,29055,285
2021-03-15,Stanislaus,099,539301,52098,51357,5520,56877,683
2021-03-15,Sutter,101,95872,8992,8962,82,9044,102
2021-03-15,Tehama,103,63373,4697,4650,502,5152,34
2021-03-15,Trinity,105,12862,472,308,83,391,3
2021-03-15,Tulare,107,460477,48980,47857,8419,56276,800
2021-03-15,Tuolumne,109,53932,3888,3937,36,3973,57
2021-03-15,Ventura,111,848112,79218,78626,2841,81467,910
2021-03-15,Yolo,113,214977,13181,13131,239,13370,190
2021-03-15,Yuba,115,75493,5652,5585,91,5676,42
2021-03-14,Alameda,001,1643700,82621,82116,1768,83884,1168
2021-03-14,Alpine,003,1148,83,82,0,82,0
2021-03-14,Amador,005,37829,3518,3504,32,3536,44
2021-03-14,Butte,007,227075,11538,11140,1637,12777,185
2021-03-14,Calaveras,009,45235,1962,1939,11,1950,49
2021-03-14,Colusa,011,21464,1883,1883,272,2155,12
2021-03-14,Contra Costa,013,1133247,64700,63808,1112,64920,731
2021-03-14,Del Norte,015,27424,1091,1048,5,1053,6
2021-03-14,El Dorado,017,186661,9309,9231,615,9846,103
2021-03-14,Fresno,019,978130,98453,97461,8049,105510,1496
2021-03-14,Glenn,021,27897,2295,2260,507,2767,15
2021-03-14,Humboldt,023,135768,3366,3335,24,3359,32
2021-03-14,Imperial,025,180216,27419,27122,2552,29674,685
2021-03-14,Inyo,027,18085,1356,1346,10,1356,35
2021-03-14,Kern,029,883053,94635,93252,10169,103421,1141
2021-03-14,Kings,031,150075,22610,22292,1006,23298,232
2021-03-14,Lake,033,64148,3286,3237,8,3245,43
2021-03-14,Lassen,035,31185,5134,5125,101,5226,1
2021-03-14,Los Angeles,037,10098052,1181953,1172100,39558,1211658,22476
2021-03-14,Madera,039,155013,15940,15804,872,16676,214
2021-03-14,Marin,041,260295,13480,13405,182,13587,218
2021-03-14,Mariposa,043,17540,382,376,5,381,5
2021-03-14,Mendocino,045,87422,3709,3613,74,3687,44
2021-03-14,Merced,047,269075,29229,29149,960,30109,407
2021-03-14,Modoc,049,8938,350,340,119,459,3
2021-03-14,Mono,051,14174,1202,1206,16,1222,3
2021-03-14,Monterey,053,433212,42288,42007,1741,43748,333
2021-03-14,Napa,055,140530,9223,9194,34,9228,75
2021-03-14,Nevada,057,99092,4173,4122,168,4290,66
2021-03-14,Orange,059,3164182,249518,247656,10527,258183,4460
2021-03-14,Placer,061,380077,21151,20288,1179,21467,238
2021-03-14,Plumas,063,18699,658,642,10,652,4
2021-03-14,Riverside,065,2383286,288012,281332,13600,294932,3845
2021-03-14,Sacramento,067,1510023,96786,95343,1337,96680,1462
2021-03-14,San Benito,069,59416,5810,5829,92,5921,61
2021-03-14,San Bernardino,071,2135413,287967,283791,8656,292447,3996
2021-03-14,San Diego,073,3302833,267956,265468,13241,278709,3452
2021-03-14,San Francisco,075,870044,34767,34810,1152,35962,455
2021-03-14,San Joaquin,077,732212,68443,66563,2943,69506,1140
2021-03-14,San Luis Obispo,079,281455,20137,19806,596,20402,247
2021-03-14,San Mateo,081,765935,40205,39744,426,40170,342
2021-03-14,Santa Barbara,083,443738,32910,32514,1080,33594,431
2021-03-14,Santa Clara,085,1922200,112619,112648,629,113277,1796
2021-03-14,Santa Cruz,087,273765,15678,14887,794,15681,200
2021-03-14,Shasta,089,179085,11116,11019,1306,12325,92
2021-03-14,Sierra,091,2930,53,49,12,61,0
2021-03-14,Siskiyou,093,43540,1549,1473,252,1725,5
2021-03-14,Solano,095,438530,30364,30230,384,30614,171
2021-03-14,Sonoma,097,501317,28707,28798,237,29035,284
2021-03-14,Stanislaus,099,539301,51978,51306,5512,56818,690
2021-03-14,Sutter,101,95872,8976,8958,82,9040,102
2021-03-14,Tehama,103,63373,4690,4650,501,5151,34
2021-03-14,Trinity,105,12862,471,308,82,390,3
2021-03-14,Tulare,107,460477,48947,47845,8398,56243,800
2021-03-14,Tuolumne,109,53932,3886,3937,36,3973,57
2021-03-14,Ventura,111,848112,79170,78611,2835,81446,910
2021-03-14,Yolo,113,214977,13158,13128,236,13364,189
2021-03-14,Yuba,115,75493,5642,5583,91,5674,42
2021-03-13,Alameda,001,1643700,82561,82010,1768,83778,1168
2021-03-13,Alpine,003,1148,83,82,0,82,0
2021-03-13,Amador,005,37829,3515,3504,32,3536,44
2021-03-13,Butte,007,227075,11529,11131,1636,12767,185
2021-03-13,Calaveras,009,45235,1961,1939,11,1950,49
2021-03-13,Colusa,011,21464,1883,1882,272,2154,12
2021-03-13,Contra Costa,013,1133247,64639,63689,1112,64801,731
2021-03-13,Del Norte,015,27424,1087,1041,5,1046,6
2021-03-13,El Dorado,017,186661,9301,9221,615,9836,103
2021-03-13,Fresno,019,978130,98394,97324,8029,105353,1495
2021-03-13,Glenn,021,27897,2294,2260,506,2766,15
2021-03-13,Humboldt,023,135768,3359,3325,24,3349,32
2021-03-13,Imperial,025,180216,27413,27099,2548,29647,677
2021-03-13,Inyo,027,18085,1355,1344,10,1354,35
2021-03-13,Kern,029,883053,94596,93197,10163,103360,1140
2021-03-13,Kings,031,150075,22594,22265,1005,23270,232
2021-03-13,Lake,033,64148,3279,3234,7,3241,43
2021-03-13,Lassen,035,31185,5134,5125,101,5226,1
2021-03-13,Los Angeles,037,10098052,1181636,1171505,39516,1211021,22451
2021-03-13,Madera,039,155013,15928,15780,872,16652,214
2021-03-13,Marin,041,260295,13474,13391,180,13571,218
2021-03-13,Mariposa,043,17540,381,376,5,381,5
2021-03-13,Mendocino,045,87422,3705,3611,74,3685,44
2021-03-13,Merced,047,269075,29198,29106,960,30066,406
2021-03-13,Modoc,049,8938,350,340,118,458,3
2021-03-13,Mono,051,14174,1202,1207,16,1223,3
2021-03-13,Monterey,053,433212,42278,41989,1739,43728,332
2021-03-13,Napa,055,140530,9217,9190,34,9224,75
2021-03-13,Nevada,057,99092,4166,4111,167,4278,66
2021-03-13,Orange,059,3164182,249437,247514,10511,258025,4423
2021-03-13,Placer,061,380077,21130,20238,1176,21414,239
2021-03-13,Plumas,063,18699,656,642,10,652,4
2021-03-13,Riverside,065,2383286,287920,281191,13592,294783,3848
2021-03-13,Sacramento,067,1510023,96700,95192,1335,96527,1461
2021-03-13,San Benito,069,59416,5807,5823,92,5915,61
2021-03-13,San Bernardino,071,2135413,287913,283727,8650,292377,3972
2021-03-13,San Diego,073,3302833,267801,265270,13227,278497,3444
2021-03-13,San Francisco,075,870044,34750,34784,1143,35927,455
2021-03-13,San Joaquin,077,732212,68387,66480,2921,69401,1141
2021-03-13,San Luis Obispo,079,281455,20119,19789,595,20384,247
2021-03-13,San Mateo,081,765935,40178,39689,425,40114,341
2021-03-13,Santa Barbara,083,443738,32885,32486,1079,33565,431
2021-03-13,Santa Clara,085,1922200,112534,112531,628,113159,1790
2021-03-13,Santa Cruz,087,273765,15671,14875,794,15669,199
2021-03-13,Shasta,089,179085,11108,11021,1303,12324,108
2021-03-13,Sierra,091,2930,52,49,12,61,0
2021-03-13,Siskiyou,093,43540,1547,1470,252,1722,5
2021-03-13,Solano,095,438530,30347,30198,384,30582,171
2021-03-13,Sonoma,097,501317,28687,28762,233,28995,285
2021-03-13,Stanislaus,099,539301,51927,51257,5507,56764,695
2021-03-13,Sutter,101,95872,8969,8948,82,9030,102
2021-03-13,Tehama,103,63373,4688,4647,501,5148,33
2021-03-13,Trinity,105,12862,471,306,82,388,3
2021-03-13,Tulare,107,460477,48921,47818,8390,56208,798
2021-03-13,Tuolumne,109,53932,3883,3937,36,3973,57
2021-03-13,Ventura,111,848112,79118,78693,2835,81528,906
2021-03-13,Yolo,113,214977,13149,13087,236,13323,189
2021-03-13,Yuba,115,75493,5641,5577,91,5668,42
2021-03-12,Alameda,001,1643700,82484,81898,1767,83665,1164
2021-03-12,Alpine,003,1148,83,82,0,82,0
2021-03-12,Amador,005,37829,3512,3503,32,3535,44
2021-03-12,Butte,007,227075,11519,11126,1634,12760,184
2021-03-12,Calaveras,009,45235,1961,1916,11,1927,49
2021-03-12,Colusa,011,21464,1883,1883,272,2155,12
2021-03-12,Contra Costa,013,1133247,64563,63583,1112,64695,728
2021-03-12,Del Norte,015,27424,1081,1033,5,1038,6
2021-03-12,El Dorado,017,186661,9292,9219,615,9834,103
2021-03-12,Fresno,019,978130,98297,97185,8018,105203,1489
2021-03-12,Glenn,021,27897,2293,2258,505,2763,15
2021-03-12,Humboldt,023,135768,3354,3315,24,3339,32
2021-03-12,Imperial,025,180216,27402,27071,2546,29617,677
2021-03-12,Inyo,027,18085,1353,1339,10,1349,35
2021-03-12,Kern,029,883053,94562,93142,10147,103289,1132
2021-03-12,Kings,031,150075,22575,22233,1005,23238,232
2021-03-12,Lake,033,64148,3273,3226,6,3232,43
2021-03-12,Lassen,035,31185,5134,5125,100,5225,1
2021-03-12,Los Angeles,037,10098052,1181237,1170860,39499,1210359,22409
2021-03-12,Madera,039,155013,15916,15761,869,16630,214
2021-03-12,Marin,041,260295,13467,13375,180,13555,218
2021-03-12,Mariposa,043,17540,379,376,5,381,5
2021-03-12,Mendocino,045,87422,3702,3605,74,3679,43
2021-03-12,Merced,047,269075,29167,29064,960,30024,403
2021-03-12,Modoc,049,8938,350,340,118,458,3
2021-03-12,Mono,051,14174,1201,1206,16,1222,3
2021-03-12,Monterey,053,433212,42264,41964,1734,43698,329
2021-03-12,Napa,055,140530,9208,9180,34,9214,75
2021-03-12,Nevada,057,99092,4156,4101,167,4268,66
2021-03-12,Orange,059,3164182,249344,247388,10500,257888,4401
2021-03-12,Placer,061,380077,21097,20210,1171,21381,239
2021-03-12,Plumas,063,18699,655,641,10,651,4
2021-03-12,Riverside,065,2383286,287821,281037,13584,294621,3854
2021-03-12,Sacramento,067,1510023,96576,95061,1328,96389,1460
2021-03-12,San Benito,069,59416,5804,5817,92,5909,61
2021-03-12,San Bernardino,071,2135413,287857,283558,8645,292203,3917
2021-03-12,San Diego,073,3302833,267638,264886,13219,278105,3434
2021-03-12,San Francisco,075,870044,34729,34758,1140,35898,452
2021-03-12,San Joaquin,077,732212,68316,66482,2912,69394,1144
2021-03-12,San Luis Obispo,079,281455,20106,19769,593,20362,247
2021-03-12,San Mateo,081,765935,40142,39638,423,40061,341
2021-03-12,Santa Barbara,083,443738,32862,32457,1076,33533,429
2021-03-12,Santa Clara,085,1922200,112439,112396,627,113023,1766
2021-03-12,Santa Cruz,087,273765,15659,14846,792,15638,195
2021-03-12,Shasta,089,179085,11099,11143,1301,12444,153
2021-03-12,Sierra,091,2930,52,49,12,61,0
2021-03-12,Siskiyou,093,43540,1547,1468,251,1719,5
2021-03-12,Solano,095,438530,30328,30180,383,30563,171
2021-03-12,Sonoma,097,501317,28660,28714,233,28947,285
2021-03-12,Stanislaus,099,539301,51868,51146,5500,56646,701
2021-03-12,Sutter,101,95872,8963,8940,82,9022,101
2021-03-12,Tehama,103,63373,4684,4638,500,5138,33
2021-03-12,Trinity,105,12862,470,306,81,387,3
2021-03-12,Tulare,107,460477,48896,47772,8384,56156,798
2021-03-12,Tuolumne,109,53932,3882,3936,36,3972,57
2021-03-12,Ventura,111,848112,79072,78698,2831,81529,899
2021-03-12,Yolo,113,214977,13139,13061,229,13290,189
2021-03-12,Yuba,115,75493,5634,5563,90,5653,42
2021-03-11,Alameda,001,1643700,82392,81809,1762,83571,1164
2021-03-11,Alpine,003,1148,83,78,0,78,0
2021-03-11,Amador,005,37829,3511,3498,32,3530,42
2021-03-11,Butte,007,227075,11508,11110,1632,12742,185
2021-03-11,Calaveras,009,45235,1958,1915,11,1926,49
2021-03-11,Colusa,011,21464,1883,1883,272,2155,12
2021-03-11,Contra Costa,013,1133247,64490,63469,1110,64579,728
2021-03-11,Del Norte,015,27424,1076,1027,5,1032,6
2021-03-11,El Dorado,017,186661,9278,9211,615,9826,101
2021-03-11,Fresno,019,978130,98181,97026,7989,105015,1481
2021-03-11,Glenn,021,27897,2290,2255,505,2760,15
2021-03-11,Humboldt,023,135768,3337,3302,24,3326,32
2021-03-11,Imperial,025,180216,27395,27045,2542,29587,675
2021-03-11,Inyo,027,18085,1348,1335,10,1345,35
2021-03-11,Kern,029,883053,94506,93052,10108,103160,1121
2021-03-11,Kings,031,150075,22560,22183,1002,23185,230
2021-03-11,Lake,033,64148,3269,3214,6,3220,42
2021-03-11,Lassen,035,31185,5133,5124,100,5224,1
2021-03-11,Los Angeles,037,10098052,1180705,1170111,39467,1209578,22316
2021-03-11,Madera,039,155013,15905,15725,867,16592,214
2021-03-11,Marin,041,260295,13455,13356,179,13535,217
2021-03-11,Mariposa,043,17540,379,376,5,381,5
2021-03-11,Mendocino,045,87422,3695,3604,74,3678,42
2021-03-11,Merced,047,269075,29119,29001,959,29960,401
2021-03-11,Modoc,049,8938,350,340,118,458,3
2021-03-11,Mono,051,14174,1200,1206,16,1222,3
2021-03-11,Monterey,053,433212,42241,41936,1728,43664,329
2021-03-11,Napa,055,140530,9195,9173,34,9207,75
2021-03-11,Nevada,057,99092,4144,4085,165,4250,66
2021-03-11,Orange,059,3164182,249206,247217,10482,257699,4373
2021-03-11,Placer,061,380077,21055,20178,1167,21345,239
2021-03-11,Plumas,063,18699,654,640,10,650,4
2021-03-11,Riverside,065,2383286,287651,280881,13571,294452,3842
2021-03-11,Sacramento,067,1510023,96435,94912,1325,96237,1455
2021-03-11,San Benito,069,59416,5801,5816,92,5908,61
2021-03-11,San Bernardino,071,2135413,287758,283312,8639,291951,3869
2021-03-11,San Diego,073,3302833,267473,264524,13203,277727,3422
2021-03-11,San Francisco,075,870044,34693,34722,1134,35856,452
2021-03-11,San Joaquin,077,732212,68204,66522,2904,69426,1157
2021-03-11,San Luis Obispo,079,281455,20081,19748,592,20340,247
2021-03-11,San Mateo,081,765935,40105,39590,422,40012,341
2021-03-11,Santa Barbara,083,443738,32834,32408,1071,33479,430
2021-03-11,Santa Clara,085,1922200,112310,112246,624,112870,1765
2021-03-11,Santa Cruz,087,273765,15647,14812,791,15603,193
2021-03-11,Shasta,089,179085,11089,11139,1296,12435,158
2021-03-11,Sierra,091,2930,52,48,12,60,0
2021-03-11,Siskiyou,093,43540,1544,1466,250,1716,5
2021-03-11,Solano,095,438530,30300,30138,382,30520,171
2021-03-11,Sonoma,097,501317,28631,28677,233,28910,285
2021-03-11,Stanislaus,099,539301,51783,51038,5492,56530,707
2021-03-11,Sutter,101,95872,8957,8933,82,9015,101
2021-03-11,Tehama,103,63373,4676,4632,500,5132,33
2021-03-11,Trinity,105,12862,469,304,80,384,3
2021-03-11,Tulare,107,460477,48859,47709,8373,56082,797
2021-03-11,Tuolumne,109,53932,3880,3934,36,3970,57
2021-03-11,Ventura,111,848112,79022,78697,2827,81524,889
2021-03-11,Yolo,113,214977,13121,13041,228,13269,190
2021-03-11,Yuba,115,75493,5630,5553,90,5643,42
2021-03-10,Alameda,001,1643700,82286,81701,1757,83458,1160
2021-03-10,Alpine,003,1148,82,78,0,78,0
2021-03-10,Amador,005,37829,3509,3496,32,3528,42
2021-03-10,Butte,007,227075,11498,11096,1632,12728,185
2021-03-10,Calaveras,009,45235,1952,1913,11,1924,48
2021-03-10,Colusa,011,21464,1883,1882,272,2154,12
2021-03-10,Contra Costa,013,1133247,64390,63372,1106,64478,725
2021-03-10,Del Norte,015,27424,1074,1020,5,1025,5
2021-03-10,El Dorado,017,186661,9265,9203,615,9818,100
2021-03-10,Fresno,019,978130,98074,96866,7973,104839,1471
2021-03-10,Glenn,021,27897,2287,2253,503,2756,15
2021-03-10,Humboldt,023,135768,3327,3296,23,3319,32
2021-03-10,Imperial,025,180216,27380,27051,2542,29593,675
2021-03-10,Inyo,027,18085,1348,1328,10,1338,35
2021-03-10,Kern,029,883053,94440,92965,10087,103052,1102
2021-03-10,Kings,031,150075,22541,22166,1000,23166,226
2021-03-10,Lake,033,64148,3259,3207,6,3213,42
2021-03-10,Lassen,035,31185,5133,5120,100,5220,1
2021-03-10,Los Angeles,037,10098052,1180158,1169079,39440,1208519,22199
2021-03-10,Madera,039,155013,15884,15705,864,16569,212
2021-03-10,Marin,041,260295,13445,13348,178,13526,216
2021-03-10,Mariposa,043,17540,379,376,5,381,5
2021-03-10,Mendocino,045,87422,3690,3602,74,3676,42
2021-03-10,Merced,047,269075,29081,28927,956,29883,401
2021-03-10,Modoc,049,8938,349,338,118,456,3
2021-03-10,Mono,051,14174,1196,1204,16,1220,3
2021-03-10,Monterey,053,433212,42219,41920,1724,43644,329
2021-03-10,Napa,055,140530,9186,9165,34,9199,75
2021-03-10,Nevada,057,99092,4140,4074,165,4239,66
2021-03-10,Orange,059,3164182,249058,247075,10467,257542,4342
2021-03-10,Placer,061,380077,21021,20144,1161,21305,239
2021-03-10,Plumas,063,18699,653,639,10,649,4
2021-03-10,Riverside,065,2383286,287510,280708,13557,294265,3822
2021-03-10,Sacramento,067,1510023,96305,94796,1319,96115,1452
2021-03-10,San Benito,069,59416,5792,5811,92,5903,61
2021-03-10,San Bernardino,071,2135413,287665,283140,8633,291773,3841
2021-03-10,San Diego,073,3302833,267251,264094,13191,277285,3413
2021-03-10,San Francisco,075,870044,34658,34688,1126,35814,450
2021-03-10,San Joaquin,077,732212,68102,66483,2887,69370,1156
2021-03-10,San Luis Obispo,079,281455,20057,19710,588,20298,247
2021-03-10,San Mateo,081,765935,40081,39571,422,39993,338
2021-03-10,Santa Barbara,083,443738,32807,32356,1068,33424,429
2021-03-10,Santa Clara,085,1922200,112201,112103,620,112723,1759
2021-03-10,Santa Cruz,087,273765,15632,14790,790,15580,192
2021-03-10,Shasta,089,179085,11079,11125,1293,12418,155
2021-03-10,Sierra,091,2930,52,48,12,60,0
2021-03-10,Siskiyou,093,43540,1542,1458,250,1708,5
2021-03-10,Solano,095,438530,30270,30111,381,30492,170
2021-03-10,Sonoma,097,501317,28596,28638,232,28870,286
2021-03-10,Stanislaus,099,539301,51696,50968,5473,56441,706
2021-03-10,Sutter,101,95872,8946,8918,82,9000,101
2021-03-10,Tehama,103,63373,4665,4623,499,5122,33
2021-03-10,Trinity,105,12862,469,304,80,384,3
2021-03-10,Tulare,107,460477,48811,47659,8355,56014,793
2021-03-10,Tuolumne,109,53932,3879,3931,36,3967,57
2021-03-10,Ventura,111,848112,78945,78609,2825,81434,878
2021-03-10,Yolo,113,214977,13097,13021,228,13249,189
2021-03-10,Yuba,115,75493,5617,5545,89,5634,42
2021-03-09,Alameda,001,1643700,82201,81618,1757,83375,1151
2021-03-09,Alpine,003,1148,82,78,0,78,0
2021-03-09,Amador,005,37829,3507,3494,32,3526,42
2021-03-09,Butte,007,227075,11485,11092,1631,12723,185
2021-03-09,Calaveras,009,45235,1950,1913,11,1924,48
2021-03-09,Colusa,011,21464,1883,1880,272,2152,11
2021-03-09,Contra Costa,013,1133247,64299,63314,1104,64418,723
2021-03-09,Del Norte,015,27424,1066,1017,5,1022,5
2021-03-09,El Dorado,017,186661,9257,9198,615,9813,98
2021-03-09,Fresno,019,978130,97955,96744,7946,104690,1463
2021-03-09,Glenn,021,27897,2283,2251,501,2752,15
2021-03-09,Humboldt,023,135768,3315,3288,22,3310,32
2021-03-09,Imperial,025,180216,27370,27045,2538,29583,675
2021-03-09,Inyo,027,18085,1346,1324,10,1334,35
2021-03-09,Kern,029,883053,94361,92924,10069,102993,1088
2021-03-09,Kings,031,150075,22516,22143,998,23141,226
2021-03-09,Lake,033,64148,3253,3202,6,3208,42
2021-03-09,Lassen,035,31185,5133,5120,100,5220,1
2021-03-09,Los Angeles,037,10098052,1179560,1167967,39406,1207373,22080
2021-03-09,Madera,039,155013,15873,15701,862,16563,211
2021-03-09,Marin,041,260295,13427,13335,176,13511,214
2021-03-09,Mariposa,043,17540,379,376,5,381,5
2021-03-09,Mendocino,045,87422,3686,3595,74,3669,42
2021-03-09,Merced,047,269075,29021,28876,953,29829,399
2021-03-09,Modoc,049,8938,349,338,117,455,3
2021-03-09,Mono,051,14174,1195,1203,16,1219,3
2021-03-09,Monterey,053,433212,42200,41894,1716,43610,329
2021-03-09,Napa,055,140530,9172,9155,34,9189,75
2021-03-09,Nevada,057,99092,4132,4062,165,4227,66
2021-03-09,Orange,059,3164182,248916,246989,10447,257436,4310
2021-03-09,Placer,061,380077,20979,20122,1156,21278,239
2021-03-09,Plumas,063,18699,650,639,10,649,4
2021-03-09,Riverside,065,2383286,287375,280562,13553,294115,3821
2021-03-09,Sacramento,067,1510023,96138,94720,1313,96033,1442
2021-03-09,San Benito,069,59416,5788,5800,92,5892,61
2021-03-09,San Bernardino,071,2135413,287551,282971,8627,291598,3823
2021-03-09,San Diego,073,3302833,267019,263745,13170,276915,3405
2021-03-09,San Francisco,075,870044,34627,34654,1122,35776,450
2021-03-09,San Joaquin,077,732212,67974,66383,2877,69260,1150
2021-03-09,San Luis Obispo,079,281455,20039,19672,581,20253,245
2021-03-09,San Mateo,081,765935,40034,39535,420,39955,336
2021-03-09,Santa Barbara,083,443738,32766,32314,1066,33380,428
2021-03-09,Santa Clara,085,1922200,112090,111963,615,112578,1756
2021-03-09,Santa Cruz,087,273765,15610,14764,789,15553,188
2021-03-09,Shasta,089,179085,11072,11113,1288,12401,155
2021-03-09,Sierra,091,2930,52,48,12,60,0
2021-03-09,Siskiyou,093,43540,1538,1447,248,1695,5
2021-03-09,Solano,095,438530,30234,30090,379,30469,169
2021-03-09,Sonoma,097,501317,28546,28601,229,28830,284
2021-03-09,Stanislaus,099,539301,51598,50884,5464,56348,703
2021-03-09,Sutter,101,95872,8933,8914,82,8996,101
2021-03-09,Tehama,103,63373,4660,4620,499,5119,33
2021-03-09,Trinity,105,12862,469,304,80,384,3
2021-03-09,Tulare,107,460477,48784,47637,8334,55971,792
2021-03-09,Tuolumne,109,53932,3877,3929,36,3965,56
2021-03-09,Ventura,111,848112,78882,78526,2823,81349,863
2021-03-09,Yolo,113,214977,13085,13015,227,13242,189
2021-03-09,Yuba,115,75493,5610,5539,89,5628,42
2021-03-08,Alameda,001,1643700,82090,81543,1756,83299,1142
2021-03-08,Alpine,003,1148,82,78,0,78,0
2021-03-08,Amador,005,37829,3504,3490,32,3522,42
2021-03-08,Butte,007,227075,11472,11082,1630,12712,185
2021-03-08,Calaveras,009,45235,1946,1909,11,1920,48
2021-03-08,Colusa,011,21464,1883,1877,272,2149,11
2021-03-08,Contra Costa,013,1133247,64203,63240,1104,64344,719
2021-03-08,Del Norte,015,27424,1061,1012,5,1017,5
2021-03-08,El Dorado,017,186661,9254,9188,614,9802,97
2021-03-08,Fresno,019,978130,97856,96665,7925,104590,1442
2021-03-08,Glenn,021,27897,2282,2249,501,2750,15
2021-03-08,Humboldt,023,135768,3301,3278,22,3300,31
2021-03-08,Imperial,025,180216,27362,27033,2535,29568,663
2021-03-08,Inyo,027,18085,1344,1320,10,1330,35
2021-03-08,Kern,029,883053,94294,92857,10049,102906,1087
2021-03-08,Kings,031,150075,22495,22130,996,23126,226
2021-03-08,Lake,033,64148,3241,3195,6,3201,42
2021-03-08,Lassen,035,31185,5133,5119,100,5219,1
2021-03-08,Los Angeles,037,10098052,1178942,1163409,39374,1202783,21868
2021-03-08,Madera,039,155013,15863,15691,860,16551,211
2021-03-08,Marin,041,260295,13407,13328,174,13502,214
2021-03-08,Mariposa,043,17540,379,376,5,381,5
2021-03-08,Mendocino,045,87422,3684,3590,73,3663,42
2021-03-08,Merced,047,269075,28961,28841,952,29793,398
2021-03-08,Modoc,049,8938,349,338,117,455,3
2021-03-08,Mono,051,14174,1194,1200,16,1216,3
2021-03-08,Monterey,053,433212,42179,41863,1715,43578,328
2021-03-08,Napa,055,140530,9169,9146,34,9180,75
2021-03-08,Nevada,057,99092,4124,4059,165,4224,66
2021-03-08,Orange,059,3164182,248743,246900,10415,257315,4243
2021-03-08,Placer,061,380077,20944,20102,1145,21247,239
2021-03-08,Plumas,063,18699,649,635,10,645,4
2021-03-08,Riverside,065,2383286,287223,280463,13543,294006,3783
2021-03-08,Sacramento,067,1510023,95968,94654,1308,95962,1438
2021-03-08,San Benito,069,59416,5785,5797,92,5889,61
2021-03-08,San Bernardino,071,2135413,287441,282894,8620,291514,3811
2021-03-08,San Diego,073,3302833,266778,263272,13155,276427,3390
2021-03-08,San Francisco,075,870044,34601,34634,1118,35752,446
2021-03-08,San Joaquin,077,732212,67857,66307,2868,69175,1139
2021-03-08,San Luis Obispo,079,281455,19996,19656,578,20234,245
2021-03-08,San Mateo,081,765935,39985,39492,418,39910,335
2021-03-08,Santa Barbara,083,443738,32734,32293,1066,33359,427
2021-03-08,Santa Clara,085,1922200,111962,111882,613,112495,1756
2021-03-08,Santa Cruz,087,273765,15590,14729,789,15518,188
2021-03-08,Shasta,089,179085,11064,11088,1283,12371,155
2021-03-08,Sierra,091,2930,52,48,12,60,0
2021-03-08,Siskiyou,093,43540,1537,1440,248,1688,5
2021-03-08,Solano,095,438530,30194,30068,377,30445,169
2021-03-08,Sonoma,097,501317,28502,28571,228,28799,284
2021-03-08,Stanislaus,099,539301,51519,50825,5459,56284,690
2021-03-08,Sutter,101,95872,8930,8905,82,8987,100
2021-03-08,Tehama,103,63373,4656,4615,499,5114,33
2021-03-08,Trinity,105,12862,468,302,80,382,3
2021-03-08,Tulare,107,460477,48742,47587,8309,55896,791
2021-03-08,Tuolumne,109,53932,3876,3921,36,3957,56
2021-03-08,Ventura,111,848112,78809,78526,2815,81341,852
2021-03-08,Yolo,113,214977,13062,13000,226,13226,189
2021-03-08,Yuba,115,75493,5600,5530,89,5619,42
2021-03-07,Alameda,001,1643700,81970,81413,1755,83168,1145
2021-03-07,Alpine,003,1148,82,78,0,78,0
2021-03-07,Amador,005,37829,3501,3489,32,3521,42
2021-03-07,Butte,007,227075,11456,11075,1629,12704,185
2021-03-07,Calaveras,009,45235,1942,1906,11,1917,48
2021-03-07,Colusa,011,21464,1883,1876,272,2148,11
2021-03-07,Contra Costa,013,1133247,64104,63148,1102,64250,719
2021-03-07,Del Norte,015,27424,1056,1010,5,1015,5
2021-03-07,El Dorado,017,186661,9251,9184,613,9797,97
2021-03-07,Fresno,019,978130,97678,96549,7903,104452,1442
2021-03-07,Glenn,021,27897,2280,2244,501,2745,15
2021-03-07,Humboldt,023,135768,3291,3274,22,3296,31
2021-03-07,Imperial,025,180216,27353,27019,2533,29552,658
2021-03-07,Inyo,027,18085,1341,1320,10,1330,35
2021-03-07,Kern,029,883053,94207,92746,10019,102765,1086
2021-03-07,Kings,031,150075,22473,22103,996,23099,224
2021-03-07,Lake,033,64148,3235,3192,6,3198,42
2021-03-07,Lassen,035,31185,5132,5119,100,5219,1
2021-03-07,Los Angeles,037,10098052,1178217,1162749,39338,1202087,21857
2021-03-07,Madera,039,155013,15844,15675,860,16535,211
2021-03-07,Marin,041,260295,13399,13313,172,13485,214
2021-03-07,Mariposa,043,17540,378,376,5,381,5
2021-03-07,Mendocino,045,87422,3680,3581,73,3654,42
2021-03-07,Merced,047,269075,28887,28829,948,29777,399
2021-03-07,Modoc,049,8938,349,338,117,455,3
2021-03-07,Mono,051,14174,1192,1199,16,1215,3
2021-03-07,Monterey,053,433212,42158,41858,1712,43570,328
2021-03-07,Napa,055,140530,9159,9137,34,9171,75
2021-03-07,Nevada,057,99092,4110,4052,164,4216,66
2021-03-07,Orange,059,3164182,248551,246771,10387,257158,4218
2021-03-07,Placer,061,380077,20903,20070,1141,21211,239
2021-03-07,Plumas,063,18699,648,635,10,645,4
2021-03-07,Riverside,065,2383286,287074,280379,13534,293913,3779
2021-03-07,Sacramento,067,1510023,95791,94513,1301,95814,1437
2021-03-07,San Benito,069,59416,5778,5795,92,5887,61
2021-03-07,San Bernardino,071,2135413,287290,282860,8615,291475,3810
2021-03-07,San Diego,073,3302833,266497,262965,13131,276096,3390
2021-03-07,San Francisco,075,870044,34567,34594,1113,35707,445
2021-03-07,San Joaquin,077,732212,67721,66252,2854,69106,1139
2021-03-07,San Luis Obispo,079,281455,19959,19614,576,20190,245
2021-03-07,San Mateo,081,765935,39945,39436,415,39851,329
2021-03-07,Santa Barbara,083,443738,32687,32218,1065,33283,425
2021-03-07,Santa Clara,085,1922200,111817,111745,609,112354,1752
2021-03-07,Santa Cruz,087,273765,15568,14715,788,15503,189
2021-03-07,Shasta,089,179085,11051,11083,1275,12358,156
2021-03-07,Sierra,091,2930,51,48,12,60,0
2021-03-07,Siskiyou,093,43540,1536,1435,244,1679,5
2021-03-07,Solano,095,438530,30157,30027,377,30404,169
2021-03-07,Sonoma,097,501317,28453,28533,226,28759,284
2021-03-07,Stanislaus,099,539301,51387,50783,5442,56225,699
2021-03-07,Sutter,101,95872,8920,8900,82,8982,100
2021-03-07,Tehama,103,63373,4649,4614,498,5112,33
2021-03-07,Trinity,105,12862,468,302,80,382,3
2021-03-07,Tulare,107,460477,48683,47569,8278,55847,790
2021-03-07,Tuolumne,109,53932,3875,3922,35,3957,56
2021-03-07,Ventura,111,848112,78717,78487,2813,81300,851
2021-03-07,Yolo,113,214977,13043,12988,226,13214,189
2021-03-07,Yuba,115,75493,5595,5516,89,5605,42
2021-03-06,Alameda,001,1643700,81912,81310,1754,83064,1143
2021-03-06,Alpine,003,1148,82,78,0,78,0
2021-03-06,Amador,005,37829,3497,3487,32,3519,42
2021-03-06,Butte,007,227075,11451,11065,1628,12693,185
2021-03-06,Calaveras,009,45235,1938,1904,11,1915,48
2021-03-06,Colusa,011,21464,1881,1874,272,2146,11
2021-03-06,Contra Costa,013,1133247,64043,63040,1098,64138,719
2021-03-06,Del Norte,015,27424,1051,1000,5,1005,5
2021-03-06,El Dorado,017,186661,9247,9166,613,9779,97
2021-03-06,Fresno,019,978130,97583,96366,7892,104258,1440
2021-03-06,Glenn,021,27897,2280,2241,501,2742,15
2021-03-06,Humboldt,023,135768,3281,3260,22,3282,31
2021-03-06,Imperial,025,180216,27348,27009,2528,29537,658
2021-03-06,Inyo,027,18085,1338,1312,10,1322,35
2021-03-06,Kern,029,883053,94161,92684,9999,102683,1082
2021-03-06,Kings,031,150075,22458,22094,996,23090,224
2021-03-06,Lake,033,64148,3233,3189,6,3195,42
2021-03-06,Lassen,035,31185,5132,5119,100,5219,1
2021-03-06,Los Angeles,037,10098052,1177777,1161745,39310,1201055,21843
2021-03-06,Madera,039,155013,15835,15646,858,16504,211
2021-03-06,Marin,041,260295,13390,13289,172,13461,213
2021-03-06,Mariposa,043,17540,378,376,5,381,5
2021-03-06,Mendocino,045,87422,3678,3579,73,3652,42
2021-03-06,Merced,047,269075,28845,28771,948,29719,399
2021-03-06,Modoc,049,8938,348,338,117,455,3
2021-03-06,Mono,051,14174,1191,1198,16,1214,3
2021-03-06,Monterey,053,433212,42153,41838,1709,43547,327
2021-03-06,Napa,055,140530,9151,9129,34,9163,75
2021-03-06,Nevada,057,99092,4104,4044,164,4208,66
2021-03-06,Orange,059,3164182,248458,246634,10373,257007,4165
2021-03-06,Placer,061,380077,20880,20030,1139,21169,239
2021-03-06,Plumas,063,18699,648,634,10,644,4
2021-03-06,Riverside,065,2383286,286981,280225,13526,293751,3781
2021-03-06,Sacramento,067,1510023,95703,94332,1292,95624,1436
2021-03-06,San Benito,069,59416,5773,5793,92,5885,61
2021-03-06,San Bernardino,071,2135413,287206,282737,8613,291350,3791
2021-03-06,San Diego,073,3302833,266310,262778,13114,275892,3385
2021-03-06,San Francisco,075,870044,34536,34560,1109,35669,435
2021-03-06,San Joaquin,077,732212,67647,66162,2844,69006,1138
2021-03-06,San Luis Obispo,079,281455,19939,19592,574,20166,245
2021-03-06,San Mateo,081,765935,39920,39384,415,39799,329
2021-03-06,Santa Barbara,083,443738,32656,32176,1064,33240,424
2021-03-06,Santa Clara,085,1922200,111722,111570,606,112176,1749
2021-03-06,Santa Cruz,087,273765,15557,14701,788,15489,188
2021-03-06,Shasta,089,179085,11042,11076,1273,12349,158
2021-03-06,Sierra,091,2930,51,48,12,60,0
2021-03-06,Siskiyou,093,43540,1534,1432,244,1676,5
2021-03-06,Solano,095,438530,30128,30000,376,30376,169
2021-03-06,Sonoma,097,501317,28430,28484,224,28708,284
2021-03-06,Stanislaus,099,539301,51317,50691,5436,56127,711
2021-03-06,Sutter,101,95872,8914,8887,82,8969,100
2021-03-06,Tehama,103,63373,4647,4610,495,5105,33
2021-03-06,Trinity,105,12862,468,302,80,382,3
2021-03-06,Tulare,107,460477,48651,47515,8250,55765,789
2021-03-06,Tuolumne,109,53932,3873,3920,35,3955,56
2021-03-06,Ventura,111,848112,78661,78439,2812,81251,848
2021-03-06,Yolo,113,214977,13037,12951,226,13177,189
2021-03-06,Yuba,115,75493,5586,5504,89,5593,42
2021-03-05,Alameda,001,1643700,81825,81215,1753,82968,1141
2021-03-05,Alpine,003,1148,82,78,0,78,0
2021-03-05,Amador,005,37829,3496,3484,32,3516,42
2021-03-05,Butte,007,227075,11440,11050,1627,12677,185
2021-03-05,Calaveras,009,45235,1935,1902,11,1913,48
2021-03-05,Colusa,011,21464,1881,1874,272,2146,11
2021-03-05,Contra Costa,013,1133247,63963,62886,1095,63981,711
2021-03-05,Del Norte,015,27424,1047,995,5,1000,5
2021-03-05,El Dorado,017,186661,9242,9150,612,9762,97
2021-03-05,Fresno,019,978130,97475,96184,7873,104057,1432
2021-03-05,Glenn,021,27897,2277,2241,500,2741,15
2021-03-05,Humboldt,023,135768,3274,3234,22,3256,31
2021-03-05,Imperial,025,180216,27338,26970,2519,29489,651
2021-03-05,Inyo,027,18085,1334,1309,10,1319,35
2021-03-05,Kern,029,883053,94121,92601,9986,102587,1076
2021-03-05,Kings,031,150075,22440,22063,995,23058,224
2021-03-05,Lake,033,64148,3231,3185,6,3191,42
2021-03-05,Lassen,035,31185,5132,5117,98,5215,1
2021-03-05,Los Angeles,037,10098052,1177285,1160688,39281,1199969,21745
2021-03-05,Madera,039,155013,15825,15624,856,16480,211
2021-03-05,Marin,041,260295,13378,13275,171,13446,215
2021-03-05,Mariposa,043,17540,378,375,5,380,4
2021-03-05,Mendocino,045,87422,3675,3577,73,3650,42
2021-03-05,Merced,047,269075,28812,28734,947,29681,399
2021-03-05,Modoc,049,8938,348,337,117,454,3
2021-03-05,Mono,051,14174,1190,1197,16,1213,3
2021-03-05,Monterey,053,433212,42140,41802,1709,43511,325
2021-03-05,Napa,055,140530,9143,9109,34,9143,75
2021-03-05,Nevada,057,99092,4100,4033,164,4197,66
2021-03-05,Orange,059,3164182,248345,246489,10360,256849,4108
2021-03-05,Placer,061,380077,20854,19973,1135,21108,239
2021-03-05,Plumas,063,18699,648,635,10,645,4
2021-03-05,Riverside,065,2383286,286869,280075,13521,293596,3781
2021-03-05,Sacramento,067,1510023,95607,94182,1285,95467,1430
2021-03-05,San Benito,069,59416,5770,5790,92,5882,61
2021-03-05,San Bernardino,071,2135413,287113,282640,8609,291249,3774
2021-03-05,San Diego,073,3302833,266077,262357,13097,275454,3371
2021-03-05,San Francisco,075,870044,34496,34526,1105,35631,430
2021-03-05,San Joaquin,077,732212,67567,66041,2835,68876,1133
2021-03-05,San Luis Obispo,079,281455,19918,19557,572,20129,244
2021-03-05,San Mateo,081,765935,39888,39305,415,39720,326
2021-03-05,Santa Barbara,083,443738,32619,32139,1059,33198,424
2021-03-05,Santa Clara,085,1922200,111627,111384,606,111990,1745
2021-03-05,Santa Cruz,087,273765,15546,14694,788,15482,188
2021-03-05,Shasta,089,179085,11030,11062,1267,12329,148
2021-03-05,Sierra,091,2930,51,48,12,60,0
2021-03-05,Siskiyou,093,43540,1529,1429,243,1672,5
2021-03-05,Solano,095,438530,30111,29951,374,30325,168
2021-03-05,Sonoma,097,501317,28404,28417,224,28641,279
2021-03-05,Stanislaus,099,539301,51266,50606,5426,56032,721
2021-03-05,Sutter,101,95872,8907,8876,82,8958,100
2021-03-05,Tehama,103,63373,4638,4606,495,5101,33
2021-03-05,Trinity,105,12862,468,302,80,382,3
2021-03-05,Tulare,107,460477,48622,47469,8231,55700,789
2021-03-05,Tuolumne,109,53932,3871,3917,35,3952,56
2021-03-05,Ventura,111,848112,78594,78368,2811,81179,839
2021-03-05,Yolo,113,214977,13025,12920,225,13145,188
2021-03-05,Yuba,115,75493,5574,5496,89,5585,42
2021-03-04,Alameda,001,1643700,81716,81115,1753,82868,1136
2021-03-04,Alpine,003,1148,82,78,0,78,0
2021-03-04,Amador,005,37829,3495,3480,32,3512,42
2021-03-04,Butte,007,227075,11433,11033,1626,12659,185
2021-03-04,Calaveras,009,45235,1934,1896,11,1907,48
2021-03-04,Colusa,011,21464,1879,1873,267,2140,11
2021-03-04,Contra Costa,013,1133247,63863,62789,1093,63882,708
2021-03-04,Del Norte,015,27424,1039,989,5,994,5
2021-03-04,El Dorado,017,186661,9227,9133,612,9745,97
2021-03-04,Fresno,019,978130,97311,96023,7853,103876,1422
2021-03-04,Glenn,021,27897,2270,2236,499,2735,15
2021-03-04,Humboldt,023,135768,3260,3212,22,3234,31
2021-03-04,Imperial,025,180216,27325,26946,2516,29462,646
2021-03-04,Inyo,027,18085,1331,1300,10,1310,35
2021-03-04,Kern,029,883053,94032,92525,9967,102492,1070
2021-03-04,Kings,031,150075,22414,22025,992,23017,224
2021-03-04,Lake,033,64148,3223,3181,6,3187,42
2021-03-04,Lassen,035,31185,5132,5116,98,5214,1
2021-03-04,Los Angeles,037,10098052,1176675,1159405,39232,1198637,21610
2021-03-04,Madera,039,155013,15790,15596,853,16449,208
2021-03-04,Marin,041,260295,13362,13240,168,13408,215
2021-03-04,Mariposa,043,17540,378,376,5,381,4
2021-03-04,Mendocino,045,87422,3672,3569,73,3642,42
2021-03-04,Merced,047,269075,28761,28671,945,29616,396
2021-03-04,Modoc,049,8938,347,336,117,453,3
2021-03-04,Mono,051,14174,1190,1197,16,1213,3
2021-03-04,Monterey,053,433212,42120,41771,1707,43478,325
2021-03-04,Napa,055,140530,9135,9094,34,9128,74
2021-03-04,Nevada,057,99092,4090,4020,164,4184,66
2021-03-04,Orange,059,3164182,248188,246354,10343,256697,4096
2021-03-04,Placer,061,380077,20822,19900,1129,21029,239
2021-03-04,Plumas,063,18699,648,634,10,644,4
2021-03-04,Riverside,065,2383286,286739,279871,13508,293379,3766
2021-03-04,Sacramento,067,1510023,95472,93982,1282,95264,1426
2021-03-04,San Benito,069,59416,5770,5781,92,5873,61
2021-03-04,San Bernardino,071,2135413,286983,282407,8605,291012,3757
2021-03-04,San Diego,073,3302833,265816,261858,13053,274911,3359
2021-03-04,San Francisco,075,870044,34461,34480,1102,35582,426
2021-03-04,San Joaquin,077,732212,67473,65931,2825,68756,1129
2021-03-04,San Luis Obispo,079,281455,19881,19520,570,20090,243
2021-03-04,San Mateo,081,765935,39844,39225,414,39639,322
2021-03-04,Santa Barbara,083,443738,32582,32090,1058,33148,423
2021-03-04,Santa Clara,085,1922200,111493,111194,604,111798,1723
2021-03-04,Santa Cruz,087,273765,15527,14669,788,15457,186
2021-03-04,Shasta,089,179085,11027,11050,1258,12308,150
2021-03-04,Sierra,091,2930,51,48,12,60,0
2021-03-04,Siskiyou,093,43540,1522,1427,243,1670,5
2021-03-04,Solano,095,438530,30084,29905,373,30278,168
2021-03-04,Sonoma,097,501317,28349,28379,223,28602,279
2021-03-04,Stanislaus,099,539301,51179,50521,5418,55939,731
2021-03-04,Sutter,101,95872,8895,8849,82,8931,100
2021-03-04,Tehama,103,63373,4630,4604,495,5099,33
2021-03-04,Trinity,105,12862,468,302,80,382,3
2021-03-04,Tulare,107,460477,48577,47398,8206,55604,784
2021-03-04,Tuolumne,109,53932,3865,3916,35,3951,56
2021-03-04,Ventura,111,848112,78504,78184,2808,80992,831
2021-03-04,Yolo,113,214977,13005,12895,225,13120,189
2021-03-04,Yuba,115,75493,5562,5483,89,5572,41
2021-03-03,Alameda,001,1643700,81595,80972,1752,82724,1127
2021-03-03,Alpine,003,1148,82,77,0,77,0
2021-03-03,Amador,005,37829,3493,3478,31,3509,42
2021-03-03,Butte,007,227075,11425,11014,1625,12639,184
2021-03-03,Calaveras,009,45235,1933,1893,11,1904,48
2021-03-03,Colusa,011,21464,1878,1873,267,2140,11
2021-03-03,Contra Costa,013,1133247,63765,62668,1090,63758,708
2021-03-03,Del Norte,015,27424,1036,988,5,993,5
2021-03-03,El Dorado,017,186661,9217,9121,612,9733,97
2021-03-03,Fresno,019,978130,97167,95893,7835,103728,1415
2021-03-03,Glenn,021,27897,2270,2233,499,2732,15
2021-03-03,Humboldt,023,135768,3249,3196,22,3218,30
2021-03-03,Imperial,025,180216,27309,26939,2512,29451,640
2021-03-03,Inyo,027,18085,1323,1294,10,1304,35
2021-03-03,Kern,029,883053,93956,92434,9950,102384,1063
2021-03-03,Kings,031,150075,22398,22009,991,23000,223
2021-03-03,Lake,033,64148,3216,3175,6,3181,40
2021-03-03,Lassen,035,31185,5132,5115,98,5213,1
2021-03-03,Los Angeles,037,10098052,1176034,1157911,39192,1197103,21500
2021-03-03,Madera,039,155013,15771,15553,847,16400,203
2021-03-03,Marin,041,260295,13348,13216,168,13384,214
2021-03-03,Mariposa,043,17540,377,376,5,381,4
2021-03-03,Mendocino,045,87422,3664,3564,73,3637,42
2021-03-03,Merced,047,269075,28709,28625,945,29570,393
2021-03-03,Modoc,049,8938,347,333,116,449,3
2021-03-03,Mono,051,14174,1190,1191,16,1207,3
2021-03-03,Monterey,053,433212,42088,41731,1704,43435,325
2021-03-03,Napa,055,140530,9127,9090,34,9124,72
2021-03-03,Nevada,057,99092,4080,4009,164,4173,66
2021-03-03,Orange,059,3164182,248043,246120,10327,256447,4072
2021-03-03,Placer,061,380077,20796,19851,1126,20977,239
2021-03-03,Plumas,063,18699,647,631,10,641,4
2021-03-03,Riverside,065,2383286,286606,279626,13502,293128,3735
2021-03-03,Sacramento,067,1510023,95311,93819,1274,95093,1419
2021-03-03,San Benito,069,59416,5769,5774,92,5866,61
2021-03-03,San Bernardino,071,2135413,286842,282138,8599,290737,3664
2021-03-03,San Diego,073,3302833,265552,261350,13022,274372,3342
2021-03-03,San Francisco,075,870044,34429,34443,1099,35542,426
2021-03-03,San Joaquin,077,732212,67360,65855,2818,68673,1115
2021-03-03,San Luis Obispo,079,281455,19855,19479,567,20046,241
2021-03-03,San Mateo,081,765935,39798,39189,413,39602,319
2021-03-03,Santa Barbara,083,443738,32544,32027,1058,33085,421
2021-03-03,Santa Clara,085,1922200,111339,110991,602,111593,1720
2021-03-03,Santa Cruz,087,273765,15516,14645,788,15433,185
2021-03-03,Shasta,089,179085,11017,11023,1251,12274,150
2021-03-03,Sierra,091,2930,51,48,12,60,0
2021-03-03,Siskiyou,093,43540,1520,1424,243,1667,5
2021-03-03,Solano,095,438530,30048,29866,372,30238,167
2021-03-03,Sonoma,097,501317,28310,28307,222,28529,279
2021-03-03,Stanislaus,099,539301,51101,50438,5411,55849,730
2021-03-03,Sutter,101,95872,8887,8840,82,8922,99
2021-03-03,Tehama,103,63373,4628,4601,495,5096,32
2021-03-03,Trinity,105,12862,468,302,80,382,3
2021-03-03,Tulare,107,460477,48526,47348,8175,55523,778
2021-03-03,Tuolumne,109,53932,3863,3914,34,3948,56
2021-03-03,Ventura,111,848112,78420,78057,2803,80860,822
2021-03-03,Yolo,113,214977,12992,12890,225,13115,189
2021-03-03,Yuba,115,75493,5549,5479,89,5568,41
2021-03-02,Alameda,001,1643700,81474,80904,1750,82654,1116
2021-03-02,Alpine,003,1148,82,77,0,77,0
2021-03-02,Amador,005,37829,3491,3474,31,3505,42
2021-03-02,Butte,007,227075,11415,11007,1622,12629,182
2021-03-02,Calaveras,009,45235,1925,1890,11,1901,48
2021-03-02,Colusa,011,21464,1878,1872,266,2138,11
2021-03-02,Contra Costa,013,1133247,63654,62557,1086,63643,694
2021-03-02,Del Norte,015,27424,1029,983,5,988,5
2021-03-02,El Dorado,017,186661,9209,9116,612,9728,98
2021-03-02,Fresno,019,978130,97021,95785,7809,103594,1410
2021-03-02,Glenn,021,27897,2264,2232,498,2730,15
2021-03-02,Humboldt,023,135768,3230,3184,22,3206,30
2021-03-02,Imperial,025,180216,27299,26926,2510,29436,637
2021-03-02,Inyo,027,18085,1319,1292,10,1302,35
2021-03-02,Kern,029,883053,93850,92313,9923,102236,1046
2021-03-02,Kings,031,150075,22346,21999,988,22987,217
2021-03-02,Lake,033,64148,3210,3169,6,3175,40
2021-03-02,Lassen,035,31185,5127,5115,97,5212,1
2021-03-02,Los Angeles,037,10098052,1175399,1156826,39146,1195972,21395
2021-03-02,Madera,039,155013,15751,15523,844,16367,194
2021-03-02,Marin,041,260295,13325,13186,167,13353,214
2021-03-02,Mariposa,043,17540,377,376,5,381,4
2021-03-02,Mendocino,045,87422,3661,3562,72,3634,41
2021-03-02,Merced,047,269075,28652,28598,945,29543,389
2021-03-02,Modoc,049,8938,347,332,116,448,3
2021-03-02,Mono,051,14174,1189,1191,16,1207,3
2021-03-02,Monterey,053,433212,42061,41716,1704,43420,325
2021-03-02,Napa,055,140530,9116,9080,34,9114,71
2021-03-02,Nevada,057,99092,4071,3983,163,4146,66
2021-03-02,Orange,059,3164182,247898,246004,10309,256313,4037
2021-03-02,Placer,061,380077,20743,19828,1123,20951,239
2021-03-02,Plumas,063,18699,644,628,10,638,4
2021-03-02,Riverside,065,2383286,286433,279486,13494,292980,3721
2021-03-02,Sacramento,067,1510023,95144,93690,1273,94963,1411
2021-03-02,San Benito,069,59416,5762,5770,92,5862,60
2021-03-02,San Bernardino,071,2135413,286708,281919,8593,290512,3604
2021-03-02,San Diego,073,3302833,265308,260998,13000,273998,3317
2021-03-02,San Francisco,075,870044,34389,34387,1095,35482,424
2021-03-02,San Joaquin,077,732212,67252,65769,2800,68569,1111
2021-03-02,San Luis Obispo,079,281455,19823,19452,567,20019,241
2021-03-02,San Mateo,081,765935,39746,39148,412,39560,317
2021-03-02,Santa Barbara,083,443738,32495,31964,1054,33018,416
2021-03-02,Santa Clara,085,1922200,111160,110832,601,111433,1706
2021-03-02,Santa Cruz,087,273765,15502,14611,786,15397,185
2021-03-02,Shasta,089,179085,11003,11012,1240,12252,149
2021-03-02,Sierra,091,2930,51,48,12,60,0
2021-03-02,Siskiyou,093,43540,1516,1412,241,1653,5
2021-03-02,Solano,095,438530,30015,29827,370,30197,167
2021-03-02,Sonoma,097,501317,28255,28261,222,28483,279
2021-03-02,Stanislaus,099,539301,51014,50359,5399,55758,724
2021-03-02,Sutter,101,95872,8878,8832,82,8914,99
2021-03-02,Tehama,103,63373,4624,4597,494,5091,32
2021-03-02,Trinity,105,12862,468,301,80,381,3
2021-03-02,Tulare,107,460477,48463,47326,8155,55481,783
2021-03-02,Tuolumne,109,53932,3859,3908,34,3942,53
2021-03-02,Ventura,111,848112,78327,77952,2799,80751,780
2021-03-02,Yolo,113,214977,12976,12867,225,13092,189
2021-03-02,Yuba,115,75493,5541,5475,89,5564,41
2021-03-01,Alameda,001,1643700,81347,80805,1748,82553,1105
2021-03-01,Alpine,003,1148,80,77,0,77,0
2021-03-01,Amador,005,37829,3488,3469,31,3500,42
2021-03-01,Butte,007,227075,11400,10981,1617,12598,180
2021-03-01,Calaveras,009,45235,1920,1885,11,1896,46
2021-03-01,Colusa,011,21464,1877,1871,266,2137,11
2021-03-01,Contra Costa,013,1133247,63545,62458,1085,63543,694
2021-03-01,Del Norte,015,27424,1024,982,5,987,5
2021-03-01,El Dorado,017,186661,9185,9085,612,9697,98
2021-03-01,Fresno,019,978130,96883,95677,7786,103463,1405
2021-03-01,Glenn,021,27897,2259,2232,497,2729,15
2021-03-01,Humboldt,023,135768,3211,3179,22,3201,30
2021-03-01,Imperial,025,180216,27289,26913,2502,29415,636
2021-03-01,Inyo,027,18085,1316,1285,10,1295,35
2021-03-01,Kern,029,883053,93761,92219,9897,102116,1041
2021-03-01,Kings,031,150075,22329,21988,982,22970,217
2021-03-01,Lake,033,64148,3205,3164,6,3170,40
2021-03-01,Lassen,035,31185,5125,5111,97,5208,1
2021-03-01,Los Angeles,037,10098052,1174741,1155984,39104,1195088,21293
2021-03-01,Madera,039,155013,15722,15505,833,16338,194
2021-03-01,Marin,041,260295,13297,13161,166,13327,214
2021-03-01,Mariposa,043,17540,377,375,5,380,4
2021-03-01,Mendocino,045,87422,3654,3561,72,3633,41
2021-03-01,Merced,047,269075,28607,28575,941,29516,385
2021-03-01,Modoc,049,8938,344,331,115,446,3
2021-03-01,Mono,051,14174,1188,1192,16,1208,3
2021-03-01,Monterey,053,433212,42036,41697,1702,43399,324
2021-03-01,Napa,055,140530,9107,9056,34,9090,70
2021-03-01,Nevada,057,99092,4052,3979,163,4142,66
2021-03-01,Orange,059,3164182,247703,245852,10294,256146,3976
2021-03-01,Placer,061,380077,20704,19803,1120,20923,239
2021-03-01,Plumas,063,18699,644,628,10,638,4
2021-03-01,Riverside,065,2383286,286216,279323,13487,292810,3680
2021-03-01,Sacramento,067,1510023,94999,93546,1271,94817,1401
2021-03-01,San Benito,069,59416,5757,5772,92,5864,57
2021-03-01,San Bernardino,071,2135413,286564,281685,8589,290274,3603
2021-03-01,San Diego,073,3302833,264991,260622,12967,273589,3303
2021-03-01,San Francisco,075,870044,34345,34318,1087,35405,424
2021-03-01,San Joaquin,077,732212,67143,65699,2789,68488,1097
2021-03-01,San Luis Obispo,079,281455,19801,19429,565,19994,239
2021-03-01,San Mateo,081,765935,39694,39096,411,39507,314
2021-03-01,Santa Barbara,083,443738,32452,31909,1053,32962,413
2021-03-01,Santa Clara,085,1922200,111001,110684,598,111282,1704
2021-03-01,Santa Cruz,087,273765,15483,14575,785,15360,185
2021-03-01,Shasta,089,179085,10991,10990,1237,12227,149
2021-03-01,Sierra,091,2930,51,48,12,60,0
2021-03-01,Siskiyou,093,43540,1512,1408,239,1647,5
2021-03-01,Solano,095,438530,29972,29779,369,30148,166
2021-03-01,Sonoma,097,501317,28207,28222,220,28442,278
2021-03-01,Stanislaus,099,539301,50938,50293,5393,55686,722
2021-03-01,Sutter,101,95872,8867,8825,82,8907,99
2021-03-01,Tehama,103,63373,4618,4595,494,5089,32
2021-03-01,Trinity,105,12862,468,298,79,377,3
2021-03-01,Tulare,107,460477,48425,47275,8122,55397,781
2021-03-01,Tuolumne,109,53932,3856,3907,34,3941,53
2021-03-01,Ventura,111,848112,78246,77849,2797,80646,775
2021-03-01,Yolo,113,214977,12959,12854,223,13077,188
2021-03-01,Yuba,115,75493,5529,5466,89,5555,41
2021-02-28,Alameda,001,1643700,81226,80727,1746,82473,1105
2021-02-28,Alpine,003,1148,80,77,0,77,0
2021-02-28,Amador,005,37829,3483,3466,30,3496,42
2021-02-28,Butte,007,227075,11385,10970,1617,12587,180
2021-02-28,Calaveras,009,45235,1916,1881,11,1892,46
2021-02-28,Colusa,011,21464,1877,1871,265,2136,11
2021-02-28,Contra Costa,013,1133247,63418,62386,1080,63466,694
2021-02-28,Del Norte,015,27424,1022,981,5,986,5
2021-02-28,El Dorado,017,186661,9174,9082,612,9694,98
2021-02-28,Fresno,019,978130,96701,95548,7752,103300,1405
2021-02-28,Glenn,021,27897,2257,2230,495,2725,15
2021-02-28,Humboldt,023,135768,3188,3179,22,3201,30
2021-02-28,Imperial,025,180216,27263,26909,2498,29407,636
2021-02-28,Inyo,027,18085,1311,1282,10,1292,35
2021-02-28,Kern,029,883053,93646,92169,9876,102045,1012
2021-02-28,Kings,031,150075,22308,21967,981,22948,217
2021-02-28,Lake,033,64148,3200,3164,6,3170,40
2021-02-28,Lassen,035,31185,5124,5106,97,5203,1
2021-02-28,Los Angeles,037,10098052,1173954,1155141,39042,1194183,21261
2021-02-28,Madera,039,155013,15680,15496,830,16326,199
2021-02-28,Marin,041,260295,13274,13152,164,13316,214
2021-02-28,Mariposa,043,17540,377,374,5,379,4
2021-02-28,Mendocino,045,87422,3648,3558,72,3630,41
2021-02-28,Merced,047,269075,28544,28546,940,29486,384
2021-02-28,Modoc,049,8938,344,331,115,446,3
2021-02-28,Mono,051,14174,1185,1192,16,1208,3
2021-02-28,Monterey,053,433212,42004,41683,1700,43383,323
2021-02-28,Napa,055,140530,9088,9053,34,9087,70
2021-02-28,Nevada,057,99092,4039,3972,163,4135,66
2021-02-28,Orange,059,3164182,247505,245706,10287,255993,3970
2021-02-28,Placer,061,380077,20658,19775,1118,20893,239
2021-02-28,Plumas,063,18699,644,628,10,638,4
2021-02-28,Riverside,065,2383286,285983,279214,13476,292690,3661
2021-02-28,Sacramento,067,1510023,94815,93463,1266,94729,1398
2021-02-28,San Benito,069,59416,5746,5772,92,5864,57
2021-02-28,San Bernardino,071,2135413,286423,281620,8577,290197,3595
2021-02-28,San Diego,073,3302833,264694,260353,12933,273286,3303
2021-02-28,San Francisco,075,870044,34303,34291,1081,35372,417
2021-02-28,San Joaquin,077,732212,67035,65662,2780,68442,1097
2021-02-28,San Luis Obispo,079,281455,19765,19422,563,19985,237
2021-02-28,San Mateo,081,765935,39641,39059,410,39469,314
2021-02-28,Santa Barbara,083,443738,32400,31877,1053,32930,413
2021-02-28,Santa Clara,085,1922200,110802,110556,595,111151,1704
2021-02-28,Santa Cruz,087,273765,15454,14571,782,15353,185
2021-02-28,Shasta,089,179085,10970,10990,1233,12223,149
2021-02-28,Sierra,091,2930,51,48,12,60,0
2021-02-28,Siskiyou,093,43540,1504,1408,239,1647,5
2021-02-28,Solano,095,438530,29917,29758,363,30121,166
2021-02-28,Sonoma,097,501317,28144,28193,219,28412,279
2021-02-28,Stanislaus,099,539301,50848,50228,5380,55608,728
2021-02-28,Sutter,101,95872,8852,8825,82,8907,99
2021-02-28,Tehama,103,63373,4613,4590,494,5084,32
2021-02-28,Trinity,105,12862,468,298,79,377,3
2021-02-28,Tulare,107,460477,48363,47258,8091,55349,780
2021-02-28,Tuolumne,109,53932,3851,3905,34,3939,53
2021-02-28,Ventura,111,848112,78134,77749,2794,80543,775
2021-02-28,Yolo,113,214977,12936,12851,223,13074,188
2021-02-28,Yuba,115,75493,5519,5461,89,5550,41
2021-02-27,Alameda,001,1643700,81153,80565,1744,82309,1108
2021-02-27,Alpine,003,1148,80,77,0,77,0
2021-02-27,Amador,005,37829,3481,3463,30,3493,42
2021-02-27,Butte,007,227075,11373,10962,1617,12579,180
2021-02-27,Calaveras,009,45235,1911,1875,11,1886,46
2021-02-27,Colusa,011,21464,1876,1869,265,2134,11
2021-02-27,Contra Costa,013,1133247,63348,62248,1077,63325,693
2021-02-27,Del Norte,015,27424,1020,978,5,983,5
2021-02-27,El Dorado,017,186661,9170,9072,612,9684,98
2021-02-27,Fresno,019,978130,96624,95393,7741,103134,1400
2021-02-27,Glenn,021,27897,2256,2225,494,2719,15
2021-02-27,Humboldt,023,135768,3182,3167,22,3189,30
2021-02-27,Imperial,025,180216,27255,26903,2496,29399,633
2021-02-27,Inyo,027,18085,1308,1275,10,1285,35
2021-02-27,Kern,029,883053,93585,92053,9861,101914,996
2021-02-27,Kings,031,150075,22298,21955,978,22933,216
2021-02-27,Lake,033,64148,3197,3156,6,3162,40
2021-02-27,Lassen,035,31185,5124,5106,97,5203,1
2021-02-27,Los Angeles,037,10098052,1173456,1154275,39015,1193290,21158
2021-02-27,Madera,039,155013,15663,15467,829,16296,199
2021-02-27,Marin,041,260295,13250,13134,164,13298,214
2021-02-27,Mariposa,043,17540,377,374,5,379,4
2021-02-27,Mendocino,045,87422,3645,3555,72,3627,41
2021-02-27,Merced,047,269075,28502,28501,932,29433,384
2021-02-27,Modoc,049,8938,344,331,114,445,3
2021-02-27,Mono,051,14174,1183,1191,16,1207,3
2021-02-27,Monterey,053,433212,41995,41665,1699,43364,322
2021-02-27,Napa,055,140530,9077,9038,34,9072,71
2021-02-27,Nevada,057,99092,4033,3960,163,4123,66
2021-02-27,Orange,059,3164182,247378,245542,10276,255818,3960
2021-02-27,Placer,061,380077,20622,19726,1115,20841,239
2021-02-27,Plumas,063,18699,644,628,10,638,4
2021-02-27,Riverside,065,2383286,285873,279048,13466,292514,3663
2021-02-27,Sacramento,067,1510023,94732,93281,1256,94537,1396
2021-02-27,San Benito,069,59416,5745,5767,91,5858,57
2021-02-27,San Bernardino,071,2135413,286344,281471,8570,290041,3527
2021-02-27,San Diego,073,3302833,264504,260091,12895,272986,3284
2021-02-27,San Francisco,075,870044,34269,34260,1078,35338,413
2021-02-27,San Joaquin,077,732212,66989,65578,2778,68356,1100
2021-02-27,San Luis Obispo,079,281455,19744,19411,562,19973,237
2021-02-27,San Mateo,081,765935,39600,38998,409,39407,313
2021-02-27,Santa Barbara,083,443738,32366,31805,1052,32857,411
2021-02-27,Santa Clara,085,1922200,110654,110361,593,110954,1703
2021-02-27,Santa Cruz,087,273765,15445,14552,781,15333,185
2021-02-27,Shasta,089,179085,10964,10985,1229,12214,149
2021-02-27,Sierra,091,2930,51,48,12,60,0
2021-02-27,Siskiyou,093,43540,1502,1407,238,1645,5
2021-02-27,Solano,095,438530,29889,29718,362,30080,165
2021-02-27,Sonoma,097,501317,28100,28141,213,28354,281
2021-02-27,Stanislaus,099,539301,50793,50147,5370,55517,733
2021-02-27,Sutter,101,95872,8847,8820,82,8902,99
2021-02-27,Tehama,103,63373,4608,4584,493,5077,32
2021-02-27,Trinity,105,12862,468,298,79,377,3
2021-02-27,Tulare,107,460477,48326,47209,8065,55274,770
2021-02-27,Tuolumne,109,53932,3848,3899,34,3933,53
2021-02-27,Ventura,111,848112,78061,77623,2791,80414,771
2021-02-27,Yolo,113,214977,12924,12834,223,13057,188
2021-02-27,Yuba,115,75493,5516,5450,89,5539,39
2021-02-26,Alameda,001,1643700,81058,80387,1739,82126,1106
2021-02-26,Alpine,003,1148,80,77,0,77,0
2021-02-26,Amador,005,37829,3475,3457,30,3487,42
2021-02-26,Butte,007,227075,11363,10941,1617,12558,180
2021-02-26,Calaveras,009,45235,1909,1873,11,1884,46
2021-02-26,Colusa,011,21464,1876,1865,265,2130,11
2021-02-26,Contra Costa,013,1133247,63265,62114,1077,63191,685
2021-02-26,Del Norte,015,27424,1016,968,5,973,5
2021-02-26,El Dorado,017,186661,9165,9038,610,9648,98
2021-02-26,Fresno,019,978130,96522,95202,7733,102935,1391
2021-02-26,Glenn,021,27897,2253,2220,494,2714,15
2021-02-26,Humboldt,023,135768,3176,3152,22,3174,30
2021-02-26,Imperial,025,180216,27248,26888,2494,29382,631
2021-02-26,Inyo,027,18085,1306,1271,10,1281,34
2021-02-26,Kern,029,883053,93506,91884,9845,101729,997
2021-02-26,Kings,031,150075,22282,21917,975,22892,216
2021-02-26,Lake,033,64148,3192,3153,6,3159,40
2021-02-26,Lassen,035,31185,5124,5102,97,5199,1
2021-02-26,Los Angeles,037,10098052,1172878,1153131,38954,1192085,21070
2021-02-26,Madera,039,155013,15647,15436,827,16263,199
2021-02-26,Marin,041,260295,13237,13091,164,13255,214
2021-02-26,Mariposa,043,17540,377,375,5,380,4
2021-02-26,Mendocino,045,87422,3640,3549,72,3621,41
2021-02-26,Merced,047,269075,28468,28455,931,29386,382
2021-02-26,Modoc,049,8938,343,330,114,444,3
2021-02-26,Mono,051,14174,1181,1191,16,1207,3
2021-02-26,Monterey,053,433212,41969,41607,1698,43305,322
2021-02-26,Napa,055,140530,9071,9014,34,9048,70
2021-02-26,Nevada,057,99092,4022,3952,163,4115,66
2021-02-26,Orange,059,3164182,247239,245278,10266,255544,3918
2021-02-26,Placer,061,380077,20596,19712,1109,20821,239
2021-02-26,Plumas,063,18699,644,628,10,638,4
2021-02-26,Riverside,065,2383286,285729,278772,13460,292232,3653
2021-02-26,Sacramento,067,1510023,94609,93180,1253,94433,1390
2021-02-26,San Benito,069,59416,5744,5759,91,5850,57
2021-02-26,San Bernardino,071,2135413,286244,281132,8568,289700,3461
2021-02-26,San Diego,073,3302833,264276,259641,12874,272515,3271
2021-02-26,San Francisco,075,870044,34239,34213,1074,35287,413
2021-02-26,San Joaquin,077,732212,66908,65492,2772,68264,1070
2021-02-26,San Luis Obispo,079,281455,19728,19359,560,19919,234
2021-02-26,San Mateo,081,765935,39554,38922,409,39331,313
2021-02-26,Santa Barbara,083,443738,32322,31724,1051,32775,410
2021-02-26,Santa Clara,085,1922200,110522,110168,591,110759,1700
2021-02-26,Santa Cruz,087,273765,15433,14528,780,15308,185
2021-02-26,Shasta,089,179085,10957,10972,1220,12192,149
2021-02-26,Sierra,091,2930,51,47,12,59,0
2021-02-26,Siskiyou,093,43540,1502,1401,237,1638,5
2021-02-26,Solano,095,438530,29855,29651,361,30012,165
2021-02-26,Sonoma,097,501317,28071,28063,212,28275,280
2021-02-26,Stanislaus,099,539301,50737,50054,5362,55416,737
2021-02-26,Sutter,101,95872,8838,8806,82,8888,99
2021-02-26,Tehama,103,63373,4606,4581,493,5074,32
2021-02-26,Trinity,105,12862,467,298,79,377,3
2021-02-26,Tulare,107,460477,48291,47135,8034,55169,770
2021-02-26,Tuolumne,109,53932,3847,3896,34,3930,53
2021-02-26,Ventura,111,848112,77961,77534,2787,80321,765
2021-02-26,Yolo,113,214977,12917,12816,223,13039,188
2021-02-26,Yuba,115,75493,5511,5438,89,5527,39
2021-02-25,Alameda,001,1643700,80937,80181,1738,81919,1093
2021-02-25,Alpine,003,1148,80,77,0,77,0
2021-02-25,Amador,005,37829,3472,3448,30,3478,41
2021-02-25,Butte,007,227075,11342,10922,1612,12534,178
2021-02-25,Calaveras,009,45235,1901,1868,11,1879,46
2021-02-25,Colusa,011,21464,1873,1863,264,2127,11
2021-02-25,Contra Costa,013,1133247,63163,61910,1077,62987,686
2021-02-25,Del Norte,015,27424,1006,966,5,971,5
2021-02-25,El Dorado,017,186661,9149,9012,610,9622,98
2021-02-25,Fresno,019,978130,96378,95015,7711,102726,1377
2021-02-25,Glenn,021,27897,2250,2219,493,2712,15
2021-02-25,Humboldt,023,135768,3169,3129,22,3151,30
2021-02-25,Imperial,025,180216,27241,26855,2490,29345,628
2021-02-25,Inyo,027,18085,1300,1264,10,1274,33
2021-02-25,Kern,029,883053,93390,91735,9820,101555,992
2021-02-25,Kings,031,150075,22273,21900,972,22872,216
2021-02-25,Lake,033,64148,3183,3141,6,3147,40
2021-02-25,Lassen,035,31185,5123,5097,96,5193,1
2021-02-25,Los Angeles,037,10098052,1172133,1151846,38896,1190742,20931
2021-02-25,Madera,039,155013,15612,15414,823,16237,194
2021-02-25,Marin,041,260295,13214,13067,164,13231,214
2021-02-25,Mariposa,043,17540,377,375,5,380,4
2021-02-25,Mendocino,045,87422,3635,3542,72,3614,41
2021-02-25,Merced,047,269075,28419,28383,929,29312,382
2021-02-25,Modoc,049,8938,343,329,114,443,3
2021-02-25,Mono,051,14174,1180,1190,16,1206,3
2021-02-25,Monterey,053,433212,41944,41564,1693,43257,321
2021-02-25,Napa,055,140530,9045,8998,34,9032,70
2021-02-25,Nevada,057,99092,4005,3940,162,4102,66
2021-02-25,Orange,059,3164182,247066,245000,10256,255256,3882
2021-02-25,Placer,061,380077,20557,19661,1107,20768,239
2021-02-25,Plumas,063,18699,644,626,10,636,4
2021-02-25,Riverside,065,2383286,285541,278544,13439,291983,3646
2021-02-25,Sacramento,067,1510023,94451,92961,1241,94202,1386
2021-02-25,San Benito,069,59416,5739,5752,91,5843,58
2021-02-25,San Bernardino,071,2135413,286109,280946,8560,289506,3409
2021-02-25,San Diego,073,3302833,263982,258979,12844,271823,3260
2021-02-25,San Francisco,075,870044,34196,34138,1071,35209,408
2021-02-25,San Joaquin,077,732212,66824,65389,2760,68149,1047
2021-02-25,San Luis Obispo,079,281455,19707,19335,558,19893,234
2021-02-25,San Mateo,081,765935,39507,38872,409,39281,300
2021-02-25,Santa Barbara,083,443738,32245,31631,1050,32681,408
2021-02-25,Santa Clara,085,1922200,110357,109923,590,110513,1677
2021-02-25,Santa Cruz,087,273765,15414,14492,779,15271,185
2021-02-25,Shasta,089,179085,10945,10947,1215,12162,148
2021-02-25,Sierra,091,2930,51,47,12,59,0
2021-02-25,Siskiyou,093,43540,1497,1390,234,1624,4
2021-02-25,Solano,095,438530,29823,29616,361,29977,161
2021-02-25,Sonoma,097,501317,28017,28004,209,28213,278
2021-02-25,Stanislaus,099,539301,50646,49964,5352,55316,738
2021-02-25,Sutter,101,95872,8824,8789,81,8870,99
2021-02-25,Tehama,103,63373,4603,4578,491,5069,32
2021-02-25,Trinity,105,12862,467,297,79,376,3
2021-02-25,Tulare,107,460477,48241,47052,8008,55060,765
2021-02-25,Tuolumne,109,53932,3844,3894,34,3928,53
2021-02-25,Ventura,111,848112,77853,77395,2781,80176,751
2021-02-25,Yolo,113,214977,12900,12787,223,13010,188
2021-02-25,Yuba,115,75493,5504,5429,89,5518,39
2021-02-24,Alameda,001,1643700,80817,80070,1734,81804,1082
2021-02-24,Alpine,003,1148,79,77,0,77,0
2021-02-24,Amador,005,37829,3467,3444,30,3474,41
2021-02-24,Butte,007,227075,11329,10915,1608,12523,178
2021-02-24,Calaveras,009,45235,1897,1864,11,1875,31
2021-02-24,Colusa,011,21464,1871,1863,264,2127,11
2021-02-24,Contra Costa,013,1133247,63055,61776,1077,62853,663
2021-02-24,Del Norte,015,27424,1005,960,4,964,5
2021-02-24,El Dorado,017,186661,9137,8993,610,9603,98
2021-02-24,Fresno,019,978130,96230,94794,7695,102489,1369
2021-02-24,Glenn,021,27897,2249,2210,493,2703,14
2021-02-24,Humboldt,023,135768,3157,3123,22,3145,29
2021-02-24,Imperial,025,180216,27228,26843,2485,29328,596
2021-02-24,Inyo,027,18085,1295,1253,10,1263,32
2021-02-24,Kern,029,883053,93257,91525,9804,101329,992
2021-02-24,Kings,031,150075,22248,21871,970,22841,216
2021-02-24,Lake,033,64148,3176,3134,6,3140,40
2021-02-24,Lassen,035,31185,5119,5095,95,5190,1
2021-02-24,Los Angeles,037,10098052,1171368,1150322,38855,1189177,20817
2021-02-24,Madera,039,155013,15585,15390,823,16213,194
2021-02-24,Marin,041,260295,13191,13044,163,13207,214
2021-02-24,Mariposa,043,17540,377,374,5,379,4
2021-02-24,Mendocino,045,87422,3628,3540,72,3612,41
2021-02-24,Merced,047,269075,28381,28295,924,29219,383
2021-02-24,Modoc,049,8938,342,329,114,443,3
2021-02-24,Mono,051,14174,1178,1189,16,1205,3
2021-02-24,Monterey,053,433212,41919,41495,1691,43186,320
2021-02-24,Napa,055,140530,9028,8976,33,9009,70
2021-02-24,Nevada,057,99092,3995,3927,162,4089,66
2021-02-24,Orange,059,3164182,246848,244743,10243,254986,3835
2021-02-24,Placer,061,380077,20518,19648,1101,20749,239
2021-02-24,Plumas,063,18699,642,626,10,636,4
2021-02-24,Riverside,065,2383286,285313,278293,13430,291723,3603
2021-02-24,Sacramento,067,1510023,94297,92742,1236,93978,1375
2021-02-24,San Benito,069,59416,5738,5743,91,5834,57
2021-02-24,San Bernardino,071,2135413,285957,280583,8556,289139,3360
2021-02-24,San Diego,073,3302833,263686,258460,12828,271288,3230
2021-02-24,San Francisco,075,870044,34150,34061,1068,35129,406
2021-02-24,San Joaquin,077,732212,66714,65274,2758,68032,1019
2021-02-24,San Luis Obispo,079,281455,19684,19309,556,19865,233
2021-02-24,San Mateo,081,765935,39470,38763,409,39172,300
2021-02-24,Santa Barbara,083,443738,32193,31563,1047,32610,405
2021-02-24,Santa Clara,085,1922200,110209,109671,589,110260,1674
2021-02-24,Santa Cruz,087,273765,15393,14458,779,15237,185
2021-02-24,Shasta,089,179085,10931,10922,1212,12134,148
2021-02-24,Sierra,091,2930,51,47,12,59,0
2021-02-24,Siskiyou,093,43540,1490,1385,230,1615,4
2021-02-24,Solano,095,438530,29783,29577,359,29936,158
2021-02-24,Sonoma,097,501317,27953,27954,205,28159,278
2021-02-24,Stanislaus,099,539301,50575,49851,5344,55195,732
2021-02-24,Sutter,101,95872,8814,8778,81,8859,99
2021-02-24,Tehama,103,63373,4600,4566,491,5057,31
2021-02-24,Trinity,105,12862,467,294,78,372,3
2021-02-24,Tulare,107,460477,48185,46976,7980,54956,759
2021-02-24,Tuolumne,109,53932,3840,3887,34,3921,53
2021-02-24,Ventura,111,848112,77745,77238,2780,80018,718
2021-02-24,Yolo,113,214977,12887,12760,219,12979,188
2021-02-24,Yuba,115,75493,5493,5425,87,5512,39
2021-02-23,Alameda,001,1643700,80679,79948,1732,81680,1070
2021-02-23,Alpine,003,1148,78,77,0,77,0
2021-02-23,Amador,005,37829,3465,3440,30,3470,41
2021-02-23,Butte,007,227075,11313,10887,1605,12492,176
2021-02-23,Calaveras,009,45235,1896,1863,11,1874,21
2021-02-23,Colusa,011,21464,1868,1862,264,2126,11
2021-02-23,Contra Costa,013,1133247,62921,61613,1074,62687,661
2021-02-23,Del Norte,015,27424,1003,953,4,957,3
2021-02-23,El Dorado,017,186661,9124,8969,610,9579,96
2021-02-23,Fresno,019,978130,96069,94741,7681,102422,1356
2021-02-23,Glenn,021,27897,2247,2209,493,2702,14
2021-02-23,Humboldt,023,135768,3140,3108,22,3130,29
2021-02-23,Imperial,025,180216,27208,26816,2480,29296,591
2021-02-23,Inyo,027,18085,1291,1250,10,1260,32
2021-02-23,Kern,029,883053,93118,91390,9775,101165,982
2021-02-23,Kings,031,150075,22233,21839,966,22805,216
2021-02-23,Lake,033,64148,3168,3121,6,3127,40
2021-02-23,Lassen,035,31185,5116,5092,95,5187,1
2021-02-23,Los Angeles,037,10098052,1170495,1148965,38802,1187767,19887
2021-02-23,Madera,039,155013,15571,15352,817,16169,193
2021-02-23,Marin,041,260295,13171,13015,162,13177,214
2021-02-23,Mariposa,043,17540,377,374,5,379,4
2021-02-23,Mendocino,045,87422,3626,3540,71,3611,41
2021-02-23,Merced,047,269075,28301,28209,917,29126,381
2021-02-23,Modoc,049,8938,341,328,113,441,3
2021-02-23,Mono,051,14174,1178,1189,16,1205,3
2021-02-23,Monterey,053,433212,41879,41439,1686,43125,317
2021-02-23,Napa,055,140530,9016,8967,33,9000,70
2021-02-23,Nevada,057,99092,3987,3912,162,4074,66
2021-02-23,Orange,059,3164182,246650,244566,10224,254790,3843
2021-02-23,Placer,061,380077,20493,19608,1097,20705,238
2021-02-23,Plumas,063,18699,641,626,10,636,4
2021-02-23,Riverside,065,2383286,285076,278075,13415,291490,3599
2021-02-23,Sacramento,067,1510023,94140,92632,1230,93862,1370
2021-02-23,San Benito,069,59416,5732,5731,90,5821,57
2021-02-23,San Bernardino,071,2135413,285768,280279,8551,288830,3283
2021-02-23,San Diego,073,3302833,263309,257802,12798,270600,3218
2021-02-23,San Francisco,075,870044,34102,33994,1067,35061,405
2021-02-23,San Joaquin,077,732212,66614,65141,2751,67892,1004
2021-02-23,San Luis Obispo,079,281455,19655,19233,555,19788,230
2021-02-23,San Mateo,081,765935,39409,38662,409,39071,299
2021-02-23,Santa Barbara,083,443738,32138,31483,1045,32528,402
2021-02-23,Santa Clara,085,1922200,110012,109449,586,110035,1661
2021-02-23,Santa Cruz,087,273765,15364,14435,777,15212,178
2021-02-23,Shasta,089,179085,10919,10903,1208,12111,146
2021-02-23,Sierra,091,2930,51,47,12,59,0
2021-02-23,Siskiyou,093,43540,1485,1380,228,1608,4
2021-02-23,Solano,095,438530,29743,29545,356,29901,154
2021-02-23,Sonoma,097,501317,27910,27882,202,28084,278
2021-02-23,Stanislaus,099,539301,50497,49749,5328,55077,722
2021-02-23,Sutter,101,95872,8801,8766,81,8847,98
2021-02-23,Tehama,103,63373,4594,4556,490,5046,30
2021-02-23,Trinity,105,12862,467,292,77,369,3
2021-02-23,Tulare,107,460477,48107,46937,7946,54883,757
2021-02-23,Tuolumne,109,53932,3836,3864,34,3898,53
2021-02-23,Ventura,111,848112,77629,77093,2771,79864,689
2021-02-23,Yolo,113,214977,12858,12729,219,12948,188
2021-02-23,Yuba,115,75493,5480,5417,86,5503,38
2021-02-22,Alameda,001,1643700,80528,79796,1728,81524,1062
2021-02-22,Alpine,003,1148,78,77,0,77,0
2021-02-22,Amador,005,37829,3460,3438,30,3468,39
2021-02-22,Butte,007,227075,11300,10855,1600,12455,176
2021-02-22,Calaveras,009,45235,1894,1862,11,1873,21
2021-02-22,Colusa,011,21464,1868,1860,264,2124,11
2021-02-22,Contra Costa,013,1133247,62792,61478,1073,62551,661
2021-02-22,Del Norte,015,27424,1002,948,4,952,3
2021-02-22,El Dorado,017,186661,9107,8940,610,9550,96
2021-02-22,Fresno,019,978130,95907,94584,7664,102248,1351
2021-02-22,Glenn,021,27897,2242,2207,491,2698,14
2021-02-22,Humboldt,023,135768,3128,3095,22,3117,29
2021-02-22,Imperial,025,180216,27186,26778,2473,29251,590
2021-02-22,Inyo,027,18085,1286,1248,10,1258,32
2021-02-22,Kern,029,883053,93001,91201,9753,100954,982
2021-02-22,Kings,031,150075,22210,21801,963,22764,214
2021-02-22,Lake,033,64148,3162,3107,6,3113,40
2021-02-22,Lassen,035,31185,5116,5088,94,5182,1
2021-02-22,Los Angeles,037,10098052,1169623,1147541,38744,1186285,19730
2021-02-22,Madera,039,155013,15546,15325,813,16138,193
2021-02-22,Marin,041,260295,13146,12991,159,13150,213
2021-02-22,Mariposa,043,17540,376,374,5,379,4
2021-02-22,Mendocino,045,87422,3620,3535,71,3606,41
2021-02-22,Merced,047,269075,28238,28166,914,29080,379
2021-02-22,Modoc,049,8938,341,329,113,442,3
2021-02-22,Mono,051,14174,1174,1189,16,1205,3
2021-02-22,Monterey,053,433212,41834,41397,1680,43077,311
2021-02-22,Napa,055,140530,8989,8950,33,8983,69
2021-02-22,Nevada,057,99092,3978,3900,160,4060,66
2021-02-22,Orange,059,3164182,246414,244118,10206,254324,3843
2021-02-22,Placer,061,380077,20456,19587,1089,20676,238
2021-02-22,Plumas,063,18699,641,625,10,635,4
2021-02-22,Riverside,065,2383286,284813,277730,13407,291137,3567
2021-02-22,Sacramento,067,1510023,93973,92476,1219,93695,1359
2021-02-22,San Benito,069,59416,5730,5723,90,5813,57
2021-02-22,San Bernardino,071,2135413,285588,279984,8538,288522,3259
2021-02-22,San Diego,073,3302833,262899,257348,12765,270113,3189
2021-02-22,San Francisco,075,870044,34042,33947,1062,35009,405
2021-02-22,San Joaquin,077,732212,66518,65060,2738,67798,1001
2021-02-22,San Luis Obispo,079,281455,19618,19198,553,19751,229
2021-02-22,San Mateo,081,765935,39352,38542,406,38948,282
2021-02-22,Santa Barbara,083,443738,32072,31421,1042,32463,399
2021-02-22,Santa Clara,085,1922200,109803,109213,575,109788,1655
2021-02-22,Santa Cruz,087,273765,15338,14417,777,15194,176
2021-02-22,Shasta,089,179085,10904,10872,1203,12075,145
2021-02-22,Sierra,091,2930,51,47,12,59,0
2021-02-22,Siskiyou,093,43540,1479,1373,227,1600,4
2021-02-22,Solano,095,438530,29704,29508,355,29863,150
2021-02-22,Sonoma,097,501317,27865,27845,201,28046,278
2021-02-22,Stanislaus,099,539301,50395,49630,5310,54940,722
2021-02-22,Sutter,101,95872,8793,8698,81,8779,98
2021-02-22,Tehama,103,63373,4591,4550,489,5039,30
2021-02-22,Trinity,105,12862,467,287,76,363,3
2021-02-22,Tulare,107,460477,48045,46879,7914,54793,751
2021-02-22,Tuolumne,109,53932,3832,3856,34,3890,53
2021-02-22,Ventura,111,848112,77501,76947,2766,79713,677
2021-02-22,Yolo,113,214977,12831,12689,219,12908,183
2021-02-22,Yuba,115,75493,5477,5404,85,5489,38
2021-02-21,Alameda,001,1643700,80336,79649,1723,81372,1061
2021-02-21,Alpine,003,1148,78,77,0,77,0
2021-02-21,Amador,005,37829,3452,3435,30,3465,39
2021-02-21,Butte,007,227075,11282,10855,1598,12453,176
2021-02-21,Calaveras,009,45235,1893,1860,11,1871,21
2021-02-21,Colusa,011,21464,1867,1860,260,2120,11
2021-02-21,Contra Costa,013,1133247,62637,61364,1070,62434,661
2021-02-21,Del Norte,015,27424,996,942,4,946,3
2021-02-21,El Dorado,017,186661,9089,8927,609,9536,96
2021-02-21,Fresno,019,978130,95765,94374,7647,102021,1349
2021-02-21,Glenn,021,27897,2240,2201,489,2690,14
2021-02-21,Humboldt,023,135768,3116,3096,22,3118,29
2021-02-21,Imperial,025,180216,27172,26779,2471,29250,590
2021-02-21,Inyo,027,18085,1280,1232,10,1242,32
2021-02-21,Kern,029,883053,92876,91141,9715,100856,980
2021-02-21,Kings,031,150075,22174,21784,961,22745,213
2021-02-21,Lake,033,64148,3154,3100,6,3106,40
2021-02-21,Lassen,035,31185,5108,5077,94,5171,1
2021-02-21,Los Angeles,037,10098052,1168587,1146756,38696,1185452,19711
2021-02-21,Madera,039,155013,15513,15298,810,16108,192
2021-02-21,Marin,041,260295,13117,12968,159,13127,212
2021-02-21,Mariposa,043,17540,376,373,5,378,4
2021-02-21,Mendocino,045,87422,3615,3535,71,3606,41
2021-02-21,Merced,047,269075,28164,28106,898,29004,379
2021-02-21,Modoc,049,8938,338,329,113,442,3
2021-02-21,Mono,051,14174,1174,1189,16,1205,3
2021-02-21,Monterey,053,433212,41778,41373,1673,43046,309
2021-02-21,Napa,055,140530,8975,8929,33,8962,69
2021-02-21,Nevada,057,99092,3965,3895,160,4055,66
2021-02-21,Orange,059,3164182,246117,243985,10189,254174,3801
2021-02-21,Placer,061,380077,20420,19553,1085,20638,238
2021-02-21,Plumas,063,18699,641,625,10,635,4
2021-02-21,Riverside,065,2383286,284579,277555,13394,290949,3564
2021-02-21,Sacramento,067,1510023,93763,92288,1207,93495,1354
2021-02-21,San Benito,069,59416,5720,5716,87,5803,57
2021-02-21,San Bernardino,071,2135413,285364,279870,8524,288394,3247
2021-02-21,San Diego,073,3302833,262465,257027,12719,269746,3190
2021-02-21,San Francisco,075,870044,33978,33891,1058,34949,405
2021-02-21,San Joaquin,077,732212,66379,64997,2726,67723,1001
2021-02-21,San Luis Obispo,079,281455,19585,19178,551,19729,229
2021-02-21,San Mateo,081,765935,39290,38448,402,38850,282
2021-02-21,Santa Barbara,083,443738,32010,31374,1039,32413,399
2021-02-21,Santa Clara,085,1922200,109577,108992,566,109558,1654
2021-02-21,Santa Cruz,087,273765,15315,14401,776,15177,176
2021-02-21,Shasta,089,179085,10890,10867,1198,12065,145
2021-02-21,Sierra,091,2930,51,47,12,59,0
2021-02-21,Siskiyou,093,43540,1473,1371,227,1598,4
2021-02-21,Solano,095,438530,29649,29471,354,29825,150
2021-02-21,Sonoma,097,501317,27801,27793,194,27987,278
2021-02-21,Stanislaus,099,539301,50282,49527,5296,54823,726
2021-02-21,Sutter,101,95872,8776,8687,80,8767,97
2021-02-21,Tehama,103,63373,4582,4547,489,5036,30
2021-02-21,Trinity,105,12862,465,286,76,362,3
2021-02-21,Tulare,107,460477,47977,46830,7879,54709,749
2021-02-21,Tuolumne,109,53932,3818,3828,34,3862,53
2021-02-21,Ventura,111,848112,77352,76862,2752,79614,677
2021-02-21,Yolo,113,214977,12800,12670,219,12889,183
2021-02-21,Yuba,115,75493,5469,5396,84,5480,38
2021-02-20,Alameda,001,1643700,80245,79496,1718,81214,1055
2021-02-20,Alpine,003,1148,78,77,0,77,0
2021-02-20,Amador,005,37829,3450,3432,30,3462,39
2021-02-20,Butte,007,227075,11274,10838,1597,12435,176
2021-02-20,Calaveras,009,45235,1892,1858,11,1869,21
2021-02-20,Colusa,011,21464,1866,1858,260,2118,11
2021-02-20,Contra Costa,013,1133247,62553,61205,1068,62273,663
2021-02-20,Del Norte,015,27424,992,937,4,941,3
2021-02-20,El Dorado,017,186661,9079,8911,609,9520,96
2021-02-20,Fresno,019,978130,95681,94234,7627,101861,1341
2021-02-20,Glenn,021,27897,2236,2199,488,2687,14
2021-02-20,Humboldt,023,135768,3108,3073,22,3095,29
2021-02-20,Imperial,025,180216,27162,26771,2471,29242,590
2021-02-20,Inyo,027,18085,1276,1226,10,1236,32
2021-02-20,Kern,029,883053,92805,91025,9683,100708,968
2021-02-20,Kings,031,150075,22156,21773,960,22733,212
2021-02-20,Lake,033,64148,3147,3089,6,3095,40
2021-02-20,Lassen,035,31185,5106,5067,94,5161,1
2021-02-20,Los Angeles,037,10098052,1168020,1145594,38653,1184247,19630
2021-02-20,Madera,039,155013,15493,15274,809,16083,191
2021-02-20,Marin,041,260295,13096,12945,157,13102,211
2021-02-20,Mariposa,043,17540,376,372,5,377,4
2021-02-20,Mendocino,045,87422,3613,3533,71,3604,40
2021-02-20,Merced,047,269075,28121,28066,895,28961,379
2021-02-20,Modoc,049,8938,338,328,113,441,3
2021-02-20,Mono,051,14174,1173,1187,16,1203,3
2021-02-20,Monterey,053,433212,41756,41313,1671,42984,309
2021-02-20,Napa,055,140530,8966,8910,33,8943,69
2021-02-20,Nevada,057,99092,3955,3887,159,4046,66
2021-02-20,Orange,059,3164182,245947,243761,10175,253936,3755
2021-02-20,Placer,061,380077,20379,19509,1081,20590,236
2021-02-20,Plumas,063,18699,641,626,10,636,4
2021-02-20,Riverside,065,2383286,284425,277267,13385,290652,3559
2021-02-20,Sacramento,067,1510023,93640,92057,1205,93262,1352
2021-02-20,San Benito,069,59416,5709,5709,87,5796,57
2021-02-20,San Bernardino,071,2135413,285262,279608,8519,288127,3203
2021-02-20,San Diego,073,3302833,262223,256510,12690,269200,3188
2021-02-20,San Francisco,075,870044,33936,33820,1049,34869,399
2021-02-20,San Joaquin,077,732212,66309,64916,2721,67637,1001
2021-02-20,San Luis Obispo,079,281455,19561,19138,550,19688,229
2021-02-20,San Mateo,081,765935,39246,38371,401,38772,282
2021-02-20,Santa Barbara,083,443738,31976,31289,1038,32327,396
2021-02-20,Santa Clara,085,1922200,109399,108728,563,109291,1649
2021-02-20,Santa Cruz,087,273765,15304,14378,774,15152,176
2021-02-20,Shasta,089,179085,10876,10850,1193,12043,146
2021-02-20,Sierra,091,2930,51,47,12,59,0
2021-02-20,Siskiyou,093,43540,1470,1366,227,1593,4
2021-02-20,Solano,095,438530,29635,29440,352,29792,150
2021-02-20,Sonoma,097,501317,27772,27703,192,27895,278
2021-02-20,Stanislaus,099,539301,50230,49445,5282,54727,733
2021-02-20,Sutter,101,95872,8770,8681,80,8761,97
2021-02-20,Tehama,103,63373,4577,4545,489,5034,30
2021-02-20,Trinity,105,12862,464,285,75,360,3
2021-02-20,Tulare,107,460477,47941,46769,7857,54626,739
2021-02-20,Tuolumne,109,53932,3813,3823,34,3857,53
2021-02-20,Ventura,111,848112,77257,76757,2749,79506,671
2021-02-20,Yolo,113,214977,12786,12639,218,12857,183
2021-02-20,Yuba,115,75493,5466,5386,84,5470,38
2021-02-19,Alameda,001,1643700,80144,79318,1714,81032,1047
2021-02-19,Alpine,003,1148,78,77,0,77,0
2021-02-19,Amador,005,37829,3446,3427,30,3457,39
2021-02-19,Butte,007,227075,11260,10823,1590,12413,176
2021-02-19,Calaveras,009,45235,1891,1856,11,1867,21
2021-02-19,Colusa,011,21464,1866,1858,260,2118,11
2021-02-19,Contra Costa,013,1133247,62441,61017,1065,62082,651
2021-02-19,Del Norte,015,27424,987,932,4,936,2
2021-02-19,El Dorado,017,186661,9070,8882,608,9490,96
2021-02-19,Fresno,019,978130,95551,93973,7611,101584,1330
2021-02-19,Glenn,021,27897,2231,2199,487,2686,14
2021-02-19,Humboldt,023,135768,3096,3037,22,3059,29
2021-02-19,Imperial,025,180216,27156,26751,2468,29219,589
2021-02-19,Inyo,027,18085,1271,1212,10,1222,32
2021-02-19,Kern,029,883053,92736,90807,9642,100449,963
2021-02-19,Kings,031,150075,22142,21724,958,22682,211
2021-02-19,Lake,033,64148,3141,3078,6,3084,40
2021-02-19,Lassen,035,31185,5105,5057,94,5151,1
2021-02-19,Los Angeles,037,10098052,1167271,1143828,38613,1182441,19498
2021-02-19,Madera,039,155013,15476,15222,807,16029,188
2021-02-19,Marin,041,260295,13078,12919,156,13075,210
2021-02-19,Mariposa,043,17540,376,371,5,376,4
2021-02-19,Mendocino,045,87422,3611,3526,71,3597,39
2021-02-19,Merced,047,269075,28091,27985,892,28877,376
2021-02-19,Modoc,049,8938,338,328,113,441,3
2021-02-19,Mono,051,14174,1173,1186,16,1202,3
2021-02-19,Monterey,053,433212,41729,41209,1667,42876,309
2021-02-19,Napa,055,140530,8953,8899,33,8932,69
2021-02-19,Nevada,057,99092,3949,3863,159,4022,66
2021-02-19,Orange,059,3164182,245771,243397,10162,253559,3715
2021-02-19,Placer,061,380077,20357,19457,1081,20538,236
2021-02-19,Plumas,063,18699,639,624,10,634,4
2021-02-19,Riverside,065,2383286,284256,276941,13368,290309,3541
2021-02-19,Sacramento,067,1510023,93519,91815,1201,93016,1351
2021-02-19,San Benito,069,59416,5704,5699,87,5786,57
2021-02-19,San Bernardino,071,2135413,285126,279209,8514,287723,3117
2021-02-19,San Diego,073,3302833,261932,255799,12667,268466,3169
2021-02-19,San Francisco,075,870044,33888,33746,1043,34789,387
2021-02-19,San Joaquin,077,732212,66233,64774,2712,67486,988
2021-02-19,San Luis Obispo,079,281455,19530,19061,548,19609,230
2021-02-19,San Mateo,081,765935,39188,38256,399,38655,282
2021-02-19,Santa Barbara,083,443738,31912,31204,1037,32241,392
2021-02-19,Santa Clara,085,1922200,109187,108400,561,108961,1634
2021-02-19,Santa Cruz,087,273765,15289,14354,774,15128,176
2021-02-19,Shasta,089,179085,10865,10833,1190,12023,140
2021-02-19,Sierra,091,2930,51,47,12,59,0
2021-02-19,Siskiyou,093,43540,1466,1363,225,1588,4
2021-02-19,Solano,095,438530,29610,29383,351,29734,150
2021-02-19,Sonoma,097,501317,27725,27595,190,27785,280
2021-02-19,Stanislaus,099,539301,50169,49282,5266,54548,739
2021-02-19,Sutter,101,95872,8760,8665,80,8745,96
2021-02-19,Tehama,103,63373,4575,4535,489,5024,30
2021-02-19,Trinity,105,12862,462,282,73,355,3
2021-02-19,Tulare,107,460477,47896,46662,7832,54494,736
2021-02-19,Tuolumne,109,53932,3806,3817,34,3851,52
2021-02-19,Ventura,111,848112,77178,76582,2746,79328,667
2021-02-19,Yolo,113,214977,12770,12606,218,12824,183
2021-02-19,Yuba,115,75493,5456,5376,84,5460,38
2021-02-18,Alameda,001,1643700,80010,79111,1706,80817,1012
2021-02-18,Alpine,003,1148,78,77,0,77,0
2021-02-18,Amador,005,37829,3442,3417,29,3446,38
2021-02-18,Butte,007,227075,11242,10791,1588,12379,175
2021-02-18,Calaveras,009,45235,1886,1873,11,1884,21
2021-02-18,Colusa,011,21464,1864,1856,258,2114,11
2021-02-18,Contra Costa,013,1133247,62327,60868,1063,61931,640
2021-02-18,Del Norte,015,27424,982,929,4,933,2
2021-02-18,El Dorado,017,186661,9055,8850,607,9457,94
2021-02-18,Fresno,019,978130,95381,93734,7586,101320,1323
2021-02-18,Glenn,021,27897,2225,2195,487,2682,14
2021-02-18,Humboldt,023,135768,3084,3023,22,3045,29
2021-02-18,Imperial,025,180216,27130,26731,2461,29192,591
2021-02-18,Inyo,027,18085,1267,1213,9,1222,32
2021-02-18,Kern,029,883053,92582,90655,9612,100267,961
2021-02-18,Kings,031,150075,22118,21648,957,22605,211
2021-02-18,Lake,033,64148,3136,3066,6,3072,40
2021-02-18,Lassen,035,31185,5096,5052,94,5146,1
2021-02-18,Los Angeles,037,10098052,1166312,1141930,38549,1180479,19358
2021-02-18,Madera,039,155013,15454,15175,802,15977,188
2021-02-18,Marin,041,260295,13065,12895,155,13050,209
2021-02-18,Mariposa,043,17540,375,369,5,374,4
2021-02-18,Mendocino,045,87422,3608,3519,70,3589,39
2021-02-18,Merced,047,269075,28042,27870,886,28756,372
2021-02-18,Modoc,049,8938,336,327,112,439,3
2021-02-18,Mono,051,14174,1173,1182,16,1198,3
2021-02-18,Monterey,053,433212,41671,41091,1658,42749,307
2021-02-18,Napa,055,140530,8936,8877,33,8910,68
2021-02-18,Nevada,057,99092,3940,3836,158,3994,66
2021-02-18,Orange,059,3164182,245548,243098,10145,253243,3673
2021-02-18,Placer,061,380077,20330,19429,1080,20509,232
2021-02-18,Plumas,063,18699,639,624,10,634,4
2021-02-18,Riverside,065,2383286,283968,276595,13347,289942,3510
2021-02-18,Sacramento,067,1510023,93357,91476,1195,92671,1334
2021-02-18,San Benito,069,59416,5701,5697,86,5783,58
2021-02-18,San Bernardino,071,2135413,284916,278887,8500,287387,3066
2021-02-18,San Diego,073,3302833,261577,254987,12644,267631,3135
2021-02-18,San Francisco,075,870044,33830,33650,1040,34690,386
2021-02-18,San Joaquin,077,732212,66150,64634,2702,67336,982
2021-02-18,San Luis Obispo,079,281455,19488,18987,545,19532,230
2021-02-18,San Mateo,081,765935,39126,38185,395,38580,282
2021-02-18,Santa Barbara,083,443738,31834,31054,1030,32084,387
2021-02-18,Santa Clara,085,1922200,108962,108210,558,108768,1605
2021-02-18,Santa Cruz,087,273765,15263,14314,774,15088,176
2021-02-18,Shasta,089,179085,10847,10811,1187,11998,139
2021-02-18,Sierra,091,2930,50,47,12,59,0
2021-02-18,Siskiyou,093,43540,1461,1359,224,1583,4
2021-02-18,Solano,095,438530,29584,29349,350,29699,150
2021-02-18,Sonoma,097,501317,27658,27512,189,27701,281
2021-02-18,Stanislaus,099,539301,50068,49150,5249,54399,738
2021-02-18,Sutter,101,95872,8752,8654,80,8734,96
2021-02-18,Tehama,103,63373,4572,4528,489,5017,30
2021-02-18,Trinity,105,12862,461,282,73,355,3
2021-02-18,Tulare,107,460477,47833,46591,7792,54383,728
2021-02-18,Tuolumne,109,53932,3769,3811,34,3845,52
2021-02-18,Ventura,111,848112,77046,76442,2738,79180,659
2021-02-18,Yolo,113,214977,12744,12549,215,12764,183
2021-02-18,Yuba,115,75493,5439,5358,84,5442,38
2021-02-17,Alameda,001,1643700,79849,78895,1704,80599,1002
2021-02-17,Alpine,003,1148,78,77,0,77,0
2021-02-17,Amador,005,37829,3438,3415,29,3444,38
2021-02-17,Butte,007,227075,11224,10770,1584,12354,174
2021-02-17,Calaveras,009,45235,1886,1876,11,1887,21
2021-02-17,Colusa,011,21464,1861,1854,258,2112,10
2021-02-17,Contra Costa,013,1133247,62189,60723,1060,61783,635
2021-02-17,Del Norte,015,27424,975,920,4,924,2
2021-02-17,El Dorado,017,186661,9044,8847,607,9454,94
2021-02-17,Fresno,019,978130,95242,93555,7559,101114,1307
2021-02-17,Glenn,021,27897,2224,2189,486,2675,14
2021-02-17,Humboldt,023,135768,3069,3006,22,3028,29
2021-02-17,Imperial,025,180216,27116,26726,2457,29183,580
2021-02-17,Inyo,027,18085,1259,1197,9,1206,32
2021-02-17,Kern,029,883053,92464,90454,9567,100021,962
2021-02-17,Kings,031,150075,22080,21617,953,22570,211
2021-02-17,Lake,033,64148,3126,3057,2,3059,38
2021-02-17,Lassen,035,31185,5091,5052,93,5145,1
2021-02-17,Los Angeles,037,10098052,1165258,1139786,38485,1178271,19213
2021-02-17,Madera,039,155013,15429,15135,793,15928,177
2021-02-17,Marin,041,260295,13040,12881,155,13036,207
2021-02-17,Mariposa,043,17540,375,368,4,372,4
2021-02-17,Mendocino,045,87422,3606,3494,69,3563,39
2021-02-17,Merced,047,269075,27987,27824,877,28701,372
2021-02-17,Modoc,049,8938,336,327,112,439,3
2021-02-17,Mono,051,14174,1173,1180,16,1196,3
2021-02-17,Monterey,053,433212,41616,41014,1646,42660,304
2021-02-17,Napa,055,140530,8922,8865,33,8898,68
2021-02-17,Nevada,057,99092,3921,3822,155,3977,52
2021-02-17,Orange,059,3164182,245286,242716,10112,252828,3626
2021-02-17,Placer,061,380077,20296,19405,1076,20481,230
2021-02-17,Plumas,063,18699,638,623,10,633,4
2021-02-17,Riverside,065,2383286,283680,276289,13326,289615,3491
2021-02-17,Sacramento,067,1510023,93198,91309,1188,92497,1326
2021-02-17,San Benito,069,59416,5695,5661,86,5747,57
2021-02-17,San Bernardino,071,2135413,284712,278461,8481,286942,3020
2021-02-17,San Diego,073,3302833,261199,254177,12623,266800,3099
2021-02-17,San Francisco,075,870044,33754,33558,1035,34593,379
2021-02-17,San Joaquin,077,732212,66044,64556,2696,67252,979
2021-02-17,San Luis Obispo,079,281455,19443,18964,545,19509,230
2021-02-17,San Mateo,081,765935,39061,38124,394,38518,282
2021-02-17,Santa Barbara,083,443738,31766,30927,1029,31956,384
2021-02-17,Santa Clara,085,1922200,108730,107949,556,108505,1592
2021-02-17,Santa Cruz,087,273765,15230,14268,771,15039,174
2021-02-17,Shasta,089,179085,10827,10770,1186,11956,139
2021-02-17,Sierra,091,2930,50,47,12,59,0
2021-02-17,Siskiyou,093,43540,1455,1352,221,1573,4
2021-02-17,Solano,095,438530,29527,29288,350,29638,149
2021-02-17,Sonoma,097,501317,27586,27408,184,27592,281
2021-02-17,Stanislaus,099,539301,49955,49050,5233,54283,730
2021-02-17,Sutter,101,95872,8742,8681,80,8761,95
2021-02-17,Tehama,103,63373,4569,4511,489,5000,30
2021-02-17,Trinity,105,12862,461,277,71,348,3
2021-02-17,Tulare,107,460477,47768,46495,7766,54261,726
2021-02-17,Tuolumne,109,53932,3760,3806,34,3840,49
2021-02-17,Ventura,111,848112,76924,76234,2732,78966,646
2021-02-17,Yolo,113,214977,12725,12506,213,12719,182
2021-02-17,Yuba,115,75493,5430,5345,84,5429,38
2021-02-16,Alameda,001,1643700,79679,78756,1701,80457,997
2021-02-16,Alpine,003,1148,78,76,0,76,0
2021-02-16,Amador,005,37829,3431,3413,29,3442,39
2021-02-16,Butte,007,227075,11198,10748,1581,12329,164
2021-02-16,Calaveras,009,45235,1884,1872,11,1883,21
2021-02-16,Colusa,011,21464,1858,1852,256,2108,10
2021-02-16,Contra Costa,013,1133247,62038,60564,1055,61619,631
2021-02-16,Del Norte,015,27424,967,913,4,917,2
2021-02-16,El Dorado,017,186661,9034,8836,605,9441,94
2021-02-16,Fresno,019,978130,95077,93363,7529,100892,1293
2021-02-16,Glenn,021,27897,2220,2189,482,2671,14
2021-02-16,Humboldt,023,135768,3046,2994,21,3015,29
2021-02-16,Imperial,025,180216,27103,26711,2453,29164,580
2021-02-16,Inyo,027,18085,1251,1191,9,1200,32
2021-02-16,Kern,029,883053,92332,90267,9537,99804,959
2021-02-16,Kings,031,150075,22034,21583,949,22532,206
2021-02-16,Lake,033,64148,3119,3041,2,3043,38
2021-02-16,Lassen,035,31185,5079,5047,93,5140,1
2021-02-16,Los Angeles,037,10098052,1164004,1138262,38424,1176686,19044
2021-02-16,Madera,039,155013,15391,15120,788,15908,172
2021-02-16,Marin,041,260295,13012,12832,155,12987,205
2021-02-16,Mariposa,043,17540,375,367,4,371,4
2021-02-16,Mendocino,045,87422,3602,3489,69,3558,39
2021-02-16,Merced,047,269075,27906,27724,871,28595,368
2021-02-16,Modoc,049,8938,336,326,112,438,3
2021-02-16,Mono,051,14174,1173,1180,16,1196,3
2021-02-16,Monterey,053,433212,41540,40962,1637,42599,303
2021-02-16,Napa,055,140530,8909,8854,33,8887,66
2021-02-16,Nevada,057,99092,3908,3774,154,3928,47
2021-02-16,Orange,059,3164182,244964,242382,10096,252478,3612
2021-02-16,Placer,061,380077,20263,19367,1073,20440,230
2021-02-16,Plumas,063,18699,638,619,10,629,4
2021-02-16,Riverside,065,2383286,283376,275954,13303,289257,3471
2021-02-16,Sacramento,067,1510023,92944,91246,1182,92428,1305
2021-02-16,San Benito,069,59416,5687,5659,85,5744,56
2021-02-16,San Bernardino,071,2135413,284489,277947,8470,286417,2978
2021-02-16,San Diego,073,3302833,260734,253638,12584,266222,3042
2021-02-16,San Francisco,075,870044,33683,33491,1030,34521,373
2021-02-16,San Joaquin,077,732212,65914,64448,2693,67141,979
2021-02-16,San Luis Obispo,079,281455,19398,18925,542,19467,229
2021-02-16,San Mateo,081,765935,39002,38041,392,38433,277
2021-02-16,Santa Barbara,083,443738,31692,30865,1026,31891,378
2021-02-16,Santa Clara,085,1922200,108478,107754,553,108307,1591
2021-02-16,Santa Cruz,087,273765,15210,14256,770,15026,174
2021-02-16,Shasta,089,179085,10812,10736,1184,11920,139
2021-02-16,Sierra,091,2930,50,47,12,59,0
2021-02-16,Siskiyou,093,43540,1451,1351,221,1572,4
2021-02-16,Solano,095,438530,29489,29246,349,29595,148
2021-02-16,Sonoma,097,501317,27527,27380,178,27558,279
2021-02-16,Stanislaus,099,539301,49831,48927,5219,54146,716
2021-02-16,Sutter,101,95872,8719,8671,80,8751,95
2021-02-16,Tehama,103,63373,4560,4501,487,4988,30
2021-02-16,Trinity,105,12862,457,275,71,346,3
2021-02-16,Tulare,107,460477,47704,46444,7722,54166,716
2021-02-16,Tuolumne,109,53932,3758,3796,34,3830,49
2021-02-16,Ventura,111,848112,76782,76043,2728,78771,631
2021-02-16,Yolo,113,214977,12696,12457,213,12670,175
2021-02-16,Yuba,115,75493,5423,5332,83,5415,38
2021-02-15,Alameda,001,1643700,79483,78647,1690,80337,996
2021-02-15,Alpine,003,1148,78,76,0,76,0
2021-02-15,Amador,005,37829,3427,3409,29,3438,39
2021-02-15,Butte,007,227075,11180,10723,1577,12300,155
2021-02-15,Calaveras,009,45235,1880,1871,11,1882,21
2021-02-15,Colusa,011,21464,1858,1849,252,2101,10
2021-02-15,Contra Costa,013,1133247,61867,60444,1050,61494,631
2021-02-15,Del Norte,015,27424,963,913,4,917,2
2021-02-15,El Dorado,017,186661,9017,8816,605,9421,94
2021-02-15,Fresno,019,978130,94878,93231,7490,100721,1288
2021-02-15,Glenn,021,27897,2218,2185,481,2666,14
2021-02-15,Humboldt,023,135768,3039,2997,21,3018,29
2021-02-15,Imperial,025,180216,27083,26700,2450,29150,580
2021-02-15,Inyo,027,18085,1232,1184,9,1193,32
2021-02-15,Kern,029,883053,92188,90181,9505,99686,959
2021-02-15,Kings,031,150075,21989,21574,945,22519,205
2021-02-15,Lake,033,64148,3105,3030,1,3031,38
2021-02-15,Lassen,035,31185,5077,5047,92,5139,1
2021-02-15,Los Angeles,037,10098052,1162616,1137164,38361,1175525,18925
2021-02-15,Madera,039,155013,15360,15108,786,15894,106
2021-02-15,Marin,041,260295,12991,12810,152,12962,203
2021-02-15,Mariposa,043,17540,373,367,4,371,4
2021-02-15,Mendocino,045,87422,3590,3481,69,3550,39
2021-02-15,Merced,047,269075,27832,27656,863,28519,368
2021-02-15,Modoc,049,8938,336,326,112,438,3
2021-02-15,Mono,051,14174,1170,1178,16,1194,3
2021-02-15,Monterey,053,433212,41476,40911,1624,42535,302
2021-02-15,Napa,055,140530,8895,8837,33,8870,57
2021-02-15,Nevada,057,99092,3891,3767,153,3920,47
2021-02-15,Orange,059,3164182,244645,242176,10067,252243,3586
2021-02-15,Placer,061,380077,20237,19361,1072,20433,230
2021-02-15,Plumas,063,18699,638,620,10,630,4
2021-02-15,Riverside,065,2383286,283022,275771,13284,289055,3468
2021-02-15,Sacramento,067,1510023,92617,91091,1177,92268,1304
2021-02-15,San Benito,069,59416,5681,5649,85,5734,56
2021-02-15,San Bernardino,071,2135413,284237,277869,8462,286331,2945
2021-02-15,San Diego,073,3302833,260221,252940,12553,265493,3037
2021-02-15,San Francisco,075,870044,33610,33454,1024,34478,373
2021-02-15,San Joaquin,077,732212,65749,64382,2686,67068,979
2021-02-15,San Luis Obispo,079,281455,19345,18891,540,19431,227
2021-02-15,San Mateo,081,765935,38923,37969,389,38358,277
2021-02-15,Santa Barbara,083,443738,31589,30810,1023,31833,378
2021-02-15,Santa Clara,085,1922200,108248,107630,551,108181,1588
2021-02-15,Santa Cruz,087,273765,15178,14239,767,15006,175
2021-02-15,Shasta,089,179085,10792,10730,1179,11909,139
2021-02-15,Sierra,091,2930,50,47,12,59,0
2021-02-15,Siskiyou,093,43540,1443,1345,220,1565,4
2021-02-15,Solano,095,438530,29434,29225,349,29574,148
2021-02-15,Sonoma,097,501317,27443,27359,174,27533,276
2021-02-15,Stanislaus,099,539301,49704,48808,5206,54014,716
2021-02-15,Sutter,101,95872,8704,8652,80,8732,95
2021-02-15,Tehama,103,63373,4551,4492,486,4978,30
2021-02-15,Trinity,105,12862,456,274,71,345,3
2021-02-15,Tulare,107,460477,47633,46344,7683,54027,715
2021-02-15,Tuolumne,109,53932,3748,3794,34,3828,49
2021-02-15,Ventura,111,848112,76627,75889,2725,78614,629
2021-02-15,Yolo,113,214977,12661,12412,207,12619,175
2021-02-15,Yuba,115,75493,5406,5320,82,5402,38
2021-02-14,Alameda,001,1643700,79332,78442,1689,80131,995
2021-02-14,Alpine,003,1148,78,76,0,76,0
2021-02-14,Amador,005,37829,3422,3398,29,3427,39
2021-02-14,Butte,007,227075,11156,10717,1574,12291,155
2021-02-14,Calaveras,009,45235,1876,1866,11,1877,21
2021-02-14,Colusa,011,21464,1854,1845,249,2094,10
2021-02-14,Contra Costa,013,1133247,61717,60272,1047,61319,631
2021-02-14,Del Norte,015,27424,959,911,4,915,2
2021-02-14,El Dorado,017,186661,8986,8790,604,9394,94
2021-02-14,Fresno,019,978130,94707,93065,7467,100532,1287
2021-02-14,Glenn,021,27897,2215,2184,481,2665,14
2021-02-14,Humboldt,023,135768,3026,2992,21,3013,29
2021-02-14,Imperial,025,180216,27076,26696,2449,29145,580
2021-02-14,Inyo,027,18085,1226,1177,9,1186,32
2021-02-14,Kern,029,883053,92028,90038,9452,99490,959
2021-02-14,Kings,031,150075,21963,21538,943,22481,205
2021-02-14,Lake,033,64148,3094,3030,1,3031,38
2021-02-14,Lassen,035,31185,5073,5037,92,5129,1
2021-02-14,Los Angeles,037,10098052,1161272,1135450,38277,1173727,18898
2021-02-14,Madera,039,155013,15328,15089,782,15871,106
2021-02-14,Marin,041,260295,12967,12784,152,12936,201
2021-02-14,Mariposa,043,17540,373,365,4,369,4
2021-02-14,Mendocino,045,87422,3584,3475,69,3544,39
2021-02-14,Merced,047,269075,27750,27601,858,28459,368
2021-02-14,Modoc,049,8938,336,326,112,438,3
2021-02-14,Mono,051,14174,1169,1180,16,1196,3
2021-02-14,Monterey,053,433212,41425,40842,1619,42461,302
2021-02-14,Napa,055,140530,8875,8826,33,8859,57
2021-02-14,Nevada,057,99092,3875,3761,153,3914,47
2021-02-14,Orange,059,3164182,244331,241859,10048,251907,3564
2021-02-14,Placer,061,380077,20198,19313,1067,20380,230
2021-02-14,Plumas,063,18699,637,620,10,630,4
2021-02-14,Riverside,065,2383286,282690,275518,13265,288783,3471
2021-02-14,Sacramento,067,1510023,92410,90856,1173,92029,1304
2021-02-14,San Benito,069,59416,5672,5641,84,5725,56
2021-02-14,San Bernardino,071,2135413,283931,277664,8442,286106,2929
2021-02-14,San Diego,073,3302833,259729,252247,12506,264753,3037
2021-02-14,San Francisco,075,870044,33536,33374,1016,34390,372
2021-02-14,San Joaquin,077,732212,65651,64243,2672,66915,979
2021-02-14,San Luis Obispo,079,281455,19307,18868,537,19405,225
2021-02-14,San Mateo,081,765935,38838,37859,389,38248,277
2021-02-14,Santa Barbara,083,443738,31497,30744,1019,31763,377
2021-02-14,Santa Clara,085,1922200,108049,107412,547,107959,1582
2021-02-14,Santa Cruz,087,273765,15150,14225,762,14987,175
2021-02-14,Shasta,089,179085,10760,10720,1174,11894,139
2021-02-14,Sierra,091,2930,50,47,12,59,0
2021-02-14,Siskiyou,093,43540,1439,1340,220,1560,4
2021-02-14,Solano,095,438530,29392,29150,346,29496,148
2021-02-14,Sonoma,097,501317,27368,27266,172,27438,276
2021-02-14,Stanislaus,099,539301,49594,48672,5191,53863,716
2021-02-14,Sutter,101,95872,8681,8642,80,8722,95
2021-02-14,Tehama,103,63373,4545,4490,483,4973,30
2021-02-14,Trinity,105,12862,456,272,71,343,3
2021-02-14,Tulare,107,460477,47548,46263,7634,53897,715
2021-02-14,Tuolumne,109,53932,3747,3764,34,3798,49
2021-02-14,Ventura,111,848112,76458,75742,2714,78456,629
2021-02-14,Yolo,113,214977,12632,12399,206,12605,175
2021-02-14,Yuba,115,75493,5396,5314,82,5396,38
2021-02-13,Alameda,001,1643700,79210,78246,1686,79932,995
2021-02-13,Alpine,003,1148,78,76,0,76,0
2021-02-13,Amador,005,37829,3419,3387,29,3416,38
2021-02-13,Butte,007,227075,11140,10699,1572,12271,155
2021-02-13,Calaveras,009,45235,1873,1863,11,1874,21
2021-02-13,Colusa,011,21464,1854,1837,249,2086,10
2021-02-13,Contra Costa,013,1133247,61596,60100,1047,61147,629
2021-02-13,Del Norte,015,27424,957,908,4,912,2
2021-02-13,El Dorado,017,186661,8974,8758,603,9361,93
2021-02-13,Fresno,019,978130,94593,92807,7445,100252,1287
2021-02-13,Glenn,021,27897,2214,2182,479,2661,14
2021-02-13,Humboldt,023,135768,3013,2974,20,2994,29
2021-02-13,Imperial,025,180216,27069,26680,2447,29127,580
2021-02-13,Inyo,027,18085,1222,1168,9,1177,32
2021-02-13,Kern,029,883053,91939,89915,9426,99341,957
2021-02-13,Kings,031,150075,21948,21513,941,22454,205
2021-02-13,Lake,033,64148,3085,3025,1,3026,37
2021-02-13,Lassen,035,31185,5070,5028,92,5120,1
2021-02-13,Los Angeles,037,10098052,1160413,1133752,38229,1171981,18822
2021-02-13,Madera,039,155013,15319,15053,778,15831,106
2021-02-13,Marin,041,260295,12943,12757,152,12909,201
2021-02-13,Mariposa,043,17540,373,365,4,369,4
2021-02-13,Mendocino,045,87422,3574,3466,69,3535,38
2021-02-13,Merced,047,269075,27706,27541,855,28396,368
2021-02-13,Modoc,049,8938,336,325,112,437,3
2021-02-13,Mono,051,14174,1169,1176,16,1192,3
2021-02-13,Monterey,053,433212,41393,40731,1618,42349,301
2021-02-13,Napa,055,140530,8866,8809,33,8842,57
2021-02-13,Nevada,057,99092,3866,3742,152,3894,47
2021-02-13,Orange,059,3164182,244125,241545,10029,251574,3520
2021-02-13,Placer,061,380077,20178,19214,1067,20281,230
2021-02-13,Plumas,063,18699,637,616,10,626,4
2021-02-13,Riverside,065,2383286,282462,275276,13256,288532,3462
2021-02-13,Sacramento,067,1510023,92243,90401,1170,91571,1302
2021-02-13,San Benito,069,59416,5655,5633,84,5717,56
2021-02-13,San Bernardino,071,2135413,283778,277405,8430,285835,2899
2021-02-13,San Diego,073,3302833,259397,251679,12494,264173,3009
2021-02-13,San Francisco,075,870044,33486,33291,1006,34297,364
2021-02-13,San Joaquin,077,732212,65582,64105,2662,66767,977
2021-02-13,San Luis Obispo,079,281455,19279,18803,531,19334,225
2021-02-13,San Mateo,081,765935,38785,37745,389,38134,277
2021-02-13,Santa Barbara,083,443738,31445,30594,1017,31611,374
2021-02-13,Santa Clara,085,1922200,107860,107125,543,107668,1570
2021-02-13,Santa Cruz,087,273765,15123,14198,761,14959,173
2021-02-13,Shasta,089,179085,10747,10713,1169,11882,139
2021-02-13,Sierra,091,2930,50,47,12,59,0
2021-02-13,Siskiyou,093,43540,1436,1336,220,1556,4
2021-02-13,Solano,095,438530,29356,29084,346,29430,148
2021-02-13,Sonoma,097,501317,27320,27157,170,27327,276
2021-02-13,Stanislaus,099,539301,49523,48568,5185,53753,697
2021-02-13,Sutter,101,95872,8669,8626,80,8706,94
2021-02-13,Tehama,103,63373,4534,4484,482,4966,30
2021-02-13,Trinity,105,12862,455,272,70,342,3
2021-02-13,Tulare,107,460477,47497,46162,7603,53765,709
2021-02-13,Tuolumne,109,53932,3746,3752,34,3786,49
2021-02-13,Ventura,111,848112,76318,75481,2708,78189,618
2021-02-13,Yolo,113,214977,12619,12374,205,12579,175
2021-02-13,Yuba,115,75493,5388,5289,82,5371,38
2021-02-12,Alameda,001,1643700,79061,77958,1680,79638,974
2021-02-12,Alpine,003,1148,78,76,0,76,0
2021-02-12,Amador,005,37829,3415,3381,29,3410,38
2021-02-12,Butte,007,227075,11127,10655,1565,12220,155
2021-02-12,Calaveras,009,45235,1870,1860,11,1871,21
2021-02-12,Colusa,011,21464,1854,1836,249,2085,10
2021-02-12,Contra Costa,013,1133247,61445,59878,1043,60921,620
2021-02-12,Del Norte,015,27424,947,901,4,905,2
2021-02-12,El Dorado,017,186661,8958,8725,600,9325,92
2021-02-12,Fresno,019,978130,94439,92520,7425,99945,1273
2021-02-12,Glenn,021,27897,2211,2175,479,2654,14
2021-02-12,Humboldt,023,135768,3005,2961,20,2981,29
2021-02-12,Imperial,025,180216,27061,26646,2444,29090,585
2021-02-12,Inyo,027,18085,1216,1156,9,1165,32
2021-02-12,Kern,029,883053,91825,89532,9392,98924,949
2021-02-12,Kings,031,150075,21916,21462,936,22398,202
2021-02-12,Lake,033,64148,3080,3012,1,3013,36
2021-02-12,Lassen,035,31185,5068,5015,92,5107,1
2021-02-12,Los Angeles,037,10098052,1159207,1131185,38160,1169345,18637
2021-02-12,Madera,039,155013,15292,15022,775,15797,106
2021-02-12,Marin,041,260295,12917,12720,152,12872,200
2021-02-12,Mariposa,043,17540,372,365,4,369,4
2021-02-12,Mendocino,045,87422,3572,3447,69,3516,38
2021-02-12,Merced,047,269075,27655,27453,852,28305,367
2021-02-12,Modoc,049,8938,336,324,112,436,3
2021-02-12,Mono,051,14174,1168,1172,16,1188,3
2021-02-12,Monterey,053,433212,41345,40633,1609,42242,297
2021-02-12,Napa,055,140530,8854,8785,33,8818,55
2021-02-12,Nevada,057,99092,3861,3728,152,3880,47
2021-02-12,Orange,059,3164182,243886,241075,10014,251089,3505
2021-02-12,Placer,061,380077,20136,19174,1062,20236,230
2021-02-12,Plumas,063,18699,636,614,10,624,4
2021-02-12,Riverside,065,2383286,282183,274792,13239,288031,3438
2021-02-12,Sacramento,067,1510023,92041,90252,1169,91421,1295
2021-02-12,San Benito,069,59416,5639,5622,83,5705,56
2021-02-12,San Bernardino,071,2135413,283588,276890,8419,285309,2827
2021-02-12,San Diego,073,3302833,259009,250788,12468,263256,2979
2021-02-12,San Francisco,075,870044,33426,33179,1002,34181,359
2021-02-12,San Joaquin,077,732212,65486,63966,2654,66620,975
2021-02-12,San Luis Obispo,079,281455,19238,18687,530,19217,224
2021-02-12,San Mateo,081,765935,38713,37560,389,37949,254
2021-02-12,Santa Barbara,083,443738,31374,30454,1012,31466,372
2021-02-12,Santa Clara,085,1922200,107688,106759,540,107299,1543
2021-02-12,Santa Cruz,087,273765,15103,14147,761,14908,170
2021-02-12,Shasta,089,179085,10729,10693,1159,11852,142
2021-02-12,Sierra,091,2930,49,45,12,57,0
2021-02-12,Siskiyou,093,43540,1432,1324,217,1541,4
2021-02-12,Solano,095,438530,29324,28996,343,29339,147
2021-02-12,Sonoma,097,501317,27265,27064,166,27230,275
2021-02-12,Stanislaus,099,539301,49435,48418,5163,53581,697
2021-02-12,Sutter,101,95872,8656,8609,80,8689,93
2021-02-12,Tehama,103,63373,4527,4470,481,4951,27
2021-02-12,Trinity,105,12862,455,269,70,339,3
2021-02-12,Tulare,107,460477,47419,46016,7577,53593,710
2021-02-12,Tuolumne,109,53932,3743,3736,33,3769,49
2021-02-12,Ventura,111,848112,76148,75210,2702,77912,605
2021-02-12,Yolo,113,214977,12598,12340,205,12545,175
2021-02-12,Yuba,115,75493,5380,5274,82,5356,38
2021-02-11,Alameda,001,1643700,78834,77564,1675,79239,960
2021-02-11,Alpine,003,1148,77,76,0,76,0
2021-02-11,Amador,005,37829,3411,3368,29,3397,35
2021-02-11,Butte,007,227075,11104,10624,1564,12188,155
2021-02-11,Calaveras,009,45235,1867,1856,11,1867,21
2021-02-11,Colusa,011,21464,1849,1823,247,2070,10
2021-02-11,Contra Costa,013,1133247,61278,59633,1039,60672,605
2021-02-11,Del Norte,015,27424,942,894,4,898,2
2021-02-11,El Dorado,017,186661,8937,8698,600,9298,92
2021-02-11,Fresno,019,978130,94286,92168,7400,99568,1255
2021-02-11,Glenn,021,27897,2206,2166,478,2644,14
2021-02-11,Humboldt,023,135768,2992,2954,19,2973,29
2021-02-11,Imperial,025,180216,27037,26545,2442,28987,578
2021-02-11,Inyo,027,18085,1207,1144,9,1153,32
2021-02-11,Kern,029,883053,91634,89224,9349,98573,941
2021-02-11,Kings,031,150075,21886,21373,933,22306,202
2021-02-11,Lake,033,64148,3070,3002,1,3003,36
2021-02-11,Lassen,035,31185,5057,5004,89,5093,1
2021-02-11,Los Angeles,037,10098052,1157576,1128437,38091,1166528,18500
2021-02-11,Madera,039,155013,15271,14984,773,15757,106
2021-02-11,Marin,041,260295,12880,12682,152,12834,200
2021-02-11,Mariposa,043,17540,372,361,4,365,4
2021-02-11,Mendocino,045,87422,3565,3420,69,3489,38
2021-02-11,Merced,047,269075,27589,27325,848,28173,363
2021-02-11,Modoc,049,8938,335,317,112,429,3
2021-02-11,Mono,051,14174,1164,1173,16,1189,3
2021-02-11,Monterey,053,433212,41239,40469,1603,42072,295
2021-02-11,Napa,055,140530,8833,8777,33,8810,55
2021-02-11,Nevada,057,99092,3845,3720,152,3872,47
2021-02-11,Orange,059,3164182,243519,240590,9990,250580,3476
2021-02-11,Placer,061,380077,20096,19118,1061,20179,224
2021-02-11,Plumas,063,18699,635,592,10,602,4
2021-02-11,Riverside,065,2383286,281817,274313,13224,287537,3394
2021-02-11,Sacramento,067,1510023,91798,89988,1163,91151,1286
2021-02-11,San Benito,069,59416,5630,5609,83,5692,56
2021-02-11,San Bernardino,071,2135413,283289,276349,8405,284754,2774
2021-02-11,San Diego,073,3302833,258456,249971,12434,262405,2955
2021-02-11,San Francisco,075,870044,33342,33076,993,34069,356
2021-02-11,San Joaquin,077,732212,65318,63719,2644,66363,971
2021-02-11,San Luis Obispo,079,281455,19173,18615,526,19141,219
2021-02-11,San Mateo,081,765935,38622,37439,387,37826,253
2021-02-11,Santa Barbara,083,443738,31276,30375,1007,31382,370
2021-02-11,Santa Clara,085,1922200,107428,106392,534,106926,1507
2021-02-11,Santa Cruz,087,273765,15080,14088,756,14844,165
2021-02-11,Shasta,089,179085,10705,10672,1155,11827,140
2021-02-11,Sierra,091,2930,49,45,12,57,0
2021-02-11,Siskiyou,093,43540,1417,1320,217,1537,4
2021-02-11,Solano,095,438530,29271,28885,343,29228,138
2021-02-11,Sonoma,097,501317,27180,26971,163,27134,272
2021-02-11,Stanislaus,099,539301,49290,48205,5151,53356,697
2021-02-11,Sutter,101,95872,8642,8590,79,8669,93
2021-02-11,Tehama,103,63373,4521,4463,481,4944,26
2021-02-11,Trinity,105,12862,455,269,70,339,3
2021-02-11,Tulare,107,460477,47324,45897,7536,53433,706
2021-02-11,Tuolumne,109,53932,3706,3716,33,3749,48
2021-02-11,Ventura,111,848112,75946,74959,2693,77652,590
2021-02-11,Yolo,113,214977,12574,12303,203,12506,173
2021-02-11,Yuba,115,75493,5366,5261,81,5342,38
2021-02-10,Alameda,001,1643700,78631,77344,1674,79018,944
2021-02-10,Alpine,003,1148,77,76,0,76,0
2021-02-10,Amador,005,37829,3399,3348,29,3377,35
2021-02-10,Butte,007,227075,11076,10594,1563,12157,155
2021-02-10,Calaveras,009,45235,1865,1850,11,1861,21
2021-02-10,Colusa,011,21464,1842,1815,245,2060,10
2021-02-10,Contra Costa,013,1133247,61103,59488,1037,60525,590
2021-02-10,Del Norte,015,27424,936,888,4,892,2
2021-02-10,El Dorado,017,186661,8906,8682,596,9278,87
2021-02-10,Fresno,019,978130,94111,91876,7374,99250,1247
2021-02-10,Glenn,021,27897,2202,2160,476,2636,14
2021-02-10,Humboldt,023,135768,2984,2924,19,2943,29
2021-02-10,Imperial,025,180216,26999,26522,2439,28961,578
2021-02-10,Inyo,027,18085,1195,1138,9,1147,30
2021-02-10,Kern,029,883053,91428,88933,9295,98228,926
2021-02-10,Kings,031,150075,21843,21294,931,22225,197
2021-02-10,Lake,033,64148,3057,2975,1,2976,36
2021-02-10,Lassen,035,31185,5053,4993,89,5082,1
2021-02-10,Los Angeles,037,10098052,1155829,1125437,37962,1163399,18338
2021-02-10,Madera,039,155013,15232,14925,771,15696,105
2021-02-10,Marin,041,260295,12843,12651,152,12803,199
2021-02-10,Mariposa,043,17540,370,360,4,364,4
2021-02-10,Mendocino,045,87422,3550,3395,69,3464,38
2021-02-10,Merced,047,269075,27506,27246,837,28083,359
2021-02-10,Modoc,049,8938,334,315,110,425,3
2021-02-10,Mono,051,14174,1159,1170,16,1186,3
2021-02-10,Monterey,053,433212,41162,40366,1588,41954,288
2021-02-10,Napa,055,140530,8814,8769,33,8802,55
2021-02-10,Nevada,057,99092,3830,3693,150,3843,47
2021-02-10,Orange,059,3164182,243102,239974,9959,249933,3439
2021-02-10,Placer,061,380077,20057,19062,1056,20118,220
2021-02-10,Plumas,063,18699,632,589,10,599,2
2021-02-10,Riverside,065,2383286,281390,273721,13214,286935,3374
2021-02-10,Sacramento,067,1510023,91547,89653,1159,90812,1275
2021-02-10,San Benito,069,59416,5616,5591,83,5674,55
2021-02-10,San Bernardino,071,2135413,282932,275616,8389,284005,2696
2021-02-10,San Diego,073,3302833,257874,248858,12396,261254,2904
2021-02-10,San Francisco,075,870044,33259,32955,990,33945,351
2021-02-10,San Joaquin,077,732212,65176,63484,2630,66114,954
2021-02-10,San Luis Obispo,079,281455,19094,18549,524,19073,216
2021-02-10,San Mateo,081,765935,38532,37323,387,37710,245
2021-02-10,Santa Barbara,083,443738,31185,30216,1002,31218,359
2021-02-10,Santa Clara,085,1922200,107188,106048,531,106579,1489
2021-02-10,Santa Cruz,087,273765,15044,14007,754,14761,165
2021-02-10,Shasta,089,179085,10682,10645,1152,11797,142
2021-02-10,Sierra,091,2930,49,45,12,57,0
2021-02-10,Siskiyou,093,43540,1412,1314,216,1530,4
2021-02-10,Solano,095,438530,29196,28835,341,29176,137
2021-02-10,Sonoma,097,501317,27084,26881,161,27042,271
2021-02-10,Stanislaus,099,539301,49173,48016,5135,53151,696
2021-02-10,Sutter,101,95872,8625,8571,79,8650,93
2021-02-10,Tehama,103,63373,4513,4445,481,4926,23
2021-02-10,Trinity,105,12862,452,268,70,338,3
2021-02-10,Tulare,107,460477,47207,45782,7497,53279,696
2021-02-10,Tuolumne,109,53932,3698,3691,33,3724,48
2021-02-10,Ventura,111,848112,75718,74651,2676,77327,580
2021-02-10,Yolo,113,214977,12550,12276,202,12478,174
2021-02-10,Yuba,115,75493,5348,5241,81,5322,38
2021-02-09,Alameda,001,1643700,78367,77018,1670,78688,936
2021-02-09,Alpine,003,1148,77,76,0,76,0
2021-02-09,Amador,005,37829,3391,3347,29,3376,35
2021-02-09,Butte,007,227075,11050,10563,1560,12123,153
2021-02-09,Calaveras,009,45235,1861,1847,11,1858,21
2021-02-09,Colusa,011,21464,1833,1812,240,2052,10
2021-02-09,Contra Costa,013,1133247,60914,59307,1031,60338,583
2021-02-09,Del Norte,015,27424,930,886,4,890,2
2021-02-09,El Dorado,017,186661,8879,8663,594,9257,87
2021-02-09,Fresno,019,978130,93869,91730,7346,99076,1211
2021-02-09,Glenn,021,27897,2198,2156,476,2632,14
2021-02-09,Humboldt,023,135768,2976,2904,19,2923,29
2021-02-09,Imperial,025,180216,26968,26509,2436,28945,568
2021-02-09,Inyo,027,18085,1187,1137,9,1146,30
2021-02-09,Kern,029,883053,91176,88684,9249,97933,920
2021-02-09,Kings,031,150075,21801,21275,929,22204,196
2021-02-09,Lake,033,64148,3046,2955,1,2956,36
2021-02-09,Lassen,035,31185,5046,4983,89,5072,1
2021-02-09,Los Angeles,037,10098052,1153855,1122745,37878,1160623,18198
2021-02-09,Madera,039,155013,15212,14912,768,15680,105
2021-02-09,Marin,041,260295,12810,12623,151,12774,197
2021-02-09,Mariposa,043,17540,368,355,4,359,4
2021-02-09,Mendocino,045,87422,3532,3369,69,3438,38
2021-02-09,Merced,047,269075,27408,27166,832,27998,354
2021-02-09,Modoc,049,8938,333,316,110,426,3
2021-02-09,Mono,051,14174,1158,1167,16,1183,3
2021-02-09,Monterey,053,433212,41054,40279,1575,41854,285
2021-02-09,Napa,055,140530,8801,8749,33,8782,55
2021-02-09,Nevada,057,99092,3814,3687,150,3837,44
2021-02-09,Orange,059,3164182,242690,239169,9928,249097,3406
2021-02-09,Placer,061,380077,19992,19008,1049,20057,220
2021-02-09,Plumas,063,18699,632,584,10,594,2
2021-02-09,Riverside,065,2383286,280896,273465,13197,286662,3334
2021-02-09,Sacramento,067,1510023,91236,89378,1158,90536,1265
2021-02-09,San Benito,069,59416,5604,5566,82,5648,54
2021-02-09,San Bernardino,071,2135413,282557,274998,8376,283374,2613
2021-02-09,San Diego,073,3302833,257216,248048,12353,260401,2853
2021-02-09,San Francisco,075,870044,33180,32782,980,33762,349
2021-02-09,San Joaquin,077,732212,65001,63341,2625,65966,937
2021-02-09,San Luis Obispo,079,281455,19035,18489,523,19012,216
2021-02-09,San Mateo,081,765935,38401,37227,386,37613,235
2021-02-09,Santa Barbara,083,443738,31073,30118,996,31114,351
2021-02-09,Santa Clara,085,1922200,106882,105762,528,106290,1463
2021-02-09,Santa Cruz,087,273765,14994,13958,749,14707,162
2021-02-09,Shasta,089,179085,10654,10595,1150,11745,139
2021-02-09,Sierra,091,2930,49,44,12,56,0
2021-02-09,Siskiyou,093,43540,1404,1306,214,1520,4
2021-02-09,Solano,095,438530,29117,28769,338,29107,131
2021-02-09,Sonoma,097,501317,26994,26826,159,26985,267
2021-02-09,Stanislaus,099,539301,49013,47906,5119,53025,679
2021-02-09,Sutter,101,95872,8609,8541,79,8620,92
2021-02-09,Tehama,103,63373,4506,4416,480,4896,22
2021-02-09,Trinity,105,12862,452,266,70,336,3
2021-02-09,Tulare,107,460477,47073,45704,7443,53147,686
2021-02-09,Tuolumne,109,53932,3679,3673,33,3706,48
2021-02-09,Ventura,111,848112,75466,74333,2668,77001,567
2021-02-09,Yolo,113,214977,12508,12220,202,12422,174
2021-02-09,Yuba,115,75493,5339,5235,81,5316,35
2021-02-08,Alameda,001,1643700,78104,76735,1665,78400,924
2021-02-08,Alpine,003,1148,77,73,0,73,0
2021-02-08,Amador,005,37829,3384,3344,28,3372,33
2021-02-08,Butte,007,227075,11028,10524,1556,12080,152
2021-02-08,Calaveras,009,45235,1860,1840,11,1851,21
2021-02-08,Colusa,011,21464,1825,1802,236,2038,10
2021-02-08,Contra Costa,013,1133247,60703,59039,1029,60068,567
2021-02-08,Del Norte,015,27424,927,885,4,889,2
2021-02-08,El Dorado,017,186661,8848,8627,591,9218,86
2021-02-08,Fresno,019,978130,93656,91430,7320,98750,1207
2021-02-08,Glenn,021,27897,2194,2148,474,2622,14
2021-02-08,Humboldt,023,135768,2968,2902,19,2921,29
2021-02-08,Imperial,025,180216,26946,26526,2434,28960,567
2021-02-08,Inyo,027,18085,1174,1126,9,1135,30
2021-02-08,Kern,029,883053,90959,88380,9189,97569,920
2021-02-08,Kings,031,150075,21739,21232,926,22158,195
2021-02-08,Lake,033,64148,3027,2949,1,2950,36
2021-02-08,Lassen,035,31185,5033,4976,89,5065,1
2021-02-08,Los Angeles,037,10098052,1151759,1120179,37756,1157935,17977
2021-02-08,Madera,039,155013,15176,14887,761,15648,93
2021-02-08,Marin,041,260295,12780,12591,151,12742,194
2021-02-08,Mariposa,043,17540,368,355,4,359,4
2021-02-08,Mendocino,045,87422,3518,3355,69,3424,38
2021-02-08,Merced,047,269075,27324,27082,827,27909,346
2021-02-08,Modoc,049,8938,331,318,110,428,3
2021-02-08,Mono,051,14174,1158,1165,16,1181,3
2021-02-08,Monterey,053,433212,40934,40186,1556,41742,283
2021-02-08,Napa,055,140530,8786,8719,33,8752,55
2021-02-08,Nevada,057,99092,3802,3671,150,3821,44
2021-02-08,Orange,059,3164182,242222,238715,9905,248620,3361
2021-02-08,Placer,061,380077,19950,18944,1043,19987,211
2021-02-08,Plumas,063,18699,631,584,10,594,2
2021-02-08,Riverside,065,2383286,280328,272904,13171,286075,3301
2021-02-08,Sacramento,067,1510023,90950,89267,1155,90422,1247
2021-02-08,San Benito,069,59416,5599,5553,81,5634,52
2021-02-08,San Bernardino,071,2135413,282154,274661,8370,283031,2587
2021-02-08,San Diego,073,3302833,256473,247259,12312,259571,2821
2021-02-08,San Francisco,075,870044,33086,32679,972,33651,348
2021-02-08,San Joaquin,077,732212,64840,63148,2615,65763,929
2021-02-08,San Luis Obispo,079,281455,18978,18421,518,18939,214
2021-02-08,San Mateo,081,765935,38292,37084,386,37470,232
2021-02-08,Santa Barbara,083,443738,30958,29978,989,30967,340
2021-02-08,Santa Clara,085,1922200,106559,105413,520,105933,1456
2021-02-08,Santa Cruz,087,273765,14955,13921,743,14664,161
2021-02-08,Shasta,089,179085,10627,10574,1144,11718,137
2021-02-08,Sierra,091,2930,49,44,12,56,0
2021-02-08,Siskiyou,093,43540,1401,1303,214,1517,4
2021-02-08,Solano,095,438530,29051,28644,336,28980,130
2021-02-08,Sonoma,097,501317,26903,26760,158,26918,259
2021-02-08,Stanislaus,099,539301,48858,47704,5091,52795,679
2021-02-08,Sutter,101,95872,8590,8526,79,8605,92
2021-02-08,Tehama,103,63373,4496,4403,477,4880,22
2021-02-08,Trinity,105,12862,450,266,70,336,3
2021-02-08,Tulare,107,460477,46965,45617,7403,53020,673
2021-02-08,Tuolumne,109,53932,3671,3647,33,3680,48
2021-02-08,Ventura,111,848112,75209,74068,2662,76730,565
2021-02-08,Yolo,113,214977,12476,12169,201,12370,162
2021-02-08,Yuba,115,75493,5323,5215,81,5296,35
2021-02-07,Alameda,001,1643700,77802,76500,1657,78157,924
2021-02-07,Alpine,003,1148,74,72,0,72,0
2021-02-07,Amador,005,37829,3363,3343,28,3371,33
2021-02-07,Butte,007,227075,10996,10513,1548,12061,152
2021-02-07,Calaveras,009,45235,1856,1837,11,1848,21
2021-02-07,Colusa,011,21464,1814,1795,234,2029,10
2021-02-07,Contra Costa,013,1133247,60461,58836,1024,59860,566
2021-02-07,Del Norte,015,27424,923,881,4,885,2
2021-02-07,El Dorado,017,186661,8819,8596,589,9185,86
2021-02-07,Fresno,019,978130,93426,91184,7282,98466,1207
2021-02-07,Glenn,021,27897,2190,2141,469,2610,14
2021-02-07,Humboldt,023,135768,2947,2895,19,2914,28
2021-02-07,Imperial,025,180216,26919,26518,2429,28947,567
2021-02-07,Inyo,027,18085,1163,1124,9,1133,27
2021-02-07,Kern,029,883053,90712,88146,9131,97277,920
2021-02-07,Kings,031,150075,21678,21180,923,22103,192
2021-02-07,Lake,033,64148,3012,2940,1,2941,36
2021-02-07,Lassen,035,31185,5022,4973,89,5062,1
2021-02-07,Los Angeles,037,10098052,1149000,1117551,37628,1155179,17889
2021-02-07,Madera,039,155013,15142,14850,757,15607,93
2021-02-07,Marin,041,260295,12747,12571,149,12720,194
2021-02-07,Mariposa,043,17540,367,355,4,359,4
2021-02-07,Mendocino,045,87422,3501,3348,69,3417,38
2021-02-07,Merced,047,269075,27212,26977,815,27792,346
2021-02-07,Modoc,049,8938,331,317,106,423,3
2021-02-07,Mono,051,14174,1155,1165,16,1181,3
2021-02-07,Monterey,053,433212,40798,40113,1537,41650,283
2021-02-07,Napa,055,140530,8763,8701,33,8734,55
2021-02-07,Nevada,057,99092,3791,3643,150,3793,44
2021-02-07,Orange,059,3164182,241624,238155,9871,248026,3336
2021-02-07,Placer,061,380077,19903,18903,1030,19933,211
2021-02-07,Plumas,063,18699,631,584,10,594,2
2021-02-07,Riverside,065,2383286,279800,272301,13150,285451,3267
2021-02-07,Sacramento,067,1510023,90617,88919,1148,90067,1246
2021-02-07,San Benito,069,59416,5580,5548,80,5628,52
2021-02-07,San Bernardino,071,2135413,281559,274316,8345,282661,2587
2021-02-07,San Diego,073,3302833,255687,246561,12248,258809,2821
2021-02-07,San Francisco,075,870044,32966,32609,960,33569,348
2021-02-07,San Joaquin,077,732212,64565,63051,2600,65651,929
2021-02-07,San Luis Obispo,079,281455,18906,18349,511,18860,214
2021-02-07,San Mateo,081,765935,38158,36984,384,37368,232
2021-02-07,Santa Barbara,083,443738,30818,29815,978,30793,340
2021-02-07,Santa Clara,085,1922200,106220,105118,510,105628,1450
2021-02-07,Santa Cruz,087,273765,14901,13887,738,14625,161
2021-02-07,Shasta,089,179085,10607,10570,1136,11706,137
2021-02-07,Sierra,091,2930,49,43,12,55,0
2021-02-07,Siskiyou,093,43540,1394,1295,212,1507,4
2021-02-07,Solano,095,438530,28940,28567,335,28902,130
2021-02-07,Sonoma,097,501317,26796,26684,154,26838,257
2021-02-07,Stanislaus,099,539301,48668,47551,5059,52610,679
2021-02-07,Sutter,101,95872,8562,8515,79,8594,92
2021-02-07,Tehama,103,63373,4480,4396,476,4872,22
2021-02-07,Trinity,105,12862,447,264,68,332,3
2021-02-07,Tulare,107,460477,46843,45520,7325,52845,671
2021-02-07,Tuolumne,109,53932,3647,3619,32,3651,48
2021-02-07,Ventura,111,848112,74898,73759,2650,76409,561
2021-02-07,Yolo,113,214977,12431,12135,201,12336,162
2021-02-07,Yuba,115,75493,5308,5198,79,5277,35
2021-02-06,Alameda,001,1643700,77648,76170,1646,77816,922
2021-02-06,Alpine,003,1148,74,72,0,72,0
2021-02-06,Amador,005,37829,3357,3306,28,3334,33
2021-02-06,Butte,007,227075,10979,10480,1544,12024,150
2021-02-06,Calaveras,009,45235,1854,1832,11,1843,21
2021-02-06,Colusa,011,21464,1812,1791,233,2024,10
2021-02-06,Contra Costa,013,1133247,60314,58567,1018,59585,566
2021-02-06,Del Norte,015,27424,919,879,4,883,2
2021-02-06,El Dorado,017,186661,8812,8575,585,9160,86
2021-02-06,Fresno,019,978130,93313,90944,7261,98205,1207
2021-02-06,Glenn,021,27897,2188,2136,468,2604,14
2021-02-06,Humboldt,023,135768,2936,2880,19,2899,28
2021-02-06,Imperial,025,180216,26907,26514,2428,28942,567
2021-02-06,Inyo,027,18085,1160,1113,9,1122,27
2021-02-06,Kern,029,883053,90558,87919,9085,97004,912
2021-02-06,Kings,031,150075,21648,21156,923,22079,190
2021-02-06,Lake,033,64148,3007,2920,1,2921,34
2021-02-06,Lassen,035,31185,5018,4964,88,5052,1
2021-02-06,Los Angeles,037,10098052,1147645,1114718,37530,1152248,17793
2021-02-06,Madera,039,155013,15121,14807,755,15562,93
2021-02-06,Marin,041,260295,12727,12531,149,12680,194
2021-02-06,Mariposa,043,17540,366,355,3,358,4
2021-02-06,Mendocino,045,87422,3483,3316,68,3384,38
2021-02-06,Merced,047,269075,27126,26881,807,27688,346
2021-02-06,Modoc,049,8938,331,313,106,419,3
2021-02-06,Mono,051,14174,1154,1159,16,1175,3
2021-02-06,Monterey,053,433212,40740,39995,1529,41524,282
2021-02-06,Napa,055,140530,8750,8639,33,8672,55
2021-02-06,Nevada,057,99092,3779,3624,150,3774,43
2021-02-06,Orange,059,3164182,241261,237391,9837,247228,3293
2021-02-06,Placer,061,380077,19866,18836,1027,19863,211
2021-02-06,Plumas,063,18699,631,584,10,594,2
2021-02-06,Riverside,065,2383286,279431,271741,13131,284872,3243
2021-02-06,Sacramento,067,1510023,90400,88532,1138,89670,1237
2021-02-06,San Benito,069,59416,5562,5516,80,5596,52
2021-02-06,San Bernardino,071,2135413,281250,273718,8323,282041,2564
2021-02-06,San Diego,073,3302833,255191,245331,12213,257544,2812
2021-02-06,San Francisco,075,870044,32892,32437,950,33387,346
2021-02-06,San Joaquin,077,732212,64486,62840,2589,65429,906
2021-02-06,San Luis Obispo,079,281455,18864,18284,507,18791,214
2021-02-06,San Mateo,081,765935,38090,36824,381,37205,232
2021-02-06,Santa Barbara,083,443738,30742,29645,976,30621,337
2021-02-06,Santa Clara,085,1922200,105998,104639,505,105144,1439
2021-02-06,Santa Cruz,087,273765,14870,13845,734,14579,161
2021-02-06,Shasta,089,179085,10596,10561,1134,11695,137
2021-02-06,Sierra,091,2930,49,43,12,55,0
2021-02-06,Siskiyou,093,43540,1391,1289,211,1500,4
2021-02-06,Solano,095,438530,28904,28446,334,28780,129
2021-02-06,Sonoma,097,501317,26759,26564,152,26716,257
2021-02-06,Stanislaus,099,539301,48572,47325,5043,52368,679
2021-02-06,Sutter,101,95872,8554,8485,79,8564,92
2021-02-06,Tehama,103,63373,4470,4380,475,4855,22
2021-02-06,Trinity,105,12862,447,263,68,331,3
2021-02-06,Tulare,107,460477,46775,45349,7278,52627,664
2021-02-06,Tuolumne,109,53932,3640,3612,32,3644,48
2021-02-06,Ventura,111,848112,74718,73431,2644,76075,552
2021-02-06,Yolo,113,214977,12408,12061,201,12262,161
2021-02-06,Yuba,115,75493,5298,5177,78,5255,35
2021-02-05,Alameda,001,1643700,77420,75716,1644,77360,916
2021-02-05,Alpine,003,1148,74,72,0,72,0
2021-02-05,Amador,005,37829,3352,3299,27,3326,33
2021-02-05,Butte,007,227075,10960,10421,1537,11958,150
2021-02-05,Calaveras,009,45235,1850,1818,11,1829,21
2021-02-05,Colusa,011,21464,1808,1785,233,2018,10
2021-02-05,Contra Costa,013,1133247,60153,58195,1016,59211,560
2021-02-05,Del Norte,015,27424,918,874,4,878,2
2021-02-05,El Dorado,017,186661,8792,8527,583,9110,86
2021-02-05,Fresno,019,978130,93111,90513,7240,97753,1194
2021-02-05,Glenn,021,27897,2185,2122,462,2584,14
2021-02-05,Humboldt,023,135768,2926,2857,19,2876,28
2021-02-05,Imperial,025,180216,26888,26474,2427,28901,557
2021-02-05,Inyo,027,18085,1156,1104,9,1113,27
2021-02-05,Kern,029,883053,90389,87470,9018,96488,906
2021-02-05,Kings,031,150075,21610,21021,920,21941,190
2021-02-05,Lake,033,64148,2995,2906,1,2907,33
2021-02-05,Lassen,035,31185,5014,4936,88,5024,1
2021-02-05,Los Angeles,037,10098052,1145542,1110384,37399,1147783,17608
2021-02-05,Madera,039,155013,15087,14752,750,15502,95
2021-02-05,Marin,041,260295,12692,12479,149,12628,193
2021-02-05,Mariposa,043,17540,366,352,3,355,4
2021-02-05,Mendocino,045,87422,3469,3272,68,3340,38
2021-02-05,Merced,047,269075,27066,26760,806,27566,345
2021-02-05,Modoc,049,8938,331,312,106,418,3
2021-02-05,Mono,051,14174,1153,1157,16,1173,3
2021-02-05,Monterey,053,433212,40673,39840,1518,41358,281
2021-02-05,Napa,055,140530,8736,8598,33,8631,55
2021-02-05,Nevada,057,99092,3776,3607,150,3757,43
2021-02-05,Orange,059,3164182,240834,236335,9810,246145,3260
2021-02-05,Placer,061,380077,19830,18756,1025,19781,211
2021-02-05,Plumas,063,18699,629,578,10,588,2
2021-02-05,Riverside,065,2383286,279017,270666,13112,283778,3235
2021-02-05,Sacramento,067,1510023,90220,87992,1131,89123,1231
2021-02-05,San Benito,069,59416,5551,5502,80,5582,51
2021-02-05,San Bernardino,071,2135413,280906,272938,8305,281243,2495
2021-02-05,San Diego,073,3302833,254615,244066,12178,256244,2777
2021-02-05,San Francisco,075,870044,32802,32229,939,33168,337
2021-02-05,San Joaquin,077,732212,64336,62565,2581,65146,902
2021-02-05,San Luis Obispo,079,281455,18803,18152,503,18655,213
2021-02-05,San Mateo,081,765935,38007,36582,380,36962,227
2021-02-05,Santa Barbara,083,443738,30645,29455,963,30418,334
2021-02-05,Santa Clara,085,1922200,105750,104112,503,104615,1421
2021-02-05,Santa Cruz,087,273765,14849,13776,732,14508,161
2021-02-05,Shasta,089,179085,10580,10507,1127,11634,136
2021-02-05,Sierra,091,2930,49,42,12,54,0
2021-02-05,Siskiyou,093,43540,1384,1276,209,1485,4
2021-02-05,Solano,095,438530,28854,28283,334,28617,127
2021-02-05,Sonoma,097,501317,26690,26423,149,26572,252
2021-02-05,Stanislaus,099,539301,48427,47024,5025,52049,678
2021-02-05,Sutter,101,95872,8534,8443,79,8522,92
2021-02-05,Tehama,103,63373,4461,4355,474,4829,22
2021-02-05,Trinity,105,12862,446,260,68,328,3
2021-02-05,Tulare,107,460477,46699,45138,7229,52367,663
2021-02-05,Tuolumne,109,53932,3614,3595,32,3627,45
2021-02-05,Ventura,111,848112,74473,72953,2632,75585,546
2021-02-05,Yolo,113,214977,12389,12025,196,12221,162
2021-02-05,Yuba,115,75493,5281,5145,78,5223,35
2021-02-04,Alameda,001,1643700,77135,75422,1638,77060,899
2021-02-04,Alpine,003,1148,73,72,0,72,0
2021-02-04,Amador,005,37829,3349,3288,27,3315,33
2021-02-04,Butte,007,227075,10927,10386,1529,11915,147
2021-02-04,Calaveras,009,45235,1848,1808,11,1819,21
2021-02-04,Colusa,011,21464,1804,1777,231,2008,10
2021-02-04,Contra Costa,013,1133247,59965,57991,1012,59003,550
2021-02-04,Del Norte,015,27424,912,870,4,874,2
2021-02-04,El Dorado,017,186661,8766,8490,580,9070,86
2021-02-04,Fresno,019,978130,92896,90126,7213,97339,1114
2021-02-04,Glenn,021,27897,2180,2102,461,2563,14
2021-02-04,Humboldt,023,135768,2916,2827,19,2846,28
2021-02-04,Imperial,025,180216,26843,26411,2425,28836,556
2021-02-04,Inyo,027,18085,1144,1084,9,1093,27
2021-02-04,Kern,029,883053,90115,87156,8941,96097,898
2021-02-04,Kings,031,150075,21559,20918,913,21831,187
2021-02-04,Lake,033,64148,2983,2882,1,2883,34
2021-02-04,Lassen,035,31185,5011,4927,88,5015,1
2021-02-04,Los Angeles,037,10098052,1142745,1106323,37272,1143595,17396
2021-02-04,Madera,039,155013,15057,14706,747,15453,95
2021-02-04,Marin,041,260295,12656,12431,149,12580,192
2021-02-04,Mariposa,043,17540,366,348,3,351,4
2021-02-04,Mendocino,045,87422,3451,3240,66,3306,38
2021-02-04,Merced,047,269075,26972,26629,803,27432,345
2021-02-04,Modoc,049,8938,331,309,106,415,3
2021-02-04,Mono,051,14174,1151,1153,16,1169,3
2021-02-04,Monterey,053,433212,40562,39619,1501,41120,279
2021-02-04,Napa,055,140530,8707,8573,33,8606,55
2021-02-04,Nevada,057,99092,3756,3590,149,3739,37
2021-02-04,Orange,059,3164182,240191,235677,9768,245445,3238
2021-02-04,Placer,061,380077,19770,18711,1016,19727,210
2021-02-04,Plumas,063,18699,626,562,10,572,2
2021-02-04,Riverside,065,2383286,278254,269851,13073,282924,3230
2021-02-04,Sacramento,067,1510023,89919,87658,1121,88779,1222
2021-02-04,San Benito,069,59416,5537,5488,79,5567,51
2021-02-04,San Bernardino,071,2135413,280357,272223,8285,280508,2409
2021-02-04,San Diego,073,3302833,253827,242613,12112,254725,2738
2021-02-04,San Francisco,075,870044,32688,32116,930,33046,326
2021-02-04,San Joaquin,077,732212,64111,62374,2573,64947,883
2021-02-04,San Luis Obispo,079,281455,18736,18058,501,18559,211
2021-02-04,San Mateo,081,765935,37886,36437,377,36814,226
2021-02-04,Santa Barbara,083,443738,30510,29344,946,30290,322
2021-02-04,Santa Clara,085,1922200,105407,103781,500,104281,1404
2021-02-04,Santa Cruz,087,273765,14816,13713,724,14437,156
2021-02-04,Shasta,089,179085,10554,10466,1122,11588,131
2021-02-04,Sierra,091,2930,49,42,12,54,0
2021-02-04,Siskiyou,093,43540,1375,1273,209,1482,4
2021-02-04,Solano,095,438530,28751,28192,332,28524,120
2021-02-04,Sonoma,097,501317,26608,26276,145,26421,249
2021-02-04,Stanislaus,099,539301,48265,46822,5006,51828,678
2021-02-04,Sutter,101,95872,8514,8401,79,8480,92
2021-02-04,Tehama,103,63373,4444,4327,473,4800,21
2021-02-04,Trinity,105,12862,445,260,67,327,3
2021-02-04,Tulare,107,460477,46572,44983,7168,52151,656
2021-02-04,Tuolumne,109,53932,3574,3585,32,3617,45
2021-02-04,Ventura,111,848112,74141,72595,2619,75214,537
2021-02-04,Yolo,113,214977,12355,11982,195,12177,161
2021-02-04,Yuba,115,75493,5255,5135,78,5213,34
2021-02-03,Alameda,001,1643700,76811,74968,1634,76602,880
2021-02-03,Alpine,003,1148,73,72,0,72,0
2021-02-03,Amador,005,37829,3345,3281,27,3308,33
2021-02-03,Butte,007,227075,10895,10355,1522,11877,144
2021-02-03,Calaveras,009,45235,1833,1799,11,1810,21
2021-02-03,Colusa,011,21464,1799,1773,230,2003,10
2021-02-03,Contra Costa,013,1133247,59725,57762,1000,58762,537
2021-02-03,Del Norte,015,27424,907,869,4,873,2
2021-02-03,El Dorado,017,186661,8745,8428,579,9007,86
2021-02-03,Fresno,019,978130,92675,89748,7174,96922,1015
2021-02-03,Glenn,021,27897,2170,2098,460,2558,14
2021-02-03,Humboldt,023,135768,2906,2800,19,2819,27
2021-02-03,Imperial,025,180216,26807,26363,2419,28782,547
2021-02-03,Inyo,027,18085,1134,1071,9,1080,27
2021-02-03,Kern,029,883053,89872,86771,8900,95671,877
2021-02-03,Kings,031,150075,21498,20831,911,21742,172
2021-02-03,Lake,033,64148,2965,2869,1,2870,33
2021-02-03,Lassen,035,31185,4999,4910,88,4998,1
2021-02-03,Los Angeles,037,10098052,1139661,1101890,37149,1139039,17163
2021-02-03,Madera,039,155013,15017,14605,745,15350,94
2021-02-03,Marin,041,260295,12621,12406,149,12555,190
2021-02-03,Mariposa,043,17540,365,347,3,350,4
2021-02-03,Mendocino,045,87422,3425,3236,65,3301,38
2021-02-03,Merced,047,269075,26857,26520,798,27318,343
2021-02-03,Modoc,049,8938,330,308,106,414,3
2021-02-03,Mono,051,14174,1144,1146,16,1162,3
2021-02-03,Monterey,053,433212,40435,39500,1484,40984,279
2021-02-03,Napa,055,140530,8672,8534,33,8567,54
2021-02-03,Nevada,057,99092,3742,3572,149,3721,35
2021-02-03,Orange,059,3164182,239447,234738,9736,244474,3189
2021-02-03,Placer,061,380077,19715,18646,1014,19660,210
2021-02-03,Plumas,063,18699,626,559,10,569,2
2021-02-03,Riverside,065,2383286,277513,269019,13042,282061,3195
2021-02-03,Sacramento,067,1510023,89596,87415,1117,88532,1212
2021-02-03,San Benito,069,59416,5519,5463,76,5539,51
2021-02-03,San Bernardino,071,2135413,279871,271477,8262,279739,2308
2021-02-03,San Diego,073,3302833,252925,241015,12066,253081,2683
2021-02-03,San Francisco,075,870044,32558,31983,925,32908,325
2021-02-03,San Joaquin,077,732212,63883,61976,2563,64539,880
2021-02-03,San Luis Obispo,079,281455,18658,17922,498,18420,206
2021-02-03,San Mateo,081,765935,37748,36227,373,36600,225
2021-02-03,Santa Barbara,083,443738,30361,29121,936,30057,315
2021-02-03,Santa Clara,085,1922200,105091,103278,498,103776,1364
2021-02-03,Santa Cruz,087,273765,14761,13611,718,14329,154
2021-02-03,Shasta,089,179085,10511,10422,1117,11539,130
2021-02-03,Sierra,091,2930,49,42,12,54,0
2021-02-03,Siskiyou,093,43540,1364,1268,208,1476,4
2021-02-03,Solano,095,438530,28629,28057,332,28389,119
2021-02-03,Sonoma,097,501317,26524,26155,144,26299,248
2021-02-03,Stanislaus,099,539301,48089,46598,4987,51585,662
2021-02-03,Sutter,101,95872,8489,8379,79,8458,90
2021-02-03,Tehama,103,63373,4426,4309,470,4779,21
2021-02-03,Trinity,105,12862,445,260,66,326,3
2021-02-03,Tulare,107,460477,46401,44838,7112,51950,640
2021-02-03,Tuolumne,109,53932,3563,3568,32,3600,45
2021-02-03,Ventura,111,848112,73804,72124,2609,74733,526
2021-02-03,Yolo,113,214977,12330,11933,194,12127,161
2021-02-03,Yuba,115,75493,5237,5124,78,5202,34
2021-02-02,Alameda,001,1643700,76466,74642,1622,76264,869
2021-02-02,Alpine,003,1148,73,72,0,72,0
2021-02-02,Amador,005,37829,3314,3275,27,3302,33
2021-02-02,Butte,007,227075,10869,10307,1513,11820,141
2021-02-02,Calaveras,009,45235,1824,1786,11,1797,21
2021-02-02,Colusa,011,21464,1791,1769,225,1994,9
2021-02-02,Contra Costa,013,1133247,59446,57551,996,58547,536
2021-02-02,Del Norte,015,27424,901,868,4,872,2
2021-02-02,El Dorado,017,186661,8705,8405,579,8984,84
2021-02-02,Fresno,019,978130,92374,89542,7138,96680,1009
2021-02-02,Glenn,021,27897,2158,2090,457,2547,14
2021-02-02,Humboldt,023,135768,2894,2784,19,2803,25
2021-02-02,Imperial,025,180216,26754,26317,2413,28730,535
2021-02-02,Inyo,027,18085,1131,1074,9,1083,27
2021-02-02,Kern,029,883053,89569,86485,8824,95309,867
2021-02-02,Kings,031,150075,21420,20785,903,21688,172
2021-02-02,Lake,033,64148,2945,2857,1,2858,33
2021-02-02,Lassen,035,31185,4992,4908,88,4996,1
2021-02-02,Los Angeles,037,10098052,1136276,1097573,36987,1134560,16913
2021-02-02,Madera,039,155013,14966,14595,740,15335,94
2021-02-02,Marin,041,260295,12592,12367,149,12516,189
2021-02-02,Mariposa,043,17540,362,345,3,348,4
2021-02-02,Mendocino,045,87422,3392,3210,65,3275,38
2021-02-02,Merced,047,269075,26760,26427,792,27219,340
2021-02-02,Modoc,049,8938,325,306,106,412,3
2021-02-02,Mono,051,14174,1142,1147,16,1163,3
2021-02-02,Monterey,053,433212,40300,39371,1470,40841,278
2021-02-02,Napa,055,140530,8643,8505,33,8538,53
2021-02-02,Nevada,057,99092,3727,3548,149,3697,20
2021-02-02,Orange,059,3164182,238645,233783,9701,243484,3152
2021-02-02,Placer,061,380077,19657,18615,1010,19625,205
2021-02-02,Plumas,063,18699,626,560,10,570,2
2021-02-02,Riverside,065,2383286,276654,267901,13008,280909,3169
2021-02-02,Sacramento,067,1510023,89306,87107,1106,88213,1202
2021-02-02,San Benito,069,59416,5505,5444,75,5519,50
2021-02-02,San Bernardino,071,2135413,279191,270486,8232,278718,2244
2021-02-02,San Diego,073,3302833,251886,240047,11979,252026,2629
2021-02-02,San Francisco,075,870044,32404,31788,915,32703,324
2021-02-02,San Joaquin,077,732212,63662,61708,2550,64258,878
2021-02-02,San Luis Obispo,079,281455,18564,17811,496,18307,201
2021-02-02,San Mateo,081,765935,37584,36004,367,36371,225
2021-02-02,Santa Barbara,083,443738,30190,28951,929,29880,304
2021-02-02,Santa Clara,085,1922200,104625,102872,493,103365,1349
2021-02-02,Santa Cruz,087,273765,14702,13572,714,14286,150
2021-02-02,Shasta,089,179085,10485,10371,1107,11478,128
2021-02-02,Sierra,091,2930,49,42,12,54,0
2021-02-02,Siskiyou,093,43540,1357,1252,205,1457,4
2021-02-02,Solano,095,438530,28533,27963,328,28291,118
2021-02-02,Sonoma,097,501317,26408,26054,144,26198,247
2021-02-02,Stanislaus,099,539301,47869,46306,4955,51261,641
2021-02-02,Sutter,101,95872,8466,8340,79,8419,89
2021-02-02,Tehama,103,63373,4412,4289,469,4758,21
2021-02-02,Trinity,105,12862,445,260,66,326,3
2021-02-02,Tulare,107,460477,46245,44720,7046,51766,625
2021-02-02,Tuolumne,109,53932,3551,3548,32,3580,39
2021-02-02,Ventura,111,848112,73386,71557,2599,74156,514
2021-02-02,Yolo,113,214977,12285,11886,187,12073,158
2021-02-02,Yuba,115,75493,5219,5111,77,5188,34
2021-02-01,Alameda,001,1643700,76111,74374,1617,75991,858
2021-02-01,Alpine,003,1148,73,72,0,72,0
2021-02-01,Amador,005,37829,3303,3234,27,3261,32
2021-02-01,Butte,007,227075,10825,10263,1509,11772,141
2021-02-01,Calaveras,009,45235,1817,1785,11,1796,21
2021-02-01,Colusa,011,21464,1786,1763,216,1979,9
2021-02-01,Contra Costa,013,1133247,59203,57324,995,58319,531
2021-02-01,Del Norte,015,27424,897,865,4,869,2
2021-02-01,El Dorado,017,186661,8666,8337,579,8916,83
2021-02-01,Fresno,019,978130,92042,89272,7103,96375,994
2021-02-01,Glenn,021,27897,2142,2086,449,2535,14
2021-02-01,Humboldt,023,135768,2873,2773,18,2791,25
2021-02-01,Imperial,025,180216,26710,26224,2411,28635,530
2021-02-01,Inyo,027,18085,1121,1072,9,1081,27
2021-02-01,Kern,029,883053,89172,86170,8755,94925,862
2021-02-01,Kings,031,150075,21329,20746,895,21641,172
2021-02-01,Lake,033,64148,2929,2843,1,2844,33
2021-02-01,Lassen,035,31185,4972,4907,88,4995,1
2021-02-01,Los Angeles,037,10098052,1132451,1094341,36819,1131160,16695
2021-02-01,Madera,039,155013,14931,14572,737,15309,94
2021-02-01,Marin,041,260295,12553,12341,148,12489,188
2021-02-01,Mariposa,043,17540,360,344,3,347,4
2021-02-01,Mendocino,045,87422,3359,3192,65,3257,37
2021-02-01,Merced,047,269075,26636,26282,783,27065,337
2021-02-01,Modoc,049,8938,319,303,102,405,1
2021-02-01,Mono,051,14174,1139,1145,16,1161,3
2021-02-01,Monterey,053,433212,40116,39196,1448,40644,278
2021-02-01,Napa,055,140530,8611,8449,33,8482,52
2021-02-01,Nevada,057,99092,3710,3535,148,3683,20
2021-02-01,Orange,059,3164182,237732,233155,9655,242810,3100
2021-02-01,Placer,061,380077,19590,18574,1003,19577,204
2021-02-01,Plumas,063,18699,624,554,10,564,2
2021-02-01,Riverside,065,2383286,275716,267025,12971,279996,3092
2021-02-01,Sacramento,067,1510023,88905,86856,1095,87951,1193
2021-02-01,San Benito,069,59416,5487,5432,75,5507,48
2021-02-01,San Bernardino,071,2135413,278496,270012,8192,278204,2172
2021-02-01,San Diego,073,3302833,250661,239121,11903,251024,2619
2021-02-01,San Francisco,075,870044,32269,31703,903,32606,324
2021-02-01,San Joaquin,077,732212,63456,61542,2539,64081,877
2021-02-01,San Luis Obispo,079,281455,18444,17690,489,18179,199
2021-02-01,San Mateo,081,765935,37435,35843,367,36210,220
2021-02-01,Santa Barbara,083,443738,30021,28837,921,29758,297
2021-02-01,Santa Clara,085,1922200,104208,102462,492,102954,1343
2021-02-01,Santa Cruz,087,273765,14649,13524,712,14236,149
2021-02-01,Shasta,089,179085,10460,10329,1101,11430,112
2021-02-01,Sierra,091,2930,49,42,12,54,0
2021-02-01,Siskiyou,093,43540,1350,1238,202,1440,4
2021-02-01,Solano,095,438530,28428,27844,327,28171,117
2021-02-01,Sonoma,097,501317,26320,26011,143,26154,243
2021-02-01,Stanislaus,099,539301,47612,46112,4927,51039,642
2021-02-01,Sutter,101,95872,8427,8313,79,8392,89
2021-02-01,Tehama,103,63373,4386,4263,469,4732,21
2021-02-01,Trinity,105,12862,443,260,66,326,3
2021-02-01,Tulare,107,460477,46100,44569,6965,51534,618
2021-02-01,Tuolumne,109,53932,3543,3534,32,3566,39
2021-02-01,Ventura,111,848112,72981,71104,2582,73686,502
2021-02-01,Yolo,113,214977,12237,11824,179,12003,151
2021-02-01,Yuba,115,75493,5205,5084,76,5160,33
2021-01-31,Alameda,001,1643700,75682,73979,1609,75588,857
2021-01-31,Alpine,003,1148,73,72,0,72,0
2021-01-31,Amador,005,37829,3293,3212,25,3237,32
2021-01-31,Butte,007,227075,10780,10215,1499,11714,140
2021-01-31,Calaveras,009,45235,1797,1778,11,1789,21
2021-01-31,Colusa,011,21464,1780,1754,211,1965,9
2021-01-31,Contra Costa,013,1133247,58871,57079,995,58074,531
2021-01-31,Del Norte,015,27424,895,865,4,869,2
2021-01-31,El Dorado,017,186661,8629,8317,577,8894,83
2021-01-31,Fresno,019,978130,91730,88852,7049,95901,994
2021-01-31,Glenn,021,27897,2132,2083,448,2531,14
2021-01-31,Humboldt,023,135768,2857,2767,18,2785,25
2021-01-31,Imperial,025,180216,26638,26206,2402,28608,530
2021-01-31,Inyo,027,18085,1108,1072,9,1081,27
2021-01-31,Kern,029,883053,88676,85872,8669,94541,861
2021-01-31,Kings,031,150075,21244,20709,883,21592,172
2021-01-31,Lake,033,64148,2908,2826,1,2827,33
2021-01-31,Lassen,035,31185,4956,4900,88,4988,1
2021-01-31,Los Angeles,037,10098052,1127822,1090304,36615,1126919,16609
2021-01-31,Madera,039,155013,14877,14496,729,15225,94
2021-01-31,Marin,041,260295,12506,12297,144,12441,185
2021-01-31,Mariposa,043,17540,358,344,3,347,4
2021-01-31,Mendocino,045,87422,3336,3181,64,3245,37
2021-01-31,Merced,047,269075,26492,26222,778,27000,337
2021-01-31,Modoc,049,8938,316,304,100,404,1
2021-01-31,Mono,051,14174,1136,1146,16,1162,3
2021-01-31,Monterey,053,433212,39937,39035,1421,40456,278
2021-01-31,Napa,055,140530,8569,8404,33,8437,52
2021-01-31,Nevada,057,99092,3688,3518,146,3664,20
2021-01-31,Orange,059,3164182,236715,232347,9614,241961,3053
2021-01-31,Placer,061,380077,19513,18506,992,19498,204
2021-01-31,Plumas,063,18699,623,554,10,564,2
2021-01-31,Riverside,065,2383286,274699,266145,12924,279069,3074
2021-01-31,Sacramento,067,1510023,88463,86560,1081,87641,1186
2021-01-31,San Benito,069,59416,5465,5425,73,5498,48
2021-01-31,San Bernardino,071,2135413,277468,269533,8161,277694,2156
2021-01-31,San Diego,073,3302833,249348,238039,11789,249828,2619
2021-01-31,San Francisco,075,870044,32078,31563,892,32455,323
2021-01-31,San Joaquin,077,732212,63055,61379,2530,63909,877
2021-01-31,San Luis Obispo,079,281455,18310,17615,484,18099,199
2021-01-31,San Mateo,081,765935,37245,35659,364,36023,219
2021-01-31,Santa Barbara,083,443738,29777,28570,912,29482,297
2021-01-31,Santa Clara,085,1922200,103658,101986,483,102469,1330
2021-01-31,Santa Cruz,087,273765,14554,13469,698,14167,149
2021-01-31,Shasta,089,179085,10415,10313,1092,11405,112
2021-01-31,Sierra,091,2930,48,43,12,55,0
2021-01-31,Siskiyou,093,43540,1340,1238,202,1440,4
2021-01-31,Solano,095,438530,28298,27678,326,28004,118
2021-01-31,Sonoma,097,501317,26217,25925,142,26067,243
2021-01-31,Stanislaus,099,539301,47328,45971,4895,50866,642
2021-01-31,Sutter,101,95872,8382,8289,79,8368,89
2021-01-31,Tehama,103,63373,4364,4256,468,4724,21
2021-01-31,Trinity,105,12862,441,260,66,326,3
2021-01-31,Tulare,107,460477,45932,44440,6884,51324,618
2021-01-31,Tuolumne,109,53932,3505,3519,32,3551,39
2021-01-31,Ventura,111,848112,72386,70635,2569,73204,502
2021-01-31,Yolo,113,214977,12176,11771,173,11944,151
2021-01-31,Yuba,115,75493,5185,5071,76,5147,33
2021-01-30,Alameda,001,1643700,75477,73622,1604,75226,850
2021-01-30,Alpine,003,1148,73,72,0,72,0
2021-01-30,Amador,005,37829,3289,3181,25,3206,32
2021-01-30,Butte,007,227075,10746,10177,1490,11667,139
2021-01-30,Calaveras,009,45235,1784,1763,11,1774,21
2021-01-30,Colusa,011,21464,1778,1748,211,1959,9
2021-01-30,Contra Costa,013,1133247,58688,56763,991,57754,531
2021-01-30,Del Norte,015,27424,894,865,4,869,2
2021-01-30,El Dorado,017,186661,8609,8299,576,8875,83
2021-01-30,Fresno,019,978130,91550,88476,7029,95505,964
2021-01-30,Glenn,021,27897,2129,2074,446,2520,14
2021-01-30,Humboldt,023,135768,2846,2742,18,2760,24
2021-01-30,Imperial,025,180216,26614,26160,2400,28560,530
2021-01-30,Inyo,027,18085,1104,1068,9,1077,27
2021-01-30,Kern,029,883053,88475,85572,8603,94175,848
2021-01-30,Kings,031,150075,21173,20605,878,21483,169
2021-01-30,Lake,033,64148,2902,2809,1,2810,33
2021-01-30,Lassen,035,31185,4952,4890,88,4978,1
2021-01-30,Los Angeles,037,10098052,1125423,1084763,36473,1121236,16484
2021-01-30,Madera,039,155013,14835,14443,724,15167,94
2021-01-30,Marin,041,260295,12478,12225,143,12368,185
2021-01-30,Mariposa,043,17540,356,344,3,347,4
2021-01-30,Mendocino,045,87422,3322,3153,63,3216,36
2021-01-30,Merced,047,269075,26418,26078,776,26854,335
2021-01-30,Modoc,049,8938,316,303,100,403,1
2021-01-30,Mono,051,14174,1136,1143,16,1159,3
2021-01-30,Monterey,053,433212,39877,38847,1418,40265,277
2021-01-30,Napa,055,140530,8553,8342,33,8375,52
2021-01-30,Nevada,057,99092,3669,3499,146,3645,20
2021-01-30,Orange,059,3164182,236170,231358,9577,240935,3013
2021-01-30,Placer,061,380077,19460,18430,986,19416,205
2021-01-30,Plumas,063,18699,621,554,10,564,2
2021-01-30,Riverside,065,2383286,274102,265137,12893,278030,3061
2021-01-30,Sacramento,067,1510023,88271,86388,1076,87464,1184
2021-01-30,San Benito,069,59416,5447,5401,72,5473,48
2021-01-30,San Bernardino,071,2135413,277045,268660,8142,276802,2122
2021-01-30,San Diego,073,3302833,248583,236765,11744,248509,2603
2021-01-30,San Francisco,075,870044,31977,31427,889,32316,316
2021-01-30,San Joaquin,077,732212,62923,61120,2521,63641,864
2021-01-30,San Luis Obispo,079,281455,18230,17522,482,18004,198
2021-01-30,San Mateo,081,765935,37106,35451,363,35814,219
2021-01-30,Santa Barbara,083,443738,29635,28342,910,29252,296
2021-01-30,Santa Clara,085,1922200,103311,101471,480,101951,1307
2021-01-30,Santa Cruz,087,273765,14514,13383,697,14080,149
2021-01-30,Shasta,089,179085,10396,10283,1089,11372,112
2021-01-30,Sierra,091,2930,48,43,12,55,0
2021-01-30,Siskiyou,093,43540,1337,1236,201,1437,4
2021-01-30,Solano,095,438530,28215,27511,325,27836,118
2021-01-30,Sonoma,097,501317,26169,25810,139,25949,243
2021-01-30,Stanislaus,099,539301,47198,45697,4868,50565,642
2021-01-30,Sutter,101,95872,8366,8226,79,8305,87
2021-01-30,Tehama,103,63373,4351,4229,467,4696,21
2021-01-30,Trinity,105,12862,441,259,66,325,3
2021-01-30,Tulare,107,460477,45796,44203,6847,51050,615
2021-01-30,Tuolumne,109,53932,3501,3508,32,3540,36
2021-01-30,Ventura,111,848112,72073,69931,2555,72486,493
2021-01-30,Yolo,113,214977,12162,11698,172,11870,151
2021-01-30,Yuba,115,75493,5175,5042,75,5117,33
2021-01-29,Alameda,001,1643700,75209,73210,1597,74807,841
2021-01-29,Alpine,003,1148,73,72,0,72,0
2021-01-29,Amador,005,37829,3277,3134,24,3158,32
2021-01-29,Butte,007,227075,10714,10122,1480,11602,138
2021-01-29,Calaveras,009,45235,1773,1757,11,1768,21
2021-01-29,Colusa,011,21464,1774,1734,210,1944,8
2021-01-29,Contra Costa,013,1133247,58518,56318,989,57307,529
2021-01-29,Del Norte,015,27424,893,865,4,869,2
2021-01-29,El Dorado,017,186661,8592,8231,575,8806,83
2021-01-29,Fresno,019,978130,91335,87936,6991,94927,962
2021-01-29,Glenn,021,27897,2124,2061,445,2506,14
2021-01-29,Humboldt,023,135768,2833,2707,18,2725,24
2021-01-29,Imperial,025,180216,26599,26045,2397,28442,521
2021-01-29,Inyo,027,18085,1092,1048,9,1057,27
2021-01-29,Kern,029,883053,88248,85044,8551,93595,836
2021-01-29,Kings,031,150075,21134,20466,873,21339,169
2021-01-29,Lake,033,64148,2893,2792,1,2793,32
2021-01-29,Lassen,035,31185,4949,4874,88,4962,1
2021-01-29,Los Angeles,037,10098052,1121933,1078329,36320,1114649,16190
2021-01-29,Madera,039,155013,14784,14377,724,15101,94
2021-01-29,Marin,041,260295,12433,12145,142,12287,185
2021-01-29,Mariposa,043,17540,355,342,3,345,4
2021-01-29,Mendocino,045,87422,3313,3131,62,3193,36
2021-01-29,Merced,047,269075,26344,25865,771,26636,334
2021-01-29,Modoc,049,8938,315,297,100,397,1
2021-01-29,Mono,051,14174,1134,1139,16,1155,3
2021-01-29,Monterey,053,433212,39763,38539,1410,39949,277
2021-01-29,Napa,055,140530,8522,8276,33,8309,52
2021-01-29,Nevada,057,99092,3660,3487,145,3632,20
2021-01-29,Orange,059,3164182,235493,229917,9539,239456,2967
2021-01-29,Placer,061,380077,19407,18367,982,19349,203
2021-01-29,Plumas,063,18699,620,548,10,558,2
2021-01-29,Riverside,065,2383286,273300,263504,12860,276364,3008
2021-01-29,Sacramento,067,1510023,88017,86320,1072,87392,1169
2021-01-29,San Benito,069,59416,5439,5386,72,5458,48
2021-01-29,San Bernardino,071,2135413,276533,267490,8102,275592,2095
2021-01-29,San Diego,073,3302833,247641,234637,11666,246303,2571
2021-01-29,San Francisco,075,870044,31837,31294,881,32175,307
2021-01-29,San Joaquin,077,732212,62778,60899,2507,63406,858
2021-01-29,San Luis Obispo,079,281455,18170,17440,477,17917,193
2021-01-29,San Mateo,081,765935,36972,35223,360,35583,218
2021-01-29,Santa Barbara,083,443738,29501,28105,904,29009,291
2021-01-29,Santa Clara,085,1922200,102949,101010,478,101488,1273
2021-01-29,Santa Cruz,087,273765,14461,13311,694,14005,148
2021-01-29,Shasta,089,179085,10379,10220,1085,11305,112
2021-01-29,Sierra,091,2930,48,43,12,55,0
2021-01-29,Siskiyou,093,43540,1336,1227,201,1428,4
2021-01-29,Solano,095,438530,28132,27352,323,27675,116
2021-01-29,Sonoma,097,501317,26113,25710,138,25848,243
2021-01-29,Stanislaus,099,539301,47055,45466,4846,50312,642
2021-01-29,Sutter,101,95872,8347,8181,79,8260,87
2021-01-29,Tehama,103,63373,4339,4191,465,4656,20
2021-01-29,Trinity,105,12862,441,260,66,326,3
2021-01-29,Tulare,107,460477,45689,43925,6808,50733,606
2021-01-29,Tuolumne,109,53932,3491,3483,32,3515,36
2021-01-29,Ventura,111,848112,71649,69511,2541,72052,484
2021-01-29,Yolo,113,214977,12124,11612,171,11783,151
2021-01-29,Yuba,115,75493,5159,5018,75,5093,32
2021-01-28,Alameda,001,1643700,74785,72758,1589,74347,833
2021-01-28,Alpine,003,1148,73,72,0,72,0
2021-01-28,Amador,005,37829,3240,3124,24,3148,31
2021-01-28,Butte,007,227075,10673,10037,1470,11507,138
2021-01-28,Calaveras,009,45235,1760,1747,10,1757,21
2021-01-28,Colusa,011,21464,1767,1731,206,1937,8
2021-01-28,Contra Costa,013,1133247,58277,55999,979,56978,525
2021-01-28,Del Norte,015,27424,892,862,4,866,2
2021-01-28,El Dorado,017,186661,8578,8198,570,8768,79
2021-01-28,Fresno,019,978130,91047,87401,6942,94343,949
2021-01-28,Glenn,021,27897,2119,2043,438,2481,14
2021-01-28,Humboldt,023,135768,2816,2686,18,2704,24
2021-01-28,Imperial,025,180216,26555,25984,2390,28374,517
2021-01-28,Inyo,027,18085,1087,1039,9,1048,27
2021-01-28,Kern,029,883053,87919,84708,8467,93175,817
2021-01-28,Kings,031,150075,21074,20328,869,21197,167
2021-01-28,Lake,033,64148,2878,2772,1,2773,32
2021-01-28,Lassen,035,31185,4943,4865,88,4953,1
2021-01-28,Los Angeles,037,10098052,1118021,1072412,36132,1108544,15967
2021-01-28,Madera,039,155013,14728,14301,720,15021,94
2021-01-28,Marin,041,260295,12380,12079,141,12220,183
2021-01-28,Mariposa,043,17540,355,334,3,337,4
2021-01-28,Mendocino,045,87422,3296,3110,62,3172,36
2021-01-28,Merced,047,269075,26222,25620,759,26379,328
2021-01-28,Modoc,049,8938,314,297,100,397,0
2021-01-28,Mono,051,14174,1132,1131,16,1147,3
2021-01-28,Monterey,053,433212,39569,38312,1391,39703,274
2021-01-28,Napa,055,140530,8475,8233,33,8266,50
2021-01-28,Nevada,057,99092,3645,3452,144,3596,19
2021-01-28,Orange,059,3164182,234513,228636,9509,238145,2860
2021-01-28,Placer,061,380077,19347,18246,979,19225,198
2021-01-28,Plumas,063,18699,619,547,10,557,2
2021-01-28,Riverside,065,2383286,272520,262342,12812,275154,2981
2021-01-28,Sacramento,067,1510023,87654,85698,1061,86759,1149
2021-01-28,San Benito,069,59416,5421,5344,71,5415,47
2021-01-28,San Bernardino,071,2135413,275829,266456,8081,274537,2057
2021-01-28,San Diego,073,3302833,246488,232967,11577,244544,2534
2021-01-28,San Francisco,075,870044,31700,31193,865,32058,290
2021-01-28,San Joaquin,077,732212,62511,60627,2492,63119,854
2021-01-28,San Luis Obispo,079,281455,18070,17279,475,17754,189
2021-01-28,San Mateo,081,765935,36803,34931,344,35275,218
2021-01-28,Santa Barbara,083,443738,29277,27674,891,28565,284
2021-01-28,Santa Clara,085,1922200,102482,100470,476,100946,1219
2021-01-28,Santa Cruz,087,273765,14372,13188,688,13876,145
2021-01-28,Shasta,089,179085,10345,10176,1077,11253,110
2021-01-28,Sierra,091,2930,48,43,12,55,0
2021-01-28,Siskiyou,093,43540,1329,1218,199,1417,4
2021-01-28,Solano,095,438530,27972,27163,322,27485,114
2021-01-28,Sonoma,097,501317,26022,25564,138,25702,236
2021-01-28,Stanislaus,099,539301,46847,45162,4826,49988,640
2021-01-28,Sutter,101,95872,8300,8136,79,8215,85
2021-01-28,Tehama,103,63373,4316,4163,462,4625,20
2021-01-28,Trinity,105,12862,439,260,66,326,3
2021-01-28,Tulare,107,460477,45533,43742,6730,50472,595
2021-01-28,Tuolumne,109,53932,3477,3472,32,3504,32
2021-01-28,Ventura,111,848112,71136,68896,2524,71420,475
2021-01-28,Yolo,113,214977,12081,11500,166,11666,151
2021-01-28,Yuba,115,75493,5143,4994,74,5068,32
2021-01-27,Alameda,001,1643700,74367,72188,1581,73769,815
2021-01-27,Alpine,003,1148,73,72,0,72,0
2021-01-27,Amador,005,37829,3224,3116,24,3140,31
2021-01-27,Butte,007,227075,10634,9988,1457,11445,138
2021-01-27,Calaveras,009,45235,1751,1737,10,1747,21
2021-01-27,Colusa,011,21464,1761,1724,204,1928,8
2021-01-27,Contra Costa,013,1133247,57978,55578,976,56554,507
2021-01-27,Del Norte,015,27424,891,859,4,863,2
2021-01-27,El Dorado,017,186661,8552,8141,569,8710,76
2021-01-27,Fresno,019,978130,90755,86886,6900,93786,938
2021-01-27,Glenn,021,27897,2115,2042,437,2479,14
2021-01-27,Humboldt,023,135768,2794,2630,18,2648,24
2021-01-27,Imperial,025,180216,26501,25861,2375,28236,504
2021-01-27,Inyo,027,18085,1083,1023,9,1032,27
2021-01-27,Kern,029,883053,87608,84244,8397,92641,809
2021-01-27,Kings,031,150075,20968,20211,861,21072,167
2021-01-27,Lake,033,64148,2858,2750,1,2751,32
2021-01-27,Lassen,035,31185,4937,4851,88,4939,1
2021-01-27,Los Angeles,037,10098052,1113210,1066569,35923,1102492,15757
2021-01-27,Madera,039,155013,14687,14194,715,14909,86
2021-01-27,Marin,041,260295,12343,12028,140,12168,180
2021-01-27,Mariposa,043,17540,355,333,3,336,4
2021-01-27,Mendocino,045,87422,3276,3095,62,3157,36
2021-01-27,Merced,047,269075,26063,25439,748,26187,315
2021-01-27,Modoc,049,8938,314,297,97,394,0
2021-01-27,Mono,051,14174,1130,1131,16,1147,3
2021-01-27,Monterey,053,433212,39361,38139,1372,39511,268
2021-01-27,Napa,055,140530,8402,8187,33,8220,46
2021-01-27,Nevada,057,99092,3623,3431,144,3575,18
2021-01-27,Orange,059,3164182,233396,227110,9455,236565,2832
2021-01-27,Placer,061,380077,19277,18106,968,19074,198
2021-01-27,Plumas,063,18699,619,544,10,554,2
2021-01-27,Riverside,065,2383286,271323,260796,12760,273556,2931
2021-01-27,Sacramento,067,1510023,87294,85428,1050,86478,1142
2021-01-27,San Benito,069,59416,5406,5284,71,5355,47
2021-01-27,San Bernardino,071,2135413,274977,265153,8050,273203,2019
2021-01-27,San Diego,073,3302833,245159,231478,11472,242950,2465
2021-01-27,San Francisco,075,870044,31556,31082,858,31940,287
2021-01-27,San Joaquin,077,732212,62241,60131,2471,62602,853
2021-01-27,San Luis Obispo,079,281455,17962,17119,471,17590,188
2021-01-27,San Mateo,081,765935,36648,34619,341,34960,216
2021-01-27,Santa Barbara,083,443738,29100,27435,885,28320,282
2021-01-27,Santa Clara,085,1922200,102078,99732,472,100204,1184
2021-01-27,Santa Cruz,087,273765,14302,13111,685,13796,143
2021-01-27,Shasta,089,179085,10311,10106,1071,11177,105
2021-01-27,Sierra,091,2930,48,44,12,56,0
2021-01-27,Siskiyou,093,43540,1324,1214,196,1410,4
2021-01-27,Solano,095,438530,27795,26982,315,27297,112
2021-01-27,Sonoma,097,501317,25923,25361,134,25495,237
2021-01-27,Stanislaus,099,539301,46663,44874,4800,49674,624
2021-01-27,Sutter,101,95872,8256,8093,78,8171,83
2021-01-27,Tehama,103,63373,4296,4133,458,4591,20
2021-01-27,Trinity,105,12862,439,260,66,326,3
2021-01-27,Tulare,107,460477,45345,43462,6659,50121,583
2021-01-27,Tuolumne,109,53932,3467,3464,32,3496,32
2021-01-27,Ventura,111,848112,70663,68291,2499,70790,468
2021-01-27,Yolo,113,214977,12033,11427,162,11589,151
2021-01-27,Yuba,115,75493,5127,4968,74,5042,32
2021-01-26,Alameda,001,1643700,73995,71851,1564,73415,789
2021-01-26,Alpine,003,1148,73,72,0,72,0
2021-01-26,Amador,005,37829,3213,3113,24,3137,31
2021-01-26,Butte,007,227075,10592,9943,1451,11394,136
2021-01-26,Calaveras,009,45235,1741,1723,10,1733,21
2021-01-26,Colusa,011,21464,1754,1719,201,1920,8
2021-01-26,Contra Costa,013,1133247,57700,55337,968,56305,491
2021-01-26,Del Norte,015,27424,890,856,4,860,2
2021-01-26,El Dorado,017,186661,8526,8115,566,8681,71
2021-01-26,Fresno,019,978130,90397,86673,6856,93529,923
2021-01-26,Glenn,021,27897,2105,2034,432,2466,13
2021-01-26,Humboldt,023,135768,2773,2612,17,2629,24
2021-01-26,Imperial,025,180216,26428,25812,2362,28174,498
2021-01-26,Inyo,027,18085,1076,1018,9,1027,27
2021-01-26,Kern,029,883053,87185,83868,8320,92188,790
2021-01-26,Kings,031,150075,20909,20156,856,21012,159
2021-01-26,Lake,033,64148,2849,2748,1,2749,32
2021-01-26,Lassen,035,31185,4931,4844,88,4932,1
2021-01-26,Los Angeles,037,10098052,1107924,1060492,35720,1096212,15458
2021-01-26,Madera,039,155013,14630,14130,709,14839,86
2021-01-26,Marin,041,260295,12298,11993,138,12131,179
2021-01-26,Mariposa,043,17540,353,332,3,335,3
2021-01-26,Mendocino,045,87422,3250,3076,61,3137,36
2021-01-26,Merced,047,269075,25923,25359,740,26099,309
2021-01-26,Modoc,049,8938,307,291,96,387,0
2021-01-26,Mono,051,14174,1128,1120,16,1136,3
2021-01-26,Monterey,053,433212,39167,37963,1352,39315,255
2021-01-26,Napa,055,140530,8345,8145,33,8178,43
2021-01-26,Nevada,057,99092,3616,3410,143,3553,18
2021-01-26,Orange,059,3164182,232272,225987,9410,235397,2760
2021-01-26,Placer,061,380077,19201,18016,966,18982,193
2021-01-26,Plumas,063,18699,617,536,10,546,2
2021-01-26,Riverside,065,2383286,269956,259399,12696,272095,2898
2021-01-26,Sacramento,067,1510023,86936,85062,1043,86105,1127
2021-01-26,San Benito,069,59416,5392,5251,70,5321,45
2021-01-26,San Bernardino,071,2135413,273976,263736,8006,271742,1970
2021-01-26,San Diego,073,3302833,243664,230063,11370,241433,2421
2021-01-26,San Francisco,075,870044,31424,30874,839,31713,286
2021-01-26,San Joaquin,077,732212,61987,59889,2455,62344,847
2021-01-26,San Luis Obispo,079,281455,17881,17016,468,17484,186
2021-01-26,San Mateo,081,765935,36454,34441,330,34771,213
2021-01-26,Santa Barbara,083,443738,28925,27321,873,28194,273
2021-01-26,Santa Clara,085,1922200,101599,99215,469,99684,1171
2021-01-26,Santa Cruz,087,273765,14236,13045,679,13724,134
2021-01-26,Shasta,089,179085,10276,10036,1063,11099,103
2021-01-26,Sierra,091,2930,48,43,12,55,0
2021-01-26,Siskiyou,093,43540,1309,1208,194,1402,4
2021-01-26,Solano,095,438530,27639,26858,308,27166,110
2021-01-26,Sonoma,097,501317,25804,25273,132,25405,236
2021-01-26,Stanislaus,099,539301,46481,44703,4758,49461,599
2021-01-26,Sutter,101,95872,8213,8067,78,8145,83
2021-01-26,Tehama,103,63373,4263,4115,458,4573,20
2021-01-26,Trinity,105,12862,439,260,66,326,3
2021-01-26,Tulare,107,460477,45142,43394,6589,49983,579
2021-01-26,Tuolumne,109,53932,3457,3451,32,3483,30
2021-01-26,Ventura,111,848112,70130,67526,2473,69999,448
2021-01-26,Yolo,113,214977,11988,11361,159,11520,148
2021-01-26,Yuba,115,75493,5102,4944,72,5016,31
2021-01-25,Alameda,001,1643700,73566,71255,1554,72809,780
2021-01-25,Alpine,003,1148,73,72,0,72,0
2021-01-25,Amador,005,37829,3173,3074,24,3098,30
2021-01-25,Butte,007,227075,10525,9865,1443,11308,133
2021-01-25,Calaveras,009,45235,1726,1713,10,1723,21
2021-01-25,Colusa,011,21464,1742,1709,197,1906,8
2021-01-25,Contra Costa,013,1133247,57345,54989,961,55950,488
2021-01-25,Del Norte,015,27424,889,855,4,859,2
2021-01-25,El Dorado,017,186661,8501,8060,566,8626,66
2021-01-25,Fresno,019,978130,90026,86336,6824,93160,913
2021-01-25,Glenn,021,27897,2096,2028,432,2460,13
2021-01-25,Humboldt,023,135768,2739,2587,17,2604,24
2021-01-25,Imperial,025,180216,26379,25745,2354,28099,491
2021-01-25,Inyo,027,18085,1070,1015,9,1024,27
2021-01-25,Kern,029,883053,86799,83401,8234,91635,787
2021-01-25,Kings,031,150075,20789,20067,852,20919,159
2021-01-25,Lake,033,64148,2830,2729,1,2730,32
2021-01-25,Lassen,035,31185,4904,4835,88,4923,1
2021-01-25,Los Angeles,037,10098052,1101968,1055181,35491,1090672,15163
2021-01-25,Madera,039,155013,14576,14068,704,14772,86
2021-01-25,Marin,041,260295,12246,11923,134,12057,177
2021-01-25,Mariposa,043,17540,350,331,3,334,3
2021-01-25,Mendocino,045,87422,3239,3054,61,3115,35
2021-01-25,Merced,047,269075,25784,25181,731,25912,305
2021-01-25,Modoc,049,8938,306,288,92,380,0
2021-01-25,Mono,051,14174,1125,1114,15,1129,3
2021-01-25,Monterey,053,433212,38914,37726,1333,39059,255
2021-01-25,Napa,055,140530,8311,8057,32,8089,43
2021-01-25,Nevada,057,99092,3602,3365,143,3508,18
2021-01-25,Orange,059,3164182,231063,225105,9364,234469,2696
2021-01-25,Placer,061,380077,19113,17936,951,18887,193
2021-01-25,Plumas,063,18699,614,533,10,543,2
2021-01-25,Riverside,065,2383286,268217,258082,12640,270722,2789
2021-01-25,Sacramento,067,1510023,86494,84653,1035,85688,1118
2021-01-25,San Benito,069,59416,5357,5238,69,5307,43
2021-01-25,San Bernardino,071,2135413,273031,263174,7970,271144,1947
2021-01-25,San Diego,073,3302833,242051,228630,11298,239928,2375
2021-01-25,San Francisco,075,870044,31274,30734,816,31550,288
2021-01-25,San Joaquin,077,732212,61693,59291,2430,61721,838
2021-01-25,San Luis Obispo,079,281455,17747,16868,463,17331,179
2021-01-25,San Mateo,081,765935,36220,34187,324,34511,213
2021-01-25,Santa Barbara,083,443738,28690,27065,863,27928,269
2021-01-25,Santa Clara,085,1922200,101032,98647,461,99108,1143
2021-01-25,Santa Cruz,087,273765,14149,12973,674,13647,133
2021-01-25,Shasta,089,179085,10235,9991,1052,11043,103
2021-01-25,Sierra,091,2930,48,42,12,54,0
2021-01-25,Siskiyou,093,43540,1301,1205,191,1396,4
2021-01-25,Solano,095,438530,27471,26648,307,26955,109
2021-01-25,Sonoma,097,501317,25697,25160,130,25290,233
2021-01-25,Stanislaus,099,539301,46235,44293,4715,49008,599
2021-01-25,Sutter,101,95872,8170,8023,78,8101,83
2021-01-25,Tehama,103,63373,4236,4082,454,4536,20
2021-01-25,Trinity,105,12862,439,262,66,328,3
2021-01-25,Tulare,107,460477,44926,43124,6485,49609,578
2021-01-25,Tuolumne,109,53932,3448,3422,32,3454,29
2021-01-25,Ventura,111,848112,69496,66910,2456,69366,439
2021-01-25,Yolo,113,214977,11902,11276,158,11434,140
2021-01-25,Yuba,115,75493,5080,4900,70,4970,31
2021-01-24,Alameda,001,1643700,73062,70823,1543,72366,780
2021-01-24,Alpine,003,1148,73,72,0,72,0
2021-01-24,Amador,005,37829,3140,3054,24,3078,30
2021-01-24,Butte,007,227075,10441,9820,1426,11246,133
2021-01-24,Calaveras,009,45235,1713,1704,10,1714,21
2021-01-24,Colusa,011,21464,1731,1689,191,1880,8
2021-01-24,Contra Costa,013,1133247,56958,54694,948,55642,488
2021-01-24,Del Norte,015,27424,885,855,4,859,2
2021-01-24,El Dorado,017,186661,8466,8003,562,8565,66
2021-01-24,Fresno,019,978130,89588,85808,6785,92593,911
2021-01-24,Glenn,021,27897,2088,2026,431,2457,13
2021-01-24,Humboldt,023,135768,2700,2562,17,2579,24
2021-01-24,Imperial,025,180216,26284,25707,2330,28037,488
2021-01-24,Inyo,027,18085,1054,1007,9,1016,27
2021-01-24,Kern,029,883053,86363,83125,8126,91251,785
2021-01-24,Kings,031,150075,20661,19988,836,20824,159
2021-01-24,Lake,033,64148,2812,2724,0,2724,32
2021-01-24,Lassen,035,31185,4893,4828,85,4913,1
2021-01-24,Los Angeles,037,10098052,1095562,1048757,35180,1083937,15119
2021-01-24,Madera,039,155013,14486,14000,698,14698,86
2021-01-24,Marin,041,260295,12179,11872,132,12004,177
2021-01-24,Mariposa,043,17540,346,322,3,325,3
2021-01-24,Mendocino,045,87422,3218,3037,60,3097,33
2021-01-24,Merced,047,269075,25573,25047,721,25768,305
2021-01-24,Modoc,049,8938,306,285,92,377,0
2021-01-24,Mono,051,14174,1118,1113,15,1128,3
2021-01-24,Monterey,053,433212,38643,37527,1299,38826,254
2021-01-24,Napa,055,140530,8269,8005,32,8037,43
2021-01-24,Nevada,057,99092,3560,3349,141,3490,18
2021-01-24,Orange,059,3164182,229632,223853,9294,233147,2632
2021-01-24,Placer,061,380077,19000,17839,931,18770,193
2021-01-24,Plumas,063,18699,611,532,10,542,2
2021-01-24,Riverside,065,2383286,266576,256767,12563,269330,2761
2021-01-24,Sacramento,067,1510023,85940,84110,1027,85137,1112
2021-01-24,San Benito,069,59416,5315,5223,66,5289,43
2021-01-24,San Bernardino,071,2135413,271705,262370,7916,270286,1935
2021-01-24,San Diego,073,3302833,240357,227193,11167,238360,2375
2021-01-24,San Francisco,075,870044,31086,30559,794,31353,275
2021-01-24,San Joaquin,077,732212,61265,59021,2414,61435,838
2021-01-24,San Luis Obispo,079,281455,17623,16758,461,17219,179
2021-01-24,San Mateo,081,765935,35974,33956,319,34275,213
2021-01-24,Santa Barbara,083,443738,28374,26735,853,27588,269
2021-01-24,Santa Clara,085,1922200,100384,98103,456,98559,1109
2021-01-24,Santa Cruz,087,273765,14063,12905,666,13571,133
2021-01-24,Shasta,089,179085,10164,9978,1043,11021,103
2021-01-24,Sierra,091,2930,47,42,12,54,0
2021-01-24,Siskiyou,093,43540,1294,1195,191,1386,4
2021-01-24,Solano,095,438530,27283,26515,303,26818,109
2021-01-24,Sonoma,097,501317,25535,25045,129,25174,233
2021-01-24,Stanislaus,099,539301,45926,44031,4653,48684,599
2021-01-24,Sutter,101,95872,8106,7980,78,8058,83
2021-01-24,Tehama,103,63373,4196,4062,449,4511,20
2021-01-24,Trinity,105,12862,439,262,66,328,3
2021-01-24,Tulare,107,460477,44707,43006,6392,49398,577
2021-01-24,Tuolumne,109,53932,3437,3416,32,3448,29
2021-01-24,Ventura,111,848112,68785,66347,2432,68779,439
2021-01-24,Yolo,113,214977,11818,11210,154,11364,140
2021-01-24,Yuba,115,75493,5040,4875,69,4944,31
2021-01-23,Alameda,001,1643700,72814,70080,1536,71616,780
2021-01-23,Alpine,003,1148,73,72,0,72,0
2021-01-23,Amador,005,37829,3137,3049,24,3073,30
2021-01-23,Butte,007,227075,10412,9757,1423,11180,133
2021-01-23,Calaveras,009,45235,1710,1695,10,1705,21
2021-01-23,Colusa,011,21464,1727,1672,190,1862,8
2021-01-23,Contra Costa,013,1133247,56745,54162,941,55103,487
2021-01-23,Del Norte,015,27424,884,855,4,859,2
2021-01-23,El Dorado,017,186661,8450,7984,560,8544,66
2021-01-23,Fresno,019,978130,89402,85274,6756,92030,910
2021-01-23,Glenn,021,27897,2085,2015,427,2442,13
2021-01-23,Humboldt,023,135768,2681,2493,16,2509,23
2021-01-23,Imperial,025,180216,26250,25581,2320,27901,487
2021-01-23,Inyo,027,18085,1045,987,9,996,27
2021-01-23,Kern,029,883053,86119,82602,8058,90660,783
2021-01-23,Kings,031,150075,20617,19904,834,20738,159
2021-01-23,Lake,033,64148,2804,2673,0,2673,32
2021-01-23,Lassen,035,31185,4892,4816,82,4898,1
2021-01-23,Los Angeles,037,10098052,1092333,1040961,35019,1075980,15034
2021-01-23,Madera,039,155013,14450,13858,695,14553,86
2021-01-23,Marin,041,260295,12123,11796,130,11926,177
2021-01-23,Mariposa,043,17540,346,323,3,326,3
2021-01-23,Mendocino,045,87422,3204,2991,60,3051,32
2021-01-23,Merced,047,269075,25481,24787,706,25493,303
2021-01-23,Modoc,049,8938,306,285,92,377,0
2021-01-23,Mono,051,14174,1116,1111,15,1126,3
2021-01-23,Monterey,053,433212,38560,37165,1294,38459,253
2021-01-23,Napa,055,140530,8244,7893,32,7925,43
2021-01-23,Nevada,057,99092,3549,3332,140,3472,18
2021-01-23,Orange,059,3164182,228864,221722,9254,230976,2618
2021-01-23,Placer,061,380077,18949,17617,926,18543,193
2021-01-23,Plumas,063,18699,610,528,10,538,2
2021-01-23,Riverside,065,2383286,265676,253636,12511,266147,2733
2021-01-23,Sacramento,067,1510023,85711,83408,1024,84432,1108
2021-01-23,San Benito,069,59416,5291,5166,65,5231,43
2021-01-23,San Bernardino,071,2135413,271154,260381,7885,268266,1922
2021-01-23,San Diego,073,3302833,239296,225556,11095,236651,2344
2021-01-23,San Francisco,075,870044,30981,30308,765,31073,268
2021-01-23,San Joaquin,077,732212,61139,58164,2404,60568,836
2021-01-23,San Luis Obispo,079,281455,17559,16652,458,17110,176
2021-01-23,San Mateo,081,765935,35798,33696,308,34004,213
2021-01-23,Santa Barbara,083,443738,28189,26234,844,27078,264
2021-01-23,Santa Clara,085,1922200,100029,97189,455,97644,1086
2021-01-23,Santa Cruz,087,273765,14005,12771,663,13434,127
2021-01-23,Shasta,089,179085,10135,9951,1042,10993,103
2021-01-23,Sierra,091,2930,47,41,12,53,0
2021-01-23,Siskiyou,093,43540,1284,1190,190,1380,4
2021-01-23,Solano,095,438530,27190,26261,301,26562,107
2021-01-23,Sonoma,097,501317,25455,24790,129,24919,232
2021-01-23,Stanislaus,099,539301,45759,43723,4622,48345,599
2021-01-23,Sutter,101,95872,8088,7943,77,8020,80
2021-01-23,Tehama,103,63373,4177,4006,448,4454,20
2021-01-23,Trinity,105,12862,439,262,66,328,3
2021-01-23,Tulare,107,460477,44554,42661,6332,48993,575
2021-01-23,Tuolumne,109,53932,3430,3407,32,3439,29
2021-01-23,Ventura,111,848112,68335,65581,2409,67990,438
2021-01-23,Yolo,113,214977,11776,11087,150,11237,141
2021-01-23,Yuba,115,75493,5028,4831,68,4899,30
2021-01-22,Alameda,001,1643700,72493,69693,1530,71223,751
2021-01-22,Alpine,003,1148,73,71,0,71,0
2021-01-22,Amador,005,37829,3132,3042,24,3066,30
2021-01-22,Butte,007,227075,10367,9711,1410,11121,133
2021-01-22,Calaveras,009,45235,1701,1672,10,1682,21
2021-01-22,Colusa,011,21464,1725,1668,190,1858,7
2021-01-22,Contra Costa,013,1133247,56508,53887,935,54822,485
2021-01-22,Del Norte,015,27424,883,852,4,856,2
2021-01-22,El Dorado,017,186661,8416,7877,557,8434,64
2021-01-22,Fresno,019,978130,89061,84744,6728,91472,892
2021-01-22,Glenn,021,27897,2080,1985,421,2406,13
2021-01-22,Humboldt,023,135768,2657,2452,16,2468,23
2021-01-22,Imperial,025,180216,26215,25562,2305,27867,474
2021-01-22,Inyo,027,18085,1034,961,9,970,26
2021-01-22,Kern,029,883053,85822,82101,7982,90083,771
2021-01-22,Kings,031,150075,20541,19760,830,20590,159
2021-01-22,Lake,033,64148,2792,2681,0,2681,32
2021-01-22,Lassen,035,31185,4883,4765,81,4846,1
2021-01-22,Los Angeles,037,10098052,1087868,1031177,34828,1066005,14777
2021-01-22,Madera,039,155013,14390,13781,694,14475,86
2021-01-22,Marin,041,260295,12087,11769,128,11897,177
2021-01-22,Mariposa,043,17540,346,323,3,326,3
2021-01-22,Mendocino,045,87422,3179,2994,59,3053,32
2021-01-22,Merced,047,269075,25358,24616,698,25314,290
2021-01-22,Modoc,049,8938,306,285,92,377,0
2021-01-22,Mono,051,14174,1116,1108,15,1123,3
2021-01-22,Monterey,053,433212,38408,36909,1289,38198,253
2021-01-22,Napa,055,140530,8198,7828,32,7860,40
2021-01-22,Nevada,057,99092,3524,3296,139,3435,18
2021-01-22,Orange,059,3164182,227911,220384,9207,229591,2542
2021-01-22,Placer,061,380077,18892,17636,911,18547,193
2021-01-22,Plumas,063,18699,608,522,10,532,2
2021-01-22,Riverside,065,2383286,264531,252440,12443,264883,2710
2021-01-22,Sacramento,067,1510023,85381,82861,1016,83877,1094
2021-01-22,San Benito,069,59416,5265,5143,65,5208,43
2021-01-22,San Bernardino,071,2135413,270338,259121,7853,266974,1849
2021-01-22,San Diego,073,3302833,238056,222576,11030,233606,2301
2021-01-22,San Francisco,075,870044,30868,30027,748,30775,266
2021-01-22,San Joaquin,077,732212,60958,58485,2392,60877,812
2021-01-22,San Luis Obispo,079,281455,17470,16336,455,16791,172
2021-01-22,San Mateo,081,765935,35576,33401,305,33706,211
2021-01-22,Santa Barbara,083,443738,27988,25989,833,26822,256
2021-01-22,Santa Clara,085,1922200,99590,96435,452,96887,1062
2021-01-22,Santa Cruz,087,273765,13947,12687,659,13346,123
2021-01-22,Shasta,089,179085,10115,9866,1040,10906,103
2021-01-22,Sierra,091,2930,47,40,12,52,0
2021-01-22,Siskiyou,093,43540,1280,1182,188,1370,4
2021-01-22,Solano,095,438530,27100,26048,299,26347,107
2021-01-22,Sonoma,097,501317,25370,24659,129,24788,232
2021-01-22,Stanislaus,099,539301,45593,43489,4596,48085,599
2021-01-22,Sutter,101,95872,8063,7878,77,7955,80
2021-01-22,Tehama,103,63373,4161,3993,446,4439,19
2021-01-22,Trinity,105,12862,438,263,66,329,3
2021-01-22,Tulare,107,460477,44374,42307,6263,48570,573
2021-01-22,Tuolumne,109,53932,3402,3379,32,3411,29
2021-01-22,Ventura,111,848112,67829,64404,2391,66795,426
2021-01-22,Yolo,113,214977,11742,11014,143,11157,141
2021-01-22,Yuba,115,75493,5004,4789,66,4855,29
2021-01-21,Alameda,001,1643700,72057,69314,1513,70827,739
2021-01-21,Alpine,003,1148,73,71,0,71,0
2021-01-21,Amador,005,37829,3110,3038,24,3062,29
2021-01-21,Butte,007,227075,10302,9643,1404,11047,130
2021-01-21,Calaveras,009,45235,1692,1647,10,1657,21
2021-01-21,Colusa,011,21464,1718,1662,187,1849,7
2021-01-21,Contra Costa,013,1133247,56096,53595,921,54516,478
2021-01-21,Del Norte,015,27424,881,850,3,853,2
2021-01-21,El Dorado,017,186661,8367,7823,554,8377,58
2021-01-21,Fresno,019,978130,88657,84137,6688,90825,889
2021-01-21,Glenn,021,27897,2072,1964,416,2380,13
2021-01-21,Humboldt,023,135768,2634,2423,16,2439,23
2021-01-21,Imperial,025,180216,26125,25509,2291,27800,463
2021-01-21,Inyo,027,18085,1025,946,9,955,26
2021-01-21,Kern,029,883053,85410,81328,7867,89195,769
2021-01-21,Kings,031,150075,20470,19633,812,20445,158
2021-01-21,Lake,033,64148,2777,2669,0,2669,32
2021-01-21,Lassen,035,31185,4876,4763,81,4844,1
2021-01-21,Los Angeles,037,10098052,1081204,1023055,34509,1057564,14537
2021-01-21,Madera,039,155013,14322,13664,686,14350,86
2021-01-21,Marin,041,260295,12032,11732,126,11858,173
2021-01-21,Mariposa,043,17540,342,322,3,325,3
2021-01-21,Mendocino,045,87422,3156,2967,57,3024,32
2021-01-21,Merced,047,269075,25203,24426,691,25117,245
2021-01-21,Modoc,049,8938,303,284,91,375,0
2021-01-21,Mono,051,14174,1111,1104,15,1119,3
2021-01-21,Monterey,053,433212,38127,36149,1279,37428,253
2021-01-21,Napa,055,140530,8134,7774,32,7806,40
2021-01-21,Nevada,057,99092,3495,3274,138,3412,18
2021-01-21,Orange,059,3164182,226533,218867,9152,228019,2540
2021-01-21,Placer,061,380077,18813,17553,907,18460,190
2021-01-21,Plumas,063,18699,604,518,10,528,2
2021-01-21,Riverside,065,2383286,262809,251007,12365,263372,2676
2021-01-21,Sacramento,067,1510023,84902,82303,995,83298,1084
2021-01-21,San Benito,069,59416,5235,5100,60,5160,43
2021-01-21,San Bernardino,071,2135413,268994,257754,7788,265542,1832
2021-01-21,San Diego,073,3302833,236281,219729,10923,230652,2222
2021-01-21,San Francisco,075,870044,30691,29801,714,30515,266
2021-01-21,San Joaquin,077,732212,60648,58270,2372,60642,806
2021-01-21,San Luis Obispo,079,281455,17384,16153,447,16600,169
2021-01-21,San Mateo,081,765935,35330,33156,292,33448,210
2021-01-21,Santa Barbara,083,443738,27700,25654,820,26474,253
2021-01-21,Santa Clara,085,1922200,98966,96028,445,96473,1062
2021-01-21,Santa Cruz,087,273765,13862,12548,649,13197,119
2021-01-21,Shasta,089,179085,10072,9795,1025,10820,98
2021-01-21,Sierra,091,2930,47,40,12,52,0
2021-01-21,Siskiyou,093,43540,1277,1178,186,1364,4
2021-01-21,Solano,095,438530,26920,25885,295,26180,106
2021-01-21,Sonoma,097,501317,25230,24440,127,24567,230
2021-01-21,Stanislaus,099,539301,45295,43223,4552,47775,599
2021-01-21,Sutter,101,95872,8029,7822,77,7899,80
2021-01-21,Tehama,103,63373,4122,3938,446,4384,19
2021-01-21,Trinity,105,12862,438,261,66,327,3
2021-01-21,Tulare,107,460477,44163,42082,6187,48269,569
2021-01-21,Tuolumne,109,53932,3392,3365,31,3396,29
2021-01-21,Ventura,111,848112,67135,63995,2370,66365,420
2021-01-21,Yolo,113,214977,11651,10940,135,11075,141
2021-01-21,Yuba,115,75493,4972,4757,65,4822,29
2021-01-20,Alameda,001,1643700,71580,68785,1498,70283,702
2021-01-20,Alpine,003,1148,73,71,0,71,0
2021-01-20,Amador,005,37829,3079,3036,24,3060,29
2021-01-20,Butte,007,227075,10246,9582,1393,10975,130
2021-01-20,Calaveras,009,45235,1670,1637,9,1646,21
2021-01-20,Colusa,011,21464,1701,1630,182,1812,7
2021-01-20,Contra Costa,013,1133247,55638,53108,914,54022,461
2021-01-20,Del Norte,015,27424,880,848,3,851,2
2021-01-20,El Dorado,017,186661,8317,7785,551,8336,53
2021-01-20,Fresno,019,978130,88238,83591,6635,90226,872
2021-01-20,Glenn,021,27897,2053,1955,414,2369,13
2021-01-20,Humboldt,023,135768,2591,2390,16,2406,22
2021-01-20,Imperial,025,180216,26053,25380,2256,27636,461
2021-01-20,Inyo,027,18085,1015,901,9,910,26
2021-01-20,Kern,029,883053,84960,80701,7759,88460,754
2021-01-20,Kings,031,150075,20380,19522,804,20326,146
2021-01-20,Lake,033,64148,2756,2646,0,2646,31
2021-01-20,Lassen,035,31185,4868,4758,79,4837,1
2021-01-20,Los Angeles,037,10098052,1073706,1015608,34223,1049831,14299
2021-01-20,Madera,039,155013,14258,13585,681,14266,86
2021-01-20,Marin,041,260295,11978,11684,124,11808,171
2021-01-20,Mariposa,043,17540,340,322,3,325,3
2021-01-20,Mendocino,045,87422,3141,2957,57,3014,32
2021-01-20,Merced,047,269075,25030,24220,669,24889,243
2021-01-20,Modoc,049,8938,302,282,91,373,0
2021-01-20,Mono,051,14174,1104,1105,14,1119,3
2021-01-20,Monterey,053,433212,37815,35960,1259,37219,249
2021-01-20,Napa,055,140530,8065,7731,31,7762,40
2021-01-20,Nevada,057,99092,3463,3238,138,3376,18
2021-01-20,Orange,059,3164182,224998,216893,9090,225983,2500
2021-01-20,Placer,061,380077,18719,17455,889,18344,186
2021-01-20,Plumas,063,18699,602,512,10,522,2
2021-01-20,Riverside,065,2383286,260764,248686,12280,260966,2615
2021-01-20,Sacramento,067,1510023,84342,81687,985,82672,1072
2021-01-20,San Benito,069,59416,5204,5036,59,5095,35
2021-01-20,San Bernardino,071,2135413,267643,255921,7740,263661,1801
2021-01-20,San Diego,073,3302833,234426,218553,10819,229372,2174
2021-01-20,San Francisco,075,870044,30503,29665,694,30359,262
2021-01-20,San Joaquin,077,732212,60244,58025,2363,60388,783
2021-01-20,San Luis Obispo,079,281455,17203,15936,438,16374,164
2021-01-20,San Mateo,081,765935,35103,32929,291,33220,210
2021-01-20,Santa Barbara,083,443738,27383,25312,808,26120,248
2021-01-20,Santa Clara,085,1922200,98286,94995,443,95438,1040
2021-01-20,Santa Cruz,087,273765,13755,12460,636,13096,107
2021-01-20,Shasta,089,179085,10020,9697,1015,10712,98
2021-01-20,Sierra,091,2930,47,40,12,52,0
2021-01-20,Siskiyou,093,43540,1270,1163,185,1348,4
2021-01-20,Solano,095,438530,26727,25659,291,25950,106
2021-01-20,Sonoma,097,501317,25093,24262,125,24387,223
2021-01-20,Stanislaus,099,539301,45015,42955,4514,47469,585
2021-01-20,Sutter,101,95872,7978,7772,75,7847,80
2021-01-20,Tehama,103,63373,4096,3892,444,4336,19
2021-01-20,Trinity,105,12862,438,260,66,326,3
2021-01-20,Tulare,107,460477,43905,41799,6094,47893,559
2021-01-20,Tuolumne,109,53932,3377,3355,30,3385,29
2021-01-20,Ventura,111,848112,66175,63413,2341,65754,395
2021-01-20,Yolo,113,214977,11583,10852,132,10984,141
2021-01-20,Yuba,115,75493,4945,4729,65,4794,29
2021-01-19,Alameda,001,1643700,70936,68434,1489,69923,680
2021-01-19,Alpine,003,1148,73,71,0,71,0
2021-01-19,Amador,005,37829,3070,3024,24,3048,28
2021-01-19,Butte,007,227075,10182,9528,1378,10906,129
2021-01-19,Calaveras,009,45235,1655,1621,8,1629,21
2021-01-19,Colusa,011,21464,1679,1617,179,1796,7
2021-01-19,Contra Costa,013,1133247,55145,52730,903,53633,448
2021-01-19,Del Norte,015,27424,878,843,3,846,2
2021-01-19,El Dorado,017,186661,8257,7743,543,8286,47
2021-01-19,Fresno,019,978130,87716,83200,6583,89783,857
2021-01-19,Glenn,021,27897,2041,1948,409,2357,13
2021-01-19,Humboldt,023,135768,2567,2359,13,2372,22
2021-01-19,Imperial,025,180216,25972,25333,2240,27573,452
2021-01-19,Inyo,027,18085,1008,891,9,900,26
2021-01-19,Kern,029,883053,84371,80272,7651,87923,742
2021-01-19,Kings,031,150075,20241,19375,793,20168,143
2021-01-19,Lake,033,64148,2741,2625,0,2625,31
2021-01-19,Lassen,035,31185,4861,4753,79,4832,1
2021-01-19,Los Angeles,037,10098052,1065029,1010375,33952,1044327,14014
2021-01-19,Madera,039,155013,14142,13528,674,14202,86
2021-01-19,Marin,041,260295,11921,11654,120,11774,169
2021-01-19,Mariposa,043,17540,340,322,3,325,3
2021-01-19,Mendocino,045,87422,3124,2930,57,2987,32
2021-01-19,Merced,047,269075,24818,24108,660,24768,242
2021-01-19,Modoc,049,8938,301,281,91,372,0
2021-01-19,Mono,051,14174,1103,1106,14,1120,3
2021-01-19,Monterey,053,433212,37513,35840,1238,37078,248
2021-01-19,Napa,055,140530,8006,7672,31,7703,38
2021-01-19,Nevada,057,99092,3445,3216,136,3352,18
2021-01-19,Orange,059,3164182,223262,215244,9022,224266,2468
2021-01-19,Placer,061,380077,18622,17348,879,18227,182
2021-01-19,Plumas,063,18699,595,509,10,519,2
2021-01-19,Riverside,065,2383286,258678,246248,12201,258449,2585
2021-01-19,Sacramento,067,1510023,83805,81183,965,82148,1053
2021-01-19,San Benito,069,59416,5158,4988,58,5046,35
2021-01-19,San Bernardino,071,2135413,265918,253651,7684,261335,1777
2021-01-19,San Diego,073,3302833,232003,216833,10721,227554,2109
2021-01-19,San Francisco,075,870044,30284,29502,663,30165,261
2021-01-19,San Joaquin,077,732212,59862,57655,2351,60006,782
2021-01-19,San Luis Obispo,079,281455,16939,15855,435,16290,161
2021-01-19,San Mateo,081,765935,34818,32730,280,33010,208
2021-01-19,Santa Barbara,083,443738,26999,24991,792,25783,236
2021-01-19,Santa Clara,085,1922200,97514,94483,441,94924,1010
2021-01-19,Santa Cruz,087,273765,13638,12410,628,13038,106
2021-01-19,Shasta,089,179085,9984,9614,1005,10619,93
2021-01-19,Sierra,091,2930,47,40,10,50,0
2021-01-19,Siskiyou,093,43540,1262,1149,183,1332,4
2021-01-19,Solano,095,438530,26480,25520,290,25810,106
2021-01-19,Sonoma,097,501317,24913,24133,123,24256,223
2021-01-19,Stanislaus,099,539301,44667,42723,4469,47192,561
2021-01-19,Sutter,101,95872,7928,7709,69,7778,80
2021-01-19,Tehama,103,63373,4064,3876,442,4318,19
2021-01-19,Trinity,105,12862,437,260,66,326,3
2021-01-19,Tulare,107,460477,43627,41559,5998,47557,549
2021-01-19,Tuolumne,109,53932,3350,3328,30,3358,29
2021-01-19,Ventura,111,848112,65496,62656,2314,64970,383
2021-01-19,Yolo,113,214977,11496,10789,131,10920,134
2021-01-19,Yuba,115,75493,4912,4695,64,4759,29
2021-01-18,Alameda,001,1643700,70304,67938,1471,69409,680
2021-01-18,Alpine,003,1148,73,71,0,71,0
2021-01-18,Amador,005,37829,3056,3016,24,3040,28
2021-01-18,Butte,007,227075,10097,9474,1367,10841,129
2021-01-18,Calaveras,009,45235,1634,1617,7,1624,21
2021-01-18,Colusa,011,21464,1662,1608,178,1786,7
2021-01-18,Contra Costa,013,1133247,54629,52323,895,53218,448
2021-01-18,Del Norte,015,27424,877,840,3,843,2
2021-01-18,El Dorado,017,186661,8189,7707,541,8248,47
2021-01-18,Fresno,019,978130,87104,82485,6516,89001,857
2021-01-18,Glenn,021,27897,2024,1935,405,2340,13
2021-01-18,Humboldt,023,135768,2529,2343,13,2356,22
2021-01-18,Imperial,025,180216,25903,25317,2215,27532,452
2021-01-18,Inyo,027,18085,996,872,9,881,26
2021-01-18,Kern,029,883053,83734,79930,7560,87490,740
2021-01-18,Kings,031,150075,20071,19267,781,20048,141
2021-01-18,Lake,033,64148,2724,2591,0,2591,30
2021-01-18,Lassen,035,31185,4825,4749,78,4827,1
2021-01-18,Los Angeles,037,10098052,1055528,1002614,33663,1036277,13828
2021-01-18,Madera,039,155013,14029,13443,666,14109,85
2021-01-18,Marin,041,260295,11874,11607,118,11725,165
2021-01-18,Mariposa,043,17540,337,320,2,322,3
2021-01-18,Mendocino,045,87422,3101,2919,57,2976,31
2021-01-18,Merced,047,269075,24573,23927,644,24571,242
2021-01-18,Modoc,049,8938,298,281,88,369,0
2021-01-18,Mono,051,14174,1100,1101,14,1115,3
2021-01-18,Monterey,053,433212,37071,35549,1224,36773,247
2021-01-18,Napa,055,140530,7932,7601,31,7632,38
2021-01-18,Nevada,057,99092,3407,3199,135,3334,17
2021-01-18,Orange,059,3164182,221364,213866,8966,222832,2405
2021-01-18,Placer,061,380077,18506,17263,870,18133,182
2021-01-18,Plumas,063,18699,592,506,10,516,2
2021-01-18,Riverside,065,2383286,256366,244151,12108,256259,2568
2021-01-18,Sacramento,067,1510023,83135,80546,949,81495,1046
2021-01-18,San Benito,069,59416,5110,4963,56,5019,35
2021-01-18,San Bernardino,071,2135413,264159,252808,7627,260435,1775
2021-01-18,San Diego,073,3302833,229355,214335,10592,224927,2103
2021-01-18,San Francisco,075,870044,30078,29321,639,29960,259
2021-01-18,San Joaquin,077,732212,59344,57405,2329,59734,782
2021-01-18,San Luis Obispo,079,281455,16752,15742,425,16167,158
2021-01-18,San Mateo,081,765935,34505,32515,261,32776,208
2021-01-18,Santa Barbara,083,443738,26620,24638,778,25416,235
2021-01-18,Santa Clara,085,1922200,96630,93688,437,94125,992
2021-01-18,Santa Cruz,087,273765,13505,12298,615,12913,106
2021-01-18,Shasta,089,179085,9945,9600,995,10595,92
2021-01-18,Sierra,091,2930,46,40,10,50,0
2021-01-18,Siskiyou,093,43540,1250,1144,182,1326,4
2021-01-18,Solano,095,438530,26203,25344,286,25630,105
2021-01-18,Sonoma,097,501317,24645,24068,122,24190,223
2021-01-18,Stanislaus,099,539301,44310,42413,4413,46826,562
2021-01-18,Sutter,101,95872,7871,7680,67,7747,78
2021-01-18,Tehama,103,63373,4020,3854,435,4289,19
2021-01-18,Trinity,105,12862,437,260,66,326,3
2021-01-18,Tulare,107,460477,43338,41196,5888,47084,549
2021-01-18,Tuolumne,109,53932,3324,3318,29,3347,28
2021-01-18,Ventura,111,848112,65066,61859,2291,64150,379
2021-01-18,Yolo,113,214977,11367,10620,128,10748,134
2021-01-18,Yuba,115,75493,4885,4671,62,4733,29
2021-01-17,Alameda,001,1643700,69740,67375,1453,68828,676
2021-01-17,Alpine,003,1148,73,71,0,71,0
2021-01-17,Amador,005,37829,3049,3001,24,3025,28
2021-01-17,Butte,007,227075,10022,9411,1343,10754,129
2021-01-17,Calaveras,009,45235,1621,1608,7,1615,21
2021-01-17,Colusa,011,21464,1648,1588,174,1762,7
2021-01-17,Contra Costa,013,1133247,54138,51932,885,52817,447
2021-01-17,Del Norte,015,27424,877,838,3,841,2
2021-01-17,El Dorado,017,186661,8133,7659,530,8189,47
2021-01-17,Fresno,019,978130,86551,82039,6440,88479,857
2021-01-17,Glenn,021,27897,2013,1924,399,2323,9
2021-01-17,Humboldt,023,135768,2492,2322,11,2333,22
2021-01-17,Imperial,025,180216,25833,25253,2171,27424,451
2021-01-17,Inyo,027,18085,990,864,9,873,26
2021-01-17,Kern,029,883053,83184,79489,7473,86962,738
2021-01-17,Kings,031,150075,19935,19201,767,19968,131
2021-01-17,Lake,033,64148,2708,2572,0,2572,30
2021-01-17,Lassen,035,31185,4817,4740,77,4817,1
2021-01-17,Los Angeles,037,10098052,1048875,993028,33267,1026295,13741
2021-01-17,Madera,039,155013,13937,13328,661,13989,85
2021-01-17,Marin,041,260295,11821,11552,116,11668,164
2021-01-17,Mariposa,043,17540,337,319,2,321,3
2021-01-17,Mendocino,045,87422,3073,2912,56,2968,31
2021-01-17,Merced,047,269075,24360,23800,626,24426,242
2021-01-17,Modoc,049,8938,297,279,88,367,0
2021-01-17,Mono,051,14174,1093,1091,13,1104,3
2021-01-17,Monterey,053,433212,36827,35340,1198,36538,244
2021-01-17,Napa,055,140530,7876,7521,31,7552,38
2021-01-17,Nevada,057,99092,3382,3176,133,3309,17
2021-01-17,Orange,059,3164182,219364,212389,8891,221280,2359
2021-01-17,Placer,061,380077,18400,17194,855,18049,181
2021-01-17,Plumas,063,18699,590,505,9,514,2
2021-01-17,Riverside,065,2383286,254257,242206,11991,254197,2534
2021-01-17,Sacramento,067,1510023,82533,80154,937,81091,1045
2021-01-17,San Benito,069,59416,5072,4941,56,4997,35
2021-01-17,San Bernardino,071,2135413,262041,251487,7542,259029,1775
2021-01-17,San Diego,073,3302833,227161,211785,10485,222270,2103
2021-01-17,San Francisco,075,870044,29892,29139,601,29740,255
2021-01-17,San Joaquin,077,732212,58987,57094,2314,59408,780
2021-01-17,San Luis Obispo,079,281455,16630,15658,416,16074,157
2021-01-17,San Mateo,081,765935,34253,32186,238,32424,208
2021-01-17,Santa Barbara,083,443738,26160,24401,765,25166,235
2021-01-17,Santa Clara,085,1922200,95880,92752,434,93186,976
2021-01-17,Santa Cruz,087,273765,13393,12196,612,12808,106
2021-01-17,Shasta,089,179085,9887,9588,987,10575,92
2021-01-17,Sierra,091,2930,46,38,9,47,0
2021-01-17,Siskiyou,093,43540,1243,1136,179,1315,4
2021-01-17,Solano,095,438530,25974,25216,284,25500,105
2021-01-17,Sonoma,097,501317,24471,23871,122,23993,223
2021-01-17,Stanislaus,099,539301,43990,42221,4349,46570,562
2021-01-17,Sutter,101,95872,7808,7604,66,7670,77
2021-01-17,Tehama,103,63373,3989,3837,431,4268,18
2021-01-17,Trinity,105,12862,437,261,66,327,3
2021-01-17,Tulare,107,460477,43046,41016,5772,46788,549
2021-01-17,Tuolumne,109,53932,3307,3287,29,3316,27
2021-01-17,Ventura,111,848112,64218,61257,2243,63500,376
2021-01-17,Yolo,113,214977,11268,10519,126,10645,134
2021-01-17,Yuba,115,75493,4835,4640,59,4699,28
2021-01-16,Alameda,001,1643700,69418,66583,1440,68023,673
2021-01-16,Alpine,003,1148,73,71,0,71,0
2021-01-16,Amador,005,37829,3046,2986,24,3010,28
2021-01-16,Butte,007,227075,9990,9359,1323,10682,129
2021-01-16,Calaveras,009,45235,1608,1596,7,1603,21
2021-01-16,Colusa,011,21464,1636,1578,174,1752,7
2021-01-16,Contra Costa,013,1133247,53873,51363,878,52241,443
2021-01-16,Del Norte,015,27424,872,833,3,836,2
2021-01-16,El Dorado,017,186661,8111,7575,529,8104,47
2021-01-16,Fresno,019,978130,86277,81294,6386,87680,846
2021-01-16,Glenn,021,27897,2009,1894,396,2290,9
2021-01-16,Humboldt,023,135768,2472,2294,9,2303,22
2021-01-16,Imperial,025,180216,25798,25140,2164,27304,451
2021-01-16,Inyo,027,18085,986,845,9,854,25
2021-01-16,Kern,029,883053,82817,78865,7419,86284,733
2021-01-16,Kings,031,150075,19879,19072,764,19836,131
2021-01-16,Lake,033,64148,2697,2504,0,2504,30
2021-01-16,Lassen,035,31185,4805,4719,77,4796,1
2021-01-16,Los Angeles,037,10098052,1044791,982684,33029,1015713,13654
2021-01-16,Madera,039,155013,13870,13193,656,13849,85
2021-01-16,Marin,041,260295,11778,11482,116,11598,164
2021-01-16,Mariposa,043,17540,336,317,2,319,3
2021-01-16,Mendocino,045,87422,3059,2890,53,2943,31
2021-01-16,Merced,047,269075,24272,23478,612,24090,242
2021-01-16,Modoc,049,8938,297,278,88,366,0
2021-01-16,Mono,051,14174,1091,1079,13,1092,3
2021-01-16,Monterey,053,433212,36716,34972,1180,36152,243
2021-01-16,Napa,055,140530,7837,7356,31,7387,39
2021-01-16,Nevada,057,99092,3349,3144,133,3277,17
2021-01-16,Orange,059,3164182,218328,210111,8834,218945,2312
2021-01-16,Placer,061,380077,18336,16995,853,17848,177
2021-01-16,Plumas,063,18699,588,502,9,511,2
2021-01-16,Riverside,065,2383286,252900,239412,11875,251287,2506
2021-01-16,Sacramento,067,1510023,82159,79122,920,80042,1033
2021-01-16,San Benito,069,59416,5039,4875,56,4931,35
2021-01-16,San Bernardino,071,2135413,261245,249401,7475,256876,1755
2021-01-16,San Diego,073,3302833,225863,209895,10388,220283,2065
2021-01-16,San Francisco,075,870044,29764,28853,570,29423,244
2021-01-16,San Joaquin,077,732212,58739,56642,2282,58924,776
2021-01-16,San Luis Obispo,079,281455,16529,15466,414,15880,152
2021-01-16,San Mateo,081,765935,34089,31805,232,32037,208
2021-01-16,Santa Barbara,083,443738,25960,24088,761,24849,229
2021-01-16,Santa Clara,085,1922200,95411,91584,427,92011,954
2021-01-16,Santa Cruz,087,273765,13334,12026,610,12636,106
2021-01-16,Shasta,089,179085,9854,9547,983,10530,92
2021-01-16,Sierra,091,2930,45,38,9,47,0
2021-01-16,Siskiyou,093,43540,1238,1124,179,1303,4
2021-01-16,Solano,095,438530,25865,24732,280,25012,103
2021-01-16,Sonoma,097,501317,24380,23607,121,23728,223
2021-01-16,Stanislaus,099,539301,43802,41809,4298,46107,562
2021-01-16,Sutter,101,95872,7776,7560,66,7626,76
2021-01-16,Tehama,103,63373,3975,3783,431,4214,18
2021-01-16,Trinity,105,12862,437,261,66,327,3
2021-01-16,Tulare,107,460477,42867,40655,5699,46354,542
2021-01-16,Tuolumne,109,53932,3299,3269,29,3298,27
2021-01-16,Ventura,111,848112,63666,60368,2213,62581,369
2021-01-16,Yolo,113,214977,11219,10406,125,10531,134
2021-01-16,Yuba,115,75493,4804,4602,59,4661,27
2021-01-15,Alameda,001,1643700,68994,65416,1429,66845,672
2021-01-15,Alpine,003,1148,73,71,0,71,0
2021-01-15,Amador,005,37829,3039,2953,24,2977,28
2021-01-15,Butte,007,227075,9949,9233,1308,10541,129
2021-01-15,Calaveras,009,45235,1601,1538,7,1545,21
2021-01-15,Colusa,011,21464,1625,1541,169,1710,7
2021-01-15,Contra Costa,013,1133247,53543,50408,871,51279,428
2021-01-15,Del Norte,015,27424,868,828,2,830,2
2021-01-15,El Dorado,017,186661,8062,7439,520,7959,47
2021-01-15,Fresno,019,978130,85740,79950,6350,86300,832
2021-01-15,Glenn,021,27897,2005,1824,393,2217,9
2021-01-15,Humboldt,023,135768,2445,2218,8,2226,22
2021-01-15,Imperial,025,180216,25764,24944,2158,27102,446
2021-01-15,Inyo,027,18085,968,814,9,823,25
2021-01-15,Kern,029,883053,82402,77873,7354,85227,719
2021-01-15,Kings,031,150075,19770,18661,758,19419,131
2021-01-15,Lake,033,64148,2671,2434,0,2434,28
2021-01-15,Lassen,035,31185,4794,4693,75,4768,1
2021-01-15,Los Angeles,037,10098052,1037743,968979,32743,1001722,13404
2021-01-15,Madera,039,155013,13785,12883,653,13536,85
2021-01-15,Marin,041,260295,11727,11310,116,11426,160
2021-01-15,Mariposa,043,17540,334,307,2,309,3
2021-01-15,Mendocino,045,87422,3048,2835,53,2888,31
2021-01-15,Merced,047,269075,24159,23060,608,23668,239
2021-01-15,Modoc,049,8938,297,278,86,364,0
2021-01-15,Mono,051,14174,1088,1057,13,1070,3
2021-01-15,Monterey,053,433212,36499,34460,1121,35581,243
2021-01-15,Napa,055,140530,7775,7231,31,7262,38
2021-01-15,Nevada,057,99092,3336,3099,130,3229,17
2021-01-15,Orange,059,3164182,216976,207129,8782,215911,2254
2021-01-15,Placer,061,380077,18232,16712,844,17556,173
2021-01-15,Plumas,063,18699,585,499,9,508,2
2021-01-15,Riverside,065,2383286,251035,235235,11794,247029,2458
2021-01-15,Sacramento,067,1510023,81737,80279,912,81191,1023
2021-01-15,San Benito,069,59416,5000,4766,54,4820,35
2021-01-15,San Bernardino,071,2135413,260080,246182,7414,253596,1726
2021-01-15,San Diego,073,3302833,224114,206868,10323,217191,2037
2021-01-15,San Francisco,075,870044,29589,28574,550,29124,242
2021-01-15,San Joaquin,077,732212,58505,55885,2268,58153,748
2021-01-15,San Luis Obispo,079,281455,16396,15129,409,15538,148
2021-01-15,San Mateo,081,765935,33844,31291,228,31519,208
2021-01-15,Santa Barbara,083,443738,25677,23487,757,24244,226
2021-01-15,Santa Clara,085,1922200,94759,90103,422,90525,942
2021-01-15,Santa Cruz,087,273765,13225,11776,596,12372,105
2021-01-15,Shasta,089,179085,9815,9459,976,10435,91
2021-01-15,Sierra,091,2930,44,36,7,43,0
2021-01-15,Siskiyou,093,43540,1234,1119,179,1298,4
2021-01-15,Solano,095,438530,25715,24222,278,24500,103
2021-01-15,Sonoma,097,501317,24249,23204,120,23324,222
2021-01-15,Stanislaus,099,539301,43552,41178,4256,45434,562
2021-01-15,Sutter,101,95872,7729,7484,65,7549,75
2021-01-15,Tehama,103,63373,3953,3714,430,4144,17
2021-01-15,Trinity,105,12862,437,262,66,328,3
2021-01-15,Tulare,107,460477,42624,39951,5614,45565,535
2021-01-15,Tuolumne,109,53932,3283,3231,29,3260,27
2021-01-15,Ventura,111,848112,62922,59061,2180,61241,353
2021-01-15,Yolo,113,214977,11163,10240,124,10364,134
2021-01-15,Yuba,115,75493,4784,4549,59,4608,27
2021-01-14,Alameda,001,1643700,68365,64364,1413,65777,686
2021-01-14,Alpine,003,1148,73,71,0,71,0
2021-01-14,Amador,005,37829,3033,2940,24,2964,28
2021-01-14,Butte,007,227075,9862,9127,1286,10413,129
2021-01-14,Calaveras,009,45235,1584,1513,7,1520,21
2021-01-14,Colusa,011,21464,1610,1535,162,1697,7
2021-01-14,Contra Costa,013,1133247,52987,49545,857,50402,415
2021-01-14,Del Norte,015,27424,862,821,2,823,2
2021-01-14,El Dorado,017,186661,7988,7321,512,7833,45
2021-01-14,Fresno,019,978130,85107,79033,6270,85303,814
2021-01-14,Glenn,021,27897,1993,1798,388,2186,9
2021-01-14,Humboldt,023,135768,2402,2169,8,2177,22
2021-01-14,Imperial,025,180216,25655,24882,2123,27005,447
2021-01-14,Inyo,027,18085,961,790,9,799,25
2021-01-14,Kern,029,883053,81731,77070,7252,84322,705
2021-01-14,Kings,031,150075,19640,18405,754,19159,108
2021-01-14,Lake,033,64148,2628,2378,0,2378,27
2021-01-14,Lassen,035,31185,4784,4673,73,4746,1
2021-01-14,Los Angeles,037,10098052,1027725,954652,32367,987019,13147
2021-01-14,Madera,039,155013,13671,12742,642,13384,85
2021-01-14,Marin,041,260295,11653,11155,115,11270,159
2021-01-14,Mariposa,043,17540,331,302,2,304,3
2021-01-14,Mendocino,045,87422,3034,2801,51,2852,31
2021-01-14,Merced,047,269075,23932,22780,598,23378,239
2021-01-14,Modoc,049,8938,297,273,86,359,0
2021-01-14,Mono,051,14174,1080,1020,13,1033,3
2021-01-14,Monterey,053,433212,36078,34105,1099,35204,242
2021-01-14,Napa,055,140530,7690,7117,31,7148,38
2021-01-14,Nevada,057,99092,3309,3075,128,3203,17
2021-01-14,Orange,059,3164182,215044,204442,8696,213138,2162
2021-01-14,Placer,061,380077,18070,16488,837,17325,169
2021-01-14,Plumas,063,18699,577,496,9,505,2
2021-01-14,Riverside,065,2383286,248390,231684,11692,243376,2357
2021-01-14,Sacramento,067,1510023,81099,79137,888,80025,1007
2021-01-14,San Benito,069,59416,4964,4678,53,4731,35
2021-01-14,San Bernardino,071,2135413,258109,243379,7343,250722,1750
2021-01-14,San Diego,073,3302833,221720,204173,10203,214376,2005
2021-01-14,San Francisco,075,870044,29344,28200,502,28702,238
2021-01-14,San Joaquin,077,732212,57989,55058,2254,57312,739
2021-01-14,San Luis Obispo,079,281455,16234,14851,400,15251,146
2021-01-14,San Mateo,081,765935,33475,30694,219,30913,208
2021-01-14,Santa Barbara,083,443738,25256,23126,739,23865,219
2021-01-14,Santa Clara,085,1922200,93831,88505,415,88920,910
2021-01-14,Santa Cruz,087,273765,13078,11583,580,12163,109
2021-01-14,Shasta,089,179085,9766,9334,960,10294,90
2021-01-14,Sierra,091,2930,44,35,6,41,0
2021-01-14,Siskiyou,093,43540,1222,1108,176,1284,3
2021-01-14,Solano,095,438530,25456,23782,274,24056,103
2021-01-14,Sonoma,097,501317,24009,22910,120,23030,202
2021-01-14,Stanislaus,099,539301,43225,40597,4215,44812,574
2021-01-14,Sutter,101,95872,7670,7416,62,7478,74
2021-01-14,Tehama,103,63373,3925,3664,426,4090,17
2021-01-14,Trinity,105,12862,437,261,65,326,3
2021-01-14,Tulare,107,460477,42240,39565,5505,45070,533
2021-01-14,Tuolumne,109,53932,3262,3215,29,3244,28
2021-01-14,Ventura,111,848112,62050,57941,2143,60084,347
2021-01-14,Yolo,113,214977,11055,10097,118,10215,135
2021-01-14,Yuba,115,75493,4751,4496,59,4555,27
2021-01-13,Alameda,001,1643700,67611,63568,1397,64965,690
2021-01-13,Alpine,003,1148,73,71,0,71,0
2021-01-13,Amador,005,37829,3019,2914,24,2938,26
2021-01-13,Butte,007,227075,9780,9013,1271,10284,126
2021-01-13,Calaveras,009,45235,1562,1493,7,1500,21
2021-01-13,Colusa,011,21464,1598,1524,154,1678,7
2021-01-13,Contra Costa,013,1133247,52409,48877,845,49722,403
2021-01-13,Del Norte,015,27424,858,820,2,822,2
2021-01-13,El Dorado,017,186661,7895,7247,504,7751,43
2021-01-13,Fresno,019,978130,84388,78278,6228,84506,804
2021-01-13,Glenn,021,27897,1977,1792,379,2171,9
2021-01-13,Humboldt,023,135768,2369,2114,8,2122,22
2021-01-13,Imperial,025,180216,25531,24717,2090,26807,463
2021-01-13,Inyo,027,18085,949,785,9,794,25
2021-01-13,Kern,029,883053,81071,76049,7162,83211,704
2021-01-13,Kings,031,150075,19473,18121,732,18853,108
2021-01-13,Lake,033,64148,2585,2305,0,2305,27
2021-01-13,Lassen,035,31185,4777,4663,72,4735,1
2021-01-13,Los Angeles,037,10098052,1016937,937985,31959,969944,12873
2021-01-13,Madera,039,155013,13545,12570,637,13207,85
2021-01-13,Marin,041,260295,11597,11039,115,11154,161
2021-01-13,Mariposa,043,17540,329,304,2,306,3
2021-01-13,Mendocino,045,87422,3014,2790,51,2841,31
2021-01-13,Merced,047,269075,23693,22497,584,23081,241
2021-01-13,Modoc,049,8938,296,274,83,357,0
2021-01-13,Mono,051,14174,1076,1017,13,1030,3
2021-01-13,Monterey,053,433212,35654,33748,1075,34823,241
2021-01-13,Napa,055,140530,7576,7028,31,7059,36
2021-01-13,Nevada,057,99092,3285,3037,125,3162,17
2021-01-13,Orange,059,3164182,212955,201158,8626,209784,2172
2021-01-13,Placer,061,380077,17944,16272,823,17095,172
2021-01-13,Plumas,063,18699,575,490,9,499,2
2021-01-13,Riverside,065,2383286,245243,228192,11579,239771,2278
2021-01-13,Sacramento,067,1510023,80438,78268,881,79149,996
2021-01-13,San Benito,069,59416,4908,4583,52,4635,35
2021-01-13,San Bernardino,071,2135413,255733,240191,7270,247461,1759
2021-01-13,San Diego,073,3302833,219106,201578,10100,211678,1952
2021-01-13,San Francisco,075,870044,29105,27863,480,28343,238
2021-01-13,San Joaquin,077,732212,57367,54373,2225,56598,738
2021-01-13,San Luis Obispo,079,281455,16079,14625,389,15014,140
2021-01-13,San Mateo,081,765935,33135,30195,217,30412,207
2021-01-13,Santa Barbara,083,443738,24814,22714,723,23437,216
2021-01-13,Santa Clara,085,1922200,92854,87187,412,87599,911
2021-01-13,Santa Cruz,087,273765,12905,11423,566,11989,110
2021-01-13,Shasta,089,179085,9702,9180,946,10126,93
2021-01-13,Sierra,091,2930,44,33,6,39,0
2021-01-13,Siskiyou,093,43540,1216,1102,172,1274,3
2021-01-13,Solano,095,438530,25171,23503,271,23774,105
2021-01-13,Sonoma,097,501317,23759,22610,119,22729,206
2021-01-13,Stanislaus,099,539301,42833,40167,4162,44329,574
2021-01-13,Sutter,101,95872,7624,7350,61,7411,73
2021-01-13,Tehama,103,63373,3875,3589,421,4010,17
2021-01-13,Trinity,105,12862,437,260,65,325,3
2021-01-13,Tulare,107,460477,41835,39129,5402,44531,522
2021-01-13,Tuolumne,109,53932,3248,3196,29,3225,28
2021-01-13,Ventura,111,848112,61038,56453,2103,58556,338
2021-01-13,Yolo,113,214977,10955,9933,114,10047,135
2021-01-13,Yuba,115,75493,4708,4448,56,4504,27
2021-01-12,Alameda,001,1643700,66779,62642,1379,64021,677
2021-01-12,Alpine,003,1148,73,71,0,71,0
2021-01-12,Amador,005,37829,3002,2897,24,2921,26
2021-01-12,Butte,007,227075,9692,8883,1255,10138,124
2021-01-12,Calaveras,009,45235,1526,1475,7,1482,21
2021-01-12,Colusa,011,21464,1586,1510,150,1660,7
2021-01-12,Contra Costa,013,1133247,51768,48242,831,49073,399
2021-01-12,Del Norte,015,27424,853,816,2,818,2
2021-01-12,El Dorado,017,186661,7812,7156,493,7649,41
2021-01-12,Fresno,019,978130,83516,77651,6159,83810,796
2021-01-12,Glenn,021,27897,1952,1781,375,2156,9
2021-01-12,Humboldt,023,135768,2315,2077,7,2084,22
2021-01-12,Imperial,025,180216,25441,24566,2049,26615,457
2021-01-12,Inyo,027,18085,931,773,9,782,25
2021-01-12,Kern,029,883053,80365,75320,7066,82386,689
2021-01-12,Kings,031,150075,19261,18072,722,18794,108
2021-01-12,Lake,033,64148,2537,2260,0,2260,27
2021-01-12,Lassen,035,31185,4755,4659,70,4729,1
2021-01-12,Los Angeles,037,10098052,1005279,926295,31551,957846,12610
2021-01-12,Madera,039,155013,13405,12485,628,13113,85
2021-01-12,Marin,041,260295,11488,10960,115,11075,157
2021-01-12,Mariposa,043,17540,326,302,2,304,3
2021-01-12,Mendocino,045,87422,2994,2762,47,2809,31
2021-01-12,Merced,047,269075,23442,22172,562,22734,239
2021-01-12,Modoc,049,8938,294,274,83,357,0
2021-01-12,Mono,051,14174,1066,1008,13,1021,3
2021-01-12,Monterey,053,433212,35163,33381,1058,34439,240
2021-01-12,Napa,055,140530,7493,6936,31,6967,36
2021-01-12,Nevada,057,99092,3257,3014,123,3137,17
2021-01-12,Orange,059,3164182,210667,198260,8539,206799,2142
2021-01-12,Placer,061,380077,17774,16087,817,16904,163
2021-01-12,Plumas,063,18699,569,483,9,492,2
2021-01-12,Riverside,065,2383286,242111,225580,11439,237019,2266
2021-01-12,Sacramento,067,1510023,79710,77201,873,78074,985
2021-01-12,San Benito,069,59416,4839,4515,52,4567,35
2021-01-12,San Bernardino,071,2135413,253165,237008,7200,244208,1739
2021-01-12,San Diego,073,3302833,216192,198317,9983,208300,1898
2021-01-12,San Francisco,075,870044,28830,27531,447,27978,238
2021-01-12,San Joaquin,077,732212,56726,53630,2197,55827,725
2021-01-12,San Luis Obispo,079,281455,15833,14367,381,14748,132
2021-01-12,San Mateo,081,765935,32744,29747,205,29952,206
2021-01-12,Santa Barbara,083,443738,24392,22182,703,22885,209
2021-01-12,Santa Clara,085,1922200,91777,86075,404,86479,904
2021-01-12,Santa Cruz,087,273765,12690,11267,550,11817,110
2021-01-12,Shasta,089,179085,9629,9086,933,10019,84
2021-01-12,Sierra,091,2930,43,33,6,39,0
2021-01-12,Siskiyou,093,43540,1206,1091,165,1256,3
2021-01-12,Solano,095,438530,24868,23160,267,23427,102
2021-01-12,Sonoma,097,501317,23454,22403,119,22522,205
2021-01-12,Stanislaus,099,539301,42395,39615,4126,43741,571
2021-01-12,Sutter,101,95872,7561,7276,60,7336,73
2021-01-12,Tehama,103,63373,3837,3567,416,3983,17
2021-01-12,Trinity,105,12862,437,258,65,323,3
2021-01-12,Tulare,107,460477,41378,38797,5285,44082,509
2021-01-12,Tuolumne,109,53932,3215,3178,29,3207,28
2021-01-12,Ventura,111,848112,60066,55342,2070,57412,324
2021-01-12,Yolo,113,214977,10819,9857,104,9961,133
2021-01-12,Yuba,115,75493,4666,4389,56,4445,27
2021-01-11,Alameda,001,1643700,65915,61949,1361,63310,652
2021-01-11,Alpine,003,1148,73,70,0,70,0
2021-01-11,Amador,005,37829,2988,2867,24,2891,24
2021-01-11,Butte,007,227075,9579,8757,1237,9994,119
2021-01-11,Calaveras,009,45235,1507,1460,7,1467,21
2021-01-11,Colusa,011,21464,1569,1494,145,1639,7
2021-01-11,Contra Costa,013,1133247,51091,47728,821,48549,398
2021-01-11,Del Norte,015,27424,849,810,2,812,2
2021-01-11,El Dorado,017,186661,7718,6987,485,7472,36
2021-01-11,Fresno,019,978130,82636,76581,6082,82663,775
2021-01-11,Glenn,021,27897,1925,1763,369,2132,9
2021-01-11,Humboldt,023,135768,2276,2069,7,2076,22
2021-01-11,Imperial,025,180216,25326,24418,2013,26431,453
2021-01-11,Inyo,027,18085,913,763,9,772,25
2021-01-11,Kern,029,883053,79504,74489,6967,81456,682
2021-01-11,Kings,031,150075,18998,17909,714,18623,108
2021-01-11,Lake,033,64148,2485,2205,0,2205,26
2021-01-11,Lassen,035,31185,4732,4647,69,4716,1
2021-01-11,Los Angeles,037,10098052,992055,914434,31084,945518,12304
2021-01-11,Madera,039,155013,13271,12366,617,12983,85
2021-01-11,Marin,041,260295,11391,10814,112,10926,156
2021-01-11,Mariposa,043,17540,319,296,2,298,3
2021-01-11,Mendocino,045,87422,2966,2728,47,2775,31
2021-01-11,Merced,047,269075,23119,21884,547,22431,238
2021-01-11,Modoc,049,8938,293,271,82,353,0
2021-01-11,Mono,051,14174,1060,1006,13,1019,3
2021-01-11,Monterey,053,433212,34624,32858,995,33853,239
2021-01-11,Napa,055,140530,7391,6822,31,6853,36
2021-01-11,Nevada,057,99092,3229,2980,123,3103,17
2021-01-11,Orange,059,3164182,208080,196340,8438,204778,2113
2021-01-11,Placer,061,380077,17594,15919,807,16726,163
2021-01-11,Plumas,063,18699,565,477,9,486,2
2021-01-11,Riverside,065,2383286,238599,222907,11293,234200,2222
2021-01-11,Sacramento,067,1510023,78778,76009,857,76866,974
2021-01-11,San Benito,069,59416,4766,4482,45,4527,34
2021-01-11,San Bernardino,071,2135413,250368,235543,7099,242642,1739
2021-01-11,San Diego,073,3302833,212923,194793,9823,204616,1857
2021-01-11,San Francisco,075,870044,28554,27264,426,27690,238
2021-01-11,San Joaquin,077,732212,56113,53002,2167,55169,725
2021-01-11,San Luis Obispo,079,281455,15462,14213,373,14586,126
2021-01-11,San Mateo,081,765935,32300,29355,193,29548,206
2021-01-11,Santa Barbara,083,443738,23942,21740,691,22431,200
2021-01-11,Santa Clara,085,1922200,90569,84851,395,85246,877
2021-01-11,Santa Cruz,087,273765,12510,11093,526,11619,106
2021-01-11,Shasta,089,179085,9531,8977,920,9897,81
2021-01-11,Sierra,091,2930,41,33,6,39,0
2021-01-11,Siskiyou,093,43540,1197,1087,163,1250,3
2021-01-11,Solano,095,438530,24548,22893,261,23154,101
2021-01-11,Sonoma,097,501317,23208,22191,119,22310,205
2021-01-11,Stanislaus,099,539301,41903,39149,4076,43225,571
2021-01-11,Sutter,101,95872,7502,7204,59,7263,71
2021-01-11,Tehama,103,63373,3774,3524,394,3918,17
2021-01-11,Trinity,105,12862,437,256,65,321,2
2021-01-11,Tulare,107,460477,40963,38380,5206,43586,497
2021-01-11,Tuolumne,109,53932,3204,3165,29,3194,27
2021-01-11,Ventura,111,848112,58930,54202,2047,56249,320
2021-01-11,Yolo,113,214977,10611,9699,102,9801,129
2021-01-11,Yuba,115,75493,4628,4349,49,4398,27
2021-01-10,Alameda,001,1643700,64923,61111,1333,62444,650
2021-01-10,Alpine,003,1148,73,70,0,70,0
2021-01-10,Amador,005,37829,2964,2861,24,2885,24
2021-01-10,Butte,007,227075,9458,8665,1211,9876,119
2021-01-10,Calaveras,009,45235,1483,1449,7,1456,21
2021-01-10,Colusa,011,21464,1546,1478,143,1621,7
2021-01-10,Contra Costa,013,1133247,50308,47109,803,47912,398
2021-01-10,Del Norte,015,27424,846,809,2,811,2
2021-01-10,El Dorado,017,186661,7631,6904,466,7370,36
2021-01-10,Fresno,019,978130,81825,75621,5959,81580,775
2021-01-10,Glenn,021,27897,1906,1746,361,2107,9
2021-01-10,Humboldt,023,135768,2215,2049,7,2056,22
2021-01-10,Imperial,025,180216,25166,24233,1962,26195,453
2021-01-10,Inyo,027,18085,885,748,9,757,25
2021-01-10,Kern,029,883053,78672,73712,6834,80546,679
2021-01-10,Kings,031,150075,18779,17812,707,18519,108
2021-01-10,Lake,033,64148,2431,2174,0,2174,26
2021-01-10,Lassen,035,31185,4710,4642,69,4711,1
2021-01-10,Los Angeles,037,10098052,977449,901783,30459,932242,12170
2021-01-10,Madera,039,155013,13082,12179,602,12781,85
2021-01-10,Marin,041,260295,11270,10737,111,10848,155
2021-01-10,Mariposa,043,17540,319,291,2,293,3
2021-01-10,Mendocino,045,87422,2935,2706,43,2749,31
2021-01-10,Merced,047,269075,22845,21691,535,22226,238
2021-01-10,Modoc,049,8938,293,271,80,351,0
2021-01-10,Mono,051,14174,1042,965,13,978,3
2021-01-10,Monterey,053,433212,34184,32571,962,33533,237
2021-01-10,Napa,055,140530,7287,6687,29,6716,36
2021-01-10,Nevada,057,99092,3210,2959,119,3078,17
2021-01-10,Orange,059,3164182,205313,193766,8314,202080,2104
2021-01-10,Placer,061,380077,17405,15779,787,16566,163
2021-01-10,Plumas,063,18699,555,477,9,486,2
2021-01-10,Riverside,065,2383286,235231,219486,11103,230589,2216
2021-01-10,Sacramento,067,1510023,77817,75394,829,76223,965
2021-01-10,San Benito,069,59416,4664,4434,44,4478,34
2021-01-10,San Bernardino,071,2135413,246846,232171,6995,239166,1736
2021-01-10,San Diego,073,3302833,209256,191886,9656,201542,1857
2021-01-10,San Francisco,075,870044,28169,27054,395,27449,238
2021-01-10,San Joaquin,077,732212,55254,52535,2134,54669,725
2021-01-10,San Luis Obispo,079,281455,15133,13968,361,14329,122
2021-01-10,San Mateo,081,765935,31810,28972,179,29151,206
2021-01-10,Santa Barbara,083,443738,23383,21290,676,21966,200
2021-01-10,Santa Clara,085,1922200,89393,83779,386,84165,858
2021-01-10,Santa Cruz,087,273765,12297,10951,507,11458,106
2021-01-10,Shasta,089,179085,9419,8936,905,9841,81
2021-01-10,Sierra,091,2930,40,32,6,38,0
2021-01-10,Siskiyou,093,43540,1191,1075,160,1235,3
2021-01-10,Solano,095,438530,24145,22621,258,22879,101
2021-01-10,Sonoma,097,501317,22932,21925,118,22043,204
2021-01-10,Stanislaus,099,539301,41330,38809,3997,42806,571
2021-01-10,Sutter,101,95872,7441,7133,56,7189,71
2021-01-10,Tehama,103,63373,3701,3504,381,3885,17
2021-01-10,Trinity,105,12862,437,253,63,316,2
2021-01-10,Tulare,107,460477,40545,38012,5084,43096,497
2021-01-10,Tuolumne,109,53932,3170,3143,28,3171,27
2021-01-10,Ventura,111,848112,57661,53095,2003,55098,319
2021-01-10,Yolo,113,214977,10458,9610,101,9711,129
2021-01-10,Yuba,115,75493,4575,4300,46,4346,27
2021-01-09,Alameda,001,1643700,64376,60125,1317,61442,649
2021-01-09,Alpine,003,1148,73,70,0,70,0
2021-01-09,Amador,005,37829,2957,2809,24,2833,24
2021-01-09,Butte,007,227075,9379,8552,1187,9739,118
2021-01-09,Calaveras,009,45235,1473,1425,7,1432,21
2021-01-09,Colusa,011,21464,1539,1468,142,1610,7
2021-01-09,Contra Costa,013,1133247,49956,46406,788,47194,393
2021-01-09,Del Norte,015,27424,844,802,2,804,2
2021-01-09,El Dorado,017,186661,7599,6800,463,7263,36
2021-01-09,Fresno,019,978130,81416,74816,5919,80735,773
2021-01-09,Glenn,021,27897,1891,1707,358,2065,9
2021-01-09,Humboldt,023,135768,2197,2026,7,2033,22
2021-01-09,Imperial,025,180216,25098,24028,1948,25976,448
2021-01-09,Inyo,027,18085,875,734,9,743,25
2021-01-09,Kern,029,883053,78203,73015,6757,79772,677
2021-01-09,Kings,031,150075,18684,17679,703,18382,108
2021-01-09,Lake,033,64148,2396,2144,0,2144,26
2021-01-09,Lassen,035,31185,4698,4613,68,4681,1
2021-01-09,Los Angeles,037,10098052,971873,887949,30023,917972,12011
2021-01-09,Madera,039,155013,12991,12063,597,12660,85
2021-01-09,Marin,041,260295,11209,10634,110,10744,154
2021-01-09,Mariposa,043,17540,316,287,2,289,3
2021-01-09,Mendocino,045,87422,2917,2664,43,2707,31
2021-01-09,Merced,047,269075,22703,21357,526,21883,237
2021-01-09,Modoc,049,8938,293,271,79,350,0
2021-01-09,Mono,051,14174,1037,964,13,977,3
2021-01-09,Monterey,053,433212,34033,31948,952,32900,235
2021-01-09,Napa,055,140530,7217,6594,26,6620,36
2021-01-09,Nevada,057,99092,3188,2932,116,3048,17
2021-01-09,Orange,059,3164182,203803,191004,8221,199225,2034
2021-01-09,Placer,061,380077,17298,15609,785,16394,162
2021-01-09,Plumas,063,18699,553,477,9,486,2
2021-01-09,Riverside,065,2383286,233476,216076,10965,227041,2201
2021-01-09,Sacramento,067,1510023,77284,74482,824,75306,953
2021-01-09,San Benito,069,59416,4613,4335,44,4379,34
2021-01-09,San Bernardino,071,2135413,245651,228857,6927,235784,1714
2021-01-09,San Diego,073,3302833,207562,188598,9536,198134,1824
2021-01-09,San Francisco,075,870044,27997,26708,352,27060,235
2021-01-09,San Joaquin,077,732212,54905,51927,2115,54042,724
2021-01-09,San Luis Obispo,079,281455,15009,13647,350,13997,121
2021-01-09,San Mateo,081,765935,31511,28512,172,28684,205
2021-01-09,Santa Barbara,083,443738,23171,20971,671,21642,197
2021-01-09,Santa Clara,085,1922200,88553,82269,374,82643,808
2021-01-09,Santa Cruz,087,273765,12201,10717,501,11218,107
2021-01-09,Shasta,089,179085,9386,8893,901,9794,81
2021-01-09,Sierra,091,2930,38,32,6,38,0
2021-01-09,Siskiyou,093,43540,1187,1062,155,1217,3
2021-01-09,Solano,095,438530,23987,22226,256,22482,101
2021-01-09,Sonoma,097,501317,22810,21393,118,21511,202
2021-01-09,Stanislaus,099,539301,41039,38403,3962,42365,567
2021-01-09,Sutter,101,95872,7405,7072,55,7127,69
2021-01-09,Tehama,103,63373,3669,3451,371,3822,15
2021-01-09,Trinity,105,12862,437,252,63,315,2
2021-01-09,Tulare,107,460477,40291,37684,5018,42702,496
2021-01-09,Tuolumne,109,53932,3162,3117,27,3144,26
2021-01-09,Ventura,111,848112,56832,51988,1977,53965,306
2021-01-09,Yolo,113,214977,10385,9524,98,9622,129
2021-01-09,Yuba,115,75493,4545,4265,46,4311,27
2021-01-08,Alameda,001,1643700,63810,59172,1308,60480,646
2021-01-08,Alpine,003,1148,73,70,0,70,0
2021-01-08,Amador,005,37829,2950,2792,24,2816,24
2021-01-08,Butte,007,227075,9319,8430,1173,9603,115
2021-01-08,Calaveras,009,45235,1459,1385,7,1392,21
2021-01-08,Colusa,011,21464,1526,1448,141,1589,7
2021-01-08,Contra Costa,013,1133247,49428,45667,784,46451,381
2021-01-08,Del Norte,015,27424,842,795,2,797,2
2021-01-08,El Dorado,017,186661,7529,6690,451,7141,36
2021-01-08,Fresno,019,978130,80602,73689,5859,79548,771
2021-01-08,Glenn,021,27897,1876,1680,353,2033,9
2021-01-08,Humboldt,023,135768,2173,1988,7,1995,22
2021-01-08,Imperial,025,180216,25032,23751,1933,25684,446
2021-01-08,Inyo,027,18085,861,682,9,691,24
2021-01-08,Kern,029,883053,77640,71978,6683,78661,674
2021-01-08,Kings,031,150075,18556,17441,698,18139,108
2021-01-08,Lake,033,64148,2371,2098,0,2098,26
2021-01-08,Lassen,035,31185,4690,4598,66,4664,1
2021-01-08,Los Angeles,037,10098052,961072,871188,29594,900782,11796
2021-01-08,Madera,039,155013,12840,11846,588,12434,85
2021-01-08,Marin,041,260295,11115,10531,109,10640,153
2021-01-08,Mariposa,043,17540,315,273,2,275,3
2021-01-08,Mendocino,045,87422,2898,2634,40,2674,31
2021-01-08,Merced,047,269075,22508,20862,521,21383,236
2021-01-08,Modoc,049,8938,293,266,79,345,0
2021-01-08,Mono,051,14174,1027,951,13,964,3
2021-01-08,Monterey,053,433212,33781,31543,941,32484,224
2021-01-08,Napa,055,140530,7147,6544,26,6570,32
2021-01-08,Nevada,057,99092,3166,2888,116,3004,17
2021-01-08,Orange,059,3164182,201809,186608,8134,194742,1991
2021-01-08,Placer,061,380077,17167,15401,778,16179,161
2021-01-08,Plumas,063,18699,547,465,9,474,2
2021-01-08,Riverside,065,2383286,231071,212122,10835,222957,2184
2021-01-08,Sacramento,067,1510023,76711,73245,818,74063,939
2021-01-08,San Benito,069,59416,4576,4225,43,4268,33
2021-01-08,San Bernardino,071,2135413,243778,224267,6857,231124,1703
2021-01-08,San Diego,073,3302833,205024,185060,9442,194502,1771
2021-01-08,San Francisco,075,870044,27747,26378,329,26707,207
2021-01-08,San Joaquin,077,732212,54571,50990,2087,53077,710
2021-01-08,San Luis Obispo,079,281455,14876,13286,338,13624,119
2021-01-08,San Mateo,081,765935,31161,28072,169,28241,204
2021-01-08,Santa Barbara,083,443738,22885,20461,666,21127,189
2021-01-08,Santa Clara,085,1922200,87548,80561,371,80932,789
2021-01-08,Santa Cruz,087,273765,12060,10486,493,10979,106
2021-01-08,Shasta,089,179085,9336,8772,886,9658,81
2021-01-08,Sierra,091,2930,38,31,6,37,0
2021-01-08,Siskiyou,093,43540,1184,1027,154,1181,3
2021-01-08,Solano,095,438530,23816,21832,253,22085,100
2021-01-08,Sonoma,097,501317,22668,21178,118,21296,201
2021-01-08,Stanislaus,099,539301,40740,37858,3927,41785,566
2021-01-08,Sutter,101,95872,7355,6982,55,7037,68
2021-01-08,Tehama,103,63373,3646,3406,367,3773,15
2021-01-08,Trinity,105,12862,437,247,63,310,2
2021-01-08,Tulare,107,460477,40019,36946,4917,41863,491
2021-01-08,Tuolumne,109,53932,3154,3099,27,3126,19
2021-01-08,Ventura,111,848112,55966,50553,1953,52506,294
2021-01-08,Yolo,113,214977,10297,9391,94,9485,129
2021-01-08,Yuba,115,75493,4503,4195,45,4240,26
2021-01-07,Alameda,001,1643700,62953,57921,1281,59202,632
2021-01-07,Alpine,003,1148,71,70,0,70,0
2021-01-07,Amador,005,37829,2937,2740,23,2763,24
2021-01-07,Butte,007,227075,9222,8278,1152,9430,112
2021-01-07,Calaveras,009,45235,1442,1342,6,1348,21
2021-01-07,Colusa,011,21464,1514,1420,134,1554,7
2021-01-07,Contra Costa,013,1133247,48651,44756,768,45524,376
2021-01-07,Del Norte,015,27424,840,791,2,793,2
2021-01-07,El Dorado,017,186661,7428,6545,439,6984,36
2021-01-07,Fresno,019,978130,79646,72557,5759,78316,765
2021-01-07,Glenn,021,27897,1858,1639,343,1982,9
2021-01-07,Humboldt,023,135768,2146,1954,7,1961,22
2021-01-07,Imperial,025,180216,24842,23608,1882,25490,431
2021-01-07,Inyo,027,18085,848,656,9,665,20
2021-01-07,Kern,029,883053,76778,70953,6532,77485,660
2021-01-07,Kings,031,150075,18428,17238,689,17927,108
2021-01-07,Lake,033,64148,2317,2054,0,2054,26
2021-01-07,Lassen,035,31185,4685,4581,64,4645,1
2021-01-07,Los Angeles,037,10098052,946155,853187,29060,882247,11480
2021-01-07,Madera,039,155013,12683,11644,577,12221,76
2021-01-07,Marin,041,260295,11026,10364,107,10471,153
2021-01-07,Mariposa,043,17540,313,264,2,266,3
2021-01-07,Mendocino,045,87422,2843,2585,35,2620,30
2021-01-07,Merced,047,269075,22187,20510,505,21015,234
2021-01-07,Modoc,049,8938,293,265,79,344,0
2021-01-07,Mono,051,14174,1016,905,13,918,3
2021-01-07,Monterey,053,433212,33276,30903,918,31821,222
2021-01-07,Napa,055,140530,7037,6408,26,6434,32
2021-01-07,Nevada,057,99092,3132,2847,111,2958,17
2021-01-07,Orange,059,3164182,198964,181922,8036,189958,1974
2021-01-07,Placer,061,380077,16989,15155,749,15904,144
2021-01-07,Plumas,063,18699,545,454,9,463,2
2021-01-07,Riverside,065,2383286,227608,208177,10680,218857,2156
2021-01-07,Sacramento,067,1510023,75803,72342,797,73139,919
2021-01-07,San Benito,069,59416,4515,4112,39,4151,33
2021-01-07,San Bernardino,071,2135413,240320,219691,6775,226466,1666
2021-01-07,San Diego,073,3302833,201718,180510,9264,189774,1738
2021-01-07,San Francisco,075,870044,27418,25885,314,26199,202
2021-01-07,San Joaquin,077,732212,53890,50156,2056,52212,689
2021-01-07,San Luis Obispo,079,281455,14637,12810,325,13135,118
2021-01-07,San Mateo,081,765935,30652,27494,165,27659,201
2021-01-07,Santa Barbara,083,443738,22458,19931,655,20586,187
2021-01-07,Santa Clara,085,1922200,86378,78808,368,79176,775
2021-01-07,Santa Cruz,087,273765,11851,10228,485,10713,104
2021-01-07,Shasta,089,179085,9248,8612,878,9490,81
2021-01-07,Sierra,091,2930,38,31,6,37,0
2021-01-07,Siskiyou,093,43540,1179,1010,152,1162,3
2021-01-07,Solano,095,438530,23424,21384,249,21633,100
2021-01-07,Sonoma,097,501317,22407,20857,117,20974,200
2021-01-07,Stanislaus,099,539301,40322,37296,3874,41170,553
2021-01-07,Sutter,101,95872,7296,6890,54,6944,65
2021-01-07,Tehama,103,63373,3622,3330,359,3689,15
2021-01-07,Trinity,105,12862,437,247,63,310,2
2021-01-07,Tulare,107,460477,39618,36397,4785,41182,482
2021-01-07,Tuolumne,109,53932,3134,3068,26,3094,14
2021-01-07,Ventura,111,848112,54805,49083,1925,51008,288
2021-01-07,Yolo,113,214977,10157,9207,92,9299,128
2021-01-07,Yuba,115,75493,4461,4128,45,4173,25
2021-01-06,Alameda,001,1643700,62096,57081,1252,58333,616
2021-01-06,Alpine,003,1148,71,70,0,70,0
2021-01-06,Amador,005,37829,2916,2717,22,2739,24
2021-01-06,Butte,007,227075,9107,8147,1132,9279,110
2021-01-06,Calaveras,009,45235,1419,1321,6,1327,21
2021-01-06,Colusa,011,21464,1493,1385,129,1514,7
2021-01-06,Contra Costa,013,1133247,47858,44054,752,44806,358
2021-01-06,Del Norte,015,27424,834,780,2,782,2
2021-01-06,El Dorado,017,186661,7316,6397,426,6823,35
2021-01-06,Fresno,019,978130,78803,71404,5657,77061,752
2021-01-06,Glenn,021,27897,1832,1622,338,1960,9
2021-01-06,Humboldt,023,135768,2120,1912,7,1919,22
2021-01-06,Imperial,025,180216,24597,23400,1841,25241,431
2021-01-06,Inyo,027,18085,832,630,9,639,20
2021-01-06,Kern,029,883053,75835,69893,6401,76294,646
2021-01-06,Kings,031,150075,18230,17019,669,17688,108
2021-01-06,Lake,033,64148,2280,2033,0,2033,26
2021-01-06,Lassen,035,31185,4673,4560,60,4620,1
2021-01-06,Los Angeles,037,10098052,930205,835052,28367,863419,11285
2021-01-06,Madera,039,155013,12547,11407,571,11978,67
2021-01-06,Marin,041,260295,10898,10282,106,10388,153
2021-01-06,Mariposa,043,17540,310,259,2,261,3
2021-01-06,Mendocino,045,87422,2813,2561,35,2596,30
2021-01-06,Merced,047,269075,21850,20258,489,20747,232
2021-01-06,Modoc,049,8938,293,263,79,342,0
2021-01-06,Mono,051,14174,985,905,13,918,3
2021-01-06,Monterey,053,433212,32675,30387,886,31273,222
2021-01-06,Napa,055,140530,6907,6342,26,6368,32
2021-01-06,Nevada,057,99092,3112,2805,110,2915,15
2021-01-06,Orange,059,3164182,195514,177686,7894,185580,1935
2021-01-06,Placer,061,380077,16801,14940,731,15671,134
2021-01-06,Plumas,063,18699,537,445,9,454,2
2021-01-06,Riverside,065,2383286,223588,203714,10493,214207,2121
2021-01-06,Sacramento,067,1510023,74780,71572,780,72352,909
2021-01-06,San Benito,069,59416,4439,4031,38,4069,32
2021-01-06,San Bernardino,071,2135413,236611,215286,6667,221953,1634
2021-01-06,San Diego,073,3302833,198218,176660,9093,185753,1691
2021-01-06,San Francisco,075,870044,27049,25424,306,25730,199
2021-01-06,San Joaquin,077,732212,53136,49286,2015,51301,673
2021-01-06,San Luis Obispo,079,281455,14244,12305,318,12623,115
2021-01-06,San Mateo,081,765935,30227,27050,162,27212,200
2021-01-06,Santa Barbara,083,443738,21969,19453,646,20099,177
2021-01-06,Santa Clara,085,1922200,85011,77485,361,77846,746
2021-01-06,Santa Cruz,087,273765,11632,9954,467,10421,97
2021-01-06,Shasta,089,179085,9178,8482,871,9353,78
2021-01-06,Sierra,091,2930,37,31,6,37,0
2021-01-06,Siskiyou,093,43540,1167,998,148,1146,3
2021-01-06,Solano,095,438530,23041,21102,246,21348,99
2021-01-06,Sonoma,097,501317,22100,20558,117,20675,196
2021-01-06,Stanislaus,099,539301,39755,36751,3815,40566,553
2021-01-06,Sutter,101,95872,7215,6839,53,6892,59
2021-01-06,Tehama,103,63373,3594,3306,353,3659,15
2021-01-06,Trinity,105,12862,437,246,63,309,2
2021-01-06,Tulare,107,460477,39069,35882,4688,40570,465
2021-01-06,Tuolumne,109,53932,3114,3008,26,3034,14
2021-01-06,Ventura,111,848112,53562,47428,1901,49329,280
2021-01-06,Yolo,113,214977,9992,9083,89,9172,127
2021-01-06,Yuba,115,75493,4412,4097,45,4142,25
2021-01-05,Alameda,001,1643700,60982,56432,1218,57650,602
2021-01-05,Alpine,003,1148,71,70,0,70,0
2021-01-05,Amador,005,37829,2876,2695,22,2717,24
2021-01-05,Butte,007,227075,8966,8008,1104,9112,107
2021-01-05,Calaveras,009,45235,1373,1292,6,1298,21
2021-01-05,Colusa,011,21464,1469,1376,123,1499,7
2021-01-05,Contra Costa,013,1133247,46988,43442,740,44182,353
2021-01-05,Del Norte,015,27424,827,770,2,772,2
2021-01-05,El Dorado,017,186661,7198,6270,405,6675,32
2021-01-05,Fresno,019,978130,77581,70971,5562,76533,741
2021-01-05,Glenn,021,27897,1809,1608,322,1930,9
2021-01-05,Humboldt,023,135768,2084,1884,7,1891,22
2021-01-05,Imperial,025,180216,24424,23165,1798,24963,421
2021-01-05,Inyo,027,18085,818,627,9,636,20
2021-01-05,Kern,029,883053,74758,68257,6261,74518,624
2021-01-05,Kings,031,150075,18032,16860,646,17506,108
2021-01-05,Lake,033,64148,2233,2015,0,2015,25
2021-01-05,Lassen,035,31185,4658,4554,56,4610,1
2021-01-05,Los Angeles,037,10098052,911471,823783,27698,851481,11028
2021-01-05,Madera,039,155013,12371,11359,558,11917,67
2021-01-05,Marin,041,260295,10746,10214,105,10319,151
2021-01-05,Mariposa,043,17540,304,257,2,259,3
2021-01-05,Mendocino,045,87422,2777,2501,35,2536,30
2021-01-05,Merced,047,269075,21499,20051,477,20528,230
2021-01-05,Modoc,049,8938,293,254,79,333,0
2021-01-05,Mono,051,14174,979,896,13,909,3
2021-01-05,Monterey,053,433212,32125,30045,853,30898,213
2021-01-05,Napa,055,140530,6820,6264,26,6290,29
2021-01-05,Nevada,057,99092,3084,2781,108,2889,15
2021-01-05,Orange,059,3164182,191879,174869,7699,182568,1918
2021-01-05,Placer,061,380077,16578,14723,708,15431,133
2021-01-05,Plumas,063,18699,530,428,9,437,2
2021-01-05,Riverside,065,2383286,219463,200439,10318,210757,2069
2021-01-05,Sacramento,067,1510023,73852,70677,754,71431,888
2021-01-05,San Benito,069,59416,4337,3961,36,3997,28
2021-01-05,San Bernardino,071,2135413,232667,212522,6551,219073,1615
2021-01-05,San Diego,073,3302833,194078,172845,8879,181724,1654
2021-01-05,San Francisco,075,870044,26682,24989,288,25277,196
2021-01-05,San Joaquin,077,732212,52265,48969,1969,50938,663
2021-01-05,San Luis Obispo,079,281455,13845,12027,308,12335,106
2021-01-05,San Mateo,081,765935,29746,26486,160,26646,198
2021-01-05,Santa Barbara,083,443738,21523,19063,637,19700,172
2021-01-05,Santa Clara,085,1922200,83482,76355,348,76703,729
2021-01-05,Santa Cruz,087,273765,11359,9753,443,10196,93
2021-01-05,Shasta,089,179085,9071,8345,853,9198,73
2021-01-05,Sierra,091,2930,37,31,6,37,0
2021-01-05,Siskiyou,093,43540,1155,985,146,1131,3
2021-01-05,Solano,095,438530,22634,20860,241,21101,97
2021-01-05,Sonoma,097,501317,21741,20247,116,20363,194
2021-01-05,Stanislaus,099,539301,39211,36363,3764,40127,553
2021-01-05,Sutter,101,95872,7118,6769,52,6821,59
2021-01-05,Tehama,103,63373,3538,3255,348,3603,9
2021-01-05,Trinity,105,12862,437,246,63,309,2
2021-01-05,Tulare,107,460477,38454,35585,4543,40128,455
2021-01-05,Tuolumne,109,53932,3090,2996,21,3017,13
2021-01-05,Ventura,111,848112,52317,46456,1879,48335,264
2021-01-05,Yolo,113,214977,9817,8980,88,9068,127
2021-01-05,Yuba,115,75493,4353,4053,44,4097,21
2021-01-04,Alameda,001,1643700,59761,55899,1184,57083,583
2021-01-04,Alpine,003,1148,71,68,0,68,0
2021-01-04,Amador,005,37829,2836,2596,22,2618,24
2021-01-04,Butte,007,227075,8807,7893,1083,8976,105
2021-01-04,Calaveras,009,45235,1332,1276,5,1281,21
2021-01-04,Colusa,011,21464,1445,1368,109,1477,7
2021-01-04,Contra Costa,013,1133247,46127,43019,714,43733,353
2021-01-04,Del Norte,015,27424,817,770,2,772,2
2021-01-04,El Dorado,017,186661,7064,6152,389,6541,27
2021-01-04,Fresno,019,978130,76312,69871,5464,75335,726
2021-01-04,Glenn,021,27897,1776,1590,317,1907,9
2021-01-04,Humboldt,023,135768,2048,1845,7,1852,22
2021-01-04,Imperial,025,180216,24274,23035,1745,24780,420
2021-01-04,Inyo,027,18085,792,623,9,632,20
2021-01-04,Kern,029,883053,73674,67418,6064,73482,623
2021-01-04,Kings,031,150075,17755,16801,621,17422,108
2021-01-04,Lake,033,64148,2194,1984,0,1984,25
2021-01-04,Lassen,035,31185,4636,4550,55,4605,1
2021-01-04,Los Angeles,037,10098052,891357,813022,26831,839853,10790
2021-01-04,Madera,039,155013,12151,11204,536,11740,67
2021-01-04,Marin,041,260295,10609,10115,102,10217,151
2021-01-04,Mariposa,043,17540,298,253,2,255,3
2021-01-04,Mendocino,045,87422,2737,2460,31,2491,28
2021-01-04,Merced,047,269075,21084,19804,458,20262,230
2021-01-04,Modoc,049,8938,277,250,77,327,0
2021-01-04,Mono,051,14174,968,895,13,908,3
2021-01-04,Monterey,053,433212,31506,29659,831,30490,212
2021-01-04,Napa,055,140530,6679,6187,26,6213,29
2021-01-04,Nevada,057,99092,3046,2765,105,2870,15
2021-01-04,Orange,059,3164182,187987,172458,7572,180030,1918
2021-01-04,Placer,061,380077,16319,14622,695,15317,133
2021-01-04,Plumas,063,18699,520,419,9,428,1
2021-01-04,Riverside,065,2383286,214910,196809,10128,206937,2066
2021-01-04,Sacramento,067,1510023,72797,70164,744,70908,870
2021-01-04,San Benito,069,59416,4224,3914,36,3950,28
2021-01-04,San Bernardino,071,2135413,228411,210868,6401,217269,1615
2021-01-04,San Diego,073,3302833,189504,171031,8683,179714,1598
2021-01-04,San Francisco,075,870044,26294,24753,282,25035,191
2021-01-04,San Joaquin,077,732212,51364,48644,1927,50571,661
2021-01-04,San Luis Obispo,079,281455,13359,11945,300,12245,96
2021-01-04,San Mateo,081,765935,29182,26150,155,26305,198
2021-01-04,Santa Barbara,083,443738,21000,18735,606,19341,165
2021-01-04,Santa Clara,085,1922200,81724,75297,340,75637,727
2021-01-04,Santa Cruz,087,273765,11071,9680,426,10106,85
2021-01-04,Shasta,089,179085,8966,8224,836,9060,72
2021-01-04,Sierra,091,2930,36,30,6,36,0
2021-01-04,Siskiyou,093,43540,1138,980,143,1123,3
2021-01-04,Solano,095,438530,22134,20588,233,20821,97
2021-01-04,Sonoma,097,501317,21403,20210,115,20325,194
2021-01-04,Stanislaus,099,539301,38649,36141,3707,39848,553
2021-01-04,Sutter,101,95872,7022,6712,51,6763,56
2021-01-04,Tehama,103,63373,3469,3190,343,3533,9
2021-01-04,Trinity,105,12862,434,245,63,308,2
2021-01-04,Tulare,107,460477,37902,35060,4440,39500,455
2021-01-04,Tuolumne,109,53932,3065,2987,21,3008,13
2021-01-04,Ventura,111,848112,50814,45014,1859,46873,255
2021-01-04,Yolo,113,214977,9622,8834,82,8916,121
2021-01-04,Yuba,115,75493,4296,4023,44,4067,21
2021-01-03,Alameda,001,1643700,58504,55082,1156,56238,580
2021-01-03,Alpine,003,1148,69,68,0,68,0
2021-01-03,Amador,005,37829,2772,2565,22,2587,24
2021-01-03,Butte,007,227075,8613,7837,1037,8874,105
2021-01-03,Calaveras,009,45235,1295,1249,3,1252,21
2021-01-03,Colusa,011,21464,1415,1337,103,1440,7
2021-01-03,Contra Costa,013,1133247,45239,42432,689,43121,352
2021-01-03,Del Norte,015,27424,805,768,2,770,2
2021-01-03,El Dorado,017,186661,6936,6034,372,6406,27
2021-01-03,Fresno,019,978130,75162,69326,5346,74672,719
2021-01-03,Glenn,021,27897,1751,1581,311,1892,9
2021-01-03,Humboldt,023,135768,2011,1833,7,1840,21
2021-01-03,Imperial,025,180216,24027,22951,1668,24619,419
2021-01-03,Inyo,027,18085,774,615,9,624,20
2021-01-03,Kern,029,883053,72412,66895,5886,72781,609
2021-01-03,Kings,031,150075,17479,16593,591,17184,108
2021-01-03,Lake,033,64148,2141,1976,0,1976,24
2021-01-03,Lassen,035,31185,4603,4531,54,4585,1
2021-01-03,Los Angeles,037,10098052,869318,792168,25768,817936,10633
2021-01-03,Madera,039,155013,11928,11152,513,11665,67
2021-01-03,Marin,041,260295,10458,10034,97,10131,150
2021-01-03,Mariposa,043,17540,291,248,2,250,3
2021-01-03,Mendocino,045,87422,2697,2445,29,2474,24
2021-01-03,Merced,047,269075,20616,19600,431,20031,230
2021-01-03,Modoc,049,8938,273,245,76,321,0
2021-01-03,Mono,051,14174,943,893,13,906,3
2021-01-03,Monterey,053,433212,30913,29357,796,30153,191
2021-01-03,Napa,055,140530,6578,6094,26,6120,29
2021-01-03,Nevada,057,99092,2985,2742,102,2844,15
2021-01-03,Orange,059,3164182,183800,169881,7379,177260,1919
2021-01-03,Placer,061,380077,16070,14319,671,14990,133
2021-01-03,Plumas,063,18699,507,416,9,425,1
2021-01-03,Riverside,065,2383286,210032,195048,9879,204927,2005
2021-01-03,Sacramento,067,1510023,71590,68558,723,69281,859
2021-01-03,San Benito,069,59416,4127,3882,35,3917,28
2021-01-03,San Bernardino,071,2135413,223102,208294,6228,214522,1592
2021-01-03,San Diego,073,3302833,184244,168018,8454,176472,1592
2021-01-03,San Francisco,075,870044,25796,24588,264,24852,193
2021-01-03,San Joaquin,077,732212,50248,47899,1870,49769,661
2021-01-03,San Luis Obispo,079,281455,12890,11636,291,11927,95
2021-01-03,San Mateo,081,765935,28588,25770,148,25918,196
2021-01-03,Santa Barbara,083,443738,20267,18267,589,18856,164
2021-01-03,Santa Clara,085,1922200,80134,74534,334,74868,720
2021-01-03,Santa Cruz,087,273765,10767,9528,411,9939,84
2021-01-03,Shasta,089,179085,8840,8192,796,8988,72
2021-01-03,Sierra,091,2930,36,30,6,36,0
2021-01-03,Siskiyou,093,43540,1105,976,134,1110,3
2021-01-03,Solano,095,438530,21605,20105,227,20332,97
2021-01-03,Sonoma,097,501317,21015,19982,113,20095,193
2021-01-03,Stanislaus,099,539301,37942,35762,3622,39384,553
2021-01-03,Sutter,101,95872,6925,6664,50,6714,53
2021-01-03,Tehama,103,63373,3414,3176,336,3512,9
2021-01-03,Trinity,105,12862,429,243,61,304,2
2021-01-03,Tulare,107,460477,37340,34747,4292,39039,455
2021-01-03,Tuolumne,109,53932,3005,2978,18,2996,13
2021-01-03,Ventura,111,848112,48989,43748,1842,45590,254
2021-01-03,Yolo,113,214977,9465,8674,78,8752,121
2021-01-03,Yuba,115,75493,4244,3966,43,4009,20
2021-01-02,Alameda,001,1643700,57881,54518,1125,55643,581
2021-01-02,Alpine,003,1148,69,68,0,68,0
2021-01-02,Amador,005,37829,2753,2540,22,2562,24
2021-01-02,Butte,007,227075,8507,7750,1015,8765,105
2021-01-02,Calaveras,009,45235,1275,1230,3,1233,21
2021-01-02,Colusa,011,21464,1405,1332,102,1434,7
2021-01-02,Contra Costa,013,1133247,44702,41993,678,42671,352
2021-01-02,Del Norte,015,27424,803,764,2,766,2
2021-01-02,El Dorado,017,186661,6881,5959,368,6327,27
2021-01-02,Fresno,019,978130,74618,68740,5232,73972,717
2021-01-02,Glenn,021,27897,1734,1546,310,1856,9
2021-01-02,Humboldt,023,135768,1984,1815,7,1822,21
2021-01-02,Imperial,025,180216,23941,22867,1632,24499,420
2021-01-02,Inyo,027,18085,761,609,9,618,20
2021-01-02,Kern,029,883053,71692,66457,5774,72231,610
2021-01-02,Kings,031,150075,17385,16515,587,17102,108
2021-01-02,Lake,033,64148,2105,1925,0,1925,24
2021-01-02,Lassen,035,31185,4592,4457,53,4510,1
2021-01-02,Los Angeles,037,10098052,860961,791892,25072,816964,10633
2021-01-02,Madera,039,155013,11817,11039,501,11540,67
2021-01-02,Marin,041,260295,10411,9924,94,10018,151
2021-01-02,Mariposa,043,17540,284,243,2,245,3
2021-01-02,Mendocino,045,87422,2654,2428,28,2456,24
2021-01-02,Merced,047,269075,20474,19395,414,19809,230
2021-01-02,Modoc,049,8938,272,245,76,321,0
2021-01-02,Mono,051,14174,932,884,13,897,3
2021-01-02,Monterey,053,433212,30700,28991,784,29775,191
2021-01-02,Napa,055,140530,6519,5994,26,6020,29
2021-01-02,Nevada,057,99092,2956,2706,98,2804,15
2021-01-02,Orange,059,3164182,181591,168457,7230,175687,1918
2021-01-02,Placer,061,380077,15897,14182,662,14844,133
2021-01-02,Plumas,063,18699,504,413,9,422,1
2021-01-02,Riverside,065,2383286,207391,192069,9650,201719,2008
2021-01-02,Sacramento,067,1510023,70956,67810,706,68516,858
2021-01-02,San Benito,069,59416,4044,3829,35,3864,28
2021-01-02,San Bernardino,071,2135413,221446,206939,6104,213043,1597
2021-01-02,San Diego,073,3302833,181645,164498,8257,172755,1592
2021-01-02,San Francisco,075,870044,25536,24414,257,24671,194
2021-01-02,San Joaquin,077,732212,49867,47310,1841,49151,662
2021-01-02,San Luis Obispo,079,281455,12755,11467,285,11752,95
2021-01-02,San Mateo,081,765935,28252,25483,140,25623,196
2021-01-02,Santa Barbara,083,443738,19978,18135,586,18721,164
2021-01-02,Santa Clara,085,1922200,78948,73662,328,73990,720
2021-01-02,Santa Cruz,087,273765,10612,9340,402,9742,85
2021-01-02,Shasta,089,179085,8774,8154,785,8939,72
2021-01-02,Sierra,091,2930,36,28,6,34,0
2021-01-02,Siskiyou,093,43540,1094,949,132,1081,3
2021-01-02,Solano,095,438530,21405,19805,218,20023,97
2021-01-02,Sonoma,097,501317,20846,19761,113,19874,194
2021-01-02,Stanislaus,099,539301,37609,35431,3557,38988,553
2021-01-02,Sutter,101,95872,6873,6621,50,6671,53
2021-01-02,Tehama,103,63373,3386,3146,332,3478,9
2021-01-02,Trinity,105,12862,426,243,61,304,2
2021-01-02,Tulare,107,460477,37020,34479,4217,38696,455
2021-01-02,Tuolumne,109,53932,2991,2942,16,2958,13
2021-01-02,Ventura,111,848112,47834,43397,1807,45204,254
2021-01-02,Yolo,113,214977,9367,8571,76,8647,122
2021-01-02,Yuba,115,75493,4205,3930,42,3972,21
2021-01-01,Alameda,001,1643700,57230,53518,1111,54629,579
2021-01-01,Alpine,003,1148,69,68,0,68,0
2021-01-01,Amador,005,37829,2727,2513,20,2533,24
2021-01-01,Butte,007,227075,8405,7589,993,8582,105
2021-01-01,Calaveras,009,45235,1260,1186,3,1189,21
2021-01-01,Colusa,011,21464,1396,1314,100,1414,7
2021-01-01,Contra Costa,013,1133247,44224,41412,660,42072,351
2021-01-01,Del Norte,015,27424,796,758,2,760,2
2021-01-01,El Dorado,017,186661,6789,5832,360,6192,27
2021-01-01,Fresno,019,978130,73545,67484,5146,72630,717
2021-01-01,Glenn,021,27897,1717,1520,301,1821,9
2021-01-01,Humboldt,023,135768,1945,1783,7,1790,21
2021-01-01,Imperial,025,180216,23852,22715,1581,24296,418
2021-01-01,Inyo,027,18085,737,606,9,615,20
2021-01-01,Kern,029,883053,70866,65571,5666,71237,609
2021-01-01,Kings,031,150075,17202,16358,580,16938,108
2021-01-01,Lake,033,64148,2072,1888,0,1888,24
2021-01-01,Lassen,035,31185,4586,4377,53,4430,1
2021-01-01,Los Angeles,037,10098052,846754,775578,24385,799963,10515
2021-01-01,Madera,039,155013,11657,10752,492,11244,66
2021-01-01,Marin,041,260295,10304,9821,93,9914,148
2021-01-01,Mariposa,043,17540,276,236,2,238,3
2021-01-01,Mendocino,045,87422,2600,2400,28,2428,24
2021-01-01,Merced,047,269075,20290,19118,398,19516,229
2021-01-01,Modoc,049,8938,272,241,76,317,0
2021-01-01,Mono,051,14174,914,884,12,896,3
2021-01-01,Monterey,053,433212,30460,28465,775,29240,191
2021-01-01,Napa,055,140530,6433,5899,26,5925,28
2021-01-01,Nevada,057,99092,2932,2663,98,2761,15
2021-01-01,Orange,059,3164182,178792,165440,7086,172526,1893
2021-01-01,Placer,061,380077,15707,13987,647,14634,133
2021-01-01,Plumas,063,18699,499,412,9,421,1
2021-01-01,Riverside,065,2383286,204203,188674,9392,198066,1990
2021-01-01,Sacramento,067,1510023,70359,66956,689,67645,848
2021-01-01,San Benito,069,59416,4006,3773,35,3808,28
2021-01-01,San Bernardino,071,2135413,218620,203651,5971,209622,1590
2021-01-01,San Diego,073,3302833,178572,160071,8078,168149,1592
2021-01-01,San Francisco,075,870044,25261,24145,246,24391,187
2021-01-01,San Joaquin,077,732212,49574,46640,1795,48435,657
2021-01-01,San Luis Obispo,079,281455,12527,11160,277,11437,94
2021-01-01,San Mateo,081,765935,27804,25041,136,25177,194
2021-01-01,Santa Barbara,083,443738,19658,17759,576,18335,164
2021-01-01,Santa Clara,085,1922200,77670,71904,322,72226,680
2021-01-01,Santa Cruz,087,273765,10432,9146,392,9538,84
2021-01-01,Shasta,089,179085,8693,8102,768,8870,72
2021-01-01,Sierra,091,2930,36,26,6,32,0
2021-01-01,Siskiyou,093,43540,1080,944,127,1071,3
2021-01-01,Solano,095,438530,21190,19393,216,19609,97
2021-01-01,Sonoma,097,501317,20650,19513,113,19626,189
2021-01-01,Stanislaus,099,539301,37321,34978,3495,38473,553
2021-01-01,Sutter,101,95872,6816,6553,49,6602,52
2021-01-01,Tehama,103,63373,3328,3079,325,3404,9
2021-01-01,Trinity,105,12862,426,243,61,304,2
2021-01-01,Tulare,107,460477,36606,33994,4122,38116,454
2021-01-01,Tuolumne,109,53932,2975,2909,16,2925,13
2021-01-01,Ventura,111,848112,46341,42026,1780,43806,253
2021-01-01,Yolo,113,214977,9256,8461,73,8534,120
2021-01-01,Yuba,115,75493,4151,3845,41,3886,19
2020-12-31,Alameda,001,1643700,56678,52475,1080,53555,579
2020-12-31,Alpine,003,1148,69,66,0,66,0
2020-12-31,Amador,005,37829,2713,2493,20,2513,24
2020-12-31,Butte,007,227075,8330,7405,973,8378,105
2020-12-31,Calaveras,009,45235,1249,1161,3,1164,21
2020-12-31,Colusa,011,21464,1386,1301,97,1398,7
2020-12-31,Contra Costa,013,1133247,43835,40512,645,41157,336
2020-12-31,Del Norte,015,27424,795,748,2,750,2
2020-12-31,El Dorado,017,186661,6737,5662,351,6013,26
2020-12-31,Fresno,019,978130,73112,66442,5084,71526,711
2020-12-31,Glenn,021,27897,1689,1484,293,1777,9
2020-12-31,Humboldt,023,135768,1928,1713,7,1720,21
2020-12-31,Imperial,025,180216,23781,22494,1565,24059,417
2020-12-31,Inyo,027,18085,729,591,9,600,20
2020-12-31,Kern,029,883053,70394,64904,5574,70478,609
2020-12-31,Kings,031,150075,17127,16077,572,16649,108
2020-12-31,Lake,033,64148,2057,1848,0,1848,23
2020-12-31,Lassen,035,31185,4580,4340,52,4392,1
2020-12-31,Los Angeles,037,10098052,841418,755844,23924,779768,10320
2020-12-31,Madera,039,155013,11584,10609,484,11093,64
2020-12-31,Marin,041,260295,10261,9731,92,9823,148
2020-12-31,Mariposa,043,17540,274,217,2,219,3
2020-12-31,Mendocino,045,87422,2585,2367,24,2391,24
2020-12-31,Merced,047,269075,20200,18808,388,19196,226
2020-12-31,Modoc,049,8938,272,238,76,314,0
2020-12-31,Mono,051,14174,906,868,12,880,3
2020-12-31,Monterey,053,433212,30231,27720,763,28483,188
2020-12-31,Napa,055,140530,6370,5801,26,5827,28
2020-12-31,Nevada,057,99092,2909,2619,97,2716,15
2020-12-31,Orange,059,3164182,176904,161586,6953,168539,1866
2020-12-31,Placer,061,380077,15551,13708,644,14352,126
2020-12-31,Plumas,063,18699,494,401,8,409,1
2020-12-31,Riverside,065,2383286,202525,184193,9259,193452,1958
2020-12-31,Sacramento,067,1510023,69829,65817,679,66496,830
2020-12-31,San Benito,069,59416,3982,3673,35,3708,28
2020-12-31,San Bernardino,071,2135413,216976,199115,5903,205018,1586
2020-12-31,San Diego,073,3302833,176809,155593,7979,163572,1534
2020-12-31,San Francisco,075,870044,25030,23740,239,23979,183
2020-12-31,San Joaquin,077,732212,49256,45764,1757,47521,646
2020-12-31,San Luis Obispo,079,281455,12413,10846,277,11123,89
2020-12-31,San Mateo,081,765935,27474,24570,130,24700,192
2020-12-31,Santa Barbara,083,443738,19414,17434,569,18003,161
2020-12-31,Santa Clara,085,1922200,76860,70032,317,70349,665
2020-12-31,Santa Cruz,087,273765,10314,8909,380,9289,84
2020-12-31,Shasta,089,179085,8627,7996,758,8754,69
2020-12-31,Sierra,091,2930,36,26,6,32,0
2020-12-31,Siskiyou,093,43540,1064,940,124,1064,3
2020-12-31,Solano,095,438530,20959,18942,215,19157,97
2020-12-31,Sonoma,097,501317,20529,19129,112,19241,188
2020-12-31,Stanislaus,099,539301,37013,34398,3447,37845,552
2020-12-31,Sutter,101,95872,6785,6432,49,6481,51
2020-12-31,Tehama,103,63373,3292,3036,324,3360,9
2020-12-31,Trinity,105,12862,425,241,61,302,2
2020-12-31,Tulare,107,460477,36429,33412,4059,37471,446
2020-12-31,Tuolumne,109,53932,2966,2902,16,2918,12
2020-12-31,Ventura,111,848112,45830,40854,1763,42617,251
2020-12-31,Yolo,113,214977,9169,8295,72,8367,117
2020-12-31,Yuba,115,75493,4110,3799,40,3839,18
2020-12-30,Alameda,001,1643700,55895,50158,1027,51185,573
2020-12-30,Alpine,003,1148,69,66,0,66,0
2020-12-30,Amador,005,37829,2693,2418,19,2437,24
2020-12-30,Butte,007,227075,8168,7140,953,8093,103
2020-12-30,Calaveras,009,45235,1224,1135,3,1138,21
2020-12-30,Colusa,011,21464,1370,1289,91,1380,7
2020-12-30,Contra Costa,013,1133247,43250,39601,633,40234,337
2020-12-30,Del Norte,015,27424,790,726,2,728,2
2020-12-30,El Dorado,017,186661,6636,5595,341,5936,27
2020-12-30,Fresno,019,978130,72266,65566,4931,70497,711
2020-12-30,Glenn,021,27897,1658,1471,280,1751,9
2020-12-30,Humboldt,023,135768,1894,1654,7,1661,22
2020-12-30,Imperial,025,180216,23612,22098,1488,23586,412
2020-12-30,Inyo,027,18085,722,572,9,581,20
2020-12-30,Kern,029,883053,69666,63292,5430,68722,604
2020-12-30,Kings,031,150075,17008,15862,564,16426,108
2020-12-30,Lake,033,64148,2035,1731,0,1731,23
2020-12-30,Lassen,035,31185,4571,4300,52,4352,1
2020-12-30,Los Angeles,037,10098052,830507,741907,23238,765145,10046
2020-12-30,Madera,039,155013,11474,10249,473,10722,65
2020-12-30,Marin,041,260295,10171,9569,85,9654,148
2020-12-30,Mariposa,043,17540,270,214,2,216,3
2020-12-30,Mendocino,045,87422,2567,2291,21,2312,24
2020-12-30,Merced,047,269075,19910,18519,378,18897,225
2020-12-30,Modoc,049,8938,269,234,76,310,0
2020-12-30,Mono,051,14174,903,868,12,880,3
2020-12-30,Monterey,053,433212,29601,26977,741,27718,186
2020-12-30,Napa,055,140530,6264,5754,26,5780,28
2020-12-30,Nevada,057,99092,2874,2595,95,2690,15
2020-12-30,Orange,059,3164182,174245,153951,6763,160714,1863
2020-12-30,Placer,061,380077,15319,13540,632,14172,127
2020-12-30,Plumas,063,18699,489,397,8,405,1
2020-12-30,Riverside,065,2383286,199577,176402,9074,185476,1919
2020-12-30,Sacramento,067,1510023,68956,64119,662,64781,847
2020-12-30,San Benito,069,59416,3901,3464,31,3495,29
2020-12-30,San Bernardino,071,2135413,214414,192648,5817,198465,1591
2020-12-30,San Diego,073,3302833,173176,152510,7804,160314,1472
2020-12-30,San Francisco,075,870044,24737,23099,234,23333,182
2020-12-30,San Joaquin,077,732212,48561,44465,1714,46179,634
2020-12-30,San Luis Obispo,079,281455,12145,10542,269,10811,89
2020-12-30,San Mateo,081,765935,27045,24150,126,24276,190
2020-12-30,Santa Barbara,083,443738,19011,16895,547,17442,161
2020-12-30,Santa Clara,085,1922200,75615,67218,313,67531,661
2020-12-30,Santa Cruz,087,273765,10120,8787,371,9158,86
2020-12-30,Shasta,089,179085,8513,7818,744,8562,69
2020-12-30,Sierra,091,2930,36,25,6,31,0
2020-12-30,Siskiyou,093,43540,1057,913,115,1028,3
2020-12-30,Solano,095,438530,20567,18300,212,18512,96
2020-12-30,Sonoma,097,501317,20272,18947,112,19059,191
2020-12-30,Stanislaus,099,539301,36549,33730,3372,37102,526
2020-12-30,Sutter,101,95872,6724,6328,47,6375,51
2020-12-30,Tehama,103,63373,3248,2969,320,3289,9
2020-12-30,Trinity,105,12862,424,231,60,291,2
2020-12-30,Tulare,107,460477,35880,32413,3995,36408,430
2020-12-30,Tuolumne,109,53932,2956,2772,14,2786,12
2020-12-30,Ventura,111,848112,44542,39039,1739,40778,251
2020-12-30,Yolo,113,214977,9061,8067,70,8137,117
2020-12-30,Yuba,115,75493,4039,3612,40,3652,18
2020-12-29,Alameda,001,1643700,54827,50946,991,51937,552
2020-12-29,Alpine,003,1148,69,65,0,65,0
2020-12-29,Amador,005,37829,2641,2388,18,2406,23
2020-12-29,Butte,007,227075,7995,7178,929,8107,98
2020-12-29,Calaveras,009,45235,1180,1111,2,1113,21
2020-12-29,Colusa,011,21464,1349,1272,86,1358,7
2020-12-29,Contra Costa,013,1133247,42448,39225,602,39827,325
2020-12-29,Del Norte,015,27424,783,724,2,726,2
2020-12-29,El Dorado,017,186661,6507,5551,328,5879,22
2020-12-29,Fresno,019,978130,70890,65149,4776,69925,688
2020-12-29,Glenn,021,27897,1624,1454,273,1727,9
2020-12-29,Humboldt,023,135768,1846,1616,7,1623,19
2020-12-29,Imperial,025,180216,23399,22105,1403,23508,407
2020-12-29,Inyo,027,18085,705,571,9,580,19
2020-12-29,Kern,029,883053,68500,63096,5258,68354,589
2020-12-29,Kings,031,150075,16839,15777,552,16329,108
2020-12-29,Lake,033,64148,2004,1805,0,1805,22
2020-12-29,Lassen,035,31185,4556,4288,52,4340,1
2020-12-29,Los Angeles,037,10098052,810314,731907,22383,754290,9786
2020-12-29,Madera,039,155013,11160,10251,458,10709,64
2020-12-29,Marin,041,260295,10019,9595,82,9677,146
2020-12-29,Mariposa,043,17540,262,212,2,214,3
2020-12-29,Mendocino,045,87422,2524,2249,20,2269,24
2020-12-29,Merced,047,269075,19560,18464,362,18826,221
2020-12-29,Modoc,049,8938,266,232,76,308,0
2020-12-29,Mono,051,14174,894,868,12,880,3
2020-12-29,Monterey,053,433212,28952,26894,714,27608,185
2020-12-29,Napa,055,140530,6146,5663,26,5689,28
2020-12-29,Nevada,057,99092,2826,2550,94,2644,15
2020-12-29,Orange,059,3164182,170453,154411,6595,161006,1839
2020-12-29,Placer,061,380077,15106,13392,611,14003,126
2020-12-29,Plumas,063,18699,480,395,8,403,1
2020-12-29,Riverside,065,2383286,194978,177624,8821,186445,1904
2020-12-29,Sacramento,067,1510023,67905,65078,648,65726,820
2020-12-29,San Benito,069,59416,3782,3474,30,3504,25
2020-12-29,San Bernardino,071,2135413,209591,190476,5680,196156,1557
2020-12-29,San Diego,073,3302833,168953,150062,7573,157635,1435
2020-12-29,San Francisco,075,870044,24399,22996,226,23222,178
2020-12-29,San Joaquin,077,732212,47641,44699,1659,46358,622
2020-12-29,San Luis Obispo,079,281455,11849,10387,261,10648,80
2020-12-29,San Mateo,081,765935,26502,23773,114,23887,189
2020-12-29,Santa Barbara,083,443738,18542,16797,521,17318,155
2020-12-29,Santa Clara,085,1922200,74072,67581,310,67891,621
2020-12-29,Santa Cruz,087,273765,9849,8492,362,8854,84
2020-12-29,Shasta,089,179085,8409,7782,729,8511,65
2020-12-29,Sierra,091,2930,34,24,5,29,0
2020-12-29,Siskiyou,093,43540,1042,926,113,1039,3
2020-12-29,Solano,095,438530,20185,18412,207,18619,96
2020-12-29,Sonoma,097,501317,19938,18790,110,18900,187
2020-12-29,Stanislaus,099,539301,36073,33775,3302,37077,508
2020-12-29,Sutter,101,95872,6657,6302,47,6349,50
2020-12-29,Tehama,103,63373,3179,2962,308,3270,9
2020-12-29,Trinity,105,12862,423,241,60,301,2
2020-12-29,Tulare,107,460477,35222,32545,3863,36408,419
2020-12-29,Tuolumne,109,53932,2914,2797,14,2811,12
2020-12-29,Ventura,111,848112,43287,38669,1713,40382,235
2020-12-29,Yolo,113,214977,8932,8124,68,8192,111
2020-12-29,Yuba,115,75493,3957,3723,40,3763,18
2020-12-28,Alameda,001,1643700,53784,50405,971,51376,551
2020-12-28,Alpine,003,1148,68,65,0,65,0
2020-12-28,Amador,005,37829,2571,2255,18,2273,23
2020-12-28,Butte,007,227075,7828,7053,898,7951,86
2020-12-28,Calaveras,009,45235,1157,1102,2,1104,21
2020-12-28,Colusa,011,21464,1324,1255,74,1329,7
2020-12-28,Contra Costa,013,1133247,41510,38872,575,39447,324
2020-12-28,Del Norte,015,27424,773,718,2,720,2
2020-12-28,El Dorado,017,186661,6351,5441,316,5757,18
2020-12-28,Fresno,019,978130,69620,64274,4625,68899,679
2020-12-28,Glenn,021,27897,1590,1435,261,1696,9
2020-12-28,Humboldt,023,135768,1811,1579,7,1586,19
2020-12-28,Imperial,025,180216,23140,22003,1329,23332,405
2020-12-28,Inyo,027,18085,698,569,9,578,19
2020-12-28,Kern,029,883053,67432,62392,5054,67446,579
2020-12-28,Kings,031,150075,16622,15733,535,16268,108
2020-12-28,Lake,033,64148,1963,1785,0,1785,22
2020-12-28,Lassen,035,31185,4449,4284,51,4335,1
2020-12-28,Los Angeles,037,10098052,787959,720699,21583,742282,9544
2020-12-28,Madera,039,155013,10986,10123,435,10558,64
2020-12-28,Marin,041,260295,9911,9546,76,9622,145
2020-12-28,Mariposa,043,17540,238,211,2,213,3
2020-12-28,Mendocino,045,87422,2489,2214,20,2234,23
2020-12-28,Merced,047,269075,19239,18245,343,18588,213
2020-12-28,Modoc,049,8938,261,220,75,295,0
2020-12-28,Mono,051,14174,890,848,12,860,3
2020-12-28,Monterey,053,433212,28103,26529,703,27232,182
2020-12-28,Napa,055,140530,6037,5576,26,5602,26
2020-12-28,Nevada,057,99092,2778,2532,90,2622,15
2020-12-28,Orange,059,3164182,166349,152089,6418,158507,1839
2020-12-28,Placer,061,380077,14766,13234,584,13818,126
2020-12-28,Plumas,063,18699,476,391,8,399,0
2020-12-28,Riverside,065,2383286,190078,174029,8531,182560,1855
2020-12-28,Sacramento,067,1510023,66669,64322,624,64946,813
2020-12-28,San Benito,069,59416,3713,3429,29,3458,24
2020-12-28,San Bernardino,071,2135413,204498,188919,5563,194482,1552
2020-12-28,San Diego,073,3302833,164209,147528,7391,154919,1404
2020-12-28,San Francisco,075,870044,24037,22726,221,22947,178
2020-12-28,San Joaquin,077,732212,46707,44172,1627,45799,618
2020-12-28,San Luis Obispo,079,281455,11497,10260,257,10517,76
2020-12-28,San Mateo,081,765935,26028,23467,110,23577,189
2020-12-28,Santa Barbara,083,443738,18074,16579,509,17088,155
2020-12-28,Santa Clara,085,1922200,72586,66418,303,66721,619
2020-12-28,Santa Cruz,087,273765,9581,8310,352,8662,81
2020-12-28,Shasta,089,179085,8292,7688,716,8404,65
2020-12-28,Sierra,091,2930,32,24,4,28,0
2020-12-28,Siskiyou,093,43540,1026,915,108,1023,3
2020-12-28,Solano,095,438530,19613,18171,200,18371,96
2020-12-28,Sonoma,097,501317,19591,18667,108,18775,185
2020-12-28,Stanislaus,099,539301,35526,33473,3238,36711,507
2020-12-28,Sutter,101,95872,6577,6253,47,6300,49
2020-12-28,Tehama,103,63373,3126,2934,301,3235,9
2020-12-28,Trinity,105,12862,421,240,60,300,2
2020-12-28,Tulare,107,460477,34538,32010,3756,35766,404
2020-12-28,Tuolumne,109,53932,2897,2777,14,2791,12
2020-12-28,Ventura,111,848112,41618,37151,1666,38817,230
2020-12-28,Yolo,113,214977,8777,8031,67,8098,111
2020-12-28,Yuba,115,75493,3895,3679,39,3718,18
2020-12-27,Alameda,001,1643700,52539,49764,944,50708,551
2020-12-27,Alpine,003,1148,66,65,0,65,0
2020-12-27,Amador,005,37829,2450,2218,18,2236,23
2020-12-27,Butte,007,227075,7673,7016,859,7875,86
2020-12-27,Calaveras,009,45235,1110,1097,2,1099,21
2020-12-27,Colusa,011,21464,1299,1253,71,1324,7
2020-12-27,Contra Costa,013,1133247,40577,38428,547,38975,324
2020-12-27,Del Norte,015,27424,750,712,2,714,2
2020-12-27,El Dorado,017,186661,6137,5388,293,5681,18
2020-12-27,Fresno,019,978130,68371,63811,4419,68230,679
2020-12-27,Glenn,021,27897,1562,1434,247,1681,9
2020-12-27,Humboldt,023,135768,1767,1575,7,1582,17
2020-12-27,Imperial,025,180216,22841,21934,1217,23151,405
2020-12-27,Inyo,027,18085,676,565,8,573,18
2020-12-27,Kern,029,883053,66151,61914,4885,66799,568
2020-12-27,Kings,031,150075,16386,15593,501,16094,108
2020-12-27,Lake,033,64148,1908,1769,0,1769,22
2020-12-27,Lassen,035,31185,4372,4230,44,4274,1
2020-12-27,Los Angeles,037,10098052,766457,707260,20701,727961,9476
2020-12-27,Madera,039,155013,10728,10005,425,10430,64
2020-12-27,Marin,041,260295,9788,9477,71,9548,144
2020-12-27,Mariposa,043,17540,231,208,2,210,3
2020-12-27,Mendocino,045,87422,2442,2209,20,2229,23
2020-12-27,Merced,047,269075,18871,18075,327,18402,213
2020-12-27,Modoc,049,8938,252,221,71,292,0
2020-12-27,Mono,051,14174,878,849,12,861,3
2020-12-27,Monterey,053,433212,27543,26322,686,27008,181
2020-12-27,Napa,055,140530,5903,5496,26,5522,26
2020-12-27,Nevada,057,99092,2742,2519,90,2609,15
2020-12-27,Orange,059,3164182,161951,149276,6230,155506,1839
2020-12-27,Placer,061,380077,14471,13017,552,13569,126
2020-12-27,Plumas,063,18699,470,390,8,398,0
2020-12-27,Riverside,065,2383286,185162,171995,8225,180220,1836
2020-12-27,Sacramento,067,1510023,65462,63416,602,64018,811
2020-12-27,San Benito,069,59416,3628,3394,29,3423,24
2020-12-27,San Bernardino,071,2135413,199422,186776,5426,192202,1551
2020-12-27,San Diego,073,3302833,159802,145777,7204,152981,1402
2020-12-27,San Francisco,075,870044,23692,22514,212,22726,178
2020-12-27,San Joaquin,077,732212,45671,43529,1577,45106,618
2020-12-27,San Luis Obispo,079,281455,11089,10154,252,10406,76
2020-12-27,San Mateo,081,765935,25463,23136,106,23242,187
2020-12-27,Santa Barbara,083,443738,17545,16364,482,16846,155
2020-12-27,Santa Clara,085,1922200,70955,65288,298,65586,619
2020-12-27,Santa Cruz,087,273765,9316,8234,343,8577,81
2020-12-27,Shasta,089,179085,8165,7671,694,8365,65
2020-12-27,Sierra,091,2930,32,24,3,27,0
2020-12-27,Siskiyou,093,43540,1016,914,103,1017,3
2020-12-27,Solano,095,438530,19118,17840,194,18034,96
2020-12-27,Sonoma,097,501317,19299,18487,107,18594,185
2020-12-27,Stanislaus,099,539301,34908,33076,3142,36218,506
2020-12-27,Sutter,101,95872,6496,6218,45,6263,48
2020-12-27,Tehama,103,63373,3055,2922,285,3207,9
2020-12-27,Trinity,105,12862,414,240,58,298,2
2020-12-27,Tulare,107,460477,33941,31864,3638,35502,400
2020-12-27,Tuolumne,109,53932,2791,2750,12,2762,12
2020-12-27,Ventura,111,848112,40555,36661,1613,38274,230
2020-12-27,Yolo,113,214977,8588,7919,63,7982,111
2020-12-27,Yuba,115,75493,3830,3665,37,3702,18
2020-12-26,Alameda,001,1643700,51921,49084,931,50015,551
2020-12-26,Alpine,003,1148,66,65,0,65,0
2020-12-26,Amador,005,37829,2436,2189,18,2207,23
2020-12-26,Butte,007,227075,7578,6968,834,7802,86
2020-12-26,Calaveras,009,45235,1104,1084,2,1086,21
2020-12-26,Colusa,011,21464,1289,1240,71,1311,7
2020-12-26,Contra Costa,013,1133247,40110,38008,531,38539,324
2020-12-26,Del Norte,015,27424,744,709,2,711,2
2020-12-26,El Dorado,017,186661,6082,5279,289,5568,18
2020-12-26,Fresno,019,978130,67901,63080,4356,67436,679
2020-12-26,Glenn,021,27897,1541,1413,242,1655,9
2020-12-26,Humboldt,023,135768,1729,1545,7,1552,17
2020-12-26,Imperial,025,180216,22749,21734,1165,22899,405
2020-12-26,Inyo,027,18085,663,554,8,562,18
2020-12-26,Kern,029,883053,65480,61174,4736,65910,564
2020-12-26,Kings,031,150075,16268,15517,497,16014,108
2020-12-26,Lake,033,64148,1867,1710,0,1710,22
2020-12-26,Lassen,035,31185,4351,3981,44,4025,1
2020-12-26,Los Angeles,037,10098052,757899,694149,20197,714346,9424
2020-12-26,Madera,039,155013,10651,9908,413,10321,64
2020-12-26,Marin,041,260295,9753,9413,70,9483,143
2020-12-26,Mariposa,043,17540,230,206,2,208,3
2020-12-26,Mendocino,045,87422,2396,2194,20,2214,23
2020-12-26,Merced,047,269075,18712,17890,322,18212,213
2020-12-26,Modoc,049,8938,249,222,71,293,0
2020-12-26,Mono,051,14174,872,850,12,862,3
2020-12-26,Monterey,053,433212,27406,26010,677,26687,182
2020-12-26,Napa,055,140530,5845,5427,26,5453,26
2020-12-26,Nevada,057,99092,2714,2480,90,2570,15
2020-12-26,Orange,059,3164182,159745,147304,6138,153442,1838
2020-12-26,Placer,061,380077,14300,12816,537,13353,122
2020-12-26,Plumas,063,18699,467,381,8,389,0
2020-12-26,Riverside,065,2383286,182677,169360,8064,177424,1834
2020-12-26,Sacramento,067,1510023,64839,62435,592,63027,807
2020-12-26,San Benito,069,59416,3555,3330,29,3359,24
2020-12-26,San Bernardino,071,2135413,197747,185111,5344,190455,1551
2020-12-26,San Diego,073,3302833,157277,142644,7057,149701,1402
2020-12-26,San Francisco,075,870044,23454,22319,212,22531,177
2020-12-26,San Joaquin,077,732212,45286,42887,1528,44415,618
2020-12-26,San Luis Obispo,079,281455,11002,9945,247,10192,76
2020-12-26,San Mateo,081,765935,25124,22908,101,23009,187
2020-12-26,Santa Barbara,083,443738,17306,16159,476,16635,155
2020-12-26,Santa Clara,085,1922200,69881,64185,296,64481,618
2020-12-26,Santa Cruz,087,273765,9190,8113,334,8447,81
2020-12-26,Shasta,089,179085,8105,7641,681,8322,65
2020-12-26,Sierra,091,2930,32,24,3,27,0
2020-12-26,Siskiyou,093,43540,1009,909,99,1008,2
2020-12-26,Solano,095,438530,18873,17528,194,17722,96
2020-12-26,Sonoma,097,501317,19096,18261,105,18366,184
2020-12-26,Stanislaus,099,539301,34608,32678,3090,35768,505
2020-12-26,Sutter,101,95872,6437,6121,45,6166,48
2020-12-26,Tehama,103,63373,3026,2884,279,3163,9
2020-12-26,Trinity,105,12862,412,237,57,294,2
2020-12-26,Tulare,107,460477,33639,31665,3582,35247,398
2020-12-26,Tuolumne,109,53932,2780,2703,12,2715,12
2020-12-26,Ventura,111,848112,39590,36064,1582,37646,230
2020-12-26,Yolo,113,214977,8486,7785,60,7845,111
2020-12-26,Yuba,115,75493,3801,3599,37,3636,18
2020-12-25,Alameda,001,1643700,51350,48365,916,49281,542
2020-12-25,Alpine,003,1148,66,64,0,64,0
2020-12-25,Amador,005,37829,2393,2172,18,2190,23
2020-12-25,Butte,007,227075,7479,6873,815,7688,85
2020-12-25,Calaveras,009,45235,1101,1062,2,1064,21
2020-12-25,Colusa,011,21464,1277,1219,70,1289,7
2020-12-25,Contra Costa,013,1133247,39640,37480,506,37986,324
2020-12-25,Del Norte,015,27424,741,692,2,694,2
2020-12-25,El Dorado,017,186661,6017,5170,276,5446,16
2020-12-25,Fresno,019,978130,67037,62251,4274,66525,679
2020-12-25,Glenn,021,27897,1525,1390,235,1625,9
2020-12-25,Humboldt,023,135768,1689,1532,7,1539,16
2020-12-25,Imperial,025,180216,22654,21646,1154,22800,405
2020-12-25,Inyo,027,18085,653,546,8,554,18
2020-12-25,Kern,029,883053,64751,60417,4589,65006,562
2020-12-25,Kings,031,150075,16157,15460,493,15953,108
2020-12-25,Lake,033,64148,1847,1669,0,1669,20
2020-12-25,Lassen,035,31185,4336,3926,44,3970,1
2020-12-25,Los Angeles,037,10098052,744243,665600,19526,685126,9292
2020-12-25,Madera,039,155013,10483,9770,406,10176,64
2020-12-25,Marin,041,260295,9704,9375,67,9442,143
2020-12-25,Mariposa,043,17540,224,203,2,205,3
2020-12-25,Mendocino,045,87422,2353,2176,20,2196,23
2020-12-25,Merced,047,269075,18551,17726,314,18040,213
2020-12-25,Modoc,049,8938,248,221,71,292,0
2020-12-25,Mono,051,14174,870,843,12,855,3
2020-12-25,Monterey,053,433212,27130,25788,668,26456,182
2020-12-25,Napa,055,140530,5768,5351,26,5377,26
2020-12-25,Nevada,057,99092,2688,2458,88,2546,15
2020-12-25,Orange,059,3164182,157064,144542,5946,150488,1814
2020-12-25,Placer,061,380077,14114,12660,515,13175,122
2020-12-25,Plumas,063,18699,460,381,8,389,0
2020-12-25,Riverside,065,2383286,179392,166690,7748,174438,1825
2020-12-25,Sacramento,067,1510023,64145,61630,566,62196,796
2020-12-25,San Benito,069,59416,3514,3281,27,3308,24
2020-12-25,San Bernardino,071,2135413,195122,181812,5228,187040,1546
2020-12-25,San Diego,073,3302833,154797,139958,6879,146837,1402
2020-12-25,San Francisco,075,870044,23177,22130,207,22337,175
2020-12-25,San Joaquin,077,732212,44978,42089,1473,43562,614
2020-12-25,San Luis Obispo,079,281455,10819,9749,240,9989,76
2020-12-25,San Mateo,081,765935,24802,22568,99,22667,187
2020-12-25,Santa Barbara,083,443738,17082,15936,469,16405,155
2020-12-25,Santa Clara,085,1922200,68762,63173,287,63460,612
2020-12-25,Santa Cruz,087,273765,9046,8018,312,8330,81
2020-12-25,Shasta,089,179085,8031,7612,658,8270,65
2020-12-25,Sierra,091,2930,32,24,3,27,0
2020-12-25,Siskiyou,093,43540,1003,905,96,1001,2
2020-12-25,Solano,095,438530,18701,17280,192,17472,96
2020-12-25,Sonoma,097,501317,18921,18035,103,18138,184
2020-12-25,Stanislaus,099,539301,34308,32290,3039,35329,498
2020-12-25,Sutter,101,95872,6378,6051,44,6095,47
2020-12-25,Tehama,103,63373,2977,2839,266,3105,9
2020-12-25,Trinity,105,12862,408,236,57,293,2
2020-12-25,Tulare,107,460477,33246,31323,3518,34841,398
2020-12-25,Tuolumne,109,53932,2761,2674,12,2686,12
2020-12-25,Ventura,111,848112,38434,35514,1534,37048,230
2020-12-25,Yolo,113,214977,8390,7700,58,7758,111
2020-12-25,Yuba,115,75493,3765,3549,36,3585,17
2020-12-24,Alameda,001,1643700,50998,47527,896,48423,541
2020-12-24,Alpine,003,1148,66,64,0,64,0
2020-12-24,Amador,005,37829,2381,2145,18,2163,23
2020-12-24,Butte,007,227075,7440,6716,800,7516,84
2020-12-24,Calaveras,009,45235,1098,1032,2,1034,21
2020-12-24,Colusa,011,21464,1272,1188,68,1256,7
2020-12-24,Contra Costa,013,1133247,39398,36623,495,37118,311
2020-12-24,Del Norte,015,27424,741,678,2,680,2
2020-12-24,El Dorado,017,186661,5991,5042,268,5310,16
2020-12-24,Fresno,019,978130,66814,61435,4260,65695,663
2020-12-24,Glenn,021,27897,1514,1363,227,1590,9
2020-12-24,Humboldt,023,135768,1666,1516,7,1523,16
2020-12-24,Imperial,025,180216,22604,21545,1145,22690,402
2020-12-24,Inyo,027,18085,651,532,8,540,17
2020-12-24,Kern,029,883053,64464,59601,4576,64177,556
2020-12-24,Kings,031,150075,16117,15211,492,15703,108
2020-12-24,Lake,033,64148,1832,1629,0,1629,20
2020-12-24,Lassen,035,31185,4323,3894,44,3938,1
2020-12-24,Los Angeles,037,10098052,740069,664840,19269,684109,9288
2020-12-24,Madera,039,155013,10443,9547,399,9946,63
2020-12-24,Marin,041,260295,9670,9287,67,9354,143
2020-12-24,Mariposa,043,17540,220,197,2,199,3
2020-12-24,Mendocino,045,87422,2342,2150,20,2170,23
2020-12-24,Merced,047,269075,18480,17485,310,17795,212
2020-12-24,Modoc,049,8938,248,220,70,290,0
2020-12-24,Mono,051,14174,868,817,12,829,3
2020-12-24,Monterey,053,433212,27018,25131,661,25792,180
2020-12-24,Napa,055,140530,5713,5265,26,5291,26
2020-12-24,Nevada,057,99092,2664,2429,88,2517,15
2020-12-24,Orange,059,3164182,155582,141205,5894,147099,1775
2020-12-24,Placer,061,380077,14024,12457,508,12965,121
2020-12-24,Plumas,063,18699,457,376,8,384,0
2020-12-24,Riverside,065,2383286,178457,162435,7708,170143,1816
2020-12-24,Sacramento,067,1510023,63870,60596,564,61160,788
2020-12-24,San Benito,069,59416,3483,3183,27,3210,24
2020-12-24,San Bernardino,071,2135413,194071,176866,5194,182060,1533
2020-12-24,San Diego,073,3302833,153713,136952,6847,143799,1382
2020-12-24,San Francisco,075,870044,23009,21830,204,22034,175
2020-12-24,San Joaquin,077,732212,44813,41324,1455,42779,611
2020-12-24,San Luis Obispo,079,281455,10750,9504,238,9742,77
2020-12-24,San Mateo,081,765935,24607,22093,99,22192,186
2020-12-24,Santa Barbara,083,443738,16977,15644,461,16105,153
2020-12-24,Santa Clara,085,1922200,68154,61742,280,62022,591
2020-12-24,Santa Cruz,087,273765,8974,7856,300,8156,82
2020-12-24,Shasta,089,179085,7990,7540,641,8181,65
2020-12-24,Sierra,091,2930,29,23,1,24,0
2020-12-24,Siskiyou,093,43540,998,900,90,990,2
2020-12-24,Solano,095,438530,18560,16872,187,17059,96
2020-12-24,Sonoma,097,501317,18821,17710,103,17813,183
2020-12-24,Stanislaus,099,539301,34103,31848,3013,34861,498
2020-12-24,Sutter,101,95872,6337,5960,43,6003,47
2020-12-24,Tehama,103,63373,2959,2779,264,3043,9
2020-12-24,Trinity,105,12862,407,235,57,292,2
2020-12-24,Tulare,107,460477,33127,30827,3492,34319,390
2020-12-24,Tuolumne,109,53932,2753,2653,12,2665,12
2020-12-24,Ventura,111,848112,38154,34400,1527,35927,224
2020-12-24,Yolo,113,214977,8348,7566,56,7622,113
2020-12-24,Yuba,115,75493,3740,3483,36,3519,16
2020-12-23,Alameda,001,1643700,50418,46753,869,47622,537
2020-12-23,Alpine,003,1148,66,64,0,64,0
2020-12-23,Amador,005,37829,2312,2108,17,2125,23
2020-12-23,Butte,007,227075,7351,6588,774,7362,84
2020-12-23,Calaveras,009,45235,1090,1002,1,1003,21
2020-12-23,Colusa,011,21464,1261,1167,67,1234,7
2020-12-23,Contra Costa,013,1133247,38998,36190,481,36671,311
2020-12-23,Del Norte,015,27424,734,670,2,672,2
2020-12-23,El Dorado,017,186661,5916,4967,260,5227,14
2020-12-23,Fresno,019,978130,66204,60488,4195,64683,654
2020-12-23,Glenn,021,27897,1500,1349,223,1572,9
2020-12-23,Humboldt,023,135768,1641,1458,7,1465,16
2020-12-23,Imperial,025,180216,22509,21323,1116,22439,399
2020-12-23,Inyo,027,18085,639,517,8,525,17
2020-12-23,Kern,029,883053,63946,58656,4482,63138,549
2020-12-23,Kings,031,150075,16040,14923,489,15412,105
2020-12-23,Lake,033,64148,1819,1595,0,1595,20
2020-12-23,Lassen,035,31185,4313,3865,41,3906,1
2020-12-23,Los Angeles,037,10098052,731001,651958,18745,670703,9146
2020-12-23,Madera,039,155013,10284,9371,385,9756,63
2020-12-23,Marin,041,260295,9612,9199,64,9263,142
2020-12-23,Mariposa,043,17540,218,194,2,196,3
2020-12-23,Mendocino,045,87422,2330,2121,20,2141,23
2020-12-23,Merced,047,269075,18324,17250,302,17552,203
2020-12-23,Modoc,049,8938,244,197,69,266,0
2020-12-23,Mono,051,14174,865,814,12,826,3
2020-12-23,Monterey,053,433212,26718,24856,654,25510,176
2020-12-23,Napa,055,140530,5645,5172,26,5198,25
2020-12-23,Nevada,057,99092,2619,2406,87,2493,15
2020-12-23,Orange,059,3164182,153133,138050,5727,143777,1771
2020-12-23,Placer,061,380077,13814,12213,500,12713,111
2020-12-23,Plumas,063,18699,450,369,8,377,0
2020-12-23,Riverside,065,2383286,176186,158110,7550,165660,1790
2020-12-23,Sacramento,067,1510023,63220,59661,551,60212,779
2020-12-23,San Benito,069,59416,3429,3073,25,3098,24
2020-12-23,San Bernardino,071,2135413,192023,172888,5125,178013,1509
2020-12-23,San Diego,073,3302833,151287,134695,6710,141405,1350
2020-12-23,San Francisco,075,870044,22787,21498,201,21699,174
2020-12-23,San Joaquin,077,732212,44290,35664,1413,37077,602
2020-12-23,San Luis Obispo,079,281455,10608,9267,233,9500,74
2020-12-23,San Mateo,081,765935,24305,21780,97,21877,186
2020-12-23,Santa Barbara,083,443738,16769,15399,435,15834,152
2020-12-23,Santa Clara,085,1922200,67243,60455,275,60730,579
2020-12-23,Santa Cruz,087,273765,8814,7637,282,7919,75
2020-12-23,Shasta,089,179085,7918,7487,635,8122,66
2020-12-23,Sierra,091,2930,27,23,1,24,0
2020-12-23,Siskiyou,093,43540,977,891,89,980,2
2020-12-23,Solano,095,438530,18352,16626,183,16809,95
2020-12-23,Sonoma,097,501317,18617,17397,103,17500,182
2020-12-23,Stanislaus,099,539301,33749,31492,2960,34452,499
2020-12-23,Sutter,101,95872,6271,5871,43,5914,46
2020-12-23,Tehama,103,63373,2941,2737,257,2994,9
2020-12-23,Trinity,105,12862,407,234,56,290,2
2020-12-23,Tulare,107,460477,32834,30315,3453,33768,385
2020-12-23,Tuolumne,109,53932,2714,2540,12,2552,12
2020-12-23,Ventura,111,848112,37757,33377,1498,34875,216
2020-12-23,Yolo,113,214977,8270,7508,56,7564,112
2020-12-23,Yuba,115,75493,3687,3438,36,3474,14
2020-12-22,Alameda,001,1643700,49530,45751,838,46589,534
2020-12-22,Alpine,003,1148,66,64,0,64,0
2020-12-22,Amador,005,37829,2301,1839,17,1856,23
2020-12-22,Butte,007,227075,7223,6467,759,7226,85
2020-12-22,Calaveras,009,45235,1064,988,0,988,21
2020-12-22,Colusa,011,21464,1238,1150,64,1214,7
2020-12-22,Contra Costa,013,1133247,38372,35681,469,36150,301
2020-12-22,Del Norte,015,27424,727,666,2,668,2
2020-12-22,El Dorado,017,186661,5793,4885,248,5133,12
2020-12-22,Fresno,019,978130,65169,59640,4089,63729,640
2020-12-22,Glenn,021,27897,1477,1337,212,1549,9
2020-12-22,Humboldt,023,135768,1608,1440,7,1447,16
2020-12-22,Imperial,025,180216,22322,21128,1073,22201,398
2020-12-22,Inyo,027,18085,619,506,8,514,17
2020-12-22,Kern,029,883053,62993,57816,4345,62161,547
2020-12-22,Kings,031,150075,15898,14855,483,15338,102
2020-12-22,Lake,033,64148,1794,1569,0,1569,20
2020-12-22,Lassen,035,31185,4171,3848,39,3887,1
2020-12-22,Los Angeles,037,10098052,713734,635931,18074,654005,9013
2020-12-22,Madera,039,155013,10166,9187,369,9556,63
2020-12-22,Marin,041,260295,9548,9115,63,9178,142
2020-12-22,Mariposa,043,17540,215,194,2,196,3
2020-12-22,Mendocino,045,87422,2297,2092,20,2112,23
2020-12-22,Merced,047,269075,18078,17012,297,17309,201
2020-12-22,Modoc,049,8938,236,182,68,250,0
2020-12-22,Mono,051,14174,859,786,12,798,3
2020-12-22,Monterey,053,433212,26048,24152,633,24785,176
2020-12-22,Napa,055,140530,5556,5059,26,5085,23
2020-12-22,Nevada,057,99092,2591,2367,86,2453,14
2020-12-22,Orange,059,3164182,149794,134850,5554,140404,1774
2020-12-22,Placer,061,380077,13570,11943,480,12423,105
2020-12-22,Plumas,063,18699,444,360,8,368,0
2020-12-22,Riverside,065,2383286,172375,155059,7281,162340,1777
2020-12-22,Sacramento,067,1510023,62292,57966,532,58498,772
2020-12-22,San Benito,069,59416,3351,2998,25,3023,24
2020-12-22,San Bernardino,071,2135413,187431,169266,4977,174243,1500
2020-12-22,San Diego,073,3302833,147928,132097,6548,138645,1311
2020-12-22,San Francisco,075,870044,22517,21232,197,21429,174
2020-12-22,San Joaquin,077,732212,43529,39423,1364,40787,592
2020-12-22,San Luis Obispo,079,281455,10263,9174,228,9402,69
2020-12-22,San Mateo,081,765935,23979,21382,81,21463,186
2020-12-22,Santa Barbara,083,443738,16504,15189,425,15614,150
2020-12-22,Santa Clara,085,1922200,66071,59192,267,59459,569
2020-12-22,Santa Cruz,087,273765,8635,7471,256,7727,72
2020-12-22,Shasta,089,179085,7839,7371,618,7989,64
2020-12-22,Sierra,091,2930,27,23,0,23,0
2020-12-22,Siskiyou,093,43540,971,880,88,968,2
2020-12-22,Solano,095,438530,17949,16229,180,16409,95
2020-12-22,Sonoma,097,501317,18297,17216,103,17319,180
2020-12-22,Stanislaus,099,539301,33365,30914,2888,33802,499
2020-12-22,Sutter,101,95872,6212,5791,42,5833,46
2020-12-22,Tehama,103,63373,2891,2688,251,2939,9
2020-12-22,Trinity,105,12862,406,231,56,287,2
2020-12-22,Tulare,107,460477,32368,30025,3387,33412,377
2020-12-22,Tuolumne,109,53932,2663,2526,12,2538,12
2020-12-22,Ventura,111,848112,36992,32488,1455,33943,213
2020-12-22,Yolo,113,214977,8156,7388,55,7443,113
2020-12-22,Yuba,115,75493,3636,3379,36,3415,14
2020-12-21,Alameda,001,1643700,48630,44756,812,45568,518
2020-12-21,Alpine,003,1148,65,64,0,64,0
2020-12-21,Amador,005,37829,2224,1815,17,1832,23
2020-12-21,Butte,007,227075,7068,6335,735,7070,81
2020-12-21,Calaveras,009,45235,1034,963,0,963,21
2020-12-21,Colusa,011,21464,1211,1135,59,1194,7
2020-12-21,Contra Costa,013,1133247,37617,35207,432,35639,300
2020-12-21,Del Norte,015,27424,712,660,2,662,2
2020-12-21,El Dorado,017,186661,5647,4805,235,5040,10
2020-12-21,Fresno,019,978130,64018,58568,3946,62514,634
2020-12-21,Glenn,021,27897,1445,1323,204,1527,9
2020-12-21,Humboldt,023,135768,1585,1419,7,1426,16
2020-12-21,Imperial,025,180216,22053,20994,1030,22024,395
2020-12-21,Inyo,027,18085,598,482,8,490,17
2020-12-21,Kern,029,883053,62102,56836,4208,61044,541
2020-12-21,Kings,031,150075,15648,14760,468,15228,100
2020-12-21,Lake,033,64148,1739,1538,0,1538,20
2020-12-21,Lassen,035,31185,4011,3798,37,3835,1
2020-12-21,Los Angeles,037,10098052,694638,624129,17401,641530,8918
2020-12-21,Madera,039,155013,9972,9069,349,9418,63
2020-12-21,Marin,041,260295,9479,9035,63,9098,142
2020-12-21,Mariposa,043,17540,210,186,2,188,3
2020-12-21,Mendocino,045,87422,2266,2066,20,2086,23
2020-12-21,Merced,047,269075,17828,16710,281,16991,198
2020-12-21,Modoc,049,8938,222,181,67,248,0
2020-12-21,Mono,051,14174,847,781,12,793,3
2020-12-21,Monterey,053,433212,25517,23673,619,24292,174
2020-12-21,Napa,055,140530,5469,4952,26,4978,23
2020-12-21,Nevada,057,99092,2558,2337,86,2423,13
2020-12-21,Orange,059,3164182,146384,130444,5401,135845,1772
2020-12-21,Placer,061,380077,13338,11715,461,12176,105
2020-12-21,Plumas,063,18699,440,353,8,361,0
2020-12-21,Riverside,065,2383286,168148,151713,6956,158669,1743
2020-12-21,Sacramento,067,1510023,61272,57064,515,57579,759
2020-12-21,San Benito,069,59416,3283,2921,25,2946,22
2020-12-21,San Bernardino,071,2135413,182636,165086,4811,169897,1476
2020-12-21,San Diego,073,3302833,144477,129716,6384,136100,1284
2020-12-21,San Francisco,075,870044,22231,21086,195,21281,174
2020-12-21,San Joaquin,077,732212,42735,38811,1314,40125,586
2020-12-21,San Luis Obispo,079,281455,10074,9006,223,9229,64
2020-12-21,San Mateo,081,765935,23574,21035,78,21113,185
2020-12-21,Santa Barbara,083,443738,16229,14988,420,15408,149
2020-12-21,Santa Clara,085,1922200,64878,57699,255,57954,570
2020-12-21,Santa Cruz,087,273765,8424,7315,243,7558,69
2020-12-21,Shasta,089,179085,7774,7299,608,7907,64
2020-12-21,Sierra,091,2930,24,23,0,23,0
2020-12-21,Siskiyou,093,43540,964,878,87,965,2
2020-12-21,Solano,095,438530,17479,15878,175,16053,95
2020-12-21,Sonoma,097,501317,18024,17075,99,17174,176
2020-12-21,Stanislaus,099,539301,32908,30437,2813,33250,499
2020-12-21,Sutter,101,95872,6117,5708,42,5750,46
2020-12-21,Tehama,103,63373,2826,2656,242,2898,9
2020-12-21,Trinity,105,12862,404,226,54,280,2
2020-12-21,Tulare,107,460477,31871,29482,3298,32780,373
2020-12-21,Tuolumne,109,53932,2638,2423,10,2433,12
2020-12-21,Ventura,111,848112,35912,31759,1418,33177,212
2020-12-21,Yolo,113,214977,8011,7266,51,7317,109
2020-12-21,Yuba,115,75493,3577,3329,36,3365,14
2020-12-20,Alameda,001,1643700,47748,44004,790,44794,516
2020-12-20,Alpine,003,1148,65,64,0,64,0
2020-12-20,Amador,005,37829,2166,1771,17,1788,23
2020-12-20,Butte,007,227075,6922,6228,699,6927,81
2020-12-20,Calaveras,009,45235,1010,926,0,926,21
2020-12-20,Colusa,011,21464,1183,1121,53,1174,7
2020-12-20,Contra Costa,013,1133247,37031,34798,416,35214,301
2020-12-20,Del Norte,015,27424,690,652,2,654,2
2020-12-20,El Dorado,017,186661,5522,4697,226,4923,10
2020-12-20,Fresno,019,978130,63027,57616,3809,61425,634
2020-12-20,Glenn,021,27897,1436,1295,197,1492,9
2020-12-20,Humboldt,023,135768,1548,1386,6,1392,15
2020-12-20,Imperial,025,180216,21813,20882,926,21808,395
2020-12-20,Inyo,027,18085,583,476,8,484,17
2020-12-20,Kern,029,883053,61004,55983,4053,60036,540
2020-12-20,Kings,031,150075,15428,14629,452,15081,100
2020-12-20,Lake,033,64148,1693,1463,0,1463,20
2020-12-20,Lassen,035,31185,3957,3669,35,3704,1
2020-12-20,Los Angeles,037,10098052,676547,612975,16670,629645,8862
2020-12-20,Madera,039,155013,9762,8871,340,9211,63
2020-12-20,Marin,041,260295,9381,8948,60,9008,142
2020-12-20,Mariposa,043,17540,209,179,2,181,3
2020-12-20,Mendocino,045,87422,2241,2033,20,2053,23
2020-12-20,Merced,047,269075,17512,16435,274,16709,198
2020-12-20,Modoc,049,8938,222,181,65,246,0
2020-12-20,Mono,051,14174,829,774,12,786,3
2020-12-20,Monterey,053,433212,25034,23250,578,23828,173
2020-12-20,Napa,055,140530,5348,4865,24,4889,23
2020-12-20,Nevada,057,99092,2512,2289,80,2369,13
2020-12-20,Orange,059,3164182,142883,128780,5251,134031,1763
2020-12-20,Placer,061,380077,13113,11496,443,11939,105
2020-12-20,Plumas,063,18699,432,347,8,355,0
2020-12-20,Riverside,065,2383286,163942,148714,6664,155378,1742
2020-12-20,Sacramento,067,1510023,60272,56017,495,56512,755
2020-12-20,San Benito,069,59416,3211,2885,24,2909,21
2020-12-20,San Bernardino,071,2135413,177644,162810,4653,167463,1458
2020-12-20,San Diego,073,3302833,140759,126465,6214,132679,1280
2020-12-20,San Francisco,075,870044,21916,20937,192,21129,174
2020-12-20,San Joaquin,077,732212,41891,38268,1253,39521,587
2020-12-20,San Luis Obispo,079,281455,9782,8881,217,9098,63
2020-12-20,San Mateo,081,765935,23140,20764,74,20838,185
2020-12-20,Santa Barbara,083,443738,15907,14817,400,15217,148
2020-12-20,Santa Clara,085,1922200,63470,56860,249,57109,566
2020-12-20,Santa Cruz,087,273765,8216,7178,230,7408,69
2020-12-20,Shasta,089,179085,7660,7256,594,7850,64
2020-12-20,Sierra,091,2930,24,22,0,22,0
2020-12-20,Siskiyou,093,43540,954,870,86,956,2
2020-12-20,Solano,095,438530,17101,15533,164,15697,95
2020-12-20,Sonoma,097,501317,17748,16802,98,16900,175
2020-12-20,Stanislaus,099,539301,32382,29995,2711,32706,498
2020-12-20,Sutter,101,95872,6030,5601,42,5643,43
2020-12-20,Tehama,103,63373,2777,2602,223,2825,9
2020-12-20,Trinity,105,12862,396,221,53,274,2
2020-12-20,Tulare,107,460477,31353,29078,3203,32281,373
2020-12-20,Tuolumne,109,53932,2527,2152,9,2161,12
2020-12-20,Ventura,111,848112,35210,31335,1385,32720,210
2020-12-20,Yolo,113,214977,7859,7121,48,7169,109
2020-12-20,Yuba,115,75493,3530,3254,34,3288,12
2020-12-19,Alameda,001,1643700,47302,43109,783,43892,516
2020-12-19,Alpine,003,1148,65,64,0,64,0
2020-12-19,Amador,005,37829,2142,1754,17,1771,23
2020-12-19,Butte,007,227075,6822,6118,676,6794,81
2020-12-19,Calaveras,009,45235,993,900,0,900,21
2020-12-19,Colusa,011,21464,1175,1096,50,1146,7
2020-12-19,Contra Costa,013,1133247,36716,34321,402,34723,301
2020-12-19,Del Norte,015,27424,688,641,1,642,2
2020-12-19,El Dorado,017,186661,5455,4588,218,4806,10
2020-12-19,Fresno,019,978130,62702,55428,3741,59169,634
2020-12-19,Glenn,021,27897,1401,1286,196,1482,9
2020-12-19,Humboldt,023,135768,1531,1357,6,1363,15
2020-12-19,Imperial,025,180216,21720,20711,880,21591,395
2020-12-19,Inyo,027,18085,576,475,8,483,17
2020-12-19,Kern,029,883053,60519,55118,3946,59064,540
2020-12-19,Kings,031,150075,15349,14474,450,14924,100
2020-12-19,Lake,033,64148,1658,1438,0,1438,20
2020-12-19,Lassen,035,31185,3929,3595,35,3630,1
2020-12-19,Los Angeles,037,10098052,669438,599888,16140,616028,8804
2020-12-19,Madera,039,155013,9670,8717,328,9045,63
2020-12-19,Marin,041,260295,9341,8864,60,8924,142
2020-12-19,Mariposa,043,17540,207,177,2,179,3
2020-12-19,Mendocino,045,87422,2216,2008,20,2028,23
2020-12-19,Merced,047,269075,17373,16230,266,16496,198
2020-12-19,Modoc,049,8938,219,181,65,246,0
2020-12-19,Mono,051,14174,822,766,12,778,3
2020-12-19,Monterey,053,433212,24919,22799,573,23372,172
2020-12-19,Napa,055,140530,5286,4772,24,4796,23
2020-12-19,Nevada,057,99092,2490,2260,80,2340,13
2020-12-19,Orange,059,3164182,140960,125574,5101,130675,1733
2020-12-19,Placer,061,380077,12958,11246,437,11683,105
2020-12-19,Plumas,063,18699,429,343,8,351,0
2020-12-19,Riverside,065,2383286,161955,146703,6428,153131,1737
2020-12-19,Sacramento,067,1510023,59740,55169,481,55650,746
2020-12-19,San Benito,069,59416,3165,2820,23,2843,21
2020-12-19,San Bernardino,071,2135413,176070,159883,4546,164429,1433
2020-12-19,San Diego,073,3302833,138992,122972,6075,129047,1280
2020-12-19,San Francisco,075,870044,21765,20643,192,20835,174
2020-12-19,San Joaquin,077,732212,41489,37340,1203,38543,586
2020-12-19,San Luis Obispo,079,281455,9711,8788,214,9002,63
2020-12-19,San Mateo,081,765935,22930,20393,67,20460,182
2020-12-19,Santa Barbara,083,443738,15751,14667,394,15061,148
2020-12-19,Santa Clara,085,1922200,62655,55540,245,55785,558
2020-12-19,Santa Cruz,087,273765,8111,7054,225,7279,68
2020-12-19,Shasta,089,179085,7608,7221,582,7803,63
2020-12-19,Sierra,091,2930,24,23,0,23,0
2020-12-19,Siskiyou,093,43540,950,853,85,938,2
2020-12-19,Solano,095,438530,16935,15204,160,15364,95
2020-12-19,Sonoma,097,501317,17639,16553,98,16651,175
2020-12-19,Stanislaus,099,539301,32061,29555,2638,32193,498
2020-12-19,Sutter,101,95872,5973,5506,42,5548,41
2020-12-19,Tehama,103,63373,2728,2574,221,2795,9
2020-12-19,Trinity,105,12862,395,219,53,272,2
2020-12-19,Tulare,107,460477,31129,28734,3137,31871,375
2020-12-19,Tuolumne,109,53932,2514,2107,9,2116,12
2020-12-19,Ventura,111,848112,34929,30843,1355,32198,209
2020-12-19,Yolo,113,214977,7790,7025,47,7072,109
2020-12-19,Yuba,115,75493,3498,3168,34,3202,11
2020-12-18,Alameda,001,1643700,46764,42196,766,42962,515
2020-12-18,Alpine,003,1148,65,64,0,64,0
2020-12-18,Amador,005,37829,2125,1727,15,1742,20
2020-12-18,Butte,007,227075,6737,5891,650,6541,81
2020-12-18,Calaveras,009,45235,983,870,0,870,21
2020-12-18,Colusa,011,21464,1166,1068,50,1118,7
2020-12-18,Contra Costa,013,1133247,36431,33610,390,34000,300
2020-12-18,Del Norte,015,27424,683,627,0,627,2
2020-12-18,El Dorado,017,186661,5393,4494,209,4703,10
2020-12-18,Fresno,019,978130,61875,52643,3677,56320,613
2020-12-18,Glenn,021,27897,1384,1264,191,1455,9
2020-12-18,Humboldt,023,135768,1516,1331,6,1337,15
2020-12-18,Imperial,025,180216,21641,20430,833,21263,393
2020-12-18,Inyo,027,18085,556,454,8,462,17
2020-12-18,Kern,029,883053,59858,54220,3861,58081,533
2020-12-18,Kings,031,150075,15223,14284,444,14728,98
2020-12-18,Lake,033,64148,1646,1397,0,1397,20
2020-12-18,Lassen,035,31185,3921,3486,35,3521,1
2020-12-18,Los Angeles,037,10098052,657298,586413,15642,602055,8744
2020-12-18,Madera,039,155013,9568,8609,323,8932,63
2020-12-18,Marin,041,260295,9257,8799,60,8859,142
2020-12-18,Mariposa,043,17540,204,176,2,178,3
2020-12-18,Mendocino,045,87422,2198,1977,20,1997,24
2020-12-18,Merced,047,269075,17292,15956,263,16219,195
2020-12-18,Modoc,049,8938,219,179,65,244,0
2020-12-18,Mono,051,14174,814,731,12,743,3
2020-12-18,Monterey,053,433212,24625,22336,567,22903,165
2020-12-18,Napa,055,140530,5237,4688,24,4712,23
2020-12-18,Nevada,057,99092,2473,2220,79,2299,13
2020-12-18,Orange,059,3164182,138523,121681,4951,126632,1725
2020-12-18,Placer,061,380077,12787,10995,428,11423,104
2020-12-18,Plumas,063,18699,423,336,8,344,0
2020-12-18,Riverside,065,2383286,159115,142375,6159,148534,1733
2020-12-18,Sacramento,067,1510023,59114,53980,465,54445,736
2020-12-18,San Benito,069,59416,3116,2744,23,2767,21
2020-12-18,San Bernardino,071,2135413,173769,154272,4412,158684,1430
2020-12-18,San Diego,073,3302833,136814,120463,5936,126399,1253
2020-12-18,San Francisco,075,870044,21599,20315,186,20501,173
2020-12-18,San Joaquin,077,732212,41130,36484,1172,37656,559
2020-12-18,San Luis Obispo,079,281455,9613,8598,209,8807,62
2020-12-18,San Mateo,081,765935,22617,19971,63,20034,182
2020-12-18,Santa Barbara,083,443738,15610,14361,381,14742,148
2020-12-18,Santa Clara,085,1922200,61783,53992,236,54228,539
2020-12-18,Santa Cruz,087,273765,7995,6838,217,7055,68
2020-12-18,Shasta,089,179085,7570,7114,571,7685,62
2020-12-18,Sierra,091,2930,24,23,0,23,0
2020-12-18,Siskiyou,093,43540,948,840,85,925,2
2020-12-18,Solano,095,438530,16782,14667,156,14823,95
2020-12-18,Sonoma,097,501317,17520,16261,98,16359,173
2020-12-18,Stanislaus,099,539301,31788,28967,2602,31569,490
2020-12-18,Sutter,101,95872,5889,5399,42,5441,39
2020-12-18,Tehama,103,63373,2713,2523,211,2734,9
2020-12-18,Trinity,105,12862,394,215,53,268,2
2020-12-18,Tulare,107,460477,30852,28322,3058,31380,370
2020-12-18,Tuolumne,109,53932,2503,2067,9,2076,12
2020-12-18,Ventura,111,848112,34425,29907,1312,31219,209
2020-12-18,Yolo,113,214977,7722,6901,46,6947,109
2020-12-18,Yuba,115,75493,3440,3097,34,3131,11
2020-12-17,Alameda,001,1643700,45957,41548,733,42281,508
2020-12-17,Alpine,003,1148,65,64,0,64,0
2020-12-17,Amador,005,37829,2077,1703,13,1716,19
2020-12-17,Butte,007,227075,6611,5746,632,6378,78
2020-12-17,Calaveras,009,45235,960,848,0,848,21
2020-12-17,Colusa,011,21464,1155,1053,48,1101,7
2020-12-17,Contra Costa,013,1133247,35906,33006,356,33362,293
2020-12-17,Del Norte,015,27424,678,583,0,583,1
2020-12-17,El Dorado,017,186661,5247,4327,196,4523,9
2020-12-17,Fresno,019,978130,61012,49918,3551,53469,597
2020-12-17,Glenn,021,27897,1360,1244,184,1428,9
2020-12-17,Humboldt,023,135768,1483,1322,6,1328,14
2020-12-17,Imperial,025,180216,21477,20208,765,20973,391
2020-12-17,Inyo,027,18085,538,450,6,456,16
2020-12-17,Kern,029,883053,58901,53683,3726,57409,526
2020-12-17,Kings,031,150075,15120,14057,429,14486,98
2020-12-17,Lake,033,64148,1621,1374,0,1374,20
2020-12-17,Lassen,035,31185,3885,3417,35,3452,1
2020-12-17,Los Angeles,037,10098052,641636,571093,15094,586187,8657
2020-12-17,Madera,039,155013,9451,8465,319,8784,62
2020-12-17,Marin,041,260295,9193,8721,58,8779,142
2020-12-17,Mariposa,043,17540,200,172,2,174,3
2020-12-17,Mendocino,045,87422,2164,1942,20,1962,23
2020-12-17,Merced,047,269075,17028,15648,255,15903,192
2020-12-17,Modoc,049,8938,216,179,65,244,0
2020-12-17,Mono,051,14174,800,718,12,730,3
2020-12-17,Monterey,053,433212,24106,21951,552,22503,163
2020-12-17,Napa,055,140530,5125,4612,24,4636,23
2020-12-17,Nevada,057,99092,2432,2173,76,2249,13
2020-12-17,Orange,059,3164182,135147,118367,4816,123183,1725
2020-12-17,Placer,061,380077,12513,10756,414,11170,99
2020-12-17,Plumas,063,18699,414,324,8,332,0
2020-12-17,Riverside,065,2383286,155231,139325,5944,145269,1696
2020-12-17,Sacramento,067,1510023,58208,53189,443,53632,721
2020-12-17,San Benito,069,59416,3047,2645,22,2667,20
2020-12-17,San Bernardino,071,2135413,169829,149838,4296,154134,1425
2020-12-17,San Diego,073,3302833,134013,116852,5780,122632,1239
2020-12-17,San Francisco,075,870044,21312,19939,181,20120,170
2020-12-17,San Joaquin,077,732212,40403,35894,1136,37030,554
2020-12-17,San Luis Obispo,079,281455,9493,8365,207,8572,59
2020-12-17,San Mateo,081,765935,22247,19647,63,19710,181
2020-12-17,Santa Barbara,083,443738,15377,14207,374,14581,147
2020-12-17,Santa Clara,085,1922200,60614,52559,230,52789,527
2020-12-17,Santa Cruz,087,273765,7840,6687,204,6891,64
2020-12-17,Shasta,089,179085,7493,7000,552,7552,62
2020-12-17,Sierra,091,2930,23,23,0,23,0
2020-12-17,Siskiyou,093,43540,941,827,84,911,2
2020-12-17,Solano,095,438530,16476,14361,154,14515,96
2020-12-17,Sonoma,097,501317,17248,15993,97,16090,171
2020-12-17,Stanislaus,099,539301,31362,28582,2543,31125,489
2020-12-17,Sutter,101,95872,5790,5309,40,5349,39
2020-12-17,Tehama,103,63373,2664,2480,205,2685,9
2020-12-17,Trinity,105,12862,389,213,53,266,2
2020-12-17,Tulare,107,460477,30460,27852,2979,30831,358
2020-12-17,Tuolumne,109,53932,2212,1992,9,2001,11
2020-12-17,Ventura,111,848112,33815,29404,1275,30679,208
2020-12-17,Yolo,113,214977,7597,6800,45,6845,105
2020-12-17,Yuba,115,75493,3381,3035,32,3067,12
2020-12-16,Alameda,001,1643700,45104,40751,708,41459,497
2020-12-16,Alpine,003,1148,65,64,0,64,0
2020-12-16,Amador,005,37829,2030,1693,12,1705,19
2020-12-16,Butte,007,227075,6422,5659,604,6263,76
2020-12-16,Calaveras,009,45235,925,821,0,821,21
2020-12-16,Colusa,011,21464,1142,1038,45,1083,7
2020-12-16,Contra Costa,013,1133247,35348,32429,336,32765,293
2020-12-16,Del Norte,015,27424,676,575,0,575,1
2020-12-16,El Dorado,017,186661,5126,4237,187,4424,9
2020-12-16,Fresno,019,978130,60054,49173,3455,52628,584
2020-12-16,Glenn,021,27897,1342,1236,173,1409,9
2020-12-16,Humboldt,023,135768,1451,1308,5,1313,12
2020-12-16,Imperial,025,180216,21295,19980,699,20679,388
2020-12-16,Inyo,027,18085,525,444,6,450,16
2020-12-16,Kern,029,883053,58024,52896,3593,56489,522
2020-12-16,Kings,031,150075,14940,13734,412,14146,99
2020-12-16,Lake,033,64148,1581,1363,0,1363,20
2020-12-16,Lassen,035,31185,3852,3396,34,3430,1
2020-12-16,Los Angeles,037,10098052,625099,557907,14415,572322,8561
2020-12-16,Madera,039,155013,9326,8278,311,8589,62
2020-12-16,Marin,041,260295,9122,8641,58,8699,142
2020-12-16,Mariposa,043,17540,197,175,2,177,3
2020-12-16,Mendocino,045,87422,2129,1929,20,1949,23
2020-12-16,Merced,047,269075,16742,15443,251,15694,190
2020-12-16,Modoc,049,8938,213,178,65,243,0
2020-12-16,Mono,051,14174,781,702,12,714,3
2020-12-16,Monterey,053,433212,23547,21107,541,21648,163
2020-12-16,Napa,055,140530,5028,4544,24,4568,23
2020-12-16,Nevada,057,99092,2396,2149,74,2223,13
2020-12-16,Orange,059,3164182,131672,115260,4649,119909,1712
2020-12-16,Placer,061,380077,12276,10554,393,10947,96
2020-12-16,Plumas,063,18699,405,319,8,327,0
2020-12-16,Riverside,065,2383286,151107,135751,5695,141446,1664
2020-12-16,Sacramento,067,1510023,57234,52166,418,52584,715
2020-12-16,San Benito,069,59416,2956,2582,22,2604,20
2020-12-16,San Bernardino,071,2135413,165222,143565,4161,147726,1403
2020-12-16,San Diego,073,3302833,130909,114248,5626,119874,1217
2020-12-16,San Francisco,075,870044,21053,19624,181,19805,170
2020-12-16,San Joaquin,077,732212,39579,35010,1096,36106,547
2020-12-16,San Luis Obispo,079,281455,9298,8252,198,8450,58
2020-12-16,San Mateo,081,765935,21922,19292,59,19351,179
2020-12-16,Santa Barbara,083,443738,15126,13966,362,14328,144
2020-12-16,Santa Clara,085,1922200,59371,51502,227,51729,523
2020-12-16,Santa Cruz,087,273765,7656,6536,193,6729,63
2020-12-16,Shasta,089,179085,7420,6914,529,7443,62
2020-12-16,Sierra,091,2930,23,23,0,23,0
2020-12-16,Siskiyou,093,43540,933,818,84,902,2
2020-12-16,Solano,095,438530,16009,14157,150,14307,96
2020-12-16,Sonoma,097,501317,16992,15768,97,15865,170
2020-12-16,Stanislaus,099,539301,30861,28279,2470,30749,489
2020-12-16,Sutter,101,95872,5710,5223,40,5263,39
2020-12-16,Tehama,103,63373,2631,2441,180,2621,9
2020-12-16,Trinity,105,12862,383,212,53,265,2
2020-12-16,Tulare,107,460477,30037,27500,2879,30379,352
2020-12-16,Tuolumne,109,53932,2169,1941,9,1950,11
2020-12-16,Ventura,111,848112,33041,28566,1232,29798,203
2020-12-16,Yolo,113,214977,7469,6649,44,6693,103
2020-12-16,Yuba,115,75493,3295,2980,31,3011,11
2020-12-15,Alameda,001,1643700,44249,40026,686,40712,492
2020-12-15,Alpine,003,1148,65,64,0,64,0
2020-12-15,Amador,005,37829,1917,1669,10,1679,19
2020-12-15,Butte,007,227075,6283,5565,575,6140,75
2020-12-15,Calaveras,009,45235,893,799,0,799,21
2020-12-15,Colusa,011,21464,1129,1026,44,1070,7
2020-12-15,Contra Costa,013,1133247,34690,31423,322,31745,281
2020-12-15,Del Norte,015,27424,665,564,0,564,1
2020-12-15,El Dorado,017,186661,5018,4113,173,4286,9
2020-12-15,Fresno,019,978130,58681,47316,3321,50637,574
2020-12-15,Glenn,021,27897,1329,1207,157,1364,9
2020-12-15,Humboldt,023,135768,1431,1276,5,1281,12
2020-12-15,Imperial,025,180216,21075,19756,620,20376,380
2020-12-15,Inyo,027,18085,512,394,6,400,16
2020-12-15,Kern,029,883053,57013,52002,3487,55489,511
2020-12-15,Kings,031,150075,14776,13652,393,14045,97
2020-12-15,Lake,033,64148,1556,1341,0,1341,21
2020-12-15,Lassen,035,31185,3680,3378,33,3411,1
2020-12-15,Los Angeles,037,10098052,608717,536258,13774,550032,8429
2020-12-15,Madera,039,155013,9172,8118,304,8422,60
2020-12-15,Marin,041,260295,9014,8528,56,8584,141
2020-12-15,Mariposa,043,17540,193,171,2,173,3
2020-12-15,Mendocino,045,87422,2102,1883,20,1903,24
2020-12-15,Merced,047,269075,16444,15120,247,15367,190
2020-12-15,Modoc,049,8938,211,179,65,244,0
2020-12-15,Mono,051,14174,765,702,12,714,3
2020-12-15,Monterey,053,433212,22949,19905,480,20385,161
2020-12-15,Napa,055,140530,4925,4440,24,4464,23
2020-12-15,Nevada,057,99092,2363,2117,72,2189,11
2020-12-15,Orange,059,3164182,128020,112893,4496,117389,1689
2020-12-15,Placer,061,380077,12042,10301,371,10672,95
2020-12-15,Plumas,063,18699,400,313,8,321,0
2020-12-15,Riverside,065,2383286,147049,131822,5416,137238,1624
2020-12-15,Sacramento,067,1510023,56217,51076,405,51481,703
2020-12-15,San Benito,069,59416,2877,2520,21,2541,19
2020-12-15,San Bernardino,071,2135413,160762,137548,4010,141558,1351
2020-12-15,San Diego,073,3302833,127342,111441,5463,116904,1194
2020-12-15,San Francisco,075,870044,20743,19283,178,19461,171
2020-12-15,San Joaquin,077,732212,38653,33849,1060,34909,537
2020-12-15,San Luis Obispo,079,281455,9189,8074,195,8269,55
2020-12-15,San Mateo,081,765935,21512,18907,57,18964,178
2020-12-15,Santa Barbara,083,443738,14899,13782,354,14136,144
2020-12-15,Santa Clara,085,1922200,57935,50311,224,50535,505
2020-12-15,Santa Cruz,087,273765,7471,6361,179,6540,59
2020-12-15,Shasta,089,179085,7361,6794,504,7298,54
2020-12-15,Sierra,091,2930,23,23,0,23,0
2020-12-15,Siskiyou,093,43540,924,812,83,895,2
2020-12-15,Solano,095,438530,15659,13796,150,13946,95
2020-12-15,Sonoma,097,501317,16771,15406,97,15503,167
2020-12-15,Stanislaus,099,539301,30348,27823,2389,30212,485
2020-12-15,Sutter,101,95872,5613,5080,39,5119,36
2020-12-15,Tehama,103,63373,2593,2392,174,2566,9
2020-12-15,Trinity,105,12862,375,213,51,264,1
2020-12-15,Tulare,107,460477,29549,27026,2789,29815,342
2020-12-15,Tuolumne,109,53932,2139,1874,9,1883,8
2020-12-15,Ventura,111,848112,32419,27936,1185,29121,201
2020-12-15,Yolo,113,214977,7346,6531,42,6573,104
2020-12-15,Yuba,115,75493,3201,2891,30,2921,11
2020-12-14,Alameda,001,1643700,43351,39252,667,39919,487
2020-12-14,Alpine,003,1148,65,63,0,63,0
2020-12-14,Amador,005,37829,1845,1609,10,1619,19
2020-12-14,Butte,007,227075,6115,5202,558,5760,75
2020-12-14,Calaveras,009,45235,855,718,0,718,21
2020-12-14,Colusa,011,21464,1105,949,43,992,7
2020-12-14,Contra Costa,013,1133247,33992,30594,308,30902,281
2020-12-14,Del Norte,015,27424,659,560,0,560,1
2020-12-14,El Dorado,017,186661,4862,4018,157,4175,9
2020-12-14,Fresno,019,978130,57657,44726,3142,47868,560
2020-12-14,Glenn,021,27897,1303,1186,149,1335,9
2020-12-14,Humboldt,023,135768,1418,1256,5,1261,9
2020-12-14,Imperial,025,180216,20836,19608,542,20150,379
2020-12-14,Inyo,027,18085,498,382,6,388,16
2020-12-14,Kern,029,883053,55976,50538,3366,53904,510
2020-12-14,Kings,031,150075,14591,13491,366,13857,97
2020-12-14,Lake,033,64148,1508,1301,0,1301,21
2020-12-14,Lassen,035,31185,3582,2905,30,2935,1
2020-12-14,Los Angeles,037,10098052,591087,524668,13136,537804,8340
2020-12-14,Madera,039,155013,8905,8011,295,8306,60
2020-12-14,Marin,041,260295,8931,8475,55,8530,141
2020-12-14,Mariposa,043,17540,192,171,2,173,3
2020-12-14,Mendocino,045,87422,2081,1845,20,1865,24
2020-12-14,Merced,047,269075,16036,14572,233,14805,189
2020-12-14,Modoc,049,8938,205,180,63,243,0
2020-12-14,Mono,051,14174,757,685,12,697,3
2020-12-14,Monterey,053,433212,22427,19154,474,19628,155
2020-12-14,Napa,055,140530,4832,4289,24,4313,22
2020-12-14,Nevada,057,99092,2325,2070,69,2139,11
2020-12-14,Orange,059,3164182,124135,108602,4360,112962,1688
2020-12-14,Placer,061,380077,11761,9551,360,9911,95
2020-12-14,Plumas,063,18699,388,309,8,317,0
2020-12-14,Riverside,065,2383286,142920,123715,5154,128869,1588
2020-12-14,Sacramento,067,1510023,55109,50304,380,50684,691
2020-12-14,San Benito,069,59416,2811,2467,20,2487,19
2020-12-14,San Bernardino,071,2135413,156312,129151,3882,133033,1347
2020-12-14,San Diego,073,3302833,123606,109578,5278,114856,1162
2020-12-14,San Francisco,075,870044,20367,18904,176,19080,171
2020-12-14,San Joaquin,077,732212,37811,32522,1014,33536,534
2020-12-14,San Luis Obispo,079,281455,8943,7791,191,7982,52
2020-12-14,San Mateo,081,765935,21014,18361,54,18415,178
2020-12-14,Santa Barbara,083,443738,14626,13587,346,13933,144
2020-12-14,Santa Clara,085,1922200,56375,49180,212,49392,502
2020-12-14,Santa Cruz,087,273765,7285,6049,164,6213,54
2020-12-14,Shasta,089,179085,7272,6665,485,7150,54
2020-12-14,Sierra,091,2930,23,21,0,21,0
2020-12-14,Siskiyou,093,43540,901,764,77,841,2
2020-12-14,Solano,095,438530,15298,13352,149,13501,93
2020-12-14,Sonoma,097,501317,16465,14807,96,14903,167
2020-12-14,Stanislaus,099,539301,29813,27311,2340,29651,485
2020-12-14,Sutter,101,95872,5509,5001,32,5033,35
2020-12-14,Tehama,103,63373,2551,2344,171,2515,9
2020-12-14,Trinity,105,12862,371,205,49,254,1
2020-12-14,Tulare,107,460477,29074,25735,2699,28434,341
2020-12-14,Tuolumne,109,53932,2086,1647,9,1656,8
2020-12-14,Ventura,111,848112,31496,27436,1126,28562,202
2020-12-14,Yolo,113,214977,7185,6389,41,6430,95
2020-12-14,Yuba,115,75493,3139,2851,30,2881,11
2020-12-13,Alameda,001,1643700,42153,38064,642,38706,486
2020-12-13,Alpine,003,1148,65,63,0,63,0
2020-12-13,Amador,005,37829,1789,1457,9,1466,19
2020-12-13,Butte,007,227075,5967,5103,518,5621,75
2020-12-13,Calaveras,009,45235,819,710,0,710,21
2020-12-13,Colusa,011,21464,1089,945,40,985,7
2020-12-13,Contra Costa,013,1133247,33264,29667,302,29969,281
2020-12-13,Del Norte,015,27424,606,542,0,542,1
2020-12-13,El Dorado,017,186661,4761,3770,146,3916,9
2020-12-13,Fresno,019,978130,56550,44114,2983,47097,559
2020-12-13,Glenn,021,27897,1290,1171,138,1309,9
2020-12-13,Humboldt,023,135768,1395,1238,4,1242,9
2020-12-13,Imperial,025,180216,20546,19472,419,19891,379
2020-12-13,Inyo,027,18085,477,380,6,386,16
2020-12-13,Kern,029,883053,54945,49051,3209,52260,510
2020-12-13,Kings,031,150075,14311,13357,348,13705,97
2020-12-13,Lake,033,64148,1467,1271,0,1271,21
2020-12-13,Lassen,035,31185,3475,2867,25,2892,1
2020-12-13,Los Angeles,037,10098052,573468,517472,12437,529909,8294
2020-12-13,Madera,039,155013,8723,7909,282,8191,60
2020-12-13,Marin,041,260295,8811,8409,55,8464,141
2020-12-13,Mariposa,043,17540,188,167,2,169,3
2020-12-13,Mendocino,045,87422,2047,1793,20,1813,24
2020-12-13,Merced,047,269075,15685,14384,230,14614,189
2020-12-13,Modoc,049,8938,192,179,57,236,0
2020-12-13,Mono,051,14174,741,675,12,687,3
2020-12-13,Monterey,053,433212,22006,18913,460,19373,153
2020-12-13,Napa,055,140530,4726,4194,24,4218,22
2020-12-13,Nevada,057,99092,2277,2030,67,2097,11
2020-12-13,Orange,059,3164182,120202,104768,4187,108955,1688
2020-12-13,Placer,061,380077,11447,9405,342,9747,95
2020-12-13,Plumas,063,18699,382,291,8,299,0
2020-12-13,Riverside,065,2383286,138793,119691,4891,124582,1581
2020-12-13,Sacramento,067,1510023,53842,49480,351,49831,682
2020-12-13,San Benito,069,59416,2742,2408,19,2427,19
2020-12-13,San Bernardino,071,2135413,151410,126718,3721,130439,1333
2020-12-13,San Diego,073,3302833,120006,107372,5109,112481,1162
2020-12-13,San Francisco,075,870044,20022,18686,167,18853,167
2020-12-13,San Joaquin,077,732212,37007,32170,974,33144,534
2020-12-13,San Luis Obispo,079,281455,8752,7625,183,7808,52
2020-12-13,San Mateo,081,765935,20523,18090,48,18138,177
2020-12-13,Santa Barbara,083,443738,14356,13249,331,13580,144
2020-12-13,Santa Clara,085,1922200,54952,47920,203,48123,499
2020-12-13,Santa Cruz,087,273765,7036,5986,153,6139,54
2020-12-13,Shasta,089,179085,7198,6647,459,7106,54
2020-12-13,Sierra,091,2930,23,21,0,21,0
2020-12-13,Siskiyou,093,43540,889,762,72,834,2
2020-12-13,Solano,095,438530,14860,13276,146,13422,93
2020-12-13,Sonoma,097,501317,16151,14495,95,14590,167
2020-12-13,Stanislaus,099,539301,29248,26569,2278,28847,485
2020-12-13,Sutter,101,95872,5382,4798,28,4826,34
2020-12-13,Tehama,103,63373,2506,2325,156,2481,9
2020-12-13,Trinity,105,12862,365,204,49,253,1
2020-12-13,Tulare,107,460477,28584,25496,2614,28110,340
2020-12-13,Tuolumne,109,53932,2024,1611,9,1620,8
2020-12-13,Ventura,111,848112,30493,26588,1064,27652,202
2020-12-13,Yolo,113,214977,7002,6265,35,6300,95
2020-12-13,Yuba,115,75493,3074,2754,27,2781,11
2020-12-12,Alameda,001,1643700,41710,37027,622,37649,486
2020-12-12,Alpine,003,1148,65,63,0,63,0
2020-12-12,Amador,005,37829,1761,1236,8,1244,19
2020-12-12,Butte,007,227075,5894,4972,506,5478,73
2020-12-12,Calaveras,009,45235,809,708,0,708,21
2020-12-12,Colusa,011,21464,1069,945,39,984,7
2020-12-12,Contra Costa,013,1133247,32920,29506,293,29799,281
2020-12-12,Del Norte,015,27424,598,529,0,529,1
2020-12-12,El Dorado,017,186661,4686,3706,129,3835,9
2020-12-12,Fresno,019,978130,56199,43756,2923,46679,559
2020-12-12,Glenn,021,27897,1282,1143,134,1277,8
2020-12-12,Humboldt,023,135768,1376,1208,4,1212,9
2020-12-12,Imperial,025,180216,20460,18947,363,19310,379
2020-12-12,Inyo,027,18085,473,380,6,386,16
2020-12-12,Kern,029,883053,54425,48194,3119,51313,507
2020-12-12,Kings,031,150075,14222,13205,344,13549,96
2020-12-12,Lake,033,64148,1450,1232,0,1232,21
2020-12-12,Lassen,035,31185,3452,2866,22,2888,1
2020-12-12,Los Angeles,037,10098052,566663,504317,11935,516252,8269
2020-12-12,Madera,039,155013,8596,7765,279,8044,59
2020-12-12,Marin,041,260295,8757,8363,54,8417,141
2020-12-12,Mariposa,043,17540,187,164,2,166,3
2020-12-12,Mendocino,045,87422,2011,1771,20,1791,24
2020-12-12,Merced,047,269075,15594,14181,226,14407,188
2020-12-12,Modoc,049,8938,191,169,54,223,0
2020-12-12,Mono,051,14174,734,640,12,652,3
2020-12-12,Monterey,053,433212,21893,18596,431,19027,151
2020-12-12,Napa,055,140530,4681,4113,24,4137,22
2020-12-12,Nevada,057,99092,2259,1981,65,2046,10
2020-12-12,Orange,059,3164182,118316,100468,4039,104507,1674
2020-12-12,Placer,061,380077,11282,9390,337,9727,95
2020-12-12,Plumas,063,18699,376,291,8,299,0
2020-12-12,Riverside,065,2383286,136736,118335,4686,123021,1579
2020-12-12,Sacramento,067,1510023,53258,48319,338,48657,673
2020-12-12,San Benito,069,59416,2686,2355,19,2374,19
2020-12-12,San Bernardino,071,2135413,149777,125741,3618,129359,1321
2020-12-12,San Diego,073,3302833,118385,104958,5012,109970,1151
2020-12-12,San Francisco,075,870044,19832,18413,163,18576,167
2020-12-12,San Joaquin,077,732212,36681,32200,943,33143,534
2020-12-12,San Luis Obispo,079,281455,8653,7462,177,7639,50
2020-12-12,San Mateo,081,765935,20302,17574,47,17621,177
2020-12-12,Santa Barbara,083,443738,14204,13174,323,13497,144
2020-12-12,Santa Clara,085,1922200,54001,45892,200,46092,498
2020-12-12,Santa Cruz,087,273765,6938,5905,144,6049,54
2020-12-12,Shasta,089,179085,7165,6551,441,6992,54
2020-12-12,Sierra,091,2930,23,21,0,21,0
2020-12-12,Siskiyou,093,43540,887,762,69,831,2
2020-12-12,Solano,095,438530,14662,12748,139,12887,93
2020-12-12,Sonoma,097,501317,16030,14466,95,14561,166
2020-12-12,Stanislaus,099,539301,28947,26246,2227,28473,483
2020-12-12,Sutter,101,95872,5320,4717,28,4745,32
2020-12-12,Tehama,103,63373,2488,2252,150,2402,9
2020-12-12,Trinity,105,12862,363,204,47,251,1
2020-12-12,Tulare,107,460477,28325,25333,2556,27889,341
2020-12-12,Tuolumne,109,53932,1981,1536,9,1545,8
2020-12-12,Ventura,111,848112,30049,25955,1031,26986,202
2020-12-12,Yolo,113,214977,6920,6116,33,6149,95
2020-12-12,Yuba,115,75493,3047,2692,26,2718,10
2020-12-11,Alameda,001,1643700,41142,36281,610,36891,482
2020-12-11,Alpine,003,1148,65,63,0,63,0
2020-12-11,Amador,005,37829,1745,1213,8,1221,19
2020-12-11,Butte,007,227075,5821,4941,488,5429,73
2020-12-11,Calaveras,009,45235,793,697,0,697,21
2020-12-11,Colusa,011,21464,1059,923,37,960,7
2020-12-11,Contra Costa,013,1133247,32496,29036,289,29325,282
2020-12-11,Del Norte,015,27424,592,505,0,505,1
2020-12-11,El Dorado,017,186661,4605,3669,114,3783,9
2020-12-11,Fresno,019,978130,55187,43071,2857,45928,550
2020-12-11,Glenn,021,27897,1266,1135,129,1264,8
2020-12-11,Humboldt,023,135768,1358,1190,4,1194,9
2020-12-11,Imperial,025,180216,20371,18599,319,18918,377
2020-12-11,Inyo,027,18085,462,372,6,378,16
2020-12-11,Kern,029,883053,53747,47664,3055,50719,502
2020-12-11,Kings,031,150075,14078,13118,340,13458,94
2020-12-11,Lake,033,64148,1436,1205,0,1205,21
2020-12-11,Lassen,035,31185,3440,2790,21,2811,1
2020-12-11,Los Angeles,037,10098052,554856,493592,11525,505117,8198
2020-12-11,Madera,039,155013,8505,7648,269,7917,59
2020-12-11,Marin,041,260295,8663,8317,53,8370,141
2020-12-11,Mariposa,043,17540,186,164,2,166,3
2020-12-11,Mendocino,045,87422,1987,1769,20,1789,24
2020-12-11,Merced,047,269075,15474,14038,218,14256,186
2020-12-11,Modoc,049,8938,191,168,53,221,0
2020-12-11,Mono,051,14174,724,631,12,643,3
2020-12-11,Monterey,053,433212,21592,18421,426,18847,150
2020-12-11,Napa,055,140530,4626,4054,24,4078,22
2020-12-11,Nevada,057,99092,2242,1959,62,2021,10
2020-12-11,Orange,059,3164182,116003,98357,3937,102294,1656
2020-12-11,Placer,061,380077,11120,8904,321,9225,93
2020-12-11,Plumas,063,18699,368,286,8,294,0
2020-12-11,Riverside,065,2383286,133668,115329,4466,119795,1573
2020-12-11,Sacramento,067,1510023,52596,47468,330,47798,669
2020-12-11,San Benito,069,59416,2635,2319,19,2338,19
2020-12-11,San Bernardino,071,2135413,147088,123092,3501,126593,1313
2020-12-11,San Diego,073,3302833,116425,102468,4929,107397,1137
2020-12-11,San Francisco,075,870044,19602,18246,162,18408,165
2020-12-11,San Joaquin,077,732212,36335,32044,915,32959,534
2020-12-11,San Luis Obispo,079,281455,8492,7415,175,7590,49
2020-12-11,San Mateo,081,765935,20031,17240,36,17276,177
2020-12-11,Santa Barbara,083,443738,14061,12997,315,13312,144
2020-12-11,Santa Clara,085,1922200,52997,45101,191,45292,494
2020-12-11,Santa Cruz,087,273765,6825,5764,135,5899,50
2020-12-11,Shasta,089,179085,7120,6459,434,6893,54
2020-12-11,Sierra,091,2930,23,19,0,19,0
2020-12-11,Siskiyou,093,43540,880,753,66,819,2
2020-12-11,Solano,095,438530,14476,12554,135,12689,92
2020-12-11,Sonoma,097,501317,15863,14298,93,14391,166
2020-12-11,Stanislaus,099,539301,28678,25928,2183,28111,464
2020-12-11,Sutter,101,95872,5257,4600,27,4627,30
2020-12-11,Tehama,103,63373,2458,2232,146,2378,9
2020-12-11,Trinity,105,12862,360,204,47,251,1
2020-12-11,Tulare,107,460477,27966,24953,2508,27461,338
2020-12-11,Tuolumne,109,53932,1966,1510,9,1519,8
2020-12-11,Ventura,111,848112,29443,24999,1009,26008,202
2020-12-11,Yolo,113,214977,6814,6006,32,6038,95
2020-12-11,Yuba,115,75493,2987,2649,25,2674,10
2020-12-10,Alameda,001,1643700,40373,35686,588,36274,477
2020-12-10,Alpine,003,1148,65,63,0,63,0
2020-12-10,Amador,005,37829,1688,1191,8,1199,18
2020-12-10,Butte,007,227075,5705,4863,461,5324,72
2020-12-10,Calaveras,009,45235,775,684,0,684,21
2020-12-10,Colusa,011,21464,1036,909,34,943,7
2020-12-10,Contra Costa,013,1133247,31814,28413,283,28696,276
2020-12-10,Del Norte,015,27424,582,501,0,501,1
2020-12-10,El Dorado,017,186661,4487,3557,109,3666,9
2020-12-10,Fresno,019,978130,54209,42461,2715,45176,540
2020-12-10,Glenn,021,27897,1246,1126,120,1246,8
2020-12-10,Humboldt,023,135768,1338,1140,4,1144,9
2020-12-10,Imperial,025,180216,20157,18333,242,18575,370
2020-12-10,Inyo,027,18085,441,365,6,371,15
2020-12-10,Kern,029,883053,52764,47176,2888,50064,499
2020-12-10,Kings,031,150075,13920,12993,334,13327,92
2020-12-10,Lake,033,64148,1395,1167,0,1167,21
2020-12-10,Lassen,035,31185,3418,2764,17,2781,0
2020-12-10,Los Angeles,037,10098052,540886,480354,10990,491344,8149
2020-12-10,Madera,039,155013,8398,7445,254,7699,59
2020-12-10,Marin,041,260295,8610,8245,52,8297,140
2020-12-10,Mariposa,043,17540,185,160,2,162,3
2020-12-10,Mendocino,045,87422,1961,1748,17,1765,24
2020-12-10,Merced,047,269075,15228,13756,215,13971,186
2020-12-10,Modoc,049,8938,186,165,51,216,0
2020-12-10,Mono,051,14174,719,601,12,613,3
2020-12-10,Monterey,053,433212,21111,18266,416,18682,145
2020-12-10,Napa,055,140530,4540,3974,23,3997,22
2020-12-10,Nevada,057,99092,2206,1919,62,1981,10
2020-12-10,Orange,059,3164182,112907,95297,3775,99072,1651
2020-12-10,Placer,061,380077,10867,8906,303,9209,90
2020-12-10,Plumas,063,18699,357,281,8,289,0
2020-12-10,Riverside,065,2383286,129981,112794,4197,116991,1552
2020-12-10,Sacramento,067,1510023,51696,46471,308,46779,664
2020-12-10,San Benito,069,59416,2575,2268,18,2286,19
2020-12-10,San Bernardino,071,2135413,142852,120186,3327,123513,1306
2020-12-10,San Diego,073,3302833,113900,99601,4780,104381,1114
2020-12-10,San Francisco,075,870044,19290,17945,154,18099,164
2020-12-10,San Joaquin,077,732212,35699,31228,885,32113,534
2020-12-10,San Luis Obispo,079,281455,8329,7245,164,7409,49
2020-12-10,San Mateo,081,765935,19587,16701,26,16727,177
2020-12-10,Santa Barbara,083,443738,13882,12788,306,13094,143
2020-12-10,Santa Clara,085,1922200,51862,43939,176,44115,491
2020-12-10,Santa Cruz,087,273765,6658,5645,122,5767,48
2020-12-10,Shasta,089,179085,7053,6312,409,6721,53
2020-12-10,Sierra,091,2930,23,18,0,18,0
2020-12-10,Siskiyou,093,43540,870,712,65,777,2
2020-12-10,Solano,095,438530,14110,12017,129,12146,90
2020-12-10,Sonoma,097,501317,15608,14282,91,14373,167
2020-12-10,Stanislaus,099,539301,28215,25582,2114,27696,464
2020-12-10,Sutter,101,95872,5127,4528,25,4553,27
2020-12-10,Tehama,103,63373,2414,2190,138,2328,9
2020-12-10,Trinity,105,12862,356,202,45,247,1
2020-12-10,Tulare,107,460477,27509,24506,2442,26948,337
2020-12-10,Tuolumne,109,53932,1724,1451,9,1460,8
2020-12-10,Ventura,111,848112,28592,24075,965,25040,202
2020-12-10,Yolo,113,214977,6693,5896,31,5927,95
2020-12-10,Yuba,115,75493,2923,2604,24,2628,10
2020-12-09,Alameda,001,1643700,39535,35047,565,35612,470
2020-12-09,Alpine,003,1148,65,58,0,58,0
2020-12-09,Amador,005,37829,1645,1121,8,1129,19
2020-12-09,Butte,007,227075,5562,4733,441,5174,70
2020-12-09,Calaveras,009,45235,748,670,0,670,21
2020-12-09,Colusa,011,21464,1021,896,33,929,7
2020-12-09,Contra Costa,013,1133247,31110,28308,272,28580,273
2020-12-09,Del Norte,015,27424,569,481,0,481,2
2020-12-09,El Dorado,017,186661,4352,3449,101,3550,8
2020-12-09,Fresno,019,978130,53207,41954,2562,44516,533
2020-12-09,Glenn,021,27897,1232,1107,114,1221,8
2020-12-09,Humboldt,023,135768,1306,1086,4,1090,10
2020-12-09,Imperial,025,180216,19902,17757,206,17963,368
2020-12-09,Inyo,027,18085,428,356,6,362,15
2020-12-09,Kern,029,883053,51606,46379,2742,49121,494
2020-12-09,Kings,031,150075,13775,12716,326,13042,92
2020-12-09,Lake,033,64148,1367,1158,0,1158,20
2020-12-09,Lassen,035,31185,3349,2331,15,2346,0
2020-12-09,Los Angeles,037,10098052,527397,467971,10444,478415,8075
2020-12-09,Madera,039,155013,8285,7216,251,7467,59
2020-12-09,Marin,041,260295,8548,8182,51,8233,138
2020-12-09,Mariposa,043,17540,183,154,2,156,3
2020-12-09,Mendocino,045,87422,1935,1703,16,1719,24
2020-12-09,Merced,047,269075,14987,13588,208,13796,183
2020-12-09,Modoc,049,8938,181,146,42,188,0
2020-12-09,Mono,051,14174,707,601,12,613,3
2020-12-09,Monterey,053,433212,20710,17891,408,18299,143
2020-12-09,Napa,055,140530,4454,3858,22,3880,21
2020-12-09,Nevada,057,99092,2153,1864,62,1926,10
2020-12-09,Orange,059,3164182,109820,93763,3601,97364,1629
2020-12-09,Placer,061,380077,10606,8588,289,8877,85
2020-12-09,Plumas,063,18699,349,271,8,279,0
2020-12-09,Riverside,065,2383286,126284,110376,3990,114366,1543
2020-12-09,Sacramento,067,1510023,50633,45284,281,45565,659
2020-12-09,San Benito,069,59416,2502,2217,16,2233,19
2020-12-09,San Bernardino,071,2135413,138574,114516,3130,117646,1305
2020-12-09,San Diego,073,3302833,110920,97551,4641,102192,1103
2020-12-09,San Francisco,075,870044,18989,17628,153,17781,163
2020-12-09,San Joaquin,077,732212,34883,30539,860,31399,531
2020-12-09,San Luis Obispo,079,281455,8111,7105,156,7261,47
2020-12-09,San Mateo,081,765935,19137,16422,25,16447,175
2020-12-09,Santa Barbara,083,443738,13682,12630,296,12926,142
2020-12-09,Santa Clara,085,1922200,50705,42912,160,43072,489
2020-12-09,Santa Cruz,087,273765,6500,5527,107,5634,47
2020-12-09,Shasta,089,179085,6988,6105,395,6500,52
2020-12-09,Sierra,091,2930,23,18,0,18,0
2020-12-09,Siskiyou,093,43540,859,713,64,777,2
2020-12-09,Solano,095,438530,13762,11862,121,11983,90
2020-12-09,Sonoma,097,501317,15352,13994,88,14082,164
2020-12-09,Stanislaus,099,539301,27718,25157,2053,27210,463
2020-12-09,Sutter,101,95872,5009,4418,21,4439,24
2020-12-09,Tehama,103,63373,2378,2102,134,2236,9
2020-12-09,Trinity,105,12862,348,199,42,241,0
2020-12-09,Tulare,107,460477,26913,24124,2363,26487,334
2020-12-09,Tuolumne,109,53932,1691,1319,9,1328,8
2020-12-09,Ventura,111,848112,27729,23830,923,24753,201
2020-12-09,Yolo,113,214977,6568,5760,29,5789,95
2020-12-09,Yuba,115,75493,2855,2513,23,2536,10
2020-12-08,Alameda,001,1643700,38633,34373,549,34922,469
2020-12-08,Alpine,003,1148,64,53,0,53,0
2020-12-08,Amador,005,37829,1359,1043,8,1051,17
2020-12-08,Butte,007,227075,5404,4651,400,5051,70
2020-12-08,Calaveras,009,45235,724,657,0,657,21
2020-12-08,Colusa,011,21464,1005,875,32,907,6
2020-12-08,Contra Costa,013,1133247,30408,27926,255,28181,270
2020-12-08,Del Norte,015,27424,553,465,0,465,2
2020-12-08,El Dorado,017,186661,4228,3296,88,3384,8
2020-12-08,Fresno,019,978130,51943,41574,2407,43981,529
2020-12-08,Glenn,021,27897,1212,1094,106,1200,8
2020-12-08,Humboldt,023,135768,1280,1059,4,1063,10
2020-12-08,Imperial,025,180216,19387,17568,198,17766,363
2020-12-08,Inyo,027,18085,405,333,6,339,15
2020-12-08,Kern,029,883053,50312,45116,2586,47702,487
2020-12-08,Kings,031,150075,13621,12623,317,12940,90
2020-12-08,Lake,033,64148,1325,1127,0,1127,20
2020-12-08,Lassen,035,31185,3193,2165,15,2180,0
2020-12-08,Los Angeles,037,10098052,514700,459738,9967,469705,8004
2020-12-08,Madera,039,155013,8154,7082,238,7320,59
2020-12-08,Marin,041,260295,8468,8099,50,8149,137
2020-12-08,Mariposa,043,17540,179,150,2,152,2
2020-12-08,Mendocino,045,87422,1893,1666,16,1682,23
2020-12-08,Merced,047,269075,14675,13380,207,13587,181
2020-12-08,Modoc,049,8938,173,138,39,177,0
2020-12-08,Mono,051,14174,693,597,12,609,3
2020-12-08,Monterey,053,433212,20139,17752,401,18153,134
2020-12-08,Napa,055,140530,4367,3778,21,3799,22
2020-12-08,Nevada,057,99092,2099,1809,59,1868,11
2020-12-08,Orange,059,3164182,106600,91406,3435,94841,1629
2020-12-08,Placer,061,380077,10338,8224,284,8508,82
2020-12-08,Plumas,063,18699,339,258,8,266,0
2020-12-08,Riverside,065,2383286,122921,107620,3810,111430,1514
2020-12-08,Sacramento,067,1510023,49569,44635,266,44901,649
2020-12-08,San Benito,069,59416,2449,2180,16,2196,18
2020-12-08,San Bernardino,071,2135413,134227,110676,3004,113680,1301
2020-12-08,San Diego,073,3302833,107549,95447,4484,99931,1088
2020-12-08,San Francisco,075,870044,18679,17384,151,17535,162
2020-12-08,San Joaquin,077,732212,33988,30225,827,31052,530
2020-12-08,San Luis Obispo,079,281455,7982,6903,145,7048,45
2020-12-08,San Mateo,081,765935,18737,16305,25,16330,175
2020-12-08,Santa Barbara,083,443738,13498,12516,287,12803,141
2020-12-08,Santa Clara,085,1922200,49399,41309,151,41460,484
2020-12-08,Santa Cruz,087,273765,6321,5374,105,5479,45
2020-12-08,Shasta,089,179085,6878,5946,387,6333,50
2020-12-08,Sierra,091,2930,22,18,0,18,0
2020-12-08,Siskiyou,093,43540,845,704,62,766,2
2020-12-08,Solano,095,438530,13360,11669,119,11788,89
2020-12-08,Sonoma,097,501317,15093,13601,87,13688,164
2020-12-08,Stanislaus,099,539301,27230,24793,1988,26781,461
2020-12-08,Sutter,101,95872,4914,4342,20,4362,24
2020-12-08,Tehama,103,63373,2304,2057,126,2183,9
2020-12-08,Trinity,105,12862,339,198,41,239,0
2020-12-08,Tulare,107,460477,26310,23607,2302,25909,330
2020-12-08,Tuolumne,109,53932,1667,1264,9,1273,7
2020-12-08,Ventura,111,848112,27066,23665,880,24545,195
2020-12-08,Yolo,113,214977,6436,5560,29,5589,90
2020-12-08,Yuba,115,75493,2778,2477,23,2500,10
2020-12-07,Alameda,001,1643700,37767,33887,513,34400,466
2020-12-07,Alpine,003,1148,63,53,0,53,0
2020-12-07,Amador,005,37829,1284,993,7,1000,17
2020-12-07,Butte,007,227075,5269,4604,378,4982,67
2020-12-07,Calaveras,009,45235,693,606,0,606,21
2020-12-07,Colusa,011,21464,980,825,27,852,6
2020-12-07,Contra Costa,013,1133247,29792,27307,242,27549,270
2020-12-07,Del Norte,015,27424,541,424,0,424,2
2020-12-07,El Dorado,017,186661,4049,3275,81,3356,8
2020-12-07,Fresno,019,978130,50468,41098,2284,43382,526
2020-12-07,Glenn,021,27897,1193,1085,100,1185,8
2020-12-07,Humboldt,023,135768,1245,1023,4,1027,9
2020-12-07,Imperial,025,180216,18965,17234,188,17422,364
2020-12-07,Inyo,027,18085,390,333,6,339,15
2020-12-07,Kern,029,883053,49287,44409,2450,46859,486
2020-12-07,Kings,031,150075,13478,12412,307,12719,90
2020-12-07,Lake,033,64148,1298,1090,0,1090,20
2020-12-07,Lassen,035,31185,3096,2167,15,2182,0
2020-12-07,Los Angeles,037,10098052,501030,451052,9532,460584,7937
2020-12-07,Madera,039,155013,7889,6935,233,7168,59
2020-12-07,Marin,041,260295,8410,8049,49,8098,136
2020-12-07,Mariposa,043,17540,176,146,2,148,2
2020-12-07,Mendocino,045,87422,1857,1638,14,1652,23
2020-12-07,Merced,047,269075,14316,13250,197,13447,179
2020-12-07,Modoc,049,8938,166,128,36,164,0
2020-12-07,Mono,051,14174,680,590,12,602,3
2020-12-07,Monterey,053,433212,19658,17746,389,18135,132
2020-12-07,Napa,055,140530,4276,3684,21,3705,21
2020-12-07,Nevada,057,99092,2050,1777,58,1835,11
2020-12-07,Orange,059,3164182,103335,89793,3315,93108,1628
2020-12-07,Placer,061,380077,10012,7911,270,8181,82
2020-12-07,Plumas,063,18699,327,256,5,261,0
2020-12-07,Riverside,065,2383286,119722,102363,3627,105990,1491
2020-12-07,Sacramento,067,1510023,48474,43419,249,43668,638
2020-12-07,San Benito,069,59416,2398,2165,15,2180,18
2020-12-07,San Bernardino,071,2135413,130274,108161,2885,111046,1295
2020-12-07,San Diego,073,3302833,104760,94171,4303,98474,1062
2020-12-07,San Francisco,075,870044,18388,17220,144,17364,161
2020-12-07,San Joaquin,077,732212,33112,28188,800,28988,530
2020-12-07,San Luis Obispo,079,281455,7800,6782,138,6920,45
2020-12-07,San Mateo,081,765935,18297,16029,24,16053,175
2020-12-07,Santa Barbara,083,443738,13256,12362,277,12639,141
2020-12-07,Santa Clara,085,1922200,48015,40621,142,40763,484
2020-12-07,Santa Cruz,087,273765,6156,5152,99,5251,41
2020-12-07,Shasta,089,179085,6755,5742,372,6114,50
2020-12-07,Sierra,091,2930,20,18,0,18,0
2020-12-07,Siskiyou,093,43540,818,652,62,714,2
2020-12-07,Solano,095,438530,13021,11354,115,11469,89
2020-12-07,Sonoma,097,501317,14809,13376,87,13463,164
2020-12-07,Stanislaus,099,539301,26672,24479,1935,26414,454
2020-12-07,Sutter,101,95872,4773,4106,20,4126,24
2020-12-07,Tehama,103,63373,2253,2030,121,2151,9
2020-12-07,Trinity,105,12862,335,194,41,235,0
2020-12-07,Tulare,107,460477,25774,22760,2245,25005,328
2020-12-07,Tuolumne,109,53932,1582,1256,8,1264,7
2020-12-07,Ventura,111,848112,26479,23354,844,24198,191
2020-12-07,Yolo,113,214977,6274,5537,28,5565,90
2020-12-07,Yuba,115,75493,2710,2428,21,2449,10
2020-12-06,Alameda,001,1643700,36777,33477,493,33970,465
2020-12-06,Alpine,003,1148,59,53,0,53,0
2020-12-06,Amador,005,37829,1221,952,6,958,17
2020-12-06,Butte,007,227075,5116,4527,345,4872,67
2020-12-06,Calaveras,009,45235,673,606,0,606,21
2020-12-06,Colusa,011,21464,963,824,23,847,6
2020-12-06,Contra Costa,013,1133247,29184,26566,235,26801,270
2020-12-06,Del Norte,015,27424,486,414,0,414,2
2020-12-06,El Dorado,017,186661,3912,3086,76,3162,8
2020-12-06,Fresno,019,978130,49512,40869,2168,43037,526
2020-12-06,Glenn,021,27897,1183,1067,96,1163,8
2020-12-06,Humboldt,023,135768,1220,1004,4,1008,9
2020-12-06,Imperial,025,180216,18650,16922,179,17101,364
2020-12-06,Inyo,027,18085,377,333,6,339,15
2020-12-06,Kern,029,883053,48298,43899,2280,46179,486
2020-12-06,Kings,031,150075,13206,12056,290,12346,90
2020-12-06,Lake,033,64148,1261,1075,0,1075,20
2020-12-06,Lassen,035,31185,2991,2168,13,2181,0
2020-12-06,Los Angeles,037,10098052,487439,443230,9092,452322,7910
2020-12-06,Madera,039,155013,7718,6826,224,7050,59
2020-12-06,Marin,041,260295,8329,8013,47,8060,136
2020-12-06,Mariposa,043,17540,175,144,2,146,2
2020-12-06,Mendocino,045,87422,1817,1614,14,1628,23
2020-12-06,Merced,047,269075,13981,12928,188,13116,179
2020-12-06,Modoc,049,8938,153,125,29,154,0
2020-12-06,Mono,051,14174,658,586,10,596,3
2020-12-06,Monterey,053,433212,19039,17426,379,17805,130
2020-12-06,Napa,055,140530,4164,3644,21,3665,21
2020-12-06,Nevada,057,99092,1991,1710,55,1765,10
2020-12-06,Orange,059,3164182,100268,87737,3185,90922,1627
2020-12-06,Placer,061,380077,9730,7837,250,8087,82
2020-12-06,Plumas,063,18699,314,254,4,258,0
2020-12-06,Riverside,065,2383286,116628,100088,3403,103491,1482
2020-12-06,Sacramento,067,1510023,47235,42808,233,43041,638
2020-12-06,San Benito,069,59416,2361,2135,15,2150,18
2020-12-06,San Bernardino,071,2135413,126120,106927,2728,109655,1286
2020-12-06,San Diego,073,3302833,101727,92173,4149,96322,1062
2020-12-06,San Francisco,075,870044,18066,17107,137,17244,161
2020-12-06,San Joaquin,077,732212,32277,28188,771,28959,530
2020-12-06,San Luis Obispo,079,281455,7634,6723,133,6856,45
2020-12-06,San Mateo,081,765935,17793,15855,21,15876,175
2020-12-06,Santa Barbara,083,443738,13024,12252,268,12520,141
2020-12-06,Santa Clara,085,1922200,46639,39112,136,39248,482
2020-12-06,Santa Cruz,087,273765,5982,5069,93,5162,40
2020-12-06,Shasta,089,179085,6614,5743,351,6094,49
2020-12-06,Sierra,091,2930,20,17,0,17,0
2020-12-06,Siskiyou,093,43540,800,652,60,712,2
2020-12-06,Solano,095,438530,12734,11354,105,11459,88
2020-12-06,Sonoma,097,501317,14520,13238,86,13324,164
2020-12-06,Stanislaus,099,539301,26121,24036,1871,25907,454
2020-12-06,Sutter,101,95872,4657,4009,19,4028,21
2020-12-06,Tehama,103,63373,2194,1982,111,2093,9
2020-12-06,Trinity,105,12862,328,181,39,220,0
2020-12-06,Tulare,107,460477,25249,22756,2177,24933,327
2020-12-06,Tuolumne,109,53932,1486,1210,8,1218,7
2020-12-06,Ventura,111,848112,25938,23035,817,23852,191
2020-12-06,Yolo,113,214977,6113,5465,23,5488,90
2020-12-06,Yuba,115,75493,2666,2340,20,2360,10
2020-12-05,Alameda,001,1643700,36419,32781,482,33263,465
2020-12-05,Alpine,003,1148,58,53,0,53,0
2020-12-05,Amador,005,37829,1197,847,6,853,17
2020-12-05,Butte,007,227075,5048,4455,326,4781,66
2020-12-05,Calaveras,009,45235,661,606,0,606,21
2020-12-05,Colusa,011,21464,945,825,20,845,6
2020-12-05,Contra Costa,013,1133247,28892,26217,228,26445,270
2020-12-05,Del Norte,015,27424,480,408,0,408,2
2020-12-05,El Dorado,017,186661,3847,3061,71,3132,8
2020-12-05,Fresno,019,978130,49193,40568,2113,42681,525
2020-12-05,Glenn,021,27897,1170,1056,90,1146,8
2020-12-05,Humboldt,023,135768,1187,979,4,983,9
2020-12-05,Imperial,025,180216,18482,16544,178,16722,362
2020-12-05,Inyo,027,18085,372,332,6,338,15
2020-12-05,Kern,029,883053,47834,43332,2195,45527,484
2020-12-05,Kings,031,150075,13125,11898,287,12185,90
2020-12-05,Lake,033,64148,1234,1069,0,1069,20
2020-12-05,Lassen,035,31185,2800,2168,11,2179,0
2020-12-05,Los Angeles,037,10098052,481638,433120,8776,441896,7888
2020-12-05,Madera,039,155013,7625,6619,217,6836,59
2020-12-05,Marin,041,260295,8302,7961,47,8008,136
2020-12-05,Mariposa,043,17540,170,143,2,145,2
2020-12-05,Mendocino,045,87422,1778,1585,14,1599,23
2020-12-05,Merced,047,269075,13874,12747,177,12924,180
2020-12-05,Modoc,049,8938,153,118,28,146,0
2020-12-05,Mono,051,14174,653,554,10,564,3
2020-12-05,Monterey,053,433212,18893,17077,375,17452,127
2020-12-05,Napa,055,140530,4093,3565,21,3586,21
2020-12-05,Nevada,057,99092,1976,1642,53,1695,10
2020-12-05,Orange,059,3164182,98802,85735,3089,88824,1612
2020-12-05,Placer,061,380077,9610,7811,241,8052,78
2020-12-05,Plumas,063,18699,307,246,1,247,0
2020-12-05,Riverside,065,2383286,115016,98612,3226,101838,1477
2020-12-05,Sacramento,067,1510023,46570,41878,218,42096,625
2020-12-05,San Benito,069,59416,2317,2073,15,2088,18
2020-12-05,San Bernardino,071,2135413,124594,105382,2599,107981,1283
2020-12-05,San Diego,073,3302833,100375,90470,4068,94538,1055
2020-12-05,San Francisco,075,870044,17882,16786,133,16919,161
2020-12-05,San Joaquin,077,732212,32010,28105,738,28843,523
2020-12-05,San Luis Obispo,079,281455,7567,6623,130,6753,44
2020-12-05,San Mateo,081,765935,17536,15512,21,15533,175
2020-12-05,Santa Barbara,083,443738,12924,12107,262,12369,141
2020-12-05,Santa Clara,085,1922200,45897,38339,131,38470,474
2020-12-05,Santa Cruz,087,273765,5909,4997,91,5088,40
2020-12-05,Shasta,089,179085,6553,5653,340,5993,49
2020-12-05,Sierra,091,2930,20,17,0,17,0
2020-12-05,Siskiyou,093,43540,792,649,59,708,2
2020-12-05,Solano,095,438530,12565,11351,103,11454,87
2020-12-05,Sonoma,097,501317,14424,13137,86,13223,164
2020-12-05,Stanislaus,099,539301,25807,23662,1836,25498,454
2020-12-05,Sutter,101,95872,4592,3937,19,3956,20
2020-12-05,Tehama,103,63373,2178,1926,109,2035,9
2020-12-05,Trinity,105,12862,327,177,39,216,0
2020-12-05,Tulare,107,460477,25034,22660,2119,24779,324
2020-12-05,Tuolumne,109,53932,1429,1180,8,1188,7
2020-12-05,Ventura,111,848112,25567,22710,803,23513,191
2020-12-05,Yolo,113,214977,6036,5351,22,5373,90
2020-12-05,Yuba,115,75493,2629,2275,20,2295,10
2020-12-04,Alameda,001,1643700,35871,31871,469,32340,465
2020-12-04,Alpine,003,1148,58,53,0,53,0
2020-12-04,Amador,005,37829,1183,766,3,769,16
2020-12-04,Butte,007,227075,4976,4336,305,4641,65
2020-12-04,Calaveras,009,45235,656,585,0,585,21
2020-12-04,Colusa,011,21464,931,790,18,808,6
2020-12-04,Contra Costa,013,1133247,28547,25705,216,25921,264
2020-12-04,Del Norte,015,27424,469,401,0,401,2
2020-12-04,El Dorado,017,186661,3759,2933,68,3001,7
2020-12-04,Fresno,019,978130,48484,40108,2045,42153,522
2020-12-04,Glenn,021,27897,1164,1017,82,1099,8
2020-12-04,Humboldt,023,135768,1169,960,4,964,9
2020-12-04,Imperial,025,180216,18240,16484,178,16662,362
2020-12-04,Inyo,027,18085,364,324,6,330,15
2020-12-04,Kern,029,883053,47283,42497,2092,44589,485
2020-12-04,Kings,031,150075,13032,11767,281,12048,88
2020-12-04,Lake,033,64148,1206,1018,0,1018,20
2020-12-04,Lassen,035,31185,2793,2167,10,2177,0
2020-12-04,Los Angeles,037,10098052,473016,424164,8483,432647,7845
2020-12-04,Madera,039,155013,7534,6479,214,6693,58
2020-12-04,Marin,041,260295,8251,7896,44,7940,136
2020-12-04,Mariposa,043,17540,170,136,2,138,2
2020-12-04,Mendocino,045,87422,1759,1563,13,1576,23
2020-12-04,Merced,047,269075,13759,12474,169,12643,177
2020-12-04,Modoc,049,8938,153,115,28,143,0
2020-12-04,Mono,051,14174,648,549,10,559,3
2020-12-04,Monterey,053,433212,18681,16737,366,17103,127
2020-12-04,Napa,055,140530,4039,3432,21,3453,19
2020-12-04,Nevada,057,99092,1951,1560,50,1610,10
2020-12-04,Orange,059,3164182,96882,83738,3024,86762,1597
2020-12-04,Placer,061,380077,9486,7461,228,7689,76
2020-12-04,Plumas,063,18699,300,232,0,232,0
2020-12-04,Riverside,065,2383286,112817,95255,3069,98324,1475
2020-12-04,Sacramento,067,1510023,45806,41061,201,41262,618
2020-12-04,San Benito,069,59416,2284,2006,15,2021,17
2020-12-04,San Bernardino,071,2135413,122319,102418,2491,104909,1290
2020-12-04,San Diego,073,3302833,98891,88183,3981,92164,1047
2020-12-04,San Francisco,075,870044,17691,16499,133,16632,161
2020-12-04,San Joaquin,077,732212,31573,27806,701,28507,522
2020-12-04,San Luis Obispo,079,281455,7482,6473,127,6600,42
2020-12-04,San Mateo,081,765935,17248,15112,20,15132,173
2020-12-04,Santa Barbara,083,443738,12818,11947,255,12202,141
2020-12-04,Santa Clara,085,1922200,44975,37465,125,37590,468
2020-12-04,Santa Cruz,087,273765,5822,4985,89,5074,32
2020-12-04,Shasta,089,179085,6465,5439,330,5769,49
2020-12-04,Sierra,091,2930,19,17,0,17,0
2020-12-04,Siskiyou,093,43540,785,639,56,695,2
2020-12-04,Solano,095,438530,12419,11037,100,11137,87
2020-12-04,Sonoma,097,501317,14276,12962,85,13047,164
2020-12-04,Stanislaus,099,539301,25537,23206,1792,24998,448
2020-12-04,Sutter,101,95872,4520,3791,14,3805,20
2020-12-04,Tehama,103,63373,2138,1876,104,1980,9
2020-12-04,Trinity,105,12862,325,172,39,211,0
2020-12-04,Tulare,107,460477,24750,22273,2047,24320,322
2020-12-04,Tuolumne,109,53932,1398,1134,8,1142,7
2020-12-04,Ventura,111,848112,25190,22024,786,22810,189
2020-12-04,Yolo,113,214977,5962,5294,21,5315,87
2020-12-04,Yuba,115,75493,2586,2225,19,2244,10
2020-12-03,Alameda,001,1643700,35106,31184,450,31634,465
2020-12-03,Alpine,003,1148,57,53,0,53,0
2020-12-03,Amador,005,37829,1132,653,3,656,16
2020-12-03,Butte,007,227075,4880,4305,286,4591,65
2020-12-03,Calaveras,009,45235,636,572,0,572,21
2020-12-03,Colusa,011,21464,918,774,17,791,6
2020-12-03,Contra Costa,013,1133247,28046,25464,209,25673,265
2020-12-03,Del Norte,015,27424,465,388,0,388,2
2020-12-03,El Dorado,017,186661,3633,2740,66,2806,6
2020-12-03,Fresno,019,978130,47731,39680,1973,41653,516
2020-12-03,Glenn,021,27897,1146,997,74,1071,8
2020-12-03,Humboldt,023,135768,1139,923,4,927,9
2020-12-03,Imperial,025,180216,18035,16436,166,16602,359
2020-12-03,Inyo,027,18085,361,321,6,327,15
2020-12-03,Kern,029,883053,46437,42062,1991,44053,483
2020-12-03,Kings,031,150075,12933,11658,269,11927,87
2020-12-03,Lake,033,64148,1191,991,0,991,20
2020-12-03,Lassen,035,31185,2753,2128,9,2137,0
2020-12-03,Los Angeles,037,10098052,462921,415805,8120,423925,7787
2020-12-03,Madera,039,155013,7411,6398,209,6607,58
2020-12-03,Marin,041,260295,8191,7861,40,7901,136
2020-12-03,Mariposa,043,17540,166,132,2,134,2
2020-12-03,Mendocino,045,87422,1742,1547,10,1557,23
2020-12-03,Merced,047,269075,13514,12310,161,12471,177
2020-12-03,Modoc,049,8938,151,114,28,142,0
2020-12-03,Mono,051,14174,626,527,10,537,3
2020-12-03,Monterey,053,433212,18220,16218,356,16574,125
2020-12-03,Napa,055,140530,3925,3360,21,3381,19
2020-12-03,Nevada,057,99092,1873,1472,49,1521,10
2020-12-03,Orange,059,3164182,94348,82187,2955,85142,1591
2020-12-03,Placer,061,380077,9284,7270,212,7482,73
2020-12-03,Plumas,063,18699,285,223,0,223,0
2020-12-03,Riverside,065,2383286,110054,92489,2907,95396,1461
2020-12-03,Sacramento,067,1510023,44747,40280,188,40468,614
2020-12-03,San Benito,069,59416,2238,1967,15,1982,16
2020-12-03,San Bernardino,071,2135413,118991,100787,2407,103194,1283
2020-12-03,San Diego,073,3302833,97076,86144,3863,90007,1040
2020-12-03,San Francisco,075,870044,17469,16236,132,16368,161
2020-12-03,San Joaquin,077,732212,30850,27239,656,27895,522
2020-12-03,San Luis Obispo,079,281455,7314,6388,126,6514,42
2020-12-03,San Mateo,081,765935,16895,14909,20,14929,173
2020-12-03,Santa Barbara,083,443738,12689,11829,249,12078,141
2020-12-03,Santa Clara,085,1922200,43780,36621,119,36740,465
2020-12-03,Santa Cruz,087,273765,5678,4850,85,4935,28
2020-12-03,Shasta,089,179085,6356,5330,323,5653,48
2020-12-03,Sierra,091,2930,19,17,0,17,0
2020-12-03,Siskiyou,093,43540,770,629,53,682,2
2020-12-03,Solano,095,438530,12205,10857,97,10954,87
2020-12-03,Sonoma,097,501317,14033,12772,84,12856,164
2020-12-03,Stanislaus,099,539301,25126,22821,1744,24565,447
2020-12-03,Sutter,101,95872,4436,3727,14,3741,20
2020-12-03,Tehama,103,63373,2086,1832,97,1929,9
2020-12-03,Trinity,105,12862,322,166,39,205,0
2020-12-03,Tulare,107,460477,24351,21993,1954,23947,321
2020-12-03,Tuolumne,109,53932,1356,1105,8,1113,7
2020-12-03,Ventura,111,848112,24487,21555,773,22328,187
2020-12-03,Yolo,113,214977,5824,5069,21,5090,87
2020-12-03,Yuba,115,75493,2516,2182,18,2200,10
2020-12-02,Alameda,001,1643700,34479,30697,441,31138,463
2020-12-02,Alpine,003,1148,56,52,0,52,0
2020-12-02,Amador,005,37829,1060,585,3,588,16
2020-12-02,Butte,007,227075,4757,4243,276,4519,65
2020-12-02,Calaveras,009,45235,620,553,0,553,21
2020-12-02,Colusa,011,21464,902,756,16,772,6
2020-12-02,Contra Costa,013,1133247,27589,25147,197,25344,264
2020-12-02,Del Norte,015,27424,451,384,0,384,2
2020-12-02,El Dorado,017,186661,3531,2638,61,2699,5
2020-12-02,Fresno,019,978130,46975,39324,1874,41198,507
2020-12-02,Glenn,021,27897,1129,995,66,1061,7
2020-12-02,Humboldt,023,135768,1113,899,4,903,9
2020-12-02,Imperial,025,180216,17612,16360,159,16519,356
2020-12-02,Inyo,027,18085,354,314,6,320,15
2020-12-02,Kern,029,883053,45540,41660,1894,43554,479
2020-12-02,Kings,031,150075,12580,11531,255,11786,86
2020-12-02,Lake,033,64148,1160,971,0,971,20
2020-12-02,Lassen,035,31185,2694,2115,9,2124,0
2020-12-02,Los Angeles,037,10098052,452868,408289,7786,416075,7739
2020-12-02,Madera,039,155013,7287,6370,203,6573,57
2020-12-02,Marin,041,260295,8144,7819,38,7857,136
2020-12-02,Mariposa,043,17540,163,131,2,133,2
2020-12-02,Mendocino,045,87422,1709,1524,10,1534,23
2020-12-02,Merced,047,269075,13271,12168,153,12321,173
2020-12-02,Modoc,049,8938,148,113,28,141,0
2020-12-02,Mono,051,14174,617,520,10,530,3
2020-12-02,Monterey,053,433212,17740,16064,317,16381,121
2020-12-02,Napa,055,140530,3822,3298,20,3318,19
2020-12-02,Nevada,057,99092,1811,1430,48,1478,9
2020-12-02,Orange,059,3164182,92150,81046,2875,83921,1569
2020-12-02,Placer,061,380077,9050,6941,199,7140,73
2020-12-02,Plumas,063,18699,272,218,0,218,0
2020-12-02,Riverside,065,2383286,107335,90089,2727,92816,1451
2020-12-02,Sacramento,067,1510023,43707,39334,177,39511,597
2020-12-02,San Benito,069,59416,2173,1921,15,1936,16
2020-12-02,San Bernardino,071,2135413,115421,98567,2300,100867,1240
2020-12-02,San Diego,073,3302833,95160,84640,3748,88388,1035
2020-12-02,San Francisco,075,870044,17233,16058,130,16188,157
2020-12-02,San Joaquin,077,732212,30229,26740,632,27372,519
2020-12-02,San Luis Obispo,079,281455,7215,6324,124,6448,42
2020-12-02,San Mateo,081,765935,16532,14757,19,14776,170
2020-12-02,Santa Barbara,083,443738,12538,11705,237,11942,140
2020-12-02,Santa Clara,085,1922200,42665,35878,119,35997,458
2020-12-02,Santa Cruz,087,273765,5546,4766,82,4848,27
2020-12-02,Shasta,089,179085,6233,5188,306,5494,47
2020-12-02,Sierra,091,2930,19,17,0,17,0
2020-12-02,Siskiyou,093,43540,754,624,51,675,1
2020-12-02,Solano,095,438530,11959,10701,93,10794,87
2020-12-02,Sonoma,097,501317,13794,12635,83,12718,163
2020-12-02,Stanislaus,099,539301,24625,22615,1689,24304,448
2020-12-02,Sutter,101,95872,4277,3604,14,3618,18
2020-12-02,Tehama,103,63373,2041,1800,82,1882,9
2020-12-02,Trinity,105,12862,312,165,38,203,0
2020-12-02,Tulare,107,460477,23971,21789,1875,23664,321
2020-12-02,Tuolumne,109,53932,1315,1076,8,1084,7
2020-12-02,Ventura,111,848112,24076,21208,755,21963,186
2020-12-02,Yolo,113,214977,5713,5053,20,5073,87
2020-12-02,Yuba,115,75493,2439,2119,17,2136,10
2020-12-01,Alameda,001,1643700,33788,30252,429,30681,460
2020-12-01,Alpine,003,1148,56,41,0,41,0
2020-12-01,Amador,005,37829,913,575,2,577,16
2020-12-01,Butte,007,227075,4651,4177,262,4439,65
2020-12-01,Calaveras,009,45235,602,544,0,544,21
2020-12-01,Colusa,011,21464,885,747,16,763,6
2020-12-01,Contra Costa,013,1133247,27019,24788,189,24977,264
2020-12-01,Del Norte,015,27424,423,357,0,357,2
2020-12-01,El Dorado,017,186661,3386,2542,56,2598,4
2020-12-01,Fresno,019,978130,46073,39004,1796,40800,505
2020-12-01,Glenn,021,27897,1108,989,62,1051,7
2020-12-01,Humboldt,023,135768,1083,886,4,890,9
2020-12-01,Imperial,025,180216,17295,16278,156,16434,356
2020-12-01,Inyo,027,18085,347,304,6,310,15
2020-12-01,Kern,029,883053,44737,41345,1763,43108,478
2020-12-01,Kings,031,150075,12265,11415,241,11656,86
2020-12-01,Lake,033,64148,1141,969,0,969,19
2020-12-01,Lassen,035,31185,2528,2047,8,2055,0
2020-12-01,Los Angeles,037,10098052,442497,403266,7467,410733,7704
2020-12-01,Madera,039,155013,7170,6270,193,6463,57
2020-12-01,Marin,041,260295,8074,7787,37,7824,136
2020-12-01,Mariposa,043,17540,158,128,2,130,2
2020-12-01,Mendocino,045,87422,1675,1497,10,1507,23
2020-12-01,Merced,047,269075,13028,12032,144,12176,172
2020-12-01,Modoc,049,8938,143,113,24,137,0
2020-12-01,Mono,051,14174,604,520,10,530,3
2020-12-01,Monterey,053,433212,17233,15835,306,16141,121
2020-12-01,Napa,055,140530,3738,3124,19,3143,19
2020-12-01,Nevada,057,99092,1749,1411,47,1458,9
2020-12-01,Orange,059,3164182,90050,79468,2786,82254,1567
2020-12-01,Placer,061,380077,8726,6794,192,6986,72
2020-12-01,Plumas,063,18699,260,201,0,201,0
2020-12-01,Riverside,065,2383286,104526,88530,2565,91095,1448
2020-12-01,Sacramento,067,1510023,42658,38966,173,39139,589
2020-12-01,San Benito,069,59416,2118,1888,15,1903,15
2020-12-01,San Bernardino,071,2135413,111948,95854,2176,98030,1220
2020-12-01,San Diego,073,3302833,92903,83423,3638,87061,1019
2020-12-01,San Francisco,075,870044,16950,15797,126,15923,157
2020-12-01,San Joaquin,077,732212,29429,26432,611,27043,514
2020-12-01,San Luis Obispo,079,281455,7073,6264,119,6383,40
2020-12-01,San Mateo,081,765935,16207,14495,19,14514,170
2020-12-01,Santa Barbara,083,443738,12399,11611,227,11838,140
2020-12-01,Santa Clara,085,1922200,41410,35397,113,35510,452
2020-12-01,Santa Cruz,087,273765,5388,4638,74,4712,27
2020-12-01,Shasta,089,179085,6108,5077,286,5363,47
2020-12-01,Sierra,091,2930,19,17,0,17,0
2020-12-01,Siskiyou,093,43540,740,608,47,655,1
2020-12-01,Solano,095,438530,11699,10604,88,10692,87
2020-12-01,Sonoma,097,501317,13589,12491,80,12571,163
2020-12-01,Stanislaus,099,539301,24168,22351,1632,23983,447
2020-12-01,Sutter,101,95872,4135,3538,14,3552,17
2020-12-01,Tehama,103,63373,1975,1773,72,1845,9
2020-12-01,Trinity,105,12862,298,165,32,197,0
2020-12-01,Tulare,107,460477,23516,21645,1806,23451,319
2020-12-01,Tuolumne,109,53932,1279,1052,6,1058,7
2020-12-01,Ventura,111,848112,23463,20604,733,21337,186
2020-12-01,Yolo,113,214977,5573,4928,20,4948,86
2020-12-01,Yuba,115,75493,2373,2088,16,2104,10
2020-11-30,Alameda,001,1643700,32968,29972,412,30384,457
2020-11-30,Alpine,003,1148,54,41,0,41,0
2020-11-30,Amador,005,37829,872,559,2,561,16
2020-11-30,Butte,007,227075,4533,4148,246,4394,65
2020-11-30,Calaveras,009,45235,580,478,0,478,21
2020-11-30,Colusa,011,21464,858,737,12,749,6
2020-11-30,Contra Costa,013,1133247,26435,24365,185,24550,264
2020-11-30,Del Norte,015,27424,400,339,0,339,2
2020-11-30,El Dorado,017,186661,3212,2488,50,2538,4
2020-11-30,Fresno,019,978130,44963,38712,1682,40394,500
2020-11-30,Glenn,021,27897,1085,954,57,1011,5
2020-11-30,Humboldt,023,135768,1036,870,4,874,9
2020-11-30,Imperial,025,180216,17041,16212,135,16347,356
2020-11-30,Inyo,027,18085,342,304,5,309,15
2020-11-30,Kern,029,883053,43975,40941,1628,42569,473
2020-11-30,Kings,031,150075,12117,11346,226,11572,85
2020-11-30,Lake,033,64148,1109,939,0,939,18
2020-11-30,Lassen,035,31185,2436,1793,8,1801,0
2020-11-30,Los Angeles,037,10098052,431824,396202,7138,403340,7658
2020-11-30,Madera,039,155013,7004,6210,179,6389,57
2020-11-30,Marin,041,260295,8031,7764,36,7800,136
2020-11-30,Mariposa,043,17540,151,123,2,125,2
2020-11-30,Mendocino,045,87422,1647,1482,10,1492,23
2020-11-30,Merced,047,269075,12753,11913,133,12046,172
2020-11-30,Modoc,049,8938,133,113,24,137,0
2020-11-30,Mono,051,14174,582,519,10,529,3
2020-11-30,Monterey,053,433212,16803,15837,298,16135,119
2020-11-30,Napa,055,140530,3638,3091,19,3110,18
2020-11-30,Nevada,057,99092,1663,1347,44,1391,9
2020-11-30,Orange,059,3164182,87940,78711,2689,81400,1568
2020-11-30,Placer,061,380077,8430,6575,179,6754,72
2020-11-30,Plumas,063,18699,249,192,0,192,0
2020-11-30,Riverside,065,2383286,101533,87722,2418,90140,1446
2020-11-30,Sacramento,067,1510023,41578,37834,164,37998,586
2020-11-30,San Benito,069,59416,2071,1875,14,1889,15
2020-11-30,San Bernardino,071,2135413,108215,92704,2064,94768,1220
2020-11-30,San Diego,073,3302833,90540,82045,3511,85556,997
2020-11-30,San Francisco,075,870044,16650,15638,123,15761,157
2020-11-30,San Joaquin,077,732212,28722,25742,585,26327,509
2020-11-30,San Luis Obispo,079,281455,6939,6224,117,6341,36
2020-11-30,San Mateo,081,765935,15848,14276,19,14295,170
2020-11-30,Santa Barbara,083,443738,12221,11572,219,11791,140
2020-11-30,Santa Clara,085,1922200,40202,35019,112,35131,451
2020-11-30,Santa Cruz,087,273765,5250,4558,70,4628,26
2020-11-30,Shasta,089,179085,5963,4933,257,5190,44
2020-11-30,Sierra,091,2930,19,16,0,16,0
2020-11-30,Siskiyou,093,43540,731,605,43,648,1
2020-11-30,Solano,095,438530,11437,10392,83,10475,87
2020-11-30,Sonoma,097,501317,13344,12232,76,12308,163
2020-11-30,Stanislaus,099,539301,23705,22110,1588,23698,446
2020-11-30,Sutter,101,95872,3978,3430,13,3443,16
2020-11-30,Tehama,103,63373,1926,1724,65,1789,9
2020-11-30,Trinity,105,12862,292,162,32,194,0
2020-11-30,Tulare,107,460477,23130,20833,1712,22545,319
2020-11-30,Tuolumne,109,53932,1234,1027,6,1033,7
2020-11-30,Ventura,111,848112,22707,20308,717,21025,180
2020-11-30,Yolo,113,214977,5462,4894,20,4914,81
2020-11-30,Yuba,115,75493,2312,2028,14,2042,10
2020-11-29,Alameda,001,1643700,32181,29918,388,30306,457
2020-11-29,Alpine,003,1148,51,41,0,41,0
2020-11-29,Amador,005,37829,721,548,2,550,16
2020-11-29,Butte,007,227075,4431,4008,229,4237,65
2020-11-29,Calaveras,009,45235,549,478,0,478,21
2020-11-29,Colusa,011,21464,829,723,8,731,6
2020-11-29,Contra Costa,013,1133247,25932,24165,179,24344,264
2020-11-29,Del Norte,015,27424,394,339,0,339,2
2020-11-29,El Dorado,017,186661,3081,2447,49,2496,4
2020-11-29,Fresno,019,978130,44011,38568,1610,40178,500
2020-11-29,Glenn,021,27897,1062,951,55,1006,4
2020-11-29,Humboldt,023,135768,1007,856,4,860,9
2020-11-29,Imperial,025,180216,16811,16138,108,16246,356
2020-11-29,Inyo,027,18085,327,289,5,294,15
2020-11-29,Kern,029,883053,43212,40596,1480,42076,473
2020-11-29,Kings,031,150075,11966,11247,208,11455,85
2020-11-29,Lake,033,64148,1085,927,0,927,18
2020-11-29,Lassen,035,31185,2333,1793,8,1801,0
2020-11-29,Los Angeles,037,10098052,421415,391162,6841,398003,7642
2020-11-29,Madera,039,155013,6861,6184,173,6357,57
2020-11-29,Marin,041,260295,7965,7739,33,7772,135
2020-11-29,Mariposa,043,17540,147,123,2,125,2
2020-11-29,Mendocino,045,87422,1613,1473,10,1483,23
2020-11-29,Merced,047,269075,12514,11773,124,11897,172
2020-11-29,Modoc,049,8938,129,105,22,127,0
2020-11-29,Mono,051,14174,559,515,9,524,3
2020-11-29,Monterey,053,433212,16490,15621,291,15912,119
2020-11-29,Napa,055,140530,3533,3090,18,3108,18
2020-11-29,Nevada,057,99092,1583,1311,42,1353,9
2020-11-29,Orange,059,3164182,85921,78057,2642,80699,1567
2020-11-29,Placer,061,380077,8132,6535,167,6702,72
2020-11-29,Plumas,063,18699,244,191,0,191,0
2020-11-29,Riverside,065,2383286,99139,87383,2264,89647,1442
2020-11-29,Sacramento,067,1510023,40501,37415,155,37570,585
2020-11-29,San Benito,069,59416,2027,1860,14,1874,15
2020-11-29,San Bernardino,071,2135413,104867,92052,1948,94000,1223
2020-11-29,San Diego,073,3302833,88129,81086,3358,84444,997
2020-11-29,San Francisco,075,870044,16369,15571,116,15687,153
2020-11-29,San Joaquin,077,732212,27979,25740,579,26319,509
2020-11-29,San Luis Obispo,079,281455,6816,6145,117,6262,36
2020-11-29,San Mateo,081,765935,15516,14177,19,14196,169
2020-11-29,Santa Barbara,083,443738,12066,11520,215,11735,140
2020-11-29,Santa Clara,085,1922200,38996,34234,106,34340,451
2020-11-29,Santa Cruz,087,273765,5091,4490,68,4558,26
2020-11-29,Shasta,089,179085,5791,4935,229,5164,43
2020-11-29,Sierra,091,2930,19,16,0,16,0
2020-11-29,Siskiyou,093,43540,708,590,41,631,1
2020-11-29,Solano,095,438530,11205,10393,79,10472,87
2020-11-29,Sonoma,097,501317,13092,12052,72,12124,163
2020-11-29,Stanislaus,099,539301,23209,21701,1554,23255,446
2020-11-29,Sutter,101,95872,3863,3297,13,3310,16
2020-11-29,Tehama,103,63373,1875,1710,51,1761,9
2020-11-29,Trinity,105,12862,289,159,30,189,0
2020-11-29,Tulare,107,460477,22761,20793,1635,22428,319
2020-11-29,Tuolumne,109,53932,1197,988,6,994,7
2020-11-29,Ventura,111,848112,22023,19952,704,20656,179
2020-11-29,Yolo,113,214977,5324,4830,19,4849,80
2020-11-29,Yuba,115,75493,2256,1959,14,1973,10
2020-11-28,Alameda,001,1643700,31872,29368,383,29751,456
2020-11-28,Alpine,003,1148,51,41,0,41,0
2020-11-28,Amador,005,37829,644,536,2,538,16
2020-11-28,Butte,007,227075,4373,3894,225,4119,65
2020-11-28,Calaveras,009,45235,544,478,0,478,21
2020-11-28,Colusa,011,21464,820,711,6,717,6
2020-11-28,Contra Costa,013,1133247,25600,23798,175,23973,264
2020-11-28,Del Norte,015,27424,384,328,0,328,2
2020-11-28,El Dorado,017,186661,3013,2415,43,2458,4
2020-11-28,Fresno,019,978130,43664,38288,1571,39859,500
2020-11-28,Glenn,021,27897,1051,925,51,976,4
2020-11-28,Humboldt,023,135768,972,844,4,848,9
2020-11-28,Imperial,025,180216,16745,16019,106,16125,356
2020-11-28,Inyo,027,18085,319,289,5,294,15
2020-11-28,Kern,029,883053,42849,40255,1391,41646,473
2020-11-28,Kings,031,150075,11901,11070,201,11271,85
2020-11-28,Lake,033,64148,1070,920,0,920,18
2020-11-28,Lassen,035,31185,2266,1714,8,1722,0
2020-11-28,Los Angeles,037,10098052,416500,386194,6683,392877,7625
2020-11-28,Madera,039,155013,6759,6119,166,6285,57
2020-11-28,Marin,041,260295,7935,7696,29,7725,135
2020-11-28,Mariposa,043,17540,144,120,2,122,2
2020-11-28,Mendocino,045,87422,1582,1458,10,1468,22
2020-11-28,Merced,047,269075,12416,11688,118,11806,172
2020-11-28,Modoc,049,8938,126,103,22,125,0
2020-11-28,Mono,051,14174,553,505,9,514,3
2020-11-28,Monterey,053,433212,16324,15328,287,15615,118
2020-11-28,Napa,055,140530,3481,3033,18,3051,18
2020-11-28,Nevada,057,99092,1554,1272,40,1312,9
2020-11-28,Orange,059,3164182,84823,76882,2595,79477,1568
2020-11-28,Placer,061,380077,7971,6497,164,6661,70
2020-11-28,Plumas,063,18699,237,188,0,188,0
2020-11-28,Riverside,065,2383286,97730,86854,2161,89015,1440
2020-11-28,Sacramento,067,1510023,39923,36905,151,37056,580
2020-11-28,San Benito,069,59416,1981,1835,14,1849,15
2020-11-28,San Bernardino,071,2135413,103464,91183,1845,93028,1224
2020-11-28,San Diego,073,3302833,86875,80020,3274,83294,997
2020-11-28,San Francisco,075,870044,16193,15450,108,15558,153
2020-11-28,San Joaquin,077,732212,27778,25742,564,26306,509
2020-11-28,San Luis Obispo,079,281455,6746,6106,113,6219,36
2020-11-28,San Mateo,081,765935,15325,14040,19,14059,169
2020-11-28,Santa Barbara,083,443738,11964,11481,210,11691,140
2020-11-28,Santa Clara,085,1922200,38252,33701,104,33805,449
2020-11-28,Santa Cruz,087,273765,5014,4426,68,4494,26
2020-11-28,Shasta,089,179085,5714,4882,222,5104,43
2020-11-28,Sierra,091,2930,19,16,0,16,0
2020-11-28,Siskiyou,093,43540,698,558,38,596,1
2020-11-28,Solano,095,438530,11086,10252,77,10329,87
2020-11-28,Sonoma,097,501317,12988,12008,63,12071,162
2020-11-28,Stanislaus,099,539301,22970,21574,1519,23093,446
2020-11-28,Sutter,101,95872,3779,3244,13,3257,15
2020-11-28,Tehama,103,63373,1856,1678,46,1724,9
2020-11-28,Trinity,105,12862,286,157,28,185,0
2020-11-28,Tulare,107,460477,22564,20701,1593,22294,319
2020-11-28,Tuolumne,109,53932,1175,976,6,982,7
2020-11-28,Ventura,111,848112,21725,19510,694,20204,179
2020-11-28,Yolo,113,214977,5250,4739,17,4756,80
2020-11-28,Yuba,115,75493,2203,1912,14,1926,10
2020-11-27,Alameda,001,1643700,31432,29064,372,29436,450
2020-11-27,Alpine,003,1148,51,41,0,41,0
2020-11-27,Amador,005,37829,597,498,1,499,16
2020-11-27,Butte,007,227075,4332,3894,219,4113,65
2020-11-27,Calaveras,009,45235,535,478,0,478,21
2020-11-27,Colusa,011,21464,803,694,4,698,6
2020-11-27,Contra Costa,013,1133247,25341,23463,169,23632,264
2020-11-27,Del Norte,015,27424,378,307,0,307,2
2020-11-27,El Dorado,017,186661,2942,2238,40,2278,4
2020-11-27,Fresno,019,978130,43258,37994,1513,39507,500
2020-11-27,Glenn,021,27897,1038,891,46,937,4
2020-11-27,Humboldt,023,135768,953,795,3,798,9
2020-11-27,Imperial,025,180216,16677,15960,97,16057,356
2020-11-27,Inyo,027,18085,313,289,5,294,15
2020-11-27,Kern,029,883053,42425,39707,1321,41028,473
2020-11-27,Kings,031,150075,11815,10667,183,10850,85
2020-11-27,Lake,033,64148,1034,909,0,909,18
2020-11-27,Lassen,035,31185,2254,1714,8,1722,0
2020-11-27,Los Angeles,037,10098052,409991,382740,6529,389269,7606
2020-11-27,Madera,039,155013,6687,6050,160,6210,57
2020-11-27,Marin,041,260295,7892,7660,29,7689,135
2020-11-27,Mariposa,043,17540,142,118,2,120,2
2020-11-27,Mendocino,045,87422,1568,1387,9,1396,22
2020-11-27,Merced,047,269075,12310,11550,111,11661,172
2020-11-27,Modoc,049,8938,125,100,22,122,0
2020-11-27,Mono,051,14174,549,498,9,507,3
2020-11-27,Monterey,053,433212,16156,14753,287,15040,113
2020-11-27,Napa,055,140530,3441,2988,18,3006,18
2020-11-27,Nevada,057,99092,1524,1184,38,1222,9
2020-11-27,Orange,059,3164182,83534,75151,2556,77707,1568
2020-11-27,Placer,061,380077,7811,6283,154,6437,68
2020-11-27,Plumas,063,18699,234,188,0,188,0
2020-11-27,Riverside,065,2383286,96119,85769,2008,87777,1440
2020-11-27,Sacramento,067,1510023,39302,36579,147,36726,579
2020-11-27,San Benito,069,59416,1947,1805,13,1818,15
2020-11-27,San Bernardino,071,2135413,101949,90254,1763,92017,1224
2020-11-27,San Diego,073,3302833,85681,78161,3185,81346,996
2020-11-27,San Francisco,075,870044,16037,15377,106,15483,153
2020-11-27,San Joaquin,077,732212,27557,25741,544,26285,509
2020-11-27,San Luis Obispo,079,281455,6663,6039,110,6149,36
2020-11-27,San Mateo,081,765935,15123,13872,18,13890,169
2020-11-27,Santa Barbara,083,443738,11871,11340,207,11547,140
2020-11-27,Santa Clara,085,1922200,37576,32935,97,33032,449
2020-11-27,Santa Cruz,087,273765,4943,4358,66,4424,26
2020-11-27,Shasta,089,179085,5637,4710,209,4919,43
2020-11-27,Sierra,091,2930,18,16,0,16,0
2020-11-27,Siskiyou,093,43540,683,554,35,589,1
2020-11-27,Solano,095,438530,10967,10044,74,10118,87
2020-11-27,Sonoma,097,501317,12855,11924,61,11985,162
2020-11-27,Stanislaus,099,539301,22742,21185,1489,22674,446
2020-11-27,Sutter,101,95872,3711,3101,13,3114,15
2020-11-27,Tehama,103,63373,1828,1649,42,1691,9
2020-11-27,Trinity,105,12862,282,151,28,179,0
2020-11-27,Tulare,107,460477,22376,20634,1536,22170,319
2020-11-27,Tuolumne,109,53932,1143,881,6,887,7
2020-11-27,Ventura,111,848112,21401,19379,672,20051,179
2020-11-27,Yolo,113,214977,5200,4737,17,4754,79
2020-11-27,Yuba,115,75493,2174,1864,13,1877,10
2020-11-26,Alameda,001,1643700,31019,28797,354,29151,447
2020-11-26,Alpine,003,1148,51,41,0,41,0
2020-11-26,Amador,005,37829,589,488,1,489,16
2020-11-26,Butte,007,227075,4269,3894,213,4107,65
2020-11-26,Calaveras,009,45235,508,478,0,478,21
2020-11-26,Colusa,011,21464,789,694,4,698,6
2020-11-26,Contra Costa,013,1133247,25007,23468,163,23631,264
2020-11-26,Del Norte,015,27424,367,307,0,307,2
2020-11-26,El Dorado,017,186661,2861,2217,38,2255,4
2020-11-26,Fresno,019,978130,42852,37724,1468,39192,500
2020-11-26,Glenn,021,27897,1022,892,44,936,4
2020-11-26,Humboldt,023,135768,930,795,2,797,9
2020-11-26,Imperial,025,180216,16566,15722,93,15815,355
2020-11-26,Inyo,027,18085,312,289,5,294,15
2020-11-26,Kern,029,883053,41975,39123,1259,40382,471
2020-11-26,Kings,031,150075,11760,10475,171,10646,85
2020-11-26,Lake,033,64148,1021,890,0,890,18
2020-11-26,Lassen,035,31185,2239,1714,8,1722,0
2020-11-26,Los Angeles,037,10098052,404834,378340,6294,384634,7581
2020-11-26,Madera,039,155013,6612,6003,154,6157,57
2020-11-26,Marin,041,260295,7855,7610,29,7639,135
2020-11-26,Mariposa,043,17540,137,116,2,118,2
2020-11-26,Mendocino,045,87422,1554,1387,7,1394,22
2020-11-26,Merced,047,269075,12163,11440,109,11549,172
2020-11-26,Modoc,049,8938,123,100,22,122,0
2020-11-26,Mono,051,14174,541,485,9,494,2
2020-11-26,Monterey,053,433212,15920,14750,279,15029,113
2020-11-26,Napa,055,140530,3377,2988,18,3006,18
2020-11-26,Nevada,057,99092,1479,1184,38,1222,9
2020-11-26,Orange,059,3164182,82146,74264,2494,76758,1563
2020-11-26,Placer,061,380077,7649,6278,145,6423,68
2020-11-26,Plumas,063,18699,226,188,0,188,0
2020-11-26,Riverside,065,2383286,94515,85774,1884,87658,1440
2020-11-26,Sacramento,067,1510023,38660,35854,139,35993,580
2020-11-26,San Benito,069,59416,1920,1769,13,1782,15
2020-11-26,San Bernardino,071,2135413,100295,89727,1671,91398,1223
2020-11-26,San Diego,073,3302833,84071,76359,3081,79440,996
2020-11-26,San Francisco,075,870044,15901,15156,103,15259,153
2020-11-26,San Joaquin,077,732212,27300,25738,532,26270,509
2020-11-26,San Luis Obispo,079,281455,6570,5964,107,6071,36
2020-11-26,San Mateo,081,765935,14934,13715,17,13732,169
2020-11-26,Santa Barbara,083,443738,11790,11277,206,11483,139
2020-11-26,Santa Clara,085,1922200,36933,32411,89,32500,446
2020-11-26,Santa Cruz,087,273765,4812,4269,60,4329,26
2020-11-26,Shasta,089,179085,5554,4712,198,4910,43
2020-11-26,Sierra,091,2930,18,15,0,15,0
2020-11-26,Siskiyou,093,43540,673,526,34,560,1
2020-11-26,Solano,095,438530,10824,9941,72,10013,87
2020-11-26,Sonoma,097,501317,12707,11922,59,11981,162
2020-11-26,Stanislaus,099,539301,22510,21186,1448,22634,445
2020-11-26,Sutter,101,95872,3617,3101,12,3113,15
2020-11-26,Tehama,103,63373,1785,1612,39,1651,9
2020-11-26,Trinity,105,12862,278,139,28,167,0
2020-11-26,Tulare,107,460477,22137,20649,1472,22121,319
2020-11-26,Tuolumne,109,53932,1115,871,6,877,7
2020-11-26,Ventura,111,848112,20905,19058,658,19716,179
2020-11-26,Yolo,113,214977,5113,4566,17,4583,76
2020-11-26,Yuba,115,75493,2114,1865,11,1876,10
2020-11-25,Alameda,001,1643700,30804,28378,346,28724,447
2020-11-25,Alpine,003,1148,51,41,0,41,0
2020-11-25,Amador,005,37829,579,484,1,485,16
2020-11-25,Butte,007,227075,4238,3848,210,4058,64
2020-11-25,Calaveras,009,45235,505,475,0,475,21
2020-11-25,Colusa,011,21464,772,693,4,697,6
2020-11-25,Contra Costa,013,1133247,24852,23307,162,23469,263
2020-11-25,Del Norte,015,27424,366,304,0,304,2
2020-11-25,El Dorado,017,186661,2825,2154,38,2192,4
2020-11-25,Fresno,019,978130,42619,37349,1446,38795,494
2020-11-25,Glenn,021,27897,1005,891,42,933,4
2020-11-25,Humboldt,023,135768,922,777,2,779,9
2020-11-25,Imperial,025,180216,16495,15640,92,15732,355
2020-11-25,Inyo,027,18085,310,289,5,294,15
2020-11-25,Kern,029,883053,41819,38878,1240,40118,467
2020-11-25,Kings,031,150075,11725,10417,167,10584,85
2020-11-25,Lake,033,64148,1004,878,0,878,18
2020-11-25,Lassen,035,31185,2196,1701,8,1709,0
2020-11-25,Los Angeles,037,10098052,401803,373919,6192,380111,7545
2020-11-25,Madera,039,155013,6590,5989,151,6140,57
2020-11-25,Marin,041,260295,7828,7601,28,7629,135
2020-11-25,Mariposa,043,17540,136,114,2,116,2
2020-11-25,Mendocino,045,87422,1535,1373,7,1380,22
2020-11-25,Merced,047,269075,12105,11346,109,11455,172
2020-11-25,Modoc,049,8938,123,96,22,118,0
2020-11-25,Mono,051,14174,536,487,9,496,2
2020-11-25,Monterey,053,433212,15804,14695,277,14972,113
2020-11-25,Napa,055,140530,3344,2945,18,2963,17
2020-11-25,Nevada,057,99092,1461,1170,36,1206,9
2020-11-25,Orange,059,3164182,81391,73014,2474,75488,1551
2020-11-25,Placer,061,380077,7572,6221,144,6365,68
2020-11-25,Plumas,063,18699,221,183,0,183,0
2020-11-25,Riverside,065,2383286,93972,85077,1866,86943,1438
2020-11-25,Sacramento,067,1510023,38324,35687,136,35823,574
2020-11-25,San Benito,069,59416,1897,1764,13,1777,15
2020-11-25,San Bernardino,071,2135413,99455,88469,1642,90111,1225
2020-11-25,San Diego,073,3302833,83414,75307,3045,78352,988
2020-11-25,San Francisco,075,870044,15796,15053,101,15154,153
2020-11-25,San Joaquin,077,732212,27173,25556,520,26076,515
2020-11-25,San Luis Obispo,079,281455,6527,5913,106,6019,34
2020-11-25,San Mateo,081,765935,14819,13614,17,13631,170
2020-11-25,Santa Barbara,083,443738,11740,11183,206,11389,138
2020-11-25,Santa Clara,085,1922200,36487,32032,88,32120,442
2020-11-25,Santa Cruz,087,273765,4759,4202,59,4261,25
2020-11-25,Shasta,089,179085,5508,4588,191,4779,43
2020-11-25,Sierra,091,2930,18,15,0,15,0
2020-11-25,Siskiyou,093,43540,666,499,34,533,1
2020-11-25,Solano,095,438530,10719,9832,71,9903,87
2020-11-25,Sonoma,097,501317,12644,11775,58,11833,162
2020-11-25,Stanislaus,099,539301,22379,21022,1421,22443,445
2020-11-25,Sutter,101,95872,3573,3064,12,3076,14
2020-11-25,Tehama,103,63373,1773,1587,33,1620,9
2020-11-25,Trinity,105,12862,276,135,28,163,0
2020-11-25,Tulare,107,460477,22047,20528,1441,21969,318
2020-11-25,Tuolumne,109,53932,1098,842,6,848,7
2020-11-25,Ventura,111,848112,20810,18914,652,19566,179
2020-11-25,Yolo,113,214977,5077,4527,17,4544,76
2020-11-25,Yuba,115,75493,2088,1840,11,1851,10
2020-11-24,Alameda,001,1643700,30325,28030,335,28365,444
2020-11-24,Alpine,003,1148,51,41,0,41,0
2020-11-24,Amador,005,37829,554,470,1,471,16
2020-11-24,Butte,007,227075,4153,3798,202,4000,63
2020-11-24,Calaveras,009,45235,498,466,0,466,21
2020-11-24,Colusa,011,21464,754,682,4,686,6
2020-11-24,Contra Costa,013,1133247,24500,23072,156,23228,259
2020-11-24,Del Norte,015,27424,357,298,0,298,2
2020-11-24,El Dorado,017,186661,2720,2005,37,2042,4
2020-11-24,Fresno,019,978130,42217,37021,1370,38391,493
2020-11-24,Glenn,021,27897,987,883,38,921,4
2020-11-24,Humboldt,023,135768,903,774,2,776,9
2020-11-24,Imperial,025,180216,16392,15600,87,15687,355
2020-11-24,Inyo,027,18085,309,282,5,287,15
2020-11-24,Kern,029,883053,41345,38551,1162,39713,465
2020-11-24,Kings,031,150075,11458,10338,154,10492,85
2020-11-24,Lake,033,64148,988,872,0,872,18
2020-11-24,Lassen,035,31185,2173,1657,8,1665,0
2020-11-24,Los Angeles,037,10098052,395491,370008,5958,375966,7501
2020-11-24,Madera,039,155013,6506,5881,145,6026,57
2020-11-24,Marin,041,260295,7781,7591,28,7619,135
2020-11-24,Mariposa,043,17540,126,114,1,115,2
2020-11-24,Mendocino,045,87422,1513,1346,6,1352,22
2020-11-24,Merced,047,269075,11917,11268,103,11371,171
2020-11-24,Modoc,049,8938,119,91,22,113,0
2020-11-24,Mono,051,14174,532,483,9,492,2
2020-11-24,Monterey,053,433212,15542,14354,265,14619,113
2020-11-24,Napa,055,140530,3278,2904,18,2922,17
2020-11-24,Nevada,057,99092,1397,1156,34,1190,9
2020-11-24,Orange,059,3164182,79949,71975,2393,74368,1547
2020-11-24,Placer,061,380077,7391,6147,137,6284,67
2020-11-24,Plumas,063,18699,218,180,0,180,0
2020-11-24,Riverside,065,2383286,92213,83685,1737,85422,1420
2020-11-24,Sacramento,067,1510023,37643,35097,129,35226,568
2020-11-24,San Benito,069,59416,1866,1740,12,1752,15
2020-11-24,San Bernardino,071,2135413,97113,86645,1540,88185,1226
2020-11-24,San Diego,073,3302833,82004,74363,2974,77337,984
2020-11-24,San Francisco,075,870044,15601,14874,97,14971,153
2020-11-24,San Joaquin,077,732212,26857,25318,492,25810,517
2020-11-24,San Luis Obispo,079,281455,6464,5805,105,5910,34
2020-11-24,San Mateo,081,765935,14610,13558,16,13574,170
2020-11-24,Santa Barbara,083,443738,11634,11154,204,11358,138
2020-11-24,Santa Clara,085,1922200,35698,31564,84,31648,438
2020-11-24,Santa Cruz,087,273765,4645,4132,58,4190,25
2020-11-24,Shasta,089,179085,5408,4410,172,4582,43
2020-11-24,Sierra,091,2930,18,15,0,15,0
2020-11-24,Siskiyou,093,43540,648,473,31,504,1
2020-11-24,Solano,095,438530,10548,9716,70,9786,86
2020-11-24,Sonoma,097,501317,12464,11644,55,11699,162
2020-11-24,Stanislaus,099,539301,22137,20830,1378,22208,438
2020-11-24,Sutter,101,95872,3467,2974,12,2986,14
2020-11-24,Tehama,103,63373,1724,1565,28,1593,9
2020-11-24,Trinity,105,12862,269,129,27,156,0
2020-11-24,Tulare,107,460477,21798,20319,1377,21696,315
2020-11-24,Tuolumne,109,53932,1069,832,6,838,7
2020-11-24,Ventura,111,848112,20428,18637,642,19279,179
2020-11-24,Yolo,113,214977,4993,4420,17,4437,76
2020-11-24,Yuba,115,75493,2037,1804,9,1813,10
2020-11-23,Alameda,001,1643700,29910,27718,323,28041,444
2020-11-23,Alpine,003,1148,49,41,0,41,0
2020-11-23,Amador,005,37829,513,457,1,458,16
2020-11-23,Butte,007,227075,4089,3765,196,3961,61
2020-11-23,Calaveras,009,45235,481,434,0,434,21
2020-11-23,Colusa,011,21464,740,662,4,666,6
2020-11-23,Contra Costa,013,1133247,24228,22674,151,22825,260
2020-11-23,Del Norte,015,27424,335,296,0,296,2
2020-11-23,El Dorado,017,186661,2600,2005,36,2041,4
2020-11-23,Fresno,019,978130,41768,36688,1308,37996,488
2020-11-23,Glenn,021,27897,961,853,38,891,4
2020-11-23,Humboldt,023,135768,890,746,2,748,9
2020-11-23,Imperial,025,180216,16223,15104,82,15186,355
2020-11-23,Inyo,027,18085,301,279,5,284,15
2020-11-23,Kern,029,883053,40832,38245,1099,39344,463
2020-11-23,Kings,031,150075,11038,10204,147,10351,85
2020-11-23,Lake,033,64148,965,840,0,840,18
2020-11-23,Lassen,035,31185,2093,1271,7,1278,0
2020-11-23,Los Angeles,037,10098052,389390,366374,5710,372084,7447
2020-11-23,Madera,039,155013,6380,5787,141,5928,56
2020-11-23,Marin,041,260295,7739,7543,28,7571,135
2020-11-23,Mariposa,043,17540,125,97,1,98,2
2020-11-23,Mendocino,045,87422,1483,1330,6,1336,22
2020-11-23,Merced,047,269075,11729,11148,100,11248,169
2020-11-23,Modoc,049,8938,105,91,21,112,0
2020-11-23,Mono,051,14174,519,480,9,489,2
2020-11-23,Monterey,053,433212,15263,14265,259,14524,112
2020-11-23,Napa,055,140530,3212,2811,17,2828,17
2020-11-23,Nevada,057,99092,1308,1087,34,1121,9
2020-11-23,Orange,059,3164182,78545,71074,2347,73421,1546
2020-11-23,Placer,061,380077,7189,5999,136,6135,66
2020-11-23,Plumas,063,18699,214,172,0,172,0
2020-11-23,Riverside,065,2383286,90434,82175,1672,83847,1415
2020-11-23,Sacramento,067,1510023,37073,34141,122,34263,556
2020-11-23,San Benito,069,59416,1838,1729,11,1740,15
2020-11-23,San Bernardino,071,2135413,95005,84387,1476,85863,1224
2020-11-23,San Diego,073,3302833,80541,72817,2886,75703,968
2020-11-23,San Francisco,075,870044,15443,14646,95,14741,153
2020-11-23,San Joaquin,077,732212,26508,24622,488,25110,517
2020-11-23,San Luis Obispo,079,281455,6382,5772,103,5875,34
2020-11-23,San Mateo,081,765935,14420,13364,16,13380,170
2020-11-23,Santa Barbara,083,443738,11527,10944,200,11144,137
2020-11-23,Santa Clara,085,1922200,35047,31064,81,31145,435
2020-11-23,Santa Cruz,087,273765,4535,4003,54,4057,25
2020-11-23,Shasta,089,179085,5290,4100,160,4260,43
2020-11-23,Sierra,091,2930,17,15,0,15,0
2020-11-23,Siskiyou,093,43540,621,460,30,490,0
2020-11-23,Solano,095,438530,10391,9394,67,9461,86
2020-11-23,Sonoma,097,501317,12291,11507,51,11558,160
2020-11-23,Stanislaus,099,539301,21844,20487,1345,21832,436
2020-11-23,Sutter,101,95872,3330,2840,11,2851,14
2020-11-23,Tehama,103,63373,1674,1526,24,1550,9
2020-11-23,Trinity,105,12862,260,120,25,145,0
2020-11-23,Tulare,107,460477,21504,19818,1311,21129,315
2020-11-23,Tuolumne,109,53932,1029,774,6,780,7
2020-11-23,Ventura,111,848112,20053,18480,629,19109,179
2020-11-23,Yolo,113,214977,4912,4265,16,4281,75
2020-11-23,Yuba,115,75493,1970,1702,9,1711,10
2020-11-22,Alameda,001,1643700,29473,27472,312,27784,444
2020-11-22,Alpine,003,1148,46,41,0,41,0
2020-11-22,Amador,005,37829,501,450,1,451,16
2020-11-22,Butte,007,227075,4038,3712,189,3901,61
2020-11-22,Calaveras,009,45235,472,434,0,434,21
2020-11-22,Colusa,011,21464,722,642,3,645,6
2020-11-22,Contra Costa,013,1133247,23924,22407,146,22553,260
2020-11-22,Del Norte,015,27424,311,271,0,271,2
2020-11-22,El Dorado,017,186661,2490,1917,33,1950,4
2020-11-22,Fresno,019,978130,41286,36315,1253,37568,488
2020-11-22,Glenn,021,27897,939,832,34,866,4
2020-11-22,Humboldt,023,135768,874,729,2,731,9
2020-11-22,Imperial,025,180216,16017,15109,37,15146,355
2020-11-22,Inyo,027,18085,295,279,5,284,15
2020-11-22,Kern,029,883053,40253,37904,1065,38969,463
2020-11-22,Kings,031,150075,10939,10035,138,10173,85
2020-11-22,Lake,033,64148,943,834,0,834,18
2020-11-22,Lassen,035,31185,1928,1211,6,1217,0
2020-11-22,Los Angeles,037,10098052,383109,360341,5463,365804,7438
2020-11-22,Madera,039,155013,6300,5745,130,5875,56
2020-11-22,Marin,041,260295,7704,7506,27,7533,135
2020-11-22,Mariposa,043,17540,124,95,1,96,2
2020-11-22,Mendocino,045,87422,1459,1285,5,1290,22
2020-11-22,Merced,047,269075,11580,10939,100,11039,169
2020-11-22,Modoc,049,8938,104,87,19,106,0
2020-11-22,Mono,051,14174,504,481,9,490,2
2020-11-22,Monterey,053,433212,15022,13887,253,14140,111
2020-11-22,Napa,055,140530,3131,2778,17,2795,17
2020-11-22,Nevada,057,99092,1250,1052,34,1086,9
2020-11-22,Orange,059,3164182,77133,69913,2308,72221,1546
2020-11-22,Placer,061,380077,6962,5880,126,6006,66
2020-11-22,Plumas,063,18699,201,172,0,172,0
2020-11-22,Riverside,065,2383286,88839,81565,1611,83176,1409
2020-11-22,Sacramento,067,1510023,36341,33421,109,33530,555
2020-11-22,San Benito,069,59416,1809,1704,11,1715,15
2020-11-22,San Bernardino,071,2135413,92658,83505,1406,84911,1224
2020-11-22,San Diego,073,3302833,78804,71649,2811,74460,968
2020-11-22,San Francisco,075,870044,15272,14515,94,14609,153
2020-11-22,San Joaquin,077,732212,26208,24619,476,25095,517
2020-11-22,San Luis Obispo,079,281455,6274,5664,102,5766,34
2020-11-22,San Mateo,081,765935,14214,13228,16,13244,170
2020-11-22,Santa Barbara,083,443738,11392,10946,195,11141,137
2020-11-22,Santa Clara,085,1922200,34369,30633,79,30712,434
2020-11-22,Santa Cruz,087,273765,4452,3896,47,3943,25
2020-11-22,Shasta,089,179085,5134,4100,142,4242,43
2020-11-22,Sierra,091,2930,17,13,0,13,0
2020-11-22,Siskiyou,093,43540,590,411,30,441,0
2020-11-22,Solano,095,438530,10219,9363,63,9426,86
2020-11-22,Sonoma,097,501317,12133,11415,49,11464,159
2020-11-22,Stanislaus,099,539301,21517,20223,1315,21538,436
2020-11-22,Sutter,101,95872,3213,2677,11,2688,13
2020-11-22,Tehama,103,63373,1640,1457,19,1476,9
2020-11-22,Trinity,105,12862,254,114,25,139,0
2020-11-22,Tulare,107,460477,21251,19818,1241,21059,314
2020-11-22,Tuolumne,109,53932,1003,689,6,695,7
2020-11-22,Ventura,111,848112,19692,18105,615,18720,179
2020-11-22,Yolo,113,214977,4812,4206,16,4222,75
2020-11-22,Yuba,115,75493,1917,1672,9,1681,10
2020-11-21,Alameda,001,1643700,29286,27424,310,27734,444
2020-11-21,Alpine,003,1148,46,41,0,41,0
2020-11-21,Amador,005,37829,487,450,1,451,16
2020-11-21,Butte,007,227075,3990,3664,186,3850,61
2020-11-21,Calaveras,009,45235,464,434,0,434,21
2020-11-21,Colusa,011,21464,713,642,3,645,6
2020-11-21,Contra Costa,013,1133247,23771,22338,144,22482,260
2020-11-21,Del Norte,015,27424,306,271,0,271,2
2020-11-21,El Dorado,017,186661,2441,1900,32,1932,4
2020-11-21,Fresno,019,978130,41030,35973,1219,37192,482
2020-11-21,Glenn,021,27897,934,829,32,861,4
2020-11-21,Humboldt,023,135768,864,728,2,730,9
2020-11-21,Imperial,025,180216,15940,15053,37,15090,355
2020-11-21,Inyo,027,18085,293,283,5,288,15
2020-11-21,Kern,029,883053,39997,37403,1030,38433,463
2020-11-21,Kings,031,150075,10891,10019,134,10153,85
2020-11-21,Lake,033,64148,930,832,0,832,18
2020-11-21,Lassen,035,31185,1861,1211,6,1217,0
2020-11-21,Los Angeles,037,10098052,379929,357754,5319,363073,7428
2020-11-21,Madera,039,155013,6263,5706,130,5836,56
2020-11-21,Marin,041,260295,7681,7488,26,7514,134
2020-11-21,Mariposa,043,17540,124,92,1,93,2
2020-11-21,Mendocino,045,87422,1428,1282,5,1287,22
2020-11-21,Merced,047,269075,11519,10849,99,10948,169
2020-11-21,Modoc,049,8938,100,87,18,105,0
2020-11-21,Mono,051,14174,499,469,9,478,2
2020-11-21,Monterey,053,433212,14924,13886,248,14134,110
2020-11-21,Napa,055,140530,3097,2757,17,2774,17
2020-11-21,Nevada,057,99092,1238,1018,33,1051,9
2020-11-21,Orange,059,3164182,76332,69021,2278,71299,1543
2020-11-21,Placer,061,380077,6848,5778,123,5901,65
2020-11-21,Plumas,063,18699,196,172,0,172,0
2020-11-21,Riverside,065,2383286,88062,80676,1565,82241,1407
2020-11-21,Sacramento,067,1510023,35945,33133,101,33234,548
2020-11-21,San Benito,069,59416,1790,1691,11,1702,15
2020-11-21,San Bernardino,071,2135413,91782,83206,1330,84536,1222
2020-11-21,San Diego,073,3302833,78025,70711,2756,73467,966
2020-11-21,San Francisco,075,870044,15169,14445,93,14538,153
2020-11-21,San Joaquin,077,732212,26075,24620,461,25081,517
2020-11-21,San Luis Obispo,079,281455,6221,5618,99,5717,34
2020-11-21,San Mateo,081,765935,14113,13138,16,13154,170
2020-11-21,Santa Barbara,083,443738,11340,10922,192,11114,137
2020-11-21,Santa Clara,085,1922200,33985,30377,76,30453,433
2020-11-21,Santa Cruz,087,273765,4395,3898,47,3945,25
2020-11-21,Shasta,089,179085,5060,4095,139,4234,42
2020-11-21,Sierra,091,2930,17,13,0,13,0
2020-11-21,Siskiyou,093,43540,574,403,30,433,0
2020-11-21,Solano,095,438530,10129,9290,60,9350,86
2020-11-21,Sonoma,097,501317,12058,11394,47,11441,158
2020-11-21,Stanislaus,099,539301,21374,20111,1290,21401,435
2020-11-21,Sutter,101,95872,3153,2615,10,2625,13
2020-11-21,Tehama,103,63373,1620,1435,18,1453,9
2020-11-21,Trinity,105,12862,251,110,24,134,0
2020-11-21,Tulare,107,460477,21125,19752,1207,20959,313
2020-11-21,Tuolumne,109,53932,984,690,6,696,7
2020-11-21,Ventura,111,848112,19528,18040,605,18645,177
2020-11-21,Yolo,113,214977,4738,4147,15,4162,75
2020-11-21,Yuba,115,75493,1885,1643,9,1652,10
2020-11-20,Alameda,001,1643700,29072,27221,303,27524,444
2020-11-20,Alpine,003,1148,46,20,0,20,0
2020-11-20,Amador,005,37829,483,446,1,447,16
2020-11-20,Butte,007,227075,3958,3618,182,3800,60
2020-11-20,Calaveras,009,45235,454,424,0,424,21
2020-11-20,Colusa,011,21464,705,631,2,633,6
2020-11-20,Contra Costa,013,1133247,23585,22116,140,22256,260
2020-11-20,Del Norte,015,27424,302,264,0,264,2
2020-11-20,El Dorado,017,186661,2345,1868,30,1898,4
2020-11-20,Fresno,019,978130,40736,35635,1189,36824,480
2020-11-20,Glenn,021,27897,922,826,30,856,4
2020-11-20,Humboldt,023,135768,855,714,1,715,9
2020-11-20,Imperial,025,180216,15878,14864,33,14897,353
2020-11-20,Inyo,027,18085,291,262,5,267,15
2020-11-20,Kern,029,883053,39704,37143,1005,38148,462
2020-11-20,Kings,031,150075,10843,9903,133,10036,85
2020-11-20,Lake,033,64148,921,820,0,820,18
2020-11-20,Lassen,035,31185,1776,1212,5,1217,0
2020-11-20,Los Angeles,037,10098052,376041,353554,5157,358711,7398
2020-11-20,Madera,039,155013,6169,5635,129,5764,54
2020-11-20,Marin,041,260295,7657,7467,25,7492,134
2020-11-20,Mariposa,043,17540,116,89,1,90,2
2020-11-20,Mendocino,045,87422,1408,1269,5,1274,22
2020-11-20,Merced,047,269075,11433,10729,99,10828,167
2020-11-20,Modoc,049,8938,100,83,18,101,0
2020-11-20,Mono,051,14174,497,469,9,478,2
2020-11-20,Monterey,053,433212,14799,13738,239,13977,110
2020-11-20,Napa,055,140530,3067,2718,17,2735,17
2020-11-20,Nevada,057,99092,1220,990,32,1022,9
2020-11-20,Orange,059,3164182,75496,68212,2240,70452,1532
2020-11-20,Placer,061,380077,6713,5687,108,5795,66
2020-11-20,Plumas,063,18699,194,163,0,163,0
2020-11-20,Riverside,065,2383286,87051,79613,1502,81115,1405
2020-11-20,Sacramento,067,1510023,35569,32832,94,32926,549
2020-11-20,San Benito,069,59416,1778,1668,11,1679,15
2020-11-20,San Bernardino,071,2135413,90414,81203,1248,82451,1220
2020-11-20,San Diego,073,3302833,77027,69233,2674,71907,960
2020-11-20,San Francisco,075,870044,15065,14327,92,14419,153
2020-11-20,San Joaquin,077,732212,25921,24460,448,24908,515
2020-11-20,San Luis Obispo,079,281455,6165,5524,96,5620,34
2020-11-20,San Mateo,081,765935,13980,12980,15,12995,169
2020-11-20,Santa Barbara,083,443738,11284,10825,186,11011,136
2020-11-20,Santa Clara,085,1922200,33564,30002,71,30073,431
2020-11-20,Santa Cruz,087,273765,4329,3815,47,3862,25
2020-11-20,Shasta,089,179085,4987,3861,134,3995,42
2020-11-20,Sierra,091,2930,17,12,0,12,0
2020-11-20,Siskiyou,093,43540,560,387,29,416,0
2020-11-20,Solano,095,438530,10037,9216,58,9274,85
2020-11-20,Sonoma,097,501317,11974,11316,46,11362,158
2020-11-20,Stanislaus,099,539301,21219,19889,1264,21153,433
2020-11-20,Sutter,101,95872,3103,2580,10,2590,13
2020-11-20,Tehama,103,63373,1604,1410,15,1425,9
2020-11-20,Trinity,105,12862,250,102,24,126,0
2020-11-20,Tulare,107,460477,20992,19568,1168,20736,311
2020-11-20,Tuolumne,109,53932,945,662,6,668,7
2020-11-20,Ventura,111,848112,19360,17741,577,18318,175
2020-11-20,Yolo,113,214977,4660,4081,14,4095,74
2020-11-20,Yuba,115,75493,1857,1611,9,1620,10
2020-11-19,Alameda,001,1643700,28727,26971,295,27266,441
2020-11-19,Alpine,003,1148,43,20,0,20,0
2020-11-19,Amador,005,37829,479,436,1,437,16
2020-11-19,Butte,007,227075,3909,3576,175,3751,60
2020-11-19,Calaveras,009,45235,443,417,0,417,21
2020-11-19,Colusa,011,21464,687,621,2,623,6
2020-11-19,Contra Costa,013,1133247,23313,21886,137,22023,259
2020-11-19,Del Norte,015,27424,294,251,0,251,2
2020-11-19,El Dorado,017,186661,2271,1825,26,1851,4
2020-11-19,Fresno,019,978130,40287,35278,1132,36410,478
2020-11-19,Glenn,021,27897,900,806,29,835,4
2020-11-19,Humboldt,023,135768,835,693,1,694,9
2020-11-19,Imperial,025,180216,15668,14507,33,14540,349
2020-11-19,Inyo,027,18085,289,262,5,267,15
2020-11-19,Kern,029,883053,39284,36779,963,37742,459
2020-11-19,Kings,031,150075,10695,9763,125,9888,85
2020-11-19,Lake,033,64148,907,809,0,809,18
2020-11-19,Lassen,035,31185,1659,1201,3,1204,0
2020-11-19,Los Angeles,037,10098052,371016,349493,4989,354482,7365
2020-11-19,Madera,039,155013,6098,5540,121,5661,54
2020-11-19,Marin,041,260295,7626,7451,25,7476,134
2020-11-19,Mariposa,043,17540,109,88,0,88,2
2020-11-19,Mendocino,045,87422,1387,1237,5,1242,23
2020-11-19,Merced,047,269075,11292,10634,93,10727,167
2020-11-19,Modoc,049,8938,97,82,18,100,0
2020-11-19,Mono,051,14174,489,468,9,477,2
2020-11-19,Monterey,053,433212,14584,13369,227,13596,108
2020-11-19,Napa,055,140530,3013,2641,17,2658,17
2020-11-19,Nevada,057,99092,1179,945,31,976,9
2020-11-19,Orange,059,3164182,74234,66998,2195,69193,1530
2020-11-19,Placer,061,380077,6522,5612,107,5719,65
2020-11-19,Plumas,063,18699,189,158,0,158,0
2020-11-19,Riverside,065,2383286,85566,78535,1431,79966,1402
2020-11-19,Sacramento,067,1510023,35055,32367,92,32459,546
2020-11-19,San Benito,069,59416,1755,1643,11,1654,15
2020-11-19,San Bernardino,071,2135413,88518,79244,1168,80412,1215
2020-11-19,San Diego,073,3302833,75777,68142,2570,70712,952
2020-11-19,San Francisco,075,870044,14908,14178,86,14264,153
2020-11-19,San Joaquin,077,732212,25601,24270,437,24707,516
2020-11-19,San Luis Obispo,079,281455,6088,5410,92,5502,34
2020-11-19,San Mateo,081,765935,13842,12714,15,12729,169
2020-11-19,Santa Barbara,083,443738,11204,10741,183,10924,136
2020-11-19,Santa Clara,085,1922200,33007,29630,70,29700,424
2020-11-19,Santa Cruz,087,273765,4239,3679,45,3724,25
2020-11-19,Shasta,089,179085,4849,3685,124,3809,42
2020-11-19,Sierra,091,2930,17,11,0,11,0
2020-11-19,Siskiyou,093,43540,535,360,28,388,0
2020-11-19,Solano,095,438530,9900,9093,54,9147,84
2020-11-19,Sonoma,097,501317,11804,11205,44,11249,156
2020-11-19,Stanislaus,099,539301,20978,19736,1222,20958,433
2020-11-19,Sutter,101,95872,3004,2509,10,2519,13
2020-11-19,Tehama,103,63373,1570,1373,12,1385,9
2020-11-19,Trinity,105,12862,244,97,24,121,0
2020-11-19,Tulare,107,460477,20770,19384,1103,20487,304
2020-11-19,Tuolumne,109,53932,913,602,6,608,7
2020-11-19,Ventura,111,848112,19007,17300,564,17864,174
2020-11-19,Yolo,113,214977,4566,3973,14,3987,72
2020-11-19,Yuba,115,75493,1817,1568,9,1577,10
2020-11-18,Alameda,001,1643700,28463,26610,290,26900,440
2020-11-18,Alpine,003,1148,42,16,0,16,0
2020-11-18,Amador,005,37829,474,430,1,431,16
2020-11-18,Butte,007,227075,3856,3537,162,3699,59
2020-11-18,Calaveras,009,45235,438,409,0,409,21
2020-11-18,Colusa,011,21464,674,611,2,613,6
2020-11-18,Contra Costa,013,1133247,23047,21685,133,21818,258
2020-11-18,Del Norte,015,27424,281,240,0,240,2
2020-11-18,El Dorado,017,186661,2183,1799,25,1824,4
2020-11-18,Fresno,019,978130,39847,34997,1081,36078,474
2020-11-18,Glenn,021,27897,883,803,27,830,4
2020-11-18,Humboldt,023,135768,821,690,1,691,9
2020-11-18,Imperial,025,180216,15445,14428,33,14461,348
2020-11-18,Inyo,027,18085,287,262,5,267,15
2020-11-18,Kern,029,883053,38895,36537,913,37450,456
2020-11-18,Kings,031,150075,10547,9696,122,9818,85
2020-11-18,Lake,033,64148,894,802,0,802,18
2020-11-18,Lassen,035,31185,1559,1124,3,1127,0
2020-11-18,Los Angeles,037,10098052,366146,344675,4806,349481,7338
2020-11-18,Madera,039,155013,6011,5519,109,5628,54
2020-11-18,Marin,041,260295,7602,7435,25,7460,134
2020-11-18,Mariposa,043,17540,106,88,0,88,2
2020-11-18,Mendocino,045,87422,1367,1237,5,1242,23
2020-11-18,Merced,047,269075,11176,10536,92,10628,166
2020-11-18,Modoc,049,8938,94,77,18,95,0
2020-11-18,Mono,051,14174,484,468,9,477,2
2020-11-18,Monterey,053,433212,14389,13340,213,13553,108
2020-11-18,Napa,055,140530,2967,2607,17,2624,17
2020-11-18,Nevada,057,99092,1139,933,29,962,9
2020-11-18,Orange,059,3164182,73137,66381,2170,68551,1521
2020-11-18,Placer,061,380077,6344,5543,102,5645,64
2020-11-18,Plumas,063,18699,184,143,0,143,0
2020-11-18,Riverside,065,2383286,84101,77739,1328,79067,1387
2020-11-18,Sacramento,067,1510023,34430,31816,84,31900,541
2020-11-18,San Benito,069,59416,1730,1632,10,1642,15
2020-11-18,San Bernardino,071,2135413,86756,77400,1088,78488,1206
2020-11-18,San Diego,073,3302833,74483,67243,2510,69753,945
2020-11-18,San Francisco,075,870044,14764,14057,84,14141,153
2020-11-18,San Joaquin,077,732212,25337,24146,423,24569,517
2020-11-18,San Luis Obispo,079,281455,6012,5322,91,5413,34
2020-11-18,San Mateo,081,765935,13689,12631,14,12645,169
2020-11-18,Santa Barbara,083,443738,11125,10684,176,10860,136
2020-11-18,Santa Clara,085,1922200,32541,29285,65,29350,421
2020-11-18,Santa Cruz,087,273765,4148,3618,43,3661,25
2020-11-18,Shasta,089,179085,4715,3547,120,3667,42
2020-11-18,Sierra,091,2930,17,11,0,11,0
2020-11-18,Siskiyou,093,43540,503,351,27,378,0
2020-11-18,Solano,095,438530,9768,8994,52,9046,84
2020-11-18,Sonoma,097,501317,11697,11129,41,11170,155
2020-11-18,Stanislaus,099,539301,20736,19609,1197,20806,431
2020-11-18,Sutter,101,95872,2886,2442,10,2452,13
2020-11-18,Tehama,103,63373,1531,1338,12,1350,8
2020-11-18,Trinity,105,12862,230,95,23,118,0
2020-11-18,Tulare,107,460477,20560,19286,1052,20338,306
2020-11-18,Tuolumne,109,53932,878,590,6,596,7
2020-11-18,Ventura,111,848112,18682,17169,549,17718,173
2020-11-18,Yolo,113,214977,4492,3929,14,3943,71
2020-11-18,Yuba,115,75493,1763,1540,9,1549,10
2020-11-17,Alameda,001,1643700,28137,26425,280,26705,439
2020-11-17,Alpine,003,1148,40,12,0,12,0
2020-11-17,Amador,005,37829,463,423,1,424,16
2020-11-17,Butte,007,227075,3814,3500,152,3652,59
2020-11-17,Calaveras,009,45235,421,405,0,405,21
2020-11-17,Colusa,011,21464,663,606,1,607,6
2020-11-17,Contra Costa,013,1133247,22775,21557,128,21685,256
2020-11-17,Del Norte,015,27424,275,233,0,233,2
2020-11-17,El Dorado,017,186661,2124,1758,25,1783,4
2020-11-17,Fresno,019,978130,39249,34765,1022,35787,472
2020-11-17,Glenn,021,27897,872,795,26,821,4
2020-11-17,Humboldt,023,135768,799,685,1,686,9
2020-11-17,Imperial,025,180216,15208,14204,31,14235,346
2020-11-17,Inyo,027,18085,286,263,5,268,15
2020-11-17,Kern,029,883053,38446,36164,860,37024,455
2020-11-17,Kings,031,150075,10474,9653,115,9768,85
2020-11-17,Lake,033,64148,874,792,0,792,18
2020-11-17,Lassen,035,31185,1480,1124,3,1127,0
2020-11-17,Los Angeles,037,10098052,361200,340933,4646,345579,7302
2020-11-17,Madera,039,155013,5922,5485,102,5587,54
2020-11-17,Marin,041,260295,7570,7404,24,7428,134
2020-11-17,Mariposa,043,17540,103,87,0,87,2
2020-11-17,Mendocino,045,87422,1346,1216,5,1221,23
2020-11-17,Merced,047,269075,11032,10457,86,10543,162
2020-11-17,Modoc,049,8938,88,71,17,88,0
2020-11-17,Mono,051,14174,479,459,9,468,2
2020-11-17,Monterey,053,433212,14159,13220,203,13423,108
2020-11-17,Napa,055,140530,2913,2568,17,2585,17
2020-11-17,Nevada,057,99092,1098,918,28,946,9
2020-11-17,Orange,059,3164182,71986,65757,2143,67900,1519
2020-11-17,Placer,061,380077,6182,5435,96,5531,63
2020-11-17,Plumas,063,18699,176,142,0,142,0
2020-11-17,Riverside,065,2383286,82715,77079,1237,78316,1379
2020-11-17,Sacramento,067,1510023,33831,31341,80,31421,538
2020-11-17,San Benito,069,59416,1714,1611,4,1615,15
2020-11-17,San Bernardino,071,2135413,84943,76134,998,77132,1188
2020-11-17,San Diego,073,3302833,73230,66321,2454,68775,933
2020-11-17,San Francisco,075,870044,14598,13952,83,14035,153
2020-11-17,San Joaquin,077,732212,25065,23997,403,24400,516
2020-11-17,San Luis Obispo,079,281455,5916,5235,91,5326,34
2020-11-17,San Mateo,081,765935,13527,12491,13,12504,169
2020-11-17,Santa Barbara,083,443738,11040,10597,171,10768,136
2020-11-17,Santa Clara,085,1922200,31994,29013,64,29077,419
2020-11-17,Santa Cruz,087,273765,4063,3548,40,3588,25
2020-11-17,Shasta,089,179085,4557,3457,108,3565,40
2020-11-17,Sierra,091,2930,15,11,0,11,0
2020-11-17,Siskiyou,093,43540,455,333,26,359,0
2020-11-17,Solano,095,438530,9623,8905,51,8956,84
2020-11-17,Sonoma,097,501317,11563,11084,40,11124,155
2020-11-17,Stanislaus,099,539301,20512,19466,1169,20635,425
2020-11-17,Sutter,101,95872,2803,2370,9,2379,12
2020-11-17,Tehama,103,63373,1481,1290,12,1302,7
2020-11-17,Trinity,105,12862,213,83,23,106,0
2020-11-17,Tulare,107,460477,20329,19176,990,20166,305
2020-11-17,Tuolumne,109,53932,840,568,6,574,7
2020-11-17,Ventura,111,848112,18410,16797,531,17328,173
2020-11-17,Yolo,113,214977,4315,3887,13,3900,70
2020-11-17,Yuba,115,75493,1715,1519,9,1528,10
2020-11-16,Alameda,001,1643700,27790,26063,275,26338,436
2020-11-16,Alpine,003,1148,37,12,0,12,0
2020-11-16,Amador,005,37829,455,414,1,415,16
2020-11-16,Butte,007,227075,3775,3490,144,3634,58
2020-11-16,Calaveras,009,45235,413,402,0,402,21
2020-11-16,Colusa,011,21464,654,601,1,602,6
2020-11-16,Contra Costa,013,1133247,22507,21386,123,21509,256
2020-11-16,Del Norte,015,27424,268,225,0,225,2
2020-11-16,El Dorado,017,186661,2064,1694,23,1717,4
2020-11-16,Fresno,019,978130,38759,34593,969,35562,471
2020-11-16,Glenn,021,27897,860,786,25,811,4
2020-11-16,Humboldt,023,135768,783,660,1,661,9
2020-11-16,Imperial,025,180216,14960,14111,31,14142,346
2020-11-16,Inyo,027,18085,283,263,5,268,15
2020-11-16,Kern,029,883053,38052,36049,817,36866,455
2020-11-16,Kings,031,150075,10207,9569,111,9680,85
2020-11-16,Lake,033,64148,862,784,0,784,18
2020-11-16,Lassen,035,31185,1299,1124,3,1127,0
2020-11-16,Los Angeles,037,10098052,356447,338778,4475,343253,7277
2020-11-16,Madera,039,155013,5835,5433,96,5529,54
2020-11-16,Marin,041,260295,7541,7359,24,7383,134
2020-11-16,Mariposa,043,17540,100,86,0,86,2
2020-11-16,Mendocino,045,87422,1321,1209,5,1214,23
2020-11-16,Merced,047,269075,10894,10399,83,10482,162
2020-11-16,Modoc,049,8938,86,71,17,88,0
2020-11-16,Mono,051,14174,477,453,9,462,2
2020-11-16,Monterey,053,433212,13913,13089,193,13282,107
2020-11-16,Napa,055,140530,2837,2536,17,2553,17
2020-11-16,Nevada,057,99092,1055,889,26,915,9
2020-11-16,Orange,059,3164182,70888,65396,2129,67525,1519
2020-11-16,Placer,061,380077,6063,5387,87,5474,63
2020-11-16,Plumas,063,18699,169,127,0,127,0
2020-11-16,Riverside,065,2383286,81341,76449,1172,77621,1379
2020-11-16,Sacramento,067,1510023,33193,30954,73,31027,534
2020-11-16,San Benito,069,59416,1696,1603,3,1606,15
2020-11-16,San Bernardino,071,2135413,83115,74401,929,75330,1186
2020-11-16,San Diego,073,3302833,71919,65603,2382,67985,926
2020-11-16,San Francisco,075,870044,14439,13847,80,13927,153
2020-11-16,San Joaquin,077,732212,24776,23515,393,23908,513
2020-11-16,San Luis Obispo,079,281455,5813,5161,86,5247,34
2020-11-16,San Mateo,081,765935,13367,12398,13,12411,169
2020-11-16,Santa Barbara,083,443738,10975,10565,167,10732,135
2020-11-16,Santa Clara,085,1922200,31428,28673,63,28736,419
2020-11-16,Santa Cruz,087,273765,3990,3520,40,3560,25
2020-11-16,Shasta,089,179085,4409,3284,103,3387,37
2020-11-16,Sierra,091,2930,15,11,0,11,0
2020-11-16,Siskiyou,093,43540,428,294,26,320,0
2020-11-16,Solano,095,438530,9424,8827,51,8878,84
2020-11-16,Sonoma,097,501317,11472,10961,39,11000,155
2020-11-16,Stanislaus,099,539301,20276,19333,1142,20475,425
2020-11-16,Sutter,101,95872,2697,2322,9,2331,12
2020-11-16,Tehama,103,63373,1435,1261,8,1269,7
2020-11-16,Trinity,105,12862,201,67,23,90,0
2020-11-16,Tulare,107,460477,20150,18891,936,19827,305
2020-11-16,Tuolumne,109,53932,804,543,6,549,7
2020-11-16,Ventura,111,848112,18072,16691,523,17214,172
2020-11-16,Yolo,113,214977,4220,3858,13,3871,70
2020-11-16,Yuba,115,75493,1679,1500,8,1508,10
2020-11-15,Alameda,001,1643700,27472,25879,269,26148,436
2020-11-15,Alpine,003,1148,35,12,0,12,0
2020-11-15,Amador,005,37829,443,409,1,410,16
2020-11-15,Butte,007,227075,3721,3452,135,3587,58
2020-11-15,Calaveras,009,45235,399,386,0,386,21
2020-11-15,Colusa,011,21464,645,601,1,602,6
2020-11-15,Contra Costa,013,1133247,22208,21179,122,21301,256
2020-11-15,Del Norte,015,27424,253,224,0,224,2
2020-11-15,El Dorado,017,186661,2002,1683,21,1704,4
2020-11-15,Fresno,019,978130,38246,34297,931,35228,471
2020-11-15,Glenn,021,27897,848,783,24,807,4
2020-11-15,Humboldt,023,135768,754,653,1,654,9
2020-11-15,Imperial,025,180216,14723,13940,31,13971,346
2020-11-15,Inyo,027,18085,273,263,5,268,15
2020-11-15,Kern,029,883053,37646,35911,782,36693,455
2020-11-15,Kings,031,150075,10014,9533,107,9640,85
2020-11-15,Lake,033,64148,853,777,0,777,17
2020-11-15,Lassen,035,31185,1252,1124,3,1127,0
2020-11-15,Los Angeles,037,10098052,351404,336035,4303,340338,7271
2020-11-15,Madera,039,155013,5738,5391,90,5481,54
2020-11-15,Marin,041,260295,7515,7347,24,7371,133
2020-11-15,Mariposa,043,17540,97,86,0,86,2
2020-11-15,Mendocino,045,87422,1302,1197,5,1202,22
2020-11-15,Merced,047,269075,10761,10350,83,10433,162
2020-11-15,Modoc,049,8938,85,68,17,85,0
2020-11-15,Mono,051,14174,475,453,9,462,2
2020-11-15,Monterey,053,433212,13717,12999,180,13179,107
2020-11-15,Napa,055,140530,2778,2509,15,2524,17
2020-11-15,Nevada,057,99092,1000,859,26,885,9
2020-11-15,Orange,059,3164182,69845,65008,2113,67121,1519
2020-11-15,Placer,061,380077,5908,5330,79,5409,63
2020-11-15,Plumas,063,18699,163,127,0,127,0
2020-11-15,Riverside,065,2383286,80018,75531,1113,76644,1374
2020-11-15,Sacramento,067,1510023,32567,30601,68,30669,534
2020-11-15,San Benito,069,59416,1671,1589,2,1591,15
2020-11-15,San Bernardino,071,2135413,80965,73769,854,74623,1185
2020-11-15,San Diego,073,3302833,70418,64770,2325,67095,926
2020-11-15,San Francisco,075,870044,14264,13757,79,13836,153
2020-11-15,San Joaquin,077,732212,24566,23516,377,23893,513
2020-11-15,San Luis Obispo,079,281455,5692,5120,84,5204,34
2020-11-15,San Mateo,081,765935,13190,12348,13,12361,169
2020-11-15,Santa Barbara,083,443738,10880,10516,165,10681,135
2020-11-15,Santa Clara,085,1922200,30974,28289,62,28351,418
2020-11-15,Santa Cruz,087,273765,3851,3439,39,3478,25
2020-11-15,Shasta,089,179085,4236,3290,94,3384,37
2020-11-15,Sierra,091,2930,15,11,0,11,0
2020-11-15,Siskiyou,093,43540,409,294,26,320,0
2020-11-15,Solano,095,438530,9263,8713,48,8761,84
2020-11-15,Sonoma,097,501317,11353,10833,38,10871,154
2020-11-15,Stanislaus,099,539301,20004,19228,1117,20345,425
2020-11-15,Sutter,101,95872,2607,2230,9,2239,12
2020-11-15,Tehama,103,63373,1384,1222,7,1229,7
2020-11-15,Trinity,105,12862,191,67,21,88,0
2020-11-15,Tulare,107,460477,19933,18891,883,19774,305
2020-11-15,Tuolumne,109,53932,762,486,6,492,7
2020-11-15,Ventura,111,848112,17798,16564,515,17079,172
2020-11-15,Yolo,113,214977,4117,3819,12,3831,67
2020-11-15,Yuba,115,75493,1638,1470,7,1477,10
2020-11-14,Alameda,001,1643700,27205,25714,267,25981,435
2020-11-14,Alpine,003,1148,35,12,0,12,0
2020-11-14,Amador,005,37829,434,404,0,404,16
2020-11-14,Butte,007,227075,3685,3434,121,3555,58
2020-11-14,Calaveras,009,45235,398,386,0,386,21
2020-11-14,Colusa,011,21464,633,601,1,602,6
2020-11-14,Contra Costa,013,1133247,22069,20975,115,21090,256
2020-11-14,Del Norte,015,27424,247,219,0,219,2
2020-11-14,El Dorado,017,186661,1958,1648,21,1669,4
2020-11-14,Fresno,019,978130,37996,33969,894,34863,471
2020-11-14,Glenn,021,27897,839,772,21,793,3
2020-11-14,Humboldt,023,135768,739,643,1,644,9
2020-11-14,Imperial,025,180216,14630,13932,30,13962,346
2020-11-14,Inyo,027,18085,272,263,5,268,15
2020-11-14,Kern,029,883053,37437,35626,763,36389,454
2020-11-14,Kings,031,150075,9979,9490,104,9594,85
2020-11-14,Lake,033,64148,844,773,0,773,17
2020-11-14,Lassen,035,31185,1238,833,3,836,0
2020-11-14,Los Angeles,037,10098052,348697,333021,4194,337215,7269
2020-11-14,Madera,039,155013,5708,5371,88,5459,54
2020-11-14,Marin,041,260295,7499,7325,24,7349,133
2020-11-14,Mariposa,043,17540,96,86,0,86,2
2020-11-14,Mendocino,045,87422,1286,1181,5,1186,22
2020-11-14,Merced,047,269075,10705,10286,81,10367,161
2020-11-14,Modoc,049,8938,84,64,16,80,0
2020-11-14,Mono,051,14174,475,453,9,462,2
2020-11-14,Monterey,053,433212,13621,12854,170,13024,105
2020-11-14,Napa,055,140530,2744,2473,15,2488,17
2020-11-14,Nevada,057,99092,984,835,26,861,9
2020-11-14,Orange,059,3164182,69224,64340,2102,66442,1517
2020-11-14,Placer,061,380077,5832,5215,73,5288,63
2020-11-14,Plumas,063,18699,158,128,0,128,0
2020-11-14,Riverside,065,2383286,79278,74910,1074,75984,1373
2020-11-14,Sacramento,067,1510023,32241,30298,68,30366,532
2020-11-14,San Benito,069,59416,1656,1573,2,1575,15
2020-11-14,San Bernardino,071,2135413,80031,72868,822,73690,1184
2020-11-14,San Diego,073,3302833,69653,63715,2273,65988,926
2020-11-14,San Francisco,075,870044,14176,13661,78,13739,153
2020-11-14,San Joaquin,077,732212,24475,23516,369,23885,511
2020-11-14,San Luis Obispo,079,281455,5629,5073,79,5152,34
2020-11-14,San Mateo,081,765935,13082,12293,13,12306,169
2020-11-14,Santa Barbara,083,443738,10826,10482,163,10645,135
2020-11-14,Santa Clara,085,1922200,30689,27962,60,28022,416
2020-11-14,Santa Cruz,087,273765,3796,3402,39,3441,25
2020-11-14,Shasta,089,179085,4155,3195,92,3287,37
2020-11-14,Sierra,091,2930,15,11,0,11,0
2020-11-14,Siskiyou,093,43540,396,292,26,318,0
2020-11-14,Solano,095,438530,9183,8655,47,8702,84
2020-11-14,Sonoma,097,501317,11300,10769,38,10807,154
2020-11-14,Stanislaus,099,539301,19861,19068,1095,20163,424
2020-11-14,Sutter,101,95872,2562,2182,9,2191,12
2020-11-14,Tehama,103,63373,1363,1206,6,1212,7
2020-11-14,Trinity,105,12862,186,67,21,88,0
2020-11-14,Tulare,107,460477,19838,18853,855,19708,305
2020-11-14,Tuolumne,109,53932,734,448,6,454,7
2020-11-14,Ventura,111,848112,17652,16297,504,16801,172
2020-11-14,Yolo,113,214977,4074,3765,10,3775,65
2020-11-14,Yuba,115,75493,1609,1453,7,1460,10
2020-11-13,Alameda,001,1643700,26989,25515,262,25777,434
2020-11-13,Alpine,003,1148,35,12,0,12,0
2020-11-13,Amador,005,37829,431,397,0,397,16
2020-11-13,Butte,007,227075,3661,3402,112,3514,58
2020-11-13,Calaveras,009,45235,394,378,0,378,21
2020-11-13,Colusa,011,21464,625,598,1,599,6
2020-11-13,Contra Costa,013,1133247,21896,20799,115,20914,256
2020-11-13,Del Norte,015,27424,244,208,0,208,2
2020-11-13,El Dorado,017,186661,1913,1611,20,1631,4
2020-11-13,Fresno,019,978130,37750,33693,880,34573,470
2020-11-13,Glenn,021,27897,825,755,17,772,3
2020-11-13,Humboldt,023,135768,724,638,1,639,9
2020-11-13,Imperial,025,180216,14560,13790,29,13819,341
2020-11-13,Inyo,027,18085,271,262,5,267,15
2020-11-13,Kern,029,883053,37235,35431,746,36177,453
2020-11-13,Kings,031,150075,9920,9428,103,9531,85
2020-11-13,Lake,033,64148,838,770,0,770,17
2020-11-13,Lassen,035,31185,1229,832,3,835,0
2020-11-13,Los Angeles,037,10098052,345569,329364,4089,333453,7248
2020-11-13,Madera,039,155013,5668,5340,87,5427,54
2020-11-13,Marin,041,260295,7486,7307,23,7330,133
2020-11-13,Mariposa,043,17540,94,86,0,86,2
2020-11-13,Mendocino,045,87422,1274,1173,5,1178,22
2020-11-13,Merced,047,269075,10649,10185,78,10263,159
2020-11-13,Modoc,049,8938,84,63,14,77,0
2020-11-13,Mono,051,14174,475,448,8,456,2
2020-11-13,Monterey,053,433212,13426,12681,158,12839,104
2020-11-13,Napa,055,140530,2705,2440,15,2455,17
2020-11-13,Nevada,057,99092,965,798,26,824,9
2020-11-13,Orange,059,3164182,68626,63804,2082,65886,1514
2020-11-13,Placer,061,380077,5727,5122,67,5189,63
2020-11-13,Plumas,063,18699,152,125,0,125,0
2020-11-13,Riverside,065,2383286,78540,74138,1045,75183,1372
2020-11-13,Sacramento,067,1510023,31923,29787,63,29850,524
2020-11-13,San Benito,069,59416,1644,1553,1,1554,15
2020-11-13,San Bernardino,071,2135413,78982,71895,801,72696,1184
2020-11-13,San Diego,073,3302833,68806,62978,2235,65213,921
2020-11-13,San Francisco,075,870044,14083,13516,76,13592,146
2020-11-13,San Joaquin,077,732212,24380,23314,363,23677,510
2020-11-13,San Luis Obispo,079,281455,5562,4960,76,5036,34
2020-11-13,San Mateo,081,765935,12988,12182,13,12195,169
2020-11-13,Santa Barbara,083,443738,10774,10405,161,10566,134
2020-11-13,Santa Clara,085,1922200,30361,27609,58,27667,415
2020-11-13,Santa Cruz,087,273765,3722,3343,39,3382,25
2020-11-13,Shasta,089,179085,4071,2983,88,3071,37
2020-11-13,Sierra,091,2930,15,11,0,11,0
2020-11-13,Siskiyou,093,43540,391,280,25,305,0
2020-11-13,Solano,095,438530,9092,8525,47,8572,84
2020-11-13,Sonoma,097,501317,11239,10685,36,10721,151
2020-11-13,Stanislaus,099,539301,19736,18936,1067,20003,422
2020-11-13,Sutter,101,95872,2516,2121,8,2129,12
2020-11-13,Tehama,103,63373,1336,1167,6,1173,7
2020-11-13,Trinity,105,12862,184,64,21,85,0
2020-11-13,Tulare,107,460477,19714,18714,814,19528,305
2020-11-13,Tuolumne,109,53932,701,427,6,433,7
2020-11-13,Ventura,111,848112,17506,16172,490,16662,171
2020-11-13,Yolo,113,214977,4023,3716,10,3726,65
2020-11-13,Yuba,115,75493,1582,1435,7,1442,10
2020-11-12,Alameda,001,1643700,26722,25345,262,25607,432
2020-11-12,Alpine,003,1148,34,12,0,12,0
2020-11-12,Amador,005,37829,430,392,0,392,16
2020-11-12,Butte,007,227075,3612,3347,109,3456,58
2020-11-12,Calaveras,009,45235,389,373,0,373,21
2020-11-12,Colusa,011,21464,620,591,1,592,6
2020-11-12,Contra Costa,013,1133247,21689,20619,113,20732,255
2020-11-12,Del Norte,015,27424,237,203,0,203,2
2020-11-12,El Dorado,017,186661,1867,1573,16,1589,4
2020-11-12,Fresno,019,978130,37401,33459,838,34297,468
2020-11-12,Glenn,021,27897,806,727,17,744,3
2020-11-12,Humboldt,023,135768,711,625,1,626,9
2020-11-12,Imperial,025,180216,14395,13619,29,13648,341
2020-11-12,Inyo,027,18085,270,255,5,260,15
2020-11-12,Kern,029,883053,36971,35207,731,35938,451
2020-11-12,Kings,031,150075,9853,9335,102,9437,85
2020-11-12,Lake,033,64148,829,764,0,764,17
2020-11-12,Lassen,035,31185,1160,832,2,834,0
2020-11-12,Los Angeles,037,10098052,341828,327001,3988,330989,7223
2020-11-12,Madera,039,155013,5633,5273,82,5355,54
2020-11-12,Marin,041,260295,7457,7268,23,7291,133
2020-11-12,Mariposa,043,17540,92,84,0,84,2
2020-11-12,Mendocino,045,87422,1255,1142,5,1147,22
2020-11-12,Merced,047,269075,10535,10107,75,10182,158
2020-11-12,Modoc,049,8938,84,63,14,77,0
2020-11-12,Mono,051,14174,474,442,8,450,2
2020-11-12,Monterey,053,433212,13305,12489,144,12633,100
2020-11-12,Napa,055,140530,2643,2398,15,2413,16
2020-11-12,Nevada,057,99092,942,780,25,805,9
2020-11-12,Orange,059,3164182,67881,63232,2063,65295,1514
2020-11-12,Placer,061,380077,5617,5044,58,5102,62
2020-11-12,Plumas,063,18699,148,121,0,121,0
2020-11-12,Riverside,065,2383286,77609,73381,1002,74383,1362
2020-11-12,Sacramento,067,1510023,31432,29459,55,29514,520
2020-11-12,San Benito,069,59416,1624,1525,1,1526,15
2020-11-12,San Bernardino,071,2135413,77616,70758,762,71520,1183
2020-11-12,San Diego,073,3302833,67826,62336,2184,64520,918
2020-11-12,San Francisco,075,870044,13984,13289,75,13364,146
2020-11-12,San Joaquin,077,732212,24187,23002,342,23344,509
2020-11-12,San Luis Obispo,079,281455,5498,4898,75,4973,33
2020-11-12,San Mateo,081,765935,12863,12086,12,12098,169
2020-11-12,Santa Barbara,083,443738,10712,10325,156,10481,134
2020-11-12,Santa Clara,085,1922200,29985,27261,57,27318,414
2020-11-12,Santa Cruz,087,273765,3639,3317,37,3354,25
2020-11-12,Shasta,089,179085,3934,2825,77,2902,37
2020-11-12,Sierra,091,2930,15,11,0,11,0
2020-11-12,Siskiyou,093,43540,374,275,20,295,0
2020-11-12,Solano,095,438530,8992,8417,46,8463,85
2020-11-12,Sonoma,097,501317,11137,10602,35,10637,151
2020-11-12,Stanislaus,099,539301,19567,18787,1038,19825,422
2020-11-12,Sutter,101,95872,2433,2075,7,2082,12
2020-11-12,Tehama,103,63373,1309,1117,6,1123,7
2020-11-12,Trinity,105,12862,176,62,20,82,0
2020-11-12,Tulare,107,460477,19602,18545,776,19321,305
2020-11-12,Tuolumne,109,53932,662,353,6,359,7
2020-11-12,Ventura,111,848112,17256,16013,484,16497,158
2020-11-12,Yolo,113,214977,3979,3646,10,3656,63
2020-11-12,Yuba,115,75493,1547,1410,7,1417,10
2020-11-11,Alameda,001,1643700,26479,25140,260,25400,429
2020-11-11,Alpine,003,1148,29,12,0,12,0
2020-11-11,Amador,005,37829,423,389,0,389,16
2020-11-11,Butte,007,227075,3586,3348,96,3444,58
2020-11-11,Calaveras,009,45235,379,373,0,373,21
2020-11-11,Colusa,011,21464,614,591,1,592,6
2020-11-11,Contra Costa,013,1133247,21471,20452,111,20563,255
2020-11-11,Del Norte,015,27424,230,203,0,203,2
2020-11-11,El Dorado,017,186661,1821,1564,15,1579,4
2020-11-11,Fresno,019,978130,37082,33287,803,34090,468
2020-11-11,Glenn,021,27897,790,722,16,738,3
2020-11-11,Humboldt,023,135768,697,623,1,624,9
2020-11-11,Imperial,025,180216,14225,13623,27,13650,340
2020-11-11,Inyo,027,18085,268,255,5,260,15
2020-11-11,Kern,029,883053,36696,35014,714,35728,449
2020-11-11,Kings,031,150075,9747,9263,99,9362,85
2020-11-11,Lake,033,64148,819,763,0,763,17
2020-11-11,Lassen,035,31185,1135,831,2,833,0
2020-11-11,Los Angeles,037,10098052,338463,324567,3905,328472,7220
2020-11-11,Madera,039,155013,5598,5248,80,5328,54
2020-11-11,Marin,041,260295,7434,7268,23,7291,133
2020-11-11,Mariposa,043,17540,92,84,0,84,2
2020-11-11,Mendocino,045,87422,1243,1142,5,1147,22
2020-11-11,Merced,047,269075,10464,10074,73,10147,157
2020-11-11,Modoc,049,8938,80,62,13,75,0
2020-11-11,Mono,051,14174,472,443,8,451,2
2020-11-11,Monterey,053,433212,13161,12417,140,12557,100
2020-11-11,Napa,055,140530,2594,2365,12,2377,15
2020-11-11,Nevada,057,99092,900,741,25,766,9
2020-11-11,Orange,059,3164182,67241,62929,2039,64968,1506
2020-11-11,Placer,061,380077,5533,4981,50,5031,60
2020-11-11,Plumas,063,18699,146,111,0,111,0
2020-11-11,Riverside,065,2383286,76706,72953,956,73909,1361
2020-11-11,Sacramento,067,1510023,30975,28968,53,29021,520
2020-11-11,San Benito,069,59416,1610,1512,1,1513,15
2020-11-11,San Bernardino,071,2135413,76329,70374,735,71109,1182
2020-11-11,San Diego,073,3302833,66891,61746,2123,63869,918
2020-11-11,San Francisco,075,870044,13876,13287,74,13361,146
2020-11-11,San Joaquin,077,732212,24027,23001,336,23337,509
2020-11-11,San Luis Obispo,079,281455,5423,4832,72,4904,33
2020-11-11,San Mateo,081,765935,12749,12008,12,12020,169
2020-11-11,Santa Barbara,083,443738,10646,10278,156,10434,134
2020-11-11,Santa Clara,085,1922200,29633,27075,56,27131,413
2020-11-11,Santa Cruz,087,273765,3571,3247,37,3284,25
2020-11-11,Shasta,089,179085,3810,2766,67,2833,36
2020-11-11,Sierra,091,2930,13,11,0,11,0
2020-11-11,Siskiyou,093,43540,343,261,17,278,0
2020-11-11,Solano,095,438530,8874,8353,44,8397,85
2020-11-11,Sonoma,097,501317,11063,10498,35,10533,150
2020-11-11,Stanislaus,099,539301,19430,18671,1008,19679,422
2020-11-11,Sutter,101,95872,2385,2049,6,2055,12
2020-11-11,Tehama,103,63373,1267,1105,5,1110,7
2020-11-11,Trinity,105,12862,165,62,20,82,0
2020-11-11,Tulare,107,460477,19471,18500,745,19245,305
2020-11-11,Tuolumne,109,53932,606,354,5,359,7
2020-11-11,Ventura,111,848112,17041,15801,471,16272,158
2020-11-11,Yolo,113,214977,3928,3606,10,3616,63
2020-11-11,Yuba,115,75493,1532,1400,7,1407,10
2020-11-10,Alameda,001,1643700,26249,25008,257,25265,424
2020-11-10,Alpine,003,1148,29,9,0,9,0
2020-11-10,Amador,005,37829,417,384,0,384,16
2020-11-10,Butte,007,227075,3550,3327,92,3419,58
2020-11-10,Calaveras,009,45235,374,367,0,367,21
2020-11-10,Colusa,011,21464,606,590,1,591,6
2020-11-10,Contra Costa,013,1133247,21264,20326,109,20435,255
2020-11-10,Del Norte,015,27424,224,196,0,196,2
2020-11-10,El Dorado,017,186661,1760,1551,15,1566,4
2020-11-10,Fresno,019,978130,36812,33024,765,33789,465
2020-11-10,Glenn,021,27897,782,719,12,731,3
2020-11-10,Humboldt,023,135768,680,610,1,611,9
2020-11-10,Imperial,025,180216,14095,13570,27,13597,338
2020-11-10,Inyo,027,18085,267,252,5,257,14
2020-11-10,Kern,029,883053,36420,34858,695,35553,448
2020-11-10,Kings,031,150075,9700,9236,92,9328,85
2020-11-10,Lake,033,64148,809,762,0,762,16
2020-11-10,Lassen,035,31185,1120,830,2,832,0
2020-11-10,Los Angeles,037,10098052,335212,322569,3791,326360,7205
2020-11-10,Madera,039,155013,5556,5229,74,5303,54
2020-11-10,Marin,041,260295,7415,7259,23,7282,133
2020-11-10,Mariposa,043,17540,90,84,0,84,2
2020-11-10,Mendocino,045,87422,1235,1137,5,1142,22
2020-11-10,Merced,047,269075,10402,9992,67,10059,157
2020-11-10,Modoc,049,8938,78,61,13,74,0
2020-11-10,Mono,051,14174,470,443,8,451,2
2020-11-10,Monterey,053,433212,13026,12335,132,12467,100
2020-11-10,Napa,055,140530,2556,2341,10,2351,15
2020-11-10,Nevada,057,99092,884,734,25,759,9
2020-11-10,Orange,059,3164182,66691,62597,2029,64626,1504
2020-11-10,Placer,061,380077,5453,4902,49,4951,60
2020-11-10,Plumas,063,18699,142,108,0,108,0
2020-11-10,Riverside,065,2383286,76064,72316,929,73245,1359
2020-11-10,Sacramento,067,1510023,30568,28677,50,28727,519
2020-11-10,San Benito,069,59416,1595,1508,1,1509,15
2020-11-10,San Bernardino,071,2135413,75158,69666,702,70368,1182
2020-11-10,San Diego,073,3302833,66000,61085,2086,63171,915
2020-11-10,San Francisco,075,870044,13759,13210,74,13284,146
2020-11-10,San Joaquin,077,732212,23862,22865,329,23194,508
2020-11-10,San Luis Obispo,079,281455,5360,4780,69,4849,33
2020-11-10,San Mateo,081,765935,12648,11939,12,11951,169
2020-11-10,Santa Barbara,083,443738,10579,10252,152,10404,134
2020-11-10,Santa Clara,085,1922200,29288,26917,55,26972,409
2020-11-10,Santa Cruz,087,273765,3508,3221,37,3258,25
2020-11-10,Shasta,089,179085,3667,2686,59,2745,36
2020-11-10,Sierra,091,2930,12,10,0,10,0
2020-11-10,Siskiyou,093,43540,326,263,16,279,0
2020-11-10,Solano,095,438530,8776,8299,44,8343,85
2020-11-10,Sonoma,097,501317,10976,10414,35,10449,150
2020-11-10,Stanislaus,099,539301,19296,18592,984,19576,420
2020-11-10,Sutter,101,95872,2290,2035,5,2040,12
2020-11-10,Tehama,103,63373,1243,1099,4,1103,7
2020-11-10,Trinity,105,12862,156,62,18,80,0
2020-11-10,Tulare,107,460477,19356,18430,721,19151,305
2020-11-10,Tuolumne,109,53932,557,353,5,358,7
2020-11-10,Ventura,111,848112,16858,15625,469,16094,158
2020-11-10,Yolo,113,214977,3867,3573,10,3583,63
2020-11-10,Yuba,115,75493,1509,1392,7,1399,10
2020-11-09,Alameda,001,1643700,26003,24899,253,25152,424
2020-11-09,Alpine,003,1148,27,6,0,6,0
2020-11-09,Amador,005,37829,408,380,0,380,16
2020-11-09,Butte,007,227075,3505,3301,83,3384,57
2020-11-09,Calaveras,009,45235,370,360,0,360,21
2020-11-09,Colusa,011,21464,600,583,1,584,6
2020-11-09,Contra Costa,013,1133247,21091,20193,107,20300,255
2020-11-09,Del Norte,015,27424,218,195,0,195,2
2020-11-09,El Dorado,017,186661,1719,1515,15,1530,4
2020-11-09,Fresno,019,978130,36501,32755,725,33480,465
2020-11-09,Glenn,021,27897,776,714,9,723,3
2020-11-09,Humboldt,023,135768,667,607,1,608,9
2020-11-09,Imperial,025,180216,13978,13508,26,13534,338
2020-11-09,Inyo,027,18085,267,252,5,257,14
2020-11-09,Kern,029,883053,36189,34764,659,35423,448
2020-11-09,Kings,031,150075,9630,9141,90,9231,84
2020-11-09,Lake,033,64148,800,755,0,755,16
2020-11-09,Lassen,035,31185,1024,799,2,801,0
2020-11-09,Los Angeles,037,10098052,332115,320370,3716,324086,7180
2020-11-09,Madera,039,155013,5510,5209,71,5280,54
2020-11-09,Marin,041,260295,7389,7237,22,7259,131
2020-11-09,Mariposa,043,17540,90,84,0,84,2
2020-11-09,Mendocino,045,87422,1223,1132,5,1137,22
2020-11-09,Merced,047,269075,10299,9922,64,9986,157
2020-11-09,Modoc,049,8938,74,54,12,66,0
2020-11-09,Mono,051,14174,467,352,8,360,2
2020-11-09,Monterey,053,433212,12879,12148,124,12272,98
2020-11-09,Napa,055,140530,2513,2309,10,2319,15
2020-11-09,Nevada,057,99092,847,729,24,753,9
2020-11-09,Orange,059,3164182,66050,62335,2016,64351,1501
2020-11-09,Placer,061,380077,5368,4843,37,4880,60
2020-11-09,Plumas,063,18699,135,102,0,102,0
2020-11-09,Riverside,065,2383286,75281,72059,895,72954,1346
2020-11-09,Sacramento,067,1510023,30096,28200,49,28249,516
2020-11-09,San Benito,069,59416,1586,1506,1,1507,15
2020-11-09,San Bernardino,071,2135413,74103,69015,660,69675,1182
2020-11-09,San Diego,073,3302833,65145,60572,2046,62618,908
2020-11-09,San Francisco,075,870044,13639,12984,71,13055,146
2020-11-09,San Joaquin,077,732212,23697,22512,324,22836,505
2020-11-09,San Luis Obispo,079,281455,5273,4746,67,4813,32
2020-11-09,San Mateo,081,765935,12541,11857,12,11869,169
2020-11-09,Santa Barbara,083,443738,10522,10214,146,10360,134
2020-11-09,Santa Clara,085,1922200,28893,26693,55,26748,409
2020-11-09,Santa Cruz,087,273765,3450,3194,37,3231,25
2020-11-09,Shasta,089,179085,3513,2581,50,2631,36
2020-11-09,Sierra,091,2930,10,10,0,10,0
2020-11-09,Siskiyou,093,43540,315,257,14,271,0
2020-11-09,Solano,095,438530,8660,8254,43,8297,85
2020-11-09,Sonoma,097,501317,10868,10310,35,10345,150
2020-11-09,Stanislaus,099,539301,19142,18482,967,19449,418
2020-11-09,Sutter,101,95872,2223,2010,4,2014,12
2020-11-09,Tehama,103,63373,1206,1071,3,1074,7
2020-11-09,Trinity,105,12862,149,46,18,64,0
2020-11-09,Tulare,107,460477,19236,18272,689,18961,304
2020-11-09,Tuolumne,109,53932,502,346,4,350,7
2020-11-09,Ventura,111,848112,16656,15568,466,16034,156
2020-11-09,Yolo,113,214977,3806,3522,10,3532,62
2020-11-09,Yuba,115,75493,1476,1380,7,1387,10
2020-11-08,Alameda,001,1643700,25773,24731,253,24984,424
2020-11-08,Alpine,003,1148,24,6,0,6,0
2020-11-08,Amador,005,37829,401,376,0,376,16
2020-11-08,Butte,007,227075,3467,3285,76,3361,57
2020-11-08,Calaveras,009,45235,368,360,0,360,21
2020-11-08,Colusa,011,21464,597,583,1,584,6
2020-11-08,Contra Costa,013,1133247,20921,20031,105,20136,254
2020-11-08,Del Norte,015,27424,210,195,0,195,2
2020-11-08,El Dorado,017,186661,1681,1502,15,1517,4
2020-11-08,Fresno,019,978130,36166,32619,687,33306,465
2020-11-08,Glenn,021,27897,770,707,8,715,3
2020-11-08,Humboldt,023,135768,651,605,1,606,9
2020-11-08,Imperial,025,180216,13862,13428,26,13454,338
2020-11-08,Inyo,027,18085,263,252,5,257,14
2020-11-08,Kern,029,883053,35970,34644,641,35285,448
2020-11-08,Kings,031,150075,9497,9026,87,9113,84
2020-11-08,Lake,033,64148,792,754,0,754,16
2020-11-08,Lassen,035,31185,876,799,2,801,0
2020-11-08,Los Angeles,037,10098052,328988,318960,3650,322610,7176
2020-11-08,Madera,039,155013,5441,5196,68,5264,54
2020-11-08,Marin,041,260295,7369,7227,22,7249,131
2020-11-08,Mariposa,043,17540,90,83,0,83,2
2020-11-08,Mendocino,045,87422,1214,1129,5,1134,22
2020-11-08,Merced,047,269075,10224,9885,62,9947,157
2020-11-08,Modoc,049,8938,70,54,12,66,0
2020-11-08,Mono,051,14174,461,352,8,360,2
2020-11-08,Monterey,053,433212,12734,12122,113,12235,98
2020-11-08,Napa,055,140530,2474,2274,10,2284,15
2020-11-08,Nevada,057,99092,831,715,24,739,9
2020-11-08,Orange,059,3164182,65461,62034,2002,64036,1501
2020-11-08,Placer,061,380077,5265,4800,32,4832,60
2020-11-08,Plumas,063,18699,130,102,0,102,0
2020-11-08,Riverside,065,2383286,74626,71442,853,72295,1345
2020-11-08,Sacramento,067,1510023,29536,28059,46,28105,515
2020-11-08,San Benito,069,59416,1571,1496,1,1497,15
2020-11-08,San Bernardino,071,2135413,72850,68412,621,69033,1182
2020-11-08,San Diego,073,3302833,64300,60199,2002,62201,908
2020-11-08,San Francisco,075,870044,13508,12985,66,13051,146
2020-11-08,San Joaquin,077,732212,23503,22514,320,22834,505
2020-11-08,San Luis Obispo,079,281455,5207,4698,62,4760,32
2020-11-08,San Mateo,081,765935,12423,11783,12,11795,169
2020-11-08,Santa Barbara,083,443738,10452,10180,144,10324,134
2020-11-08,Santa Clara,085,1922200,28519,26442,54,26496,410
2020-11-08,Santa Cruz,087,273765,3393,3134,37,3171,25
2020-11-08,Shasta,089,179085,3377,2582,44,2626,36
2020-11-08,Sierra,091,2930,10,7,0,7,0
2020-11-08,Siskiyou,093,43540,303,246,13,259,0
2020-11-08,Solano,095,438530,8539,8132,42,8174,85
2020-11-08,Sonoma,097,501317,10761,10229,35,10264,149
2020-11-08,Stanislaus,099,539301,18967,18413,946,19359,418
2020-11-08,Sutter,101,95872,2165,1980,4,1984,12
2020-11-08,Tehama,103,63373,1181,1054,3,1057,7
2020-11-08,Trinity,105,12862,146,46,17,63,0
2020-11-08,Tulare,107,460477,19093,18272,660,18932,304
2020-11-08,Tuolumne,109,53932,475,341,4,345,7
2020-11-08,Ventura,111,848112,16461,15504,458,15962,156
2020-11-08,Yolo,113,214977,3745,3492,10,3502,61
2020-11-08,Yuba,115,75493,1455,1369,7,1376,10
2020-11-07,Alameda,001,1643700,25663,24578,251,24829,424
2020-11-07,Alpine,003,1148,24,6,0,6,0
2020-11-07,Amador,005,37829,398,375,0,375,16
2020-11-07,Butte,007,227075,3455,3277,71,3348,57
2020-11-07,Calaveras,009,45235,366,360,0,360,21
2020-11-07,Colusa,011,21464,597,583,1,584,6
2020-11-07,Contra Costa,013,1133247,20820,19943,104,20047,254
2020-11-07,Del Norte,015,27424,206,194,0,194,2
2020-11-07,El Dorado,017,186661,1656,1495,14,1509,4
2020-11-07,Fresno,019,978130,36012,32497,664,33161,465
2020-11-07,Glenn,021,27897,762,707,8,715,3
2020-11-07,Humboldt,023,135768,640,590,1,591,9
2020-11-07,Imperial,025,180216,13804,13388,25,13413,338
2020-11-07,Inyo,027,18085,261,252,5,257,14
2020-11-07,Kern,029,883053,35815,34513,631,35144,448
2020-11-07,Kings,031,150075,9464,9005,81,9086,84
2020-11-07,Lake,033,64148,788,751,0,751,16
2020-11-07,Lassen,035,31185,860,799,2,801,0
2020-11-07,Los Angeles,037,10098052,327479,316756,3583,320339,7174
2020-11-07,Madera,039,155013,5419,5177,66,5243,54
2020-11-07,Marin,041,260295,7358,7215,22,7237,131
2020-11-07,Mariposa,043,17540,90,81,0,81,2
2020-11-07,Mendocino,045,87422,1203,1118,5,1123,22
2020-11-07,Merced,047,269075,10192,9855,58,9913,157
2020-11-07,Modoc,049,8938,70,51,12,63,0
2020-11-07,Mono,051,14174,458,352,8,360,2
2020-11-07,Monterey,053,433212,12664,12030,109,12139,98
2020-11-07,Napa,055,140530,2444,2260,9,2269,15
2020-11-07,Nevada,057,99092,814,710,24,734,9
2020-11-07,Orange,059,3164182,65174,62038,1996,64034,1505
2020-11-07,Placer,061,380077,5202,4745,32,4777,60
2020-11-07,Plumas,063,18699,127,94,0,94,0
2020-11-07,Riverside,065,2383286,74231,71153,826,71979,1345
2020-11-07,Sacramento,067,1510023,29286,27773,46,27819,515
2020-11-07,San Benito,069,59416,1559,1489,1,1490,15
2020-11-07,San Bernardino,071,2135413,72334,67935,610,68545,1182
2020-11-07,San Diego,073,3302833,63788,59682,1970,61652,909
2020-11-07,San Francisco,075,870044,13447,12980,65,13045,146
2020-11-07,San Joaquin,077,732212,23395,22517,314,22831,505
2020-11-07,San Luis Obispo,079,281455,5158,4668,59,4727,32
2020-11-07,San Mateo,081,765935,12360,11711,12,11723,169
2020-11-07,Santa Barbara,083,443738,10410,10157,142,10299,134
2020-11-07,Santa Clara,085,1922200,28315,26244,53,26297,410
2020-11-07,Santa Cruz,087,273765,3355,3130,37,3167,25
2020-11-07,Shasta,089,179085,3310,2547,42,2589,36
2020-11-07,Sierra,091,2930,10,7,0,7,0
2020-11-07,Siskiyou,093,43540,299,241,13,254,0
2020-11-07,Solano,095,438530,8487,8066,42,8108,85
2020-11-07,Sonoma,097,501317,10715,10200,35,10235,149
2020-11-07,Stanislaus,099,539301,18858,18386,929,19315,418
2020-11-07,Sutter,101,95872,2125,1973,4,1977,12
2020-11-07,Tehama,103,63373,1157,1043,3,1046,7
2020-11-07,Trinity,105,12862,146,42,16,58,0
2020-11-07,Tulare,107,460477,19037,18229,643,18872,304
2020-11-07,Tuolumne,109,53932,464,327,4,331,7
2020-11-07,Ventura,111,848112,16401,15364,453,15817,156
2020-11-07,Yolo,113,214977,3714,3486,10,3496,61
2020-11-07,Yuba,115,75493,1440,1349,7,1356,10
2020-11-06,Alameda,001,1643700,25531,24389,249,24638,420
2020-11-06,Alpine,003,1148,24,6,0,6,0
2020-11-06,Amador,005,37829,396,369,0,369,16
2020-11-06,Butte,007,227075,3430,3254,63,3317,57
2020-11-06,Calaveras,009,45235,365,359,0,359,21
2020-11-06,Colusa,011,21464,595,580,1,581,6
2020-11-06,Contra Costa,013,1133247,20671,19744,104,19848,252
2020-11-06,Del Norte,015,27424,203,194,0,194,2
2020-11-06,El Dorado,017,186661,1630,1475,14,1489,4
2020-11-06,Fresno,019,978130,35824,32278,648,32926,460
2020-11-06,Glenn,021,27897,756,707,7,714,3
2020-11-06,Humboldt,023,135768,637,587,1,588,9
2020-11-06,Imperial,025,180216,13751,13230,25,13255,338
2020-11-06,Inyo,027,18085,259,246,5,251,14
2020-11-06,Kern,029,883053,35651,34360,613,34973,443
2020-11-06,Kings,031,150075,9440,8883,79,8962,83
2020-11-06,Lake,033,64148,787,741,0,741,16
2020-11-06,Lassen,035,31185,852,794,2,796,0
2020-11-06,Los Angeles,037,10098052,325505,314356,3531,317887,7160
2020-11-06,Madera,039,155013,5403,5136,65,5201,54
2020-11-06,Marin,041,260295,7337,7184,22,7206,131
2020-11-06,Mariposa,043,17540,89,79,0,79,2
2020-11-06,Mendocino,045,87422,1198,1113,5,1118,22
2020-11-06,Merced,047,269075,10152,9778,55,9833,157
2020-11-06,Modoc,049,8938,70,48,12,60,0
2020-11-06,Mono,051,14174,452,308,8,316,1
2020-11-06,Monterey,053,433212,12547,11914,108,12022,96
2020-11-06,Napa,055,140530,2419,2189,9,2198,15
2020-11-06,Nevada,057,99092,801,692,23,715,9
2020-11-06,Orange,059,3164182,64871,61049,1986,63035,1494
2020-11-06,Placer,061,380077,5129,4680,32,4712,60
2020-11-06,Plumas,063,18699,122,90,0,90,0
2020-11-06,Riverside,065,2383286,73782,70409,785,71194,1341
2020-11-06,Sacramento,067,1510023,28994,27489,44,27533,514
2020-11-06,San Benito,069,59416,1550,1479,1,1480,15
2020-11-06,San Bernardino,071,2135413,71735,66740,589,67329,1179
2020-11-06,San Diego,073,3302833,63264,59143,1938,61081,907
2020-11-06,San Francisco,075,870044,13377,12825,64,12889,146
2020-11-06,San Joaquin,077,732212,23310,22424,304,22728,502
2020-11-06,San Luis Obispo,079,281455,5093,4531,53,4584,32
2020-11-06,San Mateo,081,765935,12285,11587,12,11599,168
2020-11-06,Santa Barbara,083,443738,10374,10118,137,10255,133
2020-11-06,Santa Clara,085,1922200,28073,25831,53,25884,402
2020-11-06,Santa Cruz,087,273765,3318,3063,37,3100,25
2020-11-06,Shasta,089,179085,3237,2475,41,2516,35
2020-11-06,Sierra,091,2930,9,7,0,7,0
2020-11-06,Siskiyou,093,43540,286,237,12,249,0
2020-11-06,Solano,095,438530,8422,7959,42,8001,85
2020-11-06,Sonoma,097,501317,10665,10142,35,10177,149
2020-11-06,Stanislaus,099,539301,18771,18250,920,19170,417
2020-11-06,Sutter,101,95872,2098,1937,2,1939,12
2020-11-06,Tehama,103,63373,1136,1024,3,1027,6
2020-11-06,Trinity,105,12862,143,41,16,57,0
2020-11-06,Tulare,107,460477,18973,18136,618,18754,300
2020-11-06,Tuolumne,109,53932,443,316,4,320,5
2020-11-06,Ventura,111,848112,16315,15222,450,15672,154
2020-11-06,Yolo,113,214977,3685,3420,10,3430,62
2020-11-06,Yuba,115,75493,1427,1335,7,1342,10
2020-11-05,Alameda,001,1643700,25355,24270,249,24519,420
2020-11-05,Alpine,003,1148,24,6,0,6,0
2020-11-05,Amador,005,37829,393,363,0,363,16
2020-11-05,Butte,007,227075,3407,3239,57,3296,57
2020-11-05,Calaveras,009,45235,358,333,0,333,19
2020-11-05,Colusa,011,21464,591,574,1,575,6
2020-11-05,Contra Costa,013,1133247,20489,19656,102,19758,252
2020-11-05,Del Norte,015,27424,201,192,0,192,2
2020-11-05,El Dorado,017,186661,1606,1466,14,1480,4
2020-11-05,Fresno,019,978130,35581,32056,623,32679,460
2020-11-05,Glenn,021,27897,736,702,7,709,3
2020-11-05,Humboldt,023,135768,627,581,1,582,9
2020-11-05,Imperial,025,180216,13659,13178,24,13202,337
2020-11-05,Inyo,027,18085,259,247,5,252,14
2020-11-05,Kern,029,883053,35450,34232,599,34831,443
2020-11-05,Kings,031,150075,9285,8846,76,8922,83
2020-11-05,Lake,033,64148,783,739,0,739,16
2020-11-05,Lassen,035,31185,821,782,2,784,0
2020-11-05,Los Angeles,037,10098052,323149,312381,3478,315859,7146
2020-11-05,Madera,039,155013,5364,5129,62,5191,54
2020-11-05,Marin,041,260295,7315,7171,22,7193,131
2020-11-05,Mariposa,043,17540,88,79,0,79,2
2020-11-05,Mendocino,045,87422,1186,1112,5,1117,22
2020-11-05,Merced,047,269075,10093,9753,50,9803,155
2020-11-05,Modoc,049,8938,69,47,11,58,0
2020-11-05,Mono,051,14174,450,307,8,315,1
2020-11-05,Monterey,053,433212,12437,11784,104,11888,96
2020-11-05,Napa,055,140530,2392,2158,9,2167,15
2020-11-05,Nevada,057,99092,779,687,22,709,9
2020-11-05,Orange,059,3164182,64424,60740,1976,62716,1484
2020-11-05,Placer,061,380077,5060,4627,27,4654,60
2020-11-05,Plumas,063,18699,114,90,0,90,0
2020-11-05,Riverside,065,2383286,73071,70094,727,70821,1338
2020-11-05,Sacramento,067,1510023,28613,27232,43,27275,512
2020-11-05,San Benito,069,59416,1535,1477,1,1478,15
2020-11-05,San Bernardino,071,2135413,70907,66407,576,66983,1174
2020-11-05,San Diego,073,3302833,62638,58659,1912,60571,904
2020-11-05,San Francisco,075,870044,13265,12726,63,12789,146
2020-11-05,San Joaquin,077,732212,23146,22318,300,22618,502
2020-11-05,San Luis Obispo,079,281455,5026,4459,51,4510,32
2020-11-05,San Mateo,081,765935,12191,11535,12,11547,168
2020-11-05,Santa Barbara,083,443738,10330,10080,134,10214,133
2020-11-05,Santa Clara,085,1922200,27806,25651,53,25704,402
2020-11-05,Santa Cruz,087,273765,3280,3023,37,3060,25
2020-11-05,Shasta,089,179085,3147,2401,40,2441,34
2020-11-05,Sierra,091,2930,9,6,0,6,0
2020-11-05,Siskiyou,093,43540,275,228,12,240,0
2020-11-05,Solano,095,438530,8339,7842,42,7884,85
2020-11-05,Sonoma,097,501317,10553,10064,34,10098,145
2020-11-05,Stanislaus,099,539301,18658,18194,907,19101,417
2020-11-05,Sutter,101,95872,2066,1925,2,1927,12
2020-11-05,Tehama,103,63373,1114,1015,2,1017,6
2020-11-05,Trinity,105,12862,127,41,15,56,0
2020-11-05,Tulare,107,460477,18884,18049,592,18641,301
2020-11-05,Tuolumne,109,53932,414,312,4,316,5
2020-11-05,Ventura,111,848112,16149,15113,439,15552,155
2020-11-05,Yolo,113,214977,3635,3391,10,3401,61
2020-11-05,Yuba,115,75493,1409,1322,7,1329,10
2020-11-04,Alameda,001,1643700,25178,24172,247,24419,418
2020-11-04,Alpine,003,1148,20,5,0,5,0
2020-11-04,Amador,005,37829,390,362,0,362,16
2020-11-04,Butte,007,227075,3381,3218,54,3272,57
2020-11-04,Calaveras,009,45235,355,290,0,290,19
2020-11-04,Colusa,011,21464,589,571,1,572,6
2020-11-04,Contra Costa,013,1133247,20322,19472,99,19571,251
2020-11-04,Del Norte,015,27424,197,188,0,188,2
2020-11-04,El Dorado,017,186661,1591,1448,11,1459,4
2020-11-04,Fresno,019,978130,35349,31952,595,32547,457
2020-11-04,Glenn,021,27897,732,701,6,707,3
2020-11-04,Humboldt,023,135768,618,571,1,572,9
2020-11-04,Imperial,025,180216,13561,13087,24,13111,335
2020-11-04,Inyo,027,18085,258,247,5,252,14
2020-11-04,Kern,029,883053,35295,34027,588,34615,439
2020-11-04,Kings,031,150075,9251,8817,74,8891,83
2020-11-04,Lake,033,64148,776,735,0,735,16
2020-11-04,Lassen,035,31185,816,781,2,783,0
2020-11-04,Los Angeles,037,10098052,320838,310456,3398,313854,7124
2020-11-04,Madera,039,155013,5344,5083,58,5141,54
2020-11-04,Marin,041,260295,7303,7157,22,7179,131
2020-11-04,Mariposa,043,17540,88,79,0,79,2
2020-11-04,Mendocino,045,87422,1168,1089,5,1094,22
2020-11-04,Merced,047,269075,10043,9717,48,9765,153
2020-11-04,Modoc,049,8938,59,47,11,58,0
2020-11-04,Mono,051,14174,447,237,7,244,1
2020-11-04,Monterey,053,433212,12233,11743,98,11841,96
2020-11-04,Napa,055,140530,2338,2133,9,2142,15
2020-11-04,Nevada,057,99092,760,675,22,697,9
2020-11-04,Orange,059,3164182,63990,60463,1953,62416,1483
2020-11-04,Placer,061,380077,4982,4526,24,4550,60
2020-11-04,Plumas,063,18699,112,88,0,88,0
2020-11-04,Riverside,065,2383286,72454,69562,668,70230,1335
2020-11-04,Sacramento,067,1510023,28262,27005,42,27047,510
2020-11-04,San Benito,069,59416,1520,1464,1,1465,15
2020-11-04,San Bernardino,071,2135413,70110,65891,553,66444,1169
2020-11-04,San Diego,073,3302833,61992,58126,1886,60012,904
2020-11-04,San Francisco,075,870044,13181,12649,60,12709,146
2020-11-04,San Joaquin,077,732212,23009,22197,287,22484,500
2020-11-04,San Luis Obispo,079,281455,4959,4389,49,4438,32
2020-11-04,San Mateo,081,765935,12096,11456,12,11468,168
2020-11-04,Santa Barbara,083,443738,10292,10026,133,10159,132
2020-11-04,Santa Clara,085,1922200,27543,25487,53,25540,393
2020-11-04,Santa Cruz,087,273765,3243,2997,37,3034,25
2020-11-04,Shasta,089,179085,3016,2321,35,2356,34
2020-11-04,Sierra,091,2930,9,6,0,6,0
2020-11-04,Siskiyou,093,43540,266,222,12,234,0
2020-11-04,Solano,095,438530,8240,7733,42,7775,85
2020-11-04,Sonoma,097,501317,10459,9965,34,9999,142
2020-11-04,Stanislaus,099,539301,18541,18114,892,19006,416
2020-11-04,Sutter,101,95872,2032,1916,2,1918,12
2020-11-04,Tehama,103,63373,1088,997,2,999,6
2020-11-04,Trinity,105,12862,123,37,15,52,0
2020-11-04,Tulare,107,460477,18775,17952,564,18516,298
2020-11-04,Tuolumne,109,53932,390,310,4,314,5
2020-11-04,Ventura,111,848112,16009,14936,436,15372,155
2020-11-04,Yolo,113,214977,3594,3361,10,3371,62
2020-11-04,Yuba,115,75493,1388,1312,7,1319,10
2020-11-03,Alameda,001,1643700,24994,24055,245,24300,418
2020-11-03,Alpine,003,1148,19,4,0,4,0
2020-11-03,Amador,005,37829,385,361,0,361,16
2020-11-03,Butte,007,227075,3357,3211,49,3260,57
2020-11-03,Calaveras,009,45235,351,287,0,287,19
2020-11-03,Colusa,011,21464,584,572,1,573,6
2020-11-03,Contra Costa,013,1133247,20167,19416,99,19515,250
2020-11-03,Del Norte,015,27424,196,187,0,187,2
2020-11-03,El Dorado,017,186661,1569,1445,10,1455,4
2020-11-03,Fresno,019,978130,35081,31856,572,32428,457
2020-11-03,Glenn,021,27897,726,698,6,704,3
2020-11-03,Humboldt,023,135768,612,570,1,571,8
2020-11-03,Imperial,025,180216,13472,13044,23,13067,335
2020-11-03,Inyo,027,18085,257,244,5,249,14
2020-11-03,Kern,029,883053,35104,33957,577,34534,439
2020-11-03,Kings,031,150075,9088,8783,69,8852,83
2020-11-03,Lake,033,64148,766,732,0,732,16
2020-11-03,Lassen,035,31185,807,782,2,784,0
2020-11-03,Los Angeles,037,10098052,318383,308812,3330,312142,7104
2020-11-03,Madera,039,155013,5307,5058,57,5115,54
2020-11-03,Marin,041,260295,7283,7147,21,7168,131
2020-11-03,Mariposa,043,17540,87,79,0,79,2
2020-11-03,Mendocino,045,87422,1153,1084,5,1089,22
2020-11-03,Merced,047,269075,9990,9713,47,9760,153
2020-11-03,Modoc,049,8938,57,47,9,56,0
2020-11-03,Mono,051,14174,443,210,7,217,1
2020-11-03,Monterey,053,433212,12164,11703,91,11794,94
2020-11-03,Napa,055,140530,2302,2130,9,2139,15
2020-11-03,Nevada,057,99092,740,670,21,691,9
2020-11-03,Orange,059,3164182,63560,60283,1941,62224,1477
2020-11-03,Placer,061,380077,4908,4514,24,4538,60
2020-11-03,Plumas,063,18699,109,86,0,86,0
2020-11-03,Riverside,065,2383286,71835,69300,643,69943,1325
2020-11-03,Sacramento,067,1510023,27882,26841,41,26882,510
2020-11-03,San Benito,069,59416,1510,1463,1,1464,15
2020-11-03,San Bernardino,071,2135413,69298,65320,545,65865,1159
2020-11-03,San Diego,073,3302833,61316,57722,1842,59564,901
2020-11-03,San Francisco,075,870044,13058,12585,60,12645,146
2020-11-03,San Joaquin,077,732212,22874,22109,281,22390,500
2020-11-03,San Luis Obispo,079,281455,4875,4371,47,4418,32
2020-11-03,San Mateo,081,765935,12001,11406,12,11418,162
2020-11-03,Santa Barbara,083,443738,10238,10008,128,10136,132
2020-11-03,Santa Clara,085,1922200,27271,25386,52,25438,393
2020-11-03,Santa Cruz,087,273765,3193,2980,36,3016,25
2020-11-03,Shasta,089,179085,2922,2288,28,2316,33
2020-11-03,Sierra,091,2930,7,6,0,6,0
2020-11-03,Siskiyou,093,43540,262,219,11,230,0
2020-11-03,Solano,095,438530,8157,7691,42,7733,85
2020-11-03,Sonoma,097,501317,10357,9906,34,9940,142
2020-11-03,Stanislaus,099,539301,18420,18080,881,18961,416
2020-11-03,Sutter,101,95872,1999,1914,2,1916,12
2020-11-03,Tehama,103,63373,1067,988,2,990,6
2020-11-03,Trinity,105,12862,116,36,14,50,0
2020-11-03,Tulare,107,460477,18669,17890,539,18429,297
2020-11-03,Tuolumne,109,53932,367,302,4,306,5
2020-11-03,Ventura,111,848112,15882,14816,429,15245,155
2020-11-03,Yolo,113,214977,3543,3343,10,3353,61
2020-11-03,Yuba,115,75493,1375,1295,7,1302,10
2020-11-02,Alameda,001,1643700,24798,23991,242,24233,419
2020-11-02,Alpine,003,1148,16,4,0,4,0
2020-11-02,Amador,005,37829,377,357,0,357,16
2020-11-02,Butte,007,227075,3337,3198,46,3244,57
2020-11-02,Calaveras,009,45235,351,282,0,282,18
2020-11-02,Colusa,011,21464,579,571,1,572,6
2020-11-02,Contra Costa,013,1133247,20014,19339,98,19437,250
2020-11-02,Del Norte,015,27424,193,175,0,175,2
2020-11-02,El Dorado,017,186661,1545,1405,10,1415,4
2020-11-02,Fresno,019,978130,34812,31738,555,32293,451
2020-11-02,Glenn,021,27897,720,692,5,697,3
2020-11-02,Humboldt,023,135768,603,569,1,570,8
2020-11-02,Imperial,025,180216,13392,13004,22,13026,334
2020-11-02,Inyo,027,18085,254,243,5,248,14
2020-11-02,Kern,029,883053,34946,33834,567,34401,437
2020-11-02,Kings,031,150075,9058,8654,66,8720,82
2020-11-02,Lake,033,64148,760,728,0,728,17
2020-11-02,Lassen,035,31185,799,782,2,784,0
2020-11-02,Los Angeles,037,10098052,316038,307620,3254,310874,7079
2020-11-02,Madera,039,155013,5276,5033,56,5089,54
2020-11-02,Marin,041,260295,7265,7132,20,7152,125
2020-11-02,Mariposa,043,17540,87,79,0,79,2
2020-11-02,Mendocino,045,87422,1139,1076,5,1081,21
2020-11-02,Merced,047,269075,9928,9664,41,9705,152
2020-11-02,Modoc,049,8938,54,45,5,50,0
2020-11-02,Mono,051,14174,441,211,7,218,1
2020-11-02,Monterey,053,433212,12057,11602,88,11690,93
2020-11-02,Napa,055,140530,2260,2081,9,2090,15
2020-11-02,Nevada,057,99092,724,656,21,677,9
2020-11-02,Orange,059,3164182,63155,59996,1925,61921,1474
2020-11-02,Placer,061,380077,4840,4461,22,4483,60
2020-11-02,Plumas,063,18699,101,86,0,86,0
2020-11-02,Riverside,065,2383286,71204,68833,602,69435,1321
2020-11-02,Sacramento,067,1510023,27540,26676,39,26715,508
2020-11-02,San Benito,069,59416,1498,1459,1,1460,15
2020-11-02,San Bernardino,071,2135413,68443,64629,534,65163,1157
2020-11-02,San Diego,073,3302833,60593,57429,1797,59226,891
2020-11-02,San Francisco,075,870044,12961,12436,59,12495,145
2020-11-02,San Joaquin,077,732212,22734,21919,273,22192,500
2020-11-02,San Luis Obispo,079,281455,4775,4303,44,4347,31
2020-11-02,San Mateo,081,765935,11892,11328,12,11340,161
2020-11-02,Santa Barbara,083,443738,10197,9985,123,10108,130
2020-11-02,Santa Clara,085,1922200,26981,25222,52,25274,387
2020-11-02,Santa Cruz,087,273765,3151,2943,36,2979,25
2020-11-02,Shasta,089,179085,2819,2174,24,2198,33
2020-11-02,Sierra,091,2930,7,6,0,6,0
2020-11-02,Siskiyou,093,43540,252,216,11,227,0
2020-11-02,Solano,095,438530,8039,7665,42,7707,84
2020-11-02,Sonoma,097,501317,10275,9796,33,9829,140
2020-11-02,Stanislaus,099,539301,18324,18005,872,18877,412
2020-11-02,Sutter,101,95872,1975,1895,2,1897,12
2020-11-02,Tehama,103,63373,1044,971,2,973,6
2020-11-02,Trinity,105,12862,110,30,14,44,0
2020-11-02,Tulare,107,460477,18576,17774,518,18292,299
2020-11-02,Tuolumne,109,53932,346,302,4,306,5
2020-11-02,Ventura,111,848112,15741,14767,415,15182,156
2020-11-02,Yolo,113,214977,3494,3318,10,3328,61
2020-11-02,Yuba,115,75493,1362,1280,7,1287,10
2020-11-01,Alameda,001,1643700,24635,23892,240,24132,419
2020-11-01,Alpine,003,1148,10,4,0,4,0
2020-11-01,Amador,005,37829,374,352,0,352,16
2020-11-01,Butte,007,227075,3314,3185,45,3230,57
2020-11-01,Calaveras,009,45235,350,282,0,282,18
2020-11-01,Colusa,011,21464,577,567,1,568,6
2020-11-01,Contra Costa,013,1133247,19840,19246,97,19343,250
2020-11-01,Del Norte,015,27424,189,175,0,175,2
2020-11-01,El Dorado,017,186661,1529,1394,10,1404,4
2020-11-01,Fresno,019,978130,34555,31613,535,32148,451
2020-11-01,Glenn,021,27897,711,688,3,691,3
2020-11-01,Humboldt,023,135768,595,568,1,569,8
2020-11-01,Imperial,025,180216,13301,12969,20,12989,334
2020-11-01,Inyo,027,18085,252,241,5,246,14
2020-11-01,Kern,029,883053,34765,33760,473,34233,437
2020-11-01,Kings,031,150075,9020,8641,65,8706,82
2020-11-01,Lake,033,64148,754,727,0,727,17
2020-11-01,Lassen,035,31185,799,782,2,784,0
2020-11-01,Los Angeles,037,10098052,313471,306217,3163,309380,7077
2020-11-01,Madera,039,155013,5228,5019,54,5073,54
2020-11-01,Marin,041,260295,7248,7124,20,7144,125
2020-11-01,Mariposa,043,17540,83,79,0,79,2
2020-11-01,Mendocino,045,87422,1126,1074,5,1079,21
2020-11-01,Merced,047,269075,9867,9626,41,9667,152
2020-11-01,Modoc,049,8938,53,45,5,50,0
2020-11-01,Mono,051,14174,412,211,6,217,1
2020-11-01,Monterey,053,433212,11950,11587,85,11672,93
2020-11-01,Napa,055,140530,2226,2067,9,2076,15
2020-11-01,Nevada,057,99092,708,646,20,666,9
2020-11-01,Orange,059,3164182,62753,59733,1898,61631,1475
2020-11-01,Placer,061,380077,4774,4422,21,4443,58
2020-11-01,Plumas,063,18699,96,86,0,86,0
2020-11-01,Riverside,065,2383286,70574,68493,566,69059,1319
2020-11-01,Sacramento,067,1510023,27219,26442,39,26481,508
2020-11-01,San Benito,069,59416,1483,1451,1,1452,15
2020-11-01,San Bernardino,071,2135413,67598,64339,513,64852,1157
2020-11-01,San Diego,073,3302833,59905,57122,1757,58879,891
2020-11-01,San Francisco,075,870044,12838,12436,54,12490,145
2020-11-01,San Joaquin,077,732212,22606,21919,267,22186,500
2020-11-01,San Luis Obispo,079,281455,4695,4303,43,4346,31
2020-11-01,San Mateo,081,765935,11811,11280,12,11292,160
2020-11-01,Santa Barbara,083,443738,10146,9969,107,10076,130
2020-11-01,Santa Clara,085,1922200,26701,25090,52,25142,386
2020-11-01,Santa Cruz,087,273765,3098,2921,36,2957,25
2020-11-01,Shasta,089,179085,2684,2172,23,2195,33
2020-11-01,Sierra,091,2930,7,6,0,6,0
2020-11-01,Siskiyou,093,43540,247,205,11,216,0
2020-11-01,Solano,095,438530,7949,7591,42,7633,84
2020-11-01,Sonoma,097,501317,10183,9688,33,9721,140
2020-11-01,Stanislaus,099,539301,18223,17961,852,18813,412
2020-11-01,Sutter,101,95872,1949,1888,1,1889,12
2020-11-01,Tehama,103,63373,1027,965,2,967,5
2020-11-01,Trinity,105,12862,108,30,13,43,0
2020-11-01,Tulare,107,460477,18464,17774,487,18261,299
2020-11-01,Tuolumne,109,53932,324,295,4,299,5
2020-11-01,Ventura,111,848112,15592,14686,384,15070,156
2020-11-01,Yolo,113,214977,3446,3303,10,3313,60
2020-11-01,Yuba,115,75493,1345,1273,7,1280,10
2020-10-31,Alameda,001,1643700,24519,23780,236,24016,416
2020-10-31,Alpine,003,1148,10,4,0,4,0
2020-10-31,Amador,005,37829,370,347,0,347,16
2020-10-31,Butte,007,227075,3301,3172,43,3215,57
2020-10-31,Calaveras,009,45235,350,280,0,280,18
2020-10-31,Colusa,011,21464,575,555,1,556,6
2020-10-31,Contra Costa,013,1133247,19735,19161,97,19258,249
2020-10-31,Del Norte,015,27424,188,175,0,175,2
2020-10-31,El Dorado,017,186661,1520,1390,10,1400,4
2020-10-31,Fresno,019,978130,34418,31558,532,32090,451
2020-10-31,Glenn,021,27897,709,678,3,681,3
2020-10-31,Humboldt,023,135768,592,561,1,562,8
2020-10-31,Imperial,025,180216,13259,12912,20,12932,334
2020-10-31,Inyo,027,18085,251,241,5,246,14
2020-10-31,Kern,029,883053,34662,33666,464,34130,437
2020-10-31,Kings,031,150075,8999,8612,64,8676,82
2020-10-31,Lake,033,64148,750,724,0,724,16
2020-10-31,Lassen,035,31185,794,782,2,784,0
2020-10-31,Los Angeles,037,10098052,312096,304704,3121,307825,7073
2020-10-31,Madera,039,155013,5210,5013,51,5064,54
2020-10-31,Marin,041,260295,7232,7112,20,7132,125
2020-10-31,Mariposa,043,17540,83,79,0,79,2
2020-10-31,Mendocino,045,87422,1118,1066,5,1071,21
2020-10-31,Merced,047,269075,9834,9597,40,9637,151
2020-10-31,Modoc,049,8938,52,34,4,38,0
2020-10-31,Mono,051,14174,263,194,5,199,1
2020-10-31,Monterey,053,433212,11882,11539,81,11620,93
2020-10-31,Napa,055,140530,2207,2040,9,2049,15
2020-10-31,Nevada,057,99092,690,644,20,664,9
2020-10-31,Orange,059,3164182,62495,59488,1880,61368,1473
2020-10-31,Placer,061,380077,4724,4374,20,4394,58
2020-10-31,Plumas,063,18699,95,85,0,85,0
2020-10-31,Riverside,065,2383286,70217,68178,543,68721,1319
2020-10-31,Sacramento,067,1510023,27020,26316,37,26353,507
2020-10-31,San Benito,069,59416,1476,1448,1,1449,15
2020-10-31,San Bernardino,071,2135413,67173,64016,503,64519,1157
2020-10-31,San Diego,073,3302833,59452,56769,1729,58498,891
2020-10-31,San Francisco,075,870044,12764,12438,53,12491,145
2020-10-31,San Joaquin,077,732212,22531,21918,258,22176,500
2020-10-31,San Luis Obispo,079,281455,4626,4285,40,4325,31
2020-10-31,San Mateo,081,765935,11759,11253,12,11265,160
2020-10-31,Santa Barbara,083,443738,10117,9957,99,10056,130
2020-10-31,Santa Clara,085,1922200,26532,24957,52,25009,379
2020-10-31,Santa Cruz,087,273765,3063,2895,35,2930,25
2020-10-31,Shasta,089,179085,2630,2122,22,2144,33
2020-10-31,Sierra,091,2930,7,6,0,6,0
2020-10-31,Siskiyou,093,43540,245,200,11,211,0
2020-10-31,Solano,095,438530,7885,7545,42,7587,84
2020-10-31,Sonoma,097,501317,10130,9648,33,9681,140
2020-10-31,Stanislaus,099,539301,18160,17920,836,18756,412
2020-10-31,Sutter,101,95872,1940,1876,1,1877,12
2020-10-31,Tehama,103,63373,1017,953,2,955,5
2020-10-31,Trinity,105,12862,105,30,13,43,0
2020-10-31,Tulare,107,460477,18415,17758,479,18237,299
2020-10-31,Tuolumne,109,53932,317,290,4,294,5
2020-10-31,Ventura,111,848112,15508,14635,366,15001,155
2020-10-31,Yolo,113,214977,3411,3290,10,3300,60
2020-10-31,Yuba,115,75493,1329,1260,6,1266,10
2020-10-30,Alameda,001,1643700,24440,23676,234,23910,401
2020-10-30,Alpine,003,1148,10,4,0,4,0
2020-10-30,Amador,005,37829,370,344,0,344,16
2020-10-30,Butte,007,227075,3296,3160,43,3203,57
2020-10-30,Calaveras,009,45235,349,279,0,279,18
2020-10-30,Colusa,011,21464,573,554,1,555,6
2020-10-30,Contra Costa,013,1133247,19663,19074,97,19171,249
2020-10-30,Del Norte,015,27424,187,175,0,175,2
2020-10-30,El Dorado,017,186661,1507,1386,10,1396,4
2020-10-30,Fresno,019,978130,34296,31409,523,31932,446
2020-10-30,Glenn,021,27897,703,674,2,676,3
2020-10-30,Humboldt,023,135768,591,561,1,562,7
2020-10-30,Imperial,025,180216,13218,12853,20,12873,334
2020-10-30,Inyo,027,18085,250,241,5,246,14
2020-10-30,Kern,029,883053,34569,33583,463,34046,437
2020-10-30,Kings,031,150075,8989,8564,62,8626,82
2020-10-30,Lake,033,64148,750,720,0,720,16
2020-10-30,Lassen,035,31185,788,777,2,779,0
2020-10-30,Los Angeles,037,10098052,310659,303425,3087,306512,7060
2020-10-30,Madera,039,155013,5198,4991,49,5040,54
2020-10-30,Marin,041,260295,7212,7097,20,7117,125
2020-10-30,Mariposa,043,17540,83,78,0,78,2
2020-10-30,Mendocino,045,87422,1116,1062,5,1067,21
2020-10-30,Merced,047,269075,9802,9539,40,9579,150
2020-10-30,Modoc,049,8938,51,34,3,37,0
2020-10-30,Mono,051,14174,262,193,5,198,1
2020-10-30,Monterey,053,433212,11819,11491,76,11567,92
2020-10-30,Napa,055,140530,2189,2028,9,2037,15
2020-10-30,Nevada,057,99092,684,634,20,654,9
2020-10-30,Orange,059,3164182,62254,59334,1868,61202,1469
2020-10-30,Placer,061,380077,4677,4335,20,4355,58
2020-10-30,Plumas,063,18699,92,80,0,80,0
2020-10-30,Riverside,065,2383286,69878,67752,523,68275,1317
2020-10-30,Sacramento,067,1510023,26872,26147,37,26184,505
2020-10-30,San Benito,069,59416,1470,1440,1,1441,15
2020-10-30,San Bernardino,071,2135413,66757,63512,500,64012,1156
2020-10-30,San Diego,073,3302833,59047,56387,1707,58094,888
2020-10-30,San Francisco,075,870044,12709,12384,53,12437,145
2020-10-30,San Joaquin,077,732212,22464,21849,252,22101,500
2020-10-30,San Luis Obispo,079,281455,4583,4256,40,4296,31
2020-10-30,San Mateo,081,765935,11700,11207,12,11219,159
2020-10-30,Santa Barbara,083,443738,10094,9937,99,10036,128
2020-10-30,Santa Clara,085,1922200,26383,24811,52,24863,378
2020-10-30,Santa Cruz,087,273765,3045,2874,35,2909,25
2020-10-30,Shasta,089,179085,2586,2048,21,2069,32
2020-10-30,Sierra,091,2930,7,6,0,6,0
2020-10-30,Siskiyou,093,43540,245,192,11,203,0
2020-10-30,Solano,095,438530,7824,7497,42,7539,84
2020-10-30,Sonoma,097,501317,10055,9602,33,9635,140
2020-10-30,Stanislaus,099,539301,18112,17861,820,18681,410
2020-10-30,Sutter,101,95872,1927,1860,1,1861,12
2020-10-30,Tehama,103,63373,1013,932,2,934,5
2020-10-30,Trinity,105,12862,105,29,13,42,0
2020-10-30,Tulare,107,460477,18371,17682,464,18146,299
2020-10-30,Tuolumne,109,53932,310,286,4,290,4
2020-10-30,Ventura,111,848112,15435,14578,354,14932,154
2020-10-30,Yolo,113,214977,3394,3263,10,3273,60
2020-10-30,Yuba,115,75493,1321,1256,6,1262,10
2020-10-29,Alameda,001,1643700,24276,23530,233,23763,401
2020-10-29,Alpine,003,1148,7,4,0,4,0
2020-10-29,Amador,005,37829,366,338,0,338,16
2020-10-29,Butte,007,227075,3278,3143,42,3185,57
2020-10-29,Calaveras,009,45235,347,278,0,278,13
2020-10-29,Colusa,011,21464,569,552,1,553,6
2020-10-29,Contra Costa,013,1133247,19564,18933,96,19029,249
2020-10-29,Del Norte,015,27424,185,174,0,174,2
2020-10-29,El Dorado,017,186661,1485,1370,10,1380,4
2020-10-29,Fresno,019,978130,34139,31321,516,31837,445
2020-10-29,Glenn,021,27897,701,673,2,675,3
2020-10-29,Humboldt,023,135768,586,559,1,560,7
2020-10-29,Imperial,025,180216,13174,12769,20,12789,334
2020-10-29,Inyo,027,18085,248,238,5,243,14
2020-10-29,Kern,029,883053,34468,33460,459,33919,437
2020-10-29,Kings,031,150075,8835,8502,61,8563,82
2020-10-29,Lake,033,64148,747,702,0,702,16
2020-10-29,Lassen,035,31185,787,772,2,774,0
2020-10-29,Los Angeles,037,10098052,309029,302246,3041,305287,7046
2020-10-29,Madera,039,155013,5168,4970,47,5017,53
2020-10-29,Marin,041,260295,7198,7083,20,7103,125
2020-10-29,Mariposa,043,17540,81,78,0,78,2
2020-10-29,Mendocino,045,87422,1110,1058,5,1063,21
2020-10-29,Merced,047,269075,9750,9496,40,9536,150
2020-10-29,Modoc,049,8938,49,31,3,34,0
2020-10-29,Mono,051,14174,255,176,5,181,1
2020-10-29,Monterey,053,433212,11738,11425,74,11499,92
2020-10-29,Napa,055,140530,2165,2009,9,2018,15
2020-10-29,Nevada,057,99092,677,632,20,652,9
2020-10-29,Orange,059,3164182,61986,59046,1848,60894,1464
2020-10-29,Placer,061,380077,4632,4270,18,4288,58
2020-10-29,Plumas,063,18699,90,69,0,69,0
2020-10-29,Riverside,065,2383286,69501,67268,493,67761,1304
2020-10-29,Sacramento,067,1510023,26659,25978,36,26014,507
2020-10-29,San Benito,069,59416,1465,1431,1,1432,15
2020-10-29,San Bernardino,071,2135413,66190,62968,490,63458,1150
2020-10-29,San Diego,073,3302833,58581,55916,1678,57594,885
2020-10-29,San Francisco,075,870044,12630,12312,53,12365,145
2020-10-29,San Joaquin,077,732212,22380,21736,240,21976,498
2020-10-29,San Luis Obispo,079,281455,4552,4223,39,4262,31
2020-10-29,San Mateo,081,765935,11654,11145,12,11157,157
2020-10-29,Santa Barbara,083,443738,10061,9902,97,9999,128
2020-10-29,Santa Clara,085,1922200,26232,24614,52,24666,377
2020-10-29,Santa Cruz,087,273765,3020,2850,35,2885,24
2020-10-29,Shasta,089,179085,2523,2008,21,2029,32
2020-10-29,Sierra,091,2930,6,6,0,6,0
2020-10-29,Siskiyou,093,43540,229,185,11,196,0
2020-10-29,Solano,095,438530,7762,7453,42,7495,78
2020-10-29,Sonoma,097,501317,9990,9533,33,9566,140
2020-10-29,Stanislaus,099,539301,18059,17790,798,18588,410
2020-10-29,Sutter,101,95872,1920,1852,1,1853,12
2020-10-29,Tehama,103,63373,995,925,2,927,5
2020-10-29,Trinity,105,12862,100,28,12,40,0
2020-10-29,Tulare,107,460477,18293,17627,445,18072,299
2020-10-29,Tuolumne,109,53932,305,279,4,283,4
2020-10-29,Ventura,111,848112,15344,14486,350,14836,154
2020-10-29,Yolo,113,214977,3365,3246,10,3256,60
2020-10-29,Yuba,115,75493,1310,1248,6,1254,10
2020-10-28,Alameda,001,1643700,24176,23468,232,23700,400
2020-10-28,Alpine,003,1148,6,4,0,4,0
2020-10-28,Amador,005,37829,363,337,0,337,16
2020-10-28,Butte,007,227075,3262,3134,39,3173,56
2020-10-28,Calaveras,009,45235,346,278,0,278,13
2020-10-28,Colusa,011,21464,566,551,1,552,6
2020-10-28,Contra Costa,013,1133247,19477,18828,95,18923,246
2020-10-28,Del Norte,015,27424,182,173,0,173,2
2020-10-28,El Dorado,017,186661,1473,1363,10,1373,4
2020-10-28,Fresno,019,978130,34017,31195,510,31705,444
2020-10-28,Glenn,021,27897,697,673,2,675,3
2020-10-28,Humboldt,023,135768,582,559,1,560,7
2020-10-28,Imperial,025,180216,13125,12730,20,12750,333
2020-10-28,Inyo,027,18085,248,238,5,243,14
2020-10-28,Kern,029,883053,34366,33424,440,33864,436
2020-10-28,Kings,031,150075,8813,8486,60,8546,82
2020-10-28,Lake,033,64148,744,700,0,700,15
2020-10-28,Lassen,035,31185,783,771,2,773,0
2020-10-28,Los Angeles,037,10098052,307570,300726,2999,303725,7031
2020-10-28,Madera,039,155013,5151,4954,46,5000,53
2020-10-28,Marin,041,260295,7187,7079,20,7099,126
2020-10-28,Mariposa,043,17540,81,78,0,78,2
2020-10-28,Mendocino,045,87422,1109,1037,5,1042,20
2020-10-28,Merced,047,269075,9724,9480,39,9519,150
2020-10-28,Modoc,049,8938,48,31,2,33,0
2020-10-28,Mono,051,14174,237,176,5,181,1
2020-10-28,Monterey,053,433212,11680,11330,72,11402,89
2020-10-28,Napa,055,140530,2139,1998,8,2006,15
2020-10-28,Nevada,057,99092,669,629,20,649,9
2020-10-28,Orange,059,3164182,61722,58801,1832,60633,1459
2020-10-28,Placer,061,380077,4576,4236,18,4254,57
2020-10-28,Plumas,063,18699,89,67,0,67,0
2020-10-28,Riverside,065,2383286,69103,67003,469,67472,1302
2020-10-28,Sacramento,067,1510023,26463,25838,35,25873,506
2020-10-28,San Benito,069,59416,1457,1429,1,1430,15
2020-10-28,San Bernardino,071,2135413,65731,62778,481,63259,1154
2020-10-28,San Diego,073,3302833,58198,55556,1649,57205,881
2020-10-28,San Francisco,075,870044,12572,12261,52,12313,145
2020-10-28,San Joaquin,077,732212,22296,21707,229,21936,498
2020-10-28,San Luis Obispo,079,281455,4508,4197,36,4233,31
2020-10-28,San Mateo,081,765935,11587,11101,12,11113,157
2020-10-28,Santa Barbara,083,443738,10037,9872,95,9967,127
2020-10-28,Santa Clara,085,1922200,26088,24503,52,24555,375
2020-10-28,Santa Cruz,087,273765,2989,2836,35,2871,24
2020-10-28,Shasta,089,179085,2443,1996,20,2016,31
2020-10-28,Sierra,091,2930,6,6,0,6,0
2020-10-28,Siskiyou,093,43540,226,182,10,192,0
2020-10-28,Solano,095,438530,7703,7362,42,7404,77
2020-10-28,Sonoma,097,501317,9900,9457,28,9485,140
2020-10-28,Stanislaus,099,539301,17994,17765,788,18553,409
2020-10-28,Sutter,101,95872,1911,1840,1,1841,12
2020-10-28,Tehama,103,63373,984,921,2,923,5
2020-10-28,Trinity,105,12862,93,28,11,39,0
2020-10-28,Tulare,107,460477,18236,17569,429,17998,297
2020-10-28,Tuolumne,109,53932,302,277,4,281,4
2020-10-28,Ventura,111,848112,15271,14409,341,14750,153
2020-10-28,Yolo,113,214977,3341,3230,10,3240,60
2020-10-28,Yuba,115,75493,1298,1245,6,1251,10
2020-10-27,Alameda,001,1643700,24062,23365,230,23595,400
2020-10-27,Alpine,003,1148,6,3,0,3,0
2020-10-27,Amador,005,37829,360,335,0,335,16
2020-10-27,Butte,007,227075,3246,3107,36,3143,56
2020-10-27,Calaveras,009,45235,344,277,0,277,13
2020-10-27,Colusa,011,21464,561,549,1,550,6
2020-10-27,Contra Costa,013,1133247,19371,18766,95,18861,246
2020-10-27,Del Norte,015,27424,179,173,0,173,2
2020-10-27,El Dorado,017,186661,1460,1351,10,1361,4
2020-10-27,Fresno,019,978130,33898,31096,505,31601,442
2020-10-27,Glenn,021,27897,695,667,1,668,3
2020-10-27,Humboldt,023,135768,579,559,1,560,7
2020-10-27,Imperial,025,180216,13076,12680,19,12699,333
2020-10-27,Inyo,027,18085,248,231,5,236,14
2020-10-27,Kern,029,883053,34249,33328,436,33764,436
2020-10-27,Kings,031,150075,8782,8411,60,8471,83
2020-10-27,Lake,033,64148,741,700,0,700,15
2020-10-27,Lassen,035,31185,781,764,2,766,0
2020-10-27,Los Angeles,037,10098052,306186,299438,2970,302408,7008
2020-10-27,Madera,039,155013,5121,4942,45,4987,53
2020-10-27,Marin,041,260295,7171,7070,20,7090,126
2020-10-27,Mariposa,043,17540,80,78,0,78,2
2020-10-27,Mendocino,045,87422,1103,1033,4,1037,20
2020-10-27,Merced,047,269075,9683,9449,39,9488,150
2020-10-27,Modoc,049,8938,46,31,2,33,0
2020-10-27,Mono,051,14174,223,169,5,174,1
2020-10-27,Monterey,053,433212,11624,11261,70,11331,88
2020-10-27,Napa,055,140530,2123,1979,8,1987,15
2020-10-27,Nevada,057,99092,663,622,20,642,8
2020-10-27,Orange,059,3164182,61450,58550,1816,60366,1448
2020-10-27,Placer,061,380077,4527,4197,16,4213,57
2020-10-27,Plumas,063,18699,86,63,0,63,0
2020-10-27,Riverside,065,2383286,68750,66699,424,67123,1299
2020-10-27,Sacramento,067,1510023,26276,25701,33,25734,501
2020-10-27,San Benito,069,59416,1452,1428,1,1429,15
2020-10-27,San Bernardino,071,2135413,65270,62357,468,62825,1154
2020-10-27,San Diego,073,3302833,57725,55226,1626,56852,877
2020-10-27,San Francisco,075,870044,12497,12218,51,12269,140
2020-10-27,San Joaquin,077,732212,22205,21637,220,21857,496
2020-10-27,San Luis Obispo,079,281455,4481,4148,32,4180,31
2020-10-27,San Mateo,081,765935,11539,11074,12,11086,156
2020-10-27,Santa Barbara,083,443738,10007,9874,94,9968,125
2020-10-27,Santa Clara,085,1922200,25946,24368,52,24420,367
2020-10-27,Santa Cruz,087,273765,2959,2815,34,2849,24
2020-10-27,Shasta,089,179085,2357,1962,20,1982,29
2020-10-27,Sierra,091,2930,6,6,0,6,0
2020-10-27,Siskiyou,093,43540,217,181,10,191,0
2020-10-27,Solano,095,438530,7634,7298,42,7340,77
2020-10-27,Sonoma,097,501317,9833,9389,28,9417,140
2020-10-27,Stanislaus,099,539301,17926,17720,781,18501,408
2020-10-27,Sutter,101,95872,1898,1832,1,1833,12
2020-10-27,Tehama,103,63373,970,913,2,915,5
2020-10-27,Trinity,105,12862,90,28,11,39,0
2020-10-27,Tulare,107,460477,18173,17520,406,17926,296
2020-10-27,Tuolumne,109,53932,298,275,4,279,4
2020-10-27,Ventura,111,848112,15188,14347,334,14681,153
2020-10-27,Yolo,113,214977,3327,3216,10,3226,58
2020-10-27,Yuba,115,75493,1285,1235,6,1241,10
2020-10-26,Alameda,001,1643700,23949,23284,229,23513,398
2020-10-26,Alpine,003,1148,4,3,0,3,0
2020-10-26,Amador,005,37829,356,331,0,331,16
2020-10-26,Butte,007,227075,3235,3095,34,3129,56
2020-10-26,Calaveras,009,45235,340,274,0,274,13
2020-10-26,Colusa,011,21464,559,548,1,549,6
2020-10-26,Contra Costa,013,1133247,19275,18718,94,18812,245
2020-10-26,Del Norte,015,27424,179,171,0,171,2
2020-10-26,El Dorado,017,186661,1446,1336,10,1346,4
2020-10-26,Fresno,019,978130,33785,30969,498,31467,441
2020-10-26,Glenn,021,27897,688,660,1,661,3
2020-10-26,Humboldt,023,135768,571,554,1,555,7
2020-10-26,Imperial,025,180216,13022,12654,16,12670,333
2020-10-26,Inyo,027,18085,248,226,5,231,14
2020-10-26,Kern,029,883053,34165,33233,431,33664,432
2020-10-26,Kings,031,150075,8760,8264,58,8322,82
2020-10-26,Lake,033,64148,739,697,0,697,15
2020-10-26,Lassen,035,31185,778,764,2,766,0
2020-10-26,Los Angeles,037,10098052,304757,297961,2929,300890,6979
2020-10-26,Madera,039,155013,5100,4922,44,4966,53
2020-10-26,Marin,041,260295,7165,7064,19,7083,104
2020-10-26,Mariposa,043,17540,80,77,0,77,2
2020-10-26,Mendocino,045,87422,1095,1026,4,1030,20
2020-10-26,Merced,047,269075,9636,9375,38,9413,150
2020-10-26,Modoc,049,8938,44,28,0,28,0
2020-10-26,Mono,051,14174,217,167,5,172,1
2020-10-26,Monterey,053,433212,11573,11207,66,11273,87
2020-10-26,Napa,055,140530,2091,1966,8,1974,14
2020-10-26,Nevada,057,99092,656,618,20,638,8
2020-10-26,Orange,059,3164182,61247,58377,1797,60174,1442
2020-10-26,Placer,061,380077,4485,4161,15,4176,57
2020-10-26,Plumas,063,18699,84,63,0,63,0
2020-10-26,Riverside,065,2383286,68298,66475,398,66873,1294
2020-10-26,Sacramento,067,1510023,26095,25555,31,25586,496
2020-10-26,San Benito,069,59416,1444,1424,1,1425,15
2020-10-26,San Bernardino,071,2135413,64799,61871,465,62336,1153
2020-10-26,San Diego,073,3302833,57332,54957,1588,56545,870
2020-10-26,San Francisco,075,870044,12437,12072,51,12123,138
2020-10-26,San Joaquin,077,732212,22122,21459,214,21673,495
2020-10-26,San Luis Obispo,079,281455,4455,4133,32,4165,31
2020-10-26,San Mateo,081,765935,11495,11037,12,11049,156
2020-10-26,Santa Barbara,083,443738,9984,9827,94,9921,122
2020-10-26,Santa Clara,085,1922200,25756,24258,51,24309,365
2020-10-26,Santa Cruz,087,273765,2933,2808,34,2842,24
2020-10-26,Shasta,089,179085,2303,1889,20,1909,29
2020-10-26,Sierra,091,2930,6,6,0,6,0
2020-10-26,Siskiyou,093,43540,209,179,10,189,0
2020-10-26,Solano,095,438530,7554,7271,42,7313,62
2020-10-26,Sonoma,097,501317,9754,9315,28,9343,140
2020-10-26,Stanislaus,099,539301,17876,17666,771,18437,400
2020-10-26,Sutter,101,95872,1890,1817,1,1818,12
2020-10-26,Tehama,103,63373,950,892,2,894,5
2020-10-26,Trinity,105,12862,89,26,11,37,0
2020-10-26,Tulare,107,460477,18096,17432,383,17815,296
2020-10-26,Tuolumne,109,53932,289,271,4,275,4
2020-10-26,Ventura,111,848112,15118,14330,331,14661,154
2020-10-26,Yolo,113,214977,3308,3206,10,3216,58
2020-10-26,Yuba,115,75493,1269,1226,6,1232,10
2020-10-25,Alameda,001,1643700,23843,23192,229,23421,398
2020-10-25,Alpine,003,1148,3,3,0,3,0
2020-10-25,Amador,005,37829,345,330,0,330,16
2020-10-25,Butte,007,227075,3216,3087,34,3121,56
2020-10-25,Calaveras,009,45235,339,274,0,274,13
2020-10-25,Colusa,011,21464,555,548,1,549,6
2020-10-25,Contra Costa,013,1133247,19173,18640,94,18734,245
2020-10-25,Del Norte,015,27424,175,171,0,171,2
2020-10-25,El Dorado,017,186661,1431,1328,10,1338,4
2020-10-25,Fresno,019,978130,33651,30858,485,31343,441
2020-10-25,Glenn,021,27897,685,652,1,653,3
2020-10-25,Humboldt,023,135768,568,554,1,555,7
2020-10-25,Imperial,025,180216,12973,12572,16,12588,333
2020-10-25,Inyo,027,18085,245,226,5,231,14
2020-10-25,Kern,029,883053,34058,33185,427,33612,432
2020-10-25,Kings,031,150075,8727,8246,56,8302,82
2020-10-25,Lake,033,64148,722,695,0,695,15
2020-10-25,Lassen,035,31185,776,764,2,766,0
2020-10-25,Los Angeles,037,10098052,303195,297110,2892,300002,6973
2020-10-25,Madera,039,155013,5070,4909,39,4948,53
2020-10-25,Marin,041,260295,7155,7052,19,7071,102
2020-10-25,Mariposa,043,17540,80,77,0,77,2
2020-10-25,Mendocino,045,87422,1088,1024,4,1028,20
2020-10-25,Merced,047,269075,9571,9352,36,9388,150
2020-10-25,Modoc,049,8938,39,28,0,28,0
2020-10-25,Mono,051,14174,209,167,5,172,1
2020-10-25,Monterey,053,433212,11490,11182,61,11243,87
2020-10-25,Napa,055,140530,2061,1962,8,1970,14
2020-10-25,Nevada,057,99092,648,616,20,636,8
2020-10-25,Orange,059,3164182,60959,58185,1788,59973,1443
2020-10-25,Placer,061,380077,4433,4140,15,4155,57
2020-10-25,Plumas,063,18699,84,63,0,63,0
2020-10-25,Riverside,065,2383286,67847,66192,382,66574,1289
2020-10-25,Sacramento,067,1510023,25879,25445,28,25473,496
2020-10-25,San Benito,069,59416,1437,1423,1,1424,15
2020-10-25,San Bernardino,071,2135413,64258,61551,453,62004,1153
2020-10-25,San Diego,073,3302833,56869,54599,1556,56155,870
2020-10-25,San Francisco,075,870044,12364,12072,51,12123,137
2020-10-25,San Joaquin,077,732212,22014,21459,206,21665,495
2020-10-25,San Luis Obispo,079,281455,4413,4126,30,4156,31
2020-10-25,San Mateo,081,765935,11450,10987,12,10999,156
2020-10-25,Santa Barbara,083,443738,9964,9814,94,9908,122
2020-10-25,Santa Clara,085,1922200,25568,24087,51,24138,365
2020-10-25,Santa Cruz,087,273765,2906,2789,34,2823,24
2020-10-25,Shasta,089,179085,2239,1889,20,1909,29
2020-10-25,Sierra,091,2930,6,6,0,6,0
2020-10-25,Siskiyou,093,43540,206,176,10,186,0
2020-10-25,Solano,095,438530,7476,7197,42,7239,60
2020-10-25,Sonoma,097,501317,9661,9235,27,9262,140
2020-10-25,Stanislaus,099,539301,17819,17641,761,18402,400
2020-10-25,Sutter,101,95872,1872,1811,1,1812,12
2020-10-25,Tehama,103,63373,933,880,2,882,5
2020-10-25,Trinity,105,12862,85,26,11,37,0
2020-10-25,Tulare,107,460477,18022,17431,373,17804,296
2020-10-25,Tuolumne,109,53932,284,271,4,275,4
2020-10-25,Ventura,111,848112,15025,14300,325,14625,154
2020-10-25,Yolo,113,214977,3287,3190,10,3200,58
2020-10-25,Yuba,115,75493,1261,1219,6,1225,10
2020-10-24,Alameda,001,1643700,23772,23099,226,23325,398
2020-10-24,Alpine,003,1148,3,3,0,3,0
2020-10-24,Amador,005,37829,344,328,0,328,16
2020-10-24,Butte,007,227075,3207,3078,34,3112,56
2020-10-24,Calaveras,009,45235,337,274,0,274,13
2020-10-24,Colusa,011,21464,550,548,1,549,6
2020-10-24,Contra Costa,013,1133247,19106,18567,94,18661,244
2020-10-24,Del Norte,015,27424,174,171,0,171,2
2020-10-24,El Dorado,017,186661,1415,1317,10,1327,4
2020-10-24,Fresno,019,978130,33590,30752,480,31232,441
2020-10-24,Glenn,021,27897,682,650,1,651,3
2020-10-24,Humboldt,023,135768,566,553,1,554,7
2020-10-24,Imperial,025,180216,12946,12469,16,12485,333
2020-10-24,Inyo,027,18085,245,226,5,231,14
2020-10-24,Kern,029,883053,34000,33105,422,33527,432
2020-10-24,Kings,031,150075,8717,8228,55,8283,82
2020-10-24,Lake,033,64148,717,696,0,696,15
2020-10-24,Lassen,035,31185,775,764,2,766,0
2020-10-24,Los Angeles,037,10098052,302376,296323,2870,299193,6969
2020-10-24,Madera,039,155013,5057,4898,38,4936,53
2020-10-24,Marin,041,260295,7146,7042,19,7061,102
2020-10-24,Mariposa,043,17540,80,77,0,77,2
2020-10-24,Mendocino,045,87422,1076,1022,4,1026,20
2020-10-24,Merced,047,269075,9547,9351,36,9387,150
2020-10-24,Modoc,049,8938,38,28,0,28,0
2020-10-24,Mono,051,14174,195,167,5,172,1
2020-10-24,Monterey,053,433212,11421,11153,60,11213,87
2020-10-24,Napa,055,140530,2044,1957,8,1965,14
2020-10-24,Nevada,057,99092,644,608,20,628,8
2020-10-24,Orange,059,3164182,60804,57928,1778,59706,1441
2020-10-24,Placer,061,380077,4402,4093,15,4108,57
2020-10-24,Plumas,063,18699,78,63,0,63,0
2020-10-24,Riverside,065,2383286,67639,65902,367,66269,1288
2020-10-24,Sacramento,067,1510023,25798,25372,28,25400,496
2020-10-24,San Benito,069,59416,1432,1417,1,1418,15
2020-10-24,San Bernardino,071,2135413,64018,61351,444,61795,1153
2020-10-24,San Diego,073,3302833,56592,54330,1543,55873,868
2020-10-24,San Francisco,075,870044,12306,12073,50,12123,137
2020-10-24,San Joaquin,077,732212,21961,21458,201,21659,495
2020-10-24,San Luis Obispo,079,281455,4390,4119,29,4148,31
2020-10-24,San Mateo,081,765935,11411,10942,12,10954,155
2020-10-24,Santa Barbara,083,443738,9947,9781,94,9875,122
2020-10-24,Santa Clara,085,1922200,25481,23978,51,24029,365
2020-10-24,Santa Cruz,087,273765,2887,2775,34,2809,24
2020-10-24,Shasta,089,179085,2194,1878,20,1898,29
2020-10-24,Sierra,091,2930,6,6,0,6,0
2020-10-24,Siskiyou,093,43540,205,174,10,184,0
2020-10-24,Solano,095,438530,7423,7189,42,7231,60
2020-10-24,Sonoma,097,501317,9627,9179,27,9206,140
2020-10-24,Stanislaus,099,539301,17775,17574,745,18319,400
2020-10-24,Sutter,101,95872,1863,1804,1,1805,12
2020-10-24,Tehama,103,63373,925,872,2,874,5
2020-10-24,Trinity,105,12862,85,25,11,36,0
2020-10-24,Tulare,107,460477,17999,17406,362,17768,295
2020-10-24,Tuolumne,109,53932,281,269,4,273,4
2020-10-24,Ventura,111,848112,14972,14240,324,14564,154
2020-10-24,Yolo,113,214977,3275,3164,10,3174,57
2020-10-24,Yuba,115,75493,1258,1210,6,1216,10
2020-10-23,Alameda,001,1643700,23700,23047,224,23271,393
2020-10-23,Alpine,003,1148,3,3,0,3,0
2020-10-23,Amador,005,37829,343,324,0,324,16
2020-10-23,Butte,007,227075,3198,3059,34,3093,55
2020-10-23,Calaveras,009,45235,336,273,0,273,13
2020-10-23,Colusa,011,21464,550,547,1,548,6
2020-10-23,Contra Costa,013,1133247,19036,18483,93,18576,244
2020-10-23,Del Norte,015,27424,174,171,0,171,2
2020-10-23,El Dorado,017,186661,1406,1310,10,1320,4
2020-10-23,Fresno,019,978130,33523,30590,477,31067,441
2020-10-23,Glenn,021,27897,679,644,1,645,3
2020-10-23,Humboldt,023,135768,564,553,1,554,7
2020-10-23,Imperial,025,180216,12915,12398,15,12413,333
2020-10-23,Inyo,027,18085,244,226,5,231,14
2020-10-23,Kern,029,883053,33932,33077,417,33494,431
2020-10-23,Kings,031,150075,8708,8218,55,8273,82
2020-10-23,Lake,033,64148,715,689,0,689,15
2020-10-23,Lassen,035,31185,774,764,2,766,0
2020-10-23,Los Angeles,037,10098052,301294,294287,2842,297129,6956
2020-10-23,Madera,039,155013,5052,4888,38,4926,53
2020-10-23,Marin,041,260295,7133,7029,19,7048,102
2020-10-23,Mariposa,043,17540,80,77,0,77,2
2020-10-23,Mendocino,045,87422,1073,1019,4,1023,20
2020-10-23,Merced,047,269075,9533,9327,36,9363,149
2020-10-23,Modoc,049,8938,38,28,0,28,0
2020-10-23,Mono,051,14174,194,159,5,164,1
2020-10-23,Monterey,053,433212,11374,11099,56,11155,86
2020-10-23,Napa,055,140530,2036,1942,8,1950,14
2020-10-23,Nevada,057,99092,641,604,20,624,8
2020-10-23,Orange,059,3164182,60634,57595,1763,59358,1430
2020-10-23,Placer,061,380077,4355,4073,15,4088,57
2020-10-23,Plumas,063,18699,75,63,0,63,0
2020-10-23,Riverside,065,2383286,67400,65512,359,65871,1279
2020-10-23,Sacramento,067,1510023,25693,25224,28,25252,496
2020-10-23,San Benito,069,59416,1430,1412,1,1413,15
2020-10-23,San Bernardino,071,2135413,63732,60854,430,61284,1150
2020-10-23,San Diego,073,3302833,56286,53944,1516,55460,867
2020-10-23,San Francisco,075,870044,12275,12015,50,12065,137
2020-10-23,San Joaquin,077,732212,21905,21361,195,21556,495
2020-10-23,San Luis Obispo,079,281455,4365,4102,29,4131,31
2020-10-23,San Mateo,081,765935,11362,10872,12,10884,155
2020-10-23,Santa Barbara,083,443738,9931,9751,94,9845,121
2020-10-23,Santa Clara,085,1922200,25379,23822,51,23873,364
2020-10-23,Santa Cruz,087,273765,2873,2757,34,2791,24
2020-10-23,Shasta,089,179085,2157,1846,19,1865,29
2020-10-23,Sierra,091,2930,6,6,0,6,0
2020-10-23,Siskiyou,093,43540,201,172,10,182,0
2020-10-23,Solano,095,438530,7392,7174,42,7216,59
2020-10-23,Sonoma,097,501317,9570,9112,27,9139,139
2020-10-23,Stanislaus,099,539301,17738,17496,738,18234,395
2020-10-23,Sutter,101,95872,1856,1797,1,1798,12
2020-10-23,Tehama,103,63373,916,862,2,864,5
2020-10-23,Trinity,105,12862,85,26,11,37,0
2020-10-23,Tulare,107,460477,17954,17334,350,17684,295
2020-10-23,Tuolumne,109,53932,279,254,4,258,4
2020-10-23,Ventura,111,848112,14943,14192,324,14516,155
2020-10-23,Yolo,113,214977,3263,3140,10,3150,57
2020-10-23,Yuba,115,75493,1254,1206,6,1212,10
2020-10-22,Alameda,001,1643700,23598,22915,224,23139,393
2020-10-22,Alpine,003,1148,3,3,0,3,0
2020-10-22,Amador,005,37829,339,317,0,317,16
2020-10-22,Butte,007,227075,3188,3046,32,3078,55
2020-10-22,Calaveras,009,45235,333,273,0,273,13
2020-10-22,Colusa,011,21464,550,547,1,548,6
2020-10-22,Contra Costa,013,1133247,18965,18393,93,18486,243
2020-10-22,Del Norte,015,27424,173,168,0,168,2
2020-10-22,El Dorado,017,186661,1396,1308,10,1318,4
2020-10-22,Fresno,019,978130,33413,30471,469,30940,438
2020-10-22,Glenn,021,27897,672,643,1,644,3
2020-10-22,Humboldt,023,135768,562,548,1,549,7
2020-10-22,Imperial,025,180216,12862,12311,15,12326,333
2020-10-22,Inyo,027,18085,241,220,5,225,14
2020-10-22,Kern,029,883053,33851,32991,414,33405,431
2020-10-22,Kings,031,150075,8457,8201,55,8256,82
2020-10-22,Lake,033,64148,711,678,0,678,15
2020-10-22,Lassen,035,31185,771,764,2,766,0
2020-10-22,Los Angeles,037,10098052,299918,291599,2783,294382,6935
2020-10-22,Madera,039,155013,5031,4847,38,4885,52
2020-10-22,Marin,041,260295,7126,7014,19,7033,102
2020-10-22,Mariposa,043,17540,80,77,0,77,2
2020-10-22,Mendocino,045,87422,1068,1016,4,1020,20
2020-10-22,Merced,047,269075,9505,9323,36,9359,149
2020-10-22,Modoc,049,8938,34,26,0,26,0
2020-10-22,Mono,051,14174,189,156,5,161,1
2020-10-22,Monterey,053,433212,11315,11059,53,11112,84
2020-10-22,Napa,055,140530,2021,1928,8,1936,14
2020-10-22,Nevada,057,99092,635,600,20,620,8
2020-10-22,Orange,059,3164182,60419,57418,1746,59164,1422
2020-10-22,Placer,061,380077,4306,4036,15,4051,57
2020-10-22,Plumas,063,18699,72,62,0,62,0
2020-10-22,Riverside,065,2383286,67064,65104,339,65443,1279
2020-10-22,Sacramento,067,1510023,25553,25054,28,25082,492
2020-10-22,San Benito,069,59416,1426,1403,1,1404,15
2020-10-22,San Bernardino,071,2135413,63329,60402,415,60817,1149
2020-10-22,San Diego,073,3302833,55899,53514,1497,55011,866
2020-10-22,San Francisco,075,870044,12217,11991,48,12039,137
2020-10-22,San Joaquin,077,732212,21832,21282,189,21471,495
2020-10-22,San Luis Obispo,079,281455,4349,4081,29,4110,31
2020-10-22,San Mateo,081,765935,11306,10796,12,10808,155
2020-10-22,Santa Barbara,083,443738,9897,9710,92,9802,120
2020-10-22,Santa Clara,085,1922200,25225,23621,51,23672,363
2020-10-22,Santa Cruz,087,273765,2855,2738,33,2771,24
2020-10-22,Shasta,089,179085,2111,1799,19,1818,29
2020-10-22,Sierra,091,2930,6,6,0,6,0
2020-10-22,Siskiyou,093,43540,201,169,10,179,0
2020-10-22,Solano,095,438530,7346,7116,42,7158,59
2020-10-22,Sonoma,097,501317,9504,9052,26,9078,139
2020-10-22,Stanislaus,099,539301,17684,17440,726,18166,395
2020-10-22,Sutter,101,95872,1842,1794,1,1795,12
2020-10-22,Tehama,103,63373,905,852,2,854,5
2020-10-22,Trinity,105,12862,84,26,11,37,0
2020-10-22,Tulare,107,460477,17888,17265,337,17602,293
2020-10-22,Tuolumne,109,53932,277,252,4,256,4
2020-10-22,Ventura,111,848112,14896,14124,322,14446,154
2020-10-22,Yolo,113,214977,3251,3116,10,3126,58
2020-10-22,Yuba,115,75493,1247,1199,5,1204,10
2020-10-21,Alameda,001,1643700,23510,22853,222,23075,392
2020-10-21,Alpine,003,1148,3,3,0,3,0
2020-10-21,Amador,005,37829,334,313,0,313,16
2020-10-21,Butte,007,227075,3176,3041,32,3073,55
2020-10-21,Calaveras,009,45235,332,272,0,272,13
2020-10-21,Colusa,011,21464,550,546,1,547,6
2020-10-21,Contra Costa,013,1133247,18891,18299,93,18392,243
2020-10-21,Del Norte,015,27424,173,169,0,169,2
2020-10-21,El Dorado,017,186661,1384,1305,9,1314,4
2020-10-21,Fresno,019,978130,33317,30328,464,30792,433
2020-10-21,Glenn,021,27897,667,640,1,641,3
2020-10-21,Humboldt,023,135768,561,548,1,549,7
2020-10-21,Imperial,025,180216,12805,12210,15,12225,331
2020-10-21,Inyo,027,18085,237,220,5,225,14
2020-10-21,Kern,029,883053,33776,32956,412,33368,430
2020-10-21,Kings,031,150075,8430,8186,55,8241,80
2020-10-21,Lake,033,64148,710,676,0,676,15
2020-10-21,Lassen,035,31185,770,764,2,766,0
2020-10-21,Los Angeles,037,10098052,298578,288096,2741,290837,6923
2020-10-21,Madera,039,155013,5006,4831,38,4869,52
2020-10-21,Marin,041,260295,7117,7002,19,7021,102
2020-10-21,Mariposa,043,17540,80,77,0,77,2
2020-10-21,Mendocino,045,87422,1066,1011,4,1015,21
2020-10-21,Merced,047,269075,9481,9319,34,9353,149
2020-10-21,Modoc,049,8938,33,26,0,26,0
2020-10-21,Mono,051,14174,187,156,5,161,1
2020-10-21,Monterey,053,433212,11277,11005,52,11057,83
2020-10-21,Napa,055,140530,2006,1918,8,1926,13
2020-10-21,Nevada,057,99092,629,597,20,617,8
2020-10-21,Orange,059,3164182,60207,57189,1737,58926,1409
2020-10-21,Placer,061,380077,4269,4007,15,4022,56
2020-10-21,Plumas,063,18699,69,58,0,58,0
2020-10-21,Riverside,065,2383286,66768,64778,315,65093,1278
2020-10-21,Sacramento,067,1510023,25360,24908,28,24936,490
2020-10-21,San Benito,069,59416,1425,1401,1,1402,14
2020-10-21,San Bernardino,071,2135413,62920,59948,408,60356,1141
2020-10-21,San Diego,073,3302833,55547,53279,1469,54748,863
2020-10-21,San Francisco,075,870044,12168,11976,47,12023,137
2020-10-21,San Joaquin,077,732212,21756,21201,183,21384,495
2020-10-21,San Luis Obispo,079,281455,4322,4055,27,4082,31
2020-10-21,San Mateo,081,765935,11257,10730,12,10742,155
2020-10-21,Santa Barbara,083,443738,9879,9681,91,9772,121
2020-10-21,Santa Clara,085,1922200,25099,23537,51,23588,361
2020-10-21,Santa Cruz,087,273765,2832,2729,33,2762,24
2020-10-21,Shasta,089,179085,2075,1777,19,1796,27
2020-10-21,Sierra,091,2930,6,6,0,6,0
2020-10-21,Siskiyou,093,43540,197,169,10,179,0
2020-10-21,Solano,095,438530,7300,7088,42,7130,59
2020-10-21,Sonoma,097,501317,9424,8987,26,9013,138
2020-10-21,Stanislaus,099,539301,17634,17419,718,18137,392
2020-10-21,Sutter,101,95872,1828,1786,1,1787,12
2020-10-21,Tehama,103,63373,889,824,2,826,5
2020-10-21,Trinity,105,12862,78,25,10,35,0
2020-10-21,Tulare,107,460477,17850,17204,323,17527,292
2020-10-21,Tuolumne,109,53932,276,251,4,255,4
2020-10-21,Ventura,111,848112,14833,14050,319,14369,153
2020-10-21,Yolo,113,214977,3232,3095,10,3105,58
2020-10-21,Yuba,115,75493,1238,1194,5,1199,10
2020-10-20,Alameda,001,1643700,23407,22750,218,22968,391
2020-10-20,Alpine,003,1148,3,3,0,3,0
2020-10-20,Amador,005,37829,333,313,0,313,16
2020-10-20,Butte,007,227075,3164,3027,32,3059,56
2020-10-20,Calaveras,009,45235,331,273,0,273,13
2020-10-20,Colusa,011,21464,547,546,1,547,6
2020-10-20,Contra Costa,013,1133247,18799,18246,93,18339,241
2020-10-20,Del Norte,015,27424,172,169,0,169,2
2020-10-20,El Dorado,017,186661,1378,1295,9,1304,4
2020-10-20,Fresno,019,978130,33214,30220,458,30678,431
2020-10-20,Glenn,021,27897,662,638,1,639,3
2020-10-20,Humboldt,023,135768,557,545,1,546,7
2020-10-20,Imperial,025,180216,12737,12114,15,12129,330
2020-10-20,Inyo,027,18085,237,218,5,223,14
2020-10-20,Kern,029,883053,33701,32889,399,33288,429
2020-10-20,Kings,031,150075,8412,8178,54,8232,80
2020-10-20,Lake,033,64148,708,675,0,675,15
2020-10-20,Lassen,035,31185,769,757,2,759,0
2020-10-20,Los Angeles,037,10098052,297085,287727,2691,290418,6891
2020-10-20,Madera,039,155013,4989,4823,38,4861,52
2020-10-20,Marin,041,260295,7102,6994,19,7013,101
2020-10-20,Mariposa,043,17540,79,77,0,77,2
2020-10-20,Mendocino,045,87422,1064,1004,4,1008,21
2020-10-20,Merced,047,269075,9459,9323,34,9357,149
2020-10-20,Modoc,049,8938,32,26,0,26,0
2020-10-20,Mono,051,14174,187,156,5,161,1
2020-10-20,Monterey,053,433212,11234,10942,49,10991,81
2020-10-20,Napa,055,140530,1987,1912,8,1920,13
2020-10-20,Nevada,057,99092,619,596,20,616,8
2020-10-20,Orange,059,3164182,59943,56914,1727,58641,1397
2020-10-20,Placer,061,380077,4231,3997,15,4012,56
2020-10-20,Plumas,063,18699,66,53,0,53,0
2020-10-20,Riverside,065,2383286,66389,64452,303,64755,1275
2020-10-20,Sacramento,067,1510023,25232,24767,27,24794,485
2020-10-20,San Benito,069,59416,1422,1398,1,1399,14
2020-10-20,San Bernardino,071,2135413,62536,59571,406,59977,1109
2020-10-20,San Diego,073,3302833,55211,53004,1449,54453,857
2020-10-20,San Francisco,075,870044,12121,12013,46,12059,126
2020-10-20,San Joaquin,077,732212,21677,21173,173,21346,490
2020-10-20,San Luis Obispo,079,281455,4304,4043,26,4069,31
2020-10-20,San Mateo,081,765935,11210,10659,12,10671,155
2020-10-20,Santa Barbara,083,443738,9850,9664,89,9753,121
2020-10-20,Santa Clara,085,1922200,24962,23406,51,23457,358
2020-10-20,Santa Cruz,087,273765,2809,2710,33,2743,23
2020-10-20,Shasta,089,179085,2052,1747,19,1766,20
2020-10-20,Sierra,091,2930,6,6,0,6,0
2020-10-20,Siskiyou,093,43540,189,168,10,178,0
2020-10-20,Solano,095,438530,7251,7044,42,7086,57
2020-10-20,Sonoma,097,501317,9361,8904,24,8928,135
2020-10-20,Stanislaus,099,539301,17580,17367,714,18081,393
2020-10-20,Sutter,101,95872,1819,1783,1,1784,12
2020-10-20,Tehama,103,63373,874,813,2,815,5
2020-10-20,Trinity,105,12862,77,25,10,35,0
2020-10-20,Tulare,107,460477,17783,17156,318,17474,289
2020-10-20,Tuolumne,109,53932,274,250,4,254,4
2020-10-20,Ventura,111,848112,14769,13980,317,14297,152
2020-10-20,Yolo,113,214977,3209,3083,10,3093,56
2020-10-20,Yuba,115,75493,1228,1191,5,1196,10
2020-10-19,Alameda,001,1643700,23297,22647,217,22864,392
2020-10-19,Alpine,003,1148,3,3,0,3,0
2020-10-19,Amador,005,37829,327,313,0,313,16
2020-10-19,Butte,007,227075,3153,3026,32,3058,55
2020-10-19,Calaveras,009,45235,330,268,0,268,13
2020-10-19,Colusa,011,21464,547,544,1,545,6
2020-10-19,Contra Costa,013,1133247,18701,18173,93,18266,239
2020-10-19,Del Norte,015,27424,169,167,0,167,2
2020-10-19,El Dorado,017,186661,1357,1287,9,1296,4
2020-10-19,Fresno,019,978130,33105,30152,452,30604,431
2020-10-19,Glenn,021,27897,657,635,0,635,3
2020-10-19,Humboldt,023,135768,557,543,1,544,7
2020-10-19,Imperial,025,180216,12683,12036,14,12050,330
2020-10-19,Inyo,027,18085,236,218,5,223,14
2020-10-19,Kern,029,883053,33625,32840,396,33236,428
2020-10-19,Kings,031,150075,8394,8173,54,8227,80
2020-10-19,Lake,033,64148,705,673,0,673,15
2020-10-19,Lassen,035,31185,768,757,2,759,0
2020-10-19,Los Angeles,037,10098052,295599,287119,2653,289772,6858
2020-10-19,Madera,039,155013,4974,4787,38,4825,52
2020-10-19,Marin,041,260295,7084,6981,19,7000,100
2020-10-19,Mariposa,043,17540,79,77,0,77,2
2020-10-19,Mendocino,045,87422,1059,1001,4,1005,21
2020-10-19,Merced,047,269075,9434,9305,30,9335,148
2020-10-19,Modoc,049,8938,31,26,0,26,0
2020-10-19,Mono,051,14174,182,156,5,161,1
2020-10-19,Monterey,053,433212,11173,10907,49,10956,80
2020-10-19,Napa,055,140530,1975,1892,8,1900,12
2020-10-19,Nevada,057,99092,616,590,20,610,8
2020-10-19,Orange,059,3164182,59660,56652,1712,58364,1396
2020-10-19,Placer,061,380077,4182,3962,15,3977,49
2020-10-19,Plumas,063,18699,64,52,0,52,0
2020-10-19,Riverside,065,2383286,65958,64016,287,64303,1272
2020-10-19,Sacramento,067,1510023,25094,24542,27,24569,483
2020-10-19,San Benito,069,59416,1415,1395,1,1396,14
2020-10-19,San Bernardino,071,2135413,62084,59265,394,59659,1100
2020-10-19,San Diego,073,3302833,54825,52739,1424,54163,853
2020-10-19,San Francisco,075,870044,12077,11879,46,11925,126
2020-10-19,San Joaquin,077,732212,21602,20930,165,21095,489
2020-10-19,San Luis Obispo,079,281455,4288,4016,26,4042,31
2020-10-19,San Mateo,081,765935,11164,10568,12,10580,154
2020-10-19,Santa Barbara,083,443738,9815,9632,89,9721,121
2020-10-19,Santa Clara,085,1922200,24812,23301,51,23352,352
2020-10-19,Santa Cruz,087,273765,2792,2705,33,2738,19
2020-10-19,Shasta,089,179085,2008,1709,18,1727,20
2020-10-19,Sierra,091,2930,6,6,0,6,0
2020-10-19,Siskiyou,093,43540,182,167,10,177,0
2020-10-19,Solano,095,438530,7210,7003,42,7045,57
2020-10-19,Sonoma,097,501317,9274,8830,24,8854,135
2020-10-19,Stanislaus,099,539301,17529,17342,704,18046,390
2020-10-19,Sutter,101,95872,1814,1773,1,1774,12
2020-10-19,Tehama,103,63373,871,793,2,795,5
2020-10-19,Trinity,105,12862,75,23,10,33,0
2020-10-19,Tulare,107,460477,17733,17047,311,17358,291
2020-10-19,Tuolumne,109,53932,272,247,4,251,4
2020-10-19,Ventura,111,848112,14703,13930,314,14244,152
2020-10-19,Yolo,113,214977,3196,3069,10,3079,56
2020-10-19,Yuba,115,75493,1221,1183,5,1188,10
2020-10-18,Alameda,001,1643700,23193,22546,216,22762,392
2020-10-18,Alpine,003,1148,3,3,0,3,0
2020-10-18,Amador,005,37829,316,313,0,313,16
2020-10-18,Butte,007,227075,3140,3019,32,3051,55
2020-10-18,Calaveras,009,45235,329,267,0,267,13
2020-10-18,Colusa,011,21464,545,544,1,545,6
2020-10-18,Contra Costa,013,1133247,18602,18120,93,18213,237
2020-10-18,Del Norte,015,27424,169,167,0,167,2
2020-10-18,El Dorado,017,186661,1348,1283,9,1292,4
2020-10-18,Fresno,019,978130,32976,30051,444,30495,430
2020-10-18,Glenn,021,27897,655,634,0,634,3
2020-10-18,Humboldt,023,135768,554,540,1,541,7
2020-10-18,Imperial,025,180216,12620,11987,13,12000,330
2020-10-18,Inyo,027,18085,233,215,5,220,14
2020-10-18,Kern,029,883053,33552,32799,389,33188,428
2020-10-18,Kings,031,150075,8379,8159,54,8213,80
2020-10-18,Lake,033,64148,698,670,0,670,15
2020-10-18,Lassen,035,31185,768,757,2,759,0
2020-10-18,Los Angeles,037,10098052,293891,286187,2610,288797,6857
2020-10-18,Madera,039,155013,4949,4770,37,4807,52
2020-10-18,Marin,041,260295,7063,6969,19,6988,99
2020-10-18,Mariposa,043,17540,79,77,0,77,2
2020-10-18,Mendocino,045,87422,1057,988,4,992,21
2020-10-18,Merced,047,269075,9399,9292,30,9322,148
2020-10-18,Modoc,049,8938,30,26,0,26,0
2020-10-18,Mono,051,14174,177,155,5,160,1
2020-10-18,Monterey,053,433212,11120,10872,49,10921,80
2020-10-18,Napa,055,140530,1962,1882,8,1890,12
2020-10-18,Nevada,057,99092,610,582,20,602,8
2020-10-18,Orange,059,3164182,59363,56394,1695,58089,1396
2020-10-18,Placer,061,380077,4134,3938,15,3953,49
2020-10-18,Plumas,063,18699,62,52,0,52,0
2020-10-18,Riverside,065,2383286,65645,63765,266,64031,1270
2020-10-18,Sacramento,067,1510023,24938,24425,27,24452,482
2020-10-18,San Benito,069,59416,1408,1395,1,1396,14
2020-10-18,San Bernardino,071,2135413,61585,58893,386,59279,1098
2020-10-18,San Diego,073,3302833,54436,52359,1403,53762,853
2020-10-18,San Francisco,075,870044,12038,11878,46,11924,126
2020-10-18,San Joaquin,077,732212,21519,20931,152,21083,489
2020-10-18,San Luis Obispo,079,281455,4257,4009,24,4033,31
2020-10-18,San Mateo,081,765935,11105,10503,12,10515,154
2020-10-18,Santa Barbara,083,443738,9776,9608,88,9696,121
2020-10-18,Santa Clara,085,1922200,24639,23169,51,23220,352
2020-10-18,Santa Cruz,087,273765,2778,2692,33,2725,19
2020-10-18,Shasta,089,179085,1983,1708,18,1726,20
2020-10-18,Sierra,091,2930,6,6,0,6,0
2020-10-18,Siskiyou,093,43540,182,167,10,177,0
2020-10-18,Solano,095,438530,7163,6962,42,7004,57
2020-10-18,Sonoma,097,501317,9197,8781,23,8804,134
2020-10-18,Stanislaus,099,539301,17473,17290,695,17985,390
2020-10-18,Sutter,101,95872,1805,1764,1,1765,12
2020-10-18,Tehama,103,63373,839,774,2,776,5
2020-10-18,Trinity,105,12862,75,20,10,30,0
2020-10-18,Tulare,107,460477,17639,17048,302,17350,290
2020-10-18,Tuolumne,109,53932,266,245,4,249,4
2020-10-18,Ventura,111,848112,14623,13901,313,14214,151
2020-10-18,Yolo,113,214977,3157,3059,10,3069,55
2020-10-18,Yuba,115,75493,1210,1176,5,1181,10
2020-10-17,Alameda,001,1643700,23147,22394,214,22608,398
2020-10-17,Alpine,003,1148,3,3,0,3,0
2020-10-17,Amador,005,37829,314,309,0,309,16
2020-10-17,Butte,007,227075,3132,3012,30,3042,55
2020-10-17,Calaveras,009,45235,329,267,0,267,13
2020-10-17,Colusa,011,21464,544,544,1,545,6
2020-10-17,Contra Costa,013,1133247,18549,18005,93,18098,237
2020-10-17,Del Norte,015,27424,169,167,0,167,2
2020-10-17,El Dorado,017,186661,1344,1277,9,1286,4
2020-10-17,Fresno,019,978130,32922,29911,442,30353,430
2020-10-17,Glenn,021,27897,652,633,0,633,3
2020-10-17,Humboldt,023,135768,551,535,1,536,7
2020-10-17,Imperial,025,180216,12592,11962,13,11975,330
2020-10-17,Inyo,027,18085,228,212,5,217,14
2020-10-17,Kern,029,883053,33501,32710,386,33096,428
2020-10-17,Kings,031,150075,8373,8151,53,8204,80
2020-10-17,Lake,033,64148,695,663,0,663,15
2020-10-17,Lassen,035,31185,768,757,2,759,0
2020-10-17,Los Angeles,037,10098052,293138,285858,2583,288441,6844
2020-10-17,Madera,039,155013,4943,4759,37,4796,53
2020-10-17,Marin,041,260295,7060,6958,19,6977,99
2020-10-17,Mariposa,043,17540,78,77,0,77,2
2020-10-17,Mendocino,045,87422,1050,977,4,981,21
2020-10-17,Merced,047,269075,9385,9275,30,9305,148
2020-10-17,Modoc,049,8938,30,26,0,26,0
2020-10-17,Mono,051,14174,176,155,5,160,1
2020-10-17,Monterey,053,433212,11080,10807,48,10855,80
2020-10-17,Napa,055,140530,1953,1866,8,1874,12
2020-10-17,Nevada,057,99092,609,580,20,600,8
2020-10-17,Orange,059,3164182,59221,56197,1688,57885,1396
2020-10-17,Placer,061,380077,4107,3898,15,3913,49
2020-10-17,Plumas,063,18699,62,52,0,52,0
2020-10-17,Riverside,065,2383286,65447,63171,256,63427,1270
2020-10-17,Sacramento,067,1510023,24854,24304,27,24331,482
2020-10-17,San Benito,069,59416,1404,1389,1,1390,14
2020-10-17,San Bernardino,071,2135413,61314,58415,379,58794,1097
2020-10-17,San Diego,073,3302833,54211,51986,1392,53378,853
2020-10-17,San Francisco,075,870044,12010,11877,45,11922,126
2020-10-17,San Joaquin,077,732212,21465,20932,146,21078,489
2020-10-17,San Luis Obispo,079,281455,4242,3979,24,4003,31
2020-10-17,San Mateo,081,765935,11077,10423,12,10435,153
2020-10-17,Santa Barbara,083,443738,9757,9588,86,9674,121
2020-10-17,Santa Clara,085,1922200,24550,22997,51,23048,349
2020-10-17,Santa Cruz,087,273765,2764,2680,33,2713,19
2020-10-17,Shasta,089,179085,1957,1679,18,1697,20
2020-10-17,Sierra,091,2930,6,6,0,6,0
2020-10-17,Siskiyou,093,43540,181,167,10,177,0
2020-10-17,Solano,095,438530,7137,6929,42,6971,57
2020-10-17,Sonoma,097,501317,9154,8725,23,8748,134
2020-10-17,Stanislaus,099,539301,17433,17232,686,17918,390
2020-10-17,Sutter,101,95872,1803,1762,1,1763,12
2020-10-17,Tehama,103,63373,823,764,2,766,5
2020-10-17,Trinity,105,12862,75,20,10,30,0
2020-10-17,Tulare,107,460477,17609,16995,293,17288,290
2020-10-17,Tuolumne,109,53932,266,241,4,245,4
2020-10-17,Ventura,111,848112,14578,13845,310,14155,151
2020-10-17,Yolo,113,214977,3142,3045,9,3054,55
2020-10-17,Yuba,115,75493,1205,1164,5,1169,10
2020-10-16,Alameda,001,1643700,23093,22315,214,22529,397
2020-10-16,Alpine,003,1148,3,3,0,3,0
2020-10-16,Amador,005,37829,314,309,0,309,16
2020-10-16,Butte,007,227075,3121,3004,30,3034,54
2020-10-16,Calaveras,009,45235,329,267,0,267,13
2020-10-16,Colusa,011,21464,543,544,1,545,6
2020-10-16,Contra Costa,013,1133247,18496,17956,93,18049,237
2020-10-16,Del Norte,015,27424,169,166,0,166,2
2020-10-16,El Dorado,017,186661,1338,1273,9,1282,4
2020-10-16,Fresno,019,978130,32846,29796,441,30237,427
2020-10-16,Glenn,021,27897,647,632,0,632,3
2020-10-16,Humboldt,023,135768,551,533,1,534,7
2020-10-16,Imperial,025,180216,12552,11885,13,11898,330
2020-10-16,Inyo,027,18085,224,212,5,217,14
2020-10-16,Kern,029,883053,33458,32660,384,33044,428
2020-10-16,Kings,031,150075,8364,8146,52,8198,80
2020-10-16,Lake,033,64148,693,644,0,644,14
2020-10-16,Lassen,035,31185,768,757,2,759,0
2020-10-16,Los Angeles,037,10098052,292076,284988,2562,287550,6835
2020-10-16,Madera,039,155013,4931,4736,36,4772,53
2020-10-16,Marin,041,260295,7050,6933,19,6952,99
2020-10-16,Mariposa,043,17540,78,76,0,76,2
2020-10-16,Mendocino,045,87422,1043,974,4,978,21
2020-10-16,Merced,047,269075,9368,9246,30,9276,148
2020-10-16,Modoc,049,8938,30,26,0,26,0
2020-10-16,Mono,051,14174,174,155,5,160,1
2020-10-16,Monterey,053,433212,11045,10727,48,10775,79
2020-10-16,Napa,055,140530,1944,1855,8,1863,12
2020-10-16,Nevada,057,99092,607,579,20,599,8
2020-10-16,Orange,059,3164182,59043,56091,1681,57772,1388
2020-10-16,Placer,061,380077,4087,3864,15,3879,49
2020-10-16,Plumas,063,18699,61,52,0,52,0
2020-10-16,Riverside,065,2383286,65221,62986,255,63241,1267
2020-10-16,Sacramento,067,1510023,24760,24144,27,24171,479
2020-10-16,San Benito,069,59416,1401,1388,1,1389,14
2020-10-16,San Bernardino,071,2135413,61045,58233,379,58612,1069
2020-10-16,San Diego,073,3302833,53969,51785,1378,53163,850
2020-10-16,San Francisco,075,870044,11988,11840,44,11884,126
2020-10-16,San Joaquin,077,732212,21420,20910,145,21055,489
2020-10-16,San Luis Obispo,079,281455,4226,3952,24,3976,32
2020-10-16,San Mateo,081,765935,11051,10405,12,10417,153
2020-10-16,Santa Barbara,083,443738,9738,9549,86,9635,119
2020-10-16,Santa Clara,085,1922200,24462,22920,51,22971,345
2020-10-16,Santa Cruz,087,273765,2751,2666,33,2699,20
2020-10-16,Shasta,089,179085,1935,1660,18,1678,20
2020-10-16,Sierra,091,2930,6,6,0,6,0
2020-10-16,Siskiyou,093,43540,179,167,10,177,0
2020-10-16,Solano,095,438530,7114,6879,42,6921,55
2020-10-16,Sonoma,097,501317,9098,8652,23,8675,133
2020-10-16,Stanislaus,099,539301,17399,17201,678,17879,366
2020-10-16,Sutter,101,95872,1795,1756,1,1757,12
2020-10-16,Tehama,103,63373,822,737,2,739,3
2020-10-16,Trinity,105,12862,75,20,10,30,0
2020-10-16,Tulare,107,460477,17577,16965,285,17250,290
2020-10-16,Tuolumne,109,53932,264,237,4,241,4
2020-10-16,Ventura,111,848112,14535,13805,305,14110,152
2020-10-16,Yolo,113,214977,3133,3030,9,3039,55
2020-10-16,Yuba,115,75493,1205,1155,5,1160,10
2020-10-15,Alameda,001,1643700,23025,22267,213,22480,390
2020-10-15,Alpine,003,1148,3,3,0,3,0
2020-10-15,Amador,005,37829,314,309,0,309,16
2020-10-15,Butte,007,227075,3109,3000,29,3029,54
2020-10-15,Calaveras,009,45235,328,267,0,267,13
2020-10-15,Colusa,011,21464,542,543,1,544,6
2020-10-15,Contra Costa,013,1133247,18429,17893,92,17985,237
2020-10-15,Del Norte,015,27424,169,164,0,164,2
2020-10-15,El Dorado,017,186661,1333,1265,9,1274,4
2020-10-15,Fresno,019,978130,32749,29727,438,30165,425
2020-10-15,Glenn,021,27897,642,632,0,632,3
2020-10-15,Humboldt,023,135768,547,531,1,532,7
2020-10-15,Imperial,025,180216,12511,11820,12,11832,330
2020-10-15,Inyo,027,18085,224,210,5,215,14
2020-10-15,Kern,029,883053,33377,32593,381,32974,427
2020-10-15,Kings,031,150075,8349,8134,52,8186,80
2020-10-15,Lake,033,64148,691,642,0,642,14
2020-10-15,Lassen,035,31185,767,752,2,754,0
2020-10-15,Los Angeles,037,10098052,290790,284019,2528,286547,6807
2020-10-15,Madera,039,155013,4919,4723,35,4758,50
2020-10-15,Marin,041,260295,7042,6912,19,6931,99
2020-10-15,Mariposa,043,17540,78,76,0,76,2
2020-10-15,Mendocino,045,87422,1037,963,4,967,21
2020-10-15,Merced,047,269075,9341,9213,30,9243,147
2020-10-15,Modoc,049,8938,30,26,0,26,0
2020-10-15,Mono,051,14174,174,155,5,160,1
2020-10-15,Monterey,053,433212,10978,10677,47,10724,79
2020-10-15,Napa,055,140530,1931,1842,8,1850,12
2020-10-15,Nevada,057,99092,603,575,20,595,8
2020-10-15,Orange,059,3164182,58827,55952,1669,57621,1379
2020-10-15,Placer,061,380077,4058,3848,15,3863,48
2020-10-15,Plumas,063,18699,58,52,0,52,0
2020-10-15,Riverside,065,2383286,64888,62819,252,63071,1266
2020-10-15,Sacramento,067,1510023,24644,24068,27,24095,474
2020-10-15,San Benito,069,59416,1398,1384,1,1385,14
2020-10-15,San Bernardino,071,2135413,60705,58068,376,58444,1067
2020-10-15,San Diego,073,3302833,53685,51472,1362,52834,847
2020-10-15,San Francisco,075,870044,11960,11808,41,11849,126
2020-10-15,San Joaquin,077,732212,21347,20880,139,21019,487
2020-10-15,San Luis Obispo,079,281455,4209,3934,24,3958,32
2020-10-15,San Mateo,081,765935,11011,10340,12,10352,152
2020-10-15,Santa Barbara,083,443738,9714,9526,85,9611,117
2020-10-15,Santa Clara,085,1922200,24347,22808,51,22859,343
2020-10-15,Santa Cruz,087,273765,2737,2656,33,2689,13
2020-10-15,Shasta,089,179085,1924,1635,18,1653,20
2020-10-15,Sierra,091,2930,6,6,0,6,0
2020-10-15,Siskiyou,093,43540,175,166,10,176,0
2020-10-15,Solano,095,438530,7075,6830,42,6872,55
2020-10-15,Sonoma,097,501317,9006,8571,23,8594,133
2020-10-15,Stanislaus,099,539301,17361,17151,664,17815,366
2020-10-15,Sutter,101,95872,1792,1752,1,1753,12
2020-10-15,Tehama,103,63373,795,726,2,728,3
2020-10-15,Trinity,105,12862,75,20,10,30,0
2020-10-15,Tulare,107,460477,17517,16918,270,17188,289
2020-10-15,Tuolumne,109,53932,262,236,4,240,4
2020-10-15,Ventura,111,848112,14479,13750,300,14050,152
2020-10-15,Yolo,113,214977,3113,3014,9,3023,55
2020-10-15,Yuba,115,75493,1198,1151,5,1156,10
2020-10-14,Alameda,001,1643700,22926,22227,212,22439,398
2020-10-14,Alpine,003,1148,3,3,0,3,0
2020-10-14,Amador,005,37829,312,308,0,308,16
2020-10-14,Butte,007,227075,3101,2995,29,3024,54
2020-10-14,Calaveras,009,45235,328,266,0,266,12
2020-10-14,Colusa,011,21464,542,543,1,544,6
2020-10-14,Contra Costa,013,1133247,18372,17820,90,17910,236
2020-10-14,Del Norte,015,27424,168,163,0,163,2
2020-10-14,El Dorado,017,186661,1327,1264,8,1272,4
2020-10-14,Fresno,019,978130,32634,29650,432,30082,424
2020-10-14,Glenn,021,27897,641,629,0,629,3
2020-10-14,Humboldt,023,135768,544,531,1,532,7
2020-10-14,Imperial,025,180216,12474,11765,10,11775,330
2020-10-14,Inyo,027,18085,223,209,4,213,14
2020-10-14,Kern,029,883053,33302,32528,379,32907,425
2020-10-14,Kings,031,150075,8331,8118,52,8170,80
2020-10-14,Lake,033,64148,690,642,0,642,14
2020-10-14,Lassen,035,31185,765,752,2,754,0
2020-10-14,Los Angeles,037,10098052,289477,282918,2484,285402,6786
2020-10-14,Madera,039,155013,4904,4713,34,4747,50
2020-10-14,Marin,041,260295,7036,6907,19,6926,99
2020-10-14,Mariposa,043,17540,77,76,0,76,2
2020-10-14,Mendocino,045,87422,1031,955,4,959,21
2020-10-14,Merced,047,269075,9316,9201,28,9229,147
2020-10-14,Modoc,049,8938,30,27,0,27,0
2020-10-14,Mono,051,14174,174,155,5,160,1
2020-10-14,Monterey,053,433212,10928,10616,47,10663,78
2020-10-14,Napa,055,140530,1914,1837,8,1845,12
2020-10-14,Nevada,057,99092,601,573,20,593,7
2020-10-14,Orange,059,3164182,58613,55756,1660,57416,1348
2020-10-14,Placer,061,380077,4035,3829,15,3844,48
2020-10-14,Plumas,063,18699,54,52,0,52,0
2020-10-14,Riverside,065,2383286,64605,62607,251,62858,1261
2020-10-14,Sacramento,067,1510023,24500,24013,27,24040,472
2020-10-14,San Benito,069,59416,1396,1381,0,1381,14
2020-10-14,San Bernardino,071,2135413,60378,57774,372,58146,1063
2020-10-14,San Diego,073,3302833,53366,51329,1338,52667,844
2020-10-14,San Francisco,075,870044,11928,11783,40,11823,123
2020-10-14,San Joaquin,077,732212,21268,20845,125,20970,487
2020-10-14,San Luis Obispo,079,281455,4186,3901,23,3924,32
2020-10-14,San Mateo,081,765935,10960,10309,12,10321,132
2020-10-14,Santa Barbara,083,443738,9680,9509,85,9594,117
2020-10-14,Santa Clara,085,1922200,24198,22735,51,22786,343
2020-10-14,Santa Cruz,087,273765,2727,2618,33,2651,13
2020-10-14,Shasta,089,179085,1886,1553,18,1571,20
2020-10-14,Sierra,091,2930,6,6,0,6,0
2020-10-14,Siskiyou,093,43540,175,166,10,176,0
2020-10-14,Solano,095,438530,7019,6786,42,6828,55
2020-10-14,Sonoma,097,501317,8953,8514,23,8537,133
2020-10-14,Stanislaus,099,539301,17316,17105,661,17766,365
2020-10-14,Sutter,101,95872,1783,1747,1,1748,12
2020-10-14,Tehama,103,63373,784,721,2,723,3
2020-10-14,Trinity,105,12862,74,20,10,30,0
2020-10-14,Tulare,107,460477,17455,16863,257,17120,287
2020-10-14,Tuolumne,109,53932,261,236,4,240,4
2020-10-14,Ventura,111,848112,14426,13697,296,13993,152
2020-10-14,Yolo,113,214977,3095,3007,8,3015,55
2020-10-14,Yuba,115,75493,1190,1147,5,1152,10
2020-10-13,Alameda,001,1643700,22821,22185,210,22395,389
2020-10-13,Alpine,003,1148,3,3,0,3,0
2020-10-13,Amador,005,37829,310,306,0,306,16
2020-10-13,Butte,007,227075,3092,2992,29,3021,54
2020-10-13,Calaveras,009,45235,324,262,0,262,12
2020-10-13,Colusa,011,21464,542,541,1,542,6
2020-10-13,Contra Costa,013,1133247,18314,17783,90,17873,234
2020-10-13,Del Norte,015,27424,168,163,0,163,2
2020-10-13,El Dorado,017,186661,1318,1262,8,1270,4
2020-10-13,Fresno,019,978130,32512,29579,428,30007,424
2020-10-13,Glenn,021,27897,640,629,0,629,3
2020-10-13,Humboldt,023,135768,542,523,1,524,7
2020-10-13,Imperial,025,180216,12439,11727,9,11736,327
2020-10-13,Inyo,027,18085,220,207,4,211,14
2020-10-13,Kern,029,883053,33227,32497,377,32874,419
2020-10-13,Kings,031,150075,8322,8111,52,8163,80
2020-10-13,Lake,033,64148,687,639,0,639,12
2020-10-13,Lassen,035,31185,763,752,2,754,0
2020-10-13,Los Angeles,037,10098052,288198,281716,2442,284158,6767
2020-10-13,Madera,039,155013,4886,4700,34,4734,50
2020-10-13,Marin,041,260295,7014,6900,18,6918,97
2020-10-13,Mariposa,043,17540,77,76,0,76,2
2020-10-13,Mendocino,045,87422,1022,950,4,954,21
2020-10-13,Merced,047,269075,9299,9181,28,9209,146
2020-10-13,Modoc,049,8938,29,28,0,28,0
2020-10-13,Mono,051,14174,174,155,4,159,1
2020-10-13,Monterey,053,433212,10867,10574,46,10620,78
2020-10-13,Napa,055,140530,1905,1825,8,1833,12
2020-10-13,Nevada,057,99092,594,572,20,592,7
2020-10-13,Orange,059,3164182,58400,55515,1647,57162,1326
2020-10-13,Placer,061,380077,3997,3825,15,3840,48
2020-10-13,Plumas,063,18699,52,51,0,51,0
2020-10-13,Riverside,065,2383286,64285,62279,249,62528,1254
2020-10-13,Sacramento,067,1510023,24423,23930,27,23957,466
2020-10-13,San Benito,069,59416,1388,1380,0,1380,14
2020-10-13,San Bernardino,071,2135413,60039,57411,370,57781,1061
2020-10-13,San Diego,073,3302833,53073,51026,1321,52347,840
2020-10-13,San Francisco,075,870044,11893,11659,40,11699,122
2020-10-13,San Joaquin,077,732212,21207,20822,121,20943,481
2020-10-13,San Luis Obispo,079,281455,4168,3892,22,3914,32
2020-10-13,San Mateo,081,765935,10917,10286,12,10298,130
2020-10-13,Santa Barbara,083,443738,9649,9489,85,9574,117
2020-10-13,Santa Clara,085,1922200,24071,22678,51,22729,343
2020-10-13,Santa Cruz,087,273765,2709,2603,33,2636,13
2020-10-13,Shasta,089,179085,1862,1606,18,1624,20
2020-10-13,Sierra,091,2930,6,6,0,6,0
2020-10-13,Siskiyou,093,43540,174,163,10,173,0
2020-10-13,Solano,095,438530,6984,6761,42,6803,55
2020-10-13,Sonoma,097,501317,8870,8456,23,8479,133
2020-10-13,Stanislaus,099,539301,17271,17082,656,17738,362
2020-10-13,Sutter,101,95872,1774,1748,1,1749,12
2020-10-13,Tehama,103,63373,776,717,2,719,3
2020-10-13,Trinity,105,12862,70,19,9,28,0
2020-10-13,Tulare,107,460477,17396,16822,249,17071,286
2020-10-13,Tuolumne,109,53932,259,235,4,239,4
2020-10-13,Ventura,111,848112,14371,13645,292,13937,151
2020-10-13,Yolo,113,214977,3087,2983,7,2990,55
2020-10-13,Yuba,115,75493,1185,1143,5,1148,10
2020-10-12,Alameda,001,1643700,22741,22126,209,22335,389
2020-10-12,Alpine,003,1148,3,3,0,3,0
2020-10-12,Amador,005,37829,309,305,0,305,16
2020-10-12,Butte,007,227075,3086,2975,29,3004,54
2020-10-12,Calaveras,009,45235,324,262,0,262,12
2020-10-12,Colusa,011,21464,542,541,1,542,6
2020-10-12,Contra Costa,013,1133247,18239,17728,90,17818,233
2020-10-12,Del Norte,015,27424,168,161,0,161,2
2020-10-12,El Dorado,017,186661,1315,1254,8,1262,4
2020-10-12,Fresno,019,978130,32379,29523,424,29947,421
2020-10-12,Glenn,021,27897,639,626,0,626,3
2020-10-12,Humboldt,023,135768,539,522,1,523,7
2020-10-12,Imperial,025,180216,12400,11689,9,11698,328
2020-10-12,Inyo,027,18085,217,201,4,205,14
2020-10-12,Kern,029,883053,33134,32425,374,32799,419
2020-10-12,Kings,031,150075,8316,8106,51,8157,80
2020-10-12,Lake,033,64148,681,633,0,633,12
2020-10-12,Lassen,035,31185,763,752,2,754,0
2020-10-12,Los Angeles,037,10098052,286978,280961,2415,283376,6747
2020-10-12,Madera,039,155013,4867,4689,34,4723,50
2020-10-12,Marin,041,260295,6997,6886,18,6904,97
2020-10-12,Mariposa,043,17540,77,76,0,76,2
2020-10-12,Mendocino,045,87422,1016,947,4,951,21
2020-10-12,Merced,047,269075,9278,9141,28,9169,146
2020-10-12,Modoc,049,8938,29,27,0,27,0
2020-10-12,Mono,051,14174,174,154,4,158,1
2020-10-12,Monterey,053,433212,10801,10473,46,10519,77
2020-10-12,Napa,055,140530,1897,1819,8,1827,11
2020-10-12,Nevada,057,99092,590,570,20,590,7
2020-10-12,Orange,059,3164182,58171,55373,1637,57010,1326
2020-10-12,Placer,061,380077,3965,3808,14,3822,48
2020-10-12,Plumas,063,18699,52,51,0,51,0
2020-10-12,Riverside,065,2383286,63974,62279,245,62524,1254
2020-10-12,Sacramento,067,1510023,24317,23807,27,23834,466
2020-10-12,San Benito,069,59416,1385,1376,0,1376,13
2020-10-12,San Bernardino,071,2135413,59662,57235,369,57604,1061
2020-10-12,San Diego,073,3302833,52783,50748,1294,52042,826
2020-10-12,San Francisco,075,870044,11861,11659,40,11699,122
2020-10-12,San Joaquin,077,732212,21144,20701,115,20816,480
2020-10-12,San Luis Obispo,079,281455,4140,3874,22,3896,32
2020-10-12,San Mateo,081,765935,10869,10262,12,10274,130
2020-10-12,Santa Barbara,083,443738,9611,9462,85,9547,117
2020-10-12,Santa Clara,085,1922200,23955,22578,51,22629,343
2020-10-12,Santa Cruz,087,273765,2692,2590,33,2623,13
2020-10-12,Shasta,089,179085,1837,1515,18,1533,20
2020-10-12,Sierra,091,2930,6,6,0,6,0
2020-10-12,Siskiyou,093,43540,173,162,10,172,0
2020-10-12,Solano,095,438530,6945,6742,42,6784,55
2020-10-12,Sonoma,097,501317,8799,8377,23,8400,133
2020-10-12,Stanislaus,099,539301,17222,17051,647,17698,361
2020-10-12,Sutter,101,95872,1766,1741,1,1742,12
2020-10-12,Tehama,103,63373,760,708,2,710,3
2020-10-12,Trinity,105,12862,69,19,9,28,0
2020-10-12,Tulare,107,460477,17344,16742,242,16984,286
2020-10-12,Tuolumne,109,53932,254,234,4,238,4
2020-10-12,Ventura,111,848112,14309,13617,288,13905,151
2020-10-12,Yolo,113,214977,3072,2964,7,2971,55
2020-10-12,Yuba,115,75493,1174,1141,5,1146,10
2020-10-11,Alameda,001,1643700,22651,22057,205,22262,392
2020-10-11,Alpine,003,1148,3,3,0,3,0
2020-10-11,Amador,005,37829,307,305,0,305,16
2020-10-11,Butte,007,227075,3078,2967,28,2995,54
2020-10-11,Calaveras,009,45235,322,262,0,262,12
2020-10-11,Colusa,011,21464,540,541,1,542,6
2020-10-11,Contra Costa,013,1133247,18155,17678,90,17768,233
2020-10-11,Del Norte,015,27424,166,161,0,161,2
2020-10-11,El Dorado,017,186661,1306,1242,8,1250,4
2020-10-11,Fresno,019,978130,32241,29419,416,29835,421
2020-10-11,Glenn,021,27897,637,625,0,625,3
2020-10-11,Humboldt,023,135768,538,521,1,522,7
2020-10-11,Imperial,025,180216,12340,11614,9,11623,328
2020-10-11,Inyo,027,18085,213,201,4,205,14
2020-10-11,Kern,029,883053,33047,32399,365,32764,418
2020-10-11,Kings,031,150075,8299,8094,50,8144,80
2020-10-11,Lake,033,64148,668,631,0,631,12
2020-10-11,Lassen,035,31185,762,752,2,754,0
2020-10-11,Los Angeles,037,10098052,285538,280190,2374,282564,6745
2020-10-11,Madera,039,155013,4839,4680,33,4713,50
2020-10-11,Marin,041,260295,6988,6870,18,6888,97
2020-10-11,Mariposa,043,17540,77,76,0,76,2
2020-10-11,Mendocino,045,87422,1009,944,4,948,21
2020-10-11,Merced,047,269075,9260,9124,28,9152,146
2020-10-11,Modoc,049,8938,29,27,0,27,0
2020-10-11,Mono,051,14174,174,154,4,158,1
2020-10-11,Monterey,053,433212,10750,10445,44,10489,77
2020-10-11,Napa,055,140530,1881,1811,8,1819,11
2020-10-11,Nevada,057,99092,588,569,20,589,7
2020-10-11,Orange,059,3164182,57941,55202,1631,56833,1326
2020-10-11,Placer,061,380077,3944,3787,14,3801,48
2020-10-11,Plumas,063,18699,52,51,0,51,0
2020-10-11,Riverside,065,2383286,63686,62112,241,62353,1254
2020-10-11,Sacramento,067,1510023,24175,23778,27,23805,466
2020-10-11,San Benito,069,59416,1384,1374,0,1374,13
2020-10-11,San Bernardino,071,2135413,59210,56997,367,57364,1061
2020-10-11,San Diego,073,3302833,52433,50553,1272,51825,826
2020-10-11,San Francisco,075,870044,11818,11659,40,11699,122
2020-10-11,San Joaquin,077,732212,21069,20700,105,20805,480
2020-10-11,San Luis Obispo,079,281455,4123,3874,21,3895,32
2020-10-11,San Mateo,081,765935,10837,10240,12,10252,130
2020-10-11,Santa Barbara,083,443738,9580,9440,84,9524,117
2020-10-11,Santa Clara,085,1922200,23812,22487,50,22537,336
2020-10-11,Santa Cruz,087,273765,2678,2578,33,2611,13
2020-10-11,Shasta,089,179085,1807,1515,17,1532,20
2020-10-11,Sierra,091,2930,6,6,0,6,0
2020-10-11,Siskiyou,093,43540,172,162,10,172,0
2020-10-11,Solano,095,438530,6891,6685,42,6727,53
2020-10-11,Sonoma,097,501317,8742,8319,23,8342,133
2020-10-11,Stanislaus,099,539301,17158,17007,631,17638,360
2020-10-11,Sutter,101,95872,1763,1742,1,1743,12
2020-10-11,Tehama,103,63373,736,702,2,704,3
2020-10-11,Trinity,105,12862,69,19,9,28,0
2020-10-11,Tulare,107,460477,17280,16741,234,16975,286
2020-10-11,Tuolumne,109,53932,249,234,4,238,4
2020-10-11,Ventura,111,848112,14248,13604,283,13887,151
2020-10-11,Yolo,113,214977,3042,2952,7,2959,55
2020-10-11,Yuba,115,75493,1162,1137,5,1142,10
2020-10-10,Alameda,001,1643700,22601,21979,204,22183,398
2020-10-10,Alpine,003,1148,3,3,0,3,0
2020-10-10,Amador,005,37829,306,304,0,304,16
2020-10-10,Butte,007,227075,3073,2962,27,2989,54
2020-10-10,Calaveras,009,45235,321,262,0,262,12
2020-10-10,Colusa,011,21464,540,541,1,542,6
2020-10-10,Contra Costa,013,1133247,18119,17566,89,17655,233
2020-10-10,Del Norte,015,27424,166,161,0,161,2
2020-10-10,El Dorado,017,186661,1304,1240,8,1248,4
2020-10-10,Fresno,019,978130,32177,29286,414,29700,421
2020-10-10,Glenn,021,27897,637,623,0,623,3
2020-10-10,Humboldt,023,135768,535,518,1,519,7
2020-10-10,Imperial,025,180216,12325,11591,9,11600,327
2020-10-10,Inyo,027,18085,210,201,4,205,14
2020-10-10,Kern,029,883053,33010,32338,365,32703,418
2020-10-10,Kings,031,150075,8295,8078,50,8128,80
2020-10-10,Lake,033,64148,667,630,0,630,11
2020-10-10,Lassen,035,31185,762,752,2,754,0
2020-10-10,Los Angeles,037,10098052,284818,279213,2340,281553,6743
2020-10-10,Madera,039,155013,4826,4662,33,4695,50
2020-10-10,Marin,041,260295,6979,6852,18,6870,97
2020-10-10,Mariposa,043,17540,77,76,0,76,2
2020-10-10,Mendocino,045,87422,1002,935,4,939,21
2020-10-10,Merced,047,269075,9254,9105,27,9132,146
2020-10-10,Modoc,049,8938,29,27,0,27,0
2020-10-10,Mono,051,14174,174,154,4,158,1
2020-10-10,Monterey,053,433212,10717,10410,44,10454,75
2020-10-10,Napa,055,140530,1874,1804,8,1812,11
2020-10-10,Nevada,057,99092,585,564,20,584,6
2020-10-10,Orange,059,3164182,57820,54965,1626,56591,1324
2020-10-10,Placer,061,380077,3927,3757,14,3771,48
2020-10-10,Plumas,063,18699,52,51,0,51,0
2020-10-10,Riverside,065,2383286,63483,61845,239,62084,1254
2020-10-10,Sacramento,067,1510023,24108,23689,27,23716,466
2020-10-10,San Benito,069,59416,1382,1370,0,1370,13
2020-10-10,San Bernardino,071,2135413,59047,56683,365,57048,1061
2020-10-10,San Diego,073,3302833,52203,50145,1254,51399,825
2020-10-10,San Francisco,075,870044,11797,11663,40,11703,122
2020-10-10,San Joaquin,077,732212,21041,20700,101,20801,481
2020-10-10,San Luis Obispo,079,281455,4103,3832,21,3853,32
2020-10-10,San Mateo,081,765935,10800,10218,12,10230,130
2020-10-10,Santa Barbara,083,443738,9569,9417,84,9501,116
2020-10-10,Santa Clara,085,1922200,23721,22354,50,22404,330
2020-10-10,Santa Cruz,087,273765,2664,2572,33,2605,13
2020-10-10,Shasta,089,179085,1790,1473,17,1490,20
2020-10-10,Sierra,091,2930,6,6,0,6,0
2020-10-10,Siskiyou,093,43540,172,161,10,171,0
2020-10-10,Solano,095,438530,6865,6655,42,6697,53
2020-10-10,Sonoma,097,501317,8722,8235,23,8258,133
2020-10-10,Stanislaus,099,539301,17123,16960,623,17583,360
2020-10-10,Sutter,101,95872,1760,1735,1,1736,12
2020-10-10,Tehama,103,63373,729,693,2,695,3
2020-10-10,Trinity,105,12862,69,19,9,28,0
2020-10-10,Tulare,107,460477,17245,16709,229,16938,286
2020-10-10,Tuolumne,109,53932,249,233,4,237,4
2020-10-10,Ventura,111,848112,14223,13520,283,13803,151
2020-10-10,Yolo,113,214977,3033,2939,7,2946,55
2020-10-10,Yuba,115,75493,1160,1134,5,1139,10
2020-10-09,Alameda,001,1643700,22553,21924,204,22128,399
2020-10-09,Alpine,003,1148,3,3,0,3,0
2020-10-09,Amador,005,37829,306,303,0,303,16
2020-10-09,Butte,007,227075,3070,2956,27,2983,51
2020-10-09,Calaveras,009,45235,319,262,0,262,11
2020-10-09,Colusa,011,21464,540,541,1,542,6
2020-10-09,Contra Costa,013,1133247,18069,17487,89,17576,229
2020-10-09,Del Norte,015,27424,165,161,0,161,2
2020-10-09,El Dorado,017,186661,1300,1234,8,1242,4
2020-10-09,Fresno,019,978130,32104,29208,412,29620,417
2020-10-09,Glenn,021,27897,632,617,0,617,3
2020-10-09,Humboldt,023,135768,533,516,1,517,7
2020-10-09,Imperial,025,180216,12298,11516,9,11525,330
2020-10-09,Inyo,027,18085,207,200,4,204,14
2020-10-09,Kern,029,883053,32967,32237,363,32600,417
2020-10-09,Kings,031,150075,8288,7993,48,8041,80
2020-10-09,Lake,033,64148,657,610,0,610,11
2020-10-09,Lassen,035,31185,762,751,2,753,0
2020-10-09,Los Angeles,037,10098052,283684,278039,2315,280354,6715
2020-10-09,Madera,039,155013,4816,4646,33,4679,50
2020-10-09,Marin,041,260295,6965,6838,18,6856,96
2020-10-09,Mariposa,043,17540,77,76,0,76,2
2020-10-09,Mendocino,045,87422,992,933,4,937,20
2020-10-09,Merced,047,269075,9240,9095,27,9122,145
2020-10-09,Modoc,049,8938,29,27,0,27,0
2020-10-09,Mono,051,14174,174,154,4,158,1
2020-10-09,Monterey,053,433212,10683,10369,44,10413,75
2020-10-09,Napa,055,140530,1864,1795,8,1803,11
2020-10-09,Nevada,057,99092,580,561,20,581,6
2020-10-09,Orange,059,3164182,57648,54746,1621,56367,1305
2020-10-09,Placer,061,380077,3913,3737,13,3750,48
2020-10-09,Plumas,063,18699,52,50,0,50,0
2020-10-09,Riverside,065,2383286,63247,61529,238,61767,1252
2020-10-09,Sacramento,067,1510023,24038,23606,27,23633,457
2020-10-09,San Benito,069,59416,1377,1367,0,1367,13
2020-10-09,San Bernardino,071,2135413,58807,56434,363,56797,1057
2020-10-09,San Diego,073,3302833,51927,49825,1243,51068,821
2020-10-09,San Francisco,075,870044,11767,11620,40,11660,120
2020-10-09,San Joaquin,077,732212,21011,20648,93,20741,481
2020-10-09,San Luis Obispo,079,281455,4084,3810,21,3831,32
2020-10-09,San Mateo,081,765935,10772,10140,12,10152,130
2020-10-09,Santa Barbara,083,443738,9541,9396,84,9480,116
2020-10-09,Santa Clara,085,1922200,23619,22251,49,22300,328
2020-10-09,Santa Cruz,087,273765,2655,2555,33,2588,13
2020-10-09,Shasta,089,179085,1764,1353,16,1369,20
2020-10-09,Sierra,091,2930,6,6,0,6,0
2020-10-09,Siskiyou,093,43540,170,156,10,166,0
2020-10-09,Solano,095,438530,6826,6614,42,6656,53
2020-10-09,Sonoma,097,501317,8668,8133,23,8156,133
2020-10-09,Stanislaus,099,539301,17099,16904,614,17518,362
2020-10-09,Sutter,101,95872,1756,1732,1,1733,12
2020-10-09,Tehama,103,63373,723,682,2,684,3
2020-10-09,Trinity,105,12862,69,25,9,34,0
2020-10-09,Tulare,107,460477,17205,16644,220,16864,286
2020-10-09,Tuolumne,109,53932,246,230,4,234,4
2020-10-09,Ventura,111,848112,14187,13469,280,13749,151
2020-10-09,Yolo,113,214977,3026,2928,7,2935,55
2020-10-09,Yuba,115,75493,1159,1129,5,1134,10
2020-10-08,Alameda,001,1643700,22472,21826,203,22029,395
2020-10-08,Alpine,003,1148,3,3,0,3,0
2020-10-08,Amador,005,37829,305,302,0,302,16
2020-10-08,Butte,007,227075,3060,2935,27,2962,51
2020-10-08,Calaveras,009,45235,318,262,0,262,11
2020-10-08,Colusa,011,21464,540,539,1,540,6
2020-10-08,Contra Costa,013,1133247,18009,17418,88,17506,228
2020-10-08,Del Norte,015,27424,165,151,0,151,2
2020-10-08,El Dorado,017,186661,1299,1230,8,1238,4
2020-10-08,Fresno,019,978130,31999,29111,412,29523,416
2020-10-08,Glenn,021,27897,629,616,0,616,3
2020-10-08,Humboldt,023,135768,529,515,1,516,7
2020-10-08,Imperial,025,180216,12259,11405,9,11414,330
2020-10-08,Inyo,027,18085,204,199,4,203,14
2020-10-08,Kern,029,883053,32909,32169,358,32527,411
2020-10-08,Kings,031,150075,8282,7968,48,8016,80
2020-10-08,Lake,033,64148,652,604,0,604,11
2020-10-08,Lassen,035,31185,757,751,2,753,0
2020-10-08,Los Angeles,037,10098052,282484,276763,2275,279038,6699
2020-10-08,Madera,039,155013,4797,4637,33,4670,50
2020-10-08,Marin,041,260295,6951,6810,18,6828,96
2020-10-08,Mariposa,043,17540,77,76,0,76,2
2020-10-08,Mendocino,045,87422,987,930,4,934,20
2020-10-08,Merced,047,269075,9220,9069,27,9096,144
2020-10-08,Modoc,049,8938,29,27,0,27,0
2020-10-08,Mono,051,14174,174,153,4,157,1
2020-10-08,Monterey,053,433212,10616,10343,44,10387,75
2020-10-08,Napa,055,140530,1849,1779,8,1787,11
2020-10-08,Nevada,057,99092,577,556,20,576,6
2020-10-08,Orange,059,3164182,57455,54523,1610,56133,1293
2020-10-08,Placer,061,380077,3895,3715,13,3728,48
2020-10-08,Plumas,063,18699,52,50,0,50,0
2020-10-08,Riverside,065,2383286,62978,61105,236,61341,1244
2020-10-08,Sacramento,067,1510023,23930,23482,27,23509,454
2020-10-08,San Benito,069,59416,1372,1367,0,1367,13
2020-10-08,San Bernardino,071,2135413,58442,56152,362,56514,1048
2020-10-08,San Diego,073,3302833,51647,49468,1211,50679,819
2020-10-08,San Francisco,075,870044,11729,11608,40,11648,115
2020-10-08,San Joaquin,077,732212,20959,20576,88,20664,478
2020-10-08,San Luis Obispo,079,281455,4068,3785,21,3806,32
2020-10-08,San Mateo,081,765935,10740,10044,12,10056,130
2020-10-08,Santa Barbara,083,443738,9513,9374,84,9458,116
2020-10-08,Santa Clara,085,1922200,23517,22095,49,22144,323
2020-10-08,Santa Cruz,087,273765,2643,2535,33,2568,13
2020-10-08,Shasta,089,179085,1730,1305,16,1321,20
2020-10-08,Sierra,091,2930,6,6,0,6,0
2020-10-08,Siskiyou,093,43540,170,156,10,166,0
2020-10-08,Solano,095,438530,6802,6556,42,6598,53
2020-10-08,Sonoma,097,501317,8602,8063,23,8086,132
2020-10-08,Stanislaus,099,539301,17053,16821,606,17427,360
2020-10-08,Sutter,101,95872,1756,1725,1,1726,12
2020-10-08,Tehama,103,63373,714,676,2,678,3
2020-10-08,Trinity,105,12862,68,25,9,34,0
2020-10-08,Tulare,107,460477,17144,16573,211,16784,283
2020-10-08,Tuolumne,109,53932,245,230,4,234,4
2020-10-08,Ventura,111,848112,14139,13399,278,13677,151
2020-10-08,Yolo,113,214977,3009,2914,7,2921,55
2020-10-08,Yuba,115,75493,1154,1126,5,1131,10
2020-10-07,Alameda,001,1643700,22395,21736,203,21939,395
2020-10-07,Alpine,003,1148,3,3,0,3,0
2020-10-07,Amador,005,37829,305,302,0,302,16
2020-10-07,Butte,007,227075,3048,2927,27,2954,47
2020-10-07,Calaveras,009,45235,316,262,0,262,11
2020-10-07,Colusa,011,21464,539,539,0,539,6
2020-10-07,Contra Costa,013,1133247,17939,17346,87,17433,225
2020-10-07,Del Norte,015,27424,164,149,0,149,2
2020-10-07,El Dorado,017,186661,1291,1219,8,1227,4
2020-10-07,Fresno,019,978130,31878,29069,407,29476,413
2020-10-07,Glenn,021,27897,629,615,0,615,3
2020-10-07,Humboldt,023,135768,526,512,1,513,7
2020-10-07,Imperial,025,180216,12222,11289,8,11297,330
2020-10-07,Inyo,027,18085,204,199,4,203,14
2020-10-07,Kern,029,883053,32836,32068,357,32425,410
2020-10-07,Kings,031,150075,8267,7948,48,7996,80
2020-10-07,Lake,033,64148,651,599,0,599,11
2020-10-07,Lassen,035,31185,757,751,2,753,0
2020-10-07,Los Angeles,037,10098052,281303,275559,2241,277800,6681
2020-10-07,Madera,039,155013,4777,4618,33,4651,50
2020-10-07,Marin,041,260295,6924,6790,18,6808,95
2020-10-07,Mariposa,043,17540,77,75,0,75,2
2020-10-07,Mendocino,045,87422,981,927,4,931,19
2020-10-07,Merced,047,269075,9183,9045,26,9071,144
2020-10-07,Modoc,049,8938,29,27,0,27,0
2020-10-07,Mono,051,14174,173,153,3,156,1
2020-10-07,Monterey,053,433212,10557,10272,44,10316,75
2020-10-07,Napa,055,140530,1836,1774,8,1782,11
2020-10-07,Nevada,057,99092,573,552,20,572,6
2020-10-07,Orange,059,3164182,57238,54332,1599,55931,1277
2020-10-07,Placer,061,380077,3879,3693,13,3706,48
2020-10-07,Plumas,063,18699,52,50,0,50,0
2020-10-07,Riverside,065,2383286,62631,60857,232,61089,1241
2020-10-07,Sacramento,067,1510023,23833,23380,27,23407,452
2020-10-07,San Benito,069,59416,1369,1363,0,1363,13
2020-10-07,San Bernardino,071,2135413,58093,55738,361,56099,1043
2020-10-07,San Diego,073,3302833,51331,49177,1187,50364,813
2020-10-07,San Francisco,075,870044,11694,11551,40,11591,115
2020-10-07,San Joaquin,077,732212,20907,20527,81,20608,478
2020-10-07,San Luis Obispo,079,281455,4038,3749,21,3770,32
2020-10-07,San Mateo,081,765935,10697,9980,12,9992,130
2020-10-07,Santa Barbara,083,443738,9487,9350,83,9433,116
2020-10-07,Santa Clara,085,1922200,23389,21993,49,22042,320
2020-10-07,Santa Cruz,087,273765,2631,2518,33,2551,14
2020-10-07,Shasta,089,179085,1687,1268,16,1284,20
2020-10-07,Sierra,091,2930,6,6,0,6,0
2020-10-07,Siskiyou,093,43540,168,154,10,164,0
2020-10-07,Solano,095,438530,6767,6526,42,6568,53
2020-10-07,Sonoma,097,501317,8527,7993,22,8015,130
2020-10-07,Stanislaus,099,539301,17018,16786,600,17386,357
2020-10-07,Sutter,101,95872,1753,1723,1,1724,12
2020-10-07,Tehama,103,63373,705,666,2,668,3
2020-10-07,Trinity,105,12862,64,25,8,33,0
2020-10-07,Tulare,107,460477,17101,16483,202,16685,282
2020-10-07,Tuolumne,109,53932,245,227,4,231,3
2020-10-07,Ventura,111,848112,14089,13333,272,13605,150
2020-10-07,Yolo,113,214977,2983,2904,7,2911,55
2020-10-07,Yuba,115,75493,1148,1120,5,1125,10
2020-10-06,Alameda,001,1643700,22304,21698,201,21899,385
2020-10-06,Alpine,003,1148,3,3,0,3,0
2020-10-06,Amador,005,37829,303,301,0,301,16
2020-10-06,Butte,007,227075,3041,2925,27,2952,47
2020-10-06,Calaveras,009,45235,316,261,0,261,11
2020-10-06,Colusa,011,21464,538,538,0,538,6
2020-10-06,Contra Costa,013,1133247,17860,17295,87,17382,219
2020-10-06,Del Norte,015,27424,164,144,0,144,2
2020-10-06,El Dorado,017,186661,1287,1211,8,1219,4
2020-10-06,Fresno,019,978130,31734,29022,404,29426,412
2020-10-06,Glenn,021,27897,626,604,0,604,3
2020-10-06,Humboldt,023,135768,523,508,1,509,7
2020-10-06,Imperial,025,180216,12184,11196,8,11204,327
2020-10-06,Inyo,027,18085,202,198,4,202,14
2020-10-06,Kern,029,883053,32759,32006,355,32361,407
2020-10-06,Kings,031,150075,8251,7943,48,7991,81
2020-10-06,Lake,033,64148,645,596,0,596,11
2020-10-06,Lassen,035,31185,757,743,2,745,0
2020-10-06,Los Angeles,037,10098052,280067,274115,2191,276306,6657
2020-10-06,Madera,039,155013,4765,4608,33,4641,50
2020-10-06,Marin,041,260295,6909,6766,18,6784,91
2020-10-06,Mariposa,043,17540,77,75,0,75,2
2020-10-06,Mendocino,045,87422,974,920,4,924,19
2020-10-06,Merced,047,269075,9147,9034,25,9059,143
2020-10-06,Modoc,049,8938,29,26,0,26,0
2020-10-06,Mono,051,14174,173,153,3,156,1
2020-10-06,Monterey,053,433212,10502,10235,42,10277,72
2020-10-06,Napa,055,140530,1830,1770,8,1778,11
2020-10-06,Nevada,057,99092,570,551,20,571,6
2020-10-06,Orange,059,3164182,57022,54203,1590,55793,1273
2020-10-06,Placer,061,380077,3857,3680,13,3693,48
2020-10-06,Plumas,063,18699,52,49,0,49,0
2020-10-06,Riverside,065,2383286,62366,60593,229,60822,1238
2020-10-06,Sacramento,067,1510023,23746,23322,27,23349,442
2020-10-06,San Benito,069,59416,1368,1358,0,1358,12
2020-10-06,San Bernardino,071,2135413,57778,55416,357,55773,1040
2020-10-06,San Diego,073,3302833,50994,48823,1170,49993,806
2020-10-06,San Francisco,075,870044,11668,11513,39,11552,115
2020-10-06,San Joaquin,077,732212,20867,20481,78,20559,477
2020-10-06,San Luis Obispo,079,281455,4004,3723,21,3744,32
2020-10-06,San Mateo,081,765935,10664,9934,12,9946,129
2020-10-06,Santa Barbara,083,443738,9458,9331,82,9413,116
2020-10-06,Santa Clara,085,1922200,23294,21914,49,21963,320
2020-10-06,Santa Cruz,087,273765,2609,2510,33,2543,12
2020-10-06,Shasta,089,179085,1647,1242,16,1258,18
2020-10-06,Sierra,091,2930,6,6,0,6,0
2020-10-06,Siskiyou,093,43540,168,154,10,164,0
2020-10-06,Solano,095,438530,6721,6506,42,6548,52
2020-10-06,Sonoma,097,501317,8434,7895,22,7917,130
2020-10-06,Stanislaus,099,539301,16973,16759,594,17353,354
2020-10-06,Sutter,101,95872,1751,1722,1,1723,12
2020-10-06,Tehama,103,63373,696,660,2,662,3
2020-10-06,Trinity,105,12862,64,25,8,33,0
2020-10-06,Tulare,107,460477,17059,16456,194,16650,280
2020-10-06,Tuolumne,109,53932,244,227,4,231,2
2020-10-06,Ventura,111,848112,14022,13242,267,13509,150
2020-10-06,Yolo,113,214977,2969,2899,7,2906,56
2020-10-06,Yuba,115,75493,1147,1114,5,1119,10
2020-10-05,Alameda,001,1643700,22216,21637,198,21835,383
2020-10-05,Alpine,003,1148,3,2,0,2,0
2020-10-05,Amador,005,37829,303,299,0,299,16
2020-10-05,Butte,007,227075,3031,2910,27,2937,46
2020-10-05,Calaveras,009,45235,316,259,0,259,11
2020-10-05,Colusa,011,21464,538,537,0,537,6
2020-10-05,Contra Costa,013,1133247,17783,17250,87,17337,216
2020-10-05,Del Norte,015,27424,161,142,0,142,2
2020-10-05,El Dorado,017,186661,1283,1202,7,1209,4
2020-10-05,Fresno,019,978130,31617,29136,404,29540,408
2020-10-05,Glenn,021,27897,624,603,0,603,3
2020-10-05,Humboldt,023,135768,522,506,1,507,6
2020-10-05,Imperial,025,180216,12144,11169,8,11177,327
2020-10-05,Inyo,027,18085,202,197,4,201,14
2020-10-05,Kern,029,883053,32680,31933,351,32284,404
2020-10-05,Kings,031,150075,8154,7932,48,7980,80
2020-10-05,Lake,033,64148,641,592,0,592,10
2020-10-05,Lassen,035,31185,756,743,2,745,0
2020-10-05,Los Angeles,037,10098052,278977,273200,2151,275351,6632
2020-10-05,Madera,039,155013,4757,4598,31,4629,50
2020-10-05,Marin,041,260295,6892,6751,18,6769,91
2020-10-05,Mariposa,043,17540,77,75,0,75,2
2020-10-05,Mendocino,045,87422,966,913,4,917,19
2020-10-05,Merced,047,269075,9128,9021,24,9045,143
2020-10-05,Modoc,049,8938,29,26,0,26,0
2020-10-05,Mono,051,14174,173,152,3,155,1
2020-10-05,Monterey,053,433212,10455,10187,42,10229,72
2020-10-05,Napa,055,140530,1819,1760,8,1768,11
2020-10-05,Nevada,057,99092,567,550,19,569,6
2020-10-05,Orange,059,3164182,56806,54103,1577,55680,1271
2020-10-05,Placer,061,380077,3831,3670,13,3683,46
2020-10-05,Plumas,063,18699,51,49,0,49,0
2020-10-05,Riverside,065,2383286,62046,60454,225,60679,1232
2020-10-05,Sacramento,067,1510023,23642,23207,27,23234,438
2020-10-05,San Benito,069,59416,1365,1356,0,1356,12
2020-10-05,San Bernardino,071,2135413,57470,55100,356,55456,1031
2020-10-05,San Diego,073,3302833,50658,48662,1146,49808,803
2020-10-05,San Francisco,075,870044,11629,11476,36,11512,110
2020-10-05,San Joaquin,077,732212,20796,20319,75,20394,476
2020-10-05,San Luis Obispo,079,281455,3977,3710,21,3731,32
2020-10-05,San Mateo,081,765935,10637,9896,12,9908,128
2020-10-05,Santa Barbara,083,443738,9436,9309,82,9391,116
2020-10-05,Santa Clara,085,1922200,23176,21861,49,21910,319
2020-10-05,Santa Cruz,087,273765,2597,2492,33,2525,9
2020-10-05,Shasta,089,179085,1615,1158,16,1174,18
2020-10-05,Sierra,091,2930,6,6,0,6,0
2020-10-05,Siskiyou,093,43540,168,153,10,163,0
2020-10-05,Solano,095,438530,6682,6475,42,6517,52
2020-10-05,Sonoma,097,501317,8342,7817,22,7839,130
2020-10-05,Stanislaus,099,539301,16938,16730,587,17317,351
2020-10-05,Sutter,101,95872,1743,1719,1,1720,12
2020-10-05,Tehama,103,63373,688,642,2,644,3
2020-10-05,Trinity,105,12862,62,22,8,30,0
2020-10-05,Tulare,107,460477,17000,16343,189,16532,278
2020-10-05,Tuolumne,109,53932,241,226,4,230,2
2020-10-05,Ventura,111,848112,13953,13224,247,13471,149
2020-10-05,Yolo,113,214977,2950,2889,7,2896,56
2020-10-05,Yuba,115,75493,1134,1108,5,1113,9
2020-10-04,Alameda,001,1643700,22120,21597,198,21795,383
2020-10-04,Alpine,003,1148,3,2,0,2,0
2020-10-04,Amador,005,37829,302,297,0,297,16
2020-10-04,Butte,007,227075,3017,2903,27,2930,46
2020-10-04,Calaveras,009,45235,316,259,0,259,11
2020-10-04,Colusa,011,21464,537,537,0,537,6
2020-10-04,Contra Costa,013,1133247,17718,17192,87,17279,214
2020-10-04,Del Norte,015,27424,157,142,0,142,2
2020-10-04,El Dorado,017,186661,1279,1196,7,1203,4
2020-10-04,Fresno,019,978130,31494,29065,404,29469,408
2020-10-04,Glenn,021,27897,622,601,0,601,3
2020-10-04,Humboldt,023,135768,521,506,1,507,6
2020-10-04,Imperial,025,180216,12105,11127,8,11135,327
2020-10-04,Inyo,027,18085,199,195,4,199,14
2020-10-04,Kern,029,883053,32606,31906,347,32253,404
2020-10-04,Kings,031,150075,8139,7919,48,7967,80
2020-10-04,Lake,033,64148,627,589,0,589,10
2020-10-04,Lassen,035,31185,756,743,2,745,0
2020-10-04,Los Angeles,037,10098052,277588,272822,2103,274925,6625
2020-10-04,Madera,039,155013,4741,4587,31,4618,50
2020-10-04,Marin,041,260295,6872,6741,18,6759,91
2020-10-04,Mariposa,043,17540,77,75,0,75,2
2020-10-04,Mendocino,045,87422,953,905,4,909,18
2020-10-04,Merced,047,269075,9103,9006,24,9030,140
2020-10-04,Modoc,049,8938,29,26,0,26,0
2020-10-04,Mono,051,14174,172,152,2,154,1
2020-10-04,Monterey,053,433212,10414,10141,41,10182,72
2020-10-04,Napa,055,140530,1807,1759,8,1767,11
2020-10-04,Nevada,057,99092,563,547,18,565,6
2020-10-04,Orange,059,3164182,56570,53966,1568,55534,1270
2020-10-04,Placer,061,380077,3810,3664,13,3677,46
2020-10-04,Plumas,063,18699,51,49,0,49,0
2020-10-04,Riverside,065,2383286,61760,60251,221,60472,1226
2020-10-04,Sacramento,067,1510023,23529,23162,27,23189,438
2020-10-04,San Benito,069,59416,1365,1355,0,1355,12
2020-10-04,San Bernardino,071,2135413,57022,55100,354,55454,1031
2020-10-04,San Diego,073,3302833,50291,48438,1121,49559,803
2020-10-04,San Francisco,075,870044,11597,11474,34,11508,110
2020-10-04,San Joaquin,077,732212,20719,20320,69,20389,476
2020-10-04,San Luis Obispo,079,281455,3952,3688,21,3709,31
2020-10-04,San Mateo,081,765935,10577,9858,12,9870,128
2020-10-04,Santa Barbara,083,443738,9410,9276,80,9356,116
2020-10-04,Santa Clara,085,1922200,23039,21780,49,21829,316
2020-10-04,Santa Cruz,087,273765,2581,2483,33,2516,9
2020-10-04,Shasta,089,179085,1517,1158,15,1173,18
2020-10-04,Sierra,091,2930,6,6,0,6,0
2020-10-04,Siskiyou,093,43540,168,153,10,163,0
2020-10-04,Solano,095,438530,6631,6445,42,6487,52
2020-10-04,Sonoma,097,501317,8254,7794,22,7816,129
2020-10-04,Stanislaus,099,539301,16888,16711,578,17289,351
2020-10-04,Sutter,101,95872,1740,1711,1,1712,11
2020-10-04,Tehama,103,63373,673,637,2,639,3
2020-10-04,Trinity,105,12862,61,21,8,29,0
2020-10-04,Tulare,107,460477,16923,16343,178,16521,278
2020-10-04,Tuolumne,109,53932,239,226,4,230,2
2020-10-04,Ventura,111,848112,13871,13197,230,13427,149
2020-10-04,Yolo,113,214977,2939,2875,7,2882,56
2020-10-04,Yuba,115,75493,1130,1103,5,1108,9
2020-10-03,Alameda,001,1643700,22074,21510,197,21707,386
2020-10-03,Alpine,003,1148,3,2,0,2,0
2020-10-03,Amador,005,37829,301,296,0,296,16
2020-10-03,Butte,007,227075,3011,2894,27,2921,46
2020-10-03,Calaveras,009,45235,316,259,0,259,11
2020-10-03,Colusa,011,21464,536,537,0,537,6
2020-10-03,Contra Costa,013,1133247,17668,17087,85,17172,213
2020-10-03,Del Norte,015,27424,153,142,0,142,2
2020-10-03,El Dorado,017,186661,1272,1188,7,1195,4
2020-10-03,Fresno,019,978130,31434,28975,403,29378,408
2020-10-03,Glenn,021,27897,620,601,0,601,3
2020-10-03,Humboldt,023,135768,520,504,1,505,6
2020-10-03,Imperial,025,180216,12082,11090,8,11098,327
2020-10-03,Inyo,027,18085,199,194,4,198,14
2020-10-03,Kern,029,883053,32556,31864,343,32207,403
2020-10-03,Kings,031,150075,8135,7887,48,7935,80
2020-10-03,Lake,033,64148,617,588,0,588,10
2020-10-03,Lassen,035,31185,756,743,2,745,0
2020-10-03,Los Angeles,037,10098052,276883,271869,2074,273943,6620
2020-10-03,Madera,039,155013,4724,4565,31,4596,50
2020-10-03,Marin,041,260295,6866,6728,18,6746,91
2020-10-03,Mariposa,043,17540,77,75,0,75,2
2020-10-03,Mendocino,045,87422,951,898,4,902,18
2020-10-03,Merced,047,269075,9090,8986,24,9010,139
2020-10-03,Modoc,049,8938,29,26,0,26,0
2020-10-03,Mono,051,14174,171,152,2,154,1
2020-10-03,Monterey,053,433212,10380,10092,38,10130,72
2020-10-03,Napa,055,140530,1803,1752,8,1760,11
2020-10-03,Nevada,057,99092,562,544,18,562,6
2020-10-03,Orange,059,3164182,56453,53573,1563,55136,1268
2020-10-03,Placer,061,380077,3799,3648,13,3661,47
2020-10-03,Plumas,063,18699,51,48,0,48,0
2020-10-03,Riverside,065,2383286,61608,59991,219,60210,1226
2020-10-03,Sacramento,067,1510023,23478,23076,27,23103,437
2020-10-03,San Benito,069,59416,1365,1351,0,1351,12
2020-10-03,San Bernardino,071,2135413,56849,55004,351,55355,1031
2020-10-03,San Diego,073,3302833,50060,48202,1104,49306,798
2020-10-03,San Francisco,075,870044,11572,11475,32,11507,110
2020-10-03,San Joaquin,077,732212,20693,20322,69,20391,476
2020-10-03,San Luis Obispo,079,281455,3928,3670,21,3691,31
2020-10-03,San Mateo,081,765935,10551,9822,11,9833,128
2020-10-03,Santa Barbara,083,443738,9397,9256,80,9336,116
2020-10-03,Santa Clara,085,1922200,22959,21672,49,21721,309
2020-10-03,Santa Cruz,087,273765,2573,2476,33,2509,9
2020-10-03,Shasta,089,179085,1489,1117,14,1131,18
2020-10-03,Sierra,091,2930,6,6,0,6,0
2020-10-03,Siskiyou,093,43540,168,152,10,162,0
2020-10-03,Solano,095,438530,6605,6419,42,6461,52
2020-10-03,Sonoma,097,501317,8211,7747,22,7769,129
2020-10-03,Stanislaus,099,539301,16855,16645,574,17219,351
2020-10-03,Sutter,101,95872,1736,1705,1,1706,11
2020-10-03,Tehama,103,63373,667,630,2,632,3
2020-10-03,Trinity,105,12862,61,15,8,23,0
2020-10-03,Tulare,107,460477,16879,16322,174,16496,278
2020-10-03,Tuolumne,109,53932,238,224,4,228,2
2020-10-03,Ventura,111,848112,13832,13150,226,13376,148
2020-10-03,Yolo,113,214977,2932,2863,7,2870,56
2020-10-03,Yuba,115,75493,1122,1097,5,1102,8
2020-10-02,Alameda,001,1643700,22019,21404,196,21600,382
2020-10-02,Alpine,003,1148,3,2,0,2,0
2020-10-02,Amador,005,37829,300,296,0,296,16
2020-10-02,Butte,007,227075,3001,2879,27,2906,46
2020-10-02,Calaveras,009,45235,315,259,0,259,11
2020-10-02,Colusa,011,21464,535,537,0,537,6
2020-10-02,Contra Costa,013,1133247,17625,17002,84,17086,213
2020-10-02,Del Norte,015,27424,152,141,0,141,2
2020-10-02,El Dorado,017,186661,1265,1168,7,1175,4
2020-10-02,Fresno,019,978130,31351,28855,403,29258,403
2020-10-02,Glenn,021,27897,615,594,0,594,3
2020-10-02,Humboldt,023,135768,519,503,1,504,6
2020-10-02,Imperial,025,180216,12060,11024,8,11032,327
2020-10-02,Inyo,027,18085,197,191,4,195,14
2020-10-02,Kern,029,883053,32504,31790,341,32131,399
2020-10-02,Kings,031,150075,8126,7716,48,7764,79
2020-10-02,Lake,033,64148,611,579,0,579,10
2020-10-02,Lassen,035,31185,756,742,2,744,0
2020-10-02,Los Angeles,037,10098052,275981,270935,2047,272982,6602
2020-10-02,Madera,039,155013,4715,4537,31,4568,49
2020-10-02,Marin,041,260295,6849,6717,18,6735,91
2020-10-02,Mariposa,043,17540,77,75,0,75,2
2020-10-02,Mendocino,045,87422,946,883,4,887,18
2020-10-02,Merced,047,269075,9080,8961,24,8985,139
2020-10-02,Modoc,049,8938,29,26,0,26,0
2020-10-02,Mono,051,14174,171,150,2,152,1
2020-10-02,Monterey,053,433212,10346,9997,38,10035,71
2020-10-02,Napa,055,140530,1797,1737,8,1745,11
2020-10-02,Nevada,057,99092,559,543,18,561,6
2020-10-02,Orange,059,3164182,56322,53299,1556,54855,1262
2020-10-02,Placer,061,380077,3779,3612,13,3625,46
2020-10-02,Plumas,063,18699,51,48,0,48,0
2020-10-02,Riverside,065,2383286,61387,59673,216,59889,1223
2020-10-02,Sacramento,067,1510023,23413,22818,27,22845,436
2020-10-02,San Benito,069,59416,1361,1347,0,1347,12
2020-10-02,San Bernardino,071,2135413,56661,54613,351,54964,1028
2020-10-02,San Diego,073,3302833,49808,47793,1088,48881,794
2020-10-02,San Francisco,075,870044,11549,11398,32,11430,110
2020-10-02,San Joaquin,077,732212,20659,20235,68,20303,474
2020-10-02,San Luis Obispo,079,281455,3905,3654,21,3675,31
2020-10-02,San Mateo,081,765935,10510,9745,11,9756,128
2020-10-02,Santa Barbara,083,443738,9374,9234,80,9314,116
2020-10-02,Santa Clara,085,1922200,22873,21545,48,21593,305
2020-10-02,Santa Cruz,087,273765,2556,2463,33,2496,9
2020-10-02,Shasta,089,179085,1454,1046,14,1060,18
2020-10-02,Sierra,091,2930,6,6,0,6,0
2020-10-02,Siskiyou,093,43540,168,151,10,161,0
2020-10-02,Solano,095,438530,6575,6385,42,6427,52
2020-10-02,Sonoma,097,501317,8154,7662,22,7684,125
2020-10-02,Stanislaus,099,539301,16814,16609,565,17174,349
2020-10-02,Sutter,101,95872,1735,1693,1,1694,11
2020-10-02,Tehama,103,63373,662,619,2,621,3
2020-10-02,Trinity,105,12862,61,15,8,23,0
2020-10-02,Tulare,107,460477,16838,16245,167,16412,278
2020-10-02,Tuolumne,109,53932,236,225,4,229,2
2020-10-02,Ventura,111,848112,13793,13120,221,13341,146
2020-10-02,Yolo,113,214977,2927,2845,7,2852,55
2020-10-02,Yuba,115,75493,1120,1090,5,1095,8
2020-10-01,Alameda,001,1643700,21958,21349,192,21541,383
2020-10-01,Alpine,003,1148,3,2,0,2,0
2020-10-01,Amador,005,37829,300,294,0,294,16
2020-10-01,Butte,007,227075,2993,2865,27,2892,45
2020-10-01,Calaveras,009,45235,315,257,0,257,11
2020-10-01,Colusa,011,21464,535,536,0,536,6
2020-10-01,Contra Costa,013,1133247,17562,16898,84,16982,211
2020-10-01,Del Norte,015,27424,147,140,0,140,2
2020-10-01,El Dorado,017,186661,1261,1162,6,1168,4
2020-10-01,Fresno,019,978130,31270,28796,401,29197,397
2020-10-01,Glenn,021,27897,611,593,0,593,3
2020-10-01,Humboldt,023,135768,519,499,1,500,6
2020-10-01,Imperial,025,180216,12017,10928,8,10936,325
2020-10-01,Inyo,027,18085,197,191,4,195,14
2020-10-01,Kern,029,883053,32441,31678,336,32014,399
2020-10-01,Kings,031,150075,8115,7688,45,7733,79
2020-10-01,Lake,033,64148,605,572,0,572,11
2020-10-01,Lassen,035,31185,753,742,2,744,0
2020-10-01,Los Angeles,037,10098052,274939,271513,2013,273526,6621
2020-10-01,Madera,039,155013,4692,4508,31,4539,48
2020-10-01,Marin,041,260295,6835,6710,18,6728,92
2020-10-01,Mariposa,043,17540,77,76,0,76,2
2020-10-01,Mendocino,045,87422,941,874,4,878,19
2020-10-01,Merced,047,269075,9052,8942,24,8966,138
2020-10-01,Modoc,049,8938,29,26,0,26,0
2020-10-01,Mono,051,14174,169,150,2,152,1
2020-10-01,Monterey,053,433212,10270,9958,38,9996,71
2020-10-01,Napa,055,140530,1789,1729,8,1737,11
2020-10-01,Nevada,057,99092,558,543,18,561,6
2020-10-01,Orange,059,3164182,56157,53088,1543,54631,1257
2020-10-01,Placer,061,380077,3752,3599,13,3612,45
2020-10-01,Plumas,063,18699,51,48,0,48,0
2020-10-01,Riverside,065,2383286,61135,59293,210,59503,1223
2020-10-01,Sacramento,067,1510023,23301,22714,26,22740,433
2020-10-01,San Benito,069,59416,1359,1346,0,1346,12
2020-10-01,San Bernardino,071,2135413,56367,54350,348,54698,1021
2020-10-01,San Diego,073,3302833,49526,47487,1068,48555,792
2020-10-01,San Francisco,075,870044,11518,11284,30,11314,110
2020-10-01,San Joaquin,077,732212,20612,20204,65,20269,471
2020-10-01,San Luis Obispo,079,281455,3878,3625,21,3646,31
2020-10-01,San Mateo,081,765935,10465,9681,11,9692,128
2020-10-01,Santa Barbara,083,443738,9334,9215,80,9295,118
2020-10-01,Santa Clara,085,1922200,22772,21398,48,21446,305
2020-10-01,Santa Cruz,087,273765,2541,2418,33,2451,10
2020-10-01,Shasta,089,179085,1403,991,14,1005,18
2020-10-01,Sierra,091,2930,6,6,0,6,0
2020-10-01,Siskiyou,093,43540,165,150,10,160,0
2020-10-01,Solano,095,438530,6537,6352,42,6394,52
2020-10-01,Sonoma,097,501317,8087,7569,22,7591,125
2020-10-01,Stanislaus,099,539301,16781,16555,559,17114,346
2020-10-01,Sutter,101,95872,1730,1684,1,1685,11
2020-10-01,Tehama,103,63373,652,606,2,608,3
2020-10-01,Trinity,105,12862,61,15,8,23,0
2020-10-01,Tulare,107,460477,16763,16182,164,16346,275
2020-10-01,Tuolumne,109,53932,236,223,4,227,2
2020-10-01,Ventura,111,848112,13741,13057,207,13264,146
2020-10-01,Yolo,113,214977,2909,2833,7,2840,55
2020-10-01,Yuba,115,75493,1116,1082,5,1087,8
2020-09-30,Alameda,001,1643700,21880,21271,189,21460,380
2020-09-30,Alpine,003,1148,3,2,0,2,0
2020-09-30,Amador,005,37829,300,294,0,294,16
2020-09-30,Butte,007,227075,2985,2858,27,2885,44
2020-09-30,Calaveras,009,45235,314,258,0,258,11
2020-09-30,Colusa,011,21464,534,534,0,534,6
2020-09-30,Contra Costa,013,1133247,17494,16819,84,16903,211
2020-09-30,Del Norte,015,27424,146,140,0,140,2
2020-09-30,El Dorado,017,186661,1249,1157,6,1163,4
2020-09-30,Fresno,019,978130,31179,28706,398,29104,395
2020-09-30,Glenn,021,27897,606,592,0,592,3
2020-09-30,Humboldt,023,135768,517,497,1,498,6
2020-09-30,Imperial,025,180216,11992,10868,8,10876,287
2020-09-30,Inyo,027,18085,196,189,4,193,14
2020-09-30,Kern,029,883053,32366,31601,335,31936,398
2020-09-30,Kings,031,150075,8086,7685,45,7730,79
2020-09-30,Lake,033,64148,599,567,0,567,10
2020-09-30,Lassen,035,31185,750,742,2,744,0
2020-09-30,Los Angeles,037,10098052,273714,270260,1980,272240,6568
2020-09-30,Madera,039,155013,4683,4477,31,4508,47
2020-09-30,Marin,041,260295,6811,6700,17,6717,91
2020-09-30,Mariposa,043,17540,77,76,0,76,2
2020-09-30,Mendocino,045,87422,935,867,4,871,17
2020-09-30,Merced,047,269075,9032,8926,24,8950,136
2020-09-30,Modoc,049,8938,29,26,0,26,0
2020-09-30,Mono,051,14174,169,150,2,152,1
2020-09-30,Monterey,053,433212,10220,9898,37,9935,70
2020-09-30,Napa,055,140530,1775,1728,8,1736,11
2020-09-30,Nevada,057,99092,556,540,18,558,6
2020-09-30,Orange,059,3164182,55966,52916,1526,54442,1251
2020-09-30,Placer,061,380077,3731,3585,13,3598,43
2020-09-30,Plumas,063,18699,51,48,0,48,0
2020-09-30,Riverside,065,2383286,60780,59074,206,59280,1220
2020-09-30,Sacramento,067,1510023,23197,22613,26,22639,429
2020-09-30,San Benito,069,59416,1356,1342,0,1342,12
2020-09-30,San Bernardino,071,2135413,56089,53988,347,54335,1018
2020-09-30,San Diego,073,3302833,49222,47182,1047,48229,783
2020-09-30,San Francisco,075,870044,11488,11247,30,11277,106
2020-09-30,San Joaquin,077,732212,20529,20150,63,20213,461
2020-09-30,San Luis Obispo,079,281455,3853,3597,21,3618,31
2020-09-30,San Mateo,081,765935,10423,9634,11,9645,128
2020-09-30,Santa Barbara,083,443738,9308,9186,80,9266,115
2020-09-30,Santa Clara,085,1922200,22667,21318,48,21366,302
2020-09-30,Santa Cruz,087,273765,2528,2405,33,2438,10
2020-09-30,Shasta,089,179085,1347,976,13,989,17
2020-09-30,Sierra,091,2930,6,6,0,6,0
2020-09-30,Siskiyou,093,43540,163,150,10,160,0
2020-09-30,Solano,095,438530,6495,6315,42,6357,51
2020-09-30,Sonoma,097,501317,7998,7494,22,7516,125
2020-09-30,Stanislaus,099,539301,16734,16531,553,17084,343
2020-09-30,Sutter,101,95872,1714,1680,1,1681,10
2020-09-30,Tehama,103,63373,646,594,2,596,3
2020-09-30,Trinity,105,12862,58,15,8,23,0
2020-09-30,Tulare,107,460477,16697,16117,157,16274,274
2020-09-30,Tuolumne,109,53932,234,224,4,228,2
2020-09-30,Ventura,111,848112,13706,12968,191,13159,145
2020-09-30,Yolo,113,214977,2896,2822,7,2829,55
2020-09-30,Yuba,115,75493,1113,1075,5,1080,8
2020-09-29,Alameda,001,1643700,21804,21241,185,21426,374
2020-09-29,Alpine,003,1148,3,2,0,2,0
2020-09-29,Amador,005,37829,298,294,0,294,16
2020-09-29,Butte,007,227075,2971,2848,27,2875,44
2020-09-29,Calaveras,009,45235,312,261,0,261,11
2020-09-29,Colusa,011,21464,534,534,0,534,6
2020-09-29,Contra Costa,013,1133247,17439,16716,82,16798,209
2020-09-29,Del Norte,015,27424,142,142,0,142,2
2020-09-29,El Dorado,017,186661,1240,1151,6,1157,4
2020-09-29,Fresno,019,978130,31084,28621,397,29018,394
2020-09-29,Glenn,021,27897,602,589,0,589,3
2020-09-29,Humboldt,023,135768,515,497,1,498,6
2020-09-29,Imperial,025,180216,11958,10811,8,10819,283
2020-09-29,Inyo,027,18085,195,188,4,192,14
2020-09-29,Kern,029,883053,32311,31534,334,31868,397
2020-09-29,Kings,031,150075,8030,7681,45,7726,78
2020-09-29,Lake,033,64148,597,566,0,566,11
2020-09-29,Lassen,035,31185,750,741,2,743,0
2020-09-29,Los Angeles,037,10098052,272498,269246,1952,271198,6545
2020-09-29,Madera,039,155013,4659,4453,31,4484,47
2020-09-29,Marin,041,260295,6790,6692,17,6709,91
2020-09-29,Mariposa,043,17540,77,74,0,74,2
2020-09-29,Mendocino,045,87422,925,854,4,858,17
2020-09-29,Merced,047,269075,9019,8892,22,8914,136
2020-09-29,Modoc,049,8938,29,26,0,26,0
2020-09-29,Mono,051,14174,169,149,2,151,1
2020-09-29,Monterey,053,433212,10165,9826,35,9861,70
2020-09-29,Napa,055,140530,1772,1727,8,1735,11
2020-09-29,Nevada,057,99092,551,539,18,557,6
2020-09-29,Orange,059,3164182,55780,52755,1515,54270,1231
2020-09-29,Placer,061,380077,3709,3570,13,3583,42
2020-09-29,Plumas,063,18699,51,48,0,48,0
2020-09-29,Riverside,065,2383286,60450,58863,199,59062,1208
2020-09-29,Sacramento,067,1510023,23076,22547,26,22573,425
2020-09-29,San Benito,069,59416,1351,1341,0,1341,12
2020-09-29,San Bernardino,071,2135413,55778,53753,346,54099,1012
2020-09-29,San Diego,073,3302833,48945,46987,1024,48011,781
2020-09-29,San Francisco,075,870044,11452,11142,30,11172,104
2020-09-29,San Joaquin,077,732212,20463,20094,61,20155,454
2020-09-29,San Luis Obispo,079,281455,3831,3581,21,3602,31
2020-09-29,San Mateo,081,765935,10376,9619,11,9630,127
2020-09-29,Santa Barbara,083,443738,9288,9149,79,9228,114
2020-09-29,Santa Clara,085,1922200,22531,21233,47,21280,302
2020-09-29,Santa Cruz,087,273765,2513,2383,32,2415,10
2020-09-29,Shasta,089,179085,1286,943,13,956,17
2020-09-29,Sierra,091,2930,6,6,0,6,0
2020-09-29,Siskiyou,093,43540,157,150,10,160,0
2020-09-29,Solano,095,438530,6461,6303,42,6345,51
2020-09-29,Sonoma,097,501317,7926,7426,22,7448,125
2020-09-29,Stanislaus,099,539301,16704,16505,547,17052,341
2020-09-29,Sutter,101,95872,1708,1677,1,1678,10
2020-09-29,Tehama,103,63373,628,585,2,587,2
2020-09-29,Trinity,105,12862,56,16,8,24,0
2020-09-29,Tulare,107,460477,16633,16055,150,16205,270
2020-09-29,Tuolumne,109,53932,234,224,4,228,2
2020-09-29,Ventura,111,848112,13649,12875,188,13063,145
2020-09-29,Yolo,113,214977,2883,2818,7,2825,55
2020-09-29,Yuba,115,75493,1111,1071,5,1076,8
2020-09-28,Alameda,001,1643700,21717,21133,185,21318,370
2020-09-28,Alpine,003,1148,3,2,0,2,0
2020-09-28,Amador,005,37829,296,294,0,294,16
2020-09-28,Butte,007,227075,2956,2837,27,2864,44
2020-09-28,Calaveras,009,45235,312,257,0,257,11
2020-09-28,Colusa,011,21464,533,531,0,531,6
2020-09-28,Contra Costa,013,1133247,17375,16653,82,16735,195
2020-09-28,Del Norte,015,27424,142,138,0,138,2
2020-09-28,El Dorado,017,186661,1233,1144,6,1150,4
2020-09-28,Fresno,019,978130,31003,28517,390,28907,389
2020-09-28,Glenn,021,27897,600,585,0,585,3
2020-09-28,Humboldt,023,135768,509,495,1,496,6
2020-09-28,Imperial,025,180216,11923,10777,8,10785,283
2020-09-28,Inyo,027,18085,194,188,4,192,14
2020-09-28,Kern,029,883053,32246,31481,329,31810,395
2020-09-28,Kings,031,150075,7889,7661,43,7704,78
2020-09-28,Lake,033,64148,593,559,0,559,10
2020-09-28,Lassen,035,31185,749,737,2,739,0
2020-09-28,Los Angeles,037,10098052,271392,268404,1922,270326,6508
2020-09-28,Madera,039,155013,4638,4438,31,4469,47
2020-09-28,Marin,041,260295,6774,6676,17,6693,91
2020-09-28,Mariposa,043,17540,77,74,0,74,2
2020-09-28,Mendocino,045,87422,910,850,4,854,17
2020-09-28,Merced,047,269075,8991,8869,22,8891,136
2020-09-28,Modoc,049,8938,29,26,0,26,0
2020-09-28,Mono,051,14174,169,148,2,150,1
2020-09-28,Monterey,053,433212,10100,9780,33,9813,69
2020-09-28,Napa,055,140530,1760,1705,8,1713,11
2020-09-28,Nevada,057,99092,543,538,18,556,6
2020-09-28,Orange,059,3164182,55574,52633,1506,54139,1196
2020-09-28,Placer,061,380077,3688,3572,13,3585,42
2020-09-28,Plumas,063,18699,50,48,0,48,0
2020-09-28,Riverside,065,2383286,60152,58570,190,58760,1198
2020-09-28,Sacramento,067,1510023,22929,22392,26,22418,423
2020-09-28,San Benito,069,59416,1348,1336,0,1336,11
2020-09-28,San Bernardino,071,2135413,55429,53501,346,53847,988
2020-09-28,San Diego,073,3302833,48627,46736,1004,47740,776
2020-09-28,San Francisco,075,870044,11418,11114,30,11144,100
2020-09-28,San Joaquin,077,732212,20415,19982,60,20042,448
2020-09-28,San Luis Obispo,079,281455,3810,3567,21,3588,31
2020-09-28,San Mateo,081,765935,10326,9582,11,9593,127
2020-09-28,Santa Barbara,083,443738,9270,9121,79,9200,114
2020-09-28,Santa Clara,085,1922200,22414,21180,47,21227,271
2020-09-28,Santa Cruz,087,273765,2503,2359,32,2391,9
2020-09-28,Shasta,089,179085,1232,883,10,893,17
2020-09-28,Sierra,091,2930,6,6,0,6,0
2020-09-28,Siskiyou,093,43540,157,149,10,159,0
2020-09-28,Solano,095,438530,6425,6254,42,6296,51
2020-09-28,Sonoma,097,501317,7850,7369,22,7391,125
2020-09-28,Stanislaus,099,539301,16665,16467,540,17007,336
2020-09-28,Sutter,101,95872,1701,1676,1,1677,10
2020-09-28,Tehama,103,63373,620,579,2,581,2
2020-09-28,Trinity,105,12862,56,16,8,24,0
2020-09-28,Tulare,107,460477,16580,15918,145,16063,270
2020-09-28,Tuolumne,109,53932,234,225,4,229,2
2020-09-28,Ventura,111,848112,13571,12812,181,12993,139
2020-09-28,Yolo,113,214977,2866,2809,7,2816,55
2020-09-28,Yuba,115,75493,1108,1062,5,1067,7
2020-09-27,Alameda,001,1643700,21636,21077,181,21258,370
2020-09-27,Alpine,003,1148,3,2,0,2,0
2020-09-27,Amador,005,37829,296,291,0,291,16
2020-09-27,Butte,007,227075,2944,2833,27,2860,44
2020-09-27,Calaveras,009,45235,311,257,0,257,11
2020-09-27,Colusa,011,21464,532,531,0,531,6
2020-09-27,Contra Costa,013,1133247,17273,16596,81,16677,195
2020-09-27,Del Norte,015,27424,142,138,0,138,2
2020-09-27,El Dorado,017,186661,1218,1130,6,1136,4
2020-09-27,Fresno,019,978130,30897,28441,390,28831,389
2020-09-27,Glenn,021,27897,596,576,0,576,3
2020-09-27,Humboldt,023,135768,507,492,1,493,6
2020-09-27,Imperial,025,180216,11889,10743,8,10751,283
2020-09-27,Inyo,027,18085,192,188,4,192,14
2020-09-27,Kern,029,883053,32127,31462,326,31788,395
2020-09-27,Kings,031,150075,7869,7641,43,7684,78
2020-09-27,Lake,033,64148,589,555,0,555,10
2020-09-27,Lassen,035,31185,749,737,2,739,0
2020-09-27,Los Angeles,037,10098052,270214,267754,1902,269656,6507
2020-09-27,Madera,039,155013,4609,4416,31,4447,47
2020-09-27,Marin,041,260295,6764,6663,17,6680,91
2020-09-27,Mariposa,043,17540,77,74,0,74,2
2020-09-27,Mendocino,045,87422,904,846,4,850,17
2020-09-27,Merced,047,269075,8957,8853,22,8875,136
2020-09-27,Modoc,049,8938,29,26,0,26,0
2020-09-27,Mono,051,14174,169,148,2,150,1
2020-09-27,Monterey,053,433212,10040,9724,32,9756,69
2020-09-27,Napa,055,140530,1755,1690,8,1698,11
2020-09-27,Nevada,057,99092,542,537,18,555,6
2020-09-27,Orange,059,3164182,55299,52458,1497,53955,1195
2020-09-27,Placer,061,380077,3675,3562,13,3575,42
2020-09-27,Plumas,063,18699,50,48,0,48,0
2020-09-27,Riverside,065,2383286,59856,58509,182,58691,1191
2020-09-27,Sacramento,067,1510023,22831,22356,26,22382,422
2020-09-27,San Benito,069,59416,1348,1331,0,1331,11
2020-09-27,San Bernardino,071,2135413,54993,53127,346,53473,988
2020-09-27,San Diego,073,3302833,48283,46612,987,47599,776
2020-09-27,San Francisco,075,870044,11366,11114,30,11144,100
2020-09-27,San Joaquin,077,732212,20355,19981,60,20041,448
2020-09-27,San Luis Obispo,079,281455,3790,3562,21,3583,31
2020-09-27,San Mateo,081,765935,10258,9566,11,9577,127
2020-09-27,Santa Barbara,083,443738,9249,9090,78,9168,114
2020-09-27,Santa Clara,085,1922200,22305,21091,47,21138,271
2020-09-27,Santa Cruz,087,273765,2481,2359,32,2391,9
2020-09-27,Shasta,089,179085,1189,883,9,892,17
2020-09-27,Sierra,091,2930,6,6,0,6,0
2020-09-27,Siskiyou,093,43540,156,149,10,159,0
2020-09-27,Solano,095,438530,6390,6211,41,6252,51
2020-09-27,Sonoma,097,501317,7769,7336,22,7358,124
2020-09-27,Stanislaus,099,539301,16614,16448,534,16982,336
2020-09-27,Sutter,101,95872,1694,1672,1,1673,10
2020-09-27,Tehama,103,63373,603,573,2,575,2
2020-09-27,Trinity,105,12862,56,16,8,24,0
2020-09-27,Tulare,107,460477,16502,15918,136,16054,270
2020-09-27,Tuolumne,109,53932,233,224,4,228,2
2020-09-27,Ventura,111,848112,13482,12775,172,12947,139
2020-09-27,Yolo,113,214977,2852,2796,7,2803,55
2020-09-27,Yuba,115,75493,1098,1059,5,1064,7
2020-09-26,Alameda,001,1643700,21578,21019,180,21199,370
2020-09-26,Alpine,003,1148,3,2,0,2,0
2020-09-26,Amador,005,37829,295,291,0,291,16
2020-09-26,Butte,007,227075,2936,2827,27,2854,44
2020-09-26,Calaveras,009,45235,311,257,0,257,11
2020-09-26,Colusa,011,21464,532,529,0,529,6
2020-09-26,Contra Costa,013,1133247,17230,16508,81,16589,194
2020-09-26,Del Norte,015,27424,142,138,0,138,2
2020-09-26,El Dorado,017,186661,1213,1127,6,1133,4
2020-09-26,Fresno,019,978130,30830,28336,390,28726,389
2020-09-26,Glenn,021,27897,596,576,0,576,3
2020-09-26,Humboldt,023,135768,507,491,1,492,6
2020-09-26,Imperial,025,180216,11872,10721,8,10729,283
2020-09-26,Inyo,027,18085,191,187,4,191,14
2020-09-26,Kern,029,883053,32076,31410,326,31736,394
2020-09-26,Kings,031,150075,7857,7537,43,7580,78
2020-09-26,Lake,033,64148,586,549,0,549,10
2020-09-26,Lassen,035,31185,749,737,2,739,0
2020-09-26,Los Angeles,037,10098052,269579,266931,1888,268819,6497
2020-09-26,Madera,039,155013,4593,4410,31,4441,47
2020-09-26,Marin,041,260295,6751,6641,17,6658,91
2020-09-26,Mariposa,043,17540,76,74,0,74,2
2020-09-26,Mendocino,045,87422,899,836,4,840,17
2020-09-26,Merced,047,269075,8945,8841,21,8862,136
2020-09-26,Modoc,049,8938,29,26,0,26,0
2020-09-26,Mono,051,14174,169,148,2,150,1
2020-09-26,Monterey,053,433212,10013,9651,32,9683,68
2020-09-26,Napa,055,140530,1753,1681,8,1689,11
2020-09-26,Nevada,057,99092,542,534,18,552,6
2020-09-26,Orange,059,3164182,55160,52203,1491,53694,1194
2020-09-26,Placer,061,380077,3662,3551,13,3564,42
2020-09-26,Plumas,063,18699,49,48,0,48,0
2020-09-26,Riverside,065,2383286,59721,58076,180,58256,1190
2020-09-26,Sacramento,067,1510023,22775,22269,26,22295,421
2020-09-26,San Benito,069,59416,1346,1325,0,1325,11
2020-09-26,San Bernardino,071,2135413,54860,53122,346,53468,988
2020-09-26,San Diego,073,3302833,48078,46333,973,47306,775
2020-09-26,San Francisco,075,870044,11338,11113,30,11143,100
2020-09-26,San Joaquin,077,732212,20320,19982,58,20040,449
2020-09-26,San Luis Obispo,079,281455,3774,3546,21,3567,31
2020-09-26,San Mateo,081,765935,10224,9509,11,9520,127
2020-09-26,Santa Barbara,083,443738,9238,9061,78,9139,114
2020-09-26,Santa Clara,085,1922200,22234,20967,46,21013,270
2020-09-26,Santa Cruz,087,273765,2473,2336,32,2368,9
2020-09-26,Shasta,089,179085,1139,856,8,864,17
2020-09-26,Sierra,091,2930,6,6,0,6,0
2020-09-26,Siskiyou,093,43540,155,149,10,159,0
2020-09-26,Solano,095,438530,6371,6209,41,6250,51
2020-09-26,Sonoma,097,501317,7744,7285,21,7306,124
2020-09-26,Stanislaus,099,539301,16589,16421,525,16946,336
2020-09-26,Sutter,101,95872,1689,1662,1,1663,10
2020-09-26,Tehama,103,63373,591,560,2,562,2
2020-09-26,Trinity,105,12862,54,16,8,24,0
2020-09-26,Tulare,107,460477,16476,15881,134,16015,270
2020-09-26,Tuolumne,109,53932,233,223,4,227,2
2020-09-26,Ventura,111,848112,13447,12729,171,12900,137
2020-09-26,Yolo,113,214977,2850,2789,7,2796,55
2020-09-26,Yuba,115,75493,1094,1056,5,1061,7
2020-09-25,Alameda,001,1643700,21524,20911,180,21091,367
2020-09-25,Alpine,003,1148,3,2,0,2,0
2020-09-25,Amador,005,37829,295,289,0,289,16
2020-09-25,Butte,007,227075,2931,2819,27,2846,43
2020-09-25,Calaveras,009,45235,311,257,0,257,11
2020-09-25,Colusa,011,21464,532,528,0,528,6
2020-09-25,Contra Costa,013,1133247,17171,16401,81,16482,194
2020-09-25,Del Norte,015,27424,142,138,0,138,2
2020-09-25,El Dorado,017,186661,1209,1104,6,1110,4
2020-09-25,Fresno,019,978130,30770,28199,389,28588,385
2020-09-25,Glenn,021,27897,594,570,0,570,3
2020-09-25,Humboldt,023,135768,506,489,1,490,5
2020-09-25,Imperial,025,180216,11854,10681,8,10689,283
2020-09-25,Inyo,027,18085,189,187,4,191,14
2020-09-25,Kern,029,883053,32023,31333,324,31657,393
2020-09-25,Kings,031,150075,7852,7450,43,7493,77
2020-09-25,Lake,033,64148,585,539,0,539,9
2020-09-25,Lassen,035,31185,749,737,2,739,0
2020-09-25,Los Angeles,037,10098052,268790,265713,1874,267587,6483
2020-09-25,Madera,039,155013,4574,4369,31,4400,48
2020-09-25,Marin,041,260295,6748,6622,17,6639,90
2020-09-25,Mariposa,043,17540,76,74,0,74,2
2020-09-25,Mendocino,045,87422,884,819,3,822,17
2020-09-25,Merced,047,269075,8929,8830,21,8851,135
2020-09-25,Modoc,049,8938,29,26,0,26,0
2020-09-25,Mono,051,14174,169,149,2,151,1
2020-09-25,Monterey,053,433212,9961,9581,32,9613,68
2020-09-25,Napa,055,140530,1751,1669,8,1677,11
2020-09-25,Nevada,057,99092,540,529,18,547,6
2020-09-25,Orange,059,3164182,55033,52031,1483,53514,1184
2020-09-25,Placer,061,380077,3651,3527,13,3540,41
2020-09-25,Plumas,063,18699,49,48,0,48,0
2020-09-25,Riverside,065,2383286,59545,57783,175,57958,1183
2020-09-25,Sacramento,067,1510023,22698,22132,26,22158,418
2020-09-25,San Benito,069,59416,1345,1318,0,1318,11
2020-09-25,San Bernardino,071,2135413,54706,52814,346,53160,987
2020-09-25,San Diego,073,3302833,47876,46003,957,46960,775
2020-09-25,San Francisco,075,870044,11304,11066,29,11095,100
2020-09-25,San Joaquin,077,732212,20268,19909,58,19967,449
2020-09-25,San Luis Obispo,079,281455,3762,3512,21,3533,31
2020-09-25,San Mateo,081,765935,10188,9447,11,9458,127
2020-09-25,Santa Barbara,083,443738,9214,9026,78,9104,114
2020-09-25,Santa Clara,085,1922200,22170,20812,45,20857,265
2020-09-25,Santa Cruz,087,273765,2461,2309,31,2340,9
2020-09-25,Shasta,089,179085,1105,806,8,814,16
2020-09-25,Sierra,091,2930,6,6,0,6,0
2020-09-25,Siskiyou,093,43540,155,149,10,159,0
2020-09-25,Solano,095,438530,6355,6179,41,6220,50
2020-09-25,Sonoma,097,501317,7704,7202,21,7223,124
2020-09-25,Stanislaus,099,539301,16571,16381,523,16904,326
2020-09-25,Sutter,101,95872,1686,1655,1,1656,10
2020-09-25,Tehama,103,63373,583,546,2,548,2
2020-09-25,Trinity,105,12862,54,15,8,23,0
2020-09-25,Tulare,107,460477,16436,15815,132,15947,267
2020-09-25,Tuolumne,109,53932,233,223,4,227,2
2020-09-25,Ventura,111,848112,13404,12664,168,12832,137
2020-09-25,Yolo,113,214977,2842,2784,7,2791,55
2020-09-25,Yuba,115,75493,1089,1049,5,1054,5
2020-09-24,Alameda,001,1643700,21449,20838,177,21015,364
2020-09-24,Alpine,003,1148,3,2,0,2,0
2020-09-24,Amador,005,37829,295,288,0,288,16
2020-09-24,Butte,007,227075,2920,2803,27,2830,43
2020-09-24,Calaveras,009,45235,311,258,0,258,11
2020-09-24,Colusa,011,21464,532,523,0,523,6
2020-09-24,Contra Costa,013,1133247,17089,16252,81,16333,192
2020-09-24,Del Norte,015,27424,138,137,0,137,2
2020-09-24,El Dorado,017,186661,1200,1093,6,1099,4
2020-09-24,Fresno,019,978130,30664,28106,385,28491,375
2020-09-24,Glenn,021,27897,590,567,0,567,3
2020-09-24,Humboldt,023,135768,503,482,1,483,5
2020-09-24,Imperial,025,180216,11830,10622,8,10630,283
2020-09-24,Inyo,027,18085,189,187,4,191,13
2020-09-24,Kern,029,883053,31960,31273,322,31595,388
2020-09-24,Kings,031,150075,7836,7428,43,7471,76
2020-09-24,Lake,033,64148,576,531,0,531,9
2020-09-24,Lassen,035,31185,748,737,2,739,0
2020-09-24,Los Angeles,037,10098052,267748,264374,1856,266230,6452
2020-09-24,Madera,039,155013,4555,4344,31,4375,48
2020-09-24,Marin,041,260295,6720,6588,17,6605,85
2020-09-24,Mariposa,043,17540,76,74,0,74,2
2020-09-24,Mendocino,045,87422,880,810,3,813,17
2020-09-24,Merced,047,269075,8900,8813,20,8833,135
2020-09-24,Modoc,049,8938,29,24,0,24,0
2020-09-24,Mono,051,14174,169,149,2,151,1
2020-09-24,Monterey,053,433212,9895,9544,30,9574,67
2020-09-24,Napa,055,140530,1739,1661,8,1669,11
2020-09-24,Nevada,057,99092,539,527,18,545,6
2020-09-24,Orange,059,3164182,54825,51749,1465,53214,1164
2020-09-24,Placer,061,380077,3636,3514,13,3527,41
2020-09-24,Plumas,063,18699,49,48,0,48,0
2020-09-24,Riverside,065,2383286,59279,57491,169,57660,1172
2020-09-24,Sacramento,067,1510023,22572,21985,25,22010,417
2020-09-24,San Benito,069,59416,1343,1308,0,1308,11
2020-09-24,San Bernardino,071,2135413,54369,52455,345,52800,988
2020-09-24,San Diego,073,3302833,47607,45598,942,46540,773
2020-09-24,San Francisco,075,870044,11257,10992,29,11021,99
2020-09-24,San Joaquin,077,732212,20230,19851,56,19907,444
2020-09-24,San Luis Obispo,079,281455,3746,3480,21,3501,31
2020-09-24,San Mateo,081,765935,10140,9376,11,9387,127
2020-09-24,Santa Barbara,083,443738,9161,8988,77,9065,114
2020-09-24,Santa Clara,085,1922200,22082,20689,45,20734,262
2020-09-24,Santa Cruz,087,273765,2441,2300,29,2329,9
2020-09-24,Shasta,089,179085,1068,773,5,778,14
2020-09-24,Sierra,091,2930,6,6,0,6,0
2020-09-24,Siskiyou,093,43540,155,149,10,159,0
2020-09-24,Solano,095,438530,6322,6137,41,6178,49
2020-09-24,Sonoma,097,501317,7623,7163,21,7184,122
2020-09-24,Stanislaus,099,539301,16534,16326,518,16844,326
2020-09-24,Sutter,101,95872,1683,1646,1,1647,10
2020-09-24,Tehama,103,63373,580,540,2,542,2
2020-09-24,Trinity,105,12862,54,15,8,23,0
2020-09-24,Tulare,107,460477,16371,15754,131,15885,267
2020-09-24,Tuolumne,109,53932,233,224,4,228,2
2020-09-24,Ventura,111,848112,13322,12617,167,12784,138
2020-09-24,Yolo,113,214977,2835,2776,7,2783,55
2020-09-24,Yuba,115,75493,1084,1042,5,1047,5
2020-09-23,Alameda,001,1643700,21381,20718,175,20893,361
2020-09-23,Alpine,003,1148,3,2,0,2,0
2020-09-23,Amador,005,37829,294,288,0,288,16
2020-09-23,Butte,007,227075,2912,2790,27,2817,43
2020-09-23,Calaveras,009,45235,310,258,0,258,11
2020-09-23,Colusa,011,21464,531,521,0,521,6
2020-09-23,Contra Costa,013,1133247,17027,16167,80,16247,192
2020-09-23,Del Norte,015,27424,136,137,0,137,2
2020-09-23,El Dorado,017,186661,1186,1088,6,1094,4
2020-09-23,Fresno,019,978130,30569,28019,383,28402,371
2020-09-23,Glenn,021,27897,583,561,0,561,3
2020-09-23,Humboldt,023,135768,499,477,1,478,5
2020-09-23,Imperial,025,180216,11804,10587,8,10595,284
2020-09-23,Inyo,027,18085,188,177,4,181,13
2020-09-23,Kern,029,883053,31916,31172,320,31492,387
2020-09-23,Kings,031,150075,7814,7406,43,7449,76
2020-09-23,Lake,033,64148,571,519,0,519,9
2020-09-23,Lassen,035,31185,748,736,2,738,0
2020-09-23,Los Angeles,037,10098052,266732,263318,1827,265145,6421
2020-09-23,Madera,039,155013,4540,4311,31,4342,48
2020-09-23,Marin,041,260295,6701,6567,17,6584,85
2020-09-23,Mariposa,043,17540,76,74,0,74,2
2020-09-23,Mendocino,045,87422,879,801,2,803,17
2020-09-23,Merced,047,269075,8879,8785,18,8803,134
2020-09-23,Modoc,049,8938,29,24,0,24,0
2020-09-23,Mono,051,14174,169,149,2,151,1
2020-09-23,Monterey,053,433212,9826,9452,29,9481,67
2020-09-23,Napa,055,140530,1730,1653,8,1661,11
2020-09-23,Nevada,057,99092,538,523,18,541,6
2020-09-23,Orange,059,3164182,54598,51658,1457,53115,1155
2020-09-23,Placer,061,380077,3624,3506,13,3519,41
2020-09-23,Plumas,063,18699,49,48,0,48,0
2020-09-23,Riverside,065,2383286,58973,57257,166,57423,1165
2020-09-23,Sacramento,067,1510023,22495,21821,25,21846,415
2020-09-23,San Benito,069,59416,1337,1305,0,1305,10
2020-09-23,San Bernardino,071,2135413,54075,52132,343,52475,973
2020-09-23,San Diego,073,3302833,47331,45427,923,46350,767
2020-09-23,San Francisco,075,870044,11208,10926,29,10955,95
2020-09-23,San Joaquin,077,732212,20176,19785,56,19841,439
2020-09-23,San Luis Obispo,079,281455,3728,3447,21,3468,31
2020-09-23,San Mateo,081,765935,10100,9351,11,9362,127
2020-09-23,Santa Barbara,083,443738,9132,8952,77,9029,112
2020-09-23,Santa Clara,085,1922200,21971,20575,42,20617,260
2020-09-23,Santa Cruz,087,273765,2422,2283,29,2312,9
2020-09-23,Shasta,089,179085,1029,756,4,760,14
2020-09-23,Sierra,091,2930,6,6,0,6,0
2020-09-23,Siskiyou,093,43540,155,149,10,159,0
2020-09-23,Solano,095,438530,6296,6123,41,6164,50
2020-09-23,Sonoma,097,501317,7547,7091,21,7112,122
2020-09-23,Stanislaus,099,539301,16504,16271,515,16786,317
2020-09-23,Sutter,101,95872,1679,1646,1,1647,10
2020-09-23,Tehama,103,63373,574,533,2,535,2
2020-09-23,Trinity,105,12862,53,15,8,23,0
2020-09-23,Tulare,107,460477,16306,15664,130,15794,266
2020-09-23,Tuolumne,109,53932,233,223,4,227,2
2020-09-23,Ventura,111,848112,13266,12591,164,12755,137
2020-09-23,Yolo,113,214977,2817,2766,7,2773,55
2020-09-23,Yuba,115,75493,1082,1038,5,1043,5
2020-09-22,Alameda,001,1643700,21301,20607,173,20780,355
2020-09-22,Alpine,003,1148,2,2,0,2,0
2020-09-22,Amador,005,37829,293,287,0,287,16
2020-09-22,Butte,007,227075,2907,2776,27,2803,43
2020-09-22,Calaveras,009,45235,310,258,0,258,11
2020-09-22,Colusa,011,21464,529,518,0,518,6
2020-09-22,Contra Costa,013,1133247,16937,16090,80,16170,190
2020-09-22,Del Norte,015,27424,136,137,0,137,2
2020-09-22,El Dorado,017,186661,1167,1076,6,1082,4
2020-09-22,Fresno,019,978130,30474,27944,380,28324,369
2020-09-22,Glenn,021,27897,580,560,0,560,3
2020-09-22,Humboldt,023,135768,498,476,1,477,5
2020-09-22,Imperial,025,180216,11775,10529,8,10537,284
2020-09-22,Inyo,027,18085,188,177,4,181,13
2020-09-22,Kern,029,883053,31848,31110,313,31423,383
2020-09-22,Kings,031,150075,7757,7395,42,7437,76
2020-09-22,Lake,033,64148,563,516,0,516,9
2020-09-22,Lassen,035,31185,747,736,2,738,0
2020-09-22,Los Angeles,037,10098052,265666,262117,1802,263919,6394
2020-09-22,Madera,039,155013,4524,4303,31,4334,47
2020-09-22,Marin,041,260295,6687,6561,17,6578,84
2020-09-22,Mariposa,043,17540,76,74,0,74,2
2020-09-22,Mendocino,045,87422,859,794,1,795,18
2020-09-22,Merced,047,269075,8849,8769,18,8787,132
2020-09-22,Modoc,049,8938,29,24,0,24,0
2020-09-22,Mono,051,14174,168,149,2,151,1
2020-09-22,Monterey,053,433212,9768,9393,28,9421,67
2020-09-22,Napa,055,140530,1713,1652,8,1660,11
2020-09-22,Nevada,057,99092,538,523,18,541,6
2020-09-22,Orange,059,3164182,54348,51528,1448,52976,1132
2020-09-22,Placer,061,380077,3612,3492,13,3505,40
2020-09-22,Plumas,063,18699,49,48,0,48,0
2020-09-22,Riverside,065,2383286,58489,57066,162,57228,1162
2020-09-22,Sacramento,067,1510023,22375,21745,25,21770,410
2020-09-22,San Benito,069,59416,1332,1305,0,1305,10
2020-09-22,San Bernardino,071,2135413,53801,51899,343,52242,971
2020-09-22,San Diego,073,3302833,47024,45149,904,46053,765
2020-09-22,San Francisco,075,870044,11164,10893,28,10921,95
2020-09-22,San Joaquin,077,732212,20129,19755,55,19810,426
2020-09-22,San Luis Obispo,079,281455,3706,3420,21,3441,31
2020-09-22,San Mateo,081,765935,10062,9291,11,9302,127
2020-09-22,Santa Barbara,083,443738,9102,8927,76,9003,111
2020-09-22,Santa Clara,085,1922200,21852,20514,42,20556,253
2020-09-22,Santa Cruz,087,273765,2399,2264,29,2293,8
2020-09-22,Shasta,089,179085,994,723,4,727,14
2020-09-22,Sierra,091,2930,6,6,0,6,0
2020-09-22,Siskiyou,093,43540,155,149,10,159,0
2020-09-22,Solano,095,438530,6265,6107,41,6148,48
2020-09-22,Sonoma,097,501317,7468,7068,20,7088,117
2020-09-22,Stanislaus,099,539301,16481,16231,508,16739,316
2020-09-22,Sutter,101,95872,1673,1638,1,1639,10
2020-09-22,Tehama,103,63373,566,529,2,531,2
2020-09-22,Trinity,105,12862,53,15,8,23,0
2020-09-22,Tulare,107,460477,16239,15616,126,15742,263
2020-09-22,Tuolumne,109,53932,232,224,4,228,1
2020-09-22,Ventura,111,848112,13214,12507,160,12667,136
2020-09-22,Yolo,113,214977,2810,2763,7,2770,54
2020-09-22,Yuba,115,75493,1073,1035,5,1040,5
2020-09-21,Alameda,001,1643700,21222,20501,172,20673,343
2020-09-21,Alpine,003,1148,2,2,0,2,0
2020-09-21,Amador,005,37829,291,286,0,286,16
2020-09-21,Butte,007,227075,2893,2769,27,2796,41
2020-09-21,Calaveras,009,45235,308,256,0,256,10
2020-09-21,Colusa,011,21464,528,517,0,517,6
2020-09-21,Contra Costa,013,1133247,16850,16008,80,16088,189
2020-09-21,Del Norte,015,27424,136,132,0,132,2
2020-09-21,El Dorado,017,186661,1158,1074,6,1080,4
2020-09-21,Fresno,019,978130,30372,27843,373,28216,362
2020-09-21,Glenn,021,27897,576,556,0,556,3
2020-09-21,Humboldt,023,135768,494,473,1,474,5
2020-09-21,Imperial,025,180216,11744,10521,8,10529,284
2020-09-21,Inyo,027,18085,187,177,4,181,12
2020-09-21,Kern,029,883053,31776,31031,311,31342,379
2020-09-21,Kings,031,150075,7644,7297,41,7338,76
2020-09-21,Lake,033,64148,558,508,0,508,8
2020-09-21,Lassen,035,31185,745,735,2,737,0
2020-09-21,Los Angeles,037,10098052,264580,261418,1757,263175,6360
2020-09-21,Madera,039,155013,4513,4275,30,4305,47
2020-09-21,Marin,041,260295,6676,6538,16,6554,84
2020-09-21,Mariposa,043,17540,75,74,0,74,2
2020-09-21,Mendocino,045,87422,844,778,0,778,18
2020-09-21,Merced,047,269075,8830,8749,16,8765,128
2020-09-21,Modoc,049,8938,29,22,0,22,0
2020-09-21,Mono,051,14174,168,147,2,149,1
2020-09-21,Monterey,053,433212,9704,9331,25,9356,66
2020-09-21,Napa,055,140530,1702,1641,8,1649,11
2020-09-21,Nevada,057,99092,536,515,18,533,6
2020-09-21,Orange,059,3164182,54126,51363,1441,52804,1110
2020-09-21,Placer,061,380077,3602,3473,13,3486,40
2020-09-21,Plumas,063,18699,49,47,0,47,0
2020-09-21,Riverside,065,2383286,58217,57001,155,57156,1153
2020-09-21,Sacramento,067,1510023,22194,21568,25,21593,404
2020-09-21,San Benito,069,59416,1330,1298,0,1298,10
2020-09-21,San Bernardino,071,2135413,53515,51654,343,51997,970
2020-09-21,San Diego,073,3302833,46740,44927,883,45810,760
2020-09-21,San Francisco,075,870044,11116,10743,28,10771,95
2020-09-21,San Joaquin,077,732212,20071,19579,55,19634,423
2020-09-21,San Luis Obispo,079,281455,3680,3406,21,3427,27
2020-09-21,San Mateo,081,765935,10010,9239,11,9250,127
2020-09-21,Santa Barbara,083,443738,9074,8911,76,8987,110
2020-09-21,Santa Clara,085,1922200,21751,20432,42,20474,252
2020-09-21,Santa Cruz,087,273765,2382,2257,27,2284,8
2020-09-21,Shasta,089,179085,944,696,4,700,14
2020-09-21,Sierra,091,2930,6,6,0,6,0
2020-09-21,Siskiyou,093,43540,155,146,10,156,0
2020-09-21,Solano,095,438530,6241,6019,41,6060,46
2020-09-21,Sonoma,097,501317,7392,7017,20,7037,117
2020-09-21,Stanislaus,099,539301,16451,16186,508,16694,310
2020-09-21,Sutter,101,95872,1666,1634,1,1635,10
2020-09-21,Tehama,103,63373,547,513,2,515,2
2020-09-21,Trinity,105,12862,53,15,8,23,0
2020-09-21,Tulare,107,460477,16165,15528,117,15645,260
2020-09-21,Tuolumne,109,53932,232,221,4,225,1
2020-09-21,Ventura,111,848112,13130,12477,154,12631,133
2020-09-21,Yolo,113,214977,2804,2752,7,2759,54
2020-09-21,Yuba,115,75493,1069,1033,5,1038,1
2020-09-20,Alameda,001,1643700,21122,20425,169,20594,343
2020-09-20,Alpine,003,1148,2,2,0,2,0
2020-09-20,Amador,005,37829,290,286,0,286,16
2020-09-20,Butte,007,227075,2881,2764,27,2791,39
2020-09-20,Calaveras,009,45235,304,256,0,256,10
2020-09-20,Colusa,011,21464,526,510,0,510,6
2020-09-20,Contra Costa,013,1133247,16716,15917,79,15996,189
2020-09-20,Del Norte,015,27424,134,132,0,132,2
2020-09-20,El Dorado,017,186661,1143,1073,6,1079,4
2020-09-20,Fresno,019,978130,30258,27769,368,28137,362
2020-09-20,Glenn,021,27897,572,550,0,550,3
2020-09-20,Humboldt,023,135768,494,472,1,473,5
2020-09-20,Imperial,025,180216,11717,10496,7,10503,284
2020-09-20,Inyo,027,18085,187,177,4,181,12
2020-09-20,Kern,029,883053,31693,30992,307,31299,379
2020-09-20,Kings,031,150075,7597,7159,40,7199,76
2020-09-20,Lake,033,64148,546,492,0,492,8
2020-09-20,Lassen,035,31185,745,735,2,737,0
2020-09-20,Los Angeles,037,10098052,263349,260770,1732,262502,6347
2020-09-20,Madera,039,155013,4493,4257,30,4287,47
2020-09-20,Marin,041,260295,6650,6533,16,6549,83
2020-09-20,Mariposa,043,17540,75,74,0,74,2
2020-09-20,Mendocino,045,87422,832,765,0,765,18
2020-09-20,Merced,047,269075,8803,8745,16,8761,128
2020-09-20,Modoc,049,8938,27,22,0,22,0
2020-09-20,Mono,051,14174,167,147,2,149,1
2020-09-20,Monterey,053,433212,9625,9312,25,9337,65
2020-09-20,Napa,055,140530,1693,1626,8,1634,11
2020-09-20,Nevada,057,99092,533,511,18,529,6
2020-09-20,Orange,059,3164182,53885,51233,1431,52664,1110
2020-09-20,Placer,061,380077,3587,3452,13,3465,40
2020-09-20,Plumas,063,18699,49,47,0,47,0
2020-09-20,Riverside,065,2383286,58016,56783,149,56932,1147
2020-09-20,Sacramento,067,1510023,22007,21394,24,21418,401
2020-09-20,San Benito,069,59416,1319,1291,0,1291,9
2020-09-20,San Bernardino,071,2135413,53196,51559,341,51900,970
2020-09-20,San Diego,073,3302833,46367,44579,854,45433,760
2020-09-20,San Francisco,075,870044,11062,10743,28,10771,95
2020-09-20,San Joaquin,077,732212,20006,19578,48,19626,423
2020-09-20,San Luis Obispo,079,281455,3652,3393,21,3414,27
2020-09-20,San Mateo,081,765935,9944,9198,11,9209,127
2020-09-20,Santa Barbara,083,443738,9038,8880,75,8955,110
2020-09-20,Santa Clara,085,1922200,21631,20330,41,20371,252
2020-09-20,Santa Cruz,087,273765,2362,2199,27,2226,8
2020-09-20,Shasta,089,179085,903,696,3,699,14
2020-09-20,Sierra,091,2930,6,6,0,6,0
2020-09-20,Siskiyou,093,43540,155,146,10,156,0
2020-09-20,Solano,095,438530,6197,6020,41,6061,46
2020-09-20,Sonoma,097,501317,7288,6954,20,6974,117
2020-09-20,Stanislaus,099,539301,16420,16159,501,16660,310
2020-09-20,Sutter,101,95872,1660,1624,1,1625,10
2020-09-20,Tehama,103,63373,534,509,2,511,2
2020-09-20,Trinity,105,12862,53,15,8,23,0
2020-09-20,Tulare,107,460477,16079,15528,111,15639,260
2020-09-20,Tuolumne,109,53932,232,221,4,225,1
2020-09-20,Ventura,111,848112,13064,12406,150,12556,133
2020-09-20,Yolo,113,214977,2796,2745,7,2752,54
2020-09-20,Yuba,115,75493,1062,1029,5,1034,1
2020-09-19,Alameda,001,1643700,21072,20349,166,20515,343
2020-09-19,Alpine,003,1148,2,2,0,2,0
2020-09-19,Amador,005,37829,290,285,0,285,16
2020-09-19,Butte,007,227075,2875,2748,27,2775,38
2020-09-19,Calaveras,009,45235,304,256,0,256,10
2020-09-19,Colusa,011,21464,526,507,0,507,6
2020-09-19,Contra Costa,013,1133247,16653,15783,79,15862,186
2020-09-19,Del Norte,015,27424,133,132,0,132,2
2020-09-19,El Dorado,017,186661,1137,1068,5,1073,4
2020-09-19,Fresno,019,978130,30185,27668,368,28036,362
2020-09-19,Glenn,021,27897,569,547,0,547,3
2020-09-19,Humboldt,023,135768,493,471,1,472,5
2020-09-19,Imperial,025,180216,11702,10496,7,10503,284
2020-09-19,Inyo,027,18085,187,177,4,181,12
2020-09-19,Kern,029,883053,31639,30886,304,31190,379
2020-09-19,Kings,031,150075,7591,7130,40,7170,76
2020-09-19,Lake,033,64148,546,465,0,465,8
2020-09-19,Lassen,035,31185,745,731,2,733,0
2020-09-19,Los Angeles,037,10098052,262723,259801,1718,261519,6325
2020-09-19,Madera,039,155013,4470,4237,30,4267,47
2020-09-19,Marin,041,260295,6643,6513,15,6528,81
2020-09-19,Mariposa,043,17540,75,74,0,74,2
2020-09-19,Mendocino,045,87422,829,750,0,750,18
2020-09-19,Merced,047,269075,8792,8717,15,8732,128
2020-09-19,Modoc,049,8938,27,22,0,22,0
2020-09-19,Mono,051,14174,167,147,2,149,1
2020-09-19,Monterey,053,433212,9583,9237,25,9262,65
2020-09-19,Napa,055,140530,1685,1614,8,1622,11
2020-09-19,Nevada,057,99092,531,505,18,523,6
2020-09-19,Orange,059,3164182,53757,50999,1424,52423,1105
2020-09-19,Placer,061,380077,3578,3412,13,3425,40
2020-09-19,Plumas,063,18699,49,47,0,47,0
2020-09-19,Riverside,065,2383286,57889,56562,148,56710,1147
2020-09-19,Sacramento,067,1510023,21953,21297,24,21321,396
2020-09-19,San Benito,069,59416,1315,1276,0,1276,9
2020-09-19,San Bernardino,071,2135413,53040,51353,338,51691,971
2020-09-19,San Diego,073,3302833,46139,44295,831,45126,773
2020-09-19,San Francisco,075,870044,11029,10741,28,10769,95
2020-09-19,San Joaquin,077,732212,19969,19580,48,19628,424
2020-09-19,San Luis Obispo,079,281455,3631,3369,21,3390,27
2020-09-19,San Mateo,081,765935,9913,9158,11,9169,127
2020-09-19,Santa Barbara,083,443738,9018,8862,75,8937,106
2020-09-19,Santa Clara,085,1922200,21542,20170,41,20211,251
2020-09-19,Santa Cruz,087,273765,2348,2198,26,2224,8
2020-09-19,Shasta,089,179085,876,687,3,690,14
2020-09-19,Sierra,091,2930,6,6,0,6,0
2020-09-19,Siskiyou,093,43540,155,146,10,156,0
2020-09-19,Solano,095,438530,6181,5998,41,6039,46
2020-09-19,Sonoma,097,501317,7255,6905,20,6925,117
2020-09-19,Stanislaus,099,539301,16380,16109,494,16603,313
2020-09-19,Sutter,101,95872,1659,1602,1,1603,10
2020-09-19,Tehama,103,63373,529,498,2,500,2
2020-09-19,Trinity,105,12862,53,15,8,23,0
2020-09-19,Tulare,107,460477,16030,15485,108,15593,260
2020-09-19,Tuolumne,109,53932,232,217,4,221,1
2020-09-19,Ventura,111,848112,13032,12328,150,12478,133
2020-09-19,Yolo,113,214977,2788,2739,7,2746,54
2020-09-19,Yuba,115,75493,1055,1023,5,1028,1
2020-09-18,Alameda,001,1643700,21007,20222,160,20382,341
2020-09-18,Alpine,003,1148,2,2,0,2,0
2020-09-18,Amador,005,37829,290,285,0,285,16
2020-09-18,Butte,007,227075,2873,2738,27,2765,37
2020-09-18,Calaveras,009,45235,304,255,0,255,9
2020-09-18,Colusa,011,21464,526,504,0,504,6
2020-09-18,Contra Costa,013,1133247,16568,15667,79,15746,185
2020-09-18,Del Norte,015,27424,133,131,0,131,2
2020-09-18,El Dorado,017,186661,1124,1063,5,1068,4
2020-09-18,Fresno,019,978130,30120,27560,368,27928,359
2020-09-18,Glenn,021,27897,566,541,0,541,3
2020-09-18,Humboldt,023,135768,490,470,1,471,5
2020-09-18,Imperial,025,180216,11687,10460,7,10467,283
2020-09-18,Inyo,027,18085,187,177,4,181,12
2020-09-18,Kern,029,883053,31581,30742,301,31043,373
2020-09-18,Kings,031,150075,7581,7062,40,7102,74
2020-09-18,Lake,033,64148,540,458,0,458,8
2020-09-18,Lassen,035,31185,744,731,2,733,0
2020-09-18,Los Angeles,037,10098052,261962,258488,1700,260188,6324
2020-09-18,Madera,039,155013,4458,4211,30,4241,45
2020-09-18,Marin,041,260295,6628,6475,15,6490,81
2020-09-18,Mariposa,043,17540,75,74,0,74,2
2020-09-18,Mendocino,045,87422,821,739,0,739,18
2020-09-18,Merced,047,269075,8780,8691,14,8705,127
2020-09-18,Modoc,049,8938,27,22,0,22,0
2020-09-18,Mono,051,14174,165,147,2,149,1
2020-09-18,Monterey,053,433212,9542,9183,25,9208,64
2020-09-18,Napa,055,140530,1679,1604,8,1612,11
2020-09-18,Nevada,057,99092,528,504,18,522,6
2020-09-18,Orange,059,3164182,53610,50733,1412,52145,1107
2020-09-18,Placer,061,380077,3567,3389,13,3402,40
2020-09-18,Plumas,063,18699,49,45,0,45,0
2020-09-18,Riverside,065,2383286,57767,56248,143,56391,1143
2020-09-18,Sacramento,067,1510023,21870,21105,24,21129,391
2020-09-18,San Benito,069,59416,1307,1257,0,1257,8
2020-09-18,San Bernardino,071,2135413,52895,51106,335,51441,970
2020-09-18,San Diego,073,3302833,45889,44009,826,44835,757
2020-09-18,San Francisco,075,870044,10991,10644,27,10671,95
2020-09-18,San Joaquin,077,732212,19925,19531,47,19578,423
2020-09-18,San Luis Obispo,079,281455,3607,3328,21,3349,27
2020-09-18,San Mateo,081,765935,9873,9062,11,9073,127
2020-09-18,Santa Barbara,083,443738,8997,8824,75,8899,107
2020-09-18,Santa Clara,085,1922200,21444,20058,41,20099,252
2020-09-18,Santa Cruz,087,273765,2327,2180,25,2205,8
2020-09-18,Shasta,089,179085,841,668,3,671,14
2020-09-18,Sierra,091,2930,6,6,0,6,0
2020-09-18,Siskiyou,093,43540,154,146,10,156,0
2020-09-18,Solano,095,438530,6165,5961,41,6002,46
2020-09-18,Sonoma,097,501317,7207,6856,20,6876,114
2020-09-18,Stanislaus,099,539301,16352,16042,488,16530,277
2020-09-18,Sutter,101,95872,1652,1586,1,1587,10
2020-09-18,Tehama,103,63373,529,490,2,492,2
2020-09-18,Trinity,105,12862,53,15,7,22,0
2020-09-18,Tulare,107,460477,15997,15435,104,15539,259
2020-09-18,Tuolumne,109,53932,231,216,4,220,1
2020-09-18,Ventura,111,848112,12971,12236,146,12382,133
2020-09-18,Yolo,113,214977,2782,2732,7,2739,54
2020-09-18,Yuba,115,75493,1051,1020,5,1025,1
2020-09-17,Alameda,001,1643700,20908,20146,160,20306,339
2020-09-17,Alpine,003,1148,2,2,0,2,0
2020-09-17,Amador,005,37829,288,284,0,284,16
2020-09-17,Butte,007,227075,2855,2720,27,2747,38
2020-09-17,Calaveras,009,45235,304,254,0,254,9
2020-09-17,Colusa,011,21464,524,499,0,499,6
2020-09-17,Contra Costa,013,1133247,16480,15576,79,15655,184
2020-09-17,Del Norte,015,27424,133,131,0,131,2
2020-09-17,El Dorado,017,186661,1115,1057,5,1062,4
2020-09-17,Fresno,019,978130,30011,27487,363,27850,355
2020-09-17,Glenn,021,27897,565,541,0,541,3
2020-09-17,Humboldt,023,135768,484,466,1,467,5
2020-09-17,Imperial,025,180216,11670,10436,7,10443,281
2020-09-17,Inyo,027,18085,187,176,4,180,12
2020-09-17,Kern,029,883053,31520,30627,294,30921,372
2020-09-17,Kings,031,150075,7510,7015,40,7055,72
2020-09-17,Lake,033,64148,530,433,0,433,8
2020-09-17,Lassen,035,31185,742,731,2,733,0
2020-09-17,Los Angeles,037,10098052,261020,257246,1685,258931,6318
2020-09-17,Madera,039,155013,4424,4152,30,4182,45
2020-09-17,Marin,041,260295,6607,6457,15,6472,81
2020-09-17,Mariposa,043,17540,75,74,0,74,2
2020-09-17,Mendocino,045,87422,810,737,0,737,18
2020-09-17,Merced,047,269075,8761,8671,14,8685,119
2020-09-17,Modoc,049,8938,27,22,0,22,0
2020-09-17,Mono,051,14174,165,147,2,149,1
2020-09-17,Monterey,053,433212,9480,9113,25,9138,62
2020-09-17,Napa,055,140530,1668,1592,8,1600,11
2020-09-17,Nevada,057,99092,526,494,18,512,6
2020-09-17,Orange,059,3164182,53429,50537,1400,51937,1098
2020-09-17,Placer,061,380077,3546,3368,13,3381,40
2020-09-17,Plumas,063,18699,49,45,0,45,0
2020-09-17,Riverside,065,2383286,57541,56007,142,56149,1134
2020-09-17,Sacramento,067,1510023,21635,20895,24,20919,385
2020-09-17,San Benito,069,59416,1304,1252,0,1252,8
2020-09-17,San Bernardino,071,2135413,52693,50770,335,51105,904
2020-09-17,San Diego,073,3302833,45609,43621,814,44435,754
2020-09-17,San Francisco,075,870044,10897,10564,27,10591,95
2020-09-17,San Joaquin,077,732212,19866,19439,47,19486,416
2020-09-17,San Luis Obispo,079,281455,3577,3299,21,3320,27
2020-09-17,San Mateo,081,765935,9831,8984,11,8995,127
2020-09-17,Santa Barbara,083,443738,8973,8779,75,8854,107
2020-09-17,Santa Clara,085,1922200,21327,19825,41,19866,254
2020-09-17,Santa Cruz,087,273765,2311,2155,25,2180,7
2020-09-17,Shasta,089,179085,802,660,3,663,12
2020-09-17,Sierra,091,2930,6,6,0,6,0
2020-09-17,Siskiyou,093,43540,154,146,10,156,0
2020-09-17,Solano,095,438530,6142,5915,41,5956,44
2020-09-17,Sonoma,097,501317,7143,6754,20,6774,114
2020-09-17,Stanislaus,099,539301,16319,15984,484,16468,277
2020-09-17,Sutter,101,95872,1647,1572,1,1573,10
2020-09-17,Tehama,103,63373,515,487,2,489,2
2020-09-17,Trinity,105,12862,53,15,7,22,0
2020-09-17,Tulare,107,460477,15944,15344,102,15446,258
2020-09-17,Tuolumne,109,53932,230,214,4,218,1
2020-09-17,Ventura,111,848112,12884,12167,142,12309,130
2020-09-17,Yolo,113,214977,2773,2724,7,2731,53
2020-09-17,Yuba,115,75493,1047,1015,5,1020,1
2020-09-16,Alameda,001,1643700,20810,20009,158,20167,333
2020-09-16,Alpine,003,1148,2,2,0,2,0
2020-09-16,Amador,005,37829,288,284,0,284,16
2020-09-16,Butte,007,227075,2845,2704,26,2730,38
2020-09-16,Calaveras,009,45235,304,254,0,254,9
2020-09-16,Colusa,011,21464,522,497,0,497,6
2020-09-16,Contra Costa,013,1133247,16394,15473,79,15552,183
2020-09-16,Del Norte,015,27424,133,131,0,131,2
2020-09-16,El Dorado,017,186661,1107,1049,5,1054,4
2020-09-16,Fresno,019,978130,29904,27381,361,27742,343
2020-09-16,Glenn,021,27897,563,539,0,539,3
2020-09-16,Humboldt,023,135768,483,455,1,456,4
2020-09-16,Imperial,025,180216,11647,10401,7,10408,277
2020-09-16,Inyo,027,18085,186,176,4,180,12
2020-09-16,Kern,029,883053,31460,30570,293,30863,371
2020-09-16,Kings,031,150075,7485,7002,37,7039,71
2020-09-16,Lake,033,64148,519,417,0,417,6
2020-09-16,Lassen,035,31185,741,730,2,732,0
2020-09-16,Los Angeles,037,10098052,260040,256101,1668,257769,6299
2020-09-16,Madera,039,155013,4401,4138,30,4168,45
2020-09-16,Marin,041,260295,6579,6430,15,6445,77
2020-09-16,Mariposa,043,17540,75,74,0,74,2
2020-09-16,Mendocino,045,87422,801,727,0,727,18
2020-09-16,Merced,047,269075,8740,8646,14,8660,118
2020-09-16,Modoc,049,8938,27,22,0,22,0
2020-09-16,Mono,051,14174,165,147,2,149,1
2020-09-16,Monterey,053,433212,9426,8997,25,9022,62
2020-09-16,Napa,055,140530,1654,1587,8,1595,11
2020-09-16,Nevada,057,99092,521,495,17,512,6
2020-09-16,Orange,059,3164182,53228,50414,1391,51805,1096
2020-09-16,Placer,061,380077,3528,3351,13,3364,39
2020-09-16,Plumas,063,18699,49,45,0,45,0
2020-09-16,Riverside,065,2383286,57347,55811,134,55945,1127
2020-09-16,Sacramento,067,1510023,21540,20610,24,20634,377
2020-09-16,San Benito,069,59416,1296,1244,0,1244,8
2020-09-16,San Bernardino,071,2135413,52468,50509,334,50843,907
2020-09-16,San Diego,073,3302833,45317,43447,793,44240,748
2020-09-16,San Francisco,075,870044,10850,10502,27,10529,90
2020-09-16,San Joaquin,077,732212,19812,19377,46,19423,409
2020-09-16,San Luis Obispo,079,281455,3546,3285,21,3306,28
2020-09-16,San Mateo,081,765935,9766,8944,11,8955,127
2020-09-16,Santa Barbara,083,443738,8940,8764,75,8839,107
2020-09-16,Santa Clara,085,1922200,21208,19684,41,19725,253
2020-09-16,Santa Cruz,087,273765,2270,2089,24,2113,7
2020-09-16,Shasta,089,179085,776,635,3,638,11
2020-09-16,Sierra,091,2930,6,6,0,6,0
2020-09-16,Siskiyou,093,43540,153,145,10,155,0
2020-09-16,Solano,095,438530,6112,5899,41,5940,44
2020-09-16,Sonoma,097,501317,7082,6731,20,6751,104
2020-09-16,Stanislaus,099,539301,16271,15897,476,16373,263
2020-09-16,Sutter,101,95872,1634,1567,1,1568,10
2020-09-16,Tehama,103,63373,507,485,2,487,2
2020-09-16,Trinity,105,12862,53,15,7,22,0
2020-09-16,Tulare,107,460477,15899,15314,95,15409,258
2020-09-16,Tuolumne,109,53932,229,210,4,214,1
2020-09-16,Ventura,111,848112,12813,12073,140,12213,130
2020-09-16,Yolo,113,214977,2766,2709,7,2716,53
2020-09-16,Yuba,115,75493,1045,1000,5,1005,1
2020-09-15,Alameda,001,1643700,20703,19931,155,20086,327
2020-09-15,Alpine,003,1148,2,2,0,2,0
2020-09-15,Amador,005,37829,287,282,0,282,16
2020-09-15,Butte,007,227075,2832,2695,24,2719,38
2020-09-15,Calaveras,009,45235,304,248,0,248,5
2020-09-15,Colusa,011,21464,516,497,0,497,6
2020-09-15,Contra Costa,013,1133247,16293,15423,78,15501,180
2020-09-15,Del Norte,015,27424,133,129,0,129,2
2020-09-15,El Dorado,017,186661,1102,1046,5,1051,4
2020-09-15,Fresno,019,978130,29797,27312,356,27668,343
2020-09-15,Glenn,021,27897,562,531,0,531,3
2020-09-15,Humboldt,023,135768,481,456,1,457,4
2020-09-15,Imperial,025,180216,11622,10376,7,10383,277
2020-09-15,Inyo,027,18085,186,176,4,180,12
2020-09-15,Kern,029,883053,31347,30429,290,30719,368
2020-09-15,Kings,031,150075,7327,6977,37,7014,70
2020-09-15,Lake,033,64148,505,416,0,416,4
2020-09-15,Lassen,035,31185,737,719,2,721,0
2020-09-15,Los Angeles,037,10098052,258930,255048,1646,256694,6269
2020-09-15,Madera,039,155013,4382,4122,30,4152,45
2020-09-15,Marin,041,260295,6548,6423,15,6438,77
2020-09-15,Mariposa,043,17540,75,74,0,74,2
2020-09-15,Mendocino,045,87422,783,724,0,724,18
2020-09-15,Merced,047,269075,8710,8633,14,8647,114
2020-09-15,Modoc,049,8938,26,21,0,21,0
2020-09-15,Mono,051,14174,165,147,2,149,1
2020-09-15,Monterey,053,433212,9377,8943,25,8968,62
2020-09-15,Napa,055,140530,1640,1580,8,1588,11
2020-09-15,Nevada,057,99092,516,494,17,511,6
2020-09-15,Orange,059,3164182,53046,50294,1376,51670,1088
2020-09-15,Placer,061,380077,3504,3331,13,3344,38
2020-09-15,Plumas,063,18699,49,44,0,44,0
2020-09-15,Riverside,065,2383286,57053,55569,124,55693,1118
2020-09-15,Sacramento,067,1510023,21397,20487,24,20511,372
2020-09-15,San Benito,069,59416,1289,1237,0,1237,7
2020-09-15,San Bernardino,071,2135413,52252,50333,333,50666,904
2020-09-15,San Diego,073,3302833,44998,43183,773,43956,742
2020-09-15,San Francisco,075,870044,10792,10414,27,10441,90
2020-09-15,San Joaquin,077,732212,19760,19313,46,19359,401
2020-09-15,San Luis Obispo,079,281455,3526,3262,21,3283,28
2020-09-15,San Mateo,081,765935,9696,8895,11,8906,127
2020-09-15,Santa Barbara,083,443738,8915,8724,74,8798,104
2020-09-15,Santa Clara,085,1922200,21072,19610,41,19651,252
2020-09-15,Santa Cruz,087,273765,2244,2079,23,2102,7
2020-09-15,Shasta,089,179085,764,627,3,630,11
2020-09-15,Sierra,091,2930,6,6,0,6,0
2020-09-15,Siskiyou,093,43540,153,143,10,153,0
2020-09-15,Solano,095,438530,6078,5878,41,5919,45
2020-09-15,Sonoma,097,501317,7043,6701,20,6721,104
2020-09-15,Stanislaus,099,539301,16223,15880,474,16354,260
2020-09-15,Sutter,101,95872,1623,1556,1,1557,10
2020-09-15,Tehama,103,63373,495,484,2,486,2
2020-09-15,Trinity,105,12862,53,15,7,22,0
2020-09-15,Tulare,107,460477,15823,15203,93,15296,254
2020-09-15,Tuolumne,109,53932,229,209,4,213,1
2020-09-15,Ventura,111,848112,12760,11932,139,12071,128
2020-09-15,Yolo,113,214977,2762,2708,7,2715,53
2020-09-15,Yuba,115,75493,1039,991,4,995,1
2020-09-14,Alameda,001,1643700,20576,19851,154,20005,306
2020-09-14,Alpine,003,1148,2,2,0,2,0
2020-09-14,Amador,005,37829,285,281,0,281,16
2020-09-14,Butte,007,227075,2815,2642,24,2666,37
2020-09-14,Calaveras,009,45235,304,244,0,244,3
2020-09-14,Colusa,011,21464,515,486,0,486,6
2020-09-14,Contra Costa,013,1133247,16169,15354,77,15431,174
2020-09-14,Del Norte,015,27424,130,116,0,116,2
2020-09-14,El Dorado,017,186661,1098,1039,5,1044,3
2020-09-14,Fresno,019,978130,29712,27232,353,27585,344
2020-09-14,Glenn,021,27897,554,521,0,521,3
2020-09-14,Humboldt,023,135768,478,437,1,438,4
2020-09-14,Imperial,025,180216,11602,10340,7,10347,273
2020-09-14,Inyo,027,18085,186,176,4,180,12
2020-09-14,Kern,029,883053,31259,30344,289,30633,368
2020-09-14,Kings,031,150075,7246,6950,37,6987,70
2020-09-14,Lake,033,64148,485,407,0,407,4
2020-09-14,Lassen,035,31185,737,719,2,721,0
2020-09-14,Los Angeles,037,10098052,257901,254622,1621,256243,6226
2020-09-14,Madera,039,155013,4368,4104,30,4134,45
2020-09-14,Marin,041,260295,6527,6409,15,6424,70
2020-09-14,Mariposa,043,17540,75,74,0,74,2
2020-09-14,Mendocino,045,87422,766,710,0,710,17
2020-09-14,Merced,047,269075,8691,8593,14,8607,112
2020-09-14,Modoc,049,8938,26,21,0,21,0
2020-09-14,Mono,051,14174,165,147,2,149,1
2020-09-14,Monterey,053,433212,9306,8845,24,8869,61
2020-09-14,Napa,055,140530,1623,1576,8,1584,11
2020-09-14,Nevada,057,99092,511,489,17,506,6
2020-09-14,Orange,059,3164182,52885,50149,1360,51509,1079
2020-09-14,Placer,061,380077,3483,3302,13,3315,38
2020-09-14,Plumas,063,18699,48,42,0,42,0
2020-09-14,Riverside,065,2383286,56834,55488,119,55607,1113
2020-09-14,Sacramento,067,1510023,21202,20377,23,20400,367
2020-09-14,San Benito,069,59416,1274,1233,0,1233,7
2020-09-14,San Bernardino,071,2135413,52027,50163,332,50495,895
2020-09-14,San Diego,073,3302833,44687,42889,753,43642,734
2020-09-14,San Francisco,075,870044,10725,10255,25,10280,90
2020-09-14,San Joaquin,077,732212,19686,19111,45,19156,397
2020-09-14,San Luis Obispo,079,281455,3501,3248,21,3269,25
2020-09-14,San Mateo,081,765935,9635,8847,11,8858,127
2020-09-14,Santa Barbara,083,443738,8889,8692,74,8766,104
2020-09-14,Santa Clara,085,1922200,20884,19545,41,19586,247
2020-09-14,Santa Cruz,087,273765,2223,2016,22,2038,7
2020-09-14,Shasta,089,179085,741,584,3,587,10
2020-09-14,Sierra,091,2930,6,6,0,6,0
2020-09-14,Siskiyou,093,43540,152,143,10,153,0
2020-09-14,Solano,095,438530,6043,5834,41,5875,44
2020-09-14,Sonoma,097,501317,6981,6630,20,6650,102
2020-09-14,Stanislaus,099,539301,16178,15812,471,16283,253
2020-09-14,Sutter,101,95872,1612,1549,1,1550,10
2020-09-14,Tehama,103,63373,493,475,2,477,1
2020-09-14,Trinity,105,12862,52,14,7,21,0
2020-09-14,Tulare,107,460477,15753,15096,87,15183,254
2020-09-14,Tuolumne,109,53932,228,208,4,212,1
2020-09-14,Ventura,111,848112,12658,11903,136,12039,125
2020-09-14,Yolo,113,214977,2751,2687,7,2694,53
2020-09-14,Yuba,115,75493,1031,977,4,981,1
2020-09-13,Alameda,001,1643700,20470,19815,151,19966,306
2020-09-13,Alpine,003,1148,2,2,0,2,0
2020-09-13,Amador,005,37829,282,279,0,279,16
2020-09-13,Butte,007,227075,2793,2640,24,2664,37
2020-09-13,Calaveras,009,45235,303,246,0,246,3
2020-09-13,Colusa,011,21464,511,486,0,486,6
2020-09-13,Contra Costa,013,1133247,16063,15284,77,15361,172
2020-09-13,Del Norte,015,27424,127,116,0,116,1
2020-09-13,El Dorado,017,186661,1093,1035,5,1040,2
2020-09-13,Fresno,019,978130,29604,27196,344,27540,345
2020-09-13,Glenn,021,27897,550,517,0,517,3
2020-09-13,Humboldt,023,135768,478,434,1,435,4
2020-09-13,Imperial,025,180216,11565,10304,6,10310,273
2020-09-13,Inyo,027,18085,186,176,4,180,12
2020-09-13,Kern,029,883053,31166,30277,282,30559,368
2020-09-13,Kings,031,150075,7227,6937,37,6974,70
2020-09-13,Lake,033,64148,466,397,0,397,4
2020-09-13,Lassen,035,31185,734,719,2,721,0
2020-09-13,Los Angeles,037,10098052,256750,253950,1605,255555,6203
2020-09-13,Madera,039,155013,4311,4090,30,4120,45
2020-09-13,Marin,041,260295,6506,6395,15,6410,70
2020-09-13,Mariposa,043,17540,75,74,0,74,2
2020-09-13,Mendocino,045,87422,759,707,0,707,17
2020-09-13,Merced,047,269075,8657,8575,14,8589,112
2020-09-13,Modoc,049,8938,26,21,0,21,0
2020-09-13,Mono,051,14174,165,147,2,149,1
2020-09-13,Monterey,053,433212,9224,8826,23,8849,61
2020-09-13,Napa,055,140530,1616,1563,8,1571,11
2020-09-13,Nevada,057,99092,503,486,17,503,6
2020-09-13,Orange,059,3164182,52669,50061,1353,51414,1075
2020-09-13,Placer,061,380077,3453,3291,13,3304,38
2020-09-13,Plumas,063,18699,48,42,0,42,0
2020-09-13,Riverside,065,2383286,56627,55235,108,55343,1108
2020-09-13,Sacramento,067,1510023,20856,20279,23,20302,367
2020-09-13,San Benito,069,59416,1266,1217,0,1217,7
2020-09-13,San Bernardino,071,2135413,51741,49968,330,50298,895
2020-09-13,San Diego,073,3302833,44361,42681,719,43400,734
2020-09-13,San Francisco,075,870044,10647,10254,25,10279,90
2020-09-13,San Joaquin,077,732212,19615,19110,44,19154,396
2020-09-13,San Luis Obispo,079,281455,3464,3240,21,3261,24
2020-09-13,San Mateo,081,765935,9574,8811,11,8822,127
2020-09-13,Santa Barbara,083,443738,8852,8690,74,8764,104
2020-09-13,Santa Clara,085,1922200,20746,19456,40,19496,245
2020-09-13,Santa Cruz,087,273765,2190,2016,20,2036,7
2020-09-13,Shasta,089,179085,729,583,3,586,10
2020-09-13,Sierra,091,2930,6,6,0,6,0
2020-09-13,Siskiyou,093,43540,152,143,9,152,0
2020-09-13,Solano,095,438530,5997,5810,41,5851,43
2020-09-13,Sonoma,097,501317,6916,6592,20,6612,95
2020-09-13,Stanislaus,099,539301,16115,15759,459,16218,253
2020-09-13,Sutter,101,95872,1600,1539,1,1540,10
2020-09-13,Tehama,103,63373,489,476,2,478,1
2020-09-13,Trinity,105,12862,52,14,7,21,0
2020-09-13,Tulare,107,460477,15682,15098,86,15184,254
2020-09-13,Tuolumne,109,53932,224,208,4,212,1
2020-09-13,Ventura,111,848112,12550,11855,135,11990,123
2020-09-13,Yolo,113,214977,2739,2675,7,2682,53
2020-09-13,Yuba,115,75493,1026,967,4,971,1
2020-09-12,Alameda,001,1643700,20411,19758,151,19909,307
2020-09-12,Alpine,003,1148,2,2,0,2,0
2020-09-12,Amador,005,37829,281,278,0,278,16
2020-09-12,Butte,007,227075,2786,2629,23,2652,37
2020-09-12,Calaveras,009,45235,301,246,0,246,3
2020-09-12,Colusa,011,21464,507,486,0,486,6
2020-09-12,Contra Costa,013,1133247,15986,15135,76,15211,174
2020-09-12,Del Norte,015,27424,126,116,0,116,1
2020-09-12,El Dorado,017,186661,1086,1034,5,1039,2
2020-09-12,Fresno,019,978130,29533,27076,344,27420,345
2020-09-12,Glenn,021,27897,549,517,0,517,3
2020-09-12,Humboldt,023,135768,477,430,1,431,4
2020-09-12,Imperial,025,180216,11553,10305,6,10311,273
2020-09-12,Inyo,027,18085,186,177,4,181,12
2020-09-12,Kern,029,883053,31100,30202,282,30484,368
2020-09-12,Kings,031,150075,7217,6895,37,6932,70
2020-09-12,Lake,033,64148,460,393,0,393,4
2020-09-12,Lassen,035,31185,734,719,2,721,0
2020-09-12,Los Angeles,037,10098052,256191,253156,1584,254740,6193
2020-09-12,Madera,039,155013,4300,4058,30,4088,43
2020-09-12,Marin,041,260295,6497,6393,15,6408,69
2020-09-12,Mariposa,043,17540,75,72,0,72,2
2020-09-12,Mendocino,045,87422,756,700,0,700,17
2020-09-12,Merced,047,269075,8648,8533,14,8547,112
2020-09-12,Modoc,049,8938,25,21,0,21,0
2020-09-12,Mono,051,14174,165,147,2,149,1
2020-09-12,Monterey,053,433212,9188,8743,23,8766,61
2020-09-12,Napa,055,140530,1613,1556,8,1564,11
2020-09-12,Nevada,057,99092,502,482,17,499,6
2020-09-12,Orange,059,3164182,52554,49895,1350,51245,1078
2020-09-12,Placer,061,380077,3436,3280,13,3293,38
2020-09-12,Plumas,063,18699,48,42,0,42,0
2020-09-12,Riverside,065,2383286,56498,55058,104,55162,1108
2020-09-12,Sacramento,067,1510023,20787,20184,23,20207,367
2020-09-12,San Benito,069,59416,1263,1208,0,1208,7
2020-09-12,San Bernardino,071,2135413,51650,49945,328,50273,896
2020-09-12,San Diego,073,3302833,44166,42416,710,43126,747
2020-09-12,San Francisco,075,870044,10602,10257,25,10282,90
2020-09-12,San Joaquin,077,732212,19587,19108,44,19152,396
2020-09-12,San Luis Obispo,079,281455,3437,3220,21,3241,24
2020-09-12,San Mateo,081,765935,9529,8759,11,8770,127
2020-09-12,Santa Barbara,083,443738,8838,8642,74,8716,104
2020-09-12,Santa Clara,085,1922200,20662,19330,40,19370,237
2020-09-12,Santa Cruz,087,273765,2178,2016,20,2036,7
2020-09-12,Shasta,089,179085,717,569,3,572,10
2020-09-12,Sierra,091,2930,6,6,0,6,0
2020-09-12,Siskiyou,093,43540,152,141,9,150,0
2020-09-12,Solano,095,438530,5973,5772,41,5813,43
2020-09-12,Sonoma,097,501317,6891,6531,20,6551,95
2020-09-12,Stanislaus,099,539301,16083,15675,456,16131,253
2020-09-12,Sutter,101,95872,1594,1529,1,1530,10
2020-09-12,Tehama,103,63373,486,471,2,473,1
2020-09-12,Trinity,105,12862,52,15,7,22,0
2020-09-12,Tulare,107,460477,15636,15018,85,15103,254
2020-09-12,Tuolumne,109,53932,224,208,4,212,1
2020-09-12,Ventura,111,848112,12499,11759,133,11892,123
2020-09-12,Yolo,113,214977,2732,2646,7,2653,53
2020-09-12,Yuba,115,75493,1022,963,4,967,1
2020-09-11,Alameda,001,1643700,20356,19625,150,19775,298
2020-09-11,Alpine,003,1148,2,2,0,2,0
2020-09-11,Amador,005,37829,281,277,0,277,16
2020-09-11,Butte,007,227075,2775,2605,23,2628,37
2020-09-11,Calaveras,009,45235,300,242,0,242,1
2020-09-11,Colusa,011,21464,506,484,0,484,6
2020-09-11,Contra Costa,013,1133247,15934,15001,73,15074,173
2020-09-11,Del Norte,015,27424,126,115,0,115,1
2020-09-11,El Dorado,017,186661,1083,1024,5,1029,2
2020-09-11,Fresno,019,978130,29453,26917,343,27260,344
2020-09-11,Glenn,021,27897,544,515,0,515,3
2020-09-11,Humboldt,023,135768,475,426,1,427,4
2020-09-11,Imperial,025,180216,11535,10286,6,10292,273
2020-09-11,Inyo,027,18085,186,176,4,180,12
2020-09-11,Kern,029,883053,31032,30059,281,30340,365
2020-09-11,Kings,031,150075,7200,6770,37,6807,70
2020-09-11,Lake,033,64148,453,382,0,382,4
2020-09-11,Lassen,035,31185,734,719,2,721,0
2020-09-11,Los Angeles,037,10098052,255510,252057,1573,253630,6172
2020-09-11,Madera,039,155013,4281,4018,30,4048,43
2020-09-11,Marin,041,260295,6494,6364,15,6379,69
2020-09-11,Mariposa,043,17540,75,72,0,72,2
2020-09-11,Mendocino,045,87422,745,700,0,700,17
2020-09-11,Merced,047,269075,8627,8489,14,8503,109
2020-09-11,Modoc,049,8938,25,21,0,21,0
2020-09-11,Mono,051,14174,165,145,2,147,1
2020-09-11,Monterey,053,433212,9140,8595,23,8618,61
2020-09-11,Napa,055,140530,1602,1543,8,1551,11
2020-09-11,Nevada,057,99092,495,483,17,500,6
2020-09-11,Orange,059,3164182,52425,49755,1338,51093,1068
2020-09-11,Placer,061,380077,3421,3254,13,3267,37
2020-09-11,Plumas,063,18699,48,42,0,42,0
2020-09-11,Riverside,065,2383286,56363,54717,101,54818,1099
2020-09-11,Sacramento,067,1510023,20702,20012,23,20035,358
2020-09-11,San Benito,069,59416,1253,1202,0,1202,7
2020-09-11,San Bernardino,071,2135413,51551,49682,328,50010,871
2020-09-11,San Diego,073,3302833,43946,41971,704,42675,730
2020-09-11,San Francisco,075,870044,10554,10133,24,10157,89
2020-09-11,San Joaquin,077,732212,19539,19019,44,19063,391
2020-09-11,San Luis Obispo,079,281455,3419,3190,21,3211,24
2020-09-11,San Mateo,081,765935,9487,8611,11,8622,127
2020-09-11,Santa Barbara,083,443738,8805,8592,73,8665,103
2020-09-11,Santa Clara,085,1922200,20573,19065,40,19105,234
2020-09-11,Santa Cruz,087,273765,2161,1997,20,2017,7
2020-09-11,Shasta,089,179085,707,568,3,571,10
2020-09-11,Sierra,091,2930,6,6,0,6,0
2020-09-11,Siskiyou,093,43540,151,139,9,148,0
2020-09-11,Solano,095,438530,5956,5742,41,5783,42
2020-09-11,Sonoma,097,501317,6846,6469,20,6489,91
2020-09-11,Stanislaus,099,539301,16045,15613,453,16066,253
2020-09-11,Sutter,101,95872,1584,1505,1,1506,11
2020-09-11,Tehama,103,63373,483,466,2,468,1
2020-09-11,Trinity,105,12862,52,16,7,23,0
2020-09-11,Tulare,107,460477,15605,14932,83,15015,251
2020-09-11,Tuolumne,109,53932,224,208,4,212,1
2020-09-11,Ventura,111,848112,12445,11700,131,11831,123
2020-09-11,Yolo,113,214977,2721,2632,7,2639,53
2020-09-11,Yuba,115,75493,1014,946,4,950,1
2020-09-10,Alameda,001,1643700,20282,19509,150,19659,292
2020-09-10,Alpine,003,1148,2,2,0,2,0
2020-09-10,Amador,005,37829,280,277,0,277,16
2020-09-10,Butte,007,227075,2758,2590,23,2613,37
2020-09-10,Calaveras,009,45235,300,244,0,244,1
2020-09-10,Colusa,011,21464,504,482,0,482,6
2020-09-10,Contra Costa,013,1133247,15864,14909,73,14982,172
2020-09-10,Del Norte,015,27424,125,112,0,112,1
2020-09-10,El Dorado,017,186661,1080,1020,5,1025,2
2020-09-10,Fresno,019,978130,29331,26783,343,27126,338
2020-09-10,Glenn,021,27897,534,511,0,511,3
2020-09-10,Humboldt,023,135768,464,422,1,423,4
2020-09-10,Imperial,025,180216,11519,10251,6,10257,270
2020-09-10,Inyo,027,18085,185,176,4,180,11
2020-09-10,Kern,029,883053,30950,29988,277,30265,363
2020-09-10,Kings,031,150075,7170,6739,37,6776,70
2020-09-10,Lake,033,64148,446,377,0,377,4
2020-09-10,Lassen,035,31185,733,716,2,718,0
2020-09-10,Los Angeles,037,10098052,254531,251003,1552,252555,6132
2020-09-10,Madera,039,155013,4263,3979,30,4009,43
2020-09-10,Marin,041,260295,6482,6344,15,6359,68
2020-09-10,Mariposa,043,17540,75,72,0,72,2
2020-09-10,Mendocino,045,87422,735,697,0,697,16
2020-09-10,Merced,047,269075,8581,8461,14,8475,109
2020-09-10,Modoc,049,8938,25,21,0,21,0
2020-09-10,Mono,051,14174,165,145,2,147,1
2020-09-10,Monterey,053,433212,9070,8570,23,8593,59
2020-09-10,Napa,055,140530,1596,1536,8,1544,11
2020-09-10,Nevada,057,99092,491,478,17,495,6
2020-09-10,Orange,059,3164182,52262,49617,1332,50949,1057
2020-09-10,Placer,061,380077,3401,3233,13,3246,37
2020-09-10,Plumas,063,18699,48,42,0,42,0
2020-09-10,Riverside,065,2383286,56044,54417,98,54515,1091
2020-09-10,Sacramento,067,1510023,20580,19618,22,19640,354
2020-09-10,San Benito,069,59416,1247,1201,0,1201,5
2020-09-10,San Bernardino,071,2135413,51363,49467,326,49793,867
2020-09-10,San Diego,073,3302833,43680,41610,677,42287,725
2020-09-10,San Francisco,075,870044,10477,10082,24,10106,89
2020-09-10,San Joaquin,077,732212,19486,18854,44,18898,389
2020-09-10,San Luis Obispo,079,281455,3405,3161,20,3181,24
2020-09-10,San Mateo,081,765935,9441,8529,11,8540,125
2020-09-10,Santa Barbara,083,443738,8760,8552,73,8625,100
2020-09-10,Santa Clara,085,1922200,20459,18870,40,18910,231
2020-09-10,Santa Cruz,087,273765,2146,1986,18,2004,7
2020-09-10,Shasta,089,179085,696,566,3,569,10
2020-09-10,Sierra,091,2930,6,6,0,6,0
2020-09-10,Siskiyou,093,43540,151,137,9,146,0
2020-09-10,Solano,095,438530,5916,5696,41,5737,42
2020-09-10,Sonoma,097,501317,6797,6424,20,6444,91
2020-09-10,Stanislaus,099,539301,15991,15509,448,15957,243
2020-09-10,Sutter,101,95872,1572,1494,1,1495,11
2020-09-10,Tehama,103,63373,476,466,2,468,1
2020-09-10,Trinity,105,12862,52,15,7,22,0
2020-09-10,Tulare,107,460477,15550,14860,80,14940,250
2020-09-10,Tuolumne,109,53932,223,205,4,209,1
2020-09-10,Ventura,111,848112,12351,11600,124,11724,122
2020-09-10,Yolo,113,214977,2716,2612,7,2619,53
2020-09-10,Yuba,115,75493,1008,941,4,945,1
2020-09-09,Alameda,001,1643700,20203,19399,149,19548,289
2020-09-09,Alpine,003,1148,2,2,0,2,0
2020-09-09,Amador,005,37829,279,276,0,276,16
2020-09-09,Butte,007,227075,2741,2561,23,2584,37
2020-09-09,Calaveras,009,45235,300,242,0,242,1
2020-09-09,Colusa,011,21464,499,479,0,479,6
2020-09-09,Contra Costa,013,1133247,15778,14816,73,14889,171
2020-09-09,Del Norte,015,27424,121,109,0,109,1
2020-09-09,El Dorado,017,186661,1077,1020,5,1025,2
2020-09-09,Fresno,019,978130,29228,26724,338,27062,329
2020-09-09,Glenn,021,27897,531,508,0,508,3
2020-09-09,Humboldt,023,135768,462,420,1,421,4
2020-09-09,Imperial,025,180216,11498,10233,6,10239,268
2020-09-09,Inyo,027,18085,184,173,4,177,2
2020-09-09,Kern,029,883053,30852,29925,274,30199,355
2020-09-09,Kings,031,150075,7152,6721,37,6758,72
2020-09-09,Lake,033,64148,438,371,0,371,4
2020-09-09,Lassen,035,31185,732,714,2,716,0
2020-09-09,Los Angeles,037,10098052,253656,249876,1534,251410,6091
2020-09-09,Madera,039,155013,4237,3926,30,3956,43
2020-09-09,Marin,041,260295,6463,6321,15,6336,68
2020-09-09,Mariposa,043,17540,74,72,0,72,2
2020-09-09,Mendocino,045,87422,727,695,0,695,16
2020-09-09,Merced,047,269075,8555,8441,14,8455,107
2020-09-09,Modoc,049,8938,24,20,0,20,0
2020-09-09,Mono,051,14174,165,145,2,147,1
2020-09-09,Monterey,053,433212,8998,8527,23,8550,59
2020-09-09,Napa,055,140530,1586,1531,8,1539,11
2020-09-09,Nevada,057,99092,487,476,17,493,6
2020-09-09,Orange,059,3164182,52083,49394,1324,50718,1054
2020-09-09,Placer,061,380077,3381,3222,13,3235,36
2020-09-09,Plumas,063,18699,46,42,0,42,0
2020-09-09,Riverside,065,2383286,55814,54320,95,54415,1081
2020-09-09,Sacramento,067,1510023,20474,19474,21,19495,347
2020-09-09,San Benito,069,59416,1243,1199,0,1199,5
2020-09-09,San Bernardino,071,2135413,51165,49264,325,49589,866
2020-09-09,San Diego,073,3302833,43391,41326,665,41991,721
2020-09-09,San Francisco,075,870044,10427,9996,23,10019,86
2020-09-09,San Joaquin,077,732212,19422,18799,43,18842,388
2020-09-09,San Luis Obispo,079,281455,3387,3131,20,3151,24
2020-09-09,San Mateo,081,765935,9380,8478,11,8489,125
2020-09-09,Santa Barbara,083,443738,8717,8528,73,8601,97
2020-09-09,Santa Clara,085,1922200,20327,18759,40,18799,228
2020-09-09,Santa Cruz,087,273765,2123,1967,18,1985,7
2020-09-09,Shasta,089,179085,684,562,3,565,10
2020-09-09,Sierra,091,2930,6,6,0,6,0
2020-09-09,Siskiyou,093,43540,149,137,9,146,0
2020-09-09,Solano,095,438530,5884,5680,41,5721,36
2020-09-09,Sonoma,097,501317,6731,6397,20,6417,92
2020-09-09,Stanislaus,099,539301,15952,15469,437,15906,243
2020-09-09,Sutter,101,95872,1564,1487,1,1488,11
2020-09-09,Tehama,103,63373,473,462,2,464,1
2020-09-09,Trinity,105,12862,52,14,7,21,0
2020-09-09,Tulare,107,460477,15501,14787,75,14862,249
2020-09-09,Tuolumne,109,53932,222,204,3,207,1
2020-09-09,Ventura,111,848112,12260,11497,121,11618,121
2020-09-09,Yolo,113,214977,2705,2604,7,2611,53
2020-09-09,Yuba,115,75493,1003,936,4,940,1
2020-09-08,Alameda,001,1643700,20095,19293,149,19442,288
2020-09-08,Alpine,003,1148,2,2,0,2,0
2020-09-08,Amador,005,37829,279,276,0,276,16
2020-09-08,Butte,007,227075,2723,2453,23,2476,36
2020-09-08,Calaveras,009,45235,298,233,0,233,1
2020-09-08,Colusa,011,21464,497,475,0,475,6
2020-09-08,Contra Costa,013,1133247,15650,14740,70,14810,171
2020-09-08,Del Norte,015,27424,121,109,0,109,2
2020-09-08,El Dorado,017,186661,1074,1011,5,1016,2
2020-09-08,Fresno,019,978130,29108,26640,334,26974,329
2020-09-08,Glenn,021,27897,527,492,0,492,3
2020-09-08,Humboldt,023,135768,460,420,1,421,4
2020-09-08,Imperial,025,180216,11482,10198,6,10204,267
2020-09-08,Inyo,027,18085,184,169,4,173,2
2020-09-08,Kern,029,883053,30766,29850,272,30122,351
2020-09-08,Kings,031,150075,7114,6658,37,6695,72
2020-09-08,Lake,033,64148,428,370,0,370,4
2020-09-08,Lassen,035,31185,732,710,2,712,0
2020-09-08,Los Angeles,037,10098052,252726,249217,1506,250723,6034
2020-09-08,Madera,039,155013,4213,3904,30,3934,43
2020-09-08,Marin,041,260295,6432,6313,15,6328,68
2020-09-08,Mariposa,043,17540,74,72,0,72,2
2020-09-08,Mendocino,045,87422,720,690,0,690,16
2020-09-08,Merced,047,269075,8532,8381,14,8395,104
2020-09-08,Modoc,049,8938,24,20,0,20,0
2020-09-08,Mono,051,14174,165,145,2,147,1
2020-09-08,Monterey,053,433212,8913,8491,23,8514,59
2020-09-08,Napa,055,140530,1582,1518,8,1526,11
2020-09-08,Nevada,057,99092,487,470,17,487,6
2020-09-08,Orange,059,3164182,51941,49214,1320,50534,1044
2020-09-08,Placer,061,380077,3367,3205,13,3218,36
2020-09-08,Plumas,063,18699,46,42,0,42,0
2020-09-08,Riverside,065,2383286,55600,54168,92,54260,1069
2020-09-08,Sacramento,067,1510023,20239,19411,20,19431,347
2020-09-08,San Benito,069,59416,1236,1188,0,1188,5
2020-09-08,San Bernardino,071,2135413,50976,49034,324,49358,856
2020-09-08,San Diego,073,3302833,43075,41079,653,41732,709
2020-09-08,San Francisco,075,870044,10354,9821,23,9844,86
2020-09-08,San Joaquin,077,732212,19344,18550,43,18593,388
2020-09-08,San Luis Obispo,079,281455,3372,3120,20,3140,23
2020-09-08,San Mateo,081,765935,9304,8460,11,8471,125
2020-09-08,Santa Barbara,083,443738,8683,8488,72,8560,96
2020-09-08,Santa Clara,085,1922200,20151,18645,40,18685,228
2020-09-08,Santa Cruz,087,273765,2095,1903,18,1921,7
2020-09-08,Shasta,089,179085,676,556,3,559,10
2020-09-08,Sierra,091,2930,6,6,0,6,0
2020-09-08,Siskiyou,093,43540,147,136,9,145,0
2020-09-08,Solano,095,438530,5847,5654,41,5695,36
2020-09-08,Sonoma,097,501317,6662,6356,20,6376,92
2020-09-08,Stanislaus,099,539301,15888,15415,425,15840,238
2020-09-08,Sutter,101,95872,1548,1473,1,1474,11
2020-09-08,Tehama,103,63373,469,458,2,460,1
2020-09-08,Trinity,105,12862,51,13,7,20,0
2020-09-08,Tulare,107,460477,15421,14635,74,14709,249
2020-09-08,Tuolumne,109,53932,221,197,3,200,1
2020-09-08,Ventura,111,848112,12191,11475,118,11593,118
2020-09-08,Yolo,113,214977,2695,2580,7,2587,53
2020-09-08,Yuba,115,75493,991,923,4,927,1
2020-09-07,Alameda,001,1643700,19973,19188,143,19331,281
2020-09-07,Alpine,003,1148,2,2,0,2,0
2020-09-07,Amador,005,37829,279,276,0,276,16
2020-09-07,Butte,007,227075,2690,2450,22,2472,30
2020-09-07,Calaveras,009,45235,288,234,0,234,1
2020-09-07,Colusa,011,21464,496,475,0,475,6
2020-09-07,Contra Costa,013,1133247,15537,14637,67,14704,172
2020-09-07,Del Norte,015,27424,121,109,0,109,2
2020-09-07,El Dorado,017,186661,1063,1011,5,1016,2
2020-09-07,Fresno,019,978130,29014,26565,331,26896,329
2020-09-07,Glenn,021,27897,522,488,0,488,3
2020-09-07,Humboldt,023,135768,451,416,1,417,4
2020-09-07,Imperial,025,180216,11451,10199,6,10205,267
2020-09-07,Inyo,027,18085,184,169,4,173,2
2020-09-07,Kern,029,883053,30645,29790,267,30057,348
2020-09-07,Kings,031,150075,6989,6630,37,6667,72
2020-09-07,Lake,033,64148,405,367,0,367,2
2020-09-07,Lassen,035,31185,732,709,2,711,0
2020-09-07,Los Angeles,037,10098052,251680,248804,1484,250288,6030
2020-09-07,Madera,039,155013,4182,3889,29,3918,43
2020-09-07,Marin,041,260295,6402,6296,15,6311,67
2020-09-07,Mariposa,043,17540,74,72,0,72,2
2020-09-07,Mendocino,045,87422,712,687,0,687,16
2020-09-07,Merced,047,269075,8485,8381,14,8395,104
2020-09-07,Modoc,049,8938,23,20,0,20,0
2020-09-07,Mono,051,14174,165,145,2,147,1
2020-09-07,Monterey,053,433212,8834,8463,23,8486,57
2020-09-07,Napa,055,140530,1570,1514,8,1522,11
2020-09-07,Nevada,057,99092,485,469,17,486,6
2020-09-07,Orange,059,3164182,51767,49132,1316,50448,1042
2020-09-07,Placer,061,380077,3337,3188,12,3200,36
2020-09-07,Plumas,063,18699,45,42,0,42,0
2020-09-07,Riverside,065,2383286,55325,54178,86,54264,1069
2020-09-07,Sacramento,067,1510023,19996,19292,19,19311,345
2020-09-07,San Benito,069,59416,1230,1180,0,1180,4
2020-09-07,San Bernardino,071,2135413,50748,49043,322,49365,821
2020-09-07,San Diego,073,3302833,42675,40868,626,41494,708
2020-09-07,San Francisco,075,870044,10303,9813,22,9835,85
2020-09-07,San Joaquin,077,732212,19263,18552,41,18593,386
2020-09-07,San Luis Obispo,079,281455,3335,3116,20,3136,23
2020-09-07,San Mateo,081,765935,9222,8409,11,8420,125
2020-09-07,Santa Barbara,083,443738,8639,8479,72,8551,95
2020-09-07,Santa Clara,085,1922200,19993,18596,39,18635,226
2020-09-07,Santa Cruz,087,273765,2067,1902,18,1920,7
2020-09-07,Shasta,089,179085,666,556,3,559,10
2020-09-07,Sierra,091,2930,6,6,0,6,0
2020-09-07,Siskiyou,093,43540,146,133,9,142,0
2020-09-07,Solano,095,438530,5782,5640,41,5681,36
2020-09-07,Sonoma,097,501317,6596,6268,20,6288,85
2020-09-07,Stanislaus,099,539301,15823,15343,413,15756,236
2020-09-07,Sutter,101,95872,1531,1468,1,1469,11
2020-09-07,Tehama,103,63373,466,453,2,455,1
2020-09-07,Trinity,105,12862,51,13,7,20,0
2020-09-07,Tulare,107,460477,15316,14637,72,14709,249
2020-09-07,Tuolumne,109,53932,220,196,3,199,1
2020-09-07,Ventura,111,848112,12096,11463,115,11578,118
2020-09-07,Yolo,113,214977,2678,2565,6,2571,53
2020-09-07,Yuba,115,75493,975,923,3,926,1
2020-09-06,Alameda,001,1643700,19915,19029,141,19170,281
2020-09-06,Alpine,003,1148,2,2,0,2,0
2020-09-06,Amador,005,37829,277,275,0,275,16
2020-09-06,Butte,007,227075,2681,2446,22,2468,30
2020-09-06,Calaveras,009,45235,288,235,0,235,1
2020-09-06,Colusa,011,21464,492,475,0,475,6
2020-09-06,Contra Costa,013,1133247,15457,14565,66,14631,171
2020-09-06,Del Norte,015,27424,121,109,0,109,2
2020-09-06,El Dorado,017,186661,1061,1008,5,1013,2
2020-09-06,Fresno,019,978130,28950,26471,329,26800,329
2020-09-06,Glenn,021,27897,516,474,0,474,3
2020-09-06,Humboldt,023,135768,448,404,1,405,4
2020-09-06,Imperial,025,180216,11434,10152,6,10158,267
2020-09-06,Inyo,027,18085,184,169,4,173,2
2020-09-06,Kern,029,883053,30589,29699,263,29962,348
2020-09-06,Kings,031,150075,6969,6561,36,6597,72
2020-09-06,Lake,033,64148,402,362,0,362,2
2020-09-06,Lassen,035,31185,732,709,2,711,0
2020-09-06,Los Angeles,037,10098052,251048,248316,1470,249786,6004
2020-09-06,Madera,039,155013,4138,3867,29,3896,42
2020-09-06,Marin,041,260295,6390,6276,15,6291,67
2020-09-06,Mariposa,043,17540,74,72,0,72,2
2020-09-06,Mendocino,045,87422,711,672,0,672,16
2020-09-06,Merced,047,269075,8465,8327,14,8341,104
2020-09-06,Modoc,049,8938,23,20,0,20,0
2020-09-06,Mono,051,14174,164,145,2,147,1
2020-09-06,Monterey,053,433212,8794,8403,22,8425,56
2020-09-06,Napa,055,140530,1566,1501,6,1507,11
2020-09-06,Nevada,057,99092,485,467,16,483,6
2020-09-06,Orange,059,3164182,51654,48931,1312,50243,1042
2020-09-06,Placer,061,380077,3320,3169,12,3181,36
2020-09-06,Plumas,063,18699,44,42,0,42,0
2020-09-06,Riverside,065,2383286,55209,53970,84,54054,1069
2020-09-06,Sacramento,067,1510023,19901,19128,19,19147,340
2020-09-06,San Benito,069,59416,1228,1178,0,1178,4
2020-09-06,San Bernardino,071,2135413,50640,48923,322,49245,823
2020-09-06,San Diego,073,3302833,42427,40652,620,41272,707
2020-09-06,San Francisco,075,870044,10229,9813,22,9835,85
2020-09-06,San Joaquin,077,732212,19214,18558,41,18599,386
2020-09-06,San Luis Obispo,079,281455,3324,3101,20,3121,23
2020-09-06,San Mateo,081,765935,9169,8387,11,8398,125
2020-09-06,Santa Barbara,083,443738,8610,8434,72,8506,95
2020-09-06,Santa Clara,085,1922200,19892,18495,39,18534,207
2020-09-06,Santa Cruz,087,273765,2060,1902,18,1920,7
2020-09-06,Shasta,089,179085,660,550,3,553,10
2020-09-06,Sierra,091,2930,6,6,0,6,0
2020-09-06,Siskiyou,093,43540,146,132,9,141,0
2020-09-06,Solano,095,438530,5756,5619,41,5660,37
2020-09-06,Sonoma,097,501317,6567,6212,20,6232,85
2020-09-06,Stanislaus,099,539301,15779,15288,409,15697,236
2020-09-06,Sutter,101,95872,1518,1451,1,1452,11
2020-09-06,Tehama,103,63373,465,455,2,457,1
2020-09-06,Trinity,105,12862,50,13,7,20,0
2020-09-06,Tulare,107,460477,15273,14636,71,14707,249
2020-09-06,Tuolumne,109,53932,217,194,3,197,1
2020-09-06,Ventura,111,848112,12051,11315,115,11430,118
2020-09-06,Yolo,113,214977,2664,2556,6,2562,53
2020-09-06,Yuba,115,75493,966,913,3,916,1
2020-09-05,Alameda,001,1643700,19870,18973,139,19112,279
2020-09-05,Alpine,003,1148,2,2,0,2,0
2020-09-05,Amador,005,37829,277,274,0,274,16
2020-09-05,Butte,007,227075,2665,2406,21,2427,30
2020-09-05,Calaveras,009,45235,288,237,0,237,1
2020-09-05,Colusa,011,21464,488,472,0,472,6
2020-09-05,Contra Costa,013,1133247,15380,14456,64,14520,173
2020-09-05,Del Norte,015,27424,121,109,0,109,2
2020-09-05,El Dorado,017,186661,1061,1007,5,1012,2
2020-09-05,Fresno,019,978130,28882,26325,329,26654,331
2020-09-05,Glenn,021,27897,515,474,0,474,3
2020-09-05,Humboldt,023,135768,446,402,1,403,4
2020-09-05,Imperial,025,180216,11417,10151,6,10157,268
2020-09-05,Inyo,027,18085,184,169,4,173,2
2020-09-05,Kern,029,883053,30529,29645,259,29904,347
2020-09-05,Kings,031,150075,6960,6518,36,6554,66
2020-09-05,Lake,033,64148,399,359,0,359,2
2020-09-05,Lassen,035,31185,732,709,2,711,0
2020-09-05,Los Angeles,037,10098052,250513,247572,1458,249030,6001
2020-09-05,Madera,039,155013,4097,3851,29,3880,42
2020-09-05,Marin,041,260295,6383,6259,15,6274,66
2020-09-05,Mariposa,043,17540,74,72,0,72,2
2020-09-05,Mendocino,045,87422,710,658,0,658,16
2020-09-05,Merced,047,269075,8433,8297,12,8309,104
2020-09-05,Modoc,049,8938,23,19,0,19,0
2020-09-05,Mono,051,14174,164,145,2,147,1
2020-09-05,Monterey,053,433212,8764,8301,22,8323,56
2020-09-05,Napa,055,140530,1560,1484,6,1490,11
2020-09-05,Nevada,057,99092,482,461,16,477,6
2020-09-05,Orange,059,3164182,51552,48726,1307,50033,1039
2020-09-05,Placer,061,380077,3309,3141,12,3153,35
2020-09-05,Plumas,063,18699,44,42,0,42,0
2020-09-05,Riverside,065,2383286,55103,53780,84,53864,1066
2020-09-05,Sacramento,067,1510023,19810,18955,19,18974,339
2020-09-05,San Benito,069,59416,1226,1153,0,1153,4
2020-09-05,San Bernardino,071,2135413,50564,48800,321,49121,825
2020-09-05,San Diego,073,3302833,42234,40344,608,40952,717
2020-09-05,San Francisco,075,870044,10196,9812,21,9833,85
2020-09-05,San Joaquin,077,732212,19186,18557,41,18598,386
2020-09-05,San Luis Obispo,079,281455,3314,3083,20,3103,23
2020-09-05,San Mateo,081,765935,9124,8352,11,8363,124
2020-09-05,Santa Barbara,083,443738,8594,8404,72,8476,96
2020-09-05,Santa Clara,085,1922200,19809,18311,39,18350,207
2020-09-05,Santa Cruz,087,273765,2052,1904,18,1922,7
2020-09-05,Shasta,089,179085,659,544,3,547,10
2020-09-05,Sierra,091,2930,6,6,0,6,0
2020-09-05,Siskiyou,093,43540,145,131,9,140,0
2020-09-05,Solano,095,438530,5744,5579,41,5620,37
2020-09-05,Sonoma,097,501317,6534,6149,20,6169,85
2020-09-05,Stanislaus,099,539301,15731,15198,405,15603,236
2020-09-05,Sutter,101,95872,1511,1445,1,1446,11
2020-09-05,Tehama,103,63373,464,447,2,449,1
2020-09-05,Trinity,105,12862,50,13,7,20,0
2020-09-05,Tulare,107,460477,15215,14576,69,14645,249
2020-09-05,Tuolumne,109,53932,217,194,3,197,1
2020-09-05,Ventura,111,848112,12008,11254,115,11369,118
2020-09-05,Yolo,113,214977,2654,2534,6,2540,53
2020-09-05,Yuba,115,75493,960,902,3,905,1
2020-09-04,Alameda,001,1643700,19803,18843,137,18980,276
2020-09-04,Alpine,003,1148,2,2,0,2,0
2020-09-04,Amador,005,37829,276,274,0,274,16
2020-09-04,Butte,007,227075,2642,2325,21,2346,28
2020-09-04,Calaveras,009,45235,286,237,0,237,1
2020-09-04,Colusa,011,21464,486,467,0,467,6
2020-09-04,Contra Costa,013,1133247,15300,14355,63,14418,164
2020-09-04,Del Norte,015,27424,121,109,0,109,2
2020-09-04,El Dorado,017,186661,1057,992,5,997,2
2020-09-04,Fresno,019,978130,28777,26147,328,26475,321
2020-09-04,Glenn,021,27897,507,463,0,463,3
2020-09-04,Humboldt,023,135768,441,390,1,391,4
2020-09-04,Imperial,025,180216,11408,10136,6,10142,267
2020-09-04,Inyo,027,18085,184,169,4,173,2
2020-09-04,Kern,029,883053,30461,29526,256,29782,345
2020-09-04,Kings,031,150075,6947,6259,36,6295,66
2020-09-04,Lake,033,64148,399,347,0,347,2
2020-09-04,Lassen,035,31185,732,708,2,710,0
2020-09-04,Los Angeles,037,10098052,249946,246396,1438,247834,5977
2020-09-04,Madera,039,155013,4084,3838,29,3867,42
2020-09-04,Marin,041,260295,6371,6251,15,6266,66
2020-09-04,Mariposa,043,17540,74,72,0,72,2
2020-09-04,Mendocino,045,87422,708,646,0,646,16
2020-09-04,Merced,047,269075,8413,8214,12,8226,104
2020-09-04,Modoc,049,8938,23,15,0,15,0
2020-09-04,Mono,051,14174,164,145,2,147,1
2020-09-04,Monterey,053,433212,8719,8208,22,8230,56
2020-09-04,Napa,055,140530,1551,1475,6,1481,11
2020-09-04,Nevada,057,99092,479,455,16,471,6
2020-09-04,Orange,059,3164182,51428,48488,1300,49788,1031
2020-09-04,Placer,061,380077,3297,3101,12,3113,35
2020-09-04,Plumas,063,18699,44,42,0,42,0
2020-09-04,Riverside,065,2383286,54990,53606,79,53685,1066
2020-09-04,Sacramento,067,1510023,19722,18765,19,18784,337
2020-09-04,San Benito,069,59416,1217,1137,0,1137,4
2020-09-04,San Bernardino,071,2135413,50471,48497,319,48816,800
2020-09-04,San Diego,073,3302833,42004,39901,599,40500,701
2020-09-04,San Francisco,075,870044,10156,9694,20,9714,85
2020-09-04,San Joaquin,077,732212,19132,18438,41,18479,376
2020-09-04,San Luis Obispo,079,281455,3299,3049,19,3068,21
2020-09-04,San Mateo,081,765935,9080,8275,11,8286,122
2020-09-04,Santa Barbara,083,443738,8564,8340,72,8412,96
2020-09-04,Santa Clara,085,1922200,19701,18074,39,18113,209
2020-09-04,Santa Cruz,087,273765,2035,1896,17,1913,7
2020-09-04,Shasta,089,179085,656,536,3,539,10
2020-09-04,Sierra,091,2930,6,6,0,6,0
2020-09-04,Siskiyou,093,43540,145,129,9,138,0
2020-09-04,Solano,095,438530,5731,5552,41,5593,37
2020-09-04,Sonoma,097,501317,6469,6050,20,6070,85
2020-09-04,Stanislaus,099,539301,15697,15074,396,15470,233
2020-09-04,Sutter,101,95872,1495,1425,1,1426,11
2020-09-04,Tehama,103,63373,460,442,2,444,1
2020-09-04,Trinity,105,12862,50,13,7,20,0
2020-09-04,Tulare,107,460477,15187,14501,65,14566,247
2020-09-04,Tuolumne,109,53932,217,193,3,196,1
2020-09-04,Ventura,111,848112,11966,11171,115,11286,114
2020-09-04,Yolo,113,214977,2640,2495,6,2501,53
2020-09-04,Yuba,115,75493,955,884,3,887,1
2020-09-03,Alameda,001,1643700,19700,18687,137,18824,275
2020-09-03,Alpine,003,1148,2,2,0,2,0
2020-09-03,Amador,005,37829,276,274,0,274,16
2020-09-03,Butte,007,227075,2597,2274,21,2295,27
2020-09-03,Calaveras,009,45235,285,238,0,238,1
2020-09-03,Colusa,011,21464,484,464,0,464,6
2020-09-03,Contra Costa,013,1133247,15193,14206,60,14266,159
2020-09-03,Del Norte,015,27424,118,109,0,109,2
2020-09-03,El Dorado,017,186661,1053,983,5,988,2
2020-09-03,Fresno,019,978130,28658,25978,323,26301,313
2020-09-03,Glenn,021,27897,503,460,0,460,3
2020-09-03,Humboldt,023,135768,436,390,1,391,4
2020-09-03,Imperial,025,180216,11387,10083,6,10089,255
2020-09-03,Inyo,027,18085,182,171,4,175,3
2020-09-03,Kern,029,883053,30369,29426,242,29668,340
2020-09-03,Kings,031,150075,6867,6200,36,6236,64
2020-09-03,Lake,033,64148,390,347,0,347,2
2020-09-03,Lassen,035,31185,732,707,2,709,0
2020-09-03,Los Angeles,037,10098052,249083,245026,1418,246444,5931
2020-09-03,Madera,039,155013,4065,3780,29,3809,43
2020-09-03,Marin,041,260295,6352,6175,15,6190,66
2020-09-03,Mariposa,043,17540,74,71,0,71,2
2020-09-03,Mendocino,045,87422,699,638,0,638,16
2020-09-03,Merced,047,269075,8371,8136,12,8148,105
2020-09-03,Modoc,049,8938,23,14,0,14,0
2020-09-03,Mono,051,14174,163,144,2,146,1
2020-09-03,Monterey,053,433212,8665,8128,22,8150,56
2020-09-03,Napa,055,140530,1544,1466,6,1472,10
2020-09-03,Nevada,057,99092,476,453,16,469,6
2020-09-03,Orange,059,3164182,51242,48226,1285,49511,1009
2020-09-03,Placer,061,380077,3279,3069,12,3081,34
2020-09-03,Plumas,063,18699,44,39,0,39,0
2020-09-03,Riverside,065,2383286,54810,53341,75,53416,1052
2020-09-03,Sacramento,067,1510023,19594,18553,18,18571,328
2020-09-03,San Benito,069,59416,1206,1121,0,1121,4
2020-09-03,San Bernardino,071,2135413,50305,48165,318,48483,800
2020-09-03,San Diego,073,3302833,41690,39448,583,40031,700
2020-09-03,San Francisco,075,870044,10090,9636,18,9654,84
2020-09-03,San Joaquin,077,732212,19055,18331,41,18372,371
2020-09-03,San Luis Obispo,079,281455,3282,3023,19,3042,21
2020-09-03,San Mateo,081,765935,9006,8211,11,8222,122
2020-09-03,Santa Barbara,083,443738,8516,8277,72,8349,96
2020-09-03,Santa Clara,085,1922200,19520,17879,39,17918,208
2020-09-03,Santa Cruz,087,273765,2020,1870,17,1887,7
2020-09-03,Shasta,089,179085,651,535,3,538,10
2020-09-03,Sierra,091,2930,6,6,0,6,0
2020-09-03,Siskiyou,093,43540,145,128,9,137,0
2020-09-03,Solano,095,438530,5711,5499,40,5539,36
2020-09-03,Sonoma,097,501317,6408,5997,20,6017,62
2020-09-03,Stanislaus,099,539301,15645,14985,392,15377,217
2020-09-03,Sutter,101,95872,1485,1412,1,1413,11
2020-09-03,Tehama,103,63373,456,436,2,438,1
2020-09-03,Trinity,105,12862,48,13,7,20,0
2020-09-03,Tulare,107,460477,15121,14408,64,14472,244
2020-09-03,Tuolumne,109,53932,217,193,3,196,1
2020-09-03,Ventura,111,848112,11848,11109,112,11221,112
2020-09-03,Yolo,113,214977,2624,2475,6,2481,53
2020-09-03,Yuba,115,75493,948,867,3,870,1
2020-09-02,Alameda,001,1643700,19582,18522,134,18656,260
2020-09-02,Alpine,003,1148,2,2,0,2,0
2020-09-02,Amador,005,37829,276,245,0,245,14
2020-09-02,Butte,007,227075,2551,2241,21,2262,27
2020-09-02,Calaveras,009,45235,284,235,0,235,1
2020-09-02,Colusa,011,21464,480,460,0,460,6
2020-09-02,Contra Costa,013,1133247,15104,14097,58,14155,159
2020-09-02,Del Norte,015,27424,117,109,0,109,2
2020-09-02,El Dorado,017,186661,1049,975,4,979,2
2020-09-02,Fresno,019,978130,28510,25785,320,26105,292
2020-09-02,Glenn,021,27897,498,457,0,457,3
2020-09-02,Humboldt,023,135768,433,381,1,382,4
2020-09-02,Imperial,025,180216,11371,9832,6,9838,255
2020-09-02,Inyo,027,18085,182,171,4,175,3
2020-09-02,Kern,029,883053,30277,29288,236,29524,335
2020-09-02,Kings,031,150075,6782,6142,36,6178,64
2020-09-02,Lake,033,64148,386,342,0,342,2
2020-09-02,Lassen,035,31185,730,706,2,708,0
2020-09-02,Los Angeles,037,10098052,248152,243999,1390,245389,5887
2020-09-02,Madera,039,155013,4045,3735,29,3764,41
2020-09-02,Marin,041,260295,6337,6131,15,6146,66
2020-09-02,Mariposa,043,17540,74,71,0,71,2
2020-09-02,Mendocino,045,87422,689,636,0,636,15
2020-09-02,Merced,047,269075,8340,8097,11,8108,103
2020-09-02,Modoc,049,8938,22,11,0,11,0
2020-09-02,Mono,051,14174,163,145,2,147,1
2020-09-02,Monterey,053,433212,8601,8070,22,8092,56
2020-09-02,Napa,055,140530,1532,1454,6,1460,10
2020-09-02,Nevada,057,99092,470,452,15,467,6
2020-09-02,Orange,059,3164182,51061,47871,1275,49146,994
2020-09-02,Placer,061,380077,3254,3047,11,3058,33
2020-09-02,Plumas,063,18699,44,39,0,39,0
2020-09-02,Riverside,065,2383286,54608,52923,72,52995,1032
2020-09-02,Sacramento,067,1510023,19361,18355,17,18372,316
2020-09-02,San Benito,069,59416,1193,1107,0,1107,4
2020-09-02,San Bernardino,071,2135413,50141,47766,315,48081,794
2020-09-02,San Diego,073,3302833,41370,39123,569,39692,695
2020-09-02,San Francisco,075,870044,10021,9587,18,9605,84
2020-09-02,San Joaquin,077,732212,18974,18194,40,18234,352
2020-09-02,San Luis Obispo,079,281455,3256,3002,18,3020,21
2020-09-02,San Mateo,081,765935,8949,8148,11,8159,122
2020-09-02,Santa Barbara,083,443738,8461,8206,71,8277,94
2020-09-02,Santa Clara,085,1922200,19366,17673,39,17712,206
2020-09-02,Santa Cruz,087,273765,1997,1850,17,1867,7
2020-09-02,Shasta,089,179085,650,531,3,534,10
2020-09-02,Sierra,091,2930,6,6,0,6,0
2020-09-02,Siskiyou,093,43540,144,127,9,136,0
2020-09-02,Solano,095,438530,5683,5463,40,5503,36
2020-09-02,Sonoma,097,501317,6346,5846,20,5866,62
2020-09-02,Stanislaus,099,539301,15575,14854,385,15239,220
2020-09-02,Sutter,101,95872,1470,1401,1,1402,10
2020-09-02,Tehama,103,63373,453,429,2,431,1
2020-09-02,Trinity,105,12862,48,13,7,20,0
2020-09-02,Tulare,107,460477,15054,14298,63,14361,244
2020-09-02,Tuolumne,109,53932,217,190,3,193,1
2020-09-02,Ventura,111,848112,11761,11031,111,11142,111
2020-09-02,Yolo,113,214977,2603,2449,6,2455,54
2020-09-02,Yuba,115,75493,941,856,3,859,1
2020-09-01,Alameda,001,1643700,19443,18382,131,18513,248
2020-09-01,Alpine,003,1148,2,2,0,2,0
2020-09-01,Amador,005,37829,275,244,0,244,13
2020-09-01,Butte,007,227075,2494,2146,21,2167,26
2020-09-01,Calaveras,009,45235,276,228,0,228,1
2020-09-01,Colusa,011,21464,476,454,0,454,6
2020-09-01,Contra Costa,013,1133247,15010,13998,56,14054,158
2020-09-01,Del Norte,015,27424,116,108,0,108,2
2020-09-01,El Dorado,017,186661,1041,972,4,976,2
2020-09-01,Fresno,019,978130,28363,25542,317,25859,290
2020-09-01,Glenn,021,27897,491,449,0,449,3
2020-09-01,Humboldt,023,135768,427,378,1,379,4
2020-09-01,Imperial,025,180216,11345,9782,6,9788,250
2020-09-01,Inyo,027,18085,182,171,4,175,3
2020-09-01,Kern,029,883053,30186,29162,231,29393,332
2020-09-01,Kings,031,150075,6751,6088,36,6124,62
2020-09-01,Lake,033,64148,383,341,0,341,2
2020-09-01,Lassen,035,31185,727,706,2,708,0
2020-09-01,Los Angeles,037,10098052,247060,242633,1367,244000,5832
2020-09-01,Madera,039,155013,4016,3703,28,3731,41
2020-09-01,Marin,041,260295,6322,6102,15,6117,67
2020-09-01,Mariposa,043,17540,73,72,0,72,2
2020-09-01,Mendocino,045,87422,674,626,0,626,15
2020-09-01,Merced,047,269075,8287,8046,10,8056,103
2020-09-01,Modoc,049,8938,20,10,0,10,0
2020-09-01,Mono,051,14174,163,145,2,147,1
2020-09-01,Monterey,053,433212,8495,7926,22,7948,56
2020-09-01,Napa,055,140530,1517,1446,6,1452,10
2020-09-01,Nevada,057,99092,464,450,15,465,6
2020-09-01,Orange,059,3164182,50897,47671,1256,48927,976
2020-09-01,Placer,061,380077,3232,3013,11,3024,33
2020-09-01,Plumas,063,18699,44,39,0,39,0
2020-09-01,Riverside,065,2383286,54390,52785,71,52856,1027
2020-09-01,Sacramento,067,1510023,19178,18217,16,18233,305
2020-09-01,San Benito,069,59416,1181,1089,0,1089,4
2020-09-01,San Bernardino,071,2135413,49934,47371,314,47685,786
2020-09-01,San Diego,073,3302833,41012,38873,531,39404,688
2020-09-01,San Francisco,075,870044,9952,9492,18,9510,83
2020-09-01,San Joaquin,077,732212,18892,17915,39,17954,341
2020-09-01,San Luis Obispo,079,281455,3230,2970,18,2988,21
2020-09-01,San Mateo,081,765935,8869,8132,11,8143,122
2020-09-01,Santa Barbara,083,443738,8411,8142,70,8212,93
2020-09-01,Santa Clara,085,1922200,19187,17319,39,17358,204
2020-09-01,Santa Cruz,087,273765,1973,1752,17,1769,7
2020-09-01,Shasta,089,179085,642,527,3,530,9
2020-09-01,Sierra,091,2930,6,6,0,6,0
2020-09-01,Siskiyou,093,43540,141,128,8,136,0
2020-09-01,Solano,095,438530,5657,5438,40,5478,34
2020-09-01,Sonoma,097,501317,6256,5733,20,5753,60
2020-09-01,Stanislaus,099,539301,15499,14784,375,15159,212
2020-09-01,Sutter,101,95872,1459,1389,1,1390,10
2020-09-01,Tehama,103,63373,449,422,2,424,1
2020-09-01,Trinity,105,12862,47,13,6,19,0
2020-09-01,Tulare,107,460477,14971,14156,63,14219,241
2020-09-01,Tuolumne,109,53932,211,183,3,186,1
2020-09-01,Ventura,111,848112,11683,10899,106,11005,108
2020-09-01,Yolo,113,214977,2586,2440,6,2446,51
2020-09-01,Yuba,115,75493,932,841,3,844,1
2020-08-31,Alameda,001,1643700,19298,18148,131,18279,248
2020-08-31,Alpine,003,1148,2,2,0,2,0
2020-08-31,Amador,005,37829,275,243,0,243,13
2020-08-31,Butte,007,227075,2430,2069,21,2090,26
2020-08-31,Calaveras,009,45235,271,212,0,212,1
2020-08-31,Colusa,011,21464,475,443,0,443,6
2020-08-31,Contra Costa,013,1133247,14883,13902,53,13955,153
2020-08-31,Del Norte,015,27424,116,108,0,108,2
2020-08-31,El Dorado,017,186661,1034,965,4,969,2
2020-08-31,Fresno,019,978130,28142,25185,311,25496,290
2020-08-31,Glenn,021,27897,479,437,0,437,3
2020-08-31,Humboldt,023,135768,425,374,1,375,4
2020-08-31,Imperial,025,180216,11314,9759,6,9765,250
2020-08-31,Inyo,027,18085,181,160,4,164,3
2020-08-31,Kern,029,883053,30088,29067,230,29297,318
2020-08-31,Kings,031,150075,6483,6037,36,6073,62
2020-08-31,Lake,033,64148,367,341,0,341,2
2020-08-31,Lassen,035,31185,724,706,2,708,0
2020-08-31,Los Angeles,037,10098052,245956,241793,1340,243133,5787
2020-08-31,Madera,039,155013,3993,3662,27,3689,35
2020-08-31,Marin,041,260295,6286,6074,15,6089,67
2020-08-31,Mariposa,043,17540,73,69,0,69,2
2020-08-31,Mendocino,045,87422,662,618,0,618,15
2020-08-31,Merced,047,269075,8225,7991,10,8001,79
2020-08-31,Modoc,049,8938,18,10,0,10,0
2020-08-31,Mono,051,14174,163,145,2,147,1
2020-08-31,Monterey,053,433212,8388,7839,22,7861,56
2020-08-31,Napa,055,140530,1509,1434,6,1440,10
2020-08-31,Nevada,057,99092,462,447,15,462,6
2020-08-31,Orange,059,3164182,50698,47392,1228,48620,965
2020-08-31,Placer,061,380077,3183,2989,11,3000,33
2020-08-31,Plumas,063,18699,43,39,0,39,0
2020-08-31,Riverside,065,2383286,54168,52508,69,52577,1020
2020-08-31,Sacramento,067,1510023,18941,17999,16,18015,303
2020-08-31,San Benito,069,59416,1165,1080,0,1080,4
2020-08-31,San Bernardino,071,2135413,49722,47370,313,47683,755
2020-08-31,San Diego,073,3302833,40645,38606,498,39104,682
2020-08-31,San Francisco,075,870044,9873,9293,15,9308,83
2020-08-31,San Joaquin,077,732212,18805,17807,38,17845,338
2020-08-31,San Luis Obispo,079,281455,3207,2951,17,2968,21
2020-08-31,San Mateo,081,765935,8799,8065,11,8076,122
2020-08-31,Santa Barbara,083,443738,8365,8124,70,8194,94
2020-08-31,Santa Clara,085,1922200,18998,17211,39,17250,202
2020-08-31,Santa Cruz,087,273765,1948,1742,17,1759,7
2020-08-31,Shasta,089,179085,637,528,3,531,9
2020-08-31,Sierra,091,2930,6,6,0,6,0
2020-08-31,Siskiyou,093,43540,140,127,8,135,0
2020-08-31,Solano,095,438530,5625,5302,39,5341,34
2020-08-31,Sonoma,097,501317,6181,5650,20,5670,60
2020-08-31,Stanislaus,099,539301,15424,14685,366,15051,213
2020-08-31,Sutter,101,95872,1444,1365,1,1366,10
2020-08-31,Tehama,103,63373,446,421,2,423,1
2020-08-31,Trinity,105,12862,47,13,6,19,0
2020-08-31,Tulare,107,460477,14884,13985,61,14046,237
2020-08-31,Tuolumne,109,53932,211,178,3,181,1
2020-08-31,Ventura,111,848112,11595,10866,105,10971,108
2020-08-31,Yolo,113,214977,2568,2423,5,2428,51
2020-08-31,Yuba,115,75493,918,830,3,833,1
2020-08-30,Alameda,001,1643700,19173,18099,129,18228,248
2020-08-30,Alpine,003,1148,2,2,0,2,0
2020-08-30,Amador,005,37829,274,240,0,240,13
2020-08-30,Butte,007,227075,2349,1988,21,2009,26
2020-08-30,Calaveras,009,45235,262,211,0,211,1
2020-08-30,Colusa,011,21464,474,440,0,440,6
2020-08-30,Contra Costa,013,1133247,14746,13780,53,13833,150
2020-08-30,Del Norte,015,27424,115,108,0,108,2
2020-08-30,El Dorado,017,186661,1024,962,4,966,2
2020-08-30,Fresno,019,978130,28016,24963,310,25273,291
2020-08-30,Glenn,021,27897,472,437,0,437,3
2020-08-30,Humboldt,023,135768,414,362,1,363,4
2020-08-30,Imperial,025,180216,11296,9703,6,9709,250
2020-08-30,Inyo,027,18085,181,160,4,164,3
2020-08-30,Kern,029,883053,29995,28987,230,29217,317
2020-08-30,Kings,031,150075,6437,6000,36,6036,62
2020-08-30,Lake,033,64148,362,334,0,334,2
2020-08-30,Lassen,035,31185,722,706,2,708,0
2020-08-30,Los Angeles,037,10098052,244819,240775,1308,242083,5772
2020-08-30,Madera,039,155013,3964,3626,27,3653,33
2020-08-30,Marin,041,260295,6256,6060,15,6075,66
2020-08-30,Mariposa,043,17540,73,69,0,69,2
2020-08-30,Mendocino,045,87422,656,611,0,611,13
2020-08-30,Merced,047,269075,8150,7960,10,7970,79
2020-08-30,Modoc,049,8938,13,10,0,10,0
2020-08-30,Mono,051,14174,163,145,2,147,1
2020-08-30,Monterey,053,433212,8304,7816,22,7838,54
2020-08-30,Napa,055,140530,1497,1423,6,1429,10
2020-08-30,Nevada,057,99092,459,445,15,460,6
2020-08-30,Orange,059,3164182,50502,47283,1214,48497,965
2020-08-30,Placer,061,380077,3150,2961,11,2972,32
2020-08-30,Plumas,063,18699,42,39,0,39,0
2020-08-30,Riverside,065,2383286,53989,52227,67,52294,1017
2020-08-30,Sacramento,067,1510023,18763,17751,16,17767,300
2020-08-30,San Benito,069,59416,1155,1071,0,1071,4
2020-08-30,San Bernardino,071,2135413,49465,47201,313,47514,755
2020-08-30,San Diego,073,3302833,40247,38302,477,38779,682
2020-08-30,San Francisco,075,870044,9776,9294,12,9306,83
2020-08-30,San Joaquin,077,732212,18688,17637,37,17674,338
2020-08-30,San Luis Obispo,079,281455,3182,2934,17,2951,21
2020-08-30,San Mateo,081,765935,8722,8013,10,8023,122
2020-08-30,Santa Barbara,083,443738,8305,8088,70,8158,93
2020-08-30,Santa Clara,085,1922200,18822,17045,39,17084,202
2020-08-30,Santa Cruz,087,273765,1922,1743,17,1760,7
2020-08-30,Shasta,089,179085,634,525,3,528,9
2020-08-30,Sierra,091,2930,6,6,0,6,0
2020-08-30,Siskiyou,093,43540,138,125,8,133,0
2020-08-30,Solano,095,438530,5581,5303,39,5342,34
2020-08-30,Sonoma,097,501317,6121,5590,20,5610,60
2020-08-30,Stanislaus,099,539301,15352,14580,357,14937,209
2020-08-30,Sutter,101,95872,1422,1351,1,1352,10
2020-08-30,Tehama,103,63373,437,419,2,421,1
2020-08-30,Trinity,105,12862,47,13,6,19,0
2020-08-30,Tulare,107,460477,14789,13985,60,14045,236
2020-08-30,Tuolumne,109,53932,207,178,3,181,1
2020-08-30,Ventura,111,848112,11482,10775,100,10875,108
2020-08-30,Yolo,113,214977,2540,2391,4,2395,51
2020-08-30,Yuba,115,75493,904,832,3,835,1
2020-08-29,Alameda,001,1643700,19106,17888,129,18017,250
2020-08-29,Alpine,003,1148,2,2,0,2,0
2020-08-29,Amador,005,37829,274,239,0,239,13
2020-08-29,Butte,007,227075,2318,1948,21,1969,26
2020-08-29,Calaveras,009,45235,258,211,0,211,1
2020-08-29,Colusa,011,21464,471,440,0,440,6
2020-08-29,Contra Costa,013,1133247,14673,13663,52,13715,159
2020-08-29,Del Norte,015,27424,115,108,0,108,1
2020-08-29,El Dorado,017,186661,1021,958,4,962,2
2020-08-29,Fresno,019,978130,27961,24821,310,25131,291
2020-08-29,Glenn,021,27897,466,437,0,437,3
2020-08-29,Humboldt,023,135768,411,363,1,364,4
2020-08-29,Imperial,025,180216,11281,9698,6,9704,250
2020-08-29,Inyo,027,18085,181,160,4,164,3
2020-08-29,Kern,029,883053,29954,28947,229,29176,317
2020-08-29,Kings,031,150075,6422,5906,36,5942,62
2020-08-29,Lake,033,64148,361,329,0,329,2
2020-08-29,Lassen,035,31185,722,706,2,708,0
2020-08-29,Los Angeles,037,10098052,244189,239815,1295,241110,5762
2020-08-29,Madera,039,155013,3955,3605,26,3631,33
2020-08-29,Marin,041,260295,6244,6007,15,6022,64
2020-08-29,Mariposa,043,17540,73,69,0,69,2
2020-08-29,Mendocino,045,87422,652,596,0,596,13
2020-08-29,Merced,047,269075,8120,7867,10,7877,79
2020-08-29,Modoc,049,8938,13,9,0,9,0
2020-08-29,Mono,051,14174,163,145,2,147,1
2020-08-29,Monterey,053,433212,8259,7680,22,7702,53
2020-08-29,Napa,055,140530,1494,1413,6,1419,10
2020-08-29,Nevada,057,99092,459,442,15,457,5
2020-08-29,Orange,059,3164182,50392,47007,1204,48211,960
2020-08-29,Placer,061,380077,3133,2935,11,2946,32
2020-08-29,Plumas,063,18699,41,39,0,39,0
2020-08-29,Riverside,065,2383286,53877,51918,65,51983,1016
2020-08-29,Sacramento,067,1510023,18691,17588,16,17604,291
2020-08-29,San Benito,069,59416,1146,1045,0,1045,4
2020-08-29,San Bernardino,071,2135413,49350,46849,313,47162,755
2020-08-29,San Diego,073,3302833,39981,38049,459,38508,694
2020-08-29,San Francisco,075,870044,9748,9291,11,9302,83
2020-08-29,San Joaquin,077,732212,18644,17493,37,17530,335
2020-08-29,San Luis Obispo,079,281455,3157,2917,17,2934,21
2020-08-29,San Mateo,081,765935,8680,7928,10,7938,122
2020-08-29,Santa Barbara,083,443738,8279,8052,69,8121,93
2020-08-29,Santa Clara,085,1922200,18725,16898,38,16936,202
2020-08-29,Santa Cruz,087,273765,1910,1746,17,1763,7
2020-08-29,Shasta,089,179085,626,522,3,525,9
2020-08-29,Sierra,091,2930,6,6,0,6,0
2020-08-29,Siskiyou,093,43540,138,121,8,129,0
2020-08-29,Solano,095,438530,5560,5303,39,5342,34
2020-08-29,Sonoma,097,501317,6086,5537,20,5557,60
2020-08-29,Stanislaus,099,539301,15303,14479,347,14826,208
2020-08-29,Sutter,101,95872,1417,1333,1,1334,9
2020-08-29,Tehama,103,63373,436,417,2,419,1
2020-08-29,Trinity,105,12862,46,11,6,17,0
2020-08-29,Tulare,107,460477,14751,13890,59,13949,236
2020-08-29,Tuolumne,109,53932,207,178,3,181,1
2020-08-29,Ventura,111,848112,11440,10705,100,10805,108
2020-08-29,Yolo,113,214977,2522,2357,4,2361,51
2020-08-29,Yuba,115,75493,895,822,3,825,1
2020-08-28,Alameda,001,1643700,19023,17729,128,17857,237
2020-08-28,Alpine,003,1148,2,2,0,2,0
2020-08-28,Amador,005,37829,274,234,0,234,13
2020-08-28,Butte,007,227075,2288,1886,21,1907,25
2020-08-28,Calaveras,009,45235,256,207,0,207,1
2020-08-28,Colusa,011,21464,470,441,0,441,6
2020-08-28,Contra Costa,013,1133247,14602,13522,51,13573,158
2020-08-28,Del Norte,015,27424,115,107,0,107,1
2020-08-28,El Dorado,017,186661,1015,949,4,953,2
2020-08-28,Fresno,019,978130,27827,24612,310,24922,282
2020-08-28,Glenn,021,27897,459,429,0,429,3
2020-08-28,Humboldt,023,135768,407,362,1,363,4
2020-08-28,Imperial,025,180216,11267,9656,6,9662,241
2020-08-28,Inyo,027,18085,180,160,4,164,2
2020-08-28,Kern,029,883053,29906,28744,229,28973,306
2020-08-28,Kings,031,150075,6415,5829,35,5864,62
2020-08-28,Lake,033,64148,356,320,0,320,2
2020-08-28,Lassen,035,31185,722,704,2,706,0
2020-08-28,Los Angeles,037,10098052,243378,238544,1270,239814,5740
2020-08-28,Madera,039,155013,3936,3552,26,3578,33
2020-08-28,Marin,041,260295,6222,5991,15,6006,63
2020-08-28,Mariposa,043,17540,73,67,0,67,2
2020-08-28,Mendocino,045,87422,647,588,0,588,11
2020-08-28,Merced,047,269075,8090,7803,10,7813,77
2020-08-28,Modoc,049,8938,13,6,0,6,0
2020-08-28,Mono,051,14174,163,145,2,147,1
2020-08-28,Monterey,053,433212,8202,7591,22,7613,53
2020-08-28,Napa,055,140530,1486,1403,5,1408,10
2020-08-28,Nevada,057,99092,458,438,15,453,5
2020-08-28,Orange,059,3164182,50292,46696,1189,47885,942
2020-08-28,Placer,061,380077,3122,2891,11,2902,32
2020-08-28,Plumas,063,18699,41,39,0,39,0
2020-08-28,Riverside,065,2383286,53746,51510,61,51571,1008
2020-08-28,Sacramento,067,1510023,18594,17119,16,17135,283
2020-08-28,San Benito,069,59416,1130,1016,0,1016,3
2020-08-28,San Bernardino,071,2135413,49231,46553,309,46862,754
2020-08-28,San Diego,073,3302833,39751,37786,444,38230,676
2020-08-28,San Francisco,075,870044,9696,9135,11,9146,83
2020-08-28,San Joaquin,077,732212,18591,17114,36,17150,314
2020-08-28,San Luis Obispo,079,281455,3140,2849,17,2866,20
2020-08-28,San Mateo,081,765935,8633,7783,9,7792,121
2020-08-28,Santa Barbara,083,443738,8247,8001,69,8070,92
2020-08-28,Santa Clara,085,1922200,18594,16696,38,16734,201
2020-08-28,Santa Cruz,087,273765,1898,1747,17,1764,7
2020-08-28,Shasta,089,179085,622,516,3,519,9
2020-08-28,Sierra,091,2930,6,6,0,6,0
2020-08-28,Siskiyou,093,43540,136,119,8,127,0
2020-08-28,Solano,095,438530,5541,5219,39,5258,34
2020-08-28,Sonoma,097,501317,6051,5425,19,5444,58
2020-08-28,Stanislaus,099,539301,15261,14176,343,14519,190
2020-08-28,Sutter,101,95872,1407,1308,1,1309,9
2020-08-28,Tehama,103,63373,431,410,2,412,1
2020-08-28,Trinity,105,12862,46,11,6,17,0
2020-08-28,Tulare,107,460477,14705,13776,59,13835,236
2020-08-28,Tuolumne,109,53932,207,176,3,179,1
2020-08-28,Ventura,111,848112,11404,10606,98,10704,103
2020-08-28,Yolo,113,214977,2513,2323,4,2327,51
2020-08-28,Yuba,115,75493,886,810,3,813,1
2020-08-27,Alameda,001,1643700,18878,17584,125,17709,234
2020-08-27,Alpine,003,1148,2,2,0,2,0
2020-08-27,Amador,005,37829,273,233,0,233,13
2020-08-27,Butte,007,227075,2222,1803,20,1823,25
2020-08-27,Calaveras,009,45235,250,204,0,204,1
2020-08-27,Colusa,011,21464,468,438,0,438,6
2020-08-27,Contra Costa,013,1133247,14501,13379,50,13429,158
2020-08-27,Del Norte,015,27424,115,107,0,107,1
2020-08-27,El Dorado,017,186661,1011,942,4,946,2
2020-08-27,Fresno,019,978130,27645,24367,305,24672,272
2020-08-27,Glenn,021,27897,451,429,0,429,3
2020-08-27,Humboldt,023,135768,399,358,1,359,4
2020-08-27,Imperial,025,180216,11240,9608,6,9614,235
2020-08-27,Inyo,027,18085,180,157,3,160,2
2020-08-27,Kern,029,883053,29834,28635,220,28855,294
2020-08-27,Kings,031,150075,6393,5759,35,5794,62
2020-08-27,Lake,033,64148,354,314,0,314,2
2020-08-27,Lassen,035,31185,722,703,2,705,0
2020-08-27,Los Angeles,037,10098052,242376,237103,1254,238357,5704
2020-08-27,Madera,039,155013,3910,3465,26,3491,33
2020-08-27,Marin,041,260295,6198,5929,15,5944,62
2020-08-27,Mariposa,043,17540,73,67,0,67,2
2020-08-27,Mendocino,045,87422,638,581,0,581,10
2020-08-27,Merced,047,269075,8046,7765,10,7775,75
2020-08-27,Modoc,049,8938,11,5,0,5,0
2020-08-27,Mono,051,14174,163,145,2,147,1
2020-08-27,Monterey,053,433212,8108,7501,22,7523,52
2020-08-27,Napa,055,140530,1480,1397,5,1402,10
2020-08-27,Nevada,057,99092,455,435,15,450,5
2020-08-27,Orange,059,3164182,50135,46449,1178,47627,935
2020-08-27,Placer,061,380077,3091,2869,11,2880,32
2020-08-27,Plumas,063,18699,40,39,0,39,0
2020-08-27,Riverside,065,2383286,53537,51306,58,51364,999
2020-08-27,Sacramento,067,1510023,18396,16875,16,16891,281
2020-08-27,San Benito,069,59416,1114,987,0,987,3
2020-08-27,San Bernardino,071,2135413,49006,46345,303,46648,751
2020-08-27,San Diego,073,3302833,39480,37501,424,37925,673
2020-08-27,San Francisco,075,870044,9630,9014,11,9025,83
2020-08-27,San Joaquin,077,732212,18511,16989,36,17025,314
2020-08-27,San Luis Obispo,079,281455,3115,2808,17,2825,20
2020-08-27,San Mateo,081,765935,8524,7728,9,7737,121
2020-08-27,Santa Barbara,083,443738,8209,7934,69,8003,92
2020-08-27,Santa Clara,085,1922200,18411,16495,38,16533,199
2020-08-27,Santa Cruz,087,273765,1881,1734,17,1751,7
2020-08-27,Shasta,089,179085,616,512,3,515,9
2020-08-27,Sierra,091,2930,6,6,0,6,0
2020-08-27,Siskiyou,093,43540,136,118,8,126,0
2020-08-27,Solano,095,438530,5503,5167,39,5206,34
2020-08-27,Sonoma,097,501317,5939,5357,19,5376,58
2020-08-27,Stanislaus,099,539301,15180,14080,340,14420,186
2020-08-27,Sutter,101,95872,1387,1296,1,1297,9
2020-08-27,Tehama,103,63373,427,398,2,400,1
2020-08-27,Trinity,105,12862,46,11,6,17,0
2020-08-27,Tulare,107,460477,14614,13666,58,13724,231
2020-08-27,Tuolumne,109,53932,202,174,3,177,1
2020-08-27,Ventura,111,848112,11341,10483,94,10577,102
2020-08-27,Yolo,113,214977,2489,2293,4,2297,51
2020-08-27,Yuba,115,75493,875,807,3,810,1
2020-08-26,Alameda,001,1643700,18716,17373,125,17498,233
2020-08-26,Alpine,003,1148,2,2,0,2,0
2020-08-26,Amador,005,37829,273,229,0,229,13
2020-08-26,Butte,007,227075,2155,1765,18,1783,25
2020-08-26,Calaveras,009,45235,243,201,0,201,1
2020-08-26,Colusa,011,21464,462,433,0,433,5
2020-08-26,Contra Costa,013,1133247,14364,13248,50,13298,157
2020-08-26,Del Norte,015,27424,114,86,0,86,1
2020-08-26,El Dorado,017,186661,1009,938,4,942,2
2020-08-26,Fresno,019,978130,27497,24071,303,24374,255
2020-08-26,Glenn,021,27897,449,429,0,429,3
2020-08-26,Humboldt,023,135768,387,357,1,358,4
2020-08-26,Imperial,025,180216,11218,9453,6,9459,227
2020-08-26,Inyo,027,18085,177,157,3,160,2
2020-08-26,Kern,029,883053,29695,28507,217,28724,286
2020-08-26,Kings,031,150075,6372,5720,35,5755,62
2020-08-26,Lake,033,64148,349,308,0,308,2
2020-08-26,Lassen,035,31185,722,702,2,704,0
2020-08-26,Los Angeles,037,10098052,241362,235499,1223,236722,5665
2020-08-26,Madera,039,155013,3881,3458,26,3484,32
2020-08-26,Marin,041,260295,6181,5887,15,5902,56
2020-08-26,Mariposa,043,17540,73,68,0,68,2
2020-08-26,Mendocino,045,87422,627,581,0,581,10
2020-08-26,Merced,047,269075,8013,7720,10,7730,74
2020-08-26,Modoc,049,8938,8,5,0,5,0
2020-08-26,Mono,051,14174,163,141,2,143,1
2020-08-26,Monterey,053,433212,8015,7439,22,7461,51
2020-08-26,Napa,055,140530,1467,1382,5,1387,10
2020-08-26,Nevada,057,99092,452,432,15,447,2
2020-08-26,Orange,059,3164182,49951,46157,1162,47319,905
2020-08-26,Placer,061,380077,3069,2846,9,2855,32
2020-08-26,Plumas,063,18699,39,39,0,39,0
2020-08-26,Riverside,065,2383286,53295,51138,58,51196,987
2020-08-26,Sacramento,067,1510023,18233,16708,16,16724,271
2020-08-26,San Benito,069,59416,1099,978,0,978,3
2020-08-26,San Bernardino,071,2135413,48798,45840,299,46139,743
2020-08-26,San Diego,073,3302833,39142,37224,397,37621,668
2020-08-26,San Francisco,075,870044,9555,8938,11,8949,81
2020-08-26,San Joaquin,077,732212,18422,16845,35,16880,309
2020-08-26,San Luis Obispo,079,281455,3087,2761,17,2778,20
2020-08-26,San Mateo,081,765935,8457,7655,9,7664,121
2020-08-26,Santa Barbara,083,443738,8175,7904,69,7973,90
2020-08-26,Santa Clara,085,1922200,18235,16283,38,16321,198
2020-08-26,Santa Cruz,087,273765,1870,1726,17,1743,7
2020-08-26,Shasta,089,179085,611,511,3,514,9
2020-08-26,Sierra,091,2930,6,6,0,6,0
2020-08-26,Siskiyou,093,43540,133,109,8,117,0
2020-08-26,Solano,095,438530,5479,5131,38,5169,34
2020-08-26,Sonoma,097,501317,5866,5283,19,5302,58
2020-08-26,Stanislaus,099,539301,15103,13964,334,14298,186
2020-08-26,Sutter,101,95872,1369,1275,1,1276,9
2020-08-26,Tehama,103,63373,424,396,2,398,1
2020-08-26,Trinity,105,12862,45,10,6,16,0
2020-08-26,Tulare,107,460477,14547,13568,58,13626,232
2020-08-26,Tuolumne,109,53932,201,172,3,175,1
2020-08-26,Ventura,111,848112,11269,10412,87,10499,100
2020-08-26,Yolo,113,214977,2467,2279,4,2283,49
2020-08-26,Yuba,115,75493,860,779,3,782,1
2020-08-25,Alameda,001,1643700,18559,17278,125,17403,232
2020-08-25,Alpine,003,1148,2,2,0,2,0
2020-08-25,Amador,005,37829,273,227,0,227,13
2020-08-25,Butte,007,227075,2088,1718,18,1736,24
2020-08-25,Calaveras,009,45235,241,196,0,196,1
2020-08-25,Colusa,011,21464,455,430,0,430,5
2020-08-25,Contra Costa,013,1133247,14226,13181,49,13230,156
2020-08-25,Del Norte,015,27424,113,83,0,83,1
2020-08-25,El Dorado,017,186661,1006,928,4,932,2
2020-08-25,Fresno,019,978130,27309,23932,302,24234,250
2020-08-25,Glenn,021,27897,446,429,0,429,3
2020-08-25,Humboldt,023,135768,382,342,1,343,4
2020-08-25,Imperial,025,180216,11190,9381,6,9387,217
2020-08-25,Inyo,027,18085,175,144,3,147,1
2020-08-25,Kern,029,883053,29558,28416,217,28633,285
2020-08-25,Kings,031,150075,6215,5702,35,5737,59
2020-08-25,Lake,033,64148,344,304,0,304,2
2020-08-25,Lassen,035,31185,721,692,2,694,0
2020-08-25,Los Angeles,037,10098052,240064,233961,1173,235134,5612
2020-08-25,Madera,039,155013,3866,3446,25,3471,32
2020-08-25,Marin,041,260295,6143,5860,15,5875,56
2020-08-25,Mariposa,043,17540,73,67,0,67,2
2020-08-25,Mendocino,045,87422,619,571,0,571,10
2020-08-25,Merced,047,269075,7946,7693,9,7702,69
2020-08-25,Modoc,049,8938,8,5,0,5,0
2020-08-25,Mono,051,14174,163,129,2,131,1
2020-08-25,Monterey,053,433212,7935,7333,22,7355,51
2020-08-25,Napa,055,140530,1460,1374,5,1379,10
2020-08-25,Nevada,057,99092,448,430,15,445,2
2020-08-25,Orange,059,3164182,49757,45737,1146,46883,902
2020-08-25,Placer,061,380077,3050,2829,6,2835,31
2020-08-25,Plumas,063,18699,39,39,0,39,0
2020-08-25,Riverside,065,2383286,53063,50889,58,50947,981
2020-08-25,Sacramento,067,1510023,18080,16601,16,16617,265
2020-08-25,San Benito,069,59416,1083,973,0,973,3
2020-08-25,San Bernardino,071,2135413,48563,45544,296,45840,727
2020-08-25,San Diego,073,3302833,38863,36996,375,37371,665
2020-08-25,San Francisco,075,870044,9477,8848,11,8859,81
2020-08-25,San Joaquin,077,732212,18295,16795,35,16830,306
2020-08-25,San Luis Obispo,079,281455,3028,2731,16,2747,20
2020-08-25,San Mateo,081,765935,8397,7636,9,7645,120
2020-08-25,Santa Barbara,083,443738,8123,7854,69,7923,90
2020-08-25,Santa Clara,085,1922200,18063,16199,38,16237,194
2020-08-25,Santa Cruz,087,273765,1851,1708,17,1725,7
2020-08-25,Shasta,089,179085,607,511,3,514,9
2020-08-25,Sierra,091,2930,6,6,0,6,0
2020-08-25,Siskiyou,093,43540,132,109,8,117,0
2020-08-25,Solano,095,438530,5418,5114,38,5152,34
2020-08-25,Sonoma,097,501317,5780,5148,19,5167,56
2020-08-25,Stanislaus,099,539301,14995,13886,323,14209,182
2020-08-25,Sutter,101,95872,1352,1259,1,1260,9
2020-08-25,Tehama,103,63373,421,394,2,396,1
2020-08-25,Trinity,105,12862,44,10,6,16,0
2020-08-25,Tulare,107,460477,14443,13514,57,13571,224
2020-08-25,Tuolumne,109,53932,199,172,3,175,1
2020-08-25,Ventura,111,848112,11184,10313,82,10395,99
2020-08-25,Yolo,113,214977,2454,2254,4,2258,50
2020-08-25,Yuba,115,75493,850,775,3,778,1
2020-08-24,Alameda,001,1643700,18364,16913,124,17037,231
2020-08-24,Alpine,003,1148,2,2,0,2,0
2020-08-24,Amador,005,37829,271,227,0,227,13
2020-08-24,Butte,007,227075,2004,1649,18,1667,23
2020-08-24,Calaveras,009,45235,232,187,0,187,1
2020-08-24,Colusa,011,21464,451,425,0,425,5
2020-08-24,Contra Costa,013,1133247,14110,12906,47,12953,153
2020-08-24,Del Norte,015,27424,113,80,0,80,1
2020-08-24,El Dorado,017,186661,998,908,4,912,2
2020-08-24,Fresno,019,978130,27121,23618,295,23913,235
2020-08-24,Glenn,021,27897,444,421,0,421,2
2020-08-24,Humboldt,023,135768,378,340,1,341,4
2020-08-24,Imperial,025,180216,11157,9323,6,9329,210
2020-08-24,Inyo,027,18085,171,144,3,147,2
2020-08-24,Kern,029,883053,29460,28157,211,28368,277
2020-08-24,Kings,031,150075,6127,5652,35,5687,60
2020-08-24,Lake,033,64148,329,302,0,302,2
2020-08-24,Lassen,035,31185,721,693,2,695,0
2020-08-24,Los Angeles,037,10098052,238703,233036,1154,234190,5562
2020-08-24,Madera,039,155013,3839,3418,25,3443,32
2020-08-24,Marin,041,260295,6080,5834,15,5849,56
2020-08-24,Mariposa,043,17540,71,66,0,66,2
2020-08-24,Mendocino,045,87422,604,550,0,550,10
2020-08-24,Merced,047,269075,7868,7605,9,7614,69
2020-08-24,Modoc,049,8938,8,5,0,5,0
2020-08-24,Mono,051,14174,163,129,2,131,1
2020-08-24,Monterey,053,433212,7826,7212,21,7233,50
2020-08-24,Napa,055,140530,1447,1358,5,1363,10
2020-08-24,Nevada,057,99092,443,423,15,438,2
2020-08-24,Orange,059,3164182,49564,45536,1136,46672,887
2020-08-24,Placer,061,380077,3004,2793,6,2799,31
2020-08-24,Plumas,063,18699,39,37,0,37,0
2020-08-24,Riverside,065,2383286,52785,50496,58,50554,975
2020-08-24,Sacramento,067,1510023,17883,16318,16,16334,249
2020-08-24,San Benito,069,59416,1062,961,0,961,3
2020-08-24,San Bernardino,071,2135413,48300,45199,294,45493,720
2020-08-24,San Diego,073,3302833,38575,36729,347,37076,660
2020-08-24,San Francisco,075,870044,9394,8621,10,8631,81
2020-08-24,San Joaquin,077,732212,18154,16565,34,16599,305
2020-08-24,San Luis Obispo,079,281455,3000,2705,16,2721,20
2020-08-24,San Mateo,081,765935,8330,7502,9,7511,120
2020-08-24,Santa Barbara,083,443738,8082,7784,69,7853,90
2020-08-24,Santa Clara,085,1922200,17859,16049,38,16087,192
2020-08-24,Santa Cruz,087,273765,1831,1627,16,1643,6
2020-08-24,Shasta,089,179085,605,505,3,508,9
2020-08-24,Sierra,091,2930,6,6,0,6,0
2020-08-24,Siskiyou,093,43540,128,107,8,115,0
2020-08-24,Solano,095,438530,5369,4979,36,5015,32
2020-08-24,Sonoma,097,501317,5678,5071,19,5090,56
2020-08-24,Stanislaus,099,539301,14897,13521,309,13830,171
2020-08-24,Sutter,101,95872,1333,1219,1,1220,9
2020-08-24,Tehama,103,63373,416,388,2,390,1
2020-08-24,Trinity,105,12862,44,10,6,16,0
2020-08-24,Tulare,107,460477,14336,13360,56,13416,223
2020-08-24,Tuolumne,109,53932,198,170,3,173,1
2020-08-24,Ventura,111,848112,11104,10261,78,10339,99
2020-08-24,Yolo,113,214977,2420,2239,4,2243,47
2020-08-24,Yuba,115,75493,833,750,3,753,1
2020-08-23,Alameda,001,1643700,18140,16786,123,16909,231
2020-08-23,Alpine,003,1148,2,2,0,2,0
2020-08-23,Amador,005,37829,268,227,0,227,13
2020-08-23,Butte,007,227075,1889,1637,18,1655,23
2020-08-23,Calaveras,009,45235,222,187,0,187,1
2020-08-23,Colusa,011,21464,444,424,0,424,5
2020-08-23,Contra Costa,013,1133247,13950,12642,47,12689,153
2020-08-23,Del Norte,015,27424,113,80,0,80,1
2020-08-23,El Dorado,017,186661,985,901,4,905,2
2020-08-23,Fresno,019,978130,26916,23414,291,23705,235
2020-08-23,Glenn,021,27897,437,421,0,421,2
2020-08-23,Humboldt,023,135768,376,341,1,342,4
2020-08-23,Imperial,025,180216,11128,9243,6,9249,210
2020-08-23,Inyo,027,18085,168,144,3,147,2
2020-08-23,Kern,029,883053,29311,28028,206,28234,277
2020-08-23,Kings,031,150075,6084,5628,35,5663,60
2020-08-23,Lake,033,64148,325,299,0,299,2
2020-08-23,Lassen,035,31185,720,693,2,695,0
2020-08-23,Los Angeles,037,10098052,237108,231833,1084,232917,5549
2020-08-23,Madera,039,155013,3807,3401,24,3425,32
2020-08-23,Marin,041,260295,6041,5807,14,5821,50
2020-08-23,Mariposa,043,17540,71,66,0,66,2
2020-08-23,Mendocino,045,87422,600,550,0,550,10
2020-08-23,Merced,047,269075,7799,7574,8,7582,69
2020-08-23,Modoc,049,8938,7,5,0,5,0
2020-08-23,Mono,051,14174,163,129,2,131,1
2020-08-23,Monterey,053,433212,7736,7173,21,7194,50
2020-08-23,Napa,055,140530,1435,1348,5,1353,10
2020-08-23,Nevada,057,99092,438,421,15,436,2
2020-08-23,Orange,059,3164182,49326,45267,1124,46391,887
2020-08-23,Placer,061,380077,2965,2772,6,2778,31
2020-08-23,Plumas,063,18699,39,37,0,37,0
2020-08-23,Riverside,065,2383286,52515,50293,56,50349,955
2020-08-23,Sacramento,067,1510023,17659,16084,15,16099,243
2020-08-23,San Benito,069,59416,1049,938,0,938,3
2020-08-23,San Bernardino,071,2135413,48032,45010,284,45294,719
2020-08-23,San Diego,073,3302833,38254,36542,320,36862,660
2020-08-23,San Francisco,075,870044,9299,8564,9,8573,80
2020-08-23,San Joaquin,077,732212,18021,16069,33,16102,305
2020-08-23,San Luis Obispo,079,281455,2958,2679,16,2695,20
2020-08-23,San Mateo,081,765935,8235,7450,9,7459,120
2020-08-23,Santa Barbara,083,443738,8014,7725,69,7794,90
2020-08-23,Santa Clara,085,1922200,17664,15912,36,15948,191
2020-08-23,Santa Cruz,087,273765,1805,1627,16,1643,6
2020-08-23,Shasta,089,179085,600,501,3,504,9
2020-08-23,Sierra,091,2930,6,6,0,6,0
2020-08-23,Siskiyou,093,43540,123,107,8,115,0
2020-08-23,Solano,095,438530,5311,4977,34,5011,32
2020-08-23,Sonoma,097,501317,5590,5018,19,5037,56
2020-08-23,Stanislaus,099,539301,14762,13483,286,13769,171
2020-08-23,Sutter,101,95872,1311,1203,1,1204,9
2020-08-23,Tehama,103,63373,406,381,2,383,1
2020-08-23,Trinity,105,12862,44,10,6,16,0
2020-08-23,Tulare,107,460477,14204,13303,53,13356,223
2020-08-23,Tuolumne,109,53932,195,164,3,167,1
2020-08-23,Ventura,111,848112,11003,10126,74,10200,99
2020-08-23,Yolo,113,214977,2392,2210,4,2214,47
2020-08-23,Yuba,115,75493,812,750,3,753,1
2020-08-22,Alameda,001,1643700,18046,16648,122,16770,231
2020-08-22,Alpine,003,1148,2,2,0,2,0
2020-08-22,Amador,005,37829,267,224,0,224,13
2020-08-22,Butte,007,227075,1838,1618,18,1636,22
2020-08-22,Calaveras,009,45235,218,187,0,187,1
2020-08-22,Colusa,011,21464,440,419,0,419,5
2020-08-22,Contra Costa,013,1133247,13863,12522,47,12569,153
2020-08-22,Del Norte,015,27424,112,80,0,80,1
2020-08-22,El Dorado,017,186661,983,900,4,904,2
2020-08-22,Fresno,019,978130,26819,23197,290,23487,235
2020-08-22,Glenn,021,27897,436,421,0,421,2
2020-08-22,Humboldt,023,135768,366,334,1,335,4
2020-08-22,Imperial,025,180216,11120,9244,6,9250,210
2020-08-22,Inyo,027,18085,168,144,3,147,1
2020-08-22,Kern,029,883053,29257,27807,206,28013,277
2020-08-22,Kings,031,150075,6075,5447,35,5482,60
2020-08-22,Lake,033,64148,323,291,0,291,2
2020-08-22,Lassen,035,31185,720,693,2,695,0
2020-08-22,Los Angeles,037,10098052,236448,230858,1066,231924,5540
2020-08-22,Madera,039,155013,3788,3330,24,3354,32
2020-08-22,Marin,041,260295,6029,5789,14,5803,49
2020-08-22,Mariposa,043,17540,71,66,0,66,2
2020-08-22,Mendocino,045,87422,597,529,0,529,10
2020-08-22,Merced,047,269075,7771,7493,8,7501,69
2020-08-22,Modoc,049,8938,7,5,0,5,0
2020-08-22,Mono,051,14174,163,129,2,131,1
2020-08-22,Monterey,053,433212,7688,7081,21,7102,50
2020-08-22,Napa,055,140530,1430,1328,5,1333,11
2020-08-22,Nevada,057,99092,438,411,15,426,2
2020-08-22,Orange,059,3164182,49185,45131,1118,46249,885
2020-08-22,Placer,061,380077,2951,2734,6,2740,30
2020-08-22,Plumas,063,18699,39,37,0,37,0
2020-08-22,Riverside,065,2383286,52367,49944,55,49999,953
2020-08-22,Sacramento,067,1510023,17547,15516,15,15531,239
2020-08-22,San Benito,069,59416,1033,912,0,912,3
2020-08-22,San Bernardino,071,2135413,47903,44803,280,45083,719
2020-08-22,San Diego,073,3302833,38072,36205,309,36514,673
2020-08-22,San Francisco,075,870044,9239,8568,9,8577,80
2020-08-22,San Joaquin,077,732212,17965,16068,33,16101,305
2020-08-22,San Luis Obispo,079,281455,2932,2660,16,2676,20
2020-08-22,San Mateo,081,765935,8188,7361,9,7370,120
2020-08-22,Santa Barbara,083,443738,7988,7685,69,7754,90
2020-08-22,Santa Clara,085,1922200,17556,15590,36,15626,190
2020-08-22,Santa Cruz,087,273765,1789,1628,15,1643,6
2020-08-22,Shasta,089,179085,598,493,3,496,9
2020-08-22,Sierra,091,2930,6,6,0,6,0
2020-08-22,Siskiyou,093,43540,123,106,8,114,0
2020-08-22,Solano,095,438530,5281,4944,33,4977,32
2020-08-22,Sonoma,097,501317,5544,4891,19,4910,57
2020-08-22,Stanislaus,099,539301,14712,13380,269,13649,170
2020-08-22,Sutter,101,95872,1304,1189,1,1190,8
2020-08-22,Tehama,103,63373,405,368,2,370,1
2020-08-22,Trinity,105,12862,44,8,6,14,0
2020-08-22,Tulare,107,460477,14137,13196,53,13249,222
2020-08-22,Tuolumne,109,53932,193,162,3,165,1
2020-08-22,Ventura,111,848112,10948,9959,72,10031,99
2020-08-22,Yolo,113,214977,2376,2188,4,2192,47
2020-08-22,Yuba,115,75493,800,738,3,741,1
2020-08-21,Alameda,001,1643700,17954,16413,122,16535,232
2020-08-21,Alpine,003,1148,2,2,0,2,0
2020-08-21,Amador,005,37829,266,223,0,223,11
2020-08-21,Butte,007,227075,1800,1582,18,1600,19
2020-08-21,Calaveras,009,45235,218,182,0,182,1
2020-08-21,Colusa,011,21464,438,418,0,418,5
2020-08-21,Contra Costa,013,1133247,13773,12333,46,12379,149
2020-08-21,Del Norte,015,27424,112,78,0,78,1
2020-08-21,El Dorado,017,186661,979,885,4,889,2
2020-08-21,Fresno,019,978130,26649,22840,289,23129,232
2020-08-21,Glenn,021,27897,432,418,0,418,2
2020-08-21,Humboldt,023,135768,363,331,1,332,4
2020-08-21,Imperial,025,180216,11104,9166,6,9172,204
2020-08-21,Inyo,027,18085,168,144,3,147,1
2020-08-21,Kern,029,883053,29198,27567,204,27771,269
2020-08-21,Kings,031,150075,6053,5391,35,5426,60
2020-08-21,Lake,033,64148,321,281,0,281,2
2020-08-21,Lassen,035,31185,720,693,2,695,0
2020-08-21,Los Angeles,037,10098052,235574,229235,1046,230281,5494
2020-08-21,Madera,039,155013,3758,3271,24,3295,31
2020-08-21,Marin,041,260295,6009,5762,14,5776,49
2020-08-21,Mariposa,043,17540,71,66,0,66,2
2020-08-21,Mendocino,045,87422,587,505,0,505,10
2020-08-21,Merced,047,269075,7742,7357,8,7365,69
2020-08-21,Modoc,049,8938,7,5,0,5,0
2020-08-21,Mono,051,14174,163,128,2,130,1
2020-08-21,Monterey,053,433212,7616,6974,21,6995,49
2020-08-21,Napa,055,140530,1421,1317,5,1322,10
2020-08-21,Nevada,057,99092,437,406,15,421,2
2020-08-21,Orange,059,3164182,49044,44625,1109,45734,875
2020-08-21,Placer,061,380077,2934,2698,6,2704,30
2020-08-21,Plumas,063,18699,39,36,0,36,0
2020-08-21,Riverside,065,2383286,52172,49409,55,49464,932
2020-08-21,Sacramento,067,1510023,17424,15247,15,15262,237
2020-08-21,San Benito,069,59416,1023,891,0,891,3
2020-08-21,San Bernardino,071,2135413,47783,44249,276,44525,668
2020-08-21,San Diego,073,3302833,37868,35914,292,36206,652
2020-08-21,San Francisco,075,870044,9189,8375,9,8384,80
2020-08-21,San Joaquin,077,732212,17882,15888,31,15919,301
2020-08-21,San Luis Obispo,079,281455,2909,2640,16,2656,19
2020-08-21,San Mateo,081,765935,8130,7253,9,7262,120
2020-08-21,Santa Barbara,083,443738,7947,7645,69,7714,86
2020-08-21,Santa Clara,085,1922200,17404,15399,36,15435,190
2020-08-21,Santa Cruz,087,273765,1777,1617,15,1632,6
2020-08-21,Shasta,089,179085,598,486,3,489,9
2020-08-21,Sierra,091,2930,6,6,0,6,0
2020-08-21,Siskiyou,093,43540,123,103,6,109,0
2020-08-21,Solano,095,438530,5258,4891,32,4923,32
2020-08-21,Sonoma,097,501317,5474,4816,19,4835,57
2020-08-21,Stanislaus,099,539301,14643,13282,254,13536,161
2020-08-21,Sutter,101,95872,1291,1173,1,1174,8
2020-08-21,Tehama,103,63373,403,357,2,359,1
2020-08-21,Trinity,105,12862,44,8,6,14,0
2020-08-21,Tulare,107,460477,14065,13002,52,13054,217
2020-08-21,Tuolumne,109,53932,185,161,3,164,1
2020-08-21,Ventura,111,848112,10883,9865,70,9935,98
2020-08-21,Yolo,113,214977,2361,2164,4,2168,46
2020-08-21,Yuba,115,75493,796,717,3,720,1
2020-08-20,Alameda,001,1643700,17795,16174,122,16296,229
2020-08-20,Alpine,003,1148,2,2,0,2,0
2020-08-20,Amador,005,37829,264,222,0,222,11
2020-08-20,Butte,007,227075,1749,1549,18,1567,18
2020-08-20,Calaveras,009,45235,215,179,0,179,1
2020-08-20,Colusa,011,21464,436,415,0,415,5
2020-08-20,Contra Costa,013,1133247,13645,12108,45,12153,144
2020-08-20,Del Norte,015,27424,112,78,0,78,1
2020-08-20,El Dorado,017,186661,975,881,4,885,2
2020-08-20,Fresno,019,978130,26467,22535,284,22819,228
2020-08-20,Glenn,021,27897,427,414,0,414,2
2020-08-20,Humboldt,023,135768,358,318,1,319,4
2020-08-20,Imperial,025,180216,11085,9086,6,9092,196
2020-08-20,Inyo,027,18085,167,144,3,147,1
2020-08-20,Kern,029,883053,29030,27337,193,27530,267
2020-08-20,Kings,031,150075,6013,5347,34,5381,59
2020-08-20,Lake,033,64148,316,280,0,280,2
2020-08-20,Lassen,035,31185,719,693,2,695,0
2020-08-20,Los Angeles,037,10098052,234344,227492,1027,228519,5445
2020-08-20,Madera,039,155013,3732,3197,24,3221,31
2020-08-20,Marin,041,260295,5991,5745,14,5759,47
2020-08-20,Mariposa,043,17540,71,67,0,67,2
2020-08-20,Mendocino,045,87422,577,497,0,497,10
2020-08-20,Merced,047,269075,7667,7173,8,7181,68
2020-08-20,Modoc,049,8938,7,5,0,5,0
2020-08-20,Mono,051,14174,163,128,2,130,1
2020-08-20,Monterey,053,433212,7545,6892,21,6913,47
2020-08-20,Napa,055,140530,1413,1306,5,1311,10
2020-08-20,Nevada,057,99092,436,401,15,416,2
2020-08-20,Orange,059,3164182,48817,44299,1098,45397,849
2020-08-20,Placer,061,380077,2918,2681,6,2687,30
2020-08-20,Plumas,063,18699,39,36,0,36,0
2020-08-20,Riverside,065,2383286,51953,48953,54,49007,927
2020-08-20,Sacramento,067,1510023,17182,14992,15,15007,231
2020-08-20,San Benito,069,59416,1010,866,0,866,3
2020-08-20,San Bernardino,071,2135413,47527,43627,272,43899,665
2020-08-20,San Diego,073,3302833,37648,35610,274,35884,644
2020-08-20,San Francisco,075,870044,9103,8262,9,8271,72
2020-08-20,San Joaquin,077,732212,17789,15778,31,15809,297
2020-08-20,San Luis Obispo,079,281455,2889,2590,16,2606,19
2020-08-20,San Mateo,081,765935,8065,7188,9,7197,120
2020-08-20,Santa Barbara,083,443738,7909,7571,69,7640,81
2020-08-20,Santa Clara,085,1922200,17231,15162,36,15198,190
2020-08-20,Santa Cruz,087,273765,1764,1581,15,1596,6
2020-08-20,Shasta,089,179085,597,478,3,481,9
2020-08-20,Sierra,091,2930,6,6,0,6,0
2020-08-20,Siskiyou,093,43540,122,102,1,103,0
2020-08-20,Solano,095,438530,5214,4843,32,4875,31
2020-08-20,Sonoma,097,501317,5402,4737,19,4756,54
2020-08-20,Stanislaus,099,539301,14547,13120,245,13365,161
2020-08-20,Sutter,101,95872,1267,1158,1,1159,8
2020-08-20,Tehama,103,63373,398,350,2,352,1
2020-08-20,Trinity,105,12862,44,8,6,14,0
2020-08-20,Tulare,107,460477,13957,12907,51,12958,217
2020-08-20,Tuolumne,109,53932,181,159,3,162,1
2020-08-20,Ventura,111,848112,10770,9744,69,9813,93
2020-08-20,Yolo,113,214977,2339,2150,4,2154,47
2020-08-20,Yuba,115,75493,779,709,3,712,1
2020-08-19,Alameda,001,1643700,17637,15874,121,15995,226
2020-08-19,Alpine,003,1148,2,2,0,2,0
2020-08-19,Amador,005,37829,263,219,0,219,9
2020-08-19,Butte,007,227075,1706,1517,18,1535,16
2020-08-19,Calaveras,009,45235,213,177,0,177,1
2020-08-19,Colusa,011,21464,435,415,0,415,5
2020-08-19,Contra Costa,013,1133247,13533,11895,43,11938,142
2020-08-19,Del Norte,015,27424,112,78,0,78,1
2020-08-19,El Dorado,017,186661,969,870,4,874,2
2020-08-19,Fresno,019,978130,26278,22167,275,22442,221
2020-08-19,Glenn,021,27897,425,414,0,414,2
2020-08-19,Humboldt,023,135768,355,316,1,317,4
2020-08-19,Imperial,025,180216,11057,9041,6,9047,192
2020-08-19,Inyo,027,18085,165,140,3,143,1
2020-08-19,Kern,029,883053,28913,27142,189,27331,263
2020-08-19,Kings,031,150075,5840,5301,32,5333,59
2020-08-19,Lake,033,64148,313,277,0,277,2
2020-08-19,Lassen,035,31185,711,693,2,695,0
2020-08-19,Los Angeles,037,10098052,233068,226006,987,226993,5399
2020-08-19,Madera,039,155013,3698,3158,22,3180,30
2020-08-19,Marin,041,260295,5967,5723,13,5736,46
2020-08-19,Mariposa,043,17540,71,64,0,64,2
2020-08-19,Mendocino,045,87422,560,495,0,495,8
2020-08-19,Merced,047,269075,7540,7082,5,7087,66
2020-08-19,Modoc,049,8938,7,5,0,5,0
2020-08-19,Mono,051,14174,163,128,2,130,1
2020-08-19,Monterey,053,433212,7445,6693,21,6714,45
2020-08-19,Napa,055,140530,1408,1293,5,1298,10
2020-08-19,Nevada,057,99092,429,398,15,413,2
2020-08-19,Orange,059,3164182,48612,43938,1095,45033,829
2020-08-19,Placer,061,380077,2896,2659,6,2665,28
2020-08-19,Plumas,063,18699,39,36,0,36,0
2020-08-19,Riverside,065,2383286,51704,48741,54,48795,922
2020-08-19,Sacramento,067,1510023,17002,14764,15,14779,229
2020-08-19,San Benito,069,59416,993,853,0,853,3
2020-08-19,San Bernardino,071,2135413,47229,43224,266,43490,661
2020-08-19,San Diego,073,3302833,37398,35378,259,35637,638
2020-08-19,San Francisco,075,870044,9038,8236,9,8245,72
2020-08-19,San Joaquin,077,732212,17663,15677,30,15707,296
2020-08-19,San Luis Obispo,079,281455,2849,2553,16,2569,19
2020-08-19,San Mateo,081,765935,7996,7146,9,7155,119
2020-08-19,Santa Barbara,083,443738,7860,7499,69,7568,80
2020-08-19,Santa Clara,085,1922200,17085,14994,36,15030,189
2020-08-19,Santa Cruz,087,273765,1738,1554,15,1569,6
2020-08-19,Shasta,089,179085,593,475,3,478,9
2020-08-19,Sierra,091,2930,6,6,0,6,0
2020-08-19,Siskiyou,093,43540,121,103,1,104,0
2020-08-19,Solano,095,438530,5173,4807,32,4839,31
2020-08-19,Sonoma,097,501317,5323,4614,19,4633,54
2020-08-19,Stanislaus,099,539301,14444,13084,223,13307,160
2020-08-19,Sutter,101,95872,1233,1146,1,1147,8
2020-08-19,Tehama,103,63373,392,342,2,344,1
2020-08-19,Trinity,105,12862,43,8,6,14,0
2020-08-19,Tulare,107,460477,13859,12756,51,12807,217
2020-08-19,Tuolumne,109,53932,178,159,3,162,1
2020-08-19,Ventura,111,848112,10678,9587,67,9654,91
2020-08-19,Yolo,113,214977,2317,2126,4,2130,47
2020-08-19,Yuba,115,75493,767,701,3,704,1
2020-08-18,Alameda,001,1643700,17460,15627,119,15746,223
2020-08-18,Alpine,003,1148,2,2,0,2,0
2020-08-18,Amador,005,37829,262,215,0,215,9
2020-08-18,Butte,007,227075,1673,1491,18,1509,16
2020-08-18,Calaveras,009,45235,209,174,0,174,1
2020-08-18,Colusa,011,21464,434,415,0,415,5
2020-08-18,Contra Costa,013,1133247,13413,11689,41,11730,141
2020-08-18,Del Norte,015,27424,111,78,0,78,0
2020-08-18,El Dorado,017,186661,964,866,4,870,2
2020-08-18,Fresno,019,978130,26057,21798,269,22067,212
2020-08-18,Glenn,021,27897,425,407,0,407,2
2020-08-18,Humboldt,023,135768,353,315,1,316,4
2020-08-18,Imperial,025,180216,11023,8968,6,8974,189
2020-08-18,Inyo,027,18085,164,140,3,143,1
2020-08-18,Kern,029,883053,28760,26978,185,27163,263
2020-08-18,Kings,031,150075,5805,5269,31,5300,58
2020-08-18,Lake,033,64148,310,274,0,274,2
2020-08-18,Lassen,035,31185,711,693,2,695,0
2020-08-18,Los Angeles,037,10098052,231807,224218,950,225168,5339
2020-08-18,Madera,039,155013,3670,3125,22,3147,28
2020-08-18,Marin,041,260295,5937,5708,13,5721,47
2020-08-18,Mariposa,043,17540,71,61,0,61,2
2020-08-18,Mendocino,045,87422,551,468,0,468,8
2020-08-18,Merced,047,269075,7492,6940,5,6945,66
2020-08-18,Modoc,049,8938,7,5,0,5,0
2020-08-18,Mono,051,14174,162,129,2,131,1
2020-08-18,Monterey,053,433212,7353,6691,20,6711,44
2020-08-18,Napa,055,140530,1405,1274,5,1279,10
2020-08-18,Nevada,057,99092,422,389,15,404,2
2020-08-18,Orange,059,3164182,48387,43659,1080,44739,809
2020-08-18,Placer,061,380077,2870,2644,5,2649,28
2020-08-18,Plumas,063,18699,39,34,0,34,0
2020-08-18,Riverside,065,2383286,51372,48447,54,48501,917
2020-08-18,Sacramento,067,1510023,16772,14610,14,14624,222
2020-08-18,San Benito,069,59416,973,836,0,836,3
2020-08-18,San Bernardino,071,2135413,46948,42827,260,43087,648
2020-08-18,San Diego,073,3302833,37105,35164,227,35391,633
2020-08-18,San Francisco,075,870044,8952,8016,9,8025,72
2020-08-18,San Joaquin,077,732212,17547,15509,29,15538,290
2020-08-18,San Luis Obispo,079,281455,2824,2535,15,2550,18
2020-08-18,San Mateo,081,765935,7935,7074,9,7083,119
2020-08-18,Santa Barbara,083,443738,7818,7472,69,7541,81
2020-08-18,Santa Clara,085,1922200,16912,14786,35,14821,184
2020-08-18,Santa Cruz,087,273765,1725,1509,15,1524,6
2020-08-18,Shasta,089,179085,589,468,3,471,9
2020-08-18,Sierra,091,2930,6,6,0,6,0
2020-08-18,Siskiyou,093,43540,120,103,1,104,0
2020-08-18,Solano,095,438530,5146,4700,32,4732,31
2020-08-18,Sonoma,097,501317,5254,4506,19,4525,48
2020-08-18,Stanislaus,099,539301,14346,12935,207,13142,149
2020-08-18,Sutter,101,95872,1214,1126,1,1127,8
2020-08-18,Tehama,103,63373,382,333,2,335,1
2020-08-18,Trinity,105,12862,41,8,6,14,0
2020-08-18,Tulare,107,460477,13728,12637,48,12685,212
2020-08-18,Tuolumne,109,53932,175,159,3,162,1
2020-08-18,Ventura,111,848112,10588,9536,62,9598,89
2020-08-18,Yolo,113,214977,2295,2102,4,2106,47
2020-08-18,Yuba,115,75493,759,679,3,682,1
2020-08-17,Alameda,001,1643700,17267,15454,118,15572,221
2020-08-17,Alpine,003,1148,2,2,0,2,0
2020-08-17,Amador,005,37829,262,215,0,215,9
2020-08-17,Butte,007,227075,1628,1463,18,1481,15
2020-08-17,Calaveras,009,45235,205,167,0,167,1
2020-08-17,Colusa,011,21464,431,408,0,408,5
2020-08-17,Contra Costa,013,1133247,13276,11442,41,11483,141
2020-08-17,Del Norte,015,27424,107,77,0,77,0
2020-08-17,El Dorado,017,186661,961,846,4,850,2
2020-08-17,Fresno,019,978130,25849,21316,262,21578,211
2020-08-17,Glenn,021,27897,424,402,0,402,2
2020-08-17,Humboldt,023,135768,349,302,1,303,4
2020-08-17,Imperial,025,180216,10982,8897,6,8903,188
2020-08-17,Inyo,027,18085,156,124,3,127,1
2020-08-17,Kern,029,883053,28613,26773,174,26947,249
2020-08-17,Kings,031,150075,5767,5249,31,5280,58
2020-08-17,Lake,033,64148,305,270,0,270,2
2020-08-17,Lassen,035,31185,711,666,2,668,0
2020-08-17,Los Angeles,037,10098052,230288,223418,903,224321,5282
2020-08-17,Madera,039,155013,3627,3050,21,3071,26
2020-08-17,Marin,041,260295,5914,5683,12,5695,46
2020-08-17,Mariposa,043,17540,71,61,0,61,2
2020-08-17,Mendocino,045,87422,533,454,0,454,8
2020-08-17,Merced,047,269075,7397,6814,5,6819,66
2020-08-17,Modoc,049,8938,7,5,0,5,0
2020-08-17,Mono,051,14174,162,126,2,128,1
2020-08-17,Monterey,053,433212,7253,6553,20,6573,44
2020-08-17,Napa,055,140530,1384,1255,5,1260,10
2020-08-17,Nevada,057,99092,417,383,15,398,2
2020-08-17,Orange,059,3164182,48177,43621,1067,44688,804
2020-08-17,Placer,061,380077,2845,2609,5,2614,28
2020-08-17,Plumas,063,18699,39,33,0,33,0
2020-08-17,Riverside,065,2383286,51040,48062,52,48114,916
2020-08-17,Sacramento,067,1510023,16552,14333,14,14347,219
2020-08-17,San Benito,069,59416,958,822,0,822,2
2020-08-17,San Bernardino,071,2135413,46604,42005,252,42257,604
2020-08-17,San Diego,073,3302833,36839,34962,213,35175,626
2020-08-17,San Francisco,075,870044,8881,7600,9,7609,72
2020-08-17,San Joaquin,077,732212,17385,15323,28,15351,280
2020-08-17,San Luis Obispo,079,281455,2791,2527,15,2542,18
2020-08-17,San Mateo,081,765935,7878,6987,8,6995,118
2020-08-17,Santa Barbara,083,443738,7776,7438,69,7507,80
2020-08-17,Santa Clara,085,1922200,16690,14546,35,14581,183
2020-08-17,Santa Cruz,087,273765,1709,1453,14,1467,6
2020-08-17,Shasta,089,179085,583,467,3,470,9
2020-08-17,Sierra,091,2930,6,6,0,6,0
2020-08-17,Siskiyou,093,43540,119,103,0,103,0
2020-08-17,Solano,095,438530,5089,4479,32,4511,31
2020-08-17,Sonoma,097,501317,5166,4402,17,4419,48
2020-08-17,Stanislaus,099,539301,14221,12745,200,12945,148
2020-08-17,Sutter,101,95872,1198,1071,1,1072,8
2020-08-17,Tehama,103,63373,372,324,2,326,1
2020-08-17,Trinity,105,12862,41,8,6,14,0
2020-08-17,Tulare,107,460477,13615,12487,47,12534,210
2020-08-17,Tuolumne,109,53932,172,157,3,160,1
2020-08-17,Ventura,111,848112,10465,9490,57,9547,89
2020-08-17,Yolo,113,214977,2268,2083,4,2087,47
2020-08-17,Yuba,115,75493,744,647,3,650,1
2020-08-16,Alameda,001,1643700,16976,15338,118,15456,221
2020-08-16,Alpine,003,1148,2,2,0,2,0
2020-08-16,Amador,005,37829,259,215,0,215,9
2020-08-16,Butte,007,227075,1590,1432,18,1450,15
2020-08-16,Calaveras,009,45235,198,167,0,167,1
2020-08-16,Colusa,011,21464,429,407,0,407,5
2020-08-16,Contra Costa,013,1133247,13090,11255,41,11296,140
2020-08-16,Del Norte,015,27424,103,77,0,77,0
2020-08-16,El Dorado,017,186661,949,843,4,847,2
2020-08-16,Fresno,019,978130,25628,21010,257,21267,211
2020-08-16,Glenn,021,27897,422,400,0,400,2
2020-08-16,Humboldt,023,135768,347,301,1,302,4
2020-08-16,Imperial,025,180216,10938,8883,6,8889,188
2020-08-16,Inyo,027,18085,149,125,2,127,1
2020-08-16,Kern,029,883053,28414,26520,166,26686,249
2020-08-16,Kings,031,150075,5736,5146,31,5177,58
2020-08-16,Lake,033,64148,301,269,0,269,2
2020-08-16,Lassen,035,31185,711,666,2,668,0
2020-08-16,Los Angeles,037,10098052,228715,222236,873,223109,5263
2020-08-16,Madera,039,155013,3582,3013,21,3034,26
2020-08-16,Marin,041,260295,5888,5664,12,5676,46
2020-08-16,Mariposa,043,17540,71,61,0,61,2
2020-08-16,Mendocino,045,87422,525,451,0,451,8
2020-08-16,Merced,047,269075,7315,6744,5,6749,66
2020-08-16,Modoc,049,8938,7,5,0,5,0
2020-08-16,Mono,051,14174,162,126,2,128,1
2020-08-16,Monterey,053,433212,7155,6516,19,6535,44
2020-08-16,Napa,055,140530,1366,1241,3,1244,10
2020-08-16,Nevada,057,99092,408,379,15,394,2
2020-08-16,Orange,059,3164182,47928,43303,1056,44359,803
2020-08-16,Placer,061,380077,2816,2583,4,2587,28
2020-08-16,Plumas,063,18699,39,33,0,33,0
2020-08-16,Riverside,065,2383286,50709,47669,51,47720,910
2020-08-16,Sacramento,067,1510023,16312,14210,14,14224,219
2020-08-16,San Benito,069,59416,929,815,0,815,2
2020-08-16,San Bernardino,071,2135413,46180,41724,244,41968,603
2020-08-16,San Diego,073,3302833,36575,34680,198,34878,626
2020-08-16,San Francisco,075,870044,8794,7602,9,7611,72
2020-08-16,San Joaquin,077,732212,17182,15288,28,15316,280
2020-08-16,San Luis Obispo,079,281455,2762,2494,15,2509,17
2020-08-16,San Mateo,081,765935,7804,6942,8,6950,118
2020-08-16,Santa Barbara,083,443738,7727,7368,69,7437,79
2020-08-16,Santa Clara,085,1922200,16492,14329,35,14364,183
2020-08-16,Santa Cruz,087,273765,1682,1449,13,1462,6
2020-08-16,Shasta,089,179085,576,465,3,468,9
2020-08-16,Sierra,091,2930,6,6,0,6,0
2020-08-16,Siskiyou,093,43540,118,102,0,102,0
2020-08-16,Solano,095,438530,5029,4479,32,4511,31
2020-08-16,Sonoma,097,501317,5062,4329,17,4346,46
2020-08-16,Stanislaus,099,539301,14063,12668,190,12858,148
2020-08-16,Sutter,101,95872,1180,1071,1,1072,8
2020-08-16,Tehama,103,63373,363,318,2,320,1
2020-08-16,Trinity,105,12862,38,8,6,14,0
2020-08-16,Tulare,107,460477,13483,12334,44,12378,211
2020-08-16,Tuolumne,109,53932,172,156,3,159,1
2020-08-16,Ventura,111,848112,10356,9408,52,9460,89
2020-08-16,Yolo,113,214977,2249,2057,4,2061,47
2020-08-16,Yuba,115,75493,735,647,2,649,1
2020-08-15,Alameda,001,1643700,16899,15165,118,15283,221
2020-08-15,Alpine,003,1148,2,2,0,2,0
2020-08-15,Amador,005,37829,259,210,0,210,9
2020-08-15,Butte,007,227075,1568,1409,18,1427,15
2020-08-15,Calaveras,009,45235,196,167,0,167,1
2020-08-15,Colusa,011,21464,428,401,0,401,5
2020-08-15,Contra Costa,013,1133247,12994,11106,41,11147,138
2020-08-15,Del Norte,015,27424,103,77,0,77,0
2020-08-15,El Dorado,017,186661,944,838,4,842,2
2020-08-15,Fresno,019,978130,25512,20603,255,20858,211
2020-08-15,Glenn,021,27897,422,398,0,398,2
2020-08-15,Humboldt,023,135768,346,301,1,302,4
2020-08-15,Imperial,025,180216,10918,8794,6,8800,188
2020-08-15,Inyo,027,18085,149,123,2,125,1
2020-08-15,Kern,029,883053,28326,26338,166,26504,249
2020-08-15,Kings,031,150075,5718,5039,31,5070,56
2020-08-15,Lake,033,64148,299,268,0,268,2
2020-08-15,Lassen,035,31185,711,666,2,668,0
2020-08-15,Los Angeles,037,10098052,227965,221043,863,221906,5252
2020-08-15,Madera,039,155013,3532,2950,21,2971,26
2020-08-15,Marin,041,260295,5881,5628,12,5640,46
2020-08-15,Mariposa,043,17540,71,61,0,61,2
2020-08-15,Mendocino,045,87422,521,444,0,444,8
2020-08-15,Merced,047,269075,7281,6656,5,6661,66
2020-08-15,Modoc,049,8938,7,5,0,5,0
2020-08-15,Mono,051,14174,162,126,2,128,1
2020-08-15,Monterey,053,433212,7110,6162,19,6181,44
2020-08-15,Napa,055,140530,1356,1232,3,1235,10
2020-08-15,Nevada,057,99092,408,376,15,391,2
2020-08-15,Orange,059,3164182,47815,42811,1045,43856,801
2020-08-15,Placer,061,380077,2795,2551,4,2555,27
2020-08-15,Plumas,063,18699,39,33,0,33,0
2020-08-15,Riverside,065,2383286,50558,46720,51,46771,910
2020-08-15,Sacramento,067,1510023,16202,14018,14,14032,219
2020-08-15,San Benito,069,59416,916,805,0,805,2
2020-08-15,San Bernardino,071,2135413,46028,41231,242,41473,602
2020-08-15,San Diego,073,3302833,36409,34346,184,34530,639
2020-08-15,San Francisco,075,870044,8731,7601,9,7610,69
2020-08-15,San Joaquin,077,732212,17109,15113,28,15141,280
2020-08-15,San Luis Obispo,079,281455,2745,2461,15,2476,17
2020-08-15,San Mateo,081,765935,7767,6860,8,6868,118
2020-08-15,Santa Barbara,083,443738,7699,7338,69,7407,79
2020-08-15,Santa Clara,085,1922200,16396,14105,35,14140,183
2020-08-15,Santa Cruz,087,273765,1661,1449,13,1462,6
2020-08-15,Shasta,089,179085,573,458,3,461,9
2020-08-15,Sierra,091,2930,6,6,0,6,0
2020-08-15,Siskiyou,093,43540,117,100,0,100,0
2020-08-15,Solano,095,438530,5007,4477,32,4509,31
2020-08-15,Sonoma,097,501317,5007,4134,17,4151,45
2020-08-15,Stanislaus,099,539301,13999,12541,189,12730,149
2020-08-15,Sutter,101,95872,1169,1046,1,1047,8
2020-08-15,Tehama,103,63373,362,312,2,314,1
2020-08-15,Trinity,105,12862,36,6,6,12,0
2020-08-15,Tulare,107,460477,13445,12262,44,12306,211
2020-08-15,Tuolumne,109,53932,172,155,3,158,1
2020-08-15,Ventura,111,848112,10297,9379,50,9429,89
2020-08-15,Yolo,113,214977,2237,2031,4,2035,46
2020-08-15,Yuba,115,75493,731,623,2,625,1
2020-08-14,Alameda,001,1643700,16760,14909,118,15027,221
2020-08-14,Alpine,003,1148,2,2,0,2,0
2020-08-14,Amador,005,37829,259,209,0,209,9
2020-08-14,Butte,007,227075,1559,1384,18,1402,15
2020-08-14,Calaveras,009,45235,192,165,0,165,1
2020-08-14,Colusa,011,21464,426,399,0,399,5
2020-08-14,Contra Costa,013,1133247,12882,10893,41,10934,137
2020-08-14,Del Norte,015,27424,103,76,0,76,0
2020-08-14,El Dorado,017,186661,936,827,4,831,2
2020-08-14,Fresno,019,978130,25378,19900,255,20155,208
2020-08-14,Glenn,021,27897,420,395,0,395,2
2020-08-14,Humboldt,023,135768,340,294,1,295,4
2020-08-14,Imperial,025,180216,10894,8756,6,8762,185
2020-08-14,Inyo,027,18085,148,115,2,117,1
2020-08-14,Kern,029,883053,28222,25893,165,26058,249
2020-08-14,Kings,031,150075,5704,4953,31,4984,56
2020-08-14,Lake,033,64148,290,267,0,267,2
2020-08-14,Lassen,035,31185,711,665,2,667,0
2020-08-14,Los Angeles,037,10098052,226795,219083,846,219929,5222
2020-08-14,Madera,039,155013,3502,2876,21,2897,26
2020-08-14,Marin,041,260295,5870,5601,12,5613,46
2020-08-14,Mariposa,043,17540,70,61,0,61,2
2020-08-14,Mendocino,045,87422,512,432,0,432,8
2020-08-14,Merced,047,269075,7251,6466,5,6471,67
2020-08-14,Modoc,049,8938,7,5,0,5,0
2020-08-14,Mono,051,14174,162,126,2,128,1
2020-08-14,Monterey,053,433212,7059,6121,19,6140,41
2020-08-14,Napa,055,140530,1346,1230,3,1233,10
2020-08-14,Nevada,057,99092,404,377,15,392,2
2020-08-14,Orange,059,3164182,47665,42399,1032,43431,798
2020-08-14,Placer,061,380077,2776,2546,4,2550,26
2020-08-14,Plumas,063,18699,38,33,0,33,0
2020-08-14,Riverside,065,2383286,50329,46456,51,46507,891
2020-08-14,Sacramento,067,1510023,16053,13645,14,13659,212
2020-08-14,San Benito,069,59416,899,783,0,783,2
2020-08-14,San Bernardino,071,2135413,45841,40442,239,40681,594
2020-08-14,San Diego,073,3302833,36215,34067,177,34244,622
2020-08-14,San Francisco,075,870044,8672,7467,9,7476,69
2020-08-14,San Joaquin,077,732212,17009,14925,28,14953,276
2020-08-14,San Luis Obispo,079,281455,2730,2422,15,2437,17
2020-08-14,San Mateo,081,765935,7708,6655,8,6663,118
2020-08-14,Santa Barbara,083,443738,7649,7302,69,7371,77
2020-08-14,Santa Clara,085,1922200,16230,13785,34,13819,183
2020-08-14,Santa Cruz,087,273765,1639,1418,12,1430,6
2020-08-14,Shasta,089,179085,568,446,3,449,9
2020-08-14,Sierra,091,2930,6,5,0,5,0
2020-08-14,Siskiyou,093,43540,117,98,0,98,0
2020-08-14,Solano,095,438530,4986,4421,32,4453,31
2020-08-14,Sonoma,097,501317,4947,4087,14,4101,45
2020-08-14,Stanislaus,099,539301,13921,12379,185,12564,140
2020-08-14,Sutter,101,95872,1161,1039,1,1040,8
2020-08-14,Tehama,103,63373,357,305,2,307,1
2020-08-14,Trinity,105,12862,36,6,6,12,0
2020-08-14,Tulare,107,460477,13368,12009,44,12053,211
2020-08-14,Tuolumne,109,53932,171,155,3,158,1
2020-08-14,Ventura,111,848112,10222,9313,50,9363,89
2020-08-14,Yolo,113,214977,2223,1991,4,1995,45
2020-08-14,Yuba,115,75493,715,606,2,608,1
2020-08-13,Alameda,001,1643700,16482,14385,118,14503,218
2020-08-13,Alpine,003,1148,2,2,0,2,0
2020-08-13,Amador,005,37829,259,198,0,198,8
2020-08-13,Butte,007,227075,1534,1345,18,1363,15
2020-08-13,Calaveras,009,45235,190,162,0,162,1
2020-08-13,Colusa,011,21464,426,395,0,395,5
2020-08-13,Contra Costa,013,1133247,12728,10545,40,10585,136
2020-08-13,Del Norte,015,27424,102,74,0,74,0
2020-08-13,El Dorado,017,186661,931,803,4,807,2
2020-08-13,Fresno,019,978130,25151,19157,249,19406,201
2020-08-13,Glenn,021,27897,416,392,0,392,1
2020-08-13,Humboldt,023,135768,332,281,1,282,4
2020-08-13,Imperial,025,180216,10863,8640,6,8646,170
2020-08-13,Inyo,027,18085,144,97,2,99,1
2020-08-13,Kern,029,883053,28055,25472,162,25634,242
2020-08-13,Kings,031,150075,5669,4824,31,4855,52
2020-08-13,Lake,033,64148,285,263,0,263,2
2020-08-13,Lassen,035,31185,711,652,2,654,0
2020-08-13,Los Angeles,037,10098052,225415,216497,825,217322,5179
2020-08-13,Madera,039,155013,3458,2675,20,2695,25
2020-08-13,Marin,041,260295,5854,5503,12,5515,44
2020-08-13,Mariposa,043,17540,69,61,0,61,2
2020-08-13,Mendocino,045,87422,507,401,0,401,8
2020-08-13,Merced,047,269075,7134,5945,5,5950,63
2020-08-13,Modoc,049,8938,7,5,0,5,0
2020-08-13,Mono,051,14174,162,124,2,126,1
2020-08-13,Monterey,053,433212,6976,5925,19,5944,38
2020-08-13,Napa,055,140530,1337,1179,3,1182,10
2020-08-13,Nevada,057,99092,400,362,15,377,1
2020-08-13,Orange,059,3164182,47426,42019,1020,43039,773
2020-08-13,Placer,061,380077,2753,2460,4,2464,26
2020-08-13,Plumas,063,18699,38,32,0,32,0
2020-08-13,Riverside,065,2383286,50033,45327,51,45378,885
2020-08-13,Sacramento,067,1510023,15850,13237,14,13251,197
2020-08-13,San Benito,069,59416,870,757,0,757,2
2020-08-13,San Bernardino,071,2135413,45446,39395,233,39628,591
2020-08-13,San Diego,073,3302833,35979,33661,159,33820,627
2020-08-13,San Francisco,075,870044,8578,7277,9,7286,69
2020-08-13,San Joaquin,077,732212,16854,14537,27,14564,261
2020-08-13,San Luis Obispo,079,281455,2708,2283,15,2298,16
2020-08-13,San Mateo,081,765935,7646,6503,8,6511,117
2020-08-13,Santa Barbara,083,443738,7604,7129,68,7197,74
2020-08-13,Santa Clara,085,1922200,16007,13257,34,13291,182
2020-08-13,Santa Cruz,087,273765,1614,1383,12,1395,6
2020-08-13,Shasta,089,179085,563,428,3,431,9
2020-08-13,Sierra,091,2930,6,5,0,5,0
2020-08-13,Siskiyou,093,43540,117,95,0,95,0
2020-08-13,Solano,095,438530,4949,4305,32,4337,31
2020-08-13,Sonoma,097,501317,4873,3902,14,3916,45
2020-08-13,Stanislaus,099,539301,13791,11953,169,12122,136
2020-08-13,Sutter,101,95872,1139,992,1,993,8
2020-08-13,Tehama,103,63373,348,302,2,304,1
2020-08-13,Trinity,105,12862,35,6,6,12,0
2020-08-13,Tulare,107,460477,13224,11692,41,11733,210
2020-08-13,Tuolumne,109,53932,170,152,3,155,1
2020-08-13,Ventura,111,848112,10133,9114,50,9164,90
2020-08-13,Yolo,113,214977,2196,1938,4,1942,44
2020-08-13,Yuba,115,75493,699,568,2,570,1
2020-08-12,Alameda,001,1643700,16268,14214,118,14332,215
2020-08-12,Alpine,003,1148,2,2,0,2,0
2020-08-12,Amador,005,37829,256,197,0,197,8
2020-08-12,Butte,007,227075,1506,1317,18,1335,15
2020-08-12,Calaveras,009,45235,187,157,0,157,1
2020-08-12,Colusa,011,21464,421,394,0,394,5
2020-08-12,Contra Costa,013,1133247,12583,10304,39,10343,134
2020-08-12,Del Norte,015,27424,101,74,0,74,0
2020-08-12,El Dorado,017,186661,913,794,4,798,2
2020-08-12,Fresno,019,978130,24921,18690,243,18933,194
2020-08-12,Glenn,021,27897,413,388,0,388,1
2020-08-12,Humboldt,023,135768,325,281,1,282,4
2020-08-12,Imperial,025,180216,10840,8566,6,8572,167
2020-08-12,Inyo,027,18085,127,97,2,99,1
2020-08-12,Kern,029,883053,27863,25191,160,25351,232
2020-08-12,Kings,031,150075,5630,4736,31,4767,50
2020-08-12,Lake,033,64148,283,253,0,253,2
2020-08-12,Lassen,035,31185,710,651,2,653,0
2020-08-12,Los Angeles,037,10098052,224014,214542,809,215351,5119
2020-08-12,Madera,039,155013,3424,2681,18,2699,23
2020-08-12,Marin,041,260295,5832,5423,12,5435,44
2020-08-12,Mariposa,043,17540,69,61,0,61,2
2020-08-12,Mendocino,045,87422,488,386,0,386,9
2020-08-12,Merced,047,269075,7072,5777,5,5782,66
2020-08-12,Modoc,049,8938,7,5,0,5,0
2020-08-12,Mono,051,14174,161,124,2,126,1
2020-08-12,Monterey,053,433212,6872,5919,19,5938,38
2020-08-12,Napa,055,140530,1327,1161,3,1164,10
2020-08-12,Nevada,057,99092,395,357,15,372,1
2020-08-12,Orange,059,3164182,47175,41576,996,42572,754
2020-08-12,Placer,061,380077,2721,2417,4,2421,25
2020-08-12,Plumas,063,18699,38,31,0,31,0
2020-08-12,Riverside,065,2383286,49685,44747,51,44798,867
2020-08-12,Sacramento,067,1510023,15638,12528,14,12542,189
2020-08-12,San Benito,069,59416,857,751,0,751,2
2020-08-12,San Bernardino,071,2135413,45103,38811,224,39035,589
2020-08-12,San Diego,073,3302833,35770,33395,139,33534,608
2020-08-12,San Francisco,075,870044,8495,7194,9,7203,66
2020-08-12,San Joaquin,077,732212,16708,14154,27,14181,253
2020-08-12,San Luis Obispo,079,281455,2683,2263,15,2278,15
2020-08-12,San Mateo,081,765935,7567,6427,8,6435,117
2020-08-12,Santa Barbara,083,443738,7544,7049,66,7115,74
2020-08-12,Santa Clara,085,1922200,15831,13002,34,13036,182
2020-08-12,Santa Cruz,087,273765,1585,1382,11,1393,6
2020-08-12,Shasta,089,179085,559,417,3,420,9
2020-08-12,Sierra,091,2930,5,4,0,4,0
2020-08-12,Siskiyou,093,43540,116,90,0,90,0
2020-08-12,Solano,095,438530,4904,4258,32,4290,31
2020-08-12,Sonoma,097,501317,4799,3847,14,3861,47
2020-08-12,Stanislaus,099,539301,13652,11682,161,11843,136
2020-08-12,Sutter,101,95872,1115,987,1,988,7
2020-08-12,Tehama,103,63373,338,289,2,291,1
2020-08-12,Trinity,105,12862,34,6,6,12,0
2020-08-12,Tulare,107,460477,13096,11460,41,11501,211
2020-08-12,Tuolumne,109,53932,169,150,3,153,1
2020-08-12,Ventura,111,848112,10046,9005,50,9055,87
2020-08-12,Yolo,113,214977,2172,1921,4,1925,44
2020-08-12,Yuba,115,75493,677,549,1,550,1
2020-08-11,Alameda,001,1643700,16007,13960,115,14075,204
2020-08-11,Alpine,003,1148,2,2,0,2,0
2020-08-11,Amador,005,37829,250,187,0,187,3
2020-08-11,Butte,007,227075,1479,1296,18,1314,15
2020-08-11,Calaveras,009,45235,185,161,0,161,1
2020-08-11,Colusa,011,21464,416,390,0,390,5
2020-08-11,Contra Costa,013,1133247,12394,10012,37,10049,131
2020-08-11,Del Norte,015,27424,100,73,0,73,0
2020-08-11,El Dorado,017,186661,906,786,4,790,2
2020-08-11,Fresno,019,978130,24599,18344,240,18584,187
2020-08-11,Glenn,021,27897,411,380,0,380,1
2020-08-11,Humboldt,023,135768,320,283,1,284,4
2020-08-11,Imperial,025,180216,10785,8518,6,8524,165
2020-08-11,Inyo,027,18085,122,97,2,99,1
2020-08-11,Kern,029,883053,27528,25042,158,25200,230
2020-08-11,Kings,031,150075,5439,4696,31,4727,50
2020-08-11,Lake,033,64148,280,243,0,243,2
2020-08-11,Lassen,035,31185,704,605,2,607,0
2020-08-11,Los Angeles,037,10098052,222513,212421,785,213206,5065
2020-08-11,Madera,039,155013,3370,2673,18,2691,22
2020-08-11,Marin,041,260295,5805,5287,11,5298,44
2020-08-11,Mariposa,043,17540,68,60,0,60,2
2020-08-11,Mendocino,045,87422,478,385,0,385,9
2020-08-11,Merced,047,269075,6977,5322,4,5326,65
2020-08-11,Modoc,049,8938,7,5,0,5,0
2020-08-11,Mono,051,14174,161,124,2,126,1
2020-08-11,Monterey,053,433212,6763,5624,19,5643,36
2020-08-11,Napa,055,140530,1316,1143,2,1145,11
2020-08-11,Nevada,057,99092,392,358,15,373,1
2020-08-11,Orange,059,3164182,46955,41205,974,42179,742
2020-08-11,Placer,061,380077,2689,2393,4,2397,24
2020-08-11,Plumas,063,18699,38,31,0,31,0
2020-08-11,Riverside,065,2383286,49328,44237,51,44288,836
2020-08-11,Sacramento,067,1510023,15347,12298,14,12312,182
2020-08-11,San Benito,069,59416,845,750,0,750,2
2020-08-11,San Bernardino,071,2135413,44762,38467,217,38684,584
2020-08-11,San Diego,073,3302833,35503,33159,120,33279,602
2020-08-11,San Francisco,075,870044,8399,6988,9,6997,66
2020-08-11,San Joaquin,077,732212,16530,13997,22,14019,251
2020-08-11,San Luis Obispo,079,281455,2626,2234,15,2249,15
2020-08-11,San Mateo,081,765935,7493,6339,8,6347,117
2020-08-11,Santa Barbara,083,443738,7495,6942,66,7008,70
2020-08-11,Santa Clara,085,1922200,15610,12920,34,12954,183
2020-08-11,Santa Cruz,087,273765,1562,1352,11,1363,4
2020-08-11,Shasta,089,179085,555,416,3,419,9
2020-08-11,Sierra,091,2930,5,4,0,4,0
2020-08-11,Siskiyou,093,43540,116,90,0,90,0
2020-08-11,Solano,095,438530,4856,4206,31,4237,31
2020-08-11,Sonoma,097,501317,4704,3752,14,3766,45
2020-08-11,Stanislaus,099,539301,13548,11592,149,11741,128
2020-08-11,Sutter,101,95872,1093,964,1,965,7
2020-08-11,Tehama,103,63373,334,289,2,291,1
2020-08-11,Trinity,105,12862,34,5,6,11,0
2020-08-11,Tulare,107,460477,12971,11392,40,11432,201
2020-08-11,Tuolumne,109,53932,164,146,3,149,1
2020-08-11,Ventura,111,848112,9978,8953,49,9002,88
2020-08-11,Yolo,113,214977,2150,1912,4,1916,44
2020-08-11,Yuba,115,75493,666,540,1,541,1
2020-08-10,Alameda,001,1643700,15767,13420,114,13534,203
2020-08-10,Alpine,003,1148,2,2,0,2,0
2020-08-10,Amador,005,37829,249,172,0,172,2
2020-08-10,Butte,007,227075,1455,1174,16,1190,15
2020-08-10,Calaveras,009,45235,174,121,0,121,1
2020-08-10,Colusa,011,21464,414,387,0,387,4
2020-08-10,Contra Costa,013,1133247,12241,9454,35,9489,130
2020-08-10,Del Norte,015,27424,98,69,0,69,0
2020-08-10,El Dorado,017,186661,894,771,4,775,2
2020-08-10,Fresno,019,978130,24318,17978,239,18217,183
2020-08-10,Glenn,021,27897,408,381,0,381,1
2020-08-10,Humboldt,023,135768,314,277,1,278,4
2020-08-10,Imperial,025,180216,10741,8465,6,8471,165
2020-08-10,Inyo,027,18085,122,97,2,99,1
2020-08-10,Kern,029,883053,27302,24499,157,24656,215
2020-08-10,Kings,031,150075,5333,4588,31,4619,50
2020-08-10,Lake,033,64148,273,239,0,239,2
2020-08-10,Lassen,035,31185,704,588,2,590,0
2020-08-10,Los Angeles,037,10098052,220936,211035,767,211802,5003
2020-08-10,Madera,039,155013,3337,2365,17,2382,22
2020-08-10,Marin,041,260295,5760,5242,10,5252,44
2020-08-10,Mariposa,043,17540,68,57,0,57,2
2020-08-10,Mendocino,045,87422,454,364,0,364,1
2020-08-10,Merced,047,269075,6896,4913,4,4917,51
2020-08-10,Modoc,049,8938,7,5,0,5,0
2020-08-10,Mono,051,14174,161,123,2,125,1
2020-08-10,Monterey,053,433212,6653,5358,19,5377,34
2020-08-10,Napa,055,140530,1298,1084,2,1086,8
2020-08-10,Nevada,057,99092,384,356,15,371,1
2020-08-10,Orange,059,3164182,46685,40445,956,41401,721
2020-08-10,Placer,061,380077,2650,2298,4,2302,21
2020-08-10,Plumas,063,18699,38,27,0,27,0
2020-08-10,Riverside,065,2383286,48943,43296,50,43346,830
2020-08-10,Sacramento,067,1510023,15036,12059,14,12073,168
2020-08-10,San Benito,069,59416,832,743,0,743,2
2020-08-10,San Bernardino,071,2135413,44385,37367,208,37575,579
2020-08-10,San Diego,073,3302833,35237,32977,104,33081,594
2020-08-10,San Francisco,075,870044,8309,6816,8,6824,66
2020-08-10,San Joaquin,077,732212,16348,13308,22,13330,240
2020-08-10,San Luis Obispo,079,281455,2527,2208,14,2222,15
2020-08-10,San Mateo,081,765935,7416,6222,8,6230,117
2020-08-10,Santa Barbara,083,443738,7440,6869,66,6935,66
2020-08-10,Santa Clara,085,1922200,15350,12615,33,12648,182
2020-08-10,Santa Cruz,087,273765,1542,1239,10,1249,4
2020-08-10,Shasta,089,179085,551,384,3,387,9
2020-08-10,Sierra,091,2930,5,3,0,3,0
2020-08-10,Siskiyou,093,43540,113,88,0,88,0
2020-08-10,Solano,095,438530,4796,4101,31,4132,31
2020-08-10,Sonoma,097,501317,4535,3640,10,3650,42
2020-08-10,Stanislaus,099,539301,13366,10855,132,10987,106
2020-08-10,Sutter,101,95872,1068,865,1,866,7
2020-08-10,Tehama,103,63373,327,282,2,284,1
2020-08-10,Trinity,105,12862,31,5,6,11,0
2020-08-10,Tulare,107,460477,12798,10750,38,10788,194
2020-08-10,Tuolumne,109,53932,164,143,2,145,1
2020-08-10,Ventura,111,848112,9894,8851,48,8899,85
2020-08-10,Yolo,113,214977,2127,1840,4,1844,45
2020-08-10,Yuba,115,75493,649,527,1,528,1
2020-08-09,Alameda,001,1643700,15487,13241,112,13353,203
2020-08-09,Alpine,003,1148,2,2,0,2,0
2020-08-09,Amador,005,37829,244,153,0,153,2
2020-08-09,Butte,007,227075,1411,1155,16,1171,15
2020-08-09,Calaveras,009,45235,169,122,0,122,1
2020-08-09,Colusa,011,21464,410,371,0,371,4
2020-08-09,Contra Costa,013,1133247,12014,9214,34,9248,130
2020-08-09,Del Norte,015,27424,98,69,0,69,0
2020-08-09,El Dorado,017,186661,886,748,4,752,2
2020-08-09,Fresno,019,978130,24009,17846,235,18081,183
2020-08-09,Glenn,021,27897,406,354,0,354,1
2020-08-09,Humboldt,023,135768,308,279,1,280,4
2020-08-09,Imperial,025,180216,10698,8310,5,8315,165
2020-08-09,Inyo,027,18085,117,86,1,87,1
2020-08-09,Kern,029,883053,27046,23680,157,23837,215
2020-08-09,Kings,031,150075,5290,4446,30,4476,50
2020-08-09,Lake,033,64148,266,225,0,225,2
2020-08-09,Lassen,035,31185,698,589,2,591,0
2020-08-09,Los Angeles,037,10098052,218874,208810,745,209555,4984
2020-08-09,Madera,039,155013,3278,2322,13,2335,22
2020-08-09,Marin,041,260295,5717,5204,10,5214,44
2020-08-09,Mariposa,043,17540,66,56,0,56,2
2020-08-09,Mendocino,045,87422,444,283,0,283,1
2020-08-09,Merced,047,269075,6799,4735,3,4738,51
2020-08-09,Modoc,049,8938,7,4,0,4,0
2020-08-09,Mono,051,14174,160,113,2,115,1
2020-08-09,Monterey,053,433212,6529,5199,19,5218,34
2020-08-09,Napa,055,140530,1279,1062,2,1064,8
2020-08-09,Nevada,057,99092,376,332,15,347,1
2020-08-09,Orange,059,3164182,46386,39244,941,40185,722
2020-08-09,Placer,061,380077,2621,2211,4,2215,20
2020-08-09,Plumas,063,18699,38,27,0,27,0
2020-08-09,Riverside,065,2383286,48598,41894,50,41944,828
2020-08-09,Sacramento,067,1510023,14756,11301,14,11315,167
2020-08-09,San Benito,069,59416,813,687,0,687,2
2020-08-09,San Bernardino,071,2135413,43907,36092,208,36300,579
2020-08-09,San Diego,073,3302833,34946,32749,93,32842,594
2020-08-09,San Francisco,075,870044,8194,6820,8,6828,66
2020-08-09,San Joaquin,077,732212,16144,12933,21,12954,240
2020-08-09,San Luis Obispo,079,281455,2491,2124,14,2138,15
2020-08-09,San Mateo,081,765935,7321,6094,8,6102,117
2020-08-09,Santa Barbara,083,443738,7352,6669,66,6735,66
2020-08-09,Santa Clara,085,1922200,15080,11878,33,11911,181
2020-08-09,Santa Cruz,087,273765,1518,1246,10,1256,4
2020-08-09,Shasta,089,179085,547,361,3,364,9
2020-08-09,Sierra,091,2930,5,3,0,3,0
2020-08-09,Siskiyou,093,43540,112,74,0,74,0
2020-08-09,Solano,095,438530,4743,3954,30,3984,31
2020-08-09,Sonoma,097,501317,4399,3531,8,3539,41
2020-08-09,Stanislaus,099,539301,13158,10264,119,10383,106
2020-08-09,Sutter,101,95872,1034,857,1,858,7
2020-08-09,Tehama,103,63373,319,265,2,267,1
2020-08-09,Trinity,105,12862,31,5,6,11,0
2020-08-09,Tulare,107,460477,12607,10630,35,10665,194
2020-08-09,Tuolumne,109,53932,161,143,2,145,1
2020-08-09,Ventura,111,848112,9746,8633,47,8680,85
2020-08-09,Yolo,113,214977,2096,1765,4,1769,44
2020-08-09,Yuba,115,75493,629,442,1,443,1
2020-08-08,Alameda,001,1643700,15377,13087,112,13199,204
2020-08-08,Alpine,003,1148,2,2,0,2,0
2020-08-08,Amador,005,37829,244,139,0,139,2
2020-08-08,Butte,007,227075,1393,1140,16,1156,15
2020-08-08,Calaveras,009,45235,168,122,0,122,1
2020-08-08,Colusa,011,21464,409,368,0,368,4
2020-08-08,Contra Costa,013,1133247,11905,9104,34,9138,129
2020-08-08,Del Norte,015,27424,97,69,0,69,0
2020-08-08,El Dorado,017,186661,879,734,4,738,2
2020-08-08,Fresno,019,978130,23872,17538,233,17771,183
2020-08-08,Glenn,021,27897,406,344,0,344,1
2020-08-08,Humboldt,023,135768,305,277,1,278,4
2020-08-08,Imperial,025,180216,10683,8213,5,8218,165
2020-08-08,Inyo,027,18085,113,86,1,87,1
2020-08-08,Kern,029,883053,26932,22803,157,22960,215
2020-08-08,Kings,031,150075,5276,4367,30,4397,49
2020-08-08,Lake,033,64148,264,221,0,221,2
2020-08-08,Lassen,035,31185,698,589,2,591,0
2020-08-08,Los Angeles,037,10098052,217989,206971,734,207705,4974
2020-08-08,Madera,039,155013,3247,2275,13,2288,22
2020-08-08,Marin,041,260295,5697,5118,10,5128,44
2020-08-08,Mariposa,043,17540,65,55,0,55,2
2020-08-08,Mendocino,045,87422,442,264,0,264,1
2020-08-08,Merced,047,269075,6759,4570,3,4573,51
2020-08-08,Modoc,049,8938,7,4,0,4,0
2020-08-08,Mono,051,14174,160,113,2,115,1
2020-08-08,Monterey,053,433212,6471,5101,19,5120,33
2020-08-08,Napa,055,140530,1271,1062,2,1064,8
2020-08-08,Nevada,057,99092,374,325,15,340,1
2020-08-08,Orange,059,3164182,46256,38688,932,39620,718
2020-08-08,Placer,061,380077,2604,2153,4,2157,20
2020-08-08,Plumas,063,18699,38,27,0,27,0
2020-08-08,Riverside,065,2383286,48394,41412,50,41462,823
2020-08-08,Sacramento,067,1510023,14627,11144,14,11158,166
2020-08-08,San Benito,069,59416,805,684,0,684,2
2020-08-08,San Bernardino,071,2135413,43711,35691,207,35898,531
2020-08-08,San Diego,073,3302833,34757,32332,84,32416,593
2020-08-08,San Francisco,075,870044,8128,6820,8,6828,66
2020-08-08,San Joaquin,077,732212,16063,12559,20,12579,240
2020-08-08,San Luis Obispo,079,281455,2468,2081,14,2095,15
2020-08-08,San Mateo,081,765935,7263,6021,8,6029,117
2020-08-08,Santa Barbara,083,443738,7314,6598,66,6664,66
2020-08-08,Santa Clara,085,1922200,14928,11615,33,11648,181
2020-08-08,Santa Cruz,087,273765,1504,1247,10,1257,4
2020-08-08,Shasta,089,179085,545,343,3,346,9
2020-08-08,Sierra,091,2930,5,3,0,3,0
2020-08-08,Siskiyou,093,43540,112,73,0,73,0
2020-08-08,Solano,095,438530,4722,3889,29,3918,31
2020-08-08,Sonoma,097,501317,4368,3399,8,3407,41
2020-08-08,Stanislaus,099,539301,13083,9963,114,10077,105
2020-08-08,Sutter,101,95872,1024,830,1,831,7
2020-08-08,Tehama,103,63373,318,251,2,253,1
2020-08-08,Trinity,105,12862,31,5,6,11,0
2020-08-08,Tulare,107,460477,12532,10505,35,10540,192
2020-08-08,Tuolumne,109,53932,161,143,2,145,1
2020-08-08,Ventura,111,848112,9691,8462,46,8508,85
2020-08-08,Yolo,113,214977,2083,1725,4,1729,44
2020-08-08,Yuba,115,75493,620,430,1,431,1
2020-08-07,Alameda,001,1643700,15267,12805,112,12917,204
2020-08-07,Alpine,003,1148,2,2,0,2,0
2020-08-07,Amador,005,37829,242,125,0,125,2
2020-08-07,Butte,007,227075,1375,1092,16,1108,13
2020-08-07,Calaveras,009,45235,168,119,0,119,1
2020-08-07,Colusa,011,21464,408,358,0,358,4
2020-08-07,Contra Costa,013,1133247,11757,8810,34,8844,126
2020-08-07,Del Norte,015,27424,97,69,0,69,0
2020-08-07,El Dorado,017,186661,874,724,4,728,2
2020-08-07,Fresno,019,978130,23712,17290,233,17523,171
2020-08-07,Glenn,021,27897,405,339,0,339,1
2020-08-07,Humboldt,023,135768,301,274,1,275,4
2020-08-07,Imperial,025,180216,10658,8085,5,8090,164
2020-08-07,Inyo,027,18085,112,81,1,82,1
2020-08-07,Kern,029,883053,26806,22143,154,22297,206
2020-08-07,Kings,031,150075,5259,4315,30,4345,48
2020-08-07,Lake,033,64148,262,215,0,215,1
2020-08-07,Lassen,035,31185,697,588,2,590,0
2020-08-07,Los Angeles,037,10098052,216522,204406,722,205128,4924
2020-08-07,Madera,039,155013,3215,2245,13,2258,20
2020-08-07,Marin,041,260295,5668,5094,10,5104,43
2020-08-07,Mariposa,043,17540,65,53,0,53,2
2020-08-07,Mendocino,045,87422,428,262,0,262,1
2020-08-07,Merced,047,269075,6716,4358,3,4361,30
2020-08-07,Modoc,049,8938,7,4,0,4,0
2020-08-07,Mono,051,14174,160,112,2,114,1
2020-08-07,Monterey,053,433212,6396,5041,19,5060,33
2020-08-07,Napa,055,140530,1266,1055,2,1057,8
2020-08-07,Nevada,057,99092,371,324,15,339,1
2020-08-07,Orange,059,3164182,46044,38459,915,39374,701
2020-08-07,Placer,061,380077,2586,2078,4,2082,20
2020-08-07,Plumas,063,18699,38,25,0,25,0
2020-08-07,Riverside,065,2383286,48130,40902,49,40951,810
2020-08-07,Sacramento,067,1510023,14482,10798,14,10812,160
2020-08-07,San Benito,069,59416,799,647,0,647,2
2020-08-07,San Bernardino,071,2135413,43464,35200,206,35406,524
2020-08-07,San Diego,073,3302833,34572,31781,81,31862,586
2020-08-07,San Francisco,075,870044,8050,6765,8,6773,66
2020-08-07,San Joaquin,077,732212,15978,12392,20,12412,223
2020-08-07,San Luis Obispo,079,281455,2437,2050,14,2064,14
2020-08-07,San Mateo,081,765935,7203,5948,8,5956,117
2020-08-07,Santa Barbara,083,443738,7263,6509,66,6575,66
2020-08-07,Santa Clara,085,1922200,14729,11409,33,11442,180
2020-08-07,Santa Cruz,087,273765,1486,1234,10,1244,5
2020-08-07,Shasta,089,179085,540,342,3,345,9
2020-08-07,Sierra,091,2930,5,3,0,3,0
2020-08-07,Siskiyou,093,43540,109,73,0,73,0
2020-08-07,Solano,095,438530,4690,3844,28,3872,31
2020-08-07,Sonoma,097,501317,4304,3329,8,3337,34
2020-08-07,Stanislaus,099,539301,12961,9665,104,9769,98
2020-08-07,Sutter,101,95872,1020,807,1,808,6
2020-08-07,Tehama,103,63373,314,246,2,248,1
2020-08-07,Trinity,105,12862,30,5,6,11,0
2020-08-07,Tulare,107,460477,12455,10292,35,10327,195
2020-08-07,Tuolumne,109,53932,160,136,2,138,1
2020-08-07,Ventura,111,848112,9631,8356,44,8400,84
2020-08-07,Yolo,113,214977,2056,1689,4,1693,37
2020-08-07,Yuba,115,75493,615,413,1,414,1
2020-08-06,Alameda,001,1643700,15045,12474,111,12585,200
2020-08-06,Alpine,003,1148,2,2,0,2,0
2020-08-06,Amador,005,37829,228,125,0,125,0
2020-08-06,Butte,007,227075,1356,1060,16,1076,13
2020-08-06,Calaveras,009,45235,166,117,0,117,1
2020-08-06,Colusa,011,21464,405,358,0,358,3
2020-08-06,Contra Costa,013,1133247,11563,8583,33,8616,124
2020-08-06,Del Norte,015,27424,97,69,0,69,0
2020-08-06,El Dorado,017,186661,863,703,4,707,1
2020-08-06,Fresno,019,978130,23414,17031,226,17257,161
2020-08-06,Glenn,021,27897,400,332,0,332,1
2020-08-06,Humboldt,023,135768,296,266,1,267,4
2020-08-06,Imperial,025,180216,10615,8064,5,8069,163
2020-08-06,Inyo,027,18085,104,83,1,84,1
2020-08-06,Kern,029,883053,26570,21843,153,21996,197
2020-08-06,Kings,031,150075,5197,4264,29,4293,47
2020-08-06,Lake,033,64148,259,209,0,209,1
2020-08-06,Lassen,035,31185,695,588,2,590,0
2020-08-06,Los Angeles,037,10098052,214450,201372,706,202078,4874
2020-08-06,Madera,039,155013,3167,2240,12,2252,19
2020-08-06,Marin,041,260295,5636,5058,10,5068,43
2020-08-06,Mariposa,043,17540,64,52,0,52,2
2020-08-06,Mendocino,045,87422,414,260,0,260,1
2020-08-06,Merced,047,269075,6614,4235,3,4238,30
2020-08-06,Modoc,049,8938,7,4,0,4,0
2020-08-06,Mono,051,14174,159,111,2,113,1
2020-08-06,Monterey,053,433212,6287,5001,18,5019,33
2020-08-06,Napa,055,140530,1252,1032,2,1034,8
2020-08-06,Nevada,057,99092,366,321,15,336,1
2020-08-06,Orange,059,3164182,45752,38399,910,39309,694
2020-08-06,Placer,061,380077,2560,2045,4,2049,20
2020-08-06,Plumas,063,18699,37,25,0,25,0
2020-08-06,Riverside,065,2383286,47736,40269,49,40318,781
2020-08-06,Sacramento,067,1510023,14253,10548,14,10562,153
2020-08-06,San Benito,069,59416,791,626,0,626,2
2020-08-06,San Bernardino,071,2135413,43059,34819,204,35023,516
2020-08-06,San Diego,073,3302833,34305,31129,74,31203,583
2020-08-06,San Francisco,075,870044,7957,6737,7,6744,60
2020-08-06,San Joaquin,077,732212,15818,12269,20,12289,203
2020-08-06,San Luis Obispo,079,281455,2413,2000,13,2013,13
2020-08-06,San Mateo,081,765935,7103,5885,8,5893,117
2020-08-06,Santa Barbara,083,443738,7203,6620,66,6686,65
2020-08-06,Santa Clara,085,1922200,14500,11280,33,11313,178
2020-08-06,Santa Cruz,087,273765,1465,1215,10,1225,4
2020-08-06,Shasta,089,179085,531,343,3,346,9
2020-08-06,Sierra,091,2930,5,3,0,3,0
2020-08-06,Siskiyou,093,43540,109,73,0,73,0
2020-08-06,Solano,095,438530,4646,3784,28,3812,29
2020-08-06,Sonoma,097,501317,4240,3259,8,3267,33
2020-08-06,Stanislaus,099,539301,12811,9566,88,9654,98
2020-08-06,Sutter,101,95872,989,797,1,798,6
2020-08-06,Tehama,103,63373,311,242,2,244,1
2020-08-06,Trinity,105,12862,27,5,6,11,0
2020-08-06,Tulare,107,460477,12295,10169,35,10204,195
2020-08-06,Tuolumne,109,53932,159,136,2,138,1
2020-08-06,Ventura,111,848112,9516,8245,41,8286,80
2020-08-06,Yolo,113,214977,2032,1662,4,1666,36
2020-08-06,Yuba,115,75493,606,407,0,407,1
2020-08-05,Alameda,001,1643700,14831,12140,111,12251,193
2020-08-05,Alpine,003,1148,2,2,0,2,0
2020-08-05,Amador,005,37829,218,123,0,123,0
2020-08-05,Butte,007,227075,1322,1038,15,1053,13
2020-08-05,Calaveras,009,45235,163,116,0,116,1
2020-08-05,Colusa,011,21464,401,354,0,354,3
2020-08-05,Contra Costa,013,1133247,11394,8362,33,8395,122
2020-08-05,Del Norte,015,27424,96,69,0,69,0
2020-08-05,El Dorado,017,186661,855,692,4,696,1
2020-08-05,Fresno,019,978130,23170,16625,221,16846,159
2020-08-05,Glenn,021,27897,397,330,0,330,1
2020-08-05,Humboldt,023,135768,294,249,1,250,4
2020-08-05,Imperial,025,180216,10580,8036,5,8041,163
2020-08-05,Inyo,027,18085,102,62,1,63,1
2020-08-05,Kern,029,883053,26382,21540,148,21688,194
2020-08-05,Kings,031,150075,5152,4192,27,4219,47
2020-08-05,Lake,033,64148,252,209,0,209,1
2020-08-05,Lassen,035,31185,648,557,2,559,0
2020-08-05,Los Angeles,037,10098052,212530,198355,686,199041,4832
2020-08-05,Madera,039,155013,3125,2172,12,2184,19
2020-08-05,Marin,041,260295,5604,5036,10,5046,43
2020-08-05,Mariposa,043,17540,64,52,0,52,2
2020-08-05,Mendocino,045,87422,402,248,0,248,1
2020-08-05,Merced,047,269075,6479,4119,3,4122,30
2020-08-05,Modoc,049,8938,7,3,0,3,0
2020-08-05,Mono,051,14174,159,104,2,106,1
2020-08-05,Monterey,053,433212,6172,4936,18,4954,32
2020-08-05,Napa,055,140530,1240,1020,2,1022,8
2020-08-05,Nevada,057,99092,357,327,15,342,2
2020-08-05,Orange,059,3164182,45443,37907,902,38809,663
2020-08-05,Placer,061,380077,2519,1989,4,1993,18
2020-08-05,Plumas,063,18699,36,25,0,25,0
2020-08-05,Riverside,065,2383286,47344,39454,47,39501,761
2020-08-05,Sacramento,067,1510023,14034,10261,13,10274,151
2020-08-05,San Benito,069,59416,782,613,0,613,2
2020-08-05,San Bernardino,071,2135413,42597,34442,199,34641,504
2020-08-05,San Diego,073,3302833,34081,30866,58,30924,578
2020-08-05,San Francisco,075,870044,7864,6701,7,6708,60
2020-08-05,San Joaquin,077,732212,15655,12148,20,12168,199
2020-08-05,San Luis Obispo,079,281455,2389,1928,13,1941,13
2020-08-05,San Mateo,081,765935,7007,5695,8,5703,116
2020-08-05,Santa Barbara,083,443738,7143,6597,66,6663,63
2020-08-05,Santa Clara,085,1922200,14266,11074,33,11107,176
2020-08-05,Santa Cruz,087,273765,1445,1192,8,1200,4
2020-08-05,Shasta,089,179085,525,338,3,341,9
2020-08-05,Sierra,091,2930,5,3,0,3,0
2020-08-05,Siskiyou,093,43540,105,72,0,72,0
2020-08-05,Solano,095,438530,4595,3750,27,3777,29
2020-08-05,Sonoma,097,501317,4157,3173,8,3181,33
2020-08-05,Stanislaus,099,539301,12652,9408,83,9491,97
2020-08-05,Sutter,101,95872,978,780,1,781,6
2020-08-05,Tehama,103,63373,308,231,2,233,1
2020-08-05,Trinity,105,12862,27,5,6,11,0
2020-08-05,Tulare,107,460477,12154,9924,35,9959,192
2020-08-05,Tuolumne,109,53932,159,137,2,139,0
2020-08-05,Ventura,111,848112,9400,8162,37,8199,75
2020-08-05,Yolo,113,214977,2004,1634,4,1638,36
2020-08-05,Yuba,115,75493,589,400,0,400,1
2020-08-04,Alameda,001,1643700,14614,11983,110,12093,192
2020-08-04,Alpine,003,1148,2,2,0,2,0
2020-08-04,Amador,005,37829,203,123,0,123,0
2020-08-04,Butte,007,227075,1298,1011,15,1026,10
2020-08-04,Calaveras,009,45235,159,116,0,116,1
2020-08-04,Colusa,011,21464,396,354,0,354,3
2020-08-04,Contra Costa,013,1133247,11227,8210,33,8243,122
2020-08-04,Del Norte,015,27424,94,69,0,69,0
2020-08-04,El Dorado,017,186661,845,668,4,672,1
2020-08-04,Fresno,019,978130,22885,16272,214,16486,154
2020-08-04,Glenn,021,27897,396,325,0,325,1
2020-08-04,Humboldt,023,135768,284,241,1,242,4
2020-08-04,Imperial,025,180216,10543,7974,5,7979,163
2020-08-04,Inyo,027,18085,88,59,1,60,1
2020-08-04,Kern,029,883053,26099,21403,148,21551,190
2020-08-04,Kings,031,150075,5087,4163,27,4190,47
2020-08-04,Lake,033,64148,252,206,0,206,1
2020-08-04,Lassen,035,31185,645,556,2,558,0
2020-08-04,Los Angeles,037,10098052,210594,196014,656,196670,4764
2020-08-04,Madera,039,155013,3082,2161,8,2169,19
2020-08-04,Marin,041,260295,5573,5020,9,5029,43
2020-08-04,Mariposa,043,17540,64,51,0,51,2
2020-08-04,Mendocino,045,87422,377,248,0,248,1
2020-08-04,Merced,047,269075,6365,4085,3,4088,30
2020-08-04,Modoc,049,8938,7,3,0,3,0
2020-08-04,Mono,051,14174,158,104,1,105,1
2020-08-04,Monterey,053,433212,6058,4892,18,4910,32
2020-08-04,Napa,055,140530,1227,994,0,994,8
2020-08-04,Nevada,057,99092,356,322,15,337,2
2020-08-04,Orange,059,3164182,45067,37844,895,38739,659
2020-08-04,Placer,061,380077,2482,1964,4,1968,17
2020-08-04,Plumas,063,18699,36,25,0,25,0
2020-08-04,Riverside,065,2383286,46959,38991,46,39037,743
2020-08-04,Sacramento,067,1510023,13816,10205,13,10218,146
2020-08-04,San Benito,069,59416,766,608,0,608,2
2020-08-04,San Bernardino,071,2135413,42047,34215,194,34409,495
2020-08-04,San Diego,073,3302833,33788,30518,46,30564,568
2020-08-04,San Francisco,075,870044,7776,6568,7,6575,60
2020-08-04,San Joaquin,077,732212,15526,12087,17,12104,189
2020-08-04,San Luis Obispo,079,281455,2359,1886,13,1899,13
2020-08-04,San Mateo,081,765935,6901,5690,8,5698,116
2020-08-04,Santa Barbara,083,443738,7083,6591,66,6657,61
2020-08-04,Santa Clara,085,1922200,13965,10986,32,11018,175
2020-08-04,Santa Cruz,087,273765,1426,1202,8,1210,4
2020-08-04,Shasta,089,179085,519,335,3,338,9
2020-08-04,Sierra,091,2930,5,1,0,1,0
2020-08-04,Siskiyou,093,43540,103,71,0,71,0
2020-08-04,Solano,095,438530,4524,3690,27,3717,29
2020-08-04,Sonoma,097,501317,4090,3108,8,3116,33
2020-08-04,Stanislaus,099,539301,12483,9359,75,9434,97
2020-08-04,Sutter,101,95872,964,761,1,762,6
2020-08-04,Tehama,103,63373,301,226,2,228,1
2020-08-04,Trinity,105,12862,27,5,6,11,0
2020-08-04,Tulare,107,460477,11974,9866,35,9901,192
2020-08-04,Tuolumne,109,53932,158,127,2,129,0
2020-08-04,Ventura,111,848112,9286,8134,35,8169,75
2020-08-04,Yolo,113,214977,1978,1626,4,1630,37
2020-08-04,Yuba,115,75493,574,398,0,398,1
2020-08-03,Alameda,001,1643700,14431,11817,106,11923,189
2020-08-03,Alpine,003,1148,2,2,0,2,0
2020-08-03,Amador,005,37829,199,119,0,119,0
2020-08-03,Butte,007,227075,1252,989,14,1003,9
2020-08-03,Calaveras,009,45235,156,117,0,117,1
2020-08-03,Colusa,011,21464,392,336,0,336,2
2020-08-03,Contra Costa,013,1133247,11030,8069,30,8099,120
2020-08-03,Del Norte,015,27424,90,68,0,68,0
2020-08-03,El Dorado,017,186661,834,645,4,649,1
2020-08-03,Fresno,019,978130,22591,15945,208,16153,151
2020-08-03,Glenn,021,27897,389,316,0,316,1
2020-08-03,Humboldt,023,135768,277,234,1,235,4
2020-08-03,Imperial,025,180216,10488,7953,5,7958,161
2020-08-03,Inyo,027,18085,85,57,1,58,1
2020-08-03,Kern,029,883053,25732,21285,141,21426,176
2020-08-03,Kings,031,150075,4975,4107,26,4133,47
2020-08-03,Lake,033,64148,245,201,0,201,1
2020-08-03,Lassen,035,31185,645,555,2,557,0
2020-08-03,Los Angeles,037,10098052,208559,194103,626,194729,4706
2020-08-03,Madera,039,155013,3033,2143,7,2150,18
2020-08-03,Marin,041,260295,5526,5001,9,5010,43
2020-08-03,Mariposa,043,17540,63,52,0,52,2
2020-08-03,Mendocino,045,87422,354,248,0,248,1
2020-08-03,Merced,047,269075,6243,4028,3,4031,29
2020-08-03,Modoc,049,8938,7,2,0,2,0
2020-08-03,Mono,051,14174,158,104,1,105,1
2020-08-03,Monterey,053,433212,5907,4806,15,4821,28
2020-08-03,Napa,055,140530,1213,973,0,973,8
2020-08-03,Nevada,057,99092,352,315,15,330,2
2020-08-03,Orange,059,3164182,44673,37705,885,38590,651
2020-08-03,Placer,061,380077,2426,1947,3,1950,16
2020-08-03,Plumas,063,18699,36,25,0,25,0
2020-08-03,Riverside,065,2383286,46491,38642,46,38688,740
2020-08-03,Sacramento,067,1510023,13621,10143,13,10156,142
2020-08-03,San Benito,069,59416,754,603,0,603,2
2020-08-03,San Bernardino,071,2135413,41521,33979,188,34167,444
2020-08-03,San Diego,073,3302833,33474,30228,36,30264,565
2020-08-03,San Francisco,075,870044,7682,6319,7,6326,60
2020-08-03,San Joaquin,077,732212,15330,12007,16,12023,189
2020-08-03,San Luis Obispo,079,281455,2317,1863,10,1873,14
2020-08-03,San Mateo,081,765935,6820,5661,8,5669,115
2020-08-03,Santa Barbara,083,443738,7039,6580,66,6646,59
2020-08-03,Santa Clara,085,1922200,13689,10747,32,10779,172
2020-08-03,Santa Cruz,087,273765,1406,1154,8,1162,4
2020-08-03,Shasta,089,179085,512,322,3,325,9
2020-08-03,Sierra,091,2930,5,1,0,1,0
2020-08-03,Siskiyou,093,43540,99,67,0,67,0
2020-08-03,Solano,095,438530,4455,3610,26,3636,29
2020-08-03,Sonoma,097,501317,3989,3079,7,3086,33
2020-08-03,Stanislaus,099,539301,12274,9308,67,9375,96
2020-08-03,Sutter,101,95872,940,713,1,714,6
2020-08-03,Tehama,103,63373,293,225,2,227,1
2020-08-03,Trinity,105,12862,27,5,6,11,0
2020-08-03,Tulare,107,460477,11790,9703,35,9738,188
2020-08-03,Tuolumne,109,53932,158,123,2,125,0
2020-08-03,Ventura,111,848112,9195,8084,32,8116,74
2020-08-03,Yolo,113,214977,1943,1598,3,1601,37
2020-08-03,Yuba,115,75493,550,393,0,393,1
2020-08-02,Alameda,001,1643700,14185,11696,94,11790,188
2020-08-02,Alpine,003,1148,2,2,0,2,0
2020-08-02,Amador,005,37829,194,117,0,117,0
2020-08-02,Butte,007,227075,1217,987,14,1001,9
2020-08-02,Calaveras,009,45235,153,116,0,116,1
2020-08-02,Colusa,011,21464,387,335,0,335,2
2020-08-02,Contra Costa,013,1133247,10791,7995,30,8025,118
2020-08-02,Del Norte,015,27424,89,68,0,68,0
2020-08-02,El Dorado,017,186661,824,643,4,647,1
2020-08-02,Fresno,019,978130,22316,15759,202,15961,151
2020-08-02,Glenn,021,27897,388,315,0,315,1
2020-08-02,Humboldt,023,135768,272,232,1,233,4
2020-08-02,Imperial,025,180216,10425,7919,5,7924,157
2020-08-02,Inyo,027,18085,84,45,1,46,1
2020-08-02,Kern,029,883053,25434,21162,139,21301,176
2020-08-02,Kings,031,150075,4913,3964,25,3989,47
2020-08-02,Lake,033,64148,240,201,0,201,1
2020-08-02,Lassen,035,31185,645,555,2,557,0
2020-08-02,Los Angeles,037,10098052,206471,192480,608,193088,4698
2020-08-02,Madera,039,155013,2967,2123,5,2128,18
2020-08-02,Marin,041,260295,5491,4985,9,4994,43
2020-08-02,Mariposa,043,17540,61,52,0,52,2
2020-08-02,Mendocino,045,87422,344,247,0,247,1
2020-08-02,Merced,047,269075,6101,4011,3,4014,29
2020-08-02,Modoc,049,8938,7,2,0,2,0
2020-08-02,Mono,051,14174,151,104,1,105,1
2020-08-02,Monterey,053,433212,5781,4698,15,4713,28
2020-08-02,Napa,055,140530,1198,956,0,956,8
2020-08-02,Nevada,057,99092,349,314,15,329,2
2020-08-02,Orange,059,3164182,44292,37266,874,38140,651
2020-08-02,Placer,061,380077,2387,1920,3,1923,15
2020-08-02,Plumas,063,18699,36,25,0,25,0
2020-08-02,Riverside,065,2383286,46058,38507,45,38552,735
2020-08-02,Sacramento,067,1510023,13342,10099,13,10112,142
2020-08-02,San Benito,069,59416,740,599,0,599,2
2020-08-02,San Bernardino,071,2135413,40919,33643,184,33827,443
2020-08-02,San Diego,073,3302833,33134,29885,27,29912,565
2020-08-02,San Francisco,075,870044,7564,6297,7,6304,60
2020-08-02,San Joaquin,077,732212,15044,11937,14,11951,189
2020-08-02,San Luis Obispo,079,281455,2254,1821,10,1831,14
2020-08-02,San Mateo,081,765935,6705,5618,8,5626,115
2020-08-02,Santa Barbara,083,443738,6949,6532,66,6598,59
2020-08-02,Santa Clara,085,1922200,13470,10577,32,10609,172
2020-08-02,Santa Cruz,087,273765,1386,1162,8,1170,4
2020-08-02,Shasta,089,179085,508,318,3,321,9
2020-08-02,Sierra,091,2930,4,1,0,1,0
2020-08-02,Siskiyou,093,43540,99,65,0,65,0
2020-08-02,Solano,095,438530,4397,3609,26,3635,29
2020-08-02,Sonoma,097,501317,3905,3005,7,3012,33
2020-08-02,Stanislaus,099,539301,12059,9277,62,9339,96
2020-08-02,Sutter,101,95872,905,714,1,715,6
2020-08-02,Tehama,103,63373,287,222,2,224,1
2020-08-02,Trinity,105,12862,27,5,6,11,0
2020-08-02,Tulare,107,460477,11581,9593,35,9628,188
2020-08-02,Tuolumne,109,53932,155,123,2,125,0
2020-08-02,Ventura,111,848112,9048,8014,32,8046,73
2020-08-02,Yolo,113,214977,1918,1588,3,1591,37
2020-08-02,Yuba,115,75493,530,393,0,393,1
2020-08-01,Alameda,001,1643700,14073,11590,94,11684,188
2020-08-01,Alpine,003,1148,2,2,0,2,0
2020-08-01,Amador,005,37829,190,109,0,109,0
2020-08-01,Butte,007,227075,1203,976,14,990,9
2020-08-01,Calaveras,009,45235,149,116,0,116,1
2020-08-01,Colusa,011,21464,386,327,0,327,2
2020-08-01,Contra Costa,013,1133247,10658,7867,29,7896,116
2020-08-01,Del Norte,015,27424,89,68,0,68,0
2020-08-01,El Dorado,017,186661,821,637,4,641,1
2020-08-01,Fresno,019,978130,22179,15448,202,15650,149
2020-08-01,Glenn,021,27897,387,311,0,311,1
2020-08-01,Humboldt,023,135768,271,232,1,233,4
2020-08-01,Imperial,025,180216,10389,7919,5,7924,156
2020-08-01,Inyo,027,18085,82,45,1,46,1
2020-08-01,Kern,029,883053,25276,20796,135,20931,176
2020-08-01,Kings,031,150075,4887,3948,25,3973,47
2020-08-01,Lake,033,64148,238,194,0,194,1
2020-08-01,Lassen,035,31185,644,555,2,557,0
2020-08-01,Los Angeles,037,10098052,205578,191023,581,191604,4674
2020-08-01,Madera,039,155013,2928,2103,5,2108,18
2020-08-01,Marin,041,260295,5476,4945,9,4954,43
2020-08-01,Mariposa,043,17540,61,50,0,50,2
2020-08-01,Mendocino,045,87422,337,243,0,243,1
2020-08-01,Merced,047,269075,6053,3972,3,3975,29
2020-08-01,Modoc,049,8938,7,2,0,2,0
2020-08-01,Mono,051,14174,150,104,1,105,1
2020-08-01,Monterey,053,433212,5714,4611,14,4625,28
2020-08-01,Napa,055,140530,1189,923,0,923,8
2020-08-01,Nevada,057,99092,345,305,15,320,2
2020-08-01,Orange,059,3164182,44065,36703,868,37571,648
2020-08-01,Placer,061,380077,2353,1891,3,1894,14
2020-08-01,Plumas,063,18699,35,25,0,25,0
2020-08-01,Riverside,065,2383286,45846,38216,43,38259,704
2020-08-01,Sacramento,067,1510023,13191,10044,13,10057,141
2020-08-01,San Benito,069,59416,729,579,0,579,2
2020-08-01,San Bernardino,071,2135413,40683,32947,183,33130,440
2020-08-01,San Diego,073,3302833,32917,29579,19,29598,565
2020-08-01,San Francisco,075,870044,7502,6296,7,6303,60
2020-08-01,San Joaquin,077,732212,14971,11807,13,11820,189
2020-08-01,San Luis Obispo,079,281455,2225,1798,10,1808,13
2020-08-01,San Mateo,081,765935,6651,5520,8,5528,115
2020-08-01,Santa Barbara,083,443738,6909,6465,66,6531,59
2020-08-01,Santa Clara,085,1922200,13319,10281,31,10312,171
2020-08-01,Santa Cruz,087,273765,1370,1164,8,1172,4
2020-08-01,Shasta,089,179085,503,312,3,315,9
2020-08-01,Sierra,091,2930,3,1,0,1,0
2020-08-01,Siskiyou,093,43540,99,64,0,64,0
2020-08-01,Solano,095,438530,4363,3591,25,3616,29
2020-08-01,Sonoma,097,501317,3859,2890,7,2897,29
2020-08-01,Stanislaus,099,539301,11941,9221,54,9275,96
2020-08-01,Sutter,101,95872,901,714,1,715,6
2020-08-01,Tehama,103,63373,284,220,2,222,1
2020-08-01,Trinity,105,12862,27,5,6,11,0
2020-08-01,Tulare,107,460477,11513,9520,35,9555,188
2020-08-01,Tuolumne,109,53932,155,123,2,125,0
2020-08-01,Ventura,111,848112,9002,7819,32,7851,73
2020-08-01,Yolo,113,214977,1908,1557,3,1560,37
2020-08-01,Yuba,115,75493,525,387,0,387,1
2020-07-31,Alameda,001,1643700,13943,11441,94,11535,187
2020-07-31,Alpine,003,1148,2,2,0,2,0
2020-07-31,Amador,005,37829,189,98,0,98,0
2020-07-31,Butte,007,227075,1180,925,14,939,7
2020-07-31,Calaveras,009,45235,149,112,0,112,1
2020-07-31,Colusa,011,21464,376,319,0,319,2
2020-07-31,Contra Costa,013,1133247,10510,7697,28,7725,113
2020-07-31,Del Norte,015,27424,88,68,0,68,0
2020-07-31,El Dorado,017,186661,810,616,4,620,1
2020-07-31,Fresno,019,978130,21959,15083,202,15285,133
2020-07-31,Glenn,021,27897,380,304,0,304,1
2020-07-31,Humboldt,023,135768,264,229,1,230,4
2020-07-31,Imperial,025,180216,10357,7886,5,7891,155
2020-07-31,Inyo,027,18085,72,45,1,46,1
2020-07-31,Kern,029,883053,25035,20061,131,20192,173
2020-07-31,Kings,031,150075,4859,3807,25,3832,45
2020-07-31,Lake,033,64148,237,191,0,191,1
2020-07-31,Lassen,035,31185,639,544,2,546,0
2020-07-31,Los Angeles,037,10098052,203978,188688,568,189256,4628
2020-07-31,Madera,039,155013,2881,2036,5,2041,19
2020-07-31,Marin,041,260295,5432,4885,6,4891,43
2020-07-31,Mariposa,043,17540,61,49,0,49,2
2020-07-31,Mendocino,045,87422,322,232,0,232,1
2020-07-31,Merced,047,269075,5970,3789,3,3792,30
2020-07-31,Modoc,049,8938,6,0,0,0,0
2020-07-31,Mono,051,14174,149,104,1,105,1
2020-07-31,Monterey,053,433212,5622,4493,14,4507,24
2020-07-31,Napa,055,140530,1177,897,0,897,7
2020-07-31,Nevada,057,99092,343,302,15,317,2
2020-07-31,Orange,059,3164182,43766,36196,852,37048,620
2020-07-31,Placer,061,380077,2328,1853,3,1856,14
2020-07-31,Plumas,063,18699,34,25,0,25,0
2020-07-31,Riverside,065,2383286,45456,37612,42,37654,694
2020-07-31,Sacramento,067,1510023,13013,9872,13,9885,132
2020-07-31,San Benito,069,59416,721,567,0,567,2
2020-07-31,San Bernardino,071,2135413,40353,32332,182,32514,434
2020-07-31,San Diego,073,3302833,32683,29050,11,29061,561
2020-07-31,San Francisco,075,870044,7403,6126,7,6133,60
2020-07-31,San Joaquin,077,732212,14831,11561,13,11574,177
2020-07-31,San Luis Obispo,079,281455,2156,1746,10,1756,12
2020-07-31,San Mateo,081,765935,6579,5416,8,5424,115
2020-07-31,Santa Barbara,083,443738,6842,6375,66,6441,58
2020-07-31,Santa Clara,085,1922200,13098,9863,31,9894,171
2020-07-31,Santa Cruz,087,273765,1347,1118,8,1126,4
2020-07-31,Shasta,089,179085,493,305,3,308,9
2020-07-31,Sierra,091,2930,3,1,0,1,0
2020-07-31,Siskiyou,093,43540,97,61,0,61,0
2020-07-31,Solano,095,438530,4316,3510,24,3534,29
2020-07-31,Sonoma,097,501317,3801,2745,7,2752,27
2020-07-31,Stanislaus,099,539301,11834,9061,49,9110,94
2020-07-31,Sutter,101,95872,896,714,1,715,6
2020-07-31,Tehama,103,63373,281,213,2,215,1
2020-07-31,Trinity,105,12862,27,5,6,11,0
2020-07-31,Tulare,107,460477,11392,9365,35,9400,184
2020-07-31,Tuolumne,109,53932,155,120,2,122,0
2020-07-31,Ventura,111,848112,8927,7521,32,7553,71
2020-07-31,Yolo,113,214977,1882,1522,3,1525,38
2020-07-31,Yuba,115,75493,516,369,0,369,1
2020-07-30,Alameda,001,1643700,13740,11303,54,11357,185
2020-07-30,Alpine,003,1148,2,2,0,2,0
2020-07-30,Amador,005,37829,171,97,0,97,0
2020-07-30,Butte,007,227075,1164,915,14,929,7
2020-07-30,Calaveras,009,45235,145,111,0,111,1
2020-07-30,Colusa,011,21464,373,315,0,315,2
2020-07-30,Contra Costa,013,1133247,10326,7615,27,7642,112
2020-07-30,Del Norte,015,27424,88,68,0,68,0
2020-07-30,El Dorado,017,186661,803,608,4,612,1
2020-07-30,Fresno,019,978130,21623,14793,196,14989,133
2020-07-30,Glenn,021,27897,373,297,0,297,1
2020-07-30,Humboldt,023,135768,262,228,1,229,4
2020-07-30,Imperial,025,180216,10298,7849,5,7854,151
2020-07-30,Inyo,027,18085,68,44,1,45,1
2020-07-30,Kern,029,883053,24742,19552,127,19679,171
2020-07-30,Kings,031,150075,4755,3785,25,3810,43
2020-07-30,Lake,033,64148,231,181,0,181,1
2020-07-30,Lassen,035,31185,636,544,2,546,0
2020-07-30,Los Angeles,037,10098052,201947,186177,537,186714,4564
2020-07-30,Madera,039,155013,2811,2007,5,2012,18
2020-07-30,Marin,041,260295,5390,4835,5,4840,39
2020-07-30,Mariposa,043,17540,61,49,0,49,1
2020-07-30,Mendocino,045,87422,315,232,0,232,1
2020-07-30,Merced,047,269075,5805,3695,3,3698,30
2020-07-30,Modoc,049,8938,6,0,0,0,0
2020-07-30,Mono,051,14174,148,104,1,105,1
2020-07-30,Monterey,053,433212,5510,4352,14,4366,24
2020-07-30,Napa,055,140530,1160,874,0,874,7
2020-07-30,Nevada,057,99092,338,292,15,307,2
2020-07-30,Orange,059,3164182,43351,36105,827,36932,607
2020-07-30,Placer,061,380077,2278,1821,3,1824,14
2020-07-30,Plumas,063,18699,33,25,0,25,0
2020-07-30,Riverside,065,2383286,44915,37308,42,37350,685
2020-07-30,Sacramento,067,1510023,12794,9704,13,9717,126
2020-07-30,San Benito,069,59416,708,558,0,558,2
2020-07-30,San Bernardino,071,2135413,39830,32010,182,32192,427
2020-07-30,San Diego,073,3302833,32336,28670,9,28679,558
2020-07-30,San Francisco,075,870044,7303,6107,7,6114,59
2020-07-30,San Joaquin,077,732212,14637,11435,13,11448,161
2020-07-30,San Luis Obispo,079,281455,2120,1703,10,1713,12
2020-07-30,San Mateo,081,765935,6484,5369,8,5377,115
2020-07-30,Santa Barbara,083,443738,6762,6273,66,6339,52
2020-07-30,Santa Clara,085,1922200,12863,9708,30,9738,170
2020-07-30,Santa Cruz,087,273765,1319,1087,8,1095,4
2020-07-30,Shasta,089,179085,489,306,3,309,8
2020-07-30,Sierra,091,2930,3,1,0,1,0
2020-07-30,Siskiyou,093,43540,96,60,0,60,0
2020-07-30,Solano,095,438530,4265,3463,24,3487,29
2020-07-30,Sonoma,097,501317,3730,2684,7,2691,25
2020-07-30,Stanislaus,099,539301,11621,8890,41,8931,94
2020-07-30,Sutter,101,95872,877,698,1,699,6
2020-07-30,Tehama,103,63373,278,208,2,210,1
2020-07-30,Trinity,105,12862,26,4,6,10,0
2020-07-30,Tulare,107,460477,11263,9167,35,9202,177
2020-07-30,Tuolumne,109,53932,154,119,2,121,0
2020-07-30,Ventura,111,848112,8815,7304,30,7334,69
2020-07-30,Yolo,113,214977,1862,1511,3,1514,37
2020-07-30,Yuba,115,75493,503,362,0,362,1
2020-07-29,Alameda,001,1643700,13520,11177,49,11226,180
2020-07-29,Alpine,003,1148,2,2,0,2,0
2020-07-29,Amador,005,37829,163,80,0,80,0
2020-07-29,Butte,007,227075,1138,889,12,901,7
2020-07-29,Calaveras,009,45235,139,107,0,107,1
2020-07-29,Colusa,011,21464,369,302,0,302,2
2020-07-29,Contra Costa,013,1133247,10122,7520,27,7547,108
2020-07-29,Del Norte,015,27424,88,68,0,68,0
2020-07-29,El Dorado,017,186661,793,588,4,592,1
2020-07-29,Fresno,019,978130,21331,14312,196,14508,125
2020-07-29,Glenn,021,27897,366,294,0,294,1
2020-07-29,Humboldt,023,135768,259,221,1,222,4
2020-07-29,Imperial,025,180216,10250,7825,5,7830,147
2020-07-29,Inyo,027,18085,63,44,1,45,1
2020-07-29,Kern,029,883053,24404,19073,124,19197,162
2020-07-29,Kings,031,150075,4707,3755,25,3780,43
2020-07-29,Lake,033,64148,229,179,0,179,1
2020-07-29,Lassen,035,31185,621,513,2,515,0
2020-07-29,Los Angeles,037,10098052,199918,183600,520,184120,4523
2020-07-29,Madera,039,155013,2757,1941,5,1946,18
2020-07-29,Marin,041,260295,5352,4747,5,4752,34
2020-07-29,Mariposa,043,17540,60,47,0,47,1
2020-07-29,Mendocino,045,87422,307,228,0,228,0
2020-07-29,Merced,047,269075,5665,3605,3,3608,25
2020-07-29,Modoc,049,8938,5,0,0,0,0
2020-07-29,Mono,051,14174,145,102,1,103,1
2020-07-29,Monterey,053,433212,5410,4252,14,4266,24
2020-07-29,Napa,055,140530,1132,866,0,866,7
2020-07-29,Nevada,057,99092,334,288,15,303,1
2020-07-29,Orange,059,3164182,42917,35339,816,36155,589
2020-07-29,Placer,061,380077,2246,1798,3,1801,14
2020-07-29,Plumas,063,18699,33,25,0,25,0
2020-07-29,Riverside,065,2383286,44323,36968,42,37010,678
2020-07-29,Sacramento,067,1510023,12548,9538,13,9551,122
2020-07-29,San Benito,069,59416,693,537,0,537,2
2020-07-29,San Bernardino,071,2135413,39341,31168,171,31339,417
2020-07-29,San Diego,073,3302833,32011,28289,8,28297,552
2020-07-29,San Francisco,075,870044,7209,6041,7,6048,56
2020-07-29,San Joaquin,077,732212,14389,11249,10,11259,154
2020-07-29,San Luis Obispo,079,281455,2099,1673,10,1683,11
2020-07-29,San Mateo,081,765935,6396,5305,8,5313,114
2020-07-29,Santa Barbara,083,443738,6695,6215,66,6281,31
2020-07-29,Santa Clara,085,1922200,12656,9567,30,9597,165
2020-07-29,Santa Cruz,087,273765,1295,1051,8,1059,4
2020-07-29,Shasta,089,179085,477,297,3,300,8
2020-07-29,Sierra,091,2930,2,1,0,1,0
2020-07-29,Siskiyou,093,43540,94,58,0,58,0
2020-07-29,Solano,095,438530,4211,3380,24,3404,29
2020-07-29,Sonoma,097,501317,3652,2598,7,2605,26
2020-07-29,Stanislaus,099,539301,11400,8745,35,8780,94
2020-07-29,Sutter,101,95872,849,678,1,679,6
2020-07-29,Tehama,103,63373,274,206,2,208,1
2020-07-29,Trinity,105,12862,26,4,6,10,0
2020-07-29,Tulare,107,460477,11092,9028,35,9063,156
2020-07-29,Tuolumne,109,53932,154,118,2,120,0
2020-07-29,Ventura,111,848112,8710,7161,30,7191,68
2020-07-29,Yolo,113,214977,1836,1488,3,1491,36
2020-07-29,Yuba,115,75493,487,350,0,350,1
2020-07-28,Alameda,001,1643700,13290,10875,48,10923,180
2020-07-28,Alpine,003,1148,2,2,0,2,0
2020-07-28,Amador,005,37829,153,77,0,77,0
2020-07-28,Butte,007,227075,1103,857,12,869,7
2020-07-28,Calaveras,009,45235,138,105,0,105,1
2020-07-28,Colusa,011,21464,363,290,0,290,2
2020-07-28,Contra Costa,013,1133247,9899,7426,27,7453,107
2020-07-28,Del Norte,015,27424,87,68,0,68,0
2020-07-28,El Dorado,017,186661,778,558,4,562,1
2020-07-28,Fresno,019,978130,20995,13933,190,14123,125
2020-07-28,Glenn,021,27897,364,289,0,289,1
2020-07-28,Humboldt,023,135768,258,218,1,219,4
2020-07-28,Imperial,025,180216,10214,7804,5,7809,145
2020-07-28,Inyo,027,18085,61,43,1,44,1
2020-07-28,Kern,029,883053,24041,18834,118,18952,155
2020-07-28,Kings,031,150075,4661,3721,25,3746,41
2020-07-28,Lake,033,64148,225,179,0,179,1
2020-07-28,Lassen,035,31185,615,508,2,510,0
2020-07-28,Los Angeles,037,10098052,197686,179107,497,179604,4435
2020-07-28,Madera,039,155013,2691,1889,5,1894,18
2020-07-28,Marin,041,260295,5283,4698,5,4703,23
2020-07-28,Mariposa,043,17540,58,45,0,45,1
2020-07-28,Mendocino,045,87422,296,222,0,222,0
2020-07-28,Merced,047,269075,5520,3446,3,3449,23
2020-07-28,Modoc,049,8938,4,0,0,0,0
2020-07-28,Mono,051,14174,144,102,1,103,1
2020-07-28,Monterey,053,433212,5290,4047,14,4061,22
2020-07-28,Napa,055,140530,1110,824,0,824,6
2020-07-28,Nevada,057,99092,329,278,15,293,1
2020-07-28,Orange,059,3164182,42459,34832,802,35634,582
2020-07-28,Placer,061,380077,2210,1759,3,1762,14
2020-07-28,Plumas,063,18699,33,22,0,22,0
2020-07-28,Riverside,065,2383286,43721,36458,42,36500,668
2020-07-28,Sacramento,067,1510023,12289,9429,12,9441,117
2020-07-28,San Benito,069,59416,683,503,0,503,2
2020-07-28,San Bernardino,071,2135413,38818,30493,167,30660,412
2020-07-28,San Diego,073,3302833,31661,28007,6,28013,547
2020-07-28,San Francisco,075,870044,7096,5888,7,5895,56
2020-07-28,San Joaquin,077,732212,14106,10958,7,10965,141
2020-07-28,San Luis Obispo,079,281455,2066,1636,10,1646,9
2020-07-28,San Mateo,081,765935,6323,5171,8,5179,114
2020-07-28,Santa Barbara,083,443738,6632,6110,64,6174,31
2020-07-28,Santa Clara,085,1922200,12422,9307,30,9337,165
2020-07-28,Santa Cruz,087,273765,1268,1018,8,1026,4
2020-07-28,Shasta,089,179085,465,275,3,278,8
2020-07-28,Sierra,091,2930,2,1,0,1,0
2020-07-28,Siskiyou,093,43540,90,57,0,57,0
2020-07-28,Solano,095,438530,4164,3292,23,3315,29
2020-07-28,Sonoma,097,501317,3578,2553,7,2560,20
2020-07-28,Stanislaus,099,539301,11178,8492,27,8519,92
2020-07-28,Sutter,101,95872,812,653,0,653,2
2020-07-28,Tehama,103,63373,269,199,2,201,1
2020-07-28,Trinity,105,12862,26,3,6,9,0
2020-07-28,Tulare,107,460477,10905,8787,35,8822,96
2020-07-28,Tuolumne,109,53932,153,116,2,118,0
2020-07-28,Ventura,111,848112,8584,7045,29,7074,68
2020-07-28,Yolo,113,214977,1808,1459,3,1462,36
2020-07-28,Yuba,115,75493,470,333,0,333,1
2020-07-27,Alameda,001,1643700,13063,10645,45,10690,176
2020-07-27,Alpine,003,1148,2,2,0,2,0
2020-07-27,Amador,005,37829,148,72,0,72,0
2020-07-27,Butte,007,227075,1076,843,12,855,7
2020-07-27,Calaveras,009,45235,134,103,0,103,1
2020-07-27,Colusa,011,21464,356,271,0,271,2
2020-07-27,Contra Costa,013,1133247,9677,7256,27,7283,104
2020-07-27,Del Norte,015,27424,86,67,0,67,0
2020-07-27,El Dorado,017,186661,766,548,4,552,1
2020-07-27,Fresno,019,978130,20647,13485,184,13669,117
2020-07-27,Glenn,021,27897,362,277,0,277,1
2020-07-27,Humboldt,023,135768,253,218,1,219,4
2020-07-27,Imperial,025,180216,10164,7789,5,7794,144
2020-07-27,Inyo,027,18085,61,43,1,44,1
2020-07-27,Kern,029,883053,23539,17994,112,18106,148
2020-07-27,Kings,031,150075,4412,3685,25,3710,39
2020-07-27,Lake,033,64148,221,176,0,176,1
2020-07-27,Lassen,035,31185,615,503,2,505,0
2020-07-27,Los Angeles,037,10098052,195258,176351,479,176830,4379
2020-07-27,Madera,039,155013,2626,1793,5,1798,17
2020-07-27,Marin,041,260295,5195,4669,5,4674,22
2020-07-27,Mariposa,043,17540,58,43,0,43,1
2020-07-27,Mendocino,045,87422,282,209,0,209,0
2020-07-27,Merced,047,269075,5380,3292,3,3295,23
2020-07-27,Modoc,049,8938,3,0,0,0,0
2020-07-27,Mono,051,14174,140,99,1,100,1
2020-07-27,Monterey,053,433212,5101,3960,14,3974,21
2020-07-27,Napa,055,140530,1095,769,0,769,6
2020-07-27,Nevada,057,99092,325,268,14,282,1
2020-07-27,Orange,059,3164182,42019,34649,786,35435,566
2020-07-27,Placer,061,380077,2160,1679,3,1682,12
2020-07-27,Plumas,063,18699,33,22,0,22,0
2020-07-27,Riverside,065,2383286,43042,35822,42,35864,667
2020-07-27,Sacramento,067,1510023,11996,9091,12,9103,114
2020-07-27,San Benito,069,59416,668,498,0,498,2
2020-07-27,San Bernardino,071,2135413,38225,29928,157,30085,401
2020-07-27,San Diego,073,3302833,31287,27509,5,27514,533
2020-07-27,San Francisco,075,870044,7009,5825,7,5832,55
2020-07-27,San Joaquin,077,732212,13817,10728,7,10735,129
2020-07-27,San Luis Obispo,079,281455,2021,1612,10,1622,9
2020-07-27,San Mateo,081,765935,6214,5108,8,5116,113
2020-07-27,Santa Barbara,083,443738,6553,6026,62,6088,30
2020-07-27,Santa Clara,085,1922200,12153,9157,29,9186,166
2020-07-27,Santa Cruz,087,273765,1244,984,8,992,4
2020-07-27,Shasta,089,179085,458,275,3,278,8
2020-07-27,Sierra,091,2930,2,1,0,1,0
2020-07-27,Siskiyou,093,43540,88,54,0,54,0
2020-07-27,Solano,095,438530,4097,3198,22,3220,29
2020-07-27,Sonoma,097,501317,3487,2504,7,2511,20
2020-07-27,Stanislaus,099,539301,10952,8288,19,8307,84
2020-07-27,Sutter,101,95872,786,620,0,620,2
2020-07-27,Tehama,103,63373,261,192,2,194,1
2020-07-27,Trinity,105,12862,26,3,6,9,0
2020-07-27,Tulare,107,460477,10687,8462,35,8497,172
2020-07-27,Tuolumne,109,53932,150,115,2,117,0
2020-07-27,Ventura,111,848112,8456,6998,28,7026,68
2020-07-27,Yolo,113,214977,1763,1439,3,1442,33
2020-07-27,Yuba,115,75493,450,328,0,328,1
2020-07-26,Alameda,001,1643700,12825,10489,44,10533,176
2020-07-26,Alpine,003,1148,2,2,0,2,0
2020-07-26,Amador,005,37829,142,67,0,67,0
2020-07-26,Butte,007,227075,1039,822,12,834,5
2020-07-26,Calaveras,009,45235,131,103,0,103,1
2020-07-26,Colusa,011,21464,347,270,0,270,2
2020-07-26,Contra Costa,013,1133247,9440,7095,27,7122,104
2020-07-26,Del Norte,015,27424,84,67,0,67,0
2020-07-26,El Dorado,017,186661,748,539,4,543,1
2020-07-26,Fresno,019,978130,20256,13209,176,13385,117
2020-07-26,Glenn,021,27897,354,265,0,265,1
2020-07-26,Humboldt,023,135768,247,214,1,215,4
2020-07-26,Imperial,025,180216,10091,7781,5,7786,144
2020-07-26,Inyo,027,18085,56,43,1,44,1
2020-07-26,Kern,029,883053,23014,17394,109,17503,148
2020-07-26,Kings,031,150075,4353,3591,25,3616,39
2020-07-26,Lake,033,64148,213,174,0,174,1
2020-07-26,Lassen,035,31185,574,503,2,505,0
2020-07-26,Los Angeles,037,10098052,192687,174322,461,174783,4364
2020-07-26,Madera,039,155013,2539,1744,5,1749,17
2020-07-26,Marin,041,260295,5149,4595,5,4600,22
2020-07-26,Mariposa,043,17540,56,43,0,43,1
2020-07-26,Mendocino,045,87422,273,206,0,206,0
2020-07-26,Merced,047,269075,5200,3251,2,3253,23
2020-07-26,Modoc,049,8938,3,0,0,0,0
2020-07-26,Mono,051,14174,136,82,1,83,1
2020-07-26,Monterey,053,433212,4935,3901,14,3915,21
2020-07-26,Napa,055,140530,1076,769,0,769,6
2020-07-26,Nevada,057,99092,322,261,14,275,1
2020-07-26,Orange,059,3164182,41494,34352,754,35106,564
2020-07-26,Placer,061,380077,2096,1628,3,1631,12
2020-07-26,Plumas,063,18699,33,22,0,22,0
2020-07-26,Riverside,065,2383286,42482,35636,42,35678,665
2020-07-26,Sacramento,067,1510023,11691,8972,12,8984,114
2020-07-26,San Benito,069,59416,656,495,0,495,2
2020-07-26,San Bernardino,071,2135413,37584,29545,148,29693,400
2020-07-26,San Diego,073,3302833,30891,26986,4,26990,533
2020-07-26,San Francisco,075,870044,6901,5823,7,5830,55
2020-07-26,San Joaquin,077,732212,13524,10637,7,10644,129
2020-07-26,San Luis Obispo,079,281455,1978,1565,10,1575,8
2020-07-26,San Mateo,081,765935,6108,5078,8,5086,113
2020-07-26,Santa Barbara,083,443738,6452,5939,62,6001,30
2020-07-26,Santa Clara,085,1922200,11924,8986,29,9015,166
2020-07-26,Santa Cruz,087,273765,1217,970,8,978,4
2020-07-26,Shasta,089,179085,451,265,3,268,8
2020-07-26,Sierra,091,2930,2,1,0,1,0
2020-07-26,Siskiyou,093,43540,86,54,0,54,0
2020-07-26,Solano,095,438530,4017,3197,20,3217,29
2020-07-26,Sonoma,097,501317,3398,2503,6,2509,20
2020-07-26,Stanislaus,099,539301,10691,8228,18,8246,84
2020-07-26,Sutter,101,95872,772,612,0,612,2
2020-07-26,Tehama,103,63373,254,175,2,177,1
2020-07-26,Trinity,105,12862,26,3,6,9,0
2020-07-26,Tulare,107,460477,10481,8392,35,8427,172
2020-07-26,Tuolumne,109,53932,145,113,2,115,0
2020-07-26,Ventura,111,848112,8249,6844,28,6872,67
2020-07-26,Yolo,113,214977,1732,1408,3,1411,33
2020-07-26,Yuba,115,75493,431,313,0,313,1
2020-07-25,Alameda,001,1643700,12728,10361,42,10403,176
2020-07-25,Alpine,003,1148,2,2,0,2,0
2020-07-25,Amador,005,37829,139,67,0,67,0
2020-07-25,Butte,007,227075,1030,810,12,822,5
2020-07-25,Calaveras,009,45235,127,103,0,103,1
2020-07-25,Colusa,011,21464,340,265,0,265,2
2020-07-25,Contra Costa,013,1133247,9295,6920,27,6947,104
2020-07-25,Del Norte,015,27424,84,67,0,67,0
2020-07-25,El Dorado,017,186661,737,528,4,532,1
2020-07-25,Fresno,019,978130,20069,12866,176,13042,117
2020-07-25,Glenn,021,27897,352,260,0,260,1
2020-07-25,Humboldt,023,135768,244,212,1,213,4
2020-07-25,Imperial,025,180216,10065,7727,5,7732,144
2020-07-25,Inyo,027,18085,55,43,1,44,1
2020-07-25,Kern,029,883053,22796,16910,108,17018,148
2020-07-25,Kings,031,150075,4336,3516,25,3541,39
2020-07-25,Lake,033,64148,211,173,0,173,1
2020-07-25,Lassen,035,31185,574,503,2,505,0
2020-07-25,Los Angeles,037,10098052,191556,172611,454,173065,4357
2020-07-25,Madera,039,155013,2507,1724,5,1729,17
2020-07-25,Marin,041,260295,5133,4562,5,4567,22
2020-07-25,Mariposa,043,17540,55,43,0,43,1
2020-07-25,Mendocino,045,87422,267,190,0,190,0
2020-07-25,Merced,047,269075,5121,3176,2,3178,23
2020-07-25,Modoc,049,8938,3,0,0,0,0
2020-07-25,Mono,051,14174,136,82,1,83,1
2020-07-25,Monterey,053,433212,4858,3805,14,3819,21
2020-07-25,Napa,055,140530,1063,746,0,746,6
2020-07-25,Nevada,057,99092,320,257,14,271,1
2020-07-25,Orange,059,3164182,41275,33978,733,34711,561
2020-07-25,Placer,061,380077,2080,1596,3,1599,12
2020-07-25,Plumas,063,18699,33,22,0,22,0
2020-07-25,Riverside,065,2383286,42213,34921,42,34963,655
2020-07-25,Sacramento,067,1510023,11545,8674,12,8686,113
2020-07-25,San Benito,069,59416,640,492,0,492,2
2020-07-25,San Bernardino,071,2135413,37305,29265,145,29410,394
2020-07-25,San Diego,073,3302833,30630,26703,3,26706,533
2020-07-25,San Francisco,075,870044,6843,5644,7,5651,55
2020-07-25,San Joaquin,077,732212,13398,10347,6,10353,129
2020-07-25,San Luis Obispo,079,281455,1958,1530,9,1539,8
2020-07-25,San Mateo,081,765935,6045,5023,8,5031,113
2020-07-25,Santa Barbara,083,443738,6417,5880,62,5942,30
2020-07-25,Santa Clara,085,1922200,11790,8767,29,8796,166
2020-07-25,Santa Cruz,087,273765,1200,939,8,947,4
2020-07-25,Shasta,089,179085,446,263,1,264,8
2020-07-25,Sierra,091,2930,2,1,0,1,0
2020-07-25,Siskiyou,093,43540,84,54,0,54,0
2020-07-25,Solano,095,438530,3977,3107,18,3125,29
2020-07-25,Sonoma,097,501317,3359,2412,6,2418,20
2020-07-25,Stanislaus,099,539301,10588,7994,15,8009,84
2020-07-25,Sutter,101,95872,753,603,0,603,2
2020-07-25,Tehama,103,63373,253,169,2,171,1
2020-07-25,Trinity,105,12862,26,3,6,9,0
2020-07-25,Tulare,107,460477,10381,8310,35,8345,172
2020-07-25,Tuolumne,109,53932,144,99,2,101,0
2020-07-25,Ventura,111,848112,8176,6662,28,6690,62
2020-07-25,Yolo,113,214977,1717,1357,3,1360,35
2020-07-25,Yuba,115,75493,425,312,0,312,1
2020-07-24,Alameda,001,1643700,12586,10216,39,10255,176
2020-07-24,Alpine,003,1148,2,2,0,2,0
2020-07-24,Amador,005,37829,137,66,0,66,0
2020-07-24,Butte,007,227075,1018,751,12,763,5
2020-07-24,Calaveras,009,45235,123,102,0,102,0
2020-07-24,Colusa,011,21464,337,255,0,255,2
2020-07-24,Contra Costa,013,1133247,9149,6814,27,6841,100
2020-07-24,Del Norte,015,27424,84,66,0,66,0
2020-07-24,El Dorado,017,186661,715,516,4,520,1
2020-07-24,Fresno,019,978130,19843,12564,176,12740,115
2020-07-24,Glenn,021,27897,349,251,0,251,1
2020-07-24,Humboldt,023,135768,241,210,1,211,4
2020-07-24,Imperial,025,180216,10043,7686,5,7691,141
2020-07-24,Inyo,027,18085,55,41,1,42,1
2020-07-24,Kern,029,883053,22555,16124,108,16232,143
2020-07-24,Kings,031,150075,4306,3471,25,3496,39
2020-07-24,Lake,033,64148,209,167,0,167,1
2020-07-24,Lassen,035,31185,574,503,2,505,0
2020-07-24,Los Angeles,037,10098052,189538,169078,443,169521,4302
2020-07-24,Madera,039,155013,2474,1679,5,1684,16
2020-07-24,Marin,041,260295,5106,4517,5,4522,22
2020-07-24,Mariposa,043,17540,55,41,0,41,1
2020-07-24,Mendocino,045,87422,260,188,0,188,0
2020-07-24,Merced,047,269075,5036,3100,2,3102,23
2020-07-24,Modoc,049,8938,3,0,0,0,0
2020-07-24,Mono,051,14174,135,82,1,83,1
2020-07-24,Monterey,053,433212,4786,3748,14,3762,21
2020-07-24,Napa,055,140530,1050,741,0,741,6
2020-07-24,Nevada,057,99092,317,255,14,269,1
2020-07-24,Orange,059,3164182,40988,33530,717,34247,557
2020-07-24,Placer,061,380077,2049,1551,3,1554,12
2020-07-24,Plumas,063,18699,33,22,0,22,0
2020-07-24,Riverside,065,2383286,41790,34513,41,34554,631
2020-07-24,Sacramento,067,1510023,11357,8570,12,8582,110
2020-07-24,San Benito,069,59416,633,485,0,485,2
2020-07-24,San Bernardino,071,2135413,36932,28990,140,29130,386
2020-07-24,San Diego,073,3302833,30330,26100,3,26103,524
2020-07-24,San Francisco,075,870044,6749,5611,7,5618,55
2020-07-24,San Joaquin,077,732212,13249,10190,6,10196,118
2020-07-24,San Luis Obispo,079,281455,1934,1476,9,1485,8
2020-07-24,San Mateo,081,765935,5982,4954,8,4962,112
2020-07-24,Santa Barbara,083,443738,6364,5776,60,5836,30
2020-07-24,Santa Clara,085,1922200,11625,8658,29,8687,165
2020-07-24,Santa Cruz,087,273765,1180,930,8,938,4
2020-07-24,Shasta,089,179085,438,262,1,263,8
2020-07-24,Sierra,091,2930,2,1,0,1,0
2020-07-24,Siskiyou,093,43540,84,53,0,53,0
2020-07-24,Solano,095,438530,3941,3062,15,3077,29
2020-07-24,Sonoma,097,501317,3307,2345,6,2351,20
2020-07-24,Stanislaus,099,539301,10416,7861,12,7873,82
2020-07-24,Sutter,101,95872,742,593,0,593,2
2020-07-24,Tehama,103,63373,245,170,2,172,1
2020-07-24,Trinity,105,12862,25,3,6,9,0
2020-07-24,Tulare,107,460477,10287,8167,33,8200,167
2020-07-24,Tuolumne,109,53932,138,99,2,101,0
2020-07-24,Ventura,111,848112,8091,6553,28,6581,60
2020-07-24,Yolo,113,214977,1703,1329,3,1332,35
2020-07-24,Yuba,115,75493,410,307,0,307,1
2020-07-23,Alameda,001,1643700,12345,9924,39,9963,171
2020-07-23,Alpine,003,1148,2,2,0,2,0
2020-07-23,Amador,005,37829,120,61,0,61,0
2020-07-23,Butte,007,227075,1003,726,11,737,5
2020-07-23,Calaveras,009,45235,116,102,0,102,0
2020-07-23,Colusa,011,21464,329,242,0,242,2
2020-07-23,Contra Costa,013,1133247,8949,6619,25,6644,98
2020-07-23,Del Norte,015,27424,84,66,0,66,0
2020-07-23,El Dorado,017,186661,704,491,4,495,1
2020-07-23,Fresno,019,978130,19487,12164,173,12337,112
2020-07-23,Glenn,021,27897,344,246,0,246,1
2020-07-23,Humboldt,023,135768,240,208,1,209,4
2020-07-23,Imperial,025,180216,9993,7604,5,7609,138
2020-07-23,Inyo,027,18085,53,38,1,39,1
2020-07-23,Kern,029,883053,22148,14491,104,14595,128
2020-07-23,Kings,031,150075,4194,3371,25,3396,39
2020-07-23,Lake,033,64148,200,160,0,160,1
2020-07-23,Lassen,035,31185,571,503,2,505,0
2020-07-23,Los Angeles,037,10098052,186989,167198,416,167614,4265
2020-07-23,Madera,039,155013,2408,1659,4,1663,13
2020-07-23,Marin,041,260295,5054,4423,5,4428,22
2020-07-23,Mariposa,043,17540,55,40,0,40,1
2020-07-23,Mendocino,045,87422,250,178,0,178,0
2020-07-23,Merced,047,269075,4879,2972,2,2974,22
2020-07-23,Modoc,049,8938,3,0,0,0,0
2020-07-23,Mono,051,14174,131,82,1,83,1
2020-07-23,Monterey,053,433212,4669,3655,14,3669,21
2020-07-23,Napa,055,140530,1026,713,0,713,5
2020-07-23,Nevada,057,99092,314,247,14,261,1
2020-07-23,Orange,059,3164182,40491,32863,687,33550,544
2020-07-23,Placer,061,380077,2005,1519,3,1522,12
2020-07-23,Plumas,063,18699,32,21,0,21,0
2020-07-23,Riverside,065,2383286,41185,33833,41,33874,630
2020-07-23,Sacramento,067,1510023,11124,8222,12,8234,108
2020-07-23,San Benito,069,59416,618,478,0,478,2
2020-07-23,San Bernardino,071,2135413,36412,28121,134,28255,369
2020-07-23,San Diego,073,3302833,29956,25109,3,25112,505
2020-07-23,San Francisco,075,870044,6648,5543,7,5550,55
2020-07-23,San Joaquin,077,732212,13030,9861,6,9867,111
2020-07-23,San Luis Obispo,079,281455,1905,1438,9,1447,7
2020-07-23,San Mateo,081,765935,5877,4895,8,4903,113
2020-07-23,Santa Barbara,083,443738,6291,5628,60,5688,30
2020-07-23,Santa Clara,085,1922200,11407,8458,29,8487,165
2020-07-23,Santa Cruz,087,273765,1144,887,8,895,3
2020-07-23,Shasta,089,179085,427,254,1,255,9
2020-07-23,Sierra,091,2930,2,1,0,1,0
2020-07-23,Siskiyou,093,43540,82,53,0,53,0
2020-07-23,Solano,095,438530,3877,2962,13,2975,29
2020-07-23,Sonoma,097,501317,3231,2289,6,2295,18
2020-07-23,Stanislaus,099,539301,10174,7603,12,7615,71
2020-07-23,Sutter,101,95872,709,570,0,570,2
2020-07-23,Tehama,103,63373,239,158,2,160,1
2020-07-23,Trinity,105,12862,24,3,6,9,0
2020-07-23,Tulare,107,460477,10098,7898,33,7931,168
2020-07-23,Tuolumne,109,53932,138,93,2,95,0
2020-07-23,Ventura,111,848112,7967,6303,28,6331,56
2020-07-23,Yolo,113,214977,1684,1279,3,1282,35
2020-07-23,Yuba,115,75493,390,297,0,297,1
2020-07-22,Alameda,001,1643700,12127,9678,38,9716,169
2020-07-22,Alpine,003,1148,2,2,0,2,0
2020-07-22,Amador,005,37829,118,58,0,58,0
2020-07-22,Butte,007,227075,967,694,11,705,5
2020-07-22,Calaveras,009,45235,116,98,0,98,0
2020-07-22,Colusa,011,21464,322,236,0,236,0
2020-07-22,Contra Costa,013,1133247,8723,6401,25,6426,98
2020-07-22,Del Norte,015,27424,84,66,0,66,0
2020-07-22,El Dorado,017,186661,691,466,4,470,1
2020-07-22,Fresno,019,978130,19124,11756,167,11923,110
2020-07-22,Glenn,021,27897,338,236,0,236,1
2020-07-22,Humboldt,023,135768,238,201,1,202,4
2020-07-22,Imperial,025,180216,9933,7533,5,7538,134
2020-07-22,Inyo,027,18085,49,38,1,39,1
2020-07-22,Kern,029,883053,21716,13513,96,13609,127
2020-07-22,Kings,031,150075,4138,3271,25,3296,38
2020-07-22,Lake,033,64148,197,160,0,160,1
2020-07-22,Lassen,035,31185,568,500,2,502,0
2020-07-22,Los Angeles,037,10098052,184337,165242,394,165636,4218
2020-07-22,Madera,039,155013,2333,1578,4,1582,10
2020-07-22,Marin,041,260295,4998,4373,5,4378,23
2020-07-22,Mariposa,043,17540,55,38,0,38,1
2020-07-22,Mendocino,045,87422,243,166,0,166,0
2020-07-22,Merced,047,269075,4753,2828,2,2830,15
2020-07-22,Modoc,049,8938,3,0,0,0,0
2020-07-22,Mono,051,14174,128,82,1,83,1
2020-07-22,Monterey,053,433212,4568,3533,14,3547,20
2020-07-22,Napa,055,140530,1004,687,0,687,5
2020-07-22,Nevada,057,99092,308,239,13,252,1
2020-07-22,Orange,059,3164182,39992,32047,678,32725,522
2020-07-22,Placer,061,380077,1949,1469,3,1472,12
2020-07-22,Plumas,063,18699,31,20,0,20,0
2020-07-22,Riverside,065,2383286,40549,33093,41,33134,612
2020-07-22,Sacramento,067,1510023,10862,8028,11,8039,106
2020-07-22,San Benito,069,59416,604,465,0,465,2
2020-07-22,San Bernardino,071,2135413,35890,26820,123,26943,348
2020-07-22,San Diego,073,3302833,29568,25109,2,25111,505
2020-07-22,San Francisco,075,870044,6544,5473,6,5479,53
2020-07-22,San Joaquin,077,732212,12754,9628,6,9634,102
2020-07-22,San Luis Obispo,079,281455,1859,1373,9,1382,7
2020-07-22,San Mateo,081,765935,5788,4796,8,4804,112
2020-07-22,Santa Barbara,083,443738,6207,5508,58,5566,29
2020-07-22,Santa Clara,085,1922200,11162,8266,29,8295,166
2020-07-22,Santa Cruz,087,273765,1120,866,8,874,3
2020-07-22,Shasta,089,179085,417,246,1,247,9
2020-07-22,Sierra,091,2930,1,1,0,1,0
2020-07-22,Siskiyou,093,43540,81,52,0,52,0
2020-07-22,Solano,095,438530,3816,2839,12,2851,29
2020-07-22,Sonoma,097,501317,3154,2255,6,2261,17
2020-07-22,Stanislaus,099,539301,10003,7401,12,7413,71
2020-07-22,Sutter,101,95872,685,551,0,551,2
2020-07-22,Tehama,103,63373,231,155,2,157,1
2020-07-22,Trinity,105,12862,23,3,6,9,0
2020-07-22,Tulare,107,460477,9865,7640,33,7673,167
2020-07-22,Tuolumne,109,53932,134,91,2,93,0
2020-07-22,Ventura,111,848112,7839,6223,26,6249,56
2020-07-22,Yolo,113,214977,1641,1233,3,1236,34
2020-07-22,Yuba,115,75493,375,288,0,288,1
2020-07-21,Alameda,001,1643700,11913,9390,38,9428,166
2020-07-21,Alpine,003,1148,2,2,0,2,0
2020-07-21,Amador,005,37829,113,55,0,55,0
2020-07-21,Butte,007,227075,922,659,10,669,5
2020-07-21,Calaveras,009,45235,110,96,0,96,0
2020-07-21,Colusa,011,21464,298,227,0,227,0
2020-07-21,Contra Costa,013,1133247,8481,6210,25,6235,98
2020-07-21,Del Norte,015,27424,84,66,0,66,0
2020-07-21,El Dorado,017,186661,683,440,4,444,1
2020-07-21,Fresno,019,978130,18724,11412,161,11573,107
2020-07-21,Glenn,021,27897,331,229,0,229,1
2020-07-21,Humboldt,023,135768,236,198,1,199,4
2020-07-21,Imperial,025,180216,9884,7458,5,7463,128
2020-07-21,Inyo,027,18085,48,38,1,39,1
2020-07-21,Kern,029,883053,21294,11998,90,12088,119
2020-07-21,Kings,031,150075,4073,3187,24,3211,38
2020-07-21,Lake,033,64148,197,157,0,157,1
2020-07-21,Lassen,035,31185,566,474,2,476,0
2020-07-21,Los Angeles,037,10098052,181347,162205,371,162576,4159
2020-07-21,Madera,039,155013,2268,1508,3,1511,10
2020-07-21,Marin,041,260295,4926,4318,5,4323,21
2020-07-21,Mariposa,043,17540,54,37,0,37,1
2020-07-21,Mendocino,045,87422,232,160,0,160,0
2020-07-21,Merced,047,269075,4574,2725,2,2727,15
2020-07-21,Modoc,049,8938,3,0,0,0,0
2020-07-21,Mono,051,14174,124,79,1,80,1
2020-07-21,Monterey,053,433212,4436,3404,13,3417,20
2020-07-21,Napa,055,140530,977,660,0,660,5
2020-07-21,Nevada,057,99092,306,228,11,239,1
2020-07-21,Orange,059,3164182,39495,31356,646,32002,515
2020-07-21,Placer,061,380077,1908,1413,3,1416,11
2020-07-21,Plumas,063,18699,31,19,0,19,0
2020-07-21,Riverside,065,2383286,39847,32231,41,32272,583
2020-07-21,Sacramento,067,1510023,10590,7789,10,7799,102
2020-07-21,San Benito,069,59416,593,444,0,444,2
2020-07-21,San Bernardino,071,2135413,35241,25323,116,25439,343
2020-07-21,San Diego,073,3302833,29119,24522,2,24524,487
2020-07-21,San Francisco,075,870044,6435,5377,6,5383,53
2020-07-21,San Joaquin,077,732212,12425,9150,6,9156,99
2020-07-21,San Luis Obispo,079,281455,1810,1338,9,1347,7
2020-07-21,San Mateo,081,765935,5696,4733,8,4741,111
2020-07-21,Santa Barbara,083,443738,6127,5422,57,5479,29
2020-07-21,Santa Clara,085,1922200,10899,7989,29,8018,164
2020-07-21,Santa Cruz,087,273765,1087,835,8,843,3
2020-07-21,Shasta,089,179085,409,241,1,242,9
2020-07-21,Sierra,091,2930,1,1,0,1,0
2020-07-21,Siskiyou,093,43540,81,48,0,48,0
2020-07-21,Solano,095,438530,3743,2727,12,2739,27
2020-07-21,Sonoma,097,501317,3097,2200,6,2206,17
2020-07-21,Stanislaus,099,539301,9740,6984,12,6996,69
2020-07-21,Sutter,101,95872,669,533,0,533,2
2020-07-21,Tehama,103,63373,221,150,2,152,1
2020-07-21,Trinity,105,12862,23,2,6,8,0
2020-07-21,Tulare,107,460477,9663,7447,33,7480,167
2020-07-21,Tuolumne,109,53932,132,75,2,77,0
2020-07-21,Ventura,111,848112,7707,6131,26,6157,55
2020-07-21,Yolo,113,214977,1587,1204,3,1207,34
2020-07-21,Yuba,115,75493,369,269,0,269,1
2020-07-20,Alameda,001,1643700,11658,9244,37,9281,162
2020-07-20,Alpine,003,1148,2,2,0,2,0
2020-07-20,Amador,005,37829,110,53,0,53,0
2020-07-20,Butte,007,227075,885,586,10,596,4
2020-07-20,Calaveras,009,45235,107,90,0,90,0
2020-07-20,Colusa,011,21464,287,217,0,217,0
2020-07-20,Contra Costa,013,1133247,8273,5823,25,5848,97
2020-07-20,Del Norte,015,27424,84,61,0,61,0
2020-07-20,El Dorado,017,186661,660,407,4,411,0
2020-07-20,Fresno,019,978130,18283,10891,160,11051,106
2020-07-20,Glenn,021,27897,323,225,0,225,1
2020-07-20,Humboldt,023,135768,229,194,1,195,4
2020-07-20,Imperial,025,180216,9844,7337,5,7342,124
2020-07-20,Inyo,027,18085,46,38,1,39,1
2020-07-20,Kern,029,883053,20784,10908,86,10994,118
2020-07-20,Kings,031,150075,4023,3093,24,3117,37
2020-07-20,Lake,033,64148,194,147,0,147,1
2020-07-20,Lassen,035,31185,564,474,2,476,0
2020-07-20,Los Angeles,037,10098052,178384,159202,344,159546,4108
2020-07-20,Madera,039,155013,2193,1433,3,1436,10
2020-07-20,Marin,041,260295,4844,4255,5,4260,21
2020-07-20,Mariposa,043,17540,53,36,0,36,1
2020-07-20,Mendocino,045,87422,219,153,0,153,0
2020-07-20,Merced,047,269075,4404,2584,2,2586,15
2020-07-20,Modoc,049,8938,3,0,0,0,0
2020-07-20,Mono,051,14174,118,78,1,79,1
2020-07-20,Monterey,053,433212,4330,3205,13,3218,19
2020-07-20,Napa,055,140530,942,632,0,632,5
2020-07-20,Nevada,057,99092,298,218,11,229,1
2020-07-20,Orange,059,3164182,38885,30337,616,30953,507
2020-07-20,Placer,061,380077,1857,1364,3,1367,11
2020-07-20,Plumas,063,18699,30,17,0,17,0
2020-07-20,Riverside,065,2383286,39016,31163,41,31204,581
2020-07-20,Sacramento,067,1510023,10262,7369,10,7379,99
2020-07-20,San Benito,069,59416,575,433,0,433,2
2020-07-20,San Bernardino,071,2135413,34430,24226,112,24338,338
2020-07-20,San Diego,073,3302833,28677,24137,2,24139,478
2020-07-20,San Francisco,075,870044,6314,5090,6,5096,53
2020-07-20,San Joaquin,077,732212,12069,8583,6,8589,97
2020-07-20,San Luis Obispo,079,281455,1768,1282,9,1291,6
2020-07-20,San Mateo,081,765935,5595,4609,8,4617,111
2020-07-20,Santa Barbara,083,443738,6017,5266,55,5321,29
2020-07-20,Santa Clara,085,1922200,10670,7711,28,7739,164
2020-07-20,Santa Cruz,087,273765,1055,758,8,766,3
2020-07-20,Shasta,089,179085,394,233,1,234,9
2020-07-20,Sierra,091,2930,1,1,0,1,0
2020-07-20,Siskiyou,093,43540,77,42,0,42,0
2020-07-20,Solano,095,438530,3660,2537,12,2549,26
2020-07-20,Sonoma,097,501317,2990,2148,6,2154,17
2020-07-20,Stanislaus,099,539301,9456,6835,12,6847,58
2020-07-20,Sutter,101,95872,636,507,0,507,2
2020-07-20,Tehama,103,63373,211,146,2,148,1
2020-07-20,Trinity,105,12862,23,2,6,8,0
2020-07-20,Tulare,107,460477,9429,6974,33,7007,166
2020-07-20,Tuolumne,109,53932,131,75,2,77,0
2020-07-20,Ventura,111,848112,7573,5912,26,5938,52
2020-07-20,Yolo,113,214977,1547,1155,3,1158,30
2020-07-20,Yuba,115,75493,349,258,0,258,1
2020-07-19,Alameda,001,1643700,11418,9227,31,9258,162
2020-07-19,Alpine,003,1148,2,2,0,2,0
2020-07-19,Amador,005,37829,103,51,0,51,0
2020-07-19,Butte,007,227075,860,555,10,565,4
2020-07-19,Calaveras,009,45235,105,89,0,89,0
2020-07-19,Colusa,011,21464,279,187,0,187,0
2020-07-19,Contra Costa,013,1133247,7982,5691,23,5714,95
2020-07-19,Del Norte,015,27424,83,61,0,61,0
2020-07-19,El Dorado,017,186661,642,385,4,389,0
2020-07-19,Fresno,019,978130,17759,10639,148,10787,106
2020-07-19,Glenn,021,27897,309,215,0,215,0
2020-07-19,Humboldt,023,135768,221,195,1,196,4
2020-07-19,Imperial,025,180216,9753,7280,5,7285,124
2020-07-19,Inyo,027,18085,42,38,1,39,1
2020-07-19,Kern,029,883053,20167,10094,79,10173,115
2020-07-19,Kings,031,150075,3937,3035,24,3059,37
2020-07-19,Lake,033,64148,189,144,0,144,1
2020-07-19,Lassen,035,31185,545,474,2,476,0
2020-07-19,Los Angeles,037,10098052,174937,156039,321,156360,4100
2020-07-19,Madera,039,155013,2116,1301,3,1304,10
2020-07-19,Marin,041,260295,4789,4172,5,4177,21
2020-07-19,Mariposa,043,17540,49,35,0,35,1
2020-07-19,Mendocino,045,87422,214,137,0,137,0
2020-07-19,Merced,047,269075,4197,2460,2,2462,15
2020-07-19,Modoc,049,8938,3,0,0,0,0
2020-07-19,Mono,051,14174,107,63,1,64,1
2020-07-19,Monterey,053,433212,4210,3079,13,3092,18
2020-07-19,Napa,055,140530,913,612,0,612,5
2020-07-19,Nevada,057,99092,292,210,11,221,1
2020-07-19,Orange,059,3164182,38321,29941,603,30544,505
2020-07-19,Placer,061,380077,1809,1246,3,1249,11
2020-07-19,Plumas,063,18699,30,17,0,17,0
2020-07-19,Riverside,065,2383286,38311,30340,41,30381,581
2020-07-19,Sacramento,067,1510023,9869,6985,10,6995,97
2020-07-19,San Benito,069,59416,559,412,0,412,2
2020-07-19,San Bernardino,071,2135413,33656,23928,100,24028,337
2020-07-19,San Diego,073,3302833,28176,23684,2,23686,478
2020-07-19,San Francisco,075,870044,6168,5094,6,5100,52
2020-07-19,San Joaquin,077,732212,11663,8308,6,8314,93
2020-07-19,San Luis Obispo,079,281455,1724,1262,8,1270,6
2020-07-19,San Mateo,081,765935,5490,4522,8,4530,110
2020-07-19,Santa Barbara,083,443738,5915,5145,52,5197,29
2020-07-19,Santa Clara,085,1922200,10426,7403,28,7431,164
2020-07-19,Santa Cruz,087,273765,1011,753,8,761,3
2020-07-19,Shasta,089,179085,381,218,1,219,9
2020-07-19,Sierra,091,2930,1,1,0,1,0
2020-07-19,Siskiyou,093,43540,75,42,0,42,0
2020-07-19,Solano,095,438530,3555,2551,12,2563,26
2020-07-19,Sonoma,097,501317,2890,2074,6,2080,17
2020-07-19,Stanislaus,099,539301,9160,6508,12,6520,58
2020-07-19,Sutter,101,95872,605,480,0,480,2
2020-07-19,Tehama,103,63373,207,138,2,140,1
2020-07-19,Trinity,105,12862,23,2,6,8,0
2020-07-19,Tulare,107,460477,9181,6856,33,6889,166
2020-07-19,Tuolumne,109,53932,126,75,2,77,0
2020-07-19,Ventura,111,848112,7383,5706,26,5732,52
2020-07-19,Yolo,113,214977,1507,1127,3,1130,30
2020-07-19,Yuba,115,75493,329,240,0,240,1
2020-07-18,Alameda,001,1643700,11281,9089,30,9119,162
2020-07-18,Alpine,003,1148,2,2,0,2,0
2020-07-18,Amador,005,37829,99,49,0,49,0
2020-07-18,Butte,007,227075,851,551,10,561,4
2020-07-18,Calaveras,009,45235,101,89,0,89,0
2020-07-18,Colusa,011,21464,274,182,0,182,0
2020-07-18,Contra Costa,013,1133247,7848,5617,23,5640,95
2020-07-18,Del Norte,015,27424,83,61,0,61,0
2020-07-18,El Dorado,017,186661,639,385,4,389,0
2020-07-18,Fresno,019,978130,17510,10381,146,10527,106
2020-07-18,Glenn,021,27897,303,212,0,212,0
2020-07-18,Humboldt,023,135768,218,189,1,190,4
2020-07-18,Imperial,025,180216,9722,7268,5,7273,124
2020-07-18,Inyo,027,18085,42,38,1,39,1
2020-07-18,Kern,029,883053,19864,9250,76,9326,114
2020-07-18,Kings,031,150075,3897,2996,23,3019,37
2020-07-18,Lake,033,64148,186,142,0,142,1
2020-07-18,Lassen,035,31185,544,474,2,476,0
2020-07-18,Los Angeles,037,10098052,173491,153265,311,153576,4088
2020-07-18,Madera,039,155013,2070,1260,3,1263,9
2020-07-18,Marin,041,260295,4760,4089,5,4094,21
2020-07-18,Mariposa,043,17540,49,35,0,35,1
2020-07-18,Mendocino,045,87422,208,137,0,137,0
2020-07-18,Merced,047,269075,4078,2424,2,2426,15
2020-07-18,Modoc,049,8938,3,0,0,0,0
2020-07-18,Mono,051,14174,105,54,1,55,1
2020-07-18,Monterey,053,433212,4142,3020,13,3033,17
2020-07-18,Napa,055,140530,902,609,0,609,5
2020-07-18,Nevada,057,99092,288,204,10,214,1
2020-07-18,Orange,059,3164182,38002,29603,582,30185,493
2020-07-18,Placer,061,380077,1786,1233,3,1236,11
2020-07-18,Plumas,063,18699,30,17,0,17,0
2020-07-18,Riverside,065,2383286,37957,30245,40,30285,581
2020-07-18,Sacramento,067,1510023,9624,6739,10,6749,95
2020-07-18,San Benito,069,59416,544,407,0,407,2
2020-07-18,San Bernardino,071,2135413,33196,23680,93,23773,336
2020-07-18,San Diego,073,3302833,27873,23116,2,23118,478
2020-07-18,San Francisco,075,870044,6066,5051,6,5057,52
2020-07-18,San Joaquin,077,732212,11450,8118,6,8124,93
2020-07-18,San Luis Obispo,079,281455,1689,1234,8,1242,6
2020-07-18,San Mateo,081,765935,5430,4488,8,4496,110
2020-07-18,Santa Barbara,083,443738,5855,5110,50,5160,29
2020-07-18,Santa Clara,085,1922200,10276,7255,27,7282,164
2020-07-18,Santa Cruz,087,273765,994,751,8,759,3
2020-07-18,Shasta,089,179085,372,216,1,217,9
2020-07-18,Sierra,091,2930,1,1,0,1,0
2020-07-18,Siskiyou,093,43540,71,42,0,42,0
2020-07-18,Solano,095,438530,3514,2503,12,2515,26
2020-07-18,Sonoma,097,501317,2839,2019,6,2025,15
2020-07-18,Stanislaus,099,539301,9025,6344,12,6356,58
2020-07-18,Sutter,101,95872,599,473,0,473,2
2020-07-18,Tehama,103,63373,202,136,2,138,1
2020-07-18,Trinity,105,12862,23,2,6,8,0
2020-07-18,Tulare,107,460477,9090,6810,32,6842,167
2020-07-18,Tuolumne,109,53932,123,75,2,77,0
2020-07-18,Ventura,111,848112,7301,5630,26,5656,52
2020-07-18,Yolo,113,214977,1479,1077,3,1080,30
2020-07-18,Yuba,115,75493,318,237,0,237,1
2020-07-17,Alameda,001,1643700,11141,8893,29,8922,160
2020-07-17,Alpine,003,1148,2,1,0,1,0
2020-07-17,Amador,005,37829,97,48,0,48,0
2020-07-17,Butte,007,227075,837,497,10,507,4
2020-07-17,Calaveras,009,45235,99,86,0,86,0
2020-07-17,Colusa,011,21464,272,146,0,146,0
2020-07-17,Contra Costa,013,1133247,7700,5483,23,5506,93
2020-07-17,Del Norte,015,27424,82,60,0,60,0
2020-07-17,El Dorado,017,186661,623,368,4,372,0
2020-07-17,Fresno,019,978130,17212,9954,146,10100,104
2020-07-17,Glenn,021,27897,296,203,0,203,0
2020-07-17,Humboldt,023,135768,217,185,1,186,4
2020-07-17,Imperial,025,180216,9700,7193,5,7198,120
2020-07-17,Inyo,027,18085,42,38,1,39,1
2020-07-17,Kern,029,883053,19544,8291,75,8366,113
2020-07-17,Kings,031,150075,3858,2978,23,3001,37
2020-07-17,Lake,033,64148,184,139,0,139,1
2020-07-17,Lassen,035,31185,525,391,2,393,0
2020-07-17,Los Angeles,037,10098052,171120,150481,299,150780,4052
2020-07-17,Madera,039,155013,2026,1214,3,1217,9
2020-07-17,Marin,041,260295,4723,3839,5,3844,21
2020-07-17,Mariposa,043,17540,47,35,0,35,1
2020-07-17,Mendocino,045,87422,200,126,0,126,0
2020-07-17,Merced,047,269075,4002,2328,2,2330,12
2020-07-17,Modoc,049,8938,2,0,0,0,0
2020-07-17,Mono,051,14174,100,54,1,55,1
2020-07-17,Monterey,053,433212,4013,2922,13,2935,18
2020-07-17,Napa,055,140530,888,598,0,598,5
2020-07-17,Nevada,057,99092,281,200,10,210,1
2020-07-17,Orange,059,3164182,37539,28962,549,29511,485
2020-07-17,Placer,061,380077,1757,1207,3,1210,11
2020-07-17,Plumas,063,18699,27,16,0,16,0
2020-07-17,Riverside,065,2383286,37358,29639,40,29679,580
2020-07-17,Sacramento,067,1510023,9380,6563,10,6573,95
2020-07-17,San Benito,069,59416,529,399,0,399,2
2020-07-17,San Bernardino,071,2135413,32676,23057,90,23147,322
2020-07-17,San Diego,073,3302833,27485,22491,2,22493,472
2020-07-17,San Francisco,075,870044,5972,4967,6,4973,52
2020-07-17,San Joaquin,077,732212,11206,7925,6,7931,86
2020-07-17,San Luis Obispo,079,281455,1652,1190,8,1198,6
2020-07-17,San Mateo,081,765935,5333,4407,8,4415,110
2020-07-17,Santa Barbara,083,443738,5783,5001,49,5050,29
2020-07-17,Santa Clara,085,1922200,10058,7080,27,7107,164
2020-07-17,Santa Cruz,087,273765,972,716,8,724,3
2020-07-17,Shasta,089,179085,360,213,1,214,8
2020-07-17,Sierra,091,2930,1,1,0,1,0
2020-07-17,Siskiyou,093,43540,70,40,0,40,0
2020-07-17,Solano,095,438530,3465,2452,12,2464,26
2020-07-17,Sonoma,097,501317,2790,1982,6,1988,15
2020-07-17,Stanislaus,099,539301,8851,6220,12,6232,56
2020-07-17,Sutter,101,95872,586,458,0,458,2
2020-07-17,Tehama,103,63373,198,128,2,130,1
2020-07-17,Trinity,105,12862,23,2,6,8,0
2020-07-17,Tulare,107,460477,8954,6671,32,6703,166
2020-07-17,Tuolumne,109,53932,122,73,2,75,0
2020-07-17,Ventura,111,848112,7217,5451,26,5477,51
2020-07-17,Yolo,113,214977,1455,1055,3,1058,30
2020-07-17,Yuba,115,75493,308,231,0,231,1
2020-07-16,Alameda,001,1643700,10907,8719,24,8743,153
2020-07-16,Alpine,003,1148,2,1,0,1,0
2020-07-16,Amador,005,37829,94,46,0,46,0
2020-07-16,Butte,007,227075,800,465,9,474,4
2020-07-16,Calaveras,009,45235,97,82,0,82,0
2020-07-16,Colusa,011,21464,263,140,0,140,0
2020-07-16,Contra Costa,013,1133247,7488,5338,17,5355,91
2020-07-16,Del Norte,015,27424,82,60,0,60,0
2020-07-16,El Dorado,017,186661,606,357,4,361,0
2020-07-16,Fresno,019,978130,16701,9481,137,9618,101
2020-07-16,Glenn,021,27897,287,190,0,190,0
2020-07-16,Humboldt,023,135768,215,184,1,185,4
2020-07-16,Imperial,025,180216,9606,7148,5,7153,113
2020-07-16,Inyo,027,18085,42,38,1,39,1
2020-07-16,Kern,029,883053,19022,7435,73,7508,112
2020-07-16,Kings,031,150075,3691,2937,23,2960,37
2020-07-16,Lake,033,64148,179,128,0,128,1
2020-07-16,Lassen,035,31185,524,355,2,357,0
2020-07-16,Los Angeles,037,10098052,167899,147759,274,148033,3994
2020-07-16,Madera,039,155013,1962,1192,3,1195,8
2020-07-16,Marin,041,260295,4651,3546,5,3551,21
2020-07-16,Mariposa,043,17540,45,34,0,34,1
2020-07-16,Mendocino,045,87422,195,121,0,121,0
2020-07-16,Merced,047,269075,3840,2228,2,2230,12
2020-07-16,Modoc,049,8938,1,0,0,0,0
2020-07-16,Mono,051,14174,97,53,1,54,1
2020-07-16,Monterey,053,433212,3908,2857,12,2869,18
2020-07-16,Napa,055,140530,859,581,0,581,5
2020-07-16,Nevada,057,99092,278,191,10,201,1
2020-07-16,Orange,059,3164182,36837,28525,513,29038,471
2020-07-16,Placer,061,380077,1709,1168,3,1171,11
2020-07-16,Plumas,063,18699,25,16,0,16,0
2020-07-16,Riverside,065,2383286,36613,28904,38,28942,577
2020-07-16,Sacramento,067,1510023,9067,6440,9,6449,91
2020-07-16,San Benito,069,59416,512,389,0,389,2
2020-07-16,San Bernardino,071,2135413,31815,22355,72,22427,321
2020-07-16,San Diego,073,3302833,26998,21857,2,21859,465
2020-07-16,San Francisco,075,870044,5831,4838,6,4844,52
2020-07-16,San Joaquin,077,732212,10843,7713,6,7719,82
2020-07-16,San Luis Obispo,079,281455,1608,1146,8,1154,6
2020-07-16,San Mateo,081,765935,5229,4336,8,4344,110
2020-07-16,Santa Barbara,083,443738,5688,4872,48,4920,28
2020-07-16,Santa Clara,085,1922200,9778,6990,25,7015,164
2020-07-16,Santa Cruz,087,273765,931,698,8,706,3
2020-07-16,Shasta,089,179085,345,208,1,209,7
2020-07-16,Sierra,091,2930,1,1,0,1,0
2020-07-16,Siskiyou,093,43540,67,39,0,39,0
2020-07-16,Solano,095,438530,3371,2372,12,2384,25
2020-07-16,Sonoma,097,501317,2700,1954,6,1960,14
2020-07-16,Stanislaus,099,539301,8568,6077,11,6088,56
2020-07-16,Sutter,101,95872,570,444,0,444,2
2020-07-16,Tehama,103,63373,188,126,2,128,1
2020-07-16,Trinity,105,12862,23,2,5,7,0
2020-07-16,Tulare,107,460477,8738,6467,31,6498,163
2020-07-16,Tuolumne,109,53932,117,71,2,73,0
2020-07-16,Ventura,111,848112,7055,5231,26,5257,50
2020-07-16,Yolo,113,214977,1413,1034,3,1037,29
2020-07-16,Yuba,115,75493,290,221,0,221,1
2020-07-15,Alameda,001,1643700,10702,8615,19,8634,153
2020-07-15,Alpine,003,1148,2,1,0,1,0
2020-07-15,Amador,005,37829,73,44,0,44,0
2020-07-15,Butte,007,227075,758,420,9,429,4
2020-07-15,Calaveras,009,45235,97,75,0,75,0
2020-07-15,Colusa,011,21464,258,135,0,135,0
2020-07-15,Contra Costa,013,1133247,7257,5246,17,5263,90
2020-07-15,Del Norte,015,27424,81,60,0,60,0
2020-07-15,El Dorado,017,186661,582,339,4,343,0
2020-07-15,Fresno,019,978130,16227,9124,130,9254,101
2020-07-15,Glenn,021,27897,278,184,0,184,0
2020-07-15,Humboldt,023,135768,213,181,1,182,4
2020-07-15,Imperial,025,180216,9539,7110,5,7115,110
2020-07-15,Inyo,027,18085,42,36,1,37,1
2020-07-15,Kern,029,883053,18402,7155,70,7225,108
2020-07-15,Kings,031,150075,3630,2906,23,2929,37
2020-07-15,Lake,033,64148,177,122,0,122,1
2020-07-15,Lassen,035,31185,520,319,2,321,0
2020-07-15,Los Angeles,037,10098052,164434,143343,259,143602,3946
2020-07-15,Madera,039,155013,1893,1147,3,1150,4
2020-07-15,Marin,041,260295,4596,3458,5,3463,21
2020-07-15,Mariposa,043,17540,45,34,0,34,1
2020-07-15,Mendocino,045,87422,192,119,0,119,0
2020-07-15,Merced,047,269075,3690,2156,2,2158,12
2020-07-15,Modoc,049,8938,1,0,0,0,0
2020-07-15,Mono,051,14174,95,52,1,53,1
2020-07-15,Monterey,053,433212,3796,2780,12,2792,18
2020-07-15,Napa,055,140530,833,573,0,573,5
2020-07-15,Nevada,057,99092,274,185,8,193,1
2020-07-15,Orange,059,3164182,36037,27718,479,28197,454
2020-07-15,Placer,061,380077,1651,1145,3,1148,11
2020-07-15,Plumas,063,18699,25,16,0,16,0
2020-07-15,Riverside,065,2383286,35831,28492,36,28528,568
2020-07-15,Sacramento,067,1510023,8686,6217,9,6226,91
2020-07-15,San Benito,069,59416,503,388,0,388,2
2020-07-15,San Bernardino,071,2135413,31027,21508,56,21564,317
2020-07-15,San Diego,073,3302833,26531,21448,2,21450,448
2020-07-15,San Francisco,075,870044,5717,4757,6,4763,50
2020-07-15,San Joaquin,077,732212,10411,7381,5,7386,75
2020-07-15,San Luis Obispo,079,281455,1565,1097,8,1105,6
2020-07-15,San Mateo,081,765935,5116,4258,8,4266,109
2020-07-15,Santa Barbara,083,443738,5574,4733,48,4781,28
2020-07-15,Santa Clara,085,1922200,9474,6900,25,6925,164
2020-07-15,Santa Cruz,087,273765,895,660,7,667,3
2020-07-15,Shasta,089,179085,336,193,1,194,7
2020-07-15,Sierra,091,2930,1,1,0,1,0
2020-07-15,Siskiyou,093,43540,66,38,0,38,0
2020-07-15,Solano,095,438530,3276,2343,12,2355,25
2020-07-15,Sonoma,097,501317,2602,1920,6,1926,14
2020-07-15,Stanislaus,099,539301,8271,5777,11,5788,56
2020-07-15,Sutter,101,95872,544,433,0,433,2
2020-07-15,Tehama,103,63373,180,126,2,128,1
2020-07-15,Trinity,105,12862,22,2,5,7,0
2020-07-15,Tulare,107,460477,8527,6320,30,6350,156
2020-07-15,Tuolumne,109,53932,110,68,2,70,0
2020-07-15,Ventura,111,848112,6878,5087,26,5113,50
2020-07-15,Yolo,113,214977,1380,1002,3,1005,27
2020-07-15,Yuba,115,75493,278,221,0,221,1
2020-07-14,Alameda,001,1643700,10361,8388,13,8401,151
2020-07-14,Alpine,003,1148,2,1,0,1,0
2020-07-14,Amador,005,37829,69,44,0,44,0
2020-07-14,Butte,007,227075,712,382,9,391,4
2020-07-14,Calaveras,009,45235,95,74,0,74,0
2020-07-14,Colusa,011,21464,248,128,0,128,0
2020-07-14,Contra Costa,013,1133247,7020,5110,15,5125,90
2020-07-14,Del Norte,015,27424,80,60,0,60,0
2020-07-14,El Dorado,017,186661,567,324,4,328,0
2020-07-14,Fresno,019,978130,15807,8941,125,9066,98
2020-07-14,Glenn,021,27897,268,177,0,177,0
2020-07-14,Humboldt,023,135768,210,175,1,176,4
2020-07-14,Imperial,025,180216,9411,7095,5,7100,109
2020-07-14,Inyo,027,18085,42,35,1,36,1
2020-07-14,Kern,029,883053,17643,6979,57,7036,107
2020-07-14,Kings,031,150075,3563,2867,22,2889,37
2020-07-14,Lake,033,64148,171,120,0,120,1
2020-07-14,Lassen,035,31185,503,263,2,265,0
2020-07-14,Los Angeles,037,10098052,161298,140632,230,140862,3900
2020-07-14,Madera,039,155013,1819,1118,3,1121,4
2020-07-14,Marin,041,260295,4482,3451,5,3456,21
2020-07-14,Mariposa,043,17540,41,32,0,32,1
2020-07-14,Mendocino,045,87422,184,110,0,110,0
2020-07-14,Merced,047,269075,3511,2084,2,2086,12
2020-07-14,Modoc,049,8938,1,0,0,0,0
2020-07-14,Mono,051,14174,85,48,1,49,1
2020-07-14,Monterey,053,433212,3683,2724,12,2736,18
2020-07-14,Napa,055,140530,777,557,0,557,4
2020-07-14,Nevada,057,99092,257,180,7,187,1
2020-07-14,Orange,059,3164182,35157,26915,431,27346,432
2020-07-14,Placer,061,380077,1593,1122,3,1125,11
2020-07-14,Plumas,063,18699,24,14,0,14,0
2020-07-14,Riverside,065,2383286,35074,27850,35,27885,547
2020-07-14,Sacramento,067,1510023,8332,5978,9,5987,87
2020-07-14,San Benito,069,59416,484,360,0,360,2
2020-07-14,San Bernardino,071,2135413,30176,20489,46,20535,316
2020-07-14,San Diego,073,3302833,25911,20887,2,20889,436
2020-07-14,San Francisco,075,870044,5566,4659,5,4664,50
2020-07-14,San Joaquin,077,732212,9983,7143,5,7148,75
2020-07-14,San Luis Obispo,079,281455,1527,1060,8,1068,5
2020-07-14,San Mateo,081,765935,5023,4173,8,4181,108
2020-07-14,Santa Barbara,083,443738,5450,4641,46,4687,28
2020-07-14,Santa Clara,085,1922200,9146,6686,22,6708,164
2020-07-14,Santa Cruz,087,273765,856,639,7,646,3
2020-07-14,Shasta,089,179085,327,190,1,191,7
2020-07-14,Sierra,091,2930,1,1,0,1,0
2020-07-14,Siskiyou,093,43540,65,38,0,38,0
2020-07-14,Solano,095,438530,3177,2266,10,2276,25
2020-07-14,Sonoma,097,501317,2509,1866,6,1872,14
2020-07-14,Stanislaus,099,539301,7897,5631,10,5641,53
2020-07-14,Sutter,101,95872,525,405,0,405,2
2020-07-14,Tehama,103,63373,168,123,2,125,1
2020-07-14,Trinity,105,12862,21,2,5,7,0
2020-07-14,Tulare,107,460477,8281,6199,30,6229,156
2020-07-14,Tuolumne,109,53932,105,68,2,70,0
2020-07-14,Ventura,111,848112,6717,4950,26,4976,50
2020-07-14,Yolo,113,214977,1332,966,3,969,27
2020-07-14,Yuba,115,75493,261,210,0,210,1
2020-07-13,Alameda,001,1643700,10051,8115,13,8128,148
2020-07-13,Alpine,003,1148,2,1,0,1,0
2020-07-13,Amador,005,37829,65,42,0,42,0
2020-07-13,Butte,007,227075,676,354,9,363,4
2020-07-13,Calaveras,009,45235,87,63,0,63,0
2020-07-13,Colusa,011,21464,242,116,0,116,0
2020-07-13,Contra Costa,013,1133247,6748,4882,13,4895,88
2020-07-13,Del Norte,015,27424,74,59,0,59,0
2020-07-13,El Dorado,017,186661,536,298,4,302,0
2020-07-13,Fresno,019,978130,15378,8666,120,8786,95
2020-07-13,Glenn,021,27897,261,168,0,168,0
2020-07-13,Humboldt,023,135768,205,174,1,175,4
2020-07-13,Imperial,025,180216,9326,7052,5,7057,109
2020-07-13,Inyo,027,18085,41,35,1,36,1
2020-07-13,Kern,029,883053,16958,6808,52,6860,107
2020-07-13,Kings,031,150075,3512,2824,22,2846,37
2020-07-13,Lake,033,64148,166,118,0,118,1
2020-07-13,Lassen,035,31185,498,237,2,239,0
2020-07-13,Los Angeles,037,10098052,158063,136368,216,136584,3829
2020-07-13,Madera,039,155013,1750,1059,3,1062,4
2020-07-13,Marin,041,260295,4378,3402,5,3407,21
2020-07-13,Mariposa,043,17540,40,31,0,31,1
2020-07-13,Mendocino,045,87422,180,87,0,87,0
2020-07-13,Merced,047,269075,3362,2007,2,2009,12
2020-07-13,Modoc,049,8938,1,0,0,0,0
2020-07-13,Mono,051,14174,81,47,0,47,1
2020-07-13,Monterey,053,433212,3560,2613,9,2622,18
2020-07-13,Napa,055,140530,741,534,0,534,4
2020-07-13,Nevada,057,99092,243,172,7,179,1
2020-07-13,Orange,059,3164182,34292,25978,399,26377,423
2020-07-13,Placer,061,380077,1548,1096,3,1099,11
2020-07-13,Plumas,063,18699,22,14,0,14,0
2020-07-13,Riverside,065,2383286,34149,27136,33,27169,545
2020-07-13,Sacramento,067,1510023,8035,5747,9,5756,85
2020-07-13,San Benito,069,59416,471,343,0,343,2
2020-07-13,San Bernardino,071,2135413,29299,19610,40,19650,313
2020-07-13,San Diego,073,3302833,25344,20348,2,20350,422
2020-07-13,San Francisco,075,870044,5439,4534,4,4538,50
2020-07-13,San Joaquin,077,732212,9567,6927,5,6932,71
2020-07-13,San Luis Obispo,079,281455,1496,989,8,997,5
2020-07-13,San Mateo,081,765935,4892,4057,8,4065,108
2020-07-13,Santa Barbara,083,443738,5336,4441,45,4486,28
2020-07-13,Santa Clara,085,1922200,8823,6488,21,6509,164
2020-07-13,Santa Cruz,087,273765,818,574,7,581,3
2020-07-13,Shasta,089,179085,316,185,1,186,6
2020-07-13,Sierra,091,2930,1,1,0,1,0
2020-07-13,Siskiyou,093,43540,61,37,0,37,0
2020-07-13,Solano,095,438530,3065,2046,10,2056,23
2020-07-13,Sonoma,097,501317,2398,1818,6,1824,14
2020-07-13,Stanislaus,099,539301,7594,5324,9,5333,53
2020-07-13,Sutter,101,95872,487,379,0,379,2
2020-07-13,Tehama,103,63373,155,112,2,114,1
2020-07-13,Trinity,105,12862,21,2,5,7,0
2020-07-13,Tulare,107,460477,8020,5930,28,5958,147
2020-07-13,Tuolumne,109,53932,97,56,2,58,0
2020-07-13,Ventura,111,848112,6527,4800,23,4823,50
2020-07-13,Yolo,113,214977,1286,941,3,944,27
2020-07-13,Yuba,115,75493,246,194,0,194,1
2020-07-12,Alameda,001,1643700,9780,8056,13,8069,148
2020-07-12,Alpine,003,1148,2,1,0,1,0
2020-07-12,Amador,005,37829,55,40,0,40,0
2020-07-12,Butte,007,227075,626,341,8,349,4
2020-07-12,Calaveras,009,45235,87,62,0,62,0
2020-07-12,Colusa,011,21464,208,116,0,116,0
2020-07-12,Contra Costa,013,1133247,6478,4708,11,4719,88
2020-07-12,Del Norte,015,27424,63,59,0,59,0
2020-07-12,El Dorado,017,186661,514,290,4,294,0
2020-07-12,Fresno,019,978130,14952,8407,115,8522,95
2020-07-12,Glenn,021,27897,248,166,0,166,0
2020-07-12,Humboldt,023,135768,201,174,1,175,4
2020-07-12,Imperial,025,180216,9209,6999,5,7004,109
2020-07-12,Inyo,027,18085,39,35,1,36,1
2020-07-12,Kern,029,883053,16215,6662,49,6711,105
2020-07-12,Kings,031,150075,3450,2779,22,2801,34
2020-07-12,Lake,033,64148,157,114,0,114,1
2020-07-12,Lassen,035,31185,491,237,2,239,0
2020-07-12,Los Angeles,037,10098052,154639,133830,187,134017,3816
2020-07-12,Madera,039,155013,1695,1025,3,1028,4
2020-07-12,Marin,041,260295,4301,3358,5,3363,21
2020-07-12,Mariposa,043,17540,39,31,0,31,1
2020-07-12,Mendocino,045,87422,161,88,0,88,0
2020-07-12,Merced,047,269075,3232,1908,2,1910,12
2020-07-12,Modoc,049,8938,1,0,0,0,0
2020-07-12,Mono,051,14174,71,45,0,45,1
2020-07-12,Monterey,053,433212,3445,2521,9,2530,18
2020-07-12,Napa,055,140530,709,519,0,519,4
2020-07-12,Nevada,057,99092,233,166,7,173,1
2020-07-12,Orange,059,3164182,33416,25399,390,25789,422
2020-07-12,Placer,061,380077,1491,1058,3,1061,11
2020-07-12,Plumas,063,18699,21,14,0,14,0
2020-07-12,Riverside,065,2383286,33391,26404,32,26436,542
2020-07-12,Sacramento,067,1510023,7723,5515,7,5522,85
2020-07-12,San Benito,069,59416,456,324,0,324,2
2020-07-12,San Bernardino,071,2135413,28387,19042,36,19078,312
2020-07-12,San Diego,073,3302833,24714,19929,2,19931,422
2020-07-12,San Francisco,075,870044,5289,4535,4,4539,50
2020-07-12,San Joaquin,077,732212,9205,6703,5,6708,71
2020-07-12,San Luis Obispo,079,281455,1449,972,7,979,5
2020-07-12,San Mateo,081,765935,4774,3988,8,3996,108
2020-07-12,Santa Barbara,083,443738,5206,4353,44,4397,28
2020-07-12,Santa Clara,085,1922200,8585,6252,20,6272,164
2020-07-12,Santa Cruz,087,273765,776,573,5,578,3
2020-07-12,Shasta,089,179085,310,173,1,174,6
2020-07-12,Sierra,091,2930,1,1,0,1,0
2020-07-12,Siskiyou,093,43540,59,36,0,36,0
2020-07-12,Solano,095,438530,2940,2037,10,2047,23
2020-07-12,Sonoma,097,501317,2304,1743,6,1749,13
2020-07-12,Stanislaus,099,539301,7290,5177,9,5186,53
2020-07-12,Sutter,101,95872,469,362,0,362,2
2020-07-12,Tehama,103,63373,148,111,2,113,1
2020-07-12,Trinity,105,12862,21,2,5,7,0
2020-07-12,Tulare,107,460477,7765,5864,27,5891,146
2020-07-12,Tuolumne,109,53932,89,52,2,54,0
2020-07-12,Ventura,111,848112,6311,4724,22,4746,50
2020-07-12,Yolo,113,214977,1245,889,3,892,27
2020-07-12,Yuba,115,75493,235,188,0,188,1
2020-07-11,Alameda,001,1643700,9678,7845,13,7858,148
2020-07-11,Alpine,003,1148,2,1,0,1,0
2020-07-11,Amador,005,37829,51,37,0,37,0
2020-07-11,Butte,007,227075,610,325,8,333,4
2020-07-11,Calaveras,009,45235,84,62,0,62,0
2020-07-11,Colusa,011,21464,203,110,0,110,0
2020-07-11,Contra Costa,013,1133247,6362,4650,11,4661,87
2020-07-11,Del Norte,015,27424,63,59,0,59,0
2020-07-11,El Dorado,017,186661,503,283,4,287,0
2020-07-11,Fresno,019,978130,14692,8086,113,8199,95
2020-07-11,Glenn,021,27897,240,161,0,161,0
2020-07-11,Humboldt,023,135768,200,174,1,175,4
2020-07-11,Imperial,025,180216,9170,6884,5,6889,109
2020-07-11,Inyo,027,18085,39,35,1,36,1
2020-07-11,Kern,029,883053,15858,6509,48,6557,103
2020-07-11,Kings,031,150075,3423,2753,22,2775,33
2020-07-11,Lake,033,64148,156,110,0,110,1
2020-07-11,Lassen,035,31185,490,237,2,239,0
2020-07-11,Los Angeles,037,10098052,152921,130479,177,130656,3802
2020-07-11,Madera,039,155013,1654,988,3,991,4
2020-07-11,Marin,041,260295,4273,3191,5,3196,21
2020-07-11,Mariposa,043,17540,39,31,0,31,1
2020-07-11,Mendocino,045,87422,157,88,0,88,0
2020-07-11,Merced,047,269075,3151,1851,2,1853,12
2020-07-11,Modoc,049,8938,1,0,0,0,0
2020-07-11,Mono,051,14174,68,45,0,45,1
2020-07-11,Monterey,053,433212,3356,2376,8,2384,18
2020-07-11,Napa,055,140530,697,509,0,509,4
2020-07-11,Nevada,057,99092,224,163,6,169,1
2020-07-11,Orange,059,3164182,33039,24430,376,24806,422
2020-07-11,Placer,061,380077,1456,1029,3,1032,11
2020-07-11,Plumas,063,18699,21,12,0,12,0
2020-07-11,Riverside,065,2383286,33000,25994,32,26026,538
2020-07-11,Sacramento,067,1510023,7549,5367,7,5374,84
2020-07-11,San Benito,069,59416,441,314,0,314,2
2020-07-11,San Bernardino,071,2135413,27950,18907,34,18941,310
2020-07-11,San Diego,073,3302833,24322,19371,2,19373,422
2020-07-11,San Francisco,075,870044,5193,4430,3,4433,50
2020-07-11,San Joaquin,077,732212,9027,6518,5,6523,72
2020-07-11,San Luis Obispo,079,281455,1401,930,7,937,4
2020-07-11,San Mateo,081,765935,4706,3956,8,3964,108
2020-07-11,Santa Barbara,083,443738,5137,4283,43,4326,28
2020-07-11,Santa Clara,085,1922200,8426,5959,20,5979,164
2020-07-11,Santa Cruz,087,273765,745,571,5,576,3
2020-07-11,Shasta,089,179085,303,168,1,169,6
2020-07-11,Sierra,091,2930,1,1,0,1,0
2020-07-11,Siskiyou,093,43540,59,36,0,36,0
2020-07-11,Solano,095,438530,2899,2034,10,2044,23
2020-07-11,Sonoma,097,501317,2266,1690,6,1696,13
2020-07-11,Stanislaus,099,539301,7149,4911,9,4920,51
2020-07-11,Sutter,101,95872,453,352,0,352,2
2020-07-11,Tehama,103,63373,146,111,2,113,1
2020-07-11,Trinity,105,12862,21,2,5,7,0
2020-07-11,Tulare,107,460477,7659,5780,27,5807,149
2020-07-11,Tuolumne,109,53932,87,50,2,52,0
2020-07-11,Ventura,111,848112,6215,4545,21,4566,49
2020-07-11,Yolo,113,214977,1216,833,3,836,27
2020-07-11,Yuba,115,75493,225,175,0,175,1
2020-07-10,Alameda,001,1643700,9521,7551,13,7564,147
2020-07-10,Alpine,003,1148,2,1,0,1,0
2020-07-10,Amador,005,37829,47,37,0,37,0
2020-07-10,Butte,007,227075,599,318,8,326,4
2020-07-10,Calaveras,009,45235,84,61,0,61,0
2020-07-10,Colusa,011,21464,197,103,0,103,0
2020-07-10,Contra Costa,013,1133247,6220,4482,11,4493,86
2020-07-10,Del Norte,015,27424,63,57,0,57,0
2020-07-10,El Dorado,017,186661,485,266,4,270,0
2020-07-10,Fresno,019,978130,14360,7760,110,7870,93
2020-07-10,Glenn,021,27897,235,157,0,157,0
2020-07-10,Humboldt,023,135768,199,168,1,169,4
2020-07-10,Imperial,025,180216,9125,6878,4,6882,98
2020-07-10,Inyo,027,18085,39,35,1,36,1
2020-07-10,Kern,029,883053,15425,6344,47,6391,102
2020-07-10,Kings,031,150075,3387,2707,22,2729,33
2020-07-10,Lake,033,64148,149,104,0,104,1
2020-07-10,Lassen,035,31185,489,235,2,237,0
2020-07-10,Los Angeles,037,10098052,150501,127503,171,127674,3750
2020-07-10,Madera,039,155013,1608,914,3,917,4
2020-07-10,Marin,041,260295,4210,3101,5,3106,21
2020-07-10,Mariposa,043,17540,38,31,0,31,1
2020-07-10,Mendocino,045,87422,149,88,0,88,0
2020-07-10,Merced,047,269075,3072,1802,2,1804,12
2020-07-10,Modoc,049,8938,1,0,0,0,0
2020-07-10,Mono,051,14174,67,45,0,45,1
2020-07-10,Monterey,053,433212,3278,2285,8,2293,18
2020-07-10,Napa,055,140530,686,496,0,496,4
2020-07-10,Nevada,057,99092,219,161,6,167,1
2020-07-10,Orange,059,3164182,32452,23692,373,24065,416
2020-07-10,Placer,061,380077,1414,1002,3,1005,11
2020-07-10,Plumas,063,18699,19,12,0,12,0
2020-07-10,Riverside,065,2383286,32482,25481,32,25513,533
2020-07-10,Sacramento,067,1510023,7294,5181,7,5188,81
2020-07-10,San Benito,069,59416,432,302,0,302,2
2020-07-10,San Bernardino,071,2135413,27426,18242,31,18273,308
2020-07-10,San Diego,073,3302833,23938,18862,2,18864,420
2020-07-10,San Francisco,075,870044,5102,4305,3,4308,50
2020-07-10,San Joaquin,077,732212,8794,6225,5,6230,67
2020-07-10,San Luis Obispo,079,281455,1363,891,7,898,4
2020-07-10,San Mateo,081,765935,4641,3844,8,3852,107
2020-07-10,Santa Barbara,083,443738,5040,4177,42,4219,28
2020-07-10,Santa Clara,085,1922200,8202,5819,20,5839,164
2020-07-10,Santa Cruz,087,273765,717,540,5,545,3
2020-07-10,Shasta,089,179085,299,158,1,159,6
2020-07-10,Sierra,091,2930,1,1,0,1,0
2020-07-10,Siskiyou,093,43540,59,31,0,31,0
2020-07-10,Solano,095,438530,2852,1950,10,1960,23
2020-07-10,Sonoma,097,501317,2219,1606,5,1611,13
2020-07-10,Stanislaus,099,539301,6979,4781,9,4790,46
2020-07-10,Sutter,101,95872,446,338,0,338,2
2020-07-10,Tehama,103,63373,145,107,2,109,1
2020-07-10,Trinity,105,12862,21,2,5,7,0
2020-07-10,Tulare,107,460477,7522,5677,27,5704,150
2020-07-10,Tuolumne,109,53932,86,49,2,51,0
2020-07-10,Ventura,111,848112,6101,4416,21,4437,48
2020-07-10,Yolo,113,214977,1192,794,3,797,27
2020-07-10,Yuba,115,75493,211,164,0,164,1
2020-07-09,Alameda,001,1643700,9285,7433,13,7446,146
2020-07-09,Alpine,003,1148,2,1,0,1,0
2020-07-09,Amador,005,37829,44,36,0,36,0
2020-07-09,Butte,007,227075,567,295,8,303,4
2020-07-09,Calaveras,009,45235,83,59,0,59,0
2020-07-09,Colusa,011,21464,189,97,0,97,0
2020-07-09,Contra Costa,013,1133247,5976,4388,11,4399,86
2020-07-09,Del Norte,015,27424,63,57,0,57,0
2020-07-09,El Dorado,017,186661,460,255,4,259,0
2020-07-09,Fresno,019,978130,13906,7385,107,7492,90
2020-07-09,Glenn,021,27897,225,150,0,150,0
2020-07-09,Humboldt,023,135768,196,166,1,167,4
2020-07-09,Imperial,025,180216,9028,6778,4,6782,87
2020-07-09,Inyo,027,18085,37,35,1,36,1
2020-07-09,Kern,029,883053,14780,6100,45,6145,95
2020-07-09,Kings,031,150075,3323,2686,21,2707,33
2020-07-09,Lake,033,64148,146,99,0,99,1
2020-07-09,Lassen,035,31185,433,221,2,223,0
2020-07-09,Los Angeles,037,10098052,147239,125062,148,125210,3698
2020-07-09,Madera,039,155013,1531,850,3,853,4
2020-07-09,Marin,041,260295,4058,2975,4,2979,20
2020-07-09,Mariposa,043,17540,38,32,0,32,1
2020-07-09,Mendocino,045,87422,145,88,0,88,0
2020-07-09,Merced,047,269075,2939,1728,2,1730,11
2020-07-09,Modoc,049,8938,1,0,0,0,0
2020-07-09,Mono,051,14174,63,45,0,45,1
2020-07-09,Monterey,053,433212,3153,2223,8,2231,17
2020-07-09,Napa,055,140530,669,468,0,468,4
2020-07-09,Nevada,057,99092,213,156,6,162,1
2020-07-09,Orange,059,3164182,31482,22960,355,23315,407
2020-07-09,Placer,061,380077,1372,982,3,985,11
2020-07-09,Plumas,063,18699,19,12,0,12,0
2020-07-09,Riverside,065,2383286,31589,24980,31,25011,529
2020-07-09,Sacramento,067,1510023,6967,4950,7,4957,81
2020-07-09,San Benito,069,59416,416,295,0,295,2
2020-07-09,San Bernardino,071,2135413,26553,17339,25,17364,307
2020-07-09,San Diego,073,3302833,23346,18404,2,18406,415
2020-07-09,San Francisco,075,870044,4970,4143,3,4146,50
2020-07-09,San Joaquin,077,732212,8435,6004,5,6009,66
2020-07-09,San Luis Obispo,079,281455,1323,869,7,876,3
2020-07-09,San Mateo,081,765935,4515,3792,8,3800,106
2020-07-09,Santa Barbara,083,443738,4908,4068,42,4110,28
2020-07-09,Santa Clara,085,1922200,7945,5638,19,5657,164
2020-07-09,Santa Cruz,087,273765,690,526,5,531,3
2020-07-09,Shasta,089,179085,293,155,1,156,5
2020-07-09,Sierra,091,2930,1,1,0,1,0
2020-07-09,Siskiyou,093,43540,55,31,0,31,0
2020-07-09,Solano,095,438530,2754,1892,10,1902,23
2020-07-09,Sonoma,097,501317,2133,1584,5,1589,13
2020-07-09,Stanislaus,099,539301,6664,4633,8,4641,46
2020-07-09,Sutter,101,95872,429,321,0,321,2
2020-07-09,Tehama,103,63373,140,102,2,104,1
2020-07-09,Trinity,105,12862,21,2,5,7,0
2020-07-09,Tulare,107,460477,7303,5501,26,5527,146
2020-07-09,Tuolumne,109,53932,85,47,2,49,0
2020-07-09,Ventura,111,848112,5933,4278,21,4299,47
2020-07-09,Yolo,113,214977,1144,764,3,767,27
2020-07-09,Yuba,115,75493,194,152,0,152,1
2020-07-08,Alameda,001,1643700,8993,7335,13,7348,142
2020-07-08,Alpine,003,1148,2,1,0,1,0
2020-07-08,Amador,005,37829,41,35,0,35,0
2020-07-08,Butte,007,227075,530,281,8,289,3
2020-07-08,Calaveras,009,45235,78,58,0,58,0
2020-07-08,Colusa,011,21464,176,90,0,90,0
2020-07-08,Contra Costa,013,1133247,5730,4268,9,4277,84
2020-07-08,Del Norte,015,27424,61,57,0,57,0
2020-07-08,El Dorado,017,186661,438,248,4,252,0
2020-07-08,Fresno,019,978130,13490,7102,99,7201,86
2020-07-08,Glenn,021,27897,214,146,0,146,0
2020-07-08,Humboldt,023,135768,193,162,1,163,4
2020-07-08,Imperial,025,180216,8941,6727,4,6731,76
2020-07-08,Inyo,027,18085,37,35,1,36,1
2020-07-08,Kern,029,883053,14202,5873,43,5916,91
2020-07-08,Kings,031,150075,3263,2629,18,2647,33
2020-07-08,Lake,033,64148,139,97,0,97,1
2020-07-08,Lassen,035,31185,337,221,2,223,0
2020-07-08,Los Angeles,037,10098052,144037,123462,121,123583,3650
2020-07-08,Madera,039,155013,1461,828,3,831,4
2020-07-08,Marin,041,260295,3959,2756,4,2760,17
2020-07-08,Mariposa,043,17540,38,31,0,31,1
2020-07-08,Mendocino,045,87422,132,84,0,84,0
2020-07-08,Merced,047,269075,2819,1578,2,1580,11
2020-07-08,Modoc,049,8938,1,0,0,0,0
2020-07-08,Mono,051,14174,60,45,0,45,1
2020-07-08,Monterey,053,433212,3035,2182,7,2189,17
2020-07-08,Napa,055,140530,647,468,0,468,4
2020-07-08,Nevada,057,99092,204,156,6,162,1
2020-07-08,Orange,059,3164182,30531,22088,350,22438,378
2020-07-08,Placer,061,380077,1325,948,3,951,11
2020-07-08,Plumas,063,18699,19,12,0,12,0
2020-07-08,Riverside,065,2383286,30625,24042,30,24072,508
2020-07-08,Sacramento,067,1510023,6679,4799,7,4806,80
2020-07-08,San Benito,069,59416,400,282,0,282,2
2020-07-08,San Bernardino,071,2135413,25699,16510,21,16531,296
2020-07-08,San Diego,073,3302833,22776,17844,2,17846,406
2020-07-08,San Francisco,075,870044,4881,4093,3,4096,50
2020-07-08,San Joaquin,077,732212,8092,5759,5,5764,61
2020-07-08,San Luis Obispo,079,281455,1271,825,7,832,2
2020-07-08,San Mateo,081,765935,4394,3733,8,3741,106
2020-07-08,Santa Barbara,083,443738,4789,3985,42,4027,28
2020-07-08,Santa Clara,085,1922200,7712,5510,19,5529,164
2020-07-08,Santa Cruz,087,273765,657,509,4,513,3
2020-07-08,Shasta,089,179085,284,148,1,149,6
2020-07-08,Sierra,091,2930,1,1,0,1,0
2020-07-08,Siskiyou,093,43540,55,31,0,31,0
2020-07-08,Solano,095,438530,2638,1821,10,1831,23
2020-07-08,Sonoma,097,501317,2057,1495,5,1500,9
2020-07-08,Stanislaus,099,539301,6364,4344,8,4352,46
2020-07-08,Sutter,101,95872,404,298,0,298,2
2020-07-08,Tehama,103,63373,134,100,2,102,1
2020-07-08,Trinity,105,12862,20,2,5,7,0
2020-07-08,Tulare,107,460477,7111,5307,21,5328,138
2020-07-08,Tuolumne,109,53932,81,42,2,44,0
2020-07-08,Ventura,111,848112,5768,4139,21,4160,47
2020-07-08,Yolo,113,214977,1100,727,3,730,26
2020-07-08,Yuba,115,75493,181,145,0,145,1
2020-07-07,Alameda,001,1643700,8672,7097,12,7109,141
2020-07-07,Alpine,003,1148,2,1,0,1,0
2020-07-07,Amador,005,37829,41,33,0,33,0
2020-07-07,Butte,007,227075,487,269,8,277,3
2020-07-07,Calaveras,009,45235,76,58,0,58,0
2020-07-07,Colusa,011,21464,143,84,0,84,0
2020-07-07,Contra Costa,013,1133247,5494,4131,8,4139,84
2020-07-07,Del Norte,015,27424,61,57,0,57,0
2020-07-07,El Dorado,017,186661,418,244,4,248,0
2020-07-07,Fresno,019,978130,13037,6738,99,6837,84
2020-07-07,Glenn,021,27897,205,145,0,145,0
2020-07-07,Humboldt,023,135768,190,150,1,151,4
2020-07-07,Imperial,025,180216,8842,6678,4,6682,51
2020-07-07,Inyo,027,18085,36,32,1,33,1
2020-07-07,Kern,029,883053,13503,5645,39,5684,88
2020-07-07,Kings,031,150075,3200,2623,16,2639,33
2020-07-07,Lake,033,64148,129,94,0,94,1
2020-07-07,Lassen,035,31185,266,219,2,221,0
2020-07-07,Los Angeles,037,10098052,140466,121026,113,121139,3588
2020-07-07,Madera,039,155013,1417,794,3,797,4
2020-07-07,Marin,041,260295,3870,2627,4,2631,17
2020-07-07,Mariposa,043,17540,38,31,0,31,1
2020-07-07,Mendocino,045,87422,124,82,0,82,0
2020-07-07,Merced,047,269075,2645,1531,2,1533,10
2020-07-07,Modoc,049,8938,1,0,0,0,0
2020-07-07,Mono,051,14174,59,42,0,42,1
2020-07-07,Monterey,053,433212,2892,2166,7,2173,17
2020-07-07,Napa,055,140530,628,459,0,459,4
2020-07-07,Nevada,057,99092,198,150,6,156,1
2020-07-07,Orange,059,3164182,29520,21741,336,22077,373
2020-07-07,Placer,061,380077,1284,930,3,933,11
2020-07-07,Plumas,063,18699,17,12,0,12,0
2020-07-07,Riverside,065,2383286,29609,23279,30,23309,499
2020-07-07,Sacramento,067,1510023,6337,4592,7,4599,76
2020-07-07,San Benito,069,59416,382,274,0,274,2
2020-07-07,San Bernardino,071,2135413,24830,16004,19,16023,277
2020-07-07,San Diego,073,3302833,22057,17580,2,17582,399
2020-07-07,San Francisco,075,870044,4788,4045,2,4047,50
2020-07-07,San Joaquin,077,732212,7750,5547,5,5552,59
2020-07-07,San Luis Obispo,079,281455,1210,795,7,802,2
2020-07-07,San Mateo,081,765935,4279,3691,8,3699,106
2020-07-07,Santa Barbara,083,443738,4661,3866,41,3907,27
2020-07-07,Santa Clara,085,1922200,7443,5438,19,5457,164
2020-07-07,Santa Cruz,087,273765,623,502,3,505,2
2020-07-07,Shasta,089,179085,271,144,1,145,6
2020-07-07,Sierra,091,2930,1,1,0,1,0
2020-07-07,Siskiyou,093,43540,54,30,0,30,0
2020-07-07,Solano,095,438530,2527,1776,9,1785,22
2020-07-07,Sonoma,097,501317,1986,1473,5,1478,8
2020-07-07,Stanislaus,099,539301,6025,4101,8,4109,46
2020-07-07,Sutter,101,95872,378,273,0,273,2
2020-07-07,Tehama,103,63373,125,95,2,97,1
2020-07-07,Trinity,105,12862,20,2,5,7,0
2020-07-07,Tulare,107,460477,6931,5189,19,5208,137
2020-07-07,Tuolumne,109,53932,75,40,2,42,0
2020-07-07,Ventura,111,848112,5599,3992,19,4011,46
2020-07-07,Yolo,113,214977,1032,706,3,709,26
2020-07-07,Yuba,115,75493,161,138,0,138,1
2020-07-06,Alameda,001,1643700,8434,6970,12,6982,141
2020-07-06,Alpine,003,1148,1,1,0,1,0
2020-07-06,Amador,005,37829,39,33,0,33,0
2020-07-06,Butte,007,227075,431,257,8,265,2
2020-07-06,Calaveras,009,45235,73,45,0,45,0
2020-07-06,Colusa,011,21464,134,80,0,80,0
2020-07-06,Contra Costa,013,1133247,5264,3901,7,3908,83
2020-07-06,Del Norte,015,27424,60,57,0,57,0
2020-07-06,El Dorado,017,186661,403,232,3,235,0
2020-07-06,Fresno,019,978130,12569,6364,93,6457,82
2020-07-06,Glenn,021,27897,197,129,0,129,0
2020-07-06,Humboldt,023,135768,188,148,1,149,3
2020-07-06,Imperial,025,180216,8723,6443,4,6447,47
2020-07-06,Inyo,027,18085,36,32,1,33,1
2020-07-06,Kern,029,883053,12697,5491,38,5529,82
2020-07-06,Kings,031,150075,3149,2583,11,2594,33
2020-07-06,Lake,033,64148,122,93,0,93,1
2020-07-06,Lassen,035,31185,264,219,2,221,0
2020-07-06,Los Angeles,037,10098052,136862,116707,99,116806,3541
2020-07-06,Madera,039,155013,1347,734,3,737,4
2020-07-06,Marin,041,260295,3630,2136,4,2140,17
2020-07-06,Mariposa,043,17540,36,31,0,31,1
2020-07-06,Mendocino,045,87422,107,72,0,72,0
2020-07-06,Merced,047,269075,2494,1396,2,1398,10
2020-07-06,Modoc,049,8938,1,0,0,0,0
2020-07-06,Mono,051,14174,58,40,0,40,1
2020-07-06,Monterey,053,433212,2803,2078,7,2085,15
2020-07-06,Napa,055,140530,610,454,0,454,4
2020-07-06,Nevada,057,99092,192,146,6,152,1
2020-07-06,Orange,059,3164182,28458,20167,298,20465,372
2020-07-06,Placer,061,380077,1222,904,3,907,11
2020-07-06,Plumas,063,18699,17,11,0,11,0
2020-07-06,Riverside,065,2383286,28554,22485,29,22514,477
2020-07-06,Sacramento,067,1510023,5986,4420,7,4427,71
2020-07-06,San Benito,069,59416,367,264,0,264,2
2020-07-06,San Bernardino,071,2135413,23977,15346,16,15362,272
2020-07-06,San Diego,073,3302833,21325,17002,2,17004,387
2020-07-06,San Francisco,075,870044,4667,3861,2,3863,50
2020-07-06,San Joaquin,077,732212,7380,5104,5,5109,57
2020-07-06,San Luis Obispo,079,281455,1152,751,7,758,2
2020-07-06,San Mateo,081,765935,4187,3650,7,3657,106
2020-07-06,Santa Barbara,083,443738,4524,3763,40,3803,27
2020-07-06,Santa Clara,085,1922200,7172,5369,19,5388,165
2020-07-06,Santa Cruz,087,273765,601,466,2,468,2
2020-07-06,Shasta,089,179085,261,143,1,144,6
2020-07-06,Sierra,091,2930,1,1,0,1,0
2020-07-06,Siskiyou,093,43540,50,30,0,30,0
2020-07-06,Solano,095,438530,2394,1668,9,1677,22
2020-07-06,Sonoma,097,501317,1922,1369,5,1374,8
2020-07-06,Stanislaus,099,539301,5623,3983,8,3991,46
2020-07-06,Sutter,101,95872,351,250,0,250,2
2020-07-06,Tehama,103,63373,122,95,2,97,1
2020-07-06,Trinity,105,12862,19,2,5,7,0
2020-07-06,Tulare,107,460477,6726,5039,17,5056,136
2020-07-06,Tuolumne,109,53932,72,30,2,32,0
2020-07-06,Ventura,111,848112,5406,3912,19,3931,44
2020-07-06,Yolo,113,214977,976,685,3,688,26
2020-07-06,Yuba,115,75493,147,124,0,124,1
2020-07-05,Alameda,001,1643700,8182,6861,12,6873,141
2020-07-05,Alpine,003,1148,1,1,0,1,0
2020-07-05,Amador,005,37829,37,31,0,31,0
2020-07-05,Butte,007,227075,396,248,8,256,2
2020-07-05,Calaveras,009,45235,69,45,0,45,0
2020-07-05,Colusa,011,21464,124,79,0,79,0
2020-07-05,Contra Costa,013,1133247,5024,3665,6,3671,80
2020-07-05,Del Norte,015,27424,60,57,0,57,0
2020-07-05,El Dorado,017,186661,385,227,3,230,0
2020-07-05,Fresno,019,978130,12003,6186,92,6278,82
2020-07-05,Glenn,021,27897,194,129,0,129,0
2020-07-05,Humboldt,023,135768,184,147,1,148,3
2020-07-05,Imperial,025,180216,8589,6441,4,6445,47
2020-07-05,Inyo,027,18085,35,32,1,33,1
2020-07-05,Kern,029,883053,11988,5351,38,5389,82
2020-07-05,Kings,031,150075,3066,2546,10,2556,31
2020-07-05,Lake,033,64148,122,92,0,92,1
2020-07-05,Lassen,035,31185,258,219,2,221,0
2020-07-05,Los Angeles,037,10098052,133636,115133,93,115226,3495
2020-07-05,Madera,039,155013,1269,564,3,567,4
2020-07-05,Marin,041,260295,3447,2080,4,2084,17
2020-07-05,Mariposa,043,17540,36,31,0,31,1
2020-07-05,Mendocino,045,87422,104,72,0,72,0
2020-07-05,Merced,047,269075,2349,1340,2,1342,10
2020-07-05,Modoc,049,8938,1,0,0,0,0
2020-07-05,Mono,051,14174,54,39,0,39,1
2020-07-05,Monterey,053,433212,2700,1994,7,2001,15
2020-07-05,Napa,055,140530,580,450,0,450,4
2020-07-05,Nevada,057,99092,186,141,6,147,1
2020-07-05,Orange,059,3164182,27517,19430,285,19715,372
2020-07-05,Placer,061,380077,1165,855,3,858,11
2020-07-05,Plumas,063,18699,16,11,0,11,0
2020-07-05,Riverside,065,2383286,27698,21511,29,21540,474
2020-07-05,Sacramento,067,1510023,5670,4265,6,4271,71
2020-07-05,San Benito,069,59416,348,258,0,258,2
2020-07-05,San Bernardino,071,2135413,23099,15026,16,15042,270
2020-07-05,San Diego,073,3302833,20634,16728,2,16730,387
2020-07-05,San Francisco,075,870044,4549,3861,2,3863,50
2020-07-05,San Joaquin,077,732212,7061,5015,5,5020,57
2020-07-05,San Luis Obispo,079,281455,1073,730,7,737,2
2020-07-05,San Mateo,081,765935,4076,3575,7,3582,106
2020-07-05,Santa Barbara,083,443738,4377,3671,37,3708,27
2020-07-05,Santa Clara,085,1922200,6879,5237,19,5256,162
2020-07-05,Santa Cruz,087,273765,583,467,0,467,2
2020-07-05,Shasta,089,179085,255,138,1,139,6
2020-07-05,Sierra,091,2930,1,1,0,1,0
2020-07-05,Siskiyou,093,43540,46,30,0,30,0
2020-07-05,Solano,095,438530,2274,1547,9,1556,22
2020-07-05,Sonoma,097,501317,1841,1369,5,1374,8
2020-07-05,Stanislaus,099,539301,5292,3777,7,3784,45
2020-07-05,Sutter,101,95872,323,241,0,241,2
2020-07-05,Tehama,103,63373,120,95,2,97,1
2020-07-05,Trinity,105,12862,19,2,5,7,0
2020-07-05,Tulare,107,460477,6467,4981,15,4996,135
2020-07-05,Tuolumne,109,53932,67,30,2,32,0
2020-07-05,Ventura,111,848112,5203,3866,19,3885,44
2020-07-05,Yolo,113,214977,936,644,3,647,26
2020-07-05,Yuba,115,75493,137,115,0,115,1
2020-07-04,Alameda,001,1643700,8070,6737,12,6749,141
2020-07-04,Alpine,003,1148,1,1,0,1,0
2020-07-04,Amador,005,37829,36,31,0,31,0
2020-07-04,Butte,007,227075,378,224,8,232,2
2020-07-04,Calaveras,009,45235,69,45,0,45,0
2020-07-04,Colusa,011,21464,123,76,0,76,0
2020-07-04,Contra Costa,013,1133247,4876,3583,6,3589,80
2020-07-04,Del Norte,015,27424,60,50,0,50,0
2020-07-04,El Dorado,017,186661,366,211,3,214,0
2020-07-04,Fresno,019,978130,11686,5999,90,6089,82
2020-07-04,Glenn,021,27897,187,128,0,128,0
2020-07-04,Humboldt,023,135768,177,144,1,145,3
2020-07-04,Imperial,025,180216,8540,6441,4,6445,47
2020-07-04,Inyo,027,18085,35,32,1,33,1
2020-07-04,Kern,029,883053,11684,5231,38,5269,81
2020-07-04,Kings,031,150075,3023,2509,10,2519,31
2020-07-04,Lake,033,64148,115,86,0,86,1
2020-07-04,Lassen,035,31185,258,219,2,221,0
2020-07-04,Los Angeles,037,10098052,131820,107256,82,107338,3462
2020-07-04,Madera,039,155013,1223,568,3,571,4
2020-07-04,Marin,041,260295,3418,1962,4,1966,17
2020-07-04,Mariposa,043,17540,36,28,0,28,1
2020-07-04,Mendocino,045,87422,104,72,0,72,0
2020-07-04,Merced,047,269075,2247,1252,2,1254,10
2020-07-04,Modoc,049,8938,1,0,0,0,0
2020-07-04,Mono,051,14174,54,37,0,37,1
2020-07-04,Monterey,053,433212,2620,1878,7,1885,15
2020-07-04,Napa,055,140530,571,426,0,426,4
2020-07-04,Nevada,057,99092,183,125,6,131,1
2020-07-04,Orange,059,3164182,27084,19247,272,19519,372
2020-07-04,Placer,061,380077,1130,796,3,799,11
2020-07-04,Plumas,063,18699,16,11,0,11,0
2020-07-04,Riverside,065,2383286,27331,21508,29,21537,474
2020-07-04,Sacramento,067,1510023,5499,4039,6,4045,71
2020-07-04,San Benito,069,59416,335,255,0,255,2
2020-07-04,San Bernardino,071,2135413,22674,14636,14,14650,270
2020-07-04,San Diego,073,3302833,20174,16166,2,16168,387
2020-07-04,San Francisco,075,870044,4457,3861,2,3863,50
2020-07-04,San Joaquin,077,732212,6849,4807,5,4812,57
2020-07-04,San Luis Obispo,079,281455,1033,699,7,706,2
2020-07-04,San Mateo,081,765935,4013,3532,7,3539,106
2020-07-04,Santa Barbara,083,443738,4302,3520,35,3555,27
2020-07-04,Santa Clara,085,1922200,6687,5045,18,5063,161
2020-07-04,Santa Cruz,087,273765,573,466,0,466,2
2020-07-04,Shasta,089,179085,252,135,1,136,6
2020-07-04,Sierra,091,2930,1,1,0,1,0
2020-07-04,Siskiyou,093,43540,39,30,0,30,0
2020-07-04,Solano,095,438530,2238,1548,9,1557,22
2020-07-04,Sonoma,097,501317,1815,1370,5,1375,8
2020-07-04,Stanislaus,099,539301,5134,3572,7,3579,44
2020-07-04,Sutter,101,95872,304,225,0,225,2
2020-07-04,Tehama,103,63373,117,92,2,94,1
2020-07-04,Trinity,105,12862,19,2,5,7,0
2020-07-04,Tulare,107,460477,6355,4802,14,4816,135
2020-07-04,Tuolumne,109,53932,63,30,2,32,0
2020-07-04,Ventura,111,848112,5079,3687,19,3706,44
2020-07-04,Yolo,113,214977,911,615,3,618,26
2020-07-04,Yuba,115,75493,130,102,0,102,1
2020-07-03,Alameda,001,1643700,7949,6486,12,6498,141
2020-07-03,Alpine,003,1148,1,1,0,1,0
2020-07-03,Amador,005,37829,36,25,0,25,0
2020-07-03,Butte,007,227075,366,212,8,220,2
2020-07-03,Calaveras,009,45235,69,44,0,44,0
2020-07-03,Colusa,011,21464,117,70,0,70,0
2020-07-03,Contra Costa,013,1133247,4742,3447,6,3453,78
2020-07-03,Del Norte,015,27424,60,50,0,50,0
2020-07-03,El Dorado,017,186661,354,201,3,204,0
2020-07-03,Fresno,019,978130,11381,5783,87,5870,81
2020-07-03,Glenn,021,27897,182,122,0,122,0
2020-07-03,Humboldt,023,135768,173,143,1,144,3
2020-07-03,Imperial,025,180216,8492,6345,4,6349,47
2020-07-03,Inyo,027,18085,35,32,1,33,1
2020-07-03,Kern,029,883053,11423,5213,38,5251,81
2020-07-03,Kings,031,150075,2987,2492,10,2502,31
2020-07-03,Lake,033,64148,108,83,0,83,0
2020-07-03,Lassen,035,31185,258,219,2,221,0
2020-07-03,Los Angeles,037,10098052,130305,107236,78,107314,3461
2020-07-03,Madera,039,155013,1178,565,3,568,4
2020-07-03,Marin,041,260295,3390,1776,4,1780,17
2020-07-03,Mariposa,043,17540,36,28,0,28,1
2020-07-03,Mendocino,045,87422,103,72,0,72,0
2020-07-03,Merced,047,269075,2181,1188,2,1190,10
2020-07-03,Modoc,049,8938,1,0,0,0,0
2020-07-03,Mono,051,14174,54,37,0,37,1
2020-07-03,Monterey,053,433212,2550,1804,7,1811,15
2020-07-03,Napa,055,140530,553,388,0,388,4
2020-07-03,Nevada,057,99092,182,125,6,131,1
2020-07-03,Orange,059,3164182,26693,18819,264,19083,366
2020-07-03,Placer,061,380077,1103,745,3,748,11
2020-07-03,Plumas,063,18699,16,11,0,11,0
2020-07-03,Riverside,065,2383286,27025,21171,29,21200,472
2020-07-03,Sacramento,067,1510023,5365,3711,6,3717,71
2020-07-03,San Benito,069,59416,328,243,0,243,2
2020-07-03,San Bernardino,071,2135413,22285,14040,14,14054,269
2020-07-03,San Diego,073,3302833,19719,15698,2,15700,387
2020-07-03,San Francisco,075,870044,4410,3781,2,3783,50
2020-07-03,San Joaquin,077,732212,6710,4416,4,4420,56
2020-07-03,San Luis Obispo,079,281455,998,676,7,683,2
2020-07-03,San Mateo,081,765935,3956,3439,7,3446,106
2020-07-03,Santa Barbara,083,443738,4215,3406,34,3440,27
2020-07-03,Santa Clara,085,1922200,6575,4820,18,4838,161
2020-07-03,Santa Cruz,087,273765,559,436,0,436,2
2020-07-03,Shasta,089,179085,244,113,1,114,6
2020-07-03,Sierra,091,2930,1,1,0,1,0
2020-07-03,Siskiyou,093,43540,36,30,0,30,0
2020-07-03,Solano,095,438530,2194,1496,8,1504,22
2020-07-03,Sonoma,097,501317,1767,1282,5,1287,8
2020-07-03,Stanislaus,099,539301,5010,3021,7,3028,43
2020-07-03,Sutter,101,95872,294,205,0,205,2
2020-07-03,Tehama,103,63373,115,89,2,91,1
2020-07-03,Trinity,105,12862,19,2,5,7,0
2020-07-03,Tulare,107,460477,6240,4656,14,4670,134
2020-07-03,Tuolumne,109,53932,61,27,2,29,0
2020-07-03,Ventura,111,848112,4983,3536,19,3555,44
2020-07-03,Yolo,113,214977,877,586,3,589,25
2020-07-03,Yuba,115,75493,125,96,0,96,1
2020-07-02,Alameda,001,1643700,7823,6386,12,6398,139
2020-07-02,Alpine,003,1148,1,1,0,1,0
2020-07-02,Amador,005,37829,35,23,0,23,0
2020-07-02,Butte,007,227075,349,199,8,207,2
2020-07-02,Calaveras,009,45235,65,42,0,42,0
2020-07-02,Colusa,011,21464,109,60,0,60,0
2020-07-02,Contra Costa,013,1133247,4558,3347,6,3353,77
2020-07-02,Del Norte,015,27424,59,50,0,50,0
2020-07-02,El Dorado,017,186661,343,193,3,196,0
2020-07-02,Fresno,019,978130,10921,5402,86,5488,78
2020-07-02,Glenn,021,27897,176,114,0,114,0
2020-07-02,Humboldt,023,135768,169,138,1,139,3
2020-07-02,Imperial,025,180216,8391,6236,4,6240,47
2020-07-02,Inyo,027,18085,35,29,1,30,1
2020-07-02,Kern,029,883053,10887,5036,36,5072,78
2020-07-02,Kings,031,150075,2936,2419,10,2429,31
2020-07-02,Lake,033,64148,104,81,0,81,0
2020-07-02,Lassen,035,31185,256,218,2,220,0
2020-07-02,Los Angeles,037,10098052,128286,107144,55,107199,3458
2020-07-02,Madera,039,155013,1110,548,3,551,4
2020-07-02,Marin,041,260295,3304,1706,4,1710,17
2020-07-02,Mariposa,043,17540,35,28,0,28,1
2020-07-02,Mendocino,045,87422,99,71,0,71,0
2020-07-02,Merced,047,269075,2084,1122,2,1124,10
2020-07-02,Modoc,049,8938,1,0,0,0,0
2020-07-02,Mono,051,14174,54,37,0,37,1
2020-07-02,Monterey,053,433212,2490,1796,7,1803,15
2020-07-02,Napa,055,140530,536,352,0,352,4
2020-07-02,Nevada,057,99092,176,118,5,123,1
2020-07-02,Orange,059,3164182,25929,17056,251,17307,360
2020-07-02,Placer,061,380077,1079,740,3,743,11
2020-07-02,Plumas,063,18699,15,8,0,8,0
2020-07-02,Riverside,065,2383286,26452,20253,29,20282,458
2020-07-02,Sacramento,067,1510023,5138,3587,6,3593,70
2020-07-02,San Benito,069,59416,320,236,0,236,2
2020-07-02,San Bernardino,071,2135413,21749,13185,14,13199,260
2020-07-02,San Diego,073,3302833,19254,15208,2,15210,377
2020-07-02,San Francisco,075,870044,4315,3676,2,3678,50
2020-07-02,San Joaquin,077,732212,6363,4243,4,4247,56
2020-07-02,San Luis Obispo,079,281455,953,659,7,666,2
2020-07-02,San Mateo,081,765935,3876,3390,7,3397,107
2020-07-02,Santa Barbara,083,443738,4115,3385,32,3417,27
2020-07-02,Santa Clara,085,1922200,6449,4722,18,4740,160
2020-07-02,Santa Cruz,087,273765,536,414,0,414,2
2020-07-02,Shasta,089,179085,241,110,1,111,5
2020-07-02,Sierra,091,2930,1,1,0,1,0
2020-07-02,Siskiyou,093,43540,36,30,0,30,0
2020-07-02,Solano,095,438530,2111,1429,8,1437,21
2020-07-02,Sonoma,097,501317,1709,1244,5,1249,6
2020-07-02,Stanislaus,099,539301,4838,2850,7,2857,41
2020-07-02,Sutter,101,95872,282,195,0,195,2
2020-07-02,Tehama,103,63373,113,86,2,88,1
2020-07-02,Trinity,105,12862,19,2,5,7,0
2020-07-02,Tulare,107,460477,6073,4559,13,4572,132
2020-07-02,Tuolumne,109,53932,58,23,2,25,0
2020-07-02,Ventura,111,848112,4827,3394,19,3413,42
2020-07-02,Yolo,113,214977,845,554,3,557,24
2020-07-02,Yuba,115,75493,115,93,0,93,1
2020-07-01,Alameda,001,1643700,7601,6125,12,6137,137
2020-07-01,Alpine,003,1148,1,1,0,1,0
2020-07-01,Amador,005,37829,34,22,0,22,0
2020-07-01,Butte,007,227075,324,185,8,193,2
2020-07-01,Calaveras,009,45235,63,37,0,37,0
2020-07-01,Colusa,011,21464,103,53,0,53,0
2020-07-01,Contra Costa,013,1133247,4346,3259,6,3265,76
2020-07-01,Del Norte,015,27424,59,50,0,50,0
2020-07-01,El Dorado,017,186661,316,183,3,186,0
2020-07-01,Fresno,019,978130,10487,5111,83,5194,76
2020-07-01,Glenn,021,27897,170,110,0,110,0
2020-07-01,Humboldt,023,135768,164,134,0,134,3
2020-07-01,Imperial,025,180216,8294,6150,4,6154,46
2020-07-01,Inyo,027,18085,34,30,1,31,1
2020-07-01,Kern,029,883053,10254,4853,34,4887,78
2020-07-01,Kings,031,150075,2868,2360,10,2370,30
2020-07-01,Lake,033,64148,103,75,0,75,0
2020-07-01,Lassen,035,31185,255,217,2,219,0
2020-07-01,Los Angeles,037,10098052,125081,105325,46,105371,3408
2020-07-01,Madera,039,155013,1069,519,3,522,4
2020-07-01,Marin,041,260295,3147,1636,4,1640,17
2020-07-01,Mariposa,043,17540,35,29,0,29,1
2020-07-01,Mendocino,045,87422,95,70,0,70,0
2020-07-01,Merced,047,269075,1986,1052,2,1054,10
2020-07-01,Modoc,049,8938,1,0,0,0,0
2020-07-01,Mono,051,14174,51,37,0,37,1
2020-07-01,Monterey,053,433212,2382,1703,6,1709,15
2020-07-01,Napa,055,140530,513,347,0,347,4
2020-07-01,Nevada,057,99092,166,115,5,120,1
2020-07-01,Orange,059,3164182,25044,15662,230,15892,343
2020-07-01,Placer,061,380077,1032,713,3,716,11
2020-07-01,Plumas,063,18699,13,8,0,8,0
2020-07-01,Riverside,065,2383286,25610,19537,28,19565,457
2020-07-01,Sacramento,067,1510023,4883,3425,6,3431,64
2020-07-01,San Benito,069,59416,311,219,0,219,2
2020-07-01,San Bernardino,071,2135413,20854,12712,11,12723,253
2020-07-01,San Diego,073,3302833,18686,14624,2,14626,372
2020-07-01,San Francisco,075,870044,4222,3626,2,3628,50
2020-07-01,San Joaquin,077,732212,6005,3990,4,3994,54
2020-07-01,San Luis Obispo,079,281455,926,613,7,620,1
2020-07-01,San Mateo,081,765935,3814,3326,7,3333,84
2020-07-01,Santa Barbara,083,443738,3995,3268,31,3299,27
2020-07-01,Santa Clara,085,1922200,6261,4547,17,4564,159
2020-07-01,Santa Cruz,087,273765,512,398,0,398,2
2020-07-01,Shasta,089,179085,236,104,1,105,5
2020-07-01,Sierra,091,2930,1,1,0,1,0
2020-07-01,Siskiyou,093,43540,36,28,0,28,0
2020-07-01,Solano,095,438530,2022,1350,8,1358,21
2020-07-01,Sonoma,097,501317,1614,1178,5,1183,6
2020-07-01,Stanislaus,099,539301,4559,2619,7,2626,41
2020-07-01,Sutter,101,95872,269,188,0,188,2
2020-07-01,Tehama,103,63373,106,80,2,82,1
2020-07-01,Trinity,105,12862,19,2,4,6,0
2020-07-01,Tulare,107,460477,5895,4359,13,4372,128
2020-07-01,Tuolumne,109,53932,55,17,2,19,0
2020-07-01,Ventura,111,848112,4684,3224,17,3241,41
2020-07-01,Yolo,113,214977,794,526,3,529,24
2020-07-01,Yuba,115,75493,110,57,0,57,1
2020-06-30,Alameda,001,1643700,7352,5959,10,5969,137
2020-06-30,Alpine,003,1148,1,1,0,1,0
2020-06-30,Amador,005,37829,34,21,0,21,0
2020-06-30,Butte,007,227075,307,163,8,171,2
2020-06-30,Calaveras,009,45235,58,31,0,31,0
2020-06-30,Colusa,011,21464,94,33,0,33,0
2020-06-30,Contra Costa,013,1133247,4139,3140,6,3146,75
2020-06-30,Del Norte,015,27424,59,48,0,48,0
2020-06-30,El Dorado,017,186661,303,175,3,178,0
2020-06-30,Fresno,019,978130,10040,4826,77,4903,75
2020-06-30,Glenn,021,27897,165,96,0,96,0
2020-06-30,Humboldt,023,135768,160,132,0,132,3
2020-06-30,Imperial,025,180216,8196,5968,4,5972,45
2020-06-30,Inyo,027,18085,34,30,1,31,1
2020-06-30,Kern,029,883053,9607,4721,31,4752,75
2020-06-30,Kings,031,150075,2819,2315,7,2322,30
2020-06-30,Lake,033,64148,95,56,0,56,0
2020-06-30,Lassen,035,31185,248,215,2,217,0
2020-06-30,Los Angeles,037,10098052,121499,103640,43,103683,3378
2020-06-30,Madera,039,155013,1012,475,3,478,4
2020-06-30,Marin,041,260295,3076,1614,4,1618,17
2020-06-30,Mariposa,043,17540,34,27,0,27,1
2020-06-30,Mendocino,045,87422,90,65,0,65,0
2020-06-30,Merced,047,269075,1849,970,2,972,10
2020-06-30,Modoc,049,8938,1,0,0,0,0
2020-06-30,Mono,051,14174,49,36,0,36,1
2020-06-30,Monterey,053,433212,2285,1657,6,1663,15
2020-06-30,Napa,055,140530,488,342,0,342,4
2020-06-30,Nevada,057,99092,158,113,5,118,1
2020-06-30,Orange,059,3164182,24113,14354,220,14574,335
2020-06-30,Placer,061,380077,1005,667,3,670,11
2020-06-30,Plumas,063,18699,12,8,0,8,0
2020-06-30,Riverside,065,2383286,24893,18656,27,18683,449
2020-06-30,Sacramento,067,1510023,4594,3246,6,3252,64
2020-06-30,San Benito,069,59416,300,200,0,200,2
2020-06-30,San Bernardino,071,2135413,19872,12375,10,12385,249
2020-06-30,San Diego,073,3302833,17981,14150,2,14152,365
2020-06-30,San Francisco,075,870044,4117,3555,1,3556,50
2020-06-30,San Joaquin,077,732212,5630,3744,4,3748,52
2020-06-30,San Luis Obispo,079,281455,888,583,7,590,1
2020-06-30,San Mateo,081,765935,3736,3268,7,3275,84
2020-06-30,Santa Barbara,083,443738,3879,3102,31,3133,25
2020-06-30,Santa Clara,085,1922200,6059,4346,17,4363,157
2020-06-30,Santa Cruz,087,273765,486,379,0,379,2
2020-06-30,Shasta,089,179085,220,100,1,101,5
2020-06-30,Sierra,091,2930,1,1,0,1,0
2020-06-30,Siskiyou,093,43540,35,26,0,26,0
2020-06-30,Solano,095,438530,1930,1256,8,1264,21
2020-06-30,Sonoma,097,501317,1550,1122,5,1127,6
2020-06-30,Stanislaus,099,539301,4261,2578,7,2585,41
2020-06-30,Sutter,101,95872,246,168,0,168,2
2020-06-30,Tehama,103,63373,104,75,2,77,1
2020-06-30,Trinity,105,12862,19,2,4,6,0
2020-06-30,Tulare,107,460477,5686,4207,13,4220,117
2020-06-30,Tuolumne,109,53932,51,16,2,18,0
2020-06-30,Ventura,111,848112,4550,3030,17,3047,40
2020-06-30,Yolo,113,214977,756,515,3,518,24
2020-06-30,Yuba,115,75493,106,55,0,55,1
2020-06-29,Alameda,001,1643700,7143,5766,10,5776,135
2020-06-29,Alpine,003,1148,1,1,0,1,0
2020-06-29,Amador,005,37829,31,20,0,20,0
2020-06-29,Butte,007,227075,286,157,8,165,2
2020-06-29,Calaveras,009,45235,56,30,0,30,0
2020-06-29,Colusa,011,21464,89,17,0,17,0
2020-06-29,Contra Costa,013,1133247,3976,2976,5,2981,75
2020-06-29,Del Norte,015,27424,59,47,0,47,0
2020-06-29,El Dorado,017,186661,289,163,1,164,0
2020-06-29,Fresno,019,978130,9692,4531,75,4606,74
2020-06-29,Glenn,021,27897,156,77,0,77,0
2020-06-29,Humboldt,023,135768,159,128,0,128,3
2020-06-29,Imperial,025,180216,8065,5512,4,5516,45
2020-06-29,Inyo,027,18085,33,29,0,29,1
2020-06-29,Kern,029,883053,8944,4613,29,4642,73
2020-06-29,Kings,031,150075,2754,2280,7,2287,20
2020-06-29,Lake,033,64148,88,53,0,53,0
2020-06-29,Lassen,035,31185,240,77,2,79,0
2020-06-29,Los Angeles,037,10098052,118461,100846,37,100883,3337
2020-06-29,Madera,039,155013,955,422,3,425,4
2020-06-29,Marin,041,260295,3000,1517,4,1521,17
2020-06-29,Mariposa,043,17540,32,25,0,25,1
2020-06-29,Mendocino,045,87422,87,63,0,63,0
2020-06-29,Merced,047,269075,1743,848,2,850,10
2020-06-29,Modoc,049,8938,1,0,0,0,0
2020-06-29,Mono,051,14174,47,35,0,35,1
2020-06-29,Monterey,053,433212,2213,1614,6,1620,14
2020-06-29,Napa,055,140530,466,317,0,317,4
2020-06-29,Nevada,057,99092,155,107,4,111,1
2020-06-29,Orange,059,3164182,23123,13682,204,13886,324
2020-06-29,Placer,061,380077,969,628,3,631,11
2020-06-29,Plumas,063,18699,12,6,0,6,0
2020-06-29,Riverside,065,2383286,23859,17683,27,17710,432
2020-06-29,Sacramento,067,1510023,4307,2985,6,2991,62
2020-06-29,San Benito,069,59416,285,193,0,193,2
2020-06-29,San Bernardino,071,2135413,18911,11643,10,11653,245
2020-06-29,San Diego,073,3302833,17403,13834,2,13836,361
2020-06-29,San Francisco,075,870044,4040,3389,1,3390,50
2020-06-29,San Joaquin,077,732212,5272,3202,4,3206,52
2020-06-29,San Luis Obispo,079,281455,854,544,7,551,1
2020-06-29,San Mateo,081,765935,3682,3170,7,3177,84
2020-06-29,Santa Barbara,083,443738,3770,2933,30,2963,25
2020-06-29,Santa Clara,085,1922200,5888,4231,17,4248,157
2020-06-29,Santa Cruz,087,273765,468,348,0,348,2
2020-06-29,Shasta,089,179085,212,94,1,95,5
2020-06-29,Sierra,091,2930,1,1,0,1,0
2020-06-29,Siskiyou,093,43540,35,25,0,25,0
2020-06-29,Solano,095,438530,1828,1077,8,1085,21
2020-06-29,Sonoma,097,501317,1478,1103,5,1108,5
2020-06-29,Stanislaus,099,539301,4055,2400,6,2406,36
2020-06-29,Sutter,101,95872,224,152,0,152,2
2020-06-29,Tehama,103,63373,100,63,2,65,1
2020-06-29,Trinity,105,12862,18,2,4,6,0
2020-06-29,Tulare,107,460477,5531,3906,12,3918,117
2020-06-29,Tuolumne,109,53932,47,16,2,18,0
2020-06-29,Ventura,111,848112,4403,2794,17,2811,40
2020-06-29,Yolo,113,214977,723,483,3,486,24
2020-06-29,Yuba,115,75493,93,55,0,55,1
2020-06-28,Alameda,001,1643700,6884,5698,10,5708,135
2020-06-28,Alpine,003,1148,1,1,0,1,0
2020-06-28,Amador,005,37829,29,20,0,20,0
2020-06-28,Butte,007,227075,266,150,8,158,2
2020-06-28,Calaveras,009,45235,51,30,0,30,0
2020-06-28,Colusa,011,21464,74,17,0,17,0
2020-06-28,Contra Costa,013,1133247,3786,2803,4,2807,73
2020-06-28,Del Norte,015,27424,58,47,0,47,0
2020-06-28,El Dorado,017,186661,277,162,1,163,0
2020-06-28,Fresno,019,978130,9329,4365,75,4440,74
2020-06-28,Glenn,021,27897,148,77,0,77,0
2020-06-28,Humboldt,023,135768,156,127,0,127,3
2020-06-28,Imperial,025,180216,7876,5513,4,5517,45
2020-06-28,Inyo,027,18085,33,29,0,29,1
2020-06-28,Kern,029,883053,8393,4541,27,4568,72
2020-06-28,Kings,031,150075,2694,2234,7,2241,18
2020-06-28,Lake,033,64148,84,53,0,53,0
2020-06-28,Lassen,035,31185,240,77,2,79,0
2020-06-28,Los Angeles,037,10098052,115259,98003,33,98036,3316
2020-06-28,Madera,039,155013,907,424,3,427,4
2020-06-28,Marin,041,260295,2654,1473,4,1477,17
2020-06-28,Mariposa,043,17540,32,24,0,24,1
2020-06-28,Mendocino,045,87422,85,63,0,63,0
2020-06-28,Merced,047,269075,1630,814,2,816,10
2020-06-28,Modoc,049,8938,1,0,0,0,0
2020-06-28,Mono,051,14174,47,35,0,35,1
2020-06-28,Monterey,053,433212,2131,1560,6,1566,13
2020-06-28,Napa,055,140530,432,307,0,307,4
2020-06-28,Nevada,057,99092,144,102,3,105,1
2020-06-28,Orange,059,3164182,22149,13213,186,13399,324
2020-06-28,Placer,061,380077,930,618,3,621,11
2020-06-28,Plumas,063,18699,11,6,0,6,0
2020-06-28,Riverside,065,2383286,23031,16848,26,16874,432
2020-06-28,Sacramento,067,1510023,4079,2803,6,2809,63
2020-06-28,San Benito,069,59416,274,190,0,190,2
2020-06-28,San Bernardino,071,2135413,18158,11344,9,11353,245
2020-06-28,San Diego,073,3302833,16858,13333,2,13335,361
2020-06-28,San Francisco,075,870044,3961,3388,1,3389,50
2020-06-28,San Joaquin,077,732212,4935,3201,4,3205,52
2020-06-28,San Luis Obispo,079,281455,815,531,6,537,1
2020-06-28,San Mateo,081,765935,3604,3124,6,3130,84
2020-06-28,Santa Barbara,083,443738,3625,2872,30,2902,25
2020-06-28,Santa Clara,085,1922200,5726,4131,17,4148,156
2020-06-28,Santa Cruz,087,273765,445,349,0,349,2
2020-06-28,Shasta,089,179085,199,89,0,89,5
2020-06-28,Sierra,091,2930,1,1,0,1,0
2020-06-28,Siskiyou,093,43540,35,25,0,25,0
2020-06-28,Solano,095,438530,1753,1077,8,1085,21
2020-06-28,Sonoma,097,501317,1424,1084,5,1089,5
2020-06-28,Stanislaus,099,539301,3849,2376,6,2382,36
2020-06-28,Sutter,101,95872,198,145,0,145,2
2020-06-28,Tehama,103,63373,93,63,2,65,1
2020-06-28,Trinity,105,12862,17,2,4,6,0
2020-06-28,Tulare,107,460477,5363,3812,12,3824,117
2020-06-28,Tuolumne,109,53932,42,14,2,16,0
2020-06-28,Ventura,111,848112,4245,2650,17,2667,40
2020-06-28,Yolo,113,214977,688,468,3,471,24
2020-06-28,Yuba,115,75493,89,39,0,39,1
2020-06-27,Alameda,001,1643700,6788,5581,10,5591,135
2020-06-27,Alpine,003,1148,1,1,0,1,0
2020-06-27,Amador,005,37829,27,20,0,20,0
2020-06-27,Butte,007,227075,258,137,8,145,2
2020-06-27,Calaveras,009,45235,49,30,0,30,0
2020-06-27,Colusa,011,21464,68,17,0,17,0
2020-06-27,Contra Costa,013,1133247,3691,2717,3,2720,72
2020-06-27,Del Norte,015,27424,58,47,0,47,0
2020-06-27,El Dorado,017,186661,271,159,1,160,0
2020-06-27,Fresno,019,978130,9083,4238,75,4313,74
2020-06-27,Glenn,021,27897,144,77,0,77,0
2020-06-27,Humboldt,023,135768,154,127,0,127,3
2020-06-27,Imperial,025,180216,7815,5513,4,5517,45
2020-06-27,Inyo,027,18085,33,29,0,29,1
2020-06-27,Kern,029,883053,8129,4411,26,4437,70
2020-06-27,Kings,031,150075,2668,2187,7,2194,18
2020-06-27,Lake,033,64148,81,42,0,42,0
2020-06-27,Lassen,035,31185,240,33,2,35,0
2020-06-27,Los Angeles,037,10098052,113517,95341,30,95371,3291
2020-06-27,Madera,039,155013,864,427,2,429,4
2020-06-27,Marin,041,260295,2609,1423,4,1427,17
2020-06-27,Mariposa,043,17540,31,22,0,22,1
2020-06-27,Mendocino,045,87422,85,63,0,63,0
2020-06-27,Merced,047,269075,1572,807,1,808,10
2020-06-27,Modoc,049,8938,1,0,0,0,0
2020-06-27,Mono,051,14174,46,35,0,35,1
2020-06-27,Monterey,053,433212,2067,1455,6,1461,12
2020-06-27,Napa,055,140530,422,282,0,282,3
2020-06-27,Nevada,057,99092,140,102,2,104,1
2020-06-27,Orange,059,3164182,21638,12951,181,13132,320
2020-06-27,Placer,061,380077,909,584,3,587,10
2020-06-27,Plumas,063,18699,11,6,0,6,0
2020-06-27,Riverside,065,2383286,22642,16209,26,16235,432
2020-06-27,Sacramento,067,1510023,3962,2685,6,2691,63
2020-06-27,San Benito,069,59416,267,182,0,182,2
2020-06-27,San Bernardino,071,2135413,17780,11238,9,11247,243
2020-06-27,San Diego,073,3302833,16493,12836,2,12838,360
2020-06-27,San Francisco,075,870044,3906,3332,1,3333,49
2020-06-27,San Joaquin,077,732212,4769,2995,4,2999,52
2020-06-27,San Luis Obispo,079,281455,792,505,6,511,1
2020-06-27,San Mateo,081,765935,3547,3083,6,3089,83
2020-06-27,Santa Barbara,083,443738,3553,2799,30,2829,25
2020-06-27,Santa Clara,085,1922200,5620,4006,17,4023,157
2020-06-27,Santa Cruz,087,273765,438,347,0,347,2
2020-06-27,Shasta,089,179085,193,87,0,87,5
2020-06-27,Sierra,091,2930,1,1,0,1,0
2020-06-27,Siskiyou,093,43540,35,25,0,25,0
2020-06-27,Solano,095,438530,1720,1076,8,1084,21
2020-06-27,Sonoma,097,501317,1392,1004,5,1009,5
2020-06-27,Stanislaus,099,539301,3749,2164,6,2170,36
2020-06-27,Sutter,101,95872,191,141,0,141,2
2020-06-27,Tehama,103,63373,90,63,2,65,1
2020-06-27,Trinity,105,12862,17,2,4,6,0
2020-06-27,Tulare,107,460477,5267,3810,12,3822,117
2020-06-27,Tuolumne,109,53932,41,13,2,15,0
2020-06-27,Ventura,111,848112,4145,2471,17,2488,40
2020-06-27,Yolo,113,214977,664,432,3,435,24
2020-06-27,Yuba,115,75493,81,39,0,39,1
2020-06-26,Alameda,001,1643700,6702,5502,9,5511,132
2020-06-26,Alpine,003,1148,1,1,0,1,0
2020-06-26,Amador,005,37829,26,20,0,20,0
2020-06-26,Butte,007,227075,243,135,8,143,2
2020-06-26,Calaveras,009,45235,47,30,0,30,0
2020-06-26,Colusa,011,21464,63,17,0,17,0
2020-06-26,Contra Costa,013,1133247,3579,2676,3,2679,72
2020-06-26,Del Norte,015,27424,57,47,0,47,0
2020-06-26,El Dorado,017,186661,263,159,1,160,0
2020-06-26,Fresno,019,978130,8857,4166,75,4241,74
2020-06-26,Glenn,021,27897,137,71,0,71,0
2020-06-26,Humboldt,023,135768,152,126,0,126,3
2020-06-26,Imperial,025,180216,7752,5400,4,5404,44
2020-06-26,Inyo,027,18085,32,29,0,29,1
2020-06-26,Kern,029,883053,7799,4366,26,4392,70
2020-06-26,Kings,031,150075,2636,2176,6,2182,18
2020-06-26,Lake,033,64148,80,42,0,42,0
2020-06-26,Lassen,035,31185,239,30,2,32,0
2020-06-26,Los Angeles,037,10098052,111352,93328,30,93358,3275
2020-06-26,Madera,039,155013,832,409,2,411,4
2020-06-26,Marin,041,260295,2572,1406,4,1410,17
2020-06-26,Mariposa,043,17540,30,21,0,21,1
2020-06-26,Mendocino,045,87422,82,63,0,63,0
2020-06-26,Merced,047,269075,1526,797,1,798,10
2020-06-26,Modoc,049,8938,1,0,0,0,0
2020-06-26,Mono,051,14174,45,35,0,35,1
2020-06-26,Monterey,053,433212,2015,1449,6,1455,12
2020-06-26,Napa,055,140530,412,277,0,277,3
2020-06-26,Nevada,057,99092,136,101,1,102,1
2020-06-26,Orange,059,3164182,20962,12659,178,12837,320
2020-06-26,Placer,061,380077,880,584,3,587,10
2020-06-26,Plumas,063,18699,11,6,0,6,0
2020-06-26,Riverside,065,2383286,22179,15858,26,15884,430
2020-06-26,Sacramento,067,1510023,3797,2687,6,2693,63
2020-06-26,San Benito,069,59416,263,176,0,176,2
2020-06-26,San Bernardino,071,2135413,17404,11111,9,11120,243
2020-06-26,San Diego,073,3302833,16128,12402,2,12404,358
2020-06-26,San Francisco,075,870044,3851,3330,1,3331,49
2020-06-26,San Joaquin,077,732212,4555,2943,4,2947,52
2020-06-26,San Luis Obispo,079,281455,777,498,6,504,1
2020-06-26,San Mateo,081,765935,3495,3055,6,3061,83
2020-06-26,Santa Barbara,083,443738,3463,2784,28,2812,25
2020-06-26,Santa Clara,085,1922200,5519,3968,17,3985,156
2020-06-26,Santa Cruz,087,273765,431,344,0,344,2
2020-06-26,Shasta,089,179085,186,86,0,86,5
2020-06-26,Sierra,091,2930,1,1,0,1,0
2020-06-26,Siskiyou,093,43540,34,24,0,24,0
2020-06-26,Solano,095,438530,1678,1068,8,1076,21
2020-06-26,Sonoma,097,501317,1361,977,5,982,5
2020-06-26,Stanislaus,099,539301,3636,2157,6,2163,36
2020-06-26,Sutter,101,95872,184,138,0,138,2
2020-06-26,Tehama,103,63373,87,63,2,65,1
2020-06-26,Trinity,105,12862,17,2,4,6,0
2020-06-26,Tulare,107,460477,5178,3720,12,3732,117
2020-06-26,Tuolumne,109,53932,39,10,2,12,0
2020-06-26,Ventura,111,848112,4059,2444,17,2461,40
2020-06-26,Yolo,113,214977,641,418,3,421,24
2020-06-26,Yuba,115,75493,75,38,0,38,1
2020-06-25,Alameda,001,1643700,6513,5398,9,5407,130
2020-06-25,Alpine,003,1148,1,1,0,1,0
2020-06-25,Amador,005,37829,25,18,0,18,0
2020-06-25,Butte,007,227075,238,127,8,135,1
2020-06-25,Calaveras,009,45235,42,26,0,26,0
2020-06-25,Colusa,011,21464,53,14,0,14,0
2020-06-25,Contra Costa,013,1133247,3394,2591,3,2594,71
2020-06-25,Del Norte,015,27424,55,47,0,47,0
2020-06-25,El Dorado,017,186661,255,150,1,151,0
2020-06-25,Fresno,019,978130,8544,3938,74,4012,71
2020-06-25,Glenn,021,27897,132,59,0,59,0
2020-06-25,Humboldt,023,135768,151,121,0,121,3
2020-06-25,Imperial,025,180216,7623,5192,4,5196,44
2020-06-25,Inyo,027,18085,29,27,0,27,1
2020-06-25,Kern,029,883053,7374,4236,23,4259,69
2020-06-25,Kings,031,150075,2584,2110,6,2116,17
2020-06-25,Lake,033,64148,79,42,0,42,0
2020-06-25,Lassen,035,31185,233,13,2,15,0
2020-06-25,Los Angeles,037,10098052,108586,91524,30,91554,3239
2020-06-25,Madera,039,155013,788,380,2,382,4
2020-06-25,Marin,041,260295,2470,1321,4,1325,17
2020-06-25,Mariposa,043,17540,29,20,0,20,1
2020-06-25,Mendocino,045,87422,79,61,0,61,0
2020-06-25,Merced,047,269075,1439,747,1,748,10
2020-06-25,Modoc,049,8938,1,0,0,0,0
2020-06-25,Mono,051,14174,44,35,0,35,1
2020-06-25,Monterey,053,433212,1927,1426,5,1431,12
2020-06-25,Napa,055,140530,394,260,0,260,3
2020-06-25,Nevada,057,99092,128,92,1,93,1
2020-06-25,Orange,059,3164182,20040,12221,176,12397,311
2020-06-25,Placer,061,380077,826,574,3,577,10
2020-06-25,Plumas,063,18699,10,6,0,6,0
2020-06-25,Riverside,065,2383286,21424,15224,26,15250,427
2020-06-25,Sacramento,067,1510023,3574,2519,6,2525,62
2020-06-25,San Benito,069,59416,255,174,0,174,2
2020-06-25,San Bernardino,071,2135413,16651,10590,9,10599,242
2020-06-25,San Diego,073,3302833,15589,11963,2,11965,352
2020-06-25,San Francisco,075,870044,3785,3252,1,3253,48
2020-06-25,San Joaquin,077,732212,4282,2803,4,2807,50
2020-06-25,San Luis Obispo,079,281455,745,473,6,479,1
2020-06-25,San Mateo,081,765935,3427,2996,6,3002,82
2020-06-25,Santa Barbara,083,443738,3358,2622,27,2649,25
2020-06-25,Santa Clara,085,1922200,5370,3871,17,3888,156
2020-06-25,Santa Cruz,087,273765,419,335,0,335,2
2020-06-25,Shasta,089,179085,176,84,0,84,5
2020-06-25,Sierra,091,2930,1,1,0,1,0
2020-06-25,Siskiyou,093,43540,33,24,0,24,0
2020-06-25,Solano,095,438530,1625,1034,8,1042,21
2020-06-25,Sonoma,097,501317,1312,953,4,957,5
2020-06-25,Stanislaus,099,539301,3424,2130,6,2136,36
2020-06-25,Sutter,101,95872,172,126,0,126,2
2020-06-25,Tehama,103,63373,83,59,2,61,1
2020-06-25,Trinity,105,12862,17,2,4,6,0
2020-06-25,Tulare,107,460477,5047,3656,12,3668,117
2020-06-25,Tuolumne,109,53932,38,10,1,11,0
2020-06-25,Ventura,111,848112,3877,2346,16,2362,40
2020-06-25,Yolo,113,214977,612,397,3,400,24
2020-06-25,Yuba,115,75493,64,38,0,38,1
2020-06-24,Alameda,001,1643700,6351,5242,9,5251,123
2020-06-24,Alpine,003,1148,1,1,0,1,0
2020-06-24,Amador,005,37829,23,16,0,16,0
2020-06-24,Butte,007,227075,222,119,7,126,1
2020-06-24,Calaveras,009,45235,40,26,0,26,0
2020-06-24,Colusa,011,21464,44,11,0,11,0
2020-06-24,Contra Costa,013,1133247,3239,2520,3,2523,66
2020-06-24,Del Norte,015,27424,49,47,0,47,0
2020-06-24,El Dorado,017,186661,239,149,1,150,0
2020-06-24,Fresno,019,978130,8213,3765,74,3839,71
2020-06-24,Glenn,021,27897,124,54,0,54,0
2020-06-24,Humboldt,023,135768,151,117,0,117,3
2020-06-24,Imperial,025,180216,7505,5138,4,5142,38
2020-06-24,Inyo,027,18085,29,28,0,28,1
2020-06-24,Kern,029,883053,6981,4155,21,4176,67
2020-06-24,Kings,031,150075,2520,2063,6,2069,16
2020-06-24,Lake,033,64148,66,40,0,40,0
2020-06-24,Lassen,035,31185,232,9,2,11,0
2020-06-24,Los Angeles,037,10098052,105822,89566,30,89596,3186
2020-06-24,Madera,039,155013,766,373,2,375,4
2020-06-24,Marin,041,260295,2242,1261,4,1265,17
2020-06-24,Mariposa,043,17540,28,19,0,19,1
2020-06-24,Mendocino,045,87422,79,60,0,60,0
2020-06-24,Merced,047,269075,1353,696,1,697,8
2020-06-24,Modoc,049,8938,1,0,0,0,0
2020-06-24,Mono,051,14174,42,35,0,35,1
2020-06-24,Monterey,053,433212,1850,1407,5,1412,12
2020-06-24,Napa,055,140530,377,258,0,258,3
2020-06-24,Nevada,057,99092,122,92,1,93,1
2020-06-24,Orange,059,3164182,19043,11804,158,11962,303
2020-06-24,Placer,061,380077,787,548,3,551,10
2020-06-24,Plumas,063,18699,10,6,0,6,0
2020-06-24,Riverside,065,2383286,20576,14946,26,14972,410
2020-06-24,Sacramento,067,1510023,3370,2446,5,2451,62
2020-06-24,San Benito,069,59416,251,171,0,171,2
2020-06-24,San Bernardino,071,2135413,15837,10211,9,10220,239
2020-06-24,San Diego,073,3302833,15086,11628,2,11630,347
2020-06-24,San Francisco,075,870044,3722,3216,1,3217,48
2020-06-24,San Joaquin,077,732212,4061,2680,4,2684,49
2020-06-24,San Luis Obispo,079,281455,714,461,5,466,1
2020-06-24,San Mateo,081,765935,3370,2964,6,2970,82
2020-06-24,Santa Barbara,083,443738,3239,2569,25,2594,22
2020-06-24,Santa Clara,085,1922200,5239,3812,17,3829,155
2020-06-24,Santa Cruz,087,273765,407,329,0,329,2
2020-06-24,Shasta,089,179085,168,83,0,83,5
2020-06-24,Sierra,091,2930,1,1,0,1,0
2020-06-24,Siskiyou,093,43540,32,24,0,24,0
2020-06-24,Solano,095,438530,1535,979,7,986,21
2020-06-24,Sonoma,097,501317,1263,933,4,937,4
2020-06-24,Stanislaus,099,539301,3245,2039,6,2045,36
2020-06-24,Sutter,101,95872,159,118,0,118,2
2020-06-24,Tehama,103,63373,81,55,2,57,1
2020-06-24,Trinity,105,12862,16,2,3,5,0
2020-06-24,Tulare,107,460477,4892,3541,10,3551,116
2020-06-24,Tuolumne,109,53932,33,9,1,10,0
2020-06-24,Ventura,111,848112,3536,2314,16,2330,42
2020-06-24,Yolo,113,214977,577,376,3,379,24
2020-06-24,Yuba,115,75493,58,37,0,37,1
2020-06-23,Alameda,001,1643700,6170,5159,9,5168,121
2020-06-23,Alpine,003,1148,1,1,0,1,0
2020-06-23,Amador,005,37829,22,13,0,13,0
2020-06-23,Butte,007,227075,204,111,7,118,1
2020-06-23,Calaveras,009,45235,40,26,0,26,0
2020-06-23,Colusa,011,21464,40,7,0,7,0
2020-06-23,Contra Costa,013,1133247,3113,2453,3,2456,60
2020-06-23,Del Norte,015,27424,48,46,0,46,0
2020-06-23,El Dorado,017,186661,230,142,1,143,0
2020-06-23,Fresno,019,978130,7561,3569,72,3641,67
2020-06-23,Glenn,021,27897,120,47,0,47,0
2020-06-23,Humboldt,023,135768,151,110,0,110,3
2020-06-23,Imperial,025,180216,7342,5025,4,5029,38
2020-06-23,Inyo,027,18085,29,26,0,26,1
2020-06-23,Kern,029,883053,6613,4087,18,4105,64
2020-06-23,Kings,031,150075,2455,1727,6,1733,16
2020-06-23,Lake,033,64148,60,40,0,40,0
2020-06-23,Lassen,035,31185,228,9,2,11,0
2020-06-23,Los Angeles,037,10098052,102877,88433,29,88462,3152
2020-06-23,Madera,039,155013,727,369,2,371,4
2020-06-23,Marin,041,260295,1974,1139,4,1143,17
2020-06-23,Mariposa,043,17540,26,18,0,18,1
2020-06-23,Mendocino,045,87422,78,61,0,61,0
2020-06-23,Merced,047,269075,1255,656,1,657,8
2020-06-23,Modoc,049,8938,1,0,0,0,0
2020-06-23,Mono,051,14174,42,35,0,35,1
2020-06-23,Monterey,053,433212,1780,1346,5,1351,12
2020-06-23,Napa,055,140530,362,230,0,230,3
2020-06-23,Nevada,057,99092,116,81,1,82,1
2020-06-23,Orange,059,3164182,18074,11071,155,11226,278
2020-06-23,Placer,061,380077,761,525,3,528,10
2020-06-23,Plumas,063,18699,9,6,0,6,0
2020-06-23,Riverside,065,2383286,19557,14469,26,14495,406
2020-06-23,Sacramento,067,1510023,3191,2374,5,2379,62
2020-06-23,San Benito,069,59416,237,167,0,167,2
2020-06-23,San Bernardino,071,2135413,15056,9771,9,9780,229
2020-06-23,San Diego,073,3302833,14566,11296,2,11298,341
2020-06-23,San Francisco,075,870044,3648,3177,1,3178,48
2020-06-23,San Joaquin,077,732212,3802,2502,4,2506,48
2020-06-23,San Luis Obispo,079,281455,683,445,5,450,1
2020-06-23,San Mateo,081,765935,3305,2907,6,2913,81
2020-06-23,Santa Barbara,083,443738,3144,2498,25,2523,22
2020-06-23,Santa Clara,085,1922200,5093,3700,17,3717,155
2020-06-23,Santa Cruz,087,273765,397,313,0,313,2
2020-06-23,Shasta,089,179085,159,81,0,81,5
2020-06-23,Sierra,091,2930,1,1,0,1,0
2020-06-23,Siskiyou,093,43540,30,24,0,24,0
2020-06-23,Solano,095,438530,1478,941,6,947,21
2020-06-23,Sonoma,097,501317,1210,912,4,916,4
2020-06-23,Stanislaus,099,539301,3069,1850,6,1856,35
2020-06-23,Sutter,101,95872,149,112,0,112,2
2020-06-23,Tehama,103,63373,79,50,2,52,1
2020-06-23,Trinity,105,12862,16,2,3,5,0
2020-06-23,Tulare,107,460477,4770,3456,10,3466,111
2020-06-23,Tuolumne,109,53932,28,9,0,9,0
2020-06-23,Ventura,111,848112,3376,2209,15,2224,40
2020-06-23,Yolo,113,214977,551,350,0,350,24
2020-06-23,Yuba,115,75493,55,35,0,35,1
2020-06-22,Alameda,001,1643700,6019,4944,9,4953,121
2020-06-22,Alpine,003,1148,1,1,0,1,0
2020-06-22,Amador,005,37829,19,12,0,12,0
2020-06-22,Butte,007,227075,185,104,7,111,1
2020-06-22,Calaveras,009,45235,38,20,0,20,0
2020-06-22,Colusa,011,21464,37,7,0,7,0
2020-06-22,Contra Costa,013,1133247,2971,2363,3,2366,60
2020-06-22,Del Norte,015,27424,48,46,0,46,0
2020-06-22,El Dorado,017,186661,221,137,1,138,0
2020-06-22,Fresno,019,978130,7029,3425,72,3497,67
2020-06-22,Glenn,021,27897,111,40,0,40,0
2020-06-22,Humboldt,023,135768,148,110,0,110,3
2020-06-22,Imperial,025,180216,7185,4700,4,4704,38
2020-06-22,Inyo,027,18085,29,26,0,26,1
2020-06-22,Kern,029,883053,6261,3982,16,3998,60
2020-06-22,Kings,031,150075,2406,1513,6,1519,13
2020-06-22,Lake,033,64148,54,37,0,37,0
2020-06-22,Lassen,035,31185,118,7,2,9,0
2020-06-22,Los Angeles,037,10098052,99979,85925,27,85952,3117
2020-06-22,Madera,039,155013,702,333,2,335,4
2020-06-22,Marin,041,260295,1717,1029,4,1033,17
2020-06-22,Mariposa,043,17540,25,18,0,18,1
2020-06-22,Mendocino,045,87422,73,48,0,48,0
2020-06-22,Merced,047,269075,1166,619,1,620,8
2020-06-22,Modoc,049,8938,1,0,0,0,0
2020-06-22,Mono,051,14174,42,34,0,34,1
2020-06-22,Monterey,053,433212,1719,1293,5,1298,12
2020-06-22,Napa,055,140530,338,222,0,222,3
2020-06-22,Nevada,057,99092,111,79,1,80,1
2020-06-22,Orange,059,3164182,17142,10711,152,10863,275
2020-06-22,Placer,061,380077,735,512,3,515,9
2020-06-22,Plumas,063,18699,7,6,0,6,0
2020-06-22,Riverside,065,2383286,18585,13948,26,13974,403
2020-06-22,Sacramento,067,1510023,2974,2243,5,2248,62
2020-06-22,San Benito,069,59416,228,164,0,164,2
2020-06-22,San Bernardino,071,2135413,14282,9133,9,9142,229
2020-06-22,San Diego,073,3302833,14074,11098,2,11100,338
2020-06-22,San Francisco,075,870044,3555,3000,1,3001,47
2020-06-22,San Joaquin,077,732212,3554,2332,4,2336,48
2020-06-22,San Luis Obispo,079,281455,650,422,5,427,1
2020-06-22,San Mateo,081,765935,3232,2813,5,2818,81
2020-06-22,Santa Barbara,083,443738,3052,2447,25,2472,21
2020-06-22,Santa Clara,085,1922200,4930,3580,17,3597,155
2020-06-22,Santa Cruz,087,273765,384,290,0,290,3
2020-06-22,Shasta,089,179085,156,77,0,77,5
2020-06-22,Sierra,091,2930,1,1,0,1,0
2020-06-22,Siskiyou,093,43540,30,23,0,23,0
2020-06-22,Solano,095,438530,1400,784,5,789,21
2020-06-22,Sonoma,097,501317,1166,860,2,862,4
2020-06-22,Stanislaus,099,539301,2884,1784,6,1790,35
2020-06-22,Sutter,101,95872,140,100,0,100,2
2020-06-22,Tehama,103,63373,75,38,2,40,1
2020-06-22,Trinity,105,12862,16,2,3,5,0
2020-06-22,Tulare,107,460477,4633,3185,10,3195,111
2020-06-22,Tuolumne,109,53932,19,8,0,8,0
2020-06-22,Ventura,111,848112,3227,2065,15,2080,39
2020-06-22,Yolo,113,214977,525,333,0,333,24
2020-06-22,Yuba,115,75493,50,36,0,36,1
2020-06-21,Alameda,001,1643700,5824,4835,9,4844,121
2020-06-21,Alpine,003,1148,1,1,0,1,0
2020-06-21,Amador,005,37829,14,12,0,12,0
2020-06-21,Butte,007,227075,171,97,7,104,1
2020-06-21,Calaveras,009,45235,38,20,0,20,0
2020-06-21,Colusa,011,21464,29,7,0,7,0
2020-06-21,Contra Costa,013,1133247,2845,2282,3,2285,60
2020-06-21,Del Norte,015,27424,47,46,0,46,0
2020-06-21,El Dorado,017,186661,212,132,1,133,0
2020-06-21,Fresno,019,978130,6459,3296,70,3366,67
2020-06-21,Glenn,021,27897,102,40,0,40,0
2020-06-21,Humboldt,023,135768,143,108,0,108,3
2020-06-21,Imperial,025,180216,7002,4701,4,4705,38
2020-06-21,Inyo,027,18085,27,26,0,26,1
2020-06-21,Kern,029,883053,5969,3918,14,3932,60
2020-06-21,Kings,031,150075,2342,1334,6,1340,11
2020-06-21,Lake,033,64148,49,36,0,36,0
2020-06-21,Lassen,035,31185,25,7,2,9,0
2020-06-21,Los Angeles,037,10098052,97089,83383,26,83409,3101
2020-06-21,Madera,039,155013,668,319,2,321,4
2020-06-21,Marin,041,260295,1560,907,4,911,17
2020-06-21,Mariposa,043,17540,22,18,0,18,1
2020-06-21,Mendocino,045,87422,70,48,0,48,0
2020-06-21,Merced,047,269075,1071,577,1,578,8
2020-06-21,Modoc,049,8938,1,0,0,0,0
2020-06-21,Mono,051,14174,42,34,0,34,1
2020-06-21,Monterey,053,433212,1646,1227,5,1232,12
2020-06-21,Napa,055,140530,323,218,0,218,3
2020-06-21,Nevada,057,99092,108,79,1,80,1
2020-06-21,Orange,059,3164182,16309,10563,148,10711,275
2020-06-21,Placer,061,380077,695,498,3,501,9
2020-06-21,Plumas,063,18699,7,6,0,6,0
2020-06-21,Riverside,065,2383286,17879,13528,25,13553,402
2020-06-21,Sacramento,067,1510023,2773,2156,4,2160,62
2020-06-21,San Benito,069,59416,214,151,0,151,2
2020-06-21,San Bernardino,071,2135413,13508,8925,8,8933,229
2020-06-21,San Diego,073,3302833,13528,10796,2,10798,338
2020-06-21,San Francisco,075,870044,3449,3000,1,3001,47
2020-06-21,San Joaquin,077,732212,3318,2188,4,2192,48
2020-06-21,San Luis Obispo,079,281455,624,418,5,423,1
2020-06-21,San Mateo,081,765935,3174,2781,5,2786,81
2020-06-21,Santa Barbara,083,443738,2945,2430,24,2454,21
2020-06-21,Santa Clara,085,1922200,4793,3514,17,3531,154
2020-06-21,Santa Cruz,087,273765,374,290,0,290,3
2020-06-21,Shasta,089,179085,146,75,0,75,5
2020-06-21,Sierra,091,2930,1,1,0,1,0
2020-06-21,Siskiyou,093,43540,30,23,0,23,0
2020-06-21,Solano,095,438530,1300,783,4,787,21
2020-06-21,Sonoma,097,501317,1116,836,2,838,4
2020-06-21,Stanislaus,099,539301,2698,1688,6,1694,35
2020-06-21,Sutter,101,95872,132,96,0,96,2
2020-06-21,Tehama,103,63373,64,35,2,37,1
2020-06-21,Trinity,105,12862,15,2,3,5,0
2020-06-21,Tulare,107,460477,4464,3173,10,3183,111
2020-06-21,Tuolumne,109,53932,17,8,0,8,0
2020-06-21,Ventura,111,848112,3049,2021,15,2036,39
2020-06-21,Yolo,113,214977,493,323,0,323,24
2020-06-21,Yuba,115,75493,46,35,0,35,1
2020-06-20,Alameda,001,1643700,5762,4758,9,4767,119
2020-06-20,Alpine,003,1148,1,1,0,1,0
2020-06-20,Amador,005,37829,14,12,0,12,0
2020-06-20,Butte,007,227075,164,94,7,101,1
2020-06-20,Calaveras,009,45235,38,20,0,20,0
2020-06-20,Colusa,011,21464,26,7,0,7,0
2020-06-20,Contra Costa,013,1133247,2786,2231,3,2234,54
2020-06-20,Del Norte,015,27424,47,46,0,46,0
2020-06-20,El Dorado,017,186661,207,130,1,131,0
2020-06-20,Fresno,019,978130,6333,3222,67,3289,67
2020-06-20,Glenn,021,27897,97,40,0,40,0
2020-06-20,Humboldt,023,135768,143,108,0,108,3
2020-06-20,Imperial,025,180216,6921,4616,4,4620,37
2020-06-20,Inyo,027,18085,27,26,0,26,1
2020-06-20,Kern,029,883053,5804,3836,14,3850,59
2020-06-20,Kings,031,150075,2318,1331,6,1337,9
2020-06-20,Lake,033,64148,49,37,0,37,0
2020-06-20,Lassen,035,31185,24,7,2,9,0
2020-06-20,Los Angeles,037,10098052,95518,81604,25,81629,3093
2020-06-20,Madera,039,155013,635,321,2,323,4
2020-06-20,Marin,041,260295,1540,879,4,883,17
2020-06-20,Mariposa,043,17540,22,18,0,18,1
2020-06-20,Mendocino,045,87422,69,48,0,48,0
2020-06-20,Merced,047,269075,1031,566,1,567,8
2020-06-20,Modoc,049,8938,1,0,0,0,0
2020-06-20,Mono,051,14174,42,34,0,34,1
2020-06-20,Monterey,053,433212,1610,1181,5,1186,12
2020-06-20,Napa,055,140530,314,212,0,212,3
2020-06-20,Nevada,057,99092,105,73,1,74,1
2020-06-20,Orange,059,3164182,15959,10284,144,10428,273
2020-06-20,Placer,061,380077,670,483,3,486,9
2020-06-20,Plumas,063,18699,6,6,0,6,0
2020-06-20,Riverside,065,2383286,17579,13021,25,13046,402
2020-06-20,Sacramento,067,1510023,2702,2069,4,2073,63
2020-06-20,San Benito,069,59416,210,139,0,139,2
2020-06-20,San Bernardino,071,2135413,13146,8718,8,8726,229
2020-06-20,San Diego,073,3302833,13205,10486,2,10488,338
2020-06-20,San Francisco,075,870044,3405,2999,1,3000,47
2020-06-20,San Joaquin,077,732212,3236,2046,4,2050,48
2020-06-20,San Luis Obispo,079,281455,610,405,5,410,1
2020-06-20,San Mateo,081,765935,3126,2755,5,2760,81
2020-06-20,Santa Barbara,083,443738,2888,2358,23,2381,21
2020-06-20,Santa Clara,085,1922200,4719,3435,17,3452,154
2020-06-20,Santa Cruz,087,273765,372,287,0,287,3
2020-06-20,Shasta,089,179085,140,66,0,66,5
2020-06-20,Sierra,091,2930,1,1,0,1,0
2020-06-20,Siskiyou,093,43540,29,22,0,22,0
2020-06-20,Solano,095,438530,1276,784,4,788,21
2020-06-20,Sonoma,097,501317,1080,806,2,808,4
2020-06-20,Stanislaus,099,539301,2590,1598,6,1604,35
2020-06-20,Sutter,101,95872,130,89,0,89,2
2020-06-20,Tehama,103,63373,62,35,2,37,1
2020-06-20,Trinity,105,12862,15,2,3,5,0
2020-06-20,Tulare,107,460477,4391,3172,10,3182,111
2020-06-20,Tuolumne,109,53932,14,8,0,8,0
2020-06-20,Ventura,111,848112,2983,1946,15,1961,37
2020-06-20,Yolo,113,214977,477,309,0,309,24
2020-06-20,Yuba,115,75493,44,34,0,34,1
2020-06-19,Alameda,001,1643700,5690,4646,9,4655,119
2020-06-19,Alpine,003,1148,1,1,0,1,0
2020-06-19,Amador,005,37829,14,12,0,12,0
2020-06-19,Butte,007,227075,159,91,7,98,1
2020-06-19,Calaveras,009,45235,37,20,0,20,0
2020-06-19,Colusa,011,21464,24,7,0,7,0
2020-06-19,Contra Costa,013,1133247,2706,2106,3,2109,54
2020-06-19,Del Norte,015,27424,47,46,0,46,0
2020-06-19,El Dorado,017,186661,198,124,1,125,0
2020-06-19,Fresno,019,978130,6171,3109,65,3174,61
2020-06-19,Glenn,021,27897,91,40,0,40,0
2020-06-19,Humboldt,023,135768,141,106,0,106,3
2020-06-19,Imperial,025,180216,6830,4504,4,4508,36
2020-06-19,Inyo,027,18085,27,26,0,26,1
2020-06-19,Kern,029,883053,5581,3742,13,3755,57
2020-06-19,Kings,031,150075,2297,1285,6,1291,9
2020-06-19,Lake,033,64148,46,36,0,36,0
2020-06-19,Lassen,035,31185,23,7,2,9,0
2020-06-19,Los Angeles,037,10098052,93532,79572,24,79596,3047
2020-06-19,Madera,039,155013,616,300,2,302,4
2020-06-19,Marin,041,260295,1511,829,4,833,17
2020-06-19,Mariposa,043,17540,21,18,0,18,1
2020-06-19,Mendocino,045,87422,68,48,0,48,0
2020-06-19,Merced,047,269075,986,529,1,530,8
2020-06-19,Modoc,049,8938,1,0,0,0,0
2020-06-19,Mono,051,14174,42,34,0,34,1
2020-06-19,Monterey,053,433212,1581,1159,5,1164,12
2020-06-19,Napa,055,140530,304,209,0,209,3
2020-06-19,Nevada,057,99092,102,71,1,72,1
2020-06-19,Orange,059,3164182,15426,9972,137,10109,260
2020-06-19,Placer,061,380077,652,464,3,467,9
2020-06-19,Plumas,063,18699,6,5,0,5,0
2020-06-19,Riverside,065,2383286,17174,12710,25,12735,398
2020-06-19,Sacramento,067,1510023,2619,1976,4,1980,64
2020-06-19,San Benito,069,59416,209,136,0,136,2
2020-06-19,San Bernardino,071,2135413,12741,8454,7,8461,226
2020-06-19,San Diego,073,3302833,12842,10352,2,10354,332
2020-06-19,San Francisco,075,870044,3350,2968,1,2969,47
2020-06-19,San Joaquin,077,732212,3113,1969,4,1973,48
2020-06-19,San Luis Obispo,079,281455,594,392,5,397,1
2020-06-19,San Mateo,081,765935,3087,2713,5,2718,81
2020-06-19,Santa Barbara,083,443738,2815,2284,21,2305,21
2020-06-19,Santa Clara,085,1922200,4645,3376,17,3393,154
2020-06-19,Santa Cruz,087,273765,362,283,0,283,3
2020-06-19,Shasta,089,179085,137,58,0,58,5
2020-06-19,Sierra,091,2930,1,1,0,1,0
2020-06-19,Siskiyou,093,43540,29,21,0,21,0
2020-06-19,Solano,095,438530,1238,755,4,759,21
2020-06-19,Sonoma,097,501317,1053,803,2,805,4
2020-06-19,Stanislaus,099,539301,2480,1549,6,1555,35
2020-06-19,Sutter,101,95872,129,89,0,89,2
2020-06-19,Tehama,103,63373,61,35,2,37,1
2020-06-19,Trinity,105,12862,15,2,3,5,0
2020-06-19,Tulare,107,460477,4321,3053,10,3063,107
2020-06-19,Tuolumne,109,53932,13,8,0,8,0
2020-06-19,Ventura,111,848112,2899,1865,15,1880,37
2020-06-19,Yolo,113,214977,458,303,0,303,24
2020-06-19,Yuba,115,75493,43,33,0,33,1
2020-06-18,Alameda,001,1643700,5560,4589,9,4598,118
2020-06-18,Alpine,003,1148,1,1,0,1,0
2020-06-18,Amador,005,37829,13,12,0,12,0
2020-06-18,Butte,007,227075,154,88,7,95,1
2020-06-18,Calaveras,009,45235,37,20,0,20,0
2020-06-18,Colusa,011,21464,20,7,0,7,0
2020-06-18,Contra Costa,013,1133247,2599,2072,3,2075,53
2020-06-18,Del Norte,015,27424,47,46,0,46,0
2020-06-18,El Dorado,017,186661,194,121,1,122,0
2020-06-18,Fresno,019,978130,5904,2947,64,3011,57
2020-06-18,Glenn,021,27897,82,35,0,35,0
2020-06-18,Humboldt,023,135768,140,106,0,106,3
2020-06-18,Imperial,025,180216,6680,4366,4,4370,36
2020-06-18,Inyo,027,18085,26,25,0,25,1
2020-06-18,Kern,029,883053,5363,3634,13,3647,57
2020-06-18,Kings,031,150075,2238,1141,6,1147,8
2020-06-18,Lake,033,64148,45,36,0,36,0
2020-06-18,Lassen,035,31185,22,5,2,7,0
2020-06-18,Los Angeles,037,10098052,91263,78244,24,78268,3009
2020-06-18,Madera,039,155013,581,288,2,290,4
2020-06-18,Marin,041,260295,1448,819,4,823,17
2020-06-18,Mariposa,043,17540,19,18,0,18,1
2020-06-18,Mendocino,045,87422,64,45,0,45,0
2020-06-18,Merced,047,269075,934,486,1,487,7
2020-06-18,Modoc,049,8938,1,0,0,0,0
2020-06-18,Mono,051,14174,42,34,0,34,1
2020-06-18,Monterey,053,433212,1513,1127,5,1132,12
2020-06-18,Napa,055,140530,289,205,0,205,3
2020-06-18,Nevada,057,99092,98,68,1,69,1
2020-06-18,Orange,059,3164182,14771,9597,118,9715,255
2020-06-18,Placer,061,380077,629,457,3,460,9
2020-06-18,Plumas,063,18699,6,5,0,5,0
2020-06-18,Riverside,065,2383286,16558,12410,25,12435,392
2020-06-18,Sacramento,067,1510023,2503,1938,4,1942,63
2020-06-18,San Benito,069,59416,203,134,0,134,2
2020-06-18,San Bernardino,071,2135413,12101,8141,7,8148,226
2020-06-18,San Diego,073,3302833,12420,10094,2,10096,331
2020-06-18,San Francisco,075,870044,3301,2951,1,2952,47
2020-06-18,San Joaquin,077,732212,2961,1908,4,1912,47
2020-06-18,San Luis Obispo,079,281455,574,378,5,383,1
2020-06-18,San Mateo,081,765935,3048,2674,5,2679,78
2020-06-18,Santa Barbara,083,443738,2741,2201,21,2222,19
2020-06-18,Santa Clara,085,1922200,4542,3338,17,3355,152
2020-06-18,Santa Cruz,087,273765,345,275,0,275,3
2020-06-18,Shasta,089,179085,126,51,0,51,4
2020-06-18,Sierra,091,2930,1,1,0,1,0
2020-06-18,Siskiyou,093,43540,29,18,0,18,0
2020-06-18,Solano,095,438530,1200,735,4,739,21
2020-06-18,Sonoma,097,501317,1011,789,2,791,4
2020-06-18,Stanislaus,099,539301,2346,1495,6,1501,35
2020-06-18,Sutter,101,95872,125,85,0,85,2
2020-06-18,Tehama,103,63373,56,31,2,33,1
2020-06-18,Trinity,105,12862,15,2,3,5,0
2020-06-18,Tulare,107,460477,4198,3005,10,3015,107
2020-06-18,Tuolumne,109,53932,12,8,0,8,0
2020-06-18,Ventura,111,848112,2773,1781,15,1796,37
2020-06-18,Yolo,113,214977,425,294,0,294,24
2020-06-18,Yuba,115,75493,42,32,0,32,1
2020-06-17,Alameda,001,1643700,5437,4485,9,4494,117
2020-06-17,Alpine,003,1148,1,1,0,1,0
2020-06-17,Amador,005,37829,12,10,0,10,0
2020-06-17,Butte,007,227075,145,81,7,88,1
2020-06-17,Calaveras,009,45235,37,20,0,20,0
2020-06-17,Colusa,011,21464,19,7,0,7,0
2020-06-17,Contra Costa,013,1133247,2502,2020,3,2023,45
2020-06-17,Del Norte,015,27424,47,45,0,45,0
2020-06-17,El Dorado,017,186661,187,116,1,117,0
2020-06-17,Fresno,019,978130,5678,2801,61,2862,56
2020-06-17,Glenn,021,27897,75,31,0,31,0
2020-06-17,Humboldt,023,135768,138,105,0,105,3
2020-06-17,Imperial,025,180216,6507,4108,4,4112,36
2020-06-17,Inyo,027,18085,25,25,0,25,1
2020-06-17,Kern,029,883053,5162,3547,13,3560,56
2020-06-17,Kings,031,150075,2208,1097,6,1103,7
2020-06-17,Lake,033,64148,44,32,0,32,0
2020-06-17,Lassen,035,31185,18,5,2,7,0
2020-06-17,Los Angeles,037,10098052,88953,77166,23,77189,2973
2020-06-17,Madera,039,155013,559,258,2,260,4
2020-06-17,Marin,041,260295,1256,771,3,774,17
2020-06-17,Mariposa,043,17540,18,18,0,18,1
2020-06-17,Mendocino,045,87422,62,42,0,42,0
2020-06-17,Merced,047,269075,862,460,1,461,7
2020-06-17,Modoc,049,8938,1,0,0,0,0
2020-06-17,Mono,051,14174,42,34,0,34,1
2020-06-17,Monterey,053,433212,1461,1077,5,1082,12
2020-06-17,Napa,055,140530,274,202,0,202,3
2020-06-17,Nevada,057,99092,94,57,1,58,1
2020-06-17,Orange,059,3164182,14165,9278,112,9390,230
2020-06-17,Placer,061,380077,609,427,3,430,9
2020-06-17,Plumas,063,18699,6,5,0,5,0
2020-06-17,Riverside,065,2383286,15922,11859,25,11884,370
2020-06-17,Sacramento,067,1510023,2396,1889,4,1893,63
2020-06-17,San Benito,069,59416,198,116,0,116,2
2020-06-17,San Bernardino,071,2135413,11552,7670,7,7677,225
2020-06-17,San Diego,073,3302833,12041,9856,2,9858,327
2020-06-17,San Francisco,075,870044,3262,2906,1,2907,46
2020-06-17,San Joaquin,077,732212,2788,1825,4,1829,46
2020-06-17,San Luis Obispo,079,281455,555,362,5,367,1
2020-06-17,San Mateo,081,765935,3001,2649,5,2654,78
2020-06-17,Santa Barbara,083,443738,2668,2147,19,2166,19
2020-06-17,Santa Clara,085,1922200,4449,3264,16,3280,148
2020-06-17,Santa Cruz,087,273765,339,265,0,265,2
2020-06-17,Shasta,089,179085,124,51,0,51,4
2020-06-17,Sierra,091,2930,1,1,0,1,0
2020-06-17,Siskiyou,093,43540,28,16,0,16,0
2020-06-17,Solano,095,438530,1150,722,4,726,21
2020-06-17,Sonoma,097,501317,985,748,2,750,4
2020-06-17,Stanislaus,099,539301,2223,1387,6,1393,35
2020-06-17,Sutter,101,95872,119,79,0,79,2
2020-06-17,Tehama,103,63373,41,24,2,26,1
2020-06-17,Trinity,105,12862,14,2,3,5,0
2020-06-17,Tulare,107,460477,4088,2882,10,2892,106
2020-06-17,Tuolumne,109,53932,12,7,0,7,0
2020-06-17,Ventura,111,848112,2673,1729,15,1744,37
2020-06-17,Yolo,113,214977,405,277,0,277,24
2020-06-17,Yuba,115,75493,41,30,0,30,1
2020-06-16,Alameda,001,1643700,5319,4428,9,4437,113
2020-06-16,Alpine,003,1148,1,1,0,1,0
2020-06-16,Amador,005,37829,12,10,0,10,0
2020-06-16,Butte,007,227075,141,79,7,86,1
2020-06-16,Calaveras,009,45235,34,19,0,19,0
2020-06-16,Colusa,011,21464,16,7,0,7,0
2020-06-16,Contra Costa,013,1133247,2411,1971,2,1973,45
2020-06-16,Del Norte,015,27424,47,45,0,45,0
2020-06-16,El Dorado,017,186661,181,115,1,116,0
2020-06-16,Fresno,019,978130,5440,2731,59,2790,50
2020-06-16,Glenn,021,27897,71,30,0,30,0
2020-06-16,Humboldt,023,135768,135,105,0,105,3
2020-06-16,Imperial,025,180216,6348,3939,4,3943,36
2020-06-16,Inyo,027,18085,25,24,0,24,1
2020-06-16,Kern,029,883053,4939,3496,13,3509,55
2020-06-16,Kings,031,150075,2162,1044,6,1050,6
2020-06-16,Lake,033,64148,44,31,0,31,0
2020-06-16,Lassen,035,31185,15,5,2,7,0
2020-06-16,Los Angeles,037,10098052,86629,75051,23,75074,2942
2020-06-16,Madera,039,155013,533,239,2,241,3
2020-06-16,Marin,041,260295,1203,725,3,728,17
2020-06-16,Mariposa,043,17540,18,17,0,17,1
2020-06-16,Mendocino,045,87422,61,35,0,35,0
2020-06-16,Merced,047,269075,814,436,1,437,7
2020-06-16,Modoc,049,8938,1,0,0,0,0
2020-06-16,Mono,051,14174,42,34,0,34,1
2020-06-16,Monterey,053,433212,1413,1019,5,1024,12
2020-06-16,Napa,055,140530,259,196,0,196,3
2020-06-16,Nevada,057,99092,91,53,1,54,1
2020-06-16,Orange,059,3164182,13581,9163,107,9270,223
2020-06-16,Placer,061,380077,577,392,3,395,9
2020-06-16,Plumas,063,18699,6,5,0,5,0
2020-06-16,Riverside,065,2383286,15247,11638,25,11663,364
2020-06-16,Sacramento,067,1510023,2286,1825,4,1829,60
2020-06-16,San Benito,069,59416,190,110,0,110,2
2020-06-16,San Bernardino,071,2135413,11008,7463,7,7470,225
2020-06-16,San Diego,073,3302833,11679,9732,1,9733,323
2020-06-16,San Francisco,075,870044,3211,2893,1,2894,46
2020-06-16,San Joaquin,077,732212,2635,1718,4,1722,47
2020-06-16,San Luis Obispo,079,281455,531,343,5,348,1
2020-06-16,San Mateo,081,765935,2947,2618,5,2623,77
2020-06-16,Santa Barbara,083,443738,2601,2090,19,2109,16
2020-06-16,Santa Clara,085,1922200,4338,3228,15,3243,148
2020-06-16,Santa Cruz,087,273765,323,257,0,257,2
2020-06-16,Shasta,089,179085,115,51,0,51,4
2020-06-16,Sierra,091,2930,1,1,0,1,0
2020-06-16,Siskiyou,093,43540,27,15,0,15,0
2020-06-16,Solano,095,438530,1060,694,4,698,19
2020-06-16,Sonoma,097,501317,953,739,2,741,4
2020-06-16,Stanislaus,099,539301,2070,1278,6,1284,36
2020-06-16,Sutter,101,95872,112,73,0,73,2
2020-06-16,Tehama,103,63373,37,24,2,26,1
2020-06-16,Trinity,105,12862,14,2,3,5,0
2020-06-16,Tulare,107,460477,3969,2802,10,2812,96
2020-06-16,Tuolumne,109,53932,12,7,0,7,0
2020-06-16,Ventura,111,848112,2573,1676,15,1691,37
2020-06-16,Yolo,113,214977,382,262,0,262,24
2020-06-16,Yuba,115,75493,39,29,0,29,1
2020-06-15,Alameda,001,1643700,5193,4323,9,4332,112
2020-06-15,Alpine,003,1148,1,1,0,1,0
2020-06-15,Amador,005,37829,12,10,0,10,0
2020-06-15,Butte,007,227075,133,78,7,85,1
2020-06-15,Calaveras,009,45235,34,18,0,18,0
2020-06-15,Colusa,011,21464,14,7,0,7,0
2020-06-15,Contra Costa,013,1133247,2334,1918,2,1920,43
2020-06-15,Del Norte,015,27424,47,45,0,45,0
2020-06-15,El Dorado,017,186661,171,114,1,115,0
2020-06-15,Fresno,019,978130,5228,2616,58,2674,48
2020-06-15,Glenn,021,27897,66,21,0,21,0
2020-06-15,Humboldt,023,135768,133,105,0,105,3
2020-06-15,Imperial,025,180216,6173,3726,4,3730,36
2020-06-15,Inyo,027,18085,25,23,0,23,1
2020-06-15,Kern,029,883053,4716,3417,13,3430,55
2020-06-15,Kings,031,150075,2085,1022,6,1028,6
2020-06-15,Lake,033,64148,44,31,0,31,0
2020-06-15,Lassen,035,31185,15,5,2,7,0
2020-06-15,Los Angeles,037,10098052,84442,73705,23,73728,2908
2020-06-15,Madera,039,155013,511,203,2,205,3
2020-06-15,Marin,041,260295,1036,708,3,711,17
2020-06-15,Mariposa,043,17540,18,17,0,17,1
2020-06-15,Mendocino,045,87422,52,33,0,33,0
2020-06-15,Merced,047,269075,768,414,1,415,7
2020-06-15,Modoc,049,8938,1,0,0,0,0
2020-06-15,Mono,051,14174,42,34,0,34,1
2020-06-15,Monterey,053,433212,1347,998,5,1003,12
2020-06-15,Napa,055,140530,251,187,0,187,3
2020-06-15,Nevada,057,99092,85,52,1,53,1
2020-06-15,Orange,059,3164182,13013,8944,99,9043,212
2020-06-15,Placer,061,380077,555,386,3,389,9
2020-06-15,Plumas,063,18699,6,4,0,4,0
2020-06-15,Riverside,065,2383286,14629,11376,24,11400,364
2020-06-15,Sacramento,067,1510023,2170,1791,4,1795,60
2020-06-15,San Benito,069,59416,184,108,0,108,2
2020-06-15,San Bernardino,071,2135413,10505,7189,7,7196,224
2020-06-15,San Diego,073,3302833,11339,9612,1,9613,320
2020-06-15,San Francisco,075,870044,3167,2833,1,2834,45
2020-06-15,San Joaquin,077,732212,2499,1667,4,1671,43
2020-06-15,San Luis Obispo,079,281455,516,332,5,337,1
2020-06-15,San Mateo,081,765935,2900,2591,5,2596,75
2020-06-15,Santa Barbara,083,443738,2533,2054,19,2073,16
2020-06-15,Santa Clara,085,1922200,4238,3204,15,3219,148
2020-06-15,Santa Cruz,087,273765,312,254,0,254,2
2020-06-15,Shasta,089,179085,109,50,0,50,4
2020-06-15,Sierra,091,2930,1,1,0,1,0
2020-06-15,Siskiyou,093,43540,26,14,0,14,0
2020-06-15,Solano,095,438530,1000,638,4,642,19
2020-06-15,Sonoma,097,501317,924,726,2,728,4
2020-06-15,Stanislaus,099,539301,1953,1253,6,1259,35
2020-06-15,Sutter,101,95872,102,71,0,71,2
2020-06-15,Tehama,103,63373,37,17,2,19,1
2020-06-15,Trinity,105,12862,13,2,3,5,0
2020-06-15,Tulare,107,460477,3855,2662,10,2672,96
2020-06-15,Tuolumne,109,53932,11,7,0,7,0
2020-06-15,Ventura,111,848112,2492,1656,15,1671,37
2020-06-15,Yolo,113,214977,362,255,0,255,24
2020-06-15,Yuba,115,75493,39,28,0,28,1
2020-06-14,Alameda,001,1643700,5047,4271,9,4280,112
2020-06-14,Alpine,003,1148,1,1,0,1,0
2020-06-14,Amador,005,37829,12,10,0,10,0
2020-06-14,Butte,007,227075,125,78,7,85,1
2020-06-14,Calaveras,009,45235,33,18,0,18,0
2020-06-14,Colusa,011,21464,13,7,0,7,0
2020-06-14,Contra Costa,013,1133247,2266,1893,2,1895,43
2020-06-14,Del Norte,015,27424,47,45,0,45,0
2020-06-14,El Dorado,017,186661,167,110,1,111,0
2020-06-14,Fresno,019,978130,5043,2585,57,2642,48
2020-06-14,Glenn,021,27897,51,21,0,21,0
2020-06-14,Humboldt,023,135768,129,105,0,105,3
2020-06-14,Imperial,025,180216,5942,3730,4,3734,36
2020-06-14,Inyo,027,18085,24,23,0,23,1
2020-06-14,Kern,029,883053,4505,3328,13,3341,55
2020-06-14,Kings,031,150075,2034,1022,5,1027,6
2020-06-14,Lake,033,64148,41,31,0,31,0
2020-06-14,Lassen,035,31185,15,5,2,7,0
2020-06-14,Los Angeles,037,10098052,82113,72932,22,72954,2887
2020-06-14,Madera,039,155013,492,203,2,205,3
2020-06-14,Marin,041,260295,871,689,2,691,17
2020-06-14,Mariposa,043,17540,18,16,0,16,1
2020-06-14,Mendocino,045,87422,49,33,0,33,0
2020-06-14,Merced,047,269075,717,403,1,404,7
2020-06-14,Modoc,049,8938,1,0,0,0,0
2020-06-14,Mono,051,14174,42,34,0,34,1
2020-06-14,Monterey,053,433212,1286,949,5,954,12
2020-06-14,Napa,055,140530,229,181,0,181,3
2020-06-14,Nevada,057,99092,81,52,1,53,1
2020-06-14,Orange,059,3164182,12586,8744,94,8838,211
2020-06-14,Placer,061,380077,529,369,3,372,9
2020-06-14,Plumas,063,18699,5,4,0,4,0
2020-06-14,Riverside,065,2383286,14186,11218,24,11242,364
2020-06-14,Sacramento,067,1510023,2083,1750,4,1754,60
2020-06-14,San Benito,069,59416,173,104,0,104,2
2020-06-14,San Bernardino,071,2135413,9965,7015,7,7022,224
2020-06-14,San Diego,073,3302833,10964,9442,1,9443,319
2020-06-14,San Francisco,075,870044,3127,2834,1,2835,45
2020-06-14,San Joaquin,077,732212,2348,1603,4,1607,43
2020-06-14,San Luis Obispo,079,281455,501,330,5,335,1
2020-06-14,San Mateo,081,765935,2842,2571,5,2576,75
2020-06-14,Santa Barbara,083,443738,2456,2049,19,2068,17
2020-06-14,Santa Clara,085,1922200,4143,3178,15,3193,148
2020-06-14,Santa Cruz,087,273765,298,254,0,254,2
2020-06-14,Shasta,089,179085,103,48,0,48,4
2020-06-14,Sierra,091,2930,1,1,0,1,0
2020-06-14,Siskiyou,093,43540,25,13,0,13,0
2020-06-14,Solano,095,438530,951,638,4,642,19
2020-06-14,Sonoma,097,501317,896,724,2,726,4
2020-06-14,Stanislaus,099,539301,1805,1159,6,1165,35
2020-06-14,Sutter,101,95872,97,63,0,63,2
2020-06-14,Tehama,103,63373,34,17,2,19,1
2020-06-14,Trinity,105,12862,13,2,3,5,0
2020-06-14,Tulare,107,460477,3721,2646,10,2656,96
2020-06-14,Tuolumne,109,53932,11,7,0,7,0
2020-06-14,Ventura,111,848112,2393,1610,14,1624,37
2020-06-14,Yolo,113,214977,346,254,0,254,24
2020-06-14,Yuba,115,75493,38,28,0,28,1
2020-06-13,Alameda,001,1643700,4984,4196,9,4205,112
2020-06-13,Alpine,003,1148,1,1,0,1,0
2020-06-13,Amador,005,37829,11,10,0,10,0
2020-06-13,Butte,007,227075,116,72,7,79,1
2020-06-13,Calaveras,009,45235,31,18,0,18,0
2020-06-13,Colusa,011,21464,12,7,0,7,0
2020-06-13,Contra Costa,013,1133247,2230,1868,2,1870,43
2020-06-13,Del Norte,015,27424,47,45,0,45,0
2020-06-13,El Dorado,017,186661,163,110,1,111,0
2020-06-13,Fresno,019,978130,4945,2499,57,2556,48
2020-06-13,Glenn,021,27897,49,21,0,21,0
2020-06-13,Humboldt,023,135768,128,104,0,104,3
2020-06-13,Imperial,025,180216,5869,3646,4,3650,36
2020-06-13,Inyo,027,18085,24,23,0,23,1
2020-06-13,Kern,029,883053,4396,3239,13,3252,55
2020-06-13,Kings,031,150075,2014,1023,5,1028,6
2020-06-13,Lake,033,64148,40,29,0,29,0
2020-06-13,Lassen,035,31185,15,5,2,7,0
2020-06-13,Los Angeles,037,10098052,81071,71938,22,71960,2874
2020-06-13,Madera,039,155013,488,203,2,205,3
2020-06-13,Marin,041,260295,840,677,2,679,17
2020-06-13,Mariposa,043,17540,18,16,0,16,1
2020-06-13,Mendocino,045,87422,49,33,0,33,0
2020-06-13,Merced,047,269075,699,376,1,377,7
2020-06-13,Modoc,049,8938,1,0,0,0,0
2020-06-13,Mono,051,14174,42,35,0,35,1
2020-06-13,Monterey,053,433212,1248,900,5,905,11
2020-06-13,Napa,055,140530,226,171,0,171,3
2020-06-13,Nevada,057,99092,79,52,1,53,1
2020-06-13,Orange,059,3164182,12342,8581,91,8672,211
2020-06-13,Placer,061,380077,512,346,3,349,9
2020-06-13,Plumas,063,18699,5,4,0,4,0
2020-06-13,Riverside,065,2383286,13907,10931,24,10955,364
2020-06-13,Sacramento,067,1510023,2028,1713,4,1717,60
2020-06-13,San Benito,069,59416,166,99,0,99,2
2020-06-13,San Bernardino,071,2135413,9742,6885,7,6892,224
2020-06-13,San Diego,073,3302833,10792,9316,1,9317,319
2020-06-13,San Francisco,075,870044,3107,2834,1,2835,44
2020-06-13,San Joaquin,077,732212,2267,1461,4,1465,43
2020-06-13,San Luis Obispo,079,281455,490,326,5,331,1
2020-06-13,San Mateo,081,765935,2819,2551,5,2556,75
2020-06-13,Santa Barbara,083,443738,2398,1999,19,2018,15
2020-06-13,Santa Clara,085,1922200,4100,3141,15,3156,148
2020-06-13,Santa Cruz,087,273765,292,254,0,254,2
2020-06-13,Shasta,089,179085,101,48,0,48,4
2020-06-13,Sierra,091,2930,1,1,0,1,0
2020-06-13,Siskiyou,093,43540,25,13,0,13,0
2020-06-13,Solano,095,438530,923,637,4,641,19
2020-06-13,Sonoma,097,501317,881,711,2,713,4
2020-06-13,Stanislaus,099,539301,1748,1122,6,1128,33
2020-06-13,Sutter,101,95872,96,62,0,62,2
2020-06-13,Tehama,103,63373,33,17,2,19,1
2020-06-13,Trinity,105,12862,13,2,3,5,0
2020-06-13,Tulare,107,460477,3689,2626,10,2636,96
2020-06-13,Tuolumne,109,53932,10,7,0,7,0
2020-06-13,Ventura,111,848112,2347,1567,14,1581,37
2020-06-13,Yolo,113,214977,326,251,0,251,24
2020-06-13,Yuba,115,75493,38,28,0,28,1
2020-06-12,Alameda,001,1643700,4911,4167,9,4176,109
2020-06-12,Alpine,003,1148,1,1,0,1,0
2020-06-12,Amador,005,37829,11,10,0,10,0
2020-06-12,Butte,007,227075,112,71,7,78,1
2020-06-12,Calaveras,009,45235,28,18,0,18,0
2020-06-12,Colusa,011,21464,12,7,0,7,0
2020-06-12,Contra Costa,013,1133247,2193,1827,2,1829,43
2020-06-12,Del Norte,015,27424,47,45,0,45,0
2020-06-12,El Dorado,017,186661,163,110,1,111,0
2020-06-12,Fresno,019,978130,4807,2428,57,2485,47
2020-06-12,Glenn,021,27897,46,21,0,21,0
2020-06-12,Humboldt,023,135768,126,105,0,105,3
2020-06-12,Imperial,025,180216,5785,3543,4,3547,36
2020-06-12,Inyo,027,18085,24,23,0,23,1
2020-06-12,Kern,029,883053,4279,3152,13,3165,54
2020-06-12,Kings,031,150075,2001,987,5,992,6
2020-06-12,Lake,033,64148,39,29,0,29,0
2020-06-12,Lassen,035,31185,15,5,2,7,0
2020-06-12,Los Angeles,037,10098052,79666,70385,22,70407,2814
2020-06-12,Madera,039,155013,463,187,2,189,3
2020-06-12,Marin,041,260295,837,649,2,651,17
2020-06-12,Mariposa,043,17540,18,16,0,16,1
2020-06-12,Mendocino,045,87422,49,33,0,33,0
2020-06-12,Merced,047,269075,665,372,1,373,7
2020-06-12,Modoc,049,8938,1,0,0,0,0
2020-06-12,Mono,051,14174,39,35,0,35,1
2020-06-12,Monterey,053,433212,1207,864,4,868,11
2020-06-12,Napa,055,140530,223,162,0,162,3
2020-06-12,Nevada,057,99092,73,52,1,53,1
2020-06-12,Orange,059,3164182,12036,8440,90,8530,203
2020-06-12,Placer,061,380077,495,333,3,336,9
2020-06-12,Plumas,063,18699,5,4,0,4,0
2020-06-12,Riverside,065,2383286,13570,10616,24,10640,364
2020-06-12,Sacramento,067,1510023,1973,1702,4,1706,60
2020-06-12,San Benito,069,59416,159,96,0,96,2
2020-06-12,San Bernardino,071,2135413,9474,6707,7,6714,223
2020-06-12,San Diego,073,3302833,10622,9132,1,9133,313
2020-06-12,San Francisco,075,870044,3073,2823,1,2824,44
2020-06-12,San Joaquin,077,732212,2187,1406,4,1410,43
2020-06-12,San Luis Obispo,079,281455,474,321,5,326,1
2020-06-12,San Mateo,081,765935,2784,2533,5,2538,75
2020-06-12,Santa Barbara,083,443738,2344,1969,19,1988,14
2020-06-12,Santa Clara,085,1922200,4056,3099,15,3114,149
2020-06-12,Santa Cruz,087,273765,284,251,0,251,2
2020-06-12,Shasta,089,179085,94,48,0,48,5
2020-06-12,Sierra,091,2930,1,1,0,1,0
2020-06-12,Siskiyou,093,43540,25,13,0,13,0
2020-06-12,Solano,095,438530,909,620,4,624,19
2020-06-12,Sonoma,097,501317,862,696,2,698,4
2020-06-12,Stanislaus,099,539301,1689,1092,6,1098,33
2020-06-12,Sutter,101,95872,95,56,0,56,2
2020-06-12,Tehama,103,63373,32,13,2,15,1
2020-06-12,Trinity,105,12862,13,2,3,5,0
2020-06-12,Tulare,107,460477,3635,2552,10,2562,95
2020-06-12,Tuolumne,109,53932,10,7,0,7,0
2020-06-12,Ventura,111,848112,2295,1534,14,1548,35
2020-06-12,Yolo,113,214977,314,243,0,243,24
2020-06-12,Yuba,115,75493,36,27,0,27,1
2020-06-11,Alameda,001,1643700,4781,4073,8,4081,108
2020-06-11,Alpine,003,1148,1,1,0,1,0
2020-06-11,Amador,005,37829,10,10,0,10,0
2020-06-11,Butte,007,227075,106,72,7,79,1
2020-06-11,Calaveras,009,45235,27,16,0,16,0
2020-06-11,Colusa,011,21464,12,7,0,7,0
2020-06-11,Contra Costa,013,1133247,2140,1797,2,1799,43
2020-06-11,Del Norte,015,27424,47,45,0,45,0
2020-06-11,El Dorado,017,186661,155,109,1,110,0
2020-06-11,Fresno,019,978130,4653,2338,57,2395,45
2020-06-11,Glenn,021,27897,42,21,0,21,0
2020-06-11,Humboldt,023,135768,122,113,0,113,3
2020-06-11,Imperial,025,180216,5629,3463,4,3467,36
2020-06-11,Inyo,027,18085,22,23,0,23,1
2020-06-11,Kern,029,883053,4127,3047,11,3058,54
2020-06-11,Kings,031,150075,1968,963,5,968,6
2020-06-11,Lake,033,64148,39,28,0,28,0
2020-06-11,Lassen,035,31185,15,5,2,7,0
2020-06-11,Los Angeles,037,10098052,78001,68807,21,68828,2800
2020-06-11,Madera,039,155013,445,178,2,180,3
2020-06-11,Marin,041,260295,789,637,2,639,17
2020-06-11,Mariposa,043,17540,18,16,0,16,1
2020-06-11,Mendocino,045,87422,40,35,0,35,0
2020-06-11,Merced,047,269075,625,370,1,371,7
2020-06-11,Modoc,049,8938,1,0,0,0,0
2020-06-11,Mono,051,14174,39,35,0,35,1
2020-06-11,Monterey,053,433212,1160,813,4,817,11
2020-06-11,Napa,055,140530,214,162,0,162,3
2020-06-11,Nevada,057,99092,67,50,1,51,1
2020-06-11,Orange,059,3164182,11728,8304,89,8393,188
2020-06-11,Placer,061,380077,476,321,3,324,9
2020-06-11,Plumas,063,18699,5,4,0,4,0
2020-06-11,Riverside,065,2383286,13217,10014,24,10038,361
2020-06-11,Sacramento,067,1510023,1925,1669,4,1673,60
2020-06-11,San Benito,069,59416,153,94,0,94,2
2020-06-11,San Bernardino,071,2135413,9177,6509,7,6516,221
2020-06-11,San Diego,073,3302833,10392,9000,0,9000,308
2020-06-11,San Francisco,075,870044,3044,2766,1,2767,44
2020-06-11,San Joaquin,077,732212,2075,1351,4,1355,43
2020-06-11,San Luis Obispo,079,281455,460,307,5,312,1
2020-06-11,San Mateo,081,765935,2746,2499,5,2504,74
2020-06-11,Santa Barbara,083,443738,2283,1895,19,1914,14
2020-06-11,Santa Clara,085,1922200,3989,3049,15,3064,149
2020-06-11,Santa Cruz,087,273765,280,247,0,247,2
2020-06-11,Shasta,089,179085,87,47,0,47,5
2020-06-11,Sierra,091,2930,1,1,0,1,0
2020-06-11,Siskiyou,093,43540,25,14,0,14,0
2020-06-11,Solano,095,438530,883,616,4,620,19
2020-06-11,Sonoma,097,501317,840,682,2,684,4
2020-06-11,Stanislaus,099,539301,1598,1062,6,1068,30
2020-06-11,Sutter,101,95872,92,56,0,56,2
2020-06-11,Tehama,103,63373,27,10,2,12,1
2020-06-11,Trinity,105,12862,11,2,3,5,0
2020-06-11,Tulare,107,460477,3536,2473,10,2483,95
2020-06-11,Tuolumne,109,53932,10,7,0,7,0
2020-06-11,Ventura,111,848112,2218,1491,13,1504,34
2020-06-11,Yolo,113,214977,306,230,0,230,24
2020-06-11,Yuba,115,75493,36,27,0,27,1
2020-06-10,Alameda,001,1643700,4681,4027,7,4034,107
2020-06-10,Alpine,003,1148,1,1,0,1,0
2020-06-10,Amador,005,37829,10,10,0,10,0
2020-06-10,Butte,007,227075,102,71,7,78,1
2020-06-10,Calaveras,009,45235,27,16,0,16,0
2020-06-10,Colusa,011,21464,11,7,0,7,0
2020-06-10,Contra Costa,013,1133247,2096,1778,2,1780,43
2020-06-10,Del Norte,015,27424,47,45,0,45,0
2020-06-10,El Dorado,017,186661,152,109,1,110,0
2020-06-10,Fresno,019,978130,4476,2324,57,2381,45
2020-06-10,Glenn,021,27897,39,21,0,21,0
2020-06-10,Humboldt,023,135768,118,112,0,112,3
2020-06-10,Imperial,025,180216,5481,3454,4,3458,36
2020-06-10,Inyo,027,18085,22,23,0,23,1
2020-06-10,Kern,029,883053,4002,3000,10,3010,54
2020-06-10,Kings,031,150075,1922,952,4,956,6
2020-06-10,Lake,033,64148,39,28,0,28,0
2020-06-10,Lassen,035,31185,15,5,2,7,0
2020-06-10,Los Angeles,037,10098052,76480,67018,21,67039,2752
2020-06-10,Madera,039,155013,431,176,1,177,3
2020-06-10,Marin,041,260295,757,633,2,635,17
2020-06-10,Mariposa,043,17540,17,16,0,16,1
2020-06-10,Mendocino,045,87422,39,35,0,35,0
2020-06-10,Merced,047,269075,592,370,1,371,7
2020-06-10,Modoc,049,8938,1,0,0,0,0
2020-06-10,Mono,051,14174,39,35,0,35,1
2020-06-10,Monterey,053,433212,1106,791,4,795,11
2020-06-10,Napa,055,140530,211,159,0,159,3
2020-06-10,Nevada,057,99092,65,50,1,51,1
2020-06-10,Orange,059,3164182,11452,8222,85,8307,184
2020-06-10,Placer,061,380077,451,309,3,312,9
2020-06-10,Plumas,063,18699,5,4,0,4,0
2020-06-10,Riverside,065,2383286,12894,9857,24,9881,361
2020-06-10,Sacramento,067,1510023,1886,1643,2,1645,59
2020-06-10,San Benito,069,59416,144,94,0,94,2
2020-06-10,San Bernardino,071,2135413,8884,6438,7,6445,219
2020-06-10,San Diego,073,3302833,10228,8839,0,8839,305
2020-06-10,San Francisco,075,870044,3019,2774,1,2775,44
2020-06-10,San Joaquin,077,732212,1946,1282,4,1286,41
2020-06-10,San Luis Obispo,079,281455,440,306,5,311,1
2020-06-10,San Mateo,081,765935,2706,2492,5,2497,74
2020-06-10,Santa Barbara,083,443738,2227,1878,19,1897,13
2020-06-10,Santa Clara,085,1922200,3938,3032,15,3047,149
2020-06-10,Santa Cruz,087,273765,276,242,0,242,2
2020-06-10,Shasta,089,179085,82,45,0,45,5
2020-06-10,Sierra,091,2930,1,1,0,1,0
2020-06-10,Siskiyou,093,43540,25,14,0,14,0
2020-06-10,Solano,095,438530,847,608,4,612,19
2020-06-10,Sonoma,097,501317,822,673,2,675,4
2020-06-10,Stanislaus,099,539301,1508,1030,6,1036,29
2020-06-10,Sutter,101,95872,91,56,0,56,2
2020-06-10,Tehama,103,63373,25,10,2,12,1
2020-06-10,Trinity,105,12862,11,2,3,5,0
2020-06-10,Tulare,107,460477,3443,2455,10,2465,95
2020-06-10,Tuolumne,109,53932,10,7,0,7,0
2020-06-10,Ventura,111,848112,2172,1446,12,1458,34
2020-06-10,Yolo,113,214977,298,226,0,226,24
2020-06-10,Yuba,115,75493,35,27,0,27,1
2020-06-09,Alameda,001,1643700,4571,3963,7,3970,103
2020-06-09,Alpine,003,1148,1,1,0,1,0
2020-06-09,Amador,005,37829,10,10,0,10,0
2020-06-09,Butte,007,227075,101,70,6,76,1
2020-06-09,Calaveras,009,45235,27,16,0,16,0
2020-06-09,Colusa,011,21464,10,7,0,7,0
2020-06-09,Contra Costa,013,1133247,2055,1744,2,1746,42
2020-06-09,Del Norte,015,27424,47,45,0,45,0
2020-06-09,El Dorado,017,186661,142,108,1,109,0
2020-06-09,Fresno,019,978130,4324,2278,57,2335,43
2020-06-09,Glenn,021,27897,38,19,0,19,0
2020-06-09,Humboldt,023,135768,116,113,0,113,2
2020-06-09,Imperial,025,180216,5329,3067,4,3071,36
2020-06-09,Inyo,027,18085,22,22,0,22,1
2020-06-09,Kern,029,883053,3874,2920,10,2930,51
2020-06-09,Kings,031,150075,1890,934,4,938,6
2020-06-09,Lake,033,64148,39,28,0,28,0
2020-06-09,Lassen,035,31185,15,5,2,7,0
2020-06-09,Los Angeles,037,10098052,74819,65827,21,65848,2692
2020-06-09,Madera,039,155013,416,172,1,173,3
2020-06-09,Marin,041,260295,721,616,2,618,17
2020-06-09,Mariposa,043,17540,17,16,0,16,1
2020-06-09,Mendocino,045,87422,35,35,0,35,0
2020-06-09,Merced,047,269075,563,349,1,350,7
2020-06-09,Modoc,049,8938,1,0,0,0,0
2020-06-09,Mono,051,14174,39,35,0,35,1
2020-06-09,Monterey,053,433212,1065,772,4,776,11
2020-06-09,Napa,055,140530,201,156,0,156,3
2020-06-09,Nevada,057,99092,57,50,1,51,1
2020-06-09,Orange,059,3164182,11211,7991,83,8074,174
2020-06-09,Placer,061,380077,438,301,3,304,9
2020-06-09,Plumas,063,18699,5,4,0,4,0
2020-06-09,Riverside,065,2383286,12516,9511,24,9535,354
2020-06-09,Sacramento,067,1510023,1832,1625,2,1627,59
2020-06-09,San Benito,069,59416,138,95,0,95,2
2020-06-09,San Bernardino,071,2135413,8560,6268,6,6274,217
2020-06-09,San Diego,073,3302833,10043,8731,0,8731,301
2020-06-09,San Francisco,075,870044,2994,2749,1,2750,44
2020-06-09,San Joaquin,077,732212,1840,1240,4,1244,41
2020-06-09,San Luis Obispo,079,281455,427,301,4,305,1
2020-06-09,San Mateo,081,765935,2675,2463,5,2468,74
2020-06-09,Santa Barbara,083,443738,2171,1854,19,1873,13
2020-06-09,Santa Clara,085,1922200,3870,3006,14,3020,147
2020-06-09,Santa Cruz,087,273765,270,237,0,237,2
2020-06-09,Shasta,089,179085,78,44,0,44,4
2020-06-09,Sierra,091,2930,1,1,0,1,0
2020-06-09,Siskiyou,093,43540,20,10,0,10,0
2020-06-09,Solano,095,438530,812,596,4,600,18
2020-06-09,Sonoma,097,501317,799,661,2,663,4
2020-06-09,Stanislaus,099,539301,1407,993,6,999,25
2020-06-09,Sutter,101,95872,88,56,0,56,2
2020-06-09,Tehama,103,63373,25,9,2,11,1
2020-06-09,Trinity,105,12862,10,2,3,5,0
2020-06-09,Tulare,107,460477,3377,2393,10,2403,91
2020-06-09,Tuolumne,109,53932,10,8,0,8,0
2020-06-09,Ventura,111,848112,2106,1407,12,1419,34
2020-06-09,Yolo,113,214977,287,226,0,226,24
2020-06-09,Yuba,115,75493,34,27,0,27,1
2020-06-08,Alameda,001,1643700,4490,3937,7,3944,103
2020-06-08,Alpine,003,1148,1,1,0,1,0
2020-06-08,Amador,005,37829,10,10,0,10,0
2020-06-08,Butte,007,227075,97,68,6,74,1
2020-06-08,Calaveras,009,45235,27,16,0,16,0
2020-06-08,Colusa,011,21464,9,7,0,7,0
2020-06-08,Contra Costa,013,1133247,2012,1714,2,1716,41
2020-06-08,Del Norte,015,27424,47,45,0,45,0
2020-06-08,El Dorado,017,186661,138,107,1,108,0
2020-06-08,Fresno,019,978130,4200,2194,56,2250,42
2020-06-08,Glenn,021,27897,36,17,0,17,0
2020-06-08,Humboldt,023,135768,116,112,0,112,2
2020-06-08,Imperial,025,180216,5177,3051,4,3055,21
2020-06-08,Inyo,027,18085,22,22,0,22,1
2020-06-08,Kern,029,883053,3743,2853,9,2862,49
2020-06-08,Kings,031,150075,1814,892,4,896,6
2020-06-08,Lake,033,64148,39,28,0,28,0
2020-06-08,Lassen,035,31185,15,4,2,6,0
2020-06-08,Los Angeles,037,10098052,73357,64634,21,64655,2640
2020-06-08,Madera,039,155013,386,154,1,155,3
2020-06-08,Marin,041,260295,680,596,2,598,17
2020-06-08,Mariposa,043,17540,16,16,0,16,1
2020-06-08,Mendocino,045,87422,33,32,0,32,0
2020-06-08,Merced,047,269075,529,331,1,332,7
2020-06-08,Modoc,049,8938,1,0,0,0,0
2020-06-08,Mono,051,14174,39,35,0,35,1
2020-06-08,Monterey,053,433212,1014,751,3,754,10
2020-06-08,Napa,055,140530,185,151,0,151,3
2020-06-08,Nevada,057,99092,56,50,1,51,1
2020-06-08,Orange,059,3164182,10960,7786,81,7867,160
2020-06-08,Placer,061,380077,421,290,3,293,9
2020-06-08,Plumas,063,18699,5,4,0,4,0
2020-06-08,Riverside,065,2383286,12147,9246,24,9270,347
2020-06-08,Sacramento,067,1510023,1782,1591,2,1593,59
2020-06-08,San Benito,069,59416,131,93,0,93,2
2020-06-08,San Bernardino,071,2135413,8241,6122,6,6128,214
2020-06-08,San Diego,073,3302833,9886,8621,0,8621,296
2020-06-08,San Francisco,075,870044,2967,2715,1,2716,43
2020-06-08,San Joaquin,077,732212,1733,1198,4,1202,40
2020-06-08,San Luis Obispo,079,281455,421,300,4,304,1
2020-06-08,San Mateo,081,765935,2644,2431,4,2435,74
2020-06-08,Santa Barbara,083,443738,2116,1824,17,1841,13
2020-06-08,Santa Clara,085,1922200,3824,2971,14,2985,146
2020-06-08,Santa Cruz,087,273765,269,234,0,234,2
2020-06-08,Shasta,089,179085,74,43,0,43,4
2020-06-08,Sierra,091,2930,1,1,0,1,0
2020-06-08,Siskiyou,093,43540,20,8,0,8,0
2020-06-08,Solano,095,438530,785,560,4,564,19
2020-06-08,Sonoma,097,501317,783,654,2,656,4
2020-06-08,Stanislaus,099,539301,1325,956,6,962,28
2020-06-08,Sutter,101,95872,81,55,0,55,2
2020-06-08,Tehama,103,63373,19,8,2,10,1
2020-06-08,Trinity,105,12862,10,2,3,5,0
2020-06-08,Tulare,107,460477,3294,2301,10,2311,91
2020-06-08,Tuolumne,109,53932,9,8,0,8,0
2020-06-08,Ventura,111,848112,2048,1382,12,1394,30
2020-06-08,Yolo,113,214977,276,228,0,228,24
2020-06-08,Yuba,115,75493,32,27,0,27,1
2020-06-07,Alameda,001,1643700,4377,3866,7,3873,102
2020-06-07,Alpine,003,1148,1,1,0,1,0
2020-06-07,Amador,005,37829,10,10,0,10,0
2020-06-07,Butte,007,227075,95,64,5,69,1
2020-06-07,Calaveras,009,45235,25,16,0,16,0
2020-06-07,Colusa,011,21464,9,7,0,7,0
2020-06-07,Contra Costa,013,1133247,1961,1653,1,1654,38
2020-06-07,Del Norte,015,27424,45,45,0,45,0
2020-06-07,El Dorado,017,186661,138,104,1,105,0
2020-06-07,Fresno,019,978130,4070,2144,56,2200,41
2020-06-07,Glenn,021,27897,29,16,0,16,0
2020-06-07,Humboldt,023,135768,116,112,0,112,2
2020-06-07,Imperial,025,180216,5026,3048,4,3052,19
2020-06-07,Inyo,027,18085,22,21,0,21,1
2020-06-07,Kern,029,883053,3612,2771,9,2780,46
2020-06-07,Kings,031,150075,1765,882,4,886,6
2020-06-07,Lake,033,64148,36,28,0,28,0
2020-06-07,Lassen,035,31185,14,4,2,6,0
2020-06-07,Los Angeles,037,10098052,71653,63750,21,63771,2629
2020-06-07,Madera,039,155013,369,149,1,150,3
2020-06-07,Marin,041,260295,666,584,2,586,17
2020-06-07,Mariposa,043,17540,16,16,0,16,1
2020-06-07,Mendocino,045,87422,33,32,0,32,0
2020-06-07,Merced,047,269075,496,318,1,319,7
2020-06-07,Modoc,049,8938,1,0,0,0,0
2020-06-07,Mono,051,14174,39,35,0,35,1
2020-06-07,Monterey,053,433212,968,732,3,735,10
2020-06-07,Napa,055,140530,177,142,0,142,3
2020-06-07,Nevada,057,99092,55,50,1,51,1
2020-06-07,Orange,059,3164182,10703,7643,79,7722,158
2020-06-07,Placer,061,380077,400,273,2,275,9
2020-06-07,Plumas,063,18699,5,4,0,4,0
2020-06-07,Riverside,065,2383286,11851,9105,24,9129,344
2020-06-07,Sacramento,067,1510023,1734,1568,2,1570,59
2020-06-07,San Benito,069,59416,128,92,0,92,2
2020-06-07,San Bernardino,071,2135413,7955,6033,6,6039,214
2020-06-07,San Diego,073,3302833,9707,8478,0,8478,296
2020-06-07,San Francisco,075,870044,2923,2674,0,2674,43
2020-06-07,San Joaquin,077,732212,1632,1126,4,1130,37
2020-06-07,San Luis Obispo,079,281455,411,296,4,300,1
2020-06-07,San Mateo,081,765935,2617,2399,4,2403,73
2020-06-07,Santa Barbara,083,443738,2061,1818,17,1835,13
2020-06-07,Santa Clara,085,1922200,3772,2947,14,2961,146
2020-06-07,Santa Cruz,087,273765,261,230,0,230,2
2020-06-07,Shasta,089,179085,73,41,0,41,4
2020-06-07,Sierra,091,2930,1,1,0,1,0
2020-06-07,Siskiyou,093,43540,20,8,0,8,0
2020-06-07,Solano,095,438530,762,560,4,564,19
2020-06-07,Sonoma,097,501317,752,639,2,641,4
2020-06-07,Stanislaus,099,539301,1245,905,5,910,28
2020-06-07,Sutter,101,95872,73,55,0,55,2
2020-06-07,Tehama,103,63373,16,8,2,10,1
2020-06-07,Trinity,105,12862,8,2,3,5,0
2020-06-07,Tulare,107,460477,3172,2219,10,2229,90
2020-06-07,Tuolumne,109,53932,9,4,0,4,0
2020-06-07,Ventura,111,848112,1982,1337,12,1349,30
2020-06-07,Yolo,113,214977,266,224,0,224,24
2020-06-07,Yuba,115,75493,32,27,0,27,1
2020-06-06,Alameda,001,1643700,4332,3801,7,3808,102
2020-06-06,Alpine,003,1148,1,1,0,1,0
2020-06-06,Amador,005,37829,10,10,0,10,0
2020-06-06,Butte,007,227075,94,63,5,68,1
2020-06-06,Calaveras,009,45235,23,16,0,16,0
2020-06-06,Colusa,011,21464,9,7,0,7,0
2020-06-06,Contra Costa,013,1133247,1940,1619,1,1620,37
2020-06-06,Del Norte,015,27424,45,45,0,45,0
2020-06-06,El Dorado,017,186661,133,104,1,105,0
2020-06-06,Fresno,019,978130,4015,2117,56,2173,41
2020-06-06,Glenn,021,27897,27,16,0,16,0
2020-06-06,Humboldt,023,135768,116,112,0,112,2
2020-06-06,Imperial,025,180216,4950,3047,4,3051,19
2020-06-06,Inyo,027,18085,22,21,0,21,1
2020-06-06,Kern,029,883053,3541,2695,9,2704,46
2020-06-06,Kings,031,150075,1746,882,4,886,6
2020-06-06,Lake,033,64148,36,28,0,28,0
2020-06-06,Lassen,035,31185,14,4,2,6,0
2020-06-06,Los Angeles,037,10098052,70904,62269,21,62290,2607
2020-06-06,Madera,039,155013,360,149,1,150,3
2020-06-06,Marin,041,260295,661,556,2,558,17
2020-06-06,Mariposa,043,17540,16,16,0,16,1
2020-06-06,Mendocino,045,87422,33,32,0,32,0
2020-06-06,Merced,047,269075,495,315,1,316,7
2020-06-06,Modoc,049,8938,1,0,0,0,0
2020-06-06,Mono,051,14174,39,35,0,35,1
2020-06-06,Monterey,053,433212,944,679,3,682,10
2020-06-06,Napa,055,140530,171,136,0,136,3
2020-06-06,Nevada,057,99092,54,50,1,51,1
2020-06-06,Orange,059,3164182,10544,7576,78,7654,157
2020-06-06,Placer,061,380077,388,270,2,272,9
2020-06-06,Plumas,063,18699,5,4,0,4,0
2020-06-06,Riverside,065,2383286,11673,8935,24,8959,345
2020-06-06,Sacramento,067,1510023,1711,1533,2,1535,59
2020-06-06,San Benito,069,59416,118,92,0,92,2
2020-06-06,San Bernardino,071,2135413,7807,5946,6,5952,214
2020-06-06,San Diego,073,3302833,9586,8347,0,8347,296
2020-06-06,San Francisco,075,870044,2908,2674,0,2674,43
2020-06-06,San Joaquin,077,732212,1592,1076,4,1080,37
2020-06-06,San Luis Obispo,079,281455,405,295,4,299,1
2020-06-06,San Mateo,081,765935,2602,2342,4,2346,72
2020-06-06,Santa Barbara,083,443738,2022,1815,17,1832,13
2020-06-06,Santa Clara,085,1922200,3731,2934,14,2948,144
2020-06-06,Santa Cruz,087,273765,259,226,0,226,2
2020-06-06,Shasta,089,179085,73,40,0,40,4
2020-06-06,Sierra,091,2930,1,1,0,1,0
2020-06-06,Siskiyou,093,43540,18,8,0,8,0
2020-06-06,Solano,095,438530,747,560,4,564,19
2020-06-06,Sonoma,097,501317,740,622,2,624,4
2020-06-06,Stanislaus,099,539301,1211,858,5,863,27
2020-06-06,Sutter,101,95872,73,51,0,51,2
2020-06-06,Tehama,103,63373,15,8,2,10,1
2020-06-06,Trinity,105,12862,8,2,2,4,0
2020-06-06,Tulare,107,460477,3139,2213,10,2223,90
2020-06-06,Tuolumne,109,53932,9,4,0,4,0
2020-06-06,Ventura,111,848112,1958,1303,12,1315,30
2020-06-06,Yolo,113,214977,264,223,0,223,24
2020-06-06,Yuba,115,75493,32,27,0,27,1
2020-06-05,Alameda,001,1643700,4281,3734,7,3741,102
2020-06-05,Alpine,003,1148,1,1,0,1,0
2020-06-05,Amador,005,37829,10,10,0,10,0
2020-06-05,Butte,007,227075,91,61,5,66,1
2020-06-05,Calaveras,009,45235,22,16,0,16,0
2020-06-05,Colusa,011,21464,9,7,0,7,0
2020-06-05,Contra Costa,013,1133247,1925,1575,1,1576,37
2020-06-05,Del Norte,015,27424,45,45,0,45,0
2020-06-05,El Dorado,017,186661,131,101,1,102,0
2020-06-05,Fresno,019,978130,3951,2051,55,2106,38
2020-06-05,Glenn,021,27897,25,16,0,16,0
2020-06-05,Humboldt,023,135768,115,111,0,111,2
2020-06-05,Imperial,025,180216,4844,2778,4,2782,19
2020-06-05,Inyo,027,18085,22,21,0,21,1
2020-06-05,Kern,029,883053,3452,2624,9,2633,46
2020-06-05,Kings,031,150075,1731,865,4,869,6
2020-06-05,Lake,033,64148,35,28,0,28,0
2020-06-05,Lassen,035,31185,13,4,2,6,0
2020-06-05,Los Angeles,037,10098052,69756,60955,21,60976,2553
2020-06-05,Madera,039,155013,338,144,1,145,3
2020-06-05,Marin,041,260295,652,546,2,548,17
2020-06-05,Mariposa,043,17540,16,16,0,16,1
2020-06-05,Mendocino,045,87422,33,32,0,32,0
2020-06-05,Merced,047,269075,493,309,1,310,7
2020-06-05,Modoc,049,8938,1,0,0,0,0
2020-06-05,Mono,051,14174,39,35,0,35,1
2020-06-05,Monterey,053,433212,912,649,3,652,10
2020-06-05,Napa,055,140530,168,123,0,123,3
2020-06-05,Nevada,057,99092,54,50,1,51,1
2020-06-05,Orange,059,3164182,10349,7391,76,7467,153
2020-06-05,Placer,061,380077,378,265,2,267,9
2020-06-05,Plumas,063,18699,5,4,0,4,0
2020-06-05,Riverside,065,2383286,11414,8700,24,8724,345
2020-06-05,Sacramento,067,1510023,1689,1514,2,1516,59
2020-06-05,San Benito,069,59416,116,92,0,92,2
2020-06-05,San Bernardino,071,2135413,7625,5869,5,5874,212
2020-06-05,San Diego,073,3302833,9471,8182,0,8182,294
2020-06-05,San Francisco,075,870044,2890,2675,0,2675,43
2020-06-05,San Joaquin,077,732212,1513,1046,4,1050,36
2020-06-05,San Luis Obispo,079,281455,398,293,4,297,1
2020-06-05,San Mateo,081,765935,2577,2331,4,2335,72
2020-06-05,Santa Barbara,083,443738,1991,1795,17,1812,13
2020-06-05,Santa Clara,085,1922200,3696,2902,14,2916,144
2020-06-05,Santa Cruz,087,273765,256,222,0,222,2
2020-06-05,Shasta,089,179085,72,40,0,40,4
2020-06-05,Sierra,091,2930,1,1,0,1,0
2020-06-05,Siskiyou,093,43540,16,8,0,8,0
2020-06-05,Solano,095,438530,740,558,4,562,19
2020-06-05,Sonoma,097,501317,719,618,2,620,4
2020-06-05,Stanislaus,099,539301,1178,842,5,847,27
2020-06-05,Sutter,101,95872,73,49,0,49,2
2020-06-05,Tehama,103,63373,15,7,2,9,1
2020-06-05,Trinity,105,12862,8,1,2,3,0
2020-06-05,Tulare,107,460477,3090,2180,10,2190,90
2020-06-05,Tuolumne,109,53932,9,4,0,4,0
2020-06-05,Ventura,111,848112,1925,1274,12,1286,30
2020-06-05,Yolo,113,214977,263,216,0,216,24
2020-06-05,Yuba,115,75493,32,27,0,27,1
2020-06-04,Alameda,001,1643700,4182,3643,7,3650,99
2020-06-04,Alpine,003,1148,1,1,0,1,0
2020-06-04,Amador,005,37829,10,10,0,10,0
2020-06-04,Butte,007,227075,87,57,4,61,1
2020-06-04,Calaveras,009,45235,22,15,0,15,0
2020-06-04,Colusa,011,21464,9,7,0,7,0
2020-06-04,Contra Costa,013,1133247,1867,1551,1,1552,37
2020-06-04,Del Norte,015,27424,45,45,0,45,0
2020-06-04,El Dorado,017,186661,129,101,1,102,0
2020-06-04,Fresno,019,978130,3845,2007,54,2061,35
2020-06-04,Glenn,021,27897,22,16,0,16,0
2020-06-04,Humboldt,023,135768,115,109,0,109,2
2020-06-04,Imperial,025,180216,4662,2631,4,2635,19
2020-06-04,Inyo,027,18085,22,20,0,20,1
2020-06-04,Kern,029,883053,3336,2530,9,2539,46
2020-06-04,Kings,031,150075,1661,842,4,846,6
2020-06-04,Lake,033,64148,34,27,0,27,0
2020-06-04,Lassen,035,31185,11,4,2,6,0
2020-06-04,Los Angeles,037,10098052,68288,59596,21,59617,2515
2020-06-04,Madera,039,155013,330,127,1,128,3
2020-06-04,Marin,041,260295,630,533,2,535,14
2020-06-04,Mariposa,043,17540,16,16,0,16,1
2020-06-04,Mendocino,045,87422,33,29,0,29,0
2020-06-04,Merced,047,269075,473,304,1,305,7
2020-06-04,Modoc,049,8938,1,0,0,0,0
2020-06-04,Mono,051,14174,39,35,0,35,1
2020-06-04,Monterey,053,433212,877,621,2,623,10
2020-06-04,Napa,055,140530,164,117,0,117,3
2020-06-04,Nevada,057,99092,53,49,1,50,1
2020-06-04,Orange,059,3164182,10097,7192,75,7267,148
2020-06-04,Placer,061,380077,362,256,2,258,9
2020-06-04,Plumas,063,18699,4,4,0,4,0
2020-06-04,Riverside,065,2383286,11136,8473,24,8497,341
2020-06-04,Sacramento,067,1510023,1662,1492,2,1494,58
2020-06-04,San Benito,069,59416,114,88,0,88,2
2020-06-04,San Bernardino,071,2135413,7356,5726,5,5731,207
2020-06-04,San Diego,073,3302833,9308,7942,0,7942,288
2020-06-04,San Francisco,075,870044,2857,2636,0,2636,43
2020-06-04,San Joaquin,077,732212,1451,1016,4,1020,36
2020-06-04,San Luis Obispo,079,281455,387,288,4,292,1
2020-06-04,San Mateo,081,765935,2550,2284,4,2288,72
2020-06-04,Santa Barbara,083,443738,1960,1750,16,1766,13
2020-06-04,Santa Clara,085,1922200,3662,2871,14,2885,144
2020-06-04,Santa Cruz,087,273765,250,218,0,218,2
2020-06-04,Shasta,089,179085,66,40,0,40,4
2020-06-04,Sierra,091,2930,1,1,0,1,0
2020-06-04,Siskiyou,093,43540,15,8,0,8,0
2020-06-04,Solano,095,438530,723,551,4,555,19
2020-06-04,Sonoma,097,501317,700,591,1,592,4
2020-06-04,Stanislaus,099,539301,1102,806,5,811,28
2020-06-04,Sutter,101,95872,68,46,0,46,2
2020-06-04,Tehama,103,63373,14,6,1,7,1
2020-06-04,Trinity,105,12862,8,1,2,3,0
2020-06-04,Tulare,107,460477,2973,2086,10,2096,90
2020-06-04,Tuolumne,109,53932,8,4,0,4,0
2020-06-04,Ventura,111,848112,1881,1236,11,1247,30
2020-06-04,Yolo,113,214977,258,216,0,216,24
2020-06-04,Yuba,115,75493,31,27,0,27,1
2020-06-03,Alameda,001,1643700,4123,3589,6,3595,99
2020-06-03,Alpine,003,1148,1,1,0,1,0
2020-06-03,Amador,005,37829,10,10,0,10,0
2020-06-03,Butte,007,227075,85,53,4,57,1
2020-06-03,Calaveras,009,45235,21,15,0,15,0
2020-06-03,Colusa,011,21464,9,7,0,7,0
2020-06-03,Contra Costa,013,1133247,1819,1511,1,1512,37
2020-06-03,Del Norte,015,27424,45,39,0,39,0
2020-06-03,El Dorado,017,186661,126,90,1,91,0
2020-06-03,Fresno,019,978130,3746,1943,54,1997,35
2020-06-03,Glenn,021,27897,22,16,0,16,0
2020-06-03,Humboldt,023,135768,115,103,0,103,2
2020-06-03,Imperial,025,180216,4489,2540,4,2544,19
2020-06-03,Inyo,027,18085,22,20,0,20,1
2020-06-03,Kern,029,883053,3240,2452,8,2460,44
2020-06-03,Kings,031,150075,1596,744,4,748,6
2020-06-03,Lake,033,64148,32,26,0,26,0
2020-06-03,Lassen,035,31185,11,4,2,6,0
2020-06-03,Los Angeles,037,10098052,66676,58166,21,58187,2472
2020-06-03,Madera,039,155013,322,117,1,118,3
2020-06-03,Marin,041,260295,612,527,2,529,14
2020-06-03,Mariposa,043,17540,16,16,0,16,1
2020-06-03,Mendocino,045,87422,32,29,0,29,0
2020-06-03,Merced,047,269075,459,299,1,300,7
2020-06-03,Modoc,049,8938,1,0,0,0,0
2020-06-03,Mono,051,14174,39,35,0,35,1
2020-06-03,Monterey,053,433212,849,592,2,594,10
2020-06-03,Napa,055,140530,163,116,0,116,3
2020-06-03,Nevada,057,99092,52,43,1,44,1
2020-06-03,Orange,059,3164182,9871,6939,73,7012,145
2020-06-03,Placer,061,380077,342,243,2,245,9
2020-06-03,Plumas,063,18699,4,4,0,4,0
2020-06-03,Riverside,065,2383286,10862,8208,24,8232,335
2020-06-03,Sacramento,067,1510023,1632,1457,2,1459,58
2020-06-03,San Benito,069,59416,108,88,0,88,2
2020-06-03,San Bernardino,071,2135413,7133,5565,5,5570,203
2020-06-03,San Diego,073,3302833,9160,7800,0,7800,283
2020-06-03,San Francisco,075,870044,2826,2608,0,2608,43
2020-06-03,San Joaquin,077,732212,1387,1004,4,1008,35
2020-06-03,San Luis Obispo,079,281455,382,279,4,283,1
2020-06-03,San Mateo,081,765935,2522,2243,4,2247,71
2020-06-03,Santa Barbara,083,443738,1926,1722,15,1737,12
2020-06-03,Santa Clara,085,1922200,3620,2836,14,2850,144
2020-06-03,Santa Cruz,087,273765,244,217,0,217,2
2020-06-03,Shasta,089,179085,63,40,0,40,4
2020-06-03,Sierra,091,2930,1,1,0,1,0
2020-06-03,Siskiyou,093,43540,14,8,0,8,0
2020-06-03,Solano,095,438530,698,543,2,545,18
2020-06-03,Sonoma,097,501317,688,578,1,579,4
2020-06-03,Stanislaus,099,539301,1062,780,5,785,27
2020-06-03,Sutter,101,95872,60,45,0,45,2
2020-06-03,Tehama,103,63373,14,6,1,7,1
2020-06-03,Trinity,105,12862,8,1,2,3,0
2020-06-03,Tulare,107,460477,2904,2041,10,2051,88
2020-06-03,Tuolumne,109,53932,6,4,0,4,0
2020-06-03,Ventura,111,848112,1814,1202,11,1213,30
2020-06-03,Yolo,113,214977,254,213,0,213,24
2020-06-03,Yuba,115,75493,31,27,0,27,1
2020-06-02,Alameda,001,1643700,4047,3517,6,3523,99
2020-06-02,Alpine,003,1148,1,1,0,1,0
2020-06-02,Amador,005,37829,10,10,0,10,0
2020-06-02,Butte,007,227075,81,51,3,54,1
2020-06-02,Calaveras,009,45235,21,15,0,15,0
2020-06-02,Colusa,011,21464,9,7,0,7,0
2020-06-02,Contra Costa,013,1133247,1787,1505,1,1506,37
2020-06-02,Del Norte,015,27424,45,39,0,39,0
2020-06-02,El Dorado,017,186661,125,88,1,89,0
2020-06-02,Fresno,019,978130,3633,1917,54,1971,34
2020-06-02,Glenn,021,27897,21,16,0,16,0
2020-06-02,Humboldt,023,135768,115,101,0,101,2
2020-06-02,Imperial,025,180216,4296,2459,4,2463,19
2020-06-02,Inyo,027,18085,20,20,0,20,1
2020-06-02,Kern,029,883053,3141,2406,6,2412,41
2020-06-02,Kings,031,150075,1568,720,4,724,5
2020-06-02,Lake,033,64148,32,25,0,25,0
2020-06-02,Lassen,035,31185,10,4,2,6,0
2020-06-02,Los Angeles,037,10098052,65270,57144,21,57165,2430
2020-06-02,Madera,039,155013,301,110,1,111,2
2020-06-02,Marin,041,260295,585,509,2,511,14
2020-06-02,Mariposa,043,17540,16,16,0,16,1
2020-06-02,Mendocino,045,87422,32,29,0,29,0
2020-06-02,Merced,047,269075,443,297,1,298,6
2020-06-02,Modoc,049,8938,1,0,0,0,0
2020-06-02,Mono,051,14174,39,35,0,35,1
2020-06-02,Monterey,053,433212,819,582,2,584,10
2020-06-02,Napa,055,140530,154,116,0,116,3
2020-06-02,Nevada,057,99092,51,41,1,42,1
2020-06-02,Orange,059,3164182,9670,6790,72,6862,142
2020-06-02,Placer,061,380077,328,226,2,228,9
2020-06-02,Plumas,063,18699,4,4,0,4,0
2020-06-02,Riverside,065,2383286,10566,8091,22,8113,330
2020-06-02,Sacramento,067,1510023,1603,1428,2,1430,58
2020-06-02,San Benito,069,59416,107,86,0,86,2
2020-06-02,San Bernardino,071,2135413,6926,5438,5,5443,202
2020-06-02,San Diego,073,3302833,9014,7676,0,7676,276
2020-06-02,San Francisco,075,870044,2791,2554,0,2554,43
2020-06-02,San Joaquin,077,732212,1321,985,4,989,35
2020-06-02,San Luis Obispo,079,281455,377,275,4,279,1
2020-06-02,San Mateo,081,765935,2487,2203,4,2207,71
2020-06-02,Santa Barbara,083,443738,1886,1703,15,1718,12
2020-06-02,Santa Clara,085,1922200,3570,2819,14,2833,144
2020-06-02,Santa Cruz,087,273765,239,215,0,215,2
2020-06-02,Shasta,089,179085,62,38,0,38,4
2020-06-02,Sierra,091,2930,1,1,0,1,0
2020-06-02,Siskiyou,093,43540,13,8,0,8,0
2020-06-02,Solano,095,438530,683,537,1,538,18
2020-06-02,Sonoma,097,501317,677,571,1,572,4
2020-06-02,Stanislaus,099,539301,1003,772,5,777,27
2020-06-02,Sutter,101,95872,57,43,0,43,2
2020-06-02,Tehama,103,63373,14,6,1,7,1
2020-06-02,Trinity,105,12862,8,1,2,3,0
2020-06-02,Tulare,107,460477,2824,2012,10,2022,86
2020-06-02,Tuolumne,109,53932,6,4,0,4,0
2020-06-02,Ventura,111,848112,1761,1178,11,1189,30
2020-06-02,Yolo,113,214977,252,213,0,213,24
2020-06-02,Yuba,115,75493,31,27,0,27,1
2020-06-01,Alameda,001,1643700,3981,3460,6,3466,98
2020-06-01,Alpine,003,1148,1,1,0,1,0
2020-06-01,Amador,005,37829,10,10,0,10,0
2020-06-01,Butte,007,227075,80,50,2,52,1
2020-06-01,Calaveras,009,45235,21,15,0,15,0
2020-06-01,Colusa,011,21464,9,7,0,7,0
2020-06-01,Contra Costa,013,1133247,1751,1486,1,1487,37
2020-06-01,Del Norte,015,27424,45,38,0,38,0
2020-06-01,El Dorado,017,186661,123,88,1,89,0
2020-06-01,Fresno,019,978130,3538,1854,52,1906,33
2020-06-01,Glenn,021,27897,21,16,0,16,0
2020-06-01,Humboldt,023,135768,115,98,0,98,2
2020-06-01,Imperial,025,180216,4074,2366,4,2370,14
2020-06-01,Inyo,027,18085,20,20,0,20,1
2020-06-01,Kern,029,883053,3058,2366,6,2372,38
2020-06-01,Kings,031,150075,1300,703,4,707,4
2020-06-01,Lake,033,64148,32,22,0,22,0
2020-06-01,Lassen,035,31185,10,4,2,6,0
2020-06-01,Los Angeles,037,10098052,63801,55899,21,55920,2367
2020-06-01,Madera,039,155013,289,103,1,104,2
2020-06-01,Marin,041,260295,544,495,2,497,14
2020-06-01,Mariposa,043,17540,16,16,0,16,1
2020-06-01,Mendocino,045,87422,32,28,0,28,0
2020-06-01,Merced,047,269075,424,289,1,290,6
2020-06-01,Modoc,049,8938,1,0,0,0,0
2020-06-01,Mono,051,14174,39,35,0,35,1
2020-06-01,Monterey,053,433212,795,554,2,556,10
2020-06-01,Napa,055,140530,151,114,0,114,3
2020-06-01,Nevada,057,99092,51,41,1,42,1
2020-06-01,Orange,059,3164182,9473,6640,71,6711,135
2020-06-01,Placer,061,380077,316,218,2,220,9
2020-06-01,Plumas,063,18699,4,4,0,4,0
2020-06-01,Riverside,065,2383286,10114,7921,21,7942,322
2020-06-01,Sacramento,067,1510023,1564,1415,2,1417,58
2020-06-01,San Benito,069,59416,104,86,0,86,2
2020-06-01,San Bernardino,071,2135413,6720,5310,5,5315,202
2020-06-01,San Diego,073,3302833,8834,7556,0,7556,269
2020-06-01,San Francisco,075,870044,2754,2546,0,2546,43
2020-06-01,San Joaquin,077,732212,1256,957,4,961,35
2020-06-01,San Luis Obispo,079,281455,373,275,4,279,1
2020-06-01,San Mateo,081,765935,2457,2190,4,2194,71
2020-06-01,Santa Barbara,083,443738,1852,1671,14,1685,10
2020-06-01,Santa Clara,085,1922200,3532,2797,13,2810,142
2020-06-01,Santa Cruz,087,273765,235,215,0,215,2
2020-06-01,Shasta,089,179085,62,38,0,38,4
2020-06-01,Sierra,091,2930,1,1,0,1,0
2020-06-01,Siskiyou,093,43540,13,7,0,7,0
2020-06-01,Solano,095,438530,659,529,1,530,17
2020-06-01,Sonoma,097,501317,661,565,1,566,4
2020-06-01,Stanislaus,099,539301,966,758,5,763,27
2020-06-01,Sutter,101,95872,52,43,0,43,2
2020-06-01,Tehama,103,63373,11,5,1,6,1
2020-06-01,Trinity,105,12862,7,1,2,3,0
2020-06-01,Tulare,107,460477,2709,1976,10,1986,84
2020-06-01,Tuolumne,109,53932,5,4,0,4,0
2020-06-01,Ventura,111,848112,1708,1163,11,1174,29
2020-06-01,Yolo,113,214977,249,212,0,212,24
2020-06-01,Yuba,115,75493,30,26,0,26,1
2020-05-31,Alameda,001,1643700,3876,3362,6,3368,98
2020-05-31,Alpine,003,1148,1,1,0,1,0
2020-05-31,Amador,005,37829,10,10,0,10,0
2020-05-31,Butte,007,227075,78,51,2,53,0
2020-05-31,Calaveras,009,45235,18,15,0,15,0
2020-05-31,Colusa,011,21464,9,5,0,5,0
2020-05-31,Contra Costa,013,1133247,1717,1458,1,1459,37
2020-05-31,Del Norte,015,27424,45,37,0,37,0
2020-05-31,El Dorado,017,186661,119,88,1,89,0
2020-05-31,Fresno,019,978130,3373,1780,46,1826,31
2020-05-31,Glenn,021,27897,20,16,0,16,0
2020-05-31,Humboldt,023,135768,113,98,0,98,2
2020-05-31,Imperial,025,180216,3807,2197,4,2201,14
2020-05-31,Inyo,027,18085,20,20,0,20,1
2020-05-31,Kern,029,883053,2923,2300,6,2306,38
2020-05-31,Kings,031,150075,1263,703,4,707,3
2020-05-31,Lake,033,64148,32,19,0,19,0
2020-05-31,Lassen,035,31185,10,4,2,6,0
2020-05-31,Los Angeles,037,10098052,62509,54925,21,54946,2344
2020-05-31,Madera,039,155013,271,101,1,102,2
2020-05-31,Marin,041,260295,534,486,2,488,14
2020-05-31,Mariposa,043,17540,16,16,0,16,1
2020-05-31,Mendocino,045,87422,32,24,0,24,0
2020-05-31,Merced,047,269075,397,288,0,288,6
2020-05-31,Modoc,049,8938,0,0,0,0,0
2020-05-31,Mono,051,14174,39,34,0,34,1
2020-05-31,Monterey,053,433212,721,545,2,547,10
2020-05-31,Napa,055,140530,149,114,0,114,3
2020-05-31,Nevada,057,99092,50,41,1,42,1
2020-05-31,Orange,059,3164182,9263,6532,70,6602,135
2020-05-31,Placer,061,380077,294,215,2,217,9
2020-05-31,Plumas,063,18699,4,4,0,4,0
2020-05-31,Riverside,065,2383286,9858,7704,21,7725,321
2020-05-31,Sacramento,067,1510023,1533,1398,2,1400,57
2020-05-31,San Benito,069,59416,98,85,0,85,2
2020-05-31,San Bernardino,071,2135413,6452,5185,5,5190,198
2020-05-31,San Diego,073,3302833,8640,7483,0,7483,269
2020-05-31,San Francisco,075,870044,2718,2501,0,2501,43
2020-05-31,San Joaquin,077,732212,1191,888,4,892,34
2020-05-31,San Luis Obispo,079,281455,363,271,4,275,1
2020-05-31,San Mateo,081,765935,2411,2169,4,2173,71
2020-05-31,Santa Barbara,083,443738,1801,1662,13,1675,9
2020-05-31,Santa Clara,085,1922200,3488,2785,13,2798,142
2020-05-31,Santa Cruz,087,273765,232,210,0,210,2
2020-05-31,Shasta,089,179085,60,38,0,38,4
2020-05-31,Sierra,091,2930,1,1,0,1,0
2020-05-31,Siskiyou,093,43540,12,7,0,7,0
2020-05-31,Solano,095,438530,633,512,1,513,6
2020-05-31,Sonoma,097,501317,641,555,1,556,4
2020-05-31,Stanislaus,099,539301,912,738,5,743,27
2020-05-31,Sutter,101,95872,50,42,0,42,2
2020-05-31,Tehama,103,63373,10,4,1,5,1
2020-05-31,Trinity,105,12862,7,1,2,3,0
2020-05-31,Tulare,107,460477,2636,1884,10,1894,82
2020-05-31,Tuolumne,109,53932,5,4,0,4,0
2020-05-31,Ventura,111,848112,1647,1151,11,1162,30
2020-05-31,Yolo,113,214977,243,211,0,211,24
2020-05-31,Yuba,115,75493,30,26,0,26,1
2020-05-30,Alameda,001,1643700,3850,3304,6,3310,96
2020-05-30,Alpine,003,1148,1,1,0,1,0
2020-05-30,Amador,005,37829,10,10,0,10,0
2020-05-30,Butte,007,227075,77,44,2,46,0
2020-05-30,Calaveras,009,45235,17,15,0,15,0
2020-05-30,Colusa,011,21464,8,5,0,5,0
2020-05-30,Contra Costa,013,1133247,1701,1429,1,1430,37
2020-05-30,Del Norte,015,27424,45,37,0,37,0
2020-05-30,El Dorado,017,186661,118,86,1,87,0
2020-05-30,Fresno,019,978130,3312,1744,45,1789,31
2020-05-30,Glenn,021,27897,19,16,0,16,0
2020-05-30,Humboldt,023,135768,112,98,0,98,2
2020-05-30,Imperial,025,180216,3717,2091,4,2095,14
2020-05-30,Inyo,027,18085,20,20,0,20,1
2020-05-30,Kern,029,883053,2854,2217,6,2223,38
2020-05-30,Kings,031,150075,1249,703,4,707,3
2020-05-30,Lake,033,64148,31,18,0,18,0
2020-05-30,Lassen,035,31185,10,4,2,6,0
2020-05-30,Los Angeles,037,10098052,61971,53627,21,53648,2319
2020-05-30,Madera,039,155013,266,101,1,102,2
2020-05-30,Marin,041,260295,534,462,2,464,14
2020-05-30,Mariposa,043,17540,16,16,0,16,1
2020-05-30,Mendocino,045,87422,32,24,0,24,0
2020-05-30,Merced,047,269075,396,285,0,285,6
2020-05-30,Modoc,049,8938,0,0,0,0,0
2020-05-30,Mono,051,14174,39,34,0,34,1
2020-05-30,Monterey,053,433212,705,520,2,522,10
2020-05-30,Napa,055,140530,147,113,0,113,3
2020-05-30,Nevada,057,99092,50,41,1,42,1
2020-05-30,Orange,059,3164182,9106,6354,70,6424,134
2020-05-30,Placer,061,380077,286,199,1,200,9
2020-05-30,Plumas,063,18699,4,4,0,4,0
2020-05-30,Riverside,065,2383286,9714,7492,21,7513,316
2020-05-30,Sacramento,067,1510023,1522,1384,2,1386,57
2020-05-30,San Benito,069,59416,97,85,0,85,2
2020-05-30,San Bernardino,071,2135413,6343,5122,5,5127,198
2020-05-30,San Diego,073,3302833,8547,7387,0,7387,269
2020-05-30,San Francisco,075,870044,2693,2496,0,2496,41
2020-05-30,San Joaquin,077,732212,1153,888,4,892,34
2020-05-30,San Luis Obispo,079,281455,358,270,4,274,1
2020-05-30,San Mateo,081,765935,2387,2129,4,2133,71
2020-05-30,Santa Barbara,083,443738,1782,1660,13,1673,9
2020-05-30,Santa Clara,085,1922200,3472,2741,13,2754,141
2020-05-30,Santa Cruz,087,273765,232,206,0,206,2
2020-05-30,Shasta,089,179085,60,36,0,36,4
2020-05-30,Sierra,091,2930,1,1,0,1,0
2020-05-30,Siskiyou,093,43540,11,7,0,7,0
2020-05-30,Solano,095,438530,626,512,1,513,6
2020-05-30,Sonoma,097,501317,631,551,1,552,4
2020-05-30,Stanislaus,099,539301,895,712,5,717,27
2020-05-30,Sutter,101,95872,49,40,0,40,2
2020-05-30,Tehama,103,63373,10,4,1,5,1
2020-05-30,Trinity,105,12862,7,1,2,3,0
2020-05-30,Tulare,107,460477,2599,1879,10,1889,81
2020-05-30,Tuolumne,109,53932,5,4,0,4,0
2020-05-30,Ventura,111,848112,1630,1116,11,1127,30
2020-05-30,Yolo,113,214977,239,210,0,210,24
2020-05-30,Yuba,115,75493,30,25,0,25,1
2020-05-29,Alameda,001,1643700,3815,3209,6,3215,96
2020-05-29,Alpine,003,1148,1,1,0,1,0
2020-05-29,Amador,005,37829,10,10,0,10,0
2020-05-29,Butte,007,227075,72,41,2,43,0
2020-05-29,Calaveras,009,45235,17,15,0,15,0
2020-05-29,Colusa,011,21464,8,5,0,5,0
2020-05-29,Contra Costa,013,1133247,1685,1411,1,1412,37
2020-05-29,Del Norte,015,27424,45,37,0,37,0
2020-05-29,El Dorado,017,186661,117,85,1,86,0
2020-05-29,Fresno,019,978130,3262,1687,45,1732,31
2020-05-29,Glenn,021,27897,19,14,0,14,0
2020-05-29,Humboldt,023,135768,111,98,0,98,2
2020-05-29,Imperial,025,180216,3599,1607,4,1611,14
2020-05-29,Inyo,027,18085,20,20,0,20,1
2020-05-29,Kern,029,883053,2796,2128,6,2134,36
2020-05-29,Kings,031,150075,1238,693,4,697,3
2020-05-29,Lake,033,64148,30,17,0,17,0
2020-05-29,Lassen,035,31185,10,0,2,2,0
2020-05-29,Los Angeles,037,10098052,61016,51578,21,51599,2273
2020-05-29,Madera,039,155013,251,98,1,99,2
2020-05-29,Marin,041,260295,526,448,2,450,14
2020-05-29,Mariposa,043,17540,16,16,0,16,1
2020-05-29,Mendocino,045,87422,30,25,0,25,0
2020-05-29,Merced,047,269075,391,285,0,285,7
2020-05-29,Modoc,049,8938,0,0,0,0,0
2020-05-29,Mono,051,14174,38,34,0,34,1
2020-05-29,Monterey,053,433212,675,479,2,481,10
2020-05-29,Napa,055,140530,144,113,0,113,3
2020-05-29,Nevada,057,99092,50,41,1,42,1
2020-05-29,Orange,059,3164182,8920,6176,67,6243,133
2020-05-29,Placer,061,380077,264,199,1,200,9
2020-05-29,Plumas,063,18699,4,4,0,4,0
2020-05-29,Riverside,065,2383286,9528,7376,21,7397,313
2020-05-29,Sacramento,067,1510023,1499,1360,2,1362,57
2020-05-29,San Benito,069,59416,97,84,0,84,2
2020-05-29,San Bernardino,071,2135413,6235,4983,5,4988,196
2020-05-29,San Diego,073,3302833,8424,7242,0,7242,266
2020-05-29,San Francisco,075,870044,2669,2453,0,2453,41
2020-05-29,San Joaquin,077,732212,1116,855,4,859,34
2020-05-29,San Luis Obispo,079,281455,354,270,4,274,1
2020-05-29,San Mateo,081,765935,2371,2103,4,2107,71
2020-05-29,Santa Barbara,083,443738,1755,1656,13,1669,9
2020-05-29,Santa Clara,085,1922200,3444,2707,13,2720,141
2020-05-29,Santa Cruz,087,273765,229,203,0,203,2
2020-05-29,Shasta,089,179085,60,36,0,36,4
2020-05-29,Sierra,091,2930,1,1,0,1,0
2020-05-29,Siskiyou,093,43540,11,7,0,7,0
2020-05-29,Solano,095,438530,618,498,1,499,6
2020-05-29,Sonoma,097,501317,620,537,1,538,4
2020-05-29,Stanislaus,099,539301,865,698,5,703,27
2020-05-29,Sutter,101,95872,47,40,0,40,2
2020-05-29,Tehama,103,63373,9,4,1,5,1
2020-05-29,Trinity,105,12862,7,1,2,3,0
2020-05-29,Tulare,107,460477,2561,1852,10,1862,80
2020-05-29,Tuolumne,109,53932,5,4,0,4,0
2020-05-29,Ventura,111,848112,1606,1093,11,1104,29
2020-05-29,Yolo,113,214977,235,211,0,211,24
2020-05-29,Yuba,115,75493,29,25,0,25,1
2020-05-28,Alameda,001,1643700,3715,3083,6,3089,94
2020-05-28,Alpine,003,1148,1,1,0,1,0
2020-05-28,Amador,005,37829,10,10,0,10,0
2020-05-28,Butte,007,227075,71,40,2,42,0
2020-05-28,Calaveras,009,45235,16,15,0,15,0
2020-05-28,Colusa,011,21464,8,5,0,5,0
2020-05-28,Contra Costa,013,1133247,1646,1392,1,1393,37
2020-05-28,Del Norte,015,27424,45,37,0,37,0
2020-05-28,El Dorado,017,186661,114,82,1,83,0
2020-05-28,Fresno,019,978130,3181,1653,44,1697,31
2020-05-28,Glenn,021,27897,18,14,0,14,0
2020-05-28,Humboldt,023,135768,110,97,0,97,2
2020-05-28,Imperial,025,180216,3404,1430,4,1434,14
2020-05-28,Inyo,027,18085,20,20,0,20,1
2020-05-28,Kern,029,883053,2718,2069,6,2075,36
2020-05-28,Kings,031,150075,901,626,4,630,3
2020-05-28,Lake,033,64148,29,17,0,17,0
2020-05-28,Lassen,035,31185,10,0,2,2,0
2020-05-28,Los Angeles,037,10098052,59434,49861,21,49882,2222
2020-05-28,Madera,039,155013,233,93,1,94,2
2020-05-28,Marin,041,260295,501,443,2,445,14
2020-05-28,Mariposa,043,17540,16,16,0,16,1
2020-05-28,Mendocino,045,87422,28,24,0,24,0
2020-05-28,Merced,047,269075,382,283,0,283,7
2020-05-28,Modoc,049,8938,0,0,0,0,0
2020-05-28,Mono,051,14174,38,34,0,34,1
2020-05-28,Monterey,053,433212,643,471,2,473,10
2020-05-28,Napa,055,140530,141,113,0,113,3
2020-05-28,Nevada,057,99092,45,41,1,42,1
2020-05-28,Orange,059,3164182,8724,6045,67,6112,130
2020-05-28,Placer,061,380077,257,196,1,197,9
2020-05-28,Plumas,063,18699,4,4,0,4,0
2020-05-28,Riverside,065,2383286,9124,7240,20,7260,304
2020-05-28,Sacramento,067,1510023,1479,1339,2,1341,57
2020-05-28,San Benito,069,59416,96,82,0,82,2
2020-05-28,San Bernardino,071,2135413,6070,4831,5,4836,191
2020-05-28,San Diego,073,3302833,8267,7102,0,7102,260
2020-05-28,San Francisco,075,870044,2635,2417,0,2417,40
2020-05-28,San Joaquin,077,732212,1081,840,4,844,34
2020-05-28,San Luis Obispo,079,281455,351,267,4,271,1
2020-05-28,San Mateo,081,765935,2344,2070,4,2074,71
2020-05-28,Santa Barbara,083,443738,1727,1642,12,1654,9
2020-05-28,Santa Clara,085,1922200,3404,2698,13,2711,140
2020-05-28,Santa Cruz,087,273765,228,201,0,201,2
2020-05-28,Shasta,089,179085,58,36,0,36,4
2020-05-28,Sierra,091,2930,1,1,0,1,0
2020-05-28,Siskiyou,093,43540,9,6,0,6,0
2020-05-28,Solano,095,438530,601,489,1,490,6
2020-05-28,Sonoma,097,501317,598,529,1,530,4
2020-05-28,Stanislaus,099,539301,824,684,5,689,27
2020-05-28,Sutter,101,95872,47,40,0,40,2
2020-05-28,Tehama,103,63373,9,4,1,5,1
2020-05-28,Trinity,105,12862,6,1,2,3,0
2020-05-28,Tulare,107,460477,2525,1832,10,1842,79
2020-05-28,Tuolumne,109,53932,5,4,0,4,0
2020-05-28,Ventura,111,848112,1573,1083,11,1094,29
2020-05-28,Yolo,113,214977,232,206,0,206,22
2020-05-28,Yuba,115,75493,28,24,0,24,1
2020-05-27,Alameda,001,1643700,3632,3037,6,3043,94
2020-05-27,Alpine,003,1148,1,1,0,1,0
2020-05-27,Amador,005,37829,10,10,0,10,0
2020-05-27,Butte,007,227075,68,40,1,41,0
2020-05-27,Calaveras,009,45235,15,15,0,15,0
2020-05-27,Colusa,011,21464,8,5,0,5,0
2020-05-27,Contra Costa,013,1133247,1606,1373,1,1374,37
2020-05-27,Del Norte,015,27424,45,34,0,34,0
2020-05-27,El Dorado,017,186661,113,82,1,83,0
2020-05-27,Fresno,019,978130,3093,1620,44,1664,27
2020-05-27,Glenn,021,27897,18,14,0,14,0
2020-05-27,Humboldt,023,135768,110,86,0,86,2
2020-05-27,Imperial,025,180216,3224,1369,4,1373,14
2020-05-27,Inyo,027,18085,20,20,0,20,1
2020-05-27,Kern,029,883053,2653,1999,6,2005,37
2020-05-27,Kings,031,150075,874,586,4,590,3
2020-05-27,Lake,033,64148,29,13,0,13,0
2020-05-27,Lassen,035,31185,10,0,2,2,0
2020-05-27,Los Angeles,037,10098052,58059,48711,21,48732,2177
2020-05-27,Madera,039,155013,224,91,1,92,2
2020-05-27,Marin,041,260295,472,439,2,441,14
2020-05-27,Mariposa,043,17540,16,16,0,16,1
2020-05-27,Mendocino,045,87422,27,21,0,21,0
2020-05-27,Merced,047,269075,378,278,0,278,7
2020-05-27,Modoc,049,8938,0,0,0,0,0
2020-05-27,Mono,051,14174,38,34,0,34,1
2020-05-27,Monterey,053,433212,603,443,2,445,8
2020-05-27,Napa,055,140530,136,112,0,112,3
2020-05-27,Nevada,057,99092,44,41,1,42,1
2020-05-27,Orange,059,3164182,8569,5849,67,5916,121
2020-05-27,Placer,061,380077,238,196,0,196,9
2020-05-27,Plumas,063,18699,4,4,0,4,0
2020-05-27,Riverside,065,2383286,8745,7156,20,7176,299
2020-05-27,Sacramento,067,1510023,1451,1318,2,1320,50
2020-05-27,San Benito,069,59416,93,74,0,74,2
2020-05-27,San Bernardino,071,2135413,5886,4708,5,4713,183
2020-05-27,San Diego,073,3302833,8116,6985,0,6985,255
2020-05-27,San Francisco,075,870044,2606,2394,0,2394,40
2020-05-27,San Joaquin,077,732212,1039,825,4,829,34
2020-05-27,San Luis Obispo,079,281455,346,266,4,270,1
2020-05-27,San Mateo,081,765935,2304,2045,4,2049,71
2020-05-27,Santa Barbara,083,443738,1712,1629,12,1641,9
2020-05-27,Santa Clara,085,1922200,3371,2680,13,2693,140
2020-05-27,Santa Cruz,087,273765,224,202,0,202,2
2020-05-27,Shasta,089,179085,55,36,0,36,4
2020-05-27,Sierra,091,2930,1,1,0,1,0
2020-05-27,Siskiyou,093,43540,9,6,0,6,0
2020-05-27,Solano,095,438530,581,477,1,478,5
2020-05-27,Sonoma,097,501317,584,521,1,522,4
2020-05-27,Stanislaus,099,539301,799,675,5,680,27
2020-05-27,Sutter,101,95872,46,40,0,40,2
2020-05-27,Tehama,103,63373,9,3,1,4,1
2020-05-27,Trinity,105,12862,6,1,2,3,0
2020-05-27,Tulare,107,460477,2473,1817,10,1827,77
2020-05-27,Tuolumne,109,53932,5,4,0,4,0
2020-05-27,Ventura,111,848112,1548,1065,11,1076,28
2020-05-27,Yolo,113,214977,231,204,0,204,22
2020-05-27,Yuba,115,75493,28,24,0,24,1
2020-05-26,Alameda,001,1643700,3537,2956,6,2962,92
2020-05-26,Alpine,003,1148,1,1,0,1,0
2020-05-26,Amador,005,37829,10,10,0,10,0
2020-05-26,Butte,007,227075,66,37,1,38,0
2020-05-26,Calaveras,009,45235,15,13,0,13,0
2020-05-26,Colusa,011,21464,8,4,0,4,0
2020-05-26,Contra Costa,013,1133247,1571,1352,1,1353,37
2020-05-26,Del Norte,015,27424,44,30,0,30,0
2020-05-26,El Dorado,017,186661,109,79,1,80,0
2020-05-26,Fresno,019,978130,3006,1496,44,1540,22
2020-05-26,Glenn,021,27897,16,12,0,12,0
2020-05-26,Humboldt,023,135768,108,81,0,81,2
2020-05-26,Imperial,025,180216,3009,1369,4,1373,14
2020-05-26,Inyo,027,18085,20,20,0,20,1
2020-05-26,Kern,029,883053,2575,1890,6,1896,31
2020-05-26,Kings,031,150075,806,449,3,452,2
2020-05-26,Lake,033,64148,27,12,0,12,0
2020-05-26,Lassen,035,31185,9,0,2,2,0
2020-05-26,Los Angeles,037,10098052,56592,47760,21,47781,2121
2020-05-26,Madera,039,155013,209,83,1,84,2
2020-05-26,Marin,041,260295,460,424,2,426,14
2020-05-26,Mariposa,043,17540,16,16,0,16,1
2020-05-26,Mendocino,045,87422,25,20,0,20,0
2020-05-26,Merced,047,269075,363,266,0,266,7
2020-05-26,Modoc,049,8938,0,1,0,1,0
2020-05-26,Mono,051,14174,37,34,0,34,1
2020-05-26,Monterey,053,433212,575,424,1,425,8
2020-05-26,Napa,055,140530,131,109,0,109,3
2020-05-26,Nevada,057,99092,43,41,1,42,1
2020-05-26,Orange,059,3164182,8299,5651,66,5717,115
2020-05-26,Placer,061,380077,233,188,0,188,9
2020-05-26,Plumas,063,18699,4,4,0,4,0
2020-05-26,Riverside,065,2383286,8298,6917,20,6937,284
2020-05-26,Sacramento,067,1510023,1425,1298,2,1300,50
2020-05-26,San Benito,069,59416,88,69,0,69,2
2020-05-26,San Bernardino,071,2135413,5718,4430,5,4435,175
2020-05-26,San Diego,073,3302833,7973,6884,0,6884,249
2020-05-26,San Francisco,075,870044,2573,2363,0,2363,40
2020-05-26,San Joaquin,077,732212,992,760,4,764,33
2020-05-26,San Luis Obispo,079,281455,344,260,4,264,1
2020-05-26,San Mateo,081,765935,2266,1967,3,1970,71
2020-05-26,Santa Barbara,083,443738,1695,1590,11,1601,9
2020-05-26,Santa Clara,085,1922200,3339,2659,13,2672,139
2020-05-26,Santa Cruz,087,273765,222,197,0,197,2
2020-05-26,Shasta,089,179085,55,36,0,36,4
2020-05-26,Sierra,091,2930,1,1,0,1,0
2020-05-26,Siskiyou,093,43540,8,6,0,6,0
2020-05-26,Solano,095,438530,563,470,1,471,5
2020-05-26,Sonoma,097,501317,576,509,0,509,4
2020-05-26,Stanislaus,099,539301,779,663,5,668,27
2020-05-26,Sutter,101,95872,45,39,0,39,2
2020-05-26,Tehama,103,63373,8,2,1,3,1
2020-05-26,Trinity,105,12862,6,1,2,3,0
2020-05-26,Tulare,107,460477,2417,1768,10,1778,76
2020-05-26,Tuolumne,109,53932,5,2,0,2,0
2020-05-26,Ventura,111,848112,1511,1033,8,1041,27
2020-05-26,Yolo,113,214977,225,198,0,198,22
2020-05-26,Yuba,115,75493,27,24,0,24,1
2020-05-25,Alameda,001,1643700,3443,2900,5,2905,92
2020-05-25,Alpine,003,1148,1,1,0,1,0
2020-05-25,Amador,005,37829,10,10,0,10,0
2020-05-25,Butte,007,227075,63,37,1,38,0
2020-05-25,Calaveras,009,45235,15,13,0,13,0
2020-05-25,Colusa,011,21464,7,4,0,4,0
2020-05-25,Contra Costa,013,1133247,1539,1348,1,1349,37
2020-05-25,Del Norte,015,27424,44,20,0,20,0
2020-05-25,El Dorado,017,186661,101,78,1,79,0
2020-05-25,Fresno,019,978130,2902,1496,42,1538,22
2020-05-25,Glenn,021,27897,16,12,0,12,0
2020-05-25,Humboldt,023,135768,107,81,0,81,2
2020-05-25,Imperial,025,180216,2798,1369,4,1373,14
2020-05-25,Inyo,027,18085,19,20,0,20,1
2020-05-25,Kern,029,883053,2504,1890,6,1896,31
2020-05-25,Kings,031,150075,776,447,3,450,2
2020-05-25,Lake,033,64148,25,13,0,13,0
2020-05-25,Lassen,035,31185,9,0,2,2,0
2020-05-25,Los Angeles,037,10098052,54781,45952,20,45972,2094
2020-05-25,Madera,039,155013,196,83,1,84,2
2020-05-25,Marin,041,260295,442,415,2,417,14
2020-05-25,Mariposa,043,17540,16,15,0,15,1
2020-05-25,Mendocino,045,87422,22,19,0,19,0
2020-05-25,Merced,047,269075,356,262,0,262,6
2020-05-25,Modoc,049,8938,0,1,0,1,0
2020-05-25,Mono,051,14174,37,34,0,34,1
2020-05-25,Monterey,053,433212,545,418,1,419,8
2020-05-25,Napa,055,140530,131,107,0,107,3
2020-05-25,Nevada,057,99092,43,41,1,42,1
2020-05-25,Orange,059,3164182,8077,5601,65,5666,115
2020-05-25,Placer,061,380077,229,186,0,186,9
2020-05-25,Plumas,063,18699,4,4,0,4,0
2020-05-25,Riverside,065,2383286,8067,6900,20,6920,284
2020-05-25,Sacramento,067,1510023,1405,1290,1,1291,50
2020-05-25,San Benito,069,59416,87,70,0,70,2
2020-05-25,San Bernardino,071,2135413,5528,4393,4,4397,175
2020-05-25,San Diego,073,3302833,7797,6799,0,6799,249
2020-05-25,San Francisco,075,870044,2536,2358,0,2358,40
2020-05-25,San Joaquin,077,732212,966,760,4,764,33
2020-05-25,San Luis Obispo,079,281455,341,260,4,264,1
2020-05-25,San Mateo,081,765935,2229,1938,3,1941,71
2020-05-25,Santa Barbara,083,443738,1685,1590,11,1601,9
2020-05-25,Santa Clara,085,1922200,3306,2647,13,2660,139
2020-05-25,Santa Cruz,087,273765,220,191,0,191,2
2020-05-25,Shasta,089,179085,54,36,0,36,4
2020-05-25,Sierra,091,2930,1,1,0,1,0
2020-05-25,Siskiyou,093,43540,8,6,0,6,0
2020-05-25,Solano,095,438530,549,437,1,438,5
2020-05-25,Sonoma,097,501317,564,496,0,496,4
2020-05-25,Stanislaus,099,539301,749,651,5,656,27
2020-05-25,Sutter,101,95872,45,38,0,38,2
2020-05-25,Tehama,103,63373,7,2,1,3,1
2020-05-25,Trinity,105,12862,6,1,2,3,0
2020-05-25,Tulare,107,460477,2353,1747,10,1757,76
2020-05-25,Tuolumne,109,53932,5,2,0,2,0
2020-05-25,Ventura,111,848112,1470,1020,8,1028,27
2020-05-25,Yolo,113,214977,223,197,0,197,22
2020-05-25,Yuba,115,75493,26,24,0,24,1
2020-05-24,Alameda,001,1643700,3370,2830,5,2835,92
2020-05-24,Alpine,003,1148,1,1,0,1,0
2020-05-24,Amador,005,37829,10,9,0,9,0
2020-05-24,Butte,007,227075,61,35,1,36,0
2020-05-24,Calaveras,009,45235,15,13,0,13,0
2020-05-24,Colusa,011,21464,7,4,0,4,0
2020-05-24,Contra Costa,013,1133247,1511,1325,1,1326,37
2020-05-24,Del Norte,015,27424,43,16,0,16,0
2020-05-24,El Dorado,017,186661,100,76,1,77,0
2020-05-24,Fresno,019,978130,2835,1455,41,1496,22
2020-05-24,Glenn,021,27897,15,12,0,12,0
2020-05-24,Humboldt,023,135768,107,81,0,81,2
2020-05-24,Imperial,025,180216,2672,1369,4,1373,14
2020-05-24,Inyo,027,18085,19,20,0,20,1
2020-05-24,Kern,029,883053,2431,1861,5,1866,31
2020-05-24,Kings,031,150075,765,446,3,449,2
2020-05-24,Lake,033,64148,24,12,0,12,0
2020-05-24,Lassen,035,31185,8,0,2,2,0
2020-05-24,Los Angeles,037,10098052,53766,44954,20,44974,2085
2020-05-24,Madera,039,155013,190,83,1,84,2
2020-05-24,Marin,041,260295,440,401,2,403,14
2020-05-24,Mariposa,043,17540,16,15,0,15,1
2020-05-24,Mendocino,045,87422,21,19,0,19,0
2020-05-24,Merced,047,269075,355,258,0,258,6
2020-05-24,Modoc,049,8938,0,0,0,0,0
2020-05-24,Mono,051,14174,37,34,0,34,1
2020-05-24,Monterey,053,433212,517,405,1,406,8
2020-05-24,Napa,055,140530,129,104,0,104,3
2020-05-24,Nevada,057,99092,43,41,1,42,1
2020-05-24,Orange,059,3164182,7923,5439,64,5503,113
2020-05-24,Placer,061,380077,221,184,0,184,9
2020-05-24,Plumas,063,18699,4,4,0,4,0
2020-05-24,Riverside,065,2383286,7926,6571,20,6591,284
2020-05-24,Sacramento,067,1510023,1389,1283,1,1284,50
2020-05-24,San Benito,069,59416,86,67,0,67,2
2020-05-24,San Bernardino,071,2135413,5420,4262,4,4266,175
2020-05-24,San Diego,073,3302833,7654,6703,0,6703,249
2020-05-24,San Francisco,075,870044,2512,2318,0,2318,40
2020-05-24,San Joaquin,077,732212,947,760,4,764,33
2020-05-24,San Luis Obispo,079,281455,339,257,4,261,1
2020-05-24,San Mateo,081,765935,2194,1925,3,1928,71
2020-05-24,Santa Barbara,083,443738,1673,1573,11,1584,9
2020-05-24,Santa Clara,085,1922200,3286,2623,13,2636,139
2020-05-24,Santa Cruz,087,273765,217,185,0,185,2
2020-05-24,Shasta,089,179085,53,36,0,36,4
2020-05-24,Sierra,091,2930,1,1,0,1,0
2020-05-24,Siskiyou,093,43540,7,6,0,6,0
2020-05-24,Solano,095,438530,541,436,0,436,5
2020-05-24,Sonoma,097,501317,553,485,0,485,4
2020-05-24,Stanislaus,099,539301,729,634,5,639,27
2020-05-24,Sutter,101,95872,45,38,0,38,2
2020-05-24,Tehama,103,63373,5,2,1,3,1
2020-05-24,Trinity,105,12862,6,1,2,3,0
2020-05-24,Tulare,107,460477,2307,1684,10,1694,74
2020-05-24,Tuolumne,109,53932,5,2,0,2,0
2020-05-24,Ventura,111,848112,1458,982,8,990,27
2020-05-24,Yolo,113,214977,221,192,0,192,22
2020-05-24,Yuba,115,75493,26,24,0,24,1
2020-05-23,Alameda,001,1643700,3329,2783,5,2788,91
2020-05-23,Alpine,003,1148,1,1,0,1,0
2020-05-23,Amador,005,37829,10,9,0,9,0
2020-05-23,Butte,007,227075,60,34,1,35,0
2020-05-23,Calaveras,009,45235,15,13,0,13,0
2020-05-23,Colusa,011,21464,7,4,0,4,0
2020-05-23,Contra Costa,013,1133247,1500,1302,1,1303,36
2020-05-23,Del Norte,015,27424,43,10,0,10,0
2020-05-23,El Dorado,017,186661,100,74,1,75,0
2020-05-23,Fresno,019,978130,2815,1447,41,1488,21
2020-05-23,Glenn,021,27897,15,12,0,12,0
2020-05-23,Humboldt,023,135768,105,80,0,80,2
2020-05-23,Imperial,025,180216,2584,1283,4,1287,14
2020-05-23,Inyo,027,18085,19,20,0,20,1
2020-05-23,Kern,029,883053,2388,1806,5,1811,31
2020-05-23,Kings,031,150075,761,444,3,447,2
2020-05-23,Lake,033,64148,23,10,0,10,0
2020-05-23,Lassen,035,31185,8,0,2,2,0
2020-05-23,Los Angeles,037,10098052,53224,44029,20,44049,2069
2020-05-23,Madera,039,155013,186,83,1,84,2
2020-05-23,Marin,041,260295,440,393,1,394,14
2020-05-23,Mariposa,043,17540,16,15,0,15,1
2020-05-23,Mendocino,045,87422,21,13,0,13,0
2020-05-23,Merced,047,269075,352,247,0,247,6
2020-05-23,Modoc,049,8938,0,0,0,0,0
2020-05-23,Mono,051,14174,36,34,0,34,1
2020-05-23,Monterey,053,433212,503,397,1,398,8
2020-05-23,Napa,055,140530,125,101,0,101,3
2020-05-23,Nevada,057,99092,43,41,1,42,1
2020-05-23,Orange,059,3164182,7764,5313,63,5376,113
2020-05-23,Placer,061,380077,215,184,0,184,9
2020-05-23,Plumas,063,18699,4,4,0,4,0
2020-05-23,Riverside,065,2383286,7835,6460,20,6480,284
2020-05-23,Sacramento,067,1510023,1373,1275,1,1276,50
2020-05-23,San Benito,069,59416,81,67,0,67,2
2020-05-23,San Bernardino,071,2135413,5326,4172,4,4176,175
2020-05-23,San Diego,073,3302833,7563,6561,0,6561,249
2020-05-23,San Francisco,075,870044,2493,2312,0,2312,40
2020-05-23,San Joaquin,077,732212,932,759,4,763,33
2020-05-23,San Luis Obispo,079,281455,335,256,4,260,1
2020-05-23,San Mateo,081,765935,2166,1862,3,1865,71
2020-05-23,Santa Barbara,083,443738,1665,1566,11,1577,9
2020-05-23,Santa Clara,085,1922200,3272,2593,12,2605,139
2020-05-23,Santa Cruz,087,273765,215,177,0,177,2
2020-05-23,Shasta,089,179085,53,35,0,35,4
2020-05-23,Sierra,091,2930,1,1,0,1,0
2020-05-23,Siskiyou,093,43540,7,6,0,6,0
2020-05-23,Solano,095,438530,536,435,0,435,5
2020-05-23,Sonoma,097,501317,539,462,0,462,4
2020-05-23,Stanislaus,099,539301,721,625,5,630,27
2020-05-23,Sutter,101,95872,44,38,0,38,2
2020-05-23,Tehama,103,63373,5,2,1,3,1
2020-05-23,Trinity,105,12862,6,1,2,3,0
2020-05-23,Tulare,107,460477,2286,1682,10,1692,73
2020-05-23,Tuolumne,109,53932,5,2,0,2,0
2020-05-23,Ventura,111,848112,1438,961,8,969,27
2020-05-23,Yolo,113,214977,220,188,0,188,22
2020-05-23,Yuba,115,75493,26,24,0,24,1
2020-05-22,Alameda,001,1643700,3275,2722,5,2727,91
2020-05-22,Alpine,003,1148,1,1,0,1,0
2020-05-22,Amador,005,37829,10,9,0,9,0
2020-05-22,Butte,007,227075,58,34,1,35,0
2020-05-22,Calaveras,009,45235,15,13,0,13,0
2020-05-22,Colusa,011,21464,7,4,0,4,0
2020-05-22,Contra Costa,013,1133247,1488,1272,1,1273,36
2020-05-22,Del Norte,015,27424,41,9,0,9,0
2020-05-22,El Dorado,017,186661,97,74,1,75,0
2020-05-22,Fresno,019,978130,2756,1399,40,1439,20
2020-05-22,Glenn,021,27897,15,12,0,12,0
2020-05-22,Humboldt,023,135768,105,80,0,80,2
2020-05-22,Imperial,025,180216,2483,1214,4,1218,14
2020-05-22,Inyo,027,18085,19,20,0,20,1
2020-05-22,Kern,029,883053,2339,1749,5,1754,28
2020-05-22,Kings,031,150075,758,428,3,431,2
2020-05-22,Lake,033,64148,22,10,0,10,0
2020-05-22,Lassen,035,31185,6,0,2,2,0
2020-05-22,Los Angeles,037,10098052,52430,43025,20,43045,2027
2020-05-22,Madera,039,155013,182,82,1,83,2
2020-05-22,Marin,041,260295,436,372,1,373,14
2020-05-22,Mariposa,043,17540,16,15,0,15,1
2020-05-22,Mendocino,045,87422,20,13,0,13,0
2020-05-22,Merced,047,269075,352,233,0,233,6
2020-05-22,Modoc,049,8938,0,0,0,0,0
2020-05-22,Mono,051,14174,36,34,0,34,1
2020-05-22,Monterey,053,433212,492,372,1,373,8
2020-05-22,Napa,055,140530,123,97,0,97,3
2020-05-22,Nevada,057,99092,42,41,1,42,1
2020-05-22,Orange,059,3164182,7567,5144,61,5205,113
2020-05-22,Placer,061,380077,215,181,0,181,9
2020-05-22,Plumas,063,18699,4,4,0,4,0
2020-05-22,Riverside,065,2383286,7720,6351,20,6371,283
2020-05-22,Sacramento,067,1510023,1357,1262,1,1263,50
2020-05-22,San Benito,069,59416,80,64,0,64,2
2020-05-22,San Bernardino,071,2135413,5251,4107,4,4111,173
2020-05-22,San Diego,073,3302833,7477,6436,0,6436,242
2020-05-22,San Francisco,075,870044,2475,2251,0,2251,40
2020-05-22,San Joaquin,077,732212,919,747,4,751,33
2020-05-22,San Luis Obispo,079,281455,334,254,4,258,1
2020-05-22,San Mateo,081,765935,2147,1847,3,1850,71
2020-05-22,Santa Barbara,083,443738,1655,1554,11,1565,9
2020-05-22,Santa Clara,085,1922200,3252,2537,12,2549,139
2020-05-22,Santa Cruz,087,273765,212,171,0,171,2
2020-05-22,Shasta,089,179085,53,34,0,34,4
2020-05-22,Sierra,091,2930,1,0,0,0,0
2020-05-22,Siskiyou,093,43540,7,6,0,6,0
2020-05-22,Solano,095,438530,533,431,0,431,4
2020-05-22,Sonoma,097,501317,535,444,0,444,4
2020-05-22,Stanislaus,099,539301,711,616,5,621,27
2020-05-22,Sutter,101,95872,44,38,0,38,2
2020-05-22,Tehama,103,63373,5,2,0,2,1
2020-05-22,Trinity,105,12862,6,1,2,3,0
2020-05-22,Tulare,107,460477,2256,1662,10,1672,73
2020-05-22,Tuolumne,109,53932,5,2,0,2,0
2020-05-22,Ventura,111,848112,1420,937,8,945,27
2020-05-22,Yolo,113,214977,218,187,0,187,22
2020-05-22,Yuba,115,75493,26,24,0,24,1
2020-05-21,Alameda,001,1643700,3209,2606,5,2611,89
2020-05-21,Alpine,003,1148,1,1,0,1,0
2020-05-21,Amador,005,37829,10,9,0,9,0
2020-05-21,Butte,007,227075,57,31,1,32,0
2020-05-21,Calaveras,009,45235,14,13,0,13,0
2020-05-21,Colusa,011,21464,7,4,0,4,0
2020-05-21,Contra Costa,013,1133247,1452,1243,1,1244,36
2020-05-21,Del Norte,015,27424,38,9,0,9,0
2020-05-21,El Dorado,017,186661,95,67,1,68,0
2020-05-21,Fresno,019,978130,2664,1362,39,1401,20
2020-05-21,Glenn,021,27897,14,12,0,12,0
2020-05-21,Humboldt,023,135768,104,79,0,79,0
2020-05-21,Imperial,025,180216,2322,1096,4,1100,14
2020-05-21,Inyo,027,18085,19,20,0,20,1
2020-05-21,Kern,029,883053,2263,1684,4,1688,27
2020-05-21,Kings,031,150075,737,417,2,419,2
2020-05-21,Lake,033,64148,17,10,0,10,0
2020-05-21,Lassen,035,31185,6,0,2,2,0
2020-05-21,Los Angeles,037,10098052,51393,42063,20,42083,1996
2020-05-21,Madera,039,155013,179,82,1,83,2
2020-05-21,Marin,041,260295,425,359,1,360,14
2020-05-21,Mariposa,043,17540,16,15,0,15,1
2020-05-21,Mendocino,045,87422,20,12,0,12,0
2020-05-21,Merced,047,269075,341,226,0,226,6
2020-05-21,Modoc,049,8938,0,0,0,0,0
2020-05-21,Mono,051,14174,36,33,0,33,1
2020-05-21,Monterey,053,433212,481,363,1,364,8
2020-05-21,Napa,055,140530,121,96,0,96,3
2020-05-21,Nevada,057,99092,42,41,1,42,1
2020-05-21,Orange,059,3164182,7364,4975,60,5035,106
2020-05-21,Placer,061,380077,208,176,0,176,8
2020-05-21,Plumas,063,18699,4,4,0,4,0
2020-05-21,Riverside,065,2383286,7534,6245,20,6265,279
2020-05-21,Sacramento,067,1510023,1344,1258,1,1259,56
2020-05-21,San Benito,069,59416,77,61,0,61,2
2020-05-21,San Bernardino,071,2135413,5104,3950,4,3954,167
2020-05-21,San Diego,073,3302833,7341,6317,0,6317,241
2020-05-21,San Francisco,075,870044,2451,2248,0,2248,37
2020-05-21,San Joaquin,077,732212,883,730,4,734,33
2020-05-21,San Luis Obispo,079,281455,334,251,3,254,1
2020-05-21,San Mateo,081,765935,2111,1791,3,1794,74
2020-05-21,Santa Barbara,083,443738,1640,1541,11,1552,10
2020-05-21,Santa Clara,085,1922200,3229,2520,12,2532,138
2020-05-21,Santa Cruz,087,273765,204,164,0,164,3
2020-05-21,Shasta,089,179085,51,34,0,34,4
2020-05-21,Sierra,091,2930,1,0,0,0,0
2020-05-21,Siskiyou,093,43540,7,6,0,6,0
2020-05-21,Solano,095,438530,524,424,0,424,4
2020-05-21,Sonoma,097,501317,517,427,0,427,4
2020-05-21,Stanislaus,099,539301,700,602,5,607,27
2020-05-21,Sutter,101,95872,43,38,0,38,2
2020-05-21,Tehama,103,63373,4,2,0,2,1
2020-05-21,Trinity,105,12862,5,1,2,3,0
2020-05-21,Tulare,107,460477,2206,1606,8,1614,73
2020-05-21,Tuolumne,109,53932,3,2,0,2,0
2020-05-21,Ventura,111,848112,1371,907,8,915,30
2020-05-21,Yolo,113,214977,215,185,0,185,22
2020-05-21,Yuba,115,75493,26,24,0,24,1
2020-05-20,Alameda,001,1643700,3136,2554,5,2559,89
2020-05-20,Alpine,003,1148,1,1,0,1,0
2020-05-20,Amador,005,37829,10,9,0,9,0
2020-05-20,Butte,007,227075,54,30,1,31,0
2020-05-20,Calaveras,009,45235,14,13,0,13,0
2020-05-20,Colusa,011,21464,7,3,0,3,0
2020-05-20,Contra Costa,013,1133247,1422,1223,1,1224,33
2020-05-20,Del Norte,015,27424,31,9,0,9,0
2020-05-20,El Dorado,017,186661,94,67,1,68,0
2020-05-20,Fresno,019,978130,2591,1329,38,1367,17
2020-05-20,Glenn,021,27897,13,12,0,12,0
2020-05-20,Humboldt,023,135768,101,73,0,73,0
2020-05-20,Imperial,025,180216,2209,1047,4,1051,14
2020-05-20,Inyo,027,18085,19,20,0,20,1
2020-05-20,Kern,029,883053,2200,1639,3,1642,27
2020-05-20,Kings,031,150075,593,403,2,405,2
2020-05-20,Lake,033,64148,17,9,0,9,0
2020-05-20,Lassen,035,31185,5,0,2,2,0
2020-05-20,Los Angeles,037,10098052,50398,40932,20,40952,1955
2020-05-20,Madera,039,155013,177,82,1,83,2
2020-05-20,Marin,041,260295,398,348,1,349,14
2020-05-20,Mariposa,043,17540,16,15,0,15,1
2020-05-20,Mendocino,045,87422,20,12,0,12,0
2020-05-20,Merced,047,269075,334,225,0,225,6
2020-05-20,Modoc,049,8938,0,0,0,0,0
2020-05-20,Mono,051,14174,36,33,0,33,1
2020-05-20,Monterey,053,433212,467,356,1,357,8
2020-05-20,Napa,055,140530,114,93,0,93,3
2020-05-20,Nevada,057,99092,42,41,1,42,1
2020-05-20,Orange,059,3164182,7156,4866,58,4924,96
2020-05-20,Placer,061,380077,206,176,0,176,8
2020-05-20,Plumas,063,18699,4,4,0,4,0
2020-05-20,Riverside,065,2383286,7391,6090,20,6110,265
2020-05-20,Sacramento,067,1510023,1334,1244,1,1245,56
2020-05-20,San Benito,069,59416,76,61,0,61,2
2020-05-20,San Bernardino,071,2135413,4976,3771,4,3775,161
2020-05-20,San Diego,073,3302833,7224,6142,0,6142,230
2020-05-20,San Francisco,075,870044,2428,2199,0,2199,37
2020-05-20,San Joaquin,077,732212,847,713,4,717,33
2020-05-20,San Luis Obispo,079,281455,327,249,3,252,1
2020-05-20,San Mateo,081,765935,2058,1739,3,1742,74
2020-05-20,Santa Barbara,083,443738,1621,1524,11,1535,10
2020-05-20,Santa Clara,085,1922200,3208,2508,11,2519,138
2020-05-20,Santa Cruz,087,273765,201,163,0,163,3
2020-05-20,Shasta,089,179085,51,34,0,34,4
2020-05-20,Sierra,091,2930,1,0,0,0,0
2020-05-20,Siskiyou,093,43540,7,6,0,6,0
2020-05-20,Solano,095,438530,519,418,0,418,4
2020-05-20,Sonoma,097,501317,508,411,0,411,4
2020-05-20,Stanislaus,099,539301,684,584,4,588,25
2020-05-20,Sutter,101,95872,43,38,0,38,2
2020-05-20,Tehama,103,63373,4,2,0,2,1
2020-05-20,Trinity,105,12862,4,1,1,2,0
2020-05-20,Tulare,107,460477,2165,1585,8,1593,71
2020-05-20,Tuolumne,109,53932,3,2,0,2,0
2020-05-20,Ventura,111,848112,1335,879,8,887,29
2020-05-20,Yolo,113,214977,212,184,0,184,22
2020-05-20,Yuba,115,75493,26,23,0,23,1
2020-05-19,Alameda,001,1643700,3059,2493,3,2496,88
2020-05-19,Alpine,003,1148,1,1,0,1,0
2020-05-19,Amador,005,37829,10,9,0,9,0
2020-05-19,Butte,007,227075,52,25,1,26,0
2020-05-19,Calaveras,009,45235,14,13,0,13,0
2020-05-19,Colusa,011,21464,5,3,0,3,0
2020-05-19,Contra Costa,013,1133247,1398,1205,1,1206,33
2020-05-19,Del Norte,015,27424,28,8,0,8,0
2020-05-19,El Dorado,017,186661,91,67,0,67,0
2020-05-19,Fresno,019,978130,2477,1288,37,1325,15
2020-05-19,Glenn,021,27897,13,12,0,12,0
2020-05-19,Humboldt,023,135768,101,72,0,72,0
2020-05-19,Imperial,025,180216,2047,1012,4,1016,14
2020-05-19,Inyo,027,18085,19,20,0,20,1
2020-05-19,Kern,029,883053,2102,1601,3,1604,26
2020-05-19,Kings,031,150075,582,393,2,395,2
2020-05-19,Lake,033,64148,14,11,0,11,0
2020-05-19,Lassen,035,31185,5,0,2,2,0
2020-05-19,Los Angeles,037,10098052,49193,39670,20,39690,1906
2020-05-19,Madera,039,155013,173,80,1,81,2
2020-05-19,Marin,041,260295,374,340,1,341,14
2020-05-19,Mariposa,043,17540,16,15,0,15,1
2020-05-19,Mendocino,045,87422,20,12,0,12,0
2020-05-19,Merced,047,269075,326,222,0,222,5
2020-05-19,Modoc,049,8938,0,0,0,0,0
2020-05-19,Mono,051,14174,36,33,0,33,1
2020-05-19,Monterey,053,433212,455,350,1,351,8
2020-05-19,Napa,055,140530,113,93,0,93,3
2020-05-19,Nevada,057,99092,42,41,1,42,1
2020-05-19,Orange,059,3164182,6962,4746,56,4802,90
2020-05-19,Placer,061,380077,204,177,0,177,8
2020-05-19,Plumas,063,18699,4,5,0,5,0
2020-05-19,Riverside,065,2383286,7231,5963,19,5982,265
2020-05-19,Sacramento,067,1510023,1320,1239,1,1240,57
2020-05-19,San Benito,069,59416,74,59,0,59,2
2020-05-19,San Bernardino,071,2135413,4826,3656,4,3660,158
2020-05-19,San Diego,073,3302833,7080,6028,0,6028,222
2020-05-19,San Francisco,075,870044,2394,2186,0,2186,37
2020-05-19,San Joaquin,077,732212,825,705,4,709,33
2020-05-19,San Luis Obispo,079,281455,327,245,3,248,1
2020-05-19,San Mateo,081,765935,2017,1704,3,1707,71
2020-05-19,Santa Barbara,083,443738,1607,1521,11,1532,10
2020-05-19,Santa Clara,085,1922200,3158,2480,11,2491,138
2020-05-19,Santa Cruz,087,273765,190,161,0,161,3
2020-05-19,Shasta,089,179085,51,34,0,34,4
2020-05-19,Sierra,091,2930,0,0,0,0,0
2020-05-19,Siskiyou,093,43540,7,6,0,6,0
2020-05-19,Solano,095,438530,505,415,0,415,4
2020-05-19,Sonoma,097,501317,497,389,0,389,4
2020-05-19,Stanislaus,099,539301,670,582,4,586,25
2020-05-19,Sutter,101,95872,43,38,0,38,2
2020-05-19,Tehama,103,63373,4,2,0,2,1
2020-05-19,Trinity,105,12862,3,1,0,1,0
2020-05-19,Tulare,107,460477,2117,1551,8,1559,68
2020-05-19,Tuolumne,109,53932,3,2,0,2,0
2020-05-19,Ventura,111,848112,1294,861,7,868,28
2020-05-19,Yolo,113,214977,210,183,0,183,22
2020-05-19,Yuba,115,75493,26,23,0,23,1
2020-05-18,Alameda,001,1643700,2986,2442,3,2445,84
2020-05-18,Alpine,003,1148,1,1,0,1,0
2020-05-18,Amador,005,37829,10,8,0,8,0
2020-05-18,Butte,007,227075,50,24,1,25,0
2020-05-18,Calaveras,009,45235,14,13,0,13,0
2020-05-18,Colusa,011,21464,5,3,0,3,0
2020-05-18,Contra Costa,013,1133247,1367,1173,1,1174,33
2020-05-18,Del Norte,015,27424,23,8,0,8,0
2020-05-18,El Dorado,017,186661,89,67,0,67,0
2020-05-18,Fresno,019,978130,2399,1244,36,1280,14
2020-05-18,Glenn,021,27897,13,11,0,11,0
2020-05-18,Humboldt,023,135768,101,70,0,70,0
2020-05-18,Imperial,025,180216,1894,767,4,771,14
2020-05-18,Inyo,027,18085,19,20,0,20,1
2020-05-18,Kern,029,883053,2053,1566,3,1569,26
2020-05-18,Kings,031,150075,551,381,2,383,2
2020-05-18,Lake,033,64148,13,9,0,9,0
2020-05-18,Lassen,035,31185,5,0,2,2,0
2020-05-18,Los Angeles,037,10098052,48167,38477,20,38497,1825
2020-05-18,Madera,039,155013,167,74,1,75,2
2020-05-18,Marin,041,260295,361,329,1,330,14
2020-05-18,Mariposa,043,17540,16,15,0,15,1
2020-05-18,Mendocino,045,87422,15,12,0,12,0
2020-05-18,Merced,047,269075,317,217,0,217,5
2020-05-18,Modoc,049,8938,0,0,0,0,0
2020-05-18,Mono,051,14174,36,33,0,33,1
2020-05-18,Monterey,053,433212,444,345,1,346,8
2020-05-18,Napa,055,140530,109,92,0,92,3
2020-05-18,Nevada,057,99092,42,41,1,42,1
2020-05-18,Orange,059,3164182,6773,4558,54,4612,88
2020-05-18,Placer,061,380077,202,176,0,176,8
2020-05-18,Plumas,063,18699,4,5,0,5,0
2020-05-18,Riverside,065,2383286,7031,5873,18,5891,253
2020-05-18,Sacramento,067,1510023,1314,1233,0,1233,57
2020-05-18,San Benito,069,59416,72,59,0,59,2
2020-05-18,San Bernardino,071,2135413,4679,3558,4,3562,156
2020-05-18,San Diego,073,3302833,6947,5948,0,5948,211
2020-05-18,San Francisco,075,870044,2371,2183,0,2183,36
2020-05-18,San Joaquin,077,732212,813,697,4,701,33
2020-05-18,San Luis Obispo,079,281455,323,243,3,246,1
2020-05-18,San Mateo,081,765935,1979,1701,3,1704,68
2020-05-18,Santa Barbara,083,443738,1596,1501,11,1512,10
2020-05-18,Santa Clara,085,1922200,3125,2468,11,2479,137
2020-05-18,Santa Cruz,087,273765,188,160,0,160,3
2020-05-18,Shasta,089,179085,50,34,0,34,4
2020-05-18,Sierra,091,2930,0,0,0,0,0
2020-05-18,Siskiyou,093,43540,7,6,0,6,0
2020-05-18,Solano,095,438530,495,398,0,398,4
2020-05-18,Sonoma,097,501317,479,387,0,387,4
2020-05-18,Stanislaus,099,539301,658,572,4,576,25
2020-05-18,Sutter,101,95872,43,38,0,38,2
2020-05-18,Tehama,103,63373,4,2,0,2,1
2020-05-18,Trinity,105,12862,3,1,0,1,0
2020-05-18,Tulare,107,460477,2073,1491,8,1499,63
2020-05-18,Tuolumne,109,53932,3,2,0,2,0
2020-05-18,Ventura,111,848112,1271,850,6,856,27
2020-05-18,Yolo,113,214977,205,183,0,183,22
2020-05-18,Yuba,115,75493,26,23,0,23,1
2020-05-17,Alameda,001,1643700,2891,2389,3,2392,83
2020-05-17,Alpine,003,1148,1,1,0,1,0
2020-05-17,Amador,005,37829,10,8,0,8,0
2020-05-17,Butte,007,227075,49,23,1,24,0
2020-05-17,Calaveras,009,45235,14,13,0,13,0
2020-05-17,Colusa,011,21464,3,3,0,3,0
2020-05-17,Contra Costa,013,1133247,1328,1155,1,1156,33
2020-05-17,Del Norte,015,27424,23,7,0,7,0
2020-05-17,El Dorado,017,186661,89,65,0,65,0
2020-05-17,Fresno,019,978130,2293,1213,33,1246,14
2020-05-17,Glenn,021,27897,13,9,0,9,0
2020-05-17,Humboldt,023,135768,94,70,0,70,0
2020-05-17,Imperial,025,180216,1746,715,4,719,14
2020-05-17,Inyo,027,18085,19,20,0,20,1
2020-05-17,Kern,029,883053,1975,1546,3,1549,26
2020-05-17,Kings,031,150075,504,356,2,358,2
2020-05-17,Lake,033,64148,13,7,0,7,0
2020-05-17,Lassen,035,31185,5,0,2,2,0
2020-05-17,Los Angeles,037,10098052,46926,37996,20,38016,1807
2020-05-17,Madera,039,155013,165,69,1,70,2
2020-05-17,Marin,041,260295,350,315,1,316,14
2020-05-17,Mariposa,043,17540,15,15,0,15,1
2020-05-17,Mendocino,045,87422,14,10,0,10,0
2020-05-17,Merced,047,269075,306,214,0,214,5
2020-05-17,Modoc,049,8938,0,0,0,0,0
2020-05-17,Mono,051,14174,36,32,0,32,1
2020-05-17,Monterey,053,433212,424,342,1,343,8
2020-05-17,Napa,055,140530,105,89,0,89,3
2020-05-17,Nevada,057,99092,42,41,1,42,1
2020-05-17,Orange,059,3164182,6594,4466,53,4519,88
2020-05-17,Placer,061,380077,197,175,0,175,8
2020-05-17,Plumas,063,18699,4,4,0,4,0
2020-05-17,Riverside,065,2383286,6858,5776,18,5794,245
2020-05-17,Sacramento,067,1510023,1303,1224,0,1224,56
2020-05-17,San Benito,069,59416,71,59,0,59,2
2020-05-17,San Bernardino,071,2135413,4529,3467,4,3471,155
2020-05-17,San Diego,073,3302833,6815,5838,0,5838,209
2020-05-17,San Francisco,075,870044,2344,2132,0,2132,36
2020-05-17,San Joaquin,077,732212,783,688,4,692,32
2020-05-17,San Luis Obispo,079,281455,321,242,3,245,1
2020-05-17,San Mateo,081,765935,1942,1680,3,1683,68
2020-05-17,Santa Barbara,083,443738,1576,1457,11,1468,10
2020-05-17,Santa Clara,085,1922200,3087,2453,11,2464,135
2020-05-17,Santa Cruz,087,273765,177,155,0,155,3
2020-05-17,Shasta,089,179085,49,34,0,34,4
2020-05-17,Sierra,091,2930,0,0,0,0,0
2020-05-17,Siskiyou,093,43540,7,6,0,6,0
2020-05-17,Solano,095,438530,483,392,0,392,4
2020-05-17,Sonoma,097,501317,458,376,0,376,4
2020-05-17,Stanislaus,099,539301,647,566,4,570,25
2020-05-17,Sutter,101,95872,42,38,0,38,2
2020-05-17,Tehama,103,63373,3,2,0,2,1
2020-05-17,Trinity,105,12862,2,1,0,1,0
2020-05-17,Tulare,107,460477,1997,1430,7,1437,63
2020-05-17,Tuolumne,109,53932,3,2,0,2,0
2020-05-17,Ventura,111,848112,1226,838,6,844,27
2020-05-17,Yolo,113,214977,203,182,0,182,22
2020-05-17,Yuba,115,75493,26,21,0,21,1
2020-05-16,Alameda,001,1643700,2841,2327,3,2330,83
2020-05-16,Alpine,003,1148,1,1,0,1,0
2020-05-16,Amador,005,37829,10,8,0,8,0
2020-05-16,Butte,007,227075,44,22,1,23,0
2020-05-16,Calaveras,009,45235,14,13,0,13,0
2020-05-16,Colusa,011,21464,3,3,0,3,0
2020-05-16,Contra Costa,013,1133247,1310,1136,1,1137,33
2020-05-16,Del Norte,015,27424,19,4,0,4,0
2020-05-16,El Dorado,017,186661,89,65,0,65,0
2020-05-16,Fresno,019,978130,2236,1177,33,1210,14
2020-05-16,Glenn,021,27897,13,9,0,9,0
2020-05-16,Humboldt,023,135768,92,69,0,69,0
2020-05-16,Imperial,025,180216,1682,712,4,716,14
2020-05-16,Inyo,027,18085,19,20,0,20,1
2020-05-16,Kern,029,883053,1939,1509,3,1512,26
2020-05-16,Kings,031,150075,494,356,2,358,2
2020-05-16,Lake,033,64148,13,7,0,7,0
2020-05-16,Lassen,035,31185,4,0,2,2,0
2020-05-16,Los Angeles,037,10098052,46349,37352,20,37372,1778
2020-05-16,Madera,039,155013,163,70,1,71,2
2020-05-16,Marin,041,260295,346,297,1,298,14
2020-05-16,Mariposa,043,17540,15,15,0,15,1
2020-05-16,Mendocino,045,87422,14,10,0,10,0
2020-05-16,Merced,047,269075,304,201,0,201,5
2020-05-16,Modoc,049,8938,0,0,0,0,0
2020-05-16,Mono,051,14174,36,32,0,32,1
2020-05-16,Monterey,053,433212,409,329,1,330,8
2020-05-16,Napa,055,140530,105,86,0,86,3
2020-05-16,Nevada,057,99092,42,41,1,42,1
2020-05-16,Orange,059,3164182,6518,4396,52,4448,87
2020-05-16,Placer,061,380077,195,174,0,174,8
2020-05-16,Plumas,063,18699,4,4,0,4,0
2020-05-16,Riverside,065,2383286,6773,5633,18,5651,243
2020-05-16,Sacramento,067,1510023,1296,1209,0,1209,55
2020-05-16,San Benito,069,59416,66,58,0,58,2
2020-05-16,San Bernardino,071,2135413,4457,3362,4,3366,155
2020-05-16,San Diego,073,3302833,6729,5664,0,5664,209
2020-05-16,San Francisco,075,870044,2321,2094,0,2094,36
2020-05-16,San Joaquin,077,732212,775,668,4,672,32
2020-05-16,San Luis Obispo,079,281455,320,240,3,243,1
2020-05-16,San Mateo,081,765935,1927,1652,3,1655,68
2020-05-16,Santa Barbara,083,443738,1565,1422,10,1432,10
2020-05-16,Santa Clara,085,1922200,3069,2420,11,2431,135
2020-05-16,Santa Cruz,087,273765,174,154,0,154,3
2020-05-16,Shasta,089,179085,49,33,0,33,4
2020-05-16,Sierra,091,2930,0,0,0,0,0
2020-05-16,Siskiyou,093,43540,7,6,0,6,0
2020-05-16,Solano,095,438530,478,392,0,392,4
2020-05-16,Sonoma,097,501317,445,356,0,356,4
2020-05-16,Stanislaus,099,539301,638,546,4,550,24
2020-05-16,Sutter,101,95872,42,35,0,35,2
2020-05-16,Tehama,103,63373,3,2,0,2,1
2020-05-16,Trinity,105,12862,2,1,0,1,0
2020-05-16,Tulare,107,460477,1979,1426,7,1433,63
2020-05-16,Tuolumne,109,53932,3,2,0,2,0
2020-05-16,Ventura,111,848112,1200,813,6,819,25
2020-05-16,Yolo,113,214977,202,181,0,181,22
2020-05-16,Yuba,115,75493,26,21,0,21,1
2020-05-15,Alameda,001,1643700,2807,2289,3,2292,83
2020-05-15,Alpine,003,1148,1,1,0,1,0
2020-05-15,Amador,005,37829,10,8,0,8,0
2020-05-15,Butte,007,227075,42,22,1,23,0
2020-05-15,Calaveras,009,45235,14,13,0,13,0
2020-05-15,Colusa,011,21464,3,3,0,3,0
2020-05-15,Contra Costa,013,1133247,1292,1106,1,1107,33
2020-05-15,Del Norte,015,27424,14,4,0,4,0
2020-05-15,El Dorado,017,186661,89,64,0,64,0
2020-05-15,Fresno,019,978130,2169,1126,33,1159,14
2020-05-15,Glenn,021,27897,13,9,0,9,0
2020-05-15,Humboldt,023,135768,91,60,0,60,0
2020-05-15,Imperial,025,180216,1598,680,0,680,14
2020-05-15,Inyo,027,18085,19,20,0,20,1
2020-05-15,Kern,029,883053,1883,1472,3,1475,25
2020-05-15,Kings,031,150075,491,347,2,349,2
2020-05-15,Lake,033,64148,13,7,0,7,0
2020-05-15,Lassen,035,31185,4,0,2,2,0
2020-05-15,Los Angeles,037,10098052,45562,36317,20,36337,1734
2020-05-15,Madera,039,155013,162,71,1,72,2
2020-05-15,Marin,041,260295,338,295,1,296,14
2020-05-15,Mariposa,043,17540,15,15,0,15,1
2020-05-15,Mendocino,045,87422,14,10,0,10,0
2020-05-15,Merced,047,269075,301,191,0,191,5
2020-05-15,Modoc,049,8938,0,0,0,0,0
2020-05-15,Mono,051,14174,36,31,0,31,1
2020-05-15,Monterey,053,433212,403,321,1,322,8
2020-05-15,Napa,055,140530,105,83,0,83,3
2020-05-15,Nevada,057,99092,42,41,1,42,1
2020-05-15,Orange,059,3164182,6345,4281,52,4333,87
2020-05-15,Placer,061,380077,193,174,0,174,8
2020-05-15,Plumas,063,18699,4,4,0,4,0
2020-05-15,Riverside,065,2383286,6659,5496,18,5514,233
2020-05-15,Sacramento,067,1510023,1286,1203,0,1203,55
2020-05-15,San Benito,069,59416,63,57,0,57,2
2020-05-15,San Bernardino,071,2135413,4379,3225,4,3229,153
2020-05-15,San Diego,073,3302833,6622,5525,0,5525,208
2020-05-15,San Francisco,075,870044,2305,2062,0,2062,36
2020-05-15,San Joaquin,077,732212,769,656,4,660,32
2020-05-15,San Luis Obispo,079,281455,318,237,3,240,1
2020-05-15,San Mateo,081,765935,1905,1612,3,1615,68
2020-05-15,Santa Barbara,083,443738,1556,1409,9,1418,10
2020-05-15,Santa Clara,085,1922200,3026,2395,10,2405,135
2020-05-15,Santa Cruz,087,273765,173,146,0,146,3
2020-05-15,Shasta,089,179085,48,33,0,33,4
2020-05-15,Sierra,091,2930,0,0,0,0,0
2020-05-15,Siskiyou,093,43540,6,5,0,5,0
2020-05-15,Solano,095,438530,474,388,0,388,4
2020-05-15,Sonoma,097,501317,437,349,0,349,4
2020-05-15,Stanislaus,099,539301,631,540,4,544,23
2020-05-15,Sutter,101,95872,41,35,0,35,2
2020-05-15,Tehama,103,63373,3,1,0,1,1
2020-05-15,Trinity,105,12862,2,1,0,1,0
2020-05-15,Tulare,107,460477,1951,1356,7,1363,61
2020-05-15,Tuolumne,109,53932,3,2,0,2,0
2020-05-15,Ventura,111,848112,1182,789,5,794,25
2020-05-15,Yolo,113,214977,201,182,0,182,22
2020-05-15,Yuba,115,75493,26,21,0,21,1
2020-05-14,Alameda,001,1643700,2714,2255,3,2258,80
2020-05-14,Alpine,003,1148,1,1,0,1,0
2020-05-14,Amador,005,37829,10,8,0,8,0
2020-05-14,Butte,007,227075,40,22,1,23,0
2020-05-14,Calaveras,009,45235,14,13,0,13,0
2020-05-14,Colusa,011,21464,3,3,0,3,0
2020-05-14,Contra Costa,013,1133247,1266,1090,1,1091,32
2020-05-14,Del Norte,015,27424,14,4,0,4,0
2020-05-14,El Dorado,017,186661,80,59,0,59,0
2020-05-14,Fresno,019,978130,2109,1038,29,1067,12
2020-05-14,Glenn,021,27897,12,8,0,8,0
2020-05-14,Humboldt,023,135768,89,59,0,59,0
2020-05-14,Imperial,025,180216,1481,652,0,652,13
2020-05-14,Inyo,027,18085,19,20,0,20,1
2020-05-14,Kern,029,883053,1841,1430,3,1433,21
2020-05-14,Kings,031,150075,475,342,2,344,1
2020-05-14,Lake,033,64148,13,7,0,7,0
2020-05-14,Lassen,035,31185,4,0,2,2,0
2020-05-14,Los Angeles,037,10098052,44387,35427,20,35447,1693
2020-05-14,Madera,039,155013,153,69,1,70,2
2020-05-14,Marin,041,260295,320,283,1,284,14
2020-05-14,Mariposa,043,17540,15,15,0,15,0
2020-05-14,Mendocino,045,87422,13,10,0,10,0
2020-05-14,Merced,047,269075,290,182,0,182,3
2020-05-14,Modoc,049,8938,0,0,0,0,0
2020-05-14,Mono,051,14174,36,31,0,31,1
2020-05-14,Monterey,053,433212,393,317,1,318,7
2020-05-14,Napa,055,140530,103,83,0,83,3
2020-05-14,Nevada,057,99092,41,41,1,42,1
2020-05-14,Orange,059,3164182,6169,4163,50,4213,83
2020-05-14,Placer,061,380077,193,172,0,172,8
2020-05-14,Plumas,063,18699,4,4,0,4,0
2020-05-14,Riverside,065,2383286,6475,5339,18,5357,224
2020-05-14,Sacramento,067,1510023,1274,1181,0,1181,55
2020-05-14,San Benito,069,59416,61,56,0,56,2
2020-05-14,San Bernardino,071,2135413,4200,3149,4,3153,149
2020-05-14,San Diego,073,3302833,6487,5393,0,5393,200
2020-05-14,San Francisco,075,870044,2272,2029,0,2029,36
2020-05-14,San Joaquin,077,732212,754,643,4,647,31
2020-05-14,San Luis Obispo,079,281455,315,236,3,239,1
2020-05-14,San Mateo,081,765935,1873,1588,3,1591,67
2020-05-14,Santa Barbara,083,443738,1544,1395,9,1404,11
2020-05-14,Santa Clara,085,1922200,3003,2380,10,2390,134
2020-05-14,Santa Cruz,087,273765,171,145,0,145,3
2020-05-14,Shasta,089,179085,48,33,0,33,4
2020-05-14,Sierra,091,2930,0,0,0,0,0
2020-05-14,Siskiyou,093,43540,6,5,0,5,0
2020-05-14,Solano,095,438530,465,372,0,372,4
2020-05-14,Sonoma,097,501317,420,333,0,333,4
2020-05-14,Stanislaus,099,539301,612,533,4,537,23
2020-05-14,Sutter,101,95872,41,34,0,34,2
2020-05-14,Tehama,103,63373,3,1,0,1,1
2020-05-14,Trinity,105,12862,2,1,0,1,0
2020-05-14,Tulare,107,460477,1912,1317,7,1324,55
2020-05-14,Tuolumne,109,53932,3,2,0,2,0
2020-05-14,Ventura,111,848112,1151,760,5,765,25
2020-05-14,Yolo,113,214977,201,180,0,180,22
2020-05-14,Yuba,115,75493,26,21,0,21,1
2020-05-13,Alameda,001,1643700,2656,2181,3,2184,78
2020-05-13,Alpine,003,1148,1,1,0,1,0
2020-05-13,Amador,005,37829,10,8,0,8,0
2020-05-13,Butte,007,227075,40,21,1,22,0
2020-05-13,Calaveras,009,45235,14,13,0,13,0
2020-05-13,Colusa,011,21464,3,3,0,3,0
2020-05-13,Contra Costa,013,1133247,1244,1082,1,1083,32
2020-05-13,Del Norte,015,27424,13,4,0,4,0
2020-05-13,El Dorado,017,186661,79,58,0,58,0
2020-05-13,Fresno,019,978130,2011,993,29,1022,10
2020-05-13,Glenn,021,27897,11,6,0,6,0
2020-05-13,Humboldt,023,135768,83,58,0,58,0
2020-05-13,Imperial,025,180216,1411,610,0,610,11
2020-05-13,Inyo,027,18085,19,20,0,20,1
2020-05-13,Kern,029,883053,1795,1390,3,1393,19
2020-05-13,Kings,031,150075,461,314,2,316,1
2020-05-13,Lake,033,64148,13,7,0,7,0
2020-05-13,Lassen,035,31185,4,0,2,2,0
2020-05-13,Los Angeles,037,10098052,43078,34574,20,34594,1643
2020-05-13,Madera,039,155013,144,69,1,70,2
2020-05-13,Marin,041,260295,307,278,1,279,14
2020-05-13,Mariposa,043,17540,15,15,0,15,0
2020-05-13,Mendocino,045,87422,13,10,0,10,0
2020-05-13,Merced,047,269075,287,176,0,176,3
2020-05-13,Modoc,049,8938,0,0,0,0,0
2020-05-13,Mono,051,14174,35,31,0,31,1
2020-05-13,Monterey,053,433212,383,309,1,310,6
2020-05-13,Napa,055,140530,103,81,0,81,3
2020-05-13,Nevada,057,99092,41,41,1,42,1
2020-05-13,Orange,059,3164182,5923,4025,48,4073,79
2020-05-13,Placer,061,380077,192,170,0,170,8
2020-05-13,Plumas,063,18699,4,4,0,4,0
2020-05-13,Riverside,065,2383286,6352,5204,18,5222,216
2020-05-13,Sacramento,067,1510023,1259,1173,0,1173,53
2020-05-13,San Benito,069,59416,61,55,0,55,2
2020-05-13,San Bernardino,071,2135413,3943,3064,3,3067,140
2020-05-13,San Diego,073,3302833,6351,5280,0,5280,194
2020-05-13,San Francisco,075,870044,2244,2004,0,2004,35
2020-05-13,San Joaquin,077,732212,733,639,3,642,31
2020-05-13,San Luis Obispo,079,281455,313,231,3,234,1
2020-05-13,San Mateo,081,765935,1841,1550,3,1553,66
2020-05-13,Santa Barbara,083,443738,1533,1382,9,1391,10
2020-05-13,Santa Clara,085,1922200,2983,2370,10,2380,132
2020-05-13,Santa Cruz,087,273765,167,142,0,142,2
2020-05-13,Shasta,089,179085,48,32,0,32,4
2020-05-13,Sierra,091,2930,0,0,0,0,0
2020-05-13,Siskiyou,093,43540,6,5,0,5,0
2020-05-13,Solano,095,438530,452,368,0,368,4
2020-05-13,Sonoma,097,501317,410,330,0,330,4
2020-05-13,Stanislaus,099,539301,603,521,4,525,15
2020-05-13,Sutter,101,95872,41,33,0,33,2
2020-05-13,Tehama,103,63373,3,1,0,1,1
2020-05-13,Trinity,105,12862,2,2,0,2,0
2020-05-13,Tulare,107,460477,1879,1283,7,1290,54
2020-05-13,Tuolumne,109,53932,3,2,0,2,0
2020-05-13,Ventura,111,848112,1120,742,5,747,25
2020-05-13,Yolo,113,214977,199,178,0,178,22
2020-05-13,Yuba,115,75493,24,19,0,19,1
2020-05-12,Alameda,001,1643700,2592,2146,3,2149,74
2020-05-12,Alpine,003,1148,1,1,0,1,0
2020-05-12,Amador,005,37829,10,8,0,8,0
2020-05-12,Butte,007,227075,38,20,1,21,0
2020-05-12,Calaveras,009,45235,13,13,0,13,0
2020-05-12,Colusa,011,21464,3,3,0,3,0
2020-05-12,Contra Costa,013,1133247,1213,1067,1,1068,32
2020-05-12,Del Norte,015,27424,10,3,0,3,0
2020-05-12,El Dorado,017,186661,76,56,0,56,0
2020-05-12,Fresno,019,978130,1927,978,27,1005,9
2020-05-12,Glenn,021,27897,10,6,0,6,0
2020-05-12,Humboldt,023,135768,80,58,0,58,0
2020-05-12,Imperial,025,180216,1280,602,0,602,9
2020-05-12,Inyo,027,18085,19,20,0,20,1
2020-05-12,Kern,029,883053,1754,1363,3,1366,18
2020-05-12,Kings,031,150075,440,302,2,304,1
2020-05-12,Lake,033,64148,13,7,0,7,0
2020-05-12,Lassen,035,31185,4,0,2,2,0
2020-05-12,Los Angeles,037,10098052,42081,33281,19,33300,1601
2020-05-12,Madera,039,155013,138,69,1,70,2
2020-05-12,Marin,041,260295,302,274,1,275,14
2020-05-12,Mariposa,043,17540,15,15,0,15,0
2020-05-12,Mendocino,045,87422,13,10,0,10,0
2020-05-12,Merced,047,269075,276,175,0,175,3
2020-05-12,Modoc,049,8938,0,0,0,0,0
2020-05-12,Mono,051,14174,35,31,0,31,1
2020-05-12,Monterey,053,433212,376,298,1,299,6
2020-05-12,Napa,055,140530,101,80,0,80,3
2020-05-12,Nevada,057,99092,41,41,1,42,1
2020-05-12,Orange,059,3164182,5740,3843,46,3889,78
2020-05-12,Placer,061,380077,191,170,0,170,8
2020-05-12,Plumas,063,18699,4,4,0,4,0
2020-05-12,Riverside,065,2383286,6229,5134,18,5152,210
2020-05-12,Sacramento,067,1510023,1239,1166,0,1166,52
2020-05-12,San Benito,069,59416,61,55,0,55,2
2020-05-12,San Bernardino,071,2135413,3791,2997,3,3000,131
2020-05-12,San Diego,073,3302833,6207,3,0,3,0
2020-05-12,San Francisco,075,870044,2209,1981,0,1981,35
2020-05-12,San Joaquin,077,732212,718,625,3,628,30
2020-05-12,San Luis Obispo,079,281455,310,226,3,229,1
2020-05-12,San Mateo,081,765935,1815,1533,3,1536,66
2020-05-12,Santa Barbara,083,443738,1502,1377,9,1386,10
2020-05-12,Santa Clara,085,1922200,2953,2362,10,2372,131
2020-05-12,Santa Cruz,087,273765,165,141,0,141,2
2020-05-12,Shasta,089,179085,47,33,0,33,4
2020-05-12,Sierra,091,2930,0,0,0,0,0
2020-05-12,Siskiyou,093,43540,6,5,0,5,0
2020-05-12,Solano,095,438530,444,361,0,361,4
2020-05-12,Sonoma,097,501317,387,308,0,308,4
2020-05-12,Stanislaus,099,539301,596,515,4,519,15
2020-05-12,Sutter,101,95872,41,33,0,33,2
2020-05-12,Tehama,103,63373,3,1,0,1,1
2020-05-12,Trinity,105,12862,2,1,0,1,0
2020-05-12,Tulare,107,460477,1847,1261,7,1268,52
2020-05-12,Tuolumne,109,53932,3,2,0,2,0
2020-05-12,Ventura,111,848112,1064,718,5,723,20
2020-05-12,Yolo,113,214977,198,176,0,176,22
2020-05-12,Yuba,115,75493,24,19,0,19,1
2020-05-11,Alameda,001,1643700,2542,2103,3,2106,71
2020-05-11,Alpine,003,1148,1,1,0,1,0
2020-05-11,Amador,005,37829,10,8,0,8,0
2020-05-11,Butte,007,227075,37,19,1,20,0
2020-05-11,Calaveras,009,45235,13,13,0,13,0
2020-05-11,Colusa,011,21464,3,3,0,3,0
2020-05-11,Contra Costa,013,1133247,1199,1052,1,1053,32
2020-05-11,Del Norte,015,27424,8,3,0,3,0
2020-05-11,El Dorado,017,186661,76,55,0,55,0
2020-05-11,Fresno,019,978130,1835,937,26,963,8
2020-05-11,Glenn,021,27897,10,6,0,6,0
2020-05-11,Humboldt,023,135768,77,56,0,56,0
2020-05-11,Imperial,025,180216,1174,562,0,562,9
2020-05-11,Inyo,027,18085,19,20,0,20,1
2020-05-11,Kern,029,883053,1702,1331,3,1334,17
2020-05-11,Kings,031,150075,417,289,1,290,1
2020-05-11,Lake,033,64148,12,7,0,7,0
2020-05-11,Lassen,035,31185,4,0,2,2,0
2020-05-11,Los Angeles,037,10098052,40902,32279,19,32298,1553
2020-05-11,Madera,039,155013,129,68,1,69,2
2020-05-11,Marin,041,260295,293,271,1,272,14
2020-05-11,Mariposa,043,17540,15,15,0,15,0
2020-05-11,Mendocino,045,87422,13,10,0,10,0
2020-05-11,Merced,047,269075,261,158,0,158,3
2020-05-11,Modoc,049,8938,0,0,0,0,0
2020-05-11,Mono,051,14174,35,30,0,30,1
2020-05-11,Monterey,053,433212,373,286,1,287,6
2020-05-11,Napa,055,140530,95,79,0,79,2
2020-05-11,Nevada,057,99092,41,41,1,42,1
2020-05-11,Orange,059,3164182,5526,3699,39,3738,77
2020-05-11,Placer,061,380077,191,170,0,170,8
2020-05-11,Plumas,063,18699,4,4,0,4,0
2020-05-11,Riverside,065,2383286,6071,5082,17,5099,203
2020-05-11,Sacramento,067,1510023,1224,1160,0,1160,52
2020-05-11,San Benito,069,59416,59,52,0,52,2
2020-05-11,San Bernardino,071,2135413,3680,2945,3,2948,124
2020-05-11,San Diego,073,3302833,6054,5067,0,5067,175
2020-05-11,San Francisco,075,870044,2162,1974,0,1974,35
2020-05-11,San Joaquin,077,732212,708,620,3,623,30
2020-05-11,San Luis Obispo,079,281455,308,224,3,227,1
2020-05-11,San Mateo,081,765935,1789,1499,2,1501,66
2020-05-11,Santa Barbara,083,443738,1491,1372,8,1380,10
2020-05-11,Santa Clara,085,1922200,2936,2340,10,2350,129
2020-05-11,Santa Cruz,087,273765,162,140,0,140,2
2020-05-11,Shasta,089,179085,47,31,0,31,4
2020-05-11,Sierra,091,2930,0,0,0,0,0
2020-05-11,Siskiyou,093,43540,6,5,0,5,0
2020-05-11,Solano,095,438530,439,354,0,354,4
2020-05-11,Sonoma,097,501317,377,303,0,303,3
2020-05-11,Stanislaus,099,539301,586,507,4,511,14
2020-05-11,Sutter,101,95872,40,32,0,32,2
2020-05-11,Tehama,103,63373,3,1,0,1,1
2020-05-11,Trinity,105,12862,2,1,0,1,0
2020-05-11,Tulare,107,460477,1798,1203,7,1210,49
2020-05-11,Tuolumne,109,53932,3,2,0,2,0
2020-05-11,Ventura,111,848112,1003,698,4,702,19
2020-05-11,Yolo,113,214977,198,174,0,174,20
2020-05-11,Yuba,115,75493,24,18,0,18,1
2020-05-10,Alameda,001,1643700,2465,2047,3,2050,71
2020-05-10,Alpine,003,1148,1,1,0,1,0
2020-05-10,Amador,005,37829,10,8,0,8,0
2020-05-10,Butte,007,227075,32,18,1,19,0
2020-05-10,Calaveras,009,45235,13,13,0,13,0
2020-05-10,Colusa,011,21464,3,3,0,3,0
2020-05-10,Contra Costa,013,1133247,1185,1046,0,1046,31
2020-05-10,Del Norte,015,27424,7,3,0,3,0
2020-05-10,El Dorado,017,186661,76,55,0,55,0
2020-05-10,Fresno,019,978130,1750,894,26,920,8
2020-05-10,Glenn,021,27897,10,6,0,6,0
2020-05-10,Humboldt,023,135768,73,56,0,56,0
2020-05-10,Imperial,025,180216,1079,509,0,509,7
2020-05-10,Inyo,027,18085,19,20,0,20,1
2020-05-10,Kern,029,883053,1651,1300,2,1302,16
2020-05-10,Kings,031,150075,404,266,1,267,1
2020-05-10,Lake,033,64148,12,7,0,7,0
2020-05-10,Lassen,035,31185,4,0,2,2,0
2020-05-10,Los Angeles,037,10098052,39642,31711,19,31730,1514
2020-05-10,Madera,039,155013,127,65,1,66,2
2020-05-10,Marin,041,260295,285,267,1,268,14
2020-05-10,Mariposa,043,17540,15,15,0,15,0
2020-05-10,Mendocino,045,87422,12,10,0,10,0
2020-05-10,Merced,047,269075,246,154,0,154,3
2020-05-10,Modoc,049,8938,0,0,0,0,0
2020-05-10,Mono,051,14174,35,27,0,27,1
2020-05-10,Monterey,053,433212,359,282,1,283,6
2020-05-10,Napa,055,140530,89,79,0,79,2
2020-05-10,Nevada,057,99092,41,41,1,42,1
2020-05-10,Orange,059,3164182,5383,3627,39,3666,76
2020-05-10,Placer,061,380077,190,168,0,168,8
2020-05-10,Plumas,063,18699,4,4,0,4,0
2020-05-10,Riverside,065,2383286,5949,4951,17,4968,193
2020-05-10,Sacramento,067,1510023,1208,1152,0,1152,52
2020-05-10,San Benito,069,59416,59,52,0,52,2
2020-05-10,San Bernardino,071,2135413,3582,2910,3,2913,121
2020-05-10,San Diego,073,3302833,5902,4928,0,4928,175
2020-05-10,San Francisco,075,870044,2144,1953,0,1953,35
2020-05-10,San Joaquin,077,732212,693,611,3,614,29
2020-05-10,San Luis Obispo,079,281455,305,218,3,221,1
2020-05-10,San Mateo,081,765935,1767,1463,2,1465,65
2020-05-10,Santa Barbara,083,443738,1480,1323,8,1331,10
2020-05-10,Santa Clara,085,1922200,2909,2331,10,2341,129
2020-05-10,Santa Cruz,087,273765,161,139,0,139,2
2020-05-10,Shasta,089,179085,47,31,0,31,4
2020-05-10,Sierra,091,2930,0,0,0,0,0
2020-05-10,Siskiyou,093,43540,5,5,0,5,0
2020-05-10,Solano,095,438530,429,322,0,322,4
2020-05-10,Sonoma,097,501317,367,290,0,290,3
2020-05-10,Stanislaus,099,539301,579,498,4,502,14
2020-05-10,Sutter,101,95872,37,31,0,31,2
2020-05-10,Tehama,103,63373,3,1,0,1,1
2020-05-10,Trinity,105,12862,2,1,0,1,0
2020-05-10,Tulare,107,460477,1727,1143,7,1150,47
2020-05-10,Tuolumne,109,53932,3,2,0,2,0
2020-05-10,Ventura,111,848112,945,690,2,692,19
2020-05-10,Yolo,113,214977,198,173,0,173,20
2020-05-10,Yuba,115,75493,23,17,0,17,1
2020-05-09,Alameda,001,1643700,2422,2011,3,2014,71
2020-05-09,Alpine,003,1148,1,1,0,1,0
2020-05-09,Amador,005,37829,9,8,0,8,0
2020-05-09,Butte,007,227075,31,18,1,19,0
2020-05-09,Calaveras,009,45235,13,13,0,13,0
2020-05-09,Colusa,011,21464,3,3,0,3,0
2020-05-09,Contra Costa,013,1133247,1171,1039,0,1039,31
2020-05-09,Del Norte,015,27424,7,3,0,3,0
2020-05-09,El Dorado,017,186661,73,54,0,54,0
2020-05-09,Fresno,019,978130,1712,861,25,886,8
2020-05-09,Glenn,021,27897,9,6,0,6,0
2020-05-09,Humboldt,023,135768,71,55,0,55,0
2020-05-09,Imperial,025,180216,1023,474,0,474,7
2020-05-09,Inyo,027,18085,19,20,0,20,1
2020-05-09,Kern,029,883053,1615,1262,1,1263,15
2020-05-09,Kings,031,150075,399,264,1,265,1
2020-05-09,Lake,033,64148,12,7,0,7,0
2020-05-09,Lassen,035,31185,4,0,2,2,0
2020-05-09,Los Angeles,037,10098052,39019,31268,19,31287,1499
2020-05-09,Madera,039,155013,126,61,1,62,2
2020-05-09,Marin,041,260295,284,261,1,262,14
2020-05-09,Mariposa,043,17540,15,15,0,15,0
2020-05-09,Mendocino,045,87422,12,10,0,10,0
2020-05-09,Merced,047,269075,242,153,0,153,3
2020-05-09,Modoc,049,8938,0,0,0,0,0
2020-05-09,Mono,051,14174,35,27,0,27,1
2020-05-09,Monterey,053,433212,352,273,0,273,6
2020-05-09,Napa,055,140530,88,78,0,78,2
2020-05-09,Nevada,057,99092,41,41,1,42,1
2020-05-09,Orange,059,3164182,5301,3506,38,3544,75
2020-05-09,Placer,061,380077,189,168,0,168,8
2020-05-09,Plumas,063,18699,4,4,0,4,0
2020-05-09,Riverside,065,2383286,5854,4871,17,4888,183
2020-05-09,Sacramento,067,1510023,1204,1150,0,1150,52
2020-05-09,San Benito,069,59416,58,52,0,52,2
2020-05-09,San Bernardino,071,2135413,3526,2825,3,2828,121
2020-05-09,San Diego,073,3302833,5790,4778,0,4778,175
2020-05-09,San Francisco,075,870044,2129,1944,0,1944,34
2020-05-09,San Joaquin,077,732212,684,605,3,608,28
2020-05-09,San Luis Obispo,079,281455,301,213,3,216,1
2020-05-09,San Mateo,081,765935,1748,1453,2,1455,65
2020-05-09,Santa Barbara,083,443738,1472,1245,8,1253,10
2020-05-09,Santa Clara,085,1922200,2895,2317,10,2327,128
2020-05-09,Santa Cruz,087,273765,160,138,0,138,2
2020-05-09,Shasta,089,179085,47,31,0,31,4
2020-05-09,Sierra,091,2930,0,0,0,0,0
2020-05-09,Siskiyou,093,43540,5,5,0,5,0
2020-05-09,Solano,095,438530,423,321,0,321,4
2020-05-09,Sonoma,097,501317,363,288,0,288,3
2020-05-09,Stanislaus,099,539301,571,491,4,495,12
2020-05-09,Sutter,101,95872,37,31,0,31,2
2020-05-09,Tehama,103,63373,2,1,0,1,1
2020-05-09,Trinity,105,12862,2,1,0,1,0
2020-05-09,Tulare,107,460477,1699,1083,7,1090,47
2020-05-09,Tuolumne,109,53932,3,2,0,2,0
2020-05-09,Ventura,111,848112,924,679,2,681,19
2020-05-09,Yolo,113,214977,198,172,0,172,18
2020-05-09,Yuba,115,75493,23,17,0,17,1
2020-05-08,Alameda,001,1643700,2379,1955,3,1958,70
2020-05-08,Alpine,003,1148,1,1,0,1,0
2020-05-08,Amador,005,37829,9,8,0,8,0
2020-05-08,Butte,007,227075,31,18,1,19,0
2020-05-08,Calaveras,009,45235,13,13,0,13,0
2020-05-08,Colusa,011,21464,3,3,0,3,0
2020-05-08,Contra Costa,013,1133247,1159,1024,0,1024,29
2020-05-08,Del Norte,015,27424,7,3,0,3,0
2020-05-08,El Dorado,017,186661,72,54,0,54,0
2020-05-08,Fresno,019,978130,1670,838,23,861,8
2020-05-08,Glenn,021,27897,8,6,0,6,0
2020-05-08,Humboldt,023,135768,68,54,0,54,0
2020-05-08,Imperial,025,180216,978,467,0,467,7
2020-05-08,Inyo,027,18085,19,20,0,20,1
2020-05-08,Kern,029,883053,1584,1214,1,1215,13
2020-05-08,Kings,031,150075,390,236,1,237,1
2020-05-08,Lake,033,64148,12,7,0,7,0
2020-05-08,Lassen,035,31185,4,0,2,2,0
2020-05-08,Los Angeles,037,10098052,38287,30357,19,30376,1447
2020-05-08,Madera,039,155013,123,57,1,58,2
2020-05-08,Marin,041,260295,284,257,1,258,14
2020-05-08,Mariposa,043,17540,15,15,0,15,0
2020-05-08,Mendocino,045,87422,12,10,0,10,0
2020-05-08,Merced,047,269075,241,151,0,151,3
2020-05-08,Modoc,049,8938,0,0,0,0,0
2020-05-08,Mono,051,14174,32,27,0,27,1
2020-05-08,Monterey,053,433212,344,265,0,265,6
2020-05-08,Napa,055,140530,87,78,0,78,2
2020-05-08,Nevada,057,99092,41,41,1,42,1
2020-05-08,Orange,059,3164182,5154,3395,38,3433,72
2020-05-08,Placer,061,380077,187,166,0,166,8
2020-05-08,Plumas,063,18699,4,4,0,4,0
2020-05-08,Riverside,065,2383286,5754,4672,16,4688,181
2020-05-08,Sacramento,067,1510023,1199,1145,0,1145,51
2020-05-08,San Benito,069,59416,58,51,0,51,2
2020-05-08,San Bernardino,071,2135413,3478,2631,3,2634,119
2020-05-08,San Diego,073,3302833,5683,4664,0,4664,169
2020-05-08,San Francisco,075,870044,2111,1890,0,1890,33
2020-05-08,San Joaquin,077,732212,677,595,3,598,28
2020-05-08,San Luis Obispo,079,281455,298,210,3,213,1
2020-05-08,San Mateo,081,765935,1663,1423,2,1425,62
2020-05-08,Santa Barbara,083,443738,1463,1054,6,1060,8
2020-05-08,Santa Clara,085,1922200,2872,2285,10,2295,128
2020-05-08,Santa Cruz,087,273765,156,137,0,137,2
2020-05-08,Shasta,089,179085,47,31,0,31,4
2020-05-08,Sierra,091,2930,0,0,0,0,0
2020-05-08,Siskiyou,093,43540,5,5,0,5,0
2020-05-08,Solano,095,438530,418,314,0,314,4
2020-05-08,Sonoma,097,501317,358,285,0,285,3
2020-05-08,Stanislaus,099,539301,557,487,4,491,12
2020-05-08,Sutter,101,95872,37,30,0,30,2
2020-05-08,Tehama,103,63373,2,1,0,1,1
2020-05-08,Trinity,105,12862,2,0,0,0,0
2020-05-08,Tulare,107,460477,1654,1050,6,1056,43
2020-05-08,Tuolumne,109,53932,3,2,0,2,0
2020-05-08,Ventura,111,848112,906,665,2,667,19
2020-05-08,Yolo,113,214977,197,172,0,172,18
2020-05-08,Yuba,115,75493,22,16,0,16,1
2020-05-07,Alameda,001,1643700,2319,1914,3,1917,68
2020-05-07,Alpine,003,1148,1,1,0,1,0
2020-05-07,Amador,005,37829,9,8,0,8,0
2020-05-07,Butte,007,227075,31,19,1,20,0
2020-05-07,Calaveras,009,45235,13,13,0,13,0
2020-05-07,Colusa,011,21464,3,3,0,3,0
2020-05-07,Contra Costa,013,1133247,1145,1005,0,1005,29
2020-05-07,Del Norte,015,27424,6,3,0,3,0
2020-05-07,El Dorado,017,186661,71,54,0,54,0
2020-05-07,Fresno,019,978130,1584,812,22,834,8
2020-05-07,Glenn,021,27897,8,5,0,5,0
2020-05-07,Humboldt,023,135768,67,54,0,54,0
2020-05-07,Imperial,025,180216,915,442,0,442,6
2020-05-07,Inyo,027,18085,19,20,0,20,1
2020-05-07,Kern,029,883053,1540,1176,1,1177,13
2020-05-07,Kings,031,150075,367,219,1,220,1
2020-05-07,Lake,033,64148,11,7,0,7,0
2020-05-07,Lassen,035,31185,4,0,2,2,0
2020-05-07,Los Angeles,037,10098052,37166,29544,19,29563,1399
2020-05-07,Madera,039,155013,119,54,1,55,2
2020-05-07,Marin,041,260295,277,252,1,253,14
2020-05-07,Mariposa,043,17540,15,15,0,15,0
2020-05-07,Mendocino,045,87422,12,10,0,10,0
2020-05-07,Merced,047,269075,233,146,0,146,3
2020-05-07,Modoc,049,8938,0,0,0,0,0
2020-05-07,Mono,051,14174,32,26,0,26,1
2020-05-07,Monterey,053,433212,336,249,0,249,6
2020-05-07,Napa,055,140530,87,78,0,78,2
2020-05-07,Nevada,057,99092,41,41,1,42,1
2020-05-07,Orange,059,3164182,4969,3283,37,3320,69
2020-05-07,Placer,061,380077,187,165,0,165,8
2020-05-07,Plumas,063,18699,4,4,0,4,0
2020-05-07,Riverside,065,2383286,5638,4608,16,4624,170
2020-05-07,Sacramento,067,1510023,1193,1139,0,1139,50
2020-05-07,San Benito,069,59416,58,50,0,50,2
2020-05-07,San Bernardino,071,2135413,3386,2522,3,2525,115
2020-05-07,San Diego,073,3302833,5526,4431,0,4431,165
2020-05-07,San Francisco,075,870044,2080,1852,0,1852,33
2020-05-07,San Joaquin,077,732212,664,583,3,586,28
2020-05-07,San Luis Obispo,079,281455,287,209,3,212,1
2020-05-07,San Mateo,081,765935,1641,1398,2,1400,58
2020-05-07,Santa Barbara,083,443738,1436,720,5,725,8
2020-05-07,Santa Clara,085,1922200,2834,2281,10,2291,127
2020-05-07,Santa Cruz,087,273765,153,136,0,136,2
2020-05-07,Shasta,089,179085,46,31,0,31,4
2020-05-07,Sierra,091,2930,0,0,0,0,0
2020-05-07,Siskiyou,093,43540,5,5,0,5,0
2020-05-07,Solano,095,438530,412,307,0,307,4
2020-05-07,Sonoma,097,501317,346,282,0,282,3
2020-05-07,Stanislaus,099,539301,548,466,4,470,10
2020-05-07,Sutter,101,95872,37,29,0,29,2
2020-05-07,Tehama,103,63373,2,1,0,1,1
2020-05-07,Trinity,105,12862,2,0,0,0,0
2020-05-07,Tulare,107,460477,1586,1001,6,1007,41
2020-05-07,Tuolumne,109,53932,3,2,0,2,0
2020-05-07,Ventura,111,848112,882,647,1,648,19
2020-05-07,Yolo,113,214977,196,172,0,172,18
2020-05-07,Yuba,115,75493,22,16,0,16,1
2020-05-06,Alameda,001,1643700,2281,1864,3,1867,67
2020-05-06,Alpine,003,1148,1,1,0,1,0
2020-05-06,Amador,005,37829,9,8,0,8,0
2020-05-06,Butte,007,227075,30,19,1,20,0
2020-05-06,Calaveras,009,45235,13,13,0,13,0
2020-05-06,Colusa,011,21464,3,3,0,3,0
2020-05-06,Contra Costa,013,1133247,1124,990,0,990,29
2020-05-06,Del Norte,015,27424,6,3,0,3,0
2020-05-06,El Dorado,017,186661,69,53,0,53,0
2020-05-06,Fresno,019,978130,1521,773,20,793,8
2020-05-06,Glenn,021,27897,8,3,0,3,0
2020-05-06,Humboldt,023,135768,66,54,0,54,0
2020-05-06,Imperial,025,180216,847,399,0,399,6
2020-05-06,Inyo,027,18085,19,20,0,20,1
2020-05-06,Kern,029,883053,1484,1112,1,1113,12
2020-05-06,Kings,031,150075,349,208,1,209,1
2020-05-06,Lake,033,64148,11,7,0,7,0
2020-05-06,Lassen,035,31185,4,0,2,2,0
2020-05-06,Los Angeles,037,10098052,36161,28687,19,28706,1347
2020-05-06,Madera,039,155013,117,55,1,56,2
2020-05-06,Marin,041,260295,270,244,1,245,14
2020-05-06,Mariposa,043,17540,15,14,0,14,0
2020-05-06,Mendocino,045,87422,12,10,0,10,0
2020-05-06,Merced,047,269075,226,140,0,140,3
2020-05-06,Modoc,049,8938,0,0,0,0,0
2020-05-06,Mono,051,14174,32,26,0,26,1
2020-05-06,Monterey,053,433212,328,246,0,246,6
2020-05-06,Napa,055,140530,86,78,0,78,2
2020-05-06,Nevada,057,99092,41,41,1,42,1
2020-05-06,Orange,059,3164182,4785,3156,36,3192,66
2020-05-06,Placer,061,380077,184,164,0,164,8
2020-05-06,Plumas,063,18699,4,4,0,4,0
2020-05-06,Riverside,065,2383286,5494,4535,16,4551,163
2020-05-06,Sacramento,067,1510023,1187,1135,0,1135,49
2020-05-06,San Benito,069,59416,57,50,0,50,2
2020-05-06,San Bernardino,071,2135413,3264,2426,2,2428,110
2020-05-06,San Diego,073,3302833,5393,4321,0,4321,158
2020-05-06,San Francisco,075,870044,2055,1804,0,1804,32
2020-05-06,San Joaquin,077,732212,651,581,3,584,28
2020-05-06,San Luis Obispo,079,281455,284,207,3,210,1
2020-05-06,San Mateo,081,765935,1610,1348,2,1350,57
2020-05-06,Santa Barbara,083,443738,1395,565,4,569,8
2020-05-06,Santa Clara,085,1922200,2817,2270,9,2279,127
2020-05-06,Santa Cruz,087,273765,149,135,0,135,2
2020-05-06,Shasta,089,179085,45,31,0,31,4
2020-05-06,Sierra,091,2930,0,0,0,0,0
2020-05-06,Siskiyou,093,43540,5,5,0,5,0
2020-05-06,Solano,095,438530,402,300,0,300,4
2020-05-06,Sonoma,097,501317,330,269,0,269,3
2020-05-06,Stanislaus,099,539301,532,434,4,438,9
2020-05-06,Sutter,101,95872,37,29,0,29,2
2020-05-06,Tehama,103,63373,2,1,0,1,1
2020-05-06,Trinity,105,12862,2,0,0,0,0
2020-05-06,Tulare,107,460477,1538,963,6,969,40
2020-05-06,Tuolumne,109,53932,3,2,0,2,0
2020-05-06,Ventura,111,848112,855,619,1,620,19
2020-05-06,Yolo,113,214977,195,172,0,172,18
2020-05-06,Yuba,115,75493,22,15,0,15,1
2020-05-05,Alameda,001,1643700,2238,1819,3,1822,67
2020-05-05,Alpine,003,1148,1,1,0,1,0
2020-05-05,Amador,005,37829,9,8,0,8,0
2020-05-05,Butte,007,227075,29,19,1,20,0
2020-05-05,Calaveras,009,45235,13,13,0,13,0
2020-05-05,Colusa,011,21464,3,3,0,3,0
2020-05-05,Contra Costa,013,1133247,1106,976,0,976,29
2020-05-05,Del Norte,015,27424,6,3,0,3,0
2020-05-05,El Dorado,017,186661,67,54,0,54,0
2020-05-05,Fresno,019,978130,1448,726,18,744,8
2020-05-05,Glenn,021,27897,8,3,0,3,0
2020-05-05,Humboldt,023,135768,63,54,0,54,0
2020-05-05,Imperial,025,180216,792,389,0,389,6
2020-05-05,Inyo,027,18085,19,20,0,20,1
2020-05-05,Kern,029,883053,1432,1084,1,1085,11
2020-05-05,Kings,031,150075,331,187,1,188,1
2020-05-05,Lake,033,64148,10,7,0,7,0
2020-05-05,Lassen,035,31185,4,0,2,2,0
2020-05-05,Los Angeles,037,10098052,35089,27867,19,27886,1289
2020-05-05,Madera,039,155013,113,53,1,54,2
2020-05-05,Marin,041,260295,264,244,1,245,14
2020-05-05,Mariposa,043,17540,15,14,0,14,0
2020-05-05,Mendocino,045,87422,12,10,0,10,0
2020-05-05,Merced,047,269075,221,141,0,141,3
2020-05-05,Modoc,049,8938,0,0,0,0,0
2020-05-05,Mono,051,14174,32,25,0,25,1
2020-05-05,Monterey,053,433212,314,240,0,240,6
2020-05-05,Napa,055,140530,86,74,0,74,2
2020-05-05,Nevada,057,99092,41,41,1,42,1
2020-05-05,Orange,059,3164182,4661,3041,36,3077,63
2020-05-05,Placer,061,380077,184,162,0,162,8
2020-05-05,Plumas,063,18699,4,4,0,4,0
2020-05-05,Riverside,065,2383286,5384,4309,16,4325,161
2020-05-05,Sacramento,067,1510023,1180,1125,0,1125,48
2020-05-05,San Benito,069,59416,56,50,0,50,2
2020-05-05,San Bernardino,071,2135413,3171,2345,2,2347,104
2020-05-05,San Diego,073,3302833,5250,4162,0,4162,150
2020-05-05,San Francisco,075,870044,2020,1779,0,1779,31
2020-05-05,San Joaquin,077,732212,642,577,3,580,26
2020-05-05,San Luis Obispo,079,281455,282,203,3,206,1
2020-05-05,San Mateo,081,765935,1578,1335,2,1337,56
2020-05-05,Santa Barbara,083,443738,1174,541,4,545,7
2020-05-05,Santa Clara,085,1922200,2771,2249,8,2257,124
2020-05-05,Santa Cruz,087,273765,146,134,0,134,2
2020-05-05,Shasta,089,179085,44,31,0,31,4
2020-05-05,Sierra,091,2930,0,0,0,0,0
2020-05-05,Siskiyou,093,43540,5,5,0,5,0
2020-05-05,Solano,095,438530,386,299,0,299,4
2020-05-05,Sonoma,097,501317,327,263,0,263,3
2020-05-05,Stanislaus,099,539301,520,430,4,434,9
2020-05-05,Sutter,101,95872,36,29,0,29,2
2020-05-05,Tehama,103,63373,2,1,0,1,1
2020-05-05,Trinity,105,12862,2,0,0,0,0
2020-05-05,Tulare,107,460477,1440,869,6,875,40
2020-05-05,Tuolumne,109,53932,3,2,0,2,0
2020-05-05,Ventura,111,848112,831,607,1,608,19
2020-05-05,Yolo,113,214977,193,171,0,171,18
2020-05-05,Yuba,115,75493,22,15,0,15,1
2020-05-04,Alameda,001,1643700,2179,1762,3,1765,65
2020-05-04,Alpine,003,1148,1,1,0,1,0
2020-05-04,Amador,005,37829,8,8,0,8,0
2020-05-04,Butte,007,227075,28,16,1,17,0
2020-05-04,Calaveras,009,45235,13,13,0,13,0
2020-05-04,Colusa,011,21464,3,3,0,3,0
2020-05-04,Contra Costa,013,1133247,1088,949,0,949,28
2020-05-04,Del Norte,015,27424,5,3,0,3,0
2020-05-04,El Dorado,017,186661,66,51,0,51,0
2020-05-04,Fresno,019,978130,1378,680,17,697,8
2020-05-04,Glenn,021,27897,8,4,0,4,0
2020-05-04,Humboldt,023,135768,61,54,0,54,0
2020-05-04,Imperial,025,180216,740,351,0,351,6
2020-05-04,Inyo,027,18085,19,20,0,20,1
2020-05-04,Kern,029,883053,1390,1047,1,1048,8
2020-05-04,Kings,031,150075,314,153,1,154,1
2020-05-04,Lake,033,64148,9,7,0,7,0
2020-05-04,Lassen,035,31185,3,0,2,2,0
2020-05-04,Los Angeles,037,10098052,33789,26243,17,26260,1235
2020-05-04,Madera,039,155013,110,52,1,53,2
2020-05-04,Marin,041,260295,259,244,1,245,13
2020-05-04,Mariposa,043,17540,15,13,0,13,0
2020-05-04,Mendocino,045,87422,12,10,0,10,0
2020-05-04,Merced,047,269075,221,138,0,138,3
2020-05-04,Modoc,049,8938,0,0,0,0,0
2020-05-04,Mono,051,14174,32,25,0,25,1
2020-05-04,Monterey,053,433212,303,237,0,237,6
2020-05-04,Napa,055,140530,86,72,0,72,2
2020-05-04,Nevada,057,99092,41,41,1,42,1
2020-05-04,Orange,059,3164182,4523,2931,33,2964,57
2020-05-04,Placer,061,380077,182,162,0,162,8
2020-05-04,Plumas,063,18699,4,4,0,4,0
2020-05-04,Riverside,065,2383286,5290,4221,16,4237,147
2020-05-04,Sacramento,067,1510023,1170,1119,0,1119,44
2020-05-04,San Benito,069,59416,54,49,0,49,2
2020-05-04,San Bernardino,071,2135413,3031,2184,2,2186,99
2020-05-04,San Diego,073,3302833,5109,4022,0,4022,144
2020-05-04,San Francisco,075,870044,1982,1760,0,1760,31
2020-05-04,San Joaquin,077,732212,628,574,3,577,26
2020-05-04,San Luis Obispo,079,281455,279,202,3,205,1
2020-05-04,San Mateo,081,765935,1553,1313,2,1315,53
2020-05-04,Santa Barbara,083,443738,927,524,4,528,7
2020-05-04,Santa Clara,085,1922200,2756,2238,8,2246,119
2020-05-04,Santa Cruz,087,273765,145,133,0,133,2
2020-05-04,Shasta,089,179085,42,31,0,31,4
2020-05-04,Sierra,091,2930,0,0,0,0,0
2020-05-04,Siskiyou,093,43540,5,5,0,5,0
2020-05-04,Solano,095,438530,372,293,0,293,4
2020-05-04,Sonoma,097,501317,313,256,0,256,4
2020-05-04,Stanislaus,099,539301,514,422,4,426,8
2020-05-04,Sutter,101,95872,33,28,0,28,2
2020-05-04,Tehama,103,63373,2,1,0,1,1
2020-05-04,Trinity,105,12862,1,0,0,0,0
2020-05-04,Tulare,107,460477,1361,760,6,766,40
2020-05-04,Tuolumne,109,53932,3,3,0,3,0
2020-05-04,Ventura,111,848112,810,590,1,591,19
2020-05-04,Yolo,113,214977,192,171,0,171,18
2020-05-04,Yuba,115,75493,19,16,0,16,1
2020-05-03,Alameda,001,1643700,2122,1731,3,1734,64
2020-05-03,Alpine,003,1148,1,1,0,1,0
2020-05-03,Amador,005,37829,8,8,0,8,0
2020-05-03,Butte,007,227075,28,17,1,18,0
2020-05-03,Calaveras,009,45235,13,13,0,13,0
2020-05-03,Colusa,011,21464,3,3,0,3,0
2020-05-03,Contra Costa,013,1133247,1072,945,0,945,28
2020-05-03,Del Norte,015,27424,5,3,0,3,0
2020-05-03,El Dorado,017,186661,64,49,0,49,0
2020-05-03,Fresno,019,978130,1286,646,15,661,8
2020-05-03,Glenn,021,27897,7,5,0,5,0
2020-05-03,Humboldt,023,135768,60,54,0,54,0
2020-05-03,Imperial,025,180216,684,351,0,351,6
2020-05-03,Inyo,027,18085,19,20,0,20,1
2020-05-03,Kern,029,883053,1335,1025,1,1026,8
2020-05-03,Kings,031,150075,294,137,1,138,1
2020-05-03,Lake,033,64148,9,7,0,7,0
2020-05-03,Lassen,035,31185,3,0,2,2,0
2020-05-03,Los Angeles,037,10098052,32804,25708,17,25725,1210
2020-05-03,Madera,039,155013,103,46,1,47,2
2020-05-03,Marin,041,260295,254,243,1,244,13
2020-05-03,Mariposa,043,17540,15,13,0,13,0
2020-05-03,Mendocino,045,87422,12,10,0,10,0
2020-05-03,Merced,047,269075,213,134,0,134,3
2020-05-03,Modoc,049,8938,0,0,0,0,0
2020-05-03,Mono,051,14174,32,25,0,25,1
2020-05-03,Monterey,053,433212,294,235,0,235,6
2020-05-03,Napa,055,140530,86,72,0,72,2
2020-05-03,Nevada,057,99092,41,41,1,42,1
2020-05-03,Orange,059,3164182,4349,2859,32,2891,55
2020-05-03,Placer,061,380077,182,161,0,161,8
2020-05-03,Plumas,063,18699,4,4,0,4,0
2020-05-03,Riverside,065,2383286,5185,4034,16,4050,139
2020-05-03,Sacramento,067,1510023,1161,1109,0,1109,43
2020-05-03,San Benito,069,59416,54,49,0,49,2
2020-05-03,San Bernardino,071,2135413,2970,2123,2,2125,99
2020-05-03,San Diego,073,3302833,4972,3929,0,3929,142
2020-05-03,San Francisco,075,870044,1953,1692,0,1692,30
2020-05-03,San Joaquin,077,732212,621,570,3,573,26
2020-05-03,San Luis Obispo,079,281455,276,200,3,203,1
2020-05-03,San Mateo,081,765935,1525,1277,2,1279,53
2020-05-03,Santa Barbara,083,443738,568,512,4,516,7
2020-05-03,Santa Clara,085,1922200,2719,2235,8,2243,116
2020-05-03,Santa Cruz,087,273765,145,133,0,133,2
2020-05-03,Shasta,089,179085,40,31,0,31,4
2020-05-03,Sierra,091,2930,0,0,0,0,0
2020-05-03,Siskiyou,093,43540,5,5,0,5,0
2020-05-03,Solano,095,438530,362,266,0,266,4
2020-05-03,Sonoma,097,501317,304,254,0,254,4
2020-05-03,Stanislaus,099,539301,486,411,4,415,8
2020-05-03,Sutter,101,95872,31,28,0,28,2
2020-05-03,Tehama,103,63373,2,1,0,1,1
2020-05-03,Trinity,105,12862,1,0,0,0,0
2020-05-03,Tulare,107,460477,1282,736,6,742,40
2020-05-03,Tuolumne,109,53932,3,3,0,3,0
2020-05-03,Ventura,111,848112,776,583,1,584,19
2020-05-03,Yolo,113,214977,191,171,0,171,18
2020-05-03,Yuba,115,75493,19,16,0,16,1
2020-05-02,Alameda,001,1643700,2085,1678,3,1681,63
2020-05-02,Alpine,003,1148,1,1,0,1,0
2020-05-02,Amador,005,37829,8,8,0,8,0
2020-05-02,Butte,007,227075,28,17,1,18,0
2020-05-02,Calaveras,009,45235,13,13,0,13,0
2020-05-02,Colusa,011,21464,3,3,0,3,0
2020-05-02,Contra Costa,013,1133247,1054,929,0,929,28
2020-05-02,Del Norte,015,27424,5,3,0,3,0
2020-05-02,El Dorado,017,186661,64,47,0,47,0
2020-05-02,Fresno,019,978130,1260,629,14,643,8
2020-05-02,Glenn,021,27897,7,5,0,5,0
2020-05-02,Humboldt,023,135768,60,54,0,54,0
2020-05-02,Imperial,025,180216,657,345,0,345,6
2020-05-02,Inyo,027,18085,19,20,0,20,1
2020-05-02,Kern,029,883053,1309,1007,1,1008,8
2020-05-02,Kings,031,150075,291,120,1,121,1
2020-05-02,Lake,033,64148,9,7,0,7,0
2020-05-02,Lassen,035,31185,3,0,2,2,0
2020-05-02,Los Angeles,037,10098052,32274,24955,17,24972,1192
2020-05-02,Madera,039,155013,103,46,1,47,2
2020-05-02,Marin,041,260295,253,243,1,244,13
2020-05-02,Mariposa,043,17540,15,13,0,13,0
2020-05-02,Mendocino,045,87422,12,10,0,10,0
2020-05-02,Merced,047,269075,210,131,0,131,3
2020-05-02,Modoc,049,8938,0,0,0,0,0
2020-05-02,Mono,051,14174,32,25,0,25,1
2020-05-02,Monterey,053,433212,288,225,0,225,5
2020-05-02,Napa,055,140530,86,71,0,71,2
2020-05-02,Nevada,057,99092,41,41,1,42,1
2020-05-02,Orange,059,3164182,4235,2774,32,2806,52
2020-05-02,Placer,061,380077,180,150,0,150,8
2020-05-02,Plumas,063,18699,4,4,0,4,0
2020-05-02,Riverside,065,2383286,5119,3997,16,4013,137
2020-05-02,Sacramento,067,1510023,1158,1097,0,1097,43
2020-05-02,San Benito,069,59416,54,49,0,49,2
2020-05-02,San Bernardino,071,2135413,2931,2124,2,2126,99
2020-05-02,San Diego,073,3302833,4870,3844,0,3844,138
2020-05-02,San Francisco,075,870044,1930,1632,0,1632,29
2020-05-02,San Joaquin,077,732212,613,559,3,562,25
2020-05-02,San Luis Obispo,079,281455,270,193,3,196,1
2020-05-02,San Mateo,081,765935,1509,1272,2,1274,52
2020-05-02,Santa Barbara,083,443738,560,506,4,510,7
2020-05-02,Santa Clara,085,1922200,2709,2203,8,2211,115
2020-05-02,Santa Cruz,087,273765,144,131,0,131,2
2020-05-02,Shasta,089,179085,40,31,0,31,4
2020-05-02,Sierra,091,2930,0,0,0,0,0
2020-05-02,Siskiyou,093,43540,5,5,0,5,0
2020-05-02,Solano,095,438530,355,267,0,267,4
2020-05-02,Sonoma,097,501317,301,250,0,250,3
2020-05-02,Stanislaus,099,539301,478,388,4,392,8
2020-05-02,Sutter,101,95872,31,28,0,28,2
2020-05-02,Tehama,103,63373,2,1,0,1,1
2020-05-02,Trinity,105,12862,1,0,0,0,0
2020-05-02,Tulare,107,460477,1239,711,6,717,35
2020-05-02,Tuolumne,109,53932,3,3,0,3,0
2020-05-02,Ventura,111,848112,762,564,1,565,19
2020-05-02,Yolo,113,214977,191,169,0,169,17
2020-05-02,Yuba,115,75493,19,16,0,16,1
2020-05-01,Alameda,001,1643700,2048,1630,3,1633,63
2020-05-01,Alpine,003,1148,1,1,0,1,0
2020-05-01,Amador,005,37829,8,8,0,8,0
2020-05-01,Butte,007,227075,28,17,1,18,0
2020-05-01,Calaveras,009,45235,13,13,0,13,0
2020-05-01,Colusa,011,21464,3,3,0,3,0
2020-05-01,Contra Costa,013,1133247,1040,915,0,915,28
2020-05-01,Del Norte,015,27424,5,3,0,3,0
2020-05-01,El Dorado,017,186661,64,47,0,47,0
2020-05-01,Fresno,019,978130,1229,617,14,631,7
2020-05-01,Glenn,021,27897,7,4,0,4,0
2020-05-01,Humboldt,023,135768,60,54,0,54,0
2020-05-01,Imperial,025,180216,620,337,0,337,6
2020-05-01,Inyo,027,18085,19,20,0,20,1
2020-05-01,Kern,029,883053,1282,972,1,973,8
2020-05-01,Kings,031,150075,274,112,1,113,1
2020-05-01,Lake,033,64148,9,6,0,6,0
2020-05-01,Lassen,035,31185,3,0,2,2,0
2020-05-01,Los Angeles,037,10098052,31517,24306,17,24323,1155
2020-05-01,Madera,039,155013,99,46,1,47,2
2020-05-01,Marin,041,260295,253,242,1,243,13
2020-05-01,Mariposa,043,17540,15,10,0,10,0
2020-05-01,Mendocino,045,87422,12,11,0,11,0
2020-05-01,Merced,047,269075,207,131,0,131,3
2020-05-01,Modoc,049,8938,0,0,0,0,0
2020-05-01,Mono,051,14174,32,25,0,25,1
2020-05-01,Monterey,053,433212,284,222,0,222,5
2020-05-01,Napa,055,140530,86,69,0,69,2
2020-05-01,Nevada,057,99092,41,41,1,42,1
2020-05-01,Orange,059,3164182,4158,2660,30,2690,51
2020-05-01,Placer,061,380077,179,149,0,149,8
2020-05-01,Plumas,063,18699,4,4,0,4,0
2020-05-01,Riverside,065,2383286,5055,3893,16,3909,132
2020-05-01,Sacramento,067,1510023,1153,1081,0,1081,43
2020-05-01,San Benito,069,59416,54,49,0,49,2
2020-05-01,San Bernardino,071,2135413,2876,2084,2,2086,98
2020-05-01,San Diego,073,3302833,4779,3713,0,3713,134
2020-05-01,San Francisco,075,870044,1886,1552,0,1552,29
2020-05-01,San Joaquin,077,732212,609,554,3,557,25
2020-05-01,San Luis Obispo,079,281455,267,186,3,189,1
2020-05-01,San Mateo,081,765935,1487,1222,2,1224,52
2020-05-01,Santa Barbara,083,443738,554,499,3,502,7
2020-05-01,Santa Clara,085,1922200,2697,2176,8,2184,112
2020-05-01,Santa Cruz,087,273765,144,127,0,127,2
2020-05-01,Shasta,089,179085,40,31,0,31,4
2020-05-01,Sierra,091,2930,0,0,0,0,0
2020-05-01,Siskiyou,093,43540,5,5,0,5,0
2020-05-01,Solano,095,438530,347,266,0,266,4
2020-05-01,Sonoma,097,501317,298,242,0,242,3
2020-05-01,Stanislaus,099,539301,473,384,4,388,8
2020-05-01,Sutter,101,95872,31,28,0,28,2
2020-05-01,Tehama,103,63373,2,1,0,1,1
2020-05-01,Trinity,105,12862,1,0,0,0,0
2020-05-01,Tulare,107,460477,1195,685,6,691,32
2020-05-01,Tuolumne,109,53932,3,3,0,3,0
2020-05-01,Ventura,111,848112,749,556,1,557,18
2020-05-01,Yolo,113,214977,191,165,0,165,18
2020-05-01,Yuba,115,75493,19,16,0,16,1
2020-04-30,Alameda,001,1643700,1988,1599,3,1602,60
2020-04-30,Alpine,003,1148,1,1,0,1,0
2020-04-30,Amador,005,37829,8,8,0,8,0
2020-04-30,Butte,007,227075,28,16,1,17,0
2020-04-30,Calaveras,009,45235,13,13,0,13,0
2020-04-30,Colusa,011,21464,3,3,0,3,0
2020-04-30,Contra Costa,013,1133247,1018,900,0,900,25
2020-04-30,Del Norte,015,27424,4,3,0,3,0
2020-04-30,El Dorado,017,186661,64,44,0,44,0
2020-04-30,Fresno,019,978130,1163,562,11,573,7
2020-04-30,Glenn,021,27897,7,4,0,4,0
2020-04-30,Humboldt,023,135768,60,54,0,54,0
2020-04-30,Imperial,025,180216,574,322,0,322,6
2020-04-30,Inyo,027,18085,19,20,0,20,1
2020-04-30,Kern,029,883053,1250,941,1,942,8
2020-04-30,Kings,031,150075,262,87,1,88,1
2020-04-30,Lake,033,64148,9,6,0,6,0
2020-04-30,Lassen,035,31185,3,0,2,2,0
2020-04-30,Los Angeles,037,10098052,30510,23284,17,23301,1099
2020-04-30,Madera,039,155013,88,46,1,47,2
2020-04-30,Marin,041,260295,253,240,1,241,13
2020-04-30,Mariposa,043,17540,15,3,0,3,0
2020-04-30,Mendocino,045,87422,12,11,0,11,0
2020-04-30,Merced,047,269075,200,122,0,122,3
2020-04-30,Modoc,049,8938,0,0,0,0,0
2020-04-30,Mono,051,14174,31,25,0,25,1
2020-04-30,Monterey,053,433212,274,213,0,213,5
2020-04-30,Napa,055,140530,84,69,0,69,2
2020-04-30,Nevada,057,99092,41,41,1,42,1
2020-04-30,Orange,059,3164182,3935,2591,27,2618,46
2020-04-30,Placer,061,380077,178,148,0,148,8
2020-04-30,Plumas,063,18699,4,4,0,4,0
2020-04-30,Riverside,065,2383286,4955,3820,15,3835,124
2020-04-30,Sacramento,067,1510023,1147,1071,0,1071,43
2020-04-30,San Benito,069,59416,54,48,0,48,2
2020-04-30,San Bernardino,071,2135413,2674,2020,2,2022,96
2020-04-30,San Diego,073,3302833,4608,3566,0,3566,124
2020-04-30,San Francisco,075,870044,1852,1518,0,1518,26
2020-04-30,San Joaquin,077,732212,601,548,3,551,25
2020-04-30,San Luis Obispo,079,281455,264,182,3,185,1
2020-04-30,San Mateo,081,765935,1457,1194,2,1196,52
2020-04-30,Santa Barbara,083,443738,542,490,3,493,7
2020-04-30,Santa Clara,085,1922200,2657,2172,8,2180,111
2020-04-30,Santa Cruz,087,273765,143,126,0,126,2
2020-04-30,Shasta,089,179085,39,31,0,31,4
2020-04-30,Sierra,091,2930,0,0,0,0,0
2020-04-30,Siskiyou,093,43540,5,5,0,5,0
2020-04-30,Solano,095,438530,337,262,0,262,4
2020-04-30,Sonoma,097,501317,289,233,0,233,3
2020-04-30,Stanislaus,099,539301,466,378,4,382,7
2020-04-30,Sutter,101,95872,31,28,0,28,2
2020-04-30,Tehama,103,63373,1,1,0,1,1
2020-04-30,Trinity,105,12862,1,0,0,0,0
2020-04-30,Tulare,107,460477,1129,637,6,643,31
2020-04-30,Tuolumne,109,53932,3,3,0,3,0
2020-04-30,Ventura,111,848112,721,547,1,548,18
2020-04-30,Yolo,113,214977,190,164,0,164,16
2020-04-30,Yuba,115,75493,19,15,0,15,1
2020-04-29,Alameda,001,1643700,1930,1564,2,1566,60
2020-04-29,Alpine,003,1148,1,1,0,1,0
2020-04-29,Amador,005,37829,8,8,0,8,0
2020-04-29,Butte,007,227075,28,16,1,17,0
2020-04-29,Calaveras,009,45235,13,13,0,13,0
2020-04-29,Colusa,011,21464,3,3,0,3,0
2020-04-29,Contra Costa,013,1133247,999,885,0,885,25
2020-04-29,Del Norte,015,27424,4,3,0,3,0
2020-04-29,El Dorado,017,186661,62,44,0,44,0
2020-04-29,Fresno,019,978130,1111,544,11,555,7
2020-04-29,Glenn,021,27897,7,4,0,4,0
2020-04-29,Humboldt,023,135768,60,53,0,53,0
2020-04-29,Imperial,025,180216,544,300,0,300,6
2020-04-29,Inyo,027,18085,19,20,0,20,1
2020-04-29,Kern,029,883053,1207,910,1,911,6
2020-04-29,Kings,031,150075,243,80,1,81,1
2020-04-29,Lake,033,64148,9,6,0,6,0
2020-04-29,Lassen,035,31185,3,0,2,2,0
2020-04-29,Los Angeles,037,10098052,29533,22560,16,22576,1043
2020-04-29,Madera,039,155013,86,45,1,46,2
2020-04-29,Marin,041,260295,250,234,1,235,13
2020-04-29,Mariposa,043,17540,15,1,0,1,0
2020-04-29,Mendocino,045,87422,12,11,0,11,0
2020-04-29,Merced,047,269075,193,116,0,116,3
2020-04-29,Modoc,049,8938,0,0,0,0,0
2020-04-29,Mono,051,14174,31,25,0,25,1
2020-04-29,Monterey,053,433212,266,204,0,204,5
2020-04-29,Napa,055,140530,82,68,0,68,2
2020-04-29,Nevada,057,99092,41,41,1,42,1
2020-04-29,Orange,059,3164182,3800,2421,26,2447,43
2020-04-29,Placer,061,380077,176,145,0,145,8
2020-04-29,Plumas,063,18699,4,4,0,4,0
2020-04-29,Riverside,065,2383286,4878,3700,15,3715,116
2020-04-29,Sacramento,067,1510023,1125,1055,0,1055,41
2020-04-29,San Benito,069,59416,54,48,0,48,2
2020-04-29,San Bernardino,071,2135413,2587,1975,1,1976,91
2020-04-29,San Diego,073,3302833,4466,3434,0,3434,120
2020-04-29,San Francisco,075,870044,1824,1489,0,1489,23
2020-04-29,San Joaquin,077,732212,593,540,3,543,25
2020-04-29,San Luis Obispo,079,281455,262,181,3,184,1
2020-04-29,San Mateo,081,765935,1431,1170,2,1172,50
2020-04-29,Santa Barbara,083,443738,529,477,3,480,7
2020-04-29,Santa Clara,085,1922200,2630,2147,8,2155,108
2020-04-29,Santa Cruz,087,273765,142,124,0,124,2
2020-04-29,Shasta,089,179085,38,31,0,31,4
2020-04-29,Sierra,091,2930,0,0,0,0,0
2020-04-29,Siskiyou,093,43540,5,5,0,5,0
2020-04-29,Solano,095,438530,313,252,0,252,3
2020-04-29,Sonoma,097,501317,281,230,0,230,2
2020-04-29,Stanislaus,099,539301,453,374,4,378,5
2020-04-29,Sutter,101,95872,31,28,0,28,2
2020-04-29,Tehama,103,63373,1,1,0,1,1
2020-04-29,Trinity,105,12862,1,0,0,0,0
2020-04-29,Tulare,107,460477,1056,615,5,620,30
2020-04-29,Tuolumne,109,53932,3,4,0,4,0
2020-04-29,Ventura,111,848112,697,530,1,531,18
2020-04-29,Yolo,113,214977,187,161,0,161,11
2020-04-29,Yuba,115,75493,19,15,0,15,1
2020-04-28,Alameda,001,1643700,1873,1525,2,1527,55
2020-04-28,Alpine,003,1148,1,1,0,1,0
2020-04-28,Amador,005,37829,8,8,0,8,0
2020-04-28,Butte,007,227075,28,16,1,17,0
2020-04-28,Calaveras,009,45235,13,13,0,13,0
2020-04-28,Colusa,011,21464,3,3,0,3,0
2020-04-28,Contra Costa,013,1133247,992,866,0,866,25
2020-04-28,Del Norte,015,27424,4,3,0,3,0
2020-04-28,El Dorado,017,186661,61,43,0,43,0
2020-04-28,Fresno,019,978130,1060,525,9,534,7
2020-04-28,Glenn,021,27897,5,4,0,4,0
2020-04-28,Humboldt,023,135768,59,53,0,53,0
2020-04-28,Imperial,025,180216,510,295,0,295,6
2020-04-28,Inyo,027,18085,19,20,0,20,1
2020-04-28,Kern,029,883053,1164,882,1,883,5
2020-04-28,Kings,031,150075,230,57,1,58,1
2020-04-28,Lake,033,64148,9,6,0,6,0
2020-04-28,Lassen,035,31185,3,0,2,2,0
2020-04-28,Los Angeles,037,10098052,28468,21029,16,21045,984
2020-04-28,Madera,039,155013,86,44,1,45,2
2020-04-28,Marin,041,260295,249,228,1,229,12
2020-04-28,Mariposa,043,17540,15,0,0,0,0
2020-04-28,Mendocino,045,87422,12,10,0,10,0
2020-04-28,Merced,047,269075,186,108,0,108,3
2020-04-28,Modoc,049,8938,0,0,0,0,0
2020-04-28,Mono,051,14174,31,25,0,25,1
2020-04-28,Monterey,053,433212,260,191,0,191,5
2020-04-28,Napa,055,140530,81,67,0,67,2
2020-04-28,Nevada,057,99092,41,41,1,42,1
2020-04-28,Orange,059,3164182,3637,2324,25,2349,42
2020-04-28,Placer,061,380077,166,143,0,143,8
2020-04-28,Plumas,063,18699,4,4,0,4,0
2020-04-28,Riverside,065,2383286,4783,3504,15,3519,113
2020-04-28,Sacramento,067,1510023,1110,1044,0,1044,41
2020-04-28,San Benito,069,59416,52,46,0,46,2
2020-04-28,San Bernardino,071,2135413,2510,1891,1,1892,89
2020-04-28,San Diego,073,3302833,4336,3316,0,3316,118
2020-04-28,San Francisco,075,870044,1789,1471,0,1471,23
2020-04-28,San Joaquin,077,732212,587,532,3,535,25
2020-04-28,San Luis Obispo,079,281455,255,172,3,175,1
2020-04-28,San Mateo,081,765935,1418,1129,2,1131,48
2020-04-28,Santa Barbara,083,443738,524,469,2,471,7
2020-04-28,Santa Clara,085,1922200,2596,2130,8,2138,106
2020-04-28,Santa Cruz,087,273765,142,123,0,123,2
2020-04-28,Shasta,089,179085,38,29,0,29,4
2020-04-28,Sierra,091,2930,0,0,0,0,0
2020-04-28,Siskiyou,093,43540,5,5,0,5,0
2020-04-28,Solano,095,438530,294,246,0,246,3
2020-04-28,Sonoma,097,501317,278,226,0,226,1
2020-04-28,Stanislaus,099,539301,437,330,4,334,5
2020-04-28,Sutter,101,95872,31,25,0,25,2
2020-04-28,Tehama,103,63373,1,1,0,1,1
2020-04-28,Trinity,105,12862,1,0,0,0,0
2020-04-28,Tulare,107,460477,960,579,5,584,30
2020-04-28,Tuolumne,109,53932,3,4,0,4,0
2020-04-28,Ventura,111,848112,677,517,1,518,17
2020-04-28,Yolo,113,214977,187,160,0,160,10
2020-04-28,Yuba,115,75493,19,15,0,15,1
2020-04-27,Alameda,001,1643700,1813,1494,2,1496,53
2020-04-27,Alpine,003,1148,1,1,0,1,0
2020-04-27,Amador,005,37829,8,8,0,8,0
2020-04-27,Butte,007,227075,27,16,1,17,0
2020-04-27,Calaveras,009,45235,13,13,0,13,0
2020-04-27,Colusa,011,21464,3,3,0,3,0
2020-04-27,Contra Costa,013,1133247,980,843,0,843,25
2020-04-27,Del Norte,015,27424,4,3,0,3,0
2020-04-27,El Dorado,017,186661,60,43,0,43,0
2020-04-27,Fresno,019,978130,957,504,8,512,7
2020-04-27,Glenn,021,27897,5,4,0,4,0
2020-04-27,Humboldt,023,135768,59,52,0,52,0
2020-04-27,Imperial,025,180216,480,290,0,290,6
2020-04-27,Inyo,027,18085,19,20,0,20,1
2020-04-27,Kern,029,883053,1125,865,1,866,4
2020-04-27,Kings,031,150075,207,48,1,49,1
2020-04-27,Lake,033,64148,8,6,0,6,0
2020-04-27,Lassen,035,31185,3,0,2,2,0
2020-04-27,Los Angeles,037,10098052,27450,20456,16,20472,931
2020-04-27,Madera,039,155013,84,42,1,43,2
2020-04-27,Marin,041,260295,244,227,1,228,12
2020-04-27,Mariposa,043,17540,14,0,0,0,0
2020-04-27,Mendocino,045,87422,12,10,0,10,0
2020-04-27,Merced,047,269075,183,108,0,108,3
2020-04-27,Modoc,049,8938,0,0,0,0,0
2020-04-27,Mono,051,14174,31,23,0,23,1
2020-04-27,Monterey,053,433212,253,185,0,185,4
2020-04-27,Napa,055,140530,77,64,0,64,2
2020-04-27,Nevada,057,99092,41,39,1,40,1
2020-04-27,Orange,059,3164182,3468,2198,25,2223,42
2020-04-27,Placer,061,380077,166,142,0,142,8
2020-04-27,Plumas,063,18699,4,4,0,4,0
2020-04-27,Riverside,065,2383286,4660,3381,15,3396,100
2020-04-27,Sacramento,067,1510023,1095,1035,0,1035,41
2020-04-27,San Benito,069,59416,50,45,0,45,2
2020-04-27,San Bernardino,071,2135413,2396,1742,1,1743,82
2020-04-27,San Diego,073,3302833,4210,3143,0,3143,113
2020-04-27,San Francisco,075,870044,1735,1453,0,1453,23
2020-04-27,San Joaquin,077,732212,581,522,3,525,25
2020-04-27,San Luis Obispo,079,281455,247,166,3,169,1
2020-04-27,San Mateo,081,765935,1396,1092,2,1094,46
2020-04-27,Santa Barbara,083,443738,516,466,2,468,7
2020-04-27,Santa Clara,085,1922200,2571,2104,7,2111,105
2020-04-27,Santa Cruz,087,273765,142,123,0,123,2
2020-04-27,Shasta,089,179085,38,29,0,29,4
2020-04-27,Sierra,091,2930,0,0,0,0,0
2020-04-27,Siskiyou,093,43540,5,5,0,5,0
2020-04-27,Solano,095,438530,294,222,0,222,3
2020-04-27,Sonoma,097,501317,269,220,0,220,1
2020-04-27,Stanislaus,099,539301,421,316,4,320,5
2020-04-27,Sutter,101,95872,29,26,0,26,2
2020-04-27,Tehama,103,63373,1,1,0,1,1
2020-04-27,Trinity,105,12862,1,0,0,0,0
2020-04-27,Tulare,107,460477,889,535,5,540,28
2020-04-27,Tuolumne,109,53932,3,3,0,3,0
2020-04-27,Ventura,111,848112,658,513,1,514,17
2020-04-27,Yolo,113,214977,184,160,0,160,9
2020-04-27,Yuba,115,75493,19,15,0,15,1
2020-04-26,Alameda,001,1643700,1752,1449,2,1451,52
2020-04-26,Alpine,003,1148,1,1,0,1,0
2020-04-26,Amador,005,37829,8,8,0,8,0
2020-04-26,Butte,007,227075,27,16,1,17,0
2020-04-26,Calaveras,009,45235,13,13,0,13,0
2020-04-26,Colusa,011,21464,3,3,0,3,0
2020-04-26,Contra Costa,013,1133247,964,830,0,830,25
2020-04-26,Del Norte,015,27424,3,3,0,3,0
2020-04-26,El Dorado,017,186661,58,41,0,41,0
2020-04-26,Fresno,019,978130,863,476,7,483,7
2020-04-26,Glenn,021,27897,5,4,0,4,0
2020-04-26,Humboldt,023,135768,59,53,0,53,0
2020-04-26,Imperial,025,180216,446,272,0,272,6
2020-04-26,Inyo,027,18085,19,20,0,20,1
2020-04-26,Kern,029,883053,1075,831,1,832,4
2020-04-26,Kings,031,150075,182,33,1,34,1
2020-04-26,Lake,033,64148,8,6,0,6,0
2020-04-26,Lassen,035,31185,3,0,2,2,0
2020-04-26,Los Angeles,037,10098052,26293,19570,16,19586,901
2020-04-26,Madera,039,155013,82,39,1,40,2
2020-04-26,Marin,041,260295,238,225,1,226,12
2020-04-26,Mariposa,043,17540,14,0,0,0,0
2020-04-26,Mendocino,045,87422,12,5,0,5,0
2020-04-26,Merced,047,269075,166,104,0,104,3
2020-04-26,Modoc,049,8938,0,0,0,0,0
2020-04-26,Mono,051,14174,31,23,0,23,1
2020-04-26,Monterey,053,433212,246,182,0,182,4
2020-04-26,Napa,055,140530,76,62,0,62,2
2020-04-26,Nevada,057,99092,41,37,1,38,1
2020-04-26,Orange,059,3164182,3303,2124,25,2149,40
2020-04-26,Placer,061,380077,165,141,0,141,8
2020-04-26,Plumas,063,18699,4,4,0,4,0
2020-04-26,Riverside,065,2383286,4517,3301,15,3316,95
2020-04-26,Sacramento,067,1510023,1086,1027,0,1027,41
2020-04-26,San Benito,069,59416,50,45,0,45,2
2020-04-26,San Bernardino,071,2135413,2300,1681,1,1682,82
2020-04-26,San Diego,073,3302833,4068,3045,0,3045,111
2020-04-26,San Francisco,075,870044,1696,1403,0,1403,23
2020-04-26,San Joaquin,077,732212,573,514,3,517,25
2020-04-26,San Luis Obispo,079,281455,244,165,3,168,1
2020-04-26,San Mateo,081,765935,1370,1070,2,1072,46
2020-04-26,Santa Barbara,083,443738,509,464,2,466,7
2020-04-26,Santa Clara,085,1922200,2548,2097,6,2103,102
2020-04-26,Santa Cruz,087,273765,142,116,0,116,2
2020-04-26,Shasta,089,179085,35,29,0,29,4
2020-04-26,Sierra,091,2930,0,0,0,0,0
2020-04-26,Siskiyou,093,43540,5,5,0,5,0
2020-04-26,Solano,095,438530,285,205,0,205,3
2020-04-26,Sonoma,097,501317,258,216,0,216,1
2020-04-26,Stanislaus,099,539301,406,294,4,298,4
2020-04-26,Sutter,101,95872,29,26,0,26,2
2020-04-26,Tehama,103,63373,1,1,0,1,1
2020-04-26,Trinity,105,12862,1,0,0,0,0
2020-04-26,Tulare,107,460477,830,497,5,502,28
2020-04-26,Tuolumne,109,53932,3,3,0,3,0
2020-04-26,Ventura,111,848112,640,509,1,510,17
2020-04-26,Yolo,113,214977,183,158,0,158,8
2020-04-26,Yuba,115,75493,18,15,0,15,1
2020-04-25,Alameda,001,1643700,1727,1396,2,1398,52
2020-04-25,Alpine,003,1148,1,1,0,1,0
2020-04-25,Amador,005,37829,8,8,0,8,0
2020-04-25,Butte,007,227075,26,16,1,17,0
2020-04-25,Calaveras,009,45235,13,12,0,12,0
2020-04-25,Colusa,011,21464,3,3,0,3,0
2020-04-25,Contra Costa,013,1133247,950,821,0,821,24
2020-04-25,Del Norte,015,27424,2,2,0,2,0
2020-04-25,El Dorado,017,186661,57,41,0,41,0
2020-04-25,Fresno,019,978130,831,459,6,465,7
2020-04-25,Glenn,021,27897,5,4,0,4,0
2020-04-25,Humboldt,023,135768,59,53,0,53,0
2020-04-25,Imperial,025,180216,429,232,0,232,6
2020-04-25,Inyo,027,18085,19,20,0,20,1
2020-04-25,Kern,029,883053,1044,802,1,803,4
2020-04-25,Kings,031,150075,170,33,1,34,1
2020-04-25,Lake,033,64148,6,6,0,6,0
2020-04-25,Lassen,035,31185,3,0,2,2,0
2020-04-25,Los Angeles,037,10098052,25659,19144,16,19160,881
2020-04-25,Madera,039,155013,79,39,1,40,2
2020-04-25,Marin,041,260295,238,215,1,216,12
2020-04-25,Mariposa,043,17540,14,0,0,0,0
2020-04-25,Mendocino,045,87422,11,5,0,5,0
2020-04-25,Merced,047,269075,166,103,0,103,3
2020-04-25,Modoc,049,8938,0,0,0,0,0
2020-04-25,Mono,051,14174,31,23,0,23,1
2020-04-25,Monterey,053,433212,244,173,0,173,4
2020-04-25,Napa,055,140530,76,60,0,60,2
2020-04-25,Nevada,057,99092,41,37,1,38,1
2020-04-25,Orange,059,3164182,3195,2047,25,2072,40
2020-04-25,Placer,061,380077,165,137,0,137,8
2020-04-25,Plumas,063,18699,4,4,0,4,0
2020-04-25,Riverside,065,2383286,4427,3037,15,3052,93
2020-04-25,Sacramento,067,1510023,1084,1015,0,1015,41
2020-04-25,San Benito,069,59416,50,45,0,45,2
2020-04-25,San Bernardino,071,2135413,2254,1675,1,1676,82
2020-04-25,San Diego,073,3302833,3967,2945,0,2945,111
2020-04-25,San Francisco,075,870044,1671,1341,0,1341,22
2020-04-25,San Joaquin,077,732212,566,497,3,500,24
2020-04-25,San Luis Obispo,079,281455,243,159,3,162,1
2020-04-25,San Mateo,081,765935,1352,1054,2,1056,46
2020-04-25,Santa Barbara,083,443738,502,457,2,459,7
2020-04-25,Santa Clara,085,1922200,2526,2045,5,2050,99
2020-04-25,Santa Cruz,087,273765,142,112,0,112,2
2020-04-25,Shasta,089,179085,35,29,0,29,4
2020-04-25,Sierra,091,2930,0,0,0,0,0
2020-04-25,Siskiyou,093,43540,5,5,0,5,0
2020-04-25,Solano,095,438530,281,203,0,203,3
2020-04-25,Sonoma,097,501317,254,199,0,199,1
2020-04-25,Stanislaus,099,539301,398,276,4,280,4
2020-04-25,Sutter,101,95872,29,24,0,24,2
2020-04-25,Tehama,103,63373,1,1,0,1,1
2020-04-25,Trinity,105,12862,0,0,0,0,0
2020-04-25,Tulare,107,460477,797,478,5,483,28
2020-04-25,Tuolumne,109,53932,3,2,0,2,0
2020-04-25,Ventura,111,848112,626,494,1,495,16
2020-04-25,Yolo,113,214977,183,157,0,157,8
2020-04-25,Yuba,115,75493,17,15,0,15,1
2020-04-24,Alameda,001,1643700,1696,1385,2,1387,50
2020-04-24,Alpine,003,1148,1,1,0,1,0
2020-04-24,Amador,005,37829,8,8,0,8,0
2020-04-24,Butte,007,227075,25,15,1,16,0
2020-04-24,Calaveras,009,45235,13,12,0,12,0
2020-04-24,Colusa,011,21464,3,3,0,3,0
2020-04-24,Contra Costa,013,1133247,941,806,0,806,23
2020-04-24,Del Norte,015,27424,2,2,0,2,0
2020-04-24,El Dorado,017,186661,56,41,0,41,0
2020-04-24,Fresno,019,978130,808,449,6,455,7
2020-04-24,Glenn,021,27897,5,4,0,4,0
2020-04-24,Humboldt,023,135768,59,53,0,53,0
2020-04-24,Imperial,025,180216,413,232,0,232,6
2020-04-24,Inyo,027,18085,19,20,0,20,0
2020-04-24,Kern,029,883053,1020,770,1,771,4
2020-04-24,Kings,031,150075,141,30,1,31,1
2020-04-24,Lake,033,64148,6,6,0,6,0
2020-04-24,Lassen,035,31185,3,0,2,2,0
2020-04-24,Los Angeles,037,10098052,24729,18553,16,18569,836
2020-04-24,Madera,039,155013,79,39,1,40,2
2020-04-24,Marin,041,260295,238,211,1,212,11
2020-04-24,Mariposa,043,17540,8,0,0,0,0
2020-04-24,Mendocino,045,87422,11,5,0,5,0
2020-04-24,Merced,047,269075,163,102,0,102,3
2020-04-24,Modoc,049,8938,0,0,0,0,0
2020-04-24,Mono,051,14174,30,23,0,23,1
2020-04-24,Monterey,053,433212,237,167,0,167,4
2020-04-24,Napa,055,140530,75,59,0,59,2
2020-04-24,Nevada,057,99092,41,36,1,37,1
2020-04-24,Orange,059,3164182,3088,1945,25,1970,39
2020-04-24,Placer,061,380077,163,137,0,137,8
2020-04-24,Plumas,063,18699,4,4,0,4,0
2020-04-24,Riverside,065,2383286,4346,3044,15,3059,87
2020-04-24,Sacramento,067,1510023,1078,1009,0,1009,41
2020-04-24,San Benito,069,59416,50,45,0,45,2
2020-04-24,San Bernardino,071,2135413,2219,1667,1,1668,80
2020-04-24,San Diego,073,3302833,3856,2828,0,2828,102
2020-04-24,San Francisco,075,870044,1613,1345,0,1345,22
2020-04-24,San Joaquin,077,732212,559,484,3,487,24
2020-04-24,San Luis Obispo,079,281455,240,151,3,154,1
2020-04-24,San Mateo,081,765935,1329,1004,2,1006,43
2020-04-24,Santa Barbara,083,443738,496,450,2,452,6
2020-04-24,Santa Clara,085,1922200,2484,2026,5,2031,98
2020-04-24,Santa Cruz,087,273765,138,111,0,111,2
2020-04-24,Shasta,089,179085,35,28,0,28,4
2020-04-24,Sierra,091,2930,0,0,0,0,0
2020-04-24,Siskiyou,093,43540,5,5,0,5,0
2020-04-24,Solano,095,438530,279,203,0,203,3
2020-04-24,Sonoma,097,501317,250,199,0,199,1
2020-04-24,Stanislaus,099,539301,395,273,4,277,4
2020-04-24,Sutter,101,95872,28,24,0,24,2
2020-04-24,Tehama,103,63373,1,1,0,1,1
2020-04-24,Trinity,105,12862,0,0,0,0,0
2020-04-24,Tulare,107,460477,769,459,5,464,27
2020-04-24,Tuolumne,109,53932,3,2,0,2,0
2020-04-24,Ventura,111,848112,616,489,1,490,16
2020-04-24,Yolo,113,214977,182,155,0,155,8
2020-04-24,Yuba,115,75493,16,15,0,15,1
2020-04-23,Alameda,001,1643700,1658,1336,2,1338,46
2020-04-23,Alpine,003,1148,1,1,0,1,0
2020-04-23,Amador,005,37829,8,8,0,8,0
2020-04-23,Butte,007,227075,25,15,1,16,0
2020-04-23,Calaveras,009,45235,13,12,0,12,0
2020-04-23,Colusa,011,21464,3,3,0,3,0
2020-04-23,Contra Costa,013,1133247,920,786,0,786,23
2020-04-23,Del Norte,015,27424,2,2,0,2,0
2020-04-23,El Dorado,017,186661,55,39,0,39,0
2020-04-23,Fresno,019,978130,770,426,6,432,7
2020-04-23,Glenn,021,27897,5,3,0,3,0
2020-04-23,Humboldt,023,135768,59,53,0,53,0
2020-04-23,Imperial,025,180216,392,181,0,181,4
2020-04-23,Inyo,027,18085,19,19,0,19,0
2020-04-23,Kern,029,883053,972,732,1,733,4
2020-04-23,Kings,031,150075,126,28,1,29,1
2020-04-23,Lake,033,64148,6,6,0,6,0
2020-04-23,Lassen,035,31185,3,0,2,2,0
2020-04-23,Los Angeles,037,10098052,23668,17548,15,17563,784
2020-04-23,Madera,039,155013,77,37,1,38,2
2020-04-23,Marin,041,260295,225,209,1,210,11
2020-04-23,Mariposa,043,17540,7,0,0,0,0
2020-04-23,Mendocino,045,87422,9,5,0,5,0
2020-04-23,Merced,047,269075,159,98,0,98,3
2020-04-23,Modoc,049,8938,0,0,0,0,0
2020-04-23,Mono,051,14174,30,23,0,23,1
2020-04-23,Monterey,053,433212,233,161,0,161,4
2020-04-23,Napa,055,140530,68,59,0,59,2
2020-04-23,Nevada,057,99092,41,36,1,37,1
2020-04-23,Orange,059,3164182,2910,1841,24,1865,37
2020-04-23,Placer,061,380077,160,136,0,136,8
2020-04-23,Plumas,063,18699,4,4,0,4,0
2020-04-23,Riverside,065,2383286,4232,2935,14,2949,78
2020-04-23,Sacramento,067,1510023,1066,978,0,978,41
2020-04-23,San Benito,069,59416,47,43,0,43,2
2020-04-23,San Bernardino,071,2135413,2154,1604,1,1605,79
2020-04-23,San Diego,073,3302833,3695,2645,0,2645,100
2020-04-23,San Francisco,075,870044,1588,1312,0,1312,21
2020-04-23,San Joaquin,077,732212,549,479,3,482,20
2020-04-23,San Luis Obispo,079,281455,236,146,3,149,1
2020-04-23,San Mateo,081,765935,1290,970,2,972,42
2020-04-23,Santa Barbara,083,443738,490,445,2,447,6
2020-04-23,Santa Clara,085,1922200,2449,1996,5,2001,95
2020-04-23,Santa Cruz,087,273765,137,110,0,110,2
2020-04-23,Shasta,089,179085,35,27,0,27,3
2020-04-23,Sierra,091,2930,0,0,0,0,0
2020-04-23,Siskiyou,093,43540,5,5,0,5,0
2020-04-23,Solano,095,438530,265,196,0,196,3
2020-04-23,Sonoma,097,501317,238,187,0,187,1
2020-04-23,Stanislaus,099,539301,391,254,4,258,4
2020-04-23,Sutter,101,95872,28,24,0,24,2
2020-04-23,Tehama,103,63373,1,1,0,1,1
2020-04-23,Trinity,105,12862,0,0,0,0,0
2020-04-23,Tulare,107,460477,740,440,5,445,25
2020-04-23,Tuolumne,109,53932,3,2,0,2,0
2020-04-23,Ventura,111,848112,602,479,1,480,16
2020-04-23,Yolo,113,214977,179,151,0,151,8
2020-04-23,Yuba,115,75493,16,15,0,15,1
2020-04-22,Alameda,001,1643700,1609,1275,2,1277,46
2020-04-22,Alpine,003,1148,1,1,0,1,0
2020-04-22,Amador,005,37829,8,7,0,7,0
2020-04-22,Butte,007,227075,24,15,1,16,0
2020-04-22,Calaveras,009,45235,13,12,0,12,0
2020-04-22,Colusa,011,21464,3,3,0,3,0
2020-04-22,Contra Costa,013,1133247,905,772,0,772,22
2020-04-22,Del Norte,015,27424,2,2,0,2,0
2020-04-22,El Dorado,017,186661,55,39,0,39,0
2020-04-22,Fresno,019,978130,730,388,6,394,7
2020-04-22,Glenn,021,27897,5,3,0,3,0
2020-04-22,Humboldt,023,135768,59,53,0,53,0
2020-04-22,Imperial,025,180216,381,170,0,170,3
2020-04-22,Inyo,027,18085,19,18,0,18,0
2020-04-22,Kern,029,883053,950,713,1,714,4
2020-04-22,Kings,031,150075,105,28,1,29,1
2020-04-22,Lake,033,64148,6,6,0,6,0
2020-04-22,Lassen,035,31185,3,0,2,2,0
2020-04-22,Los Angeles,037,10098052,22641,16400,15,16415,715
2020-04-22,Madera,039,155013,75,37,1,38,2
2020-04-22,Marin,041,260295,223,202,1,203,11
2020-04-22,Mariposa,043,17540,6,0,0,0,0
2020-04-22,Mendocino,045,87422,6,5,0,5,0
2020-04-22,Merced,047,269075,147,92,0,92,3
2020-04-22,Modoc,049,8938,0,0,0,0,0
2020-04-22,Mono,051,14174,29,23,0,23,1
2020-04-22,Monterey,053,433212,226,154,0,154,4
2020-04-22,Napa,055,140530,67,58,0,58,2
2020-04-22,Nevada,057,99092,41,36,1,37,1
2020-04-22,Orange,059,3164182,2816,1785,23,1808,36
2020-04-22,Placer,061,380077,158,133,0,133,8
2020-04-22,Plumas,063,18699,4,4,0,4,0
2020-04-22,Riverside,065,2383286,4128,2822,14,2836,76
2020-04-22,Sacramento,067,1510023,1061,959,0,959,36
2020-04-22,San Benito,069,59416,46,43,0,43,2
2020-04-22,San Bernardino,071,2135413,2091,1564,1,1565,74
2020-04-22,San Diego,073,3302833,3567,2493,0,2493,96
2020-04-22,San Francisco,075,870044,1551,1255,0,1255,21
2020-04-22,San Joaquin,077,732212,538,462,3,465,20
2020-04-22,San Luis Obispo,079,281455,227,142,3,145,1
2020-04-22,San Mateo,081,765935,1267,945,2,947,40
2020-04-22,Santa Barbara,083,443738,485,437,2,439,6
2020-04-22,Santa Clara,085,1922200,2433,1969,5,1974,95
2020-04-22,Santa Cruz,087,273765,133,106,0,106,2
2020-04-22,Shasta,089,179085,34,26,0,26,3
2020-04-22,Sierra,091,2930,0,0,0,0,0
2020-04-22,Siskiyou,093,43540,5,5,0,5,0
2020-04-22,Solano,095,438530,247,195,0,195,3
2020-04-22,Sonoma,097,501317,235,185,0,185,1
2020-04-22,Stanislaus,099,539301,334,247,4,251,4
2020-04-22,Sutter,101,95872,28,22,0,22,2
2020-04-22,Tehama,103,63373,1,1,0,1,1
2020-04-22,Trinity,105,12862,0,0,0,0,0
2020-04-22,Tulare,107,460477,706,425,5,430,23
2020-04-22,Tuolumne,109,53932,3,2,0,2,0
2020-04-22,Ventura,111,848112,591,465,1,466,15
2020-04-22,Yolo,113,214977,178,147,0,147,8
2020-04-22,Yuba,115,75493,16,15,0,15,1
2020-04-21,Alameda,001,1643700,1579,1234,2,1236,46
2020-04-21,Alpine,003,1148,1,1,0,1,0
2020-04-21,Amador,005,37829,8,7,0,7,0
2020-04-21,Butte,007,227075,23,15,1,16,0
2020-04-21,Calaveras,009,45235,12,12,0,12,0
2020-04-21,Colusa,011,21464,3,3,0,3,0
2020-04-21,Contra Costa,013,1133247,891,766,0,766,22
2020-04-21,Del Norte,015,27424,2,2,0,2,0
2020-04-21,El Dorado,017,186661,54,36,0,36,0
2020-04-21,Fresno,019,978130,696,372,6,378,7
2020-04-21,Glenn,021,27897,5,3,0,3,0
2020-04-21,Humboldt,023,135768,58,53,0,53,0
2020-04-21,Imperial,025,180216,361,165,0,165,2
2020-04-21,Inyo,027,18085,19,18,0,18,0
2020-04-21,Kern,029,883053,908,676,1,677,4
2020-04-21,Kings,031,150075,91,28,1,29,1
2020-04-21,Lake,033,64148,6,6,0,6,0
2020-04-21,Lassen,035,31185,3,0,2,2,0
2020-04-21,Los Angeles,037,10098052,21781,15096,15,15111,650
2020-04-21,Madera,039,155013,75,37,1,38,2
2020-04-21,Marin,041,260295,217,202,1,203,10
2020-04-21,Mariposa,043,17540,5,0,0,0,0
2020-04-21,Mendocino,045,87422,6,5,0,5,0
2020-04-21,Merced,047,269075,143,89,0,89,3
2020-04-21,Modoc,049,8938,0,0,0,0,0
2020-04-21,Mono,051,14174,29,23,0,23,1
2020-04-21,Monterey,053,433212,223,151,0,151,4
2020-04-21,Napa,055,140530,66,58,0,58,2
2020-04-21,Nevada,057,99092,41,36,1,37,1
2020-04-21,Orange,059,3164182,2693,1717,22,1739,36
2020-04-21,Placer,061,380077,156,133,0,133,8
2020-04-21,Plumas,063,18699,4,4,0,4,0
2020-04-21,Riverside,065,2383286,3996,2631,14,2645,68
2020-04-21,Sacramento,067,1510023,1051,941,0,941,33
2020-04-21,San Benito,069,59416,44,43,0,43,2
2020-04-21,San Bernardino,071,2135413,2030,1499,1,1500,71
2020-04-21,San Diego,073,3302833,3411,2436,0,2436,87
2020-04-21,San Francisco,075,870044,1521,1232,0,1232,20
2020-04-21,San Joaquin,077,732212,528,447,3,450,20
2020-04-21,San Luis Obispo,079,281455,219,134,3,137,1
2020-04-21,San Mateo,081,765935,1221,933,2,935,34
2020-04-21,Santa Barbara,083,443738,476,414,2,416,5
2020-04-21,Santa Clara,085,1922200,2383,1943,5,1948,91
2020-04-21,Santa Cruz,087,273765,131,104,0,104,2
2020-04-21,Shasta,089,179085,33,26,0,26,3
2020-04-21,Sierra,091,2930,0,0,0,0,0
2020-04-21,Siskiyou,093,43540,5,5,0,5,0
2020-04-21,Solano,095,438530,239,193,0,193,3
2020-04-21,Sonoma,097,501317,225,182,0,182,1
2020-04-21,Stanislaus,099,539301,315,235,4,239,4
2020-04-21,Sutter,101,95872,28,22,0,22,2
2020-04-21,Tehama,103,63373,1,1,0,1,1
2020-04-21,Trinity,105,12862,0,0,0,0,0
2020-04-21,Tulare,107,460477,669,410,5,415,23
2020-04-21,Tuolumne,109,53932,3,2,0,2,0
2020-04-21,Ventura,111,848112,579,455,1,456,14
2020-04-21,Yolo,113,214977,176,143,0,143,8
2020-04-21,Yuba,115,75493,16,15,0,15,1
2020-04-20,Alameda,001,1643700,1546,1181,2,1183,42
2020-04-20,Alpine,003,1148,1,1,0,1,0
2020-04-20,Amador,005,37829,8,7,0,7,0
2020-04-20,Butte,007,227075,23,15,1,16,0
2020-04-20,Calaveras,009,45235,12,12,0,12,0
2020-04-20,Colusa,011,21464,3,3,0,3,0
2020-04-20,Contra Costa,013,1133247,881,753,0,753,22
2020-04-20,Del Norte,015,27424,2,2,0,2,0
2020-04-20,El Dorado,017,186661,54,36,0,36,0
2020-04-20,Fresno,019,978130,678,356,6,362,7
2020-04-20,Glenn,021,27897,4,3,0,3,0
2020-04-20,Humboldt,023,135768,58,53,0,53,0
2020-04-20,Imperial,025,180216,342,149,0,149,2
2020-04-20,Inyo,027,18085,19,17,0,17,0
2020-04-20,Kern,029,883053,876,651,1,652,3
2020-04-20,Kings,031,150075,80,19,1,20,1
2020-04-20,Lake,033,64148,6,6,0,6,0
2020-04-20,Lassen,035,31185,3,0,2,2,0
2020-04-20,Los Angeles,037,10098052,20864,13787,15,13802,608
2020-04-20,Madera,039,155013,74,35,1,36,2
2020-04-20,Marin,041,260295,213,200,1,201,10
2020-04-20,Mariposa,043,17540,5,0,0,0,0
2020-04-20,Mendocino,045,87422,6,5,0,5,0
2020-04-20,Merced,047,269075,136,88,0,88,3
2020-04-20,Modoc,049,8938,0,0,0,0,0
2020-04-20,Mono,051,14174,29,23,0,23,1
2020-04-20,Monterey,053,433212,214,147,0,147,4
2020-04-20,Napa,055,140530,66,55,0,55,2
2020-04-20,Nevada,057,99092,41,34,1,35,1
2020-04-20,Orange,059,3164182,2609,1679,22,1701,33
2020-04-20,Placer,061,380077,155,132,0,132,8
2020-04-20,Plumas,063,18699,4,4,0,4,0
2020-04-20,Riverside,065,2383286,3871,2477,14,2491,61
2020-04-20,Sacramento,067,1510023,1041,924,0,924,32
2020-04-20,San Benito,069,59416,44,43,0,43,2
2020-04-20,San Bernardino,071,2135413,1943,1344,1,1345,63
2020-04-20,San Diego,073,3302833,3269,2327,0,2327,72
2020-04-20,San Francisco,075,870044,1489,1223,0,1223,19
2020-04-20,San Joaquin,077,732212,524,422,3,425,17
2020-04-20,San Luis Obispo,079,281455,205,132,3,135,1
2020-04-20,San Mateo,081,765935,1198,890,2,892,31
2020-04-20,Santa Barbara,083,443738,469,388,2,390,4
2020-04-20,Santa Clara,085,1922200,2352,1920,5,1925,84
2020-04-20,Santa Cruz,087,273765,129,102,0,102,2
2020-04-20,Shasta,089,179085,33,26,0,26,3
2020-04-20,Sierra,091,2930,0,0,0,0,0
2020-04-20,Siskiyou,093,43540,5,5,0,5,0
2020-04-20,Solano,095,438530,236,185,0,185,2
2020-04-20,Sonoma,097,501317,217,178,0,178,1
2020-04-20,Stanislaus,099,539301,301,228,4,232,3
2020-04-20,Sutter,101,95872,27,22,0,22,2
2020-04-20,Tehama,103,63373,1,1,0,1,1
2020-04-20,Trinity,105,12862,0,0,0,0,0
2020-04-20,Tulare,107,460477,659,401,5,406,20
2020-04-20,Tuolumne,109,53932,3,2,0,2,0
2020-04-20,Ventura,111,848112,565,426,1,427,13
2020-04-20,Yolo,113,214977,175,125,0,125,5
2020-04-20,Yuba,115,75493,16,15,0,15,1
2020-04-19,Alameda,001,1643700,1496,1134,2,1136,41
2020-04-19,Alpine,003,1148,1,1,0,1,0
2020-04-19,Amador,005,37829,7,7,0,7,0
2020-04-19,Butte,007,227075,22,15,1,16,0
2020-04-19,Calaveras,009,45235,12,12,0,12,0
2020-04-19,Colusa,011,21464,3,3,0,3,0
2020-04-19,Contra Costa,013,1133247,865,731,0,731,20
2020-04-19,Del Norte,015,27424,2,2,0,2,0
2020-04-19,El Dorado,017,186661,54,36,0,36,0
2020-04-19,Fresno,019,978130,642,326,6,332,7
2020-04-19,Glenn,021,27897,4,3,0,3,0
2020-04-19,Humboldt,023,135768,58,53,0,53,0
2020-04-19,Imperial,025,180216,316,144,0,144,2
2020-04-19,Inyo,027,18085,19,17,0,17,0
2020-04-19,Kern,029,883053,851,629,1,630,3
2020-04-19,Kings,031,150075,70,17,1,18,1
2020-04-19,Lake,033,64148,6,6,0,6,0
2020-04-19,Lassen,035,31185,3,0,2,2,0
2020-04-19,Los Angeles,037,10098052,19867,12299,15,12314,589
2020-04-19,Madera,039,155013,72,34,1,35,2
2020-04-19,Marin,041,260295,212,194,1,195,10
2020-04-19,Mariposa,043,17540,2,0,0,0,0
2020-04-19,Mendocino,045,87422,6,4,0,4,0
2020-04-19,Merced,047,269075,131,85,0,85,3
2020-04-19,Modoc,049,8938,0,0,0,0,0
2020-04-19,Mono,051,14174,29,23,0,23,1
2020-04-19,Monterey,053,433212,205,140,0,140,4
2020-04-19,Napa,055,140530,64,49,0,49,2
2020-04-19,Nevada,057,99092,40,34,1,35,1
2020-04-19,Orange,059,3164182,2512,1591,21,1612,32
2020-04-19,Placer,061,380077,154,131,0,131,8
2020-04-19,Plumas,063,18699,4,4,0,4,0
2020-04-19,Riverside,065,2383286,3728,2316,14,2330,56
2020-04-19,Sacramento,067,1510023,1014,912,0,912,32
2020-04-19,San Benito,069,59416,42,40,0,40,2
2020-04-19,San Bernardino,071,2135413,1880,1262,1,1263,58
2020-04-19,San Diego,073,3302833,3102,2270,0,2270,71
2020-04-19,San Francisco,075,870044,1456,1153,0,1153,19
2020-04-19,San Joaquin,077,732212,506,404,3,407,17
2020-04-19,San Luis Obispo,079,281455,200,132,3,135,1
2020-04-19,San Mateo,081,765935,1162,845,2,847,31
2020-04-19,Santa Barbara,083,443738,462,377,2,379,3
2020-04-19,Santa Clara,085,1922200,2307,1878,5,1883,81
2020-04-19,Santa Cruz,087,273765,126,98,0,98,2
2020-04-19,Shasta,089,179085,31,26,0,26,3
2020-04-19,Sierra,091,2930,0,0,0,0,0
2020-04-19,Siskiyou,093,43540,5,5,0,5,0
2020-04-19,Solano,095,438530,228,174,0,174,2
2020-04-19,Sonoma,097,501317,211,172,0,172,1
2020-04-19,Stanislaus,099,539301,293,221,4,225,3
2020-04-19,Sutter,101,95872,26,21,0,21,2
2020-04-19,Tehama,103,63373,1,1,0,1,1
2020-04-19,Trinity,105,12862,0,0,0,0,0
2020-04-19,Tulare,107,460477,613,391,5,396,17
2020-04-19,Tuolumne,109,53932,3,2,0,2,0
2020-04-19,Ventura,111,848112,557,418,1,419,13
2020-04-19,Yolo,113,214977,175,120,0,120,5
2020-04-19,Yuba,115,75493,16,15,0,15,1
2020-04-18,Alameda,001,1643700,1471,1085,2,1087,40
2020-04-18,Alpine,003,1148,1,1,0,1,0
2020-04-18,Amador,005,37829,7,7,0,7,0
2020-04-18,Butte,007,227075,21,15,1,16,0
2020-04-18,Calaveras,009,45235,12,12,0,12,0
2020-04-18,Colusa,011,21464,3,3,0,3,0
2020-04-18,Contra Costa,013,1133247,853,721,0,721,17
2020-04-18,Del Norte,015,27424,2,2,0,2,0
2020-04-18,El Dorado,017,186661,54,36,0,36,0
2020-04-18,Fresno,019,978130,622,319,6,325,7
2020-04-18,Glenn,021,27897,4,3,0,3,0
2020-04-18,Humboldt,023,135768,58,52,0,52,0
2020-04-18,Imperial,025,180216,307,137,0,137,2
2020-04-18,Inyo,027,18085,19,17,0,17,0
2020-04-18,Kern,029,883053,829,626,1,627,3
2020-04-18,Kings,031,150075,69,17,1,18,1
2020-04-18,Lake,033,64148,6,6,0,6,0
2020-04-18,Lassen,035,31185,3,0,2,2,0
2020-04-18,Los Angeles,037,10098052,19339,11984,15,11999,566
2020-04-18,Madera,039,155013,71,34,1,35,2
2020-04-18,Marin,041,260295,210,193,1,194,10
2020-04-18,Mariposa,043,17540,2,0,0,0,0
2020-04-18,Mendocino,045,87422,6,4,0,4,0
2020-04-18,Merced,047,269075,129,82,0,82,3
2020-04-18,Modoc,049,8938,0,0,0,0,0
2020-04-18,Mono,051,14174,29,22,0,22,1
2020-04-18,Monterey,053,433212,201,135,0,135,3
2020-04-18,Napa,055,140530,64,49,0,49,2
2020-04-18,Nevada,057,99092,39,34,1,35,1
2020-04-18,Orange,059,3164182,2448,1569,20,1589,32
2020-04-18,Placer,061,380077,152,130,0,130,8
2020-04-18,Plumas,063,18699,4,4,0,4,0
2020-04-18,Riverside,065,2383286,3653,2257,14,2271,56
2020-04-18,Sacramento,067,1510023,1002,901,0,901,32
2020-04-18,San Benito,069,59416,42,40,0,40,2
2020-04-18,San Bernardino,071,2135413,1835,1255,1,1256,58
2020-04-18,San Diego,073,3302833,3000,2215,0,2215,71
2020-04-18,San Francisco,075,870044,1417,1144,0,1144,19
2020-04-18,San Joaquin,077,732212,497,392,3,395,17
2020-04-18,San Luis Obispo,079,281455,196,129,3,132,1
2020-04-18,San Mateo,081,765935,1140,821,2,823,31
2020-04-18,Santa Barbara,083,443738,456,372,2,374,3
2020-04-18,Santa Clara,085,1922200,2274,1862,5,1867,79
2020-04-18,Santa Cruz,087,273765,124,96,0,96,2
2020-04-18,Shasta,089,179085,31,26,0,26,3
2020-04-18,Sierra,091,2930,0,0,0,0,0
2020-04-18,Siskiyou,093,43540,5,5,0,5,0
2020-04-18,Solano,095,438530,225,175,0,175,2
2020-04-18,Sonoma,097,501317,207,168,0,168,1
2020-04-18,Stanislaus,099,539301,285,216,4,220,3
2020-04-18,Sutter,101,95872,26,21,0,21,2
2020-04-18,Tehama,103,63373,1,1,0,1,1
2020-04-18,Trinity,105,12862,0,0,0,0,0
2020-04-18,Tulare,107,460477,602,385,5,390,17
2020-04-18,Tuolumne,109,53932,3,2,0,2,0
2020-04-18,Ventura,111,848112,549,416,1,417,13
2020-04-18,Yolo,113,214977,173,118,0,118,5
2020-04-18,Yuba,115,75493,16,14,0,14,1
2020-04-17,Alameda,001,1643700,1415,1043,1,1044,40
2020-04-17,Alpine,003,1148,1,1,0,1,0
2020-04-17,Amador,005,37829,7,7,0,7,0
2020-04-17,Butte,007,227075,21,15,1,16,0
2020-04-17,Calaveras,009,45235,12,11,0,11,0
2020-04-17,Colusa,011,21464,3,3,0,3,0
2020-04-17,Contra Costa,013,1133247,842,687,0,687,15
2020-04-17,Del Norte,015,27424,2,2,0,2,0
2020-04-17,El Dorado,017,186661,54,35,0,35,0
2020-04-17,Fresno,019,978130,600,315,6,321,7
2020-04-17,Glenn,021,27897,4,3,0,3,0
2020-04-17,Humboldt,023,135768,57,52,0,52,0
2020-04-17,Imperial,025,180216,298,135,0,135,2
2020-04-17,Inyo,027,18085,19,17,0,17,0
2020-04-17,Kern,029,883053,809,612,1,613,3
2020-04-17,Kings,031,150075,67,15,1,16,1
2020-04-17,Lake,033,64148,6,6,0,6,0
2020-04-17,Lassen,035,31185,3,0,2,2,0
2020-04-17,Los Angeles,037,10098052,18698,11354,15,11369,489
2020-04-17,Madera,039,155013,71,34,1,35,2
2020-04-17,Marin,041,260295,207,189,1,190,10
2020-04-17,Mariposa,043,17540,1,0,0,0,0
2020-04-17,Mendocino,045,87422,6,4,0,4,0
2020-04-17,Merced,047,269075,128,80,0,80,3
2020-04-17,Modoc,049,8938,0,0,0,0,0
2020-04-17,Mono,051,14174,29,22,0,22,1
2020-04-17,Monterey,053,433212,196,119,0,119,3
2020-04-17,Napa,055,140530,62,46,0,46,2
2020-04-17,Nevada,057,99092,38,34,1,35,1
2020-04-17,Orange,059,3164182,2397,1496,20,1516,31
2020-04-17,Placer,061,380077,152,130,0,130,8
2020-04-17,Plumas,063,18699,4,4,0,4,0
2020-04-17,Riverside,065,2383286,3526,2080,14,2094,50
2020-04-17,Sacramento,067,1510023,995,882,0,882,32
2020-04-17,San Benito,069,59416,42,38,0,38,2
2020-04-17,San Bernardino,071,2135413,1796,1229,1,1230,57
2020-04-17,San Diego,073,3302833,2910,2160,0,2160,70
2020-04-17,San Francisco,075,870044,1391,1090,0,1090,19
2020-04-17,San Joaquin,077,732212,486,356,3,359,17
2020-04-17,San Luis Obispo,079,281455,189,116,3,119,1
2020-04-17,San Mateo,081,765935,1124,768,2,770,31
2020-04-17,Santa Barbara,083,443738,451,349,2,351,3
2020-04-17,Santa Clara,085,1922200,2238,1834,5,1839,74
2020-04-17,Santa Cruz,087,273765,123,94,0,94,2
2020-04-17,Shasta,089,179085,31,26,0,26,3
2020-04-17,Sierra,091,2930,0,0,0,0,0
2020-04-17,Siskiyou,093,43540,5,5,0,5,0
2020-04-17,Solano,095,438530,224,173,0,173,2
2020-04-17,Sonoma,097,501317,204,167,0,167,1
2020-04-17,Stanislaus,099,539301,283,201,4,205,3
2020-04-17,Sutter,101,95872,26,20,0,20,2
2020-04-17,Tehama,103,63373,1,1,0,1,1
2020-04-17,Trinity,105,12862,0,0,0,0,0
2020-04-17,Tulare,107,460477,595,370,5,375,17
2020-04-17,Tuolumne,109,53932,3,2,0,2,0
2020-04-17,Ventura,111,848112,544,398,1,399,13
2020-04-17,Yolo,113,214977,172,117,0,117,5
2020-04-17,Yuba,115,75493,16,14,0,14,1
2020-04-16,Alameda,001,1643700,1381,981,1,982,39
2020-04-16,Alpine,003,1148,1,1,0,1,0
2020-04-16,Amador,005,37829,7,7,0,7,0
2020-04-16,Butte,007,227075,20,15,1,16,0
2020-04-16,Calaveras,009,45235,12,10,0,10,0
2020-04-16,Colusa,011,21464,3,3,0,3,0
2020-04-16,Contra Costa,013,1133247,828,675,0,675,14
2020-04-16,Del Norte,015,27424,2,2,0,2,0
2020-04-16,El Dorado,017,186661,53,34,0,34,0
2020-04-16,Fresno,019,978130,570,289,6,295,7
2020-04-16,Glenn,021,27897,4,3,0,3,0
2020-04-16,Humboldt,023,135768,57,47,0,47,0
2020-04-16,Imperial,025,180216,284,132,0,132,2
2020-04-16,Inyo,027,18085,17,17,0,17,0
2020-04-16,Kern,029,883053,782,587,1,588,3
2020-04-16,Kings,031,150075,63,12,1,13,1
2020-04-16,Lake,033,64148,6,6,0,6,0
2020-04-16,Lassen,035,31185,3,0,2,2,0
2020-04-16,Los Angeles,037,10098052,17807,10786,15,10801,447
2020-04-16,Madera,039,155013,69,34,1,35,2
2020-04-16,Marin,041,260295,203,170,1,171,10
2020-04-16,Mariposa,043,17540,1,1,0,1,0
2020-04-16,Mendocino,045,87422,6,4,0,4,0
2020-04-16,Merced,047,269075,122,76,0,76,3
2020-04-16,Modoc,049,8938,0,0,0,0,0
2020-04-16,Mono,051,14174,29,22,0,22,1
2020-04-16,Monterey,053,433212,193,116,0,116,3
2020-04-16,Napa,055,140530,59,44,0,44,2
2020-04-16,Nevada,057,99092,38,34,1,35,1
2020-04-16,Orange,059,3164182,2332,1439,19,1458,28
2020-04-16,Placer,061,380077,150,129,0,129,7
2020-04-16,Plumas,063,18699,4,4,0,4,0
2020-04-16,Riverside,065,2383286,3406,1913,14,1927,45
2020-04-16,Sacramento,067,1510023,987,865,0,865,32
2020-04-16,San Benito,069,59416,42,36,0,36,2
2020-04-16,San Bernardino,071,2135413,1715,1143,0,1143,54
2020-04-16,San Diego,073,3302833,2802,2089,0,2089,63
2020-04-16,San Francisco,075,870044,1347,1039,0,1039,16
2020-04-16,San Joaquin,077,732212,471,345,3,348,17
2020-04-16,San Luis Obispo,079,281455,185,113,3,116,1
2020-04-16,San Mateo,081,765935,1095,745,2,747,29
2020-04-16,Santa Barbara,083,443738,440,331,2,333,3
2020-04-16,Santa Clara,085,1922200,2201,1789,5,1794,70
2020-04-16,Santa Cruz,087,273765,121,90,0,90,2
2020-04-16,Shasta,089,179085,31,25,0,25,3
2020-04-16,Sierra,091,2930,0,0,0,0,0
2020-04-16,Siskiyou,093,43540,5,5,0,5,0
2020-04-16,Solano,095,438530,221,162,0,162,2
2020-04-16,Sonoma,097,501317,199,145,0,145,1
2020-04-16,Stanislaus,099,539301,280,185,4,189,3
2020-04-16,Sutter,101,95872,25,21,0,21,2
2020-04-16,Tehama,103,63373,1,1,0,1,1
2020-04-16,Trinity,105,12862,0,0,0,0,0
2020-04-16,Tulare,107,460477,578,305,5,310,16
2020-04-16,Tuolumne,109,53932,3,1,0,1,0
2020-04-16,Ventura,111,848112,532,384,1,385,13
2020-04-16,Yolo,113,214977,170,98,0,98,4
2020-04-16,Yuba,115,75493,15,14,0,14,1
2020-04-15,Alameda,001,1643700,1331,915,1,916,38
2020-04-15,Alpine,003,1148,1,1,0,1,0
2020-04-15,Amador,005,37829,7,7,0,7,0
2020-04-15,Butte,007,227075,20,14,1,15,0
2020-04-15,Calaveras,009,45235,11,9,0,9,0
2020-04-15,Colusa,011,21464,3,3,0,3,0
2020-04-15,Contra Costa,013,1133247,806,645,0,645,14
2020-04-15,Del Norte,015,27424,2,2,0,2,0
2020-04-15,El Dorado,017,186661,51,33,0,33,0
2020-04-15,Fresno,019,978130,544,264,6,270,7
2020-04-15,Glenn,021,27897,4,3,0,3,0
2020-04-15,Humboldt,023,135768,57,47,0,47,0
2020-04-15,Imperial,025,180216,257,115,0,115,2
2020-04-15,Inyo,027,18085,17,12,0,12,0
2020-04-15,Kern,029,883053,760,500,1,501,3
2020-04-15,Kings,031,150075,59,12,1,13,1
2020-04-15,Lake,033,64148,6,4,0,4,0
2020-04-15,Lassen,035,31185,3,0,2,2,0
2020-04-15,Los Angeles,037,10098052,16979,10416,14,10430,394
2020-04-15,Madera,039,155013,69,30,1,31,2
2020-04-15,Marin,041,260295,200,162,1,163,10
2020-04-15,Mariposa,043,17540,0,0,0,0,0
2020-04-15,Mendocino,045,87422,5,4,0,4,0
2020-04-15,Merced,047,269075,120,74,0,74,3
2020-04-15,Modoc,049,8938,0,0,0,0,0
2020-04-15,Mono,051,14174,29,22,0,22,1
2020-04-15,Monterey,053,433212,185,106,0,106,3
2020-04-15,Napa,055,140530,56,34,0,34,2
2020-04-15,Nevada,057,99092,37,34,1,35,1
2020-04-15,Orange,059,3164182,2229,1377,19,1396,24
2020-04-15,Placer,061,380077,149,123,0,123,6
2020-04-15,Plumas,063,18699,4,4,0,4,0
2020-04-15,Riverside,065,2383286,3211,1723,14,1737,42
2020-04-15,Sacramento,067,1510023,978,839,0,839,32
2020-04-15,San Benito,069,59416,42,34,0,34,2
2020-04-15,San Bernardino,071,2135413,1645,1063,0,1063,45
2020-04-15,San Diego,073,3302833,2714,2014,0,2014,60
2020-04-15,San Francisco,075,870044,1311,1006,0,1006,16
2020-04-15,San Joaquin,077,732212,463,329,3,332,17
2020-04-15,San Luis Obispo,079,281455,177,112,3,115,1
2020-04-15,San Mateo,081,765935,1046,707,2,709,28
2020-04-15,Santa Barbara,083,443738,424,317,2,319,2
2020-04-15,Santa Clara,085,1922200,2162,1692,5,1697,69
2020-04-15,Santa Cruz,087,273765,117,92,0,92,2
2020-04-15,Shasta,089,179085,31,25,0,25,3
2020-04-15,Sierra,091,2930,0,0,0,0,0
2020-04-15,Siskiyou,093,43540,5,5,0,5,0
2020-04-15,Solano,095,438530,216,153,0,153,2
2020-04-15,Sonoma,097,501317,197,140,0,140,1
2020-04-15,Stanislaus,099,539301,273,174,4,178,3
2020-04-15,Sutter,101,95872,25,19,0,19,2
2020-04-15,Tehama,103,63373,1,1,0,1,1
2020-04-15,Trinity,105,12862,0,0,0,0,0
2020-04-15,Tulare,107,460477,560,289,5,294,14
2020-04-15,Tuolumne,109,53932,3,1,0,1,0
2020-04-15,Ventura,111,848112,517,365,1,366,13
2020-04-15,Yolo,113,214977,163,93,0,93,3
2020-04-15,Yuba,115,75493,15,15,0,15,1
2020-04-14,Alameda,001,1643700,1286,843,1,844,30
2020-04-14,Alpine,003,1148,1,1,0,1,0
2020-04-14,Amador,005,37829,7,6,0,6,0
2020-04-14,Butte,007,227075,20,13,1,14,0
2020-04-14,Calaveras,009,45235,11,5,0,5,0
2020-04-14,Colusa,011,21464,3,3,0,3,0
2020-04-14,Contra Costa,013,1133247,794,617,0,617,12
2020-04-14,Del Norte,015,27424,2,2,0,2,0
2020-04-14,El Dorado,017,186661,51,30,0,30,0
2020-04-14,Fresno,019,978130,521,244,6,250,6
2020-04-14,Glenn,021,27897,4,3,0,3,0
2020-04-14,Humboldt,023,135768,57,44,0,44,0
2020-04-14,Imperial,025,180216,237,86,0,86,2
2020-04-14,Inyo,027,18085,17,12,0,12,0
2020-04-14,Kern,029,883053,736,453,1,454,3
2020-04-14,Kings,031,150075,58,12,1,13,1
2020-04-14,Lake,033,64148,6,3,0,3,0
2020-04-14,Lassen,035,31185,3,0,2,2,0
2020-04-14,Los Angeles,037,10098052,16083,9948,13,9961,357
2020-04-14,Madera,039,155013,68,29,1,30,2
2020-04-14,Marin,041,260295,196,147,1,148,9
2020-04-14,Mariposa,043,17540,0,0,0,0,0
2020-04-14,Mendocino,045,87422,5,4,0,4,0
2020-04-14,Merced,047,269075,113,61,0,61,3
2020-04-14,Modoc,049,8938,0,0,0,0,0
2020-04-14,Mono,051,14174,29,22,0,22,1
2020-04-14,Monterey,053,433212,180,98,0,98,3
2020-04-14,Napa,055,140530,56,33,0,33,2
2020-04-14,Nevada,057,99092,37,34,1,35,1
2020-04-14,Orange,059,3164182,2127,1362,19,1381,24
2020-04-14,Placer,061,380077,148,117,0,117,5
2020-04-14,Plumas,063,18699,4,3,0,3,0
2020-04-14,Riverside,065,2383286,3076,1467,14,1481,40
2020-04-14,Sacramento,067,1510023,969,737,0,737,29
2020-04-14,San Benito,069,59416,39,34,0,34,2
2020-04-14,San Bernardino,071,2135413,1590,933,0,933,37
2020-04-14,San Diego,073,3302833,2619,1932,0,1932,53
2020-04-14,San Francisco,075,870044,1257,968,0,968,14
2020-04-14,San Joaquin,077,732212,453,280,3,283,17
2020-04-14,San Luis Obispo,079,281455,174,109,3,112,1
2020-04-14,San Mateo,081,765935,1012,681,2,683,28
2020-04-14,Santa Barbara,083,443738,400,292,2,294,2
2020-04-14,Santa Clara,085,1922200,2129,1561,5,1566,63
2020-04-14,Santa Cruz,087,273765,109,84,0,84,2
2020-04-14,Shasta,089,179085,31,24,0,24,3
2020-04-14,Sierra,091,2930,0,0,0,0,0
2020-04-14,Siskiyou,093,43540,5,5,0,5,0
2020-04-14,Solano,095,438530,213,140,0,140,2
2020-04-14,Sonoma,097,501317,193,133,0,133,1
2020-04-14,Stanislaus,099,539301,260,136,4,140,3
2020-04-14,Sutter,101,95872,24,19,0,19,2
2020-04-14,Tehama,103,63373,1,1,0,1,1
2020-04-14,Trinity,105,12862,0,0,0,0,0
2020-04-14,Tulare,107,460477,536,228,5,233,12
2020-04-14,Tuolumne,109,53932,3,0,0,0,0
2020-04-14,Ventura,111,848112,504,328,1,329,11
2020-04-14,Yolo,113,214977,160,81,0,81,3
2020-04-14,Yuba,115,75493,14,14,0,14,1
2020-04-13,Alameda,001,1643700,1247,821,1,822,23
2020-04-13,Alpine,003,1148,1,1,0,1,0
2020-04-13,Amador,005,37829,7,6,0,6,0
2020-04-13,Butte,007,227075,19,13,1,14,0
2020-04-13,Calaveras,009,45235,10,5,0,5,0
2020-04-13,Colusa,011,21464,3,3,0,3,0
2020-04-13,Contra Costa,013,1133247,778,569,0,569,12
2020-04-13,Del Norte,015,27424,2,2,0,2,0
2020-04-13,El Dorado,017,186661,49,29,0,29,0
2020-04-13,Fresno,019,978130,499,205,5,210,4
2020-04-13,Glenn,021,27897,4,3,0,3,0
2020-04-13,Humboldt,023,135768,57,44,0,44,0
2020-04-13,Imperial,025,180216,219,82,0,82,2
2020-04-13,Inyo,027,18085,17,12,0,12,0
2020-04-13,Kern,029,883053,711,346,1,347,3
2020-04-13,Kings,031,150075,54,9,1,10,0
2020-04-13,Lake,033,64148,6,3,0,3,0
2020-04-13,Lassen,035,31185,3,0,2,2,0
2020-04-13,Los Angeles,037,10098052,15367,9367,13,9380,317
2020-04-13,Madera,039,155013,66,29,1,30,2
2020-04-13,Marin,041,260295,192,144,1,145,6
2020-04-13,Mariposa,043,17540,0,0,0,0,0
2020-04-13,Mendocino,045,87422,5,4,0,4,0
2020-04-13,Merced,047,269075,112,60,0,60,3
2020-04-13,Modoc,049,8938,0,0,0,0,0
2020-04-13,Mono,051,14174,29,21,0,21,1
2020-04-13,Monterey,053,433212,173,86,0,86,3
2020-04-13,Napa,055,140530,55,30,0,30,2
2020-04-13,Nevada,057,99092,37,24,1,25,1
2020-04-13,Orange,059,3164182,2054,1313,19,1332,21
2020-04-13,Placer,061,380077,147,116,0,116,5
2020-04-13,Plumas,063,18699,4,3,0,3,0
2020-04-13,Riverside,065,2383286,2935,1460,13,1473,35
2020-04-13,Sacramento,067,1510023,957,723,0,723,25
2020-04-13,San Benito,069,59416,38,33,0,33,2
2020-04-13,San Bernardino,071,2135413,1515,920,0,920,30
2020-04-13,San Diego,073,3302833,2536,1849,0,1849,47
2020-04-13,San Francisco,075,870044,1219,948,0,948,12
2020-04-13,San Joaquin,077,732212,438,255,3,258,16
2020-04-13,San Luis Obispo,079,281455,169,106,3,109,1
2020-04-13,San Mateo,081,765935,972,679,2,681,25
2020-04-13,Santa Barbara,083,443738,381,271,1,272,2
2020-04-13,Santa Clara,085,1922200,2083,1540,5,1545,58
2020-04-13,Santa Cruz,087,273765,103,82,0,82,1
2020-04-13,Shasta,089,179085,30,24,0,24,3
2020-04-13,Sierra,091,2930,0,0,0,0,0
2020-04-13,Siskiyou,093,43540,5,5,0,5,0
2020-04-13,Solano,095,438530,210,136,0,136,2
2020-04-13,Sonoma,097,501317,186,133,0,133,1
2020-04-13,Stanislaus,099,539301,254,130,4,134,1
2020-04-13,Sutter,101,95872,24,18,0,18,2
2020-04-13,Tehama,103,63373,1,1,0,1,0
2020-04-13,Trinity,105,12862,0,0,0,0,0
2020-04-13,Tulare,107,460477,500,185,5,190,11
2020-04-13,Tuolumne,109,53932,3,0,0,0,0
2020-04-13,Ventura,111,848112,483,309,0,309,9
2020-04-13,Yolo,113,214977,153,81,0,81,3
2020-04-13,Yuba,115,75493,14,13,0,13,1
2020-04-12,Alameda,001,1643700,1204,774,1,775,23
2020-04-12,Alpine,003,1148,1,1,0,1,0
2020-04-12,Amador,005,37829,7,6,0,6,0
2020-04-12,Butte,007,227075,19,13,1,14,0
2020-04-12,Calaveras,009,45235,10,5,0,5,0
2020-04-12,Colusa,011,21464,3,3,0,3,0
2020-04-12,Contra Costa,013,1133247,765,553,0,553,12
2020-04-12,Del Norte,015,27424,2,2,0,2,0
2020-04-12,El Dorado,017,186661,49,28,0,28,0
2020-04-12,Fresno,019,978130,470,205,5,210,4
2020-04-12,Glenn,021,27897,4,3,0,3,0
2020-04-12,Humboldt,023,135768,57,43,0,43,0
2020-04-12,Imperial,025,180216,196,78,0,78,2
2020-04-12,Inyo,027,18085,15,12,0,12,0
2020-04-12,Kern,029,883053,679,319,0,319,3
2020-04-12,Kings,031,150075,52,9,1,10,0
2020-04-12,Lake,033,64148,6,3,0,3,0
2020-04-12,Lassen,035,31185,3,0,2,2,0
2020-04-12,Los Angeles,037,10098052,14650,9133,13,9146,294
2020-04-12,Madera,039,155013,65,29,1,30,2
2020-04-12,Marin,041,260295,181,138,1,139,6
2020-04-12,Mariposa,043,17540,0,0,0,0,0
2020-04-12,Mendocino,045,87422,5,4,0,4,0
2020-04-12,Merced,047,269075,106,58,0,58,3
2020-04-12,Modoc,049,8938,0,0,0,0,0
2020-04-12,Mono,051,14174,29,20,0,20,1
2020-04-12,Monterey,053,433212,159,85,0,85,3
2020-04-12,Napa,055,140530,53,29,0,29,2
2020-04-12,Nevada,057,99092,37,24,1,25,1
2020-04-12,Orange,059,3164182,1994,1283,18,1301,21
2020-04-12,Placer,061,380077,146,114,0,114,4
2020-04-12,Plumas,063,18699,4,3,0,3,0
2020-04-12,Riverside,065,2383286,2753,1330,13,1343,34
2020-04-12,Sacramento,067,1510023,920,689,0,689,25
2020-04-12,San Benito,069,59416,36,33,0,33,2
2020-04-12,San Bernardino,071,2135413,1439,827,0,827,30
2020-04-12,San Diego,073,3302833,2446,1806,0,1806,45
2020-04-12,San Francisco,075,870044,1192,886,0,886,11
2020-04-12,San Joaquin,077,732212,420,246,3,249,15
2020-04-12,San Luis Obispo,079,281455,166,102,2,104,1
2020-04-12,San Mateo,081,765935,946,664,2,666,25
2020-04-12,Santa Barbara,083,443738,362,261,1,262,2
2020-04-12,Santa Clara,085,1922200,2055,1461,5,1466,53
2020-04-12,Santa Cruz,087,273765,102,80,0,80,1
2020-04-12,Shasta,089,179085,30,24,0,24,3
2020-04-12,Sierra,091,2930,0,0,0,0,0
2020-04-12,Siskiyou,093,43540,5,5,0,5,0
2020-04-12,Solano,095,438530,204,136,0,136,2
2020-04-12,Sonoma,097,501317,183,131,0,131,1
2020-04-12,Stanislaus,099,539301,246,117,4,121,1
2020-04-12,Sutter,101,95872,23,18,0,18,2
2020-04-12,Tehama,103,63373,1,1,0,1,0
2020-04-12,Trinity,105,12862,0,0,0,0,0
2020-04-12,Tulare,107,460477,488,166,5,171,11
2020-04-12,Tuolumne,109,53932,3,0,0,0,0
2020-04-12,Ventura,111,848112,473,306,0,306,9
2020-04-12,Yolo,113,214977,139,67,0,67,3
2020-04-12,Yuba,115,75493,14,13,0,13,1
2020-04-11,Alameda,001,1643700,1163,751,1,752,23
2020-04-11,Alpine,003,1148,1,1,0,1,0
2020-04-11,Amador,005,37829,7,6,0,6,0
2020-04-11,Butte,007,227075,19,13,1,14,0
2020-04-11,Calaveras,009,45235,10,5,0,5,0
2020-04-11,Colusa,011,21464,3,3,0,3,0
2020-04-11,Contra Costa,013,1133247,756,550,0,550,12
2020-04-11,Del Norte,015,27424,2,2,0,2,0
2020-04-11,El Dorado,017,186661,48,29,0,29,0
2020-04-11,Fresno,019,978130,460,201,5,206,4
2020-04-11,Glenn,021,27897,4,3,0,3,0
2020-04-11,Humboldt,023,135768,57,38,0,38,0
2020-04-11,Imperial,025,180216,186,78,0,78,2
2020-04-11,Inyo,027,18085,15,12,0,12,0
2020-04-11,Kern,029,883053,651,304,0,304,3
2020-04-11,Kings,031,150075,49,9,1,10,0
2020-04-11,Lake,033,64148,6,3,0,3,0
2020-04-11,Lassen,035,31185,3,0,2,2,0
2020-04-11,Los Angeles,037,10098052,14176,8823,13,8836,262
2020-04-11,Madera,039,155013,64,29,1,30,2
2020-04-11,Marin,041,260295,178,136,1,137,6
2020-04-11,Mariposa,043,17540,0,0,0,0,0
2020-04-11,Mendocino,045,87422,5,4,0,4,0
2020-04-11,Merced,047,269075,103,59,0,59,3
2020-04-11,Modoc,049,8938,0,0,0,0,0
2020-04-11,Mono,051,14174,29,20,0,20,1
2020-04-11,Monterey,053,433212,153,78,0,78,3
2020-04-11,Napa,055,140530,53,29,0,29,2
2020-04-11,Nevada,057,99092,37,24,1,25,1
2020-04-11,Orange,059,3164182,1932,1267,18,1285,21
2020-04-11,Placer,061,380077,146,113,0,113,4
2020-04-11,Plumas,063,18699,4,3,0,3,0
2020-04-11,Riverside,065,2383286,2674,1260,13,1273,33
2020-04-11,Sacramento,067,1510023,909,685,0,685,25
2020-04-11,San Benito,069,59416,36,33,0,33,2
2020-04-11,San Bernardino,071,2135413,1403,826,0,826,28
2020-04-11,San Diego,073,3302833,2380,1763,0,1763,45
2020-04-11,San Francisco,075,870044,1170,860,0,860,11
2020-04-11,San Joaquin,077,732212,415,244,3,247,15
2020-04-11,San Luis Obispo,079,281455,166,100,1,101,1
2020-04-11,San Mateo,081,765935,934,662,2,664,25
2020-04-11,Santa Barbara,083,443738,354,258,1,259,2
2020-04-11,Santa Clara,085,1922200,1996,1441,5,1446,51
2020-04-11,Santa Cruz,087,273765,102,79,0,79,1
2020-04-11,Shasta,089,179085,30,24,0,24,3
2020-04-11,Sierra,091,2930,0,0,0,0,0
2020-04-11,Siskiyou,093,43540,5,5,0,5,0
2020-04-11,Solano,095,438530,200,138,0,138,2
2020-04-11,Sonoma,097,501317,181,131,0,131,1
2020-04-11,Stanislaus,099,539301,238,119,3,122,1
2020-04-11,Sutter,101,95872,23,18,0,18,2
2020-04-11,Tehama,103,63373,1,1,0,1,0
2020-04-11,Trinity,105,12862,0,0,0,0,0
2020-04-11,Tulare,107,460477,466,168,5,173,10
2020-04-11,Tuolumne,109,53932,3,0,0,0,0
2020-04-11,Ventura,111,848112,463,304,0,304,9
2020-04-11,Yolo,113,214977,136,67,0,67,3
2020-04-11,Yuba,115,75493,14,13,0,13,1
2020-04-10,Alameda,001,1643700,1122,706,1,707,21
2020-04-10,Alpine,003,1148,1,1,0,1,0
2020-04-10,Amador,005,37829,7,5,0,5,0
2020-04-10,Butte,007,227075,19,13,1,14,0
2020-04-10,Calaveras,009,45235,10,5,0,5,0
2020-04-10,Colusa,011,21464,3,3,0,3,0
2020-04-10,Contra Costa,013,1133247,743,537,0,537,10
2020-04-10,Del Norte,015,27424,2,2,0,2,0
2020-04-10,El Dorado,017,186661,48,26,0,26,0
2020-04-10,Fresno,019,978130,453,186,4,190,3
2020-04-10,Glenn,021,27897,4,3,0,3,0
2020-04-10,Humboldt,023,135768,57,36,0,36,0
2020-04-10,Imperial,025,180216,179,70,0,70,2
2020-04-10,Inyo,027,18085,13,11,0,11,0
2020-04-10,Kern,029,883053,627,272,0,272,3
2020-04-10,Kings,031,150075,46,7,1,8,0
2020-04-10,Lake,033,64148,6,3,0,3,0
2020-04-10,Lassen,035,31185,3,0,2,2,0
2020-04-10,Los Angeles,037,10098052,13660,8384,12,8396,239
2020-04-10,Madera,039,155013,63,29,1,30,2
2020-04-10,Marin,041,260295,173,128,1,129,6
2020-04-10,Mariposa,043,17540,0,0,0,0,0
2020-04-10,Mendocino,045,87422,5,4,0,4,0
2020-04-10,Merced,047,269075,100,56,0,56,3
2020-04-10,Modoc,049,8938,0,0,0,0,0
2020-04-10,Mono,051,14174,29,20,0,20,1
2020-04-10,Monterey,053,433212,142,78,0,78,3
2020-04-10,Napa,055,140530,50,28,0,28,2
2020-04-10,Nevada,057,99092,37,23,1,24,1
2020-04-10,Orange,059,3164182,1885,1167,18,1185,21
2020-04-10,Placer,061,380077,145,112,0,112,4
2020-04-10,Plumas,063,18699,4,3,0,3,0
2020-04-10,Riverside,065,2383286,2608,1162,13,1175,30
2020-04-10,Sacramento,067,1510023,900,642,0,642,24
2020-04-10,San Benito,069,59416,36,32,0,32,2
2020-04-10,San Bernardino,071,2135413,1355,779,0,779,27
2020-04-10,San Diego,073,3302833,2320,1695,0,1695,44
2020-04-10,San Francisco,075,870044,1139,797,0,797,10
2020-04-10,San Joaquin,077,732212,403,234,3,237,14
2020-04-10,San Luis Obispo,079,281455,166,97,1,98,1
2020-04-10,San Mateo,081,765935,918,642,2,644,24
2020-04-10,Santa Barbara,083,443738,346,254,1,255,2
2020-04-10,Santa Clara,085,1922200,1944,1351,5,1356,50
2020-04-10,Santa Cruz,087,273765,101,75,0,75,1
2020-04-10,Shasta,089,179085,30,24,0,24,3
2020-04-10,Sierra,091,2930,0,0,0,0,0
2020-04-10,Siskiyou,093,43540,5,5,0,5,0
2020-04-10,Solano,095,438530,197,129,0,129,2
2020-04-10,Sonoma,097,501317,180,129,0,129,1
2020-04-10,Stanislaus,099,539301,231,101,3,104,0
2020-04-10,Sutter,101,95872,23,18,0,18,2
2020-04-10,Tehama,103,63373,1,1,0,1,0
2020-04-10,Trinity,105,12862,0,0,0,0,0
2020-04-10,Tulare,107,460477,424,163,5,168,10
2020-04-10,Tuolumne,109,53932,3,0,0,0,0
2020-04-10,Ventura,111,848112,454,290,0,290,9
2020-04-10,Yolo,113,214977,134,62,0,62,3
2020-04-10,Yuba,115,75493,14,13,0,13,1
2020-04-09,Alameda,001,1643700,1072,641,1,642,17
2020-04-09,Alpine,003,1148,1,1,0,1,0
2020-04-09,Amador,005,37829,7,2,0,2,0
2020-04-09,Butte,007,227075,19,12,1,13,0
2020-04-09,Calaveras,009,45235,10,5,0,5,0
2020-04-09,Colusa,011,21464,3,3,0,3,0
2020-04-09,Contra Costa,013,1133247,700,505,0,505,7
2020-04-09,Del Norte,015,27424,2,2,0,2,0
2020-04-09,El Dorado,017,186661,47,25,0,25,0
2020-04-09,Fresno,019,978130,428,165,4,169,3
2020-04-09,Glenn,021,27897,4,2,0,2,0
2020-04-09,Humboldt,023,135768,57,36,0,36,0
2020-04-09,Imperial,025,180216,158,67,0,67,2
2020-04-09,Inyo,027,18085,12,11,0,11,0
2020-04-09,Kern,029,883053,591,241,0,241,2
2020-04-09,Kings,031,150075,43,5,1,6,0
2020-04-09,Lake,033,64148,5,1,0,1,0
2020-04-09,Lassen,035,31185,3,0,2,2,0
2020-04-09,Los Angeles,037,10098052,13031,7919,12,7931,220
2020-04-09,Madera,039,155013,63,28,1,29,2
2020-04-09,Marin,041,260295,171,126,1,127,7
2020-04-09,Mariposa,043,17540,0,0,0,0,0
2020-04-09,Mendocino,045,87422,5,4,0,4,0
2020-04-09,Merced,047,269075,97,41,0,41,3
2020-04-09,Modoc,049,8938,0,0,0,0,0
2020-04-09,Mono,051,14174,29,19,0,19,1
2020-04-09,Monterey,053,433212,124,70,0,70,3
2020-04-09,Napa,055,140530,46,27,0,27,2
2020-04-09,Nevada,057,99092,36,23,1,24,1
2020-04-09,Orange,059,3164182,1811,1105,18,1123,19
2020-04-09,Placer,061,380077,144,107,0,107,4
2020-04-09,Plumas,063,18699,4,3,0,3,0
2020-04-09,Riverside,065,2383286,2465,1083,13,1096,29
2020-04-09,Sacramento,067,1510023,877,601,0,601,21
2020-04-09,San Benito,069,59416,36,32,0,32,2
2020-04-09,San Bernardino,071,2135413,1286,717,0,717,27
2020-04-09,San Diego,073,3302833,2224,1630,0,1630,40
2020-04-09,San Francisco,075,870044,1119,748,0,748,8
2020-04-09,San Joaquin,077,732212,382,223,3,226,14
2020-04-09,San Luis Obispo,079,281455,158,93,1,94,1
2020-04-09,San Mateo,081,765935,902,630,2,632,23
2020-04-09,Santa Barbara,083,443738,336,232,1,233,2
2020-04-09,Santa Clara,085,1922200,1874,1301,5,1306,49
2020-04-09,Santa Cruz,087,273765,101,73,0,73,1
2020-04-09,Shasta,089,179085,30,22,0,22,3
2020-04-09,Sierra,091,2930,0,0,0,0,0
2020-04-09,Siskiyou,093,43540,5,4,0,4,0
2020-04-09,Solano,095,438530,188,118,0,118,2
2020-04-09,Sonoma,097,501317,176,113,0,113,1
2020-04-09,Stanislaus,099,539301,219,93,3,96,0
2020-04-09,Sutter,101,95872,23,17,0,17,2
2020-04-09,Tehama,103,63373,1,1,0,1,0
2020-04-09,Trinity,105,12862,0,0,0,0,0
2020-04-09,Tulare,107,460477,395,147,5,152,9
2020-04-09,Tuolumne,109,53932,3,0,0,0,0
2020-04-09,Ventura,111,848112,435,273,0,273,9
2020-04-09,Yolo,113,214977,125,59,0,59,3
2020-04-09,Yuba,115,75493,14,13,0,13,0
2020-04-08,Alameda,001,1643700,1030,594,1,595,15
2020-04-08,Alpine,003,1148,1,1,0,1,0
2020-04-08,Amador,005,37829,7,2,0,2,0
2020-04-08,Butte,007,227075,18,11,1,12,0
2020-04-08,Calaveras,009,45235,10,5,0,5,0
2020-04-08,Colusa,011,21464,3,3,0,3,0
2020-04-08,Contra Costa,013,1133247,687,481,0,481,7
2020-04-08,Del Norte,015,27424,2,2,0,2,0
2020-04-08,El Dorado,017,186661,47,25,0,25,0
2020-04-08,Fresno,019,978130,408,151,4,155,3
2020-04-08,Glenn,021,27897,4,2,0,2,0
2020-04-08,Humboldt,023,135768,57,40,0,40,0
2020-04-08,Imperial,025,180216,147,59,0,59,2
2020-04-08,Inyo,027,18085,12,11,0,11,0
2020-04-08,Kern,029,883053,550,198,0,198,2
2020-04-08,Kings,031,150075,43,5,1,6,0
2020-04-08,Lake,033,64148,5,1,0,1,0
2020-04-08,Lassen,035,31185,3,0,2,2,0
2020-04-08,Los Angeles,037,10098052,12429,7505,12,7517,196
2020-04-08,Madera,039,155013,62,28,1,29,2
2020-04-08,Marin,041,260295,165,125,1,126,7
2020-04-08,Mariposa,043,17540,0,0,0,0,0
2020-04-08,Mendocino,045,87422,5,4,0,4,0
2020-04-08,Merced,047,269075,82,35,0,35,1
2020-04-08,Modoc,049,8938,0,0,0,0,0
2020-04-08,Mono,051,14174,29,19,0,19,1
2020-04-08,Monterey,053,433212,115,68,0,68,3
2020-04-08,Napa,055,140530,44,21,0,21,2
2020-04-08,Nevada,057,99092,36,21,1,22,1
2020-04-08,Orange,059,3164182,1748,1034,18,1052,19
2020-04-08,Placer,061,380077,144,102,0,102,4
2020-04-08,Plumas,063,18699,4,3,0,3,0
2020-04-08,Riverside,065,2383286,2308,974,13,987,28
2020-04-08,Sacramento,067,1510023,843,565,0,565,21
2020-04-08,San Benito,069,59416,36,31,0,31,2
2020-04-08,San Bernardino,071,2135413,1229,635,0,635,22
2020-04-08,San Diego,073,3302833,2150,1532,0,1532,36
2020-04-08,San Francisco,075,870044,1052,687,0,687,7
2020-04-08,San Joaquin,077,732212,365,211,3,214,12
2020-04-08,San Luis Obispo,079,281455,156,90,1,91,1
2020-04-08,San Mateo,081,765935,887,608,2,610,22
2020-04-08,Santa Barbara,083,443738,319,221,1,222,2
2020-04-08,Santa Clara,085,1922200,1829,1257,5,1262,47
2020-04-08,Santa Cruz,087,273765,100,69,0,69,1
2020-04-08,Shasta,089,179085,30,18,0,18,3
2020-04-08,Sierra,091,2930,0,0,0,0,0
2020-04-08,Siskiyou,093,43540,5,4,0,4,0
2020-04-08,Solano,095,438530,175,111,0,111,2
2020-04-08,Sonoma,097,501317,170,107,0,107,1
2020-04-08,Stanislaus,099,539301,203,86,3,89,0
2020-04-08,Sutter,101,95872,22,17,0,17,2
2020-04-08,Tehama,103,63373,1,1,0,1,0
2020-04-08,Trinity,105,12862,0,0,0,0,0
2020-04-08,Tulare,107,460477,364,145,5,150,6
2020-04-08,Tuolumne,109,53932,3,0,0,0,0
2020-04-08,Ventura,111,848112,426,263,0,263,7
2020-04-08,Yolo,113,214977,108,56,0,56,3
2020-04-08,Yuba,115,75493,14,10,0,10,0
2020-04-07,Alameda,001,1643700,995,560,1,561,14
2020-04-07,Alpine,003,1148,1,1,0,1,0
2020-04-07,Amador,005,37829,7,2,0,2,0
2020-04-07,Butte,007,227075,17,11,1,12,0
2020-04-07,Calaveras,009,45235,9,5,0,5,0
2020-04-07,Colusa,011,21464,3,2,0,2,0
2020-04-07,Contra Costa,013,1133247,667,471,0,471,7
2020-04-07,Del Norte,015,27424,2,2,0,2,0
2020-04-07,El Dorado,017,186661,46,22,0,22,0
2020-04-07,Fresno,019,978130,393,138,4,142,3
2020-04-07,Glenn,021,27897,4,2,0,2,0
2020-04-07,Humboldt,023,135768,56,40,0,40,0
2020-04-07,Imperial,025,180216,128,53,0,53,2
2020-04-07,Inyo,027,18085,12,11,0,11,0
2020-04-07,Kern,029,883053,507,134,0,134,2
2020-04-07,Kings,031,150075,40,5,1,6,0
2020-04-07,Lake,033,64148,4,1,0,1,0
2020-04-07,Lassen,035,31185,3,0,2,2,0
2020-04-07,Los Angeles,037,10098052,11780,6885,12,6897,170
2020-04-07,Madera,039,155013,60,28,0,28,2
2020-04-07,Marin,041,260295,163,122,1,123,7
2020-04-07,Mariposa,043,17540,0,0,0,0,0
2020-04-07,Mendocino,045,87422,5,4,0,4,0
2020-04-07,Merced,047,269075,67,27,0,27,1
2020-04-07,Modoc,049,8938,0,0,0,0,0
2020-04-07,Mono,051,14174,28,18,0,18,1
2020-04-07,Monterey,053,433212,107,63,0,63,2
2020-04-07,Napa,055,140530,42,18,0,18,2
2020-04-07,Nevada,057,99092,36,20,1,21,1
2020-04-07,Orange,059,3164182,1701,971,16,987,19
2020-04-07,Placer,061,380077,139,94,0,94,3
2020-04-07,Plumas,063,18699,4,3,0,3,0
2020-04-07,Riverside,065,2383286,2151,905,13,918,25
2020-04-07,Sacramento,067,1510023,813,513,0,513,18
2020-04-07,San Benito,069,59416,36,26,0,26,2
2020-04-07,San Bernardino,071,2135413,1162,554,0,554,19
2020-04-07,San Diego,073,3302833,2073,1456,0,1456,31
2020-04-07,San Francisco,075,870044,992,636,0,636,6
2020-04-07,San Joaquin,077,732212,347,198,3,201,12
2020-04-07,San Luis Obispo,079,281455,149,87,1,88,1
2020-04-07,San Mateo,081,765935,866,573,2,575,22
2020-04-07,Santa Barbara,083,443738,305,209,1,210,2
2020-04-07,Santa Clara,085,1922200,1760,1193,4,1197,46
2020-04-07,Santa Cruz,087,273765,100,67,0,67,1
2020-04-07,Shasta,089,179085,29,16,0,16,3
2020-04-07,Sierra,091,2930,0,0,0,0,0
2020-04-07,Siskiyou,093,43540,5,4,0,4,0
2020-04-07,Solano,095,438530,170,99,0,99,1
2020-04-07,Sonoma,097,501317,167,102,0,102,1
2020-04-07,Stanislaus,099,539301,186,83,3,86,0
2020-04-07,Sutter,101,95872,22,16,0,16,2
2020-04-07,Tehama,103,63373,1,1,0,1,0
2020-04-07,Trinity,105,12862,0,0,0,0,0
2020-04-07,Tulare,107,460477,335,144,5,149,5
2020-04-07,Tuolumne,109,53932,3,1,0,1,0
2020-04-07,Ventura,111,848112,409,247,0,247,6
2020-04-07,Yolo,113,214977,101,51,0,51,2
2020-04-07,Yuba,115,75493,14,10,0,10,0
2020-04-06,Alameda,001,1643700,965,527,1,528,13
2020-04-06,Alpine,003,1148,1,1,0,1,0
2020-04-06,Amador,005,37829,6,2,0,2,0
2020-04-06,Butte,007,227075,16,11,1,12,0
2020-04-06,Calaveras,009,45235,9,4,0,4,0
2020-04-06,Colusa,011,21464,3,1,0,1,0
2020-04-06,Contra Costa,013,1133247,642,447,0,447,7
2020-04-06,Del Norte,015,27424,2,2,0,2,0
2020-04-06,El Dorado,017,186661,44,23,0,23,0
2020-04-06,Fresno,019,978130,371,122,4,126,1
2020-04-06,Glenn,021,27897,4,2,0,2,0
2020-04-06,Humboldt,023,135768,55,37,0,37,0
2020-04-06,Imperial,025,180216,121,47,0,47,1
2020-04-06,Inyo,027,18085,11,11,0,11,0
2020-04-06,Kern,029,883053,470,117,0,117,2
2020-04-06,Kings,031,150075,40,3,1,4,0
2020-04-06,Lake,033,64148,4,1,0,1,0
2020-04-06,Lassen,035,31185,3,0,2,2,0
2020-04-06,Los Angeles,037,10098052,11045,6346,12,6358,145
2020-04-06,Madera,039,155013,58,29,0,29,2
2020-04-06,Marin,041,260295,160,119,1,120,7
2020-04-06,Mariposa,043,17540,0,0,0,0,0
2020-04-06,Mendocino,045,87422,5,4,0,4,0
2020-04-06,Merced,047,269075,60,25,0,25,1
2020-04-06,Modoc,049,8938,0,0,0,0,0
2020-04-06,Mono,051,14174,28,18,0,18,1
2020-04-06,Monterey,053,433212,102,62,0,62,2
2020-04-06,Napa,055,140530,42,18,0,18,2
2020-04-06,Nevada,057,99092,36,19,1,20,1
2020-04-06,Orange,059,3164182,1657,910,15,925,17
2020-04-06,Placer,061,380077,139,90,0,90,3
2020-04-06,Plumas,063,18699,4,2,0,2,0
2020-04-06,Riverside,065,2383286,2025,854,13,867,17
2020-04-06,Sacramento,067,1510023,783,448,0,448,15
2020-04-06,San Benito,069,59416,34,25,0,25,1
2020-04-06,San Bernardino,071,2135413,1103,550,0,550,13
2020-04-06,San Diego,073,3302833,1991,1406,0,1406,19
2020-04-06,San Francisco,075,870044,952,586,0,586,6
2020-04-06,San Joaquin,077,732212,332,191,3,194,10
2020-04-06,San Luis Obispo,079,281455,147,85,1,86,1
2020-04-06,San Mateo,081,765935,848,569,2,571,20
2020-04-06,Santa Barbara,083,443738,296,189,1,190,2
2020-04-06,Santa Clara,085,1922200,1707,1128,4,1132,43
2020-04-06,Santa Cruz,087,273765,98,65,0,65,1
2020-04-06,Shasta,089,179085,29,16,0,16,3
2020-04-06,Sierra,091,2930,0,0,0,0,0
2020-04-06,Siskiyou,093,43540,4,4,0,4,0
2020-04-06,Solano,095,438530,163,95,0,95,1
2020-04-06,Sonoma,097,501317,166,102,0,102,1
2020-04-06,Stanislaus,099,539301,170,72,3,75,0
2020-04-06,Sutter,101,95872,22,14,0,14,2
2020-04-06,Tehama,103,63373,1,1,0,1,0
2020-04-06,Trinity,105,12862,0,0,0,0,0
2020-04-06,Tulare,107,460477,319,126,5,131,5
2020-04-06,Tuolumne,109,53932,3,1,0,1,0
2020-04-06,Ventura,111,848112,391,234,0,234,6
2020-04-06,Yolo,113,214977,97,43,0,43,1
2020-04-06,Yuba,115,75493,14,8,0,8,0
2020-04-05,Alameda,001,1643700,923,475,1,476,12
2020-04-05,Alpine,003,1148,1,1,0,1,0
2020-04-05,Amador,005,37829,6,2,0,2,0
2020-04-05,Butte,007,227075,16,10,1,11,0
2020-04-05,Calaveras,009,45235,9,3,0,3,0
2020-04-05,Colusa,011,21464,3,1,0,1,0
2020-04-05,Contra Costa,013,1133247,625,415,0,415,6
2020-04-05,Del Norte,015,27424,2,1,0,1,0
2020-04-05,El Dorado,017,186661,42,19,0,19,0
2020-04-05,Fresno,019,978130,337,102,4,106,1
2020-04-05,Glenn,021,27897,4,2,0,2,0
2020-04-05,Humboldt,023,135768,55,29,0,29,0
2020-04-05,Imperial,025,180216,113,42,0,42,1
2020-04-05,Inyo,027,18085,11,10,0,10,0
2020-04-05,Kern,029,883053,415,109,0,109,2
2020-04-05,Kings,031,150075,39,4,1,5,0
2020-04-05,Lake,033,64148,4,0,0,0,0
2020-04-05,Lassen,035,31185,3,0,2,2,0
2020-04-05,Los Angeles,037,10098052,10474,5892,12,5904,130
2020-04-05,Madera,039,155013,57,27,0,27,2
2020-04-05,Marin,041,260295,160,113,1,114,6
2020-04-05,Mariposa,043,17540,0,0,0,0,0
2020-04-05,Mendocino,045,87422,5,4,0,4,0
2020-04-05,Merced,047,269075,53,16,0,16,0
2020-04-05,Modoc,049,8938,0,0,0,0,0
2020-04-05,Mono,051,14174,28,18,0,18,1
2020-04-05,Monterey,053,433212,95,61,0,61,2
2020-04-05,Napa,055,140530,40,15,0,15,2
2020-04-05,Nevada,057,99092,36,19,1,20,1
2020-04-05,Orange,059,3164182,1600,820,15,835,15
2020-04-05,Placer,061,380077,136,86,0,86,3
2020-04-05,Plumas,063,18699,3,2,0,2,0
2020-04-05,Riverside,065,2383286,1896,669,13,682,17
2020-04-05,Sacramento,067,1510023,752,393,0,393,11
2020-04-05,San Benito,069,59416,34,22,0,22,1
2020-04-05,San Bernardino,071,2135413,1030,375,0,375,13
2020-04-05,San Diego,073,3302833,1909,1328,0,1328,19
2020-04-05,San Francisco,075,870044,905,559,0,559,6
2020-04-05,San Joaquin,077,732212,317,179,3,182,10
2020-04-05,San Luis Obispo,079,281455,145,83,1,84,1
2020-04-05,San Mateo,081,765935,828,528,2,530,19
2020-04-05,Santa Barbara,083,443738,280,171,1,172,1
2020-04-05,Santa Clara,085,1922200,1660,1052,4,1056,42
2020-04-05,Santa Cruz,087,273765,98,59,0,59,1
2020-04-05,Shasta,089,179085,28,11,0,11,2
2020-04-05,Sierra,091,2930,0,0,0,0,0
2020-04-05,Siskiyou,093,43540,4,3,0,3,0
2020-04-05,Solano,095,438530,159,78,0,78,1
2020-04-05,Sonoma,097,501317,164,88,0,88,1
2020-04-05,Stanislaus,099,539301,156,51,3,54,0
2020-04-05,Sutter,101,95872,22,14,0,14,1
2020-04-05,Tehama,103,63373,1,1,0,1,0
2020-04-05,Trinity,105,12862,0,0,0,0,0
2020-04-05,Tulare,107,460477,282,81,5,86,4
2020-04-05,Tuolumne,109,53932,3,1,0,1,0
2020-04-05,Ventura,111,848112,377,196,0,196,6
2020-04-05,Yolo,113,214977,78,37,0,37,2
2020-04-05,Yuba,115,75493,14,7,0,7,0
2020-04-04,Alameda,001,1643700,900,468,1,469,12
2020-04-04,Alpine,003,1148,1,1,0,1,0
2020-04-04,Amador,005,37829,5,2,0,2,0
2020-04-04,Butte,007,227075,16,10,1,11,0
2020-04-04,Calaveras,009,45235,9,3,0,3,0
2020-04-04,Colusa,011,21464,3,1,0,1,0
2020-04-04,Contra Costa,013,1133247,617,382,0,382,5
2020-04-04,Del Norte,015,27424,2,1,0,1,0
2020-04-04,El Dorado,017,186661,42,19,0,19,0
2020-04-04,Fresno,019,978130,327,102,4,106,1
2020-04-04,Glenn,021,27897,4,2,0,2,0
2020-04-04,Humboldt,023,135768,55,29,0,29,0
2020-04-04,Imperial,025,180216,112,42,0,42,1
2020-04-04,Inyo,027,18085,11,10,0,10,0
2020-04-04,Kern,029,883053,385,103,0,103,2
2020-04-04,Kings,031,150075,39,3,1,4,0
2020-04-04,Lake,033,64148,4,0,0,0,0
2020-04-04,Lassen,035,31185,3,0,2,2,0
2020-04-04,Los Angeles,037,10098052,9855,5275,12,5287,117
2020-04-04,Madera,039,155013,55,27,0,27,2
2020-04-04,Marin,041,260295,158,111,0,111,6
2020-04-04,Mariposa,043,17540,0,0,0,0,0
2020-04-04,Mendocino,045,87422,5,4,0,4,0
2020-04-04,Merced,047,269075,49,11,0,11,0
2020-04-04,Modoc,049,8938,0,0,0,0,0
2020-04-04,Mono,051,14174,28,18,0,18,1
2020-04-04,Monterey,053,433212,91,61,0,61,2
2020-04-04,Napa,055,140530,40,15,0,15,2
2020-04-04,Nevada,057,99092,36,19,1,20,1
2020-04-04,Orange,059,3164182,1558,781,14,795,15
2020-04-04,Placer,061,380077,135,87,0,87,2
2020-04-04,Plumas,063,18699,3,2,0,2,0
2020-04-04,Riverside,065,2383286,1795,652,13,665,15
2020-04-04,Sacramento,067,1510023,734,393,0,393,11
2020-04-04,San Benito,069,59416,34,22,0,22,1
2020-04-04,San Bernardino,071,2135413,982,373,0,373,13
2020-04-04,San Diego,073,3302833,1861,1211,0,1211,18
2020-04-04,San Francisco,075,870044,867,537,0,537,6
2020-04-04,San Joaquin,077,732212,294,171,3,174,10
2020-04-04,San Luis Obispo,079,281455,145,82,1,83,0
2020-04-04,San Mateo,081,765935,816,520,2,522,17
2020-04-04,Santa Barbara,083,443738,271,167,1,168,1
2020-04-04,Santa Clara,085,1922200,1608,1045,4,1049,39
2020-04-04,Santa Cruz,087,273765,98,56,0,56,1
2020-04-04,Shasta,089,179085,27,11,0,11,2
2020-04-04,Sierra,091,2930,0,0,0,0,0
2020-04-04,Siskiyou,093,43540,4,3,0,3,0
2020-04-04,Solano,095,438530,154,79,0,79,1
2020-04-04,Sonoma,097,501317,161,88,0,88,1
2020-04-04,Stanislaus,099,539301,145,51,3,54,0
2020-04-04,Sutter,101,95872,22,14,0,14,1
2020-04-04,Tehama,103,63373,1,1,0,1,0
2020-04-04,Trinity,105,12862,0,0,0,0,0
2020-04-04,Tulare,107,460477,268,79,5,84,4
2020-04-04,Tuolumne,109,53932,3,1,0,1,0
2020-04-04,Ventura,111,848112,364,194,0,194,6
2020-04-04,Yolo,113,214977,76,40,0,40,2
2020-04-04,Yuba,115,75493,13,7,0,7,0
2020-04-03,Alameda,001,1643700,864,395,1,396,11
2020-04-03,Alpine,003,1148,1,1,0,1,0
2020-04-03,Amador,005,37829,5,2,0,2,0
2020-04-03,Butte,007,227075,16,8,1,9,0
2020-04-03,Calaveras,009,45235,9,3,0,3,0
2020-04-03,Colusa,011,21464,3,1,0,1,0
2020-04-03,Contra Costa,013,1133247,594,327,0,327,5
2020-04-03,Del Norte,015,27424,2,1,0,1,0
2020-04-03,El Dorado,017,186661,40,16,0,16,0
2020-04-03,Fresno,019,978130,315,98,4,102,1
2020-04-03,Glenn,021,27897,4,2,0,2,0
2020-04-03,Humboldt,023,135768,55,34,0,34,0
2020-04-03,Imperial,025,180216,103,35,0,35,0
2020-04-03,Inyo,027,18085,11,10,0,10,0
2020-04-03,Kern,029,883053,359,87,0,87,1
2020-04-03,Kings,031,150075,37,3,1,4,0
2020-04-03,Lake,033,64148,3,0,0,0,0
2020-04-03,Lassen,035,31185,3,0,2,2,0
2020-04-03,Los Angeles,037,10098052,9238,4566,12,4578,91
2020-04-03,Madera,039,155013,54,28,0,28,2
2020-04-03,Marin,041,260295,156,106,0,106,6
2020-04-03,Mariposa,043,17540,0,0,0,0,0
2020-04-03,Mendocino,045,87422,5,4,0,4,0
2020-04-03,Merced,047,269075,46,9,0,9,0
2020-04-03,Modoc,049,8938,0,0,0,0,0
2020-04-03,Mono,051,14174,28,18,0,18,1
2020-04-03,Monterey,053,433212,88,58,0,58,2
2020-04-03,Napa,055,140530,39,13,0,13,1
2020-04-03,Nevada,057,99092,36,19,1,20,1
2020-04-03,Orange,059,3164182,1519,713,14,727,13
2020-04-03,Placer,061,380077,131,76,0,76,2
2020-04-03,Plumas,063,18699,3,2,0,2,0
2020-04-03,Riverside,065,2383286,1715,540,13,553,14
2020-04-03,Sacramento,067,1510023,713,363,0,363,11
2020-04-03,San Benito,069,59416,34,22,0,22,1
2020-04-03,San Bernardino,071,2135413,937,356,0,356,11
2020-04-03,San Diego,073,3302833,1800,1114,0,1114,17
2020-04-03,San Francisco,075,870044,843,506,0,506,6
2020-04-03,San Joaquin,077,732212,282,162,3,165,10
2020-04-03,San Luis Obispo,079,281455,144,82,1,83,0
2020-04-03,San Mateo,081,765935,799,474,2,476,13
2020-04-03,Santa Barbara,083,443738,260,154,1,155,1
2020-04-03,Santa Clara,085,1922200,1572,983,4,987,39
2020-04-03,Santa Cruz,087,273765,98,52,0,52,1
2020-04-03,Shasta,089,179085,27,10,0,10,1
2020-04-03,Sierra,091,2930,0,0,0,0,0
2020-04-03,Siskiyou,093,43540,4,3,0,3,0
2020-04-03,Solano,095,438530,146,72,0,72,1
2020-04-03,Sonoma,097,501317,161,84,0,84,1
2020-04-03,Stanislaus,099,539301,139,48,3,51,0
2020-04-03,Sutter,101,95872,22,12,0,12,1
2020-04-03,Tehama,103,63373,1,1,0,1,0
2020-04-03,Trinity,105,12862,0,0,0,0,0
2020-04-03,Tulare,107,460477,254,73,5,78,3
2020-04-03,Tuolumne,109,53932,3,1,0,1,0
2020-04-03,Ventura,111,848112,354,186,0,186,6
2020-04-03,Yolo,113,214977,75,33,0,33,1
2020-04-03,Yuba,115,75493,13,6,0,6,0
2020-04-02,Alameda,001,1643700,813,345,1,346,10
2020-04-02,Alpine,003,1148,1,1,0,1,0
2020-04-02,Amador,005,37829,5,2,0,2,0
2020-04-02,Butte,007,227075,16,7,0,7,0
2020-04-02,Calaveras,009,45235,7,3,0,3,0
2020-04-02,Colusa,011,21464,3,1,0,1,0
2020-04-02,Contra Costa,013,1133247,564,297,0,297,3
2020-04-02,Del Norte,015,27424,2,0,0,0,0
2020-04-02,El Dorado,017,186661,38,16,0,16,0
2020-04-02,Fresno,019,978130,299,92,4,96,0
2020-04-02,Glenn,021,27897,3,2,0,2,0
2020-04-02,Humboldt,023,135768,51,23,0,23,0
2020-04-02,Imperial,025,180216,99,24,0,24,0
2020-04-02,Inyo,027,18085,10,8,0,8,0
2020-04-02,Kern,029,883053,332,74,0,74,0
2020-04-02,Kings,031,150075,37,3,1,4,0
2020-04-02,Lake,033,64148,3,0,0,0,0
2020-04-02,Lassen,035,31185,3,0,2,2,0
2020-04-02,Los Angeles,037,10098052,8403,4040,12,4052,79
2020-04-02,Madera,039,155013,52,25,0,25,1
2020-04-02,Marin,041,260295,150,102,0,102,1
2020-04-02,Mariposa,043,17540,0,0,0,0,0
2020-04-02,Mendocino,045,87422,5,4,0,4,0
2020-04-02,Merced,047,269075,41,9,0,9,0
2020-04-02,Modoc,049,8938,0,0,0,0,0
2020-04-02,Mono,051,14174,28,16,0,16,1
2020-04-02,Monterey,053,433212,86,50,0,50,2
2020-04-02,Napa,055,140530,39,13,0,13,0
2020-04-02,Nevada,057,99092,35,17,1,18,0
2020-04-02,Orange,059,3164182,1467,640,13,653,12
2020-04-02,Placer,061,380077,130,72,0,72,2
2020-04-02,Plumas,063,18699,3,1,0,1,0
2020-04-02,Riverside,065,2383286,1598,438,13,451,13
2020-04-02,Sacramento,067,1510023,695,322,0,322,9
2020-04-02,San Benito,069,59416,32,18,0,18,1
2020-04-02,San Bernardino,071,2135413,882,335,0,335,8
2020-04-02,San Diego,073,3302833,1733,968,0,968,16
2020-04-02,San Francisco,075,870044,817,473,0,473,6
2020-04-02,San Joaquin,077,732212,263,148,3,151,9
2020-04-02,San Luis Obispo,079,281455,139,79,1,80,0
2020-04-02,San Mateo,081,765935,778,423,2,425,13
2020-04-02,Santa Barbara,083,443738,249,125,1,126,1
2020-04-02,Santa Clara,085,1922200,1521,908,4,912,38
2020-04-02,Santa Cruz,087,273765,96,49,0,49,1
2020-04-02,Shasta,089,179085,26,7,0,7,1
2020-04-02,Sierra,091,2930,0,0,0,0,0
2020-04-02,Siskiyou,093,43540,4,3,0,3,0
2020-04-02,Solano,095,438530,136,65,0,65,0
2020-04-02,Sonoma,097,501317,157,76,0,76,1
2020-04-02,Stanislaus,099,539301,128,40,3,43,0
2020-04-02,Sutter,101,95872,21,10,0,10,1
2020-04-02,Tehama,103,63373,1,1,0,1,0
2020-04-02,Trinity,105,12862,0,0,0,0,0
2020-04-02,Tulare,107,460477,220,64,5,69,1
2020-04-02,Tuolumne,109,53932,3,1,0,1,0
2020-04-02,Ventura,111,848112,336,178,0,178,5
2020-04-02,Yolo,113,214977,73,29,0,29,1
2020-04-02,Yuba,115,75493,10,5,0,5,0
2020-04-01,Alameda,001,1643700,786,287,1,288,8
2020-04-01,Alpine,003,1148,1,1,0,1,0
2020-04-01,Amador,005,37829,5,1,0,1,0
2020-04-01,Butte,007,227075,16,6,0,6,0
2020-04-01,Calaveras,009,45235,6,3,0,3,0
2020-04-01,Colusa,011,21464,3,1,0,1,0
2020-04-01,Contra Costa,013,1133247,521,267,0,267,3
2020-04-01,Del Norte,015,27424,2,0,0,0,0
2020-04-01,El Dorado,017,186661,37,14,0,14,0
2020-04-01,Fresno,019,978130,277,75,3,78,0
2020-04-01,Glenn,021,27897,3,2,0,2,0
2020-04-01,Humboldt,023,135768,51,19,0,19,0
2020-04-01,Imperial,025,180216,93,25,0,25,0
2020-04-01,Inyo,027,18085,10,8,0,8,0
2020-04-01,Kern,029,883053,305,53,0,53,0
2020-04-01,Kings,031,150075,35,3,1,4,0
2020-04-01,Lake,033,64148,3,0,0,0,0
2020-04-01,Lassen,035,31185,3,0,2,2,0
2020-04-01,Los Angeles,037,10098052,7752,3502,12,3514,66
2020-04-01,Madera,039,155013,50,17,0,17,1
2020-04-01,Marin,041,260295,146,87,0,87,1
2020-04-01,Mariposa,043,17540,0,0,0,0,0
2020-04-01,Mendocino,045,87422,5,4,0,4,0
2020-04-01,Merced,047,269075,38,7,0,7,0
2020-04-01,Modoc,049,8938,0,0,0,0,0
2020-04-01,Mono,051,14174,28,12,0,12,1
2020-04-01,Monterey,053,433212,85,47,0,47,2
2020-04-01,Napa,055,140530,36,11,0,11,0
2020-04-01,Nevada,057,99092,35,15,1,16,0
2020-04-01,Orange,059,3164182,1415,579,13,592,11
2020-04-01,Placer,061,380077,128,52,0,52,2
2020-04-01,Plumas,063,18699,3,1,0,1,0
2020-04-01,Riverside,065,2383286,1430,306,12,318,11
2020-04-01,Sacramento,067,1510023,662,299,0,299,8
2020-04-01,San Benito,069,59416,29,14,0,14,1
2020-04-01,San Bernardino,071,2135413,833,245,0,245,5
2020-04-01,San Diego,073,3302833,1663,851,0,851,11
2020-04-01,San Francisco,075,870044,789,432,0,432,6
2020-04-01,San Joaquin,077,732212,251,132,3,135,8
2020-04-01,San Luis Obispo,079,281455,133,69,1,70,0
2020-04-01,San Mateo,081,765935,760,354,2,356,13
2020-04-01,Santa Barbara,083,443738,236,103,1,104,0
2020-04-01,Santa Clara,085,1922200,1479,805,4,809,33
2020-04-01,Santa Cruz,087,273765,91,44,0,44,1
2020-04-01,Shasta,089,179085,25,5,0,5,1
2020-04-01,Sierra,091,2930,0,0,0,0,0
2020-04-01,Siskiyou,093,43540,4,3,0,3,0
2020-04-01,Solano,095,438530,131,57,0,57,0
2020-04-01,Sonoma,097,501317,153,60,0,60,1
2020-04-01,Stanislaus,099,539301,117,29,3,32,0
2020-04-01,Sutter,101,95872,21,9,0,9,1
2020-04-01,Tehama,103,63373,1,0,0,0,0
2020-04-01,Trinity,105,12862,0,0,0,0,0
2020-04-01,Tulare,107,460477,182,43,5,48,1
2020-04-01,Tuolumne,109,53932,3,1,0,1,0
2020-04-01,Ventura,111,848112,323,154,0,154,5
2020-04-01,Yolo,113,214977,68,22,0,22,1
2020-04-01,Yuba,115,75493,9,5,0,5,0
2020-03-31,Alameda,001,1643700,718,269,1,270,7
2020-03-31,Alpine,003,1148,1,1,0,1,0
2020-03-31,Amador,005,37829,5,1,0,1,0
2020-03-31,Butte,007,227075,16,6,0,6,0
2020-03-31,Calaveras,009,45235,6,3,0,3,0
2020-03-31,Colusa,011,21464,3,1,0,1,0
2020-03-31,Contra Costa,013,1133247,496,246,0,246,3
2020-03-31,Del Norte,015,27424,1,0,0,0,0
2020-03-31,El Dorado,017,186661,33,14,0,14,0
2020-03-31,Fresno,019,978130,252,59,3,62,0
2020-03-31,Glenn,021,27897,3,2,0,2,0
2020-03-31,Humboldt,023,135768,51,18,0,18,0
2020-03-31,Imperial,025,180216,88,17,0,17,0
2020-03-31,Inyo,027,18085,10,8,0,8,0
2020-03-31,Kern,029,883053,281,47,0,47,0
2020-03-31,Kings,031,150075,33,2,1,3,0
2020-03-31,Lake,033,64148,1,0,0,0,0
2020-03-31,Lassen,035,31185,3,0,2,2,0
2020-03-31,Los Angeles,037,10098052,7088,3001,12,3013,53
2020-03-31,Madera,039,155013,49,17,0,17,1
2020-03-31,Marin,041,260295,137,85,0,85,1
2020-03-31,Mariposa,043,17540,0,0,0,0,0
2020-03-31,Mendocino,045,87422,5,4,0,4,0
2020-03-31,Merced,047,269075,33,6,0,6,0
2020-03-31,Modoc,049,8938,0,0,0,0,0
2020-03-31,Mono,051,14174,26,12,0,12,0
2020-03-31,Monterey,053,433212,83,43,0,43,2
2020-03-31,Napa,055,140530,35,9,0,9,0
2020-03-31,Nevada,057,99092,35,15,1,16,0
2020-03-31,Orange,059,3164182,1345,506,13,519,7
2020-03-31,Placer,061,380077,121,49,0,49,2
2020-03-31,Plumas,063,18699,1,0,0,0,0
2020-03-31,Riverside,065,2383286,1284,284,12,296,8
2020-03-31,Sacramento,067,1510023,610,271,0,271,8
2020-03-31,San Benito,069,59416,29,14,0,14,1
2020-03-31,San Bernardino,071,2135413,748,193,0,193,5
2020-03-31,San Diego,073,3302833,1581,736,0,736,9
2020-03-31,San Francisco,075,870044,754,404,0,404,5
2020-03-31,San Joaquin,077,732212,235,122,3,125,7
2020-03-31,San Luis Obispo,079,281455,129,67,1,68,0
2020-03-31,San Mateo,081,765935,741,297,2,299,12
2020-03-31,Santa Barbara,083,443738,221,89,1,90,0
2020-03-31,Santa Clara,085,1922200,1429,777,4,781,30
2020-03-31,Santa Cruz,087,273765,84,40,0,40,1
2020-03-31,Shasta,089,179085,22,5,0,5,1
2020-03-31,Sierra,091,2930,0,0,0,0,0
2020-03-31,Siskiyou,093,43540,4,3,0,3,0
2020-03-31,Solano,095,438530,117,56,0,56,0
2020-03-31,Sonoma,097,501317,148,58,0,58,1
2020-03-31,Stanislaus,099,539301,102,28,3,31,0
2020-03-31,Sutter,101,95872,21,8,0,8,0
2020-03-31,Tehama,103,63373,1,0,0,0,0
2020-03-31,Trinity,105,12862,0,0,0,0,0
2020-03-31,Tulare,107,460477,159,42,4,46,1
2020-03-31,Tuolumne,109,53932,3,1,0,1,0
2020-03-31,Ventura,111,848112,312,143,0,143,4
2020-03-31,Yolo,113,214977,61,21,0,21,1
2020-03-31,Yuba,115,75493,9,5,0,5,0
2020-03-30,Alameda,001,1643700,678,250,1,251,7
2020-03-30,Alpine,003,1148,1,1,0,1,0
2020-03-30,Amador,005,37829,5,1,0,1,0
2020-03-30,Butte,007,227075,14,5,0,5,0
2020-03-30,Calaveras,009,45235,6,3,0,3,0
2020-03-30,Colusa,011,21464,3,1,0,1,0
2020-03-30,Contra Costa,013,1133247,470,212,0,212,3
2020-03-30,Del Norte,015,27424,0,0,0,0,0
2020-03-30,El Dorado,017,186661,33,11,0,11,0
2020-03-30,Fresno,019,978130,227,46,3,49,0
2020-03-30,Glenn,021,27897,3,2,0,2,0
2020-03-30,Humboldt,023,135768,49,11,0,11,0
2020-03-30,Imperial,025,180216,85,9,0,9,0
2020-03-30,Inyo,027,18085,10,5,0,5,0
2020-03-30,Kern,029,883053,248,30,0,30,0
2020-03-30,Kings,031,150075,33,1,1,2,0
2020-03-30,Lake,033,64148,1,0,0,0,0
2020-03-30,Lassen,035,31185,3,0,1,1,0
2020-03-30,Los Angeles,037,10098052,6428,2467,12,2479,44
2020-03-30,Madera,039,155013,48,14,0,14,1
2020-03-30,Marin,041,260295,130,78,0,78,0
2020-03-30,Mariposa,043,17540,0,0,0,0,0
2020-03-30,Mendocino,045,87422,5,2,0,2,0
2020-03-30,Merced,047,269075,29,6,0,6,0
2020-03-30,Modoc,049,8938,0,0,0,0,0
2020-03-30,Mono,051,14174,26,11,0,11,0
2020-03-30,Monterey,053,433212,78,41,0,41,1
2020-03-30,Napa,055,140530,34,9,0,9,0
2020-03-30,Nevada,057,99092,34,14,1,15,0
2020-03-30,Orange,059,3164182,1280,418,13,431,5
2020-03-30,Placer,061,380077,118,44,0,44,2
2020-03-30,Plumas,063,18699,1,0,0,0,0
2020-03-30,Riverside,065,2383286,1203,204,12,216,7
2020-03-30,Sacramento,067,1510023,586,238,0,238,8
2020-03-30,San Benito,069,59416,29,11,0,11,1
2020-03-30,San Bernardino,071,2135413,704,145,0,145,4
2020-03-30,San Diego,073,3302833,1511,605,0,605,7
2020-03-30,San Francisco,075,870044,714,368,0,368,5
2020-03-30,San Joaquin,077,732212,228,112,3,115,5
2020-03-30,San Luis Obispo,079,281455,126,62,1,63,0
2020-03-30,San Mateo,081,765935,717,257,2,259,11
2020-03-30,Santa Barbara,083,443738,212,79,1,80,0
2020-03-30,Santa Clara,085,1922200,1398,745,3,748,31
2020-03-30,Santa Cruz,087,273765,81,36,0,36,1
2020-03-30,Shasta,089,179085,21,4,0,4,1
2020-03-30,Sierra,091,2930,0,0,0,0,0
2020-03-30,Siskiyou,093,43540,4,2,0,2,0
2020-03-30,Solano,095,438530,111,50,0,50,0
2020-03-30,Sonoma,097,501317,145,57,0,57,1
2020-03-30,Stanislaus,099,539301,95,28,3,31,0
2020-03-30,Sutter,101,95872,20,6,0,6,0
2020-03-30,Tehama,103,63373,1,0,0,0,0
2020-03-30,Trinity,105,12862,0,0,0,0,0
2020-03-30,Tulare,107,460477,147,40,3,43,1
2020-03-30,Tuolumne,109,53932,3,1,0,1,0
2020-03-30,Ventura,111,848112,301,118,0,118,2
2020-03-30,Yolo,113,214977,58,17,0,17,1
2020-03-30,Yuba,115,75493,8,5,0,5,0
2020-03-29,Alameda,001,1643700,644,207,1,208,6
2020-03-29,Alpine,003,1148,1,0,0,0,0
2020-03-29,Amador,005,37829,5,1,0,1,0
2020-03-29,Butte,007,227075,14,4,0,4,0
2020-03-29,Calaveras,009,45235,6,2,0,2,0
2020-03-29,Colusa,011,21464,3,1,0,1,0
2020-03-29,Contra Costa,013,1133247,440,187,0,187,3
2020-03-29,Del Norte,015,27424,0,0,0,0,0
2020-03-29,El Dorado,017,186661,32,9,0,9,0
2020-03-29,Fresno,019,978130,203,31,3,34,0
2020-03-29,Glenn,021,27897,2,1,0,1,0
2020-03-29,Humboldt,023,135768,46,9,0,9,0
2020-03-29,Imperial,025,180216,79,9,0,9,0
2020-03-29,Inyo,027,18085,9,0,0,0,0
2020-03-29,Kern,029,883053,230,20,0,20,0
2020-03-29,Kings,031,150075,30,1,1,2,0
2020-03-29,Lake,033,64148,0,0,0,0,0
2020-03-29,Lassen,035,31185,3,0,1,1,0
2020-03-29,Los Angeles,037,10098052,5782,2119,11,2130,37
2020-03-29,Madera,039,155013,43,11,0,11,1
2020-03-29,Marin,041,260295,125,60,0,60,0
2020-03-29,Mariposa,043,17540,0,0,0,0,0
2020-03-29,Mendocino,045,87422,5,2,0,2,0
2020-03-29,Merced,047,269075,28,4,0,4,0
2020-03-29,Modoc,049,8938,0,0,0,0,0
2020-03-29,Mono,051,14174,26,8,0,8,0
2020-03-29,Monterey,053,433212,73,36,0,36,1
2020-03-29,Napa,055,140530,32,5,0,5,0
2020-03-29,Nevada,057,99092,32,13,1,14,0
2020-03-29,Orange,059,3164182,1207,343,13,356,2
2020-03-29,Placer,061,380077,117,35,0,35,2
2020-03-29,Plumas,063,18699,1,0,0,0,0
2020-03-29,Riverside,065,2383286,1079,122,12,134,7
2020-03-29,Sacramento,067,1510023,546,217,0,217,7
2020-03-29,San Benito,069,59416,28,10,0,10,1
2020-03-29,San Bernardino,071,2135413,652,94,0,94,2
2020-03-29,San Diego,073,3302833,1439,521,0,521,7
2020-03-29,San Francisco,075,870044,670,333,0,333,5
2020-03-29,San Joaquin,077,732212,219,86,3,89,4
2020-03-29,San Luis Obispo,079,281455,119,55,0,55,0
2020-03-29,San Mateo,081,765935,692,234,2,236,12
2020-03-29,Santa Barbara,083,443738,204,52,1,53,0
2020-03-29,Santa Clara,085,1922200,1341,591,3,594,30
2020-03-29,Santa Cruz,087,273765,81,33,0,33,1
2020-03-29,Shasta,089,179085,20,4,0,4,1
2020-03-29,Sierra,091,2930,0,0,0,0,0
2020-03-29,Siskiyou,093,43540,4,2,0,2,0
2020-03-29,Solano,095,438530,103,48,0,48,0
2020-03-29,Sonoma,097,501317,143,35,0,35,1
2020-03-29,Stanislaus,099,539301,90,19,3,22,0
2020-03-29,Sutter,101,95872,17,6,0,6,0
2020-03-29,Tehama,103,63373,1,0,0,0,0
2020-03-29,Trinity,105,12862,0,0,0,0,0
2020-03-29,Tulare,107,460477,122,24,3,27,1
2020-03-29,Tuolumne,109,53932,2,1,0,1,0
2020-03-29,Ventura,111,848112,274,92,0,92,2
2020-03-29,Yolo,113,214977,53,13,0,13,1
2020-03-29,Yuba,115,75493,8,3,0,3,0
2020-03-28,Alameda,001,1643700,617,410,1,411,12
2020-03-28,Alpine,003,1148,1,0,0,0,0
2020-03-28,Amador,005,37829,5,2,0,2,0
2020-03-28,Butte,007,227075,14,8,0,8,0
2020-03-28,Calaveras,009,45235,6,4,0,4,0
2020-03-28,Colusa,011,21464,3,2,0,2,0
2020-03-28,Contra Costa,013,1133247,417,350,0,350,4
2020-03-28,Del Norte,015,27424,0,0,0,0,0
2020-03-28,El Dorado,017,186661,31,18,0,18,0
2020-03-28,Fresno,019,978130,193,62,3,65,0
2020-03-28,Glenn,021,27897,2,2,0,2,0
2020-03-28,Humboldt,023,135768,46,18,0,18,0
2020-03-28,Imperial,025,180216,74,18,0,18,0
2020-03-28,Inyo,027,18085,9,0,0,0,0
2020-03-28,Kern,029,883053,213,40,0,40,0
2020-03-28,Kings,031,150075,29,2,1,3,0
2020-03-28,Lake,033,64148,0,0,0,0,0
2020-03-28,Lassen,035,31185,3,0,1,1,0
2020-03-28,Los Angeles,037,10098052,5397,3600,10,3610,64
2020-03-28,Madera,039,155013,43,22,0,22,2
2020-03-28,Marin,041,260295,120,116,0,116,0
2020-03-28,Mariposa,043,17540,0,0,0,0,0
2020-03-28,Mendocino,045,87422,5,4,0,4,0
2020-03-28,Merced,047,269075,27,8,0,8,0
2020-03-28,Modoc,049,8938,0,0,0,0,0
2020-03-28,Mono,051,14174,24,12,0,12,0
2020-03-28,Monterey,053,433212,72,64,0,64,2
2020-03-28,Napa,055,140530,27,10,0,10,0
2020-03-28,Nevada,057,99092,32,22,1,23,0
2020-03-28,Orange,059,3164182,1171,656,13,669,4
2020-03-28,Placer,061,380077,112,70,0,70,2
2020-03-28,Plumas,063,18699,1,0,0,0,0
2020-03-28,Riverside,065,2383286,1011,242,12,254,14
2020-03-28,Sacramento,067,1510023,528,406,0,406,14
2020-03-28,San Benito,069,59416,28,20,0,20,2
2020-03-28,San Bernardino,071,2135413,604,162,0,162,4
2020-03-28,San Diego,073,3302833,1380,980,0,980,14
2020-03-28,San Francisco,075,870044,646,600,0,600,6
2020-03-28,San Joaquin,077,732212,212,166,3,169,8
2020-03-28,San Luis Obispo,079,281455,117,104,0,104,0
2020-03-28,San Mateo,081,765935,672,462,2,464,17
2020-03-28,Santa Barbara,083,443738,194,98,1,99,0
2020-03-28,Santa Clara,085,1922200,1322,1174,3,1177,54
2020-03-28,Santa Cruz,087,273765,80,62,0,62,0
2020-03-28,Shasta,089,179085,20,8,0,8,2
2020-03-28,Sierra,091,2930,0,0,0,0,0
2020-03-28,Siskiyou,093,43540,4,4,0,4,0
2020-03-28,Solano,095,438530,99,96,0,96,0
2020-03-28,Sonoma,097,501317,141,70,0,70,2
2020-03-28,Stanislaus,099,539301,85,34,3,37,0
2020-03-28,Sutter,101,95872,17,6,0,6,0
2020-03-28,Tehama,103,63373,1,0,0,0,0
2020-03-28,Trinity,105,12862,0,0,0,0,0
2020-03-28,Tulare,107,460477,114,46,3,49,0
2020-03-28,Tuolumne,109,53932,2,2,0,2,0
2020-03-28,Ventura,111,848112,270,178,0,178,4
2020-03-28,Yolo,113,214977,52,26,0,26,2
2020-03-28,Yuba,115,75493,8,6,0,6,0
2020-03-27,Alameda,001,1643700,598,185,1,186,4
2020-03-27,Alpine,003,1148,1,0,0,0,0
2020-03-27,Amador,005,37829,4,1,0,1,0
2020-03-27,Butte,007,227075,12,4,0,4,0
2020-03-27,Calaveras,009,45235,6,2,0,2,0
2020-03-27,Colusa,011,21464,3,0,0,0,0
2020-03-27,Contra Costa,013,1133247,396,161,0,161,2
2020-03-27,Del Norte,015,27424,0,0,0,0,0
2020-03-27,El Dorado,017,186661,29,9,0,9,0
2020-03-27,Fresno,019,978130,181,29,2,31,0
2020-03-27,Glenn,021,27897,2,0,0,0,0
2020-03-27,Humboldt,023,135768,42,9,0,9,0
2020-03-27,Imperial,025,180216,69,9,0,9,0
2020-03-27,Inyo,027,18085,9,0,0,0,0
2020-03-27,Kern,029,883053,200,20,0,20,0
2020-03-27,Kings,031,150075,28,0,1,1,0
2020-03-27,Lake,033,64148,0,0,0,0,0
2020-03-27,Lassen,035,31185,3,0,1,1,0
2020-03-27,Los Angeles,037,10098052,4987,1474,10,1484,26
2020-03-27,Madera,039,155013,41,10,0,10,1
2020-03-27,Marin,041,260295,115,58,0,58,0
2020-03-27,Mariposa,043,17540,0,0,0,0,0
2020-03-27,Mendocino,045,87422,5,2,0,2,0
2020-03-27,Merced,047,269075,26,3,0,3,0
2020-03-27,Modoc,049,8938,0,0,0,0,0
2020-03-27,Mono,051,14174,24,6,0,6,0
2020-03-27,Monterey,053,433212,69,26,0,26,1
2020-03-27,Napa,055,140530,27,5,0,5,0
2020-03-27,Nevada,057,99092,32,6,1,7,0
2020-03-27,Orange,059,3164182,1121,299,13,312,2
2020-03-27,Placer,061,380077,109,33,0,33,1
2020-03-27,Plumas,063,18699,0,0,0,0,0
2020-03-27,Riverside,065,2383286,955,121,12,133,7
2020-03-27,Sacramento,067,1510023,505,163,0,163,6
2020-03-27,San Benito,069,59416,27,9,0,9,1
2020-03-27,San Bernardino,071,2135413,514,77,0,77,2
2020-03-27,San Diego,073,3302833,1323,419,0,419,5
2020-03-27,San Francisco,075,870044,621,285,0,285,2
2020-03-27,San Joaquin,077,732212,201,73,3,76,3
2020-03-27,San Luis Obispo,079,281455,115,46,0,46,0
2020-03-27,San Mateo,081,765935,646,213,2,215,7
2020-03-27,Santa Barbara,083,443738,180,37,1,38,0
2020-03-27,Santa Clara,085,1922200,1284,557,3,560,25
2020-03-27,Santa Cruz,087,273765,79,31,0,31,0
2020-03-27,Shasta,089,179085,17,3,0,3,1
2020-03-27,Sierra,091,2930,0,0,0,0,0
2020-03-27,Siskiyou,093,43540,4,2,0,2,0
2020-03-27,Solano,095,438530,93,48,0,48,0
2020-03-27,Sonoma,097,501317,133,35,0,35,1
2020-03-27,Stanislaus,099,539301,83,16,3,19,0
2020-03-27,Sutter,101,95872,16,2,0,2,0
2020-03-27,Tehama,103,63373,1,0,0,0,0
2020-03-27,Trinity,105,12862,0,0,0,0,0
2020-03-27,Tulare,107,460477,106,15,3,18,0
2020-03-27,Tuolumne,109,53932,2,1,0,1,0
2020-03-27,Ventura,111,848112,261,80,0,80,2
2020-03-27,Yolo,113,214977,51,13,0,13,1
2020-03-27,Yuba,115,75493,7,3,0,3,0
2020-03-26,Alameda,001,1643700,558,172,1,173,4
2020-03-26,Alpine,003,1148,1,0,0,0,0
2020-03-26,Amador,005,37829,4,1,0,1,0
2020-03-26,Butte,007,227075,12,4,0,4,0
2020-03-26,Calaveras,009,45235,6,2,0,2,0
2020-03-26,Colusa,011,21464,3,0,0,0,0
2020-03-26,Contra Costa,013,1133247,385,147,0,147,2
2020-03-26,Del Norte,015,27424,0,0,0,0,0
2020-03-26,El Dorado,017,186661,27,7,0,7,0
2020-03-26,Fresno,019,978130,172,25,2,27,0
2020-03-26,Glenn,021,27897,2,0,0,0,0
2020-03-26,Humboldt,023,135768,38,8,0,8,0
2020-03-26,Imperial,025,180216,65,8,0,8,0
2020-03-26,Inyo,027,18085,8,0,0,0,0
2020-03-26,Kern,029,883053,184,20,0,20,0
2020-03-26,Kings,031,150075,28,0,1,1,0
2020-03-26,Lake,033,64148,0,0,0,0,0
2020-03-26,Lassen,035,31185,3,0,1,1,0
2020-03-26,Los Angeles,037,10098052,4579,1075,10,1085,19
2020-03-26,Madera,039,155013,39,8,0,8,0
2020-03-26,Marin,041,260295,106,56,0,56,0
2020-03-26,Mariposa,043,17540,0,0,0,0,0
2020-03-26,Mendocino,045,87422,4,1,0,1,0
2020-03-26,Merced,047,269075,23,1,0,1,0
2020-03-26,Modoc,049,8938,0,0,0,0,0
2020-03-26,Mono,051,14174,23,5,0,5,0
2020-03-26,Monterey,053,433212,66,25,0,25,1
2020-03-26,Napa,055,140530,26,5,0,5,0
2020-03-26,Nevada,057,99092,32,7,1,8,0
2020-03-26,Orange,059,3164182,1059,279,11,290,1
2020-03-26,Placer,061,380077,106,34,0,34,1
2020-03-26,Plumas,063,18699,0,0,0,0,0
2020-03-26,Riverside,065,2383286,884,118,12,130,7
2020-03-26,Sacramento,067,1510023,472,147,0,147,5
2020-03-26,San Benito,069,59416,27,8,0,8,1
2020-03-26,San Bernardino,071,2135413,448,57,0,57,1
2020-03-26,San Diego,073,3302833,1256,299,0,299,2
2020-03-26,San Francisco,075,870044,594,261,0,261,1
2020-03-26,San Joaquin,077,732212,190,69,3,72,3
2020-03-26,San Luis Obispo,079,281455,110,38,0,38,0
2020-03-26,San Mateo,081,765935,612,122,2,124,5
2020-03-26,Santa Barbara,083,443738,167,33,1,34,0
2020-03-26,Santa Clara,085,1922200,1239,487,2,489,20
2020-03-26,Santa Cruz,087,273765,75,30,0,30,0
2020-03-26,Shasta,089,179085,17,3,0,3,1
2020-03-26,Sierra,091,2930,0,0,0,0,0
2020-03-26,Siskiyou,093,43540,4,2,0,2,0
2020-03-26,Solano,095,438530,85,41,0,41,0
2020-03-26,Sonoma,097,501317,128,33,0,33,1
2020-03-26,Stanislaus,099,539301,81,15,3,18,0
2020-03-26,Sutter,101,95872,12,2,0,2,0
2020-03-26,Tehama,103,63373,1,0,0,0,0
2020-03-26,Trinity,105,12862,0,0,0,0,0
2020-03-26,Tulare,107,460477,97,15,3,18,0
2020-03-26,Tuolumne,109,53932,2,0,0,0,0
2020-03-26,Ventura,111,848112,245,70,0,70,1
2020-03-26,Yolo,113,214977,47,13,0,13,1
2020-03-26,Yuba,115,75493,7,3,0,3,0
2020-03-25,Alameda,001,1643700,537,134,1,135,3
2020-03-25,Alpine,003,1148,1,0,0,0,0
2020-03-25,Amador,005,37829,4,1,0,1,0
2020-03-25,Butte,007,227075,12,4,0,4,0
2020-03-25,Calaveras,009,45235,6,2,0,2,0
2020-03-25,Colusa,011,21464,2,0,0,0,0
2020-03-25,Contra Costa,013,1133247,371,131,0,131,1
2020-03-25,Del Norte,015,27424,0,0,0,0,0
2020-03-25,El Dorado,017,186661,27,5,0,5,0
2020-03-25,Fresno,019,978130,152,21,2,23,0
2020-03-25,Glenn,021,27897,2,0,0,0,0
2020-03-25,Humboldt,023,135768,35,3,0,3,0
2020-03-25,Imperial,025,180216,57,8,0,8,0
2020-03-25,Inyo,027,18085,5,0,0,0,0
2020-03-25,Kern,029,883053,164,13,0,13,0
2020-03-25,Kings,031,150075,26,0,1,1,0
2020-03-25,Lake,033,64148,0,0,0,0,0
2020-03-25,Lassen,035,31185,3,0,1,1,0
2020-03-25,Los Angeles,037,10098052,4181,725,10,735,10
2020-03-25,Madera,039,155013,37,6,0,6,0
2020-03-25,Marin,041,260295,100,47,0,47,0
2020-03-25,Mariposa,043,17540,0,0,0,0,0
2020-03-25,Mendocino,045,87422,3,1,0,1,0
2020-03-25,Merced,047,269075,19,0,0,0,0
2020-03-25,Modoc,049,8938,0,0,0,0,0
2020-03-25,Mono,051,14174,22,4,0,4,0
2020-03-25,Monterey,053,433212,63,23,0,23,1
2020-03-25,Napa,055,140530,26,5,0,5,0
2020-03-25,Nevada,057,99092,31,5,1,6,0
2020-03-25,Orange,059,3164182,1001,214,9,223,1
2020-03-25,Placer,061,380077,100,30,0,30,1
2020-03-25,Plumas,063,18699,0,1,0,1,0
2020-03-25,Riverside,065,2383286,813,87,12,99,5
2020-03-25,Sacramento,067,1510023,446,114,0,114,5
2020-03-25,San Benito,069,59416,26,4,0,4,1
2020-03-25,San Bernardino,071,2135413,409,46,0,46,1
2020-03-25,San Diego,073,3302833,1194,238,0,238,2
2020-03-25,San Francisco,075,870044,553,212,0,212,1
2020-03-25,San Joaquin,077,732212,177,64,3,67,2
2020-03-25,San Luis Obispo,079,281455,105,35,0,35,0
2020-03-25,San Mateo,081,765935,577,111,2,113,5
2020-03-25,Santa Barbara,083,443738,157,25,1,26,0
2020-03-25,Santa Clara,085,1922200,1195,452,2,454,20
2020-03-25,Santa Cruz,087,273765,72,26,0,26,0
2020-03-25,Shasta,089,179085,16,3,0,3,1
2020-03-25,Sierra,091,2930,0,0,0,0,0
2020-03-25,Siskiyou,093,43540,4,2,0,2,0
2020-03-25,Solano,095,438530,80,39,0,39,0
2020-03-25,Sonoma,097,501317,123,31,0,31,1
2020-03-25,Stanislaus,099,539301,74,14,3,17,0
2020-03-25,Sutter,101,95872,9,1,0,1,0
2020-03-25,Tehama,103,63373,1,0,0,0,0
2020-03-25,Trinity,105,12862,0,0,0,0,0
2020-03-25,Tulare,107,460477,87,11,3,14,0
2020-03-25,Tuolumne,109,53932,2,0,0,0,0
2020-03-25,Ventura,111,848112,229,53,0,53,1
2020-03-25,Yolo,113,214977,45,9,0,9,1
2020-03-25,Yuba,115,75493,7,2,0,2,0
2020-03-24,Alameda,001,1643700,504,96,1,97,2
2020-03-24,Alpine,003,1148,1,0,0,0,0
2020-03-24,Amador,005,37829,2,1,0,1,0
2020-03-24,Butte,007,227075,11,3,0,3,0
2020-03-24,Calaveras,009,45235,5,2,0,2,0
2020-03-24,Colusa,011,21464,2,0,0,0,0
2020-03-24,Contra Costa,013,1133247,358,108,0,108,1
2020-03-24,Del Norte,015,27424,0,0,0,0,0
2020-03-24,El Dorado,017,186661,27,3,0,3,0
2020-03-24,Fresno,019,978130,133,18,2,20,0
2020-03-24,Glenn,021,27897,2,0,0,0,0
2020-03-24,Humboldt,023,135768,33,2,0,2,0
2020-03-24,Imperial,025,180216,54,3,0,3,0
2020-03-24,Inyo,027,18085,5,0,0,0,0
2020-03-24,Kern,029,883053,144,5,0,5,0
2020-03-24,Kings,031,150075,25,0,1,1,0
2020-03-24,Lake,033,64148,0,0,0,0,0
2020-03-24,Lassen,035,31185,3,0,1,1,0
2020-03-24,Los Angeles,037,10098052,3728,633,10,643,7
2020-03-24,Madera,039,155013,36,6,0,6,0
2020-03-24,Marin,041,260295,89,44,0,44,0
2020-03-24,Mariposa,043,17540,0,0,0,0,0
2020-03-24,Mendocino,045,87422,3,1,0,1,0
2020-03-24,Merced,047,269075,17,0,0,0,0
2020-03-24,Modoc,049,8938,0,0,0,0,0
2020-03-24,Mono,051,14174,21,1,0,1,0
2020-03-24,Monterey,053,433212,59,23,0,23,1
2020-03-24,Napa,055,140530,23,2,0,2,0
2020-03-24,Nevada,057,99092,30,4,1,5,0
2020-03-24,Orange,059,3164182,939,166,9,175,0
2020-03-24,Placer,061,380077,93,22,0,22,1
2020-03-24,Plumas,063,18699,0,1,0,1,0
2020-03-24,Riverside,065,2383286,746,56,12,68,5
2020-03-24,Sacramento,067,1510023,426,93,0,93,4
2020-03-24,San Benito,069,59416,25,4,0,4,1
2020-03-24,San Bernardino,071,2135413,365,27,0,27,0
2020-03-24,San Diego,073,3302833,1127,231,0,231,2
2020-03-24,San Francisco,075,870044,521,181,0,181,1
2020-03-24,San Joaquin,077,732212,166,52,3,55,2
2020-03-24,San Luis Obispo,079,281455,102,32,0,32,0
2020-03-24,San Mateo,081,765935,536,100,2,102,2
2020-03-24,Santa Barbara,083,443738,151,20,1,21,0
2020-03-24,Santa Clara,085,1922200,1126,389,2,391,17
2020-03-24,Santa Cruz,087,273765,67,22,0,22,0
2020-03-24,Shasta,089,179085,15,3,0,3,0
2020-03-24,Sierra,091,2930,0,0,0,0,0
2020-03-24,Siskiyou,093,43540,4,2,0,2,0
2020-03-24,Solano,095,438530,78,34,0,34,0
2020-03-24,Sonoma,097,501317,116,27,0,27,1
2020-03-24,Stanislaus,099,539301,65,13,3,16,0
2020-03-24,Sutter,101,95872,9,0,0,0,0
2020-03-24,Tehama,103,63373,1,0,0,0,0
2020-03-24,Trinity,105,12862,0,0,0,0,0
2020-03-24,Tulare,107,460477,77,10,3,13,0
2020-03-24,Tuolumne,109,53932,2,0,0,0,0
2020-03-24,Ventura,111,848112,213,44,0,44,1
2020-03-24,Yolo,113,214977,41,8,0,8,0
2020-03-24,Yuba,115,75493,7,2,0,2,0
2020-03-23,Alameda,001,1643700,473,88,1,89,1
2020-03-23,Alpine,003,1148,1,0,0,0,0
2020-03-23,Amador,005,37829,2,1,0,1,0
2020-03-23,Butte,007,227075,11,2,0,2,0
2020-03-23,Calaveras,009,45235,5,2,0,2,0
2020-03-23,Colusa,011,21464,1,0,0,0,0
2020-03-23,Contra Costa,013,1133247,338,91,0,91,2
2020-03-23,Del Norte,015,27424,0,0,0,0,0
2020-03-23,El Dorado,017,186661,26,3,0,3,0
2020-03-23,Fresno,019,978130,123,10,2,12,0
2020-03-23,Glenn,021,27897,2,0,0,0,0
2020-03-23,Humboldt,023,135768,31,2,0,2,0
2020-03-23,Imperial,025,180216,50,2,0,2,0
2020-03-23,Inyo,027,18085,3,0,0,0,0
2020-03-23,Kern,029,883053,130,5,0,5,0
2020-03-23,Kings,031,150075,25,0,1,1,0
2020-03-23,Lake,033,64148,0,0,0,0,0
2020-03-23,Lassen,035,31185,3,0,1,1,0
2020-03-23,Los Angeles,037,10098052,3417,389,10,399,4
2020-03-23,Madera,039,155013,36,4,0,4,0
2020-03-23,Marin,041,260295,84,30,0,30,0
2020-03-23,Mariposa,043,17540,0,0,0,0,0
2020-03-23,Mendocino,045,87422,3,1,0,1,0
2020-03-23,Merced,047,269075,11,0,0,0,0
2020-03-23,Modoc,049,8938,0,0,0,0,0
2020-03-23,Mono,051,14174,19,1,0,1,0
2020-03-23,Monterey,053,433212,54,14,0,14,1
2020-03-23,Napa,055,140530,21,1,0,1,0
2020-03-23,Nevada,057,99092,27,2,1,3,0
2020-03-23,Orange,059,3164182,884,138,7,145,0
2020-03-23,Placer,061,380077,90,19,0,19,1
2020-03-23,Plumas,063,18699,0,0,0,0,0
2020-03-23,Riverside,065,2383286,703,39,12,51,5
2020-03-23,Sacramento,067,1510023,393,87,0,87,4
2020-03-23,San Benito,069,59416,24,4,0,4,1
2020-03-23,San Bernardino,071,2135413,335,17,0,17,0
2020-03-23,San Diego,073,3302833,1068,178,0,178,1
2020-03-23,San Francisco,075,870044,492,152,0,152,0
2020-03-23,San Joaquin,077,732212,154,37,3,40,2
2020-03-23,San Luis Obispo,079,281455,96,23,0,23,0
2020-03-23,San Mateo,081,765935,497,88,2,90,1
2020-03-23,Santa Barbara,083,443738,133,18,1,19,0
2020-03-23,Santa Clara,085,1922200,1077,336,2,338,13
2020-03-23,Santa Cruz,087,273765,65,21,0,21,0
2020-03-23,Shasta,089,179085,13,2,0,2,0
2020-03-23,Sierra,091,2930,0,0,0,0,0
2020-03-23,Siskiyou,093,43540,4,2,0,2,0
2020-03-23,Solano,095,438530,74,33,0,33,0
2020-03-23,Sonoma,097,501317,104,19,0,19,1
2020-03-23,Stanislaus,099,539301,57,10,3,13,0
2020-03-23,Sutter,101,95872,9,0,0,0,0
2020-03-23,Tehama,103,63373,1,0,0,0,0
2020-03-23,Trinity,105,12862,0,0,0,0,0
2020-03-23,Tulare,107,460477,68,9,3,12,0
2020-03-23,Tuolumne,109,53932,2,0,0,0,0
2020-03-23,Ventura,111,848112,196,30,0,30,0
2020-03-23,Yolo,113,214977,40,8,0,8,0
2020-03-23,Yuba,115,75493,7,2,0,2,0
2020-03-22,Alameda,001,1643700,434,72,1,73,1
2020-03-22,Alpine,003,1148,1,0,0,0,0
2020-03-22,Amador,005,37829,2,1,0,1,0
2020-03-22,Butte,007,227075,8,1,0,1,0
2020-03-22,Calaveras,009,45235,4,2,0,2,0
2020-03-22,Colusa,011,21464,1,0,0,0,0
2020-03-22,Contra Costa,013,1133247,311,79,0,79,1
2020-03-22,Del Norte,015,27424,0,0,0,0,0
2020-03-22,El Dorado,017,186661,24,1,0,1,0
2020-03-22,Fresno,019,978130,103,8,2,10,0
2020-03-22,Glenn,021,27897,2,0,0,0,0
2020-03-22,Humboldt,023,135768,28,1,0,1,0
2020-03-22,Imperial,025,180216,48,2,0,2,0
2020-03-22,Inyo,027,18085,1,0,0,0,0
2020-03-22,Kern,029,883053,114,3,0,3,0
2020-03-22,Kings,031,150075,22,0,1,1,0
2020-03-22,Lake,033,64148,0,0,0,0,0
2020-03-22,Lassen,035,31185,3,0,1,1,0
2020-03-22,Los Angeles,037,10098052,3091,384,10,394,3
2020-03-22,Madera,039,155013,33,4,0,4,0
2020-03-22,Marin,041,260295,74,30,0,30,0
2020-03-22,Mariposa,043,17540,0,0,0,0,0
2020-03-22,Mendocino,045,87422,3,1,0,1,0
2020-03-22,Merced,047,269075,7,0,0,0,0
2020-03-22,Modoc,049,8938,0,0,0,0,0
2020-03-22,Mono,051,14174,14,1,0,1,0
2020-03-22,Monterey,053,433212,51,14,0,14,1
2020-03-22,Napa,055,140530,17,1,0,1,0
2020-03-22,Nevada,057,99092,23,2,1,3,0
2020-03-22,Orange,059,3164182,811,102,4,106,0
2020-03-22,Placer,061,380077,88,18,0,18,1
2020-03-22,Plumas,063,18699,0,0,0,0,0
2020-03-22,Riverside,065,2383286,613,26,8,34,5
2020-03-22,Sacramento,067,1510023,361,82,0,82,4
2020-03-22,San Benito,069,59416,19,4,0,4,1
2020-03-22,San Bernardino,071,2135413,291,16,0,16,0
2020-03-22,San Diego,073,3302833,980,161,0,161,0
2020-03-22,San Francisco,075,870044,455,134,0,134,0
2020-03-22,San Joaquin,077,732212,140,30,3,33,2
2020-03-22,San Luis Obispo,079,281455,89,19,0,19,0
2020-03-22,San Mateo,081,765935,464,82,2,84,1
2020-03-22,Santa Barbara,083,443738,119,16,1,17,0
2020-03-22,Santa Clara,085,1922200,1013,284,2,286,13
2020-03-22,Santa Cruz,087,273765,64,19,0,19,0
2020-03-22,Shasta,089,179085,13,1,0,1,0
2020-03-22,Sierra,091,2930,0,0,0,0,0
2020-03-22,Siskiyou,093,43540,4,2,0,2,0
2020-03-22,Solano,095,438530,65,30,0,30,0
2020-03-22,Sonoma,097,501317,99,18,0,18,1
2020-03-22,Stanislaus,099,539301,51,8,3,11,0
2020-03-22,Sutter,101,95872,8,0,0,0,0
2020-03-22,Tehama,103,63373,0,0,0,0,0
2020-03-22,Trinity,105,12862,0,0,0,0,0
2020-03-22,Tulare,107,460477,62,5,3,8,0
2020-03-22,Tuolumne,109,53932,2,0,0,0,0
2020-03-22,Ventura,111,848112,174,26,0,26,0
2020-03-22,Yolo,113,214977,34,6,0,6,0
2020-03-22,Yuba,115,75493,7,2,0,2,0
2020-03-21,Alameda,001,1643700,410,62,1,63,0
2020-03-21,Alpine,003,1148,1,0,0,0,0
2020-03-21,Amador,005,37829,2,1,0,1,0
2020-03-21,Butte,007,227075,7,1,0,1,0
2020-03-21,Calaveras,009,45235,4,2,0,2,0
2020-03-21,Colusa,011,21464,1,0,0,0,0
2020-03-21,Contra Costa,013,1133247,300,62,0,62,1
2020-03-21,Del Norte,015,27424,0,0,0,0,0
2020-03-21,El Dorado,017,186661,21,1,0,1,0
2020-03-21,Fresno,019,978130,99,8,2,10,0
2020-03-21,Glenn,021,27897,2,0,0,0,0
2020-03-21,Humboldt,023,135768,25,1,0,1,0
2020-03-21,Imperial,025,180216,44,2,0,2,0
2020-03-21,Inyo,027,18085,1,0,0,0,0
2020-03-21,Kern,029,883053,108,3,0,3,0
2020-03-21,Kings,031,150075,22,0,1,1,0
2020-03-21,Lake,033,64148,0,0,0,0,0
2020-03-21,Lassen,035,31185,3,0,1,1,0
2020-03-21,Los Angeles,037,10098052,2818,322,10,332,2
2020-03-21,Madera,039,155013,33,4,0,4,0
2020-03-21,Marin,041,260295,69,30,0,30,0
2020-03-21,Mariposa,043,17540,0,0,0,0,0
2020-03-21,Mendocino,045,87422,3,1,0,1,0
2020-03-21,Merced,047,269075,6,0,0,0,0
2020-03-21,Modoc,049,8938,0,0,0,0,0
2020-03-21,Mono,051,14174,14,1,0,1,0
2020-03-21,Monterey,053,433212,48,8,0,8,1
2020-03-21,Napa,055,140530,17,0,0,0,0
2020-03-21,Nevada,057,99092,23,2,1,3,0
2020-03-21,Orange,059,3164182,762,85,4,89,0
2020-03-21,Placer,061,380077,78,11,0,11,1
2020-03-21,Plumas,063,18699,0,0,0,0,0
2020-03-21,Riverside,065,2383286,566,20,8,28,3
2020-03-21,Sacramento,067,1510023,334,66,0,66,3
2020-03-21,San Benito,069,59416,17,4,0,4,1
2020-03-21,San Bernardino,071,2135413,271,13,0,13,0
2020-03-21,San Diego,073,3302833,903,121,0,121,0
2020-03-21,San Francisco,075,870044,419,106,0,106,0
2020-03-21,San Joaquin,077,732212,131,26,3,29,2
2020-03-21,San Luis Obispo,079,281455,84,16,0,16,0
2020-03-21,San Mateo,081,765935,426,78,2,80,1
2020-03-21,Santa Barbara,083,443738,109,8,1,9,0
2020-03-21,Santa Clara,085,1922200,951,269,2,271,10
2020-03-21,Santa Cruz,087,273765,62,17,0,17,0
2020-03-21,Shasta,089,179085,12,1,0,1,0
2020-03-21,Sierra,091,2930,0,0,0,0,0
2020-03-21,Siskiyou,093,43540,4,0,0,0,0
2020-03-21,Solano,095,438530,63,30,0,30,0
2020-03-21,Sonoma,097,501317,98,15,0,15,1
2020-03-21,Stanislaus,099,539301,45,7,3,10,0
2020-03-21,Sutter,101,95872,7,0,0,0,0
2020-03-21,Tehama,103,63373,0,0,0,0,0
2020-03-21,Trinity,105,12862,0,0,0,0,0
2020-03-21,Tulare,107,460477,54,5,3,8,0
2020-03-21,Tuolumne,109,53932,2,0,0,0,0
2020-03-21,Ventura,111,848112,166,22,0,22,0
2020-03-21,Yolo,113,214977,34,6,0,6,0
2020-03-21,Yuba,115,75493,7,1,0,1,0
2020-03-20,Alameda,001,1643700,389,42,1,43,0
2020-03-20,Alpine,003,1148,1,0,0,0,0
2020-03-20,Amador,005,37829,1,0,0,0,0
2020-03-20,Butte,007,227075,7,0,0,0,0
2020-03-20,Calaveras,009,45235,4,2,0,2,0
2020-03-20,Colusa,011,21464,1,0,0,0,0
2020-03-20,Contra Costa,013,1133247,270,52,0,52,1
2020-03-20,Del Norte,015,27424,0,0,0,0,0
2020-03-20,El Dorado,017,186661,20,1,0,1,0
2020-03-20,Fresno,019,978130,96,7,2,9,0
2020-03-20,Glenn,021,27897,1,0,0,0,0
2020-03-20,Humboldt,023,135768,25,1,0,1,0
2020-03-20,Imperial,025,180216,43,2,0,2,0
2020-03-20,Inyo,027,18085,0,0,0,0,0
2020-03-20,Kern,029,883053,93,3,0,3,0
2020-03-20,Kings,031,150075,21,0,1,1,0
2020-03-20,Lake,033,64148,0,0,0,0,0
2020-03-20,Lassen,035,31185,3,0,1,1,0
2020-03-20,Los Angeles,037,10098052,2589,267,9,276,1
2020-03-20,Madera,039,155013,32,4,0,4,0
2020-03-20,Marin,041,260295,66,30,0,30,0
2020-03-20,Mariposa,043,17540,0,0,0,0,0
2020-03-20,Mendocino,045,87422,3,1,0,1,0
2020-03-20,Merced,047,269075,6,0,0,0,0
2020-03-20,Modoc,049,8938,0,0,0,0,0
2020-03-20,Mono,051,14174,14,0,0,0,0
2020-03-20,Monterey,053,433212,47,4,0,4,0
2020-03-20,Napa,055,140530,16,0,0,0,0
2020-03-20,Nevada,057,99092,20,2,1,3,0
2020-03-20,Orange,059,3164182,715,71,4,75,2
2020-03-20,Placer,061,380077,72,9,0,9,1
2020-03-20,Plumas,063,18699,0,0,0,0,0
2020-03-20,Riverside,065,2383286,507,19,8,27,3
2020-03-20,Sacramento,067,1510023,313,56,0,56,4
2020-03-20,San Benito,069,59416,17,4,0,4,1
2020-03-20,San Bernardino,071,2135413,244,9,0,9,0
2020-03-20,San Diego,073,3302833,851,98,0,98,0
2020-03-20,San Francisco,075,870044,387,87,0,87,0
2020-03-20,San Joaquin,077,732212,116,18,3,21,2
2020-03-20,San Luis Obispo,079,281455,80,11,0,11,0
2020-03-20,San Mateo,081,765935,396,71,2,73,1
2020-03-20,Santa Barbara,083,443738,97,7,1,8,0
2020-03-20,Santa Clara,085,1922200,914,246,2,248,8
2020-03-20,Santa Cruz,087,273765,60,13,0,13,0
2020-03-20,Shasta,089,179085,11,1,0,1,0
2020-03-20,Sierra,091,2930,0,0,0,0,0
2020-03-20,Siskiyou,093,43540,4,0,0,0,0
2020-03-20,Solano,095,438530,59,29,0,29,0
2020-03-20,Sonoma,097,501317,90,7,0,7,0
2020-03-20,Stanislaus,099,539301,39,7,3,10,0
2020-03-20,Sutter,101,95872,7,0,0,0,0
2020-03-20,Tehama,103,63373,0,0,0,0,0
2020-03-20,Trinity,105,12862,0,0,0,0,0
2020-03-20,Tulare,107,460477,50,4,3,7,0
2020-03-20,Tuolumne,109,53932,2,0,0,0,0
2020-03-20,Ventura,111,848112,156,18,0,18,0
2020-03-20,Yolo,113,214977,32,5,0,5,0
2020-03-20,Yuba,115,75493,6,0,0,0,0
2020-03-19,Alameda,001,1643700,353,36,1,37,0
2020-03-19,Alpine,003,1148,1,0,0,0,0
2020-03-19,Amador,005,37829,1,0,0,0,0
2020-03-19,Butte,007,227075,5,0,0,0,0
2020-03-19,Calaveras,009,45235,4,2,0,2,0
2020-03-19,Colusa,011,21464,0,0,0,0,0
2020-03-19,Contra Costa,013,1133247,254,46,0,46,0
2020-03-19,Del Norte,015,27424,0,0,0,0,0
2020-03-19,El Dorado,017,186661,18,0,0,0,0
2020-03-19,Fresno,019,978130,87,6,2,8,0
2020-03-19,Glenn,021,27897,1,0,0,0,0
2020-03-19,Humboldt,023,135768,23,1,0,1,0
2020-03-19,Imperial,025,180216,36,2,0,2,0
2020-03-19,Inyo,027,18085,0,0,0,0,0
2020-03-19,Kern,029,883053,81,3,0,3,0
2020-03-19,Kings,031,150075,17,0,1,1,0
2020-03-19,Lake,033,64148,0,0,0,0,0
2020-03-19,Lassen,035,31185,2,0,1,1,0
2020-03-19,Los Angeles,037,10098052,2300,233,9,242,0
2020-03-19,Madera,039,155013,31,3,0,3,0
2020-03-19,Marin,041,260295,63,19,0,19,0
2020-03-19,Mariposa,043,17540,0,0,0,0,0
2020-03-19,Mendocino,045,87422,2,1,0,1,0
2020-03-19,Merced,047,269075,5,0,0,0,0
2020-03-19,Modoc,049,8938,0,0,0,0,0
2020-03-19,Mono,051,14174,12,0,0,0,0
2020-03-19,Monterey,053,433212,39,3,0,3,0
2020-03-19,Napa,055,140530,14,0,0,0,0
2020-03-19,Nevada,057,99092,18,2,1,3,0
2020-03-19,Orange,059,3164182,634,59,4,63,0
2020-03-19,Placer,061,380077,64,8,0,8,1
2020-03-19,Plumas,063,18699,0,0,0,0,0
2020-03-19,Riverside,065,2383286,396,14,6,20,3
2020-03-19,Sacramento,067,1510023,280,52,0,52,3
2020-03-19,San Benito,069,59416,14,3,0,3,0
2020-03-19,San Bernardino,071,2135413,214,7,0,7,0
2020-03-19,San Diego,073,3302833,768,68,0,68,0
2020-03-19,San Francisco,075,870044,351,80,0,80,0
2020-03-19,San Joaquin,077,732212,102,15,3,18,2
2020-03-19,San Luis Obispo,079,281455,77,6,0,6,0
2020-03-19,San Mateo,081,765935,361,58,2,60,1
2020-03-19,Santa Barbara,083,443738,85,5,0,5,0
2020-03-19,Santa Clara,085,1922200,847,183,2,185,8
2020-03-19,Santa Cruz,087,273765,57,13,0,13,0
2020-03-19,Shasta,089,179085,10,1,0,1,0
2020-03-19,Sierra,091,2930,0,0,0,0,0
2020-03-19,Siskiyou,093,43540,3,0,0,0,0
2020-03-19,Solano,095,438530,55,26,0,26,0
2020-03-19,Sonoma,097,501317,87,8,0,8,0
2020-03-19,Stanislaus,099,539301,38,7,3,10,0
2020-03-19,Sutter,101,95872,7,0,0,0,0
2020-03-19,Tehama,103,63373,0,0,0,0,0
2020-03-19,Trinity,105,12862,0,0,0,0,0
2020-03-19,Tulare,107,460477,44,3,3,6,0
2020-03-19,Tuolumne,109,53932,2,0,0,0,0
2020-03-19,Ventura,111,848112,134,15,0,15,0
2020-03-19,Yolo,113,214977,28,5,0,5,0
2020-03-19,Yuba,115,75493,5,0,0,0,0
2020-03-18,Alameda,001,1643700,325,29,1,30,0
2020-03-18,Alpine,003,1148,1,0,0,0,0
2020-03-18,Amador,005,37829,1,0,0,0,0
2020-03-18,Butte,007,227075,4,0,0,0,0
2020-03-18,Calaveras,009,45235,4,2,0,2,0
2020-03-18,Colusa,011,21464,0,0,0,0,0
2020-03-18,Contra Costa,013,1133247,232,44,0,44,0
2020-03-18,Del Norte,015,27424,0,0,0,0,0
2020-03-18,El Dorado,017,186661,17,0,0,0,0
2020-03-18,Fresno,019,978130,78,3,1,4,0
2020-03-18,Glenn,021,27897,1,0,0,0,0
2020-03-18,Humboldt,023,135768,19,1,0,1,0
2020-03-18,Imperial,025,180216,30,2,0,2,0
2020-03-18,Inyo,027,18085,0,0,0,0,0
2020-03-18,Kern,029,883053,66,1,0,1,0
2020-03-18,Kings,031,150075,15,0,1,1,0
2020-03-18,Lake,033,64148,0,0,0,0,0
2020-03-18,Lassen,035,31185,1,0,1,1,0
2020-03-18,Los Angeles,037,10098052,2055,47,9,56,0
2020-03-18,Madera,039,155013,30,2,0,2,0
2020-03-18,Marin,041,260295,58,10,0,10,0
2020-03-18,Mariposa,043,17540,0,0,0,0,0
2020-03-18,Mendocino,045,87422,2,0,0,0,0
2020-03-18,Merced,047,269075,5,0,0,0,0
2020-03-18,Modoc,049,8938,0,0,0,0,0
2020-03-18,Mono,051,14174,11,0,0,0,0
2020-03-18,Monterey,053,433212,31,1,0,1,0
2020-03-18,Napa,055,140530,11,0,0,0,0
2020-03-18,Nevada,057,99092,16,2,1,3,0
2020-03-18,Orange,059,3164182,576,38,4,42,0
2020-03-18,Placer,061,380077,57,8,0,8,1
2020-03-18,Plumas,063,18699,0,0,0,0,0
2020-03-18,Riverside,065,2383286,333,11,5,16,2
2020-03-18,Sacramento,067,1510023,257,46,0,46,3
2020-03-18,San Benito,069,59416,13,3,0,3,0
2020-03-18,San Bernardino,071,2135413,192,3,0,3,0
2020-03-18,San Diego,073,3302833,683,40,0,40,0
2020-03-18,San Francisco,075,870044,332,65,0,65,0
2020-03-18,San Joaquin,077,732212,90,14,3,17,2
2020-03-18,San Luis Obispo,079,281455,70,5,0,5,0
2020-03-18,San Mateo,081,765935,340,57,2,59,1
2020-03-18,Santa Barbara,083,443738,77,2,0,2,0
2020-03-18,Santa Clara,085,1922200,796,151,2,153,6
2020-03-18,Santa Cruz,087,273765,55,11,0,11,0
2020-03-18,Shasta,089,179085,9,1,0,1,0
2020-03-18,Sierra,091,2930,0,0,0,0,0
2020-03-18,Siskiyou,093,43540,3,0,0,0,0
2020-03-18,Solano,095,438530,51,26,0,26,0
2020-03-18,Sonoma,097,501317,78,6,0,6,0
2020-03-18,Stanislaus,099,539301,34,5,2,7,0
2020-03-18,Sutter,101,95872,5,0,0,0,0
2020-03-18,Tehama,103,63373,0,0,0,0,0
2020-03-18,Trinity,105,12862,0,0,0,0,0
2020-03-18,Tulare,107,460477,34,3,3,6,0
2020-03-18,Tuolumne,109,53932,2,0,0,0,0
2020-03-18,Ventura,111,848112,115,11,0,11,0
2020-03-18,Yolo,113,214977,25,4,0,4,0
2020-03-18,Yuba,115,75493,4,0,0,0,0
2020-03-17,Alameda,001,1643700,293,19,0,19,0
2020-03-17,Alpine,003,1148,0,0,0,0,0
2020-03-17,Amador,005,37829,1,0,0,0,0
2020-03-17,Butte,007,227075,4,0,0,0,0
2020-03-17,Calaveras,009,45235,4,2,0,2,0
2020-03-17,Colusa,011,21464,0,0,0,0,0
2020-03-17,Contra Costa,013,1133247,210,37,0,37,0
2020-03-17,Del Norte,015,27424,0,0,0,0,0
2020-03-17,El Dorado,017,186661,16,0,0,0,0
2020-03-17,Fresno,019,978130,68,2,1,3,0
2020-03-17,Glenn,021,27897,1,0,0,0,0
2020-03-17,Humboldt,023,135768,17,1,0,1,0
2020-03-17,Imperial,025,180216,24,2,0,2,0
2020-03-17,Inyo,027,18085,0,0,0,0,0
2020-03-17,Kern,029,883053,52,0,0,0,0
2020-03-17,Kings,031,150075,12,0,1,1,0
2020-03-17,Lake,033,64148,0,0,0,0,0
2020-03-17,Lassen,035,31185,1,0,1,1,0
2020-03-17,Los Angeles,037,10098052,1850,41,9,50,0
2020-03-17,Madera,039,155013,22,2,0,2,0
2020-03-17,Marin,041,260295,51,4,0,4,0
2020-03-17,Mariposa,043,17540,0,0,0,0,0
2020-03-17,Mendocino,045,87422,2,0,0,0,0
2020-03-17,Merced,047,269075,5,0,0,0,0
2020-03-17,Modoc,049,8938,0,0,0,0,0
2020-03-17,Mono,051,14174,9,0,0,0,0
2020-03-17,Monterey,053,433212,29,0,0,0,0
2020-03-17,Napa,055,140530,8,0,0,0,0
2020-03-17,Nevada,057,99092,15,1,1,2,0
2020-03-17,Orange,059,3164182,498,24,3,27,0
2020-03-17,Placer,061,380077,47,7,0,7,1
2020-03-17,Plumas,063,18699,0,0,0,0,0
2020-03-17,Riverside,065,2383286,271,11,5,16,0
2020-03-17,Sacramento,067,1510023,237,36,0,36,1
2020-03-17,San Benito,069,59416,12,2,0,2,0
2020-03-17,San Bernardino,071,2135413,164,2,0,2,0
2020-03-17,San Diego,073,3302833,616,17,0,17,0
2020-03-17,San Francisco,075,870044,305,46,0,46,0
2020-03-17,San Joaquin,077,732212,84,11,3,14,0
2020-03-17,San Luis Obispo,079,281455,62,1,0,1,0
2020-03-17,San Mateo,081,765935,308,46,2,48,1
2020-03-17,Santa Barbara,083,443738,65,0,0,0,0
2020-03-17,Santa Clara,085,1922200,738,121,2,123,4
2020-03-17,Santa Cruz,087,273765,52,10,0,10,0
2020-03-17,Shasta,089,179085,5,1,0,1,0
2020-03-17,Sierra,091,2930,0,0,0,0,0
2020-03-17,Siskiyou,093,43540,3,0,0,0,0
2020-03-17,Solano,095,438530,48,27,0,27,0
2020-03-17,Sonoma,097,501317,70,4,0,4,0
2020-03-17,Stanislaus,099,539301,31,4,2,6,0
2020-03-17,Sutter,101,95872,5,0,0,0,0
2020-03-17,Tehama,103,63373,0,0,0,0,0
2020-03-17,Trinity,105,12862,0,0,0,0,0
2020-03-17,Tulare,107,460477,29,2,3,5,0
2020-03-17,Tuolumne,109,53932,2,0,0,0,0
2020-03-17,Ventura,111,848112,98,7,0,7,0
2020-03-17,Yolo,113,214977,21,2,0,2,0
2020-03-17,Yuba,115,75493,4,0,0,0,0
2020-03-16,Alameda,001,1643700,264,17,0,17,0
2020-03-16,Alpine,003,1148,0,0,0,0,0
2020-03-16,Amador,005,37829,1,0,0,0,0
2020-03-16,Butte,007,227075,3,0,0,0,0
2020-03-16,Calaveras,009,45235,4,2,0,2,0
2020-03-16,Colusa,011,21464,0,0,0,0,0
2020-03-16,Contra Costa,013,1133247,186,36,0,36,0
2020-03-16,Del Norte,015,27424,0,0,0,0,0
2020-03-16,El Dorado,017,186661,15,0,0,0,0
2020-03-16,Fresno,019,978130,53,2,1,3,0
2020-03-16,Glenn,021,27897,0,0,0,0,0
2020-03-16,Humboldt,023,135768,13,1,0,1,0
2020-03-16,Imperial,025,180216,19,2,0,2,0
2020-03-16,Inyo,027,18085,0,0,0,0,0
2020-03-16,Kern,029,883053,43,0,0,0,0
2020-03-16,Kings,031,150075,11,0,1,1,0
2020-03-16,Lake,033,64148,0,0,0,0,0
2020-03-16,Lassen,035,31185,1,0,0,0,0
2020-03-16,Los Angeles,037,10098052,1612,43,9,52,0
2020-03-16,Madera,039,155013,21,2,0,2,0
2020-03-16,Marin,041,260295,48,4,0,4,0
2020-03-16,Mariposa,043,17540,0,0,0,0,0
2020-03-16,Mendocino,045,87422,2,0,0,0,0
2020-03-16,Merced,047,269075,5,0,0,0,0
2020-03-16,Modoc,049,8938,0,0,0,0,0
2020-03-16,Mono,051,14174,7,0,0,0,0
2020-03-16,Monterey,053,433212,28,0,0,0,0
2020-03-16,Napa,055,140530,7,0,0,0,0
2020-03-16,Nevada,057,99092,11,1,1,2,0
2020-03-16,Orange,059,3164182,415,18,3,21,0
2020-03-16,Placer,061,380077,39,7,0,7,1
2020-03-16,Plumas,063,18699,0,0,0,0,0
2020-03-16,Riverside,065,2383286,235,10,5,15,0
2020-03-16,Sacramento,067,1510023,210,34,0,34,1
2020-03-16,San Benito,069,59416,8,2,0,2,0
2020-03-16,San Bernardino,071,2135413,144,1,0,1,0
2020-03-16,San Diego,073,3302833,525,17,0,17,0
2020-03-16,San Francisco,075,870044,267,40,0,40,0
2020-03-16,San Joaquin,077,732212,74,9,3,12,0
2020-03-16,San Luis Obispo,079,281455,55,1,0,1,0
2020-03-16,San Mateo,081,765935,269,42,2,44,1
2020-03-16,Santa Barbara,083,443738,55,0,0,0,0
2020-03-16,Santa Clara,085,1922200,658,115,1,116,2
2020-03-16,Santa Cruz,087,273765,45,9,0,9,0
2020-03-16,Shasta,089,179085,5,1,0,1,0
2020-03-16,Sierra,091,2930,0,0,0,0,0
2020-03-16,Siskiyou,093,43540,2,0,0,0,0
2020-03-16,Solano,095,438530,43,27,0,27,0
2020-03-16,Sonoma,097,501317,62,4,0,4,0
2020-03-16,Stanislaus,099,539301,27,2,2,4,0
2020-03-16,Sutter,101,95872,3,0,0,0,0
2020-03-16,Tehama,103,63373,0,0,0,0,0
2020-03-16,Trinity,105,12862,0,0,0,0,0
2020-03-16,Tulare,107,460477,25,2,3,5,0
2020-03-16,Tuolumne,109,53932,2,0,0,0,0
2020-03-16,Ventura,111,848112,88,7,0,7,0
2020-03-16,Yolo,113,214977,19,2,0,2,0
2020-03-16,Yuba,115,75493,3,0,0,0,0
2020-03-15,Alameda,001,1643700,216,17,0,17,0
2020-03-15,Alpine,003,1148,0,0,0,0,0
2020-03-15,Amador,005,37829,1,0,0,0,0
2020-03-15,Butte,007,227075,3,0,0,0,0
2020-03-15,Calaveras,009,45235,2,2,0,2,0
2020-03-15,Colusa,011,21464,0,0,0,0,0
2020-03-15,Contra Costa,013,1133247,161,34,0,34,0
2020-03-15,Del Norte,015,27424,0,0,0,0,0
2020-03-15,El Dorado,017,186661,14,0,0,0,0
2020-03-15,Fresno,019,978130,33,1,1,2,0
2020-03-15,Glenn,021,27897,0,0,0,0,0
2020-03-15,Humboldt,023,135768,11,1,0,1,0
2020-03-15,Imperial,025,180216,14,2,0,2,0
2020-03-15,Inyo,027,18085,0,0,0,0,0
2020-03-15,Kern,029,883053,37,0,0,0,0
2020-03-15,Kings,031,150075,11,0,1,1,0
2020-03-15,Lake,033,64148,0,0,0,0,0
2020-03-15,Lassen,035,31185,1,0,0,0,0
2020-03-15,Los Angeles,037,10098052,1365,41,9,50,0
2020-03-15,Madera,039,155013,20,2,0,2,0
2020-03-15,Marin,041,260295,41,3,0,3,0
2020-03-15,Mariposa,043,17540,0,0,0,0,0
2020-03-15,Mendocino,045,87422,2,0,0,0,0
2020-03-15,Merced,047,269075,3,0,0,0,0
2020-03-15,Modoc,049,8938,0,0,0,0,0
2020-03-15,Mono,051,14174,6,0,0,0,0
2020-03-15,Monterey,053,433212,21,0,0,0,0
2020-03-15,Napa,055,140530,7,0,0,0,0
2020-03-15,Nevada,057,99092,11,0,1,1,0
2020-03-15,Orange,059,3164182,347,16,1,17,0
2020-03-15,Placer,061,380077,33,7,0,7,1
2020-03-15,Plumas,063,18699,0,0,0,0,0
2020-03-15,Riverside,065,2383286,183,10,5,15,0
2020-03-15,Sacramento,067,1510023,174,30,0,30,1
2020-03-15,San Benito,069,59416,8,2,0,2,0
2020-03-15,San Bernardino,071,2135413,122,0,0,0,0
2020-03-15,San Diego,073,3302833,438,16,0,16,0
2020-03-15,San Francisco,075,870044,209,31,0,31,0
2020-03-15,San Joaquin,077,732212,63,6,3,9,0
2020-03-15,San Luis Obispo,079,281455,45,1,0,1,0
2020-03-15,San Mateo,081,765935,235,29,1,30,1
2020-03-15,Santa Barbara,083,443738,46,0,0,0,0
2020-03-15,Santa Clara,085,1922200,586,79,1,80,2
2020-03-15,Santa Cruz,087,273765,38,8,0,8,0
2020-03-15,Shasta,089,179085,5,1,0,1,0
2020-03-15,Sierra,091,2930,0,0,0,0,0
2020-03-15,Siskiyou,093,43540,2,0,0,0,0
2020-03-15,Solano,095,438530,42,26,0,26,0
2020-03-15,Sonoma,097,501317,53,4,0,4,0
2020-03-15,Stanislaus,099,539301,26,2,2,4,0
2020-03-15,Sutter,101,95872,2,0,0,0,0
2020-03-15,Tehama,103,63373,0,0,0,0,0
2020-03-15,Trinity,105,12862,0,0,0,0,0
2020-03-15,Tulare,107,460477,19,2,3,5,0
2020-03-15,Tuolumne,109,53932,1,0,0,0,0
2020-03-15,Ventura,111,848112,77,5,0,5,0
2020-03-15,Yolo,113,214977,15,2,0,2,0
2020-03-15,Yuba,115,75493,2,0,0,0,0
2020-03-14,Alameda,001,1643700,197,11,0,11,0
2020-03-14,Alpine,003,1148,0,0,0,0,0
2020-03-14,Amador,005,37829,1,0,0,0,0
2020-03-14,Butte,007,227075,2,0,0,0,0
2020-03-14,Calaveras,009,45235,2,2,0,2,0
2020-03-14,Colusa,011,21464,0,0,0,0,0
2020-03-14,Contra Costa,013,1133247,139,30,0,30,0
2020-03-14,Del Norte,015,27424,0,0,0,0,0
2020-03-14,El Dorado,017,186661,12,0,0,0,0
2020-03-14,Fresno,019,978130,25,1,1,2,0
2020-03-14,Glenn,021,27897,0,0,0,0,0
2020-03-14,Humboldt,023,135768,7,1,0,1,0
2020-03-14,Imperial,025,180216,10,2,0,2,0
2020-03-14,Inyo,027,18085,0,0,0,0,0
2020-03-14,Kern,029,883053,32,0,0,0,0
2020-03-14,Kings,031,150075,11,0,1,1,0
2020-03-14,Lake,033,64148,0,0,0,0,0
2020-03-14,Lassen,035,31185,1,0,0,0,0
2020-03-14,Los Angeles,037,10098052,1185,35,9,44,0
2020-03-14,Madera,039,155013,19,2,0,2,0
2020-03-14,Marin,041,260295,37,3,0,3,0
2020-03-14,Mariposa,043,17540,0,0,0,0,0
2020-03-14,Mendocino,045,87422,2,0,0,0,0
2020-03-14,Merced,047,269075,3,0,0,0,0
2020-03-14,Modoc,049,8938,0,0,0,0,0
2020-03-14,Mono,051,14174,5,0,0,0,0
2020-03-14,Monterey,053,433212,15,0,0,0,0
2020-03-14,Napa,055,140530,5,0,0,0,0
2020-03-14,Nevada,057,99092,8,0,1,1,0
2020-03-14,Orange,059,3164182,308,14,0,14,0
2020-03-14,Placer,061,380077,29,6,0,6,1
2020-03-14,Plumas,063,18699,0,0,0,0,0
2020-03-14,Riverside,065,2383286,163,10,5,15,0
2020-03-14,Sacramento,067,1510023,152,31,0,31,1
2020-03-14,San Benito,069,59416,8,2,0,2,0
2020-03-14,San Bernardino,071,2135413,103,0,0,0,0
2020-03-14,San Diego,073,3302833,363,10,0,10,0
2020-03-14,San Francisco,075,870044,188,29,0,29,0
2020-03-14,San Joaquin,077,732212,54,6,3,9,0
2020-03-14,San Luis Obispo,079,281455,40,0,0,0,0
2020-03-14,San Mateo,081,765935,212,27,1,28,0
2020-03-14,Santa Barbara,083,443738,37,0,0,0,0
2020-03-14,Santa Clara,085,1922200,530,62,1,63,2
2020-03-14,Santa Cruz,087,273765,33,8,0,8,0
2020-03-14,Shasta,089,179085,5,1,0,1,0
2020-03-14,Sierra,091,2930,0,0,0,0,0
2020-03-14,Siskiyou,093,43540,1,0,0,0,0
2020-03-14,Solano,095,438530,40,26,0,26,0
2020-03-14,Sonoma,097,501317,40,2,0,2,0
2020-03-14,Stanislaus,099,539301,22,2,2,4,0
2020-03-14,Sutter,101,95872,2,0,0,0,0
2020-03-14,Tehama,103,63373,0,0,0,0,0
2020-03-14,Trinity,105,12862,0,0,0,0,0
2020-03-14,Tulare,107,460477,17,2,2,4,0
2020-03-14,Tuolumne,109,53932,1,0,0,0,0
2020-03-14,Ventura,111,848112,68,5,0,5,0
2020-03-14,Yolo,113,214977,15,2,0,2,0
2020-03-14,Yuba,115,75493,1,0,0,0,0
2020-03-13,Alameda,001,1643700,178,12,0,12,0
2020-03-13,Alpine,003,1148,0,0,0,0,0
2020-03-13,Amador,005,37829,1,0,0,0,0
2020-03-13,Butte,007,227075,0,0,0,0,0
2020-03-13,Calaveras,009,45235,2,2,0,2,0
2020-03-13,Colusa,011,21464,0,0,0,0,0
2020-03-13,Contra Costa,013,1133247,125,22,0,22,0
2020-03-13,Del Norte,015,27424,0,0,0,0,0
2020-03-13,El Dorado,017,186661,11,0,0,0,0
2020-03-13,Fresno,019,978130,20,1,1,2,0
2020-03-13,Glenn,021,27897,0,0,0,0,0
2020-03-13,Humboldt,023,135768,7,1,0,1,0
2020-03-13,Imperial,025,180216,9,2,0,2,0
2020-03-13,Inyo,027,18085,0,0,0,0,0
2020-03-13,Kern,029,883053,27,0,0,0,0
2020-03-13,Kings,031,150075,10,0,1,1,0
2020-03-13,Lake,033,64148,0,0,0,0,0
2020-03-13,Lassen,035,31185,1,0,0,0,0
2020-03-13,Los Angeles,037,10098052,1030,30,7,37,0
2020-03-13,Madera,039,155013,18,1,0,1,0
2020-03-13,Marin,041,260295,34,3,0,3,0
2020-03-13,Mariposa,043,17540,0,0,0,0,0
2020-03-13,Mendocino,045,87422,2,0,0,0,0
2020-03-13,Merced,047,269075,2,0,0,0,0
2020-03-13,Modoc,049,8938,0,0,0,0,0
2020-03-13,Mono,051,14174,3,0,0,0,0
2020-03-13,Monterey,053,433212,10,0,0,0,0
2020-03-13,Napa,055,140530,3,0,0,0,0
2020-03-13,Nevada,057,99092,7,0,1,1,0
2020-03-13,Orange,059,3164182,268,10,0,10,0
2020-03-13,Placer,061,380077,27,6,0,6,1
2020-03-13,Plumas,063,18699,0,0,0,0,0
2020-03-13,Riverside,065,2383286,133,5,4,9,0
2020-03-13,Sacramento,067,1510023,130,18,0,18,1
2020-03-13,San Benito,069,59416,6,2,0,2,0
2020-03-13,San Bernardino,071,2135413,96,0,0,0,0
2020-03-13,San Diego,073,3302833,313,8,0,8,0
2020-03-13,San Francisco,075,870044,174,28,0,28,0
2020-03-13,San Joaquin,077,732212,50,6,3,9,0
2020-03-13,San Luis Obispo,079,281455,33,0,0,0,0
2020-03-13,San Mateo,081,765935,191,24,1,25,0
2020-03-13,Santa Barbara,083,443738,33,0,0,0,0
2020-03-13,Santa Clara,085,1922200,468,59,1,60,1
2020-03-13,Santa Cruz,087,273765,32,7,0,7,0
2020-03-13,Shasta,089,179085,3,1,0,1,0
2020-03-13,Sierra,091,2930,0,0,0,0,0
2020-03-13,Siskiyou,093,43540,0,0,0,0,0
2020-03-13,Solano,095,438530,39,26,0,26,0
2020-03-13,Sonoma,097,501317,39,2,0,2,0
2020-03-13,Stanislaus,099,539301,17,2,2,4,0
2020-03-13,Sutter,101,95872,2,0,0,0,0
2020-03-13,Tehama,103,63373,0,0,0,0,0
2020-03-13,Trinity,105,12862,0,0,0,0,0
2020-03-13,Tulare,107,460477,14,2,2,4,0
2020-03-13,Tuolumne,109,53932,1,0,0,0,0
2020-03-13,Ventura,111,848112,54,5,0,5,0
2020-03-13,Yolo,113,214977,14,1,0,1,0
2020-03-13,Yuba,115,75493,1,0,0,0,0
2020-03-12,Alameda,001,1643700,152,9,0,9,0
2020-03-12,Alpine,003,1148,0,0,0,0,0
2020-03-12,Amador,005,37829,1,0,0,0,0
2020-03-12,Butte,007,227075,0,0,0,0,0
2020-03-12,Calaveras,009,45235,2,2,0,2,0
2020-03-12,Colusa,011,21464,0,0,0,0,0
2020-03-12,Contra Costa,013,1133247,108,18,0,18,0
2020-03-12,Del Norte,015,27424,0,0,0,0,0
2020-03-12,El Dorado,017,186661,9,0,0,0,0
2020-03-12,Fresno,019,978130,12,1,1,2,0
2020-03-12,Glenn,021,27897,0,0,0,0,0
2020-03-12,Humboldt,023,135768,6,1,0,1,0
2020-03-12,Imperial,025,180216,8,2,0,2,0
2020-03-12,Inyo,027,18085,0,0,0,0,0
2020-03-12,Kern,029,883053,18,0,0,0,0
2020-03-12,Kings,031,150075,7,0,1,1,0
2020-03-12,Lake,033,64148,0,0,0,0,0
2020-03-12,Lassen,035,31185,1,0,0,0,0
2020-03-12,Los Angeles,037,10098052,867,30,7,37,0
2020-03-12,Madera,039,155013,15,1,0,1,0
2020-03-12,Marin,041,260295,24,1,0,1,0
2020-03-12,Mariposa,043,17540,0,0,0,0,0
2020-03-12,Mendocino,045,87422,2,0,0,0,0
2020-03-12,Merced,047,269075,2,0,0,0,0
2020-03-12,Modoc,049,8938,0,0,0,0,0
2020-03-12,Mono,051,14174,3,0,0,0,0
2020-03-12,Monterey,053,433212,8,0,0,0,0
2020-03-12,Napa,055,140530,3,0,0,0,0
2020-03-12,Nevada,057,99092,4,0,1,1,0
2020-03-12,Orange,059,3164182,231,7,0,7,0
2020-03-12,Placer,061,380077,23,6,0,6,1
2020-03-12,Plumas,063,18699,0,0,0,0,0
2020-03-12,Riverside,065,2383286,107,5,2,7,0
2020-03-12,Sacramento,067,1510023,106,17,0,17,1
2020-03-12,San Benito,069,59416,5,2,0,2,0
2020-03-12,San Bernardino,071,2135413,80,0,0,0,0
2020-03-12,San Diego,073,3302833,258,9,0,9,0
2020-03-12,San Francisco,075,870044,149,20,0,20,0
2020-03-12,San Joaquin,077,732212,44,3,3,6,1
2020-03-12,San Luis Obispo,079,281455,26,0,0,0,0
2020-03-12,San Mateo,081,765935,157,21,1,22,0
2020-03-12,Santa Barbara,083,443738,22,0,0,0,0
2020-03-12,Santa Clara,085,1922200,410,51,1,52,1
2020-03-12,Santa Cruz,087,273765,29,5,0,5,0
2020-03-12,Shasta,089,179085,2,1,0,1,0
2020-03-12,Sierra,091,2930,0,0,0,0,0
2020-03-12,Siskiyou,093,43540,0,0,0,0,0
2020-03-12,Solano,095,438530,34,26,0,26,0
2020-03-12,Sonoma,097,501317,34,2,0,2,0
2020-03-12,Stanislaus,099,539301,15,2,2,4,0
2020-03-12,Sutter,101,95872,0,0,0,0,0
2020-03-12,Tehama,103,63373,0,0,0,0,0
2020-03-12,Trinity,105,12862,0,0,0,0,0
2020-03-12,Tulare,107,460477,12,1,1,2,0
2020-03-12,Tuolumne,109,53932,1,0,0,0,0
2020-03-12,Ventura,111,848112,45,3,0,3,0
2020-03-12,Yolo,113,214977,13,1,0,1,0
2020-03-12,Yuba,115,75493,1,0,0,0,0
2020-03-11,Alameda,001,1643700,120,5,0,5,0
2020-03-11,Alpine,003,1148,0,0,0,0,0
2020-03-11,Amador,005,37829,1,0,0,0,0
2020-03-11,Butte,007,227075,0,0,0,0,0
2020-03-11,Calaveras,009,45235,2,2,0,2,0
2020-03-11,Colusa,011,21464,0,0,0,0,0
2020-03-11,Contra Costa,013,1133247,93,16,0,16,0
2020-03-11,Del Norte,015,27424,0,0,0,0,0
2020-03-11,El Dorado,017,186661,8,0,0,0,0
2020-03-11,Fresno,019,978130,9,1,1,2,0
2020-03-11,Glenn,021,27897,0,0,0,0,0
2020-03-11,Humboldt,023,135768,6,1,0,1,0
2020-03-11,Imperial,025,180216,6,0,0,0,0
2020-03-11,Inyo,027,18085,0,0,0,0,0
2020-03-11,Kern,029,883053,16,0,0,0,0
2020-03-11,Kings,031,150075,5,0,1,1,0
2020-03-11,Lake,033,64148,0,0,0,0,0
2020-03-11,Lassen,035,31185,1,0,0,0,0
2020-03-11,Los Angeles,037,10098052,699,21,7,28,0
2020-03-11,Madera,039,155013,12,1,0,1,0
2020-03-11,Marin,041,260295,17,1,0,1,0
2020-03-11,Mariposa,043,17540,0,0,0,0,0
2020-03-11,Mendocino,045,87422,1,0,0,0,0
2020-03-11,Merced,047,269075,2,0,0,0,0
2020-03-11,Modoc,049,8938,0,0,0,0,0
2020-03-11,Mono,051,14174,3,0,0,0,0
2020-03-11,Monterey,053,433212,7,0,0,0,0
2020-03-11,Napa,055,140530,2,0,0,0,0
2020-03-11,Nevada,057,99092,4,0,1,1,0
2020-03-11,Orange,059,3164182,202,6,0,6,0
2020-03-11,Placer,061,380077,18,6,0,6,1
2020-03-11,Plumas,063,18699,0,0,0,0,0
2020-03-11,Riverside,065,2383286,81,4,1,5,0
2020-03-11,Sacramento,067,1510023,88,9,0,9,1
2020-03-11,San Benito,069,59416,5,2,0,2,0
2020-03-11,San Bernardino,071,2135413,73,0,0,0,0
2020-03-11,San Diego,073,3302833,208,4,0,4,0
2020-03-11,San Francisco,075,870044,124,17,0,17,0
2020-03-11,San Joaquin,077,732212,33,1,3,4,0
2020-03-11,San Luis Obispo,079,281455,23,0,0,0,0
2020-03-11,San Mateo,081,765935,139,16,0,16,0
2020-03-11,Santa Barbara,083,443738,13,0,0,0,0
2020-03-11,Santa Clara,085,1922200,370,48,1,49,1
2020-03-11,Santa Cruz,087,273765,26,2,0,2,0
2020-03-11,Shasta,089,179085,2,1,0,1,0
2020-03-11,Sierra,091,2930,0,0,0,0,0
2020-03-11,Siskiyou,093,43540,0,0,0,0,0
2020-03-11,Solano,095,438530,29,26,0,26,0
2020-03-11,Sonoma,097,501317,30,2,0,2,0
2020-03-11,Stanislaus,099,539301,15,2,2,4,0
2020-03-11,Sutter,101,95872,0,0,0,0,0
2020-03-11,Tehama,103,63373,0,0,0,0,0
2020-03-11,Trinity,105,12862,0,0,0,0,0
2020-03-11,Tulare,107,460477,10,0,1,1,0
2020-03-11,Tuolumne,109,53932,1,0,0,0,0
2020-03-11,Ventura,111,848112,37,3,0,3,0
2020-03-11,Yolo,113,214977,9,1,0,1,0
2020-03-11,Yuba,115,75493,1,0,0,0,0
2020-03-10,Alameda,001,1643700,99,4,0,4,0
2020-03-10,Alpine,003,1148,0,0,0,0,0
2020-03-10,Amador,005,37829,1,0,0,0,0
2020-03-10,Butte,007,227075,0,0,0,0,0
2020-03-10,Calaveras,009,45235,2,2,0,2,0
2020-03-10,Colusa,011,21464,0,0,0,0,0
2020-03-10,Contra Costa,013,1133247,84,11,0,11,0
2020-03-10,Del Norte,015,27424,0,0,0,0,0
2020-03-10,El Dorado,017,186661,7,0,0,0,0
2020-03-10,Fresno,019,978130,7,1,1,2,0
2020-03-10,Glenn,021,27897,0,0,0,0,0
2020-03-10,Humboldt,023,135768,6,1,0,1,0
2020-03-10,Imperial,025,180216,5,0,0,0,0
2020-03-10,Inyo,027,18085,0,0,0,0,0
2020-03-10,Kern,029,883053,11,0,0,0,0
2020-03-10,Kings,031,150075,5,0,1,1,0
2020-03-10,Lake,033,64148,0,0,0,0,0
2020-03-10,Lassen,035,31185,1,0,0,0,0
2020-03-10,Los Angeles,037,10098052,563,20,7,27,0
2020-03-10,Madera,039,155013,7,1,0,1,0
2020-03-10,Marin,041,260295,16,1,0,1,0
2020-03-10,Mariposa,043,17540,0,0,0,0,0
2020-03-10,Mendocino,045,87422,0,0,0,0,0
2020-03-10,Merced,047,269075,2,0,0,0,0
2020-03-10,Modoc,049,8938,0,0,0,0,0
2020-03-10,Mono,051,14174,3,0,0,0,0
2020-03-10,Monterey,053,433212,5,0,0,0,0
2020-03-10,Napa,055,140530,2,0,0,0,0
2020-03-10,Nevada,057,99092,3,0,1,1,0
2020-03-10,Orange,059,3164182,182,5,0,5,1
2020-03-10,Placer,061,380077,14,7,0,7,1
2020-03-10,Plumas,063,18699,0,0,0,0,0
2020-03-10,Riverside,065,2383286,59,4,1,5,0
2020-03-10,Sacramento,067,1510023,79,8,0,8,0
2020-03-10,San Benito,069,59416,5,2,0,2,0
2020-03-10,San Bernardino,071,2135413,65,0,0,0,0
2020-03-10,San Diego,073,3302833,165,3,0,3,0
2020-03-10,San Francisco,075,870044,92,16,0,16,0
2020-03-10,San Joaquin,077,732212,30,1,3,4,0
2020-03-10,San Luis Obispo,079,281455,15,0,0,0,0
2020-03-10,San Mateo,081,765935,123,11,0,11,0
2020-03-10,Santa Barbara,083,443738,10,0,0,0,0
2020-03-10,Santa Clara,085,1922200,322,45,1,46,1
2020-03-10,Santa Cruz,087,273765,22,2,0,2,0
2020-03-10,Shasta,089,179085,2,1,0,1,0
2020-03-10,Sierra,091,2930,0,0,0,0,0
2020-03-10,Siskiyou,093,43540,0,0,0,0,0
2020-03-10,Solano,095,438530,27,26,0,26,0
2020-03-10,Sonoma,097,501317,27,2,0,2,0
2020-03-10,Stanislaus,099,539301,11,0,2,2,0
2020-03-10,Sutter,101,95872,0,0,0,0,0
2020-03-10,Tehama,103,63373,0,0,0,0,0
2020-03-10,Trinity,105,12862,0,0,0,0,0
2020-03-10,Tulare,107,460477,9,0,1,1,0
2020-03-10,Tuolumne,109,53932,1,0,0,0,0
2020-03-10,Ventura,111,848112,29,1,0,1,0
2020-03-10,Yolo,113,214977,6,2,0,2,0
2020-03-10,Yuba,115,75493,1,0,0,0,0
2020-03-09,Alameda,001,1643700,71,4,0,4,0
2020-03-09,Alpine,003,1148,0,0,0,0,0
2020-03-09,Amador,005,37829,0,0,0,0,0
2020-03-09,Butte,007,227075,0,0,0,0,0
2020-03-09,Calaveras,009,45235,2,0,0,0,0
2020-03-09,Colusa,011,21464,0,0,0,0,0
2020-03-09,Contra Costa,013,1133247,72,9,0,9,0
2020-03-09,Del Norte,015,27424,0,0,0,0,0
2020-03-09,El Dorado,017,186661,5,0,0,0,0
2020-03-09,Fresno,019,978130,7,1,1,2,0
2020-03-09,Glenn,021,27897,0,0,0,0,0
2020-03-09,Humboldt,023,135768,5,1,0,1,0
2020-03-09,Imperial,025,180216,5,0,0,0,0
2020-03-09,Inyo,027,18085,0,0,0,0,0
2020-03-09,Kern,029,883053,8,0,0,0,0
2020-03-09,Kings,031,150075,4,0,1,1,0
2020-03-09,Lake,033,64148,0,0,0,0,0
2020-03-09,Lassen,035,31185,1,0,0,0,0
2020-03-09,Los Angeles,037,10098052,460,17,6,23,0
2020-03-09,Madera,039,155013,7,1,0,1,0
2020-03-09,Marin,041,260295,15,1,0,1,0
2020-03-09,Mariposa,043,17540,0,0,0,0,0
2020-03-09,Mendocino,045,87422,0,0,0,0,0
2020-03-09,Merced,047,269075,2,0,0,0,0
2020-03-09,Modoc,049,8938,0,0,0,0,0
2020-03-09,Mono,051,14174,3,0,0,0,0
2020-03-09,Monterey,053,433212,3,0,0,0,0
2020-03-09,Napa,055,140530,2,0,0,0,0
2020-03-09,Nevada,057,99092,2,0,1,1,0
2020-03-09,Orange,059,3164182,154,4,0,4,0
2020-03-09,Placer,061,380077,12,7,0,7,1
2020-03-09,Plumas,063,18699,0,0,0,0,0
2020-03-09,Riverside,065,2383286,49,4,1,5,0
2020-03-09,Sacramento,067,1510023,75,8,0,8,0
2020-03-09,San Benito,069,59416,3,2,0,2,0
2020-03-09,San Bernardino,071,2135413,54,0,0,0,0
2020-03-09,San Diego,073,3302833,126,2,0,2,0
2020-03-09,San Francisco,075,870044,72,14,0,14,0
2020-03-09,San Joaquin,077,732212,21,0,3,3,0
2020-03-09,San Luis Obispo,079,281455,15,0,0,0,0
2020-03-09,San Mateo,081,765935,109,6,0,6,0
2020-03-09,Santa Barbara,083,443738,8,0,0,0,0
2020-03-09,Santa Clara,085,1922200,278,42,1,43,1
2020-03-09,Santa Cruz,087,273765,19,2,0,2,0
2020-03-09,Shasta,089,179085,2,1,0,1,0
2020-03-09,Sierra,091,2930,0,0,0,0,0
2020-03-09,Siskiyou,093,43540,0,0,0,0,0
2020-03-09,Solano,095,438530,25,26,0,26,0
2020-03-09,Sonoma,097,501317,22,2,0,2,0
2020-03-09,Stanislaus,099,539301,11,0,2,2,0
2020-03-09,Sutter,101,95872,0,0,0,0,0
2020-03-09,Tehama,103,63373,0,0,0,0,0
2020-03-09,Trinity,105,12862,0,0,0,0,0
2020-03-09,Tulare,107,460477,9,0,1,1,0
2020-03-09,Tuolumne,109,53932,1,0,0,0,0
2020-03-09,Ventura,111,848112,25,1,0,1,0
2020-03-09,Yolo,113,214977,5,2,0,2,0
2020-03-09,Yuba,115,75493,0,0,0,0,0
2020-03-08,Alameda,001,1643700,46,4,0,4,0
2020-03-08,Alpine,003,1148,0,0,0,0,0
2020-03-08,Amador,005,37829,0,0,0,0,0
2020-03-08,Butte,007,227075,0,0,0,0,0
2020-03-08,Calaveras,009,45235,2,0,0,0,0
2020-03-08,Colusa,011,21464,0,0,0,0,0
2020-03-08,Contra Costa,013,1133247,58,9,0,9,0
2020-03-08,Del Norte,015,27424,0,0,0,0,0
2020-03-08,El Dorado,017,186661,5,0,0,0,0
2020-03-08,Fresno,019,978130,5,1,1,2,0
2020-03-08,Glenn,021,27897,0,0,0,0,0
2020-03-08,Humboldt,023,135768,5,1,0,1,0
2020-03-08,Imperial,025,180216,5,0,0,0,0
2020-03-08,Inyo,027,18085,0,0,0,0,0
2020-03-08,Kern,029,883053,8,0,0,0,0
2020-03-08,Kings,031,150075,3,0,1,1,0
2020-03-08,Lake,033,64148,0,0,0,0,0
2020-03-08,Lassen,035,31185,0,0,0,0,0
2020-03-08,Los Angeles,037,10098052,367,14,6,20,0
2020-03-08,Madera,039,155013,7,1,0,1,0
2020-03-08,Marin,041,260295,13,1,0,1,0
2020-03-08,Mariposa,043,17540,0,0,0,0,0
2020-03-08,Mendocino,045,87422,0,0,0,0,0
2020-03-08,Merced,047,269075,2,0,0,0,0
2020-03-08,Modoc,049,8938,0,0,0,0,0
2020-03-08,Mono,051,14174,3,0,0,0,0
2020-03-08,Monterey,053,433212,3,0,0,0,0
2020-03-08,Napa,055,140530,2,0,0,0,0
2020-03-08,Nevada,057,99092,1,0,1,1,0
2020-03-08,Orange,059,3164182,129,4,0,4,0
2020-03-08,Placer,061,380077,11,7,0,7,1
2020-03-08,Plumas,063,18699,0,0,0,0,0
2020-03-08,Riverside,065,2383286,41,1,1,2,0
2020-03-08,Sacramento,067,1510023,65,5,0,5,0
2020-03-08,San Benito,069,59416,3,2,0,2,0
2020-03-08,San Bernardino,071,2135413,43,0,0,0,0
2020-03-08,San Diego,073,3302833,92,2,0,2,0
2020-03-08,San Francisco,075,870044,53,9,0,9,0
2020-03-08,San Joaquin,077,732212,18,0,3,3,0
2020-03-08,San Luis Obispo,079,281455,9,0,0,0,0
2020-03-08,San Mateo,081,765935,96,4,0,4,0
2020-03-08,Santa Barbara,083,443738,5,0,0,0,0
2020-03-08,Santa Clara,085,1922200,236,36,1,37,0
2020-03-08,Santa Cruz,087,273765,17,1,0,1,0
2020-03-08,Shasta,089,179085,2,0,0,0,0
2020-03-08,Sierra,091,2930,0,0,0,0,0
2020-03-08,Siskiyou,093,43540,0,0,0,0,0
2020-03-08,Solano,095,438530,24,26,0,26,0
2020-03-08,Sonoma,097,501317,17,2,0,2,0
2020-03-08,Stanislaus,099,539301,10,0,2,2,0
2020-03-08,Sutter,101,95872,0,0,0,0,0
2020-03-08,Tehama,103,63373,0,0,0,0,0
2020-03-08,Trinity,105,12862,0,0,0,0,0
2020-03-08,Tulare,107,460477,9,0,0,0,0
2020-03-08,Tuolumne,109,53932,1,0,0,0,0
2020-03-08,Ventura,111,848112,21,1,0,1,0
2020-03-08,Yolo,113,214977,2,2,0,2,0
2020-03-08,Yuba,115,75493,0,0,0,0,0
2020-03-07,Alameda,001,1643700,41,3,0,3,0
2020-03-07,Alpine,003,1148,0,0,0,0,0
2020-03-07,Amador,005,37829,0,0,0,0,0
2020-03-07,Butte,007,227075,0,0,0,0,0
2020-03-07,Calaveras,009,45235,2,0,0,0,0
2020-03-07,Colusa,011,21464,0,0,0,0,0
2020-03-07,Contra Costa,013,1133247,55,4,0,4,0
2020-03-07,Del Norte,015,27424,0,0,0,0,0
2020-03-07,El Dorado,017,186661,4,0,0,0,0
2020-03-07,Fresno,019,978130,4,1,1,2,0
2020-03-07,Glenn,021,27897,0,0,0,0,0
2020-03-07,Humboldt,023,135768,5,1,0,1,0
2020-03-07,Imperial,025,180216,4,0,0,0,0
2020-03-07,Inyo,027,18085,0,0,0,0,0
2020-03-07,Kern,029,883053,7,0,0,0,0
2020-03-07,Kings,031,150075,3,0,1,1,0
2020-03-07,Lake,033,64148,0,0,0,0,0
2020-03-07,Lassen,035,31185,0,0,0,0,0
2020-03-07,Los Angeles,037,10098052,317,14,6,20,0
2020-03-07,Madera,039,155013,6,1,0,1,0
2020-03-07,Marin,041,260295,11,0,0,0,0
2020-03-07,Mariposa,043,17540,0,0,0,0,0
2020-03-07,Mendocino,045,87422,0,0,0,0,0
2020-03-07,Merced,047,269075,2,0,0,0,0
2020-03-07,Modoc,049,8938,0,0,0,0,0
2020-03-07,Mono,051,14174,3,0,0,0,0
2020-03-07,Monterey,053,433212,3,0,0,0,0
2020-03-07,Napa,055,140530,1,0,0,0,0
2020-03-07,Nevada,057,99092,1,0,1,1,0
2020-03-07,Orange,059,3164182,121,4,0,4,0
2020-03-07,Placer,061,380077,11,6,0,6,1
2020-03-07,Plumas,063,18699,0,0,0,0,0
2020-03-07,Riverside,065,2383286,31,0,1,1,0
2020-03-07,Sacramento,067,1510023,52,4,0,4,0
2020-03-07,San Benito,069,59416,3,2,0,2,0
2020-03-07,San Bernardino,071,2135413,41,0,0,0,0
2020-03-07,San Diego,073,3302833,74,2,0,2,0
2020-03-07,San Francisco,075,870044,47,9,0,9,0
2020-03-07,San Joaquin,077,732212,16,0,3,3,0
2020-03-07,San Luis Obispo,079,281455,6,0,0,0,0
2020-03-07,San Mateo,081,765935,86,1,0,1,0
2020-03-07,Santa Barbara,083,443738,5,0,0,0,0
2020-03-07,Santa Clara,085,1922200,206,31,1,32,0
2020-03-07,Santa Cruz,087,273765,17,1,0,1,0
2020-03-07,Shasta,089,179085,2,0,0,0,0
2020-03-07,Sierra,091,2930,0,0,0,0,0
2020-03-07,Siskiyou,093,43540,0,0,0,0,0
2020-03-07,Solano,095,438530,23,25,0,25,0
2020-03-07,Sonoma,097,501317,13,2,0,2,0
2020-03-07,Stanislaus,099,539301,9,0,2,2,0
2020-03-07,Sutter,101,95872,0,0,0,0,0
2020-03-07,Tehama,103,63373,0,0,0,0,0
2020-03-07,Trinity,105,12862,0,0,0,0,0
2020-03-07,Tulare,107,460477,6,0,0,0,0
2020-03-07,Tuolumne,109,53932,1,0,0,0,0
2020-03-07,Ventura,111,848112,18,1,0,1,0
2020-03-07,Yolo,113,214977,2,2,0,2,0
2020-03-07,Yuba,115,75493,0,0,0,0,0
2020-03-06,Alameda,001,1643700,39,3,0,3,0
2020-03-06,Alpine,003,1148,0,0,0,0,0
2020-03-06,Amador,005,37829,0,0,0,0,0
2020-03-06,Butte,007,227075,0,0,0,0,0
2020-03-06,Calaveras,009,45235,2,0,0,0,0
2020-03-06,Colusa,011,21464,0,0,0,0,0
2020-03-06,Contra Costa,013,1133247,46,4,0,4,0
2020-03-06,Del Norte,015,27424,0,0,0,0,0
2020-03-06,El Dorado,017,186661,3,0,0,0,0
2020-03-06,Fresno,019,978130,3,0,1,1,0
2020-03-06,Glenn,021,27897,0,0,0,0,0
2020-03-06,Humboldt,023,135768,4,1,0,1,0
2020-03-06,Imperial,025,180216,3,0,0,0,0
2020-03-06,Inyo,027,18085,0,0,0,0,0
2020-03-06,Kern,029,883053,6,0,0,0,0
2020-03-06,Kings,031,150075,3,0,1,1,0
2020-03-06,Lake,033,64148,0,0,0,0,0
2020-03-06,Lassen,035,31185,0,0,0,0,0
2020-03-06,Los Angeles,037,10098052,274,13,6,19,0
2020-03-06,Madera,039,155013,5,0,0,0,0
2020-03-06,Marin,041,260295,10,0,0,0,0
2020-03-06,Mariposa,043,17540,0,0,0,0,0
2020-03-06,Mendocino,045,87422,0,0,0,0,0
2020-03-06,Merced,047,269075,2,0,0,0,0
2020-03-06,Modoc,049,8938,0,0,0,0,0
2020-03-06,Mono,051,14174,1,0,0,0,0
2020-03-06,Monterey,053,433212,3,0,0,0,0
2020-03-06,Napa,055,140530,1,0,0,0,0
2020-03-06,Nevada,057,99092,1,0,1,1,0
2020-03-06,Orange,059,3164182,95,4,0,4,0
2020-03-06,Placer,061,380077,10,5,0,5,1
2020-03-06,Plumas,063,18699,0,0,0,0,0
2020-03-06,Riverside,065,2383286,30,0,1,1,0
2020-03-06,Sacramento,067,1510023,43,2,0,2,0
2020-03-06,San Benito,069,59416,3,2,0,2,0
2020-03-06,San Bernardino,071,2135413,39,0,0,0,0
2020-03-06,San Diego,073,3302833,61,2,0,2,0
2020-03-06,San Francisco,075,870044,41,2,0,2,0
2020-03-06,San Joaquin,077,732212,13,0,3,3,0
2020-03-06,San Luis Obispo,079,281455,4,0,0,0,0
2020-03-06,San Mateo,081,765935,78,1,0,1,0
2020-03-06,Santa Barbara,083,443738,3,0,0,0,0
2020-03-06,Santa Clara,085,1922200,188,20,1,21,0
2020-03-06,Santa Cruz,087,273765,15,0,0,0,0
2020-03-06,Shasta,089,179085,2,0,0,0,0
2020-03-06,Sierra,091,2930,0,0,0,0,0
2020-03-06,Siskiyou,093,43540,0,0,0,0,0
2020-03-06,Solano,095,438530,22,25,0,25,0
2020-03-06,Sonoma,097,501317,13,2,0,2,0
2020-03-06,Stanislaus,099,539301,5,0,2,2,0
2020-03-06,Sutter,101,95872,0,0,0,0,0
2020-03-06,Tehama,103,63373,0,0,0,0,0
2020-03-06,Trinity,105,12862,0,0,0,0,0
2020-03-06,Tulare,107,460477,6,0,0,0,0
2020-03-06,Tuolumne,109,53932,1,0,0,0,0
2020-03-06,Ventura,111,848112,15,1,0,1,0
2020-03-06,Yolo,113,214977,2,1,0,1,0
2020-03-06,Yuba,115,75493,0,0,0,0,0
2020-03-05,Alameda,001,1643700,34,2,0,2,0
2020-03-05,Alpine,003,1148,0,0,0,0,0
2020-03-05,Amador,005,37829,0,0,0,0,0
2020-03-05,Butte,007,227075,0,0,0,0,0
2020-03-05,Calaveras,009,45235,2,0,0,0,0
2020-03-05,Colusa,011,21464,0,0,0,0,0
2020-03-05,Contra Costa,013,1133247,39,1,0,1,0
2020-03-05,Del Norte,015,27424,0,0,0,0,0
2020-03-05,El Dorado,017,186661,1,0,0,0,0
2020-03-05,Fresno,019,978130,3,0,1,1,0
2020-03-05,Glenn,021,27897,0,0,0,0,0
2020-03-05,Humboldt,023,135768,4,1,0,1,0
2020-03-05,Imperial,025,180216,2,0,0,0,0
2020-03-05,Inyo,027,18085,0,0,0,0,0
2020-03-05,Kern,029,883053,6,0,0,0,0
2020-03-05,Kings,031,150075,3,0,1,1,0
2020-03-05,Lake,033,64148,0,0,0,0,0
2020-03-05,Lassen,035,31185,0,0,0,0,0
2020-03-05,Los Angeles,037,10098052,227,11,6,17,0
2020-03-05,Madera,039,155013,5,0,0,0,0
2020-03-05,Marin,041,260295,10,0,0,0,0
2020-03-05,Mariposa,043,17540,0,0,0,0,0
2020-03-05,Mendocino,045,87422,0,0,0,0,0
2020-03-05,Merced,047,269075,2,0,0,0,0
2020-03-05,Modoc,049,8938,0,0,0,0,0
2020-03-05,Mono,051,14174,1,0,0,0,0
2020-03-05,Monterey,053,433212,3,0,0,0,0
2020-03-05,Napa,055,140530,1,0,0,0,0
2020-03-05,Nevada,057,99092,0,0,1,1,0
2020-03-05,Orange,059,3164182,80,3,0,3,0
2020-03-05,Placer,061,380077,10,2,0,2,1
2020-03-05,Plumas,063,18699,0,0,0,0,0
2020-03-05,Riverside,065,2383286,27,0,1,1,0
2020-03-05,Sacramento,067,1510023,37,2,0,2,0
2020-03-05,San Benito,069,59416,1,2,0,2,0
2020-03-05,San Bernardino,071,2135413,34,0,0,0,0
2020-03-05,San Diego,073,3302833,54,2,0,2,0
2020-03-05,San Francisco,075,870044,31,2,0,2,0
2020-03-05,San Joaquin,077,732212,10,0,3,3,0
2020-03-05,San Luis Obispo,079,281455,4,0,0,0,0
2020-03-05,San Mateo,081,765935,65,1,0,1,0
2020-03-05,Santa Barbara,083,443738,2,0,0,0,0
2020-03-05,Santa Clara,085,1922200,164,14,1,15,0
2020-03-05,Santa Cruz,087,273765,13,0,0,0,0
2020-03-05,Shasta,089,179085,2,0,0,0,0
2020-03-05,Sierra,091,2930,0,0,0,0,0
2020-03-05,Siskiyou,093,43540,0,0,0,0,0
2020-03-05,Solano,095,438530,22,24,0,24,0
2020-03-05,Sonoma,097,501317,12,2,0,2,0
2020-03-05,Stanislaus,099,539301,4,0,2,2,0
2020-03-05,Sutter,101,95872,0,0,0,0,0
2020-03-05,Tehama,103,63373,0,0,0,0,0
2020-03-05,Trinity,105,12862,0,0,0,0,0
2020-03-05,Tulare,107,460477,6,0,0,0,0
2020-03-05,Tuolumne,109,53932,1,0,0,0,0
2020-03-05,Ventura,111,848112,13,0,0,0,0
2020-03-05,Yolo,113,214977,2,0,0,0,0
2020-03-05,Yuba,115,75493,0,0,0,0,0
2020-03-04,Alameda,001,1643700,30,2,0,2,0
2020-03-04,Alpine,003,1148,0,0,0,0,0
2020-03-04,Amador,005,37829,0,0,0,0,0
2020-03-04,Butte,007,227075,0,0,0,0,0
2020-03-04,Calaveras,009,45235,0,0,0,0,0
2020-03-04,Colusa,011,21464,0,0,0,0,0
2020-03-04,Contra Costa,013,1133247,34,1,0,1,0
2020-03-04,Del Norte,015,27424,0,0,0,0,0
2020-03-04,El Dorado,017,186661,1,0,0,0,0
2020-03-04,Fresno,019,978130,3,0,1,1,0
2020-03-04,Glenn,021,27897,0,0,0,0,0
2020-03-04,Humboldt,023,135768,1,1,0,1,0
2020-03-04,Imperial,025,180216,2,0,0,0,0
2020-03-04,Inyo,027,18085,0,0,0,0,0
2020-03-04,Kern,029,883053,6,0,0,0,0
2020-03-04,Kings,031,150075,3,0,1,1,0
2020-03-04,Lake,033,64148,0,0,0,0,0
2020-03-04,Lassen,035,31185,0,0,0,0,0
2020-03-04,Los Angeles,037,10098052,191,7,6,13,0
2020-03-04,Madera,039,155013,5,0,0,0,0
2020-03-04,Marin,041,260295,10,0,0,0,0
2020-03-04,Mariposa,043,17540,0,0,0,0,0
2020-03-04,Mendocino,045,87422,0,0,0,0,0
2020-03-04,Merced,047,269075,2,0,0,0,0
2020-03-04,Modoc,049,8938,0,0,0,0,0
2020-03-04,Mono,051,14174,1,0,0,0,0
2020-03-04,Monterey,053,433212,3,0,0,0,0
2020-03-04,Napa,055,140530,1,0,0,0,0
2020-03-04,Nevada,057,99092,0,0,1,1,0
2020-03-04,Orange,059,3164182,77,3,0,3,0
2020-03-04,Placer,061,380077,9,2,0,2,1
2020-03-04,Plumas,063,18699,0,0,0,0,0
2020-03-04,Riverside,065,2383286,23,0,1,1,0
2020-03-04,Sacramento,067,1510023,32,1,0,1,0
2020-03-04,San Benito,069,59416,1,2,0,2,0
2020-03-04,San Bernardino,071,2135413,31,0,0,0,0
2020-03-04,San Diego,073,3302833,41,2,0,2,0
2020-03-04,San Francisco,075,870044,26,0,0,0,0
2020-03-04,San Joaquin,077,732212,9,0,3,3,0
2020-03-04,San Luis Obispo,079,281455,4,0,0,0,0
2020-03-04,San Mateo,081,765935,60,1,0,1,0
2020-03-04,Santa Barbara,083,443738,2,0,0,0,0
2020-03-04,Santa Clara,085,1922200,147,12,1,13,0
2020-03-04,Santa Cruz,087,273765,13,0,0,0,0
2020-03-04,Shasta,089,179085,2,0,0,0,0
2020-03-04,Sierra,091,2930,0,0,0,0,0
2020-03-04,Siskiyou,093,43540,0,0,0,0,0
2020-03-04,Solano,095,438530,21,24,0,24,0
2020-03-04,Sonoma,097,501317,11,2,0,2,0
2020-03-04,Stanislaus,099,539301,4,0,2,2,0
2020-03-04,Sutter,101,95872,0,0,0,0,0
2020-03-04,Tehama,103,63373,0,0,0,0,0
2020-03-04,Trinity,105,12862,0,0,0,0,0
2020-03-04,Tulare,107,460477,6,0,0,0,0
2020-03-04,Tuolumne,109,53932,0,0,0,0,0
2020-03-04,Ventura,111,848112,12,0,0,0,0
2020-03-04,Yolo,113,214977,2,0,0,0,0
2020-03-04,Yuba,115,75493,0,0,0,0,0
2020-03-03,Alameda,001,1643700,24,2,0,2,0
2020-03-03,Alpine,003,1148,0,0,0,0,0
2020-03-03,Amador,005,37829,0,0,0,0,0
2020-03-03,Butte,007,227075,0,0,0,0,0
2020-03-03,Calaveras,009,45235,0,0,0,0,0
2020-03-03,Colusa,011,21464,0,0,0,0,0
2020-03-03,Contra Costa,013,1133247,30,0,0,0,0
2020-03-03,Del Norte,015,27424,0,0,0,0,0
2020-03-03,El Dorado,017,186661,1,0,0,0,0
2020-03-03,Fresno,019,978130,2,0,1,1,0
2020-03-03,Glenn,021,27897,0,0,0,0,0
2020-03-03,Humboldt,023,135768,1,1,0,1,0
2020-03-03,Imperial,025,180216,2,0,0,0,0
2020-03-03,Inyo,027,18085,0,0,0,0,0
2020-03-03,Kern,029,883053,4,0,0,0,0
2020-03-03,Kings,031,150075,3,0,1,1,0
2020-03-03,Lake,033,64148,0,0,0,0,0
2020-03-03,Lassen,035,31185,0,0,0,0,0
2020-03-03,Los Angeles,037,10098052,172,5,6,11,0
2020-03-03,Madera,039,155013,4,0,0,0,0
2020-03-03,Marin,041,260295,6,0,0,0,0
2020-03-03,Mariposa,043,17540,0,0,0,0,0
2020-03-03,Mendocino,045,87422,0,0,0,0,0
2020-03-03,Merced,047,269075,2,0,0,0,0
2020-03-03,Modoc,049,8938,0,0,0,0,0
2020-03-03,Mono,051,14174,1,0,0,0,0
2020-03-03,Monterey,053,433212,2,0,0,0,0
2020-03-03,Napa,055,140530,1,0,0,0,0
2020-03-03,Nevada,057,99092,0,0,1,1,0
2020-03-03,Orange,059,3164182,69,1,0,1,0
2020-03-03,Placer,061,380077,8,2,0,2,0
2020-03-03,Plumas,063,18699,0,0,0,0,0
2020-03-03,Riverside,065,2383286,20,0,1,1,0
2020-03-03,Sacramento,067,1510023,31,1,0,1,0
2020-03-03,San Benito,069,59416,1,2,0,2,0
2020-03-03,San Bernardino,071,2135413,28,0,0,0,0
2020-03-03,San Diego,073,3302833,34,2,0,2,0
2020-03-03,San Francisco,075,870044,24,0,0,0,0
2020-03-03,San Joaquin,077,732212,8,0,3,3,0
2020-03-03,San Luis Obispo,079,281455,2,0,0,0,0
2020-03-03,San Mateo,081,765935,53,1,0,1,0
2020-03-03,Santa Barbara,083,443738,1,0,0,0,0
2020-03-03,Santa Clara,085,1922200,132,11,1,12,0
2020-03-03,Santa Cruz,087,273765,10,0,0,0,0
2020-03-03,Shasta,089,179085,2,0,0,0,0
2020-03-03,Sierra,091,2930,0,0,0,0,0
2020-03-03,Siskiyou,093,43540,0,0,0,0,0
2020-03-03,Solano,095,438530,20,24,0,24,0
2020-03-03,Sonoma,097,501317,11,1,0,1,0
2020-03-03,Stanislaus,099,539301,4,0,2,2,0
2020-03-03,Sutter,101,95872,0,0,0,0,0
2020-03-03,Tehama,103,63373,0,0,0,0,0
2020-03-03,Trinity,105,12862,0,0,0,0,0
2020-03-03,Tulare,107,460477,6,0,0,0,0
2020-03-03,Tuolumne,109,53932,0,0,0,0,0
2020-03-03,Ventura,111,848112,11,0,0,0,0
2020-03-03,Yolo,113,214977,1,0,0,0,0
2020-03-03,Yuba,115,75493,0,0,0,0,0
2020-03-02,Alameda,001,1643700,21,1,0,1,0
2020-03-02,Alpine,003,1148,0,0,0,0,0
2020-03-02,Amador,005,37829,0,0,0,0,0
2020-03-02,Butte,007,227075,0,0,0,0,0
2020-03-02,Calaveras,009,45235,0,0,0,0,0
2020-03-02,Colusa,011,21464,0,0,0,0,0
2020-03-02,Contra Costa,013,1133247,27,0,0,0,0
2020-03-02,Del Norte,015,27424,0,0,0,0,0
2020-03-02,El Dorado,017,186661,1,0,0,0,0
2020-03-02,Fresno,019,978130,2,0,1,1,0
2020-03-02,Glenn,021,27897,0,0,0,0,0
2020-03-02,Humboldt,023,135768,1,1,0,1,0
2020-03-02,Imperial,025,180216,2,0,0,0,0
2020-03-02,Inyo,027,18085,0,0,0,0,0
2020-03-02,Kern,029,883053,4,0,0,0,0
2020-03-02,Kings,031,150075,3,0,1,1,0
2020-03-02,Lake,033,64148,0,0,0,0,0
2020-03-02,Lassen,035,31185,0,0,0,0,0
2020-03-02,Los Angeles,037,10098052,157,1,6,7,0
2020-03-02,Madera,039,155013,4,0,0,0,0
2020-03-02,Marin,041,260295,6,0,0,0,0
2020-03-02,Mariposa,043,17540,0,0,0,0,0
2020-03-02,Mendocino,045,87422,0,0,0,0,0
2020-03-02,Merced,047,269075,1,0,0,0,0
2020-03-02,Modoc,049,8938,0,0,0,0,0
2020-03-02,Mono,051,14174,1,0,0,0,0
2020-03-02,Monterey,053,433212,2,0,0,0,0
2020-03-02,Napa,055,140530,1,0,0,0,0
2020-03-02,Nevada,057,99092,0,0,1,1,0
2020-03-02,Orange,059,3164182,64,1,0,1,0
2020-03-02,Placer,061,380077,8,1,0,1,0
2020-03-02,Plumas,063,18699,0,0,0,0,0
2020-03-02,Riverside,065,2383286,19,0,1,1,0
2020-03-02,Sacramento,067,1510023,25,1,0,1,0
2020-03-02,San Benito,069,59416,1,2,0,2,0
2020-03-02,San Bernardino,071,2135413,28,0,0,0,0
2020-03-02,San Diego,073,3302833,28,2,0,2,0
2020-03-02,San Francisco,075,870044,17,0,0,0,0
2020-03-02,San Joaquin,077,732212,7,0,3,3,0
2020-03-02,San Luis Obispo,079,281455,2,0,0,0,0
2020-03-02,San Mateo,081,765935,44,1,0,1,0
2020-03-02,Santa Barbara,083,443738,1,0,0,0,0
2020-03-02,Santa Clara,085,1922200,110,7,1,8,0
2020-03-02,Santa Cruz,087,273765,9,0,0,0,0
2020-03-02,Shasta,089,179085,2,0,0,0,0
2020-03-02,Sierra,091,2930,0,0,0,0,0
2020-03-02,Siskiyou,093,43540,0,0,0,0,0
2020-03-02,Solano,095,438530,19,24,0,24,0
2020-03-02,Sonoma,097,501317,10,1,0,1,0
2020-03-02,Stanislaus,099,539301,2,0,2,2,0
2020-03-02,Sutter,101,95872,0,0,0,0,0
2020-03-02,Tehama,103,63373,0,0,0,0,0
2020-03-02,Trinity,105,12862,0,0,0,0,0
2020-03-02,Tulare,107,460477,6,0,0,0,0
2020-03-02,Tuolumne,109,53932,0,0,0,0,0
2020-03-02,Ventura,111,848112,10,0,0,0,0
2020-03-02,Yolo,113,214977,1,0,0,0,0
2020-03-02,Yuba,115,75493,0,0,0,0,0
2020-03-01,Alameda,001,1643700,20,1,0,1,0
2020-03-01,Alpine,003,1148,0,0,0,0,0
2020-03-01,Amador,005,37829,0,0,0,0,0
2020-03-01,Butte,007,227075,0,0,0,0,0
2020-03-01,Calaveras,009,45235,0,0,0,0,0
2020-03-01,Colusa,011,21464,0,0,0,0,0
2020-03-01,Contra Costa,013,1133247,24,0,0,0,0
2020-03-01,Del Norte,015,27424,0,0,0,0,0
2020-03-01,El Dorado,017,186661,1,0,0,0,0
2020-03-01,Fresno,019,978130,1,0,1,1,0
2020-03-01,Glenn,021,27897,0,0,0,0,0
2020-03-01,Humboldt,023,135768,1,1,0,1,0
2020-03-01,Imperial,025,180216,2,0,0,0,0
2020-03-01,Inyo,027,18085,0,0,0,0,0
2020-03-01,Kern,029,883053,2,0,0,0,0
2020-03-01,Kings,031,150075,3,0,1,1,0
2020-03-01,Lake,033,64148,0,0,0,0,0
2020-03-01,Lassen,035,31185,0,0,0,0,0
2020-03-01,Los Angeles,037,10098052,138,1,6,7,0
2020-03-01,Madera,039,155013,2,0,0,0,0
2020-03-01,Marin,041,260295,5,0,0,0,0
2020-03-01,Mariposa,043,17540,0,0,0,0,0
2020-03-01,Mendocino,045,87422,0,0,0,0,0
2020-03-01,Merced,047,269075,1,0,0,0,0
2020-03-01,Modoc,049,8938,0,0,0,0,0
2020-03-01,Mono,051,14174,1,0,0,0,0
2020-03-01,Monterey,053,433212,1,0,0,0,0
2020-03-01,Napa,055,140530,1,0,0,0,0
2020-03-01,Nevada,057,99092,0,0,1,1,0
2020-03-01,Orange,059,3164182,61,1,0,1,0
2020-03-01,Placer,061,380077,8,0,0,0,0
2020-03-01,Plumas,063,18699,0,0,0,0,0
2020-03-01,Riverside,065,2383286,18,0,1,1,0
2020-03-01,Sacramento,067,1510023,21,1,0,1,0
2020-03-01,San Benito,069,59416,0,2,0,2,0
2020-03-01,San Bernardino,071,2135413,27,0,0,0,0
2020-03-01,San Diego,073,3302833,21,2,0,2,0
2020-03-01,San Francisco,075,870044,13,0,0,0,0
2020-03-01,San Joaquin,077,732212,7,0,3,3,0
2020-03-01,San Luis Obispo,079,281455,2,0,0,0,0
2020-03-01,San Mateo,081,765935,36,0,0,0,0
2020-03-01,Santa Barbara,083,443738,1,0,0,0,0
2020-03-01,Santa Clara,085,1922200,97,6,1,7,0
2020-03-01,Santa Cruz,087,273765,8,0,0,0,0
2020-03-01,Shasta,089,179085,2,0,0,0,0
2020-03-01,Sierra,091,2930,0,0,0,0,0
2020-03-01,Siskiyou,093,43540,0,0,0,0,0
2020-03-01,Solano,095,438530,19,24,0,24,0
2020-03-01,Sonoma,097,501317,9,0,0,0,0
2020-03-01,Stanislaus,099,539301,2,0,2,2,0
2020-03-01,Sutter,101,95872,0,0,0,0,0
2020-03-01,Tehama,103,63373,0,0,0,0,0
2020-03-01,Trinity,105,12862,0,0,0,0,0
2020-03-01,Tulare,107,460477,6,0,0,0,0
2020-03-01,Tuolumne,109,53932,0,0,0,0,0
2020-03-01,Ventura,111,848112,8,0,0,0,0
2020-03-01,Yolo,113,214977,1,0,0,0,0
2020-03-01,Yuba,115,75493,0,0,0,0,0
2020-02-29,Alameda,001,1643700,16,0,0,0,0
2020-02-29,Alpine,003,1148,0,0,0,0,0
2020-02-29,Amador,005,37829,0,0,0,0,0
2020-02-29,Butte,007,227075,0,0,0,0,0
2020-02-29,Calaveras,009,45235,0,0,0,0,0
2020-02-29,Colusa,011,21464,0,0,0,0,0
2020-02-29,Contra Costa,013,1133247,20,0,0,0,0
2020-02-29,Del Norte,015,27424,0,0,0,0,0
2020-02-29,El Dorado,017,186661,1,0,0,0,0
2020-02-29,Fresno,019,978130,1,0,0,0,0
2020-02-29,Glenn,021,27897,0,0,0,0,0
2020-02-29,Humboldt,023,135768,1,1,0,1,0
2020-02-29,Imperial,025,180216,1,0,0,0,0
2020-02-29,Inyo,027,18085,0,0,0,0,0
2020-02-29,Kern,029,883053,2,0,0,0,0
2020-02-29,Kings,031,150075,3,0,1,1,0
2020-02-29,Lake,033,64148,0,0,0,0,0
2020-02-29,Lassen,035,31185,0,0,0,0,0
2020-02-29,Los Angeles,037,10098052,110,1,6,7,0
2020-02-29,Madera,039,155013,2,0,0,0,0
2020-02-29,Marin,041,260295,4,0,0,0,0
2020-02-29,Mariposa,043,17540,0,0,0,0,0
2020-02-29,Mendocino,045,87422,0,0,0,0,0
2020-02-29,Merced,047,269075,1,0,0,0,0
2020-02-29,Modoc,049,8938,0,0,0,0,0
2020-02-29,Mono,051,14174,1,0,0,0,0
2020-02-29,Monterey,053,433212,1,0,0,0,0
2020-02-29,Napa,055,140530,1,0,0,0,0
2020-02-29,Nevada,057,99092,0,0,1,1,0
2020-02-29,Orange,059,3164182,56,1,0,1,0
2020-02-29,Placer,061,380077,7,0,0,0,0
2020-02-29,Plumas,063,18699,0,0,0,0,0
2020-02-29,Riverside,065,2383286,15,0,1,1,0
2020-02-29,Sacramento,067,1510023,16,1,0,1,0
2020-02-29,San Benito,069,59416,0,2,0,2,0
2020-02-29,San Bernardino,071,2135413,25,0,0,0,0
2020-02-29,San Diego,073,3302833,16,2,0,2,0
2020-02-29,San Francisco,075,870044,12,0,0,0,0
2020-02-29,San Joaquin,077,732212,6,0,3,3,0
2020-02-29,San Luis Obispo,079,281455,2,0,0,0,0
2020-02-29,San Mateo,081,765935,29,0,0,0,0
2020-02-29,Santa Barbara,083,443738,0,0,0,0,0
2020-02-29,Santa Clara,085,1922200,75,3,1,4,0
2020-02-29,Santa Cruz,087,273765,8,0,0,0,0
2020-02-29,Shasta,089,179085,2,0,0,0,0
2020-02-29,Sierra,091,2930,0,0,0,0,0
2020-02-29,Siskiyou,093,43540,0,0,0,0,0
2020-02-29,Solano,095,438530,18,23,0,23,0
2020-02-29,Sonoma,097,501317,6,0,0,0,0
2020-02-29,Stanislaus,099,539301,2,0,2,2,0
2020-02-29,Sutter,101,95872,0,0,0,0,0
2020-02-29,Tehama,103,63373,0,0,0,0,0
2020-02-29,Trinity,105,12862,0,0,0,0,0
2020-02-29,Tulare,107,460477,4,0,0,0,0
2020-02-29,Tuolumne,109,53932,0,0,0,0,0
2020-02-29,Ventura,111,848112,6,0,0,0,0
2020-02-29,Yolo,113,214977,1,0,0,0,0
2020-02-29,Yuba,115,75493,0,0,0,0,0
2020-02-28,Alameda,001,1643700,14,0,0,0,0
2020-02-28,Alpine,003,1148,0,0,0,0,0
2020-02-28,Amador,005,37829,0,0,0,0,0
2020-02-28,Butte,007,227075,0,0,0,0,0
2020-02-28,Calaveras,009,45235,0,0,0,0,0
2020-02-28,Colusa,011,21464,0,0,0,0,0
2020-02-28,Contra Costa,013,1133247,20,0,0,0,0
2020-02-28,Del Norte,015,27424,0,0,0,0,0
2020-02-28,El Dorado,017,186661,0,0,0,0,0
2020-02-28,Fresno,019,978130,1,0,0,0,0
2020-02-28,Glenn,021,27897,0,0,0,0,0
2020-02-28,Humboldt,023,135768,1,1,0,1,0
2020-02-28,Imperial,025,180216,1,0,0,0,0
2020-02-28,Inyo,027,18085,0,0,0,0,0
2020-02-28,Kern,029,883053,2,0,0,0,0
2020-02-28,Kings,031,150075,3,0,1,1,0
2020-02-28,Lake,033,64148,0,0,0,0,0
2020-02-28,Lassen,035,31185,0,0,0,0,0
2020-02-28,Los Angeles,037,10098052,102,1,6,7,0
2020-02-28,Madera,039,155013,2,0,0,0,0
2020-02-28,Marin,041,260295,2,0,0,0,0
2020-02-28,Mariposa,043,17540,0,0,0,0,0
2020-02-28,Mendocino,045,87422,0,0,0,0,0
2020-02-28,Merced,047,269075,1,0,0,0,0
2020-02-28,Modoc,049,8938,0,0,0,0,0
2020-02-28,Mono,051,14174,0,0,0,0,0
2020-02-28,Monterey,053,433212,1,0,0,0,0
2020-02-28,Napa,055,140530,1,0,0,0,0
2020-02-28,Nevada,057,99092,0,0,1,1,0
2020-02-28,Orange,059,3164182,54,1,0,1,0
2020-02-28,Placer,061,380077,7,0,0,0,0
2020-02-28,Plumas,063,18699,0,0,0,0,0
2020-02-28,Riverside,065,2383286,13,0,1,1,0
2020-02-28,Sacramento,067,1510023,10,1,0,1,0
2020-02-28,San Benito,069,59416,0,2,0,2,0
2020-02-28,San Bernardino,071,2135413,25,0,0,0,0
2020-02-28,San Diego,073,3302833,13,2,0,2,0
2020-02-28,San Francisco,075,870044,10,0,0,0,0
2020-02-28,San Joaquin,077,732212,6,0,3,3,0
2020-02-28,San Luis Obispo,079,281455,2,0,0,0,0
2020-02-28,San Mateo,081,765935,24,0,0,0,0
2020-02-28,Santa Barbara,083,443738,0,0,0,0,0
2020-02-28,Santa Clara,085,1922200,70,3,1,4,0
2020-02-28,Santa Cruz,087,273765,8,0,0,0,0
2020-02-28,Shasta,089,179085,2,0,0,0,0
2020-02-28,Sierra,091,2930,0,0,0,0,0
2020-02-28,Siskiyou,093,43540,0,0,0,0,0
2020-02-28,Solano,095,438530,17,23,0,23,0
2020-02-28,Sonoma,097,501317,6,0,0,0,0
2020-02-28,Stanislaus,099,539301,2,0,2,2,0
2020-02-28,Sutter,101,95872,0,0,0,0,0
2020-02-28,Tehama,103,63373,0,0,0,0,0
2020-02-28,Trinity,105,12862,0,0,0,0,0
2020-02-28,Tulare,107,460477,3,0,0,0,0
2020-02-28,Tuolumne,109,53932,0,0,0,0,0
2020-02-28,Ventura,111,848112,6,0,0,0,0
2020-02-28,Yolo,113,214977,1,0,0,0,0
2020-02-28,Yuba,115,75493,0,0,0,0,0
2020-02-27,Alameda,001,1643700,13,0,0,0,0
2020-02-27,Alpine,003,1148,0,0,0,0,0
2020-02-27,Amador,005,37829,0,0,0,0,0
2020-02-27,Butte,007,227075,0,0,0,0,0
2020-02-27,Calaveras,009,45235,0,0,0,0,0
2020-02-27,Colusa,011,21464,0,0,0,0,0
2020-02-27,Contra Costa,013,1133247,14,0,0,0,0
2020-02-27,Del Norte,015,27424,0,0,0,0,0
2020-02-27,El Dorado,017,186661,0,0,0,0,0
2020-02-27,Fresno,019,978130,1,0,0,0,0
2020-02-27,Glenn,021,27897,0,0,0,0,0
2020-02-27,Humboldt,023,135768,1,1,0,1,0
2020-02-27,Imperial,025,180216,1,0,0,0,0
2020-02-27,Inyo,027,18085,0,0,0,0,0
2020-02-27,Kern,029,883053,2,0,0,0,0
2020-02-27,Kings,031,150075,3,0,1,1,0
2020-02-27,Lake,033,64148,0,0,0,0,0
2020-02-27,Lassen,035,31185,0,0,0,0,0
2020-02-27,Los Angeles,037,10098052,94,1,6,7,0
2020-02-27,Madera,039,155013,2,0,0,0,0
2020-02-27,Marin,041,260295,1,0,0,0,0
2020-02-27,Mariposa,043,17540,0,0,0,0,0
2020-02-27,Mendocino,045,87422,0,0,0,0,0
2020-02-27,Merced,047,269075,1,0,0,0,0
2020-02-27,Modoc,049,8938,0,0,0,0,0
2020-02-27,Mono,051,14174,0,0,0,0,0
2020-02-27,Monterey,053,433212,1,0,0,0,0
2020-02-27,Napa,055,140530,1,0,0,0,0
2020-02-27,Nevada,057,99092,0,0,1,1,0
2020-02-27,Orange,059,3164182,48,1,0,1,0
2020-02-27,Placer,061,380077,6,0,0,0,0
2020-02-27,Plumas,063,18699,0,0,0,0,0
2020-02-27,Riverside,065,2383286,12,0,1,1,0
2020-02-27,Sacramento,067,1510023,10,1,0,1,0
2020-02-27,San Benito,069,59416,0,2,0,2,0
2020-02-27,San Bernardino,071,2135413,25,0,0,0,0
2020-02-27,San Diego,073,3302833,12,2,0,2,0
2020-02-27,San Francisco,075,870044,9,0,0,0,0
2020-02-27,San Joaquin,077,732212,5,0,3,3,0
2020-02-27,San Luis Obispo,079,281455,2,0,0,0,0
2020-02-27,San Mateo,081,765935,20,0,0,0,0
2020-02-27,Santa Barbara,083,443738,0,0,0,0,0
2020-02-27,Santa Clara,085,1922200,59,2,1,3,0
2020-02-27,Santa Cruz,087,273765,6,0,0,0,0
2020-02-27,Shasta,089,179085,0,0,0,0,0
2020-02-27,Sierra,091,2930,0,0,0,0,0
2020-02-27,Siskiyou,093,43540,0,0,0,0,0
2020-02-27,Solano,095,438530,17,23,0,23,0
2020-02-27,Sonoma,097,501317,5,0,0,0,0
2020-02-27,Stanislaus,099,539301,2,0,2,2,0
2020-02-27,Sutter,101,95872,0,0,0,0,0
2020-02-27,Tehama,103,63373,0,0,0,0,0
2020-02-27,Trinity,105,12862,0,0,0,0,0
2020-02-27,Tulare,107,460477,3,0,0,0,0
2020-02-27,Tuolumne,109,53932,0,0,0,0,0
2020-02-27,Ventura,111,848112,4,0,0,0,0
2020-02-27,Yolo,113,214977,1,0,0,0,0
2020-02-27,Yuba,115,75493,0,0,0,0,0
2020-02-26,Alameda,001,1643700,13,0,0,0,0
2020-02-26,Alpine,003,1148,0,0,0,0,0
2020-02-26,Amador,005,37829,0,0,0,0,0
2020-02-26,Butte,007,227075,0,0,0,0,0
2020-02-26,Calaveras,009,45235,0,0,0,0,0
2020-02-26,Colusa,011,21464,0,0,0,0,0
2020-02-26,Contra Costa,013,1133247,13,0,0,0,0
2020-02-26,Del Norte,015,27424,0,0,0,0,0
2020-02-26,El Dorado,017,186661,0,0,0,0,0
2020-02-26,Fresno,019,978130,1,0,0,0,0
2020-02-26,Glenn,021,27897,0,0,0,0,0
2020-02-26,Humboldt,023,135768,1,1,0,1,0
2020-02-26,Imperial,025,180216,1,0,0,0,0
2020-02-26,Inyo,027,18085,0,0,0,0,0
2020-02-26,Kern,029,883053,2,0,0,0,0
2020-02-26,Kings,031,150075,3,0,1,1,0
2020-02-26,Lake,033,64148,0,0,0,0,0
2020-02-26,Lassen,035,31185,0,0,0,0,0
2020-02-26,Los Angeles,037,10098052,88,1,6,7,0
2020-02-26,Madera,039,155013,2,0,0,0,0
2020-02-26,Marin,041,260295,1,0,0,0,0
2020-02-26,Mariposa,043,17540,0,0,0,0,0
2020-02-26,Mendocino,045,87422,0,0,0,0,0
2020-02-26,Merced,047,269075,1,0,0,0,0
2020-02-26,Modoc,049,8938,0,0,0,0,0
2020-02-26,Mono,051,14174,0,0,0,0,0
2020-02-26,Monterey,053,433212,1,0,0,0,0
2020-02-26,Napa,055,140530,0,0,0,0,0
2020-02-26,Nevada,057,99092,0,0,1,1,0
2020-02-26,Orange,059,3164182,47,1,0,1,0
2020-02-26,Placer,061,380077,5,0,0,0,0
2020-02-26,Plumas,063,18699,0,0,0,0,0
2020-02-26,Riverside,065,2383286,10,0,1,1,0
2020-02-26,Sacramento,067,1510023,10,1,0,1,0
2020-02-26,San Benito,069,59416,0,2,0,2,0
2020-02-26,San Bernardino,071,2135413,23,0,0,0,0
2020-02-26,San Diego,073,3302833,11,2,0,2,0
2020-02-26,San Francisco,075,870044,9,0,0,0,0
2020-02-26,San Joaquin,077,732212,5,0,3,3,0
2020-02-26,San Luis Obispo,079,281455,2,0,0,0,0
2020-02-26,San Mateo,081,765935,18,0,0,0,0
2020-02-26,Santa Barbara,083,443738,0,0,0,0,0
2020-02-26,Santa Clara,085,1922200,50,2,1,3,0
2020-02-26,Santa Cruz,087,273765,6,0,0,0,0
2020-02-26,Shasta,089,179085,0,0,0,0,0
2020-02-26,Sierra,091,2930,0,0,0,0,0
2020-02-26,Siskiyou,093,43540,0,0,0,0,0
2020-02-26,Solano,095,438530,17,23,0,23,0
2020-02-26,Sonoma,097,501317,5,0,0,0,0
2020-02-26,Stanislaus,099,539301,2,0,2,2,0
2020-02-26,Sutter,101,95872,0,0,0,0,0
2020-02-26,Tehama,103,63373,0,0,0,0,0
2020-02-26,Trinity,105,12862,0,0,0,0,0
2020-02-26,Tulare,107,460477,3,0,0,0,0
2020-02-26,Tuolumne,109,53932,0,0,0,0,0
2020-02-26,Ventura,111,848112,4,0,0,0,0
2020-02-26,Yolo,113,214977,1,0,0,0,0
2020-02-26,Yuba,115,75493,0,0,0,0,0
2020-02-25,Alameda,001,1643700,13,0,0,0,0
2020-02-25,Alpine,003,1148,0,0,0,0,0
2020-02-25,Amador,005,37829,0,0,0,0,0
2020-02-25,Butte,007,227075,0,0,0,0,0
2020-02-25,Calaveras,009,45235,0,0,0,0,0
2020-02-25,Colusa,011,21464,0,0,0,0,0
2020-02-25,Contra Costa,013,1133247,11,0,0,0,0
2020-02-25,Del Norte,015,27424,0,0,0,0,0
2020-02-25,El Dorado,017,186661,0,0,0,0,0
2020-02-25,Fresno,019,978130,1,0,0,0,0
2020-02-25,Glenn,021,27897,0,0,0,0,0
2020-02-25,Humboldt,023,135768,1,1,0,1,0
2020-02-25,Imperial,025,180216,1,0,0,0,0
2020-02-25,Inyo,027,18085,0,0,0,0,0
2020-02-25,Kern,029,883053,2,0,0,0,0
2020-02-25,Kings,031,150075,3,0,1,1,0
2020-02-25,Lake,033,64148,0,0,0,0,0
2020-02-25,Lassen,035,31185,0,0,0,0,0
2020-02-25,Los Angeles,037,10098052,76,1,6,7,0
2020-02-25,Madera,039,155013,2,0,0,0,0
2020-02-25,Marin,041,260295,1,0,0,0,0
2020-02-25,Mariposa,043,17540,0,0,0,0,0
2020-02-25,Mendocino,045,87422,0,0,0,0,0
2020-02-25,Merced,047,269075,0,0,0,0,0
2020-02-25,Modoc,049,8938,0,0,0,0,0
2020-02-25,Mono,051,14174,0,0,0,0,0
2020-02-25,Monterey,053,433212,1,0,0,0,0
2020-02-25,Napa,055,140530,0,0,0,0,0
2020-02-25,Nevada,057,99092,0,0,1,1,0
2020-02-25,Orange,059,3164182,46,1,0,1,0
2020-02-25,Placer,061,380077,5,0,0,0,0
2020-02-25,Plumas,063,18699,0,0,0,0,0
2020-02-25,Riverside,065,2383286,10,0,1,1,0
2020-02-25,Sacramento,067,1510023,8,1,0,1,0
2020-02-25,San Benito,069,59416,0,2,0,2,0
2020-02-25,San Bernardino,071,2135413,21,0,0,0,0
2020-02-25,San Diego,073,3302833,7,2,0,2,0
2020-02-25,San Francisco,075,870044,7,0,0,0,0
2020-02-25,San Joaquin,077,732212,5,0,2,2,0
2020-02-25,San Luis Obispo,079,281455,2,0,0,0,0
2020-02-25,San Mateo,081,765935,17,0,0,0,0
2020-02-25,Santa Barbara,083,443738,0,0,0,0,0
2020-02-25,Santa Clara,085,1922200,40,2,1,3,0
2020-02-25,Santa Cruz,087,273765,5,0,0,0,0
2020-02-25,Shasta,089,179085,0,0,0,0,0
2020-02-25,Sierra,091,2930,0,0,0,0,0
2020-02-25,Siskiyou,093,43540,0,0,0,0,0
2020-02-25,Solano,095,438530,16,21,0,21,0
2020-02-25,Sonoma,097,501317,5,0,0,0,0
2020-02-25,Stanislaus,099,539301,2,0,2,2,0
2020-02-25,Sutter,101,95872,0,0,0,0,0
2020-02-25,Tehama,103,63373,0,0,0,0,0
2020-02-25,Trinity,105,12862,0,0,0,0,0
2020-02-25,Tulare,107,460477,3,0,0,0,0
2020-02-25,Tuolumne,109,53932,0,0,0,0,0
2020-02-25,Ventura,111,848112,4,0,0,0,0
2020-02-25,Yolo,113,214977,1,0,0,0,0
2020-02-25,Yuba,115,75493,0,0,0,0,0
2020-02-24,Alameda,001,1643700,13,0,0,0,0
2020-02-24,Alpine,003,1148,0,0,0,0,0
2020-02-24,Amador,005,37829,0,0,0,0,0
2020-02-24,Butte,007,227075,0,0,0,0,0
2020-02-24,Calaveras,009,45235,0,0,0,0,0
2020-02-24,Colusa,011,21464,0,0,0,0,0
2020-02-24,Contra Costa,013,1133247,9,0,0,0,0
2020-02-24,Del Norte,015,27424,0,0,0,0,0
2020-02-24,El Dorado,017,186661,0,0,0,0,0
2020-02-24,Fresno,019,978130,1,0,0,0,0
2020-02-24,Glenn,021,27897,0,0,0,0,0
2020-02-24,Humboldt,023,135768,1,1,0,1,0
2020-02-24,Imperial,025,180216,1,0,0,0,0
2020-02-24,Inyo,027,18085,0,0,0,0,0
2020-02-24,Kern,029,883053,2,0,0,0,0
2020-02-24,Kings,031,150075,3,0,1,1,0
2020-02-24,Lake,033,64148,0,0,0,0,0
2020-02-24,Lassen,035,31185,0,0,0,0,0
2020-02-24,Los Angeles,037,10098052,71,1,6,7,0
2020-02-24,Madera,039,155013,1,0,0,0,0
2020-02-24,Marin,041,260295,1,0,0,0,0
2020-02-24,Mariposa,043,17540,0,0,0,0,0
2020-02-24,Mendocino,045,87422,0,0,0,0,0
2020-02-24,Merced,047,269075,0,0,0,0,0
2020-02-24,Modoc,049,8938,0,0,0,0,0
2020-02-24,Mono,051,14174,0,0,0,0,0
2020-02-24,Monterey,053,433212,1,0,0,0,0
2020-02-24,Napa,055,140530,0,0,0,0,0
2020-02-24,Nevada,057,99092,0,0,1,1,0
2020-02-24,Orange,059,3164182,44,1,0,1,0
2020-02-24,Placer,061,380077,3,0,0,0,0
2020-02-24,Plumas,063,18699,0,0,0,0,0
2020-02-24,Riverside,065,2383286,9,0,1,1,0
2020-02-24,Sacramento,067,1510023,7,1,0,1,0
2020-02-24,San Benito,069,59416,0,2,0,2,0
2020-02-24,San Bernardino,071,2135413,21,0,0,0,0
2020-02-24,San Diego,073,3302833,7,2,0,2,0
2020-02-24,San Francisco,075,870044,6,0,0,0,0
2020-02-24,San Joaquin,077,732212,5,0,1,1,0
2020-02-24,San Luis Obispo,079,281455,2,0,0,0,0
2020-02-24,San Mateo,081,765935,13,0,0,0,0
2020-02-24,Santa Barbara,083,443738,0,0,0,0,0
2020-02-24,Santa Clara,085,1922200,38,2,1,3,0
2020-02-24,Santa Cruz,087,273765,5,0,0,0,0
2020-02-24,Shasta,089,179085,0,0,0,0,0
2020-02-24,Sierra,091,2930,0,0,0,0,0
2020-02-24,Siskiyou,093,43540,0,0,0,0,0
2020-02-24,Solano,095,438530,13,15,0,15,0
2020-02-24,Sonoma,097,501317,5,0,0,0,0
2020-02-24,Stanislaus,099,539301,2,0,2,2,0
2020-02-24,Sutter,101,95872,0,0,0,0,0
2020-02-24,Tehama,103,63373,0,0,0,0,0
2020-02-24,Trinity,105,12862,0,0,0,0,0
2020-02-24,Tulare,107,460477,3,0,0,0,0
2020-02-24,Tuolumne,109,53932,0,0,0,0,0
2020-02-24,Ventura,111,848112,4,0,0,0,0
2020-02-24,Yolo,113,214977,1,0,0,0,0
2020-02-24,Yuba,115,75493,0,0,0,0,0
2020-02-23,Alameda,001,1643700,11,0,0,0,0
2020-02-23,Alpine,003,1148,0,0,0,0,0
2020-02-23,Amador,005,37829,0,0,0,0,0
2020-02-23,Butte,007,227075,0,0,0,0,0
2020-02-23,Calaveras,009,45235,0,0,0,0,0
2020-02-23,Colusa,011,21464,0,0,0,0,0
2020-02-23,Contra Costa,013,1133247,6,0,0,0,0
2020-02-23,Del Norte,015,27424,0,0,0,0,0
2020-02-23,El Dorado,017,186661,0,0,0,0,0
2020-02-23,Fresno,019,978130,1,0,0,0,0
2020-02-23,Glenn,021,27897,0,0,0,0,0
2020-02-23,Humboldt,023,135768,1,1,0,1,0
2020-02-23,Imperial,025,180216,1,0,0,0,0
2020-02-23,Inyo,027,18085,0,0,0,0,0
2020-02-23,Kern,029,883053,2,0,0,0,0
2020-02-23,Kings,031,150075,3,0,1,1,0
2020-02-23,Lake,033,64148,0,0,0,0,0
2020-02-23,Lassen,035,31185,0,0,0,0,0
2020-02-23,Los Angeles,037,10098052,63,1,6,7,0
2020-02-23,Madera,039,155013,1,0,0,0,0
2020-02-23,Marin,041,260295,1,0,0,0,0
2020-02-23,Mariposa,043,17540,0,0,0,0,0
2020-02-23,Mendocino,045,87422,0,0,0,0,0
2020-02-23,Merced,047,269075,0,0,0,0,0
2020-02-23,Modoc,049,8938,0,0,0,0,0
2020-02-23,Mono,051,14174,0,0,0,0,0
2020-02-23,Monterey,053,433212,1,0,0,0,0
2020-02-23,Napa,055,140530,0,0,0,0,0
2020-02-23,Nevada,057,99092,0,0,1,1,0
2020-02-23,Orange,059,3164182,44,1,0,1,0
2020-02-23,Placer,061,380077,3,0,0,0,0
2020-02-23,Plumas,063,18699,0,0,0,0,0
2020-02-23,Riverside,065,2383286,9,0,0,0,0
2020-02-23,Sacramento,067,1510023,6,1,0,1,0
2020-02-23,San Benito,069,59416,0,2,0,2,0
2020-02-23,San Bernardino,071,2135413,20,0,0,0,0
2020-02-23,San Diego,073,3302833,6,2,0,2,0
2020-02-23,San Francisco,075,870044,5,0,0,0,0
2020-02-23,San Joaquin,077,732212,4,0,1,1,0
2020-02-23,San Luis Obispo,079,281455,2,0,0,0,0
2020-02-23,San Mateo,081,765935,10,0,0,0,0
2020-02-23,Santa Barbara,083,443738,0,0,0,0,0
2020-02-23,Santa Clara,085,1922200,26,2,1,3,0
2020-02-23,Santa Cruz,087,273765,2,0,0,0,0
2020-02-23,Shasta,089,179085,0,0,0,0,0
2020-02-23,Sierra,091,2930,0,0,0,0,0
2020-02-23,Siskiyou,093,43540,0,0,0,0,0
2020-02-23,Solano,095,438530,11,15,0,15,0
2020-02-23,Sonoma,097,501317,5,0,0,0,0
2020-02-23,Stanislaus,099,539301,2,0,2,2,0
2020-02-23,Sutter,101,95872,0,0,0,0,0
2020-02-23,Tehama,103,63373,0,0,0,0,0
2020-02-23,Trinity,105,12862,0,0,0,0,0
2020-02-23,Tulare,107,460477,2,0,0,0,0
2020-02-23,Tuolumne,109,53932,0,0,0,0,0
2020-02-23,Ventura,111,848112,4,0,0,0,0
2020-02-23,Yolo,113,214977,1,0,0,0,0
2020-02-23,Yuba,115,75493,0,0,0,0,0
2020-02-22,Alameda,001,1643700,10,0,0,0,0
2020-02-22,Alpine,003,1148,0,0,0,0,0
2020-02-22,Amador,005,37829,0,0,0,0,0
2020-02-22,Butte,007,227075,0,0,0,0,0
2020-02-22,Calaveras,009,45235,0,0,0,0,0
2020-02-22,Colusa,011,21464,0,0,0,0,0
2020-02-22,Contra Costa,013,1133247,5,0,0,0,0
2020-02-22,Del Norte,015,27424,0,0,0,0,0
2020-02-22,El Dorado,017,186661,0,0,0,0,0
2020-02-22,Fresno,019,978130,1,0,0,0,0
2020-02-22,Glenn,021,27897,0,0,0,0,0
2020-02-22,Humboldt,023,135768,1,1,0,1,0
2020-02-22,Imperial,025,180216,0,0,0,0,0
2020-02-22,Inyo,027,18085,0,0,0,0,0
2020-02-22,Kern,029,883053,2,0,0,0,0
2020-02-22,Kings,031,150075,3,0,1,1,0
2020-02-22,Lake,033,64148,0,0,0,0,0
2020-02-22,Lassen,035,31185,0,0,0,0,0
2020-02-22,Los Angeles,037,10098052,61,1,6,7,0
2020-02-22,Madera,039,155013,0,0,0,0,0
2020-02-22,Marin,041,260295,1,0,0,0,0
2020-02-22,Mariposa,043,17540,0,0,0,0,0
2020-02-22,Mendocino,045,87422,0,0,0,0,0
2020-02-22,Merced,047,269075,0,0,0,0,0
2020-02-22,Modoc,049,8938,0,0,0,0,0
2020-02-22,Mono,051,14174,0,0,0,0,0
2020-02-22,Monterey,053,433212,1,0,0,0,0
2020-02-22,Napa,055,140530,0,0,0,0,0
2020-02-22,Nevada,057,99092,0,0,1,1,0
2020-02-22,Orange,059,3164182,43,1,0,1,0
2020-02-22,Placer,061,380077,3,0,0,0,0
2020-02-22,Plumas,063,18699,0,0,0,0,0
2020-02-22,Riverside,065,2383286,9,0,0,0,0
2020-02-22,Sacramento,067,1510023,6,1,0,1,0
2020-02-22,San Benito,069,59416,0,2,0,2,0
2020-02-22,San Bernardino,071,2135413,18,0,0,0,0
2020-02-22,San Diego,073,3302833,5,2,0,2,0
2020-02-22,San Francisco,075,870044,3,0,0,0,0
2020-02-22,San Joaquin,077,732212,4,0,1,1,0
2020-02-22,San Luis Obispo,079,281455,2,0,0,0,0
2020-02-22,San Mateo,081,765935,8,0,0,0,0
2020-02-22,Santa Barbara,083,443738,0,0,0,0,0
2020-02-22,Santa Clara,085,1922200,23,2,1,3,0
2020-02-22,Santa Cruz,087,273765,2,0,0,0,0
2020-02-22,Shasta,089,179085,0,0,0,0,0
2020-02-22,Sierra,091,2930,0,0,0,0,0
2020-02-22,Siskiyou,093,43540,0,0,0,0,0
2020-02-22,Solano,095,438530,11,11,0,11,0
2020-02-22,Sonoma,097,501317,4,0,0,0,0
2020-02-22,Stanislaus,099,539301,2,0,2,2,0
2020-02-22,Sutter,101,95872,0,0,0,0,0
2020-02-22,Tehama,103,63373,0,0,0,0,0
2020-02-22,Trinity,105,12862,0,0,0,0,0
2020-02-22,Tulare,107,460477,2,0,0,0,0
2020-02-22,Tuolumne,109,53932,0,0,0,0,0
2020-02-22,Ventura,111,848112,4,0,0,0,0
2020-02-22,Yolo,113,214977,0,0,0,0,0
2020-02-22,Yuba,115,75493,0,0,0,0,0
2020-02-21,Alameda,001,1643700,9,0,0,0,0
2020-02-21,Alpine,003,1148,0,0,0,0,0
2020-02-21,Amador,005,37829,0,0,0,0,0
2020-02-21,Butte,007,227075,0,0,0,0,0
2020-02-21,Calaveras,009,45235,0,0,0,0,0
2020-02-21,Colusa,011,21464,0,0,0,0,0
2020-02-21,Contra Costa,013,1133247,4,0,0,0,0
2020-02-21,Del Norte,015,27424,0,0,0,0,0
2020-02-21,El Dorado,017,186661,0,0,0,0,0
2020-02-21,Fresno,019,978130,1,0,0,0,0
2020-02-21,Glenn,021,27897,0,0,0,0,0
2020-02-21,Humboldt,023,135768,1,1,0,1,0
2020-02-21,Imperial,025,180216,0,0,0,0,0
2020-02-21,Inyo,027,18085,0,0,0,0,0
2020-02-21,Kern,029,883053,2,0,0,0,0
2020-02-21,Kings,031,150075,3,0,1,1,0
2020-02-21,Lake,033,64148,0,0,0,0,0
2020-02-21,Lassen,035,31185,0,0,0,0,0
2020-02-21,Los Angeles,037,10098052,57,1,6,7,0
2020-02-21,Madera,039,155013,0,0,0,0,0
2020-02-21,Marin,041,260295,1,0,0,0,0
2020-02-21,Mariposa,043,17540,0,0,0,0,0
2020-02-21,Mendocino,045,87422,0,0,0,0,0
2020-02-21,Merced,047,269075,0,0,0,0,0
2020-02-21,Modoc,049,8938,0,0,0,0,0
2020-02-21,Mono,051,14174,0,0,0,0,0
2020-02-21,Monterey,053,433212,1,0,0,0,0
2020-02-21,Napa,055,140530,0,0,0,0,0
2020-02-21,Nevada,057,99092,0,0,1,1,0
2020-02-21,Orange,059,3164182,41,1,0,1,0
2020-02-21,Placer,061,380077,2,0,0,0,0
2020-02-21,Plumas,063,18699,0,0,0,0,0
2020-02-21,Riverside,065,2383286,9,0,0,0,0
2020-02-21,Sacramento,067,1510023,5,1,0,1,0
2020-02-21,San Benito,069,59416,0,2,0,2,0
2020-02-21,San Bernardino,071,2135413,17,0,0,0,0
2020-02-21,San Diego,073,3302833,5,2,0,2,0
2020-02-21,San Francisco,075,870044,3,0,0,0,0
2020-02-21,San Joaquin,077,732212,2,0,1,1,0
2020-02-21,San Luis Obispo,079,281455,2,0,0,0,0
2020-02-21,San Mateo,081,765935,8,0,0,0,0
2020-02-21,Santa Barbara,083,443738,0,0,0,0,0
2020-02-21,Santa Clara,085,1922200,21,2,1,3,0
2020-02-21,Santa Cruz,087,273765,2,0,0,0,0
2020-02-21,Shasta,089,179085,0,0,0,0,0
2020-02-21,Sierra,091,2930,0,0,0,0,0
2020-02-21,Siskiyou,093,43540,0,0,0,0,0
2020-02-21,Solano,095,438530,10,11,0,11,0
2020-02-21,Sonoma,097,501317,3,0,0,0,0
2020-02-21,Stanislaus,099,539301,2,0,2,2,0
2020-02-21,Sutter,101,95872,0,0,0,0,0
2020-02-21,Tehama,103,63373,0,0,0,0,0
2020-02-21,Trinity,105,12862,0,0,0,0,0
2020-02-21,Tulare,107,460477,2,0,0,0,0
2020-02-21,Tuolumne,109,53932,0,0,0,0,0
2020-02-21,Ventura,111,848112,4,0,0,0,0
2020-02-21,Yolo,113,214977,0,0,0,0,0
2020-02-21,Yuba,115,75493,0,0,0,0,0
2020-02-20,Alameda,001,1643700,7,0,0,0,0
2020-02-20,Alpine,003,1148,0,0,0,0,0
2020-02-20,Amador,005,37829,0,0,0,0,0
2020-02-20,Butte,007,227075,0,0,0,0,0
2020-02-20,Calaveras,009,45235,0,0,0,0,0
2020-02-20,Colusa,011,21464,0,0,0,0,0
2020-02-20,Contra Costa,013,1133247,3,0,0,0,0
2020-02-20,Del Norte,015,27424,0,0,0,0,0
2020-02-20,El Dorado,017,186661,0,0,0,0,0
2020-02-20,Fresno,019,978130,1,0,0,0,0
2020-02-20,Glenn,021,27897,0,0,0,0,0
2020-02-20,Humboldt,023,135768,1,1,0,1,0
2020-02-20,Imperial,025,180216,0,0,0,0,0
2020-02-20,Inyo,027,18085,0,0,0,0,0
2020-02-20,Kern,029,883053,2,0,0,0,0
2020-02-20,Kings,031,150075,3,0,1,1,0
2020-02-20,Lake,033,64148,0,0,0,0,0
2020-02-20,Lassen,035,31185,0,0,0,0,0
2020-02-20,Los Angeles,037,10098052,56,1,5,6,0
2020-02-20,Madera,039,155013,0,0,0,0,0
2020-02-20,Marin,041,260295,0,0,0,0,0
2020-02-20,Mariposa,043,17540,0,0,0,0,0
2020-02-20,Mendocino,045,87422,0,0,0,0,0
2020-02-20,Merced,047,269075,0,0,0,0,0
2020-02-20,Modoc,049,8938,0,0,0,0,0
2020-02-20,Mono,051,14174,0,0,0,0,0
2020-02-20,Monterey,053,433212,1,0,0,0,0
2020-02-20,Napa,055,140530,0,0,0,0,0
2020-02-20,Nevada,057,99092,0,0,1,1,0
2020-02-20,Orange,059,3164182,41,1,0,1,0
2020-02-20,Placer,061,380077,2,0,0,0,0
2020-02-20,Plumas,063,18699,0,0,0,0,0
2020-02-20,Riverside,065,2383286,7,0,0,0,0
2020-02-20,Sacramento,067,1510023,2,1,0,1,0
2020-02-20,San Benito,069,59416,0,2,0,2,0
2020-02-20,San Bernardino,071,2135413,15,0,0,0,0
2020-02-20,San Diego,073,3302833,5,2,0,2,0
2020-02-20,San Francisco,075,870044,3,0,0,0,0
2020-02-20,San Joaquin,077,732212,2,0,1,1,0
2020-02-20,San Luis Obispo,079,281455,2,0,0,0,0
2020-02-20,San Mateo,081,765935,7,0,0,0,0
2020-02-20,Santa Barbara,083,443738,0,0,0,0,0
2020-02-20,Santa Clara,085,1922200,17,2,1,3,0
2020-02-20,Santa Cruz,087,273765,2,0,0,0,0
2020-02-20,Shasta,089,179085,0,0,0,0,0
2020-02-20,Sierra,091,2930,0,0,0,0,0
2020-02-20,Siskiyou,093,43540,0,0,0,0,0
2020-02-20,Solano,095,438530,8,7,0,7,0
2020-02-20,Sonoma,097,501317,2,0,0,0,0
2020-02-20,Stanislaus,099,539301,2,0,2,2,0
2020-02-20,Sutter,101,95872,0,0,0,0,0
2020-02-20,Tehama,103,63373,0,0,0,0,0
2020-02-20,Trinity,105,12862,0,0,0,0,0
2020-02-20,Tulare,107,460477,2,0,0,0,0
2020-02-20,Tuolumne,109,53932,0,0,0,0,0
2020-02-20,Ventura,111,848112,4,0,0,0,0
2020-02-20,Yolo,113,214977,0,0,0,0,0
2020-02-20,Yuba,115,75493,0,0,0,0,0
2020-02-19,Alameda,001,1643700,6,0,0,0,0
2020-02-19,Alpine,003,1148,0,0,0,0,0
2020-02-19,Amador,005,37829,0,0,0,0,0
2020-02-19,Butte,007,227075,0,0,0,0,0
2020-02-19,Calaveras,009,45235,0,0,0,0,0
2020-02-19,Colusa,011,21464,0,0,0,0,0
2020-02-19,Contra Costa,013,1133247,3,0,0,0,0
2020-02-19,Del Norte,015,27424,0,0,0,0,0
2020-02-19,El Dorado,017,186661,0,0,0,0,0
2020-02-19,Fresno,019,978130,1,0,0,0,0
2020-02-19,Glenn,021,27897,0,0,0,0,0
2020-02-19,Humboldt,023,135768,1,0,0,0,0
2020-02-19,Imperial,025,180216,0,0,0,0,0
2020-02-19,Inyo,027,18085,0,0,0,0,0
2020-02-19,Kern,029,883053,2,0,0,0,0
2020-02-19,Kings,031,150075,3,0,1,1,0
2020-02-19,Lake,033,64148,0,0,0,0,0
2020-02-19,Lassen,035,31185,0,0,0,0,0
2020-02-19,Los Angeles,037,10098052,53,1,5,6,0
2020-02-19,Madera,039,155013,0,0,0,0,0
2020-02-19,Marin,041,260295,0,0,0,0,0
2020-02-19,Mariposa,043,17540,0,0,0,0,0
2020-02-19,Mendocino,045,87422,0,0,0,0,0
2020-02-19,Merced,047,269075,0,0,0,0,0
2020-02-19,Modoc,049,8938,0,0,0,0,0
2020-02-19,Mono,051,14174,0,0,0,0,0
2020-02-19,Monterey,053,433212,1,0,0,0,0
2020-02-19,Napa,055,140530,0,0,0,0,0
2020-02-19,Nevada,057,99092,0,0,1,1,0
2020-02-19,Orange,059,3164182,40,1,0,1,0
2020-02-19,Placer,061,380077,2,0,0,0,0
2020-02-19,Plumas,063,18699,0,0,0,0,0
2020-02-19,Riverside,065,2383286,5,0,0,0,0
2020-02-19,Sacramento,067,1510023,2,0,0,0,0
2020-02-19,San Benito,069,59416,0,2,0,2,0
2020-02-19,San Bernardino,071,2135413,14,0,0,0,0
2020-02-19,San Diego,073,3302833,4,2,0,2,0
2020-02-19,San Francisco,075,870044,2,0,0,0,0
2020-02-19,San Joaquin,077,732212,2,0,1,1,0
2020-02-19,San Luis Obispo,079,281455,2,0,0,0,0
2020-02-19,San Mateo,081,765935,6,0,0,0,0
2020-02-19,Santa Barbara,083,443738,0,0,0,0,0
2020-02-19,Santa Clara,085,1922200,15,2,1,3,0
2020-02-19,Santa Cruz,087,273765,0,0,0,0,0
2020-02-19,Shasta,089,179085,0,0,0,0,0
2020-02-19,Sierra,091,2930,0,0,0,0,0
2020-02-19,Siskiyou,093,43540,0,0,0,0,0
2020-02-19,Solano,095,438530,5,7,0,7,0
2020-02-19,Sonoma,097,501317,2,0,0,0,0
2020-02-19,Stanislaus,099,539301,1,0,2,2,0
2020-02-19,Sutter,101,95872,0,0,0,0,0
2020-02-19,Tehama,103,63373,0,0,0,0,0
2020-02-19,Trinity,105,12862,0,0,0,0,0
2020-02-19,Tulare,107,460477,2,0,0,0,0
2020-02-19,Tuolumne,109,53932,0,0,0,0,0
2020-02-19,Ventura,111,848112,2,0,0,0,0
2020-02-19,Yolo,113,214977,0,0,0,0,0
2020-02-19,Yuba,115,75493,0,0,0,0,0
2020-02-18,Alameda,001,1643700,6,0,0,0,0
2020-02-18,Alpine,003,1148,0,0,0,0,0
2020-02-18,Amador,005,37829,0,0,0,0,0
2020-02-18,Butte,007,227075,0,0,0,0,0
2020-02-18,Calaveras,009,45235,0,0,0,0,0
2020-02-18,Colusa,011,21464,0,0,0,0,0
2020-02-18,Contra Costa,013,1133247,3,0,0,0,0
2020-02-18,Del Norte,015,27424,0,0,0,0,0
2020-02-18,El Dorado,017,186661,0,0,0,0,0
2020-02-18,Fresno,019,978130,0,0,0,0,0
2020-02-18,Glenn,021,27897,0,0,0,0,0
2020-02-18,Humboldt,023,135768,1,0,0,0,0
2020-02-18,Imperial,025,180216,0,0,0,0,0
2020-02-18,Inyo,027,18085,0,0,0,0,0
2020-02-18,Kern,029,883053,2,0,0,0,0
2020-02-18,Kings,031,150075,3,0,1,1,0
2020-02-18,Lake,033,64148,0,0,0,0,0
2020-02-18,Lassen,035,31185,0,0,0,0,0
2020-02-18,Los Angeles,037,10098052,50,1,4,5,0
2020-02-18,Madera,039,155013,0,0,0,0,0
2020-02-18,Marin,041,260295,0,0,0,0,0
2020-02-18,Mariposa,043,17540,0,0,0,0,0
2020-02-18,Mendocino,045,87422,0,0,0,0,0
2020-02-18,Merced,047,269075,0,0,0,0,0
2020-02-18,Modoc,049,8938,0,0,0,0,0
2020-02-18,Mono,051,14174,0,0,0,0,0
2020-02-18,Monterey,053,433212,1,0,0,0,0
2020-02-18,Napa,055,140530,0,0,0,0,0
2020-02-18,Nevada,057,99092,0,0,1,1,0
2020-02-18,Orange,059,3164182,39,1,0,1,0
2020-02-18,Placer,061,380077,0,0,0,0,0
2020-02-18,Plumas,063,18699,0,0,0,0,0
2020-02-18,Riverside,065,2383286,5,0,0,0,0
2020-02-18,Sacramento,067,1510023,2,0,0,0,0
2020-02-18,San Benito,069,59416,0,2,0,2,0
2020-02-18,San Bernardino,071,2135413,13,0,0,0,0
2020-02-18,San Diego,073,3302833,4,2,0,2,0
2020-02-18,San Francisco,075,870044,2,0,0,0,0
2020-02-18,San Joaquin,077,732212,1,0,1,1,0
2020-02-18,San Luis Obispo,079,281455,2,0,0,0,0
2020-02-18,San Mateo,081,765935,5,0,0,0,0
2020-02-18,Santa Barbara,083,443738,0,0,0,0,0
2020-02-18,Santa Clara,085,1922200,14,2,1,3,0
2020-02-18,Santa Cruz,087,273765,0,0,0,0,0
2020-02-18,Shasta,089,179085,0,0,0,0,0
2020-02-18,Sierra,091,2930,0,0,0,0,0
2020-02-18,Siskiyou,093,43540,0,0,0,0,0
2020-02-18,Solano,095,438530,5,7,0,7,0
2020-02-18,Sonoma,097,501317,1,0,0,0,0
2020-02-18,Stanislaus,099,539301,1,0,2,2,0
2020-02-18,Sutter,101,95872,0,0,0,0,0
2020-02-18,Tehama,103,63373,0,0,0,0,0
2020-02-18,Trinity,105,12862,0,0,0,0,0
2020-02-18,Tulare,107,460477,2,0,0,0,0
2020-02-18,Tuolumne,109,53932,0,0,0,0,0
2020-02-18,Ventura,111,848112,2,0,0,0,0
2020-02-18,Yolo,113,214977,0,0,0,0,0
2020-02-18,Yuba,115,75493,0,0,0,0,0
2020-02-17,Alameda,001,1643700,6,0,0,0,0
2020-02-17,Alpine,003,1148,0,0,0,0,0
2020-02-17,Amador,005,37829,0,0,0,0,0
2020-02-17,Butte,007,227075,0,0,0,0,0
2020-02-17,Calaveras,009,45235,0,0,0,0,0
2020-02-17,Colusa,011,21464,0,0,0,0,0
2020-02-17,Contra Costa,013,1133247,3,0,0,0,0
2020-02-17,Del Norte,015,27424,0,0,0,0,0
2020-02-17,El Dorado,017,186661,0,0,0,0,0
2020-02-17,Fresno,019,978130,0,0,0,0,0
2020-02-17,Glenn,021,27897,0,0,0,0,0
2020-02-17,Humboldt,023,135768,1,0,0,0,0
2020-02-17,Imperial,025,180216,0,0,0,0,0
2020-02-17,Inyo,027,18085,0,0,0,0,0
2020-02-17,Kern,029,883053,2,0,0,0,0
2020-02-17,Kings,031,150075,3,0,0,0,0
2020-02-17,Lake,033,64148,0,0,0,0,0
2020-02-17,Lassen,035,31185,0,0,0,0,0
2020-02-17,Los Angeles,037,10098052,47,1,4,5,0
2020-02-17,Madera,039,155013,0,0,0,0,0
2020-02-17,Marin,041,260295,0,0,0,0,0
2020-02-17,Mariposa,043,17540,0,0,0,0,0
2020-02-17,Mendocino,045,87422,0,0,0,0,0
2020-02-17,Merced,047,269075,0,0,0,0,0
2020-02-17,Modoc,049,8938,0,0,0,0,0
2020-02-17,Mono,051,14174,0,0,0,0,0
2020-02-17,Monterey,053,433212,1,0,0,0,0
2020-02-17,Napa,055,140530,0,0,0,0,0
2020-02-17,Nevada,057,99092,0,0,1,1,0
2020-02-17,Orange,059,3164182,39,1,0,1,0
2020-02-17,Placer,061,380077,0,0,0,0,0
2020-02-17,Plumas,063,18699,0,0,0,0,0
2020-02-17,Riverside,065,2383286,5,0,0,0,0
2020-02-17,Sacramento,067,1510023,2,0,0,0,0
2020-02-17,San Benito,069,59416,0,2,0,2,0
2020-02-17,San Bernardino,071,2135413,11,0,0,0,0
2020-02-17,San Diego,073,3302833,4,2,0,2,0
2020-02-17,San Francisco,075,870044,2,0,0,0,0
2020-02-17,San Joaquin,077,732212,1,0,1,1,0
2020-02-17,San Luis Obispo,079,281455,1,0,0,0,0
2020-02-17,San Mateo,081,765935,5,0,0,0,0
2020-02-17,Santa Barbara,083,443738,0,0,0,0,0
2020-02-17,Santa Clara,085,1922200,12,2,1,3,0
2020-02-17,Santa Cruz,087,273765,0,0,0,0,0
2020-02-17,Shasta,089,179085,0,0,0,0,0
2020-02-17,Sierra,091,2930,0,0,0,0,0
2020-02-17,Siskiyou,093,43540,0,0,0,0,0
2020-02-17,Solano,095,438530,3,5,0,5,0
2020-02-17,Sonoma,097,501317,1,0,0,0,0
2020-02-17,Stanislaus,099,539301,1,0,2,2,0
2020-02-17,Sutter,101,95872,0,0,0,0,0
2020-02-17,Tehama,103,63373,0,0,0,0,0
2020-02-17,Trinity,105,12862,0,0,0,0,0
2020-02-17,Tulare,107,460477,2,0,0,0,0
2020-02-17,Tuolumne,109,53932,0,0,0,0,0
2020-02-17,Ventura,111,848112,2,0,0,0,0
2020-02-17,Yolo,113,214977,0,0,0,0,0
2020-02-17,Yuba,115,75493,0,0,0,0,0
2020-02-16,Alameda,001,1643700,5,0,0,0,0
2020-02-16,Alpine,003,1148,0,0,0,0,0
2020-02-16,Amador,005,37829,0,0,0,0,0
2020-02-16,Butte,007,227075,0,0,0,0,0
2020-02-16,Calaveras,009,45235,0,0,0,0,0
2020-02-16,Colusa,011,21464,0,0,0,0,0
2020-02-16,Contra Costa,013,1133247,3,0,0,0,0
2020-02-16,Del Norte,015,27424,0,0,0,0,0
2020-02-16,El Dorado,017,186661,0,0,0,0,0
2020-02-16,Fresno,019,978130,0,0,0,0,0
2020-02-16,Glenn,021,27897,0,0,0,0,0
2020-02-16,Humboldt,023,135768,1,0,0,0,0
2020-02-16,Imperial,025,180216,0,0,0,0,0
2020-02-16,Inyo,027,18085,0,0,0,0,0
2020-02-16,Kern,029,883053,2,0,0,0,0
2020-02-16,Kings,031,150075,3,0,0,0,0
2020-02-16,Lake,033,64148,0,0,0,0,0
2020-02-16,Lassen,035,31185,0,0,0,0,0
2020-02-16,Los Angeles,037,10098052,41,1,4,5,0
2020-02-16,Madera,039,155013,0,0,0,0,0
2020-02-16,Marin,041,260295,0,0,0,0,0
2020-02-16,Mariposa,043,17540,0,0,0,0,0
2020-02-16,Mendocino,045,87422,0,0,0,0,0
2020-02-16,Merced,047,269075,0,0,0,0,0
2020-02-16,Modoc,049,8938,0,0,0,0,0
2020-02-16,Mono,051,14174,0,0,0,0,0
2020-02-16,Monterey,053,433212,1,0,0,0,0
2020-02-16,Napa,055,140530,0,0,0,0,0
2020-02-16,Nevada,057,99092,0,0,0,0,0
2020-02-16,Orange,059,3164182,38,1,0,1,0
2020-02-16,Placer,061,380077,0,0,0,0,0
2020-02-16,Plumas,063,18699,0,0,0,0,0
2020-02-16,Riverside,065,2383286,5,0,0,0,0
2020-02-16,Sacramento,067,1510023,2,0,0,0,0
2020-02-16,San Benito,069,59416,0,2,0,2,0
2020-02-16,San Bernardino,071,2135413,10,0,0,0,0
2020-02-16,San Diego,073,3302833,4,2,0,2,0
2020-02-16,San Francisco,075,870044,2,0,0,0,0
2020-02-16,San Joaquin,077,732212,1,0,1,1,0
2020-02-16,San Luis Obispo,079,281455,1,0,0,0,0
2020-02-16,San Mateo,081,765935,4,0,0,0,0
2020-02-16,Santa Barbara,083,443738,0,0,0,0,0
2020-02-16,Santa Clara,085,1922200,10,2,1,3,0
2020-02-16,Santa Cruz,087,273765,0,0,0,0,0
2020-02-16,Shasta,089,179085,0,0,0,0,0
2020-02-16,Sierra,091,2930,0,0,0,0,0
2020-02-16,Siskiyou,093,43540,0,0,0,0,0
2020-02-16,Solano,095,438530,1,0,0,0,0
2020-02-16,Sonoma,097,501317,1,0,0,0,0
2020-02-16,Stanislaus,099,539301,1,0,2,2,0
2020-02-16,Sutter,101,95872,0,0,0,0,0
2020-02-16,Tehama,103,63373,0,0,0,0,0
2020-02-16,Trinity,105,12862,0,0,0,0,0
2020-02-16,Tulare,107,460477,2,0,0,0,0
2020-02-16,Tuolumne,109,53932,0,0,0,0,0
2020-02-16,Ventura,111,848112,2,0,0,0,0
2020-02-16,Yolo,113,214977,0,0,0,0,0
2020-02-16,Yuba,115,75493,0,0,0,0,0
2020-02-15,Alameda,001,1643700,5,0,0,0,0
2020-02-15,Alpine,003,1148,0,0,0,0,0
2020-02-15,Amador,005,37829,0,0,0,0,0
2020-02-15,Butte,007,227075,0,0,0,0,0
2020-02-15,Calaveras,009,45235,0,0,0,0,0
2020-02-15,Colusa,011,21464,0,0,0,0,0
2020-02-15,Contra Costa,013,1133247,3,0,0,0,0
2020-02-15,Del Norte,015,27424,0,0,0,0,0
2020-02-15,El Dorado,017,186661,0,0,0,0,0
2020-02-15,Fresno,019,978130,0,0,0,0,0
2020-02-15,Glenn,021,27897,0,0,0,0,0
2020-02-15,Humboldt,023,135768,1,0,0,0,0
2020-02-15,Imperial,025,180216,0,0,0,0,0
2020-02-15,Inyo,027,18085,0,0,0,0,0
2020-02-15,Kern,029,883053,2,0,0,0,0
2020-02-15,Kings,031,150075,3,0,0,0,0
2020-02-15,Lake,033,64148,0,0,0,0,0
2020-02-15,Lassen,035,31185,0,0,0,0,0
2020-02-15,Los Angeles,037,10098052,38,1,4,5,0
2020-02-15,Madera,039,155013,0,0,0,0,0
2020-02-15,Marin,041,260295,0,0,0,0,0
2020-02-15,Mariposa,043,17540,0,0,0,0,0
2020-02-15,Mendocino,045,87422,0,0,0,0,0
2020-02-15,Merced,047,269075,0,0,0,0,0
2020-02-15,Modoc,049,8938,0,0,0,0,0
2020-02-15,Mono,051,14174,0,0,0,0,0
2020-02-15,Monterey,053,433212,1,0,0,0,0
2020-02-15,Napa,055,140530,0,0,0,0,0
2020-02-15,Nevada,057,99092,0,0,0,0,0
2020-02-15,Orange,059,3164182,37,1,0,1,0
2020-02-15,Placer,061,380077,0,0,0,0,0
2020-02-15,Plumas,063,18699,0,0,0,0,0
2020-02-15,Riverside,065,2383286,4,0,0,0,0
2020-02-15,Sacramento,067,1510023,2,0,0,0,0
2020-02-15,San Benito,069,59416,0,2,0,2,0
2020-02-15,San Bernardino,071,2135413,9,0,0,0,0
2020-02-15,San Diego,073,3302833,4,2,0,2,0
2020-02-15,San Francisco,075,870044,2,0,0,0,0
2020-02-15,San Joaquin,077,732212,1,0,1,1,0
2020-02-15,San Luis Obispo,079,281455,1,0,0,0,0
2020-02-15,San Mateo,081,765935,4,0,0,0,0
2020-02-15,Santa Barbara,083,443738,0,0,0,0,0
2020-02-15,Santa Clara,085,1922200,10,2,1,3,0
2020-02-15,Santa Cruz,087,273765,0,0,0,0,0
2020-02-15,Shasta,089,179085,0,0,0,0,0
2020-02-15,Sierra,091,2930,0,0,0,0,0
2020-02-15,Siskiyou,093,43540,0,0,0,0,0
2020-02-15,Solano,095,438530,1,0,0,0,0
2020-02-15,Sonoma,097,501317,0,0,0,0,0
2020-02-15,Stanislaus,099,539301,1,0,2,2,0
2020-02-15,Sutter,101,95872,0,0,0,0,0
2020-02-15,Tehama,103,63373,0,0,0,0,0
2020-02-15,Trinity,105,12862,0,0,0,0,0
2020-02-15,Tulare,107,460477,2,0,0,0,0
2020-02-15,Tuolumne,109,53932,0,0,0,0,0
2020-02-15,Ventura,111,848112,2,0,0,0,0
2020-02-15,Yolo,113,214977,0,0,0,0,0
2020-02-15,Yuba,115,75493,0,0,0,0,0
2020-02-14,Alameda,001,1643700,4,0,0,0,0
2020-02-14,Alpine,003,1148,0,0,0,0,0
2020-02-14,Amador,005,37829,0,0,0,0,0
2020-02-14,Butte,007,227075,0,0,0,0,0
2020-02-14,Calaveras,009,45235,0,0,0,0,0
2020-02-14,Colusa,011,21464,0,0,0,0,0
2020-02-14,Contra Costa,013,1133247,3,0,0,0,0
2020-02-14,Del Norte,015,27424,0,0,0,0,0
2020-02-14,El Dorado,017,186661,0,0,0,0,0
2020-02-14,Fresno,019,978130,0,0,0,0,0
2020-02-14,Glenn,021,27897,0,0,0,0,0
2020-02-14,Humboldt,023,135768,1,0,0,0,0
2020-02-14,Imperial,025,180216,0,0,0,0,0
2020-02-14,Inyo,027,18085,0,0,0,0,0
2020-02-14,Kern,029,883053,2,0,0,0,0
2020-02-14,Kings,031,150075,1,0,0,0,0
2020-02-14,Lake,033,64148,0,0,0,0,0
2020-02-14,Lassen,035,31185,0,0,0,0,0
2020-02-14,Los Angeles,037,10098052,33,1,4,5,0
2020-02-14,Madera,039,155013,0,0,0,0,0
2020-02-14,Marin,041,260295,0,0,0,0,0
2020-02-14,Mariposa,043,17540,0,0,0,0,0
2020-02-14,Mendocino,045,87422,0,0,0,0,0
2020-02-14,Merced,047,269075,0,0,0,0,0
2020-02-14,Modoc,049,8938,0,0,0,0,0
2020-02-14,Mono,051,14174,0,0,0,0,0
2020-02-14,Monterey,053,433212,1,0,0,0,0
2020-02-14,Napa,055,140530,0,0,0,0,0
2020-02-14,Nevada,057,99092,0,0,0,0,0
2020-02-14,Orange,059,3164182,37,1,0,1,0
2020-02-14,Placer,061,380077,0,0,0,0,0
2020-02-14,Plumas,063,18699,0,0,0,0,0
2020-02-14,Riverside,065,2383286,4,0,0,0,0
2020-02-14,Sacramento,067,1510023,1,0,0,0,0
2020-02-14,San Benito,069,59416,0,2,0,2,0
2020-02-14,San Bernardino,071,2135413,9,0,0,0,0
2020-02-14,San Diego,073,3302833,3,2,0,2,0
2020-02-14,San Francisco,075,870044,2,0,0,0,0
2020-02-14,San Joaquin,077,732212,1,0,1,1,0
2020-02-14,San Luis Obispo,079,281455,0,0,0,0,0
2020-02-14,San Mateo,081,765935,3,0,0,0,0
2020-02-14,Santa Barbara,083,443738,0,0,0,0,0
2020-02-14,Santa Clara,085,1922200,8,2,1,3,0
2020-02-14,Santa Cruz,087,273765,0,0,0,0,0
2020-02-14,Shasta,089,179085,0,0,0,0,0
2020-02-14,Sierra,091,2930,0,0,0,0,0
2020-02-14,Siskiyou,093,43540,0,0,0,0,0
2020-02-14,Solano,095,438530,1,0,0,0,0
2020-02-14,Sonoma,097,501317,0,0,0,0,0
2020-02-14,Stanislaus,099,539301,1,0,2,2,0
2020-02-14,Sutter,101,95872,0,0,0,0,0
2020-02-14,Tehama,103,63373,0,0,0,0,0
2020-02-14,Trinity,105,12862,0,0,0,0,0
2020-02-14,Tulare,107,460477,2,0,0,0,0
2020-02-14,Tuolumne,109,53932,0,0,0,0,0
2020-02-14,Ventura,111,848112,2,0,0,0,0
2020-02-14,Yolo,113,214977,0,0,0,0,0
2020-02-14,Yuba,115,75493,0,0,0,0,0
2020-02-13,Alameda,001,1643700,4,0,0,0,0
2020-02-13,Alpine,003,1148,0,0,0,0,0
2020-02-13,Amador,005,37829,0,0,0,0,0
2020-02-13,Butte,007,227075,0,0,0,0,0
2020-02-13,Calaveras,009,45235,0,0,0,0,0
2020-02-13,Colusa,011,21464,0,0,0,0,0
2020-02-13,Contra Costa,013,1133247,3,0,0,0,0
2020-02-13,Del Norte,015,27424,0,0,0,0,0
2020-02-13,El Dorado,017,186661,0,0,0,0,0
2020-02-13,Fresno,019,978130,0,0,0,0,0
2020-02-13,Glenn,021,27897,0,0,0,0,0
2020-02-13,Humboldt,023,135768,1,0,0,0,0
2020-02-13,Imperial,025,180216,0,0,0,0,0
2020-02-13,Inyo,027,18085,0,0,0,0,0
2020-02-13,Kern,029,883053,2,0,0,0,0
2020-02-13,Kings,031,150075,1,0,0,0,0
2020-02-13,Lake,033,64148,0,0,0,0,0
2020-02-13,Lassen,035,31185,0,0,0,0,0
2020-02-13,Los Angeles,037,10098052,30,1,3,4,0
2020-02-13,Madera,039,155013,0,0,0,0,0
2020-02-13,Marin,041,260295,0,0,0,0,0
2020-02-13,Mariposa,043,17540,0,0,0,0,0
2020-02-13,Mendocino,045,87422,0,0,0,0,0
2020-02-13,Merced,047,269075,0,0,0,0,0
2020-02-13,Modoc,049,8938,0,0,0,0,0
2020-02-13,Mono,051,14174,0,0,0,0,0
2020-02-13,Monterey,053,433212,1,0,0,0,0
2020-02-13,Napa,055,140530,0,0,0,0,0
2020-02-13,Nevada,057,99092,0,0,0,0,0
2020-02-13,Orange,059,3164182,36,1,0,1,0
2020-02-13,Placer,061,380077,0,0,0,0,0
2020-02-13,Plumas,063,18699,0,0,0,0,0
2020-02-13,Riverside,065,2383286,4,0,0,0,0
2020-02-13,Sacramento,067,1510023,1,0,0,0,0
2020-02-13,San Benito,069,59416,0,2,0,2,0
2020-02-13,San Bernardino,071,2135413,8,0,0,0,0
2020-02-13,San Diego,073,3302833,2,2,0,2,0
2020-02-13,San Francisco,075,870044,2,0,0,0,0
2020-02-13,San Joaquin,077,732212,1,0,1,1,0
2020-02-13,San Luis Obispo,079,281455,0,0,0,0,0
2020-02-13,San Mateo,081,765935,2,0,0,0,0
2020-02-13,Santa Barbara,083,443738,0,0,0,0,0
2020-02-13,Santa Clara,085,1922200,7,2,0,2,0
2020-02-13,Santa Cruz,087,273765,0,0,0,0,0
2020-02-13,Shasta,089,179085,0,0,0,0,0
2020-02-13,Sierra,091,2930,0,0,0,0,0
2020-02-13,Siskiyou,093,43540,0,0,0,0,0
2020-02-13,Solano,095,438530,0,0,0,0,0
2020-02-13,Sonoma,097,501317,0,0,0,0,0
2020-02-13,Stanislaus,099,539301,1,0,1,1,0
2020-02-13,Sutter,101,95872,0,0,0,0,0
2020-02-13,Tehama,103,63373,0,0,0,0,0
2020-02-13,Trinity,105,12862,0,0,0,0,0
2020-02-13,Tulare,107,460477,2,0,0,0,0
2020-02-13,Tuolumne,109,53932,0,0,0,0,0
2020-02-13,Ventura,111,848112,2,0,0,0,0
2020-02-13,Yolo,113,214977,0,0,0,0,0
2020-02-13,Yuba,115,75493,0,0,0,0,0
2020-02-12,Alameda,001,1643700,4,0,0,0,0
2020-02-12,Alpine,003,1148,0,0,0,0,0
2020-02-12,Amador,005,37829,0,0,0,0,0
2020-02-12,Butte,007,227075,0,0,0,0,0
2020-02-12,Calaveras,009,45235,0,0,0,0,0
2020-02-12,Colusa,011,21464,0,0,0,0,0
2020-02-12,Contra Costa,013,1133247,3,0,0,0,0
2020-02-12,Del Norte,015,27424,0,0,0,0,0
2020-02-12,El Dorado,017,186661,0,0,0,0,0
2020-02-12,Fresno,019,978130,0,0,0,0,0
2020-02-12,Glenn,021,27897,0,0,0,0,0
2020-02-12,Humboldt,023,135768,1,0,0,0,0
2020-02-12,Imperial,025,180216,0,0,0,0,0
2020-02-12,Inyo,027,18085,0,0,0,0,0
2020-02-12,Kern,029,883053,2,0,0,0,0
2020-02-12,Kings,031,150075,1,0,0,0,0
2020-02-12,Lake,033,64148,0,0,0,0,0
2020-02-12,Lassen,035,31185,0,0,0,0,0
2020-02-12,Los Angeles,037,10098052,29,1,3,4,0
2020-02-12,Madera,039,155013,0,0,0,0,0
2020-02-12,Marin,041,260295,0,0,0,0,0
2020-02-12,Mariposa,043,17540,0,0,0,0,0
2020-02-12,Mendocino,045,87422,0,0,0,0,0
2020-02-12,Merced,047,269075,0,0,0,0,0
2020-02-12,Modoc,049,8938,0,0,0,0,0
2020-02-12,Mono,051,14174,0,0,0,0,0
2020-02-12,Monterey,053,433212,1,0,0,0,0
2020-02-12,Napa,055,140530,0,0,0,0,0
2020-02-12,Nevada,057,99092,0,0,0,0,0
2020-02-12,Orange,059,3164182,36,1,0,1,0
2020-02-12,Placer,061,380077,0,0,0,0,0
2020-02-12,Plumas,063,18699,0,0,0,0,0
2020-02-12,Riverside,065,2383286,4,0,0,0,0
2020-02-12,Sacramento,067,1510023,1,0,0,0,0
2020-02-12,San Benito,069,59416,0,2,0,2,0
2020-02-12,San Bernardino,071,2135413,8,0,0,0,0
2020-02-12,San Diego,073,3302833,2,2,0,2,0
2020-02-12,San Francisco,075,870044,2,0,0,0,0
2020-02-12,San Joaquin,077,732212,1,0,1,1,0
2020-02-12,San Luis Obispo,079,281455,0,0,0,0,0
2020-02-12,San Mateo,081,765935,2,0,0,0,0
2020-02-12,Santa Barbara,083,443738,0,0,0,0,0
2020-02-12,Santa Clara,085,1922200,6,2,0,2,0
2020-02-12,Santa Cruz,087,273765,0,0,0,0,0
2020-02-12,Shasta,089,179085,0,0,0,0,0
2020-02-12,Sierra,091,2930,0,0,0,0,0
2020-02-12,Siskiyou,093,43540,0,0,0,0,0
2020-02-12,Solano,095,438530,0,0,0,0,0
2020-02-12,Sonoma,097,501317,0,0,0,0,0
2020-02-12,Stanislaus,099,539301,1,0,1,1,0
2020-02-12,Sutter,101,95872,0,0,0,0,0
2020-02-12,Tehama,103,63373,0,0,0,0,0
2020-02-12,Trinity,105,12862,0,0,0,0,0
2020-02-12,Tulare,107,460477,2,0,0,0,0
2020-02-12,Tuolumne,109,53932,0,0,0,0,0
2020-02-12,Ventura,111,848112,2,0,0,0,0
2020-02-12,Yolo,113,214977,0,0,0,0,0
2020-02-12,Yuba,115,75493,0,0,0,0,0
2020-02-11,Alameda,001,1643700,4,0,0,0,0
2020-02-11,Alpine,003,1148,0,0,0,0,0
2020-02-11,Amador,005,37829,0,0,0,0,0
2020-02-11,Butte,007,227075,0,0,0,0,0
2020-02-11,Calaveras,009,45235,0,0,0,0,0
2020-02-11,Colusa,011,21464,0,0,0,0,0
2020-02-11,Contra Costa,013,1133247,3,0,0,0,0
2020-02-11,Del Norte,015,27424,0,0,0,0,0
2020-02-11,El Dorado,017,186661,0,0,0,0,0
2020-02-11,Fresno,019,978130,0,0,0,0,0
2020-02-11,Glenn,021,27897,0,0,0,0,0
2020-02-11,Humboldt,023,135768,1,0,0,0,0
2020-02-11,Imperial,025,180216,0,0,0,0,0
2020-02-11,Inyo,027,18085,0,0,0,0,0
2020-02-11,Kern,029,883053,2,0,0,0,0
2020-02-11,Kings,031,150075,1,0,0,0,0
2020-02-11,Lake,033,64148,0,0,0,0,0
2020-02-11,Lassen,035,31185,0,0,0,0,0
2020-02-11,Los Angeles,037,10098052,29,1,3,4,0
2020-02-11,Madera,039,155013,0,0,0,0,0
2020-02-11,Marin,041,260295,0,0,0,0,0
2020-02-11,Mariposa,043,17540,0,0,0,0,0
2020-02-11,Mendocino,045,87422,0,0,0,0,0
2020-02-11,Merced,047,269075,0,0,0,0,0
2020-02-11,Modoc,049,8938,0,0,0,0,0
2020-02-11,Mono,051,14174,0,0,0,0,0
2020-02-11,Monterey,053,433212,1,0,0,0,0
2020-02-11,Napa,055,140530,0,0,0,0,0
2020-02-11,Nevada,057,99092,0,0,0,0,0
2020-02-11,Orange,059,3164182,35,1,0,1,0
2020-02-11,Placer,061,380077,0,0,0,0,0
2020-02-11,Plumas,063,18699,0,0,0,0,0
2020-02-11,Riverside,065,2383286,4,0,0,0,0
2020-02-11,Sacramento,067,1510023,1,0,0,0,0
2020-02-11,San Benito,069,59416,0,2,0,2,0
2020-02-11,San Bernardino,071,2135413,8,0,0,0,0
2020-02-11,San Diego,073,3302833,2,1,0,1,0
2020-02-11,San Francisco,075,870044,2,0,0,0,0
2020-02-11,San Joaquin,077,732212,0,0,1,1,0
2020-02-11,San Luis Obispo,079,281455,0,0,0,0,0
2020-02-11,San Mateo,081,765935,2,0,0,0,0
2020-02-11,Santa Barbara,083,443738,0,0,0,0,0
2020-02-11,Santa Clara,085,1922200,5,2,0,2,0
2020-02-11,Santa Cruz,087,273765,0,0,0,0,0
2020-02-11,Shasta,089,179085,0,0,0,0,0
2020-02-11,Sierra,091,2930,0,0,0,0,0
2020-02-11,Siskiyou,093,43540,0,0,0,0,0
2020-02-11,Solano,095,438530,0,0,0,0,0
2020-02-11,Sonoma,097,501317,0,0,0,0,0
2020-02-11,Stanislaus,099,539301,1,0,1,1,0
2020-02-11,Sutter,101,95872,0,0,0,0,0
2020-02-11,Tehama,103,63373,0,0,0,0,0
2020-02-11,Trinity,105,12862,0,0,0,0,0
2020-02-11,Tulare,107,460477,2,0,0,0,0
2020-02-11,Tuolumne,109,53932,0,0,0,0,0
2020-02-11,Ventura,111,848112,2,0,0,0,0
2020-02-11,Yolo,113,214977,0,0,0,0,0
2020-02-11,Yuba,115,75493,0,0,0,0,0
2020-02-10,Alameda,001,1643700,4,0,0,0,0
2020-02-10,Alpine,003,1148,0,0,0,0,0
2020-02-10,Amador,005,37829,0,0,0,0,0
2020-02-10,Butte,007,227075,0,0,0,0,0
2020-02-10,Calaveras,009,45235,0,0,0,0,0
2020-02-10,Colusa,011,21464,0,0,0,0,0
2020-02-10,Contra Costa,013,1133247,3,0,0,0,0
2020-02-10,Del Norte,015,27424,0,0,0,0,0
2020-02-10,El Dorado,017,186661,0,0,0,0,0
2020-02-10,Fresno,019,978130,0,0,0,0,0
2020-02-10,Glenn,021,27897,0,0,0,0,0
2020-02-10,Humboldt,023,135768,0,0,0,0,0
2020-02-10,Imperial,025,180216,0,0,0,0,0
2020-02-10,Inyo,027,18085,0,0,0,0,0
2020-02-10,Kern,029,883053,2,0,0,0,0
2020-02-10,Kings,031,150075,1,0,0,0,0
2020-02-10,Lake,033,64148,0,0,0,0,0
2020-02-10,Lassen,035,31185,0,0,0,0,0
2020-02-10,Los Angeles,037,10098052,27,1,3,4,0
2020-02-10,Madera,039,155013,0,0,0,0,0
2020-02-10,Marin,041,260295,0,0,0,0,0
2020-02-10,Mariposa,043,17540,0,0,0,0,0
2020-02-10,Mendocino,045,87422,0,0,0,0,0
2020-02-10,Merced,047,269075,0,0,0,0,0
2020-02-10,Modoc,049,8938,0,0,0,0,0
2020-02-10,Mono,051,14174,0,0,0,0,0
2020-02-10,Monterey,053,433212,1,0,0,0,0
2020-02-10,Napa,055,140530,0,0,0,0,0
2020-02-10,Nevada,057,99092,0,0,0,0,0
2020-02-10,Orange,059,3164182,35,1,0,1,0
2020-02-10,Placer,061,380077,0,0,0,0,0
2020-02-10,Plumas,063,18699,0,0,0,0,0
2020-02-10,Riverside,065,2383286,4,0,0,0,0
2020-02-10,Sacramento,067,1510023,1,0,0,0,0
2020-02-10,San Benito,069,59416,0,2,0,2,0
2020-02-10,San Bernardino,071,2135413,7,0,0,0,0
2020-02-10,San Diego,073,3302833,2,0,0,0,0
2020-02-10,San Francisco,075,870044,2,0,0,0,0
2020-02-10,San Joaquin,077,732212,0,0,1,1,0
2020-02-10,San Luis Obispo,079,281455,0,0,0,0,0
2020-02-10,San Mateo,081,765935,2,0,0,0,0
2020-02-10,Santa Barbara,083,443738,0,0,0,0,0
2020-02-10,Santa Clara,085,1922200,5,2,0,2,0
2020-02-10,Santa Cruz,087,273765,0,0,0,0,0
2020-02-10,Shasta,089,179085,0,0,0,0,0
2020-02-10,Sierra,091,2930,0,0,0,0,0
2020-02-10,Siskiyou,093,43540,0,0,0,0,0
2020-02-10,Solano,095,438530,0,0,0,0,0
2020-02-10,Sonoma,097,501317,0,0,0,0,0
2020-02-10,Stanislaus,099,539301,1,0,0,0,0
2020-02-10,Sutter,101,95872,0,0,0,0,0
2020-02-10,Tehama,103,63373,0,0,0,0,0
2020-02-10,Trinity,105,12862,0,0,0,0,0
2020-02-10,Tulare,107,460477,2,0,0,0,0
2020-02-10,Tuolumne,109,53932,0,0,0,0,0
2020-02-10,Ventura,111,848112,2,0,0,0,0
2020-02-10,Yolo,113,214977,0,0,0,0,0
2020-02-10,Yuba,115,75493,0,0,0,0,0
2020-02-09,Alameda,001,1643700,4,0,0,0,0
2020-02-09,Alpine,003,1148,0,0,0,0,0
2020-02-09,Amador,005,37829,0,0,0,0,0
2020-02-09,Butte,007,227075,0,0,0,0,0
2020-02-09,Calaveras,009,45235,0,0,0,0,0
2020-02-09,Colusa,011,21464,0,0,0,0,0
2020-02-09,Contra Costa,013,1133247,3,0,0,0,0
2020-02-09,Del Norte,015,27424,0,0,0,0,0
2020-02-09,El Dorado,017,186661,0,0,0,0,0
2020-02-09,Fresno,019,978130,0,0,0,0,0
2020-02-09,Glenn,021,27897,0,0,0,0,0
2020-02-09,Humboldt,023,135768,0,0,0,0,0
2020-02-09,Imperial,025,180216,0,0,0,0,0
2020-02-09,Inyo,027,18085,0,0,0,0,0
2020-02-09,Kern,029,883053,2,0,0,0,0
2020-02-09,Kings,031,150075,1,0,0,0,0
2020-02-09,Lake,033,64148,0,0,0,0,0
2020-02-09,Lassen,035,31185,0,0,0,0,0
2020-02-09,Los Angeles,037,10098052,26,1,3,4,0
2020-02-09,Madera,039,155013,0,0,0,0,0
2020-02-09,Marin,041,260295,0,0,0,0,0
2020-02-09,Mariposa,043,17540,0,0,0,0,0
2020-02-09,Mendocino,045,87422,0,0,0,0,0
2020-02-09,Merced,047,269075,0,0,0,0,0
2020-02-09,Modoc,049,8938,0,0,0,0,0
2020-02-09,Mono,051,14174,0,0,0,0,0
2020-02-09,Monterey,053,433212,1,0,0,0,0
2020-02-09,Napa,055,140530,0,0,0,0,0
2020-02-09,Nevada,057,99092,0,0,0,0,0
2020-02-09,Orange,059,3164182,35,1,0,1,0
2020-02-09,Placer,061,380077,0,0,0,0,0
2020-02-09,Plumas,063,18699,0,0,0,0,0
2020-02-09,Riverside,065,2383286,4,0,0,0,0
2020-02-09,Sacramento,067,1510023,0,0,0,0,0
2020-02-09,San Benito,069,59416,0,2,0,2,0
2020-02-09,San Bernardino,071,2135413,7,0,0,0,0
2020-02-09,San Diego,073,3302833,2,0,0,0,0
2020-02-09,San Francisco,075,870044,1,0,0,0,0
2020-02-09,San Joaquin,077,732212,0,0,1,1,0
2020-02-09,San Luis Obispo,079,281455,0,0,0,0,0
2020-02-09,San Mateo,081,765935,2,0,0,0,0
2020-02-09,Santa Barbara,083,443738,0,0,0,0,0
2020-02-09,Santa Clara,085,1922200,4,2,0,2,0
2020-02-09,Santa Cruz,087,273765,0,0,0,0,0
2020-02-09,Shasta,089,179085,0,0,0,0,0
2020-02-09,Sierra,091,2930,0,0,0,0,0
2020-02-09,Siskiyou,093,43540,0,0,0,0,0
2020-02-09,Solano,095,438530,0,0,0,0,0
2020-02-09,Sonoma,097,501317,0,0,0,0,0
2020-02-09,Stanislaus,099,539301,0,0,0,0,0
2020-02-09,Sutter,101,95872,0,0,0,0,0
2020-02-09,Tehama,103,63373,0,0,0,0,0
2020-02-09,Trinity,105,12862,0,0,0,0,0
2020-02-09,Tulare,107,460477,2,0,0,0,0
2020-02-09,Tuolumne,109,53932,0,0,0,0,0
2020-02-09,Ventura,111,848112,1,0,0,0,0
2020-02-09,Yolo,113,214977,0,0,0,0,0
2020-02-09,Yuba,115,75493,0,0,0,0,0
2020-02-08,Alameda,001,1643700,3,0,0,0,0
2020-02-08,Alpine,003,1148,0,0,0,0,0
2020-02-08,Amador,005,37829,0,0,0,0,0
2020-02-08,Butte,007,227075,0,0,0,0,0
2020-02-08,Calaveras,009,45235,0,0,0,0,0
2020-02-08,Colusa,011,21464,0,0,0,0,0
2020-02-08,Contra Costa,013,1133247,2,0,0,0,0
2020-02-08,Del Norte,015,27424,0,0,0,0,0
2020-02-08,El Dorado,017,186661,0,0,0,0,0
2020-02-08,Fresno,019,978130,0,0,0,0,0
2020-02-08,Glenn,021,27897,0,0,0,0,0
2020-02-08,Humboldt,023,135768,0,0,0,0,0
2020-02-08,Imperial,025,180216,0,0,0,0,0
2020-02-08,Inyo,027,18085,0,0,0,0,0
2020-02-08,Kern,029,883053,2,0,0,0,0
2020-02-08,Kings,031,150075,1,0,0,0,0
2020-02-08,Lake,033,64148,0,0,0,0,0
2020-02-08,Lassen,035,31185,0,0,0,0,0
2020-02-08,Los Angeles,037,10098052,23,1,1,2,0
2020-02-08,Madera,039,155013,0,0,0,0,0
2020-02-08,Marin,041,260295,0,0,0,0,0
2020-02-08,Mariposa,043,17540,0,0,0,0,0
2020-02-08,Mendocino,045,87422,0,0,0,0,0
2020-02-08,Merced,047,269075,0,0,0,0,0
2020-02-08,Modoc,049,8938,0,0,0,0,0
2020-02-08,Mono,051,14174,0,0,0,0,0
2020-02-08,Monterey,053,433212,1,0,0,0,0
2020-02-08,Napa,055,140530,0,0,0,0,0
2020-02-08,Nevada,057,99092,0,0,0,0,0
2020-02-08,Orange,059,3164182,35,1,0,1,0
2020-02-08,Placer,061,380077,0,0,0,0,0
2020-02-08,Plumas,063,18699,0,0,0,0,0
2020-02-08,Riverside,065,2383286,4,0,0,0,0
2020-02-08,Sacramento,067,1510023,0,0,0,0,0
2020-02-08,San Benito,069,59416,0,2,0,2,0
2020-02-08,San Bernardino,071,2135413,7,0,0,0,0
2020-02-08,San Diego,073,3302833,1,0,0,0,0
2020-02-08,San Francisco,075,870044,1,0,0,0,0
2020-02-08,San Joaquin,077,732212,0,0,1,1,0
2020-02-08,San Luis Obispo,079,281455,0,0,0,0,0
2020-02-08,San Mateo,081,765935,2,0,0,0,0
2020-02-08,Santa Barbara,083,443738,0,0,0,0,0
2020-02-08,Santa Clara,085,1922200,4,2,0,2,0
2020-02-08,Santa Cruz,087,273765,0,0,0,0,0
2020-02-08,Shasta,089,179085,0,0,0,0,0
2020-02-08,Sierra,091,2930,0,0,0,0,0
2020-02-08,Siskiyou,093,43540,0,0,0,0,0
2020-02-08,Solano,095,438530,0,0,0,0,0
2020-02-08,Sonoma,097,501317,0,0,0,0,0
2020-02-08,Stanislaus,099,539301,0,0,0,0,0
2020-02-08,Sutter,101,95872,0,0,0,0,0
2020-02-08,Tehama,103,63373,0,0,0,0,0
2020-02-08,Trinity,105,12862,0,0,0,0,0
2020-02-08,Tulare,107,460477,2,0,0,0,0
2020-02-08,Tuolumne,109,53932,0,0,0,0,0
2020-02-08,Ventura,111,848112,1,0,0,0,0
2020-02-08,Yolo,113,214977,0,0,0,0,0
2020-02-08,Yuba,115,75493,0,0,0,0,0
2020-02-07,Alameda,001,1643700,3,0,0,0,0
2020-02-07,Alpine,003,1148,0,0,0,0,0
2020-02-07,Amador,005,37829,0,0,0,0,0
2020-02-07,Butte,007,227075,0,0,0,0,0
2020-02-07,Calaveras,009,45235,0,0,0,0,0
2020-02-07,Colusa,011,21464,0,0,0,0,0
2020-02-07,Contra Costa,013,1133247,2,0,0,0,0
2020-02-07,Del Norte,015,27424,0,0,0,0,0
2020-02-07,El Dorado,017,186661,0,0,0,0,0
2020-02-07,Fresno,019,978130,0,0,0,0,0
2020-02-07,Glenn,021,27897,0,0,0,0,0
2020-02-07,Humboldt,023,135768,0,0,0,0,0
2020-02-07,Imperial,025,180216,0,0,0,0,0
2020-02-07,Inyo,027,18085,0,0,0,0,0
2020-02-07,Kern,029,883053,2,0,0,0,0
2020-02-07,Kings,031,150075,1,0,0,0,0
2020-02-07,Lake,033,64148,0,0,0,0,0
2020-02-07,Lassen,035,31185,0,0,0,0,0
2020-02-07,Los Angeles,037,10098052,22,1,0,1,0
2020-02-07,Madera,039,155013,0,0,0,0,0
2020-02-07,Marin,041,260295,0,0,0,0,0
2020-02-07,Mariposa,043,17540,0,0,0,0,0
2020-02-07,Mendocino,045,87422,0,0,0,0,0
2020-02-07,Merced,047,269075,0,0,0,0,0
2020-02-07,Modoc,049,8938,0,0,0,0,0
2020-02-07,Mono,051,14174,0,0,0,0,0
2020-02-07,Monterey,053,433212,1,0,0,0,0
2020-02-07,Napa,055,140530,0,0,0,0,0
2020-02-07,Nevada,057,99092,0,0,0,0,0
2020-02-07,Orange,059,3164182,33,1,0,1,0
2020-02-07,Placer,061,380077,0,0,0,0,0
2020-02-07,Plumas,063,18699,0,0,0,0,0
2020-02-07,Riverside,065,2383286,4,0,0,0,0
2020-02-07,Sacramento,067,1510023,0,0,0,0,0
2020-02-07,San Benito,069,59416,0,2,0,2,0
2020-02-07,San Bernardino,071,2135413,4,0,0,0,0
2020-02-07,San Diego,073,3302833,1,0,0,0,0
2020-02-07,San Francisco,075,870044,1,0,0,0,0
2020-02-07,San Joaquin,077,732212,0,0,1,1,0
2020-02-07,San Luis Obispo,079,281455,0,0,0,0,0
2020-02-07,San Mateo,081,765935,1,0,0,0,0
2020-02-07,Santa Barbara,083,443738,0,0,0,0,0
2020-02-07,Santa Clara,085,1922200,4,2,0,2,0
2020-02-07,Santa Cruz,087,273765,0,0,0,0,0
2020-02-07,Shasta,089,179085,0,0,0,0,0
2020-02-07,Sierra,091,2930,0,0,0,0,0
2020-02-07,Siskiyou,093,43540,0,0,0,0,0
2020-02-07,Solano,095,438530,0,0,0,0,0
2020-02-07,Sonoma,097,501317,0,0,0,0,0
2020-02-07,Stanislaus,099,539301,0,0,0,0,0
2020-02-07,Sutter,101,95872,0,0,0,0,0
2020-02-07,Tehama,103,63373,0,0,0,0,0
2020-02-07,Trinity,105,12862,0,0,0,0,0
2020-02-07,Tulare,107,460477,2,0,0,0,0
2020-02-07,Tuolumne,109,53932,0,0,0,0,0
2020-02-07,Ventura,111,848112,1,0,0,0,0
2020-02-07,Yolo,113,214977,0,0,0,0,0
2020-02-07,Yuba,115,75493,0,0,0,0,0
2020-02-06,Alameda,001,1643700,3,0,0,0,0
2020-02-06,Alpine,003,1148,0,0,0,0,0
2020-02-06,Amador,005,37829,0,0,0,0,0
2020-02-06,Butte,007,227075,0,0,0,0,0
2020-02-06,Calaveras,009,45235,0,0,0,0,0
2020-02-06,Colusa,011,21464,0,0,0,0,0
2020-02-06,Contra Costa,013,1133247,2,0,0,0,0
2020-02-06,Del Norte,015,27424,0,0,0,0,0
2020-02-06,El Dorado,017,186661,0,0,0,0,0
2020-02-06,Fresno,019,978130,0,0,0,0,0
2020-02-06,Glenn,021,27897,0,0,0,0,0
2020-02-06,Humboldt,023,135768,0,0,0,0,0
2020-02-06,Imperial,025,180216,0,0,0,0,0
2020-02-06,Inyo,027,18085,0,0,0,0,0
2020-02-06,Kern,029,883053,2,0,0,0,0
2020-02-06,Kings,031,150075,0,0,0,0,0
2020-02-06,Lake,033,64148,0,0,0,0,0
2020-02-06,Lassen,035,31185,0,0,0,0,0
2020-02-06,Los Angeles,037,10098052,21,1,0,1,0
2020-02-06,Madera,039,155013,0,0,0,0,0
2020-02-06,Marin,041,260295,0,0,0,0,0
2020-02-06,Mariposa,043,17540,0,0,0,0,0
2020-02-06,Mendocino,045,87422,0,0,0,0,0
2020-02-06,Merced,047,269075,0,0,0,0,0
2020-02-06,Modoc,049,8938,0,0,0,0,0
2020-02-06,Mono,051,14174,0,0,0,0,0
2020-02-06,Monterey,053,433212,1,0,0,0,0
2020-02-06,Napa,055,140530,0,0,0,0,0
2020-02-06,Nevada,057,99092,0,0,0,0,0
2020-02-06,Orange,059,3164182,3,1,0,1,0
2020-02-06,Placer,061,380077,0,0,0,0,0
2020-02-06,Plumas,063,18699,0,0,0,0,0
2020-02-06,Riverside,065,2383286,4,0,0,0,0
2020-02-06,Sacramento,067,1510023,0,0,0,0,0
2020-02-06,San Benito,069,59416,0,2,0,2,0
2020-02-06,San Bernardino,071,2135413,4,0,0,0,0
2020-02-06,San Diego,073,3302833,1,0,0,0,0
2020-02-06,San Francisco,075,870044,1,0,0,0,0
2020-02-06,San Joaquin,077,732212,0,0,1,1,0
2020-02-06,San Luis Obispo,079,281455,0,0,0,0,0
2020-02-06,San Mateo,081,765935,1,0,0,0,0
2020-02-06,Santa Barbara,083,443738,0,0,0,0,0
2020-02-06,Santa Clara,085,1922200,4,2,0,2,0
2020-02-06,Santa Cruz,087,273765,0,0,0,0,0
2020-02-06,Shasta,089,179085,0,0,0,0,0
2020-02-06,Sierra,091,2930,0,0,0,0,0
2020-02-06,Siskiyou,093,43540,0,0,0,0,0
2020-02-06,Solano,095,438530,0,0,0,0,0
2020-02-06,Sonoma,097,501317,0,0,0,0,0
2020-02-06,Stanislaus,099,539301,0,0,0,0,0
2020-02-06,Sutter,101,95872,0,0,0,0,0
2020-02-06,Tehama,103,63373,0,0,0,0,0
2020-02-06,Trinity,105,12862,0,0,0,0,0
2020-02-06,Tulare,107,460477,2,0,0,0,0
2020-02-06,Tuolumne,109,53932,0,0,0,0,0
2020-02-06,Ventura,111,848112,1,0,0,0,0
2020-02-06,Yolo,113,214977,0,0,0,0,0
2020-02-06,Yuba,115,75493,0,0,0,0,0
2020-02-05,Alameda,001,1643700,3,0,0,0,0
2020-02-05,Alpine,003,1148,0,0,0,0,0
2020-02-05,Amador,005,37829,0,0,0,0,0
2020-02-05,Butte,007,227075,0,0,0,0,0
2020-02-05,Calaveras,009,45235,0,0,0,0,0
2020-02-05,Colusa,011,21464,0,0,0,0,0
2020-02-05,Contra Costa,013,1133247,2,0,0,0,0
2020-02-05,Del Norte,015,27424,0,0,0,0,0
2020-02-05,El Dorado,017,186661,0,0,0,0,0
2020-02-05,Fresno,019,978130,0,0,0,0,0
2020-02-05,Glenn,021,27897,0,0,0,0,0
2020-02-05,Humboldt,023,135768,0,0,0,0,0
2020-02-05,Imperial,025,180216,0,0,0,0,0
2020-02-05,Inyo,027,18085,0,0,0,0,0
2020-02-05,Kern,029,883053,1,0,0,0,0
2020-02-05,Kings,031,150075,0,0,0,0,0
2020-02-05,Lake,033,64148,0,0,0,0,0
2020-02-05,Lassen,035,31185,0,0,0,0,0
2020-02-05,Los Angeles,037,10098052,21,1,0,1,0
2020-02-05,Madera,039,155013,0,0,0,0,0
2020-02-05,Marin,041,260295,0,0,0,0,0
2020-02-05,Mariposa,043,17540,0,0,0,0,0
2020-02-05,Mendocino,045,87422,0,0,0,0,0
2020-02-05,Merced,047,269075,0,0,0,0,0
2020-02-05,Modoc,049,8938,0,0,0,0,0
2020-02-05,Mono,051,14174,0,0,0,0,0
2020-02-05,Monterey,053,433212,1,0,0,0,0
2020-02-05,Napa,055,140530,0,0,0,0,0
2020-02-05,Nevada,057,99092,0,0,0,0,0
2020-02-05,Orange,059,3164182,1,1,0,1,0
2020-02-05,Placer,061,380077,0,0,0,0,0
2020-02-05,Plumas,063,18699,0,0,0,0,0
2020-02-05,Riverside,065,2383286,4,0,0,0,0
2020-02-05,Sacramento,067,1510023,0,0,0,0,0
2020-02-05,San Benito,069,59416,0,2,0,2,0
2020-02-05,San Bernardino,071,2135413,4,0,0,0,0
2020-02-05,San Diego,073,3302833,0,0,0,0,0
2020-02-05,San Francisco,075,870044,1,0,0,0,0
2020-02-05,San Joaquin,077,732212,0,0,1,1,0
2020-02-05,San Luis Obispo,079,281455,0,0,0,0,0
2020-02-05,San Mateo,081,765935,1,0,0,0,0
2020-02-05,Santa Barbara,083,443738,0,0,0,0,0
2020-02-05,Santa Clara,085,1922200,2,2,0,2,0
2020-02-05,Santa Cruz,087,273765,0,0,0,0,0
2020-02-05,Shasta,089,179085,0,0,0,0,0
2020-02-05,Sierra,091,2930,0,0,0,0,0
2020-02-05,Siskiyou,093,43540,0,0,0,0,0
2020-02-05,Solano,095,438530,0,0,0,0,0
2020-02-05,Sonoma,097,501317,0,0,0,0,0
2020-02-05,Stanislaus,099,539301,0,0,0,0,0
2020-02-05,Sutter,101,95872,0,0,0,0,0
2020-02-05,Tehama,103,63373,0,0,0,0,0
2020-02-05,Trinity,105,12862,0,0,0,0,0
2020-02-05,Tulare,107,460477,2,0,0,0,0
2020-02-05,Tuolumne,109,53932,0,0,0,0,0
2020-02-05,Ventura,111,848112,0,0,0,0,0
2020-02-05,Yolo,113,214977,0,0,0,0,0
2020-02-05,Yuba,115,75493,0,0,0,0,0
2020-02-04,Alameda,001,1643700,3,0,0,0,0
2020-02-04,Alpine,003,1148,0,0,0,0,0
2020-02-04,Amador,005,37829,0,0,0,0,0
2020-02-04,Butte,007,227075,0,0,0,0,0
2020-02-04,Calaveras,009,45235,0,0,0,0,0
2020-02-04,Colusa,011,21464,0,0,0,0,0
2020-02-04,Contra Costa,013,1133247,2,0,0,0,0
2020-02-04,Del Norte,015,27424,0,0,0,0,0
2020-02-04,El Dorado,017,186661,0,0,0,0,0
2020-02-04,Fresno,019,978130,0,0,0,0,0
2020-02-04,Glenn,021,27897,0,0,0,0,0
2020-02-04,Humboldt,023,135768,0,0,0,0,0
2020-02-04,Imperial,025,180216,0,0,0,0,0
2020-02-04,Inyo,027,18085,0,0,0,0,0
2020-02-04,Kern,029,883053,0,0,0,0,0
2020-02-04,Kings,031,150075,0,0,0,0,0
2020-02-04,Lake,033,64148,0,0,0,0,0
2020-02-04,Lassen,035,31185,0,0,0,0,0
2020-02-04,Los Angeles,037,10098052,21,1,0,1,0
2020-02-04,Madera,039,155013,0,0,0,0,0
2020-02-04,Marin,041,260295,0,0,0,0,0
2020-02-04,Mariposa,043,17540,0,0,0,0,0
2020-02-04,Mendocino,045,87422,0,0,0,0,0
2020-02-04,Merced,047,269075,0,0,0,0,0
2020-02-04,Modoc,049,8938,0,0,0,0,0
2020-02-04,Mono,051,14174,0,0,0,0,0
2020-02-04,Monterey,053,433212,1,0,0,0,0
2020-02-04,Napa,055,140530,0,0,0,0,0
2020-02-04,Nevada,057,99092,0,0,0,0,0
2020-02-04,Orange,059,3164182,1,1,0,1,0
2020-02-04,Placer,061,380077,0,0,0,0,0
2020-02-04,Plumas,063,18699,0,0,0,0,0
2020-02-04,Riverside,065,2383286,4,0,0,0,0
2020-02-04,Sacramento,067,1510023,0,0,0,0,0
2020-02-04,San Benito,069,59416,0,2,0,2,0
2020-02-04,San Bernardino,071,2135413,3,0,0,0,0
2020-02-04,San Diego,073,3302833,0,0,0,0,0
2020-02-04,San Francisco,075,870044,1,0,0,0,0
2020-02-04,San Joaquin,077,732212,0,0,1,1,0
2020-02-04,San Luis Obispo,079,281455,0,0,0,0,0
2020-02-04,San Mateo,081,765935,0,0,0,0,0
2020-02-04,Santa Barbara,083,443738,0,0,0,0,0
2020-02-04,Santa Clara,085,1922200,2,2,0,2,0
2020-02-04,Santa Cruz,087,273765,0,0,0,0,0
2020-02-04,Shasta,089,179085,0,0,0,0,0
2020-02-04,Sierra,091,2930,0,0,0,0,0
2020-02-04,Siskiyou,093,43540,0,0,0,0,0
2020-02-04,Solano,095,438530,0,0,0,0,0
2020-02-04,Sonoma,097,501317,0,0,0,0,0
2020-02-04,Stanislaus,099,539301,0,0,0,0,0
2020-02-04,Sutter,101,95872,0,0,0,0,0
2020-02-04,Tehama,103,63373,0,0,0,0,0
2020-02-04,Trinity,105,12862,0,0,0,0,0
2020-02-04,Tulare,107,460477,2,0,0,0,0
2020-02-04,Tuolumne,109,53932,0,0,0,0,0
2020-02-04,Ventura,111,848112,0,0,0,0,0
2020-02-04,Yolo,113,214977,0,0,0,0,0
2020-02-04,Yuba,115,75493,0,0,0,0,0
2020-02-03,Alameda,001,1643700,3,0,0,0,0
2020-02-03,Alpine,003,1148,0,0,0,0,0
2020-02-03,Amador,005,37829,0,0,0,0,0
2020-02-03,Butte,007,227075,0,0,0,0,0
2020-02-03,Calaveras,009,45235,0,0,0,0,0
2020-02-03,Colusa,011,21464,0,0,0,0,0
2020-02-03,Contra Costa,013,1133247,2,0,0,0,0
2020-02-03,Del Norte,015,27424,0,0,0,0,0
2020-02-03,El Dorado,017,186661,0,0,0,0,0
2020-02-03,Fresno,019,978130,0,0,0,0,0
2020-02-03,Glenn,021,27897,0,0,0,0,0
2020-02-03,Humboldt,023,135768,0,0,0,0,0
2020-02-03,Imperial,025,180216,0,0,0,0,0
2020-02-03,Inyo,027,18085,0,0,0,0,0
2020-02-03,Kern,029,883053,0,0,0,0,0
2020-02-03,Kings,031,150075,0,0,0,0,0
2020-02-03,Lake,033,64148,0,0,0,0,0
2020-02-03,Lassen,035,31185,0,0,0,0,0
2020-02-03,Los Angeles,037,10098052,21,1,0,1,0
2020-02-03,Madera,039,155013,0,0,0,0,0
2020-02-03,Marin,041,260295,0,0,0,0,0
2020-02-03,Mariposa,043,17540,0,0,0,0,0
2020-02-03,Mendocino,045,87422,0,0,0,0,0
2020-02-03,Merced,047,269075,0,0,0,0,0
2020-02-03,Modoc,049,8938,0,0,0,0,0
2020-02-03,Mono,051,14174,0,0,0,0,0
2020-02-03,Monterey,053,433212,1,0,0,0,0
2020-02-03,Napa,055,140530,0,0,0,0,0
2020-02-03,Nevada,057,99092,0,0,0,0,0
2020-02-03,Orange,059,3164182,1,1,0,1,0
2020-02-03,Placer,061,380077,0,0,0,0,0
2020-02-03,Plumas,063,18699,0,0,0,0,0
2020-02-03,Riverside,065,2383286,4,0,0,0,0
2020-02-03,Sacramento,067,1510023,0,0,0,0,0
2020-02-03,San Benito,069,59416,0,2,0,2,0
2020-02-03,San Bernardino,071,2135413,3,0,0,0,0
2020-02-03,San Diego,073,3302833,0,0,0,0,0
2020-02-03,San Francisco,075,870044,1,0,0,0,0
2020-02-03,San Joaquin,077,732212,0,0,1,1,0
2020-02-03,San Luis Obispo,079,281455,0,0,0,0,0
2020-02-03,San Mateo,081,765935,0,0,0,0,0
2020-02-03,Santa Barbara,083,443738,0,0,0,0,0
2020-02-03,Santa Clara,085,1922200,2,2,0,2,0
2020-02-03,Santa Cruz,087,273765,0,0,0,0,0
2020-02-03,Shasta,089,179085,0,0,0,0,0
2020-02-03,Sierra,091,2930,0,0,0,0,0
2020-02-03,Siskiyou,093,43540,0,0,0,0,0
2020-02-03,Solano,095,438530,0,0,0,0,0
2020-02-03,Sonoma,097,501317,0,0,0,0,0
2020-02-03,Stanislaus,099,539301,0,0,0,0,0
2020-02-03,Sutter,101,95872,0,0,0,0,0
2020-02-03,Tehama,103,63373,0,0,0,0,0
2020-02-03,Trinity,105,12862,0,0,0,0,0
2020-02-03,Tulare,107,460477,2,0,0,0,0
2020-02-03,Tuolumne,109,53932,0,0,0,0,0
2020-02-03,Ventura,111,848112,0,0,0,0,0
2020-02-03,Yolo,113,214977,0,0,0,0,0
2020-02-03,Yuba,115,75493,0,0,0,0,0
2020-02-02,Alameda,001,1643700,3,0,0,0,0
2020-02-02,Alpine,003,1148,0,0,0,0,0
2020-02-02,Amador,005,37829,0,0,0,0,0
2020-02-02,Butte,007,227075,0,0,0,0,0
2020-02-02,Calaveras,009,45235,0,0,0,0,0
2020-02-02,Colusa,011,21464,0,0,0,0,0
2020-02-02,Contra Costa,013,1133247,1,0,0,0,0
2020-02-02,Del Norte,015,27424,0,0,0,0,0
2020-02-02,El Dorado,017,186661,0,0,0,0,0
2020-02-02,Fresno,019,978130,0,0,0,0,0
2020-02-02,Glenn,021,27897,0,0,0,0,0
2020-02-02,Humboldt,023,135768,0,0,0,0,0
2020-02-02,Imperial,025,180216,0,0,0,0,0
2020-02-02,Inyo,027,18085,0,0,0,0,0
2020-02-02,Kern,029,883053,0,0,0,0,0
2020-02-02,Kings,031,150075,0,0,0,0,0
2020-02-02,Lake,033,64148,0,0,0,0,0
2020-02-02,Lassen,035,31185,0,0,0,0,0
2020-02-02,Los Angeles,037,10098052,17,1,0,1,0
2020-02-02,Madera,039,155013,0,0,0,0,0
2020-02-02,Marin,041,260295,0,0,0,0,0
2020-02-02,Mariposa,043,17540,0,0,0,0,0
2020-02-02,Mendocino,045,87422,0,0,0,0,0
2020-02-02,Merced,047,269075,0,0,0,0,0
2020-02-02,Modoc,049,8938,0,0,0,0,0
2020-02-02,Mono,051,14174,0,0,0,0,0
2020-02-02,Monterey,053,433212,1,0,0,0,0
2020-02-02,Napa,055,140530,0,0,0,0,0
2020-02-02,Nevada,057,99092,0,0,0,0,0
2020-02-02,Orange,059,3164182,1,1,0,1,0
2020-02-02,Placer,061,380077,0,0,0,0,0
2020-02-02,Plumas,063,18699,0,0,0,0,0
2020-02-02,Riverside,065,2383286,3,0,0,0,0
2020-02-02,Sacramento,067,1510023,0,0,0,0,0
2020-02-02,San Benito,069,59416,0,2,0,2,0
2020-02-02,San Bernardino,071,2135413,2,0,0,0,0
2020-02-02,San Diego,073,3302833,0,0,0,0,0
2020-02-02,San Francisco,075,870044,1,0,0,0,0
2020-02-02,San Joaquin,077,732212,0,0,1,1,0
2020-02-02,San Luis Obispo,079,281455,0,0,0,0,0
2020-02-02,San Mateo,081,765935,0,0,0,0,0
2020-02-02,Santa Barbara,083,443738,0,0,0,0,0
2020-02-02,Santa Clara,085,1922200,2,2,0,2,0
2020-02-02,Santa Cruz,087,273765,0,0,0,0,0
2020-02-02,Shasta,089,179085,0,0,0,0,0
2020-02-02,Sierra,091,2930,0,0,0,0,0
2020-02-02,Siskiyou,093,43540,0,0,0,0,0
2020-02-02,Solano,095,438530,0,0,0,0,0
2020-02-02,Sonoma,097,501317,0,0,0,0,0
2020-02-02,Stanislaus,099,539301,0,0,0,0,0
2020-02-02,Sutter,101,95872,0,0,0,0,0
2020-02-02,Tehama,103,63373,0,0,0,0,0
2020-02-02,Trinity,105,12862,0,0,0,0,0
2020-02-02,Tulare,107,460477,2,0,0,0,0
2020-02-02,Tuolumne,109,53932,0,0,0,0,0
2020-02-02,Ventura,111,848112,0,0,0,0,0
2020-02-02,Yolo,113,214977,0,0,0,0,0
2020-02-02,Yuba,115,75493,0,0,0,0,0
2020-02-01,Alameda,001,1643700,3,0,0,0,0
2020-02-01,Alpine,003,1148,0,0,0,0,0
2020-02-01,Amador,005,37829,0,0,0,0,0
2020-02-01,Butte,007,227075,0,0,0,0,0
2020-02-01,Calaveras,009,45235,0,0,0,0,0
2020-02-01,Colusa,011,21464,0,0,0,0,0
2020-02-01,Contra Costa,013,1133247,0,0,0,0,0
2020-02-01,Del Norte,015,27424,0,0,0,0,0
2020-02-01,El Dorado,017,186661,0,0,0,0,0
2020-02-01,Fresno,019,978130,0,0,0,0,0
2020-02-01,Glenn,021,27897,0,0,0,0,0
2020-02-01,Humboldt,023,135768,0,0,0,0,0
2020-02-01,Imperial,025,180216,0,0,0,0,0
2020-02-01,Inyo,027,18085,0,0,0,0,0
2020-02-01,Kern,029,883053,0,0,0,0,0
2020-02-01,Kings,031,150075,0,0,0,0,0
2020-02-01,Lake,033,64148,0,0,0,0,0
2020-02-01,Lassen,035,31185,0,0,0,0,0
2020-02-01,Los Angeles,037,10098052,13,1,0,1,0
2020-02-01,Madera,039,155013,0,0,0,0,0
2020-02-01,Marin,041,260295,0,0,0,0,0
2020-02-01,Mariposa,043,17540,0,0,0,0,0
2020-02-01,Mendocino,045,87422,0,0,0,0,0
2020-02-01,Merced,047,269075,0,0,0,0,0
2020-02-01,Modoc,049,8938,0,0,0,0,0
2020-02-01,Mono,051,14174,0,0,0,0,0
2020-02-01,Monterey,053,433212,0,0,0,0,0
2020-02-01,Napa,055,140530,0,0,0,0,0
2020-02-01,Nevada,057,99092,0,0,0,0,0
2020-02-01,Orange,059,3164182,1,1,0,1,0
2020-02-01,Placer,061,380077,0,0,0,0,0
2020-02-01,Plumas,063,18699,0,0,0,0,0
2020-02-01,Riverside,065,2383286,2,0,0,0,0
2020-02-01,Sacramento,067,1510023,0,0,0,0,0
2020-02-01,San Benito,069,59416,0,0,0,0,0
2020-02-01,San Bernardino,071,2135413,1,0,0,0,0
2020-02-01,San Diego,073,3302833,0,0,0,0,0
2020-02-01,San Francisco,075,870044,1,0,0,0,0
2020-02-01,San Joaquin,077,732212,0,0,1,1,0
2020-02-01,San Luis Obispo,079,281455,0,0,0,0,0
2020-02-01,San Mateo,081,765935,0,0,0,0,0
2020-02-01,Santa Barbara,083,443738,0,0,0,0,0
2020-02-01,Santa Clara,085,1922200,2,1,0,1,0
2020-02-01,Santa Cruz,087,273765,0,0,0,0,0
2020-02-01,Shasta,089,179085,0,0,0,0,0
2020-02-01,Sierra,091,2930,0,0,0,0,0
2020-02-01,Siskiyou,093,43540,0,0,0,0,0
2020-02-01,Solano,095,438530,0,0,0,0,0
2020-02-01,Sonoma,097,501317,0,0,0,0,0
2020-02-01,Stanislaus,099,539301,0,0,0,0,0
2020-02-01,Sutter,101,95872,0,0,0,0,0
2020-02-01,Tehama,103,63373,0,0,0,0,0
2020-02-01,Trinity,105,12862,0,0,0,0,0
2020-02-01,Tulare,107,460477,1,0,0,0,0
2020-02-01,Tuolumne,109,53932,0,0,0,0,0
2020-02-01,Ventura,111,848112,0,0,0,0,0
2020-02-01,Yolo,113,214977,0,0,0,0,0
2020-02-01,Yuba,115,75493,0,0,0,0,0
