date,county,fips,population,confirmed_cases,reported_cases,probable_cases,reported_and_probable_cases,reported_deaths
2021-08-30,Alameda,1,1643700,107728,107734,2604,110338,1296
2021-08-30,Alpine,3,1148,92,92,0,92,0
2021-08-30,Amador,5,37829,4506,4507,40,4547,53
2021-08-30,Butte,7,227075,15719,15719,2634,18353,214
2021-08-30,Calaveras,9,45235,2975,2975,21,2996,59
2021-08-30,Colusa,11,21464,2270,2271,457,2728,16
2021-08-30,Contra Costa,13,1133247,87677,87679,1817,89496,872
2021-08-30,Del Norte,15,27424,2796,2796,11,2807,11
2021-08-30,El Dorado,17,186661,13217,13217,1218,14435,119
2021-08-30,Fresno,19,978130,115867,115867,10240,126107,1790
2021-08-30,Glenn,21,27897,2804,2804,705,3509,20
2021-08-30,Humboldt,23,135768,6927,6930,267,7197,52
2021-08-30,Imperial,25,180216,30307,30311,3003,33314,750
2021-08-30,Inyo,27,18085,1544,1544,5,1549,39
2021-08-30,Kern,29,883053,107611,107615,14335,121950,1389
2021-08-30,Kings,31,150075,26234,26236,1504,27740,259
2021-08-30,Lake,33,64148,5323,5323,50,5373,74
2021-08-30,Lassen,35,31185,5667,5667,155,5822,21
2021-08-30,Los Angeles,37,10098052,1344721,1344949,52069,1397018,25269
2021-08-30,Madera,39,155013,18620,18622,1281,19903,247
2021-08-30,Marin,41,260295,16155,16160,345,16505,240
2021-08-30,Mariposa,43,17540,715,715,17,732,5
2021-08-30,Mendocino,45,87422,5721,5721,180,5901,55
2021-08-30,Merced,47,269075,35333,35335,1184,36519,497
2021-08-30,Modoc,49,8938,436,436,153,589,5
2021-08-30,Mono,51,14174,1390,1390,15,1405,3
2021-08-30,Monterey,53,433212,45463,45463,2454,47917,539
2021-08-30,Napa,55,140530,11578,11579,68,11647,87
2021-08-30,Nevada,57,99092,7351,7356,240,7596,82
2021-08-30,Orange,59,3164182,284749,284750,13337,298087,5223
2021-08-30,Placer,61,380077,29823,29825,2555,32380,319
2021-08-30,Plumas,63,18699,998,998,18,1016,5
2021-08-30,Riverside,65,2383286,327539,327593,16037,343630,4623
2021-08-30,Sacramento,67,1510023,134568,134571,2999,137570,1847
2021-08-30,San Benito,69,59416,6661,6663,136,6799,64
2021-08-30,San Bernardino,71,2135413,324828,324870,10128,334998,5348
2021-08-30,San Diego,73,3302833,333011,333011,0,333011,3885
2021-08-30,San Francisco,75,870044,46959,46966,2193,49159,581
2021-08-30,San Joaquin,77,732212,86196,86203,4589,90792,1528
2021-08-30,San Luis Obispo,79,281455,25411,25422,998,26420,280
2021-08-30,San Mateo,81,765935,48833,48839,940,49779,554
2021-08-30,Santa Barbara,83,443738,38998,38998,1587,40585,481
2021-08-30,Santa Clara,85,1922200,133268,133281,1047,134328,1789
2021-08-30,Santa Cruz,87,273765,18326,18326,979,19305,210
2021-08-30,Shasta,89,179085,15238,15238,2366,17604,217
2021-08-30,Sierra,91,2930,91,91,15,106,0
2021-08-30,Siskiyou,93,43540,2411,2411,674,3085,33
2021-08-30,Solano,95,438530,39975,39986,963,40949,290
2021-08-30,Sonoma,97,501317,36755,36764,448,37212,352
2021-08-30,Stanislaus,99,539301,66154,66173,7229,73402,1074
2021-08-30,Sutter,101,95872,11786,11791,138,11929,136
2021-08-30,Tehama,103,63373,6084,6085,820,6905,71
2021-08-30,Trinity,105,12862,468,468,104,572,3
2021-08-30,Tulare,107,460477,55140,55140,11397,66537,870
2021-08-30,Tuolumne,109,53932,5492,5492,183,5675,74
2021-08-30,Ventura,111,848112,90145,90149,4059,94208,1082
2021-08-30,Yolo,113,214977,17071,17071,730,17801,231
2021-08-30,Yuba,115,75493,8127,8129,162,8291,54
2021-08-29,Alameda,1,1643700,107728,107494,2604,110098,1296
2021-08-29,Alpine,3,1148,92,92,0,92,0
2021-08-29,Amador,5,37829,4506,4501,40,4541,53
2021-08-29,Butte,7,227075,15719,15602,2634,18236,214
2021-08-29,Calaveras,9,45235,2975,2970,21,2991,59
2021-08-29,Colusa,11,21464,2270,2260,457,2717,16
2021-08-29,Contra Costa,13,1133247,87677,87439,1817,89256,872
2021-08-29,Del Norte,15,27424,2796,2752,11,2763,11
2021-08-29,El Dorado,17,186661,13217,13166,1218,14384,119
2021-08-29,Fresno,19,978130,115867,115502,10240,125742,1790
2021-08-29,Glenn,21,27897,2804,2778,705,3483,20
2021-08-29,Humboldt,23,135768,6927,6922,267,7189,52
2021-08-29,Imperial,25,180216,30307,30293,3003,33296,750
2021-08-29,Inyo,27,18085,1544,1543,5,1548,39
2021-08-29,Kern,29,883053,107611,107324,14335,121659,1389
2021-08-29,Kings,31,150075,26234,26143,1504,27647,259
2021-08-29,Lake,33,64148,5323,5293,50,5343,74
2021-08-29,Lassen,35,31185,5667,5666,155,5821,21
2021-08-29,Los Angeles,37,10098052,1344721,1342541,52069,1394610,25263
2021-08-29,Madera,39,155013,18620,18594,1281,19875,247
2021-08-29,Marin,41,260295,16155,16134,345,16479,240
2021-08-29,Mariposa,43,17540,715,709,17,726,5
2021-08-29,Mendocino,45,87422,5721,5689,180,5869,55
2021-08-29,Merced,47,269075,35333,35250,1184,36434,497
2021-08-29,Modoc,49,8938,436,436,153,589,5
2021-08-29,Mono,51,14174,1390,1387,15,1402,3
2021-08-29,Monterey,53,433212,45463,45424,2454,47878,539
2021-08-29,Napa,55,140530,11578,11552,68,11620,87
2021-08-29,Nevada,57,99092,7351,7294,240,7534,82
2021-08-29,Orange,59,3164182,284749,284432,13337,297769,5223
2021-08-29,Placer,61,380077,29823,29674,2555,32229,319
2021-08-29,Plumas,63,18699,998,996,18,1014,5
2021-08-29,Riverside,65,2383286,327539,326987,16037,343024,4623
2021-08-29,Sacramento,67,1510023,134568,133981,2999,136980,1843
2021-08-29,San Benito,69,59416,6661,6646,136,6782,64
2021-08-29,San Bernardino,71,2135413,324828,324266,10128,334394,5347
2021-08-29,San Diego,73,3302833,333011,332014,0,332014,3880
2021-08-29,San Francisco,75,870044,46959,46885,2193,49078,581
2021-08-29,San Joaquin,77,732212,86196,85922,4589,90511,1528
2021-08-29,San Luis Obispo,79,281455,25411,25288,998,26286,280
2021-08-29,San Mateo,81,765935,48833,48737,940,49677,554
2021-08-29,Santa Barbara,83,443738,38998,38900,1587,40487,481
2021-08-29,Santa Clara,85,1922200,133268,132979,1047,134026,1789
2021-08-29,Santa Cruz,87,273765,18326,18285,979,19264,210
2021-08-29,Shasta,89,179085,15238,15198,2366,17564,217
2021-08-29,Sierra,91,2930,91,91,15,106,0
2021-08-29,Siskiyou,93,43540,2411,2407,674,3081,33
2021-08-29,Solano,95,438530,39975,39887,963,40850,290
2021-08-29,Sonoma,97,501317,36755,36650,448,37098,352
2021-08-29,Stanislaus,99,539301,66154,65956,7229,73185,1074
2021-08-29,Sutter,101,95872,11786,11719,138,11857,136
2021-08-29,Tehama,103,63373,6084,6040,820,6860,71
2021-08-29,Trinity,105,12862,468,468,104,572,3
2021-08-29,Tulare,107,460477,55140,54974,11397,66371,870
2021-08-29,Tuolumne,109,53932,5492,5478,183,5661,74
2021-08-29,Ventura,111,848112,90145,90114,4059,94173,1082
2021-08-29,Yolo,113,214977,17071,17015,730,17745,231
2021-08-29,Yuba,115,75493,8127,8042,162,8204,54
2021-08-28,Alameda,1,1643700,107702,107007,2604,109611,1296
2021-08-28,Alpine,3,1148,92,92,0,92,0
2021-08-28,Amador,5,37829,4504,4484,40,4524,53
2021-08-28,Butte,7,227075,15711,15487,2634,18121,214
2021-08-28,Calaveras,9,45235,2974,2926,21,2947,59
2021-08-28,Colusa,11,21464,2268,2252,457,2709,16
2021-08-28,Contra Costa,13,1133247,87651,86938,1817,88755,872
2021-08-28,Del Norte,15,27424,2789,2734,11,2745,11
2021-08-28,El Dorado,17,186661,13214,13089,1218,14307,119
2021-08-28,Fresno,19,978130,115838,115079,10240,125319,1792
2021-08-28,Glenn,21,27897,2801,2773,705,3478,20
2021-08-28,Humboldt,23,135768,6924,6887,267,7154,52
2021-08-28,Imperial,25,180216,30299,30260,3003,33263,750
2021-08-28,Inyo,27,18085,1544,1539,5,1544,39
2021-08-28,Kern,29,883053,107551,107012,14335,121347,1389
2021-08-28,Kings,31,150075,26222,26059,1504,27563,257
2021-08-28,Lake,33,64148,5320,5267,50,5317,74
2021-08-28,Lassen,35,31185,5667,5665,155,5820,21
2021-08-28,Los Angeles,37,10098052,1344661,1337097,52069,1389166,25234
2021-08-28,Madera,39,155013,18618,18553,1281,19834,247
2021-08-28,Marin,41,260295,16151,16106,345,16451,240
2021-08-28,Mariposa,43,17540,715,704,17,721,5
2021-08-28,Mendocino,45,87422,5716,5658,180,5838,55
2021-08-28,Merced,47,269075,35325,35108,1184,36292,497
2021-08-28,Modoc,49,8938,436,436,153,589,5
2021-08-28,Mono,51,14174,1388,1385,15,1400,3
2021-08-28,Monterey,53,433212,45450,45394,2454,47848,539
2021-08-28,Napa,55,140530,11573,11512,68,11580,88
2021-08-28,Nevada,57,99092,7349,7238,240,7478,82
2021-08-28,Orange,59,3164182,284697,283953,13337,297290,5222
2021-08-28,Placer,61,380077,29807,29428,2555,31983,319
2021-08-28,Plumas,63,18699,998,991,18,1009,5
2021-08-28,Riverside,65,2383286,327512,326222,16037,342259,4623
2021-08-28,Sacramento,67,1510023,134513,132985,2999,135984,1844
2021-08-28,San Benito,69,59416,6660,6636,136,6772,64
2021-08-28,San Bernardino,71,2135413,324813,323672,10128,333800,5348
2021-08-28,San Diego,73,3302833,332963,331330,0,331330,3880
2021-08-28,San Francisco,75,870044,46946,46654,2193,48847,581
2021-08-28,San Joaquin,77,732212,86153,85481,4589,90070,1527
2021-08-28,San Luis Obispo,79,281455,25399,25138,998,26136,280
2021-08-28,San Mateo,81,765935,48824,48575,940,49515,554
2021-08-28,Santa Barbara,83,443738,38984,38780,1587,40367,481
2021-08-28,Santa Clara,85,1922200,133235,132488,1047,133535,1789
2021-08-28,Santa Cruz,87,273765,18324,18240,979,19219,210
2021-08-28,Shasta,89,179085,15238,15147,2366,17513,217
2021-08-28,Sierra,91,2930,91,91,15,106,0
2021-08-28,Siskiyou,93,43540,2410,2402,674,3076,33
2021-08-28,Solano,95,438530,39966,39610,963,40573,290
2021-08-28,Sonoma,97,501317,36747,36466,448,36914,352
2021-08-28,Stanislaus,99,539301,66119,65670,7229,72899,1074
2021-08-28,Sutter,101,95872,11775,11669,138,11807,136
2021-08-28,Tehama,103,63373,6078,6004,820,6824,71
2021-08-28,Trinity,105,12862,468,463,104,567,3
2021-08-28,Tulare,107,460477,55115,54746,11397,66143,870
2021-08-28,Tuolumne,109,53932,5489,5469,183,5652,74
2021-08-28,Ventura,111,848112,90128,89934,4059,93993,1081
2021-08-28,Yolo,113,214977,17071,16907,730,17637,231
2021-08-28,Yuba,115,75493,8112,7985,162,8147,55
2021-08-27,Alameda,1,1643700,107636,106622,2604,109226,1296
2021-08-27,Alpine,3,1148,92,92,0,92,0
2021-08-27,Amador,5,37829,4503,4458,40,4498,53
2021-08-27,Butte,7,227075,15697,15277,2634,17911,214
2021-08-27,Calaveras,9,45235,2966,2903,21,2924,59
2021-08-27,Colusa,11,21464,2265,2240,457,2697,16
2021-08-27,Contra Costa,13,1133247,87591,86386,1817,88203,872
2021-08-27,Del Norte,15,27424,2777,2695,11,2706,11
2021-08-27,El Dorado,17,186661,13199,12968,1218,14186,119
2021-08-27,Fresno,19,978130,115722,114481,10240,124721,1774
2021-08-27,Glenn,21,27897,2798,2754,705,3459,20
2021-08-27,Humboldt,23,135768,6914,6782,267,7049,52
2021-08-27,Imperial,25,180216,30290,30201,3003,33204,750
2021-08-27,Inyo,27,18085,1540,1529,5,1534,39
2021-08-27,Kern,29,883053,107496,106570,14335,120905,1385
2021-08-27,Kings,31,150075,26205,25957,1504,27461,257
2021-08-27,Lake,33,64148,5310,5228,50,5278,74
2021-08-27,Lassen,35,31185,5667,5646,155,5801,21
2021-08-27,Los Angeles,37,10098052,1344201,1337006,52069,1389075,25230
2021-08-27,Madera,39,155013,18613,18476,1281,19757,247
2021-08-27,Marin,41,260295,16147,16055,345,16400,240
2021-08-27,Mariposa,43,17540,714,690,17,707,5
2021-08-27,Mendocino,45,87422,5708,5602,180,5782,55
2021-08-27,Merced,47,269075,35307,34906,1184,36090,495
2021-08-27,Modoc,49,8938,436,434,153,587,5
2021-08-27,Mono,51,14174,1386,1385,15,1400,3
2021-08-27,Monterey,53,433212,45444,45337,2454,47791,539
2021-08-27,Napa,55,140530,11557,11460,68,11528,87
2021-08-27,Nevada,57,99092,7339,7169,240,7409,82
2021-08-27,Orange,59,3164182,284573,283407,13337,296744,5206
2021-08-27,Placer,61,380077,29755,29157,2555,31712,320
2021-08-27,Plumas,63,18699,992,984,18,1002,5
2021-08-27,Riverside,65,2383286,327412,325379,16037,341416,4622
2021-08-27,Sacramento,67,1510023,134411,131921,2999,134920,1838
2021-08-27,San Benito,69,59416,6656,6622,136,6758,64
2021-08-27,San Bernardino,71,2135413,324592,322893,10128,333021,5342
2021-08-27,San Diego,73,3302833,332678,330162,0,330162,3877
2021-08-27,San Francisco,75,870044,46920,46456,2193,48649,581
2021-08-27,San Joaquin,77,732212,86074,84949,4589,89538,1524
2021-08-27,San Luis Obispo,79,281455,25380,24952,998,25950,280
2021-08-27,San Mateo,81,765935,48798,48424,940,49364,553
2021-08-27,Santa Barbara,83,443738,38947,38675,1587,40262,480
2021-08-27,Santa Clara,85,1922200,133161,132011,1047,133058,1783
2021-08-27,Santa Cruz,87,273765,18315,18163,979,19142,210
2021-08-27,Shasta,89,179085,15237,14996,2366,17362,217
2021-08-27,Sierra,91,2930,91,91,15,106,0
2021-08-27,Siskiyou,93,43540,2408,2358,674,3032,33
2021-08-27,Solano,95,438530,39945,39347,963,40310,287
2021-08-27,Sonoma,97,501317,36717,36326,448,36774,342
2021-08-27,Stanislaus,99,539301,66033,65167,7229,72396,1061
2021-08-27,Sutter,101,95872,11766,11590,138,11728,135
2021-08-27,Tehama,103,63373,6068,5964,820,6784,71
2021-08-27,Trinity,105,12862,468,458,104,562,3
2021-08-27,Tulare,107,460477,55076,54443,11397,65840,870
2021-08-27,Tuolumne,109,53932,5477,5438,183,5621,74
2021-08-27,Ventura,111,848112,90090,89774,4059,93833,1076
2021-08-27,Yolo,113,214977,17051,16805,730,17535,231
2021-08-27,Yuba,115,75493,8091,7926,162,8088,54
2021-08-26,Alameda,1,1643700,107473,106146,2604,108750,1296
2021-08-26,Alpine,3,1148,92,92,0,92,0
2021-08-26,Amador,5,37829,4502,4442,40,4482,53
2021-08-26,Butte,7,227075,15622,15159,2634,17793,214
2021-08-26,Calaveras,9,45235,2958,2873,21,2894,59
2021-08-26,Colusa,11,21464,2258,2234,457,2691,16
2021-08-26,Contra Costa,13,1133247,87400,85808,1817,87625,866
2021-08-26,Del Norte,15,27424,2756,2625,11,2636,8
2021-08-26,El Dorado,17,186661,13156,12863,1218,14081,118
2021-08-26,Fresno,19,978130,115543,113854,10240,124094,1770
2021-08-26,Glenn,21,27897,2794,2740,705,3445,20
2021-08-26,Humboldt,23,135768,6906,6695,267,6962,53
2021-08-26,Imperial,25,180216,30277,30121,3003,33124,748
2021-08-26,Inyo,27,18085,1535,1521,5,1526,39
2021-08-26,Kern,29,883053,107300,106051,14335,120386,1380
2021-08-26,Kings,31,150075,26178,25838,1504,27342,260
2021-08-26,Lake,33,64148,5292,5196,50,5246,74
2021-08-26,Lassen,35,31185,5667,5626,155,5781,21
2021-08-26,Los Angeles,37,10098052,1342587,1334372,52069,1386441,25199
2021-08-26,Madera,39,155013,18596,18393,1281,19674,247
2021-08-26,Marin,41,260295,16128,15983,345,16328,240
2021-08-26,Mariposa,43,17540,714,677,17,694,5
2021-08-26,Mendocino,45,87422,5683,5533,180,5713,55
2021-08-26,Merced,47,269075,35230,34755,1184,35939,495
2021-08-26,Modoc,49,8938,436,433,153,586,5
2021-08-26,Mono,51,14174,1386,1385,15,1400,3
2021-08-26,Monterey,53,433212,45412,45265,2454,47719,539
2021-08-26,Napa,55,140530,11519,11394,68,11462,87
2021-08-26,Nevada,57,99092,7321,7086,240,7326,80
2021-08-26,Orange,59,3164182,284264,282814,13337,296151,5200
2021-08-26,Placer,61,380077,29661,28898,2555,31453,319
2021-08-26,Plumas,63,18699,989,971,18,989,5
2021-08-26,Riverside,65,2383286,327000,324486,16037,340523,4615
2021-08-26,Sacramento,67,1510023,134116,130977,2999,133976,1827
2021-08-26,San Benito,69,59416,6651,6604,136,6740,64
2021-08-26,San Bernardino,71,2135413,324060,322100,10128,332228,5339
2021-08-26,San Diego,73,3302833,332255,328276,0,328276,3869
2021-08-26,San Francisco,75,870044,46851,46288,2193,48481,581
2021-08-26,San Joaquin,77,732212,85790,84429,4589,89018,1513
2021-08-26,San Luis Obispo,79,281455,25253,24831,998,25829,278
2021-08-26,San Mateo,81,765935,48731,48263,940,49203,553
2021-08-26,Santa Barbara,83,443738,38888,38566,1587,40153,479
2021-08-26,Santa Clara,85,1922200,132867,131443,1047,132490,1782
2021-08-26,Santa Cruz,87,273765,18292,18072,979,19051,210
2021-08-26,Shasta,89,179085,15206,14891,2366,17257,217
2021-08-26,Sierra,91,2930,91,90,15,105,0
2021-08-26,Siskiyou,93,43540,2404,2342,674,3016,33
2021-08-26,Solano,95,438530,39857,39027,963,39990,286
2021-08-26,Sonoma,97,501317,36664,36102,448,36550,337
2021-08-26,Stanislaus,99,539301,65889,64785,7229,72014,1061
2021-08-26,Sutter,101,95872,11744,11499,138,11637,135
2021-08-26,Tehama,103,63373,6049,5913,820,6733,68
2021-08-26,Trinity,105,12862,467,450,104,554,3
2021-08-26,Tulare,107,460477,55009,54157,11397,65554,870
2021-08-26,Tuolumne,109,53932,5472,5387,183,5570,74
2021-08-26,Ventura,111,848112,90012,89595,4059,93654,1080
2021-08-26,Yolo,113,214977,16992,16727,730,17457,231
2021-08-26,Yuba,115,75493,8057,7834,162,7996,54
2021-08-25,Alameda,1,1643700,107179,105636,2604,108240,1296
2021-08-25,Alpine,3,1148,92,92,0,92,0
2021-08-25,Amador,5,37829,4499,4415,40,4455,53
2021-08-25,Butte,7,227075,15533,15039,2634,17673,214
2021-08-25,Calaveras,9,45235,2945,2851,21,2872,59
2021-08-25,Colusa,11,21464,2253,2227,457,2684,16
2021-08-25,Contra Costa,13,1133247,87040,85322,1817,87139,863
2021-08-25,Del Norte,15,27424,2717,2573,11,2584,8
2021-08-25,El Dorado,17,186661,13094,12787,1218,14005,118
2021-08-25,Fresno,19,978130,115125,113384,10240,123624,1761
2021-08-25,Glenn,21,27897,2769,2728,705,3433,20
2021-08-25,Humboldt,23,135768,6876,6653,267,6920,52
2021-08-25,Imperial,25,180216,30251,30085,3003,33088,748
2021-08-25,Inyo,27,18085,1534,1518,5,1523,39
2021-08-25,Kern,29,883053,107011,105687,14335,120022,1379
2021-08-25,Kings,31,150075,26098,25676,1504,27180,258
2021-08-25,Lake,33,64148,5261,5163,50,5213,74
2021-08-25,Lassen,35,31185,5656,5583,155,5738,21
2021-08-25,Los Angeles,37,10098052,1340091,1331400,52069,1383469,25170
2021-08-25,Madera,39,155013,18549,18311,1281,19592,247
2021-08-25,Marin,41,260295,16103,15938,345,16283,240
2021-08-25,Mariposa,43,17540,708,676,17,693,5
2021-08-25,Mendocino,45,87422,5645,5486,180,5666,53
2021-08-25,Merced,47,269075,35102,34600,1184,35784,492
2021-08-25,Modoc,49,8938,436,433,153,586,5
2021-08-25,Mono,51,14174,1385,1382,15,1397,3
2021-08-25,Monterey,53,433212,45365,45196,2454,47650,539
2021-08-25,Napa,55,140530,11476,11348,68,11416,87
2021-08-25,Nevada,57,99092,7253,7000,240,7240,77
2021-08-25,Orange,59,3164182,283830,282061,13337,295398,5193
2021-08-25,Placer,61,380077,29513,28740,2555,31295,319
2021-08-25,Plumas,63,18699,976,962,18,980,5
2021-08-25,Riverside,65,2383286,326215,323548,16037,339585,4610
2021-08-25,Sacramento,67,1510023,133370,130046,2999,133045,1827
2021-08-25,San Benito,69,59416,6633,6587,136,6723,64
2021-08-25,San Bernardino,71,2135413,323410,321228,10128,331356,5337
2021-08-25,San Diego,73,3302833,331306,327166,0,327166,3859
2021-08-25,San Francisco,75,870044,46722,46107,2193,48300,578
2021-08-25,San Joaquin,77,732212,85444,84002,4589,88591,1510
2021-08-25,San Luis Obispo,79,281455,25074,24607,998,25605,276
2021-08-25,San Mateo,81,765935,48632,48153,940,49093,553
2021-08-25,Santa Barbara,83,443738,38779,38450,1587,40037,479
2021-08-25,Santa Clara,85,1922200,132537,130995,1047,132042,1783
2021-08-25,Santa Cruz,87,273765,18231,17987,979,18966,210
2021-08-25,Shasta,89,179085,15138,14752,2366,17118,217
2021-08-25,Sierra,91,2930,91,90,15,105,0
2021-08-25,Siskiyou,93,43540,2384,2322,674,2996,33
2021-08-25,Solano,95,438530,39703,38848,963,39811,286
2021-08-25,Sonoma,97,501317,36544,35986,448,36434,336
2021-08-25,Stanislaus,99,539301,65634,64441,7229,71670,1061
2021-08-25,Sutter,101,95872,11682,11451,138,11589,134
2021-08-25,Tehama,103,63373,5998,5861,820,6681,68
2021-08-25,Trinity,105,12862,466,450,104,554,3
2021-08-25,Tulare,107,460477,54781,53877,11397,65274,866
2021-08-25,Tuolumne,109,53932,5459,5354,183,5537,74
2021-08-25,Ventura,111,848112,89869,89379,4059,93438,1068
2021-08-25,Yolo,113,214977,16920,16667,730,17397,231
2021-08-25,Yuba,115,75493,7987,7771,162,7933,54
2021-08-24,Alameda,1,1643700,106857,105319,2604,107923,1296
2021-08-24,Alpine,3,1148,92,92,0,92,0
2021-08-24,Amador,5,37829,4486,4380,40,4420,50
2021-08-24,Butte,7,227075,15407,14964,2634,17598,214
2021-08-24,Calaveras,9,45235,2905,2811,21,2832,59
2021-08-24,Colusa,11,21464,2251,2221,457,2678,16
2021-08-24,Contra Costa,13,1133247,86726,84963,1817,86780,857
2021-08-24,Del Norte,15,27424,2695,2543,11,2554,8
2021-08-24,El Dorado,17,186661,13025,12732,1218,13950,118
2021-08-24,Fresno,19,978130,114629,113024,10240,123264,1761
2021-08-24,Glenn,21,27897,2757,2717,705,3422,20
2021-08-24,Humboldt,23,135768,6814,6585,267,6852,52
2021-08-24,Imperial,25,180216,30188,30045,3003,33048,748
2021-08-24,Inyo,27,18085,1530,1512,5,1517,39
2021-08-24,Kern,29,883053,106637,105399,14335,119734,1375
2021-08-24,Kings,31,150075,25985,25629,1504,27133,258
2021-08-24,Lake,33,64148,5233,5135,50,5185,72
2021-08-24,Lassen,35,31185,5645,5576,155,5731,21
2021-08-24,Los Angeles,37,10098052,1337347,1328777,52069,1380846,25135
2021-08-24,Madera,39,155013,18483,18251,1281,19532,247
2021-08-24,Marin,41,260295,16078,15900,345,16245,240
2021-08-24,Mariposa,43,17540,702,670,17,687,5
2021-08-24,Mendocino,45,87422,5619,5416,180,5596,52
2021-08-24,Merced,47,269075,34990,34490,1184,35674,491
2021-08-24,Modoc,49,8938,436,432,153,585,5
2021-08-24,Mono,51,14174,1383,1382,15,1397,3
2021-08-24,Monterey,53,433212,45329,45126,2454,47580,539
2021-08-24,Napa,55,140530,11462,11299,68,11367,85
2021-08-24,Nevada,57,99092,7199,6981,240,7221,77
2021-08-24,Orange,59,3164182,283301,281461,13337,294798,5187
2021-08-24,Placer,61,380077,29346,28618,2555,31173,318
2021-08-24,Plumas,63,18699,970,953,18,971,5
2021-08-24,Riverside,65,2383286,325447,322620,16037,338657,4605
2021-08-24,Sacramento,67,1510023,132656,129542,2999,132541,1812
2021-08-24,San Benito,69,59416,6620,6576,136,6712,64
2021-08-24,San Bernardino,71,2135413,322741,320300,10128,330428,5328
2021-08-24,San Diego,73,3302833,330087,325823,0,325823,3851
2021-08-24,San Francisco,75,870044,46575,46010,2193,48203,574
2021-08-24,San Joaquin,77,732212,85059,83684,4589,88273,1508
2021-08-24,San Luis Obispo,79,281455,24927,24443,998,25441,274
2021-08-24,San Mateo,81,765935,48508,48050,940,48990,553
2021-08-24,Santa Barbara,83,443738,38710,38307,1587,39894,478
2021-08-24,Santa Clara,85,1922200,132193,130763,1047,131810,1779
2021-08-24,Santa Cruz,87,273765,18153,17928,979,18907,209
2021-08-24,Shasta,89,179085,15067,14664,2366,17030,217
2021-08-24,Sierra,91,2930,91,90,15,105,0
2021-08-24,Siskiyou,93,43540,2372,2294,674,2968,33
2021-08-24,Solano,95,438530,39542,38724,963,39687,283
2021-08-24,Sonoma,97,501317,36421,35849,448,36297,336
2021-08-24,Stanislaus,99,539301,65317,64195,7229,71424,1058
2021-08-24,Sutter,101,95872,11621,11384,138,11522,134
2021-08-24,Tehama,103,63373,5972,5826,820,6646,67
2021-08-24,Trinity,105,12862,460,446,104,550,3
2021-08-24,Tulare,107,460477,54511,53702,11397,65099,856
2021-08-24,Tuolumne,109,53932,5440,5287,183,5470,74
2021-08-24,Ventura,111,848112,89708,89167,4059,93226,1068
2021-08-24,Yolo,113,214977,16861,16492,730,17222,231
2021-08-24,Yuba,115,75493,7910,7723,162,7885,54
2021-08-23,Alameda,1,1643700,106517,104922,2604,107526,1294
2021-08-23,Alpine,3,1148,92,91,0,91,0
2021-08-23,Amador,5,37829,4477,4369,40,4409,50
2021-08-23,Butte,7,227075,15295,14847,2630,17477,211
2021-08-23,Calaveras,9,45235,2873,2803,21,2824,59
2021-08-23,Colusa,11,21464,2244,2206,450,2656,16
2021-08-23,Contra Costa,13,1133247,86384,84651,1817,86468,857
2021-08-23,Del Norte,15,27424,2656,2499,11,2510,8
2021-08-23,El Dorado,17,186661,12930,12684,1215,13899,118
2021-08-23,Fresno,19,978130,114176,112445,10240,122685,1759
2021-08-23,Glenn,21,27897,2743,2696,692,3388,20
2021-08-23,Humboldt,23,135768,6756,6498,264,6762,52
2021-08-23,Imperial,25,180216,30163,30011,3003,33014,748
2021-08-23,Inyo,27,18085,1525,1509,5,1514,39
2021-08-23,Kern,29,883053,106263,104995,14332,119327,1375
2021-08-23,Kings,31,150075,25879,25465,1502,26967,257
2021-08-23,Lake,33,64148,5207,5099,50,5149,69
2021-08-23,Lassen,35,31185,5635,5562,155,5717,21
2021-08-23,Los Angeles,37,10098052,1334491,1326412,52055,1378467,25096
2021-08-23,Madera,39,155013,18424,18155,1281,19436,246
2021-08-23,Marin,41,260295,16051,15856,345,16201,240
2021-08-23,Mariposa,43,17540,695,645,17,662,5
2021-08-23,Mendocino,45,87422,5567,5374,179,5553,51
2021-08-23,Merced,47,269075,34813,34322,1183,35505,488
2021-08-23,Modoc,49,8938,433,431,153,584,6
2021-08-23,Mono,51,14174,1380,1384,15,1399,3
2021-08-23,Monterey,53,433212,45258,45047,2454,47501,538
2021-08-23,Napa,55,140530,11432,11257,68,11325,85
2021-08-23,Nevada,57,99092,7135,6930,240,7170,77
2021-08-23,Orange,59,3164182,282715,280891,13337,294228,5181
2021-08-23,Placer,61,380077,29184,28540,2555,31095,314
2021-08-23,Plumas,63,18699,961,934,18,952,5
2021-08-23,Riverside,65,2383286,324683,321650,16036,337686,4598
2021-08-23,Sacramento,67,1510023,131827,128969,2999,131968,1807
2021-08-23,San Benito,69,59416,6601,6562,135,6697,64
2021-08-23,San Bernardino,71,2135413,322006,319577,10121,329698,5324
2021-08-23,San Diego,73,3302833,328775,324536,0,324536,3848
2021-08-23,San Francisco,75,870044,46456,45945,2193,48138,573
2021-08-23,San Joaquin,77,732212,84684,83466,4586,88052,1499
2021-08-23,San Luis Obispo,79,281455,24757,24317,998,25315,274
2021-08-23,San Mateo,81,765935,48407,47935,940,48875,553
2021-08-23,Santa Barbara,83,443738,38619,38181,1587,39768,478
2021-08-23,Santa Clara,85,1922200,131882,130489,1044,131533,1778
2021-08-23,Santa Cruz,87,273765,18104,17871,979,18850,209
2021-08-23,Shasta,89,179085,14972,14537,2352,16889,216
2021-08-23,Sierra,91,2930,91,90,15,105,0
2021-08-23,Siskiyou,93,43540,2362,2274,665,2939,33
2021-08-23,Solano,95,438530,39423,38612,963,39575,283
2021-08-23,Sonoma,97,501317,36317,35769,447,36216,336
2021-08-23,Stanislaus,99,539301,65019,63922,7216,71138,1058
2021-08-23,Sutter,101,95872,11553,11314,133,11447,133
2021-08-23,Tehama,103,63373,5929,5805,820,6625,67
2021-08-23,Trinity,105,12862,460,435,104,539,3
2021-08-23,Tulare,107,460477,54280,53370,11392,64762,856
2021-08-23,Tuolumne,109,53932,5403,5240,183,5423,73
2021-08-23,Ventura,111,848112,89536,88960,4058,93018,1063
2021-08-23,Yolo,113,214977,16791,16445,730,17175,226
2021-08-23,Yuba,115,75493,7845,7653,161,7814,54
2021-08-22,Alameda,1,1643700,106154,104539,2575,107114,1294
2021-08-22,Alpine,3,1148,92,91,0,91,0
2021-08-22,Amador,5,37829,4451,4349,40,4389,50
2021-08-22,Butte,7,227075,15176,14791,2599,17390,211
2021-08-22,Calaveras,9,45235,2835,2771,21,2792,59
2021-08-22,Colusa,11,21464,2237,2201,446,2647,16
2021-08-22,Contra Costa,13,1133247,85918,84371,1809,86180,857
2021-08-22,Del Norte,15,27424,2605,2455,11,2466,8
2021-08-22,El Dorado,17,186661,12834,12629,1190,13819,118
2021-08-22,Fresno,19,978130,113632,112057,10208,122265,1759
2021-08-22,Glenn,21,27897,2725,2678,687,3365,20
2021-08-22,Humboldt,23,135768,6685,6483,241,6724,52
2021-08-22,Imperial,25,180216,30110,29993,3000,32993,748
2021-08-22,Inyo,27,18085,1519,1505,5,1510,39
2021-08-22,Kern,29,883053,105789,104691,14321,119012,1375
2021-08-22,Kings,31,150075,25751,25391,1486,26877,257
2021-08-22,Lake,33,64148,5168,5069,48,5117,69
2021-08-22,Lassen,35,31185,5613,5556,148,5704,21
2021-08-22,Los Angeles,37,10098052,1331179,1324151,51956,1376107,25089
2021-08-22,Madera,39,155013,18353,18120,1273,19393,246
2021-08-22,Marin,41,260295,15995,15822,342,16164,240
2021-08-22,Mariposa,43,17540,687,638,15,653,5
2021-08-22,Mendocino,45,87422,5525,5336,176,5512,51
2021-08-22,Merced,47,269075,34627,34234,1175,35409,488
2021-08-22,Modoc,49,8938,433,431,153,584,6
2021-08-22,Mono,51,14174,1380,1378,15,1393,3
2021-08-22,Monterey,53,433212,45184,45017,2446,47463,538
2021-08-22,Napa,55,140530,11394,11231,68,11299,85
2021-08-22,Nevada,57,99092,7085,6864,239,7103,77
2021-08-22,Orange,59,3164182,282148,280390,13320,293710,5181
2021-08-22,Placer,61,380077,29005,28395,2542,30937,314
2021-08-22,Plumas,63,18699,945,923,17,940,5
2021-08-22,Riverside,65,2383286,323852,320836,15993,336829,4594
2021-08-22,Sacramento,67,1510023,131000,128231,2923,131154,1802
2021-08-22,San Benito,69,59416,6585,6550,135,6685,64
2021-08-22,San Bernardino,71,2135413,321255,318839,10098,328937,5324
2021-08-22,San Diego,73,3302833,327585,323591,0,323591,3848
2021-08-22,San Francisco,75,870044,46311,45831,2169,48000,573
2021-08-22,San Joaquin,77,732212,84283,83121,4572,87693,1498
2021-08-22,San Luis Obispo,79,281455,24569,24250,990,25240,274
2021-08-22,San Mateo,81,765935,48295,47821,936,48757,553
2021-08-22,Santa Barbara,83,443738,38503,38099,1578,39677,478
2021-08-22,Santa Clara,85,1922200,131540,130189,1039,131228,1778
2021-08-22,Santa Cruz,87,273765,18059,17823,978,18801,209
2021-08-22,Shasta,89,179085,14857,14478,2317,16795,216
2021-08-22,Sierra,91,2930,91,87,15,102,0
2021-08-22,Siskiyou,93,43540,2337,2261,641,2902,33
2021-08-22,Solano,95,438530,39227,38489,958,39447,283
2021-08-22,Sonoma,97,501317,36179,35676,443,36119,336
2021-08-22,Stanislaus,99,539301,64736,63683,7171,70854,1058
2021-08-22,Sutter,101,95872,11488,11251,131,11382,133
2021-08-22,Tehama,103,63373,5885,5791,817,6608,67
2021-08-22,Trinity,105,12862,454,433,101,534,3
2021-08-22,Tulare,107,460477,54057,53220,11328,64548,856
2021-08-22,Tuolumne,109,53932,5365,5214,181,5395,73
2021-08-22,Ventura,111,848112,89334,88791,4053,92844,1063
2021-08-22,Yolo,113,214977,16710,16374,727,17101,226
2021-08-22,Yuba,115,75493,7782,7626,158,7784,54
2021-08-21,Alameda,1,1643700,106011,104281,2571,106852,1294
2021-08-21,Alpine,3,1148,92,91,0,91,0
2021-08-21,Amador,5,37829,4443,4338,40,4378,50
2021-08-21,Butte,7,227075,15133,14714,2583,17297,211
2021-08-21,Calaveras,9,45235,2823,2744,21,2765,59
2021-08-21,Colusa,11,21464,2233,2192,444,2636,16
2021-08-21,Contra Costa,13,1133247,85701,84136,1804,85940,857
2021-08-21,Del Norte,15,27424,2588,2409,11,2420,8
2021-08-21,El Dorado,17,186661,12808,12590,1184,13774,118
2021-08-21,Fresno,19,978130,113443,111765,10199,121964,1759
2021-08-21,Glenn,21,27897,2722,2654,680,3334,20
2021-08-21,Humboldt,23,135768,6659,6446,241,6687,52
2021-08-21,Imperial,25,180216,30071,29976,3000,32976,748
2021-08-21,Inyo,27,18085,1517,1500,5,1505,39
2021-08-21,Kern,29,883053,105582,104443,14315,118758,1375
2021-08-21,Kings,31,150075,25702,25313,1485,26798,257
2021-08-21,Lake,33,64148,5150,5055,46,5101,69
2021-08-21,Lassen,35,31185,5606,5553,148,5701,21
2021-08-21,Los Angeles,37,10098052,1330241,1321308,51870,1373178,25080
2021-08-21,Madera,39,155013,18334,18067,1266,19333,246
2021-08-21,Marin,41,260295,15970,15775,342,16117,240
2021-08-21,Mariposa,43,17540,679,634,15,649,5
2021-08-21,Mendocino,45,87422,5497,5307,175,5482,51
2021-08-21,Merced,47,269075,34562,34148,1174,35322,488
2021-08-21,Modoc,49,8938,433,430,153,583,6
2021-08-21,Mono,51,14174,1380,1378,15,1393,3
2021-08-21,Monterey,53,433212,45154,44969,2444,47413,538
2021-08-21,Napa,55,140530,11361,11211,68,11279,85
2021-08-21,Nevada,57,99092,7053,6810,239,7049,77
2021-08-21,Orange,59,3164182,281818,279855,13294,293149,5181
2021-08-21,Placer,61,380077,28904,28289,2538,30827,314
2021-08-21,Plumas,63,18699,944,916,16,932,5
2021-08-21,Riverside,65,2383286,323357,320086,15978,336064,4594
2021-08-21,Sacramento,67,1510023,130615,127751,2911,130662,1809
2021-08-21,San Benito,69,59416,6576,6542,135,6677,64
2021-08-21,San Bernardino,71,2135413,320973,318293,10079,328372,5324
2021-08-21,San Diego,73,3302833,327014,322620,0,322620,3848
2021-08-21,San Francisco,75,870044,46231,45637,2163,47800,573
2021-08-21,San Joaquin,77,732212,84114,82825,4565,87390,1498
2021-08-21,San Luis Obispo,79,281455,24526,24169,989,25158,273
2021-08-21,San Mateo,81,765935,48218,47685,935,48620,553
2021-08-21,Santa Barbara,83,443738,38437,37951,1577,39528,478
2021-08-21,Santa Clara,85,1922200,131336,129911,1037,130948,1778
2021-08-21,Santa Cruz,87,273765,18033,17763,975,18738,209
2021-08-21,Shasta,89,179085,14795,14417,2316,16733,217
2021-08-21,Sierra,91,2930,91,85,15,100,0
2021-08-21,Siskiyou,93,43540,2328,2246,636,2882,33
2021-08-21,Solano,95,438530,39150,38423,956,39379,281
2021-08-21,Sonoma,97,501317,36135,35582,442,36024,336
2021-08-21,Stanislaus,99,539301,64578,63512,7159,70671,1058
2021-08-21,Sutter,101,95872,11453,11204,131,11335,133
2021-08-21,Tehama,103,63373,5870,5757,812,6569,67
2021-08-21,Trinity,105,12862,452,431,101,532,3
2021-08-21,Tulare,107,460477,53945,53045,11301,64346,857
2021-08-21,Tuolumne,109,53932,5338,5193,181,5374,73
2021-08-21,Ventura,111,848112,89213,88558,4041,92599,1063
2021-08-21,Yolo,113,214977,16678,16322,726,17048,226
2021-08-21,Yuba,115,75493,7753,7580,158,7738,54
2021-08-20,Alameda,1,1643700,105806,103812,2564,106376,1294
2021-08-20,Alpine,3,1148,92,91,0,91,0
2021-08-20,Amador,5,37829,4418,4323,40,4363,50
2021-08-20,Butte,7,227075,15064,14617,2563,17180,211
2021-08-20,Calaveras,9,45235,2809,2717,21,2738,59
2021-08-20,Colusa,11,21464,2230,2178,444,2622,16
2021-08-20,Contra Costa,13,1133247,85461,83721,1801,85522,857
2021-08-20,Del Norte,15,27424,2564,2316,11,2327,8
2021-08-20,El Dorado,17,186661,12782,12495,1177,13672,118
2021-08-20,Fresno,19,978130,113083,111315,10181,121496,1759
2021-08-20,Glenn,21,27897,2707,2642,679,3321,20
2021-08-20,Humboldt,23,135768,6618,6349,241,6590,52
2021-08-20,Imperial,25,180216,30050,29934,3000,32934,747
2021-08-20,Inyo,27,18085,1511,1495,5,1500,39
2021-08-20,Kern,29,883053,105350,104048,14298,118346,1373
2021-08-20,Kings,31,150075,25660,25241,1482,26723,256
2021-08-20,Lake,33,64148,5138,5024,46,5070,69
2021-08-20,Lassen,35,31185,5605,5539,148,5687,21
2021-08-20,Los Angeles,37,10098052,1328579,1317541,51773,1369314,25049
2021-08-20,Madera,39,155013,18290,18018,1247,19265,246
2021-08-20,Marin,41,260295,15953,15727,337,16064,240
2021-08-20,Mariposa,43,17540,673,630,15,645,5
2021-08-20,Mendocino,45,87422,5461,5241,175,5416,51
2021-08-20,Merced,47,269075,34516,34035,1172,35207,486
2021-08-20,Modoc,49,8938,433,429,153,582,6
2021-08-20,Mono,51,14174,1379,1368,15,1383,3
2021-08-20,Monterey,53,433212,45130,44890,2440,47330,538
2021-08-20,Napa,55,140530,11338,11152,68,11220,83
2021-08-20,Nevada,57,99092,7030,6753,235,6988,77
2021-08-20,Orange,59,3164182,281468,279193,13275,292468,5179
2021-08-20,Placer,61,380077,28831,28156,2529,30685,313
2021-08-20,Plumas,63,18699,937,908,16,924,5
2021-08-20,Riverside,65,2383286,322748,319072,15951,335023,4594
2021-08-20,Sacramento,67,1510023,130172,127226,2890,130116,1797
2021-08-20,San Benito,69,59416,6563,6508,135,6643,64
2021-08-20,San Bernardino,71,2135413,320498,317372,10053,327425,5322
2021-08-20,San Diego,73,3302833,326172,321102,0,321102,3846
2021-08-20,San Francisco,75,870044,46152,45432,2147,47579,573
2021-08-20,San Joaquin,77,732212,83918,82419,4556,86975,1496
2021-08-20,San Luis Obispo,79,281455,24466,23986,983,24969,273
2021-08-20,San Mateo,81,765935,48119,47561,935,48496,551
2021-08-20,Santa Barbara,83,443738,38364,37794,1573,39367,477
2021-08-20,Santa Clara,85,1922200,131072,129510,1033,130543,1774
2021-08-20,Santa Cruz,87,273765,18000,17701,973,18674,209
2021-08-20,Shasta,89,179085,14727,14277,2301,16578,215
2021-08-20,Sierra,91,2930,90,83,15,98,0
2021-08-20,Siskiyou,93,43540,2316,2226,632,2858,33
2021-08-20,Solano,95,438530,39041,38214,956,39170,277
2021-08-20,Sonoma,97,501317,36095,35416,442,35858,336
2021-08-20,Stanislaus,99,539301,64414,63219,7142,70361,1047
2021-08-20,Sutter,101,95872,11401,11136,131,11267,133
2021-08-20,Tehama,103,63373,5860,5730,807,6537,66
2021-08-20,Trinity,105,12862,452,422,101,523,3
2021-08-20,Tulare,107,460477,53840,52855,11271,64126,856
2021-08-20,Tuolumne,109,53932,5319,5153,181,5334,73
2021-08-20,Ventura,111,848112,89068,88285,4036,92321,1061
2021-08-20,Yolo,113,214977,16633,16236,723,16959,225
2021-08-20,Yuba,115,75493,7717,7523,156,7679,54
2021-08-19,Alameda,1,1643700,105415,103276,2537,105813,1294
2021-08-19,Alpine,3,1148,92,91,0,91,0
2021-08-19,Amador,5,37829,4412,4317,40,4357,50
2021-08-19,Butte,7,227075,14940,14518,2540,17058,211
2021-08-19,Calaveras,9,45235,2791,2673,21,2694,59
2021-08-19,Colusa,11,21464,2221,2167,443,2610,16
2021-08-19,Contra Costa,13,1133247,85107,83296,1795,85091,852
2021-08-19,Del Norte,15,27424,2517,2257,11,2268,8
2021-08-19,El Dorado,17,186661,12717,12410,1158,13568,118
2021-08-19,Fresno,19,978130,112636,110947,10140,121087,1759
2021-08-19,Glenn,21,27897,2682,2629,670,3299,20
2021-08-19,Humboldt,23,135768,6565,6246,238,6484,52
2021-08-19,Imperial,25,180216,30016,29865,2997,32862,747
2021-08-19,Inyo,27,18085,1504,1494,5,1499,39
2021-08-19,Kern,29,883053,104994,103731,14266,117997,1371
2021-08-19,Kings,31,150075,25560,25128,1468,26596,256
2021-08-19,Lake,33,64148,5117,4991,43,5034,69
2021-08-19,Lassen,35,31185,5590,5520,146,5666,21
2021-08-19,Los Angeles,37,10098052,1325869,1314453,51613,1366066,25020
2021-08-19,Madera,39,155013,18246,17947,1233,19180,246
2021-08-19,Marin,41,260295,15928,15672,334,16006,240
2021-08-19,Mariposa,43,17540,664,618,14,632,5
2021-08-19,Mendocino,45,87422,5428,5167,172,5339,51
2021-08-19,Merced,47,269075,34376,33851,1157,35008,486
2021-08-19,Modoc,49,8938,433,427,153,580,6
2021-08-19,Mono,51,14174,1375,1349,15,1364,3
2021-08-19,Monterey,53,433212,45075,44821,2429,47250,538
2021-08-19,Napa,55,140530,11288,11104,68,11172,83
2021-08-19,Nevada,57,99092,6974,6695,234,6929,77
2021-08-19,Orange,59,3164182,280926,278562,13242,291804,5172
2021-08-19,Placer,61,380077,28700,27953,2522,30475,313
2021-08-19,Plumas,63,18699,925,896,16,912,5
2021-08-19,Riverside,65,2383286,321820,318056,15927,333983,4589
2021-08-19,Sacramento,67,1510023,129572,126720,2847,129567,1801
2021-08-19,San Benito,69,59416,6545,6493,133,6626,64
2021-08-19,San Bernardino,71,2135413,319818,316398,10030,326428,5318
2021-08-19,San Diego,73,3302833,324980,319582,0,319582,3839
2021-08-19,San Francisco,75,870044,46004,45220,2139,47359,571
2021-08-19,San Joaquin,77,732212,83548,82047,4521,86568,1491
2021-08-19,San Luis Obispo,79,281455,24343,23878,978,24856,271
2021-08-19,San Mateo,81,765935,48015,47431,935,48366,551
2021-08-19,Santa Barbara,83,443738,38249,37693,1572,39265,477
2021-08-19,Santa Clara,85,1922200,130746,129133,1024,130157,1774
2021-08-19,Santa Cruz,87,273765,17947,17644,970,18614,209
2021-08-19,Shasta,89,179085,14611,14200,2285,16485,214
2021-08-19,Sierra,91,2930,89,83,15,98,0
2021-08-19,Siskiyou,93,43540,2303,2218,623,2841,33
2021-08-19,Solano,95,438530,38895,38025,945,38970,273
2021-08-19,Sonoma,97,501317,36029,35233,441,35674,336
2021-08-19,Stanislaus,99,539301,64136,62928,7099,70027,1047
2021-08-19,Sutter,101,95872,11324,11057,129,11186,133
2021-08-19,Tehama,103,63373,5832,5683,787,6470,66
2021-08-19,Trinity,105,12862,448,414,100,514,3
2021-08-19,Tulare,107,460477,53645,52685,11231,63916,856
2021-08-19,Tuolumne,109,53932,5285,5112,180,5292,64
2021-08-19,Ventura,111,848112,88882,88073,4013,92086,1060
2021-08-19,Yolo,113,214977,16562,16153,715,16868,225
2021-08-19,Yuba,115,75493,7673,7458,156,7614,51
2021-08-18,Alameda,1,1643700,105106,102696,2505,105201,1294
2021-08-18,Alpine,3,1148,91,91,0,91,0
2021-08-18,Amador,5,37829,4399,4279,39,4318,50
2021-08-18,Butte,7,227075,14838,14426,2509,16935,208
2021-08-18,Calaveras,9,45235,2752,2643,20,2663,59
2021-08-18,Colusa,11,21464,2213,2160,440,2600,16
2021-08-18,Contra Costa,13,1133247,84715,82767,1786,84553,851
2021-08-18,Del Norte,15,27424,2465,2219,11,2230,8
2021-08-18,El Dorado,17,186661,12647,12306,1147,13453,118
2021-08-18,Fresno,19,978130,112179,110523,10089,120612,1759
2021-08-18,Glenn,21,27897,2654,2623,660,3283,20
2021-08-18,Humboldt,23,135768,6503,6195,235,6430,52
2021-08-18,Imperial,25,180216,29989,29821,2992,32813,746
2021-08-18,Inyo,27,18085,1501,1494,5,1499,39
2021-08-18,Kern,29,883053,104677,103440,14210,117650,1370
2021-08-18,Kings,31,150075,25461,24984,1460,26444,256
2021-08-18,Lake,33,64148,5084,4957,43,5000,69
2021-08-18,Lassen,35,31185,5575,5506,142,5648,21
2021-08-18,Los Angeles,37,10098052,1323017,1311477,51470,1362947,24984
2021-08-18,Madera,39,155013,18197,17871,1221,19092,246
2021-08-18,Marin,41,260295,15889,15610,333,15943,240
2021-08-18,Mariposa,43,17540,651,615,14,629,5
2021-08-18,Mendocino,45,87422,5389,5129,170,5299,51
2021-08-18,Merced,47,269075,34212,33708,1148,34856,484
2021-08-18,Modoc,49,8938,433,427,152,579,6
2021-08-18,Mono,51,14174,1372,1344,15,1359,3
2021-08-18,Monterey,53,433212,45008,44735,2415,47150,532
2021-08-18,Napa,55,140530,11247,11060,67,11127,83
2021-08-18,Nevada,57,99092,6915,6633,234,6867,76
2021-08-18,Orange,59,3164182,280406,277795,13205,291000,5168
2021-08-18,Placer,61,380077,28541,27741,2509,30250,312
2021-08-18,Plumas,63,18699,910,874,16,890,5
2021-08-18,Riverside,65,2383286,320874,317107,15902,333009,4585
2021-08-18,Sacramento,67,1510023,128917,125599,2809,128408,1781
2021-08-18,San Benito,69,59416,6536,6481,132,6613,64
2021-08-18,San Bernardino,71,2135413,319100,315477,10017,325494,5304
2021-08-18,San Diego,73,3302833,323708,318152,0,318152,3834
2021-08-18,San Francisco,75,870044,45821,44957,2124,47081,568
2021-08-18,San Joaquin,77,732212,83198,81601,4496,86097,1491
2021-08-18,San Luis Obispo,79,281455,24200,23726,967,24693,270
2021-08-18,San Mateo,81,765935,47885,47255,934,48189,551
2021-08-18,Santa Barbara,83,443738,38140,37599,1563,39162,475
2021-08-18,Santa Clara,85,1922200,130436,128563,1021,129584,1773
2021-08-18,Santa Cruz,87,273765,17898,17566,966,18532,209
2021-08-18,Shasta,89,179085,14508,14087,2264,16351,213
2021-08-18,Sierra,91,2930,89,83,15,98,0
2021-08-18,Siskiyou,93,43540,2279,2204,616,2820,33
2021-08-18,Solano,95,438530,38761,37812,928,38740,271
2021-08-18,Sonoma,97,501317,35910,35063,439,35502,333
2021-08-18,Stanislaus,99,539301,63843,62613,7094,69707,1047
2021-08-18,Sutter,101,95872,11255,11004,125,11129,130
2021-08-18,Tehama,103,63373,5797,5653,774,6427,66
2021-08-18,Trinity,105,12862,443,409,99,508,3
2021-08-18,Tulare,107,460477,53420,52486,11172,63658,856
2021-08-18,Tuolumne,109,53932,5252,5081,180,5261,64
2021-08-18,Ventura,111,848112,88661,87835,4004,91839,1055
2021-08-18,Yolo,113,214977,16488,16047,706,16753,225
2021-08-18,Yuba,115,75493,7616,7391,155,7546,51
2021-08-17,Alameda,1,1643700,104734,102379,2489,104868,1290
2021-08-17,Alpine,3,1148,91,91,0,91,0
2021-08-17,Amador,5,37829,4372,4266,39,4305,50
2021-08-17,Butte,7,227075,14736,14357,2465,16822,206
2021-08-17,Calaveras,9,45235,2712,2624,20,2644,59
2021-08-17,Colusa,11,21464,2205,2156,437,2593,16
2021-08-17,Contra Costa,13,1133247,84352,82482,1771,84253,848
2021-08-17,Del Norte,15,27424,2415,2188,11,2199,8
2021-08-17,El Dorado,17,186661,12581,12242,1131,13373,118
2021-08-17,Fresno,19,978130,111730,110263,10043,120306,1755
2021-08-17,Glenn,21,27897,2644,2608,642,3250,20
2021-08-17,Humboldt,23,135768,6433,6155,230,6385,52
2021-08-17,Imperial,25,180216,29945,29768,2987,32755,746
2021-08-17,Inyo,27,18085,1498,1492,5,1497,39
2021-08-17,Kern,29,883053,104318,103048,14109,117157,1367
2021-08-17,Kings,31,150075,25366,24930,1451,26381,254
2021-08-17,Lake,33,64148,5051,4930,38,4968,68
2021-08-17,Lassen,35,31185,5560,5499,141,5640,21
2021-08-17,Los Angeles,37,10098052,1319790,1307999,51328,1359327,24952
2021-08-17,Madera,39,155013,18125,17838,1205,19043,246
2021-08-17,Marin,41,260295,15841,15570,332,15902,240
2021-08-17,Mariposa,43,17540,644,609,14,623,5
2021-08-17,Mendocino,45,87422,5348,5097,169,5266,51
2021-08-17,Merced,47,269075,34071,33508,1141,34649,482
2021-08-17,Modoc,49,8938,430,424,150,574,6
2021-08-17,Mono,51,14174,1366,1341,15,1356,3
2021-08-17,Monterey,53,433212,44937,44672,2402,47074,528
2021-08-17,Napa,55,140530,11210,11007,66,11073,83
2021-08-17,Nevada,57,99092,6847,6605,233,6838,75
2021-08-17,Orange,59,3164182,279847,277121,13173,290294,5164
2021-08-17,Placer,61,380077,28389,27634,2474,30108,312
2021-08-17,Plumas,63,18699,898,860,16,876,5
2021-08-17,Riverside,65,2383286,319941,316051,15872,331923,4582
2021-08-17,Sacramento,67,1510023,128219,125151,2771,127922,1774
2021-08-17,San Benito,69,59416,6523,6470,132,6602,64
2021-08-17,San Bernardino,71,2135413,318266,314402,9982,324384,5302
2021-08-17,San Diego,73,3302833,322195,317058,0,317058,3824
2021-08-17,San Francisco,75,870044,45649,44820,2113,46933,567
2021-08-17,San Joaquin,77,732212,82787,81300,4478,85778,1489
2021-08-17,San Luis Obispo,79,281455,24056,23556,963,24519,268
2021-08-17,San Mateo,81,765935,47759,47127,917,48044,551
2021-08-17,Santa Barbara,83,443738,38007,37478,1557,39035,475
2021-08-17,Santa Clara,85,1922200,130104,128354,1018,129372,1773
2021-08-17,Santa Cruz,87,273765,17821,17528,965,18493,209
2021-08-17,Shasta,89,179085,14393,14012,2244,16256,214
2021-08-17,Sierra,91,2930,88,82,15,97,0
2021-08-17,Siskiyou,93,43540,2267,2183,605,2788,33
2021-08-17,Solano,95,438530,38618,37662,913,38575,269
2021-08-17,Sonoma,97,501317,35792,34943,438,35381,333
2021-08-17,Stanislaus,99,539301,63554,62385,7068,69453,1047
2021-08-17,Sutter,101,95872,11189,10973,124,11097,130
2021-08-17,Tehama,103,63373,5747,5612,751,6363,66
2021-08-17,Trinity,105,12862,439,406,99,505,3
2021-08-17,Tulare,107,460477,53165,52362,11121,63483,856
2021-08-17,Tuolumne,109,53932,5211,5042,180,5222,64
2021-08-17,Ventura,111,848112,88429,87601,3986,91587,1053
2021-08-17,Yolo,113,214977,16404,15975,699,16674,225
2021-08-17,Yuba,115,75493,7559,7355,155,7510,51
2021-08-16,Alameda,1,1643700,104263,102052,2474,104526,1287
2021-08-16,Alpine,3,1148,91,91,0,91,0
2021-08-16,Amador,5,37829,4365,4235,39,4274,50
2021-08-16,Butte,7,227075,14636,14283,2437,16720,206
2021-08-16,Calaveras,9,45235,2656,2609,20,2629,57
2021-08-16,Colusa,11,21464,2197,2147,434,2581,16
2021-08-16,Contra Costa,13,1133247,83948,82070,1757,83827,848
2021-08-16,Del Norte,15,27424,2345,2125,11,2136,8
2021-08-16,El Dorado,17,186661,12498,12139,1113,13252,118
2021-08-16,Fresno,19,978130,111246,109623,10000,119623,1753
2021-08-16,Glenn,21,27897,2625,2593,640,3233,20
2021-08-16,Humboldt,23,135768,6364,6064,210,6274,52
2021-08-16,Imperial,25,180216,29910,29737,2975,32712,746
2021-08-16,Inyo,27,18085,1495,1490,5,1495,39
2021-08-16,Kern,29,883053,103980,102690,13973,116663,1367
2021-08-16,Kings,31,150075,25273,24817,1439,26256,254
2021-08-16,Lake,33,64148,5030,4898,37,4935,68
2021-08-16,Lassen,35,31185,5546,5481,141,5622,21
2021-08-16,Los Angeles,37,10098052,1316696,1305330,51193,1356523,24923
2021-08-16,Madera,39,155013,18064,17756,1195,18951,246
2021-08-16,Marin,41,260295,15784,15497,332,15829,239
2021-08-16,Mariposa,43,17540,627,597,14,611,5
2021-08-16,Mendocino,45,87422,5292,5037,166,5203,49
2021-08-16,Merced,47,269075,33867,33364,1139,34503,481
2021-08-16,Modoc,49,8938,428,421,149,570,5
2021-08-16,Mono,51,14174,1359,1339,15,1354,3
2021-08-16,Monterey,53,433212,44879,44595,2379,46974,527
2021-08-16,Napa,55,140530,11186,10946,66,11012,83
2021-08-16,Nevada,57,99092,6795,6535,232,6767,74
2021-08-16,Orange,59,3164182,279117,275985,13136,289121,5161
2021-08-16,Placer,61,380077,28271,27384,2441,29825,306
2021-08-16,Plumas,63,18699,888,851,16,867,5
2021-08-16,Riverside,65,2383286,318901,314774,15839,330613,4582
2021-08-16,Sacramento,67,1510023,127494,124554,2715,127269,1762
2021-08-16,San Benito,69,59416,6500,6452,132,6584,64
2021-08-16,San Bernardino,71,2135413,317373,313617,9955,323572,5301
2021-08-16,San Diego,73,3302833,320643,315348,0,315348,3824
2021-08-16,San Francisco,75,870044,45480,44681,2094,46775,567
2021-08-16,San Joaquin,77,732212,82357,81087,4457,85544,1488
2021-08-16,San Luis Obispo,79,281455,23910,23452,952,24404,265
2021-08-16,San Mateo,81,765935,47640,47024,896,47920,548
2021-08-16,Santa Barbara,83,443738,37865,37358,1553,38911,475
2021-08-16,Santa Clara,85,1922200,129694,127978,1012,128990,1773
2021-08-16,Santa Cruz,87,273765,17762,17491,958,18449,209
2021-08-16,Shasta,89,179085,14318,13862,2225,16087,211
2021-08-16,Sierra,91,2930,85,82,15,97,0
2021-08-16,Siskiyou,93,43540,2249,2169,590,2759,33
2021-08-16,Solano,95,438530,38462,37436,899,38335,263
2021-08-16,Sonoma,97,501317,35662,34844,437,35281,333
2021-08-16,Stanislaus,99,539301,63250,62033,7052,69085,1039
2021-08-16,Sutter,101,95872,11122,10902,122,11024,130
2021-08-16,Tehama,103,63373,5679,5565,743,6308,66
2021-08-16,Trinity,105,12862,434,400,97,497,3
2021-08-16,Tulare,107,460477,52937,52162,11057,63219,856
2021-08-16,Tuolumne,109,53932,5175,4984,179,5163,64
2021-08-16,Ventura,111,848112,88183,86954,3964,90918,1052
2021-08-16,Yolo,113,214977,16318,15922,693,16615,225
2021-08-16,Yuba,115,75493,7481,7314,154,7468,51
2021-08-15,Alameda,1,1643700,103818,101660,2457,104117,1287
2021-08-15,Alpine,3,1148,91,91,0,91,0
2021-08-15,Amador,5,37829,4341,4231,39,4270,49
2021-08-15,Butte,7,227075,14528,14263,2410,16673,206
2021-08-15,Calaveras,9,45235,2623,2599,20,2619,57
2021-08-15,Colusa,11,21464,2186,2140,429,2569,16
2021-08-15,Contra Costa,13,1133247,83585,81781,1741,83522,848
2021-08-15,Del Norte,15,27424,2278,2060,11,2071,8
2021-08-15,El Dorado,17,186661,12374,12057,1097,13154,118
2021-08-15,Fresno,19,978130,110752,109382,9936,119318,1753
2021-08-15,Glenn,21,27897,2606,2592,640,3232,20
2021-08-15,Humboldt,23,135768,6300,6024,206,6230,52
2021-08-15,Imperial,25,180216,29848,29711,2967,32678,746
2021-08-15,Inyo,27,18085,1494,1489,5,1494,39
2021-08-15,Kern,29,883053,103578,102524,13861,116385,1367
2021-08-15,Kings,31,150075,25142,24736,1422,26158,254
2021-08-15,Lake,33,64148,4976,4886,37,4923,68
2021-08-15,Lassen,35,31185,5536,5482,140,5622,21
2021-08-15,Los Angeles,37,10098052,1313358,1302882,51030,1353912,24918
2021-08-15,Madera,39,155013,17988,17714,1183,18897,246
2021-08-15,Marin,41,260295,15720,15461,329,15790,239
2021-08-15,Mariposa,43,17540,621,591,14,605,5
2021-08-15,Mendocino,45,87422,5241,5022,161,5183,49
2021-08-15,Merced,47,269075,33621,33305,1134,34439,481
2021-08-15,Modoc,49,8938,426,421,149,570,5
2021-08-15,Mono,51,14174,1351,1334,15,1349,3
2021-08-15,Monterey,53,433212,44774,44567,2347,46914,527
2021-08-15,Napa,55,140530,11139,10919,66,10985,83
2021-08-15,Nevada,57,99092,6725,6486,232,6718,74
2021-08-15,Orange,59,3164182,278403,275447,13102,288549,5161
2021-08-15,Placer,61,380077,28097,27220,2400,29620,306
2021-08-15,Plumas,63,18699,880,850,16,866,5
2021-08-15,Riverside,65,2383286,317801,314133,15817,329950,4582
2021-08-15,Sacramento,67,1510023,126706,123924,2685,126609,1761
2021-08-15,San Benito,69,59416,6486,6446,132,6578,64
2021-08-15,San Bernardino,71,2135413,316377,313120,9929,323049,5301
2021-08-15,San Diego,73,3302833,319226,314247,0,314247,3824
2021-08-15,San Francisco,75,870044,45267,44531,2068,46599,567
2021-08-15,San Joaquin,77,732212,81972,80832,4426,85258,1488
2021-08-15,San Luis Obispo,79,281455,23721,23404,941,24345,265
2021-08-15,San Mateo,81,765935,47505,46897,876,47773,548
2021-08-15,Santa Barbara,83,443738,37722,37276,1544,38820,475
2021-08-15,Santa Clara,85,1922200,129351,127715,1005,128720,1773
2021-08-15,Santa Cruz,87,273765,17695,17440,950,18390,209
2021-08-15,Shasta,89,179085,14232,13835,2199,16034,211
2021-08-15,Sierra,91,2930,84,82,14,96,0
2021-08-15,Siskiyou,93,43540,2231,2169,578,2747,33
2021-08-15,Solano,95,438530,38296,37320,890,38210,263
2021-08-15,Sonoma,97,501317,35509,34706,430,35136,333
2021-08-15,Stanislaus,99,539301,62913,61795,6991,68786,1039
2021-08-15,Sutter,101,95872,11030,10863,122,10985,130
2021-08-15,Tehama,103,63373,5633,5550,740,6290,66
2021-08-15,Trinity,105,12862,431,400,96,496,3
2021-08-15,Tulare,107,460477,52701,52046,11001,63047,856
2021-08-15,Tuolumne,109,53932,5137,4934,178,5112,64
2021-08-15,Ventura,111,848112,87887,86797,3951,90748,1052
2021-08-15,Yolo,113,214977,16234,15873,685,16558,225
2021-08-15,Yuba,115,75493,7408,7265,153,7418,51
2021-08-14,Alameda,1,1643700,103631,101305,2455,103760,1287
2021-08-14,Alpine,3,1148,91,91,0,91,0
2021-08-14,Amador,5,37829,4325,4206,39,4245,49
2021-08-14,Butte,7,227075,14498,14192,2398,16590,206
2021-08-14,Calaveras,9,45235,2618,2579,20,2599,57
2021-08-14,Colusa,11,21464,2177,2134,427,2561,16
2021-08-14,Contra Costa,13,1133247,83363,81458,1731,83189,848
2021-08-14,Del Norte,15,27424,2250,2015,11,2026,8
2021-08-14,El Dorado,17,186661,12346,12019,1090,13109,118
2021-08-14,Fresno,19,978130,110587,109056,9916,118972,1753
2021-08-14,Glenn,21,27897,2601,2583,639,3222,20
2021-08-14,Humboldt,23,135768,6252,5998,202,6200,52
2021-08-14,Imperial,25,180216,29824,29671,2967,32638,746
2021-08-14,Inyo,27,18085,1492,1487,5,1492,39
2021-08-14,Kern,29,883053,103407,102306,13768,116074,1367
2021-08-14,Kings,31,150075,25053,24647,1416,26063,254
2021-08-14,Lake,33,64148,4963,4850,35,4885,68
2021-08-14,Lassen,35,31185,5531,5475,139,5614,21
2021-08-14,Los Angeles,37,10098052,1311749,1299346,50893,1350239,24911
2021-08-14,Madera,39,155013,17944,17691,1178,18869,246
2021-08-14,Marin,41,260295,15688,15441,328,15769,239
2021-08-14,Mariposa,43,17540,618,584,14,598,5
2021-08-14,Mendocino,45,87422,5207,4977,158,5135,49
2021-08-14,Merced,47,269075,33575,33234,1130,34364,481
2021-08-14,Modoc,49,8938,426,421,149,570,5
2021-08-14,Mono,51,14174,1349,1332,15,1347,3
2021-08-14,Monterey,53,433212,44738,44514,2337,46851,527
2021-08-14,Napa,55,140530,11111,10878,64,10942,83
2021-08-14,Nevada,57,99092,6692,6419,231,6650,74
2021-08-14,Orange,59,3164182,277989,274732,13079,287811,5161
2021-08-14,Placer,61,380077,27967,27115,2383,29498,306
2021-08-14,Plumas,63,18699,875,849,16,865,5
2021-08-14,Riverside,65,2383286,317120,313264,15800,329064,4582
2021-08-14,Sacramento,67,1510023,126228,123438,2671,126109,1758
2021-08-14,San Benito,69,59416,6474,6428,132,6560,64
2021-08-14,San Bernardino,71,2135413,315886,312142,9909,322051,5301
2021-08-14,San Diego,73,3302833,318602,313589,0,313589,3824
2021-08-14,San Francisco,75,870044,45144,44353,2048,46401,567
2021-08-14,San Joaquin,77,732212,81772,80585,4411,84996,1488
2021-08-14,San Luis Obispo,79,281455,23664,23328,940,24268,265
2021-08-14,San Mateo,81,765935,47404,46792,864,47656,548
2021-08-14,Santa Barbara,83,443738,37632,37118,1540,38658,475
2021-08-14,Santa Clara,85,1922200,129081,127432,1000,128432,1772
2021-08-14,Santa Cruz,87,273765,17661,17384,949,18333,209
2021-08-14,Shasta,89,179085,14171,13813,2182,15995,211
2021-08-14,Sierra,91,2930,84,81,14,95,0
2021-08-14,Siskiyou,93,43540,2221,2160,570,2730,33
2021-08-14,Solano,95,438530,38216,37237,879,38116,263
2021-08-14,Sonoma,97,501317,35399,34606,428,35034,333
2021-08-14,Stanislaus,99,539301,62732,61564,6971,68535,1039
2021-08-14,Sutter,101,95872,10987,10808,121,10929,130
2021-08-14,Tehama,103,63373,5619,5530,737,6267,66
2021-08-14,Trinity,105,12862,426,399,96,495,3
2021-08-14,Tulare,107,460477,52572,51951,10956,62907,856
2021-08-14,Tuolumne,109,53932,5104,4924,178,5102,64
2021-08-14,Ventura,111,848112,87737,86569,3934,90503,1052
2021-08-14,Yolo,113,214977,16190,15815,676,16491,225
2021-08-14,Yuba,115,75493,7360,7223,153,7376,51
2021-08-13,Alameda,1,1643700,103358,100930,2445,103375,1284
2021-08-13,Alpine,3,1148,91,91,0,91,0
2021-08-13,Amador,5,37829,4298,4169,39,4208,49
2021-08-13,Butte,7,227075,14437,14100,2383,16483,206
2021-08-13,Calaveras,9,45235,2609,2564,20,2584,57
2021-08-13,Colusa,11,21464,2171,2123,424,2547,16
2021-08-13,Contra Costa,13,1133247,83070,81046,1722,82768,848
2021-08-13,Del Norte,15,27424,2209,1973,11,1984,8
2021-08-13,El Dorado,17,186661,12315,11951,1080,13031,118
2021-08-13,Fresno,19,978130,110294,108638,9897,118535,1753
2021-08-13,Glenn,21,27897,2594,2574,639,3213,20
2021-08-13,Humboldt,23,135768,6209,5882,197,6079,52
2021-08-13,Imperial,25,180216,29797,29654,2966,32620,745
2021-08-13,Inyo,27,18085,1491,1484,5,1489,39
2021-08-13,Kern,29,883053,103203,102029,13657,115686,1364
2021-08-13,Kings,31,150075,24975,24531,1412,25943,253
2021-08-13,Lake,33,64148,4942,4811,34,4845,68
2021-08-13,Lassen,35,31185,5526,5455,139,5594,21
2021-08-13,Los Angeles,37,10098052,1309560,1295406,50764,1346170,24891
2021-08-13,Madera,39,155013,17898,17614,1172,18786,246
2021-08-13,Marin,41,260295,15662,15380,328,15708,239
2021-08-13,Mariposa,43,17540,613,577,14,591,5
2021-08-13,Mendocino,45,87422,5166,4924,155,5079,49
2021-08-13,Merced,47,269075,33534,33111,1127,34238,480
2021-08-13,Modoc,49,8938,425,421,148,569,5
2021-08-13,Mono,51,14174,1346,1331,15,1346,3
2021-08-13,Monterey,53,433212,44691,44450,2330,46780,527
2021-08-13,Napa,55,140530,11071,10830,64,10894,83
2021-08-13,Nevada,57,99092,6656,6356,229,6585,74
2021-08-13,Orange,59,3164182,277519,274004,13035,287039,5159
2021-08-13,Placer,61,380077,27877,26987,2356,29343,306
2021-08-13,Plumas,63,18699,865,842,16,858,5
2021-08-13,Riverside,65,2383286,316398,312408,15773,328181,4581
2021-08-13,Sacramento,67,1510023,125751,122868,2646,125514,1758
2021-08-13,San Benito,69,59416,6468,6422,130,6552,64
2021-08-13,San Bernardino,71,2135413,315240,311378,9891,321269,5301
2021-08-13,San Diego,73,3302833,317579,312293,0,312293,3821
2021-08-13,San Francisco,75,870044,45014,44196,2025,46221,567
2021-08-13,San Joaquin,77,732212,81572,80232,4402,84634,1481
2021-08-13,San Luis Obispo,79,281455,23606,23226,937,24163,265
2021-08-13,San Mateo,81,765935,47296,46660,855,47515,548
2021-08-13,Santa Barbara,83,443738,37551,37023,1537,38560,474
2021-08-13,Santa Clara,85,1922200,128794,126958,993,127951,1769
2021-08-13,Santa Cruz,87,273765,17626,17332,942,18274,209
2021-08-13,Shasta,89,179085,14116,13698,2167,15865,211
2021-08-13,Sierra,91,2930,83,81,14,95,0
2021-08-13,Siskiyou,93,43540,2212,2147,567,2714,33
2021-08-13,Solano,95,438530,38105,37104,869,37973,264
2021-08-13,Sonoma,97,501317,35310,34464,427,34891,333
2021-08-13,Stanislaus,99,539301,62554,61294,6950,68244,1039
2021-08-13,Sutter,101,95872,10945,10751,121,10872,130
2021-08-13,Tehama,103,63373,5599,5496,736,6232,66
2021-08-13,Trinity,105,12862,423,392,96,488,3
2021-08-13,Tulare,107,460477,52474,51770,10895,62665,856
2021-08-13,Tuolumne,109,53932,5072,4899,178,5077,64
2021-08-13,Ventura,111,848112,87579,86368,3919,90287,1052
2021-08-13,Yolo,113,214977,16140,15761,668,16429,225
2021-08-13,Yuba,115,75493,7322,7184,153,7337,51
2021-08-12,Alameda,1,1643700,102874,100472,2432,102904,1284
2021-08-12,Alpine,3,1148,91,91,0,91,0
2021-08-12,Amador,5,37829,4272,4161,39,4200,49
2021-08-12,Butte,7,227075,14367,14006,2370,16376,206
2021-08-12,Calaveras,9,45235,2589,2531,20,2551,57
2021-08-12,Colusa,11,21464,2166,2111,423,2534,17
2021-08-12,Contra Costa,13,1133247,82700,80738,1713,82451,846
2021-08-12,Del Norte,15,27424,2139,1923,11,1934,8
2021-08-12,El Dorado,17,186661,12214,11880,1073,12953,118
2021-08-12,Fresno,19,978130,109880,108193,9853,118046,1753
2021-08-12,Glenn,21,27897,2584,2559,632,3191,20
2021-08-12,Humboldt,23,135768,6145,5845,194,6039,52
2021-08-12,Imperial,25,180216,29741,29585,2959,32544,745
2021-08-12,Inyo,27,18085,1489,1483,5,1488,39
2021-08-12,Kern,29,883053,102936,101698,13574,115272,1364
2021-08-12,Kings,31,150075,24889,24423,1403,25826,252
2021-08-12,Lake,33,64148,4920,4774,33,4807,68
2021-08-12,Lassen,35,31185,5506,5428,138,5566,21
2021-08-12,Los Angeles,37,10098052,1306484,1291875,50632,1342507,24874
2021-08-12,Madera,39,155013,17846,17564,1163,18727,246
2021-08-12,Marin,41,260295,15618,15277,323,15600,239
2021-08-12,Mariposa,43,17540,604,568,14,582,5
2021-08-12,Mendocino,45,87422,5136,4873,149,5022,49
2021-08-12,Merced,47,269075,33429,32960,1124,34084,480
2021-08-12,Modoc,49,8938,424,423,148,571,5
2021-08-12,Mono,51,14174,1342,1325,15,1340,3
2021-08-12,Monterey,53,433212,44631,44383,2306,46689,527
2021-08-12,Napa,55,140530,11020,10780,63,10843,83
2021-08-12,Nevada,57,99092,6599,6283,229,6512,74
2021-08-12,Orange,59,3164182,276885,273167,12985,286152,5158
2021-08-12,Placer,61,380077,27719,26856,2336,29192,306
2021-08-12,Plumas,63,18699,856,829,16,845,5
2021-08-12,Riverside,65,2383286,315441,311304,15737,327041,4575
2021-08-12,Sacramento,67,1510023,125051,122222,2613,124835,1758
2021-08-12,San Benito,69,59416,6457,6398,127,6525,64
2021-08-12,San Bernardino,71,2135413,314407,310420,9863,320283,5297
2021-08-12,San Diego,73,3302833,316255,310596,0,310596,3821
2021-08-12,San Francisco,75,870044,44839,43774,2004,45778,564
2021-08-12,San Joaquin,77,732212,81250,79945,4378,84323,1479
2021-08-12,San Luis Obispo,79,281455,23519,23101,922,24023,264
2021-08-12,San Mateo,81,765935,47169,46435,838,47273,548
2021-08-12,Santa Barbara,83,443738,37446,36881,1526,38407,473
2021-08-12,Santa Clara,85,1922200,128442,126614,987,127601,1769
2021-08-12,Santa Cruz,87,273765,17566,17261,941,18202,209
2021-08-12,Shasta,89,179085,14034,13621,2140,15761,211
2021-08-12,Sierra,91,2930,83,81,14,95,0
2021-08-12,Siskiyou,93,43540,2207,2134,557,2691,33
2021-08-12,Solano,95,438530,37964,36980,862,37842,262
2021-08-12,Sonoma,97,501317,35204,34299,427,34726,333
2021-08-12,Stanislaus,99,539301,62303,61026,6913,67939,1039
2021-08-12,Sutter,101,95872,10883,10695,119,10814,130
2021-08-12,Tehama,103,63373,5571,5462,728,6190,66
2021-08-12,Trinity,105,12862,420,386,96,482,3
2021-08-12,Tulare,107,460477,52335,51632,10848,62480,856
2021-08-12,Tuolumne,109,53932,5025,4845,176,5021,64
2021-08-12,Ventura,111,848112,87347,86106,3893,89999,1052
2021-08-12,Yolo,113,214977,16081,15686,658,16344,224
2021-08-12,Yuba,115,75493,7275,7128,152,7280,51
2021-08-11,Alameda,1,1643700,102381,100040,2427,102467,1281
2021-08-11,Alpine,3,1148,91,91,0,91,0
2021-08-11,Amador,5,37829,4251,4127,38,4165,49
2021-08-11,Butte,7,227075,14263,13905,2347,16252,206
2021-08-11,Calaveras,9,45235,2569,2505,20,2525,57
2021-08-11,Colusa,11,21464,2156,2101,421,2522,16
2021-08-11,Contra Costa,13,1133247,82306,80275,1701,81976,843
2021-08-11,Del Norte,15,27424,2083,1893,11,1904,8
2021-08-11,El Dorado,17,186661,12121,11799,1061,12860,119
2021-08-11,Fresno,19,978130,109445,107773,9819,117592,1751
2021-08-11,Glenn,21,27897,2577,2547,630,3177,20
2021-08-11,Humboldt,23,135768,6101,5765,193,5958,52
2021-08-11,Imperial,25,180216,29702,29565,2956,32521,745
2021-08-11,Inyo,27,18085,1489,1483,5,1488,39
2021-08-11,Kern,29,883053,102635,101448,13466,114914,1363
2021-08-11,Kings,31,150075,24780,24304,1393,25697,250
2021-08-11,Lake,33,64148,4886,4713,33,4746,68
2021-08-11,Lassen,35,31185,5497,5408,137,5545,21
2021-08-11,Los Angeles,37,10098052,1303243,1288238,50448,1338686,24851
2021-08-11,Madera,39,155013,17801,17511,1151,18662,245
2021-08-11,Marin,41,260295,15574,15235,322,15557,239
2021-08-11,Mariposa,43,17540,595,554,13,567,5
2021-08-11,Mendocino,45,87422,5069,4796,141,4937,49
2021-08-11,Merced,47,269075,33292,32802,1118,33920,479
2021-08-11,Modoc,49,8938,424,421,148,569,5
2021-08-11,Mono,51,14174,1339,1320,15,1335,3
2021-08-11,Monterey,53,433212,44548,44314,2279,46593,527
2021-08-11,Napa,55,140530,10973,10732,63,10795,83
2021-08-11,Nevada,57,99092,6547,6172,227,6399,74
2021-08-11,Orange,59,3164182,276079,272212,12957,285169,5155
2021-08-11,Placer,61,380077,27533,26687,2316,29003,305
2021-08-11,Plumas,63,18699,847,824,16,840,5
2021-08-11,Riverside,65,2383286,314458,310265,15705,325970,4570
2021-08-11,Sacramento,67,1510023,124328,121603,2566,124169,1757
2021-08-11,San Benito,69,59416,6444,6381,127,6508,64
2021-08-11,San Bernardino,71,2135413,313567,309498,9846,319344,5296
2021-08-11,San Diego,73,3302833,314833,309406,0,309406,3818
2021-08-11,San Francisco,75,870044,44637,43555,1994,45549,564
2021-08-11,San Joaquin,77,732212,80901,79641,4354,83995,1478
2021-08-11,San Luis Obispo,79,281455,23416,22920,916,23836,264
2021-08-11,San Mateo,81,765935,47028,46300,824,47124,548
2021-08-11,Santa Barbara,83,443738,37332,36699,1518,38217,472
2021-08-11,Santa Clara,85,1922200,128033,126301,978,127279,1769
2021-08-11,Santa Cruz,87,273765,17504,17191,938,18129,209
2021-08-11,Shasta,89,179085,13967,13546,2122,15668,211
2021-08-11,Sierra,91,2930,82,81,14,95,0
2021-08-11,Siskiyou,93,43540,2194,2124,551,2675,33
2021-08-11,Solano,95,438530,37824,36862,851,37713,262
2021-08-11,Sonoma,97,501317,35079,34188,424,34612,333
2021-08-11,Stanislaus,99,539301,61979,60767,6884,67651,1037
2021-08-11,Sutter,101,95872,10812,10628,119,10747,130
2021-08-11,Tehama,103,63373,5535,5410,712,6122,66
2021-08-11,Trinity,105,12862,418,385,96,481,3
2021-08-11,Tulare,107,460477,52170,51464,10803,62267,854
2021-08-11,Tuolumne,109,53932,4992,4794,176,4970,64
2021-08-11,Ventura,111,848112,87096,85863,3868,89731,1051
2021-08-11,Yolo,113,214977,16017,15593,648,16241,218
2021-08-11,Yuba,115,75493,7222,7063,151,7214,53
2021-08-10,Alameda,1,1643700,101998,99771,2422,102193,1281
2021-08-10,Alpine,3,1148,91,91,0,91,0
2021-08-10,Amador,5,37829,4238,4093,38,4131,49
2021-08-10,Butte,7,227075,14175,13853,2326,16179,205
2021-08-10,Calaveras,9,45235,2550,2491,18,2509,57
2021-08-10,Colusa,11,21464,2144,2088,414,2502,16
2021-08-10,Contra Costa,13,1133247,81946,80018,1687,81705,840
2021-08-10,Del Norte,15,27424,2039,1870,11,1881,8
2021-08-10,El Dorado,17,186661,12056,11734,1050,12784,117
2021-08-10,Fresno,19,978130,109025,107616,9783,117399,1747
2021-08-10,Glenn,21,27897,2567,2538,629,3167,20
2021-08-10,Humboldt,23,135768,6046,5718,190,5908,52
2021-08-10,Imperial,25,180216,29665,29522,2954,32476,745
2021-08-10,Inyo,27,18085,1489,1482,5,1487,39
2021-08-10,Kern,29,883053,102331,101254,13372,114626,1359
2021-08-10,Kings,31,150075,24661,24252,1380,25632,251
2021-08-10,Lake,33,64148,4848,4700,32,4732,67
2021-08-10,Lassen,35,31185,5481,5401,137,5538,21
2021-08-10,Los Angeles,37,10098052,1299558,1285140,50273,1335413,24821
2021-08-10,Madera,39,155013,17736,17481,1146,18627,245
2021-08-10,Marin,41,260295,15522,15194,321,15515,239
2021-08-10,Mariposa,43,17540,584,550,13,563,5
2021-08-10,Mendocino,45,87422,5025,4775,137,4912,49
2021-08-10,Merced,47,269075,33158,32721,1115,33836,477
2021-08-10,Modoc,49,8938,423,421,148,569,5
2021-08-10,Mono,51,14174,1334,1320,15,1335,3
2021-08-10,Monterey,53,433212,44499,44259,2253,46512,527
2021-08-10,Napa,55,140530,10927,10703,63,10766,83
2021-08-10,Nevada,57,99092,6484,6151,226,6377,73
2021-08-10,Orange,59,3164182,275243,271688,12921,284609,5155
2021-08-10,Placer,61,380077,27399,26561,2274,28835,305
2021-08-10,Plumas,63,18699,841,816,16,832,5
2021-08-10,Riverside,65,2383286,313364,309529,15688,325217,4564
2021-08-10,Sacramento,67,1510023,123688,121159,2531,123690,1755
2021-08-10,San Benito,69,59416,6436,6371,127,6498,64
2021-08-10,San Bernardino,71,2135413,312686,308672,9830,318502,5295
2021-08-10,San Diego,73,3302833,313212,308288,0,308288,3815
2021-08-10,San Francisco,75,870044,44440,43389,1967,45356,564
2021-08-10,San Joaquin,77,732212,80596,79391,4339,83730,1478
2021-08-10,San Luis Obispo,79,281455,23293,22776,913,23689,264
2021-08-10,San Mateo,81,765935,46883,46184,804,46988,548
2021-08-10,Santa Barbara,83,443738,37213,36574,1511,38085,472
2021-08-10,Santa Clara,85,1922200,127673,126019,970,126989,1770
2021-08-10,Santa Cruz,87,273765,17426,17142,936,18078,209
2021-08-10,Shasta,89,179085,13898,13461,2099,15560,211
2021-08-10,Sierra,91,2930,82,76,14,90,0
2021-08-10,Siskiyou,93,43540,2186,2088,543,2631,33
2021-08-10,Solano,95,438530,37701,36767,842,37609,262
2021-08-10,Sonoma,97,501317,34972,34054,422,34476,333
2021-08-10,Stanislaus,99,539301,61688,60605,6857,67462,1037
2021-08-10,Sutter,101,95872,10751,10569,119,10688,130
2021-08-10,Tehama,103,63373,5507,5392,709,6101,66
2021-08-10,Trinity,105,12862,418,384,96,480,3
2021-08-10,Tulare,107,460477,52012,51390,10763,62153,854
2021-08-10,Tuolumne,109,53932,4963,4780,175,4955,64
2021-08-10,Ventura,111,848112,86816,85714,3849,89563,1051
2021-08-10,Yolo,113,214977,15944,15568,639,16207,218
2021-08-10,Yuba,115,75493,7176,7028,151,7179,50
2021-08-09,Alameda,1,1643700,101591,99496,2416,101912,1276
2021-08-09,Alpine,3,1148,91,91,0,91,0
2021-08-09,Amador,5,37829,4214,4078,38,4116,48
2021-08-09,Butte,7,227075,14081,13813,2294,16107,205
2021-08-09,Calaveras,9,45235,2524,2472,18,2490,57
2021-08-09,Colusa,11,21464,2134,2075,406,2481,16
2021-08-09,Contra Costa,13,1133247,81582,79740,1676,81416,840
2021-08-09,Del Norte,15,27424,1972,1848,11,1859,8
2021-08-09,El Dorado,17,186661,11991,11672,1036,12708,117
2021-08-09,Fresno,19,978130,108601,107310,9761,117071,1747
2021-08-09,Glenn,21,27897,2554,2532,627,3159,20
2021-08-09,Humboldt,23,135768,5956,5632,188,5820,52
2021-08-09,Imperial,25,180216,29626,29512,2949,32461,745
2021-08-09,Inyo,27,18085,1489,1481,5,1486,39
2021-08-09,Kern,29,883053,102032,101069,13309,114378,1359
2021-08-09,Kings,31,150075,24561,24155,1365,25520,250
2021-08-09,Lake,33,64148,4818,4670,30,4700,66
2021-08-09,Lassen,35,31185,5459,5393,136,5529,21
2021-08-09,Los Angeles,37,10098052,1295634,1282891,50078,1332969,24798
2021-08-09,Madera,39,155013,17683,17429,1130,18559,245
2021-08-09,Marin,41,260295,15469,15154,320,15474,239
2021-08-09,Mariposa,43,17540,570,545,13,558,5
2021-08-09,Mendocino,45,87422,4975,4732,128,4860,49
2021-08-09,Merced,47,269075,33002,32666,1111,33777,477
2021-08-09,Modoc,49,8938,423,419,148,567,5
2021-08-09,Mono,51,14174,1331,1337,15,1352,3
2021-08-09,Monterey,53,433212,44436,44190,2228,46418,527
2021-08-09,Napa,55,140530,10891,10679,63,10742,83
2021-08-09,Nevada,57,99092,6417,6088,225,6313,73
2021-08-09,Orange,59,3164182,274256,271036,12894,283930,5153
2021-08-09,Placer,61,380077,27253,26457,2241,28698,305
2021-08-09,Plumas,63,18699,828,803,16,819,5
2021-08-09,Riverside,65,2383286,312310,308678,15667,324345,4562
2021-08-09,Sacramento,67,1510023,123073,120812,2503,123315,1748
2021-08-09,San Benito,69,59416,6419,6359,125,6484,63
2021-08-09,San Bernardino,71,2135413,311727,308038,9814,317852,5295
2021-08-09,San Diego,73,3302833,311581,306855,0,306855,3811
2021-08-09,San Francisco,75,870044,44237,43261,1947,45208,564
2021-08-09,San Joaquin,77,732212,80306,79198,4322,83520,1469
2021-08-09,San Luis Obispo,79,281455,23155,22695,905,23600,264
2021-08-09,San Mateo,81,765935,46769,46040,788,46828,548
2021-08-09,Santa Barbara,83,443738,37036,36474,1505,37979,470
2021-08-09,Santa Clara,85,1922200,127289,125791,960,126751,2187
2021-08-09,Santa Cruz,87,273765,17367,17082,935,18017,209
2021-08-09,Shasta,89,179085,13789,13397,2086,15483,210
2021-08-09,Sierra,91,2930,81,75,14,89,0
2021-08-09,Siskiyou,93,43540,2175,2047,524,2571,32
2021-08-09,Solano,95,438530,37559,36653,840,37493,262
2021-08-09,Sonoma,97,501317,34838,33933,420,34353,333
2021-08-09,Stanislaus,99,539301,61473,60410,6816,67226,1037
2021-08-09,Sutter,101,95872,10703,10525,116,10641,129
2021-08-09,Tehama,103,63373,5462,5373,705,6078,66
2021-08-09,Trinity,105,12862,417,378,95,473,3
2021-08-09,Tulare,107,460477,51858,51274,10708,61982,854
2021-08-09,Tuolumne,109,53932,4922,4745,175,4920,64
2021-08-09,Ventura,111,848112,86542,85514,3835,89349,1047
2021-08-09,Yolo,113,214977,15872,15521,619,16140,218
2021-08-09,Yuba,115,75493,7127,6994,151,7145,50
2021-08-08,Alameda,1,1643700,101185,99135,2408,101543,1276
2021-08-08,Alpine,3,1148,91,91,0,91,0
2021-08-08,Amador,5,37829,4185,4057,37,4094,48
2021-08-08,Butte,7,227075,13990,13791,2275,16066,205
2021-08-08,Calaveras,9,45235,2493,2462,18,2480,57
2021-08-08,Colusa,11,21464,2117,2070,402,2472,16
2021-08-08,Contra Costa,13,1133247,81206,79454,1669,81123,840
2021-08-08,Del Norte,15,27424,1926,1810,11,1821,8
2021-08-08,El Dorado,17,186661,11913,11631,1025,12656,117
2021-08-08,Fresno,19,978130,108218,107078,9739,116817,1747
2021-08-08,Glenn,21,27897,2545,2527,624,3151,20
2021-08-08,Humboldt,23,135768,5866,5571,188,5759,52
2021-08-08,Imperial,25,180216,29603,29485,2938,32423,745
2021-08-08,Inyo,27,18085,1489,1481,5,1486,39
2021-08-08,Kern,29,883053,101720,100909,13238,114147,1359
2021-08-08,Kings,31,150075,24449,24095,1355,25450,250
2021-08-08,Lake,33,64148,4770,4636,29,4665,66
2021-08-08,Lassen,35,31185,5446,5391,136,5527,21
2021-08-08,Los Angeles,37,10098052,1291455,1279982,49891,1329873,24793
2021-08-08,Madera,39,155013,17614,17398,1116,18514,245
2021-08-08,Marin,41,260295,15422,15124,318,15442,239
2021-08-08,Mariposa,43,17540,566,538,13,551,5
2021-08-08,Mendocino,45,87422,4914,4702,114,4816,49
2021-08-08,Merced,47,269075,32853,32634,1105,33739,477
2021-08-08,Modoc,49,8938,422,419,147,566,5
2021-08-08,Mono,51,14174,1327,1336,15,1351,3
2021-08-08,Monterey,53,433212,44375,44171,2207,46378,527
2021-08-08,Napa,55,140530,10859,10668,63,10731,83
2021-08-08,Nevada,57,99092,6337,6009,223,6232,73
2021-08-08,Orange,59,3164182,273394,270532,12858,283390,5153
2021-08-08,Placer,61,380077,27121,26332,2201,28533,305
2021-08-08,Plumas,63,18699,820,803,16,819,5
2021-08-08,Riverside,65,2383286,311231,308042,15648,323690,4562
2021-08-08,Sacramento,67,1510023,122504,120109,2486,122595,1744
2021-08-08,San Benito,69,59416,6406,6350,124,6474,63
2021-08-08,San Bernardino,71,2135413,310614,307378,9789,317167,5295
2021-08-08,San Diego,73,3302833,310258,305983,0,305983,3811
2021-08-08,San Francisco,75,870044,44021,43098,1923,45021,564
2021-08-08,San Joaquin,77,732212,79927,79002,4307,83309,1469
2021-08-08,San Luis Obispo,79,281455,22981,22668,897,23565,263
2021-08-08,San Mateo,81,765935,46639,45927,771,46698,548
2021-08-08,Santa Barbara,83,443738,36861,36417,1498,37915,470
2021-08-08,Santa Clara,85,1922200,126928,125553,955,126508,2187
2021-08-08,Santa Cruz,87,273765,17296,17035,928,17963,209
2021-08-08,Shasta,89,179085,13706,13381,2074,15455,210
2021-08-08,Sierra,91,2930,81,74,14,88,0
2021-08-08,Siskiyou,93,43540,2160,2041,520,2561,32
2021-08-08,Solano,95,438530,37434,36551,837,37388,262
2021-08-08,Sonoma,97,501317,34662,33805,419,34224,333
2021-08-08,Stanislaus,99,539301,61186,60269,6785,67054,1037
2021-08-08,Sutter,101,95872,10644,10481,115,10596,129
2021-08-08,Tehama,103,63373,5422,5359,702,6061,66
2021-08-08,Trinity,105,12862,412,378,94,472,3
2021-08-08,Tulare,107,460477,51678,51220,10659,61879,854
2021-08-08,Tuolumne,109,53932,4883,4731,175,4906,64
2021-08-08,Ventura,111,848112,86252,85382,3828,89210,1047
2021-08-08,Yolo,113,214977,15786,15477,613,16090,218
2021-08-08,Yuba,115,75493,7090,6967,151,7118,50
2021-08-07,Alameda,1,1643700,100974,98812,2405,101217,1276
2021-08-07,Alpine,3,1148,91,91,0,91,0
2021-08-07,Amador,5,37829,4170,4041,37,4078,48
2021-08-07,Butte,7,227075,13943,13714,2263,15977,205
2021-08-07,Calaveras,9,45235,2483,2446,18,2464,57
2021-08-07,Colusa,11,21464,2113,2067,395,2462,16
2021-08-07,Contra Costa,13,1133247,80986,79168,1663,80831,840
2021-08-07,Del Norte,15,27424,1894,1791,11,1802,8
2021-08-07,El Dorado,17,186661,11873,11575,1015,12590,117
2021-08-07,Fresno,19,978130,108039,106861,9733,116594,1747
2021-08-07,Glenn,21,27897,2541,2515,624,3139,20
2021-08-07,Humboldt,23,135768,5816,5510,185,5695,52
2021-08-07,Imperial,25,180216,29585,29470,2938,32408,745
2021-08-07,Inyo,27,18085,1487,1476,5,1481,39
2021-08-07,Kern,29,883053,101569,100693,13197,113890,1359
2021-08-07,Kings,31,150075,24388,24048,1349,25397,250
2021-08-07,Lake,33,64148,4749,4613,29,4642,66
2021-08-07,Lassen,35,31185,5442,5386,136,5522,21
2021-08-07,Los Angeles,37,10098052,1289516,1276853,49735,1326588,24786
2021-08-07,Madera,39,155013,17588,17366,1110,18476,245
2021-08-07,Marin,41,260295,15391,15085,316,15401,239
2021-08-07,Mariposa,43,17540,563,530,13,543,5
2021-08-07,Mendocino,45,87422,4878,4690,112,4802,49
2021-08-07,Merced,47,269075,32802,32569,1103,33672,477
2021-08-07,Modoc,49,8938,422,419,147,566,5
2021-08-07,Mono,51,14174,1325,1329,15,1344,3
2021-08-07,Monterey,53,433212,44327,44124,2198,46322,527
2021-08-07,Napa,55,140530,10838,10658,62,10720,83
2021-08-07,Nevada,57,99092,6289,5967,220,6187,73
2021-08-07,Orange,59,3164182,272837,269900,12838,282738,5153
2021-08-07,Placer,61,380077,27016,26244,2191,28435,305
2021-08-07,Plumas,63,18699,817,801,16,817,5
2021-08-07,Riverside,65,2383286,310571,307326,15639,322965,4562
2021-08-07,Sacramento,67,1510023,122177,119636,2480,122116,1744
2021-08-07,San Benito,69,59416,6396,6332,124,6456,63
2021-08-07,San Bernardino,71,2135413,310034,306663,9776,316439,5295
2021-08-07,San Diego,73,3302833,309523,304974,0,304974,3811
2021-08-07,San Francisco,75,870044,43886,42926,1895,44821,564
2021-08-07,San Joaquin,77,732212,79769,78769,4292,83061,1469
2021-08-07,San Luis Obispo,79,281455,22917,22579,896,23475,263
2021-08-07,San Mateo,81,765935,46547,45804,760,46564,548
2021-08-07,Santa Barbara,83,443738,36764,36303,1492,37795,470
2021-08-07,Santa Clara,85,1922200,126695,125196,950,126146,2188
2021-08-07,Santa Cruz,87,273765,17255,16994,926,17920,209
2021-08-07,Shasta,89,179085,13655,13361,2065,15426,210
2021-08-07,Sierra,91,2930,81,74,14,88,0
2021-08-07,Siskiyou,93,43540,2148,2039,518,2557,32
2021-08-07,Solano,95,438530,37323,36458,830,37288,262
2021-08-07,Sonoma,97,501317,34557,33716,419,34135,333
2021-08-07,Stanislaus,99,539301,61004,60093,6759,66852,1037
2021-08-07,Sutter,101,95872,10607,10447,115,10562,129
2021-08-07,Tehama,103,63373,5415,5343,697,6040,66
2021-08-07,Trinity,105,12862,408,377,93,470,3
2021-08-07,Tulare,107,460477,51595,51133,10621,61754,854
2021-08-07,Tuolumne,109,53932,4853,4721,175,4896,64
2021-08-07,Ventura,111,848112,86077,85232,3812,89044,1047
2021-08-07,Yolo,113,214977,15748,15423,606,16029,218
2021-08-07,Yuba,115,75493,7066,6937,149,7086,50
2021-08-06,Alameda,1,1643700,100706,98487,2398,100885,1275
2021-08-06,Alpine,3,1148,91,91,0,91,0
2021-08-06,Amador,5,37829,4149,4002,37,4039,48
2021-08-06,Butte,7,227075,13900,13626,2252,15878,205
2021-08-06,Calaveras,9,45235,2473,2419,18,2437,57
2021-08-06,Colusa,11,21464,2107,2045,389,2434,16
2021-08-06,Contra Costa,13,1133247,80744,78796,1657,80453,840
2021-08-06,Del Norte,15,27424,1869,1755,11,1766,8
2021-08-06,El Dorado,17,186661,11831,11498,1003,12501,117
2021-08-06,Fresno,19,978130,107802,106542,9720,116262,1747
2021-08-06,Glenn,21,27897,2531,2504,624,3128,20
2021-08-06,Humboldt,23,135768,5765,5421,182,5603,52
2021-08-06,Imperial,25,180216,29574,29404,2935,32339,745
2021-08-06,Inyo,27,18085,1484,1471,5,1476,39
2021-08-06,Kern,29,883053,101392,100427,13123,113550,1359
2021-08-06,Kings,31,150075,24332,23974,1345,25319,250
2021-08-06,Lake,33,64148,4729,4557,29,4586,66
2021-08-06,Lassen,35,31185,5422,5368,134,5502,21
2021-08-06,Los Angeles,37,10098052,1287062,1273081,49576,1322657,24772
2021-08-06,Madera,39,155013,17555,17324,1103,18427,245
2021-08-06,Marin,41,260295,15360,15051,316,15367,239
2021-08-06,Mariposa,43,17540,554,511,13,524,5
2021-08-06,Mendocino,45,87422,4836,4649,111,4760,49
2021-08-06,Merced,47,269075,32752,32456,1099,33555,477
2021-08-06,Modoc,49,8938,422,419,147,566,5
2021-08-06,Mono,51,14174,1323,1328,15,1343,3
2021-08-06,Monterey,53,433212,44270,44058,2175,46233,527
2021-08-06,Napa,55,140530,10813,10620,62,10682,83
2021-08-06,Nevada,57,99092,6234,5874,220,6094,73
2021-08-06,Orange,59,3164182,272294,269077,12820,281897,5151
2021-08-06,Placer,61,380077,26906,26086,2169,28255,305
2021-08-06,Plumas,63,18699,812,795,16,811,5
2021-08-06,Riverside,65,2383286,309864,306304,15629,321933,4562
2021-08-06,Sacramento,67,1510023,121830,119169,2460,121629,1740
2021-08-06,San Benito,69,59416,6383,6315,124,6439,63
2021-08-06,San Bernardino,71,2135413,309343,305806,9772,315578,5286
2021-08-06,San Diego,73,3302833,308516,303691,0,303691,3810
2021-08-06,San Francisco,75,870044,43756,42659,1872,44531,565
2021-08-06,San Joaquin,77,732212,79627,78405,4280,82685,1469
2021-08-06,San Luis Obispo,79,281455,22849,22472,891,23363,263
2021-08-06,San Mateo,81,765935,46440,45665,745,46410,548
2021-08-06,Santa Barbara,83,443738,36676,36208,1487,37695,470
2021-08-06,Santa Clara,85,1922200,126461,124767,946,125713,2185
2021-08-06,Santa Cruz,87,273765,17213,16924,922,17846,207
2021-08-06,Shasta,89,179085,13590,13284,2060,15344,210
2021-08-06,Sierra,91,2930,81,73,14,87,0
2021-08-06,Siskiyou,93,43540,2139,2030,514,2544,32
2021-08-06,Solano,95,438530,37226,36351,821,37172,262
2021-08-06,Sonoma,97,501317,34478,33594,418,34012,333
2021-08-06,Stanislaus,99,539301,60855,59854,6741,66595,1037
2021-08-06,Sutter,101,95872,10567,10391,115,10506,128
2021-08-06,Tehama,103,63373,5395,5325,696,6021,66
2021-08-06,Trinity,105,12862,407,371,92,463,3
2021-08-06,Tulare,107,460477,51498,51018,10581,61599,854
2021-08-06,Tuolumne,109,53932,4826,4674,175,4849,64
2021-08-06,Ventura,111,848112,85908,85046,3805,88851,1047
2021-08-06,Yolo,113,214977,15697,15299,601,15900,218
2021-08-06,Yuba,115,75493,7044,6904,149,7053,50
2021-08-05,Alameda,1,1643700,100273,98052,2394,100446,1275
2021-08-05,Alpine,3,1148,91,91,0,91,0
2021-08-05,Amador,5,37829,4129,3992,37,4029,48
2021-08-05,Butte,7,227075,13849,13564,2230,15794,206
2021-08-05,Calaveras,9,45235,2455,2397,18,2415,57
2021-08-05,Colusa,11,21464,2095,2036,386,2422,16
2021-08-05,Contra Costa,13,1133247,80395,78514,1648,80162,840
2021-08-05,Del Norte,15,27424,1842,1731,11,1742,8
2021-08-05,El Dorado,17,186661,11755,11408,992,12400,117
2021-08-05,Fresno,19,978130,107451,106219,9693,115912,1747
2021-08-05,Glenn,21,27897,2526,2494,621,3115,20
2021-08-05,Humboldt,23,135768,5693,5328,180,5508,52
2021-08-05,Imperial,25,180216,29542,29383,2931,32314,745
2021-08-05,Inyo,27,18085,1480,1468,5,1473,38
2021-08-05,Kern,29,883053,101174,100091,13042,113133,1358
2021-08-05,Kings,31,150075,24249,23906,1341,25247,249
2021-08-05,Lake,33,64148,4691,4490,27,4517,66
2021-08-05,Lassen,35,31185,5414,5344,134,5478,21
2021-08-05,Los Angeles,37,10098052,1283865,1269445,49443,1318888,24756
2021-08-05,Madera,39,155013,17519,17301,1096,18397,245
2021-08-05,Marin,41,260295,15321,15005,312,15317,239
2021-08-05,Mariposa,43,17540,543,504,12,516,5
2021-08-05,Mendocino,45,87422,4794,4597,102,4699,49
2021-08-05,Merced,47,269075,32692,32381,1095,33476,477
2021-08-05,Modoc,49,8938,421,418,147,565,5
2021-08-05,Mono,51,14174,1313,1309,15,1324,3
2021-08-05,Monterey,53,433212,44219,43992,2155,46147,527
2021-08-05,Napa,55,140530,10779,10591,60,10651,83
2021-08-05,Nevada,57,99092,6150,5778,217,5995,73
2021-08-05,Orange,59,3164182,271556,268329,12800,281129,5149
2021-08-05,Placer,61,380077,26750,25965,2139,28104,305
2021-08-05,Plumas,63,18699,802,787,15,802,5
2021-08-05,Riverside,65,2383286,308957,305415,15605,321020,4562
2021-08-05,Sacramento,67,1510023,121214,118590,2448,121038,1739
2021-08-05,San Benito,69,59416,6367,6305,124,6429,63
2021-08-05,San Bernardino,71,2135413,308528,304956,9753,314709,5284
2021-08-05,San Diego,73,3302833,307273,302220,0,302220,3806
2021-08-05,San Francisco,75,870044,43572,42301,1858,44159,564
2021-08-05,San Joaquin,77,732212,79327,78151,4272,82423,1468
2021-08-05,San Luis Obispo,79,281455,22737,22362,886,23248,263
2021-08-05,San Mateo,81,765935,46297,45554,731,46285,548
2021-08-05,Santa Barbara,83,443738,36571,36112,1484,37596,470
2021-08-05,Santa Clara,85,1922200,126168,124490,946,125436,2185
2021-08-05,Santa Cruz,87,273765,17171,16867,919,17786,207
2021-08-05,Shasta,89,179085,13534,13217,2051,15268,210
2021-08-05,Sierra,91,2930,76,73,14,87,0
2021-08-05,Siskiyou,93,43540,2120,2024,503,2527,32
2021-08-05,Solano,95,438530,37100,36250,815,37065,262
2021-08-05,Sonoma,97,501317,34368,33455,418,33873,330
2021-08-05,Stanislaus,99,539301,60632,59692,6714,66406,1037
2021-08-05,Sutter,101,95872,10513,10349,115,10464,127
2021-08-05,Tehama,103,63373,5378,5305,693,5998,66
2021-08-05,Trinity,105,12862,401,367,92,459,3
2021-08-05,Tulare,107,460477,51388,50889,10530,61419,854
2021-08-05,Tuolumne,109,53932,4796,4619,175,4794,64
2021-08-05,Ventura,111,848112,85657,84837,3790,88627,1047
2021-08-05,Yolo,113,214977,15638,15250,596,15846,218
2021-08-05,Yuba,115,75493,7004,6872,146,7018,50
2021-08-04,Alameda,1,1643700,99837,97477,2382,99859,1274
2021-08-04,Alpine,3,1148,91,91,0,91,0
2021-08-04,Amador,5,37829,4100,3962,37,3999,48
2021-08-04,Butte,7,227075,13787,13509,2211,15720,205
2021-08-04,Calaveras,9,45235,2432,2374,18,2392,57
2021-08-04,Colusa,11,21464,2084,2025,380,2405,16
2021-08-04,Contra Costa,13,1133247,79930,77966,1642,79608,840
2021-08-04,Del Norte,15,27424,1819,1701,11,1712,8
2021-08-04,El Dorado,17,186661,11687,11319,981,12300,117
2021-08-04,Fresno,19,978130,107123,105899,9667,115566,1747
2021-08-04,Glenn,21,27897,2516,2487,621,3108,20
2021-08-04,Humboldt,23,135768,5617,5271,179,5450,52
2021-08-04,Imperial,25,180216,29493,29375,2929,32304,745
2021-08-04,Inyo,27,18085,1479,1465,5,1470,38
2021-08-04,Kern,29,883053,100926,99868,12957,112825,1358
2021-08-04,Kings,31,150075,24180,23840,1335,25175,250
2021-08-04,Lake,33,64148,4659,4423,21,4444,65
2021-08-04,Lassen,35,31185,5406,5340,134,5474,21
2021-08-04,Los Angeles,37,10098052,1280418,1265788,49277,1315065,24737
2021-08-04,Madera,39,155013,17487,17251,1089,18340,245
2021-08-04,Marin,41,260295,15277,14950,311,15261,239
2021-08-04,Mariposa,43,17540,528,497,12,509,5
2021-08-04,Mendocino,45,87422,4770,4560,97,4657,49
2021-08-04,Merced,47,269075,32559,32274,1092,33366,476
2021-08-04,Modoc,49,8938,421,416,147,563,5
2021-08-04,Mono,51,14174,1310,1307,15,1322,3
2021-08-04,Monterey,53,433212,44160,43926,2138,46064,526
2021-08-04,Napa,55,140530,10748,10544,60,10604,82
2021-08-04,Nevada,57,99092,6084,5702,216,5918,73
2021-08-04,Orange,59,3164182,270719,267199,12780,279979,5146
2021-08-04,Placer,61,380077,26566,25688,2121,27809,305
2021-08-04,Plumas,63,18699,793,784,15,799,5
2021-08-04,Riverside,65,2383286,308042,304272,15588,319860,4562
2021-08-04,Sacramento,67,1510023,120538,117882,2419,120301,1736
2021-08-04,San Benito,69,59416,6352,6300,124,6424,63
2021-08-04,San Bernardino,71,2135413,307698,304164,9738,313902,5285
2021-08-04,San Diego,73,3302833,305784,301100,0,301100,3805
2021-08-04,San Francisco,75,870044,43329,41913,1842,43755,562
2021-08-04,San Joaquin,77,732212,78993,77846,4261,82107,1466
2021-08-04,San Luis Obispo,79,281455,22631,22245,880,23125,262
2021-08-04,San Mateo,81,765935,46137,45392,722,46114,548
2021-08-04,Santa Barbara,83,443738,36457,36013,1475,37488,470
2021-08-04,Santa Clara,85,1922200,125831,124127,940,125067,2183
2021-08-04,Santa Cruz,87,273765,17109,16820,914,17734,208
2021-08-04,Shasta,89,179085,13486,13134,2037,15171,211
2021-08-04,Sierra,91,2930,76,73,14,87,0
2021-08-04,Siskiyou,93,43540,2100,2010,499,2509,32
2021-08-04,Solano,95,438530,36962,36025,806,36831,262
2021-08-04,Sonoma,97,501317,34218,33311,418,33729,330
2021-08-04,Stanislaus,99,539301,60400,59396,6684,66080,1037
2021-08-04,Sutter,101,95872,10477,10294,115,10409,127
2021-08-04,Tehama,103,63373,5356,5281,688,5969,66
2021-08-04,Trinity,105,12862,399,362,89,451,3
2021-08-04,Tulare,107,460477,51282,50797,10494,61291,855
2021-08-04,Tuolumne,109,53932,4771,4584,175,4759,64
2021-08-04,Ventura,111,848112,85397,84406,3762,88168,1047
2021-08-04,Yolo,113,214977,15566,15189,585,15774,215
2021-08-04,Yuba,115,75493,6969,6827,145,6972,50
2021-08-03,Alameda,1,1643700,99476,97275,2377,99652,1270
2021-08-03,Alpine,3,1148,91,91,0,91,0
2021-08-03,Amador,5,37829,4069,3953,37,3990,48
2021-08-03,Butte,7,227075,13727,13468,2195,15663,205
2021-08-03,Calaveras,9,45235,2411,2356,18,2374,57
2021-08-03,Colusa,11,21464,2071,2023,374,2397,16
2021-08-03,Contra Costa,13,1133247,79618,77739,1635,79374,836
2021-08-03,Del Norte,15,27424,1788,1691,10,1701,8
2021-08-03,El Dorado,17,186661,11614,11255,972,12227,117
2021-08-03,Fresno,19,978130,106810,105732,9648,115380,1746
2021-08-03,Glenn,21,27897,2510,2481,618,3099,20
2021-08-03,Humboldt,23,135768,5550,5199,172,5371,52
2021-08-03,Imperial,25,180216,29469,29333,2922,32255,745
2021-08-03,Inyo,27,18085,1476,1459,5,1464,38
2021-08-03,Kern,29,883053,100669,99708,12876,112584,1358
2021-08-03,Kings,31,150075,24093,23780,1330,25110,249
2021-08-03,Lake,33,64148,4602,4408,17,4425,66
2021-08-03,Lassen,35,31185,5396,5341,134,5475,21
2021-08-03,Los Angeles,37,10098052,1276622,1262678,49097,1311775,24721
2021-08-03,Madera,39,155013,17455,17220,1075,18295,245
2021-08-03,Marin,41,260295,15233,14906,308,15214,243
2021-08-03,Mariposa,43,17540,517,495,12,507,5
2021-08-03,Mendocino,45,87422,4720,4546,95,4641,49
2021-08-03,Merced,47,269075,32484,32197,1090,33287,476
2021-08-03,Modoc,49,8938,421,416,147,563,5
2021-08-03,Mono,51,14174,1304,1303,15,1318,3
2021-08-03,Monterey,53,433212,44099,43872,2122,45994,525
2021-08-03,Napa,55,140530,10711,10527,59,10586,82
2021-08-03,Nevada,57,99092,6007,5685,215,5900,73
2021-08-03,Orange,59,3164182,270004,266649,12753,279402,5146
2021-08-03,Placer,61,380077,26422,25624,2096,27720,305
2021-08-03,Plumas,63,18699,789,779,15,794,5
2021-08-03,Riverside,65,2383286,307117,303499,15564,319063,4562
2021-08-03,Sacramento,67,1510023,120054,117591,2397,119988,1732
2021-08-03,San Benito,69,59416,6341,6284,122,6406,63
2021-08-03,San Bernardino,71,2135413,306795,303386,9721,313107,5265
2021-08-03,San Diego,73,3302833,304373,300189,0,300189,3803
2021-08-03,San Francisco,75,870044,43083,41758,1815,43573,562
2021-08-03,San Joaquin,77,732212,78724,77615,4243,81858,1461
2021-08-03,San Luis Obispo,79,281455,22496,22166,874,23040,264
2021-08-03,San Mateo,81,765935,45981,45255,700,45955,548
2021-08-03,Santa Barbara,83,443738,36349,35912,1468,37380,469
2021-08-03,Santa Clara,85,1922200,125495,123914,934,124848,2183
2021-08-03,Santa Cruz,87,273765,17047,16778,911,17689,207
2021-08-03,Shasta,89,179085,13412,13091,2028,15119,211
2021-08-03,Sierra,91,2930,76,72,14,86,0
2021-08-03,Siskiyou,93,43540,2089,1998,494,2492,32
2021-08-03,Solano,95,438530,36848,35953,793,36746,261
2021-08-03,Sonoma,97,501317,34110,33243,417,33660,330
2021-08-03,Stanislaus,99,539301,60212,59282,6664,65946,1037
2021-08-03,Sutter,101,95872,10439,10263,115,10378,127
2021-08-03,Tehama,103,63373,5331,5269,683,5952,66
2021-08-03,Trinity,105,12862,395,361,86,447,3
2021-08-03,Tulare,107,460477,51187,50729,10454,61183,854
2021-08-03,Tuolumne,109,53932,4736,4563,175,4738,64
2021-08-03,Ventura,111,848112,85167,84270,3739,88009,1046
2021-08-03,Yolo,113,214977,15492,15149,572,15721,215
2021-08-03,Yuba,115,75493,6935,6781,145,6926,50
2021-08-02,Alameda,1,1643700,98999,96954,2373,99327,1270
2021-08-02,Alpine,3,1148,91,91,0,91,0
2021-08-02,Amador,5,37829,4049,3927,37,3964,48
2021-08-02,Butte,7,227075,13653,13442,2176,15618,205
2021-08-02,Calaveras,9,45235,2381,2347,18,2365,57
2021-08-02,Colusa,11,21464,2059,2019,371,2390,16
2021-08-02,Contra Costa,13,1133247,79195,77516,1620,79136,836
2021-08-02,Del Norte,15,27424,1760,1653,10,1663,8
2021-08-02,El Dorado,17,186661,11519,11226,957,12183,116
2021-08-02,Fresno,19,978130,106521,105471,9621,115092,1744
2021-08-02,Glenn,21,27897,2498,2477,615,3092,20
2021-08-02,Humboldt,23,135768,5467,5161,170,5331,52
2021-08-02,Imperial,25,180216,29435,29302,2919,32221,743
2021-08-02,Inyo,27,18085,1470,1455,5,1460,38
2021-08-02,Kern,29,883053,100415,99556,12786,112342,1357
2021-08-02,Kings,31,150075,24024,23722,1323,25045,249
2021-08-02,Lake,33,64148,4561,4375,17,4392,66
2021-08-02,Lassen,35,31185,5374,5338,132,5470,21
2021-08-02,Los Angeles,37,10098052,1272978,1260807,48881,1309688,24705
2021-08-02,Madera,39,155013,17415,17158,1062,18220,245
2021-08-02,Marin,41,260295,15194,14859,307,15166,239
2021-08-02,Mariposa,43,17540,508,490,12,502,5
2021-08-02,Mendocino,45,87422,4680,4512,92,4604,49
2021-08-02,Merced,47,269075,32387,32163,1086,33249,474
2021-08-02,Modoc,49,8938,421,415,147,562,5
2021-08-02,Mono,51,14174,1300,1296,15,1311,3
2021-08-02,Monterey,53,433212,44041,43842,2112,45954,525
2021-08-02,Napa,55,140530,10669,10490,56,10546,82
2021-08-02,Nevada,57,99092,5936,5611,214,5825,73
2021-08-02,Orange,59,3164182,269118,266050,12717,278767,5146
2021-08-02,Placer,61,380077,26283,25516,2058,27574,306
2021-08-02,Plumas,63,18699,782,762,15,777,5
2021-08-02,Riverside,65,2383286,306184,302756,15548,318304,4562
2021-08-02,Sacramento,67,1510023,119455,117183,2376,119559,1728
2021-08-02,San Benito,69,59416,6325,6276,121,6397,63
2021-08-02,San Bernardino,71,2135413,305950,303000,9695,312695,5253
2021-08-02,San Diego,73,3302833,302910,299021,0,299021,3798
2021-08-02,San Francisco,75,870044,42822,41553,1785,43338,562
2021-08-02,San Joaquin,77,732212,78459,77447,4212,81659,1461
2021-08-02,San Luis Obispo,79,281455,22404,22093,869,22962,261
2021-08-02,San Mateo,81,765935,45826,45154,677,45831,548
2021-08-02,Santa Barbara,83,443738,36229,35851,1462,37313,469
2021-08-02,Santa Clara,85,1922200,125095,123655,926,124581,2183
2021-08-02,Santa Cruz,87,273765,16994,16746,907,17653,207
2021-08-02,Shasta,89,179085,13353,13049,2014,15063,212
2021-08-02,Sierra,91,2930,76,71,14,85,0
2021-08-02,Siskiyou,93,43540,2078,1992,480,2472,31
2021-08-02,Solano,95,438530,36643,35852,783,36635,260
2021-08-02,Sonoma,97,501317,33920,33132,413,33545,330
2021-08-02,Stanislaus,99,539301,60013,59160,6649,65809,1037
2021-08-02,Sutter,101,95872,10393,10220,115,10335,127
2021-08-02,Tehama,103,63373,5309,5260,679,5939,66
2021-08-02,Trinity,105,12862,390,359,85,444,3
2021-08-02,Tulare,107,460477,51086,50640,10383,61023,854
2021-08-02,Tuolumne,109,53932,4670,4524,175,4699,64
2021-08-02,Ventura,111,848112,84987,84143,3724,87867,1044
2021-08-02,Yolo,113,214977,15399,15072,553,15625,215
2021-08-02,Yuba,115,75493,6893,6743,145,6888,50
2021-08-01,Alameda,1,1643700,98470,96775,2367,99142,1270
2021-08-01,Alpine,3,1148,91,91,0,91,0
2021-08-01,Amador,5,37829,4013,3923,36,3959,48
2021-08-01,Butte,7,227075,13577,13406,2160,15566,205
2021-08-01,Calaveras,9,45235,2356,2341,18,2359,57
2021-08-01,Colusa,11,21464,2049,2014,369,2383,16
2021-08-01,Contra Costa,13,1133247,78760,77360,1613,78973,836
2021-08-01,Del Norte,15,27424,1730,1642,10,1652,8
2021-08-01,El Dorado,17,186661,11414,11189,947,12136,116
2021-08-01,Fresno,19,978130,106207,105339,9597,114936,1744
2021-08-01,Glenn,21,27897,2495,2476,613,3089,20
2021-08-01,Humboldt,23,135768,5392,5118,165,5283,52
2021-08-01,Imperial,25,180216,29400,29297,2915,32212,743
2021-08-01,Inyo,27,18085,1468,1454,5,1459,38
2021-08-01,Kern,29,883053,100142,99396,12711,112107,1357
2021-08-01,Kings,31,150075,23936,23700,1317,25017,249
2021-08-01,Lake,33,64148,4482,4356,17,4373,66
2021-08-01,Lassen,35,31185,5362,5336,130,5466,21
2021-08-01,Los Angeles,37,10098052,1269361,1258461,48650,1307111,24700
2021-08-01,Madera,39,155013,17361,17146,1057,18203,245
2021-08-01,Marin,41,260295,15124,14844,305,15149,239
2021-08-01,Mariposa,43,17540,500,482,12,494,5
2021-08-01,Mendocino,45,87422,4634,4476,88,4564,49
2021-08-01,Merced,47,269075,32296,32144,1082,33226,474
2021-08-01,Modoc,49,8938,420,413,147,560,5
2021-08-01,Mono,51,14174,1297,1294,15,1309,3
2021-08-01,Monterey,53,433212,43996,43808,2099,45907,525
2021-08-01,Napa,55,140530,10622,10473,54,10527,82
2021-08-01,Nevada,57,99092,5854,5561,213,5774,73
2021-08-01,Orange,59,3164182,268338,265467,12676,278143,5146
2021-08-01,Placer,61,380077,26074,25464,2029,27493,306
2021-08-01,Plumas,63,18699,775,761,15,776,5
2021-08-01,Riverside,65,2383286,305258,302256,15529,317785,4562
2021-08-01,Sacramento,67,1510023,118743,116923,2357,119280,1727
2021-08-01,San Benito,69,59416,6307,6271,121,6392,63
2021-08-01,San Bernardino,71,2135413,305047,302542,9683,312225,5248
2021-08-01,San Diego,73,3302833,301746,298002,0,298002,3798
2021-08-01,San Francisco,75,870044,42491,41432,1769,43201,562
2021-08-01,San Joaquin,77,732212,78096,77338,4184,81522,1461
2021-08-01,San Luis Obispo,79,281455,22300,22083,864,22947,261
2021-08-01,San Mateo,81,765935,45670,45036,661,45697,548
2021-08-01,Santa Barbara,83,443738,36123,35809,1458,37267,469
2021-08-01,Santa Clara,85,1922200,124689,123511,918,124429,2183
2021-08-01,Santa Cruz,87,273765,16920,16709,897,17606,207
2021-08-01,Shasta,89,179085,13286,13036,2002,15038,212
2021-08-01,Sierra,91,2930,74,71,14,85,0
2021-08-01,Siskiyou,93,43540,2072,1989,474,2463,31
2021-08-01,Solano,95,438530,36426,35800,776,36576,260
2021-08-01,Sonoma,97,501317,33730,33076,411,33487,330
2021-08-01,Stanislaus,99,539301,59774,59078,6628,65706,1037
2021-08-01,Sutter,101,95872,10338,10198,112,10310,127
2021-08-01,Tehama,103,63373,5297,5252,674,5926,66
2021-08-01,Trinity,105,12862,388,359,84,443,3
2021-08-01,Tulare,107,460477,50934,50600,10322,60922,854
2021-08-01,Tuolumne,109,53932,4632,4489,175,4664,64
2021-08-01,Ventura,111,848112,84766,84040,3710,87750,1044
2021-08-01,Yolo,113,214977,15329,15042,544,15586,215
2021-08-01,Yuba,115,75493,6854,6721,145,6866,50
2021-07-31,Alameda,1,1643700,98162,95279,2361,97640,1265
2021-07-31,Alpine,3,1148,91,89,0,89,0
2021-07-31,Amador,5,37829,3993,3877,36,3913,48
2021-07-31,Butte,7,227075,13544,13235,2139,15374,205
2021-07-31,Calaveras,9,45235,2349,2294,18,2312,57
2021-07-31,Colusa,11,21464,2043,2006,367,2373,16
2021-07-31,Contra Costa,13,1133247,78480,75866,1610,77476,832
2021-07-31,Del Norte,15,27424,1707,1576,10,1586,8
2021-07-31,El Dorado,17,186661,11361,11017,940,11957,116
2021-07-31,Fresno,19,978130,106072,104639,9593,114232,1744
2021-07-31,Glenn,21,27897,2489,2465,610,3075,20
2021-07-31,Humboldt,23,135768,5339,4978,164,5142,52
2021-07-31,Imperial,25,180216,29384,29164,2912,32076,743
2021-07-31,Inyo,27,18085,1465,1442,5,1447,38
2021-07-31,Kern,29,883053,99983,98903,12651,111554,1357
2021-07-31,Kings,31,150075,23885,23548,1312,24860,248
2021-07-31,Lake,33,64148,4459,4238,16,4254,66
2021-07-31,Lassen,35,31185,5356,5320,130,5450,21
2021-07-31,Los Angeles,37,10098052,1267249,1248545,48503,1297048,24691
2021-07-31,Madera,39,155013,17330,17058,1052,18110,245
2021-07-31,Marin,41,260295,15080,14701,304,15005,239
2021-07-31,Mariposa,43,17540,492,470,12,482,5
2021-07-31,Mendocino,45,87422,4608,4400,85,4485,49
2021-07-31,Merced,47,269075,32255,31959,1076,33035,474
2021-07-31,Modoc,49,8938,420,413,147,560,5
2021-07-31,Mono,51,14174,1296,1287,15,1302,3
2021-07-31,Monterey,53,433212,43959,43720,2090,45810,525
2021-07-31,Napa,55,140530,10604,10401,52,10453,82
2021-07-31,Nevada,57,99092,5816,5373,212,5585,72
2021-07-31,Orange,59,3164182,267779,263446,12659,276105,5144
2021-07-31,Placer,61,380077,25942,25104,2022,27126,306
2021-07-31,Plumas,63,18699,774,743,15,758,5
2021-07-31,Riverside,65,2383286,304646,300315,15519,315834,4554
2021-07-31,Sacramento,67,1510023,118345,115259,2354,117613,1720
2021-07-31,San Benito,69,59416,6296,6251,121,6372,63
2021-07-31,San Bernardino,71,2135413,304492,300726,9680,310406,5240
2021-07-31,San Diego,73,3302833,301078,295054,0,295054,3798
2021-07-31,San Francisco,75,870044,42277,40412,1744,42156,562
2021-07-31,San Joaquin,77,732212,77931,76575,4171,80746,1443
2021-07-31,San Luis Obispo,79,281455,22244,21922,862,22784,260
2021-07-31,San Mateo,81,765935,45535,44622,648,45270,548
2021-07-31,Santa Barbara,83,443738,36047,35531,1456,36987,467
2021-07-31,Santa Clara,85,1922200,124434,122614,916,123530,2099
2021-07-31,Santa Cruz,87,273765,16881,16576,896,17472,207
2021-07-31,Shasta,89,179085,13252,12918,1993,14911,212
2021-07-31,Sierra,91,2930,74,68,14,82,0
2021-07-31,Siskiyou,93,43540,2063,1976,468,2444,31
2021-07-31,Solano,95,438530,36333,35340,770,36110,263
2021-07-31,Sonoma,97,501317,33605,32601,411,33012,329
2021-07-31,Stanislaus,99,539301,59618,58586,6607,65193,1035
2021-07-31,Sutter,101,95872,10302,10068,111,10179,127
2021-07-31,Tehama,103,63373,5285,5216,673,5889,66
2021-07-31,Trinity,105,12862,387,354,83,437,3
2021-07-31,Tulare,107,460477,50853,50409,10270,60679,854
2021-07-31,Tuolumne,109,53932,4593,4362,175,4537,64
2021-07-31,Ventura,111,848112,84611,83509,3693,87202,1044
2021-07-31,Yolo,113,214977,15281,14863,534,15397,215
2021-07-31,Yuba,115,75493,6832,6615,144,6759,50
2021-07-30,Alameda,1,1643700,97835,95279,2355,97634,1265
2021-07-30,Alpine,3,1148,91,89,0,89,0
2021-07-30,Amador,5,37829,3970,3877,36,3913,48
2021-07-30,Butte,7,227075,13490,13235,2125,15360,205
2021-07-30,Calaveras,9,45235,2345,2294,18,2312,57
2021-07-30,Colusa,11,21464,2039,2006,365,2371,16
2021-07-30,Contra Costa,13,1133247,78237,75866,1606,77472,832
2021-07-30,Del Norte,15,27424,1689,1576,10,1586,8
2021-07-30,El Dorado,17,186661,11331,11017,933,11950,116
2021-07-30,Fresno,19,978130,105885,104639,9587,114226,1744
2021-07-30,Glenn,21,27897,2487,2465,610,3075,20
2021-07-30,Humboldt,23,135768,5276,4978,161,5139,52
2021-07-30,Imperial,25,180216,29370,29164,2910,32074,743
2021-07-30,Inyo,27,18085,1464,1442,5,1447,38
2021-07-30,Kern,29,883053,99856,98903,12602,111505,1357
2021-07-30,Kings,31,150075,23844,23548,1308,24856,248
2021-07-30,Lake,33,64148,4431,4238,16,4254,66
2021-07-30,Lassen,35,31185,5352,5320,130,5450,21
2021-07-30,Los Angeles,37,10098052,1264965,1248545,48346,1296891,24691
2021-07-30,Madera,39,155013,17290,17058,1048,18106,245
2021-07-30,Marin,41,260295,15046,14701,304,15005,239
2021-07-30,Mariposa,43,17540,489,470,12,482,5
2021-07-30,Mendocino,45,87422,4579,4400,84,4484,49
2021-07-30,Merced,47,269075,32220,31959,1071,33030,474
2021-07-30,Modoc,49,8938,418,413,147,560,5
2021-07-30,Mono,51,14174,1290,1287,15,1302,3
2021-07-30,Monterey,53,433212,43927,43720,2080,45800,525
2021-07-30,Napa,55,140530,10581,10401,51,10452,82
2021-07-30,Nevada,57,99092,5759,5373,212,5585,72
2021-07-30,Orange,59,3164182,267159,263446,12631,276077,5144
2021-07-30,Placer,61,380077,25855,25104,2004,27108,306
2021-07-30,Plumas,63,18699,770,743,15,758,5
2021-07-30,Riverside,65,2383286,304010,300315,15510,315825,4554
2021-07-30,Sacramento,67,1510023,117906,115259,2349,117608,1720
2021-07-30,San Benito,69,59416,6289,6251,121,6372,63
2021-07-30,San Bernardino,71,2135413,303989,300726,9676,310402,5240
2021-07-30,San Diego,73,3302833,300316,295054,0,295054,3798
2021-07-30,San Francisco,75,870044,42065,40412,1727,42139,562
2021-07-30,San Joaquin,77,732212,77778,76575,4168,80743,1443
2021-07-30,San Luis Obispo,79,281455,22211,21922,858,22780,260
2021-07-30,San Mateo,81,765935,45417,44622,631,45253,548
2021-07-30,Santa Barbara,83,443738,35982,35531,1450,36981,467
2021-07-30,Santa Clara,85,1922200,124215,122614,913,123527,2099
2021-07-30,Santa Cruz,87,273765,16855,16576,894,17470,207
2021-07-30,Shasta,89,179085,13205,12918,1993,14911,212
2021-07-30,Sierra,91,2930,73,68,14,82,0
2021-07-30,Siskiyou,93,43540,2054,1976,467,2443,31
2021-07-30,Solano,95,438530,36242,35340,754,36094,263
2021-07-30,Sonoma,97,501317,33511,32601,411,33012,329
2021-07-30,Stanislaus,99,539301,59473,58586,6587,65173,1035
2021-07-30,Sutter,101,95872,10266,10068,111,10179,127
2021-07-30,Tehama,103,63373,5275,5216,673,5889,66
2021-07-30,Trinity,105,12862,387,354,83,437,3
2021-07-30,Tulare,107,460477,50810,50409,10236,60645,854
2021-07-30,Tuolumne,109,53932,4575,4362,175,4537,64
2021-07-30,Ventura,111,848112,84452,83509,3675,87184,1044
2021-07-30,Yolo,113,214977,15220,14863,530,15393,215
2021-07-30,Yuba,115,75493,6796,6615,143,6758,50
2021-07-29,Alameda,1,1643700,97413,95279,2350,97629,1265
2021-07-29,Alpine,3,1148,91,89,0,89,0
2021-07-29,Amador,5,37829,3951,3877,36,3913,48
2021-07-29,Butte,7,227075,13443,13235,2117,15352,205
2021-07-29,Calaveras,9,45235,2325,2294,18,2312,57
2021-07-29,Colusa,11,21464,2032,2006,365,2371,16
2021-07-29,Contra Costa,13,1133247,77799,75866,1602,77468,832
2021-07-29,Del Norte,15,27424,1665,1576,10,1586,8
2021-07-29,El Dorado,17,186661,11265,11017,921,11938,116
2021-07-29,Fresno,19,978130,105628,104639,9569,114208,1744
2021-07-29,Glenn,21,27897,2481,2465,610,3075,20
2021-07-29,Humboldt,23,135768,5216,4978,159,5137,52
2021-07-29,Imperial,25,180216,29323,29164,2908,32072,743
2021-07-29,Inyo,27,18085,1460,1442,5,1447,38
2021-07-29,Kern,29,883053,99649,98903,12524,111427,1357
2021-07-29,Kings,31,150075,23801,23548,1302,24850,248
2021-07-29,Lake,33,64148,4396,4238,16,4254,66
2021-07-29,Lassen,35,31185,5344,5320,127,5447,21
2021-07-29,Los Angeles,37,10098052,1261907,1248545,48155,1296700,24691
2021-07-29,Madera,39,155013,17246,17058,1043,18101,245
2021-07-29,Marin,41,260295,15002,14701,304,15005,239
2021-07-29,Mariposa,43,17540,484,470,12,482,5
2021-07-29,Mendocino,45,87422,4556,4400,82,4482,49
2021-07-29,Merced,47,269075,32168,31959,1071,33030,474
2021-07-29,Modoc,49,8938,418,413,147,560,5
2021-07-29,Mono,51,14174,1287,1287,15,1302,3
2021-07-29,Monterey,53,433212,43879,43720,2069,45789,525
2021-07-29,Napa,55,140530,10549,10401,49,10450,82
2021-07-29,Nevada,57,99092,5706,5373,212,5585,72
2021-07-29,Orange,59,3164182,266468,263446,12601,276047,5144
2021-07-29,Placer,61,380077,25735,25104,1988,27092,306
2021-07-29,Plumas,63,18699,762,743,15,758,5
2021-07-29,Riverside,65,2383286,303307,300315,15489,315804,4554
2021-07-29,Sacramento,67,1510023,117356,115259,2337,117596,1720
2021-07-29,San Benito,69,59416,6278,6251,121,6372,63
2021-07-29,San Bernardino,71,2135413,303381,300726,9667,310393,5240
2021-07-29,San Diego,73,3302833,299264,295054,0,295054,3798
2021-07-29,San Francisco,75,870044,41822,40412,1702,42114,562
2021-07-29,San Joaquin,77,732212,77522,76575,4162,80737,1443
2021-07-29,San Luis Obispo,79,281455,22156,21922,856,22778,260
2021-07-29,San Mateo,81,765935,45294,44622,619,45241,548
2021-07-29,Santa Barbara,83,443738,35898,35531,1448,36979,467
2021-07-29,Santa Clara,85,1922200,123919,122614,910,123524,2099
2021-07-29,Santa Cruz,87,273765,16803,16576,891,17467,207
2021-07-29,Shasta,89,179085,13153,12918,1984,14902,212
2021-07-29,Sierra,91,2930,73,68,14,82,0
2021-07-29,Siskiyou,93,43540,2050,1976,465,2441,31
2021-07-29,Solano,95,438530,36090,35340,743,36083,263
2021-07-29,Sonoma,97,501317,33338,32601,409,33010,329
2021-07-29,Stanislaus,99,539301,59299,58586,6569,65155,1035
2021-07-29,Sutter,101,95872,10221,10068,110,10178,127
2021-07-29,Tehama,103,63373,5265,5216,667,5883,66
2021-07-29,Trinity,105,12862,385,354,82,436,3
2021-07-29,Tulare,107,460477,50725,50409,10195,60604,854
2021-07-29,Tuolumne,109,53932,4539,4362,174,4536,64
2021-07-29,Ventura,111,848112,84286,83509,3667,87176,1044
2021-07-29,Yolo,113,214977,15153,14863,517,15380,215
2021-07-29,Yuba,115,75493,6748,6615,142,6757,50
2021-07-28,Alameda,1,1643700,96940,94965,2342,97307,1262
2021-07-28,Alpine,3,1148,91,89,0,89,0
2021-07-28,Amador,5,37829,3936,3870,36,3906,48
2021-07-28,Butte,7,227075,13389,13184,2104,15288,205
2021-07-28,Calaveras,9,45235,2311,2289,18,2307,57
2021-07-28,Colusa,11,21464,2028,2001,364,2365,16
2021-07-28,Contra Costa,13,1133247,77315,75487,1595,77082,832
2021-07-28,Del Norte,15,27424,1634,1545,10,1555,8
2021-07-28,El Dorado,17,186661,11216,10967,911,11878,116
2021-07-28,Fresno,19,978130,105391,104458,9549,114007,1744
2021-07-28,Glenn,21,27897,2477,2464,607,3071,20
2021-07-28,Humboldt,23,135768,5162,4946,158,5104,52
2021-07-28,Imperial,25,180216,29276,29096,2908,32004,743
2021-07-28,Inyo,27,18085,1454,1439,4,1443,38
2021-07-28,Kern,29,883053,99495,98781,12473,111254,1352
2021-07-28,Kings,31,150075,23736,23503,1292,24795,248
2021-07-28,Lake,33,64148,4349,4191,14,4205,65
2021-07-28,Lassen,35,31185,5336,5318,127,5445,21
2021-07-28,Los Angeles,37,10098052,1258775,1245485,47973,1293458,24673
2021-07-28,Madera,39,155013,17205,17024,1037,18061,245
2021-07-28,Marin,41,260295,14949,14652,304,14956,239
2021-07-28,Mariposa,43,17540,477,469,12,481,5
2021-07-28,Mendocino,45,87422,4528,4377,82,4459,49
2021-07-28,Merced,47,269075,32104,31886,1067,32953,474
2021-07-28,Modoc,49,8938,416,413,147,560,5
2021-07-28,Mono,51,14174,1287,1286,15,1301,3
2021-07-28,Monterey,53,433212,43831,43668,2059,45727,524
2021-07-28,Napa,55,140530,10509,10376,47,10423,82
2021-07-28,Nevada,57,99092,5652,5320,212,5532,72
2021-07-28,Orange,59,3164182,265704,262735,12578,275313,5143
2021-07-28,Placer,61,380077,25594,24978,1973,26951,306
2021-07-28,Plumas,63,18699,759,754,15,769,5
2021-07-28,Riverside,65,2383286,302542,299611,15468,315079,4554
2021-07-28,Sacramento,67,1510023,116712,114665,2315,116980,1714
2021-07-28,San Benito,69,59416,6267,6236,121,6357,63
2021-07-28,San Bernardino,71,2135413,302762,300121,9657,309778,5236
2021-07-28,San Diego,73,3302833,298002,294176,0,294176,3798
2021-07-28,San Francisco,75,870044,41489,40144,1675,41819,561
2021-07-28,San Joaquin,77,732212,77274,76312,4131,80443,1443
2021-07-28,San Luis Obispo,79,281455,22096,21865,855,22720,260
2021-07-28,San Mateo,81,765935,45150,44477,608,45085,547
2021-07-28,Santa Barbara,83,443738,35823,35431,1443,36874,467
2021-07-28,Santa Clara,85,1922200,123657,122345,908,123253,2099
2021-07-28,Santa Cruz,87,273765,16765,16551,890,17441,207
2021-07-28,Shasta,89,179085,13108,12882,1971,14853,212
2021-07-28,Sierra,91,2930,69,67,14,81,0
2021-07-28,Siskiyou,93,43540,2041,1971,462,2433,31
2021-07-28,Solano,95,438530,35921,35204,735,35939,262
2021-07-28,Sonoma,97,501317,33195,32434,406,32840,328
2021-07-28,Stanislaus,99,539301,59103,58427,6554,64981,1035
2021-07-28,Sutter,101,95872,10189,10033,109,10142,126
2021-07-28,Tehama,103,63373,5254,5209,663,5872,66
2021-07-28,Trinity,105,12862,384,352,82,434,3
2021-07-28,Tulare,107,460477,50638,50363,10154,60517,854
2021-07-28,Tuolumne,109,53932,4501,4313,174,4487,64
2021-07-28,Ventura,111,848112,84093,83360,3649,87009,1043
2021-07-28,Yolo,113,214977,15085,14801,510,15311,215
2021-07-28,Yuba,115,75493,6715,6591,142,6733,51
2021-07-27,Alameda,1,1643700,96529,94682,2332,97014,1256
2021-07-27,Alpine,3,1148,91,89,0,89,0
2021-07-27,Amador,5,37829,3921,3861,36,3897,48
2021-07-27,Butte,7,227075,13343,13127,2093,15220,205
2021-07-27,Calaveras,9,45235,2300,2280,18,2298,57
2021-07-27,Colusa,11,21464,2020,1999,363,2362,16
2021-07-27,Contra Costa,13,1133247,76826,75227,1591,76818,830
2021-07-27,Del Norte,15,27424,1614,1538,10,1548,8
2021-07-27,El Dorado,17,186661,11156,10941,901,11842,116
2021-07-27,Fresno,19,978130,105105,104288,9529,113817,1746
2021-07-27,Glenn,21,27897,2472,2460,605,3065,20
2021-07-27,Humboldt,23,135768,5109,4925,157,5082,52
2021-07-27,Imperial,25,180216,29231,29048,2907,31955,743
2021-07-27,Inyo,27,18085,1452,1430,4,1434,38
2021-07-27,Kern,29,883053,99330,98724,12414,111138,1352
2021-07-27,Kings,31,150075,23681,23463,1281,24744,248
2021-07-27,Lake,33,64148,4311,4157,14,4171,65
2021-07-27,Lassen,35,31185,5330,5315,127,5442,21
2021-07-27,Los Angeles,37,10098052,1255377,1243336,47798,1291134,24658
2021-07-27,Madera,39,155013,17154,16998,1032,18030,245
2021-07-27,Marin,41,260295,14902,14631,301,14932,239
2021-07-27,Mariposa,43,17540,473,468,12,480,5
2021-07-27,Mendocino,45,87422,4504,4371,82,4453,49
2021-07-27,Merced,47,269075,32043,31825,1063,32888,473
2021-07-27,Modoc,49,8938,415,413,147,560,5
2021-07-27,Mono,51,14174,1283,1288,15,1303,3
2021-07-27,Monterey,53,433212,43791,43646,2051,45697,523
2021-07-27,Napa,55,140530,10480,10354,47,10401,82
2021-07-27,Nevada,57,99092,5576,5305,210,5515,72
2021-07-27,Orange,59,3164182,264982,262193,12556,274749,5143
2021-07-27,Placer,61,380077,25435,24916,1947,26863,306
2021-07-27,Plumas,63,18699,757,752,15,767,5
2021-07-27,Riverside,65,2383286,301810,299160,15451,314611,4554
2021-07-27,Sacramento,67,1510023,116116,114413,2304,116717,1710
2021-07-27,San Benito,69,59416,6258,6229,121,6350,63
2021-07-27,San Bernardino,71,2135413,302078,299593,9635,309228,5236
2021-07-27,San Diego,73,3302833,296920,293408,0,293408,3798
2021-07-27,San Francisco,75,870044,41133,39939,1656,41595,561
2021-07-27,San Joaquin,77,732212,77016,76166,4111,80277,1442
2021-07-27,San Luis Obispo,79,281455,22042,21803,845,22648,260
2021-07-27,San Mateo,81,765935,45001,44378,603,44981,547
2021-07-27,Santa Barbara,83,443738,35724,35355,1441,36796,467
2021-07-27,Santa Clara,85,1922200,123370,122154,906,123060,2099
2021-07-27,Santa Cruz,87,273765,16719,16523,889,17412,207
2021-07-27,Shasta,89,179085,13060,12846,1959,14805,212
2021-07-27,Sierra,91,2930,69,65,14,79,0
2021-07-27,Siskiyou,93,43540,2036,1964,459,2423,31
2021-07-27,Solano,95,438530,35796,35093,725,35818,261
2021-07-27,Sonoma,97,501317,33051,32367,404,32771,328
2021-07-27,Stanislaus,99,539301,58932,58333,6539,64872,1033
2021-07-27,Sutter,101,95872,10148,9998,109,10107,115
2021-07-27,Tehama,103,63373,5233,5192,662,5854,66
2021-07-27,Trinity,105,12862,383,351,82,433,3
2021-07-27,Tulare,107,460477,50572,50324,10122,60446,854
2021-07-27,Tuolumne,109,53932,4449,4282,174,4456,64
2021-07-27,Ventura,111,848112,83886,83189,3635,86824,1043
2021-07-27,Yolo,113,214977,15012,14759,504,15263,215
2021-07-27,Yuba,115,75493,6693,6564,140,6704,51
2021-07-26,Alameda,1,1643700,96076,94436,2325,96761,1259
2021-07-26,Alpine,3,1148,91,89,0,89,0
2021-07-26,Amador,5,37829,3911,3854,36,3890,48
2021-07-26,Butte,7,227075,13290,13082,2080,15162,203
2021-07-26,Calaveras,9,45235,2295,2276,18,2294,57
2021-07-26,Colusa,11,21464,2013,1996,361,2357,16
2021-07-26,Contra Costa,13,1133247,76326,74854,1584,76438,830
2021-07-26,Del Norte,15,27424,1594,1530,10,1540,8
2021-07-26,El Dorado,17,186661,11095,10899,898,11797,116
2021-07-26,Fresno,19,978130,104908,104143,9513,113656,1742
2021-07-26,Glenn,21,27897,2471,2461,603,3064,20
2021-07-26,Humboldt,23,135768,5070,4906,155,5061,52
2021-07-26,Imperial,25,180216,29190,29034,2907,31941,743
2021-07-26,Inyo,27,18085,1447,1429,4,1433,38
2021-07-26,Kern,29,883053,99167,98633,12347,110980,1351
2021-07-26,Kings,31,150075,23632,23426,1277,24703,247
2021-07-26,Lake,33,64148,4290,4133,14,4147,65
2021-07-26,Lassen,35,31185,5325,5314,127,5441,21
2021-07-26,Los Angeles,37,10098052,1252076,1241527,47633,1289160,24647
2021-07-26,Madera,39,155013,17127,16971,1024,17995,245
2021-07-26,Marin,41,260295,14844,14579,300,14879,239
2021-07-26,Mariposa,43,17540,473,467,12,479,5
2021-07-26,Mendocino,45,87422,4484,4354,82,4436,49
2021-07-26,Merced,47,269075,31961,31774,1061,32835,473
2021-07-26,Modoc,49,8938,415,413,147,560,5
2021-07-26,Mono,51,14174,1282,1286,15,1301,3
2021-07-26,Monterey,53,433212,43748,43595,2037,45632,521
2021-07-26,Napa,55,140530,10458,10332,47,10379,82
2021-07-26,Nevada,57,99092,5489,5280,210,5490,72
2021-07-26,Orange,59,3164182,264359,261803,12534,274337,5142
2021-07-26,Placer,61,380077,25304,24842,1927,26769,304
2021-07-26,Plumas,63,18699,753,750,15,765,5
2021-07-26,Riverside,65,2383286,301121,298626,15436,314062,4553
2021-07-26,Sacramento,67,1510023,115533,113986,2285,116271,1705
2021-07-26,San Benito,69,59416,6252,6222,121,6343,63
2021-07-26,San Bernardino,71,2135413,301479,299238,9621,308859,5237
2021-07-26,San Diego,73,3302833,295815,292688,0,292688,3793
2021-07-26,San Francisco,75,870044,40783,39800,1626,41426,561
2021-07-26,San Joaquin,77,732212,76782,76033,4107,80140,1440
2021-07-26,San Luis Obispo,79,281455,21993,21752,842,22594,260
2021-07-26,San Mateo,81,765935,44852,44297,592,44889,547
2021-07-26,Santa Barbara,83,443738,35652,35311,1429,36740,467
2021-07-26,Santa Clara,85,1922200,123060,121978,897,122875,2099
2021-07-26,Santa Cruz,87,273765,16680,16493,886,17379,207
2021-07-26,Shasta,89,179085,13011,12819,1944,14763,211
2021-07-26,Sierra,91,2930,68,65,14,79,0
2021-07-26,Siskiyou,93,43540,2033,1962,457,2419,31
2021-07-26,Solano,95,438530,35648,34990,716,35706,259
2021-07-26,Sonoma,97,501317,32917,32283,402,32685,328
2021-07-26,Stanislaus,99,539301,58787,58219,6525,64744,1033
2021-07-26,Sutter,101,95872,10108,9963,106,10069,115
2021-07-26,Tehama,103,63373,5223,5183,658,5841,66
2021-07-26,Trinity,105,12862,383,351,81,432,3
2021-07-26,Tulare,107,460477,50507,50265,10089,60354,854
2021-07-26,Tuolumne,109,53932,4417,4271,174,4445,64
2021-07-26,Ventura,111,848112,83714,83072,3619,86691,1041
2021-07-26,Yolo,113,214977,14953,14727,491,15218,215
2021-07-26,Yuba,115,75493,6658,6538,139,6677,51
2021-07-25,Alameda,1,1643700,95587,94146,2319,96465,1259
2021-07-25,Alpine,3,1148,89,89,0,89,0
2021-07-25,Amador,5,37829,3896,3848,36,3884,48
2021-07-25,Butte,7,227075,13251,13074,2070,15144,203
2021-07-25,Calaveras,9,45235,2284,2275,18,2293,57
2021-07-25,Colusa,11,21464,2004,1996,357,2353,16
2021-07-25,Contra Costa,13,1133247,75841,74634,1570,76204,830
2021-07-25,Del Norte,15,27424,1574,1526,10,1536,8
2021-07-25,El Dorado,17,186661,11039,10878,895,11773,116
2021-07-25,Fresno,19,978130,104670,104019,9499,113518,1742
2021-07-25,Glenn,21,27897,2464,2461,601,3062,20
2021-07-25,Humboldt,23,135768,5011,4892,153,5045,52
2021-07-25,Imperial,25,180216,29154,29037,2907,31944,743
2021-07-25,Inyo,27,18085,1442,1427,4,1431,38
2021-07-25,Kern,29,883053,98996,98503,12274,110777,1351
2021-07-25,Kings,31,150075,23579,23396,1273,24669,247
2021-07-25,Lake,33,64148,4236,4109,13,4122,65
2021-07-25,Lassen,35,31185,5321,5314,127,5441,21
2021-07-25,Los Angeles,37,10098052,1248695,1239596,47455,1287051,24643
2021-07-25,Madera,39,155013,17093,16947,1017,17964,245
2021-07-25,Marin,41,260295,14794,14558,297,14855,239
2021-07-25,Mariposa,43,17540,471,465,12,477,5
2021-07-25,Mendocino,45,87422,4454,4335,80,4415,49
2021-07-25,Merced,47,269075,31888,31760,1060,32820,473
2021-07-25,Modoc,49,8938,415,413,147,560,5
2021-07-25,Mono,51,14174,1280,1286,15,1301,3
2021-07-25,Monterey,53,433212,43709,43590,2029,45619,521
2021-07-25,Napa,55,140530,10421,10316,46,10362,82
2021-07-25,Nevada,57,99092,5424,5256,207,5463,72
2021-07-25,Orange,59,3164182,263669,261351,12511,273862,5142
2021-07-25,Placer,61,380077,25189,24755,1904,26659,304
2021-07-25,Plumas,63,18699,752,750,15,765,5
2021-07-25,Riverside,65,2383286,300355,298181,15423,313604,4553
2021-07-25,Sacramento,67,1510023,114994,113611,2267,115878,1704
2021-07-25,San Benito,69,59416,6245,6217,121,6338,63
2021-07-25,San Bernardino,71,2135413,300838,298982,9616,308598,5237
2021-07-25,San Diego,73,3302833,294747,290626,0,290626,3793
2021-07-25,San Francisco,75,870044,40446,39663,1599,41262,561
2021-07-25,San Joaquin,77,732212,76531,75926,4087,80013,1440
2021-07-25,San Luis Obispo,79,281455,21922,21741,839,22580,260
2021-07-25,San Mateo,81,765935,44695,44189,586,44775,547
2021-07-25,Santa Barbara,83,443738,35575,35261,1426,36687,467
2021-07-25,Santa Clara,85,1922200,122735,121800,891,122691,2099
2021-07-25,Santa Cruz,87,273765,16633,16474,884,17358,207
2021-07-25,Shasta,89,179085,12964,12815,1935,14750,211
2021-07-25,Sierra,91,2930,68,65,14,79,0
2021-07-25,Siskiyou,93,43540,2025,1963,454,2417,31
2021-07-25,Solano,95,438530,35464,34863,713,35576,259
2021-07-25,Sonoma,97,501317,32790,32202,399,32601,328
2021-07-25,Stanislaus,99,539301,58621,58154,6522,64676,1033
2021-07-25,Sutter,101,95872,10055,9937,104,10041,115
2021-07-25,Tehama,103,63373,5207,5181,657,5838,66
2021-07-25,Trinity,105,12862,381,351,79,430,3
2021-07-25,Tulare,107,460477,50432,50221,10048,60269,854
2021-07-25,Tuolumne,109,53932,4365,4267,174,4441,64
2021-07-25,Ventura,111,848112,83506,82986,3592,86578,1041
2021-07-25,Yolo,113,214977,14895,14693,475,15168,215
2021-07-25,Yuba,115,75493,6626,6519,139,6658,51
2021-07-24,Alameda,1,1643700,95317,93170,2314,95484,1259
2021-07-24,Alpine,3,1148,89,89,0,89,0
2021-07-24,Amador,5,37829,3887,3816,36,3852,48
2021-07-24,Butte,7,227075,13221,12982,2068,15050,203
2021-07-24,Calaveras,9,45235,2280,2267,18,2285,57
2021-07-24,Colusa,11,21464,2003,1992,355,2347,16
2021-07-24,Contra Costa,13,1133247,75616,73682,1567,75249,830
2021-07-24,Del Norte,15,27424,1563,1497,10,1507,8
2021-07-24,El Dorado,17,186661,11006,10773,891,11664,116
2021-07-24,Fresno,19,978130,104554,103637,9492,113129,1736
2021-07-24,Glenn,21,27897,2463,2457,601,3058,20
2021-07-24,Humboldt,23,135768,4978,4780,152,4932,52
2021-07-24,Imperial,25,180216,29134,28996,2907,31903,742
2021-07-24,Inyo,27,18085,1439,1424,4,1428,38
2021-07-24,Kern,29,883053,98917,98261,12251,110512,1350
2021-07-24,Kings,31,150075,23548,23304,1270,24574,246
2021-07-24,Lake,33,64148,4213,3963,13,3976,64
2021-07-24,Lassen,35,31185,5320,5311,127,5438,21
2021-07-24,Los Angeles,37,10098052,1246947,1232164,47332,1279496,24623
2021-07-24,Madera,39,155013,17069,16885,1015,17900,245
2021-07-24,Marin,41,260295,14757,14454,297,14751,238
2021-07-24,Mariposa,43,17540,471,453,12,465,5
2021-07-24,Mendocino,45,87422,4429,4293,80,4373,49
2021-07-24,Merced,47,269075,31866,31661,1059,32720,473
2021-07-24,Modoc,49,8938,415,413,147,560,5
2021-07-24,Mono,51,14174,1278,1284,15,1299,3
2021-07-24,Monterey,53,433212,43684,43525,2022,45547,521
2021-07-24,Napa,55,140530,10405,10230,46,10276,81
2021-07-24,Nevada,57,99092,5392,5183,207,5390,72
2021-07-24,Orange,59,3164182,263210,259973,12498,272471,5141
2021-07-24,Placer,61,380077,25106,24530,1899,26429,303
2021-07-24,Plumas,63,18699,751,737,15,752,4
2021-07-24,Riverside,65,2383286,299888,296912,15413,312325,4552
2021-07-24,Sacramento,67,1510023,114685,112438,2263,114701,1698
2021-07-24,San Benito,69,59416,6241,6200,120,6320,63
2021-07-24,San Bernardino,71,2135413,300451,297899,9609,307508,5236
2021-07-24,San Diego,73,3302833,294283,289368,0,289368,3788
2021-07-24,San Francisco,75,870044,40284,38954,1582,40536,561
2021-07-24,San Joaquin,77,732212,76404,75461,4076,79537,1436
2021-07-24,San Luis Obispo,79,281455,21893,21616,837,22453,260
2021-07-24,San Mateo,81,765935,44579,43880,580,44460,542
2021-07-24,Santa Barbara,83,443738,35518,35071,1421,36492,465
2021-07-24,Santa Clara,85,1922200,122526,121092,890,121982,2099
2021-07-24,Santa Cruz,87,273765,16611,16416,884,17300,207
2021-07-24,Shasta,89,179085,12936,12759,1932,14691,211
2021-07-24,Sierra,91,2930,67,64,14,78,0
2021-07-24,Siskiyou,93,43540,2025,1951,454,2405,31
2021-07-24,Solano,95,438530,35372,34499,704,35203,259
2021-07-24,Sonoma,97,501317,32667,31928,397,32325,327
2021-07-24,Stanislaus,99,539301,58529,57879,6509,64388,1030
2021-07-24,Sutter,101,95872,10029,9890,104,9994,115
2021-07-24,Tehama,103,63373,5200,5166,655,5821,65
2021-07-24,Trinity,105,12862,381,345,79,424,3
2021-07-24,Tulare,107,460477,50390,50104,10030,60134,854
2021-07-24,Tuolumne,109,53932,4339,4216,174,4390,64
2021-07-24,Ventura,111,848112,83384,82687,3579,86266,1041
2021-07-24,Yolo,113,214977,14860,14557,472,15029,214
2021-07-24,Yuba,115,75493,6607,6449,139,6588,51
2021-07-23,Alameda,1,1643700,95068,93170,2309,95479,1259
2021-07-23,Alpine,3,1148,89,89,0,89,0
2021-07-23,Amador,5,37829,3880,3816,36,3852,48
2021-07-23,Butte,7,227075,13192,12982,2060,15042,203
2021-07-23,Calaveras,9,45235,2278,2267,18,2285,57
2021-07-23,Colusa,11,21464,2002,1992,355,2347,16
2021-07-23,Contra Costa,13,1133247,75358,73682,1557,75239,830
2021-07-23,Del Norte,15,27424,1555,1497,10,1507,8
2021-07-23,El Dorado,17,186661,10979,10773,887,11660,116
2021-07-23,Fresno,19,978130,104426,103637,9484,113121,1736
2021-07-23,Glenn,21,27897,2462,2457,598,3055,20
2021-07-23,Humboldt,23,135768,4958,4780,150,4930,52
2021-07-23,Imperial,25,180216,29122,28996,2907,31903,742
2021-07-23,Inyo,27,18085,1436,1424,4,1428,38
2021-07-23,Kern,29,883053,98834,98261,12225,110486,1350
2021-07-23,Kings,31,150075,23517,23304,1267,24571,246
2021-07-23,Lake,33,64148,4183,3963,13,3976,64
2021-07-23,Lassen,35,31185,5318,5311,127,5438,21
2021-07-23,Los Angeles,37,10098052,1245028,1232164,47243,1279407,24623
2021-07-23,Madera,39,155013,17040,16885,1011,17896,245
2021-07-23,Marin,41,260295,14720,14454,295,14749,238
2021-07-23,Mariposa,43,17540,468,453,12,465,5
2021-07-23,Mendocino,45,87422,4416,4293,80,4373,49
2021-07-23,Merced,47,269075,31841,31661,1059,32720,473
2021-07-23,Modoc,49,8938,415,413,147,560,5
2021-07-23,Mono,51,14174,1277,1284,15,1299,3
2021-07-23,Monterey,53,433212,43659,43525,2022,45547,521
2021-07-23,Napa,55,140530,10384,10230,46,10276,81
2021-07-23,Nevada,57,99092,5347,5183,207,5390,72
2021-07-23,Orange,59,3164182,262761,259973,12476,272449,5141
2021-07-23,Placer,61,380077,25024,24530,1885,26415,303
2021-07-23,Plumas,63,18699,749,737,15,752,4
2021-07-23,Riverside,65,2383286,299424,296912,15401,312313,4552
2021-07-23,Sacramento,67,1510023,114337,112438,2260,114698,1698
2021-07-23,San Benito,69,59416,6235,6200,120,6320,63
2021-07-23,San Bernardino,71,2135413,300080,297899,9605,307504,5236
2021-07-23,San Diego,73,3302833,293687,289368,0,289368,3788
2021-07-23,San Francisco,75,870044,40105,38954,1567,40521,561
2021-07-23,San Joaquin,77,732212,76304,75461,4061,79522,1436
2021-07-23,San Luis Obispo,79,281455,21855,21616,836,22452,260
2021-07-23,San Mateo,81,765935,44475,43880,575,44455,542
2021-07-23,Santa Barbara,83,443738,35454,35071,1420,36491,465
2021-07-23,Santa Clara,85,1922200,122310,121092,886,121978,2099
2021-07-23,Santa Cruz,87,273765,16587,16416,883,17299,207
2021-07-23,Shasta,89,179085,12909,12759,1929,14688,211
2021-07-23,Sierra,91,2930,67,64,14,78,0
2021-07-23,Siskiyou,93,43540,2023,1951,454,2405,31
2021-07-23,Solano,95,438530,35279,34499,700,35199,259
2021-07-23,Sonoma,97,501317,32574,31928,396,32324,327
2021-07-23,Stanislaus,99,539301,58448,57879,6499,64378,1030
2021-07-23,Sutter,101,95872,10000,9890,104,9994,115
2021-07-23,Tehama,103,63373,5191,5166,655,5821,65
2021-07-23,Trinity,105,12862,380,345,78,423,3
2021-07-23,Tulare,107,460477,50345,50104,10004,60108,854
2021-07-23,Tuolumne,109,53932,4317,4216,174,4390,64
2021-07-23,Ventura,111,848112,83224,82687,3563,86250,1041
2021-07-23,Yolo,113,214977,14821,14557,466,15023,214
2021-07-23,Yuba,115,75493,6582,6449,139,6588,51
2021-07-22,Alameda,1,1643700,94710,93170,2304,95474,1259
2021-07-22,Alpine,3,1148,89,89,0,89,0
2021-07-22,Amador,5,37829,3871,3816,36,3852,48
2021-07-22,Butte,7,227075,13158,12982,2051,15033,203
2021-07-22,Calaveras,9,45235,2275,2267,18,2285,57
2021-07-22,Colusa,11,21464,2000,1992,353,2345,16
2021-07-22,Contra Costa,13,1133247,75022,73682,1553,75235,830
2021-07-22,Del Norte,15,27424,1539,1497,10,1507,8
2021-07-22,El Dorado,17,186661,10944,10773,879,11652,116
2021-07-22,Fresno,19,978130,104296,103637,9476,113113,1736
2021-07-22,Glenn,21,27897,2459,2457,597,3054,20
2021-07-22,Humboldt,23,135768,4927,4780,147,4927,52
2021-07-22,Imperial,25,180216,29092,28996,2907,31903,742
2021-07-22,Inyo,27,18085,1434,1424,4,1428,38
2021-07-22,Kern,29,883053,98726,98261,12180,110441,1350
2021-07-22,Kings,31,150075,23477,23304,1265,24569,246
2021-07-22,Lake,33,64148,4132,3963,13,3976,64
2021-07-22,Lassen,35,31185,5315,5311,127,5438,21
2021-07-22,Los Angeles,37,10098052,1242644,1232164,47077,1279241,24623
2021-07-22,Madera,39,155013,17006,16885,1009,17894,245
2021-07-22,Marin,41,260295,14679,14454,294,14748,238
2021-07-22,Mariposa,43,17540,461,453,12,465,5
2021-07-22,Mendocino,45,87422,4403,4293,79,4372,49
2021-07-22,Merced,47,269075,31799,31661,1056,32717,473
2021-07-22,Modoc,49,8938,415,413,147,560,5
2021-07-22,Mono,51,14174,1276,1284,15,1299,3
2021-07-22,Monterey,53,433212,43630,43525,2016,45541,521
2021-07-22,Napa,55,140530,10366,10230,46,10276,81
2021-07-22,Nevada,57,99092,5321,5183,206,5389,72
2021-07-22,Orange,59,3164182,262219,259973,12469,272442,5141
2021-07-22,Placer,61,380077,24930,24530,1874,26404,303
2021-07-22,Plumas,63,18699,748,737,15,752,4
2021-07-22,Riverside,65,2383286,298915,296912,15380,312292,4552
2021-07-22,Sacramento,67,1510023,113912,112438,2250,114688,1698
2021-07-22,San Benito,69,59416,6227,6200,120,6320,63
2021-07-22,San Bernardino,71,2135413,299694,297899,9593,307492,5236
2021-07-22,San Diego,73,3302833,292975,289368,0,289368,3788
2021-07-22,San Francisco,75,870044,39894,38954,1553,40507,561
2021-07-22,San Joaquin,77,732212,76161,75461,4047,79508,1436
2021-07-22,San Luis Obispo,79,281455,21820,21616,831,22447,260
2021-07-22,San Mateo,81,765935,44362,43880,570,44450,542
2021-07-22,Santa Barbara,83,443738,35393,35071,1418,36489,465
2021-07-22,Santa Clara,85,1922200,122070,121092,883,121975,2099
2021-07-22,Santa Cruz,87,273765,16550,16416,883,17299,207
2021-07-22,Shasta,89,179085,12885,12759,1925,14684,211
2021-07-22,Sierra,91,2930,65,64,14,78,0
2021-07-22,Siskiyou,93,43540,2020,1951,454,2405,31
2021-07-22,Solano,95,438530,35132,34499,693,35192,259
2021-07-22,Sonoma,97,501317,32465,31928,394,32322,327
2021-07-22,Stanislaus,99,539301,58321,57879,6486,64365,1030
2021-07-22,Sutter,101,95872,9979,9890,104,9994,115
2021-07-22,Tehama,103,63373,5185,5166,655,5821,65
2021-07-22,Trinity,105,12862,379,345,78,423,3
2021-07-22,Tulare,107,460477,50302,50104,9976,60080,854
2021-07-22,Tuolumne,109,53932,4306,4216,174,4390,64
2021-07-22,Ventura,111,848112,83093,82687,3550,86237,1041
2021-07-22,Yolo,113,214977,14783,14557,466,15023,214
2021-07-22,Yuba,115,75493,6551,6449,139,6588,51
2021-07-21,Alameda,1,1643700,94379,92840,2298,95138,1256
2021-07-21,Alpine,3,1148,89,89,0,89,0
2021-07-21,Amador,5,37829,3858,3813,36,3849,48
2021-07-21,Butte,7,227075,13117,12939,2046,14985,203
2021-07-21,Calaveras,9,45235,2274,2257,18,2275,57
2021-07-21,Colusa,11,21464,1996,1988,352,2340,16
2021-07-21,Contra Costa,13,1133247,74757,73320,1544,74864,827
2021-07-21,Del Norte,15,27424,1529,1492,10,1502,8
2021-07-21,El Dorado,17,186661,10909,10742,875,11617,116
2021-07-21,Fresno,19,978130,104152,103504,9467,112971,1736
2021-07-21,Glenn,21,27897,2457,2455,596,3051,20
2021-07-21,Humboldt,23,135768,4897,4763,145,4908,52
2021-07-21,Imperial,25,180216,29079,28964,2905,31869,742
2021-07-21,Inyo,27,18085,1434,1423,4,1427,38
2021-07-21,Kern,29,883053,98612,98152,12136,110288,1350
2021-07-21,Kings,31,150075,23449,23270,1261,24531,246
2021-07-21,Lake,33,64148,4067,3896,13,3909,64
2021-07-21,Lassen,35,31185,5312,5310,127,5437,21
2021-07-21,Los Angeles,37,10098052,1240179,1229598,46952,1276550,24609
2021-07-21,Madera,39,155013,16987,16858,1006,17864,245
2021-07-21,Marin,41,260295,14630,14427,294,14721,238
2021-07-21,Mariposa,43,17540,457,449,12,461,5
2021-07-21,Mendocino,45,87422,4384,4274,79,4353,49
2021-07-21,Merced,47,269075,31761,31607,1051,32658,473
2021-07-21,Modoc,49,8938,415,413,147,560,5
2021-07-21,Mono,51,14174,1273,1282,15,1297,3
2021-07-21,Monterey,53,433212,43600,43502,2012,45514,515
2021-07-21,Napa,55,140530,10341,10209,46,10255,81
2021-07-21,Nevada,57,99092,5286,5152,206,5358,72
2021-07-21,Orange,59,3164182,261679,259615,12441,272056,5139
2021-07-21,Placer,61,380077,24821,24441,1863,26304,303
2021-07-21,Plumas,63,18699,748,736,15,751,4
2021-07-21,Riverside,65,2383286,298402,296419,15363,311782,4552
2021-07-21,Sacramento,67,1510023,113501,112043,2238,114281,1696
2021-07-21,San Benito,69,59416,6217,6196,120,6316,63
2021-07-21,San Bernardino,71,2135413,299254,297519,9586,307105,5230
2021-07-21,San Diego,73,3302833,292130,288682,0,288682,3787
2021-07-21,San Francisco,75,870044,39669,38699,1548,40247,559
2021-07-21,San Joaquin,77,732212,75974,75288,4035,79323,1434
2021-07-21,San Luis Obispo,79,281455,21784,21579,828,22407,260
2021-07-21,San Mateo,81,765935,44270,43755,566,44321,542
2021-07-21,Santa Barbara,83,443738,35337,34998,1398,36396,465
2021-07-21,Santa Clara,85,1922200,121863,120838,880,121718,2099
2021-07-21,Santa Cruz,87,273765,16516,16407,883,17290,207
2021-07-21,Shasta,89,179085,12853,12751,1918,14669,211
2021-07-21,Sierra,91,2930,65,64,14,78,0
2021-07-21,Siskiyou,93,43540,2018,1943,452,2395,31
2021-07-21,Solano,95,438530,34977,34374,688,35062,258
2021-07-21,Sonoma,97,501317,32349,31789,394,32183,327
2021-07-21,Stanislaus,99,539301,58219,57774,6477,64251,1028
2021-07-21,Sutter,101,95872,9955,9862,104,9966,113
2021-07-21,Tehama,103,63373,5181,5161,655,5816,65
2021-07-21,Trinity,105,12862,378,345,77,422,3
2021-07-21,Tulare,107,460477,50243,50066,9949,60015,854
2021-07-21,Tuolumne,109,53932,4269,4156,174,4330,64
2021-07-21,Ventura,111,848112,82972,82573,3538,86111,1041
2021-07-21,Yolo,113,214977,14742,14525,465,14990,213
2021-07-21,Yuba,115,75493,6524,6425,139,6564,52
2021-07-20,Alameda,1,1643700,94002,92625,2285,94910,1256
2021-07-20,Alpine,3,1148,89,89,0,89,0
2021-07-20,Amador,5,37829,3847,3807,36,3843,48
2021-07-20,Butte,7,227075,13080,12916,2040,14956,203
2021-07-20,Calaveras,9,45235,2271,2249,18,2267,57
2021-07-20,Colusa,11,21464,1996,1985,352,2337,16
2021-07-20,Contra Costa,13,1133247,74471,73143,1525,74668,825
2021-07-20,Del Norte,15,27424,1520,1490,10,1500,8
2021-07-20,El Dorado,17,186661,10868,10727,870,11597,116
2021-07-20,Fresno,19,978130,104014,103438,9457,112895,1736
2021-07-20,Glenn,21,27897,2457,2453,596,3049,20
2021-07-20,Humboldt,23,135768,4853,4735,143,4878,52
2021-07-20,Imperial,25,180216,29059,28933,2905,31838,742
2021-07-20,Inyo,27,18085,1430,1420,4,1424,36
2021-07-20,Kern,29,883053,98506,98082,12107,110189,1350
2021-07-20,Kings,31,150075,23408,23254,1257,24511,246
2021-07-20,Lake,33,64148,4043,3871,13,3884,64
2021-07-20,Lassen,35,31185,5312,5306,127,5433,21
2021-07-20,Los Angeles,37,10098052,1237413,1227404,46791,1274195,24603
2021-07-20,Madera,39,155013,16966,16856,1002,17858,245
2021-07-20,Marin,41,260295,14596,14396,291,14687,234
2021-07-20,Mariposa,43,17540,456,448,12,460,5
2021-07-20,Mendocino,45,87422,4367,4259,79,4338,49
2021-07-20,Merced,47,269075,31724,31578,1043,32621,473
2021-07-20,Modoc,49,8938,415,413,147,560,5
2021-07-20,Mono,51,14174,1269,1281,15,1296,3
2021-07-20,Monterey,53,433212,43569,43481,2009,45490,515
2021-07-20,Napa,55,140530,10319,10191,46,10237,81
2021-07-20,Nevada,57,99092,5267,5148,205,5353,72
2021-07-20,Orange,59,3164182,261140,259303,12416,271719,5139
2021-07-20,Placer,61,380077,24735,24408,1838,26246,303
2021-07-20,Plumas,63,18699,745,736,15,751,4
2021-07-20,Riverside,65,2383286,297868,296118,15349,311467,4543
2021-07-20,Sacramento,67,1510023,113063,111796,2208,114004,1695
2021-07-20,San Benito,69,59416,6210,6196,120,6316,63
2021-07-20,San Bernardino,71,2135413,298851,297222,9561,306783,5231
2021-07-20,San Diego,73,3302833,291215,288209,0,288209,3786
2021-07-20,San Francisco,75,870044,39414,38536,1536,40072,558
2021-07-20,San Joaquin,77,732212,75802,75198,4022,79220,1433
2021-07-20,San Luis Obispo,79,281455,21739,21556,827,22383,259
2021-07-20,San Mateo,81,765935,44156,43670,562,44232,542
2021-07-20,Santa Barbara,83,443738,35272,34935,1391,36326,462
2021-07-20,Santa Clara,85,1922200,121606,120704,878,121582,2098
2021-07-20,Santa Cruz,87,273765,16487,16399,883,17282,207
2021-07-20,Shasta,89,179085,12827,12734,1911,14645,211
2021-07-20,Sierra,91,2930,65,64,14,78,0
2021-07-20,Siskiyou,93,43540,2014,1931,451,2382,31
2021-07-20,Solano,95,438530,34851,34337,681,35018,258
2021-07-20,Sonoma,97,501317,32231,31763,393,32156,326
2021-07-20,Stanislaus,99,539301,58103,57706,6471,64177,1028
2021-07-20,Sutter,101,95872,9929,9854,101,9955,114
2021-07-20,Tehama,103,63373,5179,5153,655,5808,65
2021-07-20,Trinity,105,12862,377,344,75,419,3
2021-07-20,Tulare,107,460477,50202,50047,9931,59978,854
2021-07-20,Tuolumne,109,53932,4250,4156,174,4330,64
2021-07-20,Ventura,111,848112,82822,82504,3520,86024,1041
2021-07-20,Yolo,113,214977,14680,14495,462,14957,213
2021-07-20,Yuba,115,75493,6499,6393,137,6530,52
2021-07-19,Alameda,1,1643700,93627,92357,2269,94626,1256
2021-07-19,Alpine,3,1148,89,89,0,89,0
2021-07-19,Amador,5,37829,3843,3802,36,3838,48
2021-07-19,Butte,7,227075,13035,12901,2034,14935,202
2021-07-19,Calaveras,9,45235,2270,2245,18,2263,57
2021-07-19,Colusa,11,21464,1994,1981,351,2332,16
2021-07-19,Contra Costa,13,1133247,74163,72935,1503,74438,825
2021-07-19,Del Norte,15,27424,1508,1484,10,1494,8
2021-07-19,El Dorado,17,186661,10838,10703,862,11565,114
2021-07-19,Fresno,19,978130,103889,103350,9441,112791,1731
2021-07-19,Glenn,21,27897,2457,2452,595,3047,20
2021-07-19,Humboldt,23,135768,4823,4719,142,4861,52
2021-07-19,Imperial,25,180216,29033,28888,2905,31793,742
2021-07-19,Inyo,27,18085,1429,1417,4,1421,36
2021-07-19,Kern,29,883053,98395,97999,12071,110070,1349
2021-07-19,Kings,31,150075,23375,23221,1251,24472,246
2021-07-19,Lake,33,64148,4007,3848,13,3861,64
2021-07-19,Lassen,35,31185,5311,5305,127,5432,21
2021-07-19,Los Angeles,37,10098052,1234840,1225946,46601,1272547,24600
2021-07-19,Madera,39,155013,16944,16846,999,17845,244
2021-07-19,Marin,41,260295,14561,14369,288,14657,234
2021-07-19,Mariposa,43,17540,450,447,12,459,5
2021-07-19,Mendocino,45,87422,4349,4251,79,4330,49
2021-07-19,Merced,47,269075,31660,31565,1036,32601,472
2021-07-19,Modoc,49,8938,415,413,147,560,5
2021-07-19,Mono,51,14174,1267,1280,15,1295,3
2021-07-19,Monterey,53,433212,43545,43436,2008,45444,515
2021-07-19,Napa,55,140530,10294,10180,44,10224,81
2021-07-19,Nevada,57,99092,5239,5133,204,5337,72
2021-07-19,Orange,59,3164182,260639,258927,12385,271312,5138
2021-07-19,Placer,61,380077,24637,24359,1816,26175,303
2021-07-19,Plumas,63,18699,745,730,15,745,4
2021-07-19,Riverside,65,2383286,297378,295736,15311,311047,4543
2021-07-19,Sacramento,67,1510023,112706,111470,2182,113652,1696
2021-07-19,San Benito,69,59416,6207,6193,120,6313,63
2021-07-19,San Bernardino,71,2135413,298488,296929,9542,306471,5235
2021-07-19,San Diego,73,3302833,290329,287695,0,287695,3786
2021-07-19,San Francisco,75,870044,39145,38463,1522,39985,560
2021-07-19,San Joaquin,77,732212,75636,75086,4016,79102,1431
2021-07-19,San Luis Obispo,79,281455,21694,21531,823,22354,259
2021-07-19,San Mateo,81,765935,44009,43563,554,44117,542
2021-07-19,Santa Barbara,83,443738,35202,34904,1388,36292,461
2021-07-19,Santa Clara,85,1922200,121347,120554,877,121431,2098
2021-07-19,Santa Cruz,87,273765,16471,16387,883,17270,207
2021-07-19,Shasta,89,179085,12809,12723,1909,14632,209
2021-07-19,Sierra,91,2930,64,64,14,78,0
2021-07-19,Siskiyou,93,43540,2009,1927,449,2376,31
2021-07-19,Solano,95,438530,34682,34262,670,34932,261
2021-07-19,Sonoma,97,501317,32107,31713,392,32105,325
2021-07-19,Stanislaus,99,539301,58003,57644,6460,64104,1027
2021-07-19,Sutter,101,95872,9913,9834,101,9935,114
2021-07-19,Tehama,103,63373,5172,5152,653,5805,65
2021-07-19,Trinity,105,12862,377,344,74,418,3
2021-07-19,Tulare,107,460477,50157,49994,9913,59907,855
2021-07-19,Tuolumne,109,53932,4240,4151,174,4325,64
2021-07-19,Ventura,111,848112,82728,82409,3500,85909,1041
2021-07-19,Yolo,113,214977,14649,14439,460,14899,213
2021-07-19,Yuba,115,75493,6475,6370,137,6507,52
2021-07-18,Alameda,1,1643700,93280,92162,2254,94416,1256
2021-07-18,Alpine,3,1148,89,89,0,89,0
2021-07-18,Amador,5,37829,3832,3799,36,3835,48
2021-07-18,Butte,7,227075,12995,12888,2027,14915,202
2021-07-18,Calaveras,9,45235,2269,2243,18,2261,57
2021-07-18,Colusa,11,21464,1994,1981,350,2331,16
2021-07-18,Contra Costa,13,1133247,73848,72849,1485,74334,825
2021-07-18,Del Norte,15,27424,1499,1482,10,1492,8
2021-07-18,El Dorado,17,186661,10800,10687,854,11541,114
2021-07-18,Fresno,19,978130,103737,103298,9422,112720,1731
2021-07-18,Glenn,21,27897,2456,2452,594,3046,20
2021-07-18,Humboldt,23,135768,4787,4714,142,4856,52
2021-07-18,Imperial,25,180216,28996,28877,2904,31781,742
2021-07-18,Inyo,27,18085,1425,1417,4,1421,36
2021-07-18,Kern,29,883053,98269,97963,12029,109992,1349
2021-07-18,Kings,31,150075,23354,23203,1247,24450,246
2021-07-18,Lake,33,64148,3971,3825,13,3838,64
2021-07-18,Lassen,35,31185,5311,5305,127,5432,21
2021-07-18,Los Angeles,37,10098052,1232190,1224691,46411,1271102,24598
2021-07-18,Madera,39,155013,16919,16838,996,17834,244
2021-07-18,Marin,41,260295,14525,14358,287,14645,234
2021-07-18,Mariposa,43,17540,449,447,12,459,5
2021-07-18,Mendocino,45,87422,4328,4246,79,4325,49
2021-07-18,Merced,47,269075,31629,31537,1034,32571,471
2021-07-18,Modoc,49,8938,415,413,147,560,5
2021-07-18,Mono,51,14174,1266,1280,15,1295,3
2021-07-18,Monterey,53,433212,43527,43422,1999,45421,515
2021-07-18,Napa,55,140530,10277,10174,41,10215,81
2021-07-18,Nevada,57,99092,5213,5124,204,5328,72
2021-07-18,Orange,59,3164182,260159,258724,12355,271079,5138
2021-07-18,Placer,61,380077,24574,24313,1788,26101,303
2021-07-18,Plumas,63,18699,745,730,15,745,4
2021-07-18,Riverside,65,2383286,296889,295522,15270,310792,4543
2021-07-18,Sacramento,67,1510023,112280,111255,2152,113407,1696
2021-07-18,San Benito,69,59416,6199,6191,120,6311,63
2021-07-18,San Bernardino,71,2135413,298016,296739,9529,306268,5233
2021-07-18,San Diego,73,3302833,289516,286287,0,286287,3786
2021-07-18,San Francisco,75,870044,38915,38367,1511,39878,560
2021-07-18,San Joaquin,77,732212,75462,74997,4003,79000,1431
2021-07-18,San Luis Obispo,79,281455,21658,21527,820,22347,259
2021-07-18,San Mateo,81,765935,43898,43506,548,44054,542
2021-07-18,Santa Barbara,83,443738,35138,34880,1385,36265,461
2021-07-18,Santa Clara,85,1922200,121136,120438,869,121307,2098
2021-07-18,Santa Cruz,87,273765,16439,16372,882,17254,207
2021-07-18,Shasta,89,179085,12784,12714,1905,14619,209
2021-07-18,Sierra,91,2930,64,64,14,78,0
2021-07-18,Siskiyou,93,43540,2003,1927,444,2371,31
2021-07-18,Solano,95,438530,34563,34215,666,34881,261
2021-07-18,Sonoma,97,501317,32003,31675,391,32066,325
2021-07-18,Stanislaus,99,539301,57892,57600,6438,64038,1028
2021-07-18,Sutter,101,95872,9881,9826,100,9926,114
2021-07-18,Tehama,103,63373,5169,5150,652,5802,65
2021-07-18,Trinity,105,12862,377,344,74,418,3
2021-07-18,Tulare,107,460477,50105,49985,9890,59875,855
2021-07-18,Tuolumne,109,53932,4222,4149,174,4323,64
2021-07-18,Ventura,111,848112,82621,82361,3474,85835,1041
2021-07-18,Yolo,113,214977,14593,14425,454,14879,213
2021-07-18,Yuba,115,75493,6434,6357,137,6494,52
2021-07-17,Alameda,1,1643700,93067,91346,2241,93587,1255
2021-07-17,Alpine,3,1148,89,89,0,89,0
2021-07-17,Amador,5,37829,3823,3785,36,3821,48
2021-07-17,Butte,7,227075,12982,12824,2023,14847,202
2021-07-17,Calaveras,9,45235,2263,2237,18,2255,57
2021-07-17,Colusa,11,21464,1991,1976,350,2326,16
2021-07-17,Contra Costa,13,1133247,73668,72254,1471,73725,824
2021-07-17,Del Norte,15,27424,1491,1475,10,1485,8
2021-07-17,El Dorado,17,186661,10774,10622,849,11471,114
2021-07-17,Fresno,19,978130,103665,103055,9409,112464,1730
2021-07-17,Glenn,21,27897,2455,2451,594,3045,20
2021-07-17,Humboldt,23,135768,4774,4654,141,4795,52
2021-07-17,Imperial,25,180216,28981,28840,2904,31744,742
2021-07-17,Inyo,27,18085,1425,1416,4,1420,36
2021-07-17,Kern,29,883053,98213,97796,11993,109789,1348
2021-07-17,Kings,31,150075,23332,23163,1246,24409,246
2021-07-17,Lake,33,64148,3946,3760,13,3773,64
2021-07-17,Lassen,35,31185,5311,5302,127,5429,21
2021-07-17,Los Angeles,37,10098052,1230701,1219733,46258,1265991,24582
2021-07-17,Madera,39,155013,16911,16804,996,17800,240
2021-07-17,Marin,41,260295,14507,14297,285,14582,234
2021-07-17,Mariposa,43,17540,449,445,12,457,5
2021-07-17,Mendocino,45,87422,4316,4209,79,4288,49
2021-07-17,Merced,47,269075,31608,31451,1031,32482,471
2021-07-17,Modoc,49,8938,415,412,147,559,5
2021-07-17,Mono,51,14174,1264,1277,15,1292,3
2021-07-17,Monterey,53,433212,43505,43367,1993,45360,515
2021-07-17,Napa,55,140530,10261,10129,41,10170,81
2021-07-17,Nevada,57,99092,5198,5066,204,5270,72
2021-07-17,Orange,59,3164182,259858,257805,12318,270123,5136
2021-07-17,Placer,61,380077,24507,24169,1774,25943,303
2021-07-17,Plumas,63,18699,741,721,15,736,4
2021-07-17,Riverside,65,2383286,296583,294751,15238,309989,4542
2021-07-17,Sacramento,67,1510023,112046,110432,2131,112563,1694
2021-07-17,San Benito,69,59416,6193,6181,120,6301,63
2021-07-17,San Bernardino,71,2135413,297795,296048,9512,305560,5218
2021-07-17,San Diego,73,3302833,289110,285698,0,285698,3786
2021-07-17,San Francisco,75,870044,38795,37978,1507,39485,560
2021-07-17,San Joaquin,77,732212,75377,74695,3995,78690,1430
2021-07-17,San Luis Obispo,79,281455,21632,21462,819,22281,258
2021-07-17,San Mateo,81,765935,43827,43324,547,43871,542
2021-07-17,Santa Barbara,83,443738,35098,34769,1383,36152,461
2021-07-17,Santa Clara,85,1922200,120965,119980,866,120846,2097
2021-07-17,Santa Cruz,87,273765,16432,16337,882,17219,207
2021-07-17,Shasta,89,179085,12769,12683,1900,14583,210
2021-07-17,Sierra,91,2930,64,62,14,76,0
2021-07-17,Siskiyou,93,43540,1998,1922,441,2363,29
2021-07-17,Solano,95,438530,34499,34015,658,34673,263
2021-07-17,Sonoma,97,501317,31937,31536,390,31926,322
2021-07-17,Stanislaus,99,539301,57814,57400,6425,63825,1028
2021-07-17,Sutter,101,95872,9871,9778,100,9878,114
2021-07-17,Tehama,103,63373,5166,5145,652,5797,64
2021-07-17,Trinity,105,12862,376,341,74,415,3
2021-07-17,Tulare,107,460477,50084,49937,9878,59815,854
2021-07-17,Tuolumne,109,53932,4212,4131,174,4305,64
2021-07-17,Ventura,111,848112,82555,82125,3462,85587,1041
2021-07-17,Yolo,113,214977,14564,14356,446,14802,213
2021-07-17,Yuba,115,75493,6423,6309,137,6446,52
2021-07-16,Alameda,1,1643700,92833,91346,2229,93575,1255
2021-07-16,Alpine,3,1148,89,89,0,89,0
2021-07-16,Amador,5,37829,3820,3785,36,3821,48
2021-07-16,Butte,7,227075,12957,12824,2020,14844,202
2021-07-16,Calaveras,9,45235,2263,2237,18,2255,57
2021-07-16,Colusa,11,21464,1989,1976,349,2325,16
2021-07-16,Contra Costa,13,1133247,73479,72254,1466,73720,824
2021-07-16,Del Norte,15,27424,1489,1475,10,1485,8
2021-07-16,El Dorado,17,186661,10755,10622,848,11470,114
2021-07-16,Fresno,19,978130,103614,103055,9390,112445,1730
2021-07-16,Glenn,21,27897,2455,2451,594,3045,20
2021-07-16,Humboldt,23,135768,4752,4654,141,4795,52
2021-07-16,Imperial,25,180216,28969,28840,2904,31744,742
2021-07-16,Inyo,27,18085,1423,1416,4,1420,36
2021-07-16,Kern,29,883053,98151,97796,11952,109748,1348
2021-07-16,Kings,31,150075,23309,23163,1243,24406,246
2021-07-16,Lake,33,64148,3920,3760,13,3773,64
2021-07-16,Lassen,35,31185,5310,5302,127,5429,21
2021-07-16,Los Angeles,37,10098052,1229229,1219733,46109,1265842,24582
2021-07-16,Madera,39,155013,16893,16804,996,17800,240
2021-07-16,Marin,41,260295,14483,14297,282,14579,234
2021-07-16,Mariposa,43,17540,449,445,12,457,5
2021-07-16,Mendocino,45,87422,4307,4209,78,4287,49
2021-07-16,Merced,47,269075,31586,31451,1029,32480,471
2021-07-16,Modoc,49,8938,415,412,147,559,5
2021-07-16,Mono,51,14174,1263,1277,15,1292,3
2021-07-16,Monterey,53,433212,43483,43367,1991,45358,515
2021-07-16,Napa,55,140530,10237,10129,40,10169,81
2021-07-16,Nevada,57,99092,5188,5066,204,5270,72
2021-07-16,Orange,59,3164182,259593,257805,12278,270083,5136
2021-07-16,Placer,61,380077,24455,24169,1768,25937,303
2021-07-16,Plumas,63,18699,740,721,15,736,4
2021-07-16,Riverside,65,2383286,296305,294751,15212,309963,4542
2021-07-16,Sacramento,67,1510023,111831,110432,2119,112551,1694
2021-07-16,San Benito,69,59416,6191,6181,120,6301,63
2021-07-16,San Bernardino,71,2135413,297532,296048,9495,305543,5218
2021-07-16,San Diego,73,3302833,288664,285698,0,285698,3786
2021-07-16,San Francisco,75,870044,38678,37978,1502,39480,560
2021-07-16,San Joaquin,77,732212,75284,74695,3992,78687,1430
2021-07-16,San Luis Obispo,79,281455,21614,21462,819,22281,258
2021-07-16,San Mateo,81,765935,43775,43324,545,43869,542
2021-07-16,Santa Barbara,83,443738,35060,34769,1383,36152,461
2021-07-16,Santa Clara,85,1922200,120817,119980,858,120838,2097
2021-07-16,Santa Cruz,87,273765,16419,16337,882,17219,207
2021-07-16,Shasta,89,179085,12759,12683,1899,14582,210
2021-07-16,Sierra,91,2930,64,62,14,76,0
2021-07-16,Siskiyou,93,43540,1996,1922,439,2361,29
2021-07-16,Solano,95,438530,34435,34015,650,34665,263
2021-07-16,Sonoma,97,501317,31885,31536,388,31924,322
2021-07-16,Stanislaus,99,539301,57766,57400,6415,63815,1028
2021-07-16,Sutter,101,95872,9859,9778,100,9878,114
2021-07-16,Tehama,103,63373,5164,5145,652,5797,64
2021-07-16,Trinity,105,12862,376,341,73,414,3
2021-07-16,Tulare,107,460477,50060,49937,9868,59805,854
2021-07-16,Tuolumne,109,53932,4206,4131,174,4305,64
2021-07-16,Ventura,111,848112,82494,82125,3455,85580,1041
2021-07-16,Yolo,113,214977,14538,14356,442,14798,213
2021-07-16,Yuba,115,75493,6402,6309,137,6446,52
2021-07-15,Alameda,1,1643700,92532,91346,2219,93565,1255
2021-07-15,Alpine,3,1148,89,89,0,89,0
2021-07-15,Amador,5,37829,3817,3785,36,3821,48
2021-07-15,Butte,7,227075,12931,12824,2017,14841,202
2021-07-15,Calaveras,9,45235,2261,2237,18,2255,57
2021-07-15,Colusa,11,21464,1988,1976,348,2324,16
2021-07-15,Contra Costa,13,1133247,73265,72254,1458,73712,824
2021-07-15,Del Norte,15,27424,1486,1475,10,1485,8
2021-07-15,El Dorado,17,186661,10728,10622,846,11468,114
2021-07-15,Fresno,19,978130,103518,103055,9368,112423,1730
2021-07-15,Glenn,21,27897,2455,2451,594,3045,20
2021-07-15,Humboldt,23,135768,4734,4654,140,4794,52
2021-07-15,Imperial,25,180216,28946,28840,2904,31744,742
2021-07-15,Inyo,27,18085,1423,1416,4,1420,36
2021-07-15,Kern,29,883053,98081,97796,11925,109721,1348
2021-07-15,Kings,31,150075,23272,23163,1240,24403,246
2021-07-15,Lake,33,64148,3881,3760,13,3773,64
2021-07-15,Lassen,35,31185,5309,5302,127,5429,21
2021-07-15,Los Angeles,37,10098052,1227270,1219733,45944,1265677,24582
2021-07-15,Madera,39,155013,16871,16804,992,17796,240
2021-07-15,Marin,41,260295,14459,14297,282,14579,234
2021-07-15,Mariposa,43,17540,449,445,12,457,5
2021-07-15,Mendocino,45,87422,4299,4209,77,4286,49
2021-07-15,Merced,47,269075,31556,31451,1029,32480,471
2021-07-15,Modoc,49,8938,415,412,147,559,5
2021-07-15,Mono,51,14174,1263,1277,15,1292,3
2021-07-15,Monterey,53,433212,43454,43367,1988,45355,515
2021-07-15,Napa,55,140530,10212,10129,39,10168,81
2021-07-15,Nevada,57,99092,5170,5066,203,5269,72
2021-07-15,Orange,59,3164182,259244,257805,12257,270062,5136
2021-07-15,Placer,61,380077,24396,24169,1751,25920,303
2021-07-15,Plumas,63,18699,739,721,15,736,4
2021-07-15,Riverside,65,2383286,295989,294751,15196,309947,4542
2021-07-15,Sacramento,67,1510023,111532,110432,2101,112533,1694
2021-07-15,San Benito,69,59416,6189,6181,120,6301,63
2021-07-15,San Bernardino,71,2135413,297236,296048,9481,305529,5218
2021-07-15,San Diego,73,3302833,288033,285698,0,285698,3786
2021-07-15,San Francisco,75,870044,38529,37978,1493,39471,560
2021-07-15,San Joaquin,77,732212,75170,74695,3987,78682,1430
2021-07-15,San Luis Obispo,79,281455,21581,21462,819,22281,258
2021-07-15,San Mateo,81,765935,43676,43324,541,43865,542
2021-07-15,Santa Barbara,83,443738,35007,34769,1382,36151,461
2021-07-15,Santa Clara,85,1922200,120695,119980,855,120835,2097
2021-07-15,Santa Cruz,87,273765,16406,16337,882,17219,207
2021-07-15,Shasta,89,179085,12751,12683,1892,14575,210
2021-07-15,Sierra,91,2930,64,62,14,76,0
2021-07-15,Siskiyou,93,43540,1995,1922,439,2361,29
2021-07-15,Solano,95,438530,34361,34015,644,34659,263
2021-07-15,Sonoma,97,501317,31824,31536,388,31924,322
2021-07-15,Stanislaus,99,539301,57698,57400,6402,63802,1028
2021-07-15,Sutter,101,95872,9839,9778,100,9878,114
2021-07-15,Tehama,103,63373,5158,5145,651,5796,64
2021-07-15,Trinity,105,12862,376,341,73,414,3
2021-07-15,Tulare,107,460477,50039,49937,9851,59788,854
2021-07-15,Tuolumne,109,53932,4194,4131,174,4305,64
2021-07-15,Ventura,111,848112,82415,82125,3450,85575,1041
2021-07-15,Yolo,113,214977,14512,14356,441,14797,213
2021-07-15,Yuba,115,75493,6387,6309,137,6446,52
2021-07-14,Alameda,1,1643700,92279,91092,2200,93292,1255
2021-07-14,Alpine,3,1148,89,89,0,89,0
2021-07-14,Amador,5,37829,3809,3784,36,3820,48
2021-07-14,Butte,7,227075,12904,12813,2010,14823,202
2021-07-14,Calaveras,9,45235,2253,2234,18,2252,57
2021-07-14,Colusa,11,21464,1985,1974,348,2322,16
2021-07-14,Contra Costa,13,1133247,73040,72091,1445,73536,823
2021-07-14,Del Norte,15,27424,1485,1472,10,1482,8
2021-07-14,El Dorado,17,186661,10702,10598,843,11441,114
2021-07-14,Fresno,19,978130,103440,102966,9356,112322,1728
2021-07-14,Glenn,21,27897,2455,2449,594,3043,20
2021-07-14,Humboldt,23,135768,4711,4644,138,4782,52
2021-07-14,Imperial,25,180216,28916,28822,2904,31726,742
2021-07-14,Inyo,27,18085,1422,1415,4,1419,36
2021-07-14,Kern,29,883053,98018,97736,11899,109635,1346
2021-07-14,Kings,31,150075,23260,23142,1240,24382,246
2021-07-14,Lake,33,64148,3848,3739,13,3752,63
2021-07-14,Lassen,35,31185,5308,5298,127,5425,21
2021-07-14,Los Angeles,37,10098052,1225274,1218265,45792,1264057,24578
2021-07-14,Madera,39,155013,16860,16786,990,17776,240
2021-07-14,Marin,41,260295,14425,14269,280,14549,233
2021-07-14,Mariposa,43,17540,447,445,12,457,5
2021-07-14,Mendocino,45,87422,4286,4193,76,4269,49
2021-07-14,Merced,47,269075,31520,31412,1026,32438,471
2021-07-14,Modoc,49,8938,415,412,147,559,4
2021-07-14,Mono,51,14174,1263,1278,15,1293,3
2021-07-14,Monterey,53,433212,43431,43347,1985,45332,504
2021-07-14,Napa,55,140530,10190,10121,39,10160,81
2021-07-14,Nevada,57,99092,5151,5058,203,5261,72
2021-07-14,Orange,59,3164182,258932,257558,12231,269789,5137
2021-07-14,Placer,61,380077,24345,24125,1739,25864,303
2021-07-14,Plumas,63,18699,732,719,15,734,4
2021-07-14,Riverside,65,2383286,295664,294511,15179,309690,4542
2021-07-14,Sacramento,67,1510023,111205,110193,2079,112272,1688
2021-07-14,San Benito,69,59416,6186,6177,120,6297,63
2021-07-14,San Bernardino,71,2135413,296945,295820,9468,305288,5193
2021-07-14,San Diego,73,3302833,287468,285269,0,285269,3786
2021-07-14,San Francisco,75,870044,38389,37836,1486,39322,559
2021-07-14,San Joaquin,77,732212,75079,74599,3978,78577,1416
2021-07-14,San Luis Obispo,79,281455,21559,21444,817,22261,258
2021-07-14,San Mateo,81,765935,43580,43249,537,43786,542
2021-07-14,Santa Barbara,83,443738,34967,34719,1380,36099,461
2021-07-14,Santa Clara,85,1922200,120546,119844,852,120696,2098
2021-07-14,Santa Cruz,87,273765,16393,16326,882,17208,207
2021-07-14,Shasta,89,179085,12731,12669,1889,14558,209
2021-07-14,Sierra,91,2930,64,62,14,76,0
2021-07-14,Siskiyou,93,43540,1988,1922,436,2358,29
2021-07-14,Solano,95,438530,34289,33948,644,34592,268
2021-07-14,Sonoma,97,501317,31773,31470,387,31857,322
2021-07-14,Stanislaus,99,539301,57623,57340,6390,63730,1028
2021-07-14,Sutter,101,95872,9816,9766,100,9866,114
2021-07-14,Tehama,103,63373,5156,5142,651,5793,64
2021-07-14,Trinity,105,12862,376,341,73,414,3
2021-07-14,Tulare,107,460477,50023,49908,9836,59744,853
2021-07-14,Tuolumne,109,53932,4191,4128,173,4301,64
2021-07-14,Ventura,111,848112,82324,82041,3438,85479,1040
2021-07-14,Yolo,113,214977,14479,14332,438,14770,213
2021-07-14,Yuba,115,75493,6369,6294,137,6431,52
2021-07-13,Alameda,1,1643700,92013,90874,2189,93063,1255
2021-07-13,Alpine,3,1148,89,89,0,89,0
2021-07-13,Amador,5,37829,3801,3783,36,3819,48
2021-07-13,Butte,7,227075,12891,12802,2008,14810,202
2021-07-13,Calaveras,9,45235,2249,2230,18,2248,57
2021-07-13,Colusa,11,21464,1983,1972,344,2316,16
2021-07-13,Contra Costa,13,1133247,72816,71963,1436,73399,823
2021-07-13,Del Norte,15,27424,1483,1471,10,1481,8
2021-07-13,El Dorado,17,186661,10684,10581,840,11421,114
2021-07-13,Fresno,19,978130,103364,102909,9347,112256,1727
2021-07-13,Glenn,21,27897,2453,2448,594,3042,20
2021-07-13,Humboldt,23,135768,4696,4634,137,4771,51
2021-07-13,Imperial,25,180216,28905,28792,2904,31696,741
2021-07-13,Inyo,27,18085,1421,1415,4,1419,36
2021-07-13,Kern,29,883053,97932,97698,11859,109557,1346
2021-07-13,Kings,31,150075,23242,23132,1240,24372,246
2021-07-13,Lake,33,64148,3821,3719,13,3732,63
2021-07-13,Lassen,35,31185,5306,5292,127,5419,21
2021-07-13,Los Angeles,37,10098052,1223441,1217184,45618,1262802,24569
2021-07-13,Madera,39,155013,16851,16773,986,17759,240
2021-07-13,Marin,41,260295,14396,14254,279,14533,233
2021-07-13,Mariposa,43,17540,446,443,12,455,5
2021-07-13,Mendocino,45,87422,4279,4185,76,4261,49
2021-07-13,Merced,47,269075,31499,31379,1023,32402,471
2021-07-13,Modoc,49,8938,415,411,147,558,4
2021-07-13,Mono,51,14174,1262,1277,15,1292,3
2021-07-13,Monterey,53,433212,43413,43333,1981,45314,504
2021-07-13,Napa,55,140530,10169,10118,39,10157,81
2021-07-13,Nevada,57,99092,5126,5053,203,5256,72
2021-07-13,Orange,59,3164182,258609,257339,12202,269541,5136
2021-07-13,Placer,61,380077,24298,24091,1726,25817,303
2021-07-13,Plumas,63,18699,731,716,15,731,4
2021-07-13,Riverside,65,2383286,295344,294302,15152,309454,4541
2021-07-13,Sacramento,67,1510023,110903,109990,2058,112048,1687
2021-07-13,San Benito,69,59416,6184,6173,120,6293,63
2021-07-13,San Bernardino,71,2135413,296664,295596,9446,305042,5183
2021-07-13,San Diego,73,3302833,286929,284997,0,284997,3785
2021-07-13,San Francisco,75,870044,38245,37725,1479,39204,559
2021-07-13,San Joaquin,77,732212,74963,74500,3974,78474,1417
2021-07-13,San Luis Obispo,79,281455,21533,21423,814,22237,258
2021-07-13,San Mateo,81,765935,43512,43180,536,43716,542
2021-07-13,Santa Barbara,83,443738,34918,34679,1377,36056,461
2021-07-13,Santa Clara,85,1922200,120391,119727,848,120575,2098
2021-07-13,Santa Cruz,87,273765,16384,16315,881,17196,207
2021-07-13,Shasta,89,179085,12718,12659,1880,14539,209
2021-07-13,Sierra,91,2930,64,62,14,76,0
2021-07-13,Siskiyou,93,43540,1987,1916,434,2350,29
2021-07-13,Solano,95,438530,34227,33918,638,34556,268
2021-07-13,Sonoma,97,501317,31714,31431,387,31818,322
2021-07-13,Stanislaus,99,539301,57555,57282,6376,63658,1028
2021-07-13,Sutter,101,95872,9798,9752,99,9851,114
2021-07-13,Tehama,103,63373,5149,5144,651,5795,64
2021-07-13,Trinity,105,12862,376,341,72,413,3
2021-07-13,Tulare,107,460477,49999,49891,9820,59711,853
2021-07-13,Tuolumne,109,53932,4183,4122,172,4294,64
2021-07-13,Ventura,111,848112,82246,81982,3412,85394,1040
2021-07-13,Yolo,113,214977,14451,14320,431,14751,213
2021-07-13,Yuba,115,75493,6353,6279,137,6416,52
2021-07-12,Alameda,1,1643700,91763,90720,2180,92900,1254
2021-07-12,Alpine,3,1148,89,89,0,89,0
2021-07-12,Amador,5,37829,3794,3781,36,3817,47
2021-07-12,Butte,7,227075,12871,12796,2006,14802,202
2021-07-12,Calaveras,9,45235,2246,2228,18,2246,57
2021-07-12,Colusa,11,21464,1979,1971,343,2314,16
2021-07-12,Contra Costa,13,1133247,72615,71833,1431,73264,823
2021-07-12,Del Norte,15,27424,1480,1469,10,1479,8
2021-07-12,El Dorado,17,186661,10655,10569,838,11407,114
2021-07-12,Fresno,19,978130,103271,102853,9335,112188,1728
2021-07-12,Glenn,21,27897,2453,2446,594,3040,20
2021-07-12,Humboldt,23,135768,4680,4621,137,4758,51
2021-07-12,Imperial,25,180216,28875,28789,2904,31693,741
2021-07-12,Inyo,27,18085,1421,1415,4,1419,36
2021-07-12,Kern,29,883053,97863,97660,11834,109494,1346
2021-07-12,Kings,31,150075,23222,23124,1238,24362,246
2021-07-12,Lake,33,64148,3801,3706,13,3719,63
2021-07-12,Lassen,35,31185,5305,5292,127,5419,21
2021-07-12,Los Angeles,37,10098052,1221678,1216230,45473,1261703,24559
2021-07-12,Madera,39,155013,16841,16772,986,17758,240
2021-07-12,Marin,41,260295,14371,14238,278,14516,233
2021-07-12,Mariposa,43,17540,446,442,12,454,5
2021-07-12,Mendocino,45,87422,4267,4175,76,4251,49
2021-07-12,Merced,47,269075,31468,31374,1022,32396,471
2021-07-12,Modoc,49,8938,414,411,147,558,4
2021-07-12,Mono,51,14174,1260,1275,15,1290,3
2021-07-12,Monterey,53,433212,43392,43315,1977,45292,504
2021-07-12,Napa,55,140530,10151,10104,38,10142,81
2021-07-12,Nevada,57,99092,5103,5046,203,5249,72
2021-07-12,Orange,59,3164182,258260,257171,12177,269348,5136
2021-07-12,Placer,61,380077,24249,24052,1720,25772,302
2021-07-12,Plumas,63,18699,731,716,15,731,4
2021-07-12,Riverside,65,2383286,295036,294108,15123,309231,4541
2021-07-12,Sacramento,67,1510023,110687,109849,2034,111883,1685
2021-07-12,San Benito,69,59416,6181,6166,120,6286,63
2021-07-12,San Bernardino,71,2135413,296405,295447,9431,304878,5171
2021-07-12,San Diego,73,3302833,286465,284648,0,284648,3785
2021-07-12,San Francisco,75,870044,38098,37656,1475,39131,559
2021-07-12,San Joaquin,77,732212,74869,74424,3964,78388,1415
2021-07-12,San Luis Obispo,79,281455,21514,21408,813,22221,258
2021-07-12,San Mateo,81,765935,43419,43138,529,43667,542
2021-07-12,Santa Barbara,83,443738,34876,34664,1375,36039,461
2021-07-12,Santa Clara,85,1922200,120227,119634,845,120479,2098
2021-07-12,Santa Cruz,87,273765,16359,16310,880,17190,207
2021-07-12,Shasta,89,179085,12710,12648,1874,14522,208
2021-07-12,Sierra,91,2930,64,62,14,76,0
2021-07-12,Siskiyou,93,43540,1982,1916,429,2345,29
2021-07-12,Solano,95,438530,34141,33859,629,34488,268
2021-07-12,Sonoma,97,501317,31666,31377,386,31763,322
2021-07-12,Stanislaus,99,539301,57482,57243,6369,63612,1028
2021-07-12,Sutter,101,95872,9781,9736,98,9834,114
2021-07-12,Tehama,103,63373,5144,5138,650,5788,63
2021-07-12,Trinity,105,12862,372,340,70,410,3
2021-07-12,Tulare,107,460477,49972,49882,9806,59688,853
2021-07-12,Tuolumne,109,53932,4179,4116,172,4288,64
2021-07-12,Ventura,111,848112,82149,81919,3389,85308,1040
2021-07-12,Yolo,113,214977,14422,14303,427,14730,213
2021-07-12,Yuba,115,75493,6338,6266,137,6403,52
2021-07-11,Alameda,1,1643700,91439,90597,2165,92762,1254
2021-07-11,Alpine,3,1148,89,89,0,89,0
2021-07-11,Amador,5,37829,3792,3779,36,3815,47
2021-07-11,Butte,7,227075,12851,12794,1999,14793,202
2021-07-11,Calaveras,9,45235,2238,2226,17,2243,57
2021-07-11,Colusa,11,21464,1979,1971,342,2313,16
2021-07-11,Contra Costa,13,1133247,72406,71744,1424,73168,823
2021-07-11,Del Norte,15,27424,1476,1467,9,1476,8
2021-07-11,El Dorado,17,186661,10626,10554,835,11389,114
2021-07-11,Fresno,19,978130,103176,102813,9316,112129,1728
2021-07-11,Glenn,21,27897,2452,2446,594,3040,20
2021-07-11,Humboldt,23,135768,4667,4611,136,4747,51
2021-07-11,Imperial,25,180216,28857,28787,2904,31691,741
2021-07-11,Inyo,27,18085,1419,1415,4,1419,36
2021-07-11,Kern,29,883053,97790,97637,11818,109455,1346
2021-07-11,Kings,31,150075,23191,23116,1235,24351,246
2021-07-11,Lake,33,64148,3771,3699,13,3712,63
2021-07-11,Lassen,35,31185,5302,5291,127,5418,21
2021-07-11,Los Angeles,37,10098052,1219943,1215182,45308,1260490,24558
2021-07-11,Madera,39,155013,16823,16766,985,17751,240
2021-07-11,Marin,41,260295,14346,14231,278,14509,233
2021-07-11,Mariposa,43,17540,445,442,12,454,5
2021-07-11,Mendocino,45,87422,4247,4167,76,4243,49
2021-07-11,Merced,47,269075,31444,31366,1017,32383,471
2021-07-11,Modoc,49,8938,414,411,147,558,4
2021-07-11,Mono,51,14174,1260,1275,15,1290,3
2021-07-11,Monterey,53,433212,43374,43307,1972,45279,504
2021-07-11,Napa,55,140530,10147,10100,38,10138,81
2021-07-11,Nevada,57,99092,5092,5035,202,5237,72
2021-07-11,Orange,59,3164182,257956,257009,12151,269160,5136
2021-07-11,Placer,61,380077,24193,24017,1708,25725,302
2021-07-11,Plumas,63,18699,731,716,15,731,4
2021-07-11,Riverside,65,2383286,294773,293969,15105,309074,4541
2021-07-11,Sacramento,67,1510023,110416,109696,2023,111719,1685
2021-07-11,San Benito,69,59416,6176,6163,120,6283,63
2021-07-11,San Bernardino,71,2135413,296105,295342,9406,304748,5167
2021-07-11,San Diego,73,3302833,286051,283819,0,283819,3784
2021-07-11,San Francisco,75,870044,37971,37596,1469,39065,559
2021-07-11,San Joaquin,77,732212,74754,74376,3947,78323,1415
2021-07-11,San Luis Obispo,79,281455,21480,21403,812,22215,258
2021-07-11,San Mateo,81,765935,43339,43107,522,43629,542
2021-07-11,Santa Barbara,83,443738,34830,34646,1375,36021,461
2021-07-11,Santa Clara,85,1922200,120074,119549,844,120393,2098
2021-07-11,Santa Cruz,87,273765,16343,16303,880,17183,207
2021-07-11,Shasta,89,179085,12693,12647,1869,14516,208
2021-07-11,Sierra,91,2930,64,62,14,76,0
2021-07-11,Siskiyou,93,43540,1978,1915,427,2342,29
2021-07-11,Solano,95,438530,34063,33837,625,34462,268
2021-07-11,Sonoma,97,501317,31583,31352,386,31738,322
2021-07-11,Stanislaus,99,539301,57409,57230,6357,63587,1028
2021-07-11,Sutter,101,95872,9767,9728,98,9826,114
2021-07-11,Tehama,103,63373,5141,5138,649,5787,63
2021-07-11,Trinity,105,12862,371,340,70,410,3
2021-07-11,Tulare,107,460477,49948,49877,9786,59663,853
2021-07-11,Tuolumne,109,53932,4173,4116,172,4288,64
2021-07-11,Ventura,111,848112,82076,81875,3369,85244,1040
2021-07-11,Yolo,113,214977,14398,14285,419,14704,213
2021-07-11,Yuba,115,75493,6328,6260,137,6397,52
2021-07-10,Alameda,1,1643700,91294,90090,2161,92251,1252
2021-07-10,Alpine,3,1148,89,89,0,89,0
2021-07-10,Amador,5,37829,3786,3773,36,3809,47
2021-07-10,Butte,7,227075,12840,12764,1997,14761,202
2021-07-10,Calaveras,9,45235,2237,2214,17,2231,57
2021-07-10,Colusa,11,21464,1977,1969,342,2311,16
2021-07-10,Contra Costa,13,1133247,72307,71376,1423,72799,821
2021-07-10,Del Norte,15,27424,1474,1451,9,1460,8
2021-07-10,El Dorado,17,186661,10611,10508,831,11339,114
2021-07-10,Fresno,19,978130,103143,102675,9309,111984,1730
2021-07-10,Glenn,21,27897,2449,2440,593,3033,20
2021-07-10,Humboldt,23,135768,4658,4574,136,4710,51
2021-07-10,Imperial,25,180216,28844,28729,2904,31633,741
2021-07-10,Inyo,27,18085,1418,1415,4,1419,36
2021-07-10,Kern,29,883053,97751,97538,11799,109337,1346
2021-07-10,Kings,31,150075,23184,23090,1234,24324,246
2021-07-10,Lake,33,64148,3754,3667,13,3680,63
2021-07-10,Lassen,35,31185,5302,5290,127,5417,21
2021-07-10,Los Angeles,37,10098052,1218929,1212043,45203,1257246,24542
2021-07-10,Madera,39,155013,16818,16744,982,17726,241
2021-07-10,Marin,41,260295,14332,14194,278,14472,233
2021-07-10,Mariposa,43,17540,445,442,12,454,5
2021-07-10,Mendocino,45,87422,4240,4153,75,4228,49
2021-07-10,Merced,47,269075,31431,31328,1017,32345,470
2021-07-10,Modoc,49,8938,414,410,147,557,4
2021-07-10,Mono,51,14174,1260,1275,15,1290,3
2021-07-10,Monterey,53,433212,43360,43251,1970,45221,499
2021-07-10,Napa,55,140530,10135,10077,38,10115,81
2021-07-10,Nevada,57,99092,5083,5000,202,5202,72
2021-07-10,Orange,59,3164182,257786,256438,12136,268574,5135
2021-07-10,Placer,61,380077,24162,23916,1698,25614,302
2021-07-10,Plumas,63,18699,730,717,15,732,4
2021-07-10,Riverside,65,2383286,294588,293474,15092,308566,4541
2021-07-10,Sacramento,67,1510023,110264,109091,2018,111109,1682
2021-07-10,San Benito,69,59416,6171,6141,120,6261,63
2021-07-10,San Bernardino,71,2135413,295918,294932,9394,304326,5117
2021-07-10,San Diego,73,3302833,285762,283577,0,283577,3783
2021-07-10,San Francisco,75,870044,37888,37338,1464,38802,559
2021-07-10,San Joaquin,77,732212,74696,74150,3941,78091,1412
2021-07-10,San Luis Obispo,79,281455,21469,21375,811,22186,258
2021-07-10,San Mateo,81,765935,43289,42948,520,43468,542
2021-07-10,Santa Barbara,83,443738,34805,34595,1375,35970,460
2021-07-10,Santa Clara,85,1922200,119973,119330,840,120170,2094
2021-07-10,Santa Cruz,87,273765,16336,16286,880,17166,207
2021-07-10,Shasta,89,179085,12681,12623,1864,14487,206
2021-07-10,Sierra,91,2930,64,61,14,75,0
2021-07-10,Siskiyou,93,43540,1976,1909,424,2333,29
2021-07-10,Solano,95,438530,34023,33678,619,34297,268
2021-07-10,Sonoma,97,501317,31531,31231,386,31617,317
2021-07-10,Stanislaus,99,539301,57368,57104,6347,63451,1026
2021-07-10,Sutter,101,95872,9754,9692,98,9790,114
2021-07-10,Tehama,103,63373,5138,5131,649,5780,63
2021-07-10,Trinity,105,12862,371,341,70,411,3
2021-07-10,Tulare,107,460477,49938,49850,9780,59630,853
2021-07-10,Tuolumne,109,53932,4171,4114,172,4286,64
2021-07-10,Ventura,111,848112,82031,81713,3351,85064,1039
2021-07-10,Yolo,113,214977,14377,14250,416,14666,213
2021-07-10,Yuba,115,75493,6318,6238,137,6375,52
2021-07-09,Alameda,1,1643700,91142,90090,2155,92245,1252
2021-07-09,Alpine,3,1148,89,89,0,89,0
2021-07-09,Amador,5,37829,3785,3773,36,3809,47
2021-07-09,Butte,7,227075,12829,12764,1995,14759,202
2021-07-09,Calaveras,9,45235,2235,2214,17,2231,57
2021-07-09,Colusa,11,21464,1976,1969,342,2311,16
2021-07-09,Contra Costa,13,1133247,72182,71376,1422,72798,821
2021-07-09,Del Norte,15,27424,1470,1451,9,1460,8
2021-07-09,El Dorado,17,186661,10597,10508,829,11337,114
2021-07-09,Fresno,19,978130,103087,102675,9302,111977,1730
2021-07-09,Glenn,21,27897,2448,2440,591,3031,20
2021-07-09,Humboldt,23,135768,4639,4574,136,4710,51
2021-07-09,Imperial,25,180216,28835,28729,2904,31633,741
2021-07-09,Inyo,27,18085,1417,1415,4,1419,36
2021-07-09,Kern,29,883053,97713,97538,11787,109325,1346
2021-07-09,Kings,31,150075,23174,23090,1233,24323,246
2021-07-09,Lake,33,64148,3740,3667,13,3680,63
2021-07-09,Lassen,35,31185,5300,5290,126,5416,21
2021-07-09,Los Angeles,37,10098052,1217930,1212043,45125,1257168,24542
2021-07-09,Madera,39,155013,16809,16744,981,17725,241
2021-07-09,Marin,41,260295,14312,14194,276,14470,233
2021-07-09,Mariposa,43,17540,445,442,12,454,5
2021-07-09,Mendocino,45,87422,4233,4153,75,4228,49
2021-07-09,Merced,47,269075,31416,31328,1017,32345,470
2021-07-09,Modoc,49,8938,414,410,147,557,4
2021-07-09,Mono,51,14174,1260,1275,15,1290,3
2021-07-09,Monterey,53,433212,43351,43251,1970,45221,499
2021-07-09,Napa,55,140530,10128,10077,38,10115,81
2021-07-09,Nevada,57,99092,5074,5000,202,5202,72
2021-07-09,Orange,59,3164182,257584,256438,12122,268560,5135
2021-07-09,Placer,61,380077,24140,23916,1692,25608,302
2021-07-09,Plumas,63,18699,728,717,15,732,4
2021-07-09,Riverside,65,2383286,294401,293474,15078,308552,4541
2021-07-09,Sacramento,67,1510023,110113,109091,2010,111101,1682
2021-07-09,San Benito,69,59416,6169,6141,120,6261,63
2021-07-09,San Bernardino,71,2135413,295770,294932,9387,304319,5117
2021-07-09,San Diego,73,3302833,285476,283577,0,283577,3783
2021-07-09,San Francisco,75,870044,37810,37338,1456,38794,559
2021-07-09,San Joaquin,77,732212,74624,74150,3933,78083,1412
2021-07-09,San Luis Obispo,79,281455,21457,21375,811,22186,258
2021-07-09,San Mateo,81,765935,43245,42948,515,43463,542
2021-07-09,Santa Barbara,83,443738,34788,34595,1374,35969,460
2021-07-09,Santa Clara,85,1922200,119863,119330,840,120170,2094
2021-07-09,Santa Cruz,87,273765,16333,16286,880,17166,207
2021-07-09,Shasta,89,179085,12675,12623,1859,14482,206
2021-07-09,Sierra,91,2930,64,61,14,75,0
2021-07-09,Siskiyou,93,43540,1974,1909,423,2332,29
2021-07-09,Solano,95,438530,33988,33678,615,34293,268
2021-07-09,Sonoma,97,501317,31495,31231,386,31617,317
2021-07-09,Stanislaus,99,539301,57326,57104,6345,63449,1026
2021-07-09,Sutter,101,95872,9745,9692,98,9790,114
2021-07-09,Tehama,103,63373,5136,5131,649,5780,63
2021-07-09,Trinity,105,12862,370,341,67,408,3
2021-07-09,Tulare,107,460477,49925,49850,9774,59624,853
2021-07-09,Tuolumne,109,53932,4168,4114,172,4286,64
2021-07-09,Ventura,111,848112,81977,81713,3342,85055,1039
2021-07-09,Yolo,113,214977,14362,14250,412,14662,213
2021-07-09,Yuba,115,75493,6305,6238,137,6375,52
2021-07-08,Alameda,1,1643700,90936,90090,2150,92240,1252
2021-07-08,Alpine,3,1148,89,89,0,89,0
2021-07-08,Amador,5,37829,3783,3773,36,3809,47
2021-07-08,Butte,7,227075,12816,12764,1993,14757,202
2021-07-08,Calaveras,9,45235,2229,2214,16,2230,57
2021-07-08,Colusa,11,21464,1976,1969,342,2311,16
2021-07-08,Contra Costa,13,1133247,72054,71376,1417,72793,821
2021-07-08,Del Norte,15,27424,1468,1451,9,1460,8
2021-07-08,El Dorado,17,186661,10580,10508,824,11332,114
2021-07-08,Fresno,19,978130,103028,102675,9291,111966,1730
2021-07-08,Glenn,21,27897,2448,2440,591,3031,20
2021-07-08,Humboldt,23,135768,4624,4574,135,4709,51
2021-07-08,Imperial,25,180216,28822,28729,2903,31632,741
2021-07-08,Inyo,27,18085,1417,1415,4,1419,36
2021-07-08,Kern,29,883053,97669,97538,11769,109307,1346
2021-07-08,Kings,31,150075,23165,23090,1233,24323,246
2021-07-08,Lake,33,64148,3726,3667,13,3680,63
2021-07-08,Lassen,35,31185,5297,5290,126,5416,21
2021-07-08,Los Angeles,37,10098052,1216728,1212043,45026,1257069,24542
2021-07-08,Madera,39,155013,16794,16744,981,17725,241
2021-07-08,Marin,41,260295,14297,14194,276,14470,233
2021-07-08,Mariposa,43,17540,444,442,12,454,5
2021-07-08,Mendocino,45,87422,4229,4153,75,4228,49
2021-07-08,Merced,47,269075,31402,31328,1015,32343,470
2021-07-08,Modoc,49,8938,414,410,147,557,4
2021-07-08,Mono,51,14174,1260,1275,15,1290,3
2021-07-08,Monterey,53,433212,43331,43251,1964,45215,499
2021-07-08,Napa,55,140530,10124,10077,38,10115,81
2021-07-08,Nevada,57,99092,5068,5000,202,5202,72
2021-07-08,Orange,59,3164182,257394,256438,12102,268540,5135
2021-07-08,Placer,61,380077,24102,23916,1684,25600,302
2021-07-08,Plumas,63,18699,727,717,15,732,4
2021-07-08,Riverside,65,2383286,294203,293474,15066,308540,4541
2021-07-08,Sacramento,67,1510023,109894,109091,2002,111093,1682
2021-07-08,San Benito,69,59416,6166,6141,120,6261,63
2021-07-08,San Bernardino,71,2135413,295597,294932,9378,304310,5117
2021-07-08,San Diego,73,3302833,285148,283577,0,283577,3783
2021-07-08,San Francisco,75,870044,37732,37338,1451,38789,559
2021-07-08,San Joaquin,77,732212,74536,74150,3922,78072,1412
2021-07-08,San Luis Obispo,79,281455,21445,21375,808,22183,258
2021-07-08,San Mateo,81,765935,43194,42948,514,43462,542
2021-07-08,Santa Barbara,83,443738,34763,34595,1372,35967,460
2021-07-08,Santa Clara,85,1922200,119770,119330,839,120169,2094
2021-07-08,Santa Cruz,87,273765,16327,16286,880,17166,207
2021-07-08,Shasta,89,179085,12669,12623,1852,14475,206
2021-07-08,Sierra,91,2930,64,61,14,75,0
2021-07-08,Siskiyou,93,43540,1969,1909,420,2329,29
2021-07-08,Solano,95,438530,33936,33678,607,34285,268
2021-07-08,Sonoma,97,501317,31464,31231,385,31616,317
2021-07-08,Stanislaus,99,539301,57292,57104,6340,63444,1026
2021-07-08,Sutter,101,95872,9730,9692,96,9788,114
2021-07-08,Tehama,103,63373,5133,5131,648,5779,63
2021-07-08,Trinity,105,12862,370,341,67,408,3
2021-07-08,Tulare,107,460477,49908,49850,9765,59615,853
2021-07-08,Tuolumne,109,53932,4166,4114,172,4286,64
2021-07-08,Ventura,111,848112,81913,81713,3325,85038,1039
2021-07-08,Yolo,113,214977,14344,14250,410,14660,213
2021-07-08,Yuba,115,75493,6297,6238,137,6375,52
2021-07-07,Alameda,1,1643700,90754,89995,2143,92138,1253
2021-07-07,Alpine,3,1148,89,89,0,89,0
2021-07-07,Amador,5,37829,3778,3770,36,3806,47
2021-07-07,Butte,7,227075,12803,12750,1987,14737,202
2021-07-07,Calaveras,9,45235,2225,2212,16,2228,57
2021-07-07,Colusa,11,21464,1972,1969,342,2311,16
2021-07-07,Contra Costa,13,1133247,71910,71308,1415,72723,821
2021-07-07,Del Norte,15,27424,1463,1446,9,1455,8
2021-07-07,El Dorado,17,186661,10560,10494,822,11316,114
2021-07-07,Fresno,19,978130,102978,102639,9283,111922,1729
2021-07-07,Glenn,21,27897,2448,2441,591,3032,20
2021-07-07,Humboldt,23,135768,4610,4566,135,4701,51
2021-07-07,Imperial,25,180216,28813,28701,2903,31604,740
2021-07-07,Inyo,27,18085,1416,1415,4,1419,36
2021-07-07,Kern,29,883053,97627,97507,11754,109261,1348
2021-07-07,Kings,31,150075,23153,23085,1229,24314,245
2021-07-07,Lake,33,64148,3707,3660,13,3673,63
2021-07-07,Lassen,35,31185,5297,5286,126,5412,21
2021-07-07,Los Angeles,37,10098052,1215563,1211316,44914,1256230,24531
2021-07-07,Madera,39,155013,16784,16733,979,17712,241
2021-07-07,Marin,41,260295,14277,14183,275,14458,233
2021-07-07,Mariposa,43,17540,442,442,12,454,5
2021-07-07,Mendocino,45,87422,4220,4145,75,4220,49
2021-07-07,Merced,47,269075,31387,31317,1015,32332,470
2021-07-07,Modoc,49,8938,414,410,147,557,4
2021-07-07,Mono,51,14174,1259,1274,15,1289,3
2021-07-07,Monterey,53,433212,43307,43233,1962,45195,494
2021-07-07,Napa,55,140530,10113,10078,38,10116,81
2021-07-07,Nevada,57,99092,5061,4996,202,5198,72
2021-07-07,Orange,59,3164182,257171,256301,12081,268382,5132
2021-07-07,Placer,61,380077,24064,23901,1674,25575,302
2021-07-07,Plumas,63,18699,727,710,15,725,4
2021-07-07,Riverside,65,2383286,293989,293331,15055,308386,4538
2021-07-07,Sacramento,67,1510023,109705,108954,1994,110948,1682
2021-07-07,San Benito,69,59416,6161,6137,120,6257,63
2021-07-07,San Bernardino,71,2135413,295425,294787,9371,304158,5087
2021-07-07,San Diego,73,3302833,284830,283377,0,283377,3782
2021-07-07,San Francisco,75,870044,37641,37284,1448,38732,558
2021-07-07,San Joaquin,77,732212,74461,74095,3906,78001,1410
2021-07-07,San Luis Obispo,79,281455,21436,21360,806,22166,258
2021-07-07,San Mateo,81,765935,43140,42908,511,43419,542
2021-07-07,Santa Barbara,83,443738,34737,34582,1370,35952,460
2021-07-07,Santa Clara,85,1922200,119672,119250,838,120088,2094
2021-07-07,Santa Cruz,87,273765,16318,16279,879,17158,207
2021-07-07,Shasta,89,179085,12661,12613,1849,14462,206
2021-07-07,Sierra,91,2930,64,60,14,74,0
2021-07-07,Siskiyou,93,43540,1963,1908,416,2324,29
2021-07-07,Solano,95,438530,33888,33659,600,34259,268
2021-07-07,Sonoma,97,501317,31418,31172,385,31557,316
2021-07-07,Stanislaus,99,539301,57247,57102,6335,63437,1028
2021-07-07,Sutter,101,95872,9720,9683,96,9779,114
2021-07-07,Tehama,103,63373,5132,5129,647,5776,63
2021-07-07,Trinity,105,12862,370,341,67,408,3
2021-07-07,Tulare,107,460477,49904,49835,9756,59591,853
2021-07-07,Tuolumne,109,53932,4162,4115,171,4286,64
2021-07-07,Ventura,111,848112,81869,81608,3310,84918,1036
2021-07-07,Yolo,113,214977,14334,14236,407,14643,213
2021-07-07,Yuba,115,75493,6281,6233,137,6370,51
2021-07-06,Alameda,1,1643700,90559,89918,2134,92052,1253
2021-07-06,Alpine,3,1148,89,89,0,89,0
2021-07-06,Amador,5,37829,3777,3768,35,3803,47
2021-07-06,Butte,7,227075,12790,12744,1984,14728,201
2021-07-06,Calaveras,9,45235,2225,2211,16,2227,55
2021-07-06,Colusa,11,21464,1971,1967,339,2306,16
2021-07-06,Contra Costa,13,1133247,71782,71262,1413,72675,820
2021-07-06,Del Norte,15,27424,1459,1445,9,1454,8
2021-07-06,El Dorado,17,186661,10543,10484,821,11305,113
2021-07-06,Fresno,19,978130,102927,102616,9272,111888,1727
2021-07-06,Glenn,21,27897,2447,2438,591,3029,20
2021-07-06,Humboldt,23,135768,4596,4565,134,4699,49
2021-07-06,Imperial,25,180216,28799,28693,2901,31594,739
2021-07-06,Inyo,27,18085,1416,1412,4,1416,36
2021-07-06,Kern,29,883053,97586,97491,11743,109234,1346
2021-07-06,Kings,31,150075,23145,23077,1228,24305,245
2021-07-06,Lake,33,64148,3697,3659,13,3672,63
2021-07-06,Lassen,35,31185,5296,5288,125,5413,21
2021-07-06,Los Angeles,37,10098052,1214356,1210965,44815,1255780,24525
2021-07-06,Madera,39,155013,16774,16730,979,17709,241
2021-07-06,Marin,41,260295,14263,14181,275,14456,233
2021-07-06,Mariposa,43,17540,442,442,12,454,5
2021-07-06,Mendocino,45,87422,4213,4143,75,4218,49
2021-07-06,Merced,47,269075,31370,31317,1014,32331,470
2021-07-06,Modoc,49,8938,414,411,147,558,4
2021-07-06,Mono,51,14174,1257,1274,15,1289,3
2021-07-06,Monterey,53,433212,43285,43224,1961,45185,494
2021-07-06,Napa,55,140530,10102,10081,38,10119,81
2021-07-06,Nevada,57,99092,5052,4988,202,5190,72
2021-07-06,Orange,59,3164182,256932,256227,12063,268290,5129
2021-07-06,Placer,61,380077,24023,23876,1668,25544,302
2021-07-06,Plumas,63,18699,726,708,15,723,4
2021-07-06,Riverside,65,2383286,293783,293227,15036,308263,4539
2021-07-06,Sacramento,67,1510023,109498,108850,1986,110836,1679
2021-07-06,San Benito,69,59416,6157,6137,120,6257,63
2021-07-06,San Bernardino,71,2135413,295250,294712,9358,304070,5056
2021-07-06,San Diego,73,3302833,284475,283278,0,283278,3782
2021-07-06,San Francisco,75,870044,37525,37251,1445,38696,558
2021-07-06,San Joaquin,77,732212,74392,74019,3894,77913,1410
2021-07-06,San Luis Obispo,79,281455,21419,21354,805,22159,257
2021-07-06,San Mateo,81,765935,43065,42895,511,43406,541
2021-07-06,Santa Barbara,83,443738,34720,34572,1368,35940,460
2021-07-06,Santa Clara,85,1922200,119554,119194,836,120030,2095
2021-07-06,Santa Cruz,87,273765,16313,16274,878,17152,207
2021-07-06,Shasta,89,179085,12651,12606,1843,14449,205
2021-07-06,Sierra,91,2930,63,60,14,74,0
2021-07-06,Siskiyou,93,43540,1960,1905,412,2317,29
2021-07-06,Solano,95,438530,33838,33619,597,34216,268
2021-07-06,Sonoma,97,501317,31353,31130,384,31514,316
2021-07-06,Stanislaus,99,539301,57185,57120,6323,63443,1029
2021-07-06,Sutter,101,95872,9711,9674,95,9769,114
2021-07-06,Tehama,103,63373,5129,5126,646,5772,63
2021-07-06,Trinity,105,12862,370,341,67,408,3
2021-07-06,Tulare,107,460477,49889,49826,9745,59571,853
2021-07-06,Tuolumne,109,53932,4160,4113,171,4284,64
2021-07-06,Ventura,111,848112,81830,81534,3284,84818,1033
2021-07-06,Yolo,113,214977,14313,14227,402,14629,213
2021-07-06,Yuba,115,75493,6270,6231,137,6368,51
2021-07-05,Alameda,1,1643700,90383,89892,2128,92020,1253
2021-07-05,Alpine,3,1148,89,89,0,89,0
2021-07-05,Amador,5,37829,3775,3768,35,3803,47
2021-07-05,Butte,7,227075,12782,12740,1974,14714,201
2021-07-05,Calaveras,9,45235,2223,2211,16,2227,55
2021-07-05,Colusa,11,21464,1969,1966,338,2304,16
2021-07-05,Contra Costa,13,1133247,71656,71235,1413,72648,820
2021-07-05,Del Norte,15,27424,1455,1446,9,1455,8
2021-07-05,El Dorado,17,186661,10518,10481,821,11302,113
2021-07-05,Fresno,19,978130,102871,102592,9253,111845,1727
2021-07-05,Glenn,21,27897,2444,2438,590,3028,20
2021-07-05,Humboldt,23,135768,4582,4563,134,4697,49
2021-07-05,Imperial,25,180216,28780,28689,2901,31590,739
2021-07-05,Inyo,27,18085,1416,1412,4,1416,36
2021-07-05,Kern,29,883053,97538,97479,11722,109201,1346
2021-07-05,Kings,31,150075,23137,23065,1225,24290,245
2021-07-05,Lake,33,64148,3679,3645,13,3658,63
2021-07-05,Lassen,35,31185,5293,5288,123,5411,21
2021-07-05,Los Angeles,37,10098052,1213180,1210653,44706,1255359,24522
2021-07-05,Madera,39,155013,16764,16722,978,17700,241
2021-07-05,Marin,41,260295,14241,14178,275,14453,233
2021-07-05,Mariposa,43,17540,442,441,12,453,5
2021-07-05,Mendocino,45,87422,4208,4139,75,4214,49
2021-07-05,Merced,47,269075,31350,31312,1014,32326,470
2021-07-05,Modoc,49,8938,414,410,147,557,4
2021-07-05,Mono,51,14174,1257,1273,15,1288,3
2021-07-05,Monterey,53,433212,43265,43218,1956,45174,494
2021-07-05,Napa,55,140530,10096,10074,38,10112,81
2021-07-05,Nevada,57,99092,5034,4980,201,5181,72
2021-07-05,Orange,59,3164182,256736,256173,12043,268216,5129
2021-07-05,Placer,61,380077,23977,23867,1660,25527,302
2021-07-05,Plumas,63,18699,725,708,15,723,4
2021-07-05,Riverside,65,2383286,293589,293193,15023,308216,4539
2021-07-05,Sacramento,67,1510023,109317,108758,1977,110735,1679
2021-07-05,San Benito,69,59416,6150,6137,120,6257,63
2021-07-05,San Bernardino,71,2135413,295091,294647,9351,303998,5037
2021-07-05,San Diego,73,3302833,284114,282834,0,282834,3782
2021-07-05,San Francisco,75,870044,37438,37237,1440,38677,558
2021-07-05,San Joaquin,77,732212,74322,73999,3888,77887,1410
2021-07-05,San Luis Obispo,79,281455,21406,21351,804,22155,257
2021-07-05,San Mateo,81,765935,43013,42876,508,43384,541
2021-07-05,Santa Barbara,83,443738,34700,34569,1368,35937,460
2021-07-05,Santa Clara,85,1922200,119450,119184,834,120018,2095
2021-07-05,Santa Cruz,87,273765,16303,16273,877,17150,208
2021-07-05,Shasta,89,179085,12642,12603,1839,14442,205
2021-07-05,Sierra,91,2930,63,60,14,74,0
2021-07-05,Siskiyou,93,43540,1959,1904,410,2314,29
2021-07-05,Solano,95,438530,33769,33612,591,34203,268
2021-07-05,Sonoma,97,501317,31300,31116,383,31499,316
2021-07-05,Stanislaus,99,539301,57149,57109,6313,63422,1029
2021-07-05,Sutter,101,95872,9699,9667,95,9762,114
2021-07-05,Tehama,103,63373,5128,5125,646,5771,63
2021-07-05,Trinity,105,12862,369,341,66,407,3
2021-07-05,Tulare,107,460477,49871,49818,9742,59560,853
2021-07-05,Tuolumne,109,53932,4156,4112,171,4283,64
2021-07-05,Ventura,111,848112,81781,81519,3263,84782,1033
2021-07-05,Yolo,113,214977,14296,14225,393,14618,213
2021-07-05,Yuba,115,75493,6262,6223,137,6360,51
2021-07-04,Alameda,1,1643700,90216,89683,2123,91806,1253
2021-07-04,Alpine,3,1148,89,89,0,89,0
2021-07-04,Amador,5,37829,3774,3758,35,3793,46
2021-07-04,Butte,7,227075,12772,12684,1974,14658,201
2021-07-04,Calaveras,9,45235,2223,2200,16,2216,55
2021-07-04,Colusa,11,21464,1969,1969,338,2307,15
2021-07-04,Contra Costa,13,1133247,71552,70941,1408,72349,818
2021-07-04,Del Norte,15,27424,1452,1439,9,1448,8
2021-07-04,El Dorado,17,186661,10509,10433,820,11253,113
2021-07-04,Fresno,19,978130,102827,102512,9234,111746,1727
2021-07-04,Glenn,21,27897,2442,2442,589,3031,20
2021-07-04,Humboldt,23,135768,4574,4530,134,4664,49
2021-07-04,Imperial,25,180216,28774,28661,2901,31562,739
2021-07-04,Inyo,27,18085,1416,1412,4,1416,35
2021-07-04,Kern,29,883053,97520,97421,11712,109133,1347
2021-07-04,Kings,31,150075,23129,23051,1225,24276,245
2021-07-04,Lake,33,64148,3669,3623,13,3636,62
2021-07-04,Lassen,35,31185,5292,5277,123,5400,20
2021-07-04,Los Angeles,37,10098052,1212341,1208705,44610,1253315,24506
2021-07-04,Madera,39,155013,16752,16696,976,17672,240
2021-07-04,Marin,41,260295,14227,14143,275,14418,233
2021-07-04,Mariposa,43,17540,442,441,12,453,5
2021-07-04,Mendocino,45,87422,4198,4122,75,4197,49
2021-07-04,Merced,47,269075,31339,31297,1014,32311,469
2021-07-04,Modoc,49,8938,414,410,147,557,4
2021-07-04,Mono,51,14174,1257,1275,15,1290,3
2021-07-04,Monterey,53,433212,43249,43212,1955,45167,492
2021-07-04,Napa,55,140530,10088,10045,37,10082,81
2021-07-04,Nevada,57,99092,5025,4966,201,5167,72
2021-07-04,Orange,59,3164182,256565,255823,12022,267845,5126
2021-07-04,Placer,61,380077,23939,23764,1652,25416,299
2021-07-04,Plumas,63,18699,725,707,15,722,4
2021-07-04,Riverside,65,2383286,293431,293260,15015,308275,4536
2021-07-04,Sacramento,67,1510023,109153,108257,1972,110229,1676
2021-07-04,San Benito,69,59416,6143,6108,120,6228,63
2021-07-04,San Bernardino,71,2135413,294931,294294,9344,303638,5003
2021-07-04,San Diego,73,3302833,283889,282692,0,282692,3780
2021-07-04,San Francisco,75,870044,37384,37107,1433,38540,558
2021-07-04,San Joaquin,77,732212,74255,73841,3880,77721,1409
2021-07-04,San Luis Obispo,79,281455,21400,21330,803,22133,256
2021-07-04,San Mateo,81,765935,42980,42691,508,43199,541
2021-07-04,Santa Barbara,83,443738,34679,34526,1367,35893,456
2021-07-04,Santa Clara,85,1922200,119360,118966,833,119799,2090
2021-07-04,Santa Cruz,87,273765,16292,16254,877,17131,208
2021-07-04,Shasta,89,179085,12638,12582,1838,14420,204
2021-07-04,Sierra,91,2930,62,60,14,74,0
2021-07-04,Siskiyou,93,43540,1955,1899,409,2308,29
2021-07-04,Solano,95,438530,33728,33486,589,34075,268
2021-07-04,Sonoma,97,501317,31270,31000,382,31382,316
2021-07-04,Stanislaus,99,539301,57126,57018,6307,63325,1018
2021-07-04,Sutter,101,95872,9688,9644,95,9739,114
2021-07-04,Tehama,103,63373,5124,5124,645,5769,63
2021-07-04,Trinity,105,12862,368,341,66,407,3
2021-07-04,Tulare,107,460477,49861,49789,9739,59528,853
2021-07-04,Tuolumne,109,53932,4148,4113,171,4284,64
2021-07-04,Ventura,111,848112,81727,81425,3252,84677,1033
2021-07-04,Yolo,113,214977,14277,14188,390,14578,213
2021-07-04,Yuba,115,75493,6254,6197,137,6334,51
2021-07-03,Alameda,1,1643700,90135,89683,2116,91799,1253
2021-07-03,Alpine,3,1148,89,89,0,89,0
2021-07-03,Amador,5,37829,3774,3758,35,3793,46
2021-07-03,Butte,7,227075,12768,12684,1973,14657,201
2021-07-03,Calaveras,9,45235,2222,2200,16,2216,55
2021-07-03,Colusa,11,21464,1969,1969,337,2306,15
2021-07-03,Contra Costa,13,1133247,71493,70941,1405,72346,818
2021-07-03,Del Norte,15,27424,1449,1439,9,1448,8
2021-07-03,El Dorado,17,186661,10502,10433,818,11251,113
2021-07-03,Fresno,19,978130,102802,102512,9225,111737,1727
2021-07-03,Glenn,21,27897,2442,2442,589,3031,20
2021-07-03,Humboldt,23,135768,4569,4530,134,4664,49
2021-07-03,Imperial,25,180216,28764,28661,2901,31562,739
2021-07-03,Inyo,27,18085,1416,1412,4,1416,35
2021-07-03,Kern,29,883053,97500,97421,11704,109125,1347
2021-07-03,Kings,31,150075,23129,23051,1224,24275,245
2021-07-03,Lake,33,64148,3659,3623,13,3636,62
2021-07-03,Lassen,35,31185,5291,5277,123,5400,20
2021-07-03,Los Angeles,37,10098052,1211918,1208705,44580,1253285,24506
2021-07-03,Madera,39,155013,16744,16696,973,17669,240
2021-07-03,Marin,41,260295,14223,14143,275,14418,233
2021-07-03,Mariposa,43,17540,442,441,12,453,5
2021-07-03,Mendocino,45,87422,4197,4122,75,4197,49
2021-07-03,Merced,47,269075,31326,31297,1013,32310,469
2021-07-03,Modoc,49,8938,413,410,147,557,4
2021-07-03,Mono,51,14174,1256,1275,15,1290,3
2021-07-03,Monterey,53,433212,43237,43212,1952,45164,492
2021-07-03,Napa,55,140530,10083,10045,37,10082,81
2021-07-03,Nevada,57,99092,5011,4966,201,5167,72
2021-07-03,Orange,59,3164182,256482,255823,12015,267838,5126
2021-07-03,Placer,61,380077,23920,23764,1649,25413,299
2021-07-03,Plumas,63,18699,725,707,15,722,4
2021-07-03,Riverside,65,2383286,293340,293260,15010,308270,4536
2021-07-03,Sacramento,67,1510023,109079,108257,1969,110226,1676
2021-07-03,San Benito,69,59416,6136,6108,120,6228,63
2021-07-03,San Bernardino,71,2135413,294844,294294,9341,303635,5003
2021-07-03,San Diego,73,3302833,283757,282692,0,282692,3780
2021-07-03,San Francisco,75,870044,37343,37107,1430,38537,558
2021-07-03,San Joaquin,77,732212,74220,73841,3874,77715,1409
2021-07-03,San Luis Obispo,79,281455,21388,21330,803,22133,256
2021-07-03,San Mateo,81,765935,42955,42691,507,43198,541
2021-07-03,Santa Barbara,83,443738,34670,34526,1366,35892,456
2021-07-03,Santa Clara,85,1922200,119314,118966,833,119799,2090
2021-07-03,Santa Cruz,87,273765,16285,16254,877,17131,208
2021-07-03,Shasta,89,179085,12634,12582,1836,14418,204
2021-07-03,Sierra,91,2930,62,60,14,74,0
2021-07-03,Siskiyou,93,43540,1954,1899,408,2307,29
2021-07-03,Solano,95,438530,33686,33486,589,34075,268
2021-07-03,Sonoma,97,501317,31236,31000,382,31382,316
2021-07-03,Stanislaus,99,539301,57112,57018,6299,63317,1018
2021-07-03,Sutter,101,95872,9678,9644,95,9739,114
2021-07-03,Tehama,103,63373,5122,5124,645,5769,63
2021-07-03,Trinity,105,12862,368,341,66,407,3
2021-07-03,Tulare,107,460477,49856,49789,9732,59521,853
2021-07-03,Tuolumne,109,53932,4147,4113,171,4284,64
2021-07-03,Ventura,111,848112,81696,81425,3244,84669,1033
2021-07-03,Yolo,113,214977,14267,14188,387,14575,213
2021-07-03,Yuba,115,75493,6248,6197,137,6334,51
2021-07-02,Alameda,1,1643700,90053,89683,2115,91798,1253
2021-07-02,Alpine,3,1148,89,89,0,89,0
2021-07-02,Amador,5,37829,3772,3758,35,3793,46
2021-07-02,Butte,7,227075,12761,12684,1973,14657,201
2021-07-02,Calaveras,9,45235,2221,2200,16,2216,55
2021-07-02,Colusa,11,21464,1968,1969,336,2305,15
2021-07-02,Contra Costa,13,1133247,71423,70941,1401,72342,818
2021-07-02,Del Norte,15,27424,1449,1439,9,1448,8
2021-07-02,El Dorado,17,186661,10494,10433,818,11251,113
2021-07-02,Fresno,19,978130,102772,102512,9219,111731,1727
2021-07-02,Glenn,21,27897,2441,2442,588,3030,20
2021-07-02,Humboldt,23,135768,4566,4530,133,4663,49
2021-07-02,Imperial,25,180216,28758,28661,2900,31561,739
2021-07-02,Inyo,27,18085,1416,1412,4,1416,35
2021-07-02,Kern,29,883053,97482,97421,11695,109116,1347
2021-07-02,Kings,31,150075,23119,23051,1224,24275,245
2021-07-02,Lake,33,64148,3653,3623,13,3636,62
2021-07-02,Lassen,35,31185,5291,5277,123,5400,20
2021-07-02,Los Angeles,37,10098052,1211450,1208705,44541,1253246,24506
2021-07-02,Madera,39,155013,16735,16696,972,17668,240
2021-07-02,Marin,41,260295,14218,14143,275,14418,233
2021-07-02,Mariposa,43,17540,442,441,12,453,5
2021-07-02,Mendocino,45,87422,4193,4122,74,4196,49
2021-07-02,Merced,47,269075,31317,31297,1013,32310,469
2021-07-02,Modoc,49,8938,413,410,147,557,4
2021-07-02,Mono,51,14174,1255,1275,15,1290,3
2021-07-02,Monterey,53,433212,43229,43212,1951,45163,492
2021-07-02,Napa,55,140530,10078,10045,37,10082,81
2021-07-02,Nevada,57,99092,5002,4966,201,5167,72
2021-07-02,Orange,59,3164182,256370,255823,12008,267831,5126
2021-07-02,Placer,61,380077,23903,23764,1642,25406,299
2021-07-02,Plumas,63,18699,725,707,15,722,4
2021-07-02,Riverside,65,2383286,293243,293260,15005,308265,4536
2021-07-02,Sacramento,67,1510023,108998,108257,1968,110225,1676
2021-07-02,San Benito,69,59416,6133,6108,120,6228,63
2021-07-02,San Bernardino,71,2135413,294752,294294,9339,303633,5003
2021-07-02,San Diego,73,3302833,283611,282692,0,282692,3780
2021-07-02,San Francisco,75,870044,37296,37107,1428,38535,558
2021-07-02,San Joaquin,77,732212,74188,73841,3868,77709,1409
2021-07-02,San Luis Obispo,79,281455,21382,21330,802,22132,256
2021-07-02,San Mateo,81,765935,42919,42691,507,43198,541
2021-07-02,Santa Barbara,83,443738,34661,34526,1366,35892,456
2021-07-02,Santa Clara,85,1922200,119236,118966,833,119799,2090
2021-07-02,Santa Cruz,87,273765,16281,16254,877,17131,208
2021-07-02,Shasta,89,179085,12630,12582,1836,14418,204
2021-07-02,Sierra,91,2930,61,60,14,74,0
2021-07-02,Siskiyou,93,43540,1951,1899,407,2306,29
2021-07-02,Solano,95,438530,33661,33486,589,34075,268
2021-07-02,Sonoma,97,501317,31213,31000,382,31382,316
2021-07-02,Stanislaus,99,539301,57090,57018,6298,63316,1018
2021-07-02,Sutter,101,95872,9673,9644,95,9739,114
2021-07-02,Tehama,103,63373,5120,5124,643,5767,63
2021-07-02,Trinity,105,12862,368,341,66,407,3
2021-07-02,Tulare,107,460477,49846,49789,9724,59513,853
2021-07-02,Tuolumne,109,53932,4144,4113,171,4284,64
2021-07-02,Ventura,111,848112,81654,81425,3236,84661,1033
2021-07-02,Yolo,113,214977,14252,14188,385,14573,213
2021-07-02,Yuba,115,75493,6240,6197,137,6334,51
2021-07-01,Alameda,1,1643700,89948,89683,2113,91796,1253
2021-07-01,Alpine,3,1148,89,89,0,89,0
2021-07-01,Amador,5,37829,3771,3758,35,3793,46
2021-07-01,Butte,7,227075,12749,12684,1971,14655,201
2021-07-01,Calaveras,9,45235,2219,2200,16,2216,55
2021-07-01,Colusa,11,21464,1968,1969,334,2303,15
2021-07-01,Contra Costa,13,1133247,71352,70941,1400,72341,818
2021-07-01,Del Norte,15,27424,1448,1439,9,1448,8
2021-07-01,El Dorado,17,186661,10482,10433,818,11251,113
2021-07-01,Fresno,19,978130,102733,102512,9214,111726,1727
2021-07-01,Glenn,21,27897,2441,2442,588,3030,20
2021-07-01,Humboldt,23,135768,4564,4530,133,4663,49
2021-07-01,Imperial,25,180216,28741,28661,2900,31561,739
2021-07-01,Inyo,27,18085,1416,1412,4,1416,35
2021-07-01,Kern,29,883053,97456,97421,11684,109105,1347
2021-07-01,Kings,31,150075,23105,23051,1224,24275,245
2021-07-01,Lake,33,64148,3650,3623,13,3636,62
2021-07-01,Lassen,35,31185,5289,5277,123,5400,20
2021-07-01,Los Angeles,37,10098052,1210857,1208705,44485,1253190,24506
2021-07-01,Madera,39,155013,16726,16696,971,17667,240
2021-07-01,Marin,41,260295,14214,14143,275,14418,233
2021-07-01,Mariposa,43,17540,442,441,12,453,5
2021-07-01,Mendocino,45,87422,4189,4122,73,4195,49
2021-07-01,Merced,47,269075,31311,31297,1013,32310,469
2021-07-01,Modoc,49,8938,413,410,147,557,4
2021-07-01,Mono,51,14174,1254,1275,15,1290,3
2021-07-01,Monterey,53,433212,43221,43212,1947,45159,492
2021-07-01,Napa,55,140530,10072,10045,37,10082,81
2021-07-01,Nevada,57,99092,4997,4966,201,5167,72
2021-07-01,Orange,59,3164182,256252,255823,11990,267813,5126
2021-07-01,Placer,61,380077,23885,23764,1639,25403,299
2021-07-01,Plumas,63,18699,722,707,13,720,4
2021-07-01,Riverside,65,2383286,293135,293260,14999,308259,4536
2021-07-01,Sacramento,67,1510023,108877,108257,1961,110218,1676
2021-07-01,San Benito,69,59416,6129,6108,120,6228,63
2021-07-01,San Bernardino,71,2135413,294629,294294,9332,303626,5003
2021-07-01,San Diego,73,3302833,283434,282692,0,282692,3780
2021-07-01,San Francisco,75,870044,37259,37107,1426,38533,558
2021-07-01,San Joaquin,77,732212,74137,73841,3864,77705,1409
2021-07-01,San Luis Obispo,79,281455,21367,21330,801,22131,256
2021-07-01,San Mateo,81,765935,42889,42691,506,43197,541
2021-07-01,Santa Barbara,83,443738,34651,34526,1366,35892,456
2021-07-01,Santa Clara,85,1922200,119187,118966,833,119799,2090
2021-07-01,Santa Cruz,87,273765,16277,16254,877,17131,208
2021-07-01,Shasta,89,179085,12622,12582,1834,14416,204
2021-07-01,Sierra,91,2930,61,60,14,74,0
2021-07-01,Siskiyou,93,43540,1951,1899,407,2306,29
2021-07-01,Solano,95,438530,33620,33486,588,34074,268
2021-07-01,Sonoma,97,501317,31168,31000,382,31382,316
2021-07-01,Stanislaus,99,539301,57067,57018,6294,63312,1018
2021-07-01,Sutter,101,95872,9664,9644,95,9739,114
2021-07-01,Tehama,103,63373,5120,5124,642,5766,63
2021-07-01,Trinity,105,12862,368,341,66,407,3
2021-07-01,Tulare,107,460477,49837,49789,9717,59506,853
2021-07-01,Tuolumne,109,53932,4137,4113,171,4284,64
2021-07-01,Ventura,111,848112,81623,81425,3225,84650,1033
2021-07-01,Yolo,113,214977,14237,14188,383,14571,213
2021-07-01,Yuba,115,75493,6233,6197,137,6334,51
2021-06-30,Alameda,1,1643700,89859,89597,2106,91703,1256
2021-06-30,Alpine,3,1148,89,89,0,89,0
2021-06-30,Amador,5,37829,3769,3756,35,3791,46
2021-06-30,Butte,7,227075,12742,12676,1962,14638,201
2021-06-30,Calaveras,9,45235,2215,2198,16,2214,55
2021-06-30,Colusa,11,21464,1966,1967,331,2298,15
2021-06-30,Contra Costa,13,1133247,71288,70869,1397,72266,818
2021-06-30,Del Norte,15,27424,1443,1435,9,1444,8
2021-06-30,El Dorado,17,186661,10462,10420,818,11238,113
2021-06-30,Fresno,19,978130,102697,102490,9209,111699,1727
2021-06-30,Glenn,21,27897,2439,2440,588,3028,20
2021-06-30,Humboldt,23,135768,4548,4522,131,4653,49
2021-06-30,Imperial,25,180216,28732,28651,2900,31551,739
2021-06-30,Inyo,27,18085,1416,1409,4,1413,35
2021-06-30,Kern,29,883053,97418,97267,11672,108939,1348
2021-06-30,Kings,31,150075,23100,23038,1223,24261,245
2021-06-30,Lake,33,64148,3637,3601,13,3614,56
2021-06-30,Lassen,35,31185,5284,5269,123,5392,20
2021-06-30,Los Angeles,37,10098052,1210190,1208246,44440,1252686,24499
2021-06-30,Madera,39,155013,16719,16688,969,17657,240
2021-06-30,Marin,41,260295,14206,14133,273,14406,232
2021-06-30,Mariposa,43,17540,441,441,12,453,5
2021-06-30,Mendocino,45,87422,4179,4115,73,4188,49
2021-06-30,Merced,47,269075,31301,31286,1013,32299,469
2021-06-30,Modoc,49,8938,413,410,147,557,4
2021-06-30,Mono,51,14174,1254,1275,15,1290,3
2021-06-30,Monterey,53,433212,43216,43209,1945,45154,492
2021-06-30,Napa,55,140530,10064,10039,37,10076,81
2021-06-30,Nevada,57,99092,4986,4958,201,5159,72
2021-06-30,Orange,59,3164182,256125,255764,11980,267744,5125
2021-06-30,Placer,61,380077,23860,23721,1635,25356,299
2021-06-30,Plumas,63,18699,722,705,13,718,4
2021-06-30,Riverside,65,2383286,293023,293280,14987,308267,4535
2021-06-30,Sacramento,67,1510023,108738,108137,1956,110093,1676
2021-06-30,San Benito,69,59416,6125,6105,120,6225,63
2021-06-30,San Bernardino,71,2135413,294479,294211,9327,303538,4975
2021-06-30,San Diego,73,3302833,283298,282583,0,282583,3780
2021-06-30,San Francisco,75,870044,37210,37065,1421,38486,558
2021-06-30,San Joaquin,77,732212,74077,73777,3862,77639,1409
2021-06-30,San Luis Obispo,79,281455,21354,21326,800,22126,256
2021-06-30,San Mateo,81,765935,42853,42599,505,43104,537
2021-06-30,Santa Barbara,83,443738,34635,34521,1364,35885,456
2021-06-30,Santa Clara,85,1922200,119140,118930,830,119760,2090
2021-06-30,Santa Cruz,87,273765,16272,16250,877,17127,208
2021-06-30,Shasta,89,179085,12616,12564,1834,14398,204
2021-06-30,Sierra,91,2930,61,60,14,74,0
2021-06-30,Siskiyou,93,43540,1949,1900,404,2304,29
2021-06-30,Solano,95,438530,33582,33453,586,34039,268
2021-06-30,Sonoma,97,501317,31138,30947,382,31329,316
2021-06-30,Stanislaus,99,539301,57045,56997,6293,63290,1018
2021-06-30,Sutter,101,95872,9654,9638,95,9733,114
2021-06-30,Tehama,103,63373,5118,5124,642,5766,63
2021-06-30,Trinity,105,12862,368,341,66,407,3
2021-06-30,Tulare,107,460477,49826,49764,9706,59470,853
2021-06-30,Tuolumne,109,53932,4134,4112,171,4283,64
2021-06-30,Ventura,111,848112,81582,81392,3220,84612,1032
2021-06-30,Yolo,113,214977,14233,14178,380,14558,213
2021-06-30,Yuba,115,75493,6225,6191,137,6328,51
2021-06-29,Alameda,1,1643700,89755,89519,2105,91624,1257
2021-06-29,Alpine,3,1148,89,89,0,89,0
2021-06-29,Amador,5,37829,3765,3754,35,3789,46
2021-06-29,Butte,7,227075,12734,12669,1962,14631,201
2021-06-29,Calaveras,9,45235,2210,2198,16,2214,55
2021-06-29,Colusa,11,21464,1964,1967,331,2298,15
2021-06-29,Contra Costa,13,1133247,71214,70775,1397,72172,817
2021-06-29,Del Norte,15,27424,1442,1435,9,1444,8
2021-06-29,El Dorado,17,186661,10449,10403,814,11217,113
2021-06-29,Fresno,19,978130,102663,102464,9206,111670,1725
2021-06-29,Glenn,21,27897,2438,2439,588,3027,20
2021-06-29,Humboldt,23,135768,4544,4514,128,4642,49
2021-06-29,Imperial,25,180216,28723,28645,2899,31544,737
2021-06-29,Inyo,27,18085,1416,1408,4,1412,35
2021-06-29,Kern,29,883053,97397,97173,11665,108838,1347
2021-06-29,Kings,31,150075,23092,23035,1222,24257,245
2021-06-29,Lake,33,64148,3631,3594,13,3607,56
2021-06-29,Lassen,35,31185,5277,5268,123,5391,20
2021-06-29,Los Angeles,37,10098052,1209589,1207895,44404,1252299,24498
2021-06-29,Madera,39,155013,16715,16680,968,17648,240
2021-06-29,Marin,41,260295,14194,14127,273,14400,232
2021-06-29,Mariposa,43,17540,441,441,12,453,5
2021-06-29,Mendocino,45,87422,4176,4107,72,4179,49
2021-06-29,Merced,47,269075,31289,31277,1013,32290,469
2021-06-29,Modoc,49,8938,412,408,147,555,3
2021-06-29,Mono,51,14174,1254,1275,15,1290,3
2021-06-29,Monterey,53,433212,43206,43196,1943,45139,471
2021-06-29,Napa,55,140530,10058,10033,37,10070,81
2021-06-29,Nevada,57,99092,4979,4952,201,5153,72
2021-06-29,Orange,59,3164182,256028,255686,11965,267651,5124
2021-06-29,Placer,61,380077,23841,23693,1633,25326,299
2021-06-29,Plumas,63,18699,722,704,13,717,4
2021-06-29,Riverside,65,2383286,292924,292962,14980,307942,4524
2021-06-29,Sacramento,67,1510023,108586,108067,1953,110020,1677
2021-06-29,San Benito,69,59416,6114,6099,120,6219,63
2021-06-29,San Bernardino,71,2135413,294372,294118,9325,303443,4940
2021-06-29,San Diego,73,3302833,283144,282499,0,282499,3780
2021-06-29,San Francisco,75,870044,37175,37041,1418,38459,558
2021-06-29,San Joaquin,77,732212,74029,73724,3859,77583,1409
2021-06-29,San Luis Obispo,79,281455,21345,21324,798,22122,256
2021-06-29,San Mateo,81,765935,42822,42540,503,43043,540
2021-06-29,Santa Barbara,83,443738,34625,34507,1362,35869,455
2021-06-29,Santa Clara,85,1922200,119085,118893,829,119722,2090
2021-06-29,Santa Cruz,87,273765,16267,16249,877,17126,208
2021-06-29,Shasta,89,179085,12604,12564,1833,14397,204
2021-06-29,Sierra,91,2930,61,59,14,73,0
2021-06-29,Siskiyou,93,43540,1946,1897,400,2297,29
2021-06-29,Solano,95,438530,33549,33440,584,34024,268
2021-06-29,Sonoma,97,501317,31096,30950,380,31330,316
2021-06-29,Stanislaus,99,539301,57017,56980,6286,63266,1018
2021-06-29,Sutter,101,95872,9643,9634,95,9729,114
2021-06-29,Tehama,103,63373,5118,5124,642,5766,63
2021-06-29,Trinity,105,12862,368,341,66,407,3
2021-06-29,Tulare,107,460477,49813,49751,9701,59452,852
2021-06-29,Tuolumne,109,53932,4132,4111,171,4282,64
2021-06-29,Ventura,111,848112,81549,81363,3214,84577,1032
2021-06-29,Yolo,113,214977,14221,14171,379,14550,213
2021-06-29,Yuba,115,75493,6215,6188,137,6325,51
2021-06-28,Alameda,1,1643700,89662,89638,2103,91741,1259
2021-06-28,Alpine,3,1148,89,89,0,89,0
2021-06-28,Amador,5,37829,3764,3753,35,3788,46
2021-06-28,Butte,7,227075,12725,12697,1959,14656,198
2021-06-28,Calaveras,9,45235,2207,2203,16,2219,55
2021-06-28,Colusa,11,21464,1963,1974,330,2304,15
2021-06-28,Contra Costa,13,1133247,71139,70807,1395,72202,816
2021-06-28,Del Norte,15,27424,1442,1436,9,1445,8
2021-06-28,El Dorado,17,186661,10439,10422,810,11232,115
2021-06-28,Fresno,19,978130,102632,103121,9204,112325,1727
2021-06-28,Glenn,21,27897,2438,2439,588,3027,20
2021-06-28,Humboldt,23,135768,4537,4520,126,4646,49
2021-06-28,Imperial,25,180216,28715,28981,2898,31879,741
2021-06-28,Inyo,27,18085,1413,1407,4,1411,35
2021-06-28,Kern,29,883053,97378,97252,11660,108912,1348
2021-06-28,Kings,31,150075,23086,23134,1222,24356,246
2021-06-28,Lake,33,64148,3622,3591,13,3604,56
2021-06-28,Lassen,35,31185,5275,5268,123,5391,20
2021-06-28,Los Angeles,37,10098052,1209075,1207714,44366,1252080,24496
2021-06-28,Madera,39,155013,16705,16683,967,17650,240
2021-06-28,Marin,41,260295,14179,14186,273,14459,232
2021-06-28,Mariposa,43,17540,441,440,12,452,5
2021-06-28,Mendocino,45,87422,4168,4102,71,4173,49
2021-06-28,Merced,47,269075,31278,31277,1013,32290,469
2021-06-28,Modoc,49,8938,412,411,146,557,3
2021-06-28,Mono,51,14174,1254,1276,15,1291,3
2021-06-28,Monterey,53,433212,43202,43202,1942,45144,462
2021-06-28,Napa,55,140530,10049,10050,36,10086,81
2021-06-28,Nevada,57,99092,4975,4951,201,5152,72
2021-06-28,Orange,59,3164182,255941,255755,11952,267707,5123
2021-06-28,Placer,61,380077,23820,23756,1628,25384,299
2021-06-28,Plumas,63,18699,720,704,13,717,4
2021-06-28,Riverside,65,2383286,292798,292647,14969,307616,4507
2021-06-28,Sacramento,67,1510023,108453,108342,1949,110291,1675
2021-06-28,San Benito,69,59416,6112,6101,120,6221,63
2021-06-28,San Bernardino,71,2135413,294271,294151,9320,303471,4928
2021-06-28,San Diego,73,3302833,282983,282417,0,282417,3780
2021-06-28,San Francisco,75,870044,37140,37372,1416,38788,559
2021-06-28,San Joaquin,77,732212,73980,73973,3854,77827,1411
2021-06-28,San Luis Obispo,79,281455,21341,21340,797,22137,256
2021-06-28,San Mateo,81,765935,42789,42927,502,43429,540
2021-06-28,Santa Barbara,83,443738,34618,34534,1360,35894,455
2021-06-28,Santa Clara,85,1922200,119021,120377,828,121205,2103
2021-06-28,Santa Cruz,87,273765,16262,16245,877,17122,208
2021-06-28,Shasta,89,179085,12600,12642,1829,14471,203
2021-06-28,Sierra,91,2930,61,58,14,72,0
2021-06-28,Siskiyou,93,43540,1945,1896,400,2296,29
2021-06-28,Solano,95,438530,33513,33524,582,34106,267
2021-06-28,Sonoma,97,501317,31059,31137,379,31516,315
2021-06-28,Stanislaus,99,539301,56998,57047,6282,63329,1018
2021-06-28,Sutter,101,95872,9639,9682,95,9777,114
2021-06-28,Tehama,103,63373,5116,5122,642,5764,63
2021-06-28,Trinity,105,12862,368,341,66,407,3
2021-06-28,Tulare,107,460477,49804,49751,9696,59447,850
2021-06-28,Tuolumne,109,53932,4125,4121,171,4292,64
2021-06-28,Ventura,111,848112,81491,81393,3209,84602,1032
2021-06-28,Yolo,113,214977,14212,14199,376,14575,213
2021-06-28,Yuba,115,75493,6210,6207,137,6344,51
2021-06-27,Alameda,1,1643700,89577,89611,2099,91710,1259
2021-06-27,Alpine,3,1148,89,89,0,89,0
2021-06-27,Amador,5,37829,3763,3752,35,3787,46
2021-06-27,Butte,7,227075,12716,12696,1958,14654,198
2021-06-27,Calaveras,9,45235,2206,2203,16,2219,55
2021-06-27,Colusa,11,21464,1963,1974,330,2304,15
2021-06-27,Contra Costa,13,1133247,71052,70762,1391,72153,816
2021-06-27,Del Norte,15,27424,1439,1436,9,1445,8
2021-06-27,El Dorado,17,186661,10427,10418,807,11225,115
2021-06-27,Fresno,19,978130,102603,103110,9202,112312,1727
2021-06-27,Glenn,21,27897,2437,2439,587,3026,20
2021-06-27,Humboldt,23,135768,4525,4513,123,4636,49
2021-06-27,Imperial,25,180216,28701,28987,2898,31885,741
2021-06-27,Inyo,27,18085,1413,1407,4,1411,35
2021-06-27,Kern,29,883053,97353,97249,11653,108902,1348
2021-06-27,Kings,31,150075,23076,23132,1222,24354,246
2021-06-27,Lake,33,64148,3615,3581,13,3594,56
2021-06-27,Lassen,35,31185,5274,5265,123,5388,20
2021-06-27,Los Angeles,37,10098052,1208534,1207461,44326,1251787,24493
2021-06-27,Madera,39,155013,16697,16680,967,17647,240
2021-06-27,Marin,41,260295,14170,14182,273,14455,232
2021-06-27,Mariposa,43,17540,441,440,12,452,5
2021-06-27,Mendocino,45,87422,4161,4100,71,4171,49
2021-06-27,Merced,47,269075,31266,31266,1013,32279,469
2021-06-27,Modoc,49,8938,412,411,146,557,3
2021-06-27,Mono,51,14174,1254,1279,15,1294,3
2021-06-27,Monterey,53,433212,43189,43199,1942,45141,462
2021-06-27,Napa,55,140530,10042,10046,36,10082,81
2021-06-27,Nevada,57,99092,4969,4946,201,5147,72
2021-06-27,Orange,59,3164182,255827,255710,11939,267649,5123
2021-06-27,Placer,61,380077,23787,23731,1625,25356,299
2021-06-27,Plumas,63,18699,720,704,13,717,4
2021-06-27,Riverside,65,2383286,292698,292641,14963,307604,4507
2021-06-27,Sacramento,67,1510023,108320,108279,1945,110224,1675
2021-06-27,San Benito,69,59416,6106,6101,120,6221,63
2021-06-27,San Bernardino,71,2135413,294158,294115,9319,303434,4927
2021-06-27,San Diego,73,3302833,282846,282359,0,282359,3780
2021-06-27,San Francisco,75,870044,37103,37360,1415,38775,559
2021-06-27,San Joaquin,77,732212,73944,73960,3852,77812,1411
2021-06-27,San Luis Obispo,79,281455,21334,21340,796,22136,256
2021-06-27,San Mateo,81,765935,42761,42925,499,43424,539
2021-06-27,Santa Barbara,83,443738,34604,34533,1357,35890,455
2021-06-27,Santa Clara,85,1922200,118969,120352,826,121178,2103
2021-06-27,Santa Cruz,87,273765,16253,16241,877,17118,208
2021-06-27,Shasta,89,179085,12594,12640,1827,14467,203
2021-06-27,Sierra,91,2930,61,58,14,72,0
2021-06-27,Siskiyou,93,43540,1943,1896,399,2295,29
2021-06-27,Solano,95,438530,33485,33516,582,34098,267
2021-06-27,Sonoma,97,501317,31021,31129,379,31508,315
2021-06-27,Stanislaus,99,539301,56951,57021,6279,63300,1018
2021-06-27,Sutter,101,95872,9633,9678,95,9773,114
2021-06-27,Tehama,103,63373,5112,5122,642,5764,63
2021-06-27,Trinity,105,12862,368,341,65,406,3
2021-06-27,Tulare,107,460477,49792,49749,9689,59438,850
2021-06-27,Tuolumne,109,53932,4123,4121,171,4292,64
2021-06-27,Ventura,111,848112,81457,81361,3200,84561,1032
2021-06-27,Yolo,113,214977,14197,14194,373,14567,213
2021-06-27,Yuba,115,75493,6204,6205,137,6342,51
2021-06-26,Alameda,1,1643700,89520,89560,2098,91658,1259
2021-06-26,Alpine,3,1148,89,89,0,89,0
2021-06-26,Amador,5,37829,3763,3748,35,3783,46
2021-06-26,Butte,7,227075,12712,12693,1955,14648,198
2021-06-26,Calaveras,9,45235,2204,2202,16,2218,55
2021-06-26,Colusa,11,21464,1963,1973,330,2303,15
2021-06-26,Contra Costa,13,1133247,71009,70712,1390,72102,816
2021-06-26,Del Norte,15,27424,1438,1432,9,1441,8
2021-06-26,El Dorado,17,186661,10419,10414,806,11220,115
2021-06-26,Fresno,19,978130,102583,103091,9200,112291,1727
2021-06-26,Glenn,21,27897,2435,2441,587,3028,20
2021-06-26,Humboldt,23,135768,4522,4509,123,4632,49
2021-06-26,Imperial,25,180216,28697,28970,2898,31868,741
2021-06-26,Inyo,27,18085,1413,1407,4,1411,35
2021-06-26,Kern,29,883053,97327,97239,11644,108883,1348
2021-06-26,Kings,31,150075,23072,23128,1221,24349,246
2021-06-26,Lake,33,64148,3605,3576,13,3589,56
2021-06-26,Lassen,35,31185,5271,5263,123,5386,20
2021-06-26,Los Angeles,37,10098052,1208233,1207198,44290,1251488,24490
2021-06-26,Madera,39,155013,16690,16679,966,17645,240
2021-06-26,Marin,41,260295,14161,14180,273,14453,232
2021-06-26,Mariposa,43,17540,441,440,12,452,5
2021-06-26,Mendocino,45,87422,4159,4096,71,4167,49
2021-06-26,Merced,47,269075,31260,31259,1012,32271,469
2021-06-26,Modoc,49,8938,412,411,146,557,3
2021-06-26,Mono,51,14174,1254,1279,15,1294,3
2021-06-26,Monterey,53,433212,43186,43192,1942,45134,462
2021-06-26,Napa,55,140530,10036,10043,36,10079,81
2021-06-26,Nevada,57,99092,4964,4939,201,5140,72
2021-06-26,Orange,59,3164182,255752,255640,11932,267572,5123
2021-06-26,Placer,61,380077,23773,23702,1623,25325,299
2021-06-26,Plumas,63,18699,720,704,13,717,4
2021-06-26,Riverside,65,2383286,292641,292480,14957,307437,4505
2021-06-26,Sacramento,67,1510023,108251,108179,1943,110122,1675
2021-06-26,San Benito,69,59416,6102,6100,120,6220,63
2021-06-26,San Bernardino,71,2135413,294067,294034,9314,303348,4928
2021-06-26,San Diego,73,3302833,282761,282263,0,282263,3780
2021-06-26,San Francisco,75,870044,37071,37348,1414,38762,559
2021-06-26,San Joaquin,77,732212,73916,73928,3851,77779,1411
2021-06-26,San Luis Obispo,79,281455,21333,21330,795,22125,256
2021-06-26,San Mateo,81,765935,42740,42898,499,43397,539
2021-06-26,Santa Barbara,83,443738,34595,34525,1357,35882,455
2021-06-26,Santa Clara,85,1922200,118936,120321,826,121147,2103
2021-06-26,Santa Cruz,87,273765,16250,16239,877,17116,208
2021-06-26,Shasta,89,179085,12590,12635,1823,14458,203
2021-06-26,Sierra,91,2930,61,58,14,72,0
2021-06-26,Siskiyou,93,43540,1942,1896,398,2294,29
2021-06-26,Solano,95,438530,33467,33489,580,34069,267
2021-06-26,Sonoma,97,501317,30993,31088,379,31467,315
2021-06-26,Stanislaus,99,539301,56930,57006,6277,63283,1018
2021-06-26,Sutter,101,95872,9632,9669,95,9764,114
2021-06-26,Tehama,103,63373,5112,5119,642,5761,63
2021-06-26,Trinity,105,12862,368,341,65,406,3
2021-06-26,Tulare,107,460477,49786,49745,9689,59434,850
2021-06-26,Tuolumne,109,53932,4123,4121,171,4292,64
2021-06-26,Ventura,111,848112,81433,81352,3199,84551,1032
2021-06-26,Yolo,113,214977,14188,14184,373,14557,213
2021-06-26,Yuba,115,75493,6201,6200,137,6337,51
2021-06-25,Alameda,1,1643700,89455,89453,2095,91548,1271
2021-06-25,Alpine,3,1148,89,89,0,89,0
2021-06-25,Amador,5,37829,3762,3746,35,3781,46
2021-06-25,Butte,7,227075,12707,12682,1952,14634,198
2021-06-25,Calaveras,9,45235,2203,2201,16,2217,55
2021-06-25,Colusa,11,21464,1963,1972,330,2302,15
2021-06-25,Contra Costa,13,1133247,70973,70659,1390,72049,815
2021-06-25,Del Norte,15,27424,1438,1426,9,1435,8
2021-06-25,El Dorado,17,186661,10411,10406,803,11209,115
2021-06-25,Fresno,19,978130,102566,103073,9196,112269,1727
2021-06-25,Glenn,21,27897,2435,2441,587,3028,20
2021-06-25,Humboldt,23,135768,4516,4503,121,4624,49
2021-06-25,Imperial,25,180216,28694,28968,2898,31866,740
2021-06-25,Inyo,27,18085,1412,1406,4,1410,35
2021-06-25,Kern,29,883053,97308,97182,11640,108822,1347
2021-06-25,Kings,31,150075,23066,23118,1221,24339,246
2021-06-25,Lake,33,64148,3599,3571,13,3584,56
2021-06-25,Lassen,35,31185,5270,5259,123,5382,20
2021-06-25,Los Angeles,37,10098052,1207959,1206909,44271,1251180,24483
2021-06-25,Madera,39,155013,16687,16670,966,17636,240
2021-06-25,Marin,41,260295,14158,14179,273,14452,232
2021-06-25,Mariposa,43,17540,441,440,12,452,5
2021-06-25,Mendocino,45,87422,4156,4089,71,4160,49
2021-06-25,Merced,47,269075,31252,31256,1012,32268,467
2021-06-25,Modoc,49,8938,412,411,146,557,3
2021-06-25,Mono,51,14174,1254,1279,15,1294,3
2021-06-25,Monterey,53,433212,43181,43184,1941,45125,462
2021-06-25,Napa,55,140530,10031,10037,36,10073,81
2021-06-25,Nevada,57,99092,4961,4932,201,5133,72
2021-06-25,Orange,59,3164182,255685,255574,11929,267503,5119
2021-06-25,Placer,61,380077,23754,23672,1622,25294,299
2021-06-25,Plumas,63,18699,720,702,12,714,4
2021-06-25,Riverside,65,2383286,292575,291663,14951,306614,4490
2021-06-25,Sacramento,67,1510023,108178,108034,1939,109973,1673
2021-06-25,San Benito,69,59416,6098,6098,120,6218,63
2021-06-25,San Bernardino,71,2135413,294012,293941,9312,303253,4911
2021-06-25,San Diego,73,3302833,282701,282157,0,282157,3779
2021-06-25,San Francisco,75,870044,37048,37338,1413,38751,559
2021-06-25,San Joaquin,77,732212,73883,73860,3849,77709,1410
2021-06-25,San Luis Obispo,79,281455,21330,21325,794,22119,256
2021-06-25,San Mateo,81,765935,42722,42849,499,43348,537
2021-06-25,Santa Barbara,83,443738,34587,34518,1356,35874,454
2021-06-25,Santa Clara,85,1922200,118916,120272,826,121098,2103
2021-06-25,Santa Cruz,87,273765,16247,16230,877,17107,208
2021-06-25,Shasta,89,179085,12580,12633,1822,14455,202
2021-06-25,Sierra,91,2930,61,58,14,72,0
2021-06-25,Siskiyou,93,43540,1941,1894,398,2292,29
2021-06-25,Solano,95,438530,33447,33449,580,34029,267
2021-06-25,Sonoma,97,501317,30970,31043,379,31422,314
2021-06-25,Stanislaus,99,539301,56911,56973,6270,63243,1018
2021-06-25,Sutter,101,95872,9625,9664,95,9759,114
2021-06-25,Tehama,103,63373,5111,5119,642,5761,63
2021-06-25,Trinity,105,12862,368,338,65,403,3
2021-06-25,Tulare,107,460477,49780,49731,9685,59416,850
2021-06-25,Tuolumne,109,53932,4122,4121,171,4292,64
2021-06-25,Ventura,111,848112,81404,81342,3193,84535,1032
2021-06-25,Yolo,113,214977,14182,14172,373,14545,213
2021-06-25,Yuba,115,75493,6197,6195,137,6332,51
2021-06-24,Alameda,1,1643700,89381,89358,2091,91449,1268
2021-06-24,Alpine,3,1148,89,89,0,89,0
2021-06-24,Amador,5,37829,3758,3745,35,3780,46
2021-06-24,Butte,7,227075,12701,12673,1950,14623,198
2021-06-24,Calaveras,9,45235,2199,2202,16,2218,55
2021-06-24,Colusa,11,21464,1962,1972,330,2302,15
2021-06-24,Contra Costa,13,1133247,70914,70590,1390,71980,813
2021-06-24,Del Norte,15,27424,1437,1421,9,1430,8
2021-06-24,El Dorado,17,186661,10404,10402,803,11205,115
2021-06-24,Fresno,19,978130,102547,103061,9193,112254,1727
2021-06-24,Glenn,21,27897,2434,2439,587,3026,20
2021-06-24,Humboldt,23,135768,4511,4493,121,4614,49
2021-06-24,Imperial,25,180216,28691,28981,2898,31879,740
2021-06-24,Inyo,27,18085,1411,1406,4,1410,35
2021-06-24,Kern,29,883053,97289,97129,11627,108756,1346
2021-06-24,Kings,31,150075,23062,23114,1219,24333,246
2021-06-24,Lake,33,64148,3593,3571,13,3584,56
2021-06-24,Lassen,35,31185,5269,5258,123,5381,20
2021-06-24,Los Angeles,37,10098052,1207636,1206590,44247,1250837,24480
2021-06-24,Madera,39,155013,16676,16662,966,17628,240
2021-06-24,Marin,41,260295,14154,14180,273,14453,232
2021-06-24,Mariposa,43,17540,441,440,12,452,5
2021-06-24,Mendocino,45,87422,4148,4085,71,4156,49
2021-06-24,Merced,47,269075,31241,31248,1012,32260,466
2021-06-24,Modoc,49,8938,412,411,146,557,3
2021-06-24,Mono,51,14174,1254,1276,15,1291,3
2021-06-24,Monterey,53,433212,43174,43180,1941,45121,451
2021-06-24,Napa,55,140530,10029,10036,36,10072,80
2021-06-24,Nevada,57,99092,4959,4927,201,5128,72
2021-06-24,Orange,59,3164182,255622,255520,11922,267442,5117
2021-06-24,Placer,61,380077,23729,23659,1620,25279,299
2021-06-24,Plumas,63,18699,719,702,12,714,4
2021-06-24,Riverside,65,2383286,292495,291067,14944,306011,4473
2021-06-24,Sacramento,67,1510023,108090,107965,1937,109902,1672
2021-06-24,San Benito,69,59416,6095,6098,120,6218,63
2021-06-24,San Bernardino,71,2135413,293945,293895,9306,303201,4898
2021-06-24,San Diego,73,3302833,282596,282053,0,282053,3778
2021-06-24,San Francisco,75,870044,37026,37320,1411,38731,559
2021-06-24,San Joaquin,77,732212,73835,73814,3849,77663,1408
2021-06-24,San Luis Obispo,79,281455,21324,21326,794,22120,256
2021-06-24,San Mateo,81,765935,42696,42814,498,43312,542
2021-06-24,Santa Barbara,83,443738,34581,34512,1355,35867,454
2021-06-24,Santa Clara,85,1922200,118886,120274,825,121099,2103
2021-06-24,Santa Cruz,87,273765,16246,16227,877,17104,208
2021-06-24,Shasta,89,179085,12575,12629,1817,14446,202
2021-06-24,Sierra,91,2930,61,58,14,72,0
2021-06-24,Siskiyou,93,43540,1941,1892,398,2290,28
2021-06-24,Solano,95,438530,33425,33432,578,34010,267
2021-06-24,Sonoma,97,501317,30941,31020,379,31399,314
2021-06-24,Stanislaus,99,539301,56880,56946,6269,63215,1018
2021-06-24,Sutter,101,95872,9618,9660,95,9755,113
2021-06-24,Tehama,103,63373,5108,5115,641,5756,63
2021-06-24,Trinity,105,12862,367,338,65,403,3
2021-06-24,Tulare,107,460477,49770,49730,9682,59412,850
2021-06-24,Tuolumne,109,53932,4120,4120,171,4291,64
2021-06-24,Ventura,111,848112,81376,81332,3192,84524,1032
2021-06-24,Yolo,113,214977,14174,14169,369,14538,213
2021-06-24,Yuba,115,75493,6192,6195,137,6332,51
2021-06-23,Alameda,1,1643700,89308,89338,2090,91428,1266
2021-06-23,Alpine,3,1148,89,88,0,88,0
2021-06-23,Amador,5,37829,3756,3743,35,3778,46
2021-06-23,Butte,7,227075,12694,12666,1950,14616,198
2021-06-23,Calaveras,9,45235,2198,2199,16,2215,55
2021-06-23,Colusa,11,21464,1961,1972,330,2302,15
2021-06-23,Contra Costa,13,1133247,70849,70526,1389,71915,813
2021-06-23,Del Norte,15,27424,1433,1418,9,1427,8
2021-06-23,El Dorado,17,186661,10395,10395,800,11195,115
2021-06-23,Fresno,19,978130,102517,103020,9191,112211,1724
2021-06-23,Glenn,21,27897,2434,2437,586,3023,20
2021-06-23,Humboldt,23,135768,4502,4490,121,4611,48
2021-06-23,Imperial,25,180216,28684,28908,2898,31806,740
2021-06-23,Inyo,27,18085,1411,1406,4,1410,35
2021-06-23,Kern,29,883053,97262,97078,11614,108692,1345
2021-06-23,Kings,31,150075,23055,23105,1217,24322,245
2021-06-23,Lake,33,64148,3584,3566,13,3579,53
2021-06-23,Lassen,35,31185,5266,5257,123,5380,20
2021-06-23,Los Angeles,37,10098052,1207299,1206358,44236,1250594,24472
2021-06-23,Madera,39,155013,16671,16660,966,17626,240
2021-06-23,Marin,41,260295,14148,14177,273,14450,230
2021-06-23,Mariposa,43,17540,441,439,12,451,5
2021-06-23,Mendocino,45,87422,4144,4078,71,4149,49
2021-06-23,Merced,47,269075,31232,31260,1012,32272,465
2021-06-23,Modoc,49,8938,410,407,146,553,3
2021-06-23,Mono,51,14174,1254,1279,15,1294,3
2021-06-23,Monterey,53,433212,43165,43166,1941,45107,439
2021-06-23,Napa,55,140530,10020,10032,36,10068,80
2021-06-23,Nevada,57,99092,4956,4924,201,5125,72
2021-06-23,Orange,59,3164182,255558,255479,11913,267392,5116
2021-06-23,Placer,61,380077,23701,23630,1613,25243,299
2021-06-23,Plumas,63,18699,718,701,12,713,4
2021-06-23,Riverside,65,2383286,292412,290343,14942,305285,4462
2021-06-23,Sacramento,67,1510023,107997,107868,1932,109800,1671
2021-06-23,San Benito,69,59416,6091,6097,120,6217,63
2021-06-23,San Bernardino,71,2135413,293868,293816,9302,303118,4886
2021-06-23,San Diego,73,3302833,282496,281937,0,281937,3777
2021-06-23,San Francisco,75,870044,37002,37304,1410,38714,559
2021-06-23,San Joaquin,77,732212,73796,73764,3847,77611,1405
2021-06-23,San Luis Obispo,79,281455,21320,21323,793,22116,257
2021-06-23,San Mateo,81,765935,42681,42756,497,43253,542
2021-06-23,Santa Barbara,83,443738,34571,34505,1355,35860,454
2021-06-23,Santa Clara,85,1922200,118857,120233,825,121058,2098
2021-06-23,Santa Cruz,87,273765,16242,16215,877,17092,209
2021-06-23,Shasta,89,179085,12568,12604,1815,14419,202
2021-06-23,Sierra,91,2930,61,57,14,71,0
2021-06-23,Siskiyou,93,43540,1939,1892,398,2290,28
2021-06-23,Solano,95,438530,33381,33408,578,33986,267
2021-06-23,Sonoma,97,501317,30901,30959,377,31336,314
2021-06-23,Stanislaus,99,539301,56847,56926,6268,63194,1017
2021-06-23,Sutter,101,95872,9612,9653,95,9748,113
2021-06-23,Tehama,103,63373,5108,5119,639,5758,63
2021-06-23,Trinity,105,12862,367,338,65,403,3
2021-06-23,Tulare,107,460477,49764,49711,9677,59388,850
2021-06-23,Tuolumne,109,53932,4117,4120,171,4291,64
2021-06-23,Ventura,111,848112,81354,81312,3189,84501,1032
2021-06-23,Yolo,113,214977,14164,14161,369,14530,212
2021-06-23,Yuba,115,75493,6189,6190,137,6327,51
2021-06-22,Alameda,1,1643700,89239,89308,2090,91398,1263
2021-06-22,Alpine,3,1148,89,88,0,88,0
2021-06-22,Amador,5,37829,3753,3743,35,3778,46
2021-06-22,Butte,7,227075,12690,12662,1948,14610,198
2021-06-22,Calaveras,9,45235,2197,2198,16,2214,55
2021-06-22,Colusa,11,21464,1960,1971,330,2301,15
2021-06-22,Contra Costa,13,1133247,70793,70480,1388,71868,813
2021-06-22,Del Norte,15,27424,1430,1417,9,1426,8
2021-06-22,El Dorado,17,186661,10390,10380,799,11179,113
2021-06-22,Fresno,19,978130,102499,102996,9187,112183,1724
2021-06-22,Glenn,21,27897,2433,2435,584,3019,19
2021-06-22,Humboldt,23,135768,4492,4483,119,4602,42
2021-06-22,Imperial,25,180216,28679,28880,2898,31778,740
2021-06-22,Inyo,27,18085,1411,1405,4,1409,35
2021-06-22,Kern,29,883053,97248,97013,11610,108623,1342
2021-06-22,Kings,31,150075,23047,23098,1216,24314,245
2021-06-22,Lake,33,64148,3582,3564,13,3577,45
2021-06-22,Lassen,35,31185,5261,5254,123,5377,20
2021-06-22,Los Angeles,37,10098052,1206987,1206146,44224,1250370,24461
2021-06-22,Madera,39,155013,16666,16652,966,17618,240
2021-06-22,Marin,41,260295,14146,14174,273,14447,230
2021-06-22,Mariposa,43,17540,441,439,12,451,5
2021-06-22,Mendocino,45,87422,4138,4072,71,4143,49
2021-06-22,Merced,47,269075,31221,31267,1012,32279,464
2021-06-22,Modoc,49,8938,409,405,145,550,3
2021-06-22,Mono,51,14174,1254,1277,15,1292,3
2021-06-22,Monterey,53,433212,43162,43162,1940,45102,427
2021-06-22,Napa,55,140530,10015,10029,36,10065,80
2021-06-22,Nevada,57,99092,4950,4923,201,5124,72
2021-06-22,Orange,59,3164182,255493,255452,11903,267355,5114
2021-06-22,Placer,61,380077,23680,23603,1613,25216,299
2021-06-22,Plumas,63,18699,718,697,12,709,4
2021-06-22,Riverside,65,2383286,292351,289839,14938,304777,4456
2021-06-22,Sacramento,67,1510023,107895,107801,1927,109728,1670
2021-06-22,San Benito,69,59416,6090,6098,120,6218,63
2021-06-22,San Bernardino,71,2135413,293792,293770,9296,303066,4873
2021-06-22,San Diego,73,3302833,282391,281867,0,281867,3771
2021-06-22,San Francisco,75,870044,36988,37287,1410,38697,556
2021-06-22,San Joaquin,77,732212,73766,73723,3846,77569,1405
2021-06-22,San Luis Obispo,79,281455,21317,21321,792,22113,257
2021-06-22,San Mateo,81,765935,42668,42725,491,43216,542
2021-06-22,Santa Barbara,83,443738,34560,34500,1354,35854,454
2021-06-22,Santa Clara,85,1922200,118825,120194,825,121019,2095
2021-06-22,Santa Cruz,87,273765,16237,16218,877,17095,209
2021-06-22,Shasta,89,179085,12558,12616,1811,14427,202
2021-06-22,Sierra,91,2930,60,57,14,71,0
2021-06-22,Siskiyou,93,43540,1939,1892,398,2290,28
2021-06-22,Solano,95,438530,33363,33397,577,33974,267
2021-06-22,Sonoma,97,501317,30862,30933,377,31310,314
2021-06-22,Stanislaus,99,539301,56827,56915,6266,63181,1017
2021-06-22,Sutter,101,95872,9605,9649,95,9744,113
2021-06-22,Tehama,103,63373,5106,5118,637,5755,63
2021-06-22,Trinity,105,12862,365,337,65,402,3
2021-06-22,Tulare,107,460477,49756,49706,9672,59378,850
2021-06-22,Tuolumne,109,53932,4115,4119,171,4290,64
2021-06-22,Ventura,111,848112,81341,81300,3188,84488,1032
2021-06-22,Yolo,113,214977,14159,14157,367,14524,212
2021-06-22,Yuba,115,75493,6185,6181,137,6318,51
2021-06-21,Alameda,1,1643700,89178,89281,2089,91370,1262
2021-06-21,Alpine,3,1148,89,88,0,88,0
2021-06-21,Amador,5,37829,3747,3742,35,3777,46
2021-06-21,Butte,7,227075,12684,12668,1946,14614,195
2021-06-21,Calaveras,9,45235,2196,2194,16,2210,55
2021-06-21,Colusa,11,21464,1959,1970,329,2299,15
2021-06-21,Contra Costa,13,1133247,70723,70439,1386,71825,813
2021-06-21,Del Norte,15,27424,1426,1416,9,1425,8
2021-06-21,El Dorado,17,186661,10384,10375,798,11173,113
2021-06-21,Fresno,19,978130,102480,102971,9184,112155,1724
2021-06-21,Glenn,21,27897,2432,2433,584,3017,19
2021-06-21,Humboldt,23,135768,4483,4478,118,4596,42
2021-06-21,Imperial,25,180216,28675,28855,2898,31753,740
2021-06-21,Inyo,27,18085,1410,1405,4,1409,35
2021-06-21,Kern,29,883053,97219,96995,11601,108596,1342
2021-06-21,Kings,31,150075,23041,23091,1212,24303,245
2021-06-21,Lake,33,64148,3576,3563,13,3576,45
2021-06-21,Lassen,35,31185,5259,5233,123,5356,19
2021-06-21,Los Angeles,37,10098052,1206700,1205994,44199,1250193,24459
2021-06-21,Madera,39,155013,16657,16647,965,17612,240
2021-06-21,Marin,41,260295,14142,14173,273,14446,230
2021-06-21,Mariposa,43,17540,441,439,12,451,5
2021-06-21,Mendocino,45,87422,4135,4085,71,4156,49
2021-06-21,Merced,47,269075,31211,31264,1011,32275,465
2021-06-21,Modoc,49,8938,409,405,145,550,3
2021-06-21,Mono,51,14174,1254,1277,15,1292,3
2021-06-21,Monterey,53,433212,43159,43157,1940,45097,427
2021-06-21,Napa,55,140530,10011,10028,36,10064,80
2021-06-21,Nevada,57,99092,4946,4921,201,5122,72
2021-06-21,Orange,59,3164182,255426,255400,11894,267294,5113
2021-06-21,Placer,61,380077,23655,23577,1613,25190,298
2021-06-21,Plumas,63,18699,716,697,12,709,4
2021-06-21,Riverside,65,2383286,292277,289797,14933,304730,4456
2021-06-21,Sacramento,67,1510023,107784,107757,1926,109683,1669
2021-06-21,San Benito,69,59416,6086,6098,120,6218,63
2021-06-21,San Bernardino,71,2135413,293704,293736,9291,303027,4850
2021-06-21,San Diego,73,3302833,282285,281811,0,281811,3771
2021-06-21,San Francisco,75,870044,36972,37275,1409,38684,556
2021-06-21,San Joaquin,77,732212,73725,73687,3845,77532,1405
2021-06-21,San Luis Obispo,79,281455,21308,21316,792,22108,257
2021-06-21,San Mateo,81,765935,42650,42685,490,43175,542
2021-06-21,Santa Barbara,83,443738,34555,34492,1354,35846,455
2021-06-21,Santa Clara,85,1922200,118793,120192,824,121016,2093
2021-06-21,Santa Cruz,87,273765,16235,16212,877,17089,208
2021-06-21,Shasta,89,179085,12545,12617,1807,14424,201
2021-06-21,Sierra,91,2930,60,57,14,71,0
2021-06-21,Siskiyou,93,43540,1939,1892,398,2290,27
2021-06-21,Solano,95,438530,33340,33383,575,33958,266
2021-06-21,Sonoma,97,501317,30841,30912,377,31289,314
2021-06-21,Stanislaus,99,539301,56797,56891,6261,63152,1017
2021-06-21,Sutter,101,95872,9604,9649,95,9744,113
2021-06-21,Tehama,103,63373,5106,5115,636,5751,63
2021-06-21,Trinity,105,12862,365,337,65,402,3
2021-06-21,Tulare,107,460477,49748,49689,9665,59354,849
2021-06-21,Tuolumne,109,53932,4111,4119,171,4290,63
2021-06-21,Ventura,111,848112,81313,81291,3184,84475,1031
2021-06-21,Yolo,113,214977,14153,14165,367,14532,212
2021-06-21,Yuba,115,75493,6184,6172,137,6309,51
2021-06-20,Alameda,1,1643700,89115,89255,2089,91344,1263
2021-06-20,Alpine,3,1148,89,88,0,88,0
2021-06-20,Amador,5,37829,3744,3740,35,3775,46
2021-06-20,Butte,7,227075,12677,12668,1945,14613,194
2021-06-20,Calaveras,9,45235,2194,2193,16,2209,55
2021-06-20,Colusa,11,21464,1959,1970,329,2299,15
2021-06-20,Contra Costa,13,1133247,70666,70401,1384,71785,813
2021-06-20,Del Norte,15,27424,1422,1416,9,1425,8
2021-06-20,El Dorado,17,186661,10370,10372,796,11168,113
2021-06-20,Fresno,19,978130,102440,102947,9179,112126,1724
2021-06-20,Glenn,21,27897,2432,2434,584,3018,19
2021-06-20,Humboldt,23,135768,4477,4472,116,4588,42
2021-06-20,Imperial,25,180216,28666,28855,2898,31753,740
2021-06-20,Inyo,27,18085,1409,1405,4,1409,35
2021-06-20,Kern,29,883053,97198,96985,11590,108575,1342
2021-06-20,Kings,31,150075,23036,23088,1210,24298,245
2021-06-20,Lake,33,64148,3574,3563,13,3576,45
2021-06-20,Lassen,35,31185,5256,5230,123,5353,19
2021-06-20,Los Angeles,37,10098052,1206407,1205874,44189,1250063,24456
2021-06-20,Madera,39,155013,16649,16638,964,17602,240
2021-06-20,Marin,41,260295,14139,14166,273,14439,230
2021-06-20,Mariposa,43,17540,439,439,12,451,5
2021-06-20,Mendocino,45,87422,4128,4080,71,4151,49
2021-06-20,Merced,47,269075,31199,31265,1011,32276,465
2021-06-20,Modoc,49,8938,409,405,145,550,3
2021-06-20,Mono,51,14174,1254,1275,15,1290,3
2021-06-20,Monterey,53,433212,43150,43156,1939,45095,427
2021-06-20,Napa,55,140530,10004,10026,35,10061,80
2021-06-20,Nevada,57,99092,4939,4919,201,5120,72
2021-06-20,Orange,59,3164182,255364,255377,11883,267260,5113
2021-06-20,Placer,61,380077,23622,23562,1609,25171,298
2021-06-20,Plumas,63,18699,715,697,12,709,4
2021-06-20,Riverside,65,2383286,292202,289770,14923,304693,4456
2021-06-20,Sacramento,67,1510023,107676,107700,1923,109623,1669
2021-06-20,San Benito,69,59416,6086,6098,120,6218,63
2021-06-20,San Bernardino,71,2135413,293605,293713,9288,303001,4845
2021-06-20,San Diego,73,3302833,282180,281750,0,281750,3771
2021-06-20,San Francisco,75,870044,36951,37269,1409,38678,556
2021-06-20,San Joaquin,77,732212,73682,73676,3837,77513,1405
2021-06-20,San Luis Obispo,79,281455,21306,21313,792,22105,257
2021-06-20,San Mateo,81,765935,42622,42681,490,43171,542
2021-06-20,Santa Barbara,83,443738,34546,34487,1354,35841,455
2021-06-20,Santa Clara,85,1922200,118758,120163,824,120987,2093
2021-06-20,Santa Cruz,87,273765,16228,16210,877,17087,208
2021-06-20,Shasta,89,179085,12540,12617,1804,14421,201
2021-06-20,Sierra,91,2930,60,57,14,71,0
2021-06-20,Siskiyou,93,43540,1938,1891,398,2289,27
2021-06-20,Solano,95,438530,33318,33361,573,33934,266
2021-06-20,Sonoma,97,501317,30795,30884,373,31257,314
2021-06-20,Stanislaus,99,539301,56762,56868,6260,63128,1017
2021-06-20,Sutter,101,95872,9601,9645,95,9740,113
2021-06-20,Tehama,103,63373,5102,5115,636,5751,63
2021-06-20,Trinity,105,12862,365,337,65,402,3
2021-06-20,Tulare,107,460477,49739,49685,9663,59348,849
2021-06-20,Tuolumne,109,53932,4108,4117,171,4288,63
2021-06-20,Ventura,111,848112,81297,81282,3182,84464,1031
2021-06-20,Yolo,113,214977,14146,14160,367,14527,212
2021-06-20,Yuba,115,75493,6177,6167,137,6304,51
2021-06-19,Alameda,1,1643700,89082,89202,2089,91291,1263
2021-06-19,Alpine,3,1148,89,88,0,88,0
2021-06-19,Amador,5,37829,3742,3739,35,3774,46
2021-06-19,Butte,7,227075,12673,12659,1945,14604,194
2021-06-19,Calaveras,9,45235,2194,2192,16,2208,55
2021-06-19,Colusa,11,21464,1959,1969,329,2298,15
2021-06-19,Contra Costa,13,1133247,70632,70334,1383,71717,813
2021-06-19,Del Norte,15,27424,1421,1416,9,1425,8
2021-06-19,El Dorado,17,186661,10369,10363,795,11158,113
2021-06-19,Fresno,19,978130,102427,102922,9174,112096,1724
2021-06-19,Glenn,21,27897,2431,2434,583,3017,19
2021-06-19,Humboldt,23,135768,4466,4463,116,4579,42
2021-06-19,Imperial,25,180216,28665,28813,2898,31711,740
2021-06-19,Inyo,27,18085,1409,1405,4,1409,35
2021-06-19,Kern,29,883053,97182,96966,11585,108551,1342
2021-06-19,Kings,31,150075,23033,23086,1210,24296,245
2021-06-19,Lake,33,64148,3570,3563,13,3576,45
2021-06-19,Lassen,35,31185,5255,5225,123,5348,19
2021-06-19,Los Angeles,37,10098052,1206211,1205602,44174,1249776,24454
2021-06-19,Madera,39,155013,16647,16632,964,17596,240
2021-06-19,Marin,41,260295,14131,14152,273,14425,230
2021-06-19,Mariposa,43,17540,439,439,12,451,5
2021-06-19,Mendocino,45,87422,4122,4077,71,4148,49
2021-06-19,Merced,47,269075,31197,31256,1011,32267,465
2021-06-19,Modoc,49,8938,408,402,145,547,3
2021-06-19,Mono,51,14174,1254,1275,15,1290,3
2021-06-19,Monterey,53,433212,43144,43153,1939,45092,427
2021-06-19,Napa,55,140530,10000,10025,35,10060,80
2021-06-19,Nevada,57,99092,4934,4910,201,5111,72
2021-06-19,Orange,59,3164182,255319,255329,11879,267208,5112
2021-06-19,Placer,61,380077,23605,23537,1606,25143,298
2021-06-19,Plumas,63,18699,714,697,12,709,4
2021-06-19,Riverside,65,2383286,292161,289720,14923,304643,4456
2021-06-19,Sacramento,67,1510023,107632,107631,1920,109551,1669
2021-06-19,San Benito,69,59416,6085,6098,120,6218,63
2021-06-19,San Bernardino,71,2135413,293561,293673,9285,302958,4844
2021-06-19,San Diego,73,3302833,282120,281682,0,281682,3771
2021-06-19,San Francisco,75,870044,36939,37256,1408,38664,556
2021-06-19,San Joaquin,77,732212,73666,73652,3833,77485,1405
2021-06-19,San Luis Obispo,79,281455,21304,21308,792,22100,257
2021-06-19,San Mateo,81,765935,42607,42646,488,43134,542
2021-06-19,Santa Barbara,83,443738,34544,34472,1354,35826,455
2021-06-19,Santa Clara,85,1922200,118735,120110,823,120933,2093
2021-06-19,Santa Cruz,87,273765,16224,16206,877,17083,208
2021-06-19,Shasta,89,179085,12538,12615,1804,14419,201
2021-06-19,Sierra,91,2930,60,57,14,71,0
2021-06-19,Siskiyou,93,43540,1938,1891,397,2288,27
2021-06-19,Solano,95,438530,33308,33341,572,33913,266
2021-06-19,Sonoma,97,501317,30754,30841,372,31213,314
2021-06-19,Stanislaus,99,539301,56743,56847,6257,63104,1017
2021-06-19,Sutter,101,95872,9598,9645,95,9740,113
2021-06-19,Tehama,103,63373,5101,5115,636,5751,63
2021-06-19,Trinity,105,12862,365,337,65,402,3
2021-06-19,Tulare,107,460477,49732,49681,9658,59339,849
2021-06-19,Tuolumne,109,53932,4108,4117,171,4288,63
2021-06-19,Ventura,111,848112,81284,81270,3181,84451,1031
2021-06-19,Yolo,113,214977,14142,14156,366,14522,212
2021-06-19,Yuba,115,75493,6176,6157,137,6294,51
2021-06-18,Alameda,1,1643700,89044,89123,2089,91212,1263
2021-06-18,Alpine,3,1148,89,88,0,88,0
2021-06-18,Amador,5,37829,3742,3739,35,3774,46
2021-06-18,Butte,7,227075,12670,12653,1942,14595,194
2021-06-18,Calaveras,9,45235,2194,2191,16,2207,55
2021-06-18,Colusa,11,21464,1958,1969,329,2298,15
2021-06-18,Contra Costa,13,1133247,70591,70271,1381,71652,813
2021-06-18,Del Norte,15,27424,1421,1415,9,1424,8
2021-06-18,El Dorado,17,186661,10367,10348,793,11141,113
2021-06-18,Fresno,19,978130,102411,102894,9172,112066,1722
2021-06-18,Glenn,21,27897,2430,2430,583,3013,19
2021-06-18,Humboldt,23,135768,4458,4450,116,4566,42
2021-06-18,Imperial,25,180216,28663,28809,2898,31707,740
2021-06-18,Inyo,27,18085,1409,1405,4,1409,35
2021-06-18,Kern,29,883053,97171,96948,11579,108527,1341
2021-06-18,Kings,31,150075,23028,23082,1210,24292,245
2021-06-18,Lake,33,64148,3566,3563,13,3576,45
2021-06-18,Lassen,35,31185,5254,5224,123,5347,19
2021-06-18,Los Angeles,37,10098052,1206055,1205472,44156,1249628,24451
2021-06-18,Madera,39,155013,16641,16625,964,17589,241
2021-06-18,Marin,41,260295,14128,14147,273,14420,230
2021-06-18,Mariposa,43,17540,439,439,12,451,5
2021-06-18,Mendocino,45,87422,4117,4068,71,4139,49
2021-06-18,Merced,47,269075,31195,31262,1011,32273,464
2021-06-18,Modoc,49,8938,408,402,145,547,3
2021-06-18,Mono,51,14174,1253,1275,14,1289,3
2021-06-18,Monterey,53,433212,43141,43148,1939,45087,427
2021-06-18,Napa,55,140530,9996,10021,35,10056,80
2021-06-18,Nevada,57,99092,4926,4903,201,5104,72
2021-06-18,Orange,59,3164182,255283,255274,11876,267150,5108
2021-06-18,Placer,61,380077,23596,23500,1603,25103,298
2021-06-18,Plumas,63,18699,714,697,12,709,4
2021-06-18,Riverside,65,2383286,292112,289676,14922,304598,4457
2021-06-18,Sacramento,67,1510023,107585,107570,1920,109490,1669
2021-06-18,San Benito,69,59416,6084,6097,120,6217,63
2021-06-18,San Bernardino,71,2135413,293519,293629,9280,302909,4826
2021-06-18,San Diego,73,3302833,282044,281608,0,281608,3771
2021-06-18,San Francisco,75,870044,36930,37246,1408,38654,556
2021-06-18,San Joaquin,77,732212,73648,73623,3831,77454,1403
2021-06-18,San Luis Obispo,79,281455,21300,21301,791,22092,257
2021-06-18,San Mateo,81,765935,42596,42630,487,43117,542
2021-06-18,Santa Barbara,83,443738,34534,34469,1354,35823,455
2021-06-18,Santa Clara,85,1922200,118714,120081,822,120903,2093
2021-06-18,Santa Cruz,87,273765,16220,16202,877,17079,208
2021-06-18,Shasta,89,179085,12534,12607,1802,14409,201
2021-06-18,Sierra,91,2930,59,57,14,71,0
2021-06-18,Siskiyou,93,43540,1938,1890,397,2287,27
2021-06-18,Solano,95,438530,33294,33323,572,33895,266
2021-06-18,Sonoma,97,501317,30737,30816,370,31186,313
2021-06-18,Stanislaus,99,539301,56728,56803,6255,63058,1012
2021-06-18,Sutter,101,95872,9595,9643,95,9738,113
2021-06-18,Tehama,103,63373,5099,5114,636,5750,63
2021-06-18,Trinity,105,12862,365,337,64,401,3
2021-06-18,Tulare,107,460477,49730,49664,9651,59315,849
2021-06-18,Tuolumne,109,53932,4106,4116,171,4287,63
2021-06-18,Ventura,111,848112,81274,81256,3177,84433,1031
2021-06-18,Yolo,113,214977,14139,14148,364,14512,212
2021-06-18,Yuba,115,75493,6170,6150,137,6287,51
2021-06-17,Alameda,1,1643700,88997,89087,2089,91176,1262
2021-06-17,Alpine,3,1148,89,88,0,88,0
2021-06-17,Amador,5,37829,3740,3731,35,3766,46
2021-06-17,Butte,7,227075,12660,12644,1941,14585,194
2021-06-17,Calaveras,9,45235,2193,2189,16,2205,55
2021-06-17,Colusa,11,21464,1957,1969,329,2298,15
2021-06-17,Contra Costa,13,1133247,70552,70190,1378,71568,810
2021-06-17,Del Norte,15,27424,1419,1413,9,1422,8
2021-06-17,El Dorado,17,186661,10357,10341,793,11134,113
2021-06-17,Fresno,19,978130,102385,102867,9167,112034,1722
2021-06-17,Glenn,21,27897,2430,2430,583,3013,19
2021-06-17,Humboldt,23,135768,4449,4438,116,4554,42
2021-06-17,Imperial,25,180216,28655,28801,2898,31699,741
2021-06-17,Inyo,27,18085,1409,1405,4,1409,35
2021-06-17,Kern,29,883053,97156,96840,11572,108412,1340
2021-06-17,Kings,31,150075,23024,23078,1209,24287,245
2021-06-17,Lake,33,64148,3563,3563,9,3572,45
2021-06-17,Lassen,35,31185,5250,5223,123,5346,19
2021-06-17,Los Angeles,37,10098052,1205846,1205301,44126,1249427,24444
2021-06-17,Madera,39,155013,16636,16618,964,17582,241
2021-06-17,Marin,41,260295,14128,14141,273,14414,229
2021-06-17,Mariposa,43,17540,439,439,12,451,5
2021-06-17,Mendocino,45,87422,4110,4054,71,4125,49
2021-06-17,Merced,47,269075,31190,31262,1011,32273,464
2021-06-17,Modoc,49,8938,407,401,145,546,3
2021-06-17,Mono,51,14174,1252,1275,14,1289,3
2021-06-17,Monterey,53,433212,43134,43140,1939,45079,416
2021-06-17,Napa,55,140530,9996,10014,35,10049,80
2021-06-17,Nevada,57,99092,4922,4898,201,5099,72
2021-06-17,Orange,59,3164182,255241,255240,11864,267104,5109
2021-06-17,Placer,61,380077,23580,23461,1601,25062,298
2021-06-17,Plumas,63,18699,713,697,12,709,4
2021-06-17,Riverside,65,2383286,292059,289627,14919,304546,4458
2021-06-17,Sacramento,67,1510023,107521,107492,1918,109410,1666
2021-06-17,San Benito,69,59416,6084,6097,120,6217,63
2021-06-17,San Bernardino,71,2135413,293483,293560,9280,302840,4811
2021-06-17,San Diego,73,3302833,281967,281531,0,281531,3771
2021-06-17,San Francisco,75,870044,36919,37243,1407,38650,556
2021-06-17,San Joaquin,77,732212,73625,73560,3826,77386,1403
2021-06-17,San Luis Obispo,79,281455,21298,21297,791,22088,257
2021-06-17,San Mateo,81,765935,42589,42615,487,43102,542
2021-06-17,Santa Barbara,83,443738,34528,34466,1354,35820,453
2021-06-17,Santa Clara,85,1922200,118689,120032,821,120853,2093
2021-06-17,Santa Cruz,87,273765,16216,16197,877,17074,208
2021-06-17,Shasta,89,179085,12526,12597,1802,14399,201
2021-06-17,Sierra,91,2930,59,56,14,70,0
2021-06-17,Siskiyou,93,43540,1937,1889,397,2286,27
2021-06-17,Solano,95,438530,33274,33296,570,33866,266
2021-06-17,Sonoma,97,501317,30706,30793,370,31163,323
2021-06-17,Stanislaus,99,539301,56697,56752,6249,63001,1012
2021-06-17,Sutter,101,95872,9592,9629,95,9724,113
2021-06-17,Tehama,103,63373,5098,5112,634,5746,63
2021-06-17,Trinity,105,12862,365,337,64,401,3
2021-06-17,Tulare,107,460477,49725,49649,9643,59292,849
2021-06-17,Tuolumne,109,53932,4105,4116,171,4287,63
2021-06-17,Ventura,111,848112,81265,81248,3172,84420,1030
2021-06-17,Yolo,113,214977,14131,14141,364,14505,212
2021-06-17,Yuba,115,75493,6161,6140,137,6277,51
2021-06-16,Alameda,1,1643700,88946,89045,2085,91130,1265
2021-06-16,Alpine,3,1148,89,88,0,88,0
2021-06-16,Amador,5,37829,3739,3730,35,3765,46
2021-06-16,Butte,7,227075,12658,12635,1939,14574,194
2021-06-16,Calaveras,9,45235,2191,2188,16,2204,55
2021-06-16,Colusa,11,21464,1957,1967,329,2296,15
2021-06-16,Contra Costa,13,1133247,70500,70136,1377,71513,810
2021-06-16,Del Norte,15,27424,1416,1413,9,1422,8
2021-06-16,El Dorado,17,186661,10351,10334,792,11126,113
2021-06-16,Fresno,19,978130,102355,102842,9160,112002,1722
2021-06-16,Glenn,21,27897,2430,2430,583,3013,19
2021-06-16,Humboldt,23,135768,4440,4427,113,4540,42
2021-06-16,Imperial,25,180216,28652,28796,2898,31694,741
2021-06-16,Inyo,27,18085,1408,1405,4,1409,35
2021-06-16,Kern,29,883053,97135,96789,11563,108352,1339
2021-06-16,Kings,31,150075,23023,23072,1208,24280,245
2021-06-16,Lake,33,64148,3563,3562,9,3571,45
2021-06-16,Lassen,35,31185,5247,5216,123,5339,19
2021-06-16,Los Angeles,37,10098052,1205623,1205102,44114,1249216,24439
2021-06-16,Madera,39,155013,16632,16603,964,17567,240
2021-06-16,Marin,41,260295,14126,14137,273,14410,229
2021-06-16,Mariposa,43,17540,439,437,12,449,5
2021-06-16,Mendocino,45,87422,4102,4041,71,4112,49
2021-06-16,Merced,47,269075,31182,31250,1011,32261,463
2021-06-16,Modoc,49,8938,406,383,144,527,3
2021-06-16,Mono,51,14174,1252,1275,14,1289,3
2021-06-16,Monterey,53,433212,43131,43122,1939,45061,416
2021-06-16,Napa,55,140530,9992,10011,35,10046,80
2021-06-16,Nevada,57,99092,4917,4894,201,5095,72
2021-06-16,Orange,59,3164182,255193,255188,11857,267045,5109
2021-06-16,Placer,61,380077,23570,23425,1597,25022,298
2021-06-16,Plumas,63,18699,713,697,12,709,4
2021-06-16,Riverside,65,2383286,291998,289539,14917,304456,4457
2021-06-16,Sacramento,67,1510023,107449,107422,1914,109336,1665
2021-06-16,San Benito,69,59416,6084,6090,120,6210,63
2021-06-16,San Bernardino,71,2135413,293434,293499,9278,302777,4797
2021-06-16,San Diego,73,3302833,281889,281423,0,281423,3770
2021-06-16,San Francisco,75,870044,36906,37222,1405,38627,555
2021-06-16,San Joaquin,77,732212,73588,73530,3822,77352,1399
2021-06-16,San Luis Obispo,79,281455,21293,21294,791,22085,257
2021-06-16,San Mateo,81,765935,42573,42601,487,43088,542
2021-06-16,Santa Barbara,83,443738,34522,34459,1353,35812,460
2021-06-16,Santa Clara,85,1922200,118657,119982,821,120803,2087
2021-06-16,Santa Cruz,87,273765,16213,16187,877,17064,208
2021-06-16,Shasta,89,179085,12521,12592,1801,14393,200
2021-06-16,Sierra,91,2930,59,56,14,70,0
2021-06-16,Siskiyou,93,43540,1936,1886,397,2283,26
2021-06-16,Solano,95,438530,33246,33276,570,33846,266
2021-06-16,Sonoma,97,501317,30671,30741,370,31111,323
2021-06-16,Stanislaus,99,539301,56666,56738,6247,62985,984
2021-06-16,Sutter,101,95872,9588,9620,95,9715,113
2021-06-16,Tehama,103,63373,5096,5106,634,5740,63
2021-06-16,Trinity,105,12862,364,332,64,396,3
2021-06-16,Tulare,107,460477,49720,49578,9639,59217,849
2021-06-16,Tuolumne,109,53932,4105,4110,171,4281,63
2021-06-16,Ventura,111,848112,81251,81229,3170,84399,1029
2021-06-16,Yolo,113,214977,14122,14135,363,14498,212
2021-06-16,Yuba,115,75493,6151,6134,137,6271,51
2021-06-15,Alameda,1,1643700,88902,89008,2085,91093,1262
2021-06-15,Alpine,3,1148,89,88,0,88,0
2021-06-15,Amador,5,37829,3736,3723,35,3758,46
2021-06-15,Butte,7,227075,12650,12620,1938,14558,194
2021-06-15,Calaveras,9,45235,2190,2188,16,2204,55
2021-06-15,Colusa,11,21464,1957,1967,327,2294,15
2021-06-15,Contra Costa,13,1133247,70438,70101,1377,71478,810
2021-06-15,Del Norte,15,27424,1415,1411,9,1420,8
2021-06-15,El Dorado,17,186661,10342,10330,792,11122,113
2021-06-15,Fresno,19,978130,102325,102828,9158,111986,1722
2021-06-15,Glenn,21,27897,2429,2426,583,3009,19
2021-06-15,Humboldt,23,135768,4431,4414,110,4524,42
2021-06-15,Imperial,25,180216,28646,28789,2898,31687,741
2021-06-15,Inyo,27,18085,1408,1405,4,1409,35
2021-06-15,Kern,29,883053,97107,96782,11554,108336,1338
2021-06-15,Kings,31,150075,23017,23070,1207,24277,245
2021-06-15,Lake,33,64148,3562,3559,9,3568,45
2021-06-15,Lassen,35,31185,5246,5211,123,5334,19
2021-06-15,Los Angeles,37,10098052,1205396,1204926,44105,1249031,24435
2021-06-15,Madera,39,155013,16625,16600,963,17563,240
2021-06-15,Marin,41,260295,14118,14135,273,14408,229
2021-06-15,Mariposa,43,17540,439,437,12,449,5
2021-06-15,Mendocino,45,87422,4095,4034,71,4105,49
2021-06-15,Merced,47,269075,31176,31244,1011,32255,461
2021-06-15,Modoc,49,8938,405,383,144,527,3
2021-06-15,Mono,51,14174,1252,1275,14,1289,3
2021-06-15,Monterey,53,433212,43125,43118,1939,45057,416
2021-06-15,Napa,55,140530,9990,10010,35,10045,80
2021-06-15,Nevada,57,99092,4914,4888,201,5089,72
2021-06-15,Orange,59,3164182,255156,255127,11848,266975,5105
2021-06-15,Placer,61,380077,23548,23396,1596,24992,298
2021-06-15,Plumas,63,18699,712,697,12,709,4
2021-06-15,Riverside,65,2383286,291941,289508,14913,304421,4455
2021-06-15,Sacramento,67,1510023,107375,107370,1907,109277,1662
2021-06-15,San Benito,69,59416,6083,6089,120,6209,63
2021-06-15,San Bernardino,71,2135413,293382,293463,9274,302737,4790
2021-06-15,San Diego,73,3302833,281805,281375,0,281375,3770
2021-06-15,San Francisco,75,870044,36897,37210,1404,38614,555
2021-06-15,San Joaquin,77,732212,73549,73494,3818,77312,1399
2021-06-15,San Luis Obispo,79,281455,21288,21293,790,22083,257
2021-06-15,San Mateo,81,765935,42560,42593,487,43080,543
2021-06-15,Santa Barbara,83,443738,34517,34451,1353,35804,460
2021-06-15,Santa Clara,85,1922200,118619,119963,821,120784,2086
2021-06-15,Santa Cruz,87,273765,16206,16180,877,17057,208
2021-06-15,Shasta,89,179085,12515,12583,1799,14382,201
2021-06-15,Sierra,91,2930,58,55,14,69,0
2021-06-15,Siskiyou,93,43540,1935,1887,397,2284,26
2021-06-15,Solano,95,438530,33227,33264,570,33834,266
2021-06-15,Sonoma,97,501317,30632,30707,369,31076,323
2021-06-15,Stanislaus,99,539301,56637,56724,6244,62968,979
2021-06-15,Sutter,101,95872,9579,9616,95,9711,113
2021-06-15,Tehama,103,63373,5095,5102,634,5736,63
2021-06-15,Trinity,105,12862,363,332,64,396,3
2021-06-15,Tulare,107,460477,49714,49561,9635,59196,848
2021-06-15,Tuolumne,109,53932,4105,4111,171,4282,63
2021-06-15,Ventura,111,848112,81240,81215,3167,84382,1029
2021-06-15,Yolo,113,214977,14118,14127,361,14488,212
2021-06-15,Yuba,115,75493,6140,6130,137,6267,51
2021-06-14,Alameda,1,1643700,88849,88966,2084,91050,1264
2021-06-14,Alpine,3,1148,89,88,0,88,0
2021-06-14,Amador,5,37829,3735,3722,35,3757,46
2021-06-14,Butte,7,227075,12639,12613,1934,14547,194
2021-06-14,Calaveras,9,45235,2188,2190,16,2206,55
2021-06-14,Colusa,11,21464,1956,1966,327,2293,15
2021-06-14,Contra Costa,13,1133247,70385,70069,1375,71444,810
2021-06-14,Del Norte,15,27424,1415,1411,9,1420,8
2021-06-14,El Dorado,17,186661,10333,10327,791,11118,113
2021-06-14,Fresno,19,978130,102303,102812,9157,111969,1719
2021-06-14,Glenn,21,27897,2429,2426,583,3009,19
2021-06-14,Humboldt,23,135768,4423,4407,106,4513,42
2021-06-14,Imperial,25,180216,28634,28836,2898,31734,741
2021-06-14,Inyo,27,18085,1407,1405,4,1409,35
2021-06-14,Kern,29,883053,97089,96760,11543,108303,1337
2021-06-14,Kings,31,150075,23015,23071,1205,24276,245
2021-06-14,Lake,33,64148,3561,3557,9,3566,45
2021-06-14,Lassen,35,31185,5243,5209,122,5331,19
2021-06-14,Los Angeles,37,10098052,1205171,1204748,44095,1248843,24434
2021-06-14,Madera,39,155013,16620,16597,962,17559,240
2021-06-14,Marin,41,260295,14116,14133,273,14406,229
2021-06-14,Mariposa,43,17540,438,437,12,449,5
2021-06-14,Mendocino,45,87422,4089,4028,71,4099,49
2021-06-14,Merced,47,269075,31167,31241,1010,32251,461
2021-06-14,Modoc,49,8938,396,382,142,524,3
2021-06-14,Mono,51,14174,1252,1275,14,1289,3
2021-06-14,Monterey,53,433212,43122,43110,1939,45049,415
2021-06-14,Napa,55,140530,9986,10000,35,10035,80
2021-06-14,Nevada,57,99092,4907,4885,201,5086,72
2021-06-14,Orange,59,3164182,255120,255069,11843,266912,5103
2021-06-14,Placer,61,380077,23523,23379,1595,24974,298
2021-06-14,Plumas,63,18699,712,696,12,708,4
2021-06-14,Riverside,65,2383286,291891,289476,14911,304387,4453
2021-06-14,Sacramento,67,1510023,107323,107334,1901,109235,1661
2021-06-14,San Benito,69,59416,6083,6087,120,6207,63
2021-06-14,San Bernardino,71,2135413,293327,293446,9270,302716,4790
2021-06-14,San Diego,73,3302833,281700,281314,0,281314,3770
2021-06-14,San Francisco,75,870044,36884,37206,1404,38610,555
2021-06-14,San Joaquin,77,732212,73520,73453,3818,77271,1398
2021-06-14,San Luis Obispo,79,281455,21286,21302,790,22092,256
2021-06-14,San Mateo,81,765935,42546,42619,486,43105,543
2021-06-14,Santa Barbara,83,443738,34514,34449,1353,35802,460
2021-06-14,Santa Clara,85,1922200,118588,119957,820,120777,2085
2021-06-14,Santa Cruz,87,273765,16204,16175,877,17052,208
2021-06-14,Shasta,89,179085,12505,12561,1794,14355,201
2021-06-14,Sierra,91,2930,57,55,14,69,0
2021-06-14,Siskiyou,93,43540,1935,1886,397,2283,26
2021-06-14,Solano,95,438530,33209,33243,569,33812,266
2021-06-14,Sonoma,97,501317,30600,30679,368,31047,323
2021-06-14,Stanislaus,99,539301,56600,56689,6243,62932,975
2021-06-14,Sutter,101,95872,9576,9607,95,9702,112
2021-06-14,Tehama,103,63373,5093,5102,634,5736,63
2021-06-14,Trinity,105,12862,363,332,64,396,3
2021-06-14,Tulare,107,460477,49710,49538,9631,59169,848
2021-06-14,Tuolumne,109,53932,4102,4108,171,4279,63
2021-06-14,Ventura,111,848112,81230,81209,3167,84376,1028
2021-06-14,Yolo,113,214977,14110,14123,361,14484,212
2021-06-14,Yuba,115,75493,6133,6127,137,6264,50
2021-06-13,Alameda,1,1643700,88792,88947,2082,91029,1264
2021-06-13,Alpine,3,1148,88,88,0,88,0
2021-06-13,Amador,5,37829,3731,3721,35,3756,46
2021-06-13,Butte,7,227075,12628,12586,1930,14516,194
2021-06-13,Calaveras,9,45235,2188,2189,16,2205,55
2021-06-13,Colusa,11,21464,1956,1965,326,2291,15
2021-06-13,Contra Costa,13,1133247,70331,70040,1373,71413,810
2021-06-13,Del Norte,15,27424,1413,1412,9,1421,8
2021-06-13,El Dorado,17,186661,10324,10324,791,11115,113
2021-06-13,Fresno,19,978130,102273,102795,9152,111947,1719
2021-06-13,Glenn,21,27897,2428,2425,581,3006,19
2021-06-13,Humboldt,23,135768,4410,4401,105,4506,42
2021-06-13,Imperial,25,180216,28625,28800,2898,31698,741
2021-06-13,Inyo,27,18085,1407,1405,4,1409,35
2021-06-13,Kern,29,883053,97067,96743,11530,108273,1337
2021-06-13,Kings,31,150075,23010,23069,1204,24273,245
2021-06-13,Lake,33,64148,3561,3556,9,3565,45
2021-06-13,Lassen,35,31185,5238,5209,122,5331,19
2021-06-13,Los Angeles,37,10098052,1204911,1204614,44082,1248696,24433
2021-06-13,Madera,39,155013,16606,16590,962,17552,240
2021-06-13,Marin,41,260295,14110,14126,273,14399,229
2021-06-13,Mariposa,43,17540,438,434,12,446,5
2021-06-13,Mendocino,45,87422,4082,4026,71,4097,49
2021-06-13,Merced,47,269075,31160,31240,1010,32250,461
2021-06-13,Modoc,49,8938,394,382,140,522,3
2021-06-13,Mono,51,14174,1252,1275,14,1289,3
2021-06-13,Monterey,53,433212,43114,43108,1939,45047,415
2021-06-13,Napa,55,140530,9980,9995,35,10030,80
2021-06-13,Nevada,57,99092,4902,4883,201,5084,72
2021-06-13,Orange,59,3164182,255067,255043,11841,266884,5103
2021-06-13,Placer,61,380077,23496,23365,1593,24958,295
2021-06-13,Plumas,63,18699,711,696,12,708,4
2021-06-13,Riverside,65,2383286,291824,289447,14908,304355,4453
2021-06-13,Sacramento,67,1510023,107250,107289,1898,109187,1658
2021-06-13,San Benito,69,59416,6083,6086,120,6206,63
2021-06-13,San Bernardino,71,2135413,293275,293416,9265,302681,4788
2021-06-13,San Diego,73,3302833,281624,281268,0,281268,3770
2021-06-13,San Francisco,75,870044,36873,37197,1404,38601,555
2021-06-13,San Joaquin,77,732212,73489,73438,3815,77253,1398
2021-06-13,San Luis Obispo,79,281455,21280,21298,789,22087,256
2021-06-13,San Mateo,81,765935,42532,42611,486,43097,542
2021-06-13,Santa Barbara,83,443738,34503,34449,1352,35801,460
2021-06-13,Santa Clara,85,1922200,118565,119946,820,120766,2085
2021-06-13,Santa Cruz,87,273765,16197,16172,877,17049,208
2021-06-13,Shasta,89,179085,12496,12560,1791,14351,201
2021-06-13,Sierra,91,2930,57,55,14,69,0
2021-06-13,Siskiyou,93,43540,1934,1885,397,2282,26
2021-06-13,Solano,95,438530,33187,33234,569,33803,266
2021-06-13,Sonoma,97,501317,30565,30663,366,31029,323
2021-06-13,Stanislaus,99,539301,56573,56671,6242,62913,975
2021-06-13,Sutter,101,95872,9569,9603,95,9698,112
2021-06-13,Tehama,103,63373,5091,5100,634,5734,63
2021-06-13,Trinity,105,12862,362,332,64,396,3
2021-06-13,Tulare,107,460477,49701,49537,9626,59163,848
2021-06-13,Tuolumne,109,53932,4100,4107,170,4277,63
2021-06-13,Ventura,111,848112,81216,81201,3167,84368,1028
2021-06-13,Yolo,113,214977,14103,14120,359,14479,212
2021-06-13,Yuba,115,75493,6126,6125,137,6262,50
2021-06-12,Alameda,1,1643700,88763,88901,2082,90983,1271
2021-06-12,Alpine,3,1148,88,88,0,88,0
2021-06-12,Amador,5,37829,3730,3721,35,3756,46
2021-06-12,Butte,7,227075,12624,12576,1930,14506,194
2021-06-12,Calaveras,9,45235,2188,2189,16,2205,55
2021-06-12,Colusa,11,21464,1956,1965,326,2291,15
2021-06-12,Contra Costa,13,1133247,70300,69989,1370,71359,810
2021-06-12,Del Norte,15,27424,1413,1412,9,1421,8
2021-06-12,El Dorado,17,186661,10320,10320,789,11109,113
2021-06-12,Fresno,19,978130,102263,102783,9150,111933,1720
2021-06-12,Glenn,21,27897,2426,2425,581,3006,19
2021-06-12,Humboldt,23,135768,4402,4396,105,4501,42
2021-06-12,Imperial,25,180216,28622,28799,2898,31697,741
2021-06-12,Inyo,27,18085,1407,1405,4,1409,35
2021-06-12,Kern,29,883053,97052,96731,11525,108256,1337
2021-06-12,Kings,31,150075,23008,23067,1204,24271,245
2021-06-12,Lake,33,64148,3560,3552,9,3561,45
2021-06-12,Lassen,35,31185,5238,5208,122,5330,19
2021-06-12,Los Angeles,37,10098052,1204775,1204439,44073,1248512,24434
2021-06-12,Madera,39,155013,16602,16586,962,17548,240
2021-06-12,Marin,41,260295,14107,14121,273,14394,229
2021-06-12,Mariposa,43,17540,438,434,12,446,5
2021-06-12,Mendocino,45,87422,4079,4024,71,4095,49
2021-06-12,Merced,47,269075,31157,31236,1010,32246,461
2021-06-12,Modoc,49,8938,393,382,140,522,3
2021-06-12,Mono,51,14174,1252,1275,14,1289,3
2021-06-12,Monterey,53,433212,43109,43103,1939,45042,415
2021-06-12,Napa,55,140530,9976,9986,35,10021,80
2021-06-12,Nevada,57,99092,4896,4878,201,5079,72
2021-06-12,Orange,59,3164182,255039,255004,11839,266843,5103
2021-06-12,Placer,61,380077,23478,23345,1593,24938,295
2021-06-12,Plumas,63,18699,711,696,12,708,4
2021-06-12,Riverside,65,2383286,291782,289413,14906,304319,4453
2021-06-12,Sacramento,67,1510023,107190,107199,1895,109094,1658
2021-06-12,San Benito,69,59416,6081,6083,120,6203,63
2021-06-12,San Bernardino,71,2135413,293242,293375,9263,302638,4788
2021-06-12,San Diego,73,3302833,281568,281203,0,281203,3770
2021-06-12,San Francisco,75,870044,36863,37189,1404,38593,555
2021-06-12,San Joaquin,77,732212,73470,73413,3814,77227,1398
2021-06-12,San Luis Obispo,79,281455,21277,21293,789,22082,256
2021-06-12,San Mateo,81,765935,42526,42604,486,43090,542
2021-06-12,Santa Barbara,83,443738,34499,34450,1352,35802,460
2021-06-12,Santa Clara,85,1922200,118525,119894,820,120714,2085
2021-06-12,Santa Cruz,87,273765,16189,16170,877,17047,208
2021-06-12,Shasta,89,179085,12493,12556,1790,14346,201
2021-06-12,Sierra,91,2930,57,55,14,69,0
2021-06-12,Siskiyou,93,43540,1933,1884,397,2281,25
2021-06-12,Solano,95,438530,33178,33219,569,33788,266
2021-06-12,Sonoma,97,501317,30537,30647,365,31012,323
2021-06-12,Stanislaus,99,539301,56556,56649,6241,62890,974
2021-06-12,Sutter,101,95872,9565,9603,95,9698,112
2021-06-12,Tehama,103,63373,5091,5099,633,5732,63
2021-06-12,Trinity,105,12862,362,332,64,396,3
2021-06-12,Tulare,107,460477,49696,49533,9619,59152,848
2021-06-12,Tuolumne,109,53932,4099,4105,170,4275,63
2021-06-12,Ventura,111,848112,81204,81197,3167,84364,1028
2021-06-12,Yolo,113,214977,14100,14118,357,14475,212
2021-06-12,Yuba,115,75493,6121,6120,137,6257,50
2021-06-11,Alameda,1,1643700,88734,88844,2082,90926,1278
2021-06-11,Alpine,3,1148,88,88,0,88,0
2021-06-11,Amador,5,37829,3730,3710,35,3745,46
2021-06-11,Butte,7,227075,12621,12576,1928,14504,194
2021-06-11,Calaveras,9,45235,2188,2188,16,2204,55
2021-06-11,Colusa,11,21464,1955,1964,326,2290,15
2021-06-11,Contra Costa,13,1133247,70267,69940,1368,71308,808
2021-06-11,Del Norte,15,27424,1413,1409,9,1418,8
2021-06-11,El Dorado,17,186661,10317,10316,789,11105,113
2021-06-11,Fresno,19,978130,102246,102770,9149,111919,1720
2021-06-11,Glenn,21,27897,2426,2425,581,3006,19
2021-06-11,Humboldt,23,135768,4398,4389,105,4494,42
2021-06-11,Imperial,25,180216,28617,28793,2898,31691,741
2021-06-11,Inyo,27,18085,1407,1405,4,1409,35
2021-06-11,Kern,29,883053,97040,96718,11521,108239,1340
2021-06-11,Kings,31,150075,23004,23069,1203,24272,245
2021-06-11,Lake,33,64148,3559,3550,9,3559,45
2021-06-11,Lassen,35,31185,5237,5204,122,5326,18
2021-06-11,Los Angeles,37,10098052,1204631,1204259,44059,1248318,24434
2021-06-11,Madera,39,155013,16599,16582,962,17544,240
2021-06-11,Marin,41,260295,14104,14116,273,14389,229
2021-06-11,Mariposa,43,17540,438,434,12,446,5
2021-06-11,Mendocino,45,87422,4076,4022,71,4093,49
2021-06-11,Merced,47,269075,31152,31231,1010,32241,461
2021-06-11,Modoc,49,8938,393,382,139,521,3
2021-06-11,Mono,51,14174,1252,1274,14,1288,3
2021-06-11,Monterey,53,433212,43105,43097,1939,45036,415
2021-06-11,Napa,55,140530,9973,9977,35,10012,80
2021-06-11,Nevada,57,99092,4894,4873,201,5074,72
2021-06-11,Orange,59,3164182,255014,254975,11835,266810,5101
2021-06-11,Placer,61,380077,23473,23330,1593,24923,294
2021-06-11,Plumas,63,18699,711,696,12,708,4
2021-06-11,Riverside,65,2383286,291744,289376,14904,304280,4451
2021-06-11,Sacramento,67,1510023,107130,107119,1894,109013,1659
2021-06-11,San Benito,69,59416,6080,6082,120,6202,63
2021-06-11,San Bernardino,71,2135413,293205,293335,9259,302594,4788
2021-06-11,San Diego,73,3302833,281528,281144,0,281144,3768
2021-06-11,San Francisco,75,870044,36858,37177,1404,38581,555
2021-06-11,San Joaquin,77,732212,73453,73347,3811,77158,1397
2021-06-11,San Luis Obispo,79,281455,21276,21288,789,22077,256
2021-06-11,San Mateo,81,765935,42512,42585,486,43071,542
2021-06-11,Santa Barbara,83,443738,34496,34438,1352,35790,460
2021-06-11,Santa Clara,85,1922200,118506,119860,820,120680,2083
2021-06-11,Santa Cruz,87,273765,16181,16164,877,17041,208
2021-06-11,Shasta,89,179085,12485,12550,1788,14338,201
2021-06-11,Sierra,91,2930,57,55,14,69,0
2021-06-11,Siskiyou,93,43540,1932,1882,397,2279,25
2021-06-11,Solano,95,438530,33158,33179,568,33747,266
2021-06-11,Sonoma,97,501317,30519,30624,365,30989,323
2021-06-11,Stanislaus,99,539301,56530,56617,6237,62854,974
2021-06-11,Sutter,101,95872,9562,9600,94,9694,112
2021-06-11,Tehama,103,63373,5090,5099,633,5732,63
2021-06-11,Trinity,105,12862,362,331,64,395,3
2021-06-11,Tulare,107,460477,49690,49516,9618,59134,848
2021-06-11,Tuolumne,109,53932,4096,4104,170,4274,63
2021-06-11,Ventura,111,848112,81194,81189,3167,84356,1026
2021-06-11,Yolo,113,214977,14093,14111,353,14464,212
2021-06-11,Yuba,115,75493,6117,6113,137,6250,50
2021-06-10,Alameda,1,1643700,88690,88806,2081,90887,1275
2021-06-10,Alpine,3,1148,88,88,0,88,0
2021-06-10,Amador,5,37829,3726,3709,35,3744,46
2021-06-10,Butte,7,227075,12604,12565,1928,14493,194
2021-06-10,Calaveras,9,45235,2188,2188,16,2204,55
2021-06-10,Colusa,11,21464,1953,1964,326,2290,15
2021-06-10,Contra Costa,13,1133247,70213,69876,1368,71244,807
2021-06-10,Del Norte,15,27424,1413,1405,9,1414,8
2021-06-10,El Dorado,17,186661,10310,10314,785,11099,113
2021-06-10,Fresno,19,978130,102221,102724,9147,111871,1717
2021-06-10,Glenn,21,27897,2426,2425,581,3006,19
2021-06-10,Humboldt,23,135768,4390,4384,105,4489,42
2021-06-10,Imperial,25,180216,28611,28779,2898,31677,739
2021-06-10,Inyo,27,18085,1407,1405,4,1409,35
2021-06-10,Kern,29,883053,97026,96706,11516,108222,1336
2021-06-10,Kings,31,150075,23003,23067,1203,24270,245
2021-06-10,Lake,33,64148,3554,3550,9,3559,45
2021-06-10,Lassen,35,31185,5235,5201,122,5323,18
2021-06-10,Los Angeles,37,10098052,1204471,1204110,44042,1248152,24440
2021-06-10,Madera,39,155013,16592,16581,962,17543,240
2021-06-10,Marin,41,260295,14101,14118,273,14391,229
2021-06-10,Mariposa,43,17540,436,434,12,446,5
2021-06-10,Mendocino,45,87422,4071,4016,71,4087,48
2021-06-10,Merced,47,269075,31144,31231,1007,32238,461
2021-06-10,Modoc,49,8938,392,381,139,520,3
2021-06-10,Mono,51,14174,1251,1274,14,1288,3
2021-06-10,Monterey,53,433212,43099,43090,1939,45029,415
2021-06-10,Napa,55,140530,9972,9974,35,10009,80
2021-06-10,Nevada,57,99092,4889,4866,201,5067,72
2021-06-10,Orange,59,3164182,254987,254950,11829,266779,5097
2021-06-10,Placer,61,380077,23459,23296,1593,24889,293
2021-06-10,Plumas,63,18699,711,696,12,708,4
2021-06-10,Riverside,65,2383286,291703,289335,14898,304233,4450
2021-06-10,Sacramento,67,1510023,107068,107049,1894,108943,1658
2021-06-10,San Benito,69,59416,6080,6079,120,6199,63
2021-06-10,San Bernardino,71,2135413,293164,293281,9256,302537,4782
2021-06-10,San Diego,73,3302833,281471,281052,0,281052,3766
2021-06-10,San Francisco,75,870044,36848,37159,1402,38561,552
2021-06-10,San Joaquin,77,732212,73421,73276,3810,77086,1393
2021-06-10,San Luis Obispo,79,281455,21273,21280,789,22069,256
2021-06-10,San Mateo,81,765935,42506,42562,486,43048,666
2021-06-10,Santa Barbara,83,443738,34492,34434,1352,35786,460
2021-06-10,Santa Clara,85,1922200,118471,119832,819,120651,2075
2021-06-10,Santa Cruz,87,273765,16180,16159,877,17036,208
2021-06-10,Shasta,89,179085,12475,12536,1787,14323,201
2021-06-10,Sierra,91,2930,56,55,14,69,0
2021-06-10,Siskiyou,93,43540,1932,1881,397,2278,25
2021-06-10,Solano,95,438530,33141,33150,567,33717,265
2021-06-10,Sonoma,97,501317,30483,30571,363,30934,323
2021-06-10,Stanislaus,99,539301,56509,56588,6233,62821,974
2021-06-10,Sutter,101,95872,9555,9594,94,9688,112
2021-06-10,Tehama,103,63373,5090,5096,633,5729,63
2021-06-10,Trinity,105,12862,362,331,64,395,3
2021-06-10,Tulare,107,460477,49682,49503,9618,59121,848
2021-06-10,Tuolumne,109,53932,4096,4100,170,4270,63
2021-06-10,Ventura,111,848112,81183,81172,3165,84337,1026
2021-06-10,Yolo,113,214977,14090,14107,353,14460,212
2021-06-10,Yuba,115,75493,6113,6112,137,6249,50
2021-06-09,Alameda,1,1643700,88644,88762,2079,90841,1271
2021-06-09,Alpine,3,1148,88,88,0,88,0
2021-06-09,Amador,5,37829,3722,3706,35,3741,46
2021-06-09,Butte,7,227075,12598,12555,1926,14481,194
2021-06-09,Calaveras,9,45235,2186,2184,16,2200,55
2021-06-09,Colusa,11,21464,1953,1962,325,2287,15
2021-06-09,Contra Costa,13,1133247,70176,69829,1367,71196,803
2021-06-09,Del Norte,15,27424,1410,1403,9,1412,8
2021-06-09,El Dorado,17,186661,10307,10312,784,11096,113
2021-06-09,Fresno,19,978130,102203,102690,9143,111833,1717
2021-06-09,Glenn,21,27897,2425,2424,581,3005,19
2021-06-09,Humboldt,23,135768,4385,4379,103,4482,42
2021-06-09,Imperial,25,180216,28608,28754,2898,31652,739
2021-06-09,Inyo,27,18085,1407,1405,4,1409,35
2021-06-09,Kern,29,883053,97013,96697,11506,108203,1328
2021-06-09,Kings,31,150075,23001,23061,1203,24264,245
2021-06-09,Lake,33,64148,3551,3541,9,3550,45
2021-06-09,Lassen,35,31185,5234,5200,122,5322,18
2021-06-09,Los Angeles,37,10098052,1204287,1203955,44031,1247986,24432
2021-06-09,Madera,39,155013,16587,16580,962,17542,240
2021-06-09,Marin,41,260295,14096,14114,273,14387,229
2021-06-09,Mariposa,43,17540,436,434,12,446,5
2021-06-09,Mendocino,45,87422,4065,4008,71,4079,47
2021-06-09,Merced,47,269075,31140,31225,1007,32232,461
2021-06-09,Modoc,49,8938,390,377,138,515,3
2021-06-09,Mono,51,14174,1251,1274,14,1288,3
2021-06-09,Monterey,53,433212,43092,43082,1939,45021,415
2021-06-09,Napa,55,140530,9966,9971,35,10006,80
2021-06-09,Nevada,57,99092,4879,4863,200,5063,72
2021-06-09,Orange,59,3164182,254943,254893,11825,266718,5080
2021-06-09,Placer,61,380077,23441,23237,1593,24830,293
2021-06-09,Plumas,63,18699,710,697,12,709,4
2021-06-09,Riverside,65,2383286,291659,289299,14896,304195,4450
2021-06-09,Sacramento,67,1510023,107005,106971,1891,108862,1657
2021-06-09,San Benito,69,59416,6076,6078,120,6198,63
2021-06-09,San Bernardino,71,2135413,293122,293222,9256,302478,4782
2021-06-09,San Diego,73,3302833,281407,280941,0,280941,3765
2021-06-09,San Francisco,75,870044,36835,37143,1401,38544,552
2021-06-09,San Joaquin,77,732212,73396,73232,3809,77041,1392
2021-06-09,San Luis Obispo,79,281455,21272,21259,789,22048,256
2021-06-09,San Mateo,81,765935,42490,42502,485,42987,666
2021-06-09,Santa Barbara,83,443738,34481,34422,1352,35774,460
2021-06-09,Santa Clara,85,1922200,118433,119793,818,120611,2068
2021-06-09,Santa Cruz,87,273765,16177,16155,877,17032,208
2021-06-09,Shasta,89,179085,12465,12521,1784,14305,201
2021-06-09,Sierra,91,2930,55,55,14,69,0
2021-06-09,Siskiyou,93,43540,1931,1871,397,2268,25
2021-06-09,Solano,95,438530,33125,33137,566,33703,264
2021-06-09,Sonoma,97,501317,30461,30540,363,30903,323
2021-06-09,Stanislaus,99,539301,56489,56560,6230,62790,974
2021-06-09,Sutter,101,95872,9546,9586,93,9679,111
2021-06-09,Tehama,103,63373,5089,5093,632,5725,63
2021-06-09,Trinity,105,12862,361,331,64,395,3
2021-06-09,Tulare,107,460477,49678,49496,9616,59112,847
2021-06-09,Tuolumne,109,53932,4093,4100,170,4270,63
2021-06-09,Ventura,111,848112,81173,81154,3163,84317,1026
2021-06-09,Yolo,113,214977,14088,14102,352,14454,212
2021-06-09,Yuba,115,75493,6109,6109,137,6246,50
2021-06-08,Alameda,1,1643700,88594,88731,2079,90810,1267
2021-06-08,Alpine,3,1148,88,88,0,88,0
2021-06-08,Amador,5,37829,3721,3704,35,3739,46
2021-06-08,Butte,7,227075,12592,12540,1923,14463,194
2021-06-08,Calaveras,9,45235,2185,2181,16,2197,55
2021-06-08,Colusa,11,21464,1953,1961,325,2286,15
2021-06-08,Contra Costa,13,1133247,70127,69762,1366,71128,803
2021-06-08,Del Norte,15,27424,1408,1402,9,1411,8
2021-06-08,El Dorado,17,186661,10302,10306,782,11088,113
2021-06-08,Fresno,19,978130,102178,102680,9140,111820,1717
2021-06-08,Glenn,21,27897,2424,2423,581,3004,19
2021-06-08,Humboldt,23,135768,4380,4363,100,4463,42
2021-06-08,Imperial,25,180216,28599,28752,2898,31650,738
2021-06-08,Inyo,27,18085,1407,1405,4,1409,35
2021-06-08,Kern,29,883053,96993,96671,11499,108170,1325
2021-06-08,Kings,31,150075,23000,23036,1203,24239,245
2021-06-08,Lake,33,64148,3550,3540,9,3549,45
2021-06-08,Lassen,35,31185,5234,5200,122,5322,18
2021-06-08,Los Angeles,37,10098052,1204093,1203794,44019,1247813,24426
2021-06-08,Madera,39,155013,16581,16579,961,17540,240
2021-06-08,Marin,41,260295,14094,14111,272,14383,229
2021-06-08,Mariposa,43,17540,436,434,12,446,5
2021-06-08,Mendocino,45,87422,4058,4002,71,4073,47
2021-06-08,Merced,47,269075,31132,31225,1007,32232,461
2021-06-08,Modoc,49,8938,385,377,137,514,3
2021-06-08,Mono,51,14174,1251,1274,14,1288,3
2021-06-08,Monterey,53,433212,43086,43078,1938,45016,415
2021-06-08,Napa,55,140530,9962,9962,35,9997,80
2021-06-08,Nevada,57,99092,4874,4861,200,5061,72
2021-06-08,Orange,59,3164182,254902,254852,11819,266671,5078
2021-06-08,Placer,61,380077,23423,23209,1589,24798,293
2021-06-08,Plumas,63,18699,710,692,12,704,4
2021-06-08,Riverside,65,2383286,291625,289268,14888,304156,4452
2021-06-08,Sacramento,67,1510023,106944,106901,1889,108790,1654
2021-06-08,San Benito,69,59416,6074,6076,120,6196,63
2021-06-08,San Bernardino,71,2135413,293073,293186,9252,302438,4778
2021-06-08,San Diego,73,3302833,281345,280879,0,280879,3764
2021-06-08,San Francisco,75,870044,36820,37134,1400,38534,552
2021-06-08,San Joaquin,77,732212,73352,73186,3804,76990,1390
2021-06-08,San Luis Obispo,79,281455,21266,21251,788,22039,255
2021-06-08,San Mateo,81,765935,42477,42488,485,42973,663
2021-06-08,Santa Barbara,83,443738,34477,34418,1352,35770,459
2021-06-08,Santa Clara,85,1922200,118414,119770,817,120587,2068
2021-06-08,Santa Cruz,87,273765,16174,16160,877,17037,208
2021-06-08,Shasta,89,179085,12450,12498,1784,14282,201
2021-06-08,Sierra,91,2930,55,55,14,69,0
2021-06-08,Siskiyou,93,43540,1929,1870,395,2265,21
2021-06-08,Solano,95,438530,33104,33130,566,33696,259
2021-06-08,Sonoma,97,501317,30435,30523,361,30884,323
2021-06-08,Stanislaus,99,539301,56462,56548,6228,62776,973
2021-06-08,Sutter,101,95872,9543,9581,93,9674,111
2021-06-08,Tehama,103,63373,5086,5093,632,5725,63
2021-06-08,Trinity,105,12862,361,330,64,394,3
2021-06-08,Tulare,107,460477,49667,49485,9610,59095,847
2021-06-08,Tuolumne,109,53932,4090,4099,170,4269,63
2021-06-08,Ventura,111,848112,81157,81142,3162,84304,1026
2021-06-08,Yolo,113,214977,14083,14099,351,14450,212
2021-06-08,Yuba,115,75493,6107,6103,137,6240,50
2021-06-07,Alameda,1,1643700,88536,88688,2079,90767,1267
2021-06-07,Alpine,3,1148,88,88,0,88,0
2021-06-07,Amador,5,37829,3711,3697,35,3732,46
2021-06-07,Butte,7,227075,12585,12533,1922,14455,194
2021-06-07,Calaveras,9,45235,2184,2181,16,2197,55
2021-06-07,Colusa,11,21464,1952,1960,325,2285,15
2021-06-07,Contra Costa,13,1133247,70071,69718,1365,71083,817
2021-06-07,Del Norte,15,27424,1408,1401,9,1410,8
2021-06-07,El Dorado,17,186661,10297,10305,782,11087,113
2021-06-07,Fresno,19,978130,102151,102659,9131,111790,1717
2021-06-07,Glenn,21,27897,2424,2423,581,3004,19
2021-06-07,Humboldt,23,135768,4372,4354,97,4451,42
2021-06-07,Imperial,25,180216,28597,28754,2898,31652,738
2021-06-07,Inyo,27,18085,1407,1404,4,1408,35
2021-06-07,Kern,29,883053,96977,96645,11492,108137,1324
2021-06-07,Kings,31,150075,22996,23023,1203,24226,244
2021-06-07,Lake,33,64148,3548,3540,9,3549,45
2021-06-07,Lassen,35,31185,5229,5198,122,5320,18
2021-06-07,Los Angeles,37,10098052,1203873,1203664,44003,1247667,24413
2021-06-07,Madera,39,155013,16574,16572,961,17533,240
2021-06-07,Marin,41,260295,14090,14108,271,14379,229
2021-06-07,Mariposa,43,17540,436,434,12,446,5
2021-06-07,Mendocino,45,87422,4052,3998,71,4069,47
2021-06-07,Merced,47,269075,31120,31212,1006,32218,459
2021-06-07,Modoc,49,8938,384,375,134,509,3
2021-06-07,Mono,51,14174,1251,1275,14,1289,3
2021-06-07,Monterey,53,433212,43079,43077,1938,45015,415
2021-06-07,Napa,55,140530,9953,9962,35,9997,80
2021-06-07,Nevada,57,99092,4872,4860,200,5060,72
2021-06-07,Orange,59,3164182,254862,254808,11812,266620,5073
2021-06-07,Placer,61,380077,23405,23176,1587,24763,293
2021-06-07,Plumas,63,18699,710,692,12,704,4
2021-06-07,Riverside,65,2383286,291583,289232,14885,304117,4451
2021-06-07,Sacramento,67,1510023,106864,106841,1885,108726,1655
2021-06-07,San Benito,69,59416,6073,6074,120,6194,63
2021-06-07,San Bernardino,71,2135413,293035,293129,9251,302380,4775
2021-06-07,San Diego,73,3302833,281263,280808,0,280808,3764
2021-06-07,San Francisco,75,870044,36804,37122,1400,38522,552
2021-06-07,San Joaquin,77,732212,73307,73130,3794,76924,1388
2021-06-07,San Luis Obispo,79,281455,21253,21252,788,22040,255
2021-06-07,San Mateo,81,765935,42460,42479,485,42964,664
2021-06-07,Santa Barbara,83,443738,34471,34407,1352,35759,459
2021-06-07,Santa Clara,85,1922200,118387,119743,817,120560,2066
2021-06-07,Santa Cruz,87,273765,16172,16159,877,17036,208
2021-06-07,Shasta,89,179085,12436,12483,1778,14261,200
2021-06-07,Sierra,91,2930,55,55,14,69,0
2021-06-07,Siskiyou,93,43540,1929,1869,395,2264,21
2021-06-07,Solano,95,438530,33082,33124,565,33689,258
2021-06-07,Sonoma,97,501317,30399,30504,360,30864,323
2021-06-07,Stanislaus,99,539301,56429,56521,6225,62746,972
2021-06-07,Sutter,101,95872,9539,9571,93,9664,111
2021-06-07,Tehama,103,63373,5082,5092,632,5724,63
2021-06-07,Trinity,105,12862,361,329,64,393,3
2021-06-07,Tulare,107,460477,49661,49471,9610,59081,847
2021-06-07,Tuolumne,109,53932,4089,4098,166,4264,63
2021-06-07,Ventura,111,848112,81140,81137,3161,84298,1025
2021-06-07,Yolo,113,214977,14078,14097,350,14447,211
2021-06-07,Yuba,115,75493,6105,6099,134,6233,49
2021-06-06,Alameda,1,1643700,88494,88636,2078,90714,1267
2021-06-06,Alpine,3,1148,88,88,0,88,0
2021-06-06,Amador,5,37829,3708,3696,35,3731,46
2021-06-06,Butte,7,227075,12574,12527,1921,14448,194
2021-06-06,Calaveras,9,45235,2183,2181,16,2197,55
2021-06-06,Colusa,11,21464,1950,1959,325,2284,15
2021-06-06,Contra Costa,13,1133247,70006,69659,1363,71022,817
2021-06-06,Del Norte,15,27424,1403,1401,8,1409,8
2021-06-06,El Dorado,17,186661,10290,10294,782,11076,113
2021-06-06,Fresno,19,978130,102118,102642,9128,111770,1717
2021-06-06,Glenn,21,27897,2423,2423,581,3004,19
2021-06-06,Humboldt,23,135768,4361,4353,91,4444,42
2021-06-06,Imperial,25,180216,28591,28762,2898,31660,738
2021-06-06,Inyo,27,18085,1406,1404,4,1408,35
2021-06-06,Kern,29,883053,96959,96623,11485,108108,1324
2021-06-06,Kings,31,150075,22990,23021,1203,24224,244
2021-06-06,Lake,33,64148,3548,3535,9,3544,45
2021-06-06,Lassen,35,31185,5227,5191,122,5313,18
2021-06-06,Los Angeles,37,10098052,1203677,1203539,43991,1247530,24410
2021-06-06,Madera,39,155013,16568,16567,961,17528,240
2021-06-06,Marin,41,260295,14084,14106,270,14376,229
2021-06-06,Mariposa,43,17540,435,435,12,447,5
2021-06-06,Mendocino,45,87422,4048,3993,71,4064,47
2021-06-06,Merced,47,269075,31112,31215,1006,32221,459
2021-06-06,Modoc,49,8938,384,375,133,508,3
2021-06-06,Mono,51,14174,1251,1275,14,1289,3
2021-06-06,Monterey,53,433212,43074,43078,1938,45016,415
2021-06-06,Napa,55,140530,9947,9963,35,9998,80
2021-06-06,Nevada,57,99092,4865,4854,199,5053,72
2021-06-06,Orange,59,3164182,254829,254782,11807,266589,5073
2021-06-06,Placer,61,380077,23380,23156,1583,24739,293
2021-06-06,Plumas,63,18699,710,692,12,704,4
2021-06-06,Riverside,65,2383286,291549,289201,14880,304081,4451
2021-06-06,Sacramento,67,1510023,106778,106749,1884,108633,1655
2021-06-06,San Benito,69,59416,6067,6074,120,6194,63
2021-06-06,San Bernardino,71,2135413,292987,293117,9242,302359,4773
2021-06-06,San Diego,73,3302833,281183,280743,0,280743,3764
2021-06-06,San Francisco,75,870044,36792,37118,1399,38517,552
2021-06-06,San Joaquin,77,732212,73275,73105,3790,76895,1388
2021-06-06,San Luis Obispo,79,281455,21250,21246,788,22034,255
2021-06-06,San Mateo,81,765935,42442,42457,485,42942,664
2021-06-06,Santa Barbara,83,443738,34467,34403,1351,35754,459
2021-06-06,Santa Clara,85,1922200,118365,119711,817,120528,2066
2021-06-06,Santa Cruz,87,273765,16171,16158,877,17035,208
2021-06-06,Shasta,89,179085,12421,12478,1770,14248,200
2021-06-06,Sierra,91,2930,55,55,14,69,0
2021-06-06,Siskiyou,93,43540,1926,1869,395,2264,21
2021-06-06,Solano,95,438530,33055,33093,565,33658,258
2021-06-06,Sonoma,97,501317,30368,30478,359,30837,323
2021-06-06,Stanislaus,99,539301,56386,56486,6222,62708,972
2021-06-06,Sutter,101,95872,9532,9567,93,9660,111
2021-06-06,Tehama,103,63373,5078,5092,631,5723,63
2021-06-06,Trinity,105,12862,361,328,64,392,3
2021-06-06,Tulare,107,460477,49654,49466,9603,59069,847
2021-06-06,Tuolumne,109,53932,4087,4097,166,4263,63
2021-06-06,Ventura,111,848112,81129,81130,3158,84288,1025
2021-06-06,Yolo,113,214977,14070,14089,348,14437,210
2021-06-06,Yuba,115,75493,6097,6096,134,6230,49
2021-06-05,Alameda,1,1643700,88462,88612,2076,90688,1268
2021-06-05,Alpine,3,1148,88,88,0,88,0
2021-06-05,Amador,5,37829,3708,3694,35,3729,46
2021-06-05,Butte,7,227075,12568,12514,1920,14434,194
2021-06-05,Calaveras,9,45235,2183,2181,16,2197,55
2021-06-05,Colusa,11,21464,1950,1959,325,2284,15
2021-06-05,Contra Costa,13,1133247,69977,69601,1363,70964,817
2021-06-05,Del Norte,15,27424,1403,1400,8,1408,8
2021-06-05,El Dorado,17,186661,10288,10288,781,11069,113
2021-06-05,Fresno,19,978130,102109,102626,9125,111751,1717
2021-06-05,Glenn,21,27897,2422,2423,581,3004,19
2021-06-05,Humboldt,23,135768,4356,4346,91,4437,42
2021-06-05,Imperial,25,180216,28588,28764,2898,31662,738
2021-06-05,Inyo,27,18085,1406,1405,4,1409,35
2021-06-05,Kern,29,883053,96947,96597,11480,108077,1324
2021-06-05,Kings,31,150075,22987,23017,1202,24219,244
2021-06-05,Lake,33,64148,3545,3534,9,3543,45
2021-06-05,Lassen,35,31185,5226,5191,122,5313,18
2021-06-05,Los Angeles,37,10098052,1203551,1203338,43981,1247319,24411
2021-06-05,Madera,39,155013,16564,16563,961,17524,240
2021-06-05,Marin,41,260295,14082,14101,270,14371,229
2021-06-05,Mariposa,43,17540,435,435,12,447,5
2021-06-05,Mendocino,45,87422,4045,3989,71,4060,47
2021-06-05,Merced,47,269075,31110,31212,1006,32218,459
2021-06-05,Modoc,49,8938,384,375,132,507,3
2021-06-05,Mono,51,14174,1251,1274,14,1288,3
2021-06-05,Monterey,53,433212,43070,43071,1937,45008,415
2021-06-05,Napa,55,140530,9942,9960,35,9995,80
2021-06-05,Nevada,57,99092,4863,4849,199,5048,72
2021-06-05,Orange,59,3164182,254805,254752,11804,266556,5069
2021-06-05,Placer,61,380077,23365,23133,1582,24715,293
2021-06-05,Plumas,63,18699,710,692,12,704,4
2021-06-05,Riverside,65,2383286,291514,289157,14875,304032,4451
2021-06-05,Sacramento,67,1510023,106727,106688,1880,108568,1655
2021-06-05,San Benito,69,59416,6065,6074,120,6194,63
2021-06-05,San Bernardino,71,2135413,292953,293081,9240,302321,4772
2021-06-05,San Diego,73,3302833,281142,280676,0,280676,3764
2021-06-05,San Francisco,75,870044,36783,37111,1399,38510,552
2021-06-05,San Joaquin,77,732212,73259,73078,3783,76861,1388
2021-06-05,San Luis Obispo,79,281455,21247,21236,788,22024,255
2021-06-05,San Mateo,81,765935,42433,42433,485,42918,664
2021-06-05,Santa Barbara,83,443738,34464,34399,1350,35749,459
2021-06-05,Santa Clara,85,1922200,118343,119676,815,120491,2066
2021-06-05,Santa Cruz,87,273765,16171,16154,877,17031,208
2021-06-05,Shasta,89,179085,12412,12472,1769,14241,200
2021-06-05,Sierra,91,2930,55,55,14,69,0
2021-06-05,Siskiyou,93,43540,1926,1867,395,2262,21
2021-06-05,Solano,95,438530,33040,33074,565,33639,257
2021-06-05,Sonoma,97,501317,30341,30450,357,30807,323
2021-06-05,Stanislaus,99,539301,56365,56463,6220,62683,973
2021-06-05,Sutter,101,95872,9529,9559,93,9652,111
2021-06-05,Tehama,103,63373,5077,5092,630,5722,63
2021-06-05,Trinity,105,12862,361,328,64,392,3
2021-06-05,Tulare,107,460477,49649,49463,9602,59065,847
2021-06-05,Tuolumne,109,53932,4085,4098,166,4264,63
2021-06-05,Ventura,111,848112,81120,81119,3156,84275,1025
2021-06-05,Yolo,113,214977,14068,14088,348,14436,210
2021-06-05,Yuba,115,75493,6096,6087,134,6221,49
2021-06-04,Alameda,1,1643700,88435,88585,2074,90659,1263
2021-06-04,Alpine,3,1148,88,88,0,88,0
2021-06-04,Amador,5,37829,3708,3690,35,3725,46
2021-06-04,Butte,7,227075,12557,12494,1917,14411,193
2021-06-04,Calaveras,9,45235,2183,2179,16,2195,55
2021-06-04,Colusa,11,21464,1950,1959,325,2284,15
2021-06-04,Contra Costa,13,1133247,69942,69540,1360,70900,816
2021-06-04,Del Norte,15,27424,1403,1398,8,1406,8
2021-06-04,El Dorado,17,186661,10284,10284,779,11063,112
2021-06-04,Fresno,19,978130,102093,102601,9125,111726,1712
2021-06-04,Glenn,21,27897,2422,2423,580,3003,19
2021-06-04,Humboldt,23,135768,4351,4327,91,4418,42
2021-06-04,Imperial,25,180216,28584,28753,2898,31651,738
2021-06-04,Inyo,27,18085,1406,1404,4,1408,35
2021-06-04,Kern,29,883053,96929,96573,11478,108051,1327
2021-06-04,Kings,31,150075,22987,23002,1202,24204,244
2021-06-04,Lake,33,64148,3543,3528,9,3537,45
2021-06-04,Lassen,35,31185,5226,5180,122,5302,18
2021-06-04,Los Angeles,37,10098052,1203433,1203106,43971,1247077,24400
2021-06-04,Madera,39,155013,16562,16557,961,17518,240
2021-06-04,Marin,41,260295,14081,14099,269,14368,229
2021-06-04,Mariposa,43,17540,435,435,12,447,5
2021-06-04,Mendocino,45,87422,4036,3983,71,4054,47
2021-06-04,Merced,47,269075,31105,31204,1005,32209,459
2021-06-04,Modoc,49,8938,382,375,132,507,3
2021-06-04,Mono,51,14174,1251,1275,14,1289,3
2021-06-04,Monterey,53,433212,43066,43068,1937,45005,415
2021-06-04,Napa,55,140530,9938,9958,35,9993,80
2021-06-04,Nevada,57,99092,4859,4844,199,5043,72
2021-06-04,Orange,59,3164182,254769,254730,11801,266531,5059
2021-06-04,Placer,61,380077,23350,23110,1581,24691,293
2021-06-04,Plumas,63,18699,710,691,12,703,4
2021-06-04,Riverside,65,2383286,291488,289098,14871,303969,4452
2021-06-04,Sacramento,67,1510023,106675,106616,1878,108494,1654
2021-06-04,San Benito,69,59416,6063,6073,120,6193,63
2021-06-04,San Bernardino,71,2135413,292929,293056,9237,302293,4768
2021-06-04,San Diego,73,3302833,281100,280556,0,280556,3763
2021-06-04,San Francisco,75,870044,36778,37079,1398,38477,551
2021-06-04,San Joaquin,77,732212,73240,73039,3781,76820,1388
2021-06-04,San Luis Obispo,79,281455,21244,21234,787,22021,255
2021-06-04,San Mateo,81,765935,42421,42413,485,42898,478
2021-06-04,Santa Barbara,83,443738,34458,34402,1349,35751,459
2021-06-04,Santa Clara,85,1922200,118314,119619,815,120434,2065
2021-06-04,Santa Cruz,87,273765,16169,16150,877,17027,207
2021-06-04,Shasta,89,179085,12406,12458,1764,14222,200
2021-06-04,Sierra,91,2930,55,55,14,69,0
2021-06-04,Siskiyou,93,43540,1925,1865,395,2260,21
2021-06-04,Solano,95,438530,33029,33058,565,33623,256
2021-06-04,Sonoma,97,501317,30320,30411,357,30768,323
2021-06-04,Stanislaus,99,539301,56342,56442,6219,62661,973
2021-06-04,Sutter,101,95872,9524,9554,93,9647,111
2021-06-04,Tehama,103,63373,5072,5090,630,5720,63
2021-06-04,Trinity,105,12862,361,328,64,392,3
2021-06-04,Tulare,107,460477,49640,49452,9600,59052,847
2021-06-04,Tuolumne,109,53932,4084,4095,166,4261,63
2021-06-04,Ventura,111,848112,81113,81104,3154,84258,1023
2021-06-04,Yolo,113,214977,14066,14083,348,14431,210
2021-06-04,Yuba,115,75493,6093,6084,134,6218,49
2021-06-03,Alameda,1,1643700,88397,88555,2071,90626,1257
2021-06-03,Alpine,3,1148,88,88,0,88,0
2021-06-03,Amador,5,37829,3700,3688,35,3723,46
2021-06-03,Butte,7,227075,12553,12478,1916,14394,193
2021-06-03,Calaveras,9,45235,2183,2179,16,2195,55
2021-06-03,Colusa,11,21464,1950,1957,325,2282,15
2021-06-03,Contra Costa,13,1133247,69887,69500,1355,70855,816
2021-06-03,Del Norte,15,27424,1401,1397,8,1405,8
2021-06-03,El Dorado,17,186661,10278,10284,776,11060,112
2021-06-03,Fresno,19,978130,102077,102566,9125,111691,1709
2021-06-03,Glenn,21,27897,2422,2421,580,3001,19
2021-06-03,Humboldt,23,135768,4343,4314,91,4405,42
2021-06-03,Imperial,25,180216,28572,28737,2898,31635,738
2021-06-03,Inyo,27,18085,1406,1404,4,1408,35
2021-06-03,Kern,29,883053,96902,96507,11464,107971,1326
2021-06-03,Kings,31,150075,22983,22982,1202,24184,244
2021-06-03,Lake,33,64148,3541,3526,9,3535,45
2021-06-03,Lassen,35,31185,5217,5177,122,5299,12
2021-06-03,Los Angeles,37,10098052,1203260,1202923,43963,1246886,24386
2021-06-03,Madera,39,155013,16556,16554,961,17515,240
2021-06-03,Marin,41,260295,14076,14095,269,14364,230
2021-06-03,Mariposa,43,17540,435,435,12,447,5
2021-06-03,Mendocino,45,87422,4029,3978,71,4049,47
2021-06-03,Merced,47,269075,31101,31199,1005,32204,459
2021-06-03,Modoc,49,8938,381,376,131,507,3
2021-06-03,Mono,51,14174,1251,1275,14,1289,3
2021-06-03,Monterey,53,433212,43063,43063,1937,45000,415
2021-06-03,Napa,55,140530,9931,9957,35,9992,81
2021-06-03,Nevada,57,99092,4855,4837,199,5036,72
2021-06-03,Orange,59,3164182,254741,254676,11791,266467,5056
2021-06-03,Placer,61,380077,23341,23100,1580,24680,293
2021-06-03,Plumas,63,18699,710,691,12,703,4
2021-06-03,Riverside,65,2383286,291434,289035,14869,303904,4447
2021-06-03,Sacramento,67,1510023,106596,106526,1876,108402,1654
2021-06-03,San Benito,69,59416,6063,6073,120,6193,63
2021-06-03,San Bernardino,71,2135413,292899,293021,9231,302252,4762
2021-06-03,San Diego,73,3302833,281037,280430,0,280430,3761
2021-06-03,San Francisco,75,870044,36772,37072,1398,38470,551
2021-06-03,San Joaquin,77,732212,73212,72989,3777,76766,1388
2021-06-03,San Luis Obispo,79,281455,21239,21224,787,22011,255
2021-06-03,San Mateo,81,765935,42408,42396,485,42881,467
2021-06-03,Santa Barbara,83,443738,34455,34391,1349,35740,459
2021-06-03,Santa Clara,85,1922200,118292,119592,813,120405,2058
2021-06-03,Santa Cruz,87,273765,16167,16144,877,17021,207
2021-06-03,Shasta,89,179085,12391,12441,1762,14203,199
2021-06-03,Sierra,91,2930,55,55,14,69,0
2021-06-03,Siskiyou,93,43540,1925,1862,394,2256,21
2021-06-03,Solano,95,438530,33016,33019,565,33584,256
2021-06-03,Sonoma,97,501317,30298,30383,356,30739,322
2021-06-03,Stanislaus,99,539301,56312,56401,6212,62613,973
2021-06-03,Sutter,101,95872,9515,9539,93,9632,111
2021-06-03,Tehama,103,63373,5072,5087,630,5717,63
2021-06-03,Trinity,105,12862,361,328,64,392,3
2021-06-03,Tulare,107,460477,49637,49442,9596,59038,848
2021-06-03,Tuolumne,109,53932,4082,4095,166,4261,63
2021-06-03,Ventura,111,848112,81101,81078,3152,84230,1023
2021-06-03,Yolo,113,214977,14062,14078,345,14423,210
2021-06-03,Yuba,115,75493,6086,6077,134,6211,49
2021-06-02,Alameda,1,1643700,88352,88525,2069,90594,1254
2021-06-02,Alpine,3,1148,88,88,0,88,0
2021-06-02,Amador,5,37829,3698,3687,35,3722,46
2021-06-02,Butte,7,227075,12533,12432,1914,14346,193
2021-06-02,Calaveras,9,45235,2181,2174,15,2189,55
2021-06-02,Colusa,11,21464,1949,1957,325,2282,15
2021-06-02,Contra Costa,13,1133247,69836,69455,1353,70808,814
2021-06-02,Del Norte,15,27424,1399,1395,8,1403,8
2021-06-02,El Dorado,17,186661,10274,10275,776,11051,110
2021-06-02,Fresno,19,978130,102054,102547,9122,111669,1707
2021-06-02,Glenn,21,27897,2422,2421,580,3001,19
2021-06-02,Humboldt,23,135768,4328,4302,89,4391,42
2021-06-02,Imperial,25,180216,28567,28737,2896,31633,738
2021-06-02,Inyo,27,18085,1405,1403,4,1407,35
2021-06-02,Kern,29,883053,96876,96481,11455,107936,1326
2021-06-02,Kings,31,150075,22981,22981,1202,24183,244
2021-06-02,Lake,33,64148,3536,3522,9,3531,45
2021-06-02,Lassen,35,31185,5216,5177,122,5299,6
2021-06-02,Los Angeles,37,10098052,1203059,1202760,43953,1246713,24375
2021-06-02,Madera,39,155013,16548,16550,961,17511,240
2021-06-02,Marin,41,260295,14074,14091,269,14360,229
2021-06-02,Mariposa,43,17540,435,434,12,446,5
2021-06-02,Mendocino,45,87422,4023,3970,71,4041,47
2021-06-02,Merced,47,269075,31088,31195,1004,32199,458
2021-06-02,Modoc,49,8938,380,375,130,505,3
2021-06-02,Mono,51,14174,1251,1275,14,1289,3
2021-06-02,Monterey,53,433212,43061,43056,1937,44993,380
2021-06-02,Napa,55,140530,9930,9953,35,9988,82
2021-06-02,Nevada,57,99092,4852,4833,199,5032,72
2021-06-02,Orange,59,3164182,254696,254637,11787,266424,5055
2021-06-02,Placer,61,380077,23320,23058,1578,24636,293
2021-06-02,Plumas,63,18699,710,690,12,702,4
2021-06-02,Riverside,65,2383286,291379,289012,14859,303871,4445
2021-06-02,Sacramento,67,1510023,106532,106435,1869,108304,1649
2021-06-02,San Benito,69,59416,6062,6073,120,6193,63
2021-06-02,San Bernardino,71,2135413,292854,293004,9226,302230,4760
2021-06-02,San Diego,73,3302833,280957,280347,0,280347,3760
2021-06-02,San Francisco,75,870044,36752,37050,1397,38447,550
2021-06-02,San Joaquin,77,732212,73181,72893,3774,76667,1387
2021-06-02,San Luis Obispo,79,281455,21232,21214,786,22000,255
2021-06-02,San Mateo,81,765935,42398,42383,484,42867,464
2021-06-02,Santa Barbara,83,443738,34448,34381,1349,35730,456
2021-06-02,Santa Clara,85,1922200,118264,119553,812,120365,2058
2021-06-02,Santa Cruz,87,273765,16164,16144,877,17021,207
2021-06-02,Shasta,89,179085,12374,12426,1758,14184,199
2021-06-02,Sierra,91,2930,55,55,14,69,0
2021-06-02,Siskiyou,93,43540,1925,1861,392,2253,21
2021-06-02,Solano,95,438530,33004,33007,564,33571,256
2021-06-02,Sonoma,97,501317,30279,30359,351,30710,322
2021-06-02,Stanislaus,99,539301,56283,56377,6207,62584,973
2021-06-02,Sutter,101,95872,9512,9533,93,9626,111
2021-06-02,Tehama,103,63373,5069,5081,630,5711,63
2021-06-02,Trinity,105,12862,359,328,64,392,3
2021-06-02,Tulare,107,460477,49630,49434,9592,59026,846
2021-06-02,Tuolumne,109,53932,4082,4095,166,4261,63
2021-06-02,Ventura,111,848112,81076,81033,3149,84182,1020
2021-06-02,Yolo,113,214977,14059,14074,344,14418,210
2021-06-02,Yuba,115,75493,6080,6072,134,6206,48
2021-06-01,Alameda,1,1643700,88319,88472,2067,90539,1253
2021-06-01,Alpine,3,1148,88,88,0,88,0
2021-06-01,Amador,5,37829,3696,3687,35,3722,46
2021-06-01,Butte,7,227075,12519,12427,1913,14340,193
2021-06-01,Calaveras,9,45235,2179,2173,15,2188,55
2021-06-01,Colusa,11,21464,1948,1955,324,2279,15
2021-06-01,Contra Costa,13,1133247,69779,69404,1353,70757,813
2021-06-01,Del Norte,15,27424,1398,1394,8,1402,8
2021-06-01,El Dorado,17,186661,10268,10271,776,11047,110
2021-06-01,Fresno,19,978130,102033,102534,9119,111653,1706
2021-06-01,Glenn,21,27897,2422,2422,580,3002,18
2021-06-01,Humboldt,23,135768,4318,4299,89,4388,42
2021-06-01,Imperial,25,180216,28563,28722,2895,31617,736
2021-06-01,Inyo,27,18085,1405,1403,4,1407,35
2021-06-01,Kern,29,883053,96849,96477,11447,107924,1319
2021-06-01,Kings,31,150075,22977,22977,1202,24179,244
2021-06-01,Lake,33,64148,3535,3523,9,3532,45
2021-06-01,Lassen,35,31185,5209,5172,122,5294,6
2021-06-01,Los Angeles,37,10098052,1202826,1202673,43940,1246613,24367
2021-06-01,Madera,39,155013,16539,16549,961,17510,240
2021-06-01,Marin,41,260295,14072,14081,269,14350,229
2021-06-01,Mariposa,43,17540,435,431,12,443,5
2021-06-01,Mendocino,45,87422,4016,3966,71,4037,47
2021-06-01,Merced,47,269075,31079,31195,1004,32199,456
2021-06-01,Modoc,49,8938,379,375,130,505,3
2021-06-01,Mono,51,14174,1251,1275,14,1289,3
2021-06-01,Monterey,53,433212,43055,43051,1937,44988,379
2021-06-01,Napa,55,140530,9928,9949,35,9984,82
2021-06-01,Nevada,57,99092,4847,4825,199,5024,72
2021-06-01,Orange,59,3164182,254662,254603,11780,266383,5051
2021-06-01,Placer,61,380077,23290,23021,1576,24597,293
2021-06-01,Plumas,63,18699,709,690,12,702,4
2021-06-01,Riverside,65,2383286,291328,288996,14853,303849,4442
2021-06-01,Sacramento,67,1510023,106460,106330,1867,108197,1644
2021-06-01,San Benito,69,59416,6061,6073,119,6192,63
2021-06-01,San Bernardino,71,2135413,292832,292990,9224,302214,4758
2021-06-01,San Diego,73,3302833,280854,280305,0,280305,3756
2021-06-01,San Francisco,75,870044,36736,37031,1397,38428,550
2021-06-01,San Joaquin,77,732212,73149,72858,3772,76630,1383
2021-06-01,San Luis Obispo,79,281455,21227,21217,786,22003,256
2021-06-01,San Mateo,81,765935,42382,42383,483,42866,462
2021-06-01,Santa Barbara,83,443738,34445,34374,1349,35723,456
2021-06-01,Santa Clara,85,1922200,118236,119528,812,120340,2057
2021-06-01,Santa Cruz,87,273765,16160,16143,876,17019,207
2021-06-01,Shasta,89,179085,12365,12409,1752,14161,199
2021-06-01,Sierra,91,2930,55,55,14,69,0
2021-06-01,Siskiyou,93,43540,1919,1860,391,2251,21
2021-06-01,Solano,95,438530,32979,32974,563,33537,256
2021-06-01,Sonoma,97,501317,30240,30324,350,30674,322
2021-06-01,Stanislaus,99,539301,56259,56348,6205,62553,973
2021-06-01,Sutter,101,95872,9505,9528,93,9621,111
2021-06-01,Tehama,103,63373,5067,5079,630,5709,63
2021-06-01,Trinity,105,12862,358,328,63,391,3
2021-06-01,Tulare,107,460477,49622,49419,9588,59007,845
2021-06-01,Tuolumne,109,53932,4082,4094,166,4260,63
2021-06-01,Ventura,111,848112,81060,81018,3148,84166,1021
2021-06-01,Yolo,113,214977,14055,14067,343,14410,210
2021-06-01,Yuba,115,75493,6076,6067,134,6201,48
2021-05-31,Alameda,1,1643700,88281,88458,2063,90521,1253
2021-05-31,Alpine,3,1148,88,88,0,88,0
2021-05-31,Amador,5,37829,3690,3687,35,3722,46
2021-05-31,Butte,7,227075,12506,12429,1913,14342,193
2021-05-31,Calaveras,9,45235,2178,2171,15,2186,55
2021-05-31,Colusa,11,21464,1948,1956,323,2279,15
2021-05-31,Contra Costa,13,1133247,69742,69390,1351,70741,813
2021-05-31,Del Norte,15,27424,1395,1394,8,1402,8
2021-05-31,El Dorado,17,186661,10262,10271,774,11045,110
2021-05-31,Fresno,19,978130,101997,102507,9118,111625,1706
2021-05-31,Glenn,21,27897,2421,2422,579,3001,18
2021-05-31,Humboldt,23,135768,4306,4295,89,4384,42
2021-05-31,Imperial,25,180216,28557,28732,2892,31624,736
2021-05-31,Inyo,27,18085,1404,1403,4,1407,35
2021-05-31,Kern,29,883053,96813,96457,11438,107895,1319
2021-05-31,Kings,31,150075,22973,22977,1202,24179,244
2021-05-31,Lake,33,64148,3530,3523,9,3532,45
2021-05-31,Lassen,35,31185,5207,5172,121,5293,6
2021-05-31,Los Angeles,37,10098052,1202586,1202567,43932,1246499,24364
2021-05-31,Madera,39,155013,16538,16543,960,17503,240
2021-05-31,Marin,41,260295,14070,14080,268,14348,229
2021-05-31,Mariposa,43,17540,435,430,12,442,5
2021-05-31,Mendocino,45,87422,4007,3961,71,4032,47
2021-05-31,Merced,47,269075,31074,31194,1004,32198,456
2021-05-31,Modoc,49,8938,378,374,130,504,3
2021-05-31,Mono,51,14174,1251,1275,14,1289,3
2021-05-31,Monterey,53,433212,43051,43051,1937,44988,379
2021-05-31,Napa,55,140530,9921,9948,35,9983,82
2021-05-31,Nevada,57,99092,4837,4823,198,5021,72
2021-05-31,Orange,59,3164182,254635,254572,11773,266345,5051
2021-05-31,Placer,61,380077,23263,23019,1571,24590,293
2021-05-31,Plumas,63,18699,708,690,12,702,4
2021-05-31,Riverside,65,2383286,291272,288970,14841,303811,4442
2021-05-31,Sacramento,67,1510023,106363,106278,1862,108140,1644
2021-05-31,San Benito,69,59416,6061,6072,119,6191,63
2021-05-31,San Bernardino,71,2135413,292786,292973,9223,302196,4758
2021-05-31,San Diego,73,3302833,280750,280254,0,280254,3756
2021-05-31,San Francisco,75,870044,36721,37022,1396,38418,550
2021-05-31,San Joaquin,77,732212,73102,72856,3765,76621,1383
2021-05-31,San Luis Obispo,79,281455,21219,21215,786,22001,256
2021-05-31,San Mateo,81,765935,42366,42389,483,42872,442
2021-05-31,Santa Barbara,83,443738,34432,34369,1347,35716,456
2021-05-31,Santa Clara,85,1922200,118192,119515,812,120327,2057
2021-05-31,Santa Cruz,87,273765,16157,16139,876,17015,207
2021-05-31,Shasta,89,179085,12349,12408,1747,14155,199
2021-05-31,Sierra,91,2930,55,55,14,69,0
2021-05-31,Siskiyou,93,43540,1918,1856,390,2246,21
2021-05-31,Solano,95,438530,32928,32973,563,33536,256
2021-05-31,Sonoma,97,501317,30197,30314,350,30664,322
2021-05-31,Stanislaus,99,539301,56208,56335,6202,62537,973
2021-05-31,Sutter,101,95872,9486,9523,93,9616,111
2021-05-31,Tehama,103,63373,5065,5076,629,5705,63
2021-05-31,Trinity,105,12862,358,328,63,391,3
2021-05-31,Tulare,107,460477,49611,49404,9583,58987,845
2021-05-31,Tuolumne,109,53932,4080,4095,159,4254,63
2021-05-31,Ventura,111,848112,81045,81017,3145,84162,1021
2021-05-31,Yolo,113,214977,14051,14064,343,14407,210
2021-05-31,Yuba,115,75493,6070,6063,131,6194,48
2021-05-30,Alameda,1,1643700,88257,88429,2063,90492,1253
2021-05-30,Alpine,3,1148,88,88,0,88,0
2021-05-30,Amador,5,37829,3686,3685,35,3720,46
2021-05-30,Butte,7,227075,12496,12427,1911,14338,190
2021-05-30,Calaveras,9,45235,2174,2166,15,2181,55
2021-05-30,Colusa,11,21464,1948,1954,323,2277,15
2021-05-30,Contra Costa,13,1133247,69708,69381,1349,70730,813
2021-05-30,Del Norte,15,27424,1394,1393,8,1401,8
2021-05-30,El Dorado,17,186661,10259,10271,774,11045,110
2021-05-30,Fresno,19,978130,101980,102499,9114,111613,1706
2021-05-30,Glenn,21,27897,2421,2422,578,3000,18
2021-05-30,Humboldt,23,135768,4297,4291,89,4380,42
2021-05-30,Imperial,25,180216,28552,28732,2891,31623,736
2021-05-30,Inyo,27,18085,1404,1403,4,1407,35
2021-05-30,Kern,29,883053,96797,96443,11435,107878,1319
2021-05-30,Kings,31,150075,22972,22974,1201,24175,244
2021-05-30,Lake,33,64148,3530,3517,9,3526,45
2021-05-30,Lassen,35,31185,5205,5171,121,5292,6
2021-05-30,Los Angeles,37,10098052,1202484,1202425,43925,1246350,24360
2021-05-30,Madera,39,155013,16534,16538,960,17498,240
2021-05-30,Marin,41,260295,14066,14083,267,14350,229
2021-05-30,Mariposa,43,17540,435,430,12,442,5
2021-05-30,Mendocino,45,87422,4000,3955,71,4026,47
2021-05-30,Merced,47,269075,31070,31189,1003,32192,456
2021-05-30,Modoc,49,8938,378,374,130,504,3
2021-05-30,Mono,51,14174,1251,1275,14,1289,3
2021-05-30,Monterey,53,433212,43048,43049,1937,44986,379
2021-05-30,Napa,55,140530,9920,9948,35,9983,82
2021-05-30,Nevada,57,99092,4831,4818,198,5016,72
2021-05-30,Orange,59,3164182,254611,254559,11772,266331,5051
2021-05-30,Placer,61,380077,23257,23016,1571,24587,293
2021-05-30,Plumas,63,18699,706,690,12,702,4
2021-05-30,Riverside,65,2383286,291251,288961,14839,303800,4442
2021-05-30,Sacramento,67,1510023,106318,106252,1860,108112,1644
2021-05-30,San Benito,69,59416,6061,6072,119,6191,63
2021-05-30,San Bernardino,71,2135413,292761,292981,9222,302203,4758
2021-05-30,San Diego,73,3302833,280694,280209,0,280209,3756
2021-05-30,San Francisco,75,870044,36704,37016,1395,38411,550
2021-05-30,San Joaquin,77,732212,73085,72853,3764,76617,1383
2021-05-30,San Luis Obispo,79,281455,21211,21211,785,21996,256
2021-05-30,San Mateo,81,765935,42358,42386,483,42869,439
2021-05-30,Santa Barbara,83,443738,34428,34369,1345,35714,456
2021-05-30,Santa Clara,85,1922200,118170,119510,808,120318,2057
2021-05-30,Santa Cruz,87,273765,16155,16140,876,17016,207
2021-05-30,Shasta,89,179085,12347,12408,1744,14152,199
2021-05-30,Sierra,91,2930,55,55,14,69,0
2021-05-30,Siskiyou,93,43540,1918,1856,390,2246,21
2021-05-30,Solano,95,438530,32917,32952,562,33514,256
2021-05-30,Sonoma,97,501317,30181,30310,348,30658,322
2021-05-30,Stanislaus,99,539301,56189,56323,6201,62524,973
2021-05-30,Sutter,101,95872,9485,9519,92,9611,111
2021-05-30,Tehama,103,63373,5065,5073,629,5702,63
2021-05-30,Trinity,105,12862,358,328,63,391,3
2021-05-30,Tulare,107,460477,49604,49397,9575,58972,845
2021-05-30,Tuolumne,109,53932,4080,4094,159,4253,63
2021-05-30,Ventura,111,848112,81042,81012,3143,84155,1021
2021-05-30,Yolo,113,214977,14046,14059,342,14401,210
2021-05-30,Yuba,115,75493,6063,6063,130,6193,48
2021-05-29,Alameda,1,1643700,88234,88433,2061,90494,1253
2021-05-29,Alpine,3,1148,88,88,0,88,0
2021-05-29,Amador,5,37829,3685,3683,35,3718,46
2021-05-29,Butte,7,227075,12490,12425,1911,14336,190
2021-05-29,Calaveras,9,45235,2173,2166,15,2181,55
2021-05-29,Colusa,11,21464,1945,1954,323,2277,15
2021-05-29,Contra Costa,13,1133247,69675,69351,1349,70700,813
2021-05-29,Del Norte,15,27424,1394,1391,8,1399,8
2021-05-29,El Dorado,17,186661,10258,10269,772,11041,110
2021-05-29,Fresno,19,978130,101968,102470,9107,111577,1706
2021-05-29,Glenn,21,27897,2421,2422,577,2999,18
2021-05-29,Humboldt,23,135768,4291,4283,89,4372,42
2021-05-29,Imperial,25,180216,28549,28729,2890,31619,736
2021-05-29,Inyo,27,18085,1404,1404,4,1408,35
2021-05-29,Kern,29,883053,96787,96424,11418,107842,1319
2021-05-29,Kings,31,150075,22971,22970,1200,24170,244
2021-05-29,Lake,33,64148,3530,3515,9,3524,45
2021-05-29,Lassen,35,31185,5205,5171,121,5292,6
2021-05-29,Los Angeles,37,10098052,1202361,1202264,43922,1246186,24359
2021-05-29,Madera,39,155013,16532,16535,960,17495,240
2021-05-29,Marin,41,260295,14062,14071,266,14337,229
2021-05-29,Mariposa,43,17540,434,428,12,440,5
2021-05-29,Mendocino,45,87422,3994,3952,71,4023,47
2021-05-29,Merced,47,269075,31059,31187,1003,32190,456
2021-05-29,Modoc,49,8938,378,374,130,504,3
2021-05-29,Mono,51,14174,1251,1275,14,1289,3
2021-05-29,Monterey,53,433212,43046,43042,1937,44979,379
2021-05-29,Napa,55,140530,9917,9948,35,9983,82
2021-05-29,Nevada,57,99092,4830,4816,198,5014,72
2021-05-29,Orange,59,3164182,254589,254537,11762,266299,5049
2021-05-29,Placer,61,380077,23243,23009,1570,24579,293
2021-05-29,Plumas,63,18699,706,689,12,701,4
2021-05-29,Riverside,65,2383286,291231,288908,14839,303747,4442
2021-05-29,Sacramento,67,1510023,106289,106218,1857,108075,1643
2021-05-29,San Benito,69,59416,6060,6072,119,6191,63
2021-05-29,San Bernardino,71,2135413,292730,292961,9220,302181,4757
2021-05-29,San Diego,73,3302833,280635,280151,0,280151,3756
2021-05-29,San Francisco,75,870044,36695,37008,1395,38403,550
2021-05-29,San Joaquin,77,732212,73069,72827,3762,76589,1383
2021-05-29,San Luis Obispo,79,281455,21209,21201,785,21986,256
2021-05-29,San Mateo,81,765935,42350,42375,482,42857,439
2021-05-29,Santa Barbara,83,443738,34424,34367,1345,35712,456
2021-05-29,Santa Clara,85,1922200,118146,119498,807,120305,2056
2021-05-29,Santa Cruz,87,273765,16154,16137,876,17013,207
2021-05-29,Shasta,89,179085,12339,12401,1743,14144,199
2021-05-29,Sierra,91,2930,55,55,14,69,0
2021-05-29,Siskiyou,93,43540,1913,1856,390,2246,21
2021-05-29,Solano,95,438530,32908,32917,562,33479,256
2021-05-29,Sonoma,97,501317,30158,30298,347,30645,322
2021-05-29,Stanislaus,99,539301,56169,56305,6199,62504,974
2021-05-29,Sutter,101,95872,9481,9516,92,9608,111
2021-05-29,Tehama,103,63373,5064,5070,629,5699,63
2021-05-29,Trinity,105,12862,358,328,63,391,3
2021-05-29,Tulare,107,460477,49594,49392,9571,58963,845
2021-05-29,Tuolumne,109,53932,4080,4093,159,4252,63
2021-05-29,Ventura,111,848112,81034,81008,3143,84151,1021
2021-05-29,Yolo,113,214977,14045,14055,342,14397,210
2021-05-29,Yuba,115,75493,6063,6059,130,6189,48
2021-05-28,Alameda,1,1643700,88210,88391,2057,90448,1261
2021-05-28,Alpine,3,1148,88,88,0,88,0
2021-05-28,Amador,5,37829,3685,3680,35,3715,46
2021-05-28,Butte,7,227075,12487,12407,1910,14317,190
2021-05-28,Calaveras,9,45235,2172,2165,15,2180,55
2021-05-28,Colusa,11,21464,1945,1954,321,2275,15
2021-05-28,Contra Costa,13,1133247,69639,69290,1348,70638,813
2021-05-28,Del Norte,15,27424,1393,1390,8,1398,8
2021-05-28,El Dorado,17,186661,10255,10265,772,11037,110
2021-05-28,Fresno,19,978130,101954,102437,9107,111544,1705
2021-05-28,Glenn,21,27897,2421,2419,577,2996,18
2021-05-28,Humboldt,23,135768,4285,4265,89,4354,42
2021-05-28,Imperial,25,180216,28546,28722,2890,31612,736
2021-05-28,Inyo,27,18085,1404,1404,4,1408,35
2021-05-28,Kern,29,883053,96770,96396,11410,107806,1320
2021-05-28,Kings,31,150075,22969,22962,1200,24162,244
2021-05-28,Lake,33,64148,3528,3515,9,3524,45
2021-05-28,Lassen,35,31185,5205,5169,121,5290,6
2021-05-28,Los Angeles,37,10098052,1202254,1202103,43910,1246013,24357
2021-05-28,Madera,39,155013,16530,16530,960,17490,240
2021-05-28,Marin,41,260295,14061,14063,265,14328,229
2021-05-28,Mariposa,43,17540,434,428,12,440,5
2021-05-28,Mendocino,45,87422,3989,3947,71,4018,47
2021-05-28,Merced,47,269075,31056,31176,1003,32179,455
2021-05-28,Modoc,49,8938,378,374,130,504,3
2021-05-28,Mono,51,14174,1251,1274,14,1288,3
2021-05-28,Monterey,53,433212,43045,43036,1937,44973,379
2021-05-28,Napa,55,140530,9917,9941,35,9976,82
2021-05-28,Nevada,57,99092,4828,4813,198,5011,71
2021-05-28,Orange,59,3164182,254571,254494,11760,266254,5047
2021-05-28,Placer,61,380077,23233,22987,1568,24555,293
2021-05-28,Plumas,63,18699,704,688,12,700,4
2021-05-28,Riverside,65,2383286,291209,288872,14837,303709,4442
2021-05-28,Sacramento,67,1510023,106231,106131,1856,107987,1642
2021-05-28,San Benito,69,59416,6060,6074,119,6193,63
2021-05-28,San Bernardino,71,2135413,292706,292905,9220,302125,4757
2021-05-28,San Diego,73,3302833,280572,280043,0,280043,3756
2021-05-28,San Francisco,75,870044,36689,36987,1395,38382,546
2021-05-28,San Joaquin,77,732212,73039,72793,3760,76553,1383
2021-05-28,San Luis Obispo,79,281455,21205,21190,783,21973,256
2021-05-28,San Mateo,81,765935,42343,42364,482,42846,439
2021-05-28,Santa Barbara,83,443738,34423,34371,1344,35715,455
2021-05-28,Santa Clara,85,1922200,118122,119462,807,120269,2056
2021-05-28,Santa Cruz,87,273765,16153,16129,876,17005,207
2021-05-28,Shasta,89,179085,12330,12383,1741,14124,198
2021-05-28,Sierra,91,2930,55,54,14,68,0
2021-05-28,Siskiyou,93,43540,1911,1850,390,2240,19
2021-05-28,Solano,95,438530,32893,32892,562,33454,256
2021-05-28,Sonoma,97,501317,30139,30270,347,30617,321
2021-05-28,Stanislaus,99,539301,56146,56278,6196,62474,974
2021-05-28,Sutter,101,95872,9477,9511,92,9603,111
2021-05-28,Tehama,103,63373,5058,5064,629,5693,63
2021-05-28,Trinity,105,12862,358,328,63,391,3
2021-05-28,Tulare,107,460477,49588,49375,9561,58936,846
2021-05-28,Tuolumne,109,53932,4080,4090,159,4249,63
2021-05-28,Ventura,111,848112,81023,80985,3142,84127,1021
2021-05-28,Yolo,113,214977,14041,14050,341,14391,210
2021-05-28,Yuba,115,75493,6061,6050,129,6179,48
2021-05-27,Alameda,1,1643700,88174,88342,2055,90397,1274
2021-05-27,Alpine,3,1148,88,88,0,88,0
2021-05-27,Amador,5,37829,3683,3680,35,3715,46
2021-05-27,Butte,7,227075,12482,12401,1909,14310,190
2021-05-27,Calaveras,9,45235,2171,2163,15,2178,55
2021-05-27,Colusa,11,21464,1942,1952,321,2273,15
2021-05-27,Contra Costa,13,1133247,69598,69245,1346,70591,813
2021-05-27,Del Norte,15,27424,1393,1388,8,1396,8
2021-05-27,El Dorado,17,186661,10254,10248,772,11020,112
2021-05-27,Fresno,19,978130,101938,102413,9104,111517,1704
2021-05-27,Glenn,21,27897,2421,2415,577,2992,18
2021-05-27,Humboldt,23,135768,4277,4260,89,4349,42
2021-05-27,Imperial,25,180216,28535,28728,2890,31618,736
2021-05-27,Inyo,27,18085,1404,1404,4,1408,35
2021-05-27,Kern,29,883053,96754,96364,11402,107766,1322
2021-05-27,Kings,31,150075,22966,22953,1200,24153,245
2021-05-27,Lake,33,64148,3523,3509,9,3518,45
2021-05-27,Lassen,35,31185,5204,5170,120,5290,6
2021-05-27,Los Angeles,37,10098052,1202095,1201927,43893,1245820,24348
2021-05-27,Madera,39,155013,16521,16527,960,17487,240
2021-05-27,Marin,41,260295,14057,14061,265,14326,229
2021-05-27,Mariposa,43,17540,432,427,12,439,5
2021-05-27,Mendocino,45,87422,3983,3945,71,4016,47
2021-05-27,Merced,47,269075,31044,31161,1003,32164,455
2021-05-27,Modoc,49,8938,377,374,130,504,3
2021-05-27,Mono,51,14174,1251,1276,14,1290,3
2021-05-27,Monterey,53,433212,43039,43032,1937,44969,379
2021-05-27,Napa,55,140530,9916,9934,35,9969,82
2021-05-27,Nevada,57,99092,4824,4807,196,5003,71
2021-05-27,Orange,59,3164182,254535,254438,11755,266193,5059
2021-05-27,Placer,61,380077,23224,22966,1568,24534,293
2021-05-27,Plumas,63,18699,704,687,12,699,4
2021-05-27,Riverside,65,2383286,291174,288835,14832,303667,4443
2021-05-27,Sacramento,67,1510023,106157,106015,1854,107869,1642
2021-05-27,San Benito,69,59416,6059,6074,119,6193,63
2021-05-27,San Bernardino,71,2135413,292668,292755,9217,301972,4756
2021-05-27,San Diego,73,3302833,280498,279960,0,279960,3756
2021-05-27,San Francisco,75,870044,36684,36980,1391,38371,546
2021-05-27,San Joaquin,77,732212,73007,72714,3756,76470,1388
2021-05-27,San Luis Obispo,79,281455,21202,21171,783,21954,256
2021-05-27,San Mateo,81,765935,42334,42345,482,42827,436
2021-05-27,Santa Barbara,83,443738,34419,34355,1344,35699,456
2021-05-27,Santa Clara,85,1922200,118103,119452,807,120259,2053
2021-05-27,Santa Cruz,87,273765,16150,16134,876,17010,207
2021-05-27,Shasta,89,179085,12319,12380,1741,14121,202
2021-05-27,Sierra,91,2930,55,54,14,68,0
2021-05-27,Siskiyou,93,43540,1908,1846,390,2236,18
2021-05-27,Solano,95,438530,32852,32855,561,33416,257
2021-05-27,Sonoma,97,501317,30112,30253,343,30596,321
2021-05-27,Stanislaus,99,539301,56118,56207,6195,62402,974
2021-05-27,Sutter,101,95872,9473,9501,92,9593,111
2021-05-27,Tehama,103,63373,5055,5064,628,5692,63
2021-05-27,Trinity,105,12862,358,328,63,391,3
2021-05-27,Tulare,107,460477,49574,49366,9552,58918,840
2021-05-27,Tuolumne,109,53932,4079,4090,159,4249,66
2021-05-27,Ventura,111,848112,81010,80965,3138,84103,1023
2021-05-27,Yolo,113,214977,14038,14036,340,14376,213
2021-05-27,Yuba,115,75493,6056,6040,128,6168,48
2021-05-26,Alameda,1,1643700,88145,88297,2055,90352,1266
2021-05-26,Alpine,3,1148,88,88,0,88,0
2021-05-26,Amador,5,37829,3683,3679,35,3714,46
2021-05-26,Butte,7,227075,12473,12332,1908,14240,190
2021-05-26,Calaveras,9,45235,2169,2154,15,2169,55
2021-05-26,Colusa,11,21464,1941,1952,321,2273,15
2021-05-26,Contra Costa,13,1133247,69561,69210,1346,70556,812
2021-05-26,Del Norte,15,27424,1393,1386,7,1393,8
2021-05-26,El Dorado,17,186661,10250,10242,771,11013,112
2021-05-26,Fresno,19,978130,101907,102374,9098,111472,1702
2021-05-26,Glenn,21,27897,2420,2415,577,2992,18
2021-05-26,Humboldt,23,135768,4272,4246,85,4331,42
2021-05-26,Imperial,25,180216,28530,28712,2888,31600,734
2021-05-26,Inyo,27,18085,1404,1403,4,1407,36
2021-05-26,Kern,29,883053,96730,96343,11394,107737,1320
2021-05-26,Kings,31,150075,22962,22950,1199,24149,245
2021-05-26,Lake,33,64148,3522,3508,9,3517,45
2021-05-26,Lassen,35,31185,5203,5164,120,5284,6
2021-05-26,Los Angeles,37,10098052,1201931,1198100,43875,1241975,24221
2021-05-26,Madera,39,155013,16519,16520,960,17480,240
2021-05-26,Marin,41,260295,14054,14061,264,14325,227
2021-05-26,Mariposa,43,17540,432,427,12,439,5
2021-05-26,Mendocino,45,87422,3977,3938,71,4009,47
2021-05-26,Merced,47,269075,31035,31139,1003,32142,455
2021-05-26,Modoc,49,8938,377,371,129,500,3
2021-05-26,Mono,51,14174,1251,1274,14,1288,3
2021-05-26,Monterey,53,433212,43033,43018,1936,44954,379
2021-05-26,Napa,55,140530,9909,9932,33,9965,82
2021-05-26,Nevada,57,99092,4819,4803,196,4999,70
2021-05-26,Orange,59,3164182,254500,254368,11751,266119,5058
2021-05-26,Placer,61,380077,23200,22940,1568,24508,293
2021-05-26,Plumas,63,18699,703,685,12,697,4
2021-05-26,Riverside,65,2383286,291128,288782,14825,303607,4443
2021-05-26,Sacramento,67,1510023,106071,105919,1850,107769,1637
2021-05-26,San Benito,69,59416,6059,6074,119,6193,63
2021-05-26,San Bernardino,71,2135413,292631,292662,9216,301878,4755
2021-05-26,San Diego,73,3302833,280424,279859,0,279859,3755
2021-05-26,San Francisco,75,870044,36672,36954,1391,38345,546
2021-05-26,San Joaquin,77,732212,72966,72681,3753,76434,1388
2021-05-26,San Luis Obispo,79,281455,21197,21163,783,21946,256
2021-05-26,San Mateo,81,765935,42325,42331,481,42812,436
2021-05-26,Santa Barbara,83,443738,34410,34348,1344,35692,459
2021-05-26,Santa Clara,85,1922200,118076,119421,806,120227,2031
2021-05-26,Santa Cruz,87,273765,16149,16139,876,17015,207
2021-05-26,Shasta,89,179085,12305,12357,1737,14094,202
2021-05-26,Sierra,91,2930,55,54,14,68,0
2021-05-26,Siskiyou,93,43540,1906,1847,388,2235,18
2021-05-26,Solano,95,438530,32816,32831,561,33392,257
2021-05-26,Sonoma,97,501317,30086,30230,343,30573,321
2021-05-26,Stanislaus,99,539301,56096,56193,6192,62385,974
2021-05-26,Sutter,101,95872,9468,9495,92,9587,112
2021-05-26,Tehama,103,63373,5054,5054,625,5679,63
2021-05-26,Trinity,105,12862,358,328,63,391,3
2021-05-26,Tulare,107,460477,49567,49352,9548,58900,839
2021-05-26,Tuolumne,109,53932,4075,4088,159,4247,66
2021-05-26,Ventura,111,848112,80987,80944,3136,84080,1023
2021-05-26,Yolo,113,214977,14035,14025,340,14365,213
2021-05-26,Yuba,115,75493,6051,6036,128,6164,49
2021-05-25,Alameda,1,1643700,88116,88237,2055,90292,1263
2021-05-25,Alpine,3,1148,88,88,0,88,0
2021-05-25,Amador,5,37829,3678,3676,35,3711,46
2021-05-25,Butte,7,227075,12462,12295,1907,14202,189
2021-05-25,Calaveras,9,45235,2167,2148,15,2163,55
2021-05-25,Colusa,11,21464,1940,1949,321,2270,15
2021-05-25,Contra Costa,13,1133247,69509,69167,1341,70508,809
2021-05-25,Del Norte,15,27424,1393,1385,7,1392,8
2021-05-25,El Dorado,17,186661,10243,10240,770,11010,112
2021-05-25,Fresno,19,978130,101885,102329,9098,111427,1701
2021-05-25,Glenn,21,27897,2419,2414,576,2990,17
2021-05-25,Humboldt,23,135768,4265,4231,83,4314,42
2021-05-25,Imperial,25,180216,28523,28586,2888,31474,735
2021-05-25,Inyo,27,18085,1404,1402,4,1406,36
2021-05-25,Kern,29,883053,96700,96319,11379,107698,1319
2021-05-25,Kings,31,150075,22956,22944,1198,24142,245
2021-05-25,Lake,33,64148,3521,3508,9,3517,44
2021-05-25,Lassen,35,31185,5199,5164,120,5284,6
2021-05-25,Los Angeles,37,10098052,1201756,1197940,43856,1241796,24212
2021-05-25,Madera,39,155013,16514,16519,959,17478,240
2021-05-25,Marin,41,260295,14048,14053,264,14317,227
2021-05-25,Mariposa,43,17540,431,427,12,439,5
2021-05-25,Mendocino,45,87422,3972,3928,71,3999,47
2021-05-25,Merced,47,269075,31014,31132,1003,32135,455
2021-05-25,Modoc,49,8938,376,367,129,496,3
2021-05-25,Mono,51,14174,1251,1274,14,1288,3
2021-05-25,Monterey,53,433212,43029,43012,1935,44947,379
2021-05-25,Napa,55,140530,9907,9926,33,9959,82
2021-05-25,Nevada,57,99092,4813,4795,196,4991,70
2021-05-25,Orange,59,3164182,254471,254321,11750,266071,5057
2021-05-25,Placer,61,380077,23189,22920,1566,24486,292
2021-05-25,Plumas,63,18699,703,684,12,696,4
2021-05-25,Riverside,65,2383286,291089,288725,14822,303547,4443
2021-05-25,Sacramento,67,1510023,105991,105828,1846,107674,1633
2021-05-25,San Benito,69,59416,6059,6073,119,6192,63
2021-05-25,San Bernardino,71,2135413,292579,292485,9215,301700,4755
2021-05-25,San Diego,73,3302833,280345,279786,0,279786,3753
2021-05-25,San Francisco,75,870044,36649,36939,1391,38330,546
2021-05-25,San Joaquin,77,732212,72926,72628,3749,76377,1387
2021-05-25,San Luis Obispo,79,281455,21194,21153,783,21936,256
2021-05-25,San Mateo,81,765935,42315,42268,481,42749,435
2021-05-25,Santa Barbara,83,443738,34407,34337,1343,35680,459
2021-05-25,Santa Clara,85,1922200,118051,119393,805,120198,2032
2021-05-25,Santa Cruz,87,273765,16144,16141,876,17017,207
2021-05-25,Shasta,89,179085,12295,12328,1734,14062,202
2021-05-25,Sierra,91,2930,54,54,14,68,0
2021-05-25,Siskiyou,93,43540,1905,1845,387,2232,18
2021-05-25,Solano,95,438530,32798,32817,560,33377,256
2021-05-25,Sonoma,97,501317,30057,30207,342,30549,321
2021-05-25,Stanislaus,99,539301,56059,56168,6190,62358,974
2021-05-25,Sutter,101,95872,9464,9495,92,9587,112
2021-05-25,Tehama,103,63373,5052,5048,624,5672,63
2021-05-25,Trinity,105,12862,358,328,62,390,3
2021-05-25,Tulare,107,460477,49557,49326,9540,58866,838
2021-05-25,Tuolumne,109,53932,4075,4084,159,4243,66
2021-05-25,Ventura,111,848112,80969,80905,3136,84041,1022
2021-05-25,Yolo,113,214977,14028,14018,338,14356,213
2021-05-25,Yuba,115,75493,6044,6028,128,6156,49
2021-05-24,Alameda,1,1643700,88053,88182,2054,90236,1263
2021-05-24,Alpine,3,1148,88,88,0,88,0
2021-05-24,Amador,5,37829,3676,3675,35,3710,46
2021-05-24,Butte,7,227075,12449,12279,1904,14183,189
2021-05-24,Calaveras,9,45235,2166,2146,15,2161,54
2021-05-24,Colusa,11,21464,1940,1949,321,2270,15
2021-05-24,Contra Costa,13,1133247,69470,69107,1337,70444,809
2021-05-24,Del Norte,15,27424,1392,1384,7,1391,8
2021-05-24,El Dorado,17,186661,10233,10227,769,10996,112
2021-05-24,Fresno,19,978130,101845,102289,9096,111385,1698
2021-05-24,Glenn,21,27897,2419,2413,576,2989,17
2021-05-24,Humboldt,23,135768,4258,4225,83,4308,42
2021-05-24,Imperial,25,180216,28521,28575,2888,31463,735
2021-05-24,Inyo,27,18085,1404,1402,4,1406,36
2021-05-24,Kern,29,883053,96673,96296,11374,107670,1319
2021-05-24,Kings,31,150075,22952,22940,1198,24138,246
2021-05-24,Lake,33,64148,3519,3506,9,3515,43
2021-05-24,Lassen,35,31185,5195,5163,120,5283,6
2021-05-24,Los Angeles,37,10098052,1201584,1197782,43841,1241623,24201
2021-05-24,Madera,39,155013,16511,16513,958,17471,239
2021-05-24,Marin,41,260295,14046,14051,264,14315,227
2021-05-24,Mariposa,43,17540,430,427,12,439,5
2021-05-24,Mendocino,45,87422,3970,3919,71,3990,47
2021-05-24,Merced,47,269075,31004,31128,1002,32130,455
2021-05-24,Modoc,49,8938,376,366,128,494,3
2021-05-24,Mono,51,14174,1251,1270,14,1284,3
2021-05-24,Monterey,53,433212,43024,43005,1934,44939,379
2021-05-24,Napa,55,140530,9907,9924,33,9957,82
2021-05-24,Nevada,57,99092,4810,4790,196,4986,70
2021-05-24,Orange,59,3164182,254437,254287,11740,266027,5056
2021-05-24,Placer,61,380077,23169,22895,1565,24460,292
2021-05-24,Plumas,63,18699,702,683,12,695,4
2021-05-24,Riverside,65,2383286,291036,288669,14811,303480,4442
2021-05-24,Sacramento,67,1510023,105876,105716,1845,107561,1632
2021-05-24,San Benito,69,59416,6059,6072,119,6191,63
2021-05-24,San Bernardino,71,2135413,292541,292343,9213,301556,4747
2021-05-24,San Diego,73,3302833,280236,279715,0,279715,3749
2021-05-24,San Francisco,75,870044,36630,36934,1390,38324,547
2021-05-24,San Joaquin,77,732212,72894,72586,3748,76334,1371
2021-05-24,San Luis Obispo,79,281455,21176,21146,782,21928,256
2021-05-24,San Mateo,81,765935,42306,42249,481,42730,433
2021-05-24,Santa Barbara,83,443738,34402,34322,1343,35665,459
2021-05-24,Santa Clara,85,1922200,118019,119358,804,120162,2030
2021-05-24,Santa Cruz,87,273765,16139,16135,876,17011,207
2021-05-24,Shasta,89,179085,12279,12315,1730,14045,201
2021-05-24,Sierra,91,2930,54,54,14,68,0
2021-05-24,Siskiyou,93,43540,1901,1840,387,2227,17
2021-05-24,Solano,95,438530,32774,32792,559,33351,254
2021-05-24,Sonoma,97,501317,30042,30187,342,30529,321
2021-05-24,Stanislaus,99,539301,56025,56128,6186,62314,974
2021-05-24,Sutter,101,95872,9458,9486,92,9578,113
2021-05-24,Tehama,103,63373,5049,5043,622,5665,63
2021-05-24,Trinity,105,12862,358,328,62,390,3
2021-05-24,Tulare,107,460477,49550,49318,9536,58854,838
2021-05-24,Tuolumne,109,53932,4075,4083,151,4234,65
2021-05-24,Ventura,111,848112,80956,80876,3134,84010,1022
2021-05-24,Yolo,113,214977,14011,14012,335,14347,213
2021-05-24,Yuba,115,75493,6035,6022,128,6150,49
2021-05-23,Alameda,1,1643700,87980,88157,2051,90208,1263
2021-05-23,Alpine,3,1148,88,88,0,88,0
2021-05-23,Amador,5,37829,3675,3673,35,3708,46
2021-05-23,Butte,7,227075,12435,12271,1903,14174,189
2021-05-23,Calaveras,9,45235,2156,2144,15,2159,54
2021-05-23,Colusa,11,21464,1940,1949,319,2268,15
2021-05-23,Contra Costa,13,1133247,69424,69075,1335,70410,809
2021-05-23,Del Norte,15,27424,1388,1383,7,1390,8
2021-05-23,El Dorado,17,186661,10227,10222,769,10991,112
2021-05-23,Fresno,19,978130,101801,102270,9090,111360,1698
2021-05-23,Glenn,21,27897,2417,2413,576,2989,17
2021-05-23,Humboldt,23,135768,4240,4216,83,4299,42
2021-05-23,Imperial,25,180216,28515,28569,2887,31456,735
2021-05-23,Inyo,27,18085,1404,1402,4,1406,36
2021-05-23,Kern,29,883053,96651,96282,11365,107647,1319
2021-05-23,Kings,31,150075,22939,22939,1196,24135,246
2021-05-23,Lake,33,64148,3516,3504,9,3513,43
2021-05-23,Lassen,35,31185,5191,5163,119,5282,6
2021-05-23,Los Angeles,37,10098052,1201403,1197633,43827,1241460,24197
2021-05-23,Madera,39,155013,16506,16504,957,17461,239
2021-05-23,Marin,41,260295,14037,14048,264,14312,227
2021-05-23,Mariposa,43,17540,430,427,12,439,5
2021-05-23,Mendocino,45,87422,3964,3913,70,3983,47
2021-05-23,Merced,47,269075,30994,31118,1002,32120,455
2021-05-23,Modoc,49,8938,372,366,128,494,3
2021-05-23,Mono,51,14174,1250,1270,14,1284,3
2021-05-23,Monterey,53,433212,43014,43003,1934,44937,379
2021-05-23,Napa,55,140530,9903,9923,33,9956,82
2021-05-23,Nevada,57,99092,4800,4790,196,4986,70
2021-05-23,Orange,59,3164182,254399,254277,11733,266010,5050
2021-05-23,Placer,61,380077,23150,22888,1565,24453,292
2021-05-23,Plumas,63,18699,701,683,12,695,4
2021-05-23,Riverside,65,2383286,290969,288641,14807,303448,4442
2021-05-23,Sacramento,67,1510023,105759,105663,1843,107506,1632
2021-05-23,San Benito,69,59416,6058,6072,119,6191,63
2021-05-23,San Bernardino,71,2135413,292489,292327,9211,301538,4747
2021-05-23,San Diego,73,3302833,280146,279690,0,279690,3751
2021-05-23,San Francisco,75,870044,36619,36927,1389,38316,547
2021-05-23,San Joaquin,77,732212,72845,72571,3746,76317,1371
2021-05-23,San Luis Obispo,79,281455,21166,21141,781,21922,256
2021-05-23,San Mateo,81,765935,42289,42248,481,42729,433
2021-05-23,Santa Barbara,83,443738,34395,34319,1343,35662,459
2021-05-23,Santa Clara,85,1922200,117995,119333,804,120137,2030
2021-05-23,Santa Cruz,87,273765,16136,16130,876,17006,207
2021-05-23,Shasta,89,179085,12262,12313,1726,14039,201
2021-05-23,Sierra,91,2930,54,54,14,68,0
2021-05-23,Siskiyou,93,43540,1897,1826,380,2206,17
2021-05-23,Solano,95,438530,32756,32780,558,33338,254
2021-05-23,Sonoma,97,501317,30012,30168,341,30509,321
2021-05-23,Stanislaus,99,539301,55974,56104,6183,62287,974
2021-05-23,Sutter,101,95872,9449,9479,92,9571,113
2021-05-23,Tehama,103,63373,5042,5041,620,5661,63
2021-05-23,Trinity,105,12862,358,328,62,390,3
2021-05-23,Tulare,107,460477,49535,49310,9532,58842,838
2021-05-23,Tuolumne,109,53932,4072,4081,151,4232,65
2021-05-23,Ventura,111,848112,80926,80872,3133,84005,1022
2021-05-23,Yolo,113,214977,13999,14004,332,14336,213
2021-05-23,Yuba,115,75493,6030,6017,128,6145,49
2021-05-22,Alameda,1,1643700,87955,88101,2050,90151,1263
2021-05-22,Alpine,3,1148,88,88,0,88,0
2021-05-22,Amador,5,37829,3674,3672,35,3707,46
2021-05-22,Butte,7,227075,12423,12265,1902,14167,189
2021-05-22,Calaveras,9,45235,2154,2141,15,2156,54
2021-05-22,Colusa,11,21464,1936,1949,318,2267,15
2021-05-22,Contra Costa,13,1133247,69391,69004,1334,70338,809
2021-05-22,Del Norte,15,27424,1387,1381,7,1388,8
2021-05-22,El Dorado,17,186661,10222,10215,769,10984,112
2021-05-22,Fresno,19,978130,101787,102238,9083,111321,1698
2021-05-22,Glenn,21,27897,2417,2412,576,2988,17
2021-05-22,Humboldt,23,135768,4231,4194,82,4276,42
2021-05-22,Imperial,25,180216,28506,28574,2887,31461,735
2021-05-22,Inyo,27,18085,1404,1402,4,1406,36
2021-05-22,Kern,29,883053,96639,96260,11358,107618,1319
2021-05-22,Kings,31,150075,22939,22936,1196,24132,246
2021-05-22,Lake,33,64148,3513,3502,9,3511,43
2021-05-22,Lassen,35,31185,5191,5163,119,5282,6
2021-05-22,Los Angeles,37,10098052,1201297,1197454,43818,1241272,24192
2021-05-22,Madera,39,155013,16503,16503,957,17460,239
2021-05-22,Marin,41,260295,14034,14043,264,14307,227
2021-05-22,Mariposa,43,17540,430,427,12,439,5
2021-05-22,Mendocino,45,87422,3958,3908,70,3978,47
2021-05-22,Merced,47,269075,30984,31099,1002,32101,455
2021-05-22,Modoc,49,8938,372,366,128,494,3
2021-05-22,Mono,51,14174,1248,1270,14,1284,3
2021-05-22,Monterey,53,433212,43008,42998,1934,44932,379
2021-05-22,Napa,55,140530,9901,9918,33,9951,82
2021-05-22,Nevada,57,99092,4793,4787,195,4982,70
2021-05-22,Orange,59,3164182,254378,254238,11727,265965,5048
2021-05-22,Placer,61,380077,23136,22865,1564,24429,292
2021-05-22,Plumas,63,18699,700,683,12,695,4
2021-05-22,Riverside,65,2383286,290939,288580,14806,303386,4442
2021-05-22,Sacramento,67,1510023,105686,105551,1840,107391,1632
2021-05-22,San Benito,69,59416,6058,6071,119,6190,63
2021-05-22,San Bernardino,71,2135413,292466,292292,9211,301503,4747
2021-05-22,San Diego,73,3302833,280087,279614,0,279614,3751
2021-05-22,San Francisco,75,870044,36609,36906,1387,38293,547
2021-05-22,San Joaquin,77,732212,72823,72528,3743,76271,1371
2021-05-22,San Luis Obispo,79,281455,21158,21134,780,21914,256
2021-05-22,San Mateo,81,765935,42279,42218,481,42699,433
2021-05-22,Santa Barbara,83,443738,34391,34313,1342,35655,459
2021-05-22,Santa Clara,85,1922200,117972,119292,804,120096,2030
2021-05-22,Santa Cruz,87,273765,16136,16125,876,17001,207
2021-05-22,Shasta,89,179085,12256,12307,1723,14030,201
2021-05-22,Sierra,91,2930,54,54,14,68,0
2021-05-22,Siskiyou,93,43540,1896,1824,379,2203,17
2021-05-22,Solano,95,438530,32743,32753,558,33311,254
2021-05-22,Sonoma,97,501317,29998,30154,341,30495,321
2021-05-22,Stanislaus,99,539301,55949,56069,6181,62250,974
2021-05-22,Sutter,101,95872,9444,9476,92,9568,113
2021-05-22,Tehama,103,63373,5041,5036,620,5656,63
2021-05-22,Trinity,105,12862,358,328,62,390,3
2021-05-22,Tulare,107,460477,49529,49299,9527,58826,838
2021-05-22,Tuolumne,109,53932,4072,4078,151,4229,65
2021-05-22,Ventura,111,848112,80922,80859,3133,83992,1022
2021-05-22,Yolo,113,214977,13997,13997,332,14329,213
2021-05-22,Yuba,115,75493,6027,6010,128,6138,49
2021-05-21,Alameda,1,1643700,87928,88041,2049,90090,1263
2021-05-21,Alpine,3,1148,88,88,0,88,0
2021-05-21,Amador,5,37829,3671,3672,35,3707,46
2021-05-21,Butte,7,227075,12417,12236,1900,14136,188
2021-05-21,Calaveras,9,45235,2152,2138,15,2153,54
2021-05-21,Colusa,11,21464,1936,1947,318,2265,15
2021-05-21,Contra Costa,13,1133247,69348,68965,1333,70298,810
2021-05-21,Del Norte,15,27424,1386,1376,7,1383,8
2021-05-21,El Dorado,17,186661,10218,10204,769,10973,112
2021-05-21,Fresno,19,978130,101759,102189,9081,111270,1698
2021-05-21,Glenn,21,27897,2417,2408,576,2984,17
2021-05-21,Humboldt,23,135768,4224,4175,82,4257,42
2021-05-21,Imperial,25,180216,28499,28572,2886,31458,732
2021-05-21,Inyo,27,18085,1404,1402,4,1406,36
2021-05-21,Kern,29,883053,96625,96233,11351,107584,1318
2021-05-21,Kings,31,150075,22939,22927,1196,24123,246
2021-05-21,Lake,33,64148,3511,3500,9,3509,43
2021-05-21,Lassen,35,31185,5190,5161,119,5280,6
2021-05-21,Los Angeles,37,10098052,1201188,1197263,43809,1241072,24180
2021-05-21,Madera,39,155013,16502,16500,956,17456,238
2021-05-21,Marin,41,260295,14029,14042,264,14306,227
2021-05-21,Mariposa,43,17540,429,427,12,439,5
2021-05-21,Mendocino,45,87422,3952,3897,70,3967,47
2021-05-21,Merced,47,269075,30976,31076,1002,32078,455
2021-05-21,Modoc,49,8938,372,365,128,493,3
2021-05-21,Mono,51,14174,1248,1269,14,1283,3
2021-05-21,Monterey,53,433212,43006,42995,1934,44929,379
2021-05-21,Napa,55,140530,9897,9913,33,9946,82
2021-05-21,Nevada,57,99092,4792,4779,195,4974,70
2021-05-21,Orange,59,3164182,254359,254171,11725,265896,5042
2021-05-21,Placer,61,380077,23128,22853,1564,24417,292
2021-05-21,Plumas,63,18699,700,683,11,694,4
2021-05-21,Riverside,65,2383286,290912,288499,14799,303298,4442
2021-05-21,Sacramento,67,1510023,105619,105476,1837,107313,1632
2021-05-21,San Benito,69,59416,6058,6068,119,6187,63
2021-05-21,San Bernardino,71,2135413,292437,292205,9208,301413,4744
2021-05-21,San Diego,73,3302833,280016,279554,0,279554,3748
2021-05-21,San Francisco,75,870044,36603,36879,1387,38266,546
2021-05-21,San Joaquin,77,732212,72804,72467,3741,76208,1371
2021-05-21,San Luis Obispo,79,281455,21152,21128,777,21905,256
2021-05-21,San Mateo,81,765935,42266,42163,480,42643,432
2021-05-21,Santa Barbara,83,443738,34386,34302,1342,35644,459
2021-05-21,Santa Clara,85,1922200,117945,119247,804,120051,2029
2021-05-21,Santa Cruz,87,273765,16132,16120,876,16996,207
2021-05-21,Shasta,89,179085,12239,12289,1721,14010,201
2021-05-21,Sierra,91,2930,54,54,14,68,0
2021-05-21,Siskiyou,93,43540,1895,1815,379,2194,16
2021-05-21,Solano,95,438530,32728,32742,558,33300,254
2021-05-21,Sonoma,97,501317,29984,30126,341,30467,321
2021-05-21,Stanislaus,99,539301,55917,56036,6179,62215,975
2021-05-21,Sutter,101,95872,9442,9470,92,9562,113
2021-05-21,Tehama,103,63373,5035,5030,620,5650,63
2021-05-21,Trinity,105,12862,358,329,61,390,3
2021-05-21,Tulare,107,460477,49524,49271,9525,58796,838
2021-05-21,Tuolumne,109,53932,4070,4079,151,4230,65
2021-05-21,Ventura,111,848112,80914,80821,3130,83951,1021
2021-05-21,Yolo,113,214977,13990,13983,332,14315,213
2021-05-21,Yuba,115,75493,6021,6006,128,6134,49
2021-05-20,Alameda,1,1643700,87881,87975,2048,90023,1264
2021-05-20,Alpine,3,1148,88,88,0,88,0
2021-05-20,Amador,5,37829,3670,3671,35,3706,46
2021-05-20,Butte,7,227075,12410,12220,1897,14117,188
2021-05-20,Calaveras,9,45235,2148,2138,15,2153,54
2021-05-20,Colusa,11,21464,1935,1946,316,2262,15
2021-05-20,Contra Costa,13,1133247,69303,68913,1331,70244,809
2021-05-20,Del Norte,15,27424,1386,1373,7,1380,8
2021-05-20,El Dorado,17,186661,10209,10188,769,10957,112
2021-05-20,Fresno,19,978130,101739,102135,9078,111213,1696
2021-05-20,Glenn,21,27897,2414,2406,576,2982,17
2021-05-20,Humboldt,23,135768,4207,4162,82,4244,42
2021-05-20,Imperial,25,180216,28494,28551,2886,31437,732
2021-05-20,Inyo,27,18085,1404,1402,4,1406,36
2021-05-20,Kern,29,883053,96604,96204,11344,107548,1317
2021-05-20,Kings,31,150075,22937,22922,1196,24118,246
2021-05-20,Lake,33,64148,3508,3500,9,3509,43
2021-05-20,Lassen,35,31185,5188,5160,118,5278,6
2021-05-20,Los Angeles,37,10098052,1201033,1197073,43798,1240871,24168
2021-05-20,Madera,39,155013,16496,16499,954,17453,238
2021-05-20,Marin,41,260295,14025,14036,263,14299,227
2021-05-20,Mariposa,43,17540,429,426,12,438,5
2021-05-20,Mendocino,45,87422,3945,3897,70,3967,47
2021-05-20,Merced,47,269075,30963,31046,1001,32047,454
2021-05-20,Modoc,49,8938,372,365,128,493,3
2021-05-20,Mono,51,14174,1247,1269,14,1283,3
2021-05-20,Monterey,53,433212,43000,42984,1933,44917,379
2021-05-20,Napa,55,140530,9894,9913,33,9946,82
2021-05-20,Nevada,57,99092,4791,4775,195,4970,70
2021-05-20,Orange,59,3164182,254318,254127,11722,265849,5038
2021-05-20,Placer,61,380077,23116,22823,1562,24385,292
2021-05-20,Plumas,63,18699,698,682,11,693,4
2021-05-20,Riverside,65,2383286,290867,288453,14794,303247,4442
2021-05-20,Sacramento,67,1510023,105524,105414,1833,107247,1629
2021-05-20,San Benito,69,59416,6057,6067,119,6186,63
2021-05-20,San Bernardino,71,2135413,292391,292153,9207,301360,4728
2021-05-20,San Diego,73,3302833,279928,279490,0,279490,3749
2021-05-20,San Francisco,75,870044,36594,36860,1387,38247,546
2021-05-20,San Joaquin,77,732212,72766,72388,3740,76128,1371
2021-05-20,San Luis Obispo,79,281455,21140,21095,775,21870,256
2021-05-20,San Mateo,81,765935,42252,42152,478,42630,432
2021-05-20,Santa Barbara,83,443738,34382,34293,1342,35635,459
2021-05-20,Santa Clara,85,1922200,117924,119222,804,120026,2029
2021-05-20,Santa Cruz,87,273765,16127,16119,876,16995,207
2021-05-20,Shasta,89,179085,12227,12266,1716,13982,200
2021-05-20,Sierra,91,2930,54,54,14,68,0
2021-05-20,Siskiyou,93,43540,1888,1811,378,2189,16
2021-05-20,Solano,95,438530,32713,32725,558,33283,253
2021-05-20,Sonoma,97,501317,29967,30107,340,30447,321
2021-05-20,Stanislaus,99,539301,55885,55979,6177,62156,970
2021-05-20,Sutter,101,95872,9438,9467,92,9559,113
2021-05-20,Tehama,103,63373,5033,5029,619,5648,63
2021-05-20,Trinity,105,12862,358,329,60,389,3
2021-05-20,Tulare,107,460477,49513,49217,9522,58739,837
2021-05-20,Tuolumne,109,53932,4069,4077,151,4228,65
2021-05-20,Ventura,111,848112,80903,80800,3130,83930,1019
2021-05-20,Yolo,113,214977,13985,13973,332,14305,211
2021-05-20,Yuba,115,75493,6012,6002,128,6130,49
2021-05-19,Alameda,1,1643700,87840,87889,2046,89935,1260
2021-05-19,Alpine,3,1148,88,88,0,88,0
2021-05-19,Amador,5,37829,3670,3669,35,3704,46
2021-05-19,Butte,7,227075,12400,12198,1897,14095,188
2021-05-19,Calaveras,9,45235,2144,2132,15,2147,54
2021-05-19,Colusa,11,21464,1935,1945,314,2259,15
2021-05-19,Contra Costa,13,1133247,69256,68836,1331,70167,808
2021-05-19,Del Norte,15,27424,1384,1371,7,1378,8
2021-05-19,El Dorado,17,186661,10204,10179,768,10947,112
2021-05-19,Fresno,19,978130,101710,102085,9072,111157,1693
2021-05-19,Glenn,21,27897,2414,2404,576,2980,17
2021-05-19,Humboldt,23,135768,4197,4143,80,4223,42
2021-05-19,Imperial,25,180216,28485,28550,2886,31436,732
2021-05-19,Inyo,27,18085,1404,1402,4,1406,36
2021-05-19,Kern,29,883053,96577,96173,11336,107509,1316
2021-05-19,Kings,31,150075,22931,22919,1196,24115,246
2021-05-19,Lake,33,64148,3508,3497,9,3506,43
2021-05-19,Lassen,35,31185,5187,5157,118,5275,6
2021-05-19,Los Angeles,37,10098052,1200842,1196856,43783,1240639,24143
2021-05-19,Madera,39,155013,16493,16496,954,17450,238
2021-05-19,Marin,41,260295,14021,14033,261,14294,227
2021-05-19,Mariposa,43,17540,429,425,12,437,5
2021-05-19,Mendocino,45,87422,3941,3886,70,3956,47
2021-05-19,Merced,47,269075,30947,31044,1001,32045,452
2021-05-19,Modoc,49,8938,372,364,126,490,3
2021-05-19,Mono,51,14174,1247,1266,14,1280,3
2021-05-19,Monterey,53,433212,42995,42973,1932,44905,379
2021-05-19,Napa,55,140530,9891,9906,33,9939,82
2021-05-19,Nevada,57,99092,4789,4769,195,4964,70
2021-05-19,Orange,59,3164182,254283,254087,11713,265800,5035
2021-05-19,Placer,61,380077,23098,22784,1556,24340,291
2021-05-19,Plumas,63,18699,698,682,11,693,4
2021-05-19,Riverside,65,2383286,290822,288398,14792,303190,4442
2021-05-19,Sacramento,67,1510023,105447,105225,1832,107057,1629
2021-05-19,San Benito,69,59416,6056,6064,119,6183,63
2021-05-19,San Bernardino,71,2135413,292345,292078,9204,301282,4725
2021-05-19,San Diego,73,3302833,279844,279345,0,279345,3746
2021-05-19,San Francisco,75,870044,36581,36835,1386,38221,546
2021-05-19,San Joaquin,77,732212,72723,72338,3734,76072,1369
2021-05-19,San Luis Obispo,79,281455,21132,21085,774,21859,256
2021-05-19,San Mateo,81,765935,42245,42126,478,42604,429
2021-05-19,Santa Barbara,83,443738,34374,34292,1342,35634,459
2021-05-19,Santa Clara,85,1922200,117885,119176,803,119979,2015
2021-05-19,Santa Cruz,87,273765,16123,16121,875,16996,207
2021-05-19,Shasta,89,179085,12209,12233,1710,13943,200
2021-05-19,Sierra,91,2930,54,54,14,68,0
2021-05-19,Siskiyou,93,43540,1885,1803,377,2180,16
2021-05-19,Solano,95,438530,32686,32678,556,33234,253
2021-05-19,Sonoma,97,501317,29954,30080,340,30420,321
2021-05-19,Stanislaus,99,539301,55863,55912,6172,62084,967
2021-05-19,Sutter,101,95872,9431,9459,91,9550,113
2021-05-19,Tehama,103,63373,5025,5026,616,5642,63
2021-05-19,Trinity,105,12862,358,329,60,389,3
2021-05-19,Tulare,107,460477,49501,49163,9517,58680,837
2021-05-19,Tuolumne,109,53932,4069,4074,151,4225,64
2021-05-19,Ventura,111,848112,80887,80747,3129,83876,1019
2021-05-19,Yolo,113,214977,13980,13961,331,14292,211
2021-05-19,Yuba,115,75493,6008,5993,128,6121,49
2021-05-18,Alameda,1,1643700,87767,87816,2046,89862,1254
2021-05-18,Alpine,3,1148,88,88,0,88,0
2021-05-18,Amador,5,37829,3670,3669,35,3704,46
2021-05-18,Butte,7,227075,12388,12164,1894,14058,191
2021-05-18,Calaveras,9,45235,2140,2131,15,2146,54
2021-05-18,Colusa,11,21464,1935,1943,314,2257,14
2021-05-18,Contra Costa,13,1133247,69199,68750,1330,70080,808
2021-05-18,Del Norte,15,27424,1381,1371,7,1378,8
2021-05-18,El Dorado,17,186661,10193,10169,767,10936,112
2021-05-18,Fresno,19,978130,101674,102056,9069,111125,1690
2021-05-18,Glenn,21,27897,2408,2403,575,2978,17
2021-05-18,Humboldt,23,135768,4179,4132,79,4211,42
2021-05-18,Imperial,25,180216,28479,28538,2884,31422,730
2021-05-18,Inyo,27,18085,1404,1401,4,1405,36
2021-05-18,Kern,29,883053,96543,96128,11322,107450,1315
2021-05-18,Kings,31,150075,22925,22916,1196,24112,247
2021-05-18,Lake,33,64148,3506,3495,9,3504,43
2021-05-18,Lassen,35,31185,5186,5157,117,5274,6
2021-05-18,Los Angeles,37,10098052,1200665,1196668,43770,1240438,24133
2021-05-18,Madera,39,155013,16486,16491,954,17445,238
2021-05-18,Marin,41,260295,14018,14026,261,14287,227
2021-05-18,Mariposa,43,17540,429,424,12,436,5
2021-05-18,Mendocino,45,87422,3930,3877,70,3947,47
2021-05-18,Merced,47,269075,30929,31036,1001,32037,452
2021-05-18,Modoc,49,8938,371,364,126,490,3
2021-05-18,Mono,51,14174,1246,1265,14,1279,3
2021-05-18,Monterey,53,433212,42989,43001,1932,44933,379
2021-05-18,Napa,55,140530,9891,9905,33,9938,82
2021-05-18,Nevada,57,99092,4782,4762,195,4957,70
2021-05-18,Orange,59,3164182,254242,254041,11703,265744,5031
2021-05-18,Placer,61,380077,23066,22726,1552,24278,291
2021-05-18,Plumas,63,18699,698,682,11,693,4
2021-05-18,Riverside,65,2383286,290770,288354,14785,303139,4438
2021-05-18,Sacramento,67,1510023,105349,105083,1830,106913,1629
2021-05-18,San Benito,69,59416,6055,6065,119,6184,63
2021-05-18,San Bernardino,71,2135413,292296,292014,9199,301213,4722
2021-05-18,San Diego,73,3302833,279737,279254,0,279254,3742
2021-05-18,San Francisco,75,870044,36561,36818,1386,38204,546
2021-05-18,San Joaquin,77,732212,72677,72282,3730,76012,1368
2021-05-18,San Luis Obispo,79,281455,21122,21080,772,21852,256
2021-05-18,San Mateo,81,765935,42234,42099,477,42576,428
2021-05-18,Santa Barbara,83,443738,34365,34278,1342,35620,459
2021-05-18,Santa Clara,85,1922200,117858,119171,802,119973,2014
2021-05-18,Santa Cruz,87,273765,16115,16137,875,17012,207
2021-05-18,Shasta,89,179085,12191,12197,1704,13901,200
2021-05-18,Sierra,91,2930,54,54,14,68,0
2021-05-18,Siskiyou,93,43540,1884,1799,377,2176,16
2021-05-18,Solano,95,438530,32661,32644,556,33200,253
2021-05-18,Sonoma,97,501317,29933,30054,339,30393,321
2021-05-18,Stanislaus,99,539301,55825,55860,6172,62032,959
2021-05-18,Sutter,101,95872,9423,9453,91,9544,113
2021-05-18,Tehama,103,63373,5021,5020,613,5633,63
2021-05-18,Trinity,105,12862,358,329,59,388,3
2021-05-18,Tulare,107,460477,49493,49142,9512,58654,836
2021-05-18,Tuolumne,109,53932,4067,4073,151,4224,64
2021-05-18,Ventura,111,848112,80872,80726,3126,83852,1017
2021-05-18,Yolo,113,214977,13973,13951,330,14281,211
2021-05-18,Yuba,115,75493,6004,5989,127,6116,49
2021-05-17,Alameda,1,1643700,87714,87766,2043,89809,1253
2021-05-17,Alpine,3,1148,88,88,0,88,0
2021-05-17,Amador,5,37829,3667,3668,35,3703,46
2021-05-17,Butte,7,227075,12380,12144,1894,14038,192
2021-05-17,Calaveras,9,45235,2140,2131,15,2146,53
2021-05-17,Colusa,11,21464,1935,1943,314,2257,14
2021-05-17,Contra Costa,13,1133247,69144,68720,1329,70049,805
2021-05-17,Del Norte,15,27424,1376,1369,7,1376,8
2021-05-17,El Dorado,17,186661,10176,10163,767,10930,112
2021-05-17,Fresno,19,978130,101631,102013,9059,111072,1690
2021-05-17,Glenn,21,27897,2408,2401,575,2976,17
2021-05-17,Humboldt,23,135768,4168,4112,77,4189,42
2021-05-17,Imperial,25,180216,28474,28533,2882,31415,729
2021-05-17,Inyo,27,18085,1404,1401,4,1405,36
2021-05-17,Kern,29,883053,96514,96095,11305,107400,1315
2021-05-17,Kings,31,150075,22922,22918,1196,24114,246
2021-05-17,Lake,33,64148,3501,3489,9,3498,43
2021-05-17,Lassen,35,31185,5183,5156,116,5272,6
2021-05-17,Los Angeles,37,10098052,1200494,1196556,43763,1240319,24123
2021-05-17,Madera,39,155013,16483,16486,954,17440,238
2021-05-17,Marin,41,260295,14012,14021,261,14282,227
2021-05-17,Mariposa,43,17540,428,423,12,435,5
2021-05-17,Mendocino,45,87422,3921,3868,70,3938,46
2021-05-17,Merced,47,269075,30913,31031,1001,32032,450
2021-05-17,Modoc,49,8938,370,362,126,488,3
2021-05-17,Mono,51,14174,1242,1265,14,1279,3
2021-05-17,Monterey,53,433212,42982,42995,1932,44927,379
2021-05-17,Napa,55,140530,9890,9894,33,9927,82
2021-05-17,Nevada,57,99092,4778,4761,194,4955,70
2021-05-17,Orange,59,3164182,254197,253993,11696,265689,5031
2021-05-17,Placer,61,380077,23041,22706,1545,24251,289
2021-05-17,Plumas,63,18699,698,682,11,693,4
2021-05-17,Riverside,65,2383286,290705,288304,14781,303085,4433
2021-05-17,Sacramento,67,1510023,105243,105035,1828,106863,1629
2021-05-17,San Benito,69,59416,6052,6067,119,6186,63
2021-05-17,San Bernardino,71,2135413,292249,291989,9192,301181,4724
2021-05-17,San Diego,73,3302833,279605,279146,0,279146,3742
2021-05-17,San Francisco,75,870044,36549,36816,1384,38200,546
2021-05-17,San Joaquin,77,732212,72639,72234,3727,75961,1359
2021-05-17,San Luis Obispo,79,281455,21113,21079,770,21849,256
2021-05-17,San Mateo,81,765935,42206,42083,477,42560,428
2021-05-17,Santa Barbara,83,443738,34358,34275,1342,35617,459
2021-05-17,Santa Clara,85,1922200,117821,119116,800,119916,2015
2021-05-17,Santa Cruz,87,273765,16112,16151,875,17026,206
2021-05-17,Shasta,89,179085,12169,12163,1701,13864,200
2021-05-17,Sierra,91,2930,54,54,14,68,0
2021-05-17,Siskiyou,93,43540,1875,1795,374,2169,15
2021-05-17,Solano,95,438530,32643,32627,556,33183,253
2021-05-17,Sonoma,97,501317,29911,30043,339,30382,321
2021-05-17,Stanislaus,99,539301,55774,55839,6165,62004,951
2021-05-17,Sutter,101,95872,9416,9447,91,9538,113
2021-05-17,Tehama,103,63373,5018,5016,612,5628,63
2021-05-17,Trinity,105,12862,358,328,59,387,3
2021-05-17,Tulare,107,460477,49471,49107,9505,58612,836
2021-05-17,Tuolumne,109,53932,4067,4071,150,4221,64
2021-05-17,Ventura,111,848112,80852,80699,3126,83825,1017
2021-05-17,Yolo,113,214977,13967,13941,330,14271,211
2021-05-17,Yuba,115,75493,5996,5987,127,6114,49
2021-05-16,Alameda,1,1643700,87648,87743,2043,89786,1253
2021-05-16,Alpine,3,1148,88,88,0,88,0
2021-05-16,Amador,5,37829,3666,3667,35,3702,46
2021-05-16,Butte,7,227075,12366,12140,1894,14034,192
2021-05-16,Calaveras,9,45235,2138,2129,15,2144,53
2021-05-16,Colusa,11,21464,1933,1943,314,2257,14
2021-05-16,Contra Costa,13,1133247,69076,68694,1326,70020,805
2021-05-16,Del Norte,15,27424,1373,1365,7,1372,8
2021-05-16,El Dorado,17,186661,10160,10159,766,10925,112
2021-05-16,Fresno,19,978130,101587,101987,9054,111041,1690
2021-05-16,Glenn,21,27897,2408,2401,574,2975,17
2021-05-16,Humboldt,23,135768,4154,4104,76,4180,42
2021-05-16,Imperial,25,180216,28462,28516,2882,31398,729
2021-05-16,Inyo,27,18085,1404,1401,4,1405,36
2021-05-16,Kern,29,883053,96481,96083,11284,107367,1315
2021-05-16,Kings,31,150075,22918,22918,1193,24111,246
2021-05-16,Lake,33,64148,3498,3489,9,3498,43
2021-05-16,Lassen,35,31185,5182,5156,116,5272,6
2021-05-16,Los Angeles,37,10098052,1200276,1196397,43746,1240143,24120
2021-05-16,Madera,39,155013,16479,16483,951,17434,238
2021-05-16,Marin,41,260295,14009,14015,261,14276,227
2021-05-16,Mariposa,43,17540,428,423,12,435,5
2021-05-16,Mendocino,45,87422,3911,3863,70,3933,46
2021-05-16,Merced,47,269075,30890,31023,1001,32024,450
2021-05-16,Modoc,49,8938,370,362,126,488,3
2021-05-16,Mono,51,14174,1242,1265,14,1279,3
2021-05-16,Monterey,53,433212,42977,42991,1932,44923,379
2021-05-16,Napa,55,140530,9887,9891,33,9924,82
2021-05-16,Nevada,57,99092,4774,4755,194,4949,70
2021-05-16,Orange,59,3164182,254165,253962,11693,265655,5031
2021-05-16,Placer,61,380077,23009,22696,1539,24235,289
2021-05-16,Plumas,63,18699,697,682,11,693,4
2021-05-16,Riverside,65,2383286,290634,288259,14771,303030,4433
2021-05-16,Sacramento,67,1510023,105128,105013,1826,106839,1628
2021-05-16,San Benito,69,59416,6051,6067,118,6185,63
2021-05-16,San Bernardino,71,2135413,292171,291940,9189,301129,4724
2021-05-16,San Diego,73,3302833,279487,279099,0,279099,3742
2021-05-16,San Francisco,75,870044,36528,36808,1383,38191,546
2021-05-16,San Joaquin,77,732212,72591,72218,3722,75940,1359
2021-05-16,San Luis Obispo,79,281455,21106,21072,769,21841,256
2021-05-16,San Mateo,81,765935,42194,42063,476,42539,428
2021-05-16,Santa Barbara,83,443738,34351,34270,1342,35612,459
2021-05-16,Santa Clara,85,1922200,117792,119098,799,119897,2015
2021-05-16,Santa Cruz,87,273765,16110,16143,875,17018,206
2021-05-16,Shasta,89,179085,12153,12156,1694,13850,200
2021-05-16,Sierra,91,2930,54,54,14,68,0
2021-05-16,Siskiyou,93,43540,1871,1790,373,2163,15
2021-05-16,Solano,95,438530,32609,32619,554,33173,253
2021-05-16,Sonoma,97,501317,29892,30033,339,30372,321
2021-05-16,Stanislaus,99,539301,55719,55814,6153,61967,951
2021-05-16,Sutter,101,95872,9409,9445,91,9536,113
2021-05-16,Tehama,103,63373,5014,5013,610,5623,63
2021-05-16,Trinity,105,12862,358,328,59,387,3
2021-05-16,Tulare,107,460477,49455,49091,9501,58592,837
2021-05-16,Tuolumne,109,53932,4063,4070,150,4220,64
2021-05-16,Ventura,111,848112,80821,80689,3126,83815,1017
2021-05-16,Yolo,113,214977,13952,13938,330,14268,211
2021-05-16,Yuba,115,75493,5993,5987,127,6114,49
2021-05-15,Alameda,1,1643700,87622,87677,2042,89719,1252
2021-05-15,Alpine,3,1148,88,88,0,88,0
2021-05-15,Amador,5,37829,3666,3666,35,3701,46
2021-05-15,Butte,7,227075,12359,12095,1893,13988,192
2021-05-15,Calaveras,9,45235,2137,2126,15,2141,53
2021-05-15,Colusa,11,21464,1933,1941,312,2253,14
2021-05-15,Contra Costa,13,1133247,69030,68658,1326,69984,805
2021-05-15,Del Norte,15,27424,1368,1359,7,1366,8
2021-05-15,El Dorado,17,186661,10148,10156,765,10921,112
2021-05-15,Fresno,19,978130,101551,101957,9051,111008,1690
2021-05-15,Glenn,21,27897,2408,2400,574,2974,17
2021-05-15,Humboldt,23,135768,4144,4080,76,4156,42
2021-05-15,Imperial,25,180216,28459,28504,2881,31385,729
2021-05-15,Inyo,27,18085,1404,1402,4,1406,36
2021-05-15,Kern,29,883053,96468,96061,11267,107328,1315
2021-05-15,Kings,31,150075,22917,22913,1193,24106,246
2021-05-15,Lake,33,64148,3497,3485,9,3494,43
2021-05-15,Lassen,35,31185,5178,5156,115,5271,6
2021-05-15,Los Angeles,37,10098052,1200155,1196255,43732,1239987,24115
2021-05-15,Madera,39,155013,16476,16482,951,17433,238
2021-05-15,Marin,41,260295,14005,14012,261,14273,227
2021-05-15,Mariposa,43,17540,428,423,12,435,5
2021-05-15,Mendocino,45,87422,3908,3861,70,3931,46
2021-05-15,Merced,47,269075,30869,31012,1001,32013,450
2021-05-15,Modoc,49,8938,370,362,126,488,3
2021-05-15,Mono,51,14174,1242,1265,14,1279,3
2021-05-15,Monterey,53,433212,42973,42982,1932,44914,379
2021-05-15,Napa,55,140530,9884,9887,33,9920,82
2021-05-15,Nevada,57,99092,4773,4755,194,4949,70
2021-05-15,Orange,59,3164182,254139,253919,11686,265605,5030
2021-05-15,Placer,61,380077,22988,22688,1539,24227,289
2021-05-15,Plumas,63,18699,697,681,11,692,4
2021-05-15,Riverside,65,2383286,290592,288203,14766,302969,4433
2021-05-15,Sacramento,67,1510023,105055,104929,1823,106752,1628
2021-05-15,San Benito,69,59416,6051,6066,118,6184,63
2021-05-15,San Bernardino,71,2135413,292131,291892,9187,301079,4724
2021-05-15,San Diego,73,3302833,279416,278991,0,278991,3737
2021-05-15,San Francisco,75,870044,36512,36795,1381,38176,546
2021-05-15,San Joaquin,77,732212,72565,72197,3720,75917,1359
2021-05-15,San Luis Obispo,79,281455,21103,21061,768,21829,256
2021-05-15,San Mateo,81,765935,42178,42059,476,42535,428
2021-05-15,Santa Barbara,83,443738,34344,34259,1342,35601,459
2021-05-15,Santa Clara,85,1922200,117772,119060,799,119859,2016
2021-05-15,Santa Cruz,87,273765,16106,16137,875,17012,206
2021-05-15,Shasta,89,179085,12141,12152,1691,13843,200
2021-05-15,Sierra,91,2930,54,54,14,68,0
2021-05-15,Siskiyou,93,43540,1865,1788,371,2159,15
2021-05-15,Solano,95,438530,32599,32604,553,33157,253
2021-05-15,Sonoma,97,501317,29873,30020,339,30359,321
2021-05-15,Stanislaus,99,539301,55687,55795,6146,61941,952
2021-05-15,Sutter,101,95872,9407,9436,91,9527,113
2021-05-15,Tehama,103,63373,5010,5012,608,5620,63
2021-05-15,Trinity,105,12862,358,328,59,387,3
2021-05-15,Tulare,107,460477,49446,49080,9496,58576,837
2021-05-15,Tuolumne,109,53932,4061,4064,150,4214,63
2021-05-15,Ventura,111,848112,80810,80662,3126,83788,1017
2021-05-15,Yolo,113,214977,13945,13932,329,14261,211
2021-05-15,Yuba,115,75493,5990,5979,127,6106,49
2021-05-14,Alameda,1,1643700,87587,87621,2040,89661,1249
2021-05-14,Alpine,3,1148,88,88,0,88,0
2021-05-14,Amador,5,37829,3666,3665,35,3700,46
2021-05-14,Butte,7,227075,12350,12076,1890,13966,192
2021-05-14,Calaveras,9,45235,2133,2121,15,2136,53
2021-05-14,Colusa,11,21464,1932,1940,311,2251,14
2021-05-14,Contra Costa,13,1133247,68988,68589,1324,69913,806
2021-05-14,Del Norte,15,27424,1368,1355,7,1362,8
2021-05-14,El Dorado,17,186661,10141,10143,764,10907,113
2021-05-14,Fresno,19,978130,101522,101917,9045,110962,1688
2021-05-14,Glenn,21,27897,2407,2398,574,2972,17
2021-05-14,Humboldt,23,135768,4136,4050,76,4126,37
2021-05-14,Imperial,25,180216,28452,28485,2880,31365,728
2021-05-14,Inyo,27,18085,1404,1400,4,1404,36
2021-05-14,Kern,29,883053,96438,96033,11258,107291,1311
2021-05-14,Kings,31,150075,22916,22910,1193,24103,246
2021-05-14,Lake,33,64148,3493,3483,9,3492,43
2021-05-14,Lassen,35,31185,5178,5154,115,5269,6
2021-05-14,Los Angeles,37,10098052,1200023,1196038,43727,1239765,24101
2021-05-14,Madera,39,155013,16473,16474,951,17425,238
2021-05-14,Marin,41,260295,14001,14010,261,14271,227
2021-05-14,Mariposa,43,17540,428,422,12,434,5
2021-05-14,Mendocino,45,87422,3906,3855,70,3925,46
2021-05-14,Merced,47,269075,30859,31010,1001,32011,450
2021-05-14,Modoc,49,8938,370,362,126,488,3
2021-05-14,Mono,51,14174,1241,1265,14,1279,3
2021-05-14,Monterey,53,433212,42968,42973,1932,44905,380
2021-05-14,Napa,55,140530,9881,9883,33,9916,82
2021-05-14,Nevada,57,99092,4768,4745,194,4939,70
2021-05-14,Orange,59,3164182,254106,253855,11679,265534,5028
2021-05-14,Placer,61,380077,22969,22660,1533,24193,287
2021-05-14,Plumas,63,18699,696,680,11,691,4
2021-05-14,Riverside,65,2383286,290541,288140,14763,302903,4433
2021-05-14,Sacramento,67,1510023,104967,104828,1822,106650,1627
2021-05-14,San Benito,69,59416,6051,6064,118,6182,63
2021-05-14,San Bernardino,71,2135413,292082,291834,9187,301021,4721
2021-05-14,San Diego,73,3302833,279344,278853,0,278853,3732
2021-05-14,San Francisco,75,870044,36503,36771,1377,38148,545
2021-05-14,San Joaquin,77,732212,72532,72160,3713,75873,1359
2021-05-14,San Luis Obispo,79,281455,21100,21051,767,21818,256
2021-05-14,San Mateo,81,765935,42167,42041,476,42517,428
2021-05-14,Santa Barbara,83,443738,34334,34243,1342,35585,456
2021-05-14,Santa Clara,85,1922200,117743,119006,799,119805,2014
2021-05-14,Santa Cruz,87,273765,16101,16130,875,17005,207
2021-05-14,Shasta,89,179085,12135,12130,1686,13816,200
2021-05-14,Sierra,91,2930,54,54,14,68,0
2021-05-14,Siskiyou,93,43540,1858,1779,370,2149,14
2021-05-14,Solano,95,438530,32579,32585,552,33137,252
2021-05-14,Sonoma,97,501317,29854,30007,339,30346,321
2021-05-14,Stanislaus,99,539301,55651,55752,6140,61892,950
2021-05-14,Sutter,101,95872,9398,9433,89,9522,113
2021-05-14,Tehama,103,63373,5003,5005,608,5613,63
2021-05-14,Trinity,105,12862,358,328,59,387,3
2021-05-14,Tulare,107,460477,49431,49060,9489,58549,836
2021-05-14,Tuolumne,109,53932,4061,4060,150,4210,63
2021-05-14,Ventura,111,848112,80796,80628,3126,83754,1014
2021-05-14,Yolo,113,214977,13940,13922,325,14247,210
2021-05-14,Yuba,115,75493,5986,5970,127,6097,47
2021-05-13,Alameda,1,1643700,87542,87557,2039,89596,1250
2021-05-13,Alpine,3,1148,88,88,0,88,0
2021-05-13,Amador,5,37829,3666,3662,35,3697,46
2021-05-13,Butte,7,227075,12336,12051,1889,13940,196
2021-05-13,Calaveras,9,45235,2133,2120,15,2135,53
2021-05-13,Colusa,11,21464,1931,1939,307,2246,14
2021-05-13,Contra Costa,13,1133247,68940,68522,1323,69845,806
2021-05-13,Del Norte,15,27424,1366,1354,7,1361,8
2021-05-13,El Dorado,17,186661,10139,10133,764,10897,112
2021-05-13,Fresno,19,978130,101493,101862,9043,110905,1687
2021-05-13,Glenn,21,27897,2406,2395,574,2969,17
2021-05-13,Humboldt,23,135768,4118,4027,76,4103,37
2021-05-13,Imperial,25,180216,28437,28468,2878,31346,729
2021-05-13,Inyo,27,18085,1404,1400,4,1404,36
2021-05-13,Kern,29,883053,96415,95996,11239,107235,1311
2021-05-13,Kings,31,150075,22915,22904,1193,24097,246
2021-05-13,Lake,33,64148,3492,3479,9,3488,43
2021-05-13,Lassen,35,31185,5178,5152,114,5266,6
2021-05-13,Los Angeles,37,10098052,1199834,1195504,43713,1239217,24083
2021-05-13,Madera,39,155013,16467,16467,951,17418,238
2021-05-13,Marin,41,260295,13996,14004,259,14263,227
2021-05-13,Mariposa,43,17540,428,422,12,434,5
2021-05-13,Mendocino,45,87422,3902,3846,70,3916,46
2021-05-13,Merced,47,269075,30851,30989,1001,31990,450
2021-05-13,Modoc,49,8938,370,362,126,488,3
2021-05-13,Mono,51,14174,1241,1265,14,1279,3
2021-05-13,Monterey,53,433212,42954,42966,1931,44897,380
2021-05-13,Napa,55,140530,9874,9877,33,9910,82
2021-05-13,Nevada,57,99092,4764,4743,193,4936,70
2021-05-13,Orange,59,3164182,254065,253778,11677,265455,5026
2021-05-13,Placer,61,380077,22944,22668,1526,24194,288
2021-05-13,Plumas,63,18699,696,680,11,691,4
2021-05-13,Riverside,65,2383286,290481,288067,14761,302828,4433
2021-05-13,Sacramento,67,1510023,104882,104711,1819,106530,1626
2021-05-13,San Benito,69,59416,6049,6062,118,6180,63
2021-05-13,San Bernardino,71,2135413,292020,291765,9187,300952,4722
2021-05-13,San Diego,73,3302833,279231,278592,0,278592,3729
2021-05-13,San Francisco,75,870044,36479,36741,1375,38116,544
2021-05-13,San Joaquin,77,732212,72491,72096,3709,75805,1357
2021-05-13,San Luis Obispo,79,281455,21085,21043,766,21809,255
2021-05-13,San Mateo,81,765935,42148,42059,476,42535,426
2021-05-13,Santa Barbara,83,443738,34322,34242,1342,35584,456
2021-05-13,Santa Clara,85,1922200,117717,118952,799,119751,2013
2021-05-13,Santa Cruz,87,273765,16095,16129,875,17004,208
2021-05-13,Shasta,89,179085,12115,12111,1680,13791,200
2021-05-13,Sierra,91,2930,54,54,14,68,0
2021-05-13,Siskiyou,93,43540,1851,1769,367,2136,14
2021-05-13,Solano,95,438530,32566,32548,550,33098,252
2021-05-13,Sonoma,97,501317,29829,29991,339,30330,321
2021-05-13,Stanislaus,99,539301,55614,55678,6134,61812,949
2021-05-13,Sutter,101,95872,9394,9431,87,9518,112
2021-05-13,Tehama,103,63373,4998,4997,608,5605,63
2021-05-13,Trinity,105,12862,358,327,58,385,3
2021-05-13,Tulare,107,460477,49406,49032,9480,58512,837
2021-05-13,Tuolumne,109,53932,4060,4059,150,4209,63
2021-05-13,Ventura,111,848112,80766,80615,3124,83739,1012
2021-05-13,Yolo,113,214977,13931,13914,323,14237,210
2021-05-13,Yuba,115,75493,5977,5962,127,6089,47
2021-05-12,Alameda,1,1643700,87508,87482,2037,89519,1261
2021-05-12,Alpine,3,1148,88,88,0,88,0
2021-05-12,Amador,5,37829,3666,3658,35,3693,46
2021-05-12,Butte,7,227075,12326,12026,1889,13915,199
2021-05-12,Calaveras,9,45235,2130,2119,15,2134,53
2021-05-12,Colusa,11,21464,1929,1939,306,2245,14
2021-05-12,Contra Costa,13,1133247,68881,68462,1317,69779,805
2021-05-12,Del Norte,15,27424,1364,1352,7,1359,8
2021-05-12,El Dorado,17,186661,10130,10123,764,10887,112
2021-05-12,Fresno,19,978130,101446,101838,9029,110867,1688
2021-05-12,Glenn,21,27897,2403,2391,574,2965,17
2021-05-12,Humboldt,23,135768,4090,3982,73,4055,37
2021-05-12,Imperial,25,180216,28419,28443,2875,31318,726
2021-05-12,Inyo,27,18085,1404,1400,4,1404,36
2021-05-12,Kern,29,883053,96380,95955,11231,107186,1310
2021-05-12,Kings,31,150075,22913,22896,1193,24089,246
2021-05-12,Lake,33,64148,3490,3476,9,3485,43
2021-05-12,Lassen,35,31185,5176,5151,114,5265,6
2021-05-12,Los Angeles,37,10098052,1199656,1195318,43696,1239014,24067
2021-05-12,Madera,39,155013,16463,16462,950,17412,238
2021-05-12,Marin,41,260295,13991,13997,259,14256,227
2021-05-12,Mariposa,43,17540,428,422,12,434,5
2021-05-12,Mendocino,45,87422,3892,3836,70,3906,46
2021-05-12,Merced,47,269075,30835,30941,1001,31942,450
2021-05-12,Modoc,49,8938,369,362,126,488,3
2021-05-12,Mono,51,14174,1241,1265,14,1279,3
2021-05-12,Monterey,53,433212,42942,42950,1930,44880,380
2021-05-12,Napa,55,140530,9868,9870,33,9903,82
2021-05-12,Nevada,57,99092,4760,4738,193,4931,70
2021-05-12,Orange,59,3164182,254015,253587,11672,265259,5024
2021-05-12,Placer,61,380077,22926,22652,1518,24170,288
2021-05-12,Plumas,63,18699,696,681,11,692,4
2021-05-12,Riverside,65,2383286,290411,287830,14756,302586,4431
2021-05-12,Sacramento,67,1510023,104786,104592,1818,106410,1621
2021-05-12,San Benito,69,59416,6049,6062,118,6180,63
2021-05-12,San Bernardino,71,2135413,291976,291505,9182,300687,4715
2021-05-12,San Diego,73,3302833,279127,278402,0,278402,3729
2021-05-12,San Francisco,75,870044,36460,36720,1374,38094,544
2021-05-12,San Joaquin,77,732212,72437,72043,3705,75748,1356
2021-05-12,San Luis Obispo,79,281455,21075,21021,766,21787,255
2021-05-12,San Mateo,81,765935,42139,42038,474,42512,426
2021-05-12,Santa Barbara,83,443738,34315,34218,1341,35559,456
2021-05-12,Santa Clara,85,1922200,117674,118897,799,119696,2005
2021-05-12,Santa Cruz,87,273765,16089,16123,875,16998,207
2021-05-12,Shasta,89,179085,12095,12092,1675,13767,200
2021-05-12,Sierra,91,2930,54,54,14,68,0
2021-05-12,Siskiyou,93,43540,1847,1760,365,2125,13
2021-05-12,Solano,95,438530,32542,32519,550,33069,252
2021-05-12,Sonoma,97,501317,29817,29976,339,30315,320
2021-05-12,Stanislaus,99,539301,55575,55632,6125,61757,919
2021-05-12,Sutter,101,95872,9391,9427,87,9514,112
2021-05-12,Tehama,103,63373,4994,4989,608,5597,62
2021-05-12,Trinity,105,12862,358,327,58,385,3
2021-05-12,Tulare,107,460477,49390,49001,9472,58473,838
2021-05-12,Tuolumne,109,53932,4059,4056,150,4206,63
2021-05-12,Ventura,111,848112,80747,80577,3124,83701,1010
2021-05-12,Yolo,113,214977,13924,13910,322,14232,210
2021-05-12,Yuba,115,75493,5974,5956,127,6083,47
2021-05-11,Alameda,1,1643700,87444,87413,2033,89446,1290
2021-05-11,Alpine,3,1148,88,88,0,88,0
2021-05-11,Amador,5,37829,3664,3657,35,3692,46
2021-05-11,Butte,7,227075,12311,12008,1886,13894,199
2021-05-11,Calaveras,9,45235,2130,2118,15,2133,52
2021-05-11,Colusa,11,21464,1928,1939,306,2245,14
2021-05-11,Contra Costa,13,1133247,68821,68406,1316,69722,806
2021-05-11,Del Norte,15,27424,1362,1347,7,1354,8
2021-05-11,El Dorado,17,186661,10124,10108,763,10871,112
2021-05-11,Fresno,19,978130,101402,101792,9021,110813,1686
2021-05-11,Glenn,21,27897,2402,2387,573,2960,17
2021-05-11,Humboldt,23,135768,4069,3964,71,4035,37
2021-05-11,Imperial,25,180216,28411,28413,2871,31284,722
2021-05-11,Inyo,27,18085,1403,1402,4,1406,36
2021-05-11,Kern,29,883053,96354,95938,11217,107155,1310
2021-05-11,Kings,31,150075,22905,22887,1193,24080,246
2021-05-11,Lake,33,64148,3490,3473,9,3482,43
2021-05-11,Lassen,35,31185,5174,5148,114,5262,6
2021-05-11,Los Angeles,37,10098052,1199423,1195100,43683,1238783,24048
2021-05-11,Madera,39,155013,16460,16459,950,17409,238
2021-05-11,Marin,41,260295,13984,13987,259,14246,227
2021-05-11,Mariposa,43,17540,428,421,12,433,5
2021-05-11,Mendocino,45,87422,3884,3821,70,3891,46
2021-05-11,Merced,47,269075,30826,30893,1001,31894,449
2021-05-11,Modoc,49,8938,369,362,125,487,3
2021-05-11,Mono,51,14174,1241,1265,14,1279,3
2021-05-11,Monterey,53,433212,42934,42934,1929,44863,380
2021-05-11,Napa,55,140530,9861,9870,33,9903,81
2021-05-11,Nevada,57,99092,4756,4737,193,4930,70
2021-05-11,Orange,59,3164182,253955,253545,11664,265209,5017
2021-05-11,Placer,61,380077,22905,22615,1514,24129,287
2021-05-11,Plumas,63,18699,694,679,11,690,4
2021-05-11,Riverside,65,2383286,290352,287757,14750,302507,4429
2021-05-11,Sacramento,67,1510023,104689,104496,1815,106311,1616
2021-05-11,San Benito,69,59416,6046,6058,118,6176,63
2021-05-11,San Bernardino,71,2135413,291915,291421,9180,300601,4707
2021-05-11,San Diego,73,3302833,278992,278308,0,278308,3725
2021-05-11,San Francisco,75,870044,36440,36707,1374,38081,543
2021-05-11,San Joaquin,77,732212,72390,71999,3701,75700,1356
2021-05-11,San Luis Obispo,79,281455,21068,21008,764,21772,255
2021-05-11,San Mateo,81,765935,42120,41985,473,42458,425
2021-05-11,Santa Barbara,83,443738,34306,34207,1341,35548,456
2021-05-11,Santa Clara,85,1922200,117628,118857,798,119655,2005
2021-05-11,Santa Cruz,87,273765,16085,16113,875,16988,206
2021-05-11,Shasta,89,179085,12072,12050,1667,13717,200
2021-05-11,Sierra,91,2930,54,54,14,68,0
2021-05-11,Siskiyou,93,43540,1838,1756,362,2118,13
2021-05-11,Solano,95,438530,32525,32499,548,33047,250
2021-05-11,Sonoma,97,501317,29801,29966,339,30305,318
2021-05-11,Stanislaus,99,539301,55527,55589,6121,61710,909
2021-05-11,Sutter,101,95872,9384,9417,87,9504,112
2021-05-11,Tehama,103,63373,4990,4985,607,5592,62
2021-05-11,Trinity,105,12862,358,327,58,385,3
2021-05-11,Tulare,107,460477,49364,48974,9457,58431,837
2021-05-11,Tuolumne,109,53932,4058,4056,150,4206,63
2021-05-11,Ventura,111,848112,80723,80544,3121,83665,1008
2021-05-11,Yolo,113,214977,13911,13902,319,14221,210
2021-05-11,Yuba,115,75493,5965,5950,127,6077,46
2021-05-10,Alameda,1,1643700,87372,87366,2032,89398,1284
2021-05-10,Alpine,3,1148,88,88,0,88,0
2021-05-10,Amador,5,37829,3663,3657,35,3692,46
2021-05-10,Butte,7,227075,12296,11993,1880,13873,199
2021-05-10,Calaveras,9,45235,2124,2118,15,2133,52
2021-05-10,Colusa,11,21464,1928,1939,306,2245,14
2021-05-10,Contra Costa,13,1133247,68758,68357,1316,69673,806
2021-05-10,Del Norte,15,27424,1359,1339,7,1346,8
2021-05-10,El Dorado,17,186661,10110,10093,763,10856,113
2021-05-10,Fresno,19,978130,101371,101755,9013,110768,1682
2021-05-10,Glenn,21,27897,2401,2384,571,2955,17
2021-05-10,Humboldt,23,135768,4039,3961,64,4025,36
2021-05-10,Imperial,25,180216,28397,28397,2868,31265,722
2021-05-10,Inyo,27,18085,1403,1401,4,1405,36
2021-05-10,Kern,29,883053,96312,95920,11203,107123,1310
2021-05-10,Kings,31,150075,22894,22884,1192,24076,246
2021-05-10,Lake,33,64148,3482,3471,9,3480,43
2021-05-10,Lassen,35,31185,5171,5148,113,5261,5
2021-05-10,Los Angeles,37,10098052,1199168,1194976,43665,1238641,24030
2021-05-10,Madera,39,155013,16450,16450,950,17400,238
2021-05-10,Marin,41,260295,13981,13981,259,14240,228
2021-05-10,Mariposa,43,17540,427,420,12,432,5
2021-05-10,Mendocino,45,87422,3878,3818,70,3888,46
2021-05-10,Merced,47,269075,30816,30880,1001,31881,448
2021-05-10,Modoc,49,8938,369,361,125,486,3
2021-05-10,Mono,51,14174,1241,1265,14,1279,3
2021-05-10,Monterey,53,433212,42928,42927,1924,44851,380
2021-05-10,Napa,55,140530,9859,9860,33,9893,81
2021-05-10,Nevada,57,99092,4749,4735,193,4928,70
2021-05-10,Orange,59,3164182,253905,253484,11658,265142,5008
2021-05-10,Placer,61,380077,22884,22590,1511,24101,286
2021-05-10,Plumas,63,18699,693,679,11,690,4
2021-05-10,Riverside,65,2383286,290287,287689,14744,302433,4427
2021-05-10,Sacramento,67,1510023,104576,104378,1809,106187,1613
2021-05-10,San Benito,69,59416,6045,6058,118,6176,63
2021-05-10,San Bernardino,71,2135413,291864,291360,9179,300539,4707
2021-05-10,San Diego,73,3302833,278827,278183,0,278183,3725
2021-05-10,San Francisco,75,870044,36421,36683,1374,38057,543
2021-05-10,San Joaquin,77,732212,72353,71954,3686,75640,1356
2021-05-10,San Luis Obispo,79,281455,21050,20993,763,21756,256
2021-05-10,San Mateo,81,765935,42102,41926,473,42399,424
2021-05-10,Santa Barbara,83,443738,34299,34201,1341,35542,456
2021-05-10,Santa Clara,85,1922200,117570,118822,797,119619,2003
2021-05-10,Santa Cruz,87,273765,16079,16114,875,16989,206
2021-05-10,Shasta,89,179085,12058,12036,1663,13699,200
2021-05-10,Sierra,91,2930,54,54,14,68,0
2021-05-10,Siskiyou,93,43540,1828,1752,360,2112,13
2021-05-10,Solano,95,438530,32505,32466,546,33012,250
2021-05-10,Sonoma,97,501317,29787,29955,338,30293,318
2021-05-10,Stanislaus,99,539301,55452,55541,6115,61656,898
2021-05-10,Sutter,101,95872,9378,9412,87,9499,111
2021-05-10,Tehama,103,63373,4986,4980,607,5587,62
2021-05-10,Trinity,105,12862,358,327,56,383,3
2021-05-10,Tulare,107,460477,49340,48956,9451,58407,837
2021-05-10,Tuolumne,109,53932,4054,4054,146,4200,63
2021-05-10,Ventura,111,848112,80707,80501,3119,83620,1008
2021-05-10,Yolo,113,214977,13898,13898,317,14215,209
2021-05-10,Yuba,115,75493,5963,5942,127,6069,46
2021-05-09,Alameda,1,1643700,87300,87292,2029,89321,1284
2021-05-09,Alpine,3,1148,88,88,0,88,0
2021-05-09,Amador,5,37829,3661,3655,35,3690,46
2021-05-09,Butte,7,227075,12278,11985,1876,13861,199
2021-05-09,Calaveras,9,45235,2123,2116,15,2131,52
2021-05-09,Colusa,11,21464,1927,1940,306,2246,14
2021-05-09,Contra Costa,13,1133247,68694,68302,1314,69616,806
2021-05-09,Del Norte,15,27424,1352,1338,7,1345,8
2021-05-09,El Dorado,17,186661,10096,10089,760,10849,113
2021-05-09,Fresno,19,978130,101333,101729,9003,110732,1682
2021-05-09,Glenn,21,27897,2394,2382,568,2950,17
2021-05-09,Humboldt,23,135768,4019,3950,59,4009,36
2021-05-09,Imperial,25,180216,28374,28388,2861,31249,722
2021-05-09,Inyo,27,18085,1403,1401,3,1404,36
2021-05-09,Kern,29,883053,96284,95903,11192,107095,1310
2021-05-09,Kings,31,150075,22885,22878,1192,24070,246
2021-05-09,Lake,33,64148,3478,3471,9,3480,43
2021-05-09,Lassen,35,31185,5169,5147,113,5260,5
2021-05-09,Los Angeles,37,10098052,1198912,1194820,43650,1238470,24026
2021-05-09,Madera,39,155013,16441,16444,944,17388,238
2021-05-09,Marin,41,260295,13970,13979,258,14237,228
2021-05-09,Mariposa,43,17540,424,420,12,432,5
2021-05-09,Mendocino,45,87422,3868,3814,70,3884,46
2021-05-09,Merced,47,269075,30793,30883,1001,31884,448
2021-05-09,Modoc,49,8938,369,360,125,485,3
2021-05-09,Mono,51,14174,1241,1264,14,1278,3
2021-05-09,Monterey,53,433212,42911,42918,1924,44842,380
2021-05-09,Napa,55,140530,9848,9857,33,9890,81
2021-05-09,Nevada,57,99092,4742,4727,193,4920,70
2021-05-09,Orange,59,3164182,253853,253451,11650,265101,5008
2021-05-09,Placer,61,380077,22858,22566,1508,24074,286
2021-05-09,Plumas,63,18699,692,679,11,690,4
2021-05-09,Riverside,65,2383286,290208,287644,14738,302382,4427
2021-05-09,Sacramento,67,1510023,104432,104309,1802,106111,1612
2021-05-09,San Benito,69,59416,6043,6056,118,6174,63
2021-05-09,San Bernardino,71,2135413,291782,291337,9173,300510,4707
2021-05-09,San Diego,73,3302833,278661,277950,0,277950,3725
2021-05-09,San Francisco,75,870044,36395,36669,1372,38041,543
2021-05-09,San Joaquin,77,732212,72309,71927,3685,75612,1356
2021-05-09,San Luis Obispo,79,281455,21040,20999,763,21762,256
2021-05-09,San Mateo,81,765935,42073,41903,473,42376,424
2021-05-09,Santa Barbara,83,443738,34286,34196,1339,35535,456
2021-05-09,Santa Clara,85,1922200,117516,118798,796,119594,2003
2021-05-09,Santa Cruz,87,273765,16073,16094,875,16969,206
2021-05-09,Shasta,89,179085,12028,12034,1655,13689,200
2021-05-09,Sierra,91,2930,54,54,14,68,0
2021-05-09,Siskiyou,93,43540,1822,1741,357,2098,13
2021-05-09,Solano,95,438530,32465,32434,543,32977,250
2021-05-09,Sonoma,97,501317,29772,29953,337,30290,318
2021-05-09,Stanislaus,99,539301,55385,55511,6111,61622,898
2021-05-09,Sutter,101,95872,9372,9413,87,9500,111
2021-05-09,Tehama,103,63373,4981,4979,607,5586,62
2021-05-09,Trinity,105,12862,358,327,56,383,3
2021-05-09,Tulare,107,460477,49313,48948,9446,58394,837
2021-05-09,Tuolumne,109,53932,4053,4053,146,4199,63
2021-05-09,Ventura,111,848112,80692,80487,3118,83605,1008
2021-05-09,Yolo,113,214977,13887,13897,316,14213,209
2021-05-09,Yuba,115,75493,5957,5934,127,6061,46
2021-05-08,Alameda,1,1643700,87258,87213,2025,89238,1284
2021-05-08,Alpine,3,1148,88,88,0,88,0
2021-05-08,Amador,5,37829,3659,3652,35,3687,46
2021-05-08,Butte,7,227075,12266,11962,1875,13837,199
2021-05-08,Calaveras,9,45235,2122,2114,15,2129,52
2021-05-08,Colusa,11,21464,1927,1939,306,2245,14
2021-05-08,Contra Costa,13,1133247,68661,68223,1312,69535,803
2021-05-08,Del Norte,15,27424,1349,1335,7,1342,8
2021-05-08,El Dorado,17,186661,10082,10079,760,10839,113
2021-05-08,Fresno,19,978130,101298,101676,8997,110673,1682
2021-05-08,Glenn,21,27897,2392,2382,566,2948,17
2021-05-08,Humboldt,23,135768,4003,3939,59,3998,36
2021-05-08,Imperial,25,180216,28366,28373,2861,31234,721
2021-05-08,Inyo,27,18085,1403,1402,3,1405,36
2021-05-08,Kern,29,883053,96261,95880,11179,107059,1310
2021-05-08,Kings,31,150075,22882,22872,1191,24063,246
2021-05-08,Lake,33,64148,3477,3470,9,3479,43
2021-05-08,Lassen,35,31185,5168,5145,113,5258,5
2021-05-08,Los Angeles,37,10098052,1198764,1194584,43634,1238218,24022
2021-05-08,Madera,39,155013,16437,16442,944,17386,238
2021-05-08,Marin,41,260295,13967,13974,257,14231,228
2021-05-08,Mariposa,43,17540,424,420,12,432,5
2021-05-08,Mendocino,45,87422,3863,3810,69,3879,46
2021-05-08,Merced,47,269075,30784,30876,1001,31877,448
2021-05-08,Modoc,49,8938,369,360,124,484,3
2021-05-08,Mono,51,14174,1241,1262,14,1276,3
2021-05-08,Monterey,53,433212,42906,42914,1923,44837,380
2021-05-08,Napa,55,140530,9841,9853,33,9886,81
2021-05-08,Nevada,57,99092,4739,4716,193,4909,70
2021-05-08,Orange,59,3164182,253817,253412,11647,265059,5006
2021-05-08,Placer,61,380077,22840,22547,1506,24053,286
2021-05-08,Plumas,63,18699,691,679,11,690,4
2021-05-08,Riverside,65,2383286,290167,287574,14736,302310,4427
2021-05-08,Sacramento,67,1510023,104348,104208,1798,106006,1610
2021-05-08,San Benito,69,59416,6042,6048,118,6166,63
2021-05-08,San Bernardino,71,2135413,291739,291296,9173,300469,4707
2021-05-08,San Diego,73,3302833,278577,277760,0,277760,3725
2021-05-08,San Francisco,75,870044,36372,36642,1372,38014,543
2021-05-08,San Joaquin,77,732212,72280,71869,3676,75545,1356
2021-05-08,San Luis Obispo,79,281455,21029,20992,763,21755,256
2021-05-08,San Mateo,81,765935,42062,41871,473,42344,424
2021-05-08,Santa Barbara,83,443738,34273,34185,1339,35524,456
2021-05-08,Santa Clara,85,1922200,117485,118751,796,119547,2003
2021-05-08,Santa Cruz,87,273765,16070,16089,875,16964,206
2021-05-08,Shasta,89,179085,12018,12030,1651,13681,200
2021-05-08,Sierra,91,2930,54,54,14,68,0
2021-05-08,Siskiyou,93,43540,1821,1741,353,2094,13
2021-05-08,Solano,95,438530,32440,32395,541,32936,249
2021-05-08,Sonoma,97,501317,29760,29942,337,30279,318
2021-05-08,Stanislaus,99,539301,55352,55467,6107,61574,898
2021-05-08,Sutter,101,95872,9369,9413,87,9500,111
2021-05-08,Tehama,103,63373,4979,4977,607,5584,62
2021-05-08,Trinity,105,12862,358,327,56,383,3
2021-05-08,Tulare,107,460477,49299,48929,9436,58365,837
2021-05-08,Tuolumne,109,53932,4052,4050,146,4196,63
2021-05-08,Ventura,111,848112,80681,80481,3115,83596,1008
2021-05-08,Yolo,113,214977,13884,13894,315,14209,209
2021-05-08,Yuba,115,75493,5949,5928,127,6055,46
2021-05-07,Alameda,1,1643700,87206,87128,2025,89153,1280
2021-05-07,Alpine,3,1148,88,88,0,88,0
2021-05-07,Amador,5,37829,3656,3651,35,3686,46
2021-05-07,Butte,7,227075,12248,11943,1870,13813,199
2021-05-07,Calaveras,9,45235,2120,2114,15,2129,52
2021-05-07,Colusa,11,21464,1927,1937,306,2243,14
2021-05-07,Contra Costa,13,1133247,68615,68156,1310,69466,804
2021-05-07,Del Norte,15,27424,1344,1329,7,1336,8
2021-05-07,El Dorado,17,186661,10069,10065,758,10823,112
2021-05-07,Fresno,19,978130,101266,101625,8996,110621,1684
2021-05-07,Glenn,21,27897,2389,2381,565,2946,17
2021-05-07,Humboldt,23,135768,3988,3919,59,3978,36
2021-05-07,Imperial,25,180216,28358,28352,2861,31213,721
2021-05-07,Inyo,27,18085,1403,1402,3,1405,36
2021-05-07,Kern,29,883053,96248,95839,11167,107006,1308
2021-05-07,Kings,31,150075,22881,22857,1190,24047,246
2021-05-07,Lake,33,64148,3475,3467,9,3476,43
2021-05-07,Lassen,35,31185,5167,5144,112,5256,5
2021-05-07,Los Angeles,37,10098052,1198594,1194294,43624,1237918,24008
2021-05-07,Madera,39,155013,16432,16439,944,17383,238
2021-05-07,Marin,41,260295,13963,13968,257,14225,228
2021-05-07,Mariposa,43,17540,423,419,12,431,5
2021-05-07,Mendocino,45,87422,3857,3805,69,3874,46
2021-05-07,Merced,47,269075,30780,30862,1001,31863,446
2021-05-07,Modoc,49,8938,369,360,124,484,3
2021-05-07,Mono,51,14174,1240,1261,14,1275,3
2021-05-07,Monterey,53,433212,42900,42909,1921,44830,380
2021-05-07,Napa,55,140530,9840,9849,33,9882,81
2021-05-07,Nevada,57,99092,4735,4704,193,4897,70
2021-05-07,Orange,59,3164182,253780,253338,11637,264975,5000
2021-05-07,Placer,61,380077,22820,22524,1503,24027,286
2021-05-07,Plumas,63,18699,691,678,11,689,4
2021-05-07,Riverside,65,2383286,290110,287479,14735,302214,4426
2021-05-07,Sacramento,67,1510023,104275,104068,1793,105861,1609
2021-05-07,San Benito,69,59416,6041,6048,118,6166,63
2021-05-07,San Bernardino,71,2135413,291700,291185,9168,300353,4697
2021-05-07,San Diego,73,3302833,278493,277534,0,277534,3718
2021-05-07,San Francisco,75,870044,36359,36616,1371,37987,543
2021-05-07,San Joaquin,77,732212,72240,71804,3674,75478,1351
2021-05-07,San Luis Obispo,79,281455,21022,20979,763,21742,256
2021-05-07,San Mateo,81,765935,42046,41844,473,42317,424
2021-05-07,Santa Barbara,83,443738,34263,34166,1339,35505,453
2021-05-07,Santa Clara,85,1922200,117452,118691,795,119486,2002
2021-05-07,Santa Cruz,87,273765,16067,16074,875,16949,206
2021-05-07,Shasta,89,179085,11996,12005,1649,13654,200
2021-05-07,Sierra,91,2930,54,54,14,68,0
2021-05-07,Siskiyou,93,43540,1818,1723,353,2076,13
2021-05-07,Solano,95,438530,32413,32352,539,32891,249
2021-05-07,Sonoma,97,501317,29743,29925,335,30260,318
2021-05-07,Stanislaus,99,539301,55311,55407,6101,61508,896
2021-05-07,Sutter,101,95872,9369,9407,86,9493,111
2021-05-07,Tehama,103,63373,4972,4974,607,5581,57
2021-05-07,Trinity,105,12862,358,327,56,383,3
2021-05-07,Tulare,107,460477,49282,48913,9431,58344,837
2021-05-07,Tuolumne,109,53932,4050,4048,146,4194,63
2021-05-07,Ventura,111,848112,80657,80444,3115,83559,1008
2021-05-07,Yolo,113,214977,13879,13875,314,14189,209
2021-05-07,Yuba,115,75493,5939,5910,127,6037,46
2021-05-06,Alameda,1,1643700,87128,87028,2021,89049,1278
2021-05-06,Alpine,3,1148,88,88,0,88,0
2021-05-06,Amador,5,37829,3654,3650,35,3685,46
2021-05-06,Butte,7,227075,12228,11929,1865,13794,198
2021-05-06,Calaveras,9,45235,2119,2111,15,2126,52
2021-05-06,Colusa,11,21464,1927,1935,306,2241,14
2021-05-06,Contra Costa,13,1133247,68560,68076,1307,69383,802
2021-05-06,Del Norte,15,27424,1336,1324,7,1331,6
2021-05-06,El Dorado,17,186661,10062,10048,758,10806,112
2021-05-06,Fresno,19,978130,101225,101536,8990,110526,1680
2021-05-06,Glenn,21,27897,2387,2380,564,2944,17
2021-05-06,Humboldt,23,135768,3964,3898,58,3956,36
2021-05-06,Imperial,25,180216,28347,28311,2860,31171,720
2021-05-06,Inyo,27,18085,1403,1401,3,1404,36
2021-05-06,Kern,29,883053,96223,95801,11150,106951,1307
2021-05-06,Kings,31,150075,22874,22848,1189,24037,246
2021-05-06,Lake,33,64148,3474,3465,9,3474,43
2021-05-06,Lassen,35,31185,5166,5143,112,5255,1
2021-05-06,Los Angeles,37,10098052,1198354,1193954,43607,1237561,23991
2021-05-06,Madera,39,155013,16424,16430,944,17374,238
2021-05-06,Marin,41,260295,13959,13956,257,14213,228
2021-05-06,Mariposa,43,17540,422,419,12,431,5
2021-05-06,Mendocino,45,87422,3846,3802,69,3871,46
2021-05-06,Merced,47,269075,30766,30863,1000,31863,444
2021-05-06,Modoc,49,8938,369,360,124,484,3
2021-05-06,Mono,51,14174,1238,1261,14,1275,3
2021-05-06,Monterey,53,433212,42884,42899,1921,44820,379
2021-05-06,Napa,55,140530,9834,9843,33,9876,81
2021-05-06,Nevada,57,99092,4734,4687,193,4880,70
2021-05-06,Orange,59,3164182,253715,253286,11630,264916,4991
2021-05-06,Placer,61,380077,22799,22493,1503,23996,286
2021-05-06,Plumas,63,18699,691,678,11,689,4
2021-05-06,Riverside,65,2383286,290037,287399,14730,302129,4422
2021-05-06,Sacramento,67,1510023,104159,103956,1790,105746,1609
2021-05-06,San Benito,69,59416,6040,6045,118,6163,63
2021-05-06,San Bernardino,71,2135413,291631,291085,9167,300252,4683
2021-05-06,San Diego,73,3302833,278370,277324,0,277324,3716
2021-05-06,San Francisco,75,870044,36344,36599,1371,37970,543
2021-05-06,San Joaquin,77,732212,72184,71729,3671,75400,1350
2021-05-06,San Luis Obispo,79,281455,21010,20965,761,21726,256
2021-05-06,San Mateo,81,765935,42028,41802,472,42274,424
2021-05-06,Santa Barbara,83,443738,34250,34152,1339,35491,453
2021-05-06,Santa Clara,85,1922200,117411,118591,795,119386,2001
2021-05-06,Santa Cruz,87,273765,16060,16050,875,16925,206
2021-05-06,Shasta,89,179085,11974,11983,1643,13626,199
2021-05-06,Sierra,91,2930,54,54,14,68,0
2021-05-06,Siskiyou,93,43540,1809,1711,351,2062,12
2021-05-06,Solano,95,438530,32387,32320,531,32851,249
2021-05-06,Sonoma,97,501317,29735,29911,335,30246,318
2021-05-06,Stanislaus,99,539301,55255,55323,6098,61421,834
2021-05-06,Sutter,101,95872,9363,9396,86,9482,111
2021-05-06,Tehama,103,63373,4968,4970,607,5577,53
2021-05-06,Trinity,105,12862,358,327,56,383,3
2021-05-06,Tulare,107,460477,49259,48890,9416,58306,836
2021-05-06,Tuolumne,109,53932,4046,4047,146,4193,63
2021-05-06,Ventura,111,848112,80626,80411,3111,83522,1005
2021-05-06,Yolo,113,214977,13871,13871,310,14181,209
2021-05-06,Yuba,115,75493,5927,5901,127,6028,46
2021-05-05,Alameda,1,1643700,87066,86950,2019,88969,1278
2021-05-05,Alpine,3,1148,88,88,0,88,0
2021-05-05,Amador,5,37829,3651,3650,35,3685,46
2021-05-05,Butte,7,227075,12210,11907,1862,13769,198
2021-05-05,Calaveras,9,45235,2115,2103,15,2118,52
2021-05-05,Colusa,11,21464,1926,1933,306,2239,14
2021-05-05,Contra Costa,13,1133247,68495,67997,1302,69299,803
2021-05-05,Del Norte,15,27424,1333,1317,7,1324,6
2021-05-05,El Dorado,17,186661,10051,10020,757,10777,111
2021-05-05,Fresno,19,978130,101176,101491,8981,110472,1680
2021-05-05,Glenn,21,27897,2384,2380,563,2943,17
2021-05-05,Humboldt,23,135768,3945,3886,56,3942,36
2021-05-05,Imperial,25,180216,28306,28295,2853,31148,720
2021-05-05,Inyo,27,18085,1402,1401,3,1404,36
2021-05-05,Kern,29,883053,96182,95753,11145,106898,1304
2021-05-05,Kings,31,150075,22868,22840,1188,24028,246
2021-05-05,Lake,33,64148,3471,3458,9,3467,43
2021-05-05,Lassen,35,31185,5166,5143,111,5254,1
2021-05-05,Los Angeles,37,10098052,1198093,1193608,43594,1237202,23977
2021-05-05,Madera,39,155013,16422,16423,944,17367,235
2021-05-05,Marin,41,260295,13951,13950,256,14206,228
2021-05-05,Mariposa,43,17540,422,418,12,430,5
2021-05-05,Mendocino,45,87422,3842,3799,69,3868,46
2021-05-05,Merced,47,269075,30746,30844,1000,31844,444
2021-05-05,Modoc,49,8938,368,361,123,484,3
2021-05-05,Mono,51,14174,1238,1260,14,1274,3
2021-05-05,Monterey,53,433212,42871,42870,1918,44788,379
2021-05-05,Napa,55,140530,9828,9833,33,9866,81
2021-05-05,Nevada,57,99092,4731,4666,193,4859,70
2021-05-05,Orange,59,3164182,253661,253237,11625,264862,4978
2021-05-05,Placer,61,380077,22767,22362,1499,23861,287
2021-05-05,Plumas,63,18699,691,677,11,688,4
2021-05-05,Riverside,65,2383286,289949,287353,14720,302073,4414
2021-05-05,Sacramento,67,1510023,104069,103476,1785,105261,1607
2021-05-05,San Benito,69,59416,6031,6046,118,6164,63
2021-05-05,San Bernardino,71,2135413,291556,291008,9163,300171,4677
2021-05-05,San Diego,73,3302833,278233,277098,0,277098,3716
2021-05-05,San Francisco,75,870044,36329,36577,1370,37947,543
2021-05-05,San Joaquin,77,732212,72132,71638,3667,75305,1345
2021-05-05,San Luis Obispo,79,281455,21002,20958,761,21719,256
2021-05-05,San Mateo,81,765935,41998,41755,470,42225,415
2021-05-05,Santa Barbara,83,443738,34236,34139,1338,35477,453
2021-05-05,Santa Clara,85,1922200,117381,118482,791,119273,1992
2021-05-05,Santa Cruz,87,273765,16054,16013,875,16888,207
2021-05-05,Shasta,89,179085,11958,11939,1638,13577,200
2021-05-05,Sierra,91,2930,54,54,14,68,0
2021-05-05,Siskiyou,93,43540,1792,1706,343,2049,11
2021-05-05,Solano,95,438530,32352,32250,529,32779,249
2021-05-05,Sonoma,97,501317,29722,29879,335,30214,318
2021-05-05,Stanislaus,99,539301,55199,55231,6095,61326,807
2021-05-05,Sutter,101,95872,9357,9387,86,9473,111
2021-05-05,Tehama,103,63373,4965,4968,607,5575,53
2021-05-05,Trinity,105,12862,358,326,56,382,3
2021-05-05,Tulare,107,460477,49238,48875,9406,58281,835
2021-05-05,Tuolumne,109,53932,4043,4040,146,4186,63
2021-05-05,Ventura,111,848112,80597,80372,3107,83479,1005
2021-05-05,Yolo,113,214977,13867,13846,308,14154,209
2021-05-05,Yuba,115,75493,5917,5895,126,6021,44
2021-05-04,Alameda,1,1643700,86974,86894,2019,88913,1277
2021-05-04,Alpine,3,1148,88,88,0,88,0
2021-05-04,Amador,5,37829,3651,3650,35,3685,46
2021-05-04,Butte,7,227075,12186,11883,1861,13744,198
2021-05-04,Calaveras,9,45235,2110,2100,15,2115,52
2021-05-04,Colusa,11,21464,1925,1933,306,2239,14
2021-05-04,Contra Costa,13,1133247,68416,67931,1298,69229,799
2021-05-04,Del Norte,15,27424,1333,1314,7,1321,6
2021-05-04,El Dorado,17,186661,10040,10009,753,10762,110
2021-05-04,Fresno,19,978130,101122,101451,8971,110422,1677
2021-05-04,Glenn,21,27897,2381,2379,560,2939,17
2021-05-04,Humboldt,23,135768,3919,3877,55,3932,36
2021-05-04,Imperial,25,180216,28286,28276,2849,31125,720
2021-05-04,Inyo,27,18085,1402,1399,3,1402,36
2021-05-04,Kern,29,883053,96149,95720,11126,106846,1301
2021-05-04,Kings,31,150075,22853,22822,1185,24007,246
2021-05-04,Lake,33,64148,3470,3454,9,3463,43
2021-05-04,Lassen,35,31185,5165,5142,111,5253,1
2021-05-04,Los Angeles,37,10098052,1197807,1193453,43582,1237035,23957
2021-05-04,Madera,39,155013,16421,16418,944,17362,235
2021-05-04,Marin,41,260295,13944,13935,256,14191,228
2021-05-04,Mariposa,43,17540,422,418,12,430,5
2021-05-04,Mendocino,45,87422,3837,3794,69,3863,46
2021-05-04,Merced,47,269075,30729,30829,1000,31829,444
2021-05-04,Modoc,49,8938,367,360,122,482,3
2021-05-04,Mono,51,14174,1238,1260,14,1274,3
2021-05-04,Monterey,53,433212,42859,42845,1917,44762,380
2021-05-04,Napa,55,140530,9819,9824,33,9857,81
2021-05-04,Nevada,57,99092,4724,4656,193,4849,70
2021-05-04,Orange,59,3164182,253595,253177,11615,264792,4977
2021-05-04,Placer,61,380077,22738,22326,1496,23822,287
2021-05-04,Plumas,63,18699,690,675,11,686,4
2021-05-04,Riverside,65,2383286,289865,287285,14712,301997,4411
2021-05-04,Sacramento,67,1510023,103940,103383,1781,105164,1604
2021-05-04,San Benito,69,59416,6030,6039,118,6157,63
2021-05-04,San Bernardino,71,2135413,291474,290934,9156,300090,4668
2021-05-04,San Diego,73,3302833,278067,276879,0,276879,3713
2021-05-04,San Francisco,75,870044,36311,36550,1370,37920,541
2021-05-04,San Joaquin,77,732212,72071,71582,3663,75245,1342
2021-05-04,San Luis Obispo,79,281455,20998,20923,759,21682,255
2021-05-04,San Mateo,81,765935,41973,41708,470,42178,415
2021-05-04,Santa Barbara,83,443738,34220,34131,1338,35469,453
2021-05-04,Santa Clara,85,1922200,117318,118431,790,119221,1988
2021-05-04,Santa Cruz,87,273765,16048,16005,875,16880,207
2021-05-04,Shasta,89,179085,11938,11923,1631,13554,198
2021-05-04,Sierra,91,2930,54,54,14,68,0
2021-05-04,Siskiyou,93,43540,1785,1694,341,2035,11
2021-05-04,Solano,95,438530,32311,32220,527,32747,249
2021-05-04,Sonoma,97,501317,29704,29867,334,30201,318
2021-05-04,Stanislaus,99,539301,55144,55165,6092,61257,807
2021-05-04,Sutter,101,95872,9352,9375,86,9461,111
2021-05-04,Tehama,103,63373,4963,4959,606,5565,53
2021-05-04,Trinity,105,12862,358,326,56,382,3
2021-05-04,Tulare,107,460477,49212,48857,9396,58253,835
2021-05-04,Tuolumne,109,53932,4041,4041,146,4187,61
2021-05-04,Ventura,111,848112,80568,80351,3105,83456,1005
2021-05-04,Yolo,113,214977,13854,13820,306,14126,208
2021-05-04,Yuba,115,75493,5911,5891,126,6017,44
2021-05-03,Alameda,1,1643700,86897,86845,2013,88858,1272
2021-05-03,Alpine,3,1148,88,88,0,88,0
2021-05-03,Amador,5,37829,3651,3651,35,3686,46
2021-05-03,Butte,7,227075,12176,11864,1858,13722,198
2021-05-03,Calaveras,9,45235,2109,2099,15,2114,50
2021-05-03,Colusa,11,21464,1924,1931,304,2235,14
2021-05-03,Contra Costa,13,1133247,68357,67895,1294,69189,799
2021-05-03,Del Norte,15,27424,1328,1306,6,1312,6
2021-05-03,El Dorado,17,186661,10022,9984,748,10732,110
2021-05-03,Fresno,19,978130,101069,101405,8960,110365,1678
2021-05-03,Glenn,21,27897,2381,2375,559,2934,17
2021-05-03,Humboldt,23,135768,3904,3865,51,3916,36
2021-05-03,Imperial,25,180216,28264,28280,2846,31126,720
2021-05-03,Inyo,27,18085,1401,1398,3,1401,36
2021-05-03,Kern,29,883053,96114,95693,11113,106806,1299
2021-05-03,Kings,31,150075,22844,22821,1185,24006,246
2021-05-03,Lake,33,64148,3468,3446,9,3455,43
2021-05-03,Lassen,35,31185,5164,5142,111,5253,1
2021-05-03,Los Angeles,37,10098052,1197544,1193261,43554,1236815,23942
2021-05-03,Madera,39,155013,16417,16414,943,17357,235
2021-05-03,Marin,41,260295,13938,13927,256,14183,228
2021-05-03,Mariposa,43,17540,422,418,12,430,5
2021-05-03,Mendocino,45,87422,3830,3792,69,3861,46
2021-05-03,Merced,47,269075,30718,30814,998,31812,444
2021-05-03,Modoc,49,8938,367,360,122,482,3
2021-05-03,Mono,51,14174,1238,1259,14,1273,3
2021-05-03,Monterey,53,433212,42849,42837,1915,44752,380
2021-05-03,Napa,55,140530,9814,9815,33,9848,81
2021-05-03,Nevada,57,99092,4716,4650,193,4843,70
2021-05-03,Orange,59,3164182,253537,253107,11607,264714,4968
2021-05-03,Placer,61,380077,22707,22289,1490,23779,287
2021-05-03,Plumas,63,18699,689,675,11,686,4
2021-05-03,Riverside,65,2383286,289793,287233,14711,301944,4412
2021-05-03,Sacramento,67,1510023,103787,103303,1772,105075,1602
2021-05-03,San Benito,69,59416,6029,6038,118,6156,63
2021-05-03,San Bernardino,71,2135413,291406,290886,9151,300037,4659
2021-05-03,San Diego,73,3302833,277904,276693,0,276693,3712
2021-05-03,San Francisco,75,870044,36285,36538,1369,37907,541
2021-05-03,San Joaquin,77,732212,72020,71504,3660,75164,1325
2021-05-03,San Luis Obispo,79,281455,20981,20915,756,21671,254
2021-05-03,San Mateo,81,765935,41950,41689,469,42158,413
2021-05-03,Santa Barbara,83,443738,34208,34119,1338,35457,453
2021-05-03,Santa Clara,85,1922200,117264,118373,789,119162,1988
2021-05-03,Santa Cruz,87,273765,16045,16000,875,16875,207
2021-05-03,Shasta,89,179085,11915,11890,1624,13514,197
2021-05-03,Sierra,91,2930,54,54,14,68,0
2021-05-03,Siskiyou,93,43540,1779,1683,335,2018,11
2021-05-03,Solano,95,438530,32270,32201,526,32727,249
2021-05-03,Sonoma,97,501317,29692,29855,331,30186,318
2021-05-03,Stanislaus,99,539301,55080,55116,6081,61197,774
2021-05-03,Sutter,101,95872,9340,9370,86,9456,111
2021-05-03,Tehama,103,63373,4954,4952,606,5558,53
2021-05-03,Trinity,105,12862,358,326,56,382,3
2021-05-03,Tulare,107,460477,49195,48844,9386,58230,835
2021-05-03,Tuolumne,109,53932,4040,4038,140,4178,61
2021-05-03,Ventura,111,848112,80546,80291,3105,83396,1005
2021-05-03,Yolo,113,214977,13841,13809,304,14113,208
2021-05-03,Yuba,115,75493,5906,5880,126,6006,44
2021-05-02,Alameda,1,1643700,86811,86784,2011,88795,1272
2021-05-02,Alpine,3,1148,88,88,0,88,0
2021-05-02,Amador,5,37829,3651,3650,35,3685,46
2021-05-02,Butte,7,227075,12152,11859,1855,13714,198
2021-05-02,Calaveras,9,45235,2105,2098,15,2113,50
2021-05-02,Colusa,11,21464,1923,1931,303,2234,14
2021-05-02,Contra Costa,13,1133247,68271,67843,1291,69134,800
2021-05-02,Del Norte,15,27424,1321,1305,6,1311,6
2021-05-02,El Dorado,17,186661,10007,9962,747,10709,110
2021-05-02,Fresno,19,978130,100998,101372,8951,110323,1678
2021-05-02,Glenn,21,27897,2380,2374,557,2931,17
2021-05-02,Humboldt,23,135768,3892,3858,49,3907,36
2021-05-02,Imperial,25,180216,28230,28275,2837,31112,721
2021-05-02,Inyo,27,18085,1399,1398,3,1401,36
2021-05-02,Kern,29,883053,96056,95668,11106,106774,1299
2021-05-02,Kings,31,150075,22826,22816,1184,24000,246
2021-05-02,Lake,33,64148,3466,3443,9,3452,43
2021-05-02,Lassen,35,31185,5163,5142,110,5252,1
2021-05-02,Los Angeles,37,10098052,1197198,1193056,43530,1236586,23943
2021-05-02,Madera,39,155013,16411,16410,943,17353,235
2021-05-02,Marin,41,260295,13928,13917,256,14173,228
2021-05-02,Mariposa,43,17540,422,419,12,431,5
2021-05-02,Mendocino,45,87422,3825,3787,69,3856,46
2021-05-02,Merced,47,269075,30696,30793,996,31789,444
2021-05-02,Modoc,49,8938,367,360,122,482,3
2021-05-02,Mono,51,14174,1237,1259,14,1273,3
2021-05-02,Monterey,53,433212,42836,42837,1913,44750,380
2021-05-02,Napa,55,140530,9810,9805,33,9838,81
2021-05-02,Nevada,57,99092,4700,4635,193,4828,70
2021-05-02,Orange,59,3164182,253466,253025,11594,264619,4968
2021-05-02,Placer,61,380077,22678,22264,1487,23751,287
2021-05-02,Plumas,63,18699,689,675,11,686,4
2021-05-02,Riverside,65,2383286,289696,287197,14701,301898,4412
2021-05-02,Sacramento,67,1510023,103652,103153,1765,104918,1602
2021-05-02,San Benito,69,59416,6024,6037,118,6155,63
2021-05-02,San Bernardino,71,2135413,291307,290859,9149,300008,4655
2021-05-02,San Diego,73,3302833,277708,276521,0,276521,3712
2021-05-02,San Francisco,75,870044,36259,36522,1369,37891,541
2021-05-02,San Joaquin,77,732212,71956,71447,3653,75100,1325
2021-05-02,San Luis Obispo,79,281455,20961,20910,755,21665,254
2021-05-02,San Mateo,81,765935,41935,41656,468,42124,412
2021-05-02,Santa Barbara,83,443738,34194,34106,1338,35444,453
2021-05-02,Santa Clara,85,1922200,117191,118321,789,119110,1988
2021-05-02,Santa Cruz,87,273765,16040,15995,874,16869,207
2021-05-02,Shasta,89,179085,11899,11885,1616,13501,197
2021-05-02,Sierra,91,2930,54,54,14,68,0
2021-05-02,Siskiyou,93,43540,1768,1661,334,1995,11
2021-05-02,Solano,95,438530,32231,32151,522,32673,249
2021-05-02,Sonoma,97,501317,29669,29842,331,30173,318
2021-05-02,Stanislaus,99,539301,55007,55057,6074,61131,774
2021-05-02,Sutter,101,95872,9333,9363,86,9449,111
2021-05-02,Tehama,103,63373,4949,4950,603,5553,53
2021-05-02,Trinity,105,12862,358,326,56,382,3
2021-05-02,Tulare,107,460477,49177,48834,9378,58212,835
2021-05-02,Tuolumne,109,53932,4037,4038,140,4178,61
2021-05-02,Ventura,111,848112,80509,80284,3104,83388,1005
2021-05-02,Yolo,113,214977,13829,13799,303,14102,208
2021-05-02,Yuba,115,75493,5896,5879,126,6005,44
2021-05-01,Alameda,1,1643700,86768,86704,2008,88712,1270
2021-05-01,Alpine,3,1148,88,88,0,88,0
2021-05-01,Amador,5,37829,3651,3650,35,3685,46
2021-05-01,Butte,7,227075,12138,11845,1850,13695,198
2021-05-01,Calaveras,9,45235,2103,2096,15,2111,50
2021-05-01,Colusa,11,21464,1922,1931,303,2234,14
2021-05-01,Contra Costa,13,1133247,68219,67779,1288,69067,800
2021-05-01,Del Norte,15,27424,1320,1292,6,1298,6
2021-05-01,El Dorado,17,186661,9993,9944,745,10689,110
2021-05-01,Fresno,19,978130,100953,101326,8944,110270,1678
2021-05-01,Glenn,21,27897,2377,2369,556,2925,17
2021-05-01,Humboldt,23,135768,3877,3845,49,3894,36
2021-05-01,Imperial,25,180216,28223,28262,2837,31099,721
2021-05-01,Inyo,27,18085,1399,1397,3,1400,36
2021-05-01,Kern,29,883053,96029,95645,11093,106738,1299
2021-05-01,Kings,31,150075,22824,22797,1181,23978,246
2021-05-01,Lake,33,64148,3464,3441,9,3450,43
2021-05-01,Lassen,35,31185,5161,5142,110,5252,1
2021-05-01,Los Angeles,37,10098052,1197032,1192781,43515,1236296,23946
2021-05-01,Madera,39,155013,16407,16408,943,17351,235
2021-05-01,Marin,41,260295,13921,13902,256,14158,228
2021-05-01,Mariposa,43,17540,422,418,12,430,5
2021-05-01,Mendocino,45,87422,3823,3782,69,3851,46
2021-05-01,Merced,47,269075,30678,30771,995,31766,444
2021-05-01,Modoc,49,8938,367,361,122,483,3
2021-05-01,Mono,51,14174,1237,1258,14,1272,3
2021-05-01,Monterey,53,433212,42830,42828,1913,44741,379
2021-05-01,Napa,55,140530,9807,9800,33,9833,81
2021-05-01,Nevada,57,99092,4695,4625,193,4818,70
2021-05-01,Orange,59,3164182,253427,252969,11583,264552,4964
2021-05-01,Placer,61,380077,22652,22240,1485,23725,287
2021-05-01,Plumas,63,18699,688,675,11,686,4
2021-05-01,Riverside,65,2383286,289657,287129,14699,301828,4412
2021-05-01,Sacramento,67,1510023,103573,103043,1763,104806,1602
2021-05-01,San Benito,69,59416,6021,6030,118,6148,63
2021-05-01,San Bernardino,71,2135413,291262,290802,9148,299950,4652
2021-05-01,San Diego,73,3302833,277584,276367,0,276367,3706
2021-05-01,San Francisco,75,870044,36244,36496,1369,37865,541
2021-05-01,San Joaquin,77,732212,71908,71389,3651,75040,1325
2021-05-01,San Luis Obispo,79,281455,20956,20896,754,21650,254
2021-05-01,San Mateo,81,765935,41906,41617,467,42084,411
2021-05-01,Santa Barbara,83,443738,34189,34085,1336,35421,453
2021-05-01,Santa Clara,85,1922200,117140,118265,787,119052,1988
2021-05-01,Santa Cruz,87,273765,16037,15984,874,16858,207
2021-05-01,Shasta,89,179085,11879,11878,1608,13486,197
2021-05-01,Sierra,91,2930,54,53,14,67,0
2021-05-01,Siskiyou,93,43540,1760,1653,333,1986,11
2021-05-01,Solano,95,438530,32201,32124,514,32638,249
2021-05-01,Sonoma,97,501317,29667,29835,331,30166,318
2021-05-01,Stanislaus,99,539301,54972,55005,6068,61073,774
2021-05-01,Sutter,101,95872,9330,9358,86,9444,110
2021-05-01,Tehama,103,63373,4948,4950,602,5552,53
2021-05-01,Trinity,105,12862,358,326,55,381,3
2021-05-01,Tulare,107,460477,49170,48818,9372,58190,835
2021-05-01,Tuolumne,109,53932,4031,4035,140,4175,61
2021-05-01,Ventura,111,848112,80491,80268,3104,83372,1005
2021-05-01,Yolo,113,214977,13822,13784,301,14085,208
2021-05-01,Yuba,115,75493,5894,5875,126,6001,44
2021-04-30,Alameda,1,1643700,86706,86602,2005,88607,1268
2021-04-30,Alpine,3,1148,88,88,0,88,0
2021-04-30,Amador,5,37829,3649,3650,35,3685,46
2021-04-30,Butte,7,227075,12119,11812,1846,13658,197
2021-04-30,Calaveras,9,45235,2102,2087,15,2102,50
2021-04-30,Colusa,11,21464,1922,1931,302,2233,14
2021-04-30,Contra Costa,13,1133247,68171,67684,1285,68969,800
2021-04-30,Del Norte,15,27424,1308,1276,6,1282,6
2021-04-30,El Dorado,17,186661,9979,9906,745,10651,110
2021-04-30,Fresno,19,978130,100907,101263,8940,110203,1670
2021-04-30,Glenn,21,27897,2376,2369,556,2925,17
2021-04-30,Humboldt,23,135768,3864,3834,49,3883,36
2021-04-30,Imperial,25,180216,28214,28244,2834,31078,721
2021-04-30,Inyo,27,18085,1399,1397,3,1400,36
2021-04-30,Kern,29,883053,96013,95605,11088,106693,1298
2021-04-30,Kings,31,150075,22821,22793,1180,23973,246
2021-04-30,Lake,33,64148,3460,3440,9,3449,43
2021-04-30,Lassen,35,31185,5160,5140,110,5250,1
2021-04-30,Los Angeles,37,10098052,1196825,1192393,43501,1235894,23919
2021-04-30,Madera,39,155013,16401,16395,943,17338,235
2021-04-30,Marin,41,260295,13913,13895,254,14149,228
2021-04-30,Mariposa,43,17540,422,417,12,429,5
2021-04-30,Mendocino,45,87422,3819,3777,69,3846,46
2021-04-30,Merced,47,269075,30665,30740,994,31734,444
2021-04-30,Modoc,49,8938,366,360,122,482,3
2021-04-30,Mono,51,14174,1237,1258,14,1272,3
2021-04-30,Monterey,53,433212,42816,42810,1912,44722,379
2021-04-30,Napa,55,140530,9803,9792,33,9825,81
2021-04-30,Nevada,57,99092,4687,4608,193,4801,70
2021-04-30,Orange,59,3164182,253372,252883,11576,264459,4956
2021-04-30,Placer,61,380077,22633,22190,1481,23671,287
2021-04-30,Plumas,63,18699,688,677,11,688,4
2021-04-30,Riverside,65,2383286,289604,287030,14692,301722,4412
2021-04-30,Sacramento,67,1510023,103472,102864,1759,104623,1596
2021-04-30,San Benito,69,59416,6017,6024,117,6141,63
2021-04-30,San Bernardino,71,2135413,291207,290704,9147,299851,4640
2021-04-30,San Diego,73,3302833,277490,276157,0,276157,3702
2021-04-30,San Francisco,75,870044,36233,36453,1368,37821,538
2021-04-30,San Joaquin,77,732212,71857,71311,3648,74959,1306
2021-04-30,San Luis Obispo,79,281455,20950,20884,754,21638,255
2021-04-30,San Mateo,81,765935,41891,41583,466,42049,380
2021-04-30,Santa Barbara,83,443738,34176,34061,1336,35397,451
2021-04-30,Santa Clara,85,1922200,117082,118170,783,118953,1988
2021-04-30,Santa Cruz,87,273765,16032,15975,874,16849,207
2021-04-30,Shasta,89,179085,11858,11848,1605,13453,197
2021-04-30,Sierra,91,2930,54,53,14,67,0
2021-04-30,Siskiyou,93,43540,1749,1628,330,1958,11
2021-04-30,Solano,95,438530,32169,32050,511,32561,249
2021-04-30,Sonoma,97,501317,29657,29816,329,30145,318
2021-04-30,Stanislaus,99,539301,54921,54938,6065,61003,774
2021-04-30,Sutter,101,95872,9328,9353,86,9439,110
2021-04-30,Tehama,103,63373,4946,4944,602,5546,53
2021-04-30,Trinity,105,12862,358,326,55,381,3
2021-04-30,Tulare,107,460477,49161,48797,9355,58152,836
2021-04-30,Tuolumne,109,53932,4030,4033,139,4172,61
2021-04-30,Ventura,111,848112,80452,80232,3099,83331,1004
2021-04-30,Yolo,113,214977,13809,13756,301,14057,208
2021-04-30,Yuba,115,75493,5886,5870,126,5996,44
2021-04-29,Alameda,1,1643700,86641,86490,2003,88493,1263
2021-04-29,Alpine,3,1148,88,88,0,88,0
2021-04-29,Amador,5,37829,3649,3649,35,3684,46
2021-04-29,Butte,7,227075,12104,11787,1844,13631,196
2021-04-29,Calaveras,9,45235,2099,2082,15,2097,50
2021-04-29,Colusa,11,21464,1922,1929,302,2231,14
2021-04-29,Contra Costa,13,1133247,68116,67606,1282,68888,795
2021-04-29,Del Norte,15,27424,1304,1271,6,1277,6
2021-04-29,El Dorado,17,186661,9960,9884,742,10626,107
2021-04-29,Fresno,19,978130,100853,101189,8929,110118,1667
2021-04-29,Glenn,21,27897,2373,2369,556,2925,17
2021-04-29,Humboldt,23,135768,3850,3815,49,3864,36
2021-04-29,Imperial,25,180216,28201,28235,2833,31068,720
2021-04-29,Inyo,27,18085,1399,1396,3,1399,36
2021-04-29,Kern,29,883053,95980,95547,11084,106631,1295
2021-04-29,Kings,31,150075,22811,22777,1175,23952,245
2021-04-29,Lake,33,64148,3452,3438,9,3447,43
2021-04-29,Lassen,35,31185,5160,5140,110,5250,1
2021-04-29,Los Angeles,37,10098052,1196551,1192068,43480,1235548,23899
2021-04-29,Madera,39,155013,16396,16383,942,17325,235
2021-04-29,Marin,41,260295,13909,13884,246,14130,228
2021-04-29,Mariposa,43,17540,421,416,12,428,5
2021-04-29,Mendocino,45,87422,3813,3774,69,3843,46
2021-04-29,Merced,47,269075,30645,30706,994,31700,444
2021-04-29,Modoc,49,8938,366,360,122,482,3
2021-04-29,Mono,51,14174,1235,1259,14,1273,3
2021-04-29,Monterey,53,433212,42800,42797,1911,44708,379
2021-04-29,Napa,55,140530,9789,9789,33,9822,81
2021-04-29,Nevada,57,99092,4676,4590,193,4783,70
2021-04-29,Orange,59,3164182,253306,252823,11561,264384,4934
2021-04-29,Placer,61,380077,22608,22161,1479,23640,286
2021-04-29,Plumas,63,18699,687,676,11,687,4
2021-04-29,Riverside,65,2383286,289538,286947,14688,301635,4409
2021-04-29,Sacramento,67,1510023,103340,102686,1749,104435,1593
2021-04-29,San Benito,69,59416,6016,6023,117,6140,63
2021-04-29,San Bernardino,71,2135413,291134,290606,9142,299748,4609
2021-04-29,San Diego,73,3302833,277341,275961,0,275961,3700
2021-04-29,San Francisco,75,870044,36207,36412,1368,37780,537
2021-04-29,San Joaquin,77,732212,71792,71225,3643,74868,1301
2021-04-29,San Luis Obispo,79,281455,20939,20876,754,21630,255
2021-04-29,San Mateo,81,765935,41863,41538,465,42003,358
2021-04-29,Santa Barbara,83,443738,34160,34039,1334,35373,448
2021-04-29,Santa Clara,85,1922200,117027,118082,781,118863,1984
2021-04-29,Santa Cruz,87,273765,16026,15961,874,16835,205
2021-04-29,Shasta,89,179085,11828,11836,1596,13432,193
2021-04-29,Sierra,91,2930,54,53,14,67,0
2021-04-29,Siskiyou,93,43540,1740,1615,327,1942,11
2021-04-29,Solano,95,438530,32129,32002,506,32508,248
2021-04-29,Sonoma,97,501317,29642,29785,326,30111,318
2021-04-29,Stanislaus,99,539301,54854,54836,6060,60896,774
2021-04-29,Sutter,101,95872,9321,9346,86,9432,110
2021-04-29,Tehama,103,63373,4938,4939,601,5540,53
2021-04-29,Trinity,105,12862,358,326,55,381,3
2021-04-29,Tulare,107,460477,49146,48785,9341,58126,832
2021-04-29,Tuolumne,109,53932,4029,4030,139,4169,58
2021-04-29,Ventura,111,848112,80418,80188,3097,83285,1002
2021-04-29,Yolo,113,214977,13788,13745,299,14044,205
2021-04-29,Yuba,115,75493,5876,5865,126,5991,44
2021-04-28,Alameda,1,1643700,86569,86390,1998,88388,1260
2021-04-28,Alpine,3,1148,88,88,0,88,0
2021-04-28,Amador,5,37829,3649,3646,35,3681,46
2021-04-28,Butte,7,227075,12084,11762,1839,13601,196
2021-04-28,Calaveras,9,45235,2095,2078,14,2092,50
2021-04-28,Colusa,11,21464,1919,1927,301,2228,14
2021-04-28,Contra Costa,13,1133247,68056,67539,1281,68820,795
2021-04-28,Del Norte,15,27424,1296,1267,6,1273,6
2021-04-28,El Dorado,17,186661,9936,9873,742,10615,107
2021-04-28,Fresno,19,978130,100807,101161,8918,110079,1666
2021-04-28,Glenn,21,27897,2370,2368,556,2924,17
2021-04-28,Humboldt,23,135768,3833,3796,48,3844,36
2021-04-28,Imperial,25,180216,28187,28177,2832,31009,720
2021-04-28,Inyo,27,18085,1399,1396,2,1398,36
2021-04-28,Kern,29,883053,95950,95494,11076,106570,1295
2021-04-28,Kings,31,150075,22800,22767,1172,23939,245
2021-04-28,Lake,33,64148,3449,3433,9,3442,43
2021-04-28,Lassen,35,31185,5160,5138,110,5248,1
2021-04-28,Los Angeles,37,10098052,1196257,1191729,43453,1235182,23858
2021-04-28,Madera,39,155013,16392,16372,942,17314,235
2021-04-28,Marin,41,260295,13898,13866,246,14112,227
2021-04-28,Mariposa,43,17540,418,415,12,427,5
2021-04-28,Mendocino,45,87422,3807,3770,67,3837,46
2021-04-28,Merced,47,269075,30626,30649,994,31643,443
2021-04-28,Modoc,49,8938,366,360,122,482,3
2021-04-28,Mono,51,14174,1235,1258,14,1272,3
2021-04-28,Monterey,53,433212,42795,42776,1911,44687,379
2021-04-28,Napa,55,140530,9778,9777,33,9810,81
2021-04-28,Nevada,57,99092,4657,4570,193,4763,70
2021-04-28,Orange,59,3164182,253229,252747,11546,264293,4931
2021-04-28,Placer,61,380077,22581,22115,1478,23593,285
2021-04-28,Plumas,63,18699,687,676,11,687,4
2021-04-28,Riverside,65,2383286,289482,286868,14683,301551,4407
2021-04-28,Sacramento,67,1510023,103217,102613,1745,104358,1591
2021-04-28,San Benito,69,59416,6014,6021,117,6138,63
2021-04-28,San Bernardino,71,2135413,291061,290548,9131,299679,4582
2021-04-28,San Diego,73,3302833,277186,275821,0,275821,3698
2021-04-28,San Francisco,75,870044,36178,36382,1367,37749,534
2021-04-28,San Joaquin,77,732212,71712,71171,3635,74806,1301
2021-04-28,San Luis Obispo,79,281455,20931,20851,754,21605,255
2021-04-28,San Mateo,81,765935,41838,41498,463,41961,358
2021-04-28,Santa Barbara,83,443738,34146,34003,1333,35336,448
2021-04-28,Santa Clara,85,1922200,116958,117997,778,118775,1969
2021-04-28,Santa Cruz,87,273765,16022,15943,873,16816,205
2021-04-28,Shasta,89,179085,11813,11815,1585,13400,192
2021-04-28,Sierra,91,2930,54,51,14,65,0
2021-04-28,Siskiyou,93,43540,1727,1603,325,1928,11
2021-04-28,Solano,95,438530,32097,31982,502,32484,248
2021-04-28,Sonoma,97,501317,29628,29773,322,30095,318
2021-04-28,Stanislaus,99,539301,54800,54745,6056,60801,774
2021-04-28,Sutter,101,95872,9316,9343,86,9429,110
2021-04-28,Tehama,103,63373,4932,4930,600,5530,53
2021-04-28,Trinity,105,12862,358,326,55,381,3
2021-04-28,Tulare,107,460477,49129,48754,9325,58079,832
2021-04-28,Tuolumne,109,53932,4026,4029,139,4168,58
2021-04-28,Ventura,111,848112,80383,80172,3094,83266,1000
2021-04-28,Yolo,113,214977,13773,13721,298,14019,205
2021-04-28,Yuba,115,75493,5870,5857,126,5983,44
2021-04-27,Alameda,1,1643700,86472,86301,1993,88294,1260
2021-04-27,Alpine,3,1148,88,88,0,88,0
2021-04-27,Amador,5,37829,3649,3645,35,3680,46
2021-04-27,Butte,7,227075,12059,11738,1833,13571,196
2021-04-27,Calaveras,9,45235,2092,2076,14,2090,50
2021-04-27,Colusa,11,21464,1918,1926,301,2227,14
2021-04-27,Contra Costa,13,1133247,67987,67470,1277,68747,791
2021-04-27,Del Norte,15,27424,1284,1266,6,1272,6
2021-04-27,El Dorado,17,186661,9907,9866,739,10605,106
2021-04-27,Fresno,19,978130,100744,101138,8906,110044,1663
2021-04-27,Glenn,21,27897,2370,2368,556,2924,17
2021-04-27,Humboldt,23,135768,3822,3780,47,3827,35
2021-04-27,Imperial,25,180216,28171,28149,2826,30975,720
2021-04-27,Inyo,27,18085,1399,1396,2,1398,36
2021-04-27,Kern,29,883053,95896,95466,11063,106529,1295
2021-04-27,Kings,31,150075,22786,22759,1169,23928,244
2021-04-27,Lake,33,64148,3448,3431,9,3440,43
2021-04-27,Lassen,35,31185,5160,5137,110,5247,1
2021-04-27,Los Angeles,37,10098052,1195939,1191504,43422,1234926,23825
2021-04-27,Madera,39,155013,16385,16365,942,17307,235
2021-04-27,Marin,41,260295,13877,13855,245,14100,227
2021-04-27,Mariposa,43,17540,417,413,12,425,5
2021-04-27,Mendocino,45,87422,3803,3765,67,3832,46
2021-04-27,Merced,47,269075,30586,30620,994,31614,443
2021-04-27,Modoc,49,8938,365,360,122,482,3
2021-04-27,Mono,51,14174,1235,1257,14,1271,3
2021-04-27,Monterey,53,433212,42777,42752,1908,44660,379
2021-04-27,Napa,55,140530,9771,9774,33,9807,81
2021-04-27,Nevada,57,99092,4642,4557,193,4750,70
2021-04-27,Orange,59,3164182,253162,252667,11540,264207,4925
2021-04-27,Placer,61,380077,22550,22050,1475,23525,285
2021-04-27,Plumas,63,18699,686,675,11,686,4
2021-04-27,Riverside,65,2383286,289409,286820,14678,301498,4405
2021-04-27,Sacramento,67,1510023,103090,102595,1735,104330,1589
2021-04-27,San Benito,69,59416,6009,6016,117,6133,63
2021-04-27,San Bernardino,71,2135413,290991,290461,9126,299587,4575
2021-04-27,San Diego,73,3302833,277030,275685,0,275685,3692
2021-04-27,San Francisco,75,870044,36150,36358,1366,37724,533
2021-04-27,San Joaquin,77,732212,71659,71104,3630,74734,1301
2021-04-27,San Luis Obispo,79,281455,20924,20841,754,21595,255
2021-04-27,San Mateo,81,765935,41805,41474,462,41936,358
2021-04-27,Santa Barbara,83,443738,34122,33973,1331,35304,448
2021-04-27,Santa Clara,85,1922200,116908,117945,777,118722,1969
2021-04-27,Santa Cruz,87,273765,16015,15905,872,16777,205
2021-04-27,Shasta,89,179085,11787,11802,1574,13376,192
2021-04-27,Sierra,91,2930,54,51,14,65,0
2021-04-27,Siskiyou,93,43540,1712,1597,324,1921,11
2021-04-27,Solano,95,438530,32049,31964,501,32465,248
2021-04-27,Sonoma,97,501317,29609,29761,321,30082,318
2021-04-27,Stanislaus,99,539301,54730,54695,6048,60743,752
2021-04-27,Sutter,101,95872,9311,9342,86,9428,110
2021-04-27,Tehama,103,63373,4929,4922,596,5518,53
2021-04-27,Trinity,105,12862,358,326,55,381,3
2021-04-27,Tulare,107,460477,49113,48744,9315,58059,832
2021-04-27,Tuolumne,109,53932,4023,4028,139,4167,58
2021-04-27,Ventura,111,848112,80354,80152,3092,83244,1000
2021-04-27,Yolo,113,214977,13760,13697,296,13993,205
2021-04-27,Yuba,115,75493,5870,5853,126,5979,44
2021-04-26,Alameda,1,1643700,86381,86230,1989,88219,1256
2021-04-26,Alpine,3,1148,88,88,0,88,0
2021-04-26,Amador,5,37829,3648,3645,35,3680,46
2021-04-26,Butte,7,227075,12035,11720,1829,13549,196
2021-04-26,Calaveras,9,45235,2083,2074,14,2088,50
2021-04-26,Colusa,11,21464,1918,1925,300,2225,14
2021-04-26,Contra Costa,13,1133247,67919,67392,1273,68665,789
2021-04-26,Del Norte,15,27424,1275,1263,6,1269,6
2021-04-26,El Dorado,17,186661,9886,9849,738,10587,106
2021-04-26,Fresno,19,978130,100689,101099,8893,109992,1662
2021-04-26,Glenn,21,27897,2368,2367,556,2923,17
2021-04-26,Humboldt,23,135768,3812,3764,46,3810,35
2021-04-26,Imperial,25,180216,28158,28148,2823,30971,720
2021-04-26,Inyo,27,18085,1398,1396,2,1398,36
2021-04-26,Kern,29,883053,95871,95429,11056,106485,1295
2021-04-26,Kings,31,150075,22783,22756,1166,23922,244
2021-04-26,Lake,33,64148,3443,3428,9,3437,43
2021-04-26,Lassen,35,31185,5160,5138,110,5248,1
2021-04-26,Los Angeles,37,10098052,1195617,1191253,43401,1234654,23802
2021-04-26,Madera,39,155013,16373,16353,941,17294,231
2021-04-26,Marin,41,260295,13862,13849,245,14094,227
2021-04-26,Mariposa,43,17540,416,410,12,422,5
2021-04-26,Mendocino,45,87422,3801,3757,67,3824,46
2021-04-26,Merced,47,269075,30569,30611,991,31602,443
2021-04-26,Modoc,49,8938,365,360,122,482,3
2021-04-26,Mono,51,14174,1235,1258,14,1272,3
2021-04-26,Monterey,53,433212,42761,42740,1907,44647,379
2021-04-26,Napa,55,140530,9759,9769,33,9802,79
2021-04-26,Nevada,57,99092,4621,4548,193,4741,70
2021-04-26,Orange,59,3164182,253078,252592,11529,264121,4919
2021-04-26,Placer,61,380077,22521,22032,1470,23502,285
2021-04-26,Plumas,63,18699,686,670,11,681,4
2021-04-26,Riverside,65,2383286,289348,286724,14669,301393,4401
2021-04-26,Sacramento,67,1510023,102918,102459,1721,104180,1587
2021-04-26,San Benito,69,59416,6007,6013,117,6130,63
2021-04-26,San Bernardino,71,2135413,290940,290394,9124,299518,4572
2021-04-26,San Diego,73,3302833,276856,275541,0,275541,3692
2021-04-26,San Francisco,75,870044,36123,36330,1364,37694,532
2021-04-26,San Joaquin,77,732212,71593,71050,3623,74673,1301
2021-04-26,San Luis Obispo,79,281455,20916,20830,753,21583,255
2021-04-26,San Mateo,81,765935,41775,41457,462,41919,357
2021-04-26,Santa Barbara,83,443738,34091,33948,1331,35279,448
2021-04-26,Santa Clara,85,1922200,116809,117874,773,118647,1968
2021-04-26,Santa Cruz,87,273765,16006,15877,872,16749,205
2021-04-26,Shasta,89,179085,11770,11787,1566,13353,192
2021-04-26,Sierra,91,2930,53,51,14,65,0
2021-04-26,Siskiyou,93,43540,1702,1592,320,1912,11
2021-04-26,Solano,95,438530,32004,31913,499,32412,247
2021-04-26,Sonoma,97,501317,29586,29755,319,30074,318
2021-04-26,Stanislaus,99,539301,54640,54638,6042,60680,744
2021-04-26,Sutter,101,95872,9306,9328,86,9414,110
2021-04-26,Tehama,103,63373,4924,4920,593,5513,53
2021-04-26,Trinity,105,12862,358,326,55,381,3
2021-04-26,Tulare,107,460477,49093,48735,9306,58041,831
2021-04-26,Tuolumne,109,53932,4022,4024,139,4163,58
2021-04-26,Ventura,111,848112,80329,80137,3089,83226,999
2021-04-26,Yolo,113,214977,13740,13684,293,13977,205
2021-04-26,Yuba,115,75493,5868,5851,126,5977,44
2021-04-25,Alameda,1,1643700,86274,86162,1982,88144,1256
2021-04-25,Alpine,3,1148,88,87,0,87,0
2021-04-25,Amador,5,37829,3647,3643,35,3678,46
2021-04-25,Butte,7,227075,12006,11709,1822,13531,196
2021-04-25,Calaveras,9,45235,2077,2072,13,2085,50
2021-04-25,Colusa,11,21464,1917,1924,300,2224,14
2021-04-25,Contra Costa,13,1133247,67827,67316,1272,68588,789
2021-04-25,Del Norte,15,27424,1269,1259,6,1265,6
2021-04-25,El Dorado,17,186661,9870,9837,736,10573,106
2021-04-25,Fresno,19,978130,100631,101061,8881,109942,1662
2021-04-25,Glenn,21,27897,2368,2366,556,2922,17
2021-04-25,Humboldt,23,135768,3799,3751,45,3796,35
2021-04-25,Imperial,25,180216,28133,28136,2819,30955,720
2021-04-25,Inyo,27,18085,1398,1396,2,1398,36
2021-04-25,Kern,29,883053,95810,95398,11042,106440,1295
2021-04-25,Kings,31,150075,22769,22755,1164,23919,244
2021-04-25,Lake,33,64148,3441,3427,9,3436,43
2021-04-25,Lassen,35,31185,5158,5138,110,5248,1
2021-04-25,Los Angeles,37,10098052,1195287,1190970,43379,1234349,23799
2021-04-25,Madera,39,155013,16361,16346,941,17287,231
2021-04-25,Marin,41,260295,13853,13852,245,14097,227
2021-04-25,Mariposa,43,17540,416,410,12,422,5
2021-04-25,Mendocino,45,87422,3794,3757,67,3824,46
2021-04-25,Merced,47,269075,30534,30586,991,31577,443
2021-04-25,Modoc,49,8938,365,360,122,482,3
2021-04-25,Mono,51,14174,1235,1257,14,1271,3
2021-04-25,Monterey,53,433212,42748,42737,1905,44642,379
2021-04-25,Napa,55,140530,9754,9762,33,9795,79
2021-04-25,Nevada,57,99092,4609,4536,193,4729,70
2021-04-25,Orange,59,3164182,253000,252531,11522,264053,4919
2021-04-25,Placer,61,380077,22474,22011,1462,23473,285
2021-04-25,Plumas,63,18699,685,670,11,681,4
2021-04-25,Riverside,65,2383286,289255,286651,14663,301314,4401
2021-04-25,Sacramento,67,1510023,102749,102319,1711,104030,1587
2021-04-25,San Benito,69,59416,6005,6014,116,6130,63
2021-04-25,San Bernardino,71,2135413,290864,290357,9116,299473,4571
2021-04-25,San Diego,73,3302833,276643,275412,0,275412,3692
2021-04-25,San Francisco,75,870044,36093,36310,1364,37674,532
2021-04-25,San Joaquin,77,732212,71498,70987,3612,74599,1301
2021-04-25,San Luis Obispo,79,281455,20897,20820,751,21571,255
2021-04-25,San Mateo,81,765935,41741,41465,461,41926,356
2021-04-25,Santa Barbara,83,443738,34065,33931,1331,35262,448
2021-04-25,Santa Clara,85,1922200,116730,117778,771,118549,1968
2021-04-25,Santa Cruz,87,273765,16000,15868,870,16738,205
2021-04-25,Shasta,89,179085,11747,11784,1558,13342,192
2021-04-25,Sierra,91,2930,53,51,14,65,0
2021-04-25,Siskiyou,93,43540,1691,1580,318,1898,11
2021-04-25,Solano,95,438530,31957,31864,491,32355,247
2021-04-25,Sonoma,97,501317,29568,29756,319,30075,318
2021-04-25,Stanislaus,99,539301,54545,54543,6033,60576,744
2021-04-25,Sutter,101,95872,9300,9326,86,9412,110
2021-04-25,Tehama,103,63373,4920,4916,591,5507,53
2021-04-25,Trinity,105,12862,358,326,55,381,3
2021-04-25,Tulare,107,460477,49078,48728,9292,58020,831
2021-04-25,Tuolumne,109,53932,4020,4022,139,4161,58
2021-04-25,Ventura,111,848112,80305,80110,3089,83199,999
2021-04-25,Yolo,113,214977,13718,13667,291,13958,205
2021-04-25,Yuba,115,75493,5865,5849,125,5974,44
2021-04-24,Alameda,1,1643700,86218,86016,1980,87996,1257
2021-04-24,Alpine,3,1148,88,86,0,86,0
2021-04-24,Amador,5,37829,3646,3640,35,3675,46
2021-04-24,Butte,7,227075,11990,11678,1820,13498,196
2021-04-24,Calaveras,9,45235,2074,2067,13,2080,50
2021-04-24,Colusa,11,21464,1916,1921,300,2221,14
2021-04-24,Contra Costa,13,1133247,67758,67222,1269,68491,789
2021-04-24,Del Norte,15,27424,1264,1255,6,1261,6
2021-04-24,El Dorado,17,186661,9859,9814,735,10549,106
2021-04-24,Fresno,19,978130,100600,100991,8874,109865,1662
2021-04-24,Glenn,21,27897,2368,2363,556,2919,17
2021-04-24,Humboldt,23,135768,3785,3722,45,3767,35
2021-04-24,Imperial,25,180216,28126,28124,2818,30942,720
2021-04-24,Inyo,27,18085,1397,1396,2,1398,36
2021-04-24,Kern,29,883053,95792,95365,11030,106395,1295
2021-04-24,Kings,31,150075,22766,22749,1164,23913,244
2021-04-24,Lake,33,64148,3440,3426,9,3435,43
2021-04-24,Lassen,35,31185,5157,5137,110,5247,1
2021-04-24,Los Angeles,37,10098052,1195065,1190603,43359,1233962,23802
2021-04-24,Madera,39,155013,16358,16338,941,17279,231
2021-04-24,Marin,41,260295,13845,13847,245,14092,227
2021-04-24,Mariposa,43,17540,416,409,12,421,5
2021-04-24,Mendocino,45,87422,3792,3754,66,3820,46
2021-04-24,Merced,47,269075,30514,30559,991,31550,443
2021-04-24,Modoc,49,8938,365,360,122,482,3
2021-04-24,Mono,51,14174,1235,1256,14,1270,3
2021-04-24,Monterey,53,433212,42736,42727,1904,44631,379
2021-04-24,Napa,55,140530,9748,9756,33,9789,79
2021-04-24,Nevada,57,99092,4602,4522,193,4715,70
2021-04-24,Orange,59,3164182,252956,252441,11517,263958,4910
2021-04-24,Placer,61,380077,22462,21983,1461,23444,285
2021-04-24,Plumas,63,18699,684,670,11,681,4
2021-04-24,Riverside,65,2383286,289187,286552,14659,301211,4400
2021-04-24,Sacramento,67,1510023,102665,102179,1704,103883,1587
2021-04-24,San Benito,69,59416,6003,6007,116,6123,63
2021-04-24,San Bernardino,71,2135413,290816,290264,9114,299378,4568
2021-04-24,San Diego,73,3302833,276539,275252,0,275252,3688
2021-04-24,San Francisco,75,870044,36064,36285,1360,37645,532
2021-04-24,San Joaquin,77,732212,71455,70911,3608,74519,1301
2021-04-24,San Luis Obispo,79,281455,20887,20797,750,21547,255
2021-04-24,San Mateo,81,765935,41728,41424,459,41883,355
2021-04-24,Santa Barbara,83,443738,34050,33911,1330,35241,448
2021-04-24,Santa Clara,85,1922200,116675,117674,769,118443,1968
2021-04-24,Santa Cruz,87,273765,15992,15840,870,16710,205
2021-04-24,Shasta,89,179085,11729,11770,1555,13325,192
2021-04-24,Sierra,91,2930,53,51,14,65,0
2021-04-24,Siskiyou,93,43540,1681,1574,317,1891,11
2021-04-24,Solano,95,438530,31934,31821,489,32310,247
2021-04-24,Sonoma,97,501317,29565,29739,319,30058,318
2021-04-24,Stanislaus,99,539301,54496,54455,6030,60485,744
2021-04-24,Sutter,101,95872,9297,9316,86,9402,110
2021-04-24,Tehama,103,63373,4915,4907,591,5498,53
2021-04-24,Trinity,105,12862,358,326,55,381,3
2021-04-24,Tulare,107,460477,49067,48705,9282,57987,830
2021-04-24,Tuolumne,109,53932,4016,4020,139,4159,58
2021-04-24,Ventura,111,848112,80292,80097,3087,83184,999
2021-04-24,Yolo,113,214977,13707,13653,291,13944,205
2021-04-24,Yuba,115,75493,5863,5837,125,5962,44
2021-04-23,Alameda,1,1643700,86147,85935,1978,87913,1256
2021-04-23,Alpine,3,1148,87,86,0,86,0
2021-04-23,Amador,5,37829,3645,3637,35,3672,46
2021-04-23,Butte,7,227075,11969,11672,1815,13487,196
2021-04-23,Calaveras,9,45235,2072,2064,13,2077,50
2021-04-23,Colusa,11,21464,1915,1921,300,2221,14
2021-04-23,Contra Costa,13,1133247,67704,67164,1265,68429,785
2021-04-23,Del Norte,15,27424,1263,1254,6,1260,6
2021-04-23,El Dorado,17,186661,9842,9788,732,10520,106
2021-04-23,Fresno,19,978130,100560,100928,8867,109795,1662
2021-04-23,Glenn,21,27897,2368,2361,555,2916,17
2021-04-23,Humboldt,23,135768,3774,3698,45,3743,35
2021-04-23,Imperial,25,180216,28111,28108,2817,30925,720
2021-04-23,Inyo,27,18085,1397,1395,2,1397,36
2021-04-23,Kern,29,883053,95767,95330,11025,106355,1295
2021-04-23,Kings,31,150075,22763,22735,1164,23899,244
2021-04-23,Lake,33,64148,3438,3425,9,3434,43
2021-04-23,Lassen,35,31185,5157,5141,110,5251,1
2021-04-23,Los Angeles,37,10098052,1194802,1190264,43333,1233597,23785
2021-04-23,Madera,39,155013,16349,16328,941,17269,231
2021-04-23,Marin,41,260295,13840,13838,245,14083,227
2021-04-23,Mariposa,43,17540,414,405,12,417,5
2021-04-23,Mendocino,45,87422,3790,3745,65,3810,46
2021-04-23,Merced,47,269075,30496,30530,991,31521,443
2021-04-23,Modoc,49,8938,365,360,122,482,3
2021-04-23,Mono,51,14174,1233,1256,14,1270,3
2021-04-23,Monterey,53,433212,42730,42722,1904,44626,377
2021-04-23,Napa,55,140530,9742,9752,33,9785,79
2021-04-23,Nevada,57,99092,4593,4510,193,4703,70
2021-04-23,Orange,59,3164182,252913,252399,11511,263910,4904
2021-04-23,Placer,61,380077,22439,21959,1460,23419,282
2021-04-23,Plumas,63,18699,683,670,11,681,4
2021-04-23,Riverside,65,2383286,289130,286456,14654,301110,4399
2021-04-23,Sacramento,67,1510023,102578,102041,1701,103742,1586
2021-04-23,San Benito,69,59416,6001,6005,116,6121,63
2021-04-23,San Bernardino,71,2135413,290767,290189,9112,299301,4568
2021-04-23,San Diego,73,3302833,276400,275097,0,275097,3684
2021-04-23,San Francisco,75,870044,36047,36252,1359,37611,532
2021-04-23,San Joaquin,77,732212,71399,70840,3605,74445,1295
2021-04-23,San Luis Obispo,79,281455,20879,20781,749,21530,255
2021-04-23,San Mateo,81,765935,41702,41386,459,41845,355
2021-04-23,Santa Barbara,83,443738,34040,33895,1328,35223,447
2021-04-23,Santa Clara,85,1922200,116614,117593,768,118361,1965
2021-04-23,Santa Cruz,87,273765,15985,15802,870,16672,205
2021-04-23,Shasta,89,179085,11722,11759,1554,13313,192
2021-04-23,Sierra,91,2930,53,51,14,65,0
2021-04-23,Siskiyou,93,43540,1669,1567,315,1882,11
2021-04-23,Solano,95,438530,31902,31784,485,32269,247
2021-04-23,Sonoma,97,501317,29551,29727,319,30046,318
2021-04-23,Stanislaus,99,539301,54433,54391,6022,60413,744
2021-04-23,Sutter,101,95872,9295,9312,86,9398,110
2021-04-23,Tehama,103,63373,4912,4906,591,5497,53
2021-04-23,Trinity,105,12862,358,326,55,381,3
2021-04-23,Tulare,107,460477,49050,48694,9274,57968,829
2021-04-23,Tuolumne,109,53932,4015,4020,139,4159,58
2021-04-23,Ventura,111,848112,80273,80095,3087,83182,996
2021-04-23,Yolo,113,214977,13696,13647,290,13937,205
2021-04-23,Yuba,115,75493,5860,5828,125,5953,44
2021-04-22,Alameda,1,1643700,86056,85829,1977,87806,1253
2021-04-22,Alpine,3,1148,87,86,0,86,0
2021-04-22,Amador,5,37829,3644,3633,35,3668,46
2021-04-22,Butte,7,227075,11955,11656,1812,13468,196
2021-04-22,Calaveras,9,45235,2070,2059,13,2072,50
2021-04-22,Colusa,11,21464,1913,1920,298,2218,14
2021-04-22,Contra Costa,13,1133247,67633,67029,1259,68288,782
2021-04-22,Del Norte,15,27424,1258,1252,6,1258,6
2021-04-22,El Dorado,17,186661,9831,9773,729,10502,106
2021-04-22,Fresno,19,978130,100516,100864,8854,109718,1657
2021-04-22,Glenn,21,27897,2367,2361,555,2916,17
2021-04-22,Humboldt,23,135768,3765,3680,45,3725,35
2021-04-22,Imperial,25,180216,28089,28096,2814,30910,720
2021-04-22,Inyo,27,18085,1396,1394,2,1396,36
2021-04-22,Kern,29,883053,95725,95292,11010,106302,1299
2021-04-22,Kings,31,150075,22753,22725,1164,23889,243
2021-04-22,Lake,33,64148,3436,3423,9,3432,43
2021-04-22,Lassen,35,31185,5157,5155,110,5265,1
2021-04-22,Los Angeles,37,10098052,1194485,1189878,43310,1233188,23762
2021-04-22,Madera,39,155013,16330,16316,941,17257,231
2021-04-22,Marin,41,260295,13832,13832,245,14077,227
2021-04-22,Mariposa,43,17540,413,403,12,415,5
2021-04-22,Mendocino,45,87422,3784,3729,65,3794,46
2021-04-22,Merced,47,269075,30462,30490,990,31480,443
2021-04-22,Modoc,49,8938,365,360,122,482,3
2021-04-22,Mono,51,14174,1233,1254,14,1268,3
2021-04-22,Monterey,53,433212,42723,42708,1902,44610,377
2021-04-22,Napa,55,140530,9732,9734,33,9767,79
2021-04-22,Nevada,57,99092,4584,4504,191,4695,70
2021-04-22,Orange,59,3164182,252842,252307,11499,263806,4898
2021-04-22,Placer,61,380077,22409,21916,1456,23372,282
2021-04-22,Plumas,63,18699,682,670,11,681,4
2021-04-22,Riverside,65,2383286,289035,286362,14645,301007,4398
2021-04-22,Sacramento,67,1510023,102429,101870,1691,103561,1585
2021-04-22,San Benito,69,59416,5997,5998,116,6114,63
2021-04-22,San Bernardino,71,2135413,290694,290125,9104,299229,4571
2021-04-22,San Diego,73,3302833,276234,275913,0,275913,3684
2021-04-22,San Francisco,75,870044,36025,36218,1356,37574,532
2021-04-22,San Joaquin,77,732212,71340,70751,3599,74350,1295
2021-04-22,San Luis Obispo,79,281455,20865,20761,749,21510,255
2021-04-22,San Mateo,81,765935,41675,41345,457,41802,355
2021-04-22,Santa Barbara,83,443738,34017,33870,1327,35197,446
2021-04-22,Santa Clara,85,1922200,116525,117457,764,118221,1954
2021-04-22,Santa Cruz,87,273765,15982,15737,869,16606,205
2021-04-22,Shasta,89,179085,11708,11738,1549,13287,192
2021-04-22,Sierra,91,2930,53,51,14,65,0
2021-04-22,Siskiyou,93,43540,1665,1564,314,1878,11
2021-04-22,Solano,95,438530,31856,31731,482,32213,247
2021-04-22,Sonoma,97,501317,29537,29705,315,30020,318
2021-04-22,Stanislaus,99,539301,54360,54313,6016,60329,744
2021-04-22,Sutter,101,95872,9291,9302,86,9388,110
2021-04-22,Tehama,103,63373,4906,4896,587,5483,53
2021-04-22,Trinity,105,12862,358,326,55,381,3
2021-04-22,Tulare,107,460477,49031,48669,9264,57933,828
2021-04-22,Tuolumne,109,53932,4011,4020,139,4159,58
2021-04-22,Ventura,111,848112,80248,80073,3082,83155,996
2021-04-22,Yolo,113,214977,13675,13616,290,13906,205
2021-04-22,Yuba,115,75493,5849,5825,125,5950,44
2021-04-21,Alameda,1,1643700,85974,85762,1975,87737,1249
2021-04-21,Alpine,3,1148,87,86,0,86,0
2021-04-21,Amador,5,37829,3641,3632,35,3667,46
2021-04-21,Butte,7,227075,11935,11643,1810,13453,196
2021-04-21,Calaveras,9,45235,2059,2057,13,2070,50
2021-04-21,Colusa,11,21464,1911,1920,297,2217,14
2021-04-21,Contra Costa,13,1133247,67567,66981,1258,68239,782
2021-04-21,Del Norte,15,27424,1254,1252,6,1258,6
2021-04-21,El Dorado,17,186661,9814,9760,727,10487,106
2021-04-21,Fresno,19,978130,100461,100838,8848,109686,1654
2021-04-21,Glenn,21,27897,2366,2361,555,2916,17
2021-04-21,Humboldt,23,135768,3745,3642,45,3687,35
2021-04-21,Imperial,25,180216,28076,28052,2813,30865,719
2021-04-21,Inyo,27,18085,1396,1392,2,1394,36
2021-04-21,Kern,29,883053,95681,95257,11000,106257,1297
2021-04-21,Kings,31,150075,22746,22713,1163,23876,243
2021-04-21,Lake,33,64148,3433,3421,9,3430,43
2021-04-21,Lassen,35,31185,5156,5156,110,5266,1
2021-04-21,Los Angeles,37,10098052,1194149,1189530,43286,1232816,23729
2021-04-21,Madera,39,155013,16325,16309,941,17250,231
2021-04-21,Marin,41,260295,13817,13822,245,14067,227
2021-04-21,Mariposa,43,17540,412,402,12,414,5
2021-04-21,Mendocino,45,87422,3782,3729,65,3794,46
2021-04-21,Merced,47,269075,30441,30471,989,31460,442
2021-04-21,Modoc,49,8938,365,360,122,482,3
2021-04-21,Mono,51,14174,1233,1254,14,1268,3
2021-04-21,Monterey,53,433212,42708,42699,1900,44599,377
2021-04-21,Napa,55,140530,9726,9727,33,9760,79
2021-04-21,Nevada,57,99092,4570,4499,191,4690,70
2021-04-21,Orange,59,3164182,252767,252243,11486,263729,4889
2021-04-21,Placer,61,380077,22380,21896,1451,23347,282
2021-04-21,Plumas,63,18699,682,670,11,681,4
2021-04-21,Riverside,65,2383286,288940,286299,14638,300937,4388
2021-04-21,Sacramento,67,1510023,102303,101803,1685,103488,1579
2021-04-21,San Benito,69,59416,5994,5998,116,6114,63
2021-04-21,San Bernardino,71,2135413,290620,290049,9101,299150,4572
2021-04-21,San Diego,73,3302833,276026,275632,0,275632,3681
2021-04-21,San Francisco,75,870044,36005,36194,1355,37549,529
2021-04-21,San Joaquin,77,732212,71286,70687,3588,74275,1295
2021-04-21,San Luis Obispo,79,281455,20850,20724,748,21472,255
2021-04-21,San Mateo,81,765935,41644,41318,456,41774,355
2021-04-21,Santa Barbara,83,443738,33998,33830,1326,35156,445
2021-04-21,Santa Clara,85,1922200,116449,117318,758,118076,1946
2021-04-21,Santa Cruz,87,273765,15973,15698,869,16567,204
2021-04-21,Shasta,89,179085,11689,11722,1546,13268,192
2021-04-21,Sierra,91,2930,53,51,14,65,0
2021-04-21,Siskiyou,93,43540,1658,1557,314,1871,11
2021-04-21,Solano,95,438530,31817,31712,481,32193,244
2021-04-21,Sonoma,97,501317,29526,29697,313,30010,318
2021-04-21,Stanislaus,99,539301,54299,54290,6010,60300,742
2021-04-21,Sutter,101,95872,9283,9297,86,9383,110
2021-04-21,Tehama,103,63373,4899,4893,586,5479,53
2021-04-21,Trinity,105,12862,358,326,55,381,3
2021-04-21,Tulare,107,460477,49016,48653,9251,57904,828
2021-04-21,Tuolumne,109,53932,4008,4019,139,4158,58
2021-04-21,Ventura,111,848112,80216,80039,3079,83118,996
2021-04-21,Yolo,113,214977,13655,13606,289,13895,200
2021-04-21,Yuba,115,75493,5842,5822,124,5946,44
2021-04-20,Alameda,1,1643700,85879,85652,1973,87625,1248
2021-04-20,Alpine,3,1148,86,85,0,85,0
2021-04-20,Amador,5,37829,3640,3631,35,3666,46
2021-04-20,Butte,7,227075,11917,11619,1808,13427,196
2021-04-20,Calaveras,9,45235,2057,2053,13,2066,50
2021-04-20,Colusa,11,21464,1911,1915,296,2211,14
2021-04-20,Contra Costa,13,1133247,67484,66889,1255,68144,782
2021-04-20,Del Norte,15,27424,1253,1250,6,1256,6
2021-04-20,El Dorado,17,186661,9786,9743,725,10468,106
2021-04-20,Fresno,19,978130,100404,100768,8838,109606,1650
2021-04-20,Glenn,21,27897,2364,2359,554,2913,17
2021-04-20,Humboldt,23,135768,3723,3612,44,3656,35
2021-04-20,Imperial,25,180216,28056,28024,2810,30834,719
2021-04-20,Inyo,27,18085,1396,1393,2,1395,36
2021-04-20,Kern,29,883053,95646,95223,10983,106206,1295
2021-04-20,Kings,31,150075,22740,22693,1160,23853,243
2021-04-20,Lake,33,64148,3431,3418,9,3427,43
2021-04-20,Lassen,35,31185,5156,5155,110,5265,1
2021-04-20,Los Angeles,37,10098052,1193808,1189256,43256,1232512,23694
2021-04-20,Madera,39,155013,16319,16301,941,17242,231
2021-04-20,Marin,41,260295,13802,13807,245,14052,227
2021-04-20,Mariposa,43,17540,411,402,12,414,5
2021-04-20,Mendocino,45,87422,3781,3726,65,3791,46
2021-04-20,Merced,47,269075,30413,30439,989,31428,441
2021-04-20,Modoc,49,8938,365,359,122,481,3
2021-04-20,Mono,51,14174,1232,1254,14,1268,3
2021-04-20,Monterey,53,433212,42697,42663,1897,44560,363
2021-04-20,Napa,55,140530,9722,9711,33,9744,79
2021-04-20,Nevada,57,99092,4553,4485,190,4675,70
2021-04-20,Orange,59,3164182,252677,252134,11475,263609,4887
2021-04-20,Placer,61,380077,22346,21846,1447,23293,282
2021-04-20,Plumas,63,18699,681,670,11,681,4
2021-04-20,Riverside,65,2383286,288847,286194,14632,300826,4388
2021-04-20,Sacramento,67,1510023,102165,101629,1677,103306,1574
2021-04-20,San Benito,69,59416,5991,5988,116,6104,63
2021-04-20,San Bernardino,71,2135413,290541,289905,9098,299003,4569
2021-04-20,San Diego,73,3302833,275796,275369,0,275369,3674
2021-04-20,San Francisco,75,870044,35986,36117,1354,37471,529
2021-04-20,San Joaquin,77,732212,71213,70590,3579,74169,1289
2021-04-20,San Luis Obispo,79,281455,20827,20691,740,21431,254
2021-04-20,San Mateo,81,765935,41613,41251,456,41707,355
2021-04-20,Santa Barbara,83,443738,33980,33803,1324,35127,445
2021-04-20,Santa Clara,85,1922200,116352,117228,753,117981,1944
2021-04-20,Santa Cruz,87,273765,15961,15647,869,16516,204
2021-04-20,Shasta,89,179085,11673,11677,1542,13219,189
2021-04-20,Sierra,91,2930,53,51,14,65,0
2021-04-20,Siskiyou,93,43540,1650,1551,313,1864,10
2021-04-20,Solano,95,438530,31762,31673,477,32150,243
2021-04-20,Sonoma,97,501317,29517,29676,311,29987,311
2021-04-20,Stanislaus,99,539301,54234,54236,5997,60233,735
2021-04-20,Sutter,101,95872,9279,9279,86,9365,109
2021-04-20,Tehama,103,63373,4894,4887,585,5472,52
2021-04-20,Trinity,105,12862,358,326,55,381,3
2021-04-20,Tulare,107,460477,48996,48650,9240,57890,831
2021-04-20,Tuolumne,109,53932,4008,4014,139,4153,58
2021-04-20,Ventura,111,848112,80188,80018,3077,83095,995
2021-04-20,Yolo,113,214977,13637,13581,287,13868,200
2021-04-20,Yuba,115,75493,5832,5814,124,5938,44
2021-04-19,Alameda,1,1643700,85757,85583,1970,87553,1247
2021-04-19,Alpine,3,1148,86,85,0,85,0
2021-04-19,Amador,5,37829,3639,3629,35,3664,46
2021-04-19,Butte,7,227075,11898,11601,1803,13404,196
2021-04-19,Calaveras,9,45235,2054,2050,13,2063,50
2021-04-19,Colusa,11,21464,1911,1913,295,2208,14
2021-04-19,Contra Costa,13,1133247,67407,66833,1252,68085,782
2021-04-19,Del Norte,15,27424,1251,1247,6,1253,6
2021-04-19,El Dorado,17,186661,9769,9726,720,10446,106
2021-04-19,Fresno,19,978130,100336,100702,8824,109526,1646
2021-04-19,Glenn,21,27897,2364,2358,553,2911,17
2021-04-19,Humboldt,23,135768,3702,3602,42,3644,35
2021-04-19,Imperial,25,180216,28036,27995,2810,30805,719
2021-04-19,Inyo,27,18085,1396,1392,2,1394,36
2021-04-19,Kern,29,883053,95618,95162,10968,106130,1290
2021-04-19,Kings,31,150075,22724,22688,1160,23848,243
2021-04-19,Lake,33,64148,3430,3416,9,3425,43
2021-04-19,Lassen,35,31185,5155,5156,110,5266,1
2021-04-19,Los Angeles,37,10098052,1193433,1188945,43229,1232174,23666
2021-04-19,Madera,39,155013,16308,16289,940,17229,231
2021-04-19,Marin,41,260295,13791,13804,244,14048,226
2021-04-19,Mariposa,43,17540,410,401,12,413,5
2021-04-19,Mendocino,45,87422,3779,3722,65,3787,46
2021-04-19,Merced,47,269075,30384,30422,988,31410,441
2021-04-19,Modoc,49,8938,365,359,122,481,3
2021-04-19,Mono,51,14174,1231,1254,14,1268,3
2021-04-19,Monterey,53,433212,42684,42642,1892,44534,356
2021-04-19,Napa,55,140530,9714,9680,33,9713,79
2021-04-19,Nevada,57,99092,4537,4477,190,4667,70
2021-04-19,Orange,59,3164182,252561,252013,11461,263474,4883
2021-04-19,Placer,61,380077,22323,21814,1443,23257,282
2021-04-19,Plumas,63,18699,681,665,11,676,4
2021-04-19,Riverside,65,2383286,288756,286087,14622,300709,4371
2021-04-19,Sacramento,67,1510023,102032,101482,1665,103147,1572
2021-04-19,San Benito,69,59416,5983,5989,116,6105,63
2021-04-19,San Bernardino,71,2135413,290457,289738,9092,298830,4561
2021-04-19,San Diego,73,3302833,275548,275113,0,275113,3674
2021-04-19,San Francisco,75,870044,35951,36094,1351,37445,529
2021-04-19,San Joaquin,77,732212,71134,70514,3571,74085,1289
2021-04-19,San Luis Obispo,79,281455,20800,20669,734,21403,254
2021-04-19,San Mateo,81,765935,41581,41226,455,41681,355
2021-04-19,Santa Barbara,83,443738,33966,33786,1324,35110,446
2021-04-19,Santa Clara,85,1922200,116242,117099,749,117848,1944
2021-04-19,Santa Cruz,87,273765,15949,15600,869,16469,204
2021-04-19,Shasta,89,179085,11658,11662,1532,13194,189
2021-04-19,Sierra,91,2930,53,51,14,65,0
2021-04-19,Siskiyou,93,43540,1640,1544,313,1857,10
2021-04-19,Solano,95,438530,31724,31643,472,32115,239
2021-04-19,Sonoma,97,501317,29498,29667,311,29978,311
2021-04-19,Stanislaus,99,539301,54158,54179,5993,60172,728
2021-04-19,Sutter,101,95872,9268,9269,86,9355,109
2021-04-19,Tehama,103,63373,4889,4878,585,5463,52
2021-04-19,Trinity,105,12862,358,326,55,381,3
2021-04-19,Tulare,107,460477,48980,48630,9227,57857,831
2021-04-19,Tuolumne,109,53932,4007,4010,139,4149,58
2021-04-19,Ventura,111,848112,80162,80000,3075,83075,996
2021-04-19,Yolo,113,214977,13625,13572,284,13856,200
2021-04-19,Yuba,115,75493,5825,5804,123,5927,44
2021-04-18,Alameda,1,1643700,85643,85481,1963,87444,1247
2021-04-18,Alpine,3,1148,86,85,0,85,0
2021-04-18,Amador,5,37829,3636,3627,35,3662,46
2021-04-18,Butte,7,227075,11880,11591,1798,13389,196
2021-04-18,Calaveras,9,45235,2050,2047,13,2060,50
2021-04-18,Colusa,11,21464,1907,1912,294,2206,14
2021-04-18,Contra Costa,13,1133247,67303,66750,1247,67997,782
2021-04-18,Del Norte,15,27424,1251,1240,6,1246,6
2021-04-18,El Dorado,17,186661,9746,9710,718,10428,106
2021-04-18,Fresno,19,978130,100279,100621,8818,109439,1646
2021-04-18,Glenn,21,27897,2359,2358,553,2911,17
2021-04-18,Humboldt,23,135768,3674,3590,42,3632,35
2021-04-18,Imperial,25,180216,28021,27991,2805,30796,719
2021-04-18,Inyo,27,18085,1395,1392,2,1394,36
2021-04-18,Kern,29,883053,95586,95129,10951,106080,1290
2021-04-18,Kings,31,150075,22715,22685,1160,23845,243
2021-04-18,Lake,33,64148,3429,3413,9,3422,43
2021-04-18,Lassen,35,31185,5152,5156,110,5266,1
2021-04-18,Los Angeles,37,10098052,1192982,1188620,43203,1231823,23648
2021-04-18,Madera,39,155013,16297,16277,939,17216,231
2021-04-18,Marin,41,260295,13784,13801,243,14044,226
2021-04-18,Mariposa,43,17540,409,400,11,411,5
2021-04-18,Mendocino,45,87422,3776,3722,65,3787,46
2021-04-18,Merced,47,269075,30348,30405,986,31391,441
2021-04-18,Modoc,49,8938,365,359,122,481,3
2021-04-18,Mono,51,14174,1231,1254,14,1268,3
2021-04-18,Monterey,53,433212,42672,42638,1891,44529,356
2021-04-18,Napa,55,140530,9698,9674,33,9707,79
2021-04-18,Nevada,57,99092,4522,4464,190,4654,70
2021-04-18,Orange,59,3164182,252448,251940,11453,263393,4883
2021-04-18,Placer,61,380077,22280,21783,1436,23219,282
2021-04-18,Plumas,63,18699,680,665,11,676,4
2021-04-18,Riverside,65,2383286,288667,286043,14617,300660,4371
2021-04-18,Sacramento,67,1510023,101856,101354,1659,103013,1572
2021-04-18,San Benito,69,59416,5981,5989,116,6105,63
2021-04-18,San Bernardino,71,2135413,290366,289691,9083,298774,4556
2021-04-18,San Diego,73,3302833,275269,274961,0,274961,3674
2021-04-18,San Francisco,75,870044,35916,36073,1347,37420,525
2021-04-18,San Joaquin,77,732212,71053,70466,3562,74028,1289
2021-04-18,San Luis Obispo,79,281455,20779,20656,727,21383,254
2021-04-18,San Mateo,81,765935,41552,41201,454,41655,352
2021-04-18,Santa Barbara,83,443738,33932,33769,1323,35092,446
2021-04-18,Santa Clara,85,1922200,116117,116996,734,117730,1944
2021-04-18,Santa Cruz,87,273765,15939,15580,868,16448,204
2021-04-18,Shasta,89,179085,11637,11658,1529,13187,189
2021-04-18,Sierra,91,2930,53,51,14,65,0
2021-04-18,Siskiyou,93,43540,1629,1538,311,1849,10
2021-04-18,Solano,95,438530,31673,31606,471,32077,239
2021-04-18,Sonoma,97,501317,29482,29660,309,29969,311
2021-04-18,Stanislaus,99,539301,54077,54132,5984,60116,728
2021-04-18,Sutter,101,95872,9254,9261,86,9347,109
2021-04-18,Tehama,103,63373,4880,4877,584,5461,52
2021-04-18,Trinity,105,12862,358,326,54,380,3
2021-04-18,Tulare,107,460477,48968,48618,9221,57839,829
2021-04-18,Tuolumne,109,53932,4006,4008,138,4146,58
2021-04-18,Ventura,111,848112,80132,79984,3071,83055,996
2021-04-18,Yolo,113,214977,13613,13562,282,13844,200
2021-04-18,Yuba,115,75493,5818,5804,123,5927,44
2021-04-17,Alameda,1,1643700,85570,85367,1959,87326,1247
2021-04-17,Alpine,3,1148,86,85,0,85,0
2021-04-17,Amador,5,37829,3634,3625,35,3660,46
2021-04-17,Butte,7,227075,11860,11573,1794,13367,196
2021-04-17,Calaveras,9,45235,2047,2045,13,2058,50
2021-04-17,Colusa,11,21464,1907,1912,294,2206,14
2021-04-17,Contra Costa,13,1133247,67255,66657,1239,67896,782
2021-04-17,Del Norte,15,27424,1251,1238,6,1244,6
2021-04-17,El Dorado,17,186661,9731,9692,715,10407,106
2021-04-17,Fresno,19,978130,100248,100562,8810,109372,1646
2021-04-17,Glenn,21,27897,2359,2357,553,2910,17
2021-04-17,Humboldt,23,135768,3651,3579,42,3621,35
2021-04-17,Imperial,25,180216,28010,27987,2804,30791,719
2021-04-17,Inyo,27,18085,1392,1392,2,1394,36
2021-04-17,Kern,29,883053,95568,95102,10948,106050,1290
2021-04-17,Kings,31,150075,22710,22678,1159,23837,243
2021-04-17,Lake,33,64148,3428,3409,9,3418,43
2021-04-17,Lassen,35,31185,5152,5154,110,5264,1
2021-04-17,Los Angeles,37,10098052,1192728,1188262,43171,1231433,23653
2021-04-17,Madera,39,155013,16293,16260,938,17198,231
2021-04-17,Marin,41,260295,13780,13797,242,14039,226
2021-04-17,Mariposa,43,17540,408,398,11,409,5
2021-04-17,Mendocino,45,87422,3773,3721,65,3786,46
2021-04-17,Merced,47,269075,30333,30392,984,31376,441
2021-04-17,Modoc,49,8938,365,357,122,479,3
2021-04-17,Mono,51,14174,1231,1253,14,1267,3
2021-04-17,Monterey,53,433212,42663,42630,1889,44519,356
2021-04-17,Napa,55,140530,9694,9666,33,9699,79
2021-04-17,Nevada,57,99092,4514,4457,190,4647,70
2021-04-17,Orange,59,3164182,252379,251873,11441,263314,4878
2021-04-17,Placer,61,380077,22258,21736,1431,23167,282
2021-04-17,Plumas,63,18699,679,666,11,677,4
2021-04-17,Riverside,65,2383286,288598,285963,14609,300572,4371
2021-04-17,Sacramento,67,1510023,101746,101172,1647,102819,1572
2021-04-17,San Benito,69,59416,5975,5986,116,6102,63
2021-04-17,San Bernardino,71,2135413,290314,289624,9080,298704,4555
2021-04-17,San Diego,73,3302833,275122,274812,0,274812,3674
2021-04-17,San Francisco,75,870044,35895,36032,1344,37376,523
2021-04-17,San Joaquin,77,732212,71013,70372,3550,73922,1288
2021-04-17,San Luis Obispo,79,281455,20769,20642,722,21364,254
2021-04-17,San Mateo,81,765935,41529,41157,454,41611,352
2021-04-17,Santa Barbara,83,443738,33901,33738,1320,35058,446
2021-04-17,Santa Clara,85,1922200,116026,116887,729,117616,1944
2021-04-17,Santa Cruz,87,273765,15933,15571,868,16439,204
2021-04-17,Shasta,89,179085,11622,11647,1528,13175,189
2021-04-17,Sierra,91,2930,53,51,14,65,0
2021-04-17,Siskiyou,93,43540,1624,1539,310,1849,10
2021-04-17,Solano,95,438530,31642,31541,468,32009,239
2021-04-17,Sonoma,97,501317,29475,29637,309,29946,311
2021-04-17,Stanislaus,99,539301,54040,54058,5979,60037,728
2021-04-17,Sutter,101,95872,9248,9252,86,9338,109
2021-04-17,Tehama,103,63373,4874,4875,583,5458,52
2021-04-17,Trinity,105,12862,358,326,54,380,3
2021-04-17,Tulare,107,460477,48956,48603,9217,57820,829
2021-04-17,Tuolumne,109,53932,4004,4005,138,4143,58
2021-04-17,Ventura,111,848112,80112,79964,3071,83035,996
2021-04-17,Yolo,113,214977,13603,13580,282,13862,200
2021-04-17,Yuba,115,75493,5813,5802,122,5924,44
2021-04-16,Alameda,1,1643700,85491,85243,1957,87200,1245
2021-04-16,Alpine,3,1148,86,85,0,85,0
2021-04-16,Amador,5,37829,3629,3621,35,3656,46
2021-04-16,Butte,7,227075,11848,11549,1792,13341,196
2021-04-16,Calaveras,9,45235,2045,2042,13,2055,50
2021-04-16,Colusa,11,21464,1905,1911,293,2204,14
2021-04-16,Contra Costa,13,1133247,67201,66569,1236,67805,782
2021-04-16,Del Norte,15,27424,1250,1237,6,1243,6
2021-04-16,El Dorado,17,186661,9711,9665,711,10376,106
2021-04-16,Fresno,19,978130,100199,100500,8803,109303,1643
2021-04-16,Glenn,21,27897,2359,2355,553,2908,17
2021-04-16,Humboldt,23,135768,3630,3570,41,3611,35
2021-04-16,Imperial,25,180216,28000,27962,2803,30765,719
2021-04-16,Inyo,27,18085,1392,1392,2,1394,36
2021-04-16,Kern,29,883053,95539,95066,10943,106009,1288
2021-04-16,Kings,31,150075,22707,22667,1156,23823,243
2021-04-16,Lake,33,64148,3422,3406,9,3415,43
2021-04-16,Lassen,35,31185,5151,5155,110,5265,1
2021-04-16,Los Angeles,37,10098052,1192430,1187818,43132,1230950,23627
2021-04-16,Madera,39,155013,16288,16250,936,17186,231
2021-04-16,Marin,41,260295,13777,13788,242,14030,226
2021-04-16,Mariposa,43,17540,407,396,10,406,5
2021-04-16,Mendocino,45,87422,3771,3719,65,3784,46
2021-04-16,Merced,47,269075,30318,30355,984,31339,438
2021-04-16,Modoc,49,8938,365,355,122,477,3
2021-04-16,Mono,51,14174,1231,1253,14,1267,3
2021-04-16,Monterey,53,433212,42652,42620,1887,44507,351
2021-04-16,Napa,55,140530,9686,9653,33,9686,79
2021-04-16,Nevada,57,99092,4505,4443,190,4633,70
2021-04-16,Orange,59,3164182,252316,251770,11431,263201,4873
2021-04-16,Placer,61,380077,22230,21680,1425,23105,282
2021-04-16,Plumas,63,18699,678,665,11,676,4
2021-04-16,Riverside,65,2383286,288522,285818,14606,300424,4369
2021-04-16,Sacramento,67,1510023,101647,100993,1641,102634,1572
2021-04-16,San Benito,69,59416,5973,5982,116,6098,63
2021-04-16,San Bernardino,71,2135413,290267,289424,9078,298502,4550
2021-04-16,San Diego,73,3302833,274968,274567,0,274567,3662
2021-04-16,San Francisco,75,870044,35870,35993,1340,37333,517
2021-04-16,San Joaquin,77,732212,70947,70280,3541,73821,1288
2021-04-16,San Luis Obispo,79,281455,20757,20623,721,21344,253
2021-04-16,San Mateo,81,765935,41499,41107,452,41559,352
2021-04-16,Santa Barbara,83,443738,33883,33703,1320,35023,446
2021-04-16,Santa Clara,85,1922200,115926,116693,726,117419,1941
2021-04-16,Santa Cruz,87,273765,15931,15539,868,16407,204
2021-04-16,Shasta,89,179085,11610,11623,1526,13149,189
2021-04-16,Sierra,91,2930,53,51,14,65,0
2021-04-16,Siskiyou,93,43540,1620,1530,308,1838,10
2021-04-16,Solano,95,438530,31603,31470,465,31935,239
2021-04-16,Sonoma,97,501317,29464,29617,309,29926,311
2021-04-16,Stanislaus,99,539301,53992,53983,5977,59960,728
2021-04-16,Sutter,101,95872,9242,9247,86,9333,109
2021-04-16,Tehama,103,63373,4873,4866,583,5449,52
2021-04-16,Trinity,105,12862,358,326,54,380,3
2021-04-16,Tulare,107,460477,48945,48583,9214,57797,830
2021-04-16,Tuolumne,109,53932,4001,4005,138,4143,58
2021-04-16,Ventura,111,848112,80087,79942,3066,83008,994
2021-04-16,Yolo,113,214977,13590,13559,280,13839,198
2021-04-16,Yuba,115,75493,5810,5795,121,5916,44
2021-04-15,Alameda,1,1643700,85384,85089,1955,87044,1246
2021-04-15,Alpine,3,1148,86,85,0,85,0
2021-04-15,Amador,5,37829,3628,3616,35,3651,46
2021-04-15,Butte,7,227075,11833,11529,1788,13317,196
2021-04-15,Calaveras,9,45235,2044,2039,13,2052,50
2021-04-15,Colusa,11,21464,1903,1909,292,2201,14
2021-04-15,Contra Costa,13,1133247,67127,66480,1232,67712,781
2021-04-15,Del Norte,15,27424,1243,1235,6,1241,6
2021-04-15,El Dorado,17,186661,9697,9639,709,10348,106
2021-04-15,Fresno,19,978130,100140,100431,8796,109227,1642
2021-04-15,Glenn,21,27897,2359,2354,553,2907,17
2021-04-15,Humboldt,23,135768,3609,3561,41,3602,35
2021-04-15,Imperial,25,180216,27972,27920,2800,30720,718
2021-04-15,Inyo,27,18085,1392,1393,2,1395,36
2021-04-15,Kern,29,883053,95509,94989,10928,105917,1289
2021-04-15,Kings,31,150075,22693,22648,1156,23804,242
2021-04-15,Lake,33,64148,3421,3399,9,3408,43
2021-04-15,Lassen,35,31185,5150,5152,110,5262,1
2021-04-15,Los Angeles,37,10098052,1192037,1187274,43092,1230366,23598
2021-04-15,Madera,39,155013,16273,16234,936,17170,231
2021-04-15,Marin,41,260295,13773,13783,241,14024,226
2021-04-15,Mariposa,43,17540,405,395,10,405,5
2021-04-15,Mendocino,45,87422,3770,3714,65,3779,46
2021-04-15,Merced,47,269075,30292,30325,983,31308,437
2021-04-15,Modoc,49,8938,365,355,122,477,3
2021-04-15,Mono,51,14174,1230,1253,14,1267,3
2021-04-15,Monterey,53,433212,42642,42604,1885,44489,347
2021-04-15,Napa,55,140530,9678,9645,33,9678,79
2021-04-15,Nevada,57,99092,4493,4434,189,4623,70
2021-04-15,Orange,59,3164182,252221,251679,11418,263097,4857
2021-04-15,Placer,61,380077,22201,21614,1418,23032,281
2021-04-15,Plumas,63,18699,676,665,11,676,4
2021-04-15,Riverside,65,2383286,288422,285698,14599,300297,4363
2021-04-15,Sacramento,67,1510023,101519,100782,1627,102409,1570
2021-04-15,San Benito,69,59416,5970,5969,115,6084,63
2021-04-15,San Bernardino,71,2135413,290178,289288,9070,298358,4544
2021-04-15,San Diego,73,3302833,274722,274250,0,274250,3653
2021-04-15,San Francisco,75,870044,35851,35947,1337,37284,510
2021-04-15,San Joaquin,77,732212,70866,70189,3533,73722,1288
2021-04-15,San Luis Obispo,79,281455,20741,20591,718,21309,253
2021-04-15,San Mateo,81,765935,41460,41050,451,41501,352
2021-04-15,Santa Barbara,83,443738,33865,33672,1316,34988,446
2021-04-15,Santa Clara,85,1922200,115820,116602,722,117324,1927
2021-04-15,Santa Cruz,87,273765,15921,15509,868,16377,203
2021-04-15,Shasta,89,179085,11596,11597,1521,13118,191
2021-04-15,Sierra,91,2930,53,51,14,65,0
2021-04-15,Siskiyou,93,43540,1614,1524,308,1832,10
2021-04-15,Solano,95,438530,31565,31394,464,31858,239
2021-04-15,Sonoma,97,501317,29450,29587,309,29896,311
2021-04-15,Stanislaus,99,539301,53938,53918,5969,59887,728
2021-04-15,Sutter,101,95872,9235,9237,86,9323,109
2021-04-15,Tehama,103,63373,4871,4854,582,5436,52
2021-04-15,Trinity,105,12862,358,326,54,380,3
2021-04-15,Tulare,107,460477,48924,48556,9214,57770,829
2021-04-15,Tuolumne,109,53932,4001,4003,138,4141,57
2021-04-15,Ventura,111,848112,80068,79917,3064,82981,989
2021-04-15,Yolo,113,214977,13571,13547,278,13825,198
2021-04-15,Yuba,115,75493,5807,5788,121,5909,44
2021-04-14,Alameda,1,1643700,85285,85009,1954,86963,1247
2021-04-14,Alpine,3,1148,86,85,0,85,0
2021-04-14,Amador,5,37829,3627,3613,35,3648,46
2021-04-14,Butte,7,227075,11820,11513,1787,13300,196
2021-04-14,Calaveras,9,45235,2042,2037,13,2050,50
2021-04-14,Colusa,11,21464,1903,1905,292,2197,14
2021-04-14,Contra Costa,13,1133247,67041,66400,1226,67626,781
2021-04-14,Del Norte,15,27424,1243,1228,6,1234,6
2021-04-14,El Dorado,17,186661,9682,9625,704,10329,106
2021-04-14,Fresno,19,978130,100083,100376,8782,109158,1640
2021-04-14,Glenn,21,27897,2359,2353,553,2906,17
2021-04-14,Humboldt,23,135768,3587,3551,40,3591,35
2021-04-14,Imperial,25,180216,27951,27907,2797,30704,718
2021-04-14,Inyo,27,18085,1392,1392,2,1394,36
2021-04-14,Kern,29,883053,95485,94947,10921,105868,1287
2021-04-14,Kings,31,150075,22685,22641,1155,23796,243
2021-04-14,Lake,33,64148,3416,3396,9,3405,43
2021-04-14,Lassen,35,31185,5149,5151,110,5261,1
2021-04-14,Los Angeles,37,10098052,1191642,1186821,43042,1229863,23579
2021-04-14,Madera,39,155013,16264,16218,936,17154,231
2021-04-14,Marin,41,260295,13771,13768,240,14008,226
2021-04-14,Mariposa,43,17540,404,394,10,404,5
2021-04-14,Mendocino,45,87422,3765,3711,65,3776,46
2021-04-14,Merced,47,269075,30274,30296,983,31279,436
2021-04-14,Modoc,49,8938,365,355,122,477,3
2021-04-14,Mono,51,14174,1230,1252,14,1266,3
2021-04-14,Monterey,53,433212,42626,42595,1881,44476,347
2021-04-14,Napa,55,140530,9667,9643,33,9676,79
2021-04-14,Nevada,57,99092,4486,4421,189,4610,70
2021-04-14,Orange,59,3164182,252115,251568,11398,262966,4849
2021-04-14,Placer,61,380077,22168,21575,1417,22992,280
2021-04-14,Plumas,63,18699,676,665,11,676,4
2021-04-14,Riverside,65,2383286,288312,285583,14593,300176,4358
2021-04-14,Sacramento,67,1510023,101346,100645,1613,102258,1570
2021-04-14,San Benito,69,59416,5968,5960,115,6075,62
2021-04-14,San Bernardino,71,2135413,290108,289078,9067,298145,4523
2021-04-14,San Diego,73,3302833,274511,273969,0,273969,3648
2021-04-14,San Francisco,75,870044,35813,35898,1336,37234,510
2021-04-14,San Joaquin,77,732212,70797,70095,3526,73621,1288
2021-04-14,San Luis Obispo,79,281455,20717,20561,708,21269,253
2021-04-14,San Mateo,81,765935,41421,40982,447,41429,352
2021-04-14,Santa Barbara,83,443738,33836,33650,1316,34966,445
2021-04-14,Santa Clara,85,1922200,115703,116488,718,117206,1922
2021-04-14,Santa Cruz,87,273765,15911,15481,868,16349,203
2021-04-14,Shasta,89,179085,11570,11581,1518,13099,190
2021-04-14,Sierra,91,2930,53,51,14,65,0
2021-04-14,Siskiyou,93,43540,1606,1518,307,1825,10
2021-04-14,Solano,95,438530,31513,31357,456,31813,239
2021-04-14,Sonoma,97,501317,29442,29572,307,29879,311
2021-04-14,Stanislaus,99,539301,53867,53836,5960,59796,727
2021-04-14,Sutter,101,95872,9227,9230,86,9316,106
2021-04-14,Tehama,103,63373,4866,4853,580,5433,52
2021-04-14,Trinity,105,12862,358,326,54,380,3
2021-04-14,Tulare,107,460477,48898,48527,9211,57738,827
2021-04-14,Tuolumne,109,53932,4000,3997,138,4135,57
2021-04-14,Ventura,111,848112,80032,79891,3062,82953,986
2021-04-14,Yolo,113,214977,13555,13530,276,13806,198
2021-04-14,Yuba,115,75493,5805,5778,121,5899,44
2021-04-13,Alameda,1,1643700,85179,84921,1949,86870,1239
2021-04-13,Alpine,3,1148,86,85,0,85,0
2021-04-13,Amador,5,37829,3624,3609,35,3644,46
2021-04-13,Butte,7,227075,11802,11497,1783,13280,196
2021-04-13,Calaveras,9,45235,2039,2035,13,2048,50
2021-04-13,Colusa,11,21464,1901,1905,290,2195,14
2021-04-13,Contra Costa,13,1133247,66952,66304,1226,67530,778
2021-04-13,Del Norte,15,27424,1238,1221,6,1227,6
2021-04-13,El Dorado,17,186661,9656,9609,702,10311,106
2021-04-13,Fresno,19,978130,100003,100357,8777,109134,1636
2021-04-13,Glenn,21,27897,2358,2351,553,2904,17
2021-04-13,Humboldt,23,135768,3570,3540,40,3580,35
2021-04-13,Imperial,25,180216,27933,27887,2790,30677,718
2021-04-13,Inyo,27,18085,1392,1391,2,1393,36
2021-04-13,Kern,29,883053,95443,94908,10909,105817,1285
2021-04-13,Kings,31,150075,22669,22636,1154,23790,243
2021-04-13,Lake,33,64148,3413,3390,9,3399,43
2021-04-13,Lassen,35,31185,5148,5147,110,5257,1
2021-04-13,Los Angeles,37,10098052,1191192,1186482,42996,1229478,23526
2021-04-13,Madera,39,155013,16254,16207,934,17141,231
2021-04-13,Marin,41,260295,13763,13760,239,13999,224
2021-04-13,Mariposa,43,17540,403,394,7,401,5
2021-04-13,Mendocino,45,87422,3759,3702,65,3767,46
2021-04-13,Merced,47,269075,30243,30276,981,31257,435
2021-04-13,Modoc,49,8938,365,355,122,477,3
2021-04-13,Mono,51,14174,1230,1251,14,1265,3
2021-04-13,Monterey,53,433212,42615,42577,1881,44458,347
2021-04-13,Napa,55,140530,9657,9627,33,9660,79
2021-04-13,Nevada,57,99092,4474,4415,189,4604,69
2021-04-13,Orange,59,3164182,252019,251491,11380,262871,4836
2021-04-13,Placer,61,380077,22131,21534,1414,22948,280
2021-04-13,Plumas,63,18699,675,665,11,676,4
2021-04-13,Riverside,65,2383286,288195,285505,14586,300091,4348
2021-04-13,Sacramento,67,1510023,101171,100551,1607,102158,1569
2021-04-13,San Benito,69,59416,5965,5946,115,6061,62
2021-04-13,San Bernardino,71,2135413,289990,288929,9061,297990,4521
2021-04-13,San Diego,73,3302833,274257,273709,0,273709,3623
2021-04-13,San Francisco,75,870044,35777,35869,1332,37201,506
2021-04-13,San Joaquin,77,732212,70689,70034,3518,73552,1288
2021-04-13,San Luis Obispo,79,281455,20690,20536,698,21234,253
2021-04-13,San Mateo,81,765935,41376,40955,447,41402,353
2021-04-13,Santa Barbara,83,443738,33814,33613,1313,34926,444
2021-04-13,Santa Clara,85,1922200,115575,116363,716,117079,1923
2021-04-13,Santa Cruz,87,273765,15904,15449,868,16317,203
2021-04-13,Shasta,89,179085,11550,11536,1515,13051,189
2021-04-13,Sierra,91,2930,53,51,14,65,0
2021-04-13,Siskiyou,93,43540,1598,1511,303,1814,10
2021-04-13,Solano,95,438530,31466,31335,452,31787,239
2021-04-13,Sonoma,97,501317,29435,29544,306,29850,311
2021-04-13,Stanislaus,99,539301,53795,53797,5950,59747,722
2021-04-13,Sutter,101,95872,9223,9226,86,9312,106
2021-04-13,Tehama,103,63373,4859,4850,576,5426,52
2021-04-13,Trinity,105,12862,358,326,54,380,3
2021-04-13,Tulare,107,460477,48886,48511,9207,57718,825
2021-04-13,Tuolumne,109,53932,3998,3995,138,4133,57
2021-04-13,Ventura,111,848112,80000,79854,3060,82914,986
2021-04-13,Yolo,113,214977,13543,13516,275,13791,198
2021-04-13,Yuba,115,75493,5796,5776,121,5897,44
2021-04-12,Alameda,1,1643700,85076,84817,1948,86765,1238
2021-04-12,Alpine,3,1148,86,85,0,85,0
2021-04-12,Amador,5,37829,3623,3607,35,3642,46
2021-04-12,Butte,7,227075,11787,11488,1779,13267,193
2021-04-12,Calaveras,9,45235,2037,2033,13,2046,50
2021-04-12,Colusa,11,21464,1899,1904,288,2192,14
2021-04-12,Contra Costa,13,1133247,66872,66176,1226,67402,777
2021-04-12,Del Norte,15,27424,1235,1216,6,1222,6
2021-04-12,El Dorado,17,186661,9639,9588,700,10288,106
2021-04-12,Fresno,19,978130,99942,100277,8753,109030,1633
2021-04-12,Glenn,21,27897,2357,2349,553,2902,17
2021-04-12,Humboldt,23,135768,3556,3533,31,3564,35
2021-04-12,Imperial,25,180216,27904,27851,2787,30638,717
2021-04-12,Inyo,27,18085,1392,1390,2,1392,36
2021-04-12,Kern,29,883053,95411,94861,10897,105758,1283
2021-04-12,Kings,31,150075,22661,22621,1153,23774,241
2021-04-12,Lake,33,64148,3409,3380,9,3389,43
2021-04-12,Lassen,35,31185,5147,5147,110,5257,1
2021-04-12,Los Angeles,37,10098052,1190697,1186145,42954,1229099,23505
2021-04-12,Madera,39,155013,16243,16174,932,17106,231
2021-04-12,Marin,41,260295,13751,13751,236,13987,224
2021-04-12,Mariposa,43,17540,402,394,7,401,5
2021-04-12,Mendocino,45,87422,3758,3699,65,3764,46
2021-04-12,Merced,47,269075,30211,30261,979,31240,435
2021-04-12,Modoc,49,8938,363,352,122,474,3
2021-04-12,Mono,51,14174,1230,1251,14,1265,3
2021-04-12,Monterey,53,433212,42601,42555,1879,44434,346
2021-04-12,Napa,55,140530,9643,9603,33,9636,80
2021-04-12,Nevada,57,99092,4463,4408,189,4597,69
2021-04-12,Orange,59,3164182,251933,251350,11359,262709,4826
2021-04-12,Placer,61,380077,22083,21475,1408,22883,278
2021-04-12,Plumas,63,18699,673,666,11,677,4
2021-04-12,Riverside,65,2383286,288088,285361,14580,299941,4336
2021-04-12,Sacramento,67,1510023,100998,100394,1602,101996,1566
2021-04-12,San Benito,69,59416,5957,5942,114,6056,62
2021-04-12,San Bernardino,71,2135413,289880,288736,9049,297785,4493
2021-04-12,San Diego,73,3302833,273998,273431,0,273431,3621
2021-04-12,San Francisco,75,870044,35745,35841,1330,37171,506
2021-04-12,San Joaquin,77,732212,70618,69968,3509,73477,1288
2021-04-12,San Luis Obispo,79,281455,20646,20515,684,21199,253
2021-04-12,San Mateo,81,765935,41334,40920,443,41363,353
2021-04-12,Santa Barbara,83,443738,33783,33606,1312,34918,444
2021-04-12,Santa Clara,85,1922200,115447,116252,714,116966,1923
2021-04-12,Santa Cruz,87,273765,15885,15406,868,16274,203
2021-04-12,Shasta,89,179085,11533,11509,1508,13017,189
2021-04-12,Sierra,91,2930,53,51,14,65,0
2021-04-12,Siskiyou,93,43540,1587,1511,301,1812,7
2021-04-12,Solano,95,438530,31425,31305,449,31754,238
2021-04-12,Sonoma,97,501317,29406,29500,306,29806,310
2021-04-12,Stanislaus,99,539301,53730,53722,5943,59665,707
2021-04-12,Sutter,101,95872,9212,9221,86,9307,106
2021-04-12,Tehama,103,63373,4850,4834,572,5406,52
2021-04-12,Trinity,105,12862,358,324,54,378,3
2021-04-12,Tulare,107,460477,48867,48495,9197,57692,824
2021-04-12,Tuolumne,109,53932,3994,3993,129,4122,57
2021-04-12,Ventura,111,848112,79967,79818,3058,82876,985
2021-04-12,Yolo,113,214977,13529,13510,274,13784,198
2021-04-12,Yuba,115,75493,5790,5773,121,5894,43
2021-04-11,Alameda,1,1643700,84939,84756,1943,86699,1238
2021-04-11,Alpine,3,1148,86,85,0,85,0
2021-04-11,Amador,5,37829,3621,3605,35,3640,46
2021-04-11,Butte,7,227075,11752,11487,1776,13263,193
2021-04-11,Calaveras,9,45235,2032,2036,13,2049,50
2021-04-11,Colusa,11,21464,1898,1904,287,2191,14
2021-04-11,Contra Costa,13,1133247,66763,66107,1223,67330,777
2021-04-11,Del Norte,15,27424,1229,1214,6,1220,6
2021-04-11,El Dorado,17,186661,9625,9575,697,10272,106
2021-04-11,Fresno,19,978130,99876,100230,8741,108971,1633
2021-04-11,Glenn,21,27897,2353,2348,552,2900,17
2021-04-11,Humboldt,23,135768,3547,3523,31,3554,35
2021-04-11,Imperial,25,180216,27880,27841,2785,30626,717
2021-04-11,Inyo,27,18085,1392,1390,2,1392,36
2021-04-11,Kern,29,883053,95354,94830,10888,105718,1283
2021-04-11,Kings,31,150075,22652,22618,1150,23768,241
2021-04-11,Lake,33,64148,3405,3377,9,3386,43
2021-04-11,Lassen,35,31185,5143,5147,110,5257,1
2021-04-11,Los Angeles,37,10098052,1190189,1185757,42910,1228667,23503
2021-04-11,Madera,39,155013,16225,16166,930,17096,231
2021-04-11,Marin,41,260295,13745,13741,234,13975,226
2021-04-11,Mariposa,43,17540,402,394,7,401,5
2021-04-11,Mendocino,45,87422,3756,3696,65,3761,46
2021-04-11,Merced,47,269075,30173,30249,978,31227,435
2021-04-11,Modoc,49,8938,362,352,120,472,3
2021-04-11,Mono,51,14174,1229,1250,14,1264,3
2021-04-11,Monterey,53,433212,42594,42547,1872,44419,346
2021-04-11,Napa,55,140530,9632,9592,33,9625,80
2021-04-11,Nevada,57,99092,4449,4394,189,4583,69
2021-04-11,Orange,59,3164182,251808,251233,11346,262579,4826
2021-04-11,Placer,61,380077,22026,21458,1403,22861,278
2021-04-11,Plumas,63,18699,673,666,11,677,4
2021-04-11,Riverside,65,2383286,287961,285269,14568,299837,4336
2021-04-11,Sacramento,67,1510023,100829,100296,1588,101884,1566
2021-04-11,San Benito,69,59416,5949,5941,113,6054,62
2021-04-11,San Bernardino,71,2135413,289771,288686,9042,297728,4492
2021-04-11,San Diego,73,3302833,273701,273287,0,273287,3621
2021-04-11,San Francisco,75,870044,35709,35815,1327,37142,498
2021-04-11,San Joaquin,77,732212,70530,69939,3498,73437,1288
2021-04-11,San Luis Obispo,79,281455,20620,20501,681,21182,253
2021-04-11,San Mateo,81,765935,41276,40901,442,41343,353
2021-04-11,Santa Barbara,83,443738,33749,33591,1310,34901,444
2021-04-11,Santa Clara,85,1922200,115313,116161,711,116872,1923
2021-04-11,Santa Cruz,87,273765,15873,15382,868,16250,203
2021-04-11,Shasta,89,179085,11489,11504,1506,13010,189
2021-04-11,Sierra,91,2930,53,51,14,65,0
2021-04-11,Siskiyou,93,43540,1581,1509,297,1806,7
2021-04-11,Solano,95,438530,31373,31268,445,31713,238
2021-04-11,Sonoma,97,501317,29380,29496,302,29798,310
2021-04-11,Stanislaus,99,539301,53648,53683,5933,59616,707
2021-04-11,Sutter,101,95872,9203,9222,86,9308,106
2021-04-11,Tehama,103,63373,4847,4832,569,5401,52
2021-04-11,Trinity,105,12862,358,324,54,378,3
2021-04-11,Tulare,107,460477,48853,48479,9190,57669,824
2021-04-11,Tuolumne,109,53932,3992,3993,129,4122,57
2021-04-11,Ventura,111,848112,79921,79800,3051,82851,985
2021-04-11,Yolo,113,214977,13508,13496,272,13768,198
2021-04-11,Yuba,115,75493,5780,5768,121,5889,43
2021-04-10,Alameda,1,1643700,84874,84626,1943,86569,1238
2021-04-10,Alpine,3,1148,86,85,0,85,0
2021-04-10,Amador,5,37829,3619,3603,35,3638,46
2021-04-10,Butte,7,227075,11741,11482,1775,13257,193
2021-04-10,Calaveras,9,45235,2032,2032,13,2045,50
2021-04-10,Colusa,11,21464,1898,1902,287,2189,14
2021-04-10,Contra Costa,13,1133247,66702,66001,1220,67221,778
2021-04-10,Del Norte,15,27424,1226,1212,6,1218,6
2021-04-10,El Dorado,17,186661,9613,9549,694,10243,106
2021-04-10,Fresno,19,978130,99843,100135,8734,108869,1633
2021-04-10,Glenn,21,27897,2353,2343,552,2895,17
2021-04-10,Humboldt,23,135768,3537,3508,31,3539,35
2021-04-10,Imperial,25,180216,27866,27816,2785,30601,717
2021-04-10,Inyo,27,18085,1392,1387,2,1389,36
2021-04-10,Kern,29,883053,95340,94802,10882,105684,1284
2021-04-10,Kings,31,150075,22648,22614,1148,23762,241
2021-04-10,Lake,33,64148,3400,3368,9,3377,43
2021-04-10,Lassen,35,31185,5143,5146,109,5255,1
2021-04-10,Los Angeles,37,10098052,1189920,1185246,42890,1228136,23493
2021-04-10,Madera,39,155013,16217,16143,929,17072,231
2021-04-10,Marin,41,260295,13740,13731,234,13965,226
2021-04-10,Mariposa,43,17540,399,393,7,400,5
2021-04-10,Mendocino,45,87422,3754,3696,65,3761,46
2021-04-10,Merced,47,269075,30152,30225,978,31203,435
2021-04-10,Modoc,49,8938,362,352,120,472,3
2021-04-10,Mono,51,14174,1229,1249,14,1263,3
2021-04-10,Monterey,53,433212,42583,42527,1871,44398,346
2021-04-10,Napa,55,140530,9625,9569,33,9602,79
2021-04-10,Nevada,57,99092,4442,4379,189,4568,69
2021-04-10,Orange,59,3164182,251715,251139,11337,262476,4818
2021-04-10,Placer,61,380077,21995,21402,1397,22799,278
2021-04-10,Plumas,63,18699,673,666,11,677,4
2021-04-10,Riverside,65,2383286,287883,285082,14560,299642,4336
2021-04-10,Sacramento,67,1510023,100727,100048,1586,101634,1566
2021-04-10,San Benito,69,59416,5938,5932,112,6044,62
2021-04-10,San Bernardino,71,2135413,289710,288590,9035,297625,4489
2021-04-10,San Diego,73,3302833,273485,273058,0,273058,3613
2021-04-10,San Francisco,75,870044,35679,35774,1323,37097,498
2021-04-10,San Joaquin,77,732212,70494,69852,3488,73340,1288
2021-04-10,San Luis Obispo,79,281455,20605,20461,679,21140,253
2021-04-10,San Mateo,81,765935,41243,40878,442,41320,350
2021-04-10,Santa Barbara,83,443738,33721,33541,1308,34849,444
2021-04-10,Santa Clara,85,1922200,115217,116015,710,116725,1923
2021-04-10,Santa Cruz,87,273765,15867,15360,868,16228,203
2021-04-10,Shasta,89,179085,11481,11492,1502,12994,189
2021-04-10,Sierra,91,2930,53,51,14,65,0
2021-04-10,Siskiyou,93,43540,1578,1512,297,1809,7
2021-04-10,Solano,95,438530,31339,31218,441,31659,238
2021-04-10,Sonoma,97,501317,29365,29469,301,29770,310
2021-04-10,Stanislaus,99,539301,53614,53596,5926,59522,707
2021-04-10,Sutter,101,95872,9201,9214,86,9300,106
2021-04-10,Tehama,103,63373,4845,4820,567,5387,52
2021-04-10,Trinity,105,12862,358,324,54,378,3
2021-04-10,Tulare,107,460477,48844,48470,9184,57654,824
2021-04-10,Tuolumne,109,53932,3989,3991,129,4120,57
2021-04-10,Ventura,111,848112,79893,79758,3049,82807,985
2021-04-10,Yolo,113,214977,13499,13494,271,13765,198
2021-04-10,Yuba,115,75493,5777,5757,120,5877,43
2021-04-09,Alameda,1,1643700,84801,84404,1935,86339,1237
2021-04-09,Alpine,3,1148,86,85,0,85,0
2021-04-09,Amador,5,37829,3618,3600,35,3635,46
2021-04-09,Butte,7,227075,11731,11454,1774,13228,193
2021-04-09,Calaveras,9,45235,2031,2028,13,2041,50
2021-04-09,Colusa,11,21464,1898,1898,287,2185,14
2021-04-09,Contra Costa,13,1133247,66609,65857,1214,67071,777
2021-04-09,Del Norte,15,27424,1225,1207,6,1213,6
2021-04-09,El Dorado,17,186661,9591,9528,689,10217,106
2021-04-09,Fresno,19,978130,99809,100027,8729,108756,1630
2021-04-09,Glenn,21,27897,2353,2337,552,2889,17
2021-04-09,Humboldt,23,135768,3527,3496,31,3527,35
2021-04-09,Imperial,25,180216,27851,27764,2783,30547,717
2021-04-09,Inyo,27,18085,1391,1386,2,1388,36
2021-04-09,Kern,29,883053,95303,94675,10879,105554,1282
2021-04-09,Kings,31,150075,22639,22595,1142,23737,242
2021-04-09,Lake,33,64148,3396,3362,9,3371,43
2021-04-09,Lassen,35,31185,5143,5140,109,5249,1
2021-04-09,Los Angeles,37,10098052,1189557,1184501,42858,1227359,23458
2021-04-09,Madera,39,155013,16214,16118,929,17047,231
2021-04-09,Marin,41,260295,13733,13721,234,13955,226
2021-04-09,Mariposa,43,17540,399,393,7,400,5
2021-04-09,Mendocino,45,87422,3752,3693,65,3758,46
2021-04-09,Merced,47,269075,30123,30179,977,31156,435
2021-04-09,Modoc,49,8938,361,352,120,472,3
2021-04-09,Mono,51,14174,1229,1247,14,1261,3
2021-04-09,Monterey,53,433212,42574,42481,1867,44348,344
2021-04-09,Napa,55,140530,9606,9574,33,9607,80
2021-04-09,Nevada,57,99092,4434,4373,189,4562,69
2021-04-09,Orange,59,3164182,251642,250852,11332,262184,4813
2021-04-09,Placer,61,380077,21964,21327,1389,22716,278
2021-04-09,Plumas,63,18699,672,666,11,677,4
2021-04-09,Riverside,65,2383286,287801,284562,14553,299115,4325
2021-04-09,Sacramento,67,1510023,100572,99722,1578,101300,1564
2021-04-09,San Benito,69,59416,5933,5925,111,6036,62
2021-04-09,San Bernardino,71,2135413,289639,288000,9031,297031,4467
2021-04-09,San Diego,73,3302833,273287,272697,0,272697,3600
2021-04-09,San Francisco,75,870044,35637,35716,1318,37034,497
2021-04-09,San Joaquin,77,732212,70431,69675,3476,73151,1281
2021-04-09,San Luis Obispo,79,281455,20592,20427,677,21104,252
2021-04-09,San Mateo,81,765935,41207,40800,441,41241,350
2021-04-09,Santa Barbara,83,443738,33698,33424,1305,34729,444
2021-04-09,Santa Clara,85,1922200,115133,115749,708,116457,1923
2021-04-09,Santa Cruz,87,273765,15862,15331,868,16199,203
2021-04-09,Shasta,89,179085,11471,11478,1499,12977,188
2021-04-09,Sierra,91,2930,53,51,14,65,0
2021-04-09,Siskiyou,93,43540,1575,1510,296,1806,7
2021-04-09,Solano,95,438530,31306,31166,436,31602,238
2021-04-09,Sonoma,97,501317,29351,29433,301,29734,310
2021-04-09,Stanislaus,99,539301,53559,53504,5917,59421,705
2021-04-09,Sutter,101,95872,9194,9201,86,9287,106
2021-04-09,Tehama,103,63373,4839,4806,567,5373,52
2021-04-09,Trinity,105,12862,357,324,54,378,3
2021-04-09,Tulare,107,460477,48840,48430,9178,57608,824
2021-04-09,Tuolumne,109,53932,3988,3986,129,4115,57
2021-04-09,Ventura,111,848112,79865,79698,3049,82747,987
2021-04-09,Yolo,113,214977,13488,13478,269,13747,198
2021-04-09,Yuba,115,75493,5770,5754,120,5874,43
2021-04-08,Alameda,1,1643700,84700,84213,1931,86144,1232
2021-04-08,Alpine,3,1148,86,85,0,85,0
2021-04-08,Amador,5,37829,3614,3595,35,3630,46
2021-04-08,Butte,7,227075,11720,11414,1773,13187,193
2021-04-08,Calaveras,9,45235,2029,2027,13,2040,50
2021-04-08,Colusa,11,21464,1897,1897,287,2184,14
2021-04-08,Contra Costa,13,1133247,66499,65706,1211,66917,775
2021-04-08,Del Norte,15,27424,1219,1201,6,1207,6
2021-04-08,El Dorado,17,186661,9575,9513,683,10196,106
2021-04-08,Fresno,19,978130,99746,99935,8721,108656,1627
2021-04-08,Glenn,21,27897,2351,2337,552,2889,17
2021-04-08,Humboldt,23,135768,3517,3486,30,3516,35
2021-04-08,Imperial,25,180216,27824,27744,2780,30524,713
2021-04-08,Inyo,27,18085,1390,1386,2,1388,36
2021-04-08,Kern,29,883053,95260,94493,10865,105358,1281
2021-04-08,Kings,31,150075,22633,22589,1139,23728,243
2021-04-08,Lake,33,64148,3390,3360,9,3369,43
2021-04-08,Lassen,35,31185,5142,5136,109,5245,1
2021-04-08,Los Angeles,37,10098052,1189060,1184443,42819,1227262,23416
2021-04-08,Madera,39,155013,16202,16103,929,17032,231
2021-04-08,Marin,41,260295,13726,13704,234,13938,226
2021-04-08,Mariposa,43,17540,398,393,7,400,5
2021-04-08,Mendocino,45,87422,3750,3690,65,3755,45
2021-04-08,Merced,47,269075,30101,30163,977,31140,430
2021-04-08,Modoc,49,8938,361,352,120,472,3
2021-04-08,Mono,51,14174,1227,1247,14,1261,3
2021-04-08,Monterey,53,433212,42553,42437,1862,44299,342
2021-04-08,Napa,55,140530,9589,9569,33,9602,80
2021-04-08,Nevada,57,99092,4423,4367,189,4556,69
2021-04-08,Orange,59,3164182,251535,250529,11316,261845,4797
2021-04-08,Placer,61,380077,21924,21258,1380,22638,277
2021-04-08,Plumas,63,18699,672,665,11,676,4
2021-04-08,Riverside,65,2383286,287690,283853,14548,298401,4296
2021-04-08,Sacramento,67,1510023,100429,99319,1566,100885,1561
2021-04-08,San Benito,69,59416,5930,5914,109,6023,62
2021-04-08,San Bernardino,71,2135413,289540,287190,9028,296218,4445
2021-04-08,San Diego,73,3302833,273058,272495,0,272495,3592
2021-04-08,San Francisco,75,870044,35614,35657,1317,36974,494
2021-04-08,San Joaquin,77,732212,70361,69479,3470,72949,1279
2021-04-08,San Luis Obispo,79,281455,20573,20402,674,21076,252
2021-04-08,San Mateo,81,765935,41168,40749,441,41190,350
2021-04-08,Santa Barbara,83,443738,33674,33309,1304,34613,444
2021-04-08,Santa Clara,85,1922200,115028,115487,707,116194,1905
2021-04-08,Santa Cruz,87,273765,15856,15296,868,16164,203
2021-04-08,Shasta,89,179085,11461,11466,1495,12961,186
2021-04-08,Sierra,91,2930,53,51,14,65,0
2021-04-08,Siskiyou,93,43540,1572,1511,296,1807,7
2021-04-08,Solano,95,438530,31257,31120,436,31556,238
2021-04-08,Sonoma,97,501317,29331,29410,300,29710,310
2021-04-08,Stanislaus,99,539301,53481,53401,5907,59308,706
2021-04-08,Sutter,101,95872,9190,9195,86,9281,106
2021-04-08,Tehama,103,63373,4835,4802,567,5369,52
2021-04-08,Trinity,105,12862,357,324,54,378,3
2021-04-08,Tulare,107,460477,48827,48409,9167,57576,821
2021-04-08,Tuolumne,109,53932,3988,3986,129,4115,57
2021-04-08,Ventura,111,848112,79828,79626,3045,82671,986
2021-04-08,Yolo,113,214977,13479,13468,268,13736,198
2021-04-08,Yuba,115,75493,5766,5743,120,5863,43
2021-04-07,Alameda,1,1643700,84616,84130,1927,86057,1224
2021-04-07,Alpine,3,1148,86,85,0,85,0
2021-04-07,Amador,5,37829,3611,3590,35,3625,46
2021-04-07,Butte,7,227075,11716,11405,1770,13175,193
2021-04-07,Calaveras,9,45235,2025,2022,13,2035,50
2021-04-07,Colusa,11,21464,1893,1894,286,2180,14
2021-04-07,Contra Costa,13,1133247,66413,65619,1210,66829,775
2021-04-07,Del Norte,15,27424,1217,1198,6,1204,6
2021-04-07,El Dorado,17,186661,9554,9500,678,10178,106
2021-04-07,Fresno,19,978130,99683,99865,8709,108574,1627
2021-04-07,Glenn,21,27897,2348,2337,551,2888,17
2021-04-07,Humboldt,23,135768,3505,3484,30,3514,35
2021-04-07,Imperial,25,180216,27800,27704,2773,30477,713
2021-04-07,Inyo,27,18085,1389,1386,2,1388,36
2021-04-07,Kern,29,883053,95226,94456,10850,105306,1275
2021-04-07,Kings,31,150075,22631,22589,1139,23728,243
2021-04-07,Lake,33,64148,3388,3358,9,3367,43
2021-04-07,Lassen,35,31185,5142,5137,109,5246,1
2021-04-07,Los Angeles,37,10098052,1188628,1183862,42794,1226656,23372
2021-04-07,Madera,39,155013,16183,16090,928,17018,231
2021-04-07,Marin,41,260295,13715,13688,232,13920,225
2021-04-07,Mariposa,43,17540,397,391,7,398,5
2021-04-07,Mendocino,45,87422,3749,3691,65,3756,45
2021-04-07,Merced,47,269075,30078,30132,972,31104,430
2021-04-07,Modoc,49,8938,361,351,120,471,3
2021-04-07,Mono,51,14174,1227,1246,14,1260,3
2021-04-07,Monterey,53,433212,42535,42427,1861,44288,341
2021-04-07,Napa,55,140530,9575,9556,33,9589,80
2021-04-07,Nevada,57,99092,4417,4364,189,4553,69
2021-04-07,Orange,59,3164182,251413,250378,11292,261670,4778
2021-04-07,Placer,61,380077,21878,21227,1372,22599,276
2021-04-07,Plumas,63,18699,672,665,11,676,4
2021-04-07,Riverside,65,2383286,287581,283749,14538,298287,4285
2021-04-07,Sacramento,67,1510023,100263,99202,1560,100762,1544
2021-04-07,San Benito,69,59416,5925,5912,108,6020,62
2021-04-07,San Bernardino,71,2135413,289423,286978,9023,296001,4433
2021-04-07,San Diego,73,3302833,272833,272195,0,272195,3588
2021-04-07,San Francisco,75,870044,35574,35618,1312,36930,493
2021-04-07,San Joaquin,77,732212,70293,69375,3464,72839,1278
2021-04-07,San Luis Obispo,79,281455,20547,20373,671,21044,252
2021-04-07,San Mateo,81,765935,41125,40693,441,41134,350
2021-04-07,Santa Barbara,83,443738,33649,33289,1301,34590,444
2021-04-07,Santa Clara,85,1922200,114898,115311,705,116016,1900
2021-04-07,Santa Cruz,87,273765,15846,15275,867,16142,203
2021-04-07,Shasta,89,179085,11449,11456,1487,12943,184
2021-04-07,Sierra,91,2930,53,51,14,65,0
2021-04-07,Siskiyou,93,43540,1566,1512,295,1807,7
2021-04-07,Solano,95,438530,31207,31097,435,31532,238
2021-04-07,Sonoma,97,501317,29312,29394,299,29693,310
2021-04-07,Stanislaus,99,539301,53413,53344,5898,59242,686
2021-04-07,Sutter,101,95872,9187,9188,86,9274,106
2021-04-07,Tehama,103,63373,4828,4802,563,5365,52
2021-04-07,Trinity,105,12862,357,322,54,376,3
2021-04-07,Tulare,107,460477,48814,48386,9155,57541,820
2021-04-07,Tuolumne,109,53932,3987,3982,129,4111,57
2021-04-07,Ventura,111,848112,79794,79595,3043,82638,986
2021-04-07,Yolo,113,214977,13463,13450,266,13716,198
2021-04-07,Yuba,115,75493,5762,5737,120,5857,43
2021-04-06,Alameda,1,1643700,84504,84091,1921,86012,1223
2021-04-06,Alpine,3,1148,86,85,0,85,0
2021-04-06,Amador,5,37829,3610,3587,35,3622,45
2021-04-06,Butte,7,227075,11701,11396,1769,13165,193
2021-04-06,Calaveras,9,45235,2022,2021,13,2034,50
2021-04-06,Colusa,11,21464,1891,1894,284,2178,14
2021-04-06,Contra Costa,13,1133247,66336,65575,1209,66784,774
2021-04-06,Del Norte,15,27424,1212,1197,6,1203,6
2021-04-06,El Dorado,17,186661,9524,9489,676,10165,106
2021-04-06,Fresno,19,978130,99619,99814,8701,108515,1626
2021-04-06,Glenn,21,27897,2347,2335,551,2886,17
2021-04-06,Humboldt,23,135768,3496,3477,27,3504,35
2021-04-06,Imperial,25,180216,27767,27661,2763,30424,713
2021-04-06,Inyo,27,18085,1389,1379,2,1381,36
2021-04-06,Kern,29,883053,95183,94422,10844,105266,1259
2021-04-06,Kings,31,150075,22625,22587,1139,23726,240
2021-04-06,Lake,33,64148,3385,3358,9,3367,43
2021-04-06,Lassen,35,31185,5140,5137,109,5246,1
2021-04-06,Los Angeles,37,10098052,1188124,1183499,42749,1226248,23323
2021-04-06,Madera,39,155013,16164,16085,923,17008,230
2021-04-06,Marin,41,260295,13706,13675,229,13904,224
2021-04-06,Mariposa,43,17540,397,390,7,397,5
2021-04-06,Mendocino,45,87422,3747,3686,65,3751,45
2021-04-06,Merced,47,269075,30049,30100,967,31067,430
2021-04-06,Modoc,49,8938,360,351,120,471,3
2021-04-06,Mono,51,14174,1227,1246,14,1260,3
2021-04-06,Monterey,53,433212,42526,42412,1860,44272,341
2021-04-06,Napa,55,140530,9556,9509,33,9542,78
2021-04-06,Nevada,57,99092,4407,4356,187,4543,69
2021-04-06,Orange,59,3164182,251305,250304,11277,261581,4771
2021-04-06,Placer,61,380077,21831,21184,1369,22553,276
2021-04-06,Plumas,63,18699,672,665,11,676,4
2021-04-06,Riverside,65,2383286,287404,283622,14526,298148,4264
2021-04-06,Sacramento,67,1510023,100055,99110,1551,100661,1537
2021-04-06,San Benito,69,59416,5916,5907,108,6015,62
2021-04-06,San Bernardino,71,2135413,289311,286792,9013,295805,4428
2021-04-06,San Diego,73,3302833,272571,271867,0,271867,3585
2021-04-06,San Francisco,75,870044,35531,35572,1312,36884,488
2021-04-06,San Joaquin,77,732212,70210,69316,3451,72767,1278
2021-04-06,San Luis Obispo,79,281455,20526,20350,667,21017,252
2021-04-06,San Mateo,81,765935,41078,40649,440,41089,350
2021-04-06,Santa Barbara,83,443738,33631,33257,1300,34557,443
2021-04-06,Santa Clara,85,1922200,114728,115184,703,115887,1900
2021-04-06,Santa Cruz,87,273765,15836,15252,867,16119,203
2021-04-06,Shasta,89,179085,11428,11443,1483,12926,184
2021-04-06,Sierra,91,2930,53,51,14,65,0
2021-04-06,Siskiyou,93,43540,1562,1510,292,1802,7
2021-04-06,Solano,95,438530,31160,31078,434,31512,237
2021-04-06,Sonoma,97,501317,29287,29386,297,29683,311
2021-04-06,Stanislaus,99,539301,53355,53304,5892,59196,686
2021-04-06,Sutter,101,95872,9177,9179,86,9265,106
2021-04-06,Tehama,103,63373,4819,4798,563,5361,52
2021-04-06,Trinity,105,12862,357,321,54,375,3
2021-04-06,Tulare,107,460477,48771,48372,9152,57524,819
2021-04-06,Tuolumne,109,53932,3987,3981,129,4110,57
2021-04-06,Ventura,111,848112,79757,79556,3041,82597,983
2021-04-06,Yolo,113,214977,13450,13443,265,13708,198
2021-04-06,Yuba,115,75493,5758,5733,119,5852,43
2021-04-05,Alameda,1,1643700,84387,84007,1916,85923,1219
2021-04-05,Alpine,3,1148,86,85,0,85,0
2021-04-05,Amador,5,37829,3607,3584,35,3619,45
2021-04-05,Butte,7,227075,11686,11384,1767,13151,193
2021-04-05,Calaveras,9,45235,2019,2019,13,2032,50
2021-04-05,Colusa,11,21464,1891,1894,283,2177,14
2021-04-05,Contra Costa,13,1133247,66269,65457,1207,66664,774
2021-04-05,Del Norte,15,27424,1210,1189,6,1195,6
2021-04-05,El Dorado,17,186661,9509,9463,676,10139,106
2021-04-05,Fresno,19,978130,99533,99755,8691,108446,1622
2021-04-05,Glenn,21,27897,2346,2335,551,2886,17
2021-04-05,Humboldt,23,135768,3487,3475,26,3501,35
2021-04-05,Imperial,25,180216,27736,27604,2756,30360,710
2021-04-05,Inyo,27,18085,1386,1377,2,1379,36
2021-04-05,Kern,29,883053,95129,94401,10818,105219,1249
2021-04-05,Kings,31,150075,22621,22580,1139,23719,239
2021-04-05,Lake,33,64148,3377,3359,9,3368,43
2021-04-05,Lassen,35,31185,5140,5138,108,5246,1
2021-04-05,Los Angeles,37,10098052,1187591,1183200,42697,1225897,23302
2021-04-05,Madera,39,155013,16150,16065,922,16987,230
2021-04-05,Marin,41,260295,13692,13666,225,13891,221
2021-04-05,Mariposa,43,17540,397,390,7,397,5
2021-04-05,Mendocino,45,87422,3745,3687,65,3752,45
2021-04-05,Merced,47,269075,30022,30068,966,31034,427
2021-04-05,Modoc,49,8938,358,346,120,466,3
2021-04-05,Mono,51,14174,1227,1246,14,1260,3
2021-04-05,Monterey,53,433212,42513,42396,1856,44252,341
2021-04-05,Napa,55,140530,9533,9492,33,9525,78
2021-04-05,Nevada,57,99092,4396,4346,187,4533,69
2021-04-05,Orange,59,3164182,251192,250177,11253,261430,4759
2021-04-05,Placer,61,380077,21785,21133,1361,22494,276
2021-04-05,Plumas,63,18699,672,666,11,677,4
2021-04-05,Riverside,65,2383286,287273,283549,14514,298063,4237
2021-04-05,Sacramento,67,1510023,99894,98908,1543,100451,1533
2021-04-05,San Benito,69,59416,5910,5904,108,6012,61
2021-04-05,San Bernardino,71,2135413,289199,286597,9010,295607,4425
2021-04-05,San Diego,73,3302833,272323,271655,0,271655,3583
2021-04-05,San Francisco,75,870044,35501,35538,1312,36850,488
2021-04-05,San Joaquin,77,732212,70123,69214,3441,72655,1268
2021-04-05,San Luis Obispo,79,281455,20489,20333,667,21000,252
2021-04-05,San Mateo,81,765935,41035,40609,439,41048,350
2021-04-05,Santa Barbara,83,443738,33599,33235,1300,34535,443
2021-04-05,Santa Clara,85,1922200,114563,115091,700,115791,1893
2021-04-05,Santa Cruz,87,273765,15829,15228,867,16095,201
2021-04-05,Shasta,89,179085,11409,11435,1477,12912,184
2021-04-05,Sierra,91,2930,53,50,14,64,0
2021-04-05,Siskiyou,93,43540,1559,1509,290,1799,7
2021-04-05,Solano,95,438530,31120,31026,432,31458,237
2021-04-05,Sonoma,97,501317,29256,29361,295,29656,311
2021-04-05,Stanislaus,99,539301,53275,53238,5889,59127,686
2021-04-05,Sutter,101,95872,9170,9169,86,9255,106
2021-04-05,Tehama,103,63373,4813,4794,563,5357,52
2021-04-05,Trinity,105,12862,356,321,54,375,3
2021-04-05,Tulare,107,460477,48759,48356,9145,57501,818
2021-04-05,Tuolumne,109,53932,3986,3980,101,4081,57
2021-04-05,Ventura,111,848112,79727,79549,3037,82586,983
2021-04-05,Yolo,113,214977,13436,13427,264,13691,198
2021-04-05,Yuba,115,75493,5753,5728,118,5846,43
2021-04-04,Alameda,1,1643700,84269,83951,1912,85863,1219
2021-04-04,Alpine,3,1148,86,85,0,85,0
2021-04-04,Amador,5,37829,3601,3582,35,3617,45
2021-04-04,Butte,7,227075,11671,11375,1766,13141,193
2021-04-04,Calaveras,9,45235,2015,2020,13,2033,50
2021-04-04,Colusa,11,21464,1890,1893,283,2176,14
2021-04-04,Contra Costa,13,1133247,66163,65408,1202,66610,774
2021-04-04,Del Norte,15,27424,1203,1186,6,1192,6
2021-04-04,El Dorado,17,186661,9490,9455,672,10127,106
2021-04-04,Fresno,19,978130,99459,99702,8678,108380,1622
2021-04-04,Glenn,21,27897,2343,2335,550,2885,17
2021-04-04,Humboldt,23,135768,3476,3472,26,3498,35
2021-04-04,Imperial,25,180216,27680,27588,2751,30339,710
2021-04-04,Inyo,27,18085,1382,1377,2,1379,36
2021-04-04,Kern,29,883053,95089,94388,10794,105182,1247
2021-04-04,Kings,31,150075,22619,22580,1138,23718,239
2021-04-04,Lake,33,64148,3371,3355,8,3363,43
2021-04-04,Lassen,35,31185,5139,5138,108,5246,1
2021-04-04,Los Angeles,37,10098052,1187050,1182872,42649,1225521,23301
2021-04-04,Madera,39,155013,16124,16052,918,16970,230
2021-04-04,Marin,41,260295,13679,13663,224,13887,221
2021-04-04,Mariposa,43,17540,397,390,7,397,5
2021-04-04,Mendocino,45,87422,3742,3684,65,3749,45
2021-04-04,Merced,47,269075,29979,30048,963,31011,427
2021-04-04,Modoc,49,8938,358,346,120,466,3
2021-04-04,Mono,51,14174,1226,1245,14,1259,3
2021-04-04,Monterey,53,433212,42496,42391,1855,44246,341
2021-04-04,Napa,55,140530,9521,9486,33,9519,78
2021-04-04,Nevada,57,99092,4384,4337,186,4523,69
2021-04-04,Orange,59,3164182,251056,250117,11237,261354,4759
2021-04-04,Placer,61,380077,21740,21104,1342,22446,276
2021-04-04,Plumas,63,18699,672,666,11,677,4
2021-04-04,Riverside,65,2383286,287148,283537,14510,298047,4237
2021-04-04,Sacramento,67,1510023,99694,98821,1535,100356,1531
2021-04-04,San Benito,69,59416,5900,5901,104,6005,61
2021-04-04,San Bernardino,71,2135413,289057,286561,9002,295563,4423
2021-04-04,San Diego,73,3302833,272012,271528,0,271528,3583
2021-04-04,San Francisco,75,870044,35447,35525,1309,36834,488
2021-04-04,San Joaquin,77,732212,70022,69147,3429,72576,1268
2021-04-04,San Luis Obispo,79,281455,20457,20328,659,20987,252
2021-04-04,San Mateo,81,765935,40993,40587,436,41023,350
2021-04-04,Santa Barbara,83,443738,33563,33213,1300,34513,443
2021-04-04,Santa Clara,85,1922200,114397,114976,693,115669,1893
2021-04-04,Santa Cruz,87,273765,15820,15219,867,16086,201
2021-04-04,Shasta,89,179085,11383,11433,1475,12908,184
2021-04-04,Sierra,91,2930,53,50,14,64,0
2021-04-04,Siskiyou,93,43540,1556,1509,286,1795,7
2021-04-04,Solano,95,438530,31073,31002,430,31432,237
2021-04-04,Sonoma,97,501317,29224,29340,293,29633,311
2021-04-04,Stanislaus,99,539301,53182,53181,5881,59062,686
2021-04-04,Sutter,101,95872,9163,9164,86,9250,106
2021-04-04,Tehama,103,63373,4802,4792,562,5354,52
2021-04-04,Trinity,105,12862,354,321,54,375,3
2021-04-04,Tulare,107,460477,48744,48343,9137,57480,818
2021-04-04,Tuolumne,109,53932,3978,3980,101,4081,57
2021-04-04,Ventura,111,848112,79684,79526,3036,82562,983
2021-04-04,Yolo,113,214977,13415,13425,263,13688,198
2021-04-04,Yuba,115,75493,5746,5722,118,5840,43
2021-04-03,Alameda,1,1643700,84201,83861,1910,85771,1218
2021-04-03,Alpine,3,1148,86,85,0,85,0
2021-04-03,Amador,5,37829,3598,3577,35,3612,45
2021-04-03,Butte,7,227075,11667,11359,1762,13121,193
2021-04-03,Calaveras,9,45235,2013,2019,13,2032,50
2021-04-03,Colusa,11,21464,1890,1891,283,2174,14
2021-04-03,Contra Costa,13,1133247,66091,65338,1202,66540,774
2021-04-03,Del Norte,15,27424,1198,1183,6,1189,6
2021-04-03,El Dorado,17,186661,9481,9448,671,10119,106
2021-04-03,Fresno,19,978130,99402,99602,8673,108275,1622
2021-04-03,Glenn,21,27897,2343,2334,549,2883,17
2021-04-03,Humboldt,23,135768,3474,3467,26,3493,35
2021-04-03,Imperial,25,180216,27665,27572,2747,30319,710
2021-04-03,Inyo,27,18085,1381,1376,2,1378,36
2021-04-03,Kern,29,883053,95066,94369,10776,105145,1243
2021-04-03,Kings,31,150075,22617,22580,1138,23718,239
2021-04-03,Lake,33,64148,3370,3350,8,3358,43
2021-04-03,Lassen,35,31185,5138,5136,108,5244,1
2021-04-03,Los Angeles,37,10098052,1186752,1182402,42630,1225032,23301
2021-04-03,Madera,39,155013,16115,16051,916,16967,230
2021-04-03,Marin,41,260295,13671,13658,223,13881,221
2021-04-03,Mariposa,43,17540,397,390,6,396,5
2021-04-03,Mendocino,45,87422,3741,3684,65,3749,45
2021-04-03,Merced,47,269075,29964,30031,963,30994,427
2021-04-03,Modoc,49,8938,358,346,120,466,3
2021-04-03,Mono,51,14174,1226,1245,14,1259,3
2021-04-03,Monterey,53,433212,42483,42376,1853,44229,341
2021-04-03,Napa,55,140530,9512,9473,33,9506,78
2021-04-03,Nevada,57,99092,4380,4323,186,4509,69
2021-04-03,Orange,59,3164182,250977,249982,11218,261200,4755
2021-04-03,Placer,61,380077,21709,21060,1338,22398,276
2021-04-03,Plumas,63,18699,672,666,11,677,4
2021-04-03,Riverside,65,2383286,287071,283423,14507,297930,4237
2021-04-03,Sacramento,67,1510023,99586,98660,1529,100189,1531
2021-04-03,San Benito,69,59416,5897,5893,103,5996,61
2021-04-03,San Bernardino,71,2135413,288992,286473,8996,295469,4422
2021-04-03,San Diego,73,3302833,271843,271335,0,271335,3571
2021-04-03,San Francisco,75,870044,35429,35488,1307,36795,489
2021-04-03,San Joaquin,77,732212,69981,69100,3413,72513,1268
2021-04-03,San Luis Obispo,79,281455,20438,20301,659,20960,252
2021-04-03,San Mateo,81,765935,40968,40560,436,40996,350
2021-04-03,Santa Barbara,83,443738,33537,33172,1299,34471,443
2021-04-03,Santa Clara,85,1922200,114289,114865,691,115556,1893
2021-04-03,Santa Cruz,87,273765,15813,15205,867,16072,201
2021-04-03,Shasta,89,179085,11375,11418,1475,12893,184
2021-04-03,Sierra,91,2930,53,50,14,64,0
2021-04-03,Siskiyou,93,43540,1555,1509,286,1795,7
2021-04-03,Solano,95,438530,31052,30970,427,31397,237
2021-04-03,Sonoma,97,501317,29209,29315,292,29607,311
2021-04-03,Stanislaus,99,539301,53147,53137,5875,59012,686
2021-04-03,Sutter,101,95872,9157,9158,86,9244,106
2021-04-03,Tehama,103,63373,4795,4788,562,5350,52
2021-04-03,Trinity,105,12862,354,321,54,375,3
2021-04-03,Tulare,107,460477,48734,48327,9133,57460,818
2021-04-03,Tuolumne,109,53932,3978,3980,101,4081,57
2021-04-03,Ventura,111,848112,79663,79489,3034,82523,983
2021-04-03,Yolo,113,214977,13409,13414,263,13677,198
2021-04-03,Yuba,115,75493,5740,5716,118,5834,43
2021-04-02,Alameda,1,1643700,84128,83776,1906,85682,1217
2021-04-02,Alpine,3,1148,86,85,0,85,0
2021-04-02,Amador,5,37829,3594,3573,34,3607,45
2021-04-02,Butte,7,227075,11658,11350,1762,13112,193
2021-04-02,Calaveras,9,45235,2013,2010,13,2023,50
2021-04-02,Colusa,11,21464,1890,1891,283,2174,14
2021-04-02,Contra Costa,13,1133247,66027,65299,1201,66500,774
2021-04-02,Del Norte,15,27424,1195,1174,6,1180,6
2021-04-02,El Dorado,17,186661,9468,9437,668,10105,106
2021-04-02,Fresno,19,978130,99348,99551,8662,108213,1620
2021-04-02,Glenn,21,27897,2343,2331,549,2880,17
2021-04-02,Humboldt,23,135768,3470,3465,26,3491,35
2021-04-02,Imperial,25,180216,27654,27553,2739,30292,710
2021-04-02,Inyo,27,18085,1381,1377,2,1379,36
2021-04-02,Kern,29,883053,95049,94348,10772,105120,1233
2021-04-02,Kings,31,150075,22617,22571,1135,23706,239
2021-04-02,Lake,33,64148,3368,3348,8,3356,43
2021-04-02,Lassen,35,31185,5138,5134,108,5242,1
2021-04-02,Los Angeles,37,10098052,1186443,1181682,42606,1224288,23264
2021-04-02,Madera,39,155013,16106,16036,915,16951,230
2021-04-02,Marin,41,260295,13663,13649,223,13872,221
2021-04-02,Mariposa,43,17540,395,390,6,396,5
2021-04-02,Mendocino,45,87422,3738,3682,65,3747,45
2021-04-02,Merced,47,269075,29940,29998,963,30961,426
2021-04-02,Modoc,49,8938,355,346,120,466,3
2021-04-02,Mono,51,14174,1226,1246,14,1260,3
2021-04-02,Monterey,53,433212,42473,42359,1850,44209,341
2021-04-02,Napa,55,140530,9497,9453,33,9486,78
2021-04-02,Nevada,57,99092,4376,4323,186,4509,69
2021-04-02,Orange,59,3164182,250881,249891,11204,261095,4748
2021-04-02,Placer,61,380077,21674,21035,1331,22366,275
2021-04-02,Plumas,63,18699,672,666,11,677,4
2021-04-02,Riverside,65,2383286,286987,283328,14499,297827,4213
2021-04-02,Sacramento,67,1510023,99479,98648,1522,100170,1527
2021-04-02,San Benito,69,59416,5895,5888,101,5989,61
2021-04-02,San Bernardino,71,2135413,288920,286308,8991,295299,4417
2021-04-02,San Diego,73,3302833,271656,271036,0,271036,3568
2021-04-02,San Francisco,75,870044,35395,35451,1304,36755,488
2021-04-02,San Joaquin,77,732212,69917,68996,3397,72393,1268
2021-04-02,San Luis Obispo,79,281455,20421,20271,658,20929,252
2021-04-02,San Mateo,81,765935,40926,40514,436,40950,350
2021-04-02,Santa Barbara,83,443738,33509,33145,1299,34444,443
2021-04-02,Santa Clara,85,1922200,114177,114777,689,115466,1882
2021-04-02,Santa Cruz,87,273765,15805,15216,867,16083,202
2021-04-02,Shasta,89,179085,11370,11377,1467,12844,181
2021-04-02,Sierra,91,2930,53,50,14,64,0
2021-04-02,Siskiyou,93,43540,1555,1508,285,1793,7
2021-04-02,Solano,95,438530,31024,30951,425,31376,237
2021-04-02,Sonoma,97,501317,29188,29288,291,29579,311
2021-04-02,Stanislaus,99,539301,53102,53073,5868,58941,687
2021-04-02,Sutter,101,95872,9149,9131,86,9217,106
2021-04-02,Tehama,103,63373,4788,4775,561,5336,52
2021-04-02,Trinity,105,12862,354,320,54,374,3
2021-04-02,Tulare,107,460477,48728,48306,9127,57433,818
2021-04-02,Tuolumne,109,53932,3975,3980,101,4081,57
2021-04-02,Ventura,111,848112,79635,79434,3032,82466,982
2021-04-02,Yolo,113,214977,13399,13381,263,13644,197
2021-04-02,Yuba,115,75493,5737,5709,118,5827,44
2021-04-01,Alameda,1,1643700,84046,83574,1901,85475,1216
2021-04-01,Alpine,3,1148,86,85,0,85,0
2021-04-01,Amador,5,37829,3590,3558,34,3592,45
2021-04-01,Butte,7,227075,11640,11328,1760,13088,193
2021-04-01,Calaveras,9,45235,2012,2006,13,2019,50
2021-04-01,Colusa,11,21464,1887,1890,283,2173,14
2021-04-01,Contra Costa,13,1133247,65967,65176,1199,66375,771
2021-04-01,Del Norte,15,27424,1190,1138,6,1144,6
2021-04-01,El Dorado,17,186661,9459,9393,664,10057,106
2021-04-01,Fresno,19,978130,99297,99317,8654,107971,1616
2021-04-01,Glenn,21,27897,2343,2322,548,2870,17
2021-04-01,Humboldt,23,135768,3466,3464,26,3490,35
2021-04-01,Imperial,25,180216,27624,27520,2733,30253,710
2021-04-01,Inyo,27,18085,1380,1374,2,1376,36
2021-04-01,Kern,29,883053,95018,94244,10758,105002,1233
2021-04-01,Kings,31,150075,22610,22560,1134,23694,239
2021-04-01,Lake,33,64148,3363,3337,8,3345,43
2021-04-01,Lassen,35,31185,5137,5132,108,5240,1
2021-04-01,Los Angeles,37,10098052,1185956,1181101,42579,1223680,23220
2021-04-01,Madera,39,155013,16090,16023,915,16938,230
2021-04-01,Marin,41,260295,13653,13635,223,13858,221
2021-04-01,Mariposa,43,17540,393,389,6,395,5
2021-04-01,Mendocino,45,87422,3738,3680,65,3745,45
2021-04-01,Merced,47,269075,29907,29820,963,30783,425
2021-04-01,Modoc,49,8938,354,346,120,466,3
2021-04-01,Mono,51,14174,1226,1245,14,1259,3
2021-04-01,Monterey,53,433212,42465,42324,1848,44172,339
2021-04-01,Napa,55,140530,9485,9410,33,9443,78
2021-04-01,Nevada,57,99092,4366,4288,185,4473,68
2021-04-01,Orange,59,3164182,250760,249617,11186,260803,4742
2021-04-01,Placer,61,380077,21638,20909,1318,22227,274
2021-04-01,Plumas,63,18699,672,664,11,675,4
2021-04-01,Riverside,65,2383286,286885,283128,14497,297625,4193
2021-04-01,Sacramento,67,1510023,99336,97952,1508,99460,1521
2021-04-01,San Benito,69,59416,5887,5878,100,5978,61
2021-04-01,San Bernardino,71,2135413,288804,286086,8983,295069,4404
2021-04-01,San Diego,73,3302833,271432,270540,0,270540,3555
2021-04-01,San Francisco,75,870044,35375,35386,1300,36686,488
2021-04-01,San Joaquin,77,732212,69834,68802,3389,72191,1262
2021-04-01,San Luis Obispo,79,281455,20393,20235,657,20892,252
2021-04-01,San Mateo,81,765935,40885,40454,436,40890,350
2021-04-01,Santa Barbara,83,443738,33464,33096,1294,34390,443
2021-04-01,Santa Clara,85,1922200,114064,114606,688,115294,1874
2021-04-01,Santa Cruz,87,273765,15790,15271,867,16138,202
2021-04-01,Shasta,89,179085,11355,11355,1458,12813,181
2021-04-01,Sierra,91,2930,53,50,14,64,0
2021-04-01,Siskiyou,93,43540,1553,1507,284,1791,7
2021-04-01,Solano,95,438530,30991,30850,422,31272,237
2021-04-01,Sonoma,97,501317,29156,29241,284,29525,311
2021-04-01,Stanislaus,99,539301,53039,52825,5862,58687,687
2021-04-01,Sutter,101,95872,9137,9105,86,9191,106
2021-04-01,Tehama,103,63373,4782,4764,558,5322,52
2021-04-01,Trinity,105,12862,354,319,54,373,3
2021-04-01,Tulare,107,460477,48705,48279,9117,57396,817
2021-04-01,Tuolumne,109,53932,3974,3978,101,4079,57
2021-04-01,Ventura,111,848112,79611,79369,3031,82400,977
2021-04-01,Yolo,113,214977,13386,13342,263,13605,197
2021-04-01,Yuba,115,75493,5732,5694,118,5812,44
2021-03-31,Alameda,1,1643700,83965,83475,1896,85371,1215
2021-03-31,Alpine,3,1148,86,85,0,85,0
2021-03-31,Amador,5,37829,3587,3556,34,3590,45
2021-03-31,Butte,7,227075,11630,11321,1757,13078,193
2021-03-31,Calaveras,9,45235,2008,2005,13,2018,50
2021-03-31,Colusa,11,21464,1887,1890,283,2173,14
2021-03-31,Contra Costa,13,1133247,65882,65109,1198,66307,769
2021-03-31,Del Norte,15,27424,1181,1129,6,1135,6
2021-03-31,El Dorado,17,186661,9442,9390,664,10054,106
2021-03-31,Fresno,19,978130,99207,99240,8638,107878,1616
2021-03-31,Glenn,21,27897,2338,2318,546,2864,17
2021-03-31,Humboldt,23,135768,3460,3460,26,3486,35
2021-03-31,Imperial,25,180216,27604,27506,2732,30238,710
2021-03-31,Inyo,27,18085,1377,1373,2,1375,35
2021-03-31,Kern,29,883053,94979,94205,10749,104954,1229
2021-03-31,Kings,31,150075,22607,22540,1134,23674,239
2021-03-31,Lake,33,64148,3359,3332,8,3340,43
2021-03-31,Lassen,35,31185,5133,5132,108,5240,1
2021-03-31,Los Angeles,37,10098052,1185497,1180538,42537,1223075,23171
2021-03-31,Madera,39,155013,16076,16015,913,16928,229
2021-03-31,Marin,41,260295,13643,13624,223,13847,221
2021-03-31,Mariposa,43,17540,393,389,6,395,5
2021-03-31,Mendocino,45,87422,3732,3675,65,3740,45
2021-03-31,Merced,47,269075,29878,29780,963,30743,423
2021-03-31,Modoc,49,8938,354,346,120,466,3
2021-03-31,Mono,51,14174,1226,1245,14,1259,3
2021-03-31,Monterey,53,433212,42448,42309,1846,44155,338
2021-03-31,Napa,55,140530,9467,9401,33,9434,78
2021-03-31,Nevada,57,99092,4360,4283,185,4468,68
2021-03-31,Orange,59,3164182,250649,249518,11171,260689,4731
2021-03-31,Placer,61,380077,21588,20885,1310,22195,271
2021-03-31,Plumas,63,18699,671,663,11,674,4
2021-03-31,Riverside,65,2383286,286786,283006,14486,297492,4171
2021-03-31,Sacramento,67,1510023,99159,97760,1500,99260,1519
2021-03-31,San Benito,69,59416,5877,5875,100,5975,61
2021-03-31,San Bernardino,71,2135413,288708,285916,8980,294896,4356
2021-03-31,San Diego,73,3302833,271201,270288,0,270288,3555
2021-03-31,San Francisco,75,870044,35331,35347,1298,36645,474
2021-03-31,San Joaquin,77,732212,69746,68685,3372,72057,1259
2021-03-31,San Luis Obispo,79,281455,20373,20215,656,20871,251
2021-03-31,San Mateo,81,765935,40855,40423,436,40859,350
2021-03-31,Santa Barbara,83,443738,33433,33052,1292,34344,443
2021-03-31,Santa Clara,85,1922200,113938,114499,688,115187,1874
2021-03-31,Santa Cruz,87,273765,15778,15295,866,16161,201
2021-03-31,Shasta,89,179085,11343,11327,1450,12777,179
2021-03-31,Sierra,91,2930,53,50,14,64,0
2021-03-31,Siskiyou,93,43540,1552,1505,284,1789,7
2021-03-31,Solano,95,438530,30945,30824,421,31245,235
2021-03-31,Sonoma,97,501317,29130,29216,284,29500,311
2021-03-31,Stanislaus,99,539301,52971,52782,5850,58632,687
2021-03-31,Sutter,101,95872,9126,9111,86,9197,106
2021-03-31,Tehama,103,63373,4777,4762,555,5317,52
2021-03-31,Trinity,105,12862,354,319,54,373,3
2021-03-31,Tulare,107,460477,48686,48261,9100,57361,816
2021-03-31,Tuolumne,109,53932,3974,3976,101,4077,57
2021-03-31,Ventura,111,848112,79579,79326,3027,82353,969
2021-03-31,Yolo,113,214977,13368,13359,262,13621,197
2021-03-31,Yuba,115,75493,5725,5686,118,5804,44
2021-03-30,Alameda,1,1643700,83865,83395,1893,85288,1211
2021-03-30,Alpine,3,1148,86,85,0,85,0
2021-03-30,Amador,5,37829,3584,3551,34,3585,45
2021-03-30,Butte,7,227075,11617,11296,1754,13050,193
2021-03-30,Calaveras,9,45235,2004,1997,13,2010,50
2021-03-30,Colusa,11,21464,1886,1890,282,2172,14
2021-03-30,Contra Costa,13,1133247,65794,65041,1196,66237,767
2021-03-30,Del Norte,15,27424,1173,1118,5,1123,6
2021-03-30,El Dorado,17,186661,9423,9381,661,10042,105
2021-03-30,Fresno,19,978130,99143,99156,8626,107782,1609
2021-03-30,Glenn,21,27897,2338,2310,544,2854,17
2021-03-30,Humboldt,23,135768,3457,3461,26,3487,35
2021-03-30,Imperial,25,180216,27575,27471,2730,30201,706
2021-03-30,Inyo,27,18085,1377,1374,2,1376,35
2021-03-30,Kern,29,883053,94939,94151,10740,104891,1221
2021-03-30,Kings,31,150075,22603,22530,1132,23662,238
2021-03-30,Lake,33,64148,3353,3330,8,3338,43
2021-03-30,Lassen,35,31185,5133,5132,108,5240,1
2021-03-30,Los Angeles,37,10098052,1185008,1180044,42513,1222557,23136
2021-03-30,Madera,39,155013,16066,16003,910,16913,229
2021-03-30,Marin,41,260295,13634,13611,215,13826,221
2021-03-30,Mariposa,43,17540,393,388,6,394,5
2021-03-30,Mendocino,45,87422,3730,3670,65,3735,45
2021-03-30,Merced,47,269075,29842,29731,963,30694,423
2021-03-30,Modoc,49,8938,353,346,120,466,3
2021-03-30,Mono,51,14174,1225,1245,14,1259,3
2021-03-30,Monterey,53,433212,42422,42308,1843,44151,338
2021-03-30,Napa,55,140530,9452,9391,33,9424,78
2021-03-30,Nevada,57,99092,4348,4266,184,4450,68
2021-03-30,Orange,59,3164182,250521,249412,11143,260555,4727
2021-03-30,Placer,61,380077,21548,20866,1303,22169,271
2021-03-30,Plumas,63,18699,671,661,11,672,4
2021-03-30,Riverside,65,2383286,286667,282930,14477,297407,4154
2021-03-30,Sacramento,67,1510023,99023,97718,1495,99213,1516
2021-03-30,San Benito,69,59416,5871,5870,100,5970,61
2021-03-30,San Bernardino,71,2135413,288599,285758,8971,294729,4343
2021-03-30,San Diego,73,3302833,270964,269998,0,269998,3555
2021-03-30,San Francisco,75,870044,35281,35325,1297,36622,474
2021-03-30,San Joaquin,77,732212,69659,68613,3361,71974,1232
2021-03-30,San Luis Obispo,79,281455,20353,20194,656,20850,251
2021-03-30,San Mateo,81,765935,40810,40377,436,40813,349
2021-03-30,Santa Barbara,83,443738,33408,33016,1291,34307,441
2021-03-30,Santa Clara,85,1922200,113815,114413,687,115100,1873
2021-03-30,Santa Cruz,87,273765,15772,15278,866,16144,201
2021-03-30,Shasta,89,179085,11335,11316,1447,12763,184
2021-03-30,Sierra,91,2930,53,50,14,64,0
2021-03-30,Siskiyou,93,43540,1551,1501,284,1785,7
2021-03-30,Solano,95,438530,30916,30802,420,31222,232
2021-03-30,Sonoma,97,501317,29098,29198,284,29482,311
2021-03-30,Stanislaus,99,539301,52893,52690,5842,58532,677
2021-03-30,Sutter,101,95872,9122,9107,85,9192,106
2021-03-30,Tehama,103,63373,4768,4748,554,5302,52
2021-03-30,Trinity,105,12862,354,316,54,370,3
2021-03-30,Tulare,107,460477,48672,48249,9090,57339,815
2021-03-30,Tuolumne,109,53932,3969,3972,101,4073,57
2021-03-30,Ventura,111,848112,79535,79282,3024,82306,958
2021-03-30,Yolo,113,214977,13355,13353,262,13615,195
2021-03-30,Yuba,115,75493,5714,5679,112,5791,42
2021-03-29,Alameda,1,1643700,83763,83338,1892,85230,1211
2021-03-29,Alpine,3,1148,86,85,0,85,0
2021-03-29,Amador,5,37829,3578,3549,34,3583,45
2021-03-29,Butte,7,227075,11608,11291,1751,13042,191
2021-03-29,Calaveras,9,45235,2000,1998,13,2011,50
2021-03-29,Colusa,11,21464,1886,1889,281,2170,14
2021-03-29,Contra Costa,13,1133247,65726,64971,1195,66166,767
2021-03-29,Del Norte,15,27424,1168,1116,4,1120,6
2021-03-29,El Dorado,17,186661,9403,9374,655,10029,105
2021-03-29,Fresno,19,978130,99060,99085,8614,107699,1606
2021-03-29,Glenn,21,27897,2332,2310,544,2854,17
2021-03-29,Humboldt,23,135768,3452,3459,26,3485,34
2021-03-29,Imperial,25,180216,27555,27442,2726,30168,704
2021-03-29,Inyo,27,18085,1377,1372,2,1374,35
2021-03-29,Kern,29,883053,94894,94098,10719,104817,1220
2021-03-29,Kings,31,150075,22591,22522,1131,23653,238
2021-03-29,Lake,33,64148,3350,3325,8,3333,43
2021-03-29,Lassen,35,31185,5133,5131,108,5239,1
2021-03-29,Los Angeles,37,10098052,1184518,1179736,42471,1222207,23108
2021-03-29,Madera,39,155013,16046,15987,908,16895,210
2021-03-29,Marin,41,260295,13622,13600,211,13811,220
2021-03-29,Mariposa,43,17540,392,388,6,394,5
2021-03-29,Mendocino,45,87422,3727,3667,65,3732,45
2021-03-29,Merced,47,269075,29818,29699,963,30662,422
2021-03-29,Modoc,49,8938,352,344,120,464,3
2021-03-29,Mono,51,14174,1224,1243,14,1257,3
2021-03-29,Monterey,53,433212,42405,42305,1838,44143,337
2021-03-29,Napa,55,140530,9436,9379,33,9412,78
2021-03-29,Nevada,57,99092,4341,4258,184,4442,68
2021-03-29,Orange,59,3164182,250408,249295,11131,260426,4713
2021-03-29,Placer,61,380077,21513,20827,1296,22123,267
2021-03-29,Plumas,63,18699,670,660,11,671,4
2021-03-29,Riverside,65,2383286,286578,282867,14475,297342,4133
2021-03-29,Sacramento,67,1510023,98830,97577,1486,99063,1514
2021-03-29,San Benito,69,59416,5864,5865,100,5965,61
2021-03-29,San Bernardino,71,2135413,288500,285615,8967,294582,4335
2021-03-29,San Diego,73,3302833,270698,269771,0,269771,3547
2021-03-29,San Francisco,75,870044,35248,35291,1293,36584,474
2021-03-29,San Joaquin,77,732212,69573,68537,3347,71884,1211
2021-03-29,San Luis Obispo,79,281455,20318,20176,654,20830,250
2021-03-29,San Mateo,81,765935,40768,40357,435,40792,348
2021-03-29,Santa Barbara,83,443738,33374,32983,1290,34273,439
2021-03-29,Santa Clara,85,1922200,113709,114335,681,115016,1871
2021-03-29,Santa Cruz,87,273765,15761,15249,865,16114,201
2021-03-29,Shasta,89,179085,11317,11313,1442,12755,183
2021-03-29,Sierra,91,2930,53,50,14,64,0
2021-03-29,Siskiyou,93,43540,1550,1497,283,1780,6
2021-03-29,Solano,95,438530,30877,30762,418,31180,232
2021-03-29,Sonoma,97,501317,29074,29184,280,29464,310
2021-03-29,Stanislaus,99,539301,52809,52614,5834,58448,677
2021-03-29,Sutter,101,95872,9115,9105,85,9190,106
2021-03-29,Tehama,103,63373,4760,4742,553,5295,52
2021-03-29,Trinity,105,12862,354,314,54,368,3
2021-03-29,Tulare,107,460477,48645,48226,9079,57305,815
2021-03-29,Tuolumne,109,53932,3967,3969,91,4060,57
2021-03-29,Ventura,111,848112,79493,79252,3023,82275,956
2021-03-29,Yolo,113,214977,13337,13346,262,13608,195
2021-03-29,Yuba,115,75493,5707,5671,111,5782,42
2021-03-28,Alameda,1,1643700,83641,83239,1890,85129,1212
2021-03-28,Alpine,3,1148,86,85,0,85,0
2021-03-28,Amador,5,37829,3574,3541,34,3575,45
2021-03-28,Butte,7,227075,11595,11285,1749,13034,191
2021-03-28,Calaveras,9,45235,1997,1995,13,2008,50
2021-03-28,Colusa,11,21464,1885,1889,281,2170,14
2021-03-28,Contra Costa,13,1133247,65652,64878,1191,66069,767
2021-03-28,Del Norte,15,27424,1161,1107,2,1109,6
2021-03-28,El Dorado,17,186661,9388,9371,653,10024,105
2021-03-28,Fresno,19,978130,98978,99004,8601,107605,1606
2021-03-28,Glenn,21,27897,2329,2309,542,2851,17
2021-03-28,Humboldt,23,135768,3449,3452,25,3477,34
2021-03-28,Imperial,25,180216,27527,27426,2723,30149,704
2021-03-28,Inyo,27,18085,1376,1372,2,1374,35
2021-03-28,Kern,29,883053,94852,94084,10707,104791,1219
2021-03-28,Kings,31,150075,22587,22514,1127,23641,238
2021-03-28,Lake,33,64148,3345,3320,8,3328,43
2021-03-28,Lassen,35,31185,5133,5131,107,5238,1
2021-03-28,Los Angeles,37,10098052,1183968,1179316,42409,1221725,23101
2021-03-28,Madera,39,155013,16031,15973,907,16880,210
2021-03-28,Marin,41,260295,13609,13594,209,13803,221
2021-03-28,Mariposa,43,17540,392,388,6,394,5
2021-03-28,Mendocino,45,87422,3725,3666,65,3731,45
2021-03-28,Merced,47,269075,29761,29679,963,30642,422
2021-03-28,Modoc,49,8938,352,344,120,464,3
2021-03-28,Mono,51,14174,1223,1242,14,1256,3
2021-03-28,Monterey,53,433212,42382,42294,1834,44128,337
2021-03-28,Napa,55,140530,9422,9368,33,9401,78
2021-03-28,Nevada,57,99092,4327,4239,184,4423,68
2021-03-28,Orange,59,3164182,250256,249238,11120,260358,4713
2021-03-28,Placer,61,380077,21470,20796,1289,22085,267
2021-03-28,Plumas,63,18699,668,657,11,668,4
2021-03-28,Riverside,65,2383286,286475,282811,14466,297277,4132
2021-03-28,Sacramento,67,1510023,98656,97425,1480,98905,1514
2021-03-28,San Benito,69,59416,5859,5862,100,5962,61
2021-03-28,San Bernardino,71,2135413,288385,285570,8957,294527,4332
2021-03-28,San Diego,73,3302833,270425,269476,0,269476,3547
2021-03-28,San Francisco,75,870044,35201,35286,1289,36575,474
2021-03-28,San Joaquin,77,732212,69448,68459,3327,71786,1211
2021-03-28,San Luis Obispo,79,281455,20283,20172,651,20823,250
2021-03-28,San Mateo,81,765935,40723,40305,434,40739,348
2021-03-28,Santa Barbara,83,443738,33335,32953,1288,34241,439
2021-03-28,Santa Clara,85,1922200,113610,114232,677,114909,1871
2021-03-28,Santa Cruz,87,273765,15747,15238,864,16102,201
2021-03-28,Shasta,89,179085,11291,11308,1429,12737,183
2021-03-28,Sierra,91,2930,53,50,14,64,0
2021-03-28,Siskiyou,93,43540,1550,1497,282,1779,6
2021-03-28,Solano,95,438530,30840,30719,416,31135,232
2021-03-28,Sonoma,97,501317,29039,29161,277,29438,310
2021-03-28,Stanislaus,99,539301,52725,52567,5818,58385,678
2021-03-28,Sutter,101,95872,9106,9094,85,9179,106
2021-03-28,Tehama,103,63373,4751,4740,548,5288,52
2021-03-28,Trinity,105,12862,352,314,53,367,3
2021-03-28,Tulare,107,460477,48616,48218,9073,57291,815
2021-03-28,Tuolumne,109,53932,3965,3969,90,4059,57
2021-03-28,Ventura,111,848112,79441,79222,3018,82240,956
2021-03-28,Yolo,113,214977,13319,13325,261,13586,194
2021-03-28,Yuba,115,75493,5703,5662,111,5773,42
2021-03-27,Alameda,1,1643700,83569,83169,1886,85055,1211
2021-03-27,Alpine,3,1148,86,85,0,85,0
2021-03-27,Amador,5,37829,3569,3538,34,3572,45
2021-03-27,Butte,7,227075,11588,11278,1748,13026,191
2021-03-27,Calaveras,9,45235,1997,1992,13,2005,50
2021-03-27,Colusa,11,21464,1885,1889,281,2170,14
2021-03-27,Contra Costa,13,1133247,65583,64804,1188,65992,767
2021-03-27,Del Norte,15,27424,1151,1104,2,1106,6
2021-03-27,El Dorado,17,186661,9374,9367,653,10020,105
2021-03-27,Fresno,19,978130,98926,98901,8596,107497,1606
2021-03-27,Glenn,21,27897,2328,2308,542,2850,17
2021-03-27,Humboldt,23,135768,3444,3442,25,3467,34
2021-03-27,Imperial,25,180216,27515,27406,2720,30126,704
2021-03-27,Inyo,27,18085,1374,1372,2,1374,35
2021-03-27,Kern,29,883053,94834,94041,10693,104734,1217
2021-03-27,Kings,31,150075,22584,22502,1127,23629,238
2021-03-27,Lake,33,64148,3343,3317,8,3325,43
2021-03-27,Lassen,35,31185,5133,5129,107,5236,1
2021-03-27,Los Angeles,37,10098052,1183655,1178831,42380,1221211,23103
2021-03-27,Madera,39,155013,16024,15968,905,16873,210
2021-03-27,Marin,41,260295,13604,13579,209,13788,222
2021-03-27,Mariposa,43,17540,392,386,6,392,5
2021-03-27,Mendocino,45,87422,3724,3666,65,3731,45
2021-03-27,Merced,47,269075,29728,29647,961,30608,422
2021-03-27,Modoc,49,8938,352,344,120,464,3
2021-03-27,Mono,51,14174,1221,1241,14,1255,3
2021-03-27,Monterey,53,433212,42372,42271,1834,44105,337
2021-03-27,Napa,55,140530,9410,9360,33,9393,78
2021-03-27,Nevada,57,99092,4317,4231,184,4415,68
2021-03-27,Orange,59,3164182,250163,249160,11104,260264,4698
2021-03-27,Placer,61,380077,21450,20717,1282,21999,267
2021-03-27,Plumas,63,18699,667,655,11,666,4
2021-03-27,Riverside,65,2383286,286413,282707,14458,297165,4132
2021-03-27,Sacramento,67,1510023,98566,97247,1478,98725,1513
2021-03-27,San Benito,69,59416,5857,5862,98,5960,61
2021-03-27,San Bernardino,71,2135413,288323,285480,8955,294435,4325
2021-03-27,San Diego,73,3302833,270255,269271,0,269271,3540
2021-03-27,San Francisco,75,870044,35177,35244,1287,36531,474
2021-03-27,San Joaquin,77,732212,69388,68365,3318,71683,1211
2021-03-27,San Luis Obispo,79,281455,20272,20153,648,20801,250
2021-03-27,San Mateo,81,765935,40699,40264,434,40698,348
2021-03-27,Santa Barbara,83,443738,33312,32921,1287,34208,439
2021-03-27,Santa Clara,85,1922200,113513,114124,675,114799,1871
2021-03-27,Santa Cruz,87,273765,15741,15215,864,16079,201
2021-03-27,Shasta,89,179085,11280,11288,1427,12715,183
2021-03-27,Sierra,91,2930,53,50,14,64,0
2021-03-27,Siskiyou,93,43540,1550,1497,282,1779,6
2021-03-27,Solano,95,438530,30812,30669,415,31084,232
2021-03-27,Sonoma,97,501317,29024,29133,275,29408,310
2021-03-27,Stanislaus,99,539301,52662,52497,5809,58306,678
2021-03-27,Sutter,101,95872,9098,9093,85,9178,106
2021-03-27,Tehama,103,63373,4745,4738,546,5284,52
2021-03-27,Trinity,105,12862,352,313,53,366,3
2021-03-27,Tulare,107,460477,48600,48203,9065,57268,813
2021-03-27,Tuolumne,109,53932,3962,3968,90,4058,57
2021-03-27,Ventura,111,848112,79414,79184,3016,82200,956
2021-03-27,Yolo,113,214977,13314,13317,260,13577,194
2021-03-27,Yuba,115,75493,5701,5657,111,5768,42
2021-03-26,Alameda,1,1643700,83507,83043,1884,84927,1208
2021-03-26,Alpine,3,1148,86,85,0,85,0
2021-03-26,Amador,5,37829,3564,3532,34,3566,45
2021-03-26,Butte,7,227075,11578,11278,1748,13026,191
2021-03-26,Calaveras,9,45235,1996,1989,13,2002,50
2021-03-26,Colusa,11,21464,1885,1889,281,2170,14
2021-03-26,Contra Costa,13,1133247,65523,64699,1186,65885,761
2021-03-26,Del Norte,15,27424,1148,1101,2,1103,6
2021-03-26,El Dorado,17,186661,9369,9353,653,10006,105
2021-03-26,Fresno,19,978130,98865,98731,8584,107315,1601
2021-03-26,Glenn,21,27897,2328,2307,541,2848,17
2021-03-26,Humboldt,23,135768,3442,3431,25,3456,34
2021-03-26,Imperial,25,180216,27491,27374,2720,30094,701
2021-03-26,Inyo,27,18085,1373,1369,2,1371,35
2021-03-26,Kern,29,883053,94808,93949,10687,104636,1211
2021-03-26,Kings,31,150075,22576,22493,1125,23618,239
2021-03-26,Lake,33,64148,3342,3314,8,3322,43
2021-03-26,Lassen,35,31185,5132,5131,107,5238,1
2021-03-26,Los Angeles,37,10098052,1183320,1178213,42365,1220578,23080
2021-03-26,Madera,39,155013,16014,15952,905,16857,210
2021-03-26,Marin,41,260295,13598,13553,204,13757,221
2021-03-26,Mariposa,43,17540,392,386,6,392,5
2021-03-26,Mendocino,45,87422,3723,3664,65,3729,45
2021-03-26,Merced,47,269075,29705,29613,959,30572,419
2021-03-26,Modoc,49,8938,352,344,120,464,3
2021-03-26,Mono,51,14174,1220,1236,14,1250,3
2021-03-26,Monterey,53,433212,42360,42241,1830,44071,338
2021-03-26,Napa,55,140530,9400,9349,33,9382,78
2021-03-26,Nevada,57,99092,4297,4222,184,4406,83
2021-03-26,Orange,59,3164182,250100,248995,11090,260085,4671
2021-03-26,Placer,61,380077,21424,20679,1280,21959,259
2021-03-26,Plumas,63,18699,666,654,11,665,4
2021-03-26,Riverside,65,2383286,286335,282602,14452,297054,4109
2021-03-26,Sacramento,67,1510023,98466,97040,1473,98513,1509
2021-03-26,San Benito,69,59416,5854,5855,98,5953,61
2021-03-26,San Bernardino,71,2135413,288265,285313,8952,294265,4288
2021-03-26,San Diego,73,3302833,270077,269045,0,269045,3525
2021-03-26,San Francisco,75,870044,35152,35186,1287,36473,472
2021-03-26,San Joaquin,77,732212,69326,68249,3313,71562,1202
2021-03-26,San Luis Obispo,79,281455,20259,20118,648,20766,250
2021-03-26,San Mateo,81,765935,40664,40199,434,40633,348
2021-03-26,Santa Barbara,83,443738,33282,32895,1287,34182,439
2021-03-26,Santa Clara,85,1922200,113415,113959,674,114633,1868
2021-03-26,Santa Cruz,87,273765,15727,15199,863,16062,201
2021-03-26,Shasta,89,179085,11271,11276,1421,12697,182
2021-03-26,Sierra,91,2930,53,50,14,64,0
2021-03-26,Siskiyou,93,43540,1550,1493,281,1774,6
2021-03-26,Solano,95,438530,30787,30640,415,31055,205
2021-03-26,Sonoma,97,501317,29009,29101,272,29373,310
2021-03-26,Stanislaus,99,539301,52594,52420,5805,58225,678
2021-03-26,Sutter,101,95872,9096,9082,85,9167,104
2021-03-26,Tehama,103,63373,4744,4722,545,5267,51
2021-03-26,Trinity,105,12862,352,311,53,364,3
2021-03-26,Tulare,107,460477,48586,48179,9056,57235,813
2021-03-26,Tuolumne,109,53932,3961,3965,90,4055,57
2021-03-26,Ventura,111,848112,79381,79122,3014,82136,953
2021-03-26,Yolo,113,214977,13306,13299,258,13557,194
2021-03-26,Yuba,115,75493,5691,5653,111,5764,42
2021-03-25,Alameda,1,1643700,83407,82945,1882,84827,1206
2021-03-25,Alpine,3,1148,86,84,0,84,0
2021-03-25,Amador,5,37829,3562,3530,34,3564,45
2021-03-25,Butte,7,227075,11568,11270,1748,13018,188
2021-03-25,Calaveras,9,45235,1991,1982,13,1995,50
2021-03-25,Colusa,11,21464,1885,1888,281,2169,14
2021-03-25,Contra Costa,13,1133247,65456,64606,1182,65788,757
2021-03-25,Del Norte,15,27424,1142,1095,2,1097,6
2021-03-25,El Dorado,17,186661,9359,9331,653,9984,105
2021-03-25,Fresno,19,978130,98749,98602,8569,107171,1593
2021-03-25,Glenn,21,27897,2327,2302,540,2842,17
2021-03-25,Humboldt,23,135768,3437,3423,25,3448,34
2021-03-25,Imperial,25,180216,27475,27352,2719,30071,699
2021-03-25,Inyo,27,18085,1373,1369,2,1371,35
2021-03-25,Kern,29,883053,94776,93857,10682,104539,1206
2021-03-25,Kings,31,150075,22566,22472,1125,23597,237
2021-03-25,Lake,33,64148,3337,3312,8,3320,43
2021-03-25,Lassen,35,31185,5132,5129,107,5236,1
2021-03-25,Los Angeles,37,10098052,1182893,1177490,42327,1219817,23051
2021-03-25,Madera,39,155013,15995,15937,902,16839,210
2021-03-25,Marin,41,260295,13589,13538,201,13739,219
2021-03-25,Mariposa,43,17540,392,386,6,392,5
2021-03-25,Mendocino,45,87422,3722,3664,65,3729,45
2021-03-25,Merced,47,269075,29671,29576,950,30526,416
2021-03-25,Modoc,49,8938,352,343,120,463,3
2021-03-25,Mono,51,14174,1220,1235,14,1249,3
2021-03-25,Monterey,53,433212,42339,42220,1825,44045,336
2021-03-25,Napa,55,140530,9381,9321,33,9354,78
2021-03-25,Nevada,57,99092,4279,4202,182,4384,84
2021-03-25,Orange,59,3164182,249989,248871,11068,259939,4655
2021-03-25,Placer,61,380077,21385,20639,1273,21912,252
2021-03-25,Plumas,63,18699,666,654,11,665,4
2021-03-25,Riverside,65,2383286,286239,282492,14441,296933,4078
2021-03-25,Sacramento,67,1510023,98322,96823,1470,98293,1505
2021-03-25,San Benito,69,59416,5851,5850,98,5948,61
2021-03-25,San Bernardino,71,2135413,288182,285134,8947,294081,4222
2021-03-25,San Diego,73,3302833,269850,268623,0,268623,3520
2021-03-25,San Francisco,75,870044,35113,35154,1285,36439,468
2021-03-25,San Joaquin,77,732212,69230,68089,3264,71353,1196
2021-03-25,San Luis Obispo,79,281455,20242,20076,647,20723,250
2021-03-25,San Mateo,81,765935,40624,40147,434,40581,348
2021-03-25,Santa Barbara,83,443738,33255,32857,1286,34143,439
2021-03-25,Santa Clara,85,1922200,113313,113877,672,114549,1868
2021-03-25,Santa Cruz,87,273765,15706,15170,863,16033,201
2021-03-25,Shasta,89,179085,11254,11262,1418,12680,181
2021-03-25,Sierra,91,2930,53,50,14,64,0
2021-03-25,Siskiyou,93,43540,1548,1491,280,1771,6
2021-03-25,Solano,95,438530,30727,30583,413,30996,193
2021-03-25,Sonoma,97,501317,28975,29060,268,29328,310
2021-03-25,Stanislaus,99,539301,52528,52321,5798,58119,678
2021-03-25,Sutter,101,95872,9087,9069,85,9154,104
2021-03-25,Tehama,103,63373,4742,4719,544,5263,52
2021-03-25,Trinity,105,12862,352,310,53,363,3
2021-03-25,Tulare,107,460477,48561,48148,9043,57191,811
2021-03-25,Tuolumne,109,53932,3960,3962,90,4052,57
2021-03-25,Ventura,111,848112,79341,79045,3010,82055,952
2021-03-25,Yolo,113,214977,13299,13287,258,13545,194
2021-03-25,Yuba,115,75493,5685,5647,104,5751,42
2021-03-24,Alameda,1,1643700,83313,82871,1879,84750,1199
2021-03-24,Alpine,3,1148,86,84,0,84,0
2021-03-24,Amador,5,37829,3556,3529,34,3563,45
2021-03-24,Butte,7,227075,11558,11252,1744,12996,187
2021-03-24,Calaveras,9,45235,1987,1975,13,1988,50
2021-03-24,Colusa,11,21464,1885,1886,280,2166,14
2021-03-24,Contra Costa,13,1133247,65376,64539,1181,65720,755
2021-03-24,Del Norte,15,27424,1137,1087,2,1089,6
2021-03-24,El Dorado,17,186661,9353,9319,652,9971,105
2021-03-24,Fresno,19,978130,98660,98437,8553,106990,1585
2021-03-24,Glenn,21,27897,2326,2297,539,2836,17
2021-03-24,Humboldt,23,135768,3434,3414,25,3439,34
2021-03-24,Imperial,25,180216,27466,27325,2719,30044,699
2021-03-24,Inyo,27,18085,1373,1368,2,1370,35
2021-03-24,Kern,29,883053,94730,93800,10673,104473,1198
2021-03-24,Kings,31,150075,22552,22456,1123,23579,237
2021-03-24,Lake,33,64148,3333,3307,8,3315,43
2021-03-24,Lassen,35,31185,5130,5130,106,5236,1
2021-03-24,Los Angeles,37,10098052,1182423,1177015,42290,1219305,22993
2021-03-24,Madera,39,155013,15986,15918,901,16819,210
2021-03-24,Marin,41,260295,13576,13526,199,13725,219
2021-03-24,Mariposa,43,17540,392,384,6,390,5
2021-03-24,Mendocino,45,87422,3719,3660,65,3725,45
2021-03-24,Merced,47,269075,29630,29525,950,30475,415
2021-03-24,Modoc,49,8938,351,341,120,461,3
2021-03-24,Mono,51,14174,1219,1243,14,1257,3
2021-03-24,Monterey,53,433212,42317,42201,1822,44023,335
2021-03-24,Napa,55,140530,9361,9310,33,9343,78
2021-03-24,Nevada,57,99092,4265,4191,181,4372,85
2021-03-24,Orange,59,3164182,249872,248775,11049,259824,4638
2021-03-24,Placer,61,380077,21354,20606,1265,21871,250
2021-03-24,Plumas,63,18699,664,652,11,663,4
2021-03-24,Riverside,65,2383286,286156,282410,14439,296849,4058
2021-03-24,Sacramento,67,1510023,98148,96628,1457,98085,1500
2021-03-24,San Benito,69,59416,5850,5847,98,5945,61
2021-03-24,San Bernardino,71,2135413,288093,284983,8943,293926,4170
2021-03-24,San Diego,73,3302833,269635,268413,0,268413,3509
2021-03-24,San Francisco,75,870044,35085,35103,1282,36385,462
2021-03-24,San Joaquin,77,732212,69159,67978,3252,71230,1196
2021-03-24,San Luis Obispo,79,281455,20212,20021,646,20667,250
2021-03-24,San Mateo,81,765935,40575,40083,434,40517,348
2021-03-24,Santa Barbara,83,443738,33228,32810,1286,34096,438
2021-03-24,Santa Clara,85,1922200,113200,113757,667,114424,1851
2021-03-24,Santa Cruz,87,273765,15693,15138,862,16000,202
2021-03-24,Shasta,89,179085,11235,11243,1415,12658,181
2021-03-24,Sierra,91,2930,53,50,14,64,0
2021-03-24,Siskiyou,93,43540,1546,1490,280,1770,6
2021-03-24,Solano,95,438530,30690,30552,412,30964,178
2021-03-24,Sonoma,97,501317,28956,29034,263,29297,310
2021-03-24,Stanislaus,99,539301,52452,52259,5790,58049,677
2021-03-24,Sutter,101,95872,9071,9049,85,9134,104
2021-03-24,Tehama,103,63373,4736,4719,543,5262,49
2021-03-24,Trinity,105,12862,351,310,53,363,3
2021-03-24,Tulare,107,460477,48551,48109,9030,57139,808
2021-03-24,Tuolumne,109,53932,3959,3961,90,4051,57
2021-03-24,Ventura,111,848112,79289,78993,3003,81996,944
2021-03-24,Yolo,113,214977,13288,13269,258,13527,194
2021-03-24,Yuba,115,75493,5679,5634,101,5735,42
2021-03-23,Alameda,1,1643700,83211,82799,1875,84674,1190
2021-03-23,Alpine,3,1148,86,84,0,84,0
2021-03-23,Amador,5,37829,3550,3524,34,3558,45
2021-03-23,Butte,7,227075,11547,11227,1743,12970,187
2021-03-23,Calaveras,9,45235,1987,1971,13,1984,50
2021-03-23,Colusa,11,21464,1883,1885,279,2164,14
2021-03-23,Contra Costa,13,1133247,65277,64491,1180,65671,750
2021-03-23,Del Norte,15,27424,1132,1082,2,1084,6
2021-03-23,El Dorado,17,186661,9343,9318,650,9968,105
2021-03-23,Fresno,19,978130,98549,98362,8527,106889,1575
2021-03-23,Glenn,21,27897,2321,2293,537,2830,17
2021-03-23,Humboldt,23,135768,3425,3405,25,3430,34
2021-03-23,Imperial,25,180216,27458,27320,2719,30039,699
2021-03-23,Inyo,27,18085,1371,1364,2,1366,35
2021-03-23,Kern,29,883053,94624,93728,10666,104394,1191
2021-03-23,Kings,31,150075,22541,22439,1121,23560,237
2021-03-23,Lake,33,64148,3331,3294,8,3302,43
2021-03-23,Lassen,35,31185,5130,5130,106,5236,1
2021-03-23,Los Angeles,37,10098052,1181911,1176572,42250,1218822,22904
2021-03-23,Madera,39,155013,15970,15908,900,16808,210
2021-03-23,Marin,41,260295,13553,13514,197,13711,221
2021-03-23,Mariposa,43,17540,391,384,6,390,5
2021-03-23,Mendocino,45,87422,3717,3652,65,3717,45
2021-03-23,Merced,47,269075,29598,29485,950,30435,415
2021-03-23,Modoc,49,8938,350,342,120,462,3
2021-03-23,Mono,51,14174,1218,1263,14,1277,3
2021-03-23,Monterey,53,433212,42306,42180,1820,44000,335
2021-03-23,Napa,55,140530,9336,9299,33,9332,78
2021-03-23,Nevada,57,99092,4246,4179,180,4359,89
2021-03-23,Orange,59,3164182,249746,248661,11030,259691,4626
2021-03-23,Placer,61,380077,21319,20567,1261,21828,248
2021-03-23,Plumas,63,18699,664,652,11,663,4
2021-03-23,Riverside,65,2383286,286062,282317,14431,296748,4035
2021-03-23,Sacramento,67,1510023,97956,96521,1451,97972,1496
2021-03-23,San Benito,69,59416,5845,5845,97,5942,61
2021-03-23,San Bernardino,71,2135413,288010,284875,8934,293809,4134
2021-03-23,San Diego,73,3302833,269390,268156,0,268156,3498
2021-03-23,San Francisco,75,870044,35028,35071,1275,36346,462
2021-03-23,San Joaquin,77,732212,69063,67903,3234,71137,1182
2021-03-23,San Luis Obispo,79,281455,20171,20009,645,20654,250
2021-03-23,San Mateo,81,765935,40517,40032,433,40465,348
2021-03-23,Santa Barbara,83,443738,33190,32771,1284,34055,438
2021-03-23,Santa Clara,85,1922200,113083,113645,664,114309,1848
2021-03-23,Santa Cruz,87,273765,15678,15106,862,15968,201
2021-03-23,Shasta,89,179085,11222,11234,1412,12646,175
2021-03-23,Sierra,91,2930,53,50,14,64,0
2021-03-23,Siskiyou,93,43540,1541,1485,278,1763,6
2021-03-23,Solano,95,438530,30649,30524,411,30935,178
2021-03-23,Sonoma,97,501317,28921,29020,261,29281,310
2021-03-23,Stanislaus,99,539301,52352,52148,5785,57933,677
2021-03-23,Sutter,101,95872,9063,9039,85,9124,104
2021-03-23,Tehama,103,63373,4725,4707,542,5249,46
2021-03-23,Trinity,105,12862,351,310,53,363,3
2021-03-23,Tulare,107,460477,48524,48095,9014,57109,808
2021-03-23,Tuolumne,109,53932,3956,3957,90,4047,57
2021-03-23,Ventura,111,848112,79228,78930,3000,81930,932
2021-03-23,Yolo,113,214977,13277,13255,258,13513,194
2021-03-23,Yuba,115,75493,5674,5628,101,5729,42
2021-03-22,Alameda,1,1643700,83118,82748,1870,84618,1189
2021-03-22,Alpine,3,1148,85,83,0,83,0
2021-03-22,Amador,5,37829,3542,3522,34,3556,44
2021-03-22,Butte,7,227075,11538,11211,1741,12952,185
2021-03-22,Calaveras,9,45235,1985,1963,13,1976,49
2021-03-22,Colusa,11,21464,1882,1885,278,2163,13
2021-03-22,Contra Costa,13,1133247,65182,64432,1178,65610,740
2021-03-22,Del Norte,15,27424,1126,1082,2,1084,6
2021-03-22,El Dorado,17,186661,9327,9310,647,9957,105
2021-03-22,Fresno,19,978130,98453,98276,8513,106789,1556
2021-03-22,Glenn,21,27897,2313,2291,537,2828,17
2021-03-22,Humboldt,23,135768,3420,3403,25,3428,34
2021-03-22,Imperial,25,180216,27443,27302,2715,30017,699
2021-03-22,Inyo,27,18085,1368,1363,2,1365,35
2021-03-22,Kern,29,883053,94555,93675,10649,104324,1178
2021-03-22,Kings,31,150075,22528,22433,1116,23549,236
2021-03-22,Lake,33,64148,3330,3290,8,3298,43
2021-03-22,Lassen,35,31185,5128,5129,106,5235,1
2021-03-22,Los Angeles,37,10098052,1181408,1176205,42215,1218420,22843
2021-03-22,Madera,39,155013,15955,15904,900,16804,210
2021-03-22,Marin,41,260295,13544,13501,196,13697,221
2021-03-22,Mariposa,43,17540,390,381,6,387,5
2021-03-22,Mendocino,45,87422,3715,3653,65,3718,45
2021-03-22,Merced,47,269075,29555,29468,947,30415,413
2021-03-22,Modoc,49,8938,348,342,120,462,3
2021-03-22,Mono,51,14174,1213,1263,14,1277,3
2021-03-22,Monterey,53,433212,42289,42161,1818,43979,335
2021-03-22,Napa,55,140530,9325,9288,33,9321,77
2021-03-22,Nevada,57,99092,4236,4174,175,4349,89
2021-03-22,Orange,59,3164182,249596,248517,10995,259512,4599
2021-03-22,Placer,61,380077,21283,20543,1256,21799,242
2021-03-22,Plumas,63,18699,664,652,11,663,4
2021-03-22,Riverside,65,2383286,285970,282242,14419,296661,4009
2021-03-22,Sacramento,67,1510023,97779,96385,1441,97826,1493
2021-03-22,San Benito,69,59416,5842,5844,96,5940,61
2021-03-22,San Bernardino,71,2135413,287922,284771,8921,293692,4107
2021-03-22,San Diego,73,3302833,269180,267913,0,267913,3494
2021-03-22,San Francisco,75,870044,34986,35040,1271,36311,462
2021-03-22,San Joaquin,77,732212,68972,67815,3214,71029,1182
2021-03-22,San Luis Obispo,79,281455,20147,20000,644,20644,250
2021-03-22,San Mateo,81,765935,40467,40024,431,40455,348
2021-03-22,Santa Barbara,83,443738,33145,32756,1281,34037,437
2021-03-22,Santa Clara,85,1922200,112964,113575,664,114239,1845
2021-03-22,Santa Cruz,87,273765,15666,15077,861,15938,201
2021-03-22,Shasta,89,179085,11208,11218,1410,12628,150
2021-03-22,Sierra,91,2930,53,50,14,64,0
2021-03-22,Siskiyou,93,43540,1540,1487,277,1764,5
2021-03-22,Solano,95,438530,30610,30490,407,30897,171
2021-03-22,Sonoma,97,501317,28891,29010,257,29267,310
2021-03-22,Stanislaus,99,539301,52268,52083,5780,57863,677
2021-03-22,Sutter,101,95872,9050,9024,85,9109,104
2021-03-22,Tehama,103,63373,4717,4704,541,5245,45
2021-03-22,Trinity,105,12862,351,310,53,363,3
2021-03-22,Tulare,107,460477,48509,48074,8993,57067,807
2021-03-22,Tuolumne,109,53932,3953,3954,90,4044,57
2021-03-22,Ventura,111,848112,79180,78890,2997,81887,927
2021-03-22,Yolo,113,214977,13265,13243,257,13500,190
2021-03-22,Yuba,115,75493,5663,5627,99,5726,42
2021-03-21,Alameda,1,1643700,83029,82684,1867,84551,1187
2021-03-21,Alpine,3,1148,85,83,0,83,0
2021-03-21,Amador,5,37829,3538,3519,34,3553,44
2021-03-21,Butte,7,227075,11522,11208,1735,12943,185
2021-03-21,Calaveras,9,45235,1982,1962,13,1975,49
2021-03-21,Colusa,11,21464,1882,1885,278,2163,13
2021-03-21,Contra Costa,13,1133247,65100,64382,1174,65556,740
2021-03-21,Del Norte,15,27424,1111,1076,2,1078,6
2021-03-21,El Dorado,17,186661,9317,9302,642,9944,105
2021-03-21,Fresno,19,978130,98341,98211,8489,106700,1556
2021-03-21,Glenn,21,27897,2310,2288,536,2824,17
2021-03-21,Humboldt,23,135768,3415,3402,24,3426,34
2021-03-21,Imperial,25,180216,27426,27267,2706,29973,699
2021-03-21,Inyo,27,18085,1368,1363,2,1365,35
2021-03-21,Kern,29,883053,94491,93649,10638,104287,1170
2021-03-21,Kings,31,150075,22511,22422,1115,23537,236
2021-03-21,Lake,33,64148,3326,3286,8,3294,43
2021-03-21,Lassen,35,31185,5128,5129,106,5235,1
2021-03-21,Los Angeles,37,10098052,1180886,1175684,42163,1217847,22834
2021-03-21,Madera,39,155013,15936,15895,898,16793,210
2021-03-21,Marin,41,260295,13528,13495,195,13690,220
2021-03-21,Mariposa,43,17540,390,381,6,387,5
2021-03-21,Mendocino,45,87422,3712,3651,65,3716,45
2021-03-21,Merced,47,269075,29495,29446,941,30387,413
2021-03-21,Modoc,49,8938,348,341,120,461,3
2021-03-21,Mono,51,14174,1208,1263,14,1277,3
2021-03-21,Monterey,53,433212,42264,42153,1815,43968,335
2021-03-21,Napa,55,140530,9305,9282,33,9315,77
2021-03-21,Nevada,57,99092,4223,4169,175,4344,89
2021-03-21,Orange,59,3164182,249464,248442,10967,259409,4598
2021-03-21,Placer,61,380077,21247,20520,1248,21768,242
2021-03-21,Plumas,63,18699,664,653,11,664,4
2021-03-21,Riverside,65,2383286,285865,282187,14407,296594,4009
2021-03-21,Sacramento,67,1510023,97584,96269,1432,97701,1489
2021-03-21,San Benito,69,59416,5836,5842,96,5938,61
2021-03-21,San Bernardino,71,2135413,287830,284732,8913,293645,4094
2021-03-21,San Diego,73,3302833,268920,267724,0,267724,3494
2021-03-21,San Francisco,75,870044,34939,35012,1264,36276,460
2021-03-21,San Joaquin,77,732212,68850,67729,3196,70925,1182
2021-03-21,San Luis Obispo,79,281455,20115,19979,642,20621,250
2021-03-21,San Mateo,81,765935,40423,39988,430,40418,344
2021-03-21,Santa Barbara,83,443738,33106,32743,1278,34021,437
2021-03-21,Santa Clara,85,1922200,112835,113487,661,114148,1840
2021-03-21,Santa Cruz,87,273765,15659,15064,861,15925,199
2021-03-21,Shasta,89,179085,11188,11215,1409,12624,150
2021-03-21,Sierra,91,2930,53,50,14,64,0
2021-03-21,Siskiyou,93,43540,1540,1486,276,1762,5
2021-03-21,Solano,95,438530,30570,30474,404,30878,171
2021-03-21,Sonoma,97,501317,28861,28986,256,29242,310
2021-03-21,Stanislaus,99,539301,52178,52014,5779,57793,677
2021-03-21,Sutter,101,95872,9037,9021,85,9106,104
2021-03-21,Tehama,103,63373,4713,4701,541,5242,45
2021-03-21,Trinity,105,12862,349,310,52,362,3
2021-03-21,Tulare,107,460477,48493,48060,8981,57041,807
2021-03-21,Tuolumne,109,53932,3951,3953,90,4043,57
2021-03-21,Ventura,111,848112,79116,78863,2992,81855,927
2021-03-21,Yolo,113,214977,13244,13235,257,13492,190
2021-03-21,Yuba,115,75493,5653,5624,99,5723,42
2021-03-20,Alameda,1,1643700,82960,82614,1865,84479,1178
2021-03-20,Alpine,3,1148,85,83,0,83,0
2021-03-20,Amador,5,37829,3536,3518,34,3552,44
2021-03-20,Butte,7,227075,11516,11199,1733,12932,185
2021-03-20,Calaveras,9,45235,1978,1961,13,1974,49
2021-03-20,Colusa,11,21464,1882,1883,278,2161,12
2021-03-20,Contra Costa,13,1133247,65040,64313,1174,65487,713
2021-03-20,Del Norte,15,27424,1110,1075,2,1077,6
2021-03-20,El Dorado,17,186661,9311,9290,642,9932,105
2021-03-20,Fresno,19,978130,98281,98112,8481,106593,1532
2021-03-20,Glenn,21,27897,2309,2288,534,2822,17
2021-03-20,Humboldt,23,135768,3408,3399,24,3423,33
2021-03-20,Imperial,25,180216,27420,27239,2704,29943,695
2021-03-20,Inyo,27,18085,1368,1362,2,1364,35
2021-03-20,Kern,29,883053,94462,93606,10633,104239,1155
2021-03-20,Kings,31,150075,22504,22415,1114,23529,236
2021-03-20,Lake,33,64148,3322,3280,8,3288,43
2021-03-20,Lassen,35,31185,5128,5128,106,5234,1
2021-03-20,Los Angeles,37,10098052,1180591,1175290,42135,1217425,22810
2021-03-20,Madera,39,155013,15928,15891,897,16788,210
2021-03-20,Marin,41,260295,13516,13470,191,13661,220
2021-03-20,Mariposa,43,17540,389,381,6,387,5
2021-03-20,Mendocino,45,87422,3711,3639,65,3704,43
2021-03-20,Merced,47,269075,29464,29411,938,30349,412
2021-03-20,Modoc,49,8938,347,341,120,461,3
2021-03-20,Mono,51,14174,1208,1256,14,1270,3
2021-03-20,Monterey,53,433212,42255,42146,1814,43960,334
2021-03-20,Napa,55,140530,9297,9274,33,9307,77
2021-03-20,Nevada,57,99092,4212,4164,174,4338,89
2021-03-20,Orange,59,3164182,249382,248348,10953,259301,4522
2021-03-20,Placer,61,380077,21225,20505,1246,21751,242
2021-03-20,Plumas,63,18699,661,652,11,663,4
2021-03-20,Riverside,65,2383286,285792,282081,14403,296484,4000
2021-03-20,Sacramento,67,1510023,97474,96126,1428,97554,1488
2021-03-20,San Benito,69,59416,5832,5840,96,5936,61
2021-03-20,San Bernardino,71,2135413,287766,284690,8909,293599,3965
2021-03-20,San Diego,73,3302833,268749,267532,0,267532,3493
2021-03-20,San Francisco,75,870044,34916,34968,1257,36225,453
2021-03-20,San Joaquin,77,732212,68809,67662,3189,70851,1161
2021-03-20,San Luis Obispo,79,281455,20099,19951,636,20587,250
2021-03-20,San Mateo,81,765935,40389,39958,429,40387,344
2021-03-20,Santa Barbara,83,443738,33082,32723,1277,34000,434
2021-03-20,Santa Clara,85,1922200,112743,113384,660,114044,1799
2021-03-20,Santa Cruz,87,273765,15643,15053,861,15914,199
2021-03-20,Shasta,89,179085,11182,11211,1409,12620,147
2021-03-20,Sierra,91,2930,53,50,14,64,0
2021-03-20,Siskiyou,93,43540,1540,1483,276,1759,5
2021-03-20,Solano,95,438530,30540,30439,404,30843,170
2021-03-20,Sonoma,97,501317,28846,28962,255,29217,309
2021-03-20,Stanislaus,99,539301,52122,51925,5771,57696,673
2021-03-20,Sutter,101,95872,9029,9014,85,9099,103
2021-03-20,Tehama,103,63373,4708,4696,539,5235,33
2021-03-20,Trinity,105,12862,348,310,52,362,3
2021-03-20,Tulare,107,460477,48478,48030,8964,56994,804
2021-03-20,Tuolumne,109,53932,3948,3950,90,4040,57
2021-03-20,Ventura,111,848112,79079,78818,2990,81808,922
2021-03-20,Yolo,113,214977,13240,13226,257,13483,190
2021-03-20,Yuba,115,75493,5650,5621,98,5719,42
2021-03-19,Alameda,1,1643700,82887,82499,1863,84362,1187
2021-03-19,Alpine,3,1148,84,82,0,82,0
2021-03-19,Amador,5,37829,3533,3515,34,3549,44
2021-03-19,Butte,7,227075,11507,11191,1730,12921,185
2021-03-19,Calaveras,9,45235,1977,1957,13,1970,49
2021-03-19,Colusa,11,21464,1881,1883,278,2161,12
2021-03-19,Contra Costa,13,1133247,64981,64195,1171,65366,737
2021-03-19,Del Norte,15,27424,1104,1071,0,1071,6
2021-03-19,El Dorado,17,186661,9302,9274,642,9916,105
2021-03-19,Fresno,19,978130,98200,97969,8466,106435,1527
2021-03-19,Glenn,21,27897,2309,2282,534,2816,17
2021-03-19,Humboldt,23,135768,3399,3388,24,3412,33
2021-03-19,Imperial,25,180216,27409,27218,2698,29916,695
2021-03-19,Inyo,27,18085,1366,1356,2,1358,35
2021-03-19,Kern,29,883053,94429,93534,10620,104154,1152
2021-03-19,Kings,31,150075,22495,22369,1111,23480,235
2021-03-19,Lake,33,64148,3316,3262,8,3270,43
2021-03-19,Lassen,35,31185,5128,5126,106,5232,1
2021-03-19,Los Angeles,37,10098052,1180256,1174818,42119,1216937,22752
2021-03-19,Madera,39,155013,15921,15877,896,16773,210
2021-03-19,Marin,41,260295,13504,13441,191,13632,220
2021-03-19,Mariposa,43,17540,388,380,6,386,5
2021-03-19,Mendocino,45,87422,3710,3639,65,3704,45
2021-03-19,Merced,47,269075,29435,29376,937,30313,412
2021-03-19,Modoc,49,8938,347,341,120,461,3
2021-03-19,Mono,51,14174,1206,1244,14,1258,3
2021-03-19,Monterey,53,433212,42246,42125,1812,43937,335
2021-03-19,Napa,55,140530,9285,9256,33,9289,77
2021-03-19,Nevada,57,99092,4201,4156,174,4330,88
2021-03-19,Orange,59,3164182,249283,248146,10939,259085,4501
2021-03-19,Placer,61,380077,21207,20451,1244,21695,242
2021-03-19,Plumas,63,18699,661,650,11,661,4
2021-03-19,Riverside,65,2383286,285710,281937,14398,296335,3989
2021-03-19,Sacramento,67,1510023,97372,95934,1425,97359,1486
2021-03-19,San Benito,69,59416,5832,5845,96,5941,61
2021-03-19,San Bernardino,71,2135413,287701,284501,8907,293408,4017
2021-03-19,San Diego,73,3302833,268614,267173,0,267173,3491
2021-03-19,San Francisco,75,870044,34871,34936,1254,36190,461
2021-03-19,San Joaquin,77,732212,68739,67515,3175,70690,1180
2021-03-19,San Luis Obispo,79,281455,20079,19913,634,20547,249
2021-03-19,San Mateo,81,765935,40365,39893,429,40322,344
2021-03-19,Santa Barbara,83,443738,33053,32685,1276,33961,435
2021-03-19,Santa Clara,85,1922200,112669,113232,659,113891,1797
2021-03-19,Santa Cruz,87,273765,15636,15026,861,15887,199
2021-03-19,Shasta,89,179085,11175,11104,1407,12511,103
2021-03-19,Sierra,91,2930,52,49,14,63,0
2021-03-19,Siskiyou,93,43540,1540,1480,275,1755,5
2021-03-19,Solano,95,438530,30510,30395,402,30797,172
2021-03-19,Sonoma,97,501317,28826,28932,253,29185,292
2021-03-19,Stanislaus,99,539301,52064,51755,5768,57523,679
2021-03-19,Sutter,101,95872,9027,9005,85,9090,103
2021-03-19,Tehama,103,63373,4699,4685,539,5224,33
2021-03-19,Trinity,105,12862,348,310,52,362,3
2021-03-19,Tulare,107,460477,48456,47989,8941,56930,805
2021-03-19,Tuolumne,109,53932,3945,3946,90,4036,57
2021-03-19,Ventura,111,848112,79041,78753,2985,81738,920
2021-03-19,Yolo,113,214977,13232,13197,257,13454,189
2021-03-19,Yuba,115,75493,5647,5615,97,5712,42
2021-03-18,Alameda,1,1643700,82803,82419,1860,84279,1189
2021-03-18,Alpine,3,1148,84,82,0,82,0
2021-03-18,Amador,5,37829,3529,3513,34,3547,44
2021-03-18,Butte,7,227075,11496,11179,1728,12907,185
2021-03-18,Calaveras,9,45235,1975,1954,13,1967,49
2021-03-18,Colusa,11,21464,1881,1882,278,2160,12
2021-03-18,Contra Costa,13,1133247,64908,64103,1168,65271,739
2021-03-18,Del Norte,15,27424,1095,1059,0,1059,6
2021-03-18,El Dorado,17,186661,9289,9261,641,9902,105
2021-03-18,Fresno,19,978130,98105,97856,8451,106307,1527
2021-03-18,Glenn,21,27897,2305,2275,533,2808,17
2021-03-18,Humboldt,23,135768,3392,3381,24,3405,34
2021-03-18,Imperial,25,180216,27393,27190,2692,29882,695
2021-03-18,Inyo,27,18085,1363,1354,2,1356,35
2021-03-18,Kern,29,883053,94373,93458,10606,104064,1158
2021-03-18,Kings,31,150075,22489,22354,1110,23464,235
2021-03-18,Lake,33,64148,3313,3260,8,3268,43
2021-03-18,Lassen,35,31185,5127,5126,106,5232,1
2021-03-18,Los Angeles,37,10098052,1179828,1174205,42088,1216293,22689
2021-03-18,Madera,39,155013,15911,15860,894,16754,211
2021-03-18,Marin,41,260295,13486,13435,190,13625,219
2021-03-18,Mariposa,43,17540,386,380,6,386,5
2021-03-18,Mendocino,45,87422,3700,3630,65,3695,45
2021-03-18,Merced,47,269075,29400,29317,937,30254,410
2021-03-18,Modoc,49,8938,347,341,120,461,3
2021-03-18,Mono,51,14174,1202,1215,14,1229,3
2021-03-18,Monterey,53,433212,42232,42105,1812,43917,335
2021-03-18,Napa,55,140530,9276,9243,33,9276,77
2021-03-18,Nevada,57,99092,4194,4154,174,4328,74
2021-03-18,Orange,59,3164182,249180,248050,10926,258976,4514
2021-03-18,Placer,61,380077,21174,20421,1241,21662,243
2021-03-18,Plumas,63,18699,659,648,11,659,4
2021-03-18,Riverside,65,2383286,285631,281789,14391,296180,3957
2021-03-18,Sacramento,67,1510023,97221,95819,1421,97240,1481
2021-03-18,San Benito,69,59416,5830,5842,96,5938,61
2021-03-18,San Bernardino,71,2135413,287624,284294,8877,293171,4076
2021-03-18,San Diego,73,3302833,268462,266752,0,266752,3478
2021-03-18,San Francisco,75,870044,34833,34904,1253,36157,461
2021-03-18,San Joaquin,77,732212,68639,67301,3163,70464,1169
2021-03-18,San Luis Obispo,79,281455,20050,19894,633,20527,249
2021-03-18,San Mateo,81,765935,40324,39874,429,40303,344
2021-03-18,Santa Barbara,83,443738,33011,32640,1276,33916,434
2021-03-18,Santa Clara,85,1922200,112552,113119,655,113774,1808
2021-03-18,Santa Cruz,87,273765,15626,14998,861,15859,198
2021-03-18,Shasta,89,179085,11161,11059,1404,12463,100
2021-03-18,Sierra,91,2930,52,49,14,63,0
2021-03-18,Siskiyou,93,43540,1537,1480,274,1754,5
2021-03-18,Solano,95,438530,30468,30352,399,30751,172
2021-03-18,Sonoma,97,501317,28803,28915,251,29166,292
2021-03-18,Stanislaus,99,539301,51993,51615,5764,57379,682
2021-03-18,Sutter,101,95872,9015,8999,85,9084,103
2021-03-18,Tehama,103,63373,4693,4683,538,5221,35
2021-03-18,Trinity,105,12862,348,310,52,362,3
2021-03-18,Tulare,107,460477,48437,47964,8926,56890,805
2021-03-18,Tuolumne,109,53932,3945,3942,90,4032,57
2021-03-18,Ventura,111,848112,78985,78697,2985,81682,918
2021-03-18,Yolo,113,214977,13219,13183,257,13440,191
2021-03-18,Yuba,115,75493,5643,5612,97,5709,42
2021-03-17,Alameda,1,1643700,82728,82353,1855,84208,1185
2021-03-17,Alpine,3,1148,84,82,0,82,0
2021-03-17,Amador,5,37829,3527,3511,34,3545,44
2021-03-17,Butte,7,227075,11487,11170,1726,12896,185
2021-03-17,Calaveras,9,45235,1974,1946,13,1959,49
2021-03-17,Colusa,11,21464,1880,1882,278,2160,12
2021-03-17,Contra Costa,13,1133247,64838,64026,1167,65193,737
2021-03-17,Del Norte,15,27424,1091,1053,0,1053,6
2021-03-17,El Dorado,17,186661,9279,9252,641,9893,105
2021-03-17,Fresno,19,978130,97995,97727,8431,106158,1507
2021-03-17,Glenn,21,27897,2298,2269,532,2801,17
2021-03-17,Humboldt,23,135768,3384,3365,24,3389,33
2021-03-17,Imperial,25,180216,27376,27168,2690,29858,691
2021-03-17,Inyo,27,18085,1361,1351,2,1353,35
2021-03-17,Kern,29,883053,94317,93392,10593,103985,1149
2021-03-17,Kings,31,150075,22473,22336,1109,23445,233
2021-03-17,Lake,33,64148,3306,3251,8,3259,43
2021-03-17,Lassen,35,31185,5126,5125,106,5231,1
2021-03-17,Los Angeles,37,10098052,1179380,1173416,42054,1215470,22602
2021-03-17,Madera,39,155013,15904,15835,893,16728,214
2021-03-17,Marin,41,260295,13468,13428,189,13617,218
2021-03-17,Mariposa,43,17540,386,379,6,385,5
2021-03-17,Mendocino,45,87422,3696,3625,65,3690,44
2021-03-17,Merced,47,269075,29372,29250,933,30183,408
2021-03-17,Modoc,49,8938,347,341,120,461,3
2021-03-17,Mono,51,14174,1200,1212,14,1226,3
2021-03-17,Monterey,53,433212,42213,42061,1809,43870,334
2021-03-17,Napa,55,140530,9261,9219,33,9252,76
2021-03-17,Nevada,57,99092,4184,4145,174,4319,74
2021-03-17,Orange,59,3164182,249063,247943,10898,258841,4502
2021-03-17,Placer,61,380077,21147,20369,1239,21608,243
2021-03-17,Plumas,63,18699,658,645,11,656,4
2021-03-17,Riverside,65,2383286,285520,281649,14383,296032,3925
2021-03-17,Sacramento,67,1510023,97094,95650,1415,97065,1477
2021-03-17,San Benito,69,59416,5827,5841,96,5937,61
2021-03-17,San Bernardino,71,2135413,287508,284170,8872,293042,4049
2021-03-17,San Diego,73,3302833,268251,266313,0,266313,3470
2021-03-17,San Francisco,75,870044,34798,34873,1252,36125,457
2021-03-17,San Joaquin,77,732212,68557,67093,3147,70240,1164
2021-03-17,San Luis Obispo,79,281455,20027,19858,629,20487,249
2021-03-17,San Mateo,81,765935,40293,39838,428,40266,344
2021-03-17,Santa Barbara,83,443738,32991,32585,1275,33860,433
2021-03-17,Santa Clara,85,1922200,112459,112983,654,113637,1805
2021-03-17,Santa Cruz,87,273765,15618,14967,861,15828,199
2021-03-17,Shasta,89,179085,11156,11045,1398,12443,100
2021-03-17,Sierra,91,2930,52,49,14,63,0
2021-03-17,Siskiyou,93,43540,1536,1479,272,1751,5
2021-03-17,Solano,95,438530,30442,30320,397,30717,171
2021-03-17,Sonoma,97,501317,28780,28877,250,29127,292
2021-03-17,Stanislaus,99,539301,51920,51524,5757,57281,682
2021-03-17,Sutter,101,95872,9005,8982,85,9067,103
2021-03-17,Tehama,103,63373,4687,4670,538,5208,34
2021-03-17,Trinity,105,12862,348,308,52,360,3
2021-03-17,Tulare,107,460477,48417,47929,8916,56845,805
2021-03-17,Tuolumne,109,53932,3942,3938,90,4028,57
2021-03-17,Ventura,111,848112,78930,78648,2982,81630,916
2021-03-17,Yolo,113,214977,13204,13169,256,13425,190
2021-03-17,Yuba,115,75493,5640,5603,97,5700,42
2021-03-16,Alameda,1,1643700,82628,82259,1853,84112,1177
2021-03-16,Alpine,3,1148,84,82,0,82,0
2021-03-16,Amador,5,37829,3525,3510,34,3544,44
2021-03-16,Butte,7,227075,11475,11154,1725,12879,184
2021-03-16,Calaveras,9,45235,1969,1945,13,1958,49
2021-03-16,Colusa,11,21464,1879,1882,278,2160,12
2021-03-16,Contra Costa,13,1133247,64757,63951,1163,65114,736
2021-03-16,Del Norte,15,27424,1083,1048,0,1048,6
2021-03-16,El Dorado,17,186661,9262,9249,641,9890,105
2021-03-16,Fresno,19,978130,97863,97638,8407,106045,1498
2021-03-16,Glenn,21,27897,2290,2267,528,2795,17
2021-03-16,Humboldt,23,135768,3380,3351,24,3375,33
2021-03-16,Imperial,25,180216,27365,27143,2687,29830,689
2021-03-16,Inyo,27,18085,1360,1346,2,1348,35
2021-03-16,Kern,29,883053,94252,93340,10577,103917,1144
2021-03-16,Kings,31,150075,22439,22320,1108,23428,233
2021-03-16,Lake,33,64148,3298,3246,8,3254,43
2021-03-16,Lassen,35,31185,5125,5126,106,5232,1
2021-03-16,Los Angeles,37,10098052,1178861,1172676,42014,1214690,22527
2021-03-16,Madera,39,155013,15889,15822,891,16713,214
2021-03-16,Marin,41,260295,13450,13419,189,13608,218
2021-03-16,Mariposa,43,17540,383,379,6,385,5
2021-03-16,Mendocino,45,87422,3691,3623,65,3688,44
2021-03-16,Merced,47,269075,29319,29198,932,30130,407
2021-03-16,Modoc,49,8938,347,341,120,461,3
2021-03-16,Mono,51,14174,1199,1207,14,1221,3
2021-03-16,Monterey,53,433212,42194,42023,1809,43832,334
2021-03-16,Napa,55,140530,9251,9209,33,9242,75
2021-03-16,Nevada,57,99092,4175,4132,173,4305,67
2021-03-16,Orange,59,3164182,248936,247843,10877,258720,4479
2021-03-16,Placer,61,380077,21114,20339,1235,21574,240
2021-03-16,Plumas,63,18699,657,643,11,654,4
2021-03-16,Riverside,65,2383286,285419,281540,14365,295905,3893
2021-03-16,Sacramento,67,1510023,96959,95522,1412,96934,1466
2021-03-16,San Benito,69,59416,5822,5831,96,5927,61
2021-03-16,San Bernardino,71,2135413,287392,283980,8864,292844,4032
2021-03-16,San Diego,73,3302833,268022,265903,0,265903,3462
2021-03-16,San Francisco,75,870044,34769,34833,1248,36081,456
2021-03-16,San Joaquin,77,732212,68455,66856,3134,69990,1163
2021-03-16,San Luis Obispo,79,281455,19998,19832,627,20459,248
2021-03-16,San Mateo,81,765935,40259,39806,427,40233,344
2021-03-16,Santa Barbara,83,443738,32959,32556,1274,33830,433
2021-03-16,Santa Clara,85,1922200,112342,112845,651,113496,1797
2021-03-16,Santa Cruz,87,273765,15612,14926,861,15787,199
2021-03-16,Shasta,89,179085,11143,11035,1393,12428,100
2021-03-16,Sierra,91,2930,51,49,14,63,0
2021-03-16,Siskiyou,93,43540,1532,1477,272,1749,5
2021-03-16,Solano,95,438530,30408,30298,396,30694,171
2021-03-16,Sonoma,97,501317,28750,28850,248,29098,291
2021-03-16,Stanislaus,99,539301,51841,51410,5749,57159,683
2021-03-16,Sutter,101,95872,8997,8970,85,9055,102
2021-03-16,Tehama,103,63373,4683,4660,537,5197,34
2021-03-16,Trinity,105,12862,348,308,51,359,3
2021-03-16,Tulare,107,460477,48369,47895,8908,56803,803
2021-03-16,Tuolumne,109,53932,3939,3938,90,4028,57
2021-03-16,Ventura,111,848112,78863,78671,2975,81646,916
2021-03-16,Yolo,113,214977,13189,13162,256,13418,190
2021-03-16,Yuba,115,75493,5637,5596,96,5692,42
2021-03-15,Alameda,1,1643700,82541,82159,1853,84012,1167
2021-03-15,Alpine,3,1148,84,82,0,82,0
2021-03-15,Amador,5,37829,3524,3506,34,3540,44
2021-03-15,Butte,7,227075,11462,11141,1721,12862,185
2021-03-15,Calaveras,9,45235,1965,1941,13,1954,49
2021-03-15,Colusa,11,21464,1879,1883,278,2161,12
2021-03-15,Contra Costa,13,1133247,64696,63847,1162,65009,732
2021-03-15,Del Norte,15,27424,1080,1048,0,1048,6
2021-03-15,El Dorado,17,186661,9256,9235,640,9875,103
2021-03-15,Fresno,19,978130,97737,97520,8390,105910,1496
2021-03-15,Glenn,21,27897,2285,2261,525,2786,15
2021-03-15,Humboldt,23,135768,3374,3337,24,3361,32
2021-03-15,Imperial,25,180216,27344,27122,2685,29807,684
2021-03-15,Inyo,27,18085,1360,1346,2,1348,35
2021-03-15,Kern,29,883053,94192,93266,10570,103836,1141
2021-03-15,Kings,31,150075,22422,22294,1103,23397,233
2021-03-15,Lake,33,64148,3286,3237,8,3245,43
2021-03-15,Lassen,35,31185,5125,5125,106,5231,1
2021-03-15,Los Angeles,37,10098052,1178303,1172445,41973,1214418,22477
2021-03-15,Madera,39,155013,15878,15806,889,16695,214
2021-03-15,Marin,41,260295,13444,13408,188,13596,218
2021-03-15,Mariposa,43,17540,383,376,6,382,5
2021-03-15,Mendocino,45,87422,3687,3615,65,3680,44
2021-03-15,Merced,47,269075,29279,29169,930,30099,407
2021-03-15,Modoc,49,8938,347,340,120,460,3
2021-03-15,Mono,51,14174,1198,1206,14,1220,3
2021-03-15,Monterey,53,433212,42166,42011,1806,43817,333
2021-03-15,Napa,55,140530,9240,9196,33,9229,75
2021-03-15,Nevada,57,99092,4170,4123,172,4295,66
2021-03-15,Orange,59,3164182,248824,247697,10857,258554,4481
2021-03-15,Placer,61,380077,21091,20308,1235,21543,238
2021-03-15,Plumas,63,18699,657,642,11,653,4
2021-03-15,Riverside,65,2383286,285276,281367,14353,295720,3856
2021-03-15,Sacramento,67,1510023,96805,95414,1406,96820,1463
2021-03-15,San Benito,69,59416,5819,5831,96,5927,61
2021-03-15,San Bernardino,71,2135413,287297,283815,8856,292671,4004
2021-03-15,San Diego,73,3302833,267771,265646,0,265646,3452
2021-03-15,San Francisco,75,870044,34733,34820,1244,36064,456
2021-03-15,San Joaquin,77,732212,68351,66622,3121,69743,1140
2021-03-15,San Luis Obispo,79,281455,19969,19813,622,20435,247
2021-03-15,San Mateo,81,765935,40206,39765,427,40192,344
2021-03-15,Santa Barbara,83,443738,32937,32529,1271,33800,431
2021-03-15,Santa Clara,85,1922200,112241,112729,649,113378,1798
2021-03-15,Santa Cruz,87,273765,15606,14899,859,15758,200
2021-03-15,Shasta,89,179085,11127,11019,1386,12405,92
2021-03-15,Sierra,91,2930,51,49,14,63,0
2021-03-15,Siskiyou,93,43540,1532,1475,272,1747,5
2021-03-15,Solano,95,438530,30379,30258,395,30653,171
2021-03-15,Sonoma,97,501317,28732,28814,245,29059,285
2021-03-15,Stanislaus,99,539301,51764,51357,5741,57098,683
2021-03-15,Sutter,101,95872,8991,8962,85,9047,102
2021-03-15,Tehama,103,63373,4673,4650,536,5186,34
2021-03-15,Trinity,105,12862,348,308,51,359,3
2021-03-15,Tulare,107,460477,48339,47857,8893,56750,800
2021-03-15,Tuolumne,109,53932,3937,3937,64,4001,57
2021-03-15,Ventura,111,848112,78809,78626,2974,81600,910
2021-03-15,Yolo,113,214977,13170,13131,254,13385,190
2021-03-15,Yuba,115,75493,5632,5585,95,5680,42
2021-03-14,Alameda,1,1643700,82454,82116,1850,83966,1168
2021-03-14,Alpine,3,1148,84,82,0,82,0
2021-03-14,Amador,5,37829,3519,3504,34,3538,44
2021-03-14,Butte,7,227075,11449,11140,1717,12857,185
2021-03-14,Calaveras,9,45235,1961,1939,13,1952,49
2021-03-14,Colusa,11,21464,1879,1883,278,2161,12
2021-03-14,Contra Costa,13,1133247,64592,63808,1160,64968,731
2021-03-14,Del Norte,15,27424,1066,1048,0,1048,6
2021-03-14,El Dorado,17,186661,9246,9231,640,9871,103
2021-03-14,Fresno,19,978130,97630,97461,8370,105831,1496
2021-03-14,Glenn,21,27897,2280,2260,522,2782,15
2021-03-14,Humboldt,23,135768,3360,3335,24,3359,32
2021-03-14,Imperial,25,180216,27326,27122,2681,29803,685
2021-03-14,Inyo,27,18085,1356,1346,2,1348,35
2021-03-14,Kern,29,883053,94112,93252,10548,103800,1141
2021-03-14,Kings,31,150075,22404,22292,1100,23392,232
2021-03-14,Lake,33,64148,3281,3237,8,3245,43
2021-03-14,Lassen,35,31185,5123,5125,106,5231,1
2021-03-14,Los Angeles,37,10098052,1177735,1172100,41934,1214034,22476
2021-03-14,Madera,39,155013,15857,15804,889,16693,214
2021-03-14,Marin,41,260295,13428,13405,186,13591,218
2021-03-14,Mariposa,43,17540,381,376,6,382,5
2021-03-14,Mendocino,45,87422,3682,3613,65,3678,44
2021-03-14,Merced,47,269075,29211,29149,926,30075,407
2021-03-14,Modoc,49,8938,347,340,120,460,3
2021-03-14,Mono,51,14174,1192,1206,14,1220,3
2021-03-14,Monterey,53,433212,42144,42007,1802,43809,333
2021-03-14,Napa,55,140530,9222,9194,33,9227,75
2021-03-14,Nevada,57,99092,4164,4122,170,4292,66
2021-03-14,Orange,59,3164182,248689,247656,10835,258491,4460
2021-03-14,Placer,61,380077,21058,20288,1227,21515,238
2021-03-14,Plumas,63,18699,655,642,11,653,4
2021-03-14,Riverside,65,2383286,285125,281332,14343,295675,3845
2021-03-14,Sacramento,67,1510023,96629,95343,1401,96744,1462
2021-03-14,San Benito,69,59416,5810,5829,96,5925,61
2021-03-14,San Bernardino,71,2135413,287168,283791,8839,292630,3996
2021-03-14,San Diego,73,3302833,267536,265468,0,265468,3452
2021-03-14,San Francisco,75,870044,34696,34810,1240,36050,455
2021-03-14,San Joaquin,77,732212,68223,66563,3102,69665,1140
2021-03-14,San Luis Obispo,79,281455,19941,19806,620,20426,247
2021-03-14,San Mateo,81,765935,40167,39744,427,40171,342
2021-03-14,Santa Barbara,83,443738,32893,32514,1269,33783,431
2021-03-14,Santa Clara,85,1922200,112114,112648,648,113296,1796
2021-03-14,Santa Cruz,87,273765,15589,14887,857,15744,200
2021-03-14,Shasta,89,179085,11111,11019,1377,12396,92
2021-03-14,Sierra,91,2930,51,49,14,63,0
2021-03-14,Siskiyou,93,43540,1528,1473,271,1744,5
2021-03-14,Solano,95,438530,30347,30230,390,30620,171
2021-03-14,Sonoma,97,501317,28698,28798,241,29039,284
2021-03-14,Stanislaus,99,539301,51645,51306,5732,57038,690
2021-03-14,Sutter,101,95872,8975,8958,85,9043,102
2021-03-14,Tehama,103,63373,4661,4650,535,5185,34
2021-03-14,Trinity,105,12862,347,308,50,358,3
2021-03-14,Tulare,107,460477,48306,47845,8872,56717,800
2021-03-14,Tuolumne,109,53932,3935,3937,64,4001,57
2021-03-14,Ventura,111,848112,78756,78611,2968,81579,910
2021-03-14,Yolo,113,214977,13148,13128,250,13378,189
2021-03-14,Yuba,115,75493,5622,5583,95,5678,42
2021-03-13,Alameda,1,1643700,82394,82010,1850,83860,1168
2021-03-13,Alpine,3,1148,84,82,0,82,0
2021-03-13,Amador,5,37829,3516,3504,34,3538,44
2021-03-13,Butte,7,227075,11439,11131,1716,12847,185
2021-03-13,Calaveras,9,45235,1957,1939,13,1952,49
2021-03-13,Colusa,11,21464,1879,1882,278,2160,12
2021-03-13,Contra Costa,13,1133247,64532,63689,1160,64849,731
2021-03-13,Del Norte,15,27424,1062,1041,0,1041,6
2021-03-13,El Dorado,17,186661,9238,9221,640,9861,103
2021-03-13,Fresno,19,978130,97571,97324,8350,105674,1495
2021-03-13,Glenn,21,27897,2279,2260,521,2781,15
2021-03-13,Humboldt,23,135768,3353,3325,24,3349,32
2021-03-13,Imperial,25,180216,27321,27099,2676,29775,677
2021-03-13,Inyo,27,18085,1355,1344,2,1346,35
2021-03-13,Kern,29,883053,94073,93197,10541,103738,1140
2021-03-13,Kings,31,150075,22388,22265,1099,23364,232
2021-03-13,Lake,33,64148,3274,3234,7,3241,43
2021-03-13,Lassen,35,31185,5123,5125,106,5231,1
2021-03-13,Los Angeles,37,10098052,1177420,1171505,41890,1213395,22451
2021-03-13,Madera,39,155013,15845,15780,889,16669,214
2021-03-13,Marin,41,260295,13422,13391,184,13575,218
2021-03-13,Mariposa,43,17540,380,376,6,382,5
2021-03-13,Mendocino,45,87422,3678,3611,65,3676,44
2021-03-13,Merced,47,269075,29180,29106,926,30032,406
2021-03-13,Modoc,49,8938,347,340,119,459,3
2021-03-13,Mono,51,14174,1192,1207,14,1221,3
2021-03-13,Monterey,53,433212,42134,41989,1800,43789,332
2021-03-13,Napa,55,140530,9216,9190,33,9223,75
2021-03-13,Nevada,57,99092,4157,4111,169,4280,66
2021-03-13,Orange,59,3164182,248609,247514,10818,258332,4423
2021-03-13,Placer,61,380077,21038,20238,1224,21462,239
2021-03-13,Plumas,63,18699,653,642,11,653,4
2021-03-13,Riverside,65,2383286,285038,281191,14335,295526,3848
2021-03-13,Sacramento,67,1510023,96543,95192,1399,96591,1461
2021-03-13,San Benito,69,59416,5807,5823,96,5919,61
2021-03-13,San Bernardino,71,2135413,287118,283727,8833,292560,3972
2021-03-13,San Diego,73,3302833,267381,265270,0,265270,3444
2021-03-13,San Francisco,75,870044,34679,34784,1231,36015,455
2021-03-13,San Joaquin,77,732212,68167,66480,3086,69566,1141
2021-03-13,San Luis Obispo,79,281455,19922,19789,619,20408,247
2021-03-13,San Mateo,81,765935,40140,39689,426,40115,341
2021-03-13,Santa Barbara,83,443738,32868,32486,1268,33754,431
2021-03-13,Santa Clara,85,1922200,112029,112531,647,113178,1790
2021-03-13,Santa Cruz,87,273765,15582,14875,857,15732,199
2021-03-13,Shasta,89,179085,11103,11021,1374,12395,108
2021-03-13,Sierra,91,2930,50,49,14,63,0
2021-03-13,Siskiyou,93,43540,1527,1470,271,1741,5
2021-03-13,Solano,95,438530,30330,30198,390,30588,171
2021-03-13,Sonoma,97,501317,28677,28762,237,28999,285
2021-03-13,Stanislaus,99,539301,51595,51257,5728,56985,695
2021-03-13,Sutter,101,95872,8968,8948,85,9033,102
2021-03-13,Tehama,103,63373,4659,4647,535,5182,33
2021-03-13,Trinity,105,12862,347,306,50,356,3
2021-03-13,Tulare,107,460477,48281,47818,8863,56681,798
2021-03-13,Tuolumne,109,53932,3932,3937,64,4001,57
2021-03-13,Ventura,111,848112,78707,78693,2968,81661,906
2021-03-13,Yolo,113,214977,13140,13087,249,13336,189
2021-03-13,Yuba,115,75493,5621,5577,95,5672,42
2021-03-12,Alameda,1,1643700,82316,81898,1849,83747,1164
2021-03-12,Alpine,3,1148,84,82,0,82,0
2021-03-12,Amador,5,37829,3513,3503,34,3537,44
2021-03-12,Butte,7,227075,11429,11126,1714,12840,184
2021-03-12,Calaveras,9,45235,1955,1916,13,1929,49
2021-03-12,Colusa,11,21464,1879,1883,278,2161,12
2021-03-12,Contra Costa,13,1133247,64457,63583,1159,64742,728
2021-03-12,Del Norte,15,27424,1056,1033,0,1033,6
2021-03-12,El Dorado,17,186661,9229,9219,640,9859,103
2021-03-12,Fresno,19,978130,97477,97185,8337,105522,1489
2021-03-12,Glenn,21,27897,2278,2258,520,2778,15
2021-03-12,Humboldt,23,135768,3348,3315,24,3339,32
2021-03-12,Imperial,25,180216,27310,27071,2674,29745,677
2021-03-12,Inyo,27,18085,1353,1339,2,1341,35
2021-03-12,Kern,29,883053,94038,93142,10525,103667,1132
2021-03-12,Kings,31,150075,22369,22233,1099,23332,232
2021-03-12,Lake,33,64148,3268,3226,6,3232,43
2021-03-12,Lassen,35,31185,5123,5125,105,5230,1
2021-03-12,Los Angeles,37,10098052,1177025,1170860,41873,1212733,22409
2021-03-12,Madera,39,155013,15833,15761,886,16647,214
2021-03-12,Marin,41,260295,13415,13375,184,13559,218
2021-03-12,Mariposa,43,17540,378,376,6,382,5
2021-03-12,Mendocino,45,87422,3675,3605,65,3670,43
2021-03-12,Merced,47,269075,29149,29064,926,29990,403
2021-03-12,Modoc,49,8938,347,340,119,459,3
2021-03-12,Mono,51,14174,1191,1206,14,1220,3
2021-03-12,Monterey,53,433212,42120,41964,1795,43759,329
2021-03-12,Napa,55,140530,9207,9180,33,9213,75
2021-03-12,Nevada,57,99092,4147,4101,169,4270,66
2021-03-12,Orange,59,3164182,248518,247388,10807,258195,4401
2021-03-12,Placer,61,380077,21005,20210,1219,21429,239
2021-03-12,Plumas,63,18699,652,641,11,652,4
2021-03-12,Riverside,65,2383286,284940,281037,14325,295362,3854
2021-03-12,Sacramento,67,1510023,96420,95061,1392,96453,1460
2021-03-12,San Benito,69,59416,5804,5817,96,5913,61
2021-03-12,San Bernardino,71,2135413,287065,283558,8827,292385,3917
2021-03-12,San Diego,73,3302833,267218,264886,0,264886,3434
2021-03-12,San Francisco,75,870044,34658,34758,1228,35986,452
2021-03-12,San Joaquin,77,732212,68097,66482,3076,69558,1144
2021-03-12,San Luis Obispo,79,281455,19908,19769,617,20386,247
2021-03-12,San Mateo,81,765935,40104,39638,424,40062,341
2021-03-12,Santa Barbara,83,443738,32845,32457,1265,33722,429
2021-03-12,Santa Clara,85,1922200,111935,112396,645,113041,1766
2021-03-12,Santa Cruz,87,273765,15570,14846,855,15701,195
2021-03-12,Shasta,89,179085,11095,11143,1372,12515,153
2021-03-12,Sierra,91,2930,50,49,14,63,0
2021-03-12,Siskiyou,93,43540,1527,1468,270,1738,5
2021-03-12,Solano,95,438530,30311,30180,389,30569,171
2021-03-12,Sonoma,97,501317,28651,28714,236,28950,285
2021-03-12,Stanislaus,99,539301,51536,51146,5721,56867,701
2021-03-12,Sutter,101,95872,8962,8940,85,9025,101
2021-03-12,Tehama,103,63373,4655,4638,534,5172,33
2021-03-12,Trinity,105,12862,346,306,49,355,3
2021-03-12,Tulare,107,460477,48257,47772,8856,56628,798
2021-03-12,Tuolumne,109,53932,3931,3936,64,4000,57
2021-03-12,Ventura,111,848112,78665,78698,2963,81661,899
2021-03-12,Yolo,113,214977,13130,13061,242,13303,189
2021-03-12,Yuba,115,75493,5614,5563,94,5657,42
2021-03-11,Alameda,1,1643700,82223,81809,1844,83653,1164
2021-03-11,Alpine,3,1148,84,78,0,78,0
2021-03-11,Amador,5,37829,3512,3498,34,3532,42
2021-03-11,Butte,7,227075,11418,11110,1712,12822,185
2021-03-11,Calaveras,9,45235,1952,1915,13,1928,49
2021-03-11,Colusa,11,21464,1879,1883,278,2161,12
2021-03-11,Contra Costa,13,1133247,64384,63469,1156,64625,728
2021-03-11,Del Norte,15,27424,1051,1027,0,1027,6
2021-03-11,El Dorado,17,186661,9215,9211,640,9851,101
2021-03-11,Fresno,19,978130,97362,97026,8309,105335,1481
2021-03-11,Glenn,21,27897,2275,2255,520,2775,15
2021-03-11,Humboldt,23,135768,3331,3302,24,3326,32
2021-03-11,Imperial,25,180216,27303,27045,2670,29715,675
2021-03-11,Inyo,27,18085,1348,1335,2,1337,35
2021-03-11,Kern,29,883053,93983,93052,10486,103538,1121
2021-03-11,Kings,31,150075,22354,22183,1096,23279,230
2021-03-11,Lake,33,64148,3264,3214,6,3220,42
2021-03-11,Lassen,35,31185,5122,5124,105,5229,1
2021-03-11,Los Angeles,37,10098052,1176496,1170111,41839,1211950,22316
2021-03-11,Madera,39,155013,15822,15725,885,16610,214
2021-03-11,Marin,41,260295,13404,13356,183,13539,217
2021-03-11,Mariposa,43,17540,378,376,6,382,5
2021-03-11,Mendocino,45,87422,3668,3604,65,3669,42
2021-03-11,Merced,47,269075,29100,29001,925,29926,401
2021-03-11,Modoc,49,8938,347,340,119,459,3
2021-03-11,Mono,51,14174,1190,1206,14,1220,3
2021-03-11,Monterey,53,433212,42097,41936,1789,43725,329
2021-03-11,Napa,55,140530,9194,9173,33,9206,75
2021-03-11,Nevada,57,99092,4135,4085,167,4252,66
2021-03-11,Orange,59,3164182,248380,247217,10792,258009,4373
2021-03-11,Placer,61,380077,20961,20178,1215,21393,239
2021-03-11,Plumas,63,18699,651,640,11,651,4
2021-03-11,Riverside,65,2383286,284776,280881,14312,295193,3842
2021-03-11,Sacramento,67,1510023,96280,94912,1389,96301,1455
2021-03-11,San Benito,69,59416,5802,5816,95,5911,61
2021-03-11,San Bernardino,71,2135413,286973,283312,8820,292132,3869
2021-03-11,San Diego,73,3302833,267054,264524,0,264524,3422
2021-03-11,San Francisco,75,870044,34622,34722,1222,35944,452
2021-03-11,San Joaquin,77,732212,67986,66522,3067,69589,1157
2021-03-11,San Luis Obispo,79,281455,19883,19748,616,20364,247
2021-03-11,San Mateo,81,765935,40066,39590,423,40013,341
2021-03-11,Santa Barbara,83,443738,32819,32408,1262,33670,430
2021-03-11,Santa Clara,85,1922200,111806,112246,642,112888,1765
2021-03-11,Santa Cruz,87,273765,15558,14812,854,15666,193
2021-03-11,Shasta,89,179085,11085,11139,1366,12505,158
2021-03-11,Sierra,91,2930,50,48,14,62,0
2021-03-11,Siskiyou,93,43540,1524,1466,270,1736,5
2021-03-11,Solano,95,438530,30284,30138,388,30526,171
2021-03-11,Sonoma,97,501317,28621,28677,236,28913,285
2021-03-11,Stanislaus,99,539301,51452,51038,5713,56751,707
2021-03-11,Sutter,101,95872,8956,8933,85,9018,101
2021-03-11,Tehama,103,63373,4646,4632,533,5165,33
2021-03-11,Trinity,105,12862,345,304,48,352,3
2021-03-11,Tulare,107,460477,48221,47709,8844,56553,797
2021-03-11,Tuolumne,109,53932,3929,3934,64,3998,57
2021-03-11,Ventura,111,848112,78615,78697,2959,81656,889
2021-03-11,Yolo,113,214977,13112,13041,240,13281,190
2021-03-11,Yuba,115,75493,5610,5553,94,5647,42
2021-03-10,Alameda,1,1643700,82114,81701,1838,83539,1160
2021-03-10,Alpine,3,1148,83,78,0,78,0
2021-03-10,Amador,5,37829,3510,3496,34,3530,42
2021-03-10,Butte,7,227075,11408,11096,1712,12808,185
2021-03-10,Calaveras,9,45235,1948,1913,13,1926,48
2021-03-10,Colusa,11,21464,1879,1882,278,2160,12
2021-03-10,Contra Costa,13,1133247,64286,63372,1152,64524,725
2021-03-10,Del Norte,15,27424,1049,1020,0,1020,5
2021-03-10,El Dorado,17,186661,9203,9203,639,9842,100
2021-03-10,Fresno,19,978130,97257,96866,8291,105157,1471
2021-03-10,Glenn,21,27897,2272,2253,518,2771,15
2021-03-10,Humboldt,23,135768,3321,3296,23,3319,32
2021-03-10,Imperial,25,180216,27288,27051,2670,29721,675
2021-03-10,Inyo,27,18085,1348,1328,2,1330,35
2021-03-10,Kern,29,883053,93917,92965,10463,103428,1102
2021-03-10,Kings,31,150075,22335,22166,1094,23260,226
2021-03-10,Lake,33,64148,3254,3207,6,3213,42
2021-03-10,Lassen,35,31185,5122,5120,105,5225,1
2021-03-10,Los Angeles,37,10098052,1175952,1169079,41809,1210888,22199
2021-03-10,Madera,39,155013,15801,15705,882,16587,212
2021-03-10,Marin,41,260295,13394,13348,182,13530,216
2021-03-10,Mariposa,43,17540,378,376,6,382,5
2021-03-10,Mendocino,45,87422,3663,3602,65,3667,42
2021-03-10,Merced,47,269075,29063,28927,923,29850,401
2021-03-10,Modoc,49,8938,346,338,119,457,3
2021-03-10,Mono,51,14174,1187,1204,14,1218,3
2021-03-10,Monterey,53,433212,42075,41920,1785,43705,329
2021-03-10,Napa,55,140530,9185,9165,33,9198,75
2021-03-10,Nevada,57,99092,4131,4074,167,4241,66
2021-03-10,Orange,59,3164182,248235,247075,10772,257847,4342
2021-03-10,Placer,61,380077,20926,20144,1209,21353,239
2021-03-10,Plumas,63,18699,650,639,11,650,4
2021-03-10,Riverside,65,2383286,284640,280708,14298,295006,3822
2021-03-10,Sacramento,67,1510023,96150,94796,1383,96179,1452
2021-03-10,San Benito,69,59416,5793,5811,95,5906,61
2021-03-10,San Bernardino,71,2135413,286877,283140,8811,291951,3841
2021-03-10,San Diego,73,3302833,266833,264094,0,264094,3413
2021-03-10,San Francisco,75,870044,34589,34688,1213,35901,450
2021-03-10,San Joaquin,77,732212,67884,66483,3049,69532,1156
2021-03-10,San Luis Obispo,79,281455,19859,19710,612,20322,247
2021-03-10,San Mateo,81,765935,40041,39571,423,39994,338
2021-03-10,Santa Barbara,83,443738,32792,32356,1259,33615,429
2021-03-10,Santa Clara,85,1922200,111700,112103,638,112741,1759
2021-03-10,Santa Cruz,87,273765,15543,14790,853,15643,192
2021-03-10,Shasta,89,179085,11075,11125,1363,12488,155
2021-03-10,Sierra,91,2930,50,48,14,62,0
2021-03-10,Siskiyou,93,43540,1522,1458,270,1728,5
2021-03-10,Solano,95,438530,30254,30111,387,30498,170
2021-03-10,Sonoma,97,501317,28586,28638,235,28873,286
2021-03-10,Stanislaus,99,539301,51363,50968,5700,56668,706
2021-03-10,Sutter,101,95872,8945,8918,85,9003,101
2021-03-10,Tehama,103,63373,4636,4623,533,5156,33
2021-03-10,Trinity,105,12862,345,304,48,352,3
2021-03-10,Tulare,107,460477,48173,47659,8825,56484,793
2021-03-10,Tuolumne,109,53932,3928,3931,64,3995,57
2021-03-10,Ventura,111,848112,78538,78609,2957,81566,878
2021-03-10,Yolo,113,214977,13089,13021,239,13260,189
2021-03-10,Yuba,115,75493,5596,5545,93,5638,42
2021-03-09,Alameda,1,1643700,82028,81618,1838,83456,1151
2021-03-09,Alpine,3,1148,83,78,0,78,0
2021-03-09,Amador,5,37829,3508,3494,34,3528,42
2021-03-09,Butte,7,227075,11395,11092,1710,12802,185
2021-03-09,Calaveras,9,45235,1946,1913,13,1926,48
2021-03-09,Colusa,11,21464,1879,1880,278,2158,11
2021-03-09,Contra Costa,13,1133247,64193,63314,1150,64464,723
2021-03-09,Del Norte,15,27424,1041,1017,0,1017,5
2021-03-09,El Dorado,17,186661,9196,9198,639,9837,98
2021-03-09,Fresno,19,978130,97138,96744,8263,105007,1463
2021-03-09,Glenn,21,27897,2268,2251,516,2767,15
2021-03-09,Humboldt,23,135768,3310,3288,22,3310,32
2021-03-09,Imperial,25,180216,27279,27045,2666,29711,675
2021-03-09,Inyo,27,18085,1346,1324,2,1326,35
2021-03-09,Kern,29,883053,93838,92924,10445,103369,1088
2021-03-09,Kings,31,150075,22310,22143,1092,23235,226
2021-03-09,Lake,33,64148,3248,3202,6,3208,42
2021-03-09,Lassen,35,31185,5122,5120,105,5225,1
2021-03-09,Los Angeles,37,10098052,1175358,1167967,41773,1209740,22080
2021-03-09,Madera,39,155013,15790,15701,879,16580,211
2021-03-09,Marin,41,260295,13376,13335,180,13515,214
2021-03-09,Mariposa,43,17540,378,376,6,382,5
2021-03-09,Mendocino,45,87422,3659,3595,65,3660,42
2021-03-09,Merced,47,269075,29002,28876,922,29798,399
2021-03-09,Modoc,49,8938,346,338,118,456,3
2021-03-09,Mono,51,14174,1186,1203,14,1217,3
2021-03-09,Monterey,53,433212,42058,41894,1776,43670,329
2021-03-09,Napa,55,140530,9171,9155,33,9188,75
2021-03-09,Nevada,57,99092,4123,4062,167,4229,66
2021-03-09,Orange,59,3164182,248094,246989,10751,257740,4310
2021-03-09,Placer,61,380077,20883,20122,1205,21327,239
2021-03-09,Plumas,63,18699,647,639,11,650,4
2021-03-09,Riverside,65,2383286,284512,280562,14292,294854,3821
2021-03-09,Sacramento,67,1510023,95982,94720,1377,96097,1442
2021-03-09,San Benito,69,59416,5789,5800,95,5895,61
2021-03-09,San Bernardino,71,2135413,286760,282971,8804,291775,3823
2021-03-09,San Diego,73,3302833,266600,263745,0,263745,3405
2021-03-09,San Francisco,75,870044,34559,34654,1209,35863,450
2021-03-09,San Joaquin,77,732212,67756,66383,3039,69422,1150
2021-03-09,San Luis Obispo,79,281455,19841,19672,605,20277,245
2021-03-09,San Mateo,81,765935,39993,39535,421,39956,336
2021-03-09,Santa Barbara,83,443738,32751,32314,1256,33570,428
2021-03-09,Santa Clara,85,1922200,111589,111963,633,112596,1756
2021-03-09,Santa Cruz,87,273765,15523,14764,850,15614,188
2021-03-09,Shasta,89,179085,11069,11113,1357,12470,155
2021-03-09,Sierra,91,2930,50,48,14,62,0
2021-03-09,Siskiyou,93,43540,1518,1447,268,1715,5
2021-03-09,Solano,95,438530,30218,30090,385,30475,169
2021-03-09,Sonoma,97,501317,28536,28601,232,28833,284
2021-03-09,Stanislaus,99,539301,51269,50884,5691,56575,703
2021-03-09,Sutter,101,95872,8932,8914,85,8999,101
2021-03-09,Tehama,103,63373,4628,4620,532,5152,33
2021-03-09,Trinity,105,12862,345,304,48,352,3
2021-03-09,Tulare,107,460477,48147,47637,8802,56439,792
2021-03-09,Tuolumne,109,53932,3926,3929,64,3993,56
2021-03-09,Ventura,111,848112,78469,78526,2955,81481,863
2021-03-09,Yolo,113,214977,13078,13015,238,13253,189
2021-03-09,Yuba,115,75493,5589,5539,93,5632,42
2021-03-08,Alameda,1,1643700,81914,81543,1837,83380,1142
2021-03-08,Alpine,3,1148,83,78,0,78,0
2021-03-08,Amador,5,37829,3505,3490,34,3524,42
2021-03-08,Butte,7,227075,11380,11082,1709,12791,185
2021-03-08,Calaveras,9,45235,1945,1909,13,1922,48
2021-03-08,Colusa,11,21464,1879,1877,278,2155,11
2021-03-08,Contra Costa,13,1133247,64099,63240,1150,64390,719
2021-03-08,Del Norte,15,27424,1036,1012,0,1012,5
2021-03-08,El Dorado,17,186661,9193,9188,638,9826,97
2021-03-08,Fresno,19,978130,97043,96665,8236,104901,1442
2021-03-08,Glenn,21,27897,2267,2249,516,2765,15
2021-03-08,Humboldt,23,135768,3296,3278,22,3300,31
2021-03-08,Imperial,25,180216,27272,27033,2663,29696,663
2021-03-08,Inyo,27,18085,1344,1320,2,1322,35
2021-03-08,Kern,29,883053,93770,92857,10424,103281,1087
2021-03-08,Kings,31,150075,22290,22130,1089,23219,226
2021-03-08,Lake,33,64148,3236,3195,6,3201,42
2021-03-08,Lassen,35,31185,5122,5119,105,5224,1
2021-03-08,Los Angeles,37,10098052,1174747,1163409,41739,1205148,21868
2021-03-08,Madera,39,155013,15780,15691,877,16568,211
2021-03-08,Marin,41,260295,13356,13328,178,13506,214
2021-03-08,Mariposa,43,17540,378,376,6,382,5
2021-03-08,Mendocino,45,87422,3657,3590,64,3654,42
2021-03-08,Merced,47,269075,28941,28841,921,29762,398
2021-03-08,Modoc,49,8938,346,338,118,456,3
2021-03-08,Mono,51,14174,1185,1200,14,1214,3
2021-03-08,Monterey,53,433212,42037,41863,1775,43638,328
2021-03-08,Napa,55,140530,9168,9146,33,9179,75
2021-03-08,Nevada,57,99092,4115,4059,167,4226,66
2021-03-08,Orange,59,3164182,247923,246900,10719,257619,4243
2021-03-08,Placer,61,380077,20850,20102,1194,21296,239
2021-03-08,Plumas,63,18699,646,635,11,646,4
2021-03-08,Riverside,65,2383286,284374,280463,14283,294746,3783
2021-03-08,Sacramento,67,1510023,95810,94654,1372,96026,1438
2021-03-08,San Benito,69,59416,5786,5797,95,5892,61
2021-03-08,San Bernardino,71,2135413,286656,282894,8791,291685,3811
2021-03-08,San Diego,73,3302833,266359,263272,0,263272,3390
2021-03-08,San Francisco,75,870044,34532,34634,1205,35839,446
2021-03-08,San Joaquin,77,732212,67641,66307,3030,69337,1139
2021-03-08,San Luis Obispo,79,281455,19801,19656,601,20257,245
2021-03-08,San Mateo,81,765935,39946,39492,419,39911,335
2021-03-08,Santa Barbara,83,443738,32719,32293,1256,33549,427
2021-03-08,Santa Clara,85,1922200,111463,111882,631,112513,1756
2021-03-08,Santa Cruz,87,273765,15503,14729,850,15579,188
2021-03-08,Shasta,89,179085,11062,11088,1351,12439,155
2021-03-08,Sierra,91,2930,50,48,14,62,0
2021-03-08,Siskiyou,93,43540,1517,1440,268,1708,5
2021-03-08,Solano,95,438530,30178,30068,383,30451,169
2021-03-08,Sonoma,97,501317,28492,28571,231,28802,284
2021-03-08,Stanislaus,99,539301,51189,50825,5686,56511,690
2021-03-08,Sutter,101,95872,8929,8905,85,8990,100
2021-03-08,Tehama,103,63373,4625,4615,531,5146,33
2021-03-08,Trinity,105,12862,344,302,48,350,3
2021-03-08,Tulare,107,460477,48109,47587,8775,56362,791
2021-03-08,Tuolumne,109,53932,3925,3921,64,3985,56
2021-03-08,Ventura,111,848112,78398,78526,2947,81473,852
2021-03-08,Yolo,113,214977,13055,13000,237,13237,189
2021-03-08,Yuba,115,75493,5579,5530,93,5623,42
2021-03-07,Alameda,1,1643700,81794,81413,1836,83249,1145
2021-03-07,Alpine,3,1148,83,78,0,78,0
2021-03-07,Amador,5,37829,3502,3489,34,3523,42
2021-03-07,Butte,7,227075,11365,11075,1708,12783,185
2021-03-07,Calaveras,9,45235,1944,1906,13,1919,48
2021-03-07,Colusa,11,21464,1878,1876,278,2154,11
2021-03-07,Contra Costa,13,1133247,64002,63148,1147,64295,719
2021-03-07,Del Norte,15,27424,1031,1010,0,1010,5
2021-03-07,El Dorado,17,186661,9191,9184,637,9821,97
2021-03-07,Fresno,19,978130,96868,96549,8211,104760,1442
2021-03-07,Glenn,21,27897,2265,2244,516,2760,15
2021-03-07,Humboldt,23,135768,3286,3274,22,3296,31
2021-03-07,Imperial,25,180216,27263,27019,2661,29680,658
2021-03-07,Inyo,27,18085,1341,1320,2,1322,35
2021-03-07,Kern,29,883053,93684,92746,10392,103138,1086
2021-03-07,Kings,31,150075,22269,22103,1087,23190,224
2021-03-07,Lake,33,64148,3230,3192,6,3198,42
2021-03-07,Lassen,35,31185,5121,5119,105,5224,1
2021-03-07,Los Angeles,37,10098052,1174027,1162749,41699,1204448,21857
2021-03-07,Madera,39,155013,15761,15675,877,16552,211
2021-03-07,Marin,41,260295,13348,13313,176,13489,214
2021-03-07,Mariposa,43,17540,377,376,6,382,5
2021-03-07,Mendocino,45,87422,3654,3581,64,3645,42
2021-03-07,Merced,47,269075,28869,28829,917,29746,399
2021-03-07,Modoc,49,8938,346,338,118,456,3
2021-03-07,Mono,51,14174,1183,1199,14,1213,3
2021-03-07,Monterey,53,433212,42016,41858,1772,43630,328
2021-03-07,Napa,55,140530,9158,9137,33,9170,75
2021-03-07,Nevada,57,99092,4101,4052,166,4218,66
2021-03-07,Orange,59,3164182,247734,246771,10692,257463,4218
2021-03-07,Placer,61,380077,20812,20070,1190,21260,239
2021-03-07,Plumas,63,18699,645,635,11,646,4
2021-03-07,Riverside,65,2383286,284231,280379,14272,294651,3779
2021-03-07,Sacramento,67,1510023,95633,94513,1364,95877,1437
2021-03-07,San Benito,69,59416,5779,5795,95,5890,61
2021-03-07,San Bernardino,71,2135413,286492,282860,8780,291640,3810
2021-03-07,San Diego,73,3302833,266077,262965,0,262965,3390
2021-03-07,San Francisco,75,870044,34498,34594,1200,35794,445
2021-03-07,San Joaquin,77,732212,67507,66252,3016,69268,1139
2021-03-07,San Luis Obispo,79,281455,19763,19614,599,20213,245
2021-03-07,San Mateo,81,765935,39907,39436,416,39852,329
2021-03-07,Santa Barbara,83,443738,32672,32218,1255,33473,425
2021-03-07,Santa Clara,85,1922200,111316,111745,627,112372,1752
2021-03-07,Santa Cruz,87,273765,15481,14715,849,15564,189
2021-03-07,Shasta,89,179085,11049,11083,1343,12426,156
2021-03-07,Sierra,91,2930,49,48,14,62,0
2021-03-07,Siskiyou,93,43540,1514,1435,264,1699,5
2021-03-07,Solano,95,438530,30142,30027,383,30410,169
2021-03-07,Sonoma,97,501317,28441,28533,229,28762,284
2021-03-07,Stanislaus,99,539301,51057,50783,5668,56451,699
2021-03-07,Sutter,101,95872,8919,8900,85,8985,100
2021-03-07,Tehama,103,63373,4615,4614,528,5142,33
2021-03-07,Trinity,105,12862,344,302,48,350,3
2021-03-07,Tulare,107,460477,48053,47569,8741,56310,790
2021-03-07,Tuolumne,109,53932,3924,3922,64,3986,56
2021-03-07,Ventura,111,848112,78301,78487,2942,81429,851
2021-03-07,Yolo,113,214977,13036,12988,237,13225,189
2021-03-07,Yuba,115,75493,5575,5516,93,5609,42
2021-03-06,Alameda,1,1643700,81741,81310,1835,83145,1143
2021-03-06,Alpine,3,1148,83,78,0,78,0
2021-03-06,Amador,5,37829,3498,3487,34,3521,42
2021-03-06,Butte,7,227075,11361,11065,1707,12772,185
2021-03-06,Calaveras,9,45235,1940,1904,13,1917,48
2021-03-06,Colusa,11,21464,1876,1874,278,2152,11
2021-03-06,Contra Costa,13,1133247,63942,63040,1143,64183,719
2021-03-06,Del Norte,15,27424,1026,1000,0,1000,5
2021-03-06,El Dorado,17,186661,9187,9166,637,9803,97
2021-03-06,Fresno,19,978130,96777,96366,8196,104562,1440
2021-03-06,Glenn,21,27897,2265,2241,516,2757,15
2021-03-06,Humboldt,23,135768,3276,3260,22,3282,31
2021-03-06,Imperial,25,180216,27259,27009,2655,29664,658
2021-03-06,Inyo,27,18085,1338,1312,2,1314,35
2021-03-06,Kern,29,883053,93638,92684,10371,103055,1082
2021-03-06,Kings,31,150075,22252,22094,1087,23181,224
2021-03-06,Lake,33,64148,3228,3189,6,3195,42
2021-03-06,Lassen,35,31185,5121,5119,105,5224,1
2021-03-06,Los Angeles,37,10098052,1173595,1161745,41667,1203412,21843
2021-03-06,Madera,39,155013,15752,15646,875,16521,211
2021-03-06,Marin,41,260295,13339,13289,176,13465,213
2021-03-06,Mariposa,43,17540,377,376,6,382,5
2021-03-06,Mendocino,45,87422,3652,3579,64,3643,42
2021-03-06,Merced,47,269075,28827,28771,917,29688,399
2021-03-06,Modoc,49,8938,345,338,118,456,3
2021-03-06,Mono,51,14174,1182,1198,14,1212,3
2021-03-06,Monterey,53,433212,42011,41838,1769,43607,327
2021-03-06,Napa,55,140530,9150,9129,33,9162,75
2021-03-06,Nevada,57,99092,4095,4044,166,4210,66
2021-03-06,Orange,59,3164182,247643,246634,10678,257312,4165
2021-03-06,Placer,61,380077,20789,20030,1188,21218,239
2021-03-06,Plumas,63,18699,645,634,11,645,4
2021-03-06,Riverside,65,2383286,284140,280225,14263,294488,3781
2021-03-06,Sacramento,67,1510023,95544,94332,1355,95687,1436
2021-03-06,San Benito,69,59416,5774,5793,95,5888,61
2021-03-06,San Bernardino,71,2135413,286419,282737,8778,291515,3791
2021-03-06,San Diego,73,3302833,265890,262778,0,262778,3385
2021-03-06,San Francisco,75,870044,34468,34560,1195,35755,435
2021-03-06,San Joaquin,77,732212,67433,66162,3005,69167,1138
2021-03-06,San Luis Obispo,79,281455,19745,19592,596,20188,245
2021-03-06,San Mateo,81,765935,39884,39384,416,39800,329
2021-03-06,Santa Barbara,83,443738,32641,32176,1254,33430,424
2021-03-06,Santa Clara,85,1922200,111221,111570,625,112195,1749
2021-03-06,Santa Cruz,87,273765,15470,14701,849,15550,188
2021-03-06,Shasta,89,179085,11040,11076,1341,12417,158
2021-03-06,Sierra,91,2930,49,48,14,62,0
2021-03-06,Siskiyou,93,43540,1512,1432,264,1696,5
2021-03-06,Solano,95,438530,30113,30000,382,30382,169
2021-03-06,Sonoma,97,501317,28419,28484,227,28711,284
2021-03-06,Stanislaus,99,539301,50988,50691,5661,56352,711
2021-03-06,Sutter,101,95872,8913,8887,85,8972,100
2021-03-06,Tehama,103,63373,4615,4610,526,5136,33
2021-03-06,Trinity,105,12862,344,302,48,350,3
2021-03-06,Tulare,107,460477,48022,47515,8711,56226,789
2021-03-06,Tuolumne,109,53932,3922,3920,64,3984,56
2021-03-06,Ventura,111,848112,78247,78439,2940,81379,848
2021-03-06,Yolo,113,214977,13030,12951,237,13188,189
2021-03-06,Yuba,115,75493,5566,5504,93,5597,42
2021-03-05,Alameda,1,1643700,81655,81215,1833,83048,1141
2021-03-05,Alpine,3,1148,83,78,0,78,0
2021-03-05,Amador,5,37829,3497,3484,34,3518,42
2021-03-05,Butte,7,227075,11350,11050,1706,12756,185
2021-03-05,Calaveras,9,45235,1936,1902,13,1915,48
2021-03-05,Colusa,11,21464,1876,1874,278,2152,11
2021-03-05,Contra Costa,13,1133247,63862,62886,1140,64026,711
2021-03-05,Del Norte,15,27424,1022,995,0,995,5
2021-03-05,El Dorado,17,186661,9182,9150,636,9786,97
2021-03-05,Fresno,19,978130,96671,96184,8175,104359,1432
2021-03-05,Glenn,21,27897,2260,2241,516,2757,15
2021-03-05,Humboldt,23,135768,3269,3234,22,3256,31
2021-03-05,Imperial,25,180216,27249,26970,2646,29616,651
2021-03-05,Inyo,27,18085,1334,1309,2,1311,35
2021-03-05,Kern,29,883053,93600,92601,10357,102958,1076
2021-03-05,Kings,31,150075,22235,22063,1085,23148,224
2021-03-05,Lake,33,64148,3226,3185,6,3191,42
2021-03-05,Lassen,35,31185,5121,5117,103,5220,1
2021-03-05,Los Angeles,37,10098052,1173112,1160688,41632,1202320,21745
2021-03-05,Madera,39,155013,15742,15624,873,16497,211
2021-03-05,Marin,41,260295,13326,13275,175,13450,215
2021-03-05,Mariposa,43,17540,377,375,6,381,4
2021-03-05,Mendocino,45,87422,3649,3577,64,3641,42
2021-03-05,Merced,47,269075,28793,28734,916,29650,399
2021-03-05,Modoc,49,8938,345,337,118,455,3
2021-03-05,Mono,51,14174,1181,1197,14,1211,3
2021-03-05,Monterey,53,433212,41998,41802,1769,43571,325
2021-03-05,Napa,55,140530,9142,9109,33,9142,75
2021-03-05,Nevada,57,99092,4091,4033,166,4199,66
2021-03-05,Orange,59,3164182,247529,246489,10665,257154,4108
2021-03-05,Placer,61,380077,20763,19973,1184,21157,239
2021-03-05,Plumas,63,18699,645,635,11,646,4
2021-03-05,Riverside,65,2383286,284030,280075,14256,294331,3781
2021-03-05,Sacramento,67,1510023,95446,94182,1348,95530,1430
2021-03-05,San Benito,69,59416,5771,5790,95,5885,61
2021-03-05,San Bernardino,71,2135413,286327,282640,8769,291409,3774
2021-03-05,San Diego,73,3302833,265658,262357,0,262357,3371
2021-03-05,San Francisco,75,870044,34428,34526,1191,35717,430
2021-03-05,San Joaquin,77,732212,67355,66041,2993,69034,1133
2021-03-05,San Luis Obispo,79,281455,19723,19557,594,20151,244
2021-03-05,San Mateo,81,765935,39852,39305,416,39721,326
2021-03-05,Santa Barbara,83,443738,32606,32139,1249,33388,424
2021-03-05,Santa Clara,85,1922200,111125,111384,625,112009,1745
2021-03-05,Santa Cruz,87,273765,15459,14694,849,15543,188
2021-03-05,Shasta,89,179085,11028,11062,1335,12397,148
2021-03-05,Sierra,91,2930,49,48,14,62,0
2021-03-05,Siskiyou,93,43540,1508,1429,263,1692,5
2021-03-05,Solano,95,438530,30096,29951,380,30331,168
2021-03-05,Sonoma,97,501317,28392,28417,227,28644,279
2021-03-05,Stanislaus,99,539301,50937,50606,5651,56257,721
2021-03-05,Sutter,101,95872,8906,8876,85,8961,100
2021-03-05,Tehama,103,63373,4606,4606,526,5132,33
2021-03-05,Trinity,105,12862,344,302,48,350,3
2021-03-05,Tulare,107,460477,47995,47469,8690,56159,789
2021-03-05,Tuolumne,109,53932,3920,3917,64,3981,56
2021-03-05,Ventura,111,848112,78180,78368,2938,81306,839
2021-03-05,Yolo,113,214977,13018,12920,236,13156,188
2021-03-05,Yuba,115,75493,5554,5496,93,5589,42
2021-03-04,Alameda,1,1643700,81543,81115,1833,82948,1136
2021-03-04,Alpine,3,1148,83,78,0,78,0
2021-03-04,Amador,5,37829,3496,3480,34,3514,42
2021-03-04,Butte,7,227075,11343,11033,1705,12738,185
2021-03-04,Calaveras,9,45235,1935,1896,13,1909,48
2021-03-04,Colusa,11,21464,1874,1873,273,2146,11
2021-03-04,Contra Costa,13,1133247,63764,62789,1137,63926,708
2021-03-04,Del Norte,15,27424,1014,989,0,989,5
2021-03-04,El Dorado,17,186661,9167,9133,636,9769,97
2021-03-04,Fresno,19,978130,96509,96023,8156,104179,1422
2021-03-04,Glenn,21,27897,2256,2236,513,2749,15
2021-03-04,Humboldt,23,135768,3256,3212,22,3234,31
2021-03-04,Imperial,25,180216,27238,26946,2642,29588,646
2021-03-04,Inyo,27,18085,1331,1300,2,1302,35
2021-03-04,Kern,29,883053,93513,92525,10337,102862,1070
2021-03-04,Kings,31,150075,22210,22025,1082,23107,224
2021-03-04,Lake,33,64148,3218,3181,6,3187,42
2021-03-04,Lassen,35,31185,5121,5116,103,5219,1
2021-03-04,Los Angeles,37,10098052,1172503,1159405,41581,1200986,21610
2021-03-04,Madera,39,155013,15708,15596,869,16465,208
2021-03-04,Marin,41,260295,13309,13240,172,13412,215
2021-03-04,Mariposa,43,17540,377,376,6,382,4
2021-03-04,Mendocino,45,87422,3646,3569,64,3633,42
2021-03-04,Merced,47,269075,28743,28671,914,29585,396
2021-03-04,Modoc,49,8938,344,336,118,454,3
2021-03-04,Mono,51,14174,1181,1197,14,1211,3
2021-03-04,Monterey,53,433212,41978,41771,1766,43537,325
2021-03-04,Napa,55,140530,9134,9094,33,9127,74
2021-03-04,Nevada,57,99092,4081,4020,166,4186,66
2021-03-04,Orange,59,3164182,247377,246354,10646,257000,4096
2021-03-04,Placer,61,380077,20731,19900,1178,21078,239
2021-03-04,Plumas,63,18699,645,634,11,645,4
2021-03-04,Riverside,65,2383286,283905,279871,14243,294114,3766
2021-03-04,Sacramento,67,1510023,95313,93982,1344,95326,1426
2021-03-04,San Benito,69,59416,5771,5781,95,5876,61
2021-03-04,San Bernardino,71,2135413,286194,282407,8765,291172,3757
2021-03-04,San Diego,73,3302833,265399,261858,0,261858,3359
2021-03-04,San Francisco,75,870044,34394,34480,1188,35668,426
2021-03-04,San Joaquin,77,732212,67263,65931,2983,68914,1129
2021-03-04,San Luis Obispo,79,281455,19685,19520,592,20112,243
2021-03-04,San Mateo,81,765935,39808,39225,415,39640,322
2021-03-04,Santa Barbara,83,443738,32569,32090,1248,33338,423
2021-03-04,Santa Clara,85,1922200,110992,111194,623,111817,1723
2021-03-04,Santa Cruz,87,273765,15440,14669,849,15518,186
2021-03-04,Shasta,89,179085,11025,11050,1326,12376,150
2021-03-04,Sierra,91,2930,49,48,14,62,0
2021-03-04,Siskiyou,93,43540,1502,1427,263,1690,5
2021-03-04,Solano,95,438530,30069,29905,379,30284,168
2021-03-04,Sonoma,97,501317,28338,28379,226,28605,279
2021-03-04,Stanislaus,99,539301,50849,50521,5643,56164,731
2021-03-04,Sutter,101,95872,8894,8849,85,8934,100
2021-03-04,Tehama,103,63373,4600,4604,526,5130,33
2021-03-04,Trinity,105,12862,344,302,48,350,3
2021-03-04,Tulare,107,460477,47951,47398,8664,56062,784
2021-03-04,Tuolumne,109,53932,3914,3916,64,3980,56
2021-03-04,Ventura,111,848112,78093,78184,2936,81120,831
2021-03-04,Yolo,113,214977,12998,12895,236,13131,189
2021-03-04,Yuba,115,75493,5542,5483,93,5576,41
2021-03-03,Alameda,1,1643700,81420,80972,1831,82803,1127
2021-03-03,Alpine,3,1148,83,77,0,77,0
2021-03-03,Amador,5,37829,3494,3478,33,3511,42
2021-03-03,Butte,7,227075,11336,11014,1704,12718,184
2021-03-03,Calaveras,9,45235,1932,1893,13,1906,48
2021-03-03,Colusa,11,21464,1873,1873,273,2146,11
2021-03-03,Contra Costa,13,1133247,63666,62668,1134,63802,708
2021-03-03,Del Norte,15,27424,1011,988,0,988,5
2021-03-03,El Dorado,17,186661,9157,9121,636,9757,97
2021-03-03,Fresno,19,978130,96368,95893,8137,104030,1415
2021-03-03,Glenn,21,27897,2256,2233,513,2746,15
2021-03-03,Humboldt,23,135768,3244,3196,22,3218,30
2021-03-03,Imperial,25,180216,27220,26939,2637,29576,640
2021-03-03,Inyo,27,18085,1323,1294,2,1296,35
2021-03-03,Kern,29,883053,93440,92434,10319,102753,1063
2021-03-03,Kings,31,150075,22194,22009,1081,23090,223
2021-03-03,Lake,33,64148,3211,3175,6,3181,40
2021-03-03,Lassen,35,31185,5121,5115,102,5217,1
2021-03-03,Los Angeles,37,10098052,1171868,1157911,41538,1199449,21500
2021-03-03,Madera,39,155013,15689,15553,863,16416,203
2021-03-03,Marin,41,260295,13296,13216,172,13388,214
2021-03-03,Mariposa,43,17540,376,376,6,382,4
2021-03-03,Mendocino,45,87422,3638,3564,64,3628,42
2021-03-03,Merced,47,269075,28690,28625,914,29539,393
2021-03-03,Modoc,49,8938,344,333,117,450,3
2021-03-03,Mono,51,14174,1181,1191,14,1205,3
2021-03-03,Monterey,53,433212,41945,41731,1763,43494,325
2021-03-03,Napa,55,140530,9126,9090,33,9123,72
2021-03-03,Nevada,57,99092,4071,4009,166,4175,66
2021-03-03,Orange,59,3164182,247233,246120,10630,256750,4072
2021-03-03,Placer,61,380077,20705,19851,1175,21026,239
2021-03-03,Plumas,63,18699,644,631,11,642,4
2021-03-03,Riverside,65,2383286,283776,279626,14238,293864,3735
2021-03-03,Sacramento,67,1510023,95154,93819,1335,95154,1419
2021-03-03,San Benito,69,59416,5770,5774,95,5869,61
2021-03-03,San Bernardino,71,2135413,286053,282138,8754,290892,3664
2021-03-03,San Diego,73,3302833,265137,261350,0,261350,3342
2021-03-03,San Francisco,75,870044,34363,34443,1185,35628,426
2021-03-03,San Joaquin,77,732212,67152,65855,2975,68830,1115
2021-03-03,San Luis Obispo,79,281455,19659,19479,588,20067,241
2021-03-03,San Mateo,81,765935,39761,39189,414,39603,319
2021-03-03,Santa Barbara,83,443738,32532,32027,1248,33275,421
2021-03-03,Santa Clara,85,1922200,110836,110991,621,111612,1720
2021-03-03,Santa Cruz,87,273765,15429,14645,849,15494,185
2021-03-03,Shasta,89,179085,11015,11023,1319,12342,150
2021-03-03,Sierra,91,2930,49,48,14,62,0
2021-03-03,Siskiyou,93,43540,1500,1424,263,1687,5
2021-03-03,Solano,95,438530,30033,29866,378,30244,167
2021-03-03,Sonoma,97,501317,28298,28307,225,28532,279
2021-03-03,Stanislaus,99,539301,50772,50438,5635,56073,730
2021-03-03,Sutter,101,95872,8885,8840,85,8925,99
2021-03-03,Tehama,103,63373,4597,4601,526,5127,32
2021-03-03,Trinity,105,12862,344,302,48,350,3
2021-03-03,Tulare,107,460477,47901,47348,8633,55981,778
2021-03-03,Tuolumne,109,53932,3912,3914,63,3977,56
2021-03-03,Ventura,111,848112,78010,78057,2930,80987,822
2021-03-03,Yolo,113,214977,12985,12890,236,13126,189
2021-03-03,Yuba,115,75493,5529,5479,93,5572,41
2021-03-02,Alameda,1,1643700,81303,80904,1829,82733,1116
2021-03-02,Alpine,3,1148,83,77,0,77,0
2021-03-02,Amador,5,37829,3492,3474,33,3507,42
2021-03-02,Butte,7,227075,11326,11007,1702,12709,182
2021-03-02,Calaveras,9,45235,1926,1890,13,1903,48
2021-03-02,Colusa,11,21464,1873,1872,272,2144,11
2021-03-02,Contra Costa,13,1133247,63555,62557,1129,63686,694
2021-03-02,Del Norte,15,27424,1004,983,0,983,5
2021-03-02,El Dorado,17,186661,9149,9116,636,9752,98
2021-03-02,Fresno,19,978130,96224,95785,8109,103894,1410
2021-03-02,Glenn,21,27897,2250,2232,512,2744,15
2021-03-02,Humboldt,23,135768,3225,3184,22,3206,30
2021-03-02,Imperial,25,180216,27210,26926,2635,29561,637
2021-03-02,Inyo,27,18085,1319,1292,2,1294,35
2021-03-02,Kern,29,883053,93335,92313,10289,102602,1046
2021-03-02,Kings,31,150075,22142,21999,1079,23078,217
2021-03-02,Lake,33,64148,3205,3169,6,3175,40
2021-03-02,Lassen,35,31185,5116,5115,101,5216,1
2021-03-02,Los Angeles,37,10098052,1171229,1156826,41490,1198316,21395
2021-03-02,Madera,39,155013,15670,15523,860,16383,194
2021-03-02,Marin,41,260295,13273,13186,171,13357,214
2021-03-02,Mariposa,43,17540,376,376,6,382,4
2021-03-02,Mendocino,45,87422,3635,3562,63,3625,41
2021-03-02,Merced,47,269075,28633,28598,914,29512,389
2021-03-02,Modoc,49,8938,344,332,117,449,3
2021-03-02,Mono,51,14174,1180,1191,14,1205,3
2021-03-02,Monterey,53,433212,41918,41716,1761,43477,325
2021-03-02,Napa,55,140530,9114,9080,33,9113,71
2021-03-02,Nevada,57,99092,4062,3983,164,4147,66
2021-03-02,Orange,59,3164182,247087,246004,10614,256618,4037
2021-03-02,Placer,61,380077,20650,19828,1172,21000,239
2021-03-02,Plumas,63,18699,642,628,11,639,4
2021-03-02,Riverside,65,2383286,283610,279486,14223,293709,3721
2021-03-02,Sacramento,67,1510023,94987,93690,1334,95024,1411
2021-03-02,San Benito,69,59416,5763,5770,95,5865,60
2021-03-02,San Bernardino,71,2135413,285919,281919,8746,290665,3604
2021-03-02,San Diego,73,3302833,264894,260998,0,260998,3317
2021-03-02,San Francisco,75,870044,34322,34387,1181,35568,424
2021-03-02,San Joaquin,77,732212,67047,65769,2953,68722,1111
2021-03-02,San Luis Obispo,79,281455,19627,19452,587,20039,241
2021-03-02,San Mateo,81,765935,39710,39148,413,39561,317
2021-03-02,Santa Barbara,83,443738,32484,31964,1244,33208,416
2021-03-02,Santa Clara,85,1922200,110658,110832,619,111451,1706
2021-03-02,Santa Cruz,87,273765,15415,14611,847,15458,185
2021-03-02,Shasta,89,179085,11001,11012,1308,12320,149
2021-03-02,Sierra,91,2930,49,48,14,62,0
2021-03-02,Siskiyou,93,43540,1496,1412,261,1673,5
2021-03-02,Solano,95,438530,30000,29827,376,30203,167
2021-03-02,Sonoma,97,501317,28244,28261,225,28486,279
2021-03-02,Stanislaus,99,539301,50685,50359,5621,55980,724
2021-03-02,Sutter,101,95872,8876,8832,85,8917,99
2021-03-02,Tehama,103,63373,4595,4597,526,5123,32
2021-03-02,Trinity,105,12862,344,301,48,349,3
2021-03-02,Tulare,107,460477,47845,47326,8607,55933,783
2021-03-02,Tuolumne,109,53932,3908,3908,63,3971,53
2021-03-02,Ventura,111,848112,77919,77952,2926,80878,780
2021-03-02,Yolo,113,214977,12968,12867,236,13103,189
2021-03-02,Yuba,115,75493,5521,5475,93,5568,41
2021-03-01,Alameda,1,1643700,81177,80805,1827,82632,1105
2021-03-01,Alpine,3,1148,81,77,0,77,0
2021-03-01,Amador,5,37829,3489,3469,33,3502,42
2021-03-01,Butte,7,227075,11310,10981,1697,12678,180
2021-03-01,Calaveras,9,45235,1920,1885,13,1898,46
2021-03-01,Colusa,11,21464,1872,1871,272,2143,11
2021-03-01,Contra Costa,13,1133247,63448,62458,1128,63586,694
2021-03-01,Del Norte,15,27424,999,982,0,982,5
2021-03-01,El Dorado,17,186661,9125,9085,636,9721,98
2021-03-01,Fresno,19,978130,96087,95677,8084,103761,1405
2021-03-01,Glenn,21,27897,2245,2232,511,2743,15
2021-03-01,Humboldt,23,135768,3207,3179,22,3201,30
2021-03-01,Imperial,25,180216,27200,26913,2627,29540,636
2021-03-01,Inyo,27,18085,1316,1285,2,1287,35
2021-03-01,Kern,29,883053,93248,92219,10262,102481,1041
2021-03-01,Kings,31,150075,22125,21988,1073,23061,217
2021-03-01,Lake,33,64148,3200,3164,6,3170,40
2021-03-01,Lassen,35,31185,5114,5111,101,5212,1
2021-03-01,Los Angeles,37,10098052,1170583,1155984,41445,1197429,21293
2021-03-01,Madera,39,155013,15641,15505,849,16354,194
2021-03-01,Marin,41,260295,13247,13161,171,13332,214
2021-03-01,Mariposa,43,17540,376,375,6,381,4
2021-03-01,Mendocino,45,87422,3628,3561,63,3624,41
2021-03-01,Merced,47,269075,28588,28575,910,29485,385
2021-03-01,Modoc,49,8938,341,331,116,447,3
2021-03-01,Mono,51,14174,1179,1192,14,1206,3
2021-03-01,Monterey,53,433212,41893,41697,1759,43456,324
2021-03-01,Napa,55,140530,9105,9056,33,9089,70
2021-03-01,Nevada,57,99092,4043,3979,164,4143,66
2021-03-01,Orange,59,3164182,246895,245852,10600,256452,3976
2021-03-01,Placer,61,380077,20612,19803,1169,20972,239
2021-03-01,Plumas,63,18699,642,628,11,639,4
2021-03-01,Riverside,65,2383286,283395,279323,14215,293538,3680
2021-03-01,Sacramento,67,1510023,94842,93546,1332,94878,1401
2021-03-01,San Benito,69,59416,5758,5772,95,5867,57
2021-03-01,San Bernardino,71,2135413,285772,281685,8742,290427,3603
2021-03-01,San Diego,73,3302833,264579,260622,0,260622,3303
2021-03-01,San Francisco,75,870044,34278,34318,1173,35491,424
2021-03-01,San Joaquin,77,732212,66940,65699,2941,68640,1097
2021-03-01,San Luis Obispo,79,281455,19605,19429,585,20014,239
2021-03-01,San Mateo,81,765935,39660,39096,412,39508,314
2021-03-01,Santa Barbara,83,443738,32442,31909,1243,33152,413
2021-03-01,Santa Clara,85,1922200,110500,110684,615,111299,1704
2021-03-01,Santa Cruz,87,273765,15396,14575,846,15421,185
2021-03-01,Shasta,89,179085,10989,10990,1305,12295,149
2021-03-01,Sierra,91,2930,49,48,14,62,0
2021-03-01,Siskiyou,93,43540,1492,1408,259,1667,5
2021-03-01,Solano,95,438530,29957,29779,375,30154,166
2021-03-01,Sonoma,97,501317,28197,28222,223,28445,278
2021-03-01,Stanislaus,99,539301,50611,50293,5614,55907,722
2021-03-01,Sutter,101,95872,8864,8825,85,8910,99
2021-03-01,Tehama,103,63373,4591,4595,526,5121,32
2021-03-01,Trinity,105,12862,344,298,47,345,3
2021-03-01,Tulare,107,460477,47808,47275,8572,55847,781
2021-03-01,Tuolumne,109,53932,3905,3907,63,3970,53
2021-03-01,Ventura,111,848112,77837,77849,2923,80772,775
2021-03-01,Yolo,113,214977,12951,12854,234,13088,188
2021-03-01,Yuba,115,75493,5509,5466,93,5559,41
2021-02-28,Alameda,1,1643700,81054,80727,1825,82552,1105
2021-02-28,Alpine,3,1148,81,77,0,77,0
2021-02-28,Amador,5,37829,3484,3466,32,3498,42
2021-02-28,Butte,7,227075,11295,10970,1697,12667,180
2021-02-28,Calaveras,9,45235,1914,1881,13,1894,46
2021-02-28,Colusa,11,21464,1872,1871,271,2142,11
2021-02-28,Contra Costa,13,1133247,63321,62386,1123,63509,694
2021-02-28,Del Norte,15,27424,997,981,0,981,5
2021-02-28,El Dorado,17,186661,9114,9082,636,9718,98
2021-02-28,Fresno,19,978130,95910,95548,8047,103595,1405
2021-02-28,Glenn,21,27897,2243,2230,509,2739,15
2021-02-28,Humboldt,23,135768,3184,3179,22,3201,30
2021-02-28,Imperial,25,180216,27174,26909,2619,29528,636
2021-02-28,Inyo,27,18085,1311,1282,2,1284,35
2021-02-28,Kern,29,883053,93134,92169,10239,102408,1012
2021-02-28,Kings,31,150075,22104,21967,1072,23039,217
2021-02-28,Lake,33,64148,3195,3164,6,3170,40
2021-02-28,Lassen,35,31185,5113,5106,101,5207,1
2021-02-28,Los Angeles,37,10098052,1169808,1155141,41381,1196522,21261
2021-02-28,Madera,39,155013,15598,15496,846,16342,199
2021-02-28,Marin,41,260295,13224,13152,169,13321,214
2021-02-28,Mariposa,43,17540,376,374,6,380,4
2021-02-28,Mendocino,45,87422,3622,3558,63,3621,41
2021-02-28,Merced,47,269075,28526,28546,909,29455,384
2021-02-28,Modoc,49,8938,341,331,116,447,3
2021-02-28,Mono,51,14174,1176,1192,14,1206,3
2021-02-28,Monterey,53,433212,41861,41683,1758,43441,323
2021-02-28,Napa,55,140530,9086,9053,33,9086,70
2021-02-28,Nevada,57,99092,4030,3972,164,4136,66
2021-02-28,Orange,59,3164182,246695,245706,10592,256298,3970
2021-02-28,Placer,61,380077,20566,19775,1167,20942,239
2021-02-28,Plumas,63,18699,642,628,11,639,4
2021-02-28,Riverside,65,2383286,283176,279214,14204,293418,3661
2021-02-28,Sacramento,67,1510023,94658,93463,1327,94790,1398
2021-02-28,San Benito,69,59416,5747,5772,95,5867,57
2021-02-28,San Bernardino,71,2135413,285642,281620,8722,290342,3595
2021-02-28,San Diego,73,3302833,264283,260353,0,260353,3303
2021-02-28,San Francisco,75,870044,34237,34291,1166,35457,417
2021-02-28,San Joaquin,77,732212,66832,65662,2932,68594,1097
2021-02-28,San Luis Obispo,79,281455,19570,19422,582,20004,237
2021-02-28,San Mateo,81,765935,39605,39059,411,39470,314
2021-02-28,Santa Barbara,83,443738,32391,31877,1241,33118,413
2021-02-28,Santa Clara,85,1922200,110302,110556,612,111168,1704
2021-02-28,Santa Cruz,87,273765,15367,14571,843,15414,185
2021-02-28,Shasta,89,179085,10968,10990,1299,12289,149
2021-02-28,Sierra,91,2930,49,48,14,62,0
2021-02-28,Siskiyou,93,43540,1484,1408,258,1666,5
2021-02-28,Solano,95,438530,29901,29758,370,30128,166
2021-02-28,Sonoma,97,501317,28135,28193,222,28415,279
2021-02-28,Stanislaus,99,539301,50521,50228,5600,55828,728
2021-02-28,Sutter,101,95872,8849,8825,85,8910,99
2021-02-28,Tehama,103,63373,4584,4590,526,5116,32
2021-02-28,Trinity,105,12862,344,298,47,345,3
2021-02-28,Tulare,107,460477,47746,47258,8541,55799,780
2021-02-28,Tuolumne,109,53932,3900,3905,63,3968,53
2021-02-28,Ventura,111,848112,77726,77749,2920,80669,775
2021-02-28,Yolo,113,214977,12929,12851,234,13085,188
2021-02-28,Yuba,115,75493,5499,5461,93,5554,41
2021-02-27,Alameda,1,1643700,80980,80565,1823,82388,1108
2021-02-27,Alpine,3,1148,81,77,0,77,0
2021-02-27,Amador,5,37829,3482,3463,32,3495,42
2021-02-27,Butte,7,227075,11283,10962,1697,12659,180
2021-02-27,Calaveras,9,45235,1912,1875,13,1888,46
2021-02-27,Colusa,11,21464,1871,1869,271,2140,11
2021-02-27,Contra Costa,13,1133247,63250,62248,1120,63368,693
2021-02-27,Del Norte,15,27424,995,978,0,978,5
2021-02-27,El Dorado,17,186661,9110,9072,636,9708,98
2021-02-27,Fresno,19,978130,95837,95393,8033,103426,1400
2021-02-27,Glenn,21,27897,2243,2225,508,2733,15
2021-02-27,Humboldt,23,135768,3178,3167,22,3189,30
2021-02-27,Imperial,25,180216,27166,26903,2618,29521,633
2021-02-27,Inyo,27,18085,1308,1275,2,1277,35
2021-02-27,Kern,29,883053,93074,92053,10224,102277,996
2021-02-27,Kings,31,150075,22094,21955,1069,23024,216
2021-02-27,Lake,33,64148,3192,3156,6,3162,40
2021-02-27,Lassen,35,31185,5113,5106,101,5207,1
2021-02-27,Los Angeles,37,10098052,1169318,1154275,41351,1195626,21158
2021-02-27,Madera,39,155013,15581,15467,845,16312,199
2021-02-27,Marin,41,260295,13200,13134,169,13303,214
2021-02-27,Mariposa,43,17540,376,374,6,380,4
2021-02-27,Mendocino,45,87422,3619,3555,63,3618,41
2021-02-27,Merced,47,269075,28485,28501,900,29401,384
2021-02-27,Modoc,49,8938,341,331,115,446,3
2021-02-27,Mono,51,14174,1174,1191,14,1205,3
2021-02-27,Monterey,53,433212,41852,41665,1758,43423,322
2021-02-27,Napa,55,140530,9075,9038,33,9071,71
2021-02-27,Nevada,57,99092,4024,3960,164,4124,66
2021-02-27,Orange,59,3164182,246569,245542,10580,256122,3960
2021-02-27,Placer,61,380077,20530,19726,1164,20890,239
2021-02-27,Plumas,63,18699,642,628,11,639,4
2021-02-27,Riverside,65,2383286,283067,279048,14194,293242,3663
2021-02-27,Sacramento,67,1510023,94576,93281,1314,94595,1396
2021-02-27,San Benito,69,59416,5746,5767,94,5861,57
2021-02-27,San Bernardino,71,2135413,285571,281471,8714,290185,3527
2021-02-27,San Diego,73,3302833,264094,260091,0,260091,3284
2021-02-27,San Francisco,75,870044,34205,34260,1163,35423,413
2021-02-27,San Joaquin,77,732212,66786,65578,2930,68508,1100
2021-02-27,San Luis Obispo,79,281455,19549,19411,581,19992,237
2021-02-27,San Mateo,81,765935,39563,38998,410,39408,313
2021-02-27,Santa Barbara,83,443738,32357,31805,1240,33045,411
2021-02-27,Santa Clara,85,1922200,110155,110361,610,110971,1703
2021-02-27,Santa Cruz,87,273765,15358,14552,842,15394,185
2021-02-27,Shasta,89,179085,10962,10985,1295,12280,149
2021-02-27,Sierra,91,2930,49,48,14,62,0
2021-02-27,Siskiyou,93,43540,1482,1407,257,1664,5
2021-02-27,Solano,95,438530,29873,29718,369,30087,165
2021-02-27,Sonoma,97,501317,28091,28141,216,28357,281
2021-02-27,Stanislaus,99,539301,50467,50147,5590,55737,733
2021-02-27,Sutter,101,95872,8844,8820,85,8905,99
2021-02-27,Tehama,103,63373,4581,4584,526,5110,32
2021-02-27,Trinity,105,12862,344,298,47,345,3
2021-02-27,Tulare,107,460477,47710,47209,8514,55723,770
2021-02-27,Tuolumne,109,53932,3897,3899,63,3962,53
2021-02-27,Ventura,111,848112,77654,77623,2917,80540,771
2021-02-27,Yolo,113,214977,12917,12834,234,13068,188
2021-02-27,Yuba,115,75493,5496,5450,93,5543,39
2021-02-26,Alameda,1,1643700,80883,80387,1818,82205,1106
2021-02-26,Alpine,3,1148,81,77,0,77,0
2021-02-26,Amador,5,37829,3476,3457,32,3489,42
2021-02-26,Butte,7,227075,11273,10941,1696,12637,180
2021-02-26,Calaveras,9,45235,1911,1873,13,1886,46
2021-02-26,Colusa,11,21464,1871,1865,271,2136,11
2021-02-26,Contra Costa,13,1133247,63168,62114,1120,63234,685
2021-02-26,Del Norte,15,27424,991,968,0,968,5
2021-02-26,El Dorado,17,186661,9104,9038,634,9672,98
2021-02-26,Fresno,19,978130,95734,95202,8025,103227,1391
2021-02-26,Glenn,21,27897,2240,2220,508,2728,15
2021-02-26,Humboldt,23,135768,3172,3152,22,3174,30
2021-02-26,Imperial,25,180216,27158,26888,2616,29504,631
2021-02-26,Inyo,27,18085,1306,1271,2,1273,34
2021-02-26,Kern,29,883053,92995,91884,10208,102092,997
2021-02-26,Kings,31,150075,22078,21917,1066,22983,216
2021-02-26,Lake,33,64148,3187,3153,6,3159,40
2021-02-26,Lassen,35,31185,5113,5102,101,5203,1
2021-02-26,Los Angeles,37,10098052,1168750,1153131,41288,1194419,21070
2021-02-26,Madera,39,155013,15565,15436,843,16279,199
2021-02-26,Marin,41,260295,13186,13091,169,13260,214
2021-02-26,Mariposa,43,17540,376,375,6,381,4
2021-02-26,Mendocino,45,87422,3614,3549,63,3612,41
2021-02-26,Merced,47,269075,28453,28455,899,29354,382
2021-02-26,Modoc,49,8938,340,330,115,445,3
2021-02-26,Mono,51,14174,1172,1191,14,1205,3
2021-02-26,Monterey,53,433212,41826,41607,1758,43365,322
2021-02-26,Napa,55,140530,9069,9014,33,9047,70
2021-02-26,Nevada,57,99092,4013,3952,164,4116,66
2021-02-26,Orange,59,3164182,246431,245278,10570,255848,3918
2021-02-26,Placer,61,380077,20504,19712,1158,20870,239
2021-02-26,Plumas,63,18699,642,628,11,639,4
2021-02-26,Riverside,65,2383286,282923,278772,14188,292960,3653
2021-02-26,Sacramento,67,1510023,94453,93180,1311,94491,1390
2021-02-26,San Benito,69,59416,5745,5759,94,5853,57
2021-02-26,San Bernardino,71,2135413,285463,281132,8712,289844,3461
2021-02-26,San Diego,73,3302833,263867,259641,0,259641,3271
2021-02-26,San Francisco,75,870044,34175,34213,1158,35371,413
2021-02-26,San Joaquin,77,732212,66705,65492,2924,68416,1070
2021-02-26,San Luis Obispo,79,281455,19533,19359,579,19938,234
2021-02-26,San Mateo,81,765935,39517,38922,410,39332,313
2021-02-26,Santa Barbara,83,443738,32314,31724,1239,32963,410
2021-02-26,Santa Clara,85,1922200,110026,110168,607,110775,1700
2021-02-26,Santa Cruz,87,273765,15346,14528,841,15369,185
2021-02-26,Shasta,89,179085,10956,10972,1285,12257,149
2021-02-26,Sierra,91,2930,49,47,14,61,0
2021-02-26,Siskiyou,93,43540,1482,1401,257,1658,5
2021-02-26,Solano,95,438530,29839,29651,368,30019,165
2021-02-26,Sonoma,97,501317,28063,28063,215,28278,280
2021-02-26,Stanislaus,99,539301,50411,50054,5581,55635,737
2021-02-26,Sutter,101,95872,8835,8806,85,8891,99
2021-02-26,Tehama,103,63373,4579,4581,526,5107,32
2021-02-26,Trinity,105,12862,343,298,47,345,3
2021-02-26,Tulare,107,460477,47675,47135,8483,55618,770
2021-02-26,Tuolumne,109,53932,3896,3896,63,3959,53
2021-02-26,Ventura,111,848112,77554,77534,2915,80449,765
2021-02-26,Yolo,113,214977,12910,12816,234,13050,188
2021-02-26,Yuba,115,75493,5491,5438,93,5531,39
2021-02-25,Alameda,1,1643700,80761,80181,1817,81998,1093
2021-02-25,Alpine,3,1148,81,77,0,77,0
2021-02-25,Amador,5,37829,3473,3448,32,3480,41
2021-02-25,Butte,7,227075,11252,10922,1691,12613,178
2021-02-25,Calaveras,9,45235,1903,1868,13,1881,46
2021-02-25,Colusa,11,21464,1868,1863,270,2133,11
2021-02-25,Contra Costa,13,1133247,63066,61910,1120,63030,686
2021-02-25,Del Norte,15,27424,981,966,0,966,5
2021-02-25,El Dorado,17,186661,9088,9012,634,9646,98
2021-02-25,Fresno,19,978130,95592,95015,8004,103019,1377
2021-02-25,Glenn,21,27897,2237,2219,507,2726,15
2021-02-25,Humboldt,23,135768,3165,3129,21,3150,30
2021-02-25,Imperial,25,180216,27152,26855,2611,29466,628
2021-02-25,Inyo,27,18085,1300,1264,2,1266,33
2021-02-25,Kern,29,883053,92881,91735,10182,101917,992
2021-02-25,Kings,31,150075,22069,21900,1063,22963,216
2021-02-25,Lake,33,64148,3178,3141,6,3147,40
2021-02-25,Lassen,35,31185,5112,5097,99,5196,1
2021-02-25,Los Angeles,37,10098052,1168013,1151846,41228,1193074,20931
2021-02-25,Madera,39,155013,15530,15414,839,16253,194
2021-02-25,Marin,41,260295,13162,13067,169,13236,214
2021-02-25,Mariposa,43,17540,376,375,6,381,4
2021-02-25,Mendocino,45,87422,3609,3542,63,3605,41
2021-02-25,Merced,47,269075,28403,28383,898,29281,382
2021-02-25,Modoc,49,8938,340,329,115,444,3
2021-02-25,Mono,51,14174,1171,1190,14,1204,3
2021-02-25,Monterey,53,433212,41801,41564,1753,43317,321
2021-02-25,Napa,55,140530,9043,8998,33,9031,70
2021-02-25,Nevada,57,99092,3996,3940,163,4103,66
2021-02-25,Orange,59,3164182,246257,245000,10560,255560,3882
2021-02-25,Placer,61,380077,20463,19661,1156,20817,239
2021-02-25,Plumas,63,18699,642,626,11,637,4
2021-02-25,Riverside,65,2383286,282738,278544,14164,292708,3646
2021-02-25,Sacramento,67,1510023,94294,92961,1298,94259,1386
2021-02-25,San Benito,69,59416,5740,5752,94,5846,58
2021-02-25,San Bernardino,71,2135413,285317,280946,8703,289649,3409
2021-02-25,San Diego,73,3302833,263572,258979,0,258979,3260
2021-02-25,San Francisco,75,870044,34133,34138,1155,35293,408
2021-02-25,San Joaquin,77,732212,66622,65389,2912,68301,1047
2021-02-25,San Luis Obispo,79,281455,19512,19335,577,19912,234
2021-02-25,San Mateo,81,765935,39472,38872,410,39282,300
2021-02-25,Santa Barbara,83,443738,32238,31631,1238,32869,408
2021-02-25,Santa Clara,85,1922200,109862,109923,606,110529,1677
2021-02-25,Santa Cruz,87,273765,15328,14492,839,15331,185
2021-02-25,Shasta,89,179085,10944,10947,1280,12227,148
2021-02-25,Sierra,91,2930,49,47,14,61,0
2021-02-25,Siskiyou,93,43540,1478,1390,254,1644,4
2021-02-25,Solano,95,438530,29807,29616,368,29984,161
2021-02-25,Sonoma,97,501317,28008,28004,212,28216,278
2021-02-25,Stanislaus,99,539301,50322,49964,5570,55534,738
2021-02-25,Sutter,101,95872,8821,8789,84,8873,99
2021-02-25,Tehama,103,63373,4575,4578,524,5102,32
2021-02-25,Trinity,105,12862,343,297,47,344,3
2021-02-25,Tulare,107,460477,47627,47052,8455,55507,765
2021-02-25,Tuolumne,109,53932,3893,3894,63,3957,53
2021-02-25,Ventura,111,848112,77449,77395,2909,80304,751
2021-02-25,Yolo,113,214977,12893,12787,234,13021,188
2021-02-25,Yuba,115,75493,5483,5429,93,5522,39
2021-02-24,Alameda,1,1643700,80638,80070,1813,81883,1082
2021-02-24,Alpine,3,1148,80,77,0,77,0
2021-02-24,Amador,5,37829,3468,3444,32,3476,41
2021-02-24,Butte,7,227075,11240,10915,1687,12602,178
2021-02-24,Calaveras,9,45235,1900,1864,13,1877,31
2021-02-24,Colusa,11,21464,1866,1863,270,2133,11
2021-02-24,Contra Costa,13,1133247,62958,61776,1120,62896,663
2021-02-24,Del Norte,15,27424,980,960,0,960,5
2021-02-24,El Dorado,17,186661,9076,8993,634,9627,98
2021-02-24,Fresno,19,978130,95446,94794,7987,102781,1369
2021-02-24,Glenn,21,27897,2235,2210,507,2717,14
2021-02-24,Humboldt,23,135768,3153,3123,21,3144,29
2021-02-24,Imperial,25,180216,27137,26843,2607,29450,596
2021-02-24,Inyo,27,18085,1295,1253,2,1255,32
2021-02-24,Kern,29,883053,92748,91525,10166,101691,992
2021-02-24,Kings,31,150075,22046,21871,1059,22930,216
2021-02-24,Lake,33,64148,3171,3134,6,3140,40
2021-02-24,Lassen,35,31185,5109,5095,98,5193,1
2021-02-24,Los Angeles,37,10098052,1167258,1150322,41178,1191500,20817
2021-02-24,Madera,39,155013,15503,15390,839,16229,194
2021-02-24,Marin,41,260295,13139,13044,168,13212,214
2021-02-24,Mariposa,43,17540,376,374,6,380,4
2021-02-24,Mendocino,45,87422,3602,3540,63,3603,41
2021-02-24,Merced,47,269075,28364,28295,895,29190,383
2021-02-24,Modoc,49,8938,339,329,115,444,3
2021-02-24,Mono,51,14174,1169,1189,14,1203,3
2021-02-24,Monterey,53,433212,41775,41495,1751,43246,320
2021-02-24,Napa,55,140530,9026,8976,32,9008,70
2021-02-24,Nevada,57,99092,3986,3927,163,4090,66
2021-02-24,Orange,59,3164182,246040,244743,10546,255289,3835
2021-02-24,Placer,61,380077,20425,19648,1150,20798,239
2021-02-24,Plumas,63,18699,640,626,11,637,4
2021-02-24,Riverside,65,2383286,282516,278293,14154,292447,3603
2021-02-24,Sacramento,67,1510023,94141,92742,1293,94035,1375
2021-02-24,San Benito,69,59416,5739,5743,94,5837,57
2021-02-24,San Bernardino,71,2135413,285173,280583,8699,289282,3360
2021-02-24,San Diego,73,3302833,263279,258460,0,258460,3230
2021-02-24,San Francisco,75,870044,34088,34061,1151,35212,406
2021-02-24,San Joaquin,77,732212,66512,65274,2908,68182,1019
2021-02-24,San Luis Obispo,79,281455,19489,19309,575,19884,233
2021-02-24,San Mateo,81,765935,39435,38763,409,39172,300
2021-02-24,Santa Barbara,83,443738,32187,31563,1232,32795,405
2021-02-24,Santa Clara,85,1922200,109708,109671,605,110276,1674
2021-02-24,Santa Cruz,87,273765,15307,14458,839,15297,185
2021-02-24,Shasta,89,179085,10929,10922,1277,12199,148
2021-02-24,Sierra,91,2930,49,47,14,61,0
2021-02-24,Siskiyou,93,43540,1471,1385,250,1635,4
2021-02-24,Solano,95,438530,29768,29577,365,29942,158
2021-02-24,Sonoma,97,501317,27943,27954,208,28162,278
2021-02-24,Stanislaus,99,539301,50254,49851,5561,55412,732
2021-02-24,Sutter,101,95872,8811,8778,84,8862,99
2021-02-24,Tehama,103,63373,4571,4566,524,5090,31
2021-02-24,Trinity,105,12862,343,294,46,340,3
2021-02-24,Tulare,107,460477,47573,46976,8425,55401,759
2021-02-24,Tuolumne,109,53932,3890,3887,63,3950,53
2021-02-24,Ventura,111,848112,77343,77238,2907,80145,718
2021-02-24,Yolo,113,214977,12881,12760,229,12989,188
2021-02-24,Yuba,115,75493,5472,5425,91,5516,39
2021-02-23,Alameda,1,1643700,80500,79948,1809,81757,1070
2021-02-23,Alpine,3,1148,79,77,0,77,0
2021-02-23,Amador,5,37829,3466,3440,32,3472,41
2021-02-23,Butte,7,227075,11225,10887,1683,12570,176
2021-02-23,Calaveras,9,45235,1899,1863,13,1876,21
2021-02-23,Colusa,11,21464,1863,1862,270,2132,11
2021-02-23,Contra Costa,13,1133247,62825,61613,1118,62731,661
2021-02-23,Del Norte,15,27424,978,953,0,953,3
2021-02-23,El Dorado,17,186661,9063,8969,634,9603,96
2021-02-23,Fresno,19,978130,95285,94741,7973,102714,1356
2021-02-23,Glenn,21,27897,2233,2209,507,2716,14
2021-02-23,Humboldt,23,135768,3135,3108,21,3129,29
2021-02-23,Imperial,25,180216,27117,26816,2602,29418,591
2021-02-23,Inyo,27,18085,1291,1250,2,1252,32
2021-02-23,Kern,29,883053,92612,91390,10137,101527,982
2021-02-23,Kings,31,150075,22031,21839,1055,22894,216
2021-02-23,Lake,33,64148,3163,3121,6,3127,40
2021-02-23,Lassen,35,31185,5106,5092,98,5190,1
2021-02-23,Los Angeles,37,10098052,1166397,1148965,41121,1190086,19887
2021-02-23,Madera,39,155013,15489,15352,833,16185,193
2021-02-23,Marin,41,260295,13119,13015,167,13182,214
2021-02-23,Mariposa,43,17540,376,374,6,380,4
2021-02-23,Mendocino,45,87422,3600,3540,62,3602,41
2021-02-23,Merced,47,269075,28276,28209,894,29103,381
2021-02-23,Modoc,49,8938,338,328,114,442,3
2021-02-23,Mono,51,14174,1169,1189,14,1203,3
2021-02-23,Monterey,53,433212,41734,41439,1745,43184,317
2021-02-23,Napa,55,140530,9015,8967,32,8999,70
2021-02-23,Nevada,57,99092,3978,3912,163,4075,66
2021-02-23,Orange,59,3164182,245844,244566,10529,255095,3843
2021-02-23,Placer,61,380077,20399,19608,1146,20754,238
2021-02-23,Plumas,63,18699,639,626,11,637,4
2021-02-23,Riverside,65,2383286,282284,278075,14141,292216,3599
2021-02-23,Sacramento,67,1510023,93984,92632,1287,93919,1370
2021-02-23,San Benito,69,59416,5733,5731,93,5824,57
2021-02-23,San Bernardino,71,2135413,284981,280279,8690,288969,3283
2021-02-23,San Diego,73,3302833,262904,257802,0,257802,3218
2021-02-23,San Francisco,75,870044,34039,33994,1150,35144,405
2021-02-23,San Joaquin,77,732212,66414,65141,2900,68041,1004
2021-02-23,San Luis Obispo,79,281455,19460,19233,574,19807,230
2021-02-23,San Mateo,81,765935,39374,38662,409,39071,299
2021-02-23,Santa Barbara,83,443738,32134,31483,1225,32708,402
2021-02-23,Santa Clara,85,1922200,109512,109449,602,110051,1661
2021-02-23,Santa Cruz,87,273765,15280,14435,835,15270,178
2021-02-23,Shasta,89,179085,10917,10903,1273,12176,146
2021-02-23,Sierra,91,2930,49,47,14,61,0
2021-02-23,Siskiyou,93,43540,1466,1380,248,1628,4
2021-02-23,Solano,95,438530,29728,29545,362,29907,154
2021-02-23,Sonoma,97,501317,27900,27882,205,28087,278
2021-02-23,Stanislaus,99,539301,50178,49749,5543,55292,722
2021-02-23,Sutter,101,95872,8798,8766,84,8850,98
2021-02-23,Tehama,103,63373,4567,4556,523,5079,30
2021-02-23,Trinity,105,12862,343,292,45,337,3
2021-02-23,Tulare,107,460477,47494,46937,8389,55326,757
2021-02-23,Tuolumne,109,53932,3886,3864,63,3927,53
2021-02-23,Ventura,111,848112,77228,77093,2897,79990,689
2021-02-23,Yolo,113,214977,12852,12729,229,12958,188
2021-02-23,Yuba,115,75493,5459,5417,90,5507,38
2021-02-22,Alameda,1,1643700,80347,79796,1806,81602,1062
2021-02-22,Alpine,3,1148,79,77,0,77,0
2021-02-22,Amador,5,37829,3461,3438,32,3470,39
2021-02-22,Butte,7,227075,11213,10855,1677,12532,176
2021-02-22,Calaveras,9,45235,1896,1862,13,1875,21
2021-02-22,Colusa,11,21464,1863,1860,270,2130,11
2021-02-22,Contra Costa,13,1133247,62690,61478,1116,62594,661
2021-02-22,Del Norte,15,27424,977,948,0,948,3
2021-02-22,El Dorado,17,186661,9046,8940,634,9574,96
2021-02-22,Fresno,19,978130,95121,94584,7954,102538,1351
2021-02-22,Glenn,21,27897,2227,2207,505,2712,14
2021-02-22,Humboldt,23,135768,3123,3095,21,3116,29
2021-02-22,Imperial,25,180216,27093,26778,2594,29372,590
2021-02-22,Inyo,27,18085,1286,1248,2,1250,32
2021-02-22,Kern,29,883053,92498,91201,10114,101315,982
2021-02-22,Kings,31,150075,22010,21801,1052,22853,214
2021-02-22,Lake,33,64148,3157,3107,6,3113,40
2021-02-22,Lassen,35,31185,5106,5088,97,5185,1
2021-02-22,Los Angeles,37,10098052,1165532,1147541,41059,1188600,19730
2021-02-22,Madera,39,155013,15464,15325,829,16154,193
2021-02-22,Marin,41,260295,13095,12991,164,13155,213
2021-02-22,Mariposa,43,17540,375,374,6,380,4
2021-02-22,Mendocino,45,87422,3594,3535,62,3597,41
2021-02-22,Merced,47,269075,28208,28166,892,29058,379
2021-02-22,Modoc,49,8938,338,329,114,443,3
2021-02-22,Mono,51,14174,1165,1189,14,1203,3
2021-02-22,Monterey,53,433212,41683,41397,1737,43134,311
2021-02-22,Napa,55,140530,8988,8950,32,8982,69
2021-02-22,Nevada,57,99092,3969,3900,161,4061,66
2021-02-22,Orange,59,3164182,245607,244118,10512,254630,3843
2021-02-22,Placer,61,380077,20362,19587,1138,20725,238
2021-02-22,Plumas,63,18699,639,625,11,636,4
2021-02-22,Riverside,65,2383286,282025,277730,14132,291862,3567
2021-02-22,Sacramento,67,1510023,93818,92476,1277,93753,1359
2021-02-22,San Benito,69,59416,5731,5723,93,5816,57
2021-02-22,San Bernardino,71,2135413,284798,279984,8677,288661,3259
2021-02-22,San Diego,73,3302833,262495,257348,0,257348,3189
2021-02-22,San Francisco,75,870044,33980,33947,1144,35091,405
2021-02-22,San Joaquin,77,732212,66313,65060,2887,67947,1001
2021-02-22,San Luis Obispo,79,281455,19423,19198,572,19770,229
2021-02-22,San Mateo,81,765935,39317,38542,406,38948,282
2021-02-22,Santa Barbara,83,443738,32069,31421,1222,32643,399
2021-02-22,Santa Clara,85,1922200,109301,109213,590,109803,1655
2021-02-22,Santa Cruz,87,273765,15255,14417,834,15251,176
2021-02-22,Shasta,89,179085,10902,10872,1267,12139,145
2021-02-22,Sierra,91,2930,49,47,14,61,0
2021-02-22,Siskiyou,93,43540,1460,1373,247,1620,4
2021-02-22,Solano,95,438530,29689,29508,361,29869,150
2021-02-22,Sonoma,97,501317,27855,27845,204,28049,278
2021-02-22,Stanislaus,99,539301,50074,49630,5522,55152,722
2021-02-22,Sutter,101,95872,8790,8698,84,8782,98
2021-02-22,Tehama,103,63373,4558,4550,523,5073,30
2021-02-22,Trinity,105,12862,343,287,44,331,3
2021-02-22,Tulare,107,460477,47433,46879,8356,55235,751
2021-02-22,Tuolumne,109,53932,3882,3856,63,3919,53
2021-02-22,Ventura,111,848112,77101,76947,2891,79838,677
2021-02-22,Yolo,113,214977,12826,12689,228,12917,183
2021-02-22,Yuba,115,75493,5456,5404,89,5493,38
2021-02-21,Alameda,1,1643700,80149,79649,1801,81450,1061
2021-02-21,Alpine,3,1148,79,77,0,77,0
2021-02-21,Amador,5,37829,3453,3435,32,3467,39
2021-02-21,Butte,7,227075,11190,10855,1675,12530,176
2021-02-21,Calaveras,9,45235,1895,1860,13,1873,21
2021-02-21,Colusa,11,21464,1862,1860,266,2126,11
2021-02-21,Contra Costa,13,1133247,62526,61364,1113,62477,661
2021-02-21,Del Norte,15,27424,971,942,0,942,3
2021-02-21,El Dorado,17,186661,9028,8927,633,9560,96
2021-02-21,Fresno,19,978130,94975,94374,7935,102309,1349
2021-02-21,Glenn,21,27897,2225,2201,503,2704,14
2021-02-21,Humboldt,23,135768,3111,3096,21,3117,29
2021-02-21,Imperial,25,180216,27074,26779,2590,29369,590
2021-02-21,Inyo,27,18085,1280,1232,2,1234,32
2021-02-21,Kern,29,883053,92373,91141,10075,101216,980
2021-02-21,Kings,31,150075,21976,21784,1049,22833,213
2021-02-21,Lake,33,64148,3149,3100,6,3106,40
2021-02-21,Lassen,35,31185,5098,5077,97,5174,1
2021-02-21,Los Angeles,37,10098052,1164501,1146756,41004,1187760,19711
2021-02-21,Madera,39,155013,15433,15298,826,16124,192
2021-02-21,Marin,41,260295,13065,12968,164,13132,212
2021-02-21,Mariposa,43,17540,375,373,6,379,4
2021-02-21,Mendocino,45,87422,3589,3535,62,3597,41
2021-02-21,Merced,47,269075,28118,28106,880,28986,379
2021-02-21,Modoc,49,8938,335,329,114,443,3
2021-02-21,Mono,51,14174,1165,1189,14,1203,3
2021-02-21,Monterey,53,433212,41628,41373,1727,43100,309
2021-02-21,Napa,55,140530,8973,8929,32,8961,69
2021-02-21,Nevada,57,99092,3956,3895,161,4056,66
2021-02-21,Orange,59,3164182,245304,243985,10492,254477,3801
2021-02-21,Placer,61,380077,20325,19553,1134,20687,238
2021-02-21,Plumas,63,18699,639,625,11,636,4
2021-02-21,Riverside,65,2383286,281794,277555,14118,291673,3564
2021-02-21,Sacramento,67,1510023,93606,92288,1264,93552,1354
2021-02-21,San Benito,69,59416,5721,5716,90,5806,57
2021-02-21,San Bernardino,71,2135413,284553,279870,8655,288525,3247
2021-02-21,San Diego,73,3302833,262061,257027,0,257027,3190
2021-02-21,San Francisco,75,870044,33915,33891,1140,35031,405
2021-02-21,San Joaquin,77,732212,66164,64997,2874,67871,1001
2021-02-21,San Luis Obispo,79,281455,19391,19178,570,19748,229
2021-02-21,San Mateo,81,765935,39256,38448,403,38851,282
2021-02-21,Santa Barbara,83,443738,32007,31374,1216,32590,399
2021-02-21,Santa Clara,85,1922200,109077,108992,580,109572,1654
2021-02-21,Santa Cruz,87,273765,15231,14401,833,15234,176
2021-02-21,Shasta,89,179085,10887,10867,1262,12129,145
2021-02-21,Sierra,91,2930,49,47,14,61,0
2021-02-21,Siskiyou,93,43540,1454,1371,247,1618,4
2021-02-21,Solano,95,438530,29632,29471,360,29831,150
2021-02-21,Sonoma,97,501317,27789,27793,196,27989,278
2021-02-21,Stanislaus,99,539301,49950,49527,5505,55032,726
2021-02-21,Sutter,101,95872,8772,8687,83,8770,97
2021-02-21,Tehama,103,63373,4546,4547,523,5070,30
2021-02-21,Trinity,105,12862,341,286,44,330,3
2021-02-21,Tulare,107,460477,47366,46830,8319,55149,749
2021-02-21,Tuolumne,109,53932,3868,3828,63,3891,53
2021-02-21,Ventura,111,848112,76955,76862,2877,79739,677
2021-02-21,Yolo,113,214977,12795,12670,227,12897,183
2021-02-21,Yuba,115,75493,5448,5396,87,5483,38
2021-02-20,Alameda,1,1643700,80055,79496,1797,81293,1055
2021-02-20,Alpine,3,1148,79,77,0,77,0
2021-02-20,Amador,5,37829,3451,3432,32,3464,39
2021-02-20,Butte,7,227075,11182,10838,1673,12511,176
2021-02-20,Calaveras,9,45235,1894,1858,13,1871,21
2021-02-20,Colusa,11,21464,1861,1858,266,2124,11
2021-02-20,Contra Costa,13,1133247,62437,61205,1111,62316,663
2021-02-20,Del Norte,15,27424,967,937,0,937,3
2021-02-20,El Dorado,17,186661,9017,8911,633,9544,96
2021-02-20,Fresno,19,978130,94888,94234,7916,102150,1341
2021-02-20,Glenn,21,27897,2222,2199,502,2701,14
2021-02-20,Humboldt,23,135768,3103,3073,21,3094,29
2021-02-20,Imperial,25,180216,27066,26771,2590,29361,590
2021-02-20,Inyo,27,18085,1276,1226,2,1228,32
2021-02-20,Kern,29,883053,92302,91025,10041,101066,968
2021-02-20,Kings,31,150075,21958,21773,1048,22821,212
2021-02-20,Lake,33,64148,3142,3089,6,3095,40
2021-02-20,Lassen,35,31185,5096,5067,97,5164,1
2021-02-20,Los Angeles,37,10098052,1163939,1145594,40960,1186554,19630
2021-02-20,Madera,39,155013,15413,15274,825,16099,191
2021-02-20,Marin,41,260295,13044,12945,162,13107,211
2021-02-20,Mariposa,43,17540,375,372,6,378,4
2021-02-20,Mendocino,45,87422,3587,3533,62,3595,40
2021-02-20,Merced,47,269075,28073,28066,878,28944,379
2021-02-20,Modoc,49,8938,335,328,114,442,3
2021-02-20,Mono,51,14174,1164,1187,14,1201,3
2021-02-20,Monterey,53,433212,41608,41313,1725,43038,309
2021-02-20,Napa,55,140530,8964,8910,32,8942,69
2021-02-20,Nevada,57,99092,3946,3887,160,4047,66
2021-02-20,Orange,59,3164182,245141,243761,10476,254237,3755
2021-02-20,Placer,61,380077,20284,19509,1130,20639,236
2021-02-20,Plumas,63,18699,639,626,11,637,4
2021-02-20,Riverside,65,2383286,281643,277267,14106,291373,3559
2021-02-20,Sacramento,67,1510023,93481,92057,1262,93319,1352
2021-02-20,San Benito,69,59416,5709,5709,90,5799,57
2021-02-20,San Bernardino,71,2135413,284458,279608,8649,288257,3203
2021-02-20,San Diego,73,3302833,261819,256510,0,256510,3188
2021-02-20,San Francisco,75,870044,33873,33820,1131,34951,399
2021-02-20,San Joaquin,77,732212,66092,64916,2869,67785,1001
2021-02-20,San Luis Obispo,79,281455,19368,19138,568,19706,229
2021-02-20,San Mateo,81,765935,39214,38371,402,38773,282
2021-02-20,Santa Barbara,83,443738,31973,31289,1214,32503,396
2021-02-20,Santa Clara,85,1922200,108901,108728,577,109305,1649
2021-02-20,Santa Cruz,87,273765,15220,14378,831,15209,176
2021-02-20,Shasta,89,179085,10873,10850,1257,12107,146
2021-02-20,Sierra,91,2930,49,47,14,61,0
2021-02-20,Siskiyou,93,43540,1451,1366,247,1613,4
2021-02-20,Solano,95,438530,29617,29440,358,29798,150
2021-02-20,Sonoma,97,501317,27760,27703,193,27896,278
2021-02-20,Stanislaus,99,539301,49895,49445,5492,54937,733
2021-02-20,Sutter,101,95872,8766,8681,83,8764,97
2021-02-20,Tehama,103,63373,4545,4545,523,5068,30
2021-02-20,Trinity,105,12862,340,285,43,328,3
2021-02-20,Tulare,107,460477,47333,46769,8294,55063,739
2021-02-20,Tuolumne,109,53932,3863,3823,63,3886,53
2021-02-20,Ventura,111,848112,76860,76757,2874,79631,671
2021-02-20,Yolo,113,214977,12781,12639,226,12865,183
2021-02-20,Yuba,115,75493,5445,5386,87,5473,38
2021-02-19,Alameda,1,1643700,79948,79318,1793,81111,1047
2021-02-19,Alpine,3,1148,79,77,0,77,0
2021-02-19,Amador,5,37829,3447,3427,32,3459,39
2021-02-19,Butte,7,227075,11172,10823,1668,12491,176
2021-02-19,Calaveras,9,45235,1893,1856,13,1869,21
2021-02-19,Colusa,11,21464,1861,1858,266,2124,11
2021-02-19,Contra Costa,13,1133247,62330,61017,1109,62126,651
2021-02-19,Del Norte,15,27424,962,932,0,932,2
2021-02-19,El Dorado,17,186661,9008,8882,632,9514,96
2021-02-19,Fresno,19,978130,94758,93973,7897,101870,1330
2021-02-19,Glenn,21,27897,2217,2199,501,2700,14
2021-02-19,Humboldt,23,135768,3090,3037,21,3058,29
2021-02-19,Imperial,25,180216,27061,26751,2587,29338,589
2021-02-19,Inyo,27,18085,1271,1212,2,1214,32
2021-02-19,Kern,29,883053,92233,90807,9999,100806,963
2021-02-19,Kings,31,150075,21944,21724,1045,22769,211
2021-02-19,Lake,33,64148,3136,3078,6,3084,40
2021-02-19,Lassen,35,31185,5095,5057,97,5154,1
2021-02-19,Los Angeles,37,10098052,1163188,1143828,40916,1184744,19498
2021-02-19,Madera,39,155013,15396,15222,823,16045,188
2021-02-19,Marin,41,260295,13020,12919,160,13079,210
2021-02-19,Mariposa,43,17540,375,371,6,377,4
2021-02-19,Mendocino,45,87422,3585,3526,62,3588,39
2021-02-19,Merced,47,269075,28042,27985,874,28859,376
2021-02-19,Modoc,49,8938,335,328,114,442,3
2021-02-19,Mono,51,14174,1164,1186,14,1200,3
2021-02-19,Monterey,53,433212,41579,41209,1721,42930,309
2021-02-19,Napa,55,140530,8953,8899,32,8931,69
2021-02-19,Nevada,57,99092,3940,3863,160,4023,66
2021-02-19,Orange,59,3164182,244962,243397,10461,253858,3715
2021-02-19,Placer,61,380077,20263,19457,1129,20586,236
2021-02-19,Plumas,63,18699,637,624,11,635,4
2021-02-19,Riverside,65,2383286,281472,276941,14089,291030,3541
2021-02-19,Sacramento,67,1510023,93360,91815,1256,93071,1351
2021-02-19,San Benito,69,59416,5704,5699,90,5789,57
2021-02-19,San Bernardino,71,2135413,284340,279209,8643,287852,3117
2021-02-19,San Diego,73,3302833,261529,255799,0,255799,3169
2021-02-19,San Francisco,75,870044,33825,33746,1125,34871,387
2021-02-19,San Joaquin,77,732212,66021,64774,2860,67634,988
2021-02-19,San Luis Obispo,79,281455,19338,19061,566,19627,230
2021-02-19,San Mateo,81,765935,39156,38256,400,38656,282
2021-02-19,Santa Barbara,83,443738,31909,31204,1213,32417,392
2021-02-19,Santa Clara,85,1922200,108688,108400,575,108975,1634
2021-02-19,Santa Cruz,87,273765,15205,14354,831,15185,176
2021-02-19,Shasta,89,179085,10861,10833,1254,12087,140
2021-02-19,Sierra,91,2930,49,47,14,61,0
2021-02-19,Siskiyou,93,43540,1447,1363,245,1608,4
2021-02-19,Solano,95,438530,29586,29383,357,29740,150
2021-02-19,Sonoma,97,501317,27713,27595,191,27786,280
2021-02-19,Stanislaus,99,539301,49834,49282,5476,54758,739
2021-02-19,Sutter,101,95872,8756,8665,83,8748,96
2021-02-19,Tehama,103,63373,4543,4535,523,5058,30
2021-02-19,Trinity,105,12862,339,282,40,322,3
2021-02-19,Tulare,107,460477,47289,46662,8266,54928,736
2021-02-19,Tuolumne,109,53932,3857,3817,62,3879,52
2021-02-19,Ventura,111,848112,76780,76582,2871,79453,667
2021-02-19,Yolo,113,214977,12765,12606,226,12832,183
2021-02-19,Yuba,115,75493,5435,5376,87,5463,38
2021-02-18,Alameda,1,1643700,79800,79111,1786,80897,1012
2021-02-18,Alpine,3,1148,79,77,0,77,0
2021-02-18,Amador,5,37829,3443,3417,31,3448,38
2021-02-18,Butte,7,227075,11153,10791,1665,12456,175
2021-02-18,Calaveras,9,45235,1888,1873,13,1886,21
2021-02-18,Colusa,11,21464,1859,1856,264,2120,11
2021-02-18,Contra Costa,13,1133247,62219,60868,1108,61976,640
2021-02-18,Del Norte,15,27424,957,929,0,929,2
2021-02-18,El Dorado,17,186661,8994,8850,631,9481,94
2021-02-18,Fresno,19,978130,94590,93734,7868,101602,1323
2021-02-18,Glenn,21,27897,2211,2195,501,2696,14
2021-02-18,Humboldt,23,135768,3078,3023,21,3044,29
2021-02-18,Imperial,25,180216,27035,26731,2582,29313,591
2021-02-18,Inyo,27,18085,1267,1213,1,1214,32
2021-02-18,Kern,29,883053,92077,90655,9969,100624,961
2021-02-18,Kings,31,150075,21923,21648,1043,22691,211
2021-02-18,Lake,33,64148,3128,3066,6,3072,40
2021-02-18,Lassen,35,31185,5086,5052,97,5149,1
2021-02-18,Los Angeles,37,10098052,1162235,1141930,40846,1182776,19358
2021-02-18,Madera,39,155013,15375,15175,818,15993,188
2021-02-18,Marin,41,260295,13006,12895,160,13055,209
2021-02-18,Mariposa,43,17540,374,369,6,375,4
2021-02-18,Mendocino,45,87422,3582,3519,61,3580,39
2021-02-18,Merced,47,269075,27992,27870,868,28738,372
2021-02-18,Modoc,49,8938,333,327,113,440,3
2021-02-18,Mono,51,14174,1164,1182,14,1196,3
2021-02-18,Monterey,53,433212,41516,41091,1712,42803,307
2021-02-18,Napa,55,140530,8936,8877,32,8909,68
2021-02-18,Nevada,57,99092,3931,3836,159,3995,66
2021-02-18,Orange,59,3164182,244742,243098,10442,253540,3673
2021-02-18,Placer,61,380077,20237,19429,1128,20557,232
2021-02-18,Plumas,63,18699,637,624,11,635,4
2021-02-18,Riverside,65,2383286,281192,276595,14068,290663,3510
2021-02-18,Sacramento,67,1510023,93197,91476,1250,92726,1334
2021-02-18,San Benito,69,59416,5701,5697,89,5786,58
2021-02-18,San Bernardino,71,2135413,284125,278887,8625,287512,3066
2021-02-18,San Diego,73,3302833,261176,254987,0,254987,3135
2021-02-18,San Francisco,75,870044,33767,33650,1122,34772,386
2021-02-18,San Joaquin,77,732212,65936,64634,2849,67483,982
2021-02-18,San Luis Obispo,79,281455,19296,18987,563,19550,230
2021-02-18,San Mateo,81,765935,39094,38185,396,38581,282
2021-02-18,Santa Barbara,83,443738,31830,31054,1204,32258,387
2021-02-18,Santa Clara,85,1922200,108463,108210,572,108782,1605
2021-02-18,Santa Cruz,87,273765,15179,14314,831,15145,176
2021-02-18,Shasta,89,179085,10841,10811,1251,12062,139
2021-02-18,Sierra,91,2930,48,47,14,61,0
2021-02-18,Siskiyou,93,43540,1442,1359,244,1603,4
2021-02-18,Solano,95,438530,29559,29349,356,29705,150
2021-02-18,Sonoma,97,501317,27645,27512,190,27702,281
2021-02-18,Stanislaus,99,539301,49737,49150,5461,54611,738
2021-02-18,Sutter,101,95872,8748,8654,83,8737,96
2021-02-18,Tehama,103,63373,4540,4528,522,5050,30
2021-02-18,Trinity,105,12862,338,282,40,322,3
2021-02-18,Tulare,107,460477,47230,46591,8224,54815,728
2021-02-18,Tuolumne,109,53932,3820,3811,62,3873,52
2021-02-18,Ventura,111,848112,76649,76442,2861,79303,659
2021-02-18,Yolo,113,214977,12738,12549,223,12772,183
2021-02-18,Yuba,115,75493,5418,5358,87,5445,38
2021-02-17,Alameda,1,1643700,79637,78895,1784,80679,1002
2021-02-17,Alpine,3,1148,79,77,0,77,0
2021-02-17,Amador,5,37829,3439,3415,31,3446,38
2021-02-17,Butte,7,227075,11135,10770,1662,12432,174
2021-02-17,Calaveras,9,45235,1888,1876,13,1889,21
2021-02-17,Colusa,11,21464,1856,1854,264,2118,10
2021-02-17,Contra Costa,13,1133247,62080,60723,1105,61828,635
2021-02-17,Del Norte,15,27424,951,920,0,920,2
2021-02-17,El Dorado,17,186661,8983,8847,631,9478,94
2021-02-17,Fresno,19,978130,94458,93555,7841,101396,1307
2021-02-17,Glenn,21,27897,2211,2189,500,2689,14
2021-02-17,Humboldt,23,135768,3063,3006,21,3027,29
2021-02-17,Imperial,25,180216,27020,26726,2580,29306,580
2021-02-17,Inyo,27,18085,1259,1197,1,1198,32
2021-02-17,Kern,29,883053,91958,90454,9922,100376,962
2021-02-17,Kings,31,150075,21886,21617,1039,22656,211
2021-02-17,Lake,33,64148,3117,3057,2,3059,38
2021-02-17,Lassen,35,31185,5081,5052,96,5148,1
2021-02-17,Los Angeles,37,10098052,1161174,1139786,40779,1180565,19213
2021-02-17,Madera,39,155013,15349,15135,809,15944,177
2021-02-17,Marin,41,260295,12979,12881,160,13041,207
2021-02-17,Mariposa,43,17540,374,368,5,373,4
2021-02-17,Mendocino,45,87422,3580,3494,60,3554,39
2021-02-17,Merced,47,269075,27938,27824,859,28683,372
2021-02-17,Modoc,49,8938,333,327,113,440,3
2021-02-17,Mono,51,14174,1164,1180,14,1194,3
2021-02-17,Monterey,53,433212,41462,41014,1700,42714,304
2021-02-17,Napa,55,140530,8922,8865,32,8897,68
2021-02-17,Nevada,57,99092,3912,3822,156,3978,52
2021-02-17,Orange,59,3164182,244474,242716,10409,253125,3626
2021-02-17,Placer,61,380077,20204,19405,1123,20528,230
2021-02-17,Plumas,63,18699,636,623,11,634,4
2021-02-17,Riverside,65,2383286,280917,276289,14045,290334,3491
2021-02-17,Sacramento,67,1510023,93042,91309,1242,92551,1326
2021-02-17,San Benito,69,59416,5695,5661,89,5750,57
2021-02-17,San Bernardino,71,2135413,283916,278461,8602,287063,3020
2021-02-17,San Diego,73,3302833,260800,254177,0,254177,3099
2021-02-17,San Francisco,75,870044,33690,33558,1117,34675,379
2021-02-17,San Joaquin,77,732212,65835,64556,2842,67398,979
2021-02-17,San Luis Obispo,79,281455,19251,18964,563,19527,230
2021-02-17,San Mateo,81,765935,39027,38124,394,38518,282
2021-02-17,Santa Barbara,83,443738,31763,30927,1203,32130,384
2021-02-17,Santa Clara,85,1922200,108231,107949,570,108519,1592
2021-02-17,Santa Cruz,87,273765,15146,14268,828,15096,174
2021-02-17,Shasta,89,179085,10821,10770,1250,12020,139
2021-02-17,Sierra,91,2930,48,47,14,61,0
2021-02-17,Siskiyou,93,43540,1436,1352,241,1593,4
2021-02-17,Solano,95,438530,29504,29288,356,29644,149
2021-02-17,Sonoma,97,501317,27572,27408,185,27593,281
2021-02-17,Stanislaus,99,539301,49628,49050,5444,54494,730
2021-02-17,Sutter,101,95872,8738,8681,83,8764,95
2021-02-17,Tehama,103,63373,4536,4511,521,5032,30
2021-02-17,Trinity,105,12862,338,277,38,315,3
2021-02-17,Tulare,107,460477,47169,46495,8194,54689,726
2021-02-17,Tuolumne,109,53932,3811,3806,62,3868,49
2021-02-17,Ventura,111,848112,76524,76234,2854,79088,646
2021-02-17,Yolo,113,214977,12721,12506,221,12727,182
2021-02-17,Yuba,115,75493,5409,5345,87,5432,38
2021-02-16,Alameda,1,1643700,79462,78756,1780,80536,997
2021-02-16,Alpine,3,1148,79,76,0,76,0
2021-02-16,Amador,5,37829,3432,3413,31,3444,39
2021-02-16,Butte,7,227075,11109,10748,1659,12407,164
2021-02-16,Calaveras,9,45235,1886,1872,13,1885,21
2021-02-16,Colusa,11,21464,1853,1852,262,2114,10
2021-02-16,Contra Costa,13,1133247,61933,60564,1100,61664,631
2021-02-16,Del Norte,15,27424,943,913,0,913,2
2021-02-16,El Dorado,17,186661,8974,8836,629,9465,94
2021-02-16,Fresno,19,978130,94286,93363,7809,101172,1293
2021-02-16,Glenn,21,27897,2202,2189,495,2684,14
2021-02-16,Humboldt,23,135768,3040,2994,21,3015,29
2021-02-16,Imperial,25,180216,27007,26711,2576,29287,580
2021-02-16,Inyo,27,18085,1251,1191,1,1192,32
2021-02-16,Kern,29,883053,91827,90267,9889,100156,959
2021-02-16,Kings,31,150075,21840,21583,1035,22618,206
2021-02-16,Lake,33,64148,3108,3041,2,3043,38
2021-02-16,Lassen,35,31185,5069,5047,96,5143,1
2021-02-16,Los Angeles,37,10098052,1159921,1138262,40715,1178977,19044
2021-02-16,Madera,39,155013,15310,15120,805,15925,172
2021-02-16,Marin,41,260295,12955,12832,160,12992,205
2021-02-16,Mariposa,43,17540,374,367,5,372,4
2021-02-16,Mendocino,45,87422,3576,3489,60,3549,39
2021-02-16,Merced,47,269075,27866,27724,852,28576,368
2021-02-16,Modoc,49,8938,333,326,113,439,3
2021-02-16,Mono,51,14174,1164,1180,14,1194,3
2021-02-16,Monterey,53,433212,41388,40962,1691,42653,303
2021-02-16,Napa,55,140530,8909,8854,32,8886,66
2021-02-16,Nevada,57,99092,3899,3774,155,3929,47
2021-02-16,Orange,59,3164182,244151,242382,10394,252776,3612
2021-02-16,Placer,61,380077,20172,19367,1120,20487,230
2021-02-16,Plumas,63,18699,636,619,11,630,4
2021-02-16,Riverside,65,2383286,280616,275954,14015,289969,3471
2021-02-16,Sacramento,67,1510023,92787,91246,1235,92481,1305
2021-02-16,San Benito,69,59416,5687,5659,88,5747,56
2021-02-16,San Bernardino,71,2135413,283698,277947,8587,286534,2978
2021-02-16,San Diego,73,3302833,260338,253638,0,253638,3042
2021-02-16,San Francisco,75,870044,33620,33491,1112,34603,373
2021-02-16,San Joaquin,77,732212,65715,64448,2838,67286,979
2021-02-16,San Luis Obispo,79,281455,19206,18925,560,19485,229
2021-02-16,San Mateo,81,765935,38968,38041,392,38433,277
2021-02-16,Santa Barbara,83,443738,31690,30865,1196,32061,378
2021-02-16,Santa Clara,85,1922200,107978,107754,567,108321,1591
2021-02-16,Santa Cruz,87,273765,15127,14256,826,15082,174
2021-02-16,Shasta,89,179085,10805,10736,1248,11984,139
2021-02-16,Sierra,91,2930,48,47,14,61,0
2021-02-16,Siskiyou,93,43540,1432,1351,241,1592,4
2021-02-16,Solano,95,438530,29464,29246,355,29601,148
2021-02-16,Sonoma,97,501317,27509,27380,179,27559,279
2021-02-16,Stanislaus,99,539301,49512,48927,5427,54354,716
2021-02-16,Sutter,101,95872,8715,8671,83,8754,95
2021-02-16,Tehama,103,63373,4527,4501,520,5021,30
2021-02-16,Trinity,105,12862,334,275,38,313,3
2021-02-16,Tulare,107,460477,47105,46444,8148,54592,716
2021-02-16,Tuolumne,109,53932,3809,3796,62,3858,49
2021-02-16,Ventura,111,848112,76380,76043,2850,78893,631
2021-02-16,Yolo,113,214977,12690,12457,221,12678,175
2021-02-16,Yuba,115,75493,5402,5332,86,5418,38
2021-02-15,Alameda,1,1643700,79261,78647,1769,80416,996
2021-02-15,Alpine,3,1148,79,76,0,76,0
2021-02-15,Amador,5,37829,3428,3409,31,3440,39
2021-02-15,Butte,7,227075,11091,10723,1655,12378,155
2021-02-15,Calaveras,9,45235,1883,1871,13,1884,21
2021-02-15,Colusa,11,21464,1853,1849,258,2107,10
2021-02-15,Contra Costa,13,1133247,61758,60444,1093,61537,631
2021-02-15,Del Norte,15,27424,939,913,0,913,2
2021-02-15,El Dorado,17,186661,8958,8816,629,9445,94
2021-02-15,Fresno,19,978130,94087,93231,7771,101002,1288
2021-02-15,Glenn,21,27897,2199,2185,492,2677,14
2021-02-15,Humboldt,23,135768,3032,2997,21,3018,29
2021-02-15,Imperial,25,180216,26988,26700,2572,29272,580
2021-02-15,Inyo,27,18085,1232,1184,1,1185,32
2021-02-15,Kern,29,883053,91684,90181,9856,100037,959
2021-02-15,Kings,31,150075,21795,21574,1031,22605,205
2021-02-15,Lake,33,64148,3094,3030,1,3031,38
2021-02-15,Lassen,35,31185,5067,5047,95,5142,1
2021-02-15,Los Angeles,37,10098052,1158531,1137164,40652,1177816,18925
2021-02-15,Madera,39,155013,15279,15108,804,15912,106
2021-02-15,Marin,41,260295,12935,12810,157,12967,203
2021-02-15,Mariposa,43,17540,372,367,5,372,4
2021-02-15,Mendocino,45,87422,3564,3481,60,3541,39
2021-02-15,Merced,47,269075,27791,27656,846,28502,368
2021-02-15,Modoc,49,8938,333,326,113,439,3
2021-02-15,Mono,51,14174,1161,1178,14,1192,3
2021-02-15,Monterey,53,433212,41326,40911,1677,42588,302
2021-02-15,Napa,55,140530,8895,8837,32,8869,57
2021-02-15,Nevada,57,99092,3882,3767,154,3921,47
2021-02-15,Orange,59,3164182,243832,242176,10367,252543,3586
2021-02-15,Placer,61,380077,20145,19361,1119,20480,230
2021-02-15,Plumas,63,18699,636,620,11,631,4
2021-02-15,Riverside,65,2383286,280270,275771,14000,289771,3468
2021-02-15,Sacramento,67,1510023,92460,91091,1229,92320,1304
2021-02-15,San Benito,69,59416,5678,5649,88,5737,56
2021-02-15,San Bernardino,71,2135413,283436,277869,8577,286446,2945
2021-02-15,San Diego,73,3302833,259826,252940,0,252940,3037
2021-02-15,San Francisco,75,870044,33548,33454,1104,34558,373
2021-02-15,San Joaquin,77,732212,65550,64382,2831,67213,979
2021-02-15,San Luis Obispo,79,281455,19153,18891,558,19449,227
2021-02-15,San Mateo,81,765935,38888,37969,389,38358,277
2021-02-15,Santa Barbara,83,443738,31590,30810,1193,32003,378
2021-02-15,Santa Clara,85,1922200,107744,107630,565,108195,1588
2021-02-15,Santa Cruz,87,273765,15095,14239,823,15062,175
2021-02-15,Shasta,89,179085,10785,10730,1243,11973,139
2021-02-15,Sierra,91,2930,48,47,14,61,0
2021-02-15,Siskiyou,93,43540,1424,1345,240,1585,4
2021-02-15,Solano,95,438530,29409,29225,355,29580,148
2021-02-15,Sonoma,97,501317,27422,27359,175,27534,276
2021-02-15,Stanislaus,99,539301,49388,48808,5413,54221,716
2021-02-15,Sutter,101,95872,8700,8652,83,8735,95
2021-02-15,Tehama,103,63373,4516,4492,518,5010,30
2021-02-15,Trinity,105,12862,333,274,38,312,3
2021-02-15,Tulare,107,460477,47033,46344,8107,54451,715
2021-02-15,Tuolumne,109,53932,3799,3794,61,3855,49
2021-02-15,Ventura,111,848112,76224,75889,2847,78736,629
2021-02-15,Yolo,113,214977,12655,12412,214,12626,175
2021-02-15,Yuba,115,75493,5385,5320,85,5405,38
2021-02-14,Alameda,1,1643700,79104,78442,1768,80210,995
2021-02-14,Alpine,3,1148,79,76,0,76,0
2021-02-14,Amador,5,37829,3423,3398,31,3429,39
2021-02-14,Butte,7,227075,11067,10717,1650,12367,155
2021-02-14,Calaveras,9,45235,1880,1866,13,1879,21
2021-02-14,Colusa,11,21464,1849,1845,255,2100,10
2021-02-14,Contra Costa,13,1133247,61610,60272,1090,61362,631
2021-02-14,Del Norte,15,27424,935,911,0,911,2
2021-02-14,El Dorado,17,186661,8930,8790,627,9417,94
2021-02-14,Fresno,19,978130,93923,93065,7746,100811,1287
2021-02-14,Glenn,21,27897,2197,2184,492,2676,14
2021-02-14,Humboldt,23,135768,3019,2992,21,3013,29
2021-02-14,Imperial,25,180216,26980,26696,2571,29267,580
2021-02-14,Inyo,27,18085,1226,1177,1,1178,32
2021-02-14,Kern,29,883053,91527,90038,9801,99839,959
2021-02-14,Kings,31,150075,21770,21538,1028,22566,205
2021-02-14,Lake,33,64148,3085,3030,1,3031,38
2021-02-14,Lassen,35,31185,5063,5037,95,5132,1
2021-02-14,Los Angeles,37,10098052,1157194,1135450,40564,1176014,18898
2021-02-14,Madera,39,155013,15248,15089,800,15889,106
2021-02-14,Marin,41,260295,12911,12784,157,12941,201
2021-02-14,Mariposa,43,17540,372,365,5,370,4
2021-02-14,Mendocino,45,87422,3559,3475,60,3535,39
2021-02-14,Merced,47,269075,27714,27601,840,28441,368
2021-02-14,Modoc,49,8938,333,326,113,439,3
2021-02-14,Mono,51,14174,1160,1180,14,1194,3
2021-02-14,Monterey,53,433212,41277,40842,1673,42515,302
2021-02-14,Napa,55,140530,8875,8826,32,8858,57
2021-02-14,Nevada,57,99092,3866,3761,154,3915,47
2021-02-14,Orange,59,3164182,243523,241859,10346,252205,3564
2021-02-14,Placer,61,380077,20107,19313,1114,20427,230
2021-02-14,Plumas,63,18699,635,620,11,631,4
2021-02-14,Riverside,65,2383286,279956,275518,13976,289494,3471
2021-02-14,Sacramento,67,1510023,92253,90856,1225,92081,1304
2021-02-14,San Benito,69,59416,5670,5641,87,5728,56
2021-02-14,San Bernardino,71,2135413,283119,277664,8551,286215,2929
2021-02-14,San Diego,73,3302833,259334,252247,0,252247,3037
2021-02-14,San Francisco,75,870044,33476,33374,1094,34468,372
2021-02-14,San Joaquin,77,732212,65451,64243,2817,67060,979
2021-02-14,San Luis Obispo,79,281455,19115,18868,555,19423,225
2021-02-14,San Mateo,81,765935,38806,37859,389,38248,277
2021-02-14,Santa Barbara,83,443738,31498,30744,1185,31929,377
2021-02-14,Santa Clara,85,1922200,107544,107412,561,107973,1582
2021-02-14,Santa Cruz,87,273765,15067,14225,818,15043,175
2021-02-14,Shasta,89,179085,10755,10720,1237,11957,139
2021-02-14,Sierra,91,2930,48,47,14,61,0
2021-02-14,Siskiyou,93,43540,1420,1340,240,1580,4
2021-02-14,Solano,95,438530,29371,29150,351,29501,148
2021-02-14,Sonoma,97,501317,27345,27266,173,27439,276
2021-02-14,Stanislaus,99,539301,49283,48672,5396,54068,716
2021-02-14,Sutter,101,95872,8677,8642,83,8725,95
2021-02-14,Tehama,103,63373,4508,4490,516,5006,30
2021-02-14,Trinity,105,12862,333,272,38,310,3
2021-02-14,Tulare,107,460477,46958,46263,8051,54314,715
2021-02-14,Tuolumne,109,53932,3798,3764,61,3825,49
2021-02-14,Ventura,111,848112,76050,75742,2836,78578,629
2021-02-14,Yolo,113,214977,12625,12399,213,12612,175
2021-02-14,Yuba,115,75493,5375,5314,85,5399,38
2021-02-13,Alameda,1,1643700,78985,78246,1765,80011,995
2021-02-13,Alpine,3,1148,79,76,0,76,0
2021-02-13,Amador,5,37829,3420,3387,31,3418,38
2021-02-13,Butte,7,227075,11051,10699,1649,12348,155
2021-02-13,Calaveras,9,45235,1876,1863,13,1876,21
2021-02-13,Colusa,11,21464,1849,1837,255,2092,10
2021-02-13,Contra Costa,13,1133247,61490,60100,1090,61190,629
2021-02-13,Del Norte,15,27424,933,908,0,908,2
2021-02-13,El Dorado,17,186661,8919,8758,626,9384,93
2021-02-13,Fresno,19,978130,93816,92807,7722,100529,1287
2021-02-13,Glenn,21,27897,2196,2182,492,2674,14
2021-02-13,Humboldt,23,135768,3006,2974,20,2994,29
2021-02-13,Imperial,25,180216,26973,26680,2569,29249,580
2021-02-13,Inyo,27,18085,1222,1168,1,1169,32
2021-02-13,Kern,29,883053,91439,89915,9775,99690,957
2021-02-13,Kings,31,150075,21755,21513,1026,22539,205
2021-02-13,Lake,33,64148,3079,3025,1,3026,37
2021-02-13,Lassen,35,31185,5060,5028,95,5123,1
2021-02-13,Los Angeles,37,10098052,1156336,1133752,40514,1174266,18822
2021-02-13,Madera,39,155013,15239,15053,795,15848,106
2021-02-13,Marin,41,260295,12890,12757,157,12914,201
2021-02-13,Mariposa,43,17540,372,365,5,370,4
2021-02-13,Mendocino,45,87422,3549,3466,60,3526,38
2021-02-13,Merced,47,269075,27670,27541,837,28378,368
2021-02-13,Modoc,49,8938,333,325,113,438,3
2021-02-13,Mono,51,14174,1160,1176,14,1190,3
2021-02-13,Monterey,53,433212,41246,40731,1671,42402,301
2021-02-13,Napa,55,140530,8866,8809,32,8841,57
2021-02-13,Nevada,57,99092,3857,3742,153,3895,47
2021-02-13,Orange,59,3164182,243322,241545,10325,251870,3520
2021-02-13,Placer,61,380077,20086,19214,1114,20328,230
2021-02-13,Plumas,63,18699,635,616,11,627,4
2021-02-13,Riverside,65,2383286,279728,275276,13966,289242,3462
2021-02-13,Sacramento,67,1510023,92084,90401,1222,91623,1302
2021-02-13,San Benito,69,59416,5656,5633,87,5720,56
2021-02-13,San Bernardino,71,2135413,282976,277405,8539,285944,2899
2021-02-13,San Diego,73,3302833,259004,251679,0,251679,3009
2021-02-13,San Francisco,75,870044,33427,33291,1083,34374,364
2021-02-13,San Joaquin,77,732212,65383,64105,2807,66912,977
2021-02-13,San Luis Obispo,79,281455,19087,18803,549,19352,225
2021-02-13,San Mateo,81,765935,38753,37745,389,38134,277
2021-02-13,Santa Barbara,83,443738,31447,30594,1182,31776,374
2021-02-13,Santa Clara,85,1922200,107360,107125,557,107682,1570
2021-02-13,Santa Cruz,87,273765,15040,14198,817,15015,173
2021-02-13,Shasta,89,179085,10743,10713,1231,11944,139
2021-02-13,Sierra,91,2930,48,47,14,61,0
2021-02-13,Siskiyou,93,43540,1417,1336,240,1576,4
2021-02-13,Solano,95,438530,29335,29084,351,29435,148
2021-02-13,Sonoma,97,501317,27299,27157,171,27328,276
2021-02-13,Stanislaus,99,539301,49214,48568,5390,53958,697
2021-02-13,Sutter,101,95872,8665,8626,83,8709,94
2021-02-13,Tehama,103,63373,4499,4484,515,4999,30
2021-02-13,Trinity,105,12862,332,272,37,309,3
2021-02-13,Tulare,107,460477,46914,46162,8014,54176,709
2021-02-13,Tuolumne,109,53932,3797,3752,61,3813,49
2021-02-13,Ventura,111,848112,75913,75481,2830,78311,618
2021-02-13,Yolo,113,214977,12613,12374,212,12586,175
2021-02-13,Yuba,115,75493,5367,5289,85,5374,38
2021-02-12,Alameda,1,1643700,78851,77958,1759,79717,974
2021-02-12,Alpine,3,1148,79,76,0,76,0
2021-02-12,Amador,5,37829,3416,3381,31,3412,38
2021-02-12,Butte,7,227075,11036,10655,1642,12297,155
2021-02-12,Calaveras,9,45235,1873,1860,13,1873,21
2021-02-12,Colusa,11,21464,1849,1836,255,2091,10
2021-02-12,Contra Costa,13,1133247,61340,59878,1086,60964,620
2021-02-12,Del Norte,15,27424,923,901,0,901,2
2021-02-12,El Dorado,17,186661,8903,8725,623,9348,92
2021-02-12,Fresno,19,978130,93669,92520,7701,100221,1273
2021-02-12,Glenn,21,27897,2193,2175,492,2667,14
2021-02-12,Humboldt,23,135768,2997,2961,20,2981,29
2021-02-12,Imperial,25,180216,26965,26646,2567,29213,585
2021-02-12,Inyo,27,18085,1216,1156,1,1157,32
2021-02-12,Kern,29,883053,91330,89532,9738,99270,949
2021-02-12,Kings,31,150075,21724,21462,1020,22482,202
2021-02-12,Lake,33,64148,3074,3012,1,3013,36
2021-02-12,Lassen,35,31185,5058,5015,95,5110,1
2021-02-12,Los Angeles,37,10098052,1155133,1131185,40443,1171628,18637
2021-02-12,Madera,39,155013,15212,15022,792,15814,106
2021-02-12,Marin,41,260295,12864,12720,157,12877,200
2021-02-12,Mariposa,43,17540,371,365,5,370,4
2021-02-12,Mendocino,45,87422,3547,3447,60,3507,38
2021-02-12,Merced,47,269075,27619,27453,834,28287,367
2021-02-12,Modoc,49,8938,333,324,113,437,3
2021-02-12,Mono,51,14174,1159,1172,14,1186,3
2021-02-12,Monterey,53,433212,41199,40633,1662,42295,297
2021-02-12,Napa,55,140530,8854,8785,32,8817,55
2021-02-12,Nevada,57,99092,3852,3728,153,3881,47
2021-02-12,Orange,59,3164182,243085,241075,10309,251384,3505
2021-02-12,Placer,61,380077,20046,19174,1109,20283,230
2021-02-12,Plumas,63,18699,634,614,11,625,4
2021-02-12,Riverside,65,2383286,279454,274792,13947,288739,3438
2021-02-12,Sacramento,67,1510023,91879,90252,1221,91473,1295
2021-02-12,San Benito,69,59416,5640,5622,86,5708,56
2021-02-12,San Bernardino,71,2135413,282788,276890,8527,285417,2827
2021-02-12,San Diego,73,3302833,258622,250788,0,250788,2979
2021-02-12,San Francisco,75,870044,33367,33179,1079,34258,359
2021-02-12,San Joaquin,77,732212,65289,63966,2799,66765,975
2021-02-12,San Luis Obispo,79,281455,19046,18687,548,19235,224
2021-02-12,San Mateo,81,765935,38681,37560,389,37949,254
2021-02-12,Santa Barbara,83,443738,31376,30454,1177,31631,372
2021-02-12,Santa Clara,85,1922200,107191,106759,553,107312,1543
2021-02-12,Santa Cruz,87,273765,15020,14147,817,14964,170
2021-02-12,Shasta,89,179085,10725,10693,1221,11914,142
2021-02-12,Sierra,91,2930,47,45,14,59,0
2021-02-12,Siskiyou,93,43540,1413,1324,237,1561,4
2021-02-12,Solano,95,438530,29303,28996,348,29344,147
2021-02-12,Sonoma,97,501317,27243,27064,167,27231,275
2021-02-12,Stanislaus,99,539301,49131,48418,5365,53783,697
2021-02-12,Sutter,101,95872,8651,8609,83,8692,93
2021-02-12,Tehama,103,63373,4491,4470,514,4984,27
2021-02-12,Trinity,105,12862,332,269,37,306,3
2021-02-12,Tulare,107,460477,46836,46016,7987,54003,710
2021-02-12,Tuolumne,109,53932,3795,3736,60,3796,49
2021-02-12,Ventura,111,848112,75746,75210,2822,78032,605
2021-02-12,Yolo,113,214977,12593,12340,212,12552,175
2021-02-12,Yuba,115,75493,5359,5274,85,5359,38
2021-02-11,Alameda,1,1643700,78623,77564,1754,79318,960
2021-02-11,Alpine,3,1148,78,76,0,76,0
2021-02-11,Amador,5,37829,3412,3368,31,3399,35
2021-02-11,Butte,7,227075,11012,10624,1640,12264,155
2021-02-11,Calaveras,9,45235,1871,1856,13,1869,21
2021-02-11,Colusa,11,21464,1844,1823,253,2076,10
2021-02-11,Contra Costa,13,1133247,61173,59633,1083,60716,605
2021-02-11,Del Norte,15,27424,918,894,0,894,2
2021-02-11,El Dorado,17,186661,8882,8698,623,9321,92
2021-02-11,Fresno,19,978130,93517,92168,7674,99842,1255
2021-02-11,Glenn,21,27897,2191,2166,490,2656,14
2021-02-11,Humboldt,23,135768,2985,2954,19,2973,29
2021-02-11,Imperial,25,180216,26942,26545,2565,29110,578
2021-02-11,Inyo,27,18085,1207,1144,1,1145,32
2021-02-11,Kern,29,883053,91143,89224,9691,98915,941
2021-02-11,Kings,31,150075,21694,21373,1017,22390,202
2021-02-11,Lake,33,64148,3064,3002,1,3003,36
2021-02-11,Lassen,35,31185,5047,5004,92,5096,1
2021-02-11,Los Angeles,37,10098052,1153505,1128437,40371,1168808,18500
2021-02-11,Madera,39,155013,15191,14984,790,15774,106
2021-02-11,Marin,41,260295,12827,12682,157,12839,200
2021-02-11,Mariposa,43,17540,371,361,5,366,4
2021-02-11,Mendocino,45,87422,3540,3420,60,3480,38
2021-02-11,Merced,47,269075,27554,27325,830,28155,363
2021-02-11,Modoc,49,8938,332,317,113,430,3
2021-02-11,Mono,51,14174,1155,1173,14,1187,3
2021-02-11,Monterey,53,433212,41091,40469,1655,42124,295
2021-02-11,Napa,55,140530,8833,8777,32,8809,55
2021-02-11,Nevada,57,99092,3836,3720,153,3873,47
2021-02-11,Orange,59,3164182,242718,240590,10285,250875,3476
2021-02-11,Placer,61,380077,20006,19118,1108,20226,224
2021-02-11,Plumas,63,18699,633,592,11,603,4
2021-02-11,Riverside,65,2383286,279089,274313,13932,288245,3394
2021-02-11,Sacramento,67,1510023,91633,89988,1215,91203,1286
2021-02-11,San Benito,69,59416,5631,5609,86,5695,56
2021-02-11,San Bernardino,71,2135413,282471,276349,8511,284860,2774
2021-02-11,San Diego,73,3302833,258071,249971,0,249971,2955
2021-02-11,San Francisco,75,870044,33284,33076,1067,34143,356
2021-02-11,San Joaquin,77,732212,65119,63719,2788,66507,971
2021-02-11,San Luis Obispo,79,281455,18981,18615,544,19159,219
2021-02-11,San Mateo,81,765935,38588,37439,386,37825,253
2021-02-11,Santa Barbara,83,443738,31283,30375,1172,31547,370
2021-02-11,Santa Clara,85,1922200,106935,106392,548,106940,1507
2021-02-11,Santa Cruz,87,273765,14998,14088,811,14899,165
2021-02-11,Shasta,89,179085,10701,10672,1217,11889,140
2021-02-11,Sierra,91,2930,47,45,14,59,0
2021-02-11,Siskiyou,93,43540,1398,1320,237,1557,4
2021-02-11,Solano,95,438530,29251,28885,348,29233,138
2021-02-11,Sonoma,97,501317,27160,26971,164,27135,272
2021-02-11,Stanislaus,99,539301,48989,48205,5354,53559,697
2021-02-11,Sutter,101,95872,8637,8590,82,8672,93
2021-02-11,Tehama,103,63373,4485,4463,514,4977,26
2021-02-11,Trinity,105,12862,332,269,37,306,3
2021-02-11,Tulare,107,460477,46744,45897,7942,53839,706
2021-02-11,Tuolumne,109,53932,3758,3716,60,3776,48
2021-02-11,Ventura,111,848112,75545,74959,2813,77772,590
2021-02-11,Yolo,113,214977,12570,12303,210,12513,173
2021-02-11,Yuba,115,75493,5345,5261,83,5344,38
2021-02-10,Alameda,1,1643700,78419,77344,1752,79096,944
2021-02-10,Alpine,3,1148,78,76,0,76,0
2021-02-10,Amador,5,37829,3400,3348,31,3379,35
2021-02-10,Butte,7,227075,10986,10594,1639,12233,155
2021-02-10,Calaveras,9,45235,1869,1850,13,1863,21
2021-02-10,Colusa,11,21464,1837,1815,251,2066,10
2021-02-10,Contra Costa,13,1133247,61001,59488,1081,60569,590
2021-02-10,Del Norte,15,27424,912,888,0,888,2
2021-02-10,El Dorado,17,186661,8852,8682,619,9301,87
2021-02-10,Fresno,19,978130,93345,91876,7647,99523,1247
2021-02-10,Glenn,21,27897,2189,2160,488,2648,14
2021-02-10,Humboldt,23,135768,2977,2924,19,2943,29
2021-02-10,Imperial,25,180216,26902,26522,2563,29085,578
2021-02-10,Inyo,27,18085,1195,1138,1,1139,30
2021-02-10,Kern,29,883053,90940,88933,9634,98567,926
2021-02-10,Kings,31,150075,21652,21294,1013,22307,197
2021-02-10,Lake,33,64148,3051,2975,1,2976,36
2021-02-10,Lassen,35,31185,5043,4993,92,5085,1
2021-02-10,Los Angeles,37,10098052,1151768,1125437,40237,1165674,18338
2021-02-10,Madera,39,155013,15153,14925,788,15713,105
2021-02-10,Marin,41,260295,12790,12651,157,12808,199
2021-02-10,Mariposa,43,17540,369,360,5,365,4
2021-02-10,Mendocino,45,87422,3525,3395,60,3455,38
2021-02-10,Merced,47,269075,27471,27246,819,28065,359
2021-02-10,Modoc,49,8938,331,315,111,426,3
2021-02-10,Mono,51,14174,1151,1170,14,1184,3
2021-02-10,Monterey,53,433212,41012,40366,1641,42007,288
2021-02-10,Napa,55,140530,8814,8769,32,8801,55
2021-02-10,Nevada,57,99092,3821,3693,151,3844,47
2021-02-10,Orange,59,3164182,242300,239974,10252,250226,3439
2021-02-10,Placer,61,380077,19966,19062,1103,20165,220
2021-02-10,Plumas,63,18699,630,589,11,600,2
2021-02-10,Riverside,65,2383286,278678,273721,13920,287641,3374
2021-02-10,Sacramento,67,1510023,91386,89653,1210,90863,1275
2021-02-10,San Benito,69,59416,5617,5591,86,5677,55
2021-02-10,San Bernardino,71,2135413,282112,275616,8492,284108,2696
2021-02-10,San Diego,73,3302833,257490,248858,0,248858,2904
2021-02-10,San Francisco,75,870044,33202,32955,1064,34019,351
2021-02-10,San Joaquin,77,732212,64978,63484,2774,66258,954
2021-02-10,San Luis Obispo,79,281455,18902,18549,542,19091,216
2021-02-10,San Mateo,81,765935,38497,37323,386,37709,245
2021-02-10,Santa Barbara,83,443738,31194,30216,1167,31383,359
2021-02-10,Santa Clara,85,1922200,106697,106048,545,106593,1489
2021-02-10,Santa Cruz,87,273765,14963,14007,808,14815,165
2021-02-10,Shasta,89,179085,10677,10645,1214,11859,142
2021-02-10,Sierra,91,2930,47,45,14,59,0
2021-02-10,Siskiyou,93,43540,1393,1314,236,1550,4
2021-02-10,Solano,95,438530,29176,28835,346,29181,137
2021-02-10,Sonoma,97,501317,27069,26881,162,27043,271
2021-02-10,Stanislaus,99,539301,48875,48016,5336,53352,696
2021-02-10,Sutter,101,95872,8620,8571,82,8653,93
2021-02-10,Tehama,103,63373,4477,4445,514,4959,23
2021-02-10,Trinity,105,12862,330,268,37,305,3
2021-02-10,Tulare,107,460477,46629,45782,7902,53684,696
2021-02-10,Tuolumne,109,53932,3750,3691,60,3751,48
2021-02-10,Ventura,111,848112,75319,74651,2795,77446,580
2021-02-10,Yolo,113,214977,12544,12276,209,12485,174
2021-02-10,Yuba,115,75493,5327,5241,83,5324,38
2021-02-09,Alameda,1,1643700,78153,77018,1749,78767,936
2021-02-09,Alpine,3,1148,78,76,0,76,0
2021-02-09,Amador,5,37829,3392,3347,31,3378,35
2021-02-09,Butte,7,227075,10959,10563,1637,12200,153
2021-02-09,Calaveras,9,45235,1862,1847,13,1860,21
2021-02-09,Colusa,11,21464,1828,1812,246,2058,10
2021-02-09,Contra Costa,13,1133247,60813,59307,1075,60382,583
2021-02-09,Del Norte,15,27424,906,886,0,886,2
2021-02-09,El Dorado,17,186661,8827,8663,618,9281,87
2021-02-09,Fresno,19,978130,93110,91730,7613,99343,1211
2021-02-09,Glenn,21,27897,2185,2156,487,2643,14
2021-02-09,Humboldt,23,135768,2969,2904,19,2923,29
2021-02-09,Imperial,25,180216,26874,26509,2560,29069,568
2021-02-09,Inyo,27,18085,1187,1137,1,1138,30
2021-02-09,Kern,29,883053,90693,88684,9586,98270,920
2021-02-09,Kings,31,150075,21611,21275,1011,22286,196
2021-02-09,Lake,33,64148,3039,2955,1,2956,36
2021-02-09,Lassen,35,31185,5036,4983,92,5075,1
2021-02-09,Los Angeles,37,10098052,1149808,1122745,40146,1162891,18198
2021-02-09,Madera,39,155013,15133,14912,785,15697,105
2021-02-09,Marin,41,260295,12758,12623,156,12779,197
2021-02-09,Mariposa,43,17540,367,355,5,360,4
2021-02-09,Mendocino,45,87422,3507,3369,60,3429,38
2021-02-09,Merced,47,269075,27373,27166,814,27980,354
2021-02-09,Modoc,49,8938,330,316,111,427,3
2021-02-09,Mono,51,14174,1150,1167,14,1181,3
2021-02-09,Monterey,53,433212,40903,40279,1630,41909,285
2021-02-09,Napa,55,140530,8801,8749,32,8781,55
2021-02-09,Nevada,57,99092,3805,3687,151,3838,44
2021-02-09,Orange,59,3164182,241883,239169,10219,249388,3406
2021-02-09,Placer,61,380077,19903,19008,1095,20103,220
2021-02-09,Plumas,63,18699,630,584,11,595,2
2021-02-09,Riverside,65,2383286,278192,273465,13905,287370,3334
2021-02-09,Sacramento,67,1510023,91076,89378,1207,90585,1265
2021-02-09,San Benito,69,59416,5605,5566,85,5651,54
2021-02-09,San Bernardino,71,2135413,281743,274998,8476,283474,2613
2021-02-09,San Diego,73,3302833,256834,248048,0,248048,2853
2021-02-09,San Francisco,75,870044,33123,32782,1054,33836,349
2021-02-09,San Joaquin,77,732212,64804,63341,2769,66110,937
2021-02-09,San Luis Obispo,79,281455,18843,18489,541,19030,216
2021-02-09,San Mateo,81,765935,38367,37227,385,37612,235
2021-02-09,Santa Barbara,83,443738,31084,30118,1160,31278,351
2021-02-09,Santa Clara,85,1922200,106390,105762,542,106304,1463
2021-02-09,Santa Cruz,87,273765,14913,13958,803,14761,162
2021-02-09,Shasta,89,179085,10651,10595,1212,11807,139
2021-02-09,Sierra,91,2930,47,44,14,58,0
2021-02-09,Siskiyou,93,43540,1386,1306,233,1539,4
2021-02-09,Solano,95,438530,29100,28769,342,29111,131
2021-02-09,Sonoma,97,501317,26977,26826,160,26986,267
2021-02-09,Stanislaus,99,539301,48714,47906,5319,53225,679
2021-02-09,Sutter,101,95872,8603,8541,82,8623,92
2021-02-09,Tehama,103,63373,4470,4416,512,4928,22
2021-02-09,Trinity,105,12862,330,266,37,303,3
2021-02-09,Tulare,107,460477,46499,45704,7843,53547,686
2021-02-09,Tuolumne,109,53932,3730,3673,59,3732,48
2021-02-09,Ventura,111,848112,75070,74333,2787,77120,567
2021-02-09,Yolo,113,214977,12501,12220,208,12428,174
2021-02-09,Yuba,115,75493,5318,5235,83,5318,35
2021-02-08,Alameda,1,1643700,77886,76735,1744,78479,924
2021-02-08,Alpine,3,1148,78,73,0,73,0
2021-02-08,Amador,5,37829,3385,3344,30,3374,33
2021-02-08,Butte,7,227075,10936,10524,1634,12158,152
2021-02-08,Calaveras,9,45235,1857,1840,13,1853,21
2021-02-08,Colusa,11,21464,1820,1802,242,2044,10
2021-02-08,Contra Costa,13,1133247,60605,59039,1073,60112,567
2021-02-08,Del Norte,15,27424,903,885,0,885,2
2021-02-08,El Dorado,17,186661,8796,8627,616,9243,86
2021-02-08,Fresno,19,978130,92898,91430,7586,99016,1207
2021-02-08,Glenn,21,27897,2178,2148,485,2633,14
2021-02-08,Humboldt,23,135768,2961,2902,19,2921,29
2021-02-08,Imperial,25,180216,26855,26526,2558,29084,567
2021-02-08,Inyo,27,18085,1174,1126,1,1127,30
2021-02-08,Kern,29,883053,90478,88380,9527,97907,920
2021-02-08,Kings,31,150075,21549,21232,1008,22240,195
2021-02-08,Lake,33,64148,3020,2949,1,2950,36
2021-02-08,Lassen,35,31185,5023,4976,92,5068,1
2021-02-08,Los Angeles,37,10098052,1147721,1120179,40023,1160202,17977
2021-02-08,Madera,39,155013,15097,14887,778,15665,93
2021-02-08,Marin,41,260295,12729,12591,156,12747,194
2021-02-08,Mariposa,43,17540,367,355,5,360,4
2021-02-08,Mendocino,45,87422,3493,3355,60,3415,38
2021-02-08,Merced,47,269075,27287,27082,809,27891,346
2021-02-08,Modoc,49,8938,328,318,111,429,3
2021-02-08,Mono,51,14174,1150,1165,14,1179,3
2021-02-08,Monterey,53,433212,40780,40186,1611,41797,283
2021-02-08,Napa,55,140530,8786,8719,32,8751,55
2021-02-08,Nevada,57,99092,3793,3671,151,3822,44
2021-02-08,Orange,59,3164182,241416,238715,10194,248909,3361
2021-02-08,Placer,61,380077,19860,18944,1088,20032,211
2021-02-08,Plumas,63,18699,629,584,11,595,2
2021-02-08,Riverside,65,2383286,277633,272904,13880,286784,3301
2021-02-08,Sacramento,67,1510023,90787,89267,1204,90471,1247
2021-02-08,San Benito,69,59416,5600,5553,84,5637,52
2021-02-08,San Bernardino,71,2135413,281343,274661,8469,283130,2587
2021-02-08,San Diego,73,3302833,256092,247259,0,247259,2821
2021-02-08,San Francisco,75,870044,33028,32679,1046,33725,348
2021-02-08,San Joaquin,77,732212,64643,63148,2759,65907,929
2021-02-08,San Luis Obispo,79,281455,18786,18421,536,18957,214
2021-02-08,San Mateo,81,765935,38262,37084,385,37469,232
2021-02-08,Santa Barbara,83,443738,30971,29978,1153,31131,340
2021-02-08,Santa Clara,85,1922200,106065,105413,535,105948,1456
2021-02-08,Santa Cruz,87,273765,14874,13921,796,14717,161
2021-02-08,Shasta,89,179085,10625,10574,1206,11780,137
2021-02-08,Sierra,91,2930,47,44,14,58,0
2021-02-08,Siskiyou,93,43540,1383,1303,233,1536,4
2021-02-08,Solano,95,438530,29037,28644,340,28984,130
2021-02-08,Sonoma,97,501317,26889,26760,159,26919,259
2021-02-08,Stanislaus,99,539301,48563,47704,5290,52994,679
2021-02-08,Sutter,101,95872,8584,8526,82,8608,92
2021-02-08,Tehama,103,63373,4455,4403,510,4913,22
2021-02-08,Trinity,105,12862,328,266,37,303,3
2021-02-08,Tulare,107,460477,46393,45617,7802,53419,673
2021-02-08,Tuolumne,109,53932,3722,3647,58,3705,48
2021-02-08,Ventura,111,848112,74813,74068,2781,76849,565
2021-02-08,Yolo,113,214977,12469,12169,208,12377,162
2021-02-08,Yuba,115,75493,5302,5215,83,5298,35
2021-02-07,Alameda,1,1643700,77584,76500,1735,78235,924
2021-02-07,Alpine,3,1148,75,72,0,72,0
2021-02-07,Amador,5,37829,3364,3343,30,3373,33
2021-02-07,Butte,7,227075,10903,10513,1624,12137,152
2021-02-07,Calaveras,9,45235,1849,1837,13,1850,21
2021-02-07,Colusa,11,21464,1809,1795,240,2035,10
2021-02-07,Contra Costa,13,1133247,60369,58836,1067,59903,566
2021-02-07,Del Norte,15,27424,899,881,0,881,2
2021-02-07,El Dorado,17,186661,8767,8596,614,9210,86
2021-02-07,Fresno,19,978130,92674,91184,7545,98729,1207
2021-02-07,Glenn,21,27897,2174,2141,481,2622,14
2021-02-07,Humboldt,23,135768,2941,2895,19,2914,28
2021-02-07,Imperial,25,180216,26829,26518,2551,29069,567
2021-02-07,Inyo,27,18085,1163,1124,1,1125,27
2021-02-07,Kern,29,883053,90235,88146,9470,97616,920
2021-02-07,Kings,31,150075,21489,21180,1005,22185,192
2021-02-07,Lake,33,64148,3004,2940,1,2941,36
2021-02-07,Lassen,35,31185,5012,4973,92,5065,1
2021-02-07,Los Angeles,37,10098052,1144977,1117551,39890,1157441,17889
2021-02-07,Madera,39,155013,15063,14850,774,15624,93
2021-02-07,Marin,41,260295,12695,12571,154,12725,194
2021-02-07,Mariposa,43,17540,366,355,5,360,4
2021-02-07,Mendocino,45,87422,3476,3348,60,3408,38
2021-02-07,Merced,47,269075,27176,26977,797,27774,346
2021-02-07,Modoc,49,8938,328,317,107,424,3
2021-02-07,Mono,51,14174,1147,1165,14,1179,3
2021-02-07,Monterey,53,433212,40644,40113,1590,41703,283
2021-02-07,Napa,55,140530,8763,8701,32,8733,55
2021-02-07,Nevada,57,99092,3782,3643,151,3794,44
2021-02-07,Orange,59,3164182,240820,238155,10162,248317,3336
2021-02-07,Placer,61,380077,19813,18903,1075,19978,211
2021-02-07,Plumas,63,18699,629,584,11,595,2
2021-02-07,Riverside,65,2383286,277121,272301,13857,286158,3267
2021-02-07,Sacramento,67,1510023,90453,88919,1195,90114,1246
2021-02-07,San Benito,69,59416,5581,5548,83,5631,52
2021-02-07,San Bernardino,71,2135413,280762,274316,8438,282754,2587
2021-02-07,San Diego,73,3302833,255306,246561,0,246561,2821
2021-02-07,San Francisco,75,870044,32908,32609,1034,33643,348
2021-02-07,San Joaquin,77,732212,64372,63051,2743,65794,929
2021-02-07,San Luis Obispo,79,281455,18714,18349,529,18878,214
2021-02-07,San Mateo,81,765935,38128,36984,383,37367,232
2021-02-07,Santa Barbara,83,443738,30835,29815,1142,30957,340
2021-02-07,Santa Clara,85,1922200,105725,105118,525,105643,1450
2021-02-07,Santa Cruz,87,273765,14821,13887,792,14679,161
2021-02-07,Shasta,89,179085,10605,10570,1198,11768,137
2021-02-07,Sierra,91,2930,47,43,14,57,0
2021-02-07,Siskiyou,93,43540,1376,1295,231,1526,4
2021-02-07,Solano,95,438530,28927,28567,339,28906,130
2021-02-07,Sonoma,97,501317,26784,26684,155,26839,257
2021-02-07,Stanislaus,99,539301,48373,47551,5258,52809,679
2021-02-07,Sutter,101,95872,8557,8515,82,8597,92
2021-02-07,Tehama,103,63373,4441,4396,508,4904,22
2021-02-07,Trinity,105,12862,325,264,35,299,3
2021-02-07,Tulare,107,460477,46272,45520,7722,53242,671
2021-02-07,Tuolumne,109,53932,3698,3619,57,3676,48
2021-02-07,Ventura,111,848112,74506,73759,2768,76527,561
2021-02-07,Yolo,113,214977,12424,12135,208,12343,162
2021-02-07,Yuba,115,75493,5287,5198,81,5279,35
2021-02-06,Alameda,1,1643700,77425,76170,1721,77891,922
2021-02-06,Alpine,3,1148,75,72,0,72,0
2021-02-06,Amador,5,37829,3358,3306,30,3336,33
2021-02-06,Butte,7,227075,10886,10480,1620,12100,150
2021-02-06,Calaveras,9,45235,1847,1832,13,1845,21
2021-02-06,Colusa,11,21464,1807,1791,239,2030,10
2021-02-06,Contra Costa,13,1133247,60223,58567,1061,59628,566
2021-02-06,Del Norte,15,27424,895,879,0,879,2
2021-02-06,El Dorado,17,186661,8760,8575,610,9185,86
2021-02-06,Fresno,19,978130,92564,90944,7523,98467,1207
2021-02-06,Glenn,21,27897,2173,2136,479,2615,14
2021-02-06,Humboldt,23,135768,2930,2880,19,2899,28
2021-02-06,Imperial,25,180216,26819,26514,2550,29064,567
2021-02-06,Inyo,27,18085,1160,1113,1,1114,27
2021-02-06,Kern,29,883053,90085,87919,9423,97342,912
2021-02-06,Kings,31,150075,21459,21156,1005,22161,190
2021-02-06,Lake,33,64148,2999,2920,1,2921,34
2021-02-06,Lassen,35,31185,5008,4964,91,5055,1
2021-02-06,Los Angeles,37,10098052,1143626,1114718,39789,1154507,17793
2021-02-06,Madera,39,155013,15042,14807,772,15579,93
2021-02-06,Marin,41,260295,12676,12531,153,12684,194
2021-02-06,Mariposa,43,17540,365,355,4,359,4
2021-02-06,Mendocino,45,87422,3458,3316,59,3375,38
2021-02-06,Merced,47,269075,27092,26881,789,27670,346
2021-02-06,Modoc,49,8938,328,313,107,420,3
2021-02-06,Mono,51,14174,1146,1159,14,1173,3
2021-02-06,Monterey,53,433212,40588,39995,1582,41577,282
2021-02-06,Napa,55,140530,8750,8639,32,8671,55
2021-02-06,Nevada,57,99092,3770,3624,151,3775,43
2021-02-06,Orange,59,3164182,240462,237391,10126,247517,3293
2021-02-06,Placer,61,380077,19776,18836,1071,19907,211
2021-02-06,Plumas,63,18699,629,584,11,595,2
2021-02-06,Riverside,65,2383286,276762,271741,13838,285579,3243
2021-02-06,Sacramento,67,1510023,90234,88532,1186,89718,1237
2021-02-06,San Benito,69,59416,5563,5516,83,5599,52
2021-02-06,San Bernardino,71,2135413,280458,273718,8415,282133,2564
2021-02-06,San Diego,73,3302833,254810,245331,0,245331,2812
2021-02-06,San Francisco,75,870044,32837,32437,1023,33460,346
2021-02-06,San Joaquin,77,732212,64295,62840,2730,65570,906
2021-02-06,San Luis Obispo,79,281455,18672,18284,525,18809,214
2021-02-06,San Mateo,81,765935,38060,36824,380,37204,232
2021-02-06,Santa Barbara,83,443738,30761,29645,1140,30785,337
2021-02-06,Santa Clara,85,1922200,105505,104639,520,105159,1439
2021-02-06,Santa Cruz,87,273765,14790,13845,788,14633,161
2021-02-06,Shasta,89,179085,10594,10561,1196,11757,137
2021-02-06,Sierra,91,2930,47,43,14,57,0
2021-02-06,Siskiyou,93,43540,1373,1289,230,1519,4
2021-02-06,Solano,95,438530,28891,28446,338,28784,129
2021-02-06,Sonoma,97,501317,26748,26564,153,26717,257
2021-02-06,Stanislaus,99,539301,48275,47325,5242,52567,679
2021-02-06,Sutter,101,95872,8549,8485,82,8567,92
2021-02-06,Tehama,103,63373,4434,4380,506,4886,22
2021-02-06,Trinity,105,12862,325,263,35,298,3
2021-02-06,Tulare,107,460477,46207,45349,7672,53021,664
2021-02-06,Tuolumne,109,53932,3691,3612,57,3669,48
2021-02-06,Ventura,111,848112,74326,73431,2762,76193,552
2021-02-06,Yolo,113,214977,12402,12061,208,12269,161
2021-02-06,Yuba,115,75493,5279,5177,80,5257,35
2021-02-05,Alameda,1,1643700,77198,75716,1718,77434,916
2021-02-05,Alpine,3,1148,75,72,0,72,0
2021-02-05,Amador,5,37829,3353,3299,29,3328,33
2021-02-05,Butte,7,227075,10868,10421,1614,12035,150
2021-02-05,Calaveras,9,45235,1842,1818,13,1831,21
2021-02-05,Colusa,11,21464,1803,1785,239,2024,10
2021-02-05,Contra Costa,13,1133247,60062,58195,1059,59254,560
2021-02-05,Del Norte,15,27424,894,874,0,874,2
2021-02-05,El Dorado,17,186661,8740,8527,608,9135,86
2021-02-05,Fresno,19,978130,92360,90513,7502,98015,1194
2021-02-05,Glenn,21,27897,2167,2122,474,2596,14
2021-02-05,Humboldt,23,135768,2920,2857,19,2876,28
2021-02-05,Imperial,25,180216,26800,26474,2550,29024,557
2021-02-05,Inyo,27,18085,1156,1104,1,1105,27
2021-02-05,Kern,29,883053,89918,87470,9355,96825,906
2021-02-05,Kings,31,150075,21422,21021,1001,22022,190
2021-02-05,Lake,33,64148,2987,2906,1,2907,33
2021-02-05,Lassen,35,31185,5004,4936,91,5027,1
2021-02-05,Los Angeles,37,10098052,1141536,1110384,39647,1150031,17608
2021-02-05,Madera,39,155013,15008,14752,767,15519,95
2021-02-05,Marin,41,260295,12641,12479,153,12632,193
2021-02-05,Mariposa,43,17540,365,352,4,356,4
2021-02-05,Mendocino,45,87422,3444,3272,59,3331,38
2021-02-05,Merced,47,269075,27033,26760,788,27548,345
2021-02-05,Modoc,49,8938,328,312,107,419,3
2021-02-05,Mono,51,14174,1145,1157,14,1171,3
2021-02-05,Monterey,53,433212,40524,39840,1571,41411,281
2021-02-05,Napa,55,140530,8736,8598,32,8630,55
2021-02-05,Nevada,57,99092,3767,3607,151,3758,43
2021-02-05,Orange,59,3164182,240042,236335,10097,246432,3260
2021-02-05,Placer,61,380077,19741,18756,1069,19825,211
2021-02-05,Plumas,63,18699,627,578,11,589,2
2021-02-05,Riverside,65,2383286,276356,270666,13819,284485,3235
2021-02-05,Sacramento,67,1510023,90055,87992,1179,89171,1231
2021-02-05,San Benito,69,59416,5552,5502,83,5585,51
2021-02-05,San Bernardino,71,2135413,280123,272938,8397,281335,2495
2021-02-05,San Diego,73,3302833,254234,244066,0,244066,2777
2021-02-05,San Francisco,75,870044,32748,32229,1011,33240,337
2021-02-05,San Joaquin,77,732212,64147,62565,2722,65287,902
2021-02-05,San Luis Obispo,79,281455,18611,18152,521,18673,213
2021-02-05,San Mateo,81,765935,37976,36582,379,36961,227
2021-02-05,Santa Barbara,83,443738,30668,29455,1125,30580,334
2021-02-05,Santa Clara,85,1922200,105255,104112,518,104630,1421
2021-02-05,Santa Cruz,87,273765,14769,13776,786,14562,161
2021-02-05,Shasta,89,179085,10578,10507,1189,11696,136
2021-02-05,Sierra,91,2930,47,42,14,56,0
2021-02-05,Siskiyou,93,43540,1366,1276,228,1504,4
2021-02-05,Solano,95,438530,28841,28283,338,28621,127
2021-02-05,Sonoma,97,501317,26680,26423,150,26573,252
2021-02-05,Stanislaus,99,539301,48133,47024,5223,52247,678
2021-02-05,Sutter,101,95872,8529,8443,82,8525,92
2021-02-05,Tehama,103,63373,4426,4355,506,4861,22
2021-02-05,Trinity,105,12862,324,260,35,295,3
2021-02-05,Tulare,107,460477,46131,45138,7621,52759,663
2021-02-05,Tuolumne,109,53932,3665,3595,57,3652,45
2021-02-05,Ventura,111,848112,74082,72953,2751,75704,546
2021-02-05,Yolo,113,214977,12383,12025,203,12228,162
2021-02-05,Yuba,115,75493,5262,5145,80,5225,35
2021-02-04,Alameda,1,1643700,76913,75422,1712,77134,899
2021-02-04,Alpine,3,1148,74,72,0,72,0
2021-02-04,Amador,5,37829,3350,3288,29,3317,33
2021-02-04,Butte,7,227075,10836,10386,1604,11990,147
2021-02-04,Calaveras,9,45235,1842,1808,13,1821,21
2021-02-04,Colusa,11,21464,1799,1777,237,2014,10
2021-02-04,Contra Costa,13,1133247,59872,57991,1055,59046,550
2021-02-04,Del Norte,15,27424,888,870,0,870,2
2021-02-04,El Dorado,17,186661,8714,8490,605,9095,86
2021-02-04,Fresno,19,978130,92148,90126,7474,97600,1114
2021-02-04,Glenn,21,27897,2163,2102,474,2576,14
2021-02-04,Humboldt,23,135768,2910,2827,19,2846,28
2021-02-04,Imperial,25,180216,26754,26411,2547,28958,556
2021-02-04,Inyo,27,18085,1144,1084,1,1085,27
2021-02-04,Kern,29,883053,89647,87156,9276,96432,898
2021-02-04,Kings,31,150075,21372,20918,993,21911,187
2021-02-04,Lake,33,64148,2975,2882,1,2883,34
2021-02-04,Lassen,35,31185,5001,4927,91,5018,1
2021-02-04,Los Angeles,37,10098052,1138750,1106323,39515,1145838,17396
2021-02-04,Madera,39,155013,14979,14706,763,15469,95
2021-02-04,Marin,41,260295,12606,12431,153,12584,192
2021-02-04,Mariposa,43,17540,365,348,4,352,4
2021-02-04,Mendocino,45,87422,3426,3240,57,3297,38
2021-02-04,Merced,47,269075,26940,26629,785,27414,345
2021-02-04,Modoc,49,8938,328,309,107,416,3
2021-02-04,Mono,51,14174,1143,1153,14,1167,3
2021-02-04,Monterey,53,433212,40416,39619,1553,41172,279
2021-02-04,Napa,55,140530,8707,8573,32,8605,55
2021-02-04,Nevada,57,99092,3747,3590,150,3740,37
2021-02-04,Orange,59,3164182,239399,235677,10056,245733,3238
2021-02-04,Placer,61,380077,19681,18711,1060,19771,210
2021-02-04,Plumas,63,18699,624,562,11,573,2
2021-02-04,Riverside,65,2383286,275617,269851,13779,283630,3230
2021-02-04,Sacramento,67,1510023,89752,87658,1167,88825,1222
2021-02-04,San Benito,69,59416,5538,5488,82,5570,51
2021-02-04,San Bernardino,71,2135413,279578,272223,8376,280599,2409
2021-02-04,San Diego,73,3302833,253446,242613,0,242613,2738
2021-02-04,San Francisco,75,870044,32635,32116,1001,33117,326
2021-02-04,San Joaquin,77,732212,63921,62374,2714,65088,883
2021-02-04,San Luis Obispo,79,281455,18545,18058,518,18576,211
2021-02-04,San Mateo,81,765935,37854,36437,376,36813,226
2021-02-04,Santa Barbara,83,443738,30536,29344,1106,30450,322
2021-02-04,Santa Clara,85,1922200,104907,103781,515,104296,1404
2021-02-04,Santa Cruz,87,273765,14736,13713,778,14491,156
2021-02-04,Shasta,89,179085,10551,10466,1184,11650,131
2021-02-04,Sierra,91,2930,47,42,14,56,0
2021-02-04,Siskiyou,93,43540,1357,1273,228,1501,4
2021-02-04,Solano,95,438530,28738,28192,337,28529,120
2021-02-04,Sonoma,97,501317,26598,26276,146,26422,249
2021-02-04,Stanislaus,99,539301,47973,46822,5201,52023,678
2021-02-04,Sutter,101,95872,8509,8401,82,8483,92
2021-02-04,Tehama,103,63373,4410,4327,506,4833,21
2021-02-04,Trinity,105,12862,323,260,34,294,3
2021-02-04,Tulare,107,460477,46007,44983,7554,52537,656
2021-02-04,Tuolumne,109,53932,3625,3585,57,3642,45
2021-02-04,Ventura,111,848112,73750,72595,2738,75333,537
2021-02-04,Yolo,113,214977,12349,11982,202,12184,161
2021-02-04,Yuba,115,75493,5236,5135,80,5215,34
2021-02-03,Alameda,1,1643700,76576,74968,1708,76676,880
2021-02-03,Alpine,3,1148,74,72,0,72,0
2021-02-03,Amador,5,37829,3346,3281,29,3310,33
2021-02-03,Butte,7,227075,10800,10355,1597,11952,144
2021-02-03,Calaveras,9,45235,1832,1799,12,1811,21
2021-02-03,Colusa,11,21464,1794,1773,236,2009,10
2021-02-03,Contra Costa,13,1133247,59633,57762,1043,58805,537
2021-02-03,Del Norte,15,27424,883,869,0,869,2
2021-02-03,El Dorado,17,186661,8694,8428,604,9032,86
2021-02-03,Fresno,19,978130,91931,89748,7434,97182,1015
2021-02-03,Glenn,21,27897,2154,2098,472,2570,14
2021-02-03,Humboldt,23,135768,2900,2800,19,2819,27
2021-02-03,Imperial,25,180216,26720,26363,2541,28904,547
2021-02-03,Inyo,27,18085,1134,1071,1,1072,27
2021-02-03,Kern,29,883053,89406,86771,9234,96005,877
2021-02-03,Kings,31,150075,21313,20831,989,21820,172
2021-02-03,Lake,33,64148,2959,2869,1,2870,33
2021-02-03,Lassen,35,31185,4990,4910,91,5001,1
2021-02-03,Los Angeles,37,10098052,1135687,1101890,39382,1141272,17163
2021-02-03,Madera,39,155013,14941,14605,761,15366,94
2021-02-03,Marin,41,260295,12572,12406,153,12559,190
2021-02-03,Mariposa,43,17540,364,347,4,351,4
2021-02-03,Mendocino,45,87422,3400,3236,56,3292,38
2021-02-03,Merced,47,269075,26825,26520,780,27300,343
2021-02-03,Modoc,49,8938,327,308,107,415,3
2021-02-03,Mono,51,14174,1136,1146,14,1160,3
2021-02-03,Monterey,53,433212,40289,39500,1535,41035,279
2021-02-03,Napa,55,140530,8672,8534,32,8566,54
2021-02-03,Nevada,57,99092,3733,3572,150,3722,35
2021-02-03,Orange,59,3164182,238653,234738,10024,244762,3189
2021-02-03,Placer,61,380077,19625,18646,1058,19704,210
2021-02-03,Plumas,63,18699,624,559,11,570,2
2021-02-03,Riverside,65,2383286,274892,269019,13747,282766,3195
2021-02-03,Sacramento,67,1510023,89429,87415,1162,88577,1212
2021-02-03,San Benito,69,59416,5520,5463,79,5542,51
2021-02-03,San Bernardino,71,2135413,279097,271477,8351,279828,2308
2021-02-03,San Diego,73,3302833,252545,241015,0,241015,2683
2021-02-03,San Francisco,75,870044,32506,31983,996,32979,325
2021-02-03,San Joaquin,77,732212,63696,61976,2703,64679,880
2021-02-03,San Luis Obispo,79,281455,18468,17922,515,18437,206
2021-02-03,San Mateo,81,765935,37715,36227,372,36599,225
2021-02-03,Santa Barbara,83,443738,30390,29121,1096,30217,315
2021-02-03,Santa Clara,85,1922200,104592,103278,511,103789,1364
2021-02-03,Santa Cruz,87,273765,14682,13611,770,14381,154
2021-02-03,Shasta,89,179085,10508,10422,1179,11601,130
2021-02-03,Sierra,91,2930,47,42,14,56,0
2021-02-03,Siskiyou,93,43540,1346,1268,227,1495,4
2021-02-03,Solano,95,438530,28616,28057,337,28394,119
2021-02-03,Sonoma,97,501317,26515,26155,145,26300,248
2021-02-03,Stanislaus,99,539301,47799,46598,5181,51779,662
2021-02-03,Sutter,101,95872,8484,8379,82,8461,90
2021-02-03,Tehama,103,63373,4388,4309,503,4812,21
2021-02-03,Trinity,105,12862,323,260,33,293,3
2021-02-03,Tulare,107,460477,45840,44838,7493,52331,640
2021-02-03,Tuolumne,109,53932,3614,3568,57,3625,45
2021-02-03,Ventura,111,848112,73415,72124,2726,74850,526
2021-02-03,Yolo,113,214977,12325,11933,201,12134,161
2021-02-03,Yuba,115,75493,5218,5124,80,5204,34
2021-02-02,Alameda,1,1643700,76229,74642,1694,76336,869
2021-02-02,Alpine,3,1148,74,72,0,72,0
2021-02-02,Amador,5,37829,3315,3275,29,3304,33
2021-02-02,Butte,7,227075,10773,10307,1589,11896,141
2021-02-02,Calaveras,9,45235,1824,1786,12,1798,21
2021-02-02,Colusa,11,21464,1786,1769,231,2000,9
2021-02-02,Contra Costa,13,1133247,59353,57551,1038,58589,536
2021-02-02,Del Norte,15,27424,877,868,0,868,2
2021-02-02,El Dorado,17,186661,8654,8405,604,9009,84
2021-02-02,Fresno,19,978130,91631,89542,7398,96940,1009
2021-02-02,Glenn,21,27897,2143,2090,468,2558,14
2021-02-02,Humboldt,23,135768,2889,2784,19,2803,25
2021-02-02,Imperial,25,180216,26669,26317,2536,28853,535
2021-02-02,Inyo,27,18085,1131,1074,1,1075,27
2021-02-02,Kern,29,883053,89104,86485,9157,95642,867
2021-02-02,Kings,31,150075,21236,20785,980,21765,172
2021-02-02,Lake,33,64148,2939,2857,1,2858,33
2021-02-02,Lassen,35,31185,4983,4908,91,4999,1
2021-02-02,Los Angeles,37,10098052,1132322,1097573,39211,1136784,16913
2021-02-02,Madera,39,155013,14891,14595,756,15351,94
2021-02-02,Marin,41,260295,12543,12367,153,12520,189
2021-02-02,Mariposa,43,17540,361,345,4,349,4
2021-02-02,Mendocino,45,87422,3367,3210,56,3266,38
2021-02-02,Merced,47,269075,26728,26427,772,27199,340
2021-02-02,Modoc,49,8938,322,306,107,413,3
2021-02-02,Mono,51,14174,1134,1147,14,1161,3
2021-02-02,Monterey,53,433212,40153,39371,1521,40892,278
2021-02-02,Napa,55,140530,8643,8505,32,8537,53
2021-02-02,Nevada,57,99092,3718,3548,150,3698,20
2021-02-02,Orange,59,3164182,237855,233783,9987,243770,3152
2021-02-02,Placer,61,380077,19566,18615,1054,19669,205
2021-02-02,Plumas,63,18699,624,560,11,571,2
2021-02-02,Riverside,65,2383286,274059,267901,13708,281609,3169
2021-02-02,Sacramento,67,1510023,89137,87107,1150,88257,1202
2021-02-02,San Benito,69,59416,5507,5444,78,5522,50
2021-02-02,San Bernardino,71,2135413,278426,270486,8316,278802,2244
2021-02-02,San Diego,73,3302833,251508,240047,0,240047,2629
2021-02-02,San Francisco,75,870044,32350,31788,985,32773,324
2021-02-02,San Joaquin,77,732212,63478,61708,2688,64396,878
2021-02-02,San Luis Obispo,79,281455,18374,17811,513,18324,201
2021-02-02,San Mateo,81,765935,37548,36004,366,36370,225
2021-02-02,Santa Barbara,83,443738,30221,28951,1089,30040,304
2021-02-02,Santa Clara,85,1922200,104129,102872,506,103378,1349
2021-02-02,Santa Cruz,87,273765,14623,13572,766,14338,150
2021-02-02,Shasta,89,179085,10483,10371,1167,11538,128
2021-02-02,Sierra,91,2930,47,42,14,56,0
2021-02-02,Siskiyou,93,43540,1339,1252,224,1476,4
2021-02-02,Solano,95,438530,28520,27963,333,28296,118
2021-02-02,Sonoma,97,501317,26398,26054,145,26199,247
2021-02-02,Stanislaus,99,539301,47582,46306,5148,51454,641
2021-02-02,Sutter,101,95872,8461,8340,82,8422,89
2021-02-02,Tehama,103,63373,4375,4289,500,4789,21
2021-02-02,Trinity,105,12862,323,260,33,293,3
2021-02-02,Tulare,107,460477,45686,44720,7425,52145,625
2021-02-02,Tuolumne,109,53932,3602,3548,57,3605,39
2021-02-02,Ventura,111,848112,72996,71557,2716,74273,514
2021-02-02,Yolo,113,214977,12278,11886,194,12080,158
2021-02-02,Yuba,115,75493,5200,5111,80,5191,34
2021-02-01,Alameda,1,1643700,75873,74374,1688,76062,858
2021-02-01,Alpine,3,1148,74,72,0,72,0
2021-02-01,Amador,5,37829,3304,3234,29,3263,32
2021-02-01,Butte,7,227075,10731,10263,1585,11848,141
2021-02-01,Calaveras,9,45235,1805,1785,12,1797,21
2021-02-01,Colusa,11,21464,1781,1763,222,1985,9
2021-02-01,Contra Costa,13,1133247,59108,57324,1037,58361,531
2021-02-01,Del Norte,15,27424,873,865,0,865,2
2021-02-01,El Dorado,17,186661,8615,8337,604,8941,83
2021-02-01,Fresno,19,978130,91302,89272,7359,96631,994
2021-02-01,Glenn,21,27897,2128,2086,460,2546,14
2021-02-01,Humboldt,23,135768,2868,2773,18,2791,25
2021-02-01,Imperial,25,180216,26626,26224,2534,28758,530
2021-02-01,Inyo,27,18085,1121,1072,1,1073,27
2021-02-01,Kern,29,883053,88710,86170,9086,95256,862
2021-02-01,Kings,31,150075,21147,20746,971,21717,172
2021-02-01,Lake,33,64148,2923,2843,1,2844,33
2021-02-01,Lassen,35,31185,4963,4907,91,4998,1
2021-02-01,Los Angeles,37,10098052,1128515,1094341,39033,1133374,16695
2021-02-01,Madera,39,155013,14856,14572,753,15325,94
2021-02-01,Marin,41,260295,12505,12341,152,12493,188
2021-02-01,Mariposa,43,17540,359,344,4,348,4
2021-02-01,Mendocino,45,87422,3334,3192,56,3248,37
2021-02-01,Merced,47,269075,26602,26282,764,27046,337
2021-02-01,Modoc,49,8938,316,303,103,406,1
2021-02-01,Mono,51,14174,1131,1145,14,1159,3
2021-02-01,Monterey,53,433212,39973,39196,1499,40695,278
2021-02-01,Napa,55,140530,8611,8449,32,8481,52
2021-02-01,Nevada,57,99092,3701,3535,149,3684,20
2021-02-01,Orange,59,3164182,236946,233155,9941,243096,3100
2021-02-01,Placer,61,380077,19499,18574,1047,19621,204
2021-02-01,Plumas,63,18699,622,554,11,565,2
2021-02-01,Riverside,65,2383286,273153,267025,13669,280694,3092
2021-02-01,Sacramento,67,1510023,88740,86856,1138,87994,1193
2021-02-01,San Benito,69,59416,5489,5432,78,5510,48
2021-02-01,San Bernardino,71,2135413,277736,270012,8272,278284,2172
2021-02-01,San Diego,73,3302833,250286,239121,0,239121,2619
2021-02-01,San Francisco,75,870044,32218,31703,972,32675,324
2021-02-01,San Joaquin,77,732212,63274,61542,2677,64219,877
2021-02-01,San Luis Obispo,79,281455,18256,17690,505,18195,199
2021-02-01,San Mateo,81,765935,37400,35843,366,36209,220
2021-02-01,Santa Barbara,83,443738,30051,28837,1081,29918,297
2021-02-01,Santa Clara,85,1922200,103714,102462,506,102968,1343
2021-02-01,Santa Cruz,87,273765,14569,13524,764,14288,149
2021-02-01,Shasta,89,179085,10458,10329,1161,11490,112
2021-02-01,Sierra,91,2930,47,42,14,56,0
2021-02-01,Siskiyou,93,43540,1332,1238,221,1459,4
2021-02-01,Solano,95,438530,28415,27844,332,28176,117
2021-02-01,Sonoma,97,501317,26309,26011,144,26155,243
2021-02-01,Stanislaus,99,539301,47324,46112,5120,51232,642
2021-02-01,Sutter,101,95872,8421,8313,82,8395,89
2021-02-01,Tehama,103,63373,4351,4263,500,4763,21
2021-02-01,Trinity,105,12862,321,260,33,293,3
2021-02-01,Tulare,107,460477,45542,44569,7343,51912,618
2021-02-01,Tuolumne,109,53932,3594,3534,57,3591,39
2021-02-01,Ventura,111,848112,72589,71104,2700,73804,502
2021-02-01,Yolo,113,214977,12234,11824,186,12010,151
2021-02-01,Yuba,115,75493,5187,5084,79,5163,33
2021-01-31,Alameda,1,1643700,75444,73979,1679,75658,857
2021-01-31,Alpine,3,1148,74,72,0,72,0
2021-01-31,Amador,5,37829,3294,3212,27,3239,32
2021-01-31,Butte,7,227075,10690,10215,1573,11788,140
2021-01-31,Calaveras,9,45235,1784,1778,12,1790,21
2021-01-31,Colusa,11,21464,1774,1754,217,1971,9
2021-01-31,Contra Costa,13,1133247,58777,57079,1037,58116,531
2021-01-31,Del Norte,15,27424,871,865,0,865,2
2021-01-31,El Dorado,17,186661,8579,8317,601,8918,83
2021-01-31,Fresno,19,978130,90988,88852,7305,96157,994
2021-01-31,Glenn,21,27897,2117,2083,459,2542,14
2021-01-31,Humboldt,23,135768,2852,2767,18,2785,25
2021-01-31,Imperial,25,180216,26555,26206,2525,28731,530
2021-01-31,Inyo,27,18085,1108,1072,1,1073,27
2021-01-31,Kern,29,883053,88216,85872,8997,94869,861
2021-01-31,Kings,31,150075,21065,20709,958,21667,172
2021-01-31,Lake,33,64148,2902,2826,1,2827,33
2021-01-31,Lassen,35,31185,4947,4900,91,4991,1
2021-01-31,Los Angeles,37,10098052,1123916,1090304,38819,1129123,16609
2021-01-31,Madera,39,155013,14802,14496,745,15241,94
2021-01-31,Marin,41,260295,12458,12297,148,12445,185
2021-01-31,Mariposa,43,17540,357,344,4,348,4
2021-01-31,Mendocino,45,87422,3311,3181,55,3236,37
2021-01-31,Merced,47,269075,26459,26222,759,26981,337
2021-01-31,Modoc,49,8938,313,304,101,405,1
2021-01-31,Mono,51,14174,1128,1146,14,1160,3
2021-01-31,Monterey,53,433212,39794,39035,1471,40506,278
2021-01-31,Napa,55,140530,8569,8404,32,8436,52
2021-01-31,Nevada,57,99092,3679,3518,147,3665,20
2021-01-31,Orange,59,3164182,235937,232347,9900,242247,3053
2021-01-31,Placer,61,380077,19425,18506,1035,19541,204
2021-01-31,Plumas,63,18699,621,554,11,565,2
2021-01-31,Riverside,65,2383286,272183,266145,13621,279766,3074
2021-01-31,Sacramento,67,1510023,88299,86560,1123,87683,1186
2021-01-31,San Benito,69,59416,5467,5425,76,5501,48
2021-01-31,San Bernardino,71,2135413,276698,269533,8235,277768,2156
2021-01-31,San Diego,73,3302833,248972,238039,0,238039,2619
2021-01-31,San Francisco,75,870044,32031,31563,960,32523,323
2021-01-31,San Joaquin,77,732212,62870,61379,2667,64046,877
2021-01-31,San Luis Obispo,79,281455,18123,17615,500,18115,199
2021-01-31,San Mateo,81,765935,37209,35659,363,36022,219
2021-01-31,Santa Barbara,83,443738,29812,28570,1072,29642,297
2021-01-31,Santa Clara,85,1922200,103165,101986,496,102482,1330
2021-01-31,Santa Cruz,87,273765,14475,13469,750,14219,149
2021-01-31,Shasta,89,179085,10413,10313,1152,11465,112
2021-01-31,Sierra,91,2930,46,43,14,57,0
2021-01-31,Siskiyou,93,43540,1322,1238,221,1459,4
2021-01-31,Solano,95,438530,28285,27678,332,28010,118
2021-01-31,Sonoma,97,501317,26208,25925,143,26068,243
2021-01-31,Stanislaus,99,539301,47041,45971,5079,51050,642
2021-01-31,Sutter,101,95872,8376,8289,82,8371,89
2021-01-31,Tehama,103,63373,4331,4256,499,4755,21
2021-01-31,Trinity,105,12862,319,260,33,293,3
2021-01-31,Tulare,107,460477,45375,44440,7261,51701,618
2021-01-31,Tuolumne,109,53932,3555,3519,57,3576,39
2021-01-31,Ventura,111,848112,71996,70635,2687,73322,502
2021-01-31,Yolo,113,214977,12173,11771,180,11951,151
2021-01-31,Yuba,115,75493,5167,5071,78,5149,33
2021-01-30,Alameda,1,1643700,75241,73622,1674,75296,850
2021-01-30,Alpine,3,1148,74,72,0,72,0
2021-01-30,Amador,5,37829,3290,3181,27,3208,32
2021-01-30,Butte,7,227075,10655,10177,1564,11741,139
2021-01-30,Calaveras,9,45235,1772,1763,12,1775,21
2021-01-30,Colusa,11,21464,1772,1748,217,1965,9
2021-01-30,Contra Costa,13,1133247,58592,56763,1033,57796,531
2021-01-30,Del Norte,15,27424,870,865,0,865,2
2021-01-30,El Dorado,17,186661,8559,8299,600,8899,83
2021-01-30,Fresno,19,978130,90811,88476,7285,95761,964
2021-01-30,Glenn,21,27897,2114,2074,457,2531,14
2021-01-30,Humboldt,23,135768,2841,2742,18,2760,24
2021-01-30,Imperial,25,180216,26534,26160,2524,28684,530
2021-01-30,Inyo,27,18085,1104,1068,1,1069,27
2021-01-30,Kern,29,883053,88014,85572,8931,94503,848
2021-01-30,Kings,31,150075,20995,20605,952,21557,169
2021-01-30,Lake,33,64148,2896,2809,1,2810,33
2021-01-30,Lassen,35,31185,4944,4890,91,4981,1
2021-01-30,Los Angeles,37,10098052,1121554,1084763,38672,1123435,16484
2021-01-30,Madera,39,155013,14760,14443,740,15183,94
2021-01-30,Marin,41,260295,12430,12225,147,12372,185
2021-01-30,Mariposa,43,17540,355,344,4,348,4
2021-01-30,Mendocino,45,87422,3297,3153,54,3207,36
2021-01-30,Merced,47,269075,26384,26078,758,26836,335
2021-01-30,Modoc,49,8938,313,303,101,404,1
2021-01-30,Mono,51,14174,1128,1143,14,1157,3
2021-01-30,Monterey,53,433212,39733,38847,1468,40315,277
2021-01-30,Napa,55,140530,8553,8342,32,8374,52
2021-01-30,Nevada,57,99092,3660,3499,147,3646,20
2021-01-30,Orange,59,3164182,235394,231358,9860,241218,3013
2021-01-30,Placer,61,380077,19374,18430,1029,19459,205
2021-01-30,Plumas,63,18699,619,554,11,565,2
2021-01-30,Riverside,65,2383286,271593,265137,13588,278725,3061
2021-01-30,Sacramento,67,1510023,88105,86388,1116,87504,1184
2021-01-30,San Benito,69,59416,5449,5401,75,5476,48
2021-01-30,San Bernardino,71,2135413,276286,268660,8216,276876,2122
2021-01-30,San Diego,73,3302833,248214,236765,0,236765,2603
2021-01-30,San Francisco,75,870044,31931,31427,956,32383,316
2021-01-30,San Joaquin,77,732212,62735,61120,2656,63776,864
2021-01-30,San Luis Obispo,79,281455,18045,17522,497,18019,198
2021-01-30,San Mateo,81,765935,37071,35451,362,35813,219
2021-01-30,Santa Barbara,83,443738,29671,28342,1068,29410,296
2021-01-30,Santa Clara,85,1922200,102815,101471,493,101964,1307
2021-01-30,Santa Cruz,87,273765,14435,13383,749,14132,149
2021-01-30,Shasta,89,179085,10395,10283,1148,11431,112
2021-01-30,Sierra,91,2930,46,43,14,57,0
2021-01-30,Siskiyou,93,43540,1320,1236,219,1455,4
2021-01-30,Solano,95,438530,28202,27511,330,27841,118
2021-01-30,Sonoma,97,501317,26158,25810,140,25950,243
2021-01-30,Stanislaus,99,539301,46912,45697,5055,50752,642
2021-01-30,Sutter,101,95872,8360,8226,82,8308,87
2021-01-30,Tehama,103,63373,4317,4229,498,4727,21
2021-01-30,Trinity,105,12862,319,259,33,292,3
2021-01-30,Tulare,107,460477,45241,44203,7223,51426,615
2021-01-30,Tuolumne,109,53932,3551,3508,57,3565,36
2021-01-30,Ventura,111,848112,71685,69931,2670,72601,493
2021-01-30,Yolo,113,214977,12160,11698,178,11876,151
2021-01-30,Yuba,115,75493,5157,5042,77,5119,33
2021-01-29,Alameda,1,1643700,74962,73210,1666,74876,841
2021-01-29,Alpine,3,1148,74,72,0,72,0
2021-01-29,Amador,5,37829,3278,3134,26,3160,32
2021-01-29,Butte,7,227075,10624,10122,1554,11676,138
2021-01-29,Calaveras,9,45235,1768,1757,12,1769,21
2021-01-29,Colusa,11,21464,1768,1734,216,1950,8
2021-01-29,Contra Costa,13,1133247,58418,56318,1031,57349,529
2021-01-29,Del Norte,15,27424,869,865,0,865,2
2021-01-29,El Dorado,17,186661,8542,8231,599,8830,83
2021-01-29,Fresno,19,978130,90600,87936,7246,95182,962
2021-01-29,Glenn,21,27897,2109,2061,456,2517,14
2021-01-29,Humboldt,23,135768,2828,2707,18,2725,24
2021-01-29,Imperial,25,180216,26519,26045,2521,28566,521
2021-01-29,Inyo,27,18085,1092,1048,1,1049,27
2021-01-29,Kern,29,883053,87789,85044,8879,93923,836
2021-01-29,Kings,31,150075,20956,20466,947,21413,169
2021-01-29,Lake,33,64148,2887,2792,1,2793,32
2021-01-29,Lassen,35,31185,4941,4874,91,4965,1
2021-01-29,Los Angeles,37,10098052,1118089,1078329,38515,1116844,16190
2021-01-29,Madera,39,155013,14709,14377,740,15117,94
2021-01-29,Marin,41,260295,12386,12145,146,12291,185
2021-01-29,Mariposa,43,17540,354,342,4,346,4
2021-01-29,Mendocino,45,87422,3288,3131,53,3184,36
2021-01-29,Merced,47,269075,26309,25865,754,26619,334
2021-01-29,Modoc,49,8938,312,297,101,398,1
2021-01-29,Mono,51,14174,1126,1139,14,1153,3
2021-01-29,Monterey,53,433212,39612,38539,1459,39998,277
2021-01-29,Napa,55,140530,8521,8276,32,8308,52
2021-01-29,Nevada,57,99092,3651,3487,146,3633,20
2021-01-29,Orange,59,3164182,234703,229917,9821,239738,2967
2021-01-29,Placer,61,380077,19318,18367,1025,19392,203
2021-01-29,Plumas,63,18699,618,548,11,559,2
2021-01-29,Riverside,65,2383286,270802,263504,13553,277057,3008
2021-01-29,Sacramento,67,1510023,87851,86320,1112,87432,1169
2021-01-29,San Benito,69,59416,5441,5386,75,5461,48
2021-01-29,San Bernardino,71,2135413,275773,267490,8173,275663,2095
2021-01-29,San Diego,73,3302833,247273,234637,0,234637,2571
2021-01-29,San Francisco,75,870044,31791,31294,947,32241,307
2021-01-29,San Joaquin,77,732212,62587,60899,2641,63540,858
2021-01-29,San Luis Obispo,79,281455,17984,17440,492,17932,193
2021-01-29,San Mateo,81,765935,36938,35223,359,35582,218
2021-01-29,Santa Barbara,83,443738,29541,28105,1062,29167,291
2021-01-29,Santa Clara,85,1922200,102448,101010,491,101501,1273
2021-01-29,Santa Cruz,87,273765,14381,13311,746,14057,148
2021-01-29,Shasta,89,179085,10378,10220,1144,11364,112
2021-01-29,Sierra,91,2930,46,43,14,57,0
2021-01-29,Siskiyou,93,43540,1319,1227,219,1446,4
2021-01-29,Solano,95,438530,28116,27352,327,27679,116
2021-01-29,Sonoma,97,501317,26095,25710,139,25849,243
2021-01-29,Stanislaus,99,539301,46763,45466,5035,50501,642
2021-01-29,Sutter,101,95872,8341,8181,82,8263,87
2021-01-29,Tehama,103,63373,4304,4191,496,4687,20
2021-01-29,Trinity,105,12862,319,260,33,293,3
2021-01-29,Tulare,107,460477,45136,43925,7181,51106,606
2021-01-29,Tuolumne,109,53932,3541,3483,57,3540,36
2021-01-29,Ventura,111,848112,71261,69511,2656,72167,484
2021-01-29,Yolo,113,214977,12124,11612,176,11788,151
2021-01-29,Yuba,115,75493,5141,5018,77,5095,32
2021-01-28,Alameda,1,1643700,74525,72758,1658,74416,833
2021-01-28,Alpine,3,1148,74,72,0,72,0
2021-01-28,Amador,5,37829,3241,3124,26,3150,31
2021-01-28,Butte,7,227075,10583,10037,1543,11580,138
2021-01-28,Calaveras,9,45235,1759,1747,11,1758,21
2021-01-28,Colusa,11,21464,1761,1731,212,1943,8
2021-01-28,Contra Costa,13,1133247,58174,55999,1021,57020,525
2021-01-28,Del Norte,15,27424,868,862,0,862,2
2021-01-28,El Dorado,17,186661,8529,8198,594,8792,79
2021-01-28,Fresno,19,978130,90314,87401,7194,94595,949
2021-01-28,Glenn,21,27897,2104,2043,447,2490,14
2021-01-28,Humboldt,23,135768,2811,2686,18,2704,24
2021-01-28,Imperial,25,180216,26475,25984,2514,28498,517
2021-01-28,Inyo,27,18085,1087,1039,1,1040,27
2021-01-28,Kern,29,883053,87461,84708,8791,93499,817
2021-01-28,Kings,31,150075,20897,20328,942,21270,167
2021-01-28,Lake,33,64148,2872,2772,1,2773,32
2021-01-28,Lassen,35,31185,4935,4865,91,4956,1
2021-01-28,Los Angeles,37,10098052,1114206,1072412,38312,1110724,15967
2021-01-28,Madera,39,155013,14653,14301,736,15037,94
2021-01-28,Marin,41,260295,12333,12079,145,12224,183
2021-01-28,Mariposa,43,17540,354,334,4,338,4
2021-01-28,Mendocino,45,87422,3271,3110,53,3163,36
2021-01-28,Merced,47,269075,26185,25620,745,26365,328
2021-01-28,Modoc,49,8938,311,297,101,398,0
2021-01-28,Mono,51,14174,1124,1131,14,1145,3
2021-01-28,Monterey,53,433212,39409,38312,1441,39753,274
2021-01-28,Napa,55,140530,8473,8233,32,8265,50
2021-01-28,Nevada,57,99092,3636,3452,145,3597,19
2021-01-28,Orange,59,3164182,233721,228636,9789,238425,2860
2021-01-28,Placer,61,380077,19249,18246,1022,19268,198
2021-01-28,Plumas,63,18699,617,547,11,558,2
2021-01-28,Riverside,65,2383286,270039,262342,13503,275845,2981
2021-01-28,Sacramento,67,1510023,87485,85698,1101,86799,1149
2021-01-28,San Benito,69,59416,5423,5344,74,5418,47
2021-01-28,San Bernardino,71,2135413,275080,266456,8151,274607,2057
2021-01-28,San Diego,73,3302833,246124,232967,0,232967,2534
2021-01-28,San Francisco,75,870044,31653,31193,931,32124,290
2021-01-28,San Joaquin,77,732212,62323,60627,2625,63252,854
2021-01-28,San Luis Obispo,79,281455,17885,17279,490,17769,189
2021-01-28,San Mateo,81,765935,36769,34931,343,35274,218
2021-01-28,Santa Barbara,83,443738,29322,27674,1049,28723,284
2021-01-28,Santa Clara,85,1922200,101983,100470,488,100958,1219
2021-01-28,Santa Cruz,87,273765,14292,13188,740,13928,145
2021-01-28,Shasta,89,179085,10344,10176,1136,11312,110
2021-01-28,Sierra,91,2930,46,43,14,57,0
2021-01-28,Siskiyou,93,43540,1312,1218,217,1435,4
2021-01-28,Solano,95,438530,27955,27163,326,27489,114
2021-01-28,Sonoma,97,501317,26002,25564,139,25703,236
2021-01-28,Stanislaus,99,539301,46545,45162,5010,50172,640
2021-01-28,Sutter,101,95872,8293,8136,82,8218,85
2021-01-28,Tehama,103,63373,4285,4163,493,4656,20
2021-01-28,Trinity,105,12862,317,260,33,293,3
2021-01-28,Tulare,107,460477,44980,43742,7100,50842,595
2021-01-28,Tuolumne,109,53932,3527,3472,57,3529,32
2021-01-28,Ventura,111,848112,70752,68896,2636,71532,475
2021-01-28,Yolo,113,214977,12082,11500,171,11671,151
2021-01-28,Yuba,115,75493,5125,4994,76,5070,32
2021-01-27,Alameda,1,1643700,74092,72188,1649,73837,815
2021-01-27,Alpine,3,1148,74,72,0,72,0
2021-01-27,Amador,5,37829,3225,3116,26,3142,31
2021-01-27,Butte,7,227075,10544,9988,1531,11519,138
2021-01-27,Calaveras,9,45235,1751,1737,11,1748,21
2021-01-27,Colusa,11,21464,1755,1724,210,1934,8
2021-01-27,Contra Costa,13,1133247,57875,55578,1018,56596,507
2021-01-27,Del Norte,15,27424,867,859,0,859,2
2021-01-27,El Dorado,17,186661,8504,8141,593,8734,76
2021-01-27,Fresno,19,978130,90019,86886,7147,94033,938
2021-01-27,Glenn,21,27897,2101,2042,445,2487,14
2021-01-27,Humboldt,23,135768,2789,2630,18,2648,24
2021-01-27,Imperial,25,180216,26421,25861,2501,28362,504
2021-01-27,Inyo,27,18085,1083,1023,1,1024,27
2021-01-27,Kern,29,883053,87149,84244,8720,92964,809
2021-01-27,Kings,31,150075,20791,20211,934,21145,167
2021-01-27,Lake,33,64148,2852,2750,1,2751,32
2021-01-27,Lassen,35,31185,4929,4851,91,4942,1
2021-01-27,Los Angeles,37,10098052,1109447,1066569,38095,1104664,15757
2021-01-27,Madera,39,155013,14613,14194,731,14925,86
2021-01-27,Marin,41,260295,12296,12028,144,12172,180
2021-01-27,Mariposa,43,17540,354,333,4,337,4
2021-01-27,Mendocino,45,87422,3251,3095,53,3148,36
2021-01-27,Merced,47,269075,26026,25439,734,26173,315
2021-01-27,Modoc,49,8938,311,297,98,395,0
2021-01-27,Mono,51,14174,1122,1131,14,1145,3
2021-01-27,Monterey,53,433212,39207,38139,1422,39561,268
2021-01-27,Napa,55,140530,8402,8187,32,8219,46
2021-01-27,Nevada,57,99092,3615,3431,145,3576,18
2021-01-27,Orange,59,3164182,232602,227110,9734,236844,2832
2021-01-27,Placer,61,380077,19178,18106,1011,19117,198
2021-01-27,Plumas,63,18699,617,544,11,555,2
2021-01-27,Riverside,65,2383286,268868,260796,13450,274246,2931
2021-01-27,Sacramento,67,1510023,87119,85428,1089,86517,1142
2021-01-27,San Benito,69,59416,5408,5284,74,5358,47
2021-01-27,San Bernardino,71,2135413,274231,265153,8118,273271,2019
2021-01-27,San Diego,73,3302833,244795,231478,0,231478,2465
2021-01-27,San Francisco,75,870044,31511,31082,924,32006,287
2021-01-27,San Joaquin,77,732212,62053,60131,2601,62732,853
2021-01-27,San Luis Obispo,79,281455,17778,17119,486,17605,188
2021-01-27,San Mateo,81,765935,36614,34619,339,34958,216
2021-01-27,Santa Barbara,83,443738,29148,27435,1042,28477,282
2021-01-27,Santa Clara,85,1922200,101580,99732,483,100215,1184
2021-01-27,Santa Cruz,87,273765,14222,13111,737,13848,143
2021-01-27,Shasta,89,179085,10310,10106,1130,11236,105
2021-01-27,Sierra,91,2930,46,44,14,58,0
2021-01-27,Siskiyou,93,43540,1306,1214,214,1428,4
2021-01-27,Solano,95,438530,27779,26982,318,27300,112
2021-01-27,Sonoma,97,501317,25904,25361,139,25500,237
2021-01-27,Stanislaus,99,539301,46361,44874,4982,49856,624
2021-01-27,Sutter,101,95872,8250,8093,82,8175,83
2021-01-27,Tehama,103,63373,4260,4133,489,4622,20
2021-01-27,Trinity,105,12862,317,260,33,293,3
2021-01-27,Tulare,107,460477,44795,43462,7025,50487,583
2021-01-27,Tuolumne,109,53932,3517,3464,57,3521,32
2021-01-27,Ventura,111,848112,70279,68291,2611,70902,468
2021-01-27,Yolo,113,214977,12035,11427,167,11594,151
2021-01-27,Yuba,115,75493,5109,4968,76,5044,32
2021-01-26,Alameda,1,1643700,73713,71851,1631,73482,789
2021-01-26,Alpine,3,1148,74,72,0,72,0
2021-01-26,Amador,5,37829,3214,3113,26,3139,31
2021-01-26,Butte,7,227075,10502,9943,1525,11468,136
2021-01-26,Calaveras,9,45235,1740,1723,11,1734,21
2021-01-26,Colusa,11,21464,1748,1719,207,1926,8
2021-01-26,Contra Costa,13,1133247,57595,55337,1010,56347,491
2021-01-26,Del Norte,15,27424,866,856,0,856,2
2021-01-26,El Dorado,17,186661,8478,8115,590,8705,71
2021-01-26,Fresno,19,978130,89665,86673,7102,93775,923
2021-01-26,Glenn,21,27897,2091,2034,441,2475,13
2021-01-26,Humboldt,23,135768,2767,2612,17,2629,24
2021-01-26,Imperial,25,180216,26351,25812,2486,28298,498
2021-01-26,Inyo,27,18085,1076,1018,1,1019,27
2021-01-26,Kern,29,883053,86725,83868,8640,92508,790
2021-01-26,Kings,31,150075,20733,20156,929,21085,159
2021-01-26,Lake,33,64148,2843,2748,1,2749,32
2021-01-26,Lassen,35,31185,4923,4844,91,4935,1
2021-01-26,Los Angeles,37,10098052,1104200,1060492,37877,1098369,15458
2021-01-26,Madera,39,155013,14556,14130,725,14855,86
2021-01-26,Marin,41,260295,12250,11993,141,12134,179
2021-01-26,Mariposa,43,17540,352,332,4,336,3
2021-01-26,Mendocino,45,87422,3225,3076,52,3128,36
2021-01-26,Merced,47,269075,25886,25359,727,26086,309
2021-01-26,Modoc,49,8938,304,291,97,388,0
2021-01-26,Mono,51,14174,1121,1120,14,1134,3
2021-01-26,Monterey,53,433212,39009,37963,1401,39364,255
2021-01-26,Napa,55,140530,8345,8145,32,8177,43
2021-01-26,Nevada,57,99092,3608,3410,144,3554,18
2021-01-26,Orange,59,3164182,231471,225987,9690,235677,2760
2021-01-26,Placer,61,380077,19104,18016,1009,19025,193
2021-01-26,Plumas,63,18699,615,536,11,547,2
2021-01-26,Riverside,65,2383286,267536,259399,13387,272786,2898
2021-01-26,Sacramento,67,1510023,86765,85062,1082,86144,1127
2021-01-26,San Benito,69,59416,5394,5251,73,5324,45
2021-01-26,San Bernardino,71,2135413,273242,263736,8071,271807,1970
2021-01-26,San Diego,73,3302833,243305,230063,0,230063,2421
2021-01-26,San Francisco,75,870044,31380,30874,903,31777,286
2021-01-26,San Joaquin,77,732212,61799,59889,2584,62473,847
2021-01-26,San Luis Obispo,79,281455,17697,17016,483,17499,186
2021-01-26,San Mateo,81,765935,36423,34441,328,34769,213
2021-01-26,Santa Barbara,83,443738,28977,27321,1030,28351,273
2021-01-26,Santa Clara,85,1922200,101104,99215,478,99693,1171
2021-01-26,Santa Cruz,87,273765,14157,13045,731,13776,134
2021-01-26,Shasta,89,179085,10275,10036,1122,11158,103
2021-01-26,Sierra,91,2930,46,43,14,57,0
2021-01-26,Siskiyou,93,43540,1292,1208,212,1420,4
2021-01-26,Solano,95,438530,27623,26858,312,27170,110
2021-01-26,Sonoma,97,501317,25783,25273,137,25410,236
2021-01-26,Stanislaus,99,539301,46178,44703,4939,49642,599
2021-01-26,Sutter,101,95872,8208,8067,82,8149,83
2021-01-26,Tehama,103,63373,4229,4115,489,4604,20
2021-01-26,Trinity,105,12862,317,260,33,293,3
2021-01-26,Tulare,107,460477,44593,43394,6953,50347,579
2021-01-26,Tuolumne,109,53932,3507,3451,57,3508,30
2021-01-26,Ventura,111,848112,69749,67526,2584,70110,448
2021-01-26,Yolo,113,214977,11990,11361,164,11525,148
2021-01-26,Yuba,115,75493,5084,4944,74,5018,31
2021-01-25,Alameda,1,1643700,73271,71255,1621,72876,780
2021-01-25,Alpine,3,1148,74,72,0,72,0
2021-01-25,Amador,5,37829,3174,3074,26,3100,30
2021-01-25,Butte,7,227075,10437,9865,1517,11382,133
2021-01-25,Calaveras,9,45235,1723,1713,11,1724,21
2021-01-25,Colusa,11,21464,1736,1709,203,1912,8
2021-01-25,Contra Costa,13,1133247,57233,54989,1003,55992,488
2021-01-25,Del Norte,15,27424,865,855,0,855,2
2021-01-25,El Dorado,17,186661,8454,8060,590,8650,66
2021-01-25,Fresno,19,978130,89297,86336,7069,93405,913
2021-01-25,Glenn,21,27897,2080,2028,441,2469,13
2021-01-25,Humboldt,23,135768,2733,2587,17,2604,24
2021-01-25,Imperial,25,180216,26301,25745,2477,28222,491
2021-01-25,Inyo,27,18085,1070,1015,1,1016,27
2021-01-25,Kern,29,883053,86336,83401,8547,91948,787
2021-01-25,Kings,31,150075,20613,20067,925,20992,159
2021-01-25,Lake,33,64148,2824,2729,1,2730,32
2021-01-25,Lassen,35,31185,4898,4835,91,4926,1
2021-01-25,Los Angeles,37,10098052,1098279,1055181,37642,1092823,15163
2021-01-25,Madera,39,155013,14502,14068,721,14789,86
2021-01-25,Marin,41,260295,12197,11923,137,12060,177
2021-01-25,Mariposa,43,17540,349,331,4,335,3
2021-01-25,Mendocino,45,87422,3214,3054,52,3106,35
2021-01-25,Merced,47,269075,25747,25181,718,25899,305
2021-01-25,Modoc,49,8938,303,288,93,381,0
2021-01-25,Mono,51,14174,1118,1114,13,1127,3
2021-01-25,Monterey,53,433212,38752,37726,1380,39106,255
2021-01-25,Napa,55,140530,8312,8057,31,8088,43
2021-01-25,Nevada,57,99092,3594,3365,144,3509,18
2021-01-25,Orange,59,3164182,230269,225105,9649,234754,2696
2021-01-25,Placer,61,380077,19011,17936,994,18930,193
2021-01-25,Plumas,63,18699,612,533,11,544,2
2021-01-25,Riverside,65,2383286,265856,258082,13332,271414,2789
2021-01-25,Sacramento,67,1510023,86313,84653,1073,85726,1118
2021-01-25,San Benito,69,59416,5357,5238,72,5310,43
2021-01-25,San Bernardino,71,2135413,272291,263174,8033,271207,1947
2021-01-25,San Diego,73,3302833,241696,228630,0,228630,2375
2021-01-25,San Francisco,75,870044,31232,30734,880,31614,288
2021-01-25,San Joaquin,77,732212,61506,59291,2554,61845,838
2021-01-25,San Luis Obispo,79,281455,17563,16868,478,17346,179
2021-01-25,San Mateo,81,765935,36191,34187,321,34508,213
2021-01-25,Santa Barbara,83,443738,28747,27065,1019,28084,269
2021-01-25,Santa Clara,85,1922200,100533,98647,470,99117,1143
2021-01-25,Santa Cruz,87,273765,14071,12973,725,13698,133
2021-01-25,Shasta,89,179085,10234,9991,1111,11102,103
2021-01-25,Sierra,91,2930,46,42,14,56,0
2021-01-25,Siskiyou,93,43540,1284,1205,209,1414,4
2021-01-25,Solano,95,438530,27454,26648,311,26959,109
2021-01-25,Sonoma,97,501317,25673,25160,135,25295,233
2021-01-25,Stanislaus,99,539301,45935,44293,4895,49188,599
2021-01-25,Sutter,101,95872,8165,8023,82,8105,83
2021-01-25,Tehama,103,63373,4201,4082,485,4567,20
2021-01-25,Trinity,105,12862,317,262,33,295,3
2021-01-25,Tulare,107,460477,44379,43124,6846,49970,578
2021-01-25,Tuolumne,109,53932,3498,3422,57,3479,29
2021-01-25,Ventura,111,848112,69106,66910,2566,69476,439
2021-01-25,Yolo,113,214977,11903,11276,162,11438,140
2021-01-25,Yuba,115,75493,5060,4900,72,4972,31
2021-01-24,Alameda,1,1643700,72764,70823,1609,72432,780
2021-01-24,Alpine,3,1148,74,72,0,72,0
2021-01-24,Amador,5,37829,3141,3054,26,3080,30
2021-01-24,Butte,7,227075,10353,9820,1498,11318,133
2021-01-24,Calaveras,9,45235,1707,1704,11,1715,21
2021-01-24,Colusa,11,21464,1725,1689,197,1886,8
2021-01-24,Contra Costa,13,1133247,56844,54694,990,55684,488
2021-01-24,Del Norte,15,27424,860,855,0,855,2
2021-01-24,El Dorado,17,186661,8419,8003,586,8589,66
2021-01-24,Fresno,19,978130,88860,85808,7029,92837,911
2021-01-24,Glenn,21,27897,2073,2026,439,2465,13
2021-01-24,Humboldt,23,135768,2694,2562,16,2578,24
2021-01-24,Imperial,25,180216,26207,25707,2448,28155,488
2021-01-24,Inyo,27,18085,1054,1007,1,1008,27
2021-01-24,Kern,29,883053,85898,83125,8433,91558,785
2021-01-24,Kings,31,150075,20487,19988,907,20895,159
2021-01-24,Lake,33,64148,2806,2724,0,2724,32
2021-01-24,Lassen,35,31185,4887,4828,88,4916,1
2021-01-24,Los Angeles,37,10098052,1091927,1048757,37321,1086078,15119
2021-01-24,Madera,39,155013,14410,14000,715,14715,86
2021-01-24,Marin,41,260295,12131,11872,135,12007,177
2021-01-24,Mariposa,43,17540,345,322,4,326,3
2021-01-24,Mendocino,45,87422,3193,3037,51,3088,33
2021-01-24,Merced,47,269075,25534,25047,710,25757,305
2021-01-24,Modoc,49,8938,303,285,93,378,0
2021-01-24,Mono,51,14174,1111,1113,13,1126,3
2021-01-24,Monterey,53,433212,38480,37527,1347,38874,254
2021-01-24,Napa,55,140530,8270,8005,31,8036,43
2021-01-24,Nevada,57,99092,3552,3349,142,3491,18
2021-01-24,Orange,59,3164182,228843,223853,9582,233435,2632
2021-01-24,Placer,61,380077,18900,17839,974,18813,193
2021-01-24,Plumas,63,18699,609,532,11,543,2
2021-01-24,Riverside,65,2383286,264259,256767,13251,270018,2761
2021-01-24,Sacramento,67,1510023,85743,84110,1066,85176,1112
2021-01-24,San Benito,69,59416,5315,5223,69,5292,43
2021-01-24,San Bernardino,71,2135413,270972,262370,7976,270346,1935
2021-01-24,San Diego,73,3302833,240006,227193,0,227193,2375
2021-01-24,San Francisco,75,870044,31044,30559,857,31416,275
2021-01-24,San Joaquin,77,732212,61082,59021,2538,61559,838
2021-01-24,San Luis Obispo,79,281455,17441,16758,475,17233,179
2021-01-24,San Mateo,81,765935,35948,33956,316,34272,213
2021-01-24,Santa Barbara,83,443738,28434,26735,1009,27744,269
2021-01-24,Santa Clara,85,1922200,99882,98103,466,98569,1109
2021-01-24,Santa Cruz,87,273765,13986,12905,716,13621,133
2021-01-24,Shasta,89,179085,10164,9978,1102,11080,103
2021-01-24,Sierra,91,2930,45,42,14,56,0
2021-01-24,Siskiyou,93,43540,1277,1195,209,1404,4
2021-01-24,Solano,95,438530,27266,26515,307,26822,109
2021-01-24,Sonoma,97,501317,25483,25045,134,25179,233
2021-01-24,Stanislaus,99,539301,45625,44031,4836,48867,599
2021-01-24,Sutter,101,95872,8097,7980,81,8061,83
2021-01-24,Tehama,103,63373,4161,4062,477,4539,20
2021-01-24,Trinity,105,12862,317,262,33,295,3
2021-01-24,Tulare,107,460477,44167,43006,6747,49753,577
2021-01-24,Tuolumne,109,53932,3488,3416,57,3473,29
2021-01-24,Ventura,111,848112,68392,66347,2541,68888,439
2021-01-24,Yolo,113,214977,11817,11210,158,11368,140
2021-01-24,Yuba,115,75493,5020,4875,71,4946,31
2021-01-23,Alameda,1,1643700,72522,70080,1600,71680,780
2021-01-23,Alpine,3,1148,74,72,0,72,0
2021-01-23,Amador,5,37829,3138,3049,26,3075,30
2021-01-23,Butte,7,227075,10323,9757,1493,11250,133
2021-01-23,Calaveras,9,45235,1701,1695,11,1706,21
2021-01-23,Colusa,11,21464,1721,1672,196,1868,8
2021-01-23,Contra Costa,13,1133247,56633,54162,982,55144,487
2021-01-23,Del Norte,15,27424,859,855,0,855,2
2021-01-23,El Dorado,17,186661,8403,7984,584,8568,66
2021-01-23,Fresno,19,978130,88677,85274,6998,92272,910
2021-01-23,Glenn,21,27897,2070,2015,435,2450,13
2021-01-23,Humboldt,23,135768,2675,2493,15,2508,23
2021-01-23,Imperial,25,180216,26176,25581,2439,28020,487
2021-01-23,Inyo,27,18085,1045,987,1,988,27
2021-01-23,Kern,29,883053,85657,82602,8357,90959,783
2021-01-23,Kings,31,150075,20443,19904,905,20809,159
2021-01-23,Lake,33,64148,2798,2673,0,2673,32
2021-01-23,Lassen,35,31185,4886,4816,85,4901,1
2021-01-23,Los Angeles,37,10098052,1088734,1040961,37152,1078113,15034
2021-01-23,Madera,39,155013,14374,13858,713,14571,86
2021-01-23,Marin,41,260295,12075,11796,133,11929,177
2021-01-23,Mariposa,43,17540,345,323,4,327,3
2021-01-23,Mendocino,45,87422,3179,2991,51,3042,32
2021-01-23,Merced,47,269075,25442,24787,696,25483,303
2021-01-23,Modoc,49,8938,303,285,93,378,0
2021-01-23,Mono,51,14174,1109,1111,13,1124,3
2021-01-23,Monterey,53,433212,38398,37165,1342,38507,253
2021-01-23,Napa,55,140530,8245,7893,31,7924,43
2021-01-23,Nevada,57,99092,3541,3332,141,3473,18
2021-01-23,Orange,59,3164182,228076,221722,9539,231261,2618
2021-01-23,Placer,61,380077,18851,17617,969,18586,193
2021-01-23,Plumas,63,18699,608,528,11,539,2
2021-01-23,Riverside,65,2383286,263386,253636,13195,266831,2733
2021-01-23,Sacramento,67,1510023,85516,83408,1063,84471,1108
2021-01-23,San Benito,69,59416,5291,5166,68,5234,43
2021-01-23,San Bernardino,71,2135413,270426,260381,7942,268323,1922
2021-01-23,San Diego,73,3302833,238948,225556,0,225556,2344
2021-01-23,San Francisco,75,870044,30939,30308,827,31135,268
2021-01-23,San Joaquin,77,732212,60960,58164,2526,60690,836
2021-01-23,San Luis Obispo,79,281455,17378,16652,472,17124,176
2021-01-23,San Mateo,81,765935,35772,33696,305,34001,213
2021-01-23,Santa Barbara,83,443738,28253,26234,1000,27234,264
2021-01-23,Santa Clara,85,1922200,99527,97189,464,97653,1086
2021-01-23,Santa Cruz,87,273765,13928,12771,713,13484,127
2021-01-23,Shasta,89,179085,10134,9951,1101,11052,103
2021-01-23,Sierra,91,2930,45,41,14,55,0
2021-01-23,Siskiyou,93,43540,1267,1190,208,1398,4
2021-01-23,Solano,95,438530,27172,26261,305,26566,107
2021-01-23,Sonoma,97,501317,25407,24790,134,24924,232
2021-01-23,Stanislaus,99,539301,45464,43723,4806,48529,599
2021-01-23,Sutter,101,95872,8079,7943,80,8023,80
2021-01-23,Tehama,103,63373,4142,4006,476,4482,20
2021-01-23,Trinity,105,12862,317,262,33,295,3
2021-01-23,Tulare,107,460477,44020,42661,6681,49342,575
2021-01-23,Tuolumne,109,53932,3481,3407,57,3464,29
2021-01-23,Ventura,111,848112,67946,65581,2516,68097,438
2021-01-23,Yolo,113,214977,11774,11087,154,11241,141
2021-01-23,Yuba,115,75493,5009,4831,69,4900,30
2021-01-22,Alameda,1,1643700,72196,69693,1594,71287,751
2021-01-22,Alpine,3,1148,74,71,0,71,0
2021-01-22,Amador,5,37829,3133,3042,26,3068,30
2021-01-22,Butte,7,227075,10275,9711,1479,11190,133
2021-01-22,Calaveras,9,45235,1692,1672,11,1683,21
2021-01-22,Colusa,11,21464,1719,1668,196,1864,7
2021-01-22,Contra Costa,13,1133247,56393,53887,975,54862,485
2021-01-22,Del Norte,15,27424,858,852,0,852,2
2021-01-22,El Dorado,17,186661,8370,7877,581,8458,64
2021-01-22,Fresno,19,978130,88342,84744,6967,91711,892
2021-01-22,Glenn,21,27897,2066,1985,430,2415,13
2021-01-22,Humboldt,23,135768,2651,2452,15,2467,23
2021-01-22,Imperial,25,180216,26141,25562,2424,27986,474
2021-01-22,Inyo,27,18085,1034,961,1,962,26
2021-01-22,Kern,29,883053,85362,82101,8282,90383,771
2021-01-22,Kings,31,150075,20367,19760,901,20661,159
2021-01-22,Lake,33,64148,2786,2681,0,2681,32
2021-01-22,Lassen,35,31185,4878,4765,84,4849,1
2021-01-22,Los Angeles,37,10098052,1084302,1031177,36951,1068128,14777
2021-01-22,Madera,39,155013,14313,13781,712,14493,86
2021-01-22,Marin,41,260295,12038,11769,131,11900,177
2021-01-22,Mariposa,43,17540,345,323,4,327,3
2021-01-22,Mendocino,45,87422,3154,2994,50,3044,32
2021-01-22,Merced,47,269075,25319,24616,688,25304,290
2021-01-22,Modoc,49,8938,303,285,93,378,0
2021-01-22,Mono,51,14174,1109,1108,13,1121,3
2021-01-22,Monterey,53,433212,38244,36909,1336,38245,253
2021-01-22,Napa,55,140530,8199,7828,31,7859,40
2021-01-22,Nevada,57,99092,3516,3296,140,3436,18
2021-01-22,Orange,59,3164182,227129,220384,9490,229874,2542
2021-01-22,Placer,61,380077,18797,17636,954,18590,193
2021-01-22,Plumas,63,18699,606,522,11,533,2
2021-01-22,Riverside,65,2383286,262262,252440,13126,265566,2710
2021-01-22,Sacramento,67,1510023,85186,82861,1055,83916,1094
2021-01-22,San Benito,69,59416,5266,5143,68,5211,43
2021-01-22,San Bernardino,71,2135413,269602,259121,7907,267028,1849
2021-01-22,San Diego,73,3302833,237709,222576,0,222576,2301
2021-01-22,San Francisco,75,870044,30828,30027,806,30833,266
2021-01-22,San Joaquin,77,732212,60778,58485,2513,60998,812
2021-01-22,San Luis Obispo,79,281455,17289,16336,469,16805,172
2021-01-22,San Mateo,81,765935,35549,33401,302,33703,211
2021-01-22,Santa Barbara,83,443738,28053,25989,989,26978,256
2021-01-22,Santa Clara,85,1922200,99086,96435,461,96896,1062
2021-01-22,Santa Cruz,87,273765,13871,12687,708,13395,123
2021-01-22,Shasta,89,179085,10115,9866,1099,10965,103
2021-01-22,Sierra,91,2930,45,40,14,54,0
2021-01-22,Siskiyou,93,43540,1263,1182,206,1388,4
2021-01-22,Solano,95,438530,27083,26048,303,26351,107
2021-01-22,Sonoma,97,501317,25328,24659,134,24793,232
2021-01-22,Stanislaus,99,539301,45310,43489,4768,48257,599
2021-01-22,Sutter,101,95872,8053,7878,80,7958,80
2021-01-22,Tehama,103,63373,4123,3993,475,4468,19
2021-01-22,Trinity,105,12862,316,263,33,296,3
2021-01-22,Tulare,107,460477,43843,42307,6608,48915,573
2021-01-22,Tuolumne,109,53932,3452,3379,57,3436,29
2021-01-22,Ventura,111,848112,67439,64404,2499,66903,426
2021-01-22,Yolo,113,214977,11741,11014,146,11160,141
2021-01-22,Yuba,115,75493,4985,4789,67,4856,29
2021-01-21,Alameda,1,1643700,71754,69314,1577,70891,739
2021-01-21,Alpine,3,1148,74,71,0,71,0
2021-01-21,Amador,5,37829,3111,3038,26,3064,29
2021-01-21,Butte,7,227075,10204,9643,1472,11115,130
2021-01-21,Calaveras,9,45235,1685,1647,11,1658,21
2021-01-21,Colusa,11,21464,1712,1662,193,1855,7
2021-01-21,Contra Costa,13,1133247,55978,53595,961,54556,478
2021-01-21,Del Norte,15,27424,856,850,0,850,2
2021-01-21,El Dorado,17,186661,8321,7823,578,8401,58
2021-01-21,Fresno,19,978130,87939,84137,6926,91063,889
2021-01-21,Glenn,21,27897,2057,1964,426,2390,13
2021-01-21,Humboldt,23,135768,2628,2423,15,2438,23
2021-01-21,Imperial,25,180216,26050,25509,2406,27915,463
2021-01-21,Inyo,27,18085,1025,946,1,947,26
2021-01-21,Kern,29,883053,84952,81328,8161,89489,769
2021-01-21,Kings,31,150075,20297,19633,882,20515,158
2021-01-21,Lake,33,64148,2770,2669,0,2669,32
2021-01-21,Lassen,35,31185,4872,4763,84,4847,1
2021-01-21,Los Angeles,37,10098052,1077673,1023055,36611,1059666,14537
2021-01-21,Madera,39,155013,14247,13664,704,14368,86
2021-01-21,Marin,41,260295,11981,11732,129,11861,173
2021-01-21,Mariposa,43,17540,341,322,4,326,3
2021-01-21,Mendocino,45,87422,3131,2967,48,3015,32
2021-01-21,Merced,47,269075,25165,24426,682,25108,245
2021-01-21,Modoc,49,8938,300,284,92,376,0
2021-01-21,Mono,51,14174,1104,1104,13,1117,3
2021-01-21,Monterey,53,433212,37964,36149,1325,37474,253
2021-01-21,Napa,55,140530,8135,7774,31,7805,40
2021-01-21,Nevada,57,99092,3487,3274,139,3413,18
2021-01-21,Orange,59,3164182,225753,218867,9431,228298,2540
2021-01-21,Placer,61,380077,18713,17553,950,18503,190
2021-01-21,Plumas,63,18699,602,518,11,529,2
2021-01-21,Riverside,65,2383286,260549,251007,13043,264050,2676
2021-01-21,Sacramento,67,1510023,84707,82303,1035,83338,1084
2021-01-21,San Benito,69,59416,5233,5100,62,5162,43
2021-01-21,San Bernardino,71,2135413,268257,257754,7838,265592,1832
2021-01-21,San Diego,73,3302833,235936,219729,0,219729,2222
2021-01-21,San Francisco,75,870044,30651,29801,772,30573,266
2021-01-21,San Joaquin,77,732212,60470,58270,2492,60762,806
2021-01-21,San Luis Obispo,79,281455,17203,16153,461,16614,169
2021-01-21,San Mateo,81,765935,35305,33156,288,33444,210
2021-01-21,Santa Barbara,83,443738,27770,25654,975,26629,253
2021-01-21,Santa Clara,85,1922200,98465,96028,453,96481,1062
2021-01-21,Santa Cruz,87,273765,13787,12548,698,13246,119
2021-01-21,Shasta,89,179085,10073,9795,1081,10876,98
2021-01-21,Sierra,91,2930,45,40,14,54,0
2021-01-21,Siskiyou,93,43540,1260,1178,202,1380,4
2021-01-21,Solano,95,438530,26902,25885,299,26184,106
2021-01-21,Sonoma,97,501317,25186,24440,132,24572,230
2021-01-21,Stanislaus,99,539301,45008,43223,4722,47945,599
2021-01-21,Sutter,101,95872,8019,7822,80,7902,80
2021-01-21,Tehama,103,63373,4087,3938,475,4413,19
2021-01-21,Trinity,105,12862,316,261,33,294,3
2021-01-21,Tulare,107,460477,43638,42082,6526,48608,569
2021-01-21,Tuolumne,109,53932,3442,3365,57,3422,29
2021-01-21,Ventura,111,848112,66749,63995,2477,66472,420
2021-01-21,Yolo,113,214977,11649,10940,138,11078,141
2021-01-21,Yuba,115,75493,4953,4757,66,4823,29
2021-01-20,Alameda,1,1643700,71236,68785,1562,70347,702
2021-01-20,Alpine,3,1148,74,71,0,71,0
2021-01-20,Amador,5,37829,3080,3036,26,3062,29
2021-01-20,Butte,7,227075,10147,9582,1461,11043,130
2021-01-20,Calaveras,9,45235,1663,1637,10,1647,21
2021-01-20,Colusa,11,21464,1696,1630,188,1818,7
2021-01-20,Contra Costa,13,1133247,55524,53108,955,54063,461
2021-01-20,Del Norte,15,27424,855,848,0,848,2
2021-01-20,El Dorado,17,186661,8275,7785,574,8359,53
2021-01-20,Fresno,19,978130,87518,83591,6870,90461,872
2021-01-20,Glenn,21,27897,2039,1955,423,2378,13
2021-01-20,Humboldt,23,135768,2586,2390,15,2405,22
2021-01-20,Imperial,25,180216,25982,25380,2370,27750,461
2021-01-20,Inyo,27,18085,1015,901,1,902,26
2021-01-20,Kern,29,883053,84503,80701,8055,88756,754
2021-01-20,Kings,31,150075,20208,19522,873,20395,146
2021-01-20,Lake,33,64148,2747,2646,0,2646,31
2021-01-20,Lassen,35,31185,4864,4758,82,4840,1
2021-01-20,Los Angeles,37,10098052,1070206,1015608,36316,1051924,14299
2021-01-20,Madera,39,155013,14182,13585,699,14284,86
2021-01-20,Marin,41,260295,11928,11684,127,11811,171
2021-01-20,Mariposa,43,17540,339,322,4,326,3
2021-01-20,Mendocino,45,87422,3116,2957,48,3005,32
2021-01-20,Merced,47,269075,24991,24220,661,24881,243
2021-01-20,Modoc,49,8938,299,282,92,374,0
2021-01-20,Mono,51,14174,1097,1105,12,1117,3
2021-01-20,Monterey,53,433212,37648,35960,1302,37262,249
2021-01-20,Napa,55,140530,8066,7731,30,7761,40
2021-01-20,Nevada,57,99092,3455,3238,139,3377,18
2021-01-20,Orange,59,3164182,224214,216893,9365,226258,2500
2021-01-20,Placer,61,380077,18610,17455,931,18386,186
2021-01-20,Plumas,63,18699,600,512,11,523,2
2021-01-20,Riverside,65,2383286,258542,248686,12955,261641,2615
2021-01-20,Sacramento,67,1510023,84142,81687,1023,82710,1072
2021-01-20,San Benito,69,59416,5203,5036,61,5097,35
2021-01-20,San Bernardino,71,2135413,266895,255921,7783,263704,1801
2021-01-20,San Diego,73,3302833,234083,218553,0,218553,2174
2021-01-20,San Francisco,75,870044,30455,29665,752,30417,262
2021-01-20,San Joaquin,77,732212,60067,58025,2483,60508,783
2021-01-20,San Luis Obispo,79,281455,17021,15936,452,16388,164
2021-01-20,San Mateo,81,765935,35081,32929,287,33216,210
2021-01-20,Santa Barbara,83,443738,27457,25312,962,26274,248
2021-01-20,Santa Clara,85,1922200,97785,94995,451,95446,1040
2021-01-20,Santa Cruz,87,273765,13681,12460,684,13144,107
2021-01-20,Shasta,89,179085,10021,9697,1070,10767,98
2021-01-20,Sierra,91,2930,45,40,14,54,0
2021-01-20,Siskiyou,93,43540,1254,1163,201,1364,4
2021-01-20,Solano,95,438530,26708,25659,295,25954,106
2021-01-20,Sonoma,97,501317,25039,24262,130,24392,223
2021-01-20,Stanislaus,99,539301,44719,42955,4674,47629,585
2021-01-20,Sutter,101,95872,7968,7772,78,7850,80
2021-01-20,Tehama,103,63373,4062,3892,474,4366,19
2021-01-20,Trinity,105,12862,316,260,33,293,3
2021-01-20,Tulare,107,460477,43388,41799,6426,48225,559
2021-01-20,Tuolumne,109,53932,3428,3355,56,3411,29
2021-01-20,Ventura,111,848112,65794,63413,2444,65857,395
2021-01-20,Yolo,113,214977,11577,10852,135,10987,141
2021-01-20,Yuba,115,75493,4926,4729,66,4795,29
2021-01-19,Alameda,1,1643700,70569,68434,1552,69986,680
2021-01-19,Alpine,3,1148,74,71,0,71,0
2021-01-19,Amador,5,37829,3071,3024,26,3050,28
2021-01-19,Butte,7,227075,10082,9528,1447,10975,129
2021-01-19,Calaveras,9,45235,1648,1621,9,1630,21
2021-01-19,Colusa,11,21464,1674,1617,180,1797,7
2021-01-19,Contra Costa,13,1133247,55026,52730,944,53674,448
2021-01-19,Del Norte,15,27424,854,843,0,843,2
2021-01-19,El Dorado,17,186661,8214,7743,566,8309,47
2021-01-19,Fresno,19,978130,87003,83200,6818,90018,857
2021-01-19,Glenn,21,27897,2028,1948,417,2365,13
2021-01-19,Humboldt,23,135768,2562,2359,12,2371,22
2021-01-19,Imperial,25,180216,25903,25333,2353,27686,452
2021-01-19,Inyo,27,18085,1008,891,1,892,26
2021-01-19,Kern,29,883053,83918,80272,7947,88219,742
2021-01-19,Kings,31,150075,20069,19375,861,20236,143
2021-01-19,Lake,33,64148,2733,2625,0,2625,31
2021-01-19,Lassen,35,31185,4857,4753,82,4835,1
2021-01-19,Los Angeles,37,10098052,1061563,1010375,36029,1046404,14014
2021-01-19,Madera,39,155013,14065,13528,692,14220,86
2021-01-19,Marin,41,260295,11870,11654,123,11777,169
2021-01-19,Mariposa,43,17540,339,322,4,326,3
2021-01-19,Mendocino,45,87422,3099,2930,48,2978,32
2021-01-19,Merced,47,269075,24777,24108,655,24763,242
2021-01-19,Modoc,49,8938,298,281,92,373,0
2021-01-19,Mono,51,14174,1096,1106,12,1118,3
2021-01-19,Monterey,53,433212,37322,35840,1278,37118,248
2021-01-19,Napa,55,140530,8007,7672,30,7702,38
2021-01-19,Nevada,57,99092,3437,3216,137,3353,18
2021-01-19,Orange,59,3164182,222463,215244,9296,224540,2468
2021-01-19,Placer,61,380077,18510,17348,921,18269,182
2021-01-19,Plumas,63,18699,593,509,11,520,2
2021-01-19,Riverside,65,2383286,256484,246248,12869,259117,2585
2021-01-19,Sacramento,67,1510023,83610,81183,1003,82186,1053
2021-01-19,San Benito,69,59416,5157,4988,60,5048,35
2021-01-19,San Bernardino,71,2135413,265130,253651,7717,261368,1777
2021-01-19,San Diego,73,3302833,231664,216833,0,216833,2109
2021-01-19,San Francisco,75,870044,30239,29502,720,30222,261
2021-01-19,San Joaquin,77,732212,59685,57655,2468,60123,782
2021-01-19,San Luis Obispo,79,281455,16757,15855,449,16304,161
2021-01-19,San Mateo,81,765935,34796,32730,275,33005,208
2021-01-19,Santa Barbara,83,443738,27077,24991,943,25934,236
2021-01-19,Santa Clara,85,1922200,97001,94483,449,94932,1010
2021-01-19,Santa Cruz,87,273765,13566,12410,674,13084,106
2021-01-19,Shasta,89,179085,9985,9614,1058,10672,93
2021-01-19,Sierra,91,2930,45,40,12,52,0
2021-01-19,Siskiyou,93,43540,1246,1149,200,1349,4
2021-01-19,Solano,95,438530,26461,25520,295,25815,106
2021-01-19,Sonoma,97,501317,24861,24133,128,24261,223
2021-01-19,Stanislaus,99,539301,44369,42723,4618,47341,561
2021-01-19,Sutter,101,95872,7917,7709,72,7781,80
2021-01-19,Tehama,103,63373,4028,3876,472,4348,19
2021-01-19,Trinity,105,12862,315,260,33,293,3
2021-01-19,Tulare,107,460477,43116,41559,6323,47882,549
2021-01-19,Tuolumne,109,53932,3401,3328,56,3384,29
2021-01-19,Ventura,111,848112,65118,62656,2414,65070,383
2021-01-19,Yolo,113,214977,11497,10789,135,10924,134
2021-01-19,Yuba,115,75493,4892,4695,65,4760,29
2021-01-18,Alameda,1,1643700,69888,67938,1535,69473,680
2021-01-18,Alpine,3,1148,74,71,0,71,0
2021-01-18,Amador,5,37829,3057,3016,26,3042,28
2021-01-18,Butte,7,227075,9995,9474,1434,10908,129
2021-01-18,Calaveras,9,45235,1630,1617,8,1625,21
2021-01-18,Colusa,11,21464,1657,1608,175,1783,7
2021-01-18,Contra Costa,13,1133247,54506,52323,936,53259,448
2021-01-18,Del Norte,15,27424,853,840,0,840,2
2021-01-18,El Dorado,17,186661,8145,7707,564,8271,47
2021-01-18,Fresno,19,978130,86394,82485,6747,89232,857
2021-01-18,Glenn,21,27897,2011,1935,413,2348,13
2021-01-18,Humboldt,23,135768,2525,2343,12,2355,22
2021-01-18,Imperial,25,180216,25836,25317,2325,27642,452
2021-01-18,Inyo,27,18085,996,872,1,873,26
2021-01-18,Kern,29,883053,83280,79930,7853,87783,740
2021-01-18,Kings,31,150075,19901,19267,848,20115,141
2021-01-18,Lake,33,64148,2716,2591,0,2591,30
2021-01-18,Lassen,35,31185,4821,4749,81,4830,1
2021-01-18,Los Angeles,37,10098052,1052084,1002614,35728,1038342,13828
2021-01-18,Madera,39,155013,13951,13443,684,14127,85
2021-01-18,Marin,41,260295,11820,11607,121,11728,165
2021-01-18,Mariposa,43,17540,336,320,3,323,3
2021-01-18,Mendocino,45,87422,3076,2919,48,2967,31
2021-01-18,Merced,47,269075,24532,23927,638,24565,242
2021-01-18,Modoc,49,8938,295,281,89,370,0
2021-01-18,Mono,51,14174,1093,1101,12,1113,3
2021-01-18,Monterey,53,433212,36849,35549,1260,36809,247
2021-01-18,Napa,55,140530,7933,7601,30,7631,38
2021-01-18,Nevada,57,99092,3399,3199,136,3335,17
2021-01-18,Orange,59,3164182,220536,213866,9234,223100,2405
2021-01-18,Placer,61,380077,18393,17263,911,18174,182
2021-01-18,Plumas,63,18699,589,506,11,517,2
2021-01-18,Riverside,65,2383286,254208,244151,12776,256927,2568
2021-01-18,Sacramento,67,1510023,82933,80546,986,81532,1046
2021-01-18,San Benito,69,59416,5106,4963,58,5021,35
2021-01-18,San Bernardino,71,2135413,263336,252808,7656,260464,1775
2021-01-18,San Diego,73,3302833,229022,214335,0,214335,2103
2021-01-18,San Francisco,75,870044,30033,29321,696,30017,259
2021-01-18,San Joaquin,77,732212,59162,57405,2445,59850,782
2021-01-18,San Luis Obispo,79,281455,16570,15742,439,16181,158
2021-01-18,San Mateo,81,765935,34485,32515,255,32770,208
2021-01-18,Santa Barbara,83,443738,26704,24638,929,25567,235
2021-01-18,Santa Clara,85,1922200,96101,93688,445,94133,992
2021-01-18,Santa Cruz,87,273765,13434,12298,661,12959,106
2021-01-18,Shasta,89,179085,9947,9600,1046,10646,92
2021-01-18,Sierra,91,2930,44,40,12,52,0
2021-01-18,Siskiyou,93,43540,1234,1144,198,1342,4
2021-01-18,Solano,95,438530,26176,25344,290,25634,105
2021-01-18,Sonoma,97,501317,24586,24068,127,24195,223
2021-01-18,Stanislaus,99,539301,44012,42413,4568,46981,562
2021-01-18,Sutter,101,95872,7860,7680,69,7749,78
2021-01-18,Tehama,103,63373,3981,3854,465,4319,19
2021-01-18,Trinity,105,12862,315,260,33,293,3
2021-01-18,Tulare,107,460477,42831,41196,6204,47400,549
2021-01-18,Tuolumne,109,53932,3378,3318,55,3373,28
2021-01-18,Ventura,111,848112,64690,61859,2393,64252,379
2021-01-18,Yolo,113,214977,11364,10620,132,10752,134
2021-01-18,Yuba,115,75493,4864,4671,63,4734,29
2021-01-17,Alameda,1,1643700,69313,67375,1515,68890,676
2021-01-17,Alpine,3,1148,74,71,0,71,0
2021-01-17,Amador,5,37829,3050,3001,26,3027,28
2021-01-17,Butte,7,227075,9923,9411,1412,10823,129
2021-01-17,Calaveras,9,45235,1618,1608,8,1616,21
2021-01-17,Colusa,11,21464,1644,1588,169,1757,7
2021-01-17,Contra Costa,13,1133247,54012,51932,929,52861,447
2021-01-17,Del Norte,15,27424,853,838,0,838,2
2021-01-17,El Dorado,17,186661,8089,7659,551,8210,47
2021-01-17,Fresno,19,978130,85840,82039,6670,88709,857
2021-01-17,Glenn,21,27897,1999,1924,408,2332,9
2021-01-17,Humboldt,23,135768,2487,2322,10,2332,22
2021-01-17,Imperial,25,180216,25764,25253,2280,27533,451
2021-01-17,Inyo,27,18085,990,864,1,865,26
2021-01-17,Kern,29,883053,82732,79489,7767,87256,738
2021-01-17,Kings,31,150075,19765,19201,834,20035,131
2021-01-17,Lake,33,64148,2698,2572,0,2572,30
2021-01-17,Lassen,35,31185,4813,4740,80,4820,1
2021-01-17,Los Angeles,37,10098052,1045487,993028,35298,1028326,13741
2021-01-17,Madera,39,155013,13859,13328,678,14006,85
2021-01-17,Marin,41,260295,11768,11552,119,11671,164
2021-01-17,Mariposa,43,17540,336,319,3,322,3
2021-01-17,Mendocino,45,87422,3048,2912,47,2959,31
2021-01-17,Merced,47,269075,24318,23800,624,24424,242
2021-01-17,Modoc,49,8938,294,279,89,368,0
2021-01-17,Mono,51,14174,1087,1091,11,1102,3
2021-01-17,Monterey,53,433212,36617,35340,1235,36575,244
2021-01-17,Napa,55,140530,7877,7521,30,7551,38
2021-01-17,Nevada,57,99092,3374,3176,134,3310,17
2021-01-17,Orange,59,3164182,218523,212389,9154,221543,2359
2021-01-17,Placer,61,380077,18273,17194,895,18089,181
2021-01-17,Plumas,63,18699,588,505,10,515,2
2021-01-17,Riverside,65,2383286,252122,242206,12650,254856,2534
2021-01-17,Sacramento,67,1510023,82339,80154,972,81126,1045
2021-01-17,San Benito,69,59416,5068,4941,58,4999,35
2021-01-17,San Bernardino,71,2135413,261203,251487,7565,259052,1775
2021-01-17,San Diego,73,3302833,226829,211785,0,211785,2103
2021-01-17,San Francisco,75,870044,29845,29139,656,29795,255
2021-01-17,San Joaquin,77,732212,58794,57094,2429,59523,780
2021-01-17,San Luis Obispo,79,281455,16448,15658,430,16088,157
2021-01-17,San Mateo,81,765935,34233,32186,230,32416,208
2021-01-17,Santa Barbara,83,443738,26257,24401,913,25314,235
2021-01-17,Santa Clara,85,1922200,95341,92752,443,93195,976
2021-01-17,Santa Cruz,87,273765,13322,12196,658,12854,106
2021-01-17,Shasta,89,179085,9890,9588,1038,10626,92
2021-01-17,Sierra,91,2930,44,38,11,49,0
2021-01-17,Siskiyou,93,43540,1227,1136,195,1331,4
2021-01-17,Solano,95,438530,25945,25216,288,25504,105
2021-01-17,Sonoma,97,501317,24412,23871,127,23998,223
2021-01-17,Stanislaus,99,539301,43695,42221,4516,46737,562
2021-01-17,Sutter,101,95872,7797,7604,67,7671,77
2021-01-17,Tehama,103,63373,3952,3837,460,4297,18
2021-01-17,Trinity,105,12862,315,261,33,294,3
2021-01-17,Tulare,107,460477,42547,41016,6074,47090,549
2021-01-17,Tuolumne,109,53932,3361,3287,55,3342,27
2021-01-17,Ventura,111,848112,63850,61257,2345,63602,376
2021-01-17,Yolo,113,214977,11263,10519,131,10650,134
2021-01-17,Yuba,115,75493,4813,4640,61,4701,28
2021-01-16,Alameda,1,1643700,69006,66583,1501,68084,673
2021-01-16,Alpine,3,1148,74,71,0,71,0
2021-01-16,Amador,5,37829,3047,2986,26,3012,28
2021-01-16,Butte,7,227075,9893,9359,1392,10751,129
2021-01-16,Calaveras,9,45235,1607,1596,8,1604,21
2021-01-16,Colusa,11,21464,1632,1578,169,1747,7
2021-01-16,Contra Costa,13,1133247,53755,51363,920,52283,443
2021-01-16,Del Norte,15,27424,848,833,0,833,2
2021-01-16,El Dorado,17,186661,8067,7575,550,8125,47
2021-01-16,Fresno,19,978130,85569,81294,6616,87910,846
2021-01-16,Glenn,21,27897,1995,1894,404,2298,9
2021-01-16,Humboldt,23,135768,2467,2294,8,2302,22
2021-01-16,Imperial,25,180216,25731,25140,2273,27413,451
2021-01-16,Inyo,27,18085,986,845,1,846,25
2021-01-16,Kern,29,883053,82369,78865,7711,86576,733
2021-01-16,Kings,31,150075,19709,19072,831,19903,131
2021-01-16,Lake,33,64148,2689,2504,0,2504,30
2021-01-16,Lassen,35,31185,4803,4719,80,4799,1
2021-01-16,Los Angeles,37,10098052,1041422,982684,35048,1017732,13654
2021-01-16,Madera,39,155013,13795,13193,674,13867,85
2021-01-16,Marin,41,260295,11724,11482,119,11601,164
2021-01-16,Mariposa,43,17540,335,317,3,320,3
2021-01-16,Mendocino,45,87422,3034,2890,45,2935,31
2021-01-16,Merced,47,269075,24229,23478,612,24090,242
2021-01-16,Modoc,49,8938,294,278,89,367,0
2021-01-16,Mono,51,14174,1086,1079,11,1090,3
2021-01-16,Monterey,53,433212,36520,34972,1217,36189,243
2021-01-16,Napa,55,140530,7838,7356,30,7386,39
2021-01-16,Nevada,57,99092,3341,3144,134,3278,17
2021-01-16,Orange,59,3164182,217488,210111,9095,219206,2312
2021-01-16,Placer,61,380077,18214,16995,893,17888,177
2021-01-16,Plumas,63,18699,586,502,10,512,2
2021-01-16,Riverside,65,2383286,250772,239412,12528,251940,2506
2021-01-16,Sacramento,67,1510023,81967,79122,954,80076,1033
2021-01-16,San Benito,69,59416,5032,4875,58,4933,35
2021-01-16,San Bernardino,71,2135413,260440,249401,7499,256900,1755
2021-01-16,San Diego,73,3302833,225533,209895,0,209895,2065
2021-01-16,San Francisco,75,870044,29718,28853,624,29477,244
2021-01-16,San Joaquin,77,732212,58554,56642,2396,59038,776
2021-01-16,San Luis Obispo,79,281455,16349,15466,428,15894,152
2021-01-16,San Mateo,81,765935,34065,31805,224,32029,208
2021-01-16,Santa Barbara,83,443738,26063,24088,905,24993,229
2021-01-16,Santa Clara,85,1922200,94880,91584,436,92020,954
2021-01-16,Santa Cruz,87,273765,13263,12026,656,12682,106
2021-01-16,Shasta,89,179085,9857,9547,1034,10581,92
2021-01-16,Sierra,91,2930,43,38,11,49,0
2021-01-16,Siskiyou,93,43540,1223,1124,195,1319,4
2021-01-16,Solano,95,438530,25840,24732,281,25013,103
2021-01-16,Sonoma,97,501317,24328,23607,126,23733,223
2021-01-16,Stanislaus,99,539301,43506,41809,4466,46275,562
2021-01-16,Sutter,101,95872,7765,7560,67,7627,76
2021-01-16,Tehama,103,63373,3939,3783,460,4243,18
2021-01-16,Trinity,105,12862,315,261,33,294,3
2021-01-16,Tulare,107,460477,42361,40655,5998,46653,542
2021-01-16,Tuolumne,109,53932,3354,3269,55,3324,27
2021-01-16,Ventura,111,848112,63297,60368,2315,62683,369
2021-01-16,Yolo,113,214977,11213,10406,130,10536,134
2021-01-16,Yuba,115,75493,4782,4602,61,4663,27
2021-01-15,Alameda,1,1643700,68583,65416,1490,66906,672
2021-01-15,Alpine,3,1148,74,71,0,71,0
2021-01-15,Amador,5,37829,3040,2953,26,2979,28
2021-01-15,Butte,7,227075,9855,9233,1374,10607,129
2021-01-15,Calaveras,9,45235,1600,1538,8,1546,21
2021-01-15,Colusa,11,21464,1621,1541,165,1706,7
2021-01-15,Contra Costa,13,1133247,53430,50408,913,51321,428
2021-01-15,Del Norte,15,27424,844,828,0,828,2
2021-01-15,El Dorado,17,186661,8019,7439,541,7980,47
2021-01-15,Fresno,19,978130,85031,79950,6582,86532,832
2021-01-15,Glenn,21,27897,1990,1824,402,2226,9
2021-01-15,Humboldt,23,135768,2440,2218,7,2225,22
2021-01-15,Imperial,25,180216,25697,24944,2269,27213,446
2021-01-15,Inyo,27,18085,968,814,1,815,25
2021-01-15,Kern,29,883053,81960,77873,7645,85518,719
2021-01-15,Kings,31,150075,19602,18661,823,19484,131
2021-01-15,Lake,33,64148,2661,2434,0,2434,28
2021-01-15,Lassen,35,31185,4792,4693,78,4771,1
2021-01-15,Los Angeles,37,10098052,1034403,968979,34745,1003724,13404
2021-01-15,Madera,39,155013,13706,12883,671,13554,85
2021-01-15,Marin,41,260295,11674,11310,119,11429,160
2021-01-15,Mariposa,43,17540,333,307,3,310,3
2021-01-15,Mendocino,45,87422,3023,2835,45,2880,31
2021-01-15,Merced,47,269075,24116,23060,608,23668,239
2021-01-15,Modoc,49,8938,294,278,87,365,0
2021-01-15,Mono,51,14174,1083,1057,11,1068,3
2021-01-15,Monterey,53,433212,36312,34460,1156,35616,243
2021-01-15,Napa,55,140530,7776,7231,30,7261,38
2021-01-15,Nevada,57,99092,3328,3099,130,3229,17
2021-01-15,Orange,59,3164182,216122,207129,9043,216172,2254
2021-01-15,Placer,61,380077,18113,16712,883,17595,173
2021-01-15,Plumas,63,18699,583,499,10,509,2
2021-01-15,Riverside,65,2383286,248941,235235,12449,247684,2458
2021-01-15,Sacramento,67,1510023,81549,80279,946,81225,1023
2021-01-15,San Benito,69,59416,4988,4766,56,4822,35
2021-01-15,San Bernardino,71,2135413,259290,246182,7441,253623,1726
2021-01-15,San Diego,73,3302833,223785,206868,0,206868,2037
2021-01-15,San Francisco,75,870044,29548,28574,602,29176,242
2021-01-15,San Joaquin,77,732212,58324,55885,2381,58266,748
2021-01-15,San Luis Obispo,79,281455,16217,15129,422,15551,148
2021-01-15,San Mateo,81,765935,33821,31291,220,31511,208
2021-01-15,Santa Barbara,83,443738,25788,23487,893,24380,226
2021-01-15,Santa Clara,85,1922200,94230,90103,431,90534,942
2021-01-15,Santa Cruz,87,273765,13154,11776,641,12417,105
2021-01-15,Shasta,89,179085,9818,9459,1026,10485,91
2021-01-15,Sierra,91,2930,42,36,10,46,0
2021-01-15,Siskiyou,93,43540,1219,1119,194,1313,4
2021-01-15,Solano,95,438530,25691,24222,278,24500,103
2021-01-15,Sonoma,97,501317,24198,23204,125,23329,222
2021-01-15,Stanislaus,99,539301,43263,41178,4428,45606,562
2021-01-15,Sutter,101,95872,7718,7484,66,7550,75
2021-01-15,Tehama,103,63373,3918,3714,459,4173,17
2021-01-15,Trinity,105,12862,315,262,33,295,3
2021-01-15,Tulare,107,460477,42112,39951,5913,45864,535
2021-01-15,Tuolumne,109,53932,3338,3231,55,3286,27
2021-01-15,Ventura,111,848112,62553,59061,2282,61343,353
2021-01-15,Yolo,113,214977,11155,10240,129,10369,134
2021-01-15,Yuba,115,75493,4761,4549,61,4610,27
2021-01-14,Alameda,1,1643700,67944,64364,1475,65839,686
2021-01-14,Alpine,3,1148,74,71,0,71,0
2021-01-14,Amador,5,37829,3034,2940,26,2966,28
2021-01-14,Butte,7,227075,9771,9127,1352,10479,129
2021-01-14,Calaveras,9,45235,1583,1513,8,1521,21
2021-01-14,Colusa,11,21464,1606,1535,162,1697,7
2021-01-14,Contra Costa,13,1133247,52876,49545,896,50441,415
2021-01-14,Del Norte,15,27424,838,821,0,821,2
2021-01-14,El Dorado,17,186661,7946,7321,532,7853,45
2021-01-14,Fresno,19,978130,84399,79033,6507,85540,814
2021-01-14,Glenn,21,27897,1977,1798,397,2195,9
2021-01-14,Humboldt,23,135768,2397,2169,7,2176,22
2021-01-14,Imperial,25,180216,25590,24882,2233,27115,447
2021-01-14,Inyo,27,18085,961,790,1,791,25
2021-01-14,Kern,29,883053,81297,77070,7541,84611,705
2021-01-14,Kings,31,150075,19473,18405,817,19222,108
2021-01-14,Lake,33,64148,2618,2378,0,2378,27
2021-01-14,Lassen,35,31185,4782,4673,76,4749,1
2021-01-14,Los Angeles,37,10098052,1024373,954652,34345,988997,13147
2021-01-14,Madera,39,155013,13590,12742,659,13401,85
2021-01-14,Marin,41,260295,11599,11155,118,11273,159
2021-01-14,Mariposa,43,17540,330,302,3,305,3
2021-01-14,Mendocino,45,87422,3009,2801,43,2844,31
2021-01-14,Merced,47,269075,23888,22780,598,23378,239
2021-01-14,Modoc,49,8938,294,273,87,360,0
2021-01-14,Mono,51,14174,1075,1020,11,1031,3
2021-01-14,Monterey,53,433212,35905,34105,1138,35243,242
2021-01-14,Napa,55,140530,7691,7117,30,7147,38
2021-01-14,Nevada,57,99092,3301,3075,128,3203,17
2021-01-14,Orange,59,3164182,214194,204442,8950,213392,2162
2021-01-14,Placer,61,380077,17952,16488,875,17363,169
2021-01-14,Plumas,63,18699,575,496,10,506,2
2021-01-14,Riverside,65,2383286,246324,231684,12345,244029,2357
2021-01-14,Sacramento,67,1510023,80912,79137,921,80058,1007
2021-01-14,San Benito,69,59416,4950,4678,55,4733,35
2021-01-14,San Bernardino,71,2135413,257332,243379,7365,250744,1750
2021-01-14,San Diego,73,3302833,221395,204173,0,204173,2005
2021-01-14,San Francisco,75,870044,29305,28200,549,28749,238
2021-01-14,San Joaquin,77,732212,57812,55058,2366,57424,739
2021-01-14,San Luis Obispo,79,281455,16058,14851,412,15263,146
2021-01-14,San Mateo,81,765935,33456,30694,211,30905,208
2021-01-14,Santa Barbara,83,443738,25380,23126,866,23992,219
2021-01-14,Santa Clara,85,1922200,93339,88505,424,88929,910
2021-01-14,Santa Cruz,87,273765,13007,11583,625,12208,109
2021-01-14,Shasta,89,179085,9770,9334,1009,10343,90
2021-01-14,Sierra,91,2930,42,35,9,44,0
2021-01-14,Siskiyou,93,43540,1208,1108,190,1298,3
2021-01-14,Solano,95,438530,25430,23782,274,24056,103
2021-01-14,Sonoma,97,501317,23946,22910,125,23035,202
2021-01-14,Stanislaus,99,539301,42944,40597,4386,44983,574
2021-01-14,Sutter,101,95872,7659,7416,63,7479,74
2021-01-14,Tehama,103,63373,3888,3664,455,4119,17
2021-01-14,Trinity,105,12862,315,261,32,293,3
2021-01-14,Tulare,107,460477,41732,39565,5800,45365,533
2021-01-14,Tuolumne,109,53932,3318,3215,55,3270,28
2021-01-14,Ventura,111,848112,61682,57941,2244,60185,347
2021-01-14,Yolo,113,214977,11044,10097,123,10220,135
2021-01-14,Yuba,115,75493,4729,4496,61,4557,27
2021-01-13,Alameda,1,1643700,67196,63568,1456,65024,690
2021-01-13,Alpine,3,1148,74,71,0,71,0
2021-01-13,Amador,5,37829,3020,2914,26,2940,26
2021-01-13,Butte,7,227075,9692,9013,1337,10350,126
2021-01-13,Calaveras,9,45235,1562,1493,8,1501,21
2021-01-13,Colusa,11,21464,1594,1524,157,1681,7
2021-01-13,Contra Costa,13,1133247,52301,48877,883,49760,403
2021-01-13,Del Norte,15,27424,834,820,0,820,2
2021-01-13,El Dorado,17,186661,7853,7247,524,7771,43
2021-01-13,Fresno,19,978130,83692,78278,6453,84731,804
2021-01-13,Glenn,21,27897,1963,1792,389,2181,9
2021-01-13,Humboldt,23,135768,2365,2114,7,2121,22
2021-01-13,Imperial,25,180216,25462,24717,2201,26918,463
2021-01-13,Inyo,27,18085,949,785,1,786,25
2021-01-13,Kern,29,883053,80633,76049,7450,83499,704
2021-01-13,Kings,31,150075,19308,18121,791,18912,108
2021-01-13,Lake,33,64148,2574,2305,0,2305,27
2021-01-13,Lassen,35,31185,4775,4663,75,4738,1
2021-01-13,Los Angeles,37,10098052,1013738,937985,33912,971897,12873
2021-01-13,Madera,39,155013,13466,12570,653,13223,85
2021-01-13,Marin,41,260295,11542,11039,118,11157,161
2021-01-13,Mariposa,43,17540,328,304,3,307,3
2021-01-13,Mendocino,45,87422,2989,2790,43,2833,31
2021-01-13,Merced,47,269075,23649,22497,586,23083,241
2021-01-13,Modoc,49,8938,293,274,84,358,0
2021-01-13,Mono,51,14174,1071,1017,11,1028,3
2021-01-13,Monterey,53,433212,35489,33748,1113,34861,241
2021-01-13,Napa,55,140530,7577,7028,30,7058,36
2021-01-13,Nevada,57,99092,3278,3037,124,3161,17
2021-01-13,Orange,59,3164182,212115,201158,8880,210038,2172
2021-01-13,Placer,61,380077,17826,16272,861,17133,172
2021-01-13,Plumas,63,18699,573,490,10,500,2
2021-01-13,Riverside,65,2383286,243229,228192,12219,240411,2278
2021-01-13,Sacramento,67,1510023,80259,78268,914,79182,996
2021-01-13,San Benito,69,59416,4896,4583,54,4637,35
2021-01-13,San Bernardino,71,2135413,254966,240191,7287,247478,1759
2021-01-13,San Diego,73,3302833,218782,201578,0,201578,1952
2021-01-13,San Francisco,75,870044,29067,27863,525,28388,238
2021-01-13,San Joaquin,77,732212,57187,54373,2334,56707,738
2021-01-13,San Luis Obispo,79,281455,15905,14625,401,15026,140
2021-01-13,San Mateo,81,765935,33113,30195,209,30404,207
2021-01-13,Santa Barbara,83,443738,24951,22714,840,23554,216
2021-01-13,Santa Clara,85,1922200,92364,87187,421,87608,911
2021-01-13,Santa Cruz,87,273765,12836,11423,610,12033,110
2021-01-13,Shasta,89,179085,9707,9180,994,10174,93
2021-01-13,Sierra,91,2930,42,33,9,42,0
2021-01-13,Siskiyou,93,43540,1202,1102,186,1288,3
2021-01-13,Solano,95,438530,25151,23503,273,23776,105
2021-01-13,Sonoma,97,501317,23695,22610,125,22735,206
2021-01-13,Stanislaus,99,539301,42547,40167,4329,44496,574
2021-01-13,Sutter,101,95872,7613,7350,62,7412,73
2021-01-13,Tehama,103,63373,3839,3589,450,4039,17
2021-01-13,Trinity,105,12862,315,260,32,292,3
2021-01-13,Tulare,107,460477,41330,39129,5689,44818,522
2021-01-13,Tuolumne,109,53932,3304,3196,55,3251,28
2021-01-13,Ventura,111,848112,60673,56453,2206,58659,338
2021-01-13,Yolo,113,214977,10942,9933,119,10052,135
2021-01-13,Yuba,115,75493,4687,4448,58,4506,27
2021-01-12,Alameda,1,1643700,66390,62642,1436,64078,677
2021-01-12,Alpine,3,1148,74,71,0,71,0
2021-01-12,Amador,5,37829,3003,2897,26,2923,26
2021-01-12,Butte,7,227075,9609,8883,1316,10199,124
2021-01-12,Calaveras,9,45235,1525,1475,8,1483,21
2021-01-12,Colusa,11,21464,1582,1510,153,1663,7
2021-01-12,Contra Costa,13,1133247,51656,48242,867,49109,399
2021-01-12,Del Norte,15,27424,830,816,0,816,2
2021-01-12,El Dorado,17,186661,7770,7156,513,7669,41
2021-01-12,Fresno,19,978130,82829,77651,6383,84034,796
2021-01-12,Glenn,21,27897,1935,1781,383,2164,9
2021-01-12,Humboldt,23,135768,2311,2077,6,2083,22
2021-01-12,Imperial,25,180216,25375,24566,2159,26725,457
2021-01-12,Inyo,27,18085,932,773,1,774,25
2021-01-12,Kern,29,883053,79934,75320,7347,82667,689
2021-01-12,Kings,31,150075,19102,18072,777,18849,108
2021-01-12,Lake,33,64148,2526,2260,0,2260,27
2021-01-12,Lassen,35,31185,4753,4659,73,4732,1
2021-01-12,Los Angeles,37,10098052,1002125,926295,33485,959780,12610
2021-01-12,Madera,39,155013,13325,12485,645,13130,85
2021-01-12,Marin,41,260295,11433,10960,118,11078,157
2021-01-12,Mariposa,43,17540,326,302,3,305,3
2021-01-12,Mendocino,45,87422,2969,2762,39,2801,31
2021-01-12,Merced,47,269075,23400,22172,563,22735,239
2021-01-12,Modoc,49,8938,291,274,84,358,0
2021-01-12,Mono,51,14174,1062,1008,11,1019,3
2021-01-12,Monterey,53,433212,34990,33381,1091,34472,240
2021-01-12,Napa,55,140530,7494,6936,30,6966,36
2021-01-12,Nevada,57,99092,3250,3014,122,3136,17
2021-01-12,Orange,59,3164182,209779,198260,8793,207053,2142
2021-01-12,Placer,61,380077,17645,16087,855,16942,163
2021-01-12,Plumas,63,18699,567,483,10,493,2
2021-01-12,Riverside,65,2383286,240117,225580,12072,237652,2266
2021-01-12,Sacramento,67,1510023,79515,77201,905,78106,985
2021-01-12,San Benito,69,59416,4829,4515,54,4569,35
2021-01-12,San Bernardino,71,2135413,252398,237008,7210,244218,1739
2021-01-12,San Diego,73,3302833,215872,198317,0,198317,1898
2021-01-12,San Francisco,75,870044,28791,27531,489,28020,238
2021-01-12,San Joaquin,77,732212,56537,53630,2303,55933,725
2021-01-12,San Luis Obispo,79,281455,15659,14367,393,14760,132
2021-01-12,San Mateo,81,765935,32725,29747,197,29944,206
2021-01-12,Santa Barbara,83,443738,24543,22182,809,22991,209
2021-01-12,Santa Clara,85,1922200,91305,86075,412,86487,904
2021-01-12,Santa Cruz,87,273765,12621,11267,593,11860,110
2021-01-12,Shasta,89,179085,9634,9086,981,10067,84
2021-01-12,Sierra,91,2930,40,33,8,41,0
2021-01-12,Siskiyou,93,43540,1192,1091,180,1271,3
2021-01-12,Solano,95,438530,24847,23160,268,23428,102
2021-01-12,Sonoma,97,501317,23391,22403,125,22528,205
2021-01-12,Stanislaus,99,539301,42096,39615,4293,43908,571
2021-01-12,Sutter,101,95872,7550,7276,61,7337,73
2021-01-12,Tehama,103,63373,3804,3567,446,4013,17
2021-01-12,Trinity,105,12862,315,258,32,290,3
2021-01-12,Tulare,107,460477,40881,38797,5567,44364,509
2021-01-12,Tuolumne,109,53932,3270,3178,55,3233,28
2021-01-12,Ventura,111,848112,59706,55342,2172,57514,324
2021-01-12,Yolo,113,214977,10804,9857,108,9965,133
2021-01-12,Yuba,115,75493,4647,4389,58,4447,27
2021-01-11,Alameda,1,1643700,65541,61949,1418,63367,652
2021-01-11,Alpine,3,1148,74,70,0,70,0
2021-01-11,Amador,5,37829,2989,2867,26,2893,24
2021-01-11,Butte,7,227075,9497,8757,1298,10055,119
2021-01-11,Calaveras,9,45235,1507,1460,8,1468,21
2021-01-11,Colusa,11,21464,1564,1494,149,1643,7
2021-01-11,Contra Costa,13,1133247,50982,47728,857,48585,398
2021-01-11,Del Norte,15,27424,826,810,0,810,2
2021-01-11,El Dorado,17,186661,7678,6987,503,7490,36
2021-01-11,Fresno,19,978130,81953,76581,6303,82884,775
2021-01-11,Glenn,21,27897,1906,1763,374,2137,9
2021-01-11,Humboldt,23,135768,2271,2069,6,2075,22
2021-01-11,Imperial,25,180216,25262,24418,2123,26541,453
2021-01-11,Inyo,27,18085,914,763,1,764,25
2021-01-11,Kern,29,883053,79083,74489,7243,81732,682
2021-01-11,Kings,31,150075,18838,17909,769,18678,108
2021-01-11,Lake,33,64148,2476,2205,0,2205,26
2021-01-11,Lassen,35,31185,4730,4647,72,4719,1
2021-01-11,Los Angeles,37,10098052,988976,914434,32992,947426,12304
2021-01-11,Madera,39,155013,13192,12366,634,13000,85
2021-01-11,Marin,41,260295,11337,10814,115,10929,156
2021-01-11,Mariposa,43,17540,319,296,3,299,3
2021-01-11,Mendocino,45,87422,2942,2728,39,2767,31
2021-01-11,Merced,47,269075,23077,21884,549,22433,238
2021-01-11,Modoc,49,8938,290,271,83,354,0
2021-01-11,Mono,51,14174,1056,1006,11,1017,3
2021-01-11,Monterey,53,433212,34455,32858,1028,33886,239
2021-01-11,Napa,55,140530,7391,6822,30,6852,36
2021-01-11,Nevada,57,99092,3223,2980,122,3102,17
2021-01-11,Orange,59,3164182,207216,196340,8692,205032,2113
2021-01-11,Placer,61,380077,17466,15919,842,16761,163
2021-01-11,Plumas,63,18699,563,477,10,487,2
2021-01-11,Riverside,65,2383286,236625,222907,11915,234822,2222
2021-01-11,Sacramento,67,1510023,78597,76009,888,76897,974
2021-01-11,San Benito,69,59416,4752,4482,47,4529,34
2021-01-11,San Bernardino,71,2135413,249575,235543,7108,242651,1739
2021-01-11,San Diego,73,3302833,212609,194793,0,194793,1857
2021-01-11,San Francisco,75,870044,28521,27264,465,27729,238
2021-01-11,San Joaquin,77,732212,55924,53002,2273,55275,725
2021-01-11,San Luis Obispo,79,281455,15289,14213,385,14598,126
2021-01-11,San Mateo,81,765935,32278,29355,184,29539,206
2021-01-11,Santa Barbara,83,443738,24106,21740,792,22532,200
2021-01-11,Santa Clara,85,1922200,90108,84851,403,85254,877
2021-01-11,Santa Cruz,87,273765,12444,11093,566,11659,106
2021-01-11,Shasta,89,179085,9536,8977,967,9944,81
2021-01-11,Sierra,91,2930,39,33,8,41,0
2021-01-11,Siskiyou,93,43540,1184,1087,177,1264,3
2021-01-11,Solano,95,438530,24527,22893,263,23156,101
2021-01-11,Sonoma,97,501317,23145,22191,125,22316,205
2021-01-11,Stanislaus,99,539301,41607,39149,4239,43388,571
2021-01-11,Sutter,101,95872,7492,7204,60,7264,71
2021-01-11,Tehama,103,63373,3740,3524,423,3947,17
2021-01-11,Trinity,105,12862,315,256,32,288,2
2021-01-11,Tulare,107,460477,40485,38380,5474,43854,497
2021-01-11,Tuolumne,109,53932,3259,3165,55,3220,27
2021-01-11,Ventura,111,848112,58573,54202,2145,56347,320
2021-01-11,Yolo,113,214977,10589,9699,106,9805,129
2021-01-11,Yuba,115,75493,4608,4349,51,4400,27
2021-01-10,Alameda,1,1643700,64562,61111,1389,62500,650
2021-01-10,Alpine,3,1148,74,70,0,70,0
2021-01-10,Amador,5,37829,2965,2861,26,2887,24
2021-01-10,Butte,7,227075,9381,8665,1271,9936,119
2021-01-10,Calaveras,9,45235,1481,1449,8,1457,21
2021-01-10,Colusa,11,21464,1540,1478,147,1625,7
2021-01-10,Contra Costa,13,1133247,50197,47109,839,47948,398
2021-01-10,Del Norte,15,27424,823,809,0,809,2
2021-01-10,El Dorado,17,186661,7591,6904,485,7389,36
2021-01-10,Fresno,19,978130,81143,75621,6180,81801,775
2021-01-10,Glenn,21,27897,1882,1746,366,2112,9
2021-01-10,Humboldt,23,135768,2210,2049,6,2055,22
2021-01-10,Imperial,25,180216,25102,24233,2068,26301,453
2021-01-10,Inyo,27,18085,886,748,1,749,25
2021-01-10,Kern,29,883053,78260,73712,7107,80819,679
2021-01-10,Kings,31,150075,18619,17812,761,18573,108
2021-01-10,Lake,33,64148,2424,2174,0,2174,26
2021-01-10,Lassen,35,31185,4708,4642,71,4713,1
2021-01-10,Los Angeles,37,10098052,974442,901783,32330,934113,12170
2021-01-10,Madera,39,155013,13005,12179,619,12798,85
2021-01-10,Marin,41,260295,11218,10737,113,10850,155
2021-01-10,Mariposa,43,17540,319,291,3,294,3
2021-01-10,Mendocino,45,87422,2911,2706,36,2742,31
2021-01-10,Merced,47,269075,22802,21691,539,22230,238
2021-01-10,Modoc,49,8938,290,271,81,352,0
2021-01-10,Mono,51,14174,1039,965,11,976,3
2021-01-10,Monterey,53,433212,34015,32571,996,33567,237
2021-01-10,Napa,55,140530,7289,6687,28,6715,36
2021-01-10,Nevada,57,99092,3204,2959,118,3077,17
2021-01-10,Orange,59,3164182,204469,193766,8568,202334,2104
2021-01-10,Placer,61,380077,17289,15779,820,16599,163
2021-01-10,Plumas,63,18699,553,477,10,487,2
2021-01-10,Riverside,65,2383286,233293,219486,11722,231208,2216
2021-01-10,Sacramento,67,1510023,77643,75394,859,76253,965
2021-01-10,San Benito,69,59416,4658,4434,46,4480,34
2021-01-10,San Bernardino,71,2135413,245967,232171,7004,239175,1736
2021-01-10,San Diego,73,3302833,208955,191886,0,191886,1857
2021-01-10,San Francisco,75,870044,28140,27054,429,27483,238
2021-01-10,San Joaquin,77,732212,55065,52535,2239,54774,725
2021-01-10,San Luis Obispo,79,281455,14961,13968,371,14339,122
2021-01-10,San Mateo,81,765935,31790,28972,169,29141,206
2021-01-10,Santa Barbara,83,443738,23563,21290,767,22057,200
2021-01-10,Santa Clara,85,1922200,88932,83779,392,84171,858
2021-01-10,Santa Cruz,87,273765,12233,10951,542,11493,106
2021-01-10,Shasta,89,179085,9426,8936,950,9886,81
2021-01-10,Sierra,91,2930,38,32,8,40,0
2021-01-10,Siskiyou,93,43540,1178,1075,174,1249,3
2021-01-10,Solano,95,438530,24126,22621,260,22881,101
2021-01-10,Sonoma,97,501317,22874,21925,125,22050,204
2021-01-10,Stanislaus,99,539301,41048,38809,4156,42965,571
2021-01-10,Sutter,101,95872,7431,7133,57,7190,71
2021-01-10,Tehama,103,63373,3668,3504,410,3914,17
2021-01-10,Trinity,105,12862,315,253,31,284,2
2021-01-10,Tulare,107,460477,40074,38012,5337,43349,497
2021-01-10,Tuolumne,109,53932,3225,3143,54,3197,27
2021-01-10,Ventura,111,848112,57305,53095,2100,55195,319
2021-01-10,Yolo,113,214977,10441,9610,105,9715,129
2021-01-10,Yuba,115,75493,4556,4300,48,4348,27
2021-01-09,Alameda,1,1643700,64054,60125,1371,61496,649
2021-01-09,Alpine,3,1148,74,70,0,70,0
2021-01-09,Amador,5,37829,2958,2809,26,2835,24
2021-01-09,Butte,7,227075,9300,8552,1247,9799,118
2021-01-09,Calaveras,9,45235,1471,1425,8,1433,21
2021-01-09,Colusa,11,21464,1534,1468,146,1614,7
2021-01-09,Contra Costa,13,1133247,49851,46406,825,47231,393
2021-01-09,Del Norte,15,27424,821,802,0,802,2
2021-01-09,El Dorado,17,186661,7559,6800,482,7282,36
2021-01-09,Fresno,19,978130,80734,74816,6138,80954,773
2021-01-09,Glenn,21,27897,1867,1707,361,2068,9
2021-01-09,Humboldt,23,135768,2192,2026,6,2032,22
2021-01-09,Imperial,25,180216,25035,24028,2053,26081,448
2021-01-09,Inyo,27,18085,876,734,1,735,25
2021-01-09,Kern,29,883053,77803,73015,7026,80041,677
2021-01-09,Kings,31,150075,18523,17679,757,18436,108
2021-01-09,Lake,33,64148,2391,2144,0,2144,26
2021-01-09,Lassen,35,31185,4696,4613,70,4683,1
2021-01-09,Los Angeles,37,10098052,968915,887949,31867,919816,12011
2021-01-09,Madera,39,155013,12920,12063,614,12677,85
2021-01-09,Marin,41,260295,11154,10634,112,10746,154
2021-01-09,Mariposa,43,17540,316,287,3,290,3
2021-01-09,Mendocino,45,87422,2893,2664,36,2700,31
2021-01-09,Merced,47,269075,22661,21357,529,21886,237
2021-01-09,Modoc,49,8938,290,271,80,351,0
2021-01-09,Mono,51,14174,1034,964,11,975,3
2021-01-09,Monterey,53,433212,33872,31948,987,32935,235
2021-01-09,Napa,55,140530,7219,6594,25,6619,36
2021-01-09,Nevada,57,99092,3182,2932,115,3047,17
2021-01-09,Orange,59,3164182,202975,191004,8476,199480,2034
2021-01-09,Placer,61,380077,17188,15609,818,16427,162
2021-01-09,Plumas,63,18699,551,477,10,487,2
2021-01-09,Riverside,65,2383286,231590,216076,11574,227650,2201
2021-01-09,Sacramento,67,1510023,77119,74482,854,75336,953
2021-01-09,San Benito,69,59416,4610,4335,46,4381,34
2021-01-09,San Bernardino,71,2135413,244791,228857,6934,235791,1714
2021-01-09,San Diego,73,3302833,207264,188598,0,188598,1824
2021-01-09,San Francisco,75,870044,27965,26708,384,27092,235
2021-01-09,San Joaquin,77,732212,54720,51927,2218,54145,724
2021-01-09,San Luis Obispo,79,281455,14838,13647,360,14007,121
2021-01-09,San Mateo,81,765935,31490,28512,162,28674,205
2021-01-09,Santa Barbara,83,443738,23354,20971,758,21729,197
2021-01-09,Santa Clara,85,1922200,88092,82269,380,82649,808
2021-01-09,Santa Cruz,87,273765,12136,10717,537,11254,107
2021-01-09,Shasta,89,179085,9393,8893,946,9839,81
2021-01-09,Sierra,91,2930,36,32,8,40,0
2021-01-09,Siskiyou,93,43540,1175,1062,170,1232,3
2021-01-09,Solano,95,438530,23971,22226,259,22485,101
2021-01-09,Sonoma,97,501317,22764,21393,125,21518,202
2021-01-09,Stanislaus,99,539301,40756,38403,4114,42517,567
2021-01-09,Sutter,101,95872,7395,7072,56,7128,69
2021-01-09,Tehama,103,63373,3639,3451,398,3849,15
2021-01-09,Trinity,105,12862,315,252,31,283,2
2021-01-09,Tulare,107,460477,39832,37684,5263,42947,496
2021-01-09,Tuolumne,109,53932,3217,3117,53,3170,26
2021-01-09,Ventura,111,848112,56479,51988,2073,54061,306
2021-01-09,Yolo,113,214977,10371,9524,102,9626,129
2021-01-09,Yuba,115,75493,4528,4265,48,4313,27
2021-01-08,Alameda,1,1643700,63486,59172,1360,60532,646
2021-01-08,Alpine,3,1148,74,70,0,70,0
2021-01-08,Amador,5,37829,2951,2792,26,2818,24
2021-01-08,Butte,7,227075,9242,8430,1230,9660,115
2021-01-08,Calaveras,9,45235,1458,1385,8,1393,21
2021-01-08,Colusa,11,21464,1521,1448,145,1593,7
2021-01-08,Contra Costa,13,1133247,49325,45667,821,46488,381
2021-01-08,Del Norte,15,27424,819,795,0,795,2
2021-01-08,El Dorado,17,186661,7489,6690,470,7160,36
2021-01-08,Fresno,19,978130,79921,73689,6073,79762,771
2021-01-08,Glenn,21,27897,1851,1680,357,2037,9
2021-01-08,Humboldt,23,135768,2169,1988,6,1994,22
2021-01-08,Imperial,25,180216,24967,23751,2038,25789,446
2021-01-08,Inyo,27,18085,862,682,1,683,24
2021-01-08,Kern,29,883053,77243,71978,6953,78931,674
2021-01-08,Kings,31,150075,18395,17441,752,18193,108
2021-01-08,Lake,33,64148,2364,2098,0,2098,26
2021-01-08,Lassen,35,31185,4688,4598,68,4666,1
2021-01-08,Los Angeles,37,10098052,958156,871188,31411,902599,11796
2021-01-08,Madera,39,155013,12768,11846,605,12451,85
2021-01-08,Marin,41,260295,11059,10531,111,10642,153
2021-01-08,Mariposa,43,17540,315,273,3,276,3
2021-01-08,Mendocino,45,87422,2874,2634,33,2667,31
2021-01-08,Merced,47,269075,22466,20862,524,21386,236
2021-01-08,Modoc,49,8938,290,266,80,346,0
2021-01-08,Mono,51,14174,1024,951,11,962,3
2021-01-08,Monterey,53,433212,33605,31543,974,32517,224
2021-01-08,Napa,55,140530,7149,6544,25,6569,32
2021-01-08,Nevada,57,99092,3160,2888,115,3003,17
2021-01-08,Orange,59,3164182,200987,186608,8387,194995,1991
2021-01-08,Placer,61,380077,17062,15401,811,16212,161
2021-01-08,Plumas,63,18699,545,465,10,475,2
2021-01-08,Riverside,65,2383286,229235,212122,11435,223557,2184
2021-01-08,Sacramento,67,1510023,76543,73245,848,74093,939
2021-01-08,San Benito,69,59416,4574,4225,45,4270,33
2021-01-08,San Bernardino,71,2135413,242904,224267,6861,231128,1703
2021-01-08,San Diego,73,3302833,204731,185060,0,185060,1771
2021-01-08,San Francisco,75,870044,27718,26378,359,26737,207
2021-01-08,San Joaquin,77,732212,54382,50990,2187,53177,710
2021-01-08,San Luis Obispo,79,281455,14705,13286,346,13632,119
2021-01-08,San Mateo,81,765935,31141,28072,159,28231,204
2021-01-08,Santa Barbara,83,443738,23076,20461,749,21210,189
2021-01-08,Santa Clara,85,1922200,87065,80561,377,80938,789
2021-01-08,Santa Cruz,87,273765,11998,10486,526,11012,106
2021-01-08,Shasta,89,179085,9343,8772,931,9703,81
2021-01-08,Sierra,91,2930,36,31,8,39,0
2021-01-08,Siskiyou,93,43540,1172,1027,169,1196,3
2021-01-08,Solano,95,438530,23803,21832,259,22091,100
2021-01-08,Sonoma,97,501317,22626,21178,125,21303,201
2021-01-08,Stanislaus,99,539301,40455,37858,4077,41935,566
2021-01-08,Sutter,101,95872,7345,6982,56,7038,68
2021-01-08,Tehama,103,63373,3616,3406,393,3799,15
2021-01-08,Trinity,105,12862,315,247,31,278,2
2021-01-08,Tulare,107,460477,39568,36946,5146,42092,491
2021-01-08,Tuolumne,109,53932,3208,3099,53,3152,19
2021-01-08,Ventura,111,848112,55616,50553,2048,52601,294
2021-01-08,Yolo,113,214977,10283,9391,98,9489,129
2021-01-08,Yuba,115,75493,4486,4195,47,4242,26
2021-01-07,Alameda,1,1643700,62514,57921,1332,59253,632
2021-01-07,Alpine,3,1148,72,70,0,70,0
2021-01-07,Amador,5,37829,2938,2740,25,2765,24
2021-01-07,Butte,7,227075,9146,8278,1201,9479,112
2021-01-07,Calaveras,9,45235,1441,1342,7,1349,21
2021-01-07,Colusa,11,21464,1509,1420,138,1558,7
2021-01-07,Contra Costa,13,1133247,48548,44756,804,45560,376
2021-01-07,Del Norte,15,27424,817,791,0,791,2
2021-01-07,El Dorado,17,186661,7390,6545,456,7001,36
2021-01-07,Fresno,19,978130,78970,72557,5969,78526,765
2021-01-07,Glenn,21,27897,1835,1639,348,1987,9
2021-01-07,Humboldt,23,135768,2142,1954,6,1960,22
2021-01-07,Imperial,25,180216,24773,23608,1986,25594,431
2021-01-07,Inyo,27,18085,849,656,1,657,20
2021-01-07,Kern,29,883053,76392,70953,6800,77753,660
2021-01-07,Kings,31,150075,18267,17238,743,17981,108
2021-01-07,Lake,33,64148,2309,2054,0,2054,26
2021-01-07,Lassen,35,31185,4683,4581,66,4647,1
2021-01-07,Los Angeles,37,10098052,943301,853187,30847,884034,11480
2021-01-07,Madera,39,155013,12612,11644,593,12237,76
2021-01-07,Marin,41,260295,10966,10364,109,10473,153
2021-01-07,Mariposa,43,17540,313,264,3,267,3
2021-01-07,Mendocino,45,87422,2819,2585,29,2614,30
2021-01-07,Merced,47,269075,22145,20510,509,21019,234
2021-01-07,Modoc,49,8938,290,265,80,345,0
2021-01-07,Mono,51,14174,1013,905,11,916,3
2021-01-07,Monterey,53,433212,33077,30903,951,31854,222
2021-01-07,Napa,55,140530,7039,6408,25,6433,32
2021-01-07,Nevada,57,99092,3126,2847,110,2957,17
2021-01-07,Orange,59,3164182,198125,181922,8283,190205,1974
2021-01-07,Placer,61,380077,16879,15155,781,15936,144
2021-01-07,Plumas,63,18699,543,454,10,464,2
2021-01-07,Riverside,65,2383286,225901,208177,11245,219422,2156
2021-01-07,Sacramento,67,1510023,75638,72342,828,73170,919
2021-01-07,San Benito,69,59416,4512,4112,41,4153,33
2021-01-07,San Bernardino,71,2135413,239370,219691,6776,226467,1666
2021-01-07,San Diego,73,3302833,201427,180510,0,180510,1738
2021-01-07,San Francisco,75,870044,27382,25885,342,26227,202
2021-01-07,San Joaquin,77,732212,53698,50156,2154,52310,689
2021-01-07,San Luis Obispo,79,281455,14468,12810,332,13142,118
2021-01-07,San Mateo,81,765935,30632,27494,155,27649,201
2021-01-07,Santa Barbara,83,443738,22658,19931,735,20666,187
2021-01-07,Santa Clara,85,1922200,85845,78808,373,79181,775
2021-01-07,Santa Cruz,87,273765,11789,10228,519,10747,104
2021-01-07,Shasta,89,179085,9256,8612,923,9535,81
2021-01-07,Sierra,91,2930,36,31,8,39,0
2021-01-07,Siskiyou,93,43540,1167,1010,167,1177,3
2021-01-07,Solano,95,438530,23408,21384,255,21639,100
2021-01-07,Sonoma,97,501317,22362,20857,124,20981,200
2021-01-07,Stanislaus,99,539301,40030,37296,4025,41321,553
2021-01-07,Sutter,101,95872,7286,6890,55,6945,65
2021-01-07,Tehama,103,63373,3592,3330,386,3716,15
2021-01-07,Trinity,105,12862,315,247,31,278,2
2021-01-07,Tulare,107,460477,39163,36397,5002,41399,482
2021-01-07,Tuolumne,109,53932,3188,3068,52,3120,14
2021-01-07,Ventura,111,848112,54454,49083,2018,51101,288
2021-01-07,Yolo,113,214977,10147,9207,96,9303,128
2021-01-07,Yuba,115,75493,4444,4128,47,4175,25
2021-01-06,Alameda,1,1643700,61628,57081,1302,58383,616
2021-01-06,Alpine,3,1148,72,70,0,70,0
2021-01-06,Amador,5,37829,2917,2717,24,2741,24
2021-01-06,Butte,7,227075,9035,8147,1182,9329,110
2021-01-06,Calaveras,9,45235,1416,1321,7,1328,21
2021-01-06,Colusa,11,21464,1489,1385,132,1517,7
2021-01-06,Contra Costa,13,1133247,47746,44054,786,44840,358
2021-01-06,Del Norte,15,27424,811,780,0,780,2
2021-01-06,El Dorado,17,186661,7278,6397,442,6839,35
2021-01-06,Fresno,19,978130,78128,71404,5866,77270,752
2021-01-06,Glenn,21,27897,1811,1622,342,1964,9
2021-01-06,Humboldt,23,135768,2116,1912,6,1918,22
2021-01-06,Imperial,25,180216,24521,23400,1944,25344,431
2021-01-06,Inyo,27,18085,833,630,1,631,20
2021-01-06,Kern,29,883053,75453,69893,6662,76555,646
2021-01-06,Kings,31,150075,18073,17019,720,17739,108
2021-01-06,Lake,33,64148,2272,2033,0,2033,26
2021-01-06,Lassen,35,31185,4671,4560,62,4622,1
2021-01-06,Los Angeles,37,10098052,927415,835052,30121,865173,11285
2021-01-06,Madera,39,155013,12478,11407,587,11994,67
2021-01-06,Marin,41,260295,10839,10282,108,10390,153
2021-01-06,Mariposa,43,17540,310,259,3,262,3
2021-01-06,Mendocino,45,87422,2789,2561,29,2590,30
2021-01-06,Merced,47,269075,21802,20258,493,20751,232
2021-01-06,Modoc,49,8938,290,263,80,343,0
2021-01-06,Mono,51,14174,982,905,11,916,3
2021-01-06,Monterey,53,433212,32488,30387,914,31301,222
2021-01-06,Napa,55,140530,6909,6342,25,6367,32
2021-01-06,Nevada,57,99092,3106,2805,110,2915,15
2021-01-06,Orange,59,3164182,194633,177686,8138,185824,1935
2021-01-06,Placer,61,380077,16693,14940,762,15702,134
2021-01-06,Plumas,63,18699,535,445,10,455,2
2021-01-06,Riverside,65,2383286,221894,203714,11026,214740,2121
2021-01-06,Sacramento,67,1510023,74620,71572,810,72382,909
2021-01-06,San Benito,69,59416,4436,4031,40,4071,32
2021-01-06,San Bernardino,71,2135413,235666,215286,6659,221945,1634
2021-01-06,San Diego,73,3302833,197932,176660,0,176660,1691
2021-01-06,San Francisco,75,870044,27011,25424,332,25756,199
2021-01-06,San Joaquin,77,732212,52936,49286,2111,51397,673
2021-01-06,San Luis Obispo,79,281455,14071,12305,325,12630,115
2021-01-06,San Mateo,81,765935,30209,27050,152,27202,200
2021-01-06,Santa Barbara,83,443738,22178,19453,723,20176,177
2021-01-06,Santa Clara,85,1922200,84443,77485,367,77852,746
2021-01-06,Santa Cruz,87,273765,11571,9954,499,10453,97
2021-01-06,Shasta,89,179085,9185,8482,916,9398,78
2021-01-06,Sierra,91,2930,35,31,8,39,0
2021-01-06,Siskiyou,93,43540,1155,998,163,1161,3
2021-01-06,Solano,95,438530,23020,21102,252,21354,99
2021-01-06,Sonoma,97,501317,22049,20558,124,20682,196
2021-01-06,Stanislaus,99,539301,39435,36751,3962,40713,553
2021-01-06,Sutter,101,95872,7204,6839,54,6893,59
2021-01-06,Tehama,103,63373,3565,3306,380,3686,15
2021-01-06,Trinity,105,12862,315,246,31,277,2
2021-01-06,Tulare,107,460477,38601,35882,4891,40773,465
2021-01-06,Tuolumne,109,53932,3168,3008,52,3060,14
2021-01-06,Ventura,111,848112,53212,47428,1993,49421,280
2021-01-06,Yolo,113,214977,9986,9083,93,9176,127
2021-01-06,Yuba,115,75493,4397,4097,47,4144,25
2021-01-05,Alameda,1,1643700,60480,56432,1265,57697,602
2021-01-05,Alpine,3,1148,72,70,0,70,0
2021-01-05,Amador,5,37829,2877,2695,24,2719,24
2021-01-05,Butte,7,227075,8896,8008,1155,9163,107
2021-01-05,Calaveras,9,45235,1367,1292,7,1299,21
2021-01-05,Colusa,11,21464,1464,1376,126,1502,7
2021-01-05,Contra Costa,13,1133247,46866,43442,775,44217,353
2021-01-05,Del Norte,15,27424,804,770,0,770,2
2021-01-05,El Dorado,17,186661,7160,6270,421,6691,32
2021-01-05,Fresno,19,978130,76899,70971,5770,76741,741
2021-01-05,Glenn,21,27897,1786,1608,330,1938,9
2021-01-05,Humboldt,23,135768,2079,1884,6,1890,22
2021-01-05,Imperial,25,180216,24358,23165,1895,25060,421
2021-01-05,Inyo,27,18085,819,627,1,628,20
2021-01-05,Kern,29,883053,74383,68257,6515,74772,624
2021-01-05,Kings,31,150075,17875,16860,696,17556,108
2021-01-05,Lake,33,64148,2224,2015,0,2015,25
2021-01-05,Lassen,35,31185,4657,4554,58,4612,1
2021-01-05,Los Angeles,37,10098052,908753,823783,29430,853213,11028
2021-01-05,Madera,39,155013,12302,11359,574,11933,67
2021-01-05,Marin,41,260295,10689,10214,106,10320,151
2021-01-05,Mariposa,43,17540,304,257,3,260,3
2021-01-05,Mendocino,45,87422,2754,2501,29,2530,30
2021-01-05,Merced,47,269075,21452,20051,480,20531,230
2021-01-05,Modoc,49,8938,290,254,80,334,0
2021-01-05,Mono,51,14174,976,896,11,907,3
2021-01-05,Monterey,53,433212,31916,30045,876,30921,213
2021-01-05,Napa,55,140530,6822,6264,25,6289,29
2021-01-05,Nevada,57,99092,3078,2781,109,2890,15
2021-01-05,Orange,59,3164182,190938,174869,7936,182805,1918
2021-01-05,Placer,61,380077,16462,14723,738,15461,133
2021-01-05,Plumas,63,18699,528,428,10,438,2
2021-01-05,Riverside,65,2383286,217786,200439,10822,211261,2069
2021-01-05,Sacramento,67,1510023,73693,70677,781,71458,888
2021-01-05,San Benito,69,59416,4333,3961,38,3999,28
2021-01-05,San Bernardino,71,2135413,231739,212522,6541,219063,1615
2021-01-05,San Diego,73,3302833,193796,172845,0,172845,1654
2021-01-05,San Francisco,75,870044,26643,24989,313,25302,196
2021-01-05,San Joaquin,77,732212,52066,48969,2068,51037,663
2021-01-05,San Luis Obispo,79,281455,13672,12027,315,12342,106
2021-01-05,San Mateo,81,765935,29719,26486,150,26636,198
2021-01-05,Santa Barbara,83,443738,21745,19063,712,19775,172
2021-01-05,Santa Clara,85,1922200,82910,76355,353,76708,729
2021-01-05,Santa Cruz,87,273765,11300,9753,473,10226,93
2021-01-05,Shasta,89,179085,9080,8345,895,9240,73
2021-01-05,Sierra,91,2930,35,31,8,39,0
2021-01-05,Siskiyou,93,43540,1143,985,161,1146,3
2021-01-05,Solano,95,438530,22614,20860,247,21107,97
2021-01-05,Sonoma,97,501317,21683,20247,123,20370,194
2021-01-05,Stanislaus,99,539301,38892,36363,3914,40277,553
2021-01-05,Sutter,101,95872,7105,6769,53,6822,59
2021-01-05,Tehama,103,63373,3508,3255,375,3630,9
2021-01-05,Trinity,105,12862,315,246,31,277,2
2021-01-05,Tulare,107,460477,37984,35585,4748,40333,455
2021-01-05,Tuolumne,109,53932,3144,2996,47,3043,13
2021-01-05,Ventura,111,848112,51966,46456,1970,48426,264
2021-01-05,Yolo,113,214977,9813,8980,92,9072,127
2021-01-05,Yuba,115,75493,4339,4053,46,4099,21
2021-01-04,Alameda,1,1643700,59258,55899,1231,57130,583
2021-01-04,Alpine,3,1148,72,68,0,68,0
2021-01-04,Amador,5,37829,2837,2596,24,2620,24
2021-01-04,Butte,7,227075,8737,7893,1131,9024,105
2021-01-04,Calaveras,9,45235,1327,1276,6,1282,21
2021-01-04,Colusa,11,21464,1439,1368,112,1480,7
2021-01-04,Contra Costa,13,1133247,46011,43019,749,43768,353
2021-01-04,Del Norte,15,27424,795,770,0,770,2
2021-01-04,El Dorado,17,186661,7027,6152,405,6557,27
2021-01-04,Fresno,19,978130,75641,69871,5667,75538,726
2021-01-04,Glenn,21,27897,1755,1590,322,1912,9
2021-01-04,Humboldt,23,135768,2042,1845,6,1851,22
2021-01-04,Imperial,25,180216,24207,23035,1842,24877,420
2021-01-04,Inyo,27,18085,792,623,1,624,20
2021-01-04,Kern,29,883053,73308,67418,6308,73726,623
2021-01-04,Kings,31,150075,17604,16801,669,17470,108
2021-01-04,Lake,33,64148,2182,1984,0,1984,25
2021-01-04,Lassen,35,31185,4634,4550,57,4607,1
2021-01-04,Los Angeles,37,10098052,888741,813022,28512,841534,10790
2021-01-04,Madera,39,155013,12081,11204,552,11756,67
2021-01-04,Marin,41,260295,10555,10115,103,10218,151
2021-01-04,Mariposa,43,17540,298,253,3,256,3
2021-01-04,Mendocino,45,87422,2714,2460,25,2485,28
2021-01-04,Merced,47,269075,21038,19804,461,20265,230
2021-01-04,Modoc,49,8938,274,250,78,328,0
2021-01-04,Mono,51,14174,966,895,11,906,3
2021-01-04,Monterey,53,433212,31262,29659,853,30512,212
2021-01-04,Napa,55,140530,6681,6187,25,6212,29
2021-01-04,Nevada,57,99092,3041,2765,104,2869,15
2021-01-04,Orange,59,3164182,187023,172458,7804,180262,1918
2021-01-04,Placer,61,380077,16187,14622,724,15346,133
2021-01-04,Plumas,63,18699,518,419,10,429,1
2021-01-04,Riverside,65,2383286,213312,196809,10606,207415,2066
2021-01-04,Sacramento,67,1510023,72633,70164,771,70935,870
2021-01-04,San Benito,69,59416,4220,3914,38,3952,28
2021-01-04,San Bernardino,71,2135413,227532,210868,6374,217242,1615
2021-01-04,San Diego,73,3302833,189228,171031,0,171031,1598
2021-01-04,San Francisco,75,870044,26258,24753,306,25059,191
2021-01-04,San Joaquin,77,732212,51167,48644,2026,50670,661
2021-01-04,San Luis Obispo,79,281455,13186,11945,307,12252,96
2021-01-04,San Mateo,81,765935,29161,26150,145,26295,198
2021-01-04,Santa Barbara,83,443738,21230,18735,679,19414,165
2021-01-04,Santa Clara,85,1922200,81158,75297,346,75643,727
2021-01-04,Santa Cruz,87,273765,11013,9680,456,10136,85
2021-01-04,Shasta,89,179085,8973,8224,877,9101,72
2021-01-04,Sierra,91,2930,34,30,8,38,0
2021-01-04,Siskiyou,93,43540,1127,980,156,1136,3
2021-01-04,Solano,95,438530,22109,20588,240,20828,97
2021-01-04,Sonoma,97,501317,21345,20210,122,20332,194
2021-01-04,Stanislaus,99,539301,38332,36141,3855,39996,553
2021-01-04,Sutter,101,95872,7007,6712,52,6764,56
2021-01-04,Tehama,103,63373,3435,3190,369,3559,9
2021-01-04,Trinity,105,12862,312,245,31,276,2
2021-01-04,Tulare,107,460477,37423,35060,4640,39700,455
2021-01-04,Tuolumne,109,53932,3119,2987,47,3034,13
2021-01-04,Ventura,111,848112,50464,45014,1950,46964,255
2021-01-04,Yolo,113,214977,9618,8834,86,8920,121
2021-01-04,Yuba,115,75493,4280,4023,46,4069,21
2021-01-03,Alameda,1,1643700,58039,55082,1200,56282,580
2021-01-03,Alpine,3,1148,70,68,0,68,0
2021-01-03,Amador,5,37829,2773,2565,24,2589,24
2021-01-03,Butte,7,227075,8547,7837,1076,8913,105
2021-01-03,Calaveras,9,45235,1292,1249,4,1253,21
2021-01-03,Colusa,11,21464,1410,1337,106,1443,7
2021-01-03,Contra Costa,13,1133247,45119,42432,724,43156,352
2021-01-03,Del Norte,15,27424,783,768,0,768,2
2021-01-03,El Dorado,17,186661,6899,6034,388,6422,27
2021-01-03,Fresno,19,978130,74496,69326,5541,74867,719
2021-01-03,Glenn,21,27897,1730,1581,311,1892,9
2021-01-03,Humboldt,23,135768,2005,1833,6,1839,21
2021-01-03,Imperial,25,180216,23955,22951,1756,24707,419
2021-01-03,Inyo,27,18085,775,615,1,616,20
2021-01-03,Kern,29,883053,72059,66895,6124,73019,609
2021-01-03,Kings,31,150075,17337,16593,635,17228,108
2021-01-03,Lake,33,64148,2129,1976,0,1976,24
2021-01-03,Lassen,35,31185,4600,4531,56,4587,1
2021-01-03,Los Angeles,37,10098052,866843,792168,27405,819573,10633
2021-01-03,Madera,39,155013,11856,11152,528,11680,67
2021-01-03,Marin,41,260295,10406,10034,98,10132,150
2021-01-03,Mariposa,43,17540,291,248,3,251,3
2021-01-03,Mendocino,45,87422,2674,2445,24,2469,24
2021-01-03,Merced,47,269075,20568,19600,434,20034,230
2021-01-03,Modoc,49,8938,270,245,77,322,0
2021-01-03,Mono,51,14174,941,893,11,904,3
2021-01-03,Monterey,53,433212,30673,29357,816,30173,191
2021-01-03,Napa,55,140530,6580,6094,25,6119,29
2021-01-03,Nevada,57,99092,2982,2742,101,2843,15
2021-01-03,Orange,59,3164182,182862,169881,7608,177489,1919
2021-01-03,Placer,61,380077,15941,14319,699,15018,133
2021-01-03,Plumas,63,18699,505,416,10,426,1
2021-01-03,Riverside,65,2383286,208538,195048,10328,205376,2005
2021-01-03,Sacramento,67,1510023,71430,68558,749,69307,859
2021-01-03,San Benito,69,59416,4121,3882,37,3919,28
2021-01-03,San Bernardino,71,2135413,222246,208294,6194,214488,1592
2021-01-03,San Diego,73,3302833,183974,168018,0,168018,1592
2021-01-03,San Francisco,75,870044,25759,24588,288,24876,193
2021-01-03,San Joaquin,77,732212,50068,47899,1962,49861,661
2021-01-03,San Luis Obispo,79,281455,12718,11636,297,11933,95
2021-01-03,San Mateo,81,765935,28573,25770,139,25909,196
2021-01-03,Santa Barbara,83,443738,20513,18267,662,18929,164
2021-01-03,Santa Clara,85,1922200,79606,74534,340,74874,720
2021-01-03,Santa Cruz,87,273765,10713,9528,437,9965,84
2021-01-03,Shasta,89,179085,8846,8192,835,9027,72
2021-01-03,Sierra,91,2930,34,30,8,38,0
2021-01-03,Siskiyou,93,43540,1096,976,145,1121,3
2021-01-03,Solano,95,438530,21576,20105,235,20340,97
2021-01-03,Sonoma,97,501317,20963,19982,118,20100,193
2021-01-03,Stanislaus,99,539301,37645,35762,3771,39533,553
2021-01-03,Sutter,101,95872,6909,6664,51,6715,53
2021-01-03,Tehama,103,63373,3375,3176,360,3536,9
2021-01-03,Trinity,105,12862,309,243,30,273,2
2021-01-03,Tulare,107,460477,36872,34747,4494,39241,455
2021-01-03,Tuolumne,109,53932,3057,2978,44,3022,13
2021-01-03,Ventura,111,848112,48640,43748,1932,45680,254
2021-01-03,Yolo,113,214977,9456,8674,82,8756,121
2021-01-03,Yuba,115,75493,4226,3966,45,4011,20
2021-01-02,Alameda,1,1643700,57450,54518,1170,55688,581
2021-01-02,Alpine,3,1148,70,68,0,68,0
2021-01-02,Amador,5,37829,2754,2540,24,2564,24
2021-01-02,Butte,7,227075,8440,7750,1055,8805,105
2021-01-02,Calaveras,9,45235,1273,1230,4,1234,21
2021-01-02,Colusa,11,21464,1400,1332,105,1437,7
2021-01-02,Contra Costa,13,1133247,44596,41993,712,42705,352
2021-01-02,Del Norte,15,27424,781,764,0,764,2
2021-01-02,El Dorado,17,186661,6844,5959,384,6343,27
2021-01-02,Fresno,19,978130,73965,68740,5426,74166,717
2021-01-02,Glenn,21,27897,1715,1546,310,1856,9
2021-01-02,Humboldt,23,135768,1981,1815,6,1821,21
2021-01-02,Imperial,25,180216,23877,22867,1716,24583,420
2021-01-02,Inyo,27,18085,762,609,1,610,20
2021-01-02,Kern,29,883053,71345,66457,6015,72472,610
2021-01-02,Kings,31,150075,17245,16515,631,17146,108
2021-01-02,Lake,33,64148,2092,1925,0,1925,24
2021-01-02,Lassen,35,31185,4589,4457,55,4512,1
2021-01-02,Los Angeles,37,10098052,858574,791892,26666,818558,10633
2021-01-02,Madera,39,155013,11747,11039,516,11555,67
2021-01-02,Marin,41,260295,10361,9924,95,10019,151
2021-01-02,Mariposa,43,17540,284,243,3,246,3
2021-01-02,Mendocino,45,87422,2632,2428,23,2451,24
2021-01-02,Merced,47,269075,20427,19395,417,19812,230
2021-01-02,Modoc,49,8938,269,245,77,322,0
2021-01-02,Mono,51,14174,931,884,11,895,3
2021-01-02,Monterey,53,433212,30466,28991,805,29796,191
2021-01-02,Napa,55,140530,6521,5994,25,6019,29
2021-01-02,Nevada,57,99092,2955,2706,97,2803,15
2021-01-02,Orange,59,3164182,180709,168457,7450,175907,1918
2021-01-02,Placer,61,380077,15768,14182,689,14871,133
2021-01-02,Plumas,63,18699,502,413,10,423,1
2021-01-02,Riverside,65,2383286,205986,192069,10080,202149,2008
2021-01-02,Sacramento,67,1510023,70788,67810,734,68544,858
2021-01-02,San Benito,69,59416,4041,3829,37,3866,28
2021-01-02,San Bernardino,71,2135413,220632,206939,6059,212998,1597
2021-01-02,San Diego,73,3302833,181382,164498,0,164498,1592
2021-01-02,San Francisco,75,870044,25499,24414,281,24695,194
2021-01-02,San Joaquin,77,732212,49706,47310,1930,49240,662
2021-01-02,San Luis Obispo,79,281455,12585,11467,292,11759,95
2021-01-02,San Mateo,81,765935,28236,25483,131,25614,196
2021-01-02,Santa Barbara,83,443738,20229,18135,658,18793,164
2021-01-02,Santa Clara,85,1922200,78438,73662,333,73995,720
2021-01-02,Santa Cruz,87,273765,10562,9340,428,9768,85
2021-01-02,Shasta,89,179085,8780,8154,822,8976,72
2021-01-02,Sierra,91,2930,34,28,8,36,0
2021-01-02,Siskiyou,93,43540,1085,949,143,1092,3
2021-01-02,Solano,95,438530,21380,19805,225,20030,97
2021-01-02,Sonoma,97,501317,20808,19761,118,19879,194
2021-01-02,Stanislaus,99,539301,37334,35431,3702,39133,553
2021-01-02,Sutter,101,95872,6854,6621,51,6672,53
2021-01-02,Tehama,103,63373,3350,3146,355,3501,9
2021-01-02,Trinity,105,12862,306,243,30,273,2
2021-01-02,Tulare,107,460477,36556,34479,4424,38903,455
2021-01-02,Tuolumne,109,53932,3043,2942,42,2984,13
2021-01-02,Ventura,111,848112,47490,43397,1897,45294,254
2021-01-02,Yolo,113,214977,9364,8571,80,8651,122
2021-01-02,Yuba,115,75493,4188,3930,44,3974,21
2021-01-01,Alameda,1,1643700,56817,53518,1153,54671,579
2021-01-01,Alpine,3,1148,70,68,0,68,0
2021-01-01,Amador,5,37829,2728,2513,22,2535,24
2021-01-01,Butte,7,227075,8339,7589,1030,8619,105
2021-01-01,Calaveras,9,45235,1258,1186,4,1190,21
2021-01-01,Colusa,11,21464,1391,1314,103,1417,7
2021-01-01,Contra Costa,13,1133247,44121,41412,690,42102,351
2021-01-01,Del Norte,15,27424,775,758,0,758,2
2021-01-01,El Dorado,17,186661,6755,5832,373,6205,27
2021-01-01,Fresno,19,978130,72900,67484,5335,72819,717
2021-01-01,Glenn,21,27897,1699,1520,307,1827,9
2021-01-01,Humboldt,23,135768,1943,1783,6,1789,21
2021-01-01,Imperial,25,180216,23792,22715,1665,24380,418
2021-01-01,Inyo,27,18085,738,606,1,607,20
2021-01-01,Kern,29,883053,70524,65571,5901,71472,609
2021-01-01,Kings,31,150075,17062,16358,625,16983,108
2021-01-01,Lake,33,64148,2061,1888,0,1888,24
2021-01-01,Lassen,35,31185,4583,4377,55,4432,1
2021-01-01,Los Angeles,37,10098052,844447,775578,25935,801513,10515
2021-01-01,Madera,39,155013,11587,10752,507,11259,66
2021-01-01,Marin,41,260295,10256,9821,95,9916,148
2021-01-01,Mariposa,43,17540,276,236,3,239,3
2021-01-01,Mendocino,45,87422,2578,2400,23,2423,24
2021-01-01,Merced,47,269075,20244,19118,401,19519,229
2021-01-01,Modoc,49,8938,269,241,77,318,0
2021-01-01,Mono,51,14174,913,884,11,895,3
2021-01-01,Monterey,53,433212,30236,28465,797,29262,191
2021-01-01,Napa,55,140530,6435,5899,25,5924,28
2021-01-01,Nevada,57,99092,2931,2663,97,2760,15
2021-01-01,Orange,59,3164182,177950,165440,7299,172739,1893
2021-01-01,Placer,61,380077,15603,13987,671,14658,133
2021-01-01,Plumas,63,18699,497,412,10,422,1
2021-01-01,Riverside,65,2383286,202762,188674,9797,198471,1990
2021-01-01,Sacramento,67,1510023,70188,66956,716,67672,848
2021-01-01,San Benito,69,59416,4005,3773,37,3810,28
2021-01-01,San Bernardino,71,2135413,217808,203651,5920,209571,1590
2021-01-01,San Diego,73,3302833,178322,160071,0,160071,1592
2021-01-01,San Francisco,75,870044,25224,24145,269,24414,187
2021-01-01,San Joaquin,77,732212,49425,46640,1882,48522,657
2021-01-01,San Luis Obispo,79,281455,12363,11160,284,11444,94
2021-01-01,San Mateo,81,765935,27787,25041,127,25168,194
2021-01-01,Santa Barbara,83,443738,19910,17759,648,18407,164
2021-01-01,Santa Clara,85,1922200,77170,71904,328,72232,680
2021-01-01,Santa Cruz,87,273765,10385,9146,416,9562,84
2021-01-01,Shasta,89,179085,8699,8102,804,8906,72
2021-01-01,Sierra,91,2930,34,26,8,34,0
2021-01-01,Siskiyou,93,43540,1071,944,138,1082,3
2021-01-01,Solano,95,438530,21168,19393,223,19616,97
2021-01-01,Sonoma,97,501317,20625,19513,118,19631,189
2021-01-01,Stanislaus,99,539301,37058,34978,3634,38612,553
2021-01-01,Sutter,101,95872,6798,6553,50,6603,52
2021-01-01,Tehama,103,63373,3294,3079,346,3425,9
2021-01-01,Trinity,105,12862,306,243,30,273,2
2021-01-01,Tulare,107,460477,36151,33994,4322,38316,454
2021-01-01,Tuolumne,109,53932,3027,2909,42,2951,13
2021-01-01,Ventura,111,848112,45999,42026,1869,43895,253
2021-01-01,Yolo,113,214977,9251,8461,78,8539,120
2021-01-01,Yuba,115,75493,4129,3845,43,3888,19
2020-12-31,Alameda,1,1643700,56315,52475,1121,53596,579
2020-12-31,Alpine,3,1148,70,66,0,66,0
2020-12-31,Amador,5,37829,2714,2493,22,2515,24
2020-12-31,Butte,7,227075,8266,7405,1011,8416,105
2020-12-31,Calaveras,9,45235,1247,1161,4,1165,21
2020-12-31,Colusa,11,21464,1383,1301,100,1401,7
2020-12-31,Contra Costa,13,1133247,43750,40512,676,41188,336
2020-12-31,Del Norte,15,27424,774,748,0,748,2
2020-12-31,El Dorado,17,186661,6703,5662,364,6026,26
2020-12-31,Fresno,19,978130,72483,66442,5271,71713,711
2020-12-31,Glenn,21,27897,1679,1484,302,1786,9
2020-12-31,Humboldt,23,135768,1926,1713,6,1719,21
2020-12-31,Imperial,25,180216,23729,22494,1650,24144,417
2020-12-31,Inyo,27,18085,730,591,1,592,20
2020-12-31,Kern,29,883053,70059,64904,5806,70710,609
2020-12-31,Kings,31,150075,16987,16077,617,16694,108
2020-12-31,Lake,33,64148,2047,1848,0,1848,23
2020-12-31,Lassen,35,31185,4577,4340,54,4394,1
2020-12-31,Los Angeles,37,10098052,839179,755844,25440,781284,10320
2020-12-31,Madera,39,155013,11520,10609,496,11105,64
2020-12-31,Marin,41,260295,10215,9731,94,9825,148
2020-12-31,Mariposa,43,17540,274,217,3,220,3
2020-12-31,Mendocino,45,87422,2563,2367,19,2386,24
2020-12-31,Merced,47,269075,20157,18808,391,19199,226
2020-12-31,Modoc,49,8938,269,238,77,315,0
2020-12-31,Mono,51,14174,906,868,11,879,3
2020-12-31,Monterey,53,433212,30048,27720,785,28505,188
2020-12-31,Napa,55,140530,6372,5801,25,5826,28
2020-12-31,Nevada,57,99092,2908,2619,95,2714,15
2020-12-31,Orange,59,3164182,176128,161586,7166,168752,1866
2020-12-31,Placer,61,380077,15453,13708,668,14376,126
2020-12-31,Plumas,63,18699,492,401,9,410,1
2020-12-31,Riverside,65,2383286,201266,184193,9631,193824,1958
2020-12-31,Sacramento,67,1510023,69671,65817,704,66521,830
2020-12-31,San Benito,69,59416,3983,3673,37,3710,28
2020-12-31,San Bernardino,71,2135413,216256,199115,5847,204962,1586
2020-12-31,San Diego,73,3302833,176560,155593,0,155593,1534
2020-12-31,San Francisco,75,870044,24999,23740,261,24001,183
2020-12-31,San Joaquin,77,732212,49122,45764,1841,47605,646
2020-12-31,San Luis Obispo,79,281455,12253,10846,284,11130,89
2020-12-31,San Mateo,81,765935,27463,24570,122,24692,192
2020-12-31,Santa Barbara,83,443738,19668,17434,641,18075,161
2020-12-31,Santa Clara,85,1922200,76407,70032,323,70355,665
2020-12-31,Santa Cruz,87,273765,10267,8909,403,9312,84
2020-12-31,Shasta,89,179085,8634,7996,793,8789,69
2020-12-31,Sierra,91,2930,34,26,8,34,0
2020-12-31,Siskiyou,93,43540,1055,940,135,1075,3
2020-12-31,Solano,95,438530,20941,18942,222,19164,97
2020-12-31,Sonoma,97,501317,20511,19129,117,19246,188
2020-12-31,Stanislaus,99,539301,36764,34398,3578,37976,552
2020-12-31,Sutter,101,95872,6768,6432,49,6481,51
2020-12-31,Tehama,103,63373,3265,3036,345,3381,9
2020-12-31,Trinity,105,12862,305,241,30,271,2
2020-12-31,Tulare,107,460477,35992,33412,4268,37680,446
2020-12-31,Tuolumne,109,53932,3018,2902,42,2944,12
2020-12-31,Ventura,111,848112,45493,40854,1851,42705,251
2020-12-31,Yolo,113,214977,9168,8295,77,8372,117
2020-12-31,Yuba,115,75493,4090,3799,42,3841,18
2020-12-30,Alameda,1,1643700,55554,50158,1070,51228,573
2020-12-30,Alpine,3,1148,70,66,0,66,0
2020-12-30,Amador,5,37829,2694,2418,21,2439,24
2020-12-30,Butte,7,227075,8106,7140,994,8134,103
2020-12-30,Calaveras,9,45235,1222,1135,4,1139,21
2020-12-30,Colusa,11,21464,1367,1289,94,1383,7
2020-12-30,Contra Costa,13,1133247,43168,39601,664,40265,337
2020-12-30,Del Norte,15,27424,769,726,0,726,2
2020-12-30,El Dorado,17,186661,6604,5595,352,5947,27
2020-12-30,Fresno,19,978130,71644,65566,5105,70671,711
2020-12-30,Glenn,21,27897,1650,1471,289,1760,9
2020-12-30,Humboldt,23,135768,1893,1654,6,1660,22
2020-12-30,Imperial,25,180216,23563,22098,1573,23671,412
2020-12-30,Inyo,27,18085,723,572,1,573,20
2020-12-30,Kern,29,883053,69339,63292,5654,68946,604
2020-12-30,Kings,31,150075,16868,15862,609,16471,108
2020-12-30,Lake,33,64148,2025,1731,0,1731,23
2020-12-30,Lassen,35,31185,4568,4300,54,4354,1
2020-12-30,Los Angeles,37,10098052,828342,741907,24711,766618,10046
2020-12-30,Madera,39,155013,11410,10249,485,10734,65
2020-12-30,Marin,41,260295,10127,9569,87,9656,148
2020-12-30,Mariposa,43,17540,270,214,3,217,3
2020-12-30,Mendocino,45,87422,2545,2291,17,2308,24
2020-12-30,Merced,47,269075,19864,18519,381,18900,225
2020-12-30,Modoc,49,8938,266,234,77,311,0
2020-12-30,Mono,51,14174,903,868,11,879,3
2020-12-30,Monterey,53,433212,29441,26977,762,27739,186
2020-12-30,Napa,55,140530,6267,5754,25,5779,28
2020-12-30,Nevada,57,99092,2873,2595,93,2688,15
2020-12-30,Orange,59,3164182,173469,153951,6970,160921,1863
2020-12-30,Placer,61,380077,15201,13540,656,14196,127
2020-12-30,Plumas,63,18699,487,397,9,406,1
2020-12-30,Riverside,65,2383286,198326,176402,9440,185842,1919
2020-12-30,Sacramento,67,1510023,68800,64119,686,64805,847
2020-12-30,San Benito,69,59416,3902,3464,33,3497,29
2020-12-30,San Bernardino,71,2135413,213682,192648,5757,198405,1591
2020-12-30,San Diego,73,3302833,172931,152510,0,152510,1472
2020-12-30,San Francisco,75,870044,24708,23099,255,23354,182
2020-12-30,San Joaquin,77,732212,48435,44465,1798,46263,634
2020-12-30,San Luis Obispo,79,281455,11987,10542,276,10818,89
2020-12-30,San Mateo,81,765935,27032,24150,119,24269,190
2020-12-30,Santa Barbara,83,443738,19277,16895,617,17512,161
2020-12-30,Santa Clara,85,1922200,75142,67218,319,67537,661
2020-12-30,Santa Cruz,87,273765,10074,8787,393,9180,86
2020-12-30,Shasta,89,179085,8522,7818,779,8597,69
2020-12-30,Sierra,91,2930,34,25,8,33,0
2020-12-30,Siskiyou,93,43540,1048,913,125,1038,3
2020-12-30,Solano,95,438530,20545,18300,219,18519,96
2020-12-30,Sonoma,97,501317,20252,18947,117,19064,191
2020-12-30,Stanislaus,99,539301,36285,33730,3502,37232,526
2020-12-30,Sutter,101,95872,6707,6328,48,6376,51
2020-12-30,Tehama,103,63373,3221,2969,341,3310,9
2020-12-30,Trinity,105,12862,304,231,30,261,2
2020-12-30,Tulare,107,460477,35439,32413,4200,36613,430
2020-12-30,Tuolumne,109,53932,3006,2772,40,2812,12
2020-12-30,Ventura,111,848112,44205,39039,1823,40862,251
2020-12-30,Yolo,113,214977,9062,8067,74,8141,117
2020-12-30,Yuba,115,75493,4022,3612,42,3654,18
2020-12-29,Alameda,1,1643700,54499,50946,1033,51979,552
2020-12-29,Alpine,3,1148,70,65,0,65,0
2020-12-29,Amador,5,37829,2642,2388,20,2408,23
2020-12-29,Butte,7,227075,7935,7178,970,8148,98
2020-12-29,Calaveras,9,45235,1176,1111,3,1114,21
2020-12-29,Colusa,11,21464,1346,1272,89,1361,7
2020-12-29,Contra Costa,13,1133247,42366,39225,633,39858,325
2020-12-29,Del Norte,15,27424,762,724,0,724,2
2020-12-29,El Dorado,17,186661,6476,5551,337,5888,22
2020-12-29,Fresno,19,978130,70275,65149,4943,70092,688
2020-12-29,Glenn,21,27897,1616,1454,282,1736,9
2020-12-29,Humboldt,23,135768,1845,1616,6,1622,19
2020-12-29,Imperial,25,180216,23354,22105,1482,23587,407
2020-12-29,Inyo,27,18085,706,571,1,572,19
2020-12-29,Kern,29,883053,68185,63096,5475,68571,589
2020-12-29,Kings,31,150075,16700,15777,597,16374,108
2020-12-29,Lake,33,64148,1993,1805,0,1805,22
2020-12-29,Lassen,35,31185,4553,4288,54,4342,1
2020-12-29,Los Angeles,37,10098052,808219,731907,23803,755710,9786
2020-12-29,Madera,39,155013,11096,10251,469,10720,64
2020-12-29,Marin,41,260295,9976,9595,84,9679,146
2020-12-29,Mariposa,43,17540,262,212,3,215,3
2020-12-29,Mendocino,45,87422,2502,2249,16,2265,24
2020-12-29,Merced,47,269075,19514,18464,366,18830,221
2020-12-29,Modoc,49,8938,263,232,77,309,0
2020-12-29,Mono,51,14174,894,868,11,879,3
2020-12-29,Monterey,53,433212,28806,26894,734,27628,185
2020-12-29,Napa,55,140530,6147,5663,25,5688,28
2020-12-29,Nevada,57,99092,2825,2550,92,2642,15
2020-12-29,Orange,59,3164182,169626,154411,6795,161206,1839
2020-12-29,Placer,61,380077,14963,13392,633,14025,126
2020-12-29,Plumas,63,18699,478,395,9,404,1
2020-12-29,Riverside,65,2383286,193729,177624,9174,186798,1904
2020-12-29,Sacramento,67,1510023,67764,65078,671,65749,820
2020-12-29,San Benito,69,59416,3783,3474,32,3506,25
2020-12-29,San Bernardino,71,2135413,208856,190476,5616,196092,1557
2020-12-29,San Diego,73,3302833,168710,150062,0,150062,1435
2020-12-29,San Francisco,75,870044,24373,22996,246,23242,178
2020-12-29,San Joaquin,77,732212,47521,44699,1741,46440,622
2020-12-29,San Luis Obispo,79,281455,11693,10387,268,10655,80
2020-12-29,San Mateo,81,765935,26494,23773,111,23884,189
2020-12-29,Santa Barbara,83,443738,18814,16797,591,17388,155
2020-12-29,Santa Clara,85,1922200,73601,67581,316,67897,621
2020-12-29,Santa Cruz,87,273765,9804,8492,384,8876,84
2020-12-29,Shasta,89,179085,8417,7782,764,8546,65
2020-12-29,Sierra,91,2930,31,24,7,31,0
2020-12-29,Siskiyou,93,43540,1033,926,123,1049,3
2020-12-29,Solano,95,438530,20163,18412,214,18626,96
2020-12-29,Sonoma,97,501317,19917,18790,115,18905,187
2020-12-29,Stanislaus,99,539301,35787,33775,3438,37213,508
2020-12-29,Sutter,101,95872,6639,6302,48,6350,50
2020-12-29,Tehama,103,63373,3154,2962,326,3288,9
2020-12-29,Trinity,105,12862,303,241,30,271,2
2020-12-29,Tulare,107,460477,34780,32545,4068,36613,419
2020-12-29,Tuolumne,109,53932,2964,2797,40,2837,12
2020-12-29,Ventura,111,848112,42957,38669,1795,40464,235
2020-12-29,Yolo,113,214977,8932,8124,72,8196,111
2020-12-29,Yuba,115,75493,3942,3723,42,3765,18
2020-12-28,Alameda,1,1643700,53467,50405,1010,51415,551
2020-12-28,Alpine,3,1148,69,65,0,65,0
2020-12-28,Amador,5,37829,2572,2255,20,2275,23
2020-12-28,Butte,7,227075,7769,7053,940,7993,86
2020-12-28,Calaveras,9,45235,1154,1102,3,1105,21
2020-12-28,Colusa,11,21464,1322,1255,74,1329,7
2020-12-28,Contra Costa,13,1133247,41434,38872,606,39478,324
2020-12-28,Del Norte,15,27424,752,718,0,718,2
2020-12-28,El Dorado,17,186661,6320,5441,324,5765,18
2020-12-28,Fresno,19,978130,69009,64274,4785,69059,679
2020-12-28,Glenn,21,27897,1582,1435,270,1705,9
2020-12-28,Humboldt,23,135768,1810,1579,6,1585,19
2020-12-28,Imperial,25,180216,23092,22003,1406,23409,405
2020-12-28,Inyo,27,18085,699,569,1,570,19
2020-12-28,Kern,29,883053,67127,62392,5266,67658,579
2020-12-28,Kings,31,150075,16484,15733,579,16312,108
2020-12-28,Lake,33,64148,1951,1785,0,1785,22
2020-12-28,Lassen,35,31185,4446,4284,53,4337,1
2020-12-28,Los Angeles,37,10098052,785931,720699,22951,743650,9544
2020-12-28,Madera,39,155013,10922,10123,446,10569,64
2020-12-28,Marin,41,260295,9867,9546,77,9623,145
2020-12-28,Mariposa,43,17540,238,211,3,214,3
2020-12-28,Mendocino,45,87422,2467,2214,16,2230,23
2020-12-28,Merced,47,269075,19193,18245,348,18593,213
2020-12-28,Modoc,49,8938,258,220,76,296,0
2020-12-28,Mono,51,14174,890,848,11,859,3
2020-12-28,Monterey,53,433212,27975,26529,721,27250,182
2020-12-28,Napa,55,140530,6038,5576,25,5601,26
2020-12-28,Nevada,57,99092,2778,2532,87,2619,15
2020-12-28,Orange,59,3164182,165492,152089,6616,158705,1839
2020-12-28,Placer,61,380077,14622,13234,605,13839,126
2020-12-28,Plumas,63,18699,474,391,9,400,0
2020-12-28,Riverside,65,2383286,188898,174029,8864,182893,1855
2020-12-28,Sacramento,67,1510023,66537,64322,646,64968,813
2020-12-28,San Benito,69,59416,3712,3429,31,3460,24
2020-12-28,San Bernardino,71,2135413,203763,188919,5493,194412,1552
2020-12-28,San Diego,73,3302833,163972,147528,0,147528,1404
2020-12-28,San Francisco,75,870044,24011,22726,240,22966,178
2020-12-28,San Joaquin,77,732212,46586,44172,1710,45882,618
2020-12-28,San Luis Obispo,79,281455,11341,10260,263,10523,76
2020-12-28,San Mateo,81,765935,26025,23467,108,23575,189
2020-12-28,Santa Barbara,83,443738,18357,16579,577,17156,155
2020-12-28,Santa Clara,85,1922200,72111,66418,309,66727,619
2020-12-28,Santa Cruz,87,273765,9538,8310,374,8684,81
2020-12-28,Shasta,89,179085,8299,7688,750,8438,65
2020-12-28,Sierra,91,2930,29,24,7,31,0
2020-12-28,Siskiyou,93,43540,1018,915,117,1032,3
2020-12-28,Solano,95,438530,19588,18171,208,18379,96
2020-12-28,Sonoma,97,501317,19573,18667,113,18780,185
2020-12-28,Stanislaus,99,539301,35242,33473,3372,36845,507
2020-12-28,Sutter,101,95872,6556,6253,48,6301,49
2020-12-28,Tehama,103,63373,3101,2934,317,3251,9
2020-12-28,Trinity,105,12862,301,240,30,270,2
2020-12-28,Tulare,107,460477,34098,32010,3956,35966,404
2020-12-28,Tuolumne,109,53932,2948,2777,40,2817,12
2020-12-28,Ventura,111,848112,41291,37151,1745,38896,230
2020-12-28,Yolo,113,214977,8777,8031,71,8102,111
2020-12-28,Yuba,115,75493,3880,3679,41,3720,18
2020-12-27,Alameda,1,1643700,52232,49764,981,50745,551
2020-12-27,Alpine,3,1148,67,65,0,65,0
2020-12-27,Amador,5,37829,2451,2218,20,2238,23
2020-12-27,Butte,7,227075,7615,7016,903,7919,86
2020-12-27,Calaveras,9,45235,1109,1097,3,1100,21
2020-12-27,Colusa,11,21464,1297,1253,71,1324,7
2020-12-27,Contra Costa,13,1133247,40515,38428,576,39004,324
2020-12-27,Del Norte,15,27424,729,712,0,712,2
2020-12-27,El Dorado,17,186661,6107,5388,298,5686,18
2020-12-27,Fresno,19,978130,67771,63811,4569,68380,679
2020-12-27,Glenn,21,27897,1556,1434,255,1689,9
2020-12-27,Humboldt,23,135768,1767,1575,6,1581,17
2020-12-27,Imperial,25,180216,22806,21934,1287,23221,405
2020-12-27,Inyo,27,18085,677,565,1,566,18
2020-12-27,Kern,29,883053,65856,61914,5094,67008,568
2020-12-27,Kings,31,150075,16249,15593,543,16136,108
2020-12-27,Lake,33,64148,1894,1769,0,1769,22
2020-12-27,Lassen,35,31185,4369,4230,46,4276,1
2020-12-27,Los Angeles,37,10098052,764541,707260,22004,729264,9476
2020-12-27,Madera,39,155013,10664,10005,436,10441,64
2020-12-27,Marin,41,260295,9744,9477,72,9549,144
2020-12-27,Mariposa,43,17540,231,208,3,211,3
2020-12-27,Mendocino,45,87422,2419,2209,16,2225,23
2020-12-27,Merced,47,269075,18825,18075,332,18407,213
2020-12-27,Modoc,49,8938,249,221,72,293,0
2020-12-27,Mono,51,14174,871,849,11,860,3
2020-12-27,Monterey,53,433212,27433,26322,704,27026,181
2020-12-27,Napa,55,140530,5903,5496,25,5521,26
2020-12-27,Nevada,57,99092,2742,2519,87,2606,15
2020-12-27,Orange,59,3164182,161098,149276,6420,155696,1839
2020-12-27,Placer,61,380077,14333,13017,572,13589,126
2020-12-27,Plumas,63,18699,468,390,9,399,0
2020-12-27,Riverside,65,2383286,184089,171995,8547,180542,1836
2020-12-27,Sacramento,67,1510023,65336,63416,620,64036,811
2020-12-27,San Benito,69,59416,3626,3394,31,3425,24
2020-12-27,San Bernardino,71,2135413,198708,186776,5345,192121,1551
2020-12-27,San Diego,73,3302833,159567,145777,0,145777,1402
2020-12-27,San Francisco,75,870044,23664,22514,231,22745,178
2020-12-27,San Joaquin,77,732212,45549,43529,1657,45186,618
2020-12-27,San Luis Obispo,79,281455,10932,10154,258,10412,76
2020-12-27,San Mateo,81,765935,25460,23136,104,23240,187
2020-12-27,Santa Barbara,83,443738,17840,16364,548,16912,155
2020-12-27,Santa Clara,85,1922200,70489,65288,303,65591,619
2020-12-27,Santa Cruz,87,273765,9271,8234,365,8599,81
2020-12-27,Shasta,89,179085,8175,7671,725,8396,65
2020-12-27,Sierra,91,2930,29,24,6,30,0
2020-12-27,Siskiyou,93,43540,1007,914,112,1026,3
2020-12-27,Solano,95,438530,19096,17840,202,18042,96
2020-12-27,Sonoma,97,501317,19287,18487,112,18599,185
2020-12-27,Stanislaus,99,539301,34641,33076,3276,36352,506
2020-12-27,Sutter,101,95872,6474,6218,46,6264,48
2020-12-27,Tehama,103,63373,3030,2922,299,3221,9
2020-12-27,Trinity,105,12862,297,240,28,268,2
2020-12-27,Tulare,107,460477,33507,31864,3836,35700,400
2020-12-27,Tuolumne,109,53932,2841,2750,38,2788,12
2020-12-27,Ventura,111,848112,40231,36661,1691,38352,230
2020-12-27,Yolo,113,214977,8586,7919,64,7983,111
2020-12-27,Yuba,115,75493,3818,3665,39,3704,18
2020-12-26,Alameda,1,1643700,51625,49084,968,50052,551
2020-12-26,Alpine,3,1148,67,65,0,65,0
2020-12-26,Amador,5,37829,2437,2189,20,2209,23
2020-12-26,Butte,7,227075,7521,6968,881,7849,86
2020-12-26,Calaveras,9,45235,1103,1084,3,1087,21
2020-12-26,Colusa,11,21464,1287,1240,71,1311,7
2020-12-26,Contra Costa,13,1133247,40055,38008,562,38570,324
2020-12-26,Del Norte,15,27424,723,709,0,709,2
2020-12-26,El Dorado,17,186661,6052,5279,293,5572,18
2020-12-26,Fresno,19,978130,67304,63080,4504,67584,679
2020-12-26,Glenn,21,27897,1535,1413,249,1662,9
2020-12-26,Humboldt,23,135768,1729,1545,6,1551,17
2020-12-26,Imperial,25,180216,22717,21734,1235,22969,405
2020-12-26,Inyo,27,18085,664,554,1,555,18
2020-12-26,Kern,29,883053,65193,61174,4934,66108,564
2020-12-26,Kings,31,150075,16131,15517,538,16055,108
2020-12-26,Lake,33,64148,1852,1710,0,1710,22
2020-12-26,Lassen,35,31185,4348,3981,46,4027,1
2020-12-26,Los Angeles,37,10098052,756038,694149,21464,715613,9424
2020-12-26,Madera,39,155013,10590,9908,422,10330,64
2020-12-26,Marin,41,260295,9709,9413,71,9484,143
2020-12-26,Mariposa,43,17540,230,206,3,209,3
2020-12-26,Mendocino,45,87422,2373,2194,16,2210,23
2020-12-26,Merced,47,269075,18668,17890,327,18217,213
2020-12-26,Modoc,49,8938,246,222,72,294,0
2020-12-26,Mono,51,14174,865,850,11,861,3
2020-12-26,Monterey,53,433212,27300,26010,695,26705,182
2020-12-26,Napa,55,140530,5845,5427,25,5452,26
2020-12-26,Nevada,57,99092,2714,2480,87,2567,15
2020-12-26,Orange,59,3164182,158941,147304,6321,153625,1838
2020-12-26,Placer,61,380077,14168,12816,556,13372,122
2020-12-26,Plumas,63,18699,465,381,9,390,0
2020-12-26,Riverside,65,2383286,181661,169360,8382,177742,1834
2020-12-26,Sacramento,67,1510023,64714,62435,610,63045,807
2020-12-26,San Benito,69,59416,3553,3330,31,3361,24
2020-12-26,San Bernardino,71,2135413,197063,185111,5257,190368,1551
2020-12-26,San Diego,73,3302833,157046,142644,0,142644,1402
2020-12-26,San Francisco,75,870044,23431,22319,230,22549,177
2020-12-26,San Joaquin,77,732212,45163,42887,1608,44495,618
2020-12-26,San Luis Obispo,79,281455,10846,9945,252,10197,76
2020-12-26,San Mateo,81,765935,25122,22908,98,23006,187
2020-12-26,Santa Barbara,83,443738,17603,16159,542,16701,155
2020-12-26,Santa Clara,85,1922200,69428,64185,300,64485,618
2020-12-26,Santa Cruz,87,273765,9147,8113,355,8468,81
2020-12-26,Shasta,89,179085,8116,7641,711,8352,65
2020-12-26,Sierra,91,2930,29,24,6,30,0
2020-12-26,Siskiyou,93,43540,1001,909,107,1016,2
2020-12-26,Solano,95,438530,18856,17528,202,17730,96
2020-12-26,Sonoma,97,501317,19088,18261,110,18371,184
2020-12-26,Stanislaus,99,539301,34351,32678,3225,35903,505
2020-12-26,Sutter,101,95872,6415,6121,46,6167,48
2020-12-26,Tehama,103,63373,3003,2884,293,3177,9
2020-12-26,Trinity,105,12862,297,237,27,264,2
2020-12-26,Tulare,107,460477,33211,31665,3782,35447,398
2020-12-26,Tuolumne,109,53932,2830,2703,38,2741,12
2020-12-26,Ventura,111,848112,39269,36064,1656,37720,230
2020-12-26,Yolo,113,214977,8483,7785,62,7847,111
2020-12-26,Yuba,115,75493,3791,3599,39,3638,18
2020-12-25,Alameda,1,1643700,51065,48365,952,49317,542
2020-12-25,Alpine,3,1148,67,64,0,64,0
2020-12-25,Amador,5,37829,2394,2172,20,2192,23
2020-12-25,Butte,7,227075,7424,6873,860,7733,85
2020-12-25,Calaveras,9,45235,1100,1062,3,1065,21
2020-12-25,Colusa,11,21464,1275,1219,70,1289,7
2020-12-25,Contra Costa,13,1133247,39583,37480,536,38016,324
2020-12-25,Del Norte,15,27424,720,692,0,692,2
2020-12-25,El Dorado,17,186661,5988,5170,278,5448,16
2020-12-25,Fresno,19,978130,66446,62251,4415,66666,679
2020-12-25,Glenn,21,27897,1520,1390,241,1631,9
2020-12-25,Humboldt,23,135768,1691,1532,6,1538,16
2020-12-25,Imperial,25,180216,22626,21646,1223,22869,405
2020-12-25,Inyo,27,18085,655,546,1,547,18
2020-12-25,Kern,29,883053,64471,60417,4782,65199,562
2020-12-25,Kings,31,150075,16021,15460,533,15993,108
2020-12-25,Lake,33,64148,1832,1669,0,1669,20
2020-12-25,Lassen,35,31185,4333,3926,46,3972,1
2020-12-25,Los Angeles,37,10098052,742425,665600,20754,686354,9292
2020-12-25,Madera,39,155013,10420,9770,414,10184,64
2020-12-25,Marin,41,260295,9661,9375,68,9443,143
2020-12-25,Mariposa,43,17540,224,203,3,206,3
2020-12-25,Mendocino,45,87422,2331,2176,16,2192,23
2020-12-25,Merced,47,269075,18508,17726,320,18046,213
2020-12-25,Modoc,49,8938,245,221,72,293,0
2020-12-25,Mono,51,14174,863,843,11,854,3
2020-12-25,Monterey,53,433212,27029,25788,686,26474,182
2020-12-25,Napa,55,140530,5765,5351,25,5376,26
2020-12-25,Nevada,57,99092,2688,2458,85,2543,15
2020-12-25,Orange,59,3164182,156297,144542,6118,150660,1814
2020-12-25,Placer,61,380077,13986,12660,533,13193,122
2020-12-25,Plumas,63,18699,458,381,9,390,0
2020-12-25,Riverside,65,2383286,178418,166690,8051,174741,1825
2020-12-25,Sacramento,67,1510023,64020,61630,583,62213,796
2020-12-25,San Benito,69,59416,3515,3281,29,3310,24
2020-12-25,San Bernardino,71,2135413,194427,181812,5136,186948,1546
2020-12-25,San Diego,73,3302833,154566,139958,0,139958,1402
2020-12-25,San Francisco,75,870044,23155,22130,225,22355,175
2020-12-25,San Joaquin,77,732212,44859,42089,1549,43638,614
2020-12-25,San Luis Obispo,79,281455,10663,9749,245,9994,76
2020-12-25,San Mateo,81,765935,24799,22568,95,22663,187
2020-12-25,Santa Barbara,83,443738,17380,15936,533,16469,155
2020-12-25,Santa Clara,85,1922200,68312,63173,291,63464,612
2020-12-25,Santa Cruz,87,273765,9007,8018,331,8349,81
2020-12-25,Shasta,89,179085,8043,7612,688,8300,65
2020-12-25,Sierra,91,2930,29,24,5,29,0
2020-12-25,Siskiyou,93,43540,995,905,104,1009,2
2020-12-25,Solano,95,438530,18685,17280,200,17480,96
2020-12-25,Sonoma,97,501317,18912,18035,108,18143,184
2020-12-25,Stanislaus,99,539301,34061,32290,3176,35466,498
2020-12-25,Sutter,101,95872,6356,6051,45,6096,47
2020-12-25,Tehama,103,63373,2959,2839,278,3117,9
2020-12-25,Trinity,105,12862,294,236,27,263,2
2020-12-25,Tulare,107,460477,32834,31323,3714,35037,398
2020-12-25,Tuolumne,109,53932,2811,2674,38,2712,12
2020-12-25,Ventura,111,848112,38116,35514,1605,37119,230
2020-12-25,Yolo,113,214977,8383,7700,60,7760,111
2020-12-25,Yuba,115,75493,3756,3549,38,3587,17
2020-12-24,Alameda,1,1643700,50737,47527,931,48458,541
2020-12-24,Alpine,3,1148,67,64,0,64,0
2020-12-24,Amador,5,37829,2382,2145,20,2165,23
2020-12-24,Butte,7,227075,7386,6716,845,7561,84
2020-12-24,Calaveras,9,45235,1096,1032,3,1035,21
2020-12-24,Colusa,11,21464,1270,1188,69,1257,7
2020-12-24,Contra Costa,13,1133247,39338,36623,524,37147,311
2020-12-24,Del Norte,15,27424,720,678,0,678,2
2020-12-24,El Dorado,17,186661,5962,5042,270,5312,16
2020-12-24,Fresno,19,978130,66223,61435,4401,65836,663
2020-12-24,Glenn,21,27897,1509,1363,233,1596,9
2020-12-24,Humboldt,23,135768,1668,1516,6,1522,16
2020-12-24,Imperial,25,180216,22577,21545,1214,22759,402
2020-12-24,Inyo,27,18085,653,532,1,533,17
2020-12-24,Kern,29,883053,64186,59601,4769,64370,556
2020-12-24,Kings,31,150075,15981,15211,532,15743,108
2020-12-24,Lake,33,64148,1821,1629,0,1629,20
2020-12-24,Lassen,35,31185,4320,3894,46,3940,1
2020-12-24,Los Angeles,37,10098052,738281,664840,20483,685323,9288
2020-12-24,Madera,39,155013,10382,9547,407,9954,63
2020-12-24,Marin,41,260295,9628,9287,68,9355,143
2020-12-24,Mariposa,43,17540,220,197,3,200,3
2020-12-24,Mendocino,45,87422,2321,2150,16,2166,23
2020-12-24,Merced,47,269075,18438,17485,316,17801,212
2020-12-24,Modoc,49,8938,245,220,71,291,0
2020-12-24,Mono,51,14174,861,817,11,828,3
2020-12-24,Monterey,53,433212,26926,25131,679,25810,180
2020-12-24,Napa,55,140530,5711,5265,25,5290,26
2020-12-24,Nevada,57,99092,2664,2429,85,2514,15
2020-12-24,Orange,59,3164182,154853,141205,6069,147274,1775
2020-12-24,Placer,61,380077,13908,12457,526,12983,121
2020-12-24,Plumas,63,18699,455,376,9,385,0
2020-12-24,Riverside,65,2383286,177514,162435,8012,170447,1816
2020-12-24,Sacramento,67,1510023,63745,60596,581,61177,788
2020-12-24,San Benito,69,59416,3485,3183,29,3212,24
2020-12-24,San Bernardino,71,2135413,193421,176866,5101,181967,1533
2020-12-24,San Diego,73,3302833,153484,136952,0,136952,1382
2020-12-24,San Francisco,75,870044,22991,21830,222,22052,175
2020-12-24,San Joaquin,77,732212,44698,41324,1530,42854,611
2020-12-24,San Luis Obispo,79,281455,10595,9504,243,9747,77
2020-12-24,San Mateo,81,765935,24601,22093,95,22188,186
2020-12-24,Santa Barbara,83,443738,17276,15644,525,16169,153
2020-12-24,Santa Clara,85,1922200,67710,61742,284,62026,591
2020-12-24,Santa Cruz,87,273765,8937,7856,318,8174,82
2020-12-24,Shasta,89,179085,8003,7540,670,8210,65
2020-12-24,Sierra,91,2930,27,23,2,25,0
2020-12-24,Siskiyou,93,43540,991,900,97,997,2
2020-12-24,Solano,95,438530,18544,16872,195,17067,96
2020-12-24,Sonoma,97,501317,18814,17710,108,17818,183
2020-12-24,Stanislaus,99,539301,33867,31848,3151,34999,498
2020-12-24,Sutter,101,95872,6315,5960,44,6004,47
2020-12-24,Tehama,103,63373,2943,2779,278,3057,9
2020-12-24,Trinity,105,12862,293,235,27,262,2
2020-12-24,Tulare,107,460477,32720,30827,3687,34514,390
2020-12-24,Tuolumne,109,53932,2803,2653,38,2691,12
2020-12-24,Ventura,111,848112,37838,34400,1598,35998,224
2020-12-24,Yolo,113,214977,8344,7566,60,7626,113
2020-12-24,Yuba,115,75493,3731,3483,38,3521,16
2020-12-23,Alameda,1,1643700,50172,46753,903,47656,537
2020-12-23,Alpine,3,1148,67,64,0,64,0
2020-12-23,Amador,5,37829,2314,2108,19,2127,23
2020-12-23,Butte,7,227075,7300,6588,817,7405,84
2020-12-23,Calaveras,9,45235,1089,1002,2,1004,21
2020-12-23,Colusa,11,21464,1259,1167,69,1236,7
2020-12-23,Contra Costa,13,1133247,38940,36190,510,36700,311
2020-12-23,Del Norte,15,27424,713,670,0,670,2
2020-12-23,El Dorado,17,186661,5888,4967,261,5228,14
2020-12-23,Fresno,19,978130,65617,60488,4332,64820,654
2020-12-23,Glenn,21,27897,1495,1349,229,1578,9
2020-12-23,Humboldt,23,135768,1643,1458,6,1464,16
2020-12-23,Imperial,25,180216,22483,21323,1184,22507,399
2020-12-23,Inyo,27,18085,641,517,1,518,17
2020-12-23,Kern,29,883053,63674,58656,4670,63326,549
2020-12-23,Kings,31,150075,15903,14923,529,15452,105
2020-12-23,Lake,33,64148,1806,1595,0,1595,20
2020-12-23,Lassen,35,31185,4310,3865,43,3908,1
2020-12-23,Los Angeles,37,10098052,729278,651958,19909,671867,9146
2020-12-23,Madera,39,155013,10226,9371,392,9763,63
2020-12-23,Marin,41,260295,9570,9199,65,9264,142
2020-12-23,Mariposa,43,17540,218,194,3,197,3
2020-12-23,Mendocino,45,87422,2309,2121,16,2137,23
2020-12-23,Merced,47,269075,18282,17250,309,17559,203
2020-12-23,Modoc,49,8938,241,197,70,267,0
2020-12-23,Mono,51,14174,859,814,11,825,3
2020-12-23,Monterey,53,433212,26628,24856,673,25529,176
2020-12-23,Napa,55,140530,5643,5172,25,5197,25
2020-12-23,Nevada,57,99092,2619,2406,84,2490,15
2020-12-23,Orange,59,3164182,152420,138050,5895,143945,1771
2020-12-23,Placer,61,380077,13702,12213,518,12731,111
2020-12-23,Plumas,63,18699,448,369,9,378,0
2020-12-23,Riverside,65,2383286,175291,158110,7843,165953,1790
2020-12-23,Sacramento,67,1510023,63100,59661,566,60227,779
2020-12-23,San Benito,69,59416,3430,3073,27,3100,24
2020-12-23,San Bernardino,71,2135413,191391,172888,5032,177920,1509
2020-12-23,San Diego,73,3302833,151063,134695,0,134695,1350
2020-12-23,San Francisco,75,870044,22768,21498,219,21717,174
2020-12-23,San Joaquin,77,732212,44175,35664,1488,37152,602
2020-12-23,San Luis Obispo,79,281455,10454,9267,237,9504,74
2020-12-23,San Mateo,81,765935,24297,21780,93,21873,186
2020-12-23,Santa Barbara,83,443738,17069,15399,495,15894,152
2020-12-23,Santa Clara,85,1922200,66803,60455,279,60734,579
2020-12-23,Santa Cruz,87,273765,8777,7637,300,7937,75
2020-12-23,Shasta,89,179085,7930,7487,663,8150,66
2020-12-23,Sierra,91,2930,27,23,0,23,0
2020-12-23,Siskiyou,93,43540,971,891,94,985,2
2020-12-23,Solano,95,438530,18337,16626,190,16816,95
2020-12-23,Sonoma,97,501317,18610,17397,108,17505,182
2020-12-23,Stanislaus,99,539301,33527,31492,3093,34585,499
2020-12-23,Sutter,101,95872,6250,5871,44,5915,46
2020-12-23,Tehama,103,63373,2922,2737,274,3011,9
2020-12-23,Trinity,105,12862,293,234,27,261,2
2020-12-23,Tulare,107,460477,32426,30315,3645,33960,385
2020-12-23,Tuolumne,109,53932,2763,2540,38,2578,12
2020-12-23,Ventura,111,848112,37449,33377,1564,34941,216
2020-12-23,Yolo,113,214977,8264,7508,58,7566,112
2020-12-23,Yuba,115,75493,3680,3438,37,3475,14
2020-12-22,Alameda,1,1643700,49287,45751,870,46621,534
2020-12-22,Alpine,3,1148,67,64,0,64,0
2020-12-22,Amador,5,37829,2303,1839,19,1858,23
2020-12-22,Butte,7,227075,7173,6467,800,7267,85
2020-12-22,Calaveras,9,45235,1062,988,1,989,21
2020-12-22,Colusa,11,21464,1236,1150,65,1215,7
2020-12-22,Contra Costa,13,1133247,38317,35681,497,36178,301
2020-12-22,Del Norte,15,27424,707,666,0,666,2
2020-12-22,El Dorado,17,186661,5767,4885,247,5132,12
2020-12-22,Fresno,19,978130,64590,59640,4217,63857,640
2020-12-22,Glenn,21,27897,1472,1337,218,1555,9
2020-12-22,Humboldt,23,135768,1609,1440,6,1446,16
2020-12-22,Imperial,25,180216,22296,21128,1141,22269,398
2020-12-22,Inyo,27,18085,620,506,1,507,17
2020-12-22,Kern,29,883053,62733,57816,4522,62338,547
2020-12-22,Kings,31,150075,15764,14855,522,15377,102
2020-12-22,Lake,33,64148,1782,1569,0,1569,20
2020-12-22,Lassen,35,31185,4168,3848,41,3889,1
2020-12-22,Los Angeles,37,10098052,712078,635931,19177,655108,9013
2020-12-22,Madera,39,155013,10108,9187,376,9563,63
2020-12-22,Marin,41,260295,9507,9115,64,9179,142
2020-12-22,Mariposa,43,17540,215,194,3,197,3
2020-12-22,Mendocino,45,87422,2276,2092,16,2108,23
2020-12-22,Merced,47,269075,18037,17012,305,17317,201
2020-12-22,Modoc,49,8938,233,182,69,251,0
2020-12-22,Mono,51,14174,849,786,11,797,3
2020-12-22,Monterey,53,433212,25966,24152,653,24805,176
2020-12-22,Napa,55,140530,5556,5059,25,5084,23
2020-12-22,Nevada,57,99092,2592,2367,83,2450,14
2020-12-22,Orange,59,3164182,149048,134850,5719,140569,1774
2020-12-22,Placer,61,380077,13472,11943,497,12440,105
2020-12-22,Plumas,63,18699,442,360,9,369,0
2020-12-22,Riverside,65,2383286,171525,155059,7560,162619,1777
2020-12-22,Sacramento,67,1510023,62175,57966,546,58512,772
2020-12-22,San Benito,69,59416,3353,2998,27,3025,24
2020-12-22,San Bernardino,71,2135413,186822,169266,4879,174145,1500
2020-12-22,San Diego,73,3302833,147710,132097,0,132097,1311
2020-12-22,San Francisco,75,870044,22499,21232,215,21447,174
2020-12-22,San Joaquin,77,732212,43422,39423,1440,40863,592
2020-12-22,San Luis Obispo,79,281455,10110,9174,232,9406,69
2020-12-22,San Mateo,81,765935,23969,21382,79,21461,186
2020-12-22,Santa Barbara,83,443738,16808,15189,485,15674,150
2020-12-22,Santa Clara,85,1922200,65639,59192,272,59464,569
2020-12-22,Santa Cruz,87,273765,8599,7471,273,7744,72
2020-12-22,Shasta,89,179085,7851,7371,645,8016,64
2020-12-22,Sierra,91,2930,27,23,0,23,0
2020-12-22,Siskiyou,93,43540,966,880,91,971,2
2020-12-22,Solano,95,438530,17933,16229,187,16416,95
2020-12-22,Sonoma,97,501317,18291,17216,108,17324,180
2020-12-22,Stanislaus,99,539301,33151,30914,3018,33932,499
2020-12-22,Sutter,101,95872,6189,5791,43,5834,46
2020-12-22,Tehama,103,63373,2875,2688,266,2954,9
2020-12-22,Trinity,105,12862,293,231,27,258,2
2020-12-22,Tulare,107,460477,31964,30025,3573,33598,377
2020-12-22,Tuolumne,109,53932,2708,2526,38,2564,12
2020-12-22,Ventura,111,848112,36690,32488,1515,34003,213
2020-12-22,Yolo,113,214977,8151,7388,57,7445,113
2020-12-22,Yuba,115,75493,3630,3379,37,3416,14
2020-12-21,Alameda,1,1643700,48389,44756,841,45597,518
2020-12-21,Alpine,3,1148,66,64,0,64,0
2020-12-21,Amador,5,37829,2226,1815,19,1834,23
2020-12-21,Butte,7,227075,7018,6335,776,7111,81
2020-12-21,Calaveras,9,45235,1032,963,1,964,21
2020-12-21,Colusa,11,21464,1209,1135,60,1195,7
2020-12-21,Contra Costa,13,1133247,37570,35207,460,35667,300
2020-12-21,Del Norte,15,27424,696,660,0,660,2
2020-12-21,El Dorado,17,186661,5622,4805,233,5038,10
2020-12-21,Fresno,19,978130,63444,58568,4064,62632,634
2020-12-21,Glenn,21,27897,1440,1323,210,1533,9
2020-12-21,Humboldt,23,135768,1585,1419,6,1425,16
2020-12-21,Imperial,25,180216,22025,20994,1098,22092,395
2020-12-21,Inyo,27,18085,599,482,1,483,17
2020-12-21,Kern,29,883053,61843,56836,4381,61217,541
2020-12-21,Kings,31,150075,15514,14760,506,15266,100
2020-12-21,Lake,33,64148,1728,1538,0,1538,20
2020-12-21,Lassen,35,31185,4008,3798,39,3837,1
2020-12-21,Los Angeles,37,10098052,693079,624129,18456,642585,8918
2020-12-21,Madera,39,155013,9916,9069,356,9425,63
2020-12-21,Marin,41,260295,9438,9035,64,9099,142
2020-12-21,Mariposa,43,17540,210,186,3,189,3
2020-12-21,Mendocino,45,87422,2246,2066,15,2081,23
2020-12-21,Merced,47,269075,17789,16710,288,16998,198
2020-12-21,Modoc,49,8938,219,181,68,249,0
2020-12-21,Mono,51,14174,837,781,11,792,3
2020-12-21,Monterey,53,433212,25435,23673,639,24312,174
2020-12-21,Napa,55,140530,5468,4952,25,4977,23
2020-12-21,Nevada,57,99092,2559,2337,83,2420,13
2020-12-21,Orange,59,3164182,145648,130444,5561,136005,1772
2020-12-21,Placer,61,380077,13247,11715,477,12192,105
2020-12-21,Plumas,63,18699,438,353,9,362,0
2020-12-21,Riverside,65,2383286,167332,151713,7214,158927,1743
2020-12-21,Sacramento,67,1510023,61159,57064,528,57592,759
2020-12-21,San Benito,69,59416,3284,2921,27,2948,22
2020-12-21,San Bernardino,71,2135413,182055,165086,4703,169789,1476
2020-12-21,San Diego,73,3302833,144264,129716,0,129716,1284
2020-12-21,San Francisco,75,870044,22217,21086,211,21297,174
2020-12-21,San Joaquin,77,732212,42627,38811,1386,40197,586
2020-12-21,San Luis Obispo,79,281455,9922,9006,227,9233,64
2020-12-21,San Mateo,81,765935,23564,21035,75,21110,185
2020-12-21,Santa Barbara,83,443738,16537,14988,480,15468,149
2020-12-21,Santa Clara,85,1922200,64447,57699,260,57959,570
2020-12-21,Santa Cruz,87,273765,8386,7315,259,7574,69
2020-12-21,Shasta,89,179085,7786,7299,635,7934,64
2020-12-21,Sierra,91,2930,24,23,0,23,0
2020-12-21,Siskiyou,93,43540,958,878,90,968,2
2020-12-21,Solano,95,438530,17463,15878,182,16060,95
2020-12-21,Sonoma,97,501317,18016,17075,104,17179,176
2020-12-21,Stanislaus,99,539301,32697,30437,2942,33379,499
2020-12-21,Sutter,101,95872,6094,5708,43,5751,46
2020-12-21,Tehama,103,63373,2809,2656,257,2913,9
2020-12-21,Trinity,105,12862,291,226,27,253,2
2020-12-21,Tulare,107,460477,31478,29482,3478,32960,373
2020-12-21,Tuolumne,109,53932,2683,2423,36,2459,12
2020-12-21,Ventura,111,848112,35609,31759,1478,33237,212
2020-12-21,Yolo,113,214977,8007,7266,53,7319,109
2020-12-21,Yuba,115,75493,3571,3329,37,3366,14
2020-12-20,Alameda,1,1643700,47505,44004,819,44823,516
2020-12-20,Alpine,3,1148,66,64,0,64,0
2020-12-20,Amador,5,37829,2168,1771,18,1789,23
2020-12-20,Butte,7,227075,6871,6228,738,6966,81
2020-12-20,Calaveras,9,45235,1008,926,1,927,21
2020-12-20,Colusa,11,21464,1182,1121,52,1173,7
2020-12-20,Contra Costa,13,1133247,36984,34798,441,35239,301
2020-12-20,Del Norte,15,27424,674,652,0,652,2
2020-12-20,El Dorado,17,186661,5493,4697,224,4921,10
2020-12-20,Fresno,19,978130,62462,57616,3920,61536,634
2020-12-20,Glenn,21,27897,1431,1295,203,1498,9
2020-12-20,Humboldt,23,135768,1548,1386,5,1391,15
2020-12-20,Imperial,25,180216,21783,20882,992,21874,395
2020-12-20,Inyo,27,18085,585,476,1,477,17
2020-12-20,Kern,29,883053,60749,55983,4221,60204,540
2020-12-20,Kings,31,150075,15296,14629,486,15115,100
2020-12-20,Lake,33,64148,1680,1463,0,1463,20
2020-12-20,Lassen,35,31185,3953,3669,37,3706,1
2020-12-20,Los Angeles,37,10098052,675080,612975,17677,630652,8862
2020-12-20,Madera,39,155013,9706,8871,346,9217,63
2020-12-20,Marin,41,260295,9341,8948,60,9008,142
2020-12-20,Mariposa,43,17540,209,179,3,182,3
2020-12-20,Mendocino,45,87422,2221,2033,15,2048,23
2020-12-20,Merced,47,269075,17473,16435,281,16716,198
2020-12-20,Modoc,49,8938,219,181,66,247,0
2020-12-20,Mono,51,14174,816,774,11,785,3
2020-12-20,Monterey,53,433212,24961,23250,595,23845,173
2020-12-20,Napa,55,140530,5346,4865,23,4888,23
2020-12-20,Nevada,57,99092,2513,2289,77,2366,13
2020-12-20,Orange,59,3164182,142167,128780,5404,134184,1763
2020-12-20,Placer,61,380077,13015,11496,458,11954,105
2020-12-20,Plumas,63,18699,430,347,9,356,0
2020-12-20,Riverside,65,2383286,163157,148714,6913,155627,1742
2020-12-20,Sacramento,67,1510023,60166,56017,509,56526,755
2020-12-20,San Benito,69,59416,3212,2885,26,2911,21
2020-12-20,San Bernardino,71,2135413,177096,162810,4540,167350,1458
2020-12-20,San Diego,73,3302833,140551,126465,0,126465,1280
2020-12-20,San Francisco,75,870044,21902,20937,207,21144,174
2020-12-20,San Joaquin,77,732212,41791,38268,1321,39589,587
2020-12-20,San Luis Obispo,79,281455,9629,8881,220,9101,63
2020-12-20,San Mateo,81,765935,23129,20764,71,20835,185
2020-12-20,Santa Barbara,83,443738,16223,14817,458,15275,148
2020-12-20,Santa Clara,85,1922200,63045,56860,254,57114,566
2020-12-20,Santa Cruz,87,273765,8181,7178,246,7424,69
2020-12-20,Shasta,89,179085,7672,7256,619,7875,64
2020-12-20,Sierra,91,2930,24,22,0,22,0
2020-12-20,Siskiyou,93,43540,948,870,89,959,2
2020-12-20,Solano,95,438530,17085,15533,171,15704,95
2020-12-20,Sonoma,97,501317,17741,16802,103,16905,175
2020-12-20,Stanislaus,99,539301,32176,29995,2838,32833,498
2020-12-20,Sutter,101,95872,6007,5601,43,5644,43
2020-12-20,Tehama,103,63373,2762,2602,237,2839,9
2020-12-20,Trinity,105,12862,286,221,26,247,2
2020-12-20,Tulare,107,460477,30964,29078,3378,32456,373
2020-12-20,Tuolumne,109,53932,2571,2152,35,2187,12
2020-12-20,Ventura,111,848112,34908,31335,1443,32778,210
2020-12-20,Yolo,113,214977,7853,7121,50,7171,109
2020-12-20,Yuba,115,75493,3523,3254,35,3289,12
2020-12-19,Alameda,1,1643700,47065,43109,812,43921,516
2020-12-19,Alpine,3,1148,66,64,0,64,0
2020-12-19,Amador,5,37829,2144,1754,18,1772,23
2020-12-19,Butte,7,227075,6771,6118,714,6832,81
2020-12-19,Calaveras,9,45235,990,900,1,901,21
2020-12-19,Colusa,11,21464,1174,1096,50,1146,7
2020-12-19,Contra Costa,13,1133247,36674,34321,425,34746,301
2020-12-19,Del Norte,15,27424,672,641,0,641,2
2020-12-19,El Dorado,17,186661,5427,4588,215,4803,10
2020-12-19,Fresno,19,978130,62141,55428,3850,59278,634
2020-12-19,Glenn,21,27897,1396,1286,202,1488,9
2020-12-19,Humboldt,23,135768,1531,1357,5,1362,15
2020-12-19,Imperial,25,180216,21696,20711,941,21652,395
2020-12-19,Inyo,27,18085,578,475,1,476,17
2020-12-19,Kern,29,883053,60269,55118,4109,59227,540
2020-12-19,Kings,31,150075,15217,14474,484,14958,100
2020-12-19,Lake,33,64148,1647,1438,0,1438,20
2020-12-19,Lassen,35,31185,3925,3595,37,3632,1
2020-12-19,Los Angeles,37,10098052,668050,599888,17119,617007,8804
2020-12-19,Madera,39,155013,9615,8717,335,9052,63
2020-12-19,Marin,41,260295,9302,8864,60,8924,142
2020-12-19,Mariposa,43,17540,207,177,3,180,3
2020-12-19,Mendocino,45,87422,2196,2008,15,2023,23
2020-12-19,Merced,47,269075,17335,16230,272,16502,198
2020-12-19,Modoc,49,8938,216,181,66,247,0
2020-12-19,Mono,51,14174,812,766,11,777,3
2020-12-19,Monterey,53,433212,24850,22799,589,23388,172
2020-12-19,Napa,55,140530,5284,4772,23,4795,23
2020-12-19,Nevada,57,99092,2491,2260,77,2337,13
2020-12-19,Orange,59,3164182,140280,125574,5247,130821,1733
2020-12-19,Placer,61,380077,12862,11246,452,11698,105
2020-12-19,Plumas,63,18699,427,343,9,352,0
2020-12-19,Riverside,65,2383286,161195,146703,6670,153373,1737
2020-12-19,Sacramento,67,1510023,59635,55169,494,55663,746
2020-12-19,San Benito,69,59416,3166,2820,25,2845,21
2020-12-19,San Bernardino,71,2135413,175556,159883,4426,164309,1433
2020-12-19,San Diego,73,3302833,138785,122972,0,122972,1280
2020-12-19,San Francisco,75,870044,21752,20643,206,20849,174
2020-12-19,San Joaquin,77,732212,41392,37340,1265,38605,586
2020-12-19,San Luis Obispo,79,281455,9559,8788,217,9005,63
2020-12-19,San Mateo,81,765935,22919,20393,64,20457,182
2020-12-19,Santa Barbara,83,443738,16068,14667,450,15117,148
2020-12-19,Santa Clara,85,1922200,62237,55540,249,55789,558
2020-12-19,Santa Cruz,87,273765,8079,7054,240,7294,68
2020-12-19,Shasta,89,179085,7619,7221,607,7828,63
2020-12-19,Sierra,91,2930,24,23,0,23,0
2020-12-19,Siskiyou,93,43540,945,853,88,941,2
2020-12-19,Solano,95,438530,16919,15204,167,15371,95
2020-12-19,Sonoma,97,501317,17634,16553,103,16656,175
2020-12-19,Stanislaus,99,539301,31858,29555,2764,32319,498
2020-12-19,Sutter,101,95872,5949,5506,43,5549,41
2020-12-19,Tehama,103,63373,2711,2574,234,2808,9
2020-12-19,Trinity,105,12862,286,219,26,245,2
2020-12-19,Tulare,107,460477,30747,28734,3309,32043,375
2020-12-19,Tuolumne,109,53932,2558,2107,35,2142,12
2020-12-19,Ventura,111,848112,34629,30843,1412,32255,209
2020-12-19,Yolo,113,214977,7784,7025,49,7074,109
2020-12-19,Yuba,115,75493,3491,3168,35,3203,11
2020-12-18,Alameda,1,1643700,46529,42196,795,42991,515
2020-12-18,Alpine,3,1148,66,64,0,64,0
2020-12-18,Amador,5,37829,2127,1727,16,1743,20
2020-12-18,Butte,7,227075,6687,5891,687,6578,81
2020-12-18,Calaveras,9,45235,981,870,1,871,21
2020-12-18,Colusa,11,21464,1165,1068,50,1118,7
2020-12-18,Contra Costa,13,1133247,36393,33610,411,34021,300
2020-12-18,Del Norte,15,27424,667,627,0,627,2
2020-12-18,El Dorado,17,186661,5366,4494,204,4698,10
2020-12-18,Fresno,19,978130,61314,52643,3786,56429,613
2020-12-18,Glenn,21,27897,1380,1264,196,1460,9
2020-12-18,Humboldt,23,135768,1516,1331,5,1336,15
2020-12-18,Imperial,25,180216,21618,20430,894,21324,393
2020-12-18,Inyo,27,18085,558,454,1,455,17
2020-12-18,Kern,29,883053,59613,54220,4023,58243,533
2020-12-18,Kings,31,150075,15092,14284,478,14762,98
2020-12-18,Lake,33,64148,1637,1397,0,1397,20
2020-12-18,Lassen,35,31185,3917,3486,37,3523,1
2020-12-18,Los Angeles,37,10098052,655984,586413,16596,603009,8744
2020-12-18,Madera,39,155013,9513,8609,330,8939,63
2020-12-18,Marin,41,260295,9219,8799,60,8859,142
2020-12-18,Mariposa,43,17540,204,176,3,179,3
2020-12-18,Mendocino,45,87422,2178,1977,15,1992,24
2020-12-18,Merced,47,269075,17254,15956,269,16225,195
2020-12-18,Modoc,49,8938,216,179,66,245,0
2020-12-18,Mono,51,14174,806,731,11,742,3
2020-12-18,Monterey,53,433212,24558,22336,583,22919,165
2020-12-18,Napa,55,140530,5236,4688,23,4711,23
2020-12-18,Nevada,57,99092,2474,2220,76,2296,13
2020-12-18,Orange,59,3164182,137863,121681,5088,126769,1725
2020-12-18,Placer,61,380077,12698,10995,443,11438,104
2020-12-18,Plumas,63,18699,421,336,9,345,0
2020-12-18,Riverside,65,2383286,158378,142375,6395,148770,1733
2020-12-18,Sacramento,67,1510023,59007,53980,476,54456,736
2020-12-18,San Benito,69,59416,3118,2744,25,2769,21
2020-12-18,San Bernardino,71,2135413,173269,154272,4291,158563,1430
2020-12-18,San Diego,73,3302833,136611,120463,0,120463,1253
2020-12-18,San Francisco,75,870044,21586,20315,200,20515,173
2020-12-18,San Joaquin,77,732212,41036,36484,1229,37713,559
2020-12-18,San Luis Obispo,79,281455,9460,8598,212,8810,62
2020-12-18,San Mateo,81,765935,22604,19971,60,20031,182
2020-12-18,Santa Barbara,83,443738,15928,14361,437,14798,148
2020-12-18,Santa Clara,85,1922200,61369,53992,236,54228,539
2020-12-18,Santa Cruz,87,273765,7964,6838,232,7070,68
2020-12-18,Shasta,89,179085,7583,7114,595,7709,62
2020-12-18,Sierra,91,2930,24,23,0,23,0
2020-12-18,Siskiyou,93,43540,943,840,88,928,2
2020-12-18,Solano,95,438530,16767,14667,163,14830,95
2020-12-18,Sonoma,97,501317,17514,16261,103,16364,173
2020-12-18,Stanislaus,99,539301,31589,28967,2725,31692,490
2020-12-18,Sutter,101,95872,5865,5399,43,5442,39
2020-12-18,Tehama,103,63373,2694,2523,225,2748,9
2020-12-18,Trinity,105,12862,285,215,26,241,2
2020-12-18,Tulare,107,460477,30481,28322,3223,31545,370
2020-12-18,Tuolumne,109,53932,2547,2067,35,2102,12
2020-12-18,Ventura,111,848112,34128,29907,1368,31275,209
2020-12-18,Yolo,113,214977,7716,6901,48,6949,109
2020-12-18,Yuba,115,75493,3433,3097,35,3132,11
2020-12-17,Alameda,1,1643700,45727,41548,762,42310,508
2020-12-17,Alpine,3,1148,66,64,0,64,0
2020-12-17,Amador,5,37829,2079,1703,14,1717,19
2020-12-17,Butte,7,227075,6563,5746,667,6413,78
2020-12-17,Calaveras,9,45235,958,848,1,849,21
2020-12-17,Colusa,11,21464,1154,1053,48,1101,7
2020-12-17,Contra Costa,13,1133247,35872,33006,376,33382,293
2020-12-17,Del Norte,15,27424,662,583,0,583,1
2020-12-17,El Dorado,17,186661,5224,4327,191,4518,9
2020-12-17,Fresno,19,978130,60456,49918,3656,53574,597
2020-12-17,Glenn,21,27897,1356,1244,189,1433,9
2020-12-17,Humboldt,23,135768,1483,1322,5,1327,14
2020-12-17,Imperial,25,180216,21460,20208,817,21025,391
2020-12-17,Inyo,27,18085,540,450,1,451,16
2020-12-17,Kern,29,883053,58665,53683,3881,57564,526
2020-12-17,Kings,31,150075,14993,14057,462,14519,98
2020-12-17,Lake,33,64148,1612,1374,0,1374,20
2020-12-17,Lassen,35,31185,3881,3417,37,3454,1
2020-12-17,Los Angeles,37,10098052,640420,571093,16007,587100,8657
2020-12-17,Madera,39,155013,9397,8465,325,8790,62
2020-12-17,Marin,41,260295,9162,8721,57,8778,142
2020-12-17,Mariposa,43,17540,200,172,3,175,3
2020-12-17,Mendocino,45,87422,2144,1942,15,1957,23
2020-12-17,Merced,47,269075,16991,15648,261,15909,192
2020-12-17,Modoc,49,8938,213,179,66,245,0
2020-12-17,Mono,51,14174,797,718,11,729,3
2020-12-17,Monterey,53,433212,24039,21951,568,22519,163
2020-12-17,Napa,55,140530,5124,4612,23,4635,23
2020-12-17,Nevada,57,99092,2433,2173,73,2246,13
2020-12-17,Orange,59,3164182,134496,118367,4952,123319,1725
2020-12-17,Placer,61,380077,12430,10756,429,11185,99
2020-12-17,Plumas,63,18699,412,324,9,333,0
2020-12-17,Riverside,65,2383286,154537,139325,6171,145496,1696
2020-12-17,Sacramento,67,1510023,58104,53189,453,53642,721
2020-12-17,San Benito,69,59416,3048,2645,24,2669,20
2020-12-17,San Bernardino,71,2135413,169351,149838,4166,154004,1425
2020-12-17,San Diego,73,3302833,133817,116852,0,116852,1239
2020-12-17,San Francisco,75,870044,21297,19939,195,20134,170
2020-12-17,San Joaquin,77,732212,40308,35894,1192,37086,554
2020-12-17,San Luis Obispo,79,281455,9340,8365,210,8575,59
2020-12-17,San Mateo,81,765935,22232,19647,60,19707,181
2020-12-17,Santa Barbara,83,443738,15695,14207,430,14637,147
2020-12-17,Santa Clara,85,1922200,60202,52559,229,52788,527
2020-12-17,Santa Cruz,87,273765,7809,6687,217,6904,64
2020-12-17,Shasta,89,179085,7507,7000,576,7576,62
2020-12-17,Sierra,91,2930,23,23,0,23,0
2020-12-17,Siskiyou,93,43540,936,827,87,914,2
2020-12-17,Solano,95,438530,16459,14361,161,14522,96
2020-12-17,Sonoma,97,501317,17242,15993,102,16095,171
2020-12-17,Stanislaus,99,539301,31165,28582,2664,31246,489
2020-12-17,Sutter,101,95872,5766,5309,42,5351,39
2020-12-17,Tehama,103,63373,2647,2480,219,2699,9
2020-12-17,Trinity,105,12862,282,213,26,239,2
2020-12-17,Tulare,107,460477,30089,27852,3141,30993,358
2020-12-17,Tuolumne,109,53932,2236,1992,35,2027,11
2020-12-17,Ventura,111,848112,33521,29404,1330,30734,208
2020-12-17,Yolo,113,214977,7589,6800,47,6847,105
2020-12-17,Yuba,115,75493,3374,3035,33,3068,12
2020-12-16,Alameda,1,1643700,44872,40751,734,41485,497
2020-12-16,Alpine,3,1148,66,64,0,64,0
2020-12-16,Amador,5,37829,2032,1693,13,1706,19
2020-12-16,Butte,7,227075,6372,5659,637,6296,76
2020-12-16,Calaveras,9,45235,923,821,1,822,21
2020-12-16,Colusa,11,21464,1141,1038,43,1081,7
2020-12-16,Contra Costa,13,1133247,35318,32429,353,32782,293
2020-12-16,Del Norte,15,27424,660,575,0,575,1
2020-12-16,El Dorado,17,186661,5103,4237,180,4417,9
2020-12-16,Fresno,19,978130,59503,49173,3552,52725,584
2020-12-16,Glenn,21,27897,1338,1236,178,1414,9
2020-12-16,Humboldt,23,135768,1451,1308,4,1312,12
2020-12-16,Imperial,25,180216,21280,19980,749,20729,388
2020-12-16,Inyo,27,18085,527,444,1,445,16
2020-12-16,Kern,29,883053,57795,52896,3744,56640,522
2020-12-16,Kings,31,150075,14814,13734,445,14179,99
2020-12-16,Lake,33,64148,1572,1363,0,1363,20
2020-12-16,Lassen,35,31185,3848,3396,36,3432,1
2020-12-16,Los Angeles,37,10098052,623964,557907,15301,573208,8561
2020-12-16,Madera,39,155013,9272,8278,317,8595,62
2020-12-16,Marin,41,260295,9092,8641,57,8698,142
2020-12-16,Mariposa,43,17540,197,175,3,178,3
2020-12-16,Mendocino,45,87422,2108,1929,15,1944,23
2020-12-16,Merced,47,269075,16704,15443,257,15700,190
2020-12-16,Modoc,49,8938,210,178,66,244,0
2020-12-16,Mono,51,14174,780,702,11,713,3
2020-12-16,Monterey,53,433212,23483,21107,557,21664,163
2020-12-16,Napa,55,140530,5026,4544,23,4567,23
2020-12-16,Nevada,57,99092,2397,2149,71,2220,13
2020-12-16,Orange,59,3164182,131042,115260,4770,120030,1712
2020-12-16,Placer,61,380077,12199,10554,406,10960,96
2020-12-16,Plumas,63,18699,403,319,9,328,0
2020-12-16,Riverside,65,2383286,150428,135751,5912,141663,1664
2020-12-16,Sacramento,67,1510023,57132,52166,426,52592,715
2020-12-16,San Benito,69,59416,2958,2582,24,2606,20
2020-12-16,San Bernardino,71,2135413,164749,143565,4026,147591,1403
2020-12-16,San Diego,73,3302833,130717,114248,0,114248,1217
2020-12-16,San Francisco,75,870044,21039,19624,194,19818,170
2020-12-16,San Joaquin,77,732212,39484,35010,1150,36160,547
2020-12-16,San Luis Obispo,79,281455,9144,8252,201,8453,58
2020-12-16,San Mateo,81,765935,21906,19292,56,19348,179
2020-12-16,Santa Barbara,83,443738,15453,13966,417,14383,144
2020-12-16,Santa Clara,85,1922200,58963,51502,226,51728,523
2020-12-16,Santa Cruz,87,273765,7624,6536,205,6741,63
2020-12-16,Shasta,89,179085,7435,6914,554,7468,62
2020-12-16,Sierra,91,2930,23,23,0,23,0
2020-12-16,Siskiyou,93,43540,928,818,87,905,2
2020-12-16,Solano,95,438530,15994,14157,156,14313,96
2020-12-16,Sonoma,97,501317,16986,15768,102,15870,170
2020-12-16,Stanislaus,99,539301,30661,28279,2590,30869,489
2020-12-16,Sutter,101,95872,5686,5223,42,5265,39
2020-12-16,Tehama,103,63373,2617,2441,192,2633,9
2020-12-16,Trinity,105,12862,276,212,26,238,2
2020-12-16,Tulare,107,460477,29676,27500,3034,30534,352
2020-12-16,Tuolumne,109,53932,2190,1941,35,1976,11
2020-12-16,Ventura,111,848112,32749,28566,1284,29850,203
2020-12-16,Yolo,113,214977,7460,6649,46,6695,103
2020-12-16,Yuba,115,75493,3288,2980,32,3012,11
2020-12-15,Alameda,1,1643700,44019,40026,710,40736,492
2020-12-15,Alpine,3,1148,66,64,0,64,0
2020-12-15,Amador,5,37829,1919,1669,11,1680,19
2020-12-15,Butte,7,227075,6236,5565,605,6170,75
2020-12-15,Calaveras,9,45235,891,799,1,800,21
2020-12-15,Colusa,11,21464,1128,1026,41,1067,7
2020-12-15,Contra Costa,13,1133247,34665,31423,337,31760,281
2020-12-15,Del Norte,15,27424,649,564,0,564,1
2020-12-15,El Dorado,17,186661,4998,4113,164,4277,9
2020-12-15,Fresno,19,978130,58137,47316,3412,50728,574
2020-12-15,Glenn,21,27897,1325,1207,161,1368,9
2020-12-15,Humboldt,23,135768,1431,1276,4,1280,12
2020-12-15,Imperial,25,180216,21063,19756,667,20423,380
2020-12-15,Inyo,27,18085,514,394,1,395,16
2020-12-15,Kern,29,883053,56783,52002,3639,55641,511
2020-12-15,Kings,31,150075,14650,13652,426,14078,97
2020-12-15,Lake,33,64148,1548,1341,0,1341,21
2020-12-15,Lassen,35,31185,3676,3378,35,3413,1
2020-12-15,Los Angeles,37,10098052,607661,536258,14626,550884,8429
2020-12-15,Madera,39,155013,9116,8118,308,8426,60
2020-12-15,Marin,41,260295,8985,8528,55,8583,141
2020-12-15,Mariposa,43,17540,193,171,3,174,3
2020-12-15,Mendocino,45,87422,2081,1883,15,1898,24
2020-12-15,Merced,47,269075,16401,15120,253,15373,190
2020-12-15,Modoc,49,8938,208,179,66,245,0
2020-12-15,Mono,51,14174,764,702,11,713,3
2020-12-15,Monterey,53,433212,22884,19905,494,20399,161
2020-12-15,Napa,55,140530,4921,4440,23,4463,23
2020-12-15,Nevada,57,99092,2364,2117,69,2186,11
2020-12-15,Orange,59,3164182,127390,112893,4614,117507,1689
2020-12-15,Placer,61,380077,11970,10301,384,10685,95
2020-12-15,Plumas,63,18699,398,313,9,322,0
2020-12-15,Riverside,65,2383286,146392,131822,5625,137447,1624
2020-12-15,Sacramento,67,1510023,56117,51076,413,51489,703
2020-12-15,San Benito,69,59416,2878,2520,23,2543,19
2020-12-15,San Bernardino,71,2135413,160310,137548,3861,141409,1351
2020-12-15,San Diego,73,3302833,127157,111441,0,111441,1194
2020-12-15,San Francisco,75,870044,20730,19283,191,19474,171
2020-12-15,San Joaquin,77,732212,38561,33849,1112,34961,537
2020-12-15,San Luis Obispo,79,281455,9035,8074,198,8272,55
2020-12-15,San Mateo,81,765935,21497,18907,54,18961,178
2020-12-15,Santa Barbara,83,443738,15235,13782,408,14190,144
2020-12-15,Santa Clara,85,1922200,57529,50311,222,50533,505
2020-12-15,Santa Cruz,87,273765,7442,6361,189,6550,59
2020-12-15,Shasta,89,179085,7378,6794,527,7321,54
2020-12-15,Sierra,91,2930,23,23,0,23,0
2020-12-15,Siskiyou,93,43540,919,812,86,898,2
2020-12-15,Solano,95,438530,15647,13796,156,13952,95
2020-12-15,Sonoma,97,501317,16764,15406,102,15508,167
2020-12-15,Stanislaus,99,539301,30154,27823,2502,30325,485
2020-12-15,Sutter,101,95872,5589,5080,41,5121,36
2020-12-15,Tehama,103,63373,2580,2392,187,2579,9
2020-12-15,Trinity,105,12862,271,213,24,237,1
2020-12-15,Tulare,107,460477,29179,27026,2943,29969,342
2020-12-15,Tuolumne,109,53932,2159,1874,35,1909,8
2020-12-15,Ventura,111,848112,32128,27936,1236,29172,201
2020-12-15,Yolo,113,214977,7338,6531,44,6575,104
2020-12-15,Yuba,115,75493,3194,2891,31,2922,11
2020-12-14,Alameda,1,1643700,43126,39252,690,39942,487
2020-12-14,Alpine,3,1148,66,63,0,63,0
2020-12-14,Amador,5,37829,1847,1609,11,1620,19
2020-12-14,Butte,7,227075,6069,5202,587,5789,75
2020-12-14,Calaveras,9,45235,853,718,1,719,21
2020-12-14,Colusa,11,21464,1104,949,40,989,7
2020-12-14,Contra Costa,13,1133247,33966,30594,322,30916,281
2020-12-14,Del Norte,15,27424,643,560,0,560,1
2020-12-14,El Dorado,17,186661,4843,4018,147,4165,9
2020-12-14,Fresno,19,978130,57119,44726,3224,47950,560
2020-12-14,Glenn,21,27897,1299,1186,153,1339,9
2020-12-14,Humboldt,23,135768,1418,1256,4,1260,9
2020-12-14,Imperial,25,180216,20825,19608,585,20193,379
2020-12-14,Inyo,27,18085,500,382,1,383,16
2020-12-14,Kern,29,883053,55752,50538,3512,54050,510
2020-12-14,Kings,31,150075,14467,13491,397,13888,97
2020-12-14,Lake,33,64148,1497,1301,0,1301,21
2020-12-14,Lassen,35,31185,3577,2905,32,2937,1
2020-12-14,Los Angeles,37,10098052,590103,524668,13961,538629,8340
2020-12-14,Madera,39,155013,8843,8011,299,8310,60
2020-12-14,Marin,41,260295,8900,8475,53,8528,141
2020-12-14,Mariposa,43,17540,192,171,3,174,3
2020-12-14,Mendocino,45,87422,2060,1845,15,1860,24
2020-12-14,Merced,47,269075,16000,14572,239,14811,189
2020-12-14,Modoc,49,8938,203,180,64,244,0
2020-12-14,Mono,51,14174,756,685,11,696,3
2020-12-14,Monterey,53,433212,22366,19154,487,19641,155
2020-12-14,Napa,55,140530,4828,4289,23,4312,22
2020-12-14,Nevada,57,99092,2325,2070,66,2136,11
2020-12-14,Orange,59,3164182,123524,108602,4473,113075,1688
2020-12-14,Placer,61,380077,11677,9551,373,9924,95
2020-12-14,Plumas,63,18699,386,309,9,318,0
2020-12-14,Riverside,65,2383286,142282,123715,5355,129070,1588
2020-12-14,Sacramento,67,1510023,55009,50304,387,50691,691
2020-12-14,San Benito,69,59416,2811,2467,22,2489,19
2020-12-14,San Bernardino,71,2135413,155886,129151,3722,132873,1347
2020-12-14,San Diego,73,3302833,123426,109578,0,109578,1162
2020-12-14,San Francisco,75,870044,20356,18904,189,19093,171
2020-12-14,San Joaquin,77,732212,37721,32522,1063,33585,534
2020-12-14,San Luis Obispo,79,281455,8789,7791,192,7983,52
2020-12-14,San Mateo,81,765935,20997,18361,52,18413,178
2020-12-14,Santa Barbara,83,443738,14965,13587,401,13988,144
2020-12-14,Santa Clara,85,1922200,55970,49180,210,49390,502
2020-12-14,Santa Cruz,87,273765,7256,6049,173,6222,54
2020-12-14,Shasta,89,179085,7289,6665,508,7173,54
2020-12-14,Sierra,91,2930,23,21,0,21,0
2020-12-14,Siskiyou,93,43540,896,764,80,844,2
2020-12-14,Solano,95,438530,15283,13352,154,13506,93
2020-12-14,Sonoma,97,501317,16458,14807,99,14906,167
2020-12-14,Stanislaus,99,539301,29624,27311,2451,29762,485
2020-12-14,Sutter,101,95872,5481,5001,34,5035,35
2020-12-14,Tehama,103,63373,2533,2344,184,2528,9
2020-12-14,Trinity,105,12862,268,205,22,227,1
2020-12-14,Tulare,107,460477,28707,25735,2844,28579,341
2020-12-14,Tuolumne,109,53932,2102,1647,35,1682,8
2020-12-14,Ventura,111,848112,31209,27436,1173,28609,202
2020-12-14,Yolo,113,214977,7178,6389,43,6432,95
2020-12-14,Yuba,115,75493,3132,2851,31,2882,11
2020-12-13,Alameda,1,1643700,41934,38064,663,38727,486
2020-12-13,Alpine,3,1148,66,63,0,63,0
2020-12-13,Amador,5,37829,1791,1457,10,1467,19
2020-12-13,Butte,7,227075,5920,5103,542,5645,75
2020-12-13,Calaveras,9,45235,817,710,1,711,21
2020-12-13,Colusa,11,21464,1088,945,36,981,7
2020-12-13,Contra Costa,13,1133247,33239,29667,314,29981,281
2020-12-13,Del Norte,15,27424,590,542,0,542,1
2020-12-13,El Dorado,17,186661,4745,3770,135,3905,9
2020-12-13,Fresno,19,978130,56017,44114,3056,47170,559
2020-12-13,Glenn,21,27897,1286,1171,142,1313,9
2020-12-13,Humboldt,23,135768,1395,1238,3,1241,9
2020-12-13,Imperial,25,180216,20541,19472,450,19922,379
2020-12-13,Inyo,27,18085,479,380,1,381,16
2020-12-13,Kern,29,883053,54733,49051,3350,52401,510
2020-12-13,Kings,31,150075,14190,13357,376,13733,97
2020-12-13,Lake,33,64148,1455,1271,0,1271,21
2020-12-13,Lassen,35,31185,3470,2867,27,2894,1
2020-12-13,Los Angeles,37,10098052,572606,517472,13211,530683,8294
2020-12-13,Madera,39,155013,8659,7909,284,8193,60
2020-12-13,Marin,41,260295,8778,8409,53,8462,141
2020-12-13,Mariposa,43,17540,188,167,3,170,3
2020-12-13,Mendocino,45,87422,2026,1793,15,1808,24
2020-12-13,Merced,47,269075,15649,14384,236,14620,189
2020-12-13,Modoc,49,8938,191,179,58,237,0
2020-12-13,Mono,51,14174,738,675,11,686,3
2020-12-13,Monterey,53,433212,21944,18913,471,19384,153
2020-12-13,Napa,55,140530,4722,4194,23,4217,22
2020-12-13,Nevada,57,99092,2274,2030,64,2094,11
2020-12-13,Orange,59,3164182,119628,104768,4285,109053,1688
2020-12-13,Placer,61,380077,11365,9405,355,9760,95
2020-12-13,Plumas,63,18699,380,291,9,300,0
2020-12-13,Riverside,65,2383286,138178,119691,5076,124767,1581
2020-12-13,Sacramento,67,1510023,53747,49480,356,49836,682
2020-12-13,San Benito,69,59416,2739,2408,21,2429,19
2020-12-13,San Bernardino,71,2135413,151003,126718,3552,130270,1333
2020-12-13,San Diego,73,3302833,119831,107372,0,107372,1162
2020-12-13,San Francisco,75,870044,20014,18686,179,18865,167
2020-12-13,San Joaquin,77,732212,36921,32170,1020,33190,534
2020-12-13,San Luis Obispo,79,281455,8598,7625,184,7809,52
2020-12-13,San Mateo,81,765935,20506,18090,46,18136,177
2020-12-13,Santa Barbara,83,443738,14701,13249,384,13633,144
2020-12-13,Santa Clara,85,1922200,54542,47920,201,48121,499
2020-12-13,Santa Cruz,87,273765,7008,5986,162,6148,54
2020-12-13,Shasta,89,179085,7215,6647,482,7129,54
2020-12-13,Sierra,91,2930,23,21,0,21,0
2020-12-13,Siskiyou,93,43540,885,762,74,836,2
2020-12-13,Solano,95,438530,14844,13276,151,13427,93
2020-12-13,Sonoma,97,501317,16143,14495,98,14593,167
2020-12-13,Stanislaus,99,539301,29065,26569,2383,28952,485
2020-12-13,Sutter,101,95872,5354,4798,29,4827,34
2020-12-13,Tehama,103,63373,2489,2325,167,2492,9
2020-12-13,Trinity,105,12862,264,204,21,225,1
2020-12-13,Tulare,107,460477,28215,25496,2748,28244,340
2020-12-13,Tuolumne,109,53932,2039,1611,35,1646,8
2020-12-13,Ventura,111,848112,30210,26588,1107,27695,202
2020-12-13,Yolo,113,214977,6998,6265,36,6301,95
2020-12-13,Yuba,115,75493,3067,2754,28,2782,11
2020-12-12,Alameda,1,1643700,41499,37027,642,37669,486
2020-12-12,Alpine,3,1148,66,63,0,63,0
2020-12-12,Amador,5,37829,1763,1236,9,1245,19
2020-12-12,Butte,7,227075,5848,4972,528,5500,73
2020-12-12,Calaveras,9,45235,807,708,1,709,21
2020-12-12,Colusa,11,21464,1068,945,34,979,7
2020-12-12,Contra Costa,13,1133247,32896,29506,304,29810,281
2020-12-12,Del Norte,15,27424,582,529,0,529,1
2020-12-12,El Dorado,17,186661,4670,3706,117,3823,9
2020-12-12,Fresno,19,978130,55667,43756,2995,46751,559
2020-12-12,Glenn,21,27897,1278,1143,138,1281,8
2020-12-12,Humboldt,23,135768,1376,1208,3,1211,9
2020-12-12,Imperial,25,180216,20460,18947,389,19336,379
2020-12-12,Inyo,27,18085,475,380,1,381,16
2020-12-12,Kern,29,883053,54218,48194,3258,51452,507
2020-12-12,Kings,31,150075,14103,13205,371,13576,96
2020-12-12,Lake,33,64148,1438,1232,0,1232,21
2020-12-12,Lassen,35,31185,3448,2866,23,2889,1
2020-12-12,Los Angeles,37,10098052,565866,504317,12672,516989,8269
2020-12-12,Madera,39,155013,8536,7765,281,8046,59
2020-12-12,Marin,41,260295,8722,8363,52,8415,141
2020-12-12,Mariposa,43,17540,187,164,3,167,3
2020-12-12,Mendocino,45,87422,1990,1771,15,1786,24
2020-12-12,Merced,47,269075,15559,14181,232,14413,188
2020-12-12,Modoc,49,8938,190,169,55,224,0
2020-12-12,Mono,51,14174,729,640,11,651,3
2020-12-12,Monterey,53,433212,21833,18596,442,19038,151
2020-12-12,Napa,55,140530,4678,4113,23,4136,22
2020-12-12,Nevada,57,99092,2256,1981,62,2043,10
2020-12-12,Orange,59,3164182,117786,100468,4124,104592,1674
2020-12-12,Placer,61,380077,11207,9390,349,9739,95
2020-12-12,Plumas,63,18699,374,291,9,300,0
2020-12-12,Riverside,65,2383286,136132,118335,4858,123193,1579
2020-12-12,Sacramento,67,1510023,53165,48319,341,48660,673
2020-12-12,San Benito,69,59416,2683,2355,20,2375,19
2020-12-12,San Bernardino,71,2135413,149387,125741,3440,129181,1321
2020-12-12,San Diego,73,3302833,118211,104958,0,104958,1151
2020-12-12,San Francisco,75,870044,19826,18413,174,18587,167
2020-12-12,San Joaquin,77,732212,36596,32200,987,33187,534
2020-12-12,San Luis Obispo,79,281455,8503,7462,175,7637,50
2020-12-12,San Mateo,81,765935,20286,17574,45,17619,177
2020-12-12,Santa Barbara,83,443738,14549,13174,376,13550,144
2020-12-12,Santa Clara,85,1922200,53588,45892,198,46090,498
2020-12-12,Santa Cruz,87,273765,6909,5905,152,6057,54
2020-12-12,Shasta,89,179085,7180,6551,464,7015,54
2020-12-12,Sierra,91,2930,23,21,0,21,0
2020-12-12,Siskiyou,93,43540,883,762,71,833,2
2020-12-12,Solano,95,438530,14647,12748,144,12892,93
2020-12-12,Sonoma,97,501317,16024,14466,98,14564,166
2020-12-12,Stanislaus,99,539301,28764,26246,2326,28572,483
2020-12-12,Sutter,101,95872,5292,4717,29,4746,32
2020-12-12,Tehama,103,63373,2473,2252,161,2413,9
2020-12-12,Trinity,105,12862,263,204,19,223,1
2020-12-12,Tulare,107,460477,27953,25333,2689,28022,341
2020-12-12,Tuolumne,109,53932,1996,1536,35,1571,8
2020-12-12,Ventura,111,848112,29767,25955,1074,27029,202
2020-12-12,Yolo,113,214977,6916,6116,34,6150,95
2020-12-12,Yuba,115,75493,3040,2692,27,2719,10
2020-12-11,Alameda,1,1643700,40932,36281,630,36911,482
2020-12-11,Alpine,3,1148,66,63,0,63,0
2020-12-11,Amador,5,37829,1748,1213,8,1221,19
2020-12-11,Butte,7,227075,5777,4941,507,5448,73
2020-12-11,Calaveras,9,45235,791,697,1,698,21
2020-12-11,Colusa,11,21464,1058,923,32,955,7
2020-12-11,Contra Costa,13,1133247,32467,29036,300,29336,282
2020-12-11,Del Norte,15,27424,576,505,0,505,1
2020-12-11,El Dorado,17,186661,4588,3669,102,3771,9
2020-12-11,Fresno,19,978130,54659,43071,2927,45998,550
2020-12-11,Glenn,21,27897,1262,1135,133,1268,8
2020-12-11,Humboldt,23,135768,1359,1190,3,1193,9
2020-12-11,Imperial,25,180216,20372,18599,340,18939,377
2020-12-11,Inyo,27,18085,463,372,1,373,16
2020-12-11,Kern,29,883053,53546,47664,3191,50855,502
2020-12-11,Kings,31,150075,13961,13118,365,13483,94
2020-12-11,Lake,33,64148,1426,1205,0,1205,21
2020-12-11,Lassen,35,31185,3437,2790,21,2811,1
2020-12-11,Los Angeles,37,10098052,554114,493592,12241,505833,8198
2020-12-11,Madera,39,155013,8446,7648,271,7919,59
2020-12-11,Marin,41,260295,8627,8317,51,8368,141
2020-12-11,Mariposa,43,17540,186,164,3,167,3
2020-12-11,Mendocino,45,87422,1967,1769,15,1784,24
2020-12-11,Merced,47,269075,15441,14038,224,14262,186
2020-12-11,Modoc,49,8938,190,168,54,222,0
2020-12-11,Mono,51,14174,720,631,11,642,3
2020-12-11,Monterey,53,433212,21532,18421,437,18858,150
2020-12-11,Napa,55,140530,4622,4054,23,4077,22
2020-12-11,Nevada,57,99092,2239,1959,59,2018,10
2020-12-11,Orange,59,3164182,115490,98357,4021,102378,1656
2020-12-11,Placer,61,380077,11051,8904,333,9237,93
2020-12-11,Plumas,63,18699,366,286,9,295,0
2020-12-11,Riverside,65,2383286,133081,115329,4626,119955,1573
2020-12-11,Sacramento,67,1510023,52500,47468,332,47800,669
2020-12-11,San Benito,69,59416,2632,2319,20,2339,19
2020-12-11,San Bernardino,71,2135413,146710,123092,3314,126406,1313
2020-12-11,San Diego,73,3302833,116254,102468,0,102468,1137
2020-12-11,San Francisco,75,870044,19596,18246,173,18419,165
2020-12-11,San Joaquin,77,732212,36254,32044,958,33002,534
2020-12-11,San Luis Obispo,79,281455,8343,7415,172,7587,49
2020-12-11,San Mateo,81,765935,20014,17240,34,17274,177
2020-12-11,Santa Barbara,83,443738,14407,12997,368,13365,144
2020-12-11,Santa Clara,85,1922200,52582,45101,188,45289,494
2020-12-11,Santa Cruz,87,273765,6797,5764,141,5905,50
2020-12-11,Shasta,89,179085,7134,6459,456,6915,54
2020-12-11,Sierra,91,2930,23,19,0,19,0
2020-12-11,Siskiyou,93,43540,876,753,68,821,2
2020-12-11,Solano,95,438530,14459,12554,140,12694,92
2020-12-11,Sonoma,97,501317,15859,14298,95,14393,166
2020-12-11,Stanislaus,99,539301,28498,25928,2280,28208,464
2020-12-11,Sutter,101,95872,5228,4600,28,4628,30
2020-12-11,Tehama,103,63373,2444,2232,157,2389,9
2020-12-11,Trinity,105,12862,262,204,18,222,1
2020-12-11,Tulare,107,460477,27599,24953,2639,27592,338
2020-12-11,Tuolumne,109,53932,1981,1510,35,1545,8
2020-12-11,Ventura,111,848112,29161,24999,1051,26050,202
2020-12-11,Yolo,113,214977,6811,6006,32,6038,95
2020-12-11,Yuba,115,75493,2979,2649,26,2675,10
2020-12-10,Alameda,1,1643700,40164,35686,608,36294,477
2020-12-10,Alpine,3,1148,66,63,0,63,0
2020-12-10,Amador,5,37829,1691,1191,8,1199,18
2020-12-10,Butte,7,227075,5661,4863,480,5343,72
2020-12-10,Calaveras,9,45235,772,684,1,685,21
2020-12-10,Colusa,11,21464,1035,909,27,936,7
2020-12-10,Contra Costa,13,1133247,31785,28413,294,28707,276
2020-12-10,Del Norte,15,27424,567,501,0,501,1
2020-12-10,El Dorado,17,186661,4470,3557,97,3654,9
2020-12-10,Fresno,19,978130,53682,42461,2778,45239,540
2020-12-10,Glenn,21,27897,1242,1126,124,1250,8
2020-12-10,Humboldt,23,135768,1339,1140,3,1143,9
2020-12-10,Imperial,25,180216,20158,18333,258,18591,370
2020-12-10,Inyo,27,18085,442,365,1,366,15
2020-12-10,Kern,29,883053,52567,47176,3021,50197,499
2020-12-10,Kings,31,150075,13810,12993,359,13352,92
2020-12-10,Lake,33,64148,1385,1167,0,1167,21
2020-12-10,Lassen,35,31185,3415,2764,17,2781,0
2020-12-10,Los Angeles,37,10098052,540205,480354,11684,492038,8149
2020-12-10,Madera,39,155013,8340,7445,256,7701,59
2020-12-10,Marin,41,260295,8581,8245,50,8295,140
2020-12-10,Mariposa,43,17540,185,160,3,163,3
2020-12-10,Mendocino,45,87422,1941,1748,12,1760,24
2020-12-10,Merced,47,269075,15195,13756,221,13977,186
2020-12-10,Modoc,49,8938,185,165,52,217,0
2020-12-10,Mono,51,14174,714,601,11,612,3
2020-12-10,Monterey,53,433212,21054,18266,427,18693,145
2020-12-10,Napa,55,140530,4536,3974,22,3996,22
2020-12-10,Nevada,57,99092,2202,1919,59,1978,10
2020-12-10,Orange,59,3164182,112405,95297,3849,99146,1651
2020-12-10,Placer,61,380077,10800,8906,314,9220,90
2020-12-10,Plumas,63,18699,355,281,9,290,0
2020-12-10,Riverside,65,2383286,129409,112794,4347,117141,1552
2020-12-10,Sacramento,67,1510023,51608,46471,311,46782,664
2020-12-10,San Benito,69,59416,2573,2268,19,2287,19
2020-12-10,San Bernardino,71,2135413,142501,120186,3124,123310,1306
2020-12-10,San Diego,73,3302833,113728,99601,0,99601,1114
2020-12-10,San Francisco,75,870044,19282,17945,165,18110,164
2020-12-10,San Joaquin,77,732212,35622,31228,927,32155,534
2020-12-10,San Luis Obispo,79,281455,8179,7245,161,7406,49
2020-12-10,San Mateo,81,765935,19573,16701,24,16725,177
2020-12-10,Santa Barbara,83,443738,14231,12788,358,13146,143
2020-12-10,Santa Clara,85,1922200,51446,43939,172,44111,491
2020-12-10,Santa Cruz,87,273765,6624,5645,127,5772,48
2020-12-10,Shasta,89,179085,7065,6312,427,6739,53
2020-12-10,Sierra,91,2930,23,18,0,18,0
2020-12-10,Siskiyou,93,43540,866,712,67,779,2
2020-12-10,Solano,95,438530,14093,12017,134,12151,90
2020-12-10,Sonoma,97,501317,15604,14282,94,14376,167
2020-12-10,Stanislaus,99,539301,28030,25582,2209,27791,464
2020-12-10,Sutter,101,95872,5097,4528,25,4553,27
2020-12-10,Tehama,103,63373,2395,2190,145,2335,9
2020-12-10,Trinity,105,12862,259,202,17,219,1
2020-12-10,Tulare,107,460477,27152,24506,2574,27080,337
2020-12-10,Tuolumne,109,53932,1722,1451,35,1486,8
2020-12-10,Ventura,111,848112,28309,24075,1007,25082,202
2020-12-10,Yolo,113,214977,6690,5896,31,5927,95
2020-12-10,Yuba,115,75493,2915,2604,25,2629,10
2020-12-09,Alameda,1,1643700,39320,35047,586,35633,470
2020-12-09,Alpine,3,1148,66,58,0,58,0
2020-12-09,Amador,5,37829,1648,1121,8,1129,19
2020-12-09,Butte,7,227075,5520,4733,457,5190,70
2020-12-09,Calaveras,9,45235,744,670,1,671,21
2020-12-09,Colusa,11,21464,1020,896,26,922,7
2020-12-09,Contra Costa,13,1133247,31081,28308,283,28591,273
2020-12-09,Del Norte,15,27424,553,481,0,481,2
2020-12-09,El Dorado,17,186661,4334,3449,89,3538,8
2020-12-09,Fresno,19,978130,52686,41954,2619,44573,533
2020-12-09,Glenn,21,27897,1228,1107,118,1225,8
2020-12-09,Humboldt,23,135768,1307,1086,3,1089,10
2020-12-09,Imperial,25,180216,19901,17757,218,17975,368
2020-12-09,Inyo,27,18085,428,356,1,357,15
2020-12-09,Kern,29,883053,51414,46379,2873,49252,494
2020-12-09,Kings,31,150075,13666,12716,349,13065,92
2020-12-09,Lake,33,64148,1357,1158,0,1158,20
2020-12-09,Lassen,35,31185,3346,2331,15,2346,0
2020-12-09,Los Angeles,37,10098052,526793,467971,11109,479080,8075
2020-12-09,Madera,39,155013,8228,7216,251,7467,59
2020-12-09,Marin,41,260295,8521,8182,49,8231,138
2020-12-09,Mariposa,43,17540,183,154,3,157,3
2020-12-09,Mendocino,45,87422,1915,1703,11,1714,24
2020-12-09,Merced,47,269075,14956,13588,212,13800,183
2020-12-09,Modoc,49,8938,181,146,43,189,0
2020-12-09,Mono,51,14174,698,601,11,612,3
2020-12-09,Monterey,53,433212,20660,17891,418,18309,143
2020-12-09,Napa,55,140530,4451,3858,21,3879,21
2020-12-09,Nevada,57,99092,2149,1864,59,1923,10
2020-12-09,Orange,59,3164182,109307,93763,3679,97442,1629
2020-12-09,Placer,61,380077,10532,8588,299,8887,85
2020-12-09,Plumas,63,18699,347,271,9,280,0
2020-12-09,Riverside,65,2383286,125725,110376,4135,114511,1543
2020-12-09,Sacramento,67,1510023,50547,45284,283,45567,659
2020-12-09,San Benito,69,59416,2494,2217,16,2233,19
2020-12-09,San Bernardino,71,2135413,138234,114516,2917,117433,1305
2020-12-09,San Diego,73,3302833,110753,97551,0,97551,1103
2020-12-09,San Francisco,75,870044,18981,17628,164,17792,163
2020-12-09,San Joaquin,77,732212,34800,30539,901,31440,531
2020-12-09,San Luis Obispo,79,281455,7961,7105,152,7257,47
2020-12-09,San Mateo,81,765935,19123,16422,23,16445,175
2020-12-09,Santa Barbara,83,443738,14030,12630,348,12978,142
2020-12-09,Santa Clara,85,1922200,50304,42912,156,43068,489
2020-12-09,Santa Cruz,87,273765,6466,5527,113,5640,47
2020-12-09,Shasta,89,179085,7000,6105,413,6518,52
2020-12-09,Sierra,91,2930,23,18,0,18,0
2020-12-09,Siskiyou,93,43540,855,713,66,779,2
2020-12-09,Solano,95,438530,13747,11862,125,11987,90
2020-12-09,Sonoma,97,501317,15348,13994,91,14085,164
2020-12-09,Stanislaus,99,539301,27533,25157,2147,27304,463
2020-12-09,Sutter,101,95872,4988,4418,21,4439,24
2020-12-09,Tehama,103,63373,2360,2102,142,2244,9
2020-12-09,Trinity,105,12862,251,199,16,215,0
2020-12-09,Tulare,107,460477,26557,24124,2492,26616,334
2020-12-09,Tuolumne,109,53932,1681,1319,35,1354,8
2020-12-09,Ventura,111,848112,27451,23830,960,24790,201
2020-12-09,Yolo,113,214977,6564,5760,29,5789,95
2020-12-09,Yuba,115,75493,2847,2513,24,2537,10
2020-12-08,Alameda,1,1643700,38424,34373,569,34942,469
2020-12-08,Alpine,3,1148,65,53,0,53,0
2020-12-08,Amador,5,37829,1360,1043,8,1051,17
2020-12-08,Butte,7,227075,5364,4651,412,5063,70
2020-12-08,Calaveras,9,45235,720,657,1,658,21
2020-12-08,Colusa,11,21464,1003,875,25,900,6
2020-12-08,Contra Costa,13,1133247,30379,27926,267,28193,270
2020-12-08,Del Norte,15,27424,538,465,0,465,2
2020-12-08,El Dorado,17,186661,4210,3296,77,3373,8
2020-12-08,Fresno,19,978130,51431,41574,2447,44021,529
2020-12-08,Glenn,21,27897,1208,1094,110,1204,8
2020-12-08,Humboldt,23,135768,1281,1059,3,1062,10
2020-12-08,Imperial,25,180216,19381,17568,209,17777,363
2020-12-08,Inyo,27,18085,405,333,1,334,15
2020-12-08,Kern,29,883053,50124,45116,2714,47830,487
2020-12-08,Kings,31,150075,13514,12623,338,12961,90
2020-12-08,Lake,33,64148,1315,1127,0,1127,20
2020-12-08,Lassen,35,31185,3190,2165,15,2180,0
2020-12-08,Los Angeles,37,10098052,514150,459738,10609,470347,8004
2020-12-08,Madera,39,155013,8096,7082,238,7320,59
2020-12-08,Marin,41,260295,8438,8099,48,8147,137
2020-12-08,Mariposa,43,17540,179,150,3,153,2
2020-12-08,Mendocino,45,87422,1873,1666,11,1677,23
2020-12-08,Merced,47,269075,14649,13380,211,13591,181
2020-12-08,Modoc,49,8938,173,138,40,178,0
2020-12-08,Mono,51,14174,676,597,11,608,3
2020-12-08,Monterey,53,433212,20092,17752,411,18163,134
2020-12-08,Napa,55,140530,4363,3778,20,3798,22
2020-12-08,Nevada,57,99092,2095,1809,56,1865,11
2020-12-08,Orange,59,3164182,106108,91406,3507,94913,1629
2020-12-08,Placer,61,380077,10263,8224,293,8517,82
2020-12-08,Plumas,63,18699,337,258,9,267,0
2020-12-08,Riverside,65,2383286,122393,107620,3947,111567,1514
2020-12-08,Sacramento,67,1510023,49480,44635,265,44900,649
2020-12-08,San Benito,69,59416,2438,2180,16,2196,18
2020-12-08,San Bernardino,71,2135413,133892,110676,2787,113463,1301
2020-12-08,San Diego,73,3302833,107383,95447,0,95447,1088
2020-12-08,San Francisco,75,870044,18673,17384,160,17544,162
2020-12-08,San Joaquin,77,732212,33908,30225,867,31092,530
2020-12-08,San Luis Obispo,79,281455,7832,6903,141,7044,45
2020-12-08,San Mateo,81,765935,18725,16305,23,16328,175
2020-12-08,Santa Barbara,83,443738,13846,12516,337,12853,141
2020-12-08,Santa Clara,85,1922200,49002,41309,145,41454,484
2020-12-08,Santa Cruz,87,273765,6289,5374,110,5484,45
2020-12-08,Shasta,89,179085,6891,5946,405,6351,50
2020-12-08,Sierra,91,2930,22,18,0,18,0
2020-12-08,Siskiyou,93,43540,841,704,64,768,2
2020-12-08,Solano,95,438530,13344,11669,123,11792,89
2020-12-08,Sonoma,97,501317,15087,13601,90,13691,164
2020-12-08,Stanislaus,99,539301,27049,24793,2082,26875,461
2020-12-08,Sutter,101,95872,4891,4342,20,4362,24
2020-12-08,Tehama,103,63373,2277,2057,132,2189,9
2020-12-08,Trinity,105,12862,246,198,15,213,0
2020-12-08,Tulare,107,460477,25961,23607,2425,26032,330
2020-12-08,Tuolumne,109,53932,1652,1264,35,1299,7
2020-12-08,Ventura,111,848112,26789,23665,916,24581,195
2020-12-08,Yolo,113,214977,6431,5560,29,5589,90
2020-12-08,Yuba,115,75493,2771,2477,24,2501,10
2020-12-07,Alameda,1,1643700,37560,33887,533,34420,466
2020-12-07,Alpine,3,1148,64,53,0,53,0
2020-12-07,Amador,5,37829,1285,993,7,1000,17
2020-12-07,Butte,7,227075,5228,4604,390,4994,67
2020-12-07,Calaveras,9,45235,688,606,1,607,21
2020-12-07,Colusa,11,21464,978,825,23,848,6
2020-12-07,Contra Costa,13,1133247,29766,27307,254,27561,270
2020-12-07,Del Norte,15,27424,526,424,0,424,2
2020-12-07,El Dorado,17,186661,4031,3275,70,3345,8
2020-12-07,Fresno,19,978130,49966,41098,2319,43417,526
2020-12-07,Glenn,21,27897,1189,1085,104,1189,8
2020-12-07,Humboldt,23,135768,1246,1023,3,1026,9
2020-12-07,Imperial,25,180216,18962,17234,199,17433,364
2020-12-07,Inyo,27,18085,390,333,1,334,15
2020-12-07,Kern,29,883053,49105,44409,2569,46978,486
2020-12-07,Kings,31,150075,13374,12412,325,12737,90
2020-12-07,Lake,33,64148,1285,1090,0,1090,20
2020-12-07,Lassen,35,31185,3092,2167,15,2182,0
2020-12-07,Los Angeles,37,10098052,500532,451052,10141,461193,7937
2020-12-07,Madera,39,155013,7832,6935,232,7167,59
2020-12-07,Marin,41,260295,8381,8049,47,8096,136
2020-12-07,Mariposa,43,17540,176,146,3,149,2
2020-12-07,Mendocino,45,87422,1838,1638,9,1647,23
2020-12-07,Merced,47,269075,14291,13250,201,13451,179
2020-12-07,Modoc,49,8938,166,128,37,165,0
2020-12-07,Mono,51,14174,665,590,11,601,3
2020-12-07,Monterey,53,433212,19611,17746,399,18145,132
2020-12-07,Napa,55,140530,4272,3684,20,3704,21
2020-12-07,Nevada,57,99092,2046,1777,55,1832,11
2020-12-07,Orange,59,3164182,102859,89793,3391,93184,1628
2020-12-07,Placer,61,380077,9938,7911,279,8190,82
2020-12-07,Plumas,63,18699,326,256,5,261,0
2020-12-07,Riverside,65,2383286,119211,102363,3753,106116,1491
2020-12-07,Sacramento,67,1510023,48388,43419,246,43665,638
2020-12-07,San Benito,69,59416,2387,2165,16,2181,18
2020-12-07,San Bernardino,71,2135413,129949,108161,2659,110820,1295
2020-12-07,San Diego,73,3302833,104594,94171,0,94171,1062
2020-12-07,San Francisco,75,870044,18383,17220,152,17372,161
2020-12-07,San Joaquin,77,732212,33033,28188,840,29028,530
2020-12-07,San Luis Obispo,79,281455,7651,6782,134,6916,45
2020-12-07,San Mateo,81,765935,18286,16029,22,16051,175
2020-12-07,Santa Barbara,83,443738,13605,12362,325,12687,141
2020-12-07,Santa Clara,85,1922200,47620,40621,134,40755,484
2020-12-07,Santa Cruz,87,273765,6125,5152,104,5256,41
2020-12-07,Shasta,89,179085,6768,5742,389,6131,50
2020-12-07,Sierra,91,2930,20,18,0,18,0
2020-12-07,Siskiyou,93,43540,815,652,63,715,2
2020-12-07,Solano,95,438530,13005,11354,119,11473,89
2020-12-07,Sonoma,97,501317,14800,13376,90,13466,164
2020-12-07,Stanislaus,99,539301,26496,24479,2028,26507,454
2020-12-07,Sutter,101,95872,4757,4106,20,4126,24
2020-12-07,Tehama,103,63373,2225,2030,126,2156,9
2020-12-07,Trinity,105,12862,243,194,15,209,0
2020-12-07,Tulare,107,460477,25439,22760,2363,25123,328
2020-12-07,Tuolumne,109,53932,1568,1256,34,1290,7
2020-12-07,Ventura,111,848112,26205,23354,879,24233,191
2020-12-07,Yolo,113,214977,6269,5537,28,5565,90
2020-12-07,Yuba,115,75493,2702,2428,22,2450,10
2020-12-06,Alameda,1,1643700,36594,33477,510,33987,465
2020-12-06,Alpine,3,1148,60,53,0,53,0
2020-12-06,Amador,5,37829,1223,952,6,958,17
2020-12-06,Butte,7,227075,5078,4527,356,4883,67
2020-12-06,Calaveras,9,45235,669,606,1,607,21
2020-12-06,Colusa,11,21464,961,824,20,844,6
2020-12-06,Contra Costa,13,1133247,29160,26566,246,26812,270
2020-12-06,Del Norte,15,27424,489,414,0,414,2
2020-12-06,El Dorado,17,186661,3893,3086,65,3151,8
2020-12-06,Fresno,19,978130,49017,40869,2198,43067,526
2020-12-06,Glenn,21,27897,1179,1067,100,1167,8
2020-12-06,Humboldt,23,135768,1221,1004,3,1007,9
2020-12-06,Imperial,25,180216,18649,16922,190,17112,364
2020-12-06,Inyo,27,18085,377,333,1,334,15
2020-12-06,Kern,29,883053,48121,43899,2390,46289,486
2020-12-06,Kings,31,150075,13105,12056,307,12363,90
2020-12-06,Lake,33,64148,1249,1075,0,1075,20
2020-12-06,Lassen,35,31185,2988,2168,13,2181,0
2020-12-06,Los Angeles,37,10098052,487006,443230,9669,452899,7910
2020-12-06,Madera,39,155013,7662,6826,224,7050,59
2020-12-06,Marin,41,260295,8303,8013,45,8058,136
2020-12-06,Mariposa,43,17540,175,144,3,147,2
2020-12-06,Mendocino,45,87422,1797,1614,9,1623,23
2020-12-06,Merced,47,269075,13956,12928,192,13120,179
2020-12-06,Modoc,49,8938,153,125,29,154,0
2020-12-06,Mono,51,14174,641,586,10,596,3
2020-12-06,Monterey,53,433212,18994,17426,388,17814,130
2020-12-06,Napa,55,140530,4160,3644,20,3664,21
2020-12-06,Nevada,57,99092,1988,1710,52,1762,10
2020-12-06,Orange,59,3164182,99820,87737,3257,90994,1627
2020-12-06,Placer,61,380077,9664,7837,257,8094,82
2020-12-06,Plumas,63,18699,313,254,4,258,0
2020-12-06,Riverside,65,2383286,116135,100088,3515,103603,1482
2020-12-06,Sacramento,67,1510023,47146,42808,231,43039,638
2020-12-06,San Benito,69,59416,2349,2135,16,2151,18
2020-12-06,San Bernardino,71,2135413,125817,106927,2496,109423,1286
2020-12-06,San Diego,73,3302833,101564,92173,0,92173,1062
2020-12-06,San Francisco,75,870044,18062,17107,145,17252,161
2020-12-06,San Joaquin,77,732212,32203,28188,812,29000,530
2020-12-06,San Luis Obispo,79,281455,7484,6723,131,6854,45
2020-12-06,San Mateo,81,765935,17783,15855,19,15874,175
2020-12-06,Santa Barbara,83,443738,13375,12252,317,12569,141
2020-12-06,Santa Clara,85,1922200,46248,39112,128,39240,482
2020-12-06,Santa Cruz,87,273765,5953,5069,98,5167,40
2020-12-06,Shasta,89,179085,6627,5743,367,6110,49
2020-12-06,Sierra,91,2930,20,17,0,17,0
2020-12-06,Siskiyou,93,43540,797,652,61,713,2
2020-12-06,Solano,95,438530,12717,11354,109,11463,88
2020-12-06,Sonoma,97,501317,14510,13238,89,13327,164
2020-12-06,Stanislaus,99,539301,25945,24036,1962,25998,454
2020-12-06,Sutter,101,95872,4643,4009,20,4029,21
2020-12-06,Tehama,103,63373,2169,1982,115,2097,9
2020-12-06,Trinity,105,12862,237,181,14,195,0
2020-12-06,Tulare,107,460477,24923,22756,2291,25047,327
2020-12-06,Tuolumne,109,53932,1471,1210,34,1244,7
2020-12-06,Ventura,111,848112,25662,23035,852,23887,191
2020-12-06,Yolo,113,214977,6109,5465,23,5488,90
2020-12-06,Yuba,115,75493,2658,2340,21,2361,10
2020-12-05,Alameda,1,1643700,36235,32781,499,33280,465
2020-12-05,Alpine,3,1148,59,53,0,53,0
2020-12-05,Amador,5,37829,1199,847,6,853,17
2020-12-05,Butte,7,227075,5009,4455,337,4792,66
2020-12-05,Calaveras,9,45235,658,606,1,607,21
2020-12-05,Colusa,11,21464,944,825,17,842,6
2020-12-05,Contra Costa,13,1133247,28866,26217,239,26456,270
2020-12-05,Del Norte,15,27424,483,408,0,408,2
2020-12-05,El Dorado,17,186661,3829,3061,60,3121,8
2020-12-05,Fresno,19,978130,48697,40568,2142,42710,525
2020-12-05,Glenn,21,27897,1166,1056,94,1150,8
2020-12-05,Humboldt,23,135768,1188,979,3,982,9
2020-12-05,Imperial,25,180216,18487,16544,188,16732,362
2020-12-05,Inyo,27,18085,372,332,1,333,15
2020-12-05,Kern,29,883053,47662,43332,2299,45631,484
2020-12-05,Kings,31,150075,13026,11898,304,12202,90
2020-12-05,Lake,33,64148,1225,1069,0,1069,20
2020-12-05,Lassen,35,31185,2797,2168,11,2179,0
2020-12-05,Los Angeles,37,10098052,481237,433120,9326,442446,7888
2020-12-05,Madera,39,155013,7574,6619,217,6836,59
2020-12-05,Marin,41,260295,8277,7961,45,8006,136
2020-12-05,Mariposa,43,17540,170,143,3,146,2
2020-12-05,Mendocino,45,87422,1758,1585,9,1594,23
2020-12-05,Merced,47,269075,13851,12747,181,12928,180
2020-12-05,Modoc,49,8938,153,118,28,146,0
2020-12-05,Mono,51,14174,638,554,10,564,3
2020-12-05,Monterey,53,433212,18848,17077,384,17461,127
2020-12-05,Napa,55,140530,4090,3565,20,3585,21
2020-12-05,Nevada,57,99092,1974,1642,50,1692,10
2020-12-05,Orange,59,3164182,98384,85735,3162,88897,1612
2020-12-05,Placer,61,380077,9546,7811,248,8059,78
2020-12-05,Plumas,63,18699,306,246,1,247,0
2020-12-05,Riverside,65,2383286,114538,98612,3326,101938,1477
2020-12-05,Sacramento,67,1510023,46482,41878,216,42094,625
2020-12-05,San Benito,69,59416,2308,2073,16,2089,18
2020-12-05,San Bernardino,71,2135413,124300,105382,2358,107740,1283
2020-12-05,San Diego,73,3302833,100216,90470,0,90470,1055
2020-12-05,San Francisco,75,870044,17878,16786,141,16927,161
2020-12-05,San Joaquin,77,732212,31944,28105,777,28882,523
2020-12-05,San Luis Obispo,79,281455,7417,6623,128,6751,44
2020-12-05,San Mateo,81,765935,17526,15512,19,15531,175
2020-12-05,Santa Barbara,83,443738,13276,12107,311,12418,141
2020-12-05,Santa Clara,85,1922200,45513,38339,123,38462,474
2020-12-05,Santa Cruz,87,273765,5880,4997,95,5092,40
2020-12-05,Shasta,89,179085,6566,5653,356,6009,49
2020-12-05,Sierra,91,2930,20,17,0,17,0
2020-12-05,Siskiyou,93,43540,789,649,60,709,2
2020-12-05,Solano,95,438530,12548,11351,107,11458,87
2020-12-05,Sonoma,97,501317,14414,13137,89,13226,164
2020-12-05,Stanislaus,99,539301,25640,23662,1926,25588,454
2020-12-05,Sutter,101,95872,4576,3937,20,3957,20
2020-12-05,Tehama,103,63373,2155,1926,113,2039,9
2020-12-05,Trinity,105,12862,236,177,14,191,0
2020-12-05,Tulare,107,460477,24715,22660,2228,24888,324
2020-12-05,Tuolumne,109,53932,1416,1180,34,1214,7
2020-12-05,Ventura,111,848112,25295,22710,836,23546,191
2020-12-05,Yolo,113,214977,6032,5351,22,5373,90
2020-12-05,Yuba,115,75493,2622,2275,21,2296,10
2020-12-04,Alameda,1,1643700,35687,31871,486,32357,465
2020-12-04,Alpine,3,1148,59,53,0,53,0
2020-12-04,Amador,5,37829,1185,766,3,769,16
2020-12-04,Butte,7,227075,4938,4336,315,4651,65
2020-12-04,Calaveras,9,45235,654,585,1,586,21
2020-12-04,Colusa,11,21464,930,790,16,806,6
2020-12-04,Contra Costa,13,1133247,28526,25705,227,25932,264
2020-12-04,Del Norte,15,27424,472,401,0,401,2
2020-12-04,El Dorado,17,186661,3741,2933,57,2990,7
2020-12-04,Fresno,19,978130,47989,40108,2073,42181,522
2020-12-04,Glenn,21,27897,1160,1017,86,1103,8
2020-12-04,Humboldt,23,135768,1170,960,3,963,9
2020-12-04,Imperial,25,180216,18244,16484,188,16672,362
2020-12-04,Inyo,27,18085,364,324,1,325,15
2020-12-04,Kern,29,883053,47116,42497,2193,44690,485
2020-12-04,Kings,31,150075,12933,11767,298,12065,88
2020-12-04,Lake,33,64148,1197,1018,0,1018,20
2020-12-04,Lassen,35,31185,2790,2167,9,2176,0
2020-12-04,Los Angeles,37,10098052,472650,424164,9015,433179,7845
2020-12-04,Madera,39,155013,7485,6479,214,6693,58
2020-12-04,Marin,41,260295,8227,7896,43,7939,136
2020-12-04,Mariposa,43,17540,170,136,3,139,2
2020-12-04,Mendocino,45,87422,1739,1563,9,1572,23
2020-12-04,Merced,47,269075,13736,12474,173,12647,177
2020-12-04,Modoc,49,8938,153,115,28,143,0
2020-12-04,Mono,51,14174,636,549,10,559,3
2020-12-04,Monterey,53,433212,18643,16737,375,17112,127
2020-12-04,Napa,55,140530,4037,3432,20,3452,19
2020-12-04,Nevada,57,99092,1949,1560,47,1607,10
2020-12-04,Orange,59,3164182,96494,83738,3093,86831,1597
2020-12-04,Placer,61,380077,9420,7461,234,7695,76
2020-12-04,Plumas,63,18699,299,232,0,232,0
2020-12-04,Riverside,65,2383286,112351,95255,3163,98418,1475
2020-12-04,Sacramento,67,1510023,45721,41061,199,41260,618
2020-12-04,San Benito,69,59416,2280,2006,16,2022,17
2020-12-04,San Bernardino,71,2135413,122035,102418,2247,104665,1290
2020-12-04,San Diego,73,3302833,98734,88183,0,88183,1047
2020-12-04,San Francisco,75,870044,17689,16499,140,16639,161
2020-12-04,San Joaquin,77,732212,31508,27806,739,28545,522
2020-12-04,San Luis Obispo,79,281455,7332,6473,125,6598,42
2020-12-04,San Mateo,81,765935,17238,15112,18,15130,173
2020-12-04,Santa Barbara,83,443738,13170,11947,303,12250,141
2020-12-04,Santa Clara,85,1922200,44595,37465,117,37582,468
2020-12-04,Santa Cruz,87,273765,5795,4985,93,5078,32
2020-12-04,Shasta,89,179085,6479,5439,345,5784,49
2020-12-04,Sierra,91,2930,19,17,0,17,0
2020-12-04,Siskiyou,93,43540,782,639,57,696,2
2020-12-04,Solano,95,438530,12402,11037,104,11141,87
2020-12-04,Sonoma,97,501317,14266,12962,88,13050,164
2020-12-04,Stanislaus,99,539301,25375,23206,1880,25086,448
2020-12-04,Sutter,101,95872,4504,3791,15,3806,20
2020-12-04,Tehama,103,63373,2116,1876,107,1983,9
2020-12-04,Trinity,105,12862,234,172,14,186,0
2020-12-04,Tulare,107,460477,24435,22273,2153,24426,322
2020-12-04,Tuolumne,109,53932,1385,1134,34,1168,7
2020-12-04,Ventura,111,848112,24921,22024,817,22841,189
2020-12-04,Yolo,113,214977,5958,5294,21,5315,87
2020-12-04,Yuba,115,75493,2579,2225,20,2245,10
2020-12-03,Alameda,1,1643700,34930,31184,467,31651,465
2020-12-03,Alpine,3,1148,58,53,0,53,0
2020-12-03,Amador,5,37829,1134,653,3,656,16
2020-12-03,Butte,7,227075,4844,4305,294,4599,65
2020-12-03,Calaveras,9,45235,635,572,1,573,21
2020-12-03,Colusa,11,21464,917,774,16,790,6
2020-12-03,Contra Costa,13,1133247,28028,25464,219,25683,265
2020-12-03,Del Norte,15,27424,468,388,0,388,2
2020-12-03,El Dorado,17,186661,3615,2740,55,2795,6
2020-12-03,Fresno,19,978130,47243,39680,1998,41678,516
2020-12-03,Glenn,21,27897,1143,997,77,1074,8
2020-12-03,Humboldt,23,135768,1140,923,3,926,9
2020-12-03,Imperial,25,180216,18039,16436,178,16614,359
2020-12-03,Inyo,27,18085,361,321,1,322,15
2020-12-03,Kern,29,883053,46277,42062,2085,44147,483
2020-12-03,Kings,31,150075,12834,11658,285,11943,87
2020-12-03,Lake,33,64148,1183,991,0,991,20
2020-12-03,Lassen,35,31185,2750,2128,8,2136,0
2020-12-03,Los Angeles,37,10098052,462573,415805,8634,424439,7787
2020-12-03,Madera,39,155013,7364,6398,210,6608,58
2020-12-03,Marin,41,260295,8168,7861,38,7899,136
2020-12-03,Mariposa,43,17540,166,132,3,135,2
2020-12-03,Mendocino,45,87422,1723,1547,5,1552,23
2020-12-03,Merced,47,269075,13489,12310,165,12475,177
2020-12-03,Modoc,49,8938,151,114,28,142,0
2020-12-03,Mono,51,14174,616,527,10,537,3
2020-12-03,Monterey,53,433212,18181,16218,362,16580,125
2020-12-03,Napa,55,140530,3924,3360,20,3380,19
2020-12-03,Nevada,57,99092,1872,1472,46,1518,10
2020-12-03,Orange,59,3164182,93998,82187,3018,85205,1591
2020-12-03,Placer,61,380077,9214,7270,218,7488,73
2020-12-03,Plumas,63,18699,285,223,0,223,0
2020-12-03,Riverside,65,2383286,109607,92489,2989,95478,1461
2020-12-03,Sacramento,67,1510023,44672,40280,186,40466,614
2020-12-03,San Benito,69,59416,2236,1967,16,1983,16
2020-12-03,San Bernardino,71,2135413,118716,100787,2158,102945,1283
2020-12-03,San Diego,73,3302833,96926,86144,0,86144,1040
2020-12-03,San Francisco,75,870044,17467,16236,139,16375,161
2020-12-03,San Joaquin,77,732212,30789,27239,689,27928,522
2020-12-03,San Luis Obispo,79,281455,7163,6388,124,6512,42
2020-12-03,San Mateo,81,765935,16887,14909,17,14926,173
2020-12-03,Santa Barbara,83,443738,13042,11829,296,12125,141
2020-12-03,Santa Clara,85,1922200,43400,36621,111,36732,465
2020-12-03,Santa Cruz,87,273765,5653,4850,89,4939,28
2020-12-03,Shasta,89,179085,6370,5330,338,5668,48
2020-12-03,Sierra,91,2930,19,17,0,17,0
2020-12-03,Siskiyou,93,43540,767,629,54,683,2
2020-12-03,Solano,95,438530,12191,10857,101,10958,87
2020-12-03,Sonoma,97,501317,14022,12772,87,12859,164
2020-12-03,Stanislaus,99,539301,24970,22821,1827,24648,447
2020-12-03,Sutter,101,95872,4421,3727,14,3741,20
2020-12-03,Tehama,103,63373,2065,1832,98,1930,9
2020-12-03,Trinity,105,12862,232,166,14,180,0
2020-12-03,Tulare,107,460477,24040,21993,2057,24050,321
2020-12-03,Tuolumne,109,53932,1344,1105,34,1139,7
2020-12-03,Ventura,111,848112,24218,21555,802,22357,187
2020-12-03,Yolo,113,214977,5820,5069,21,5090,87
2020-12-03,Yuba,115,75493,2510,2182,18,2200,10
2020-12-02,Alameda,1,1643700,34310,30697,455,31152,463
2020-12-02,Alpine,3,1148,57,52,0,52,0
2020-12-02,Amador,5,37829,1062,585,3,588,16
2020-12-02,Butte,7,227075,4722,4243,284,4527,65
2020-12-02,Calaveras,9,45235,618,553,1,554,21
2020-12-02,Colusa,11,21464,901,756,15,771,6
2020-12-02,Contra Costa,13,1133247,27571,25147,206,25353,264
2020-12-02,Del Norte,15,27424,454,384,0,384,2
2020-12-02,El Dorado,17,186661,3515,2638,49,2687,5
2020-12-02,Fresno,19,978130,46498,39324,1888,41212,507
2020-12-02,Glenn,21,27897,1126,995,69,1064,7
2020-12-02,Humboldt,23,135768,1114,899,3,902,9
2020-12-02,Imperial,25,180216,17615,16360,170,16530,356
2020-12-02,Inyo,27,18085,354,314,1,315,15
2020-12-02,Kern,29,883053,45387,41660,1980,43640,479
2020-12-02,Kings,31,150075,12481,11531,271,11802,86
2020-12-02,Lake,33,64148,1154,971,0,971,20
2020-12-02,Lassen,35,31185,2691,2115,8,2123,0
2020-12-02,Los Angeles,37,10098052,452573,408289,8275,416564,7739
2020-12-02,Madera,39,155013,7241,6370,202,6572,57
2020-12-02,Marin,41,260295,8122,7819,36,7855,136
2020-12-02,Mariposa,43,17540,163,131,3,134,2
2020-12-02,Mendocino,45,87422,1690,1524,5,1529,23
2020-12-02,Merced,47,269075,13247,12168,158,12326,173
2020-12-02,Modoc,49,8938,148,113,28,141,0
2020-12-02,Mono,51,14174,607,520,10,530,3
2020-12-02,Monterey,53,433212,17707,16064,323,16387,121
2020-12-02,Napa,55,140530,3821,3298,19,3317,19
2020-12-02,Nevada,57,99092,1810,1430,45,1475,9
2020-12-02,Orange,59,3164182,91819,81046,2933,83979,1569
2020-12-02,Placer,61,380077,8982,6941,203,7144,73
2020-12-02,Plumas,63,18699,272,218,0,218,0
2020-12-02,Riverside,65,2383286,106899,90089,2797,92886,1451
2020-12-02,Sacramento,67,1510023,43642,39334,175,39509,597
2020-12-02,San Benito,69,59416,2172,1921,16,1937,16
2020-12-02,San Bernardino,71,2135413,115158,98567,2040,100607,1240
2020-12-02,San Diego,73,3302833,95012,84640,0,84640,1035
2020-12-02,San Francisco,75,870044,17229,16058,137,16195,157
2020-12-02,San Joaquin,77,732212,30169,26740,665,27405,519
2020-12-02,San Luis Obispo,79,281455,7065,6324,121,6445,42
2020-12-02,San Mateo,81,765935,16525,14757,16,14773,170
2020-12-02,Santa Barbara,83,443738,12891,11705,282,11987,140
2020-12-02,Santa Clara,85,1922200,42283,35878,110,35988,458
2020-12-02,Santa Cruz,87,273765,5521,4766,86,4852,27
2020-12-02,Shasta,89,179085,6246,5188,321,5509,47
2020-12-02,Sierra,91,2930,19,17,0,17,0
2020-12-02,Siskiyou,93,43540,751,624,52,676,1
2020-12-02,Solano,95,438530,11946,10701,96,10797,87
2020-12-02,Sonoma,97,501317,13783,12635,86,12721,163
2020-12-02,Stanislaus,99,539301,24475,22615,1767,24382,448
2020-12-02,Sutter,101,95872,4268,3604,14,3618,18
2020-12-02,Tehama,103,63373,2022,1800,82,1882,9
2020-12-02,Trinity,105,12862,225,165,14,179,0
2020-12-02,Tulare,107,460477,23664,21789,1970,23759,321
2020-12-02,Tuolumne,109,53932,1304,1076,34,1110,7
2020-12-02,Ventura,111,848112,23810,21208,783,21991,186
2020-12-02,Yolo,113,214977,5709,5053,20,5073,87
2020-12-02,Yuba,115,75493,2433,2119,17,2136,10
2020-12-01,Alameda,1,1643700,33624,30252,443,30695,460
2020-12-01,Alpine,3,1148,57,41,0,41,0
2020-12-01,Amador,5,37829,915,575,2,577,16
2020-12-01,Butte,7,227075,4618,4177,268,4445,65
2020-12-01,Calaveras,9,45235,600,544,1,545,21
2020-12-01,Colusa,11,21464,884,747,15,762,6
2020-12-01,Contra Costa,13,1133247,26998,24788,198,24986,264
2020-12-01,Del Norte,15,27424,426,357,0,357,2
2020-12-01,El Dorado,17,186661,3370,2542,44,2586,4
2020-12-01,Fresno,19,978130,45602,39004,1804,40808,505
2020-12-01,Glenn,21,27897,1105,989,65,1054,7
2020-12-01,Humboldt,23,135768,1083,886,3,889,9
2020-12-01,Imperial,25,180216,17302,16278,167,16445,356
2020-12-01,Inyo,27,18085,347,304,1,305,15
2020-12-01,Kern,29,883053,44587,41345,1844,43189,478
2020-12-01,Kings,31,150075,12168,11415,255,11670,86
2020-12-01,Lake,33,64148,1136,969,0,969,19
2020-12-01,Lassen,35,31185,2525,2047,7,2054,0
2020-12-01,Los Angeles,37,10098052,442242,403266,7933,411199,7704
2020-12-01,Madera,39,155013,7125,6270,193,6463,57
2020-12-01,Marin,41,260295,8052,7787,35,7822,136
2020-12-01,Mariposa,43,17540,158,128,3,131,2
2020-12-01,Mendocino,45,87422,1656,1497,5,1502,23
2020-12-01,Merced,47,269075,13005,12032,148,12180,172
2020-12-01,Modoc,49,8938,143,113,24,137,0
2020-12-01,Mono,51,14174,599,520,10,530,3
2020-12-01,Monterey,53,433212,17201,15835,312,16147,121
2020-12-01,Napa,55,140530,3737,3124,18,3142,19
2020-12-01,Nevada,57,99092,1748,1411,44,1455,9
2020-12-01,Orange,59,3164182,89733,79468,2842,82310,1567
2020-12-01,Placer,61,380077,8655,6794,196,6990,72
2020-12-01,Plumas,63,18699,260,201,0,201,0
2020-12-01,Riverside,65,2383286,104106,88530,2629,91159,1448
2020-12-01,Sacramento,67,1510023,42595,38966,170,39136,589
2020-12-01,San Benito,69,59416,2117,1888,16,1904,15
2020-12-01,San Bernardino,71,2135413,111690,95854,1909,97763,1220
2020-12-01,San Diego,73,3302833,92755,83423,0,83423,1019
2020-12-01,San Francisco,75,870044,16949,15797,133,15930,157
2020-12-01,San Joaquin,77,732212,29367,26432,643,27075,514
2020-12-01,San Luis Obispo,79,281455,6925,6264,116,6380,40
2020-12-01,San Mateo,81,765935,16200,14495,16,14511,170
2020-12-01,Santa Barbara,83,443738,12751,11611,272,11883,140
2020-12-01,Santa Clara,85,1922200,41029,35397,105,35502,452
2020-12-01,Santa Cruz,87,273765,5365,4638,78,4716,27
2020-12-01,Shasta,89,179085,6118,5077,299,5376,47
2020-12-01,Sierra,91,2930,19,17,0,17,0
2020-12-01,Siskiyou,93,43540,737,608,48,656,1
2020-12-01,Solano,95,438530,11688,10604,90,10694,87
2020-12-01,Sonoma,97,501317,13578,12491,83,12574,163
2020-12-01,Stanislaus,99,539301,24020,22351,1709,24060,447
2020-12-01,Sutter,101,95872,4127,3538,14,3552,17
2020-12-01,Tehama,103,63373,1963,1773,73,1846,9
2020-12-01,Trinity,105,12862,216,165,13,178,0
2020-12-01,Tulare,107,460477,23212,21645,1895,23540,319
2020-12-01,Tuolumne,109,53932,1268,1052,31,1083,7
2020-12-01,Ventura,111,848112,23197,20604,761,21365,186
2020-12-01,Yolo,113,214977,5573,4928,20,4948,86
2020-12-01,Yuba,115,75493,2367,2088,16,2104,10
2020-11-30,Alameda,1,1643700,32810,29972,425,30397,457
2020-11-30,Alpine,3,1148,55,41,0,41,0
2020-11-30,Amador,5,37829,874,559,2,561,16
2020-11-30,Butte,7,227075,4501,4148,251,4399,65
2020-11-30,Calaveras,9,45235,578,478,1,479,21
2020-11-30,Colusa,11,21464,857,737,11,748,6
2020-11-30,Contra Costa,13,1133247,26422,24365,194,24559,264
2020-11-30,Del Norte,15,27424,403,339,0,339,2
2020-11-30,El Dorado,17,186661,3196,2488,39,2527,4
2020-11-30,Fresno,19,978130,44498,38712,1683,40395,500
2020-11-30,Glenn,21,27897,1082,954,60,1014,5
2020-11-30,Humboldt,23,135768,1036,870,3,873,9
2020-11-30,Imperial,25,180216,17049,16212,143,16355,356
2020-11-30,Inyo,27,18085,342,304,1,305,15
2020-11-30,Kern,29,883053,43833,40941,1697,42638,473
2020-11-30,Kings,31,150075,12022,11346,238,11584,85
2020-11-30,Lake,33,64148,1105,939,0,939,18
2020-11-30,Lassen,35,31185,2432,1793,7,1800,0
2020-11-30,Los Angeles,37,10098052,431593,396202,7585,403787,7658
2020-11-30,Madera,39,155013,6957,6210,179,6389,57
2020-11-30,Marin,41,260295,8009,7764,34,7798,136
2020-11-30,Mariposa,43,17540,151,123,3,126,2
2020-11-30,Mendocino,45,87422,1629,1482,5,1487,23
2020-11-30,Merced,47,269075,12731,11913,137,12050,172
2020-11-30,Modoc,49,8938,133,113,24,137,0
2020-11-30,Mono,51,14174,578,519,10,529,3
2020-11-30,Monterey,53,433212,16772,15837,304,16141,119
2020-11-30,Napa,55,140530,3638,3091,17,3108,18
2020-11-30,Nevada,57,99092,1661,1347,41,1388,9
2020-11-30,Orange,59,3164182,87641,78711,2744,81455,1568
2020-11-30,Placer,61,380077,8359,6575,183,6758,72
2020-11-30,Plumas,63,18699,249,192,0,192,0
2020-11-30,Riverside,65,2383286,101120,87722,2474,90196,1446
2020-11-30,Sacramento,67,1510023,41518,37834,162,37996,586
2020-11-30,San Benito,69,59416,2068,1875,15,1890,15
2020-11-30,San Bernardino,71,2135413,107957,92704,1790,94494,1220
2020-11-30,San Diego,73,3302833,90395,82045,0,82045,997
2020-11-30,San Francisco,75,870044,16651,15638,130,15768,157
2020-11-30,San Joaquin,77,732212,28663,25742,616,26358,509
2020-11-30,San Luis Obispo,79,281455,6790,6224,114,6338,36
2020-11-30,San Mateo,81,765935,15839,14276,16,14292,170
2020-11-30,Santa Barbara,83,443738,12573,11572,265,11837,140
2020-11-30,Santa Clara,85,1922200,39822,35019,104,35123,451
2020-11-30,Santa Cruz,87,273765,5226,4558,74,4632,26
2020-11-30,Shasta,89,179085,5977,4933,265,5198,44
2020-11-30,Sierra,91,2930,19,16,0,16,0
2020-11-30,Siskiyou,93,43540,728,605,44,649,1
2020-11-30,Solano,95,438530,11427,10392,85,10477,87
2020-11-30,Sonoma,97,501317,13333,12232,79,12311,163
2020-11-30,Stanislaus,99,539301,23564,22110,1663,23773,446
2020-11-30,Sutter,101,95872,3973,3430,13,3443,16
2020-11-30,Tehama,103,63373,1915,1724,67,1791,9
2020-11-30,Trinity,105,12862,211,162,13,175,0
2020-11-30,Tulare,107,460477,22828,20833,1798,22631,319
2020-11-30,Tuolumne,109,53932,1223,1027,31,1058,7
2020-11-30,Ventura,111,848112,22438,20308,745,21053,180
2020-11-30,Yolo,113,214977,5461,4894,20,4914,81
2020-11-30,Yuba,115,75493,2307,2028,14,2042,10
2020-11-29,Alameda,1,1643700,32026,29918,403,30321,457
2020-11-29,Alpine,3,1148,52,41,0,41,0
2020-11-29,Amador,5,37829,723,548,2,550,16
2020-11-29,Butte,7,227075,4402,4008,229,4237,65
2020-11-29,Calaveras,9,45235,546,478,1,479,21
2020-11-29,Colusa,11,21464,828,723,7,730,6
2020-11-29,Contra Costa,13,1133247,25919,24165,188,24353,264
2020-11-29,Del Norte,15,27424,397,339,0,339,2
2020-11-29,El Dorado,17,186661,3067,2447,38,2485,4
2020-11-29,Fresno,19,978130,43553,38568,1606,40174,500
2020-11-29,Glenn,21,27897,1059,951,58,1009,4
2020-11-29,Humboldt,23,135768,1007,856,3,859,9
2020-11-29,Imperial,25,180216,16822,16138,114,16252,356
2020-11-29,Inyo,27,18085,327,289,1,290,15
2020-11-29,Kern,29,883053,43076,40596,1545,42141,473
2020-11-29,Kings,31,150075,11874,11247,218,11465,85
2020-11-29,Lake,33,64148,1081,927,0,927,18
2020-11-29,Lassen,35,31185,2329,1793,7,1800,0
2020-11-29,Los Angeles,37,10098052,421224,391162,7266,398428,7642
2020-11-29,Madera,39,155013,6814,6184,173,6357,57
2020-11-29,Marin,41,260295,7943,7739,32,7771,135
2020-11-29,Mariposa,43,17540,147,123,3,126,2
2020-11-29,Mendocino,45,87422,1594,1473,5,1478,23
2020-11-29,Merced,47,269075,12494,11773,128,11901,172
2020-11-29,Modoc,49,8938,129,105,22,127,0
2020-11-29,Mono,51,14174,556,515,10,525,3
2020-11-29,Monterey,53,433212,16461,15621,297,15918,119
2020-11-29,Napa,55,140530,3533,3090,16,3106,18
2020-11-29,Nevada,57,99092,1580,1311,39,1350,9
2020-11-29,Orange,59,3164182,85623,78057,2695,80752,1567
2020-11-29,Placer,61,380077,8071,6535,169,6704,72
2020-11-29,Plumas,63,18699,244,191,0,191,0
2020-11-29,Riverside,65,2383286,98740,87383,2318,89701,1442
2020-11-29,Sacramento,67,1510023,40444,37415,154,37569,585
2020-11-29,San Benito,69,59416,2024,1860,15,1875,15
2020-11-29,San Bernardino,71,2135413,104616,92052,1684,93736,1223
2020-11-29,San Diego,73,3302833,87984,81086,0,81086,997
2020-11-29,San Francisco,75,870044,16371,15571,123,15694,153
2020-11-29,San Joaquin,77,732212,27921,25740,610,26350,509
2020-11-29,San Luis Obispo,79,281455,6668,6145,114,6259,36
2020-11-29,San Mateo,81,765935,15506,14177,16,14193,169
2020-11-29,Santa Barbara,83,443738,12419,11520,261,11781,140
2020-11-29,Santa Clara,85,1922200,38617,34234,98,34332,451
2020-11-29,Santa Cruz,87,273765,5067,4490,72,4562,26
2020-11-29,Shasta,89,179085,5805,4935,233,5168,43
2020-11-29,Sierra,91,2930,19,16,0,16,0
2020-11-29,Siskiyou,93,43540,705,590,42,632,1
2020-11-29,Solano,95,438530,11195,10393,81,10474,87
2020-11-29,Sonoma,97,501317,13081,12052,75,12127,163
2020-11-29,Stanislaus,99,539301,23073,21701,1623,23324,446
2020-11-29,Sutter,101,95872,3856,3297,13,3310,16
2020-11-29,Tehama,103,63373,1864,1710,51,1761,9
2020-11-29,Trinity,105,12862,208,159,13,172,0
2020-11-29,Tulare,107,460477,22470,20793,1713,22506,319
2020-11-29,Tuolumne,109,53932,1187,988,31,1019,7
2020-11-29,Ventura,111,848112,21754,19952,732,20684,179
2020-11-29,Yolo,113,214977,5323,4830,19,4849,80
2020-11-29,Yuba,115,75493,2252,1959,14,1973,10
2020-11-28,Alameda,1,1643700,31716,29368,398,29766,456
2020-11-28,Alpine,3,1148,52,41,0,41,0
2020-11-28,Amador,5,37829,646,536,2,538,16
2020-11-28,Butte,7,227075,4344,3894,225,4119,65
2020-11-28,Calaveras,9,45235,542,478,1,479,21
2020-11-28,Colusa,11,21464,819,711,5,716,6
2020-11-28,Contra Costa,13,1133247,25585,23798,184,23982,264
2020-11-28,Del Norte,15,27424,387,328,0,328,2
2020-11-28,El Dorado,17,186661,2999,2415,32,2447,4
2020-11-28,Fresno,19,978130,43209,38288,1565,39853,500
2020-11-28,Glenn,21,27897,1048,925,54,979,4
2020-11-28,Humboldt,23,135768,973,844,3,847,9
2020-11-28,Imperial,25,180216,16758,16019,112,16131,356
2020-11-28,Inyo,27,18085,319,289,1,290,15
2020-11-28,Kern,29,883053,42715,40255,1456,41711,473
2020-11-28,Kings,31,150075,11810,11070,209,11279,85
2020-11-28,Lake,33,64148,1066,920,0,920,18
2020-11-28,Lassen,35,31185,2263,1714,7,1721,0
2020-11-28,Los Angeles,37,10098052,416315,386194,7103,393297,7625
2020-11-28,Madera,39,155013,6712,6119,166,6285,57
2020-11-28,Marin,41,260295,7914,7696,28,7724,135
2020-11-28,Mariposa,43,17540,144,120,3,123,2
2020-11-28,Mendocino,45,87422,1563,1458,5,1463,22
2020-11-28,Merced,47,269075,12397,11688,121,11809,172
2020-11-28,Modoc,49,8938,126,103,22,125,0
2020-11-28,Mono,51,14174,549,505,10,515,3
2020-11-28,Monterey,53,433212,16295,15328,293,15621,118
2020-11-28,Napa,55,140530,3482,3033,15,3048,18
2020-11-28,Nevada,57,99092,1552,1272,37,1309,9
2020-11-28,Orange,59,3164182,84530,76882,2647,79529,1568
2020-11-28,Placer,61,380077,7917,6497,166,6663,70
2020-11-28,Plumas,63,18699,237,188,0,188,0
2020-11-28,Riverside,65,2383286,97339,86854,2212,89066,1440
2020-11-28,Sacramento,67,1510023,39863,36905,150,37055,580
2020-11-28,San Benito,69,59416,1979,1835,15,1850,15
2020-11-28,San Bernardino,71,2135413,103220,91183,1580,92763,1224
2020-11-28,San Diego,73,3302833,86730,80020,0,80020,997
2020-11-28,San Francisco,75,870044,16194,15450,115,15565,153
2020-11-28,San Joaquin,77,732212,27726,25742,595,26337,509
2020-11-28,San Luis Obispo,79,281455,6598,6106,110,6216,36
2020-11-28,San Mateo,81,765935,15316,14040,16,14056,169
2020-11-28,Santa Barbara,83,443738,12317,11481,256,11737,140
2020-11-28,Santa Clara,85,1922200,37871,33701,96,33797,449
2020-11-28,Santa Cruz,87,273765,4990,4426,72,4498,26
2020-11-28,Shasta,89,179085,5727,4882,226,5108,43
2020-11-28,Sierra,91,2930,19,16,0,16,0
2020-11-28,Siskiyou,93,43540,695,558,39,597,1
2020-11-28,Solano,95,438530,11076,10252,79,10331,87
2020-11-28,Sonoma,97,501317,12978,12008,65,12073,162
2020-11-28,Stanislaus,99,539301,22839,21574,1585,23159,446
2020-11-28,Sutter,101,95872,3772,3244,13,3257,15
2020-11-28,Tehama,103,63373,1848,1678,47,1725,9
2020-11-28,Trinity,105,12862,206,157,11,168,0
2020-11-28,Tulare,107,460477,22281,20701,1665,22366,319
2020-11-28,Tuolumne,109,53932,1165,976,31,1007,7
2020-11-28,Ventura,111,848112,21456,19510,722,20232,179
2020-11-28,Yolo,113,214977,5249,4739,17,4756,80
2020-11-28,Yuba,115,75493,2198,1912,14,1926,10
2020-11-27,Alameda,1,1643700,31278,29064,387,29451,450
2020-11-27,Alpine,3,1148,52,41,0,41,0
2020-11-27,Amador,5,37829,599,498,1,499,16
2020-11-27,Butte,7,227075,4303,3894,219,4113,65
2020-11-27,Calaveras,9,45235,534,478,1,479,21
2020-11-27,Colusa,11,21464,802,694,3,697,6
2020-11-27,Contra Costa,13,1133247,25326,23463,178,23641,264
2020-11-27,Del Norte,15,27424,381,307,0,307,2
2020-11-27,El Dorado,17,186661,2927,2238,29,2267,4
2020-11-27,Fresno,19,978130,42803,37994,1505,39499,500
2020-11-27,Glenn,21,27897,1035,891,49,940,4
2020-11-27,Humboldt,23,135768,954,795,2,797,9
2020-11-27,Imperial,25,180216,16691,15960,102,16062,356
2020-11-27,Inyo,27,18085,313,289,1,290,15
2020-11-27,Kern,29,883053,42297,39707,1380,41087,473
2020-11-27,Kings,31,150075,11724,10667,191,10858,85
2020-11-27,Lake,33,64148,1030,909,0,909,18
2020-11-27,Lassen,35,31185,2251,1714,7,1721,0
2020-11-27,Los Angeles,37,10098052,409817,382740,6935,389675,7606
2020-11-27,Madera,39,155013,6640,6050,160,6210,57
2020-11-27,Marin,41,260295,7871,7660,28,7688,135
2020-11-27,Mariposa,43,17540,142,118,3,121,2
2020-11-27,Mendocino,45,87422,1548,1387,5,1392,22
2020-11-27,Merced,47,269075,12291,11550,114,11664,172
2020-11-27,Modoc,49,8938,125,100,22,122,0
2020-11-27,Mono,51,14174,545,498,10,508,3
2020-11-27,Monterey,53,433212,16127,14753,293,15046,113
2020-11-27,Napa,55,140530,3442,2988,15,3003,18
2020-11-27,Nevada,57,99092,1522,1184,35,1219,9
2020-11-27,Orange,59,3164182,83250,75151,2605,77756,1568
2020-11-27,Placer,61,380077,7757,6283,156,6439,68
2020-11-27,Plumas,63,18699,234,188,0,188,0
2020-11-27,Riverside,65,2383286,95741,85769,2049,87818,1440
2020-11-27,Sacramento,67,1510023,39242,36579,146,36725,579
2020-11-27,San Benito,69,59416,1945,1805,14,1819,15
2020-11-27,San Bernardino,71,2135413,101717,90254,1494,91748,1224
2020-11-27,San Diego,73,3302833,85538,78161,0,78161,996
2020-11-27,San Francisco,75,870044,16039,15377,113,15490,153
2020-11-27,San Joaquin,77,732212,27507,25741,574,26315,509
2020-11-27,San Luis Obispo,79,281455,6515,6039,107,6146,36
2020-11-27,San Mateo,81,765935,15113,13872,15,13887,169
2020-11-27,Santa Barbara,83,443738,12224,11340,253,11593,140
2020-11-27,Santa Clara,85,1922200,37195,32935,89,33024,449
2020-11-27,Santa Cruz,87,273765,4919,4358,70,4428,26
2020-11-27,Shasta,89,179085,5650,4710,213,4923,43
2020-11-27,Sierra,91,2930,18,16,0,16,0
2020-11-27,Siskiyou,93,43540,680,554,36,590,1
2020-11-27,Solano,95,438530,10957,10044,76,10120,87
2020-11-27,Sonoma,97,501317,12846,11924,63,11987,162
2020-11-27,Stanislaus,99,539301,22613,21185,1554,22739,446
2020-11-27,Sutter,101,95872,3706,3101,12,3113,15
2020-11-27,Tehama,103,63373,1820,1649,43,1692,9
2020-11-27,Trinity,105,12862,202,151,11,162,0
2020-11-27,Tulare,107,460477,22095,20634,1606,22240,319
2020-11-27,Tuolumne,109,53932,1134,881,31,912,7
2020-11-27,Ventura,111,848112,21134,19379,699,20078,179
2020-11-27,Yolo,113,214977,5200,4737,17,4754,79
2020-11-27,Yuba,115,75493,2169,1864,13,1877,10
2020-11-26,Alameda,1,1643700,30866,28797,368,29165,447
2020-11-26,Alpine,3,1148,52,41,0,41,0
2020-11-26,Amador,5,37829,591,488,1,489,16
2020-11-26,Butte,7,227075,4240,3894,213,4107,65
2020-11-26,Calaveras,9,45235,506,478,1,479,21
2020-11-26,Colusa,11,21464,788,694,3,697,6
2020-11-26,Contra Costa,13,1133247,24992,23468,172,23640,264
2020-11-26,Del Norte,15,27424,370,307,0,307,2
2020-11-26,El Dorado,17,186661,2846,2217,27,2244,4
2020-11-26,Fresno,19,978130,42403,37724,1458,39182,500
2020-11-26,Glenn,21,27897,1020,892,46,938,4
2020-11-26,Humboldt,23,135768,931,795,1,796,9
2020-11-26,Imperial,25,180216,16583,15722,97,15819,355
2020-11-26,Inyo,27,18085,312,289,1,290,15
2020-11-26,Kern,29,883053,41860,39123,1308,40431,471
2020-11-26,Kings,31,150075,11669,10475,178,10653,85
2020-11-26,Lake,33,64148,1017,890,0,890,18
2020-11-26,Lassen,35,31185,2236,1714,7,1721,0
2020-11-26,Los Angeles,37,10098052,404685,378340,6685,385025,7581
2020-11-26,Madera,39,155013,6566,6003,154,6157,57
2020-11-26,Marin,41,260295,7834,7610,28,7638,135
2020-11-26,Mariposa,43,17540,137,116,3,119,2
2020-11-26,Mendocino,45,87422,1534,1387,4,1391,22
2020-11-26,Merced,47,269075,12144,11440,112,11552,172
2020-11-26,Modoc,49,8938,123,100,22,122,0
2020-11-26,Mono,51,14174,537,485,8,493,2
2020-11-26,Monterey,53,433212,15890,14750,285,15035,113
2020-11-26,Napa,55,140530,3377,2988,15,3003,18
2020-11-26,Nevada,57,99092,1476,1184,35,1219,9
2020-11-26,Orange,59,3164182,81896,74264,2539,76803,1563
2020-11-26,Placer,61,380077,7597,6278,147,6425,68
2020-11-26,Plumas,63,18699,226,188,0,188,0
2020-11-26,Riverside,65,2383286,94153,85774,1915,87689,1440
2020-11-26,Sacramento,67,1510023,38598,35854,138,35992,580
2020-11-26,San Benito,69,59416,1918,1769,14,1783,15
2020-11-26,San Bernardino,71,2135413,100075,89727,1398,91125,1223
2020-11-26,San Diego,73,3302833,83929,76359,0,76359,996
2020-11-26,San Francisco,75,870044,15902,15156,110,15266,153
2020-11-26,San Joaquin,77,732212,27254,25738,559,26297,509
2020-11-26,San Luis Obispo,79,281455,6422,5964,104,6068,36
2020-11-26,San Mateo,81,765935,14926,13715,13,13728,169
2020-11-26,Santa Barbara,83,443738,12143,11277,252,11529,139
2020-11-26,Santa Clara,85,1922200,36555,32411,80,32491,446
2020-11-26,Santa Cruz,87,273765,4789,4269,64,4333,26
2020-11-26,Shasta,89,179085,5569,4712,201,4913,43
2020-11-26,Sierra,91,2930,18,15,0,15,0
2020-11-26,Siskiyou,93,43540,670,526,35,561,1
2020-11-26,Solano,95,438530,10814,9941,74,10015,87
2020-11-26,Sonoma,97,501317,12698,11922,61,11983,162
2020-11-26,Stanislaus,99,539301,22385,21186,1510,22696,445
2020-11-26,Sutter,101,95872,3612,3101,11,3112,15
2020-11-26,Tehama,103,63373,1779,1612,39,1651,9
2020-11-26,Trinity,105,12862,199,139,11,150,0
2020-11-26,Tulare,107,460477,21860,20649,1537,22186,319
2020-11-26,Tuolumne,109,53932,1106,871,31,902,7
2020-11-26,Ventura,111,848112,20637,19058,684,19742,179
2020-11-26,Yolo,113,214977,5112,4566,17,4583,76
2020-11-26,Yuba,115,75493,2111,1865,11,1876,10
2020-11-25,Alameda,1,1643700,30650,28378,360,28738,447
2020-11-25,Alpine,3,1148,52,41,0,41,0
2020-11-25,Amador,5,37829,581,484,1,485,16
2020-11-25,Butte,7,227075,4210,3848,210,4058,64
2020-11-25,Calaveras,9,45235,503,475,1,476,21
2020-11-25,Colusa,11,21464,771,693,3,696,6
2020-11-25,Contra Costa,13,1133247,24837,23307,171,23478,263
2020-11-25,Del Norte,15,27424,369,304,0,304,2
2020-11-25,El Dorado,17,186661,2810,2154,27,2181,4
2020-11-25,Fresno,19,978130,42171,37349,1436,38785,494
2020-11-25,Glenn,21,27897,1003,891,44,935,4
2020-11-25,Humboldt,23,135768,923,777,1,778,9
2020-11-25,Imperial,25,180216,16513,15640,95,15735,355
2020-11-25,Inyo,27,18085,310,289,1,290,15
2020-11-25,Kern,29,883053,41706,38878,1289,40167,467
2020-11-25,Kings,31,150075,11634,10417,174,10591,85
2020-11-25,Lake,33,64148,1000,878,0,878,18
2020-11-25,Lassen,35,31185,2194,1701,7,1708,0
2020-11-25,Los Angeles,37,10098052,401667,373919,6573,380492,7545
2020-11-25,Madera,39,155013,6544,5989,151,6140,57
2020-11-25,Marin,41,260295,7807,7601,27,7628,135
2020-11-25,Mariposa,43,17540,136,114,3,117,2
2020-11-25,Mendocino,45,87422,1515,1373,4,1377,22
2020-11-25,Merced,47,269075,12086,11346,112,11458,172
2020-11-25,Modoc,49,8938,123,96,22,118,0
2020-11-25,Mono,51,14174,532,487,8,495,2
2020-11-25,Monterey,53,433212,15773,14695,283,14978,113
2020-11-25,Napa,55,140530,3344,2945,15,2960,17
2020-11-25,Nevada,57,99092,1458,1170,33,1203,9
2020-11-25,Orange,59,3164182,81154,73014,2519,75533,1551
2020-11-25,Placer,61,380077,7523,6221,146,6367,68
2020-11-25,Plumas,63,18699,221,183,0,183,0
2020-11-25,Riverside,65,2383286,93617,85077,1892,86969,1438
2020-11-25,Sacramento,67,1510023,38257,35687,135,35822,574
2020-11-25,San Benito,69,59416,1896,1764,14,1778,15
2020-11-25,San Bernardino,71,2135413,99238,88469,1367,89836,1225
2020-11-25,San Diego,73,3302833,83276,75307,0,75307,988
2020-11-25,San Francisco,75,870044,15797,15053,108,15161,153
2020-11-25,San Joaquin,77,732212,27129,25556,547,26103,515
2020-11-25,San Luis Obispo,79,281455,6379,5913,103,6016,34
2020-11-25,San Mateo,81,765935,14811,13614,13,13627,170
2020-11-25,Santa Barbara,83,443738,12093,11183,252,11435,138
2020-11-25,Santa Clara,85,1922200,36108,32032,79,32111,442
2020-11-25,Santa Cruz,87,273765,4738,4202,62,4264,25
2020-11-25,Shasta,89,179085,5523,4588,194,4782,43
2020-11-25,Sierra,91,2930,18,15,0,15,0
2020-11-25,Siskiyou,93,43540,663,499,35,534,1
2020-11-25,Solano,95,438530,10709,9832,73,9905,87
2020-11-25,Sonoma,97,501317,12635,11775,60,11835,162
2020-11-25,Stanislaus,99,539301,22256,21022,1481,22503,445
2020-11-25,Sutter,101,95872,3568,3064,11,3075,14
2020-11-25,Tehama,103,63373,1767,1587,35,1622,9
2020-11-25,Trinity,105,12862,197,135,11,146,0
2020-11-25,Tulare,107,460477,21770,20528,1504,22032,318
2020-11-25,Tuolumne,109,53932,1089,842,31,873,7
2020-11-25,Ventura,111,848112,20544,18914,678,19592,179
2020-11-25,Yolo,113,214977,5076,4527,17,4544,76
2020-11-25,Yuba,115,75493,2085,1840,11,1851,10
2020-11-24,Alameda,1,1643700,30172,28030,349,28379,444
2020-11-24,Alpine,3,1148,52,41,0,41,0
2020-11-24,Amador,5,37829,556,470,1,471,16
2020-11-24,Butte,7,227075,4124,3798,202,4000,63
2020-11-24,Calaveras,9,45235,496,466,1,467,21
2020-11-24,Colusa,11,21464,753,682,3,685,6
2020-11-24,Contra Costa,13,1133247,24483,23072,165,23237,259
2020-11-24,Del Norte,15,27424,359,298,0,298,2
2020-11-24,El Dorado,17,186661,2705,2005,26,2031,4
2020-11-24,Fresno,19,978130,41770,37021,1358,38379,493
2020-11-24,Glenn,21,27897,985,883,40,923,4
2020-11-24,Humboldt,23,135768,904,774,1,775,9
2020-11-24,Imperial,25,180216,16413,15600,88,15688,355
2020-11-24,Inyo,27,18085,309,282,1,283,15
2020-11-24,Kern,29,883053,41236,38551,1210,39761,465
2020-11-24,Kings,31,150075,11367,10338,161,10499,85
2020-11-24,Lake,33,64148,985,872,0,872,18
2020-11-24,Lassen,35,31185,2172,1657,7,1664,0
2020-11-24,Los Angeles,37,10098052,395373,370008,6331,376339,7501
2020-11-24,Madera,39,155013,6461,5881,144,6025,57
2020-11-24,Marin,41,260295,7760,7591,27,7618,135
2020-11-24,Mariposa,43,17540,127,114,1,115,2
2020-11-24,Mendocino,45,87422,1493,1346,4,1350,22
2020-11-24,Merced,47,269075,11897,11268,107,11375,171
2020-11-24,Modoc,49,8938,119,91,22,113,0
2020-11-24,Mono,51,14174,529,483,8,491,2
2020-11-24,Monterey,53,433212,15515,14354,271,14625,113
2020-11-24,Napa,55,140530,3278,2904,15,2919,17
2020-11-24,Nevada,57,99092,1395,1156,30,1186,9
2020-11-24,Orange,59,3164182,79720,71975,2434,74409,1547
2020-11-24,Placer,61,380077,7343,6147,139,6286,67
2020-11-24,Plumas,63,18699,218,180,0,180,0
2020-11-24,Riverside,65,2383286,91868,83685,1758,85443,1420
2020-11-24,Sacramento,67,1510023,37578,35097,127,35224,568
2020-11-24,San Benito,69,59416,1865,1740,13,1753,15
2020-11-24,San Bernardino,71,2135413,96906,86645,1259,87904,1226
2020-11-24,San Diego,73,3302833,81870,74363,0,74363,984
2020-11-24,San Francisco,75,870044,15602,14874,105,14979,153
2020-11-24,San Joaquin,77,732212,26815,25318,516,25834,517
2020-11-24,San Luis Obispo,79,281455,6316,5805,102,5907,34
2020-11-24,San Mateo,81,765935,14602,13558,12,13570,170
2020-11-24,Santa Barbara,83,443738,11987,11154,250,11404,138
2020-11-24,Santa Clara,85,1922200,35322,31564,75,31639,438
2020-11-24,Santa Cruz,87,273765,4626,4132,61,4193,25
2020-11-24,Shasta,89,179085,5423,4410,175,4585,43
2020-11-24,Sierra,91,2930,18,15,0,15,0
2020-11-24,Siskiyou,93,43540,645,473,32,505,1
2020-11-24,Solano,95,438530,10538,9716,72,9788,86
2020-11-24,Sonoma,97,501317,12455,11644,57,11701,162
2020-11-24,Stanislaus,99,539301,22016,20830,1437,22267,438
2020-11-24,Sutter,101,95872,3463,2974,11,2985,14
2020-11-24,Tehama,103,63373,1717,1565,30,1595,9
2020-11-24,Trinity,105,12862,191,129,11,140,0
2020-11-24,Tulare,107,460477,21524,20319,1438,21757,315
2020-11-24,Tuolumne,109,53932,1061,832,31,863,7
2020-11-24,Ventura,111,848112,20164,18637,666,19303,179
2020-11-24,Yolo,113,214977,4992,4420,17,4437,76
2020-11-24,Yuba,115,75493,2034,1804,9,1813,10
2020-11-23,Alameda,1,1643700,29758,27718,336,28054,444
2020-11-23,Alpine,3,1148,50,41,0,41,0
2020-11-23,Amador,5,37829,515,457,1,458,16
2020-11-23,Butte,7,227075,4060,3765,196,3961,61
2020-11-23,Calaveras,9,45235,478,434,1,435,21
2020-11-23,Colusa,11,21464,739,662,3,665,6
2020-11-23,Contra Costa,13,1133247,24212,22674,159,22833,260
2020-11-23,Del Norte,15,27424,337,296,0,296,2
2020-11-23,El Dorado,17,186661,2584,2005,25,2030,4
2020-11-23,Fresno,19,978130,41324,36688,1296,37984,488
2020-11-23,Glenn,21,27897,959,853,40,893,4
2020-11-23,Humboldt,23,135768,891,746,1,747,9
2020-11-23,Imperial,25,180216,16243,15104,83,15187,355
2020-11-23,Inyo,27,18085,302,279,1,280,15
2020-11-23,Kern,29,883053,40725,38245,1145,39390,463
2020-11-23,Kings,31,150075,10948,10204,153,10357,85
2020-11-23,Lake,33,64148,961,840,0,840,18
2020-11-23,Lassen,35,31185,2092,1271,6,1277,0
2020-11-23,Los Angeles,37,10098052,389288,366374,6072,372446,7447
2020-11-23,Madera,39,155013,6336,5787,140,5927,56
2020-11-23,Marin,41,260295,7718,7543,27,7570,135
2020-11-23,Mariposa,43,17540,126,97,1,98,2
2020-11-23,Mendocino,45,87422,1463,1330,4,1334,22
2020-11-23,Merced,47,269075,11710,11148,104,11252,169
2020-11-23,Modoc,49,8938,105,91,21,112,0
2020-11-23,Mono,51,14174,512,480,8,488,2
2020-11-23,Monterey,53,433212,15237,14265,264,14529,112
2020-11-23,Napa,55,140530,3212,2811,14,2825,17
2020-11-23,Nevada,57,99092,1306,1087,30,1117,9
2020-11-23,Orange,59,3164182,78328,71074,2386,73460,1546
2020-11-23,Placer,61,380077,7138,5999,138,6137,66
2020-11-23,Plumas,63,18699,214,172,0,172,0
2020-11-23,Riverside,65,2383286,90091,82175,1696,83871,1415
2020-11-23,Sacramento,67,1510023,37019,34141,118,34259,556
2020-11-23,San Benito,69,59416,1836,1729,12,1741,15
2020-11-23,San Bernardino,71,2135413,94799,84387,1194,85581,1224
2020-11-23,San Diego,73,3302833,80410,72817,0,72817,968
2020-11-23,San Francisco,75,870044,15444,14646,103,14749,153
2020-11-23,San Joaquin,77,732212,26466,24622,512,25134,517
2020-11-23,San Luis Obispo,79,281455,6233,5772,100,5872,34
2020-11-23,San Mateo,81,765935,14410,13364,12,13376,170
2020-11-23,Santa Barbara,83,443738,11879,10944,246,11190,137
2020-11-23,Santa Clara,85,1922200,34673,31064,70,31134,435
2020-11-23,Santa Cruz,87,273765,4517,4003,56,4059,25
2020-11-23,Shasta,89,179085,5306,4100,162,4262,43
2020-11-23,Sierra,91,2930,17,15,0,15,0
2020-11-23,Siskiyou,93,43540,618,460,31,491,0
2020-11-23,Solano,95,438530,10381,9394,69,9463,86
2020-11-23,Sonoma,97,501317,12282,11507,53,11560,160
2020-11-23,Stanislaus,99,539301,21725,20487,1404,21891,436
2020-11-23,Sutter,101,95872,3325,2840,10,2850,14
2020-11-23,Tehama,103,63373,1669,1526,27,1553,9
2020-11-23,Trinity,105,12862,185,120,10,130,0
2020-11-23,Tulare,107,460477,21238,19818,1364,21182,315
2020-11-23,Tuolumne,109,53932,1021,774,31,805,7
2020-11-23,Ventura,111,848112,19790,18480,654,19134,179
2020-11-23,Yolo,113,214977,4912,4265,16,4281,75
2020-11-23,Yuba,115,75493,1967,1702,9,1711,10
2020-11-22,Alameda,1,1643700,29325,27472,324,27796,444
2020-11-22,Alpine,3,1148,47,41,0,41,0
2020-11-22,Amador,5,37829,503,450,1,451,16
2020-11-22,Butte,7,227075,4011,3712,186,3898,61
2020-11-22,Calaveras,9,45235,466,434,1,435,21
2020-11-22,Colusa,11,21464,721,642,2,644,6
2020-11-22,Contra Costa,13,1133247,23907,22407,154,22561,260
2020-11-22,Del Norte,15,27424,313,271,0,271,2
2020-11-22,El Dorado,17,186661,2473,1917,22,1939,4
2020-11-22,Fresno,19,978130,40844,36315,1237,37552,488
2020-11-22,Glenn,21,27897,939,832,34,866,4
2020-11-22,Humboldt,23,135768,875,729,1,730,9
2020-11-22,Imperial,25,180216,16039,15109,36,15145,355
2020-11-22,Inyo,27,18085,295,279,1,280,15
2020-11-22,Kern,29,883053,40149,37904,1108,39012,463
2020-11-22,Kings,31,150075,10847,10035,144,10179,85
2020-11-22,Lake,33,64148,939,834,0,834,18
2020-11-22,Lassen,35,31185,1927,1211,5,1216,0
2020-11-22,Los Angeles,37,10098052,383019,360341,5810,366151,7438
2020-11-22,Madera,39,155013,6256,5745,129,5874,56
2020-11-22,Marin,41,260295,7683,7506,26,7532,135
2020-11-22,Mariposa,43,17540,125,95,1,96,2
2020-11-22,Mendocino,45,87422,1439,1285,3,1288,22
2020-11-22,Merced,47,269075,11561,10939,104,11043,169
2020-11-22,Modoc,49,8938,104,87,19,106,0
2020-11-22,Mono,51,14174,494,481,8,489,2
2020-11-22,Monterey,53,433212,14996,13887,257,14144,111
2020-11-22,Napa,55,140530,3132,2778,14,2792,17
2020-11-22,Nevada,57,99092,1248,1052,30,1082,9
2020-11-22,Orange,59,3164182,76914,69913,2346,72259,1546
2020-11-22,Placer,61,380077,6923,5880,127,6007,66
2020-11-22,Plumas,63,18699,201,172,0,172,0
2020-11-22,Riverside,65,2383286,88504,81565,1633,83198,1409
2020-11-22,Sacramento,67,1510023,36288,33421,105,33526,555
2020-11-22,San Benito,69,59416,1807,1704,12,1716,15
2020-11-22,San Bernardino,71,2135413,92458,83505,1119,84624,1224
2020-11-22,San Diego,73,3302833,78675,71649,0,71649,968
2020-11-22,San Francisco,75,870044,15274,14515,102,14617,153
2020-11-22,San Joaquin,77,732212,26170,24619,499,25118,517
2020-11-22,San Luis Obispo,79,281455,6131,5664,99,5763,34
2020-11-22,San Mateo,81,765935,14206,13228,12,13240,170
2020-11-22,Santa Barbara,83,443738,11744,10946,240,11186,137
2020-11-22,Santa Clara,85,1922200,33997,30633,68,30701,434
2020-11-22,Santa Cruz,87,273765,4435,3896,49,3945,25
2020-11-22,Shasta,89,179085,5149,4100,143,4243,43
2020-11-22,Sierra,91,2930,17,13,0,13,0
2020-11-22,Siskiyou,93,43540,586,411,31,442,0
2020-11-22,Solano,95,438530,10211,9363,65,9428,86
2020-11-22,Sonoma,97,501317,12124,11415,51,11466,159
2020-11-22,Stanislaus,99,539301,21401,20223,1370,21593,436
2020-11-22,Sutter,101,95872,3207,2677,10,2687,13
2020-11-22,Tehama,103,63373,1635,1457,22,1479,9
2020-11-22,Trinity,105,12862,181,114,10,124,0
2020-11-22,Tulare,107,460477,20990,19818,1290,21108,314
2020-11-22,Tuolumne,109,53932,995,689,31,720,7
2020-11-22,Ventura,111,848112,19429,18105,640,18745,179
2020-11-22,Yolo,113,214977,4812,4206,16,4222,75
2020-11-22,Yuba,115,75493,1914,1672,9,1681,10
2020-11-21,Alameda,1,1643700,29142,27424,322,27746,444
2020-11-21,Alpine,3,1148,47,41,0,41,0
2020-11-21,Amador,5,37829,489,450,1,451,16
2020-11-21,Butte,7,227075,3963,3664,183,3847,61
2020-11-21,Calaveras,9,45235,460,434,1,435,21
2020-11-21,Colusa,11,21464,712,642,2,644,6
2020-11-21,Contra Costa,13,1133247,23753,22338,152,22490,260
2020-11-21,Del Norte,15,27424,308,271,0,271,2
2020-11-21,El Dorado,17,186661,2424,1900,21,1921,4
2020-11-21,Fresno,19,978130,40589,35973,1204,37177,482
2020-11-21,Glenn,21,27897,934,829,32,861,4
2020-11-21,Humboldt,23,135768,865,728,1,729,9
2020-11-21,Imperial,25,180216,15961,15053,36,15089,355
2020-11-21,Inyo,27,18085,293,283,1,284,15
2020-11-21,Kern,29,883053,39899,37403,1070,38473,463
2020-11-21,Kings,31,150075,10799,10019,139,10158,85
2020-11-21,Lake,33,64148,926,832,0,832,18
2020-11-21,Lassen,35,31185,1859,1211,5,1216,0
2020-11-21,Los Angeles,37,10098052,379854,357754,5655,363409,7428
2020-11-21,Madera,39,155013,6219,5706,129,5835,56
2020-11-21,Marin,41,260295,7660,7488,25,7513,134
2020-11-21,Mariposa,43,17540,125,92,1,93,2
2020-11-21,Mendocino,45,87422,1408,1282,3,1285,22
2020-11-21,Merced,47,269075,11500,10849,103,10952,169
2020-11-21,Modoc,49,8938,100,87,18,105,0
2020-11-21,Mono,51,14174,490,469,8,477,2
2020-11-21,Monterey,53,433212,14898,13886,251,14137,110
2020-11-21,Napa,55,140530,3098,2757,14,2771,17
2020-11-21,Nevada,57,99092,1236,1018,29,1047,9
2020-11-21,Orange,59,3164182,76110,69021,2315,71336,1543
2020-11-21,Placer,61,380077,6811,5778,124,5902,65
2020-11-21,Plumas,63,18699,196,172,0,172,0
2020-11-21,Riverside,65,2383286,87733,80676,1583,82259,1407
2020-11-21,Sacramento,67,1510023,35896,33133,97,33230,548
2020-11-21,San Benito,69,59416,1788,1691,12,1703,15
2020-11-21,San Bernardino,71,2135413,91585,83206,1038,84244,1222
2020-11-21,San Diego,73,3302833,77896,70711,0,70711,966
2020-11-21,San Francisco,75,870044,15171,14445,101,14546,153
2020-11-21,San Joaquin,77,732212,26038,24620,483,25103,517
2020-11-21,San Luis Obispo,79,281455,6079,5618,96,5714,34
2020-11-21,San Mateo,81,765935,14104,13138,12,13150,170
2020-11-21,Santa Barbara,83,443738,11693,10922,237,11159,137
2020-11-21,Santa Clara,85,1922200,33616,30377,65,30442,433
2020-11-21,Santa Cruz,87,273765,4379,3898,48,3946,25
2020-11-21,Shasta,89,179085,5076,4095,140,4235,42
2020-11-21,Sierra,91,2930,17,13,0,13,0
2020-11-21,Siskiyou,93,43540,570,403,31,434,0
2020-11-21,Solano,95,438530,10122,9290,61,9351,86
2020-11-21,Sonoma,97,501317,12049,11394,49,11443,158
2020-11-21,Stanislaus,99,539301,21258,20111,1345,21456,435
2020-11-21,Sutter,101,95872,3147,2615,9,2624,13
2020-11-21,Tehama,103,63373,1615,1435,21,1456,9
2020-11-21,Trinity,105,12862,178,110,9,119,0
2020-11-21,Tulare,107,460477,20865,19752,1256,21008,313
2020-11-21,Tuolumne,109,53932,976,690,31,721,7
2020-11-21,Ventura,111,848112,19266,18040,630,18670,177
2020-11-21,Yolo,113,214977,4736,4147,15,4162,75
2020-11-21,Yuba,115,75493,1882,1643,9,1652,10
2020-11-20,Alameda,1,1643700,28932,27221,314,27535,444
2020-11-20,Alpine,3,1148,47,20,0,20,0
2020-11-20,Amador,5,37829,485,446,1,447,16
2020-11-20,Butte,7,227075,3931,3618,179,3797,60
2020-11-20,Calaveras,9,45235,448,424,1,425,21
2020-11-20,Colusa,11,21464,704,631,1,632,6
2020-11-20,Contra Costa,13,1133247,23567,22116,147,22263,260
2020-11-20,Del Norte,15,27424,304,264,0,264,2
2020-11-20,El Dorado,17,186661,2329,1868,19,1887,4
2020-11-20,Fresno,19,978130,40298,35635,1171,36806,480
2020-11-20,Glenn,21,27897,922,826,30,856,4
2020-11-20,Humboldt,23,135768,856,714,0,714,9
2020-11-20,Imperial,25,180216,15899,14864,32,14896,353
2020-11-20,Inyo,27,18085,291,262,1,263,15
2020-11-20,Kern,29,883053,39607,37143,1044,38187,462
2020-11-20,Kings,31,150075,10752,9903,137,10040,85
2020-11-20,Lake,33,64148,917,820,0,820,18
2020-11-20,Lassen,35,31185,1774,1212,4,1216,0
2020-11-20,Los Angeles,37,10098052,375979,353554,5487,359041,7398
2020-11-20,Madera,39,155013,6128,5635,126,5761,54
2020-11-20,Marin,41,260295,7636,7467,24,7491,134
2020-11-20,Mariposa,43,17540,117,89,1,90,2
2020-11-20,Mendocino,45,87422,1388,1269,3,1272,22
2020-11-20,Merced,47,269075,11414,10729,103,10832,167
2020-11-20,Modoc,49,8938,100,83,18,101,0
2020-11-20,Mono,51,14174,490,469,8,477,2
2020-11-20,Monterey,53,433212,14773,13738,242,13980,110
2020-11-20,Napa,55,140530,3068,2718,14,2732,17
2020-11-20,Nevada,57,99092,1218,990,28,1018,9
2020-11-20,Orange,59,3164182,75283,68212,2273,70485,1532
2020-11-20,Placer,61,380077,6681,5687,108,5795,66
2020-11-20,Plumas,63,18699,193,163,0,163,0
2020-11-20,Riverside,65,2383286,86727,79613,1515,81128,1405
2020-11-20,Sacramento,67,1510023,35516,32832,87,32919,549
2020-11-20,San Benito,69,59416,1776,1668,12,1680,15
2020-11-20,San Bernardino,71,2135413,90217,81203,954,82157,1220
2020-11-20,San Diego,73,3302833,76897,69233,0,69233,960
2020-11-20,San Francisco,75,870044,15067,14327,100,14427,153
2020-11-20,San Joaquin,77,732212,25886,24460,469,24929,515
2020-11-20,San Luis Obispo,79,281455,6025,5524,93,5617,34
2020-11-20,San Mateo,81,765935,13971,12980,11,12991,169
2020-11-20,Santa Barbara,83,443738,11636,10825,231,11056,136
2020-11-20,Santa Clara,85,1922200,33195,30002,59,30061,431
2020-11-20,Santa Cruz,87,273765,4313,3815,48,3863,25
2020-11-20,Shasta,89,179085,5002,3861,135,3996,42
2020-11-20,Sierra,91,2930,17,12,0,12,0
2020-11-20,Siskiyou,93,43540,557,387,29,416,0
2020-11-20,Solano,95,438530,10031,9216,58,9274,85
2020-11-20,Sonoma,97,501317,11965,11316,48,11364,158
2020-11-20,Stanislaus,99,539301,21105,19889,1317,21206,433
2020-11-20,Sutter,101,95872,3098,2580,9,2589,13
2020-11-20,Tehama,103,63373,1601,1410,17,1427,9
2020-11-20,Trinity,105,12862,177,102,9,111,0
2020-11-20,Tulare,107,460477,20734,19568,1215,20783,311
2020-11-20,Tuolumne,109,53932,937,662,31,693,7
2020-11-20,Ventura,111,848112,19099,17741,602,18343,175
2020-11-20,Yolo,113,214977,4658,4081,14,4095,74
2020-11-20,Yuba,115,75493,1854,1611,9,1620,10
2020-11-19,Alameda,1,1643700,28590,26971,305,27276,441
2020-11-19,Alpine,3,1148,44,20,0,20,0
2020-11-19,Amador,5,37829,481,436,1,437,16
2020-11-19,Butte,7,227075,3882,3576,172,3748,60
2020-11-19,Calaveras,9,45235,439,417,1,418,21
2020-11-19,Colusa,11,21464,686,621,1,622,6
2020-11-19,Contra Costa,13,1133247,23297,21886,144,22030,259
2020-11-19,Del Norte,15,27424,296,251,0,251,2
2020-11-19,El Dorado,17,186661,2255,1825,18,1843,4
2020-11-19,Fresno,19,978130,39854,35278,1111,36389,478
2020-11-19,Glenn,21,27897,900,806,29,835,4
2020-11-19,Humboldt,23,135768,836,693,0,693,9
2020-11-19,Imperial,25,180216,15689,14507,32,14539,349
2020-11-19,Inyo,27,18085,289,262,1,263,15
2020-11-19,Kern,29,883053,39188,36779,999,37778,459
2020-11-19,Kings,31,150075,10605,9763,129,9892,85
2020-11-19,Lake,33,64148,903,809,0,809,18
2020-11-19,Lassen,35,31185,1657,1201,2,1203,0
2020-11-19,Los Angeles,37,10098052,370912,349493,5309,354802,7365
2020-11-19,Madera,39,155013,6056,5540,119,5659,54
2020-11-19,Marin,41,260295,7605,7451,24,7475,134
2020-11-19,Mariposa,43,17540,110,88,0,88,2
2020-11-19,Mendocino,45,87422,1367,1237,3,1240,23
2020-11-19,Merced,47,269075,11273,10634,97,10731,167
2020-11-19,Modoc,49,8938,97,82,18,100,0
2020-11-19,Mono,51,14174,485,468,8,476,2
2020-11-19,Monterey,53,433212,14558,13369,231,13600,108
2020-11-19,Napa,55,140530,3014,2641,14,2655,17
2020-11-19,Nevada,57,99092,1177,945,27,972,9
2020-11-19,Orange,59,3164182,74012,66998,2225,69223,1530
2020-11-19,Placer,61,380077,6491,5612,107,5719,65
2020-11-19,Plumas,63,18699,188,158,0,158,0
2020-11-19,Riverside,65,2383286,85257,78535,1443,79978,1402
2020-11-19,Sacramento,67,1510023,34999,32367,85,32452,546
2020-11-19,San Benito,69,59416,1753,1643,12,1655,15
2020-11-19,San Bernardino,71,2135413,88325,79244,870,80114,1215
2020-11-19,San Diego,73,3302833,75649,68142,0,68142,952
2020-11-19,San Francisco,75,870044,14912,14178,94,14272,153
2020-11-19,San Joaquin,77,732212,25567,24270,457,24727,516
2020-11-19,San Luis Obispo,79,281455,5949,5410,90,5500,34
2020-11-19,San Mateo,81,765935,13833,12714,11,12725,169
2020-11-19,Santa Barbara,83,443738,11556,10741,227,10968,136
2020-11-19,Santa Clara,85,1922200,32637,29630,58,29688,424
2020-11-19,Santa Cruz,87,273765,4222,3679,46,3725,25
2020-11-19,Shasta,89,179085,4865,3685,124,3809,42
2020-11-19,Sierra,91,2930,17,11,0,11,0
2020-11-19,Siskiyou,93,43540,532,360,28,388,0
2020-11-19,Solano,95,438530,9894,9093,54,9147,84
2020-11-19,Sonoma,97,501317,11795,11205,46,11251,156
2020-11-19,Stanislaus,99,539301,20864,19736,1274,21010,433
2020-11-19,Sutter,101,95872,3001,2509,9,2518,13
2020-11-19,Tehama,103,63373,1568,1373,14,1387,9
2020-11-19,Trinity,105,12862,171,97,9,106,0
2020-11-19,Tulare,107,460477,20512,19384,1148,20532,304
2020-11-19,Tuolumne,109,53932,905,602,31,633,7
2020-11-19,Ventura,111,848112,18746,17300,589,17889,174
2020-11-19,Yolo,113,214977,4563,3973,14,3987,72
2020-11-19,Yuba,115,75493,1814,1568,9,1577,10
2020-11-18,Alameda,1,1643700,28329,26610,300,26910,440
2020-11-18,Alpine,3,1148,43,16,0,16,0
2020-11-18,Amador,5,37829,476,430,1,431,16
2020-11-18,Butte,7,227075,3829,3537,159,3696,59
2020-11-18,Calaveras,9,45235,433,409,1,410,21
2020-11-18,Colusa,11,21464,673,611,1,612,6
2020-11-18,Contra Costa,13,1133247,23030,21685,140,21825,258
2020-11-18,Del Norte,15,27424,282,240,0,240,2
2020-11-18,El Dorado,17,186661,2168,1799,17,1816,4
2020-11-18,Fresno,19,978130,39417,34997,1057,36054,474
2020-11-18,Glenn,21,27897,884,803,27,830,4
2020-11-18,Humboldt,23,135768,822,690,0,690,9
2020-11-18,Imperial,25,180216,15466,14428,31,14459,348
2020-11-18,Inyo,27,18085,287,262,1,263,15
2020-11-18,Kern,29,883053,38802,36537,946,37483,456
2020-11-18,Kings,31,150075,10457,9696,126,9822,85
2020-11-18,Lake,33,64148,890,802,0,802,18
2020-11-18,Lassen,35,31185,1557,1124,2,1126,0
2020-11-18,Los Angeles,37,10098052,366197,344675,5116,349791,7338
2020-11-18,Madera,39,155013,5969,5519,107,5626,54
2020-11-18,Marin,41,260295,7581,7435,24,7459,134
2020-11-18,Mariposa,43,17540,107,88,0,88,2
2020-11-18,Mendocino,45,87422,1347,1237,3,1240,23
2020-11-18,Merced,47,269075,11158,10536,95,10631,166
2020-11-18,Modoc,49,8938,94,77,18,95,0
2020-11-18,Mono,51,14174,479,468,8,476,2
2020-11-18,Monterey,53,433212,14366,13340,216,13556,108
2020-11-18,Napa,55,140530,2967,2607,14,2621,17
2020-11-18,Nevada,57,99092,1138,933,25,958,9
2020-11-18,Orange,59,3164182,72917,66381,2201,68582,1521
2020-11-18,Placer,61,380077,6314,5543,102,5645,64
2020-11-18,Plumas,63,18699,183,143,0,143,0
2020-11-18,Riverside,65,2383286,83835,77739,1341,79080,1387
2020-11-18,Sacramento,67,1510023,34375,31816,77,31893,541
2020-11-18,San Benito,69,59416,1728,1632,11,1643,15
2020-11-18,San Bernardino,71,2135413,86571,77400,787,78187,1206
2020-11-18,San Diego,73,3302833,74359,67243,0,67243,945
2020-11-18,San Francisco,75,870044,14768,14057,92,14149,153
2020-11-18,San Joaquin,77,732212,25301,24146,442,24588,517
2020-11-18,San Luis Obispo,79,281455,5874,5322,89,5411,34
2020-11-18,San Mateo,81,765935,13681,12631,10,12641,169
2020-11-18,Santa Barbara,83,443738,11477,10684,220,10904,136
2020-11-18,Santa Clara,85,1922200,32172,29285,53,29338,421
2020-11-18,Santa Cruz,87,273765,4130,3618,44,3662,25
2020-11-18,Shasta,89,179085,4729,3547,120,3667,42
2020-11-18,Sierra,91,2930,17,11,0,11,0
2020-11-18,Siskiyou,93,43540,500,351,27,378,0
2020-11-18,Solano,95,438530,9762,8994,52,9046,84
2020-11-18,Sonoma,97,501317,11688,11129,43,11172,155
2020-11-18,Stanislaus,99,539301,20622,19609,1249,20858,431
2020-11-18,Sutter,101,95872,2885,2442,9,2451,13
2020-11-18,Tehama,103,63373,1529,1338,14,1352,8
2020-11-18,Trinity,105,12862,161,95,9,104,0
2020-11-18,Tulare,107,460477,20306,19286,1093,20379,306
2020-11-18,Tuolumne,109,53932,869,590,31,621,7
2020-11-18,Ventura,111,848112,18420,17169,575,17744,173
2020-11-18,Yolo,113,214977,4489,3929,14,3943,71
2020-11-18,Yuba,115,75493,1761,1540,9,1549,10
2020-11-17,Alameda,1,1643700,28006,26425,290,26715,439
2020-11-17,Alpine,3,1148,41,12,0,12,0
2020-11-17,Amador,5,37829,465,423,1,424,16
2020-11-17,Butte,7,227075,3787,3500,149,3649,59
2020-11-17,Calaveras,9,45235,418,405,1,406,21
2020-11-17,Colusa,11,21464,662,606,0,606,6
2020-11-17,Contra Costa,13,1133247,22757,21557,135,21692,256
2020-11-17,Del Norte,15,27424,277,233,0,233,2
2020-11-17,El Dorado,17,186661,2109,1758,17,1775,4
2020-11-17,Fresno,19,978130,38823,34765,997,35762,472
2020-11-17,Glenn,21,27897,873,795,26,821,4
2020-11-17,Humboldt,23,135768,800,685,0,685,9
2020-11-17,Imperial,25,180216,15231,14204,30,14234,346
2020-11-17,Inyo,27,18085,286,263,1,264,15
2020-11-17,Kern,29,883053,38352,36164,891,37055,455
2020-11-17,Kings,31,150075,10384,9653,119,9772,85
2020-11-17,Lake,33,64148,870,792,0,792,18
2020-11-17,Lassen,35,31185,1478,1124,2,1126,0
2020-11-17,Los Angeles,37,10098052,361259,340933,4948,345881,7302
2020-11-17,Madera,39,155013,5880,5485,100,5585,54
2020-11-17,Marin,41,260295,7549,7404,23,7427,134
2020-11-17,Mariposa,43,17540,104,87,0,87,2
2020-11-17,Mendocino,45,87422,1326,1216,3,1219,23
2020-11-17,Merced,47,269075,11014,10457,89,10546,162
2020-11-17,Modoc,49,8938,88,71,17,88,0
2020-11-17,Mono,51,14174,477,459,8,467,2
2020-11-17,Monterey,53,433212,14138,13220,205,13425,108
2020-11-17,Napa,55,140530,2913,2568,14,2582,17
2020-11-17,Nevada,57,99092,1097,918,24,942,9
2020-11-17,Orange,59,3164182,71772,65757,2169,67926,1519
2020-11-17,Placer,61,380077,6157,5435,96,5531,63
2020-11-17,Plumas,63,18699,175,142,0,142,0
2020-11-17,Riverside,65,2383286,82459,77079,1248,78327,1379
2020-11-17,Sacramento,67,1510023,33782,31341,73,31414,538
2020-11-17,San Benito,69,59416,1713,1611,4,1615,15
2020-11-17,San Bernardino,71,2135413,84760,76134,693,76827,1188
2020-11-17,San Diego,73,3302833,73108,66321,0,66321,933
2020-11-17,San Francisco,75,870044,14602,13952,91,14043,153
2020-11-17,San Joaquin,77,732212,25027,23997,423,24420,516
2020-11-17,San Luis Obispo,79,281455,5780,5235,89,5324,34
2020-11-17,San Mateo,81,765935,13519,12491,9,12500,169
2020-11-17,Santa Barbara,83,443738,11390,10597,213,10810,136
2020-11-17,Santa Clara,85,1922200,31623,29013,52,29065,419
2020-11-17,Santa Cruz,87,273765,4046,3548,41,3589,25
2020-11-17,Shasta,89,179085,4568,3457,107,3564,40
2020-11-17,Sierra,91,2930,15,11,0,11,0
2020-11-17,Siskiyou,93,43540,452,333,26,359,0
2020-11-17,Solano,95,438530,9617,8905,51,8956,84
2020-11-17,Sonoma,97,501317,11554,11084,41,11125,155
2020-11-17,Stanislaus,99,539301,20399,19466,1220,20686,425
2020-11-17,Sutter,101,95872,2802,2370,8,2378,12
2020-11-17,Tehama,103,63373,1480,1290,13,1303,7
2020-11-17,Trinity,105,12862,149,83,9,92,0
2020-11-17,Tulare,107,460477,20089,19176,1028,20204,305
2020-11-17,Tuolumne,109,53932,831,568,31,599,7
2020-11-17,Ventura,111,848112,18147,16797,556,17353,173
2020-11-17,Yolo,113,214977,4312,3887,13,3900,70
2020-11-17,Yuba,115,75493,1713,1519,9,1528,10
2020-11-16,Alameda,1,1643700,27659,26063,285,26348,436
2020-11-16,Alpine,3,1148,38,12,0,12,0
2020-11-16,Amador,5,37829,457,414,1,415,16
2020-11-16,Butte,7,227075,3748,3490,140,3630,58
2020-11-16,Calaveras,9,45235,411,402,1,403,21
2020-11-16,Colusa,11,21464,653,601,0,601,6
2020-11-16,Contra Costa,13,1133247,22490,21386,130,21516,256
2020-11-16,Del Norte,15,27424,270,225,0,225,2
2020-11-16,El Dorado,17,186661,2048,1694,15,1709,4
2020-11-16,Fresno,19,978130,38339,34593,939,35532,471
2020-11-16,Glenn,21,27897,861,786,25,811,4
2020-11-16,Humboldt,23,135768,782,660,0,660,9
2020-11-16,Imperial,25,180216,14984,14111,30,14141,346
2020-11-16,Inyo,27,18085,283,263,1,264,15
2020-11-16,Kern,29,883053,37961,36049,847,36896,455
2020-11-16,Kings,31,150075,10118,9569,115,9684,85
2020-11-16,Lake,33,64148,858,784,0,784,18
2020-11-16,Lassen,35,31185,1297,1124,2,1126,0
2020-11-16,Los Angeles,37,10098052,356531,338778,4758,343536,7277
2020-11-16,Madera,39,155013,5794,5433,93,5526,54
2020-11-16,Marin,41,260295,7520,7359,23,7382,134
2020-11-16,Mariposa,43,17540,101,86,0,86,2
2020-11-16,Mendocino,45,87422,1301,1209,3,1212,23
2020-11-16,Merced,47,269075,10877,10399,86,10485,162
2020-11-16,Modoc,49,8938,86,71,17,88,0
2020-11-16,Mono,51,14174,475,453,8,461,2
2020-11-16,Monterey,53,433212,13895,13089,192,13281,107
2020-11-16,Napa,55,140530,2837,2536,14,2550,17
2020-11-16,Nevada,57,99092,1054,889,22,911,9
2020-11-16,Orange,59,3164182,70674,65396,2154,67550,1519
2020-11-16,Placer,61,380077,6038,5387,88,5475,63
2020-11-16,Plumas,63,18699,168,127,0,127,0
2020-11-16,Riverside,65,2383286,81092,76449,1180,77629,1379
2020-11-16,Sacramento,67,1510023,33142,30954,66,31020,534
2020-11-16,San Benito,69,59416,1695,1603,3,1606,15
2020-11-16,San Bernardino,71,2135413,82935,74401,621,75022,1186
2020-11-16,San Diego,73,3302833,71800,65603,0,65603,926
2020-11-16,San Francisco,75,870044,14444,13847,88,13935,153
2020-11-16,San Joaquin,77,732212,24740,23515,413,23928,513
2020-11-16,San Luis Obispo,79,281455,5676,5161,84,5245,34
2020-11-16,San Mateo,81,765935,13360,12398,9,12407,169
2020-11-16,Santa Barbara,83,443738,11326,10565,209,10774,135
2020-11-16,Santa Clara,85,1922200,31056,28673,50,28723,419
2020-11-16,Santa Cruz,87,273765,3973,3520,41,3561,25
2020-11-16,Shasta,89,179085,4418,3284,102,3386,37
2020-11-16,Sierra,91,2930,15,11,0,11,0
2020-11-16,Siskiyou,93,43540,425,294,26,320,0
2020-11-16,Solano,95,438530,9419,8827,51,8878,84
2020-11-16,Sonoma,97,501317,11463,10961,40,11001,155
2020-11-16,Stanislaus,99,539301,20163,19333,1192,20525,425
2020-11-16,Sutter,101,95872,2695,2322,8,2330,12
2020-11-16,Tehama,103,63373,1435,1261,9,1270,7
2020-11-16,Trinity,105,12862,141,67,9,76,0
2020-11-16,Tulare,107,460477,19915,18891,971,19862,305
2020-11-16,Tuolumne,109,53932,795,543,31,574,7
2020-11-16,Ventura,111,848112,17810,16691,548,17239,172
2020-11-16,Yolo,113,214977,4215,3858,13,3871,70
2020-11-16,Yuba,115,75493,1677,1500,8,1508,10
2020-11-15,Alameda,1,1643700,27341,25879,280,26159,436
2020-11-15,Alpine,3,1148,36,12,0,12,0
2020-11-15,Amador,5,37829,445,409,1,410,16
2020-11-15,Butte,7,227075,3695,3452,130,3582,58
2020-11-15,Calaveras,9,45235,398,386,1,387,21
2020-11-15,Colusa,11,21464,644,601,0,601,6
2020-11-15,Contra Costa,13,1133247,22191,21179,129,21308,256
2020-11-15,Del Norte,15,27424,254,224,0,224,2
2020-11-15,El Dorado,17,186661,1986,1683,14,1697,4
2020-11-15,Fresno,19,978130,37832,34297,899,35196,471
2020-11-15,Glenn,21,27897,849,783,24,807,4
2020-11-15,Humboldt,23,135768,754,653,0,653,9
2020-11-15,Imperial,25,180216,14747,13940,30,13970,346
2020-11-15,Inyo,27,18085,273,263,1,264,15
2020-11-15,Kern,29,883053,37558,35911,810,36721,455
2020-11-15,Kings,31,150075,9925,9533,111,9644,85
2020-11-15,Lake,33,64148,849,777,0,777,17
2020-11-15,Lassen,35,31185,1249,1124,2,1126,0
2020-11-15,Los Angeles,37,10098052,351503,336035,4576,340611,7271
2020-11-15,Madera,39,155013,5697,5391,87,5478,54
2020-11-15,Marin,41,260295,7494,7347,23,7370,133
2020-11-15,Mariposa,43,17540,98,86,0,86,2
2020-11-15,Mendocino,45,87422,1282,1197,3,1200,22
2020-11-15,Merced,47,269075,10744,10350,86,10436,162
2020-11-15,Modoc,49,8938,85,68,17,85,0
2020-11-15,Mono,51,14174,473,453,8,461,2
2020-11-15,Monterey,53,433212,13698,12999,179,13178,107
2020-11-15,Napa,55,140530,2778,2509,12,2521,17
2020-11-15,Nevada,57,99092,999,859,22,881,9
2020-11-15,Orange,59,3164182,69645,65008,2134,67142,1519
2020-11-15,Placer,61,380077,5884,5330,80,5410,63
2020-11-15,Plumas,63,18699,162,127,0,127,0
2020-11-15,Riverside,65,2383286,79773,75531,1119,76650,1374
2020-11-15,Sacramento,67,1510023,32518,30601,62,30663,534
2020-11-15,San Benito,69,59416,1670,1589,2,1591,15
2020-11-15,San Bernardino,71,2135413,80793,73769,536,74305,1185
2020-11-15,San Diego,73,3302833,70302,64770,0,64770,926
2020-11-15,San Francisco,75,870044,14266,13757,87,13844,153
2020-11-15,San Joaquin,77,732212,24531,23516,397,23913,513
2020-11-15,San Luis Obispo,79,281455,5553,5120,81,5201,34
2020-11-15,San Mateo,81,765935,13183,12348,9,12357,169
2020-11-15,Santa Barbara,83,443738,11231,10516,207,10723,135
2020-11-15,Santa Clara,85,1922200,30602,28289,49,28338,418
2020-11-15,Santa Cruz,87,273765,3835,3439,40,3479,25
2020-11-15,Shasta,89,179085,4244,3290,93,3383,37
2020-11-15,Sierra,91,2930,15,11,0,11,0
2020-11-15,Siskiyou,93,43540,406,294,26,320,0
2020-11-15,Solano,95,438530,9258,8713,48,8761,84
2020-11-15,Sonoma,97,501317,11343,10833,39,10872,154
2020-11-15,Stanislaus,99,539301,19893,19228,1165,20393,425
2020-11-15,Sutter,101,95872,2606,2230,8,2238,12
2020-11-15,Tehama,103,63373,1384,1222,8,1230,7
2020-11-15,Trinity,105,12862,133,67,8,75,0
2020-11-15,Tulare,107,460477,19700,18891,916,19807,305
2020-11-15,Tuolumne,109,53932,754,486,31,517,7
2020-11-15,Ventura,111,848112,17537,16564,540,17104,172
2020-11-15,Yolo,113,214977,4112,3819,12,3831,67
2020-11-15,Yuba,115,75493,1636,1470,7,1477,10
2020-11-14,Alameda,1,1643700,27075,25714,277,25991,435
2020-11-14,Alpine,3,1148,36,12,0,12,0
2020-11-14,Amador,5,37829,436,404,0,404,16
2020-11-14,Butte,7,227075,3659,3434,116,3550,58
2020-11-14,Calaveras,9,45235,397,386,1,387,21
2020-11-14,Colusa,11,21464,632,601,0,601,6
2020-11-14,Contra Costa,13,1133247,22052,20975,122,21097,256
2020-11-14,Del Norte,15,27424,248,219,0,219,2
2020-11-14,El Dorado,17,186661,1942,1648,14,1662,4
2020-11-14,Fresno,19,978130,37582,33969,864,34833,471
2020-11-14,Glenn,21,27897,840,772,21,793,3
2020-11-14,Humboldt,23,135768,739,643,0,643,9
2020-11-14,Imperial,25,180216,14654,13932,29,13961,346
2020-11-14,Inyo,27,18085,272,263,1,264,15
2020-11-14,Kern,29,883053,37348,35626,791,36417,454
2020-11-14,Kings,31,150075,9890,9490,108,9598,85
2020-11-14,Lake,33,64148,840,773,0,773,17
2020-11-14,Lassen,35,31185,1235,833,2,835,0
2020-11-14,Los Angeles,37,10098052,348804,333021,4461,337482,7269
2020-11-14,Madera,39,155013,5667,5371,85,5456,54
2020-11-14,Marin,41,260295,7478,7325,23,7348,133
2020-11-14,Mariposa,43,17540,97,86,0,86,2
2020-11-14,Mendocino,45,87422,1266,1181,3,1184,22
2020-11-14,Merced,47,269075,10688,10286,84,10370,161
2020-11-14,Modoc,49,8938,84,64,16,80,0
2020-11-14,Mono,51,14174,473,453,8,461,2
2020-11-14,Monterey,53,433212,13602,12854,169,13023,105
2020-11-14,Napa,55,140530,2744,2473,12,2485,17
2020-11-14,Nevada,57,99092,983,835,22,857,9
2020-11-14,Orange,59,3164182,69031,64340,2121,66461,1517
2020-11-14,Placer,61,380077,5808,5215,74,5289,63
2020-11-14,Plumas,63,18699,157,128,0,128,0
2020-11-14,Riverside,65,2383286,79035,74910,1078,75988,1373
2020-11-14,Sacramento,67,1510023,32192,30298,61,30359,532
2020-11-14,San Benito,69,59416,1655,1573,2,1575,15
2020-11-14,San Bernardino,71,2135413,79859,72868,503,73371,1184
2020-11-14,San Diego,73,3302833,69537,63715,0,63715,926
2020-11-14,San Francisco,75,870044,14179,13661,86,13747,153
2020-11-14,San Joaquin,77,732212,24440,23516,389,23905,511
2020-11-14,San Luis Obispo,79,281455,5490,5073,75,5148,34
2020-11-14,San Mateo,81,765935,13075,12293,9,12302,169
2020-11-14,Santa Barbara,83,443738,11177,10482,205,10687,135
2020-11-14,Santa Clara,85,1922200,30318,27962,47,28009,416
2020-11-14,Santa Cruz,87,273765,3780,3402,40,3442,25
2020-11-14,Shasta,89,179085,4159,3195,91,3286,37
2020-11-14,Sierra,91,2930,15,11,0,11,0
2020-11-14,Siskiyou,93,43540,393,292,26,318,0
2020-11-14,Solano,95,438530,9178,8655,47,8702,84
2020-11-14,Sonoma,97,501317,11290,10769,39,10808,154
2020-11-14,Stanislaus,99,539301,19751,19068,1143,20211,424
2020-11-14,Sutter,101,95872,2563,2182,8,2190,12
2020-11-14,Tehama,103,63373,1363,1206,7,1213,7
2020-11-14,Trinity,105,12862,128,67,8,75,0
2020-11-14,Tulare,107,460477,19606,18853,887,19740,305
2020-11-14,Tuolumne,109,53932,726,448,31,479,7
2020-11-14,Ventura,111,848112,17392,16297,528,16825,172
2020-11-14,Yolo,113,214977,4070,3765,10,3775,65
2020-11-14,Yuba,115,75493,1607,1453,7,1460,10
2020-11-13,Alameda,1,1643700,26858,25515,272,25787,434
2020-11-13,Alpine,3,1148,36,12,0,12,0
2020-11-13,Amador,5,37829,433,397,0,397,16
2020-11-13,Butte,7,227075,3635,3402,107,3509,58
2020-11-13,Calaveras,9,45235,393,378,1,379,21
2020-11-13,Colusa,11,21464,624,598,0,598,6
2020-11-13,Contra Costa,13,1133247,21880,20799,122,20921,256
2020-11-13,Del Norte,15,27424,246,208,0,208,2
2020-11-13,El Dorado,17,186661,1897,1611,13,1624,4
2020-11-13,Fresno,19,978130,37335,33693,850,34543,470
2020-11-13,Glenn,21,27897,826,755,17,772,3
2020-11-13,Humboldt,23,135768,724,638,0,638,9
2020-11-13,Imperial,25,180216,14584,13790,28,13818,341
2020-11-13,Inyo,27,18085,271,262,1,263,15
2020-11-13,Kern,29,883053,37147,35431,774,36205,453
2020-11-13,Kings,31,150075,9831,9428,107,9535,85
2020-11-13,Lake,33,64148,834,770,0,770,17
2020-11-13,Lassen,35,31185,1226,832,2,834,0
2020-11-13,Los Angeles,37,10098052,345684,329364,4347,333711,7248
2020-11-13,Madera,39,155013,5627,5340,84,5424,54
2020-11-13,Marin,41,260295,7465,7307,22,7329,133
2020-11-13,Mariposa,43,17540,95,86,0,86,2
2020-11-13,Mendocino,45,87422,1254,1173,3,1176,22
2020-11-13,Merced,47,269075,10633,10185,81,10266,159
2020-11-13,Modoc,49,8938,84,63,14,77,0
2020-11-13,Mono,51,14174,473,448,7,455,2
2020-11-13,Monterey,53,433212,13407,12681,157,12838,104
2020-11-13,Napa,55,140530,2705,2440,12,2452,17
2020-11-13,Nevada,57,99092,964,798,22,820,9
2020-11-13,Orange,59,3164182,68431,63804,2102,65906,1514
2020-11-13,Placer,61,380077,5704,5122,68,5190,63
2020-11-13,Plumas,63,18699,151,125,0,125,0
2020-11-13,Riverside,65,2383286,78297,74138,1050,75188,1372
2020-11-13,Sacramento,67,1510023,31875,29787,56,29843,524
2020-11-13,San Benito,69,59416,1643,1553,1,1554,15
2020-11-13,San Bernardino,71,2135413,78811,71895,481,72376,1184
2020-11-13,San Diego,73,3302833,68690,62978,0,62978,921
2020-11-13,San Francisco,75,870044,14086,13516,84,13600,146
2020-11-13,San Joaquin,77,732212,24345,23314,382,23696,510
2020-11-13,San Luis Obispo,79,281455,5423,4960,71,5031,34
2020-11-13,San Mateo,81,765935,12982,12182,9,12191,169
2020-11-13,Santa Barbara,83,443738,11125,10405,203,10608,134
2020-11-13,Santa Clara,85,1922200,29993,27609,45,27654,415
2020-11-13,Santa Cruz,87,273765,3707,3343,40,3383,25
2020-11-13,Shasta,89,179085,4074,2983,87,3070,37
2020-11-13,Sierra,91,2930,15,11,0,11,0
2020-11-13,Siskiyou,93,43540,388,280,25,305,0
2020-11-13,Solano,95,438530,9087,8525,47,8572,84
2020-11-13,Sonoma,97,501317,11230,10685,37,10722,151
2020-11-13,Stanislaus,99,539301,19628,18936,1113,20049,422
2020-11-13,Sutter,101,95872,2517,2121,7,2128,12
2020-11-13,Tehama,103,63373,1335,1167,7,1174,7
2020-11-13,Trinity,105,12862,126,64,8,72,0
2020-11-13,Tulare,107,460477,19485,18714,844,19558,305
2020-11-13,Tuolumne,109,53932,693,427,31,458,7
2020-11-13,Ventura,111,848112,17248,16172,512,16684,171
2020-11-13,Yolo,113,214977,4019,3716,10,3726,65
2020-11-13,Yuba,115,75493,1580,1435,7,1442,10
2020-11-12,Alameda,1,1643700,26591,25345,272,25617,432
2020-11-12,Alpine,3,1148,35,12,0,12,0
2020-11-12,Amador,5,37829,432,392,0,392,16
2020-11-12,Butte,7,227075,3586,3347,104,3451,58
2020-11-12,Calaveras,9,45235,388,373,1,374,21
2020-11-12,Colusa,11,21464,619,591,0,591,6
2020-11-12,Contra Costa,13,1133247,21672,20619,120,20739,255
2020-11-12,Del Norte,15,27424,239,203,0,203,2
2020-11-12,El Dorado,17,186661,1851,1573,9,1582,4
2020-11-12,Fresno,19,978130,36991,33459,807,34266,468
2020-11-12,Glenn,21,27897,807,727,17,744,3
2020-11-12,Humboldt,23,135768,711,625,0,625,9
2020-11-12,Imperial,25,180216,14419,13619,28,13647,341
2020-11-12,Inyo,27,18085,270,255,1,256,15
2020-11-12,Kern,29,883053,36883,35207,757,35964,451
2020-11-12,Kings,31,150075,9766,9335,104,9439,85
2020-11-12,Lake,33,64148,825,764,0,764,17
2020-11-12,Lassen,35,31185,1157,832,1,833,0
2020-11-12,Los Angeles,37,10098052,341945,327001,4244,331245,7223
2020-11-12,Madera,39,155013,5593,5273,79,5352,54
2020-11-12,Marin,41,260295,7436,7268,22,7290,133
2020-11-12,Mariposa,43,17540,93,84,0,84,2
2020-11-12,Mendocino,45,87422,1235,1142,3,1145,22
2020-11-12,Merced,47,269075,10519,10107,77,10184,158
2020-11-12,Modoc,49,8938,84,63,14,77,0
2020-11-12,Mono,51,14174,472,442,7,449,2
2020-11-12,Monterey,53,433212,13287,12489,142,12631,100
2020-11-12,Napa,55,140530,2643,2398,12,2410,16
2020-11-12,Nevada,57,99092,941,780,21,801,9
2020-11-12,Orange,59,3164182,67689,63232,2081,65313,1514
2020-11-12,Placer,61,380077,5595,5044,58,5102,62
2020-11-12,Plumas,63,18699,147,121,0,121,0
2020-11-12,Riverside,65,2383286,77371,73381,1004,74385,1362
2020-11-12,Sacramento,67,1510023,31386,29459,49,29508,520
2020-11-12,San Benito,69,59416,1623,1525,1,1526,15
2020-11-12,San Bernardino,71,2135413,77444,70758,441,71199,1183
2020-11-12,San Diego,73,3302833,67711,62336,0,62336,918
2020-11-12,San Francisco,75,870044,13987,13289,83,13372,146
2020-11-12,San Joaquin,77,732212,24152,23002,360,23362,509
2020-11-12,San Luis Obispo,79,281455,5359,4898,70,4968,33
2020-11-12,San Mateo,81,765935,12859,12086,8,12094,169
2020-11-12,Santa Barbara,83,443738,11063,10325,197,10522,134
2020-11-12,Santa Clara,85,1922200,29618,27261,44,27305,414
2020-11-12,Santa Cruz,87,273765,3624,3317,38,3355,25
2020-11-12,Shasta,89,179085,3936,2825,76,2901,37
2020-11-12,Sierra,91,2930,15,11,0,11,0
2020-11-12,Siskiyou,93,43540,371,275,20,295,0
2020-11-12,Solano,95,438530,8987,8417,46,8463,85
2020-11-12,Sonoma,97,501317,11128,10602,36,10638,151
2020-11-12,Stanislaus,99,539301,19465,18787,1081,19868,422
2020-11-12,Sutter,101,95872,2433,2075,7,2082,12
2020-11-12,Tehama,103,63373,1308,1117,7,1124,7
2020-11-12,Trinity,105,12862,119,62,8,70,0
2020-11-12,Tulare,107,460477,19373,18545,807,19352,305
2020-11-12,Tuolumne,109,53932,654,353,31,384,7
2020-11-12,Ventura,111,848112,16999,16013,505,16518,158
2020-11-12,Yolo,113,214977,3975,3646,10,3656,63
2020-11-12,Yuba,115,75493,1545,1410,7,1417,10
2020-11-11,Alameda,1,1643700,26349,25140,270,25410,429
2020-11-11,Alpine,3,1148,30,12,0,12,0
2020-11-11,Amador,5,37829,425,389,0,389,16
2020-11-11,Butte,7,227075,3561,3348,90,3438,58
2020-11-11,Calaveras,9,45235,378,373,1,374,21
2020-11-11,Colusa,11,21464,613,591,0,591,6
2020-11-11,Contra Costa,13,1133247,21453,20452,118,20570,255
2020-11-11,Del Norte,15,27424,232,203,0,203,2
2020-11-11,El Dorado,17,186661,1805,1564,8,1572,4
2020-11-11,Fresno,19,978130,36672,33287,773,34060,468
2020-11-11,Glenn,21,27897,791,722,16,738,3
2020-11-11,Humboldt,23,135768,697,623,0,623,9
2020-11-11,Imperial,25,180216,14248,13623,25,13648,340
2020-11-11,Inyo,27,18085,268,255,1,256,15
2020-11-11,Kern,29,883053,36609,35014,739,35753,449
2020-11-11,Kings,31,150075,9660,9263,101,9364,85
2020-11-11,Lake,33,64148,815,763,0,763,17
2020-11-11,Lassen,35,31185,1132,831,1,832,0
2020-11-11,Los Angeles,37,10098052,338592,324567,4150,328717,7220
2020-11-11,Madera,39,155013,5559,5248,76,5324,54
2020-11-11,Marin,41,260295,7413,7268,22,7290,133
2020-11-11,Mariposa,43,17540,93,84,0,84,2
2020-11-11,Mendocino,45,87422,1223,1142,3,1145,22
2020-11-11,Merced,47,269075,10448,10074,75,10149,157
2020-11-11,Modoc,49,8938,80,62,13,75,0
2020-11-11,Mono,51,14174,471,443,7,450,2
2020-11-11,Monterey,53,433212,13145,12417,138,12555,100
2020-11-11,Napa,55,140530,2594,2365,9,2374,15
2020-11-11,Nevada,57,99092,899,741,21,762,9
2020-11-11,Orange,59,3164182,67051,62929,2058,64987,1506
2020-11-11,Placer,61,380077,5512,4981,50,5031,60
2020-11-11,Plumas,63,18699,145,111,0,111,0
2020-11-11,Riverside,65,2383286,76470,72953,958,73911,1361
2020-11-11,Sacramento,67,1510023,30932,28968,47,29015,520
2020-11-11,San Benito,69,59416,1609,1512,1,1513,15
2020-11-11,San Bernardino,71,2135413,76160,70374,411,70785,1182
2020-11-11,San Diego,73,3302833,66776,61746,0,61746,918
2020-11-11,San Francisco,75,870044,13879,13287,81,13368,146
2020-11-11,San Joaquin,77,732212,23993,23001,354,23355,509
2020-11-11,San Luis Obispo,79,281455,5284,4832,67,4899,33
2020-11-11,San Mateo,81,765935,12743,12008,8,12016,169
2020-11-11,Santa Barbara,83,443738,10998,10278,197,10475,134
2020-11-11,Santa Clara,85,1922200,29265,27075,42,27117,413
2020-11-11,Santa Cruz,87,273765,3556,3247,38,3285,25
2020-11-11,Shasta,89,179085,3813,2766,66,2832,36
2020-11-11,Sierra,91,2930,13,11,0,11,0
2020-11-11,Siskiyou,93,43540,340,261,17,278,0
2020-11-11,Solano,95,438530,8870,8353,43,8396,85
2020-11-11,Sonoma,97,501317,11054,10498,36,10534,150
2020-11-11,Stanislaus,99,539301,19327,18671,1049,19720,422
2020-11-11,Sutter,101,95872,2386,2049,6,2055,12
2020-11-11,Tehama,103,63373,1266,1105,6,1111,7
2020-11-11,Trinity,105,12862,110,62,8,70,0
2020-11-11,Tulare,107,460477,19245,18500,775,19275,305
2020-11-11,Tuolumne,109,53932,598,354,31,385,7
2020-11-11,Ventura,111,848112,16784,15801,491,16292,158
2020-11-11,Yolo,113,214977,3924,3606,10,3616,63
2020-11-11,Yuba,115,75493,1530,1400,7,1407,10
2020-11-10,Alameda,1,1643700,26118,25008,267,25275,424
2020-11-10,Alpine,3,1148,30,9,0,9,0
2020-11-10,Amador,5,37829,419,384,0,384,16
2020-11-10,Butte,7,227075,3525,3327,86,3413,58
2020-11-10,Calaveras,9,45235,373,367,1,368,21
2020-11-10,Colusa,11,21464,606,590,0,590,6
2020-11-10,Contra Costa,13,1133247,21247,20326,115,20441,255
2020-11-10,Del Norte,15,27424,226,196,0,196,2
2020-11-10,El Dorado,17,186661,1744,1551,8,1559,4
2020-11-10,Fresno,19,978130,36405,33024,734,33758,465
2020-11-10,Glenn,21,27897,783,719,12,731,3
2020-11-10,Humboldt,23,135768,680,610,0,610,9
2020-11-10,Imperial,25,180216,14118,13570,25,13595,338
2020-11-10,Inyo,27,18085,267,252,1,253,14
2020-11-10,Kern,29,883053,36332,34858,720,35578,448
2020-11-10,Kings,31,150075,9613,9236,94,9330,85
2020-11-10,Lake,33,64148,805,762,0,762,16
2020-11-10,Lassen,35,31185,1118,830,1,831,0
2020-11-10,Los Angeles,37,10098052,335348,322569,4031,326600,7205
2020-11-10,Madera,39,155013,5517,5229,70,5299,54
2020-11-10,Marin,41,260295,7394,7259,22,7281,133
2020-11-10,Mariposa,43,17540,91,84,0,84,2
2020-11-10,Mendocino,45,87422,1215,1137,3,1140,22
2020-11-10,Merced,47,269075,10387,9992,68,10060,157
2020-11-10,Modoc,49,8938,78,61,13,74,0
2020-11-10,Mono,51,14174,469,443,7,450,2
2020-11-10,Monterey,53,433212,13007,12335,130,12465,100
2020-11-10,Napa,55,140530,2556,2341,7,2348,15
2020-11-10,Nevada,57,99092,883,734,21,755,9
2020-11-10,Orange,59,3164182,66500,62597,2047,64644,1504
2020-11-10,Placer,61,380077,5432,4902,49,4951,60
2020-11-10,Plumas,63,18699,141,108,0,108,0
2020-11-10,Riverside,65,2383286,75829,72316,932,73248,1359
2020-11-10,Sacramento,67,1510023,30522,28677,44,28721,519
2020-11-10,San Benito,69,59416,1594,1508,1,1509,15
2020-11-10,San Bernardino,71,2135413,74992,69666,376,70042,1182
2020-11-10,San Diego,73,3302833,65887,61085,0,61085,915
2020-11-10,San Francisco,75,870044,13762,13210,81,13291,146
2020-11-10,San Joaquin,77,732212,23829,22865,347,23212,508
2020-11-10,San Luis Obispo,79,281455,5222,4780,63,4843,33
2020-11-10,San Mateo,81,765935,12643,11939,8,11947,169
2020-11-10,Santa Barbara,83,443738,10931,10252,193,10445,134
2020-11-10,Santa Clara,85,1922200,28924,26917,40,26957,409
2020-11-10,Santa Cruz,87,273765,3492,3221,38,3259,25
2020-11-10,Shasta,89,179085,3671,2686,58,2744,36
2020-11-10,Sierra,91,2930,12,10,0,10,0
2020-11-10,Siskiyou,93,43540,324,263,16,279,0
2020-11-10,Solano,95,438530,8772,8299,43,8342,85
2020-11-10,Sonoma,97,501317,10968,10414,36,10450,150
2020-11-10,Stanislaus,99,539301,19194,18592,1025,19617,420
2020-11-10,Sutter,101,95872,2291,2035,5,2040,12
2020-11-10,Tehama,103,63373,1240,1099,5,1104,7
2020-11-10,Trinity,105,12862,101,62,7,69,0
2020-11-10,Tulare,107,460477,19131,18430,751,19181,305
2020-11-10,Tuolumne,109,53932,551,353,29,382,7
2020-11-10,Ventura,111,848112,16601,15625,489,16114,158
2020-11-10,Yolo,113,214977,3862,3573,10,3583,63
2020-11-10,Yuba,115,75493,1507,1392,7,1399,10
2020-11-09,Alameda,1,1643700,25869,24899,263,25162,424
2020-11-09,Alpine,3,1148,28,6,0,6,0
2020-11-09,Amador,5,37829,410,380,0,380,16
2020-11-09,Butte,7,227075,3480,3301,76,3377,57
2020-11-09,Calaveras,9,45235,369,360,1,361,21
2020-11-09,Colusa,11,21464,600,583,0,583,6
2020-11-09,Contra Costa,13,1133247,21074,20193,113,20306,255
2020-11-09,Del Norte,15,27424,220,195,0,195,2
2020-11-09,El Dorado,17,186661,1703,1515,8,1523,4
2020-11-09,Fresno,19,978130,36097,32755,689,33444,465
2020-11-09,Glenn,21,27897,777,714,9,723,3
2020-11-09,Humboldt,23,135768,667,607,0,607,9
2020-11-09,Imperial,25,180216,14001,13508,24,13532,338
2020-11-09,Inyo,27,18085,267,252,1,253,14
2020-11-09,Kern,29,883053,36104,34764,681,35445,448
2020-11-09,Kings,31,150075,9543,9141,92,9233,84
2020-11-09,Lake,33,64148,796,755,0,755,16
2020-11-09,Lassen,35,31185,1023,799,1,800,0
2020-11-09,Los Angeles,37,10098052,332259,320370,3950,324320,7180
2020-11-09,Madera,39,155013,5471,5209,67,5276,54
2020-11-09,Marin,41,260295,7368,7237,21,7258,131
2020-11-09,Mariposa,43,17540,91,84,0,84,2
2020-11-09,Mendocino,45,87422,1203,1132,3,1135,22
2020-11-09,Merced,47,269075,10284,9922,65,9987,157
2020-11-09,Modoc,49,8938,74,54,12,66,0
2020-11-09,Mono,51,14174,466,352,7,359,2
2020-11-09,Monterey,53,433212,12861,12148,122,12270,98
2020-11-09,Napa,55,140530,2513,2309,7,2316,15
2020-11-09,Nevada,57,99092,846,729,20,749,9
2020-11-09,Orange,59,3164182,65858,62335,2035,64370,1501
2020-11-09,Placer,61,380077,5348,4843,38,4881,60
2020-11-09,Plumas,63,18699,134,102,0,102,0
2020-11-09,Riverside,65,2383286,75048,72059,898,72957,1346
2020-11-09,Sacramento,67,1510023,30051,28200,44,28244,516
2020-11-09,San Benito,69,59416,1585,1506,1,1507,15
2020-11-09,San Bernardino,71,2135413,73939,69015,335,69350,1182
2020-11-09,San Diego,73,3302833,65032,60572,0,60572,908
2020-11-09,San Francisco,75,870044,13643,12984,78,13062,146
2020-11-09,San Joaquin,77,732212,23664,22512,341,22853,505
2020-11-09,San Luis Obispo,79,281455,5140,4746,60,4806,32
2020-11-09,San Mateo,81,765935,12536,11857,8,11865,169
2020-11-09,Santa Barbara,83,443738,10874,10214,187,10401,134
2020-11-09,Santa Clara,85,1922200,28529,26693,40,26733,409
2020-11-09,Santa Cruz,87,273765,3434,3194,38,3232,25
2020-11-09,Shasta,89,179085,3514,2581,49,2630,36
2020-11-09,Sierra,91,2930,10,10,0,10,0
2020-11-09,Siskiyou,93,43540,313,257,14,271,0
2020-11-09,Solano,95,438530,8656,8254,42,8296,85
2020-11-09,Sonoma,97,501317,10860,10310,36,10346,150
2020-11-09,Stanislaus,99,539301,19044,18482,1006,19488,418
2020-11-09,Sutter,101,95872,2223,2010,4,2014,12
2020-11-09,Tehama,103,63373,1204,1071,4,1075,7
2020-11-09,Trinity,105,12862,97,46,7,53,0
2020-11-09,Tulare,107,460477,19011,18272,719,18991,304
2020-11-09,Tuolumne,109,53932,497,346,27,373,7
2020-11-09,Ventura,111,848112,16399,15568,486,16054,156
2020-11-09,Yolo,113,214977,3801,3522,10,3532,62
2020-11-09,Yuba,115,75493,1474,1380,7,1387,10
2020-11-08,Alameda,1,1643700,25641,24731,263,24994,424
2020-11-08,Alpine,3,1148,25,6,0,6,0
2020-11-08,Amador,5,37829,403,376,0,376,16
2020-11-08,Butte,7,227075,3442,3285,70,3355,57
2020-11-08,Calaveras,9,45235,367,360,1,361,21
2020-11-08,Colusa,11,21464,597,583,0,583,6
2020-11-08,Contra Costa,13,1133247,20904,20031,111,20142,254
2020-11-08,Del Norte,15,27424,211,195,0,195,2
2020-11-08,El Dorado,17,186661,1665,1502,8,1510,4
2020-11-08,Fresno,19,978130,35765,32619,650,33269,465
2020-11-08,Glenn,21,27897,771,707,8,715,3
2020-11-08,Humboldt,23,135768,651,605,0,605,9
2020-11-08,Imperial,25,180216,13884,13428,24,13452,338
2020-11-08,Inyo,27,18085,263,252,1,253,14
2020-11-08,Kern,29,883053,35886,34644,663,35307,448
2020-11-08,Kings,31,150075,9410,9026,89,9115,84
2020-11-08,Lake,33,64148,788,754,0,754,16
2020-11-08,Lassen,35,31185,875,799,1,800,0
2020-11-08,Los Angeles,37,10098052,329139,318960,3876,322836,7176
2020-11-08,Madera,39,155013,5403,5196,64,5260,54
2020-11-08,Marin,41,260295,7348,7227,21,7248,131
2020-11-08,Mariposa,43,17540,91,83,0,83,2
2020-11-08,Mendocino,45,87422,1194,1129,3,1132,22
2020-11-08,Merced,47,269075,10209,9885,62,9947,157
2020-11-08,Modoc,49,8938,70,54,12,66,0
2020-11-08,Mono,51,14174,460,352,7,359,2
2020-11-08,Monterey,53,433212,12717,12122,110,12232,98
2020-11-08,Napa,55,140530,2473,2274,7,2281,15
2020-11-08,Nevada,57,99092,830,715,20,735,9
2020-11-08,Orange,59,3164182,65275,62034,2020,64054,1501
2020-11-08,Placer,61,380077,5246,4800,33,4833,60
2020-11-08,Plumas,63,18699,129,102,0,102,0
2020-11-08,Riverside,65,2383286,74397,71442,854,72296,1345
2020-11-08,Sacramento,67,1510023,29491,28059,40,28099,515
2020-11-08,San Benito,69,59416,1570,1496,1,1497,15
2020-11-08,San Bernardino,71,2135413,72699,68412,296,68708,1182
2020-11-08,San Diego,73,3302833,64187,60199,0,60199,908
2020-11-08,San Francisco,75,870044,13512,12985,73,13058,146
2020-11-08,San Joaquin,77,732212,23472,22514,335,22849,505
2020-11-08,San Luis Obispo,79,281455,5074,4698,55,4753,32
2020-11-08,San Mateo,81,765935,12417,11783,8,11791,169
2020-11-08,Santa Barbara,83,443738,10804,10180,185,10365,134
2020-11-08,Santa Clara,85,1922200,28156,26442,39,26481,410
2020-11-08,Santa Cruz,87,273765,3377,3134,38,3172,25
2020-11-08,Shasta,89,179085,3378,2582,43,2625,36
2020-11-08,Sierra,91,2930,10,7,0,7,0
2020-11-08,Siskiyou,93,43540,301,246,13,259,0
2020-11-08,Solano,95,438530,8535,8132,41,8173,85
2020-11-08,Sonoma,97,501317,10753,10229,36,10265,149
2020-11-08,Stanislaus,99,539301,18872,18413,983,19396,418
2020-11-08,Sutter,101,95872,2166,1980,4,1984,12
2020-11-08,Tehama,103,63373,1180,1054,4,1058,7
2020-11-08,Trinity,105,12862,94,46,7,53,0
2020-11-08,Tulare,107,460477,18871,18272,686,18958,304
2020-11-08,Tuolumne,109,53932,470,341,27,368,7
2020-11-08,Ventura,111,848112,16205,15504,478,15982,156
2020-11-08,Yolo,113,214977,3738,3492,10,3502,61
2020-11-08,Yuba,115,75493,1453,1369,7,1376,10
2020-11-07,Alameda,1,1643700,25532,24578,261,24839,424
2020-11-07,Alpine,3,1148,25,6,0,6,0
2020-11-07,Amador,5,37829,400,375,0,375,16
2020-11-07,Butte,7,227075,3430,3277,65,3342,57
2020-11-07,Calaveras,9,45235,365,360,1,361,21
2020-11-07,Colusa,11,21464,597,583,0,583,6
2020-11-07,Contra Costa,13,1133247,20802,19943,110,20053,254
2020-11-07,Del Norte,15,27424,207,194,0,194,2
2020-11-07,El Dorado,17,186661,1640,1495,7,1502,4
2020-11-07,Fresno,19,978130,35612,32497,628,33125,465
2020-11-07,Glenn,21,27897,763,707,8,715,3
2020-11-07,Humboldt,23,135768,640,590,0,590,9
2020-11-07,Imperial,25,180216,13826,13388,23,13411,338
2020-11-07,Inyo,27,18085,261,252,1,253,14
2020-11-07,Kern,29,883053,35732,34513,652,35165,448
2020-11-07,Kings,31,150075,9377,9005,83,9088,84
2020-11-07,Lake,33,64148,784,751,0,751,16
2020-11-07,Lassen,35,31185,859,799,1,800,0
2020-11-07,Los Angeles,37,10098052,327638,316756,3800,320556,7174
2020-11-07,Madera,39,155013,5381,5177,62,5239,54
2020-11-07,Marin,41,260295,7337,7215,21,7236,131
2020-11-07,Mariposa,43,17540,91,81,0,81,2
2020-11-07,Mendocino,45,87422,1184,1118,3,1121,22
2020-11-07,Merced,47,269075,10177,9855,58,9913,157
2020-11-07,Modoc,49,8938,70,51,12,63,0
2020-11-07,Mono,51,14174,457,352,7,359,2
2020-11-07,Monterey,53,433212,12648,12030,106,12136,98
2020-11-07,Napa,55,140530,2443,2260,6,2266,15
2020-11-07,Nevada,57,99092,814,710,20,730,9
2020-11-07,Orange,59,3164182,64989,62038,2013,64051,1505
2020-11-07,Placer,61,380077,5184,4745,33,4778,60
2020-11-07,Plumas,63,18699,127,94,0,94,0
2020-11-07,Riverside,65,2383286,74004,71153,824,71977,1345
2020-11-07,Sacramento,67,1510023,29240,27773,40,27813,515
2020-11-07,San Benito,69,59416,1558,1489,1,1490,15
2020-11-07,San Bernardino,71,2135413,72185,67935,285,68220,1182
2020-11-07,San Diego,73,3302833,63675,59682,0,59682,909
2020-11-07,San Francisco,75,870044,13453,12980,72,13052,146
2020-11-07,San Joaquin,77,732212,23364,22517,328,22845,505
2020-11-07,San Luis Obispo,79,281455,5025,4668,52,4720,32
2020-11-07,San Mateo,81,765935,12354,11711,8,11719,169
2020-11-07,Santa Barbara,83,443738,10762,10157,183,10340,134
2020-11-07,Santa Clara,85,1922200,27952,26244,38,26282,410
2020-11-07,Santa Cruz,87,273765,3339,3130,38,3168,25
2020-11-07,Shasta,89,179085,3310,2547,41,2588,36
2020-11-07,Sierra,91,2930,10,7,0,7,0
2020-11-07,Siskiyou,93,43540,297,241,13,254,0
2020-11-07,Solano,95,438530,8483,8066,41,8107,85
2020-11-07,Sonoma,97,501317,10707,10200,36,10236,149
2020-11-07,Stanislaus,99,539301,18764,18386,965,19351,418
2020-11-07,Sutter,101,95872,2126,1973,4,1977,12
2020-11-07,Tehama,103,63373,1156,1043,4,1047,7
2020-11-07,Trinity,105,12862,94,42,6,48,0
2020-11-07,Tulare,107,460477,18816,18229,668,18897,304
2020-11-07,Tuolumne,109,53932,459,327,27,354,7
2020-11-07,Ventura,111,848112,16145,15364,473,15837,156
2020-11-07,Yolo,113,214977,3707,3486,10,3496,61
2020-11-07,Yuba,115,75493,1438,1349,7,1356,10
2020-11-06,Alameda,1,1643700,25400,24389,259,24648,420
2020-11-06,Alpine,3,1148,25,6,0,6,0
2020-11-06,Amador,5,37829,398,369,0,369,16
2020-11-06,Butte,7,227075,3405,3254,57,3311,57
2020-11-06,Calaveras,9,45235,364,359,1,360,21
2020-11-06,Colusa,11,21464,595,580,0,580,6
2020-11-06,Contra Costa,13,1133247,20653,19744,110,19854,252
2020-11-06,Del Norte,15,27424,204,194,0,194,2
2020-11-06,El Dorado,17,186661,1614,1475,7,1482,4
2020-11-06,Fresno,19,978130,35424,32278,611,32889,460
2020-11-06,Glenn,21,27897,757,707,7,714,3
2020-11-06,Humboldt,23,135768,637,587,0,587,9
2020-11-06,Imperial,25,180216,13773,13230,23,13253,338
2020-11-06,Inyo,27,18085,259,246,1,247,14
2020-11-06,Kern,29,883053,35569,34360,633,34993,443
2020-11-06,Kings,31,150075,9354,8883,80,8963,83
2020-11-06,Lake,33,64148,783,741,0,741,16
2020-11-06,Lassen,35,31185,851,794,1,795,0
2020-11-06,Los Angeles,37,10098052,325674,314356,3744,318100,7160
2020-11-06,Madera,39,155013,5365,5136,61,5197,54
2020-11-06,Marin,41,260295,7316,7184,21,7205,131
2020-11-06,Mariposa,43,17540,90,79,0,79,2
2020-11-06,Mendocino,45,87422,1179,1113,3,1116,22
2020-11-06,Merced,47,269075,10138,9778,54,9832,157
2020-11-06,Modoc,49,8938,70,48,12,60,0
2020-11-06,Mono,51,14174,452,308,7,315,1
2020-11-06,Monterey,53,433212,12530,11914,105,12019,96
2020-11-06,Napa,55,140530,2418,2189,6,2195,15
2020-11-06,Nevada,57,99092,801,692,19,711,9
2020-11-06,Orange,59,3164182,64687,61049,2004,63053,1494
2020-11-06,Placer,61,380077,5110,4680,33,4713,60
2020-11-06,Plumas,63,18699,122,90,0,90,0
2020-11-06,Riverside,65,2383286,73557,70409,780,71189,1341
2020-11-06,Sacramento,67,1510023,28950,27489,38,27527,514
2020-11-06,San Benito,69,59416,1549,1479,1,1480,15
2020-11-06,San Bernardino,71,2135413,71591,66740,264,67004,1179
2020-11-06,San Diego,73,3302833,63152,59143,0,59143,907
2020-11-06,San Francisco,75,870044,13384,12825,70,12895,146
2020-11-06,San Joaquin,77,732212,23278,22424,318,22742,502
2020-11-06,San Luis Obispo,79,281455,4962,4531,46,4577,32
2020-11-06,San Mateo,81,765935,12280,11587,8,11595,168
2020-11-06,Santa Barbara,83,443738,10726,10118,178,10296,133
2020-11-06,Santa Clara,85,1922200,27709,25831,38,25869,402
2020-11-06,Santa Cruz,87,273765,3302,3063,38,3101,25
2020-11-06,Shasta,89,179085,3238,2475,39,2514,35
2020-11-06,Sierra,91,2930,9,7,0,7,0
2020-11-06,Siskiyou,93,43540,284,237,12,249,0
2020-11-06,Solano,95,438530,8418,7959,41,8000,85
2020-11-06,Sonoma,97,501317,10657,10142,36,10178,149
2020-11-06,Stanislaus,99,539301,18676,18250,956,19206,417
2020-11-06,Sutter,101,95872,2099,1937,2,1939,12
2020-11-06,Tehama,103,63373,1135,1024,4,1028,6
2020-11-06,Trinity,105,12862,91,41,6,47,0
2020-11-06,Tulare,107,460477,18754,18136,641,18777,300
2020-11-06,Tuolumne,109,53932,438,316,27,343,5
2020-11-06,Ventura,111,848112,16059,15222,470,15692,154
2020-11-06,Yolo,113,214977,3678,3420,9,3429,62
2020-11-06,Yuba,115,75493,1425,1335,7,1342,10
2020-11-05,Alameda,1,1643700,25222,24270,259,24529,420
2020-11-05,Alpine,3,1148,25,6,0,6,0
2020-11-05,Amador,5,37829,395,363,0,363,16
2020-11-05,Butte,7,227075,3382,3239,51,3290,57
2020-11-05,Calaveras,9,45235,357,333,1,334,19
2020-11-05,Colusa,11,21464,591,574,0,574,6
2020-11-05,Contra Costa,13,1133247,20471,19656,108,19764,252
2020-11-05,Del Norte,15,27424,202,192,0,192,2
2020-11-05,El Dorado,17,186661,1590,1466,7,1473,4
2020-11-05,Fresno,19,978130,35190,32056,591,32647,460
2020-11-05,Glenn,21,27897,737,702,7,709,3
2020-11-05,Humboldt,23,135768,626,581,0,581,9
2020-11-05,Imperial,25,180216,13681,13178,21,13199,337
2020-11-05,Inyo,27,18085,259,247,1,248,14
2020-11-05,Kern,29,883053,35369,34232,619,34851,443
2020-11-05,Kings,31,150075,9199,8846,77,8923,83
2020-11-05,Lake,33,64148,779,739,0,739,16
2020-11-05,Lassen,35,31185,820,782,1,783,0
2020-11-05,Los Angeles,37,10098052,323322,312381,3688,316069,7146
2020-11-05,Madera,39,155013,5328,5129,58,5187,54
2020-11-05,Marin,41,260295,7294,7171,21,7192,131
2020-11-05,Mariposa,43,17540,89,79,0,79,2
2020-11-05,Mendocino,45,87422,1167,1112,3,1115,22
2020-11-05,Merced,47,269075,10079,9753,49,9802,155
2020-11-05,Modoc,49,8938,69,47,11,58,0
2020-11-05,Mono,51,14174,450,307,7,314,1
2020-11-05,Monterey,53,433212,12422,11784,101,11885,96
2020-11-05,Napa,55,140530,2391,2158,6,2164,15
2020-11-05,Nevada,57,99092,779,687,18,705,9
2020-11-05,Orange,59,3164182,64242,60740,1994,62734,1484
2020-11-05,Placer,61,380077,5043,4627,28,4655,60
2020-11-05,Plumas,63,18699,114,90,0,90,0
2020-11-05,Riverside,65,2383286,72847,70094,721,70815,1338
2020-11-05,Sacramento,67,1510023,28567,27232,37,27269,512
2020-11-05,San Benito,69,59416,1534,1477,1,1478,15
2020-11-05,San Bernardino,71,2135413,70763,66407,248,66655,1174
2020-11-05,San Diego,73,3302833,62526,58659,0,58659,904
2020-11-05,San Francisco,75,870044,13272,12726,69,12795,146
2020-11-05,San Joaquin,77,732212,23115,22318,313,22631,502
2020-11-05,San Luis Obispo,79,281455,4894,4459,44,4503,32
2020-11-05,San Mateo,81,765935,12186,11535,8,11543,168
2020-11-05,Santa Barbara,83,443738,10682,10080,172,10252,133
2020-11-05,Santa Clara,85,1922200,27441,25651,38,25689,402
2020-11-05,Santa Cruz,87,273765,3264,3023,38,3061,25
2020-11-05,Shasta,89,179085,3147,2401,38,2439,34
2020-11-05,Sierra,91,2930,9,6,0,6,0
2020-11-05,Siskiyou,93,43540,273,228,12,240,0
2020-11-05,Solano,95,438530,8335,7842,41,7883,85
2020-11-05,Sonoma,97,501317,10545,10064,35,10099,145
2020-11-05,Stanislaus,99,539301,18563,18194,943,19137,417
2020-11-05,Sutter,101,95872,2067,1925,2,1927,12
2020-11-05,Tehama,103,63373,1113,1015,4,1019,6
2020-11-05,Trinity,105,12862,77,41,6,47,0
2020-11-05,Tulare,107,460477,18670,18049,608,18657,301
2020-11-05,Tuolumne,109,53932,408,312,27,339,5
2020-11-05,Ventura,111,848112,15893,15113,458,15571,155
2020-11-05,Yolo,113,214977,3628,3391,9,3400,61
2020-11-05,Yuba,115,75493,1407,1322,7,1329,10
2020-11-04,Alameda,1,1643700,25044,24172,257,24429,418
2020-11-04,Alpine,3,1148,21,5,0,5,0
2020-11-04,Amador,5,37829,392,362,0,362,16
2020-11-04,Butte,7,227075,3356,3218,48,3266,57
2020-11-04,Calaveras,9,45235,354,290,1,291,19
2020-11-04,Colusa,11,21464,589,571,0,571,6
2020-11-04,Contra Costa,13,1133247,20306,19472,104,19576,251
2020-11-04,Del Norte,15,27424,198,188,0,188,2
2020-11-04,El Dorado,17,186661,1575,1448,4,1452,4
2020-11-04,Fresno,19,978130,34964,31952,562,32514,457
2020-11-04,Glenn,21,27897,733,701,6,707,3
2020-11-04,Humboldt,23,135768,618,571,0,571,9
2020-11-04,Imperial,25,180216,13583,13087,21,13108,335
2020-11-04,Inyo,27,18085,258,247,1,248,14
2020-11-04,Kern,29,883053,35216,34027,607,34634,439
2020-11-04,Kings,31,150075,9165,8817,75,8892,83
2020-11-04,Lake,33,64148,772,735,0,735,16
2020-11-04,Lassen,35,31185,815,781,1,782,0
2020-11-04,Los Angeles,37,10098052,321022,310456,3599,314055,7124
2020-11-04,Madera,39,155013,5308,5083,54,5137,54
2020-11-04,Marin,41,260295,7283,7157,21,7178,131
2020-11-04,Mariposa,43,17540,89,79,0,79,2
2020-11-04,Mendocino,45,87422,1149,1089,3,1092,22
2020-11-04,Merced,47,269075,10029,9717,47,9764,153
2020-11-04,Modoc,49,8938,59,47,11,58,0
2020-11-04,Mono,51,14174,447,237,6,243,1
2020-11-04,Monterey,53,433212,12218,11743,94,11837,96
2020-11-04,Napa,55,140530,2337,2133,6,2139,15
2020-11-04,Nevada,57,99092,760,675,18,693,9
2020-11-04,Orange,59,3164182,63810,60463,1970,62433,1483
2020-11-04,Placer,61,380077,4965,4526,25,4551,60
2020-11-04,Plumas,63,18699,112,88,0,88,0
2020-11-04,Riverside,65,2383286,72232,69562,660,70222,1335
2020-11-04,Sacramento,67,1510023,28220,27005,36,27041,510
2020-11-04,San Benito,69,59416,1519,1464,1,1465,15
2020-11-04,San Bernardino,71,2135413,69968,65891,223,66114,1169
2020-11-04,San Diego,73,3302833,61881,58126,0,58126,904
2020-11-04,San Francisco,75,870044,13189,12649,66,12715,146
2020-11-04,San Joaquin,77,732212,22978,22197,300,22497,500
2020-11-04,San Luis Obispo,79,281455,4827,4389,42,4431,32
2020-11-04,San Mateo,81,765935,12091,11456,8,11464,168
2020-11-04,Santa Barbara,83,443738,10644,10026,171,10197,132
2020-11-04,Santa Clara,85,1922200,27180,25487,38,25525,393
2020-11-04,Santa Cruz,87,273765,3227,2997,38,3035,25
2020-11-04,Shasta,89,179085,3016,2321,33,2354,34
2020-11-04,Sierra,91,2930,9,6,0,6,0
2020-11-04,Siskiyou,93,43540,264,222,12,234,0
2020-11-04,Solano,95,438530,8236,7733,41,7774,85
2020-11-04,Sonoma,97,501317,10451,9965,35,10000,142
2020-11-04,Stanislaus,99,539301,18447,18114,927,19041,416
2020-11-04,Sutter,101,95872,2033,1916,2,1918,12
2020-11-04,Tehama,103,63373,1089,997,4,1001,6
2020-11-04,Trinity,105,12862,75,37,6,43,0
2020-11-04,Tulare,107,460477,18562,17952,580,18532,298
2020-11-04,Tuolumne,109,53932,386,310,27,337,5
2020-11-04,Ventura,111,848112,15753,14936,454,15390,155
2020-11-04,Yolo,113,214977,3587,3361,9,3370,62
2020-11-04,Yuba,115,75493,1386,1312,7,1319,10
2020-11-03,Alameda,1,1643700,24860,24055,255,24310,418
2020-11-03,Alpine,3,1148,20,4,0,4,0
2020-11-03,Amador,5,37829,387,361,0,361,16
2020-11-03,Butte,7,227075,3333,3211,42,3253,57
2020-11-03,Calaveras,9,45235,350,287,1,288,19
2020-11-03,Colusa,11,21464,584,572,0,572,6
2020-11-03,Contra Costa,13,1133247,20151,19416,104,19520,250
2020-11-03,Del Norte,15,27424,197,187,0,187,2
2020-11-03,El Dorado,17,186661,1553,1445,3,1448,4
2020-11-03,Fresno,19,978130,34701,31856,535,32391,457
2020-11-03,Glenn,21,27897,727,698,6,704,3
2020-11-03,Humboldt,23,135768,612,570,0,570,8
2020-11-03,Imperial,25,180216,13494,13044,19,13063,335
2020-11-03,Inyo,27,18085,257,244,1,245,14
2020-11-03,Kern,29,883053,35026,33957,595,34552,439
2020-11-03,Kings,31,150075,9002,8783,70,8853,83
2020-11-03,Lake,33,64148,762,732,0,732,16
2020-11-03,Lassen,35,31185,806,782,1,783,0
2020-11-03,Los Angeles,37,10098052,318572,308812,3524,312336,7104
2020-11-03,Madera,39,155013,5272,5058,53,5111,54
2020-11-03,Marin,41,260295,7263,7147,20,7167,131
2020-11-03,Mariposa,43,17540,88,79,0,79,2
2020-11-03,Mendocino,45,87422,1135,1084,3,1087,22
2020-11-03,Merced,47,269075,9977,9713,46,9759,153
2020-11-03,Modoc,49,8938,57,47,9,56,0
2020-11-03,Mono,51,14174,443,210,6,216,1
2020-11-03,Monterey,53,433212,12150,11703,87,11790,94
2020-11-03,Napa,55,140530,2301,2130,6,2136,15
2020-11-03,Nevada,57,99092,740,670,17,687,9
2020-11-03,Orange,59,3164182,63384,60283,1958,62241,1477
2020-11-03,Placer,61,380077,4891,4514,25,4539,60
2020-11-03,Plumas,63,18699,109,86,0,86,0
2020-11-03,Riverside,65,2383286,71617,69300,633,69933,1325
2020-11-03,Sacramento,67,1510023,27838,26841,35,26876,510
2020-11-03,San Benito,69,59416,1509,1463,1,1464,15
2020-11-03,San Bernardino,71,2135413,69159,65320,219,65539,1159
2020-11-03,San Diego,73,3302833,61206,57722,0,57722,901
2020-11-03,San Francisco,75,870044,13066,12585,65,12650,146
2020-11-03,San Joaquin,77,732212,22844,22109,294,22403,500
2020-11-03,San Luis Obispo,79,281455,4743,4371,40,4411,32
2020-11-03,San Mateo,81,765935,11997,11406,8,11414,162
2020-11-03,Santa Barbara,83,443738,10590,10008,165,10173,132
2020-11-03,Santa Clara,85,1922200,26905,25386,37,25423,393
2020-11-03,Santa Cruz,87,273765,3177,2980,37,3017,25
2020-11-03,Shasta,89,179085,2921,2288,27,2315,33
2020-11-03,Sierra,91,2930,7,6,0,6,0
2020-11-03,Siskiyou,93,43540,260,219,11,230,0
2020-11-03,Solano,95,438530,8153,7691,41,7732,85
2020-11-03,Sonoma,97,501317,10349,9906,35,9941,142
2020-11-03,Stanislaus,99,539301,18329,18080,914,18994,416
2020-11-03,Sutter,101,95872,2000,1914,2,1916,12
2020-11-03,Tehama,103,63373,1068,988,4,992,6
2020-11-03,Trinity,105,12862,69,36,5,41,0
2020-11-03,Tulare,107,460477,18459,17890,552,18442,297
2020-11-03,Tuolumne,109,53932,363,302,27,329,5
2020-11-03,Ventura,111,848112,15626,14816,447,15263,155
2020-11-03,Yolo,113,214977,3536,3343,9,3352,61
2020-11-03,Yuba,115,75493,1373,1295,7,1302,10
2020-11-02,Alameda,1,1643700,24664,23991,252,24243,419
2020-11-02,Alpine,3,1148,17,4,0,4,0
2020-11-02,Amador,5,37829,379,357,0,357,16
2020-11-02,Butte,7,227075,3313,3198,39,3237,57
2020-11-02,Calaveras,9,45235,350,282,1,283,18
2020-11-02,Colusa,11,21464,579,571,0,571,6
2020-11-02,Contra Costa,13,1133247,19997,19339,103,19442,250
2020-11-02,Del Norte,15,27424,194,175,0,175,2
2020-11-02,El Dorado,17,186661,1529,1405,3,1408,4
2020-11-02,Fresno,19,978130,34435,31738,518,32256,451
2020-11-02,Glenn,21,27897,721,692,5,697,3
2020-11-02,Humboldt,23,135768,603,569,0,569,8
2020-11-02,Imperial,25,180216,13414,13004,18,13022,334
2020-11-02,Inyo,27,18085,254,243,1,244,14
2020-11-02,Kern,29,883053,34870,33834,585,34419,437
2020-11-02,Kings,31,150075,8972,8654,67,8721,82
2020-11-02,Lake,33,64148,756,728,0,728,17
2020-11-02,Lassen,35,31185,798,782,1,783,0
2020-11-02,Los Angeles,37,10098052,316229,307620,3443,311063,7079
2020-11-02,Madera,39,155013,5242,5033,52,5085,54
2020-11-02,Marin,41,260295,7245,7132,19,7151,125
2020-11-02,Mariposa,43,17540,88,79,0,79,2
2020-11-02,Mendocino,45,87422,1121,1076,3,1079,21
2020-11-02,Merced,47,269075,9915,9664,40,9704,152
2020-11-02,Modoc,49,8938,54,45,5,50,0
2020-11-02,Mono,51,14174,441,211,6,217,1
2020-11-02,Monterey,53,433212,12043,11602,84,11686,93
2020-11-02,Napa,55,140530,2259,2081,6,2087,15
2020-11-02,Nevada,57,99092,724,656,17,673,9
2020-11-02,Orange,59,3164182,62982,59996,1940,61936,1474
2020-11-02,Placer,61,380077,4822,4461,23,4484,60
2020-11-02,Plumas,63,18699,101,86,0,86,0
2020-11-02,Riverside,65,2383286,70986,68833,592,69425,1321
2020-11-02,Sacramento,67,1510023,27498,26676,33,26709,508
2020-11-02,San Benito,69,59416,1497,1459,1,1460,15
2020-11-02,San Bernardino,71,2135413,68302,64629,212,64841,1157
2020-11-02,San Diego,73,3302833,60483,57429,0,57429,891
2020-11-02,San Francisco,75,870044,12969,12436,64,12500,145
2020-11-02,San Joaquin,77,732212,22705,21919,285,22204,500
2020-11-02,San Luis Obispo,79,281455,4642,4303,37,4340,31
2020-11-02,San Mateo,81,765935,11888,11328,8,11336,161
2020-11-02,Santa Barbara,83,443738,10549,9985,160,10145,130
2020-11-02,Santa Clara,85,1922200,26616,25222,37,25259,387
2020-11-02,Santa Cruz,87,273765,3135,2943,37,2980,25
2020-11-02,Shasta,89,179085,2816,2174,23,2197,33
2020-11-02,Sierra,91,2930,7,6,0,6,0
2020-11-02,Siskiyou,93,43540,250,216,11,227,0
2020-11-02,Solano,95,438530,8035,7665,41,7706,84
2020-11-02,Sonoma,97,501317,10265,9796,34,9830,140
2020-11-02,Stanislaus,99,539301,18233,18005,905,18910,412
2020-11-02,Sutter,101,95872,1976,1895,2,1897,12
2020-11-02,Tehama,103,63373,1045,971,4,975,6
2020-11-02,Trinity,105,12862,65,30,5,35,0
2020-11-02,Tulare,107,460477,18369,17774,530,18304,299
2020-11-02,Tuolumne,109,53932,343,302,27,329,5
2020-11-02,Ventura,111,848112,15491,14767,427,15194,156
2020-11-02,Yolo,113,214977,3487,3318,9,3327,61
2020-11-02,Yuba,115,75493,1360,1280,7,1287,10
2020-11-01,Alameda,1,1643700,24503,23892,250,24142,419
2020-11-01,Alpine,3,1148,11,4,0,4,0
2020-11-01,Amador,5,37829,376,352,0,352,16
2020-11-01,Butte,7,227075,3290,3185,37,3222,57
2020-11-01,Calaveras,9,45235,349,282,1,283,18
2020-11-01,Colusa,11,21464,577,567,0,567,6
2020-11-01,Contra Costa,13,1133247,19823,19246,102,19348,250
2020-11-01,Del Norte,15,27424,190,175,0,175,2
2020-11-01,El Dorado,17,186661,1513,1394,3,1397,4
2020-11-01,Fresno,19,978130,34181,31613,501,32114,451
2020-11-01,Glenn,21,27897,712,688,3,691,3
2020-11-01,Humboldt,23,135768,595,568,0,568,8
2020-11-01,Imperial,25,180216,13323,12969,16,12985,334
2020-11-01,Inyo,27,18085,252,241,1,242,14
2020-11-01,Kern,29,883053,34690,33760,471,34231,437
2020-11-01,Kings,31,150075,8934,8641,66,8707,82
2020-11-01,Lake,33,64148,750,727,0,727,17
2020-11-01,Lassen,35,31185,798,782,1,783,0
2020-11-01,Los Angeles,37,10098052,313669,306217,3344,309561,7077
2020-11-01,Madera,39,155013,5195,5019,50,5069,54
2020-11-01,Marin,41,260295,7228,7124,19,7143,125
2020-11-01,Mariposa,43,17540,84,79,0,79,2
2020-11-01,Mendocino,45,87422,1108,1074,3,1077,21
2020-11-01,Merced,47,269075,9854,9626,40,9666,152
2020-11-01,Modoc,49,8938,53,45,5,50,0
2020-11-01,Mono,51,14174,411,211,5,216,1
2020-11-01,Monterey,53,433212,11935,11587,81,11668,93
2020-11-01,Napa,55,140530,2225,2067,6,2073,15
2020-11-01,Nevada,57,99092,708,646,16,662,9
2020-11-01,Orange,59,3164182,62580,59733,1912,61645,1475
2020-11-01,Placer,61,380077,4758,4422,22,4444,58
2020-11-01,Plumas,63,18699,96,86,0,86,0
2020-11-01,Riverside,65,2383286,70358,68493,556,69049,1319
2020-11-01,Sacramento,67,1510023,27180,26442,33,26475,508
2020-11-01,San Benito,69,59416,1482,1451,1,1452,15
2020-11-01,San Bernardino,71,2135413,67462,64339,190,64529,1157
2020-11-01,San Diego,73,3302833,59796,57122,0,57122,891
2020-11-01,San Francisco,75,870044,12847,12436,59,12495,145
2020-11-01,San Joaquin,77,732212,22578,21919,278,22197,500
2020-11-01,San Luis Obispo,79,281455,4562,4303,36,4339,31
2020-11-01,San Mateo,81,765935,11808,11280,8,11288,160
2020-11-01,Santa Barbara,83,443738,10499,9969,142,10111,130
2020-11-01,Santa Clara,85,1922200,26339,25090,37,25127,386
2020-11-01,Santa Cruz,87,273765,3082,2921,37,2958,25
2020-11-01,Shasta,89,179085,2680,2172,22,2194,33
2020-11-01,Sierra,91,2930,7,6,0,6,0
2020-11-01,Siskiyou,93,43540,245,205,11,216,0
2020-11-01,Solano,95,438530,7945,7591,41,7632,84
2020-11-01,Sonoma,97,501317,10173,9688,34,9722,140
2020-11-01,Stanislaus,99,539301,18132,17961,885,18846,412
2020-11-01,Sutter,101,95872,1950,1888,1,1889,12
2020-11-01,Tehama,103,63373,1028,965,4,969,5
2020-11-01,Trinity,105,12862,63,30,5,35,0
2020-11-01,Tulare,107,460477,18257,17774,499,18273,299
2020-11-01,Tuolumne,109,53932,321,295,27,322,5
2020-11-01,Ventura,111,848112,15345,14686,392,15078,156
2020-11-01,Yolo,113,214977,3438,3303,9,3312,60
2020-11-01,Yuba,115,75493,1343,1273,7,1280,10
2020-10-31,Alameda,1,1643700,24388,23780,246,24026,416
2020-10-31,Alpine,3,1148,11,4,0,4,0
2020-10-31,Amador,5,37829,372,347,0,347,16
2020-10-31,Butte,7,227075,3277,3172,35,3207,57
2020-10-31,Calaveras,9,45235,349,280,1,281,18
2020-10-31,Colusa,11,21464,575,555,0,555,6
2020-10-31,Contra Costa,13,1133247,19717,19161,102,19263,249
2020-10-31,Del Norte,15,27424,189,175,0,175,2
2020-10-31,El Dorado,17,186661,1504,1390,3,1393,4
2020-10-31,Fresno,19,978130,34045,31558,497,32055,451
2020-10-31,Glenn,21,27897,710,678,3,681,3
2020-10-31,Humboldt,23,135768,592,561,0,561,8
2020-10-31,Imperial,25,180216,13281,12912,16,12928,334
2020-10-31,Inyo,27,18085,251,241,1,242,14
2020-10-31,Kern,29,883053,34589,33666,460,34126,437
2020-10-31,Kings,31,150075,8913,8612,64,8676,82
2020-10-31,Lake,33,64148,746,724,0,724,16
2020-10-31,Lassen,35,31185,793,782,1,783,0
2020-10-31,Los Angeles,37,10098052,312301,304704,3299,308003,7073
2020-10-31,Madera,39,155013,5178,5013,47,5060,54
2020-10-31,Marin,41,260295,7212,7112,19,7131,125
2020-10-31,Mariposa,43,17540,84,79,0,79,2
2020-10-31,Mendocino,45,87422,1100,1066,3,1069,21
2020-10-31,Merced,47,269075,9821,9597,39,9636,151
2020-10-31,Modoc,49,8938,52,34,4,38,0
2020-10-31,Mono,51,14174,262,194,4,198,1
2020-10-31,Monterey,53,433212,11867,11539,77,11616,93
2020-10-31,Napa,55,140530,2206,2040,6,2046,15
2020-10-31,Nevada,57,99092,690,644,16,660,9
2020-10-31,Orange,59,3164182,62321,59488,1894,61382,1473
2020-10-31,Placer,61,380077,4709,4374,21,4395,58
2020-10-31,Plumas,63,18699,95,85,0,85,0
2020-10-31,Riverside,65,2383286,70002,68178,533,68711,1319
2020-10-31,Sacramento,67,1510023,26980,26316,31,26347,507
2020-10-31,San Benito,69,59416,1475,1448,1,1449,15
2020-10-31,San Bernardino,71,2135413,67037,64016,180,64196,1157
2020-10-31,San Diego,73,3302833,59343,56769,0,56769,891
2020-10-31,San Francisco,75,870044,12774,12438,58,12496,145
2020-10-31,San Joaquin,77,732212,22503,21918,268,22186,500
2020-10-31,San Luis Obispo,79,281455,4493,4285,33,4318,31
2020-10-31,San Mateo,81,765935,11756,11253,8,11261,160
2020-10-31,Santa Barbara,83,443738,10471,9957,134,10091,130
2020-10-31,Santa Clara,85,1922200,26171,24957,37,24994,379
2020-10-31,Santa Cruz,87,273765,3047,2895,36,2931,25
2020-10-31,Shasta,89,179085,2630,2122,21,2143,33
2020-10-31,Sierra,91,2930,7,6,0,6,0
2020-10-31,Siskiyou,93,43540,243,200,11,211,0
2020-10-31,Solano,95,438530,7881,7545,41,7586,84
2020-10-31,Sonoma,97,501317,10120,9648,34,9682,140
2020-10-31,Stanislaus,99,539301,18070,17920,868,18788,412
2020-10-31,Sutter,101,95872,1941,1876,1,1877,12
2020-10-31,Tehama,103,63373,1018,953,4,957,5
2020-10-31,Trinity,105,12862,60,30,5,35,0
2020-10-31,Tulare,107,460477,18208,17758,491,18249,299
2020-10-31,Tuolumne,109,53932,315,290,27,317,5
2020-10-31,Ventura,111,848112,15262,14635,373,15008,155
2020-10-31,Yolo,113,214977,3403,3290,9,3299,60
2020-10-31,Yuba,115,75493,1327,1260,6,1266,10
2020-10-30,Alameda,1,1643700,24309,23676,243,23919,401
2020-10-30,Alpine,3,1148,11,4,0,4,0
2020-10-30,Amador,5,37829,372,344,0,344,16
2020-10-30,Butte,7,227075,3272,3160,35,3195,57
2020-10-30,Calaveras,9,45235,348,279,1,280,18
2020-10-30,Colusa,11,21464,573,554,0,554,6
2020-10-30,Contra Costa,13,1133247,19645,19074,102,19176,249
2020-10-30,Del Norte,15,27424,188,175,0,175,2
2020-10-30,El Dorado,17,186661,1491,1386,3,1389,4
2020-10-30,Fresno,19,978130,33925,31409,489,31898,446
2020-10-30,Glenn,21,27897,704,674,2,676,3
2020-10-30,Humboldt,23,135768,591,561,0,561,7
2020-10-30,Imperial,25,180216,13240,12853,16,12869,334
2020-10-30,Inyo,27,18085,250,241,1,242,14
2020-10-30,Kern,29,883053,34496,33583,459,34042,437
2020-10-30,Kings,31,150075,8903,8564,62,8626,82
2020-10-30,Lake,33,64148,746,720,0,720,16
2020-10-30,Lassen,35,31185,787,777,1,778,0
2020-10-30,Los Angeles,37,10098052,310868,303425,3260,306685,7060
2020-10-30,Madera,39,155013,5166,4991,45,5036,54
2020-10-30,Marin,41,260295,7192,7097,19,7116,125
2020-10-30,Mariposa,43,17540,84,78,0,78,2
2020-10-30,Mendocino,45,87422,1098,1062,3,1065,21
2020-10-30,Merced,47,269075,9789,9539,39,9578,150
2020-10-30,Modoc,49,8938,51,34,3,37,0
2020-10-30,Mono,51,14174,261,193,4,197,1
2020-10-30,Monterey,53,433212,11805,11491,71,11562,92
2020-10-30,Napa,55,140530,2188,2028,6,2034,15
2020-10-30,Nevada,57,99092,684,634,16,650,9
2020-10-30,Orange,59,3164182,62080,59334,1881,61215,1469
2020-10-30,Placer,61,380077,4662,4335,21,4356,58
2020-10-30,Plumas,63,18699,92,80,0,80,0
2020-10-30,Riverside,65,2383286,69661,67752,513,68265,1317
2020-10-30,Sacramento,67,1510023,26833,26147,31,26178,505
2020-10-30,San Benito,69,59416,1469,1440,1,1441,15
2020-10-30,San Bernardino,71,2135413,66621,63512,179,63691,1156
2020-10-30,San Diego,73,3302833,58938,56387,0,56387,888
2020-10-30,San Francisco,75,870044,12720,12384,58,12442,145
2020-10-30,San Joaquin,77,732212,22437,21849,261,22110,500
2020-10-30,San Luis Obispo,79,281455,4450,4256,33,4289,31
2020-10-30,San Mateo,81,765935,11697,11207,8,11215,159
2020-10-30,Santa Barbara,83,443738,10448,9937,132,10069,128
2020-10-30,Santa Clara,85,1922200,26022,24811,37,24848,378
2020-10-30,Santa Cruz,87,273765,3029,2874,36,2910,25
2020-10-30,Shasta,89,179085,2586,2048,20,2068,32
2020-10-30,Sierra,91,2930,7,6,0,6,0
2020-10-30,Siskiyou,93,43540,243,192,11,203,0
2020-10-30,Solano,95,438530,7820,7497,41,7538,84
2020-10-30,Sonoma,97,501317,10046,9602,33,9635,140
2020-10-30,Stanislaus,99,539301,18024,17861,851,18712,410
2020-10-30,Sutter,101,95872,1928,1860,1,1861,12
2020-10-30,Tehama,103,63373,1014,932,4,936,5
2020-10-30,Trinity,105,12862,60,29,5,34,0
2020-10-30,Tulare,107,460477,18165,17682,473,18155,299
2020-10-30,Tuolumne,109,53932,308,286,27,313,4
2020-10-30,Ventura,111,848112,15191,14578,358,14936,154
2020-10-30,Yolo,113,214977,3386,3263,9,3272,60
2020-10-30,Yuba,115,75493,1319,1256,6,1262,10
2020-10-29,Alameda,1,1643700,24146,23530,242,23772,401
2020-10-29,Alpine,3,1148,8,4,0,4,0
2020-10-29,Amador,5,37829,368,338,0,338,16
2020-10-29,Butte,7,227075,3254,3143,35,3178,57
2020-10-29,Calaveras,9,45235,346,278,1,279,13
2020-10-29,Colusa,11,21464,569,552,0,552,6
2020-10-29,Contra Costa,13,1133247,19546,18933,101,19034,249
2020-10-29,Del Norte,15,27424,186,174,0,174,2
2020-10-29,El Dorado,17,186661,1469,1370,3,1373,4
2020-10-29,Fresno,19,978130,33770,31321,481,31802,445
2020-10-29,Glenn,21,27897,702,673,2,675,3
2020-10-29,Humboldt,23,135768,586,559,0,559,7
2020-10-29,Imperial,25,180216,13196,12769,16,12785,334
2020-10-29,Inyo,27,18085,248,238,1,239,14
2020-10-29,Kern,29,883053,34395,33460,454,33914,437
2020-10-29,Kings,31,150075,8749,8502,61,8563,82
2020-10-29,Lake,33,64148,743,702,0,702,16
2020-10-29,Lassen,35,31185,786,772,1,773,0
2020-10-29,Los Angeles,37,10098052,309250,302246,3206,305452,7046
2020-10-29,Madera,39,155013,5137,4970,43,5013,53
2020-10-29,Marin,41,260295,7179,7083,19,7102,125
2020-10-29,Mariposa,43,17540,82,78,0,78,2
2020-10-29,Mendocino,45,87422,1092,1058,3,1061,21
2020-10-29,Merced,47,269075,9736,9496,39,9535,150
2020-10-29,Modoc,49,8938,49,31,3,34,0
2020-10-29,Mono,51,14174,254,176,4,180,1
2020-10-29,Monterey,53,433212,11724,11425,69,11494,92
2020-10-29,Napa,55,140530,2164,2009,6,2015,15
2020-10-29,Nevada,57,99092,678,632,16,648,9
2020-10-29,Orange,59,3164182,61812,59046,1860,60906,1464
2020-10-29,Placer,61,380077,4617,4270,19,4289,58
2020-10-29,Plumas,63,18699,90,69,0,69,0
2020-10-29,Riverside,65,2383286,69286,67268,484,67752,1304
2020-10-29,Sacramento,67,1510023,26621,25978,30,26008,507
2020-10-29,San Benito,69,59416,1464,1431,1,1432,15
2020-10-29,San Bernardino,71,2135413,66053,62968,169,63137,1150
2020-10-29,San Diego,73,3302833,58474,55916,0,55916,885
2020-10-29,San Francisco,75,870044,12641,12312,58,12370,145
2020-10-29,San Joaquin,77,732212,22354,21736,248,21984,498
2020-10-29,San Luis Obispo,79,281455,4421,4223,31,4254,31
2020-10-29,San Mateo,81,765935,11651,11145,8,11153,157
2020-10-29,Santa Barbara,83,443738,10415,9902,130,10032,128
2020-10-29,Santa Clara,85,1922200,25870,24614,37,24651,377
2020-10-29,Santa Cruz,87,273765,3005,2850,36,2886,24
2020-10-29,Shasta,89,179085,2523,2008,20,2028,32
2020-10-29,Sierra,91,2930,6,6,0,6,0
2020-10-29,Siskiyou,93,43540,227,185,11,196,0
2020-10-29,Solano,95,438530,7757,7453,41,7494,78
2020-10-29,Sonoma,97,501317,9982,9533,33,9566,140
2020-10-29,Stanislaus,99,539301,17971,17790,829,18619,410
2020-10-29,Sutter,101,95872,1920,1852,1,1853,12
2020-10-29,Tehama,103,63373,996,925,4,929,5
2020-10-29,Trinity,105,12862,55,28,5,33,0
2020-10-29,Tulare,107,460477,18089,17627,453,18080,299
2020-10-29,Tuolumne,109,53932,303,279,27,306,4
2020-10-29,Ventura,111,848112,15101,14486,353,14839,154
2020-10-29,Yolo,113,214977,3357,3246,9,3255,60
2020-10-29,Yuba,115,75493,1308,1248,6,1254,10
2020-10-28,Alameda,1,1643700,24046,23468,241,23709,400
2020-10-28,Alpine,3,1148,7,4,0,4,0
2020-10-28,Amador,5,37829,365,337,0,337,16
2020-10-28,Butte,7,227075,3238,3134,32,3166,56
2020-10-28,Calaveras,9,45235,345,278,1,279,13
2020-10-28,Colusa,11,21464,566,551,0,551,6
2020-10-28,Contra Costa,13,1133247,19459,18828,100,18928,246
2020-10-28,Del Norte,15,27424,183,173,0,173,2
2020-10-28,El Dorado,17,186661,1457,1363,3,1366,4
2020-10-28,Fresno,19,978130,33651,31195,477,31672,444
2020-10-28,Glenn,21,27897,698,673,2,675,3
2020-10-28,Humboldt,23,135768,582,559,0,559,7
2020-10-28,Imperial,25,180216,13147,12730,16,12746,333
2020-10-28,Inyo,27,18085,248,238,1,239,14
2020-10-28,Kern,29,883053,34293,33424,435,33859,436
2020-10-28,Kings,31,150075,8727,8486,60,8546,82
2020-10-28,Lake,33,64148,740,700,0,700,15
2020-10-28,Lassen,35,31185,782,771,1,772,0
2020-10-28,Los Angeles,37,10098052,307791,300726,3164,303890,7031
2020-10-28,Madera,39,155013,5121,4954,42,4996,53
2020-10-28,Marin,41,260295,7168,7079,19,7098,126
2020-10-28,Mariposa,43,17540,82,78,0,78,2
2020-10-28,Mendocino,45,87422,1091,1037,3,1040,20
2020-10-28,Merced,47,269075,9710,9480,38,9518,150
2020-10-28,Modoc,49,8938,48,31,2,33,0
2020-10-28,Mono,51,14174,236,176,4,180,1
2020-10-28,Monterey,53,433212,11666,11330,67,11397,89
2020-10-28,Napa,55,140530,2138,1998,5,2003,15
2020-10-28,Nevada,57,99092,670,629,16,645,9
2020-10-28,Orange,59,3164182,61550,58801,1843,60644,1459
2020-10-28,Placer,61,380077,4561,4236,19,4255,57
2020-10-28,Plumas,63,18699,89,67,0,67,0
2020-10-28,Riverside,65,2383286,68888,67003,460,67463,1302
2020-10-28,Sacramento,67,1510023,26424,25838,28,25866,506
2020-10-28,San Benito,69,59416,1456,1429,1,1430,15
2020-10-28,San Bernardino,71,2135413,65593,62778,164,62942,1154
2020-10-28,San Diego,73,3302833,58090,55556,0,55556,881
2020-10-28,San Francisco,75,870044,12583,12261,57,12318,145
2020-10-28,San Joaquin,77,732212,22271,21707,236,21943,498
2020-10-28,San Luis Obispo,79,281455,4380,4197,28,4225,31
2020-10-28,San Mateo,81,765935,11587,11101,8,11109,157
2020-10-28,Santa Barbara,83,443738,10392,9872,128,10000,127
2020-10-28,Santa Clara,85,1922200,25726,24503,37,24540,375
2020-10-28,Santa Cruz,87,273765,2974,2836,36,2872,24
2020-10-28,Shasta,89,179085,2443,1996,19,2015,31
2020-10-28,Sierra,91,2930,6,6,0,6,0
2020-10-28,Siskiyou,93,43540,224,182,10,192,0
2020-10-28,Solano,95,438530,7698,7362,41,7403,77
2020-10-28,Sonoma,97,501317,9891,9457,28,9485,140
2020-10-28,Stanislaus,99,539301,17906,17765,820,18585,409
2020-10-28,Sutter,101,95872,1911,1840,1,1841,12
2020-10-28,Tehama,103,63373,985,921,4,925,5
2020-10-28,Trinity,105,12862,51,28,5,33,0
2020-10-28,Tulare,107,460477,18033,17569,435,18004,297
2020-10-28,Tuolumne,109,53932,300,277,27,304,4
2020-10-28,Ventura,111,848112,15028,14409,344,14753,153
2020-10-28,Yolo,113,214977,3333,3230,9,3239,60
2020-10-28,Yuba,115,75493,1296,1245,6,1251,10
2020-10-27,Alameda,1,1643700,23935,23365,238,23603,400
2020-10-27,Alpine,3,1148,7,3,0,3,0
2020-10-27,Amador,5,37829,362,335,0,335,16
2020-10-27,Butte,7,227075,3222,3107,29,3136,56
2020-10-27,Calaveras,9,45235,343,277,1,278,13
2020-10-27,Colusa,11,21464,561,549,0,549,6
2020-10-27,Contra Costa,13,1133247,19354,18766,100,18866,246
2020-10-27,Del Norte,15,27424,180,173,0,173,2
2020-10-27,El Dorado,17,186661,1444,1351,3,1354,4
2020-10-27,Fresno,19,978130,33537,31096,472,31568,442
2020-10-27,Glenn,21,27897,696,667,1,668,3
2020-10-27,Humboldt,23,135768,579,559,0,559,7
2020-10-27,Imperial,25,180216,13098,12680,16,12696,333
2020-10-27,Inyo,27,18085,248,231,1,232,14
2020-10-27,Kern,29,883053,34176,33328,431,33759,436
2020-10-27,Kings,31,150075,8696,8411,60,8471,83
2020-10-27,Lake,33,64148,737,700,0,700,15
2020-10-27,Lassen,35,31185,780,764,1,765,0
2020-10-27,Los Angeles,37,10098052,306413,299438,3133,302571,7008
2020-10-27,Madera,39,155013,5091,4942,41,4983,53
2020-10-27,Marin,41,260295,7152,7070,19,7089,126
2020-10-27,Mariposa,43,17540,81,78,0,78,2
2020-10-27,Mendocino,45,87422,1084,1033,2,1035,20
2020-10-27,Merced,47,269075,9670,9449,38,9487,150
2020-10-27,Modoc,49,8938,46,31,2,33,0
2020-10-27,Mono,51,14174,222,169,4,173,1
2020-10-27,Monterey,53,433212,11610,11261,65,11326,88
2020-10-27,Napa,55,140530,2122,1979,5,1984,15
2020-10-27,Nevada,57,99092,664,622,16,638,8
2020-10-27,Orange,59,3164182,61280,58550,1826,60376,1448
2020-10-27,Placer,61,380077,4513,4197,17,4214,57
2020-10-27,Plumas,63,18699,86,63,0,63,0
2020-10-27,Riverside,65,2383286,68535,66699,415,67114,1299
2020-10-27,Sacramento,67,1510023,26238,25701,27,25728,501
2020-10-27,San Benito,69,59416,1451,1428,1,1429,15
2020-10-27,San Bernardino,71,2135413,65134,62357,152,62509,1154
2020-10-27,San Diego,73,3302833,57617,55226,0,55226,877
2020-10-27,San Francisco,75,870044,12509,12218,56,12274,140
2020-10-27,San Joaquin,77,732212,22180,21637,227,21864,496
2020-10-27,San Luis Obispo,79,281455,4353,4148,24,4172,31
2020-10-27,San Mateo,81,765935,11538,11074,8,11082,156
2020-10-27,Santa Barbara,83,443738,10363,9874,127,10001,125
2020-10-27,Santa Clara,85,1922200,25584,24368,37,24405,367
2020-10-27,Santa Cruz,87,273765,2944,2815,35,2850,24
2020-10-27,Shasta,89,179085,2356,1962,19,1981,29
2020-10-27,Sierra,91,2930,6,6,0,6,0
2020-10-27,Siskiyou,93,43540,215,181,10,191,0
2020-10-27,Solano,95,438530,7629,7298,41,7339,77
2020-10-27,Sonoma,97,501317,9824,9389,28,9417,140
2020-10-27,Stanislaus,99,539301,17839,17720,812,18532,408
2020-10-27,Sutter,101,95872,1898,1832,1,1833,12
2020-10-27,Tehama,103,63373,971,913,4,917,5
2020-10-27,Trinity,105,12862,48,28,5,33,0
2020-10-27,Tulare,107,460477,17970,17520,412,17932,296
2020-10-27,Tuolumne,109,53932,296,275,27,302,4
2020-10-27,Ventura,111,848112,14945,14347,337,14684,153
2020-10-27,Yolo,113,214977,3319,3216,9,3225,58
2020-10-27,Yuba,115,75493,1283,1235,6,1241,10
2020-10-26,Alameda,1,1643700,23823,23284,238,23522,398
2020-10-26,Alpine,3,1148,5,3,0,3,0
2020-10-26,Amador,5,37829,358,331,0,331,16
2020-10-26,Butte,7,227075,3210,3095,27,3122,56
2020-10-26,Calaveras,9,45235,339,274,1,275,13
2020-10-26,Colusa,11,21464,559,548,0,548,6
2020-10-26,Contra Costa,13,1133247,19258,18718,99,18817,245
2020-10-26,Del Norte,15,27424,180,171,0,171,2
2020-10-26,El Dorado,17,186661,1430,1336,3,1339,4
2020-10-26,Fresno,19,978130,33425,30969,465,31434,441
2020-10-26,Glenn,21,27897,689,660,1,661,3
2020-10-26,Humboldt,23,135768,571,554,0,554,7
2020-10-26,Imperial,25,180216,13044,12654,12,12666,333
2020-10-26,Inyo,27,18085,248,226,1,227,14
2020-10-26,Kern,29,883053,34092,33233,426,33659,432
2020-10-26,Kings,31,150075,8674,8264,58,8322,82
2020-10-26,Lake,33,64148,735,697,0,697,15
2020-10-26,Lassen,35,31185,777,764,1,765,0
2020-10-26,Los Angeles,37,10098052,304987,297961,3090,301051,6979
2020-10-26,Madera,39,155013,5071,4922,40,4962,53
2020-10-26,Marin,41,260295,7146,7064,18,7082,104
2020-10-26,Mariposa,43,17540,81,77,0,77,2
2020-10-26,Mendocino,45,87422,1076,1026,2,1028,20
2020-10-26,Merced,47,269075,9623,9375,37,9412,150
2020-10-26,Modoc,49,8938,44,28,0,28,0
2020-10-26,Mono,51,14174,216,167,4,171,1
2020-10-26,Monterey,53,433212,11560,11207,61,11268,87
2020-10-26,Napa,55,140530,2090,1966,5,1971,14
2020-10-26,Nevada,57,99092,657,618,16,634,8
2020-10-26,Orange,59,3164182,61077,58377,1806,60183,1442
2020-10-26,Placer,61,380077,4470,4161,16,4177,57
2020-10-26,Plumas,63,18699,84,63,0,63,0
2020-10-26,Riverside,65,2383286,68081,66475,391,66866,1294
2020-10-26,Sacramento,67,1510023,26055,25555,25,25580,496
2020-10-26,San Benito,69,59416,1443,1424,1,1425,15
2020-10-26,San Bernardino,71,2135413,64662,61871,150,62021,1153
2020-10-26,San Diego,73,3302833,57226,54957,0,54957,870
2020-10-26,San Francisco,75,870044,12449,12072,56,12128,138
2020-10-26,San Joaquin,77,732212,22098,21459,221,21680,495
2020-10-26,San Luis Obispo,79,281455,4328,4133,24,4157,31
2020-10-26,San Mateo,81,765935,11495,11037,8,11045,156
2020-10-26,Santa Barbara,83,443738,10340,9827,127,9954,122
2020-10-26,Santa Clara,85,1922200,25394,24258,36,24294,365
2020-10-26,Santa Cruz,87,273765,2918,2808,35,2843,24
2020-10-26,Shasta,89,179085,2303,1889,19,1908,29
2020-10-26,Sierra,91,2930,6,6,0,6,0
2020-10-26,Siskiyou,93,43540,207,179,10,189,0
2020-10-26,Solano,95,438530,7549,7271,41,7312,62
2020-10-26,Sonoma,97,501317,9745,9315,28,9343,140
2020-10-26,Stanislaus,99,539301,17789,17666,802,18468,400
2020-10-26,Sutter,101,95872,1890,1817,1,1818,12
2020-10-26,Tehama,103,63373,951,892,4,896,5
2020-10-26,Trinity,105,12862,48,26,5,31,0
2020-10-26,Tulare,107,460477,17893,17432,389,17821,296
2020-10-26,Tuolumne,109,53932,287,271,27,298,4
2020-10-26,Ventura,111,848112,14875,14330,334,14664,154
2020-10-26,Yolo,113,214977,3299,3206,9,3215,58
2020-10-26,Yuba,115,75493,1267,1226,6,1232,10
2020-10-25,Alameda,1,1643700,23717,23192,238,23430,398
2020-10-25,Alpine,3,1148,4,3,0,3,0
2020-10-25,Amador,5,37829,347,330,0,330,16
2020-10-25,Butte,7,227075,3191,3087,27,3114,56
2020-10-25,Calaveras,9,45235,338,274,1,275,13
2020-10-25,Colusa,11,21464,555,548,0,548,6
2020-10-25,Contra Costa,13,1133247,19157,18640,99,18739,245
2020-10-25,Del Norte,15,27424,176,171,0,171,2
2020-10-25,El Dorado,17,186661,1415,1328,3,1331,4
2020-10-25,Fresno,19,978130,33296,30858,456,31314,441
2020-10-25,Glenn,21,27897,686,652,1,653,3
2020-10-25,Humboldt,23,135768,568,554,0,554,7
2020-10-25,Imperial,25,180216,12994,12572,12,12584,333
2020-10-25,Inyo,27,18085,245,226,1,227,14
2020-10-25,Kern,29,883053,33985,33185,422,33607,432
2020-10-25,Kings,31,150075,8641,8246,56,8302,82
2020-10-25,Lake,33,64148,718,695,0,695,15
2020-10-25,Lassen,35,31185,774,764,1,765,0
2020-10-25,Los Angeles,37,10098052,303415,297110,3050,300160,6973
2020-10-25,Madera,39,155013,5041,4909,35,4944,53
2020-10-25,Marin,41,260295,7136,7052,18,7070,102
2020-10-25,Mariposa,43,17540,81,77,0,77,2
2020-10-25,Mendocino,45,87422,1069,1024,2,1026,20
2020-10-25,Merced,47,269075,9558,9352,35,9387,150
2020-10-25,Modoc,49,8938,39,28,0,28,0
2020-10-25,Mono,51,14174,208,167,4,171,1
2020-10-25,Monterey,53,433212,11477,11182,56,11238,87
2020-10-25,Napa,55,140530,2060,1962,5,1967,14
2020-10-25,Nevada,57,99092,649,616,16,632,8
2020-10-25,Orange,59,3164182,60788,58185,1796,59981,1443
2020-10-25,Placer,61,380077,4418,4140,16,4156,57
2020-10-25,Plumas,63,18699,84,63,0,63,0
2020-10-25,Riverside,65,2383286,67629,66192,375,66567,1289
2020-10-25,Sacramento,67,1510023,25840,25445,22,25467,496
2020-10-25,San Benito,69,59416,1436,1423,1,1424,15
2020-10-25,San Bernardino,71,2135413,64123,61551,142,61693,1153
2020-10-25,San Diego,73,3302833,56763,54599,0,54599,870
2020-10-25,San Francisco,75,870044,12376,12072,56,12128,137
2020-10-25,San Joaquin,77,732212,21991,21459,212,21671,495
2020-10-25,San Luis Obispo,79,281455,4286,4126,22,4148,31
2020-10-25,San Mateo,81,765935,11450,10987,8,10995,156
2020-10-25,Santa Barbara,83,443738,10320,9814,127,9941,122
2020-10-25,Santa Clara,85,1922200,25207,24087,36,24123,365
2020-10-25,Santa Cruz,87,273765,2891,2789,35,2824,24
2020-10-25,Shasta,89,179085,2240,1889,19,1908,29
2020-10-25,Sierra,91,2930,6,6,0,6,0
2020-10-25,Siskiyou,93,43540,204,176,10,186,0
2020-10-25,Solano,95,438530,7472,7197,41,7238,60
2020-10-25,Sonoma,97,501317,9651,9235,27,9262,140
2020-10-25,Stanislaus,99,539301,17732,17641,792,18433,400
2020-10-25,Sutter,101,95872,1872,1811,1,1812,12
2020-10-25,Tehama,103,63373,934,880,4,884,5
2020-10-25,Trinity,105,12862,45,26,5,31,0
2020-10-25,Tulare,107,460477,17821,17431,379,17810,296
2020-10-25,Tuolumne,109,53932,282,271,27,298,4
2020-10-25,Ventura,111,848112,14782,14300,328,14628,154
2020-10-25,Yolo,113,214977,3278,3190,9,3199,58
2020-10-25,Yuba,115,75493,1259,1219,6,1225,10
2020-10-24,Alameda,1,1643700,23646,23099,235,23334,398
2020-10-24,Alpine,3,1148,4,3,0,3,0
2020-10-24,Amador,5,37829,346,328,0,328,16
2020-10-24,Butte,7,227075,3182,3078,27,3105,56
2020-10-24,Calaveras,9,45235,336,274,1,275,13
2020-10-24,Colusa,11,21464,550,548,0,548,6
2020-10-24,Contra Costa,13,1133247,19090,18567,99,18666,244
2020-10-24,Del Norte,15,27424,175,171,0,171,2
2020-10-24,El Dorado,17,186661,1399,1317,3,1320,4
2020-10-24,Fresno,19,978130,33235,30752,452,31204,441
2020-10-24,Glenn,21,27897,683,650,1,651,3
2020-10-24,Humboldt,23,135768,566,553,0,553,7
2020-10-24,Imperial,25,180216,12967,12469,12,12481,333
2020-10-24,Inyo,27,18085,245,226,1,227,14
2020-10-24,Kern,29,883053,33926,33105,417,33522,432
2020-10-24,Kings,31,150075,8631,8228,55,8283,82
2020-10-24,Lake,33,64148,713,696,0,696,15
2020-10-24,Lassen,35,31185,773,764,1,765,0
2020-10-24,Los Angeles,37,10098052,302598,296323,3026,299349,6969
2020-10-24,Madera,39,155013,5028,4898,34,4932,53
2020-10-24,Marin,41,260295,7126,7042,18,7060,102
2020-10-24,Mariposa,43,17540,81,77,0,77,2
2020-10-24,Mendocino,45,87422,1057,1022,2,1024,20
2020-10-24,Merced,47,269075,9534,9351,35,9386,150
2020-10-24,Modoc,49,8938,38,28,0,28,0
2020-10-24,Mono,51,14174,194,167,4,171,1
2020-10-24,Monterey,53,433212,11410,11153,55,11208,87
2020-10-24,Napa,55,140530,2043,1957,5,1962,14
2020-10-24,Nevada,57,99092,645,608,16,624,8
2020-10-24,Orange,59,3164182,60635,57928,1785,59713,1441
2020-10-24,Placer,61,380077,4388,4093,16,4109,57
2020-10-24,Plumas,63,18699,78,63,0,63,0
2020-10-24,Riverside,65,2383286,67420,65902,361,66263,1288
2020-10-24,Sacramento,67,1510023,25759,25372,22,25394,496
2020-10-24,San Benito,69,59416,1431,1417,1,1418,15
2020-10-24,San Bernardino,71,2135413,63883,61351,134,61485,1153
2020-10-24,San Diego,73,3302833,56486,54330,0,54330,868
2020-10-24,San Francisco,75,870044,12318,12073,55,12128,137
2020-10-24,San Joaquin,77,732212,21940,21458,207,21665,495
2020-10-24,San Luis Obispo,79,281455,4261,4119,21,4140,31
2020-10-24,San Mateo,81,765935,11411,10942,8,10950,155
2020-10-24,Santa Barbara,83,443738,10303,9781,127,9908,122
2020-10-24,Santa Clara,85,1922200,25120,23978,36,24014,365
2020-10-24,Santa Cruz,87,273765,2872,2775,35,2810,24
2020-10-24,Shasta,89,179085,2195,1878,19,1897,29
2020-10-24,Sierra,91,2930,6,6,0,6,0
2020-10-24,Siskiyou,93,43540,203,174,10,184,0
2020-10-24,Solano,95,438530,7419,7189,41,7230,60
2020-10-24,Sonoma,97,501317,9617,9179,27,9206,140
2020-10-24,Stanislaus,99,539301,17689,17574,775,18349,400
2020-10-24,Sutter,101,95872,1863,1804,1,1805,12
2020-10-24,Tehama,103,63373,926,872,4,876,5
2020-10-24,Trinity,105,12862,45,25,5,30,0
2020-10-24,Tulare,107,460477,17799,17406,366,17772,295
2020-10-24,Tuolumne,109,53932,279,269,27,296,4
2020-10-24,Ventura,111,848112,14729,14240,327,14567,154
2020-10-24,Yolo,113,214977,3267,3164,9,3173,57
2020-10-24,Yuba,115,75493,1256,1210,6,1216,10
2020-10-23,Alameda,1,1643700,23574,23047,233,23280,393
2020-10-23,Alpine,3,1148,4,3,0,3,0
2020-10-23,Amador,5,37829,345,324,0,324,16
2020-10-23,Butte,7,227075,3173,3059,27,3086,55
2020-10-23,Calaveras,9,45235,335,273,1,274,13
2020-10-23,Colusa,11,21464,550,547,0,547,6
2020-10-23,Contra Costa,13,1133247,19019,18483,98,18581,244
2020-10-23,Del Norte,15,27424,175,171,0,171,2
2020-10-23,El Dorado,17,186661,1390,1310,3,1313,4
2020-10-23,Fresno,19,978130,33168,30590,448,31038,441
2020-10-23,Glenn,21,27897,680,644,1,645,3
2020-10-23,Humboldt,23,135768,564,553,0,553,7
2020-10-23,Imperial,25,180216,12936,12398,12,12410,333
2020-10-23,Inyo,27,18085,244,226,1,227,14
2020-10-23,Kern,29,883053,33858,33077,412,33489,431
2020-10-23,Kings,31,150075,8622,8218,55,8273,82
2020-10-23,Lake,33,64148,711,689,0,689,15
2020-10-23,Lassen,35,31185,772,764,1,765,0
2020-10-23,Los Angeles,37,10098052,301519,294287,2995,297282,6956
2020-10-23,Madera,39,155013,5023,4888,34,4922,53
2020-10-23,Marin,41,260295,7114,7029,18,7047,102
2020-10-23,Mariposa,43,17540,81,77,0,77,2
2020-10-23,Mendocino,45,87422,1054,1019,2,1021,20
2020-10-23,Merced,47,269075,9520,9327,35,9362,149
2020-10-23,Modoc,49,8938,38,28,0,28,0
2020-10-23,Mono,51,14174,193,159,4,163,1
2020-10-23,Monterey,53,433212,11363,11099,51,11150,86
2020-10-23,Napa,55,140530,2035,1942,5,1947,14
2020-10-23,Nevada,57,99092,642,604,16,620,8
2020-10-23,Orange,59,3164182,60464,57595,1770,59365,1430
2020-10-23,Placer,61,380077,4343,4073,16,4089,57
2020-10-23,Plumas,63,18699,75,63,0,63,0
2020-10-23,Riverside,65,2383286,67181,65512,353,65865,1279
2020-10-23,Sacramento,67,1510023,25651,25224,22,25246,496
2020-10-23,San Benito,69,59416,1429,1412,1,1413,15
2020-10-23,San Bernardino,71,2135413,63599,60854,124,60978,1150
2020-10-23,San Diego,73,3302833,56180,53944,0,53944,867
2020-10-23,San Francisco,75,870044,12287,12015,55,12070,137
2020-10-23,San Joaquin,77,732212,21884,21361,201,21562,495
2020-10-23,San Luis Obispo,79,281455,4235,4102,21,4123,31
2020-10-23,San Mateo,81,765935,11362,10872,8,10880,155
2020-10-23,Santa Barbara,83,443738,10287,9751,127,9878,121
2020-10-23,Santa Clara,85,1922200,25019,23822,36,23858,364
2020-10-23,Santa Cruz,87,273765,2858,2757,35,2792,24
2020-10-23,Shasta,89,179085,2158,1846,18,1864,29
2020-10-23,Sierra,91,2930,6,6,0,6,0
2020-10-23,Siskiyou,93,43540,200,172,10,182,0
2020-10-23,Solano,95,438530,7388,7174,41,7215,59
2020-10-23,Sonoma,97,501317,9561,9112,27,9139,139
2020-10-23,Stanislaus,99,539301,17652,17496,767,18263,395
2020-10-23,Sutter,101,95872,1856,1797,1,1798,12
2020-10-23,Tehama,103,63373,917,862,4,866,5
2020-10-23,Trinity,105,12862,45,26,5,31,0
2020-10-23,Tulare,107,460477,17754,17334,354,17688,295
2020-10-23,Tuolumne,109,53932,277,254,27,281,4
2020-10-23,Ventura,111,848112,14700,14192,327,14519,155
2020-10-23,Yolo,113,214977,3254,3140,9,3149,57
2020-10-23,Yuba,115,75493,1252,1206,6,1212,10
2020-10-22,Alameda,1,1643700,23473,22915,233,23148,393
2020-10-22,Alpine,3,1148,4,3,0,3,0
2020-10-22,Amador,5,37829,341,317,0,317,16
2020-10-22,Butte,7,227075,3163,3046,25,3071,55
2020-10-22,Calaveras,9,45235,332,273,1,274,13
2020-10-22,Colusa,11,21464,550,547,0,547,6
2020-10-22,Contra Costa,13,1133247,18947,18393,96,18489,243
2020-10-22,Del Norte,15,27424,174,168,0,168,2
2020-10-22,El Dorado,17,186661,1380,1308,3,1311,4
2020-10-22,Fresno,19,978130,33060,30471,440,30911,438
2020-10-22,Glenn,21,27897,673,643,1,644,3
2020-10-22,Humboldt,23,135768,563,548,0,548,7
2020-10-22,Imperial,25,180216,12883,12311,11,12322,333
2020-10-22,Inyo,27,18085,241,220,1,221,14
2020-10-22,Kern,29,883053,33778,32991,409,33400,431
2020-10-22,Kings,31,150075,8371,8201,55,8256,82
2020-10-22,Lake,33,64148,707,678,0,678,15
2020-10-22,Lassen,35,31185,769,764,1,765,0
2020-10-22,Los Angeles,37,10098052,300146,291599,2935,294534,6935
2020-10-22,Madera,39,155013,5002,4847,34,4881,52
2020-10-22,Marin,41,260295,7108,7014,18,7032,102
2020-10-22,Mariposa,43,17540,81,77,0,77,2
2020-10-22,Mendocino,45,87422,1049,1016,2,1018,20
2020-10-22,Merced,47,269075,9492,9323,35,9358,149
2020-10-22,Modoc,49,8938,34,26,0,26,0
2020-10-22,Mono,51,14174,188,156,4,160,1
2020-10-22,Monterey,53,433212,11304,11059,48,11107,84
2020-10-22,Napa,55,140530,2021,1928,5,1933,14
2020-10-22,Nevada,57,99092,636,600,16,616,8
2020-10-22,Orange,59,3164182,60250,57418,1753,59171,1422
2020-10-22,Placer,61,380077,4293,4036,16,4052,57
2020-10-22,Plumas,63,18699,72,62,0,62,0
2020-10-22,Riverside,65,2383286,66847,65104,334,65438,1279
2020-10-22,Sacramento,67,1510023,25514,25054,22,25076,492
2020-10-22,San Benito,69,59416,1425,1403,1,1404,15
2020-10-22,San Bernardino,71,2135413,63199,60402,111,60513,1149
2020-10-22,San Diego,73,3302833,55795,53514,0,53514,866
2020-10-22,San Francisco,75,870044,12229,11991,54,12045,137
2020-10-22,San Joaquin,77,732212,21810,21282,195,21477,495
2020-10-22,San Luis Obispo,79,281455,4219,4081,21,4102,31
2020-10-22,San Mateo,81,765935,11306,10796,8,10804,155
2020-10-22,Santa Barbara,83,443738,10253,9710,125,9835,120
2020-10-22,Santa Clara,85,1922200,24864,23621,36,23657,363
2020-10-22,Santa Cruz,87,273765,2840,2738,34,2772,24
2020-10-22,Shasta,89,179085,2112,1799,18,1817,29
2020-10-22,Sierra,91,2930,6,6,0,6,0
2020-10-22,Siskiyou,93,43540,200,169,10,179,0
2020-10-22,Solano,95,438530,7342,7116,41,7157,59
2020-10-22,Sonoma,97,501317,9495,9052,26,9078,139
2020-10-22,Stanislaus,99,539301,17599,17440,753,18193,395
2020-10-22,Sutter,101,95872,1842,1794,1,1795,12
2020-10-22,Tehama,103,63373,906,852,4,856,5
2020-10-22,Trinity,105,12862,44,26,5,31,0
2020-10-22,Tulare,107,460477,17688,17265,341,17606,293
2020-10-22,Tuolumne,109,53932,275,252,27,279,4
2020-10-22,Ventura,111,848112,14653,14124,325,14449,154
2020-10-22,Yolo,113,214977,3242,3116,9,3125,58
2020-10-22,Yuba,115,75493,1245,1199,6,1205,10
2020-10-21,Alameda,1,1643700,23386,22853,231,23084,392
2020-10-21,Alpine,3,1148,4,3,0,3,0
2020-10-21,Amador,5,37829,336,313,0,313,16
2020-10-21,Butte,7,227075,3151,3041,25,3066,55
2020-10-21,Calaveras,9,45235,331,272,1,273,13
2020-10-21,Colusa,11,21464,550,546,0,546,6
2020-10-21,Contra Costa,13,1133247,18873,18299,95,18394,243
2020-10-21,Del Norte,15,27424,174,169,0,169,2
2020-10-21,El Dorado,17,186661,1368,1305,2,1307,4
2020-10-21,Fresno,19,978130,32966,30328,438,30766,433
2020-10-21,Glenn,21,27897,668,640,1,641,3
2020-10-21,Humboldt,23,135768,562,548,0,548,7
2020-10-21,Imperial,25,180216,12826,12210,11,12221,331
2020-10-21,Inyo,27,18085,237,220,1,221,14
2020-10-21,Kern,29,883053,33704,32956,407,33363,430
2020-10-21,Kings,31,150075,8344,8186,55,8241,80
2020-10-21,Lake,33,64148,706,676,0,676,15
2020-10-21,Lassen,35,31185,768,764,1,765,0
2020-10-21,Los Angeles,37,10098052,298810,288096,2892,290988,6923
2020-10-21,Madera,39,155013,4977,4831,34,4865,52
2020-10-21,Marin,41,260295,7099,7002,18,7020,102
2020-10-21,Mariposa,43,17540,81,77,0,77,2
2020-10-21,Mendocino,45,87422,1047,1011,2,1013,21
2020-10-21,Merced,47,269075,9468,9319,33,9352,149
2020-10-21,Modoc,49,8938,33,26,0,26,0
2020-10-21,Mono,51,14174,186,156,4,160,1
2020-10-21,Monterey,53,433212,11266,11005,47,11052,83
2020-10-21,Napa,55,140530,2005,1918,5,1923,13
2020-10-21,Nevada,57,99092,630,597,16,613,8
2020-10-21,Orange,59,3164182,60039,57189,1742,58931,1409
2020-10-21,Placer,61,380077,4257,4007,16,4023,56
2020-10-21,Plumas,63,18699,69,58,0,58,0
2020-10-21,Riverside,65,2383286,66554,64778,308,65086,1278
2020-10-21,Sacramento,67,1510023,25322,24908,22,24930,490
2020-10-21,San Benito,69,59416,1424,1401,1,1402,14
2020-10-21,San Bernardino,71,2135413,62794,59948,104,60052,1141
2020-10-21,San Diego,73,3302833,55444,53279,0,53279,863
2020-10-21,San Francisco,75,870044,12180,11976,53,12029,137
2020-10-21,San Joaquin,77,732212,21734,21201,189,21390,495
2020-10-21,San Luis Obispo,79,281455,4205,4055,19,4074,31
2020-10-21,San Mateo,81,765935,11257,10730,8,10738,155
2020-10-21,Santa Barbara,83,443738,10235,9681,124,9805,121
2020-10-21,Santa Clara,85,1922200,24739,23537,36,23573,361
2020-10-21,Santa Cruz,87,273765,2817,2729,34,2763,24
2020-10-21,Shasta,89,179085,2075,1777,18,1795,27
2020-10-21,Sierra,91,2930,6,6,0,6,0
2020-10-21,Siskiyou,93,43540,196,169,10,179,0
2020-10-21,Solano,95,438530,7297,7088,41,7129,59
2020-10-21,Sonoma,97,501317,9415,8987,26,9013,138
2020-10-21,Stanislaus,99,539301,17550,17419,744,18163,392
2020-10-21,Sutter,101,95872,1827,1786,1,1787,12
2020-10-21,Tehama,103,63373,890,824,4,828,5
2020-10-21,Trinity,105,12862,41,25,5,30,0
2020-10-21,Tulare,107,460477,17652,17204,327,17531,292
2020-10-21,Tuolumne,109,53932,274,251,27,278,4
2020-10-21,Ventura,111,848112,14590,14050,322,14372,153
2020-10-21,Yolo,113,214977,3223,3095,9,3104,58
2020-10-21,Yuba,115,75493,1236,1194,6,1200,10
2020-10-20,Alameda,1,1643700,23283,22750,227,22977,391
2020-10-20,Alpine,3,1148,4,3,0,3,0
2020-10-20,Amador,5,37829,335,313,0,313,16
2020-10-20,Butte,7,227075,3139,3027,25,3052,56
2020-10-20,Calaveras,9,45235,330,273,1,274,13
2020-10-20,Colusa,11,21464,547,546,0,546,6
2020-10-20,Contra Costa,13,1133247,18781,18246,95,18341,241
2020-10-20,Del Norte,15,27424,173,169,0,169,2
2020-10-20,El Dorado,17,186661,1362,1295,2,1297,4
2020-10-20,Fresno,19,978130,32864,30220,432,30652,431
2020-10-20,Glenn,21,27897,663,638,1,639,3
2020-10-20,Humboldt,23,135768,558,545,0,545,7
2020-10-20,Imperial,25,180216,12757,12114,11,12125,330
2020-10-20,Inyo,27,18085,237,218,1,219,14
2020-10-20,Kern,29,883053,33629,32889,394,33283,429
2020-10-20,Kings,31,150075,8326,8178,54,8232,80
2020-10-20,Lake,33,64148,704,675,0,675,15
2020-10-20,Lassen,35,31185,767,757,1,758,0
2020-10-20,Los Angeles,37,10098052,297322,287727,2839,290566,6891
2020-10-20,Madera,39,155013,4960,4823,34,4857,52
2020-10-20,Marin,41,260295,7084,6994,18,7012,101
2020-10-20,Mariposa,43,17540,80,77,0,77,2
2020-10-20,Mendocino,45,87422,1045,1004,2,1006,21
2020-10-20,Merced,47,269075,9446,9323,33,9356,149
2020-10-20,Modoc,49,8938,32,26,0,26,0
2020-10-20,Mono,51,14174,186,156,4,160,1
2020-10-20,Monterey,53,433212,11223,10942,44,10986,81
2020-10-20,Napa,55,140530,1986,1912,5,1917,13
2020-10-20,Nevada,57,99092,621,596,16,612,8
2020-10-20,Orange,59,3164182,59778,56914,1733,58647,1397
2020-10-20,Placer,61,380077,4219,3997,16,4013,56
2020-10-20,Plumas,63,18699,66,53,0,53,0
2020-10-20,Riverside,65,2383286,66173,64452,296,64748,1275
2020-10-20,Sacramento,67,1510023,25197,24767,21,24788,485
2020-10-20,San Benito,69,59416,1421,1398,1,1399,14
2020-10-20,San Bernardino,71,2135413,62417,59571,99,59670,1109
2020-10-20,San Diego,73,3302833,55108,53004,0,53004,857
2020-10-20,San Francisco,75,870044,12133,12013,52,12065,126
2020-10-20,San Joaquin,77,732212,21656,21173,178,21351,490
2020-10-20,San Luis Obispo,79,281455,4187,4043,18,4061,31
2020-10-20,San Mateo,81,765935,11211,10659,8,10667,155
2020-10-20,Santa Barbara,83,443738,10206,9664,122,9786,121
2020-10-20,Santa Clara,85,1922200,24603,23406,36,23442,358
2020-10-20,Santa Cruz,87,273765,2794,2710,34,2744,23
2020-10-20,Shasta,89,179085,2052,1747,18,1765,20
2020-10-20,Sierra,91,2930,6,6,0,6,0
2020-10-20,Siskiyou,93,43540,188,168,10,178,0
2020-10-20,Solano,95,438530,7248,7044,41,7085,57
2020-10-20,Sonoma,97,501317,9352,8904,24,8928,135
2020-10-20,Stanislaus,99,539301,17496,17367,740,18107,393
2020-10-20,Sutter,101,95872,1818,1783,1,1784,12
2020-10-20,Tehama,103,63373,875,813,4,817,5
2020-10-20,Trinity,105,12862,40,25,5,30,0
2020-10-20,Tulare,107,460477,17586,17156,321,17477,289
2020-10-20,Tuolumne,109,53932,272,250,27,277,4
2020-10-20,Ventura,111,848112,14526,13980,320,14300,152
2020-10-20,Yolo,113,214977,3200,3083,9,3092,56
2020-10-20,Yuba,115,75493,1226,1191,6,1197,10
2020-10-19,Alameda,1,1643700,23174,22647,226,22873,392
2020-10-19,Alpine,3,1148,4,3,0,3,0
2020-10-19,Amador,5,37829,329,313,0,313,16
2020-10-19,Butte,7,227075,3128,3026,25,3051,55
2020-10-19,Calaveras,9,45235,329,268,1,269,13
2020-10-19,Colusa,11,21464,547,544,0,544,6
2020-10-19,Contra Costa,13,1133247,18683,18173,95,18268,239
2020-10-19,Del Norte,15,27424,170,167,0,167,2
2020-10-19,El Dorado,17,186661,1341,1287,2,1289,4
2020-10-19,Fresno,19,978130,32756,30152,427,30579,431
2020-10-19,Glenn,21,27897,658,635,0,635,3
2020-10-19,Humboldt,23,135768,558,543,0,543,7
2020-10-19,Imperial,25,180216,12703,12036,10,12046,330
2020-10-19,Inyo,27,18085,236,218,1,219,14
2020-10-19,Kern,29,883053,33554,32840,391,33231,428
2020-10-19,Kings,31,150075,8308,8173,54,8227,80
2020-10-19,Lake,33,64148,701,673,0,673,15
2020-10-19,Lassen,35,31185,766,757,1,758,0
2020-10-19,Los Angeles,37,10098052,295840,287119,2799,289918,6858
2020-10-19,Madera,39,155013,4945,4787,34,4821,52
2020-10-19,Marin,41,260295,7066,6981,18,6999,100
2020-10-19,Mariposa,43,17540,80,77,0,77,2
2020-10-19,Mendocino,45,87422,1040,1001,2,1003,21
2020-10-19,Merced,47,269075,9422,9305,28,9333,148
2020-10-19,Modoc,49,8938,31,26,0,26,0
2020-10-19,Mono,51,14174,181,156,4,160,1
2020-10-19,Monterey,53,433212,11162,10907,44,10951,80
2020-10-19,Napa,55,140530,1972,1892,5,1897,12
2020-10-19,Nevada,57,99092,618,590,16,606,8
2020-10-19,Orange,59,3164182,59492,56652,1719,58371,1396
2020-10-19,Placer,61,380077,4171,3962,16,3978,49
2020-10-19,Plumas,63,18699,64,52,0,52,0
2020-10-19,Riverside,65,2383286,65745,64016,279,64295,1272
2020-10-19,Sacramento,67,1510023,25058,24542,21,24563,483
2020-10-19,San Benito,69,59416,1414,1395,1,1396,14
2020-10-19,San Bernardino,71,2135413,61968,59265,91,59356,1100
2020-10-19,San Diego,73,3302833,54722,52739,0,52739,853
2020-10-19,San Francisco,75,870044,12089,11879,52,11931,126
2020-10-19,San Joaquin,77,732212,21581,20930,170,21100,489
2020-10-19,San Luis Obispo,79,281455,4171,4016,18,4034,31
2020-10-19,San Mateo,81,765935,11164,10568,8,10576,154
2020-10-19,Santa Barbara,83,443738,10171,9632,122,9754,121
2020-10-19,Santa Clara,85,1922200,24452,23301,36,23337,352
2020-10-19,Santa Cruz,87,273765,2777,2705,34,2739,19
2020-10-19,Shasta,89,179085,2008,1709,17,1726,20
2020-10-19,Sierra,91,2930,6,6,0,6,0
2020-10-19,Siskiyou,93,43540,181,167,10,177,0
2020-10-19,Solano,95,438530,7207,7003,41,7044,57
2020-10-19,Sonoma,97,501317,9265,8830,24,8854,135
2020-10-19,Stanislaus,99,539301,17445,17342,730,18072,390
2020-10-19,Sutter,101,95872,1813,1773,1,1774,12
2020-10-19,Tehama,103,63373,872,793,4,797,5
2020-10-19,Trinity,105,12862,38,23,5,28,0
2020-10-19,Tulare,107,460477,17538,17047,313,17360,291
2020-10-19,Tuolumne,109,53932,270,247,27,274,4
2020-10-19,Ventura,111,848112,14460,13930,317,14247,152
2020-10-19,Yolo,113,214977,3187,3069,9,3078,56
2020-10-19,Yuba,115,75493,1219,1183,6,1189,10
2020-10-18,Alameda,1,1643700,23070,22546,225,22771,392
2020-10-18,Alpine,3,1148,4,3,0,3,0
2020-10-18,Amador,5,37829,317,313,0,313,16
2020-10-18,Butte,7,227075,3115,3019,25,3044,55
2020-10-18,Calaveras,9,45235,328,267,1,268,13
2020-10-18,Colusa,11,21464,545,544,0,544,6
2020-10-18,Contra Costa,13,1133247,18584,18120,95,18215,237
2020-10-18,Del Norte,15,27424,170,167,0,167,2
2020-10-18,El Dorado,17,186661,1332,1283,2,1285,4
2020-10-18,Fresno,19,978130,32632,30051,419,30470,430
2020-10-18,Glenn,21,27897,656,634,0,634,3
2020-10-18,Humboldt,23,135768,555,540,0,540,7
2020-10-18,Imperial,25,180216,12641,11987,9,11996,330
2020-10-18,Inyo,27,18085,233,215,1,216,14
2020-10-18,Kern,29,883053,33481,32799,384,33183,428
2020-10-18,Kings,31,150075,8293,8159,54,8213,80
2020-10-18,Lake,33,64148,694,670,0,670,15
2020-10-18,Lassen,35,31185,766,757,1,758,0
2020-10-18,Los Angeles,37,10098052,294138,286187,2750,288937,6857
2020-10-18,Madera,39,155013,4920,4770,33,4803,52
2020-10-18,Marin,41,260295,7045,6969,18,6987,99
2020-10-18,Mariposa,43,17540,80,77,0,77,2
2020-10-18,Mendocino,45,87422,1038,988,2,990,21
2020-10-18,Merced,47,269075,9387,9292,28,9320,148
2020-10-18,Modoc,49,8938,30,26,0,26,0
2020-10-18,Mono,51,14174,176,155,4,159,1
2020-10-18,Monterey,53,433212,11110,10872,44,10916,80
2020-10-18,Napa,55,140530,1959,1882,5,1887,12
2020-10-18,Nevada,57,99092,612,582,16,598,8
2020-10-18,Orange,59,3164182,59193,56394,1703,58097,1396
2020-10-18,Placer,61,380077,4123,3938,16,3954,49
2020-10-18,Plumas,63,18699,62,52,0,52,0
2020-10-18,Riverside,65,2383286,65435,63765,256,64021,1270
2020-10-18,Sacramento,67,1510023,24904,24425,21,24446,482
2020-10-18,San Benito,69,59416,1407,1395,1,1396,14
2020-10-18,San Bernardino,71,2135413,61468,58893,83,58976,1098
2020-10-18,San Diego,73,3302833,54333,52359,0,52359,853
2020-10-18,San Francisco,75,870044,12050,11878,52,11930,126
2020-10-18,San Joaquin,77,732212,21499,20931,157,21088,489
2020-10-18,San Luis Obispo,79,281455,4140,4009,16,4025,31
2020-10-18,San Mateo,81,765935,11106,10503,8,10511,154
2020-10-18,Santa Barbara,83,443738,10132,9608,121,9729,121
2020-10-18,Santa Clara,85,1922200,24278,23169,36,23205,352
2020-10-18,Santa Cruz,87,273765,2763,2692,34,2726,19
2020-10-18,Shasta,89,179085,1983,1708,17,1725,20
2020-10-18,Sierra,91,2930,6,6,0,6,0
2020-10-18,Siskiyou,93,43540,180,167,10,177,0
2020-10-18,Solano,95,438530,7160,6962,41,7003,57
2020-10-18,Sonoma,97,501317,9189,8781,22,8803,134
2020-10-18,Stanislaus,99,539301,17389,17290,721,18011,390
2020-10-18,Sutter,101,95872,1804,1764,1,1765,12
2020-10-18,Tehama,103,63373,840,774,4,778,5
2020-10-18,Trinity,105,12862,38,20,5,25,0
2020-10-18,Tulare,107,460477,17446,17048,303,17351,290
2020-10-18,Tuolumne,109,53932,265,245,27,272,4
2020-10-18,Ventura,111,848112,14381,13901,316,14217,151
2020-10-18,Yolo,113,214977,3148,3059,9,3068,55
2020-10-18,Yuba,115,75493,1208,1176,6,1182,10
2020-10-17,Alameda,1,1643700,23025,22394,223,22617,398
2020-10-17,Alpine,3,1148,4,3,0,3,0
2020-10-17,Amador,5,37829,315,309,0,309,16
2020-10-17,Butte,7,227075,3107,3012,23,3035,55
2020-10-17,Calaveras,9,45235,328,267,1,268,13
2020-10-17,Colusa,11,21464,544,544,0,544,6
2020-10-17,Contra Costa,13,1133247,18531,18005,95,18100,237
2020-10-17,Del Norte,15,27424,170,167,0,167,2
2020-10-17,El Dorado,17,186661,1328,1277,2,1279,4
2020-10-17,Fresno,19,978130,32578,29911,417,30328,430
2020-10-17,Glenn,21,27897,653,633,0,633,3
2020-10-17,Humboldt,23,135768,552,535,0,535,7
2020-10-17,Imperial,25,180216,12613,11962,9,11971,330
2020-10-17,Inyo,27,18085,228,212,1,213,14
2020-10-17,Kern,29,883053,33430,32710,381,33091,428
2020-10-17,Kings,31,150075,8287,8151,53,8204,80
2020-10-17,Lake,33,64148,691,663,0,663,15
2020-10-17,Lassen,35,31185,766,757,1,758,0
2020-10-17,Los Angeles,37,10098052,293387,285858,2722,288580,6844
2020-10-17,Madera,39,155013,4914,4759,33,4792,53
2020-10-17,Marin,41,260295,7042,6958,18,6976,99
2020-10-17,Mariposa,43,17540,79,77,0,77,2
2020-10-17,Mendocino,45,87422,1031,977,2,979,21
2020-10-17,Merced,47,269075,9373,9275,28,9303,148
2020-10-17,Modoc,49,8938,30,26,0,26,0
2020-10-17,Mono,51,14174,175,155,4,159,1
2020-10-17,Monterey,53,433212,11070,10807,43,10850,80
2020-10-17,Napa,55,140530,1952,1866,5,1871,12
2020-10-17,Nevada,57,99092,611,580,16,596,8
2020-10-17,Orange,59,3164182,59053,56197,1694,57891,1396
2020-10-17,Placer,61,380077,4096,3898,16,3914,49
2020-10-17,Plumas,63,18699,62,52,0,52,0
2020-10-17,Riverside,65,2383286,65238,63171,245,63416,1270
2020-10-17,Sacramento,67,1510023,24819,24304,21,24325,482
2020-10-17,San Benito,69,59416,1403,1389,1,1390,14
2020-10-17,San Bernardino,71,2135413,61198,58415,79,58494,1097
2020-10-17,San Diego,73,3302833,54108,51986,0,51986,853
2020-10-17,San Francisco,75,870044,12022,11877,51,11928,126
2020-10-17,San Joaquin,77,732212,21445,20932,151,21083,489
2020-10-17,San Luis Obispo,79,281455,4125,3979,16,3995,31
2020-10-17,San Mateo,81,765935,11078,10423,8,10431,153
2020-10-17,Santa Barbara,83,443738,10113,9588,119,9707,121
2020-10-17,Santa Clara,85,1922200,24189,22997,36,23033,349
2020-10-17,Santa Cruz,87,273765,2749,2680,34,2714,19
2020-10-17,Shasta,89,179085,1957,1679,17,1696,20
2020-10-17,Sierra,91,2930,6,6,0,6,0
2020-10-17,Siskiyou,93,43540,179,167,10,177,0
2020-10-17,Solano,95,438530,7134,6929,41,6970,57
2020-10-17,Sonoma,97,501317,9146,8725,22,8747,134
2020-10-17,Stanislaus,99,539301,17350,17232,711,17943,390
2020-10-17,Sutter,101,95872,1802,1762,1,1763,12
2020-10-17,Tehama,103,63373,824,764,4,768,5
2020-10-17,Trinity,105,12862,38,20,5,25,0
2020-10-17,Tulare,107,460477,17416,16995,294,17289,290
2020-10-17,Tuolumne,109,53932,265,241,27,268,4
2020-10-17,Ventura,111,848112,14336,13845,313,14158,151
2020-10-17,Yolo,113,214977,3133,3045,7,3052,55
2020-10-17,Yuba,115,75493,1203,1164,6,1170,10
2020-10-16,Alameda,1,1643700,22971,22315,223,22538,397
2020-10-16,Alpine,3,1148,4,3,0,3,0
2020-10-16,Amador,5,37829,315,309,0,309,16
2020-10-16,Butte,7,227075,3096,3004,23,3027,54
2020-10-16,Calaveras,9,45235,328,267,1,268,13
2020-10-16,Colusa,11,21464,543,544,0,544,6
2020-10-16,Contra Costa,13,1133247,18478,17956,95,18051,237
2020-10-16,Del Norte,15,27424,170,166,0,166,2
2020-10-16,El Dorado,17,186661,1322,1273,2,1275,4
2020-10-16,Fresno,19,978130,32503,29796,415,30211,427
2020-10-16,Glenn,21,27897,648,632,0,632,3
2020-10-16,Humboldt,23,135768,552,533,0,533,7
2020-10-16,Imperial,25,180216,12573,11885,9,11894,330
2020-10-16,Inyo,27,18085,224,212,1,213,14
2020-10-16,Kern,29,883053,33387,32660,379,33039,428
2020-10-16,Kings,31,150075,8278,8146,52,8198,80
2020-10-16,Lake,33,64148,689,644,0,644,14
2020-10-16,Lassen,35,31185,766,757,1,758,0
2020-10-16,Los Angeles,37,10098052,292328,284988,2699,287687,6835
2020-10-16,Madera,39,155013,4902,4736,32,4768,53
2020-10-16,Marin,41,260295,7032,6933,18,6951,99
2020-10-16,Mariposa,43,17540,79,76,0,76,2
2020-10-16,Mendocino,45,87422,1024,974,2,976,21
2020-10-16,Merced,47,269075,9356,9246,28,9274,148
2020-10-16,Modoc,49,8938,30,26,0,26,0
2020-10-16,Mono,51,14174,173,155,4,159,1
2020-10-16,Monterey,53,433212,11036,10727,43,10770,79
2020-10-16,Napa,55,140530,1943,1855,5,1860,12
2020-10-16,Nevada,57,99092,609,579,16,595,8
2020-10-16,Orange,59,3164182,58877,56091,1687,57778,1388
2020-10-16,Placer,61,380077,4076,3864,16,3880,49
2020-10-16,Plumas,63,18699,61,52,0,52,0
2020-10-16,Riverside,65,2383286,65013,62986,244,63230,1267
2020-10-16,Sacramento,67,1510023,24725,24144,21,24165,479
2020-10-16,San Benito,69,59416,1400,1388,1,1389,14
2020-10-16,San Bernardino,71,2135413,60930,58233,79,58312,1069
2020-10-16,San Diego,73,3302833,53867,51785,0,51785,850
2020-10-16,San Francisco,75,870044,12000,11840,50,11890,126
2020-10-16,San Joaquin,77,732212,21400,20910,150,21060,489
2020-10-16,San Luis Obispo,79,281455,4111,3952,16,3968,32
2020-10-16,San Mateo,81,765935,11052,10405,8,10413,153
2020-10-16,Santa Barbara,83,443738,10095,9549,119,9668,119
2020-10-16,Santa Clara,85,1922200,24104,22920,36,22956,345
2020-10-16,Santa Cruz,87,273765,2736,2666,34,2700,20
2020-10-16,Shasta,89,179085,1935,1660,17,1677,20
2020-10-16,Sierra,91,2930,6,6,0,6,0
2020-10-16,Siskiyou,93,43540,177,167,10,177,0
2020-10-16,Solano,95,438530,7111,6879,41,6920,55
2020-10-16,Sonoma,97,501317,9090,8652,22,8674,133
2020-10-16,Stanislaus,99,539301,17317,17201,702,17903,366
2020-10-16,Sutter,101,95872,1794,1756,1,1757,12
2020-10-16,Tehama,103,63373,823,737,4,741,3
2020-10-16,Trinity,105,12862,38,20,5,25,0
2020-10-16,Tulare,107,460477,17384,16965,286,17251,290
2020-10-16,Tuolumne,109,53932,262,237,27,264,4
2020-10-16,Ventura,111,848112,14293,13805,308,14113,152
2020-10-16,Yolo,113,214977,3124,3030,7,3037,55
2020-10-16,Yuba,115,75493,1203,1155,6,1161,10
2020-10-15,Alameda,1,1643700,22904,22267,222,22489,390
2020-10-15,Alpine,3,1148,4,3,0,3,0
2020-10-15,Amador,5,37829,315,309,0,309,16
2020-10-15,Butte,7,227075,3084,3000,22,3022,54
2020-10-15,Calaveras,9,45235,327,267,1,268,13
2020-10-15,Colusa,11,21464,542,543,0,543,6
2020-10-15,Contra Costa,13,1133247,18411,17893,94,17987,237
2020-10-15,Del Norte,15,27424,170,164,0,164,2
2020-10-15,El Dorado,17,186661,1317,1265,2,1267,4
2020-10-15,Fresno,19,978130,32410,29727,413,30140,425
2020-10-15,Glenn,21,27897,643,632,0,632,3
2020-10-15,Humboldt,23,135768,548,531,0,531,7
2020-10-15,Imperial,25,180216,12532,11820,8,11828,330
2020-10-15,Inyo,27,18085,224,210,1,211,14
2020-10-15,Kern,29,883053,33308,32593,376,32969,427
2020-10-15,Kings,31,150075,8263,8134,52,8186,80
2020-10-15,Lake,33,64148,687,642,0,642,14
2020-10-15,Lassen,35,31185,765,752,1,753,0
2020-10-15,Los Angeles,37,10098052,291052,284019,2659,286678,6807
2020-10-15,Madera,39,155013,4890,4723,31,4754,50
2020-10-15,Marin,41,260295,7024,6912,18,6930,99
2020-10-15,Mariposa,43,17540,79,76,0,76,2
2020-10-15,Mendocino,45,87422,1019,963,2,965,21
2020-10-15,Merced,47,269075,9329,9213,28,9241,147
2020-10-15,Modoc,49,8938,30,26,0,26,0
2020-10-15,Mono,51,14174,173,155,4,159,1
2020-10-15,Monterey,53,433212,10969,10677,42,10719,79
2020-10-15,Napa,55,140530,1930,1842,5,1847,12
2020-10-15,Nevada,57,99092,605,575,16,591,8
2020-10-15,Orange,59,3164182,58662,55952,1674,57626,1379
2020-10-15,Placer,61,380077,4048,3848,16,3864,48
2020-10-15,Plumas,63,18699,58,52,0,52,0
2020-10-15,Riverside,65,2383286,64682,62819,241,63060,1266
2020-10-15,Sacramento,67,1510023,24606,24068,21,24089,474
2020-10-15,San Benito,69,59416,1397,1384,1,1385,14
2020-10-15,San Bernardino,71,2135413,60593,58068,78,58146,1067
2020-10-15,San Diego,73,3302833,53583,51472,0,51472,847
2020-10-15,San Francisco,75,870044,11972,11808,47,11855,126
2020-10-15,San Joaquin,77,732212,21327,20880,144,21024,487
2020-10-15,San Luis Obispo,79,281455,4096,3934,16,3950,32
2020-10-15,San Mateo,81,765935,11012,10340,8,10348,152
2020-10-15,Santa Barbara,83,443738,10071,9526,118,9644,117
2020-10-15,Santa Clara,85,1922200,23987,22808,36,22844,343
2020-10-15,Santa Cruz,87,273765,2722,2656,34,2690,13
2020-10-15,Shasta,89,179085,1924,1635,17,1652,20
2020-10-15,Sierra,91,2930,6,6,0,6,0
2020-10-15,Siskiyou,93,43540,174,166,10,176,0
2020-10-15,Solano,95,438530,7072,6830,41,6871,55
2020-10-15,Sonoma,97,501317,8998,8571,22,8593,133
2020-10-15,Stanislaus,99,539301,17279,17151,688,17839,366
2020-10-15,Sutter,101,95872,1791,1752,1,1753,12
2020-10-15,Tehama,103,63373,796,726,4,730,3
2020-10-15,Trinity,105,12862,38,20,5,25,0
2020-10-15,Tulare,107,460477,17324,16918,270,17188,289
2020-10-15,Tuolumne,109,53932,260,236,27,263,4
2020-10-15,Ventura,111,848112,14237,13750,303,14053,152
2020-10-15,Yolo,113,214977,3104,3014,7,3021,55
2020-10-15,Yuba,115,75493,1196,1151,6,1157,10
2020-10-14,Alameda,1,1643700,22808,22227,221,22448,398
2020-10-14,Alpine,3,1148,4,3,0,3,0
2020-10-14,Amador,5,37829,313,308,0,308,16
2020-10-14,Butte,7,227075,3076,2995,22,3017,54
2020-10-14,Calaveras,9,45235,327,266,1,267,12
2020-10-14,Colusa,11,21464,542,543,0,543,6
2020-10-14,Contra Costa,13,1133247,18354,17820,92,17912,236
2020-10-14,Del Norte,15,27424,169,163,0,163,2
2020-10-14,El Dorado,17,186661,1311,1264,2,1266,4
2020-10-14,Fresno,19,978130,32298,29650,408,30058,424
2020-10-14,Glenn,21,27897,642,629,0,629,3
2020-10-14,Humboldt,23,135768,545,531,0,531,7
2020-10-14,Imperial,25,180216,12495,11765,7,11772,330
2020-10-14,Inyo,27,18085,223,209,1,210,14
2020-10-14,Kern,29,883053,33234,32528,373,32901,425
2020-10-14,Kings,31,150075,8246,8118,51,8169,80
2020-10-14,Lake,33,64148,686,642,0,642,14
2020-10-14,Lassen,35,31185,763,752,1,753,0
2020-10-14,Los Angeles,37,10098052,289741,282918,2612,285530,6786
2020-10-14,Madera,39,155013,4875,4713,30,4743,50
2020-10-14,Marin,41,260295,7018,6907,18,6925,99
2020-10-14,Mariposa,43,17540,78,76,0,76,2
2020-10-14,Mendocino,45,87422,1013,955,2,957,21
2020-10-14,Merced,47,269075,9305,9201,26,9227,147
2020-10-14,Modoc,49,8938,30,27,0,27,0
2020-10-14,Mono,51,14174,173,155,4,159,1
2020-10-14,Monterey,53,433212,10918,10616,42,10658,78
2020-10-14,Napa,55,140530,1913,1837,5,1842,12
2020-10-14,Nevada,57,99092,603,573,16,589,7
2020-10-14,Orange,59,3164182,58451,55756,1663,57419,1348
2020-10-14,Placer,61,380077,4025,3829,16,3845,48
2020-10-14,Plumas,63,18699,54,52,0,52,0
2020-10-14,Riverside,65,2383286,64399,62607,239,62846,1261
2020-10-14,Sacramento,67,1510023,24464,24013,21,24034,472
2020-10-14,San Benito,69,59416,1395,1381,0,1381,14
2020-10-14,San Bernardino,71,2135413,60268,57774,76,57850,1063
2020-10-14,San Diego,73,3302833,53265,51329,0,51329,844
2020-10-14,San Francisco,75,870044,11940,11783,46,11829,123
2020-10-14,San Joaquin,77,732212,21248,20845,130,20975,487
2020-10-14,San Luis Obispo,79,281455,4073,3901,15,3916,32
2020-10-14,San Mateo,81,765935,10961,10309,8,10317,132
2020-10-14,Santa Barbara,83,443738,10036,9509,118,9627,117
2020-10-14,Santa Clara,85,1922200,23839,22735,36,22771,343
2020-10-14,Santa Cruz,87,273765,2712,2618,34,2652,13
2020-10-14,Shasta,89,179085,1886,1553,17,1570,20
2020-10-14,Sierra,91,2930,6,6,0,6,0
2020-10-14,Siskiyou,93,43540,174,166,10,176,0
2020-10-14,Solano,95,438530,7016,6786,41,6827,55
2020-10-14,Sonoma,97,501317,8945,8514,22,8536,133
2020-10-14,Stanislaus,99,539301,17234,17105,685,17790,365
2020-10-14,Sutter,101,95872,1782,1747,1,1748,12
2020-10-14,Tehama,103,63373,785,721,4,725,3
2020-10-14,Trinity,105,12862,37,20,5,25,0
2020-10-14,Tulare,107,460477,17262,16863,257,17120,287
2020-10-14,Tuolumne,109,53932,259,236,27,263,4
2020-10-14,Ventura,111,848112,14184,13697,299,13996,152
2020-10-14,Yolo,113,214977,3086,3007,7,3014,55
2020-10-14,Yuba,115,75493,1188,1147,6,1153,10
2020-10-13,Alameda,1,1643700,22704,22185,219,22404,389
2020-10-13,Alpine,3,1148,4,3,0,3,0
2020-10-13,Amador,5,37829,311,306,0,306,16
2020-10-13,Butte,7,227075,3067,2992,22,3014,54
2020-10-13,Calaveras,9,45235,323,262,1,263,12
2020-10-13,Colusa,11,21464,542,541,0,541,6
2020-10-13,Contra Costa,13,1133247,18296,17783,92,17875,234
2020-10-13,Del Norte,15,27424,169,163,0,163,2
2020-10-13,El Dorado,17,186661,1302,1262,2,1264,4
2020-10-13,Fresno,19,978130,32178,29579,404,29983,424
2020-10-13,Glenn,21,27897,641,629,0,629,3
2020-10-13,Humboldt,23,135768,543,523,0,523,7
2020-10-13,Imperial,25,180216,12460,11727,7,11734,327
2020-10-13,Inyo,27,18085,220,207,1,208,14
2020-10-13,Kern,29,883053,33159,32497,371,32868,419
2020-10-13,Kings,31,150075,8237,8111,51,8162,80
2020-10-13,Lake,33,64148,683,639,0,639,12
2020-10-13,Lassen,35,31185,761,752,1,753,0
2020-10-13,Los Angeles,37,10098052,288468,281716,2569,284285,6767
2020-10-13,Madera,39,155013,4857,4700,30,4730,50
2020-10-13,Marin,41,260295,6996,6900,18,6918,97
2020-10-13,Mariposa,43,17540,78,76,0,76,2
2020-10-13,Mendocino,45,87422,1004,950,2,952,21
2020-10-13,Merced,47,269075,9287,9181,26,9207,146
2020-10-13,Modoc,49,8938,29,28,0,28,0
2020-10-13,Mono,51,14174,173,155,3,158,1
2020-10-13,Monterey,53,433212,10857,10574,41,10615,78
2020-10-13,Napa,55,140530,1904,1825,5,1830,12
2020-10-13,Nevada,57,99092,597,572,16,588,7
2020-10-13,Orange,59,3164182,58240,55515,1649,57164,1326
2020-10-13,Placer,61,380077,3988,3825,16,3841,48
2020-10-13,Plumas,63,18699,52,51,0,51,0
2020-10-13,Riverside,65,2383286,64081,62279,237,62516,1254
2020-10-13,Sacramento,67,1510023,24386,23930,21,23951,466
2020-10-13,San Benito,69,59416,1387,1380,0,1380,14
2020-10-13,San Bernardino,71,2135413,59930,57411,75,57486,1061
2020-10-13,San Diego,73,3302833,52973,51026,0,51026,840
2020-10-13,San Francisco,75,870044,11904,11659,46,11705,122
2020-10-13,San Joaquin,77,732212,21186,20822,126,20948,481
2020-10-13,San Luis Obispo,79,281455,4062,3892,14,3906,32
2020-10-13,San Mateo,81,765935,10918,10286,8,10294,130
2020-10-13,Santa Barbara,83,443738,10005,9489,118,9607,117
2020-10-13,Santa Clara,85,1922200,23713,22678,36,22714,343
2020-10-13,Santa Cruz,87,273765,2694,2603,34,2637,13
2020-10-13,Shasta,89,179085,1862,1606,17,1623,20
2020-10-13,Sierra,91,2930,6,6,0,6,0
2020-10-13,Siskiyou,93,43540,173,163,10,173,0
2020-10-13,Solano,95,438530,6981,6761,41,6802,55
2020-10-13,Sonoma,97,501317,8862,8456,22,8478,133
2020-10-13,Stanislaus,99,539301,17189,17082,680,17762,362
2020-10-13,Sutter,101,95872,1773,1748,1,1749,12
2020-10-13,Tehama,103,63373,777,717,4,721,3
2020-10-13,Trinity,105,12862,33,19,5,24,0
2020-10-13,Tulare,107,460477,17204,16822,249,17071,286
2020-10-13,Tuolumne,109,53932,257,235,27,262,4
2020-10-13,Ventura,111,848112,14131,13645,294,13939,151
2020-10-13,Yolo,113,214977,3078,2983,6,2989,55
2020-10-13,Yuba,115,75493,1183,1143,6,1149,10
2020-10-12,Alameda,1,1643700,22626,22126,218,22344,389
2020-10-12,Alpine,3,1148,4,3,0,3,0
2020-10-12,Amador,5,37829,310,305,0,305,16
2020-10-12,Butte,7,227075,3061,2975,22,2997,54
2020-10-12,Calaveras,9,45235,323,262,1,263,12
2020-10-12,Colusa,11,21464,542,541,0,541,6
2020-10-12,Contra Costa,13,1133247,18221,17728,92,17820,233
2020-10-12,Del Norte,15,27424,169,161,0,161,2
2020-10-12,El Dorado,17,186661,1299,1254,2,1256,4
2020-10-12,Fresno,19,978130,32045,29523,400,29923,421
2020-10-12,Glenn,21,27897,640,626,0,626,3
2020-10-12,Humboldt,23,135768,540,522,0,522,7
2020-10-12,Imperial,25,180216,12421,11689,7,11696,328
2020-10-12,Inyo,27,18085,217,201,1,202,14
2020-10-12,Kern,29,883053,33066,32425,368,32793,419
2020-10-12,Kings,31,150075,8231,8106,50,8156,80
2020-10-12,Lake,33,64148,677,633,0,633,12
2020-10-12,Lassen,35,31185,761,752,1,753,0
2020-10-12,Los Angeles,37,10098052,287255,280961,2538,283499,6747
2020-10-12,Madera,39,155013,4838,4689,30,4719,50
2020-10-12,Marin,41,260295,6979,6886,18,6904,97
2020-10-12,Mariposa,43,17540,78,76,0,76,2
2020-10-12,Mendocino,45,87422,999,947,2,949,21
2020-10-12,Merced,47,269075,9266,9141,26,9167,146
2020-10-12,Modoc,49,8938,29,27,0,27,0
2020-10-12,Mono,51,14174,173,154,3,157,1
2020-10-12,Monterey,53,433212,10791,10473,41,10514,77
2020-10-12,Napa,55,140530,1896,1819,5,1824,11
2020-10-12,Nevada,57,99092,593,570,16,586,7
2020-10-12,Orange,59,3164182,58011,55373,1639,57012,1326
2020-10-12,Placer,61,380077,3955,3808,15,3823,48
2020-10-12,Plumas,63,18699,52,51,0,51,0
2020-10-12,Riverside,65,2383286,63769,62279,233,62512,1254
2020-10-12,Sacramento,67,1510023,24280,23807,21,23828,466
2020-10-12,San Benito,69,59416,1384,1376,0,1376,13
2020-10-12,San Bernardino,71,2135413,59560,57235,75,57310,1061
2020-10-12,San Diego,73,3302833,52683,50748,0,50748,826
2020-10-12,San Francisco,75,870044,11871,11659,46,11705,122
2020-10-12,San Joaquin,77,732212,21123,20701,120,20821,480
2020-10-12,San Luis Obispo,79,281455,4038,3874,14,3888,32
2020-10-12,San Mateo,81,765935,10870,10262,8,10270,130
2020-10-12,Santa Barbara,83,443738,9969,9462,118,9580,117
2020-10-12,Santa Clara,85,1922200,23599,22578,36,22614,343
2020-10-12,Santa Cruz,87,273765,2677,2590,34,2624,13
2020-10-12,Shasta,89,179085,1837,1515,17,1532,20
2020-10-12,Sierra,91,2930,6,6,0,6,0
2020-10-12,Siskiyou,93,43540,172,162,10,172,0
2020-10-12,Solano,95,438530,6942,6742,41,6783,55
2020-10-12,Sonoma,97,501317,8791,8377,22,8399,133
2020-10-12,Stanislaus,99,539301,17140,17051,671,17722,361
2020-10-12,Sutter,101,95872,1765,1741,1,1742,12
2020-10-12,Tehama,103,63373,761,708,4,712,3
2020-10-12,Trinity,105,12862,32,19,5,24,0
2020-10-12,Tulare,107,460477,17152,16742,242,16984,286
2020-10-12,Tuolumne,109,53932,252,234,27,261,4
2020-10-12,Ventura,111,848112,14069,13617,290,13907,151
2020-10-12,Yolo,113,214977,3063,2964,6,2970,55
2020-10-12,Yuba,115,75493,1172,1141,6,1147,10
2020-10-11,Alameda,1,1643700,22537,22057,214,22271,392
2020-10-11,Alpine,3,1148,4,3,0,3,0
2020-10-11,Amador,5,37829,308,305,0,305,16
2020-10-11,Butte,7,227075,3053,2967,21,2988,54
2020-10-11,Calaveras,9,45235,321,262,1,263,12
2020-10-11,Colusa,11,21464,540,541,0,541,6
2020-10-11,Contra Costa,13,1133247,18139,17678,92,17770,233
2020-10-11,Del Norte,15,27424,167,161,0,161,2
2020-10-11,El Dorado,17,186661,1290,1242,2,1244,4
2020-10-11,Fresno,19,978130,31908,29419,393,29812,421
2020-10-11,Glenn,21,27897,638,625,0,625,3
2020-10-11,Humboldt,23,135768,539,521,0,521,7
2020-10-11,Imperial,25,180216,12361,11614,7,11621,328
2020-10-11,Inyo,27,18085,213,201,1,202,14
2020-10-11,Kern,29,883053,32979,32399,361,32760,418
2020-10-11,Kings,31,150075,8214,8094,49,8143,80
2020-10-11,Lake,33,64148,664,631,0,631,12
2020-10-11,Lassen,35,31185,760,752,1,753,0
2020-10-11,Los Angeles,37,10098052,285819,280190,2496,282686,6745
2020-10-11,Madera,39,155013,4811,4680,29,4709,50
2020-10-11,Marin,41,260295,6970,6870,17,6887,97
2020-10-11,Mariposa,43,17540,78,76,0,76,2
2020-10-11,Mendocino,45,87422,993,944,2,946,21
2020-10-11,Merced,47,269075,9248,9124,26,9150,146
2020-10-11,Modoc,49,8938,29,27,0,27,0
2020-10-11,Mono,51,14174,173,154,3,157,1
2020-10-11,Monterey,53,433212,10740,10445,39,10484,77
2020-10-11,Napa,55,140530,1880,1811,5,1816,11
2020-10-11,Nevada,57,99092,591,569,16,585,7
2020-10-11,Orange,59,3164182,57781,55202,1633,56835,1326
2020-10-11,Placer,61,380077,3934,3787,15,3802,48
2020-10-11,Plumas,63,18699,52,51,0,51,0
2020-10-11,Riverside,65,2383286,63480,62112,229,62341,1254
2020-10-11,Sacramento,67,1510023,24140,23778,21,23799,466
2020-10-11,San Benito,69,59416,1383,1374,0,1374,13
2020-10-11,San Bernardino,71,2135413,59107,56997,74,57071,1061
2020-10-11,San Diego,73,3302833,52334,50553,0,50553,826
2020-10-11,San Francisco,75,870044,11828,11659,46,11705,122
2020-10-11,San Joaquin,77,732212,21048,20700,110,20810,480
2020-10-11,San Luis Obispo,79,281455,4021,3874,13,3887,32
2020-10-11,San Mateo,81,765935,10839,10240,8,10248,130
2020-10-11,Santa Barbara,83,443738,9939,9440,116,9556,117
2020-10-11,Santa Clara,85,1922200,23457,22487,35,22522,336
2020-10-11,Santa Cruz,87,273765,2663,2578,34,2612,13
2020-10-11,Shasta,89,179085,1807,1515,16,1531,20
2020-10-11,Sierra,91,2930,6,6,0,6,0
2020-10-11,Siskiyou,93,43540,171,162,10,172,0
2020-10-11,Solano,95,438530,6888,6685,41,6726,53
2020-10-11,Sonoma,97,501317,8734,8319,22,8341,133
2020-10-11,Stanislaus,99,539301,17077,17007,654,17661,360
2020-10-11,Sutter,101,95872,1762,1742,1,1743,12
2020-10-11,Tehama,103,63373,737,702,4,706,3
2020-10-11,Trinity,105,12862,32,19,5,24,0
2020-10-11,Tulare,107,460477,17089,16741,234,16975,286
2020-10-11,Tuolumne,109,53932,248,234,27,261,4
2020-10-11,Ventura,111,848112,14009,13604,285,13889,151
2020-10-11,Yolo,113,214977,3033,2952,6,2958,55
2020-10-11,Yuba,115,75493,1160,1137,6,1143,10
2020-10-10,Alameda,1,1643700,22487,21979,213,22192,398
2020-10-10,Alpine,3,1148,4,3,0,3,0
2020-10-10,Amador,5,37829,307,304,0,304,16
2020-10-10,Butte,7,227075,3048,2962,20,2982,54
2020-10-10,Calaveras,9,45235,320,262,1,263,12
2020-10-10,Colusa,11,21464,540,541,0,541,6
2020-10-10,Contra Costa,13,1133247,18103,17566,91,17657,233
2020-10-10,Del Norte,15,27424,167,161,0,161,2
2020-10-10,El Dorado,17,186661,1288,1240,2,1242,4
2020-10-10,Fresno,19,978130,31845,29286,391,29677,421
2020-10-10,Glenn,21,27897,638,623,0,623,3
2020-10-10,Humboldt,23,135768,536,518,0,518,7
2020-10-10,Imperial,25,180216,12346,11591,7,11598,327
2020-10-10,Inyo,27,18085,210,201,1,202,14
2020-10-10,Kern,29,883053,32942,32338,361,32699,418
2020-10-10,Kings,31,150075,8210,8078,49,8127,80
2020-10-10,Lake,33,64148,663,630,0,630,11
2020-10-10,Lassen,35,31185,760,752,1,753,0
2020-10-10,Los Angeles,37,10098052,285100,279213,2462,281675,6743
2020-10-10,Madera,39,155013,4798,4662,29,4691,50
2020-10-10,Marin,41,260295,6961,6852,17,6869,97
2020-10-10,Mariposa,43,17540,78,76,0,76,2
2020-10-10,Mendocino,45,87422,986,935,2,937,21
2020-10-10,Merced,47,269075,9242,9105,25,9130,146
2020-10-10,Modoc,49,8938,29,27,0,27,0
2020-10-10,Mono,51,14174,173,154,3,157,1
2020-10-10,Monterey,53,433212,10707,10410,39,10449,75
2020-10-10,Napa,55,140530,1873,1804,5,1809,11
2020-10-10,Nevada,57,99092,588,564,16,580,6
2020-10-10,Orange,59,3164182,57660,54965,1628,56593,1324
2020-10-10,Placer,61,380077,3917,3757,15,3772,48
2020-10-10,Plumas,63,18699,52,51,0,51,0
2020-10-10,Riverside,65,2383286,63278,61845,226,62071,1254
2020-10-10,Sacramento,67,1510023,24074,23689,21,23710,466
2020-10-10,San Benito,69,59416,1381,1370,0,1370,13
2020-10-10,San Bernardino,71,2135413,58945,56683,74,56757,1061
2020-10-10,San Diego,73,3302833,52104,50145,0,50145,825
2020-10-10,San Francisco,75,870044,11807,11663,46,11709,122
2020-10-10,San Joaquin,77,732212,21020,20700,106,20806,481
2020-10-10,San Luis Obispo,79,281455,4001,3832,13,3845,32
2020-10-10,San Mateo,81,765935,10802,10218,8,10226,130
2020-10-10,Santa Barbara,83,443738,9928,9417,116,9533,116
2020-10-10,Santa Clara,85,1922200,23365,22354,35,22389,330
2020-10-10,Santa Cruz,87,273765,2649,2572,34,2606,13
2020-10-10,Shasta,89,179085,1790,1473,16,1489,20
2020-10-10,Sierra,91,2930,6,6,0,6,0
2020-10-10,Siskiyou,93,43540,171,161,10,171,0
2020-10-10,Solano,95,438530,6862,6655,41,6696,53
2020-10-10,Sonoma,97,501317,8714,8235,22,8257,133
2020-10-10,Stanislaus,99,539301,17042,16960,646,17606,360
2020-10-10,Sutter,101,95872,1759,1735,1,1736,12
2020-10-10,Tehama,103,63373,730,693,4,697,3
2020-10-10,Trinity,105,12862,32,19,5,24,0
2020-10-10,Tulare,107,460477,17055,16709,229,16938,286
2020-10-10,Tuolumne,109,53932,248,233,27,260,4
2020-10-10,Ventura,111,848112,13985,13520,285,13805,151
2020-10-10,Yolo,113,214977,3024,2939,6,2945,55
2020-10-10,Yuba,115,75493,1158,1134,6,1140,10
2020-10-09,Alameda,1,1643700,22439,21924,213,22137,399
2020-10-09,Alpine,3,1148,4,3,0,3,0
2020-10-09,Amador,5,37829,307,303,0,303,16
2020-10-09,Butte,7,227075,3045,2956,20,2976,51
2020-10-09,Calaveras,9,45235,318,262,1,263,11
2020-10-09,Colusa,11,21464,540,541,0,541,6
2020-10-09,Contra Costa,13,1133247,18053,17487,91,17578,229
2020-10-09,Del Norte,15,27424,166,161,0,161,2
2020-10-09,El Dorado,17,186661,1284,1234,2,1236,4
2020-10-09,Fresno,19,978130,31772,29208,389,29597,417
2020-10-09,Glenn,21,27897,633,617,0,617,3
2020-10-09,Humboldt,23,135768,534,516,0,516,7
2020-10-09,Imperial,25,180216,12319,11516,7,11523,330
2020-10-09,Inyo,27,18085,207,200,1,201,14
2020-10-09,Kern,29,883053,32900,32237,359,32596,417
2020-10-09,Kings,31,150075,8203,7993,47,8040,80
2020-10-09,Lake,33,64148,653,610,0,610,11
2020-10-09,Lassen,35,31185,760,751,1,752,0
2020-10-09,Los Angeles,37,10098052,283968,278039,2437,280476,6715
2020-10-09,Madera,39,155013,4788,4646,29,4675,50
2020-10-09,Marin,41,260295,6947,6838,17,6855,96
2020-10-09,Mariposa,43,17540,78,76,0,76,2
2020-10-09,Mendocino,45,87422,979,933,2,935,20
2020-10-09,Merced,47,269075,9228,9095,25,9120,145
2020-10-09,Modoc,49,8938,29,27,0,27,0
2020-10-09,Mono,51,14174,173,154,3,157,1
2020-10-09,Monterey,53,433212,10673,10369,39,10408,75
2020-10-09,Napa,55,140530,1863,1795,5,1800,11
2020-10-09,Nevada,57,99092,583,561,16,577,6
2020-10-09,Orange,59,3164182,57493,54746,1622,56368,1305
2020-10-09,Placer,61,380077,3904,3737,15,3752,48
2020-10-09,Plumas,63,18699,52,50,0,50,0
2020-10-09,Riverside,65,2383286,63042,61529,225,61754,1252
2020-10-09,Sacramento,67,1510023,24004,23606,21,23627,457
2020-10-09,San Benito,69,59416,1376,1367,0,1367,13
2020-10-09,San Bernardino,71,2135413,58706,56434,74,56508,1057
2020-10-09,San Diego,73,3302833,51828,49825,0,49825,821
2020-10-09,San Francisco,75,870044,11777,11620,46,11666,120
2020-10-09,San Joaquin,77,732212,20991,20648,96,20744,481
2020-10-09,San Luis Obispo,79,281455,3982,3810,13,3823,32
2020-10-09,San Mateo,81,765935,10774,10140,8,10148,130
2020-10-09,Santa Barbara,83,443738,9900,9396,116,9512,116
2020-10-09,Santa Clara,85,1922200,23263,22251,34,22285,328
2020-10-09,Santa Cruz,87,273765,2640,2555,34,2589,13
2020-10-09,Shasta,89,179085,1763,1353,15,1368,20
2020-10-09,Sierra,91,2930,6,6,0,6,0
2020-10-09,Siskiyou,93,43540,169,156,10,166,0
2020-10-09,Solano,95,438530,6823,6614,41,6655,53
2020-10-09,Sonoma,97,501317,8660,8133,22,8155,133
2020-10-09,Stanislaus,99,539301,17019,16904,637,17541,362
2020-10-09,Sutter,101,95872,1755,1732,1,1733,12
2020-10-09,Tehama,103,63373,724,682,4,686,3
2020-10-09,Trinity,105,12862,32,25,5,30,0
2020-10-09,Tulare,107,460477,17015,16644,220,16864,286
2020-10-09,Tuolumne,109,53932,245,230,27,257,4
2020-10-09,Ventura,111,848112,13949,13469,282,13751,151
2020-10-09,Yolo,113,214977,3017,2928,6,2934,55
2020-10-09,Yuba,115,75493,1157,1129,6,1135,10
2020-10-08,Alameda,1,1643700,22359,21826,212,22038,395
2020-10-08,Alpine,3,1148,4,3,0,3,0
2020-10-08,Amador,5,37829,306,302,0,302,16
2020-10-08,Butte,7,227075,3035,2935,20,2955,51
2020-10-08,Calaveras,9,45235,317,262,1,263,11
2020-10-08,Colusa,11,21464,540,539,0,539,6
2020-10-08,Contra Costa,13,1133247,17993,17418,90,17508,228
2020-10-08,Del Norte,15,27424,166,151,0,151,2
2020-10-08,El Dorado,17,186661,1283,1230,2,1232,4
2020-10-08,Fresno,19,978130,31667,29111,389,29500,416
2020-10-08,Glenn,21,27897,630,616,0,616,3
2020-10-08,Humboldt,23,135768,530,515,0,515,7
2020-10-08,Imperial,25,180216,12280,11405,7,11412,330
2020-10-08,Inyo,27,18085,204,199,1,200,14
2020-10-08,Kern,29,883053,32842,32169,354,32523,411
2020-10-08,Kings,31,150075,8197,7968,47,8015,80
2020-10-08,Lake,33,64148,648,604,0,604,11
2020-10-08,Lassen,35,31185,755,751,1,752,0
2020-10-08,Los Angeles,37,10098052,282771,276763,2396,279159,6699
2020-10-08,Madera,39,155013,4769,4637,29,4666,50
2020-10-08,Marin,41,260295,6933,6810,17,6827,96
2020-10-08,Mariposa,43,17540,78,76,0,76,2
2020-10-08,Mendocino,45,87422,974,930,2,932,20
2020-10-08,Merced,47,269075,9208,9069,25,9094,144
2020-10-08,Modoc,49,8938,29,27,0,27,0
2020-10-08,Mono,51,14174,173,153,3,156,1
2020-10-08,Monterey,53,433212,10606,10343,39,10382,75
2020-10-08,Napa,55,140530,1848,1779,5,1784,11
2020-10-08,Nevada,57,99092,580,556,16,572,6
2020-10-08,Orange,59,3164182,57300,54523,1610,56133,1293
2020-10-08,Placer,61,380077,3886,3715,15,3730,48
2020-10-08,Plumas,63,18699,52,50,0,50,0
2020-10-08,Riverside,65,2383286,62774,61105,223,61328,1244
2020-10-08,Sacramento,67,1510023,23896,23482,21,23503,454
2020-10-08,San Benito,69,59416,1371,1367,0,1367,13
2020-10-08,San Bernardino,71,2135413,58343,56152,74,56226,1048
2020-10-08,San Diego,73,3302833,51548,49468,0,49468,819
2020-10-08,San Francisco,75,870044,11740,11608,46,11654,115
2020-10-08,San Joaquin,77,732212,20941,20576,91,20667,478
2020-10-08,San Luis Obispo,79,281455,3966,3785,13,3798,32
2020-10-08,San Mateo,81,765935,10742,10044,8,10052,130
2020-10-08,Santa Barbara,83,443738,9870,9374,116,9490,116
2020-10-08,Santa Clara,85,1922200,23161,22095,34,22129,323
2020-10-08,Santa Cruz,87,273765,2629,2535,34,2569,13
2020-10-08,Shasta,89,179085,1729,1305,15,1320,20
2020-10-08,Sierra,91,2930,6,6,0,6,0
2020-10-08,Siskiyou,93,43540,169,156,10,166,0
2020-10-08,Solano,95,438530,6799,6556,41,6597,53
2020-10-08,Sonoma,97,501317,8594,8063,22,8085,132
2020-10-08,Stanislaus,99,539301,16974,16821,629,17450,360
2020-10-08,Sutter,101,95872,1755,1725,1,1726,12
2020-10-08,Tehama,103,63373,715,676,4,680,3
2020-10-08,Trinity,105,12862,32,25,5,30,0
2020-10-08,Tulare,107,460477,16954,16573,211,16784,283
2020-10-08,Tuolumne,109,53932,244,230,27,257,4
2020-10-08,Ventura,111,848112,13902,13399,279,13678,151
2020-10-08,Yolo,113,214977,3000,2914,6,2920,55
2020-10-08,Yuba,115,75493,1152,1126,6,1132,10
2020-10-07,Alameda,1,1643700,22283,21736,212,21948,395
2020-10-07,Alpine,3,1148,4,3,0,3,0
2020-10-07,Amador,5,37829,306,302,0,302,16
2020-10-07,Butte,7,227075,3023,2927,20,2947,47
2020-10-07,Calaveras,9,45235,315,262,1,263,11
2020-10-07,Colusa,11,21464,539,539,0,539,6
2020-10-07,Contra Costa,13,1133247,17923,17346,89,17435,225
2020-10-07,Del Norte,15,27424,165,149,0,149,2
2020-10-07,El Dorado,17,186661,1275,1219,2,1221,4
2020-10-07,Fresno,19,978130,31545,29069,384,29453,413
2020-10-07,Glenn,21,27897,630,615,0,615,3
2020-10-07,Humboldt,23,135768,527,512,0,512,7
2020-10-07,Imperial,25,180216,12244,11289,7,11296,330
2020-10-07,Inyo,27,18085,204,199,1,200,14
2020-10-07,Kern,29,883053,32770,32068,353,32421,410
2020-10-07,Kings,31,150075,8182,7948,47,7995,80
2020-10-07,Lake,33,64148,647,599,0,599,11
2020-10-07,Lassen,35,31185,755,751,1,752,0
2020-10-07,Los Angeles,37,10098052,281599,275559,2358,277917,6681
2020-10-07,Madera,39,155013,4749,4618,29,4647,50
2020-10-07,Marin,41,260295,6906,6790,17,6807,95
2020-10-07,Mariposa,43,17540,78,75,0,75,2
2020-10-07,Mendocino,45,87422,968,927,2,929,19
2020-10-07,Merced,47,269075,9171,9045,24,9069,144
2020-10-07,Modoc,49,8938,29,27,0,27,0
2020-10-07,Mono,51,14174,172,153,2,155,1
2020-10-07,Monterey,53,433212,10547,10272,39,10311,75
2020-10-07,Napa,55,140530,1835,1774,5,1779,11
2020-10-07,Nevada,57,99092,576,552,16,568,6
2020-10-07,Orange,59,3164182,57081,54332,1600,55932,1277
2020-10-07,Placer,61,380077,3870,3693,15,3708,48
2020-10-07,Plumas,63,18699,52,50,0,50,0
2020-10-07,Riverside,65,2383286,62427,60857,219,61076,1241
2020-10-07,Sacramento,67,1510023,23800,23380,21,23401,452
2020-10-07,San Benito,69,59416,1368,1363,0,1363,13
2020-10-07,San Bernardino,71,2135413,57995,55738,73,55811,1043
2020-10-07,San Diego,73,3302833,51232,49177,0,49177,813
2020-10-07,San Francisco,75,870044,11705,11551,46,11597,115
2020-10-07,San Joaquin,77,732212,20889,20527,83,20610,478
2020-10-07,San Luis Obispo,79,281455,3936,3749,13,3762,32
2020-10-07,San Mateo,81,765935,10700,9980,8,9988,130
2020-10-07,Santa Barbara,83,443738,9842,9350,115,9465,116
2020-10-07,Santa Clara,85,1922200,23034,21993,34,22027,320
2020-10-07,Santa Cruz,87,273765,2617,2518,34,2552,14
2020-10-07,Shasta,89,179085,1686,1268,15,1283,20
2020-10-07,Sierra,91,2930,6,6,0,6,0
2020-10-07,Siskiyou,93,43540,167,154,10,164,0
2020-10-07,Solano,95,438530,6764,6526,41,6567,53
2020-10-07,Sonoma,97,501317,8517,7993,22,8015,130
2020-10-07,Stanislaus,99,539301,16941,16786,623,17409,357
2020-10-07,Sutter,101,95872,1751,1723,1,1724,12
2020-10-07,Tehama,103,63373,706,666,4,670,3
2020-10-07,Trinity,105,12862,31,25,5,30,0
2020-10-07,Tulare,107,460477,16913,16483,202,16685,282
2020-10-07,Tuolumne,109,53932,244,227,27,254,3
2020-10-07,Ventura,111,848112,13852,13333,273,13606,150
2020-10-07,Yolo,113,214977,2974,2904,6,2910,55
2020-10-07,Yuba,115,75493,1146,1120,6,1126,10
2020-10-06,Alameda,1,1643700,22193,21698,210,21908,385
2020-10-06,Alpine,3,1148,4,3,0,3,0
2020-10-06,Amador,5,37829,304,301,0,301,16
2020-10-06,Butte,7,227075,3016,2925,20,2945,47
2020-10-06,Calaveras,9,45235,315,261,1,262,11
2020-10-06,Colusa,11,21464,538,538,0,538,6
2020-10-06,Contra Costa,13,1133247,17844,17295,89,17384,219
2020-10-06,Del Norte,15,27424,165,144,0,144,2
2020-10-06,El Dorado,17,186661,1271,1211,2,1213,4
2020-10-06,Fresno,19,978130,31403,29022,381,29403,412
2020-10-06,Glenn,21,27897,627,604,0,604,3
2020-10-06,Humboldt,23,135768,524,508,0,508,7
2020-10-06,Imperial,25,180216,12206,11196,7,11203,327
2020-10-06,Inyo,27,18085,202,198,1,199,14
2020-10-06,Kern,29,883053,32693,32006,351,32357,407
2020-10-06,Kings,31,150075,8166,7943,47,7990,81
2020-10-06,Lake,33,64148,641,596,0,596,11
2020-10-06,Lassen,35,31185,755,743,1,744,0
2020-10-06,Los Angeles,37,10098052,280367,274115,2305,276420,6657
2020-10-06,Madera,39,155013,4737,4608,29,4637,50
2020-10-06,Marin,41,260295,6892,6766,17,6783,91
2020-10-06,Mariposa,43,17540,78,75,0,75,2
2020-10-06,Mendocino,45,87422,962,920,2,922,19
2020-10-06,Merced,47,269075,9135,9034,23,9057,143
2020-10-06,Modoc,49,8938,29,26,0,26,0
2020-10-06,Mono,51,14174,172,153,2,155,1
2020-10-06,Monterey,53,433212,10491,10235,38,10273,72
2020-10-06,Napa,55,140530,1829,1770,5,1775,11
2020-10-06,Nevada,57,99092,574,551,16,567,6
2020-10-06,Orange,59,3164182,56866,54203,1592,55795,1273
2020-10-06,Placer,61,380077,3848,3680,15,3695,48
2020-10-06,Plumas,63,18699,52,49,0,49,0
2020-10-06,Riverside,65,2383286,62163,60593,215,60808,1238
2020-10-06,Sacramento,67,1510023,23713,23322,21,23343,442
2020-10-06,San Benito,69,59416,1367,1358,0,1358,12
2020-10-06,San Bernardino,71,2135413,57680,55416,72,55488,1040
2020-10-06,San Diego,73,3302833,50895,48823,0,48823,806
2020-10-06,San Francisco,75,870044,11679,11513,45,11558,115
2020-10-06,San Joaquin,77,732212,20849,20481,80,20561,477
2020-10-06,San Luis Obispo,79,281455,3902,3723,13,3736,32
2020-10-06,San Mateo,81,765935,10667,9934,8,9942,129
2020-10-06,Santa Barbara,83,443738,9813,9331,114,9445,116
2020-10-06,Santa Clara,85,1922200,22939,21914,34,21948,320
2020-10-06,Santa Cruz,87,273765,2595,2510,34,2544,12
2020-10-06,Shasta,89,179085,1646,1242,15,1257,18
2020-10-06,Sierra,91,2930,6,6,0,6,0
2020-10-06,Siskiyou,93,43540,167,154,10,164,0
2020-10-06,Solano,95,438530,6718,6506,41,6547,52
2020-10-06,Sonoma,97,501317,8425,7895,22,7917,130
2020-10-06,Stanislaus,99,539301,16896,16759,617,17376,354
2020-10-06,Sutter,101,95872,1749,1722,1,1723,12
2020-10-06,Tehama,103,63373,697,660,4,664,3
2020-10-06,Trinity,105,12862,31,25,5,30,0
2020-10-06,Tulare,107,460477,16871,16456,194,16650,280
2020-10-06,Tuolumne,109,53932,243,227,27,254,2
2020-10-06,Ventura,111,848112,13785,13242,268,13510,150
2020-10-06,Yolo,113,214977,2960,2899,6,2905,56
2020-10-06,Yuba,115,75493,1145,1114,6,1120,10
2020-10-05,Alameda,1,1643700,22106,21637,207,21844,383
2020-10-05,Alpine,3,1148,4,2,0,2,0
2020-10-05,Amador,5,37829,304,299,0,299,16
2020-10-05,Butte,7,227075,3006,2910,20,2930,46
2020-10-05,Calaveras,9,45235,315,259,1,260,11
2020-10-05,Colusa,11,21464,538,537,0,537,6
2020-10-05,Contra Costa,13,1133247,17767,17250,89,17339,216
2020-10-05,Del Norte,15,27424,162,142,0,142,2
2020-10-05,El Dorado,17,186661,1267,1202,2,1204,4
2020-10-05,Fresno,19,978130,31286,29136,381,29517,408
2020-10-05,Glenn,21,27897,625,603,0,603,3
2020-10-05,Humboldt,23,135768,523,506,0,506,6
2020-10-05,Imperial,25,180216,12167,11169,7,11176,327
2020-10-05,Inyo,27,18085,202,197,1,198,14
2020-10-05,Kern,29,883053,32614,31933,347,32280,404
2020-10-05,Kings,31,150075,8069,7932,47,7979,80
2020-10-05,Lake,33,64148,637,592,0,592,10
2020-10-05,Lassen,35,31185,754,743,1,744,0
2020-10-05,Los Angeles,37,10098052,279288,273200,2261,275461,6632
2020-10-05,Madera,39,155013,4729,4598,27,4625,50
2020-10-05,Marin,41,260295,6876,6751,17,6768,91
2020-10-05,Mariposa,43,17540,78,75,0,75,2
2020-10-05,Mendocino,45,87422,955,913,2,915,19
2020-10-05,Merced,47,269075,9116,9021,22,9043,143
2020-10-05,Modoc,49,8938,29,26,0,26,0
2020-10-05,Mono,51,14174,172,152,2,154,1
2020-10-05,Monterey,53,433212,10444,10187,38,10225,72
2020-10-05,Napa,55,140530,1819,1760,5,1765,11
2020-10-05,Nevada,57,99092,571,550,15,565,6
2020-10-05,Orange,59,3164182,56652,54103,1577,55680,1271
2020-10-05,Placer,61,380077,3822,3670,15,3685,46
2020-10-05,Plumas,63,18699,51,49,0,49,0
2020-10-05,Riverside,65,2383286,61844,60454,211,60665,1232
2020-10-05,Sacramento,67,1510023,23611,23207,21,23228,438
2020-10-05,San Benito,69,59416,1364,1356,0,1356,12
2020-10-05,San Bernardino,71,2135413,57374,55100,72,55172,1031
2020-10-05,San Diego,73,3302833,50559,48662,0,48662,803
2020-10-05,San Francisco,75,870044,11640,11476,42,11518,110
2020-10-05,San Joaquin,77,732212,20778,20319,77,20396,476
2020-10-05,San Luis Obispo,79,281455,3876,3710,13,3723,32
2020-10-05,San Mateo,81,765935,10640,9896,8,9904,128
2020-10-05,Santa Barbara,83,443738,9791,9309,114,9423,116
2020-10-05,Santa Clara,85,1922200,22824,21861,34,21895,319
2020-10-05,Santa Cruz,87,273765,2583,2492,34,2526,9
2020-10-05,Shasta,89,179085,1613,1158,15,1173,18
2020-10-05,Sierra,91,2930,6,6,0,6,0
2020-10-05,Siskiyou,93,43540,167,153,10,163,0
2020-10-05,Solano,95,438530,6679,6475,41,6516,52
2020-10-05,Sonoma,97,501317,8333,7817,22,7839,130
2020-10-05,Stanislaus,99,539301,16861,16730,610,17340,351
2020-10-05,Sutter,101,95872,1741,1719,1,1720,12
2020-10-05,Tehama,103,63373,689,642,4,646,3
2020-10-05,Trinity,105,12862,31,22,5,27,0
2020-10-05,Tulare,107,460477,16813,16343,190,16533,278
2020-10-05,Tuolumne,109,53932,240,226,27,253,2
2020-10-05,Ventura,111,848112,13718,13224,246,13470,149
2020-10-05,Yolo,113,214977,2941,2889,6,2895,56
2020-10-05,Yuba,115,75493,1132,1108,6,1114,9
2020-10-04,Alameda,1,1643700,22011,21597,207,21804,383
2020-10-04,Alpine,3,1148,4,2,0,2,0
2020-10-04,Amador,5,37829,302,297,0,297,16
2020-10-04,Butte,7,227075,2992,2903,20,2923,46
2020-10-04,Calaveras,9,45235,315,259,1,260,11
2020-10-04,Colusa,11,21464,537,537,0,537,6
2020-10-04,Contra Costa,13,1133247,17702,17192,89,17281,214
2020-10-04,Del Norte,15,27424,158,142,0,142,2
2020-10-04,El Dorado,17,186661,1263,1196,2,1198,4
2020-10-04,Fresno,19,978130,31163,29065,381,29446,408
2020-10-04,Glenn,21,27897,623,601,0,601,3
2020-10-04,Humboldt,23,135768,522,506,0,506,6
2020-10-04,Imperial,25,180216,12127,11127,7,11134,327
2020-10-04,Inyo,27,18085,199,195,1,196,14
2020-10-04,Kern,29,883053,32540,31906,345,32251,404
2020-10-04,Kings,31,150075,8054,7919,47,7966,80
2020-10-04,Lake,33,64148,623,589,0,589,10
2020-10-04,Lassen,35,31185,754,743,1,744,0
2020-10-04,Los Angeles,37,10098052,277907,272822,2210,275032,6625
2020-10-04,Madera,39,155013,4713,4587,27,4614,50
2020-10-04,Marin,41,260295,6856,6741,17,6758,91
2020-10-04,Mariposa,43,17540,78,75,0,75,2
2020-10-04,Mendocino,45,87422,942,905,2,907,18
2020-10-04,Merced,47,269075,9091,9006,22,9028,140
2020-10-04,Modoc,49,8938,29,26,0,26,0
2020-10-04,Mono,51,14174,171,152,1,153,1
2020-10-04,Monterey,53,433212,10403,10141,37,10178,72
2020-10-04,Napa,55,140530,1807,1759,5,1764,11
2020-10-04,Nevada,57,99092,567,547,14,561,6
2020-10-04,Orange,59,3164182,56416,53966,1568,55534,1270
2020-10-04,Placer,61,380077,3801,3664,15,3679,46
2020-10-04,Plumas,63,18699,51,49,0,49,0
2020-10-04,Riverside,65,2383286,61558,60251,206,60457,1226
2020-10-04,Sacramento,67,1510023,23498,23162,21,23183,438
2020-10-04,San Benito,69,59416,1364,1355,0,1355,12
2020-10-04,San Bernardino,71,2135413,56930,55100,72,55172,1031
2020-10-04,San Diego,73,3302833,50193,48438,0,48438,803
2020-10-04,San Francisco,75,870044,11608,11474,40,11514,110
2020-10-04,San Joaquin,77,732212,20701,20320,71,20391,476
2020-10-04,San Luis Obispo,79,281455,3851,3688,13,3701,31
2020-10-04,San Mateo,81,765935,10579,9858,8,9866,128
2020-10-04,Santa Barbara,83,443738,9765,9276,111,9387,116
2020-10-04,Santa Clara,85,1922200,22688,21780,34,21814,316
2020-10-04,Santa Cruz,87,273765,2567,2483,34,2517,9
2020-10-04,Shasta,89,179085,1515,1158,14,1172,18
2020-10-04,Sierra,91,2930,6,6,0,6,0
2020-10-04,Siskiyou,93,43540,167,153,10,163,0
2020-10-04,Solano,95,438530,6628,6445,41,6486,52
2020-10-04,Sonoma,97,501317,8245,7794,22,7816,129
2020-10-04,Stanislaus,99,539301,16811,16711,601,17312,351
2020-10-04,Sutter,101,95872,1736,1711,1,1712,11
2020-10-04,Tehama,103,63373,674,637,4,641,3
2020-10-04,Trinity,105,12862,31,21,5,26,0
2020-10-04,Tulare,107,460477,16739,16343,178,16521,278
2020-10-04,Tuolumne,109,53932,238,226,27,253,2
2020-10-04,Ventura,111,848112,13636,13197,228,13425,149
2020-10-04,Yolo,113,214977,2930,2875,6,2881,56
2020-10-04,Yuba,115,75493,1128,1103,6,1109,9
2020-10-03,Alameda,1,1643700,21967,21510,206,21716,386
2020-10-03,Alpine,3,1148,4,2,0,2,0
2020-10-03,Amador,5,37829,301,296,0,296,16
2020-10-03,Butte,7,227075,2986,2894,20,2914,46
2020-10-03,Calaveras,9,45235,315,259,1,260,11
2020-10-03,Colusa,11,21464,536,537,0,537,6
2020-10-03,Contra Costa,13,1133247,17652,17087,87,17174,213
2020-10-03,Del Norte,15,27424,154,142,0,142,2
2020-10-03,El Dorado,17,186661,1256,1188,2,1190,4
2020-10-03,Fresno,19,978130,31104,28975,380,29355,408
2020-10-03,Glenn,21,27897,621,601,0,601,3
2020-10-03,Humboldt,23,135768,521,504,0,504,6
2020-10-03,Imperial,25,180216,12104,11090,7,11097,327
2020-10-03,Inyo,27,18085,199,194,1,195,14
2020-10-03,Kern,29,883053,32491,31864,342,32206,403
2020-10-03,Kings,31,150075,8050,7887,47,7934,80
2020-10-03,Lake,33,64148,613,588,0,588,10
2020-10-03,Lassen,35,31185,754,743,1,744,0
2020-10-03,Los Angeles,37,10098052,277203,271869,2180,274049,6620
2020-10-03,Madera,39,155013,4696,4565,27,4592,50
2020-10-03,Marin,41,260295,6850,6728,17,6745,91
2020-10-03,Mariposa,43,17540,78,75,0,75,2
2020-10-03,Mendocino,45,87422,941,898,2,900,18
2020-10-03,Merced,47,269075,9078,8986,22,9008,139
2020-10-03,Modoc,49,8938,29,26,0,26,0
2020-10-03,Mono,51,14174,171,152,1,153,1
2020-10-03,Monterey,53,433212,10369,10092,34,10126,72
2020-10-03,Napa,55,140530,1803,1752,5,1757,11
2020-10-03,Nevada,57,99092,565,544,14,558,6
2020-10-03,Orange,59,3164182,56299,53573,1563,55136,1268
2020-10-03,Placer,61,380077,3790,3648,15,3663,47
2020-10-03,Plumas,63,18699,51,48,0,48,0
2020-10-03,Riverside,65,2383286,61403,59991,205,60196,1226
2020-10-03,Sacramento,67,1510023,23447,23076,21,23097,437
2020-10-03,San Benito,69,59416,1364,1351,0,1351,12
2020-10-03,San Bernardino,71,2135413,56758,55004,71,55075,1031
2020-10-03,San Diego,73,3302833,49962,48202,0,48202,798
2020-10-03,San Francisco,75,870044,11583,11475,38,11513,110
2020-10-03,San Joaquin,77,732212,20675,20322,71,20393,476
2020-10-03,San Luis Obispo,79,281455,3827,3670,13,3683,31
2020-10-03,San Mateo,81,765935,10553,9822,7,9829,128
2020-10-03,Santa Barbara,83,443738,9752,9256,111,9367,116
2020-10-03,Santa Clara,85,1922200,22608,21672,34,21706,309
2020-10-03,Santa Cruz,87,273765,2559,2476,34,2510,9
2020-10-03,Shasta,89,179085,1487,1117,13,1130,18
2020-10-03,Sierra,91,2930,6,6,0,6,0
2020-10-03,Siskiyou,93,43540,167,152,10,162,0
2020-10-03,Solano,95,438530,6602,6419,41,6460,52
2020-10-03,Sonoma,97,501317,8202,7747,22,7769,129
2020-10-03,Stanislaus,99,539301,16778,16645,597,17242,351
2020-10-03,Sutter,101,95872,1732,1705,1,1706,11
2020-10-03,Tehama,103,63373,668,630,4,634,3
2020-10-03,Trinity,105,12862,31,15,5,20,0
2020-10-03,Tulare,107,460477,16697,16322,173,16495,278
2020-10-03,Tuolumne,109,53932,237,224,27,251,2
2020-10-03,Ventura,111,848112,13597,13150,224,13374,148
2020-10-03,Yolo,113,214977,2923,2863,6,2869,56
2020-10-03,Yuba,115,75493,1120,1097,6,1103,8
2020-10-02,Alameda,1,1643700,21913,21404,205,21609,382
2020-10-02,Alpine,3,1148,4,2,0,2,0
2020-10-02,Amador,5,37829,300,296,0,296,16
2020-10-02,Butte,7,227075,2976,2879,20,2899,46
2020-10-02,Calaveras,9,45235,314,259,1,260,11
2020-10-02,Colusa,11,21464,535,537,0,537,6
2020-10-02,Contra Costa,13,1133247,17609,17002,87,17089,213
2020-10-02,Del Norte,15,27424,153,141,0,141,2
2020-10-02,El Dorado,17,186661,1249,1168,2,1170,4
2020-10-02,Fresno,19,978130,31021,28855,380,29235,403
2020-10-02,Glenn,21,27897,616,594,0,594,3
2020-10-02,Humboldt,23,135768,520,503,0,503,6
2020-10-02,Imperial,25,180216,12082,11024,7,11031,327
2020-10-02,Inyo,27,18085,197,191,1,192,14
2020-10-02,Kern,29,883053,32439,31790,340,32130,399
2020-10-02,Kings,31,150075,8041,7716,47,7763,79
2020-10-02,Lake,33,64148,607,579,0,579,10
2020-10-02,Lassen,35,31185,754,742,1,743,0
2020-10-02,Los Angeles,37,10098052,276302,270935,2151,273086,6602
2020-10-02,Madera,39,155013,4687,4537,27,4564,49
2020-10-02,Marin,41,260295,6833,6717,17,6734,91
2020-10-02,Mariposa,43,17540,78,75,0,75,2
2020-10-02,Mendocino,45,87422,937,883,2,885,18
2020-10-02,Merced,47,269075,9068,8961,22,8983,139
2020-10-02,Modoc,49,8938,29,26,0,26,0
2020-10-02,Mono,51,14174,171,150,1,151,1
2020-10-02,Monterey,53,433212,10335,9997,34,10031,71
2020-10-02,Napa,55,140530,1797,1737,5,1742,11
2020-10-02,Nevada,57,99092,562,543,14,557,6
2020-10-02,Orange,59,3164182,56169,53299,1556,54855,1262
2020-10-02,Placer,61,380077,3770,3612,15,3627,46
2020-10-02,Plumas,63,18699,51,48,0,48,0
2020-10-02,Riverside,65,2383286,61182,59673,202,59875,1223
2020-10-02,Sacramento,67,1510023,23384,22818,21,22839,436
2020-10-02,San Benito,69,59416,1360,1347,0,1347,12
2020-10-02,San Bernardino,71,2135413,56571,54613,71,54684,1028
2020-10-02,San Diego,73,3302833,49710,47793,0,47793,794
2020-10-02,San Francisco,75,870044,11560,11398,38,11436,110
2020-10-02,San Joaquin,77,732212,20642,20235,69,20304,474
2020-10-02,San Luis Obispo,79,281455,3804,3654,13,3667,31
2020-10-02,San Mateo,81,765935,10512,9745,7,9752,128
2020-10-02,Santa Barbara,83,443738,9730,9234,111,9345,116
2020-10-02,Santa Clara,85,1922200,22527,21545,34,21579,305
2020-10-02,Santa Cruz,87,273765,2542,2463,34,2497,9
2020-10-02,Shasta,89,179085,1452,1046,13,1059,18
2020-10-02,Sierra,91,2930,6,6,0,6,0
2020-10-02,Siskiyou,93,43540,167,151,10,161,0
2020-10-02,Solano,95,438530,6572,6385,41,6426,52
2020-10-02,Sonoma,97,501317,8145,7662,22,7684,125
2020-10-02,Stanislaus,99,539301,16738,16609,588,17197,349
2020-10-02,Sutter,101,95872,1731,1693,1,1694,11
2020-10-02,Tehama,103,63373,663,619,4,623,3
2020-10-02,Trinity,105,12862,31,15,5,20,0
2020-10-02,Tulare,107,460477,16657,16245,166,16411,278
2020-10-02,Tuolumne,109,53932,235,225,27,252,2
2020-10-02,Ventura,111,848112,13560,13120,218,13338,146
2020-10-02,Yolo,113,214977,2918,2845,6,2851,55
2020-10-02,Yuba,115,75493,1118,1090,6,1096,8
2020-10-01,Alameda,1,1643700,21853,21349,202,21551,383
2020-10-01,Alpine,3,1148,4,2,0,2,0
2020-10-01,Amador,5,37829,300,294,0,294,16
2020-10-01,Butte,7,227075,2968,2865,20,2885,45
2020-10-01,Calaveras,9,45235,314,257,1,258,11
2020-10-01,Colusa,11,21464,535,536,0,536,6
2020-10-01,Contra Costa,13,1133247,17547,16898,87,16985,211
2020-10-01,Del Norte,15,27424,148,140,0,140,2
2020-10-01,El Dorado,17,186661,1245,1162,1,1163,4
2020-10-01,Fresno,19,978130,30941,28796,378,29174,397
2020-10-01,Glenn,21,27897,612,593,0,593,3
2020-10-01,Humboldt,23,135768,520,499,0,499,6
2020-10-01,Imperial,25,180216,12039,10928,7,10935,325
2020-10-01,Inyo,27,18085,197,191,1,192,14
2020-10-01,Kern,29,883053,32376,31678,337,32015,399
2020-10-01,Kings,31,150075,8030,7688,44,7732,79
2020-10-01,Lake,33,64148,601,572,0,572,11
2020-10-01,Lassen,35,31185,751,742,1,743,0
2020-10-01,Los Angeles,37,10098052,275263,271513,2114,273627,6621
2020-10-01,Madera,39,155013,4664,4508,27,4535,48
2020-10-01,Marin,41,260295,6819,6710,17,6727,92
2020-10-01,Mariposa,43,17540,78,76,0,76,2
2020-10-01,Mendocino,45,87422,933,874,2,876,19
2020-10-01,Merced,47,269075,9040,8942,22,8964,138
2020-10-01,Modoc,49,8938,29,26,0,26,0
2020-10-01,Mono,51,14174,169,150,1,151,1
2020-10-01,Monterey,53,433212,10259,9958,34,9992,71
2020-10-01,Napa,55,140530,1789,1729,5,1734,11
2020-10-01,Nevada,57,99092,561,543,14,557,6
2020-10-01,Orange,59,3164182,56004,53088,1543,54631,1257
2020-10-01,Placer,61,380077,3742,3599,15,3614,45
2020-10-01,Plumas,63,18699,51,48,0,48,0
2020-10-01,Riverside,65,2383286,60932,59293,195,59488,1223
2020-10-01,Sacramento,67,1510023,23273,22714,20,22734,433
2020-10-01,San Benito,69,59416,1358,1346,0,1346,12
2020-10-01,San Bernardino,71,2135413,56277,54350,69,54419,1021
2020-10-01,San Diego,73,3302833,49428,47487,0,47487,792
2020-10-01,San Francisco,75,870044,11529,11284,36,11320,110
2020-10-01,San Joaquin,77,732212,20595,20204,66,20270,471
2020-10-01,San Luis Obispo,79,281455,3777,3625,13,3638,31
2020-10-01,San Mateo,81,765935,10467,9681,7,9688,128
2020-10-01,Santa Barbara,83,443738,9688,9215,111,9326,118
2020-10-01,Santa Clara,85,1922200,22427,21398,34,21432,305
2020-10-01,Santa Cruz,87,273765,2527,2418,34,2452,10
2020-10-01,Shasta,89,179085,1401,991,13,1004,18
2020-10-01,Sierra,91,2930,6,6,0,6,0
2020-10-01,Siskiyou,93,43540,164,150,10,160,0
2020-10-01,Solano,95,438530,6534,6352,41,6393,52
2020-10-01,Sonoma,97,501317,8078,7569,22,7591,125
2020-10-01,Stanislaus,99,539301,16705,16555,582,17137,346
2020-10-01,Sutter,101,95872,1726,1684,1,1685,11
2020-10-01,Tehama,103,63373,653,606,4,610,3
2020-10-01,Trinity,105,12862,31,15,5,20,0
2020-10-01,Tulare,107,460477,16584,16182,163,16345,275
2020-10-01,Tuolumne,109,53932,235,223,27,250,2
2020-10-01,Ventura,111,848112,13511,13057,202,13259,146
2020-10-01,Yolo,113,214977,2900,2833,6,2839,55
2020-10-01,Yuba,115,75493,1114,1082,6,1088,8
2020-09-30,Alameda,1,1643700,21776,21271,197,21468,380
2020-09-30,Alpine,3,1148,4,2,0,2,0
2020-09-30,Amador,5,37829,300,294,0,294,16
2020-09-30,Butte,7,227075,2960,2858,20,2878,44
2020-09-30,Calaveras,9,45235,313,258,1,259,11
2020-09-30,Colusa,11,21464,534,534,0,534,6
2020-09-30,Contra Costa,13,1133247,17478,16819,87,16906,211
2020-09-30,Del Norte,15,27424,147,140,0,140,2
2020-09-30,El Dorado,17,186661,1233,1157,1,1158,4
2020-09-30,Fresno,19,978130,30850,28706,375,29081,395
2020-09-30,Glenn,21,27897,607,592,0,592,3
2020-09-30,Humboldt,23,135768,518,497,0,497,6
2020-09-30,Imperial,25,180216,12014,10868,7,10875,287
2020-09-30,Inyo,27,18085,197,189,0,189,14
2020-09-30,Kern,29,883053,32303,31601,336,31937,398
2020-09-30,Kings,31,150075,8001,7685,44,7729,79
2020-09-30,Lake,33,64148,595,567,0,567,10
2020-09-30,Lassen,35,31185,748,742,1,743,0
2020-09-30,Los Angeles,37,10098052,274026,270260,2080,272340,6568
2020-09-30,Madera,39,155013,4655,4477,27,4504,47
2020-09-30,Marin,41,260295,6795,6700,16,6716,91
2020-09-30,Mariposa,43,17540,78,76,0,76,2
2020-09-30,Mendocino,45,87422,927,867,2,869,17
2020-09-30,Merced,47,269075,9020,8926,22,8948,136
2020-09-30,Modoc,49,8938,29,26,0,26,0
2020-09-30,Mono,51,14174,169,150,1,151,1
2020-09-30,Monterey,53,433212,10209,9898,33,9931,70
2020-09-30,Napa,55,140530,1775,1728,5,1733,11
2020-09-30,Nevada,57,99092,559,540,14,554,6
2020-09-30,Orange,59,3164182,55813,52916,1527,54443,1251
2020-09-30,Placer,61,380077,3721,3585,15,3600,43
2020-09-30,Plumas,63,18699,51,48,0,48,0
2020-09-30,Riverside,65,2383286,60580,59074,190,59264,1220
2020-09-30,Sacramento,67,1510023,23171,22613,20,22633,429
2020-09-30,San Benito,69,59416,1355,1342,0,1342,12
2020-09-30,San Bernardino,71,2135413,56001,53988,69,54057,1018
2020-09-30,San Diego,73,3302833,49126,47182,0,47182,783
2020-09-30,San Francisco,75,870044,11499,11247,36,11283,106
2020-09-30,San Joaquin,77,732212,20512,20150,64,20214,461
2020-09-30,San Luis Obispo,79,281455,3752,3597,13,3610,31
2020-09-30,San Mateo,81,765935,10425,9634,7,9641,128
2020-09-30,Santa Barbara,83,443738,9663,9186,111,9297,115
2020-09-30,Santa Clara,85,1922200,22322,21318,34,21352,302
2020-09-30,Santa Cruz,87,273765,2514,2405,34,2439,10
2020-09-30,Shasta,89,179085,1344,976,13,989,17
2020-09-30,Sierra,91,2930,6,6,0,6,0
2020-09-30,Siskiyou,93,43540,162,150,10,160,0
2020-09-30,Solano,95,438530,6492,6315,41,6356,51
2020-09-30,Sonoma,97,501317,7990,7494,22,7516,125
2020-09-30,Stanislaus,99,539301,16658,16531,576,17107,343
2020-09-30,Sutter,101,95872,1710,1680,1,1681,10
2020-09-30,Tehama,103,63373,647,594,4,598,3
2020-09-30,Trinity,105,12862,28,15,5,20,0
2020-09-30,Tulare,107,460477,16518,16117,157,16274,274
2020-09-30,Tuolumne,109,53932,233,224,27,251,2
2020-09-30,Ventura,111,848112,13476,12968,186,13154,145
2020-09-30,Yolo,113,214977,2887,2822,6,2828,55
2020-09-30,Yuba,115,75493,1111,1075,6,1081,8
2020-09-29,Alameda,1,1643700,21700,21241,193,21434,374
2020-09-29,Alpine,3,1148,4,2,0,2,0
2020-09-29,Amador,5,37829,298,294,0,294,16
2020-09-29,Butte,7,227075,2946,2848,20,2868,44
2020-09-29,Calaveras,9,45235,311,261,1,262,11
2020-09-29,Colusa,11,21464,534,534,0,534,6
2020-09-29,Contra Costa,13,1133247,17423,16716,85,16801,209
2020-09-29,Del Norte,15,27424,143,142,0,142,2
2020-09-29,El Dorado,17,186661,1224,1151,1,1152,4
2020-09-29,Fresno,19,978130,30756,28621,374,28995,394
2020-09-29,Glenn,21,27897,603,589,0,589,3
2020-09-29,Humboldt,23,135768,516,497,0,497,6
2020-09-29,Imperial,25,180216,11980,10811,7,10818,283
2020-09-29,Inyo,27,18085,196,188,0,188,14
2020-09-29,Kern,29,883053,32248,31534,335,31869,397
2020-09-29,Kings,31,150075,7945,7681,43,7724,78
2020-09-29,Lake,33,64148,593,566,0,566,11
2020-09-29,Lassen,35,31185,748,741,1,742,0
2020-09-29,Los Angeles,37,10098052,272808,269246,2050,271296,6545
2020-09-29,Madera,39,155013,4631,4453,27,4480,47
2020-09-29,Marin,41,260295,6774,6692,16,6708,91
2020-09-29,Mariposa,43,17540,78,74,0,74,2
2020-09-29,Mendocino,45,87422,918,854,2,856,17
2020-09-29,Merced,47,269075,9007,8892,20,8912,136
2020-09-29,Modoc,49,8938,29,26,0,26,0
2020-09-29,Mono,51,14174,169,149,1,150,1
2020-09-29,Monterey,53,433212,10154,9826,31,9857,70
2020-09-29,Napa,55,140530,1772,1727,5,1732,11
2020-09-29,Nevada,57,99092,554,539,14,553,6
2020-09-29,Orange,59,3164182,55627,52755,1516,54271,1231
2020-09-29,Placer,61,380077,3700,3570,15,3585,42
2020-09-29,Plumas,63,18699,51,48,0,48,0
2020-09-29,Riverside,65,2383286,60251,58863,181,59044,1208
2020-09-29,Sacramento,67,1510023,23050,22547,20,22567,425
2020-09-29,San Benito,69,59416,1350,1341,0,1341,12
2020-09-29,San Bernardino,71,2135413,55694,53753,69,53822,1012
2020-09-29,San Diego,73,3302833,48851,46987,0,46987,781
2020-09-29,San Francisco,75,870044,11463,11142,36,11178,104
2020-09-29,San Joaquin,77,732212,20447,20094,62,20156,454
2020-09-29,San Luis Obispo,79,281455,3732,3581,13,3594,31
2020-09-29,San Mateo,81,765935,10379,9619,7,9626,127
2020-09-29,Santa Barbara,83,443738,9643,9149,110,9259,114
2020-09-29,Santa Clara,85,1922200,22189,21233,33,21266,302
2020-09-29,Santa Cruz,87,273765,2499,2383,33,2416,10
2020-09-29,Shasta,89,179085,1283,943,13,956,17
2020-09-29,Sierra,91,2930,6,6,0,6,0
2020-09-29,Siskiyou,93,43540,156,150,10,160,0
2020-09-29,Solano,95,438530,6458,6303,41,6344,51
2020-09-29,Sonoma,97,501317,7918,7426,22,7448,125
2020-09-29,Stanislaus,99,539301,16628,16505,570,17075,341
2020-09-29,Sutter,101,95872,1704,1677,1,1678,10
2020-09-29,Tehama,103,63373,629,585,4,589,2
2020-09-29,Trinity,105,12862,28,16,5,21,0
2020-09-29,Tulare,107,460477,16455,16055,148,16203,270
2020-09-29,Tuolumne,109,53932,233,224,27,251,2
2020-09-29,Ventura,111,848112,13421,12875,183,13058,145
2020-09-29,Yolo,113,214977,2874,2818,6,2824,55
2020-09-29,Yuba,115,75493,1109,1071,6,1077,8
2020-09-28,Alameda,1,1643700,21615,21133,193,21326,370
2020-09-28,Alpine,3,1148,4,2,0,2,0
2020-09-28,Amador,5,37829,296,294,0,294,16
2020-09-28,Butte,7,227075,2931,2837,20,2857,44
2020-09-28,Calaveras,9,45235,311,257,1,258,11
2020-09-28,Colusa,11,21464,533,531,0,531,6
2020-09-28,Contra Costa,13,1133247,17358,16653,85,16738,195
2020-09-28,Del Norte,15,27424,143,138,0,138,2
2020-09-28,El Dorado,17,186661,1217,1144,1,1145,4
2020-09-28,Fresno,19,978130,30674,28517,367,28884,389
2020-09-28,Glenn,21,27897,601,585,0,585,3
2020-09-28,Humboldt,23,135768,510,495,0,495,6
2020-09-28,Imperial,25,180216,11946,10777,7,10784,283
2020-09-28,Inyo,27,18085,195,188,0,188,14
2020-09-28,Kern,29,883053,32183,31481,331,31812,395
2020-09-28,Kings,31,150075,7804,7661,41,7702,78
2020-09-28,Lake,33,64148,589,559,0,559,10
2020-09-28,Lassen,35,31185,747,737,1,738,0
2020-09-28,Los Angeles,37,10098052,271694,268404,2019,270423,6508
2020-09-28,Madera,39,155013,4610,4438,27,4465,47
2020-09-28,Marin,41,260295,6758,6676,16,6692,91
2020-09-28,Mariposa,43,17540,78,74,0,74,2
2020-09-28,Mendocino,45,87422,904,850,2,852,17
2020-09-28,Merced,47,269075,8979,8869,20,8889,136
2020-09-28,Modoc,49,8938,29,26,0,26,0
2020-09-28,Mono,51,14174,169,148,1,149,1
2020-09-28,Monterey,53,433212,10090,9780,29,9809,69
2020-09-28,Napa,55,140530,1760,1705,5,1710,11
2020-09-28,Nevada,57,99092,546,538,14,552,6
2020-09-28,Orange,59,3164182,55421,52633,1507,54140,1196
2020-09-28,Placer,61,380077,3681,3572,15,3587,42
2020-09-28,Plumas,63,18699,50,48,0,48,0
2020-09-28,Riverside,65,2383286,59952,58570,172,58742,1198
2020-09-28,Sacramento,67,1510023,22902,22392,20,22412,423
2020-09-28,San Benito,69,59416,1347,1336,0,1336,11
2020-09-28,San Bernardino,71,2135413,55352,53501,69,53570,988
2020-09-28,San Diego,73,3302833,48533,46736,0,46736,776
2020-09-28,San Francisco,75,870044,11429,11114,36,11150,100
2020-09-28,San Joaquin,77,732212,20398,19982,61,20043,448
2020-09-28,San Luis Obispo,79,281455,3711,3567,13,3580,31
2020-09-28,San Mateo,81,765935,10329,9582,7,9589,127
2020-09-28,Santa Barbara,83,443738,9626,9121,110,9231,114
2020-09-28,Santa Clara,85,1922200,22073,21180,33,21213,271
2020-09-28,Santa Cruz,87,273765,2489,2359,33,2392,9
2020-09-28,Shasta,89,179085,1229,883,10,893,17
2020-09-28,Sierra,91,2930,6,6,0,6,0
2020-09-28,Siskiyou,93,43540,156,149,10,159,0
2020-09-28,Solano,95,438530,6422,6254,41,6295,51
2020-09-28,Sonoma,97,501317,7842,7369,22,7391,125
2020-09-28,Stanislaus,99,539301,16588,16467,563,17030,336
2020-09-28,Sutter,101,95872,1697,1676,1,1677,10
2020-09-28,Tehama,103,63373,621,579,4,583,2
2020-09-28,Trinity,105,12862,28,16,5,21,0
2020-09-28,Tulare,107,460477,16403,15918,142,16060,270
2020-09-28,Tuolumne,109,53932,233,225,27,252,2
2020-09-28,Ventura,111,848112,13345,12812,176,12988,139
2020-09-28,Yolo,113,214977,2857,2809,6,2815,55
2020-09-28,Yuba,115,75493,1106,1062,6,1068,7
2020-09-27,Alameda,1,1643700,21535,21077,188,21265,370
2020-09-27,Alpine,3,1148,4,2,0,2,0
2020-09-27,Amador,5,37829,296,291,0,291,16
2020-09-27,Butte,7,227075,2920,2833,19,2852,44
2020-09-27,Calaveras,9,45235,310,257,1,258,11
2020-09-27,Colusa,11,21464,532,531,0,531,6
2020-09-27,Contra Costa,13,1133247,17256,16596,84,16680,195
2020-09-27,Del Norte,15,27424,143,138,0,138,2
2020-09-27,El Dorado,17,186661,1202,1130,1,1131,4
2020-09-27,Fresno,19,978130,30569,28441,366,28807,389
2020-09-27,Glenn,21,27897,597,576,0,576,3
2020-09-27,Humboldt,23,135768,508,492,0,492,6
2020-09-27,Imperial,25,180216,11912,10743,7,10750,283
2020-09-27,Inyo,27,18085,193,188,0,188,14
2020-09-27,Kern,29,883053,32064,31462,328,31790,395
2020-09-27,Kings,31,150075,7784,7641,41,7682,78
2020-09-27,Lake,33,64148,585,555,0,555,10
2020-09-27,Lassen,35,31185,747,737,1,738,0
2020-09-27,Los Angeles,37,10098052,270520,267754,1997,269751,6507
2020-09-27,Madera,39,155013,4581,4416,27,4443,47
2020-09-27,Marin,41,260295,6748,6663,16,6679,91
2020-09-27,Mariposa,43,17540,78,74,0,74,2
2020-09-27,Mendocino,45,87422,898,846,2,848,17
2020-09-27,Merced,47,269075,8945,8853,20,8873,136
2020-09-27,Modoc,49,8938,29,26,0,26,0
2020-09-27,Mono,51,14174,169,148,1,149,1
2020-09-27,Monterey,53,433212,10030,9724,28,9752,69
2020-09-27,Napa,55,140530,1755,1690,5,1695,11
2020-09-27,Nevada,57,99092,545,537,14,551,6
2020-09-27,Orange,59,3164182,55149,52458,1497,53955,1195
2020-09-27,Placer,61,380077,3668,3562,15,3577,42
2020-09-27,Plumas,63,18699,50,48,0,48,0
2020-09-27,Riverside,65,2383286,59656,58509,164,58673,1191
2020-09-27,Sacramento,67,1510023,22806,22356,19,22375,422
2020-09-27,San Benito,69,59416,1347,1331,0,1331,11
2020-09-27,San Bernardino,71,2135413,54916,53127,69,53196,988
2020-09-27,San Diego,73,3302833,48189,46612,0,46612,776
2020-09-27,San Francisco,75,870044,11373,11114,36,11150,100
2020-09-27,San Joaquin,77,732212,20338,19981,61,20042,448
2020-09-27,San Luis Obispo,79,281455,3690,3562,13,3575,31
2020-09-27,San Mateo,81,765935,10261,9566,7,9573,127
2020-09-27,Santa Barbara,83,443738,9605,9090,108,9198,114
2020-09-27,Santa Clara,85,1922200,21964,21091,33,21124,271
2020-09-27,Santa Cruz,87,273765,2467,2359,33,2392,9
2020-09-27,Shasta,89,179085,1186,883,9,892,17
2020-09-27,Sierra,91,2930,6,6,0,6,0
2020-09-27,Siskiyou,93,43540,155,149,10,159,0
2020-09-27,Solano,95,438530,6387,6211,41,6252,51
2020-09-27,Sonoma,97,501317,7761,7336,22,7358,124
2020-09-27,Stanislaus,99,539301,16538,16448,556,17004,336
2020-09-27,Sutter,101,95872,1690,1672,1,1673,10
2020-09-27,Tehama,103,63373,604,573,4,577,2
2020-09-27,Trinity,105,12862,28,16,5,21,0
2020-09-27,Tulare,107,460477,16327,15918,132,16050,270
2020-09-27,Tuolumne,109,53932,232,224,27,251,2
2020-09-27,Ventura,111,848112,13260,12775,167,12942,139
2020-09-27,Yolo,113,214977,2843,2796,6,2802,55
2020-09-27,Yuba,115,75493,1096,1059,6,1065,7
2020-09-26,Alameda,1,1643700,21478,21019,187,21206,370
2020-09-26,Alpine,3,1148,4,2,0,2,0
2020-09-26,Amador,5,37829,295,291,0,291,16
2020-09-26,Butte,7,227075,2912,2827,19,2846,44
2020-09-26,Calaveras,9,45235,310,257,1,258,11
2020-09-26,Colusa,11,21464,532,529,0,529,6
2020-09-26,Contra Costa,13,1133247,17214,16508,84,16592,194
2020-09-26,Del Norte,15,27424,143,138,0,138,2
2020-09-26,El Dorado,17,186661,1197,1127,1,1128,4
2020-09-26,Fresno,19,978130,30502,28336,366,28702,389
2020-09-26,Glenn,21,27897,597,576,0,576,3
2020-09-26,Humboldt,23,135768,508,491,0,491,6
2020-09-26,Imperial,25,180216,11895,10721,7,10728,283
2020-09-26,Inyo,27,18085,192,187,0,187,14
2020-09-26,Kern,29,883053,32013,31410,328,31738,394
2020-09-26,Kings,31,150075,7772,7537,41,7578,78
2020-09-26,Lake,33,64148,582,549,0,549,10
2020-09-26,Lassen,35,31185,747,737,1,738,0
2020-09-26,Los Angeles,37,10098052,269885,266931,1980,268911,6497
2020-09-26,Madera,39,155013,4565,4410,27,4437,47
2020-09-26,Marin,41,260295,6735,6641,16,6657,91
2020-09-26,Mariposa,43,17540,77,74,0,74,2
2020-09-26,Mendocino,45,87422,893,836,2,838,17
2020-09-26,Merced,47,269075,8933,8841,19,8860,136
2020-09-26,Modoc,49,8938,29,26,0,26,0
2020-09-26,Mono,51,14174,169,148,1,149,1
2020-09-26,Monterey,53,433212,10003,9651,28,9679,68
2020-09-26,Napa,55,140530,1753,1681,5,1686,11
2020-09-26,Nevada,57,99092,545,534,14,548,6
2020-09-26,Orange,59,3164182,55009,52203,1491,53694,1194
2020-09-26,Placer,61,380077,3655,3551,15,3566,42
2020-09-26,Plumas,63,18699,49,48,0,48,0
2020-09-26,Riverside,65,2383286,59521,58076,162,58238,1190
2020-09-26,Sacramento,67,1510023,22749,22269,19,22288,421
2020-09-26,San Benito,69,59416,1345,1325,0,1325,11
2020-09-26,San Bernardino,71,2135413,54783,53122,69,53191,988
2020-09-26,San Diego,73,3302833,47984,46333,0,46333,775
2020-09-26,San Francisco,75,870044,11345,11113,36,11149,100
2020-09-26,San Joaquin,77,732212,20302,19982,59,20041,449
2020-09-26,San Luis Obispo,79,281455,3673,3546,13,3559,31
2020-09-26,San Mateo,81,765935,10227,9509,7,9516,127
2020-09-26,Santa Barbara,83,443738,9594,9061,108,9169,114
2020-09-26,Santa Clara,85,1922200,21893,20967,32,20999,270
2020-09-26,Santa Cruz,87,273765,2459,2336,33,2369,9
2020-09-26,Shasta,89,179085,1136,856,8,864,17
2020-09-26,Sierra,91,2930,6,6,0,6,0
2020-09-26,Siskiyou,93,43540,154,149,10,159,0
2020-09-26,Solano,95,438530,6368,6209,41,6250,51
2020-09-26,Sonoma,97,501317,7736,7285,21,7306,124
2020-09-26,Stanislaus,99,539301,16513,16421,547,16968,336
2020-09-26,Sutter,101,95872,1685,1662,1,1663,10
2020-09-26,Tehama,103,63373,592,560,4,564,2
2020-09-26,Trinity,105,12862,26,16,5,21,0
2020-09-26,Tulare,107,460477,16303,15881,130,16011,270
2020-09-26,Tuolumne,109,53932,232,223,27,250,2
2020-09-26,Ventura,111,848112,13228,12729,165,12894,137
2020-09-26,Yolo,113,214977,2841,2789,6,2795,55
2020-09-26,Yuba,115,75493,1092,1056,6,1062,7
2020-09-25,Alameda,1,1643700,21424,20911,187,21098,367
2020-09-25,Alpine,3,1148,4,2,0,2,0
2020-09-25,Amador,5,37829,295,289,0,289,16
2020-09-25,Butte,7,227075,2907,2819,19,2838,43
2020-09-25,Calaveras,9,45235,310,257,1,258,11
2020-09-25,Colusa,11,21464,532,528,0,528,6
2020-09-25,Contra Costa,13,1133247,17155,16401,84,16485,194
2020-09-25,Del Norte,15,27424,143,138,0,138,2
2020-09-25,El Dorado,17,186661,1193,1104,1,1105,4
2020-09-25,Fresno,19,978130,30444,28199,365,28564,385
2020-09-25,Glenn,21,27897,595,570,0,570,3
2020-09-25,Humboldt,23,135768,507,489,0,489,5
2020-09-25,Imperial,25,180216,11877,10681,7,10688,283
2020-09-25,Inyo,27,18085,190,187,0,187,14
2020-09-25,Kern,29,883053,31961,31333,326,31659,393
2020-09-25,Kings,31,150075,7767,7450,41,7491,77
2020-09-25,Lake,33,64148,581,539,0,539,9
2020-09-25,Lassen,35,31185,747,737,1,738,0
2020-09-25,Los Angeles,37,10098052,269097,265713,1966,267679,6483
2020-09-25,Madera,39,155013,4546,4369,27,4396,48
2020-09-25,Marin,41,260295,6732,6622,16,6638,90
2020-09-25,Mariposa,43,17540,77,74,0,74,2
2020-09-25,Mendocino,45,87422,879,819,2,821,17
2020-09-25,Merced,47,269075,8917,8830,19,8849,135
2020-09-25,Modoc,49,8938,29,26,0,26,0
2020-09-25,Mono,51,14174,169,149,1,150,1
2020-09-25,Monterey,53,433212,9951,9581,28,9609,68
2020-09-25,Napa,55,140530,1751,1669,5,1674,11
2020-09-25,Nevada,57,99092,543,529,14,543,6
2020-09-25,Orange,59,3164182,54882,52031,1482,53513,1184
2020-09-25,Placer,61,380077,3644,3527,15,3542,41
2020-09-25,Plumas,63,18699,49,48,0,48,0
2020-09-25,Riverside,65,2383286,59345,57783,157,57940,1183
2020-09-25,Sacramento,67,1510023,22671,22132,19,22151,418
2020-09-25,San Benito,69,59416,1344,1318,0,1318,11
2020-09-25,San Bernardino,71,2135413,54629,52814,69,52883,987
2020-09-25,San Diego,73,3302833,47782,46003,0,46003,775
2020-09-25,San Francisco,75,870044,11310,11066,34,11100,100
2020-09-25,San Joaquin,77,732212,20250,19909,59,19968,449
2020-09-25,San Luis Obispo,79,281455,3663,3512,13,3525,31
2020-09-25,San Mateo,81,765935,10191,9447,7,9454,127
2020-09-25,Santa Barbara,83,443738,9570,9026,108,9134,114
2020-09-25,Santa Clara,85,1922200,21830,20812,31,20843,265
2020-09-25,Santa Cruz,87,273765,2447,2309,32,2341,9
2020-09-25,Shasta,89,179085,1102,806,8,814,16
2020-09-25,Sierra,91,2930,6,6,0,6,0
2020-09-25,Siskiyou,93,43540,154,149,10,159,0
2020-09-25,Solano,95,438530,6352,6179,41,6220,50
2020-09-25,Sonoma,97,501317,7696,7202,21,7223,124
2020-09-25,Stanislaus,99,539301,16495,16381,545,16926,326
2020-09-25,Sutter,101,95872,1682,1655,1,1656,10
2020-09-25,Tehama,103,63373,584,546,4,550,2
2020-09-25,Trinity,105,12862,26,15,5,20,0
2020-09-25,Tulare,107,460477,16264,15815,127,15942,267
2020-09-25,Tuolumne,109,53932,232,223,27,250,2
2020-09-25,Ventura,111,848112,13186,12664,162,12826,137
2020-09-25,Yolo,113,214977,2833,2784,6,2790,55
2020-09-25,Yuba,115,75493,1087,1049,6,1055,5
2020-09-24,Alameda,1,1643700,21349,20838,184,21022,364
2020-09-24,Alpine,3,1148,4,2,0,2,0
2020-09-24,Amador,5,37829,295,288,0,288,16
2020-09-24,Butte,7,227075,2896,2803,19,2822,43
2020-09-24,Calaveras,9,45235,310,258,1,259,11
2020-09-24,Colusa,11,21464,532,523,0,523,6
2020-09-24,Contra Costa,13,1133247,17073,16252,84,16336,192
2020-09-24,Del Norte,15,27424,139,137,0,137,2
2020-09-24,El Dorado,17,186661,1184,1093,1,1094,4
2020-09-24,Fresno,19,978130,30340,28106,361,28467,375
2020-09-24,Glenn,21,27897,591,567,0,567,3
2020-09-24,Humboldt,23,135768,504,482,0,482,5
2020-09-24,Imperial,25,180216,11853,10622,7,10629,283
2020-09-24,Inyo,27,18085,190,187,0,187,13
2020-09-24,Kern,29,883053,31898,31273,324,31597,388
2020-09-24,Kings,31,150075,7751,7428,41,7469,76
2020-09-24,Lake,33,64148,572,531,0,531,9
2020-09-24,Lassen,35,31185,746,737,1,738,0
2020-09-24,Los Angeles,37,10098052,268052,264374,1947,266321,6452
2020-09-24,Madera,39,155013,4527,4344,27,4371,48
2020-09-24,Marin,41,260295,6704,6588,16,6604,85
2020-09-24,Mariposa,43,17540,77,74,0,74,2
2020-09-24,Mendocino,45,87422,875,810,2,812,17
2020-09-24,Merced,47,269075,8888,8813,18,8831,135
2020-09-24,Modoc,49,8938,29,24,0,24,0
2020-09-24,Mono,51,14174,169,149,1,150,1
2020-09-24,Monterey,53,433212,9885,9544,25,9569,67
2020-09-24,Napa,55,140530,1739,1661,5,1666,11
2020-09-24,Nevada,57,99092,542,527,14,541,6
2020-09-24,Orange,59,3164182,54674,51749,1464,53213,1164
2020-09-24,Placer,61,380077,3629,3514,15,3529,41
2020-09-24,Plumas,63,18699,49,48,0,48,0
2020-09-24,Riverside,65,2383286,59077,57491,151,57642,1172
2020-09-24,Sacramento,67,1510023,22545,21985,19,22004,417
2020-09-24,San Benito,69,59416,1342,1308,0,1308,11
2020-09-24,San Bernardino,71,2135413,54294,52455,69,52524,988
2020-09-24,San Diego,73,3302833,47513,45598,0,45598,773
2020-09-24,San Francisco,75,870044,11263,10992,34,11026,99
2020-09-24,San Joaquin,77,732212,20213,19851,58,19909,444
2020-09-24,San Luis Obispo,79,281455,3647,3480,13,3493,31
2020-09-24,San Mateo,81,765935,10143,9376,7,9383,127
2020-09-24,Santa Barbara,83,443738,9519,8988,106,9094,114
2020-09-24,Santa Clara,85,1922200,21742,20689,31,20720,262
2020-09-24,Santa Cruz,87,273765,2427,2300,30,2330,9
2020-09-24,Shasta,89,179085,1065,773,5,778,14
2020-09-24,Sierra,91,2930,6,6,0,6,0
2020-09-24,Siskiyou,93,43540,154,149,10,159,0
2020-09-24,Solano,95,438530,6319,6137,41,6178,49
2020-09-24,Sonoma,97,501317,7615,7163,20,7183,122
2020-09-24,Stanislaus,99,539301,16458,16326,540,16866,326
2020-09-24,Sutter,101,95872,1679,1646,1,1647,10
2020-09-24,Tehama,103,63373,581,540,4,544,2
2020-09-24,Trinity,105,12862,26,15,5,20,0
2020-09-24,Tulare,107,460477,16199,15754,126,15880,267
2020-09-24,Tuolumne,109,53932,232,224,27,251,2
2020-09-24,Ventura,111,848112,13104,12617,161,12778,138
2020-09-24,Yolo,113,214977,2826,2776,6,2782,55
2020-09-24,Yuba,115,75493,1082,1042,6,1048,5
2020-09-23,Alameda,1,1643700,21281,20718,182,20900,361
2020-09-23,Alpine,3,1148,4,2,0,2,0
2020-09-23,Amador,5,37829,294,288,0,288,16
2020-09-23,Butte,7,227075,2888,2790,19,2809,43
2020-09-23,Calaveras,9,45235,309,258,1,259,11
2020-09-23,Colusa,11,21464,531,521,0,521,6
2020-09-23,Contra Costa,13,1133247,17009,16167,83,16250,192
2020-09-23,Del Norte,15,27424,137,137,0,137,2
2020-09-23,El Dorado,17,186661,1170,1088,1,1089,4
2020-09-23,Fresno,19,978130,30247,28019,358,28377,371
2020-09-23,Glenn,21,27897,584,561,0,561,3
2020-09-23,Humboldt,23,135768,499,477,0,477,5
2020-09-23,Imperial,25,180216,11827,10587,7,10594,284
2020-09-23,Inyo,27,18085,189,177,0,177,13
2020-09-23,Kern,29,883053,31854,31172,323,31495,387
2020-09-23,Kings,31,150075,7729,7406,41,7447,76
2020-09-23,Lake,33,64148,567,519,0,519,9
2020-09-23,Lassen,35,31185,746,736,1,737,0
2020-09-23,Los Angeles,37,10098052,267005,263318,1917,265235,6421
2020-09-23,Madera,39,155013,4512,4311,27,4338,48
2020-09-23,Marin,41,260295,6685,6567,16,6583,85
2020-09-23,Mariposa,43,17540,77,74,0,74,2
2020-09-23,Mendocino,45,87422,874,801,1,802,17
2020-09-23,Merced,47,269075,8867,8785,17,8802,134
2020-09-23,Modoc,49,8938,29,24,0,24,0
2020-09-23,Mono,51,14174,169,149,1,150,1
2020-09-23,Monterey,53,433212,9816,9452,25,9477,67
2020-09-23,Napa,55,140530,1730,1653,5,1658,11
2020-09-23,Nevada,57,99092,541,523,14,537,6
2020-09-23,Orange,59,3164182,54446,51658,1458,53116,1155
2020-09-23,Placer,61,380077,3617,3506,15,3521,41
2020-09-23,Plumas,63,18699,49,48,0,48,0
2020-09-23,Riverside,65,2383286,58774,57257,148,57405,1165
2020-09-23,Sacramento,67,1510023,22468,21821,19,21840,415
2020-09-23,San Benito,69,59416,1336,1305,0,1305,10
2020-09-23,San Bernardino,71,2135413,54000,52132,68,52200,973
2020-09-23,San Diego,73,3302833,47237,45427,0,45427,767
2020-09-23,San Francisco,75,870044,11214,10926,34,10960,95
2020-09-23,San Joaquin,77,732212,20160,19785,58,19843,439
2020-09-23,San Luis Obispo,79,281455,3629,3447,13,3460,31
2020-09-23,San Mateo,81,765935,10103,9351,7,9358,127
2020-09-23,Santa Barbara,83,443738,9491,8952,104,9056,112
2020-09-23,Santa Clara,85,1922200,21632,20575,28,20603,260
2020-09-23,Santa Cruz,87,273765,2408,2283,30,2313,9
2020-09-23,Shasta,89,179085,1026,756,4,760,14
2020-09-23,Sierra,91,2930,6,6,0,6,0
2020-09-23,Siskiyou,93,43540,154,149,10,159,0
2020-09-23,Solano,95,438530,6294,6123,41,6164,50
2020-09-23,Sonoma,97,501317,7539,7091,20,7111,122
2020-09-23,Stanislaus,99,539301,16428,16271,537,16808,317
2020-09-23,Sutter,101,95872,1675,1646,1,1647,10
2020-09-23,Tehama,103,63373,575,533,4,537,2
2020-09-23,Trinity,105,12862,26,15,5,20,0
2020-09-23,Tulare,107,460477,16135,15664,124,15788,266
2020-09-23,Tuolumne,109,53932,232,223,27,250,2
2020-09-23,Ventura,111,848112,13049,12591,157,12748,137
2020-09-23,Yolo,113,214977,2808,2766,6,2772,55
2020-09-23,Yuba,115,75493,1080,1038,6,1044,5
2020-09-22,Alameda,1,1643700,21202,20607,180,20787,355
2020-09-22,Alpine,3,1148,3,2,0,2,0
2020-09-22,Amador,5,37829,293,287,0,287,16
2020-09-22,Butte,7,227075,2883,2776,19,2795,43
2020-09-22,Calaveras,9,45235,309,258,1,259,11
2020-09-22,Colusa,11,21464,529,518,0,518,6
2020-09-22,Contra Costa,13,1133247,16919,16090,83,16173,190
2020-09-22,Del Norte,15,27424,137,137,0,137,2
2020-09-22,El Dorado,17,186661,1151,1076,1,1077,4
2020-09-22,Fresno,19,978130,30153,27944,355,28299,369
2020-09-22,Glenn,21,27897,581,560,0,560,3
2020-09-22,Humboldt,23,135768,498,476,0,476,5
2020-09-22,Imperial,25,180216,11798,10529,7,10536,284
2020-09-22,Inyo,27,18085,189,177,0,177,13
2020-09-22,Kern,29,883053,31786,31110,316,31426,383
2020-09-22,Kings,31,150075,7672,7395,40,7435,76
2020-09-22,Lake,33,64148,559,516,0,516,9
2020-09-22,Lassen,35,31185,745,736,1,737,0
2020-09-22,Los Angeles,37,10098052,265927,262117,1888,264005,6394
2020-09-22,Madera,39,155013,4496,4303,27,4330,47
2020-09-22,Marin,41,260295,6671,6561,16,6577,84
2020-09-22,Mariposa,43,17540,77,74,0,74,2
2020-09-22,Mendocino,45,87422,854,794,1,795,18
2020-09-22,Merced,47,269075,8837,8769,17,8786,132
2020-09-22,Modoc,49,8938,29,24,0,24,0
2020-09-22,Mono,51,14174,168,149,1,150,1
2020-09-22,Monterey,53,433212,9758,9393,25,9418,67
2020-09-22,Napa,55,140530,1713,1652,5,1657,11
2020-09-22,Nevada,57,99092,541,523,14,537,6
2020-09-22,Orange,59,3164182,54196,51528,1450,52978,1132
2020-09-22,Placer,61,380077,3604,3492,15,3507,40
2020-09-22,Plumas,63,18699,49,48,0,48,0
2020-09-22,Riverside,65,2383286,58290,57066,143,57209,1162
2020-09-22,Sacramento,67,1510023,22349,21745,19,21764,410
2020-09-22,San Benito,69,59416,1331,1305,0,1305,10
2020-09-22,San Bernardino,71,2135413,53727,51899,68,51967,971
2020-09-22,San Diego,73,3302833,46930,45149,0,45149,765
2020-09-22,San Francisco,75,870044,11170,10893,33,10926,95
2020-09-22,San Joaquin,77,732212,20114,19755,56,19811,426
2020-09-22,San Luis Obispo,79,281455,3612,3420,13,3433,31
2020-09-22,San Mateo,81,765935,10065,9291,7,9298,127
2020-09-22,Santa Barbara,83,443738,9461,8927,103,9030,111
2020-09-22,Santa Clara,85,1922200,21515,20514,28,20542,253
2020-09-22,Santa Cruz,87,273765,2385,2264,30,2294,8
2020-09-22,Shasta,89,179085,991,723,4,727,14
2020-09-22,Sierra,91,2930,6,6,0,6,0
2020-09-22,Siskiyou,93,43540,154,149,10,159,0
2020-09-22,Solano,95,438530,6263,6107,41,6148,48
2020-09-22,Sonoma,97,501317,7460,7068,19,7087,117
2020-09-22,Stanislaus,99,539301,16406,16231,529,16760,316
2020-09-22,Sutter,101,95872,1669,1638,1,1639,10
2020-09-22,Tehama,103,63373,567,529,4,533,2
2020-09-22,Trinity,105,12862,26,15,5,20,0
2020-09-22,Tulare,107,460477,16068,15616,120,15736,263
2020-09-22,Tuolumne,109,53932,231,224,27,251,1
2020-09-22,Ventura,111,848112,12998,12507,153,12660,136
2020-09-22,Yolo,113,214977,2801,2763,6,2769,54
2020-09-22,Yuba,115,75493,1071,1035,6,1041,5
2020-09-21,Alameda,1,1643700,21123,20501,179,20680,343
2020-09-21,Alpine,3,1148,3,2,0,2,0
2020-09-21,Amador,5,37829,291,286,0,286,16
2020-09-21,Butte,7,227075,2870,2769,19,2788,41
2020-09-21,Calaveras,9,45235,307,256,1,257,10
2020-09-21,Colusa,11,21464,528,517,0,517,6
2020-09-21,Contra Costa,13,1133247,16831,16008,83,16091,189
2020-09-21,Del Norte,15,27424,137,132,0,132,2
2020-09-21,El Dorado,17,186661,1142,1074,1,1075,4
2020-09-21,Fresno,19,978130,30052,27843,347,28190,362
2020-09-21,Glenn,21,27897,577,556,0,556,3
2020-09-21,Humboldt,23,135768,494,473,0,473,5
2020-09-21,Imperial,25,180216,11767,10521,7,10528,284
2020-09-21,Inyo,27,18085,188,177,0,177,12
2020-09-21,Kern,29,883053,31715,31031,314,31345,379
2020-09-21,Kings,31,150075,7560,7297,38,7335,76
2020-09-21,Lake,33,64148,554,508,0,508,8
2020-09-21,Lassen,35,31185,743,735,1,736,0
2020-09-21,Los Angeles,37,10098052,264841,261418,1842,263260,6360
2020-09-21,Madera,39,155013,4485,4275,26,4301,47
2020-09-21,Marin,41,260295,6658,6538,15,6553,84
2020-09-21,Mariposa,43,17540,76,74,0,74,2
2020-09-21,Mendocino,45,87422,839,778,0,778,18
2020-09-21,Merced,47,269075,8818,8749,15,8764,128
2020-09-21,Modoc,49,8938,29,22,0,22,0
2020-09-21,Mono,51,14174,168,147,1,148,1
2020-09-21,Monterey,53,433212,9694,9331,22,9353,66
2020-09-21,Napa,55,140530,1702,1641,5,1646,11
2020-09-21,Nevada,57,99092,539,515,14,529,6
2020-09-21,Orange,59,3164182,53977,51363,1443,52806,1110
2020-09-21,Placer,61,380077,3594,3473,15,3488,40
2020-09-21,Plumas,63,18699,49,47,0,47,0
2020-09-21,Riverside,65,2383286,58017,57001,135,57136,1153
2020-09-21,Sacramento,67,1510023,22167,21568,19,21587,404
2020-09-21,San Benito,69,59416,1329,1298,0,1298,10
2020-09-21,San Bernardino,71,2135413,53442,51654,68,51722,970
2020-09-21,San Diego,73,3302833,46647,44927,0,44927,760
2020-09-21,San Francisco,75,870044,11122,10743,33,10776,95
2020-09-21,San Joaquin,77,732212,20056,19579,56,19635,423
2020-09-21,San Luis Obispo,79,281455,3585,3406,13,3419,27
2020-09-21,San Mateo,81,765935,10013,9239,7,9246,127
2020-09-21,Santa Barbara,83,443738,9433,8911,103,9014,110
2020-09-21,Santa Clara,85,1922200,21415,20432,28,20460,252
2020-09-21,Santa Cruz,87,273765,2368,2257,28,2285,8
2020-09-21,Shasta,89,179085,941,696,4,700,14
2020-09-21,Sierra,91,2930,6,6,0,6,0
2020-09-21,Siskiyou,93,43540,154,146,10,156,0
2020-09-21,Solano,95,438530,6239,6019,41,6060,46
2020-09-21,Sonoma,97,501317,7384,7017,19,7036,117
2020-09-21,Stanislaus,99,539301,16376,16186,529,16715,310
2020-09-21,Sutter,101,95872,1662,1634,1,1635,10
2020-09-21,Tehama,103,63373,548,513,4,517,2
2020-09-21,Trinity,105,12862,26,15,5,20,0
2020-09-21,Tulare,107,460477,15994,15528,111,15639,260
2020-09-21,Tuolumne,109,53932,231,221,27,248,1
2020-09-21,Ventura,111,848112,12916,12477,147,12624,133
2020-09-21,Yolo,113,214977,2795,2752,6,2758,54
2020-09-21,Yuba,115,75493,1067,1033,6,1039,1
2020-09-20,Alameda,1,1643700,21023,20425,176,20601,343
2020-09-20,Alpine,3,1148,3,2,0,2,0
2020-09-20,Amador,5,37829,290,286,0,286,16
2020-09-20,Butte,7,227075,2858,2764,19,2783,39
2020-09-20,Calaveras,9,45235,303,256,1,257,10
2020-09-20,Colusa,11,21464,526,510,0,510,6
2020-09-20,Contra Costa,13,1133247,16697,15917,82,15999,189
2020-09-20,Del Norte,15,27424,135,132,0,132,2
2020-09-20,El Dorado,17,186661,1127,1073,1,1074,4
2020-09-20,Fresno,19,978130,29938,27769,341,28110,362
2020-09-20,Glenn,21,27897,573,550,0,550,3
2020-09-20,Humboldt,23,135768,494,472,0,472,5
2020-09-20,Imperial,25,180216,11740,10496,6,10502,284
2020-09-20,Inyo,27,18085,188,177,0,177,12
2020-09-20,Kern,29,883053,31632,30992,311,31303,379
2020-09-20,Kings,31,150075,7513,7159,37,7196,76
2020-09-20,Lake,33,64148,542,492,0,492,8
2020-09-20,Lassen,35,31185,743,735,1,736,0
2020-09-20,Los Angeles,37,10098052,263609,260770,1813,262583,6347
2020-09-20,Madera,39,155013,4466,4257,26,4283,47
2020-09-20,Marin,41,260295,6633,6533,15,6548,83
2020-09-20,Mariposa,43,17540,76,74,0,74,2
2020-09-20,Mendocino,45,87422,827,765,0,765,18
2020-09-20,Merced,47,269075,8791,8745,15,8760,128
2020-09-20,Modoc,49,8938,27,22,0,22,0
2020-09-20,Mono,51,14174,167,147,1,148,1
2020-09-20,Monterey,53,433212,9616,9312,22,9334,65
2020-09-20,Napa,55,140530,1693,1626,5,1631,11
2020-09-20,Nevada,57,99092,536,511,14,525,6
2020-09-20,Orange,59,3164182,53739,51233,1431,52664,1110
2020-09-20,Placer,61,380077,3579,3452,15,3467,40
2020-09-20,Plumas,63,18699,49,47,0,47,0
2020-09-20,Riverside,65,2383286,57823,56783,129,56912,1147
2020-09-20,Sacramento,67,1510023,21980,21394,18,21412,401
2020-09-20,San Benito,69,59416,1318,1291,0,1291,9
2020-09-20,San Bernardino,71,2135413,53122,51559,66,51625,970
2020-09-20,San Diego,73,3302833,46274,44579,0,44579,760
2020-09-20,San Francisco,75,870044,11068,10743,33,10776,95
2020-09-20,San Joaquin,77,732212,19992,19578,48,19626,423
2020-09-20,San Luis Obispo,79,281455,3557,3393,13,3406,27
2020-09-20,San Mateo,81,765935,9946,9198,7,9205,127
2020-09-20,Santa Barbara,83,443738,9399,8880,102,8982,110
2020-09-20,Santa Clara,85,1922200,21295,20330,27,20357,252
2020-09-20,Santa Cruz,87,273765,2348,2199,28,2227,8
2020-09-20,Shasta,89,179085,900,696,3,699,14
2020-09-20,Sierra,91,2930,6,6,0,6,0
2020-09-20,Siskiyou,93,43540,154,146,10,156,0
2020-09-20,Solano,95,438530,6195,6020,41,6061,46
2020-09-20,Sonoma,97,501317,7280,6954,19,6973,117
2020-09-20,Stanislaus,99,539301,16345,16159,522,16681,310
2020-09-20,Sutter,101,95872,1656,1624,1,1625,10
2020-09-20,Tehama,103,63373,535,509,4,513,2
2020-09-20,Trinity,105,12862,26,15,5,20,0
2020-09-20,Tulare,107,460477,15911,15528,105,15633,260
2020-09-20,Tuolumne,109,53932,231,221,27,248,1
2020-09-20,Ventura,111,848112,12853,12406,143,12549,133
2020-09-20,Yolo,113,214977,2787,2745,6,2751,54
2020-09-20,Yuba,115,75493,1060,1029,6,1035,1
2020-09-19,Alameda,1,1643700,20972,20349,173,20522,343
2020-09-19,Alpine,3,1148,3,2,0,2,0
2020-09-19,Amador,5,37829,290,285,0,285,16
2020-09-19,Butte,7,227075,2852,2748,19,2767,38
2020-09-19,Calaveras,9,45235,303,256,1,257,10
2020-09-19,Colusa,11,21464,526,507,0,507,6
2020-09-19,Contra Costa,13,1133247,16634,15783,82,15865,186
2020-09-19,Del Norte,15,27424,134,132,0,132,2
2020-09-19,El Dorado,17,186661,1121,1068,0,1068,4
2020-09-19,Fresno,19,978130,29865,27668,341,28009,362
2020-09-19,Glenn,21,27897,570,547,0,547,3
2020-09-19,Humboldt,23,135768,493,471,0,471,5
2020-09-19,Imperial,25,180216,11725,10496,6,10502,284
2020-09-19,Inyo,27,18085,188,177,0,177,12
2020-09-19,Kern,29,883053,31578,30886,308,31194,379
2020-09-19,Kings,31,150075,7507,7130,37,7167,76
2020-09-19,Lake,33,64148,542,465,0,465,8
2020-09-19,Lassen,35,31185,743,731,1,732,0
2020-09-19,Los Angeles,37,10098052,262986,259801,1797,261598,6325
2020-09-19,Madera,39,155013,4443,4237,26,4263,47
2020-09-19,Marin,41,260295,6626,6513,14,6527,81
2020-09-19,Mariposa,43,17540,76,74,0,74,2
2020-09-19,Mendocino,45,87422,824,750,0,750,18
2020-09-19,Merced,47,269075,8780,8717,14,8731,128
2020-09-19,Modoc,49,8938,27,22,0,22,0
2020-09-19,Mono,51,14174,167,147,1,148,1
2020-09-19,Monterey,53,433212,9574,9237,22,9259,65
2020-09-19,Napa,55,140530,1685,1614,5,1619,11
2020-09-19,Nevada,57,99092,534,505,14,519,6
2020-09-19,Orange,59,3164182,53610,50999,1424,52423,1105
2020-09-19,Placer,61,380077,3571,3412,15,3427,40
2020-09-19,Plumas,63,18699,49,47,0,47,0
2020-09-19,Riverside,65,2383286,57702,56562,128,56690,1147
2020-09-19,Sacramento,67,1510023,21926,21297,18,21315,396
2020-09-19,San Benito,69,59416,1314,1276,0,1276,9
2020-09-19,San Bernardino,71,2135413,52966,51353,64,51417,971
2020-09-19,San Diego,73,3302833,46047,44295,0,44295,773
2020-09-19,San Francisco,75,870044,11035,10741,33,10774,95
2020-09-19,San Joaquin,77,732212,19955,19580,48,19628,424
2020-09-19,San Luis Obispo,79,281455,3536,3369,13,3382,27
2020-09-19,San Mateo,81,765935,9915,9158,7,9165,127
2020-09-19,Santa Barbara,83,443738,9378,8862,102,8964,106
2020-09-19,Santa Clara,85,1922200,21206,20170,27,20197,251
2020-09-19,Santa Cruz,87,273765,2334,2198,28,2226,8
2020-09-19,Shasta,89,179085,872,687,3,690,14
2020-09-19,Sierra,91,2930,6,6,0,6,0
2020-09-19,Siskiyou,93,43540,154,146,10,156,0
2020-09-19,Solano,95,438530,6179,5998,41,6039,46
2020-09-19,Sonoma,97,501317,7246,6905,19,6924,117
2020-09-19,Stanislaus,99,539301,16305,16109,515,16624,313
2020-09-19,Sutter,101,95872,1655,1602,1,1603,10
2020-09-19,Tehama,103,63373,530,498,4,502,2
2020-09-19,Trinity,105,12862,26,15,5,20,0
2020-09-19,Tulare,107,460477,15862,15485,102,15587,260
2020-09-19,Tuolumne,109,53932,231,217,27,244,1
2020-09-19,Ventura,111,848112,12821,12328,143,12471,133
2020-09-19,Yolo,113,214977,2779,2739,6,2745,54
2020-09-19,Yuba,115,75493,1053,1023,6,1029,1
2020-09-18,Alameda,1,1643700,20907,20222,167,20389,341
2020-09-18,Alpine,3,1148,3,2,0,2,0
2020-09-18,Amador,5,37829,290,285,0,285,16
2020-09-18,Butte,7,227075,2850,2738,19,2757,37
2020-09-18,Calaveras,9,45235,303,255,1,256,9
2020-09-18,Colusa,11,21464,526,504,0,504,6
2020-09-18,Contra Costa,13,1133247,16549,15667,82,15749,185
2020-09-18,Del Norte,15,27424,134,131,0,131,2
2020-09-18,El Dorado,17,186661,1108,1063,0,1063,4
2020-09-18,Fresno,19,978130,29801,27560,341,27901,359
2020-09-18,Glenn,21,27897,567,541,0,541,3
2020-09-18,Humboldt,23,135768,490,470,0,470,5
2020-09-18,Imperial,25,180216,11710,10460,6,10466,283
2020-09-18,Inyo,27,18085,188,177,0,177,12
2020-09-18,Kern,29,883053,31520,30742,305,31047,373
2020-09-18,Kings,31,150075,7497,7062,37,7099,74
2020-09-18,Lake,33,64148,536,458,0,458,8
2020-09-18,Lassen,35,31185,742,731,1,732,0
2020-09-18,Los Angeles,37,10098052,262212,258488,1777,260265,6324
2020-09-18,Madera,39,155013,4431,4211,26,4237,45
2020-09-18,Marin,41,260295,6611,6475,14,6489,81
2020-09-18,Mariposa,43,17540,76,74,0,74,2
2020-09-18,Mendocino,45,87422,816,739,0,739,18
2020-09-18,Merced,47,269075,8768,8691,13,8704,127
2020-09-18,Modoc,49,8938,27,22,0,22,0
2020-09-18,Mono,51,14174,165,147,1,148,1
2020-09-18,Monterey,53,433212,9534,9183,22,9205,64
2020-09-18,Napa,55,140530,1679,1604,5,1609,11
2020-09-18,Nevada,57,99092,531,504,14,518,6
2020-09-18,Orange,59,3164182,53463,50733,1411,52144,1107
2020-09-18,Placer,61,380077,3560,3389,15,3404,40
2020-09-18,Plumas,63,18699,49,45,0,45,0
2020-09-18,Riverside,65,2383286,57582,56248,124,56372,1143
2020-09-18,Sacramento,67,1510023,21841,21105,18,21123,391
2020-09-18,San Benito,69,59416,1306,1257,0,1257,8
2020-09-18,San Bernardino,71,2135413,52823,51106,63,51169,970
2020-09-18,San Diego,73,3302833,45797,44009,0,44009,757
2020-09-18,San Francisco,75,870044,10997,10644,32,10676,95
2020-09-18,San Joaquin,77,732212,19912,19531,46,19577,423
2020-09-18,San Luis Obispo,79,281455,3512,3328,13,3341,27
2020-09-18,San Mateo,81,765935,9875,9062,7,9069,127
2020-09-18,Santa Barbara,83,443738,9356,8824,102,8926,107
2020-09-18,Santa Clara,85,1922200,21109,20058,27,20085,252
2020-09-18,Santa Cruz,87,273765,2313,2180,27,2207,8
2020-09-18,Shasta,89,179085,837,668,3,671,14
2020-09-18,Sierra,91,2930,6,6,0,6,0
2020-09-18,Siskiyou,93,43540,153,146,10,156,0
2020-09-18,Solano,95,438530,6163,5961,41,6002,46
2020-09-18,Sonoma,97,501317,7199,6856,19,6875,114
2020-09-18,Stanislaus,99,539301,16277,16042,509,16551,277
2020-09-18,Sutter,101,95872,1647,1586,1,1587,10
2020-09-18,Tehama,103,63373,530,490,4,494,2
2020-09-18,Trinity,105,12862,26,15,4,19,0
2020-09-18,Tulare,107,460477,15829,15435,98,15533,259
2020-09-18,Tuolumne,109,53932,230,216,27,243,1
2020-09-18,Ventura,111,848112,12760,12236,139,12375,133
2020-09-18,Yolo,113,214977,2773,2732,6,2738,54
2020-09-18,Yuba,115,75493,1049,1020,6,1026,1
2020-09-17,Alameda,1,1643700,20809,20146,167,20313,339
2020-09-17,Alpine,3,1148,3,2,0,2,0
2020-09-17,Amador,5,37829,288,284,0,284,16
2020-09-17,Butte,7,227075,2832,2720,19,2739,38
2020-09-17,Calaveras,9,45235,303,254,1,255,9
2020-09-17,Colusa,11,21464,524,499,0,499,6
2020-09-17,Contra Costa,13,1133247,16459,15576,82,15658,184
2020-09-17,Del Norte,15,27424,134,131,0,131,2
2020-09-17,El Dorado,17,186661,1099,1057,0,1057,4
2020-09-17,Fresno,19,978130,29692,27487,336,27823,355
2020-09-17,Glenn,21,27897,566,541,0,541,3
2020-09-17,Humboldt,23,135768,484,466,0,466,5
2020-09-17,Imperial,25,180216,11693,10436,6,10442,281
2020-09-17,Inyo,27,18085,188,176,0,176,12
2020-09-17,Kern,29,883053,31459,30627,298,30925,372
2020-09-17,Kings,31,150075,7426,7015,37,7052,72
2020-09-17,Lake,33,64148,526,433,0,433,8
2020-09-17,Lassen,35,31185,740,731,1,732,0
2020-09-17,Los Angeles,37,10098052,261271,257246,1762,259008,6318
2020-09-17,Madera,39,155013,4397,4152,26,4178,45
2020-09-17,Marin,41,260295,6590,6457,14,6471,81
2020-09-17,Mariposa,43,17540,75,74,0,74,2
2020-09-17,Mendocino,45,87422,805,737,0,737,18
2020-09-17,Merced,47,269075,8749,8671,13,8684,119
2020-09-17,Modoc,49,8938,27,22,0,22,0
2020-09-17,Mono,51,14174,165,147,1,148,1
2020-09-17,Monterey,53,433212,9472,9113,21,9134,62
2020-09-17,Napa,55,140530,1668,1592,5,1597,11
2020-09-17,Nevada,57,99092,529,494,14,508,6
2020-09-17,Orange,59,3164182,53284,50537,1397,51934,1098
2020-09-17,Placer,61,380077,3540,3368,15,3383,40
2020-09-17,Plumas,63,18699,49,45,0,45,0
2020-09-17,Riverside,65,2383286,57359,56007,121,56128,1134
2020-09-17,Sacramento,67,1510023,21609,20895,18,20913,385
2020-09-17,San Benito,69,59416,1303,1252,0,1252,8
2020-09-17,San Bernardino,71,2135413,52622,50770,63,50833,904
2020-09-17,San Diego,73,3302833,45519,43621,0,43621,754
2020-09-17,San Francisco,75,870044,10903,10564,32,10596,95
2020-09-17,San Joaquin,77,732212,19853,19439,46,19485,416
2020-09-17,San Luis Obispo,79,281455,3486,3299,13,3312,27
2020-09-17,San Mateo,81,765935,9833,8984,7,8991,127
2020-09-17,Santa Barbara,83,443738,9332,8779,102,8881,107
2020-09-17,Santa Clara,85,1922200,20994,19825,27,19852,254
2020-09-17,Santa Cruz,87,273765,2297,2155,27,2182,7
2020-09-17,Shasta,89,179085,798,660,3,663,12
2020-09-17,Sierra,91,2930,6,6,0,6,0
2020-09-17,Siskiyou,93,43540,153,146,10,156,0
2020-09-17,Solano,95,438530,6140,5915,41,5956,44
2020-09-17,Sonoma,97,501317,7135,6754,19,6773,114
2020-09-17,Stanislaus,99,539301,16244,15984,505,16489,277
2020-09-17,Sutter,101,95872,1642,1572,1,1573,10
2020-09-17,Tehama,103,63373,516,487,4,491,2
2020-09-17,Trinity,105,12862,26,15,4,19,0
2020-09-17,Tulare,107,460477,15776,15344,96,15440,258
2020-09-17,Tuolumne,109,53932,229,214,27,241,1
2020-09-17,Ventura,111,848112,12675,12167,134,12301,130
2020-09-17,Yolo,113,214977,2764,2724,6,2730,53
2020-09-17,Yuba,115,75493,1045,1015,6,1021,1
2020-09-16,Alameda,1,1643700,20713,20009,165,20174,333
2020-09-16,Alpine,3,1148,3,2,0,2,0
2020-09-16,Amador,5,37829,288,284,0,284,16
2020-09-16,Butte,7,227075,2822,2704,19,2723,38
2020-09-16,Calaveras,9,45235,303,254,1,255,9
2020-09-16,Colusa,11,21464,522,497,0,497,6
2020-09-16,Contra Costa,13,1133247,16373,15473,82,15555,183
2020-09-16,Del Norte,15,27424,134,131,0,131,2
2020-09-16,El Dorado,17,186661,1091,1049,0,1049,4
2020-09-16,Fresno,19,978130,29587,27381,334,27715,343
2020-09-16,Glenn,21,27897,564,539,0,539,3
2020-09-16,Humboldt,23,135768,483,455,0,455,4
2020-09-16,Imperial,25,180216,11670,10401,6,10407,277
2020-09-16,Inyo,27,18085,187,176,0,176,12
2020-09-16,Kern,29,883053,31400,30570,297,30867,371
2020-09-16,Kings,31,150075,7401,7002,35,7037,71
2020-09-16,Lake,33,64148,515,417,0,417,6
2020-09-16,Lassen,35,31185,739,730,1,731,0
2020-09-16,Los Angeles,37,10098052,260274,256101,1743,257844,6299
2020-09-16,Madera,39,155013,4374,4138,26,4164,45
2020-09-16,Marin,41,260295,6563,6430,14,6444,77
2020-09-16,Mariposa,43,17540,75,74,0,74,2
2020-09-16,Mendocino,45,87422,796,727,0,727,18
2020-09-16,Merced,47,269075,8728,8646,13,8659,118
2020-09-16,Modoc,49,8938,27,22,0,22,0
2020-09-16,Mono,51,14174,165,147,1,148,1
2020-09-16,Monterey,53,433212,9418,8997,21,9018,62
2020-09-16,Napa,55,140530,1654,1587,5,1592,11
2020-09-16,Nevada,57,99092,524,495,13,508,6
2020-09-16,Orange,59,3164182,53084,50414,1388,51802,1096
2020-09-16,Placer,61,380077,3522,3351,15,3366,39
2020-09-16,Plumas,63,18699,49,45,0,45,0
2020-09-16,Riverside,65,2383286,57166,55811,113,55924,1127
2020-09-16,Sacramento,67,1510023,21514,20610,18,20628,377
2020-09-16,San Benito,69,59416,1295,1244,0,1244,8
2020-09-16,San Bernardino,71,2135413,52397,50509,63,50572,907
2020-09-16,San Diego,73,3302833,45229,43447,0,43447,748
2020-09-16,San Francisco,75,870044,10856,10502,32,10534,90
2020-09-16,San Joaquin,77,732212,19799,19377,45,19422,409
2020-09-16,San Luis Obispo,79,281455,3457,3285,13,3298,28
2020-09-16,San Mateo,81,765935,9768,8944,7,8951,127
2020-09-16,Santa Barbara,83,443738,9300,8764,102,8866,107
2020-09-16,Santa Clara,85,1922200,20875,19684,27,19711,253
2020-09-16,Santa Cruz,87,273765,2256,2089,26,2115,7
2020-09-16,Shasta,89,179085,772,635,3,638,11
2020-09-16,Sierra,91,2930,6,6,0,6,0
2020-09-16,Siskiyou,93,43540,152,145,10,155,0
2020-09-16,Solano,95,438530,6111,5899,41,5940,44
2020-09-16,Sonoma,97,501317,7074,6731,19,6750,104
2020-09-16,Stanislaus,99,539301,16197,15897,497,16394,263
2020-09-16,Sutter,101,95872,1629,1567,1,1568,10
2020-09-16,Tehama,103,63373,508,485,4,489,2
2020-09-16,Trinity,105,12862,26,15,4,19,0
2020-09-16,Tulare,107,460477,15734,15314,88,15402,258
2020-09-16,Tuolumne,109,53932,228,210,27,237,1
2020-09-16,Ventura,111,848112,12607,12073,133,12206,130
2020-09-16,Yolo,113,214977,2757,2709,6,2715,53
2020-09-16,Yuba,115,75493,1043,1000,6,1006,1
2020-09-15,Alameda,1,1643700,20607,19931,162,20093,327
2020-09-15,Alpine,3,1148,3,2,0,2,0
2020-09-15,Amador,5,37829,287,282,0,282,16
2020-09-15,Butte,7,227075,2809,2695,17,2712,38
2020-09-15,Calaveras,9,45235,303,248,1,249,5
2020-09-15,Colusa,11,21464,516,497,0,497,6
2020-09-15,Contra Costa,13,1133247,16270,15423,81,15504,180
2020-09-15,Del Norte,15,27424,134,129,0,129,2
2020-09-15,El Dorado,17,186661,1086,1046,0,1046,4
2020-09-15,Fresno,19,978130,29481,27312,329,27641,343
2020-09-15,Glenn,21,27897,563,531,0,531,3
2020-09-15,Humboldt,23,135768,481,456,0,456,4
2020-09-15,Imperial,25,180216,11645,10376,6,10382,277
2020-09-15,Inyo,27,18085,187,176,0,176,12
2020-09-15,Kern,29,883053,31288,30429,294,30723,368
2020-09-15,Kings,31,150075,7243,6977,35,7012,70
2020-09-15,Lake,33,64148,501,416,0,416,4
2020-09-15,Lassen,35,31185,735,719,1,720,0
2020-09-15,Los Angeles,37,10098052,259160,255048,1718,256766,6269
2020-09-15,Madera,39,155013,4355,4122,26,4148,45
2020-09-15,Marin,41,260295,6532,6423,14,6437,77
2020-09-15,Mariposa,43,17540,75,74,0,74,2
2020-09-15,Mendocino,45,87422,780,724,0,724,18
2020-09-15,Merced,47,269075,8698,8633,13,8646,114
2020-09-15,Modoc,49,8938,26,21,0,21,0
2020-09-15,Mono,51,14174,165,147,1,148,1
2020-09-15,Monterey,53,433212,9369,8943,21,8964,62
2020-09-15,Napa,55,140530,1640,1580,5,1585,11
2020-09-15,Nevada,57,99092,519,494,13,507,6
2020-09-15,Orange,59,3164182,52902,50294,1373,51667,1088
2020-09-15,Placer,61,380077,3498,3331,15,3346,38
2020-09-15,Plumas,63,18699,49,44,0,44,0
2020-09-15,Riverside,65,2383286,56875,55569,103,55672,1118
2020-09-15,Sacramento,67,1510023,21371,20487,18,20505,372
2020-09-15,San Benito,69,59416,1288,1237,0,1237,7
2020-09-15,San Bernardino,71,2135413,52182,50333,62,50395,904
2020-09-15,San Diego,73,3302833,44911,43183,0,43183,742
2020-09-15,San Francisco,75,870044,10798,10414,32,10446,90
2020-09-15,San Joaquin,77,732212,19747,19313,45,19358,401
2020-09-15,San Luis Obispo,79,281455,3436,3262,13,3275,28
2020-09-15,San Mateo,81,765935,9698,8895,7,8902,127
2020-09-15,Santa Barbara,83,443738,9275,8724,101,8825,104
2020-09-15,Santa Clara,85,1922200,20739,19610,27,19637,252
2020-09-15,Santa Cruz,87,273765,2230,2079,25,2104,7
2020-09-15,Shasta,89,179085,760,627,3,630,11
2020-09-15,Sierra,91,2930,6,6,0,6,0
2020-09-15,Siskiyou,93,43540,152,143,10,153,0
2020-09-15,Solano,95,438530,6077,5878,41,5919,45
2020-09-15,Sonoma,97,501317,7035,6701,19,6720,104
2020-09-15,Stanislaus,99,539301,16149,15880,495,16375,260
2020-09-15,Sutter,101,95872,1617,1556,1,1557,10
2020-09-15,Tehama,103,63373,496,484,4,488,2
2020-09-15,Trinity,105,12862,26,15,4,19,0
2020-09-15,Tulare,107,460477,15657,15203,86,15289,254
2020-09-15,Tuolumne,109,53932,228,209,27,236,1
2020-09-15,Ventura,111,848112,12555,11932,132,12064,128
2020-09-15,Yolo,113,214977,2753,2708,6,2714,53
2020-09-15,Yuba,115,75493,1037,991,5,996,1
2020-09-14,Alameda,1,1643700,20480,19851,161,20012,306
2020-09-14,Alpine,3,1148,3,2,0,2,0
2020-09-14,Amador,5,37829,285,281,0,281,16
2020-09-14,Butte,7,227075,2792,2642,17,2659,37
2020-09-14,Calaveras,9,45235,303,244,1,245,3
2020-09-14,Colusa,11,21464,515,486,0,486,6
2020-09-14,Contra Costa,13,1133247,16145,15354,80,15434,174
2020-09-14,Del Norte,15,27424,131,116,0,116,2
2020-09-14,El Dorado,17,186661,1082,1039,0,1039,3
2020-09-14,Fresno,19,978130,29396,27232,326,27558,344
2020-09-14,Glenn,21,27897,555,521,0,521,3
2020-09-14,Humboldt,23,135768,478,437,0,437,4
2020-09-14,Imperial,25,180216,11625,10340,6,10346,273
2020-09-14,Inyo,27,18085,187,176,0,176,12
2020-09-14,Kern,29,883053,31202,30344,291,30635,368
2020-09-14,Kings,31,150075,7161,6950,35,6985,70
2020-09-14,Lake,33,64148,481,407,0,407,4
2020-09-14,Lassen,35,31185,735,719,1,720,0
2020-09-14,Los Angeles,37,10098052,258129,254622,1689,256311,6226
2020-09-14,Madera,39,155013,4341,4104,26,4130,45
2020-09-14,Marin,41,260295,6511,6409,14,6423,70
2020-09-14,Mariposa,43,17540,75,74,0,74,2
2020-09-14,Mendocino,45,87422,763,710,0,710,17
2020-09-14,Merced,47,269075,8679,8593,13,8606,112
2020-09-14,Modoc,49,8938,26,21,0,21,0
2020-09-14,Mono,51,14174,165,147,1,148,1
2020-09-14,Monterey,53,433212,9298,8845,20,8865,61
2020-09-14,Napa,55,140530,1623,1576,5,1581,11
2020-09-14,Nevada,57,99092,514,489,13,502,6
2020-09-14,Orange,59,3164182,52743,50149,1357,51506,1079
2020-09-14,Placer,61,380077,3477,3302,15,3317,38
2020-09-14,Plumas,63,18699,48,42,0,42,0
2020-09-14,Riverside,65,2383286,56656,55488,97,55585,1113
2020-09-14,Sacramento,67,1510023,21178,20377,17,20394,367
2020-09-14,San Benito,69,59416,1273,1233,0,1233,7
2020-09-14,San Bernardino,71,2135413,51960,50163,61,50224,895
2020-09-14,San Diego,73,3302833,44600,42889,0,42889,734
2020-09-14,San Francisco,75,870044,10732,10255,30,10285,90
2020-09-14,San Joaquin,77,732212,19673,19111,44,19155,397
2020-09-14,San Luis Obispo,79,281455,3411,3248,13,3261,25
2020-09-14,San Mateo,81,765935,9636,8847,7,8854,127
2020-09-14,Santa Barbara,83,443738,9249,8692,101,8793,104
2020-09-14,Santa Clara,85,1922200,20552,19545,27,19572,247
2020-09-14,Santa Cruz,87,273765,2210,2016,22,2038,7
2020-09-14,Shasta,89,179085,738,584,3,587,10
2020-09-14,Sierra,91,2930,6,6,0,6,0
2020-09-14,Siskiyou,93,43540,151,143,10,153,0
2020-09-14,Solano,95,438530,6042,5834,41,5875,44
2020-09-14,Sonoma,97,501317,6972,6630,19,6649,102
2020-09-14,Stanislaus,99,539301,16104,15812,492,16304,253
2020-09-14,Sutter,101,95872,1606,1549,1,1550,10
2020-09-14,Tehama,103,63373,493,475,4,479,1
2020-09-14,Trinity,105,12862,25,14,4,18,0
2020-09-14,Tulare,107,460477,15588,15096,80,15176,254
2020-09-14,Tuolumne,109,53932,227,208,27,235,1
2020-09-14,Ventura,111,848112,12454,11903,129,12032,125
2020-09-14,Yolo,113,214977,2742,2687,6,2693,53
2020-09-14,Yuba,115,75493,1029,977,5,982,1
2020-09-13,Alameda,1,1643700,20374,19815,158,19973,306
2020-09-13,Alpine,3,1148,3,2,0,2,0
2020-09-13,Amador,5,37829,282,279,0,279,16
2020-09-13,Butte,7,227075,2770,2640,17,2657,37
2020-09-13,Calaveras,9,45235,302,246,1,247,3
2020-09-13,Colusa,11,21464,511,486,0,486,6
2020-09-13,Contra Costa,13,1133247,16040,15284,79,15363,172
2020-09-13,Del Norte,15,27424,128,116,0,116,1
2020-09-13,El Dorado,17,186661,1077,1035,0,1035,2
2020-09-13,Fresno,19,978130,29289,27196,318,27514,345
2020-09-13,Glenn,21,27897,551,517,0,517,3
2020-09-13,Humboldt,23,135768,478,434,0,434,4
2020-09-13,Imperial,25,180216,11588,10304,6,10310,273
2020-09-13,Inyo,27,18085,187,176,0,176,12
2020-09-13,Kern,29,883053,31109,30277,285,30562,368
2020-09-13,Kings,31,150075,7142,6937,35,6972,70
2020-09-13,Lake,33,64148,462,397,0,397,4
2020-09-13,Lassen,35,31185,732,719,1,720,0
2020-09-13,Los Angeles,37,10098052,256982,253950,1672,255622,6203
2020-09-13,Madera,39,155013,4284,4090,26,4116,45
2020-09-13,Marin,41,260295,6490,6395,14,6409,70
2020-09-13,Mariposa,43,17540,75,74,0,74,2
2020-09-13,Mendocino,45,87422,756,707,0,707,17
2020-09-13,Merced,47,269075,8646,8575,13,8588,112
2020-09-13,Modoc,49,8938,26,21,0,21,0
2020-09-13,Mono,51,14174,165,147,1,148,1
2020-09-13,Monterey,53,433212,9216,8826,19,8845,61
2020-09-13,Napa,55,140530,1616,1563,5,1568,11
2020-09-13,Nevada,57,99092,506,486,13,499,6
2020-09-13,Orange,59,3164182,52530,50061,1350,51411,1075
2020-09-13,Placer,61,380077,3447,3291,15,3306,38
2020-09-13,Plumas,63,18699,48,42,0,42,0
2020-09-13,Riverside,65,2383286,56449,55235,86,55321,1108
2020-09-13,Sacramento,67,1510023,20831,20279,17,20296,367
2020-09-13,San Benito,69,59416,1265,1217,0,1217,7
2020-09-13,San Bernardino,71,2135413,51674,49968,61,50029,895
2020-09-13,San Diego,73,3302833,44276,42681,0,42681,734
2020-09-13,San Francisco,75,870044,10654,10254,30,10284,90
2020-09-13,San Joaquin,77,732212,19601,19110,43,19153,396
2020-09-13,San Luis Obispo,79,281455,3375,3240,13,3253,24
2020-09-13,San Mateo,81,765935,9575,8811,7,8818,127
2020-09-13,Santa Barbara,83,443738,9212,8690,101,8791,104
2020-09-13,Santa Clara,85,1922200,20417,19456,26,19482,245
2020-09-13,Santa Cruz,87,273765,2177,2016,20,2036,7
2020-09-13,Shasta,89,179085,726,583,3,586,10
2020-09-13,Sierra,91,2930,6,6,0,6,0
2020-09-13,Siskiyou,93,43540,151,143,9,152,0
2020-09-13,Solano,95,438530,5996,5810,41,5851,43
2020-09-13,Sonoma,97,501317,6908,6592,19,6611,95
2020-09-13,Stanislaus,99,539301,16041,15759,480,16239,253
2020-09-13,Sutter,101,95872,1594,1539,1,1540,10
2020-09-13,Tehama,103,63373,489,476,4,480,1
2020-09-13,Trinity,105,12862,25,14,4,18,0
2020-09-13,Tulare,107,460477,15516,15098,79,15177,254
2020-09-13,Tuolumne,109,53932,224,208,27,235,1
2020-09-13,Ventura,111,848112,12349,11855,128,11983,123
2020-09-13,Yolo,113,214977,2730,2675,6,2681,53
2020-09-13,Yuba,115,75493,1024,967,5,972,1
2020-09-12,Alameda,1,1643700,20315,19758,158,19916,307
2020-09-12,Alpine,3,1148,3,2,0,2,0
2020-09-12,Amador,5,37829,281,278,0,278,16
2020-09-12,Butte,7,227075,2763,2629,16,2645,37
2020-09-12,Calaveras,9,45235,300,246,1,247,3
2020-09-12,Colusa,11,21464,507,486,0,486,6
2020-09-12,Contra Costa,13,1133247,15967,15135,78,15213,174
2020-09-12,Del Norte,15,27424,127,116,0,116,1
2020-09-12,El Dorado,17,186661,1070,1034,0,1034,2
2020-09-12,Fresno,19,978130,29220,27076,317,27393,345
2020-09-12,Glenn,21,27897,550,517,0,517,3
2020-09-12,Humboldt,23,135768,477,430,0,430,4
2020-09-12,Imperial,25,180216,11576,10305,6,10311,273
2020-09-12,Inyo,27,18085,187,177,0,177,12
2020-09-12,Kern,29,883053,31043,30202,285,30487,368
2020-09-12,Kings,31,150075,7132,6895,35,6930,70
2020-09-12,Lake,33,64148,456,393,0,393,4
2020-09-12,Lassen,35,31185,732,719,1,720,0
2020-09-12,Los Angeles,37,10098052,256423,253156,1651,254807,6193
2020-09-12,Madera,39,155013,4273,4058,26,4084,43
2020-09-12,Marin,41,260295,6481,6393,14,6407,69
2020-09-12,Mariposa,43,17540,75,72,0,72,2
2020-09-12,Mendocino,45,87422,753,700,0,700,17
2020-09-12,Merced,47,269075,8637,8533,13,8546,112
2020-09-12,Modoc,49,8938,25,21,0,21,0
2020-09-12,Mono,51,14174,165,147,1,148,1
2020-09-12,Monterey,53,433212,9180,8743,19,8762,61
2020-09-12,Napa,55,140530,1613,1556,5,1561,11
2020-09-12,Nevada,57,99092,505,482,13,495,6
2020-09-12,Orange,59,3164182,52417,49895,1346,51241,1078
2020-09-12,Placer,61,380077,3430,3280,15,3295,38
2020-09-12,Plumas,63,18699,48,42,0,42,0
2020-09-12,Riverside,65,2383286,56322,55058,81,55139,1108
2020-09-12,Sacramento,67,1510023,20763,20184,17,20201,367
2020-09-12,San Benito,69,59416,1262,1208,0,1208,7
2020-09-12,San Bernardino,71,2135413,51583,49945,60,50005,896
2020-09-12,San Diego,73,3302833,44082,42416,0,42416,747
2020-09-12,San Francisco,75,870044,10609,10257,30,10287,90
2020-09-12,San Joaquin,77,732212,19573,19108,43,19151,396
2020-09-12,San Luis Obispo,79,281455,3349,3220,13,3233,24
2020-09-12,San Mateo,81,765935,9530,8759,7,8766,127
2020-09-12,Santa Barbara,83,443738,9197,8642,101,8743,104
2020-09-12,Santa Clara,85,1922200,20333,19330,26,19356,237
2020-09-12,Santa Cruz,87,273765,2165,2016,20,2036,7
2020-09-12,Shasta,89,179085,714,569,3,572,10
2020-09-12,Sierra,91,2930,6,6,0,6,0
2020-09-12,Siskiyou,93,43540,151,141,9,150,0
2020-09-12,Solano,95,438530,5972,5772,41,5813,43
2020-09-12,Sonoma,97,501317,6884,6531,19,6550,95
2020-09-12,Stanislaus,99,539301,16009,15675,477,16152,253
2020-09-12,Sutter,101,95872,1588,1529,1,1530,10
2020-09-12,Tehama,103,63373,486,471,4,475,1
2020-09-12,Trinity,105,12862,25,15,4,19,0
2020-09-12,Tulare,107,460477,15471,15018,78,15096,254
2020-09-12,Tuolumne,109,53932,224,208,27,235,1
2020-09-12,Ventura,111,848112,12298,11759,126,11885,123
2020-09-12,Yolo,113,214977,2723,2646,6,2652,53
2020-09-12,Yuba,115,75493,1020,963,5,968,1
2020-09-11,Alameda,1,1643700,20259,19625,157,19782,298
2020-09-11,Alpine,3,1148,3,2,0,2,0
2020-09-11,Amador,5,37829,281,277,0,277,16
2020-09-11,Butte,7,227075,2752,2605,16,2621,37
2020-09-11,Calaveras,9,45235,299,242,1,243,1
2020-09-11,Colusa,11,21464,506,484,0,484,6
2020-09-11,Contra Costa,13,1133247,15914,15001,75,15076,173
2020-09-11,Del Norte,15,27424,127,115,0,115,1
2020-09-11,El Dorado,17,186661,1067,1024,0,1024,2
2020-09-11,Fresno,19,978130,29140,26917,316,27233,344
2020-09-11,Glenn,21,27897,545,515,0,515,3
2020-09-11,Humboldt,23,135768,475,426,0,426,4
2020-09-11,Imperial,25,180216,11558,10286,6,10292,273
2020-09-11,Inyo,27,18085,187,176,0,176,12
2020-09-11,Kern,29,883053,30976,30059,284,30343,365
2020-09-11,Kings,31,150075,7115,6770,35,6805,70
2020-09-11,Lake,33,64148,449,382,0,382,4
2020-09-11,Lassen,35,31185,732,719,1,720,0
2020-09-11,Los Angeles,37,10098052,255742,252057,1640,253697,6172
2020-09-11,Madera,39,155013,4254,4018,26,4044,43
2020-09-11,Marin,41,260295,6478,6364,14,6378,69
2020-09-11,Mariposa,43,17540,75,72,0,72,2
2020-09-11,Mendocino,45,87422,742,700,0,700,17
2020-09-11,Merced,47,269075,8616,8489,13,8502,109
2020-09-11,Modoc,49,8938,25,21,0,21,0
2020-09-11,Mono,51,14174,165,145,1,146,1
2020-09-11,Monterey,53,433212,9132,8595,19,8614,61
2020-09-11,Napa,55,140530,1602,1543,5,1548,11
2020-09-11,Nevada,57,99092,498,483,13,496,6
2020-09-11,Orange,59,3164182,52290,49755,1333,51088,1068
2020-09-11,Placer,61,380077,3415,3254,15,3269,37
2020-09-11,Plumas,63,18699,48,42,0,42,0
2020-09-11,Riverside,65,2383286,56189,54717,78,54795,1099
2020-09-11,Sacramento,67,1510023,20676,20012,17,20029,358
2020-09-11,San Benito,69,59416,1252,1202,0,1202,7
2020-09-11,San Bernardino,71,2135413,51483,49682,60,49742,871
2020-09-11,San Diego,73,3302833,43862,41971,0,41971,730
2020-09-11,San Francisco,75,870044,10560,10133,29,10162,89
2020-09-11,San Joaquin,77,732212,19526,19019,43,19062,391
2020-09-11,San Luis Obispo,79,281455,3331,3190,13,3203,24
2020-09-11,San Mateo,81,765935,9488,8611,7,8618,127
2020-09-11,Santa Barbara,83,443738,9163,8592,100,8692,103
2020-09-11,Santa Clara,85,1922200,20243,19065,26,19091,234
2020-09-11,Santa Cruz,87,273765,2148,1997,20,2017,7
2020-09-11,Shasta,89,179085,704,568,3,571,10
2020-09-11,Sierra,91,2930,6,6,0,6,0
2020-09-11,Siskiyou,93,43540,150,139,9,148,0
2020-09-11,Solano,95,438530,5955,5742,41,5783,42
2020-09-11,Sonoma,97,501317,6839,6469,19,6488,91
2020-09-11,Stanislaus,99,539301,15971,15613,474,16087,253
2020-09-11,Sutter,101,95872,1578,1505,1,1506,11
2020-09-11,Tehama,103,63373,483,466,4,470,1
2020-09-11,Trinity,105,12862,25,16,4,20,0
2020-09-11,Tulare,107,460477,15440,14932,76,15008,251
2020-09-11,Tuolumne,109,53932,224,208,27,235,1
2020-09-11,Ventura,111,848112,12244,11700,125,11825,123
2020-09-11,Yolo,113,214977,2712,2632,6,2638,53
2020-09-11,Yuba,115,75493,1012,946,5,951,1
2020-09-10,Alameda,1,1643700,20185,19509,157,19666,292
2020-09-10,Alpine,3,1148,3,2,0,2,0
2020-09-10,Amador,5,37829,280,277,0,277,16
2020-09-10,Butte,7,227075,2735,2590,16,2606,37
2020-09-10,Calaveras,9,45235,299,244,1,245,1
2020-09-10,Colusa,11,21464,504,482,0,482,6
2020-09-10,Contra Costa,13,1133247,15844,14909,75,14984,172
2020-09-10,Del Norte,15,27424,126,112,0,112,1
2020-09-10,El Dorado,17,186661,1064,1020,0,1020,2
2020-09-10,Fresno,19,978130,29019,26783,316,27099,338
2020-09-10,Glenn,21,27897,535,511,0,511,3
2020-09-10,Humboldt,23,135768,464,422,0,422,4
2020-09-10,Imperial,25,180216,11542,10251,6,10257,270
2020-09-10,Inyo,27,18085,186,176,0,176,11
2020-09-10,Kern,29,883053,30895,29988,280,30268,363
2020-09-10,Kings,31,150075,7086,6739,35,6774,70
2020-09-10,Lake,33,64148,442,377,0,377,4
2020-09-10,Lassen,35,31185,731,716,1,717,0
2020-09-10,Los Angeles,37,10098052,254760,251003,1618,252621,6132
2020-09-10,Madera,39,155013,4236,3979,26,4005,43
2020-09-10,Marin,41,260295,6467,6344,14,6358,68
2020-09-10,Mariposa,43,17540,75,72,0,72,2
2020-09-10,Mendocino,45,87422,732,697,0,697,16
2020-09-10,Merced,47,269075,8570,8461,13,8474,109
2020-09-10,Modoc,49,8938,25,21,0,21,0
2020-09-10,Mono,51,14174,165,145,1,146,1
2020-09-10,Monterey,53,433212,9062,8570,19,8589,59
2020-09-10,Napa,55,140530,1596,1536,5,1541,11
2020-09-10,Nevada,57,99092,494,478,13,491,6
2020-09-10,Orange,59,3164182,52127,49617,1326,50943,1057
2020-09-10,Placer,61,380077,3396,3233,15,3248,37
2020-09-10,Plumas,63,18699,48,42,0,42,0
2020-09-10,Riverside,65,2383286,55871,54417,74,54491,1091
2020-09-10,Sacramento,67,1510023,20556,19618,16,19634,354
2020-09-10,San Benito,69,59416,1246,1201,0,1201,5
2020-09-10,San Bernardino,71,2135413,51294,49467,59,49526,867
2020-09-10,San Diego,73,3302833,43596,41610,0,41610,725
2020-09-10,San Francisco,75,870044,10483,10082,29,10111,89
2020-09-10,San Joaquin,77,732212,19473,18854,43,18897,389
2020-09-10,San Luis Obispo,79,281455,3318,3161,13,3174,24
2020-09-10,San Mateo,81,765935,9441,8529,7,8536,125
2020-09-10,Santa Barbara,83,443738,9119,8552,100,8652,100
2020-09-10,Santa Clara,85,1922200,20129,18870,25,18895,231
2020-09-10,Santa Cruz,87,273765,2133,1986,18,2004,7
2020-09-10,Shasta,89,179085,693,566,3,569,10
2020-09-10,Sierra,91,2930,6,6,0,6,0
2020-09-10,Siskiyou,93,43540,150,137,9,146,0
2020-09-10,Solano,95,438530,5915,5696,41,5737,42
2020-09-10,Sonoma,97,501317,6790,6424,19,6443,91
2020-09-10,Stanislaus,99,539301,15917,15509,469,15978,243
2020-09-10,Sutter,101,95872,1566,1494,1,1495,11
2020-09-10,Tehama,103,63373,476,466,4,470,1
2020-09-10,Trinity,105,12862,25,15,4,19,0
2020-09-10,Tulare,107,460477,15385,14860,73,14933,250
2020-09-10,Tuolumne,109,53932,223,205,27,232,1
2020-09-10,Ventura,111,848112,12152,11600,118,11718,122
2020-09-10,Yolo,113,214977,2707,2612,6,2618,53
2020-09-10,Yuba,115,75493,1006,941,5,946,1
2020-09-09,Alameda,1,1643700,20107,19399,156,19555,289
2020-09-09,Alpine,3,1148,3,2,0,2,0
2020-09-09,Amador,5,37829,279,276,0,276,16
2020-09-09,Butte,7,227075,2718,2561,16,2577,37
2020-09-09,Calaveras,9,45235,299,242,1,243,1
2020-09-09,Colusa,11,21464,499,479,0,479,6
2020-09-09,Contra Costa,13,1133247,15758,14816,75,14891,171
2020-09-09,Del Norte,15,27424,122,109,0,109,1
2020-09-09,El Dorado,17,186661,1063,1020,0,1020,2
2020-09-09,Fresno,19,978130,28916,26724,311,27035,329
2020-09-09,Glenn,21,27897,532,508,0,508,3
2020-09-09,Humboldt,23,135768,462,420,0,420,4
2020-09-09,Imperial,25,180216,11521,10233,6,10239,268
2020-09-09,Inyo,27,18085,185,173,0,173,2
2020-09-09,Kern,29,883053,30798,29925,277,30202,355
2020-09-09,Kings,31,150075,7068,6721,35,6756,72
2020-09-09,Lake,33,64148,434,371,0,371,4
2020-09-09,Lassen,35,31185,730,714,1,715,0
2020-09-09,Los Angeles,37,10098052,253877,249876,1599,251475,6091
2020-09-09,Madera,39,155013,4212,3926,26,3952,43
2020-09-09,Marin,41,260295,6448,6321,14,6335,68
2020-09-09,Mariposa,43,17540,74,72,0,72,2
2020-09-09,Mendocino,45,87422,724,695,0,695,16
2020-09-09,Merced,47,269075,8544,8441,13,8454,107
2020-09-09,Modoc,49,8938,24,20,0,20,0
2020-09-09,Mono,51,14174,165,145,1,146,1
2020-09-09,Monterey,53,433212,8990,8527,19,8546,59
2020-09-09,Napa,55,140530,1586,1531,5,1536,11
2020-09-09,Nevada,57,99092,490,476,13,489,6
2020-09-09,Orange,59,3164182,51948,49394,1318,50712,1054
2020-09-09,Placer,61,380077,3377,3222,15,3237,36
2020-09-09,Plumas,63,18699,46,42,0,42,0
2020-09-09,Riverside,65,2383286,55641,54320,71,54391,1081
2020-09-09,Sacramento,67,1510023,20450,19474,16,19490,347
2020-09-09,San Benito,69,59416,1242,1199,0,1199,5
2020-09-09,San Bernardino,71,2135413,51096,49264,59,49323,866
2020-09-09,San Diego,73,3302833,43307,41326,0,41326,721
2020-09-09,San Francisco,75,870044,10433,9996,28,10024,86
2020-09-09,San Joaquin,77,732212,19409,18799,42,18841,388
2020-09-09,San Luis Obispo,79,281455,3300,3131,13,3144,24
2020-09-09,San Mateo,81,765935,9380,8478,7,8485,125
2020-09-09,Santa Barbara,83,443738,9076,8528,100,8628,97
2020-09-09,Santa Clara,85,1922200,19998,18759,25,18784,228
2020-09-09,Santa Cruz,87,273765,2110,1967,18,1985,7
2020-09-09,Shasta,89,179085,681,562,3,565,10
2020-09-09,Sierra,91,2930,6,6,0,6,0
2020-09-09,Siskiyou,93,43540,148,137,9,146,0
2020-09-09,Solano,95,438530,5883,5680,41,5721,36
2020-09-09,Sonoma,97,501317,6723,6397,19,6416,92
2020-09-09,Stanislaus,99,539301,15879,15469,456,15925,243
2020-09-09,Sutter,101,95872,1558,1487,1,1488,11
2020-09-09,Tehama,103,63373,473,462,4,466,1
2020-09-09,Trinity,105,12862,25,14,4,18,0
2020-09-09,Tulare,107,460477,15335,14787,68,14855,249
2020-09-09,Tuolumne,109,53932,222,204,27,231,1
2020-09-09,Ventura,111,848112,12064,11497,115,11612,121
2020-09-09,Yolo,113,214977,2696,2604,6,2610,53
2020-09-09,Yuba,115,75493,1001,936,5,941,1
2020-09-08,Alameda,1,1643700,20000,19293,156,19449,288
2020-09-08,Alpine,3,1148,3,2,0,2,0
2020-09-08,Amador,5,37829,279,276,0,276,16
2020-09-08,Butte,7,227075,2700,2453,16,2469,36
2020-09-08,Calaveras,9,45235,297,233,1,234,1
2020-09-08,Colusa,11,21464,497,475,0,475,6
2020-09-08,Contra Costa,13,1133247,15630,14740,72,14812,171
2020-09-08,Del Norte,15,27424,122,109,0,109,2
2020-09-08,El Dorado,17,186661,1060,1011,0,1011,2
2020-09-08,Fresno,19,978130,28797,26640,307,26947,329
2020-09-08,Glenn,21,27897,528,492,0,492,3
2020-09-08,Humboldt,23,135768,460,420,0,420,4
2020-09-08,Imperial,25,180216,11505,10198,6,10204,267
2020-09-08,Inyo,27,18085,185,169,0,169,2
2020-09-08,Kern,29,883053,30713,29850,275,30125,351
2020-09-08,Kings,31,150075,7030,6658,35,6693,72
2020-09-08,Lake,33,64148,424,370,0,370,4
2020-09-08,Lassen,35,31185,730,710,1,711,0
2020-09-08,Los Angeles,37,10098052,252942,249217,1571,250788,6034
2020-09-08,Madera,39,155013,4188,3904,26,3930,43
2020-09-08,Marin,41,260295,6417,6313,14,6327,68
2020-09-08,Mariposa,43,17540,74,72,0,72,2
2020-09-08,Mendocino,45,87422,717,690,0,690,16
2020-09-08,Merced,47,269075,8521,8381,13,8394,104
2020-09-08,Modoc,49,8938,24,20,0,20,0
2020-09-08,Mono,51,14174,165,145,1,146,1
2020-09-08,Monterey,53,433212,8905,8491,19,8510,59
2020-09-08,Napa,55,140530,1582,1518,5,1523,11
2020-09-08,Nevada,57,99092,490,470,13,483,6
2020-09-08,Orange,59,3164182,51807,49214,1314,50528,1044
2020-09-08,Placer,61,380077,3363,3205,15,3220,36
2020-09-08,Plumas,63,18699,46,42,0,42,0
2020-09-08,Riverside,65,2383286,55429,54168,68,54236,1069
2020-09-08,Sacramento,67,1510023,20215,19411,16,19427,347
2020-09-08,San Benito,69,59416,1235,1188,0,1188,5
2020-09-08,San Bernardino,71,2135413,50907,49034,58,49092,856
2020-09-08,San Diego,73,3302833,42991,41079,0,41079,709
2020-09-08,San Francisco,75,870044,10360,9821,27,9848,86
2020-09-08,San Joaquin,77,732212,19331,18550,42,18592,388
2020-09-08,San Luis Obispo,79,281455,3286,3120,13,3133,23
2020-09-08,San Mateo,81,765935,9304,8460,7,8467,125
2020-09-08,Santa Barbara,83,443738,9042,8488,98,8586,96
2020-09-08,Santa Clara,85,1922200,19822,18645,25,18670,228
2020-09-08,Santa Cruz,87,273765,2082,1903,18,1921,7
2020-09-08,Shasta,89,179085,673,556,3,559,10
2020-09-08,Sierra,91,2930,6,6,0,6,0
2020-09-08,Siskiyou,93,43540,146,136,9,145,0
2020-09-08,Solano,95,438530,5846,5654,41,5695,36
2020-09-08,Sonoma,97,501317,6654,6356,19,6375,92
2020-09-08,Stanislaus,99,539301,15815,15415,444,15859,238
2020-09-08,Sutter,101,95872,1544,1473,1,1474,11
2020-09-08,Tehama,103,63373,469,458,4,462,1
2020-09-08,Trinity,105,12862,24,13,4,17,0
2020-09-08,Tulare,107,460477,15255,14635,67,14702,249
2020-09-08,Tuolumne,109,53932,221,197,27,224,1
2020-09-08,Ventura,111,848112,11996,11475,113,11588,118
2020-09-08,Yolo,113,214977,2686,2580,6,2586,53
2020-09-08,Yuba,115,75493,989,923,5,928,1
2020-09-07,Alameda,1,1643700,19878,19188,151,19339,281
2020-09-07,Alpine,3,1148,3,2,0,2,0
2020-09-07,Amador,5,37829,279,276,0,276,16
2020-09-07,Butte,7,227075,2667,2450,15,2465,30
2020-09-07,Calaveras,9,45235,287,234,1,235,1
2020-09-07,Colusa,11,21464,496,475,0,475,6
2020-09-07,Contra Costa,13,1133247,15517,14637,69,14706,172
2020-09-07,Del Norte,15,27424,122,109,0,109,2
2020-09-07,El Dorado,17,186661,1049,1011,0,1011,2
2020-09-07,Fresno,19,978130,28704,26565,303,26868,329
2020-09-07,Glenn,21,27897,523,488,0,488,3
2020-09-07,Humboldt,23,135768,451,416,0,416,4
2020-09-07,Imperial,25,180216,11474,10199,6,10205,267
2020-09-07,Inyo,27,18085,185,169,0,169,2
2020-09-07,Kern,29,883053,30592,29790,271,30061,348
2020-09-07,Kings,31,150075,6906,6630,35,6665,72
2020-09-07,Lake,33,64148,401,367,0,367,2
2020-09-07,Lassen,35,31185,729,709,1,710,0
2020-09-07,Los Angeles,37,10098052,251897,248804,1548,250352,6030
2020-09-07,Madera,39,155013,4157,3889,26,3915,43
2020-09-07,Marin,41,260295,6387,6296,14,6310,67
2020-09-07,Mariposa,43,17540,74,72,0,72,2
2020-09-07,Mendocino,45,87422,709,687,0,687,16
2020-09-07,Merced,47,269075,8474,8381,13,8394,104
2020-09-07,Modoc,49,8938,23,20,0,20,0
2020-09-07,Mono,51,14174,165,145,1,146,1
2020-09-07,Monterey,53,433212,8825,8463,19,8482,57
2020-09-07,Napa,55,140530,1570,1514,5,1519,11
2020-09-07,Nevada,57,99092,488,469,13,482,6
2020-09-07,Orange,59,3164182,51637,49132,1310,50442,1042
2020-09-07,Placer,61,380077,3332,3188,14,3202,36
2020-09-07,Plumas,63,18699,45,42,0,42,0
2020-09-07,Riverside,65,2383286,55154,54178,61,54239,1069
2020-09-07,Sacramento,67,1510023,19973,19292,16,19308,345
2020-09-07,San Benito,69,59416,1229,1180,0,1180,4
2020-09-07,San Bernardino,71,2135413,50683,49043,58,49101,821
2020-09-07,San Diego,73,3302833,42591,40868,0,40868,708
2020-09-07,San Francisco,75,870044,10309,9813,26,9839,85
2020-09-07,San Joaquin,77,732212,19250,18552,40,18592,386
2020-09-07,San Luis Obispo,79,281455,3249,3116,13,3129,23
2020-09-07,San Mateo,81,765935,9222,8409,7,8416,125
2020-09-07,Santa Barbara,83,443738,9000,8479,98,8577,95
2020-09-07,Santa Clara,85,1922200,19664,18596,23,18619,226
2020-09-07,Santa Cruz,87,273765,2054,1902,18,1920,7
2020-09-07,Shasta,89,179085,663,556,3,559,10
2020-09-07,Sierra,91,2930,6,6,0,6,0
2020-09-07,Siskiyou,93,43540,145,133,9,142,0
2020-09-07,Solano,95,438530,5781,5640,41,5681,36
2020-09-07,Sonoma,97,501317,6587,6268,19,6287,85
2020-09-07,Stanislaus,99,539301,15750,15343,431,15774,236
2020-09-07,Sutter,101,95872,1527,1468,1,1469,11
2020-09-07,Tehama,103,63373,466,453,4,457,1
2020-09-07,Trinity,105,12862,24,13,4,17,0
2020-09-07,Tulare,107,460477,15149,14637,65,14702,249
2020-09-07,Tuolumne,109,53932,220,196,27,223,1
2020-09-07,Ventura,111,848112,11903,11463,111,11574,118
2020-09-07,Yolo,113,214977,2669,2565,5,2570,53
2020-09-07,Yuba,115,75493,973,923,4,927,1
2020-09-06,Alameda,1,1643700,19820,19029,149,19178,281
2020-09-06,Alpine,3,1148,3,2,0,2,0
2020-09-06,Amador,5,37829,277,275,0,275,16
2020-09-06,Butte,7,227075,2658,2446,15,2461,30
2020-09-06,Calaveras,9,45235,287,235,1,236,1
2020-09-06,Colusa,11,21464,492,475,0,475,6
2020-09-06,Contra Costa,13,1133247,15437,14565,68,14633,171
2020-09-06,Del Norte,15,27424,122,109,0,109,2
2020-09-06,El Dorado,17,186661,1047,1008,0,1008,2
2020-09-06,Fresno,19,978130,28640,26471,303,26774,329
2020-09-06,Glenn,21,27897,517,474,0,474,3
2020-09-06,Humboldt,23,135768,448,404,0,404,4
2020-09-06,Imperial,25,180216,11457,10152,6,10158,267
2020-09-06,Inyo,27,18085,185,169,0,169,2
2020-09-06,Kern,29,883053,30537,29699,267,29966,348
2020-09-06,Kings,31,150075,6886,6561,34,6595,72
2020-09-06,Lake,33,64148,398,362,0,362,2
2020-09-06,Lassen,35,31185,729,709,1,710,0
2020-09-06,Los Angeles,37,10098052,251269,248316,1532,249848,6004
2020-09-06,Madera,39,155013,4113,3867,26,3893,42
2020-09-06,Marin,41,260295,6375,6276,14,6290,67
2020-09-06,Mariposa,43,17540,74,72,0,72,2
2020-09-06,Mendocino,45,87422,708,672,0,672,16
2020-09-06,Merced,47,269075,8455,8327,13,8340,104
2020-09-06,Modoc,49,8938,23,20,0,20,0
2020-09-06,Mono,51,14174,164,145,1,146,1
2020-09-06,Monterey,53,433212,8786,8403,18,8421,56
2020-09-06,Napa,55,140530,1566,1501,3,1504,11
2020-09-06,Nevada,57,99092,488,467,13,480,6
2020-09-06,Orange,59,3164182,51525,48931,1305,50236,1042
2020-09-06,Placer,61,380077,3315,3169,14,3183,36
2020-09-06,Plumas,63,18699,44,42,0,42,0
2020-09-06,Riverside,65,2383286,55037,53970,59,54029,1069
2020-09-06,Sacramento,67,1510023,19878,19128,16,19144,340
2020-09-06,San Benito,69,59416,1227,1178,0,1178,4
2020-09-06,San Bernardino,71,2135413,50574,48923,58,48981,823
2020-09-06,San Diego,73,3302833,42343,40652,0,40652,707
2020-09-06,San Francisco,75,870044,10234,9813,26,9839,85
2020-09-06,San Joaquin,77,732212,19201,18558,40,18598,386
2020-09-06,San Luis Obispo,79,281455,3238,3101,13,3114,23
2020-09-06,San Mateo,81,765935,9169,8387,7,8394,125
2020-09-06,Santa Barbara,83,443738,8971,8434,98,8532,95
2020-09-06,Santa Clara,85,1922200,19563,18495,23,18518,207
2020-09-06,Santa Cruz,87,273765,2047,1902,18,1920,7
2020-09-06,Shasta,89,179085,657,550,3,553,10
2020-09-06,Sierra,91,2930,6,6,0,6,0
2020-09-06,Siskiyou,93,43540,145,132,9,141,0
2020-09-06,Solano,95,438530,5755,5619,41,5660,37
2020-09-06,Sonoma,97,501317,6558,6212,19,6231,85
2020-09-06,Stanislaus,99,539301,15707,15288,426,15714,236
2020-09-06,Sutter,101,95872,1514,1451,1,1452,11
2020-09-06,Tehama,103,63373,465,455,4,459,1
2020-09-06,Trinity,105,12862,23,13,4,17,0
2020-09-06,Tulare,107,460477,15106,14636,64,14700,249
2020-09-06,Tuolumne,109,53932,217,194,27,221,1
2020-09-06,Ventura,111,848112,11861,11315,110,11425,118
2020-09-06,Yolo,113,214977,2656,2556,5,2561,53
2020-09-06,Yuba,115,75493,965,913,4,917,1
2020-09-05,Alameda,1,1643700,19773,18973,147,19120,279
2020-09-05,Alpine,3,1148,3,2,0,2,0
2020-09-05,Amador,5,37829,277,274,0,274,16
2020-09-05,Butte,7,227075,2642,2406,14,2420,30
2020-09-05,Calaveras,9,45235,287,237,1,238,1
2020-09-05,Colusa,11,21464,488,472,0,472,6
2020-09-05,Contra Costa,13,1133247,15361,14456,66,14522,173
2020-09-05,Del Norte,15,27424,122,109,0,109,2
2020-09-05,El Dorado,17,186661,1047,1007,0,1007,2
2020-09-05,Fresno,19,978130,28572,26325,303,26628,331
2020-09-05,Glenn,21,27897,516,474,0,474,3
2020-09-05,Humboldt,23,135768,446,402,0,402,4
2020-09-05,Imperial,25,180216,11440,10151,6,10157,268
2020-09-05,Inyo,27,18085,185,169,0,169,2
2020-09-05,Kern,29,883053,30477,29645,263,29908,347
2020-09-05,Kings,31,150075,6877,6518,34,6552,66
2020-09-05,Lake,33,64148,395,359,0,359,2
2020-09-05,Lassen,35,31185,729,709,1,710,0
2020-09-05,Los Angeles,37,10098052,250735,247572,1519,249091,6001
2020-09-05,Madera,39,155013,4072,3851,26,3877,42
2020-09-05,Marin,41,260295,6368,6259,14,6273,66
2020-09-05,Mariposa,43,17540,74,72,0,72,2
2020-09-05,Mendocino,45,87422,707,658,0,658,16
2020-09-05,Merced,47,269075,8423,8297,11,8308,104
2020-09-05,Modoc,49,8938,23,19,0,19,0
2020-09-05,Mono,51,14174,164,145,1,146,1
2020-09-05,Monterey,53,433212,8756,8301,18,8319,56
2020-09-05,Napa,55,140530,1560,1484,3,1487,11
2020-09-05,Nevada,57,99092,485,461,13,474,6
2020-09-05,Orange,59,3164182,51422,48726,1300,50026,1039
2020-09-05,Placer,61,380077,3305,3141,14,3155,35
2020-09-05,Plumas,63,18699,44,42,0,42,0
2020-09-05,Riverside,65,2383286,54931,53780,59,53839,1066
2020-09-05,Sacramento,67,1510023,19789,18955,16,18971,339
2020-09-05,San Benito,69,59416,1225,1153,0,1153,4
2020-09-05,San Bernardino,71,2135413,50499,48800,57,48857,825
2020-09-05,San Diego,73,3302833,42151,40344,0,40344,717
2020-09-05,San Francisco,75,870044,10201,9812,25,9837,85
2020-09-05,San Joaquin,77,732212,19173,18557,40,18597,386
2020-09-05,San Luis Obispo,79,281455,3228,3083,13,3096,23
2020-09-05,San Mateo,81,765935,9124,8352,6,8358,124
2020-09-05,Santa Barbara,83,443738,8954,8404,98,8502,96
2020-09-05,Santa Clara,85,1922200,19479,18311,23,18334,207
2020-09-05,Santa Cruz,87,273765,2039,1904,18,1922,7
2020-09-05,Shasta,89,179085,656,544,3,547,10
2020-09-05,Sierra,91,2930,6,6,0,6,0
2020-09-05,Siskiyou,93,43540,144,131,9,140,0
2020-09-05,Solano,95,438530,5743,5579,41,5620,37
2020-09-05,Sonoma,97,501317,6525,6149,19,6168,85
2020-09-05,Stanislaus,99,539301,15659,15198,422,15620,236
2020-09-05,Sutter,101,95872,1507,1445,1,1446,11
2020-09-05,Tehama,103,63373,464,447,4,451,1
2020-09-05,Trinity,105,12862,23,13,4,17,0
2020-09-05,Tulare,107,460477,15050,14576,62,14638,249
2020-09-05,Tuolumne,109,53932,217,194,27,221,1
2020-09-05,Ventura,111,848112,11820,11254,110,11364,118
2020-09-05,Yolo,113,214977,2646,2534,5,2539,53
2020-09-05,Yuba,115,75493,959,902,4,906,1
2020-09-04,Alameda,1,1643700,19705,18843,145,18988,276
2020-09-04,Alpine,3,1148,3,2,0,2,0
2020-09-04,Amador,5,37829,276,274,0,274,16
2020-09-04,Butte,7,227075,2619,2325,14,2339,28
2020-09-04,Calaveras,9,45235,285,237,1,238,1
2020-09-04,Colusa,11,21464,486,467,0,467,6
2020-09-04,Contra Costa,13,1133247,15281,14355,65,14420,164
2020-09-04,Del Norte,15,27424,122,109,0,109,2
2020-09-04,El Dorado,17,186661,1043,992,0,992,2
2020-09-04,Fresno,19,978130,28467,26147,302,26449,321
2020-09-04,Glenn,21,27897,508,463,0,463,3
2020-09-04,Humboldt,23,135768,441,390,0,390,4
2020-09-04,Imperial,25,180216,11431,10136,6,10142,267
2020-09-04,Inyo,27,18085,185,169,0,169,2
2020-09-04,Kern,29,883053,30409,29526,260,29786,345
2020-09-04,Kings,31,150075,6864,6259,34,6293,66
2020-09-04,Lake,33,64148,395,347,0,347,2
2020-09-04,Lassen,35,31185,729,708,1,709,0
2020-09-04,Los Angeles,37,10098052,250164,246396,1498,247894,5977
2020-09-04,Madera,39,155013,4059,3838,26,3864,42
2020-09-04,Marin,41,260295,6356,6251,14,6265,66
2020-09-04,Mariposa,43,17540,74,72,0,72,2
2020-09-04,Mendocino,45,87422,705,646,0,646,16
2020-09-04,Merced,47,269075,8403,8214,11,8225,104
2020-09-04,Modoc,49,8938,23,15,0,15,0
2020-09-04,Mono,51,14174,164,145,1,146,1
2020-09-04,Monterey,53,433212,8711,8208,18,8226,56
2020-09-04,Napa,55,140530,1551,1475,3,1478,11
2020-09-04,Nevada,57,99092,482,455,13,468,6
2020-09-04,Orange,59,3164182,51298,48488,1293,49781,1031
2020-09-04,Placer,61,380077,3293,3101,14,3115,35
2020-09-04,Plumas,63,18699,44,42,0,42,0
2020-09-04,Riverside,65,2383286,54818,53606,54,53660,1066
2020-09-04,Sacramento,67,1510023,19701,18765,16,18781,337
2020-09-04,San Benito,69,59416,1216,1137,0,1137,4
2020-09-04,San Bernardino,71,2135413,50407,48497,57,48554,800
2020-09-04,San Diego,73,3302833,41921,39901,0,39901,701
2020-09-04,San Francisco,75,870044,10161,9694,24,9718,85
2020-09-04,San Joaquin,77,732212,19119,18438,40,18478,376
2020-09-04,San Luis Obispo,79,281455,3213,3049,12,3061,21
2020-09-04,San Mateo,81,765935,9080,8275,6,8281,122
2020-09-04,Santa Barbara,83,443738,8923,8340,98,8438,96
2020-09-04,Santa Clara,85,1922200,19371,18074,23,18097,209
2020-09-04,Santa Cruz,87,273765,2022,1896,17,1913,7
2020-09-04,Shasta,89,179085,653,536,3,539,10
2020-09-04,Sierra,91,2930,6,6,0,6,0
2020-09-04,Siskiyou,93,43540,144,129,9,138,0
2020-09-04,Solano,95,438530,5730,5552,41,5593,37
2020-09-04,Sonoma,97,501317,6460,6050,19,6069,85
2020-09-04,Stanislaus,99,539301,15624,15074,413,15487,233
2020-09-04,Sutter,101,95872,1491,1425,1,1426,11
2020-09-04,Tehama,103,63373,460,442,4,446,1
2020-09-04,Trinity,105,12862,23,13,4,17,0
2020-09-04,Tulare,107,460477,15022,14501,58,14559,247
2020-09-04,Tuolumne,109,53932,217,193,27,220,1
2020-09-04,Ventura,111,848112,11778,11171,110,11281,114
2020-09-04,Yolo,113,214977,2631,2495,5,2500,53
2020-09-04,Yuba,115,75493,954,884,4,888,1
2020-09-03,Alameda,1,1643700,19602,18687,145,18832,275
2020-09-03,Alpine,3,1148,3,2,0,2,0
2020-09-03,Amador,5,37829,276,274,0,274,16
2020-09-03,Butte,7,227075,2574,2274,14,2288,27
2020-09-03,Calaveras,9,45235,284,238,1,239,1
2020-09-03,Colusa,11,21464,484,464,0,464,6
2020-09-03,Contra Costa,13,1133247,15174,14206,62,14268,159
2020-09-03,Del Norte,15,27424,119,109,0,109,2
2020-09-03,El Dorado,17,186661,1039,983,0,983,2
2020-09-03,Fresno,19,978130,28349,25978,296,26274,313
2020-09-03,Glenn,21,27897,504,460,0,460,3
2020-09-03,Humboldt,23,135768,436,390,0,390,4
2020-09-03,Imperial,25,180216,11411,10083,6,10089,255
2020-09-03,Inyo,27,18085,183,171,0,171,3
2020-09-03,Kern,29,883053,30317,29426,245,29671,340
2020-09-03,Kings,31,150075,6784,6200,34,6234,64
2020-09-03,Lake,33,64148,386,347,0,347,2
2020-09-03,Lassen,35,31185,729,707,1,708,0
2020-09-03,Los Angeles,37,10098052,249287,245026,1476,246502,5931
2020-09-03,Madera,39,155013,4040,3780,26,3806,43
2020-09-03,Marin,41,260295,6337,6175,14,6189,66
2020-09-03,Mariposa,43,17540,74,71,0,71,2
2020-09-03,Mendocino,45,87422,696,638,0,638,16
2020-09-03,Merced,47,269075,8361,8136,11,8147,105
2020-09-03,Modoc,49,8938,23,14,0,14,0
2020-09-03,Mono,51,14174,163,144,1,145,1
2020-09-03,Monterey,53,433212,8657,8128,18,8146,56
2020-09-03,Napa,55,140530,1544,1466,3,1469,10
2020-09-03,Nevada,57,99092,479,453,13,466,6
2020-09-03,Orange,59,3164182,51112,48226,1277,49503,1009
2020-09-03,Placer,61,380077,3275,3069,14,3083,34
2020-09-03,Plumas,63,18699,44,39,0,39,0
2020-09-03,Riverside,65,2383286,54639,53341,49,53390,1052
2020-09-03,Sacramento,67,1510023,19573,18553,15,18568,328
2020-09-03,San Benito,69,59416,1205,1121,0,1121,4
2020-09-03,San Bernardino,71,2135413,50243,48165,57,48222,800
2020-09-03,San Diego,73,3302833,41607,39448,0,39448,700
2020-09-03,San Francisco,75,870044,10095,9636,22,9658,84
2020-09-03,San Joaquin,77,732212,19042,18331,40,18371,371
2020-09-03,San Luis Obispo,79,281455,3196,3023,12,3035,21
2020-09-03,San Mateo,81,765935,9006,8211,6,8217,122
2020-09-03,Santa Barbara,83,443738,8876,8277,98,8375,96
2020-09-03,Santa Clara,85,1922200,19191,17879,23,17902,208
2020-09-03,Santa Cruz,87,273765,2007,1870,17,1887,7
2020-09-03,Shasta,89,179085,648,535,3,538,10
2020-09-03,Sierra,91,2930,6,6,0,6,0
2020-09-03,Siskiyou,93,43540,144,128,9,137,0
2020-09-03,Solano,95,438530,5710,5499,40,5539,36
2020-09-03,Sonoma,97,501317,6398,5997,19,6016,62
2020-09-03,Stanislaus,99,539301,15572,14985,409,15394,217
2020-09-03,Sutter,101,95872,1481,1412,1,1413,11
2020-09-03,Tehama,103,63373,456,436,4,440,1
2020-09-03,Trinity,105,12862,22,13,4,17,0
2020-09-03,Tulare,107,460477,14956,14408,57,14465,244
2020-09-03,Tuolumne,109,53932,217,193,27,220,1
2020-09-03,Ventura,111,848112,11662,11109,107,11216,112
2020-09-03,Yolo,113,214977,2615,2475,5,2480,53
2020-09-03,Yuba,115,75493,947,867,4,871,1
2020-09-02,Alameda,1,1643700,19484,18522,142,18664,260
2020-09-02,Alpine,3,1148,3,2,0,2,0
2020-09-02,Amador,5,37829,276,245,0,245,14
2020-09-02,Butte,7,227075,2528,2241,14,2255,27
2020-09-02,Calaveras,9,45235,283,235,1,236,1
2020-09-02,Colusa,11,21464,480,460,0,460,6
2020-09-02,Contra Costa,13,1133247,15086,14097,59,14156,159
2020-09-02,Del Norte,15,27424,118,109,0,109,2
2020-09-02,El Dorado,17,186661,1035,975,0,975,2
2020-09-02,Fresno,19,978130,28202,25785,293,26078,292
2020-09-02,Glenn,21,27897,499,457,0,457,3
2020-09-02,Humboldt,23,135768,433,381,0,381,4
2020-09-02,Imperial,25,180216,11395,9832,6,9838,255
2020-09-02,Inyo,27,18085,183,171,0,171,3
2020-09-02,Kern,29,883053,30225,29288,239,29527,335
2020-09-02,Kings,31,150075,6699,6142,34,6176,64
2020-09-02,Lake,33,64148,382,342,0,342,2
2020-09-02,Lassen,35,31185,727,706,1,707,0
2020-09-02,Los Angeles,37,10098052,248342,243999,1449,245448,5887
2020-09-02,Madera,39,155013,4020,3735,26,3761,41
2020-09-02,Marin,41,260295,6322,6131,14,6145,66
2020-09-02,Mariposa,43,17540,74,71,0,71,2
2020-09-02,Mendocino,45,87422,686,636,0,636,15
2020-09-02,Merced,47,269075,8330,8097,10,8107,103
2020-09-02,Modoc,49,8938,22,11,0,11,0
2020-09-02,Mono,51,14174,163,145,1,146,1
2020-09-02,Monterey,53,433212,8593,8070,18,8088,56
2020-09-02,Napa,55,140530,1532,1454,3,1457,10
2020-09-02,Nevada,57,99092,473,452,12,464,6
2020-09-02,Orange,59,3164182,50930,47871,1268,49139,994
2020-09-02,Placer,61,380077,3250,3047,13,3060,33
2020-09-02,Plumas,63,18699,44,39,0,39,0
2020-09-02,Riverside,65,2383286,54437,52923,46,52969,1032
2020-09-02,Sacramento,67,1510023,19339,18355,15,18370,316
2020-09-02,San Benito,69,59416,1192,1107,0,1107,4
2020-09-02,San Bernardino,71,2135413,50080,47766,56,47822,794
2020-09-02,San Diego,73,3302833,41287,39123,0,39123,695
2020-09-02,San Francisco,75,870044,10026,9587,22,9609,84
2020-09-02,San Joaquin,77,732212,18961,18194,39,18233,352
2020-09-02,San Luis Obispo,79,281455,3170,3002,11,3013,21
2020-09-02,San Mateo,81,765935,8949,8148,6,8154,122
2020-09-02,Santa Barbara,83,443738,8821,8206,97,8303,94
2020-09-02,Santa Clara,85,1922200,19038,17673,23,17696,206
2020-09-02,Santa Cruz,87,273765,1984,1850,17,1867,7
2020-09-02,Shasta,89,179085,647,531,3,534,10
2020-09-02,Sierra,91,2930,6,6,0,6,0
2020-09-02,Siskiyou,93,43540,143,127,9,136,0
2020-09-02,Solano,95,438530,5682,5463,40,5503,36
2020-09-02,Sonoma,97,501317,6336,5846,19,5865,62
2020-09-02,Stanislaus,99,539301,15502,14854,402,15256,220
2020-09-02,Sutter,101,95872,1466,1401,1,1402,10
2020-09-02,Tehama,103,63373,453,429,4,433,1
2020-09-02,Trinity,105,12862,22,13,4,17,0
2020-09-02,Tulare,107,460477,14890,14298,56,14354,244
2020-09-02,Tuolumne,109,53932,217,190,27,217,1
2020-09-02,Ventura,111,848112,11575,11031,106,11137,111
2020-09-02,Yolo,113,214977,2594,2449,5,2454,54
2020-09-02,Yuba,115,75493,940,856,4,860,1
2020-09-01,Alameda,1,1643700,19345,18382,139,18521,248
2020-09-01,Alpine,3,1148,3,2,0,2,0
2020-09-01,Amador,5,37829,275,244,0,244,13
2020-09-01,Butte,7,227075,2471,2146,14,2160,26
2020-09-01,Calaveras,9,45235,275,228,1,229,1
2020-09-01,Colusa,11,21464,476,454,0,454,6
2020-09-01,Contra Costa,13,1133247,14992,13998,57,14055,158
2020-09-01,Del Norte,15,27424,117,108,0,108,2
2020-09-01,El Dorado,17,186661,1027,972,0,972,2
2020-09-01,Fresno,19,978130,28057,25542,290,25832,290
2020-09-01,Glenn,21,27897,492,449,0,449,3
2020-09-01,Humboldt,23,135768,427,378,0,378,4
2020-09-01,Imperial,25,180216,11369,9782,6,9788,250
2020-09-01,Inyo,27,18085,183,171,0,171,3
2020-09-01,Kern,29,883053,30135,29162,234,29396,332
2020-09-01,Kings,31,150075,6668,6088,34,6122,62
2020-09-01,Lake,33,64148,379,341,0,341,2
2020-09-01,Lassen,35,31185,724,706,1,707,0
2020-09-01,Los Angeles,37,10098052,247239,242633,1422,244055,5832
2020-09-01,Madera,39,155013,3991,3703,25,3728,41
2020-09-01,Marin,41,260295,6307,6102,14,6116,67
2020-09-01,Mariposa,43,17540,73,72,0,72,2
2020-09-01,Mendocino,45,87422,671,626,0,626,15
2020-09-01,Merced,47,269075,8277,8046,9,8055,103
2020-09-01,Modoc,49,8938,20,10,0,10,0
2020-09-01,Mono,51,14174,163,145,1,146,1
2020-09-01,Monterey,53,433212,8485,7926,18,7944,56
2020-09-01,Napa,55,140530,1517,1446,3,1449,10
2020-09-01,Nevada,57,99092,467,450,12,462,6
2020-09-01,Orange,59,3164182,50765,47671,1249,48920,976
2020-09-01,Placer,61,380077,3228,3013,13,3026,33
2020-09-01,Plumas,63,18699,44,39,0,39,0
2020-09-01,Riverside,65,2383286,54218,52785,45,52830,1027
2020-09-01,Sacramento,67,1510023,19155,18217,14,18231,305
2020-09-01,San Benito,69,59416,1180,1089,0,1089,4
2020-09-01,San Bernardino,71,2135413,49873,47371,56,47427,786
2020-09-01,San Diego,73,3302833,40928,38873,0,38873,688
2020-09-01,San Francisco,75,870044,9957,9492,22,9514,83
2020-09-01,San Joaquin,77,732212,18879,17915,38,17953,341
2020-09-01,San Luis Obispo,79,281455,3144,2970,11,2981,21
2020-09-01,San Mateo,81,765935,8870,8132,6,8138,122
2020-09-01,Santa Barbara,83,443738,8771,8142,96,8238,93
2020-09-01,Santa Clara,85,1922200,18860,17319,23,17342,204
2020-09-01,Santa Cruz,87,273765,1960,1752,17,1769,7
2020-09-01,Shasta,89,179085,639,527,3,530,9
2020-09-01,Sierra,91,2930,6,6,0,6,0
2020-09-01,Siskiyou,93,43540,140,128,8,136,0
2020-09-01,Solano,95,438530,5656,5438,40,5478,34
2020-09-01,Sonoma,97,501317,6246,5733,19,5752,60
2020-09-01,Stanislaus,99,539301,15428,14784,392,15176,212
2020-09-01,Sutter,101,95872,1455,1389,1,1390,10
2020-09-01,Tehama,103,63373,449,422,4,426,1
2020-09-01,Trinity,105,12862,22,13,4,17,0
2020-09-01,Tulare,107,460477,14807,14156,56,14212,241
2020-09-01,Tuolumne,109,53932,211,183,27,210,1
2020-09-01,Ventura,111,848112,11501,10899,100,10999,108
2020-09-01,Yolo,113,214977,2577,2440,5,2445,51
2020-09-01,Yuba,115,75493,931,841,4,845,1
2020-08-31,Alameda,1,1643700,19201,18148,139,18287,248
2020-08-31,Alpine,3,1148,3,2,0,2,0
2020-08-31,Amador,5,37829,275,243,0,243,13
2020-08-31,Butte,7,227075,2408,2069,14,2083,26
2020-08-31,Calaveras,9,45235,270,212,1,213,1
2020-08-31,Colusa,11,21464,475,443,0,443,6
2020-08-31,Contra Costa,13,1133247,14865,13902,53,13955,153
2020-08-31,Del Norte,15,27424,117,108,0,108,2
2020-08-31,El Dorado,17,186661,1020,965,0,965,2
2020-08-31,Fresno,19,978130,27839,25185,284,25469,290
2020-08-31,Glenn,21,27897,480,437,0,437,3
2020-08-31,Humboldt,23,135768,425,374,0,374,4
2020-08-31,Imperial,25,180216,11338,9759,6,9765,250
2020-08-31,Inyo,27,18085,182,160,0,160,3
2020-08-31,Kern,29,883053,30037,29067,233,29300,318
2020-08-31,Kings,31,150075,6400,6037,34,6071,62
2020-08-31,Lake,33,64148,363,341,0,341,2
2020-08-31,Lassen,35,31185,721,706,1,707,0
2020-08-31,Los Angeles,37,10098052,246121,241793,1394,243187,5787
2020-08-31,Madera,39,155013,3968,3662,24,3686,35
2020-08-31,Marin,41,260295,6270,6074,14,6088,67
2020-08-31,Mariposa,43,17540,73,69,0,69,2
2020-08-31,Mendocino,45,87422,659,618,0,618,15
2020-08-31,Merced,47,269075,8216,7991,9,8000,79
2020-08-31,Modoc,49,8938,18,10,0,10,0
2020-08-31,Mono,51,14174,163,145,1,146,1
2020-08-31,Monterey,53,433212,8378,7839,18,7857,56
2020-08-31,Napa,55,140530,1509,1434,3,1437,10
2020-08-31,Nevada,57,99092,465,447,12,459,6
2020-08-31,Orange,59,3164182,50567,47392,1220,48612,965
2020-08-31,Placer,61,380077,3177,2989,13,3002,33
2020-08-31,Plumas,63,18699,43,39,0,39,0
2020-08-31,Riverside,65,2383286,53998,52508,43,52551,1020
2020-08-31,Sacramento,67,1510023,18920,17999,14,18013,303
2020-08-31,San Benito,69,59416,1164,1080,0,1080,4
2020-08-31,San Bernardino,71,2135413,49664,47370,55,47425,755
2020-08-31,San Diego,73,3302833,40561,38606,0,38606,682
2020-08-31,San Francisco,75,870044,9878,9293,19,9312,83
2020-08-31,San Joaquin,77,732212,18792,17807,37,17844,338
2020-08-31,San Luis Obispo,79,281455,3121,2951,10,2961,21
2020-08-31,San Mateo,81,765935,8800,8065,6,8071,122
2020-08-31,Santa Barbara,83,443738,8724,8124,96,8220,94
2020-08-31,Santa Clara,85,1922200,18671,17211,23,17234,202
2020-08-31,Santa Cruz,87,273765,1935,1742,17,1759,7
2020-08-31,Shasta,89,179085,634,528,3,531,9
2020-08-31,Sierra,91,2930,6,6,0,6,0
2020-08-31,Siskiyou,93,43540,139,127,8,135,0
2020-08-31,Solano,95,438530,5624,5302,39,5341,34
2020-08-31,Sonoma,97,501317,6171,5650,19,5669,60
2020-08-31,Stanislaus,99,539301,15355,14685,382,15067,213
2020-08-31,Sutter,101,95872,1440,1365,1,1366,10
2020-08-31,Tehama,103,63373,446,421,4,425,1
2020-08-31,Trinity,105,12862,22,13,4,17,0
2020-08-31,Tulare,107,460477,14720,13985,55,14040,237
2020-08-31,Tuolumne,109,53932,211,178,27,205,1
2020-08-31,Ventura,111,848112,11418,10866,99,10965,108
2020-08-31,Yolo,113,214977,2559,2423,5,2428,51
2020-08-31,Yuba,115,75493,917,830,4,834,1
2020-08-30,Alameda,1,1643700,19077,18099,136,18235,248
2020-08-30,Alpine,3,1148,3,2,0,2,0
2020-08-30,Amador,5,37829,274,240,0,240,13
2020-08-30,Butte,7,227075,2328,1988,14,2002,26
2020-08-30,Calaveras,9,45235,261,211,1,212,1
2020-08-30,Colusa,11,21464,474,440,0,440,6
2020-08-30,Contra Costa,13,1133247,14726,13780,53,13833,150
2020-08-30,Del Norte,15,27424,116,108,0,108,2
2020-08-30,El Dorado,17,186661,1010,962,0,962,2
2020-08-30,Fresno,19,978130,27715,24963,283,25246,291
2020-08-30,Glenn,21,27897,473,437,0,437,3
2020-08-30,Humboldt,23,135768,414,362,0,362,4
2020-08-30,Imperial,25,180216,11319,9703,6,9709,250
2020-08-30,Inyo,27,18085,182,160,0,160,3
2020-08-30,Kern,29,883053,29944,28987,233,29220,317
2020-08-30,Kings,31,150075,6354,6000,34,6034,62
2020-08-30,Lake,33,64148,358,334,0,334,2
2020-08-30,Lassen,35,31185,719,706,1,707,0
2020-08-30,Los Angeles,37,10098052,244970,240775,1360,242135,5772
2020-08-30,Madera,39,155013,3939,3626,24,3650,33
2020-08-30,Marin,41,260295,6240,6060,14,6074,66
2020-08-30,Mariposa,43,17540,73,69,0,69,2
2020-08-30,Mendocino,45,87422,653,611,0,611,13
2020-08-30,Merced,47,269075,8141,7960,9,7969,79
2020-08-30,Modoc,49,8938,13,10,0,10,0
2020-08-30,Mono,51,14174,163,145,1,146,1
2020-08-30,Monterey,53,433212,8295,7816,18,7834,54
2020-08-30,Napa,55,140530,1497,1423,3,1426,10
2020-08-30,Nevada,57,99092,462,445,12,457,6
2020-08-30,Orange,59,3164182,50373,47283,1204,48487,965
2020-08-30,Placer,61,380077,3144,2961,13,2974,32
2020-08-30,Plumas,63,18699,42,39,0,39,0
2020-08-30,Riverside,65,2383286,53819,52227,41,52268,1017
2020-08-30,Sacramento,67,1510023,18740,17751,14,17765,300
2020-08-30,San Benito,69,59416,1154,1071,0,1071,4
2020-08-30,San Bernardino,71,2135413,49408,47201,55,47256,755
2020-08-30,San Diego,73,3302833,40163,38302,0,38302,682
2020-08-30,San Francisco,75,870044,9780,9294,16,9310,83
2020-08-30,San Joaquin,77,732212,18675,17637,36,17673,338
2020-08-30,San Luis Obispo,79,281455,3097,2934,10,2944,21
2020-08-30,San Mateo,81,765935,8723,8013,5,8018,122
2020-08-30,Santa Barbara,83,443738,8664,8088,96,8184,93
2020-08-30,Santa Clara,85,1922200,18495,17045,23,17068,202
2020-08-30,Santa Cruz,87,273765,1909,1743,17,1760,7
2020-08-30,Shasta,89,179085,631,525,3,528,9
2020-08-30,Sierra,91,2930,6,6,0,6,0
2020-08-30,Siskiyou,93,43540,137,125,8,133,0
2020-08-30,Solano,95,438530,5580,5303,39,5342,34
2020-08-30,Sonoma,97,501317,6113,5590,19,5609,60
2020-08-30,Stanislaus,99,539301,15284,14580,373,14953,209
2020-08-30,Sutter,101,95872,1418,1351,1,1352,10
2020-08-30,Tehama,103,63373,437,419,4,423,1
2020-08-30,Trinity,105,12862,22,13,4,17,0
2020-08-30,Tulare,107,460477,14625,13985,54,14039,236
2020-08-30,Tuolumne,109,53932,207,178,27,205,1
2020-08-30,Ventura,111,848112,11306,10775,94,10869,108
2020-08-30,Yolo,113,214977,2531,2391,4,2395,51
2020-08-30,Yuba,115,75493,903,832,4,836,1
2020-08-29,Alameda,1,1643700,19011,17888,136,18024,250
2020-08-29,Alpine,3,1148,3,2,0,2,0
2020-08-29,Amador,5,37829,274,239,0,239,13
2020-08-29,Butte,7,227075,2297,1948,14,1962,26
2020-08-29,Calaveras,9,45235,257,211,1,212,1
2020-08-29,Colusa,11,21464,471,440,0,440,6
2020-08-29,Contra Costa,13,1133247,14653,13663,52,13715,159
2020-08-29,Del Norte,15,27424,116,108,0,108,1
2020-08-29,El Dorado,17,186661,1007,958,0,958,2
2020-08-29,Fresno,19,978130,27660,24821,283,25104,291
2020-08-29,Glenn,21,27897,467,437,0,437,3
2020-08-29,Humboldt,23,135768,411,363,0,363,4
2020-08-29,Imperial,25,180216,11304,9698,6,9704,250
2020-08-29,Inyo,27,18085,182,160,0,160,3
2020-08-29,Kern,29,883053,29903,28947,232,29179,317
2020-08-29,Kings,31,150075,6339,5906,34,5940,62
2020-08-29,Lake,33,64148,357,329,0,329,2
2020-08-29,Lassen,35,31185,719,706,1,707,0
2020-08-29,Los Angeles,37,10098052,244312,239815,1347,241162,5762
2020-08-29,Madera,39,155013,3930,3605,23,3628,33
2020-08-29,Marin,41,260295,6228,6007,14,6021,64
2020-08-29,Mariposa,43,17540,73,69,0,69,2
2020-08-29,Mendocino,45,87422,648,596,0,596,13
2020-08-29,Merced,47,269075,8111,7867,9,7876,79
2020-08-29,Modoc,49,8938,13,9,0,9,0
2020-08-29,Mono,51,14174,163,145,1,146,1
2020-08-29,Monterey,53,433212,8249,7680,18,7698,53
2020-08-29,Napa,55,140530,1494,1413,3,1416,10
2020-08-29,Nevada,57,99092,462,442,12,454,5
2020-08-29,Orange,59,3164182,50268,47007,1193,48200,960
2020-08-29,Placer,61,380077,3128,2935,13,2948,32
2020-08-29,Plumas,63,18699,41,39,0,39,0
2020-08-29,Riverside,65,2383286,53708,51918,39,51957,1016
2020-08-29,Sacramento,67,1510023,18669,17588,14,17602,291
2020-08-29,San Benito,69,59416,1145,1045,0,1045,4
2020-08-29,San Bernardino,71,2135413,49294,46849,55,46904,755
2020-08-29,San Diego,73,3302833,39897,38049,0,38049,694
2020-08-29,San Francisco,75,870044,9752,9291,15,9306,83
2020-08-29,San Joaquin,77,732212,18631,17493,36,17529,335
2020-08-29,San Luis Obispo,79,281455,3073,2917,10,2927,21
2020-08-29,San Mateo,81,765935,8681,7928,5,7933,122
2020-08-29,Santa Barbara,83,443738,8638,8052,95,8147,93
2020-08-29,Santa Clara,85,1922200,18398,16898,22,16920,202
2020-08-29,Santa Cruz,87,273765,1897,1746,17,1763,7
2020-08-29,Shasta,89,179085,623,522,3,525,9
2020-08-29,Sierra,91,2930,6,6,0,6,0
2020-08-29,Siskiyou,93,43540,137,121,8,129,0
2020-08-29,Solano,95,438530,5559,5303,39,5342,34
2020-08-29,Sonoma,97,501317,6079,5537,19,5556,60
2020-08-29,Stanislaus,99,539301,15235,14479,363,14842,208
2020-08-29,Sutter,101,95872,1413,1333,1,1334,9
2020-08-29,Tehama,103,63373,436,417,4,421,1
2020-08-29,Trinity,105,12862,22,11,4,15,0
2020-08-29,Tulare,107,460477,14587,13890,53,13943,236
2020-08-29,Tuolumne,109,53932,207,178,27,205,1
2020-08-29,Ventura,111,848112,11266,10705,94,10799,108
2020-08-29,Yolo,113,214977,2513,2357,4,2361,51
2020-08-29,Yuba,115,75493,894,822,4,826,1
2020-08-28,Alameda,1,1643700,18927,17729,135,17864,237
2020-08-28,Alpine,3,1148,3,2,0,2,0
2020-08-28,Amador,5,37829,274,234,0,234,13
2020-08-28,Butte,7,227075,2267,1886,14,1900,25
2020-08-28,Calaveras,9,45235,255,207,1,208,1
2020-08-28,Colusa,11,21464,470,441,0,441,6
2020-08-28,Contra Costa,13,1133247,14582,13522,51,13573,158
2020-08-28,Del Norte,15,27424,116,107,0,107,1
2020-08-28,El Dorado,17,186661,1001,949,0,949,2
2020-08-28,Fresno,19,978130,27526,24612,283,24895,282
2020-08-28,Glenn,21,27897,460,429,0,429,3
2020-08-28,Humboldt,23,135768,407,362,0,362,4
2020-08-28,Imperial,25,180216,11290,9656,6,9662,241
2020-08-28,Inyo,27,18085,181,160,0,160,2
2020-08-28,Kern,29,883053,29856,28744,232,28976,306
2020-08-28,Kings,31,150075,6332,5829,33,5862,62
2020-08-28,Lake,33,64148,352,320,0,320,2
2020-08-28,Lassen,35,31185,719,704,1,705,0
2020-08-28,Los Angeles,37,10098052,243503,238544,1322,239866,5740
2020-08-28,Madera,39,155013,3911,3552,23,3575,33
2020-08-28,Marin,41,260295,6206,5991,14,6005,63
2020-08-28,Mariposa,43,17540,73,67,0,67,2
2020-08-28,Mendocino,45,87422,643,588,0,588,11
2020-08-28,Merced,47,269075,8081,7803,9,7812,77
2020-08-28,Modoc,49,8938,13,6,0,6,0
2020-08-28,Mono,51,14174,163,145,1,146,1
2020-08-28,Monterey,53,433212,8192,7591,18,7609,53
2020-08-28,Napa,55,140530,1486,1403,3,1406,10
2020-08-28,Nevada,57,99092,461,438,12,450,5
2020-08-28,Orange,59,3164182,50168,46696,1178,47874,942
2020-08-28,Placer,61,380077,3117,2891,13,2904,32
2020-08-28,Plumas,63,18699,41,39,0,39,0
2020-08-28,Riverside,65,2383286,53577,51510,36,51546,1008
2020-08-28,Sacramento,67,1510023,18571,17119,14,17133,283
2020-08-28,San Benito,69,59416,1129,1016,0,1016,3
2020-08-28,San Bernardino,71,2135413,49179,46553,55,46608,754
2020-08-28,San Diego,73,3302833,39667,37786,0,37786,676
2020-08-28,San Francisco,75,870044,9698,9135,15,9150,83
2020-08-28,San Joaquin,77,732212,18578,17114,35,17149,314
2020-08-28,San Luis Obispo,79,281455,3056,2849,10,2859,20
2020-08-28,San Mateo,81,765935,8634,7783,5,7788,121
2020-08-28,Santa Barbara,83,443738,8604,8001,95,8096,92
2020-08-28,Santa Clara,85,1922200,18267,16696,22,16718,201
2020-08-28,Santa Cruz,87,273765,1885,1747,17,1764,7
2020-08-28,Shasta,89,179085,619,516,3,519,9
2020-08-28,Sierra,91,2930,6,6,0,6,0
2020-08-28,Siskiyou,93,43540,135,119,8,127,0
2020-08-28,Solano,95,438530,5540,5219,39,5258,34
2020-08-28,Sonoma,97,501317,6044,5425,18,5443,58
2020-08-28,Stanislaus,99,539301,15193,14176,358,14534,190
2020-08-28,Sutter,101,95872,1403,1308,1,1309,9
2020-08-28,Tehama,103,63373,431,410,4,414,1
2020-08-28,Trinity,105,12862,22,11,4,15,0
2020-08-28,Tulare,107,460477,14541,13776,53,13829,236
2020-08-28,Tuolumne,109,53932,207,176,27,203,1
2020-08-28,Ventura,111,848112,11230,10606,92,10698,103
2020-08-28,Yolo,113,214977,2504,2323,4,2327,51
2020-08-28,Yuba,115,75493,885,810,4,814,1
2020-08-27,Alameda,1,1643700,18783,17584,132,17716,234
2020-08-27,Alpine,3,1148,3,2,0,2,0
2020-08-27,Amador,5,37829,273,233,0,233,13
2020-08-27,Butte,7,227075,2201,1803,13,1816,25
2020-08-27,Calaveras,9,45235,249,204,1,205,1
2020-08-27,Colusa,11,21464,468,438,0,438,6
2020-08-27,Contra Costa,13,1133247,14482,13379,50,13429,158
2020-08-27,Del Norte,15,27424,116,107,0,107,1
2020-08-27,El Dorado,17,186661,997,942,0,942,2
2020-08-27,Fresno,19,978130,27347,24367,278,24645,272
2020-08-27,Glenn,21,27897,452,429,0,429,3
2020-08-27,Humboldt,23,135768,399,358,0,358,4
2020-08-27,Imperial,25,180216,11263,9608,6,9614,235
2020-08-27,Inyo,27,18085,181,157,0,157,2
2020-08-27,Kern,29,883053,29784,28635,223,28858,294
2020-08-27,Kings,31,150075,6310,5759,33,5792,62
2020-08-27,Lake,33,64148,350,314,0,314,2
2020-08-27,Lassen,35,31185,719,703,1,704,0
2020-08-27,Los Angeles,37,10098052,242492,237103,1304,238407,5704
2020-08-27,Madera,39,155013,3885,3465,23,3488,33
2020-08-27,Marin,41,260295,6182,5929,14,5943,62
2020-08-27,Mariposa,43,17540,73,67,0,67,2
2020-08-27,Mendocino,45,87422,634,581,0,581,10
2020-08-27,Merced,47,269075,8037,7765,9,7774,75
2020-08-27,Modoc,49,8938,11,5,0,5,0
2020-08-27,Mono,51,14174,163,145,1,146,1
2020-08-27,Monterey,53,433212,8098,7501,18,7519,52
2020-08-27,Napa,55,140530,1480,1397,3,1400,10
2020-08-27,Nevada,57,99092,458,435,12,447,5
2020-08-27,Orange,59,3164182,50011,46449,1167,47616,935
2020-08-27,Placer,61,380077,3086,2869,13,2882,32
2020-08-27,Plumas,63,18699,40,39,0,39,0
2020-08-27,Riverside,65,2383286,53371,51306,33,51339,999
2020-08-27,Sacramento,67,1510023,18372,16875,14,16889,281
2020-08-27,San Benito,69,59416,1113,987,0,987,3
2020-08-27,San Bernardino,71,2135413,48953,46345,55,46400,751
2020-08-27,San Diego,73,3302833,39396,37501,0,37501,673
2020-08-27,San Francisco,75,870044,9632,9014,15,9029,83
2020-08-27,San Joaquin,77,732212,18498,16989,35,17024,314
2020-08-27,San Luis Obispo,79,281455,3031,2808,10,2818,20
2020-08-27,San Mateo,81,765935,8526,7728,5,7733,121
2020-08-27,Santa Barbara,83,443738,8566,7934,95,8029,92
2020-08-27,Santa Clara,85,1922200,18084,16495,22,16517,199
2020-08-27,Santa Cruz,87,273765,1868,1734,17,1751,7
2020-08-27,Shasta,89,179085,613,512,3,515,9
2020-08-27,Sierra,91,2930,6,6,0,6,0
2020-08-27,Siskiyou,93,43540,135,118,8,126,0
2020-08-27,Solano,95,438530,5502,5167,39,5206,34
2020-08-27,Sonoma,97,501317,5932,5357,18,5375,58
2020-08-27,Stanislaus,99,539301,15113,14080,354,14434,186
2020-08-27,Sutter,101,95872,1383,1296,1,1297,9
2020-08-27,Tehama,103,63373,426,398,4,402,1
2020-08-27,Trinity,105,12862,22,11,4,15,0
2020-08-27,Tulare,107,460477,14449,13666,52,13718,231
2020-08-27,Tuolumne,109,53932,202,174,27,201,1
2020-08-27,Ventura,111,848112,11167,10483,88,10571,102
2020-08-27,Yolo,113,214977,2480,2293,4,2297,51
2020-08-27,Yuba,115,75493,874,807,3,810,1
2020-08-26,Alameda,1,1643700,18622,17373,132,17505,233
2020-08-26,Alpine,3,1148,3,2,0,2,0
2020-08-26,Amador,5,37829,273,229,0,229,13
2020-08-26,Butte,7,227075,2134,1765,11,1776,25
2020-08-26,Calaveras,9,45235,241,201,1,202,1
2020-08-26,Colusa,11,21464,462,433,0,433,5
2020-08-26,Contra Costa,13,1133247,14344,13248,50,13298,157
2020-08-26,Del Norte,15,27424,115,86,0,86,1
2020-08-26,El Dorado,17,186661,995,938,0,938,2
2020-08-26,Fresno,19,978130,27199,24071,276,24347,255
2020-08-26,Glenn,21,27897,450,429,0,429,3
2020-08-26,Humboldt,23,135768,387,357,0,357,4
2020-08-26,Imperial,25,180216,11241,9453,6,9459,227
2020-08-26,Inyo,27,18085,178,157,0,157,2
2020-08-26,Kern,29,883053,29647,28507,219,28726,286
2020-08-26,Kings,31,150075,6290,5720,33,5753,62
2020-08-26,Lake,33,64148,346,308,0,308,2
2020-08-26,Lassen,35,31185,719,702,1,703,0
2020-08-26,Los Angeles,37,10098052,241457,235499,1271,236770,5665
2020-08-26,Madera,39,155013,3856,3458,23,3481,32
2020-08-26,Marin,41,260295,6165,5887,14,5901,56
2020-08-26,Mariposa,43,17540,73,68,0,68,2
2020-08-26,Mendocino,45,87422,623,581,0,581,10
2020-08-26,Merced,47,269075,8004,7720,9,7729,74
2020-08-26,Modoc,49,8938,8,5,0,5,0
2020-08-26,Mono,51,14174,163,141,1,142,1
2020-08-26,Monterey,53,433212,8005,7439,18,7457,51
2020-08-26,Napa,55,140530,1467,1382,3,1385,10
2020-08-26,Nevada,57,99092,455,432,12,444,2
2020-08-26,Orange,59,3164182,49827,46157,1152,47309,905
2020-08-26,Placer,61,380077,3064,2846,11,2857,32
2020-08-26,Plumas,63,18699,39,39,0,39,0
2020-08-26,Riverside,65,2383286,53129,51138,33,51171,987
2020-08-26,Sacramento,67,1510023,18209,16708,14,16722,271
2020-08-26,San Benito,69,59416,1098,978,0,978,3
2020-08-26,San Bernardino,71,2135413,48744,45840,55,45895,743
2020-08-26,San Diego,73,3302833,39058,37224,0,37224,668
2020-08-26,San Francisco,75,870044,9557,8938,15,8953,81
2020-08-26,San Joaquin,77,732212,18409,16845,34,16879,309
2020-08-26,San Luis Obispo,79,281455,3003,2761,10,2771,20
2020-08-26,San Mateo,81,765935,8459,7655,5,7660,121
2020-08-26,Santa Barbara,83,443738,8533,7904,95,7999,90
2020-08-26,Santa Clara,85,1922200,17908,16283,22,16305,198
2020-08-26,Santa Cruz,87,273765,1857,1726,17,1743,7
2020-08-26,Shasta,89,179085,608,511,3,514,9
2020-08-26,Sierra,91,2930,6,6,0,6,0
2020-08-26,Siskiyou,93,43540,132,109,8,117,0
2020-08-26,Solano,95,438530,5478,5131,38,5169,34
2020-08-26,Sonoma,97,501317,5858,5283,18,5301,58
2020-08-26,Stanislaus,99,539301,15036,13964,348,14312,186
2020-08-26,Sutter,101,95872,1365,1275,1,1276,9
2020-08-26,Tehama,103,63373,423,396,4,400,1
2020-08-26,Trinity,105,12862,22,10,4,14,0
2020-08-26,Tulare,107,460477,14382,13568,52,13620,232
2020-08-26,Tuolumne,109,53932,201,172,27,199,1
2020-08-26,Ventura,111,848112,11096,10412,81,10493,100
2020-08-26,Yolo,113,214977,2458,2279,4,2283,49
2020-08-26,Yuba,115,75493,859,779,3,782,1
2020-08-25,Alameda,1,1643700,18464,17278,132,17410,232
2020-08-25,Alpine,3,1148,3,2,0,2,0
2020-08-25,Amador,5,37829,273,227,0,227,13
2020-08-25,Butte,7,227075,2067,1718,11,1729,24
2020-08-25,Calaveras,9,45235,239,196,1,197,1
2020-08-25,Colusa,11,21464,455,430,0,430,5
2020-08-25,Contra Costa,13,1133247,14206,13181,49,13230,156
2020-08-25,Del Norte,15,27424,114,83,0,83,1
2020-08-25,El Dorado,17,186661,992,928,0,928,2
2020-08-25,Fresno,19,978130,27012,23932,275,24207,250
2020-08-25,Glenn,21,27897,447,429,0,429,3
2020-08-25,Humboldt,23,135768,382,342,0,342,4
2020-08-25,Imperial,25,180216,11213,9381,6,9387,217
2020-08-25,Inyo,27,18085,176,144,0,144,1
2020-08-25,Kern,29,883053,29510,28416,219,28635,285
2020-08-25,Kings,31,150075,6133,5702,33,5735,59
2020-08-25,Lake,33,64148,341,304,0,304,2
2020-08-25,Lassen,35,31185,718,692,1,693,0
2020-08-25,Los Angeles,37,10098052,240136,233961,1224,235185,5612
2020-08-25,Madera,39,155013,3841,3446,22,3468,32
2020-08-25,Marin,41,260295,6127,5860,14,5874,56
2020-08-25,Mariposa,43,17540,73,67,0,67,2
2020-08-25,Mendocino,45,87422,617,571,0,571,10
2020-08-25,Merced,47,269075,7937,7693,8,7701,69
2020-08-25,Modoc,49,8938,8,5,0,5,0
2020-08-25,Mono,51,14174,163,129,1,130,1
2020-08-25,Monterey,53,433212,7925,7333,18,7351,51
2020-08-25,Napa,55,140530,1460,1374,3,1377,10
2020-08-25,Nevada,57,99092,452,430,12,442,2
2020-08-25,Orange,59,3164182,49634,45737,1135,46872,902
2020-08-25,Placer,61,380077,3045,2829,8,2837,31
2020-08-25,Plumas,63,18699,39,39,0,39,0
2020-08-25,Riverside,65,2383286,52899,50889,33,50922,981
2020-08-25,Sacramento,67,1510023,18057,16601,14,16615,265
2020-08-25,San Benito,69,59416,1082,973,0,973,3
2020-08-25,San Bernardino,71,2135413,48509,45544,55,45599,727
2020-08-25,San Diego,73,3302833,38780,36996,0,36996,665
2020-08-25,San Francisco,75,870044,9480,8848,15,8863,81
2020-08-25,San Joaquin,77,732212,18281,16795,34,16829,306
2020-08-25,San Luis Obispo,79,281455,2945,2731,8,2739,20
2020-08-25,San Mateo,81,765935,8399,7636,5,7641,120
2020-08-25,Santa Barbara,83,443738,8481,7854,94,7948,90
2020-08-25,Santa Clara,85,1922200,17735,16199,22,16221,194
2020-08-25,Santa Cruz,87,273765,1838,1708,17,1725,7
2020-08-25,Shasta,89,179085,604,511,3,514,9
2020-08-25,Sierra,91,2930,6,6,0,6,0
2020-08-25,Siskiyou,93,43540,131,109,8,117,0
2020-08-25,Solano,95,438530,5417,5114,38,5152,34
2020-08-25,Sonoma,97,501317,5773,5148,18,5166,56
2020-08-25,Stanislaus,99,539301,14928,13886,337,14223,182
2020-08-25,Sutter,101,95872,1348,1259,1,1260,9
2020-08-25,Tehama,103,63373,420,394,4,398,1
2020-08-25,Trinity,105,12862,20,10,4,14,0
2020-08-25,Tulare,107,460477,14279,13514,51,13565,224
2020-08-25,Tuolumne,109,53932,199,172,27,199,1
2020-08-25,Ventura,111,848112,11011,10313,76,10389,99
2020-08-25,Yolo,113,214977,2445,2254,4,2258,50
2020-08-25,Yuba,115,75493,849,775,3,778,1
2020-08-24,Alameda,1,1643700,18272,16913,131,17044,231
2020-08-24,Alpine,3,1148,3,2,0,2,0
2020-08-24,Amador,5,37829,271,227,0,227,13
2020-08-24,Butte,7,227075,1983,1649,11,1660,23
2020-08-24,Calaveras,9,45235,229,187,1,188,1
2020-08-24,Colusa,11,21464,451,425,0,425,5
2020-08-24,Contra Costa,13,1133247,14090,12906,47,12953,153
2020-08-24,Del Norte,15,27424,114,80,0,80,1
2020-08-24,El Dorado,17,186661,984,908,0,908,2
2020-08-24,Fresno,19,978130,26827,23618,268,23886,235
2020-08-24,Glenn,21,27897,445,421,0,421,2
2020-08-24,Humboldt,23,135768,378,340,0,340,4
2020-08-24,Imperial,25,180216,11179,9323,6,9329,210
2020-08-24,Inyo,27,18085,172,144,0,144,2
2020-08-24,Kern,29,883053,29413,28157,213,28370,277
2020-08-24,Kings,31,150075,6045,5652,33,5685,60
2020-08-24,Lake,33,64148,327,302,0,302,2
2020-08-24,Lassen,35,31185,718,693,1,694,0
2020-08-24,Los Angeles,37,10098052,238772,233036,1202,234238,5562
2020-08-24,Madera,39,155013,3814,3418,22,3440,32
2020-08-24,Marin,41,260295,6064,5834,14,5848,56
2020-08-24,Mariposa,43,17540,71,66,0,66,2
2020-08-24,Mendocino,45,87422,602,550,0,550,10
2020-08-24,Merced,47,269075,7859,7605,8,7613,69
2020-08-24,Modoc,49,8938,8,5,0,5,0
2020-08-24,Mono,51,14174,163,129,1,130,1
2020-08-24,Monterey,53,433212,7816,7212,17,7229,50
2020-08-24,Napa,55,140530,1447,1358,3,1361,10
2020-08-24,Nevada,57,99092,447,423,12,435,2
2020-08-24,Orange,59,3164182,49443,45536,1124,46660,887
2020-08-24,Placer,61,380077,2999,2793,8,2801,31
2020-08-24,Plumas,63,18699,39,37,0,37,0
2020-08-24,Riverside,65,2383286,52622,50496,33,50529,975
2020-08-24,Sacramento,67,1510023,17859,16318,14,16332,249
2020-08-24,San Benito,69,59416,1061,961,0,961,3
2020-08-24,San Bernardino,71,2135413,48248,45199,54,45253,720
2020-08-24,San Diego,73,3302833,38493,36729,0,36729,660
2020-08-24,San Francisco,75,870044,9397,8621,15,8636,81
2020-08-24,San Joaquin,77,732212,18140,16565,33,16598,305
2020-08-24,San Luis Obispo,79,281455,2917,2705,8,2713,20
2020-08-24,San Mateo,81,765935,8333,7502,5,7507,120
2020-08-24,Santa Barbara,83,443738,8440,7784,94,7878,90
2020-08-24,Santa Clara,85,1922200,17532,16049,22,16071,192
2020-08-24,Santa Cruz,87,273765,1818,1627,16,1643,6
2020-08-24,Shasta,89,179085,602,505,3,508,9
2020-08-24,Sierra,91,2930,6,6,0,6,0
2020-08-24,Siskiyou,93,43540,127,107,8,115,0
2020-08-24,Solano,95,438530,5368,4979,36,5015,32
2020-08-24,Sonoma,97,501317,5671,5071,18,5089,56
2020-08-24,Stanislaus,99,539301,14830,13521,322,13843,171
2020-08-24,Sutter,101,95872,1329,1219,1,1220,9
2020-08-24,Tehama,103,63373,415,388,4,392,1
2020-08-24,Trinity,105,12862,20,10,4,14,0
2020-08-24,Tulare,107,460477,14172,13360,49,13409,223
2020-08-24,Tuolumne,109,53932,198,170,27,197,1
2020-08-24,Ventura,111,848112,10931,10261,73,10334,99
2020-08-24,Yolo,113,214977,2410,2239,4,2243,47
2020-08-24,Yuba,115,75493,832,750,3,753,1
2020-08-23,Alameda,1,1643700,18049,16786,131,16917,231
2020-08-23,Alpine,3,1148,3,2,0,2,0
2020-08-23,Amador,5,37829,268,227,0,227,13
2020-08-23,Butte,7,227075,1869,1637,11,1648,23
2020-08-23,Calaveras,9,45235,219,187,1,188,1
2020-08-23,Colusa,11,21464,444,424,0,424,5
2020-08-23,Contra Costa,13,1133247,13930,12642,47,12689,153
2020-08-23,Del Norte,15,27424,114,80,0,80,1
2020-08-23,El Dorado,17,186661,971,901,0,901,2
2020-08-23,Fresno,19,978130,26625,23414,263,23677,235
2020-08-23,Glenn,21,27897,438,421,0,421,2
2020-08-23,Humboldt,23,135768,376,341,0,341,4
2020-08-23,Imperial,25,180216,11152,9243,6,9249,210
2020-08-23,Inyo,27,18085,169,144,0,144,2
2020-08-23,Kern,29,883053,29265,28028,207,28235,277
2020-08-23,Kings,31,150075,6003,5628,33,5661,60
2020-08-23,Lake,33,64148,323,299,0,299,2
2020-08-23,Lassen,35,31185,717,693,1,694,0
2020-08-23,Los Angeles,37,10098052,237175,231833,1125,232958,5549
2020-08-23,Madera,39,155013,3782,3401,21,3422,32
2020-08-23,Marin,41,260295,6024,5807,13,5820,50
2020-08-23,Mariposa,43,17540,71,66,0,66,2
2020-08-23,Mendocino,45,87422,598,550,0,550,10
2020-08-23,Merced,47,269075,7790,7574,7,7581,69
2020-08-23,Modoc,49,8938,7,5,0,5,0
2020-08-23,Mono,51,14174,163,129,1,130,1
2020-08-23,Monterey,53,433212,7726,7173,17,7190,50
2020-08-23,Napa,55,140530,1435,1348,3,1351,10
2020-08-23,Nevada,57,99092,442,421,12,433,2
2020-08-23,Orange,59,3164182,49207,45267,1111,46378,887
2020-08-23,Placer,61,380077,2960,2772,8,2780,31
2020-08-23,Plumas,63,18699,39,37,0,37,0
2020-08-23,Riverside,65,2383286,52353,50293,31,50324,955
2020-08-23,Sacramento,67,1510023,17635,16084,13,16097,243
2020-08-23,San Benito,69,59416,1048,938,0,938,3
2020-08-23,San Bernardino,71,2135413,47979,45010,53,45063,719
2020-08-23,San Diego,73,3302833,38172,36542,0,36542,660
2020-08-23,San Francisco,75,870044,9302,8564,14,8578,80
2020-08-23,San Joaquin,77,732212,18008,16069,32,16101,305
2020-08-23,San Luis Obispo,79,281455,2875,2679,8,2687,20
2020-08-23,San Mateo,81,765935,8238,7450,5,7455,120
2020-08-23,Santa Barbara,83,443738,8372,7725,94,7819,90
2020-08-23,Santa Clara,85,1922200,17339,15912,20,15932,191
2020-08-23,Santa Cruz,87,273765,1792,1627,16,1643,6
2020-08-23,Shasta,89,179085,597,501,3,504,9
2020-08-23,Sierra,91,2930,6,6,0,6,0
2020-08-23,Siskiyou,93,43540,122,107,8,115,0
2020-08-23,Solano,95,438530,5310,4977,34,5011,32
2020-08-23,Sonoma,97,501317,5583,5018,18,5036,56
2020-08-23,Stanislaus,99,539301,14696,13483,298,13781,171
2020-08-23,Sutter,101,95872,1307,1203,1,1204,9
2020-08-23,Tehama,103,63373,405,381,4,385,1
2020-08-23,Trinity,105,12862,20,10,4,14,0
2020-08-23,Tulare,107,460477,14041,13303,45,13348,223
2020-08-23,Tuolumne,109,53932,194,164,27,191,1
2020-08-23,Ventura,111,848112,10831,10126,68,10194,99
2020-08-23,Yolo,113,214977,2382,2210,4,2214,47
2020-08-23,Yuba,115,75493,811,750,3,753,1
2020-08-22,Alameda,1,1643700,17955,16648,130,16778,231
2020-08-22,Alpine,3,1148,3,2,0,2,0
2020-08-22,Amador,5,37829,267,224,0,224,13
2020-08-22,Butte,7,227075,1819,1618,11,1629,22
2020-08-22,Calaveras,9,45235,216,187,1,188,1
2020-08-22,Colusa,11,21464,440,419,0,419,5
2020-08-22,Contra Costa,13,1133247,13843,12522,47,12569,153
2020-08-22,Del Norte,15,27424,113,80,0,80,1
2020-08-22,El Dorado,17,186661,969,900,0,900,2
2020-08-22,Fresno,19,978130,26527,23197,262,23459,235
2020-08-22,Glenn,21,27897,437,421,0,421,2
2020-08-22,Humboldt,23,135768,366,334,0,334,4
2020-08-22,Imperial,25,180216,11144,9244,6,9250,210
2020-08-22,Inyo,27,18085,169,144,0,144,1
2020-08-22,Kern,29,883053,29211,27807,207,28014,277
2020-08-22,Kings,31,150075,5994,5447,33,5480,60
2020-08-22,Lake,33,64148,321,291,0,291,2
2020-08-22,Lassen,35,31185,717,693,1,694,0
2020-08-22,Los Angeles,37,10098052,236519,230858,1106,231964,5540
2020-08-22,Madera,39,155013,3763,3330,21,3351,32
2020-08-22,Marin,41,260295,6012,5789,13,5802,49
2020-08-22,Mariposa,43,17540,71,66,0,66,2
2020-08-22,Mendocino,45,87422,595,529,0,529,10
2020-08-22,Merced,47,269075,7762,7493,7,7500,69
2020-08-22,Modoc,49,8938,7,5,0,5,0
2020-08-22,Mono,51,14174,163,129,1,130,1
2020-08-22,Monterey,53,433212,7678,7081,17,7098,50
2020-08-22,Napa,55,140530,1430,1328,3,1331,11
2020-08-22,Nevada,57,99092,442,411,12,423,2
2020-08-22,Orange,59,3164182,49065,45131,1105,46236,885
2020-08-22,Placer,61,380077,2946,2734,8,2742,30
2020-08-22,Plumas,63,18699,39,37,0,37,0
2020-08-22,Riverside,65,2383286,52205,49944,30,49974,953
2020-08-22,Sacramento,67,1510023,17524,15516,13,15529,239
2020-08-22,San Benito,69,59416,1032,912,0,912,3
2020-08-22,San Bernardino,71,2135413,47850,44803,52,44855,719
2020-08-22,San Diego,73,3302833,37990,36205,0,36205,673
2020-08-22,San Francisco,75,870044,9242,8568,14,8582,80
2020-08-22,San Joaquin,77,732212,17952,16068,32,16100,305
2020-08-22,San Luis Obispo,79,281455,2850,2660,8,2668,20
2020-08-22,San Mateo,81,765935,8191,7361,5,7366,120
2020-08-22,Santa Barbara,83,443738,8346,7685,94,7779,90
2020-08-22,Santa Clara,85,1922200,17232,15590,20,15610,190
2020-08-22,Santa Cruz,87,273765,1776,1628,15,1643,6
2020-08-22,Shasta,89,179085,595,493,3,496,9
2020-08-22,Sierra,91,2930,6,6,0,6,0
2020-08-22,Siskiyou,93,43540,122,106,8,114,0
2020-08-22,Solano,95,438530,5280,4944,33,4977,32
2020-08-22,Sonoma,97,501317,5537,4891,18,4909,57
2020-08-22,Stanislaus,99,539301,14648,13380,279,13659,170
2020-08-22,Sutter,101,95872,1300,1189,1,1190,8
2020-08-22,Tehama,103,63373,404,368,4,372,1
2020-08-22,Trinity,105,12862,20,8,4,12,0
2020-08-22,Tulare,107,460477,13974,13196,45,13241,222
2020-08-22,Tuolumne,109,53932,192,162,27,189,1
2020-08-22,Ventura,111,848112,10776,9959,66,10025,99
2020-08-22,Yolo,113,214977,2366,2188,4,2192,47
2020-08-22,Yuba,115,75493,799,738,3,741,1
2020-08-21,Alameda,1,1643700,17864,16413,130,16543,232
2020-08-21,Alpine,3,1148,3,2,0,2,0
2020-08-21,Amador,5,37829,266,223,0,223,11
2020-08-21,Butte,7,227075,1780,1582,11,1593,19
2020-08-21,Calaveras,9,45235,216,182,1,183,1
2020-08-21,Colusa,11,21464,438,418,0,418,5
2020-08-21,Contra Costa,13,1133247,13753,12333,46,12379,149
2020-08-21,Del Norte,15,27424,113,78,0,78,1
2020-08-21,El Dorado,17,186661,965,885,0,885,2
2020-08-21,Fresno,19,978130,26357,22840,260,23100,232
2020-08-21,Glenn,21,27897,433,418,0,418,2
2020-08-21,Humboldt,23,135768,363,331,0,331,4
2020-08-21,Imperial,25,180216,11128,9166,6,9172,204
2020-08-21,Inyo,27,18085,169,144,0,144,1
2020-08-21,Kern,29,883053,29152,27567,205,27772,269
2020-08-21,Kings,31,150075,5972,5391,33,5424,60
2020-08-21,Lake,33,64148,319,281,0,281,2
2020-08-21,Lassen,35,31185,717,693,1,694,0
2020-08-21,Los Angeles,37,10098052,235643,229235,1084,230319,5494
2020-08-21,Madera,39,155013,3733,3271,21,3292,31
2020-08-21,Marin,41,260295,5992,5762,13,5775,49
2020-08-21,Mariposa,43,17540,71,66,0,66,2
2020-08-21,Mendocino,45,87422,585,505,0,505,10
2020-08-21,Merced,47,269075,7733,7357,7,7364,69
2020-08-21,Modoc,49,8938,7,5,0,5,0
2020-08-21,Mono,51,14174,163,128,1,129,1
2020-08-21,Monterey,53,433212,7606,6974,17,6991,49
2020-08-21,Napa,55,140530,1421,1317,3,1320,10
2020-08-21,Nevada,57,99092,441,406,12,418,2
2020-08-21,Orange,59,3164182,48924,44625,1097,45722,875
2020-08-21,Placer,61,380077,2930,2698,7,2705,30
2020-08-21,Plumas,63,18699,39,36,0,36,0
2020-08-21,Riverside,65,2383286,52012,49409,30,49439,932
2020-08-21,Sacramento,67,1510023,17401,15247,13,15260,237
2020-08-21,San Benito,69,59416,1022,891,0,891,3
2020-08-21,San Bernardino,71,2135413,47730,44249,52,44301,668
2020-08-21,San Diego,73,3302833,37786,35914,0,35914,652
2020-08-21,San Francisco,75,870044,9192,8375,14,8389,80
2020-08-21,San Joaquin,77,732212,17869,15888,30,15918,301
2020-08-21,San Luis Obispo,79,281455,2827,2640,8,2648,19
2020-08-21,San Mateo,81,765935,8133,7253,5,7258,120
2020-08-21,Santa Barbara,83,443738,8305,7645,94,7739,86
2020-08-21,Santa Clara,85,1922200,17080,15399,20,15419,190
2020-08-21,Santa Cruz,87,273765,1764,1617,15,1632,6
2020-08-21,Shasta,89,179085,595,486,3,489,9
2020-08-21,Sierra,91,2930,6,6,0,6,0
2020-08-21,Siskiyou,93,43540,122,103,6,109,0
2020-08-21,Solano,95,438530,5257,4891,32,4923,32
2020-08-21,Sonoma,97,501317,5467,4816,18,4834,57
2020-08-21,Stanislaus,99,539301,14579,13282,264,13546,161
2020-08-21,Sutter,101,95872,1287,1173,1,1174,8
2020-08-21,Tehama,103,63373,402,357,4,361,1
2020-08-21,Trinity,105,12862,20,8,4,12,0
2020-08-21,Tulare,107,460477,13902,13002,44,13046,217
2020-08-21,Tuolumne,109,53932,184,161,27,188,1
2020-08-21,Ventura,111,848112,10712,9865,64,9929,98
2020-08-21,Yolo,113,214977,2351,2164,4,2168,46
2020-08-21,Yuba,115,75493,795,717,3,720,1
2020-08-20,Alameda,1,1643700,17706,16174,130,16304,229
2020-08-20,Alpine,3,1148,3,2,0,2,0
2020-08-20,Amador,5,37829,264,222,0,222,11
2020-08-20,Butte,7,227075,1729,1549,11,1560,18
2020-08-20,Calaveras,9,45235,213,179,1,180,1
2020-08-20,Colusa,11,21464,436,415,0,415,5
2020-08-20,Contra Costa,13,1133247,13625,12108,45,12153,144
2020-08-20,Del Norte,15,27424,113,78,0,78,1
2020-08-20,El Dorado,17,186661,961,881,0,881,2
2020-08-20,Fresno,19,978130,26175,22535,255,22790,228
2020-08-20,Glenn,21,27897,428,414,0,414,2
2020-08-20,Humboldt,23,135768,358,318,0,318,4
2020-08-20,Imperial,25,180216,11109,9086,6,9092,196
2020-08-20,Inyo,27,18085,168,144,0,144,1
2020-08-20,Kern,29,883053,28985,27337,195,27532,267
2020-08-20,Kings,31,150075,5932,5347,32,5379,59
2020-08-20,Lake,33,64148,314,280,0,280,2
2020-08-20,Lassen,35,31185,716,693,1,694,0
2020-08-20,Los Angeles,37,10098052,234406,227492,1065,228557,5445
2020-08-20,Madera,39,155013,3707,3197,21,3218,31
2020-08-20,Marin,41,260295,5974,5745,13,5758,47
2020-08-20,Mariposa,43,17540,71,67,0,67,2
2020-08-20,Mendocino,45,87422,574,497,0,497,10
2020-08-20,Merced,47,269075,7658,7173,7,7180,68
2020-08-20,Modoc,49,8938,7,5,0,5,0
2020-08-20,Mono,51,14174,163,128,1,129,1
2020-08-20,Monterey,53,433212,7535,6892,17,6909,47
2020-08-20,Napa,55,140530,1413,1306,3,1309,10
2020-08-20,Nevada,57,99092,440,401,12,413,2
2020-08-20,Orange,59,3164182,48697,44299,1085,45384,849
2020-08-20,Placer,61,380077,2914,2681,7,2688,30
2020-08-20,Plumas,63,18699,39,36,0,36,0
2020-08-20,Riverside,65,2383286,51795,48953,29,48982,927
2020-08-20,Sacramento,67,1510023,17158,14992,12,15004,231
2020-08-20,San Benito,69,59416,1009,866,0,866,3
2020-08-20,San Bernardino,71,2135413,47473,43627,52,43679,665
2020-08-20,San Diego,73,3302833,37566,35610,0,35610,644
2020-08-20,San Francisco,75,870044,9106,8262,14,8276,72
2020-08-20,San Joaquin,77,732212,17776,15778,30,15808,297
2020-08-20,San Luis Obispo,79,281455,2807,2590,8,2598,19
2020-08-20,San Mateo,81,765935,8067,7188,5,7193,120
2020-08-20,Santa Barbara,83,443738,8267,7571,94,7665,81
2020-08-20,Santa Clara,85,1922200,16909,15162,20,15182,190
2020-08-20,Santa Cruz,87,273765,1751,1581,15,1596,6
2020-08-20,Shasta,89,179085,594,478,3,481,9
2020-08-20,Sierra,91,2930,6,6,0,6,0
2020-08-20,Siskiyou,93,43540,121,102,1,103,0
2020-08-20,Solano,95,438530,5213,4843,32,4875,31
2020-08-20,Sonoma,97,501317,5395,4737,18,4755,54
2020-08-20,Stanislaus,99,539301,14483,13120,255,13375,161
2020-08-20,Sutter,101,95872,1263,1158,1,1159,8
2020-08-20,Tehama,103,63373,396,350,4,354,1
2020-08-20,Trinity,105,12862,20,8,4,12,0
2020-08-20,Tulare,107,460477,13794,12907,43,12950,217
2020-08-20,Tuolumne,109,53932,180,159,27,186,1
2020-08-20,Ventura,111,848112,10599,9744,63,9807,93
2020-08-20,Yolo,113,214977,2329,2150,4,2154,47
2020-08-20,Yuba,115,75493,778,709,3,712,1
2020-08-19,Alameda,1,1643700,17547,15874,129,16003,226
2020-08-19,Alpine,3,1148,3,2,0,2,0
2020-08-19,Amador,5,37829,263,219,0,219,9
2020-08-19,Butte,7,227075,1686,1517,11,1528,16
2020-08-19,Calaveras,9,45235,210,177,1,178,1
2020-08-19,Colusa,11,21464,435,415,0,415,5
2020-08-19,Contra Costa,13,1133247,13513,11895,43,11938,142
2020-08-19,Del Norte,15,27424,113,78,0,78,1
2020-08-19,El Dorado,17,186661,955,870,0,870,2
2020-08-19,Fresno,19,978130,25985,22167,248,22415,221
2020-08-19,Glenn,21,27897,426,414,0,414,2
2020-08-19,Humboldt,23,135768,355,316,0,316,4
2020-08-19,Imperial,25,180216,11081,9041,6,9047,192
2020-08-19,Inyo,27,18085,166,140,0,140,1
2020-08-19,Kern,29,883053,28869,27142,191,27333,263
2020-08-19,Kings,31,150075,5760,5301,32,5333,59
2020-08-19,Lake,33,64148,311,277,0,277,2
2020-08-19,Lassen,35,31185,708,693,1,694,0
2020-08-19,Los Angeles,37,10098052,233124,226006,1025,227031,5399
2020-08-19,Madera,39,155013,3673,3158,19,3177,30
2020-08-19,Marin,41,260295,5950,5723,12,5735,46
2020-08-19,Mariposa,43,17540,71,64,0,64,2
2020-08-19,Mendocino,45,87422,558,495,0,495,8
2020-08-19,Merced,47,269075,7531,7082,4,7086,66
2020-08-19,Modoc,49,8938,7,5,0,5,0
2020-08-19,Mono,51,14174,163,128,1,129,1
2020-08-19,Monterey,53,433212,7433,6693,17,6710,45
2020-08-19,Napa,55,140530,1408,1293,3,1296,10
2020-08-19,Nevada,57,99092,433,398,12,410,2
2020-08-19,Orange,59,3164182,48493,43938,1080,45018,829
2020-08-19,Placer,61,380077,2891,2659,7,2666,28
2020-08-19,Plumas,63,18699,39,36,0,36,0
2020-08-19,Riverside,65,2383286,51547,48741,28,48769,922
2020-08-19,Sacramento,67,1510023,16975,14764,12,14776,229
2020-08-19,San Benito,69,59416,992,853,0,853,3
2020-08-19,San Bernardino,71,2135413,47175,43224,51,43275,661
2020-08-19,San Diego,73,3302833,37317,35378,0,35378,638
2020-08-19,San Francisco,75,870044,9041,8236,14,8250,72
2020-08-19,San Joaquin,77,732212,17649,15677,29,15706,296
2020-08-19,San Luis Obispo,79,281455,2768,2553,8,2561,19
2020-08-19,San Mateo,81,765935,8000,7146,5,7151,119
2020-08-19,Santa Barbara,83,443738,8218,7499,94,7593,80
2020-08-19,Santa Clara,85,1922200,16764,14994,20,15014,189
2020-08-19,Santa Cruz,87,273765,1725,1554,15,1569,6
2020-08-19,Shasta,89,179085,590,475,3,478,9
2020-08-19,Sierra,91,2930,6,6,0,6,0
2020-08-19,Siskiyou,93,43540,120,103,1,104,0
2020-08-19,Solano,95,438530,5172,4807,32,4839,31
2020-08-19,Sonoma,97,501317,5316,4614,18,4632,54
2020-08-19,Stanislaus,99,539301,14381,13084,233,13317,160
2020-08-19,Sutter,101,95872,1229,1146,1,1147,8
2020-08-19,Tehama,103,63373,390,342,4,346,1
2020-08-19,Trinity,105,12862,19,8,4,12,0
2020-08-19,Tulare,107,460477,13696,12756,43,12799,217
2020-08-19,Tuolumne,109,53932,177,159,27,186,1
2020-08-19,Ventura,111,848112,10507,9587,61,9648,91
2020-08-19,Yolo,113,214977,2306,2126,4,2130,47
2020-08-19,Yuba,115,75493,766,701,3,704,1
2020-08-18,Alameda,1,1643700,17371,15627,126,15753,223
2020-08-18,Alpine,3,1148,3,2,0,2,0
2020-08-18,Amador,5,37829,262,215,0,215,9
2020-08-18,Butte,7,227075,1653,1491,11,1502,16
2020-08-18,Calaveras,9,45235,206,174,1,175,1
2020-08-18,Colusa,11,21464,434,415,0,415,5
2020-08-18,Contra Costa,13,1133247,13393,11689,41,11730,141
2020-08-18,Del Norte,15,27424,112,78,0,78,0
2020-08-18,El Dorado,17,186661,950,866,0,866,2
2020-08-18,Fresno,19,978130,25766,21798,242,22040,212
2020-08-18,Glenn,21,27897,426,407,0,407,2
2020-08-18,Humboldt,23,135768,353,315,0,315,4
2020-08-18,Imperial,25,180216,11047,8968,6,8974,189
2020-08-18,Inyo,27,18085,165,140,0,140,1
2020-08-18,Kern,29,883053,28717,26978,186,27164,263
2020-08-18,Kings,31,150075,5734,5269,31,5300,58
2020-08-18,Lake,33,64148,308,274,0,274,2
2020-08-18,Lassen,35,31185,708,693,1,694,0
2020-08-18,Los Angeles,37,10098052,231843,224218,986,225204,5339
2020-08-18,Madera,39,155013,3645,3125,19,3144,28
2020-08-18,Marin,41,260295,5920,5708,12,5720,47
2020-08-18,Mariposa,43,17540,71,61,0,61,2
2020-08-18,Mendocino,45,87422,549,468,0,468,8
2020-08-18,Merced,47,269075,7483,6940,4,6944,66
2020-08-18,Modoc,49,8938,7,5,0,5,0
2020-08-18,Mono,51,14174,162,129,1,130,1
2020-08-18,Monterey,53,433212,7342,6691,16,6707,44
2020-08-18,Napa,55,140530,1405,1274,3,1277,10
2020-08-18,Nevada,57,99092,426,389,12,401,2
2020-08-18,Orange,59,3164182,48267,43659,1064,44723,809
2020-08-18,Placer,61,380077,2865,2644,6,2650,28
2020-08-18,Plumas,63,18699,39,34,0,34,0
2020-08-18,Riverside,65,2383286,51218,48447,28,48475,917
2020-08-18,Sacramento,67,1510023,16747,14610,11,14621,222
2020-08-18,San Benito,69,59416,972,836,0,836,3
2020-08-18,San Bernardino,71,2135413,46894,42827,50,42877,648
2020-08-18,San Diego,73,3302833,37025,35164,0,35164,633
2020-08-18,San Francisco,75,870044,8956,8016,14,8030,72
2020-08-18,San Joaquin,77,732212,17532,15509,27,15536,290
2020-08-18,San Luis Obispo,79,281455,2744,2535,7,2542,18
2020-08-18,San Mateo,81,765935,7938,7074,5,7079,119
2020-08-18,Santa Barbara,83,443738,8176,7472,94,7566,81
2020-08-18,Santa Clara,85,1922200,16591,14786,20,14806,184
2020-08-18,Santa Cruz,87,273765,1712,1509,15,1524,6
2020-08-18,Shasta,89,179085,586,468,3,471,9
2020-08-18,Sierra,91,2930,6,6,0,6,0
2020-08-18,Siskiyou,93,43540,119,103,1,104,0
2020-08-18,Solano,95,438530,5145,4700,32,4732,31
2020-08-18,Sonoma,97,501317,5247,4506,18,4524,48
2020-08-18,Stanislaus,99,539301,14283,12935,217,13152,149
2020-08-18,Sutter,101,95872,1210,1126,1,1127,8
2020-08-18,Tehama,103,63373,380,333,4,337,1
2020-08-18,Trinity,105,12862,18,8,4,12,0
2020-08-18,Tulare,107,460477,13564,12637,40,12677,212
2020-08-18,Tuolumne,109,53932,174,159,27,186,1
2020-08-18,Ventura,111,848112,10417,9536,56,9592,89
2020-08-18,Yolo,113,214977,2283,2102,4,2106,47
2020-08-18,Yuba,115,75493,758,679,3,682,1
2020-08-17,Alameda,1,1643700,17181,15454,124,15578,221
2020-08-17,Alpine,3,1148,3,2,0,2,0
2020-08-17,Amador,5,37829,262,215,0,215,9
2020-08-17,Butte,7,227075,1608,1463,11,1474,15
2020-08-17,Calaveras,9,45235,202,167,1,168,1
2020-08-17,Colusa,11,21464,431,408,0,408,5
2020-08-17,Contra Costa,13,1133247,13255,11442,41,11483,141
2020-08-17,Del Norte,15,27424,108,77,0,77,0
2020-08-17,El Dorado,17,186661,947,846,0,846,2
2020-08-17,Fresno,19,978130,25561,21316,235,21551,211
2020-08-17,Glenn,21,27897,425,402,0,402,2
2020-08-17,Humboldt,23,135768,349,302,0,302,4
2020-08-17,Imperial,25,180216,11006,8897,6,8903,188
2020-08-17,Inyo,27,18085,157,124,0,124,1
2020-08-17,Kern,29,883053,28569,26773,175,26948,249
2020-08-17,Kings,31,150075,5697,5249,31,5280,58
2020-08-17,Lake,33,64148,303,270,0,270,2
2020-08-17,Lassen,35,31185,708,666,1,667,0
2020-08-17,Los Angeles,37,10098052,230329,223418,934,224352,5282
2020-08-17,Madera,39,155013,3602,3050,18,3068,26
2020-08-17,Marin,41,260295,5897,5683,11,5694,46
2020-08-17,Mariposa,43,17540,71,61,0,61,2
2020-08-17,Mendocino,45,87422,532,454,0,454,8
2020-08-17,Merced,47,269075,7387,6814,4,6818,66
2020-08-17,Modoc,49,8938,7,5,0,5,0
2020-08-17,Mono,51,14174,162,126,1,127,1
2020-08-17,Monterey,53,433212,7243,6553,16,6569,44
2020-08-17,Napa,55,140530,1384,1255,3,1258,10
2020-08-17,Nevada,57,99092,421,383,12,395,2
2020-08-17,Orange,59,3164182,48057,43621,1053,44674,804
2020-08-17,Placer,61,380077,2840,2609,5,2614,28
2020-08-17,Plumas,63,18699,39,33,0,33,0
2020-08-17,Riverside,65,2383286,50889,48062,26,48088,916
2020-08-17,Sacramento,67,1510023,16524,14333,11,14344,219
2020-08-17,San Benito,69,59416,957,822,0,822,2
2020-08-17,San Bernardino,71,2135413,46552,42005,50,42055,604
2020-08-17,San Diego,73,3302833,36759,34962,0,34962,626
2020-08-17,San Francisco,75,870044,8884,7600,14,7614,72
2020-08-17,San Joaquin,77,732212,17368,15323,26,15349,280
2020-08-17,San Luis Obispo,79,281455,2711,2527,7,2534,18
2020-08-17,San Mateo,81,765935,7881,6987,4,6991,118
2020-08-17,Santa Barbara,83,443738,8134,7438,94,7532,80
2020-08-17,Santa Clara,85,1922200,16371,14546,20,14566,183
2020-08-17,Santa Cruz,87,273765,1696,1453,14,1467,6
2020-08-17,Shasta,89,179085,580,467,3,470,9
2020-08-17,Sierra,91,2930,6,6,0,6,0
2020-08-17,Siskiyou,93,43540,118,103,0,103,0
2020-08-17,Solano,95,438530,5088,4479,32,4511,31
2020-08-17,Sonoma,97,501317,5158,4402,16,4418,48
2020-08-17,Stanislaus,99,539301,14158,12745,211,12956,148
2020-08-17,Sutter,101,95872,1194,1071,1,1072,8
2020-08-17,Tehama,103,63373,371,324,4,328,1
2020-08-17,Trinity,105,12862,18,8,4,12,0
2020-08-17,Tulare,107,460477,13451,12487,39,12526,210
2020-08-17,Tuolumne,109,53932,171,157,27,184,1
2020-08-17,Ventura,111,848112,10295,9490,51,9541,89
2020-08-17,Yolo,113,214977,2256,2083,4,2087,47
2020-08-17,Yuba,115,75493,743,647,3,650,1
2020-08-16,Alameda,1,1643700,16893,15338,124,15462,221
2020-08-16,Alpine,3,1148,3,2,0,2,0
2020-08-16,Amador,5,37829,259,215,0,215,9
2020-08-16,Butte,7,227075,1570,1432,11,1443,15
2020-08-16,Calaveras,9,45235,195,167,1,168,1
2020-08-16,Colusa,11,21464,429,407,0,407,5
2020-08-16,Contra Costa,13,1133247,13069,11255,41,11296,140
2020-08-16,Del Norte,15,27424,104,77,0,77,0
2020-08-16,El Dorado,17,186661,935,843,0,843,2
2020-08-16,Fresno,19,978130,25343,21010,230,21240,211
2020-08-16,Glenn,21,27897,423,400,0,400,2
2020-08-16,Humboldt,23,135768,347,301,0,301,4
2020-08-16,Imperial,25,180216,10962,8883,6,8889,188
2020-08-16,Inyo,27,18085,150,125,0,125,1
2020-08-16,Kern,29,883053,28370,26520,167,26687,249
2020-08-16,Kings,31,150075,5666,5146,31,5177,58
2020-08-16,Lake,33,64148,299,269,0,269,2
2020-08-16,Lassen,35,31185,708,666,1,667,0
2020-08-16,Los Angeles,37,10098052,228762,222236,903,223139,5263
2020-08-16,Madera,39,155013,3557,3013,18,3031,26
2020-08-16,Marin,41,260295,5871,5664,11,5675,46
2020-08-16,Mariposa,43,17540,71,61,0,61,2
2020-08-16,Mendocino,45,87422,524,451,0,451,8
2020-08-16,Merced,47,269075,7305,6744,4,6748,66
2020-08-16,Modoc,49,8938,7,5,0,5,0
2020-08-16,Mono,51,14174,162,126,1,127,1
2020-08-16,Monterey,53,433212,7145,6516,15,6531,44
2020-08-16,Napa,55,140530,1366,1241,2,1243,10
2020-08-16,Nevada,57,99092,410,379,12,391,2
2020-08-16,Orange,59,3164182,47807,43303,1042,44345,803
2020-08-16,Placer,61,380077,2811,2583,4,2587,28
2020-08-16,Plumas,63,18699,39,33,0,33,0
2020-08-16,Riverside,65,2383286,50559,47669,26,47695,910
2020-08-16,Sacramento,67,1510023,16283,14210,11,14221,219
2020-08-16,San Benito,69,59416,928,815,0,815,2
2020-08-16,San Bernardino,71,2135413,46129,41724,48,41772,603
2020-08-16,San Diego,73,3302833,36496,34680,0,34680,626
2020-08-16,San Francisco,75,870044,8796,7602,14,7616,72
2020-08-16,San Joaquin,77,732212,17165,15288,26,15314,280
2020-08-16,San Luis Obispo,79,281455,2682,2494,7,2501,17
2020-08-16,San Mateo,81,765935,7805,6942,4,6946,118
2020-08-16,Santa Barbara,83,443738,8085,7368,94,7462,79
2020-08-16,Santa Clara,85,1922200,16173,14329,20,14349,183
2020-08-16,Santa Cruz,87,273765,1669,1449,13,1462,6
2020-08-16,Shasta,89,179085,573,465,3,468,9
2020-08-16,Sierra,91,2930,6,6,0,6,0
2020-08-16,Siskiyou,93,43540,117,102,0,102,0
2020-08-16,Solano,95,438530,5029,4479,32,4511,31
2020-08-16,Sonoma,97,501317,5054,4329,16,4345,46
2020-08-16,Stanislaus,99,539301,14003,12668,198,12866,148
2020-08-16,Sutter,101,95872,1176,1071,1,1072,8
2020-08-16,Tehama,103,63373,362,318,4,322,1
2020-08-16,Trinity,105,12862,17,8,4,12,0
2020-08-16,Tulare,107,460477,13319,12334,35,12369,211
2020-08-16,Tuolumne,109,53932,171,156,27,183,1
2020-08-16,Ventura,111,848112,10186,9408,46,9454,89
2020-08-16,Yolo,113,214977,2237,2057,4,2061,47
2020-08-16,Yuba,115,75493,734,647,2,649,1
2020-08-15,Alameda,1,1643700,16816,15165,124,15289,221
2020-08-15,Alpine,3,1148,3,2,0,2,0
2020-08-15,Amador,5,37829,259,210,0,210,9
2020-08-15,Butte,7,227075,1548,1409,11,1420,15
2020-08-15,Calaveras,9,45235,193,167,1,168,1
2020-08-15,Colusa,11,21464,428,401,0,401,5
2020-08-15,Contra Costa,13,1133247,12973,11106,41,11147,138
2020-08-15,Del Norte,15,27424,104,77,0,77,0
2020-08-15,El Dorado,17,186661,930,838,0,838,2
2020-08-15,Fresno,19,978130,25227,20603,228,20831,211
2020-08-15,Glenn,21,27897,423,398,0,398,2
2020-08-15,Humboldt,23,135768,346,301,0,301,4
2020-08-15,Imperial,25,180216,10942,8794,6,8800,188
2020-08-15,Inyo,27,18085,150,123,0,123,1
2020-08-15,Kern,29,883053,28282,26338,167,26505,249
2020-08-15,Kings,31,150075,5649,5039,31,5070,56
2020-08-15,Lake,33,64148,297,268,0,268,2
2020-08-15,Lassen,35,31185,708,666,1,667,0
2020-08-15,Los Angeles,37,10098052,228009,221043,894,221937,5252
2020-08-15,Madera,39,155013,3507,2950,18,2968,26
2020-08-15,Marin,41,260295,5864,5628,11,5639,46
2020-08-15,Mariposa,43,17540,71,61,0,61,2
2020-08-15,Mendocino,45,87422,520,444,0,444,8
2020-08-15,Merced,47,269075,7271,6656,4,6660,66
2020-08-15,Modoc,49,8938,7,5,0,5,0
2020-08-15,Mono,51,14174,162,126,1,127,1
2020-08-15,Monterey,53,433212,7100,6162,15,6177,44
2020-08-15,Napa,55,140530,1356,1232,2,1234,10
2020-08-15,Nevada,57,99092,410,376,12,388,2
2020-08-15,Orange,59,3164182,47695,42811,1031,43842,801
2020-08-15,Placer,61,380077,2789,2551,4,2555,27
2020-08-15,Plumas,63,18699,39,33,0,33,0
2020-08-15,Riverside,65,2383286,50408,46720,26,46746,910
2020-08-15,Sacramento,67,1510023,16173,14018,11,14029,219
2020-08-15,San Benito,69,59416,915,805,0,805,2
2020-08-15,San Bernardino,71,2135413,45978,41231,46,41277,602
2020-08-15,San Diego,73,3302833,36330,34346,0,34346,639
2020-08-15,San Francisco,75,870044,8732,7601,14,7615,69
2020-08-15,San Joaquin,77,732212,17093,15113,26,15139,280
2020-08-15,San Luis Obispo,79,281455,2665,2461,7,2468,17
2020-08-15,San Mateo,81,765935,7768,6860,4,6864,118
2020-08-15,Santa Barbara,83,443738,8057,7338,94,7432,79
2020-08-15,Santa Clara,85,1922200,16077,14105,20,14125,183
2020-08-15,Santa Cruz,87,273765,1648,1449,13,1462,6
2020-08-15,Shasta,89,179085,570,458,3,461,9
2020-08-15,Sierra,91,2930,6,6,0,6,0
2020-08-15,Siskiyou,93,43540,116,100,0,100,0
2020-08-15,Solano,95,438530,5007,4477,32,4509,31
2020-08-15,Sonoma,97,501317,4999,4134,16,4150,45
2020-08-15,Stanislaus,99,539301,13941,12541,196,12737,149
2020-08-15,Sutter,101,95872,1165,1046,1,1047,8
2020-08-15,Tehama,103,63373,361,312,4,316,1
2020-08-15,Trinity,105,12862,15,6,4,10,0
2020-08-15,Tulare,107,460477,13281,12262,35,12297,211
2020-08-15,Tuolumne,109,53932,171,155,27,182,1
2020-08-15,Ventura,111,848112,10128,9379,44,9423,89
2020-08-15,Yolo,113,214977,2225,2031,4,2035,46
2020-08-15,Yuba,115,75493,730,623,2,625,1
2020-08-14,Alameda,1,1643700,16677,14909,124,15033,221
2020-08-14,Alpine,3,1148,3,2,0,2,0
2020-08-14,Amador,5,37829,259,209,0,209,9
2020-08-14,Butte,7,227075,1539,1384,11,1395,15
2020-08-14,Calaveras,9,45235,189,165,1,166,1
2020-08-14,Colusa,11,21464,426,399,0,399,5
2020-08-14,Contra Costa,13,1133247,12861,10893,41,10934,137
2020-08-14,Del Norte,15,27424,104,76,0,76,0
2020-08-14,El Dorado,17,186661,922,827,0,827,2
2020-08-14,Fresno,19,978130,25093,19900,228,20128,208
2020-08-14,Glenn,21,27897,421,395,0,395,2
2020-08-14,Humboldt,23,135768,340,294,0,294,4
2020-08-14,Imperial,25,180216,10918,8756,6,8762,185
2020-08-14,Inyo,27,18085,148,115,0,115,1
2020-08-14,Kern,29,883053,28178,25893,166,26059,249
2020-08-14,Kings,31,150075,5635,4953,31,4984,56
2020-08-14,Lake,33,64148,288,267,0,267,2
2020-08-14,Lassen,35,31185,708,665,1,666,0
2020-08-14,Los Angeles,37,10098052,226845,219083,876,219959,5222
2020-08-14,Madera,39,155013,3477,2876,18,2894,26
2020-08-14,Marin,41,260295,5853,5601,11,5612,46
2020-08-14,Mariposa,43,17540,70,61,0,61,2
2020-08-14,Mendocino,45,87422,511,432,0,432,8
2020-08-14,Merced,47,269075,7242,6466,4,6470,67
2020-08-14,Modoc,49,8938,7,5,0,5,0
2020-08-14,Mono,51,14174,162,126,1,127,1
2020-08-14,Monterey,53,433212,7049,6121,15,6136,41
2020-08-14,Napa,55,140530,1346,1230,2,1232,10
2020-08-14,Nevada,57,99092,406,377,12,389,2
2020-08-14,Orange,59,3164182,47546,42399,1017,43416,798
2020-08-14,Placer,61,380077,2770,2546,4,2550,26
2020-08-14,Plumas,63,18699,38,33,0,33,0
2020-08-14,Riverside,65,2383286,50179,46456,26,46482,891
2020-08-14,Sacramento,67,1510023,16023,13645,10,13655,212
2020-08-14,San Benito,69,59416,898,783,0,783,2
2020-08-14,San Bernardino,71,2135413,45792,40442,46,40488,594
2020-08-14,San Diego,73,3302833,36136,34067,0,34067,622
2020-08-14,San Francisco,75,870044,8673,7467,14,7481,69
2020-08-14,San Joaquin,77,732212,16994,14925,26,14951,276
2020-08-14,San Luis Obispo,79,281455,2650,2422,7,2429,17
2020-08-14,San Mateo,81,765935,7709,6655,4,6659,118
2020-08-14,Santa Barbara,83,443738,8007,7302,94,7396,77
2020-08-14,Santa Clara,85,1922200,15912,13785,20,13805,183
2020-08-14,Santa Cruz,87,273765,1626,1418,12,1430,6
2020-08-14,Shasta,89,179085,565,446,3,449,9
2020-08-14,Sierra,91,2930,6,5,0,5,0
2020-08-14,Siskiyou,93,43540,116,98,0,98,0
2020-08-14,Solano,95,438530,4986,4421,32,4453,31
2020-08-14,Sonoma,97,501317,4940,4087,13,4100,45
2020-08-14,Stanislaus,99,539301,13864,12379,192,12571,140
2020-08-14,Sutter,101,95872,1157,1039,1,1040,8
2020-08-14,Tehama,103,63373,357,305,4,309,1
2020-08-14,Trinity,105,12862,15,6,4,10,0
2020-08-14,Tulare,107,460477,13204,12009,35,12044,211
2020-08-14,Tuolumne,109,53932,170,155,27,182,1
2020-08-14,Ventura,111,848112,10053,9313,44,9357,89
2020-08-14,Yolo,113,214977,2211,1991,4,1995,45
2020-08-14,Yuba,115,75493,714,606,2,608,1
2020-08-13,Alameda,1,1643700,16403,14385,124,14509,218
2020-08-13,Alpine,3,1148,3,2,0,2,0
2020-08-13,Amador,5,37829,259,198,0,198,8
2020-08-13,Butte,7,227075,1514,1345,11,1356,15
2020-08-13,Calaveras,9,45235,187,162,1,163,1
2020-08-13,Colusa,11,21464,426,395,0,395,5
2020-08-13,Contra Costa,13,1133247,12706,10545,40,10585,136
2020-08-13,Del Norte,15,27424,103,74,0,74,0
2020-08-13,El Dorado,17,186661,917,803,0,803,2
2020-08-13,Fresno,19,978130,24869,19157,221,19378,201
2020-08-13,Glenn,21,27897,417,392,0,392,1
2020-08-13,Humboldt,23,135768,332,281,0,281,4
2020-08-13,Imperial,25,180216,10887,8640,6,8646,170
2020-08-13,Inyo,27,18085,144,97,0,97,1
2020-08-13,Kern,29,883053,28012,25472,163,25635,242
2020-08-13,Kings,31,150075,5601,4824,31,4855,52
2020-08-13,Lake,33,64148,283,263,0,263,2
2020-08-13,Lassen,35,31185,708,652,1,653,0
2020-08-13,Los Angeles,37,10098052,225434,216497,856,217353,5179
2020-08-13,Madera,39,155013,3434,2675,17,2692,25
2020-08-13,Marin,41,260295,5837,5503,11,5514,44
2020-08-13,Mariposa,43,17540,69,61,0,61,2
2020-08-13,Mendocino,45,87422,506,401,0,401,8
2020-08-13,Merced,47,269075,7124,5945,4,5949,63
2020-08-13,Modoc,49,8938,7,5,0,5,0
2020-08-13,Mono,51,14174,162,124,1,125,1
2020-08-13,Monterey,53,433212,6966,5925,15,5940,38
2020-08-13,Napa,55,140530,1337,1179,2,1181,10
2020-08-13,Nevada,57,99092,402,362,12,374,1
2020-08-13,Orange,59,3164182,47307,42019,1005,43024,773
2020-08-13,Placer,61,380077,2749,2460,4,2464,26
2020-08-13,Plumas,63,18699,38,32,0,32,0
2020-08-13,Riverside,65,2383286,49885,45327,26,45353,885
2020-08-13,Sacramento,67,1510023,15823,13237,10,13247,197
2020-08-13,San Benito,69,59416,869,757,0,757,2
2020-08-13,San Bernardino,71,2135413,45398,39395,45,39440,591
2020-08-13,San Diego,73,3302833,35900,33661,0,33661,627
2020-08-13,San Francisco,75,870044,8579,7277,14,7291,69
2020-08-13,San Joaquin,77,732212,16840,14537,25,14562,261
2020-08-13,San Luis Obispo,79,281455,2629,2283,7,2290,16
2020-08-13,San Mateo,81,765935,7647,6503,4,6507,117
2020-08-13,Santa Barbara,83,443738,7963,7129,93,7222,74
2020-08-13,Santa Clara,85,1922200,15689,13257,20,13277,182
2020-08-13,Santa Cruz,87,273765,1601,1383,12,1395,6
2020-08-13,Shasta,89,179085,561,428,3,431,9
2020-08-13,Sierra,91,2930,6,5,0,5,0
2020-08-13,Siskiyou,93,43540,116,95,0,95,0
2020-08-13,Solano,95,438530,4949,4305,32,4337,31
2020-08-13,Sonoma,97,501317,4866,3902,13,3915,45
2020-08-13,Stanislaus,99,539301,13734,11953,176,12129,136
2020-08-13,Sutter,101,95872,1136,992,1,993,8
2020-08-13,Tehama,103,63373,348,302,4,306,1
2020-08-13,Trinity,105,12862,15,6,4,10,0
2020-08-13,Tulare,107,460477,13061,11692,31,11723,210
2020-08-13,Tuolumne,109,53932,169,152,27,179,1
2020-08-13,Ventura,111,848112,9964,9114,43,9157,90
2020-08-13,Yolo,113,214977,2184,1938,4,1942,44
2020-08-13,Yuba,115,75493,698,568,2,570,1
2020-08-12,Alameda,1,1643700,16191,14214,124,14338,215
2020-08-12,Alpine,3,1148,3,2,0,2,0
2020-08-12,Amador,5,37829,256,197,0,197,8
2020-08-12,Butte,7,227075,1486,1317,11,1328,15
2020-08-12,Calaveras,9,45235,184,157,1,158,1
2020-08-12,Colusa,11,21464,421,394,0,394,5
2020-08-12,Contra Costa,13,1133247,12562,10304,38,10342,134
2020-08-12,Del Norte,15,27424,102,74,0,74,0
2020-08-12,El Dorado,17,186661,899,794,0,794,2
2020-08-12,Fresno,19,978130,24639,18690,215,18905,194
2020-08-12,Glenn,21,27897,414,388,0,388,1
2020-08-12,Humboldt,23,135768,325,281,0,281,4
2020-08-12,Imperial,25,180216,10865,8566,6,8572,167
2020-08-12,Inyo,27,18085,127,97,0,97,1
2020-08-12,Kern,29,883053,27822,25191,161,25352,232
2020-08-12,Kings,31,150075,5562,4736,31,4767,50
2020-08-12,Lake,33,64148,281,253,0,253,2
2020-08-12,Lassen,35,31185,707,651,1,652,0
2020-08-12,Los Angeles,37,10098052,223975,214542,840,215382,5119
2020-08-12,Madera,39,155013,3400,2681,15,2696,23
2020-08-12,Marin,41,260295,5815,5423,11,5434,44
2020-08-12,Mariposa,43,17540,69,61,0,61,2
2020-08-12,Mendocino,45,87422,487,386,0,386,9
2020-08-12,Merced,47,269075,7063,5777,4,5781,66
2020-08-12,Modoc,49,8938,7,5,0,5,0
2020-08-12,Mono,51,14174,161,124,1,125,1
2020-08-12,Monterey,53,433212,6862,5919,15,5934,38
2020-08-12,Napa,55,140530,1327,1161,2,1163,10
2020-08-12,Nevada,57,99092,397,357,12,369,1
2020-08-12,Orange,59,3164182,47056,41576,980,42556,754
2020-08-12,Placer,61,380077,2716,2417,4,2421,25
2020-08-12,Plumas,63,18699,38,31,0,31,0
2020-08-12,Riverside,65,2383286,49536,44747,26,44773,867
2020-08-12,Sacramento,67,1510023,15608,12528,10,12538,189
2020-08-12,San Benito,69,59416,856,751,0,751,2
2020-08-12,San Bernardino,71,2135413,45056,38811,44,38855,589
2020-08-12,San Diego,73,3302833,35691,33395,0,33395,608
2020-08-12,San Francisco,75,870044,8495,7194,14,7208,66
2020-08-12,San Joaquin,77,732212,16697,14154,25,14179,253
2020-08-12,San Luis Obispo,79,281455,2604,2263,7,2270,15
2020-08-12,San Mateo,81,765935,7569,6427,4,6431,117
2020-08-12,Santa Barbara,83,443738,7903,7049,91,7140,74
2020-08-12,Santa Clara,85,1922200,15513,13002,20,13022,182
2020-08-12,Santa Cruz,87,273765,1572,1382,11,1393,6
2020-08-12,Shasta,89,179085,557,417,3,420,9
2020-08-12,Sierra,91,2930,5,4,0,4,0
2020-08-12,Siskiyou,93,43540,115,90,0,90,0
2020-08-12,Solano,95,438530,4904,4258,32,4290,31
2020-08-12,Sonoma,97,501317,4792,3847,13,3860,47
2020-08-12,Stanislaus,99,539301,13596,11682,167,11849,136
2020-08-12,Sutter,101,95872,1112,987,1,988,7
2020-08-12,Tehama,103,63373,338,289,4,293,1
2020-08-12,Trinity,105,12862,14,6,4,10,0
2020-08-12,Tulare,107,460477,12933,11460,31,11491,211
2020-08-12,Tuolumne,109,53932,168,150,27,177,1
2020-08-12,Ventura,111,848112,9879,9005,42,9047,87
2020-08-12,Yolo,113,214977,2161,1921,4,1925,44
2020-08-12,Yuba,115,75493,676,549,1,550,1
2020-08-11,Alameda,1,1643700,15934,13960,121,14081,204
2020-08-11,Alpine,3,1148,3,2,0,2,0
2020-08-11,Amador,5,37829,250,187,0,187,3
2020-08-11,Butte,7,227075,1459,1296,11,1307,15
2020-08-11,Calaveras,9,45235,182,161,1,162,1
2020-08-11,Colusa,11,21464,416,390,0,390,5
2020-08-11,Contra Costa,13,1133247,12373,10012,36,10048,131
2020-08-11,Del Norte,15,27424,101,73,0,73,0
2020-08-11,El Dorado,17,186661,892,786,0,786,2
2020-08-11,Fresno,19,978130,24319,18344,212,18556,187
2020-08-11,Glenn,21,27897,412,380,0,380,1
2020-08-11,Humboldt,23,135768,320,283,0,283,4
2020-08-11,Imperial,25,180216,10809,8518,6,8524,165
2020-08-11,Inyo,27,18085,122,97,0,97,1
2020-08-11,Kern,29,883053,27488,25042,158,25200,230
2020-08-11,Kings,31,150075,5377,4696,31,4727,50
2020-08-11,Lake,33,64148,278,243,0,243,2
2020-08-11,Lassen,35,31185,701,605,1,606,0
2020-08-11,Los Angeles,37,10098052,222471,212421,815,213236,5065
2020-08-11,Madera,39,155013,3346,2673,15,2688,22
2020-08-11,Marin,41,260295,5787,5287,10,5297,44
2020-08-11,Mariposa,43,17540,68,60,0,60,2
2020-08-11,Mendocino,45,87422,477,385,0,385,9
2020-08-11,Merced,47,269075,6969,5322,3,5325,65
2020-08-11,Modoc,49,8938,7,5,0,5,0
2020-08-11,Mono,51,14174,161,124,1,125,1
2020-08-11,Monterey,53,433212,6754,5624,15,5639,36
2020-08-11,Napa,55,140530,1316,1143,1,1144,11
2020-08-11,Nevada,57,99092,394,358,12,370,1
2020-08-11,Orange,59,3164182,46836,41205,957,42162,742
2020-08-11,Placer,61,380077,2684,2393,4,2397,24
2020-08-11,Plumas,63,18699,38,31,0,31,0
2020-08-11,Riverside,65,2383286,49177,44237,26,44263,836
2020-08-11,Sacramento,67,1510023,15321,12298,10,12308,182
2020-08-11,San Benito,69,59416,844,750,0,750,2
2020-08-11,San Bernardino,71,2135413,44715,38467,43,38510,584
2020-08-11,San Diego,73,3302833,35424,33159,0,33159,602
2020-08-11,San Francisco,75,870044,8399,6988,14,7002,66
2020-08-11,San Joaquin,77,732212,16520,13997,20,14017,251
2020-08-11,San Luis Obispo,79,281455,2547,2234,7,2241,15
2020-08-11,San Mateo,81,765935,7493,6339,4,6343,117
2020-08-11,Santa Barbara,83,443738,7853,6942,91,7033,70
2020-08-11,Santa Clara,85,1922200,15292,12920,20,12940,183
2020-08-11,Santa Cruz,87,273765,1549,1352,11,1363,4
2020-08-11,Shasta,89,179085,553,416,3,419,9
2020-08-11,Sierra,91,2930,5,4,0,4,0
2020-08-11,Siskiyou,93,43540,115,90,0,90,0
2020-08-11,Solano,95,438530,4856,4206,31,4237,31
2020-08-11,Sonoma,97,501317,4698,3752,13,3765,45
2020-08-11,Stanislaus,99,539301,13492,11592,155,11747,128
2020-08-11,Sutter,101,95872,1090,964,1,965,7
2020-08-11,Tehama,103,63373,334,289,4,293,1
2020-08-11,Trinity,105,12862,14,5,4,9,0
2020-08-11,Tulare,107,460477,12807,11392,30,11422,201
2020-08-11,Tuolumne,109,53932,164,146,27,173,1
2020-08-11,Ventura,111,848112,9811,8953,41,8994,88
2020-08-11,Yolo,113,214977,2139,1912,4,1916,44
2020-08-11,Yuba,115,75493,665,540,1,541,1
2020-08-10,Alameda,1,1643700,15695,13420,120,13540,203
2020-08-10,Alpine,3,1148,3,2,0,2,0
2020-08-10,Amador,5,37829,249,172,0,172,2
2020-08-10,Butte,7,227075,1435,1174,10,1184,15
2020-08-10,Calaveras,9,45235,172,121,1,122,1
2020-08-10,Colusa,11,21464,414,387,0,387,4
2020-08-10,Contra Costa,13,1133247,12220,9454,34,9488,130
2020-08-10,Del Norte,15,27424,99,69,0,69,0
2020-08-10,El Dorado,17,186661,880,771,0,771,2
2020-08-10,Fresno,19,978130,24040,17978,211,18189,183
2020-08-10,Glenn,21,27897,409,381,0,381,1
2020-08-10,Humboldt,23,135768,314,277,0,277,4
2020-08-10,Imperial,25,180216,10765,8465,6,8471,165
2020-08-10,Inyo,27,18085,122,97,0,97,1
2020-08-10,Kern,29,883053,27263,24499,157,24656,215
2020-08-10,Kings,31,150075,5271,4588,31,4619,50
2020-08-10,Lake,33,64148,271,239,0,239,2
2020-08-10,Lassen,35,31185,701,588,1,589,0
2020-08-10,Los Angeles,37,10098052,220890,211035,796,211831,5003
2020-08-10,Madera,39,155013,3313,2365,14,2379,22
2020-08-10,Marin,41,260295,5744,5242,9,5251,44
2020-08-10,Mariposa,43,17540,68,57,0,57,2
2020-08-10,Mendocino,45,87422,453,364,0,364,1
2020-08-10,Merced,47,269075,6888,4913,3,4916,51
2020-08-10,Modoc,49,8938,7,5,0,5,0
2020-08-10,Mono,51,14174,161,123,1,124,1
2020-08-10,Monterey,53,433212,6644,5358,15,5373,34
2020-08-10,Napa,55,140530,1298,1084,1,1085,8
2020-08-10,Nevada,57,99092,386,356,12,368,1
2020-08-10,Orange,59,3164182,46568,40445,939,41384,721
2020-08-10,Placer,61,380077,2645,2298,4,2302,21
2020-08-10,Plumas,63,18699,38,27,0,27,0
2020-08-10,Riverside,65,2383286,48790,43296,25,43321,830
2020-08-10,Sacramento,67,1510023,15008,12059,10,12069,168
2020-08-10,San Benito,69,59416,831,743,0,743,2
2020-08-10,San Bernardino,71,2135413,44339,37367,41,37408,579
2020-08-10,San Diego,73,3302833,35158,32977,0,32977,594
2020-08-10,San Francisco,75,870044,8308,6816,13,6829,66
2020-08-10,San Joaquin,77,732212,16338,13308,20,13328,240
2020-08-10,San Luis Obispo,79,281455,2448,2208,7,2215,15
2020-08-10,San Mateo,81,765935,7416,6222,4,6226,117
2020-08-10,Santa Barbara,83,443738,7798,6869,91,6960,66
2020-08-10,Santa Clara,85,1922200,15032,12615,20,12635,182
2020-08-10,Santa Cruz,87,273765,1529,1239,10,1249,4
2020-08-10,Shasta,89,179085,549,384,3,387,9
2020-08-10,Sierra,91,2930,5,3,0,3,0
2020-08-10,Siskiyou,93,43540,112,88,0,88,0
2020-08-10,Solano,95,438530,4796,4101,31,4132,31
2020-08-10,Sonoma,97,501317,4529,3640,9,3649,42
2020-08-10,Stanislaus,99,539301,13310,10855,138,10993,106
2020-08-10,Sutter,101,95872,1065,865,1,866,7
2020-08-10,Tehama,103,63373,327,282,4,286,1
2020-08-10,Trinity,105,12862,12,5,4,9,0
2020-08-10,Tulare,107,460477,12634,10750,28,10778,194
2020-08-10,Tuolumne,109,53932,164,143,26,169,1
2020-08-10,Ventura,111,848112,9727,8851,40,8891,85
2020-08-10,Yolo,113,214977,2116,1840,4,1844,45
2020-08-10,Yuba,115,75493,648,527,1,528,1
2020-08-09,Alameda,1,1643700,15417,13241,118,13359,203
2020-08-09,Alpine,3,1148,3,2,0,2,0
2020-08-09,Amador,5,37829,244,153,0,153,2
2020-08-09,Butte,7,227075,1391,1155,10,1165,15
2020-08-09,Calaveras,9,45235,167,122,1,123,1
2020-08-09,Colusa,11,21464,410,371,0,371,4
2020-08-09,Contra Costa,13,1133247,11993,9214,32,9246,130
2020-08-09,Del Norte,15,27424,99,69,0,69,0
2020-08-09,El Dorado,17,186661,872,748,0,748,2
2020-08-09,Fresno,19,978130,23732,17846,207,18053,183
2020-08-09,Glenn,21,27897,407,354,0,354,1
2020-08-09,Humboldt,23,135768,308,279,0,279,4
2020-08-09,Imperial,25,180216,10721,8310,6,8316,165
2020-08-09,Inyo,27,18085,117,86,0,86,1
2020-08-09,Kern,29,883053,27007,23680,157,23837,215
2020-08-09,Kings,31,150075,5228,4446,30,4476,50
2020-08-09,Lake,33,64148,264,225,0,225,2
2020-08-09,Lassen,35,31185,695,589,1,590,0
2020-08-09,Los Angeles,37,10098052,218831,208810,773,209583,4984
2020-08-09,Madera,39,155013,3254,2322,10,2332,22
2020-08-09,Marin,41,260295,5701,5204,9,5213,44
2020-08-09,Mariposa,43,17540,66,56,0,56,2
2020-08-09,Mendocino,45,87422,443,283,0,283,1
2020-08-09,Merced,47,269075,6790,4735,2,4737,51
2020-08-09,Modoc,49,8938,7,4,0,4,0
2020-08-09,Mono,51,14174,160,113,1,114,1
2020-08-09,Monterey,53,433212,6520,5199,15,5214,34
2020-08-09,Napa,55,140530,1279,1062,1,1063,8
2020-08-09,Nevada,57,99092,378,332,12,344,1
2020-08-09,Orange,59,3164182,46270,39244,924,40168,722
2020-08-09,Placer,61,380077,2617,2211,4,2215,20
2020-08-09,Plumas,63,18699,38,27,0,27,0
2020-08-09,Riverside,65,2383286,48446,41894,24,41918,828
2020-08-09,Sacramento,67,1510023,14731,11301,10,11311,167
2020-08-09,San Benito,69,59416,812,687,0,687,2
2020-08-09,San Bernardino,71,2135413,43864,36092,40,36132,579
2020-08-09,San Diego,73,3302833,34867,32749,0,32749,594
2020-08-09,San Francisco,75,870044,8193,6820,13,6833,66
2020-08-09,San Joaquin,77,732212,16133,12933,19,12952,240
2020-08-09,San Luis Obispo,79,281455,2412,2124,7,2131,15
2020-08-09,San Mateo,81,765935,7321,6094,4,6098,117
2020-08-09,Santa Barbara,83,443738,7711,6669,91,6760,66
2020-08-09,Santa Clara,85,1922200,14762,11878,20,11898,181
2020-08-09,Santa Cruz,87,273765,1505,1246,10,1256,4
2020-08-09,Shasta,89,179085,545,361,3,364,9
2020-08-09,Sierra,91,2930,5,3,0,3,0
2020-08-09,Siskiyou,93,43540,111,74,0,74,0
2020-08-09,Solano,95,438530,4743,3954,30,3984,31
2020-08-09,Sonoma,97,501317,4393,3531,7,3538,41
2020-08-09,Stanislaus,99,539301,13101,10264,125,10389,106
2020-08-09,Sutter,101,95872,1031,857,1,858,7
2020-08-09,Tehama,103,63373,319,265,4,269,1
2020-08-09,Trinity,105,12862,12,5,4,9,0
2020-08-09,Tulare,107,460477,12442,10630,25,10655,194
2020-08-09,Tuolumne,109,53932,161,143,26,169,1
2020-08-09,Ventura,111,848112,9580,8633,39,8672,85
2020-08-09,Yolo,113,214977,2085,1765,4,1769,44
2020-08-09,Yuba,115,75493,628,442,1,443,1
2020-08-08,Alameda,1,1643700,15307,13087,118,13205,204
2020-08-08,Alpine,3,1148,3,2,0,2,0
2020-08-08,Amador,5,37829,244,139,0,139,2
2020-08-08,Butte,7,227075,1373,1140,10,1150,15
2020-08-08,Calaveras,9,45235,166,122,1,123,1
2020-08-08,Colusa,11,21464,409,368,0,368,4
2020-08-08,Contra Costa,13,1133247,11884,9104,32,9136,129
2020-08-08,Del Norte,15,27424,98,69,0,69,0
2020-08-08,El Dorado,17,186661,865,734,0,734,2
2020-08-08,Fresno,19,978130,23596,17538,205,17743,183
2020-08-08,Glenn,21,27897,407,344,0,344,1
2020-08-08,Humboldt,23,135768,305,277,0,277,4
2020-08-08,Imperial,25,180216,10706,8213,6,8219,165
2020-08-08,Inyo,27,18085,113,86,0,86,1
2020-08-08,Kern,29,883053,26893,22803,157,22960,215
2020-08-08,Kings,31,150075,5214,4367,30,4397,49
2020-08-08,Lake,33,64148,262,221,0,221,2
2020-08-08,Lassen,35,31185,695,589,1,590,0
2020-08-08,Los Angeles,37,10098052,217942,206971,762,207733,4974
2020-08-08,Madera,39,155013,3223,2275,10,2285,22
2020-08-08,Marin,41,260295,5681,5118,9,5127,44
2020-08-08,Mariposa,43,17540,65,55,0,55,2
2020-08-08,Mendocino,45,87422,441,264,0,264,1
2020-08-08,Merced,47,269075,6750,4570,2,4572,51
2020-08-08,Modoc,49,8938,7,4,0,4,0
2020-08-08,Mono,51,14174,160,113,1,114,1
2020-08-08,Monterey,53,433212,6462,5101,15,5116,33
2020-08-08,Napa,55,140530,1271,1062,1,1063,8
2020-08-08,Nevada,57,99092,376,325,12,337,1
2020-08-08,Orange,59,3164182,46145,38688,915,39603,718
2020-08-08,Placer,61,380077,2600,2153,4,2157,20
2020-08-08,Plumas,63,18699,38,27,0,27,0
2020-08-08,Riverside,65,2383286,48243,41412,24,41436,823
2020-08-08,Sacramento,67,1510023,14601,11144,10,11154,166
2020-08-08,San Benito,69,59416,804,684,0,684,2
2020-08-08,San Bernardino,71,2135413,43668,35691,39,35730,531
2020-08-08,San Diego,73,3302833,34678,32332,0,32332,593
2020-08-08,San Francisco,75,870044,8127,6820,13,6833,66
2020-08-08,San Joaquin,77,732212,16052,12559,18,12577,240
2020-08-08,San Luis Obispo,79,281455,2389,2081,7,2088,15
2020-08-08,San Mateo,81,765935,7263,6021,4,6025,117
2020-08-08,Santa Barbara,83,443738,7673,6598,91,6689,66
2020-08-08,Santa Clara,85,1922200,14610,11615,20,11635,181
2020-08-08,Santa Cruz,87,273765,1491,1247,10,1257,4
2020-08-08,Shasta,89,179085,543,343,3,346,9
2020-08-08,Sierra,91,2930,5,3,0,3,0
2020-08-08,Siskiyou,93,43540,111,73,0,73,0
2020-08-08,Solano,95,438530,4722,3889,29,3918,31
2020-08-08,Sonoma,97,501317,4361,3399,7,3406,41
2020-08-08,Stanislaus,99,539301,13026,9963,119,10082,105
2020-08-08,Sutter,101,95872,1021,830,1,831,7
2020-08-08,Tehama,103,63373,318,251,4,255,1
2020-08-08,Trinity,105,12862,12,5,4,9,0
2020-08-08,Tulare,107,460477,12366,10505,25,10530,192
2020-08-08,Tuolumne,109,53932,161,143,26,169,1
2020-08-08,Ventura,111,848112,9526,8462,38,8500,85
2020-08-08,Yolo,113,214977,2072,1725,4,1729,44
2020-08-08,Yuba,115,75493,619,430,1,431,1
2020-08-07,Alameda,1,1643700,15198,12805,118,12923,204
2020-08-07,Alpine,3,1148,3,2,0,2,0
2020-08-07,Amador,5,37829,242,125,0,125,2
2020-08-07,Butte,7,227075,1355,1092,10,1102,13
2020-08-07,Calaveras,9,45235,166,119,1,120,1
2020-08-07,Colusa,11,21464,408,358,0,358,4
2020-08-07,Contra Costa,13,1133247,11735,8810,32,8842,126
2020-08-07,Del Norte,15,27424,98,69,0,69,0
2020-08-07,El Dorado,17,186661,860,724,0,724,2
2020-08-07,Fresno,19,978130,23436,17290,205,17495,171
2020-08-07,Glenn,21,27897,406,339,0,339,1
2020-08-07,Humboldt,23,135768,301,274,0,274,4
2020-08-07,Imperial,25,180216,10681,8085,6,8091,164
2020-08-07,Inyo,27,18085,112,81,0,81,1
2020-08-07,Kern,29,883053,26767,22143,154,22297,206
2020-08-07,Kings,31,150075,5197,4315,30,4345,48
2020-08-07,Lake,33,64148,260,215,0,215,1
2020-08-07,Lassen,35,31185,694,588,1,589,0
2020-08-07,Los Angeles,37,10098052,216485,204406,750,205156,4924
2020-08-07,Madera,39,155013,3191,2245,10,2255,20
2020-08-07,Marin,41,260295,5652,5094,9,5103,43
2020-08-07,Mariposa,43,17540,65,53,0,53,2
2020-08-07,Mendocino,45,87422,427,262,0,262,1
2020-08-07,Merced,47,269075,6707,4358,2,4360,30
2020-08-07,Modoc,49,8938,7,4,0,4,0
2020-08-07,Mono,51,14174,160,112,1,113,1
2020-08-07,Monterey,53,433212,6387,5041,15,5056,33
2020-08-07,Napa,55,140530,1266,1055,1,1056,8
2020-08-07,Nevada,57,99092,373,324,12,336,1
2020-08-07,Orange,59,3164182,45933,38459,898,39357,701
2020-08-07,Placer,61,380077,2583,2078,4,2082,20
2020-08-07,Plumas,63,18699,38,25,0,25,0
2020-08-07,Riverside,65,2383286,47979,40902,23,40925,810
2020-08-07,Sacramento,67,1510023,14456,10798,10,10808,160
2020-08-07,San Benito,69,59416,798,647,0,647,2
2020-08-07,San Bernardino,71,2135413,43422,35200,38,35238,524
2020-08-07,San Diego,73,3302833,34493,31781,0,31781,586
2020-08-07,San Francisco,75,870044,8049,6765,13,6778,66
2020-08-07,San Joaquin,77,732212,15968,12392,18,12410,223
2020-08-07,San Luis Obispo,79,281455,2358,2050,7,2057,14
2020-08-07,San Mateo,81,765935,7204,5948,4,5952,117
2020-08-07,Santa Barbara,83,443738,7622,6509,91,6600,66
2020-08-07,Santa Clara,85,1922200,14411,11409,20,11429,180
2020-08-07,Santa Cruz,87,273765,1473,1234,10,1244,5
2020-08-07,Shasta,89,179085,538,342,3,345,9
2020-08-07,Sierra,91,2930,5,3,0,3,0
2020-08-07,Siskiyou,93,43540,108,73,0,73,0
2020-08-07,Solano,95,438530,4690,3844,28,3872,31
2020-08-07,Sonoma,97,501317,4297,3329,7,3336,34
2020-08-07,Stanislaus,99,539301,12905,9665,108,9773,98
2020-08-07,Sutter,101,95872,1017,807,1,808,6
2020-08-07,Tehama,103,63373,314,246,4,250,1
2020-08-07,Trinity,105,12862,11,5,4,9,0
2020-08-07,Tulare,107,460477,12289,10292,25,10317,195
2020-08-07,Tuolumne,109,53932,160,136,26,162,1
2020-08-07,Ventura,111,848112,9466,8356,36,8392,84
2020-08-07,Yolo,113,214977,2047,1689,4,1693,37
2020-08-07,Yuba,115,75493,614,413,1,414,1
2020-08-06,Alameda,1,1643700,14978,12474,117,12591,200
2020-08-06,Alpine,3,1148,3,2,0,2,0
2020-08-06,Amador,5,37829,228,125,0,125,0
2020-08-06,Butte,7,227075,1336,1060,10,1070,13
2020-08-06,Calaveras,9,45235,164,117,1,118,1
2020-08-06,Colusa,11,21464,405,358,0,358,3
2020-08-06,Contra Costa,13,1133247,11541,8583,31,8614,124
2020-08-06,Del Norte,15,27424,98,69,0,69,0
2020-08-06,El Dorado,17,186661,849,703,0,703,1
2020-08-06,Fresno,19,978130,23140,17031,198,17229,161
2020-08-06,Glenn,21,27897,401,332,0,332,1
2020-08-06,Humboldt,23,135768,296,266,0,266,4
2020-08-06,Imperial,25,180216,10637,8064,6,8070,163
2020-08-06,Inyo,27,18085,104,83,0,83,1
2020-08-06,Kern,29,883053,26531,21843,153,21996,197
2020-08-06,Kings,31,150075,5137,4264,28,4292,47
2020-08-06,Lake,33,64148,257,209,0,209,1
2020-08-06,Lassen,35,31185,692,588,1,589,0
2020-08-06,Los Angeles,37,10098052,214407,201372,733,202105,4874
2020-08-06,Madera,39,155013,3143,2240,9,2249,19
2020-08-06,Marin,41,260295,5619,5058,9,5067,43
2020-08-06,Mariposa,43,17540,64,52,0,52,2
2020-08-06,Mendocino,45,87422,413,260,0,260,1
2020-08-06,Merced,47,269075,6606,4235,2,4237,30
2020-08-06,Modoc,49,8938,7,4,0,4,0
2020-08-06,Mono,51,14174,159,111,1,112,1
2020-08-06,Monterey,53,433212,6278,5001,14,5015,33
2020-08-06,Napa,55,140530,1252,1032,1,1033,8
2020-08-06,Nevada,57,99092,368,321,12,333,1
2020-08-06,Orange,59,3164182,45641,38399,893,39292,694
2020-08-06,Placer,61,380077,2556,2045,4,2049,20
2020-08-06,Plumas,63,18699,37,25,0,25,0
2020-08-06,Riverside,65,2383286,47584,40269,23,40292,781
2020-08-06,Sacramento,67,1510023,14225,10548,10,10558,153
2020-08-06,San Benito,69,59416,790,626,0,626,2
2020-08-06,San Bernardino,71,2135413,43018,34819,38,34857,516
2020-08-06,San Diego,73,3302833,34226,31129,0,31129,583
2020-08-06,San Francisco,75,870044,7956,6737,12,6749,60
2020-08-06,San Joaquin,77,732212,15809,12269,18,12287,203
2020-08-06,San Luis Obispo,79,281455,2334,2000,7,2007,13
2020-08-06,San Mateo,81,765935,7105,5885,4,5889,117
2020-08-06,Santa Barbara,83,443738,7562,6620,91,6711,65
2020-08-06,Santa Clara,85,1922200,14182,11280,20,11300,178
2020-08-06,Santa Cruz,87,273765,1452,1215,10,1225,4
2020-08-06,Shasta,89,179085,529,343,3,346,9
2020-08-06,Sierra,91,2930,5,3,0,3,0
2020-08-06,Siskiyou,93,43540,108,73,0,73,0
2020-08-06,Solano,95,438530,4647,3784,28,3812,29
2020-08-06,Sonoma,97,501317,4233,3259,7,3266,33
2020-08-06,Stanislaus,99,539301,12756,9566,91,9657,98
2020-08-06,Sutter,101,95872,986,797,1,798,6
2020-08-06,Tehama,103,63373,311,242,4,246,1
2020-08-06,Trinity,105,12862,9,5,4,9,0
2020-08-06,Tulare,107,460477,12130,10169,25,10194,195
2020-08-06,Tuolumne,109,53932,159,136,26,162,1
2020-08-06,Ventura,111,848112,9355,8245,33,8278,80
2020-08-06,Yolo,113,214977,2023,1662,4,1666,36
2020-08-06,Yuba,115,75493,605,407,0,407,1
2020-08-05,Alameda,1,1643700,14766,12140,116,12256,193
2020-08-05,Alpine,3,1148,3,2,0,2,0
2020-08-05,Amador,5,37829,218,123,0,123,0
2020-08-05,Butte,7,227075,1303,1038,10,1048,13
2020-08-05,Calaveras,9,45235,161,116,1,117,1
2020-08-05,Colusa,11,21464,401,354,0,354,3
2020-08-05,Contra Costa,13,1133247,11377,8362,31,8393,122
2020-08-05,Del Norte,15,27424,97,69,0,69,0
2020-08-05,El Dorado,17,186661,841,692,0,692,1
2020-08-05,Fresno,19,978130,22899,16625,191,16816,159
2020-08-05,Glenn,21,27897,398,330,0,330,1
2020-08-05,Humboldt,23,135768,294,249,0,249,4
2020-08-05,Imperial,25,180216,10602,8036,6,8042,163
2020-08-05,Inyo,27,18085,102,62,0,62,1
2020-08-05,Kern,29,883053,26344,21540,148,21688,194
2020-08-05,Kings,31,150075,5092,4192,26,4218,47
2020-08-05,Lake,33,64148,250,209,0,209,1
2020-08-05,Lassen,35,31185,645,557,1,558,0
2020-08-05,Los Angeles,37,10098052,212490,198355,712,199067,4832
2020-08-05,Madera,39,155013,3101,2172,9,2181,19
2020-08-05,Marin,41,260295,5587,5036,9,5045,43
2020-08-05,Mariposa,43,17540,64,52,0,52,2
2020-08-05,Mendocino,45,87422,401,248,0,248,1
2020-08-05,Merced,47,269075,6471,4119,2,4121,30
2020-08-05,Modoc,49,8938,7,3,0,3,0
2020-08-05,Mono,51,14174,159,104,1,105,1
2020-08-05,Monterey,53,433212,6163,4936,14,4950,32
2020-08-05,Napa,55,140530,1240,1020,1,1021,8
2020-08-05,Nevada,57,99092,359,327,12,339,2
2020-08-05,Orange,59,3164182,45332,37907,886,38793,663
2020-08-05,Placer,61,380077,2515,1989,4,1993,18
2020-08-05,Plumas,63,18699,36,25,0,25,0
2020-08-05,Riverside,65,2383286,47193,39454,21,39475,761
2020-08-05,Sacramento,67,1510023,14007,10261,9,10270,151
2020-08-05,San Benito,69,59416,781,613,0,613,2
2020-08-05,San Bernardino,71,2135413,42554,34442,36,34478,504
2020-08-05,San Diego,73,3302833,34002,30866,0,30866,578
2020-08-05,San Francisco,75,870044,7863,6701,12,6713,60
2020-08-05,San Joaquin,77,732212,15646,12148,18,12166,199
2020-08-05,San Luis Obispo,79,281455,2311,1928,7,1935,13
2020-08-05,San Mateo,81,765935,7009,5695,4,5699,116
2020-08-05,Santa Barbara,83,443738,7501,6597,91,6688,63
2020-08-05,Santa Clara,85,1922200,13947,11074,20,11094,176
2020-08-05,Santa Cruz,87,273765,1432,1192,9,1201,4
2020-08-05,Shasta,89,179085,523,338,3,341,9
2020-08-05,Sierra,91,2930,5,3,0,3,0
2020-08-05,Siskiyou,93,43540,104,72,0,72,0
2020-08-05,Solano,95,438530,4596,3750,27,3777,29
2020-08-05,Sonoma,97,501317,4151,3173,7,3180,33
2020-08-05,Stanislaus,99,539301,12597,9408,86,9494,97
2020-08-05,Sutter,101,95872,975,780,1,781,6
2020-08-05,Tehama,103,63373,308,231,4,235,1
2020-08-05,Trinity,105,12862,9,5,4,9,0
2020-08-05,Tulare,107,460477,11990,9924,25,9949,192
2020-08-05,Tuolumne,109,53932,159,137,26,163,0
2020-08-05,Ventura,111,848112,9248,8162,30,8192,75
2020-08-05,Yolo,113,214977,1995,1634,4,1638,36
2020-08-05,Yuba,115,75493,588,400,0,400,1
2020-08-04,Alameda,1,1643700,14548,11983,115,12098,192
2020-08-04,Alpine,3,1148,3,2,0,2,0
2020-08-04,Amador,5,37829,203,123,0,123,0
2020-08-04,Butte,7,227075,1279,1011,10,1021,10
2020-08-04,Calaveras,9,45235,157,116,1,117,1
2020-08-04,Colusa,11,21464,396,354,0,354,3
2020-08-04,Contra Costa,13,1133247,11211,8210,31,8241,122
2020-08-04,Del Norte,15,27424,95,69,0,69,0
2020-08-04,El Dorado,17,186661,831,668,0,668,1
2020-08-04,Fresno,19,978130,22617,16272,183,16455,154
2020-08-04,Glenn,21,27897,397,325,0,325,1
2020-08-04,Humboldt,23,135768,284,241,0,241,4
2020-08-04,Imperial,25,180216,10565,7974,6,7980,163
2020-08-04,Inyo,27,18085,88,59,0,59,1
2020-08-04,Kern,29,883053,26060,21403,148,21551,190
2020-08-04,Kings,31,150075,5032,4163,26,4189,47
2020-08-04,Lake,33,64148,250,206,0,206,1
2020-08-04,Lassen,35,31185,642,556,1,557,0
2020-08-04,Los Angeles,37,10098052,210527,196014,681,196695,4764
2020-08-04,Madera,39,155013,3058,2161,4,2165,19
2020-08-04,Marin,41,260295,5556,5020,8,5028,43
2020-08-04,Mariposa,43,17540,64,51,0,51,2
2020-08-04,Mendocino,45,87422,376,248,0,248,1
2020-08-04,Merced,47,269075,6357,4085,2,4087,30
2020-08-04,Modoc,49,8938,7,3,0,3,0
2020-08-04,Mono,51,14174,158,104,0,104,1
2020-08-04,Monterey,53,433212,6049,4892,14,4906,32
2020-08-04,Napa,55,140530,1227,994,0,994,8
2020-08-04,Nevada,57,99092,358,322,12,334,2
2020-08-04,Orange,59,3164182,44959,37844,881,38725,659
2020-08-04,Placer,61,380077,2476,1964,4,1968,17
2020-08-04,Plumas,63,18699,36,25,0,25,0
2020-08-04,Riverside,65,2383286,46808,38991,20,39011,743
2020-08-04,Sacramento,67,1510023,13787,10205,9,10214,146
2020-08-04,San Benito,69,59416,765,608,0,608,2
2020-08-04,San Bernardino,71,2135413,42009,34215,35,34250,495
2020-08-04,San Diego,73,3302833,33709,30518,0,30518,568
2020-08-04,San Francisco,75,870044,7776,6568,12,6580,60
2020-08-04,San Joaquin,77,732212,15517,12087,15,12102,189
2020-08-04,San Luis Obispo,79,281455,2281,1886,7,1893,13
2020-08-04,San Mateo,81,765935,6903,5690,4,5694,116
2020-08-04,Santa Barbara,83,443738,7441,6591,91,6682,61
2020-08-04,Santa Clara,85,1922200,13647,10986,20,11006,175
2020-08-04,Santa Cruz,87,273765,1413,1202,9,1211,4
2020-08-04,Shasta,89,179085,517,335,3,338,9
2020-08-04,Sierra,91,2930,5,1,0,1,0
2020-08-04,Siskiyou,93,43540,102,71,0,71,0
2020-08-04,Solano,95,438530,4525,3690,27,3717,29
2020-08-04,Sonoma,97,501317,4084,3108,7,3115,33
2020-08-04,Stanislaus,99,539301,12428,9359,78,9437,97
2020-08-04,Sutter,101,95872,961,761,1,762,6
2020-08-04,Tehama,103,63373,301,226,4,230,1
2020-08-04,Trinity,105,12862,9,5,4,9,0
2020-08-04,Tulare,107,460477,11810,9866,25,9891,192
2020-08-04,Tuolumne,109,53932,158,127,26,153,0
2020-08-04,Ventura,111,848112,9142,8134,28,8162,75
2020-08-04,Yolo,113,214977,1968,1626,4,1630,37
2020-08-04,Yuba,115,75493,573,398,0,398,1
2020-08-03,Alameda,1,1643700,14365,11817,111,11928,189
2020-08-03,Alpine,3,1148,3,2,0,2,0
2020-08-03,Amador,5,37829,199,119,0,119,0
2020-08-03,Butte,7,227075,1233,989,9,998,9
2020-08-03,Calaveras,9,45235,154,117,1,118,1
2020-08-03,Colusa,11,21464,392,336,0,336,2
2020-08-03,Contra Costa,13,1133247,11015,8069,27,8096,120
2020-08-03,Del Norte,15,27424,91,68,0,68,0
2020-08-03,El Dorado,17,186661,820,645,0,645,1
2020-08-03,Fresno,19,978130,22323,15945,177,16122,151
2020-08-03,Glenn,21,27897,390,316,0,316,1
2020-08-03,Humboldt,23,135768,277,234,0,234,4
2020-08-03,Imperial,25,180216,10511,7953,6,7959,161
2020-08-03,Inyo,27,18085,85,57,0,57,1
2020-08-03,Kern,29,883053,25692,21285,141,21426,176
2020-08-03,Kings,31,150075,4920,4107,26,4133,47
2020-08-03,Lake,33,64148,243,201,0,201,1
2020-08-03,Lassen,35,31185,642,555,1,556,0
2020-08-03,Los Angeles,37,10098052,208478,194103,650,194753,4706
2020-08-03,Madera,39,155013,3009,2143,3,2146,18
2020-08-03,Marin,41,260295,5509,5001,8,5009,43
2020-08-03,Mariposa,43,17540,63,52,0,52,2
2020-08-03,Mendocino,45,87422,353,248,0,248,1
2020-08-03,Merced,47,269075,6235,4028,2,4030,29
2020-08-03,Modoc,49,8938,7,2,0,2,0
2020-08-03,Mono,51,14174,158,104,0,104,1
2020-08-03,Monterey,53,433212,5898,4806,11,4817,28
2020-08-03,Napa,55,140530,1212,973,0,973,8
2020-08-03,Nevada,57,99092,353,315,12,327,2
2020-08-03,Orange,59,3164182,44565,37705,872,38577,651
2020-08-03,Placer,61,380077,2421,1947,3,1950,16
2020-08-03,Plumas,63,18699,36,25,0,25,0
2020-08-03,Riverside,65,2383286,46340,38642,20,38662,740
2020-08-03,Sacramento,67,1510023,13590,10143,9,10152,142
2020-08-03,San Benito,69,59416,753,603,0,603,2
2020-08-03,San Bernardino,71,2135413,41481,33979,34,34013,444
2020-08-03,San Diego,73,3302833,33397,30228,0,30228,565
2020-08-03,San Francisco,75,870044,7682,6319,12,6331,60
2020-08-03,San Joaquin,77,732212,15318,12007,14,12021,189
2020-08-03,San Luis Obispo,79,281455,2239,1863,4,1867,14
2020-08-03,San Mateo,81,765935,6822,5661,4,5665,115
2020-08-03,Santa Barbara,83,443738,7397,6580,91,6671,59
2020-08-03,Santa Clara,85,1922200,13371,10747,20,10767,172
2020-08-03,Santa Cruz,87,273765,1393,1154,9,1163,4
2020-08-03,Shasta,89,179085,510,322,3,325,9
2020-08-03,Sierra,91,2930,5,1,0,1,0
2020-08-03,Siskiyou,93,43540,98,67,0,67,0
2020-08-03,Solano,95,438530,4456,3610,26,3636,29
2020-08-03,Sonoma,97,501317,3985,3079,6,3085,33
2020-08-03,Stanislaus,99,539301,12223,9308,70,9378,96
2020-08-03,Sutter,101,95872,937,713,1,714,6
2020-08-03,Tehama,103,63373,293,225,4,229,1
2020-08-03,Trinity,105,12862,9,5,4,9,0
2020-08-03,Tulare,107,460477,11626,9703,25,9728,188
2020-08-03,Tuolumne,109,53932,158,123,26,149,0
2020-08-03,Ventura,111,848112,9056,8084,26,8110,74
2020-08-03,Yolo,113,214977,1933,1598,3,1601,37
2020-08-03,Yuba,115,75493,549,393,0,393,1
2020-08-02,Alameda,1,1643700,14122,11696,97,11793,188
2020-08-02,Alpine,3,1148,3,2,0,2,0
2020-08-02,Amador,5,37829,194,117,0,117,0
2020-08-02,Butte,7,227075,1198,987,9,996,9
2020-08-02,Calaveras,9,45235,151,116,1,117,1
2020-08-02,Colusa,11,21464,387,335,0,335,2
2020-08-02,Contra Costa,13,1133247,10777,7995,27,8022,118
2020-08-02,Del Norte,15,27424,90,68,0,68,0
2020-08-02,El Dorado,17,186661,810,643,0,643,1
2020-08-02,Fresno,19,978130,22048,15759,170,15929,151
2020-08-02,Glenn,21,27897,389,315,0,315,1
2020-08-02,Humboldt,23,135768,272,232,0,232,4
2020-08-02,Imperial,25,180216,10448,7919,6,7925,157
2020-08-02,Inyo,27,18085,84,45,0,45,1
2020-08-02,Kern,29,883053,25394,21162,139,21301,176
2020-08-02,Kings,31,150075,4858,3964,25,3989,47
2020-08-02,Lake,33,64148,238,201,0,201,1
2020-08-02,Lassen,35,31185,642,555,1,556,0
2020-08-02,Los Angeles,37,10098052,206378,192480,632,193112,4698
2020-08-02,Madera,39,155013,2943,2123,1,2124,18
2020-08-02,Marin,41,260295,5475,4985,8,4993,43
2020-08-02,Mariposa,43,17540,61,52,0,52,2
2020-08-02,Mendocino,45,87422,343,247,0,247,1
2020-08-02,Merced,47,269075,6094,4011,2,4013,29
2020-08-02,Modoc,49,8938,7,2,0,2,0
2020-08-02,Mono,51,14174,151,104,0,104,1
2020-08-02,Monterey,53,433212,5773,4698,11,4709,28
2020-08-02,Napa,55,140530,1197,956,0,956,8
2020-08-02,Nevada,57,99092,350,314,12,326,2
2020-08-02,Orange,59,3164182,44184,37266,861,38127,651
2020-08-02,Placer,61,380077,2381,1920,3,1923,15
2020-08-02,Plumas,63,18699,36,25,0,25,0
2020-08-02,Riverside,65,2383286,45907,38507,20,38527,735
2020-08-02,Sacramento,67,1510023,13305,10099,9,10108,142
2020-08-02,San Benito,69,59416,739,599,0,599,2
2020-08-02,San Bernardino,71,2135413,40882,33643,34,33677,443
2020-08-02,San Diego,73,3302833,33058,29885,0,29885,565
2020-08-02,San Francisco,75,870044,7564,6297,12,6309,60
2020-08-02,San Joaquin,77,732212,15032,11937,12,11949,189
2020-08-02,San Luis Obispo,79,281455,2177,1821,4,1825,14
2020-08-02,San Mateo,81,765935,6707,5618,4,5622,115
2020-08-02,Santa Barbara,83,443738,7306,6532,91,6623,59
2020-08-02,Santa Clara,85,1922200,13153,10577,20,10597,172
2020-08-02,Santa Cruz,87,273765,1373,1162,9,1171,4
2020-08-02,Shasta,89,179085,506,318,3,321,9
2020-08-02,Sierra,91,2930,4,1,0,1,0
2020-08-02,Siskiyou,93,43540,98,65,0,65,0
2020-08-02,Solano,95,438530,4397,3609,26,3635,29
2020-08-02,Sonoma,97,501317,3901,3005,6,3011,33
2020-08-02,Stanislaus,99,539301,12008,9277,64,9341,96
2020-08-02,Sutter,101,95872,902,714,1,715,6
2020-08-02,Tehama,103,63373,287,222,4,226,1
2020-08-02,Trinity,105,12862,9,5,4,9,0
2020-08-02,Tulare,107,460477,11417,9593,25,9618,188
2020-08-02,Tuolumne,109,53932,155,123,26,149,0
2020-08-02,Ventura,111,848112,8914,8014,26,8040,73
2020-08-02,Yolo,113,214977,1909,1588,3,1591,37
2020-08-02,Yuba,115,75493,529,393,0,393,1
2020-08-01,Alameda,1,1643700,14011,11590,97,11687,188
2020-08-01,Alpine,3,1148,3,2,0,2,0
2020-08-01,Amador,5,37829,190,109,0,109,0
2020-08-01,Butte,7,227075,1184,976,9,985,9
2020-08-01,Calaveras,9,45235,147,116,1,117,1
2020-08-01,Colusa,11,21464,386,327,0,327,2
2020-08-01,Contra Costa,13,1133247,10644,7867,26,7893,116
2020-08-01,Del Norte,15,27424,90,68,0,68,0
2020-08-01,El Dorado,17,186661,807,637,0,637,1
2020-08-01,Fresno,19,978130,21911,15448,170,15618,149
2020-08-01,Glenn,21,27897,388,311,0,311,1
2020-08-01,Humboldt,23,135768,271,232,0,232,4
2020-08-01,Imperial,25,180216,10412,7919,6,7925,156
2020-08-01,Inyo,27,18085,82,45,0,45,1
2020-08-01,Kern,29,883053,25234,20796,135,20931,176
2020-08-01,Kings,31,150075,4832,3948,25,3973,47
2020-08-01,Lake,33,64148,236,194,0,194,1
2020-08-01,Lassen,35,31185,641,555,1,556,0
2020-08-01,Los Angeles,37,10098052,205490,191023,604,191627,4674
2020-08-01,Madera,39,155013,2905,2103,1,2104,18
2020-08-01,Marin,41,260295,5461,4945,7,4952,43
2020-08-01,Mariposa,43,17540,61,50,0,50,2
2020-08-01,Mendocino,45,87422,336,243,0,243,1
2020-08-01,Merced,47,269075,6046,3972,2,3974,29
2020-08-01,Modoc,49,8938,7,2,0,2,0
2020-08-01,Mono,51,14174,150,104,0,104,1
2020-08-01,Monterey,53,433212,5706,4611,10,4621,28
2020-08-01,Napa,55,140530,1188,923,0,923,8
2020-08-01,Nevada,57,99092,346,305,12,317,2
2020-08-01,Orange,59,3164182,43957,36703,855,37558,648
2020-08-01,Placer,61,380077,2348,1891,3,1894,14
2020-08-01,Plumas,63,18699,35,25,0,25,0
2020-08-01,Riverside,65,2383286,45696,38216,19,38235,704
2020-08-01,Sacramento,67,1510023,13148,10044,9,10053,141
2020-08-01,San Benito,69,59416,727,579,0,579,2
2020-08-01,San Bernardino,71,2135413,40647,32947,34,32981,440
2020-08-01,San Diego,73,3302833,32841,29579,0,29579,565
2020-08-01,San Francisco,75,870044,7502,6296,12,6308,60
2020-08-01,San Joaquin,77,732212,14960,11807,11,11818,189
2020-08-01,San Luis Obispo,79,281455,2151,1798,4,1802,13
2020-08-01,San Mateo,81,765935,6652,5520,4,5524,115
2020-08-01,Santa Barbara,83,443738,7266,6465,91,6556,59
2020-08-01,Santa Clara,85,1922200,13002,10281,20,10301,171
2020-08-01,Santa Cruz,87,273765,1357,1164,9,1173,4
2020-08-01,Shasta,89,179085,501,312,3,315,9
2020-08-01,Sierra,91,2930,3,1,0,1,0
2020-08-01,Siskiyou,93,43540,98,64,0,64,0
2020-08-01,Solano,95,438530,4363,3591,25,3616,29
2020-08-01,Sonoma,97,501317,3855,2890,6,2896,29
2020-08-01,Stanislaus,99,539301,11891,9221,56,9277,96
2020-08-01,Sutter,101,95872,898,714,1,715,6
2020-08-01,Tehama,103,63373,284,220,4,224,1
2020-08-01,Trinity,105,12862,9,5,4,9,0
2020-08-01,Tulare,107,460477,11349,9520,25,9545,188
2020-08-01,Tuolumne,109,53932,155,123,26,149,0
2020-08-01,Ventura,111,848112,8868,7819,25,7844,73
2020-08-01,Yolo,113,214977,1899,1557,3,1560,37
2020-08-01,Yuba,115,75493,524,387,0,387,1
2020-07-31,Alameda,1,1643700,13879,11441,97,11538,187
2020-07-31,Alpine,3,1148,3,2,0,2,0
2020-07-31,Amador,5,37829,189,98,0,98,0
2020-07-31,Butte,7,227075,1161,925,9,934,7
2020-07-31,Calaveras,9,45235,147,112,1,113,1
2020-07-31,Colusa,11,21464,376,319,0,319,2
2020-07-31,Contra Costa,13,1133247,10496,7697,25,7722,113
2020-07-31,Del Norte,15,27424,89,68,0,68,0
2020-07-31,El Dorado,17,186661,796,616,0,616,1
2020-07-31,Fresno,19,978130,21692,15083,170,15253,133
2020-07-31,Glenn,21,27897,381,304,0,304,1
2020-07-31,Humboldt,23,135768,264,229,0,229,4
2020-07-31,Imperial,25,180216,10380,7886,6,7892,155
2020-07-31,Inyo,27,18085,72,45,0,45,1
2020-07-31,Kern,29,883053,24992,20061,130,20191,173
2020-07-31,Kings,31,150075,4804,3807,25,3832,45
2020-07-31,Lake,33,64148,235,191,0,191,1
2020-07-31,Lassen,35,31185,636,544,1,545,0
2020-07-31,Los Angeles,37,10098052,203883,188688,592,189280,4628
2020-07-31,Madera,39,155013,2858,2036,1,2037,19
2020-07-31,Marin,41,260295,5417,4885,4,4889,43
2020-07-31,Mariposa,43,17540,61,49,0,49,2
2020-07-31,Mendocino,45,87422,321,232,0,232,1
2020-07-31,Merced,47,269075,5963,3789,2,3791,30
2020-07-31,Modoc,49,8938,6,0,0,0,0
2020-07-31,Mono,51,14174,149,104,0,104,1
2020-07-31,Monterey,53,433212,5614,4493,10,4503,24
2020-07-31,Napa,55,140530,1176,897,0,897,7
2020-07-31,Nevada,57,99092,344,302,12,314,2
2020-07-31,Orange,59,3164182,43657,36196,839,37035,620
2020-07-31,Placer,61,380077,2324,1853,3,1856,14
2020-07-31,Plumas,63,18699,34,25,0,25,0
2020-07-31,Riverside,65,2383286,45306,37612,19,37631,694
2020-07-31,Sacramento,67,1510023,12967,9872,9,9881,132
2020-07-31,San Benito,69,59416,719,567,0,567,2
2020-07-31,San Bernardino,71,2135413,40318,32332,33,32365,434
2020-07-31,San Diego,73,3302833,32607,29050,0,29050,561
2020-07-31,San Francisco,75,870044,7403,6126,12,6138,60
2020-07-31,San Joaquin,77,732212,14824,11561,11,11572,177
2020-07-31,San Luis Obispo,79,281455,2081,1746,4,1750,12
2020-07-31,San Mateo,81,765935,6580,5416,4,5420,115
2020-07-31,Santa Barbara,83,443738,7199,6375,91,6466,58
2020-07-31,Santa Clara,85,1922200,12781,9863,20,9883,171
2020-07-31,Santa Cruz,87,273765,1334,1118,9,1127,4
2020-07-31,Shasta,89,179085,491,305,3,308,9
2020-07-31,Sierra,91,2930,3,1,0,1,0
2020-07-31,Siskiyou,93,43540,96,61,0,61,0
2020-07-31,Solano,95,438530,4316,3510,24,3534,29
2020-07-31,Sonoma,97,501317,3797,2745,6,2751,27
2020-07-31,Stanislaus,99,539301,11784,9061,51,9112,94
2020-07-31,Sutter,101,95872,893,714,1,715,6
2020-07-31,Tehama,103,63373,281,213,4,217,1
2020-07-31,Trinity,105,12862,9,5,4,9,0
2020-07-31,Tulare,107,460477,11228,9365,25,9390,184
2020-07-31,Tuolumne,109,53932,155,120,26,146,0
2020-07-31,Ventura,111,848112,8793,7521,25,7546,71
2020-07-31,Yolo,113,214977,1873,1522,3,1525,38
2020-07-31,Yuba,115,75493,515,369,0,369,1
2020-07-30,Alameda,1,1643700,13682,11303,53,11356,185
2020-07-30,Alpine,3,1148,3,2,0,2,0
2020-07-30,Amador,5,37829,171,97,0,97,0
2020-07-30,Butte,7,227075,1145,915,9,924,7
2020-07-30,Calaveras,9,45235,143,111,1,112,1
2020-07-30,Colusa,11,21464,373,315,0,315,2
2020-07-30,Contra Costa,13,1133247,10311,7615,24,7639,112
2020-07-30,Del Norte,15,27424,89,68,0,68,0
2020-07-30,El Dorado,17,186661,789,608,0,608,1
2020-07-30,Fresno,19,978130,21356,14793,164,14957,133
2020-07-30,Glenn,21,27897,374,297,0,297,1
2020-07-30,Humboldt,23,135768,262,228,0,228,4
2020-07-30,Imperial,25,180216,10321,7849,6,7855,151
2020-07-30,Inyo,27,18085,68,44,0,44,1
2020-07-30,Kern,29,883053,24699,19552,126,19678,171
2020-07-30,Kings,31,150075,4700,3785,25,3810,43
2020-07-30,Lake,33,64148,229,181,0,181,1
2020-07-30,Lassen,35,31185,633,544,1,545,0
2020-07-30,Los Angeles,37,10098052,201847,186177,559,186736,4564
2020-07-30,Madera,39,155013,2788,2007,1,2008,18
2020-07-30,Marin,41,260295,5375,4835,4,4839,39
2020-07-30,Mariposa,43,17540,61,49,0,49,1
2020-07-30,Mendocino,45,87422,314,232,0,232,1
2020-07-30,Merced,47,269075,5799,3695,2,3697,30
2020-07-30,Modoc,49,8938,6,0,0,0,0
2020-07-30,Mono,51,14174,148,104,0,104,1
2020-07-30,Monterey,53,433212,5502,4352,10,4362,24
2020-07-30,Napa,55,140530,1159,874,0,874,7
2020-07-30,Nevada,57,99092,339,292,12,304,2
2020-07-30,Orange,59,3164182,43243,36105,814,36919,607
2020-07-30,Placer,61,380077,2270,1821,3,1824,14
2020-07-30,Plumas,63,18699,33,25,0,25,0
2020-07-30,Riverside,65,2383286,44765,37308,19,37327,685
2020-07-30,Sacramento,67,1510023,12746,9704,9,9713,126
2020-07-30,San Benito,69,59416,706,558,0,558,2
2020-07-30,San Bernardino,71,2135413,39794,32010,32,32042,427
2020-07-30,San Diego,73,3302833,32260,28670,0,28670,558
2020-07-30,San Francisco,75,870044,7303,6107,12,6119,59
2020-07-30,San Joaquin,77,732212,14629,11435,11,11446,161
2020-07-30,San Luis Obispo,79,281455,2047,1703,4,1707,12
2020-07-30,San Mateo,81,765935,6485,5369,4,5373,115
2020-07-30,Santa Barbara,83,443738,7119,6273,90,6363,52
2020-07-30,Santa Clara,85,1922200,12543,9708,19,9727,170
2020-07-30,Santa Cruz,87,273765,1307,1087,9,1096,4
2020-07-30,Shasta,89,179085,487,306,3,309,8
2020-07-30,Sierra,91,2930,3,1,0,1,0
2020-07-30,Siskiyou,93,43540,95,60,0,60,0
2020-07-30,Solano,95,438530,4265,3463,24,3487,29
2020-07-30,Sonoma,97,501317,3725,2684,6,2690,25
2020-07-30,Stanislaus,99,539301,11571,8890,43,8933,94
2020-07-30,Sutter,101,95872,874,698,1,699,6
2020-07-30,Tehama,103,63373,278,208,4,212,1
2020-07-30,Trinity,105,12862,9,4,4,8,0
2020-07-30,Tulare,107,460477,11100,9167,25,9192,177
2020-07-30,Tuolumne,109,53932,154,119,26,145,0
2020-07-30,Ventura,111,848112,8681,7304,23,7327,69
2020-07-30,Yolo,113,214977,1852,1511,3,1514,37
2020-07-30,Yuba,115,75493,502,362,0,362,1
2020-07-29,Alameda,1,1643700,13462,11177,48,11225,180
2020-07-29,Alpine,3,1148,3,2,0,2,0
2020-07-29,Amador,5,37829,163,80,0,80,0
2020-07-29,Butte,7,227075,1119,889,7,896,7
2020-07-29,Calaveras,9,45235,137,107,1,108,1
2020-07-29,Colusa,11,21464,369,302,0,302,2
2020-07-29,Contra Costa,13,1133247,10108,7520,24,7544,108
2020-07-29,Del Norte,15,27424,89,68,0,68,0
2020-07-29,El Dorado,17,186661,779,588,0,588,1
2020-07-29,Fresno,19,978130,21065,14312,164,14476,125
2020-07-29,Glenn,21,27897,367,294,0,294,1
2020-07-29,Humboldt,23,135768,259,221,0,221,4
2020-07-29,Imperial,25,180216,10273,7825,6,7831,147
2020-07-29,Inyo,27,18085,63,44,0,44,1
2020-07-29,Kern,29,883053,24361,19073,123,19196,162
2020-07-29,Kings,31,150075,4652,3755,25,3780,43
2020-07-29,Lake,33,64148,227,179,0,179,1
2020-07-29,Lassen,35,31185,618,513,1,514,0
2020-07-29,Los Angeles,37,10098052,199816,183600,542,184142,4523
2020-07-29,Madera,39,155013,2734,1941,1,1942,18
2020-07-29,Marin,41,260295,5337,4747,4,4751,34
2020-07-29,Mariposa,43,17540,60,47,0,47,1
2020-07-29,Mendocino,45,87422,306,228,0,228,0
2020-07-29,Merced,47,269075,5660,3605,2,3607,25
2020-07-29,Modoc,49,8938,5,0,0,0,0
2020-07-29,Mono,51,14174,145,102,0,102,1
2020-07-29,Monterey,53,433212,5403,4252,10,4262,24
2020-07-29,Napa,55,140530,1131,866,0,866,7
2020-07-29,Nevada,57,99092,335,288,12,300,1
2020-07-29,Orange,59,3164182,42810,35339,802,36141,589
2020-07-29,Placer,61,380077,2238,1798,3,1801,14
2020-07-29,Plumas,63,18699,33,25,0,25,0
2020-07-29,Riverside,65,2383286,44174,36968,19,36987,678
2020-07-29,Sacramento,67,1510023,12503,9538,9,9547,122
2020-07-29,San Benito,69,59416,691,537,0,537,2
2020-07-29,San Bernardino,71,2135413,39305,31168,31,31199,417
2020-07-29,San Diego,73,3302833,31935,28289,0,28289,552
2020-07-29,San Francisco,75,870044,7209,6041,12,6053,56
2020-07-29,San Joaquin,77,732212,14381,11249,8,11257,154
2020-07-29,San Luis Obispo,79,281455,2027,1673,4,1677,11
2020-07-29,San Mateo,81,765935,6397,5305,4,5309,114
2020-07-29,Santa Barbara,83,443738,7049,6215,90,6305,31
2020-07-29,Santa Clara,85,1922200,12335,9567,19,9586,165
2020-07-29,Santa Cruz,87,273765,1283,1051,9,1060,4
2020-07-29,Shasta,89,179085,475,297,3,300,8
2020-07-29,Sierra,91,2930,2,1,0,1,0
2020-07-29,Siskiyou,93,43540,93,58,0,58,0
2020-07-29,Solano,95,438530,4211,3380,24,3404,29
2020-07-29,Sonoma,97,501317,3648,2598,6,2604,26
2020-07-29,Stanislaus,99,539301,11351,8745,37,8782,94
2020-07-29,Sutter,101,95872,846,678,1,679,6
2020-07-29,Tehama,103,63373,274,206,4,210,1
2020-07-29,Trinity,105,12862,9,4,4,8,0
2020-07-29,Tulare,107,460477,10929,9028,25,9053,156
2020-07-29,Tuolumne,109,53932,154,118,26,144,0
2020-07-29,Ventura,111,848112,8576,7161,23,7184,68
2020-07-29,Yolo,113,214977,1826,1488,3,1491,36
2020-07-29,Yuba,115,75493,486,350,0,350,1
2020-07-28,Alameda,1,1643700,13238,10875,47,10922,180
2020-07-28,Alpine,3,1148,3,2,0,2,0
2020-07-28,Amador,5,37829,153,77,0,77,0
2020-07-28,Butte,7,227075,1084,857,7,864,7
2020-07-28,Calaveras,9,45235,136,105,1,106,1
2020-07-28,Colusa,11,21464,363,290,0,290,2
2020-07-28,Contra Costa,13,1133247,9886,7426,24,7450,107
2020-07-28,Del Norte,15,27424,88,68,0,68,0
2020-07-28,El Dorado,17,186661,764,558,0,558,1
2020-07-28,Fresno,19,978130,20731,13933,158,14091,125
2020-07-28,Glenn,21,27897,365,289,0,289,1
2020-07-28,Humboldt,23,135768,258,218,0,218,4
2020-07-28,Imperial,25,180216,10237,7804,6,7810,145
2020-07-28,Inyo,27,18085,61,43,0,43,1
2020-07-28,Kern,29,883053,23998,18834,117,18951,155
2020-07-28,Kings,31,150075,4606,3721,25,3746,41
2020-07-28,Lake,33,64148,223,179,0,179,1
2020-07-28,Lassen,35,31185,612,508,1,509,0
2020-07-28,Los Angeles,37,10098052,197582,179107,520,179627,4435
2020-07-28,Madera,39,155013,2668,1889,1,1890,18
2020-07-28,Marin,41,260295,5268,4698,4,4702,23
2020-07-28,Mariposa,43,17540,58,45,0,45,1
2020-07-28,Mendocino,45,87422,295,222,0,222,0
2020-07-28,Merced,47,269075,5515,3446,2,3448,23
2020-07-28,Modoc,49,8938,4,0,0,0,0
2020-07-28,Mono,51,14174,144,102,0,102,1
2020-07-28,Monterey,53,433212,5282,4047,10,4057,22
2020-07-28,Napa,55,140530,1109,824,0,824,6
2020-07-28,Nevada,57,99092,330,278,12,290,1
2020-07-28,Orange,59,3164182,42352,34832,788,35620,582
2020-07-28,Placer,61,380077,2205,1759,3,1762,14
2020-07-28,Plumas,63,18699,33,22,0,22,0
2020-07-28,Riverside,65,2383286,43575,36458,19,36477,668
2020-07-28,Sacramento,67,1510023,12252,9429,9,9438,117
2020-07-28,San Benito,69,59416,681,503,0,503,2
2020-07-28,San Bernardino,71,2135413,38784,30493,31,30524,412
2020-07-28,San Diego,73,3302833,31585,28007,0,28007,547
2020-07-28,San Francisco,75,870044,7096,5888,12,5900,56
2020-07-28,San Joaquin,77,732212,14098,10958,6,10964,141
2020-07-28,San Luis Obispo,79,281455,1996,1636,4,1640,9
2020-07-28,San Mateo,81,765935,6323,5171,4,5175,114
2020-07-28,Santa Barbara,83,443738,6986,6110,88,6198,31
2020-07-28,Santa Clara,85,1922200,12101,9307,19,9326,165
2020-07-28,Santa Cruz,87,273765,1256,1018,9,1027,4
2020-07-28,Shasta,89,179085,463,275,3,278,8
2020-07-28,Sierra,91,2930,2,1,0,1,0
2020-07-28,Siskiyou,93,43540,89,57,0,57,0
2020-07-28,Solano,95,438530,4164,3292,23,3315,29
2020-07-28,Sonoma,97,501317,3575,2553,6,2559,20
2020-07-28,Stanislaus,99,539301,11131,8492,28,8520,92
2020-07-28,Sutter,101,95872,809,653,0,653,2
2020-07-28,Tehama,103,63373,269,199,4,203,1
2020-07-28,Trinity,105,12862,9,3,4,7,0
2020-07-28,Tulare,107,460477,10742,8787,25,8812,96
2020-07-28,Tuolumne,109,53932,153,116,26,142,0
2020-07-28,Ventura,111,848112,8451,7045,21,7066,68
2020-07-28,Yolo,113,214977,1798,1459,3,1462,36
2020-07-28,Yuba,115,75493,469,333,0,333,1
2020-07-27,Alameda,1,1643700,13011,10645,44,10689,176
2020-07-27,Alpine,3,1148,3,2,0,2,0
2020-07-27,Amador,5,37829,148,72,0,72,0
2020-07-27,Butte,7,227075,1057,843,7,850,7
2020-07-27,Calaveras,9,45235,132,103,1,104,1
2020-07-27,Colusa,11,21464,356,271,0,271,2
2020-07-27,Contra Costa,13,1133247,9664,7256,24,7280,104
2020-07-27,Del Norte,15,27424,87,67,0,67,0
2020-07-27,El Dorado,17,186661,752,548,0,548,1
2020-07-27,Fresno,19,978130,20385,13485,152,13637,117
2020-07-27,Glenn,21,27897,363,277,0,277,1
2020-07-27,Humboldt,23,135768,253,218,0,218,4
2020-07-27,Imperial,25,180216,10187,7789,6,7795,144
2020-07-27,Inyo,27,18085,61,43,0,43,1
2020-07-27,Kern,29,883053,23496,17994,111,18105,148
2020-07-27,Kings,31,150075,4357,3685,25,3710,39
2020-07-27,Lake,33,64148,219,176,0,176,1
2020-07-27,Lassen,35,31185,612,503,1,504,0
2020-07-27,Los Angeles,37,10098052,195130,176351,499,176850,4379
2020-07-27,Madera,39,155013,2603,1793,1,1794,17
2020-07-27,Marin,41,260295,5181,4669,4,4673,22
2020-07-27,Mariposa,43,17540,58,43,0,43,1
2020-07-27,Mendocino,45,87422,282,209,0,209,0
2020-07-27,Merced,47,269075,5375,3292,2,3294,23
2020-07-27,Modoc,49,8938,3,0,0,0,0
2020-07-27,Mono,51,14174,140,99,0,99,1
2020-07-27,Monterey,53,433212,5092,3960,10,3970,21
2020-07-27,Napa,55,140530,1094,769,0,769,6
2020-07-27,Nevada,57,99092,326,268,12,280,1
2020-07-27,Orange,59,3164182,41912,34649,772,35421,566
2020-07-27,Placer,61,380077,2155,1679,3,1682,12
2020-07-27,Plumas,63,18699,33,22,0,22,0
2020-07-27,Riverside,65,2383286,42897,35822,19,35841,667
2020-07-27,Sacramento,67,1510023,11957,9091,9,9100,114
2020-07-27,San Benito,69,59416,666,498,0,498,2
2020-07-27,San Bernardino,71,2135413,38193,29928,31,29959,401
2020-07-27,San Diego,73,3302833,31211,27509,0,27509,533
2020-07-27,San Francisco,75,870044,7009,5825,12,5837,55
2020-07-27,San Joaquin,77,732212,13807,10728,6,10734,129
2020-07-27,San Luis Obispo,79,281455,1951,1612,4,1616,9
2020-07-27,San Mateo,81,765935,6214,5108,4,5112,113
2020-07-27,Santa Barbara,83,443738,6905,6026,85,6111,30
2020-07-27,Santa Clara,85,1922200,11834,9157,18,9175,166
2020-07-27,Santa Cruz,87,273765,1234,984,9,993,4
2020-07-27,Shasta,89,179085,456,275,3,278,8
2020-07-27,Sierra,91,2930,2,1,0,1,0
2020-07-27,Siskiyou,93,43540,87,54,0,54,0
2020-07-27,Solano,95,438530,4097,3198,22,3220,29
2020-07-27,Sonoma,97,501317,3484,2504,6,2510,20
2020-07-27,Stanislaus,99,539301,10903,8288,20,8308,84
2020-07-27,Sutter,101,95872,783,620,0,620,2
2020-07-27,Tehama,103,63373,261,192,4,196,1
2020-07-27,Trinity,105,12862,9,3,4,7,0
2020-07-27,Tulare,107,460477,10524,8462,25,8487,172
2020-07-27,Tuolumne,109,53932,150,115,26,141,0
2020-07-27,Ventura,111,848112,8323,6998,21,7019,68
2020-07-27,Yolo,113,214977,1753,1439,3,1442,33
2020-07-27,Yuba,115,75493,449,328,0,328,1
2020-07-26,Alameda,1,1643700,12773,10489,44,10533,176
2020-07-26,Alpine,3,1148,3,2,0,2,0
2020-07-26,Amador,5,37829,142,67,0,67,0
2020-07-26,Butte,7,227075,1020,822,7,829,5
2020-07-26,Calaveras,9,45235,129,103,1,104,1
2020-07-26,Colusa,11,21464,347,270,0,270,2
2020-07-26,Contra Costa,13,1133247,9427,7095,24,7119,104
2020-07-26,Del Norte,15,27424,85,67,0,67,0
2020-07-26,El Dorado,17,186661,734,539,0,539,1
2020-07-26,Fresno,19,978130,19995,13209,144,13353,117
2020-07-26,Glenn,21,27897,355,265,0,265,1
2020-07-26,Humboldt,23,135768,247,214,0,214,4
2020-07-26,Imperial,25,180216,10114,7781,6,7787,144
2020-07-26,Inyo,27,18085,56,43,0,43,1
2020-07-26,Kern,29,883053,22972,17394,108,17502,148
2020-07-26,Kings,31,150075,4298,3591,25,3616,39
2020-07-26,Lake,33,64148,211,174,0,174,1
2020-07-26,Lassen,35,31185,571,503,1,504,0
2020-07-26,Los Angeles,37,10098052,192556,174322,479,174801,4364
2020-07-26,Madera,39,155013,2516,1744,1,1745,17
2020-07-26,Marin,41,260295,5135,4595,4,4599,22
2020-07-26,Mariposa,43,17540,56,43,0,43,1
2020-07-26,Mendocino,45,87422,273,206,0,206,0
2020-07-26,Merced,47,269075,5195,3251,2,3253,23
2020-07-26,Modoc,49,8938,3,0,0,0,0
2020-07-26,Mono,51,14174,136,82,0,82,1
2020-07-26,Monterey,53,433212,4926,3901,10,3911,21
2020-07-26,Napa,55,140530,1075,769,0,769,6
2020-07-26,Nevada,57,99092,323,261,12,273,1
2020-07-26,Orange,59,3164182,41387,34352,740,35092,564
2020-07-26,Placer,61,380077,2087,1628,3,1631,12
2020-07-26,Plumas,63,18699,33,22,0,22,0
2020-07-26,Riverside,65,2383286,42338,35636,19,35655,665
2020-07-26,Sacramento,67,1510023,11654,8972,9,8981,114
2020-07-26,San Benito,69,59416,654,495,0,495,2
2020-07-26,San Bernardino,71,2135413,37556,29545,29,29574,400
2020-07-26,San Diego,73,3302833,30816,26986,0,26986,533
2020-07-26,San Francisco,75,870044,6901,5823,11,5834,55
2020-07-26,San Joaquin,77,732212,13515,10637,6,10643,129
2020-07-26,San Luis Obispo,79,281455,1908,1565,4,1569,8
2020-07-26,San Mateo,81,765935,6108,5078,4,5082,113
2020-07-26,Santa Barbara,83,443738,6803,5939,85,6024,30
2020-07-26,Santa Clara,85,1922200,11604,8986,18,9004,166
2020-07-26,Santa Cruz,87,273765,1207,970,9,979,4
2020-07-26,Shasta,89,179085,448,265,3,268,8
2020-07-26,Sierra,91,2930,2,1,0,1,0
2020-07-26,Siskiyou,93,43540,85,54,0,54,0
2020-07-26,Solano,95,438530,4017,3197,20,3217,29
2020-07-26,Sonoma,97,501317,3395,2503,5,2508,20
2020-07-26,Stanislaus,99,539301,10644,8228,18,8246,84
2020-07-26,Sutter,101,95872,769,612,0,612,2
2020-07-26,Tehama,103,63373,254,175,4,179,1
2020-07-26,Trinity,105,12862,9,3,4,7,0
2020-07-26,Tulare,107,460477,10317,8392,25,8417,172
2020-07-26,Tuolumne,109,53932,145,113,25,138,0
2020-07-26,Ventura,111,848112,8117,6844,21,6865,67
2020-07-26,Yolo,113,214977,1722,1408,3,1411,33
2020-07-26,Yuba,115,75493,430,313,0,313,1
2020-07-25,Alameda,1,1643700,12676,10361,42,10403,176
2020-07-25,Alpine,3,1148,3,2,0,2,0
2020-07-25,Amador,5,37829,139,67,0,67,0
2020-07-25,Butte,7,227075,1011,810,7,817,5
2020-07-25,Calaveras,9,45235,125,103,1,104,1
2020-07-25,Colusa,11,21464,340,265,0,265,2
2020-07-25,Contra Costa,13,1133247,9282,6920,24,6944,104
2020-07-25,Del Norte,15,27424,85,67,0,67,0
2020-07-25,El Dorado,17,186661,723,528,0,528,1
2020-07-25,Fresno,19,978130,19809,12866,144,13010,117
2020-07-25,Glenn,21,27897,353,260,0,260,1
2020-07-25,Humboldt,23,135768,244,212,0,212,4
2020-07-25,Imperial,25,180216,10088,7727,6,7733,144
2020-07-25,Inyo,27,18085,55,43,0,43,1
2020-07-25,Kern,29,883053,22754,16910,107,17017,148
2020-07-25,Kings,31,150075,4281,3516,25,3541,39
2020-07-25,Lake,33,64148,209,173,0,173,1
2020-07-25,Lassen,35,31185,571,503,1,504,0
2020-07-25,Los Angeles,37,10098052,191428,172611,471,173082,4357
2020-07-25,Madera,39,155013,2484,1724,1,1725,17
2020-07-25,Marin,41,260295,5119,4562,4,4566,22
2020-07-25,Mariposa,43,17540,55,43,0,43,1
2020-07-25,Mendocino,45,87422,267,190,0,190,0
2020-07-25,Merced,47,269075,5116,3176,2,3178,23
2020-07-25,Modoc,49,8938,3,0,0,0,0
2020-07-25,Mono,51,14174,136,82,0,82,1
2020-07-25,Monterey,53,433212,4849,3805,10,3815,21
2020-07-25,Napa,55,140530,1062,746,0,746,6
2020-07-25,Nevada,57,99092,321,257,12,269,1
2020-07-25,Orange,59,3164182,41167,33978,718,34696,561
2020-07-25,Placer,61,380077,2070,1596,3,1599,12
2020-07-25,Plumas,63,18699,33,22,0,22,0
2020-07-25,Riverside,65,2383286,42069,34921,19,34940,655
2020-07-25,Sacramento,67,1510023,11506,8674,9,8683,113
2020-07-25,San Benito,69,59416,638,492,0,492,2
2020-07-25,San Bernardino,71,2135413,37277,29265,29,29294,394
2020-07-25,San Diego,73,3302833,30555,26703,0,26703,533
2020-07-25,San Francisco,75,870044,6843,5644,11,5655,55
2020-07-25,San Joaquin,77,732212,13389,10347,6,10353,129
2020-07-25,San Luis Obispo,79,281455,1887,1530,3,1533,8
2020-07-25,San Mateo,81,765935,6045,5023,4,5027,113
2020-07-25,Santa Barbara,83,443738,6768,5880,85,5965,30
2020-07-25,Santa Clara,85,1922200,11470,8767,18,8785,166
2020-07-25,Santa Cruz,87,273765,1190,939,9,948,4
2020-07-25,Shasta,89,179085,443,263,1,264,8
2020-07-25,Sierra,91,2930,2,1,0,1,0
2020-07-25,Siskiyou,93,43540,83,54,0,54,0
2020-07-25,Solano,95,438530,3977,3107,18,3125,29
2020-07-25,Sonoma,97,501317,3356,2412,5,2417,20
2020-07-25,Stanislaus,99,539301,10541,7994,15,8009,84
2020-07-25,Sutter,101,95872,750,603,0,603,2
2020-07-25,Tehama,103,63373,253,169,4,173,1
2020-07-25,Trinity,105,12862,9,3,4,7,0
2020-07-25,Tulare,107,460477,10217,8310,25,8335,172
2020-07-25,Tuolumne,109,53932,144,99,25,124,0
2020-07-25,Ventura,111,848112,8044,6662,21,6683,62
2020-07-25,Yolo,113,214977,1707,1357,3,1360,35
2020-07-25,Yuba,115,75493,424,312,0,312,1
2020-07-24,Alameda,1,1643700,12534,10216,39,10255,176
2020-07-24,Alpine,3,1148,3,2,0,2,0
2020-07-24,Amador,5,37829,137,66,0,66,0
2020-07-24,Butte,7,227075,999,751,7,758,5
2020-07-24,Calaveras,9,45235,121,102,1,103,0
2020-07-24,Colusa,11,21464,337,255,0,255,2
2020-07-24,Contra Costa,13,1133247,9136,6814,24,6838,100
2020-07-24,Del Norte,15,27424,85,66,0,66,0
2020-07-24,El Dorado,17,186661,701,516,0,516,1
2020-07-24,Fresno,19,978130,19583,12564,144,12708,115
2020-07-24,Glenn,21,27897,350,251,0,251,1
2020-07-24,Humboldt,23,135768,241,210,0,210,4
2020-07-24,Imperial,25,180216,10066,7686,6,7692,141
2020-07-24,Inyo,27,18085,55,41,0,41,1
2020-07-24,Kern,29,883053,22513,16124,107,16231,143
2020-07-24,Kings,31,150075,4253,3471,25,3496,39
2020-07-24,Lake,33,64148,207,167,0,167,1
2020-07-24,Lassen,35,31185,571,503,1,504,0
2020-07-24,Los Angeles,37,10098052,189409,169078,458,169536,4302
2020-07-24,Madera,39,155013,2451,1679,1,1680,16
2020-07-24,Marin,41,260295,5092,4517,4,4521,22
2020-07-24,Mariposa,43,17540,55,41,0,41,1
2020-07-24,Mendocino,45,87422,260,188,0,188,0
2020-07-24,Merced,47,269075,5032,3100,2,3102,23
2020-07-24,Modoc,49,8938,3,0,0,0,0
2020-07-24,Mono,51,14174,135,82,0,82,1
2020-07-24,Monterey,53,433212,4776,3748,10,3758,21
2020-07-24,Napa,55,140530,1049,741,0,741,6
2020-07-24,Nevada,57,99092,318,255,12,267,1
2020-07-24,Orange,59,3164182,40880,33530,701,34231,557
2020-07-24,Placer,61,380077,2040,1551,3,1554,12
2020-07-24,Plumas,63,18699,33,22,0,22,0
2020-07-24,Riverside,65,2383286,41645,34513,18,34531,631
2020-07-24,Sacramento,67,1510023,11321,8570,9,8579,110
2020-07-24,San Benito,69,59416,631,485,0,485,2
2020-07-24,San Bernardino,71,2135413,36905,28990,29,29019,386
2020-07-24,San Diego,73,3302833,30255,26100,0,26100,524
2020-07-24,San Francisco,75,870044,6749,5611,11,5622,55
2020-07-24,San Joaquin,77,732212,13241,10190,6,10196,118
2020-07-24,San Luis Obispo,79,281455,1863,1476,3,1479,8
2020-07-24,San Mateo,81,765935,5982,4954,4,4958,112
2020-07-24,Santa Barbara,83,443738,6714,5776,83,5859,30
2020-07-24,Santa Clara,85,1922200,11306,8658,18,8676,165
2020-07-24,Santa Cruz,87,273765,1170,930,9,939,4
2020-07-24,Shasta,89,179085,435,262,1,263,8
2020-07-24,Sierra,91,2930,2,1,0,1,0
2020-07-24,Siskiyou,93,43540,83,53,0,53,0
2020-07-24,Solano,95,438530,3941,3062,15,3077,29
2020-07-24,Sonoma,97,501317,3303,2345,5,2350,20
2020-07-24,Stanislaus,99,539301,10371,7861,12,7873,82
2020-07-24,Sutter,101,95872,739,593,0,593,2
2020-07-24,Tehama,103,63373,245,170,4,174,1
2020-07-24,Trinity,105,12862,8,3,4,7,0
2020-07-24,Tulare,107,460477,10123,8167,23,8190,167
2020-07-24,Tuolumne,109,53932,138,99,25,124,0
2020-07-24,Ventura,111,848112,7959,6553,21,6574,60
2020-07-24,Yolo,113,214977,1693,1329,3,1332,35
2020-07-24,Yuba,115,75493,409,307,0,307,1
2020-07-23,Alameda,1,1643700,12295,9924,39,9963,171
2020-07-23,Alpine,3,1148,3,2,0,2,0
2020-07-23,Amador,5,37829,120,61,0,61,0
2020-07-23,Butte,7,227075,984,726,7,733,5
2020-07-23,Calaveras,9,45235,114,102,1,103,0
2020-07-23,Colusa,11,21464,329,242,0,242,2
2020-07-23,Contra Costa,13,1133247,8935,6619,22,6641,98
2020-07-23,Del Norte,15,27424,85,66,0,66,0
2020-07-23,El Dorado,17,186661,690,491,0,491,1
2020-07-23,Fresno,19,978130,19227,12164,141,12305,112
2020-07-23,Glenn,21,27897,345,246,0,246,1
2020-07-23,Humboldt,23,135768,240,208,0,208,4
2020-07-23,Imperial,25,180216,10016,7604,6,7610,138
2020-07-23,Inyo,27,18085,53,38,0,38,1
2020-07-23,Kern,29,883053,22107,14491,103,14594,128
2020-07-23,Kings,31,150075,4145,3371,25,3396,39
2020-07-23,Lake,33,64148,198,160,0,160,1
2020-07-23,Lassen,35,31185,568,503,1,504,0
2020-07-23,Los Angeles,37,10098052,186863,167198,432,167630,4265
2020-07-23,Madera,39,155013,2384,1659,1,1660,13
2020-07-23,Marin,41,260295,5040,4423,4,4427,22
2020-07-23,Mariposa,43,17540,55,40,0,40,1
2020-07-23,Mendocino,45,87422,250,178,0,178,0
2020-07-23,Merced,47,269075,4876,2972,2,2974,22
2020-07-23,Modoc,49,8938,3,0,0,0,0
2020-07-23,Mono,51,14174,131,82,0,82,1
2020-07-23,Monterey,53,433212,4659,3655,10,3665,21
2020-07-23,Napa,55,140530,1025,713,0,713,5
2020-07-23,Nevada,57,99092,315,247,12,259,1
2020-07-23,Orange,59,3164182,40384,32863,670,33533,544
2020-07-23,Placer,61,380077,1997,1519,3,1522,12
2020-07-23,Plumas,63,18699,32,21,0,21,0
2020-07-23,Riverside,65,2383286,41040,33833,18,33851,630
2020-07-23,Sacramento,67,1510023,11091,8222,9,8231,108
2020-07-23,San Benito,69,59416,616,478,0,478,2
2020-07-23,San Bernardino,71,2135413,36385,28121,28,28149,369
2020-07-23,San Diego,73,3302833,29881,25109,0,25109,505
2020-07-23,San Francisco,75,870044,6648,5543,11,5554,55
2020-07-23,San Joaquin,77,732212,13022,9861,6,9867,111
2020-07-23,San Luis Obispo,79,281455,1837,1438,3,1441,7
2020-07-23,San Mateo,81,765935,5877,4895,4,4899,113
2020-07-23,Santa Barbara,83,443738,6640,5628,83,5711,30
2020-07-23,Santa Clara,85,1922200,11089,8458,18,8476,165
2020-07-23,Santa Cruz,87,273765,1134,887,9,896,3
2020-07-23,Shasta,89,179085,424,254,1,255,9
2020-07-23,Sierra,91,2930,2,1,0,1,0
2020-07-23,Siskiyou,93,43540,81,53,0,53,0
2020-07-23,Solano,95,438530,3877,2962,13,2975,29
2020-07-23,Sonoma,97,501317,3227,2289,5,2294,18
2020-07-23,Stanislaus,99,539301,10130,7603,12,7615,71
2020-07-23,Sutter,101,95872,706,570,0,570,2
2020-07-23,Tehama,103,63373,239,158,4,162,1
2020-07-23,Trinity,105,12862,7,3,4,7,0
2020-07-23,Tulare,107,460477,9934,7898,23,7921,168
2020-07-23,Tuolumne,109,53932,138,93,24,117,0
2020-07-23,Ventura,111,848112,7835,6303,21,6324,56
2020-07-23,Yolo,113,214977,1675,1279,3,1282,35
2020-07-23,Yuba,115,75493,389,297,0,297,1
2020-07-22,Alameda,1,1643700,12075,9678,38,9716,169
2020-07-22,Alpine,3,1148,3,2,0,2,0
2020-07-22,Amador,5,37829,118,58,0,58,0
2020-07-22,Butte,7,227075,949,694,6,700,5
2020-07-22,Calaveras,9,45235,114,98,1,99,0
2020-07-22,Colusa,11,21464,322,236,0,236,0
2020-07-22,Contra Costa,13,1133247,8709,6401,22,6423,98
2020-07-22,Del Norte,15,27424,85,66,0,66,0
2020-07-22,El Dorado,17,186661,677,466,0,466,1
2020-07-22,Fresno,19,978130,18867,11756,135,11891,110
2020-07-22,Glenn,21,27897,339,236,0,236,1
2020-07-22,Humboldt,23,135768,238,201,0,201,4
2020-07-22,Imperial,25,180216,9957,7533,6,7539,134
2020-07-22,Inyo,27,18085,49,38,0,38,1
2020-07-22,Kern,29,883053,21675,13513,96,13609,127
2020-07-22,Kings,31,150075,4092,3271,25,3296,38
2020-07-22,Lake,33,64148,195,160,0,160,1
2020-07-22,Lassen,35,31185,565,500,1,501,0
2020-07-22,Los Angeles,37,10098052,184200,165242,408,165650,4218
2020-07-22,Madera,39,155013,2309,1578,1,1579,10
2020-07-22,Marin,41,260295,4984,4373,4,4377,23
2020-07-22,Mariposa,43,17540,55,38,0,38,1
2020-07-22,Mendocino,45,87422,243,166,0,166,0
2020-07-22,Merced,47,269075,4749,2828,2,2830,15
2020-07-22,Modoc,49,8938,3,0,0,0,0
2020-07-22,Mono,51,14174,128,82,0,82,1
2020-07-22,Monterey,53,433212,4558,3533,10,3543,20
2020-07-22,Napa,55,140530,1003,687,0,687,5
2020-07-22,Nevada,57,99092,309,239,11,250,1
2020-07-22,Orange,59,3164182,39884,32047,661,32708,522
2020-07-22,Placer,61,380077,1940,1469,3,1472,12
2020-07-22,Plumas,63,18699,31,20,0,20,0
2020-07-22,Riverside,65,2383286,40406,33093,18,33111,612
2020-07-22,Sacramento,67,1510023,10826,8028,8,8036,106
2020-07-22,San Benito,69,59416,602,465,0,465,2
2020-07-22,San Bernardino,71,2135413,35865,26820,28,26848,348
2020-07-22,San Diego,73,3302833,29493,25109,0,25109,505
2020-07-22,San Francisco,75,870044,6544,5473,10,5483,53
2020-07-22,San Joaquin,77,732212,12746,9628,6,9634,102
2020-07-22,San Luis Obispo,79,281455,1794,1373,3,1376,7
2020-07-22,San Mateo,81,765935,5788,4796,4,4800,112
2020-07-22,Santa Barbara,83,443738,6555,5508,81,5589,29
2020-07-22,Santa Clara,85,1922200,10844,8266,18,8284,166
2020-07-22,Santa Cruz,87,273765,1111,866,9,875,3
2020-07-22,Shasta,89,179085,414,246,1,247,9
2020-07-22,Sierra,91,2930,1,1,0,1,0
2020-07-22,Siskiyou,93,43540,80,52,0,52,0
2020-07-22,Solano,95,438530,3816,2839,12,2851,29
2020-07-22,Sonoma,97,501317,3150,2255,5,2260,17
2020-07-22,Stanislaus,99,539301,9959,7401,12,7413,71
2020-07-22,Sutter,101,95872,682,551,0,551,2
2020-07-22,Tehama,103,63373,231,155,4,159,1
2020-07-22,Trinity,105,12862,7,3,4,7,0
2020-07-22,Tulare,107,460477,9701,7640,23,7663,167
2020-07-22,Tuolumne,109,53932,134,91,24,115,0
2020-07-22,Ventura,111,848112,7708,6223,19,6242,56
2020-07-22,Yolo,113,214977,1632,1233,3,1236,34
2020-07-22,Yuba,115,75493,374,288,0,288,1
2020-07-21,Alameda,1,1643700,11861,9390,38,9428,166
2020-07-21,Alpine,3,1148,3,2,0,2,0
2020-07-21,Amador,5,37829,113,55,0,55,0
2020-07-21,Butte,7,227075,905,659,5,664,5
2020-07-21,Calaveras,9,45235,109,96,1,97,0
2020-07-21,Colusa,11,21464,298,227,0,227,0
2020-07-21,Contra Costa,13,1133247,8467,6210,22,6232,98
2020-07-21,Del Norte,15,27424,85,66,0,66,0
2020-07-21,El Dorado,17,186661,669,440,0,440,1
2020-07-21,Fresno,19,978130,18469,11412,129,11541,107
2020-07-21,Glenn,21,27897,332,229,0,229,1
2020-07-21,Humboldt,23,135768,236,198,0,198,4
2020-07-21,Imperial,25,180216,9908,7458,6,7464,128
2020-07-21,Inyo,27,18085,48,38,0,38,1
2020-07-21,Kern,29,883053,21253,11998,90,12088,119
2020-07-21,Kings,31,150075,4029,3187,25,3212,38
2020-07-21,Lake,33,64148,195,157,0,157,1
2020-07-21,Lassen,35,31185,563,474,1,475,0
2020-07-21,Los Angeles,37,10098052,181193,162205,386,162591,4159
2020-07-21,Madera,39,155013,2244,1508,1,1509,10
2020-07-21,Marin,41,260295,4913,4318,4,4322,21
2020-07-21,Mariposa,43,17540,54,37,0,37,1
2020-07-21,Mendocino,45,87422,232,160,0,160,0
2020-07-21,Merced,47,269075,4570,2725,2,2727,15
2020-07-21,Modoc,49,8938,3,0,0,0,0
2020-07-21,Mono,51,14174,124,79,0,79,1
2020-07-21,Monterey,53,433212,4426,3404,9,3413,20
2020-07-21,Napa,55,140530,976,660,0,660,5
2020-07-21,Nevada,57,99092,307,228,9,237,1
2020-07-21,Orange,59,3164182,39388,31356,627,31983,515
2020-07-21,Placer,61,380077,1900,1413,3,1416,11
2020-07-21,Plumas,63,18699,31,19,0,19,0
2020-07-21,Riverside,65,2383286,39705,32231,18,32249,583
2020-07-21,Sacramento,67,1510023,10554,7789,7,7796,102
2020-07-21,San Benito,69,59416,591,444,0,444,2
2020-07-21,San Bernardino,71,2135413,35219,25323,27,25350,343
2020-07-21,San Diego,73,3302833,29044,24522,0,24522,487
2020-07-21,San Francisco,75,870044,6435,5377,10,5387,53
2020-07-21,San Joaquin,77,732212,12420,9150,6,9156,99
2020-07-21,San Luis Obispo,79,281455,1746,1338,3,1341,7
2020-07-21,San Mateo,81,765935,5696,4733,4,4737,111
2020-07-21,Santa Barbara,83,443738,6473,5422,80,5502,29
2020-07-21,Santa Clara,85,1922200,10581,7989,18,8007,164
2020-07-21,Santa Cruz,87,273765,1078,835,9,844,3
2020-07-21,Shasta,89,179085,406,241,1,242,9
2020-07-21,Sierra,91,2930,1,1,0,1,0
2020-07-21,Siskiyou,93,43540,80,48,0,48,0
2020-07-21,Solano,95,438530,3743,2727,12,2739,27
2020-07-21,Sonoma,97,501317,3093,2200,5,2205,17
2020-07-21,Stanislaus,99,539301,9695,6984,12,6996,69
2020-07-21,Sutter,101,95872,666,533,0,533,2
2020-07-21,Tehama,103,63373,221,150,4,154,1
2020-07-21,Trinity,105,12862,7,2,4,6,0
2020-07-21,Tulare,107,460477,9498,7447,23,7470,167
2020-07-21,Tuolumne,109,53932,132,75,24,99,0
2020-07-21,Ventura,111,848112,7576,6131,19,6150,55
2020-07-21,Yolo,113,214977,1579,1204,3,1207,34
2020-07-21,Yuba,115,75493,368,269,0,269,1
2020-07-20,Alameda,1,1643700,11608,9244,37,9281,162
2020-07-20,Alpine,3,1148,3,2,0,2,0
2020-07-20,Amador,5,37829,110,53,0,53,0
2020-07-20,Butte,7,227075,867,586,5,591,4
2020-07-20,Calaveras,9,45235,106,90,0,90,0
2020-07-20,Colusa,11,21464,287,217,0,217,0
2020-07-20,Contra Costa,13,1133247,8259,5823,22,5845,97
2020-07-20,Del Norte,15,27424,85,61,0,61,0
2020-07-20,El Dorado,17,186661,646,407,0,407,0
2020-07-20,Fresno,19,978130,18027,10891,128,11019,106
2020-07-20,Glenn,21,27897,324,225,0,225,1
2020-07-20,Humboldt,23,135768,229,194,0,194,4
2020-07-20,Imperial,25,180216,9868,7337,6,7343,124
2020-07-20,Inyo,27,18085,46,38,0,38,1
2020-07-20,Kern,29,883053,20743,10908,86,10994,118
2020-07-20,Kings,31,150075,3981,3093,25,3118,37
2020-07-20,Lake,33,64148,192,147,0,147,1
2020-07-20,Lassen,35,31185,561,474,1,475,0
2020-07-20,Los Angeles,37,10098052,178223,159202,358,159560,4108
2020-07-20,Madera,39,155013,2169,1433,1,1434,10
2020-07-20,Marin,41,260295,4833,4255,4,4259,21
2020-07-20,Mariposa,43,17540,53,36,0,36,1
2020-07-20,Mendocino,45,87422,219,153,0,153,0
2020-07-20,Merced,47,269075,4400,2584,2,2586,15
2020-07-20,Modoc,49,8938,3,0,0,0,0
2020-07-20,Mono,51,14174,118,78,0,78,1
2020-07-20,Monterey,53,433212,4320,3205,9,3214,19
2020-07-20,Napa,55,140530,939,632,0,632,5
2020-07-20,Nevada,57,99092,299,218,9,227,1
2020-07-20,Orange,59,3164182,38781,30337,596,30933,507
2020-07-20,Placer,61,380077,1852,1364,3,1367,11
2020-07-20,Plumas,63,18699,30,17,0,17,0
2020-07-20,Riverside,65,2383286,38877,31163,18,31181,581
2020-07-20,Sacramento,67,1510023,10226,7369,7,7376,99
2020-07-20,San Benito,69,59416,573,433,0,433,2
2020-07-20,San Bernardino,71,2135413,34409,24226,26,24252,338
2020-07-20,San Diego,73,3302833,28602,24137,0,24137,478
2020-07-20,San Francisco,75,870044,6314,5090,10,5100,53
2020-07-20,San Joaquin,77,732212,12063,8583,6,8589,97
2020-07-20,San Luis Obispo,79,281455,1706,1282,3,1285,6
2020-07-20,San Mateo,81,765935,5595,4609,4,4613,111
2020-07-20,Santa Barbara,83,443738,6355,5266,78,5344,29
2020-07-20,Santa Clara,85,1922200,10353,7711,17,7728,164
2020-07-20,Santa Cruz,87,273765,1046,758,9,767,3
2020-07-20,Shasta,89,179085,391,233,1,234,9
2020-07-20,Sierra,91,2930,1,1,0,1,0
2020-07-20,Siskiyou,93,43540,76,42,0,42,0
2020-07-20,Solano,95,438530,3660,2537,12,2549,26
2020-07-20,Sonoma,97,501317,2986,2148,5,2153,17
2020-07-20,Stanislaus,99,539301,9417,6835,12,6847,58
2020-07-20,Sutter,101,95872,633,507,0,507,2
2020-07-20,Tehama,103,63373,211,146,4,150,1
2020-07-20,Trinity,105,12862,7,2,4,6,0
2020-07-20,Tulare,107,460477,9264,6974,23,6997,166
2020-07-20,Tuolumne,109,53932,131,75,24,99,0
2020-07-20,Ventura,111,848112,7443,5912,19,5931,52
2020-07-20,Yolo,113,214977,1539,1155,3,1158,30
2020-07-20,Yuba,115,75493,348,258,0,258,1
2020-07-19,Alameda,1,1643700,11371,9227,31,9258,162
2020-07-19,Alpine,3,1148,3,2,0,2,0
2020-07-19,Amador,5,37829,103,51,0,51,0
2020-07-19,Butte,7,227075,842,555,5,560,4
2020-07-19,Calaveras,9,45235,104,89,0,89,0
2020-07-19,Colusa,11,21464,279,187,0,187,0
2020-07-19,Contra Costa,13,1133247,7968,5691,20,5711,95
2020-07-19,Del Norte,15,27424,84,61,0,61,0
2020-07-19,El Dorado,17,186661,628,385,0,385,0
2020-07-19,Fresno,19,978130,17505,10639,116,10755,106
2020-07-19,Glenn,21,27897,310,215,0,215,0
2020-07-19,Humboldt,23,135768,221,195,0,195,4
2020-07-19,Imperial,25,180216,9777,7280,6,7286,124
2020-07-19,Inyo,27,18085,42,38,0,38,1
2020-07-19,Kern,29,883053,20126,10094,79,10173,115
2020-07-19,Kings,31,150075,3897,3035,25,3060,37
2020-07-19,Lake,33,64148,187,144,0,144,1
2020-07-19,Lassen,35,31185,542,474,1,475,0
2020-07-19,Los Angeles,37,10098052,174782,156039,335,156374,4100
2020-07-19,Madera,39,155013,2092,1301,1,1302,10
2020-07-19,Marin,41,260295,4778,4172,4,4176,21
2020-07-19,Mariposa,43,17540,49,35,0,35,1
2020-07-19,Mendocino,45,87422,214,137,0,137,0
2020-07-19,Merced,47,269075,4193,2460,2,2462,15
2020-07-19,Modoc,49,8938,3,0,0,0,0
2020-07-19,Mono,51,14174,107,63,0,63,1
2020-07-19,Monterey,53,433212,4200,3079,9,3088,18
2020-07-19,Napa,55,140530,910,612,0,612,5
2020-07-19,Nevada,57,99092,293,210,9,219,1
2020-07-19,Orange,59,3164182,38218,29941,583,30524,505
2020-07-19,Placer,61,380077,1803,1246,3,1249,11
2020-07-19,Plumas,63,18699,30,17,0,17,0
2020-07-19,Riverside,65,2383286,38174,30340,18,30358,581
2020-07-19,Sacramento,67,1510023,9840,6985,7,6992,97
2020-07-19,San Benito,69,59416,557,412,0,412,2
2020-07-19,San Bernardino,71,2135413,33639,23928,25,23953,337
2020-07-19,San Diego,73,3302833,28102,23684,0,23684,478
2020-07-19,San Francisco,75,870044,6167,5094,10,5104,52
2020-07-19,San Joaquin,77,732212,11658,8308,6,8314,93
2020-07-19,San Luis Obispo,79,281455,1663,1262,3,1265,6
2020-07-19,San Mateo,81,765935,5488,4522,4,4526,110
2020-07-19,Santa Barbara,83,443738,6251,5145,75,5220,29
2020-07-19,Santa Clara,85,1922200,10109,7403,17,7420,164
2020-07-19,Santa Cruz,87,273765,1002,753,9,762,3
2020-07-19,Shasta,89,179085,378,218,1,219,9
2020-07-19,Sierra,91,2930,1,1,0,1,0
2020-07-19,Siskiyou,93,43540,74,42,0,42,0
2020-07-19,Solano,95,438530,3556,2551,12,2563,26
2020-07-19,Sonoma,97,501317,2885,2074,5,2079,17
2020-07-19,Stanislaus,99,539301,9121,6508,12,6520,58
2020-07-19,Sutter,101,95872,602,480,0,480,2
2020-07-19,Tehama,103,63373,207,138,4,142,1
2020-07-19,Trinity,105,12862,7,2,4,6,0
2020-07-19,Tulare,107,460477,9015,6856,23,6879,166
2020-07-19,Tuolumne,109,53932,126,75,24,99,0
2020-07-19,Ventura,111,848112,7253,5706,19,5725,52
2020-07-19,Yolo,113,214977,1499,1127,3,1130,30
2020-07-19,Yuba,115,75493,328,240,0,240,1
2020-07-18,Alameda,1,1643700,11235,9089,29,9118,162
2020-07-18,Alpine,3,1148,3,2,0,2,0
2020-07-18,Amador,5,37829,99,49,0,49,0
2020-07-18,Butte,7,227075,833,551,5,556,4
2020-07-18,Calaveras,9,45235,100,89,0,89,0
2020-07-18,Colusa,11,21464,274,182,0,182,0
2020-07-18,Contra Costa,13,1133247,7832,5617,20,5637,95
2020-07-18,Del Norte,15,27424,84,61,0,61,0
2020-07-18,El Dorado,17,186661,625,385,0,385,0
2020-07-18,Fresno,19,978130,17256,10381,114,10495,106
2020-07-18,Glenn,21,27897,304,212,0,212,0
2020-07-18,Humboldt,23,135768,218,189,0,189,4
2020-07-18,Imperial,25,180216,9746,7268,6,7274,124
2020-07-18,Inyo,27,18085,42,38,0,38,1
2020-07-18,Kern,29,883053,19823,9250,76,9326,114
2020-07-18,Kings,31,150075,3860,2996,24,3020,37
2020-07-18,Lake,33,64148,184,142,0,142,1
2020-07-18,Lassen,35,31185,541,474,1,475,0
2020-07-18,Los Angeles,37,10098052,173336,153265,320,153585,4088
2020-07-18,Madera,39,155013,2046,1260,1,1261,9
2020-07-18,Marin,41,260295,4749,4089,4,4093,21
2020-07-18,Mariposa,43,17540,49,35,0,35,1
2020-07-18,Mendocino,45,87422,207,137,0,137,0
2020-07-18,Merced,47,269075,4074,2424,2,2426,15
2020-07-18,Modoc,49,8938,3,0,0,0,0
2020-07-18,Mono,51,14174,105,54,0,54,1
2020-07-18,Monterey,53,433212,4133,3020,9,3029,17
2020-07-18,Napa,55,140530,899,609,0,609,5
2020-07-18,Nevada,57,99092,289,204,8,212,1
2020-07-18,Orange,59,3164182,37899,29603,561,30164,493
2020-07-18,Placer,61,380077,1779,1233,3,1236,11
2020-07-18,Plumas,63,18699,30,17,0,17,0
2020-07-18,Riverside,65,2383286,37822,30245,17,30262,581
2020-07-18,Sacramento,67,1510023,9597,6739,7,6746,95
2020-07-18,San Benito,69,59416,542,407,0,407,2
2020-07-18,San Bernardino,71,2135413,33179,23680,25,23705,336
2020-07-18,San Diego,73,3302833,27799,23116,0,23116,478
2020-07-18,San Francisco,75,870044,6065,5051,10,5061,52
2020-07-18,San Joaquin,77,732212,11446,8118,6,8124,93
2020-07-18,San Luis Obispo,79,281455,1631,1234,3,1237,6
2020-07-18,San Mateo,81,765935,5428,4488,4,4492,110
2020-07-18,Santa Barbara,83,443738,6191,5110,73,5183,29
2020-07-18,Santa Clara,85,1922200,9959,7255,16,7271,164
2020-07-18,Santa Cruz,87,273765,985,751,9,760,3
2020-07-18,Shasta,89,179085,369,216,1,217,9
2020-07-18,Sierra,91,2930,1,1,0,1,0
2020-07-18,Siskiyou,93,43540,70,42,0,42,0
2020-07-18,Solano,95,438530,3515,2503,12,2515,26
2020-07-18,Sonoma,97,501317,2834,2019,5,2024,15
2020-07-18,Stanislaus,99,539301,8989,6344,12,6356,58
2020-07-18,Sutter,101,95872,596,473,0,473,2
2020-07-18,Tehama,103,63373,202,136,4,140,1
2020-07-18,Trinity,105,12862,7,2,4,6,0
2020-07-18,Tulare,107,460477,8924,6810,22,6832,167
2020-07-18,Tuolumne,109,53932,123,75,24,99,0
2020-07-18,Ventura,111,848112,7171,5630,19,5649,52
2020-07-18,Yolo,113,214977,1471,1077,3,1080,30
2020-07-18,Yuba,115,75493,317,237,0,237,1
2020-07-17,Alameda,1,1643700,11095,8893,27,8920,160
2020-07-17,Alpine,3,1148,3,1,0,1,0
2020-07-17,Amador,5,37829,97,48,0,48,0
2020-07-17,Butte,7,227075,819,497,5,502,4
2020-07-17,Calaveras,9,45235,98,86,0,86,0
2020-07-17,Colusa,11,21464,272,146,0,146,0
2020-07-17,Contra Costa,13,1133247,7684,5483,20,5503,93
2020-07-17,Del Norte,15,27424,83,60,0,60,0
2020-07-17,El Dorado,17,186661,609,368,0,368,0
2020-07-17,Fresno,19,978130,16958,9954,114,10068,104
2020-07-17,Glenn,21,27897,297,203,0,203,0
2020-07-17,Humboldt,23,135768,217,185,0,185,4
2020-07-17,Imperial,25,180216,9724,7193,6,7199,120
2020-07-17,Inyo,27,18085,42,38,0,38,1
2020-07-17,Kern,29,883053,19503,8291,74,8365,113
2020-07-17,Kings,31,150075,3822,2978,24,3002,37
2020-07-17,Lake,33,64148,182,139,0,139,1
2020-07-17,Lassen,35,31185,522,391,1,392,0
2020-07-17,Los Angeles,37,10098052,170966,150481,307,150788,4052
2020-07-17,Madera,39,155013,2002,1214,1,1215,9
2020-07-17,Marin,41,260295,4712,3839,4,3843,21
2020-07-17,Mariposa,43,17540,47,35,0,35,1
2020-07-17,Mendocino,45,87422,199,126,0,126,0
2020-07-17,Merced,47,269075,3998,2328,2,2330,12
2020-07-17,Modoc,49,8938,2,0,0,0,0
2020-07-17,Mono,51,14174,100,54,0,54,1
2020-07-17,Monterey,53,433212,4004,2922,9,2931,18
2020-07-17,Napa,55,140530,885,598,0,598,5
2020-07-17,Nevada,57,99092,282,200,8,208,1
2020-07-17,Orange,59,3164182,37437,28962,527,29489,485
2020-07-17,Placer,61,380077,1751,1207,3,1210,11
2020-07-17,Plumas,63,18699,27,16,0,16,0
2020-07-17,Riverside,65,2383286,37223,29639,17,29656,580
2020-07-17,Sacramento,67,1510023,9353,6563,7,6570,95
2020-07-17,San Benito,69,59416,527,399,0,399,2
2020-07-17,San Bernardino,71,2135413,32661,23057,25,23082,322
2020-07-17,San Diego,73,3302833,27411,22491,0,22491,472
2020-07-17,San Francisco,75,870044,5970,4967,10,4977,52
2020-07-17,San Joaquin,77,732212,11201,7925,6,7931,86
2020-07-17,San Luis Obispo,79,281455,1595,1190,3,1193,6
2020-07-17,San Mateo,81,765935,5332,4407,4,4411,110
2020-07-17,Santa Barbara,83,443738,6119,5001,72,5073,29
2020-07-17,Santa Clara,85,1922200,9742,7080,16,7096,164
2020-07-17,Santa Cruz,87,273765,963,716,9,725,3
2020-07-17,Shasta,89,179085,357,213,1,214,8
2020-07-17,Sierra,91,2930,1,1,0,1,0
2020-07-17,Siskiyou,93,43540,69,40,0,40,0
2020-07-17,Solano,95,438530,3466,2452,12,2464,26
2020-07-17,Sonoma,97,501317,2786,1982,5,1987,15
2020-07-17,Stanislaus,99,539301,8817,6220,12,6232,56
2020-07-17,Sutter,101,95872,583,458,0,458,2
2020-07-17,Tehama,103,63373,198,128,4,132,1
2020-07-17,Trinity,105,12862,7,2,4,6,0
2020-07-17,Tulare,107,460477,8788,6671,22,6693,166
2020-07-17,Tuolumne,109,53932,122,73,24,97,0
2020-07-17,Ventura,111,848112,7088,5451,19,5470,51
2020-07-17,Yolo,113,214977,1447,1055,3,1058,30
2020-07-17,Yuba,115,75493,307,231,0,231,1
2020-07-16,Alameda,1,1643700,10862,8719,21,8740,153
2020-07-16,Alpine,3,1148,3,1,0,1,0
2020-07-16,Amador,5,37829,94,46,0,46,0
2020-07-16,Butte,7,227075,782,465,5,470,4
2020-07-16,Calaveras,9,45235,96,82,0,82,0
2020-07-16,Colusa,11,21464,263,140,0,140,0
2020-07-16,Contra Costa,13,1133247,7472,5338,14,5352,91
2020-07-16,Del Norte,15,27424,83,60,0,60,0
2020-07-16,El Dorado,17,186661,592,357,0,357,0
2020-07-16,Fresno,19,978130,16447,9481,105,9586,101
2020-07-16,Glenn,21,27897,288,190,0,190,0
2020-07-16,Humboldt,23,135768,215,184,0,184,4
2020-07-16,Imperial,25,180216,9629,7148,6,7154,113
2020-07-16,Inyo,27,18085,42,38,0,38,1
2020-07-16,Kern,29,883053,18981,7435,72,7507,112
2020-07-16,Kings,31,150075,3656,2937,24,2961,37
2020-07-16,Lake,33,64148,177,128,0,128,1
2020-07-16,Lassen,35,31185,521,355,1,356,0
2020-07-16,Los Angeles,37,10098052,167693,147759,283,148042,3994
2020-07-16,Madera,39,155013,1938,1192,1,1193,8
2020-07-16,Marin,41,260295,4640,3546,4,3550,21
2020-07-16,Mariposa,43,17540,45,34,0,34,1
2020-07-16,Mendocino,45,87422,194,121,0,121,0
2020-07-16,Merced,47,269075,3836,2228,2,2230,12
2020-07-16,Modoc,49,8938,1,0,0,0,0
2020-07-16,Mono,51,14174,97,53,0,53,1
2020-07-16,Monterey,53,433212,3899,2857,8,2865,18
2020-07-16,Napa,55,140530,856,581,0,581,5
2020-07-16,Nevada,57,99092,279,191,8,199,1
2020-07-16,Orange,59,3164182,36736,28525,489,29014,471
2020-07-16,Placer,61,380077,1699,1168,3,1171,11
2020-07-16,Plumas,63,18699,25,16,0,16,0
2020-07-16,Riverside,65,2383286,36477,28904,16,28920,577
2020-07-16,Sacramento,67,1510023,9039,6440,7,6447,91
2020-07-16,San Benito,69,59416,510,389,0,389,2
2020-07-16,San Bernardino,71,2135413,31804,22355,23,22378,321
2020-07-16,San Diego,73,3302833,26924,21857,0,21857,465
2020-07-16,San Francisco,75,870044,5829,4838,10,4848,52
2020-07-16,San Joaquin,77,732212,10838,7713,6,7719,82
2020-07-16,San Luis Obispo,79,281455,1551,1146,3,1149,6
2020-07-16,San Mateo,81,765935,5228,4336,4,4340,110
2020-07-16,Santa Barbara,83,443738,6023,4872,71,4943,28
2020-07-16,Santa Clara,85,1922200,9462,6990,14,7004,164
2020-07-16,Santa Cruz,87,273765,922,698,9,707,3
2020-07-16,Shasta,89,179085,342,208,1,209,7
2020-07-16,Sierra,91,2930,1,1,0,1,0
2020-07-16,Siskiyou,93,43540,66,39,0,39,0
2020-07-16,Solano,95,438530,3372,2372,12,2384,25
2020-07-16,Sonoma,97,501317,2695,1954,5,1959,14
2020-07-16,Stanislaus,99,539301,8536,6077,11,6088,56
2020-07-16,Sutter,101,95872,567,444,0,444,2
2020-07-16,Tehama,103,63373,188,126,4,130,1
2020-07-16,Trinity,105,12862,7,2,3,5,0
2020-07-16,Tulare,107,460477,8572,6467,21,6488,163
2020-07-16,Tuolumne,109,53932,117,71,24,95,0
2020-07-16,Ventura,111,848112,6926,5231,19,5250,50
2020-07-16,Yolo,113,214977,1405,1034,3,1037,29
2020-07-16,Yuba,115,75493,289,221,0,221,1
2020-07-15,Alameda,1,1643700,10660,8615,15,8630,153
2020-07-15,Alpine,3,1148,3,1,0,1,0
2020-07-15,Amador,5,37829,73,44,0,44,0
2020-07-15,Butte,7,227075,741,420,5,425,4
2020-07-15,Calaveras,9,45235,96,75,0,75,0
2020-07-15,Colusa,11,21464,258,135,0,135,0
2020-07-15,Contra Costa,13,1133247,7241,5246,14,5260,90
2020-07-15,Del Norte,15,27424,82,60,0,60,0
2020-07-15,El Dorado,17,186661,568,339,0,339,0
2020-07-15,Fresno,19,978130,15974,9124,98,9222,101
2020-07-15,Glenn,21,27897,279,184,0,184,0
2020-07-15,Humboldt,23,135768,213,181,0,181,4
2020-07-15,Imperial,25,180216,9562,7110,6,7116,110
2020-07-15,Inyo,27,18085,42,36,0,36,1
2020-07-15,Kern,29,883053,18362,7155,68,7223,108
2020-07-15,Kings,31,150075,3595,2906,24,2930,37
2020-07-15,Lake,33,64148,175,122,0,122,1
2020-07-15,Lassen,35,31185,517,319,1,320,0
2020-07-15,Los Angeles,37,10098052,164228,143343,268,143611,3946
2020-07-15,Madera,39,155013,1869,1147,1,1148,4
2020-07-15,Marin,41,260295,4585,3458,4,3462,21
2020-07-15,Mariposa,43,17540,45,34,0,34,1
2020-07-15,Mendocino,45,87422,191,119,0,119,0
2020-07-15,Merced,47,269075,3686,2156,2,2158,12
2020-07-15,Modoc,49,8938,1,0,0,0,0
2020-07-15,Mono,51,14174,95,52,0,52,1
2020-07-15,Monterey,53,433212,3788,2780,8,2788,18
2020-07-15,Napa,55,140530,830,573,0,573,5
2020-07-15,Nevada,57,99092,275,185,6,191,1
2020-07-15,Orange,59,3164182,35934,27718,454,28172,454
2020-07-15,Placer,61,380077,1644,1145,3,1148,11
2020-07-15,Plumas,63,18699,25,16,0,16,0
2020-07-15,Riverside,65,2383286,35698,28492,14,28506,568
2020-07-15,Sacramento,67,1510023,8662,6217,7,6224,91
2020-07-15,San Benito,69,59416,501,388,0,388,2
2020-07-15,San Bernardino,71,2135413,31018,21508,23,21531,317
2020-07-15,San Diego,73,3302833,26457,21448,0,21448,448
2020-07-15,San Francisco,75,870044,5715,4757,10,4767,50
2020-07-15,San Joaquin,77,732212,10405,7381,5,7386,75
2020-07-15,San Luis Obispo,79,281455,1508,1097,3,1100,6
2020-07-15,San Mateo,81,765935,5115,4258,4,4262,109
2020-07-15,Santa Barbara,83,443738,5907,4733,71,4804,28
2020-07-15,Santa Clara,85,1922200,9159,6900,14,6914,164
2020-07-15,Santa Cruz,87,273765,886,660,8,668,3
2020-07-15,Shasta,89,179085,333,193,1,194,7
2020-07-15,Sierra,91,2930,1,1,0,1,0
2020-07-15,Siskiyou,93,43540,65,38,0,38,0
2020-07-15,Solano,95,438530,3278,2343,12,2355,25
2020-07-15,Sonoma,97,501317,2598,1920,5,1925,14
2020-07-15,Stanislaus,99,539301,8241,5777,11,5788,56
2020-07-15,Sutter,101,95872,541,433,0,433,2
2020-07-15,Tehama,103,63373,180,126,4,130,1
2020-07-15,Trinity,105,12862,6,2,3,5,0
2020-07-15,Tulare,107,460477,8359,6320,20,6340,156
2020-07-15,Tuolumne,109,53932,110,68,24,92,0
2020-07-15,Ventura,111,848112,6749,5087,19,5106,50
2020-07-15,Yolo,113,214977,1373,1002,3,1005,27
2020-07-15,Yuba,115,75493,277,221,0,221,1
2020-07-14,Alameda,1,1643700,10320,8388,9,8397,151
2020-07-14,Alpine,3,1148,3,1,0,1,0
2020-07-14,Amador,5,37829,69,44,0,44,0
2020-07-14,Butte,7,227075,696,382,5,387,4
2020-07-14,Calaveras,9,45235,94,74,0,74,0
2020-07-14,Colusa,11,21464,248,128,0,128,0
2020-07-14,Contra Costa,13,1133247,7005,5110,12,5122,90
2020-07-14,Del Norte,15,27424,81,60,0,60,0
2020-07-14,El Dorado,17,186661,553,324,0,324,0
2020-07-14,Fresno,19,978130,15554,8941,94,9035,98
2020-07-14,Glenn,21,27897,269,177,0,177,0
2020-07-14,Humboldt,23,135768,210,175,0,175,4
2020-07-14,Imperial,25,180216,9435,7095,6,7101,109
2020-07-14,Inyo,27,18085,42,35,0,35,1
2020-07-14,Kern,29,883053,17603,6979,55,7034,107
2020-07-14,Kings,31,150075,3528,2867,23,2890,37
2020-07-14,Lake,33,64148,169,120,0,120,1
2020-07-14,Lassen,35,31185,500,263,1,264,0
2020-07-14,Los Angeles,37,10098052,161092,140632,237,140869,3900
2020-07-14,Madera,39,155013,1795,1118,1,1119,4
2020-07-14,Marin,41,260295,4471,3451,4,3455,21
2020-07-14,Mariposa,43,17540,41,32,0,32,1
2020-07-14,Mendocino,45,87422,183,110,0,110,0
2020-07-14,Merced,47,269075,3507,2084,2,2086,12
2020-07-14,Modoc,49,8938,1,0,0,0,0
2020-07-14,Mono,51,14174,85,48,0,48,1
2020-07-14,Monterey,53,433212,3674,2724,8,2732,18
2020-07-14,Napa,55,140530,774,557,0,557,4
2020-07-14,Nevada,57,99092,258,180,5,185,1
2020-07-14,Orange,59,3164182,35055,26915,407,27322,432
2020-07-14,Placer,61,380077,1588,1122,3,1125,11
2020-07-14,Plumas,63,18699,24,14,0,14,0
2020-07-14,Riverside,65,2383286,34943,27850,13,27863,547
2020-07-14,Sacramento,67,1510023,8310,5978,7,5985,87
2020-07-14,San Benito,69,59416,482,360,0,360,2
2020-07-14,San Bernardino,71,2135413,30169,20489,23,20512,316
2020-07-14,San Diego,73,3302833,25838,20887,0,20887,436
2020-07-14,San Francisco,75,870044,5565,4659,9,4668,50
2020-07-14,San Joaquin,77,732212,9978,7143,5,7148,75
2020-07-14,San Luis Obispo,79,281455,1469,1060,3,1063,5
2020-07-14,San Mateo,81,765935,5022,4173,4,4177,108
2020-07-14,Santa Barbara,83,443738,5783,4641,69,4710,28
2020-07-14,Santa Clara,85,1922200,8832,6686,10,6696,164
2020-07-14,Santa Cruz,87,273765,847,639,8,647,3
2020-07-14,Shasta,89,179085,324,190,1,191,7
2020-07-14,Sierra,91,2930,1,1,0,1,0
2020-07-14,Siskiyou,93,43540,64,38,0,38,0
2020-07-14,Solano,95,438530,3178,2266,10,2276,25
2020-07-14,Sonoma,97,501317,2506,1866,5,1871,14
2020-07-14,Stanislaus,99,539301,7872,5631,10,5641,53
2020-07-14,Sutter,101,95872,522,405,0,405,2
2020-07-14,Tehama,103,63373,168,123,4,127,1
2020-07-14,Trinity,105,12862,6,2,3,5,0
2020-07-14,Tulare,107,460477,8113,6199,20,6219,156
2020-07-14,Tuolumne,109,53932,105,68,24,92,0
2020-07-14,Ventura,111,848112,6588,4950,19,4969,50
2020-07-14,Yolo,113,214977,1325,966,3,969,27
2020-07-14,Yuba,115,75493,260,210,0,210,1
2020-07-13,Alameda,1,1643700,10012,8115,9,8124,148
2020-07-13,Alpine,3,1148,3,1,0,1,0
2020-07-13,Amador,5,37829,65,42,0,42,0
2020-07-13,Butte,7,227075,660,354,5,359,4
2020-07-13,Calaveras,9,45235,86,63,0,63,0
2020-07-13,Colusa,11,21464,242,116,0,116,0
2020-07-13,Contra Costa,13,1133247,6732,4882,10,4892,88
2020-07-13,Del Norte,15,27424,75,59,0,59,0
2020-07-13,El Dorado,17,186661,522,298,0,298,0
2020-07-13,Fresno,19,978130,15129,8666,90,8756,95
2020-07-13,Glenn,21,27897,262,168,0,168,0
2020-07-13,Humboldt,23,135768,205,174,0,174,4
2020-07-13,Imperial,25,180216,9349,7052,6,7058,109
2020-07-13,Inyo,27,18085,41,35,0,35,1
2020-07-13,Kern,29,883053,16918,6808,51,6859,107
2020-07-13,Kings,31,150075,3477,2824,23,2847,37
2020-07-13,Lake,33,64148,164,118,0,118,1
2020-07-13,Lassen,35,31185,495,237,1,238,0
2020-07-13,Los Angeles,37,10098052,157854,136368,223,136591,3829
2020-07-13,Madera,39,155013,1726,1059,1,1060,4
2020-07-13,Marin,41,260295,4368,3402,4,3406,21
2020-07-13,Mariposa,43,17540,40,31,0,31,1
2020-07-13,Mendocino,45,87422,179,87,0,87,0
2020-07-13,Merced,47,269075,3358,2007,2,2009,12
2020-07-13,Modoc,49,8938,1,0,0,0,0
2020-07-13,Mono,51,14174,81,47,0,47,1
2020-07-13,Monterey,53,433212,3551,2613,5,2618,18
2020-07-13,Napa,55,140530,738,534,0,534,4
2020-07-13,Nevada,57,99092,243,172,5,177,1
2020-07-13,Orange,59,3164182,34192,25978,376,26354,423
2020-07-13,Placer,61,380077,1540,1096,3,1099,11
2020-07-13,Plumas,63,18699,22,14,0,14,0
2020-07-13,Riverside,65,2383286,34017,27136,11,27147,545
2020-07-13,Sacramento,67,1510023,8015,5747,7,5754,85
2020-07-13,San Benito,69,59416,469,343,0,343,2
2020-07-13,San Bernardino,71,2135413,29292,19610,20,19630,313
2020-07-13,San Diego,73,3302833,25271,20348,0,20348,422
2020-07-13,San Francisco,75,870044,5438,4534,8,4542,50
2020-07-13,San Joaquin,77,732212,9561,6927,5,6932,71
2020-07-13,San Luis Obispo,79,281455,1438,989,3,992,5
2020-07-13,San Mateo,81,765935,4891,4057,4,4061,108
2020-07-13,Santa Barbara,83,443738,5669,4441,68,4509,28
2020-07-13,Santa Clara,85,1922200,8508,6488,9,6497,164
2020-07-13,Santa Cruz,87,273765,808,574,8,582,3
2020-07-13,Shasta,89,179085,313,185,1,186,6
2020-07-13,Sierra,91,2930,1,1,0,1,0
2020-07-13,Siskiyou,93,43540,60,37,0,37,0
2020-07-13,Solano,95,438530,3066,2046,10,2056,23
2020-07-13,Sonoma,97,501317,2396,1818,5,1823,14
2020-07-13,Stanislaus,99,539301,7572,5324,8,5332,53
2020-07-13,Sutter,101,95872,484,379,0,379,2
2020-07-13,Tehama,103,63373,155,112,4,116,1
2020-07-13,Trinity,105,12862,6,2,3,5,0
2020-07-13,Tulare,107,460477,7852,5930,18,5948,147
2020-07-13,Tuolumne,109,53932,97,56,24,80,0
2020-07-13,Ventura,111,848112,6398,4800,16,4816,50
2020-07-13,Yolo,113,214977,1280,941,3,944,27
2020-07-13,Yuba,115,75493,245,194,0,194,1
2020-07-12,Alameda,1,1643700,9741,8056,9,8065,148
2020-07-12,Alpine,3,1148,3,1,0,1,0
2020-07-12,Amador,5,37829,55,40,0,40,0
2020-07-12,Butte,7,227075,610,341,5,346,4
2020-07-12,Calaveras,9,45235,86,62,0,62,0
2020-07-12,Colusa,11,21464,208,116,0,116,0
2020-07-12,Contra Costa,13,1133247,6460,4708,8,4716,88
2020-07-12,Del Norte,15,27424,63,59,0,59,0
2020-07-12,El Dorado,17,186661,500,290,0,290,0
2020-07-12,Fresno,19,978130,14704,8407,87,8494,95
2020-07-12,Glenn,21,27897,249,166,0,166,0
2020-07-12,Humboldt,23,135768,201,174,0,174,4
2020-07-12,Imperial,25,180216,9229,6999,6,7005,109
2020-07-12,Inyo,27,18085,39,35,0,35,1
2020-07-12,Kern,29,883053,16175,6662,48,6710,105
2020-07-12,Kings,31,150075,3415,2779,22,2801,34
2020-07-12,Lake,33,64148,155,114,0,114,1
2020-07-12,Lassen,35,31185,488,237,1,238,0
2020-07-12,Los Angeles,37,10098052,154429,133830,194,134024,3816
2020-07-12,Madera,39,155013,1671,1025,1,1026,4
2020-07-12,Marin,41,260295,4290,3358,4,3362,21
2020-07-12,Mariposa,43,17540,39,31,0,31,1
2020-07-12,Mendocino,45,87422,160,88,0,88,0
2020-07-12,Merced,47,269075,3228,1908,2,1910,12
2020-07-12,Modoc,49,8938,1,0,0,0,0
2020-07-12,Mono,51,14174,71,45,0,45,1
2020-07-12,Monterey,53,433212,3436,2521,5,2526,18
2020-07-12,Napa,55,140530,706,519,0,519,4
2020-07-12,Nevada,57,99092,233,166,5,171,1
2020-07-12,Orange,59,3164182,33318,25399,367,25766,422
2020-07-12,Placer,61,380077,1483,1058,3,1061,11
2020-07-12,Plumas,63,18699,21,14,0,14,0
2020-07-12,Riverside,65,2383286,33259,26404,11,26415,542
2020-07-12,Sacramento,67,1510023,7706,5515,6,5521,85
2020-07-12,San Benito,69,59416,454,324,0,324,2
2020-07-12,San Bernardino,71,2135413,28383,19042,15,19057,312
2020-07-12,San Diego,73,3302833,24644,19929,0,19929,422
2020-07-12,San Francisco,75,870044,5289,4535,8,4543,50
2020-07-12,San Joaquin,77,732212,9199,6703,5,6708,71
2020-07-12,San Luis Obispo,79,281455,1392,972,3,975,5
2020-07-12,San Mateo,81,765935,4773,3988,4,3992,108
2020-07-12,Santa Barbara,83,443738,5539,4353,67,4420,28
2020-07-12,Santa Clara,85,1922200,8268,6252,9,6261,164
2020-07-12,Santa Cruz,87,273765,766,573,6,579,3
2020-07-12,Shasta,89,179085,307,173,1,174,6
2020-07-12,Sierra,91,2930,1,1,0,1,0
2020-07-12,Siskiyou,93,43540,58,36,0,36,0
2020-07-12,Solano,95,438530,2941,2037,10,2047,23
2020-07-12,Sonoma,97,501317,2301,1743,5,1748,13
2020-07-12,Stanislaus,99,539301,7270,5177,8,5185,53
2020-07-12,Sutter,101,95872,466,362,0,362,2
2020-07-12,Tehama,103,63373,148,111,4,115,1
2020-07-12,Trinity,105,12862,6,2,3,5,0
2020-07-12,Tulare,107,460477,7597,5864,17,5881,146
2020-07-12,Tuolumne,109,53932,89,52,23,75,0
2020-07-12,Ventura,111,848112,6182,4724,15,4739,50
2020-07-12,Yolo,113,214977,1238,889,3,892,27
2020-07-12,Yuba,115,75493,234,188,0,188,1
2020-07-11,Alameda,1,1643700,9639,7845,9,7854,148
2020-07-11,Alpine,3,1148,3,1,0,1,0
2020-07-11,Amador,5,37829,51,37,0,37,0
2020-07-11,Butte,7,227075,594,325,4,329,4
2020-07-11,Calaveras,9,45235,83,62,0,62,0
2020-07-11,Colusa,11,21464,203,110,0,110,0
2020-07-11,Contra Costa,13,1133247,6344,4650,8,4658,87
2020-07-11,Del Norte,15,27424,63,59,0,59,0
2020-07-11,El Dorado,17,186661,489,283,0,283,0
2020-07-11,Fresno,19,978130,14446,8086,86,8172,95
2020-07-11,Glenn,21,27897,241,161,0,161,0
2020-07-11,Humboldt,23,135768,200,174,0,174,4
2020-07-11,Imperial,25,180216,9190,6884,6,6890,109
2020-07-11,Inyo,27,18085,39,35,0,35,1
2020-07-11,Kern,29,883053,15819,6509,47,6556,103
2020-07-11,Kings,31,150075,3388,2753,22,2775,33
2020-07-11,Lake,33,64148,154,110,0,110,1
2020-07-11,Lassen,35,31185,487,237,1,238,0
2020-07-11,Los Angeles,37,10098052,152712,130479,184,130663,3802
2020-07-11,Madera,39,155013,1630,988,1,989,4
2020-07-11,Marin,41,260295,4262,3191,4,3195,21
2020-07-11,Mariposa,43,17540,39,31,0,31,1
2020-07-11,Mendocino,45,87422,156,88,0,88,0
2020-07-11,Merced,47,269075,3147,1851,2,1853,12
2020-07-11,Modoc,49,8938,1,0,0,0,0
2020-07-11,Mono,51,14174,68,45,0,45,1
2020-07-11,Monterey,53,433212,3347,2376,4,2380,18
2020-07-11,Napa,55,140530,694,509,0,509,4
2020-07-11,Nevada,57,99092,224,163,4,167,1
2020-07-11,Orange,59,3164182,32941,24430,353,24783,422
2020-07-11,Placer,61,380077,1447,1029,3,1032,11
2020-07-11,Plumas,63,18699,21,12,0,12,0
2020-07-11,Riverside,65,2383286,32867,25994,11,26005,538
2020-07-11,Sacramento,67,1510023,7532,5367,6,5373,84
2020-07-11,San Benito,69,59416,439,314,0,314,2
2020-07-11,San Bernardino,71,2135413,27946,18907,15,18922,310
2020-07-11,San Diego,73,3302833,24259,19371,0,19371,422
2020-07-11,San Francisco,75,870044,5193,4430,7,4437,50
2020-07-11,San Joaquin,77,732212,9021,6518,5,6523,72
2020-07-11,San Luis Obispo,79,281455,1344,930,3,933,4
2020-07-11,San Mateo,81,765935,4705,3956,4,3960,108
2020-07-11,Santa Barbara,83,443738,5470,4283,66,4349,28
2020-07-11,Santa Clara,85,1922200,8109,5959,9,5968,164
2020-07-11,Santa Cruz,87,273765,735,571,6,577,3
2020-07-11,Shasta,89,179085,300,168,1,169,6
2020-07-11,Sierra,91,2930,1,1,0,1,0
2020-07-11,Siskiyou,93,43540,58,36,0,36,0
2020-07-11,Solano,95,438530,2900,2034,10,2044,23
2020-07-11,Sonoma,97,501317,2264,1690,5,1695,13
2020-07-11,Stanislaus,99,539301,7130,4911,8,4919,51
2020-07-11,Sutter,101,95872,450,352,0,352,2
2020-07-11,Tehama,103,63373,146,111,4,115,1
2020-07-11,Trinity,105,12862,6,2,3,5,0
2020-07-11,Tulare,107,460477,7491,5780,17,5797,149
2020-07-11,Tuolumne,109,53932,87,50,23,73,0
2020-07-11,Ventura,111,848112,6086,4545,14,4559,49
2020-07-11,Yolo,113,214977,1209,833,3,836,27
2020-07-11,Yuba,115,75493,224,175,0,175,1
2020-07-10,Alameda,1,1643700,9482,7551,9,7560,147
2020-07-10,Alpine,3,1148,3,1,0,1,0
2020-07-10,Amador,5,37829,47,37,0,37,0
2020-07-10,Butte,7,227075,583,318,3,321,4
2020-07-10,Calaveras,9,45235,83,61,0,61,0
2020-07-10,Colusa,11,21464,197,103,0,103,0
2020-07-10,Contra Costa,13,1133247,6201,4482,8,4490,86
2020-07-10,Del Norte,15,27424,63,57,0,57,0
2020-07-10,El Dorado,17,186661,471,266,0,266,0
2020-07-10,Fresno,19,978130,14114,7760,83,7843,93
2020-07-10,Glenn,21,27897,236,157,0,157,0
2020-07-10,Humboldt,23,135768,199,168,0,168,4
2020-07-10,Imperial,25,180216,9145,6878,6,6884,98
2020-07-10,Inyo,27,18085,39,35,0,35,1
2020-07-10,Kern,29,883053,15386,6344,46,6390,102
2020-07-10,Kings,31,150075,3353,2707,22,2729,33
2020-07-10,Lake,33,64148,147,104,0,104,1
2020-07-10,Lassen,35,31185,486,235,1,236,0
2020-07-10,Los Angeles,37,10098052,150294,127503,178,127681,3750
2020-07-10,Madera,39,155013,1584,914,1,915,4
2020-07-10,Marin,41,260295,4200,3101,4,3105,21
2020-07-10,Mariposa,43,17540,38,31,0,31,1
2020-07-10,Mendocino,45,87422,148,88,0,88,0
2020-07-10,Merced,47,269075,3068,1802,2,1804,12
2020-07-10,Modoc,49,8938,1,0,0,0,0
2020-07-10,Mono,51,14174,67,45,0,45,1
2020-07-10,Monterey,53,433212,3268,2285,4,2289,18
2020-07-10,Napa,55,140530,683,496,0,496,4
2020-07-10,Nevada,57,99092,219,161,4,165,1
2020-07-10,Orange,59,3164182,32355,23692,349,24041,416
2020-07-10,Placer,61,380077,1403,1002,3,1005,11
2020-07-10,Plumas,63,18699,19,12,0,12,0
2020-07-10,Riverside,65,2383286,32349,25481,11,25492,533
2020-07-10,Sacramento,67,1510023,7275,5181,6,5187,81
2020-07-10,San Benito,69,59416,430,302,0,302,2
2020-07-10,San Bernardino,71,2135413,27420,18242,15,18257,308
2020-07-10,San Diego,73,3302833,23879,18862,0,18862,420
2020-07-10,San Francisco,75,870044,5102,4305,7,4312,50
2020-07-10,San Joaquin,77,732212,8788,6225,5,6230,67
2020-07-10,San Luis Obispo,79,281455,1306,891,3,894,4
2020-07-10,San Mateo,81,765935,4641,3844,4,3848,107
2020-07-10,Santa Barbara,83,443738,5373,4177,65,4242,28
2020-07-10,Santa Clara,85,1922200,7885,5819,9,5828,164
2020-07-10,Santa Cruz,87,273765,708,540,6,546,3
2020-07-10,Shasta,89,179085,296,158,1,159,6
2020-07-10,Sierra,91,2930,1,1,0,1,0
2020-07-10,Siskiyou,93,43540,58,31,0,31,0
2020-07-10,Solano,95,438530,2853,1950,10,1960,23
2020-07-10,Sonoma,97,501317,2217,1606,4,1610,13
2020-07-10,Stanislaus,99,539301,6961,4781,8,4789,46
2020-07-10,Sutter,101,95872,443,338,0,338,2
2020-07-10,Tehama,103,63373,145,107,4,111,1
2020-07-10,Trinity,105,12862,6,2,3,5,0
2020-07-10,Tulare,107,460477,7354,5677,17,5694,150
2020-07-10,Tuolumne,109,53932,86,49,23,72,0
2020-07-10,Ventura,111,848112,5974,4416,14,4430,48
2020-07-10,Yolo,113,214977,1185,794,3,797,27
2020-07-10,Yuba,115,75493,210,164,0,164,1
2020-07-09,Alameda,1,1643700,9246,7433,9,7442,146
2020-07-09,Alpine,3,1148,3,1,0,1,0
2020-07-09,Amador,5,37829,44,36,0,36,0
2020-07-09,Butte,7,227075,552,295,3,298,4
2020-07-09,Calaveras,9,45235,82,59,0,59,0
2020-07-09,Colusa,11,21464,189,97,0,97,0
2020-07-09,Contra Costa,13,1133247,5958,4388,8,4396,86
2020-07-09,Del Norte,15,27424,63,57,0,57,0
2020-07-09,El Dorado,17,186661,447,255,0,255,0
2020-07-09,Fresno,19,978130,13658,7385,81,7466,90
2020-07-09,Glenn,21,27897,226,150,0,150,0
2020-07-09,Humboldt,23,135768,196,166,0,166,4
2020-07-09,Imperial,25,180216,9049,6778,6,6784,87
2020-07-09,Inyo,27,18085,37,35,0,35,1
2020-07-09,Kern,29,883053,14740,6100,44,6144,95
2020-07-09,Kings,31,150075,3290,2686,21,2707,33
2020-07-09,Lake,33,64148,144,99,0,99,1
2020-07-09,Lassen,35,31185,430,221,1,222,0
2020-07-09,Los Angeles,37,10098052,147026,125062,151,125213,3698
2020-07-09,Madera,39,155013,1507,850,1,851,4
2020-07-09,Marin,41,260295,4048,2975,4,2979,20
2020-07-09,Mariposa,43,17540,38,32,0,32,1
2020-07-09,Mendocino,45,87422,144,88,0,88,0
2020-07-09,Merced,47,269075,2935,1728,2,1730,11
2020-07-09,Modoc,49,8938,1,0,0,0,0
2020-07-09,Mono,51,14174,63,45,0,45,1
2020-07-09,Monterey,53,433212,3143,2223,4,2227,17
2020-07-09,Napa,55,140530,666,468,0,468,4
2020-07-09,Nevada,57,99092,213,156,4,160,1
2020-07-09,Orange,59,3164182,31386,22960,331,23291,407
2020-07-09,Placer,61,380077,1358,982,3,985,11
2020-07-09,Plumas,63,18699,19,12,0,12,0
2020-07-09,Riverside,65,2383286,31455,24980,11,24991,529
2020-07-09,Sacramento,67,1510023,6950,4950,6,4956,81
2020-07-09,San Benito,69,59416,414,295,0,295,2
2020-07-09,San Bernardino,71,2135413,26548,17339,14,17353,307
2020-07-09,San Diego,73,3302833,23287,18404,0,18404,415
2020-07-09,San Francisco,75,870044,4969,4143,7,4150,50
2020-07-09,San Joaquin,77,732212,8429,6004,5,6009,66
2020-07-09,San Luis Obispo,79,281455,1267,869,3,872,3
2020-07-09,San Mateo,81,765935,4514,3792,4,3796,106
2020-07-09,Santa Barbara,83,443738,5240,4068,65,4133,28
2020-07-09,Santa Clara,85,1922200,7628,5638,9,5647,164
2020-07-09,Santa Cruz,87,273765,681,526,6,532,3
2020-07-09,Shasta,89,179085,290,155,1,156,5
2020-07-09,Sierra,91,2930,1,1,0,1,0
2020-07-09,Siskiyou,93,43540,54,31,0,31,0
2020-07-09,Solano,95,438530,2755,1892,10,1902,23
2020-07-09,Sonoma,97,501317,2131,1584,4,1588,13
2020-07-09,Stanislaus,99,539301,6647,4633,7,4640,46
2020-07-09,Sutter,101,95872,426,321,0,321,2
2020-07-09,Tehama,103,63373,140,102,4,106,1
2020-07-09,Trinity,105,12862,6,2,3,5,0
2020-07-09,Tulare,107,460477,7137,5501,15,5516,146
2020-07-09,Tuolumne,109,53932,85,47,23,70,0
2020-07-09,Ventura,111,848112,5806,4278,14,4292,47
2020-07-09,Yolo,113,214977,1139,764,3,767,27
2020-07-09,Yuba,115,75493,193,152,0,152,1
2020-07-08,Alameda,1,1643700,8953,7335,9,7344,142
2020-07-08,Alpine,3,1148,3,1,0,1,0
2020-07-08,Amador,5,37829,41,35,0,35,0
2020-07-08,Butte,7,227075,515,281,3,284,3
2020-07-08,Calaveras,9,45235,76,58,0,58,0
2020-07-08,Colusa,11,21464,176,90,0,90,0
2020-07-08,Contra Costa,13,1133247,5712,4268,6,4274,84
2020-07-08,Del Norte,15,27424,61,57,0,57,0
2020-07-08,El Dorado,17,186661,426,248,0,248,0
2020-07-08,Fresno,19,978130,13243,7102,75,7177,86
2020-07-08,Glenn,21,27897,215,146,0,146,0
2020-07-08,Humboldt,23,135768,193,162,0,162,4
2020-07-08,Imperial,25,180216,8961,6727,6,6733,76
2020-07-08,Inyo,27,18085,37,35,0,35,1
2020-07-08,Kern,29,883053,14162,5873,43,5916,91
2020-07-08,Kings,31,150075,3230,2629,19,2648,33
2020-07-08,Lake,33,64148,137,97,0,97,1
2020-07-08,Lassen,35,31185,334,221,1,222,0
2020-07-08,Los Angeles,37,10098052,143809,123462,121,123583,3650
2020-07-08,Madera,39,155013,1437,828,1,829,4
2020-07-08,Marin,41,260295,3949,2756,4,2760,17
2020-07-08,Mariposa,43,17540,38,31,0,31,1
2020-07-08,Mendocino,45,87422,131,84,0,84,0
2020-07-08,Merced,47,269075,2816,1578,2,1580,11
2020-07-08,Modoc,49,8938,1,0,0,0,0
2020-07-08,Mono,51,14174,60,45,0,45,1
2020-07-08,Monterey,53,433212,3025,2182,3,2185,17
2020-07-08,Napa,55,140530,643,468,0,468,4
2020-07-08,Nevada,57,99092,204,156,4,160,1
2020-07-08,Orange,59,3164182,30435,22088,325,22413,378
2020-07-08,Placer,61,380077,1308,948,3,951,11
2020-07-08,Plumas,63,18699,19,12,0,12,0
2020-07-08,Riverside,65,2383286,30491,24042,10,24052,508
2020-07-08,Sacramento,67,1510023,6661,4799,6,4805,80
2020-07-08,San Benito,69,59416,398,282,0,282,2
2020-07-08,San Bernardino,71,2135413,25698,16510,13,16523,296
2020-07-08,San Diego,73,3302833,22720,17844,0,17844,406
2020-07-08,San Francisco,75,870044,4880,4093,7,4100,50
2020-07-08,San Joaquin,77,732212,8086,5759,5,5764,61
2020-07-08,San Luis Obispo,79,281455,1216,825,3,828,2
2020-07-08,San Mateo,81,765935,4393,3733,4,3737,106
2020-07-08,Santa Barbara,83,443738,5121,3985,59,4044,28
2020-07-08,Santa Clara,85,1922200,7395,5510,9,5519,164
2020-07-08,Santa Cruz,87,273765,648,509,5,514,3
2020-07-08,Shasta,89,179085,281,148,1,149,6
2020-07-08,Sierra,91,2930,1,1,0,1,0
2020-07-08,Siskiyou,93,43540,54,31,0,31,0
2020-07-08,Solano,95,438530,2639,1821,10,1831,23
2020-07-08,Sonoma,97,501317,2057,1495,4,1499,9
2020-07-08,Stanislaus,99,539301,6348,4344,6,4350,46
2020-07-08,Sutter,101,95872,401,298,0,298,2
2020-07-08,Tehama,103,63373,134,100,4,104,1
2020-07-08,Trinity,105,12862,5,2,3,5,0
2020-07-08,Tulare,107,460477,6945,5307,10,5317,138
2020-07-08,Tuolumne,109,53932,81,42,18,60,0
2020-07-08,Ventura,111,848112,5641,4139,13,4152,47
2020-07-08,Yolo,113,214977,1096,727,3,730,26
2020-07-08,Yuba,115,75493,180,145,0,145,1
2020-07-07,Alameda,1,1643700,8634,7097,9,7106,141
2020-07-07,Alpine,3,1148,3,1,0,1,0
2020-07-07,Amador,5,37829,41,33,0,33,0
2020-07-07,Butte,7,227075,471,269,3,272,3
2020-07-07,Calaveras,9,45235,74,58,0,58,0
2020-07-07,Colusa,11,21464,143,84,0,84,0
2020-07-07,Contra Costa,13,1133247,5474,4131,5,4136,84
2020-07-07,Del Norte,15,27424,61,57,0,57,0
2020-07-07,El Dorado,17,186661,406,244,0,244,0
2020-07-07,Fresno,19,978130,12791,6738,75,6813,84
2020-07-07,Glenn,21,27897,206,145,0,145,0
2020-07-07,Humboldt,23,135768,190,150,0,150,4
2020-07-07,Imperial,25,180216,8862,6678,6,6684,51
2020-07-07,Inyo,27,18085,36,32,0,32,1
2020-07-07,Kern,29,883053,13463,5645,39,5684,88
2020-07-07,Kings,31,150075,3169,2623,15,2638,33
2020-07-07,Lake,33,64148,127,94,0,94,1
2020-07-07,Lassen,35,31185,263,219,1,220,0
2020-07-07,Los Angeles,37,10098052,140241,121026,113,121139,3588
2020-07-07,Madera,39,155013,1393,794,1,795,4
2020-07-07,Marin,41,260295,3860,2627,4,2631,17
2020-07-07,Mariposa,43,17540,38,31,0,31,1
2020-07-07,Mendocino,45,87422,123,82,0,82,0
2020-07-07,Merced,47,269075,2642,1531,2,1533,10
2020-07-07,Modoc,49,8938,1,0,0,0,0
2020-07-07,Mono,51,14174,59,42,0,42,1
2020-07-07,Monterey,53,433212,2882,2166,3,2169,17
2020-07-07,Napa,55,140530,624,459,0,459,4
2020-07-07,Nevada,57,99092,198,150,4,154,1
2020-07-07,Orange,59,3164182,29424,21741,310,22051,373
2020-07-07,Placer,61,380077,1265,930,3,933,11
2020-07-07,Plumas,63,18699,17,12,0,12,0
2020-07-07,Riverside,65,2383286,29476,23279,10,23289,499
2020-07-07,Sacramento,67,1510023,6319,4592,6,4598,76
2020-07-07,San Benito,69,59416,380,274,0,274,2
2020-07-07,San Bernardino,71,2135413,24830,16004,12,16016,277
2020-07-07,San Diego,73,3302833,22006,17580,0,17580,399
2020-07-07,San Francisco,75,870044,4788,4045,6,4051,50
2020-07-07,San Joaquin,77,732212,7745,5547,5,5552,59
2020-07-07,San Luis Obispo,79,281455,1155,795,3,798,2
2020-07-07,San Mateo,81,765935,4278,3691,4,3695,106
2020-07-07,Santa Barbara,83,443738,4993,3866,57,3923,27
2020-07-07,Santa Clara,85,1922200,7125,5438,9,5447,164
2020-07-07,Santa Cruz,87,273765,614,502,4,506,2
2020-07-07,Shasta,89,179085,268,144,1,145,6
2020-07-07,Sierra,91,2930,1,1,0,1,0
2020-07-07,Siskiyou,93,43540,53,30,0,30,0
2020-07-07,Solano,95,438530,2528,1776,9,1785,22
2020-07-07,Sonoma,97,501317,1986,1473,4,1477,8
2020-07-07,Stanislaus,99,539301,6011,4101,6,4107,46
2020-07-07,Sutter,101,95872,375,273,0,273,2
2020-07-07,Tehama,103,63373,125,95,4,99,1
2020-07-07,Trinity,105,12862,5,2,3,5,0
2020-07-07,Tulare,107,460477,6767,5189,8,5197,137
2020-07-07,Tuolumne,109,53932,75,40,18,58,0
2020-07-07,Ventura,111,848112,5472,3992,11,4003,46
2020-07-07,Yolo,113,214977,1027,706,3,709,26
2020-07-07,Yuba,115,75493,160,138,0,138,1
2020-07-06,Alameda,1,1643700,8396,6970,9,6979,141
2020-07-06,Alpine,3,1148,2,1,0,1,0
2020-07-06,Amador,5,37829,39,33,0,33,0
2020-07-06,Butte,7,227075,416,257,3,260,2
2020-07-06,Calaveras,9,45235,71,45,0,45,0
2020-07-06,Colusa,11,21464,134,80,0,80,0
2020-07-06,Contra Costa,13,1133247,5244,3901,4,3905,83
2020-07-06,Del Norte,15,27424,60,57,0,57,0
2020-07-06,El Dorado,17,186661,391,232,0,232,0
2020-07-06,Fresno,19,978130,12325,6364,68,6432,82
2020-07-06,Glenn,21,27897,198,129,0,129,0
2020-07-06,Humboldt,23,135768,188,148,0,148,3
2020-07-06,Imperial,25,180216,8741,6443,6,6449,47
2020-07-06,Inyo,27,18085,36,32,0,32,1
2020-07-06,Kern,29,883053,12656,5491,37,5528,82
2020-07-06,Kings,31,150075,3120,2583,9,2592,33
2020-07-06,Lake,33,64148,121,93,0,93,1
2020-07-06,Lassen,35,31185,261,219,1,220,0
2020-07-06,Los Angeles,37,10098052,136623,116707,99,116806,3541
2020-07-06,Madera,39,155013,1323,734,1,735,4
2020-07-06,Marin,41,260295,3621,2136,4,2140,17
2020-07-06,Mariposa,43,17540,36,31,0,31,1
2020-07-06,Mendocino,45,87422,106,72,0,72,0
2020-07-06,Merced,47,269075,2491,1396,2,1398,10
2020-07-06,Modoc,49,8938,1,0,0,0,0
2020-07-06,Mono,51,14174,58,40,0,40,1
2020-07-06,Monterey,53,433212,2794,2078,3,2081,15
2020-07-06,Napa,55,140530,606,454,0,454,4
2020-07-06,Nevada,57,99092,192,146,4,150,1
2020-07-06,Orange,59,3164182,28364,20167,272,20439,372
2020-07-06,Placer,61,380077,1205,904,3,907,11
2020-07-06,Plumas,63,18699,17,11,0,11,0
2020-07-06,Riverside,65,2383286,28425,22485,10,22495,477
2020-07-06,Sacramento,67,1510023,5967,4420,6,4426,71
2020-07-06,San Benito,69,59416,365,264,0,264,2
2020-07-06,San Bernardino,71,2135413,23975,15346,12,15358,272
2020-07-06,San Diego,73,3302833,21293,17002,0,17002,387
2020-07-06,San Francisco,75,870044,4667,3861,4,3865,50
2020-07-06,San Joaquin,77,732212,7375,5104,5,5109,57
2020-07-06,San Luis Obispo,79,281455,1097,751,3,754,2
2020-07-06,San Mateo,81,765935,4186,3650,4,3654,106
2020-07-06,Santa Barbara,83,443738,4856,3763,56,3819,27
2020-07-06,Santa Clara,85,1922200,6855,5369,9,5378,165
2020-07-06,Santa Cruz,87,273765,592,466,3,469,2
2020-07-06,Shasta,89,179085,258,143,1,144,6
2020-07-06,Sierra,91,2930,1,1,0,1,0
2020-07-06,Siskiyou,93,43540,49,30,0,30,0
2020-07-06,Solano,95,438530,2395,1668,9,1677,22
2020-07-06,Sonoma,97,501317,1922,1369,4,1373,8
2020-07-06,Stanislaus,99,539301,5611,3983,6,3989,46
2020-07-06,Sutter,101,95872,348,250,0,250,2
2020-07-06,Tehama,103,63373,122,95,4,99,1
2020-07-06,Trinity,105,12862,4,2,3,5,0
2020-07-06,Tulare,107,460477,6563,5039,6,5045,136
2020-07-06,Tuolumne,109,53932,72,30,17,47,0
2020-07-06,Ventura,111,848112,5278,3912,11,3923,44
2020-07-06,Yolo,113,214977,971,685,3,688,26
2020-07-06,Yuba,115,75493,146,124,0,124,1
2020-07-05,Alameda,1,1643700,8144,6861,9,6870,141
2020-07-05,Alpine,3,1148,2,1,0,1,0
2020-07-05,Amador,5,37829,37,31,0,31,0
2020-07-05,Butte,7,227075,381,248,3,251,2
2020-07-05,Calaveras,9,45235,69,45,0,45,0
2020-07-05,Colusa,11,21464,124,79,0,79,0
2020-07-05,Contra Costa,13,1133247,5004,3665,3,3668,80
2020-07-05,Del Norte,15,27424,60,57,0,57,0
2020-07-05,El Dorado,17,186661,373,227,0,227,0
2020-07-05,Fresno,19,978130,11760,6186,66,6252,82
2020-07-05,Glenn,21,27897,195,129,0,129,0
2020-07-05,Humboldt,23,135768,184,147,0,147,3
2020-07-05,Imperial,25,180216,8607,6441,6,6447,47
2020-07-05,Inyo,27,18085,35,32,0,32,1
2020-07-05,Kern,29,883053,11945,5351,37,5388,82
2020-07-05,Kings,31,150075,3037,2546,8,2554,31
2020-07-05,Lake,33,64148,121,92,0,92,1
2020-07-05,Lassen,35,31185,255,219,1,220,0
2020-07-05,Los Angeles,37,10098052,133401,115133,93,115226,3495
2020-07-05,Madera,39,155013,1244,564,1,565,4
2020-07-05,Marin,41,260295,3437,2080,4,2084,17
2020-07-05,Mariposa,43,17540,36,31,0,31,1
2020-07-05,Mendocino,45,87422,103,72,0,72,0
2020-07-05,Merced,47,269075,2347,1340,2,1342,10
2020-07-05,Modoc,49,8938,1,0,0,0,0
2020-07-05,Mono,51,14174,54,39,0,39,1
2020-07-05,Monterey,53,433212,2691,1994,3,1997,15
2020-07-05,Napa,55,140530,576,450,0,450,4
2020-07-05,Nevada,57,99092,186,141,4,145,1
2020-07-05,Orange,59,3164182,27422,19430,257,19687,372
2020-07-05,Placer,61,380077,1151,855,3,858,11
2020-07-05,Plumas,63,18699,16,11,0,11,0
2020-07-05,Riverside,65,2383286,27566,21511,10,21521,474
2020-07-05,Sacramento,67,1510023,5650,4265,2,4267,71
2020-07-05,San Benito,69,59416,346,258,0,258,2
2020-07-05,San Bernardino,71,2135413,23097,15026,12,15038,270
2020-07-05,San Diego,73,3302833,20605,16728,0,16728,387
2020-07-05,San Francisco,75,870044,4549,3861,4,3865,50
2020-07-05,San Joaquin,77,732212,7056,5015,5,5020,57
2020-07-05,San Luis Obispo,79,281455,1017,730,3,733,2
2020-07-05,San Mateo,81,765935,4075,3575,4,3579,106
2020-07-05,Santa Barbara,83,443738,4709,3671,53,3724,27
2020-07-05,Santa Clara,85,1922200,6566,5237,9,5246,162
2020-07-05,Santa Cruz,87,273765,574,467,1,468,2
2020-07-05,Shasta,89,179085,252,138,1,139,6
2020-07-05,Sierra,91,2930,1,1,0,1,0
2020-07-05,Siskiyou,93,43540,45,30,0,30,0
2020-07-05,Solano,95,438530,2275,1547,9,1556,22
2020-07-05,Sonoma,97,501317,1841,1369,4,1373,8
2020-07-05,Stanislaus,99,539301,5281,3777,6,3783,45
2020-07-05,Sutter,101,95872,320,241,0,241,2
2020-07-05,Tehama,103,63373,120,95,4,99,1
2020-07-05,Trinity,105,12862,4,2,3,5,0
2020-07-05,Tulare,107,460477,6304,4981,4,4985,135
2020-07-05,Tuolumne,109,53932,67,30,16,46,0
2020-07-05,Ventura,111,848112,5075,3866,11,3877,44
2020-07-05,Yolo,113,214977,931,644,3,647,26
2020-07-05,Yuba,115,75493,136,115,0,115,1
2020-07-04,Alameda,1,1643700,8032,6737,9,6746,141
2020-07-04,Alpine,3,1148,2,1,0,1,0
2020-07-04,Amador,5,37829,36,31,0,31,0
2020-07-04,Butte,7,227075,363,224,3,227,2
2020-07-04,Calaveras,9,45235,69,45,0,45,0
2020-07-04,Colusa,11,21464,123,76,0,76,0
2020-07-04,Contra Costa,13,1133247,4857,3583,3,3586,80
2020-07-04,Del Norte,15,27424,60,50,0,50,0
2020-07-04,El Dorado,17,186661,353,211,0,211,0
2020-07-04,Fresno,19,978130,11444,5999,64,6063,82
2020-07-04,Glenn,21,27897,188,128,0,128,0
2020-07-04,Humboldt,23,135768,177,144,0,144,3
2020-07-04,Imperial,25,180216,8559,6441,6,6447,47
2020-07-04,Inyo,27,18085,35,32,0,32,1
2020-07-04,Kern,29,883053,11640,5231,37,5268,81
2020-07-04,Kings,31,150075,2994,2509,8,2517,31
2020-07-04,Lake,33,64148,113,86,0,86,1
2020-07-04,Lassen,35,31185,255,219,1,220,0
2020-07-04,Los Angeles,37,10098052,131585,107256,82,107338,3462
2020-07-04,Madera,39,155013,1198,568,1,569,4
2020-07-04,Marin,41,260295,3408,1962,4,1966,17
2020-07-04,Mariposa,43,17540,36,28,0,28,1
2020-07-04,Mendocino,45,87422,103,72,0,72,0
2020-07-04,Merced,47,269075,2244,1252,2,1254,10
2020-07-04,Modoc,49,8938,1,0,0,0,0
2020-07-04,Mono,51,14174,54,37,0,37,1
2020-07-04,Monterey,53,433212,2611,1878,3,1881,15
2020-07-04,Napa,55,140530,567,426,0,426,4
2020-07-04,Nevada,57,99092,183,125,4,129,1
2020-07-04,Orange,59,3164182,26990,19247,242,19489,372
2020-07-04,Placer,61,380077,1113,796,3,799,11
2020-07-04,Plumas,63,18699,16,11,0,11,0
2020-07-04,Riverside,65,2383286,27198,21508,10,21518,474
2020-07-04,Sacramento,67,1510023,5483,4039,2,4041,71
2020-07-04,San Benito,69,59416,333,255,0,255,2
2020-07-04,San Bernardino,71,2135413,22670,14636,12,14648,270
2020-07-04,San Diego,73,3302833,20145,16166,0,16166,387
2020-07-04,San Francisco,75,870044,4458,3861,4,3865,50
2020-07-04,San Joaquin,77,732212,6843,4807,5,4812,57
2020-07-04,San Luis Obispo,79,281455,977,699,3,702,2
2020-07-04,San Mateo,81,765935,4012,3532,4,3536,106
2020-07-04,Santa Barbara,83,443738,4634,3520,51,3571,27
2020-07-04,Santa Clara,85,1922200,6375,5045,9,5054,161
2020-07-04,Santa Cruz,87,273765,564,466,1,467,2
2020-07-04,Shasta,89,179085,249,135,1,136,6
2020-07-04,Sierra,91,2930,1,1,0,1,0
2020-07-04,Siskiyou,93,43540,38,30,0,30,0
2020-07-04,Solano,95,438530,2239,1548,9,1557,22
2020-07-04,Sonoma,97,501317,1815,1370,4,1374,8
2020-07-04,Stanislaus,99,539301,5124,3572,6,3578,44
2020-07-04,Sutter,101,95872,301,225,0,225,2
2020-07-04,Tehama,103,63373,117,92,4,96,1
2020-07-04,Trinity,105,12862,4,2,3,5,0
2020-07-04,Tulare,107,460477,6192,4802,3,4805,135
2020-07-04,Tuolumne,109,53932,63,30,16,46,0
2020-07-04,Ventura,111,848112,4951,3687,11,3698,44
2020-07-04,Yolo,113,214977,906,615,3,618,26
2020-07-04,Yuba,115,75493,129,102,0,102,1
2020-07-03,Alameda,1,1643700,7911,6486,9,6495,141
2020-07-03,Alpine,3,1148,2,1,0,1,0
2020-07-03,Amador,5,37829,36,25,0,25,0
2020-07-03,Butte,7,227075,351,212,3,215,2
2020-07-03,Calaveras,9,45235,69,44,0,44,0
2020-07-03,Colusa,11,21464,117,70,0,70,0
2020-07-03,Contra Costa,13,1133247,4723,3447,3,3450,78
2020-07-03,Del Norte,15,27424,60,50,0,50,0
2020-07-03,El Dorado,17,186661,341,201,0,201,0
2020-07-03,Fresno,19,978130,11140,5783,62,5845,81
2020-07-03,Glenn,21,27897,183,122,0,122,0
2020-07-03,Humboldt,23,135768,173,143,0,143,3
2020-07-03,Imperial,25,180216,8511,6345,6,6351,47
2020-07-03,Inyo,27,18085,35,32,0,32,1
2020-07-03,Kern,29,883053,11379,5213,37,5250,81
2020-07-03,Kings,31,150075,2958,2492,8,2500,31
2020-07-03,Lake,33,64148,106,83,0,83,0
2020-07-03,Lassen,35,31185,255,219,1,220,0
2020-07-03,Los Angeles,37,10098052,130068,107236,78,107314,3461
2020-07-03,Madera,39,155013,1153,565,1,566,4
2020-07-03,Marin,41,260295,3379,1776,4,1780,17
2020-07-03,Mariposa,43,17540,36,28,0,28,1
2020-07-03,Mendocino,45,87422,102,72,0,72,0
2020-07-03,Merced,47,269075,2178,1188,2,1190,10
2020-07-03,Modoc,49,8938,1,0,0,0,0
2020-07-03,Mono,51,14174,54,37,0,37,1
2020-07-03,Monterey,53,433212,2540,1804,3,1807,15
2020-07-03,Napa,55,140530,549,388,0,388,4
2020-07-03,Nevada,57,99092,182,125,4,129,1
2020-07-03,Orange,59,3164182,26599,18819,233,19052,366
2020-07-03,Placer,61,380077,1084,745,3,748,11
2020-07-03,Plumas,63,18699,16,11,0,11,0
2020-07-03,Riverside,65,2383286,26892,21171,10,21181,472
2020-07-03,Sacramento,67,1510023,5347,3711,2,3713,71
2020-07-03,San Benito,69,59416,326,243,0,243,2
2020-07-03,San Bernardino,71,2135413,22281,14040,12,14052,269
2020-07-03,San Diego,73,3302833,19689,15698,0,15698,387
2020-07-03,San Francisco,75,870044,4411,3781,4,3785,50
2020-07-03,San Joaquin,77,732212,6705,4416,4,4420,56
2020-07-03,San Luis Obispo,79,281455,942,676,3,679,2
2020-07-03,San Mateo,81,765935,3955,3439,4,3443,106
2020-07-03,Santa Barbara,83,443738,4547,3406,48,3454,27
2020-07-03,Santa Clara,85,1922200,6264,4820,9,4829,161
2020-07-03,Santa Cruz,87,273765,551,436,1,437,2
2020-07-03,Shasta,89,179085,241,113,1,114,6
2020-07-03,Sierra,91,2930,1,1,0,1,0
2020-07-03,Siskiyou,93,43540,35,30,0,30,0
2020-07-03,Solano,95,438530,2195,1496,8,1504,22
2020-07-03,Sonoma,97,501317,1767,1282,4,1286,8
2020-07-03,Stanislaus,99,539301,4999,3021,6,3027,43
2020-07-03,Sutter,101,95872,291,205,0,205,2
2020-07-03,Tehama,103,63373,115,89,4,93,1
2020-07-03,Trinity,105,12862,4,2,3,5,0
2020-07-03,Tulare,107,460477,6078,4656,3,4659,134
2020-07-03,Tuolumne,109,53932,61,27,16,43,0
2020-07-03,Ventura,111,848112,4855,3536,10,3546,44
2020-07-03,Yolo,113,214977,872,586,3,589,25
2020-07-03,Yuba,115,75493,124,96,0,96,1
2020-07-02,Alameda,1,1643700,7785,6386,9,6395,139
2020-07-02,Alpine,3,1148,2,1,0,1,0
2020-07-02,Amador,5,37829,35,23,0,23,0
2020-07-02,Butte,7,227075,334,199,3,202,2
2020-07-02,Calaveras,9,45235,65,42,0,42,0
2020-07-02,Colusa,11,21464,109,60,0,60,0
2020-07-02,Contra Costa,13,1133247,4541,3347,3,3350,77
2020-07-02,Del Norte,15,27424,59,50,0,50,0
2020-07-02,El Dorado,17,186661,330,193,0,193,0
2020-07-02,Fresno,19,978130,10683,5402,61,5463,78
2020-07-02,Glenn,21,27897,177,114,0,114,0
2020-07-02,Humboldt,23,135768,169,138,0,138,3
2020-07-02,Imperial,25,180216,8408,6236,6,6242,47
2020-07-02,Inyo,27,18085,35,29,0,29,1
2020-07-02,Kern,29,883053,10844,5036,35,5071,78
2020-07-02,Kings,31,150075,2908,2419,8,2427,31
2020-07-02,Lake,33,64148,103,81,0,81,0
2020-07-02,Lassen,35,31185,253,218,1,219,0
2020-07-02,Los Angeles,37,10098052,128050,107144,55,107199,3458
2020-07-02,Madera,39,155013,1085,548,1,549,4
2020-07-02,Marin,41,260295,3294,1706,4,1710,17
2020-07-02,Mariposa,43,17540,35,28,0,28,1
2020-07-02,Mendocino,45,87422,98,71,0,71,0
2020-07-02,Merced,47,269075,2081,1122,2,1124,10
2020-07-02,Modoc,49,8938,1,0,0,0,0
2020-07-02,Mono,51,14174,54,37,0,37,1
2020-07-02,Monterey,53,433212,2481,1796,3,1799,15
2020-07-02,Napa,55,140530,532,352,0,352,4
2020-07-02,Nevada,57,99092,176,118,4,122,1
2020-07-02,Orange,59,3164182,25837,17056,220,17276,360
2020-07-02,Placer,61,380077,1052,740,3,743,11
2020-07-02,Plumas,63,18699,15,8,0,8,0
2020-07-02,Riverside,65,2383286,26321,20253,10,20263,458
2020-07-02,Sacramento,67,1510023,5113,3587,2,3589,70
2020-07-02,San Benito,69,59416,318,236,0,236,2
2020-07-02,San Bernardino,71,2135413,21745,13185,12,13197,260
2020-07-02,San Diego,73,3302833,19227,15208,0,15208,377
2020-07-02,San Francisco,75,870044,4316,3676,4,3680,50
2020-07-02,San Joaquin,77,732212,6357,4243,4,4247,56
2020-07-02,San Luis Obispo,79,281455,897,659,3,662,2
2020-07-02,San Mateo,81,765935,3874,3390,4,3394,107
2020-07-02,Santa Barbara,83,443738,4447,3385,46,3431,27
2020-07-02,Santa Clara,85,1922200,6138,4722,9,4731,160
2020-07-02,Santa Cruz,87,273765,528,414,1,415,2
2020-07-02,Shasta,89,179085,238,110,1,111,5
2020-07-02,Sierra,91,2930,1,1,0,1,0
2020-07-02,Siskiyou,93,43540,35,30,0,30,0
2020-07-02,Solano,95,438530,2112,1429,8,1437,21
2020-07-02,Sonoma,97,501317,1710,1244,4,1248,6
2020-07-02,Stanislaus,99,539301,4830,2850,6,2856,41
2020-07-02,Sutter,101,95872,279,195,0,195,2
2020-07-02,Tehama,103,63373,113,86,4,90,1
2020-07-02,Trinity,105,12862,4,2,3,5,0
2020-07-02,Tulare,107,460477,5912,4559,2,4561,132
2020-07-02,Tuolumne,109,53932,58,23,14,37,0
2020-07-02,Ventura,111,848112,4699,3394,10,3404,42
2020-07-02,Yolo,113,214977,840,554,3,557,24
2020-07-02,Yuba,115,75493,114,93,0,93,1
2020-07-01,Alameda,1,1643700,7563,6125,9,6134,137
2020-07-01,Alpine,3,1148,2,1,0,1,0
2020-07-01,Amador,5,37829,34,22,0,22,0
2020-07-01,Butte,7,227075,309,185,3,188,2
2020-07-01,Calaveras,9,45235,63,37,0,37,0
2020-07-01,Colusa,11,21464,103,53,0,53,0
2020-07-01,Contra Costa,13,1133247,4329,3259,3,3262,76
2020-07-01,Del Norte,15,27424,59,50,0,50,0
2020-07-01,El Dorado,17,186661,303,183,0,183,0
2020-07-01,Fresno,19,978130,10250,5111,58,5169,76
2020-07-01,Glenn,21,27897,170,110,0,110,0
2020-07-01,Humboldt,23,135768,164,134,0,134,3
2020-07-01,Imperial,25,180216,8310,6150,6,6156,46
2020-07-01,Inyo,27,18085,34,30,0,30,1
2020-07-01,Kern,29,883053,10213,4853,32,4885,78
2020-07-01,Kings,31,150075,2840,2360,8,2368,30
2020-07-01,Lake,33,64148,102,75,0,75,0
2020-07-01,Lassen,35,31185,252,217,1,218,0
2020-07-01,Los Angeles,37,10098052,124849,105325,44,105369,3408
2020-07-01,Madera,39,155013,1044,519,1,520,4
2020-07-01,Marin,41,260295,3136,1636,4,1640,17
2020-07-01,Mariposa,43,17540,35,29,0,29,1
2020-07-01,Mendocino,45,87422,94,70,0,70,0
2020-07-01,Merced,47,269075,1981,1052,2,1054,10
2020-07-01,Modoc,49,8938,1,0,0,0,0
2020-07-01,Mono,51,14174,51,37,0,37,1
2020-07-01,Monterey,53,433212,2374,1703,3,1706,15
2020-07-01,Napa,55,140530,509,347,0,347,4
2020-07-01,Nevada,57,99092,166,115,4,119,1
2020-07-01,Orange,59,3164182,24954,15662,198,15860,343
2020-07-01,Placer,61,380077,1000,713,3,716,11
2020-07-01,Plumas,63,18699,13,8,0,8,0
2020-07-01,Riverside,65,2383286,25480,19537,10,19547,457
2020-07-01,Sacramento,67,1510023,4862,3425,2,3427,64
2020-07-01,San Benito,69,59416,309,219,0,219,2
2020-07-01,San Bernardino,71,2135413,20846,12712,11,12723,253
2020-07-01,San Diego,73,3302833,18669,14624,0,14624,372
2020-07-01,San Francisco,75,870044,4223,3626,4,3630,50
2020-07-01,San Joaquin,77,732212,5998,3990,4,3994,54
2020-07-01,San Luis Obispo,79,281455,871,613,3,616,1
2020-07-01,San Mateo,81,765935,3812,3326,4,3330,84
2020-07-01,Santa Barbara,83,443738,4327,3268,44,3312,27
2020-07-01,Santa Clara,85,1922200,5951,4547,8,4555,159
2020-07-01,Santa Cruz,87,273765,507,398,0,398,2
2020-07-01,Shasta,89,179085,233,104,1,105,5
2020-07-01,Sierra,91,2930,1,1,0,1,0
2020-07-01,Siskiyou,93,43540,35,28,0,28,0
2020-07-01,Solano,95,438530,2023,1350,8,1358,21
2020-07-01,Sonoma,97,501317,1614,1178,4,1182,6
2020-07-01,Stanislaus,99,539301,4551,2619,6,2625,41
2020-07-01,Sutter,101,95872,266,188,0,188,2
2020-07-01,Tehama,103,63373,106,80,4,84,1
2020-07-01,Trinity,105,12862,4,2,2,4,0
2020-07-01,Tulare,107,460477,5734,4359,2,4361,128
2020-07-01,Tuolumne,109,53932,55,17,1,18,0
2020-07-01,Ventura,111,848112,4556,3224,8,3232,41
2020-07-01,Yolo,113,214977,790,526,3,529,24
2020-07-01,Yuba,115,75493,109,57,0,57,1
2020-06-30,Alameda,1,1643700,7314,5959,7,5966,137
2020-06-30,Alpine,3,1148,2,1,0,1,0
2020-06-30,Amador,5,37829,34,21,0,21,0
2020-06-30,Butte,7,227075,292,163,3,166,2
2020-06-30,Calaveras,9,45235,58,31,0,31,0
2020-06-30,Colusa,11,21464,94,33,0,33,0
2020-06-30,Contra Costa,13,1133247,4123,3140,3,3143,75
2020-06-30,Del Norte,15,27424,59,48,0,48,0
2020-06-30,El Dorado,17,186661,290,175,0,175,0
2020-06-30,Fresno,19,978130,9803,4826,54,4880,75
2020-06-30,Glenn,21,27897,165,96,0,96,0
2020-06-30,Humboldt,23,135768,160,132,0,132,3
2020-06-30,Imperial,25,180216,8213,5968,6,5974,45
2020-06-30,Inyo,27,18085,34,30,0,30,1
2020-06-30,Kern,29,883053,9564,4721,28,4749,75
2020-06-30,Kings,31,150075,2791,2315,5,2320,30
2020-06-30,Lake,33,64148,94,56,0,56,0
2020-06-30,Lassen,35,31185,245,215,1,216,0
2020-06-30,Los Angeles,37,10098052,121262,103640,41,103681,3378
2020-06-30,Madera,39,155013,987,475,1,476,4
2020-06-30,Marin,41,260295,3066,1614,4,1618,17
2020-06-30,Mariposa,43,17540,34,27,0,27,1
2020-06-30,Mendocino,45,87422,89,65,0,65,0
2020-06-30,Merced,47,269075,1844,970,2,972,10
2020-06-30,Modoc,49,8938,1,0,0,0,0
2020-06-30,Mono,51,14174,49,36,0,36,1
2020-06-30,Monterey,53,433212,2276,1657,3,1660,15
2020-06-30,Napa,55,140530,484,342,0,342,4
2020-06-30,Nevada,57,99092,158,113,4,117,1
2020-06-30,Orange,59,3164182,24026,14354,188,14542,335
2020-06-30,Placer,61,380077,975,667,3,670,11
2020-06-30,Plumas,63,18699,12,8,0,8,0
2020-06-30,Riverside,65,2383286,24763,18656,10,18666,449
2020-06-30,Sacramento,67,1510023,4572,3246,2,3248,64
2020-06-30,San Benito,69,59416,298,200,0,200,2
2020-06-30,San Bernardino,71,2135413,19862,12375,11,12386,249
2020-06-30,San Diego,73,3302833,17966,14150,0,14150,365
2020-06-30,San Francisco,75,870044,4118,3555,4,3559,50
2020-06-30,San Joaquin,77,732212,5624,3744,4,3748,52
2020-06-30,San Luis Obispo,79,281455,835,583,3,586,1
2020-06-30,San Mateo,81,765935,3735,3268,4,3272,84
2020-06-30,Santa Barbara,83,443738,4210,3102,38,3140,25
2020-06-30,Santa Clara,85,1922200,5751,4346,8,4354,157
2020-06-30,Santa Cruz,87,273765,483,379,0,379,2
2020-06-30,Shasta,89,179085,217,100,1,101,5
2020-06-30,Sierra,91,2930,1,1,0,1,0
2020-06-30,Siskiyou,93,43540,34,26,0,26,0
2020-06-30,Solano,95,438530,1931,1256,8,1264,21
2020-06-30,Sonoma,97,501317,1549,1122,4,1126,6
2020-06-30,Stanislaus,99,539301,4255,2578,6,2584,41
2020-06-30,Sutter,101,95872,243,168,0,168,2
2020-06-30,Tehama,103,63373,104,75,4,79,1
2020-06-30,Trinity,105,12862,4,2,2,4,0
2020-06-30,Tulare,107,460477,5527,4207,2,4209,117
2020-06-30,Tuolumne,109,53932,51,16,1,17,0
2020-06-30,Ventura,111,848112,4422,3030,8,3038,40
2020-06-30,Yolo,113,214977,752,515,3,518,24
2020-06-30,Yuba,115,75493,105,55,0,55,1
2020-06-29,Alameda,1,1643700,7104,5766,7,5773,135
2020-06-29,Alpine,3,1148,2,1,0,1,0
2020-06-29,Amador,5,37829,31,20,0,20,0
2020-06-29,Butte,7,227075,271,157,3,160,2
2020-06-29,Calaveras,9,45235,56,30,0,30,0
2020-06-29,Colusa,11,21464,89,17,0,17,0
2020-06-29,Contra Costa,13,1133247,3960,2976,2,2978,75
2020-06-29,Del Norte,15,27424,59,47,0,47,0
2020-06-29,El Dorado,17,186661,276,163,0,163,0
2020-06-29,Fresno,19,978130,9456,4531,53,4584,74
2020-06-29,Glenn,21,27897,156,77,0,77,0
2020-06-29,Humboldt,23,135768,159,128,0,128,3
2020-06-29,Imperial,25,180216,8082,5512,6,5518,45
2020-06-29,Inyo,27,18085,33,29,0,29,1
2020-06-29,Kern,29,883053,8901,4613,26,4639,73
2020-06-29,Kings,31,150075,2727,2280,5,2285,20
2020-06-29,Lake,33,64148,87,53,0,53,0
2020-06-29,Lassen,35,31185,237,77,1,78,0
2020-06-29,Los Angeles,37,10098052,118214,100846,35,100881,3337
2020-06-29,Madera,39,155013,930,422,1,423,4
2020-06-29,Marin,41,260295,2990,1517,4,1521,17
2020-06-29,Mariposa,43,17540,32,25,0,25,1
2020-06-29,Mendocino,45,87422,86,63,0,63,0
2020-06-29,Merced,47,269075,1738,848,2,850,10
2020-06-29,Modoc,49,8938,1,0,0,0,0
2020-06-29,Mono,51,14174,47,35,0,35,1
2020-06-29,Monterey,53,433212,2204,1614,3,1617,14
2020-06-29,Napa,55,140530,463,317,0,317,4
2020-06-29,Nevada,57,99092,155,107,3,110,1
2020-06-29,Orange,59,3164182,23034,13682,172,13854,324
2020-06-29,Placer,61,380077,934,628,3,631,11
2020-06-29,Plumas,63,18699,12,6,0,6,0
2020-06-29,Riverside,65,2383286,23729,17683,10,17693,432
2020-06-29,Sacramento,67,1510023,4290,2985,2,2987,62
2020-06-29,San Benito,69,59416,283,193,0,193,2
2020-06-29,San Bernardino,71,2135413,18899,11643,11,11654,245
2020-06-29,San Diego,73,3302833,17390,13834,0,13834,361
2020-06-29,San Francisco,75,870044,4041,3389,4,3393,50
2020-06-29,San Joaquin,77,732212,5266,3202,4,3206,52
2020-06-29,San Luis Obispo,79,281455,801,544,3,547,1
2020-06-29,San Mateo,81,765935,3681,3170,4,3174,84
2020-06-29,Santa Barbara,83,443738,4100,2933,37,2970,25
2020-06-29,Santa Clara,85,1922200,5579,4231,8,4239,157
2020-06-29,Santa Cruz,87,273765,465,348,0,348,2
2020-06-29,Shasta,89,179085,209,94,1,95,5
2020-06-29,Sierra,91,2930,1,1,0,1,0
2020-06-29,Siskiyou,93,43540,34,25,0,25,0
2020-06-29,Solano,95,438530,1829,1077,8,1085,21
2020-06-29,Sonoma,97,501317,1477,1103,4,1107,5
2020-06-29,Stanislaus,99,539301,4049,2400,5,2405,36
2020-06-29,Sutter,101,95872,221,152,0,152,2
2020-06-29,Tehama,103,63373,100,63,4,67,1
2020-06-29,Trinity,105,12862,4,2,2,4,0
2020-06-29,Tulare,107,460477,5373,3906,2,3908,117
2020-06-29,Tuolumne,109,53932,47,16,1,17,0
2020-06-29,Ventura,111,848112,4275,2794,8,2802,40
2020-06-29,Yolo,113,214977,719,483,3,486,24
2020-06-29,Yuba,115,75493,92,55,0,55,1
2020-06-28,Alameda,1,1643700,6845,5698,7,5705,135
2020-06-28,Alpine,3,1148,2,1,0,1,0
2020-06-28,Amador,5,37829,29,20,0,20,0
2020-06-28,Butte,7,227075,252,150,3,153,2
2020-06-28,Calaveras,9,45235,51,30,0,30,0
2020-06-28,Colusa,11,21464,74,17,0,17,0
2020-06-28,Contra Costa,13,1133247,3770,2803,2,2805,73
2020-06-28,Del Norte,15,27424,58,47,0,47,0
2020-06-28,El Dorado,17,186661,264,162,0,162,0
2020-06-28,Fresno,19,978130,9095,4365,53,4418,74
2020-06-28,Glenn,21,27897,148,77,0,77,0
2020-06-28,Humboldt,23,135768,156,127,0,127,3
2020-06-28,Imperial,25,180216,7893,5513,6,5519,45
2020-06-28,Inyo,27,18085,33,29,0,29,1
2020-06-28,Kern,29,883053,8348,4541,24,4565,72
2020-06-28,Kings,31,150075,2668,2234,5,2239,18
2020-06-28,Lake,33,64148,83,53,0,53,0
2020-06-28,Lassen,35,31185,237,77,1,78,0
2020-06-28,Los Angeles,37,10098052,115009,98003,31,98034,3316
2020-06-28,Madera,39,155013,883,424,1,425,4
2020-06-28,Marin,41,260295,2644,1473,4,1477,17
2020-06-28,Mariposa,43,17540,32,24,0,24,1
2020-06-28,Mendocino,45,87422,84,63,0,63,0
2020-06-28,Merced,47,269075,1625,814,2,816,10
2020-06-28,Modoc,49,8938,1,0,0,0,0
2020-06-28,Mono,51,14174,47,35,0,35,1
2020-06-28,Monterey,53,433212,2122,1560,3,1563,13
2020-06-28,Napa,55,140530,429,307,0,307,4
2020-06-28,Nevada,57,99092,144,102,3,105,1
2020-06-28,Orange,59,3164182,22059,13213,154,13367,324
2020-06-28,Placer,61,380077,891,618,3,621,11
2020-06-28,Plumas,63,18699,11,6,0,6,0
2020-06-28,Riverside,65,2383286,22902,16848,9,16857,432
2020-06-28,Sacramento,67,1510023,4062,2803,2,2805,63
2020-06-28,San Benito,69,59416,272,190,0,190,2
2020-06-28,San Bernardino,71,2135413,18145,11344,10,11354,245
2020-06-28,San Diego,73,3302833,16845,13333,0,13333,361
2020-06-28,San Francisco,75,870044,3962,3388,4,3392,50
2020-06-28,San Joaquin,77,732212,4930,3201,4,3205,52
2020-06-28,San Luis Obispo,79,281455,762,531,3,534,1
2020-06-28,San Mateo,81,765935,3603,3124,4,3128,84
2020-06-28,Santa Barbara,83,443738,3955,2872,35,2907,25
2020-06-28,Santa Clara,85,1922200,5419,4131,8,4139,156
2020-06-28,Santa Cruz,87,273765,442,349,0,349,2
2020-06-28,Shasta,89,179085,196,89,0,89,5
2020-06-28,Sierra,91,2930,1,1,0,1,0
2020-06-28,Siskiyou,93,43540,34,25,0,25,0
2020-06-28,Solano,95,438530,1754,1077,8,1085,21
2020-06-28,Sonoma,97,501317,1423,1084,4,1088,5
2020-06-28,Stanislaus,99,539301,3843,2376,5,2381,36
2020-06-28,Sutter,101,95872,195,145,0,145,2
2020-06-28,Tehama,103,63373,93,63,4,67,1
2020-06-28,Trinity,105,12862,4,2,2,4,0
2020-06-28,Tulare,107,460477,5207,3812,2,3814,117
2020-06-28,Tuolumne,109,53932,42,14,1,15,0
2020-06-28,Ventura,111,848112,4117,2650,8,2658,40
2020-06-28,Yolo,113,214977,684,468,3,471,24
2020-06-28,Yuba,115,75493,88,39,0,39,1
2020-06-27,Alameda,1,1643700,6750,5581,7,5588,135
2020-06-27,Alpine,3,1148,2,1,0,1,0
2020-06-27,Amador,5,37829,27,20,0,20,0
2020-06-27,Butte,7,227075,244,137,3,140,2
2020-06-27,Calaveras,9,45235,49,30,0,30,0
2020-06-27,Colusa,11,21464,68,17,0,17,0
2020-06-27,Contra Costa,13,1133247,3675,2717,1,2718,72
2020-06-27,Del Norte,15,27424,58,47,0,47,0
2020-06-27,El Dorado,17,186661,258,159,0,159,0
2020-06-27,Fresno,19,978130,8849,4238,53,4291,74
2020-06-27,Glenn,21,27897,144,77,0,77,0
2020-06-27,Humboldt,23,135768,154,127,0,127,3
2020-06-27,Imperial,25,180216,7831,5513,6,5519,45
2020-06-27,Inyo,27,18085,33,29,0,29,1
2020-06-27,Kern,29,883053,8086,4411,23,4434,70
2020-06-27,Kings,31,150075,2642,2187,5,2192,18
2020-06-27,Lake,33,64148,80,42,0,42,0
2020-06-27,Lassen,35,31185,237,33,1,34,0
2020-06-27,Los Angeles,37,10098052,113269,95341,28,95369,3291
2020-06-27,Madera,39,155013,840,427,0,427,4
2020-06-27,Marin,41,260295,2599,1423,4,1427,17
2020-06-27,Mariposa,43,17540,31,22,0,22,1
2020-06-27,Mendocino,45,87422,84,63,0,63,0
2020-06-27,Merced,47,269075,1567,807,1,808,10
2020-06-27,Modoc,49,8938,1,0,0,0,0
2020-06-27,Mono,51,14174,46,35,0,35,1
2020-06-27,Monterey,53,433212,2058,1455,3,1458,12
2020-06-27,Napa,55,140530,419,282,0,282,3
2020-06-27,Nevada,57,99092,140,102,2,104,1
2020-06-27,Orange,59,3164182,21551,12951,149,13100,320
2020-06-27,Placer,61,380077,870,584,3,587,10
2020-06-27,Plumas,63,18699,11,6,0,6,0
2020-06-27,Riverside,65,2383286,22513,16209,9,16218,432
2020-06-27,Sacramento,67,1510023,3944,2685,2,2687,63
2020-06-27,San Benito,69,59416,265,182,0,182,2
2020-06-27,San Bernardino,71,2135413,17767,11238,10,11248,243
2020-06-27,San Diego,73,3302833,16480,12836,0,12836,360
2020-06-27,San Francisco,75,870044,3907,3332,4,3336,49
2020-06-27,San Joaquin,77,732212,4765,2995,4,2999,52
2020-06-27,San Luis Obispo,79,281455,738,505,3,508,1
2020-06-27,San Mateo,81,765935,3547,3083,4,3087,83
2020-06-27,Santa Barbara,83,443738,3883,2799,35,2834,25
2020-06-27,Santa Clara,85,1922200,5313,4006,8,4014,157
2020-06-27,Santa Cruz,87,273765,435,347,0,347,2
2020-06-27,Shasta,89,179085,191,87,0,87,5
2020-06-27,Sierra,91,2930,1,1,0,1,0
2020-06-27,Siskiyou,93,43540,34,25,0,25,0
2020-06-27,Solano,95,438530,1721,1076,8,1084,21
2020-06-27,Sonoma,97,501317,1392,1004,4,1008,5
2020-06-27,Stanislaus,99,539301,3744,2164,5,2169,36
2020-06-27,Sutter,101,95872,188,141,0,141,2
2020-06-27,Tehama,103,63373,90,63,4,67,1
2020-06-27,Trinity,105,12862,4,2,2,4,0
2020-06-27,Tulare,107,460477,5111,3810,2,3812,117
2020-06-27,Tuolumne,109,53932,41,13,1,14,0
2020-06-27,Ventura,111,848112,4018,2471,8,2479,40
2020-06-27,Yolo,113,214977,659,432,3,435,24
2020-06-27,Yuba,115,75493,80,39,0,39,1
2020-06-26,Alameda,1,1643700,6664,5502,6,5508,132
2020-06-26,Alpine,3,1148,2,1,0,1,0
2020-06-26,Amador,5,37829,26,20,0,20,0
2020-06-26,Butte,7,227075,230,135,3,138,2
2020-06-26,Calaveras,9,45235,47,30,0,30,0
2020-06-26,Colusa,11,21464,63,17,0,17,0
2020-06-26,Contra Costa,13,1133247,3562,2676,1,2677,72
2020-06-26,Del Norte,15,27424,57,47,0,47,0
2020-06-26,El Dorado,17,186661,250,159,0,159,0
2020-06-26,Fresno,19,978130,8624,4166,53,4219,74
2020-06-26,Glenn,21,27897,137,71,0,71,0
2020-06-26,Humboldt,23,135768,152,126,0,126,3
2020-06-26,Imperial,25,180216,7767,5400,6,5406,44
2020-06-26,Inyo,27,18085,32,29,0,29,1
2020-06-26,Kern,29,883053,7753,4366,23,4389,70
2020-06-26,Kings,31,150075,2610,2176,4,2180,18
2020-06-26,Lake,33,64148,79,42,0,42,0
2020-06-26,Lassen,35,31185,236,30,1,31,0
2020-06-26,Los Angeles,37,10098052,111104,93328,28,93356,3275
2020-06-26,Madera,39,155013,808,409,0,409,4
2020-06-26,Marin,41,260295,2563,1406,4,1410,17
2020-06-26,Mariposa,43,17540,30,21,0,21,1
2020-06-26,Mendocino,45,87422,81,63,0,63,0
2020-06-26,Merced,47,269075,1521,797,1,798,10
2020-06-26,Modoc,49,8938,1,0,0,0,0
2020-06-26,Mono,51,14174,45,35,0,35,1
2020-06-26,Monterey,53,433212,2006,1449,3,1452,12
2020-06-26,Napa,55,140530,409,277,0,277,3
2020-06-26,Nevada,57,99092,136,101,1,102,1
2020-06-26,Orange,59,3164182,20875,12659,146,12805,320
2020-06-26,Placer,61,380077,842,584,3,587,10
2020-06-26,Plumas,63,18699,11,6,0,6,0
2020-06-26,Riverside,65,2383286,22051,15858,9,15867,430
2020-06-26,Sacramento,67,1510023,3780,2687,2,2689,63
2020-06-26,San Benito,69,59416,261,176,0,176,2
2020-06-26,San Bernardino,71,2135413,17390,11111,10,11121,243
2020-06-26,San Diego,73,3302833,16115,12402,0,12402,358
2020-06-26,San Francisco,75,870044,3851,3330,4,3334,49
2020-06-26,San Joaquin,77,732212,4551,2943,4,2947,52
2020-06-26,San Luis Obispo,79,281455,723,498,3,501,1
2020-06-26,San Mateo,81,765935,3495,3055,4,3059,83
2020-06-26,Santa Barbara,83,443738,3793,2784,33,2817,25
2020-06-26,Santa Clara,85,1922200,5212,3968,8,3976,156
2020-06-26,Santa Cruz,87,273765,428,344,0,344,2
2020-06-26,Shasta,89,179085,184,86,0,86,5
2020-06-26,Sierra,91,2930,1,1,0,1,0
2020-06-26,Siskiyou,93,43540,33,24,0,24,0
2020-06-26,Solano,95,438530,1679,1068,8,1076,21
2020-06-26,Sonoma,97,501317,1360,977,4,981,5
2020-06-26,Stanislaus,99,539301,3631,2157,5,2162,36
2020-06-26,Sutter,101,95872,181,138,0,138,2
2020-06-26,Tehama,103,63373,87,63,4,67,1
2020-06-26,Trinity,105,12862,4,2,2,4,0
2020-06-26,Tulare,107,460477,5022,3720,2,3722,117
2020-06-26,Tuolumne,109,53932,39,10,1,11,0
2020-06-26,Ventura,111,848112,3932,2444,8,2452,40
2020-06-26,Yolo,113,214977,635,418,3,421,24
2020-06-26,Yuba,115,75493,74,38,0,38,1
2020-06-25,Alameda,1,1643700,6473,5398,6,5404,130
2020-06-25,Alpine,3,1148,2,1,0,1,0
2020-06-25,Amador,5,37829,25,18,0,18,0
2020-06-25,Butte,7,227075,226,127,3,130,1
2020-06-25,Calaveras,9,45235,42,26,0,26,0
2020-06-25,Colusa,11,21464,53,14,0,14,0
2020-06-25,Contra Costa,13,1133247,3378,2591,1,2592,71
2020-06-25,Del Norte,15,27424,55,47,0,47,0
2020-06-25,El Dorado,17,186661,242,150,0,150,0
2020-06-25,Fresno,19,978130,8311,3938,52,3990,71
2020-06-25,Glenn,21,27897,132,59,0,59,0
2020-06-25,Humboldt,23,135768,151,121,0,121,3
2020-06-25,Imperial,25,180216,7638,5192,6,5198,44
2020-06-25,Inyo,27,18085,29,27,0,27,1
2020-06-25,Kern,29,883053,7328,4236,20,4256,69
2020-06-25,Kings,31,150075,2558,2110,4,2114,17
2020-06-25,Lake,33,64148,78,42,0,42,0
2020-06-25,Lassen,35,31185,230,13,1,14,0
2020-06-25,Los Angeles,37,10098052,108340,91524,28,91552,3239
2020-06-25,Madera,39,155013,764,380,0,380,4
2020-06-25,Marin,41,260295,2462,1321,4,1325,17
2020-06-25,Mariposa,43,17540,29,20,0,20,1
2020-06-25,Mendocino,45,87422,78,61,0,61,0
2020-06-25,Merced,47,269075,1434,747,1,748,10
2020-06-25,Modoc,49,8938,1,0,0,0,0
2020-06-25,Mono,51,14174,44,35,0,35,1
2020-06-25,Monterey,53,433212,1918,1426,2,1428,12
2020-06-25,Napa,55,140530,391,260,0,260,3
2020-06-25,Nevada,57,99092,128,92,1,93,1
2020-06-25,Orange,59,3164182,19953,12221,144,12365,311
2020-06-25,Placer,61,380077,791,574,3,577,10
2020-06-25,Plumas,63,18699,10,6,0,6,0
2020-06-25,Riverside,65,2383286,21297,15224,9,15233,427
2020-06-25,Sacramento,67,1510023,3559,2519,2,2521,62
2020-06-25,San Benito,69,59416,253,174,0,174,2
2020-06-25,San Bernardino,71,2135413,16638,10590,10,10600,242
2020-06-25,San Diego,73,3302833,15576,11963,0,11963,352
2020-06-25,San Francisco,75,870044,3786,3252,4,3256,48
2020-06-25,San Joaquin,77,732212,4279,2803,4,2807,50
2020-06-25,San Luis Obispo,79,281455,691,473,3,476,1
2020-06-25,San Mateo,81,765935,3427,2996,4,3000,82
2020-06-25,Santa Barbara,83,443738,3687,2622,31,2653,25
2020-06-25,Santa Clara,85,1922200,5064,3871,8,3879,156
2020-06-25,Santa Cruz,87,273765,416,335,0,335,2
2020-06-25,Shasta,89,179085,174,84,0,84,5
2020-06-25,Sierra,91,2930,1,1,0,1,0
2020-06-25,Siskiyou,93,43540,32,24,0,24,0
2020-06-25,Solano,95,438530,1626,1034,8,1042,21
2020-06-25,Sonoma,97,501317,1313,953,3,956,5
2020-06-25,Stanislaus,99,539301,3419,2130,5,2135,36
2020-06-25,Sutter,101,95872,169,126,0,126,2
2020-06-25,Tehama,103,63373,83,59,4,63,1
2020-06-25,Trinity,105,12862,4,2,2,4,0
2020-06-25,Tulare,107,460477,4892,3656,2,3658,117
2020-06-25,Tuolumne,109,53932,38,10,1,11,0
2020-06-25,Ventura,111,848112,3750,2346,8,2354,40
2020-06-25,Yolo,113,214977,605,397,3,400,24
2020-06-25,Yuba,115,75493,63,38,0,38,1
2020-06-24,Alameda,1,1643700,6312,5242,6,5248,123
2020-06-24,Alpine,3,1148,2,1,0,1,0
2020-06-24,Amador,5,37829,23,16,0,16,0
2020-06-24,Butte,7,227075,210,119,3,122,1
2020-06-24,Calaveras,9,45235,40,26,0,26,0
2020-06-24,Colusa,11,21464,44,11,0,11,0
2020-06-24,Contra Costa,13,1133247,3224,2520,1,2521,66
2020-06-24,Del Norte,15,27424,49,47,0,47,0
2020-06-24,El Dorado,17,186661,226,149,0,149,0
2020-06-24,Fresno,19,978130,7980,3765,52,3817,71
2020-06-24,Glenn,21,27897,124,54,0,54,0
2020-06-24,Humboldt,23,135768,151,117,0,117,3
2020-06-24,Imperial,25,180216,7520,5138,6,5144,38
2020-06-24,Inyo,27,18085,29,28,0,28,1
2020-06-24,Kern,29,883053,6935,4155,17,4172,67
2020-06-24,Kings,31,150075,2496,2063,4,2067,16
2020-06-24,Lake,33,64148,65,40,0,40,0
2020-06-24,Lassen,35,31185,229,9,1,10,0
2020-06-24,Los Angeles,37,10098052,105583,89566,28,89594,3186
2020-06-24,Madera,39,155013,743,373,0,373,4
2020-06-24,Marin,41,260295,2234,1261,4,1265,17
2020-06-24,Mariposa,43,17540,28,19,0,19,1
2020-06-24,Mendocino,45,87422,78,60,0,60,0
2020-06-24,Merced,47,269075,1348,696,1,697,8
2020-06-24,Modoc,49,8938,1,0,0,0,0
2020-06-24,Mono,51,14174,42,35,0,35,1
2020-06-24,Monterey,53,433212,1841,1407,2,1409,12
2020-06-24,Napa,55,140530,373,258,0,258,3
2020-06-24,Nevada,57,99092,122,92,1,93,1
2020-06-24,Orange,59,3164182,18960,11804,125,11929,303
2020-06-24,Placer,61,380077,751,548,3,551,10
2020-06-24,Plumas,63,18699,10,6,0,6,0
2020-06-24,Riverside,65,2383286,20451,14946,9,14955,410
2020-06-24,Sacramento,67,1510023,3355,2446,2,2448,62
2020-06-24,San Benito,69,59416,249,171,0,171,2
2020-06-24,San Bernardino,71,2135413,15826,10211,9,10220,239
2020-06-24,San Diego,73,3302833,15076,11628,0,11628,347
2020-06-24,San Francisco,75,870044,3723,3216,4,3220,48
2020-06-24,San Joaquin,77,732212,4057,2680,4,2684,49
2020-06-24,San Luis Obispo,79,281455,660,461,2,463,1
2020-06-24,San Mateo,81,765935,3370,2964,4,2968,82
2020-06-24,Santa Barbara,83,443738,3567,2569,29,2598,22
2020-06-24,Santa Clara,85,1922200,4934,3812,8,3820,155
2020-06-24,Santa Cruz,87,273765,404,329,0,329,2
2020-06-24,Shasta,89,179085,166,83,0,83,5
2020-06-24,Sierra,91,2930,1,1,0,1,0
2020-06-24,Siskiyou,93,43540,31,24,0,24,0
2020-06-24,Solano,95,438530,1536,979,7,986,21
2020-06-24,Sonoma,97,501317,1264,933,3,936,4
2020-06-24,Stanislaus,99,539301,3241,2039,5,2044,36
2020-06-24,Sutter,101,95872,156,118,0,118,2
2020-06-24,Tehama,103,63373,81,55,4,59,1
2020-06-24,Trinity,105,12862,4,2,2,4,0
2020-06-24,Tulare,107,460477,4739,3541,2,3543,116
2020-06-24,Tuolumne,109,53932,33,9,1,10,0
2020-06-24,Ventura,111,848112,3409,2314,8,2322,42
2020-06-24,Yolo,113,214977,570,376,3,379,24
2020-06-24,Yuba,115,75493,57,37,0,37,1
2020-06-23,Alameda,1,1643700,6131,5159,6,5165,121
2020-06-23,Alpine,3,1148,2,1,0,1,0
2020-06-23,Amador,5,37829,22,13,0,13,0
2020-06-23,Butte,7,227075,192,111,3,114,1
2020-06-23,Calaveras,9,45235,40,26,0,26,0
2020-06-23,Colusa,11,21464,40,7,0,7,0
2020-06-23,Contra Costa,13,1133247,3097,2453,1,2454,60
2020-06-23,Del Norte,15,27424,48,46,0,46,0
2020-06-23,El Dorado,17,186661,217,142,0,142,0
2020-06-23,Fresno,19,978130,7332,3569,50,3619,67
2020-06-23,Glenn,21,27897,120,47,0,47,0
2020-06-23,Humboldt,23,135768,151,110,0,110,3
2020-06-23,Imperial,25,180216,7357,5025,6,5031,38
2020-06-23,Inyo,27,18085,29,26,0,26,1
2020-06-23,Kern,29,883053,6569,4087,14,4101,64
2020-06-23,Kings,31,150075,2431,1727,4,1731,16
2020-06-23,Lake,33,64148,59,40,0,40,0
2020-06-23,Lassen,35,31185,225,9,1,10,0
2020-06-23,Los Angeles,37,10098052,102651,88433,26,88459,3152
2020-06-23,Madera,39,155013,704,369,0,369,4
2020-06-23,Marin,41,260295,1966,1139,4,1143,17
2020-06-23,Mariposa,43,17540,26,18,0,18,1
2020-06-23,Mendocino,45,87422,77,61,0,61,0
2020-06-23,Merced,47,269075,1251,656,0,656,8
2020-06-23,Modoc,49,8938,1,0,0,0,0
2020-06-23,Mono,51,14174,42,35,0,35,1
2020-06-23,Monterey,53,433212,1771,1346,2,1348,12
2020-06-23,Napa,55,140530,358,230,0,230,3
2020-06-23,Nevada,57,99092,116,81,1,82,1
2020-06-23,Orange,59,3164182,17990,11071,122,11193,278
2020-06-23,Placer,61,380077,722,525,3,528,10
2020-06-23,Plumas,63,18699,9,6,0,6,0
2020-06-23,Riverside,65,2383286,19431,14469,9,14478,406
2020-06-23,Sacramento,67,1510023,3178,2374,2,2376,62
2020-06-23,San Benito,69,59416,235,167,0,167,2
2020-06-23,San Bernardino,71,2135413,15042,9771,9,9780,229
2020-06-23,San Diego,73,3302833,14556,11296,0,11296,341
2020-06-23,San Francisco,75,870044,3650,3177,4,3181,48
2020-06-23,San Joaquin,77,732212,3798,2502,4,2506,48
2020-06-23,San Luis Obispo,79,281455,630,445,2,447,1
2020-06-23,San Mateo,81,765935,3304,2907,4,2911,81
2020-06-23,Santa Barbara,83,443738,3471,2498,29,2527,22
2020-06-23,Santa Clara,85,1922200,4788,3700,8,3708,155
2020-06-23,Santa Cruz,87,273765,394,313,0,313,2
2020-06-23,Shasta,89,179085,157,81,0,81,5
2020-06-23,Sierra,91,2930,1,1,0,1,0
2020-06-23,Siskiyou,93,43540,29,24,0,24,0
2020-06-23,Solano,95,438530,1479,941,6,947,21
2020-06-23,Sonoma,97,501317,1211,912,3,915,4
2020-06-23,Stanislaus,99,539301,3066,1850,5,1855,35
2020-06-23,Sutter,101,95872,146,112,0,112,2
2020-06-23,Tehama,103,63373,79,50,4,54,1
2020-06-23,Trinity,105,12862,4,2,2,4,0
2020-06-23,Tulare,107,460477,4617,3456,2,3458,111
2020-06-23,Tuolumne,109,53932,28,9,1,10,0
2020-06-23,Ventura,111,848112,3249,2209,7,2216,40
2020-06-23,Yolo,113,214977,544,350,0,350,24
2020-06-23,Yuba,115,75493,54,35,0,35,1
2020-06-22,Alameda,1,1643700,5980,4944,6,4950,121
2020-06-22,Alpine,3,1148,2,1,0,1,0
2020-06-22,Amador,5,37829,19,12,0,12,0
2020-06-22,Butte,7,227075,173,104,3,107,1
2020-06-22,Calaveras,9,45235,38,20,0,20,0
2020-06-22,Colusa,11,21464,37,7,0,7,0
2020-06-22,Contra Costa,13,1133247,2955,2363,1,2364,60
2020-06-22,Del Norte,15,27424,48,46,0,46,0
2020-06-22,El Dorado,17,186661,208,137,0,137,0
2020-06-22,Fresno,19,978130,6800,3425,50,3475,67
2020-06-22,Glenn,21,27897,111,40,0,40,0
2020-06-22,Humboldt,23,135768,148,110,0,110,3
2020-06-22,Imperial,25,180216,7201,4700,6,4706,38
2020-06-22,Inyo,27,18085,29,26,0,26,1
2020-06-22,Kern,29,883053,6217,3982,12,3994,60
2020-06-22,Kings,31,150075,2383,1513,4,1517,13
2020-06-22,Lake,33,64148,53,37,0,37,0
2020-06-22,Lassen,35,31185,115,7,1,8,0
2020-06-22,Los Angeles,37,10098052,99762,85925,25,85950,3117
2020-06-22,Madera,39,155013,679,333,0,333,4
2020-06-22,Marin,41,260295,1710,1029,4,1033,17
2020-06-22,Mariposa,43,17540,25,18,0,18,1
2020-06-22,Mendocino,45,87422,72,48,0,48,0
2020-06-22,Merced,47,269075,1162,619,0,619,8
2020-06-22,Modoc,49,8938,1,0,0,0,0
2020-06-22,Mono,51,14174,42,34,0,34,1
2020-06-22,Monterey,53,433212,1710,1293,2,1295,12
2020-06-22,Napa,55,140530,334,222,0,222,3
2020-06-22,Nevada,57,99092,111,79,1,80,1
2020-06-22,Orange,59,3164182,17061,10711,120,10831,275
2020-06-22,Placer,61,380077,687,512,3,515,9
2020-06-22,Plumas,63,18699,7,6,0,6,0
2020-06-22,Riverside,65,2383286,18458,13948,9,13957,403
2020-06-22,Sacramento,67,1510023,2964,2243,2,2245,62
2020-06-22,San Benito,69,59416,226,164,0,164,2
2020-06-22,San Bernardino,71,2135413,14266,9133,8,9141,229
2020-06-22,San Diego,73,3302833,14065,11098,0,11098,338
2020-06-22,San Francisco,75,870044,3557,3000,4,3004,47
2020-06-22,San Joaquin,77,732212,3551,2332,4,2336,48
2020-06-22,San Luis Obispo,79,281455,599,422,2,424,1
2020-06-22,San Mateo,81,765935,3232,2813,4,2817,81
2020-06-22,Santa Barbara,83,443738,3379,2447,29,2476,21
2020-06-22,Santa Clara,85,1922200,4628,3580,8,3588,155
2020-06-22,Santa Cruz,87,273765,381,290,0,290,3
2020-06-22,Shasta,89,179085,154,77,0,77,5
2020-06-22,Sierra,91,2930,1,1,0,1,0
2020-06-22,Siskiyou,93,43540,29,23,0,23,0
2020-06-22,Solano,95,438530,1401,784,5,789,21
2020-06-22,Sonoma,97,501317,1166,860,1,861,4
2020-06-22,Stanislaus,99,539301,2881,1784,5,1789,35
2020-06-22,Sutter,101,95872,137,100,0,100,2
2020-06-22,Tehama,103,63373,75,38,3,41,1
2020-06-22,Trinity,105,12862,4,2,2,4,0
2020-06-22,Tulare,107,460477,4480,3185,2,3187,111
2020-06-22,Tuolumne,109,53932,19,8,1,9,0
2020-06-22,Ventura,111,848112,3100,2065,7,2072,39
2020-06-22,Yolo,113,214977,518,333,0,333,24
2020-06-22,Yuba,115,75493,49,36,0,36,1
2020-06-21,Alameda,1,1643700,5786,4835,6,4841,121
2020-06-21,Alpine,3,1148,2,1,0,1,0
2020-06-21,Amador,5,37829,14,12,0,12,0
2020-06-21,Butte,7,227075,159,97,3,100,1
2020-06-21,Calaveras,9,45235,38,20,0,20,0
2020-06-21,Colusa,11,21464,29,7,0,7,0
2020-06-21,Contra Costa,13,1133247,2829,2282,1,2283,60
2020-06-21,Del Norte,15,27424,47,46,0,46,0
2020-06-21,El Dorado,17,186661,199,132,0,132,0
2020-06-21,Fresno,19,978130,6230,3296,49,3345,67
2020-06-21,Glenn,21,27897,102,40,0,40,0
2020-06-21,Humboldt,23,135768,143,108,0,108,3
2020-06-21,Imperial,25,180216,7017,4701,6,4707,38
2020-06-21,Inyo,27,18085,27,26,0,26,1
2020-06-21,Kern,29,883053,5926,3918,11,3929,60
2020-06-21,Kings,31,150075,2320,1334,4,1338,11
2020-06-21,Lake,33,64148,48,36,0,36,0
2020-06-21,Lassen,35,31185,22,7,1,8,0
2020-06-21,Los Angeles,37,10098052,96887,83383,25,83408,3101
2020-06-21,Madera,39,155013,645,319,0,319,4
2020-06-21,Marin,41,260295,1553,907,4,911,17
2020-06-21,Mariposa,43,17540,22,18,0,18,1
2020-06-21,Mendocino,45,87422,69,48,0,48,0
2020-06-21,Merced,47,269075,1067,577,0,577,8
2020-06-21,Modoc,49,8938,1,0,0,0,0
2020-06-21,Mono,51,14174,42,34,0,34,1
2020-06-21,Monterey,53,433212,1637,1227,2,1229,12
2020-06-21,Napa,55,140530,319,218,0,218,3
2020-06-21,Nevada,57,99092,108,79,1,80,1
2020-06-21,Orange,59,3164182,16224,10563,115,10678,275
2020-06-21,Placer,61,380077,656,498,3,501,9
2020-06-21,Plumas,63,18699,7,6,0,6,0
2020-06-21,Riverside,65,2383286,17753,13528,8,13536,402
2020-06-21,Sacramento,67,1510023,2764,2156,2,2158,62
2020-06-21,San Benito,69,59416,212,151,0,151,2
2020-06-21,San Bernardino,71,2135413,13490,8925,7,8932,229
2020-06-21,San Diego,73,3302833,13520,10796,0,10796,338
2020-06-21,San Francisco,75,870044,3451,3000,3,3003,47
2020-06-21,San Joaquin,77,732212,3315,2188,4,2192,48
2020-06-21,San Luis Obispo,79,281455,574,418,2,420,1
2020-06-21,San Mateo,81,765935,3174,2781,3,2784,81
2020-06-21,Santa Barbara,83,443738,3272,2430,27,2457,21
2020-06-21,Santa Clara,85,1922200,4490,3514,8,3522,154
2020-06-21,Santa Cruz,87,273765,371,290,0,290,3
2020-06-21,Shasta,89,179085,144,75,0,75,5
2020-06-21,Sierra,91,2930,1,1,0,1,0
2020-06-21,Siskiyou,93,43540,29,23,0,23,0
2020-06-21,Solano,95,438530,1301,783,4,787,21
2020-06-21,Sonoma,97,501317,1116,836,1,837,4
2020-06-21,Stanislaus,99,539301,2694,1688,5,1693,35
2020-06-21,Sutter,101,95872,129,96,0,96,2
2020-06-21,Tehama,103,63373,64,35,2,37,1
2020-06-21,Trinity,105,12862,4,2,2,4,0
2020-06-21,Tulare,107,460477,4312,3173,2,3175,111
2020-06-21,Tuolumne,109,53932,17,8,1,9,0
2020-06-21,Ventura,111,848112,2922,2021,7,2028,39
2020-06-21,Yolo,113,214977,486,323,0,323,24
2020-06-21,Yuba,115,75493,45,35,0,35,1
2020-06-20,Alameda,1,1643700,5724,4758,6,4764,119
2020-06-20,Alpine,3,1148,2,1,0,1,0
2020-06-20,Amador,5,37829,14,12,0,12,0
2020-06-20,Butte,7,227075,152,94,3,97,1
2020-06-20,Calaveras,9,45235,38,20,0,20,0
2020-06-20,Colusa,11,21464,26,7,0,7,0
2020-06-20,Contra Costa,13,1133247,2771,2231,1,2232,54
2020-06-20,Del Norte,15,27424,47,46,0,46,0
2020-06-20,El Dorado,17,186661,194,130,0,130,0
2020-06-20,Fresno,19,978130,6105,3222,47,3269,67
2020-06-20,Glenn,21,27897,97,40,0,40,0
2020-06-20,Humboldt,23,135768,143,108,0,108,3
2020-06-20,Imperial,25,180216,6936,4616,6,4622,37
2020-06-20,Inyo,27,18085,27,26,0,26,1
2020-06-20,Kern,29,883053,5762,3836,11,3847,59
2020-06-20,Kings,31,150075,2296,1331,4,1335,9
2020-06-20,Lake,33,64148,48,37,0,37,0
2020-06-20,Lassen,35,31185,21,7,1,8,0
2020-06-20,Los Angeles,37,10098052,95314,81604,24,81628,3093
2020-06-20,Madera,39,155013,612,321,0,321,4
2020-06-20,Marin,41,260295,1533,879,4,883,17
2020-06-20,Mariposa,43,17540,22,18,0,18,1
2020-06-20,Mendocino,45,87422,68,48,0,48,0
2020-06-20,Merced,47,269075,1027,566,0,566,8
2020-06-20,Modoc,49,8938,1,0,0,0,0
2020-06-20,Mono,51,14174,42,34,0,34,1
2020-06-20,Monterey,53,433212,1601,1181,2,1183,12
2020-06-20,Napa,55,140530,310,212,0,212,3
2020-06-20,Nevada,57,99092,105,73,1,74,1
2020-06-20,Orange,59,3164182,15877,10284,110,10394,273
2020-06-20,Placer,61,380077,634,483,3,486,9
2020-06-20,Plumas,63,18699,6,6,0,6,0
2020-06-20,Riverside,65,2383286,17454,13021,8,13029,402
2020-06-20,Sacramento,67,1510023,2695,2069,2,2071,63
2020-06-20,San Benito,69,59416,208,139,0,139,2
2020-06-20,San Bernardino,71,2135413,13129,8718,7,8725,229
2020-06-20,San Diego,73,3302833,13197,10486,0,10486,338
2020-06-20,San Francisco,75,870044,3408,2999,3,3002,47
2020-06-20,San Joaquin,77,732212,3232,2046,4,2050,48
2020-06-20,San Luis Obispo,79,281455,561,405,2,407,1
2020-06-20,San Mateo,81,765935,3126,2755,3,2758,81
2020-06-20,Santa Barbara,83,443738,3216,2358,26,2384,21
2020-06-20,Santa Clara,85,1922200,4418,3435,8,3443,154
2020-06-20,Santa Cruz,87,273765,369,287,0,287,3
2020-06-20,Shasta,89,179085,138,66,0,66,5
2020-06-20,Sierra,91,2930,1,1,0,1,0
2020-06-20,Siskiyou,93,43540,28,22,0,22,0
2020-06-20,Solano,95,438530,1277,784,4,788,21
2020-06-20,Sonoma,97,501317,1080,806,1,807,4
2020-06-20,Stanislaus,99,539301,2587,1598,5,1603,35
2020-06-20,Sutter,101,95872,127,89,0,89,2
2020-06-20,Tehama,103,63373,62,35,2,37,1
2020-06-20,Trinity,105,12862,4,2,2,4,0
2020-06-20,Tulare,107,460477,4239,3172,2,3174,111
2020-06-20,Tuolumne,109,53932,14,8,1,9,0
2020-06-20,Ventura,111,848112,2857,1946,7,1953,37
2020-06-20,Yolo,113,214977,470,309,0,309,24
2020-06-20,Yuba,115,75493,43,34,0,34,1
2020-06-19,Alameda,1,1643700,5652,4646,6,4652,119
2020-06-19,Alpine,3,1148,2,1,0,1,0
2020-06-19,Amador,5,37829,14,12,0,12,0
2020-06-19,Butte,7,227075,147,91,3,94,1
2020-06-19,Calaveras,9,45235,37,20,0,20,0
2020-06-19,Colusa,11,21464,24,7,0,7,0
2020-06-19,Contra Costa,13,1133247,2692,2106,1,2107,54
2020-06-19,Del Norte,15,27424,47,46,0,46,0
2020-06-19,El Dorado,17,186661,185,124,0,124,0
2020-06-19,Fresno,19,978130,5943,3109,45,3154,61
2020-06-19,Glenn,21,27897,91,40,0,40,0
2020-06-19,Humboldt,23,135768,141,106,0,106,3
2020-06-19,Imperial,25,180216,6845,4504,6,4510,36
2020-06-19,Inyo,27,18085,27,26,0,26,1
2020-06-19,Kern,29,883053,5539,3742,10,3752,57
2020-06-19,Kings,31,150075,2275,1285,4,1289,9
2020-06-19,Lake,33,64148,45,36,0,36,0
2020-06-19,Lassen,35,31185,20,7,1,8,0
2020-06-19,Los Angeles,37,10098052,93335,79572,24,79596,3047
2020-06-19,Madera,39,155013,592,300,0,300,4
2020-06-19,Marin,41,260295,1504,829,4,833,17
2020-06-19,Mariposa,43,17540,21,18,0,18,1
2020-06-19,Mendocino,45,87422,67,48,0,48,0
2020-06-19,Merced,47,269075,982,529,0,529,8
2020-06-19,Modoc,49,8938,1,0,0,0,0
2020-06-19,Mono,51,14174,42,34,0,34,1
2020-06-19,Monterey,53,433212,1572,1159,2,1161,12
2020-06-19,Napa,55,140530,300,209,0,209,3
2020-06-19,Nevada,57,99092,102,71,1,72,1
2020-06-19,Orange,59,3164182,15352,9972,102,10074,260
2020-06-19,Placer,61,380077,617,464,3,467,9
2020-06-19,Plumas,63,18699,6,5,0,5,0
2020-06-19,Riverside,65,2383286,17048,12710,8,12718,398
2020-06-19,Sacramento,67,1510023,2611,1976,2,1978,64
2020-06-19,San Benito,69,59416,207,136,0,136,2
2020-06-19,San Bernardino,71,2135413,12723,8454,6,8460,226
2020-06-19,San Diego,73,3302833,12834,10352,0,10352,332
2020-06-19,San Francisco,75,870044,3353,2968,3,2971,47
2020-06-19,San Joaquin,77,732212,3109,1969,4,1973,48
2020-06-19,San Luis Obispo,79,281455,546,392,2,394,1
2020-06-19,San Mateo,81,765935,3087,2713,3,2716,81
2020-06-19,Santa Barbara,83,443738,3143,2284,24,2308,21
2020-06-19,Santa Clara,85,1922200,4344,3376,8,3384,154
2020-06-19,Santa Cruz,87,273765,359,283,0,283,3
2020-06-19,Shasta,89,179085,134,58,0,58,5
2020-06-19,Sierra,91,2930,1,1,0,1,0
2020-06-19,Siskiyou,93,43540,28,21,0,21,0
2020-06-19,Solano,95,438530,1239,755,4,759,21
2020-06-19,Sonoma,97,501317,1053,803,1,804,4
2020-06-19,Stanislaus,99,539301,2478,1549,5,1554,35
2020-06-19,Sutter,101,95872,126,89,0,89,2
2020-06-19,Tehama,103,63373,61,35,2,37,1
2020-06-19,Trinity,105,12862,4,2,2,4,0
2020-06-19,Tulare,107,460477,4167,3053,2,3055,107
2020-06-19,Tuolumne,109,53932,13,8,1,9,0
2020-06-19,Ventura,111,848112,2773,1865,7,1872,37
2020-06-19,Yolo,113,214977,451,303,0,303,24
2020-06-19,Yuba,115,75493,42,33,0,33,1
2020-06-18,Alameda,1,1643700,5523,4589,6,4595,118
2020-06-18,Alpine,3,1148,2,1,0,1,0
2020-06-18,Amador,5,37829,13,12,0,12,0
2020-06-18,Butte,7,227075,142,88,3,91,1
2020-06-18,Calaveras,9,45235,37,20,0,20,0
2020-06-18,Colusa,11,21464,20,7,0,7,0
2020-06-18,Contra Costa,13,1133247,2587,2072,1,2073,53
2020-06-18,Del Norte,15,27424,47,46,0,46,0
2020-06-18,El Dorado,17,186661,181,121,0,121,0
2020-06-18,Fresno,19,978130,5677,2947,44,2991,57
2020-06-18,Glenn,21,27897,82,35,0,35,0
2020-06-18,Humboldt,23,135768,140,106,0,106,3
2020-06-18,Imperial,25,180216,6696,4366,6,4372,36
2020-06-18,Inyo,27,18085,26,25,0,25,1
2020-06-18,Kern,29,883053,5321,3634,10,3644,57
2020-06-18,Kings,31,150075,2216,1141,4,1145,8
2020-06-18,Lake,33,64148,44,36,0,36,0
2020-06-18,Lassen,35,31185,19,5,1,6,0
2020-06-18,Los Angeles,37,10098052,91074,78244,24,78268,3009
2020-06-18,Madera,39,155013,557,288,0,288,4
2020-06-18,Marin,41,260295,1441,819,4,823,17
2020-06-18,Mariposa,43,17540,19,18,0,18,1
2020-06-18,Mendocino,45,87422,63,45,0,45,0
2020-06-18,Merced,47,269075,931,486,0,486,7
2020-06-18,Modoc,49,8938,1,0,0,0,0
2020-06-18,Mono,51,14174,42,34,0,34,1
2020-06-18,Monterey,53,433212,1505,1127,2,1129,12
2020-06-18,Napa,55,140530,285,205,0,205,3
2020-06-18,Nevada,57,99092,98,68,1,69,1
2020-06-18,Orange,59,3164182,14697,9597,83,9680,255
2020-06-18,Placer,61,380077,599,457,3,460,9
2020-06-18,Plumas,63,18699,6,5,0,5,0
2020-06-18,Riverside,65,2383286,16435,12410,8,12418,392
2020-06-18,Sacramento,67,1510023,2496,1938,2,1940,63
2020-06-18,San Benito,69,59416,201,134,0,134,2
2020-06-18,San Bernardino,71,2135413,12087,8141,6,8147,226
2020-06-18,San Diego,73,3302833,12412,10094,0,10094,331
2020-06-18,San Francisco,75,870044,3304,2951,3,2954,47
2020-06-18,San Joaquin,77,732212,2956,1908,4,1912,47
2020-06-18,San Luis Obispo,79,281455,527,378,2,380,1
2020-06-18,San Mateo,81,765935,3048,2674,3,2677,78
2020-06-18,Santa Barbara,83,443738,3069,2201,24,2225,19
2020-06-18,Santa Clara,85,1922200,4244,3338,8,3346,152
2020-06-18,Santa Cruz,87,273765,342,275,0,275,3
2020-06-18,Shasta,89,179085,123,51,0,51,4
2020-06-18,Sierra,91,2930,1,1,0,1,0
2020-06-18,Siskiyou,93,43540,28,18,0,18,0
2020-06-18,Solano,95,438530,1201,735,4,739,21
2020-06-18,Sonoma,97,501317,1011,789,1,790,4
2020-06-18,Stanislaus,99,539301,2345,1495,5,1500,35
2020-06-18,Sutter,101,95872,122,85,0,85,2
2020-06-18,Tehama,103,63373,56,31,2,33,1
2020-06-18,Trinity,105,12862,4,2,2,4,0
2020-06-18,Tulare,107,460477,4047,3005,2,3007,107
2020-06-18,Tuolumne,109,53932,12,8,1,9,0
2020-06-18,Ventura,111,848112,2647,1781,7,1788,37
2020-06-18,Yolo,113,214977,418,294,0,294,24
2020-06-18,Yuba,115,75493,41,32,0,32,1
2020-06-17,Alameda,1,1643700,5400,4485,6,4491,117
2020-06-17,Alpine,3,1148,2,1,0,1,0
2020-06-17,Amador,5,37829,12,10,0,10,0
2020-06-17,Butte,7,227075,133,81,2,83,1
2020-06-17,Calaveras,9,45235,37,20,0,20,0
2020-06-17,Colusa,11,21464,19,7,0,7,0
2020-06-17,Contra Costa,13,1133247,2490,2020,1,2021,45
2020-06-17,Del Norte,15,27424,47,45,0,45,0
2020-06-17,El Dorado,17,186661,174,116,0,116,0
2020-06-17,Fresno,19,978130,5453,2801,42,2843,56
2020-06-17,Glenn,21,27897,75,31,0,31,0
2020-06-17,Humboldt,23,135768,138,105,0,105,3
2020-06-17,Imperial,25,180216,6524,4108,6,4114,36
2020-06-17,Inyo,27,18085,25,25,0,25,1
2020-06-17,Kern,29,883053,5121,3547,10,3557,56
2020-06-17,Kings,31,150075,2186,1097,4,1101,7
2020-06-17,Lake,33,64148,43,32,0,32,0
2020-06-17,Lassen,35,31185,15,5,1,6,0
2020-06-17,Los Angeles,37,10098052,88766,77166,24,77190,2973
2020-06-17,Madera,39,155013,535,258,0,258,4
2020-06-17,Marin,41,260295,1249,771,3,774,17
2020-06-17,Mariposa,43,17540,18,18,0,18,1
2020-06-17,Mendocino,45,87422,61,42,0,42,0
2020-06-17,Merced,47,269075,860,460,0,460,7
2020-06-17,Modoc,49,8938,1,0,0,0,0
2020-06-17,Mono,51,14174,42,34,0,34,1
2020-06-17,Monterey,53,433212,1453,1077,2,1079,12
2020-06-17,Napa,55,140530,270,202,0,202,3
2020-06-17,Nevada,57,99092,94,57,1,58,1
2020-06-17,Orange,59,3164182,14094,9278,77,9355,230
2020-06-17,Placer,61,380077,578,427,3,430,9
2020-06-17,Plumas,63,18699,6,5,0,5,0
2020-06-17,Riverside,65,2383286,15802,11859,8,11867,370
2020-06-17,Sacramento,67,1510023,2388,1889,2,1891,63
2020-06-17,San Benito,69,59416,196,116,0,116,2
2020-06-17,San Bernardino,71,2135413,11535,7670,6,7676,225
2020-06-17,San Diego,73,3302833,12033,9856,0,9856,327
2020-06-17,San Francisco,75,870044,3265,2906,3,2909,46
2020-06-17,San Joaquin,77,732212,2784,1825,4,1829,46
2020-06-17,San Luis Obispo,79,281455,510,362,2,364,1
2020-06-17,San Mateo,81,765935,3001,2649,3,2652,78
2020-06-17,Santa Barbara,83,443738,2996,2147,22,2169,19
2020-06-17,Santa Clara,85,1922200,4153,3264,7,3271,148
2020-06-17,Santa Cruz,87,273765,336,265,0,265,2
2020-06-17,Shasta,89,179085,121,51,0,51,4
2020-06-17,Sierra,91,2930,1,1,0,1,0
2020-06-17,Siskiyou,93,43540,27,16,0,16,0
2020-06-17,Solano,95,438530,1151,722,4,726,21
2020-06-17,Sonoma,97,501317,985,748,1,749,4
2020-06-17,Stanislaus,99,539301,2222,1387,5,1392,35
2020-06-17,Sutter,101,95872,116,79,0,79,2
2020-06-17,Tehama,103,63373,41,24,2,26,1
2020-06-17,Trinity,105,12862,4,2,2,4,0
2020-06-17,Tulare,107,460477,3938,2882,2,2884,106
2020-06-17,Tuolumne,109,53932,12,7,1,8,0
2020-06-17,Ventura,111,848112,2547,1729,7,1736,37
2020-06-17,Yolo,113,214977,398,277,0,277,24
2020-06-17,Yuba,115,75493,40,30,0,30,1
2020-06-16,Alameda,1,1643700,5284,4428,6,4434,113
2020-06-16,Alpine,3,1148,2,1,0,1,0
2020-06-16,Amador,5,37829,12,10,0,10,0
2020-06-16,Butte,7,227075,129,79,2,81,1
2020-06-16,Calaveras,9,45235,34,19,0,19,0
2020-06-16,Colusa,11,21464,16,7,0,7,0
2020-06-16,Contra Costa,13,1133247,2399,1971,0,1971,45
2020-06-16,Del Norte,15,27424,47,45,0,45,0
2020-06-16,El Dorado,17,186661,168,115,0,115,0
2020-06-16,Fresno,19,978130,5216,2731,41,2772,50
2020-06-16,Glenn,21,27897,71,30,0,30,0
2020-06-16,Humboldt,23,135768,135,105,0,105,3
2020-06-16,Imperial,25,180216,6364,3939,6,3945,36
2020-06-16,Inyo,27,18085,25,24,0,24,1
2020-06-16,Kern,29,883053,4897,3496,10,3506,55
2020-06-16,Kings,31,150075,2140,1044,4,1048,6
2020-06-16,Lake,33,64148,43,31,0,31,0
2020-06-16,Lassen,35,31185,12,5,1,6,0
2020-06-16,Los Angeles,37,10098052,86443,75051,24,75075,2942
2020-06-16,Madera,39,155013,509,239,0,239,3
2020-06-16,Marin,41,260295,1196,725,3,728,17
2020-06-16,Mariposa,43,17540,18,17,0,17,1
2020-06-16,Mendocino,45,87422,60,35,0,35,0
2020-06-16,Merced,47,269075,812,436,0,436,7
2020-06-16,Modoc,49,8938,1,0,0,0,0
2020-06-16,Mono,51,14174,42,34,0,34,1
2020-06-16,Monterey,53,433212,1405,1019,2,1021,12
2020-06-16,Napa,55,140530,255,196,0,196,3
2020-06-16,Nevada,57,99092,91,53,1,54,1
2020-06-16,Orange,59,3164182,13511,9163,75,9238,223
2020-06-16,Placer,61,380077,545,392,2,394,9
2020-06-16,Plumas,63,18699,6,5,0,5,0
2020-06-16,Riverside,65,2383286,15127,11638,8,11646,364
2020-06-16,Sacramento,67,1510023,2278,1825,2,1827,60
2020-06-16,San Benito,69,59416,188,110,0,110,2
2020-06-16,San Bernardino,71,2135413,10993,7463,6,7469,225
2020-06-16,San Diego,73,3302833,11671,9732,0,9732,323
2020-06-16,San Francisco,75,870044,3214,2893,3,2896,46
2020-06-16,San Joaquin,77,732212,2632,1718,4,1722,47
2020-06-16,San Luis Obispo,79,281455,487,343,2,345,1
2020-06-16,San Mateo,81,765935,2947,2618,3,2621,77
2020-06-16,Santa Barbara,83,443738,2929,2090,22,2112,16
2020-06-16,Santa Clara,85,1922200,4047,3228,6,3234,148
2020-06-16,Santa Cruz,87,273765,320,257,0,257,2
2020-06-16,Shasta,89,179085,112,51,0,51,4
2020-06-16,Sierra,91,2930,1,1,0,1,0
2020-06-16,Siskiyou,93,43540,26,15,0,15,0
2020-06-16,Solano,95,438530,1061,694,4,698,19
2020-06-16,Sonoma,97,501317,953,739,1,740,4
2020-06-16,Stanislaus,99,539301,2069,1278,5,1283,36
2020-06-16,Sutter,101,95872,109,73,0,73,2
2020-06-16,Tehama,103,63373,37,24,2,26,1
2020-06-16,Trinity,105,12862,4,2,2,4,0
2020-06-16,Tulare,107,460477,3821,2802,2,2804,96
2020-06-16,Tuolumne,109,53932,12,7,1,8,0
2020-06-16,Ventura,111,848112,2446,1676,7,1683,37
2020-06-16,Yolo,113,214977,374,262,0,262,24
2020-06-16,Yuba,115,75493,39,29,0,29,1
2020-06-15,Alameda,1,1643700,5159,4323,6,4329,112
2020-06-15,Alpine,3,1148,2,1,0,1,0
2020-06-15,Amador,5,37829,12,10,0,10,0
2020-06-15,Butte,7,227075,121,78,2,80,1
2020-06-15,Calaveras,9,45235,34,18,0,18,0
2020-06-15,Colusa,11,21464,14,7,0,7,0
2020-06-15,Contra Costa,13,1133247,2322,1918,0,1918,43
2020-06-15,Del Norte,15,27424,47,45,0,45,0
2020-06-15,El Dorado,17,186661,158,114,0,114,0
2020-06-15,Fresno,19,978130,5006,2616,40,2656,48
2020-06-15,Glenn,21,27897,66,21,0,21,0
2020-06-15,Humboldt,23,135768,133,105,0,105,3
2020-06-15,Imperial,25,180216,6189,3726,6,3732,36
2020-06-15,Inyo,27,18085,25,23,0,23,1
2020-06-15,Kern,29,883053,4675,3417,10,3427,55
2020-06-15,Kings,31,150075,2063,1022,4,1026,6
2020-06-15,Lake,33,64148,43,31,0,31,0
2020-06-15,Lassen,35,31185,12,5,1,6,0
2020-06-15,Los Angeles,37,10098052,84268,73705,24,73729,2908
2020-06-15,Madera,39,155013,487,203,0,203,3
2020-06-15,Marin,41,260295,1030,708,3,711,17
2020-06-15,Mariposa,43,17540,18,17,0,17,1
2020-06-15,Mendocino,45,87422,51,33,0,33,0
2020-06-15,Merced,47,269075,767,414,0,414,7
2020-06-15,Modoc,49,8938,1,0,0,0,0
2020-06-15,Mono,51,14174,42,34,0,34,1
2020-06-15,Monterey,53,433212,1339,998,2,1000,12
2020-06-15,Napa,55,140530,247,187,0,187,3
2020-06-15,Nevada,57,99092,85,52,1,53,1
2020-06-15,Orange,59,3164182,12947,8944,68,9012,212
2020-06-15,Placer,61,380077,528,386,2,388,9
2020-06-15,Plumas,63,18699,6,4,0,4,0
2020-06-15,Riverside,65,2383286,14505,11376,8,11384,364
2020-06-15,Sacramento,67,1510023,2163,1791,2,1793,60
2020-06-15,San Benito,69,59416,182,108,0,108,2
2020-06-15,San Bernardino,71,2135413,10488,7189,6,7195,224
2020-06-15,San Diego,73,3302833,11331,9612,0,9612,320
2020-06-15,San Francisco,75,870044,3170,2833,3,2836,45
2020-06-15,San Joaquin,77,732212,2496,1667,4,1671,43
2020-06-15,San Luis Obispo,79,281455,474,332,2,334,1
2020-06-15,San Mateo,81,765935,2900,2591,3,2594,75
2020-06-15,Santa Barbara,83,443738,2861,2054,22,2076,16
2020-06-15,Santa Clara,85,1922200,3947,3204,6,3210,148
2020-06-15,Santa Cruz,87,273765,309,254,0,254,2
2020-06-15,Shasta,89,179085,106,50,0,50,4
2020-06-15,Sierra,91,2930,1,1,0,1,0
2020-06-15,Siskiyou,93,43540,25,14,0,14,0
2020-06-15,Solano,95,438530,1001,638,4,642,19
2020-06-15,Sonoma,97,501317,924,726,1,727,4
2020-06-15,Stanislaus,99,539301,1952,1253,5,1258,35
2020-06-15,Sutter,101,95872,99,71,0,71,2
2020-06-15,Tehama,103,63373,37,17,2,19,1
2020-06-15,Trinity,105,12862,3,2,2,4,0
2020-06-15,Tulare,107,460477,3707,2662,2,2664,96
2020-06-15,Tuolumne,109,53932,11,7,1,8,0
2020-06-15,Ventura,111,848112,2365,1656,7,1663,37
2020-06-15,Yolo,113,214977,354,255,0,255,24
2020-06-15,Yuba,115,75493,39,28,0,28,1
2020-06-14,Alameda,1,1643700,5014,4271,6,4277,112
2020-06-14,Alpine,3,1148,2,1,0,1,0
2020-06-14,Amador,5,37829,12,10,0,10,0
2020-06-14,Butte,7,227075,114,78,2,80,1
2020-06-14,Calaveras,9,45235,33,18,0,18,0
2020-06-14,Colusa,11,21464,13,7,0,7,0
2020-06-14,Contra Costa,13,1133247,2253,1893,0,1893,43
2020-06-14,Del Norte,15,27424,47,45,0,45,0
2020-06-14,El Dorado,17,186661,154,110,0,110,0
2020-06-14,Fresno,19,978130,4822,2585,39,2624,48
2020-06-14,Glenn,21,27897,51,21,0,21,0
2020-06-14,Humboldt,23,135768,129,105,0,105,3
2020-06-14,Imperial,25,180216,5956,3730,6,3736,36
2020-06-14,Inyo,27,18085,24,23,0,23,1
2020-06-14,Kern,29,883053,4464,3328,10,3338,55
2020-06-14,Kings,31,150075,2012,1022,4,1026,6
2020-06-14,Lake,33,64148,40,31,0,31,0
2020-06-14,Lassen,35,31185,12,5,1,6,0
2020-06-14,Los Angeles,37,10098052,81944,72932,24,72956,2887
2020-06-14,Madera,39,155013,469,203,0,203,3
2020-06-14,Marin,41,260295,865,689,2,691,17
2020-06-14,Mariposa,43,17540,18,16,0,16,1
2020-06-14,Mendocino,45,87422,48,33,0,33,0
2020-06-14,Merced,47,269075,716,403,0,403,7
2020-06-14,Modoc,49,8938,1,0,0,0,0
2020-06-14,Mono,51,14174,42,34,0,34,1
2020-06-14,Monterey,53,433212,1278,949,2,951,12
2020-06-14,Napa,55,140530,225,181,0,181,3
2020-06-14,Nevada,57,99092,81,52,1,53,1
2020-06-14,Orange,59,3164182,12523,8744,65,8809,211
2020-06-14,Placer,61,380077,505,369,2,371,9
2020-06-14,Plumas,63,18699,5,4,0,4,0
2020-06-14,Riverside,65,2383286,14062,11218,8,11226,364
2020-06-14,Sacramento,67,1510023,2078,1750,2,1752,60
2020-06-14,San Benito,69,59416,171,104,0,104,2
2020-06-14,San Bernardino,71,2135413,9948,7015,6,7021,224
2020-06-14,San Diego,73,3302833,10956,9442,0,9442,319
2020-06-14,San Francisco,75,870044,3130,2834,3,2837,45
2020-06-14,San Joaquin,77,732212,2345,1603,4,1607,43
2020-06-14,San Luis Obispo,79,281455,459,330,2,332,1
2020-06-14,San Mateo,81,765935,2843,2571,3,2574,75
2020-06-14,Santa Barbara,83,443738,2784,2049,22,2071,17
2020-06-14,Santa Clara,85,1922200,3855,3178,6,3184,148
2020-06-14,Santa Cruz,87,273765,295,254,0,254,2
2020-06-14,Shasta,89,179085,100,48,0,48,4
2020-06-14,Sierra,91,2930,1,1,0,1,0
2020-06-14,Siskiyou,93,43540,24,13,0,13,0
2020-06-14,Solano,95,438530,952,638,4,642,19
2020-06-14,Sonoma,97,501317,896,724,1,725,4
2020-06-14,Stanislaus,99,539301,1804,1159,5,1164,35
2020-06-14,Sutter,101,95872,94,63,0,63,2
2020-06-14,Tehama,103,63373,34,17,2,19,1
2020-06-14,Trinity,105,12862,3,2,2,4,0
2020-06-14,Tulare,107,460477,3575,2646,2,2648,96
2020-06-14,Tuolumne,109,53932,11,7,1,8,0
2020-06-14,Ventura,111,848112,2267,1610,6,1616,37
2020-06-14,Yolo,113,214977,338,254,0,254,24
2020-06-14,Yuba,115,75493,38,28,0,28,1
2020-06-13,Alameda,1,1643700,4951,4196,6,4202,112
2020-06-13,Alpine,3,1148,2,1,0,1,0
2020-06-13,Amador,5,37829,11,10,0,10,0
2020-06-13,Butte,7,227075,105,72,2,74,1
2020-06-13,Calaveras,9,45235,31,18,0,18,0
2020-06-13,Colusa,11,21464,12,7,0,7,0
2020-06-13,Contra Costa,13,1133247,2217,1868,0,1868,43
2020-06-13,Del Norte,15,27424,47,45,0,45,0
2020-06-13,El Dorado,17,186661,150,110,0,110,0
2020-06-13,Fresno,19,978130,4724,2499,39,2538,48
2020-06-13,Glenn,21,27897,49,21,0,21,0
2020-06-13,Humboldt,23,135768,128,104,0,104,3
2020-06-13,Imperial,25,180216,5883,3646,6,3652,36
2020-06-13,Inyo,27,18085,24,23,0,23,1
2020-06-13,Kern,29,883053,4355,3239,10,3249,55
2020-06-13,Kings,31,150075,1992,1023,4,1027,6
2020-06-13,Lake,33,64148,39,29,0,29,0
2020-06-13,Lassen,35,31185,12,5,1,6,0
2020-06-13,Los Angeles,37,10098052,80904,71938,23,71961,2874
2020-06-13,Madera,39,155013,465,203,0,203,3
2020-06-13,Marin,41,260295,835,677,2,679,17
2020-06-13,Mariposa,43,17540,18,16,0,16,1
2020-06-13,Mendocino,45,87422,48,33,0,33,0
2020-06-13,Merced,47,269075,698,376,0,376,7
2020-06-13,Modoc,49,8938,1,0,0,0,0
2020-06-13,Mono,51,14174,42,35,0,35,1
2020-06-13,Monterey,53,433212,1240,900,2,902,11
2020-06-13,Napa,55,140530,222,171,0,171,3
2020-06-13,Nevada,57,99092,79,52,1,53,1
2020-06-13,Orange,59,3164182,12280,8581,61,8642,211
2020-06-13,Placer,61,380077,492,346,2,348,9
2020-06-13,Plumas,63,18699,5,4,0,4,0
2020-06-13,Riverside,65,2383286,13782,10931,8,10939,364
2020-06-13,Sacramento,67,1510023,2024,1713,2,1715,60
2020-06-13,San Benito,69,59416,164,99,0,99,2
2020-06-13,San Bernardino,71,2135413,9723,6885,6,6891,224
2020-06-13,San Diego,73,3302833,10784,9316,0,9316,319
2020-06-13,San Francisco,75,870044,3110,2834,3,2837,44
2020-06-13,San Joaquin,77,732212,2264,1461,4,1465,43
2020-06-13,San Luis Obispo,79,281455,448,326,2,328,1
2020-06-13,San Mateo,81,765935,2820,2551,3,2554,75
2020-06-13,Santa Barbara,83,443738,2726,1999,22,2021,15
2020-06-13,Santa Clara,85,1922200,3814,3141,6,3147,148
2020-06-13,Santa Cruz,87,273765,289,254,0,254,2
2020-06-13,Shasta,89,179085,98,48,0,48,4
2020-06-13,Sierra,91,2930,1,1,0,1,0
2020-06-13,Siskiyou,93,43540,24,13,0,13,0
2020-06-13,Solano,95,438530,924,637,4,641,19
2020-06-13,Sonoma,97,501317,881,711,1,712,4
2020-06-13,Stanislaus,99,539301,1747,1122,5,1127,33
2020-06-13,Sutter,101,95872,93,62,0,62,2
2020-06-13,Tehama,103,63373,33,17,2,19,1
2020-06-13,Trinity,105,12862,3,2,2,4,0
2020-06-13,Tulare,107,460477,3543,2626,2,2628,96
2020-06-13,Tuolumne,109,53932,10,7,1,8,0
2020-06-13,Ventura,111,848112,2221,1567,6,1573,37
2020-06-13,Yolo,113,214977,317,251,0,251,24
2020-06-13,Yuba,115,75493,38,28,0,28,1
2020-06-12,Alameda,1,1643700,4878,4167,6,4173,109
2020-06-12,Alpine,3,1148,2,1,0,1,0
2020-06-12,Amador,5,37829,11,10,0,10,0
2020-06-12,Butte,7,227075,101,71,2,73,1
2020-06-12,Calaveras,9,45235,28,18,0,18,0
2020-06-12,Colusa,11,21464,12,7,0,7,0
2020-06-12,Contra Costa,13,1133247,2180,1827,0,1827,43
2020-06-12,Del Norte,15,27424,47,45,0,45,0
2020-06-12,El Dorado,17,186661,150,110,0,110,0
2020-06-12,Fresno,19,978130,4588,2428,39,2467,47
2020-06-12,Glenn,21,27897,46,21,0,21,0
2020-06-12,Humboldt,23,135768,126,105,0,105,3
2020-06-12,Imperial,25,180216,5799,3543,6,3549,36
2020-06-12,Inyo,27,18085,24,23,0,23,1
2020-06-12,Kern,29,883053,4239,3152,10,3162,54
2020-06-12,Kings,31,150075,1979,987,4,991,6
2020-06-12,Lake,33,64148,38,29,0,29,0
2020-06-12,Lassen,35,31185,12,5,1,6,0
2020-06-12,Los Angeles,37,10098052,79496,70385,23,70408,2814
2020-06-12,Madera,39,155013,440,187,0,187,3
2020-06-12,Marin,41,260295,832,649,2,651,17
2020-06-12,Mariposa,43,17540,18,16,0,16,1
2020-06-12,Mendocino,45,87422,48,33,0,33,0
2020-06-12,Merced,47,269075,663,372,0,372,7
2020-06-12,Modoc,49,8938,1,0,0,0,0
2020-06-12,Mono,51,14174,39,35,0,35,1
2020-06-12,Monterey,53,433212,1199,864,2,866,11
2020-06-12,Napa,55,140530,219,162,0,162,3
2020-06-12,Nevada,57,99092,73,52,1,53,1
2020-06-12,Orange,59,3164182,11975,8440,60,8500,203
2020-06-12,Placer,61,380077,477,333,2,335,9
2020-06-12,Plumas,63,18699,5,4,0,4,0
2020-06-12,Riverside,65,2383286,13445,10616,8,10624,364
2020-06-12,Sacramento,67,1510023,1969,1702,2,1704,60
2020-06-12,San Benito,69,59416,157,96,0,96,2
2020-06-12,San Bernardino,71,2135413,9454,6707,5,6712,223
2020-06-12,San Diego,73,3302833,10614,9132,0,9132,313
2020-06-12,San Francisco,75,870044,3076,2823,3,2826,44
2020-06-12,San Joaquin,77,732212,2184,1406,4,1410,43
2020-06-12,San Luis Obispo,79,281455,432,321,2,323,1
2020-06-12,San Mateo,81,765935,2785,2533,3,2536,75
2020-06-12,Santa Barbara,83,443738,2672,1969,22,1991,14
2020-06-12,Santa Clara,85,1922200,3773,3099,6,3105,149
2020-06-12,Santa Cruz,87,273765,281,251,0,251,2
2020-06-12,Shasta,89,179085,91,48,0,48,5
2020-06-12,Sierra,91,2930,1,1,0,1,0
2020-06-12,Siskiyou,93,43540,24,13,0,13,0
2020-06-12,Solano,95,438530,910,620,4,624,19
2020-06-12,Sonoma,97,501317,862,696,1,697,4
2020-06-12,Stanislaus,99,539301,1688,1092,5,1097,33
2020-06-12,Sutter,101,95872,92,56,0,56,2
2020-06-12,Tehama,103,63373,32,13,2,15,1
2020-06-12,Trinity,105,12862,3,2,2,4,0
2020-06-12,Tulare,107,460477,3489,2552,2,2554,95
2020-06-12,Tuolumne,109,53932,10,7,1,8,0
2020-06-12,Ventura,111,848112,2169,1534,6,1540,35
2020-06-12,Yolo,113,214977,305,243,0,243,24
2020-06-12,Yuba,115,75493,36,27,0,27,1
2020-06-11,Alameda,1,1643700,4747,4073,5,4078,108
2020-06-11,Alpine,3,1148,2,1,0,1,0
2020-06-11,Amador,5,37829,10,10,0,10,0
2020-06-11,Butte,7,227075,95,72,2,74,1
2020-06-11,Calaveras,9,45235,27,16,0,16,0
2020-06-11,Colusa,11,21464,12,7,0,7,0
2020-06-11,Contra Costa,13,1133247,2126,1797,0,1797,43
2020-06-11,Del Norte,15,27424,47,45,0,45,0
2020-06-11,El Dorado,17,186661,142,109,0,109,0
2020-06-11,Fresno,19,978130,4433,2338,39,2377,45
2020-06-11,Glenn,21,27897,42,21,0,21,0
2020-06-11,Humboldt,23,135768,122,113,0,113,3
2020-06-11,Imperial,25,180216,5642,3463,6,3469,36
2020-06-11,Inyo,27,18085,22,23,0,23,1
2020-06-11,Kern,29,883053,4087,3047,8,3055,54
2020-06-11,Kings,31,150075,1945,963,4,967,6
2020-06-11,Lake,33,64148,38,28,0,28,0
2020-06-11,Lassen,35,31185,12,5,1,6,0
2020-06-11,Los Angeles,37,10098052,77828,68807,22,68829,2800
2020-06-11,Madera,39,155013,422,178,0,178,3
2020-06-11,Marin,41,260295,784,637,2,639,17
2020-06-11,Mariposa,43,17540,18,16,0,16,1
2020-06-11,Mendocino,45,87422,39,35,0,35,0
2020-06-11,Merced,47,269075,623,370,0,370,7
2020-06-11,Modoc,49,8938,1,0,0,0,0
2020-06-11,Mono,51,14174,39,35,0,35,1
2020-06-11,Monterey,53,433212,1152,813,2,815,11
2020-06-11,Napa,55,140530,210,162,0,162,3
2020-06-11,Nevada,57,99092,67,50,1,51,1
2020-06-11,Orange,59,3164182,11667,8304,59,8363,188
2020-06-11,Placer,61,380077,457,321,2,323,9
2020-06-11,Plumas,63,18699,5,4,0,4,0
2020-06-11,Riverside,65,2383286,13093,10014,8,10022,361
2020-06-11,Sacramento,67,1510023,1921,1669,2,1671,60
2020-06-11,San Benito,69,59416,151,94,0,94,2
2020-06-11,San Bernardino,71,2135413,9158,6509,5,6514,221
2020-06-11,San Diego,73,3302833,10384,9000,0,9000,308
2020-06-11,San Francisco,75,870044,3047,2766,3,2769,44
2020-06-11,San Joaquin,77,732212,2072,1351,4,1355,43
2020-06-11,San Luis Obispo,79,281455,418,307,2,309,1
2020-06-11,San Mateo,81,765935,2747,2499,3,2502,74
2020-06-11,Santa Barbara,83,443738,2607,1895,22,1917,14
2020-06-11,Santa Clara,85,1922200,3707,3049,6,3055,149
2020-06-11,Santa Cruz,87,273765,277,247,0,247,2
2020-06-11,Shasta,89,179085,84,47,0,47,5
2020-06-11,Sierra,91,2930,1,1,0,1,0
2020-06-11,Siskiyou,93,43540,24,14,0,14,0
2020-06-11,Solano,95,438530,884,616,4,620,19
2020-06-11,Sonoma,97,501317,839,682,1,683,4
2020-06-11,Stanislaus,99,539301,1597,1062,5,1067,30
2020-06-11,Sutter,101,95872,89,56,0,56,2
2020-06-11,Tehama,103,63373,27,10,2,12,1
2020-06-11,Trinity,105,12862,3,2,2,4,0
2020-06-11,Tulare,107,460477,3392,2473,2,2475,95
2020-06-11,Tuolumne,109,53932,10,7,1,8,0
2020-06-11,Ventura,111,848112,2092,1491,6,1497,34
2020-06-11,Yolo,113,214977,297,230,0,230,24
2020-06-11,Yuba,115,75493,36,27,0,27,1
2020-06-10,Alameda,1,1643700,4647,4027,4,4031,107
2020-06-10,Alpine,3,1148,2,1,0,1,0
2020-06-10,Amador,5,37829,10,10,0,10,0
2020-06-10,Butte,7,227075,92,71,2,73,1
2020-06-10,Calaveras,9,45235,27,16,0,16,0
2020-06-10,Colusa,11,21464,11,7,0,7,0
2020-06-10,Contra Costa,13,1133247,2082,1778,0,1778,43
2020-06-10,Del Norte,15,27424,47,45,0,45,0
2020-06-10,El Dorado,17,186661,139,109,0,109,0
2020-06-10,Fresno,19,978130,4257,2324,39,2363,45
2020-06-10,Glenn,21,27897,39,21,0,21,0
2020-06-10,Humboldt,23,135768,118,112,0,112,3
2020-06-10,Imperial,25,180216,5494,3454,6,3460,36
2020-06-10,Inyo,27,18085,22,23,0,23,1
2020-06-10,Kern,29,883053,3962,3000,8,3008,54
2020-06-10,Kings,31,150075,1898,952,3,955,6
2020-06-10,Lake,33,64148,38,28,0,28,0
2020-06-10,Lassen,35,31185,12,5,1,6,0
2020-06-10,Los Angeles,37,10098052,76307,67018,22,67040,2752
2020-06-10,Madera,39,155013,408,176,0,176,3
2020-06-10,Marin,41,260295,752,633,2,635,17
2020-06-10,Mariposa,43,17540,17,16,0,16,1
2020-06-10,Mendocino,45,87422,38,35,0,35,0
2020-06-10,Merced,47,269075,590,370,0,370,7
2020-06-10,Modoc,49,8938,1,0,0,0,0
2020-06-10,Mono,51,14174,39,35,0,35,1
2020-06-10,Monterey,53,433212,1098,791,2,793,11
2020-06-10,Napa,55,140530,207,159,0,159,3
2020-06-10,Nevada,57,99092,65,50,1,51,1
2020-06-10,Orange,59,3164182,11391,8222,56,8278,184
2020-06-10,Placer,61,380077,426,309,2,311,9
2020-06-10,Plumas,63,18699,5,4,0,4,0
2020-06-10,Riverside,65,2383286,12770,9857,8,9865,361
2020-06-10,Sacramento,67,1510023,1882,1643,2,1645,59
2020-06-10,San Benito,69,59416,142,94,0,94,2
2020-06-10,San Bernardino,71,2135413,8866,6438,5,6443,219
2020-06-10,San Diego,73,3302833,10220,8839,0,8839,305
2020-06-10,San Francisco,75,870044,3022,2774,3,2777,44
2020-06-10,San Joaquin,77,732212,1943,1282,4,1286,41
2020-06-10,San Luis Obispo,79,281455,399,306,2,308,1
2020-06-10,San Mateo,81,765935,2706,2492,3,2495,74
2020-06-10,Santa Barbara,83,443738,2551,1878,22,1900,13
2020-06-10,Santa Clara,85,1922200,3656,3032,6,3038,149
2020-06-10,Santa Cruz,87,273765,273,242,0,242,2
2020-06-10,Shasta,89,179085,79,45,0,45,5
2020-06-10,Sierra,91,2930,1,1,0,1,0
2020-06-10,Siskiyou,93,43540,24,14,0,14,0
2020-06-10,Solano,95,438530,848,608,4,612,19
2020-06-10,Sonoma,97,501317,821,673,1,674,4
2020-06-10,Stanislaus,99,539301,1507,1030,5,1035,29
2020-06-10,Sutter,101,95872,88,56,0,56,2
2020-06-10,Tehama,103,63373,25,10,2,12,1
2020-06-10,Trinity,105,12862,3,2,2,4,0
2020-06-10,Tulare,107,460477,3300,2455,2,2457,95
2020-06-10,Tuolumne,109,53932,10,7,1,8,0
2020-06-10,Ventura,111,848112,2046,1446,5,1451,34
2020-06-10,Yolo,113,214977,289,226,0,226,24
2020-06-10,Yuba,115,75493,35,27,0,27,1
2020-06-09,Alameda,1,1643700,4537,3963,4,3967,103
2020-06-09,Alpine,3,1148,2,1,0,1,0
2020-06-09,Amador,5,37829,10,10,0,10,0
2020-06-09,Butte,7,227075,91,70,2,72,1
2020-06-09,Calaveras,9,45235,27,16,0,16,0
2020-06-09,Colusa,11,21464,10,7,0,7,0
2020-06-09,Contra Costa,13,1133247,2042,1744,0,1744,42
2020-06-09,Del Norte,15,27424,47,45,0,45,0
2020-06-09,El Dorado,17,186661,133,108,0,108,0
2020-06-09,Fresno,19,978130,4105,2278,39,2317,43
2020-06-09,Glenn,21,27897,38,19,0,19,0
2020-06-09,Humboldt,23,135768,116,113,0,113,2
2020-06-09,Imperial,25,180216,5342,3067,6,3073,36
2020-06-09,Inyo,27,18085,22,22,0,22,1
2020-06-09,Kern,29,883053,3835,2920,8,2928,51
2020-06-09,Kings,31,150075,1866,934,3,937,6
2020-06-09,Lake,33,64148,38,28,0,28,0
2020-06-09,Lassen,35,31185,12,5,1,6,0
2020-06-09,Los Angeles,37,10098052,74648,65827,22,65849,2692
2020-06-09,Madera,39,155013,393,172,0,172,3
2020-06-09,Marin,41,260295,716,616,2,618,17
2020-06-09,Mariposa,43,17540,17,16,0,16,1
2020-06-09,Mendocino,45,87422,34,35,0,35,0
2020-06-09,Merced,47,269075,561,349,0,349,7
2020-06-09,Modoc,49,8938,1,0,0,0,0
2020-06-09,Mono,51,14174,39,35,0,35,1
2020-06-09,Monterey,53,433212,1057,772,2,774,11
2020-06-09,Napa,55,140530,197,156,0,156,3
2020-06-09,Nevada,57,99092,57,50,1,51,1
2020-06-09,Orange,59,3164182,11150,7991,54,8045,174
2020-06-09,Placer,61,380077,413,301,2,303,9
2020-06-09,Plumas,63,18699,5,4,0,4,0
2020-06-09,Riverside,65,2383286,12392,9511,8,9519,354
2020-06-09,Sacramento,67,1510023,1828,1625,2,1627,59
2020-06-09,San Benito,69,59416,136,95,0,95,2
2020-06-09,San Bernardino,71,2135413,8542,6268,4,6272,217
2020-06-09,San Diego,73,3302833,10035,8731,0,8731,301
2020-06-09,San Francisco,75,870044,2997,2749,3,2752,44
2020-06-09,San Joaquin,77,732212,1836,1240,4,1244,41
2020-06-09,San Luis Obispo,79,281455,386,301,1,302,1
2020-06-09,San Mateo,81,765935,2675,2463,3,2466,74
2020-06-09,Santa Barbara,83,443738,2489,1854,22,1876,13
2020-06-09,Santa Clara,85,1922200,3589,3006,6,3012,147
2020-06-09,Santa Cruz,87,273765,267,237,0,237,2
2020-06-09,Shasta,89,179085,75,44,0,44,4
2020-06-09,Sierra,91,2930,1,1,0,1,0
2020-06-09,Siskiyou,93,43540,19,10,0,10,0
2020-06-09,Solano,95,438530,813,596,4,600,18
2020-06-09,Sonoma,97,501317,798,661,1,662,4
2020-06-09,Stanislaus,99,539301,1406,993,5,998,25
2020-06-09,Sutter,101,95872,85,56,0,56,2
2020-06-09,Tehama,103,63373,25,9,2,11,1
2020-06-09,Trinity,105,12862,3,2,2,4,0
2020-06-09,Tulare,107,460477,3234,2393,2,2395,91
2020-06-09,Tuolumne,109,53932,10,8,1,9,0
2020-06-09,Ventura,111,848112,1980,1407,5,1412,34
2020-06-09,Yolo,113,214977,278,226,0,226,24
2020-06-09,Yuba,115,75493,34,27,0,27,1
2020-06-08,Alameda,1,1643700,4457,3937,4,3941,103
2020-06-08,Alpine,3,1148,2,1,0,1,0
2020-06-08,Amador,5,37829,10,10,0,10,0
2020-06-08,Butte,7,227075,89,68,2,70,1
2020-06-08,Calaveras,9,45235,27,16,0,16,0
2020-06-08,Colusa,11,21464,9,7,0,7,0
2020-06-08,Contra Costa,13,1133247,1999,1714,0,1714,41
2020-06-08,Del Norte,15,27424,47,45,0,45,0
2020-06-08,El Dorado,17,186661,129,107,0,107,0
2020-06-08,Fresno,19,978130,3980,2194,38,2232,42
2020-06-08,Glenn,21,27897,36,17,0,17,0
2020-06-08,Humboldt,23,135768,116,112,0,112,2
2020-06-08,Imperial,25,180216,5190,3051,6,3057,21
2020-06-08,Inyo,27,18085,22,22,0,22,1
2020-06-08,Kern,29,883053,3705,2853,8,2861,49
2020-06-08,Kings,31,150075,1790,892,3,895,6
2020-06-08,Lake,33,64148,38,28,0,28,0
2020-06-08,Lassen,35,31185,12,4,1,5,0
2020-06-08,Los Angeles,37,10098052,73189,64634,22,64656,2640
2020-06-08,Madera,39,155013,363,154,0,154,3
2020-06-08,Marin,41,260295,675,596,2,598,17
2020-06-08,Mariposa,43,17540,16,16,0,16,1
2020-06-08,Mendocino,45,87422,32,32,0,32,0
2020-06-08,Merced,47,269075,527,331,0,331,7
2020-06-08,Modoc,49,8938,1,0,0,0,0
2020-06-08,Mono,51,14174,39,35,0,35,1
2020-06-08,Monterey,53,433212,1006,751,1,752,10
2020-06-08,Napa,55,140530,181,151,0,151,3
2020-06-08,Nevada,57,99092,56,50,1,51,1
2020-06-08,Orange,59,3164182,10898,7786,53,7839,160
2020-06-08,Placer,61,380077,386,290,2,292,9
2020-06-08,Plumas,63,18699,5,4,0,4,0
2020-06-08,Riverside,65,2383286,12023,9246,8,9254,347
2020-06-08,Sacramento,67,1510023,1778,1591,2,1593,59
2020-06-08,San Benito,69,59416,129,93,0,93,2
2020-06-08,San Bernardino,71,2135413,8221,6122,4,6126,214
2020-06-08,San Diego,73,3302833,9878,8621,0,8621,296
2020-06-08,San Francisco,75,870044,2970,2715,3,2718,43
2020-06-08,San Joaquin,77,732212,1729,1198,4,1202,40
2020-06-08,San Luis Obispo,79,281455,380,300,1,301,1
2020-06-08,San Mateo,81,765935,2644,2431,3,2434,74
2020-06-08,Santa Barbara,83,443738,2428,1824,22,1846,13
2020-06-08,Santa Clara,85,1922200,3544,2971,6,2977,146
2020-06-08,Santa Cruz,87,273765,266,234,0,234,2
2020-06-08,Shasta,89,179085,71,43,0,43,4
2020-06-08,Sierra,91,2930,1,1,0,1,0
2020-06-08,Siskiyou,93,43540,19,8,0,8,0
2020-06-08,Solano,95,438530,786,560,4,564,19
2020-06-08,Sonoma,97,501317,782,654,1,655,4
2020-06-08,Stanislaus,99,539301,1324,956,5,961,28
2020-06-08,Sutter,101,95872,78,55,0,55,2
2020-06-08,Tehama,103,63373,19,8,1,9,1
2020-06-08,Trinity,105,12862,3,2,2,4,0
2020-06-08,Tulare,107,460477,3151,2301,2,2303,91
2020-06-08,Tuolumne,109,53932,9,8,1,9,0
2020-06-08,Ventura,111,848112,1922,1382,5,1387,30
2020-06-08,Yolo,113,214977,267,228,0,228,24
2020-06-08,Yuba,115,75493,32,27,0,27,1
2020-06-07,Alameda,1,1643700,4344,3866,4,3870,102
2020-06-07,Alpine,3,1148,2,1,0,1,0
2020-06-07,Amador,5,37829,10,10,0,10,0
2020-06-07,Butte,7,227075,87,64,1,65,1
2020-06-07,Calaveras,9,45235,25,16,0,16,0
2020-06-07,Colusa,11,21464,9,7,0,7,0
2020-06-07,Contra Costa,13,1133247,1948,1653,0,1653,38
2020-06-07,Del Norte,15,27424,45,45,0,45,0
2020-06-07,El Dorado,17,186661,129,104,0,104,0
2020-06-07,Fresno,19,978130,3850,2144,38,2182,41
2020-06-07,Glenn,21,27897,29,16,0,16,0
2020-06-07,Humboldt,23,135768,116,112,0,112,2
2020-06-07,Imperial,25,180216,5038,3048,6,3054,19
2020-06-07,Inyo,27,18085,22,21,0,21,1
2020-06-07,Kern,29,883053,3575,2771,8,2779,46
2020-06-07,Kings,31,150075,1742,882,3,885,6
2020-06-07,Lake,33,64148,35,28,0,28,0
2020-06-07,Lassen,35,31185,11,4,1,5,0
2020-06-07,Los Angeles,37,10098052,71480,63750,22,63772,2629
2020-06-07,Madera,39,155013,346,149,0,149,3
2020-06-07,Marin,41,260295,661,584,2,586,17
2020-06-07,Mariposa,43,17540,16,16,0,16,1
2020-06-07,Mendocino,45,87422,32,32,0,32,0
2020-06-07,Merced,47,269075,494,318,0,318,7
2020-06-07,Modoc,49,8938,1,0,0,0,0
2020-06-07,Mono,51,14174,39,35,0,35,1
2020-06-07,Monterey,53,433212,959,732,1,733,10
2020-06-07,Napa,55,140530,173,142,0,142,3
2020-06-07,Nevada,57,99092,55,50,1,51,1
2020-06-07,Orange,59,3164182,10641,7643,51,7694,158
2020-06-07,Placer,61,380077,364,273,2,275,9
2020-06-07,Plumas,63,18699,5,4,0,4,0
2020-06-07,Riverside,65,2383286,11727,9105,8,9113,344
2020-06-07,Sacramento,67,1510023,1732,1568,2,1570,59
2020-06-07,San Benito,69,59416,126,92,0,92,2
2020-06-07,San Bernardino,71,2135413,7938,6033,4,6037,214
2020-06-07,San Diego,73,3302833,9699,8478,0,8478,296
2020-06-07,San Francisco,75,870044,2926,2674,2,2676,43
2020-06-07,San Joaquin,77,732212,1628,1126,4,1130,37
2020-06-07,San Luis Obispo,79,281455,370,296,1,297,1
2020-06-07,San Mateo,81,765935,2617,2399,3,2402,73
2020-06-07,Santa Barbara,83,443738,2367,1818,22,1840,13
2020-06-07,Santa Clara,85,1922200,3494,2947,6,2953,146
2020-06-07,Santa Cruz,87,273765,258,230,0,230,2
2020-06-07,Shasta,89,179085,70,41,0,41,4
2020-06-07,Sierra,91,2930,1,1,0,1,0
2020-06-07,Siskiyou,93,43540,19,8,0,8,0
2020-06-07,Solano,95,438530,763,560,4,564,19
2020-06-07,Sonoma,97,501317,751,639,1,640,4
2020-06-07,Stanislaus,99,539301,1245,905,5,910,28
2020-06-07,Sutter,101,95872,70,55,0,55,2
2020-06-07,Tehama,103,63373,16,8,1,9,1
2020-06-07,Trinity,105,12862,2,2,1,3,0
2020-06-07,Tulare,107,460477,3029,2219,2,2221,90
2020-06-07,Tuolumne,109,53932,9,4,1,5,0
2020-06-07,Ventura,111,848112,1857,1337,5,1342,30
2020-06-07,Yolo,113,214977,257,224,0,224,24
2020-06-07,Yuba,115,75493,32,27,0,27,1
2020-06-06,Alameda,1,1643700,4299,3801,4,3805,102
2020-06-06,Alpine,3,1148,2,1,0,1,0
2020-06-06,Amador,5,37829,10,10,0,10,0
2020-06-06,Butte,7,227075,86,63,1,64,1
2020-06-06,Calaveras,9,45235,23,16,0,16,0
2020-06-06,Colusa,11,21464,9,7,0,7,0
2020-06-06,Contra Costa,13,1133247,1927,1619,0,1619,37
2020-06-06,Del Norte,15,27424,45,45,0,45,0
2020-06-06,El Dorado,17,186661,126,104,0,104,0
2020-06-06,Fresno,19,978130,3797,2117,38,2155,41
2020-06-06,Glenn,21,27897,27,16,0,16,0
2020-06-06,Humboldt,23,135768,116,112,0,112,2
2020-06-06,Imperial,25,180216,4963,3047,6,3053,19
2020-06-06,Inyo,27,18085,22,21,0,21,1
2020-06-06,Kern,29,883053,3505,2695,8,2703,46
2020-06-06,Kings,31,150075,1723,882,3,885,6
2020-06-06,Lake,33,64148,35,28,0,28,0
2020-06-06,Lassen,35,31185,11,4,1,5,0
2020-06-06,Los Angeles,37,10098052,70733,62269,22,62291,2607
2020-06-06,Madera,39,155013,337,149,0,149,3
2020-06-06,Marin,41,260295,656,556,2,558,17
2020-06-06,Mariposa,43,17540,16,16,0,16,1
2020-06-06,Mendocino,45,87422,32,32,0,32,0
2020-06-06,Merced,47,269075,492,315,0,315,7
2020-06-06,Modoc,49,8938,1,0,0,0,0
2020-06-06,Mono,51,14174,39,35,0,35,1
2020-06-06,Monterey,53,433212,935,679,1,680,10
2020-06-06,Napa,55,140530,167,136,0,136,3
2020-06-06,Nevada,57,99092,54,50,1,51,1
2020-06-06,Orange,59,3164182,10482,7576,50,7626,157
2020-06-06,Placer,61,380077,356,270,2,272,9
2020-06-06,Plumas,63,18699,5,4,0,4,0
2020-06-06,Riverside,65,2383286,11548,8935,8,8943,345
2020-06-06,Sacramento,67,1510023,1709,1533,2,1535,59
2020-06-06,San Benito,69,59416,116,92,0,92,2
2020-06-06,San Bernardino,71,2135413,7790,5946,4,5950,214
2020-06-06,San Diego,73,3302833,9579,8347,0,8347,296
2020-06-06,San Francisco,75,870044,2911,2674,2,2676,43
2020-06-06,San Joaquin,77,732212,1588,1076,4,1080,37
2020-06-06,San Luis Obispo,79,281455,364,295,1,296,1
2020-06-06,San Mateo,81,765935,2602,2342,3,2345,72
2020-06-06,Santa Barbara,83,443738,2327,1815,22,1837,13
2020-06-06,Santa Clara,85,1922200,3453,2934,6,2940,144
2020-06-06,Santa Cruz,87,273765,256,226,0,226,2
2020-06-06,Shasta,89,179085,70,40,0,40,4
2020-06-06,Sierra,91,2930,1,1,0,1,0
2020-06-06,Siskiyou,93,43540,17,8,0,8,0
2020-06-06,Solano,95,438530,748,560,4,564,19
2020-06-06,Sonoma,97,501317,739,622,1,623,4
2020-06-06,Stanislaus,99,539301,1211,858,5,863,27
2020-06-06,Sutter,101,95872,70,51,0,51,2
2020-06-06,Tehama,103,63373,15,8,1,9,1
2020-06-06,Trinity,105,12862,2,2,1,3,0
2020-06-06,Tulare,107,460477,2996,2213,2,2215,90
2020-06-06,Tuolumne,109,53932,9,4,1,5,0
2020-06-06,Ventura,111,848112,1833,1303,5,1308,30
2020-06-06,Yolo,113,214977,255,223,0,223,24
2020-06-06,Yuba,115,75493,32,27,0,27,1
2020-06-05,Alameda,1,1643700,4248,3734,4,3738,102
2020-06-05,Alpine,3,1148,2,1,0,1,0
2020-06-05,Amador,5,37829,10,10,0,10,0
2020-06-05,Butte,7,227075,83,61,1,62,1
2020-06-05,Calaveras,9,45235,22,16,0,16,0
2020-06-05,Colusa,11,21464,9,7,0,7,0
2020-06-05,Contra Costa,13,1133247,1912,1575,0,1575,37
2020-06-05,Del Norte,15,27424,45,45,0,45,0
2020-06-05,El Dorado,17,186661,125,101,0,101,0
2020-06-05,Fresno,19,978130,3733,2051,37,2088,38
2020-06-05,Glenn,21,27897,25,16,0,16,0
2020-06-05,Humboldt,23,135768,115,111,0,111,2
2020-06-05,Imperial,25,180216,4856,2778,6,2784,19
2020-06-05,Inyo,27,18085,22,21,0,21,1
2020-06-05,Kern,29,883053,3416,2624,8,2632,46
2020-06-05,Kings,31,150075,1708,865,3,868,6
2020-06-05,Lake,33,64148,35,28,0,28,0
2020-06-05,Lassen,35,31185,10,4,1,5,0
2020-06-05,Los Angeles,37,10098052,69574,60955,22,60977,2553
2020-06-05,Madera,39,155013,315,144,0,144,3
2020-06-05,Marin,41,260295,647,546,2,548,17
2020-06-05,Mariposa,43,17540,16,16,0,16,1
2020-06-05,Mendocino,45,87422,32,32,0,32,0
2020-06-05,Merced,47,269075,490,309,0,309,7
2020-06-05,Modoc,49,8938,1,0,0,0,0
2020-06-05,Mono,51,14174,39,35,0,35,1
2020-06-05,Monterey,53,433212,903,649,1,650,10
2020-06-05,Napa,55,140530,164,123,0,123,3
2020-06-05,Nevada,57,99092,54,50,1,51,1
2020-06-05,Orange,59,3164182,10287,7391,48,7439,153
2020-06-05,Placer,61,380077,347,265,2,267,9
2020-06-05,Plumas,63,18699,5,4,0,4,0
2020-06-05,Riverside,65,2383286,11288,8700,8,8708,345
2020-06-05,Sacramento,67,1510023,1687,1514,2,1516,59
2020-06-05,San Benito,69,59416,114,92,0,92,2
2020-06-05,San Bernardino,71,2135413,7608,5869,3,5872,212
2020-06-05,San Diego,73,3302833,9464,8182,0,8182,294
2020-06-05,San Francisco,75,870044,2892,2675,2,2677,43
2020-06-05,San Joaquin,77,732212,1509,1046,4,1050,36
2020-06-05,San Luis Obispo,79,281455,357,293,1,294,1
2020-06-05,San Mateo,81,765935,2577,2331,3,2334,72
2020-06-05,Santa Barbara,83,443738,2292,1795,22,1817,13
2020-06-05,Santa Clara,85,1922200,3428,2902,6,2908,144
2020-06-05,Santa Cruz,87,273765,253,222,0,222,2
2020-06-05,Shasta,89,179085,69,40,0,40,4
2020-06-05,Sierra,91,2930,1,1,0,1,0
2020-06-05,Siskiyou,93,43540,15,8,0,8,0
2020-06-05,Solano,95,438530,741,558,4,562,19
2020-06-05,Sonoma,97,501317,718,618,1,619,4
2020-06-05,Stanislaus,99,539301,1178,842,5,847,27
2020-06-05,Sutter,101,95872,70,49,0,49,2
2020-06-05,Tehama,103,63373,15,7,1,8,1
2020-06-05,Trinity,105,12862,2,1,1,2,0
2020-06-05,Tulare,107,460477,2947,2180,2,2182,90
2020-06-05,Tuolumne,109,53932,9,4,1,5,0
2020-06-05,Ventura,111,848112,1800,1274,5,1279,30
2020-06-05,Yolo,113,214977,254,216,0,216,24
2020-06-05,Yuba,115,75493,32,27,0,27,1
2020-06-04,Alameda,1,1643700,4149,3643,4,3647,99
2020-06-04,Alpine,3,1148,2,1,0,1,0
2020-06-04,Amador,5,37829,10,10,0,10,0
2020-06-04,Butte,7,227075,79,57,1,58,1
2020-06-04,Calaveras,9,45235,22,15,0,15,0
2020-06-04,Colusa,11,21464,9,7,0,7,0
2020-06-04,Contra Costa,13,1133247,1854,1551,0,1551,37
2020-06-04,Del Norte,15,27424,45,45,0,45,0
2020-06-04,El Dorado,17,186661,123,101,0,101,0
2020-06-04,Fresno,19,978130,3627,2007,37,2044,35
2020-06-04,Glenn,21,27897,22,16,0,16,0
2020-06-04,Humboldt,23,135768,115,109,0,109,2
2020-06-04,Imperial,25,180216,4673,2631,6,2637,19
2020-06-04,Inyo,27,18085,22,20,0,20,1
2020-06-04,Kern,29,883053,3302,2530,8,2538,46
2020-06-04,Kings,31,150075,1638,842,3,845,6
2020-06-04,Lake,33,64148,34,27,0,27,0
2020-06-04,Lassen,35,31185,8,4,1,5,0
2020-06-04,Los Angeles,37,10098052,68100,59596,22,59618,2515
2020-06-04,Madera,39,155013,307,127,0,127,3
2020-06-04,Marin,41,260295,625,533,2,535,14
2020-06-04,Mariposa,43,17540,16,16,0,16,1
2020-06-04,Mendocino,45,87422,32,29,0,29,0
2020-06-04,Merced,47,269075,470,304,0,304,7
2020-06-04,Modoc,49,8938,1,0,0,0,0
2020-06-04,Mono,51,14174,39,35,0,35,1
2020-06-04,Monterey,53,433212,868,621,1,622,10
2020-06-04,Napa,55,140530,160,117,0,117,3
2020-06-04,Nevada,57,99092,53,49,1,50,1
2020-06-04,Orange,59,3164182,10036,7192,47,7239,148
2020-06-04,Placer,61,380077,333,256,2,258,9
2020-06-04,Plumas,63,18699,4,4,0,4,0
2020-06-04,Riverside,65,2383286,11010,8473,8,8481,341
2020-06-04,Sacramento,67,1510023,1660,1492,2,1494,58
2020-06-04,San Benito,69,59416,112,88,0,88,2
2020-06-04,San Bernardino,71,2135413,7340,5726,3,5729,207
2020-06-04,San Diego,73,3302833,9301,7942,0,7942,288
2020-06-04,San Francisco,75,870044,2859,2636,2,2638,43
2020-06-04,San Joaquin,77,732212,1447,1016,4,1020,36
2020-06-04,San Luis Obispo,79,281455,349,288,1,289,1
2020-06-04,San Mateo,81,765935,2551,2284,3,2287,72
2020-06-04,Santa Barbara,83,443738,2254,1750,22,1772,13
2020-06-04,Santa Clara,85,1922200,3396,2871,6,2877,144
2020-06-04,Santa Cruz,87,273765,247,218,0,218,2
2020-06-04,Shasta,89,179085,63,40,0,40,4
2020-06-04,Sierra,91,2930,1,1,0,1,0
2020-06-04,Siskiyou,93,43540,14,8,0,8,0
2020-06-04,Solano,95,438530,724,551,4,555,19
2020-06-04,Sonoma,97,501317,699,591,1,592,4
2020-06-04,Stanislaus,99,539301,1102,806,5,811,28
2020-06-04,Sutter,101,95872,65,46,0,46,2
2020-06-04,Tehama,103,63373,14,6,1,7,1
2020-06-04,Trinity,105,12862,2,1,1,2,0
2020-06-04,Tulare,107,460477,2831,2086,2,2088,90
2020-06-04,Tuolumne,109,53932,8,4,1,5,0
2020-06-04,Ventura,111,848112,1757,1236,5,1241,30
2020-06-04,Yolo,113,214977,249,216,0,216,24
2020-06-04,Yuba,115,75493,31,27,0,27,1
2020-06-03,Alameda,1,1643700,4090,3589,3,3592,99
2020-06-03,Alpine,3,1148,2,1,0,1,0
2020-06-03,Amador,5,37829,10,10,0,10,0
2020-06-03,Butte,7,227075,77,53,1,54,1
2020-06-03,Calaveras,9,45235,21,15,0,15,0
2020-06-03,Colusa,11,21464,9,7,0,7,0
2020-06-03,Contra Costa,13,1133247,1806,1511,0,1511,37
2020-06-03,Del Norte,15,27424,45,39,0,39,0
2020-06-03,El Dorado,17,186661,120,90,0,90,0
2020-06-03,Fresno,19,978130,3530,1943,37,1980,35
2020-06-03,Glenn,21,27897,22,16,0,16,0
2020-06-03,Humboldt,23,135768,115,103,0,103,2
2020-06-03,Imperial,25,180216,4501,2540,6,2546,19
2020-06-03,Inyo,27,18085,22,20,0,20,1
2020-06-03,Kern,29,883053,3207,2452,8,2460,44
2020-06-03,Kings,31,150075,1573,744,3,747,6
2020-06-03,Lake,33,64148,32,26,0,26,0
2020-06-03,Lassen,35,31185,8,4,1,5,0
2020-06-03,Los Angeles,37,10098052,66488,58166,22,58188,2472
2020-06-03,Madera,39,155013,299,117,0,117,3
2020-06-03,Marin,41,260295,607,527,2,529,14
2020-06-03,Mariposa,43,17540,16,16,0,16,1
2020-06-03,Mendocino,45,87422,31,29,0,29,0
2020-06-03,Merced,47,269075,456,299,0,299,7
2020-06-03,Modoc,49,8938,1,0,0,0,0
2020-06-03,Mono,51,14174,39,35,0,35,1
2020-06-03,Monterey,53,433212,840,592,1,593,10
2020-06-03,Napa,55,140530,159,116,0,116,3
2020-06-03,Nevada,57,99092,52,43,1,44,1
2020-06-03,Orange,59,3164182,9808,6939,46,6985,145
2020-06-03,Placer,61,380077,320,243,2,245,9
2020-06-03,Plumas,63,18699,4,4,0,4,0
2020-06-03,Riverside,65,2383286,10735,8208,8,8216,335
2020-06-03,Sacramento,67,1510023,1630,1457,2,1459,58
2020-06-03,San Benito,69,59416,106,88,0,88,2
2020-06-03,San Bernardino,71,2135413,7117,5565,3,5568,203
2020-06-03,San Diego,73,3302833,9153,7800,0,7800,283
2020-06-03,San Francisco,75,870044,2828,2608,2,2610,43
2020-06-03,San Joaquin,77,732212,1382,1004,4,1008,35
2020-06-03,San Luis Obispo,79,281455,344,279,1,280,1
2020-06-03,San Mateo,81,765935,2522,2243,3,2246,71
2020-06-03,Santa Barbara,83,443738,2211,1722,22,1744,12
2020-06-03,Santa Clara,85,1922200,3357,2836,6,2842,144
2020-06-03,Santa Cruz,87,273765,241,217,0,217,2
2020-06-03,Shasta,89,179085,60,40,0,40,4
2020-06-03,Sierra,91,2930,1,1,0,1,0
2020-06-03,Siskiyou,93,43540,13,8,0,8,0
2020-06-03,Solano,95,438530,699,543,2,545,18
2020-06-03,Sonoma,97,501317,688,578,1,579,4
2020-06-03,Stanislaus,99,539301,1062,780,5,785,27
2020-06-03,Sutter,101,95872,57,45,0,45,2
2020-06-03,Tehama,103,63373,14,6,1,7,1
2020-06-03,Trinity,105,12862,2,1,1,2,0
2020-06-03,Tulare,107,460477,2762,2041,2,2043,88
2020-06-03,Tuolumne,109,53932,6,4,1,5,0
2020-06-03,Ventura,111,848112,1693,1202,5,1207,30
2020-06-03,Yolo,113,214977,245,213,0,213,24
2020-06-03,Yuba,115,75493,31,27,0,27,1
2020-06-02,Alameda,1,1643700,4014,3517,3,3520,99
2020-06-02,Alpine,3,1148,2,1,0,1,0
2020-06-02,Amador,5,37829,10,10,0,10,0
2020-06-02,Butte,7,227075,73,51,1,52,1
2020-06-02,Calaveras,9,45235,21,15,0,15,0
2020-06-02,Colusa,11,21464,9,7,0,7,0
2020-06-02,Contra Costa,13,1133247,1774,1505,0,1505,37
2020-06-02,Del Norte,15,27424,45,39,0,39,0
2020-06-02,El Dorado,17,186661,119,88,0,88,0
2020-06-02,Fresno,19,978130,3420,1917,37,1954,34
2020-06-02,Glenn,21,27897,21,16,0,16,0
2020-06-02,Humboldt,23,135768,115,101,0,101,2
2020-06-02,Imperial,25,180216,4308,2459,6,2465,19
2020-06-02,Inyo,27,18085,20,20,0,20,1
2020-06-02,Kern,29,883053,3109,2406,6,2412,41
2020-06-02,Kings,31,150075,1545,720,3,723,5
2020-06-02,Lake,33,64148,32,25,0,25,0
2020-06-02,Lassen,35,31185,7,4,1,5,0
2020-06-02,Los Angeles,37,10098052,65085,57144,22,57166,2430
2020-06-02,Madera,39,155013,278,110,0,110,2
2020-06-02,Marin,41,260295,580,509,2,511,14
2020-06-02,Mariposa,43,17540,16,16,0,16,1
2020-06-02,Mendocino,45,87422,31,29,0,29,0
2020-06-02,Merced,47,269075,440,297,0,297,6
2020-06-02,Modoc,49,8938,1,0,0,0,0
2020-06-02,Mono,51,14174,39,35,0,35,1
2020-06-02,Monterey,53,433212,810,582,1,583,10
2020-06-02,Napa,55,140530,150,116,0,116,3
2020-06-02,Nevada,57,99092,51,41,1,42,1
2020-06-02,Orange,59,3164182,9606,6790,45,6835,142
2020-06-02,Placer,61,380077,304,226,2,228,9
2020-06-02,Plumas,63,18699,4,4,0,4,0
2020-06-02,Riverside,65,2383286,10440,8091,7,8098,330
2020-06-02,Sacramento,67,1510023,1601,1428,2,1430,58
2020-06-02,San Benito,69,59416,105,86,0,86,2
2020-06-02,San Bernardino,71,2135413,6911,5438,3,5441,202
2020-06-02,San Diego,73,3302833,9007,7676,0,7676,276
2020-06-02,San Francisco,75,870044,2793,2554,2,2556,43
2020-06-02,San Joaquin,77,732212,1316,985,4,989,35
2020-06-02,San Luis Obispo,79,281455,339,275,1,276,1
2020-06-02,San Mateo,81,765935,2487,2203,3,2206,71
2020-06-02,Santa Barbara,83,443738,2166,1703,22,1725,12
2020-06-02,Santa Clara,85,1922200,3308,2819,6,2825,144
2020-06-02,Santa Cruz,87,273765,236,215,0,215,2
2020-06-02,Shasta,89,179085,59,38,0,38,4
2020-06-02,Sierra,91,2930,1,1,0,1,0
2020-06-02,Siskiyou,93,43540,12,8,0,8,0
2020-06-02,Solano,95,438530,684,537,1,538,18
2020-06-02,Sonoma,97,501317,677,571,1,572,4
2020-06-02,Stanislaus,99,539301,1003,772,5,777,27
2020-06-02,Sutter,101,95872,54,43,0,43,2
2020-06-02,Tehama,103,63373,14,6,1,7,1
2020-06-02,Trinity,105,12862,2,1,1,2,0
2020-06-02,Tulare,107,460477,2683,2012,2,2014,86
2020-06-02,Tuolumne,109,53932,6,4,1,5,0
2020-06-02,Ventura,111,848112,1643,1178,4,1182,30
2020-06-02,Yolo,113,214977,243,213,0,213,24
2020-06-02,Yuba,115,75493,31,27,0,27,1
2020-06-01,Alameda,1,1643700,3949,3460,3,3463,98
2020-06-01,Alpine,3,1148,2,1,0,1,0
2020-06-01,Amador,5,37829,10,10,0,10,0
2020-06-01,Butte,7,227075,72,50,1,51,1
2020-06-01,Calaveras,9,45235,21,15,0,15,0
2020-06-01,Colusa,11,21464,9,7,0,7,0
2020-06-01,Contra Costa,13,1133247,1738,1486,0,1486,37
2020-06-01,Del Norte,15,27424,45,38,0,38,0
2020-06-01,El Dorado,17,186661,117,88,0,88,0
2020-06-01,Fresno,19,978130,3326,1854,36,1890,33
2020-06-01,Glenn,21,27897,21,16,0,16,0
2020-06-01,Humboldt,23,135768,115,98,0,98,2
2020-06-01,Imperial,25,180216,4085,2366,6,2372,14
2020-06-01,Inyo,27,18085,20,20,0,20,1
2020-06-01,Kern,29,883053,3026,2366,6,2372,38
2020-06-01,Kings,31,150075,1277,703,3,706,4
2020-06-01,Lake,33,64148,32,22,0,22,0
2020-06-01,Lassen,35,31185,7,4,1,5,0
2020-06-01,Los Angeles,37,10098052,63620,55899,22,55921,2367
2020-06-01,Madera,39,155013,267,103,0,103,2
2020-06-01,Marin,41,260295,539,495,2,497,14
2020-06-01,Mariposa,43,17540,16,16,0,16,1
2020-06-01,Mendocino,45,87422,31,28,0,28,0
2020-06-01,Merced,47,269075,421,289,0,289,6
2020-06-01,Modoc,49,8938,1,0,0,0,0
2020-06-01,Mono,51,14174,39,35,0,35,1
2020-06-01,Monterey,53,433212,784,554,1,555,10
2020-06-01,Napa,55,140530,147,114,0,114,3
2020-06-01,Nevada,57,99092,51,41,1,42,1
2020-06-01,Orange,59,3164182,9410,6640,44,6684,135
2020-06-01,Placer,61,380077,292,218,2,220,9
2020-06-01,Plumas,63,18699,4,4,0,4,0
2020-06-01,Riverside,65,2383286,9989,7921,7,7928,322
2020-06-01,Sacramento,67,1510023,1562,1415,2,1417,58
2020-06-01,San Benito,69,59416,102,86,0,86,2
2020-06-01,San Bernardino,71,2135413,6705,5310,3,5313,202
2020-06-01,San Diego,73,3302833,8827,7556,0,7556,269
2020-06-01,San Francisco,75,870044,2756,2546,2,2548,43
2020-06-01,San Joaquin,77,732212,1251,957,4,961,35
2020-06-01,San Luis Obispo,79,281455,335,275,1,276,1
2020-06-01,San Mateo,81,765935,2457,2190,3,2193,71
2020-06-01,Santa Barbara,83,443738,2126,1671,21,1692,10
2020-06-01,Santa Clara,85,1922200,3270,2797,5,2802,142
2020-06-01,Santa Cruz,87,273765,232,215,0,215,2
2020-06-01,Shasta,89,179085,59,38,0,38,4
2020-06-01,Sierra,91,2930,1,1,0,1,0
2020-06-01,Siskiyou,93,43540,12,7,0,7,0
2020-06-01,Solano,95,438530,660,529,1,530,17
2020-06-01,Sonoma,97,501317,661,565,1,566,4
2020-06-01,Stanislaus,99,539301,966,758,5,763,27
2020-06-01,Sutter,101,95872,49,43,0,43,2
2020-06-01,Tehama,103,63373,11,5,1,6,1
2020-06-01,Trinity,105,12862,1,1,1,2,0
2020-06-01,Tulare,107,460477,2570,1976,2,1978,84
2020-06-01,Tuolumne,109,53932,5,4,1,5,0
2020-06-01,Ventura,111,848112,1593,1163,4,1167,29
2020-06-01,Yolo,113,214977,240,212,0,212,24
2020-06-01,Yuba,115,75493,30,26,0,26,1
2020-05-31,Alameda,1,1643700,3843,3362,3,3365,98
2020-05-31,Alpine,3,1148,2,1,0,1,0
2020-05-31,Amador,5,37829,10,10,0,10,0
2020-05-31,Butte,7,227075,70,51,1,52,0
2020-05-31,Calaveras,9,45235,18,15,0,15,0
2020-05-31,Colusa,11,21464,9,5,0,5,0
2020-05-31,Contra Costa,13,1133247,1704,1458,0,1458,37
2020-05-31,Del Norte,15,27424,45,37,0,37,0
2020-05-31,El Dorado,17,186661,113,88,0,88,0
2020-05-31,Fresno,19,978130,3169,1780,34,1814,31
2020-05-31,Glenn,21,27897,20,16,0,16,0
2020-05-31,Humboldt,23,135768,113,98,0,98,2
2020-05-31,Imperial,25,180216,3819,2197,6,2203,14
2020-05-31,Inyo,27,18085,20,20,0,20,1
2020-05-31,Kern,29,883053,2892,2300,6,2306,38
2020-05-31,Kings,31,150075,1240,703,3,706,3
2020-05-31,Lake,33,64148,32,19,0,19,0
2020-05-31,Lassen,35,31185,7,4,1,5,0
2020-05-31,Los Angeles,37,10098052,62333,54925,22,54947,2344
2020-05-31,Madera,39,155013,249,101,0,101,2
2020-05-31,Marin,41,260295,529,486,2,488,14
2020-05-31,Mariposa,43,17540,16,16,0,16,1
2020-05-31,Mendocino,45,87422,31,24,0,24,0
2020-05-31,Merced,47,269075,394,288,0,288,6
2020-05-31,Modoc,49,8938,0,0,0,0,0
2020-05-31,Mono,51,14174,39,34,0,34,1
2020-05-31,Monterey,53,433212,711,545,1,546,10
2020-05-31,Napa,55,140530,145,114,0,114,3
2020-05-31,Nevada,57,99092,50,41,1,42,1
2020-05-31,Orange,59,3164182,9199,6532,43,6575,135
2020-05-31,Placer,61,380077,273,215,2,217,9
2020-05-31,Plumas,63,18699,4,4,0,4,0
2020-05-31,Riverside,65,2383286,9733,7704,7,7711,321
2020-05-31,Sacramento,67,1510023,1531,1398,2,1400,57
2020-05-31,San Benito,69,59416,96,85,0,85,2
2020-05-31,San Bernardino,71,2135413,6437,5185,3,5188,198
2020-05-31,San Diego,73,3302833,8633,7483,0,7483,269
2020-05-31,San Francisco,75,870044,2720,2501,2,2503,43
2020-05-31,San Joaquin,77,732212,1186,888,4,892,34
2020-05-31,San Luis Obispo,79,281455,325,271,1,272,1
2020-05-31,San Mateo,81,765935,2411,2169,3,2172,71
2020-05-31,Santa Barbara,83,443738,2070,1662,21,1683,9
2020-05-31,Santa Clara,85,1922200,3226,2785,5,2790,142
2020-05-31,Santa Cruz,87,273765,229,210,0,210,2
2020-05-31,Shasta,89,179085,57,38,0,38,4
2020-05-31,Sierra,91,2930,1,1,0,1,0
2020-05-31,Siskiyou,93,43540,11,7,0,7,0
2020-05-31,Solano,95,438530,634,512,1,513,6
2020-05-31,Sonoma,97,501317,641,555,1,556,4
2020-05-31,Stanislaus,99,539301,912,738,5,743,27
2020-05-31,Sutter,101,95872,47,42,0,42,2
2020-05-31,Tehama,103,63373,10,4,1,5,1
2020-05-31,Trinity,105,12862,1,1,1,2,0
2020-05-31,Tulare,107,460477,2498,1884,2,1886,82
2020-05-31,Tuolumne,109,53932,5,4,1,5,0
2020-05-31,Ventura,111,848112,1538,1151,4,1155,30
2020-05-31,Yolo,113,214977,234,211,0,211,24
2020-05-31,Yuba,115,75493,30,26,0,26,1
2020-05-30,Alameda,1,1643700,3817,3304,3,3307,96
2020-05-30,Alpine,3,1148,2,1,0,1,0
2020-05-30,Amador,5,37829,10,10,0,10,0
2020-05-30,Butte,7,227075,69,44,1,45,0
2020-05-30,Calaveras,9,45235,17,15,0,15,0
2020-05-30,Colusa,11,21464,8,5,0,5,0
2020-05-30,Contra Costa,13,1133247,1689,1429,0,1429,37
2020-05-30,Del Norte,15,27424,45,37,0,37,0
2020-05-30,El Dorado,17,186661,112,86,0,86,0
2020-05-30,Fresno,19,978130,3108,1744,33,1777,31
2020-05-30,Glenn,21,27897,19,16,0,16,0
2020-05-30,Humboldt,23,135768,112,98,0,98,2
2020-05-30,Imperial,25,180216,3729,2091,6,2097,14
2020-05-30,Inyo,27,18085,20,20,0,20,1
2020-05-30,Kern,29,883053,2823,2217,6,2223,38
2020-05-30,Kings,31,150075,1226,703,3,706,3
2020-05-30,Lake,33,64148,31,18,0,18,0
2020-05-30,Lassen,35,31185,7,4,1,5,0
2020-05-30,Los Angeles,37,10098052,61796,53627,22,53649,2319
2020-05-30,Madera,39,155013,244,101,0,101,2
2020-05-30,Marin,41,260295,529,462,2,464,14
2020-05-30,Mariposa,43,17540,16,16,0,16,1
2020-05-30,Mendocino,45,87422,31,24,0,24,0
2020-05-30,Merced,47,269075,393,285,0,285,6
2020-05-30,Modoc,49,8938,0,0,0,0,0
2020-05-30,Mono,51,14174,39,34,0,34,1
2020-05-30,Monterey,53,433212,695,520,1,521,10
2020-05-30,Napa,55,140530,143,113,0,113,3
2020-05-30,Nevada,57,99092,50,41,1,42,1
2020-05-30,Orange,59,3164182,9044,6354,43,6397,134
2020-05-30,Placer,61,380077,266,199,1,200,9
2020-05-30,Plumas,63,18699,4,4,0,4,0
2020-05-30,Riverside,65,2383286,9589,7492,7,7499,316
2020-05-30,Sacramento,67,1510023,1520,1384,2,1386,57
2020-05-30,San Benito,69,59416,95,85,0,85,2
2020-05-30,San Bernardino,71,2135413,6328,5122,3,5125,198
2020-05-30,San Diego,73,3302833,8540,7387,0,7387,269
2020-05-30,San Francisco,75,870044,2695,2496,2,2498,41
2020-05-30,San Joaquin,77,732212,1148,888,4,892,34
2020-05-30,San Luis Obispo,79,281455,320,270,1,271,1
2020-05-30,San Mateo,81,765935,2387,2129,3,2132,71
2020-05-30,Santa Barbara,83,443738,2043,1660,21,1681,9
2020-05-30,Santa Clara,85,1922200,3210,2741,5,2746,141
2020-05-30,Santa Cruz,87,273765,229,206,0,206,2
2020-05-30,Shasta,89,179085,57,36,0,36,4
2020-05-30,Sierra,91,2930,1,1,0,1,0
2020-05-30,Siskiyou,93,43540,10,7,0,7,0
2020-05-30,Solano,95,438530,627,512,1,513,6
2020-05-30,Sonoma,97,501317,631,551,1,552,4
2020-05-30,Stanislaus,99,539301,895,712,5,717,27
2020-05-30,Sutter,101,95872,46,40,0,40,2
2020-05-30,Tehama,103,63373,10,4,1,5,1
2020-05-30,Trinity,105,12862,1,1,1,2,0
2020-05-30,Tulare,107,460477,2461,1879,2,1881,81
2020-05-30,Tuolumne,109,53932,5,4,1,5,0
2020-05-30,Ventura,111,848112,1521,1116,4,1120,30
2020-05-30,Yolo,113,214977,230,210,0,210,24
2020-05-30,Yuba,115,75493,30,25,0,25,1
2020-05-29,Alameda,1,1643700,3782,3209,3,3212,96
2020-05-29,Alpine,3,1148,2,1,0,1,0
2020-05-29,Amador,5,37829,10,10,0,10,0
2020-05-29,Butte,7,227075,64,41,1,42,0
2020-05-29,Calaveras,9,45235,17,15,0,15,0
2020-05-29,Colusa,11,21464,8,5,0,5,0
2020-05-29,Contra Costa,13,1133247,1673,1411,0,1411,37
2020-05-29,Del Norte,15,27424,45,37,0,37,0
2020-05-29,El Dorado,17,186661,111,85,0,85,0
2020-05-29,Fresno,19,978130,3060,1687,33,1720,31
2020-05-29,Glenn,21,27897,19,14,0,14,0
2020-05-29,Humboldt,23,135768,111,98,0,98,2
2020-05-29,Imperial,25,180216,3611,1607,6,1613,14
2020-05-29,Inyo,27,18085,20,20,0,20,1
2020-05-29,Kern,29,883053,2765,2128,6,2134,36
2020-05-29,Kings,31,150075,1215,693,3,696,3
2020-05-29,Lake,33,64148,30,17,0,17,0
2020-05-29,Lassen,35,31185,7,0,1,1,0
2020-05-29,Los Angeles,37,10098052,60836,51578,22,51600,2273
2020-05-29,Madera,39,155013,229,98,0,98,2
2020-05-29,Marin,41,260295,521,448,2,450,14
2020-05-29,Mariposa,43,17540,16,16,0,16,1
2020-05-29,Mendocino,45,87422,29,25,0,25,0
2020-05-29,Merced,47,269075,388,285,0,285,7
2020-05-29,Modoc,49,8938,0,0,0,0,0
2020-05-29,Mono,51,14174,38,34,0,34,1
2020-05-29,Monterey,53,433212,665,479,1,480,10
2020-05-29,Napa,55,140530,140,113,0,113,3
2020-05-29,Nevada,57,99092,50,41,1,42,1
2020-05-29,Orange,59,3164182,8849,6176,41,6217,133
2020-05-29,Placer,61,380077,251,199,1,200,9
2020-05-29,Plumas,63,18699,4,4,0,4,0
2020-05-29,Riverside,65,2383286,9403,7376,7,7383,313
2020-05-29,Sacramento,67,1510023,1497,1360,2,1362,57
2020-05-29,San Benito,69,59416,95,84,0,84,2
2020-05-29,San Bernardino,71,2135413,6222,4983,3,4986,196
2020-05-29,San Diego,73,3302833,8417,7242,0,7242,266
2020-05-29,San Francisco,75,870044,2671,2453,2,2455,41
2020-05-29,San Joaquin,77,732212,1111,855,4,859,34
2020-05-29,San Luis Obispo,79,281455,316,270,1,271,1
2020-05-29,San Mateo,81,765935,2371,2103,3,2106,71
2020-05-29,Santa Barbara,83,443738,2014,1656,21,1677,9
2020-05-29,Santa Clara,85,1922200,3182,2707,5,2712,141
2020-05-29,Santa Cruz,87,273765,226,203,0,203,2
2020-05-29,Shasta,89,179085,57,36,0,36,4
2020-05-29,Sierra,91,2930,1,1,0,1,0
2020-05-29,Siskiyou,93,43540,10,7,0,7,0
2020-05-29,Solano,95,438530,619,498,1,499,6
2020-05-29,Sonoma,97,501317,620,537,1,538,4
2020-05-29,Stanislaus,99,539301,865,698,5,703,27
2020-05-29,Sutter,101,95872,44,40,0,40,2
2020-05-29,Tehama,103,63373,9,4,1,5,1
2020-05-29,Trinity,105,12862,1,1,1,2,0
2020-05-29,Tulare,107,460477,2423,1852,2,1854,80
2020-05-29,Tuolumne,109,53932,5,4,1,5,0
2020-05-29,Ventura,111,848112,1498,1093,4,1097,29
2020-05-29,Yolo,113,214977,226,211,0,211,24
2020-05-29,Yuba,115,75493,29,25,0,25,1
2020-05-28,Alameda,1,1643700,3683,3083,3,3086,94
2020-05-28,Alpine,3,1148,2,1,0,1,0
2020-05-28,Amador,5,37829,10,10,0,10,0
2020-05-28,Butte,7,227075,63,40,1,41,0
2020-05-28,Calaveras,9,45235,16,15,0,15,0
2020-05-28,Colusa,11,21464,8,5,0,5,0
2020-05-28,Contra Costa,13,1133247,1634,1392,0,1392,37
2020-05-28,Del Norte,15,27424,45,37,0,37,0
2020-05-28,El Dorado,17,186661,108,82,0,82,0
2020-05-28,Fresno,19,978130,2980,1653,32,1685,31
2020-05-28,Glenn,21,27897,18,14,0,14,0
2020-05-28,Humboldt,23,135768,110,97,0,97,2
2020-05-28,Imperial,25,180216,3416,1430,6,1436,14
2020-05-28,Inyo,27,18085,20,20,0,20,1
2020-05-28,Kern,29,883053,2689,2069,6,2075,36
2020-05-28,Kings,31,150075,878,626,3,629,3
2020-05-28,Lake,33,64148,29,17,0,17,0
2020-05-28,Lassen,35,31185,7,0,1,1,0
2020-05-28,Los Angeles,37,10098052,59269,49861,22,49883,2222
2020-05-28,Madera,39,155013,211,93,0,93,2
2020-05-28,Marin,41,260295,497,443,2,445,14
2020-05-28,Mariposa,43,17540,16,16,0,16,1
2020-05-28,Mendocino,45,87422,27,24,0,24,0
2020-05-28,Merced,47,269075,379,283,0,283,7
2020-05-28,Modoc,49,8938,0,0,0,0,0
2020-05-28,Mono,51,14174,38,34,0,34,1
2020-05-28,Monterey,53,433212,632,471,1,472,10
2020-05-28,Napa,55,140530,137,113,0,113,3
2020-05-28,Nevada,57,99092,45,41,1,42,1
2020-05-28,Orange,59,3164182,8653,6045,41,6086,130
2020-05-28,Placer,61,380077,245,196,1,197,9
2020-05-28,Plumas,63,18699,4,4,0,4,0
2020-05-28,Riverside,65,2383286,9001,7240,7,7247,304
2020-05-28,Sacramento,67,1510023,1477,1339,2,1341,57
2020-05-28,San Benito,69,59416,94,82,0,82,2
2020-05-28,San Bernardino,71,2135413,6057,4831,3,4834,191
2020-05-28,San Diego,73,3302833,8260,7102,0,7102,260
2020-05-28,San Francisco,75,870044,2637,2417,2,2419,40
2020-05-28,San Joaquin,77,732212,1076,840,4,844,34
2020-05-28,San Luis Obispo,79,281455,313,267,1,268,1
2020-05-28,San Mateo,81,765935,2344,2070,3,2073,71
2020-05-28,Santa Barbara,83,443738,1971,1642,20,1662,9
2020-05-28,Santa Clara,85,1922200,3143,2698,5,2703,140
2020-05-28,Santa Cruz,87,273765,225,201,0,201,2
2020-05-28,Shasta,89,179085,55,36,0,36,4
2020-05-28,Sierra,91,2930,1,1,0,1,0
2020-05-28,Siskiyou,93,43540,8,6,0,6,0
2020-05-28,Solano,95,438530,602,489,1,490,6
2020-05-28,Sonoma,97,501317,598,529,1,530,4
2020-05-28,Stanislaus,99,539301,824,684,5,689,27
2020-05-28,Sutter,101,95872,44,40,0,40,2
2020-05-28,Tehama,103,63373,9,4,1,5,1
2020-05-28,Trinity,105,12862,1,1,1,2,0
2020-05-28,Tulare,107,460477,2387,1832,2,1834,79
2020-05-28,Tuolumne,109,53932,5,4,1,5,0
2020-05-28,Ventura,111,848112,1469,1083,4,1087,29
2020-05-28,Yolo,113,214977,223,206,0,206,22
2020-05-28,Yuba,115,75493,28,24,0,24,1
2020-05-27,Alameda,1,1643700,3602,3037,3,3040,94
2020-05-27,Alpine,3,1148,2,1,0,1,0
2020-05-27,Amador,5,37829,10,10,0,10,0
2020-05-27,Butte,7,227075,60,40,0,40,0
2020-05-27,Calaveras,9,45235,15,15,0,15,0
2020-05-27,Colusa,11,21464,8,5,0,5,0
2020-05-27,Contra Costa,13,1133247,1594,1373,0,1373,37
2020-05-27,Del Norte,15,27424,45,34,0,34,0
2020-05-27,El Dorado,17,186661,107,82,0,82,0
2020-05-27,Fresno,19,978130,2893,1620,32,1652,27
2020-05-27,Glenn,21,27897,18,14,0,14,0
2020-05-27,Humboldt,23,135768,110,86,0,86,2
2020-05-27,Imperial,25,180216,3236,1369,6,1375,14
2020-05-27,Inyo,27,18085,20,20,0,20,1
2020-05-27,Kern,29,883053,2624,1999,6,2005,37
2020-05-27,Kings,31,150075,851,586,3,589,3
2020-05-27,Lake,33,64148,29,13,0,13,0
2020-05-27,Lassen,35,31185,7,0,1,1,0
2020-05-27,Los Angeles,37,10098052,57896,48711,22,48733,2177
2020-05-27,Madera,39,155013,202,91,0,91,2
2020-05-27,Marin,41,260295,469,439,2,441,14
2020-05-27,Mariposa,43,17540,16,16,0,16,1
2020-05-27,Mendocino,45,87422,26,21,0,21,0
2020-05-27,Merced,47,269075,375,278,0,278,7
2020-05-27,Modoc,49,8938,0,0,0,0,0
2020-05-27,Mono,51,14174,38,34,0,34,1
2020-05-27,Monterey,53,433212,592,443,1,444,8
2020-05-27,Napa,55,140530,132,112,0,112,3
2020-05-27,Nevada,57,99092,44,41,1,42,1
2020-05-27,Orange,59,3164182,8497,5849,40,5889,121
2020-05-27,Placer,61,380077,226,196,1,197,9
2020-05-27,Plumas,63,18699,4,4,0,4,0
2020-05-27,Riverside,65,2383286,8622,7156,7,7163,299
2020-05-27,Sacramento,67,1510023,1449,1318,2,1320,50
2020-05-27,San Benito,69,59416,91,74,0,74,2
2020-05-27,San Bernardino,71,2135413,5873,4708,3,4711,183
2020-05-27,San Diego,73,3302833,8110,6985,0,6985,255
2020-05-27,San Francisco,75,870044,2608,2394,2,2396,40
2020-05-27,San Joaquin,77,732212,1035,825,4,829,34
2020-05-27,San Luis Obispo,79,281455,308,266,1,267,1
2020-05-27,San Mateo,81,765935,2304,2045,3,2048,71
2020-05-27,Santa Barbara,83,443738,1952,1629,20,1649,9
2020-05-27,Santa Clara,85,1922200,3111,2680,5,2685,140
2020-05-27,Santa Cruz,87,273765,221,202,0,202,2
2020-05-27,Shasta,89,179085,52,36,0,36,4
2020-05-27,Sierra,91,2930,1,1,0,1,0
2020-05-27,Siskiyou,93,43540,8,6,0,6,0
2020-05-27,Solano,95,438530,582,477,1,478,5
2020-05-27,Sonoma,97,501317,584,521,1,522,4
2020-05-27,Stanislaus,99,539301,799,675,5,680,27
2020-05-27,Sutter,101,95872,43,40,0,40,2
2020-05-27,Tehama,103,63373,9,3,1,4,1
2020-05-27,Trinity,105,12862,1,1,1,2,0
2020-05-27,Tulare,107,460477,2335,1817,2,1819,77
2020-05-27,Tuolumne,109,53932,5,4,1,5,0
2020-05-27,Ventura,111,848112,1447,1065,4,1069,28
2020-05-27,Yolo,113,214977,222,204,0,204,22
2020-05-27,Yuba,115,75493,28,24,0,24,1
2020-05-26,Alameda,1,1643700,3510,2956,3,2959,92
2020-05-26,Alpine,3,1148,2,1,0,1,0
2020-05-26,Amador,5,37829,10,10,0,10,0
2020-05-26,Butte,7,227075,58,37,0,37,0
2020-05-26,Calaveras,9,45235,15,13,0,13,0
2020-05-26,Colusa,11,21464,8,4,0,4,0
2020-05-26,Contra Costa,13,1133247,1559,1352,0,1352,37
2020-05-26,Del Norte,15,27424,44,30,0,30,0
2020-05-26,El Dorado,17,186661,103,79,0,79,0
2020-05-26,Fresno,19,978130,2809,1496,32,1528,22
2020-05-26,Glenn,21,27897,16,12,0,12,0
2020-05-26,Humboldt,23,135768,108,81,0,81,2
2020-05-26,Imperial,25,180216,3020,1369,6,1375,14
2020-05-26,Inyo,27,18085,20,20,0,20,1
2020-05-26,Kern,29,883053,2546,1890,6,1896,31
2020-05-26,Kings,31,150075,783,449,2,451,2
2020-05-26,Lake,33,64148,27,12,0,12,0
2020-05-26,Lassen,35,31185,6,0,1,1,0
2020-05-26,Los Angeles,37,10098052,56440,47760,22,47782,2121
2020-05-26,Madera,39,155013,187,83,0,83,2
2020-05-26,Marin,41,260295,457,424,2,426,14
2020-05-26,Mariposa,43,17540,16,16,0,16,1
2020-05-26,Mendocino,45,87422,24,20,0,20,0
2020-05-26,Merced,47,269075,361,266,0,266,7
2020-05-26,Modoc,49,8938,0,1,0,1,0
2020-05-26,Mono,51,14174,37,34,0,34,1
2020-05-26,Monterey,53,433212,564,424,0,424,8
2020-05-26,Napa,55,140530,127,109,0,109,3
2020-05-26,Nevada,57,99092,43,41,1,42,1
2020-05-26,Orange,59,3164182,8229,5651,39,5690,115
2020-05-26,Placer,61,380077,222,188,1,189,9
2020-05-26,Plumas,63,18699,4,4,0,4,0
2020-05-26,Riverside,65,2383286,8175,6917,7,6924,284
2020-05-26,Sacramento,67,1510023,1423,1298,2,1300,50
2020-05-26,San Benito,69,59416,86,69,0,69,2
2020-05-26,San Bernardino,71,2135413,5705,4430,3,4433,175
2020-05-26,San Diego,73,3302833,7967,6884,0,6884,249
2020-05-26,San Francisco,75,870044,2575,2363,2,2365,40
2020-05-26,San Joaquin,77,732212,988,760,4,764,33
2020-05-26,San Luis Obispo,79,281455,306,260,1,261,1
2020-05-26,San Mateo,81,765935,2266,1967,2,1969,71
2020-05-26,Santa Barbara,83,443738,1928,1590,20,1610,9
2020-05-26,Santa Clara,85,1922200,3078,2659,5,2664,139
2020-05-26,Santa Cruz,87,273765,219,197,0,197,2
2020-05-26,Shasta,89,179085,52,36,0,36,4
2020-05-26,Sierra,91,2930,1,1,0,1,0
2020-05-26,Siskiyou,93,43540,7,6,0,6,0
2020-05-26,Solano,95,438530,564,470,1,471,5
2020-05-26,Sonoma,97,501317,576,509,0,509,4
2020-05-26,Stanislaus,99,539301,778,663,5,668,27
2020-05-26,Sutter,101,95872,42,39,0,39,2
2020-05-26,Tehama,103,63373,8,2,1,3,1
2020-05-26,Trinity,105,12862,1,1,1,2,0
2020-05-26,Tulare,107,460477,2279,1768,2,1770,76
2020-05-26,Tuolumne,109,53932,5,2,1,3,0
2020-05-26,Ventura,111,848112,1413,1033,2,1035,27
2020-05-26,Yolo,113,214977,216,198,0,198,22
2020-05-26,Yuba,115,75493,27,24,0,24,1
2020-05-25,Alameda,1,1643700,3417,2900,2,2902,92
2020-05-25,Alpine,3,1148,2,1,0,1,0
2020-05-25,Amador,5,37829,10,10,0,10,0
2020-05-25,Butte,7,227075,55,37,0,37,0
2020-05-25,Calaveras,9,45235,15,13,0,13,0
2020-05-25,Colusa,11,21464,7,4,0,4,0
2020-05-25,Contra Costa,13,1133247,1527,1348,0,1348,37
2020-05-25,Del Norte,15,27424,44,20,0,20,0
2020-05-25,El Dorado,17,186661,95,78,0,78,0
2020-05-25,Fresno,19,978130,2708,1496,29,1525,22
2020-05-25,Glenn,21,27897,16,12,0,12,0
2020-05-25,Humboldt,23,135768,107,81,0,81,2
2020-05-25,Imperial,25,180216,2809,1369,6,1375,14
2020-05-25,Inyo,27,18085,19,20,0,20,1
2020-05-25,Kern,29,883053,2474,1890,6,1896,31
2020-05-25,Kings,31,150075,754,447,2,449,2
2020-05-25,Lake,33,64148,25,13,0,13,0
2020-05-25,Lassen,35,31185,6,0,1,1,0
2020-05-25,Los Angeles,37,10098052,54635,45952,22,45974,2094
2020-05-25,Madera,39,155013,176,83,0,83,2
2020-05-25,Marin,41,260295,440,415,2,417,14
2020-05-25,Mariposa,43,17540,16,15,0,15,1
2020-05-25,Mendocino,45,87422,21,19,0,19,0
2020-05-25,Merced,47,269075,354,262,0,262,6
2020-05-25,Modoc,49,8938,0,1,0,1,0
2020-05-25,Mono,51,14174,37,34,0,34,1
2020-05-25,Monterey,53,433212,534,418,0,418,8
2020-05-25,Napa,55,140530,127,107,0,107,3
2020-05-25,Nevada,57,99092,43,41,1,42,1
2020-05-25,Orange,59,3164182,8006,5601,38,5639,115
2020-05-25,Placer,61,380077,220,186,1,187,9
2020-05-25,Plumas,63,18699,4,4,0,4,0
2020-05-25,Riverside,65,2383286,7944,6900,7,6907,284
2020-05-25,Sacramento,67,1510023,1403,1290,1,1291,50
2020-05-25,San Benito,69,59416,85,70,0,70,2
2020-05-25,San Bernardino,71,2135413,5515,4393,3,4396,175
2020-05-25,San Diego,73,3302833,7791,6799,0,6799,249
2020-05-25,San Francisco,75,870044,2538,2358,2,2360,40
2020-05-25,San Joaquin,77,732212,962,760,4,764,33
2020-05-25,San Luis Obispo,79,281455,304,260,1,261,1
2020-05-25,San Mateo,81,765935,2230,1938,2,1940,71
2020-05-25,Santa Barbara,83,443738,1913,1590,20,1610,9
2020-05-25,Santa Clara,85,1922200,3046,2647,5,2652,139
2020-05-25,Santa Cruz,87,273765,217,191,0,191,2
2020-05-25,Shasta,89,179085,51,36,0,36,4
2020-05-25,Sierra,91,2930,1,1,0,1,0
2020-05-25,Siskiyou,93,43540,7,6,0,6,0
2020-05-25,Solano,95,438530,550,437,1,438,5
2020-05-25,Sonoma,97,501317,564,496,0,496,4
2020-05-25,Stanislaus,99,539301,748,651,5,656,27
2020-05-25,Sutter,101,95872,42,38,0,38,2
2020-05-25,Tehama,103,63373,7,2,1,3,1
2020-05-25,Trinity,105,12862,1,1,1,2,0
2020-05-25,Tulare,107,460477,2216,1747,2,1749,76
2020-05-25,Tuolumne,109,53932,5,2,1,3,0
2020-05-25,Ventura,111,848112,1374,1020,2,1022,27
2020-05-25,Yolo,113,214977,214,197,0,197,22
2020-05-25,Yuba,115,75493,26,24,0,24,1
2020-05-24,Alameda,1,1643700,3344,2830,2,2832,92
2020-05-24,Alpine,3,1148,2,1,0,1,0
2020-05-24,Amador,5,37829,10,9,0,9,0
2020-05-24,Butte,7,227075,53,35,0,35,0
2020-05-24,Calaveras,9,45235,15,13,0,13,0
2020-05-24,Colusa,11,21464,7,4,0,4,0
2020-05-24,Contra Costa,13,1133247,1499,1325,0,1325,37
2020-05-24,Del Norte,15,27424,43,16,0,16,0
2020-05-24,El Dorado,17,186661,94,76,0,76,0
2020-05-24,Fresno,19,978130,2642,1455,27,1482,22
2020-05-24,Glenn,21,27897,15,12,0,12,0
2020-05-24,Humboldt,23,135768,107,81,0,81,2
2020-05-24,Imperial,25,180216,2683,1369,6,1375,14
2020-05-24,Inyo,27,18085,19,20,0,20,1
2020-05-24,Kern,29,883053,2401,1861,5,1866,31
2020-05-24,Kings,31,150075,743,446,2,448,2
2020-05-24,Lake,33,64148,24,12,0,12,0
2020-05-24,Lassen,35,31185,5,0,1,1,0
2020-05-24,Los Angeles,37,10098052,53629,44954,22,44976,2085
2020-05-24,Madera,39,155013,171,83,0,83,2
2020-05-24,Marin,41,260295,438,401,2,403,14
2020-05-24,Mariposa,43,17540,16,15,0,15,1
2020-05-24,Mendocino,45,87422,20,19,0,19,0
2020-05-24,Merced,47,269075,353,258,0,258,6
2020-05-24,Modoc,49,8938,0,0,0,0,0
2020-05-24,Mono,51,14174,37,34,0,34,1
2020-05-24,Monterey,53,433212,506,405,0,405,8
2020-05-24,Napa,55,140530,125,104,0,104,3
2020-05-24,Nevada,57,99092,43,41,1,42,1
2020-05-24,Orange,59,3164182,7852,5439,37,5476,113
2020-05-24,Placer,61,380077,215,184,1,185,9
2020-05-24,Plumas,63,18699,4,4,0,4,0
2020-05-24,Riverside,65,2383286,7803,6571,7,6578,284
2020-05-24,Sacramento,67,1510023,1386,1283,1,1284,50
2020-05-24,San Benito,69,59416,84,67,0,67,2
2020-05-24,San Bernardino,71,2135413,5407,4262,3,4265,175
2020-05-24,San Diego,73,3302833,7648,6703,0,6703,249
2020-05-24,San Francisco,75,870044,2514,2318,2,2320,40
2020-05-24,San Joaquin,77,732212,943,760,4,764,33
2020-05-24,San Luis Obispo,79,281455,302,257,1,258,1
2020-05-24,San Mateo,81,765935,2195,1925,2,1927,71
2020-05-24,Santa Barbara,83,443738,1898,1573,20,1593,9
2020-05-24,Santa Clara,85,1922200,3027,2623,5,2628,139
2020-05-24,Santa Cruz,87,273765,214,185,0,185,2
2020-05-24,Shasta,89,179085,50,36,0,36,4
2020-05-24,Sierra,91,2930,1,1,0,1,0
2020-05-24,Siskiyou,93,43540,6,6,0,6,0
2020-05-24,Solano,95,438530,542,436,0,436,5
2020-05-24,Sonoma,97,501317,553,485,0,485,4
2020-05-24,Stanislaus,99,539301,728,634,5,639,27
2020-05-24,Sutter,101,95872,42,38,0,38,2
2020-05-24,Tehama,103,63373,5,2,1,3,1
2020-05-24,Trinity,105,12862,1,1,1,2,0
2020-05-24,Tulare,107,460477,2170,1684,2,1686,74
2020-05-24,Tuolumne,109,53932,5,2,0,2,0
2020-05-24,Ventura,111,848112,1362,982,2,984,27
2020-05-24,Yolo,113,214977,212,192,0,192,22
2020-05-24,Yuba,115,75493,26,24,0,24,1
2020-05-23,Alameda,1,1643700,3303,2783,2,2785,91
2020-05-23,Alpine,3,1148,2,1,0,1,0
2020-05-23,Amador,5,37829,10,9,0,9,0
2020-05-23,Butte,7,227075,52,34,0,34,0
2020-05-23,Calaveras,9,45235,15,13,0,13,0
2020-05-23,Colusa,11,21464,7,4,0,4,0
2020-05-23,Contra Costa,13,1133247,1488,1302,0,1302,36
2020-05-23,Del Norte,15,27424,43,10,0,10,0
2020-05-23,El Dorado,17,186661,94,74,0,74,0
2020-05-23,Fresno,19,978130,2622,1447,27,1474,21
2020-05-23,Glenn,21,27897,15,12,0,12,0
2020-05-23,Humboldt,23,135768,105,80,0,80,2
2020-05-23,Imperial,25,180216,2595,1283,6,1289,14
2020-05-23,Inyo,27,18085,19,20,0,20,1
2020-05-23,Kern,29,883053,2358,1806,5,1811,31
2020-05-23,Kings,31,150075,739,444,2,446,2
2020-05-23,Lake,33,64148,23,10,0,10,0
2020-05-23,Lassen,35,31185,5,0,1,1,0
2020-05-23,Los Angeles,37,10098052,53087,44029,22,44051,2069
2020-05-23,Madera,39,155013,167,83,0,83,2
2020-05-23,Marin,41,260295,438,393,1,394,14
2020-05-23,Mariposa,43,17540,16,15,0,15,1
2020-05-23,Mendocino,45,87422,20,13,0,13,0
2020-05-23,Merced,47,269075,350,247,0,247,6
2020-05-23,Modoc,49,8938,0,0,0,0,0
2020-05-23,Mono,51,14174,36,34,0,34,1
2020-05-23,Monterey,53,433212,492,397,0,397,8
2020-05-23,Napa,55,140530,121,101,0,101,3
2020-05-23,Nevada,57,99092,43,41,1,42,1
2020-05-23,Orange,59,3164182,7695,5313,36,5349,113
2020-05-23,Placer,61,380077,210,184,1,185,9
2020-05-23,Plumas,63,18699,4,4,0,4,0
2020-05-23,Riverside,65,2383286,7712,6460,7,6467,284
2020-05-23,Sacramento,67,1510023,1370,1275,1,1276,50
2020-05-23,San Benito,69,59416,79,67,0,67,2
2020-05-23,San Bernardino,71,2135413,5314,4172,3,4175,175
2020-05-23,San Diego,73,3302833,7557,6561,0,6561,249
2020-05-23,San Francisco,75,870044,2495,2312,2,2314,40
2020-05-23,San Joaquin,77,732212,928,759,4,763,33
2020-05-23,San Luis Obispo,79,281455,299,256,1,257,1
2020-05-23,San Mateo,81,765935,2167,1862,2,1864,71
2020-05-23,Santa Barbara,83,443738,1886,1566,20,1586,9
2020-05-23,Santa Clara,85,1922200,3014,2593,5,2598,139
2020-05-23,Santa Cruz,87,273765,212,177,0,177,2
2020-05-23,Shasta,89,179085,50,35,0,35,4
2020-05-23,Sierra,91,2930,1,1,0,1,0
2020-05-23,Siskiyou,93,43540,6,6,0,6,0
2020-05-23,Solano,95,438530,537,435,0,435,5
2020-05-23,Sonoma,97,501317,539,462,0,462,4
2020-05-23,Stanislaus,99,539301,720,625,5,630,27
2020-05-23,Sutter,101,95872,41,38,0,38,2
2020-05-23,Tehama,103,63373,5,2,1,3,1
2020-05-23,Trinity,105,12862,1,1,1,2,0
2020-05-23,Tulare,107,460477,2149,1682,2,1684,73
2020-05-23,Tuolumne,109,53932,5,2,0,2,0
2020-05-23,Ventura,111,848112,1342,961,2,963,27
2020-05-23,Yolo,113,214977,211,188,0,188,22
2020-05-23,Yuba,115,75493,26,24,0,24,1
2020-05-22,Alameda,1,1643700,3249,2722,2,2724,91
2020-05-22,Alpine,3,1148,2,1,0,1,0
2020-05-22,Amador,5,37829,10,9,0,9,0
2020-05-22,Butte,7,227075,50,34,0,34,0
2020-05-22,Calaveras,9,45235,15,13,0,13,0
2020-05-22,Colusa,11,21464,7,4,0,4,0
2020-05-22,Contra Costa,13,1133247,1476,1272,0,1272,36
2020-05-22,Del Norte,15,27424,41,9,0,9,0
2020-05-22,El Dorado,17,186661,91,74,0,74,0
2020-05-22,Fresno,19,978130,2565,1399,26,1425,20
2020-05-22,Glenn,21,27897,15,12,0,12,0
2020-05-22,Humboldt,23,135768,105,80,0,80,2
2020-05-22,Imperial,25,180216,2495,1214,6,1220,14
2020-05-22,Inyo,27,18085,19,20,0,20,1
2020-05-22,Kern,29,883053,2310,1749,5,1754,28
2020-05-22,Kings,31,150075,736,428,2,430,2
2020-05-22,Lake,33,64148,22,10,0,10,0
2020-05-22,Lassen,35,31185,3,0,1,1,0
2020-05-22,Los Angeles,37,10098052,52296,43025,22,43047,2027
2020-05-22,Madera,39,155013,163,82,0,82,2
2020-05-22,Marin,41,260295,434,372,1,373,14
2020-05-22,Mariposa,43,17540,16,15,0,15,1
2020-05-22,Mendocino,45,87422,19,13,0,13,0
2020-05-22,Merced,47,269075,350,233,0,233,6
2020-05-22,Modoc,49,8938,0,0,0,0,0
2020-05-22,Mono,51,14174,36,34,0,34,1
2020-05-22,Monterey,53,433212,481,372,0,372,8
2020-05-22,Napa,55,140530,119,97,0,97,3
2020-05-22,Nevada,57,99092,42,41,1,42,1
2020-05-22,Orange,59,3164182,7501,5144,34,5178,113
2020-05-22,Placer,61,380077,210,181,1,182,9
2020-05-22,Plumas,63,18699,4,4,0,4,0
2020-05-22,Riverside,65,2383286,7597,6351,7,6358,283
2020-05-22,Sacramento,67,1510023,1354,1262,1,1263,50
2020-05-22,San Benito,69,59416,78,64,0,64,2
2020-05-22,San Bernardino,71,2135413,5239,4107,3,4110,173
2020-05-22,San Diego,73,3302833,7471,6436,0,6436,242
2020-05-22,San Francisco,75,870044,2477,2251,2,2253,40
2020-05-22,San Joaquin,77,732212,915,747,4,751,33
2020-05-22,San Luis Obispo,79,281455,299,254,1,255,1
2020-05-22,San Mateo,81,765935,2148,1847,2,1849,71
2020-05-22,Santa Barbara,83,443738,1870,1554,20,1574,9
2020-05-22,Santa Clara,85,1922200,2996,2537,5,2542,139
2020-05-22,Santa Cruz,87,273765,209,171,0,171,2
2020-05-22,Shasta,89,179085,50,34,0,34,4
2020-05-22,Sierra,91,2930,1,0,0,0,0
2020-05-22,Siskiyou,93,43540,6,6,0,6,0
2020-05-22,Solano,95,438530,534,431,0,431,4
2020-05-22,Sonoma,97,501317,535,444,0,444,4
2020-05-22,Stanislaus,99,539301,710,616,5,621,27
2020-05-22,Sutter,101,95872,41,38,0,38,2
2020-05-22,Tehama,103,63373,5,2,0,2,1
2020-05-22,Trinity,105,12862,1,1,1,2,0
2020-05-22,Tulare,107,460477,2119,1662,2,1664,73
2020-05-22,Tuolumne,109,53932,5,2,0,2,0
2020-05-22,Ventura,111,848112,1324,937,2,939,27
2020-05-22,Yolo,113,214977,209,187,0,187,22
2020-05-22,Yuba,115,75493,26,24,0,24,1
2020-05-21,Alameda,1,1643700,3184,2606,2,2608,89
2020-05-21,Alpine,3,1148,2,1,0,1,0
2020-05-21,Amador,5,37829,10,9,0,9,0
2020-05-21,Butte,7,227075,49,31,0,31,0
2020-05-21,Calaveras,9,45235,14,13,0,13,0
2020-05-21,Colusa,11,21464,7,4,0,4,0
2020-05-21,Contra Costa,13,1133247,1440,1243,0,1243,36
2020-05-21,Del Norte,15,27424,38,9,0,9,0
2020-05-21,El Dorado,17,186661,90,67,0,67,0
2020-05-21,Fresno,19,978130,2477,1362,26,1388,20
2020-05-21,Glenn,21,27897,14,12,0,12,0
2020-05-21,Humboldt,23,135768,104,79,0,79,0
2020-05-21,Imperial,25,180216,2333,1096,6,1102,14
2020-05-21,Inyo,27,18085,19,20,0,20,1
2020-05-21,Kern,29,883053,2234,1684,4,1688,27
2020-05-21,Kings,31,150075,715,417,2,419,2
2020-05-21,Lake,33,64148,17,10,0,10,0
2020-05-21,Lassen,35,31185,3,0,1,1,0
2020-05-21,Los Angeles,37,10098052,51257,42063,22,42085,1996
2020-05-21,Madera,39,155013,160,82,0,82,2
2020-05-21,Marin,41,260295,423,359,1,360,14
2020-05-21,Mariposa,43,17540,16,15,0,15,1
2020-05-21,Mendocino,45,87422,19,12,0,12,0
2020-05-21,Merced,47,269075,339,226,0,226,6
2020-05-21,Modoc,49,8938,0,0,0,0,0
2020-05-21,Mono,51,14174,36,33,0,33,1
2020-05-21,Monterey,53,433212,470,363,0,363,8
2020-05-21,Napa,55,140530,117,96,0,96,3
2020-05-21,Nevada,57,99092,42,41,1,42,1
2020-05-21,Orange,59,3164182,7300,4975,34,5009,106
2020-05-21,Placer,61,380077,204,176,1,177,8
2020-05-21,Plumas,63,18699,4,4,0,4,0
2020-05-21,Riverside,65,2383286,7410,6245,7,6252,279
2020-05-21,Sacramento,67,1510023,1341,1258,1,1259,56
2020-05-21,San Benito,69,59416,75,61,0,61,2
2020-05-21,San Bernardino,71,2135413,5093,3950,3,3953,167
2020-05-21,San Diego,73,3302833,7335,6317,0,6317,241
2020-05-21,San Francisco,75,870044,2453,2248,2,2250,37
2020-05-21,San Joaquin,77,732212,879,730,4,734,33
2020-05-21,San Luis Obispo,79,281455,299,251,1,252,1
2020-05-21,San Mateo,81,765935,2111,1791,2,1793,74
2020-05-21,Santa Barbara,83,443738,1851,1541,20,1561,10
2020-05-21,Santa Clara,85,1922200,2977,2520,5,2525,138
2020-05-21,Santa Cruz,87,273765,201,164,0,164,3
2020-05-21,Shasta,89,179085,48,34,0,34,4
2020-05-21,Sierra,91,2930,1,0,0,0,0
2020-05-21,Siskiyou,93,43540,6,6,0,6,0
2020-05-21,Solano,95,438530,525,424,0,424,4
2020-05-21,Sonoma,97,501317,517,427,0,427,4
2020-05-21,Stanislaus,99,539301,699,602,5,607,27
2020-05-21,Sutter,101,95872,40,38,0,38,2
2020-05-21,Tehama,103,63373,4,2,0,2,1
2020-05-21,Trinity,105,12862,1,1,1,2,0
2020-05-21,Tulare,107,460477,2069,1606,2,1608,73
2020-05-21,Tuolumne,109,53932,3,2,0,2,0
2020-05-21,Ventura,111,848112,1277,907,2,909,30
2020-05-21,Yolo,113,214977,206,185,0,185,22
2020-05-21,Yuba,115,75493,26,24,0,24,1
2020-05-20,Alameda,1,1643700,3111,2554,2,2556,89
2020-05-20,Alpine,3,1148,2,1,0,1,0
2020-05-20,Amador,5,37829,10,9,0,9,0
2020-05-20,Butte,7,227075,46,30,0,30,0
2020-05-20,Calaveras,9,45235,14,13,0,13,0
2020-05-20,Colusa,11,21464,7,3,0,3,0
2020-05-20,Contra Costa,13,1133247,1410,1223,0,1223,33
2020-05-20,Del Norte,15,27424,31,9,0,9,0
2020-05-20,El Dorado,17,186661,89,67,0,67,0
2020-05-20,Fresno,19,978130,2405,1329,25,1354,17
2020-05-20,Glenn,21,27897,13,12,0,12,0
2020-05-20,Humboldt,23,135768,101,73,0,73,0
2020-05-20,Imperial,25,180216,2222,1047,6,1053,14
2020-05-20,Inyo,27,18085,19,20,0,20,1
2020-05-20,Kern,29,883053,2171,1639,3,1642,27
2020-05-20,Kings,31,150075,572,403,2,405,2
2020-05-20,Lake,33,64148,17,9,0,9,0
2020-05-20,Lassen,35,31185,2,0,1,1,0
2020-05-20,Los Angeles,37,10098052,50260,40932,22,40954,1955
2020-05-20,Madera,39,155013,158,82,0,82,2
2020-05-20,Marin,41,260295,396,348,1,349,14
2020-05-20,Mariposa,43,17540,16,15,0,15,1
2020-05-20,Mendocino,45,87422,19,12,0,12,0
2020-05-20,Merced,47,269075,332,225,0,225,6
2020-05-20,Modoc,49,8938,0,0,0,0,0
2020-05-20,Mono,51,14174,36,33,0,33,1
2020-05-20,Monterey,53,433212,456,356,0,356,8
2020-05-20,Napa,55,140530,110,93,0,93,3
2020-05-20,Nevada,57,99092,42,41,1,42,1
2020-05-20,Orange,59,3164182,7095,4866,33,4899,96
2020-05-20,Placer,61,380077,202,176,1,177,8
2020-05-20,Plumas,63,18699,4,4,0,4,0
2020-05-20,Riverside,65,2383286,7267,6090,7,6097,265
2020-05-20,Sacramento,67,1510023,1331,1244,1,1245,56
2020-05-20,San Benito,69,59416,74,61,0,61,2
2020-05-20,San Bernardino,71,2135413,4967,3771,3,3774,161
2020-05-20,San Diego,73,3302833,7218,6142,0,6142,230
2020-05-20,San Francisco,75,870044,2430,2199,2,2201,37
2020-05-20,San Joaquin,77,732212,843,713,4,717,33
2020-05-20,San Luis Obispo,79,281455,293,249,1,250,1
2020-05-20,San Mateo,81,765935,2058,1739,2,1741,74
2020-05-20,Santa Barbara,83,443738,1829,1524,20,1544,10
2020-05-20,Santa Clara,85,1922200,2957,2508,5,2513,138
2020-05-20,Santa Cruz,87,273765,198,163,0,163,3
2020-05-20,Shasta,89,179085,48,34,0,34,4
2020-05-20,Sierra,91,2930,1,0,0,0,0
2020-05-20,Siskiyou,93,43540,6,6,0,6,0
2020-05-20,Solano,95,438530,520,418,0,418,4
2020-05-20,Sonoma,97,501317,508,411,0,411,4
2020-05-20,Stanislaus,99,539301,683,584,4,588,25
2020-05-20,Sutter,101,95872,40,38,0,38,2
2020-05-20,Tehama,103,63373,4,2,0,2,1
2020-05-20,Trinity,105,12862,1,1,1,2,0
2020-05-20,Tulare,107,460477,2031,1585,2,1587,71
2020-05-20,Tuolumne,109,53932,3,2,0,2,0
2020-05-20,Ventura,111,848112,1245,879,2,881,29
2020-05-20,Yolo,113,214977,203,184,0,184,22
2020-05-20,Yuba,115,75493,26,23,0,23,1
2020-05-19,Alameda,1,1643700,3036,2493,0,2493,88
2020-05-19,Alpine,3,1148,2,1,0,1,0
2020-05-19,Amador,5,37829,10,9,0,9,0
2020-05-19,Butte,7,227075,44,25,0,25,0
2020-05-19,Calaveras,9,45235,14,13,0,13,0
2020-05-19,Colusa,11,21464,5,3,0,3,0
2020-05-19,Contra Costa,13,1133247,1387,1205,0,1205,33
2020-05-19,Del Norte,15,27424,28,8,0,8,0
2020-05-19,El Dorado,17,186661,86,67,0,67,0
2020-05-19,Fresno,19,978130,2304,1288,25,1313,15
2020-05-19,Glenn,21,27897,13,12,0,12,0
2020-05-19,Humboldt,23,135768,101,72,0,72,0
2020-05-19,Imperial,25,180216,2061,1012,6,1018,14
2020-05-19,Inyo,27,18085,19,20,0,20,1
2020-05-19,Kern,29,883053,2075,1601,3,1604,26
2020-05-19,Kings,31,150075,563,393,2,395,2
2020-05-19,Lake,33,64148,14,11,0,11,0
2020-05-19,Lassen,35,31185,2,0,1,1,0
2020-05-19,Los Angeles,37,10098052,49052,39670,22,39692,1906
2020-05-19,Madera,39,155013,155,80,0,80,2
2020-05-19,Marin,41,260295,372,340,1,341,14
2020-05-19,Mariposa,43,17540,16,15,0,15,1
2020-05-19,Mendocino,45,87422,19,12,0,12,0
2020-05-19,Merced,47,269075,324,222,0,222,5
2020-05-19,Modoc,49,8938,0,0,0,0,0
2020-05-19,Mono,51,14174,36,33,0,33,1
2020-05-19,Monterey,53,433212,444,350,0,350,8
2020-05-19,Napa,55,140530,109,93,0,93,3
2020-05-19,Nevada,57,99092,42,41,1,42,1
2020-05-19,Orange,59,3164182,6900,4746,33,4779,90
2020-05-19,Placer,61,380077,200,177,1,178,8
2020-05-19,Plumas,63,18699,4,5,0,5,0
2020-05-19,Riverside,65,2383286,7107,5963,7,5970,265
2020-05-19,Sacramento,67,1510023,1317,1239,1,1240,57
2020-05-19,San Benito,69,59416,72,59,0,59,2
2020-05-19,San Bernardino,71,2135413,4819,3656,3,3659,158
2020-05-19,San Diego,73,3302833,7074,6028,0,6028,222
2020-05-19,San Francisco,75,870044,2396,2186,1,2187,37
2020-05-19,San Joaquin,77,732212,821,705,4,709,33
2020-05-19,San Luis Obispo,79,281455,293,245,1,246,1
2020-05-19,San Mateo,81,765935,2017,1704,2,1706,71
2020-05-19,Santa Barbara,83,443738,1812,1521,20,1541,10
2020-05-19,Santa Clara,85,1922200,2912,2480,5,2485,138
2020-05-19,Santa Cruz,87,273765,187,161,0,161,3
2020-05-19,Shasta,89,179085,48,34,0,34,4
2020-05-19,Sierra,91,2930,0,0,0,0,0
2020-05-19,Siskiyou,93,43540,6,6,0,6,0
2020-05-19,Solano,95,438530,506,415,0,415,4
2020-05-19,Sonoma,97,501317,497,389,0,389,4
2020-05-19,Stanislaus,99,539301,669,582,4,586,25
2020-05-19,Sutter,101,95872,40,38,0,38,2
2020-05-19,Tehama,103,63373,4,2,0,2,1
2020-05-19,Trinity,105,12862,1,1,0,1,0
2020-05-19,Tulare,107,460477,1985,1551,2,1553,68
2020-05-19,Tuolumne,109,53932,3,2,0,2,0
2020-05-19,Ventura,111,848112,1208,861,2,863,28
2020-05-19,Yolo,113,214977,201,183,0,183,22
2020-05-19,Yuba,115,75493,26,23,0,23,1
2020-05-18,Alameda,1,1643700,2963,2442,0,2442,84
2020-05-18,Alpine,3,1148,1,1,0,1,0
2020-05-18,Amador,5,37829,10,8,0,8,0
2020-05-18,Butte,7,227075,42,24,0,24,0
2020-05-18,Calaveras,9,45235,14,13,0,13,0
2020-05-18,Colusa,11,21464,5,3,0,3,0
2020-05-18,Contra Costa,13,1133247,1356,1173,0,1173,33
2020-05-18,Del Norte,15,27424,23,8,0,8,0
2020-05-18,El Dorado,17,186661,84,67,0,67,0
2020-05-18,Fresno,19,978130,2233,1244,25,1269,14
2020-05-18,Glenn,21,27897,13,11,0,11,0
2020-05-18,Humboldt,23,135768,101,70,0,70,0
2020-05-18,Imperial,25,180216,1906,767,6,773,14
2020-05-18,Inyo,27,18085,19,20,0,20,1
2020-05-18,Kern,29,883053,2026,1566,3,1569,26
2020-05-18,Kings,31,150075,532,381,2,383,2
2020-05-18,Lake,33,64148,13,9,0,9,0
2020-05-18,Lassen,35,31185,2,0,1,1,0
2020-05-18,Los Angeles,37,10098052,48017,38477,22,38499,1825
2020-05-18,Madera,39,155013,150,74,0,74,2
2020-05-18,Marin,41,260295,359,329,1,330,14
2020-05-18,Mariposa,43,17540,16,15,0,15,1
2020-05-18,Mendocino,45,87422,14,12,0,12,0
2020-05-18,Merced,47,269075,315,217,0,217,5
2020-05-18,Modoc,49,8938,0,0,0,0,0
2020-05-18,Mono,51,14174,36,33,0,33,1
2020-05-18,Monterey,53,433212,433,345,0,345,8
2020-05-18,Napa,55,140530,105,92,0,92,3
2020-05-18,Nevada,57,99092,42,41,1,42,1
2020-05-18,Orange,59,3164182,6712,4558,30,4588,88
2020-05-18,Placer,61,380077,198,176,1,177,8
2020-05-18,Plumas,63,18699,4,5,0,5,0
2020-05-18,Riverside,65,2383286,6907,5873,7,5880,253
2020-05-18,Sacramento,67,1510023,1311,1233,0,1233,57
2020-05-18,San Benito,69,59416,70,59,0,59,2
2020-05-18,San Bernardino,71,2135413,4672,3558,3,3561,156
2020-05-18,San Diego,73,3302833,6941,5948,0,5948,211
2020-05-18,San Francisco,75,870044,2373,2183,1,2184,36
2020-05-18,San Joaquin,77,732212,809,697,4,701,33
2020-05-18,San Luis Obispo,79,281455,289,243,1,244,1
2020-05-18,San Mateo,81,765935,1979,1701,2,1703,68
2020-05-18,Santa Barbara,83,443738,1796,1501,20,1521,10
2020-05-18,Santa Clara,85,1922200,2881,2468,5,2473,137
2020-05-18,Santa Cruz,87,273765,185,160,0,160,3
2020-05-18,Shasta,89,179085,47,34,0,34,4
2020-05-18,Sierra,91,2930,0,0,0,0,0
2020-05-18,Siskiyou,93,43540,6,6,0,6,0
2020-05-18,Solano,95,438530,496,398,0,398,4
2020-05-18,Sonoma,97,501317,479,387,0,387,4
2020-05-18,Stanislaus,99,539301,657,572,4,576,25
2020-05-18,Sutter,101,95872,40,38,0,38,2
2020-05-18,Tehama,103,63373,4,2,0,2,1
2020-05-18,Trinity,105,12862,1,1,0,1,0
2020-05-18,Tulare,107,460477,1940,1491,2,1493,63
2020-05-18,Tuolumne,109,53932,3,2,0,2,0
2020-05-18,Ventura,111,848112,1186,850,1,851,27
2020-05-18,Yolo,113,214977,196,183,0,183,22
2020-05-18,Yuba,115,75493,26,23,0,23,1
2020-05-17,Alameda,1,1643700,2868,2389,0,2389,83
2020-05-17,Alpine,3,1148,1,1,0,1,0
2020-05-17,Amador,5,37829,10,8,0,8,0
2020-05-17,Butte,7,227075,42,23,0,23,0
2020-05-17,Calaveras,9,45235,14,13,0,13,0
2020-05-17,Colusa,11,21464,3,3,0,3,0
2020-05-17,Contra Costa,13,1133247,1318,1155,0,1155,33
2020-05-17,Del Norte,15,27424,23,7,0,7,0
2020-05-17,El Dorado,17,186661,84,65,0,65,0
2020-05-17,Fresno,19,978130,2137,1213,22,1235,14
2020-05-17,Glenn,21,27897,13,9,0,9,0
2020-05-17,Humboldt,23,135768,94,70,0,70,0
2020-05-17,Imperial,25,180216,1757,715,5,720,14
2020-05-17,Inyo,27,18085,19,20,0,20,1
2020-05-17,Kern,29,883053,1948,1546,3,1549,26
2020-05-17,Kings,31,150075,485,356,2,358,2
2020-05-17,Lake,33,64148,13,7,0,7,0
2020-05-17,Lassen,35,31185,2,0,1,1,0
2020-05-17,Los Angeles,37,10098052,46783,37996,22,38018,1807
2020-05-17,Madera,39,155013,148,69,0,69,2
2020-05-17,Marin,41,260295,348,315,1,316,14
2020-05-17,Mariposa,43,17540,15,15,0,15,1
2020-05-17,Mendocino,45,87422,13,10,0,10,0
2020-05-17,Merced,47,269075,304,214,0,214,5
2020-05-17,Modoc,49,8938,0,0,0,0,0
2020-05-17,Mono,51,14174,36,32,0,32,1
2020-05-17,Monterey,53,433212,413,342,0,342,8
2020-05-17,Napa,55,140530,102,89,0,89,3
2020-05-17,Nevada,57,99092,42,41,1,42,1
2020-05-17,Orange,59,3164182,6533,4466,30,4496,88
2020-05-17,Placer,61,380077,192,175,1,176,8
2020-05-17,Plumas,63,18699,4,4,0,4,0
2020-05-17,Riverside,65,2383286,6734,5776,7,5783,245
2020-05-17,Sacramento,67,1510023,1300,1224,0,1224,56
2020-05-17,San Benito,69,59416,69,59,0,59,2
2020-05-17,San Bernardino,71,2135413,4521,3467,3,3470,155
2020-05-17,San Diego,73,3302833,6809,5838,0,5838,209
2020-05-17,San Francisco,75,870044,2346,2132,1,2133,36
2020-05-17,San Joaquin,77,732212,779,688,4,692,32
2020-05-17,San Luis Obispo,79,281455,287,242,1,243,1
2020-05-17,San Mateo,81,765935,1942,1680,2,1682,68
2020-05-17,Santa Barbara,83,443738,1770,1457,20,1477,10
2020-05-17,Santa Clara,85,1922200,2843,2453,5,2458,135
2020-05-17,Santa Cruz,87,273765,174,155,0,155,3
2020-05-17,Shasta,89,179085,46,34,0,34,4
2020-05-17,Sierra,91,2930,0,0,0,0,0
2020-05-17,Siskiyou,93,43540,6,6,0,6,0
2020-05-17,Solano,95,438530,484,392,0,392,4
2020-05-17,Sonoma,97,501317,458,376,0,376,4
2020-05-17,Stanislaus,99,539301,646,566,4,570,25
2020-05-17,Sutter,101,95872,39,38,0,38,2
2020-05-17,Tehama,103,63373,3,2,0,2,1
2020-05-17,Trinity,105,12862,1,1,0,1,0
2020-05-17,Tulare,107,460477,1881,1430,2,1432,63
2020-05-17,Tuolumne,109,53932,3,2,0,2,0
2020-05-17,Ventura,111,848112,1144,838,1,839,27
2020-05-17,Yolo,113,214977,194,182,0,182,22
2020-05-17,Yuba,115,75493,26,21,0,21,1
2020-05-16,Alameda,1,1643700,2818,2327,0,2327,83
2020-05-16,Alpine,3,1148,1,1,0,1,0
2020-05-16,Amador,5,37829,10,8,0,8,0
2020-05-16,Butte,7,227075,37,22,0,22,0
2020-05-16,Calaveras,9,45235,14,13,0,13,0
2020-05-16,Colusa,11,21464,3,3,0,3,0
2020-05-16,Contra Costa,13,1133247,1300,1136,0,1136,33
2020-05-16,Del Norte,15,27424,19,4,0,4,0
2020-05-16,El Dorado,17,186661,84,65,0,65,0
2020-05-16,Fresno,19,978130,2082,1177,22,1199,14
2020-05-16,Glenn,21,27897,13,9,0,9,0
2020-05-16,Humboldt,23,135768,92,69,0,69,0
2020-05-16,Imperial,25,180216,1692,712,5,717,14
2020-05-16,Inyo,27,18085,19,20,0,20,1
2020-05-16,Kern,29,883053,1912,1509,3,1512,26
2020-05-16,Kings,31,150075,476,356,2,358,2
2020-05-16,Lake,33,64148,13,7,0,7,0
2020-05-16,Lassen,35,31185,1,0,1,1,0
2020-05-16,Los Angeles,37,10098052,46206,37352,22,37374,1778
2020-05-16,Madera,39,155013,146,70,0,70,2
2020-05-16,Marin,41,260295,344,297,1,298,14
2020-05-16,Mariposa,43,17540,15,15,0,15,1
2020-05-16,Mendocino,45,87422,13,10,0,10,0
2020-05-16,Merced,47,269075,302,201,0,201,5
2020-05-16,Modoc,49,8938,0,0,0,0,0
2020-05-16,Mono,51,14174,36,32,0,32,1
2020-05-16,Monterey,53,433212,398,329,0,329,8
2020-05-16,Napa,55,140530,102,86,0,86,3
2020-05-16,Nevada,57,99092,42,41,1,42,1
2020-05-16,Orange,59,3164182,6457,4396,30,4426,87
2020-05-16,Placer,61,380077,190,174,1,175,8
2020-05-16,Plumas,63,18699,4,4,0,4,0
2020-05-16,Riverside,65,2383286,6648,5633,7,5640,243
2020-05-16,Sacramento,67,1510023,1293,1209,0,1209,55
2020-05-16,San Benito,69,59416,64,58,0,58,2
2020-05-16,San Bernardino,71,2135413,4450,3362,3,3365,155
2020-05-16,San Diego,73,3302833,6723,5664,0,5664,209
2020-05-16,San Francisco,75,870044,2323,2094,1,2095,36
2020-05-16,San Joaquin,77,732212,771,668,4,672,32
2020-05-16,San Luis Obispo,79,281455,286,240,1,241,1
2020-05-16,San Mateo,81,765935,1927,1652,2,1654,68
2020-05-16,Santa Barbara,83,443738,1758,1422,19,1441,10
2020-05-16,Santa Clara,85,1922200,2828,2420,4,2424,135
2020-05-16,Santa Cruz,87,273765,171,154,0,154,3
2020-05-16,Shasta,89,179085,46,33,0,33,4
2020-05-16,Sierra,91,2930,0,0,0,0,0
2020-05-16,Siskiyou,93,43540,6,6,0,6,0
2020-05-16,Solano,95,438530,479,392,0,392,4
2020-05-16,Sonoma,97,501317,445,356,0,356,4
2020-05-16,Stanislaus,99,539301,637,546,4,550,24
2020-05-16,Sutter,101,95872,39,35,0,35,2
2020-05-16,Tehama,103,63373,3,2,0,2,1
2020-05-16,Trinity,105,12862,1,1,0,1,0
2020-05-16,Tulare,107,460477,1863,1426,2,1428,63
2020-05-16,Tuolumne,109,53932,3,2,0,2,0
2020-05-16,Ventura,111,848112,1119,813,1,814,25
2020-05-16,Yolo,113,214977,193,181,0,181,22
2020-05-16,Yuba,115,75493,26,21,0,21,1
2020-05-15,Alameda,1,1643700,2784,2289,0,2289,83
2020-05-15,Alpine,3,1148,1,1,0,1,0
2020-05-15,Amador,5,37829,10,8,0,8,0
2020-05-15,Butte,7,227075,35,22,0,22,0
2020-05-15,Calaveras,9,45235,14,13,0,13,0
2020-05-15,Colusa,11,21464,3,3,0,3,0
2020-05-15,Contra Costa,13,1133247,1282,1106,0,1106,33
2020-05-15,Del Norte,15,27424,14,4,0,4,0
2020-05-15,El Dorado,17,186661,84,64,0,64,0
2020-05-15,Fresno,19,978130,2017,1126,22,1148,14
2020-05-15,Glenn,21,27897,13,9,0,9,0
2020-05-15,Humboldt,23,135768,91,60,0,60,0
2020-05-15,Imperial,25,180216,1609,680,5,685,14
2020-05-15,Inyo,27,18085,19,20,0,20,1
2020-05-15,Kern,29,883053,1856,1472,3,1475,25
2020-05-15,Kings,31,150075,473,347,2,349,2
2020-05-15,Lake,33,64148,13,7,0,7,0
2020-05-15,Lassen,35,31185,1,0,1,1,0
2020-05-15,Los Angeles,37,10098052,45418,36317,22,36339,1734
2020-05-15,Madera,39,155013,145,71,0,71,2
2020-05-15,Marin,41,260295,336,295,1,296,14
2020-05-15,Mariposa,43,17540,15,15,0,15,1
2020-05-15,Mendocino,45,87422,13,10,0,10,0
2020-05-15,Merced,47,269075,299,191,0,191,5
2020-05-15,Modoc,49,8938,0,0,0,0,0
2020-05-15,Mono,51,14174,36,31,0,31,1
2020-05-15,Monterey,53,433212,392,321,0,321,8
2020-05-15,Napa,55,140530,102,83,0,83,3
2020-05-15,Nevada,57,99092,42,41,1,42,1
2020-05-15,Orange,59,3164182,6286,4281,30,4311,87
2020-05-15,Placer,61,380077,188,174,1,175,8
2020-05-15,Plumas,63,18699,4,4,0,4,0
2020-05-15,Riverside,65,2383286,6534,5496,7,5503,233
2020-05-15,Sacramento,67,1510023,1283,1203,0,1203,55
2020-05-15,San Benito,69,59416,61,57,0,57,2
2020-05-15,San Bernardino,71,2135413,4372,3225,3,3228,153
2020-05-15,San Diego,73,3302833,6616,5525,0,5525,208
2020-05-15,San Francisco,75,870044,2307,2062,1,2063,36
2020-05-15,San Joaquin,77,732212,765,656,4,660,32
2020-05-15,San Luis Obispo,79,281455,285,237,1,238,1
2020-05-15,San Mateo,81,765935,1905,1612,2,1614,68
2020-05-15,Santa Barbara,83,443738,1745,1409,19,1428,10
2020-05-15,Santa Clara,85,1922200,2803,2395,4,2399,135
2020-05-15,Santa Cruz,87,273765,170,146,0,146,3
2020-05-15,Shasta,89,179085,45,33,0,33,4
2020-05-15,Sierra,91,2930,0,0,0,0,0
2020-05-15,Siskiyou,93,43540,5,5,0,5,0
2020-05-15,Solano,95,438530,475,388,0,388,4
2020-05-15,Sonoma,97,501317,437,349,0,349,4
2020-05-15,Stanislaus,99,539301,630,540,4,544,23
2020-05-15,Sutter,101,95872,38,35,0,35,2
2020-05-15,Tehama,103,63373,3,1,0,1,1
2020-05-15,Trinity,105,12862,1,1,0,1,0
2020-05-15,Tulare,107,460477,1836,1356,2,1358,61
2020-05-15,Tuolumne,109,53932,3,2,0,2,0
2020-05-15,Ventura,111,848112,1103,789,1,790,25
2020-05-15,Yolo,113,214977,192,182,0,182,22
2020-05-15,Yuba,115,75493,26,21,0,21,1
2020-05-14,Alameda,1,1643700,2693,2255,0,2255,80
2020-05-14,Alpine,3,1148,1,1,0,1,0
2020-05-14,Amador,5,37829,10,8,0,8,0
2020-05-14,Butte,7,227075,33,22,0,22,0
2020-05-14,Calaveras,9,45235,14,13,0,13,0
2020-05-14,Colusa,11,21464,3,3,0,3,0
2020-05-14,Contra Costa,13,1133247,1256,1090,0,1090,32
2020-05-14,Del Norte,15,27424,14,4,0,4,0
2020-05-14,El Dorado,17,186661,75,59,0,59,0
2020-05-14,Fresno,19,978130,1965,1038,19,1057,12
2020-05-14,Glenn,21,27897,12,8,0,8,0
2020-05-14,Humboldt,23,135768,89,59,0,59,0
2020-05-14,Imperial,25,180216,1492,652,5,657,13
2020-05-14,Inyo,27,18085,19,20,0,20,1
2020-05-14,Kern,29,883053,1814,1430,3,1433,21
2020-05-14,Kings,31,150075,457,342,2,344,1
2020-05-14,Lake,33,64148,13,7,0,7,0
2020-05-14,Lassen,35,31185,1,0,1,1,0
2020-05-14,Los Angeles,37,10098052,44238,35427,22,35449,1693
2020-05-14,Madera,39,155013,136,69,0,69,2
2020-05-14,Marin,41,260295,318,283,1,284,14
2020-05-14,Mariposa,43,17540,15,15,0,15,0
2020-05-14,Mendocino,45,87422,12,10,0,10,0
2020-05-14,Merced,47,269075,289,182,0,182,3
2020-05-14,Modoc,49,8938,0,0,0,0,0
2020-05-14,Mono,51,14174,36,31,0,31,1
2020-05-14,Monterey,53,433212,382,317,0,317,7
2020-05-14,Napa,55,140530,100,83,0,83,3
2020-05-14,Nevada,57,99092,41,41,1,42,1
2020-05-14,Orange,59,3164182,6110,4163,28,4191,83
2020-05-14,Placer,61,380077,188,172,1,173,8
2020-05-14,Plumas,63,18699,4,4,0,4,0
2020-05-14,Riverside,65,2383286,6351,5339,7,5346,224
2020-05-14,Sacramento,67,1510023,1271,1181,0,1181,55
2020-05-14,San Benito,69,59416,59,56,0,56,2
2020-05-14,San Bernardino,71,2135413,4194,3149,3,3152,149
2020-05-14,San Diego,73,3302833,6482,5393,0,5393,200
2020-05-14,San Francisco,75,870044,2274,2029,1,2030,36
2020-05-14,San Joaquin,77,732212,750,643,4,647,31
2020-05-14,San Luis Obispo,79,281455,282,236,1,237,1
2020-05-14,San Mateo,81,765935,1873,1588,2,1590,67
2020-05-14,Santa Barbara,83,443738,1727,1395,19,1414,11
2020-05-14,Santa Clara,85,1922200,2782,2380,4,2384,134
2020-05-14,Santa Cruz,87,273765,168,145,0,145,3
2020-05-14,Shasta,89,179085,45,33,0,33,4
2020-05-14,Sierra,91,2930,0,0,0,0,0
2020-05-14,Siskiyou,93,43540,5,5,0,5,0
2020-05-14,Solano,95,438530,466,372,0,372,4
2020-05-14,Sonoma,97,501317,420,333,0,333,4
2020-05-14,Stanislaus,99,539301,611,533,4,537,23
2020-05-14,Sutter,101,95872,38,34,0,34,2
2020-05-14,Tehama,103,63373,3,1,0,1,1
2020-05-14,Trinity,105,12862,1,1,0,1,0
2020-05-14,Tulare,107,460477,1803,1317,2,1319,55
2020-05-14,Tuolumne,109,53932,3,2,0,2,0
2020-05-14,Ventura,111,848112,1075,760,1,761,25
2020-05-14,Yolo,113,214977,192,180,0,180,22
2020-05-14,Yuba,115,75493,26,21,0,21,1
2020-05-13,Alameda,1,1643700,2635,2181,0,2181,78
2020-05-13,Alpine,3,1148,1,1,0,1,0
2020-05-13,Amador,5,37829,10,8,0,8,0
2020-05-13,Butte,7,227075,33,21,0,21,0
2020-05-13,Calaveras,9,45235,14,13,0,13,0
2020-05-13,Colusa,11,21464,3,3,0,3,0
2020-05-13,Contra Costa,13,1133247,1234,1082,0,1082,32
2020-05-13,Del Norte,15,27424,13,4,0,4,0
2020-05-13,El Dorado,17,186661,74,58,0,58,0
2020-05-13,Fresno,19,978130,1879,993,19,1012,10
2020-05-13,Glenn,21,27897,11,6,0,6,0
2020-05-13,Humboldt,23,135768,83,58,0,58,0
2020-05-13,Imperial,25,180216,1422,610,5,615,11
2020-05-13,Inyo,27,18085,19,20,0,20,1
2020-05-13,Kern,29,883053,1770,1390,3,1393,19
2020-05-13,Kings,31,150075,444,314,2,316,1
2020-05-13,Lake,33,64148,13,7,0,7,0
2020-05-13,Lassen,35,31185,1,0,1,1,0
2020-05-13,Los Angeles,37,10098052,42925,34574,22,34596,1643
2020-05-13,Madera,39,155013,127,69,0,69,2
2020-05-13,Marin,41,260295,305,278,1,279,14
2020-05-13,Mariposa,43,17540,15,15,0,15,0
2020-05-13,Mendocino,45,87422,12,10,0,10,0
2020-05-13,Merced,47,269075,286,176,0,176,3
2020-05-13,Modoc,49,8938,0,0,0,0,0
2020-05-13,Mono,51,14174,35,31,0,31,1
2020-05-13,Monterey,53,433212,372,309,0,309,6
2020-05-13,Napa,55,140530,100,81,0,81,3
2020-05-13,Nevada,57,99092,41,41,1,42,1
2020-05-13,Orange,59,3164182,5864,4025,26,4051,79
2020-05-13,Placer,61,380077,187,170,1,171,8
2020-05-13,Plumas,63,18699,4,4,0,4,0
2020-05-13,Riverside,65,2383286,6228,5204,7,5211,216
2020-05-13,Sacramento,67,1510023,1256,1173,0,1173,53
2020-05-13,San Benito,69,59416,59,55,0,55,2
2020-05-13,San Bernardino,71,2135413,3939,3064,2,3066,140
2020-05-13,San Diego,73,3302833,6346,5280,0,5280,194
2020-05-13,San Francisco,75,870044,2246,2004,1,2005,35
2020-05-13,San Joaquin,77,732212,729,639,3,642,31
2020-05-13,San Luis Obispo,79,281455,280,231,1,232,1
2020-05-13,San Mateo,81,765935,1841,1550,2,1552,66
2020-05-13,Santa Barbara,83,443738,1711,1382,19,1401,10
2020-05-13,Santa Clara,85,1922200,2765,2370,4,2374,132
2020-05-13,Santa Cruz,87,273765,164,142,0,142,2
2020-05-13,Shasta,89,179085,45,32,0,32,4
2020-05-13,Sierra,91,2930,0,0,0,0,0
2020-05-13,Siskiyou,93,43540,5,5,0,5,0
2020-05-13,Solano,95,438530,453,368,0,368,4
2020-05-13,Sonoma,97,501317,410,330,0,330,4
2020-05-13,Stanislaus,99,539301,602,521,4,525,15
2020-05-13,Sutter,101,95872,38,33,0,33,2
2020-05-13,Tehama,103,63373,3,1,0,1,1
2020-05-13,Trinity,105,12862,1,2,0,2,0
2020-05-13,Tulare,107,460477,1770,1283,2,1285,54
2020-05-13,Tuolumne,109,53932,3,2,0,2,0
2020-05-13,Ventura,111,848112,1048,742,1,743,25
2020-05-13,Yolo,113,214977,190,178,0,178,22
2020-05-13,Yuba,115,75493,24,19,0,19,1
2020-05-12,Alameda,1,1643700,2573,2146,0,2146,74
2020-05-12,Alpine,3,1148,1,1,0,1,0
2020-05-12,Amador,5,37829,10,8,0,8,0
2020-05-12,Butte,7,227075,31,20,0,20,0
2020-05-12,Calaveras,9,45235,13,13,0,13,0
2020-05-12,Colusa,11,21464,3,3,0,3,0
2020-05-12,Contra Costa,13,1133247,1203,1067,0,1067,32
2020-05-12,Del Norte,15,27424,10,3,0,3,0
2020-05-12,El Dorado,17,186661,71,56,0,56,0
2020-05-12,Fresno,19,978130,1801,978,19,997,9
2020-05-12,Glenn,21,27897,10,6,0,6,0
2020-05-12,Humboldt,23,135768,80,58,0,58,0
2020-05-12,Imperial,25,180216,1291,602,3,605,9
2020-05-12,Inyo,27,18085,19,20,0,20,1
2020-05-12,Kern,29,883053,1729,1363,3,1366,18
2020-05-12,Kings,31,150075,423,302,2,304,1
2020-05-12,Lake,33,64148,13,7,0,7,0
2020-05-12,Lassen,35,31185,1,0,1,1,0
2020-05-12,Los Angeles,37,10098052,41929,33281,21,33302,1601
2020-05-12,Madera,39,155013,123,69,0,69,2
2020-05-12,Marin,41,260295,300,274,1,275,14
2020-05-12,Mariposa,43,17540,15,15,0,15,0
2020-05-12,Mendocino,45,87422,12,10,0,10,0
2020-05-12,Merced,47,269075,275,175,0,175,3
2020-05-12,Modoc,49,8938,0,0,0,0,0
2020-05-12,Mono,51,14174,35,31,0,31,1
2020-05-12,Monterey,53,433212,365,298,0,298,6
2020-05-12,Napa,55,140530,98,80,0,80,3
2020-05-12,Nevada,57,99092,41,41,1,42,1
2020-05-12,Orange,59,3164182,5682,3843,24,3867,78
2020-05-12,Placer,61,380077,187,170,1,171,8
2020-05-12,Plumas,63,18699,4,4,0,4,0
2020-05-12,Riverside,65,2383286,6107,5134,7,5141,210
2020-05-12,Sacramento,67,1510023,1236,1166,0,1166,52
2020-05-12,San Benito,69,59416,59,55,0,55,2
2020-05-12,San Bernardino,71,2135413,3788,2997,2,2999,131
2020-05-12,San Diego,73,3302833,6202,3,0,3,0
2020-05-12,San Francisco,75,870044,2211,1981,1,1982,35
2020-05-12,San Joaquin,77,732212,714,625,3,628,30
2020-05-12,San Luis Obispo,79,281455,277,226,1,227,1
2020-05-12,San Mateo,81,765935,1815,1533,2,1535,66
2020-05-12,Santa Barbara,83,443738,1672,1377,19,1396,10
2020-05-12,Santa Clara,85,1922200,2735,2362,3,2365,131
2020-05-12,Santa Cruz,87,273765,162,141,0,141,2
2020-05-12,Shasta,89,179085,44,33,0,33,4
2020-05-12,Sierra,91,2930,0,0,0,0,0
2020-05-12,Siskiyou,93,43540,5,5,0,5,0
2020-05-12,Solano,95,438530,445,361,0,361,4
2020-05-12,Sonoma,97,501317,387,308,0,308,4
2020-05-12,Stanislaus,99,539301,595,515,4,519,15
2020-05-12,Sutter,101,95872,38,33,0,33,2
2020-05-12,Tehama,103,63373,3,1,0,1,1
2020-05-12,Trinity,105,12862,1,1,0,1,0
2020-05-12,Tulare,107,460477,1740,1261,1,1262,52
2020-05-12,Tuolumne,109,53932,3,2,0,2,0
2020-05-12,Ventura,111,848112,1010,718,1,719,20
2020-05-12,Yolo,113,214977,189,176,0,176,22
2020-05-12,Yuba,115,75493,24,19,0,19,1
2020-05-11,Alameda,1,1643700,2523,2103,0,2103,71
2020-05-11,Alpine,3,1148,1,1,0,1,0
2020-05-11,Amador,5,37829,10,8,0,8,0
2020-05-11,Butte,7,227075,30,19,0,19,0
2020-05-11,Calaveras,9,45235,13,13,0,13,0
2020-05-11,Colusa,11,21464,3,3,0,3,0
2020-05-11,Contra Costa,13,1133247,1189,1052,0,1052,32
2020-05-11,Del Norte,15,27424,8,3,0,3,0
2020-05-11,El Dorado,17,186661,71,55,0,55,0
2020-05-11,Fresno,19,978130,1720,937,17,954,8
2020-05-11,Glenn,21,27897,10,6,0,6,0
2020-05-11,Humboldt,23,135768,77,56,0,56,0
2020-05-11,Imperial,25,180216,1185,562,1,563,9
2020-05-11,Inyo,27,18085,19,20,0,20,1
2020-05-11,Kern,29,883053,1677,1331,3,1334,17
2020-05-11,Kings,31,150075,400,289,1,290,1
2020-05-11,Lake,33,64148,12,7,0,7,0
2020-05-11,Lassen,35,31185,1,0,1,1,0
2020-05-11,Los Angeles,37,10098052,40759,32279,21,32300,1553
2020-05-11,Madera,39,155013,116,68,0,68,2
2020-05-11,Marin,41,260295,291,271,1,272,14
2020-05-11,Mariposa,43,17540,15,15,0,15,0
2020-05-11,Mendocino,45,87422,12,10,0,10,0
2020-05-11,Merced,47,269075,260,158,0,158,3
2020-05-11,Modoc,49,8938,0,0,0,0,0
2020-05-11,Mono,51,14174,35,30,0,30,1
2020-05-11,Monterey,53,433212,362,286,0,286,6
2020-05-11,Napa,55,140530,92,79,0,79,2
2020-05-11,Nevada,57,99092,41,41,1,42,1
2020-05-11,Orange,59,3164182,5476,3699,20,3719,77
2020-05-11,Placer,61,380077,187,170,1,171,8
2020-05-11,Plumas,63,18699,4,4,0,4,0
2020-05-11,Riverside,65,2383286,5950,5082,7,5089,203
2020-05-11,Sacramento,67,1510023,1221,1160,0,1160,52
2020-05-11,San Benito,69,59416,57,52,0,52,2
2020-05-11,San Bernardino,71,2135413,3678,2945,2,2947,124
2020-05-11,San Diego,73,3302833,6049,5067,0,5067,175
2020-05-11,San Francisco,75,870044,2163,1974,1,1975,35
2020-05-11,San Joaquin,77,732212,704,620,3,623,30
2020-05-11,San Luis Obispo,79,281455,275,224,1,225,1
2020-05-11,San Mateo,81,765935,1789,1499,2,1501,66
2020-05-11,Santa Barbara,83,443738,1652,1372,19,1391,10
2020-05-11,Santa Clara,85,1922200,2719,2340,3,2343,129
2020-05-11,Santa Cruz,87,273765,159,140,0,140,2
2020-05-11,Shasta,89,179085,44,31,0,31,4
2020-05-11,Sierra,91,2930,0,0,0,0,0
2020-05-11,Siskiyou,93,43540,5,5,0,5,0
2020-05-11,Solano,95,438530,440,354,0,354,4
2020-05-11,Sonoma,97,501317,377,303,0,303,3
2020-05-11,Stanislaus,99,539301,585,507,4,511,14
2020-05-11,Sutter,101,95872,37,32,0,32,2
2020-05-11,Tehama,103,63373,3,1,0,1,1
2020-05-11,Trinity,105,12862,1,1,0,1,0
2020-05-11,Tulare,107,460477,1692,1203,1,1204,49
2020-05-11,Tuolumne,109,53932,3,2,0,2,0
2020-05-11,Ventura,111,848112,966,698,0,698,19
2020-05-11,Yolo,113,214977,189,174,0,174,20
2020-05-11,Yuba,115,75493,24,18,0,18,1
2020-05-10,Alameda,1,1643700,2446,2047,0,2047,71
2020-05-10,Alpine,3,1148,1,1,0,1,0
2020-05-10,Amador,5,37829,10,8,0,8,0
2020-05-10,Butte,7,227075,26,18,0,18,0
2020-05-10,Calaveras,9,45235,13,13,0,13,0
2020-05-10,Colusa,11,21464,3,3,0,3,0
2020-05-10,Contra Costa,13,1133247,1175,1046,0,1046,31
2020-05-10,Del Norte,15,27424,7,3,0,3,0
2020-05-10,El Dorado,17,186661,71,55,0,55,0
2020-05-10,Fresno,19,978130,1643,894,17,911,8
2020-05-10,Glenn,21,27897,10,6,0,6,0
2020-05-10,Humboldt,23,135768,73,56,0,56,0
2020-05-10,Imperial,25,180216,1089,509,1,510,7
2020-05-10,Inyo,27,18085,19,20,0,20,1
2020-05-10,Kern,29,883053,1628,1300,2,1302,16
2020-05-10,Kings,31,150075,387,266,1,267,1
2020-05-10,Lake,33,64148,12,7,0,7,0
2020-05-10,Lassen,35,31185,1,0,1,1,0
2020-05-10,Los Angeles,37,10098052,39507,31711,21,31732,1514
2020-05-10,Madera,39,155013,114,65,0,65,2
2020-05-10,Marin,41,260295,283,267,1,268,14
2020-05-10,Mariposa,43,17540,15,15,0,15,0
2020-05-10,Mendocino,45,87422,11,10,0,10,0
2020-05-10,Merced,47,269075,245,154,0,154,3
2020-05-10,Modoc,49,8938,0,0,0,0,0
2020-05-10,Mono,51,14174,35,27,0,27,1
2020-05-10,Monterey,53,433212,348,282,0,282,6
2020-05-10,Napa,55,140530,86,79,0,79,2
2020-05-10,Nevada,57,99092,41,41,1,42,1
2020-05-10,Orange,59,3164182,5331,3627,20,3647,76
2020-05-10,Placer,61,380077,186,168,1,169,8
2020-05-10,Plumas,63,18699,4,4,0,4,0
2020-05-10,Riverside,65,2383286,5828,4951,7,4958,193
2020-05-10,Sacramento,67,1510023,1205,1152,0,1152,52
2020-05-10,San Benito,69,59416,57,52,0,52,2
2020-05-10,San Bernardino,71,2135413,3580,2910,2,2912,121
2020-05-10,San Diego,73,3302833,5897,4928,0,4928,175
2020-05-10,San Francisco,75,870044,2143,1953,1,1954,35
2020-05-10,San Joaquin,77,732212,689,611,3,614,29
2020-05-10,San Luis Obispo,79,281455,272,218,1,219,1
2020-05-10,San Mateo,81,765935,1767,1463,2,1465,65
2020-05-10,Santa Barbara,83,443738,1631,1323,19,1342,10
2020-05-10,Santa Clara,85,1922200,2695,2331,3,2334,129
2020-05-10,Santa Cruz,87,273765,158,139,0,139,2
2020-05-10,Shasta,89,179085,44,31,0,31,4
2020-05-10,Sierra,91,2930,0,0,0,0,0
2020-05-10,Siskiyou,93,43540,5,5,0,5,0
2020-05-10,Solano,95,438530,430,322,0,322,4
2020-05-10,Sonoma,97,501317,367,290,0,290,3
2020-05-10,Stanislaus,99,539301,578,498,4,502,14
2020-05-10,Sutter,101,95872,34,31,0,31,2
2020-05-10,Tehama,103,63373,3,1,0,1,1
2020-05-10,Trinity,105,12862,1,1,0,1,0
2020-05-10,Tulare,107,460477,1624,1143,1,1144,47
2020-05-10,Tuolumne,109,53932,3,2,0,2,0
2020-05-10,Ventura,111,848112,918,690,0,690,19
2020-05-10,Yolo,113,214977,189,173,0,173,20
2020-05-10,Yuba,115,75493,23,17,0,17,1
2020-05-09,Alameda,1,1643700,2403,2011,0,2011,71
2020-05-09,Alpine,3,1148,1,1,0,1,0
2020-05-09,Amador,5,37829,9,8,0,8,0
2020-05-09,Butte,7,227075,25,18,0,18,0
2020-05-09,Calaveras,9,45235,13,13,0,13,0
2020-05-09,Colusa,11,21464,3,3,0,3,0
2020-05-09,Contra Costa,13,1133247,1161,1039,0,1039,31
2020-05-09,Del Norte,15,27424,7,3,0,3,0
2020-05-09,El Dorado,17,186661,68,54,0,54,0
2020-05-09,Fresno,19,978130,1607,861,17,878,8
2020-05-09,Glenn,21,27897,9,6,0,6,0
2020-05-09,Humboldt,23,135768,71,55,0,55,0
2020-05-09,Imperial,25,180216,1033,474,1,475,7
2020-05-09,Inyo,27,18085,19,20,0,20,1
2020-05-09,Kern,29,883053,1592,1262,1,1263,15
2020-05-09,Kings,31,150075,382,264,1,265,1
2020-05-09,Lake,33,64148,12,7,0,7,0
2020-05-09,Lassen,35,31185,1,0,1,1,0
2020-05-09,Los Angeles,37,10098052,38882,31268,21,31289,1499
2020-05-09,Madera,39,155013,113,61,0,61,2
2020-05-09,Marin,41,260295,282,261,1,262,14
2020-05-09,Mariposa,43,17540,15,15,0,15,0
2020-05-09,Mendocino,45,87422,11,10,0,10,0
2020-05-09,Merced,47,269075,241,153,0,153,3
2020-05-09,Modoc,49,8938,0,0,0,0,0
2020-05-09,Mono,51,14174,35,27,0,27,1
2020-05-09,Monterey,53,433212,341,273,0,273,6
2020-05-09,Napa,55,140530,85,78,0,78,2
2020-05-09,Nevada,57,99092,41,41,1,42,1
2020-05-09,Orange,59,3164182,5250,3506,19,3525,75
2020-05-09,Placer,61,380077,185,168,1,169,8
2020-05-09,Plumas,63,18699,4,4,0,4,0
2020-05-09,Riverside,65,2383286,5734,4871,7,4878,183
2020-05-09,Sacramento,67,1510023,1201,1150,0,1150,52
2020-05-09,San Benito,69,59416,56,52,0,52,2
2020-05-09,San Bernardino,71,2135413,3524,2825,2,2827,121
2020-05-09,San Diego,73,3302833,5785,4778,0,4778,175
2020-05-09,San Francisco,75,870044,2128,1944,1,1945,34
2020-05-09,San Joaquin,77,732212,680,605,3,608,28
2020-05-09,San Luis Obispo,79,281455,268,213,1,214,1
2020-05-09,San Mateo,81,765935,1748,1453,2,1455,65
2020-05-09,Santa Barbara,83,443738,1619,1245,19,1264,10
2020-05-09,Santa Clara,85,1922200,2684,2317,3,2320,128
2020-05-09,Santa Cruz,87,273765,157,138,0,138,2
2020-05-09,Shasta,89,179085,44,31,0,31,4
2020-05-09,Sierra,91,2930,0,0,0,0,0
2020-05-09,Siskiyou,93,43540,5,5,0,5,0
2020-05-09,Solano,95,438530,424,321,0,321,4
2020-05-09,Sonoma,97,501317,363,288,0,288,3
2020-05-09,Stanislaus,99,539301,570,491,4,495,12
2020-05-09,Sutter,101,95872,34,31,0,31,2
2020-05-09,Tehama,103,63373,2,1,0,1,1
2020-05-09,Trinity,105,12862,1,1,0,1,0
2020-05-09,Tulare,107,460477,1596,1083,1,1084,47
2020-05-09,Tuolumne,109,53932,3,2,0,2,0
2020-05-09,Ventura,111,848112,897,679,0,679,19
2020-05-09,Yolo,113,214977,189,172,0,172,18
2020-05-09,Yuba,115,75493,23,17,0,17,1
2020-05-08,Alameda,1,1643700,2360,1955,0,1955,70
2020-05-08,Alpine,3,1148,1,1,0,1,0
2020-05-08,Amador,5,37829,9,8,0,8,0
2020-05-08,Butte,7,227075,25,18,0,18,0
2020-05-08,Calaveras,9,45235,13,13,0,13,0
2020-05-08,Colusa,11,21464,3,3,0,3,0
2020-05-08,Contra Costa,13,1133247,1149,1024,0,1024,29
2020-05-08,Del Norte,15,27424,7,3,0,3,0
2020-05-08,El Dorado,17,186661,67,54,0,54,0
2020-05-08,Fresno,19,978130,1575,838,17,855,8
2020-05-08,Glenn,21,27897,8,6,0,6,0
2020-05-08,Humboldt,23,135768,68,54,0,54,0
2020-05-08,Imperial,25,180216,987,467,1,468,7
2020-05-08,Inyo,27,18085,19,20,0,20,1
2020-05-08,Kern,29,883053,1561,1214,1,1215,13
2020-05-08,Kings,31,150075,373,236,1,237,1
2020-05-08,Lake,33,64148,12,7,0,7,0
2020-05-08,Lassen,35,31185,1,0,1,1,0
2020-05-08,Los Angeles,37,10098052,38152,30357,21,30378,1447
2020-05-08,Madera,39,155013,110,57,0,57,2
2020-05-08,Marin,41,260295,282,257,1,258,14
2020-05-08,Mariposa,43,17540,15,15,0,15,0
2020-05-08,Mendocino,45,87422,11,10,0,10,0
2020-05-08,Merced,47,269075,240,151,0,151,3
2020-05-08,Modoc,49,8938,0,0,0,0,0
2020-05-08,Mono,51,14174,32,27,0,27,1
2020-05-08,Monterey,53,433212,333,265,0,265,6
2020-05-08,Napa,55,140530,84,78,0,78,2
2020-05-08,Nevada,57,99092,41,41,1,42,1
2020-05-08,Orange,59,3164182,5108,3395,19,3414,72
2020-05-08,Placer,61,380077,183,166,1,167,8
2020-05-08,Plumas,63,18699,4,4,0,4,0
2020-05-08,Riverside,65,2383286,5635,4672,7,4679,181
2020-05-08,Sacramento,67,1510023,1196,1145,0,1145,51
2020-05-08,San Benito,69,59416,56,51,0,51,2
2020-05-08,San Bernardino,71,2135413,3476,2631,2,2633,119
2020-05-08,San Diego,73,3302833,5678,4664,0,4664,169
2020-05-08,San Francisco,75,870044,2110,1890,1,1891,33
2020-05-08,San Joaquin,77,732212,673,595,3,598,28
2020-05-08,San Luis Obispo,79,281455,265,210,1,211,1
2020-05-08,San Mateo,81,765935,1663,1423,2,1425,62
2020-05-08,Santa Barbara,83,443738,1607,1054,18,1072,8
2020-05-08,Santa Clara,85,1922200,2662,2285,3,2288,128
2020-05-08,Santa Cruz,87,273765,153,137,0,137,2
2020-05-08,Shasta,89,179085,44,31,0,31,4
2020-05-08,Sierra,91,2930,0,0,0,0,0
2020-05-08,Siskiyou,93,43540,5,5,0,5,0
2020-05-08,Solano,95,438530,419,314,0,314,4
2020-05-08,Sonoma,97,501317,358,285,0,285,3
2020-05-08,Stanislaus,99,539301,556,487,4,491,12
2020-05-08,Sutter,101,95872,34,30,0,30,2
2020-05-08,Tehama,103,63373,2,1,0,1,1
2020-05-08,Trinity,105,12862,1,0,0,0,0
2020-05-08,Tulare,107,460477,1551,1050,1,1051,43
2020-05-08,Tuolumne,109,53932,3,2,0,2,0
2020-05-08,Ventura,111,848112,880,665,0,665,19
2020-05-08,Yolo,113,214977,188,172,0,172,18
2020-05-08,Yuba,115,75493,22,16,0,16,1
2020-05-07,Alameda,1,1643700,2300,1914,0,1914,68
2020-05-07,Alpine,3,1148,1,1,0,1,0
2020-05-07,Amador,5,37829,9,8,0,8,0
2020-05-07,Butte,7,227075,25,19,0,19,0
2020-05-07,Calaveras,9,45235,13,13,0,13,0
2020-05-07,Colusa,11,21464,3,3,0,3,0
2020-05-07,Contra Costa,13,1133247,1135,1005,0,1005,29
2020-05-07,Del Norte,15,27424,6,3,0,3,0
2020-05-07,El Dorado,17,186661,66,54,0,54,0
2020-05-07,Fresno,19,978130,1497,812,17,829,8
2020-05-07,Glenn,21,27897,8,5,0,5,0
2020-05-07,Humboldt,23,135768,67,54,0,54,0
2020-05-07,Imperial,25,180216,924,442,1,443,6
2020-05-07,Inyo,27,18085,19,20,0,20,1
2020-05-07,Kern,29,883053,1519,1176,1,1177,13
2020-05-07,Kings,31,150075,351,219,1,220,1
2020-05-07,Lake,33,64148,11,7,0,7,0
2020-05-07,Lassen,35,31185,1,0,1,1,0
2020-05-07,Los Angeles,37,10098052,37031,29544,21,29565,1399
2020-05-07,Madera,39,155013,106,54,0,54,2
2020-05-07,Marin,41,260295,275,252,1,253,14
2020-05-07,Mariposa,43,17540,15,15,0,15,0
2020-05-07,Mendocino,45,87422,11,10,0,10,0
2020-05-07,Merced,47,269075,232,146,0,146,3
2020-05-07,Modoc,49,8938,0,0,0,0,0
2020-05-07,Mono,51,14174,32,26,0,26,1
2020-05-07,Monterey,53,433212,325,249,0,249,6
2020-05-07,Napa,55,140530,84,78,0,78,2
2020-05-07,Nevada,57,99092,41,41,1,42,1
2020-05-07,Orange,59,3164182,4925,3283,17,3300,69
2020-05-07,Placer,61,380077,183,165,1,166,8
2020-05-07,Plumas,63,18699,4,4,0,4,0
2020-05-07,Riverside,65,2383286,5519,4608,7,4615,170
2020-05-07,Sacramento,67,1510023,1190,1139,0,1139,50
2020-05-07,San Benito,69,59416,56,50,0,50,2
2020-05-07,San Bernardino,71,2135413,3384,2522,2,2524,115
2020-05-07,San Diego,73,3302833,5521,4431,0,4431,165
2020-05-07,San Francisco,75,870044,2078,1852,1,1853,33
2020-05-07,San Joaquin,77,732212,660,583,3,586,28
2020-05-07,San Luis Obispo,79,281455,254,209,1,210,1
2020-05-07,San Mateo,81,765935,1641,1398,2,1400,58
2020-05-07,Santa Barbara,83,443738,1577,720,18,738,8
2020-05-07,Santa Clara,85,1922200,2625,2281,3,2284,127
2020-05-07,Santa Cruz,87,273765,150,136,0,136,2
2020-05-07,Shasta,89,179085,43,31,0,31,4
2020-05-07,Sierra,91,2930,0,0,0,0,0
2020-05-07,Siskiyou,93,43540,5,5,0,5,0
2020-05-07,Solano,95,438530,413,307,0,307,4
2020-05-07,Sonoma,97,501317,346,282,0,282,3
2020-05-07,Stanislaus,99,539301,547,466,4,470,10
2020-05-07,Sutter,101,95872,34,29,0,29,2
2020-05-07,Tehama,103,63373,2,1,0,1,1
2020-05-07,Trinity,105,12862,1,0,0,0,0
2020-05-07,Tulare,107,460477,1487,1001,1,1002,41
2020-05-07,Tuolumne,109,53932,3,2,0,2,0
2020-05-07,Ventura,111,848112,858,647,0,647,19
2020-05-07,Yolo,113,214977,187,172,0,172,18
2020-05-07,Yuba,115,75493,22,16,0,16,1
2020-05-06,Alameda,1,1643700,2263,1864,0,1864,67
2020-05-06,Alpine,3,1148,1,1,0,1,0
2020-05-06,Amador,5,37829,9,8,0,8,0
2020-05-06,Butte,7,227075,24,19,0,19,0
2020-05-06,Calaveras,9,45235,13,13,0,13,0
2020-05-06,Colusa,11,21464,3,3,0,3,0
2020-05-06,Contra Costa,13,1133247,1114,990,0,990,29
2020-05-06,Del Norte,15,27424,6,3,0,3,0
2020-05-06,El Dorado,17,186661,64,53,0,53,0
2020-05-06,Fresno,19,978130,1439,773,15,788,8
2020-05-06,Glenn,21,27897,8,3,0,3,0
2020-05-06,Humboldt,23,135768,66,54,0,54,0
2020-05-06,Imperial,25,180216,856,399,1,400,6
2020-05-06,Inyo,27,18085,19,20,0,20,1
2020-05-06,Kern,29,883053,1464,1112,1,1113,12
2020-05-06,Kings,31,150075,333,208,1,209,1
2020-05-06,Lake,33,64148,11,7,0,7,0
2020-05-06,Lassen,35,31185,1,0,1,1,0
2020-05-06,Los Angeles,37,10098052,36022,28687,21,28708,1347
2020-05-06,Madera,39,155013,104,55,0,55,2
2020-05-06,Marin,41,260295,268,244,1,245,14
2020-05-06,Mariposa,43,17540,15,14,0,14,0
2020-05-06,Mendocino,45,87422,11,10,0,10,0
2020-05-06,Merced,47,269075,225,140,0,140,3
2020-05-06,Modoc,49,8938,0,0,0,0,0
2020-05-06,Mono,51,14174,32,26,0,26,1
2020-05-06,Monterey,53,433212,317,246,0,246,6
2020-05-06,Napa,55,140530,83,78,0,78,2
2020-05-06,Nevada,57,99092,41,41,1,42,1
2020-05-06,Orange,59,3164182,4740,3156,16,3172,66
2020-05-06,Placer,61,380077,180,164,1,165,8
2020-05-06,Plumas,63,18699,4,4,0,4,0
2020-05-06,Riverside,65,2383286,5374,4535,7,4542,163
2020-05-06,Sacramento,67,1510023,1183,1135,0,1135,49
2020-05-06,San Benito,69,59416,55,50,0,50,2
2020-05-06,San Bernardino,71,2135413,3262,2426,1,2427,110
2020-05-06,San Diego,73,3302833,5388,4321,0,4321,158
2020-05-06,San Francisco,75,870044,2052,1804,1,1805,32
2020-05-06,San Joaquin,77,732212,647,581,3,584,28
2020-05-06,San Luis Obispo,79,281455,251,207,1,208,1
2020-05-06,San Mateo,81,765935,1610,1348,2,1350,57
2020-05-06,Santa Barbara,83,443738,1531,565,18,583,8
2020-05-06,Santa Clara,85,1922200,2610,2270,3,2273,127
2020-05-06,Santa Cruz,87,273765,146,135,0,135,2
2020-05-06,Shasta,89,179085,43,31,0,31,4
2020-05-06,Sierra,91,2930,0,0,0,0,0
2020-05-06,Siskiyou,93,43540,5,5,0,5,0
2020-05-06,Solano,95,438530,403,300,0,300,4
2020-05-06,Sonoma,97,501317,330,269,0,269,3
2020-05-06,Stanislaus,99,539301,531,434,4,438,9
2020-05-06,Sutter,101,95872,34,29,0,29,2
2020-05-06,Tehama,103,63373,2,1,0,1,1
2020-05-06,Trinity,105,12862,1,0,0,0,0
2020-05-06,Tulare,107,460477,1439,963,1,964,40
2020-05-06,Tuolumne,109,53932,3,2,0,2,0
2020-05-06,Ventura,111,848112,833,619,0,619,19
2020-05-06,Yolo,113,214977,186,172,0,172,18
2020-05-06,Yuba,115,75493,22,15,0,15,1
2020-05-05,Alameda,1,1643700,2220,1819,0,1819,67
2020-05-05,Alpine,3,1148,1,1,0,1,0
2020-05-05,Amador,5,37829,9,8,0,8,0
2020-05-05,Butte,7,227075,23,19,0,19,0
2020-05-05,Calaveras,9,45235,13,13,0,13,0
2020-05-05,Colusa,11,21464,3,3,0,3,0
2020-05-05,Contra Costa,13,1133247,1096,976,0,976,29
2020-05-05,Del Norte,15,27424,6,3,0,3,0
2020-05-05,El Dorado,17,186661,62,54,0,54,0
2020-05-05,Fresno,19,978130,1371,726,13,739,8
2020-05-05,Glenn,21,27897,8,3,0,3,0
2020-05-05,Humboldt,23,135768,63,54,0,54,0
2020-05-05,Imperial,25,180216,801,389,1,390,6
2020-05-05,Inyo,27,18085,19,20,0,20,1
2020-05-05,Kern,29,883053,1413,1084,1,1085,11
2020-05-05,Kings,31,150075,317,187,1,188,1
2020-05-05,Lake,33,64148,10,7,0,7,0
2020-05-05,Lassen,35,31185,1,0,1,1,0
2020-05-05,Los Angeles,37,10098052,34961,27867,21,27888,1289
2020-05-05,Madera,39,155013,101,53,0,53,2
2020-05-05,Marin,41,260295,262,244,1,245,14
2020-05-05,Mariposa,43,17540,15,14,0,14,0
2020-05-05,Mendocino,45,87422,11,10,0,10,0
2020-05-05,Merced,47,269075,220,141,0,141,3
2020-05-05,Modoc,49,8938,0,0,0,0,0
2020-05-05,Mono,51,14174,32,25,0,25,1
2020-05-05,Monterey,53,433212,303,240,0,240,6
2020-05-05,Napa,55,140530,83,74,0,74,2
2020-05-05,Nevada,57,99092,41,41,1,42,1
2020-05-05,Orange,59,3164182,4617,3041,16,3057,63
2020-05-05,Placer,61,380077,180,162,1,163,8
2020-05-05,Plumas,63,18699,4,4,0,4,0
2020-05-05,Riverside,65,2383286,5264,4309,7,4316,161
2020-05-05,Sacramento,67,1510023,1176,1125,0,1125,48
2020-05-05,San Benito,69,59416,54,50,0,50,2
2020-05-05,San Bernardino,71,2135413,3169,2345,1,2346,104
2020-05-05,San Diego,73,3302833,5245,4162,0,4162,150
2020-05-05,San Francisco,75,870044,2017,1779,1,1780,31
2020-05-05,San Joaquin,77,732212,638,577,3,580,26
2020-05-05,San Luis Obispo,79,281455,250,203,1,204,1
2020-05-05,San Mateo,81,765935,1578,1335,2,1337,56
2020-05-05,Santa Barbara,83,443738,1307,541,18,559,7
2020-05-05,Santa Clara,85,1922200,2568,2249,3,2252,124
2020-05-05,Santa Cruz,87,273765,143,134,0,134,2
2020-05-05,Shasta,89,179085,42,31,0,31,4
2020-05-05,Sierra,91,2930,0,0,0,0,0
2020-05-05,Siskiyou,93,43540,5,5,0,5,0
2020-05-05,Solano,95,438530,387,299,0,299,4
2020-05-05,Sonoma,97,501317,327,263,0,263,3
2020-05-05,Stanislaus,99,539301,519,430,4,434,9
2020-05-05,Sutter,101,95872,34,29,0,29,2
2020-05-05,Tehama,103,63373,2,1,0,1,1
2020-05-05,Trinity,105,12862,1,0,0,0,0
2020-05-05,Tulare,107,460477,1350,869,1,870,40
2020-05-05,Tuolumne,109,53932,3,2,0,2,0
2020-05-05,Ventura,111,848112,811,607,0,607,19
2020-05-05,Yolo,113,214977,184,171,0,171,18
2020-05-05,Yuba,115,75493,22,15,0,15,1
2020-05-04,Alameda,1,1643700,2161,1762,0,1762,65
2020-05-04,Alpine,3,1148,1,1,0,1,0
2020-05-04,Amador,5,37829,8,8,0,8,0
2020-05-04,Butte,7,227075,23,16,0,16,0
2020-05-04,Calaveras,9,45235,13,13,0,13,0
2020-05-04,Colusa,11,21464,3,3,0,3,0
2020-05-04,Contra Costa,13,1133247,1078,949,0,949,28
2020-05-04,Del Norte,15,27424,5,3,0,3,0
2020-05-04,El Dorado,17,186661,61,51,0,51,0
2020-05-04,Fresno,19,978130,1306,680,12,692,8
2020-05-04,Glenn,21,27897,8,4,0,4,0
2020-05-04,Humboldt,23,135768,61,54,0,54,0
2020-05-04,Imperial,25,180216,748,351,1,352,6
2020-05-04,Inyo,27,18085,19,20,0,20,1
2020-05-04,Kern,29,883053,1373,1047,1,1048,8
2020-05-04,Kings,31,150075,300,153,1,154,1
2020-05-04,Lake,33,64148,9,7,0,7,0
2020-05-04,Lassen,35,31185,1,0,1,1,0
2020-05-04,Los Angeles,37,10098052,33661,26243,20,26263,1235
2020-05-04,Madera,39,155013,100,52,0,52,2
2020-05-04,Marin,41,260295,258,244,1,245,13
2020-05-04,Mariposa,43,17540,15,13,0,13,0
2020-05-04,Mendocino,45,87422,11,10,0,10,0
2020-05-04,Merced,47,269075,220,138,0,138,3
2020-05-04,Modoc,49,8938,0,0,0,0,0
2020-05-04,Mono,51,14174,32,25,0,25,1
2020-05-04,Monterey,53,433212,292,237,0,237,6
2020-05-04,Napa,55,140530,83,72,0,72,2
2020-05-04,Nevada,57,99092,41,41,1,42,1
2020-05-04,Orange,59,3164182,4481,2931,15,2946,57
2020-05-04,Placer,61,380077,179,162,1,163,8
2020-05-04,Plumas,63,18699,4,4,0,4,0
2020-05-04,Riverside,65,2383286,5171,4221,7,4228,147
2020-05-04,Sacramento,67,1510023,1166,1119,0,1119,44
2020-05-04,San Benito,69,59416,52,49,0,49,2
2020-05-04,San Bernardino,71,2135413,3027,2184,1,2185,99
2020-05-04,San Diego,73,3302833,5104,4022,0,4022,144
2020-05-04,San Francisco,75,870044,1979,1760,1,1761,31
2020-05-04,San Joaquin,77,732212,624,574,3,577,26
2020-05-04,San Luis Obispo,79,281455,247,202,1,203,1
2020-05-04,San Mateo,81,765935,1553,1313,2,1315,53
2020-05-04,Santa Barbara,83,443738,1051,524,18,542,7
2020-05-04,Santa Clara,85,1922200,2554,2238,3,2241,119
2020-05-04,Santa Cruz,87,273765,142,133,0,133,2
2020-05-04,Shasta,89,179085,40,31,0,31,4
2020-05-04,Sierra,91,2930,0,0,0,0,0
2020-05-04,Siskiyou,93,43540,5,5,0,5,0
2020-05-04,Solano,95,438530,373,293,0,293,4
2020-05-04,Sonoma,97,501317,313,256,0,256,4
2020-05-04,Stanislaus,99,539301,513,422,4,426,8
2020-05-04,Sutter,101,95872,31,28,0,28,2
2020-05-04,Tehama,103,63373,2,1,0,1,1
2020-05-04,Trinity,105,12862,0,0,0,0,0
2020-05-04,Tulare,107,460477,1272,760,1,761,40
2020-05-04,Tuolumne,109,53932,3,3,0,3,0
2020-05-04,Ventura,111,848112,791,590,0,590,19
2020-05-04,Yolo,113,214977,183,171,0,171,18
2020-05-04,Yuba,115,75493,19,16,0,16,1
2020-05-03,Alameda,1,1643700,2105,1731,0,1731,64
2020-05-03,Alpine,3,1148,1,1,0,1,0
2020-05-03,Amador,5,37829,8,8,0,8,0
2020-05-03,Butte,7,227075,23,17,0,17,0
2020-05-03,Calaveras,9,45235,13,13,0,13,0
2020-05-03,Colusa,11,21464,3,3,0,3,0
2020-05-03,Contra Costa,13,1133247,1062,945,0,945,28
2020-05-03,Del Norte,15,27424,5,3,0,3,0
2020-05-03,El Dorado,17,186661,59,49,0,49,0
2020-05-03,Fresno,19,978130,1217,646,11,657,8
2020-05-03,Glenn,21,27897,7,5,0,5,0
2020-05-03,Humboldt,23,135768,60,54,0,54,0
2020-05-03,Imperial,25,180216,691,351,1,352,6
2020-05-03,Inyo,27,18085,19,20,0,20,1
2020-05-03,Kern,29,883053,1321,1025,1,1026,8
2020-05-03,Kings,31,150075,280,137,1,138,1
2020-05-03,Lake,33,64148,9,7,0,7,0
2020-05-03,Lassen,35,31185,1,0,1,1,0
2020-05-03,Los Angeles,37,10098052,32679,25708,20,25728,1210
2020-05-03,Madera,39,155013,93,46,0,46,2
2020-05-03,Marin,41,260295,253,243,1,244,13
2020-05-03,Mariposa,43,17540,15,13,0,13,0
2020-05-03,Mendocino,45,87422,11,10,0,10,0
2020-05-03,Merced,47,269075,212,134,0,134,3
2020-05-03,Modoc,49,8938,0,0,0,0,0
2020-05-03,Mono,51,14174,32,25,0,25,1
2020-05-03,Monterey,53,433212,283,235,0,235,6
2020-05-03,Napa,55,140530,83,72,0,72,2
2020-05-03,Nevada,57,99092,41,41,1,42,1
2020-05-03,Orange,59,3164182,4310,2859,14,2873,55
2020-05-03,Placer,61,380077,179,161,1,162,8
2020-05-03,Plumas,63,18699,4,4,0,4,0
2020-05-03,Riverside,65,2383286,5066,4034,7,4041,139
2020-05-03,Sacramento,67,1510023,1157,1109,0,1109,43
2020-05-03,San Benito,69,59416,52,49,0,49,2
2020-05-03,San Bernardino,71,2135413,2966,2123,1,2124,99
2020-05-03,San Diego,73,3302833,4967,3929,0,3929,142
2020-05-03,San Francisco,75,870044,1951,1692,0,1692,30
2020-05-03,San Joaquin,77,732212,617,570,3,573,26
2020-05-03,San Luis Obispo,79,281455,244,200,1,201,1
2020-05-03,San Mateo,81,765935,1525,1277,2,1279,53
2020-05-03,Santa Barbara,83,443738,686,512,17,529,7
2020-05-03,Santa Clara,85,1922200,2527,2235,3,2238,116
2020-05-03,Santa Cruz,87,273765,142,133,0,133,2
2020-05-03,Shasta,89,179085,38,31,0,31,4
2020-05-03,Sierra,91,2930,0,0,0,0,0
2020-05-03,Siskiyou,93,43540,5,5,0,5,0
2020-05-03,Solano,95,438530,363,266,0,266,4
2020-05-03,Sonoma,97,501317,304,254,0,254,4
2020-05-03,Stanislaus,99,539301,485,411,4,415,8
2020-05-03,Sutter,101,95872,30,28,0,28,2
2020-05-03,Tehama,103,63373,2,1,0,1,1
2020-05-03,Trinity,105,12862,0,0,0,0,0
2020-05-03,Tulare,107,460477,1194,736,1,737,40
2020-05-03,Tuolumne,109,53932,3,3,0,3,0
2020-05-03,Ventura,111,848112,760,583,0,583,19
2020-05-03,Yolo,113,214977,182,171,0,171,18
2020-05-03,Yuba,115,75493,19,16,0,16,1
2020-05-02,Alameda,1,1643700,2068,1678,0,1678,63
2020-05-02,Alpine,3,1148,1,1,0,1,0
2020-05-02,Amador,5,37829,8,8,0,8,0
2020-05-02,Butte,7,227075,23,17,0,17,0
2020-05-02,Calaveras,9,45235,13,13,0,13,0
2020-05-02,Colusa,11,21464,3,3,0,3,0
2020-05-02,Contra Costa,13,1133247,1045,929,0,929,28
2020-05-02,Del Norte,15,27424,5,3,0,3,0
2020-05-02,El Dorado,17,186661,59,47,0,47,0
2020-05-02,Fresno,19,978130,1199,629,10,639,8
2020-05-02,Glenn,21,27897,7,5,0,5,0
2020-05-02,Humboldt,23,135768,60,54,0,54,0
2020-05-02,Imperial,25,180216,664,345,1,346,6
2020-05-02,Inyo,27,18085,19,20,0,20,1
2020-05-02,Kern,29,883053,1295,1007,1,1008,8
2020-05-02,Kings,31,150075,277,120,1,121,1
2020-05-02,Lake,33,64148,9,7,0,7,0
2020-05-02,Lassen,35,31185,1,0,1,1,0
2020-05-02,Los Angeles,37,10098052,32149,24955,20,24975,1192
2020-05-02,Madera,39,155013,93,46,0,46,2
2020-05-02,Marin,41,260295,252,243,1,244,13
2020-05-02,Mariposa,43,17540,15,13,0,13,0
2020-05-02,Mendocino,45,87422,11,10,0,10,0
2020-05-02,Merced,47,269075,209,131,0,131,3
2020-05-02,Modoc,49,8938,0,0,0,0,0
2020-05-02,Mono,51,14174,32,25,0,25,1
2020-05-02,Monterey,53,433212,277,225,0,225,5
2020-05-02,Napa,55,140530,83,71,0,71,2
2020-05-02,Nevada,57,99092,41,41,1,42,1
2020-05-02,Orange,59,3164182,4196,2774,14,2788,52
2020-05-02,Placer,61,380077,177,150,1,151,8
2020-05-02,Plumas,63,18699,4,4,0,4,0
2020-05-02,Riverside,65,2383286,5000,3997,7,4004,137
2020-05-02,Sacramento,67,1510023,1154,1097,0,1097,43
2020-05-02,San Benito,69,59416,52,49,0,49,2
2020-05-02,San Bernardino,71,2135413,2927,2124,1,2125,99
2020-05-02,San Diego,73,3302833,4865,3844,0,3844,138
2020-05-02,San Francisco,75,870044,1928,1632,0,1632,29
2020-05-02,San Joaquin,77,732212,609,559,3,562,25
2020-05-02,San Luis Obispo,79,281455,238,193,1,194,1
2020-05-02,San Mateo,81,765935,1509,1272,2,1274,52
2020-05-02,Santa Barbara,83,443738,674,506,17,523,7
2020-05-02,Santa Clara,85,1922200,2517,2203,3,2206,115
2020-05-02,Santa Cruz,87,273765,141,131,0,131,2
2020-05-02,Shasta,89,179085,38,31,0,31,4
2020-05-02,Sierra,91,2930,0,0,0,0,0
2020-05-02,Siskiyou,93,43540,5,5,0,5,0
2020-05-02,Solano,95,438530,356,267,0,267,4
2020-05-02,Sonoma,97,501317,301,250,0,250,3
2020-05-02,Stanislaus,99,539301,477,388,4,392,8
2020-05-02,Sutter,101,95872,30,28,0,28,2
2020-05-02,Tehama,103,63373,2,1,0,1,1
2020-05-02,Trinity,105,12862,0,0,0,0,0
2020-05-02,Tulare,107,460477,1154,711,1,712,35
2020-05-02,Tuolumne,109,53932,3,3,0,3,0
2020-05-02,Ventura,111,848112,746,564,0,564,19
2020-05-02,Yolo,113,214977,182,169,0,169,17
2020-05-02,Yuba,115,75493,19,16,0,16,1
2020-05-01,Alameda,1,1643700,2032,1630,0,1630,63
2020-05-01,Alpine,3,1148,1,1,0,1,0
2020-05-01,Amador,5,37829,8,8,0,8,0
2020-05-01,Butte,7,227075,23,17,0,17,0
2020-05-01,Calaveras,9,45235,13,13,0,13,0
2020-05-01,Colusa,11,21464,3,3,0,3,0
2020-05-01,Contra Costa,13,1133247,1031,915,0,915,28
2020-05-01,Del Norte,15,27424,5,3,0,3,0
2020-05-01,El Dorado,17,186661,59,47,0,47,0
2020-05-01,Fresno,19,978130,1171,617,10,627,7
2020-05-01,Glenn,21,27897,7,4,0,4,0
2020-05-01,Humboldt,23,135768,60,54,0,54,0
2020-05-01,Imperial,25,180216,627,337,1,338,6
2020-05-01,Inyo,27,18085,19,20,0,20,1
2020-05-01,Kern,29,883053,1268,972,1,973,8
2020-05-01,Kings,31,150075,260,112,1,113,1
2020-05-01,Lake,33,64148,9,6,0,6,0
2020-05-01,Lassen,35,31185,1,0,1,1,0
2020-05-01,Los Angeles,37,10098052,31395,24306,20,24326,1155
2020-05-01,Madera,39,155013,89,46,0,46,2
2020-05-01,Marin,41,260295,252,242,1,243,13
2020-05-01,Mariposa,43,17540,15,10,0,10,0
2020-05-01,Mendocino,45,87422,11,11,0,11,0
2020-05-01,Merced,47,269075,206,131,0,131,3
2020-05-01,Modoc,49,8938,0,0,0,0,0
2020-05-01,Mono,51,14174,32,25,0,25,1
2020-05-01,Monterey,53,433212,273,222,0,222,5
2020-05-01,Napa,55,140530,83,69,0,69,2
2020-05-01,Nevada,57,99092,41,41,1,42,1
2020-05-01,Orange,59,3164182,4118,2660,13,2673,51
2020-05-01,Placer,61,380077,176,149,1,150,8
2020-05-01,Plumas,63,18699,4,4,0,4,0
2020-05-01,Riverside,65,2383286,4937,3893,7,3900,132
2020-05-01,Sacramento,67,1510023,1149,1081,0,1081,43
2020-05-01,San Benito,69,59416,52,49,0,49,2
2020-05-01,San Bernardino,71,2135413,2872,2084,1,2085,98
2020-05-01,San Diego,73,3302833,4775,3713,0,3713,134
2020-05-01,San Francisco,75,870044,1884,1552,0,1552,29
2020-05-01,San Joaquin,77,732212,605,554,3,557,25
2020-05-01,San Luis Obispo,79,281455,235,186,1,187,1
2020-05-01,San Mateo,81,765935,1487,1222,2,1224,52
2020-05-01,Santa Barbara,83,443738,666,499,13,512,7
2020-05-01,Santa Clara,85,1922200,2507,2176,3,2179,112
2020-05-01,Santa Cruz,87,273765,141,127,0,127,2
2020-05-01,Shasta,89,179085,38,31,0,31,4
2020-05-01,Sierra,91,2930,0,0,0,0,0
2020-05-01,Siskiyou,93,43540,5,5,0,5,0
2020-05-01,Solano,95,438530,348,266,0,266,4
2020-05-01,Sonoma,97,501317,298,242,0,242,3
2020-05-01,Stanislaus,99,539301,472,384,4,388,8
2020-05-01,Sutter,101,95872,30,28,0,28,2
2020-05-01,Tehama,103,63373,2,1,0,1,1
2020-05-01,Trinity,105,12862,0,0,0,0,0
2020-05-01,Tulare,107,460477,1110,685,1,686,32
2020-05-01,Tuolumne,109,53932,3,3,0,3,0
2020-05-01,Ventura,111,848112,733,556,0,556,18
2020-05-01,Yolo,113,214977,182,165,0,165,18
2020-05-01,Yuba,115,75493,19,16,0,16,1
2020-04-30,Alameda,1,1643700,1972,1599,0,1599,60
2020-04-30,Alpine,3,1148,1,1,0,1,0
2020-04-30,Amador,5,37829,8,8,0,8,0
2020-04-30,Butte,7,227075,23,16,0,16,0
2020-04-30,Calaveras,9,45235,13,13,0,13,0
2020-04-30,Colusa,11,21464,3,3,0,3,0
2020-04-30,Contra Costa,13,1133247,1009,900,0,900,25
2020-04-30,Del Norte,15,27424,4,3,0,3,0
2020-04-30,El Dorado,17,186661,59,44,0,44,0
2020-04-30,Fresno,19,978130,1109,562,7,569,7
2020-04-30,Glenn,21,27897,7,4,0,4,0
2020-04-30,Humboldt,23,135768,60,54,0,54,0
2020-04-30,Imperial,25,180216,580,322,1,323,6
2020-04-30,Inyo,27,18085,19,20,0,20,1
2020-04-30,Kern,29,883053,1237,941,1,942,8
2020-04-30,Kings,31,150075,248,87,1,88,1
2020-04-30,Lake,33,64148,9,6,0,6,0
2020-04-30,Lassen,35,31185,1,0,1,1,0
2020-04-30,Los Angeles,37,10098052,30388,23284,20,23304,1099
2020-04-30,Madera,39,155013,78,46,0,46,2
2020-04-30,Marin,41,260295,252,240,1,241,13
2020-04-30,Mariposa,43,17540,15,3,0,3,0
2020-04-30,Mendocino,45,87422,11,11,0,11,0
2020-04-30,Merced,47,269075,199,122,0,122,3
2020-04-30,Modoc,49,8938,0,0,0,0,0
2020-04-30,Mono,51,14174,31,25,0,25,1
2020-04-30,Monterey,53,433212,263,213,0,213,5
2020-04-30,Napa,55,140530,81,69,0,69,2
2020-04-30,Nevada,57,99092,41,41,1,42,1
2020-04-30,Orange,59,3164182,3904,2591,12,2603,46
2020-04-30,Placer,61,380077,175,148,1,149,8
2020-04-30,Plumas,63,18699,4,4,0,4,0
2020-04-30,Riverside,65,2383286,4837,3820,6,3826,124
2020-04-30,Sacramento,67,1510023,1143,1071,0,1071,43
2020-04-30,San Benito,69,59416,52,48,0,48,2
2020-04-30,San Bernardino,71,2135413,2671,2020,1,2021,96
2020-04-30,San Diego,73,3302833,4604,3566,0,3566,124
2020-04-30,San Francisco,75,870044,1850,1518,0,1518,26
2020-04-30,San Joaquin,77,732212,598,548,3,551,25
2020-04-30,San Luis Obispo,79,281455,232,182,1,183,1
2020-04-30,San Mateo,81,765935,1457,1194,2,1196,52
2020-04-30,Santa Barbara,83,443738,649,490,2,492,7
2020-04-30,Santa Clara,85,1922200,2472,2172,3,2175,111
2020-04-30,Santa Cruz,87,273765,140,126,0,126,2
2020-04-30,Shasta,89,179085,37,31,0,31,4
2020-04-30,Sierra,91,2930,0,0,0,0,0
2020-04-30,Siskiyou,93,43540,5,5,0,5,0
2020-04-30,Solano,95,438530,338,262,0,262,4
2020-04-30,Sonoma,97,501317,289,233,0,233,3
2020-04-30,Stanislaus,99,539301,465,378,4,382,7
2020-04-30,Sutter,101,95872,30,28,0,28,2
2020-04-30,Tehama,103,63373,1,1,0,1,1
2020-04-30,Trinity,105,12862,0,0,0,0,0
2020-04-30,Tulare,107,460477,1046,637,1,638,31
2020-04-30,Tuolumne,109,53932,3,3,0,3,0
2020-04-30,Ventura,111,848112,705,547,0,547,18
2020-04-30,Yolo,113,214977,181,164,0,164,16
2020-04-30,Yuba,115,75493,19,15,0,15,1
2020-04-29,Alameda,1,1643700,1914,1564,0,1564,60
2020-04-29,Alpine,3,1148,1,1,0,1,0
2020-04-29,Amador,5,37829,8,8,0,8,0
2020-04-29,Butte,7,227075,23,16,0,16,0
2020-04-29,Calaveras,9,45235,13,13,0,13,0
2020-04-29,Colusa,11,21464,3,3,0,3,0
2020-04-29,Contra Costa,13,1133247,990,885,0,885,25
2020-04-29,Del Norte,15,27424,4,3,0,3,0
2020-04-29,El Dorado,17,186661,57,44,0,44,0
2020-04-29,Fresno,19,978130,1057,544,7,551,7
2020-04-29,Glenn,21,27897,7,4,0,4,0
2020-04-29,Humboldt,23,135768,60,53,0,53,0
2020-04-29,Imperial,25,180216,551,300,1,301,6
2020-04-29,Inyo,27,18085,19,20,0,20,1
2020-04-29,Kern,29,883053,1194,910,1,911,6
2020-04-29,Kings,31,150075,229,80,1,81,1
2020-04-29,Lake,33,64148,9,6,0,6,0
2020-04-29,Lassen,35,31185,1,0,1,1,0
2020-04-29,Los Angeles,37,10098052,29413,22560,20,22580,1043
2020-04-29,Madera,39,155013,77,45,0,45,2
2020-04-29,Marin,41,260295,249,234,1,235,13
2020-04-29,Mariposa,43,17540,15,1,0,1,0
2020-04-29,Mendocino,45,87422,11,11,0,11,0
2020-04-29,Merced,47,269075,192,116,0,116,3
2020-04-29,Modoc,49,8938,0,0,0,0,0
2020-04-29,Mono,51,14174,31,25,0,25,1
2020-04-29,Monterey,53,433212,255,204,0,204,5
2020-04-29,Napa,55,140530,79,68,0,68,2
2020-04-29,Nevada,57,99092,41,41,1,42,1
2020-04-29,Orange,59,3164182,3774,2421,11,2432,43
2020-04-29,Placer,61,380077,173,145,1,146,8
2020-04-29,Plumas,63,18699,4,4,0,4,0
2020-04-29,Riverside,65,2383286,4761,3700,6,3706,116
2020-04-29,Sacramento,67,1510023,1121,1055,0,1055,41
2020-04-29,San Benito,69,59416,52,48,0,48,2
2020-04-29,San Bernardino,71,2135413,2584,1975,0,1975,91
2020-04-29,San Diego,73,3302833,4463,3434,0,3434,120
2020-04-29,San Francisco,75,870044,1821,1489,0,1489,23
2020-04-29,San Joaquin,77,732212,590,540,3,543,25
2020-04-29,San Luis Obispo,79,281455,230,181,1,182,1
2020-04-29,San Mateo,81,765935,1431,1170,2,1172,50
2020-04-29,Santa Barbara,83,443738,635,477,2,479,7
2020-04-29,Santa Clara,85,1922200,2454,2147,3,2150,108
2020-04-29,Santa Cruz,87,273765,139,124,0,124,2
2020-04-29,Shasta,89,179085,37,31,0,31,4
2020-04-29,Sierra,91,2930,0,0,0,0,0
2020-04-29,Siskiyou,93,43540,5,5,0,5,0
2020-04-29,Solano,95,438530,315,252,0,252,3
2020-04-29,Sonoma,97,501317,281,230,0,230,2
2020-04-29,Stanislaus,99,539301,452,374,4,378,5
2020-04-29,Sutter,101,95872,30,28,0,28,2
2020-04-29,Tehama,103,63373,1,1,0,1,1
2020-04-29,Trinity,105,12862,0,0,0,0,0
2020-04-29,Tulare,107,460477,976,615,1,616,30
2020-04-29,Tuolumne,109,53932,3,4,0,4,0
2020-04-29,Ventura,111,848112,682,530,0,530,18
2020-04-29,Yolo,113,214977,178,161,0,161,11
2020-04-29,Yuba,115,75493,19,15,0,15,1
2020-04-28,Alameda,1,1643700,1857,1525,0,1525,55
2020-04-28,Alpine,3,1148,1,1,0,1,0
2020-04-28,Amador,5,37829,8,8,0,8,0
2020-04-28,Butte,7,227075,23,16,0,16,0
2020-04-28,Calaveras,9,45235,13,13,0,13,0
2020-04-28,Colusa,11,21464,3,3,0,3,0
2020-04-28,Contra Costa,13,1133247,983,866,0,866,25
2020-04-28,Del Norte,15,27424,4,3,0,3,0
2020-04-28,El Dorado,17,186661,56,43,0,43,0
2020-04-28,Fresno,19,978130,1008,525,6,531,7
2020-04-28,Glenn,21,27897,5,4,0,4,0
2020-04-28,Humboldt,23,135768,59,53,0,53,0
2020-04-28,Imperial,25,180216,517,295,1,296,6
2020-04-28,Inyo,27,18085,19,20,0,20,1
2020-04-28,Kern,29,883053,1152,882,1,883,5
2020-04-28,Kings,31,150075,216,57,1,58,1
2020-04-28,Lake,33,64148,9,6,0,6,0
2020-04-28,Lassen,35,31185,1,0,1,1,0
2020-04-28,Los Angeles,37,10098052,28352,21029,20,21049,984
2020-04-28,Madera,39,155013,77,44,0,44,2
2020-04-28,Marin,41,260295,248,228,1,229,12
2020-04-28,Mariposa,43,17540,15,0,0,0,0
2020-04-28,Mendocino,45,87422,11,10,0,10,0
2020-04-28,Merced,47,269075,185,108,0,108,3
2020-04-28,Modoc,49,8938,0,0,0,0,0
2020-04-28,Mono,51,14174,31,25,0,25,1
2020-04-28,Monterey,53,433212,249,191,0,191,5
2020-04-28,Napa,55,140530,78,67,0,67,2
2020-04-28,Nevada,57,99092,41,41,1,42,1
2020-04-28,Orange,59,3164182,3611,2324,10,2334,42
2020-04-28,Placer,61,380077,163,143,1,144,8
2020-04-28,Plumas,63,18699,4,4,0,4,0
2020-04-28,Riverside,65,2383286,4666,3504,6,3510,113
2020-04-28,Sacramento,67,1510023,1107,1044,0,1044,41
2020-04-28,San Benito,69,59416,51,46,0,46,2
2020-04-28,San Bernardino,71,2135413,2507,1891,0,1891,89
2020-04-28,San Diego,73,3302833,4333,3316,0,3316,118
2020-04-28,San Francisco,75,870044,1786,1471,0,1471,23
2020-04-28,San Joaquin,77,732212,584,532,3,535,25
2020-04-28,San Luis Obispo,79,281455,224,172,1,173,1
2020-04-28,San Mateo,81,765935,1418,1129,2,1131,48
2020-04-28,Santa Barbara,83,443738,629,469,2,471,7
2020-04-28,Santa Clara,85,1922200,2424,2130,3,2133,106
2020-04-28,Santa Cruz,87,273765,139,123,0,123,2
2020-04-28,Shasta,89,179085,37,29,0,29,4
2020-04-28,Sierra,91,2930,0,0,0,0,0
2020-04-28,Siskiyou,93,43540,5,5,0,5,0
2020-04-28,Solano,95,438530,296,246,0,246,3
2020-04-28,Sonoma,97,501317,278,226,0,226,1
2020-04-28,Stanislaus,99,539301,436,330,4,334,5
2020-04-28,Sutter,101,95872,30,25,0,25,2
2020-04-28,Tehama,103,63373,1,1,0,1,1
2020-04-28,Trinity,105,12862,0,0,0,0,0
2020-04-28,Tulare,107,460477,882,579,1,580,30
2020-04-28,Tuolumne,109,53932,3,4,0,4,0
2020-04-28,Ventura,111,848112,665,517,0,517,17
2020-04-28,Yolo,113,214977,178,160,0,160,10
2020-04-28,Yuba,115,75493,19,15,0,15,1
2020-04-27,Alameda,1,1643700,1797,1494,0,1494,53
2020-04-27,Alpine,3,1148,1,1,0,1,0
2020-04-27,Amador,5,37829,8,8,0,8,0
2020-04-27,Butte,7,227075,22,16,0,16,0
2020-04-27,Calaveras,9,45235,13,13,0,13,0
2020-04-27,Colusa,11,21464,3,3,0,3,0
2020-04-27,Contra Costa,13,1133247,971,843,0,843,25
2020-04-27,Del Norte,15,27424,4,3,0,3,0
2020-04-27,El Dorado,17,186661,55,43,0,43,0
2020-04-27,Fresno,19,978130,905,504,5,509,7
2020-04-27,Glenn,21,27897,5,4,0,4,0
2020-04-27,Humboldt,23,135768,59,52,0,52,0
2020-04-27,Imperial,25,180216,487,290,1,291,6
2020-04-27,Inyo,27,18085,19,20,0,20,1
2020-04-27,Kern,29,883053,1114,865,1,866,4
2020-04-27,Kings,31,150075,193,48,1,49,1
2020-04-27,Lake,33,64148,8,6,0,6,0
2020-04-27,Lassen,35,31185,1,0,1,1,0
2020-04-27,Los Angeles,37,10098052,27339,20456,20,20476,931
2020-04-27,Madera,39,155013,75,42,0,42,2
2020-04-27,Marin,41,260295,243,227,1,228,12
2020-04-27,Mariposa,43,17540,14,0,0,0,0
2020-04-27,Mendocino,45,87422,11,10,0,10,0
2020-04-27,Merced,47,269075,182,108,0,108,3
2020-04-27,Modoc,49,8938,0,0,0,0,0
2020-04-27,Mono,51,14174,31,23,0,23,1
2020-04-27,Monterey,53,433212,242,185,0,185,4
2020-04-27,Napa,55,140530,75,64,0,64,2
2020-04-27,Nevada,57,99092,41,39,1,40,1
2020-04-27,Orange,59,3164182,3443,2198,10,2208,42
2020-04-27,Placer,61,380077,163,142,1,143,8
2020-04-27,Plumas,63,18699,4,4,0,4,0
2020-04-27,Riverside,65,2383286,4543,3381,6,3387,100
2020-04-27,Sacramento,67,1510023,1092,1035,0,1035,41
2020-04-27,San Benito,69,59416,49,45,0,45,2
2020-04-27,San Bernardino,71,2135413,2393,1742,0,1742,82
2020-04-27,San Diego,73,3302833,4207,3143,0,3143,113
2020-04-27,San Francisco,75,870044,1732,1453,0,1453,23
2020-04-27,San Joaquin,77,732212,578,522,3,525,25
2020-04-27,San Luis Obispo,79,281455,217,166,1,167,1
2020-04-27,San Mateo,81,765935,1396,1092,2,1094,46
2020-04-27,Santa Barbara,83,443738,616,466,2,468,7
2020-04-27,Santa Clara,85,1922200,2404,2104,2,2106,105
2020-04-27,Santa Cruz,87,273765,139,123,0,123,2
2020-04-27,Shasta,89,179085,37,29,0,29,4
2020-04-27,Sierra,91,2930,0,0,0,0,0
2020-04-27,Siskiyou,93,43540,5,5,0,5,0
2020-04-27,Solano,95,438530,296,222,0,222,3
2020-04-27,Sonoma,97,501317,269,220,0,220,1
2020-04-27,Stanislaus,99,539301,420,316,4,320,5
2020-04-27,Sutter,101,95872,29,26,0,26,2
2020-04-27,Tehama,103,63373,1,1,0,1,1
2020-04-27,Trinity,105,12862,0,0,0,0,0
2020-04-27,Tulare,107,460477,811,535,1,536,28
2020-04-27,Tuolumne,109,53932,3,3,0,3,0
2020-04-27,Ventura,111,848112,648,513,0,513,17
2020-04-27,Yolo,113,214977,175,160,0,160,9
2020-04-27,Yuba,115,75493,19,15,0,15,1
2020-04-26,Alameda,1,1643700,1736,1449,0,1449,52
2020-04-26,Alpine,3,1148,1,1,0,1,0
2020-04-26,Amador,5,37829,8,8,0,8,0
2020-04-26,Butte,7,227075,22,16,0,16,0
2020-04-26,Calaveras,9,45235,13,13,0,13,0
2020-04-26,Colusa,11,21464,3,3,0,3,0
2020-04-26,Contra Costa,13,1133247,955,830,0,830,25
2020-04-26,Del Norte,15,27424,3,3,0,3,0
2020-04-26,El Dorado,17,186661,53,41,0,41,0
2020-04-26,Fresno,19,978130,815,476,5,481,7
2020-04-26,Glenn,21,27897,5,4,0,4,0
2020-04-26,Humboldt,23,135768,59,53,0,53,0
2020-04-26,Imperial,25,180216,453,272,1,273,6
2020-04-26,Inyo,27,18085,19,20,0,20,1
2020-04-26,Kern,29,883053,1064,831,1,832,4
2020-04-26,Kings,31,150075,168,33,1,34,1
2020-04-26,Lake,33,64148,8,6,0,6,0
2020-04-26,Lassen,35,31185,1,0,1,1,0
2020-04-26,Los Angeles,37,10098052,26192,19570,20,19590,901
2020-04-26,Madera,39,155013,74,39,0,39,2
2020-04-26,Marin,41,260295,237,225,1,226,12
2020-04-26,Mariposa,43,17540,14,0,0,0,0
2020-04-26,Mendocino,45,87422,11,5,0,5,0
2020-04-26,Merced,47,269075,166,104,0,104,3
2020-04-26,Modoc,49,8938,0,0,0,0,0
2020-04-26,Mono,51,14174,31,23,0,23,1
2020-04-26,Monterey,53,433212,235,182,0,182,4
2020-04-26,Napa,55,140530,74,62,0,62,2
2020-04-26,Nevada,57,99092,41,37,1,38,1
2020-04-26,Orange,59,3164182,3278,2124,10,2134,40
2020-04-26,Placer,61,380077,163,141,1,142,8
2020-04-26,Plumas,63,18699,4,4,0,4,0
2020-04-26,Riverside,65,2383286,4402,3301,6,3307,95
2020-04-26,Sacramento,67,1510023,1083,1027,0,1027,41
2020-04-26,San Benito,69,59416,49,45,0,45,2
2020-04-26,San Bernardino,71,2135413,2296,1681,0,1681,82
2020-04-26,San Diego,73,3302833,4065,3045,0,3045,111
2020-04-26,San Francisco,75,870044,1693,1403,0,1403,23
2020-04-26,San Joaquin,77,732212,570,514,3,517,25
2020-04-26,San Luis Obispo,79,281455,214,165,1,166,1
2020-04-26,San Mateo,81,765935,1370,1070,2,1072,46
2020-04-26,Santa Barbara,83,443738,604,464,2,466,7
2020-04-26,Santa Clara,85,1922200,2385,2097,1,2098,102
2020-04-26,Santa Cruz,87,273765,139,116,0,116,2
2020-04-26,Shasta,89,179085,34,29,0,29,4
2020-04-26,Sierra,91,2930,0,0,0,0,0
2020-04-26,Siskiyou,93,43540,5,5,0,5,0
2020-04-26,Solano,95,438530,287,205,0,205,3
2020-04-26,Sonoma,97,501317,258,216,0,216,1
2020-04-26,Stanislaus,99,539301,405,294,4,298,4
2020-04-26,Sutter,101,95872,29,26,0,26,2
2020-04-26,Tehama,103,63373,1,1,0,1,1
2020-04-26,Trinity,105,12862,0,0,0,0,0
2020-04-26,Tulare,107,460477,754,497,1,498,28
2020-04-26,Tuolumne,109,53932,3,3,0,3,0
2020-04-26,Ventura,111,848112,633,509,0,509,17
2020-04-26,Yolo,113,214977,174,158,0,158,8
2020-04-26,Yuba,115,75493,18,15,0,15,1
2020-04-25,Alameda,1,1643700,1711,1396,0,1396,52
2020-04-25,Alpine,3,1148,1,1,0,1,0
2020-04-25,Amador,5,37829,8,8,0,8,0
2020-04-25,Butte,7,227075,21,16,0,16,0
2020-04-25,Calaveras,9,45235,13,12,0,12,0
2020-04-25,Colusa,11,21464,3,3,0,3,0
2020-04-25,Contra Costa,13,1133247,941,821,0,821,24
2020-04-25,Del Norte,15,27424,2,2,0,2,0
2020-04-25,El Dorado,17,186661,52,41,0,41,0
2020-04-25,Fresno,19,978130,785,459,4,463,7
2020-04-25,Glenn,21,27897,5,4,0,4,0
2020-04-25,Humboldt,23,135768,59,53,0,53,0
2020-04-25,Imperial,25,180216,436,232,1,233,6
2020-04-25,Inyo,27,18085,19,20,0,20,1
2020-04-25,Kern,29,883053,1033,802,1,803,4
2020-04-25,Kings,31,150075,156,33,1,34,1
2020-04-25,Lake,33,64148,6,6,0,6,0
2020-04-25,Lassen,35,31185,1,0,1,1,0
2020-04-25,Los Angeles,37,10098052,25558,19144,20,19164,881
2020-04-25,Madera,39,155013,71,39,0,39,2
2020-04-25,Marin,41,260295,237,215,1,216,12
2020-04-25,Mariposa,43,17540,14,0,0,0,0
2020-04-25,Mendocino,45,87422,10,5,0,5,0
2020-04-25,Merced,47,269075,166,103,0,103,3
2020-04-25,Modoc,49,8938,0,0,0,0,0
2020-04-25,Mono,51,14174,31,23,0,23,1
2020-04-25,Monterey,53,433212,233,173,0,173,4
2020-04-25,Napa,55,140530,74,60,0,60,2
2020-04-25,Nevada,57,99092,41,37,1,38,1
2020-04-25,Orange,59,3164182,3172,2047,10,2057,40
2020-04-25,Placer,61,380077,163,137,1,138,8
2020-04-25,Plumas,63,18699,4,4,0,4,0
2020-04-25,Riverside,65,2383286,4314,3037,6,3043,93
2020-04-25,Sacramento,67,1510023,1081,1015,0,1015,41
2020-04-25,San Benito,69,59416,49,45,0,45,2
2020-04-25,San Bernardino,71,2135413,2251,1675,0,1675,82
2020-04-25,San Diego,73,3302833,3965,2945,0,2945,111
2020-04-25,San Francisco,75,870044,1668,1341,0,1341,22
2020-04-25,San Joaquin,77,732212,563,497,3,500,24
2020-04-25,San Luis Obispo,79,281455,213,159,1,160,1
2020-04-25,San Mateo,81,765935,1352,1054,2,1056,46
2020-04-25,Santa Barbara,83,443738,596,457,2,459,7
2020-04-25,Santa Clara,85,1922200,2369,2045,1,2046,99
2020-04-25,Santa Cruz,87,273765,139,112,0,112,2
2020-04-25,Shasta,89,179085,34,29,0,29,4
2020-04-25,Sierra,91,2930,0,0,0,0,0
2020-04-25,Siskiyou,93,43540,5,5,0,5,0
2020-04-25,Solano,95,438530,283,203,0,203,3
2020-04-25,Sonoma,97,501317,254,199,0,199,1
2020-04-25,Stanislaus,99,539301,397,276,4,280,4
2020-04-25,Sutter,101,95872,29,24,0,24,2
2020-04-25,Tehama,103,63373,1,1,0,1,1
2020-04-25,Trinity,105,12862,0,0,0,0,0
2020-04-25,Tulare,107,460477,721,478,1,479,28
2020-04-25,Tuolumne,109,53932,3,2,0,2,0
2020-04-25,Ventura,111,848112,619,494,0,494,16
2020-04-25,Yolo,113,214977,174,157,0,157,8
2020-04-25,Yuba,115,75493,17,15,0,15,1
2020-04-24,Alameda,1,1643700,1680,1385,0,1385,50
2020-04-24,Alpine,3,1148,1,1,0,1,0
2020-04-24,Amador,5,37829,8,8,0,8,0
2020-04-24,Butte,7,227075,21,15,0,15,0
2020-04-24,Calaveras,9,45235,13,12,0,12,0
2020-04-24,Colusa,11,21464,3,3,0,3,0
2020-04-24,Contra Costa,13,1133247,932,806,0,806,23
2020-04-24,Del Norte,15,27424,2,2,0,2,0
2020-04-24,El Dorado,17,186661,51,41,0,41,0
2020-04-24,Fresno,19,978130,766,449,4,453,7
2020-04-24,Glenn,21,27897,5,4,0,4,0
2020-04-24,Humboldt,23,135768,59,53,0,53,0
2020-04-24,Imperial,25,180216,420,232,1,233,6
2020-04-24,Inyo,27,18085,19,20,0,20,0
2020-04-24,Kern,29,883053,1009,770,1,771,4
2020-04-24,Kings,31,150075,127,30,1,31,1
2020-04-24,Lake,33,64148,6,6,0,6,0
2020-04-24,Lassen,35,31185,1,0,1,1,0
2020-04-24,Los Angeles,37,10098052,24626,18553,20,18573,836
2020-04-24,Madera,39,155013,71,39,0,39,2
2020-04-24,Marin,41,260295,237,211,1,212,11
2020-04-24,Mariposa,43,17540,8,0,0,0,0
2020-04-24,Mendocino,45,87422,10,5,0,5,0
2020-04-24,Merced,47,269075,163,102,0,102,3
2020-04-24,Modoc,49,8938,0,0,0,0,0
2020-04-24,Mono,51,14174,30,23,0,23,1
2020-04-24,Monterey,53,433212,226,167,0,167,4
2020-04-24,Napa,55,140530,73,59,0,59,2
2020-04-24,Nevada,57,99092,41,36,1,37,1
2020-04-24,Orange,59,3164182,3064,1945,10,1955,39
2020-04-24,Placer,61,380077,161,137,1,138,8
2020-04-24,Plumas,63,18699,4,4,0,4,0
2020-04-24,Riverside,65,2383286,4233,3044,6,3050,87
2020-04-24,Sacramento,67,1510023,1075,1009,0,1009,41
2020-04-24,San Benito,69,59416,49,45,0,45,2
2020-04-24,San Bernardino,71,2135413,2216,1667,0,1667,80
2020-04-24,San Diego,73,3302833,3854,2828,0,2828,102
2020-04-24,San Francisco,75,870044,1610,1345,0,1345,22
2020-04-24,San Joaquin,77,732212,556,484,3,487,24
2020-04-24,San Luis Obispo,79,281455,210,151,1,152,1
2020-04-24,San Mateo,81,765935,1329,1004,2,1006,43
2020-04-24,Santa Barbara,83,443738,589,450,2,452,6
2020-04-24,Santa Clara,85,1922200,2343,2026,1,2027,98
2020-04-24,Santa Cruz,87,273765,135,111,0,111,2
2020-04-24,Shasta,89,179085,34,28,0,28,4
2020-04-24,Sierra,91,2930,0,0,0,0,0
2020-04-24,Siskiyou,93,43540,5,5,0,5,0
2020-04-24,Solano,95,438530,281,203,0,203,3
2020-04-24,Sonoma,97,501317,250,199,0,199,1
2020-04-24,Stanislaus,99,539301,394,273,4,277,4
2020-04-24,Sutter,101,95872,28,24,0,24,2
2020-04-24,Tehama,103,63373,1,1,0,1,1
2020-04-24,Trinity,105,12862,0,0,0,0,0
2020-04-24,Tulare,107,460477,693,459,1,460,27
2020-04-24,Tuolumne,109,53932,3,2,0,2,0
2020-04-24,Ventura,111,848112,610,489,0,489,16
2020-04-24,Yolo,113,214977,173,155,0,155,8
2020-04-24,Yuba,115,75493,16,15,0,15,1
2020-04-23,Alameda,1,1643700,1642,1336,0,1336,46
2020-04-23,Alpine,3,1148,1,1,0,1,0
2020-04-23,Amador,5,37829,8,8,0,8,0
2020-04-23,Butte,7,227075,20,15,0,15,0
2020-04-23,Calaveras,9,45235,13,12,0,12,0
2020-04-23,Colusa,11,21464,3,3,0,3,0
2020-04-23,Contra Costa,13,1133247,911,786,0,786,23
2020-04-23,Del Norte,15,27424,2,2,0,2,0
2020-04-23,El Dorado,17,186661,50,39,0,39,0
2020-04-23,Fresno,19,978130,729,426,4,430,7
2020-04-23,Glenn,21,27897,5,3,0,3,0
2020-04-23,Humboldt,23,135768,59,53,0,53,0
2020-04-23,Imperial,25,180216,400,181,1,182,4
2020-04-23,Inyo,27,18085,19,19,0,19,0
2020-04-23,Kern,29,883053,961,732,1,733,4
2020-04-23,Kings,31,150075,112,28,1,29,1
2020-04-23,Lake,33,64148,6,6,0,6,0
2020-04-23,Lassen,35,31185,1,0,1,1,0
2020-04-23,Los Angeles,37,10098052,23567,17548,19,17567,784
2020-04-23,Madera,39,155013,70,37,0,37,2
2020-04-23,Marin,41,260295,224,209,1,210,11
2020-04-23,Mariposa,43,17540,7,0,0,0,0
2020-04-23,Mendocino,45,87422,8,5,0,5,0
2020-04-23,Merced,47,269075,159,98,0,98,3
2020-04-23,Modoc,49,8938,0,0,0,0,0
2020-04-23,Mono,51,14174,30,23,0,23,1
2020-04-23,Monterey,53,433212,222,161,0,161,4
2020-04-23,Napa,55,140530,66,59,0,59,2
2020-04-23,Nevada,57,99092,41,36,1,37,1
2020-04-23,Orange,59,3164182,2886,1841,9,1850,37
2020-04-23,Placer,61,380077,158,136,1,137,8
2020-04-23,Plumas,63,18699,4,4,0,4,0
2020-04-23,Riverside,65,2383286,4120,2935,6,2941,78
2020-04-23,Sacramento,67,1510023,1063,978,0,978,41
2020-04-23,San Benito,69,59416,46,43,0,43,2
2020-04-23,San Bernardino,71,2135413,2151,1604,0,1604,79
2020-04-23,San Diego,73,3302833,3693,2645,0,2645,100
2020-04-23,San Francisco,75,870044,1584,1312,0,1312,21
2020-04-23,San Joaquin,77,732212,546,479,3,482,20
2020-04-23,San Luis Obispo,79,281455,206,146,1,147,1
2020-04-23,San Mateo,81,765935,1289,970,2,972,42
2020-04-23,Santa Barbara,83,443738,579,445,2,447,6
2020-04-23,Santa Clara,85,1922200,2313,1996,1,1997,95
2020-04-23,Santa Cruz,87,273765,134,110,0,110,2
2020-04-23,Shasta,89,179085,34,27,0,27,3
2020-04-23,Sierra,91,2930,0,0,0,0,0
2020-04-23,Siskiyou,93,43540,5,5,0,5,0
2020-04-23,Solano,95,438530,267,196,0,196,3
2020-04-23,Sonoma,97,501317,238,187,0,187,1
2020-04-23,Stanislaus,99,539301,390,254,4,258,4
2020-04-23,Sutter,101,95872,28,24,0,24,2
2020-04-23,Tehama,103,63373,1,1,0,1,1
2020-04-23,Trinity,105,12862,0,0,0,0,0
2020-04-23,Tulare,107,460477,664,440,1,441,25
2020-04-23,Tuolumne,109,53932,3,2,0,2,0
2020-04-23,Ventura,111,848112,596,479,0,479,16
2020-04-23,Yolo,113,214977,170,151,0,151,8
2020-04-23,Yuba,115,75493,16,15,0,15,1
2020-04-22,Alameda,1,1643700,1592,1275,0,1275,46
2020-04-22,Alpine,3,1148,1,1,0,1,0
2020-04-22,Amador,5,37829,8,7,0,7,0
2020-04-22,Butte,7,227075,20,15,0,15,0
2020-04-22,Calaveras,9,45235,13,12,0,12,0
2020-04-22,Colusa,11,21464,3,3,0,3,0
2020-04-22,Contra Costa,13,1133247,896,772,0,772,22
2020-04-22,Del Norte,15,27424,2,2,0,2,0
2020-04-22,El Dorado,17,186661,50,39,0,39,0
2020-04-22,Fresno,19,978130,693,388,4,392,7
2020-04-22,Glenn,21,27897,5,3,0,3,0
2020-04-22,Humboldt,23,135768,59,53,0,53,0
2020-04-22,Imperial,25,180216,389,170,1,171,3
2020-04-22,Inyo,27,18085,19,18,0,18,0
2020-04-22,Kern,29,883053,939,713,1,714,4
2020-04-22,Kings,31,150075,91,28,1,29,1
2020-04-22,Lake,33,64148,6,6,0,6,0
2020-04-22,Lassen,35,31185,1,0,1,1,0
2020-04-22,Los Angeles,37,10098052,22538,16400,19,16419,715
2020-04-22,Madera,39,155013,69,37,0,37,2
2020-04-22,Marin,41,260295,222,202,1,203,11
2020-04-22,Mariposa,43,17540,6,0,0,0,0
2020-04-22,Mendocino,45,87422,5,5,0,5,0
2020-04-22,Merced,47,269075,147,92,0,92,3
2020-04-22,Modoc,49,8938,0,0,0,0,0
2020-04-22,Mono,51,14174,29,23,0,23,1
2020-04-22,Monterey,53,433212,215,154,0,154,4
2020-04-22,Napa,55,140530,65,58,0,58,2
2020-04-22,Nevada,57,99092,41,36,1,37,1
2020-04-22,Orange,59,3164182,2793,1785,9,1794,36
2020-04-22,Placer,61,380077,156,133,1,134,8
2020-04-22,Plumas,63,18699,4,4,0,4,0
2020-04-22,Riverside,65,2383286,4017,2822,6,2828,76
2020-04-22,Sacramento,67,1510023,1058,959,0,959,36
2020-04-22,San Benito,69,59416,45,43,0,43,2
2020-04-22,San Bernardino,71,2135413,2088,1564,0,1564,74
2020-04-22,San Diego,73,3302833,3565,2493,0,2493,96
2020-04-22,San Francisco,75,870044,1547,1255,0,1255,21
2020-04-22,San Joaquin,77,732212,535,462,3,465,20
2020-04-22,San Luis Obispo,79,281455,197,142,1,143,1
2020-04-22,San Mateo,81,765935,1266,945,2,947,40
2020-04-22,Santa Barbara,83,443738,571,437,2,439,6
2020-04-22,Santa Clara,85,1922200,2300,1969,1,1970,95
2020-04-22,Santa Cruz,87,273765,130,106,0,106,2
2020-04-22,Shasta,89,179085,33,26,0,26,3
2020-04-22,Sierra,91,2930,0,0,0,0,0
2020-04-22,Siskiyou,93,43540,5,5,0,5,0
2020-04-22,Solano,95,438530,248,195,0,195,3
2020-04-22,Sonoma,97,501317,235,185,0,185,1
2020-04-22,Stanislaus,99,539301,334,247,4,251,4
2020-04-22,Sutter,101,95872,28,22,0,22,2
2020-04-22,Tehama,103,63373,1,1,0,1,1
2020-04-22,Trinity,105,12862,0,0,0,0,0
2020-04-22,Tulare,107,460477,631,425,1,426,23
2020-04-22,Tuolumne,109,53932,3,2,0,2,0
2020-04-22,Ventura,111,848112,586,465,0,465,15
2020-04-22,Yolo,113,214977,170,147,0,147,8
2020-04-22,Yuba,115,75493,16,15,0,15,1
2020-04-21,Alameda,1,1643700,1562,1234,0,1234,46
2020-04-21,Alpine,3,1148,1,1,0,1,0
2020-04-21,Amador,5,37829,8,7,0,7,0
2020-04-21,Butte,7,227075,19,15,0,15,0
2020-04-21,Calaveras,9,45235,12,12,0,12,0
2020-04-21,Colusa,11,21464,3,3,0,3,0
2020-04-21,Contra Costa,13,1133247,882,766,0,766,22
2020-04-21,Del Norte,15,27424,2,2,0,2,0
2020-04-21,El Dorado,17,186661,50,36,0,36,0
2020-04-21,Fresno,19,978130,659,372,4,376,7
2020-04-21,Glenn,21,27897,5,3,0,3,0
2020-04-21,Humboldt,23,135768,58,53,0,53,0
2020-04-21,Imperial,25,180216,369,165,1,166,2
2020-04-21,Inyo,27,18085,19,18,0,18,0
2020-04-21,Kern,29,883053,897,676,1,677,4
2020-04-21,Kings,31,150075,78,28,1,29,1
2020-04-21,Lake,33,64148,6,6,0,6,0
2020-04-21,Lassen,35,31185,1,0,1,1,0
2020-04-21,Los Angeles,37,10098052,21679,15096,19,15115,650
2020-04-21,Madera,39,155013,69,37,0,37,2
2020-04-21,Marin,41,260295,216,202,1,203,10
2020-04-21,Mariposa,43,17540,5,0,0,0,0
2020-04-21,Mendocino,45,87422,5,5,0,5,0
2020-04-21,Merced,47,269075,143,89,0,89,3
2020-04-21,Modoc,49,8938,0,0,0,0,0
2020-04-21,Mono,51,14174,29,23,0,23,1
2020-04-21,Monterey,53,433212,212,151,0,151,4
2020-04-21,Napa,55,140530,64,58,0,58,2
2020-04-21,Nevada,57,99092,41,36,1,37,1
2020-04-21,Orange,59,3164182,2671,1717,8,1725,36
2020-04-21,Placer,61,380077,154,133,0,133,8
2020-04-21,Plumas,63,18699,4,4,0,4,0
2020-04-21,Riverside,65,2383286,3886,2631,6,2637,68
2020-04-21,Sacramento,67,1510023,1048,941,0,941,33
2020-04-21,San Benito,69,59416,44,43,0,43,2
2020-04-21,San Bernardino,71,2135413,2027,1499,0,1499,71
2020-04-21,San Diego,73,3302833,3409,2436,0,2436,87
2020-04-21,San Francisco,75,870044,1517,1232,0,1232,20
2020-04-21,San Joaquin,77,732212,525,447,3,450,20
2020-04-21,San Luis Obispo,79,281455,193,134,1,135,1
2020-04-21,San Mateo,81,765935,1220,933,2,935,34
2020-04-21,Santa Barbara,83,443738,560,414,1,415,5
2020-04-21,Santa Clara,85,1922200,2259,1943,1,1944,91
2020-04-21,Santa Cruz,87,273765,128,104,0,104,2
2020-04-21,Shasta,89,179085,32,26,0,26,3
2020-04-21,Sierra,91,2930,0,0,0,0,0
2020-04-21,Siskiyou,93,43540,5,5,0,5,0
2020-04-21,Solano,95,438530,240,193,0,193,3
2020-04-21,Sonoma,97,501317,225,182,0,182,1
2020-04-21,Stanislaus,99,539301,315,235,4,239,4
2020-04-21,Sutter,101,95872,28,22,0,22,2
2020-04-21,Tehama,103,63373,1,1,0,1,1
2020-04-21,Trinity,105,12862,0,0,0,0,0
2020-04-21,Tulare,107,460477,596,410,1,411,23
2020-04-21,Tuolumne,109,53932,3,2,0,2,0
2020-04-21,Ventura,111,848112,574,455,0,455,14
2020-04-21,Yolo,113,214977,168,143,0,143,8
2020-04-21,Yuba,115,75493,16,15,0,15,1
2020-04-20,Alameda,1,1643700,1529,1181,0,1181,42
2020-04-20,Alpine,3,1148,1,1,0,1,0
2020-04-20,Amador,5,37829,8,7,0,7,0
2020-04-20,Butte,7,227075,19,15,0,15,0
2020-04-20,Calaveras,9,45235,12,12,0,12,0
2020-04-20,Colusa,11,21464,3,3,0,3,0
2020-04-20,Contra Costa,13,1133247,872,753,0,753,22
2020-04-20,Del Norte,15,27424,2,2,0,2,0
2020-04-20,El Dorado,17,186661,50,36,0,36,0
2020-04-20,Fresno,19,978130,641,356,4,360,7
2020-04-20,Glenn,21,27897,4,3,0,3,0
2020-04-20,Humboldt,23,135768,58,53,0,53,0
2020-04-20,Imperial,25,180216,349,149,1,150,2
2020-04-20,Inyo,27,18085,19,17,0,17,0
2020-04-20,Kern,29,883053,865,651,1,652,3
2020-04-20,Kings,31,150075,67,19,1,20,1
2020-04-20,Lake,33,64148,6,6,0,6,0
2020-04-20,Lassen,35,31185,1,0,1,1,0
2020-04-20,Los Angeles,37,10098052,20765,13787,19,13806,608
2020-04-20,Madera,39,155013,68,35,0,35,2
2020-04-20,Marin,41,260295,212,200,1,201,10
2020-04-20,Mariposa,43,17540,5,0,0,0,0
2020-04-20,Mendocino,45,87422,5,5,0,5,0
2020-04-20,Merced,47,269075,136,88,0,88,3
2020-04-20,Modoc,49,8938,0,0,0,0,0
2020-04-20,Mono,51,14174,29,23,0,23,1
2020-04-20,Monterey,53,433212,203,147,0,147,4
2020-04-20,Napa,55,140530,64,55,0,55,2
2020-04-20,Nevada,57,99092,41,34,1,35,1
2020-04-20,Orange,59,3164182,2590,1679,8,1687,33
2020-04-20,Placer,61,380077,153,132,0,132,8
2020-04-20,Plumas,63,18699,4,4,0,4,0
2020-04-20,Riverside,65,2383286,3761,2477,6,2483,61
2020-04-20,Sacramento,67,1510023,1037,924,0,924,32
2020-04-20,San Benito,69,59416,44,43,0,43,2
2020-04-20,San Bernardino,71,2135413,1940,1344,0,1344,63
2020-04-20,San Diego,73,3302833,3268,2327,0,2327,72
2020-04-20,San Francisco,75,870044,1485,1223,0,1223,19
2020-04-20,San Joaquin,77,732212,521,422,3,425,17
2020-04-20,San Luis Obispo,79,281455,180,132,1,133,1
2020-04-20,San Mateo,81,765935,1197,890,2,892,31
2020-04-20,Santa Barbara,83,443738,549,388,1,389,4
2020-04-20,Santa Clara,85,1922200,2236,1920,1,1921,84
2020-04-20,Santa Cruz,87,273765,126,102,0,102,2
2020-04-20,Shasta,89,179085,32,26,0,26,3
2020-04-20,Sierra,91,2930,0,0,0,0,0
2020-04-20,Siskiyou,93,43540,5,5,0,5,0
2020-04-20,Solano,95,438530,237,185,0,185,2
2020-04-20,Sonoma,97,501317,217,178,0,178,1
2020-04-20,Stanislaus,99,539301,301,228,4,232,3
2020-04-20,Sutter,101,95872,27,22,0,22,2
2020-04-20,Tehama,103,63373,1,1,0,1,1
2020-04-20,Trinity,105,12862,0,0,0,0,0
2020-04-20,Tulare,107,460477,585,401,1,402,20
2020-04-20,Tuolumne,109,53932,3,2,0,2,0
2020-04-20,Ventura,111,848112,562,426,0,426,13
2020-04-20,Yolo,113,214977,167,125,0,125,5
2020-04-20,Yuba,115,75493,16,15,0,15,1
2020-04-19,Alameda,1,1643700,1479,1134,0,1134,41
2020-04-19,Alpine,3,1148,1,1,0,1,0
2020-04-19,Amador,5,37829,7,7,0,7,0
2020-04-19,Butte,7,227075,19,15,0,15,0
2020-04-19,Calaveras,9,45235,12,12,0,12,0
2020-04-19,Colusa,11,21464,3,3,0,3,0
2020-04-19,Contra Costa,13,1133247,858,731,0,731,20
2020-04-19,Del Norte,15,27424,2,2,0,2,0
2020-04-19,El Dorado,17,186661,50,36,0,36,0
2020-04-19,Fresno,19,978130,605,326,4,330,7
2020-04-19,Glenn,21,27897,4,3,0,3,0
2020-04-19,Humboldt,23,135768,58,53,0,53,0
2020-04-19,Imperial,25,180216,323,144,0,144,2
2020-04-19,Inyo,27,18085,19,17,0,17,0
2020-04-19,Kern,29,883053,840,629,1,630,3
2020-04-19,Kings,31,150075,57,17,1,18,1
2020-04-19,Lake,33,64148,6,6,0,6,0
2020-04-19,Lassen,35,31185,1,0,1,1,0
2020-04-19,Los Angeles,37,10098052,19769,12299,19,12318,589
2020-04-19,Madera,39,155013,66,34,0,34,2
2020-04-19,Marin,41,260295,211,194,1,195,10
2020-04-19,Mariposa,43,17540,2,0,0,0,0
2020-04-19,Mendocino,45,87422,5,4,0,4,0
2020-04-19,Merced,47,269075,131,85,0,85,3
2020-04-19,Modoc,49,8938,0,0,0,0,0
2020-04-19,Mono,51,14174,29,23,0,23,1
2020-04-19,Monterey,53,433212,195,140,0,140,4
2020-04-19,Napa,55,140530,62,49,0,49,2
2020-04-19,Nevada,57,99092,40,34,1,35,1
2020-04-19,Orange,59,3164182,2494,1591,6,1597,32
2020-04-19,Placer,61,380077,152,131,0,131,8
2020-04-19,Plumas,63,18699,4,4,0,4,0
2020-04-19,Riverside,65,2383286,3618,2316,6,2322,56
2020-04-19,Sacramento,67,1510023,1011,912,0,912,32
2020-04-19,San Benito,69,59416,42,40,0,40,2
2020-04-19,San Bernardino,71,2135413,1877,1262,0,1262,58
2020-04-19,San Diego,73,3302833,3101,2270,0,2270,71
2020-04-19,San Francisco,75,870044,1452,1153,0,1153,19
2020-04-19,San Joaquin,77,732212,503,404,3,407,17
2020-04-19,San Luis Obispo,79,281455,175,132,1,133,1
2020-04-19,San Mateo,81,765935,1161,845,2,847,31
2020-04-19,Santa Barbara,83,443738,540,377,1,378,3
2020-04-19,Santa Clara,85,1922200,2200,1878,1,1879,81
2020-04-19,Santa Cruz,87,273765,123,98,0,98,2
2020-04-19,Shasta,89,179085,30,26,0,26,3
2020-04-19,Sierra,91,2930,0,0,0,0,0
2020-04-19,Siskiyou,93,43540,5,5,0,5,0
2020-04-19,Solano,95,438530,229,174,0,174,2
2020-04-19,Sonoma,97,501317,211,172,0,172,1
2020-04-19,Stanislaus,99,539301,293,221,4,225,3
2020-04-19,Sutter,101,95872,26,21,0,21,2
2020-04-19,Tehama,103,63373,1,1,0,1,1
2020-04-19,Trinity,105,12862,0,0,0,0,0
2020-04-19,Tulare,107,460477,540,391,1,392,17
2020-04-19,Tuolumne,109,53932,3,2,0,2,0
2020-04-19,Ventura,111,848112,554,418,0,418,13
2020-04-19,Yolo,113,214977,167,120,0,120,5
2020-04-19,Yuba,115,75493,16,15,0,15,1
2020-04-18,Alameda,1,1643700,1454,1085,0,1085,40
2020-04-18,Alpine,3,1148,1,1,0,1,0
2020-04-18,Amador,5,37829,7,7,0,7,0
2020-04-18,Butte,7,227075,18,15,0,15,0
2020-04-18,Calaveras,9,45235,12,12,0,12,0
2020-04-18,Colusa,11,21464,3,3,0,3,0
2020-04-18,Contra Costa,13,1133247,846,721,0,721,17
2020-04-18,Del Norte,15,27424,2,2,0,2,0
2020-04-18,El Dorado,17,186661,50,36,0,36,0
2020-04-18,Fresno,19,978130,585,319,4,323,7
2020-04-18,Glenn,21,27897,4,3,0,3,0
2020-04-18,Humboldt,23,135768,58,52,0,52,0
2020-04-18,Imperial,25,180216,314,137,0,137,2
2020-04-18,Inyo,27,18085,19,17,0,17,0
2020-04-18,Kern,29,883053,818,626,1,627,3
2020-04-18,Kings,31,150075,56,17,1,18,1
2020-04-18,Lake,33,64148,6,6,0,6,0
2020-04-18,Lassen,35,31185,1,0,1,1,0
2020-04-18,Los Angeles,37,10098052,19245,11984,18,12002,566
2020-04-18,Madera,39,155013,65,34,0,34,2
2020-04-18,Marin,41,260295,209,193,1,194,10
2020-04-18,Mariposa,43,17540,2,0,0,0,0
2020-04-18,Mendocino,45,87422,5,4,0,4,0
2020-04-18,Merced,47,269075,129,82,0,82,3
2020-04-18,Modoc,49,8938,0,0,0,0,0
2020-04-18,Mono,51,14174,29,22,0,22,1
2020-04-18,Monterey,53,433212,191,135,0,135,3
2020-04-18,Napa,55,140530,62,49,0,49,2
2020-04-18,Nevada,57,99092,39,34,1,35,1
2020-04-18,Orange,59,3164182,2430,1569,5,1574,32
2020-04-18,Placer,61,380077,150,130,0,130,8
2020-04-18,Plumas,63,18699,4,4,0,4,0
2020-04-18,Riverside,65,2383286,3546,2257,6,2263,56
2020-04-18,Sacramento,67,1510023,999,901,0,901,32
2020-04-18,San Benito,69,59416,42,40,0,40,2
2020-04-18,San Bernardino,71,2135413,1832,1255,0,1255,58
2020-04-18,San Diego,73,3302833,2999,2215,0,2215,71
2020-04-18,San Francisco,75,870044,1413,1144,0,1144,19
2020-04-18,San Joaquin,77,732212,494,392,3,395,17
2020-04-18,San Luis Obispo,79,281455,171,129,1,130,1
2020-04-18,San Mateo,81,765935,1139,821,2,823,31
2020-04-18,Santa Barbara,83,443738,534,372,1,373,3
2020-04-18,Santa Clara,85,1922200,2170,1862,1,1863,79
2020-04-18,Santa Cruz,87,273765,121,96,0,96,2
2020-04-18,Shasta,89,179085,30,26,0,26,3
2020-04-18,Sierra,91,2930,0,0,0,0,0
2020-04-18,Siskiyou,93,43540,5,5,0,5,0
2020-04-18,Solano,95,438530,226,175,0,175,2
2020-04-18,Sonoma,97,501317,207,168,0,168,1
2020-04-18,Stanislaus,99,539301,285,216,4,220,3
2020-04-18,Sutter,101,95872,26,21,0,21,2
2020-04-18,Tehama,103,63373,1,1,0,1,1
2020-04-18,Trinity,105,12862,0,0,0,0,0
2020-04-18,Tulare,107,460477,531,385,1,386,17
2020-04-18,Tuolumne,109,53932,3,2,0,2,0
2020-04-18,Ventura,111,848112,546,416,0,416,13
2020-04-18,Yolo,113,214977,165,118,0,118,5
2020-04-18,Yuba,115,75493,16,14,0,14,1
2020-04-17,Alameda,1,1643700,1399,1043,0,1043,40
2020-04-17,Alpine,3,1148,1,1,0,1,0
2020-04-17,Amador,5,37829,7,7,0,7,0
2020-04-17,Butte,7,227075,18,15,0,15,0
2020-04-17,Calaveras,9,45235,12,11,0,11,0
2020-04-17,Colusa,11,21464,3,3,0,3,0
2020-04-17,Contra Costa,13,1133247,837,687,0,687,15
2020-04-17,Del Norte,15,27424,2,2,0,2,0
2020-04-17,El Dorado,17,186661,50,35,0,35,0
2020-04-17,Fresno,19,978130,563,315,4,319,7
2020-04-17,Glenn,21,27897,4,3,0,3,0
2020-04-17,Humboldt,23,135768,57,52,0,52,0
2020-04-17,Imperial,25,180216,305,135,0,135,2
2020-04-17,Inyo,27,18085,19,17,0,17,0
2020-04-17,Kern,29,883053,798,612,1,613,3
2020-04-17,Kings,31,150075,54,15,1,16,1
2020-04-17,Lake,33,64148,6,6,0,6,0
2020-04-17,Lassen,35,31185,1,0,1,1,0
2020-04-17,Los Angeles,37,10098052,18602,11354,18,11372,489
2020-04-17,Madera,39,155013,65,34,0,34,2
2020-04-17,Marin,41,260295,206,189,1,190,10
2020-04-17,Mariposa,43,17540,1,0,0,0,0
2020-04-17,Mendocino,45,87422,5,4,0,4,0
2020-04-17,Merced,47,269075,128,80,0,80,3
2020-04-17,Modoc,49,8938,0,0,0,0,0
2020-04-17,Mono,51,14174,29,22,0,22,1
2020-04-17,Monterey,53,433212,186,119,0,119,3
2020-04-17,Napa,55,140530,60,46,0,46,2
2020-04-17,Nevada,57,99092,38,34,1,35,1
2020-04-17,Orange,59,3164182,2380,1496,5,1501,31
2020-04-17,Placer,61,380077,150,130,0,130,8
2020-04-17,Plumas,63,18699,4,4,0,4,0
2020-04-17,Riverside,65,2383286,3420,2080,6,2086,50
2020-04-17,Sacramento,67,1510023,992,882,0,882,32
2020-04-17,San Benito,69,59416,42,38,0,38,2
2020-04-17,San Bernardino,71,2135413,1794,1229,0,1229,57
2020-04-17,San Diego,73,3302833,2909,2160,0,2160,70
2020-04-17,San Francisco,75,870044,1387,1090,0,1090,19
2020-04-17,San Joaquin,77,732212,483,356,3,359,17
2020-04-17,San Luis Obispo,79,281455,164,116,1,117,1
2020-04-17,San Mateo,81,765935,1123,768,2,770,31
2020-04-17,Santa Barbara,83,443738,529,349,1,350,3
2020-04-17,Santa Clara,85,1922200,2142,1834,1,1835,74
2020-04-17,Santa Cruz,87,273765,120,94,0,94,2
2020-04-17,Shasta,89,179085,30,26,0,26,3
2020-04-17,Sierra,91,2930,0,0,0,0,0
2020-04-17,Siskiyou,93,43540,5,5,0,5,0
2020-04-17,Solano,95,438530,225,173,0,173,2
2020-04-17,Sonoma,97,501317,204,167,0,167,1
2020-04-17,Stanislaus,99,539301,283,201,4,205,3
2020-04-17,Sutter,101,95872,26,20,0,20,2
2020-04-17,Tehama,103,63373,1,1,0,1,1
2020-04-17,Trinity,105,12862,0,0,0,0,0
2020-04-17,Tulare,107,460477,524,370,1,371,17
2020-04-17,Tuolumne,109,53932,3,2,0,2,0
2020-04-17,Ventura,111,848112,541,398,0,398,13
2020-04-17,Yolo,113,214977,164,117,0,117,5
2020-04-17,Yuba,115,75493,16,14,0,14,1
2020-04-16,Alameda,1,1643700,1366,981,0,981,39
2020-04-16,Alpine,3,1148,1,1,0,1,0
2020-04-16,Amador,5,37829,7,7,0,7,0
2020-04-16,Butte,7,227075,18,15,0,15,0
2020-04-16,Calaveras,9,45235,12,10,0,10,0
2020-04-16,Colusa,11,21464,3,3,0,3,0
2020-04-16,Contra Costa,13,1133247,823,675,0,675,14
2020-04-16,Del Norte,15,27424,2,2,0,2,0
2020-04-16,El Dorado,17,186661,49,34,0,34,0
2020-04-16,Fresno,19,978130,535,289,4,293,7
2020-04-16,Glenn,21,27897,4,3,0,3,0
2020-04-16,Humboldt,23,135768,57,47,0,47,0
2020-04-16,Imperial,25,180216,291,132,0,132,2
2020-04-16,Inyo,27,18085,17,17,0,17,0
2020-04-16,Kern,29,883053,773,587,1,588,3
2020-04-16,Kings,31,150075,50,12,1,13,1
2020-04-16,Lake,33,64148,6,6,0,6,0
2020-04-16,Lassen,35,31185,1,0,1,1,0
2020-04-16,Los Angeles,37,10098052,17717,10786,18,10804,447
2020-04-16,Madera,39,155013,63,34,0,34,2
2020-04-16,Marin,41,260295,202,170,1,171,10
2020-04-16,Mariposa,43,17540,1,1,0,1,0
2020-04-16,Mendocino,45,87422,5,4,0,4,0
2020-04-16,Merced,47,269075,122,76,0,76,3
2020-04-16,Modoc,49,8938,0,0,0,0,0
2020-04-16,Mono,51,14174,29,22,0,22,1
2020-04-16,Monterey,53,433212,183,116,0,116,3
2020-04-16,Napa,55,140530,57,44,0,44,2
2020-04-16,Nevada,57,99092,38,34,1,35,1
2020-04-16,Orange,59,3164182,2317,1439,4,1443,28
2020-04-16,Placer,61,380077,148,129,0,129,7
2020-04-16,Plumas,63,18699,4,4,0,4,0
2020-04-16,Riverside,65,2383286,3302,1913,6,1919,45
2020-04-16,Sacramento,67,1510023,984,865,0,865,32
2020-04-16,San Benito,69,59416,42,36,0,36,2
2020-04-16,San Bernardino,71,2135413,1711,1143,0,1143,54
2020-04-16,San Diego,73,3302833,2801,2089,0,2089,63
2020-04-16,San Francisco,75,870044,1342,1039,0,1039,16
2020-04-16,San Joaquin,77,732212,468,345,3,348,17
2020-04-16,San Luis Obispo,79,281455,160,113,1,114,1
2020-04-16,San Mateo,81,765935,1094,745,2,747,29
2020-04-16,Santa Barbara,83,443738,516,331,1,332,3
2020-04-16,Santa Clara,85,1922200,2116,1789,1,1790,70
2020-04-16,Santa Cruz,87,273765,118,90,0,90,2
2020-04-16,Shasta,89,179085,30,25,0,25,3
2020-04-16,Sierra,91,2930,0,0,0,0,0
2020-04-16,Siskiyou,93,43540,5,5,0,5,0
2020-04-16,Solano,95,438530,222,162,0,162,2
2020-04-16,Sonoma,97,501317,199,145,0,145,1
2020-04-16,Stanislaus,99,539301,280,185,4,189,3
2020-04-16,Sutter,101,95872,25,21,0,21,2
2020-04-16,Tehama,103,63373,1,1,0,1,1
2020-04-16,Trinity,105,12862,0,0,0,0,0
2020-04-16,Tulare,107,460477,508,305,1,306,16
2020-04-16,Tuolumne,109,53932,3,1,0,1,0
2020-04-16,Ventura,111,848112,529,384,0,384,13
2020-04-16,Yolo,113,214977,162,98,0,98,4
2020-04-16,Yuba,115,75493,15,14,0,14,1
2020-04-15,Alameda,1,1643700,1316,915,0,915,38
2020-04-15,Alpine,3,1148,1,1,0,1,0
2020-04-15,Amador,5,37829,7,7,0,7,0
2020-04-15,Butte,7,227075,18,14,0,14,0
2020-04-15,Calaveras,9,45235,11,9,0,9,0
2020-04-15,Colusa,11,21464,3,3,0,3,0
2020-04-15,Contra Costa,13,1133247,801,645,0,645,14
2020-04-15,Del Norte,15,27424,2,2,0,2,0
2020-04-15,El Dorado,17,186661,47,33,0,33,0
2020-04-15,Fresno,19,978130,511,264,4,268,7
2020-04-15,Glenn,21,27897,4,3,0,3,0
2020-04-15,Humboldt,23,135768,57,47,0,47,0
2020-04-15,Imperial,25,180216,265,115,0,115,2
2020-04-15,Inyo,27,18085,17,12,0,12,0
2020-04-15,Kern,29,883053,751,500,1,501,3
2020-04-15,Kings,31,150075,46,12,1,13,1
2020-04-15,Lake,33,64148,6,4,0,4,0
2020-04-15,Lassen,35,31185,1,0,1,1,0
2020-04-15,Los Angeles,37,10098052,16897,10416,18,10434,394
2020-04-15,Madera,39,155013,63,30,0,30,2
2020-04-15,Marin,41,260295,199,162,1,163,10
2020-04-15,Mariposa,43,17540,0,0,0,0,0
2020-04-15,Mendocino,45,87422,4,4,0,4,0
2020-04-15,Merced,47,269075,120,74,0,74,3
2020-04-15,Modoc,49,8938,0,0,0,0,0
2020-04-15,Mono,51,14174,29,22,0,22,1
2020-04-15,Monterey,53,433212,175,106,0,106,3
2020-04-15,Napa,55,140530,55,34,0,34,2
2020-04-15,Nevada,57,99092,37,34,1,35,1
2020-04-15,Orange,59,3164182,2215,1377,4,1381,24
2020-04-15,Placer,61,380077,147,123,0,123,6
2020-04-15,Plumas,63,18699,4,4,0,4,0
2020-04-15,Riverside,65,2383286,3107,1723,6,1729,42
2020-04-15,Sacramento,67,1510023,975,839,0,839,32
2020-04-15,San Benito,69,59416,42,34,0,34,2
2020-04-15,San Bernardino,71,2135413,1642,1063,0,1063,45
2020-04-15,San Diego,73,3302833,2713,2014,0,2014,60
2020-04-15,San Francisco,75,870044,1306,1006,0,1006,16
2020-04-15,San Joaquin,77,732212,460,329,3,332,17
2020-04-15,San Luis Obispo,79,281455,154,112,1,113,1
2020-04-15,San Mateo,81,765935,1045,707,2,709,28
2020-04-15,Santa Barbara,83,443738,497,317,1,318,2
2020-04-15,Santa Clara,85,1922200,2082,1692,1,1693,69
2020-04-15,Santa Cruz,87,273765,114,92,0,92,2
2020-04-15,Shasta,89,179085,30,25,0,25,3
2020-04-15,Sierra,91,2930,0,0,0,0,0
2020-04-15,Siskiyou,93,43540,5,5,0,5,0
2020-04-15,Solano,95,438530,217,153,0,153,2
2020-04-15,Sonoma,97,501317,197,140,0,140,1
2020-04-15,Stanislaus,99,539301,273,174,4,178,3
2020-04-15,Sutter,101,95872,25,19,0,19,2
2020-04-15,Tehama,103,63373,1,1,0,1,1
2020-04-15,Trinity,105,12862,0,0,0,0,0
2020-04-15,Tulare,107,460477,491,289,1,290,14
2020-04-15,Tuolumne,109,53932,3,1,0,1,0
2020-04-15,Ventura,111,848112,514,365,0,365,13
2020-04-15,Yolo,113,214977,158,93,0,93,3
2020-04-15,Yuba,115,75493,15,15,0,15,1
2020-04-14,Alameda,1,1643700,1271,843,0,843,30
2020-04-14,Alpine,3,1148,1,1,0,1,0
2020-04-14,Amador,5,37829,7,6,0,6,0
2020-04-14,Butte,7,227075,18,13,0,13,0
2020-04-14,Calaveras,9,45235,11,5,0,5,0
2020-04-14,Colusa,11,21464,3,3,0,3,0
2020-04-14,Contra Costa,13,1133247,789,617,0,617,12
2020-04-14,Del Norte,15,27424,2,2,0,2,0
2020-04-14,El Dorado,17,186661,47,30,0,30,0
2020-04-14,Fresno,19,978130,489,244,4,248,6
2020-04-14,Glenn,21,27897,4,3,0,3,0
2020-04-14,Humboldt,23,135768,57,44,0,44,0
2020-04-14,Imperial,25,180216,245,86,0,86,2
2020-04-14,Inyo,27,18085,17,12,0,12,0
2020-04-14,Kern,29,883053,728,453,1,454,3
2020-04-14,Kings,31,150075,45,12,1,13,1
2020-04-14,Lake,33,64148,6,3,0,3,0
2020-04-14,Lassen,35,31185,1,0,1,1,0
2020-04-14,Los Angeles,37,10098052,16003,9948,17,9965,357
2020-04-14,Madera,39,155013,62,29,0,29,2
2020-04-14,Marin,41,260295,195,147,1,148,9
2020-04-14,Mariposa,43,17540,0,0,0,0,0
2020-04-14,Mendocino,45,87422,4,4,0,4,0
2020-04-14,Merced,47,269075,113,61,0,61,3
2020-04-14,Modoc,49,8938,0,0,0,0,0
2020-04-14,Mono,51,14174,29,22,0,22,1
2020-04-14,Monterey,53,433212,170,98,0,98,3
2020-04-14,Napa,55,140530,55,33,0,33,2
2020-04-14,Nevada,57,99092,37,34,1,35,1
2020-04-14,Orange,59,3164182,2115,1362,4,1366,24
2020-04-14,Placer,61,380077,146,117,0,117,5
2020-04-14,Plumas,63,18699,4,3,0,3,0
2020-04-14,Riverside,65,2383286,2972,1467,6,1473,40
2020-04-14,Sacramento,67,1510023,966,737,0,737,29
2020-04-14,San Benito,69,59416,39,34,0,34,2
2020-04-14,San Bernardino,71,2135413,1587,933,0,933,37
2020-04-14,San Diego,73,3302833,2618,1932,0,1932,53
2020-04-14,San Francisco,75,870044,1252,968,0,968,14
2020-04-14,San Joaquin,77,732212,450,280,3,283,17
2020-04-14,San Luis Obispo,79,281455,152,109,1,110,1
2020-04-14,San Mateo,81,765935,1011,681,2,683,28
2020-04-14,Santa Barbara,83,443738,472,292,1,293,2
2020-04-14,Santa Clara,85,1922200,2049,1561,1,1562,63
2020-04-14,Santa Cruz,87,273765,106,84,0,84,2
2020-04-14,Shasta,89,179085,30,24,0,24,3
2020-04-14,Sierra,91,2930,0,0,0,0,0
2020-04-14,Siskiyou,93,43540,5,5,0,5,0
2020-04-14,Solano,95,438530,214,140,0,140,2
2020-04-14,Sonoma,97,501317,193,133,0,133,1
2020-04-14,Stanislaus,99,539301,260,136,4,140,3
2020-04-14,Sutter,101,95872,24,19,0,19,2
2020-04-14,Tehama,103,63373,1,1,0,1,1
2020-04-14,Trinity,105,12862,0,0,0,0,0
2020-04-14,Tulare,107,460477,468,228,1,229,12
2020-04-14,Tuolumne,109,53932,3,0,0,0,0
2020-04-14,Ventura,111,848112,501,328,0,328,11
2020-04-14,Yolo,113,214977,154,81,0,81,3
2020-04-14,Yuba,115,75493,14,14,0,14,1
2020-04-13,Alameda,1,1643700,1232,821,0,821,23
2020-04-13,Alpine,3,1148,1,1,0,1,0
2020-04-13,Amador,5,37829,7,6,0,6,0
2020-04-13,Butte,7,227075,18,13,0,13,0
2020-04-13,Calaveras,9,45235,10,5,0,5,0
2020-04-13,Colusa,11,21464,3,3,0,3,0
2020-04-13,Contra Costa,13,1133247,773,569,0,569,12
2020-04-13,Del Norte,15,27424,2,2,0,2,0
2020-04-13,El Dorado,17,186661,45,29,0,29,0
2020-04-13,Fresno,19,978130,467,205,3,208,4
2020-04-13,Glenn,21,27897,4,3,0,3,0
2020-04-13,Humboldt,23,135768,57,44,0,44,0
2020-04-13,Imperial,25,180216,227,82,0,82,2
2020-04-13,Inyo,27,18085,17,12,0,12,0
2020-04-13,Kern,29,883053,703,346,1,347,3
2020-04-13,Kings,31,150075,41,9,1,10,0
2020-04-13,Lake,33,64148,6,3,0,3,0
2020-04-13,Lassen,35,31185,1,0,1,1,0
2020-04-13,Los Angeles,37,10098052,15289,9367,17,9384,317
2020-04-13,Madera,39,155013,60,29,0,29,2
2020-04-13,Marin,41,260295,191,144,1,145,6
2020-04-13,Mariposa,43,17540,0,0,0,0,0
2020-04-13,Mendocino,45,87422,4,4,0,4,0
2020-04-13,Merced,47,269075,112,60,0,60,3
2020-04-13,Modoc,49,8938,0,0,0,0,0
2020-04-13,Mono,51,14174,29,21,0,21,1
2020-04-13,Monterey,53,433212,164,86,0,86,3
2020-04-13,Napa,55,140530,54,30,0,30,2
2020-04-13,Nevada,57,99092,37,24,1,25,1
2020-04-13,Orange,59,3164182,2043,1313,4,1317,21
2020-04-13,Placer,61,380077,145,116,0,116,5
2020-04-13,Plumas,63,18699,4,3,0,3,0
2020-04-13,Riverside,65,2383286,2832,1460,5,1465,35
2020-04-13,Sacramento,67,1510023,954,723,0,723,25
2020-04-13,San Benito,69,59416,38,33,0,33,2
2020-04-13,San Bernardino,71,2135413,1512,920,0,920,30
2020-04-13,San Diego,73,3302833,2535,1849,0,1849,47
2020-04-13,San Francisco,75,870044,1214,948,0,948,12
2020-04-13,San Joaquin,77,732212,436,255,3,258,16
2020-04-13,San Luis Obispo,79,281455,147,106,1,107,1
2020-04-13,San Mateo,81,765935,971,679,2,681,25
2020-04-13,Santa Barbara,83,443738,453,271,0,271,2
2020-04-13,Santa Clara,85,1922200,2009,1540,1,1541,58
2020-04-13,Santa Cruz,87,273765,100,82,0,82,1
2020-04-13,Shasta,89,179085,29,24,0,24,3
2020-04-13,Sierra,91,2930,0,0,0,0,0
2020-04-13,Siskiyou,93,43540,5,5,0,5,0
2020-04-13,Solano,95,438530,211,136,0,136,2
2020-04-13,Sonoma,97,501317,186,133,0,133,1
2020-04-13,Stanislaus,99,539301,254,130,4,134,1
2020-04-13,Sutter,101,95872,24,18,0,18,2
2020-04-13,Tehama,103,63373,1,1,0,1,0
2020-04-13,Trinity,105,12862,0,0,0,0,0
2020-04-13,Tulare,107,460477,431,185,1,186,11
2020-04-13,Tuolumne,109,53932,3,0,0,0,0
2020-04-13,Ventura,111,848112,480,309,0,309,9
2020-04-13,Yolo,113,214977,148,81,0,81,3
2020-04-13,Yuba,115,75493,14,13,0,13,1
2020-04-12,Alameda,1,1643700,1189,774,0,774,23
2020-04-12,Alpine,3,1148,1,1,0,1,0
2020-04-12,Amador,5,37829,7,6,0,6,0
2020-04-12,Butte,7,227075,18,13,0,13,0
2020-04-12,Calaveras,9,45235,10,5,0,5,0
2020-04-12,Colusa,11,21464,3,3,0,3,0
2020-04-12,Contra Costa,13,1133247,761,553,0,553,12
2020-04-12,Del Norte,15,27424,2,2,0,2,0
2020-04-12,El Dorado,17,186661,45,28,0,28,0
2020-04-12,Fresno,19,978130,438,205,3,208,4
2020-04-12,Glenn,21,27897,4,3,0,3,0
2020-04-12,Humboldt,23,135768,57,43,0,43,0
2020-04-12,Imperial,25,180216,204,78,0,78,2
2020-04-12,Inyo,27,18085,15,12,0,12,0
2020-04-12,Kern,29,883053,671,319,0,319,3
2020-04-12,Kings,31,150075,39,9,1,10,0
2020-04-12,Lake,33,64148,6,3,0,3,0
2020-04-12,Lassen,35,31185,1,0,1,1,0
2020-04-12,Los Angeles,37,10098052,14579,9133,17,9150,294
2020-04-12,Madera,39,155013,59,29,0,29,2
2020-04-12,Marin,41,260295,180,138,1,139,6
2020-04-12,Mariposa,43,17540,0,0,0,0,0
2020-04-12,Mendocino,45,87422,4,4,0,4,0
2020-04-12,Merced,47,269075,106,58,0,58,3
2020-04-12,Modoc,49,8938,0,0,0,0,0
2020-04-12,Mono,51,14174,29,20,0,20,1
2020-04-12,Monterey,53,433212,150,85,0,85,3
2020-04-12,Napa,55,140530,52,29,0,29,2
2020-04-12,Nevada,57,99092,37,24,1,25,1
2020-04-12,Orange,59,3164182,1983,1283,4,1287,21
2020-04-12,Placer,61,380077,144,114,0,114,4
2020-04-12,Plumas,63,18699,4,3,0,3,0
2020-04-12,Riverside,65,2383286,2650,1330,5,1335,34
2020-04-12,Sacramento,67,1510023,917,689,0,689,25
2020-04-12,San Benito,69,59416,36,33,0,33,2
2020-04-12,San Bernardino,71,2135413,1436,827,0,827,30
2020-04-12,San Diego,73,3302833,2445,1806,0,1806,45
2020-04-12,San Francisco,75,870044,1186,886,0,886,11
2020-04-12,San Joaquin,77,732212,418,246,3,249,15
2020-04-12,San Luis Obispo,79,281455,145,102,1,103,1
2020-04-12,San Mateo,81,765935,945,664,2,666,25
2020-04-12,Santa Barbara,83,443738,428,261,0,261,2
2020-04-12,Santa Clara,85,1922200,1985,1461,1,1462,53
2020-04-12,Santa Cruz,87,273765,99,80,0,80,1
2020-04-12,Shasta,89,179085,29,24,0,24,3
2020-04-12,Sierra,91,2930,0,0,0,0,0
2020-04-12,Siskiyou,93,43540,5,5,0,5,0
2020-04-12,Solano,95,438530,205,136,0,136,2
2020-04-12,Sonoma,97,501317,183,131,0,131,1
2020-04-12,Stanislaus,99,539301,246,117,4,121,1
2020-04-12,Sutter,101,95872,23,18,0,18,2
2020-04-12,Tehama,103,63373,1,1,0,1,0
2020-04-12,Trinity,105,12862,0,0,0,0,0
2020-04-12,Tulare,107,460477,420,166,1,167,11
2020-04-12,Tuolumne,109,53932,3,0,0,0,0
2020-04-12,Ventura,111,848112,470,306,0,306,9
2020-04-12,Yolo,113,214977,135,67,0,67,3
2020-04-12,Yuba,115,75493,14,13,0,13,1
2020-04-11,Alameda,1,1643700,1148,751,0,751,23
2020-04-11,Alpine,3,1148,1,1,0,1,0
2020-04-11,Amador,5,37829,7,6,0,6,0
2020-04-11,Butte,7,227075,18,13,0,13,0
2020-04-11,Calaveras,9,45235,10,5,0,5,0
2020-04-11,Colusa,11,21464,3,3,0,3,0
2020-04-11,Contra Costa,13,1133247,752,550,0,550,12
2020-04-11,Del Norte,15,27424,2,2,0,2,0
2020-04-11,El Dorado,17,186661,45,29,0,29,0
2020-04-11,Fresno,19,978130,428,201,3,204,4
2020-04-11,Glenn,21,27897,4,3,0,3,0
2020-04-11,Humboldt,23,135768,57,38,0,38,0
2020-04-11,Imperial,25,180216,193,78,0,78,2
2020-04-11,Inyo,27,18085,15,12,0,12,0
2020-04-11,Kern,29,883053,644,304,0,304,3
2020-04-11,Kings,31,150075,36,9,1,10,0
2020-04-11,Lake,33,64148,6,3,0,3,0
2020-04-11,Lassen,35,31185,1,0,1,1,0
2020-04-11,Los Angeles,37,10098052,14109,8823,17,8840,262
2020-04-11,Madera,39,155013,58,29,0,29,2
2020-04-11,Marin,41,260295,177,136,1,137,6
2020-04-11,Mariposa,43,17540,0,0,0,0,0
2020-04-11,Mendocino,45,87422,4,4,0,4,0
2020-04-11,Merced,47,269075,103,59,0,59,3
2020-04-11,Modoc,49,8938,0,0,0,0,0
2020-04-11,Mono,51,14174,29,20,0,20,1
2020-04-11,Monterey,53,433212,144,78,0,78,3
2020-04-11,Napa,55,140530,52,29,0,29,2
2020-04-11,Nevada,57,99092,37,24,1,25,1
2020-04-11,Orange,59,3164182,1922,1267,4,1271,21
2020-04-11,Placer,61,380077,144,113,0,113,4
2020-04-11,Plumas,63,18699,4,3,0,3,0
2020-04-11,Riverside,65,2383286,2571,1260,5,1265,33
2020-04-11,Sacramento,67,1510023,906,685,0,685,25
2020-04-11,San Benito,69,59416,36,33,0,33,2
2020-04-11,San Bernardino,71,2135413,1400,826,0,826,28
2020-04-11,San Diego,73,3302833,2379,1763,0,1763,45
2020-04-11,San Francisco,75,870044,1164,860,0,860,11
2020-04-11,San Joaquin,77,732212,413,244,3,247,15
2020-04-11,San Luis Obispo,79,281455,145,100,0,100,1
2020-04-11,San Mateo,81,765935,933,662,2,664,25
2020-04-11,Santa Barbara,83,443738,420,258,0,258,2
2020-04-11,Santa Clara,85,1922200,1944,1441,1,1442,51
2020-04-11,Santa Cruz,87,273765,99,79,0,79,1
2020-04-11,Shasta,89,179085,29,24,0,24,3
2020-04-11,Sierra,91,2930,0,0,0,0,0
2020-04-11,Siskiyou,93,43540,5,5,0,5,0
2020-04-11,Solano,95,438530,201,138,0,138,2
2020-04-11,Sonoma,97,501317,181,131,0,131,1
2020-04-11,Stanislaus,99,539301,239,119,3,122,1
2020-04-11,Sutter,101,95872,23,18,0,18,2
2020-04-11,Tehama,103,63373,1,1,0,1,0
2020-04-11,Trinity,105,12862,0,0,0,0,0
2020-04-11,Tulare,107,460477,398,168,1,169,10
2020-04-11,Tuolumne,109,53932,3,0,0,0,0
2020-04-11,Ventura,111,848112,460,304,0,304,9
2020-04-11,Yolo,113,214977,132,67,0,67,3
2020-04-11,Yuba,115,75493,14,13,0,13,1
2020-04-10,Alameda,1,1643700,1107,706,0,706,21
2020-04-10,Alpine,3,1148,1,1,0,1,0
2020-04-10,Amador,5,37829,7,5,0,5,0
2020-04-10,Butte,7,227075,18,13,0,13,0
2020-04-10,Calaveras,9,45235,10,5,0,5,0
2020-04-10,Colusa,11,21464,3,3,0,3,0
2020-04-10,Contra Costa,13,1133247,739,537,0,537,10
2020-04-10,Del Norte,15,27424,2,2,0,2,0
2020-04-10,El Dorado,17,186661,45,26,0,26,0
2020-04-10,Fresno,19,978130,421,186,3,189,3
2020-04-10,Glenn,21,27897,4,3,0,3,0
2020-04-10,Humboldt,23,135768,57,36,0,36,0
2020-04-10,Imperial,25,180216,186,70,0,70,2
2020-04-10,Inyo,27,18085,13,11,0,11,0
2020-04-10,Kern,29,883053,620,272,0,272,3
2020-04-10,Kings,31,150075,33,7,1,8,0
2020-04-10,Lake,33,64148,6,3,0,3,0
2020-04-10,Lassen,35,31185,1,0,1,1,0
2020-04-10,Los Angeles,37,10098052,13596,8384,16,8400,239
2020-04-10,Madera,39,155013,57,29,0,29,2
2020-04-10,Marin,41,260295,172,128,1,129,6
2020-04-10,Mariposa,43,17540,0,0,0,0,0
2020-04-10,Mendocino,45,87422,4,4,0,4,0
2020-04-10,Merced,47,269075,100,56,0,56,3
2020-04-10,Modoc,49,8938,0,0,0,0,0
2020-04-10,Mono,51,14174,29,20,0,20,1
2020-04-10,Monterey,53,433212,133,78,0,78,3
2020-04-10,Napa,55,140530,49,28,0,28,2
2020-04-10,Nevada,57,99092,37,23,1,24,1
2020-04-10,Orange,59,3164182,1876,1167,4,1171,21
2020-04-10,Placer,61,380077,143,112,0,112,4
2020-04-10,Plumas,63,18699,4,3,0,3,0
2020-04-10,Riverside,65,2383286,2506,1162,5,1167,30
2020-04-10,Sacramento,67,1510023,897,642,0,642,24
2020-04-10,San Benito,69,59416,36,32,0,32,2
2020-04-10,San Bernardino,71,2135413,1352,779,0,779,27
2020-04-10,San Diego,73,3302833,2319,1695,0,1695,44
2020-04-10,San Francisco,75,870044,1133,797,0,797,10
2020-04-10,San Joaquin,77,732212,401,234,3,237,14
2020-04-10,San Luis Obispo,79,281455,145,97,0,97,1
2020-04-10,San Mateo,81,765935,917,642,2,644,24
2020-04-10,Santa Barbara,83,443738,409,254,0,254,2
2020-04-10,Santa Clara,85,1922200,1895,1351,1,1352,50
2020-04-10,Santa Cruz,87,273765,98,75,0,75,1
2020-04-10,Shasta,89,179085,29,24,0,24,3
2020-04-10,Sierra,91,2930,0,0,0,0,0
2020-04-10,Siskiyou,93,43540,5,5,0,5,0
2020-04-10,Solano,95,438530,198,129,0,129,2
2020-04-10,Sonoma,97,501317,180,129,0,129,1
2020-04-10,Stanislaus,99,539301,232,101,3,104,0
2020-04-10,Sutter,101,95872,23,18,0,18,2
2020-04-10,Tehama,103,63373,1,1,0,1,0
2020-04-10,Trinity,105,12862,0,0,0,0,0
2020-04-10,Tulare,107,460477,355,163,1,164,10
2020-04-10,Tuolumne,109,53932,3,0,0,0,0
2020-04-10,Ventura,111,848112,452,290,0,290,9
2020-04-10,Yolo,113,214977,130,62,0,62,3
2020-04-10,Yuba,115,75493,14,13,0,13,1
2020-04-09,Alameda,1,1643700,1057,641,0,641,17
2020-04-09,Alpine,3,1148,1,1,0,1,0
2020-04-09,Amador,5,37829,7,2,0,2,0
2020-04-09,Butte,7,227075,18,12,0,12,0
2020-04-09,Calaveras,9,45235,10,5,0,5,0
2020-04-09,Colusa,11,21464,3,3,0,3,0
2020-04-09,Contra Costa,13,1133247,696,505,0,505,7
2020-04-09,Del Norte,15,27424,2,2,0,2,0
2020-04-09,El Dorado,17,186661,44,25,0,25,0
2020-04-09,Fresno,19,978130,401,165,3,168,3
2020-04-09,Glenn,21,27897,4,2,0,2,0
2020-04-09,Humboldt,23,135768,57,36,0,36,0
2020-04-09,Imperial,25,180216,165,67,0,67,2
2020-04-09,Inyo,27,18085,12,11,0,11,0
2020-04-09,Kern,29,883053,584,241,0,241,2
2020-04-09,Kings,31,150075,31,5,1,6,0
2020-04-09,Lake,33,64148,5,1,0,1,0
2020-04-09,Lassen,35,31185,1,0,1,1,0
2020-04-09,Los Angeles,37,10098052,12969,7919,16,7935,220
2020-04-09,Madera,39,155013,57,28,0,28,2
2020-04-09,Marin,41,260295,170,126,1,127,7
2020-04-09,Mariposa,43,17540,0,0,0,0,0
2020-04-09,Mendocino,45,87422,4,4,0,4,0
2020-04-09,Merced,47,269075,97,41,0,41,3
2020-04-09,Modoc,49,8938,0,0,0,0,0
2020-04-09,Mono,51,14174,29,19,0,19,1
2020-04-09,Monterey,53,433212,115,70,0,70,3
2020-04-09,Napa,55,140530,45,27,0,27,2
2020-04-09,Nevada,57,99092,36,23,1,24,1
2020-04-09,Orange,59,3164182,1800,1105,3,1108,19
2020-04-09,Placer,61,380077,142,107,0,107,4
2020-04-09,Plumas,63,18699,4,3,0,3,0
2020-04-09,Riverside,65,2383286,2364,1083,5,1088,29
2020-04-09,Sacramento,67,1510023,874,601,0,601,21
2020-04-09,San Benito,69,59416,36,32,0,32,2
2020-04-09,San Bernardino,71,2135413,1283,717,0,717,27
2020-04-09,San Diego,73,3302833,2223,1630,0,1630,40
2020-04-09,San Francisco,75,870044,1113,748,0,748,8
2020-04-09,San Joaquin,77,732212,380,223,3,226,14
2020-04-09,San Luis Obispo,79,281455,138,93,0,93,1
2020-04-09,San Mateo,81,765935,901,630,2,632,23
2020-04-09,Santa Barbara,83,443738,399,232,0,232,2
2020-04-09,Santa Clara,85,1922200,1827,1301,1,1302,49
2020-04-09,Santa Cruz,87,273765,98,73,0,73,1
2020-04-09,Shasta,89,179085,29,22,0,22,3
2020-04-09,Sierra,91,2930,0,0,0,0,0
2020-04-09,Siskiyou,93,43540,5,4,0,4,0
2020-04-09,Solano,95,438530,189,118,0,118,2
2020-04-09,Sonoma,97,501317,176,113,0,113,1
2020-04-09,Stanislaus,99,539301,220,93,3,96,0
2020-04-09,Sutter,101,95872,23,17,0,17,2
2020-04-09,Tehama,103,63373,1,1,0,1,0
2020-04-09,Trinity,105,12862,0,0,0,0,0
2020-04-09,Tulare,107,460477,330,147,1,148,9
2020-04-09,Tuolumne,109,53932,3,0,0,0,0
2020-04-09,Ventura,111,848112,433,273,0,273,9
2020-04-09,Yolo,113,214977,121,59,0,59,3
2020-04-09,Yuba,115,75493,14,13,0,13,0
2020-04-08,Alameda,1,1643700,1016,594,0,594,15
2020-04-08,Alpine,3,1148,1,1,0,1,0
2020-04-08,Amador,5,37829,7,2,0,2,0
2020-04-08,Butte,7,227075,17,11,0,11,0
2020-04-08,Calaveras,9,45235,10,5,0,5,0
2020-04-08,Colusa,11,21464,3,3,0,3,0
2020-04-08,Contra Costa,13,1133247,683,481,0,481,7
2020-04-08,Del Norte,15,27424,2,2,0,2,0
2020-04-08,El Dorado,17,186661,44,25,0,25,0
2020-04-08,Fresno,19,978130,382,151,3,154,3
2020-04-08,Glenn,21,27897,4,2,0,2,0
2020-04-08,Humboldt,23,135768,57,40,0,40,0
2020-04-08,Imperial,25,180216,154,59,0,59,2
2020-04-08,Inyo,27,18085,12,11,0,11,0
2020-04-08,Kern,29,883053,543,198,0,198,2
2020-04-08,Kings,31,150075,31,5,1,6,0
2020-04-08,Lake,33,64148,5,1,0,1,0
2020-04-08,Lassen,35,31185,1,0,1,1,0
2020-04-08,Los Angeles,37,10098052,12369,7505,16,7521,196
2020-04-08,Madera,39,155013,56,28,0,28,2
2020-04-08,Marin,41,260295,164,125,1,126,7
2020-04-08,Mariposa,43,17540,0,0,0,0,0
2020-04-08,Mendocino,45,87422,4,4,0,4,0
2020-04-08,Merced,47,269075,82,35,0,35,1
2020-04-08,Modoc,49,8938,0,0,0,0,0
2020-04-08,Mono,51,14174,29,19,0,19,1
2020-04-08,Monterey,53,433212,106,68,0,68,3
2020-04-08,Napa,55,140530,43,21,0,21,2
2020-04-08,Nevada,57,99092,36,21,1,22,1
2020-04-08,Orange,59,3164182,1739,1034,3,1037,19
2020-04-08,Placer,61,380077,142,102,0,102,4
2020-04-08,Plumas,63,18699,4,3,0,3,0
2020-04-08,Riverside,65,2383286,2210,974,5,979,28
2020-04-08,Sacramento,67,1510023,840,565,0,565,21
2020-04-08,San Benito,69,59416,36,31,0,31,2
2020-04-08,San Bernardino,71,2135413,1226,635,0,635,22
2020-04-08,San Diego,73,3302833,2149,1532,0,1532,36
2020-04-08,San Francisco,75,870044,1045,687,0,687,7
2020-04-08,San Joaquin,77,732212,363,211,3,214,12
2020-04-08,San Luis Obispo,79,281455,136,90,0,90,1
2020-04-08,San Mateo,81,765935,886,608,2,610,22
2020-04-08,Santa Barbara,83,443738,381,221,0,221,2
2020-04-08,Santa Clara,85,1922200,1783,1257,1,1258,47
2020-04-08,Santa Cruz,87,273765,97,69,0,69,1
2020-04-08,Shasta,89,179085,29,18,0,18,3
2020-04-08,Sierra,91,2930,0,0,0,0,0
2020-04-08,Siskiyou,93,43540,5,4,0,4,0
2020-04-08,Solano,95,438530,176,111,0,111,2
2020-04-08,Sonoma,97,501317,171,107,0,107,1
2020-04-08,Stanislaus,99,539301,204,86,3,89,0
2020-04-08,Sutter,101,95872,22,17,0,17,2
2020-04-08,Tehama,103,63373,1,1,0,1,0
2020-04-08,Trinity,105,12862,0,0,0,0,0
2020-04-08,Tulare,107,460477,301,145,1,146,6
2020-04-08,Tuolumne,109,53932,3,0,0,0,0
2020-04-08,Ventura,111,848112,424,263,0,263,7
2020-04-08,Yolo,113,214977,104,56,0,56,3
2020-04-08,Yuba,115,75493,14,10,0,10,0
2020-04-07,Alameda,1,1643700,981,560,0,560,14
2020-04-07,Alpine,3,1148,1,1,0,1,0
2020-04-07,Amador,5,37829,7,2,0,2,0
2020-04-07,Butte,7,227075,16,11,0,11,0
2020-04-07,Calaveras,9,45235,9,5,0,5,0
2020-04-07,Colusa,11,21464,3,2,0,2,0
2020-04-07,Contra Costa,13,1133247,663,471,0,471,7
2020-04-07,Del Norte,15,27424,2,2,0,2,0
2020-04-07,El Dorado,17,186661,43,22,0,22,0
2020-04-07,Fresno,19,978130,367,138,3,141,3
2020-04-07,Glenn,21,27897,4,2,0,2,0
2020-04-07,Humboldt,23,135768,56,40,0,40,0
2020-04-07,Imperial,25,180216,136,53,0,53,2
2020-04-07,Inyo,27,18085,12,11,0,11,0
2020-04-07,Kern,29,883053,500,134,0,134,2
2020-04-07,Kings,31,150075,29,5,1,6,0
2020-04-07,Lake,33,64148,4,1,0,1,0
2020-04-07,Lassen,35,31185,1,0,1,1,0
2020-04-07,Los Angeles,37,10098052,11719,6885,16,6901,170
2020-04-07,Madera,39,155013,55,28,0,28,2
2020-04-07,Marin,41,260295,162,122,1,123,7
2020-04-07,Mariposa,43,17540,0,0,0,0,0
2020-04-07,Mendocino,45,87422,4,4,0,4,0
2020-04-07,Merced,47,269075,67,27,0,27,1
2020-04-07,Modoc,49,8938,0,0,0,0,0
2020-04-07,Mono,51,14174,28,18,0,18,1
2020-04-07,Monterey,53,433212,98,63,0,63,2
2020-04-07,Napa,55,140530,41,18,0,18,2
2020-04-07,Nevada,57,99092,36,20,1,21,1
2020-04-07,Orange,59,3164182,1692,971,3,974,19
2020-04-07,Placer,61,380077,137,94,0,94,3
2020-04-07,Plumas,63,18699,4,3,0,3,0
2020-04-07,Riverside,65,2383286,2054,905,5,910,25
2020-04-07,Sacramento,67,1510023,810,513,0,513,18
2020-04-07,San Benito,69,59416,36,26,0,26,2
2020-04-07,San Bernardino,71,2135413,1159,554,0,554,19
2020-04-07,San Diego,73,3302833,2072,1456,0,1456,31
2020-04-07,San Francisco,75,870044,985,636,0,636,6
2020-04-07,San Joaquin,77,732212,345,198,3,201,12
2020-04-07,San Luis Obispo,79,281455,131,87,0,87,1
2020-04-07,San Mateo,81,765935,865,573,2,575,22
2020-04-07,Santa Barbara,83,443738,366,209,0,209,2
2020-04-07,Santa Clara,85,1922200,1715,1193,1,1194,46
2020-04-07,Santa Cruz,87,273765,97,67,0,67,1
2020-04-07,Shasta,89,179085,28,16,0,16,3
2020-04-07,Sierra,91,2930,0,0,0,0,0
2020-04-07,Siskiyou,93,43540,5,4,0,4,0
2020-04-07,Solano,95,438530,171,99,0,99,1
2020-04-07,Sonoma,97,501317,168,102,0,102,1
2020-04-07,Stanislaus,99,539301,187,83,3,86,0
2020-04-07,Sutter,101,95872,22,16,0,16,2
2020-04-07,Tehama,103,63373,1,1,0,1,0
2020-04-07,Trinity,105,12862,0,0,0,0,0
2020-04-07,Tulare,107,460477,274,144,1,145,5
2020-04-07,Tuolumne,109,53932,3,1,0,1,0
2020-04-07,Ventura,111,848112,407,247,0,247,6
2020-04-07,Yolo,113,214977,97,51,0,51,2
2020-04-07,Yuba,115,75493,14,10,0,10,0
2020-04-06,Alameda,1,1643700,951,527,0,527,13
2020-04-06,Alpine,3,1148,1,1,0,1,0
2020-04-06,Amador,5,37829,6,2,0,2,0
2020-04-06,Butte,7,227075,15,11,0,11,0
2020-04-06,Calaveras,9,45235,9,4,0,4,0
2020-04-06,Colusa,11,21464,3,1,0,1,0
2020-04-06,Contra Costa,13,1133247,638,447,0,447,7
2020-04-06,Del Norte,15,27424,2,2,0,2,0
2020-04-06,El Dorado,17,186661,41,23,0,23,0
2020-04-06,Fresno,19,978130,347,122,3,125,1
2020-04-06,Glenn,21,27897,4,2,0,2,0
2020-04-06,Humboldt,23,135768,55,37,0,37,0
2020-04-06,Imperial,25,180216,129,47,0,47,1
2020-04-06,Inyo,27,18085,11,11,0,11,0
2020-04-06,Kern,29,883053,463,117,0,117,2
2020-04-06,Kings,31,150075,29,3,1,4,0
2020-04-06,Lake,33,64148,4,1,0,1,0
2020-04-06,Lassen,35,31185,1,0,1,1,0
2020-04-06,Los Angeles,37,10098052,10987,6346,16,6362,145
2020-04-06,Madera,39,155013,53,29,0,29,2
2020-04-06,Marin,41,260295,159,119,1,120,7
2020-04-06,Mariposa,43,17540,0,0,0,0,0
2020-04-06,Mendocino,45,87422,4,4,0,4,0
2020-04-06,Merced,47,269075,60,25,0,25,1
2020-04-06,Modoc,49,8938,0,0,0,0,0
2020-04-06,Mono,51,14174,28,18,0,18,1
2020-04-06,Monterey,53,433212,93,62,0,62,2
2020-04-06,Napa,55,140530,41,18,0,18,2
2020-04-06,Nevada,57,99092,36,19,1,20,1
2020-04-06,Orange,59,3164182,1648,910,2,912,17
2020-04-06,Placer,61,380077,137,90,0,90,3
2020-04-06,Plumas,63,18699,4,2,0,2,0
2020-04-06,Riverside,65,2383286,1928,854,5,859,17
2020-04-06,Sacramento,67,1510023,780,448,0,448,15
2020-04-06,San Benito,69,59416,34,25,0,25,1
2020-04-06,San Bernardino,71,2135413,1099,550,0,550,13
2020-04-06,San Diego,73,3302833,1990,1406,0,1406,19
2020-04-06,San Francisco,75,870044,946,586,0,586,6
2020-04-06,San Joaquin,77,732212,330,191,3,194,10
2020-04-06,San Luis Obispo,79,281455,129,85,0,85,1
2020-04-06,San Mateo,81,765935,847,569,2,571,20
2020-04-06,Santa Barbara,83,443738,354,189,0,189,2
2020-04-06,Santa Clara,85,1922200,1664,1128,1,1129,43
2020-04-06,Santa Cruz,87,273765,95,65,0,65,1
2020-04-06,Shasta,89,179085,28,16,0,16,3
2020-04-06,Sierra,91,2930,0,0,0,0,0
2020-04-06,Siskiyou,93,43540,4,4,0,4,0
2020-04-06,Solano,95,438530,164,95,0,95,1
2020-04-06,Sonoma,97,501317,167,102,0,102,1
2020-04-06,Stanislaus,99,539301,171,72,3,75,0
2020-04-06,Sutter,101,95872,22,14,0,14,2
2020-04-06,Tehama,103,63373,1,1,0,1,0
2020-04-06,Trinity,105,12862,0,0,0,0,0
2020-04-06,Tulare,107,460477,262,126,1,127,5
2020-04-06,Tuolumne,109,53932,3,1,0,1,0
2020-04-06,Ventura,111,848112,389,234,0,234,6
2020-04-06,Yolo,113,214977,93,43,0,43,1
2020-04-06,Yuba,115,75493,14,8,0,8,0
2020-04-05,Alameda,1,1643700,909,475,0,475,12
2020-04-05,Alpine,3,1148,1,1,0,1,0
2020-04-05,Amador,5,37829,6,2,0,2,0
2020-04-05,Butte,7,227075,15,10,0,10,0
2020-04-05,Calaveras,9,45235,9,3,0,3,0
2020-04-05,Colusa,11,21464,3,1,0,1,0
2020-04-05,Contra Costa,13,1133247,621,415,0,415,6
2020-04-05,Del Norte,15,27424,2,1,0,1,0
2020-04-05,El Dorado,17,186661,40,19,0,19,0
2020-04-05,Fresno,19,978130,314,102,3,105,1
2020-04-05,Glenn,21,27897,4,2,0,2,0
2020-04-05,Humboldt,23,135768,55,29,0,29,0
2020-04-05,Imperial,25,180216,121,42,0,42,1
2020-04-05,Inyo,27,18085,11,10,0,10,0
2020-04-05,Kern,29,883053,409,109,0,109,2
2020-04-05,Kings,31,150075,28,4,1,5,0
2020-04-05,Lake,33,64148,4,0,0,0,0
2020-04-05,Lassen,35,31185,1,0,1,1,0
2020-04-05,Los Angeles,37,10098052,10417,5892,16,5908,130
2020-04-05,Madera,39,155013,52,27,0,27,2
2020-04-05,Marin,41,260295,159,113,1,114,6
2020-04-05,Mariposa,43,17540,0,0,0,0,0
2020-04-05,Mendocino,45,87422,4,4,0,4,0
2020-04-05,Merced,47,269075,53,16,0,16,0
2020-04-05,Modoc,49,8938,0,0,0,0,0
2020-04-05,Mono,51,14174,28,18,0,18,1
2020-04-05,Monterey,53,433212,86,61,0,61,2
2020-04-05,Napa,55,140530,39,15,0,15,2
2020-04-05,Nevada,57,99092,36,19,1,20,1
2020-04-05,Orange,59,3164182,1591,820,2,822,15
2020-04-05,Placer,61,380077,134,86,0,86,3
2020-04-05,Plumas,63,18699,3,2,0,2,0
2020-04-05,Riverside,65,2383286,1799,669,5,674,17
2020-04-05,Sacramento,67,1510023,750,393,0,393,11
2020-04-05,San Benito,69,59416,34,22,0,22,1
2020-04-05,San Bernardino,71,2135413,1026,375,0,375,13
2020-04-05,San Diego,73,3302833,1908,1328,0,1328,19
2020-04-05,San Francisco,75,870044,898,559,0,559,6
2020-04-05,San Joaquin,77,732212,315,179,3,182,10
2020-04-05,San Luis Obispo,79,281455,127,83,0,83,1
2020-04-05,San Mateo,81,765935,827,528,2,530,19
2020-04-05,Santa Barbara,83,443738,334,171,0,171,1
2020-04-05,Santa Clara,85,1922200,1620,1052,1,1053,42
2020-04-05,Santa Cruz,87,273765,95,59,0,59,1
2020-04-05,Shasta,89,179085,27,11,0,11,2
2020-04-05,Sierra,91,2930,0,0,0,0,0
2020-04-05,Siskiyou,93,43540,4,3,0,3,0
2020-04-05,Solano,95,438530,160,78,0,78,1
2020-04-05,Sonoma,97,501317,165,88,0,88,1
2020-04-05,Stanislaus,99,539301,157,51,3,54,0
2020-04-05,Sutter,101,95872,22,14,0,14,1
2020-04-05,Tehama,103,63373,1,1,0,1,0
2020-04-05,Trinity,105,12862,0,0,0,0,0
2020-04-05,Tulare,107,460477,230,81,1,82,4
2020-04-05,Tuolumne,109,53932,3,1,0,1,0
2020-04-05,Ventura,111,848112,375,196,0,196,6
2020-04-05,Yolo,113,214977,75,37,0,37,2
2020-04-05,Yuba,115,75493,14,7,0,7,0
2020-04-04,Alameda,1,1643700,886,468,0,468,12
2020-04-04,Alpine,3,1148,1,1,0,1,0
2020-04-04,Amador,5,37829,5,2,0,2,0
2020-04-04,Butte,7,227075,15,10,0,10,0
2020-04-04,Calaveras,9,45235,9,3,0,3,0
2020-04-04,Colusa,11,21464,3,1,0,1,0
2020-04-04,Contra Costa,13,1133247,613,382,0,382,5
2020-04-04,Del Norte,15,27424,2,1,0,1,0
2020-04-04,El Dorado,17,186661,40,19,0,19,0
2020-04-04,Fresno,19,978130,305,102,3,105,1
2020-04-04,Glenn,21,27897,4,2,0,2,0
2020-04-04,Humboldt,23,135768,55,29,0,29,0
2020-04-04,Imperial,25,180216,120,42,0,42,1
2020-04-04,Inyo,27,18085,11,10,0,10,0
2020-04-04,Kern,29,883053,380,103,0,103,2
2020-04-04,Kings,31,150075,28,3,1,4,0
2020-04-04,Lake,33,64148,4,0,0,0,0
2020-04-04,Lassen,35,31185,1,0,1,1,0
2020-04-04,Los Angeles,37,10098052,9802,5275,16,5291,117
2020-04-04,Madera,39,155013,50,27,0,27,2
2020-04-04,Marin,41,260295,157,111,0,111,6
2020-04-04,Mariposa,43,17540,0,0,0,0,0
2020-04-04,Mendocino,45,87422,4,4,0,4,0
2020-04-04,Merced,47,269075,49,11,0,11,0
2020-04-04,Modoc,49,8938,0,0,0,0,0
2020-04-04,Mono,51,14174,28,18,0,18,1
2020-04-04,Monterey,53,433212,83,61,0,61,2
2020-04-04,Napa,55,140530,39,15,0,15,2
2020-04-04,Nevada,57,99092,36,19,1,20,1
2020-04-04,Orange,59,3164182,1549,781,1,782,15
2020-04-04,Placer,61,380077,133,87,0,87,2
2020-04-04,Plumas,63,18699,3,2,0,2,0
2020-04-04,Riverside,65,2383286,1697,652,5,657,15
2020-04-04,Sacramento,67,1510023,732,393,0,393,11
2020-04-04,San Benito,69,59416,34,22,0,22,1
2020-04-04,San Bernardino,71,2135413,978,373,0,373,13
2020-04-04,San Diego,73,3302833,1860,1211,0,1211,18
2020-04-04,San Francisco,75,870044,860,537,0,537,6
2020-04-04,San Joaquin,77,732212,292,171,3,174,10
2020-04-04,San Luis Obispo,79,281455,127,82,0,82,0
2020-04-04,San Mateo,81,765935,815,520,2,522,17
2020-04-04,Santa Barbara,83,443738,325,167,0,167,1
2020-04-04,Santa Clara,85,1922200,1570,1045,1,1046,39
2020-04-04,Santa Cruz,87,273765,95,56,0,56,1
2020-04-04,Shasta,89,179085,26,11,0,11,2
2020-04-04,Sierra,91,2930,0,0,0,0,0
2020-04-04,Siskiyou,93,43540,4,3,0,3,0
2020-04-04,Solano,95,438530,155,79,0,79,1
2020-04-04,Sonoma,97,501317,162,88,0,88,1
2020-04-04,Stanislaus,99,539301,146,51,3,54,0
2020-04-04,Sutter,101,95872,22,14,0,14,1
2020-04-04,Tehama,103,63373,1,1,0,1,0
2020-04-04,Trinity,105,12862,0,0,0,0,0
2020-04-04,Tulare,107,460477,216,79,1,80,4
2020-04-04,Tuolumne,109,53932,3,1,0,1,0
2020-04-04,Ventura,111,848112,362,194,0,194,6
2020-04-04,Yolo,113,214977,73,40,0,40,2
2020-04-04,Yuba,115,75493,13,7,0,7,0
2020-04-03,Alameda,1,1643700,850,395,0,395,11
2020-04-03,Alpine,3,1148,1,1,0,1,0
2020-04-03,Amador,5,37829,5,2,0,2,0
2020-04-03,Butte,7,227075,15,8,0,8,0
2020-04-03,Calaveras,9,45235,9,3,0,3,0
2020-04-03,Colusa,11,21464,3,1,0,1,0
2020-04-03,Contra Costa,13,1133247,590,327,0,327,5
2020-04-03,Del Norte,15,27424,2,1,0,1,0
2020-04-03,El Dorado,17,186661,38,16,0,16,0
2020-04-03,Fresno,19,978130,293,98,3,101,1
2020-04-03,Glenn,21,27897,4,2,0,2,0
2020-04-03,Humboldt,23,135768,55,34,0,34,0
2020-04-03,Imperial,25,180216,111,35,0,35,0
2020-04-03,Inyo,27,18085,11,10,0,10,0
2020-04-03,Kern,29,883053,354,87,0,87,1
2020-04-03,Kings,31,150075,26,3,1,4,0
2020-04-03,Lake,33,64148,3,0,0,0,0
2020-04-03,Lassen,35,31185,1,0,1,1,0
2020-04-03,Los Angeles,37,10098052,9187,4566,16,4582,91
2020-04-03,Madera,39,155013,49,28,0,28,2
2020-04-03,Marin,41,260295,155,106,0,106,6
2020-04-03,Mariposa,43,17540,0,0,0,0,0
2020-04-03,Mendocino,45,87422,4,4,0,4,0
2020-04-03,Merced,47,269075,46,9,0,9,0
2020-04-03,Modoc,49,8938,0,0,0,0,0
2020-04-03,Mono,51,14174,28,18,0,18,1
2020-04-03,Monterey,53,433212,80,58,0,58,2
2020-04-03,Napa,55,140530,38,13,0,13,1
2020-04-03,Nevada,57,99092,36,19,1,20,1
2020-04-03,Orange,59,3164182,1510,713,1,714,13
2020-04-03,Placer,61,380077,129,76,0,76,2
2020-04-03,Plumas,63,18699,3,2,0,2,0
2020-04-03,Riverside,65,2383286,1618,540,5,545,14
2020-04-03,Sacramento,67,1510023,710,363,0,363,11
2020-04-03,San Benito,69,59416,34,22,0,22,1
2020-04-03,San Bernardino,71,2135413,933,356,0,356,11
2020-04-03,San Diego,73,3302833,1800,1114,0,1114,17
2020-04-03,San Francisco,75,870044,835,506,0,506,6
2020-04-03,San Joaquin,77,732212,280,162,3,165,10
2020-04-03,San Luis Obispo,79,281455,127,82,0,82,0
2020-04-03,San Mateo,81,765935,798,474,2,476,13
2020-04-03,Santa Barbara,83,443738,314,154,0,154,1
2020-04-03,Santa Clara,85,1922200,1536,983,1,984,39
2020-04-03,Santa Cruz,87,273765,95,52,0,52,1
2020-04-03,Shasta,89,179085,26,10,0,10,1
2020-04-03,Sierra,91,2930,0,0,0,0,0
2020-04-03,Siskiyou,93,43540,4,3,0,3,0
2020-04-03,Solano,95,438530,147,72,0,72,1
2020-04-03,Sonoma,97,501317,162,84,0,84,1
2020-04-03,Stanislaus,99,539301,140,48,3,51,0
2020-04-03,Sutter,101,95872,22,12,0,12,1
2020-04-03,Tehama,103,63373,1,1,0,1,0
2020-04-03,Trinity,105,12862,0,0,0,0,0
2020-04-03,Tulare,107,460477,203,73,1,74,3
2020-04-03,Tuolumne,109,53932,3,1,0,1,0
2020-04-03,Ventura,111,848112,352,186,0,186,6
2020-04-03,Yolo,113,214977,72,33,0,33,1
2020-04-03,Yuba,115,75493,13,6,0,6,0
2020-04-02,Alameda,1,1643700,799,345,0,345,10
2020-04-02,Alpine,3,1148,1,1,0,1,0
2020-04-02,Amador,5,37829,5,2,0,2,0
2020-04-02,Butte,7,227075,15,7,0,7,0
2020-04-02,Calaveras,9,45235,7,3,0,3,0
2020-04-02,Colusa,11,21464,3,1,0,1,0
2020-04-02,Contra Costa,13,1133247,560,297,0,297,3
2020-04-02,Del Norte,15,27424,2,0,0,0,0
2020-04-02,El Dorado,17,186661,36,16,0,16,0
2020-04-02,Fresno,19,978130,279,92,3,95,0
2020-04-02,Glenn,21,27897,3,2,0,2,0
2020-04-02,Humboldt,23,135768,51,23,0,23,0
2020-04-02,Imperial,25,180216,107,24,0,24,0
2020-04-02,Inyo,27,18085,10,8,0,8,0
2020-04-02,Kern,29,883053,328,74,0,74,0
2020-04-02,Kings,31,150075,26,3,1,4,0
2020-04-02,Lake,33,64148,3,0,0,0,0
2020-04-02,Lassen,35,31185,1,0,1,1,0
2020-04-02,Los Angeles,37,10098052,8355,4040,16,4056,79
2020-04-02,Madera,39,155013,47,25,0,25,1
2020-04-02,Marin,41,260295,149,102,0,102,1
2020-04-02,Mariposa,43,17540,0,0,0,0,0
2020-04-02,Mendocino,45,87422,4,4,0,4,0
2020-04-02,Merced,47,269075,41,9,0,9,0
2020-04-02,Modoc,49,8938,0,0,0,0,0
2020-04-02,Mono,51,14174,28,16,0,16,1
2020-04-02,Monterey,53,433212,79,50,0,50,2
2020-04-02,Napa,55,140530,38,13,0,13,0
2020-04-02,Nevada,57,99092,35,17,1,18,0
2020-04-02,Orange,59,3164182,1458,640,1,641,12
2020-04-02,Placer,61,380077,128,72,0,72,2
2020-04-02,Plumas,63,18699,3,1,0,1,0
2020-04-02,Riverside,65,2383286,1502,438,5,443,13
2020-04-02,Sacramento,67,1510023,692,322,0,322,9
2020-04-02,San Benito,69,59416,32,18,0,18,1
2020-04-02,San Bernardino,71,2135413,878,335,0,335,8
2020-04-02,San Diego,73,3302833,1733,968,0,968,16
2020-04-02,San Francisco,75,870044,808,473,0,473,6
2020-04-02,San Joaquin,77,732212,262,148,3,151,9
2020-04-02,San Luis Obispo,79,281455,122,79,0,79,0
2020-04-02,San Mateo,81,765935,777,423,2,425,13
2020-04-02,Santa Barbara,83,443738,301,125,0,125,1
2020-04-02,Santa Clara,85,1922200,1486,908,1,909,38
2020-04-02,Santa Cruz,87,273765,93,49,0,49,1
2020-04-02,Shasta,89,179085,25,7,0,7,1
2020-04-02,Sierra,91,2930,0,0,0,0,0
2020-04-02,Siskiyou,93,43540,4,3,0,3,0
2020-04-02,Solano,95,438530,137,65,0,65,0
2020-04-02,Sonoma,97,501317,158,76,0,76,1
2020-04-02,Stanislaus,99,539301,129,40,3,43,0
2020-04-02,Sutter,101,95872,21,10,0,10,1
2020-04-02,Tehama,103,63373,1,1,0,1,0
2020-04-02,Trinity,105,12862,0,0,0,0,0
2020-04-02,Tulare,107,460477,176,64,1,65,1
2020-04-02,Tuolumne,109,53932,3,1,0,1,0
2020-04-02,Ventura,111,848112,334,178,0,178,5
2020-04-02,Yolo,113,214977,70,29,0,29,1
2020-04-02,Yuba,115,75493,10,5,0,5,0
2020-04-01,Alameda,1,1643700,773,287,0,287,8
2020-04-01,Alpine,3,1148,1,1,0,1,0
2020-04-01,Amador,5,37829,5,1,0,1,0
2020-04-01,Butte,7,227075,15,6,0,6,0
2020-04-01,Calaveras,9,45235,6,3,0,3,0
2020-04-01,Colusa,11,21464,3,1,0,1,0
2020-04-01,Contra Costa,13,1133247,516,267,0,267,3
2020-04-01,Del Norte,15,27424,2,0,0,0,0
2020-04-01,El Dorado,17,186661,35,14,0,14,0
2020-04-01,Fresno,19,978130,260,75,2,77,0
2020-04-01,Glenn,21,27897,3,2,0,2,0
2020-04-01,Humboldt,23,135768,51,19,0,19,0
2020-04-01,Imperial,25,180216,100,25,0,25,0
2020-04-01,Inyo,27,18085,10,8,0,8,0
2020-04-01,Kern,29,883053,302,53,0,53,0
2020-04-01,Kings,31,150075,24,3,1,4,0
2020-04-01,Lake,33,64148,3,0,0,0,0
2020-04-01,Lassen,35,31185,1,0,1,1,0
2020-04-01,Los Angeles,37,10098052,7702,3502,16,3518,66
2020-04-01,Madera,39,155013,45,17,0,17,1
2020-04-01,Marin,41,260295,145,87,0,87,1
2020-04-01,Mariposa,43,17540,0,0,0,0,0
2020-04-01,Mendocino,45,87422,4,4,0,4,0
2020-04-01,Merced,47,269075,38,7,0,7,0
2020-04-01,Modoc,49,8938,0,0,0,0,0
2020-04-01,Mono,51,14174,28,12,0,12,1
2020-04-01,Monterey,53,433212,78,47,0,47,2
2020-04-01,Napa,55,140530,36,11,0,11,0
2020-04-01,Nevada,57,99092,35,15,1,16,0
2020-04-01,Orange,59,3164182,1405,579,1,580,11
2020-04-01,Placer,61,380077,127,52,0,52,2
2020-04-01,Plumas,63,18699,3,1,0,1,0
2020-04-01,Riverside,65,2383286,1334,306,5,311,11
2020-04-01,Sacramento,67,1510023,660,299,0,299,8
2020-04-01,San Benito,69,59416,29,14,0,14,1
2020-04-01,San Bernardino,71,2135413,828,245,0,245,5
2020-04-01,San Diego,73,3302833,1663,851,0,851,11
2020-04-01,San Francisco,75,870044,780,432,0,432,6
2020-04-01,San Joaquin,77,732212,251,132,3,135,8
2020-04-01,San Luis Obispo,79,281455,118,69,0,69,0
2020-04-01,San Mateo,81,765935,759,354,2,356,13
2020-04-01,Santa Barbara,83,443738,283,103,0,103,0
2020-04-01,Santa Clara,85,1922200,1446,805,1,806,33
2020-04-01,Santa Cruz,87,273765,88,44,0,44,1
2020-04-01,Shasta,89,179085,24,5,0,5,1
2020-04-01,Sierra,91,2930,0,0,0,0,0
2020-04-01,Siskiyou,93,43540,4,3,0,3,0
2020-04-01,Solano,95,438530,132,57,0,57,0
2020-04-01,Sonoma,97,501317,154,60,0,60,1
2020-04-01,Stanislaus,99,539301,118,29,3,32,0
2020-04-01,Sutter,101,95872,21,9,0,9,1
2020-04-01,Tehama,103,63373,1,0,0,0,0
2020-04-01,Trinity,105,12862,0,0,0,0,0
2020-04-01,Tulare,107,460477,141,43,1,44,1
2020-04-01,Tuolumne,109,53932,3,1,0,1,0
2020-04-01,Ventura,111,848112,321,154,0,154,5
2020-04-01,Yolo,113,214977,65,22,0,22,1
2020-04-01,Yuba,115,75493,9,5,0,5,0
2020-03-31,Alameda,1,1643700,705,269,0,269,7
2020-03-31,Alpine,3,1148,1,1,0,1,0
2020-03-31,Amador,5,37829,5,1,0,1,0
2020-03-31,Butte,7,227075,15,6,0,6,0
2020-03-31,Calaveras,9,45235,6,3,0,3,0
2020-03-31,Colusa,11,21464,3,1,0,1,0
2020-03-31,Contra Costa,13,1133247,491,246,0,246,3
2020-03-31,Del Norte,15,27424,1,0,0,0,0
2020-03-31,El Dorado,17,186661,31,14,0,14,0
2020-03-31,Fresno,19,978130,238,59,2,61,0
2020-03-31,Glenn,21,27897,3,2,0,2,0
2020-03-31,Humboldt,23,135768,51,18,0,18,0
2020-03-31,Imperial,25,180216,95,17,0,17,0
2020-03-31,Inyo,27,18085,10,8,0,8,0
2020-03-31,Kern,29,883053,279,47,0,47,0
2020-03-31,Kings,31,150075,22,2,1,3,0
2020-03-31,Lake,33,64148,1,0,0,0,0
2020-03-31,Lassen,35,31185,1,0,1,1,0
2020-03-31,Los Angeles,37,10098052,7038,3001,16,3017,53
2020-03-31,Madera,39,155013,44,17,0,17,1
2020-03-31,Marin,41,260295,136,85,0,85,1
2020-03-31,Mariposa,43,17540,0,0,0,0,0
2020-03-31,Mendocino,45,87422,4,4,0,4,0
2020-03-31,Merced,47,269075,33,6,0,6,0
2020-03-31,Modoc,49,8938,0,0,0,0,0
2020-03-31,Mono,51,14174,26,12,0,12,0
2020-03-31,Monterey,53,433212,76,43,0,43,2
2020-03-31,Napa,55,140530,35,9,0,9,0
2020-03-31,Nevada,57,99092,35,15,1,16,0
2020-03-31,Orange,59,3164182,1337,506,1,507,7
2020-03-31,Placer,61,380077,120,49,0,49,2
2020-03-31,Plumas,63,18699,1,0,0,0,0
2020-03-31,Riverside,65,2383286,1187,284,5,289,8
2020-03-31,Sacramento,67,1510023,608,271,0,271,8
2020-03-31,San Benito,69,59416,29,14,0,14,1
2020-03-31,San Bernardino,71,2135413,744,193,0,193,5
2020-03-31,San Diego,73,3302833,1581,736,0,736,9
2020-03-31,San Francisco,75,870044,745,404,0,404,5
2020-03-31,San Joaquin,77,732212,235,122,3,125,7
2020-03-31,San Luis Obispo,79,281455,115,67,0,67,0
2020-03-31,San Mateo,81,765935,740,297,2,299,12
2020-03-31,Santa Barbara,83,443738,266,89,0,89,0
2020-03-31,Santa Clara,85,1922200,1397,777,1,778,30
2020-03-31,Santa Cruz,87,273765,82,40,0,40,1
2020-03-31,Shasta,89,179085,21,5,0,5,1
2020-03-31,Sierra,91,2930,0,0,0,0,0
2020-03-31,Siskiyou,93,43540,4,3,0,3,0
2020-03-31,Solano,95,438530,118,56,0,56,0
2020-03-31,Sonoma,97,501317,149,58,0,58,1
2020-03-31,Stanislaus,99,539301,103,28,3,31,0
2020-03-31,Sutter,101,95872,21,8,0,8,0
2020-03-31,Tehama,103,63373,1,0,0,0,0
2020-03-31,Trinity,105,12862,0,0,0,0,0
2020-03-31,Tulare,107,460477,121,42,1,43,1
2020-03-31,Tuolumne,109,53932,3,1,0,1,0
2020-03-31,Ventura,111,848112,310,143,0,143,4
2020-03-31,Yolo,113,214977,58,21,0,21,1
2020-03-31,Yuba,115,75493,9,5,0,5,0
2020-03-30,Alameda,1,1643700,665,250,0,250,7
2020-03-30,Alpine,3,1148,1,1,0,1,0
2020-03-30,Amador,5,37829,5,1,0,1,0
2020-03-30,Butte,7,227075,13,5,0,5,0
2020-03-30,Calaveras,9,45235,6,3,0,3,0
2020-03-30,Colusa,11,21464,3,1,0,1,0
2020-03-30,Contra Costa,13,1133247,465,212,0,212,3
2020-03-30,Del Norte,15,27424,0,0,0,0,0
2020-03-30,El Dorado,17,186661,31,11,0,11,0
2020-03-30,Fresno,19,978130,214,46,2,48,0
2020-03-30,Glenn,21,27897,3,2,0,2,0
2020-03-30,Humboldt,23,135768,49,11,0,11,0
2020-03-30,Imperial,25,180216,91,9,0,9,0
2020-03-30,Inyo,27,18085,10,5,0,5,0
2020-03-30,Kern,29,883053,246,30,0,30,0
2020-03-30,Kings,31,150075,22,1,1,2,0
2020-03-30,Lake,33,64148,1,0,0,0,0
2020-03-30,Lassen,35,31185,1,0,0,0,0
2020-03-30,Los Angeles,37,10098052,6386,2467,16,2483,44
2020-03-30,Madera,39,155013,43,14,0,14,1
2020-03-30,Marin,41,260295,129,78,0,78,0
2020-03-30,Mariposa,43,17540,0,0,0,0,0
2020-03-30,Mendocino,45,87422,4,2,0,2,0
2020-03-30,Merced,47,269075,29,6,0,6,0
2020-03-30,Modoc,49,8938,0,0,0,0,0
2020-03-30,Mono,51,14174,26,11,0,11,0
2020-03-30,Monterey,53,433212,71,41,0,41,1
2020-03-30,Napa,55,140530,34,9,0,9,0
2020-03-30,Nevada,57,99092,34,14,1,15,0
2020-03-30,Orange,59,3164182,1273,418,1,419,5
2020-03-30,Placer,61,380077,117,44,0,44,2
2020-03-30,Plumas,63,18699,1,0,0,0,0
2020-03-30,Riverside,65,2383286,1106,204,5,209,7
2020-03-30,Sacramento,67,1510023,584,238,0,238,8
2020-03-30,San Benito,69,59416,29,11,0,11,1
2020-03-30,San Bernardino,71,2135413,700,145,0,145,4
2020-03-30,San Diego,73,3302833,1511,605,0,605,7
2020-03-30,San Francisco,75,870044,705,368,0,368,5
2020-03-30,San Joaquin,77,732212,228,112,3,115,5
2020-03-30,San Luis Obispo,79,281455,113,62,0,62,0
2020-03-30,San Mateo,81,765935,716,257,2,259,11
2020-03-30,Santa Barbara,83,443738,256,79,0,79,0
2020-03-30,Santa Clara,85,1922200,1366,745,1,746,31
2020-03-30,Santa Cruz,87,273765,79,36,0,36,1
2020-03-30,Shasta,89,179085,20,4,0,4,1
2020-03-30,Sierra,91,2930,0,0,0,0,0
2020-03-30,Siskiyou,93,43540,4,2,0,2,0
2020-03-30,Solano,95,438530,112,50,0,50,0
2020-03-30,Sonoma,97,501317,146,57,0,57,1
2020-03-30,Stanislaus,99,539301,96,28,3,31,0
2020-03-30,Sutter,101,95872,20,6,0,6,0
2020-03-30,Tehama,103,63373,1,0,0,0,0
2020-03-30,Trinity,105,12862,0,0,0,0,0
2020-03-30,Tulare,107,460477,112,40,1,41,1
2020-03-30,Tuolumne,109,53932,3,1,0,1,0
2020-03-30,Ventura,111,848112,299,118,0,118,2
2020-03-30,Yolo,113,214977,56,17,0,17,1
2020-03-30,Yuba,115,75493,8,5,0,5,0
2020-03-29,Alameda,1,1643700,631,207,0,207,6
2020-03-29,Alpine,3,1148,1,0,0,0,0
2020-03-29,Amador,5,37829,5,1,0,1,0
2020-03-29,Butte,7,227075,13,4,0,4,0
2020-03-29,Calaveras,9,45235,6,2,0,2,0
2020-03-29,Colusa,11,21464,3,1,0,1,0
2020-03-29,Contra Costa,13,1133247,435,187,0,187,3
2020-03-29,Del Norte,15,27424,0,0,0,0,0
2020-03-29,El Dorado,17,186661,30,9,0,9,0
2020-03-29,Fresno,19,978130,191,31,2,33,0
2020-03-29,Glenn,21,27897,2,1,0,1,0
2020-03-29,Humboldt,23,135768,46,9,0,9,0
2020-03-29,Imperial,25,180216,85,9,0,9,0
2020-03-29,Inyo,27,18085,9,0,0,0,0
2020-03-29,Kern,29,883053,228,20,0,20,0
2020-03-29,Kings,31,150075,19,1,1,2,0
2020-03-29,Lake,33,64148,0,0,0,0,0
2020-03-29,Lassen,35,31185,1,0,0,0,0
2020-03-29,Los Angeles,37,10098052,5742,2119,16,2135,37
2020-03-29,Madera,39,155013,38,11,0,11,1
2020-03-29,Marin,41,260295,124,60,0,60,0
2020-03-29,Mariposa,43,17540,0,0,0,0,0
2020-03-29,Mendocino,45,87422,4,2,0,2,0
2020-03-29,Merced,47,269075,28,4,0,4,0
2020-03-29,Modoc,49,8938,0,0,0,0,0
2020-03-29,Mono,51,14174,26,8,0,8,0
2020-03-29,Monterey,53,433212,66,36,0,36,1
2020-03-29,Napa,55,140530,32,5,0,5,0
2020-03-29,Nevada,57,99092,32,13,1,14,0
2020-03-29,Orange,59,3164182,1200,343,1,344,2
2020-03-29,Placer,61,380077,116,35,0,35,2
2020-03-29,Plumas,63,18699,1,0,0,0,0
2020-03-29,Riverside,65,2383286,982,122,5,127,7
2020-03-29,Sacramento,67,1510023,544,217,0,217,7
2020-03-29,San Benito,69,59416,28,10,0,10,1
2020-03-29,San Bernardino,71,2135413,648,94,0,94,2
2020-03-29,San Diego,73,3302833,1439,521,0,521,7
2020-03-29,San Francisco,75,870044,661,333,0,333,5
2020-03-29,San Joaquin,77,732212,219,86,3,89,4
2020-03-29,San Luis Obispo,79,281455,108,55,0,55,0
2020-03-29,San Mateo,81,765935,691,234,2,236,12
2020-03-29,Santa Barbara,83,443738,245,52,0,52,0
2020-03-29,Santa Clara,85,1922200,1311,591,1,592,30
2020-03-29,Santa Cruz,87,273765,79,33,0,33,1
2020-03-29,Shasta,89,179085,19,4,0,4,1
2020-03-29,Sierra,91,2930,0,0,0,0,0
2020-03-29,Siskiyou,93,43540,4,2,0,2,0
2020-03-29,Solano,95,438530,103,48,0,48,0
2020-03-29,Sonoma,97,501317,144,35,0,35,1
2020-03-29,Stanislaus,99,539301,91,19,3,22,0
2020-03-29,Sutter,101,95872,17,6,0,6,0
2020-03-29,Tehama,103,63373,1,0,0,0,0
2020-03-29,Trinity,105,12862,0,0,0,0,0
2020-03-29,Tulare,107,460477,93,24,1,25,1
2020-03-29,Tuolumne,109,53932,2,1,0,1,0
2020-03-29,Ventura,111,848112,272,92,0,92,2
2020-03-29,Yolo,113,214977,51,13,0,13,1
2020-03-29,Yuba,115,75493,8,3,0,3,0
2020-03-28,Alameda,1,1643700,604,410,0,410,12
2020-03-28,Alpine,3,1148,1,0,0,0,0
2020-03-28,Amador,5,37829,5,2,0,2,0
2020-03-28,Butte,7,227075,13,8,0,8,0
2020-03-28,Calaveras,9,45235,6,4,0,4,0
2020-03-28,Colusa,11,21464,3,2,0,2,0
2020-03-28,Contra Costa,13,1133247,412,350,0,350,4
2020-03-28,Del Norte,15,27424,0,0,0,0,0
2020-03-28,El Dorado,17,186661,29,18,0,18,0
2020-03-28,Fresno,19,978130,181,62,2,64,0
2020-03-28,Glenn,21,27897,2,2,0,2,0
2020-03-28,Humboldt,23,135768,46,18,0,18,0
2020-03-28,Imperial,25,180216,80,18,0,18,0
2020-03-28,Inyo,27,18085,9,0,0,0,0
2020-03-28,Kern,29,883053,211,40,0,40,0
2020-03-28,Kings,31,150075,18,2,1,3,0
2020-03-28,Lake,33,64148,0,0,0,0,0
2020-03-28,Lassen,35,31185,1,0,0,0,0
2020-03-28,Los Angeles,37,10098052,5357,3600,15,3615,64
2020-03-28,Madera,39,155013,38,22,0,22,2
2020-03-28,Marin,41,260295,119,116,0,116,0
2020-03-28,Mariposa,43,17540,0,0,0,0,0
2020-03-28,Mendocino,45,87422,4,4,0,4,0
2020-03-28,Merced,47,269075,27,8,0,8,0
2020-03-28,Modoc,49,8938,0,0,0,0,0
2020-03-28,Mono,51,14174,24,12,0,12,0
2020-03-28,Monterey,53,433212,65,64,0,64,2
2020-03-28,Napa,55,140530,27,10,0,10,0
2020-03-28,Nevada,57,99092,32,22,1,23,0
2020-03-28,Orange,59,3164182,1164,656,1,657,4
2020-03-28,Placer,61,380077,111,70,0,70,2
2020-03-28,Plumas,63,18699,1,0,0,0,0
2020-03-28,Riverside,65,2383286,914,242,5,247,14
2020-03-28,Sacramento,67,1510023,526,406,0,406,14
2020-03-28,San Benito,69,59416,28,20,0,20,2
2020-03-28,San Bernardino,71,2135413,600,162,0,162,4
2020-03-28,San Diego,73,3302833,1380,980,0,980,14
2020-03-28,San Francisco,75,870044,637,600,0,600,6
2020-03-28,San Joaquin,77,732212,212,166,3,169,8
2020-03-28,San Luis Obispo,79,281455,106,104,0,104,0
2020-03-28,San Mateo,81,765935,671,462,2,464,17
2020-03-28,Santa Barbara,83,443738,234,98,0,98,0
2020-03-28,Santa Clara,85,1922200,1292,1174,1,1175,54
2020-03-28,Santa Cruz,87,273765,78,62,0,62,0
2020-03-28,Shasta,89,179085,19,8,0,8,2
2020-03-28,Sierra,91,2930,0,0,0,0,0
2020-03-28,Siskiyou,93,43540,4,4,0,4,0
2020-03-28,Solano,95,438530,99,96,0,96,0
2020-03-28,Sonoma,97,501317,142,70,0,70,2
2020-03-28,Stanislaus,99,539301,86,34,3,37,0
2020-03-28,Sutter,101,95872,17,6,0,6,0
2020-03-28,Tehama,103,63373,1,0,0,0,0
2020-03-28,Trinity,105,12862,0,0,0,0,0
2020-03-28,Tulare,107,460477,87,46,1,47,0
2020-03-28,Tuolumne,109,53932,2,2,0,2,0
2020-03-28,Ventura,111,848112,268,178,0,178,4
2020-03-28,Yolo,113,214977,50,26,0,26,2
2020-03-28,Yuba,115,75493,8,6,0,6,0
2020-03-27,Alameda,1,1643700,585,185,0,185,4
2020-03-27,Alpine,3,1148,1,0,0,0,0
2020-03-27,Amador,5,37829,4,1,0,1,0
2020-03-27,Butte,7,227075,11,4,0,4,0
2020-03-27,Calaveras,9,45235,6,2,0,2,0
2020-03-27,Colusa,11,21464,3,0,0,0,0
2020-03-27,Contra Costa,13,1133247,391,161,0,161,2
2020-03-27,Del Norte,15,27424,0,0,0,0,0
2020-03-27,El Dorado,17,186661,27,9,0,9,0
2020-03-27,Fresno,19,978130,170,29,1,30,0
2020-03-27,Glenn,21,27897,2,0,0,0,0
2020-03-27,Humboldt,23,135768,42,9,0,9,0
2020-03-27,Imperial,25,180216,75,9,0,9,0
2020-03-27,Inyo,27,18085,9,0,0,0,0
2020-03-27,Kern,29,883053,198,20,0,20,0
2020-03-27,Kings,31,150075,17,0,1,1,0
2020-03-27,Lake,33,64148,0,0,0,0,0
2020-03-27,Lassen,35,31185,1,0,0,0,0
2020-03-27,Los Angeles,37,10098052,4944,1474,15,1489,26
2020-03-27,Madera,39,155013,36,10,0,10,1
2020-03-27,Marin,41,260295,114,58,0,58,0
2020-03-27,Mariposa,43,17540,0,0,0,0,0
2020-03-27,Mendocino,45,87422,4,2,0,2,0
2020-03-27,Merced,47,269075,26,3,0,3,0
2020-03-27,Modoc,49,8938,0,0,0,0,0
2020-03-27,Mono,51,14174,24,6,0,6,0
2020-03-27,Monterey,53,433212,62,26,0,26,1
2020-03-27,Napa,55,140530,27,5,0,5,0
2020-03-27,Nevada,57,99092,32,6,1,7,0
2020-03-27,Orange,59,3164182,1112,299,1,300,2
2020-03-27,Placer,61,380077,108,33,0,33,1
2020-03-27,Plumas,63,18699,0,0,0,0,0
2020-03-27,Riverside,65,2383286,858,121,5,126,7
2020-03-27,Sacramento,67,1510023,503,163,0,163,6
2020-03-27,San Benito,69,59416,27,9,0,9,1
2020-03-27,San Bernardino,71,2135413,510,77,0,77,2
2020-03-27,San Diego,73,3302833,1323,419,0,419,5
2020-03-27,San Francisco,75,870044,612,285,0,285,2
2020-03-27,San Joaquin,77,732212,201,73,3,76,3
2020-03-27,San Luis Obispo,79,281455,104,46,0,46,0
2020-03-27,San Mateo,81,765935,645,213,2,215,7
2020-03-27,Santa Barbara,83,443738,218,37,0,37,0
2020-03-27,Santa Clara,85,1922200,1255,557,1,558,25
2020-03-27,Santa Cruz,87,273765,78,31,0,31,0
2020-03-27,Shasta,89,179085,16,3,0,3,1
2020-03-27,Sierra,91,2930,0,0,0,0,0
2020-03-27,Siskiyou,93,43540,4,2,0,2,0
2020-03-27,Solano,95,438530,93,48,0,48,0
2020-03-27,Sonoma,97,501317,134,35,0,35,1
2020-03-27,Stanislaus,99,539301,84,16,3,19,0
2020-03-27,Sutter,101,95872,16,2,0,2,0
2020-03-27,Tehama,103,63373,1,0,0,0,0
2020-03-27,Trinity,105,12862,0,0,0,0,0
2020-03-27,Tulare,107,460477,79,15,1,16,0
2020-03-27,Tuolumne,109,53932,2,1,0,1,0
2020-03-27,Ventura,111,848112,259,80,0,80,2
2020-03-27,Yolo,113,214977,49,13,0,13,1
2020-03-27,Yuba,115,75493,7,3,0,3,0
2020-03-26,Alameda,1,1643700,545,172,0,172,4
2020-03-26,Alpine,3,1148,1,0,0,0,0
2020-03-26,Amador,5,37829,4,1,0,1,0
2020-03-26,Butte,7,227075,11,4,0,4,0
2020-03-26,Calaveras,9,45235,6,2,0,2,0
2020-03-26,Colusa,11,21464,3,0,0,0,0
2020-03-26,Contra Costa,13,1133247,381,147,0,147,2
2020-03-26,Del Norte,15,27424,0,0,0,0,0
2020-03-26,El Dorado,17,186661,26,7,0,7,0
2020-03-26,Fresno,19,978130,161,25,1,26,0
2020-03-26,Glenn,21,27897,2,0,0,0,0
2020-03-26,Humboldt,23,135768,38,8,0,8,0
2020-03-26,Imperial,25,180216,71,8,0,8,0
2020-03-26,Inyo,27,18085,8,0,0,0,0
2020-03-26,Kern,29,883053,182,20,0,20,0
2020-03-26,Kings,31,150075,17,0,1,1,0
2020-03-26,Lake,33,64148,0,0,0,0,0
2020-03-26,Lassen,35,31185,1,0,0,0,0
2020-03-26,Los Angeles,37,10098052,4543,1075,15,1090,19
2020-03-26,Madera,39,155013,34,8,0,8,0
2020-03-26,Marin,41,260295,105,56,0,56,0
2020-03-26,Mariposa,43,17540,0,0,0,0,0
2020-03-26,Mendocino,45,87422,3,1,0,1,0
2020-03-26,Merced,47,269075,23,1,0,1,0
2020-03-26,Modoc,49,8938,0,0,0,0,0
2020-03-26,Mono,51,14174,23,5,0,5,0
2020-03-26,Monterey,53,433212,59,25,0,25,1
2020-03-26,Napa,55,140530,26,5,0,5,0
2020-03-26,Nevada,57,99092,32,7,1,8,0
2020-03-26,Orange,59,3164182,1050,279,1,280,1
2020-03-26,Placer,61,380077,104,34,0,34,1
2020-03-26,Plumas,63,18699,0,0,0,0,0
2020-03-26,Riverside,65,2383286,788,118,5,123,7
2020-03-26,Sacramento,67,1510023,470,147,0,147,5
2020-03-26,San Benito,69,59416,27,8,0,8,1
2020-03-26,San Bernardino,71,2135413,444,57,0,57,1
2020-03-26,San Diego,73,3302833,1256,299,0,299,2
2020-03-26,San Francisco,75,870044,585,261,0,261,1
2020-03-26,San Joaquin,77,732212,190,69,3,72,3
2020-03-26,San Luis Obispo,79,281455,99,38,0,38,0
2020-03-26,San Mateo,81,765935,612,122,2,124,5
2020-03-26,Santa Barbara,83,443738,202,33,0,33,0
2020-03-26,Santa Clara,85,1922200,1212,487,1,488,20
2020-03-26,Santa Cruz,87,273765,74,30,0,30,0
2020-03-26,Shasta,89,179085,16,3,0,3,1
2020-03-26,Sierra,91,2930,0,0,0,0,0
2020-03-26,Siskiyou,93,43540,4,2,0,2,0
2020-03-26,Solano,95,438530,85,41,0,41,0
2020-03-26,Sonoma,97,501317,129,33,0,33,1
2020-03-26,Stanislaus,99,539301,82,15,3,18,0
2020-03-26,Sutter,101,95872,12,2,0,2,0
2020-03-26,Tehama,103,63373,1,0,0,0,0
2020-03-26,Trinity,105,12862,0,0,0,0,0
2020-03-26,Tulare,107,460477,72,15,1,16,0
2020-03-26,Tuolumne,109,53932,2,0,0,0,0
2020-03-26,Ventura,111,848112,243,70,0,70,1
2020-03-26,Yolo,113,214977,45,13,0,13,1
2020-03-26,Yuba,115,75493,7,3,0,3,0
2020-03-25,Alameda,1,1643700,524,134,0,134,3
2020-03-25,Alpine,3,1148,1,0,0,0,0
2020-03-25,Amador,5,37829,4,1,0,1,0
2020-03-25,Butte,7,227075,11,4,0,4,0
2020-03-25,Calaveras,9,45235,6,2,0,2,0
2020-03-25,Colusa,11,21464,2,0,0,0,0
2020-03-25,Contra Costa,13,1133247,367,131,0,131,1
2020-03-25,Del Norte,15,27424,0,0,0,0,0
2020-03-25,El Dorado,17,186661,26,5,0,5,0
2020-03-25,Fresno,19,978130,146,21,1,22,0
2020-03-25,Glenn,21,27897,2,0,0,0,0
2020-03-25,Humboldt,23,135768,35,3,0,3,0
2020-03-25,Imperial,25,180216,63,8,0,8,0
2020-03-25,Inyo,27,18085,5,0,0,0,0
2020-03-25,Kern,29,883053,162,13,0,13,0
2020-03-25,Kings,31,150075,16,0,1,1,0
2020-03-25,Lake,33,64148,0,0,0,0,0
2020-03-25,Lassen,35,31185,1,0,0,0,0
2020-03-25,Los Angeles,37,10098052,4146,725,15,740,10
2020-03-25,Madera,39,155013,32,6,0,6,0
2020-03-25,Marin,41,260295,99,47,0,47,0
2020-03-25,Mariposa,43,17540,0,0,0,0,0
2020-03-25,Mendocino,45,87422,2,1,0,1,0
2020-03-25,Merced,47,269075,19,0,0,0,0
2020-03-25,Modoc,49,8938,0,0,0,0,0
2020-03-25,Mono,51,14174,22,4,0,4,0
2020-03-25,Monterey,53,433212,56,23,0,23,1
2020-03-25,Napa,55,140530,26,5,0,5,0
2020-03-25,Nevada,57,99092,31,5,1,6,0
2020-03-25,Orange,59,3164182,992,214,1,215,1
2020-03-25,Placer,61,380077,98,30,0,30,1
2020-03-25,Plumas,63,18699,0,1,0,1,0
2020-03-25,Riverside,65,2383286,717,87,5,92,5
2020-03-25,Sacramento,67,1510023,444,114,0,114,5
2020-03-25,San Benito,69,59416,26,4,0,4,1
2020-03-25,San Bernardino,71,2135413,405,46,0,46,1
2020-03-25,San Diego,73,3302833,1194,238,0,238,2
2020-03-25,San Francisco,75,870044,544,212,0,212,1
2020-03-25,San Joaquin,77,732212,177,64,3,67,2
2020-03-25,San Luis Obispo,79,281455,96,35,0,35,0
2020-03-25,San Mateo,81,765935,577,111,2,113,5
2020-03-25,Santa Barbara,83,443738,191,25,0,25,0
2020-03-25,Santa Clara,85,1922200,1168,452,1,453,20
2020-03-25,Santa Cruz,87,273765,71,26,0,26,0
2020-03-25,Shasta,89,179085,15,3,0,3,1
2020-03-25,Sierra,91,2930,0,0,0,0,0
2020-03-25,Siskiyou,93,43540,4,2,0,2,0
2020-03-25,Solano,95,438530,80,39,0,39,0
2020-03-25,Sonoma,97,501317,124,31,0,31,1
2020-03-25,Stanislaus,99,539301,75,14,3,17,0
2020-03-25,Sutter,101,95872,9,1,0,1,0
2020-03-25,Tehama,103,63373,1,0,0,0,0
2020-03-25,Trinity,105,12862,0,0,0,0,0
2020-03-25,Tulare,107,460477,62,11,1,12,0
2020-03-25,Tuolumne,109,53932,2,0,0,0,0
2020-03-25,Ventura,111,848112,227,53,0,53,1
2020-03-25,Yolo,113,214977,43,9,0,9,1
2020-03-25,Yuba,115,75493,7,2,0,2,0
2020-03-24,Alameda,1,1643700,492,96,0,96,2
2020-03-24,Alpine,3,1148,1,0,0,0,0
2020-03-24,Amador,5,37829,2,1,0,1,0
2020-03-24,Butte,7,227075,10,3,0,3,0
2020-03-24,Calaveras,9,45235,5,2,0,2,0
2020-03-24,Colusa,11,21464,2,0,0,0,0
2020-03-24,Contra Costa,13,1133247,354,108,0,108,1
2020-03-24,Del Norte,15,27424,0,0,0,0,0
2020-03-24,El Dorado,17,186661,26,3,0,3,0
2020-03-24,Fresno,19,978130,127,18,1,19,0
2020-03-24,Glenn,21,27897,2,0,0,0,0
2020-03-24,Humboldt,23,135768,33,2,0,2,0
2020-03-24,Imperial,25,180216,60,3,0,3,0
2020-03-24,Inyo,27,18085,5,0,0,0,0
2020-03-24,Kern,29,883053,144,5,0,5,0
2020-03-24,Kings,31,150075,15,0,1,1,0
2020-03-24,Lake,33,64148,0,0,0,0,0
2020-03-24,Lassen,35,31185,1,0,0,0,0
2020-03-24,Los Angeles,37,10098052,3696,633,15,648,7
2020-03-24,Madera,39,155013,31,6,0,6,0
2020-03-24,Marin,41,260295,88,44,0,44,0
2020-03-24,Mariposa,43,17540,0,0,0,0,0
2020-03-24,Mendocino,45,87422,2,1,0,1,0
2020-03-24,Merced,47,269075,17,0,0,0,0
2020-03-24,Modoc,49,8938,0,0,0,0,0
2020-03-24,Mono,51,14174,21,1,0,1,0
2020-03-24,Monterey,53,433212,52,23,0,23,1
2020-03-24,Napa,55,140530,23,2,0,2,0
2020-03-24,Nevada,57,99092,30,4,1,5,0
2020-03-24,Orange,59,3164182,930,166,1,167,0
2020-03-24,Placer,61,380077,92,22,0,22,1
2020-03-24,Plumas,63,18699,0,1,0,1,0
2020-03-24,Riverside,65,2383286,650,56,5,61,5
2020-03-24,Sacramento,67,1510023,425,93,0,93,4
2020-03-24,San Benito,69,59416,25,4,0,4,1
2020-03-24,San Bernardino,71,2135413,361,27,0,27,0
2020-03-24,San Diego,73,3302833,1127,231,0,231,2
2020-03-24,San Francisco,75,870044,512,181,0,181,1
2020-03-24,San Joaquin,77,732212,166,52,3,55,2
2020-03-24,San Luis Obispo,79,281455,94,32,0,32,0
2020-03-24,San Mateo,81,765935,536,100,2,102,2
2020-03-24,Santa Barbara,83,443738,185,20,0,20,0
2020-03-24,Santa Clara,85,1922200,1099,389,1,390,17
2020-03-24,Santa Cruz,87,273765,66,22,0,22,0
2020-03-24,Shasta,89,179085,14,3,0,3,0
2020-03-24,Sierra,91,2930,0,0,0,0,0
2020-03-24,Siskiyou,93,43540,4,2,0,2,0
2020-03-24,Solano,95,438530,78,34,0,34,0
2020-03-24,Sonoma,97,501317,117,27,0,27,1
2020-03-24,Stanislaus,99,539301,66,13,3,16,0
2020-03-24,Sutter,101,95872,9,0,0,0,0
2020-03-24,Tehama,103,63373,1,0,0,0,0
2020-03-24,Trinity,105,12862,0,0,0,0,0
2020-03-24,Tulare,107,460477,54,10,1,11,0
2020-03-24,Tuolumne,109,53932,2,0,0,0,0
2020-03-24,Ventura,111,848112,211,44,0,44,1
2020-03-24,Yolo,113,214977,39,8,0,8,0
2020-03-24,Yuba,115,75493,7,2,0,2,0
2020-03-23,Alameda,1,1643700,460,88,0,88,1
2020-03-23,Alpine,3,1148,1,0,0,0,0
2020-03-23,Amador,5,37829,2,1,0,1,0
2020-03-23,Butte,7,227075,10,2,0,2,0
2020-03-23,Calaveras,9,45235,5,2,0,2,0
2020-03-23,Colusa,11,21464,1,0,0,0,0
2020-03-23,Contra Costa,13,1133247,334,91,0,91,2
2020-03-23,Del Norte,15,27424,0,0,0,0,0
2020-03-23,El Dorado,17,186661,25,3,0,3,0
2020-03-23,Fresno,19,978130,117,10,1,11,0
2020-03-23,Glenn,21,27897,2,0,0,0,0
2020-03-23,Humboldt,23,135768,31,2,0,2,0
2020-03-23,Imperial,25,180216,55,2,0,2,0
2020-03-23,Inyo,27,18085,3,0,0,0,0
2020-03-23,Kern,29,883053,130,5,0,5,0
2020-03-23,Kings,31,150075,15,0,1,1,0
2020-03-23,Lake,33,64148,0,0,0,0,0
2020-03-23,Lassen,35,31185,1,0,0,0,0
2020-03-23,Los Angeles,37,10098052,3392,389,15,404,4
2020-03-23,Madera,39,155013,31,4,0,4,0
2020-03-23,Marin,41,260295,83,30,0,30,0
2020-03-23,Mariposa,43,17540,0,0,0,0,0
2020-03-23,Mendocino,45,87422,2,1,0,1,0
2020-03-23,Merced,47,269075,11,0,0,0,0
2020-03-23,Modoc,49,8938,0,0,0,0,0
2020-03-23,Mono,51,14174,19,1,0,1,0
2020-03-23,Monterey,53,433212,47,14,0,14,1
2020-03-23,Napa,55,140530,21,1,0,1,0
2020-03-23,Nevada,57,99092,27,2,1,3,0
2020-03-23,Orange,59,3164182,876,138,1,139,0
2020-03-23,Placer,61,380077,89,19,0,19,1
2020-03-23,Plumas,63,18699,0,0,0,0,0
2020-03-23,Riverside,65,2383286,609,39,5,44,5
2020-03-23,Sacramento,67,1510023,392,87,0,87,4
2020-03-23,San Benito,69,59416,24,4,0,4,1
2020-03-23,San Bernardino,71,2135413,331,17,0,17,0
2020-03-23,San Diego,73,3302833,1068,178,0,178,1
2020-03-23,San Francisco,75,870044,483,152,0,152,0
2020-03-23,San Joaquin,77,732212,154,37,3,40,2
2020-03-23,San Luis Obispo,79,281455,88,23,0,23,0
2020-03-23,San Mateo,81,765935,498,88,2,90,1
2020-03-23,Santa Barbara,83,443738,164,18,0,18,0
2020-03-23,Santa Clara,85,1922200,1052,336,1,337,13
2020-03-23,Santa Cruz,87,273765,64,21,0,21,0
2020-03-23,Shasta,89,179085,12,2,0,2,0
2020-03-23,Sierra,91,2930,0,0,0,0,0
2020-03-23,Siskiyou,93,43540,4,2,0,2,0
2020-03-23,Solano,95,438530,74,33,0,33,0
2020-03-23,Sonoma,97,501317,105,19,0,19,1
2020-03-23,Stanislaus,99,539301,58,10,3,13,0
2020-03-23,Sutter,101,95872,9,0,0,0,0
2020-03-23,Tehama,103,63373,1,0,0,0,0
2020-03-23,Trinity,105,12862,0,0,0,0,0
2020-03-23,Tulare,107,460477,49,9,1,10,0
2020-03-23,Tuolumne,109,53932,2,0,0,0,0
2020-03-23,Ventura,111,848112,194,30,0,30,0
2020-03-23,Yolo,113,214977,38,8,0,8,0
2020-03-23,Yuba,115,75493,7,2,0,2,0
2020-03-22,Alameda,1,1643700,421,72,0,72,1
2020-03-22,Alpine,3,1148,1,0,0,0,0
2020-03-22,Amador,5,37829,2,1,0,1,0
2020-03-22,Butte,7,227075,7,1,0,1,0
2020-03-22,Calaveras,9,45235,4,2,0,2,0
2020-03-22,Colusa,11,21464,1,0,0,0,0
2020-03-22,Contra Costa,13,1133247,309,79,0,79,1
2020-03-22,Del Norte,15,27424,0,0,0,0,0
2020-03-22,El Dorado,17,186661,23,1,0,1,0
2020-03-22,Fresno,19,978130,99,8,1,9,0
2020-03-22,Glenn,21,27897,2,0,0,0,0
2020-03-22,Humboldt,23,135768,28,1,0,1,0
2020-03-22,Imperial,25,180216,53,2,0,2,0
2020-03-22,Inyo,27,18085,1,0,0,0,0
2020-03-22,Kern,29,883053,114,3,0,3,0
2020-03-22,Kings,31,150075,13,0,1,1,0
2020-03-22,Lake,33,64148,0,0,0,0,0
2020-03-22,Lassen,35,31185,1,0,0,0,0
2020-03-22,Los Angeles,37,10098052,3070,384,15,399,3
2020-03-22,Madera,39,155013,29,4,0,4,0
2020-03-22,Marin,41,260295,73,30,0,30,0
2020-03-22,Mariposa,43,17540,0,0,0,0,0
2020-03-22,Mendocino,45,87422,2,1,0,1,0
2020-03-22,Merced,47,269075,7,0,0,0,0
2020-03-22,Modoc,49,8938,0,0,0,0,0
2020-03-22,Mono,51,14174,14,1,0,1,0
2020-03-22,Monterey,53,433212,45,14,0,14,1
2020-03-22,Napa,55,140530,17,1,0,1,0
2020-03-22,Nevada,57,99092,23,2,1,3,0
2020-03-22,Orange,59,3164182,810,102,1,103,0
2020-03-22,Placer,61,380077,87,18,0,18,1
2020-03-22,Plumas,63,18699,0,0,0,0,0
2020-03-22,Riverside,65,2383286,532,26,3,29,5
2020-03-22,Sacramento,67,1510023,361,82,0,82,4
2020-03-22,San Benito,69,59416,19,4,0,4,1
2020-03-22,San Bernardino,71,2135413,288,16,0,16,0
2020-03-22,San Diego,73,3302833,980,161,0,161,0
2020-03-22,San Francisco,75,870044,446,134,0,134,0
2020-03-22,San Joaquin,77,732212,140,30,3,33,2
2020-03-22,San Luis Obispo,79,281455,83,19,0,19,0
2020-03-22,San Mateo,81,765935,465,82,2,84,1
2020-03-22,Santa Barbara,83,443738,148,16,0,16,0
2020-03-22,Santa Clara,85,1922200,990,284,1,285,13
2020-03-22,Santa Cruz,87,273765,63,19,0,19,0
2020-03-22,Shasta,89,179085,12,1,0,1,0
2020-03-22,Sierra,91,2930,0,0,0,0,0
2020-03-22,Siskiyou,93,43540,4,2,0,2,0
2020-03-22,Solano,95,438530,65,30,0,30,0
2020-03-22,Sonoma,97,501317,100,18,0,18,1
2020-03-22,Stanislaus,99,539301,51,8,3,11,0
2020-03-22,Sutter,101,95872,8,0,0,0,0
2020-03-22,Tehama,103,63373,0,0,0,0,0
2020-03-22,Trinity,105,12862,0,0,0,0,0
2020-03-22,Tulare,107,460477,46,5,1,6,0
2020-03-22,Tuolumne,109,53932,2,0,0,0,0
2020-03-22,Ventura,111,848112,173,26,0,26,0
2020-03-22,Yolo,113,214977,32,6,0,6,0
2020-03-22,Yuba,115,75493,7,2,0,2,0
2020-03-21,Alameda,1,1643700,399,62,0,62,0
2020-03-21,Alpine,3,1148,1,0,0,0,0
2020-03-21,Amador,5,37829,2,1,0,1,0
2020-03-21,Butte,7,227075,7,1,0,1,0
2020-03-21,Calaveras,9,45235,4,2,0,2,0
2020-03-21,Colusa,11,21464,1,0,0,0,0
2020-03-21,Contra Costa,13,1133247,298,62,0,62,1
2020-03-21,Del Norte,15,27424,0,0,0,0,0
2020-03-21,El Dorado,17,186661,20,1,0,1,0
2020-03-21,Fresno,19,978130,95,8,1,9,0
2020-03-21,Glenn,21,27897,2,0,0,0,0
2020-03-21,Humboldt,23,135768,25,1,0,1,0
2020-03-21,Imperial,25,180216,49,2,0,2,0
2020-03-21,Inyo,27,18085,1,0,0,0,0
2020-03-21,Kern,29,883053,108,3,0,3,0
2020-03-21,Kings,31,150075,13,0,1,1,0
2020-03-21,Lake,33,64148,0,0,0,0,0
2020-03-21,Lassen,35,31185,1,0,0,0,0
2020-03-21,Los Angeles,37,10098052,2798,322,15,337,2
2020-03-21,Madera,39,155013,29,4,0,4,0
2020-03-21,Marin,41,260295,68,30,0,30,0
2020-03-21,Mariposa,43,17540,0,0,0,0,0
2020-03-21,Mendocino,45,87422,2,1,0,1,0
2020-03-21,Merced,47,269075,6,0,0,0,0
2020-03-21,Modoc,49,8938,0,0,0,0,0
2020-03-21,Mono,51,14174,14,1,0,1,0
2020-03-21,Monterey,53,433212,43,8,0,8,1
2020-03-21,Napa,55,140530,17,0,0,0,0
2020-03-21,Nevada,57,99092,23,2,1,3,0
2020-03-21,Orange,59,3164182,761,85,1,86,0
2020-03-21,Placer,61,380077,77,11,0,11,1
2020-03-21,Plumas,63,18699,0,0,0,0,0
2020-03-21,Riverside,65,2383286,489,20,3,23,3
2020-03-21,Sacramento,67,1510023,333,66,0,66,3
2020-03-21,San Benito,69,59416,17,4,0,4,1
2020-03-21,San Bernardino,71,2135413,267,13,0,13,0
2020-03-21,San Diego,73,3302833,903,121,0,121,0
2020-03-21,San Francisco,75,870044,410,106,0,106,0
2020-03-21,San Joaquin,77,732212,131,26,3,29,2
2020-03-21,San Luis Obispo,79,281455,79,16,0,16,0
2020-03-21,San Mateo,81,765935,427,78,2,80,1
2020-03-21,Santa Barbara,83,443738,133,8,0,8,0
2020-03-21,Santa Clara,85,1922200,930,269,1,270,10
2020-03-21,Santa Cruz,87,273765,61,17,0,17,0
2020-03-21,Shasta,89,179085,11,1,0,1,0
2020-03-21,Sierra,91,2930,0,0,0,0,0
2020-03-21,Siskiyou,93,43540,4,0,0,0,0
2020-03-21,Solano,95,438530,63,30,0,30,0
2020-03-21,Sonoma,97,501317,99,15,0,15,1
2020-03-21,Stanislaus,99,539301,45,7,3,10,0
2020-03-21,Sutter,101,95872,7,0,0,0,0
2020-03-21,Tehama,103,63373,0,0,0,0,0
2020-03-21,Trinity,105,12862,0,0,0,0,0
2020-03-21,Tulare,107,460477,42,5,1,6,0
2020-03-21,Tuolumne,109,53932,2,0,0,0,0
2020-03-21,Ventura,111,848112,165,22,0,22,0
2020-03-21,Yolo,113,214977,32,6,0,6,0
2020-03-21,Yuba,115,75493,7,1,0,1,0
2020-03-20,Alameda,1,1643700,378,42,0,42,0
2020-03-20,Alpine,3,1148,1,0,0,0,0
2020-03-20,Amador,5,37829,1,0,0,0,0
2020-03-20,Butte,7,227075,7,0,0,0,0
2020-03-20,Calaveras,9,45235,4,2,0,2,0
2020-03-20,Colusa,11,21464,1,0,0,0,0
2020-03-20,Contra Costa,13,1133247,269,52,0,52,1
2020-03-20,Del Norte,15,27424,0,0,0,0,0
2020-03-20,El Dorado,17,186661,19,1,0,1,0
2020-03-20,Fresno,19,978130,92,7,1,8,0
2020-03-20,Glenn,21,27897,1,0,0,0,0
2020-03-20,Humboldt,23,135768,25,1,0,1,0
2020-03-20,Imperial,25,180216,48,2,0,2,0
2020-03-20,Inyo,27,18085,0,0,0,0,0
2020-03-20,Kern,29,883053,93,3,0,3,0
2020-03-20,Kings,31,150075,13,0,1,1,0
2020-03-20,Lake,33,64148,0,0,0,0,0
2020-03-20,Lassen,35,31185,1,0,0,0,0
2020-03-20,Los Angeles,37,10098052,2573,267,14,281,1
2020-03-20,Madera,39,155013,28,4,0,4,0
2020-03-20,Marin,41,260295,65,30,0,30,0
2020-03-20,Mariposa,43,17540,0,0,0,0,0
2020-03-20,Mendocino,45,87422,2,1,0,1,0
2020-03-20,Merced,47,269075,6,0,0,0,0
2020-03-20,Modoc,49,8938,0,0,0,0,0
2020-03-20,Mono,51,14174,14,0,0,0,0
2020-03-20,Monterey,53,433212,42,4,0,4,0
2020-03-20,Napa,55,140530,16,0,0,0,0
2020-03-20,Nevada,57,99092,20,2,1,3,0
2020-03-20,Orange,59,3164182,714,71,1,72,2
2020-03-20,Placer,61,380077,70,9,0,9,1
2020-03-20,Plumas,63,18699,0,0,0,0,0
2020-03-20,Riverside,65,2383286,437,19,3,22,3
2020-03-20,Sacramento,67,1510023,312,56,0,56,4
2020-03-20,San Benito,69,59416,17,4,0,4,1
2020-03-20,San Bernardino,71,2135413,240,9,0,9,0
2020-03-20,San Diego,73,3302833,851,98,0,98,0
2020-03-20,San Francisco,75,870044,378,87,0,87,0
2020-03-20,San Joaquin,77,732212,116,18,3,21,2
2020-03-20,San Luis Obispo,79,281455,76,11,0,11,0
2020-03-20,San Mateo,81,765935,397,71,2,73,1
2020-03-20,Santa Barbara,83,443738,117,7,0,7,0
2020-03-20,Santa Clara,85,1922200,894,246,1,247,8
2020-03-20,Santa Cruz,87,273765,59,13,0,13,0
2020-03-20,Shasta,89,179085,10,1,0,1,0
2020-03-20,Sierra,91,2930,0,0,0,0,0
2020-03-20,Siskiyou,93,43540,4,0,0,0,0
2020-03-20,Solano,95,438530,59,29,0,29,0
2020-03-20,Sonoma,97,501317,91,7,0,7,0
2020-03-20,Stanislaus,99,539301,39,7,3,10,0
2020-03-20,Sutter,101,95872,7,0,0,0,0
2020-03-20,Tehama,103,63373,0,0,0,0,0
2020-03-20,Trinity,105,12862,0,0,0,0,0
2020-03-20,Tulare,107,460477,38,4,1,5,0
2020-03-20,Tuolumne,109,53932,2,0,0,0,0
2020-03-20,Ventura,111,848112,155,18,0,18,0
2020-03-20,Yolo,113,214977,30,5,0,5,0
2020-03-20,Yuba,115,75493,6,0,0,0,0
2020-03-19,Alameda,1,1643700,342,36,0,36,0
2020-03-19,Alpine,3,1148,1,0,0,0,0
2020-03-19,Amador,5,37829,1,0,0,0,0
2020-03-19,Butte,7,227075,5,0,0,0,0
2020-03-19,Calaveras,9,45235,4,2,0,2,0
2020-03-19,Colusa,11,21464,0,0,0,0,0
2020-03-19,Contra Costa,13,1133247,253,46,0,46,0
2020-03-19,Del Norte,15,27424,0,0,0,0,0
2020-03-19,El Dorado,17,186661,18,0,0,0,0
2020-03-19,Fresno,19,978130,84,6,1,7,0
2020-03-19,Glenn,21,27897,1,0,0,0,0
2020-03-19,Humboldt,23,135768,23,1,0,1,0
2020-03-19,Imperial,25,180216,41,2,0,2,0
2020-03-19,Inyo,27,18085,0,0,0,0,0
2020-03-19,Kern,29,883053,81,3,0,3,0
2020-03-19,Kings,31,150075,10,0,1,1,0
2020-03-19,Lake,33,64148,0,0,0,0,0
2020-03-19,Lassen,35,31185,0,0,0,0,0
2020-03-19,Los Angeles,37,10098052,2286,233,14,247,0
2020-03-19,Madera,39,155013,27,3,0,3,0
2020-03-19,Marin,41,260295,62,19,0,19,0
2020-03-19,Mariposa,43,17540,0,0,0,0,0
2020-03-19,Mendocino,45,87422,1,1,0,1,0
2020-03-19,Merced,47,269075,5,0,0,0,0
2020-03-19,Modoc,49,8938,0,0,0,0,0
2020-03-19,Mono,51,14174,12,0,0,0,0
2020-03-19,Monterey,53,433212,34,3,0,3,0
2020-03-19,Napa,55,140530,14,0,0,0,0
2020-03-19,Nevada,57,99092,18,2,1,3,0
2020-03-19,Orange,59,3164182,632,59,1,60,0
2020-03-19,Placer,61,380077,62,8,0,8,1
2020-03-19,Plumas,63,18699,0,0,0,0,0
2020-03-19,Riverside,65,2383286,354,14,2,16,3
2020-03-19,Sacramento,67,1510023,279,52,0,52,3
2020-03-19,San Benito,69,59416,14,3,0,3,0
2020-03-19,San Bernardino,71,2135413,210,7,0,7,0
2020-03-19,San Diego,73,3302833,768,68,0,68,0
2020-03-19,San Francisco,75,870044,342,80,0,80,0
2020-03-19,San Joaquin,77,732212,102,15,3,18,2
2020-03-19,San Luis Obispo,79,281455,74,6,0,6,0
2020-03-19,San Mateo,81,765935,362,58,2,60,1
2020-03-19,Santa Barbara,83,443738,102,5,0,5,0
2020-03-19,Santa Clara,85,1922200,828,183,1,184,8
2020-03-19,Santa Cruz,87,273765,56,13,0,13,0
2020-03-19,Shasta,89,179085,9,1,0,1,0
2020-03-19,Sierra,91,2930,0,0,0,0,0
2020-03-19,Siskiyou,93,43540,3,0,0,0,0
2020-03-19,Solano,95,438530,55,26,0,26,0
2020-03-19,Sonoma,97,501317,88,8,0,8,0
2020-03-19,Stanislaus,99,539301,38,7,3,10,0
2020-03-19,Sutter,101,95872,7,0,0,0,0
2020-03-19,Tehama,103,63373,0,0,0,0,0
2020-03-19,Trinity,105,12862,0,0,0,0,0
2020-03-19,Tulare,107,460477,33,3,1,4,0
2020-03-19,Tuolumne,109,53932,2,0,0,0,0
2020-03-19,Ventura,111,848112,133,15,0,15,0
2020-03-19,Yolo,113,214977,26,5,0,5,0
2020-03-19,Yuba,115,75493,5,0,0,0,0
2020-03-18,Alameda,1,1643700,314,29,0,29,0
2020-03-18,Alpine,3,1148,1,0,0,0,0
2020-03-18,Amador,5,37829,1,0,0,0,0
2020-03-18,Butte,7,227075,4,0,0,0,0
2020-03-18,Calaveras,9,45235,4,2,0,2,0
2020-03-18,Colusa,11,21464,0,0,0,0,0
2020-03-18,Contra Costa,13,1133247,232,44,0,44,0
2020-03-18,Del Norte,15,27424,0,0,0,0,0
2020-03-18,El Dorado,17,186661,17,0,0,0,0
2020-03-18,Fresno,19,978130,75,3,1,4,0
2020-03-18,Glenn,21,27897,1,0,0,0,0
2020-03-18,Humboldt,23,135768,19,1,0,1,0
2020-03-18,Imperial,25,180216,34,2,0,2,0
2020-03-18,Inyo,27,18085,0,0,0,0,0
2020-03-18,Kern,29,883053,66,1,0,1,0
2020-03-18,Kings,31,150075,8,0,1,1,0
2020-03-18,Lake,33,64148,0,0,0,0,0
2020-03-18,Lassen,35,31185,0,0,0,0,0
2020-03-18,Los Angeles,37,10098052,2047,47,14,61,0
2020-03-18,Madera,39,155013,26,2,0,2,0
2020-03-18,Marin,41,260295,58,10,0,10,0
2020-03-18,Mariposa,43,17540,0,0,0,0,0
2020-03-18,Mendocino,45,87422,1,0,0,0,0
2020-03-18,Merced,47,269075,5,0,0,0,0
2020-03-18,Modoc,49,8938,0,0,0,0,0
2020-03-18,Mono,51,14174,11,0,0,0,0
2020-03-18,Monterey,53,433212,28,1,0,1,0
2020-03-18,Napa,55,140530,11,0,0,0,0
2020-03-18,Nevada,57,99092,16,2,1,3,0
2020-03-18,Orange,59,3164182,576,38,1,39,0
2020-03-18,Placer,61,380077,55,8,0,8,1
2020-03-18,Plumas,63,18699,0,0,0,0,0
2020-03-18,Riverside,65,2383286,302,11,2,13,2
2020-03-18,Sacramento,67,1510023,256,46,0,46,3
2020-03-18,San Benito,69,59416,13,3,0,3,0
2020-03-18,San Bernardino,71,2135413,188,3,0,3,0
2020-03-18,San Diego,73,3302833,683,40,0,40,0
2020-03-18,San Francisco,75,870044,323,65,0,65,0
2020-03-18,San Joaquin,77,732212,90,14,3,17,2
2020-03-18,San Luis Obispo,79,281455,68,5,0,5,0
2020-03-18,San Mateo,81,765935,339,57,2,59,1
2020-03-18,Santa Barbara,83,443738,89,2,0,2,0
2020-03-18,Santa Clara,85,1922200,780,151,1,152,6
2020-03-18,Santa Cruz,87,273765,54,11,0,11,0
2020-03-18,Shasta,89,179085,8,1,0,1,0
2020-03-18,Sierra,91,2930,0,0,0,0,0
2020-03-18,Siskiyou,93,43540,3,0,0,0,0
2020-03-18,Solano,95,438530,51,26,0,26,0
2020-03-18,Sonoma,97,501317,79,6,0,6,0
2020-03-18,Stanislaus,99,539301,34,5,2,7,0
2020-03-18,Sutter,101,95872,5,0,0,0,0
2020-03-18,Tehama,103,63373,0,0,0,0,0
2020-03-18,Trinity,105,12862,0,0,0,0,0
2020-03-18,Tulare,107,460477,25,3,1,4,0
2020-03-18,Tuolumne,109,53932,2,0,0,0,0
2020-03-18,Ventura,111,848112,114,11,0,11,0
2020-03-18,Yolo,113,214977,23,4,0,4,0
2020-03-18,Yuba,115,75493,4,0,0,0,0
2020-03-17,Alameda,1,1643700,283,19,0,19,0
2020-03-17,Alpine,3,1148,0,0,0,0,0
2020-03-17,Amador,5,37829,1,0,0,0,0
2020-03-17,Butte,7,227075,4,0,0,0,0
2020-03-17,Calaveras,9,45235,4,2,0,2,0
2020-03-17,Colusa,11,21464,0,0,0,0,0
2020-03-17,Contra Costa,13,1133247,210,37,0,37,0
2020-03-17,Del Norte,15,27424,0,0,0,0,0
2020-03-17,El Dorado,17,186661,16,0,0,0,0
2020-03-17,Fresno,19,978130,66,2,1,3,0
2020-03-17,Glenn,21,27897,1,0,0,0,0
2020-03-17,Humboldt,23,135768,17,1,0,1,0
2020-03-17,Imperial,25,180216,28,2,0,2,0
2020-03-17,Inyo,27,18085,0,0,0,0,0
2020-03-17,Kern,29,883053,52,0,0,0,0
2020-03-17,Kings,31,150075,7,0,1,1,0
2020-03-17,Lake,33,64148,0,0,0,0,0
2020-03-17,Lassen,35,31185,0,0,0,0,0
2020-03-17,Los Angeles,37,10098052,1846,41,14,55,0
2020-03-17,Madera,39,155013,19,2,0,2,0
2020-03-17,Marin,41,260295,51,4,0,4,0
2020-03-17,Mariposa,43,17540,0,0,0,0,0
2020-03-17,Mendocino,45,87422,1,0,0,0,0
2020-03-17,Merced,47,269075,5,0,0,0,0
2020-03-17,Modoc,49,8938,0,0,0,0,0
2020-03-17,Mono,51,14174,9,0,0,0,0
2020-03-17,Monterey,53,433212,26,0,0,0,0
2020-03-17,Napa,55,140530,8,0,0,0,0
2020-03-17,Nevada,57,99092,15,1,1,2,0
2020-03-17,Orange,59,3164182,500,24,1,25,0
2020-03-17,Placer,61,380077,47,7,0,7,1
2020-03-17,Plumas,63,18699,0,0,0,0,0
2020-03-17,Riverside,65,2383286,245,11,2,13,0
2020-03-17,Sacramento,67,1510023,236,36,0,36,1
2020-03-17,San Benito,69,59416,12,2,0,2,0
2020-03-17,San Bernardino,71,2135413,160,2,0,2,0
2020-03-17,San Diego,73,3302833,616,17,0,17,0
2020-03-17,San Francisco,75,870044,297,46,0,46,0
2020-03-17,San Joaquin,77,732212,84,11,3,14,0
2020-03-17,San Luis Obispo,79,281455,61,1,0,1,0
2020-03-17,San Mateo,81,765935,307,46,2,48,1
2020-03-17,Santa Barbara,83,443738,76,0,0,0,0
2020-03-17,Santa Clara,85,1922200,723,121,1,122,4
2020-03-17,Santa Cruz,87,273765,51,10,0,10,0
2020-03-17,Shasta,89,179085,4,1,0,1,0
2020-03-17,Sierra,91,2930,0,0,0,0,0
2020-03-17,Siskiyou,93,43540,3,0,0,0,0
2020-03-17,Solano,95,438530,48,27,0,27,0
2020-03-17,Sonoma,97,501317,71,4,0,4,0
2020-03-17,Stanislaus,99,539301,31,4,2,6,0
2020-03-17,Sutter,101,95872,5,0,0,0,0
2020-03-17,Tehama,103,63373,0,0,0,0,0
2020-03-17,Trinity,105,12862,0,0,0,0,0
2020-03-17,Tulare,107,460477,22,2,1,3,0
2020-03-17,Tuolumne,109,53932,2,0,0,0,0
2020-03-17,Ventura,111,848112,98,7,0,7,0
2020-03-17,Yolo,113,214977,19,2,0,2,0
2020-03-17,Yuba,115,75493,4,0,0,0,0
2020-03-16,Alameda,1,1643700,254,17,0,17,0
2020-03-16,Alpine,3,1148,0,0,0,0,0
2020-03-16,Amador,5,37829,1,0,0,0,0
2020-03-16,Butte,7,227075,3,0,0,0,0
2020-03-16,Calaveras,9,45235,4,2,0,2,0
2020-03-16,Colusa,11,21464,0,0,0,0,0
2020-03-16,Contra Costa,13,1133247,186,36,0,36,0
2020-03-16,Del Norte,15,27424,0,0,0,0,0
2020-03-16,El Dorado,17,186661,15,0,0,0,0
2020-03-16,Fresno,19,978130,52,2,1,3,0
2020-03-16,Glenn,21,27897,0,0,0,0,0
2020-03-16,Humboldt,23,135768,13,1,0,1,0
2020-03-16,Imperial,25,180216,23,2,0,2,0
2020-03-16,Inyo,27,18085,0,0,0,0,0
2020-03-16,Kern,29,883053,43,0,0,0,0
2020-03-16,Kings,31,150075,6,0,1,1,0
2020-03-16,Lake,33,64148,0,0,0,0,0
2020-03-16,Lassen,35,31185,0,0,0,0,0
2020-03-16,Los Angeles,37,10098052,1612,43,14,57,0
2020-03-16,Madera,39,155013,18,2,0,2,0
2020-03-16,Marin,41,260295,48,4,0,4,0
2020-03-16,Mariposa,43,17540,0,0,0,0,0
2020-03-16,Mendocino,45,87422,1,0,0,0,0
2020-03-16,Merced,47,269075,5,0,0,0,0
2020-03-16,Modoc,49,8938,0,0,0,0,0
2020-03-16,Mono,51,14174,7,0,0,0,0
2020-03-16,Monterey,53,433212,25,0,0,0,0
2020-03-16,Napa,55,140530,7,0,0,0,0
2020-03-16,Nevada,57,99092,11,1,1,2,0
2020-03-16,Orange,59,3164182,418,18,1,19,0
2020-03-16,Placer,61,380077,39,7,0,7,1
2020-03-16,Plumas,63,18699,0,0,0,0,0
2020-03-16,Riverside,65,2383286,211,10,2,12,0
2020-03-16,Sacramento,67,1510023,209,34,0,34,1
2020-03-16,San Benito,69,59416,8,2,0,2,0
2020-03-16,San Bernardino,71,2135413,140,1,0,1,0
2020-03-16,San Diego,73,3302833,525,17,0,17,0
2020-03-16,San Francisco,75,870044,261,40,0,40,0
2020-03-16,San Joaquin,77,732212,74,9,3,12,0
2020-03-16,San Luis Obispo,79,281455,54,1,0,1,0
2020-03-16,San Mateo,81,765935,269,42,2,44,1
2020-03-16,Santa Barbara,83,443738,64,0,0,0,0
2020-03-16,Santa Clara,85,1922200,648,115,1,116,2
2020-03-16,Santa Cruz,87,273765,44,9,0,9,0
2020-03-16,Shasta,89,179085,4,1,0,1,0
2020-03-16,Sierra,91,2930,0,0,0,0,0
2020-03-16,Siskiyou,93,43540,2,0,0,0,0
2020-03-16,Solano,95,438530,43,27,0,27,0
2020-03-16,Sonoma,97,501317,63,4,0,4,0
2020-03-16,Stanislaus,99,539301,27,2,2,4,0
2020-03-16,Sutter,101,95872,3,0,0,0,0
2020-03-16,Tehama,103,63373,0,0,0,0,0
2020-03-16,Trinity,105,12862,0,0,0,0,0
2020-03-16,Tulare,107,460477,19,2,1,3,0
2020-03-16,Tuolumne,109,53932,2,0,0,0,0
2020-03-16,Ventura,111,848112,88,7,0,7,0
2020-03-16,Yolo,113,214977,18,2,0,2,0
2020-03-16,Yuba,115,75493,3,0,0,0,0
2020-03-15,Alameda,1,1643700,208,17,0,17,0
2020-03-15,Alpine,3,1148,0,0,0,0,0
2020-03-15,Amador,5,37829,1,0,0,0,0
2020-03-15,Butte,7,227075,3,0,0,0,0
2020-03-15,Calaveras,9,45235,2,2,0,2,0
2020-03-15,Colusa,11,21464,0,0,0,0,0
2020-03-15,Contra Costa,13,1133247,161,34,0,34,0
2020-03-15,Del Norte,15,27424,0,0,0,0,0
2020-03-15,El Dorado,17,186661,14,0,0,0,0
2020-03-15,Fresno,19,978130,32,1,1,2,0
2020-03-15,Glenn,21,27897,0,0,0,0,0
2020-03-15,Humboldt,23,135768,11,1,0,1,0
2020-03-15,Imperial,25,180216,18,2,0,2,0
2020-03-15,Inyo,27,18085,0,0,0,0,0
2020-03-15,Kern,29,883053,37,0,0,0,0
2020-03-15,Kings,31,150075,6,0,1,1,0
2020-03-15,Lake,33,64148,0,0,0,0,0
2020-03-15,Lassen,35,31185,0,0,0,0,0
2020-03-15,Los Angeles,37,10098052,1374,41,14,55,0
2020-03-15,Madera,39,155013,17,2,0,2,0
2020-03-15,Marin,41,260295,41,3,0,3,0
2020-03-15,Mariposa,43,17540,0,0,0,0,0
2020-03-15,Mendocino,45,87422,1,0,0,0,0
2020-03-15,Merced,47,269075,3,0,0,0,0
2020-03-15,Modoc,49,8938,0,0,0,0,0
2020-03-15,Mono,51,14174,6,0,0,0,0
2020-03-15,Monterey,53,433212,19,0,0,0,0
2020-03-15,Napa,55,140530,7,0,0,0,0
2020-03-15,Nevada,57,99092,11,0,1,1,0
2020-03-15,Orange,59,3164182,349,16,0,16,0
2020-03-15,Placer,61,380077,33,7,0,7,1
2020-03-15,Plumas,63,18699,0,0,0,0,0
2020-03-15,Riverside,65,2383286,166,10,2,12,0
2020-03-15,Sacramento,67,1510023,173,30,0,30,1
2020-03-15,San Benito,69,59416,8,2,0,2,0
2020-03-15,San Bernardino,71,2135413,118,0,0,0,0
2020-03-15,San Diego,73,3302833,438,16,0,16,0
2020-03-15,San Francisco,75,870044,205,31,0,31,0
2020-03-15,San Joaquin,77,732212,63,6,3,9,0
2020-03-15,San Luis Obispo,79,281455,45,1,0,1,0
2020-03-15,San Mateo,81,765935,235,29,1,30,1
2020-03-15,Santa Barbara,83,443738,54,0,0,0,0
2020-03-15,Santa Clara,85,1922200,577,79,1,80,2
2020-03-15,Santa Cruz,87,273765,38,8,0,8,0
2020-03-15,Shasta,89,179085,4,1,0,1,0
2020-03-15,Sierra,91,2930,0,0,0,0,0
2020-03-15,Siskiyou,93,43540,2,0,0,0,0
2020-03-15,Solano,95,438530,42,26,0,26,0
2020-03-15,Sonoma,97,501317,54,4,0,4,0
2020-03-15,Stanislaus,99,539301,26,2,2,4,0
2020-03-15,Sutter,101,95872,2,0,0,0,0
2020-03-15,Tehama,103,63373,0,0,0,0,0
2020-03-15,Trinity,105,12862,0,0,0,0,0
2020-03-15,Tulare,107,460477,14,2,1,3,0
2020-03-15,Tuolumne,109,53932,1,0,0,0,0
2020-03-15,Ventura,111,848112,77,5,0,5,0
2020-03-15,Yolo,113,214977,15,2,0,2,0
2020-03-15,Yuba,115,75493,2,0,0,0,0
2020-03-14,Alameda,1,1643700,191,11,0,11,0
2020-03-14,Alpine,3,1148,0,0,0,0,0
2020-03-14,Amador,5,37829,1,0,0,0,0
2020-03-14,Butte,7,227075,2,0,0,0,0
2020-03-14,Calaveras,9,45235,2,2,0,2,0
2020-03-14,Colusa,11,21464,0,0,0,0,0
2020-03-14,Contra Costa,13,1133247,139,30,0,30,0
2020-03-14,Del Norte,15,27424,0,0,0,0,0
2020-03-14,El Dorado,17,186661,12,0,0,0,0
2020-03-14,Fresno,19,978130,24,1,1,2,0
2020-03-14,Glenn,21,27897,0,0,0,0,0
2020-03-14,Humboldt,23,135768,7,1,0,1,0
2020-03-14,Imperial,25,180216,14,2,0,2,0
2020-03-14,Inyo,27,18085,0,0,0,0,0
2020-03-14,Kern,29,883053,32,0,0,0,0
2020-03-14,Kings,31,150075,6,0,1,1,0
2020-03-14,Lake,33,64148,0,0,0,0,0
2020-03-14,Lassen,35,31185,0,0,0,0,0
2020-03-14,Los Angeles,37,10098052,1196,35,14,49,0
2020-03-14,Madera,39,155013,17,2,0,2,0
2020-03-14,Marin,41,260295,37,3,0,3,0
2020-03-14,Mariposa,43,17540,0,0,0,0,0
2020-03-14,Mendocino,45,87422,1,0,0,0,0
2020-03-14,Merced,47,269075,3,0,0,0,0
2020-03-14,Modoc,49,8938,0,0,0,0,0
2020-03-14,Mono,51,14174,5,0,0,0,0
2020-03-14,Monterey,53,433212,13,0,0,0,0
2020-03-14,Napa,55,140530,5,0,0,0,0
2020-03-14,Nevada,57,99092,8,0,1,1,0
2020-03-14,Orange,59,3164182,311,14,0,14,0
2020-03-14,Placer,61,380077,29,6,0,6,1
2020-03-14,Plumas,63,18699,0,0,0,0,0
2020-03-14,Riverside,65,2383286,146,10,2,12,0
2020-03-14,Sacramento,67,1510023,151,31,0,31,1
2020-03-14,San Benito,69,59416,8,2,0,2,0
2020-03-14,San Bernardino,71,2135413,100,0,0,0,0
2020-03-14,San Diego,73,3302833,363,10,0,10,0
2020-03-14,San Francisco,75,870044,184,29,0,29,0
2020-03-14,San Joaquin,77,732212,54,6,3,9,0
2020-03-14,San Luis Obispo,79,281455,40,0,0,0,0
2020-03-14,San Mateo,81,765935,212,27,1,28,0
2020-03-14,Santa Barbara,83,443738,42,0,0,0,0
2020-03-14,Santa Clara,85,1922200,521,62,1,63,2
2020-03-14,Santa Cruz,87,273765,33,8,0,8,0
2020-03-14,Shasta,89,179085,4,1,0,1,0
2020-03-14,Sierra,91,2930,0,0,0,0,0
2020-03-14,Siskiyou,93,43540,1,0,0,0,0
2020-03-14,Solano,95,438530,40,26,0,26,0
2020-03-14,Sonoma,97,501317,41,2,0,2,0
2020-03-14,Stanislaus,99,539301,22,2,2,4,0
2020-03-14,Sutter,101,95872,2,0,0,0,0
2020-03-14,Tehama,103,63373,0,0,0,0,0
2020-03-14,Trinity,105,12862,0,0,0,0,0
2020-03-14,Tulare,107,460477,12,2,1,3,0
2020-03-14,Tuolumne,109,53932,1,0,0,0,0
2020-03-14,Ventura,111,848112,68,5,0,5,0
2020-03-14,Yolo,113,214977,15,2,0,2,0
2020-03-14,Yuba,115,75493,1,0,0,0,0
2020-03-13,Alameda,1,1643700,173,12,0,12,0
2020-03-13,Alpine,3,1148,0,0,0,0,0
2020-03-13,Amador,5,37829,1,0,0,0,0
2020-03-13,Butte,7,227075,0,0,0,0,0
2020-03-13,Calaveras,9,45235,2,2,0,2,0
2020-03-13,Colusa,11,21464,0,0,0,0,0
2020-03-13,Contra Costa,13,1133247,125,22,0,22,0
2020-03-13,Del Norte,15,27424,0,0,0,0,0
2020-03-13,El Dorado,17,186661,11,0,0,0,0
2020-03-13,Fresno,19,978130,19,1,1,2,0
2020-03-13,Glenn,21,27897,0,0,0,0,0
2020-03-13,Humboldt,23,135768,7,1,0,1,0
2020-03-13,Imperial,25,180216,13,2,0,2,0
2020-03-13,Inyo,27,18085,0,0,0,0,0
2020-03-13,Kern,29,883053,27,0,0,0,0
2020-03-13,Kings,31,150075,5,0,1,1,0
2020-03-13,Lake,33,64148,0,0,0,0,0
2020-03-13,Lassen,35,31185,0,0,0,0,0
2020-03-13,Los Angeles,37,10098052,1043,30,13,43,0
2020-03-13,Madera,39,155013,16,1,0,1,0
2020-03-13,Marin,41,260295,34,3,0,3,0
2020-03-13,Mariposa,43,17540,0,0,0,0,0
2020-03-13,Mendocino,45,87422,1,0,0,0,0
2020-03-13,Merced,47,269075,2,0,0,0,0
2020-03-13,Modoc,49,8938,0,0,0,0,0
2020-03-13,Mono,51,14174,3,0,0,0,0
2020-03-13,Monterey,53,433212,8,0,0,0,0
2020-03-13,Napa,55,140530,3,0,0,0,0
2020-03-13,Nevada,57,99092,7,0,1,1,0
2020-03-13,Orange,59,3164182,273,10,0,10,0
2020-03-13,Placer,61,380077,26,6,0,6,1
2020-03-13,Plumas,63,18699,0,0,0,0,0
2020-03-13,Riverside,65,2383286,120,5,2,7,0
2020-03-13,Sacramento,67,1510023,129,18,0,18,1
2020-03-13,San Benito,69,59416,6,2,0,2,0
2020-03-13,San Bernardino,71,2135413,93,0,0,0,0
2020-03-13,San Diego,73,3302833,313,8,0,8,0
2020-03-13,San Francisco,75,870044,170,28,0,28,0
2020-03-13,San Joaquin,77,732212,50,6,3,9,0
2020-03-13,San Luis Obispo,79,281455,32,0,0,0,0
2020-03-13,San Mateo,81,765935,191,24,1,25,0
2020-03-13,Santa Barbara,83,443738,38,0,0,0,0
2020-03-13,Santa Clara,85,1922200,459,59,1,60,1
2020-03-13,Santa Cruz,87,273765,32,7,0,7,0
2020-03-13,Shasta,89,179085,3,1,0,1,0
2020-03-13,Sierra,91,2930,0,0,0,0,0
2020-03-13,Siskiyou,93,43540,0,0,0,0,0
2020-03-13,Solano,95,438530,39,26,0,26,0
2020-03-13,Sonoma,97,501317,40,2,0,2,0
2020-03-13,Stanislaus,99,539301,17,2,2,4,0
2020-03-13,Sutter,101,95872,2,0,0,0,0
2020-03-13,Tehama,103,63373,0,0,0,0,0
2020-03-13,Trinity,105,12862,0,0,0,0,0
2020-03-13,Tulare,107,460477,9,2,1,3,0
2020-03-13,Tuolumne,109,53932,1,0,0,0,0
2020-03-13,Ventura,111,848112,54,5,0,5,0
2020-03-13,Yolo,113,214977,15,1,0,1,0
2020-03-13,Yuba,115,75493,1,0,0,0,0
2020-03-12,Alameda,1,1643700,148,9,0,9,0
2020-03-12,Alpine,3,1148,0,0,0,0,0
2020-03-12,Amador,5,37829,1,0,0,0,0
2020-03-12,Butte,7,227075,0,0,0,0,0
2020-03-12,Calaveras,9,45235,2,2,0,2,0
2020-03-12,Colusa,11,21464,0,0,0,0,0
2020-03-12,Contra Costa,13,1133247,108,18,0,18,0
2020-03-12,Del Norte,15,27424,0,0,0,0,0
2020-03-12,El Dorado,17,186661,9,0,0,0,0
2020-03-12,Fresno,19,978130,10,1,1,2,0
2020-03-12,Glenn,21,27897,0,0,0,0,0
2020-03-12,Humboldt,23,135768,6,1,0,1,0
2020-03-12,Imperial,25,180216,12,2,0,2,0
2020-03-12,Inyo,27,18085,0,0,0,0,0
2020-03-12,Kern,29,883053,18,0,0,0,0
2020-03-12,Kings,31,150075,4,0,1,1,0
2020-03-12,Lake,33,64148,0,0,0,0,0
2020-03-12,Lassen,35,31185,0,0,0,0,0
2020-03-12,Los Angeles,37,10098052,883,30,13,43,0
2020-03-12,Madera,39,155013,13,1,0,1,0
2020-03-12,Marin,41,260295,24,1,0,1,0
2020-03-12,Mariposa,43,17540,0,0,0,0,0
2020-03-12,Mendocino,45,87422,1,0,0,0,0
2020-03-12,Merced,47,269075,2,0,0,0,0
2020-03-12,Modoc,49,8938,0,0,0,0,0
2020-03-12,Mono,51,14174,3,0,0,0,0
2020-03-12,Monterey,53,433212,6,0,0,0,0
2020-03-12,Napa,55,140530,3,0,0,0,0
2020-03-12,Nevada,57,99092,4,0,1,1,0
2020-03-12,Orange,59,3164182,237,7,0,7,0
2020-03-12,Placer,61,380077,22,6,0,6,1
2020-03-12,Plumas,63,18699,0,0,0,0,0
2020-03-12,Riverside,65,2383286,97,5,1,6,0
2020-03-12,Sacramento,67,1510023,105,17,0,17,1
2020-03-12,San Benito,69,59416,5,2,0,2,0
2020-03-12,San Bernardino,71,2135413,77,0,0,0,0
2020-03-12,San Diego,73,3302833,258,9,0,9,0
2020-03-12,San Francisco,75,870044,147,20,0,20,0
2020-03-12,San Joaquin,77,732212,44,3,3,6,1
2020-03-12,San Luis Obispo,79,281455,25,0,0,0,0
2020-03-12,San Mateo,81,765935,157,21,1,22,0
2020-03-12,Santa Barbara,83,443738,26,0,0,0,0
2020-03-12,Santa Clara,85,1922200,401,51,1,52,1
2020-03-12,Santa Cruz,87,273765,29,5,0,5,0
2020-03-12,Shasta,89,179085,2,1,0,1,0
2020-03-12,Sierra,91,2930,0,0,0,0,0
2020-03-12,Siskiyou,93,43540,0,0,0,0,0
2020-03-12,Solano,95,438530,34,26,0,26,0
2020-03-12,Sonoma,97,501317,34,2,0,2,0
2020-03-12,Stanislaus,99,539301,15,2,2,4,0
2020-03-12,Sutter,101,95872,0,0,0,0,0
2020-03-12,Tehama,103,63373,0,0,0,0,0
2020-03-12,Trinity,105,12862,0,0,0,0,0
2020-03-12,Tulare,107,460477,9,1,0,1,0
2020-03-12,Tuolumne,109,53932,1,0,0,0,0
2020-03-12,Ventura,111,848112,45,3,0,3,0
2020-03-12,Yolo,113,214977,14,1,0,1,0
2020-03-12,Yuba,115,75493,1,0,0,0,0
2020-03-11,Alameda,1,1643700,117,5,0,5,0
2020-03-11,Alpine,3,1148,0,0,0,0,0
2020-03-11,Amador,5,37829,1,0,0,0,0
2020-03-11,Butte,7,227075,0,0,0,0,0
2020-03-11,Calaveras,9,45235,2,2,0,2,0
2020-03-11,Colusa,11,21464,0,0,0,0,0
2020-03-11,Contra Costa,13,1133247,93,16,0,16,0
2020-03-11,Del Norte,15,27424,0,0,0,0,0
2020-03-11,El Dorado,17,186661,8,0,0,0,0
2020-03-11,Fresno,19,978130,8,1,1,2,0
2020-03-11,Glenn,21,27897,0,0,0,0,0
2020-03-11,Humboldt,23,135768,6,1,0,1,0
2020-03-11,Imperial,25,180216,10,0,0,0,0
2020-03-11,Inyo,27,18085,0,0,0,0,0
2020-03-11,Kern,29,883053,16,0,0,0,0
2020-03-11,Kings,31,150075,3,0,1,1,0
2020-03-11,Lake,33,64148,0,0,0,0,0
2020-03-11,Lassen,35,31185,0,0,0,0,0
2020-03-11,Los Angeles,37,10098052,715,21,13,34,0
2020-03-11,Madera,39,155013,11,1,0,1,0
2020-03-11,Marin,41,260295,17,1,0,1,0
2020-03-11,Mariposa,43,17540,0,0,0,0,0
2020-03-11,Mendocino,45,87422,0,0,0,0,0
2020-03-11,Merced,47,269075,2,0,0,0,0
2020-03-11,Modoc,49,8938,0,0,0,0,0
2020-03-11,Mono,51,14174,3,0,0,0,0
2020-03-11,Monterey,53,433212,5,0,0,0,0
2020-03-11,Napa,55,140530,2,0,0,0,0
2020-03-11,Nevada,57,99092,4,0,1,1,0
2020-03-11,Orange,59,3164182,206,6,0,6,0
2020-03-11,Placer,61,380077,18,6,0,6,1
2020-03-11,Plumas,63,18699,0,0,0,0,0
2020-03-11,Riverside,65,2383286,74,4,1,5,0
2020-03-11,Sacramento,67,1510023,87,9,0,9,1
2020-03-11,San Benito,69,59416,5,2,0,2,0
2020-03-11,San Bernardino,71,2135413,70,0,0,0,0
2020-03-11,San Diego,73,3302833,208,4,0,4,0
2020-03-11,San Francisco,75,870044,122,17,0,17,0
2020-03-11,San Joaquin,77,732212,33,1,3,4,0
2020-03-11,San Luis Obispo,79,281455,22,0,0,0,0
2020-03-11,San Mateo,81,765935,139,16,0,16,0
2020-03-11,Santa Barbara,83,443738,16,0,0,0,0
2020-03-11,Santa Clara,85,1922200,361,48,1,49,1
2020-03-11,Santa Cruz,87,273765,26,2,0,2,0
2020-03-11,Shasta,89,179085,2,1,0,1,0
2020-03-11,Sierra,91,2930,0,0,0,0,0
2020-03-11,Siskiyou,93,43540,0,0,0,0,0
2020-03-11,Solano,95,438530,29,26,0,26,0
2020-03-11,Sonoma,97,501317,30,2,0,2,0
2020-03-11,Stanislaus,99,539301,15,2,2,4,0
2020-03-11,Sutter,101,95872,0,0,0,0,0
2020-03-11,Tehama,103,63373,0,0,0,0,0
2020-03-11,Trinity,105,12862,0,0,0,0,0
2020-03-11,Tulare,107,460477,8,0,0,0,0
2020-03-11,Tuolumne,109,53932,1,0,0,0,0
2020-03-11,Ventura,111,848112,37,3,0,3,0
2020-03-11,Yolo,113,214977,10,1,0,1,0
2020-03-11,Yuba,115,75493,1,0,0,0,0
2020-03-10,Alameda,1,1643700,98,4,0,4,0
2020-03-10,Alpine,3,1148,0,0,0,0,0
2020-03-10,Amador,5,37829,1,0,0,0,0
2020-03-10,Butte,7,227075,0,0,0,0,0
2020-03-10,Calaveras,9,45235,2,2,0,2,0
2020-03-10,Colusa,11,21464,0,0,0,0,0
2020-03-10,Contra Costa,13,1133247,84,11,0,11,0
2020-03-10,Del Norte,15,27424,0,0,0,0,0
2020-03-10,El Dorado,17,186661,7,0,0,0,0
2020-03-10,Fresno,19,978130,6,1,1,2,0
2020-03-10,Glenn,21,27897,0,0,0,0,0
2020-03-10,Humboldt,23,135768,6,1,0,1,0
2020-03-10,Imperial,25,180216,9,0,0,0,0
2020-03-10,Inyo,27,18085,0,0,0,0,0
2020-03-10,Kern,29,883053,11,0,0,0,0
2020-03-10,Kings,31,150075,3,0,1,1,0
2020-03-10,Lake,33,64148,0,0,0,0,0
2020-03-10,Lassen,35,31185,0,0,0,0,0
2020-03-10,Los Angeles,37,10098052,579,20,13,33,0
2020-03-10,Madera,39,155013,7,1,0,1,0
2020-03-10,Marin,41,260295,16,1,0,1,0
2020-03-10,Mariposa,43,17540,0,0,0,0,0
2020-03-10,Mendocino,45,87422,0,0,0,0,0
2020-03-10,Merced,47,269075,2,0,0,0,0
2020-03-10,Modoc,49,8938,0,0,0,0,0
2020-03-10,Mono,51,14174,3,0,0,0,0
2020-03-10,Monterey,53,433212,3,0,0,0,0
2020-03-10,Napa,55,140530,2,0,0,0,0
2020-03-10,Nevada,57,99092,3,0,1,1,0
2020-03-10,Orange,59,3164182,186,5,0,5,1
2020-03-10,Placer,61,380077,14,7,0,7,1
2020-03-10,Plumas,63,18699,0,0,0,0,0
2020-03-10,Riverside,65,2383286,56,4,1,5,0
2020-03-10,Sacramento,67,1510023,78,8,0,8,0
2020-03-10,San Benito,69,59416,5,2,0,2,0
2020-03-10,San Bernardino,71,2135413,62,0,0,0,0
2020-03-10,San Diego,73,3302833,165,3,0,3,0
2020-03-10,San Francisco,75,870044,91,16,0,16,0
2020-03-10,San Joaquin,77,732212,30,1,3,4,0
2020-03-10,San Luis Obispo,79,281455,15,0,0,0,0
2020-03-10,San Mateo,81,765935,123,11,0,11,0
2020-03-10,Santa Barbara,83,443738,12,0,0,0,0
2020-03-10,Santa Clara,85,1922200,314,45,1,46,1
2020-03-10,Santa Cruz,87,273765,22,2,0,2,0
2020-03-10,Shasta,89,179085,2,1,0,1,0
2020-03-10,Sierra,91,2930,0,0,0,0,0
2020-03-10,Siskiyou,93,43540,0,0,0,0,0
2020-03-10,Solano,95,438530,27,26,0,26,0
2020-03-10,Sonoma,97,501317,27,2,0,2,0
2020-03-10,Stanislaus,99,539301,11,0,2,2,0
2020-03-10,Sutter,101,95872,0,0,0,0,0
2020-03-10,Tehama,103,63373,0,0,0,0,0
2020-03-10,Trinity,105,12862,0,0,0,0,0
2020-03-10,Tulare,107,460477,7,0,0,0,0
2020-03-10,Tuolumne,109,53932,1,0,0,0,0
2020-03-10,Ventura,111,848112,29,1,0,1,0
2020-03-10,Yolo,113,214977,7,2,0,2,0
2020-03-10,Yuba,115,75493,1,0,0,0,0
2020-03-09,Alameda,1,1643700,71,4,0,4,0
2020-03-09,Alpine,3,1148,0,0,0,0,0
2020-03-09,Amador,5,37829,0,0,0,0,0
2020-03-09,Butte,7,227075,0,0,0,0,0
2020-03-09,Calaveras,9,45235,2,0,0,0,0
2020-03-09,Colusa,11,21464,0,0,0,0,0
2020-03-09,Contra Costa,13,1133247,72,9,0,9,0
2020-03-09,Del Norte,15,27424,0,0,0,0,0
2020-03-09,El Dorado,17,186661,5,0,0,0,0
2020-03-09,Fresno,19,978130,6,1,1,2,0
2020-03-09,Glenn,21,27897,0,0,0,0,0
2020-03-09,Humboldt,23,135768,5,1,0,1,0
2020-03-09,Imperial,25,180216,9,0,0,0,0
2020-03-09,Inyo,27,18085,0,0,0,0,0
2020-03-09,Kern,29,883053,8,0,0,0,0
2020-03-09,Kings,31,150075,2,0,1,1,0
2020-03-09,Lake,33,64148,0,0,0,0,0
2020-03-09,Lassen,35,31185,0,0,0,0,0
2020-03-09,Los Angeles,37,10098052,478,17,12,29,0
2020-03-09,Madera,39,155013,7,1,0,1,0
2020-03-09,Marin,41,260295,15,1,0,1,0
2020-03-09,Mariposa,43,17540,0,0,0,0,0
2020-03-09,Mendocino,45,87422,0,0,0,0,0
2020-03-09,Merced,47,269075,2,0,0,0,0
2020-03-09,Modoc,49,8938,0,0,0,0,0
2020-03-09,Mono,51,14174,3,0,0,0,0
2020-03-09,Monterey,53,433212,1,0,0,0,0
2020-03-09,Napa,55,140530,2,0,0,0,0
2020-03-09,Nevada,57,99092,2,0,1,1,0
2020-03-09,Orange,59,3164182,157,4,0,4,0
2020-03-09,Placer,61,380077,12,7,0,7,1
2020-03-09,Plumas,63,18699,0,0,0,0,0
2020-03-09,Riverside,65,2383286,47,4,1,5,0
2020-03-09,Sacramento,67,1510023,74,8,0,8,0
2020-03-09,San Benito,69,59416,3,2,0,2,0
2020-03-09,San Bernardino,71,2135413,51,0,0,0,0
2020-03-09,San Diego,73,3302833,126,2,0,2,0
2020-03-09,San Francisco,75,870044,71,14,0,14,0
2020-03-09,San Joaquin,77,732212,21,0,3,3,0
2020-03-09,San Luis Obispo,79,281455,15,0,0,0,0
2020-03-09,San Mateo,81,765935,109,6,0,6,0
2020-03-09,Santa Barbara,83,443738,10,0,0,0,0
2020-03-09,Santa Clara,85,1922200,271,42,1,43,1
2020-03-09,Santa Cruz,87,273765,19,2,0,2,0
2020-03-09,Shasta,89,179085,2,1,0,1,0
2020-03-09,Sierra,91,2930,0,0,0,0,0
2020-03-09,Siskiyou,93,43540,0,0,0,0,0
2020-03-09,Solano,95,438530,25,26,0,26,0
2020-03-09,Sonoma,97,501317,22,2,0,2,0
2020-03-09,Stanislaus,99,539301,11,0,2,2,0
2020-03-09,Sutter,101,95872,0,0,0,0,0
2020-03-09,Tehama,103,63373,0,0,0,0,0
2020-03-09,Trinity,105,12862,0,0,0,0,0
2020-03-09,Tulare,107,460477,7,0,0,0,0
2020-03-09,Tuolumne,109,53932,1,0,0,0,0
2020-03-09,Ventura,111,848112,25,1,0,1,0
2020-03-09,Yolo,113,214977,6,2,0,2,0
2020-03-09,Yuba,115,75493,0,0,0,0,0
2020-03-08,Alameda,1,1643700,46,4,0,4,0
2020-03-08,Alpine,3,1148,0,0,0,0,0
2020-03-08,Amador,5,37829,0,0,0,0,0
2020-03-08,Butte,7,227075,0,0,0,0,0
2020-03-08,Calaveras,9,45235,2,0,0,0,0
2020-03-08,Colusa,11,21464,0,0,0,0,0
2020-03-08,Contra Costa,13,1133247,58,9,0,9,0
2020-03-08,Del Norte,15,27424,0,0,0,0,0
2020-03-08,El Dorado,17,186661,5,0,0,0,0
2020-03-08,Fresno,19,978130,4,1,1,2,0
2020-03-08,Glenn,21,27897,0,0,0,0,0
2020-03-08,Humboldt,23,135768,5,1,0,1,0
2020-03-08,Imperial,25,180216,9,0,0,0,0
2020-03-08,Inyo,27,18085,0,0,0,0,0
2020-03-08,Kern,29,883053,8,0,0,0,0
2020-03-08,Kings,31,150075,1,0,1,1,0
2020-03-08,Lake,33,64148,0,0,0,0,0
2020-03-08,Lassen,35,31185,0,0,0,0,0
2020-03-08,Los Angeles,37,10098052,386,14,12,26,0
2020-03-08,Madera,39,155013,7,1,0,1,0
2020-03-08,Marin,41,260295,13,1,0,1,0
2020-03-08,Mariposa,43,17540,0,0,0,0,0
2020-03-08,Mendocino,45,87422,0,0,0,0,0
2020-03-08,Merced,47,269075,2,0,0,0,0
2020-03-08,Modoc,49,8938,0,0,0,0,0
2020-03-08,Mono,51,14174,3,0,0,0,0
2020-03-08,Monterey,53,433212,1,0,0,0,0
2020-03-08,Napa,55,140530,2,0,0,0,0
2020-03-08,Nevada,57,99092,1,0,1,1,0
2020-03-08,Orange,59,3164182,132,4,0,4,0
2020-03-08,Placer,61,380077,11,7,0,7,1
2020-03-08,Plumas,63,18699,0,0,0,0,0
2020-03-08,Riverside,65,2383286,40,1,1,2,0
2020-03-08,Sacramento,67,1510023,64,5,0,5,0
2020-03-08,San Benito,69,59416,3,2,0,2,0
2020-03-08,San Bernardino,71,2135413,40,0,0,0,0
2020-03-08,San Diego,73,3302833,92,2,0,2,0
2020-03-08,San Francisco,75,870044,52,9,0,9,0
2020-03-08,San Joaquin,77,732212,18,0,3,3,0
2020-03-08,San Luis Obispo,79,281455,9,0,0,0,0
2020-03-08,San Mateo,81,765935,96,4,0,4,0
2020-03-08,Santa Barbara,83,443738,6,0,0,0,0
2020-03-08,Santa Clara,85,1922200,230,36,1,37,0
2020-03-08,Santa Cruz,87,273765,17,1,0,1,0
2020-03-08,Shasta,89,179085,2,0,0,0,0
2020-03-08,Sierra,91,2930,0,0,0,0,0
2020-03-08,Siskiyou,93,43540,0,0,0,0,0
2020-03-08,Solano,95,438530,24,26,0,26,0
2020-03-08,Sonoma,97,501317,17,2,0,2,0
2020-03-08,Stanislaus,99,539301,10,0,2,2,0
2020-03-08,Sutter,101,95872,0,0,0,0,0
2020-03-08,Tehama,103,63373,0,0,0,0,0
2020-03-08,Trinity,105,12862,0,0,0,0,0
2020-03-08,Tulare,107,460477,7,0,0,0,0
2020-03-08,Tuolumne,109,53932,1,0,0,0,0
2020-03-08,Ventura,111,848112,21,1,0,1,0
2020-03-08,Yolo,113,214977,3,2,0,2,0
2020-03-08,Yuba,115,75493,0,0,0,0,0
2020-03-07,Alameda,1,1643700,41,3,0,3,0
2020-03-07,Alpine,3,1148,0,0,0,0,0
2020-03-07,Amador,5,37829,0,0,0,0,0
2020-03-07,Butte,7,227075,0,0,0,0,0
2020-03-07,Calaveras,9,45235,2,0,0,0,0
2020-03-07,Colusa,11,21464,0,0,0,0,0
2020-03-07,Contra Costa,13,1133247,55,4,0,4,0
2020-03-07,Del Norte,15,27424,0,0,0,0,0
2020-03-07,El Dorado,17,186661,4,0,0,0,0
2020-03-07,Fresno,19,978130,3,1,1,2,0
2020-03-07,Glenn,21,27897,0,0,0,0,0
2020-03-07,Humboldt,23,135768,5,1,0,1,0
2020-03-07,Imperial,25,180216,8,0,0,0,0
2020-03-07,Inyo,27,18085,0,0,0,0,0
2020-03-07,Kern,29,883053,7,0,0,0,0
2020-03-07,Kings,31,150075,1,0,1,1,0
2020-03-07,Lake,33,64148,0,0,0,0,0
2020-03-07,Lassen,35,31185,0,0,0,0,0
2020-03-07,Los Angeles,37,10098052,336,14,12,26,0
2020-03-07,Madera,39,155013,6,1,0,1,0
2020-03-07,Marin,41,260295,11,0,0,0,0
2020-03-07,Mariposa,43,17540,0,0,0,0,0
2020-03-07,Mendocino,45,87422,0,0,0,0,0
2020-03-07,Merced,47,269075,2,0,0,0,0
2020-03-07,Modoc,49,8938,0,0,0,0,0
2020-03-07,Mono,51,14174,3,0,0,0,0
2020-03-07,Monterey,53,433212,1,0,0,0,0
2020-03-07,Napa,55,140530,1,0,0,0,0
2020-03-07,Nevada,57,99092,1,0,1,1,0
2020-03-07,Orange,59,3164182,124,4,0,4,0
2020-03-07,Placer,61,380077,10,6,0,6,1
2020-03-07,Plumas,63,18699,0,0,0,0,0
2020-03-07,Riverside,65,2383286,30,0,1,1,0
2020-03-07,Sacramento,67,1510023,51,4,0,4,0
2020-03-07,San Benito,69,59416,3,2,0,2,0
2020-03-07,San Bernardino,71,2135413,38,0,0,0,0
2020-03-07,San Diego,73,3302833,74,2,0,2,0
2020-03-07,San Francisco,75,870044,46,9,0,9,0
2020-03-07,San Joaquin,77,732212,16,0,3,3,0
2020-03-07,San Luis Obispo,79,281455,6,0,0,0,0
2020-03-07,San Mateo,81,765935,86,1,0,1,0
2020-03-07,Santa Barbara,83,443738,5,0,0,0,0
2020-03-07,Santa Clara,85,1922200,201,31,1,32,0
2020-03-07,Santa Cruz,87,273765,17,1,0,1,0
2020-03-07,Shasta,89,179085,2,0,0,0,0
2020-03-07,Sierra,91,2930,0,0,0,0,0
2020-03-07,Siskiyou,93,43540,0,0,0,0,0
2020-03-07,Solano,95,438530,23,25,0,25,0
2020-03-07,Sonoma,97,501317,13,2,0,2,0
2020-03-07,Stanislaus,99,539301,9,0,2,2,0
2020-03-07,Sutter,101,95872,0,0,0,0,0
2020-03-07,Tehama,103,63373,0,0,0,0,0
2020-03-07,Trinity,105,12862,0,0,0,0,0
2020-03-07,Tulare,107,460477,4,0,0,0,0
2020-03-07,Tuolumne,109,53932,1,0,0,0,0
2020-03-07,Ventura,111,848112,18,1,0,1,0
2020-03-07,Yolo,113,214977,3,2,0,2,0
2020-03-07,Yuba,115,75493,0,0,0,0,0
2020-03-06,Alameda,1,1643700,39,3,0,3,0
2020-03-06,Alpine,3,1148,0,0,0,0,0
2020-03-06,Amador,5,37829,0,0,0,0,0
2020-03-06,Butte,7,227075,0,0,0,0,0
2020-03-06,Calaveras,9,45235,2,0,0,0,0
2020-03-06,Colusa,11,21464,0,0,0,0,0
2020-03-06,Contra Costa,13,1133247,46,4,0,4,0
2020-03-06,Del Norte,15,27424,0,0,0,0,0
2020-03-06,El Dorado,17,186661,3,0,0,0,0
2020-03-06,Fresno,19,978130,2,0,1,1,0
2020-03-06,Glenn,21,27897,0,0,0,0,0
2020-03-06,Humboldt,23,135768,4,1,0,1,0
2020-03-06,Imperial,25,180216,7,0,0,0,0
2020-03-06,Inyo,27,18085,0,0,0,0,0
2020-03-06,Kern,29,883053,6,0,0,0,0
2020-03-06,Kings,31,150075,1,0,1,1,0
2020-03-06,Lake,33,64148,0,0,0,0,0
2020-03-06,Lassen,35,31185,0,0,0,0,0
2020-03-06,Los Angeles,37,10098052,293,13,12,25,0
2020-03-06,Madera,39,155013,5,0,0,0,0
2020-03-06,Marin,41,260295,10,0,0,0,0
2020-03-06,Mariposa,43,17540,0,0,0,0,0
2020-03-06,Mendocino,45,87422,0,0,0,0,0
2020-03-06,Merced,47,269075,2,0,0,0,0
2020-03-06,Modoc,49,8938,0,0,0,0,0
2020-03-06,Mono,51,14174,1,0,0,0,0
2020-03-06,Monterey,53,433212,1,0,0,0,0
2020-03-06,Napa,55,140530,1,0,0,0,0
2020-03-06,Nevada,57,99092,1,0,1,1,0
2020-03-06,Orange,59,3164182,98,4,0,4,0
2020-03-06,Placer,61,380077,10,5,0,5,1
2020-03-06,Plumas,63,18699,0,0,0,0,0
2020-03-06,Riverside,65,2383286,30,0,1,1,0
2020-03-06,Sacramento,67,1510023,42,2,0,2,0
2020-03-06,San Benito,69,59416,3,2,0,2,0
2020-03-06,San Bernardino,71,2135413,36,0,0,0,0
2020-03-06,San Diego,73,3302833,61,2,0,2,0
2020-03-06,San Francisco,75,870044,40,2,0,2,0
2020-03-06,San Joaquin,77,732212,13,0,3,3,0
2020-03-06,San Luis Obispo,79,281455,4,0,0,0,0
2020-03-06,San Mateo,81,765935,78,1,0,1,0
2020-03-06,Santa Barbara,83,443738,3,0,0,0,0
2020-03-06,Santa Clara,85,1922200,183,20,1,21,0
2020-03-06,Santa Cruz,87,273765,15,0,0,0,0
2020-03-06,Shasta,89,179085,2,0,0,0,0
2020-03-06,Sierra,91,2930,0,0,0,0,0
2020-03-06,Siskiyou,93,43540,0,0,0,0,0
2020-03-06,Solano,95,438530,22,25,0,25,0
2020-03-06,Sonoma,97,501317,13,2,0,2,0
2020-03-06,Stanislaus,99,539301,6,0,2,2,0
2020-03-06,Sutter,101,95872,0,0,0,0,0
2020-03-06,Tehama,103,63373,0,0,0,0,0
2020-03-06,Trinity,105,12862,0,0,0,0,0
2020-03-06,Tulare,107,460477,4,0,0,0,0
2020-03-06,Tuolumne,109,53932,1,0,0,0,0
2020-03-06,Ventura,111,848112,15,1,0,1,0
2020-03-06,Yolo,113,214977,3,1,0,1,0
2020-03-06,Yuba,115,75493,0,0,0,0,0
2020-03-05,Alameda,1,1643700,34,2,0,2,0
2020-03-05,Alpine,3,1148,0,0,0,0,0
2020-03-05,Amador,5,37829,0,0,0,0,0
2020-03-05,Butte,7,227075,0,0,0,0,0
2020-03-05,Calaveras,9,45235,2,0,0,0,0
2020-03-05,Colusa,11,21464,0,0,0,0,0
2020-03-05,Contra Costa,13,1133247,39,1,0,1,0
2020-03-05,Del Norte,15,27424,0,0,0,0,0
2020-03-05,El Dorado,17,186661,1,0,0,0,0
2020-03-05,Fresno,19,978130,2,0,1,1,0
2020-03-05,Glenn,21,27897,0,0,0,0,0
2020-03-05,Humboldt,23,135768,4,1,0,1,0
2020-03-05,Imperial,25,180216,5,0,0,0,0
2020-03-05,Inyo,27,18085,0,0,0,0,0
2020-03-05,Kern,29,883053,6,0,0,0,0
2020-03-05,Kings,31,150075,1,0,1,1,0
2020-03-05,Lake,33,64148,0,0,0,0,0
2020-03-05,Lassen,35,31185,0,0,0,0,0
2020-03-05,Los Angeles,37,10098052,246,11,12,23,0
2020-03-05,Madera,39,155013,5,0,0,0,0
2020-03-05,Marin,41,260295,10,0,0,0,0
2020-03-05,Mariposa,43,17540,0,0,0,0,0
2020-03-05,Mendocino,45,87422,0,0,0,0,0
2020-03-05,Merced,47,269075,2,0,0,0,0
2020-03-05,Modoc,49,8938,0,0,0,0,0
2020-03-05,Mono,51,14174,1,0,0,0,0
2020-03-05,Monterey,53,433212,1,0,0,0,0
2020-03-05,Napa,55,140530,1,0,0,0,0
2020-03-05,Nevada,57,99092,0,0,1,1,0
2020-03-05,Orange,59,3164182,83,3,0,3,0
2020-03-05,Placer,61,380077,10,2,0,2,1
2020-03-05,Plumas,63,18699,0,0,0,0,0
2020-03-05,Riverside,65,2383286,27,0,1,1,0
2020-03-05,Sacramento,67,1510023,36,2,0,2,0
2020-03-05,San Benito,69,59416,1,2,0,2,0
2020-03-05,San Bernardino,71,2135413,31,0,0,0,0
2020-03-05,San Diego,73,3302833,54,2,0,2,0
2020-03-05,San Francisco,75,870044,30,2,0,2,0
2020-03-05,San Joaquin,77,732212,10,0,3,3,0
2020-03-05,San Luis Obispo,79,281455,4,0,0,0,0
2020-03-05,San Mateo,81,765935,65,1,0,1,0
2020-03-05,Santa Barbara,83,443738,2,0,0,0,0
2020-03-05,Santa Clara,85,1922200,162,14,1,15,0
2020-03-05,Santa Cruz,87,273765,13,0,0,0,0
2020-03-05,Shasta,89,179085,2,0,0,0,0
2020-03-05,Sierra,91,2930,0,0,0,0,0
2020-03-05,Siskiyou,93,43540,0,0,0,0,0
2020-03-05,Solano,95,438530,22,24,0,24,0
2020-03-05,Sonoma,97,501317,12,2,0,2,0
2020-03-05,Stanislaus,99,539301,5,0,2,2,0
2020-03-05,Sutter,101,95872,0,0,0,0,0
2020-03-05,Tehama,103,63373,0,0,0,0,0
2020-03-05,Trinity,105,12862,0,0,0,0,0
2020-03-05,Tulare,107,460477,4,0,0,0,0
2020-03-05,Tuolumne,109,53932,1,0,0,0,0
2020-03-05,Ventura,111,848112,13,0,0,0,0
2020-03-05,Yolo,113,214977,3,0,0,0,0
2020-03-05,Yuba,115,75493,0,0,0,0,0
2020-03-04,Alameda,1,1643700,30,2,0,2,0
2020-03-04,Alpine,3,1148,0,0,0,0,0
2020-03-04,Amador,5,37829,0,0,0,0,0
2020-03-04,Butte,7,227075,0,0,0,0,0
2020-03-04,Calaveras,9,45235,0,0,0,0,0
2020-03-04,Colusa,11,21464,0,0,0,0,0
2020-03-04,Contra Costa,13,1133247,34,1,0,1,0
2020-03-04,Del Norte,15,27424,0,0,0,0,0
2020-03-04,El Dorado,17,186661,1,0,0,0,0
2020-03-04,Fresno,19,978130,2,0,1,1,0
2020-03-04,Glenn,21,27897,0,0,0,0,0
2020-03-04,Humboldt,23,135768,1,1,0,1,0
2020-03-04,Imperial,25,180216,5,0,0,0,0
2020-03-04,Inyo,27,18085,0,0,0,0,0
2020-03-04,Kern,29,883053,6,0,0,0,0
2020-03-04,Kings,31,150075,1,0,1,1,0
2020-03-04,Lake,33,64148,0,0,0,0,0
2020-03-04,Lassen,35,31185,0,0,0,0,0
2020-03-04,Los Angeles,37,10098052,211,7,12,19,0
2020-03-04,Madera,39,155013,5,0,0,0,0
2020-03-04,Marin,41,260295,10,0,0,0,0
2020-03-04,Mariposa,43,17540,0,0,0,0,0
2020-03-04,Mendocino,45,87422,0,0,0,0,0
2020-03-04,Merced,47,269075,2,0,0,0,0
2020-03-04,Modoc,49,8938,0,0,0,0,0
2020-03-04,Mono,51,14174,1,0,0,0,0
2020-03-04,Monterey,53,433212,1,0,0,0,0
2020-03-04,Napa,55,140530,1,0,0,0,0
2020-03-04,Nevada,57,99092,0,0,1,1,0
2020-03-04,Orange,59,3164182,80,3,0,3,0
2020-03-04,Placer,61,380077,9,2,0,2,1
2020-03-04,Plumas,63,18699,0,0,0,0,0
2020-03-04,Riverside,65,2383286,23,0,1,1,0
2020-03-04,Sacramento,67,1510023,32,1,0,1,0
2020-03-04,San Benito,69,59416,1,2,0,2,0
2020-03-04,San Bernardino,71,2135413,28,0,0,0,0
2020-03-04,San Diego,73,3302833,41,2,0,2,0
2020-03-04,San Francisco,75,870044,25,0,0,0,0
2020-03-04,San Joaquin,77,732212,9,0,3,3,0
2020-03-04,San Luis Obispo,79,281455,4,0,0,0,0
2020-03-04,San Mateo,81,765935,60,1,0,1,0
2020-03-04,Santa Barbara,83,443738,2,0,0,0,0
2020-03-04,Santa Clara,85,1922200,145,12,1,13,0
2020-03-04,Santa Cruz,87,273765,13,0,0,0,0
2020-03-04,Shasta,89,179085,2,0,0,0,0
2020-03-04,Sierra,91,2930,0,0,0,0,0
2020-03-04,Siskiyou,93,43540,0,0,0,0,0
2020-03-04,Solano,95,438530,21,24,0,24,0
2020-03-04,Sonoma,97,501317,11,2,0,2,0
2020-03-04,Stanislaus,99,539301,5,0,2,2,0
2020-03-04,Sutter,101,95872,0,0,0,0,0
2020-03-04,Tehama,103,63373,0,0,0,0,0
2020-03-04,Trinity,105,12862,0,0,0,0,0
2020-03-04,Tulare,107,460477,4,0,0,0,0
2020-03-04,Tuolumne,109,53932,0,0,0,0,0
2020-03-04,Ventura,111,848112,12,0,0,0,0
2020-03-04,Yolo,113,214977,3,0,0,0,0
2020-03-04,Yuba,115,75493,0,0,0,0,0
2020-03-03,Alameda,1,1643700,24,2,0,2,0
2020-03-03,Alpine,3,1148,0,0,0,0,0
2020-03-03,Amador,5,37829,0,0,0,0,0
2020-03-03,Butte,7,227075,0,0,0,0,0
2020-03-03,Calaveras,9,45235,0,0,0,0,0
2020-03-03,Colusa,11,21464,0,0,0,0,0
2020-03-03,Contra Costa,13,1133247,30,0,0,0,0
2020-03-03,Del Norte,15,27424,0,0,0,0,0
2020-03-03,El Dorado,17,186661,1,0,0,0,0
2020-03-03,Fresno,19,978130,1,0,1,1,0
2020-03-03,Glenn,21,27897,0,0,0,0,0
2020-03-03,Humboldt,23,135768,1,1,0,1,0
2020-03-03,Imperial,25,180216,5,0,0,0,0
2020-03-03,Inyo,27,18085,0,0,0,0,0
2020-03-03,Kern,29,883053,4,0,0,0,0
2020-03-03,Kings,31,150075,1,0,1,1,0
2020-03-03,Lake,33,64148,0,0,0,0,0
2020-03-03,Lassen,35,31185,0,0,0,0,0
2020-03-03,Los Angeles,37,10098052,192,5,12,17,0
2020-03-03,Madera,39,155013,4,0,0,0,0
2020-03-03,Marin,41,260295,6,0,0,0,0
2020-03-03,Mariposa,43,17540,0,0,0,0,0
2020-03-03,Mendocino,45,87422,0,0,0,0,0
2020-03-03,Merced,47,269075,2,0,0,0,0
2020-03-03,Modoc,49,8938,0,0,0,0,0
2020-03-03,Mono,51,14174,1,0,0,0,0
2020-03-03,Monterey,53,433212,0,0,0,0,0
2020-03-03,Napa,55,140530,1,0,0,0,0
2020-03-03,Nevada,57,99092,0,0,1,1,0
2020-03-03,Orange,59,3164182,72,1,0,1,0
2020-03-03,Placer,61,380077,8,2,0,2,0
2020-03-03,Plumas,63,18699,0,0,0,0,0
2020-03-03,Riverside,65,2383286,20,0,1,1,0
2020-03-03,Sacramento,67,1510023,31,1,0,1,0
2020-03-03,San Benito,69,59416,1,2,0,2,0
2020-03-03,San Bernardino,71,2135413,25,0,0,0,0
2020-03-03,San Diego,73,3302833,34,2,0,2,0
2020-03-03,San Francisco,75,870044,23,0,0,0,0
2020-03-03,San Joaquin,77,732212,8,0,3,3,0
2020-03-03,San Luis Obispo,79,281455,2,0,0,0,0
2020-03-03,San Mateo,81,765935,53,1,0,1,0
2020-03-03,Santa Barbara,83,443738,1,0,0,0,0
2020-03-03,Santa Clara,85,1922200,130,11,1,12,0
2020-03-03,Santa Cruz,87,273765,10,0,0,0,0
2020-03-03,Shasta,89,179085,2,0,0,0,0
2020-03-03,Sierra,91,2930,0,0,0,0,0
2020-03-03,Siskiyou,93,43540,0,0,0,0,0
2020-03-03,Solano,95,438530,20,24,0,24,0
2020-03-03,Sonoma,97,501317,11,1,0,1,0
2020-03-03,Stanislaus,99,539301,5,0,2,2,0
2020-03-03,Sutter,101,95872,0,0,0,0,0
2020-03-03,Tehama,103,63373,0,0,0,0,0
2020-03-03,Trinity,105,12862,0,0,0,0,0
2020-03-03,Tulare,107,460477,4,0,0,0,0
2020-03-03,Tuolumne,109,53932,0,0,0,0,0
2020-03-03,Ventura,111,848112,11,0,0,0,0
2020-03-03,Yolo,113,214977,2,0,0,0,0
2020-03-03,Yuba,115,75493,0,0,0,0,0
2020-03-02,Alameda,1,1643700,21,1,0,1,0
2020-03-02,Alpine,3,1148,0,0,0,0,0
2020-03-02,Amador,5,37829,0,0,0,0,0
2020-03-02,Butte,7,227075,0,0,0,0,0
2020-03-02,Calaveras,9,45235,0,0,0,0,0
2020-03-02,Colusa,11,21464,0,0,0,0,0
2020-03-02,Contra Costa,13,1133247,27,0,0,0,0
2020-03-02,Del Norte,15,27424,0,0,0,0,0
2020-03-02,El Dorado,17,186661,1,0,0,0,0
2020-03-02,Fresno,19,978130,1,0,1,1,0
2020-03-02,Glenn,21,27897,0,0,0,0,0
2020-03-02,Humboldt,23,135768,1,1,0,1,0
2020-03-02,Imperial,25,180216,5,0,0,0,0
2020-03-02,Inyo,27,18085,0,0,0,0,0
2020-03-02,Kern,29,883053,4,0,0,0,0
2020-03-02,Kings,31,150075,1,0,1,1,0
2020-03-02,Lake,33,64148,0,0,0,0,0
2020-03-02,Lassen,35,31185,0,0,0,0,0
2020-03-02,Los Angeles,37,10098052,177,1,12,13,0
2020-03-02,Madera,39,155013,4,0,0,0,0
2020-03-02,Marin,41,260295,6,0,0,0,0
2020-03-02,Mariposa,43,17540,0,0,0,0,0
2020-03-02,Mendocino,45,87422,0,0,0,0,0
2020-03-02,Merced,47,269075,1,0,0,0,0
2020-03-02,Modoc,49,8938,0,0,0,0,0
2020-03-02,Mono,51,14174,1,0,0,0,0
2020-03-02,Monterey,53,433212,0,0,0,0,0
2020-03-02,Napa,55,140530,1,0,0,0,0
2020-03-02,Nevada,57,99092,0,0,1,1,0
2020-03-02,Orange,59,3164182,67,1,0,1,0
2020-03-02,Placer,61,380077,8,1,0,1,0
2020-03-02,Plumas,63,18699,0,0,0,0,0
2020-03-02,Riverside,65,2383286,19,0,1,1,0
2020-03-02,Sacramento,67,1510023,25,1,0,1,0
2020-03-02,San Benito,69,59416,1,2,0,2,0
2020-03-02,San Bernardino,71,2135413,25,0,0,0,0
2020-03-02,San Diego,73,3302833,28,2,0,2,0
2020-03-02,San Francisco,75,870044,17,0,0,0,0
2020-03-02,San Joaquin,77,732212,7,0,3,3,0
2020-03-02,San Luis Obispo,79,281455,2,0,0,0,0
2020-03-02,San Mateo,81,765935,44,1,0,1,0
2020-03-02,Santa Barbara,83,443738,1,0,0,0,0
2020-03-02,Santa Clara,85,1922200,108,7,1,8,0
2020-03-02,Santa Cruz,87,273765,9,0,0,0,0
2020-03-02,Shasta,89,179085,2,0,0,0,0
2020-03-02,Sierra,91,2930,0,0,0,0,0
2020-03-02,Siskiyou,93,43540,0,0,0,0,0
2020-03-02,Solano,95,438530,19,24,0,24,0
2020-03-02,Sonoma,97,501317,10,1,0,1,0
2020-03-02,Stanislaus,99,539301,2,0,2,2,0
2020-03-02,Sutter,101,95872,0,0,0,0,0
2020-03-02,Tehama,103,63373,0,0,0,0,0
2020-03-02,Trinity,105,12862,0,0,0,0,0
2020-03-02,Tulare,107,460477,4,0,0,0,0
2020-03-02,Tuolumne,109,53932,0,0,0,0,0
2020-03-02,Ventura,111,848112,10,0,0,0,0
2020-03-02,Yolo,113,214977,2,0,0,0,0
2020-03-02,Yuba,115,75493,0,0,0,0,0
2020-03-01,Alameda,1,1643700,20,1,0,1,0
2020-03-01,Alpine,3,1148,0,0,0,0,0
2020-03-01,Amador,5,37829,0,0,0,0,0
2020-03-01,Butte,7,227075,0,0,0,0,0
2020-03-01,Calaveras,9,45235,0,0,0,0,0
2020-03-01,Colusa,11,21464,0,0,0,0,0
2020-03-01,Contra Costa,13,1133247,24,0,0,0,0
2020-03-01,Del Norte,15,27424,0,0,0,0,0
2020-03-01,El Dorado,17,186661,1,0,0,0,0
2020-03-01,Fresno,19,978130,0,0,1,1,0
2020-03-01,Glenn,21,27897,0,0,0,0,0
2020-03-01,Humboldt,23,135768,1,1,0,1,0
2020-03-01,Imperial,25,180216,5,0,0,0,0
2020-03-01,Inyo,27,18085,0,0,0,0,0
2020-03-01,Kern,29,883053,2,0,0,0,0
2020-03-01,Kings,31,150075,1,0,1,1,0
2020-03-01,Lake,33,64148,0,0,0,0,0
2020-03-01,Lassen,35,31185,0,0,0,0,0
2020-03-01,Los Angeles,37,10098052,158,1,12,13,0
2020-03-01,Madera,39,155013,2,0,0,0,0
2020-03-01,Marin,41,260295,5,0,0,0,0
2020-03-01,Mariposa,43,17540,0,0,0,0,0
2020-03-01,Mendocino,45,87422,0,0,0,0,0
2020-03-01,Merced,47,269075,1,0,0,0,0
2020-03-01,Modoc,49,8938,0,0,0,0,0
2020-03-01,Mono,51,14174,1,0,0,0,0
2020-03-01,Monterey,53,433212,0,0,0,0,0
2020-03-01,Napa,55,140530,1,0,0,0,0
2020-03-01,Nevada,57,99092,0,0,1,1,0
2020-03-01,Orange,59,3164182,64,1,0,1,0
2020-03-01,Placer,61,380077,8,0,0,0,0
2020-03-01,Plumas,63,18699,0,0,0,0,0
2020-03-01,Riverside,65,2383286,18,0,1,1,0
2020-03-01,Sacramento,67,1510023,21,1,0,1,0
2020-03-01,San Benito,69,59416,0,2,0,2,0
2020-03-01,San Bernardino,71,2135413,23,0,0,0,0
2020-03-01,San Diego,73,3302833,21,2,0,2,0
2020-03-01,San Francisco,75,870044,13,0,0,0,0
2020-03-01,San Joaquin,77,732212,7,0,3,3,0
2020-03-01,San Luis Obispo,79,281455,2,0,0,0,0
2020-03-01,San Mateo,81,765935,36,0,0,0,0
2020-03-01,Santa Barbara,83,443738,1,0,0,0,0
2020-03-01,Santa Clara,85,1922200,95,6,1,7,0
2020-03-01,Santa Cruz,87,273765,8,0,0,0,0
2020-03-01,Shasta,89,179085,2,0,0,0,0
2020-03-01,Sierra,91,2930,0,0,0,0,0
2020-03-01,Siskiyou,93,43540,0,0,0,0,0
2020-03-01,Solano,95,438530,19,24,0,24,0
2020-03-01,Sonoma,97,501317,9,0,0,0,0
2020-03-01,Stanislaus,99,539301,2,0,2,2,0
2020-03-01,Sutter,101,95872,0,0,0,0,0
2020-03-01,Tehama,103,63373,0,0,0,0,0
2020-03-01,Trinity,105,12862,0,0,0,0,0
2020-03-01,Tulare,107,460477,4,0,0,0,0
2020-03-01,Tuolumne,109,53932,0,0,0,0,0
2020-03-01,Ventura,111,848112,8,0,0,0,0
2020-03-01,Yolo,113,214977,2,0,0,0,0
2020-03-01,Yuba,115,75493,0,0,0,0,0
2020-02-29,Alameda,1,1643700,16,0,0,0,0
2020-02-29,Alpine,3,1148,0,0,0,0,0
2020-02-29,Amador,5,37829,0,0,0,0,0
2020-02-29,Butte,7,227075,0,0,0,0,0
2020-02-29,Calaveras,9,45235,0,0,0,0,0
2020-02-29,Colusa,11,21464,0,0,0,0,0
2020-02-29,Contra Costa,13,1133247,20,0,0,0,0
2020-02-29,Del Norte,15,27424,0,0,0,0,0
2020-02-29,El Dorado,17,186661,1,0,0,0,0
2020-02-29,Fresno,19,978130,0,0,0,0,0
2020-02-29,Glenn,21,27897,0,0,0,0,0
2020-02-29,Humboldt,23,135768,1,1,0,1,0
2020-02-29,Imperial,25,180216,3,0,0,0,0
2020-02-29,Inyo,27,18085,0,0,0,0,0
2020-02-29,Kern,29,883053,2,0,0,0,0
2020-02-29,Kings,31,150075,1,0,1,1,0
2020-02-29,Lake,33,64148,0,0,0,0,0
2020-02-29,Lassen,35,31185,0,0,0,0,0
2020-02-29,Los Angeles,37,10098052,130,1,12,13,0
2020-02-29,Madera,39,155013,2,0,0,0,0
2020-02-29,Marin,41,260295,4,0,0,0,0
2020-02-29,Mariposa,43,17540,0,0,0,0,0
2020-02-29,Mendocino,45,87422,0,0,0,0,0
2020-02-29,Merced,47,269075,1,0,0,0,0
2020-02-29,Modoc,49,8938,0,0,0,0,0
2020-02-29,Mono,51,14174,1,0,0,0,0
2020-02-29,Monterey,53,433212,0,0,0,0,0
2020-02-29,Napa,55,140530,1,0,0,0,0
2020-02-29,Nevada,57,99092,0,0,1,1,0
2020-02-29,Orange,59,3164182,59,1,0,1,0
2020-02-29,Placer,61,380077,7,0,0,0,0
2020-02-29,Plumas,63,18699,0,0,0,0,0
2020-02-29,Riverside,65,2383286,15,0,1,1,0
2020-02-29,Sacramento,67,1510023,16,1,0,1,0
2020-02-29,San Benito,69,59416,0,2,0,2,0
2020-02-29,San Bernardino,71,2135413,21,0,0,0,0
2020-02-29,San Diego,73,3302833,16,2,0,2,0
2020-02-29,San Francisco,75,870044,12,0,0,0,0
2020-02-29,San Joaquin,77,732212,6,0,3,3,0
2020-02-29,San Luis Obispo,79,281455,2,0,0,0,0
2020-02-29,San Mateo,81,765935,29,0,0,0,0
2020-02-29,Santa Barbara,83,443738,0,0,0,0,0
2020-02-29,Santa Clara,85,1922200,73,3,1,4,0
2020-02-29,Santa Cruz,87,273765,8,0,0,0,0
2020-02-29,Shasta,89,179085,2,0,0,0,0
2020-02-29,Sierra,91,2930,0,0,0,0,0
2020-02-29,Siskiyou,93,43540,0,0,0,0,0
2020-02-29,Solano,95,438530,18,23,0,23,0
2020-02-29,Sonoma,97,501317,6,0,0,0,0
2020-02-29,Stanislaus,99,539301,2,0,2,2,0
2020-02-29,Sutter,101,95872,0,0,0,0,0
2020-02-29,Tehama,103,63373,0,0,0,0,0
2020-02-29,Trinity,105,12862,0,0,0,0,0
2020-02-29,Tulare,107,460477,2,0,0,0,0
2020-02-29,Tuolumne,109,53932,0,0,0,0,0
2020-02-29,Ventura,111,848112,6,0,0,0,0
2020-02-29,Yolo,113,214977,2,0,0,0,0
2020-02-29,Yuba,115,75493,0,0,0,0,0
2020-02-28,Alameda,1,1643700,14,0,0,0,0
2020-02-28,Alpine,3,1148,0,0,0,0,0
2020-02-28,Amador,5,37829,0,0,0,0,0
2020-02-28,Butte,7,227075,0,0,0,0,0
2020-02-28,Calaveras,9,45235,0,0,0,0,0
2020-02-28,Colusa,11,21464,0,0,0,0,0
2020-02-28,Contra Costa,13,1133247,20,0,0,0,0
2020-02-28,Del Norte,15,27424,0,0,0,0,0
2020-02-28,El Dorado,17,186661,0,0,0,0,0
2020-02-28,Fresno,19,978130,0,0,0,0,0
2020-02-28,Glenn,21,27897,0,0,0,0,0
2020-02-28,Humboldt,23,135768,1,1,0,1,0
2020-02-28,Imperial,25,180216,3,0,0,0,0
2020-02-28,Inyo,27,18085,0,0,0,0,0
2020-02-28,Kern,29,883053,2,0,0,0,0
2020-02-28,Kings,31,150075,1,0,1,1,0
2020-02-28,Lake,33,64148,0,0,0,0,0
2020-02-28,Lassen,35,31185,0,0,0,0,0
2020-02-28,Los Angeles,37,10098052,121,1,12,13,0
2020-02-28,Madera,39,155013,2,0,0,0,0
2020-02-28,Marin,41,260295,2,0,0,0,0
2020-02-28,Mariposa,43,17540,0,0,0,0,0
2020-02-28,Mendocino,45,87422,0,0,0,0,0
2020-02-28,Merced,47,269075,1,0,0,0,0
2020-02-28,Modoc,49,8938,0,0,0,0,0
2020-02-28,Mono,51,14174,0,0,0,0,0
2020-02-28,Monterey,53,433212,0,0,0,0,0
2020-02-28,Napa,55,140530,1,0,0,0,0
2020-02-28,Nevada,57,99092,0,0,1,1,0
2020-02-28,Orange,59,3164182,57,1,0,1,0
2020-02-28,Placer,61,380077,7,0,0,0,0
2020-02-28,Plumas,63,18699,0,0,0,0,0
2020-02-28,Riverside,65,2383286,13,0,1,1,0
2020-02-28,Sacramento,67,1510023,10,1,0,1,0
2020-02-28,San Benito,69,59416,0,2,0,2,0
2020-02-28,San Bernardino,71,2135413,21,0,0,0,0
2020-02-28,San Diego,73,3302833,13,2,0,2,0
2020-02-28,San Francisco,75,870044,10,0,0,0,0
2020-02-28,San Joaquin,77,732212,6,0,3,3,0
2020-02-28,San Luis Obispo,79,281455,2,0,0,0,0
2020-02-28,San Mateo,81,765935,24,0,0,0,0
2020-02-28,Santa Barbara,83,443738,0,0,0,0,0
2020-02-28,Santa Clara,85,1922200,69,3,1,4,0
2020-02-28,Santa Cruz,87,273765,8,0,0,0,0
2020-02-28,Shasta,89,179085,2,0,0,0,0
2020-02-28,Sierra,91,2930,0,0,0,0,0
2020-02-28,Siskiyou,93,43540,0,0,0,0,0
2020-02-28,Solano,95,438530,17,23,0,23,0
2020-02-28,Sonoma,97,501317,6,0,0,0,0
2020-02-28,Stanislaus,99,539301,2,0,2,2,0
2020-02-28,Sutter,101,95872,0,0,0,0,0
2020-02-28,Tehama,103,63373,0,0,0,0,0
2020-02-28,Trinity,105,12862,0,0,0,0,0
2020-02-28,Tulare,107,460477,2,0,0,0,0
2020-02-28,Tuolumne,109,53932,0,0,0,0,0
2020-02-28,Ventura,111,848112,6,0,0,0,0
2020-02-28,Yolo,113,214977,2,0,0,0,0
2020-02-28,Yuba,115,75493,0,0,0,0,0
2020-02-27,Alameda,1,1643700,13,0,0,0,0
2020-02-27,Alpine,3,1148,0,0,0,0,0
2020-02-27,Amador,5,37829,0,0,0,0,0
2020-02-27,Butte,7,227075,0,0,0,0,0
2020-02-27,Calaveras,9,45235,0,0,0,0,0
2020-02-27,Colusa,11,21464,0,0,0,0,0
2020-02-27,Contra Costa,13,1133247,14,0,0,0,0
2020-02-27,Del Norte,15,27424,0,0,0,0,0
2020-02-27,El Dorado,17,186661,0,0,0,0,0
2020-02-27,Fresno,19,978130,0,0,0,0,0
2020-02-27,Glenn,21,27897,0,0,0,0,0
2020-02-27,Humboldt,23,135768,1,1,0,1,0
2020-02-27,Imperial,25,180216,3,0,0,0,0
2020-02-27,Inyo,27,18085,0,0,0,0,0
2020-02-27,Kern,29,883053,2,0,0,0,0
2020-02-27,Kings,31,150075,1,0,1,1,0
2020-02-27,Lake,33,64148,0,0,0,0,0
2020-02-27,Lassen,35,31185,0,0,0,0,0
2020-02-27,Los Angeles,37,10098052,107,1,12,13,0
2020-02-27,Madera,39,155013,2,0,0,0,0
2020-02-27,Marin,41,260295,1,0,0,0,0
2020-02-27,Mariposa,43,17540,0,0,0,0,0
2020-02-27,Mendocino,45,87422,0,0,0,0,0
2020-02-27,Merced,47,269075,1,0,0,0,0
2020-02-27,Modoc,49,8938,0,0,0,0,0
2020-02-27,Mono,51,14174,0,0,0,0,0
2020-02-27,Monterey,53,433212,0,0,0,0,0
2020-02-27,Napa,55,140530,1,0,0,0,0
2020-02-27,Nevada,57,99092,0,0,1,1,0
2020-02-27,Orange,59,3164182,51,1,0,1,0
2020-02-27,Placer,61,380077,6,0,0,0,0
2020-02-27,Plumas,63,18699,0,0,0,0,0
2020-02-27,Riverside,65,2383286,12,0,1,1,0
2020-02-27,Sacramento,67,1510023,10,1,0,1,0
2020-02-27,San Benito,69,59416,0,2,0,2,0
2020-02-27,San Bernardino,71,2135413,21,0,0,0,0
2020-02-27,San Diego,73,3302833,12,2,0,2,0
2020-02-27,San Francisco,75,870044,9,0,0,0,0
2020-02-27,San Joaquin,77,732212,5,0,3,3,0
2020-02-27,San Luis Obispo,79,281455,2,0,0,0,0
2020-02-27,San Mateo,81,765935,20,0,0,0,0
2020-02-27,Santa Barbara,83,443738,0,0,0,0,0
2020-02-27,Santa Clara,85,1922200,58,2,1,3,0
2020-02-27,Santa Cruz,87,273765,6,0,0,0,0
2020-02-27,Shasta,89,179085,0,0,0,0,0
2020-02-27,Sierra,91,2930,0,0,0,0,0
2020-02-27,Siskiyou,93,43540,0,0,0,0,0
2020-02-27,Solano,95,438530,17,23,0,23,0
2020-02-27,Sonoma,97,501317,5,0,0,0,0
2020-02-27,Stanislaus,99,539301,2,0,2,2,0
2020-02-27,Sutter,101,95872,0,0,0,0,0
2020-02-27,Tehama,103,63373,0,0,0,0,0
2020-02-27,Trinity,105,12862,0,0,0,0,0
2020-02-27,Tulare,107,460477,2,0,0,0,0
2020-02-27,Tuolumne,109,53932,0,0,0,0,0
2020-02-27,Ventura,111,848112,4,0,0,0,0
2020-02-27,Yolo,113,214977,2,0,0,0,0
2020-02-27,Yuba,115,75493,0,0,0,0,0
2020-02-26,Alameda,1,1643700,13,0,0,0,0
2020-02-26,Alpine,3,1148,0,0,0,0,0
2020-02-26,Amador,5,37829,0,0,0,0,0
2020-02-26,Butte,7,227075,0,0,0,0,0
2020-02-26,Calaveras,9,45235,0,0,0,0,0
2020-02-26,Colusa,11,21464,0,0,0,0,0
2020-02-26,Contra Costa,13,1133247,13,0,0,0,0
2020-02-26,Del Norte,15,27424,0,0,0,0,0
2020-02-26,El Dorado,17,186661,0,0,0,0,0
2020-02-26,Fresno,19,978130,0,0,0,0,0
2020-02-26,Glenn,21,27897,0,0,0,0,0
2020-02-26,Humboldt,23,135768,1,1,0,1,0
2020-02-26,Imperial,25,180216,3,0,0,0,0
2020-02-26,Inyo,27,18085,0,0,0,0,0
2020-02-26,Kern,29,883053,2,0,0,0,0
2020-02-26,Kings,31,150075,1,0,1,1,0
2020-02-26,Lake,33,64148,0,0,0,0,0
2020-02-26,Lassen,35,31185,0,0,0,0,0
2020-02-26,Los Angeles,37,10098052,101,1,12,13,0
2020-02-26,Madera,39,155013,2,0,0,0,0
2020-02-26,Marin,41,260295,1,0,0,0,0
2020-02-26,Mariposa,43,17540,0,0,0,0,0
2020-02-26,Mendocino,45,87422,0,0,0,0,0
2020-02-26,Merced,47,269075,1,0,0,0,0
2020-02-26,Modoc,49,8938,0,0,0,0,0
2020-02-26,Mono,51,14174,0,0,0,0,0
2020-02-26,Monterey,53,433212,0,0,0,0,0
2020-02-26,Napa,55,140530,0,0,0,0,0
2020-02-26,Nevada,57,99092,0,0,1,1,0
2020-02-26,Orange,59,3164182,50,1,0,1,0
2020-02-26,Placer,61,380077,5,0,0,0,0
2020-02-26,Plumas,63,18699,0,0,0,0,0
2020-02-26,Riverside,65,2383286,10,0,1,1,0
2020-02-26,Sacramento,67,1510023,10,1,0,1,0
2020-02-26,San Benito,69,59416,0,2,0,2,0
2020-02-26,San Bernardino,71,2135413,19,0,0,0,0
2020-02-26,San Diego,73,3302833,11,2,0,2,0
2020-02-26,San Francisco,75,870044,9,0,0,0,0
2020-02-26,San Joaquin,77,732212,5,0,3,3,0
2020-02-26,San Luis Obispo,79,281455,2,0,0,0,0
2020-02-26,San Mateo,81,765935,18,0,0,0,0
2020-02-26,Santa Barbara,83,443738,0,0,0,0,0
2020-02-26,Santa Clara,85,1922200,50,2,1,3,0
2020-02-26,Santa Cruz,87,273765,6,0,0,0,0
2020-02-26,Shasta,89,179085,0,0,0,0,0
2020-02-26,Sierra,91,2930,0,0,0,0,0
2020-02-26,Siskiyou,93,43540,0,0,0,0,0
2020-02-26,Solano,95,438530,17,23,0,23,0
2020-02-26,Sonoma,97,501317,5,0,0,0,0
2020-02-26,Stanislaus,99,539301,2,0,2,2,0
2020-02-26,Sutter,101,95872,0,0,0,0,0
2020-02-26,Tehama,103,63373,0,0,0,0,0
2020-02-26,Trinity,105,12862,0,0,0,0,0
2020-02-26,Tulare,107,460477,2,0,0,0,0
2020-02-26,Tuolumne,109,53932,0,0,0,0,0
2020-02-26,Ventura,111,848112,4,0,0,0,0
2020-02-26,Yolo,113,214977,2,0,0,0,0
2020-02-26,Yuba,115,75493,0,0,0,0,0
2020-02-25,Alameda,1,1643700,13,0,0,0,0
2020-02-25,Alpine,3,1148,0,0,0,0,0
2020-02-25,Amador,5,37829,0,0,0,0,0
2020-02-25,Butte,7,227075,0,0,0,0,0
2020-02-25,Calaveras,9,45235,0,0,0,0,0
2020-02-25,Colusa,11,21464,0,0,0,0,0
2020-02-25,Contra Costa,13,1133247,11,0,0,0,0
2020-02-25,Del Norte,15,27424,0,0,0,0,0
2020-02-25,El Dorado,17,186661,0,0,0,0,0
2020-02-25,Fresno,19,978130,0,0,0,0,0
2020-02-25,Glenn,21,27897,0,0,0,0,0
2020-02-25,Humboldt,23,135768,1,1,0,1,0
2020-02-25,Imperial,25,180216,3,0,0,0,0
2020-02-25,Inyo,27,18085,0,0,0,0,0
2020-02-25,Kern,29,883053,2,0,0,0,0
2020-02-25,Kings,31,150075,1,0,1,1,0
2020-02-25,Lake,33,64148,0,0,0,0,0
2020-02-25,Lassen,35,31185,0,0,0,0,0
2020-02-25,Los Angeles,37,10098052,86,1,12,13,0
2020-02-25,Madera,39,155013,2,0,0,0,0
2020-02-25,Marin,41,260295,1,0,0,0,0
2020-02-25,Mariposa,43,17540,0,0,0,0,0
2020-02-25,Mendocino,45,87422,0,0,0,0,0
2020-02-25,Merced,47,269075,0,0,0,0,0
2020-02-25,Modoc,49,8938,0,0,0,0,0
2020-02-25,Mono,51,14174,0,0,0,0,0
2020-02-25,Monterey,53,433212,0,0,0,0,0
2020-02-25,Napa,55,140530,0,0,0,0,0
2020-02-25,Nevada,57,99092,0,0,1,1,0
2020-02-25,Orange,59,3164182,49,1,0,1,0
2020-02-25,Placer,61,380077,5,0,0,0,0
2020-02-25,Plumas,63,18699,0,0,0,0,0
2020-02-25,Riverside,65,2383286,10,0,1,1,0
2020-02-25,Sacramento,67,1510023,8,1,0,1,0
2020-02-25,San Benito,69,59416,0,2,0,2,0
2020-02-25,San Bernardino,71,2135413,17,0,0,0,0
2020-02-25,San Diego,73,3302833,7,2,0,2,0
2020-02-25,San Francisco,75,870044,7,0,0,0,0
2020-02-25,San Joaquin,77,732212,5,0,2,2,0
2020-02-25,San Luis Obispo,79,281455,2,0,0,0,0
2020-02-25,San Mateo,81,765935,17,0,0,0,0
2020-02-25,Santa Barbara,83,443738,0,0,0,0,0
2020-02-25,Santa Clara,85,1922200,40,2,1,3,0
2020-02-25,Santa Cruz,87,273765,5,0,0,0,0
2020-02-25,Shasta,89,179085,0,0,0,0,0
2020-02-25,Sierra,91,2930,0,0,0,0,0
2020-02-25,Siskiyou,93,43540,0,0,0,0,0
2020-02-25,Solano,95,438530,16,21,0,21,0
2020-02-25,Sonoma,97,501317,5,0,0,0,0
2020-02-25,Stanislaus,99,539301,2,0,2,2,0
2020-02-25,Sutter,101,95872,0,0,0,0,0
2020-02-25,Tehama,103,63373,0,0,0,0,0
2020-02-25,Trinity,105,12862,0,0,0,0,0
2020-02-25,Tulare,107,460477,2,0,0,0,0
2020-02-25,Tuolumne,109,53932,0,0,0,0,0
2020-02-25,Ventura,111,848112,4,0,0,0,0
2020-02-25,Yolo,113,214977,2,0,0,0,0
2020-02-25,Yuba,115,75493,0,0,0,0,0
2020-02-24,Alameda,1,1643700,13,0,0,0,0
2020-02-24,Alpine,3,1148,0,0,0,0,0
2020-02-24,Amador,5,37829,0,0,0,0,0
2020-02-24,Butte,7,227075,0,0,0,0,0
2020-02-24,Calaveras,9,45235,0,0,0,0,0
2020-02-24,Colusa,11,21464,0,0,0,0,0
2020-02-24,Contra Costa,13,1133247,9,0,0,0,0
2020-02-24,Del Norte,15,27424,0,0,0,0,0
2020-02-24,El Dorado,17,186661,0,0,0,0,0
2020-02-24,Fresno,19,978130,0,0,0,0,0
2020-02-24,Glenn,21,27897,0,0,0,0,0
2020-02-24,Humboldt,23,135768,1,1,0,1,0
2020-02-24,Imperial,25,180216,3,0,0,0,0
2020-02-24,Inyo,27,18085,0,0,0,0,0
2020-02-24,Kern,29,883053,2,0,0,0,0
2020-02-24,Kings,31,150075,1,0,1,1,0
2020-02-24,Lake,33,64148,0,0,0,0,0
2020-02-24,Lassen,35,31185,0,0,0,0,0
2020-02-24,Los Angeles,37,10098052,80,1,12,13,0
2020-02-24,Madera,39,155013,1,0,0,0,0
2020-02-24,Marin,41,260295,1,0,0,0,0
2020-02-24,Mariposa,43,17540,0,0,0,0,0
2020-02-24,Mendocino,45,87422,0,0,0,0,0
2020-02-24,Merced,47,269075,0,0,0,0,0
2020-02-24,Modoc,49,8938,0,0,0,0,0
2020-02-24,Mono,51,14174,0,0,0,0,0
2020-02-24,Monterey,53,433212,0,0,0,0,0
2020-02-24,Napa,55,140530,0,0,0,0,0
2020-02-24,Nevada,57,99092,0,0,1,1,0
2020-02-24,Orange,59,3164182,47,1,0,1,0
2020-02-24,Placer,61,380077,3,0,0,0,0
2020-02-24,Plumas,63,18699,0,0,0,0,0
2020-02-24,Riverside,65,2383286,9,0,1,1,0
2020-02-24,Sacramento,67,1510023,7,1,0,1,0
2020-02-24,San Benito,69,59416,0,2,0,2,0
2020-02-24,San Bernardino,71,2135413,17,0,0,0,0
2020-02-24,San Diego,73,3302833,7,2,0,2,0
2020-02-24,San Francisco,75,870044,6,0,0,0,0
2020-02-24,San Joaquin,77,732212,5,0,1,1,0
2020-02-24,San Luis Obispo,79,281455,2,0,0,0,0
2020-02-24,San Mateo,81,765935,13,0,0,0,0
2020-02-24,Santa Barbara,83,443738,0,0,0,0,0
2020-02-24,Santa Clara,85,1922200,38,2,1,3,0
2020-02-24,Santa Cruz,87,273765,5,0,0,0,0
2020-02-24,Shasta,89,179085,0,0,0,0,0
2020-02-24,Sierra,91,2930,0,0,0,0,0
2020-02-24,Siskiyou,93,43540,0,0,0,0,0
2020-02-24,Solano,95,438530,13,15,0,15,0
2020-02-24,Sonoma,97,501317,5,0,0,0,0
2020-02-24,Stanislaus,99,539301,2,0,2,2,0
2020-02-24,Sutter,101,95872,0,0,0,0,0
2020-02-24,Tehama,103,63373,0,0,0,0,0
2020-02-24,Trinity,105,12862,0,0,0,0,0
2020-02-24,Tulare,107,460477,2,0,0,0,0
2020-02-24,Tuolumne,109,53932,0,0,0,0,0
2020-02-24,Ventura,111,848112,4,0,0,0,0
2020-02-24,Yolo,113,214977,2,0,0,0,0
2020-02-24,Yuba,115,75493,0,0,0,0,0
2020-02-23,Alameda,1,1643700,11,0,0,0,0
2020-02-23,Alpine,3,1148,0,0,0,0,0
2020-02-23,Amador,5,37829,0,0,0,0,0
2020-02-23,Butte,7,227075,0,0,0,0,0
2020-02-23,Calaveras,9,45235,0,0,0,0,0
2020-02-23,Colusa,11,21464,0,0,0,0,0
2020-02-23,Contra Costa,13,1133247,6,0,0,0,0
2020-02-23,Del Norte,15,27424,0,0,0,0,0
2020-02-23,El Dorado,17,186661,0,0,0,0,0
2020-02-23,Fresno,19,978130,0,0,0,0,0
2020-02-23,Glenn,21,27897,0,0,0,0,0
2020-02-23,Humboldt,23,135768,1,1,0,1,0
2020-02-23,Imperial,25,180216,3,0,0,0,0
2020-02-23,Inyo,27,18085,0,0,0,0,0
2020-02-23,Kern,29,883053,2,0,0,0,0
2020-02-23,Kings,31,150075,1,0,1,1,0
2020-02-23,Lake,33,64148,0,0,0,0,0
2020-02-23,Lassen,35,31185,0,0,0,0,0
2020-02-23,Los Angeles,37,10098052,71,1,12,13,0
2020-02-23,Madera,39,155013,1,0,0,0,0
2020-02-23,Marin,41,260295,1,0,0,0,0
2020-02-23,Mariposa,43,17540,0,0,0,0,0
2020-02-23,Mendocino,45,87422,0,0,0,0,0
2020-02-23,Merced,47,269075,0,0,0,0,0
2020-02-23,Modoc,49,8938,0,0,0,0,0
2020-02-23,Mono,51,14174,0,0,0,0,0
2020-02-23,Monterey,53,433212,0,0,0,0,0
2020-02-23,Napa,55,140530,0,0,0,0,0
2020-02-23,Nevada,57,99092,0,0,1,1,0
2020-02-23,Orange,59,3164182,47,1,0,1,0
2020-02-23,Placer,61,380077,3,0,0,0,0
2020-02-23,Plumas,63,18699,0,0,0,0,0
2020-02-23,Riverside,65,2383286,9,0,0,0,0
2020-02-23,Sacramento,67,1510023,6,1,0,1,0
2020-02-23,San Benito,69,59416,0,2,0,2,0
2020-02-23,San Bernardino,71,2135413,16,0,0,0,0
2020-02-23,San Diego,73,3302833,6,2,0,2,0
2020-02-23,San Francisco,75,870044,5,0,0,0,0
2020-02-23,San Joaquin,77,732212,4,0,1,1,0
2020-02-23,San Luis Obispo,79,281455,2,0,0,0,0
2020-02-23,San Mateo,81,765935,10,0,0,0,0
2020-02-23,Santa Barbara,83,443738,0,0,0,0,0
2020-02-23,Santa Clara,85,1922200,26,2,1,3,0
2020-02-23,Santa Cruz,87,273765,2,0,0,0,0
2020-02-23,Shasta,89,179085,0,0,0,0,0
2020-02-23,Sierra,91,2930,0,0,0,0,0
2020-02-23,Siskiyou,93,43540,0,0,0,0,0
2020-02-23,Solano,95,438530,11,15,0,15,0
2020-02-23,Sonoma,97,501317,5,0,0,0,0
2020-02-23,Stanislaus,99,539301,2,0,2,2,0
2020-02-23,Sutter,101,95872,0,0,0,0,0
2020-02-23,Tehama,103,63373,0,0,0,0,0
2020-02-23,Trinity,105,12862,0,0,0,0,0
2020-02-23,Tulare,107,460477,2,0,0,0,0
2020-02-23,Tuolumne,109,53932,0,0,0,0,0
2020-02-23,Ventura,111,848112,4,0,0,0,0
2020-02-23,Yolo,113,214977,2,0,0,0,0
2020-02-23,Yuba,115,75493,0,0,0,0,0
2020-02-22,Alameda,1,1643700,10,0,0,0,0
2020-02-22,Alpine,3,1148,0,0,0,0,0
2020-02-22,Amador,5,37829,0,0,0,0,0
2020-02-22,Butte,7,227075,0,0,0,0,0
2020-02-22,Calaveras,9,45235,0,0,0,0,0
2020-02-22,Colusa,11,21464,0,0,0,0,0
2020-02-22,Contra Costa,13,1133247,5,0,0,0,0
2020-02-22,Del Norte,15,27424,0,0,0,0,0
2020-02-22,El Dorado,17,186661,0,0,0,0,0
2020-02-22,Fresno,19,978130,0,0,0,0,0
2020-02-22,Glenn,21,27897,0,0,0,0,0
2020-02-22,Humboldt,23,135768,1,1,0,1,0
2020-02-22,Imperial,25,180216,2,0,0,0,0
2020-02-22,Inyo,27,18085,0,0,0,0,0
2020-02-22,Kern,29,883053,2,0,0,0,0
2020-02-22,Kings,31,150075,1,0,1,1,0
2020-02-22,Lake,33,64148,0,0,0,0,0
2020-02-22,Lassen,35,31185,0,0,0,0,0
2020-02-22,Los Angeles,37,10098052,69,1,12,13,0
2020-02-22,Madera,39,155013,0,0,0,0,0
2020-02-22,Marin,41,260295,1,0,0,0,0
2020-02-22,Mariposa,43,17540,0,0,0,0,0
2020-02-22,Mendocino,45,87422,0,0,0,0,0
2020-02-22,Merced,47,269075,0,0,0,0,0
2020-02-22,Modoc,49,8938,0,0,0,0,0
2020-02-22,Mono,51,14174,0,0,0,0,0
2020-02-22,Monterey,53,433212,0,0,0,0,0
2020-02-22,Napa,55,140530,0,0,0,0,0
2020-02-22,Nevada,57,99092,0,0,1,1,0
2020-02-22,Orange,59,3164182,46,1,0,1,0
2020-02-22,Placer,61,380077,3,0,0,0,0
2020-02-22,Plumas,63,18699,0,0,0,0,0
2020-02-22,Riverside,65,2383286,9,0,0,0,0
2020-02-22,Sacramento,67,1510023,6,1,0,1,0
2020-02-22,San Benito,69,59416,0,2,0,2,0
2020-02-22,San Bernardino,71,2135413,14,0,0,0,0
2020-02-22,San Diego,73,3302833,5,2,0,2,0
2020-02-22,San Francisco,75,870044,3,0,0,0,0
2020-02-22,San Joaquin,77,732212,4,0,1,1,0
2020-02-22,San Luis Obispo,79,281455,2,0,0,0,0
2020-02-22,San Mateo,81,765935,8,0,0,0,0
2020-02-22,Santa Barbara,83,443738,0,0,0,0,0
2020-02-22,Santa Clara,85,1922200,23,2,1,3,0
2020-02-22,Santa Cruz,87,273765,2,0,0,0,0
2020-02-22,Shasta,89,179085,0,0,0,0,0
2020-02-22,Sierra,91,2930,0,0,0,0,0
2020-02-22,Siskiyou,93,43540,0,0,0,0,0
2020-02-22,Solano,95,438530,11,11,0,11,0
2020-02-22,Sonoma,97,501317,4,0,0,0,0
2020-02-22,Stanislaus,99,539301,2,0,2,2,0
2020-02-22,Sutter,101,95872,0,0,0,0,0
2020-02-22,Tehama,103,63373,0,0,0,0,0
2020-02-22,Trinity,105,12862,0,0,0,0,0
2020-02-22,Tulare,107,460477,2,0,0,0,0
2020-02-22,Tuolumne,109,53932,0,0,0,0,0
2020-02-22,Ventura,111,848112,4,0,0,0,0
2020-02-22,Yolo,113,214977,1,0,0,0,0
2020-02-22,Yuba,115,75493,0,0,0,0,0
2020-02-21,Alameda,1,1643700,9,0,0,0,0
2020-02-21,Alpine,3,1148,0,0,0,0,0
2020-02-21,Amador,5,37829,0,0,0,0,0
2020-02-21,Butte,7,227075,0,0,0,0,0
2020-02-21,Calaveras,9,45235,0,0,0,0,0
2020-02-21,Colusa,11,21464,0,0,0,0,0
2020-02-21,Contra Costa,13,1133247,4,0,0,0,0
2020-02-21,Del Norte,15,27424,0,0,0,0,0
2020-02-21,El Dorado,17,186661,0,0,0,0,0
2020-02-21,Fresno,19,978130,0,0,0,0,0
2020-02-21,Glenn,21,27897,0,0,0,0,0
2020-02-21,Humboldt,23,135768,1,1,0,1,0
2020-02-21,Imperial,25,180216,2,0,0,0,0
2020-02-21,Inyo,27,18085,0,0,0,0,0
2020-02-21,Kern,29,883053,2,0,0,0,0
2020-02-21,Kings,31,150075,1,0,1,1,0
2020-02-21,Lake,33,64148,0,0,0,0,0
2020-02-21,Lassen,35,31185,0,0,0,0,0
2020-02-21,Los Angeles,37,10098052,67,1,12,13,0
2020-02-21,Madera,39,155013,0,0,0,0,0
2020-02-21,Marin,41,260295,1,0,0,0,0
2020-02-21,Mariposa,43,17540,0,0,0,0,0
2020-02-21,Mendocino,45,87422,0,0,0,0,0
2020-02-21,Merced,47,269075,0,0,0,0,0
2020-02-21,Modoc,49,8938,0,0,0,0,0
2020-02-21,Mono,51,14174,0,0,0,0,0
2020-02-21,Monterey,53,433212,0,0,0,0,0
2020-02-21,Napa,55,140530,0,0,0,0,0
2020-02-21,Nevada,57,99092,0,0,1,1,0
2020-02-21,Orange,59,3164182,44,1,0,1,0
2020-02-21,Placer,61,380077,2,0,0,0,0
2020-02-21,Plumas,63,18699,0,0,0,0,0
2020-02-21,Riverside,65,2383286,9,0,0,0,0
2020-02-21,Sacramento,67,1510023,5,1,0,1,0
2020-02-21,San Benito,69,59416,0,2,0,2,0
2020-02-21,San Bernardino,71,2135413,13,0,0,0,0
2020-02-21,San Diego,73,3302833,5,2,0,2,0
2020-02-21,San Francisco,75,870044,3,0,0,0,0
2020-02-21,San Joaquin,77,732212,2,0,1,1,0
2020-02-21,San Luis Obispo,79,281455,2,0,0,0,0
2020-02-21,San Mateo,81,765935,8,0,0,0,0
2020-02-21,Santa Barbara,83,443738,0,0,0,0,0
2020-02-21,Santa Clara,85,1922200,21,2,1,3,0
2020-02-21,Santa Cruz,87,273765,2,0,0,0,0
2020-02-21,Shasta,89,179085,0,0,0,0,0
2020-02-21,Sierra,91,2930,0,0,0,0,0
2020-02-21,Siskiyou,93,43540,0,0,0,0,0
2020-02-21,Solano,95,438530,10,11,0,11,0
2020-02-21,Sonoma,97,501317,3,0,0,0,0
2020-02-21,Stanislaus,99,539301,2,0,2,2,0
2020-02-21,Sutter,101,95872,0,0,0,0,0
2020-02-21,Tehama,103,63373,0,0,0,0,0
2020-02-21,Trinity,105,12862,0,0,0,0,0
2020-02-21,Tulare,107,460477,2,0,0,0,0
2020-02-21,Tuolumne,109,53932,0,0,0,0,0
2020-02-21,Ventura,111,848112,4,0,0,0,0
2020-02-21,Yolo,113,214977,1,0,0,0,0
2020-02-21,Yuba,115,75493,0,0,0,0,0
2020-02-20,Alameda,1,1643700,7,0,0,0,0
2020-02-20,Alpine,3,1148,0,0,0,0,0
2020-02-20,Amador,5,37829,0,0,0,0,0
2020-02-20,Butte,7,227075,0,0,0,0,0
2020-02-20,Calaveras,9,45235,0,0,0,0,0
2020-02-20,Colusa,11,21464,0,0,0,0,0
2020-02-20,Contra Costa,13,1133247,3,0,0,0,0
2020-02-20,Del Norte,15,27424,0,0,0,0,0
2020-02-20,El Dorado,17,186661,0,0,0,0,0
2020-02-20,Fresno,19,978130,0,0,0,0,0
2020-02-20,Glenn,21,27897,0,0,0,0,0
2020-02-20,Humboldt,23,135768,1,1,0,1,0
2020-02-20,Imperial,25,180216,2,0,0,0,0
2020-02-20,Inyo,27,18085,0,0,0,0,0
2020-02-20,Kern,29,883053,2,0,0,0,0
2020-02-20,Kings,31,150075,1,0,1,1,0
2020-02-20,Lake,33,64148,0,0,0,0,0
2020-02-20,Lassen,35,31185,0,0,0,0,0
2020-02-20,Los Angeles,37,10098052,65,1,10,11,0
2020-02-20,Madera,39,155013,0,0,0,0,0
2020-02-20,Marin,41,260295,0,0,0,0,0
2020-02-20,Mariposa,43,17540,0,0,0,0,0
2020-02-20,Mendocino,45,87422,0,0,0,0,0
2020-02-20,Merced,47,269075,0,0,0,0,0
2020-02-20,Modoc,49,8938,0,0,0,0,0
2020-02-20,Mono,51,14174,0,0,0,0,0
2020-02-20,Monterey,53,433212,0,0,0,0,0
2020-02-20,Napa,55,140530,0,0,0,0,0
2020-02-20,Nevada,57,99092,0,0,1,1,0
2020-02-20,Orange,59,3164182,44,1,0,1,0
2020-02-20,Placer,61,380077,2,0,0,0,0
2020-02-20,Plumas,63,18699,0,0,0,0,0
2020-02-20,Riverside,65,2383286,7,0,0,0,0
2020-02-20,Sacramento,67,1510023,2,1,0,1,0
2020-02-20,San Benito,69,59416,0,2,0,2,0
2020-02-20,San Bernardino,71,2135413,12,0,0,0,0
2020-02-20,San Diego,73,3302833,5,2,0,2,0
2020-02-20,San Francisco,75,870044,3,0,0,0,0
2020-02-20,San Joaquin,77,732212,2,0,1,1,0
2020-02-20,San Luis Obispo,79,281455,2,0,0,0,0
2020-02-20,San Mateo,81,765935,7,0,0,0,0
2020-02-20,Santa Barbara,83,443738,0,0,0,0,0
2020-02-20,Santa Clara,85,1922200,17,2,1,3,0
2020-02-20,Santa Cruz,87,273765,2,0,0,0,0
2020-02-20,Shasta,89,179085,0,0,0,0,0
2020-02-20,Sierra,91,2930,0,0,0,0,0
2020-02-20,Siskiyou,93,43540,0,0,0,0,0
2020-02-20,Solano,95,438530,8,7,0,7,0
2020-02-20,Sonoma,97,501317,2,0,0,0,0
2020-02-20,Stanislaus,99,539301,2,0,2,2,0
2020-02-20,Sutter,101,95872,0,0,0,0,0
2020-02-20,Tehama,103,63373,0,0,0,0,0
2020-02-20,Trinity,105,12862,0,0,0,0,0
2020-02-20,Tulare,107,460477,2,0,0,0,0
2020-02-20,Tuolumne,109,53932,0,0,0,0,0
2020-02-20,Ventura,111,848112,4,0,0,0,0
2020-02-20,Yolo,113,214977,1,0,0,0,0
2020-02-20,Yuba,115,75493,0,0,0,0,0
2020-02-19,Alameda,1,1643700,6,0,0,0,0
2020-02-19,Alpine,3,1148,0,0,0,0,0
2020-02-19,Amador,5,37829,0,0,0,0,0
2020-02-19,Butte,7,227075,0,0,0,0,0
2020-02-19,Calaveras,9,45235,0,0,0,0,0
2020-02-19,Colusa,11,21464,0,0,0,0,0
2020-02-19,Contra Costa,13,1133247,3,0,0,0,0
2020-02-19,Del Norte,15,27424,0,0,0,0,0
2020-02-19,El Dorado,17,186661,0,0,0,0,0
2020-02-19,Fresno,19,978130,0,0,0,0,0
2020-02-19,Glenn,21,27897,0,0,0,0,0
2020-02-19,Humboldt,23,135768,1,0,0,0,0
2020-02-19,Imperial,25,180216,2,0,0,0,0
2020-02-19,Inyo,27,18085,0,0,0,0,0
2020-02-19,Kern,29,883053,2,0,0,0,0
2020-02-19,Kings,31,150075,1,0,1,1,0
2020-02-19,Lake,33,64148,0,0,0,0,0
2020-02-19,Lassen,35,31185,0,0,0,0,0
2020-02-19,Los Angeles,37,10098052,59,1,10,11,0
2020-02-19,Madera,39,155013,0,0,0,0,0
2020-02-19,Marin,41,260295,0,0,0,0,0
2020-02-19,Mariposa,43,17540,0,0,0,0,0
2020-02-19,Mendocino,45,87422,0,0,0,0,0
2020-02-19,Merced,47,269075,0,0,0,0,0
2020-02-19,Modoc,49,8938,0,0,0,0,0
2020-02-19,Mono,51,14174,0,0,0,0,0
2020-02-19,Monterey,53,433212,0,0,0,0,0
2020-02-19,Napa,55,140530,0,0,0,0,0
2020-02-19,Nevada,57,99092,0,0,1,1,0
2020-02-19,Orange,59,3164182,43,1,0,1,0
2020-02-19,Placer,61,380077,2,0,0,0,0
2020-02-19,Plumas,63,18699,0,0,0,0,0
2020-02-19,Riverside,65,2383286,5,0,0,0,0
2020-02-19,Sacramento,67,1510023,2,0,0,0,0
2020-02-19,San Benito,69,59416,0,2,0,2,0
2020-02-19,San Bernardino,71,2135413,11,0,0,0,0
2020-02-19,San Diego,73,3302833,4,2,0,2,0
2020-02-19,San Francisco,75,870044,2,0,0,0,0
2020-02-19,San Joaquin,77,732212,2,0,1,1,0
2020-02-19,San Luis Obispo,79,281455,2,0,0,0,0
2020-02-19,San Mateo,81,765935,6,0,0,0,0
2020-02-19,Santa Barbara,83,443738,0,0,0,0,0
2020-02-19,Santa Clara,85,1922200,15,2,1,3,0
2020-02-19,Santa Cruz,87,273765,0,0,0,0,0
2020-02-19,Shasta,89,179085,0,0,0,0,0
2020-02-19,Sierra,91,2930,0,0,0,0,0
2020-02-19,Siskiyou,93,43540,0,0,0,0,0
2020-02-19,Solano,95,438530,5,7,0,7,0
2020-02-19,Sonoma,97,501317,2,0,0,0,0
2020-02-19,Stanislaus,99,539301,1,0,2,2,0
2020-02-19,Sutter,101,95872,0,0,0,0,0
2020-02-19,Tehama,103,63373,0,0,0,0,0
2020-02-19,Trinity,105,12862,0,0,0,0,0
2020-02-19,Tulare,107,460477,2,0,0,0,0
2020-02-19,Tuolumne,109,53932,0,0,0,0,0
2020-02-19,Ventura,111,848112,2,0,0,0,0
2020-02-19,Yolo,113,214977,1,0,0,0,0
2020-02-19,Yuba,115,75493,0,0,0,0,0
2020-02-18,Alameda,1,1643700,6,0,0,0,0
2020-02-18,Alpine,3,1148,0,0,0,0,0
2020-02-18,Amador,5,37829,0,0,0,0,0
2020-02-18,Butte,7,227075,0,0,0,0,0
2020-02-18,Calaveras,9,45235,0,0,0,0,0
2020-02-18,Colusa,11,21464,0,0,0,0,0
2020-02-18,Contra Costa,13,1133247,3,0,0,0,0
2020-02-18,Del Norte,15,27424,0,0,0,0,0
2020-02-18,El Dorado,17,186661,0,0,0,0,0
2020-02-18,Fresno,19,978130,0,0,0,0,0
2020-02-18,Glenn,21,27897,0,0,0,0,0
2020-02-18,Humboldt,23,135768,1,0,0,0,0
2020-02-18,Imperial,25,180216,1,0,0,0,0
2020-02-18,Inyo,27,18085,0,0,0,0,0
2020-02-18,Kern,29,883053,2,0,0,0,0
2020-02-18,Kings,31,150075,1,0,1,1,0
2020-02-18,Lake,33,64148,0,0,0,0,0
2020-02-18,Lassen,35,31185,0,0,0,0,0
2020-02-18,Los Angeles,37,10098052,56,1,9,10,0
2020-02-18,Madera,39,155013,0,0,0,0,0
2020-02-18,Marin,41,260295,0,0,0,0,0
2020-02-18,Mariposa,43,17540,0,0,0,0,0
2020-02-18,Mendocino,45,87422,0,0,0,0,0
2020-02-18,Merced,47,269075,0,0,0,0,0
2020-02-18,Modoc,49,8938,0,0,0,0,0
2020-02-18,Mono,51,14174,0,0,0,0,0
2020-02-18,Monterey,53,433212,0,0,0,0,0
2020-02-18,Napa,55,140530,0,0,0,0,0
2020-02-18,Nevada,57,99092,0,0,1,1,0
2020-02-18,Orange,59,3164182,42,1,0,1,0
2020-02-18,Placer,61,380077,0,0,0,0,0
2020-02-18,Plumas,63,18699,0,0,0,0,0
2020-02-18,Riverside,65,2383286,5,0,0,0,0
2020-02-18,Sacramento,67,1510023,2,0,0,0,0
2020-02-18,San Benito,69,59416,0,2,0,2,0
2020-02-18,San Bernardino,71,2135413,11,0,0,0,0
2020-02-18,San Diego,73,3302833,4,2,0,2,0
2020-02-18,San Francisco,75,870044,2,0,0,0,0
2020-02-18,San Joaquin,77,732212,1,0,1,1,0
2020-02-18,San Luis Obispo,79,281455,2,0,0,0,0
2020-02-18,San Mateo,81,765935,5,0,0,0,0
2020-02-18,Santa Barbara,83,443738,0,0,0,0,0
2020-02-18,Santa Clara,85,1922200,14,2,1,3,0
2020-02-18,Santa Cruz,87,273765,0,0,0,0,0
2020-02-18,Shasta,89,179085,0,0,0,0,0
2020-02-18,Sierra,91,2930,0,0,0,0,0
2020-02-18,Siskiyou,93,43540,0,0,0,0,0
2020-02-18,Solano,95,438530,5,7,0,7,0
2020-02-18,Sonoma,97,501317,1,0,0,0,0
2020-02-18,Stanislaus,99,539301,1,0,2,2,0
2020-02-18,Sutter,101,95872,0,0,0,0,0
2020-02-18,Tehama,103,63373,0,0,0,0,0
2020-02-18,Trinity,105,12862,0,0,0,0,0
2020-02-18,Tulare,107,460477,2,0,0,0,0
2020-02-18,Tuolumne,109,53932,0,0,0,0,0
2020-02-18,Ventura,111,848112,2,0,0,0,0
2020-02-18,Yolo,113,214977,1,0,0,0,0
2020-02-18,Yuba,115,75493,0,0,0,0,0
2020-02-17,Alameda,1,1643700,6,0,0,0,0
2020-02-17,Alpine,3,1148,0,0,0,0,0
2020-02-17,Amador,5,37829,0,0,0,0,0
2020-02-17,Butte,7,227075,0,0,0,0,0
2020-02-17,Calaveras,9,45235,0,0,0,0,0
2020-02-17,Colusa,11,21464,0,0,0,0,0
2020-02-17,Contra Costa,13,1133247,3,0,0,0,0
2020-02-17,Del Norte,15,27424,0,0,0,0,0
2020-02-17,El Dorado,17,186661,0,0,0,0,0
2020-02-17,Fresno,19,978130,0,0,0,0,0
2020-02-17,Glenn,21,27897,0,0,0,0,0
2020-02-17,Humboldt,23,135768,1,0,0,0,0
2020-02-17,Imperial,25,180216,1,0,0,0,0
2020-02-17,Inyo,27,18085,0,0,0,0,0
2020-02-17,Kern,29,883053,2,0,0,0,0
2020-02-17,Kings,31,150075,1,0,0,0,0
2020-02-17,Lake,33,64148,0,0,0,0,0
2020-02-17,Lassen,35,31185,0,0,0,0,0
2020-02-17,Los Angeles,37,10098052,53,1,8,9,0
2020-02-17,Madera,39,155013,0,0,0,0,0
2020-02-17,Marin,41,260295,0,0,0,0,0
2020-02-17,Mariposa,43,17540,0,0,0,0,0
2020-02-17,Mendocino,45,87422,0,0,0,0,0
2020-02-17,Merced,47,269075,0,0,0,0,0
2020-02-17,Modoc,49,8938,0,0,0,0,0
2020-02-17,Mono,51,14174,0,0,0,0,0
2020-02-17,Monterey,53,433212,0,0,0,0,0
2020-02-17,Napa,55,140530,0,0,0,0,0
2020-02-17,Nevada,57,99092,0,0,1,1,0
2020-02-17,Orange,59,3164182,42,1,0,1,0
2020-02-17,Placer,61,380077,0,0,0,0,0
2020-02-17,Plumas,63,18699,0,0,0,0,0
2020-02-17,Riverside,65,2383286,5,0,0,0,0
2020-02-17,Sacramento,67,1510023,2,0,0,0,0
2020-02-17,San Benito,69,59416,0,2,0,2,0
2020-02-17,San Bernardino,71,2135413,9,0,0,0,0
2020-02-17,San Diego,73,3302833,4,2,0,2,0
2020-02-17,San Francisco,75,870044,2,0,0,0,0
2020-02-17,San Joaquin,77,732212,1,0,1,1,0
2020-02-17,San Luis Obispo,79,281455,1,0,0,0,0
2020-02-17,San Mateo,81,765935,5,0,0,0,0
2020-02-17,Santa Barbara,83,443738,0,0,0,0,0
2020-02-17,Santa Clara,85,1922200,12,2,1,3,0
2020-02-17,Santa Cruz,87,273765,0,0,0,0,0
2020-02-17,Shasta,89,179085,0,0,0,0,0
2020-02-17,Sierra,91,2930,0,0,0,0,0
2020-02-17,Siskiyou,93,43540,0,0,0,0,0
2020-02-17,Solano,95,438530,3,5,0,5,0
2020-02-17,Sonoma,97,501317,1,0,0,0,0
2020-02-17,Stanislaus,99,539301,1,0,2,2,0
2020-02-17,Sutter,101,95872,0,0,0,0,0
2020-02-17,Tehama,103,63373,0,0,0,0,0
2020-02-17,Trinity,105,12862,0,0,0,0,0
2020-02-17,Tulare,107,460477,2,0,0,0,0
2020-02-17,Tuolumne,109,53932,0,0,0,0,0
2020-02-17,Ventura,111,848112,2,0,0,0,0
2020-02-17,Yolo,113,214977,1,0,0,0,0
2020-02-17,Yuba,115,75493,0,0,0,0,0
2020-02-16,Alameda,1,1643700,5,0,0,0,0
2020-02-16,Alpine,3,1148,0,0,0,0,0
2020-02-16,Amador,5,37829,0,0,0,0,0
2020-02-16,Butte,7,227075,0,0,0,0,0
2020-02-16,Calaveras,9,45235,0,0,0,0,0
2020-02-16,Colusa,11,21464,0,0,0,0,0
2020-02-16,Contra Costa,13,1133247,3,0,0,0,0
2020-02-16,Del Norte,15,27424,0,0,0,0,0
2020-02-16,El Dorado,17,186661,0,0,0,0,0
2020-02-16,Fresno,19,978130,0,0,0,0,0
2020-02-16,Glenn,21,27897,0,0,0,0,0
2020-02-16,Humboldt,23,135768,1,0,0,0,0
2020-02-16,Imperial,25,180216,1,0,0,0,0
2020-02-16,Inyo,27,18085,0,0,0,0,0
2020-02-16,Kern,29,883053,2,0,0,0,0
2020-02-16,Kings,31,150075,1,0,0,0,0
2020-02-16,Lake,33,64148,0,0,0,0,0
2020-02-16,Lassen,35,31185,0,0,0,0,0
2020-02-16,Los Angeles,37,10098052,46,1,8,9,0
2020-02-16,Madera,39,155013,0,0,0,0,0
2020-02-16,Marin,41,260295,0,0,0,0,0
2020-02-16,Mariposa,43,17540,0,0,0,0,0
2020-02-16,Mendocino,45,87422,0,0,0,0,0
2020-02-16,Merced,47,269075,0,0,0,0,0
2020-02-16,Modoc,49,8938,0,0,0,0,0
2020-02-16,Mono,51,14174,0,0,0,0,0
2020-02-16,Monterey,53,433212,0,0,0,0,0
2020-02-16,Napa,55,140530,0,0,0,0,0
2020-02-16,Nevada,57,99092,0,0,0,0,0
2020-02-16,Orange,59,3164182,41,1,0,1,0
2020-02-16,Placer,61,380077,0,0,0,0,0
2020-02-16,Plumas,63,18699,0,0,0,0,0
2020-02-16,Riverside,65,2383286,5,0,0,0,0
2020-02-16,Sacramento,67,1510023,2,0,0,0,0
2020-02-16,San Benito,69,59416,0,2,0,2,0
2020-02-16,San Bernardino,71,2135413,8,0,0,0,0
2020-02-16,San Diego,73,3302833,4,2,0,2,0
2020-02-16,San Francisco,75,870044,2,0,0,0,0
2020-02-16,San Joaquin,77,732212,1,0,1,1,0
2020-02-16,San Luis Obispo,79,281455,1,0,0,0,0
2020-02-16,San Mateo,81,765935,4,0,0,0,0
2020-02-16,Santa Barbara,83,443738,0,0,0,0,0
2020-02-16,Santa Clara,85,1922200,10,2,1,3,0
2020-02-16,Santa Cruz,87,273765,0,0,0,0,0
2020-02-16,Shasta,89,179085,0,0,0,0,0
2020-02-16,Sierra,91,2930,0,0,0,0,0
2020-02-16,Siskiyou,93,43540,0,0,0,0,0
2020-02-16,Solano,95,438530,1,0,0,0,0
2020-02-16,Sonoma,97,501317,1,0,0,0,0
2020-02-16,Stanislaus,99,539301,1,0,2,2,0
2020-02-16,Sutter,101,95872,0,0,0,0,0
2020-02-16,Tehama,103,63373,0,0,0,0,0
2020-02-16,Trinity,105,12862,0,0,0,0,0
2020-02-16,Tulare,107,460477,2,0,0,0,0
2020-02-16,Tuolumne,109,53932,0,0,0,0,0
2020-02-16,Ventura,111,848112,2,0,0,0,0
2020-02-16,Yolo,113,214977,1,0,0,0,0
2020-02-16,Yuba,115,75493,0,0,0,0,0
2020-02-15,Alameda,1,1643700,5,0,0,0,0
2020-02-15,Alpine,3,1148,0,0,0,0,0
2020-02-15,Amador,5,37829,0,0,0,0,0
2020-02-15,Butte,7,227075,0,0,0,0,0
2020-02-15,Calaveras,9,45235,0,0,0,0,0
2020-02-15,Colusa,11,21464,0,0,0,0,0
2020-02-15,Contra Costa,13,1133247,3,0,0,0,0
2020-02-15,Del Norte,15,27424,0,0,0,0,0
2020-02-15,El Dorado,17,186661,0,0,0,0,0
2020-02-15,Fresno,19,978130,0,0,0,0,0
2020-02-15,Glenn,21,27897,0,0,0,0,0
2020-02-15,Humboldt,23,135768,1,0,0,0,0
2020-02-15,Imperial,25,180216,1,0,0,0,0
2020-02-15,Inyo,27,18085,0,0,0,0,0
2020-02-15,Kern,29,883053,2,0,0,0,0
2020-02-15,Kings,31,150075,1,0,0,0,0
2020-02-15,Lake,33,64148,0,0,0,0,0
2020-02-15,Lassen,35,31185,0,0,0,0,0
2020-02-15,Los Angeles,37,10098052,43,1,8,9,0
2020-02-15,Madera,39,155013,0,0,0,0,0
2020-02-15,Marin,41,260295,0,0,0,0,0
2020-02-15,Mariposa,43,17540,0,0,0,0,0
2020-02-15,Mendocino,45,87422,0,0,0,0,0
2020-02-15,Merced,47,269075,0,0,0,0,0
2020-02-15,Modoc,49,8938,0,0,0,0,0
2020-02-15,Mono,51,14174,0,0,0,0,0
2020-02-15,Monterey,53,433212,0,0,0,0,0
2020-02-15,Napa,55,140530,0,0,0,0,0
2020-02-15,Nevada,57,99092,0,0,0,0,0
2020-02-15,Orange,59,3164182,40,1,0,1,0
2020-02-15,Placer,61,380077,0,0,0,0,0
2020-02-15,Plumas,63,18699,0,0,0,0,0
2020-02-15,Riverside,65,2383286,4,0,0,0,0
2020-02-15,Sacramento,67,1510023,2,0,0,0,0
2020-02-15,San Benito,69,59416,0,2,0,2,0
2020-02-15,San Bernardino,71,2135413,7,0,0,0,0
2020-02-15,San Diego,73,3302833,4,2,0,2,0
2020-02-15,San Francisco,75,870044,2,0,0,0,0
2020-02-15,San Joaquin,77,732212,1,0,1,1,0
2020-02-15,San Luis Obispo,79,281455,1,0,0,0,0
2020-02-15,San Mateo,81,765935,4,0,0,0,0
2020-02-15,Santa Barbara,83,443738,0,0,0,0,0
2020-02-15,Santa Clara,85,1922200,10,2,1,3,0
2020-02-15,Santa Cruz,87,273765,0,0,0,0,0
2020-02-15,Shasta,89,179085,0,0,0,0,0
2020-02-15,Sierra,91,2930,0,0,0,0,0
2020-02-15,Siskiyou,93,43540,0,0,0,0,0
2020-02-15,Solano,95,438530,1,0,0,0,0
2020-02-15,Sonoma,97,501317,0,0,0,0,0
2020-02-15,Stanislaus,99,539301,1,0,2,2,0
2020-02-15,Sutter,101,95872,0,0,0,0,0
2020-02-15,Tehama,103,63373,0,0,0,0,0
2020-02-15,Trinity,105,12862,0,0,0,0,0
2020-02-15,Tulare,107,460477,2,0,0,0,0
2020-02-15,Tuolumne,109,53932,0,0,0,0,0
2020-02-15,Ventura,111,848112,2,0,0,0,0
2020-02-15,Yolo,113,214977,1,0,0,0,0
2020-02-15,Yuba,115,75493,0,0,0,0,0
2020-02-14,Alameda,1,1643700,4,0,0,0,0
2020-02-14,Alpine,3,1148,0,0,0,0,0
2020-02-14,Amador,5,37829,0,0,0,0,0
2020-02-14,Butte,7,227075,0,0,0,0,0
2020-02-14,Calaveras,9,45235,0,0,0,0,0
2020-02-14,Colusa,11,21464,0,0,0,0,0
2020-02-14,Contra Costa,13,1133247,3,0,0,0,0
2020-02-14,Del Norte,15,27424,0,0,0,0,0
2020-02-14,El Dorado,17,186661,0,0,0,0,0
2020-02-14,Fresno,19,978130,0,0,0,0,0
2020-02-14,Glenn,21,27897,0,0,0,0,0
2020-02-14,Humboldt,23,135768,1,0,0,0,0
2020-02-14,Imperial,25,180216,1,0,0,0,0
2020-02-14,Inyo,27,18085,0,0,0,0,0
2020-02-14,Kern,29,883053,2,0,0,0,0
2020-02-14,Kings,31,150075,1,0,0,0,0
2020-02-14,Lake,33,64148,0,0,0,0,0
2020-02-14,Lassen,35,31185,0,0,0,0,0
2020-02-14,Los Angeles,37,10098052,38,1,8,9,0
2020-02-14,Madera,39,155013,0,0,0,0,0
2020-02-14,Marin,41,260295,0,0,0,0,0
2020-02-14,Mariposa,43,17540,0,0,0,0,0
2020-02-14,Mendocino,45,87422,0,0,0,0,0
2020-02-14,Merced,47,269075,0,0,0,0,0
2020-02-14,Modoc,49,8938,0,0,0,0,0
2020-02-14,Mono,51,14174,0,0,0,0,0
2020-02-14,Monterey,53,433212,0,0,0,0,0
2020-02-14,Napa,55,140530,0,0,0,0,0
2020-02-14,Nevada,57,99092,0,0,0,0,0
2020-02-14,Orange,59,3164182,40,1,0,1,0
2020-02-14,Placer,61,380077,0,0,0,0,0
2020-02-14,Plumas,63,18699,0,0,0,0,0
2020-02-14,Riverside,65,2383286,4,0,0,0,0
2020-02-14,Sacramento,67,1510023,1,0,0,0,0
2020-02-14,San Benito,69,59416,0,2,0,2,0
2020-02-14,San Bernardino,71,2135413,7,0,0,0,0
2020-02-14,San Diego,73,3302833,3,2,0,2,0
2020-02-14,San Francisco,75,870044,2,0,0,0,0
2020-02-14,San Joaquin,77,732212,1,0,1,1,0
2020-02-14,San Luis Obispo,79,281455,0,0,0,0,0
2020-02-14,San Mateo,81,765935,3,0,0,0,0
2020-02-14,Santa Barbara,83,443738,0,0,0,0,0
2020-02-14,Santa Clara,85,1922200,8,2,1,3,0
2020-02-14,Santa Cruz,87,273765,0,0,0,0,0
2020-02-14,Shasta,89,179085,0,0,0,0,0
2020-02-14,Sierra,91,2930,0,0,0,0,0
2020-02-14,Siskiyou,93,43540,0,0,0,0,0
2020-02-14,Solano,95,438530,1,0,0,0,0
2020-02-14,Sonoma,97,501317,0,0,0,0,0
2020-02-14,Stanislaus,99,539301,1,0,2,2,0
2020-02-14,Sutter,101,95872,0,0,0,0,0
2020-02-14,Tehama,103,63373,0,0,0,0,0
2020-02-14,Trinity,105,12862,0,0,0,0,0
2020-02-14,Tulare,107,460477,2,0,0,0,0
2020-02-14,Tuolumne,109,53932,0,0,0,0,0
2020-02-14,Ventura,111,848112,2,0,0,0,0
2020-02-14,Yolo,113,214977,1,0,0,0,0
2020-02-14,Yuba,115,75493,0,0,0,0,0
2020-02-13,Alameda,1,1643700,4,0,0,0,0
2020-02-13,Alpine,3,1148,0,0,0,0,0
2020-02-13,Amador,5,37829,0,0,0,0,0
2020-02-13,Butte,7,227075,0,0,0,0,0
2020-02-13,Calaveras,9,45235,0,0,0,0,0
2020-02-13,Colusa,11,21464,0,0,0,0,0
2020-02-13,Contra Costa,13,1133247,3,0,0,0,0
2020-02-13,Del Norte,15,27424,0,0,0,0,0
2020-02-13,El Dorado,17,186661,0,0,0,0,0
2020-02-13,Fresno,19,978130,0,0,0,0,0
2020-02-13,Glenn,21,27897,0,0,0,0,0
2020-02-13,Humboldt,23,135768,1,0,0,0,0
2020-02-13,Imperial,25,180216,1,0,0,0,0
2020-02-13,Inyo,27,18085,0,0,0,0,0
2020-02-13,Kern,29,883053,2,0,0,0,0
2020-02-13,Kings,31,150075,1,0,0,0,0
2020-02-13,Lake,33,64148,0,0,0,0,0
2020-02-13,Lassen,35,31185,0,0,0,0,0
2020-02-13,Los Angeles,37,10098052,33,1,7,8,0
2020-02-13,Madera,39,155013,0,0,0,0,0
2020-02-13,Marin,41,260295,0,0,0,0,0
2020-02-13,Mariposa,43,17540,0,0,0,0,0
2020-02-13,Mendocino,45,87422,0,0,0,0,0
2020-02-13,Merced,47,269075,0,0,0,0,0
2020-02-13,Modoc,49,8938,0,0,0,0,0
2020-02-13,Mono,51,14174,0,0,0,0,0
2020-02-13,Monterey,53,433212,0,0,0,0,0
2020-02-13,Napa,55,140530,0,0,0,0,0
2020-02-13,Nevada,57,99092,0,0,0,0,0
2020-02-13,Orange,59,3164182,39,1,0,1,0
2020-02-13,Placer,61,380077,0,0,0,0,0
2020-02-13,Plumas,63,18699,0,0,0,0,0
2020-02-13,Riverside,65,2383286,4,0,0,0,0
2020-02-13,Sacramento,67,1510023,1,0,0,0,0
2020-02-13,San Benito,69,59416,0,2,0,2,0
2020-02-13,San Bernardino,71,2135413,7,0,0,0,0
2020-02-13,San Diego,73,3302833,2,2,0,2,0
2020-02-13,San Francisco,75,870044,2,0,0,0,0
2020-02-13,San Joaquin,77,732212,1,0,1,1,0
2020-02-13,San Luis Obispo,79,281455,0,0,0,0,0
2020-02-13,San Mateo,81,765935,2,0,0,0,0
2020-02-13,Santa Barbara,83,443738,0,0,0,0,0
2020-02-13,Santa Clara,85,1922200,7,2,0,2,0
2020-02-13,Santa Cruz,87,273765,0,0,0,0,0
2020-02-13,Shasta,89,179085,0,0,0,0,0
2020-02-13,Sierra,91,2930,0,0,0,0,0
2020-02-13,Siskiyou,93,43540,0,0,0,0,0
2020-02-13,Solano,95,438530,0,0,0,0,0
2020-02-13,Sonoma,97,501317,0,0,0,0,0
2020-02-13,Stanislaus,99,539301,1,0,1,1,0
2020-02-13,Sutter,101,95872,0,0,0,0,0
2020-02-13,Tehama,103,63373,0,0,0,0,0
2020-02-13,Trinity,105,12862,0,0,0,0,0
2020-02-13,Tulare,107,460477,2,0,0,0,0
2020-02-13,Tuolumne,109,53932,0,0,0,0,0
2020-02-13,Ventura,111,848112,2,0,0,0,0
2020-02-13,Yolo,113,214977,1,0,0,0,0
2020-02-13,Yuba,115,75493,0,0,0,0,0
2020-02-12,Alameda,1,1643700,4,0,0,0,0
2020-02-12,Alpine,3,1148,0,0,0,0,0
2020-02-12,Amador,5,37829,0,0,0,0,0
2020-02-12,Butte,7,227075,0,0,0,0,0
2020-02-12,Calaveras,9,45235,0,0,0,0,0
2020-02-12,Colusa,11,21464,0,0,0,0,0
2020-02-12,Contra Costa,13,1133247,3,0,0,0,0
2020-02-12,Del Norte,15,27424,0,0,0,0,0
2020-02-12,El Dorado,17,186661,0,0,0,0,0
2020-02-12,Fresno,19,978130,0,0,0,0,0
2020-02-12,Glenn,21,27897,0,0,0,0,0
2020-02-12,Humboldt,23,135768,1,0,0,0,0
2020-02-12,Imperial,25,180216,1,0,0,0,0
2020-02-12,Inyo,27,18085,0,0,0,0,0
2020-02-12,Kern,29,883053,2,0,0,0,0
2020-02-12,Kings,31,150075,1,0,0,0,0
2020-02-12,Lake,33,64148,0,0,0,0,0
2020-02-12,Lassen,35,31185,0,0,0,0,0
2020-02-12,Los Angeles,37,10098052,31,1,7,8,0
2020-02-12,Madera,39,155013,0,0,0,0,0
2020-02-12,Marin,41,260295,0,0,0,0,0
2020-02-12,Mariposa,43,17540,0,0,0,0,0
2020-02-12,Mendocino,45,87422,0,0,0,0,0
2020-02-12,Merced,47,269075,0,0,0,0,0
2020-02-12,Modoc,49,8938,0,0,0,0,0
2020-02-12,Mono,51,14174,0,0,0,0,0
2020-02-12,Monterey,53,433212,0,0,0,0,0
2020-02-12,Napa,55,140530,0,0,0,0,0
2020-02-12,Nevada,57,99092,0,0,0,0,0
2020-02-12,Orange,59,3164182,39,1,0,1,0
2020-02-12,Placer,61,380077,0,0,0,0,0
2020-02-12,Plumas,63,18699,0,0,0,0,0
2020-02-12,Riverside,65,2383286,4,0,0,0,0
2020-02-12,Sacramento,67,1510023,1,0,0,0,0
2020-02-12,San Benito,69,59416,0,2,0,2,0
2020-02-12,San Bernardino,71,2135413,7,0,0,0,0
2020-02-12,San Diego,73,3302833,2,2,0,2,0
2020-02-12,San Francisco,75,870044,2,0,0,0,0
2020-02-12,San Joaquin,77,732212,1,0,1,1,0
2020-02-12,San Luis Obispo,79,281455,0,0,0,0,0
2020-02-12,San Mateo,81,765935,2,0,0,0,0
2020-02-12,Santa Barbara,83,443738,0,0,0,0,0
2020-02-12,Santa Clara,85,1922200,6,2,0,2,0
2020-02-12,Santa Cruz,87,273765,0,0,0,0,0
2020-02-12,Shasta,89,179085,0,0,0,0,0
2020-02-12,Sierra,91,2930,0,0,0,0,0
2020-02-12,Siskiyou,93,43540,0,0,0,0,0
2020-02-12,Solano,95,438530,0,0,0,0,0
2020-02-12,Sonoma,97,501317,0,0,0,0,0
2020-02-12,Stanislaus,99,539301,1,0,1,1,0
2020-02-12,Sutter,101,95872,0,0,0,0,0
2020-02-12,Tehama,103,63373,0,0,0,0,0
2020-02-12,Trinity,105,12862,0,0,0,0,0
2020-02-12,Tulare,107,460477,2,0,0,0,0
2020-02-12,Tuolumne,109,53932,0,0,0,0,0
2020-02-12,Ventura,111,848112,2,0,0,0,0
2020-02-12,Yolo,113,214977,1,0,0,0,0
2020-02-12,Yuba,115,75493,0,0,0,0,0
2020-02-11,Alameda,1,1643700,4,0,0,0,0
2020-02-11,Alpine,3,1148,0,0,0,0,0
2020-02-11,Amador,5,37829,0,0,0,0,0
2020-02-11,Butte,7,227075,0,0,0,0,0
2020-02-11,Calaveras,9,45235,0,0,0,0,0
2020-02-11,Colusa,11,21464,0,0,0,0,0
2020-02-11,Contra Costa,13,1133247,3,0,0,0,0
2020-02-11,Del Norte,15,27424,0,0,0,0,0
2020-02-11,El Dorado,17,186661,0,0,0,0,0
2020-02-11,Fresno,19,978130,0,0,0,0,0
2020-02-11,Glenn,21,27897,0,0,0,0,0
2020-02-11,Humboldt,23,135768,1,0,0,0,0
2020-02-11,Imperial,25,180216,1,0,0,0,0
2020-02-11,Inyo,27,18085,0,0,0,0,0
2020-02-11,Kern,29,883053,2,0,0,0,0
2020-02-11,Kings,31,150075,1,0,0,0,0
2020-02-11,Lake,33,64148,0,0,0,0,0
2020-02-11,Lassen,35,31185,0,0,0,0,0
2020-02-11,Los Angeles,37,10098052,30,1,6,7,0
2020-02-11,Madera,39,155013,0,0,0,0,0
2020-02-11,Marin,41,260295,0,0,0,0,0
2020-02-11,Mariposa,43,17540,0,0,0,0,0
2020-02-11,Mendocino,45,87422,0,0,0,0,0
2020-02-11,Merced,47,269075,0,0,0,0,0
2020-02-11,Modoc,49,8938,0,0,0,0,0
2020-02-11,Mono,51,14174,0,0,0,0,0
2020-02-11,Monterey,53,433212,0,0,0,0,0
2020-02-11,Napa,55,140530,0,0,0,0,0
2020-02-11,Nevada,57,99092,0,0,0,0,0
2020-02-11,Orange,59,3164182,38,1,0,1,0
2020-02-11,Placer,61,380077,0,0,0,0,0
2020-02-11,Plumas,63,18699,0,0,0,0,0
2020-02-11,Riverside,65,2383286,4,0,0,0,0
2020-02-11,Sacramento,67,1510023,1,0,0,0,0
2020-02-11,San Benito,69,59416,0,2,0,2,0
2020-02-11,San Bernardino,71,2135413,7,0,0,0,0
2020-02-11,San Diego,73,3302833,2,1,0,1,0
2020-02-11,San Francisco,75,870044,2,0,0,0,0
2020-02-11,San Joaquin,77,732212,0,0,1,1,0
2020-02-11,San Luis Obispo,79,281455,0,0,0,0,0
2020-02-11,San Mateo,81,765935,2,0,0,0,0
2020-02-11,Santa Barbara,83,443738,0,0,0,0,0
2020-02-11,Santa Clara,85,1922200,5,2,0,2,0
2020-02-11,Santa Cruz,87,273765,0,0,0,0,0
2020-02-11,Shasta,89,179085,0,0,0,0,0
2020-02-11,Sierra,91,2930,0,0,0,0,0
2020-02-11,Siskiyou,93,43540,0,0,0,0,0
2020-02-11,Solano,95,438530,0,0,0,0,0
2020-02-11,Sonoma,97,501317,0,0,0,0,0
2020-02-11,Stanislaus,99,539301,1,0,1,1,0
2020-02-11,Sutter,101,95872,0,0,0,0,0
2020-02-11,Tehama,103,63373,0,0,0,0,0
2020-02-11,Trinity,105,12862,0,0,0,0,0
2020-02-11,Tulare,107,460477,2,0,0,0,0
2020-02-11,Tuolumne,109,53932,0,0,0,0,0
2020-02-11,Ventura,111,848112,2,0,0,0,0
2020-02-11,Yolo,113,214977,1,0,0,0,0
2020-02-11,Yuba,115,75493,0,0,0,0,0
2020-02-10,Alameda,1,1643700,4,0,0,0,0
2020-02-10,Alpine,3,1148,0,0,0,0,0
2020-02-10,Amador,5,37829,0,0,0,0,0
2020-02-10,Butte,7,227075,0,0,0,0,0
2020-02-10,Calaveras,9,45235,0,0,0,0,0
2020-02-10,Colusa,11,21464,0,0,0,0,0
2020-02-10,Contra Costa,13,1133247,3,0,0,0,0
2020-02-10,Del Norte,15,27424,0,0,0,0,0
2020-02-10,El Dorado,17,186661,0,0,0,0,0
2020-02-10,Fresno,19,978130,0,0,0,0,0
2020-02-10,Glenn,21,27897,0,0,0,0,0
2020-02-10,Humboldt,23,135768,0,0,0,0,0
2020-02-10,Imperial,25,180216,1,0,0,0,0
2020-02-10,Inyo,27,18085,0,0,0,0,0
2020-02-10,Kern,29,883053,2,0,0,0,0
2020-02-10,Kings,31,150075,1,0,0,0,0
2020-02-10,Lake,33,64148,0,0,0,0,0
2020-02-10,Lassen,35,31185,0,0,0,0,0
2020-02-10,Los Angeles,37,10098052,28,1,6,7,0
2020-02-10,Madera,39,155013,0,0,0,0,0
2020-02-10,Marin,41,260295,0,0,0,0,0
2020-02-10,Mariposa,43,17540,0,0,0,0,0
2020-02-10,Mendocino,45,87422,0,0,0,0,0
2020-02-10,Merced,47,269075,0,0,0,0,0
2020-02-10,Modoc,49,8938,0,0,0,0,0
2020-02-10,Mono,51,14174,0,0,0,0,0
2020-02-10,Monterey,53,433212,0,0,0,0,0
2020-02-10,Napa,55,140530,0,0,0,0,0
2020-02-10,Nevada,57,99092,0,0,0,0,0
2020-02-10,Orange,59,3164182,38,1,0,1,0
2020-02-10,Placer,61,380077,0,0,0,0,0
2020-02-10,Plumas,63,18699,0,0,0,0,0
2020-02-10,Riverside,65,2383286,4,0,0,0,0
2020-02-10,Sacramento,67,1510023,1,0,0,0,0
2020-02-10,San Benito,69,59416,0,2,0,2,0
2020-02-10,San Bernardino,71,2135413,6,0,0,0,0
2020-02-10,San Diego,73,3302833,2,0,0,0,0
2020-02-10,San Francisco,75,870044,2,0,0,0,0
2020-02-10,San Joaquin,77,732212,0,0,1,1,0
2020-02-10,San Luis Obispo,79,281455,0,0,0,0,0
2020-02-10,San Mateo,81,765935,2,0,0,0,0
2020-02-10,Santa Barbara,83,443738,0,0,0,0,0
2020-02-10,Santa Clara,85,1922200,5,2,0,2,0
2020-02-10,Santa Cruz,87,273765,0,0,0,0,0
2020-02-10,Shasta,89,179085,0,0,0,0,0
2020-02-10,Sierra,91,2930,0,0,0,0,0
2020-02-10,Siskiyou,93,43540,0,0,0,0,0
2020-02-10,Solano,95,438530,0,0,0,0,0
2020-02-10,Sonoma,97,501317,0,0,0,0,0
2020-02-10,Stanislaus,99,539301,1,0,0,0,0
2020-02-10,Sutter,101,95872,0,0,0,0,0
2020-02-10,Tehama,103,63373,0,0,0,0,0
2020-02-10,Trinity,105,12862,0,0,0,0,0
2020-02-10,Tulare,107,460477,2,0,0,0,0
2020-02-10,Tuolumne,109,53932,0,0,0,0,0
2020-02-10,Ventura,111,848112,2,0,0,0,0
2020-02-10,Yolo,113,214977,1,0,0,0,0
2020-02-10,Yuba,115,75493,0,0,0,0,0
2020-02-09,Alameda,1,1643700,4,0,0,0,0
2020-02-09,Alpine,3,1148,0,0,0,0,0
2020-02-09,Amador,5,37829,0,0,0,0,0
2020-02-09,Butte,7,227075,0,0,0,0,0
2020-02-09,Calaveras,9,45235,0,0,0,0,0
2020-02-09,Colusa,11,21464,0,0,0,0,0
2020-02-09,Contra Costa,13,1133247,3,0,0,0,0
2020-02-09,Del Norte,15,27424,0,0,0,0,0
2020-02-09,El Dorado,17,186661,0,0,0,0,0
2020-02-09,Fresno,19,978130,0,0,0,0,0
2020-02-09,Glenn,21,27897,0,0,0,0,0
2020-02-09,Humboldt,23,135768,0,0,0,0,0
2020-02-09,Imperial,25,180216,1,0,0,0,0
2020-02-09,Inyo,27,18085,0,0,0,0,0
2020-02-09,Kern,29,883053,2,0,0,0,0
2020-02-09,Kings,31,150075,1,0,0,0,0
2020-02-09,Lake,33,64148,0,0,0,0,0
2020-02-09,Lassen,35,31185,0,0,0,0,0
2020-02-09,Los Angeles,37,10098052,25,1,6,7,0
2020-02-09,Madera,39,155013,0,0,0,0,0
2020-02-09,Marin,41,260295,0,0,0,0,0
2020-02-09,Mariposa,43,17540,0,0,0,0,0
2020-02-09,Mendocino,45,87422,0,0,0,0,0
2020-02-09,Merced,47,269075,0,0,0,0,0
2020-02-09,Modoc,49,8938,0,0,0,0,0
2020-02-09,Mono,51,14174,0,0,0,0,0
2020-02-09,Monterey,53,433212,0,0,0,0,0
2020-02-09,Napa,55,140530,0,0,0,0,0
2020-02-09,Nevada,57,99092,0,0,0,0,0
2020-02-09,Orange,59,3164182,37,1,0,1,0
2020-02-09,Placer,61,380077,0,0,0,0,0
2020-02-09,Plumas,63,18699,0,0,0,0,0
2020-02-09,Riverside,65,2383286,4,0,0,0,0
2020-02-09,Sacramento,67,1510023,0,0,0,0,0
2020-02-09,San Benito,69,59416,0,2,0,2,0
2020-02-09,San Bernardino,71,2135413,6,0,0,0,0
2020-02-09,San Diego,73,3302833,2,0,0,0,0
2020-02-09,San Francisco,75,870044,1,0,0,0,0
2020-02-09,San Joaquin,77,732212,0,0,1,1,0
2020-02-09,San Luis Obispo,79,281455,0,0,0,0,0
2020-02-09,San Mateo,81,765935,2,0,0,0,0
2020-02-09,Santa Barbara,83,443738,0,0,0,0,0
2020-02-09,Santa Clara,85,1922200,4,2,0,2,0
2020-02-09,Santa Cruz,87,273765,0,0,0,0,0
2020-02-09,Shasta,89,179085,0,0,0,0,0
2020-02-09,Sierra,91,2930,0,0,0,0,0
2020-02-09,Siskiyou,93,43540,0,0,0,0,0
2020-02-09,Solano,95,438530,0,0,0,0,0
2020-02-09,Sonoma,97,501317,0,0,0,0,0
2020-02-09,Stanislaus,99,539301,0,0,0,0,0
2020-02-09,Sutter,101,95872,0,0,0,0,0
2020-02-09,Tehama,103,63373,0,0,0,0,0
2020-02-09,Trinity,105,12862,0,0,0,0,0
2020-02-09,Tulare,107,460477,2,0,0,0,0
2020-02-09,Tuolumne,109,53932,0,0,0,0,0
2020-02-09,Ventura,111,848112,1,0,0,0,0
2020-02-09,Yolo,113,214977,1,0,0,0,0
2020-02-09,Yuba,115,75493,0,0,0,0,0
2020-02-08,Alameda,1,1643700,3,0,0,0,0
2020-02-08,Alpine,3,1148,0,0,0,0,0
2020-02-08,Amador,5,37829,0,0,0,0,0
2020-02-08,Butte,7,227075,0,0,0,0,0
2020-02-08,Calaveras,9,45235,0,0,0,0,0
2020-02-08,Colusa,11,21464,0,0,0,0,0
2020-02-08,Contra Costa,13,1133247,2,0,0,0,0
2020-02-08,Del Norte,15,27424,0,0,0,0,0
2020-02-08,El Dorado,17,186661,0,0,0,0,0
2020-02-08,Fresno,19,978130,0,0,0,0,0
2020-02-08,Glenn,21,27897,0,0,0,0,0
2020-02-08,Humboldt,23,135768,0,0,0,0,0
2020-02-08,Imperial,25,180216,1,0,0,0,0
2020-02-08,Inyo,27,18085,0,0,0,0,0
2020-02-08,Kern,29,883053,2,0,0,0,0
2020-02-08,Kings,31,150075,1,0,0,0,0
2020-02-08,Lake,33,64148,0,0,0,0,0
2020-02-08,Lassen,35,31185,0,0,0,0,0
2020-02-08,Los Angeles,37,10098052,21,1,3,4,0
2020-02-08,Madera,39,155013,0,0,0,0,0
2020-02-08,Marin,41,260295,0,0,0,0,0
2020-02-08,Mariposa,43,17540,0,0,0,0,0
2020-02-08,Mendocino,45,87422,0,0,0,0,0
2020-02-08,Merced,47,269075,0,0,0,0,0
2020-02-08,Modoc,49,8938,0,0,0,0,0
2020-02-08,Mono,51,14174,0,0,0,0,0
2020-02-08,Monterey,53,433212,0,0,0,0,0
2020-02-08,Napa,55,140530,0,0,0,0,0
2020-02-08,Nevada,57,99092,0,0,0,0,0
2020-02-08,Orange,59,3164182,37,1,0,1,0
2020-02-08,Placer,61,380077,0,0,0,0,0
2020-02-08,Plumas,63,18699,0,0,0,0,0
2020-02-08,Riverside,65,2383286,4,0,0,0,0
2020-02-08,Sacramento,67,1510023,0,0,0,0,0
2020-02-08,San Benito,69,59416,0,2,0,2,0
2020-02-08,San Bernardino,71,2135413,6,0,0,0,0
2020-02-08,San Diego,73,3302833,1,0,0,0,0
2020-02-08,San Francisco,75,870044,1,0,0,0,0
2020-02-08,San Joaquin,77,732212,0,0,1,1,0
2020-02-08,San Luis Obispo,79,281455,0,0,0,0,0
2020-02-08,San Mateo,81,765935,2,0,0,0,0
2020-02-08,Santa Barbara,83,443738,0,0,0,0,0
2020-02-08,Santa Clara,85,1922200,4,2,0,2,0
2020-02-08,Santa Cruz,87,273765,0,0,0,0,0
2020-02-08,Shasta,89,179085,0,0,0,0,0
2020-02-08,Sierra,91,2930,0,0,0,0,0
2020-02-08,Siskiyou,93,43540,0,0,0,0,0
2020-02-08,Solano,95,438530,0,0,0,0,0
2020-02-08,Sonoma,97,501317,0,0,0,0,0
2020-02-08,Stanislaus,99,539301,0,0,0,0,0
2020-02-08,Sutter,101,95872,0,0,0,0,0
2020-02-08,Tehama,103,63373,0,0,0,0,0
2020-02-08,Trinity,105,12862,0,0,0,0,0
2020-02-08,Tulare,107,460477,2,0,0,0,0
2020-02-08,Tuolumne,109,53932,0,0,0,0,0
2020-02-08,Ventura,111,848112,1,0,0,0,0
2020-02-08,Yolo,113,214977,1,0,0,0,0
2020-02-08,Yuba,115,75493,0,0,0,0,0
2020-02-07,Alameda,1,1643700,3,0,0,0,0
2020-02-07,Alpine,3,1148,0,0,0,0,0
2020-02-07,Amador,5,37829,0,0,0,0,0
2020-02-07,Butte,7,227075,0,0,0,0,0
2020-02-07,Calaveras,9,45235,0,0,0,0,0
2020-02-07,Colusa,11,21464,0,0,0,0,0
2020-02-07,Contra Costa,13,1133247,2,0,0,0,0
2020-02-07,Del Norte,15,27424,0,0,0,0,0
2020-02-07,El Dorado,17,186661,0,0,0,0,0
2020-02-07,Fresno,19,978130,0,0,0,0,0
2020-02-07,Glenn,21,27897,0,0,0,0,0
2020-02-07,Humboldt,23,135768,0,0,0,0,0
2020-02-07,Imperial,25,180216,1,0,0,0,0
2020-02-07,Inyo,27,18085,0,0,0,0,0
2020-02-07,Kern,29,883053,2,0,0,0,0
2020-02-07,Kings,31,150075,1,0,0,0,0
2020-02-07,Lake,33,64148,0,0,0,0,0
2020-02-07,Lassen,35,31185,0,0,0,0,0
2020-02-07,Los Angeles,37,10098052,20,1,2,3,0
2020-02-07,Madera,39,155013,0,0,0,0,0
2020-02-07,Marin,41,260295,0,0,0,0,0
2020-02-07,Mariposa,43,17540,0,0,0,0,0
2020-02-07,Mendocino,45,87422,0,0,0,0,0
2020-02-07,Merced,47,269075,0,0,0,0,0
2020-02-07,Modoc,49,8938,0,0,0,0,0
2020-02-07,Mono,51,14174,0,0,0,0,0
2020-02-07,Monterey,53,433212,0,0,0,0,0
2020-02-07,Napa,55,140530,0,0,0,0,0
2020-02-07,Nevada,57,99092,0,0,0,0,0
2020-02-07,Orange,59,3164182,35,1,0,1,0
2020-02-07,Placer,61,380077,0,0,0,0,0
2020-02-07,Plumas,63,18699,0,0,0,0,0
2020-02-07,Riverside,65,2383286,4,0,0,0,0
2020-02-07,Sacramento,67,1510023,0,0,0,0,0
2020-02-07,San Benito,69,59416,0,2,0,2,0
2020-02-07,San Bernardino,71,2135413,3,0,0,0,0
2020-02-07,San Diego,73,3302833,1,0,0,0,0
2020-02-07,San Francisco,75,870044,1,0,0,0,0
2020-02-07,San Joaquin,77,732212,0,0,1,1,0
2020-02-07,San Luis Obispo,79,281455,0,0,0,0,0
2020-02-07,San Mateo,81,765935,1,0,0,0,0
2020-02-07,Santa Barbara,83,443738,0,0,0,0,0
2020-02-07,Santa Clara,85,1922200,4,2,0,2,0
2020-02-07,Santa Cruz,87,273765,0,0,0,0,0
2020-02-07,Shasta,89,179085,0,0,0,0,0
2020-02-07,Sierra,91,2930,0,0,0,0,0
2020-02-07,Siskiyou,93,43540,0,0,0,0,0
2020-02-07,Solano,95,438530,0,0,0,0,0
2020-02-07,Sonoma,97,501317,0,0,0,0,0
2020-02-07,Stanislaus,99,539301,0,0,0,0,0
2020-02-07,Sutter,101,95872,0,0,0,0,0
2020-02-07,Tehama,103,63373,0,0,0,0,0
2020-02-07,Trinity,105,12862,0,0,0,0,0
2020-02-07,Tulare,107,460477,2,0,0,0,0
2020-02-07,Tuolumne,109,53932,0,0,0,0,0
2020-02-07,Ventura,111,848112,1,0,0,0,0
2020-02-07,Yolo,113,214977,1,0,0,0,0
2020-02-07,Yuba,115,75493,0,0,0,0,0
2020-02-06,Alameda,1,1643700,3,0,0,0,0
2020-02-06,Alpine,3,1148,0,0,0,0,0
2020-02-06,Amador,5,37829,0,0,0,0,0
2020-02-06,Butte,7,227075,0,0,0,0,0
2020-02-06,Calaveras,9,45235,0,0,0,0,0
2020-02-06,Colusa,11,21464,0,0,0,0,0
2020-02-06,Contra Costa,13,1133247,2,0,0,0,0
2020-02-06,Del Norte,15,27424,0,0,0,0,0
2020-02-06,El Dorado,17,186661,0,0,0,0,0
2020-02-06,Fresno,19,978130,0,0,0,0,0
2020-02-06,Glenn,21,27897,0,0,0,0,0
2020-02-06,Humboldt,23,135768,0,0,0,0,0
2020-02-06,Imperial,25,180216,1,0,0,0,0
2020-02-06,Inyo,27,18085,0,0,0,0,0
2020-02-06,Kern,29,883053,2,0,0,0,0
2020-02-06,Kings,31,150075,0,0,0,0,0
2020-02-06,Lake,33,64148,0,0,0,0,0
2020-02-06,Lassen,35,31185,0,0,0,0,0
2020-02-06,Los Angeles,37,10098052,18,1,2,3,0
2020-02-06,Madera,39,155013,0,0,0,0,0
2020-02-06,Marin,41,260295,0,0,0,0,0
2020-02-06,Mariposa,43,17540,0,0,0,0,0
2020-02-06,Mendocino,45,87422,0,0,0,0,0
2020-02-06,Merced,47,269075,0,0,0,0,0
2020-02-06,Modoc,49,8938,0,0,0,0,0
2020-02-06,Mono,51,14174,0,0,0,0,0
2020-02-06,Monterey,53,433212,0,0,0,0,0
2020-02-06,Napa,55,140530,0,0,0,0,0
2020-02-06,Nevada,57,99092,0,0,0,0,0
2020-02-06,Orange,59,3164182,5,1,0,1,0
2020-02-06,Placer,61,380077,0,0,0,0,0
2020-02-06,Plumas,63,18699,0,0,0,0,0
2020-02-06,Riverside,65,2383286,4,0,0,0,0
2020-02-06,Sacramento,67,1510023,0,0,0,0,0
2020-02-06,San Benito,69,59416,0,2,0,2,0
2020-02-06,San Bernardino,71,2135413,3,0,0,0,0
2020-02-06,San Diego,73,3302833,1,0,0,0,0
2020-02-06,San Francisco,75,870044,1,0,0,0,0
2020-02-06,San Joaquin,77,732212,0,0,1,1,0
2020-02-06,San Luis Obispo,79,281455,0,0,0,0,0
2020-02-06,San Mateo,81,765935,1,0,0,0,0
2020-02-06,Santa Barbara,83,443738,0,0,0,0,0
2020-02-06,Santa Clara,85,1922200,4,2,0,2,0
2020-02-06,Santa Cruz,87,273765,0,0,0,0,0
2020-02-06,Shasta,89,179085,0,0,0,0,0
2020-02-06,Sierra,91,2930,0,0,0,0,0
2020-02-06,Siskiyou,93,43540,0,0,0,0,0
2020-02-06,Solano,95,438530,0,0,0,0,0
2020-02-06,Sonoma,97,501317,0,0,0,0,0
2020-02-06,Stanislaus,99,539301,0,0,0,0,0
2020-02-06,Sutter,101,95872,0,0,0,0,0
2020-02-06,Tehama,103,63373,0,0,0,0,0
2020-02-06,Trinity,105,12862,0,0,0,0,0
2020-02-06,Tulare,107,460477,2,0,0,0,0
2020-02-06,Tuolumne,109,53932,0,0,0,0,0
2020-02-06,Ventura,111,848112,1,0,0,0,0
2020-02-06,Yolo,113,214977,1,0,0,0,0
2020-02-06,Yuba,115,75493,0,0,0,0,0
2020-02-05,Alameda,1,1643700,3,0,0,0,0
2020-02-05,Alpine,3,1148,0,0,0,0,0
2020-02-05,Amador,5,37829,0,0,0,0,0
2020-02-05,Butte,7,227075,0,0,0,0,0
2020-02-05,Calaveras,9,45235,0,0,0,0,0
2020-02-05,Colusa,11,21464,0,0,0,0,0
2020-02-05,Contra Costa,13,1133247,2,0,0,0,0
2020-02-05,Del Norte,15,27424,0,0,0,0,0
2020-02-05,El Dorado,17,186661,0,0,0,0,0
2020-02-05,Fresno,19,978130,0,0,0,0,0
2020-02-05,Glenn,21,27897,0,0,0,0,0
2020-02-05,Humboldt,23,135768,0,0,0,0,0
2020-02-05,Imperial,25,180216,1,0,0,0,0
2020-02-05,Inyo,27,18085,0,0,0,0,0
2020-02-05,Kern,29,883053,1,0,0,0,0
2020-02-05,Kings,31,150075,0,0,0,0,0
2020-02-05,Lake,33,64148,0,0,0,0,0
2020-02-05,Lassen,35,31185,0,0,0,0,0
2020-02-05,Los Angeles,37,10098052,18,1,1,2,0
2020-02-05,Madera,39,155013,0,0,0,0,0
2020-02-05,Marin,41,260295,0,0,0,0,0
2020-02-05,Mariposa,43,17540,0,0,0,0,0
2020-02-05,Mendocino,45,87422,0,0,0,0,0
2020-02-05,Merced,47,269075,0,0,0,0,0
2020-02-05,Modoc,49,8938,0,0,0,0,0
2020-02-05,Mono,51,14174,0,0,0,0,0
2020-02-05,Monterey,53,433212,0,0,0,0,0
2020-02-05,Napa,55,140530,0,0,0,0,0
2020-02-05,Nevada,57,99092,0,0,0,0,0
2020-02-05,Orange,59,3164182,4,1,0,1,0
2020-02-05,Placer,61,380077,0,0,0,0,0
2020-02-05,Plumas,63,18699,0,0,0,0,0
2020-02-05,Riverside,65,2383286,4,0,0,0,0
2020-02-05,Sacramento,67,1510023,0,0,0,0,0
2020-02-05,San Benito,69,59416,0,2,0,2,0
2020-02-05,San Bernardino,71,2135413,3,0,0,0,0
2020-02-05,San Diego,73,3302833,0,0,0,0,0
2020-02-05,San Francisco,75,870044,1,0,0,0,0
2020-02-05,San Joaquin,77,732212,0,0,1,1,0
2020-02-05,San Luis Obispo,79,281455,0,0,0,0,0
2020-02-05,San Mateo,81,765935,1,0,0,0,0
2020-02-05,Santa Barbara,83,443738,0,0,0,0,0
2020-02-05,Santa Clara,85,1922200,2,2,0,2,0
2020-02-05,Santa Cruz,87,273765,0,0,0,0,0
2020-02-05,Shasta,89,179085,0,0,0,0,0
2020-02-05,Sierra,91,2930,0,0,0,0,0
2020-02-05,Siskiyou,93,43540,0,0,0,0,0
2020-02-05,Solano,95,438530,0,0,0,0,0
2020-02-05,Sonoma,97,501317,0,0,0,0,0
2020-02-05,Stanislaus,99,539301,0,0,0,0,0
2020-02-05,Sutter,101,95872,0,0,0,0,0
2020-02-05,Tehama,103,63373,0,0,0,0,0
2020-02-05,Trinity,105,12862,0,0,0,0,0
2020-02-05,Tulare,107,460477,2,0,0,0,0
2020-02-05,Tuolumne,109,53932,0,0,0,0,0
2020-02-05,Ventura,111,848112,0,0,0,0,0
2020-02-05,Yolo,113,214977,1,0,0,0,0
2020-02-05,Yuba,115,75493,0,0,0,0,0
2020-02-04,Alameda,1,1643700,3,0,0,0,0
2020-02-04,Alpine,3,1148,0,0,0,0,0
2020-02-04,Amador,5,37829,0,0,0,0,0
2020-02-04,Butte,7,227075,0,0,0,0,0
2020-02-04,Calaveras,9,45235,0,0,0,0,0
2020-02-04,Colusa,11,21464,0,0,0,0,0
2020-02-04,Contra Costa,13,1133247,2,0,0,0,0
2020-02-04,Del Norte,15,27424,0,0,0,0,0
2020-02-04,El Dorado,17,186661,0,0,0,0,0
2020-02-04,Fresno,19,978130,0,0,0,0,0
2020-02-04,Glenn,21,27897,0,0,0,0,0
2020-02-04,Humboldt,23,135768,0,0,0,0,0
2020-02-04,Imperial,25,180216,1,0,0,0,0
2020-02-04,Inyo,27,18085,0,0,0,0,0
2020-02-04,Kern,29,883053,0,0,0,0,0
2020-02-04,Kings,31,150075,0,0,0,0,0
2020-02-04,Lake,33,64148,0,0,0,0,0
2020-02-04,Lassen,35,31185,0,0,0,0,0
2020-02-04,Los Angeles,37,10098052,17,1,1,2,0
2020-02-04,Madera,39,155013,0,0,0,0,0
2020-02-04,Marin,41,260295,0,0,0,0,0
2020-02-04,Mariposa,43,17540,0,0,0,0,0
2020-02-04,Mendocino,45,87422,0,0,0,0,0
2020-02-04,Merced,47,269075,0,0,0,0,0
2020-02-04,Modoc,49,8938,0,0,0,0,0
2020-02-04,Mono,51,14174,0,0,0,0,0
2020-02-04,Monterey,53,433212,0,0,0,0,0
2020-02-04,Napa,55,140530,0,0,0,0,0
2020-02-04,Nevada,57,99092,0,0,0,0,0
2020-02-04,Orange,59,3164182,4,1,0,1,0
2020-02-04,Placer,61,380077,0,0,0,0,0
2020-02-04,Plumas,63,18699,0,0,0,0,0
2020-02-04,Riverside,65,2383286,4,0,0,0,0
2020-02-04,Sacramento,67,1510023,0,0,0,0,0
2020-02-04,San Benito,69,59416,0,2,0,2,0
2020-02-04,San Bernardino,71,2135413,2,0,0,0,0
2020-02-04,San Diego,73,3302833,0,0,0,0,0
2020-02-04,San Francisco,75,870044,1,0,0,0,0
2020-02-04,San Joaquin,77,732212,0,0,1,1,0
2020-02-04,San Luis Obispo,79,281455,0,0,0,0,0
2020-02-04,San Mateo,81,765935,0,0,0,0,0
2020-02-04,Santa Barbara,83,443738,0,0,0,0,0
2020-02-04,Santa Clara,85,1922200,2,2,0,2,0
2020-02-04,Santa Cruz,87,273765,0,0,0,0,0
2020-02-04,Shasta,89,179085,0,0,0,0,0
2020-02-04,Sierra,91,2930,0,0,0,0,0
2020-02-04,Siskiyou,93,43540,0,0,0,0,0
2020-02-04,Solano,95,438530,0,0,0,0,0
2020-02-04,Sonoma,97,501317,0,0,0,0,0
2020-02-04,Stanislaus,99,539301,0,0,0,0,0
2020-02-04,Sutter,101,95872,0,0,0,0,0
2020-02-04,Tehama,103,63373,0,0,0,0,0
2020-02-04,Trinity,105,12862,0,0,0,0,0
2020-02-04,Tulare,107,460477,2,0,0,0,0
2020-02-04,Tuolumne,109,53932,0,0,0,0,0
2020-02-04,Ventura,111,848112,0,0,0,0,0
2020-02-04,Yolo,113,214977,1,0,0,0,0
2020-02-04,Yuba,115,75493,0,0,0,0,0
2020-02-03,Alameda,1,1643700,3,0,0,0,0
2020-02-03,Alpine,3,1148,0,0,0,0,0
2020-02-03,Amador,5,37829,0,0,0,0,0
2020-02-03,Butte,7,227075,0,0,0,0,0
2020-02-03,Calaveras,9,45235,0,0,0,0,0
2020-02-03,Colusa,11,21464,0,0,0,0,0
2020-02-03,Contra Costa,13,1133247,2,0,0,0,0
2020-02-03,Del Norte,15,27424,0,0,0,0,0
2020-02-03,El Dorado,17,186661,0,0,0,0,0
2020-02-03,Fresno,19,978130,0,0,0,0,0
2020-02-03,Glenn,21,27897,0,0,0,0,0
2020-02-03,Humboldt,23,135768,0,0,0,0,0
2020-02-03,Imperial,25,180216,1,0,0,0,0
2020-02-03,Inyo,27,18085,0,0,0,0,0
2020-02-03,Kern,29,883053,0,0,0,0,0
2020-02-03,Kings,31,150075,0,0,0,0,0
2020-02-03,Lake,33,64148,0,0,0,0,0
2020-02-03,Lassen,35,31185,0,0,0,0,0
2020-02-03,Los Angeles,37,10098052,17,1,0,1,0
2020-02-03,Madera,39,155013,0,0,0,0,0
2020-02-03,Marin,41,260295,0,0,0,0,0
2020-02-03,Mariposa,43,17540,0,0,0,0,0
2020-02-03,Mendocino,45,87422,0,0,0,0,0
2020-02-03,Merced,47,269075,0,0,0,0,0
2020-02-03,Modoc,49,8938,0,0,0,0,0
2020-02-03,Mono,51,14174,0,0,0,0,0
2020-02-03,Monterey,53,433212,0,0,0,0,0
2020-02-03,Napa,55,140530,0,0,0,0,0
2020-02-03,Nevada,57,99092,0,0,0,0,0
2020-02-03,Orange,59,3164182,3,1,0,1,0
2020-02-03,Placer,61,380077,0,0,0,0,0
2020-02-03,Plumas,63,18699,0,0,0,0,0
2020-02-03,Riverside,65,2383286,4,0,0,0,0
2020-02-03,Sacramento,67,1510023,0,0,0,0,0
2020-02-03,San Benito,69,59416,0,2,0,2,0
2020-02-03,San Bernardino,71,2135413,2,0,0,0,0
2020-02-03,San Diego,73,3302833,0,0,0,0,0
2020-02-03,San Francisco,75,870044,1,0,0,0,0
2020-02-03,San Joaquin,77,732212,0,0,1,1,0
2020-02-03,San Luis Obispo,79,281455,0,0,0,0,0
2020-02-03,San Mateo,81,765935,0,0,0,0,0
2020-02-03,Santa Barbara,83,443738,0,0,0,0,0
2020-02-03,Santa Clara,85,1922200,2,2,0,2,0
2020-02-03,Santa Cruz,87,273765,0,0,0,0,0
2020-02-03,Shasta,89,179085,0,0,0,0,0
2020-02-03,Sierra,91,2930,0,0,0,0,0
2020-02-03,Siskiyou,93,43540,0,0,0,0,0
2020-02-03,Solano,95,438530,0,0,0,0,0
2020-02-03,Sonoma,97,501317,0,0,0,0,0
2020-02-03,Stanislaus,99,539301,0,0,0,0,0
2020-02-03,Sutter,101,95872,0,0,0,0,0
2020-02-03,Tehama,103,63373,0,0,0,0,0
2020-02-03,Trinity,105,12862,0,0,0,0,0
2020-02-03,Tulare,107,460477,2,0,0,0,0
2020-02-03,Tuolumne,109,53932,0,0,0,0,0
2020-02-03,Ventura,111,848112,0,0,0,0,0
2020-02-03,Yolo,113,214977,1,0,0,0,0
2020-02-03,Yuba,115,75493,0,0,0,0,0
2020-02-02,Alameda,1,1643700,3,0,0,0,0
2020-02-02,Alpine,3,1148,0,0,0,0,0
2020-02-02,Amador,5,37829,0,0,0,0,0
2020-02-02,Butte,7,227075,0,0,0,0,0
2020-02-02,Calaveras,9,45235,0,0,0,0,0
2020-02-02,Colusa,11,21464,0,0,0,0,0
2020-02-02,Contra Costa,13,1133247,1,0,0,0,0
2020-02-02,Del Norte,15,27424,0,0,0,0,0
2020-02-02,El Dorado,17,186661,0,0,0,0,0
2020-02-02,Fresno,19,978130,0,0,0,0,0
2020-02-02,Glenn,21,27897,0,0,0,0,0
2020-02-02,Humboldt,23,135768,0,0,0,0,0
2020-02-02,Imperial,25,180216,1,0,0,0,0
2020-02-02,Inyo,27,18085,0,0,0,0,0
2020-02-02,Kern,29,883053,0,0,0,0,0
2020-02-02,Kings,31,150075,0,0,0,0,0
2020-02-02,Lake,33,64148,0,0,0,0,0
2020-02-02,Lassen,35,31185,0,0,0,0,0
2020-02-02,Los Angeles,37,10098052,15,1,0,1,0
2020-02-02,Madera,39,155013,0,0,0,0,0
2020-02-02,Marin,41,260295,0,0,0,0,0
2020-02-02,Mariposa,43,17540,0,0,0,0,0
2020-02-02,Mendocino,45,87422,0,0,0,0,0
2020-02-02,Merced,47,269075,0,0,0,0,0
2020-02-02,Modoc,49,8938,0,0,0,0,0
2020-02-02,Mono,51,14174,0,0,0,0,0
2020-02-02,Monterey,53,433212,0,0,0,0,0
2020-02-02,Napa,55,140530,0,0,0,0,0
2020-02-02,Nevada,57,99092,0,0,0,0,0
2020-02-02,Orange,59,3164182,3,1,0,1,0
2020-02-02,Placer,61,380077,0,0,0,0,0
2020-02-02,Plumas,63,18699,0,0,0,0,0
2020-02-02,Riverside,65,2383286,3,0,0,0,0
2020-02-02,Sacramento,67,1510023,0,0,0,0,0
2020-02-02,San Benito,69,59416,0,2,0,2,0
2020-02-02,San Bernardino,71,2135413,2,0,0,0,0
2020-02-02,San Diego,73,3302833,0,0,0,0,0
2020-02-02,San Francisco,75,870044,1,0,0,0,0
2020-02-02,San Joaquin,77,732212,0,0,1,1,0
2020-02-02,San Luis Obispo,79,281455,0,0,0,0,0
2020-02-02,San Mateo,81,765935,0,0,0,0,0
2020-02-02,Santa Barbara,83,443738,0,0,0,0,0
2020-02-02,Santa Clara,85,1922200,2,2,0,2,0
2020-02-02,Santa Cruz,87,273765,0,0,0,0,0
2020-02-02,Shasta,89,179085,0,0,0,0,0
2020-02-02,Sierra,91,2930,0,0,0,0,0
2020-02-02,Siskiyou,93,43540,0,0,0,0,0
2020-02-02,Solano,95,438530,0,0,0,0,0
2020-02-02,Sonoma,97,501317,0,0,0,0,0
2020-02-02,Stanislaus,99,539301,0,0,0,0,0
2020-02-02,Sutter,101,95872,0,0,0,0,0
2020-02-02,Tehama,103,63373,0,0,0,0,0
2020-02-02,Trinity,105,12862,0,0,0,0,0
2020-02-02,Tulare,107,460477,2,0,0,0,0
2020-02-02,Tuolumne,109,53932,0,0,0,0,0
2020-02-02,Ventura,111,848112,0,0,0,0,0
2020-02-02,Yolo,113,214977,1,0,0,0,0
2020-02-02,Yuba,115,75493,0,0,0,0,0
2020-02-01,Alameda,1,1643700,3,0,0,0,0
2020-02-01,Alpine,3,1148,0,0,0,0,0
2020-02-01,Amador,5,37829,0,0,0,0,0
2020-02-01,Butte,7,227075,0,0,0,0,0
2020-02-01,Calaveras,9,45235,0,0,0,0,0
2020-02-01,Colusa,11,21464,0,0,0,0,0
2020-02-01,Contra Costa,13,1133247,0,0,0,0,0
2020-02-01,Del Norte,15,27424,0,0,0,0,0
2020-02-01,El Dorado,17,186661,0,0,0,0,0
2020-02-01,Fresno,19,978130,0,0,0,0,0
2020-02-01,Glenn,21,27897,0,0,0,0,0
2020-02-01,Humboldt,23,135768,0,0,0,0,0
2020-02-01,Imperial,25,180216,0,0,0,0,0
2020-02-01,Inyo,27,18085,0,0,0,0,0
2020-02-01,Kern,29,883053,0,0,0,0,0
2020-02-01,Kings,31,150075,0,0,0,0,0
2020-02-01,Lake,33,64148,0,0,0,0,0
2020-02-01,Lassen,35,31185,0,0,0,0,0
2020-02-01,Los Angeles,37,10098052,14,1,0,1,0
2020-02-01,Madera,39,155013,0,0,0,0,0
2020-02-01,Marin,41,260295,0,0,0,0,0
2020-02-01,Mariposa,43,17540,0,0,0,0,0
2020-02-01,Mendocino,45,87422,0,0,0,0,0
2020-02-01,Merced,47,269075,0,0,0,0,0
2020-02-01,Modoc,49,8938,0,0,0,0,0
2020-02-01,Mono,51,14174,0,0,0,0,0
2020-02-01,Monterey,53,433212,0,0,0,0,0
2020-02-01,Napa,55,140530,0,0,0,0,0
2020-02-01,Nevada,57,99092,0,0,0,0,0
2020-02-01,Orange,59,3164182,3,1,0,1,0
2020-02-01,Placer,61,380077,0,0,0,0,0
2020-02-01,Plumas,63,18699,0,0,0,0,0
2020-02-01,Riverside,65,2383286,2,0,0,0,0
2020-02-01,Sacramento,67,1510023,0,0,0,0,0
2020-02-01,San Benito,69,59416,0,0,0,0,0
2020-02-01,San Bernardino,71,2135413,1,0,0,0,0
2020-02-01,San Diego,73,3302833,0,0,0,0,0
2020-02-01,San Francisco,75,870044,1,0,0,0,0
2020-02-01,San Joaquin,77,732212,0,0,1,1,0
2020-02-01,San Luis Obispo,79,281455,0,0,0,0,0
2020-02-01,San Mateo,81,765935,0,0,0,0,0
2020-02-01,Santa Barbara,83,443738,0,0,0,0,0
2020-02-01,Santa Clara,85,1922200,2,1,0,1,0
2020-02-01,Santa Cruz,87,273765,0,0,0,0,0
2020-02-01,Shasta,89,179085,0,0,0,0,0
2020-02-01,Sierra,91,2930,0,0,0,0,0
2020-02-01,Siskiyou,93,43540,0,0,0,0,0
2020-02-01,Solano,95,438530,0,0,0,0,0
2020-02-01,Sonoma,97,501317,0,0,0,0,0
2020-02-01,Stanislaus,99,539301,0,0,0,0,0
2020-02-01,Sutter,101,95872,0,0,0,0,0
2020-02-01,Tehama,103,63373,0,0,0,0,0
2020-02-01,Trinity,105,12862,0,0,0,0,0
2020-02-01,Tulare,107,460477,1,0,0,0,0
2020-02-01,Tuolumne,109,53932,0,0,0,0,0
2020-02-01,Ventura,111,848112,0,0,0,0,0
2020-02-01,Yolo,113,214977,0,0,0,0,0
2020-02-01,Yuba,115,75493,0,0,0,0,0
