date,county,fips,population,confirmed_cases,reported_cases,probable_cases,reported_and_probable_cases,reported_deaths
2022-08-25,Alameda,001,1643700,339614,339618,19706,359324,1978
2022-08-25,Alpine,003,1148,133,133,1,134,0
2022-08-25,Amador,005,37829,9801,9802,894,10696,89
2022-08-25,Butte,007,227075,38606,38606,8656,47262,452
2022-08-25,Calaveras,009,45235,8368,8368,504,8872,133
2022-08-25,Colusa,011,21464,3734,3736,1225,4961,22
2022-08-25,Contra Costa,013,1133247,243328,243331,19840,263171,1404
2022-08-25,Del Norte,015,27424,7315,7316,390,7706,55
2022-08-25,El Dorado,017,186661,31760,31760,4142,35902,226
2022-08-25,Fresno,019,978130,269678,269680,28963,298643,2829
2022-08-25,Glenn,021,27897,5434,5434,1841,7275,49
2022-08-25,Humboldt,023,135768,21261,21264,4784,26048,154
2022-08-25,Imperial,025,180216,64388,64391,15063,79454,953
2022-08-25,Inyo,027,18085,4443,4443,876,5319,59
2022-08-25,Kern,029,883053,215601,215612,56340,271952,2399
2022-08-25,Kings,031,150075,58441,58443,3982,62425,455
2022-08-25,Lake,033,64148,12524,12524,1122,13646,142
2022-08-25,Lassen,035,31185,9871,9871,972,10843,64
2022-08-25,Los Angeles,037,10098052,3219072,3219328,172982,3392310,32833
2022-08-25,Madera,039,155013,43103,43105,7889,50994,372
2022-08-25,Marin,041,260295,44188,44192,5129,49321,305
2022-08-25,Mariposa,043,17540,3018,3018,328,3346,31
2022-08-25,Mendocino,045,87422,15698,15698,4260,19958,134
2022-08-25,Merced,047,269075,70903,70906,11081,81987,851
2022-08-25,Modoc,049,8938,865,865,315,1180,11
2022-08-25,Mono,051,14174,3181,3181,238,3419,7
2022-08-25,Monterey,053,433212,92843,92844,20354,113198,760
2022-08-25,Napa,055,140530,31667,31668,1390,33058,156
2022-08-25,Nevada,057,99092,18587,18592,1731,20323,132
2022-08-25,Orange,059,3164182,656438,656440,59079,715519,7326
2022-08-25,Placer,061,380077,74391,74391,9186,83577,657
2022-08-25,Plumas,063,18699,3571,3571,430,4001,13
2022-08-25,Riverside,065,2383286,683454,683511,34174,717685,6580
2022-08-25,Sacramento,067,1510023,339842,339846,32596,372442,3222
2022-08-25,San Benito,069,59416,15803,15805,922,16727,103
2022-08-25,San Bernardino,071,2135413,653784,653843,29541,683384,8017
2022-08-25,San Diego,073,3302833,908809,908809,69700,978509,5456
2022-08-25,San Francisco,075,870044,175196,175204,11785,186989,1000
2022-08-25,San Joaquin,077,732212,193872,193880,13745,207625,2296
2022-08-25,San Luis Obispo,079,281455,62093,62105,6891,68996,515
2022-08-25,San Mateo,081,765935,164673,164675,10381,175056,738
2022-08-25,Santa Barbara,083,443738,103496,103496,6626,110122,717
2022-08-25,Santa Clara,085,1922200,422633,422650,18367,441017,2459
2022-08-25,Santa Cruz,087,273765,61594,61594,3320,64914,273
2022-08-25,Shasta,089,179085,34283,34283,7158,41441,590
2022-08-25,Sierra,091,2930,300,300,60,360,5
2022-08-25,Siskiyou,093,43540,5140,5140,3261,8401,89
2022-08-25,Solano,095,438530,102843,102855,7485,110340,460
2022-08-25,Sonoma,097,501317,104639,104646,5043,109689,557
2022-08-25,Stanislaus,099,539301,135290,135310,20534,155844,1722
2022-08-25,Sutter,101,95872,23754,23759,2426,26185,228
2022-08-25,Tehama,103,63373,13340,13340,3000,16340,210
2022-08-25,Trinity,105,12862,1370,1370,363,1733,20
2022-08-25,Tulare,107,460477,119940,119942,34708,154650,1527
2022-08-25,Tuolumne,109,53932,15192,15193,905,16098,196
2022-08-25,Ventura,111,848112,204565,204567,14819,219386,1553
2022-08-25,Yolo,113,214977,46744,46744,4217,50961,334
2022-08-25,Yuba,115,75493,18479,18482,1650,20132,129
2022-08-24,Alameda,001,1643700,339614,338591,19706,358297,1976
2022-08-24,Alpine,003,1148,133,131,1,132,0
2022-08-24,Amador,005,37829,9801,9786,894,10680,89
2022-08-24,Butte,007,227075,38606,38458,8656,47114,449
2022-08-24,Calaveras,009,45235,8368,8334,504,8838,132
2022-08-24,Colusa,011,21464,3734,3722,1225,4947,22
2022-08-24,Contra Costa,013,1133247,243328,242633,19840,262473,1399
2022-08-24,Del Norte,015,27424,7315,7308,390,7698,55
2022-08-24,El Dorado,017,186661,31760,31682,4142,35824,225
2022-08-24,Fresno,019,978130,269678,269025,28963,297988,2822
2022-08-24,Glenn,021,27897,5434,5423,1841,7264,48
2022-08-24,Humboldt,023,135768,21261,21195,4784,25979,153
2022-08-24,Imperial,025,180216,64388,64271,15063,79334,951
2022-08-24,Inyo,027,18085,4443,4440,876,5316,59
2022-08-24,Kern,029,883053,215601,215225,56340,271565,2399
2022-08-24,Kings,031,150075,58441,58324,3982,62306,454
2022-08-24,Lake,033,64148,12524,12476,1122,13598,142
2022-08-24,Lassen,035,31185,9871,9867,972,10839,64
2022-08-24,Los Angeles,037,10098052,3219072,3211321,172982,3384303,32783
2022-08-24,Madera,039,155013,43103,42984,7889,50873,372
2022-08-24,Marin,041,260295,44188,44082,5129,49211,305
2022-08-24,Mariposa,043,17540,3018,3010,328,3338,31
2022-08-24,Mendocino,045,87422,15698,15623,4260,19883,134
2022-08-24,Merced,047,269075,70903,70665,11081,81746,849
2022-08-24,Modoc,049,8938,865,864,315,1179,11
2022-08-24,Mono,051,14174,3181,3181,238,3419,7
2022-08-24,Monterey,053,433212,92843,92590,20354,112944,760
2022-08-24,Napa,055,140530,31667,31602,1390,32992,156
2022-08-24,Nevada,057,99092,18587,18565,1731,20296,132
2022-08-24,Orange,059,3164182,656438,654893,59079,713972,7312
2022-08-24,Placer,061,380077,74391,74226,9186,83412,657
2022-08-24,Plumas,063,18699,3571,3555,430,3985,13
2022-08-24,Riverside,065,2383286,683454,681805,34174,715979,6573
2022-08-24,Sacramento,067,1510023,339842,339009,32596,371605,3208
2022-08-24,San Benito,069,59416,15803,15745,922,16667,103
2022-08-24,San Bernardino,071,2135413,653784,651496,29541,681037,8018
2022-08-24,San Diego,073,3302833,908809,906885,69700,976585,5453
2022-08-24,San Francisco,075,870044,175196,174731,11785,186516,974
2022-08-24,San Joaquin,077,732212,193872,193370,13745,207115,2288
2022-08-24,San Luis Obispo,079,281455,62093,61962,6891,68853,515
2022-08-24,San Mateo,081,765935,164673,164307,10381,174688,738
2022-08-24,Santa Barbara,083,443738,103496,103237,6626,109863,716
2022-08-24,Santa Clara,085,1922200,422633,421483,18367,439850,2454
2022-08-24,Santa Cruz,087,273765,61594,61387,3320,64707,270
2022-08-24,Shasta,089,179085,34283,34180,7158,41338,589
2022-08-24,Sierra,091,2930,300,301,60,361,5
2022-08-24,Siskiyou,093,43540,5140,5133,3261,8394,88
2022-08-24,Solano,095,438530,102843,102631,7485,110116,459
2022-08-24,Sonoma,097,501317,104639,104444,5043,109487,520
2022-08-24,Stanislaus,099,539301,135290,134894,20534,155428,1720
2022-08-24,Sutter,101,95872,23754,23673,2426,26099,228
2022-08-24,Tehama,103,63373,13340,13312,3000,16312,209
2022-08-24,Trinity,105,12862,1370,1369,363,1732,20
2022-08-24,Tulare,107,460477,119940,119644,34708,154352,1525
2022-08-24,Tuolumne,109,53932,15192,15140,905,16045,196
2022-08-24,Ventura,111,848112,204565,204064,14819,218883,1551
2022-08-24,Yolo,113,214977,46744,46665,4217,50882,333
2022-08-24,Yuba,115,75493,18479,18425,1650,20075,129
2022-08-23,Alameda,001,1643700,339540,338591,19705,358296,1976
2022-08-23,Alpine,003,1148,133,131,1,132,0
2022-08-23,Amador,005,37829,9800,9786,894,10680,89
2022-08-23,Butte,007,227075,38594,38458,8656,47114,449
2022-08-23,Calaveras,009,45235,8362,8334,504,8838,132
2022-08-23,Colusa,011,21464,3733,3722,1219,4941,22
2022-08-23,Contra Costa,013,1133247,243305,242633,19840,262473,1399
2022-08-23,Del Norte,015,27424,7314,7308,390,7698,55
2022-08-23,El Dorado,017,186661,31756,31682,4141,35823,225
2022-08-23,Fresno,019,978130,269601,269025,28963,297988,2822
2022-08-23,Glenn,021,27897,5433,5423,1841,7264,48
2022-08-23,Humboldt,023,135768,21257,21195,4784,25979,153
2022-08-23,Imperial,025,180216,64380,64271,15063,79334,951
2022-08-23,Inyo,027,18085,4443,4440,876,5316,59
2022-08-23,Kern,029,883053,215585,215225,56338,271563,2399
2022-08-23,Kings,031,150075,58424,58324,3981,62305,454
2022-08-23,Lake,033,64148,12515,12476,1122,13598,142
2022-08-23,Lassen,035,31185,9870,9867,972,10839,64
2022-08-23,Los Angeles,037,10098052,3219017,3211321,172952,3384273,32783
2022-08-23,Madera,039,155013,43088,42984,7889,50873,372
2022-08-23,Marin,041,260295,44179,44082,5129,49211,305
2022-08-23,Mariposa,043,17540,3017,3010,328,3338,31
2022-08-23,Mendocino,045,87422,15693,15623,4260,19883,134
2022-08-23,Merced,047,269075,70895,70665,11081,81746,849
2022-08-23,Modoc,049,8938,865,864,315,1179,11
2022-08-23,Mono,051,14174,3181,3181,238,3419,7
2022-08-23,Monterey,053,433212,92826,92590,20354,112944,760
2022-08-23,Napa,055,140530,31660,31602,1390,32992,156
2022-08-23,Nevada,057,99092,18585,18565,1729,20294,132
2022-08-23,Orange,059,3164182,656344,654893,59079,713972,7312
2022-08-23,Placer,061,380077,74381,74226,9186,83412,657
2022-08-23,Plumas,063,18699,3569,3555,430,3985,13
2022-08-23,Riverside,065,2383286,683386,681805,34169,715974,6573
2022-08-23,Sacramento,067,1510023,339798,339009,32596,371605,3208
2022-08-23,San Benito,069,59416,15799,15745,922,16667,103
2022-08-23,San Bernardino,071,2135413,653734,651496,29539,681035,8018
2022-08-23,San Diego,073,3302833,908705,906885,69642,976527,5453
2022-08-23,San Francisco,075,870044,175162,174731,11785,186516,974
2022-08-23,San Joaquin,077,732212,193827,193370,13735,207105,2288
2022-08-23,San Luis Obispo,079,281455,62088,61962,6891,68853,515
2022-08-23,San Mateo,081,765935,164650,164307,10381,174688,738
2022-08-23,Santa Barbara,083,443738,103471,103237,6626,109863,716
2022-08-23,Santa Clara,085,1922200,422581,421483,18367,439850,2454
2022-08-23,Santa Cruz,087,273765,61592,61387,3320,64707,270
2022-08-23,Shasta,089,179085,34282,34180,7158,41338,589
2022-08-23,Sierra,091,2930,300,301,60,361,5
2022-08-23,Siskiyou,093,43540,5139,5133,3260,8393,88
2022-08-23,Solano,095,438530,102831,102631,7485,110116,459
2022-08-23,Sonoma,097,501317,104618,104444,5043,109487,520
2022-08-23,Stanislaus,099,539301,135249,134894,20527,155421,1720
2022-08-23,Sutter,101,95872,23747,23673,2426,26099,228
2022-08-23,Tehama,103,63373,13339,13312,3000,16312,209
2022-08-23,Trinity,105,12862,1370,1369,363,1732,20
2022-08-23,Tulare,107,460477,119906,119644,34697,154341,1525
2022-08-23,Tuolumne,109,53932,15185,15140,905,16045,196
2022-08-23,Ventura,111,848112,204540,204064,14813,218877,1551
2022-08-23,Yolo,113,214977,46741,46665,4217,50882,333
2022-08-23,Yuba,115,75493,18470,18425,1649,20074,129
2022-08-22,Alameda,001,1643700,339321,338591,19705,358296,1976
2022-08-22,Alpine,003,1148,133,131,1,132,0
2022-08-22,Amador,005,37829,9797,9786,894,10680,89
2022-08-22,Butte,007,227075,38556,38458,8655,47113,449
2022-08-22,Calaveras,009,45235,8353,8334,504,8838,132
2022-08-22,Colusa,011,21464,3731,3722,1219,4941,22
2022-08-22,Contra Costa,013,1133247,243136,242633,19839,262472,1399
2022-08-22,Del Norte,015,27424,7313,7308,390,7698,55
2022-08-22,El Dorado,017,186661,31738,31682,4141,35823,225
2022-08-22,Fresno,019,978130,269435,269025,28963,297988,2822
2022-08-22,Glenn,021,27897,5432,5423,1839,7262,48
2022-08-22,Humboldt,023,135768,21243,21195,4773,25968,153
2022-08-22,Imperial,025,180216,64336,64271,15062,79333,951
2022-08-22,Inyo,027,18085,4442,4440,876,5316,59
2022-08-22,Kern,029,883053,215540,215225,56332,271557,2399
2022-08-22,Kings,031,150075,58396,58324,3978,62302,454
2022-08-22,Lake,033,64148,12500,12476,1122,13598,142
2022-08-22,Lassen,035,31185,9870,9867,972,10839,64
2022-08-22,Los Angeles,037,10098052,3218011,3211321,172754,3384075,32783
2022-08-22,Madera,039,155013,43060,42984,7889,50873,372
2022-08-22,Marin,041,260295,44140,44082,5123,49205,305
2022-08-22,Mariposa,043,17540,3012,3010,328,3338,31
2022-08-22,Mendocino,045,87422,15679,15623,4260,19883,134
2022-08-22,Merced,047,269075,70848,70665,11081,81746,849
2022-08-22,Modoc,049,8938,865,864,315,1179,11
2022-08-22,Mono,051,14174,3181,3181,238,3419,7
2022-08-22,Monterey,053,433212,92765,92590,20350,112940,760
2022-08-22,Napa,055,140530,31634,31602,1390,32992,156
2022-08-22,Nevada,057,99092,18579,18565,1729,20294,132
2022-08-22,Orange,059,3164182,656032,654893,59079,713972,7312
2022-08-22,Placer,061,380077,74351,74226,9183,83409,657
2022-08-22,Plumas,063,18699,3566,3555,430,3985,13
2022-08-22,Riverside,065,2383286,683056,681805,34163,715968,6573
2022-08-22,Sacramento,067,1510023,339585,339009,32596,371605,3208
2022-08-22,San Benito,069,59416,15783,15745,922,16667,103
2022-08-22,San Bernardino,071,2135413,653366,651496,29539,681035,8018
2022-08-22,San Diego,073,3302833,908256,906885,69520,976405,5453
2022-08-22,San Francisco,075,870044,175019,174731,11785,186516,974
2022-08-22,San Joaquin,077,732212,193679,193370,13728,207098,2288
2022-08-22,San Luis Obispo,079,281455,62058,61962,6889,68851,515
2022-08-22,San Mateo,081,765935,164549,164307,10381,174688,738
2022-08-22,Santa Barbara,083,443738,103407,103237,6626,109863,716
2022-08-22,Santa Clara,085,1922200,422236,421483,18367,439850,2454
2022-08-22,Santa Cruz,087,273765,61563,61387,3320,64707,270
2022-08-22,Shasta,089,179085,34277,34180,7158,41338,589
2022-08-22,Sierra,091,2930,300,301,60,361,5
2022-08-22,Siskiyou,093,43540,5137,5133,3260,8393,88
2022-08-22,Solano,095,438530,102772,102631,7485,110116,459
2022-08-22,Sonoma,097,501317,104572,104444,5042,109486,520
2022-08-22,Stanislaus,099,539301,135118,134894,20509,155403,1720
2022-08-22,Sutter,101,95872,23716,23673,2426,26099,228
2022-08-22,Tehama,103,63373,13338,13312,3000,16312,209
2022-08-22,Trinity,105,12862,1370,1369,363,1732,20
2022-08-22,Tulare,107,460477,119814,119644,34675,154319,1525
2022-08-22,Tuolumne,109,53932,15175,15140,905,16045,196
2022-08-22,Ventura,111,848112,204428,204064,14791,218855,1551
2022-08-22,Yolo,113,214977,46718,46665,4217,50882,333
2022-08-22,Yuba,115,75493,18454,18425,1646,20071,129
2022-08-21,Alameda,001,1643700,338974,337238,19705,356943,1970
2022-08-21,Alpine,003,1148,132,131,1,132,0
2022-08-21,Amador,005,37829,9793,9761,894,10655,89
2022-08-21,Butte,007,227075,38515,38316,8652,46968,449
2022-08-21,Calaveras,009,45235,8341,8313,504,8817,132
2022-08-21,Colusa,011,21464,3727,3718,1218,4936,22
2022-08-21,Contra Costa,013,1133247,242899,241665,19839,261504,1399
2022-08-21,Del Norte,015,27424,7306,7290,390,7680,55
2022-08-21,El Dorado,017,186661,31712,31600,4141,35741,225
2022-08-21,Fresno,019,978130,269186,268147,28963,297110,2822
2022-08-21,Glenn,021,27897,5430,5413,1838,7251,48
2022-08-21,Humboldt,023,135768,21222,21104,4760,25864,153
2022-08-21,Imperial,025,180216,64289,64092,15059,79151,951
2022-08-21,Inyo,027,18085,4442,4435,876,5311,59
2022-08-21,Kern,029,883053,215386,214656,56328,270984,2389
2022-08-21,Kings,031,150075,58333,58109,3977,62086,454
2022-08-21,Lake,033,64148,12479,12426,1122,13548,142
2022-08-21,Lassen,035,31185,9868,9843,972,10815,64
2022-08-21,Los Angeles,037,10098052,3215699,3200023,172489,3372512,32746
2022-08-21,Madera,039,155013,43017,42822,7889,50711,372
2022-08-21,Marin,041,260295,44099,43966,5113,49079,305
2022-08-21,Mariposa,043,17540,3011,3003,328,3331,31
2022-08-21,Mendocino,045,87422,15647,15578,4260,19838,134
2022-08-21,Merced,047,269075,70756,70449,11081,81530,846
2022-08-21,Modoc,049,8938,864,862,315,1177,11
2022-08-21,Mono,051,14174,3181,3177,238,3415,7
2022-08-21,Monterey,053,433212,92683,92287,20346,112633,760
2022-08-21,Napa,055,140530,31611,31534,1390,32924,156
2022-08-21,Nevada,057,99092,18570,18497,1729,20226,132
2022-08-21,Orange,059,3164182,655396,652703,59078,711781,7280
2022-08-21,Placer,061,380077,74297,74027,9181,83208,657
2022-08-21,Plumas,063,18699,3559,3550,430,3980,13
2022-08-21,Riverside,065,2383286,682393,679298,34158,713456,6574
2022-08-21,Sacramento,067,1510023,339241,337745,32595,370340,3208
2022-08-21,San Benito,069,59416,15763,15698,922,16620,103
2022-08-21,San Bernardino,071,2135413,652644,648583,29538,678121,8014
2022-08-21,San Diego,073,3302833,907430,904015,69446,973461,5448
2022-08-21,San Francisco,075,870044,174855,174151,11785,185936,973
2022-08-21,San Joaquin,077,732212,193449,192738,13716,206454,2288
2022-08-21,San Luis Obispo,079,281455,62015,61764,6887,68651,516
2022-08-21,San Mateo,081,765935,164409,163705,10381,174086,738
2022-08-21,Santa Barbara,083,443738,103293,102795,6626,109421,713
2022-08-21,Santa Clara,085,1922200,421813,419723,18367,438090,2437
2022-08-21,Santa Cruz,087,273765,61453,61098,3319,64417,269
2022-08-21,Shasta,089,179085,34235,34105,7158,41263,588
2022-08-21,Sierra,091,2930,300,298,60,358,4
2022-08-21,Siskiyou,093,43540,5137,5119,3259,8378,88
2022-08-21,Solano,095,438530,102689,102355,7485,109840,457
2022-08-21,Sonoma,097,501317,104490,104090,5041,109131,511
2022-08-21,Stanislaus,099,539301,134981,134407,20463,154870,1719
2022-08-21,Sutter,101,95872,23685,23587,2426,26013,228
2022-08-21,Tehama,103,63373,13329,13289,2998,16287,209
2022-08-21,Trinity,105,12862,1369,1366,363,1729,20
2022-08-21,Tulare,107,460477,119702,119251,34657,153908,1521
2022-08-21,Tuolumne,109,53932,15162,15085,905,15990,196
2022-08-21,Ventura,111,848112,204221,203318,14769,218087,1547
2022-08-21,Yolo,113,214977,46684,46567,4217,50784,333
2022-08-21,Yuba,115,75493,18430,18363,1641,20004,129
2022-08-20,Alameda,001,1643700,338840,337238,19701,356939,1970
2022-08-20,Alpine,003,1148,132,131,1,132,0
2022-08-20,Amador,005,37829,9790,9761,894,10655,89
2022-08-20,Butte,007,227075,38495,38316,8648,46964,449
2022-08-20,Calaveras,009,45235,8340,8313,503,8816,132
2022-08-20,Colusa,011,21464,3726,3718,1218,4936,22
2022-08-20,Contra Costa,013,1133247,242794,241665,19829,261494,1399
2022-08-20,Del Norte,015,27424,7305,7290,390,7680,55
2022-08-20,El Dorado,017,186661,31692,31600,4140,35740,225
2022-08-20,Fresno,019,978130,269065,268147,28962,297109,2822
2022-08-20,Glenn,021,27897,5427,5413,1838,7251,48
2022-08-20,Humboldt,023,135768,21209,21104,4756,25860,153
2022-08-20,Imperial,025,180216,64267,64092,15057,79149,951
2022-08-20,Inyo,027,18085,4442,4435,876,5311,59
2022-08-20,Kern,029,883053,215311,214656,56315,270971,2389
2022-08-20,Kings,031,150075,58312,58109,3974,62083,454
2022-08-20,Lake,033,64148,12472,12426,1122,13548,142
2022-08-20,Lassen,035,31185,9867,9843,972,10815,64
2022-08-20,Los Angeles,037,10098052,3214461,3200023,172326,3372349,32746
2022-08-20,Madera,039,155013,42997,42822,7888,50710,372
2022-08-20,Marin,041,260295,44083,43966,5112,49078,305
2022-08-20,Mariposa,043,17540,3011,3003,328,3331,31
2022-08-20,Mendocino,045,87422,15637,15578,4259,19837,134
2022-08-20,Merced,047,269075,70734,70449,11079,81528,846
2022-08-20,Modoc,049,8938,864,862,315,1177,11
2022-08-20,Mono,051,14174,3181,3177,238,3415,7
2022-08-20,Monterey,053,433212,92654,92287,20333,112620,760
2022-08-20,Napa,055,140530,31608,31534,1390,32924,156
2022-08-20,Nevada,057,99092,18569,18497,1729,20226,132
2022-08-20,Orange,059,3164182,655079,652703,59030,711733,7280
2022-08-20,Placer,061,380077,74251,74027,9180,83207,657
2022-08-20,Plumas,063,18699,3559,3550,430,3980,13
2022-08-20,Riverside,065,2383286,682082,679298,34148,713446,6574
2022-08-20,Sacramento,067,1510023,339085,337745,32593,370338,3208
2022-08-20,San Benito,069,59416,15744,15698,919,16617,103
2022-08-20,San Bernardino,071,2135413,652355,648583,29519,678102,8014
2022-08-20,San Diego,073,3302833,907100,904015,69424,973439,5448
2022-08-20,San Francisco,075,870044,174767,174151,11785,185936,973
2022-08-20,San Joaquin,077,732212,193377,192738,13704,206442,2288
2022-08-20,San Luis Obispo,079,281455,61999,61764,6884,68648,516
2022-08-20,San Mateo,081,765935,164329,163705,10377,174082,738
2022-08-20,Santa Barbara,083,443738,103246,102795,6621,109416,713
2022-08-20,Santa Clara,085,1922200,421603,419723,18365,438088,2437
2022-08-20,Santa Cruz,087,273765,61437,61098,3316,64414,269
2022-08-20,Shasta,089,179085,34211,34105,7158,41263,588
2022-08-20,Sierra,091,2930,300,298,60,358,4
2022-08-20,Siskiyou,093,43540,5132,5119,3259,8378,88
2022-08-20,Solano,095,438530,102643,102355,7483,109838,457
2022-08-20,Sonoma,097,501317,104449,104090,5039,109129,511
2022-08-20,Stanislaus,099,539301,134907,134407,20453,154860,1719
2022-08-20,Sutter,101,95872,23658,23587,2426,26013,228
2022-08-20,Tehama,103,63373,13326,13289,2996,16285,209
2022-08-20,Trinity,105,12862,1369,1366,363,1729,20
2022-08-20,Tulare,107,460477,119655,119251,34637,153888,1521
2022-08-20,Tuolumne,109,53932,15158,15085,905,15990,196
2022-08-20,Ventura,111,848112,204132,203318,14764,218082,1547
2022-08-20,Yolo,113,214977,46672,46567,4214,50781,333
2022-08-20,Yuba,115,75493,18423,18363,1640,20003,129
2022-08-19,Alameda,001,1643700,338683,337238,19687,356925,1970
2022-08-19,Alpine,003,1148,132,131,1,132,0
2022-08-19,Amador,005,37829,9789,9761,893,10654,89
2022-08-19,Butte,007,227075,38478,38316,8642,46958,449
2022-08-19,Calaveras,009,45235,8337,8313,503,8816,132
2022-08-19,Colusa,011,21464,3725,3718,1217,4935,22
2022-08-19,Contra Costa,013,1133247,242680,241665,19821,261486,1399
2022-08-19,Del Norte,015,27424,7300,7290,390,7680,55
2022-08-19,El Dorado,017,186661,31685,31600,4138,35738,225
2022-08-19,Fresno,019,978130,268928,268147,28953,297100,2822
2022-08-19,Glenn,021,27897,5427,5413,1838,7251,48
2022-08-19,Humboldt,023,135768,21199,21104,4750,25854,153
2022-08-19,Imperial,025,180216,64245,64092,15051,79143,951
2022-08-19,Inyo,027,18085,4442,4435,873,5308,59
2022-08-19,Kern,029,883053,215237,214656,56289,270945,2389
2022-08-19,Kings,031,150075,58271,58109,3968,62077,454
2022-08-19,Lake,033,64148,12461,12426,1120,13546,142
2022-08-19,Lassen,035,31185,9864,9843,972,10815,64
2022-08-19,Los Angeles,037,10098052,3212855,3200023,172161,3372184,32746
2022-08-19,Madera,039,155013,42978,42822,7884,50706,372
2022-08-19,Marin,041,260295,44060,43966,5110,49076,305
2022-08-19,Mariposa,043,17540,3010,3003,328,3331,31
2022-08-19,Mendocino,045,87422,15625,15578,4252,19830,134
2022-08-19,Merced,047,269075,70712,70449,11079,81528,846
2022-08-19,Modoc,049,8938,864,862,315,1177,11
2022-08-19,Mono,051,14174,3181,3177,238,3415,7
2022-08-19,Monterey,053,433212,92618,92287,20315,112602,760
2022-08-19,Napa,055,140530,31594,31534,1388,32922,156
2022-08-19,Nevada,057,99092,18566,18497,1729,20226,132
2022-08-19,Orange,059,3164182,654728,652703,58955,711658,7280
2022-08-19,Placer,061,380077,74226,74027,9178,83205,657
2022-08-19,Plumas,063,18699,3559,3550,430,3980,13
2022-08-19,Riverside,065,2383286,681767,679298,34128,713426,6574
2022-08-19,Sacramento,067,1510023,338919,337745,32585,370330,3208
2022-08-19,San Benito,069,59416,15742,15698,919,16617,103
2022-08-19,San Bernardino,071,2135413,652017,648583,29508,678091,8014
2022-08-19,San Diego,073,3302833,906625,904015,69376,973391,5448
2022-08-19,San Francisco,075,870044,174648,174151,11770,185921,973
2022-08-19,San Joaquin,077,732212,193295,192738,13693,206431,2288
2022-08-19,San Luis Obispo,079,281455,61987,61764,6882,68646,516
2022-08-19,San Mateo,081,765935,164233,163705,10373,174078,738
2022-08-19,Santa Barbara,083,443738,103191,102795,6620,109415,713
2022-08-19,Santa Clara,085,1922200,421330,419723,18354,438077,2437
2022-08-19,Santa Cruz,087,273765,61386,61098,3312,64410,269
2022-08-19,Shasta,089,179085,34196,34105,7158,41263,588
2022-08-19,Sierra,091,2930,300,298,60,358,4
2022-08-19,Siskiyou,093,43540,5126,5119,3259,8378,88
2022-08-19,Solano,095,438530,102588,102355,7483,109838,457
2022-08-19,Sonoma,097,501317,104404,104090,5038,109128,511
2022-08-19,Stanislaus,099,539301,134843,134407,20442,154849,1719
2022-08-19,Sutter,101,95872,23643,23587,2426,26013,228
2022-08-19,Tehama,103,63373,13319,13289,2993,16282,209
2022-08-19,Trinity,105,12862,1369,1366,363,1729,20
2022-08-19,Tulare,107,460477,119591,119251,34609,153860,1521
2022-08-19,Tuolumne,109,53932,15155,15085,903,15988,196
2022-08-19,Ventura,111,848112,204034,203318,14748,218066,1547
2022-08-19,Yolo,113,214977,46652,46567,4213,50780,333
2022-08-19,Yuba,115,75493,18414,18363,1640,20003,129
2022-08-18,Alameda,001,1643700,338422,337238,19658,356896,1970
2022-08-18,Alpine,003,1148,131,131,1,132,0
2022-08-18,Amador,005,37829,9785,9761,892,10653,89
2022-08-18,Butte,007,227075,38451,38316,8631,46947,449
2022-08-18,Calaveras,009,45235,8332,8313,503,8816,132
2022-08-18,Colusa,011,21464,3725,3718,1217,4935,22
2022-08-18,Contra Costa,013,1133247,242492,241665,19793,261458,1399
2022-08-18,Del Norte,015,27424,7295,7290,390,7680,55
2022-08-18,El Dorado,017,186661,31669,31600,4134,35734,225
2022-08-18,Fresno,019,978130,268728,268147,28916,297063,2822
2022-08-18,Glenn,021,27897,5424,5413,1837,7250,48
2022-08-18,Humboldt,023,135768,21177,21104,4732,25836,153
2022-08-18,Imperial,025,180216,64227,64092,15022,79114,951
2022-08-18,Inyo,027,18085,4441,4435,869,5304,59
2022-08-18,Kern,029,883053,215113,214656,56250,270906,2389
2022-08-18,Kings,031,150075,58226,58109,3955,62064,454
2022-08-18,Lake,033,64148,12450,12426,1118,13544,142
2022-08-18,Lassen,035,31185,9863,9843,972,10815,64
2022-08-18,Los Angeles,037,10098052,3210457,3200023,171929,3371952,32746
2022-08-18,Madera,039,155013,42939,42822,7865,50687,372
2022-08-18,Marin,041,260295,44040,43966,5102,49068,305
2022-08-18,Mariposa,043,17540,3009,3003,328,3331,31
2022-08-18,Mendocino,045,87422,15613,15578,4251,19829,134
2022-08-18,Merced,047,269075,70639,70449,11050,81499,846
2022-08-18,Modoc,049,8938,864,862,315,1177,11
2022-08-18,Mono,051,14174,3179,3177,238,3415,7
2022-08-18,Monterey,053,433212,92538,92287,20289,112576,760
2022-08-18,Napa,055,140530,31575,31534,1387,32921,156
2022-08-18,Nevada,057,99092,18552,18497,1725,20222,132
2022-08-18,Orange,059,3164182,654267,652703,58867,711570,7280
2022-08-18,Placer,061,380077,74174,74027,9178,83205,657
2022-08-18,Plumas,063,18699,3555,3550,430,3980,13
2022-08-18,Riverside,065,2383286,681273,679298,34082,713380,6574
2022-08-18,Sacramento,067,1510023,338629,337745,32535,370280,3208
2022-08-18,San Benito,069,59416,15731,15698,916,16614,103
2022-08-18,San Bernardino,071,2135413,651422,648583,29465,678048,8014
2022-08-18,San Diego,073,3302833,905985,904015,69305,973320,5448
2022-08-18,San Francisco,075,870044,174514,174151,11748,185899,973
2022-08-18,San Joaquin,077,732212,193144,192738,13671,206409,2288
2022-08-18,San Luis Obispo,079,281455,61950,61764,6869,68633,516
2022-08-18,San Mateo,081,765935,164065,163705,10365,174070,738
2022-08-18,Santa Barbara,083,443738,103091,102795,6609,109404,713
2022-08-18,Santa Clara,085,1922200,420937,419723,18335,438058,2437
2022-08-18,Santa Cruz,087,273765,61319,61098,3307,64405,269
2022-08-18,Shasta,089,179085,34177,34105,7155,41260,588
2022-08-18,Sierra,091,2930,300,298,60,358,4
2022-08-18,Siskiyou,093,43540,5124,5119,3257,8376,88
2022-08-18,Solano,095,438530,102518,102355,7478,109833,457
2022-08-18,Sonoma,097,501317,104323,104090,5030,109120,511
2022-08-18,Stanislaus,099,539301,134729,134407,20421,154828,1719
2022-08-18,Sutter,101,95872,23623,23587,2425,26012,228
2022-08-18,Tehama,103,63373,13313,13289,2991,16280,209
2022-08-18,Trinity,105,12862,1369,1366,361,1727,20
2022-08-18,Tulare,107,460477,119521,119251,34538,153789,1521
2022-08-18,Tuolumne,109,53932,15116,15085,899,15984,196
2022-08-18,Ventura,111,848112,203880,203318,14707,218025,1547
2022-08-18,Yolo,113,214977,46632,46567,4212,50779,333
2022-08-18,Yuba,115,75493,18395,18363,1637,20000,129
2022-08-17,Alameda,001,1643700,338109,336198,19628,355826,1948
2022-08-17,Alpine,003,1148,131,131,1,132,0
2022-08-17,Amador,005,37829,9777,9728,892,10620,89
2022-08-17,Butte,007,227075,38415,38203,8622,46825,447
2022-08-17,Calaveras,009,45235,8325,8295,500,8795,131
2022-08-17,Colusa,011,21464,3723,3716,1216,4932,22
2022-08-17,Contra Costa,013,1133247,242278,240894,19761,260655,1394
2022-08-17,Del Norte,015,27424,7292,7274,390,7664,55
2022-08-17,El Dorado,017,186661,31655,31523,4130,35653,225
2022-08-17,Fresno,019,978130,268514,267367,28869,296236,2818
2022-08-17,Glenn,021,27897,5423,5403,1834,7237,48
2022-08-17,Humboldt,023,135768,21155,21029,4720,25749,153
2022-08-17,Imperial,025,180216,64189,63972,14997,78969,950
2022-08-17,Inyo,027,18085,4439,4421,866,5287,58
2022-08-17,Kern,029,883053,214993,214040,56182,270222,2389
2022-08-17,Kings,031,150075,58164,57948,3951,61899,454
2022-08-17,Lake,033,64148,12440,12383,1117,13500,142
2022-08-17,Lassen,035,31185,9854,9813,972,10785,64
2022-08-17,Los Angeles,037,10098052,3207710,3190808,171642,3362450,32701
2022-08-17,Madera,039,155013,42894,42677,7826,50503,372
2022-08-17,Marin,041,260295,44014,43852,5097,48949,305
2022-08-17,Mariposa,043,17540,3005,2998,327,3325,31
2022-08-17,Mendocino,045,87422,15601,15504,4246,19750,132
2022-08-17,Merced,047,269075,70584,70232,11009,81241,843
2022-08-17,Modoc,049,8938,863,857,315,1172,11
2022-08-17,Mono,051,14174,3178,3175,238,3413,7
2022-08-17,Monterey,053,433212,92484,91984,20239,112223,759
2022-08-17,Napa,055,140530,31561,31454,1384,32838,155
2022-08-17,Nevada,057,99092,18536,18443,1723,20166,132
2022-08-17,Orange,059,3164182,653667,650827,58767,709594,7266
2022-08-17,Placer,061,380077,74128,73852,9171,83023,655
2022-08-17,Plumas,063,18699,3553,3544,429,3973,13
2022-08-17,Riverside,065,2383286,680687,677437,34017,711454,6562
2022-08-17,Sacramento,067,1510023,338307,336667,32495,369162,3194
2022-08-17,San Benito,069,59416,15715,15655,915,16570,103
2022-08-17,San Bernardino,071,2135413,650849,646584,29418,676002,7999
2022-08-17,San Diego,073,3302833,905279,901794,69237,971031,5442
2022-08-17,San Francisco,075,870044,174387,173590,11739,185329,971
2022-08-17,San Joaquin,077,732212,193007,192078,13641,205719,2283
2022-08-17,San Luis Obispo,079,281455,61904,61604,6857,68461,514
2022-08-17,San Mateo,081,765935,163974,163218,10356,173574,738
2022-08-17,Santa Barbara,083,443738,102996,102430,6593,109023,712
2022-08-17,Santa Clara,085,1922200,420498,418231,18327,436558,2424
2022-08-17,Santa Cruz,087,273765,61233,60880,3302,64182,269
2022-08-17,Shasta,089,179085,34160,33984,7146,41130,587
2022-08-17,Sierra,091,2930,300,297,60,357,4
2022-08-17,Siskiyou,093,43540,5122,5102,3253,8355,88
2022-08-17,Solano,095,438530,102437,102115,7472,109587,459
2022-08-17,Sonoma,097,501317,104223,103844,5025,108869,504
2022-08-17,Stanislaus,099,539301,134598,133989,20382,154371,1715
2022-08-17,Sutter,101,95872,23589,23489,2419,25908,228
2022-08-17,Tehama,103,63373,13309,13259,2990,16249,209
2022-08-17,Trinity,105,12862,1369,1362,359,1721,20
2022-08-17,Tulare,107,460477,119420,118997,34450,153447,1521
2022-08-17,Tuolumne,109,53932,15109,15044,897,15941,196
2022-08-17,Ventura,111,848112,203726,202609,14656,217265,1546
2022-08-17,Yolo,113,214977,46601,46414,4207,50621,331
2022-08-17,Yuba,115,75493,18376,18305,1632,19937,129
2022-08-16,Alameda,001,1643700,337758,336198,19610,355808,1948
2022-08-16,Alpine,003,1148,131,131,1,132,0
2022-08-16,Amador,005,37829,9764,9728,887,10615,89
2022-08-16,Butte,007,227075,38385,38203,8607,46810,447
2022-08-16,Calaveras,009,45235,8319,8295,500,8795,131
2022-08-16,Colusa,011,21464,3722,3716,1215,4931,22
2022-08-16,Contra Costa,013,1133247,242054,240894,19721,260615,1394
2022-08-16,Del Norte,015,27424,7287,7274,390,7664,55
2022-08-16,El Dorado,017,186661,31639,31523,4124,35647,225
2022-08-16,Fresno,019,978130,268280,267367,28838,296205,2818
2022-08-16,Glenn,021,27897,5422,5403,1831,7234,48
2022-08-16,Humboldt,023,135768,21128,21029,4696,25725,153
2022-08-16,Imperial,025,180216,64149,63972,14963,78935,950
2022-08-16,Inyo,027,18085,4436,4421,862,5283,58
2022-08-16,Kern,029,883053,214868,214040,56130,270170,2389
2022-08-16,Kings,031,150075,58114,57948,3948,61896,454
2022-08-16,Lake,033,64148,12425,12383,1113,13496,142
2022-08-16,Lassen,035,31185,9841,9813,971,10784,64
2022-08-16,Los Angeles,037,10098052,3204849,3190808,171336,3362144,32701
2022-08-16,Madera,039,155013,42838,42677,7806,50483,372
2022-08-16,Marin,041,260295,43980,43852,5089,48941,305
2022-08-16,Mariposa,043,17540,3004,2998,326,3324,31
2022-08-16,Mendocino,045,87422,15583,15504,4233,19737,132
2022-08-16,Merced,047,269075,70511,70232,10968,81200,843
2022-08-16,Modoc,049,8938,863,857,315,1172,11
2022-08-16,Mono,051,14174,3177,3175,237,3412,7
2022-08-16,Monterey,053,433212,92405,91984,20171,112155,759
2022-08-16,Napa,055,140530,31544,31454,1384,32838,155
2022-08-16,Nevada,057,99092,18520,18443,1719,20162,132
2022-08-16,Orange,059,3164182,653012,650827,58650,709477,7266
2022-08-16,Placer,061,380077,74061,73852,9167,83019,655
2022-08-16,Plumas,063,18699,3552,3544,429,3973,13
2022-08-16,Riverside,065,2383286,680028,677437,33967,711404,6562
2022-08-16,Sacramento,067,1510023,337979,336667,32464,369131,3194
2022-08-16,San Benito,069,59416,15702,15655,911,16566,103
2022-08-16,San Bernardino,071,2135413,650169,646584,29362,675946,7999
2022-08-16,San Diego,073,3302833,904479,901794,69145,970939,5442
2022-08-16,San Francisco,075,870044,174232,173590,11734,185324,971
2022-08-16,San Joaquin,077,732212,192801,192078,13614,205692,2283
2022-08-16,San Luis Obispo,079,281455,61866,61604,6851,68455,514
2022-08-16,San Mateo,081,765935,163818,163218,10343,173561,738
2022-08-16,Santa Barbara,083,443738,102879,102430,6570,109000,712
2022-08-16,Santa Clara,085,1922200,420042,418231,18302,436533,2424
2022-08-16,Santa Cruz,087,273765,61183,60880,3297,64177,269
2022-08-16,Shasta,089,179085,34137,33984,7138,41122,587
2022-08-16,Sierra,091,2930,299,297,60,357,4
2022-08-16,Siskiyou,093,43540,5118,5102,3248,8350,88
2022-08-16,Solano,095,438530,102365,102115,7456,109571,459
2022-08-16,Sonoma,097,501317,104124,103844,5016,108860,504
2022-08-16,Stanislaus,099,539301,134468,133989,20328,154317,1715
2022-08-16,Sutter,101,95872,23564,23489,2414,25903,228
2022-08-16,Tehama,103,63373,13305,13259,2985,16244,209
2022-08-16,Trinity,105,12862,1367,1362,359,1721,20
2022-08-16,Tulare,107,460477,119346,118997,34352,153349,1521
2022-08-16,Tuolumne,109,53932,15097,15044,897,15941,196
2022-08-16,Ventura,111,848112,203512,202609,14603,217212,1546
2022-08-16,Yolo,113,214977,46583,46414,4204,50618,331
2022-08-16,Yuba,115,75493,18358,18305,1626,19931,129
2022-08-15,Alameda,001,1643700,337394,336198,19579,355777,1948
2022-08-15,Alpine,003,1148,131,131,1,132,0
2022-08-15,Amador,005,37829,9752,9728,887,10615,89
2022-08-15,Butte,007,227075,38364,38203,8587,46790,447
2022-08-15,Calaveras,009,45235,8317,8295,499,8794,131
2022-08-15,Colusa,011,21464,3720,3716,1215,4931,22
2022-08-15,Contra Costa,013,1133247,241777,240894,19687,260581,1394
2022-08-15,Del Norte,015,27424,7282,7274,388,7662,55
2022-08-15,El Dorado,017,186661,31611,31523,4117,35640,225
2022-08-15,Fresno,019,978130,267991,267367,28785,296152,2818
2022-08-15,Glenn,021,27897,5414,5403,1830,7233,48
2022-08-15,Humboldt,023,135768,21109,21029,4674,25703,153
2022-08-15,Imperial,025,180216,64102,63972,14927,78899,950
2022-08-15,Inyo,027,18085,4435,4421,860,5281,58
2022-08-15,Kern,029,883053,214691,214040,56068,270108,2389
2022-08-15,Kings,031,150075,58039,57948,3939,61887,454
2022-08-15,Lake,033,64148,12409,12383,1111,13494,142
2022-08-15,Lassen,035,31185,9840,9813,971,10784,64
2022-08-15,Los Angeles,037,10098052,3201661,3190808,171045,3361853,32701
2022-08-15,Madera,039,155013,42787,42677,7765,50442,372
2022-08-15,Marin,041,260295,43939,43852,5085,48937,305
2022-08-15,Mariposa,043,17540,3002,2998,325,3323,31
2022-08-15,Mendocino,045,87422,15566,15504,4226,19730,132
2022-08-15,Merced,047,269075,70449,70232,10918,81150,843
2022-08-15,Modoc,049,8938,859,857,315,1172,11
2022-08-15,Mono,051,14174,3176,3175,237,3412,7
2022-08-15,Monterey,053,433212,92297,91984,20097,112081,759
2022-08-15,Napa,055,140530,31518,31454,1384,32838,155
2022-08-15,Nevada,057,99092,18507,18443,1718,20161,132
2022-08-15,Orange,059,3164182,652310,650827,58536,709363,7266
2022-08-15,Placer,061,380077,74006,73852,9159,83011,655
2022-08-15,Plumas,063,18699,3549,3544,429,3973,13
2022-08-15,Riverside,065,2383286,679275,677437,33905,711342,6562
2022-08-15,Sacramento,067,1510023,337584,336667,32430,369097,3194
2022-08-15,San Benito,069,59416,15686,15655,909,16564,103
2022-08-15,San Bernardino,071,2135413,649380,646584,29291,675875,7999
2022-08-15,San Diego,073,3302833,903650,901794,69030,970824,5442
2022-08-15,San Francisco,075,870044,174058,173590,11730,185320,971
2022-08-15,San Joaquin,077,732212,192605,192078,13576,205654,2283
2022-08-15,San Luis Obispo,079,281455,61829,61604,6833,68437,514
2022-08-15,San Mateo,081,765935,163621,163218,10337,173555,738
2022-08-15,Santa Barbara,083,443738,102787,102430,6547,108977,712
2022-08-15,Santa Clara,085,1922200,419527,418231,18274,436505,2424
2022-08-15,Santa Cruz,087,273765,61104,60880,3291,64171,269
2022-08-15,Shasta,089,179085,34112,33984,7128,41112,587
2022-08-15,Sierra,091,2930,299,297,60,357,4
2022-08-15,Siskiyou,093,43540,5115,5102,3246,8348,88
2022-08-15,Solano,095,438530,102261,102115,7442,109557,459
2022-08-15,Sonoma,097,501317,104034,103844,5008,108852,504
2022-08-15,Stanislaus,099,539301,134330,133989,20295,154284,1715
2022-08-15,Sutter,101,95872,23534,23489,2412,25901,228
2022-08-15,Tehama,103,63373,13298,13259,2981,16240,209
2022-08-15,Trinity,105,12862,1364,1362,357,1719,20
2022-08-15,Tulare,107,460477,119217,118997,34239,153236,1521
2022-08-15,Tuolumne,109,53932,15089,15044,897,15941,196
2022-08-15,Ventura,111,848112,203272,202609,14540,217149,1546
2022-08-15,Yolo,113,214977,46548,46414,4203,50617,331
2022-08-15,Yuba,115,75493,18335,18305,1620,19925,129
2022-08-14,Alameda,001,1643700,336946,334944,19553,354497,1948
2022-08-14,Alpine,003,1148,131,131,1,132,0
2022-08-14,Amador,005,37829,9743,9705,885,10590,89
2022-08-14,Butte,007,227075,38314,38062,8571,46633,447
2022-08-14,Calaveras,009,45235,8308,8271,498,8769,131
2022-08-14,Colusa,011,21464,3719,3704,1212,4916,22
2022-08-14,Contra Costa,013,1133247,241506,239735,19631,259366,1393
2022-08-14,Del Norte,015,27424,7274,7245,386,7631,54
2022-08-14,El Dorado,017,186661,31582,31430,4112,35542,225
2022-08-14,Fresno,019,978130,267702,266211,28745,294956,2816
2022-08-14,Glenn,021,27897,5410,5393,1829,7222,48
2022-08-14,Humboldt,023,135768,21080,20954,4659,25613,153
2022-08-14,Imperial,025,180216,64041,63766,14883,78649,950
2022-08-14,Inyo,027,18085,4427,4418,856,5274,58
2022-08-14,Kern,029,883053,214517,213071,55988,269059,2380
2022-08-14,Kings,031,150075,57985,57748,3934,61682,454
2022-08-14,Lake,033,64148,12391,12324,1108,13432,142
2022-08-14,Lassen,035,31185,9820,9795,970,10765,64
2022-08-14,Los Angeles,037,10098052,3198393,3177769,170687,3348456,32657
2022-08-14,Madera,039,155013,42725,42517,7721,50238,372
2022-08-14,Marin,041,260295,43895,43662,5080,48742,305
2022-08-14,Mariposa,043,17540,3000,2986,324,3310,31
2022-08-14,Mendocino,045,87422,15547,15456,4219,19675,132
2022-08-14,Merced,047,269075,70346,69974,10855,80829,842
2022-08-14,Modoc,049,8938,858,856,315,1171,11
2022-08-14,Mono,051,14174,3176,3170,236,3406,7
2022-08-14,Monterey,053,433212,92176,91612,20024,111636,759
2022-08-14,Napa,055,140530,31480,31312,1382,32694,156
2022-08-14,Nevada,057,99092,18486,18398,1716,20114,132
2022-08-14,Orange,059,3164182,651591,648171,58395,706566,7248
2022-08-14,Placer,061,380077,73950,73588,9143,82731,656
2022-08-14,Plumas,063,18699,3546,3539,429,3968,13
2022-08-14,Riverside,065,2383286,678503,674362,33816,708178,6561
2022-08-14,Sacramento,067,1510023,337108,335292,32381,367673,3190
2022-08-14,San Benito,069,59416,15664,15578,899,16477,103
2022-08-14,San Bernardino,071,2135413,648547,643895,29218,673113,7983
2022-08-14,San Diego,073,3302833,902769,898646,68932,967578,5437
2022-08-14,San Francisco,075,870044,173847,172876,11716,184592,955
2022-08-14,San Joaquin,077,732212,192316,191272,13514,204786,2283
2022-08-14,San Luis Obispo,079,281455,61765,61403,6805,68208,512
2022-08-14,San Mateo,081,765935,163420,162531,10323,172854,738
2022-08-14,Santa Barbara,083,443738,102650,101942,6521,108463,712
2022-08-14,Santa Clara,085,1922200,418964,416369,18237,434606,2422
2022-08-14,Santa Cruz,087,273765,61000,60594,3284,63878,273
2022-08-14,Shasta,089,179085,34069,33895,7116,41011,584
2022-08-14,Sierra,091,2930,299,296,60,356,4
2022-08-14,Siskiyou,093,43540,5108,5086,3244,8330,88
2022-08-14,Solano,095,438530,102123,101761,7432,109193,458
2022-08-14,Sonoma,097,501317,103934,103496,4994,108490,504
2022-08-14,Stanislaus,099,539301,134149,133490,20241,153731,1702
2022-08-14,Sutter,101,95872,23490,23386,2409,25795,228
2022-08-14,Tehama,103,63373,13292,13213,2979,16192,209
2022-08-14,Trinity,105,12862,1363,1356,357,1713,20
2022-08-14,Tulare,107,460477,119073,118563,34118,152681,1520
2022-08-14,Tuolumne,109,53932,15069,14964,896,15860,196
2022-08-14,Ventura,111,848112,203015,201765,14495,216260,1541
2022-08-14,Yolo,113,214977,46504,46225,4198,50423,331
2022-08-14,Yuba,115,75493,18314,18232,1616,19848,129
2022-08-13,Alameda,001,1643700,336700,334944,19539,354483,1948
2022-08-13,Alpine,003,1148,131,131,1,132,0
2022-08-13,Amador,005,37829,9739,9705,885,10590,89
2022-08-13,Butte,007,227075,38290,38062,8560,46622,447
2022-08-13,Calaveras,009,45235,8305,8271,497,8768,131
2022-08-13,Colusa,011,21464,3717,3704,1212,4916,22
2022-08-13,Contra Costa,013,1133247,241343,239735,19605,259340,1393
2022-08-13,Del Norte,015,27424,7272,7245,386,7631,54
2022-08-13,El Dorado,017,186661,31574,31430,4111,35541,225
2022-08-13,Fresno,019,978130,267564,266211,28731,294942,2816
2022-08-13,Glenn,021,27897,5410,5393,1827,7220,48
2022-08-13,Humboldt,023,135768,21065,20954,4649,25603,153
2022-08-13,Imperial,025,180216,63999,63766,14863,78629,950
2022-08-13,Inyo,027,18085,4425,4418,855,5273,58
2022-08-13,Kern,029,883053,214433,213071,55963,269034,2380
2022-08-13,Kings,031,150075,57960,57748,3933,61681,454
2022-08-13,Lake,033,64148,12380,12324,1108,13432,142
2022-08-13,Lassen,035,31185,9814,9795,969,10764,64
2022-08-13,Los Angeles,037,10098052,3196775,3177769,170452,3348221,32657
2022-08-13,Madera,039,155013,42709,42517,7714,50231,372
2022-08-13,Marin,041,260295,43876,43662,5077,48739,305
2022-08-13,Mariposa,043,17540,3000,2986,323,3309,31
2022-08-13,Mendocino,045,87422,15536,15456,4216,19672,132
2022-08-13,Merced,047,269075,70307,69974,10851,80825,842
2022-08-13,Modoc,049,8938,858,856,315,1171,11
2022-08-13,Mono,051,14174,3176,3170,235,3405,7
2022-08-13,Monterey,053,433212,92114,91612,19987,111599,759
2022-08-13,Napa,055,140530,31468,31312,1380,32692,156
2022-08-13,Nevada,057,99092,18475,18398,1715,20113,132
2022-08-13,Orange,059,3164182,651204,648171,58319,706490,7248
2022-08-13,Placer,061,380077,73902,73588,9139,82727,656
2022-08-13,Plumas,063,18699,3546,3539,429,3968,13
2022-08-13,Riverside,065,2383286,678089,674362,33784,708146,6561
2022-08-13,Sacramento,067,1510023,336917,335292,32371,367663,3190
2022-08-13,San Benito,069,59416,15659,15578,893,16471,103
2022-08-13,San Bernardino,071,2135413,648106,643895,29191,673086,7983
2022-08-13,San Diego,073,3302833,902341,898646,68892,967538,5437
2022-08-13,San Francisco,075,870044,173732,172876,11710,184586,955
2022-08-13,San Joaquin,077,732212,192195,191272,13493,204765,2283
2022-08-13,San Luis Obispo,079,281455,61744,61403,6800,68203,512
2022-08-13,San Mateo,081,765935,163313,162531,10310,172841,738
2022-08-13,Santa Barbara,083,443738,102577,101942,6503,108445,712
2022-08-13,Santa Clara,085,1922200,418652,416369,18219,434588,2422
2022-08-13,Santa Cruz,087,273765,60962,60594,3278,63872,273
2022-08-13,Shasta,089,179085,34031,33895,7112,41007,584
2022-08-13,Sierra,091,2930,299,296,60,356,4
2022-08-13,Siskiyou,093,43540,5106,5086,3241,8327,88
2022-08-13,Solano,095,438530,102084,101761,7424,109185,458
2022-08-13,Sonoma,097,501317,103886,103496,4993,108489,504
2022-08-13,Stanislaus,099,539301,134053,133490,20223,153713,1702
2022-08-13,Sutter,101,95872,23475,23386,2409,25795,228
2022-08-13,Tehama,103,63373,13288,13213,2978,16191,209
2022-08-13,Trinity,105,12862,1362,1356,357,1713,20
2022-08-13,Tulare,107,460477,119004,118563,34062,152625,1520
2022-08-13,Tuolumne,109,53932,15056,14964,891,15855,196
2022-08-13,Ventura,111,848112,202855,201765,14480,216245,1541
2022-08-13,Yolo,113,214977,46475,46225,4193,50418,331
2022-08-13,Yuba,115,75493,18305,18232,1614,19846,129
2022-08-12,Alameda,001,1643700,336457,334944,19525,354469,1948
2022-08-12,Alpine,003,1148,131,131,1,132,0
2022-08-12,Amador,005,37829,9729,9705,882,10587,89
2022-08-12,Butte,007,227075,38270,38062,8553,46615,447
2022-08-12,Calaveras,009,45235,8297,8271,494,8765,131
2022-08-12,Colusa,011,21464,3714,3704,1212,4916,22
2022-08-12,Contra Costa,013,1133247,241177,239735,19587,259322,1393
2022-08-12,Del Norte,015,27424,7268,7245,386,7631,54
2022-08-12,El Dorado,017,186661,31557,31430,4107,35537,225
2022-08-12,Fresno,019,978130,267363,266211,28718,294929,2816
2022-08-12,Glenn,021,27897,5410,5393,1827,7220,48
2022-08-12,Humboldt,023,135768,21046,20954,4642,25596,153
2022-08-12,Imperial,025,180216,63972,63766,14850,78616,950
2022-08-12,Inyo,027,18085,4424,4418,853,5271,58
2022-08-12,Kern,029,883053,214339,213071,55930,269001,2380
2022-08-12,Kings,031,150075,57939,57748,3930,61678,454
2022-08-12,Lake,033,64148,12377,12324,1105,13429,142
2022-08-12,Lassen,035,31185,9812,9795,969,10764,64
2022-08-12,Los Angeles,037,10098052,3194835,3177769,170226,3347995,32657
2022-08-12,Madera,039,155013,42678,42517,7708,50225,372
2022-08-12,Marin,041,260295,43847,43662,5070,48732,305
2022-08-12,Mariposa,043,17540,3000,2986,323,3309,31
2022-08-12,Mendocino,045,87422,15525,15456,4208,19664,132
2022-08-12,Merced,047,269075,70275,69974,10845,80819,842
2022-08-12,Modoc,049,8938,858,856,315,1171,11
2022-08-12,Mono,051,14174,3176,3170,235,3405,7
2022-08-12,Monterey,053,433212,92057,91612,19955,111567,759
2022-08-12,Napa,055,140530,31448,31312,1379,32691,156
2022-08-12,Nevada,057,99092,18471,18398,1713,20111,132
2022-08-12,Orange,059,3164182,650789,648171,58229,706400,7248
2022-08-12,Placer,061,380077,73851,73588,9129,82717,656
2022-08-12,Plumas,063,18699,3544,3539,429,3968,13
2022-08-12,Riverside,065,2383286,677688,674362,33752,708114,6561
2022-08-12,Sacramento,067,1510023,336701,335292,32354,367646,3190
2022-08-12,San Benito,069,59416,15642,15578,892,16470,103
2022-08-12,San Bernardino,071,2135413,647719,643895,29174,673069,7983
2022-08-12,San Diego,073,3302833,901817,898646,68813,967459,5437
2022-08-12,San Francisco,075,870044,173611,172876,11700,184576,955
2022-08-12,San Joaquin,077,732212,192079,191272,13475,204747,2283
2022-08-12,San Luis Obispo,079,281455,61727,61403,6792,68195,512
2022-08-12,San Mateo,081,765935,163189,162531,10304,172835,738
2022-08-12,Santa Barbara,083,443738,102509,101942,6497,108439,712
2022-08-12,Santa Clara,085,1922200,418313,416369,18199,434568,2422
2022-08-12,Santa Cruz,087,273765,60909,60594,3276,63870,273
2022-08-12,Shasta,089,179085,34018,33895,7104,40999,584
2022-08-12,Sierra,091,2930,297,296,59,355,4
2022-08-12,Siskiyou,093,43540,5103,5086,3241,8327,88
2022-08-12,Solano,095,438530,102011,101761,7413,109174,458
2022-08-12,Sonoma,097,501317,103829,103496,4992,108488,504
2022-08-12,Stanislaus,099,539301,133969,133490,20210,153700,1702
2022-08-12,Sutter,101,95872,23460,23386,2409,25795,228
2022-08-12,Tehama,103,63373,13280,13213,2977,16190,209
2022-08-12,Trinity,105,12862,1359,1356,356,1712,20
2022-08-12,Tulare,107,460477,118947,118563,34003,152566,1520
2022-08-12,Tuolumne,109,53932,15049,14964,890,15854,196
2022-08-12,Ventura,111,848112,202716,201765,14464,216229,1541
2022-08-12,Yolo,113,214977,46453,46225,4189,50414,331
2022-08-12,Yuba,115,75493,18294,18232,1613,19845,129
2022-08-11,Alameda,001,1643700,336139,334944,19492,354436,1948
2022-08-11,Alpine,003,1148,131,131,1,132,0
2022-08-11,Amador,005,37829,9726,9705,879,10584,89
2022-08-11,Butte,007,227075,38235,38062,8544,46606,447
2022-08-11,Calaveras,009,45235,8292,8271,492,8763,131
2022-08-11,Colusa,011,21464,3712,3704,1211,4915,22
2022-08-11,Contra Costa,013,1133247,240930,239735,19552,259287,1393
2022-08-11,Del Norte,015,27424,7261,7245,384,7629,54
2022-08-11,El Dorado,017,186661,31528,31430,4099,35529,225
2022-08-11,Fresno,019,978130,267115,266211,28678,294889,2816
2022-08-11,Glenn,021,27897,5408,5393,1826,7219,48
2022-08-11,Humboldt,023,135768,21017,20954,4633,25587,153
2022-08-11,Imperial,025,180216,63929,63766,14805,78571,950
2022-08-11,Inyo,027,18085,4423,4418,847,5265,58
2022-08-11,Kern,029,883053,214166,213071,55865,268936,2380
2022-08-11,Kings,031,150075,57882,57748,3923,61671,454
2022-08-11,Lake,033,64148,12367,12324,1104,13428,142
2022-08-11,Lassen,035,31185,9807,9795,969,10764,64
2022-08-11,Los Angeles,037,10098052,3192031,3177769,169896,3347665,32657
2022-08-11,Madera,039,155013,42632,42517,7680,50197,372
2022-08-11,Marin,041,260295,43808,43662,5066,48728,305
2022-08-11,Mariposa,043,17540,3000,2986,320,3306,31
2022-08-11,Mendocino,045,87422,15514,15456,4205,19661,132
2022-08-11,Merced,047,269075,70224,69974,10809,80783,842
2022-08-11,Modoc,049,8938,857,856,315,1171,11
2022-08-11,Mono,051,14174,3176,3170,235,3405,7
2022-08-11,Monterey,053,433212,91960,91612,19902,111514,759
2022-08-11,Napa,055,140530,31412,31312,1377,32689,156
2022-08-11,Nevada,057,99092,18452,18398,1709,20107,132
2022-08-11,Orange,059,3164182,650147,648171,58107,706278,7248
2022-08-11,Placer,061,380077,73790,73588,9120,82708,656
2022-08-11,Plumas,063,18699,3543,3539,429,3968,13
2022-08-11,Riverside,065,2383286,677110,674362,33707,708069,6561
2022-08-11,Sacramento,067,1510023,336389,335292,32322,367614,3190
2022-08-11,San Benito,069,59416,15627,15578,891,16469,103
2022-08-11,San Bernardino,071,2135413,647017,643895,29123,673018,7983
2022-08-11,San Diego,073,3302833,901060,898646,68689,967335,5437
2022-08-11,San Francisco,075,870044,173464,172876,11684,184560,955
2022-08-11,San Joaquin,077,732212,191890,191272,13450,204722,2283
2022-08-11,San Luis Obispo,079,281455,61688,61403,6766,68169,512
2022-08-11,San Mateo,081,765935,163032,162531,10291,172822,738
2022-08-11,Santa Barbara,083,443738,102408,101942,6475,108417,712
2022-08-11,Santa Clara,085,1922200,417880,416369,18177,434546,2422
2022-08-11,Santa Cruz,087,273765,60845,60594,3272,63866,273
2022-08-11,Shasta,089,179085,34000,33895,7090,40985,584
2022-08-11,Sierra,091,2930,296,296,59,355,4
2022-08-11,Siskiyou,093,43540,5100,5086,3237,8323,88
2022-08-11,Solano,095,438530,101944,101761,7401,109162,458
2022-08-11,Sonoma,097,501317,103735,103496,4985,108481,504
2022-08-11,Stanislaus,099,539301,133815,133490,20171,153661,1702
2022-08-11,Sutter,101,95872,23429,23386,2409,25795,228
2022-08-11,Tehama,103,63373,13272,13213,2977,16190,209
2022-08-11,Trinity,105,12862,1359,1356,355,1711,20
2022-08-11,Tulare,107,460477,118847,118563,33915,152478,1520
2022-08-11,Tuolumne,109,53932,15041,14964,888,15852,196
2022-08-11,Ventura,111,848112,202529,201765,14427,216192,1541
2022-08-11,Yolo,113,214977,46420,46225,4185,50410,331
2022-08-11,Yuba,115,75493,18271,18232,1610,19842,129
2022-08-10,Alameda,001,1643700,335746,333587,19469,353056,1944
2022-08-10,Alpine,003,1148,131,131,1,132,0
2022-08-10,Amador,005,37829,9721,9677,876,10553,88
2022-08-10,Butte,007,227075,38202,37892,8533,46425,446
2022-08-10,Calaveras,009,45235,8286,8251,489,8740,130
2022-08-10,Colusa,011,21464,3708,3700,1211,4911,22
2022-08-10,Contra Costa,013,1133247,240679,238658,19512,258170,1382
2022-08-10,Del Norte,015,27424,7256,7220,384,7604,54
2022-08-10,El Dorado,017,186661,31503,31354,4084,35438,225
2022-08-10,Fresno,019,978130,266849,265300,28622,293922,2815
2022-08-10,Glenn,021,27897,5406,5387,1823,7210,48
2022-08-10,Humboldt,023,135768,21004,20843,4615,25458,153
2022-08-10,Imperial,025,180216,63869,63532,14761,78293,949
2022-08-10,Inyo,027,18085,4423,4416,846,5262,57
2022-08-10,Kern,029,883053,213994,212602,55823,268425,2380
2022-08-10,Kings,031,150075,57836,57569,3922,61491,453
2022-08-10,Lake,033,64148,12352,12281,1104,13385,142
2022-08-10,Lassen,035,31185,9800,9682,969,10651,64
2022-08-10,Los Angeles,037,10098052,3188969,3168105,169567,3337672,32609
2022-08-10,Madera,039,155013,42595,42350,7665,50015,372
2022-08-10,Marin,041,260295,43761,43532,5064,48596,302
2022-08-10,Mariposa,043,17540,2999,2980,320,3300,31
2022-08-10,Mendocino,045,87422,15500,15394,4203,19597,132
2022-08-10,Merced,047,269075,70153,69740,10786,80526,839
2022-08-10,Modoc,049,8938,857,855,314,1169,11
2022-08-10,Mono,051,14174,3174,3165,235,3400,7
2022-08-10,Monterey,053,433212,91859,91307,19839,111146,758
2022-08-10,Napa,055,140530,31376,31223,1375,32598,153
2022-08-10,Nevada,057,99092,18438,18354,1707,20061,132
2022-08-10,Orange,059,3164182,649436,646005,57983,703988,7235
2022-08-10,Placer,061,380077,73737,73348,9114,82462,650
2022-08-10,Plumas,063,18699,3541,3525,429,3954,13
2022-08-10,Riverside,065,2383286,676405,672334,33647,705981,6555
2022-08-10,Sacramento,067,1510023,336056,334382,32295,366677,3177
2022-08-10,San Benito,069,59416,15598,15507,884,16391,101
2022-08-10,San Bernardino,071,2135413,646399,641936,29072,671008,7977
2022-08-10,San Diego,073,3302833,900213,895482,68580,964062,5429
2022-08-10,San Francisco,075,870044,173307,172265,11668,183933,945
2022-08-10,San Joaquin,077,732212,191669,190596,13413,204009,2281
2022-08-10,San Luis Obispo,079,281455,61648,61207,6751,67958,510
2022-08-10,San Mateo,081,765935,162844,161882,10282,172164,738
2022-08-10,Santa Barbara,083,443738,102297,101558,6455,108013,711
2022-08-10,Santa Clara,085,1922200,417359,414659,18155,432814,2398
2022-08-10,Santa Cruz,087,273765,60765,60360,3269,63629,269
2022-08-10,Shasta,089,179085,33982,33816,7081,40897,584
2022-08-10,Sierra,091,2930,296,295,59,354,4
2022-08-10,Siskiyou,093,43540,5095,5074,3231,8305,87
2022-08-10,Solano,095,438530,101853,101393,7396,108789,457
2022-08-10,Sonoma,097,501317,103644,103168,4978,108146,501
2022-08-10,Stanislaus,099,539301,133679,133071,20139,153210,1702
2022-08-10,Sutter,101,95872,23401,23279,2407,25686,228
2022-08-10,Tehama,103,63373,13263,13187,2976,16163,209
2022-08-10,Trinity,105,12862,1358,1350,355,1705,20
2022-08-10,Tulare,107,460477,118761,118239,33840,152079,1520
2022-08-10,Tuolumne,109,53932,15006,14922,886,15808,196
2022-08-10,Ventura,111,848112,202315,201179,14390,215569,1539
2022-08-10,Yolo,113,214977,46386,46069,4177,50246,330
2022-08-10,Yuba,115,75493,18251,18179,1606,19785,129
2022-08-09,Alameda,001,1643700,335324,333587,19424,353011,1944
2022-08-09,Alpine,003,1148,131,131,1,132,0
2022-08-09,Amador,005,37829,9711,9677,875,10552,88
2022-08-09,Butte,007,227075,38165,37892,8521,46413,446
2022-08-09,Calaveras,009,45235,8280,8251,489,8740,130
2022-08-09,Colusa,011,21464,3705,3700,1210,4910,22
2022-08-09,Contra Costa,013,1133247,240405,238658,19468,258126,1382
2022-08-09,Del Norte,015,27424,7239,7220,383,7603,54
2022-08-09,El Dorado,017,186661,31475,31354,4078,35432,225
2022-08-09,Fresno,019,978130,266528,265300,28594,293894,2815
2022-08-09,Glenn,021,27897,5404,5387,1823,7210,48
2022-08-09,Humboldt,023,135768,20980,20843,4605,25448,153
2022-08-09,Imperial,025,180216,63804,63532,14702,78234,949
2022-08-09,Inyo,027,18085,4422,4416,843,5259,57
2022-08-09,Kern,029,883053,213805,212602,55758,268360,2380
2022-08-09,Kings,031,150075,57770,57569,3920,61489,453
2022-08-09,Lake,033,64148,12329,12281,1103,13384,142
2022-08-09,Lassen,035,31185,9794,9682,969,10651,64
2022-08-09,Los Angeles,037,10098052,3185436,3168105,169221,3337326,32609
2022-08-09,Madera,039,155013,42541,42350,7654,50004,372
2022-08-09,Marin,041,260295,43706,43532,5060,48592,302
2022-08-09,Mariposa,043,17540,2995,2980,319,3299,31
2022-08-09,Mendocino,045,87422,15483,15394,4193,19587,132
2022-08-09,Merced,047,269075,70089,69740,10759,80499,839
2022-08-09,Modoc,049,8938,857,855,313,1168,11
2022-08-09,Mono,051,14174,3173,3165,234,3399,7
2022-08-09,Monterey,053,433212,91747,91307,19773,111080,758
2022-08-09,Napa,055,140530,31349,31223,1373,32596,153
2022-08-09,Nevada,057,99092,18426,18354,1705,20059,132
2022-08-09,Orange,059,3164182,648624,646005,57843,703848,7235
2022-08-09,Placer,061,380077,73675,73348,9109,82457,650
2022-08-09,Plumas,063,18699,3536,3525,429,3954,13
2022-08-09,Riverside,065,2383286,675652,672334,33592,705926,6555
2022-08-09,Sacramento,067,1510023,335645,334382,32260,366642,3177
2022-08-09,San Benito,069,59416,15581,15507,879,16386,101
2022-08-09,San Bernardino,071,2135413,645752,641936,29013,670949,7977
2022-08-09,San Diego,073,3302833,899341,895482,68439,963921,5429
2022-08-09,San Francisco,075,870044,173062,172265,11649,183914,945
2022-08-09,San Joaquin,077,732212,191457,190596,13375,203971,2281
2022-08-09,San Luis Obispo,079,281455,61597,61207,6727,67934,510
2022-08-09,San Mateo,081,765935,162653,161882,10266,172148,738
2022-08-09,Santa Barbara,083,443738,102150,101558,6423,107981,711
2022-08-09,Santa Clara,085,1922200,416833,414659,18134,432793,2398
2022-08-09,Santa Cruz,087,273765,60691,60360,3260,63620,269
2022-08-09,Shasta,089,179085,33960,33816,7078,40894,584
2022-08-09,Sierra,091,2930,296,295,59,354,4
2022-08-09,Siskiyou,093,43540,5091,5074,3227,8301,87
2022-08-09,Solano,095,438530,101747,101393,7384,108777,457
2022-08-09,Sonoma,097,501317,103544,103168,4970,108138,501
2022-08-09,Stanislaus,099,539301,133539,133071,20106,153177,1702
2022-08-09,Sutter,101,95872,23370,23279,2405,25684,228
2022-08-09,Tehama,103,63373,13249,13187,2966,16153,209
2022-08-09,Trinity,105,12862,1356,1350,354,1704,20
2022-08-09,Tulare,107,460477,118646,118239,33753,151992,1520
2022-08-09,Tuolumne,109,53932,14991,14922,886,15808,196
2022-08-09,Ventura,111,848112,202083,201179,14357,215536,1539
2022-08-09,Yolo,113,214977,46342,46069,4165,50234,330
2022-08-09,Yuba,115,75493,18232,18179,1596,19775,129
2022-08-08,Alameda,001,1643700,334867,333587,19380,352967,1944
2022-08-08,Alpine,003,1148,131,131,1,132,0
2022-08-08,Amador,005,37829,9706,9677,874,10551,88
2022-08-08,Butte,007,227075,38110,37892,8506,46398,446
2022-08-08,Calaveras,009,45235,8275,8251,486,8737,130
2022-08-08,Colusa,011,21464,3705,3700,1209,4909,22
2022-08-08,Contra Costa,013,1133247,240030,238658,19420,258078,1382
2022-08-08,Del Norte,015,27424,7232,7220,382,7602,54
2022-08-08,El Dorado,017,186661,31449,31354,4071,35425,225
2022-08-08,Fresno,019,978130,266168,265300,28557,293857,2815
2022-08-08,Glenn,021,27897,5398,5387,1822,7209,48
2022-08-08,Humboldt,023,135768,20940,20843,4588,25431,153
2022-08-08,Imperial,025,180216,63743,63532,14629,78161,949
2022-08-08,Inyo,027,18085,4421,4416,842,5258,57
2022-08-08,Kern,029,883053,213556,212602,55675,268277,2380
2022-08-08,Kings,031,150075,57710,57569,3911,61480,453
2022-08-08,Lake,033,64148,12308,12281,1099,13380,142
2022-08-08,Lassen,035,31185,9781,9682,966,10648,64
2022-08-08,Los Angeles,037,10098052,3181787,3168105,168807,3336912,32609
2022-08-08,Madera,039,155013,42484,42350,7631,49981,372
2022-08-08,Marin,041,260295,43656,43532,5049,48581,302
2022-08-08,Mariposa,043,17540,2991,2980,315,3295,31
2022-08-08,Mendocino,045,87422,15469,15394,4183,19577,132
2022-08-08,Merced,047,269075,70019,69740,10732,80472,839
2022-08-08,Modoc,049,8938,856,855,313,1168,11
2022-08-08,Mono,051,14174,3173,3165,234,3399,7
2022-08-08,Monterey,053,433212,91648,91307,19693,111000,758
2022-08-08,Napa,055,140530,31314,31223,1372,32595,153
2022-08-08,Nevada,057,99092,18410,18354,1697,20051,132
2022-08-08,Orange,059,3164182,647793,646005,57682,703687,7235
2022-08-08,Placer,061,380077,73617,73348,9100,82448,650
2022-08-08,Plumas,063,18699,3533,3525,428,3953,13
2022-08-08,Riverside,065,2383286,674858,672334,33538,705872,6555
2022-08-08,Sacramento,067,1510023,335244,334382,32222,366604,3177
2022-08-08,San Benito,069,59416,15553,15507,876,16383,101
2022-08-08,San Bernardino,071,2135413,644943,641936,28957,670893,7977
2022-08-08,San Diego,073,3302833,898247,895482,68324,963806,5429
2022-08-08,San Francisco,075,870044,172841,172265,11631,183896,945
2022-08-08,San Joaquin,077,732212,191193,190596,13334,203930,2281
2022-08-08,San Luis Obispo,079,281455,61532,61207,6703,67910,510
2022-08-08,San Mateo,081,765935,162446,161882,10255,172137,738
2022-08-08,Santa Barbara,083,443738,102017,101558,6406,107964,711
2022-08-08,Santa Clara,085,1922200,416228,414659,18112,432771,2398
2022-08-08,Santa Cruz,087,273765,60615,60360,3257,63617,269
2022-08-08,Shasta,089,179085,33933,33816,7069,40885,584
2022-08-08,Sierra,091,2930,296,295,59,354,4
2022-08-08,Siskiyou,093,43540,5088,5074,3224,8298,87
2022-08-08,Solano,095,438530,101603,101393,7369,108762,457
2022-08-08,Sonoma,097,501317,103432,103168,4962,108130,501
2022-08-08,Stanislaus,099,539301,133415,133071,20081,153152,1702
2022-08-08,Sutter,101,95872,23332,23279,2405,25684,228
2022-08-08,Tehama,103,63373,13239,13187,2964,16151,209
2022-08-08,Trinity,105,12862,1356,1350,353,1703,20
2022-08-08,Tulare,107,460477,118506,118239,33669,151908,1520
2022-08-08,Tuolumne,109,53932,14983,14922,885,15807,196
2022-08-08,Ventura,111,848112,201843,201179,14310,215489,1539
2022-08-08,Yolo,113,214977,46285,46069,4159,50228,330
2022-08-08,Yuba,115,75493,18208,18179,1594,19773,129
2022-08-07,Alameda,001,1643700,334310,331755,19340,351095,1945
2022-08-07,Alpine,003,1148,131,130,1,131,0
2022-08-07,Amador,005,37829,9699,9655,872,10527,88
2022-08-07,Butte,007,227075,38042,37717,8491,46208,446
2022-08-07,Calaveras,009,45235,8262,8219,482,8701,129
2022-08-07,Colusa,011,21464,3701,3696,1208,4904,22
2022-08-07,Contra Costa,013,1133247,239645,237436,19373,256809,1383
2022-08-07,Del Norte,015,27424,7220,7191,378,7569,54
2022-08-07,El Dorado,017,186661,31412,31240,4066,35306,225
2022-08-07,Fresno,019,978130,265757,263912,28495,292407,2815
2022-08-07,Glenn,021,27897,5396,5379,1819,7198,48
2022-08-07,Humboldt,023,135768,20902,20746,4568,25314,153
2022-08-07,Imperial,025,180216,63664,63198,14554,77752,949
2022-08-07,Inyo,027,18085,4421,4408,839,5247,57
2022-08-07,Kern,029,883053,213325,211798,55564,267362,2375
2022-08-07,Kings,031,150075,57613,57294,3903,61197,453
2022-08-07,Lake,033,64148,12296,12220,1098,13318,142
2022-08-07,Lassen,035,31185,9725,9654,966,10620,64
2022-08-07,Los Angeles,037,10098052,3177465,3153757,168440,3322197,32563
2022-08-07,Madera,039,155013,42426,42139,7595,49734,372
2022-08-07,Marin,041,260295,43600,43295,5039,48334,302
2022-08-07,Mariposa,043,17540,2988,2965,314,3279,31
2022-08-07,Mendocino,045,87422,15449,15335,4164,19499,132
2022-08-07,Merced,047,269075,69899,69498,10689,80187,838
2022-08-07,Modoc,049,8938,855,853,313,1166,11
2022-08-07,Mono,051,14174,3170,3161,233,3394,7
2022-08-07,Monterey,053,433212,91516,90884,19599,110483,757
2022-08-07,Napa,055,140530,31270,31052,1370,32422,151
2022-08-07,Nevada,057,99092,18386,18309,1691,20000,132
2022-08-07,Orange,059,3164182,646900,643029,57507,700536,7213
2022-08-07,Placer,061,380077,73533,73064,9083,82147,648
2022-08-07,Plumas,063,18699,3532,3516,428,3944,13
2022-08-07,Riverside,065,2383286,673931,669230,33455,702685,6555
2022-08-07,Sacramento,067,1510023,334755,332928,32171,365099,3175
2022-08-07,San Benito,069,59416,15527,15403,873,16276,101
2022-08-07,San Bernardino,071,2135413,644066,639120,28894,668014,7956
2022-08-07,San Diego,073,3302833,896973,891504,68211,959715,5424
2022-08-07,San Francisco,075,870044,172567,171486,11607,183093,946
2022-08-07,San Joaquin,077,732212,190896,189696,13289,202985,2276
2022-08-07,San Luis Obispo,079,281455,61434,60903,6671,67574,510
2022-08-07,San Mateo,081,765935,162201,161011,10239,171250,734
2022-08-07,Santa Barbara,083,443738,101832,100995,6378,107373,711
2022-08-07,Santa Clara,085,1922200,415515,412411,18093,430504,2386
2022-08-07,Santa Cruz,087,273765,60495,59982,3239,63221,269
2022-08-07,Shasta,089,179085,33885,33727,7055,40782,583
2022-08-07,Sierra,091,2930,295,295,59,354,4
2022-08-07,Siskiyou,093,43540,5081,5045,3219,8264,87
2022-08-07,Solano,095,438530,101446,100081,7351,107432,457
2022-08-07,Sonoma,097,501317,103320,102682,4954,107636,502
2022-08-07,Stanislaus,099,539301,133222,132406,20050,152456,1701
2022-08-07,Sutter,101,95872,23295,23178,2404,25582,228
2022-08-07,Tehama,103,63373,13228,13155,2960,16115,209
2022-08-07,Trinity,105,12862,1354,1347,352,1699,20
2022-08-07,Tulare,107,460477,118357,117668,33576,151244,1516
2022-08-07,Tuolumne,109,53932,14966,14844,885,15729,196
2022-08-07,Ventura,111,848112,201586,200270,14264,214534,1537
2022-08-07,Yolo,113,214977,46235,45902,4149,50051,331
2022-08-07,Yuba,115,75493,18189,18099,1590,19689,124
2022-08-06,Alameda,001,1643700,334073,331755,19330,351085,1945
2022-08-06,Alpine,003,1148,131,130,1,131,0
2022-08-06,Amador,005,37829,9692,9655,870,10525,88
2022-08-06,Butte,007,227075,38004,37717,8481,46198,446
2022-08-06,Calaveras,009,45235,8255,8219,481,8700,129
2022-08-06,Colusa,011,21464,3699,3696,1205,4901,22
2022-08-06,Contra Costa,013,1133247,239401,237436,19351,256787,1383
2022-08-06,Del Norte,015,27424,7214,7191,378,7569,54
2022-08-06,El Dorado,017,186661,31397,31240,4063,35303,225
2022-08-06,Fresno,019,978130,265582,263912,28480,292392,2815
2022-08-06,Glenn,021,27897,5396,5379,1818,7197,48
2022-08-06,Humboldt,023,135768,20880,20746,4559,25305,153
2022-08-06,Imperial,025,180216,63616,63198,14524,77722,949
2022-08-06,Inyo,027,18085,4421,4408,838,5246,57
2022-08-06,Kern,029,883053,213237,211798,55510,267308,2375
2022-08-06,Kings,031,150075,57574,57294,3902,61196,453
2022-08-06,Lake,033,64148,12291,12220,1098,13318,142
2022-08-06,Lassen,035,31185,9692,9654,966,10620,64
2022-08-06,Los Angeles,037,10098052,3175404,3153757,168164,3321921,32563
2022-08-06,Madera,039,155013,42382,42139,7590,49729,372
2022-08-06,Marin,041,260295,43571,43295,5035,48330,302
2022-08-06,Mariposa,043,17540,2987,2965,314,3279,31
2022-08-06,Mendocino,045,87422,15439,15335,4163,19498,132
2022-08-06,Merced,047,269075,69871,69498,10683,80181,838
2022-08-06,Modoc,049,8938,855,853,313,1166,11
2022-08-06,Mono,051,14174,3168,3161,233,3394,7
2022-08-06,Monterey,053,433212,91464,90884,19553,110437,757
2022-08-06,Napa,055,140530,31251,31052,1369,32421,151
2022-08-06,Nevada,057,99092,18381,18309,1689,19998,132
2022-08-06,Orange,059,3164182,646459,643029,57394,700423,7213
2022-08-06,Placer,061,380077,73479,73064,9076,82140,648
2022-08-06,Plumas,063,18699,3530,3516,428,3944,13
2022-08-06,Riverside,065,2383286,673419,669230,33416,702646,6555
2022-08-06,Sacramento,067,1510023,334589,332928,32162,365090,3175
2022-08-06,San Benito,069,59416,15510,15403,871,16274,101
2022-08-06,San Bernardino,071,2135413,643637,639120,28859,667979,7956
2022-08-06,San Diego,073,3302833,896419,891504,68171,959675,5424
2022-08-06,San Francisco,075,870044,172412,171486,11597,183083,946
2022-08-06,San Joaquin,077,732212,190766,189696,13278,202974,2276
2022-08-06,San Luis Obispo,079,281455,61406,60903,6666,67569,510
2022-08-06,San Mateo,081,765935,162064,161011,10232,171243,734
2022-08-06,Santa Barbara,083,443738,101760,100995,6364,107359,711
2022-08-06,Santa Clara,085,1922200,415056,412411,18075,430486,2386
2022-08-06,Santa Cruz,087,273765,60440,59982,3232,63214,269
2022-08-06,Shasta,089,179085,33863,33727,7045,40772,583
2022-08-06,Sierra,091,2930,295,295,59,354,4
2022-08-06,Siskiyou,093,43540,5075,5045,3217,8262,87
2022-08-06,Solano,095,438530,101399,100081,7346,107427,457
2022-08-06,Sonoma,097,501317,103258,102682,4945,107627,502
2022-08-06,Stanislaus,099,539301,133117,132406,20041,152447,1701
2022-08-06,Sutter,101,95872,23273,23178,2404,25582,228
2022-08-06,Tehama,103,63373,13226,13155,2956,16111,209
2022-08-06,Trinity,105,12862,1354,1347,352,1699,20
2022-08-06,Tulare,107,460477,118276,117668,33534,151202,1516
2022-08-06,Tuolumne,109,53932,14958,14844,884,15728,196
2022-08-06,Ventura,111,848112,201482,200270,14243,214513,1537
2022-08-06,Yolo,113,214977,46205,45902,4142,50044,331
2022-08-06,Yuba,115,75493,18174,18099,1589,19688,124
2022-08-05,Alameda,001,1643700,333767,331755,19320,351075,1945
2022-08-05,Alpine,003,1148,131,130,1,131,0
2022-08-05,Amador,005,37829,9690,9655,870,10525,88
2022-08-05,Butte,007,227075,37966,37717,8470,46187,446
2022-08-05,Calaveras,009,45235,8251,8219,481,8700,129
2022-08-05,Colusa,011,21464,3698,3696,1205,4901,22
2022-08-05,Contra Costa,013,1133247,239209,237436,19323,256759,1383
2022-08-05,Del Norte,015,27424,7210,7191,377,7568,54
2022-08-05,El Dorado,017,186661,31389,31240,4062,35302,225
2022-08-05,Fresno,019,978130,265406,263912,28463,292375,2815
2022-08-05,Glenn,021,27897,5395,5379,1817,7196,48
2022-08-05,Humboldt,023,135768,20863,20746,4546,25292,153
2022-08-05,Imperial,025,180216,63539,63198,14485,77683,949
2022-08-05,Inyo,027,18085,4421,4408,838,5246,57
2022-08-05,Kern,029,883053,213141,211798,55464,267262,2375
2022-08-05,Kings,031,150075,57549,57294,3900,61194,453
2022-08-05,Lake,033,64148,12281,12220,1098,13318,142
2022-08-05,Lassen,035,31185,9680,9654,965,10619,64
2022-08-05,Los Angeles,037,10098052,3173038,3153757,167894,3321651,32563
2022-08-05,Madera,039,155013,42340,42139,7580,49719,372
2022-08-05,Marin,041,260295,43527,43295,5029,48324,302
2022-08-05,Mariposa,043,17540,2983,2965,312,3277,31
2022-08-05,Mendocino,045,87422,15426,15335,4159,19494,132
2022-08-05,Merced,047,269075,69821,69498,10677,80175,838
2022-08-05,Modoc,049,8938,855,853,313,1166,11
2022-08-05,Mono,051,14174,3167,3161,233,3394,7
2022-08-05,Monterey,053,433212,91396,90884,19517,110401,757
2022-08-05,Napa,055,140530,31222,31052,1368,32420,151
2022-08-05,Nevada,057,99092,18374,18309,1687,19996,132
2022-08-05,Orange,059,3164182,645957,643029,57290,700319,7213
2022-08-05,Placer,061,380077,73430,73064,9066,82130,648
2022-08-05,Plumas,063,18699,3527,3516,428,3944,13
2022-08-05,Riverside,065,2383286,672864,669230,33366,702596,6555
2022-08-05,Sacramento,067,1510023,334363,332928,32144,365072,3175
2022-08-05,San Benito,069,59416,15491,15403,869,16272,101
2022-08-05,San Bernardino,071,2135413,643190,639120,28832,667952,7956
2022-08-05,San Diego,073,3302833,895752,891504,68091,959595,5424
2022-08-05,San Francisco,075,870044,172271,171486,11576,183062,946
2022-08-05,San Joaquin,077,732212,190641,189696,13260,202956,2276
2022-08-05,San Luis Obispo,079,281455,61370,60903,6658,67561,510
2022-08-05,San Mateo,081,765935,161892,161011,10221,171232,734
2022-08-05,Santa Barbara,083,443738,101659,100995,6356,107351,711
2022-08-05,Santa Clara,085,1922200,414552,412411,18047,430458,2386
2022-08-05,Santa Cruz,087,273765,60372,59982,3228,63210,269
2022-08-05,Shasta,089,179085,33853,33727,7042,40769,583
2022-08-05,Sierra,091,2930,295,295,59,354,4
2022-08-05,Siskiyou,093,43540,5072,5045,3215,8260,87
2022-08-05,Solano,095,438530,101323,100081,7339,107420,457
2022-08-05,Sonoma,097,501317,103191,102682,4941,107623,502
2022-08-05,Stanislaus,099,539301,133014,132406,20033,152439,1701
2022-08-05,Sutter,101,95872,23252,23178,2402,25580,228
2022-08-05,Tehama,103,63373,13221,13155,2956,16111,209
2022-08-05,Trinity,105,12862,1353,1347,352,1699,20
2022-08-05,Tulare,107,460477,118189,117668,33480,151148,1516
2022-08-05,Tuolumne,109,53932,14945,14844,883,15727,196
2022-08-05,Ventura,111,848112,201333,200270,14213,214483,1537
2022-08-05,Yolo,113,214977,46189,45902,4128,50030,331
2022-08-05,Yuba,115,75493,18166,18099,1588,19687,124
2022-08-04,Alameda,001,1643700,333313,331755,19273,351028,1945
2022-08-04,Alpine,003,1148,130,130,1,131,0
2022-08-04,Amador,005,37829,9679,9655,865,10520,88
2022-08-04,Butte,007,227075,37922,37717,8454,46171,446
2022-08-04,Calaveras,009,45235,8244,8219,480,8699,129
2022-08-04,Colusa,011,21464,3697,3696,1205,4901,22
2022-08-04,Contra Costa,013,1133247,238933,237436,19281,256717,1383
2022-08-04,Del Norte,015,27424,7202,7191,376,7567,54
2022-08-04,El Dorado,017,186661,31359,31240,4059,35299,225
2022-08-04,Fresno,019,978130,265077,263912,28416,292328,2815
2022-08-04,Glenn,021,27897,5391,5379,1814,7193,48
2022-08-04,Humboldt,023,135768,20841,20746,4533,25279,153
2022-08-04,Imperial,025,180216,63471,63198,14431,77629,949
2022-08-04,Inyo,027,18085,4420,4408,837,5245,57
2022-08-04,Kern,029,883053,212950,211798,55389,267187,2375
2022-08-04,Kings,031,150075,57483,57294,3892,61186,453
2022-08-04,Lake,033,64148,12268,12220,1097,13317,142
2022-08-04,Lassen,035,31185,9674,9654,962,10616,64
2022-08-04,Los Angeles,037,10098052,3169483,3153757,167523,3321280,32563
2022-08-04,Madera,039,155013,42298,42139,7538,49677,372
2022-08-04,Marin,041,260295,43474,43295,5003,48298,302
2022-08-04,Mariposa,043,17540,2978,2965,310,3275,31
2022-08-04,Mendocino,045,87422,15413,15335,4151,19486,132
2022-08-04,Merced,047,269075,69758,69498,10638,80136,838
2022-08-04,Modoc,049,8938,855,853,313,1166,11
2022-08-04,Mono,051,14174,3167,3161,233,3394,7
2022-08-04,Monterey,053,433212,91288,90884,19450,110334,757
2022-08-04,Napa,055,140530,31185,31052,1367,32419,151
2022-08-04,Nevada,057,99092,18365,18309,1680,19989,132
2022-08-04,Orange,059,3164182,645197,643029,57150,700179,7213
2022-08-04,Placer,061,380077,73363,73064,9052,82116,648
2022-08-04,Plumas,063,18699,3522,3516,428,3944,13
2022-08-04,Riverside,065,2383286,672158,669230,33318,702548,6555
2022-08-04,Sacramento,067,1510023,333966,332928,32121,365049,3175
2022-08-04,San Benito,069,59416,15463,15403,861,16264,101
2022-08-04,San Bernardino,071,2135413,642510,639120,28778,667898,7956
2022-08-04,San Diego,073,3302833,894763,891504,67990,959494,5424
2022-08-04,San Francisco,075,870044,172064,171486,11548,183034,946
2022-08-04,San Joaquin,077,732212,190437,189696,13232,202928,2276
2022-08-04,San Luis Obispo,079,281455,61307,60903,6631,67534,510
2022-08-04,San Mateo,081,765935,161669,161011,10214,171225,734
2022-08-04,Santa Barbara,083,443738,101526,100995,6335,107330,711
2022-08-04,Santa Clara,085,1922200,413976,412411,18017,430428,2386
2022-08-04,Santa Cruz,087,273765,60285,59982,3227,63209,269
2022-08-04,Shasta,089,179085,33835,33727,7028,40755,583
2022-08-04,Sierra,091,2930,295,295,59,354,4
2022-08-04,Siskiyou,093,43540,5067,5045,3209,8254,87
2022-08-04,Solano,095,438530,101212,100081,7329,107410,457
2022-08-04,Sonoma,097,501317,103086,102682,4930,107612,502
2022-08-04,Stanislaus,099,539301,132859,132406,20012,152418,1701
2022-08-04,Sutter,101,95872,23225,23178,2400,25578,228
2022-08-04,Tehama,103,63373,13216,13155,2951,16106,209
2022-08-04,Trinity,105,12862,1352,1347,351,1698,20
2022-08-04,Tulare,107,460477,118073,117668,33421,151089,1516
2022-08-04,Tuolumne,109,53932,14921,14844,881,15725,196
2022-08-04,Ventura,111,848112,201106,200270,14175,214445,1537
2022-08-04,Yolo,113,214977,46153,45902,4120,50022,331
2022-08-04,Yuba,115,75493,18146,18099,1587,19686,124
2022-08-03,Alameda,001,1643700,332818,330158,19239,349397,1941
2022-08-03,Alpine,003,1148,130,130,1,131,0
2022-08-03,Amador,005,37829,9673,9627,862,10489,88
2022-08-03,Butte,007,227075,37878,37567,8443,46010,444
2022-08-03,Calaveras,009,45235,8237,8194,479,8673,128
2022-08-03,Colusa,011,21464,3697,3676,1205,4881,22
2022-08-03,Contra Costa,013,1133247,238614,236190,19231,255421,1381
2022-08-03,Del Norte,015,27424,7198,7156,376,7532,54
2022-08-03,El Dorado,017,186661,31324,31165,4049,35214,222
2022-08-03,Fresno,019,978130,264685,262758,28379,291137,2806
2022-08-03,Glenn,021,27897,5389,5363,1810,7173,48
2022-08-03,Humboldt,023,135768,20807,20640,4514,25154,153
2022-08-03,Imperial,025,180216,63394,62884,14379,77263,949
2022-08-03,Inyo,027,18085,4420,4398,831,5229,57
2022-08-03,Kern,029,883053,212763,211047,55313,266360,2375
2022-08-03,Kings,031,150075,57419,57065,3889,60954,453
2022-08-03,Lake,033,64148,12251,12172,1094,13266,142
2022-08-03,Lassen,035,31185,9671,9563,962,10525,64
2022-08-03,Los Angeles,037,10098052,3165841,3140955,167156,3308111,32500
2022-08-03,Madera,039,155013,42250,41918,7519,49437,372
2022-08-03,Marin,041,260295,43413,43127,4988,48115,300
2022-08-03,Mariposa,043,17540,2974,2950,310,3260,30
2022-08-03,Mendocino,045,87422,15396,15260,4143,19403,132
2022-08-03,Merced,047,269075,69692,69198,10610,79808,838
2022-08-03,Modoc,049,8938,854,842,313,1155,11
2022-08-03,Mono,051,14174,3167,3157,231,3388,7
2022-08-03,Monterey,053,433212,91183,90456,19384,109840,754
2022-08-03,Napa,055,140530,31148,30935,1362,32297,151
2022-08-03,Nevada,057,99092,18354,18253,1677,19930,132
2022-08-03,Orange,059,3164182,644382,640110,56986,697096,7202
2022-08-03,Placer,061,380077,73284,72834,9038,81872,646
2022-08-03,Plumas,063,18699,3519,3496,428,3924,13
2022-08-03,Riverside,065,2383286,671308,666773,33253,700026,6547
2022-08-03,Sacramento,067,1510023,333542,331584,32087,363671,3162
2022-08-03,San Benito,069,59416,15435,15338,854,16192,100
2022-08-03,San Bernardino,071,2135413,641805,636510,28720,665230,7951
2022-08-03,San Diego,073,3302833,893554,887729,67864,955593,5417
2022-08-03,San Francisco,075,870044,171862,170637,11529,182166,939
2022-08-03,San Joaquin,077,732212,190197,188962,13207,202169,2276
2022-08-03,San Luis Obispo,079,281455,61226,60648,6615,67263,504
2022-08-03,San Mateo,081,765935,161481,160258,10202,170460,725
2022-08-03,Santa Barbara,083,443738,101405,100558,6313,106871,710
2022-08-03,Santa Clara,085,1922200,413505,410394,17988,428382,2383
2022-08-03,Santa Cruz,087,273765,60196,59661,3224,62885,269
2022-08-03,Shasta,089,179085,33809,33630,7022,40652,582
2022-08-03,Sierra,091,2930,295,295,59,354,4
2022-08-03,Siskiyou,093,43540,5064,5021,3207,8228,86
2022-08-03,Solano,095,438530,101093,99608,7317,106925,459
2022-08-03,Sonoma,097,501317,102967,102306,4921,107227,500
2022-08-03,Stanislaus,099,539301,132715,131869,19987,151856,1701
2022-08-03,Sutter,101,95872,23197,23056,2398,25454,228
2022-08-03,Tehama,103,63373,13204,13135,2947,16082,209
2022-08-03,Trinity,105,12862,1352,1342,350,1692,20
2022-08-03,Tulare,107,460477,117934,117288,33353,150641,1516
2022-08-03,Tuolumne,109,53932,14902,14778,880,15658,196
2022-08-03,Ventura,111,848112,200872,199530,14137,213667,1536
2022-08-03,Yolo,113,214977,46107,45757,4101,49858,330
2022-08-03,Yuba,115,75493,18117,18036,1586,19622,124
2022-08-02,Alameda,001,1643700,332293,330158,19204,349362,1941
2022-08-02,Alpine,003,1148,130,130,1,131,0
2022-08-02,Amador,005,37829,9664,9627,855,10482,88
2022-08-02,Butte,007,227075,37838,37567,8432,45999,444
2022-08-02,Calaveras,009,45235,8222,8194,477,8671,128
2022-08-02,Colusa,011,21464,3694,3676,1205,4881,22
2022-08-02,Contra Costa,013,1133247,238265,236190,19168,255358,1381
2022-08-02,Del Norte,015,27424,7188,7156,376,7532,54
2022-08-02,El Dorado,017,186661,31300,31165,4044,35209,222
2022-08-02,Fresno,019,978130,264263,262758,28310,291068,2806
2022-08-02,Glenn,021,27897,5385,5363,1808,7171,48
2022-08-02,Humboldt,023,135768,20770,20640,4491,25131,153
2022-08-02,Imperial,025,180216,63314,62884,14331,77215,949
2022-08-02,Inyo,027,18085,4417,4398,821,5219,57
2022-08-02,Kern,029,883053,212536,211047,55215,266262,2375
2022-08-02,Kings,031,150075,57338,57065,3885,60950,453
2022-08-02,Lake,033,64148,12240,12172,1091,13263,142
2022-08-02,Lassen,035,31185,9668,9563,961,10524,64
2022-08-02,Los Angeles,037,10098052,3161597,3140955,166699,3307654,32500
2022-08-02,Madera,039,155013,42180,41918,7497,49415,372
2022-08-02,Marin,041,260295,43355,43127,4980,48107,300
2022-08-02,Mariposa,043,17540,2969,2950,310,3260,30
2022-08-02,Mendocino,045,87422,15365,15260,4128,19388,132
2022-08-02,Merced,047,269075,69619,69198,10572,79770,838
2022-08-02,Modoc,049,8938,854,842,313,1155,11
2022-08-02,Mono,051,14174,3165,3157,226,3383,7
2022-08-02,Monterey,053,433212,91060,90456,19309,109765,754
2022-08-02,Napa,055,140530,31111,30935,1359,32294,151
2022-08-02,Nevada,057,99092,18340,18253,1676,19929,132
2022-08-02,Orange,059,3164182,643501,640110,56824,696934,7202
2022-08-02,Placer,061,380077,73200,72834,9029,81863,646
2022-08-02,Plumas,063,18699,3514,3496,428,3924,13
2022-08-02,Riverside,065,2383286,670397,666773,33201,699974,6547
2022-08-02,Sacramento,067,1510023,333146,331584,32043,363627,3162
2022-08-02,San Benito,069,59416,15401,15338,851,16189,100
2022-08-02,San Bernardino,071,2135413,640990,636510,28666,665176,7951
2022-08-02,San Diego,073,3302833,892391,887729,67736,955465,5417
2022-08-02,San Francisco,075,870044,171625,170637,11515,182152,939
2022-08-02,San Joaquin,077,732212,189964,188962,13181,202143,2276
2022-08-02,San Luis Obispo,079,281455,61138,60648,6586,67234,504
2022-08-02,San Mateo,081,765935,161236,160258,10198,170456,725
2022-08-02,Santa Barbara,083,443738,101242,100558,6284,106842,710
2022-08-02,Santa Clara,085,1922200,412880,410394,17952,428346,2383
2022-08-02,Santa Cruz,087,273765,60107,59661,3216,62877,269
2022-08-02,Shasta,089,179085,33791,33630,7008,40638,582
2022-08-02,Sierra,091,2930,295,295,59,354,4
2022-08-02,Siskiyou,093,43540,5051,5021,3203,8224,86
2022-08-02,Solano,095,438530,100912,99608,7295,106903,459
2022-08-02,Sonoma,097,501317,102799,102306,4905,107211,500
2022-08-02,Stanislaus,099,539301,132557,131869,19950,151819,1701
2022-08-02,Sutter,101,95872,23163,23056,2397,25453,228
2022-08-02,Tehama,103,63373,13197,13135,2943,16078,209
2022-08-02,Trinity,105,12862,1352,1342,348,1690,20
2022-08-02,Tulare,107,460477,117794,117288,33272,150560,1516
2022-08-02,Tuolumne,109,53932,14884,14778,878,15656,196
2022-08-02,Ventura,111,848112,200622,199530,14093,213623,1536
2022-08-02,Yolo,113,214977,46062,45757,4096,49853,330
2022-08-02,Yuba,115,75493,18096,18036,1582,19618,124
2022-08-01,Alameda,001,1643700,331643,330158,19169,349327,1941
2022-08-01,Alpine,003,1148,130,130,1,131,0
2022-08-01,Amador,005,37829,9657,9627,853,10480,88
2022-08-01,Butte,007,227075,37782,37567,8416,45983,444
2022-08-01,Calaveras,009,45235,8219,8194,476,8670,128
2022-08-01,Colusa,011,21464,3690,3676,1196,4872,22
2022-08-01,Contra Costa,013,1133247,237879,236190,19112,255302,1381
2022-08-01,Del Norte,015,27424,7183,7156,376,7532,54
2022-08-01,El Dorado,017,186661,31271,31165,4039,35204,222
2022-08-01,Fresno,019,978130,263806,262758,28237,290995,2806
2022-08-01,Glenn,021,27897,5376,5363,1807,7170,48
2022-08-01,Humboldt,023,135768,20739,20640,4473,25113,153
2022-08-01,Imperial,025,180216,63201,62884,14270,77154,949
2022-08-01,Inyo,027,18085,4414,4398,817,5215,57
2022-08-01,Kern,029,883053,212301,211047,55138,266185,2375
2022-08-01,Kings,031,150075,57246,57065,3874,60939,453
2022-08-01,Lake,033,64148,12211,12172,1090,13262,142
2022-08-01,Lassen,035,31185,9648,9563,961,10524,64
2022-08-01,Los Angeles,037,10098052,3156957,3140955,166255,3307210,32500
2022-08-01,Madera,039,155013,42098,41918,7466,49384,372
2022-08-01,Marin,041,260295,43298,43127,4956,48083,300
2022-08-01,Mariposa,043,17540,2965,2950,308,3258,30
2022-08-01,Mendocino,045,87422,15341,15260,4119,19379,132
2022-08-01,Merced,047,269075,69513,69198,10547,79745,838
2022-08-01,Modoc,049,8938,854,842,313,1155,11
2022-08-01,Mono,051,14174,3164,3157,224,3381,7
2022-08-01,Monterey,053,433212,90916,90456,19234,109690,754
2022-08-01,Napa,055,140530,31063,30935,1356,32291,151
2022-08-01,Nevada,057,99092,18328,18253,1671,19924,132
2022-08-01,Orange,059,3164182,642561,640110,56659,696769,7202
2022-08-01,Placer,061,380077,73134,72834,9017,81851,646
2022-08-01,Plumas,063,18699,3510,3496,428,3924,13
2022-08-01,Riverside,065,2383286,669391,666773,33153,699926,6547
2022-08-01,Sacramento,067,1510023,332710,331584,32003,363587,3162
2022-08-01,San Benito,069,59416,15382,15338,851,16189,100
2022-08-01,San Bernardino,071,2135413,640109,636510,28612,665122,7951
2022-08-01,San Diego,073,3302833,890969,887729,67563,955292,5417
2022-08-01,San Francisco,075,870044,171369,170637,11502,182139,939
2022-08-01,San Joaquin,077,732212,189695,188962,13148,202110,2276
2022-08-01,San Luis Obispo,079,281455,61041,60648,6569,67217,504
2022-08-01,San Mateo,081,765935,160942,160258,10185,170443,725
2022-08-01,Santa Barbara,083,443738,101068,100558,6258,106816,710
2022-08-01,Santa Clara,085,1922200,412103,410394,17926,428320,2383
2022-08-01,Santa Cruz,087,273765,60004,59661,3203,62864,269
2022-08-01,Shasta,089,179085,33765,33630,6996,40626,582
2022-08-01,Sierra,091,2930,295,295,59,354,4
2022-08-01,Siskiyou,093,43540,5043,5021,3195,8216,86
2022-08-01,Solano,095,438530,100729,99608,7277,106885,459
2022-08-01,Sonoma,097,501317,102635,102306,4896,107202,500
2022-08-01,Stanislaus,099,539301,132385,131869,19925,151794,1701
2022-08-01,Sutter,101,95872,23107,23056,2396,25452,228
2022-08-01,Tehama,103,63373,13181,13135,2937,16072,209
2022-08-01,Trinity,105,12862,1351,1342,347,1689,20
2022-08-01,Tulare,107,460477,117621,117288,33195,150483,1516
2022-08-01,Tuolumne,109,53932,14865,14778,878,15656,196
2022-08-01,Ventura,111,848112,200374,199530,14046,213576,1536
2022-08-01,Yolo,113,214977,46011,45757,4080,49837,330
2022-08-01,Yuba,115,75493,18073,18036,1578,19614,124
2022-07-31,Alameda,001,1643700,330922,327608,19128,346736,1941
2022-07-31,Alpine,003,1148,130,130,1,131,0
2022-07-31,Amador,005,37829,9644,9609,848,10457,88
2022-07-31,Butte,007,227075,37708,37349,8397,45746,444
2022-07-31,Calaveras,009,45235,8207,8145,473,8618,128
2022-07-31,Colusa,011,21464,3686,3664,1194,4858,22
2022-07-31,Contra Costa,013,1133247,237409,234635,19045,253680,1375
2022-07-31,Del Norte,015,27424,7171,7136,373,7509,54
2022-07-31,El Dorado,017,186661,31244,31007,4031,35038,222
2022-07-31,Fresno,019,978130,263249,260858,28164,289022,2805
2022-07-31,Glenn,021,27897,5373,5350,1805,7155,48
2022-07-31,Humboldt,023,135768,20699,20523,4440,24963,151
2022-07-31,Imperial,025,180216,63100,62471,14189,76660,949
2022-07-31,Inyo,027,18085,4409,4388,812,5200,57
2022-07-31,Kern,029,883053,212004,210190,55002,265192,2375
2022-07-31,Kings,031,150075,57118,56673,3866,60539,454
2022-07-31,Lake,033,64148,12195,12102,1088,13190,142
2022-07-31,Lassen,035,31185,9569,9548,961,10509,64
2022-07-31,Los Angeles,037,10098052,3151895,3122700,165672,3288372,32445
2022-07-31,Madera,039,155013,42009,41641,7432,49073,372
2022-07-31,Marin,041,260295,43225,42840,4943,47783,300
2022-07-31,Mariposa,043,17540,2959,2940,307,3247,30
2022-07-31,Mendocino,045,87422,15322,15172,4110,19282,132
2022-07-31,Merced,047,269075,69386,68853,10504,79357,838
2022-07-31,Modoc,049,8938,850,841,313,1154,11
2022-07-31,Mono,051,14174,3161,3155,224,3379,7
2022-07-31,Monterey,053,433212,90758,89974,19150,109124,754
2022-07-31,Napa,055,140530,30996,30777,1353,32130,150
2022-07-31,Nevada,057,99092,18291,18187,1668,19855,131
2022-07-31,Orange,059,3164182,641582,636403,56465,692868,7194
2022-07-31,Placer,061,380077,73032,72444,9000,81444,647
2022-07-31,Plumas,063,18699,3504,3490,427,3917,13
2022-07-31,Riverside,065,2383286,668350,662929,33067,695996,6543
2022-07-31,Sacramento,067,1510023,332109,329639,31948,361587,3156
2022-07-31,San Benito,069,59416,15355,15256,845,16101,100
2022-07-31,San Bernardino,071,2135413,639043,633131,28516,661647,7941
2022-07-31,San Diego,073,3302833,889374,881822,67411,949233,5409
2022-07-31,San Francisco,075,870044,170973,169564,11461,181025,937
2022-07-31,San Joaquin,077,732212,189343,187937,13077,201014,2276
2022-07-31,San Luis Obispo,079,281455,60895,60370,6533,66903,503
2022-07-31,San Mateo,081,765935,160699,159145,10157,169302,726
2022-07-31,Santa Barbara,083,443738,100840,99946,6211,106157,708
2022-07-31,Santa Clara,085,1922200,411343,407392,17891,425283,2381
2022-07-31,Santa Cruz,087,273765,59838,59227,3187,62414,269
2022-07-31,Shasta,089,179085,33715,33454,6973,40427,581
2022-07-31,Sierra,091,2930,295,293,59,352,4
2022-07-31,Siskiyou,093,43540,5032,4997,3192,8189,86
2022-07-31,Solano,095,438530,100535,99034,7263,106297,457
2022-07-31,Sonoma,097,501317,102484,101747,4870,106617,500
2022-07-31,Stanislaus,099,539301,132152,131081,19884,150965,1696
2022-07-31,Sutter,101,95872,23062,22931,2385,25316,228
2022-07-31,Tehama,103,63373,13173,13079,2928,16007,208
2022-07-31,Trinity,105,12862,1349,1340,346,1686,20
2022-07-31,Tulare,107,460477,117428,116640,33081,149721,1514
2022-07-31,Tuolumne,109,53932,14841,14701,875,15576,196
2022-07-31,Ventura,111,848112,200060,198498,13965,212463,1530
2022-07-31,Yolo,113,214977,45950,45511,4071,49582,327
2022-07-31,Yuba,115,75493,18042,17951,1569,19520,124
2022-07-30,Alameda,001,1643700,330585,327608,19111,346719,1941
2022-07-30,Alpine,003,1148,130,130,1,131,0
2022-07-30,Amador,005,37829,9642,9609,842,10451,88
2022-07-30,Butte,007,227075,37678,37349,8388,45737,444
2022-07-30,Calaveras,009,45235,8197,8145,472,8617,128
2022-07-30,Colusa,011,21464,3681,3664,1194,4858,22
2022-07-30,Contra Costa,013,1133247,237135,234635,19006,253641,1375
2022-07-30,Del Norte,015,27424,7166,7136,371,7507,54
2022-07-30,El Dorado,017,186661,31226,31007,4027,35034,222
2022-07-30,Fresno,019,978130,263048,260858,28131,288989,2805
2022-07-30,Glenn,021,27897,5368,5350,1804,7154,48
2022-07-30,Humboldt,023,135768,20679,20523,4428,24951,151
2022-07-30,Imperial,025,180216,63054,62471,14159,76630,949
2022-07-30,Inyo,027,18085,4408,4388,808,5196,57
2022-07-30,Kern,029,883053,211886,210190,54950,265140,2375
2022-07-30,Kings,031,150075,57085,56673,3866,60539,454
2022-07-30,Lake,033,64148,12185,12102,1087,13189,142
2022-07-30,Lassen,035,31185,9568,9548,959,10507,64
2022-07-30,Los Angeles,037,10098052,3149490,3122700,165308,3288008,32445
2022-07-30,Madera,039,155013,41975,41641,7426,49067,372
2022-07-30,Marin,041,260295,43193,42840,4941,47781,300
2022-07-30,Mariposa,043,17540,2957,2940,306,3246,30
2022-07-30,Mendocino,045,87422,15298,15172,4106,19278,132
2022-07-30,Merced,047,269075,69335,68853,10495,79348,838
2022-07-30,Modoc,049,8938,850,841,313,1154,11
2022-07-30,Mono,051,14174,3161,3155,223,3378,7
2022-07-30,Monterey,053,433212,90667,89974,19104,109078,754
2022-07-30,Napa,055,140530,30969,30777,1349,32126,150
2022-07-30,Nevada,057,99092,18282,18187,1664,19851,131
2022-07-30,Orange,059,3164182,641048,636403,56358,692761,7194
2022-07-30,Placer,061,380077,72993,72444,8987,81431,647
2022-07-30,Plumas,063,18699,3503,3490,427,3917,13
2022-07-30,Riverside,065,2383286,667818,662929,33038,695967,6543
2022-07-30,Sacramento,067,1510023,331866,329639,31940,361579,3156
2022-07-30,San Benito,069,59416,15343,15256,842,16098,100
2022-07-30,San Bernardino,071,2135413,638577,633131,28475,661606,7941
2022-07-30,San Diego,073,3302833,888731,881822,67361,949183,5409
2022-07-30,San Francisco,075,870044,170822,169564,11450,181014,937
2022-07-30,San Joaquin,077,732212,189216,187937,13054,200991,2276
2022-07-30,San Luis Obispo,079,281455,60863,60370,6519,66889,503
2022-07-30,San Mateo,081,765935,160517,159145,10139,169284,726
2022-07-30,Santa Barbara,083,443738,100751,99946,6190,106136,708
2022-07-30,Santa Clara,085,1922200,410855,407392,17872,425264,2381
2022-07-30,Santa Cruz,087,273765,59775,59227,3179,62406,269
2022-07-30,Shasta,089,179085,33695,33454,6972,40426,581
2022-07-30,Sierra,091,2930,295,293,59,352,4
2022-07-30,Siskiyou,093,43540,5029,4997,3190,8187,86
2022-07-30,Solano,095,438530,100477,99034,7251,106285,457
2022-07-30,Sonoma,097,501317,102398,101747,4862,106609,500
2022-07-30,Stanislaus,099,539301,132021,131081,19862,150943,1696
2022-07-30,Sutter,101,95872,23037,22931,2384,25315,228
2022-07-30,Tehama,103,63373,13167,13079,2925,16004,208
2022-07-30,Trinity,105,12862,1349,1340,346,1686,20
2022-07-30,Tulare,107,460477,117336,116640,33017,149657,1514
2022-07-30,Tuolumne,109,53932,14822,14701,875,15576,196
2022-07-30,Ventura,111,848112,199902,198498,13934,212432,1530
2022-07-30,Yolo,113,214977,45923,45511,4068,49579,327
2022-07-30,Yuba,115,75493,18029,17951,1569,19520,124
2022-07-29,Alameda,001,1643700,330219,327608,19086,346694,1941
2022-07-29,Alpine,003,1148,130,130,1,131,0
2022-07-29,Amador,005,37829,9641,9609,841,10450,88
2022-07-29,Butte,007,227075,37646,37349,8371,45720,444
2022-07-29,Calaveras,009,45235,8193,8145,472,8617,128
2022-07-29,Colusa,011,21464,3681,3664,1194,4858,22
2022-07-29,Contra Costa,013,1133247,236909,234635,18982,253617,1375
2022-07-29,Del Norte,015,27424,7161,7136,370,7506,54
2022-07-29,El Dorado,017,186661,31204,31007,4026,35033,222
2022-07-29,Fresno,019,978130,262812,260858,28086,288944,2805
2022-07-29,Glenn,021,27897,5366,5350,1802,7152,48
2022-07-29,Humboldt,023,135768,20654,20523,4418,24941,151
2022-07-29,Imperial,025,180216,62993,62471,14131,76602,949
2022-07-29,Inyo,027,18085,4407,4388,807,5195,57
2022-07-29,Kern,029,883053,211724,210190,54892,265082,2375
2022-07-29,Kings,031,150075,57048,56673,3865,60538,454
2022-07-29,Lake,033,64148,12170,12102,1084,13186,142
2022-07-29,Lassen,035,31185,9566,9548,959,10507,64
2022-07-29,Los Angeles,037,10098052,3146678,3122700,164991,3287691,32445
2022-07-29,Madera,039,155013,41930,41641,7413,49054,372
2022-07-29,Marin,041,260295,43146,42840,4933,47773,300
2022-07-29,Mariposa,043,17540,2956,2940,306,3246,30
2022-07-29,Mendocino,045,87422,15280,15172,4094,19266,132
2022-07-29,Merced,047,269075,69278,68853,10478,79331,838
2022-07-29,Modoc,049,8938,850,841,313,1154,11
2022-07-29,Mono,051,14174,3161,3155,222,3377,7
2022-07-29,Monterey,053,433212,90575,89974,19068,109042,754
2022-07-29,Napa,055,140530,30943,30777,1348,32125,150
2022-07-29,Nevada,057,99092,18271,18187,1662,19849,131
2022-07-29,Orange,059,3164182,640461,636403,56227,692630,7194
2022-07-29,Placer,061,380077,72923,72444,8973,81417,647
2022-07-29,Plumas,063,18699,3502,3490,427,3917,13
2022-07-29,Riverside,065,2383286,667275,662929,32992,695921,6543
2022-07-29,Sacramento,067,1510023,331554,329639,31921,361560,3156
2022-07-29,San Benito,069,59416,15328,15256,841,16097,100
2022-07-29,San Bernardino,071,2135413,638058,633131,28443,661574,7941
2022-07-29,San Diego,073,3302833,887866,881822,67254,949076,5409
2022-07-29,San Francisco,075,870044,170643,169564,11438,181002,937
2022-07-29,San Joaquin,077,732212,189106,187937,13041,200978,2276
2022-07-29,San Luis Obispo,079,281455,60825,60370,6507,66877,503
2022-07-29,San Mateo,081,765935,160340,159145,10130,169275,726
2022-07-29,Santa Barbara,083,443738,100629,99946,6180,106126,708
2022-07-29,Santa Clara,085,1922200,410380,407392,17851,425243,2381
2022-07-29,Santa Cruz,087,273765,59699,59227,3176,62403,269
2022-07-29,Shasta,089,179085,33669,33454,6964,40418,581
2022-07-29,Sierra,091,2930,295,293,58,351,4
2022-07-29,Siskiyou,093,43540,5024,4997,3189,8186,86
2022-07-29,Solano,095,438530,100347,99034,7241,106275,457
2022-07-29,Sonoma,097,501317,102304,101747,4850,106597,500
2022-07-29,Stanislaus,099,539301,131917,131081,19851,150932,1696
2022-07-29,Sutter,101,95872,23017,22931,2384,25315,228
2022-07-29,Tehama,103,63373,13160,13079,2923,16002,208
2022-07-29,Trinity,105,12862,1345,1340,345,1685,20
2022-07-29,Tulare,107,460477,117235,116640,32956,149596,1514
2022-07-29,Tuolumne,109,53932,14809,14701,874,15575,196
2022-07-29,Ventura,111,848112,199752,198498,13895,212393,1530
2022-07-29,Yolo,113,214977,45889,45511,4055,49566,327
2022-07-29,Yuba,115,75493,18008,17951,1567,19518,124
2022-07-28,Alameda,001,1643700,329735,327608,19037,346645,1941
2022-07-28,Alpine,003,1148,130,130,1,131,0
2022-07-28,Amador,005,37829,9634,9609,840,10449,88
2022-07-28,Butte,007,227075,37595,37349,8359,45708,444
2022-07-28,Calaveras,009,45235,8182,8145,471,8616,128
2022-07-28,Colusa,011,21464,3675,3664,1194,4858,22
2022-07-28,Contra Costa,013,1133247,236547,234635,18927,253562,1375
2022-07-28,Del Norte,015,27424,7155,7136,369,7505,54
2022-07-28,El Dorado,017,186661,31169,31007,4021,35028,222
2022-07-28,Fresno,019,978130,262383,260858,28013,288871,2805
2022-07-28,Glenn,021,27897,5364,5350,1798,7148,48
2022-07-28,Humboldt,023,135768,20620,20523,4407,24930,151
2022-07-28,Imperial,025,180216,62896,62471,14067,76538,949
2022-07-28,Inyo,027,18085,4403,4388,805,5193,57
2022-07-28,Kern,029,883053,211484,210190,54819,265009,2375
2022-07-28,Kings,031,150075,56946,56673,3862,60535,454
2022-07-28,Lake,033,64148,12153,12102,1083,13185,142
2022-07-28,Lassen,035,31185,9561,9548,959,10507,64
2022-07-28,Los Angeles,037,10098052,3142484,3122700,164467,3287167,32445
2022-07-28,Madera,039,155013,41869,41641,7402,49043,372
2022-07-28,Marin,041,260295,43097,42840,4928,47768,300
2022-07-28,Mariposa,043,17540,2953,2940,303,3243,30
2022-07-28,Mendocino,045,87422,15259,15172,4083,19255,132
2022-07-28,Merced,047,269075,69200,68853,10440,79293,838
2022-07-28,Modoc,049,8938,847,841,313,1154,11
2022-07-28,Mono,051,14174,3161,3155,221,3376,7
2022-07-28,Monterey,053,433212,90419,89974,18991,108965,754
2022-07-28,Napa,055,140530,30905,30777,1346,32123,150
2022-07-28,Nevada,057,99092,18257,18187,1656,19843,131
2022-07-28,Orange,059,3164182,639512,636403,56077,692480,7194
2022-07-28,Placer,061,380077,72832,72444,8952,81396,647
2022-07-28,Plumas,063,18699,3501,3490,427,3917,13
2022-07-28,Riverside,065,2383286,666476,662929,32938,695867,6543
2022-07-28,Sacramento,067,1510023,331132,329639,31891,361530,3156
2022-07-28,San Benito,069,59416,15300,15256,836,16092,100
2022-07-28,San Bernardino,071,2135413,637256,633131,28398,661529,7941
2022-07-28,San Diego,073,3302833,886510,881822,67121,948943,5409
2022-07-28,San Francisco,075,870044,170417,169564,11408,180972,937
2022-07-28,San Joaquin,077,732212,188852,187937,13003,200940,2276
2022-07-28,San Luis Obispo,079,281455,60748,60370,6485,66855,503
2022-07-28,San Mateo,081,765935,160090,159145,10115,169260,726
2022-07-28,Santa Barbara,083,443738,100510,99946,6147,106093,708
2022-07-28,Santa Clara,085,1922200,409734,407392,17819,425211,2381
2022-07-28,Santa Cruz,087,273765,59581,59227,3165,62392,269
2022-07-28,Shasta,089,179085,33642,33454,6949,40403,581
2022-07-28,Sierra,091,2930,295,293,58,351,4
2022-07-28,Siskiyou,093,43540,5020,4997,3182,8179,86
2022-07-28,Solano,095,438530,100198,99034,7230,106264,457
2022-07-28,Sonoma,097,501317,102182,101747,4824,106571,500
2022-07-28,Stanislaus,099,539301,131766,131081,19819,150900,1696
2022-07-28,Sutter,101,95872,22986,22931,2379,25310,228
2022-07-28,Tehama,103,63373,13142,13079,2914,15993,208
2022-07-28,Trinity,105,12862,1344,1340,344,1684,20
2022-07-28,Tulare,107,460477,117108,116640,32863,149503,1514
2022-07-28,Tuolumne,109,53932,14790,14701,872,15573,196
2022-07-28,Ventura,111,848112,199492,198498,13855,212353,1530
2022-07-28,Yolo,113,214977,45840,45511,4043,49554,327
2022-07-28,Yuba,115,75493,17994,17951,1558,19509,124
2022-07-27,Alameda,001,1643700,329212,325669,18990,344659,1938
2022-07-27,Alpine,003,1148,130,130,1,131,0
2022-07-27,Amador,005,37829,9625,9568,839,10407,87
2022-07-27,Butte,007,227075,37552,37146,8348,45494,441
2022-07-27,Calaveras,009,45235,8172,8105,470,8575,130
2022-07-27,Colusa,011,21464,3666,3649,1194,4843,22
2022-07-27,Contra Costa,013,1133247,236192,233236,18875,252111,1374
2022-07-27,Del Norte,015,27424,7151,7161,369,7530,54
2022-07-27,El Dorado,017,186661,31121,30891,4012,34903,222
2022-07-27,Fresno,019,978130,261965,259483,27944,287427,2801
2022-07-27,Glenn,021,27897,5360,5327,1797,7124,48
2022-07-27,Humboldt,023,135768,20580,20406,4398,24804,150
2022-07-27,Imperial,025,180216,62813,62014,14014,76028,948
2022-07-27,Inyo,027,18085,4399,4381,801,5182,57
2022-07-27,Kern,029,883053,211258,209400,54709,264109,2368
2022-07-27,Kings,031,150075,56871,56417,3854,60271,451
2022-07-27,Lake,033,64148,12137,12025,1081,13106,142
2022-07-27,Lassen,035,31185,9556,9509,958,10467,64
2022-07-27,Los Angeles,037,10098052,3137825,3107063,163994,3271057,32392
2022-07-27,Madera,039,155013,41781,41423,7389,48812,372
2022-07-27,Marin,041,260295,43025,42624,4919,47543,300
2022-07-27,Mariposa,043,17540,2948,2927,303,3230,30
2022-07-27,Mendocino,045,87422,15231,15066,4067,19133,131
2022-07-27,Merced,047,269075,69084,68455,10411,78866,838
2022-07-27,Modoc,049,8938,845,840,313,1153,10
2022-07-27,Mono,051,14174,3159,3148,218,3366,7
2022-07-27,Monterey,053,433212,90289,89520,18918,108438,752
2022-07-27,Napa,055,140530,30861,30647,1344,31991,150
2022-07-27,Nevada,057,99092,18239,18134,1655,19789,132
2022-07-27,Orange,059,3164182,638526,632871,55904,688775,7188
2022-07-27,Placer,061,380077,72751,72194,8931,81125,647
2022-07-27,Plumas,063,18699,3495,3472,427,3899,13
2022-07-27,Riverside,065,2383286,665472,659650,32858,692508,6528
2022-07-27,Sacramento,067,1510023,330673,328249,31836,360085,3146
2022-07-27,San Benito,069,59416,15280,15188,834,16022,100
2022-07-27,San Bernardino,071,2135413,636396,629895,28344,658239,7937
2022-07-27,San Diego,073,3302833,885057,876507,66984,943491,5386
2022-07-27,San Francisco,075,870044,170168,168570,11392,179962,931
2022-07-27,San Joaquin,077,732212,188567,187066,12969,200035,2267
2022-07-27,San Luis Obispo,079,281455,60673,60180,6451,66631,502
2022-07-27,San Mateo,081,765935,159843,158343,10105,168448,724
2022-07-27,Santa Barbara,083,443738,100361,99460,6111,105571,707
2022-07-27,Santa Clara,085,1922200,409042,404896,17799,422695,2380
2022-07-27,Santa Cruz,087,273765,59485,58873,3152,62025,269
2022-07-27,Shasta,089,179085,33609,33314,6939,40253,578
2022-07-27,Sierra,091,2930,294,293,58,351,4
2022-07-27,Siskiyou,093,43540,5007,4975,3178,8153,84
2022-07-27,Solano,095,438530,100034,98579,7220,105799,457
2022-07-27,Sonoma,097,501317,102044,101316,4811,106127,499
2022-07-27,Stanislaus,099,539301,131566,130451,19778,150229,1695
2022-07-27,Sutter,101,95872,22950,22811,2373,25184,228
2022-07-27,Tehama,103,63373,13129,13036,2908,15944,207
2022-07-27,Trinity,105,12862,1343,1337,343,1680,20
2022-07-27,Tulare,107,460477,116946,116167,32795,148962,1514
2022-07-27,Tuolumne,109,53932,14760,14594,869,15463,196
2022-07-27,Ventura,111,848112,199215,197572,13791,211363,1527
2022-07-27,Yolo,113,214977,45793,45359,4026,49385,326
2022-07-27,Yuba,115,75493,17970,17873,1550,19423,124
2022-07-26,Alameda,001,1643700,328579,325669,18941,344610,1938
2022-07-26,Alpine,003,1148,130,130,1,131,0
2022-07-26,Amador,005,37829,9616,9568,835,10403,87
2022-07-26,Butte,007,227075,37491,37146,8332,45478,441
2022-07-26,Calaveras,009,45235,8162,8105,468,8573,130
2022-07-26,Colusa,011,21464,3665,3649,1194,4843,22
2022-07-26,Contra Costa,013,1133247,235759,233236,18819,252055,1374
2022-07-26,Del Norte,015,27424,7138,7161,369,7530,54
2022-07-26,El Dorado,017,186661,31077,30891,4006,34897,222
2022-07-26,Fresno,019,978130,261426,259483,27862,287345,2801
2022-07-26,Glenn,021,27897,5358,5327,1793,7120,48
2022-07-26,Humboldt,023,135768,20548,20406,4383,24789,150
2022-07-26,Imperial,025,180216,62694,62014,13934,75948,948
2022-07-26,Inyo,027,18085,4396,4381,799,5180,57
2022-07-26,Kern,029,883053,210951,209400,54611,264011,2368
2022-07-26,Kings,031,150075,56755,56417,3852,60269,451
2022-07-26,Lake,033,64148,12107,12025,1080,13105,142
2022-07-26,Lassen,035,31185,9553,9509,956,10465,64
2022-07-26,Los Angeles,037,10098052,3132874,3107063,163428,3270491,32392
2022-07-26,Madera,039,155013,41716,41423,7365,48788,372
2022-07-26,Marin,041,260295,42959,42624,4907,47531,300
2022-07-26,Mariposa,043,17540,2946,2927,303,3230,30
2022-07-26,Mendocino,045,87422,15209,15066,4055,19121,131
2022-07-26,Merced,047,269075,68993,68455,10386,78841,838
2022-07-26,Modoc,049,8938,843,840,313,1153,10
2022-07-26,Mono,051,14174,3158,3148,217,3365,7
2022-07-26,Monterey,053,433212,90152,89520,18829,108349,752
2022-07-26,Napa,055,140530,30825,30647,1338,31985,150
2022-07-26,Nevada,057,99092,18216,18134,1652,19786,132
2022-07-26,Orange,059,3164182,637425,632871,55690,688561,7188
2022-07-26,Placer,061,380077,72633,72194,8912,81106,647
2022-07-26,Plumas,063,18699,3492,3472,426,3898,13
2022-07-26,Riverside,065,2383286,664450,659650,32778,692428,6528
2022-07-26,Sacramento,067,1510023,330139,328249,31772,360021,3146
2022-07-26,San Benito,069,59416,15250,15188,833,16021,100
2022-07-26,San Bernardino,071,2135413,635442,629895,28278,658173,7937
2022-07-26,San Diego,073,3302833,883369,876507,66807,943314,5386
2022-07-26,San Francisco,075,870044,169883,168570,11378,179948,931
2022-07-26,San Joaquin,077,732212,188270,187066,12929,199995,2267
2022-07-26,San Luis Obispo,079,281455,60598,60180,6423,66603,502
2022-07-26,San Mateo,081,765935,159560,158343,10094,168437,724
2022-07-26,Santa Barbara,083,443738,100182,99460,6087,105547,707
2022-07-26,Santa Clara,085,1922200,408189,404896,17761,422657,2380
2022-07-26,Santa Cruz,087,273765,59381,58873,3136,62009,269
2022-07-26,Shasta,089,179085,33579,33314,6923,40237,578
2022-07-26,Sierra,091,2930,293,293,58,351,4
2022-07-26,Siskiyou,093,43540,5002,4975,3170,8145,84
2022-07-26,Solano,095,438530,99845,98579,7202,105781,457
2022-07-26,Sonoma,097,501317,101899,101316,4782,106098,499
2022-07-26,Stanislaus,099,539301,131354,130451,19753,150204,1695
2022-07-26,Sutter,101,95872,22920,22811,2372,25183,228
2022-07-26,Tehama,103,63373,13111,13036,2903,15939,207
2022-07-26,Trinity,105,12862,1342,1337,341,1678,20
2022-07-26,Tulare,107,460477,116797,116167,32709,148876,1514
2022-07-26,Tuolumne,109,53932,14740,14594,867,15461,196
2022-07-26,Ventura,111,848112,198907,197572,13734,211306,1527
2022-07-26,Yolo,113,214977,45745,45359,4015,49374,326
2022-07-26,Yuba,115,75493,17952,17873,1549,19422,124
2022-07-25,Alameda,001,1643700,327848,325669,18871,344540,1938
2022-07-25,Alpine,003,1148,130,130,1,131,0
2022-07-25,Amador,005,37829,9603,9568,832,10400,87
2022-07-25,Butte,007,227075,37417,37146,8317,45463,441
2022-07-25,Calaveras,009,45235,8151,8105,467,8572,130
2022-07-25,Colusa,011,21464,3664,3649,1191,4840,22
2022-07-25,Contra Costa,013,1133247,235277,233236,18736,251972,1374
2022-07-25,Del Norte,015,27424,7131,7161,368,7529,54
2022-07-25,El Dorado,017,186661,31038,30891,3992,34883,222
2022-07-25,Fresno,019,978130,260850,259483,27777,287260,2801
2022-07-25,Glenn,021,27897,5349,5327,1790,7117,48
2022-07-25,Humboldt,023,135768,20514,20406,4362,24768,150
2022-07-25,Imperial,025,180216,62574,62014,13849,75863,948
2022-07-25,Inyo,027,18085,4393,4381,793,5174,57
2022-07-25,Kern,029,883053,210664,209400,54492,263892,2368
2022-07-25,Kings,031,150075,56620,56417,3842,60259,451
2022-07-25,Lake,033,64148,12086,12025,1079,13104,142
2022-07-25,Lassen,035,31185,9546,9509,955,10464,64
2022-07-25,Los Angeles,037,10098052,3127108,3107063,162898,3269961,32392
2022-07-25,Madera,039,155013,41628,41423,7340,48763,372
2022-07-25,Marin,041,260295,42885,42624,4900,47524,300
2022-07-25,Mariposa,043,17540,2943,2927,300,3227,30
2022-07-25,Mendocino,045,87422,15172,15066,4043,19109,131
2022-07-25,Merced,047,269075,68879,68455,10357,78812,838
2022-07-25,Modoc,049,8938,838,840,311,1151,10
2022-07-25,Mono,051,14174,3156,3148,217,3365,7
2022-07-25,Monterey,053,433212,89999,89520,18721,108241,752
2022-07-25,Napa,055,140530,30781,30647,1337,31984,150
2022-07-25,Nevada,057,99092,18204,18134,1644,19778,132
2022-07-25,Orange,059,3164182,636177,632871,55489,688360,7188
2022-07-25,Placer,061,380077,72551,72194,8906,81100,647
2022-07-25,Plumas,063,18699,3486,3472,425,3897,13
2022-07-25,Riverside,065,2383286,663366,659650,32699,692349,6528
2022-07-25,Sacramento,067,1510023,329606,328249,31710,359959,3146
2022-07-25,San Benito,069,59416,15218,15188,831,16019,100
2022-07-25,San Bernardino,071,2135413,634291,629895,28227,658122,7937
2022-07-25,San Diego,073,3302833,881583,876507,66621,943128,5386
2022-07-25,San Francisco,075,870044,169571,168570,11364,179934,931
2022-07-25,San Joaquin,077,732212,187984,187066,12861,199927,2267
2022-07-25,San Luis Obispo,079,281455,60495,60180,6391,66571,502
2022-07-25,San Mateo,081,765935,159195,158343,10072,168415,724
2022-07-25,Santa Barbara,083,443738,99989,99460,6062,105522,707
2022-07-25,Santa Clara,085,1922200,407300,404896,17682,422578,2380
2022-07-25,Santa Cruz,087,273765,59260,58873,3123,61996,269
2022-07-25,Shasta,089,179085,33528,33314,6915,40229,578
2022-07-25,Sierra,091,2930,292,293,58,351,4
2022-07-25,Siskiyou,093,43540,4996,4975,3161,8136,84
2022-07-25,Solano,095,438530,99599,98579,7186,105765,457
2022-07-25,Sonoma,097,501317,101740,101316,4764,106080,499
2022-07-25,Stanislaus,099,539301,131159,130451,19727,150178,1695
2022-07-25,Sutter,101,95872,22873,22811,2371,25182,228
2022-07-25,Tehama,103,63373,13094,13036,2895,15931,207
2022-07-25,Trinity,105,12862,1340,1337,341,1678,20
2022-07-25,Tulare,107,460477,116585,116167,32620,148787,1514
2022-07-25,Tuolumne,109,53932,14721,14594,867,15461,196
2022-07-25,Ventura,111,848112,198601,197572,13679,211251,1527
2022-07-25,Yolo,113,214977,45682,45359,4000,49359,326
2022-07-25,Yuba,115,75493,17914,17873,1548,19421,124
2022-07-24,Alameda,001,1643700,327046,323165,18828,341993,1933
2022-07-24,Alpine,003,1148,130,130,1,131,0
2022-07-24,Amador,005,37829,9581,9526,829,10355,87
2022-07-24,Butte,007,227075,37354,36994,8292,45286,440
2022-07-24,Calaveras,009,45235,8134,8064,465,8529,128
2022-07-24,Colusa,011,21464,3658,3639,1191,4830,22
2022-07-24,Contra Costa,013,1133247,234744,231714,18656,250370,1363
2022-07-24,Del Norte,015,27424,7113,7128,363,7491,54
2022-07-24,El Dorado,017,186661,30990,30722,3975,34697,222
2022-07-24,Fresno,019,978130,260200,257571,27689,285260,2792
2022-07-24,Glenn,021,27897,5343,5311,1788,7099,48
2022-07-24,Humboldt,023,135768,20481,20283,4345,24628,150
2022-07-24,Imperial,025,180216,62411,61671,13728,75399,948
2022-07-24,Inyo,027,18085,4389,4366,782,5148,57
2022-07-24,Kern,029,883053,210302,208535,54362,262897,2366
2022-07-24,Kings,031,150075,56495,56103,3829,59932,451
2022-07-24,Lake,033,64148,12060,11957,1076,13033,142
2022-07-24,Lassen,035,31185,9520,9504,952,10456,64
2022-07-24,Los Angeles,037,10098052,3120707,3085376,162236,3247612,32340
2022-07-24,Madera,039,155013,41531,41145,7310,48455,372
2022-07-24,Marin,041,260295,42817,42347,4888,47235,300
2022-07-24,Mariposa,043,17540,2940,2897,299,3196,30
2022-07-24,Mendocino,045,87422,15122,14988,4011,18999,131
2022-07-24,Merced,047,269075,68722,68127,10303,78430,837
2022-07-24,Modoc,049,8938,838,829,310,1139,10
2022-07-24,Mono,051,14174,3155,3141,217,3358,7
2022-07-24,Monterey,053,433212,89827,89067,18621,107688,747
2022-07-24,Napa,055,140530,30728,30495,1336,31831,148
2022-07-24,Nevada,057,99092,18185,18073,1635,19708,131
2022-07-24,Orange,059,3164182,634832,627948,55250,683198,7181
2022-07-24,Placer,061,380077,72428,71870,8893,80763,644
2022-07-24,Plumas,063,18699,3485,3464,425,3889,13
2022-07-24,Riverside,065,2383286,662079,655603,32586,688189,6527
2022-07-24,Sacramento,067,1510023,328923,326216,31641,357857,3136
2022-07-24,San Benito,069,59416,15197,15049,831,15880,100
2022-07-24,San Bernardino,071,2135413,632935,626059,28150,654209,7933
2022-07-24,San Diego,073,3302833,879506,870102,66432,936534,5380
2022-07-24,San Francisco,075,870044,169123,167260,11334,178594,931
2022-07-24,San Joaquin,077,732212,187620,186142,12795,198937,2267
2022-07-24,San Luis Obispo,079,281455,60350,59919,6358,66277,500
2022-07-24,San Mateo,081,765935,158859,157266,10048,167314,724
2022-07-24,Santa Barbara,083,443738,99763,98826,6022,104848,706
2022-07-24,Santa Clara,085,1922200,406345,401495,17642,419137,2381
2022-07-24,Santa Cruz,087,273765,59088,58386,3102,61488,268
2022-07-24,Shasta,089,179085,33466,33185,6900,40085,578
2022-07-24,Sierra,091,2930,292,293,58,351,4
2022-07-24,Siskiyou,093,43540,4992,4938,3145,8083,84
2022-07-24,Solano,095,438530,99386,98016,7172,105188,457
2022-07-24,Sonoma,097,501317,101537,100735,4744,105479,499
2022-07-24,Stanislaus,099,539301,130867,129813,19692,149505,1695
2022-07-24,Sutter,101,95872,22823,22687,2368,25055,228
2022-07-24,Tehama,103,63373,13083,12974,2885,15859,207
2022-07-24,Trinity,105,12862,1339,1330,339,1669,20
2022-07-24,Tulare,107,460477,116397,115548,32521,148069,1513
2022-07-24,Tuolumne,109,53932,14687,14514,866,15380,196
2022-07-24,Ventura,111,848112,198192,196127,13578,209705,1525
2022-07-24,Yolo,113,214977,45607,45141,3988,49129,327
2022-07-24,Yuba,115,75493,17887,17770,1546,19316,124
2022-07-23,Alameda,001,1643700,326632,323165,18807,341972,1933
2022-07-23,Alpine,003,1148,130,130,1,131,0
2022-07-23,Amador,005,37829,9571,9526,829,10355,87
2022-07-23,Butte,007,227075,37305,36994,8285,45279,440
2022-07-23,Calaveras,009,45235,8123,8064,465,8529,128
2022-07-23,Colusa,011,21464,3653,3639,1191,4830,22
2022-07-23,Contra Costa,013,1133247,234450,231714,18626,250340,1363
2022-07-23,Del Norte,015,27424,7110,7128,362,7490,54
2022-07-23,El Dorado,017,186661,30972,30722,3973,34695,222
2022-07-23,Fresno,019,978130,259977,257571,27656,285227,2792
2022-07-23,Glenn,021,27897,5341,5311,1786,7097,48
2022-07-23,Humboldt,023,135768,20454,20283,4332,24615,150
2022-07-23,Imperial,025,180216,62349,61671,13706,75377,948
2022-07-23,Inyo,027,18085,4387,4366,781,5147,57
2022-07-23,Kern,029,883053,210137,208535,54297,262832,2366
2022-07-23,Kings,031,150075,56452,56103,3826,59929,451
2022-07-23,Lake,033,64148,12049,11957,1075,13032,142
2022-07-23,Lassen,035,31185,9518,9504,952,10456,64
2022-07-23,Los Angeles,037,10098052,3117905,3085376,161804,3247180,32340
2022-07-23,Madera,039,155013,41472,41145,7305,48450,372
2022-07-23,Marin,041,260295,42742,42347,4878,47225,300
2022-07-23,Mariposa,043,17540,2937,2897,299,3196,30
2022-07-23,Mendocino,045,87422,15102,14988,4004,18992,131
2022-07-23,Merced,047,269075,68654,68127,10286,78413,837
2022-07-23,Modoc,049,8938,838,829,310,1139,10
2022-07-23,Mono,051,14174,3155,3141,217,3358,7
2022-07-23,Monterey,053,433212,89742,89067,18600,107667,747
2022-07-23,Napa,055,140530,30695,30495,1335,31830,148
2022-07-23,Nevada,057,99092,18173,18073,1633,19706,131
2022-07-23,Orange,059,3164182,634128,627948,55065,683013,7181
2022-07-23,Placer,061,380077,72355,71870,8883,80753,644
2022-07-23,Plumas,063,18699,3484,3464,425,3889,13
2022-07-23,Riverside,065,2383286,661374,655603,32546,688149,6527
2022-07-23,Sacramento,067,1510023,328654,326216,31626,357842,3136
2022-07-23,San Benito,069,59416,15187,15049,821,15870,100
2022-07-23,San Bernardino,071,2135413,632336,626059,28110,654169,7933
2022-07-23,San Diego,073,3302833,878685,870102,66377,936479,5380
2022-07-23,San Francisco,075,870044,168928,167260,11319,178579,931
2022-07-23,San Joaquin,077,732212,187466,186142,12774,198916,2267
2022-07-23,San Luis Obispo,079,281455,60320,59919,6347,66266,500
2022-07-23,San Mateo,081,765935,158683,157266,10034,167300,724
2022-07-23,Santa Barbara,083,443738,99663,98826,5991,104817,706
2022-07-23,Santa Clara,085,1922200,405732,401495,17617,419112,2381
2022-07-23,Santa Cruz,087,273765,59037,58386,3090,61476,268
2022-07-23,Shasta,089,179085,33427,33185,6894,40079,578
2022-07-23,Sierra,091,2930,292,293,58,351,4
2022-07-23,Siskiyou,093,43540,4988,4938,3143,8081,84
2022-07-23,Solano,095,438530,99322,98016,7166,105182,457
2022-07-23,Sonoma,097,501317,101449,100735,4734,105469,499
2022-07-23,Stanislaus,099,539301,130736,129813,19658,149471,1695
2022-07-23,Sutter,101,95872,22802,22687,2368,25055,228
2022-07-23,Tehama,103,63373,13069,12974,2882,15856,207
2022-07-23,Trinity,105,12862,1339,1330,338,1668,20
2022-07-23,Tulare,107,460477,116281,115548,32452,148000,1513
2022-07-23,Tuolumne,109,53932,14664,14514,866,15380,196
2022-07-23,Ventura,111,848112,198008,196127,13545,209672,1525
2022-07-23,Yolo,113,214977,45573,45141,3980,49121,327
2022-07-23,Yuba,115,75493,17874,17770,1542,19312,124
2022-07-22,Alameda,001,1643700,326221,323165,18764,341929,1933
2022-07-22,Alpine,003,1148,130,130,1,131,0
2022-07-22,Amador,005,37829,9565,9526,828,10354,87
2022-07-22,Butte,007,227075,37270,36994,8270,45264,440
2022-07-22,Calaveras,009,45235,8114,8064,465,8529,128
2022-07-22,Colusa,011,21464,3652,3639,1187,4826,22
2022-07-22,Contra Costa,013,1133247,234159,231714,18589,250303,1363
2022-07-22,Del Norte,015,27424,7103,7128,362,7490,54
2022-07-22,El Dorado,017,186661,30943,30722,3968,34690,222
2022-07-22,Fresno,019,978130,259701,257571,27616,285187,2792
2022-07-22,Glenn,021,27897,5336,5311,1785,7096,48
2022-07-22,Humboldt,023,135768,20432,20283,4322,24605,150
2022-07-22,Imperial,025,180216,62258,61671,13674,75345,948
2022-07-22,Inyo,027,18085,4387,4366,774,5140,57
2022-07-22,Kern,029,883053,209939,208535,54233,262768,2366
2022-07-22,Kings,031,150075,56416,56103,3825,59928,451
2022-07-22,Lake,033,64148,12035,11957,1073,13030,142
2022-07-22,Lassen,035,31185,9518,9504,952,10456,64
2022-07-22,Los Angeles,037,10098052,3114431,3085376,161363,3246739,32340
2022-07-22,Madera,039,155013,41429,41145,7293,48438,372
2022-07-22,Marin,041,260295,42689,42347,4870,47217,300
2022-07-22,Mariposa,043,17540,2935,2897,299,3196,30
2022-07-22,Mendocino,045,87422,15078,14988,3999,18987,131
2022-07-22,Merced,047,269075,68581,68127,10274,78401,837
2022-07-22,Modoc,049,8938,838,829,310,1139,10
2022-07-22,Mono,051,14174,3154,3141,216,3357,7
2022-07-22,Monterey,053,433212,89653,89067,18566,107633,747
2022-07-22,Napa,055,140530,30664,30495,1335,31830,148
2022-07-22,Nevada,057,99092,18161,18073,1626,19699,131
2022-07-22,Orange,059,3164182,633355,627948,54914,682862,7181
2022-07-22,Placer,061,380077,72310,71870,8875,80745,644
2022-07-22,Plumas,063,18699,3483,3464,425,3889,13
2022-07-22,Riverside,065,2383286,660633,655603,32481,688084,6527
2022-07-22,Sacramento,067,1510023,328300,326216,31599,357815,3136
2022-07-22,San Benito,069,59416,15178,15049,821,15870,100
2022-07-22,San Bernardino,071,2135413,631735,626059,28067,654126,7933
2022-07-22,San Diego,073,3302833,877604,870102,66250,936352,5380
2022-07-22,San Francisco,075,870044,168732,167260,11291,178551,931
2022-07-22,San Joaquin,077,732212,187312,186142,12747,198889,2267
2022-07-22,San Luis Obispo,079,281455,60264,59919,6335,66254,500
2022-07-22,San Mateo,081,765935,158455,157266,10021,167287,724
2022-07-22,Santa Barbara,083,443738,99562,98826,5985,104811,706
2022-07-22,Santa Clara,085,1922200,405078,401495,17591,419086,2381
2022-07-22,Santa Cruz,087,273765,58931,58386,3082,61468,268
2022-07-22,Shasta,089,179085,33396,33185,6889,40074,578
2022-07-22,Sierra,091,2930,292,293,58,351,4
2022-07-22,Siskiyou,093,43540,4981,4938,3140,8078,84
2022-07-22,Solano,095,438530,99184,98016,7156,105172,457
2022-07-22,Sonoma,097,501317,101352,100735,4711,105446,499
2022-07-22,Stanislaus,099,539301,130607,129813,19641,149454,1695
2022-07-22,Sutter,101,95872,22778,22687,2367,25054,228
2022-07-22,Tehama,103,63373,13060,12974,2880,15854,207
2022-07-22,Trinity,105,12862,1337,1330,337,1667,20
2022-07-22,Tulare,107,460477,116169,115548,32391,147939,1513
2022-07-22,Tuolumne,109,53932,14641,14514,862,15376,196
2022-07-22,Ventura,111,848112,197822,196127,13511,209638,1525
2022-07-22,Yolo,113,214977,45519,45141,3962,49103,327
2022-07-22,Yuba,115,75493,17860,17770,1540,19310,124
2022-07-21,Alameda,001,1643700,325544,323165,18714,341879,1933
2022-07-21,Alpine,003,1148,130,130,1,131,0
2022-07-21,Amador,005,37829,9558,9526,826,10352,87
2022-07-21,Butte,007,227075,37228,36994,8251,45245,440
2022-07-21,Calaveras,009,45235,8099,8064,463,8527,128
2022-07-21,Colusa,011,21464,3648,3639,1185,4824,22
2022-07-21,Contra Costa,013,1133247,233772,231714,18533,250247,1363
2022-07-21,Del Norte,015,27424,7093,7128,362,7490,54
2022-07-21,El Dorado,017,186661,30892,30722,3965,34687,222
2022-07-21,Fresno,019,978130,259228,257571,27541,285112,2792
2022-07-21,Glenn,021,27897,5330,5311,1785,7096,48
2022-07-21,Humboldt,023,135768,20400,20283,4299,24582,150
2022-07-21,Imperial,025,180216,62145,61671,13576,75247,948
2022-07-21,Inyo,027,18085,4383,4366,767,5133,57
2022-07-21,Kern,029,883053,209664,208535,54148,262683,2366
2022-07-21,Kings,031,150075,56343,56103,3812,59915,451
2022-07-21,Lake,033,64148,12022,11957,1070,13027,142
2022-07-21,Lassen,035,31185,9515,9504,952,10456,64
2022-07-21,Los Angeles,037,10098052,3108892,3085376,160759,3246135,32340
2022-07-21,Madera,039,155013,41354,41145,7271,48416,372
2022-07-21,Marin,041,260295,42624,42347,4867,47214,300
2022-07-21,Mariposa,043,17540,2931,2897,298,3195,30
2022-07-21,Mendocino,045,87422,15052,14988,3993,18981,131
2022-07-21,Merced,047,269075,68479,68127,10248,78375,837
2022-07-21,Modoc,049,8938,836,829,310,1139,10
2022-07-21,Mono,051,14174,3150,3141,215,3356,7
2022-07-21,Monterey,053,433212,89529,89067,18491,107558,747
2022-07-21,Napa,055,140530,30620,30495,1335,31830,148
2022-07-21,Nevada,057,99092,18143,18073,1620,19693,131
2022-07-21,Orange,059,3164182,632227,627948,54695,682643,7181
2022-07-21,Placer,061,380077,72202,71870,8853,80723,644
2022-07-21,Plumas,063,18699,3482,3464,425,3889,13
2022-07-21,Riverside,065,2383286,659572,655603,32408,688011,6527
2022-07-21,Sacramento,067,1510023,327788,326216,31559,357775,3136
2022-07-21,San Benito,069,59416,15135,15049,818,15867,100
2022-07-21,San Bernardino,071,2135413,630724,626059,28003,654062,7933
2022-07-21,San Diego,073,3302833,875916,870102,66057,936159,5380
2022-07-21,San Francisco,075,870044,168374,167260,11238,178498,931
2022-07-21,San Joaquin,077,732212,187059,186142,12719,198861,2267
2022-07-21,San Luis Obispo,079,281455,60209,59919,6305,66224,500
2022-07-21,San Mateo,081,765935,158160,157266,10006,167272,724
2022-07-21,Santa Barbara,083,443738,99401,98826,5965,104791,706
2022-07-21,Santa Clara,085,1922200,404279,401495,17553,419048,2381
2022-07-21,Santa Cruz,087,273765,58813,58386,3067,61453,268
2022-07-21,Shasta,089,179085,33346,33185,6875,40060,578
2022-07-21,Sierra,091,2930,292,293,58,351,4
2022-07-21,Siskiyou,093,43540,4970,4938,3134,8072,84
2022-07-21,Solano,095,438530,99042,98016,7148,105164,457
2022-07-21,Sonoma,097,501317,101208,100735,4696,105431,499
2022-07-21,Stanislaus,099,539301,130415,129813,19622,149435,1695
2022-07-21,Sutter,101,95872,22750,22687,2365,25052,228
2022-07-21,Tehama,103,63373,13043,12974,2869,15843,207
2022-07-21,Trinity,105,12862,1333,1330,337,1667,20
2022-07-21,Tulare,107,460477,116016,115548,32317,147865,1513
2022-07-21,Tuolumne,109,53932,14609,14514,859,15373,196
2022-07-21,Ventura,111,848112,197496,196127,13421,209548,1525
2022-07-21,Yolo,113,214977,45458,45141,3949,49090,327
2022-07-21,Yuba,115,75493,17832,17770,1537,19307,124
2022-07-20,Alameda,001,1643700,324867,321347,18648,339995,1915
2022-07-20,Alpine,003,1148,130,130,1,131,0
2022-07-20,Amador,005,37829,9540,9478,824,10302,87
2022-07-20,Butte,007,227075,37179,36820,8231,45051,440
2022-07-20,Calaveras,009,45235,8090,8035,462,8497,126
2022-07-20,Colusa,011,21464,3644,3627,1183,4810,22
2022-07-20,Contra Costa,013,1133247,233369,230356,18484,248840,1362
2022-07-20,Del Norte,015,27424,7084,7081,362,7443,54
2022-07-20,El Dorado,017,186661,30860,30628,3955,34583,221
2022-07-20,Fresno,019,978130,258717,256217,27476,283693,2790
2022-07-20,Glenn,021,27897,5326,5287,1782,7069,48
2022-07-20,Humboldt,023,135768,20361,20149,4279,24428,150
2022-07-20,Imperial,025,180216,62001,61170,13484,74654,944
2022-07-20,Inyo,027,18085,4381,4355,762,5117,56
2022-07-20,Kern,029,883053,209379,207603,54053,261656,2366
2022-07-20,Kings,031,150075,56259,55836,3801,59637,449
2022-07-20,Lake,033,64148,12001,11895,1067,12962,142
2022-07-20,Lassen,035,31185,9506,9455,952,10407,64
2022-07-20,Los Angeles,037,10098052,3103377,3068779,160159,3228938,32292
2022-07-20,Madera,039,155013,41281,40902,7251,48153,372
2022-07-20,Marin,041,260295,42543,42153,4860,47013,300
2022-07-20,Mariposa,043,17540,2916,2884,296,3180,30
2022-07-20,Mendocino,045,87422,15037,14890,3984,18874,131
2022-07-20,Merced,047,269075,68382,67775,10223,77998,833
2022-07-20,Modoc,049,8938,835,799,309,1108,9
2022-07-20,Mono,051,14174,3147,3138,212,3350,7
2022-07-20,Monterey,053,433212,89392,88606,18409,107015,747
2022-07-20,Napa,055,140530,30582,30353,1333,31686,145
2022-07-20,Nevada,057,99092,18117,18020,1616,19636,131
2022-07-20,Orange,059,3164182,630960,624998,54462,679460,7173
2022-07-20,Placer,061,380077,72120,71614,8835,80449,639
2022-07-20,Plumas,063,18699,3476,3433,424,3857,13
2022-07-20,Riverside,065,2383286,658480,652192,32309,684501,6510
2022-07-20,Sacramento,067,1510023,327236,324765,31514,356279,3123
2022-07-20,San Benito,069,59416,15103,14966,815,15781,100
2022-07-20,San Bernardino,071,2135413,629711,622760,27945,650705,7921
2022-07-20,San Diego,073,3302833,874086,864434,65879,930313,5375
2022-07-20,San Francisco,075,870044,168036,166241,11220,177461,929
2022-07-20,San Joaquin,077,732212,186771,185319,12683,198002,2262
2022-07-20,San Luis Obispo,079,281455,60138,59727,6276,66003,499
2022-07-20,San Mateo,081,765935,157874,156191,9981,166172,724
2022-07-20,Santa Barbara,083,443738,99230,98322,5937,104259,703
2022-07-20,Santa Clara,085,1922200,403472,398816,17515,416331,2374
2022-07-20,Santa Cruz,087,273765,58698,58004,3054,61058,267
2022-07-20,Shasta,089,179085,33304,33017,6869,39886,576
2022-07-20,Sierra,091,2930,292,292,58,350,4
2022-07-20,Siskiyou,093,43540,4955,4921,3127,8048,84
2022-07-20,Solano,095,438530,98878,97577,7128,104705,459
2022-07-20,Sonoma,097,501317,101021,100304,4684,104988,499
2022-07-20,Stanislaus,099,539301,130249,129200,19590,148790,1695
2022-07-20,Sutter,101,95872,22715,22592,2362,24954,228
2022-07-20,Tehama,103,63373,13027,12923,2865,15788,205
2022-07-20,Trinity,105,12862,1333,1319,336,1655,20
2022-07-20,Tulare,107,460477,115835,115073,32206,147279,1510
2022-07-20,Tuolumne,109,53932,14583,14389,858,15247,196
2022-07-20,Ventura,111,848112,197177,195189,13349,208538,1522
2022-07-20,Yolo,113,214977,45402,44950,3939,48889,325
2022-07-20,Yuba,115,75493,17808,17661,1536,19197,124
2022-07-19,Alameda,001,1643700,324191,321347,18615,339962,1915
2022-07-19,Alpine,003,1148,130,130,1,131,0
2022-07-19,Amador,005,37829,9528,9478,820,10298,87
2022-07-19,Butte,007,227075,37127,36820,8217,45037,440
2022-07-19,Calaveras,009,45235,8080,8035,462,8497,126
2022-07-19,Colusa,011,21464,3641,3627,1179,4806,22
2022-07-19,Contra Costa,013,1133247,232924,230356,18425,248781,1362
2022-07-19,Del Norte,015,27424,7076,7081,361,7442,54
2022-07-19,El Dorado,017,186661,30815,30628,3946,34574,221
2022-07-19,Fresno,019,978130,258116,256217,27399,283616,2790
2022-07-19,Glenn,021,27897,5319,5287,1781,7068,48
2022-07-19,Humboldt,023,135768,20326,20149,4265,24414,150
2022-07-19,Imperial,025,180216,61865,61170,13395,74565,944
2022-07-19,Inyo,027,18085,4379,4355,760,5115,56
2022-07-19,Kern,029,883053,209107,207603,53952,261555,2366
2022-07-19,Kings,031,150075,56156,55836,3782,59618,449
2022-07-19,Lake,033,64148,11980,11895,1059,12954,142
2022-07-19,Lassen,035,31185,9498,9455,952,10407,64
2022-07-19,Los Angeles,037,10098052,3097307,3068779,159474,3228253,32292
2022-07-19,Madera,039,155013,41201,40902,7228,48130,372
2022-07-19,Marin,041,260295,42480,42153,4847,47000,300
2022-07-19,Mariposa,043,17540,2911,2884,295,3179,30
2022-07-19,Mendocino,045,87422,15005,14890,3977,18867,131
2022-07-19,Merced,047,269075,68278,67775,10192,77967,833
2022-07-19,Modoc,049,8938,834,799,309,1108,9
2022-07-19,Mono,051,14174,3142,3138,211,3349,7
2022-07-19,Monterey,053,433212,89242,88606,18328,106934,747
2022-07-19,Napa,055,140530,30525,30353,1329,31682,145
2022-07-19,Nevada,057,99092,18103,18020,1609,19629,131
2022-07-19,Orange,059,3164182,629668,624998,54212,679210,7173
2022-07-19,Placer,061,380077,72034,71614,8819,80433,639
2022-07-19,Plumas,063,18699,3470,3433,422,3855,13
2022-07-19,Riverside,065,2383286,657175,652192,32215,684407,6510
2022-07-19,Sacramento,067,1510023,326608,324765,31474,356239,3123
2022-07-19,San Benito,069,59416,15059,14966,813,15779,100
2022-07-19,San Bernardino,071,2135413,628618,622760,27876,650636,7921
2022-07-19,San Diego,073,3302833,871982,864434,65653,930087,5375
2022-07-19,San Francisco,075,870044,167678,166241,11201,177442,929
2022-07-19,San Joaquin,077,732212,186495,185319,12627,197946,2262
2022-07-19,San Luis Obispo,079,281455,60055,59727,6238,65965,499
2022-07-19,San Mateo,081,765935,157580,156191,9957,166148,724
2022-07-19,Santa Barbara,083,443738,99019,98322,5915,104237,703
2022-07-19,Santa Clara,085,1922200,402528,398816,17468,416284,2374
2022-07-19,Santa Cruz,087,273765,58576,58004,3039,61043,267
2022-07-19,Shasta,089,179085,33272,33017,6855,39872,576
2022-07-19,Sierra,091,2930,292,292,58,350,4
2022-07-19,Siskiyou,093,43540,4948,4921,3120,8041,84
2022-07-19,Solano,095,438530,98654,97577,7103,104680,459
2022-07-19,Sonoma,097,501317,100865,100304,4657,104961,499
2022-07-19,Stanislaus,099,539301,130006,129200,19562,148762,1695
2022-07-19,Sutter,101,95872,22685,22592,2360,24952,228
2022-07-19,Tehama,103,63373,13013,12923,2858,15781,205
2022-07-19,Trinity,105,12862,1330,1319,335,1654,20
2022-07-19,Tulare,107,460477,115649,115073,32098,147171,1510
2022-07-19,Tuolumne,109,53932,14559,14389,849,15238,196
2022-07-19,Ventura,111,848112,196830,195189,13274,208463,1522
2022-07-19,Yolo,113,214977,45341,44950,3930,48880,325
2022-07-19,Yuba,115,75493,17775,17661,1535,19196,124
2022-07-18,Alameda,001,1643700,323451,321347,18579,339926,1915
2022-07-18,Alpine,003,1148,130,130,1,131,0
2022-07-18,Amador,005,37829,9513,9478,820,10298,87
2022-07-18,Butte,007,227075,37057,36820,8205,45025,440
2022-07-18,Calaveras,009,45235,8069,8035,459,8494,126
2022-07-18,Colusa,011,21464,3638,3627,1173,4800,22
2022-07-18,Contra Costa,013,1133247,232461,230356,18354,248710,1362
2022-07-18,Del Norte,015,27424,7065,7081,359,7440,54
2022-07-18,El Dorado,017,186661,30763,30628,3937,34565,221
2022-07-18,Fresno,019,978130,257527,256217,27327,283544,2790
2022-07-18,Glenn,021,27897,5317,5287,1781,7068,48
2022-07-18,Humboldt,023,135768,20285,20149,4245,24394,150
2022-07-18,Imperial,025,180216,61700,61170,13297,74467,944
2022-07-18,Inyo,027,18085,4375,4355,759,5114,56
2022-07-18,Kern,029,883053,208802,207603,53826,261429,2366
2022-07-18,Kings,031,150075,56049,55836,3774,59610,449
2022-07-18,Lake,033,64148,11958,11895,1053,12948,142
2022-07-18,Lassen,035,31185,9494,9455,951,10406,64
2022-07-18,Los Angeles,037,10098052,3090576,3068779,158830,3227609,32292
2022-07-18,Madera,039,155013,41093,40902,7200,48102,372
2022-07-18,Marin,041,260295,42402,42153,4836,46989,300
2022-07-18,Mariposa,043,17540,2903,2884,294,3178,30
2022-07-18,Mendocino,045,87422,14976,14890,3966,18856,131
2022-07-18,Merced,047,269075,68156,67775,10166,77941,833
2022-07-18,Modoc,049,8938,833,799,309,1108,9
2022-07-18,Mono,051,14174,3141,3138,210,3348,7
2022-07-18,Monterey,053,433212,89079,88606,18249,106855,747
2022-07-18,Napa,055,140530,30485,30353,1326,31679,145
2022-07-18,Nevada,057,99092,18089,18020,1598,19618,131
2022-07-18,Orange,059,3164182,628187,624998,53972,678970,7173
2022-07-18,Placer,061,380077,71948,71614,8803,80417,639
2022-07-18,Plumas,063,18699,3461,3433,421,3854,13
2022-07-18,Riverside,065,2383286,655893,652192,32103,684295,6510
2022-07-18,Sacramento,067,1510023,325984,324765,31410,356175,3123
2022-07-18,San Benito,069,59416,15020,14966,808,15774,100
2022-07-18,San Bernardino,071,2135413,627407,622760,27811,650571,7921
2022-07-18,San Diego,073,3302833,869668,864434,65381,929815,5375
2022-07-18,San Francisco,075,870044,167256,166241,11178,177419,929
2022-07-18,San Joaquin,077,732212,186163,185319,12583,197902,2262
2022-07-18,San Luis Obispo,079,281455,59962,59727,6212,65939,499
2022-07-18,San Mateo,081,765935,157212,156191,9938,166129,724
2022-07-18,Santa Barbara,083,443738,98839,98322,5894,104216,703
2022-07-18,Santa Clara,085,1922200,401550,398816,17417,416233,2374
2022-07-18,Santa Cruz,087,273765,58427,58004,3027,61031,267
2022-07-18,Shasta,089,179085,33229,33017,6839,39856,576
2022-07-18,Sierra,091,2930,292,292,58,350,4
2022-07-18,Siskiyou,093,43540,4944,4921,3113,8034,84
2022-07-18,Solano,095,438530,98421,97577,7088,104665,459
2022-07-18,Sonoma,097,501317,100690,100304,4639,104943,499
2022-07-18,Stanislaus,099,539301,129785,129200,19525,148725,1695
2022-07-18,Sutter,101,95872,22651,22592,2360,24952,228
2022-07-18,Tehama,103,63373,12992,12923,2858,15781,205
2022-07-18,Trinity,105,12862,1328,1319,334,1653,20
2022-07-18,Tulare,107,460477,115458,115073,32009,147082,1510
2022-07-18,Tuolumne,109,53932,14523,14389,847,15236,196
2022-07-18,Ventura,111,848112,196448,195189,13208,208397,1522
2022-07-18,Yolo,113,214977,45271,44950,3919,48869,325
2022-07-18,Yuba,115,75493,17740,17661,1526,19187,124
2022-07-17,Alameda,001,1643700,322535,318442,18487,336929,1911
2022-07-17,Alpine,003,1148,130,130,1,131,0
2022-07-17,Amador,005,37829,9504,9437,816,10253,87
2022-07-17,Butte,007,227075,36997,36644,8182,44826,440
2022-07-17,Calaveras,009,45235,8052,7994,449,8443,126
2022-07-17,Colusa,011,21464,3631,3617,1167,4784,22
2022-07-17,Contra Costa,013,1133247,231897,228634,18285,246919,1356
2022-07-17,Del Norte,015,27424,7038,6860,357,7217,54
2022-07-17,El Dorado,017,186661,30715,30461,3923,34384,219
2022-07-17,Fresno,019,978130,256830,254088,27243,281331,2790
2022-07-17,Glenn,021,27897,5311,5273,1779,7052,48
2022-07-17,Humboldt,023,135768,20229,20016,4228,24244,150
2022-07-17,Imperial,025,180216,61504,60550,13151,73701,944
2022-07-17,Inyo,027,18085,4364,4343,755,5098,56
2022-07-17,Kern,029,883053,208316,206466,53700,260166,2364
2022-07-17,Kings,031,150075,55911,55432,3752,59184,449
2022-07-17,Lake,033,64148,11925,11835,1049,12884,141
2022-07-17,Lassen,035,31185,9468,9425,947,10372,64
2022-07-17,Los Angeles,037,10098052,3083357,3042708,158048,3200756,32248
2022-07-17,Madera,039,155013,40981,40627,7157,47784,372
2022-07-17,Marin,041,260295,42305,41829,4829,46658,300
2022-07-17,Mariposa,043,17540,2896,2866,294,3160,30
2022-07-17,Mendocino,045,87422,14937,14799,3949,18748,131
2022-07-17,Merced,047,269075,68021,67416,10128,77544,833
2022-07-17,Modoc,049,8938,830,799,309,1108,9
2022-07-17,Mono,051,14174,3137,3131,208,3339,7
2022-07-17,Monterey,053,433212,88884,88118,18179,106297,747
2022-07-17,Napa,055,140530,30426,30176,1325,31501,145
2022-07-17,Nevada,057,99092,18063,17941,1590,19531,131
2022-07-17,Orange,059,3164182,626610,620414,53707,674121,7161
2022-07-17,Placer,061,380077,71861,71232,8784,80016,637
2022-07-17,Plumas,063,18699,3446,3406,421,3827,13
2022-07-17,Riverside,065,2383286,654427,647328,31987,679315,6508
2022-07-17,Sacramento,067,1510023,325323,322788,31352,354140,3119
2022-07-17,San Benito,069,59416,14994,14869,802,15671,100
2022-07-17,San Bernardino,071,2135413,626014,618482,27710,646192,7914
2022-07-17,San Diego,073,3302833,867280,857262,65178,922440,5370
2022-07-17,San Francisco,075,870044,166787,164853,11135,175988,928
2022-07-17,San Joaquin,077,732212,185795,184187,12523,196710,2262
2022-07-17,San Luis Obispo,079,281455,59851,59437,6175,65612,499
2022-07-17,San Mateo,081,765935,156848,154961,9916,164877,723
2022-07-17,Santa Barbara,083,443738,98574,97600,5867,103467,702
2022-07-17,Santa Clara,085,1922200,400492,395466,17363,412829,2371
2022-07-17,Santa Cruz,087,273765,58231,57531,3009,60540,267
2022-07-17,Shasta,089,179085,33178,32871,6813,39684,575
2022-07-17,Sierra,091,2930,292,291,58,349,4
2022-07-17,Siskiyou,093,43540,4934,4899,3099,7998,83
2022-07-17,Solano,095,438530,98223,96974,7064,104038,457
2022-07-17,Sonoma,097,501317,100496,99679,4623,104302,499
2022-07-17,Stanislaus,099,539301,129517,128436,19494,147930,1692
2022-07-17,Sutter,101,95872,22597,22452,2357,24809,228
2022-07-17,Tehama,103,63373,12969,12860,2851,15711,205
2022-07-17,Trinity,105,12862,1325,1304,332,1636,20
2022-07-17,Tulare,107,460477,115232,114399,31920,146319,1510
2022-07-17,Tuolumne,109,53932,14490,14280,839,15119,196
2022-07-17,Ventura,111,848112,195997,193965,13101,207066,1519
2022-07-17,Yolo,113,214977,45194,44703,3903,48606,324
2022-07-17,Yuba,115,75493,17700,17567,1516,19083,124
2022-07-16,Alameda,001,1643700,322113,318442,18465,336907,1911
2022-07-16,Alpine,003,1148,130,130,1,131,0
2022-07-16,Amador,005,37829,9496,9437,816,10253,87
2022-07-16,Butte,007,227075,36976,36644,8167,44811,440
2022-07-16,Calaveras,009,45235,8047,7994,443,8437,126
2022-07-16,Colusa,011,21464,3627,3617,1163,4780,22
2022-07-16,Contra Costa,013,1133247,231591,228634,18237,246871,1356
2022-07-16,Del Norte,015,27424,7027,6860,357,7217,54
2022-07-16,El Dorado,017,186661,30694,30461,3921,34382,219
2022-07-16,Fresno,019,978130,256539,254088,27208,281296,2790
2022-07-16,Glenn,021,27897,5306,5273,1776,7049,48
2022-07-16,Humboldt,023,135768,20198,20016,4217,24233,150
2022-07-16,Imperial,025,180216,61418,60550,13107,73657,944
2022-07-16,Inyo,027,18085,4363,4343,754,5097,56
2022-07-16,Kern,029,883053,208152,206466,53631,260097,2364
2022-07-16,Kings,031,150075,55870,55432,3748,59180,449
2022-07-16,Lake,033,64148,11909,11835,1049,12884,141
2022-07-16,Lassen,035,31185,9466,9425,946,10371,64
2022-07-16,Los Angeles,037,10098052,3079946,3042708,157581,3200289,32248
2022-07-16,Madera,039,155013,40939,40627,7143,47770,372
2022-07-16,Marin,041,260295,42268,41829,4822,46651,300
2022-07-16,Mariposa,043,17540,2894,2866,294,3160,30
2022-07-16,Mendocino,045,87422,14929,14799,3947,18746,131
2022-07-16,Merced,047,269075,67934,67416,10117,77533,833
2022-07-16,Modoc,049,8938,830,799,309,1108,9
2022-07-16,Mono,051,14174,3137,3131,207,3338,7
2022-07-16,Monterey,053,433212,88791,88118,18137,106255,747
2022-07-16,Napa,055,140530,30399,30176,1323,31499,145
2022-07-16,Nevada,057,99092,18049,17941,1583,19524,131
2022-07-16,Orange,059,3164182,625880,620414,53562,673976,7161
2022-07-16,Placer,061,380077,71776,71232,8768,80000,637
2022-07-16,Plumas,063,18699,3442,3406,420,3826,13
2022-07-16,Riverside,065,2383286,653641,647328,31935,679263,6508
2022-07-16,Sacramento,067,1510023,325052,322788,31338,354126,3119
2022-07-16,San Benito,069,59416,14977,14869,798,15667,100
2022-07-16,San Bernardino,071,2135413,625299,618482,27651,646133,7914
2022-07-16,San Diego,073,3302833,866374,857262,65105,922367,5370
2022-07-16,San Francisco,075,870044,166602,164853,11119,175972,928
2022-07-16,San Joaquin,077,732212,185638,184187,12500,196687,2262
2022-07-16,San Luis Obispo,079,281455,59823,59437,6155,65592,499
2022-07-16,San Mateo,081,765935,156609,154961,9905,164866,723
2022-07-16,Santa Barbara,083,443738,98458,97600,5847,103447,702
2022-07-16,Santa Clara,085,1922200,399827,395466,17338,412804,2371
2022-07-16,Santa Cruz,087,273765,58159,57531,3004,60535,267
2022-07-16,Shasta,089,179085,33158,32871,6809,39680,575
2022-07-16,Sierra,091,2930,292,291,58,349,4
2022-07-16,Siskiyou,093,43540,4932,4899,3094,7993,83
2022-07-16,Solano,095,438530,98152,96974,7049,104023,457
2022-07-16,Sonoma,097,501317,100409,99679,4612,104291,499
2022-07-16,Stanislaus,099,539301,129386,128436,19464,147900,1692
2022-07-16,Sutter,101,95872,22573,22452,2356,24808,228
2022-07-16,Tehama,103,63373,12960,12860,2846,15706,205
2022-07-16,Trinity,105,12862,1323,1304,332,1636,20
2022-07-16,Tulare,107,460477,115126,114399,31859,146258,1510
2022-07-16,Tuolumne,109,53932,14466,14280,839,15119,196
2022-07-16,Ventura,111,848112,195772,193965,13064,207029,1519
2022-07-16,Yolo,113,214977,45150,44703,3890,48593,324
2022-07-16,Yuba,115,75493,17676,17567,1516,19083,124
2022-07-15,Alameda,001,1643700,321631,318442,18406,336848,1911
2022-07-15,Alpine,003,1148,130,130,1,131,0
2022-07-15,Amador,005,37829,9493,9437,815,10252,87
2022-07-15,Butte,007,227075,36936,36644,8161,44805,440
2022-07-15,Calaveras,009,45235,8041,7994,439,8433,126
2022-07-15,Colusa,011,21464,3625,3617,1161,4778,22
2022-07-15,Contra Costa,013,1133247,231316,228634,18196,246830,1356
2022-07-15,Del Norte,015,27424,7016,6860,354,7214,54
2022-07-15,El Dorado,017,186661,30666,30461,3918,34379,219
2022-07-15,Fresno,019,978130,256152,254088,27158,281246,2790
2022-07-15,Glenn,021,27897,5303,5273,1773,7046,48
2022-07-15,Humboldt,023,135768,20174,20016,4205,24221,150
2022-07-15,Imperial,025,180216,61343,60550,13064,73614,944
2022-07-15,Inyo,027,18085,4359,4343,749,5092,56
2022-07-15,Kern,029,883053,207946,206466,53554,260020,2364
2022-07-15,Kings,031,150075,55806,55432,3741,59173,449
2022-07-15,Lake,033,64148,11897,11835,1046,12881,141
2022-07-15,Lassen,035,31185,9464,9425,944,10369,64
2022-07-15,Los Angeles,037,10098052,3075796,3042708,157083,3199791,32248
2022-07-15,Madera,039,155013,40876,40627,7125,47752,372
2022-07-15,Marin,041,260295,42208,41829,4810,46639,300
2022-07-15,Mariposa,043,17540,2891,2866,293,3159,30
2022-07-15,Mendocino,045,87422,14908,14799,3945,18744,131
2022-07-15,Merced,047,269075,67874,67416,10108,77524,833
2022-07-15,Modoc,049,8938,829,799,309,1108,9
2022-07-15,Mono,051,14174,3135,3131,206,3337,7
2022-07-15,Monterey,053,433212,88679,88118,18109,106227,747
2022-07-15,Napa,055,140530,30367,30176,1321,31497,145
2022-07-15,Nevada,057,99092,18037,17941,1581,19522,131
2022-07-15,Orange,059,3164182,625034,620414,53399,673813,7161
2022-07-15,Placer,061,380077,71703,71232,8741,79973,637
2022-07-15,Plumas,063,18699,3435,3406,418,3824,13
2022-07-15,Riverside,065,2383286,652815,647328,31872,679200,6508
2022-07-15,Sacramento,067,1510023,324685,322788,31319,354107,3119
2022-07-15,San Benito,069,59416,14963,14869,798,15667,100
2022-07-15,San Bernardino,071,2135413,624582,618482,27610,646092,7914
2022-07-15,San Diego,073,3302833,865103,857262,64942,922204,5370
2022-07-15,San Francisco,075,870044,166346,164853,11077,175930,928
2022-07-15,San Joaquin,077,732212,185462,184187,12470,196657,2262
2022-07-15,San Luis Obispo,079,281455,59792,59437,6142,65579,499
2022-07-15,San Mateo,081,765935,156375,154961,9888,164849,723
2022-07-15,Santa Barbara,083,443738,98329,97600,5840,103440,702
2022-07-15,Santa Clara,085,1922200,399142,395466,17314,412780,2371
2022-07-15,Santa Cruz,087,273765,58069,57531,2992,60523,267
2022-07-15,Shasta,089,179085,33135,32871,6802,39673,575
2022-07-15,Sierra,091,2930,292,291,58,349,4
2022-07-15,Siskiyou,093,43540,4929,4899,3092,7991,83
2022-07-15,Solano,095,438530,98003,96974,7038,104012,457
2022-07-15,Sonoma,097,501317,100297,99679,4599,104278,499
2022-07-15,Stanislaus,099,539301,129263,128436,19450,147886,1692
2022-07-15,Sutter,101,95872,22546,22452,2355,24807,228
2022-07-15,Tehama,103,63373,12953,12860,2838,15698,205
2022-07-15,Trinity,105,12862,1319,1304,332,1636,20
2022-07-15,Tulare,107,460477,114974,114399,31774,146173,1510
2022-07-15,Tuolumne,109,53932,14422,14280,836,15116,196
2022-07-15,Ventura,111,848112,195546,193965,13029,206994,1519
2022-07-15,Yolo,113,214977,45104,44703,3879,48582,324
2022-07-15,Yuba,115,75493,17650,17567,1516,19083,124
2022-07-14,Alameda,001,1643700,320858,318442,18316,336758,1911
2022-07-14,Alpine,003,1148,130,130,1,131,0
2022-07-14,Amador,005,37829,9480,9437,810,10247,87
2022-07-14,Butte,007,227075,36895,36644,8154,44798,440
2022-07-14,Calaveras,009,45235,8034,7994,435,8429,126
2022-07-14,Colusa,011,21464,3625,3617,1159,4776,22
2022-07-14,Contra Costa,013,1133247,230875,228634,18112,246746,1356
2022-07-14,Del Norte,015,27424,6995,6860,352,7212,54
2022-07-14,El Dorado,017,186661,30629,30461,3910,34371,219
2022-07-14,Fresno,019,978130,255621,254088,27072,281160,2790
2022-07-14,Glenn,021,27897,5294,5273,1770,7043,48
2022-07-14,Humboldt,023,135768,20133,20016,4191,24207,150
2022-07-14,Imperial,025,180216,61165,60550,12948,73498,944
2022-07-14,Inyo,027,18085,4357,4343,744,5087,56
2022-07-14,Kern,029,883053,207627,206466,53448,259914,2364
2022-07-14,Kings,031,150075,55711,55432,3730,59162,449
2022-07-14,Lake,033,64148,11881,11835,1044,12879,141
2022-07-14,Lassen,035,31185,9459,9425,943,10368,64
2022-07-14,Los Angeles,037,10098052,3069679,3042708,156378,3199086,32248
2022-07-14,Madera,039,155013,40803,40627,7074,47701,372
2022-07-14,Marin,041,260295,42115,41829,4805,46634,300
2022-07-14,Mariposa,043,17540,2885,2866,290,3156,30
2022-07-14,Mendocino,045,87422,14894,14799,3940,18739,131
2022-07-14,Merced,047,269075,67779,67416,10084,77500,833
2022-07-14,Modoc,049,8938,829,799,309,1108,9
2022-07-14,Mono,051,14174,3134,3131,206,3337,7
2022-07-14,Monterey,053,433212,88563,88118,18031,106149,747
2022-07-14,Napa,055,140530,30324,30176,1317,31493,145
2022-07-14,Nevada,057,99092,18013,17941,1572,19513,131
2022-07-14,Orange,059,3164182,623766,620414,53190,673604,7161
2022-07-14,Placer,061,380077,71593,71232,8721,79953,637
2022-07-14,Plumas,063,18699,3426,3406,417,3823,13
2022-07-14,Riverside,065,2383286,651582,647328,31798,679126,6508
2022-07-14,Sacramento,067,1510023,324130,322788,31276,354064,3119
2022-07-14,San Benito,069,59416,14934,14869,794,15663,100
2022-07-14,San Bernardino,071,2135413,623459,618482,27534,646016,7914
2022-07-14,San Diego,073,3302833,863220,857262,64712,921974,5370
2022-07-14,San Francisco,075,870044,166013,164853,11030,175883,928
2022-07-14,San Joaquin,077,732212,185154,184187,12436,196623,2262
2022-07-14,San Luis Obispo,079,281455,59705,59437,6098,65535,499
2022-07-14,San Mateo,081,765935,156089,154961,9866,164827,723
2022-07-14,Santa Barbara,083,443738,98150,97600,5829,103429,702
2022-07-14,Santa Clara,085,1922200,398290,395466,17273,412739,2371
2022-07-14,Santa Cruz,087,273765,57978,57531,2978,60509,267
2022-07-14,Shasta,089,179085,33087,32871,6790,39661,575
2022-07-14,Sierra,091,2930,292,291,58,349,4
2022-07-14,Siskiyou,093,43540,4921,4899,3084,7983,83
2022-07-14,Solano,095,438530,97826,96974,7026,104000,457
2022-07-14,Sonoma,097,501317,100164,99679,4576,104255,499
2022-07-14,Stanislaus,099,539301,129059,128436,19420,147856,1692
2022-07-14,Sutter,101,95872,22520,22452,2354,24806,228
2022-07-14,Tehama,103,63373,12930,12860,2833,15693,205
2022-07-14,Trinity,105,12862,1319,1304,328,1632,20
2022-07-14,Tulare,107,460477,114843,114399,31675,146074,1510
2022-07-14,Tuolumne,109,53932,14383,14280,832,15112,196
2022-07-14,Ventura,111,848112,195199,193965,12960,206925,1519
2022-07-14,Yolo,113,214977,45039,44703,3866,48569,324
2022-07-14,Yuba,115,75493,17618,17567,1507,19074,124
2022-07-13,Alameda,001,1643700,320132,316026,18234,334260,1911
2022-07-13,Alpine,003,1148,130,129,1,130,0
2022-07-13,Amador,005,37829,9469,9388,809,10197,87
2022-07-13,Butte,007,227075,36837,36405,8140,44545,439
2022-07-13,Calaveras,009,45235,8021,7945,434,8379,125
2022-07-13,Colusa,011,21464,3621,3606,1159,4765,22
2022-07-13,Contra Costa,013,1133247,230398,226833,18033,244866,1356
2022-07-13,Del Norte,015,27424,6976,6790,352,7142,54
2022-07-13,El Dorado,017,186661,30580,30273,3905,34178,218
2022-07-13,Fresno,019,978130,255080,252573,26982,279555,2786
2022-07-13,Glenn,021,27897,5289,5256,1769,7025,48
2022-07-13,Humboldt,023,135768,20101,19854,4176,24030,150
2022-07-13,Imperial,025,180216,61010,60011,12865,72876,944
2022-07-13,Inyo,027,18085,4356,4324,739,5063,56
2022-07-13,Kern,029,883053,207234,205428,53324,258752,2359
2022-07-13,Kings,031,150075,55601,55138,3721,58859,449
2022-07-13,Lake,033,64148,11863,11773,1043,12816,140
2022-07-13,Lassen,035,31185,9437,9381,942,10323,64
2022-07-13,Los Angeles,037,10098052,3063079,3024953,155675,3180628,32206
2022-07-13,Madera,039,155013,40739,40378,7049,47427,372
2022-07-13,Marin,041,260295,42048,41616,4797,46413,300
2022-07-13,Mariposa,043,17540,2880,2847,289,3136,30
2022-07-13,Mendocino,045,87422,14874,14713,3927,18640,128
2022-07-13,Merced,047,269075,67649,67028,10052,77080,832
2022-07-13,Modoc,049,8938,828,791,308,1099,9
2022-07-13,Mono,051,14174,3134,3131,202,3333,7
2022-07-13,Monterey,053,433212,88420,87575,17955,105530,745
2022-07-13,Napa,055,140530,30286,30032,1316,31348,145
2022-07-13,Nevada,057,99092,17995,17849,1565,19414,131
2022-07-13,Orange,059,3164182,622382,616278,52951,669229,7147
2022-07-13,Placer,061,380077,71487,70890,8708,79598,637
2022-07-13,Plumas,063,18699,3418,3354,416,3770,13
2022-07-13,Riverside,065,2383286,650374,643472,31701,675173,6504
2022-07-13,Sacramento,067,1510023,323607,321076,31235,352311,3114
2022-07-13,San Benito,069,59416,14907,14774,788,15562,100
2022-07-13,San Bernardino,071,2135413,622325,614957,27447,642404,7907
2022-07-13,San Diego,073,3302833,861309,851596,64494,916090,5363
2022-07-13,San Francisco,075,870044,165613,163635,11002,174637,919
2022-07-13,San Joaquin,077,732212,184827,183283,12402,195685,2260
2022-07-13,San Luis Obispo,079,281455,59599,59134,6052,65186,498
2022-07-13,San Mateo,081,765935,155749,153875,9849,163724,723
2022-07-13,Santa Barbara,083,443738,97970,97053,5817,102870,699
2022-07-13,Santa Clara,085,1922200,397409,392415,17237,409652,2365
2022-07-13,Santa Cruz,087,273765,57843,57124,2971,60095,267
2022-07-13,Shasta,089,179085,33030,32708,6775,39483,574
2022-07-13,Sierra,091,2930,292,289,58,347,4
2022-07-13,Siskiyou,093,43540,4914,4873,3082,7955,82
2022-07-13,Solano,095,438530,97621,96479,7003,103482,455
2022-07-13,Sonoma,097,501317,100008,99173,4559,103732,499
2022-07-13,Stanislaus,099,539301,128859,127845,19373,147218,1689
2022-07-13,Sutter,101,95872,22473,22331,2352,24683,228
2022-07-13,Tehama,103,63373,12917,12793,2830,15623,205
2022-07-13,Trinity,105,12862,1318,1293,326,1619,20
2022-07-13,Tulare,107,460477,114647,113830,31581,145411,1508
2022-07-13,Tuolumne,109,53932,14360,14159,826,14985,194
2022-07-13,Ventura,111,848112,194866,192923,12884,205807,1518
2022-07-13,Yolo,113,214977,44977,44447,3856,48303,326
2022-07-13,Yuba,115,75493,17591,17464,1499,18963,124
2022-07-12,Alameda,001,1643700,319331,316026,18169,334195,1911
2022-07-12,Alpine,003,1148,130,129,1,130,0
2022-07-12,Amador,005,37829,9436,9388,802,10190,87
2022-07-12,Butte,007,227075,36780,36405,8122,44527,439
2022-07-12,Calaveras,009,45235,8006,7945,432,8377,125
2022-07-12,Colusa,011,21464,3619,3606,1156,4762,22
2022-07-12,Contra Costa,013,1133247,229894,226833,17959,244792,1356
2022-07-12,Del Norte,015,27424,6929,6790,349,7139,54
2022-07-12,El Dorado,017,186661,30541,30273,3899,34172,218
2022-07-12,Fresno,019,978130,254545,252573,26909,279482,2786
2022-07-12,Glenn,021,27897,5286,5256,1765,7021,48
2022-07-12,Humboldt,023,135768,20051,19854,4160,24014,150
2022-07-12,Imperial,025,180216,60834,60011,12764,72775,944
2022-07-12,Inyo,027,18085,4348,4324,739,5063,56
2022-07-12,Kern,029,883053,206916,205428,53173,258601,2359
2022-07-12,Kings,031,150075,55489,55138,3711,58849,449
2022-07-12,Lake,033,64148,11851,11773,1038,12811,140
2022-07-12,Lassen,035,31185,9424,9381,936,10317,64
2022-07-12,Los Angeles,037,10098052,3056347,3024953,154987,3179940,32206
2022-07-12,Madera,039,155013,40653,40378,7034,47412,372
2022-07-12,Marin,041,260295,41975,41616,4787,46403,300
2022-07-12,Mariposa,043,17540,2869,2847,289,3136,30
2022-07-12,Mendocino,045,87422,14837,14713,3906,18619,128
2022-07-12,Merced,047,269075,67542,67028,10020,77048,832
2022-07-12,Modoc,049,8938,826,791,305,1096,9
2022-07-12,Mono,051,14174,3130,3131,202,3333,7
2022-07-12,Monterey,053,433212,88265,87575,17866,105441,745
2022-07-12,Napa,055,140530,30232,30032,1313,31345,145
2022-07-12,Nevada,057,99092,17974,17849,1560,19409,131
2022-07-12,Orange,059,3164182,620970,616278,52717,668995,7147
2022-07-12,Placer,061,380077,71377,70890,8693,79583,637
2022-07-12,Plumas,063,18699,3412,3354,415,3769,13
2022-07-12,Riverside,065,2383286,649091,643472,31607,675079,6504
2022-07-12,Sacramento,067,1510023,323018,321076,31196,352272,3114
2022-07-12,San Benito,069,59416,14862,14774,782,15556,100
2022-07-12,San Bernardino,071,2135413,621029,614957,27367,642324,7907
2022-07-12,San Diego,073,3302833,858954,851596,64265,915861,5363
2022-07-12,San Francisco,075,870044,165209,163635,10978,174613,919
2022-07-12,San Joaquin,077,732212,184517,183283,12366,195649,2260
2022-07-12,San Luis Obispo,079,281455,59523,59134,6023,65157,498
2022-07-12,San Mateo,081,765935,155359,153875,9830,163705,723
2022-07-12,Santa Barbara,083,443738,97756,97053,5800,102853,699
2022-07-12,Santa Clara,085,1922200,396465,392415,17194,409609,2365
2022-07-12,Santa Cruz,087,273765,57706,57124,2962,60086,267
2022-07-12,Shasta,089,179085,32967,32708,6756,39464,574
2022-07-12,Sierra,091,2930,291,289,58,347,4
2022-07-12,Siskiyou,093,43540,4905,4873,3080,7953,82
2022-07-12,Solano,095,438530,97409,96479,6980,103459,455
2022-07-12,Sonoma,097,501317,99848,99173,4531,103704,499
2022-07-12,Stanislaus,099,539301,128613,127845,19337,147182,1689
2022-07-12,Sutter,101,95872,22440,22331,2350,24681,228
2022-07-12,Tehama,103,63373,12897,12793,2824,15617,205
2022-07-12,Trinity,105,12862,1310,1293,326,1619,20
2022-07-12,Tulare,107,460477,114452,113830,31481,145311,1508
2022-07-12,Tuolumne,109,53932,14325,14159,824,14983,194
2022-07-12,Ventura,111,848112,194534,192923,12789,205712,1518
2022-07-12,Yolo,113,214977,44907,44447,3848,48295,326
2022-07-12,Yuba,115,75493,17563,17464,1486,18950,124
2022-07-11,Alameda,001,1643700,318409,316026,18084,334110,1911
2022-07-11,Alpine,003,1148,130,129,1,130,0
2022-07-11,Amador,005,37829,9428,9388,796,10184,87
2022-07-11,Butte,007,227075,36722,36405,8103,44508,439
2022-07-11,Calaveras,009,45235,7990,7945,430,8375,125
2022-07-11,Colusa,011,21464,3615,3606,1153,4759,22
2022-07-11,Contra Costa,013,1133247,229417,226833,17903,244736,1356
2022-07-11,Del Norte,015,27424,6898,6790,340,7130,54
2022-07-11,El Dorado,017,186661,30484,30273,3888,34161,218
2022-07-11,Fresno,019,978130,253883,252573,26833,279406,2786
2022-07-11,Glenn,021,27897,5283,5256,1763,7019,48
2022-07-11,Humboldt,023,135768,19993,19854,4142,23996,150
2022-07-11,Imperial,025,180216,60675,60011,12654,72665,944
2022-07-11,Inyo,027,18085,4345,4324,735,5059,56
2022-07-11,Kern,029,883053,206597,205428,53052,258480,2359
2022-07-11,Kings,031,150075,55341,55138,3701,58839,449
2022-07-11,Lake,033,64148,11825,11773,1037,12810,140
2022-07-11,Lassen,035,31185,9418,9381,936,10317,64
2022-07-11,Los Angeles,037,10098052,3049278,3024953,154212,3179165,32206
2022-07-11,Madera,039,155013,40566,40378,6991,47369,372
2022-07-11,Marin,041,260295,41886,41616,4778,46394,300
2022-07-11,Mariposa,043,17540,2861,2847,287,3134,30
2022-07-11,Mendocino,045,87422,14798,14713,3894,18607,128
2022-07-11,Merced,047,269075,67417,67028,9986,77014,832
2022-07-11,Modoc,049,8938,820,791,303,1094,9
2022-07-11,Mono,051,14174,3130,3131,200,3331,7
2022-07-11,Monterey,053,433212,88101,87575,17799,105374,745
2022-07-11,Napa,055,140530,30170,30032,1313,31345,145
2022-07-11,Nevada,057,99092,17956,17849,1558,19407,131
2022-07-11,Orange,059,3164182,619394,616278,52488,668766,7147
2022-07-11,Placer,061,380077,71270,70890,8678,79568,637
2022-07-11,Plumas,063,18699,3401,3354,413,3767,13
2022-07-11,Riverside,065,2383286,647658,643472,31521,674993,6504
2022-07-11,Sacramento,067,1510023,322475,321076,31151,352227,3114
2022-07-11,San Benito,069,59416,14826,14774,778,15552,100
2022-07-11,San Bernardino,071,2135413,619714,614957,27282,642239,7907
2022-07-11,San Diego,073,3302833,856580,851596,64027,915623,5363
2022-07-11,San Francisco,075,870044,164797,163635,10951,174586,919
2022-07-11,San Joaquin,077,732212,184143,183283,12330,195613,2260
2022-07-11,San Luis Obispo,079,281455,59415,59134,5991,65125,498
2022-07-11,San Mateo,081,765935,154961,153875,9795,163670,723
2022-07-11,Santa Barbara,083,443738,97548,97053,5787,102840,699
2022-07-11,Santa Clara,085,1922200,395400,392415,17139,409554,2365
2022-07-11,Santa Cruz,087,273765,57557,57124,2948,60072,267
2022-07-11,Shasta,089,179085,32912,32708,6726,39434,574
2022-07-11,Sierra,091,2930,291,289,58,347,4
2022-07-11,Siskiyou,093,43540,4898,4873,3073,7946,82
2022-07-11,Solano,095,438530,97197,96479,6965,103444,455
2022-07-11,Sonoma,097,501317,99657,99173,4512,103685,499
2022-07-11,Stanislaus,099,539301,128388,127845,19301,147146,1689
2022-07-11,Sutter,101,95872,22398,22331,2344,24675,228
2022-07-11,Tehama,103,63373,12884,12793,2817,15610,205
2022-07-11,Trinity,105,12862,1308,1293,325,1618,20
2022-07-11,Tulare,107,460477,114263,113830,31377,145207,1508
2022-07-11,Tuolumne,109,53932,14286,14159,822,14981,194
2022-07-11,Ventura,111,848112,194138,192923,12709,205632,1518
2022-07-11,Yolo,113,214977,44841,44447,3833,48280,326
2022-07-11,Yuba,115,75493,17527,17464,1483,18947,124
2022-07-10,Alameda,001,1643700,317416,312651,18003,330654,1912
2022-07-10,Alpine,003,1148,130,129,1,130,0
2022-07-10,Amador,005,37829,9418,9335,793,10128,87
2022-07-10,Butte,007,227075,36621,36165,8080,44245,438
2022-07-10,Calaveras,009,45235,7980,7895,429,8324,125
2022-07-10,Colusa,011,21464,3611,3586,1145,4731,22
2022-07-10,Contra Costa,013,1133247,228807,224718,17809,242527,1351
2022-07-10,Del Norte,015,27424,6858,6666,334,7000,54
2022-07-10,El Dorado,017,186661,30401,30070,3880,33950,218
2022-07-10,Fresno,019,978130,253210,250379,26740,277119,2786
2022-07-10,Glenn,021,27897,5278,5231,1759,6990,48
2022-07-10,Humboldt,023,135768,19934,19677,4128,23805,149
2022-07-10,Imperial,025,180216,60452,59558,12513,72071,944
2022-07-10,Inyo,027,18085,4340,4297,729,5026,56
2022-07-10,Kern,029,883053,206094,204128,52866,256994,2359
2022-07-10,Kings,031,150075,55165,54725,3695,58420,449
2022-07-10,Lake,033,64148,11800,11685,1034,12719,140
2022-07-10,Lassen,035,31185,9403,9362,934,10296,64
2022-07-10,Los Angeles,037,10098052,3042058,3002013,153419,3155432,32151
2022-07-10,Madera,039,155013,40457,40081,6957,47038,372
2022-07-10,Marin,041,260295,41789,41271,4769,46040,302
2022-07-10,Mariposa,043,17540,2854,2805,283,3088,30
2022-07-10,Mendocino,045,87422,14768,14610,3877,18487,128
2022-07-10,Merced,047,269075,67260,66616,9930,76546,832
2022-07-10,Modoc,049,8938,819,789,295,1084,9
2022-07-10,Mono,051,14174,3130,3119,198,3317,7
2022-07-10,Monterey,053,433212,87913,87002,17719,104721,745
2022-07-10,Napa,055,140530,30107,29807,1311,31118,145
2022-07-10,Nevada,057,99092,17894,17693,1549,19242,131
2022-07-10,Orange,059,3164182,617698,610975,52182,663157,7132
2022-07-10,Placer,061,380077,71154,70401,8659,79060,632
2022-07-10,Plumas,063,18699,3388,3339,409,3748,13
2022-07-10,Riverside,065,2383286,646065,638193,31391,669584,6506
2022-07-10,Sacramento,067,1510023,321773,318556,31077,349633,3108
2022-07-10,San Benito,069,59416,14790,14628,767,15395,100
2022-07-10,San Bernardino,071,2135413,618305,610086,27203,637289,7893
2022-07-10,San Diego,073,3302833,854095,844085,63755,907840,5357
2022-07-10,San Francisco,075,870044,164262,161931,10878,172809,914
2022-07-10,San Joaquin,077,732212,183770,181958,12270,194228,2257
2022-07-10,San Luis Obispo,079,281455,59299,58636,5952,64588,498
2022-07-10,San Mateo,081,765935,154500,152319,9769,162088,723
2022-07-10,Santa Barbara,083,443738,97316,96266,5761,102027,697
2022-07-10,Santa Clara,085,1922200,394276,388270,17077,405347,2360
2022-07-10,Santa Cruz,087,273765,57366,56455,2932,59387,266
2022-07-10,Shasta,089,179085,32852,32536,6703,39239,576
2022-07-10,Sierra,091,2930,289,291,58,349,4
2022-07-10,Siskiyou,093,43540,4893,4855,3060,7915,82
2022-07-10,Solano,095,438530,96952,95651,6937,102588,455
2022-07-10,Sonoma,097,501317,99456,98430,4482,102912,496
2022-07-10,Stanislaus,099,539301,128148,126897,19257,146154,1686
2022-07-10,Sutter,101,95872,22349,22165,2343,24508,228
2022-07-10,Tehama,103,63373,12859,12716,2804,15520,205
2022-07-10,Trinity,105,12862,1302,1272,323,1595,20
2022-07-10,Tulare,107,460477,114008,113002,31280,144282,1508
2022-07-10,Tuolumne,109,53932,14251,14019,814,14833,194
2022-07-10,Ventura,111,848112,193666,191462,12608,204070,1518
2022-07-10,Yolo,113,214977,44763,44152,3818,47970,323
2022-07-10,Yuba,115,75493,17488,17345,1481,18826,125
2022-07-09,Alameda,001,1643700,316929,312651,17981,330632,1912
2022-07-09,Alpine,003,1148,130,129,1,130,0
2022-07-09,Amador,005,37829,9410,9335,791,10126,87
2022-07-09,Butte,007,227075,36573,36165,8066,44231,438
2022-07-09,Calaveras,009,45235,7965,7895,428,8323,125
2022-07-09,Colusa,011,21464,3610,3586,1144,4730,22
2022-07-09,Contra Costa,013,1133247,228500,224718,17752,242470,1351
2022-07-09,Del Norte,015,27424,6849,6666,334,7000,54
2022-07-09,El Dorado,017,186661,30358,30070,3875,33945,218
2022-07-09,Fresno,019,978130,252952,250379,26706,277085,2786
2022-07-09,Glenn,021,27897,5271,5231,1759,6990,48
2022-07-09,Humboldt,023,135768,19916,19677,4119,23796,149
2022-07-09,Imperial,025,180216,60373,59558,12460,72018,944
2022-07-09,Inyo,027,18085,4334,4297,728,5025,56
2022-07-09,Kern,029,883053,205926,204128,52774,256902,2359
2022-07-09,Kings,031,150075,55126,54725,3693,58418,449
2022-07-09,Lake,033,64148,11792,11685,1033,12718,140
2022-07-09,Lassen,035,31185,9402,9362,934,10296,64
2022-07-09,Los Angeles,037,10098052,3038592,3002013,152935,3154948,32151
2022-07-09,Madera,039,155013,40418,40081,6949,47030,372
2022-07-09,Marin,041,260295,41733,41271,4758,46029,302
2022-07-09,Mariposa,043,17540,2849,2805,283,3088,30
2022-07-09,Mendocino,045,87422,14753,14610,3867,18477,128
2022-07-09,Merced,047,269075,67209,66616,9925,76541,832
2022-07-09,Modoc,049,8938,819,789,291,1080,9
2022-07-09,Mono,051,14174,3130,3119,198,3317,7
2022-07-09,Monterey,053,433212,87816,87002,17669,104671,745
2022-07-09,Napa,055,140530,30076,29807,1308,31115,145
2022-07-09,Nevada,057,99092,17882,17693,1545,19238,131
2022-07-09,Orange,059,3164182,616833,610975,52014,662989,7132
2022-07-09,Placer,061,380077,71065,70401,8651,79052,632
2022-07-09,Plumas,063,18699,3381,3339,407,3746,13
2022-07-09,Riverside,065,2383286,645169,638193,31336,669529,6506
2022-07-09,Sacramento,067,1510023,321469,318556,31059,349615,3108
2022-07-09,San Benito,069,59416,14770,14628,766,15394,100
2022-07-09,San Bernardino,071,2135413,617614,610086,27153,637239,7893
2022-07-09,San Diego,073,3302833,853196,844085,63674,907759,5357
2022-07-09,San Francisco,075,870044,164028,161931,10857,172788,914
2022-07-09,San Joaquin,077,732212,183603,181958,12245,194203,2257
2022-07-09,San Luis Obispo,079,281455,59243,58636,5933,64569,498
2022-07-09,San Mateo,081,765935,154259,152319,9753,162072,723
2022-07-09,Santa Barbara,083,443738,97183,96266,5751,102017,697
2022-07-09,Santa Clara,085,1922200,393541,388270,17048,405318,2360
2022-07-09,Santa Cruz,087,273765,57289,56455,2923,59378,266
2022-07-09,Shasta,089,179085,32830,32536,6693,39229,576
2022-07-09,Sierra,091,2930,289,291,58,349,4
2022-07-09,Siskiyou,093,43540,4889,4855,3058,7913,82
2022-07-09,Solano,095,438530,96867,95651,6927,102578,455
2022-07-09,Sonoma,097,501317,99368,98430,4476,102906,496
2022-07-09,Stanislaus,099,539301,127984,126897,19229,146126,1686
2022-07-09,Sutter,101,95872,22319,22165,2343,24508,228
2022-07-09,Tehama,103,63373,12842,12716,2795,15511,205
2022-07-09,Trinity,105,12862,1302,1272,322,1594,20
2022-07-09,Tulare,107,460477,113898,113002,31221,144223,1508
2022-07-09,Tuolumne,109,53932,14213,14019,812,14831,194
2022-07-09,Ventura,111,848112,193404,191462,12567,204029,1518
2022-07-09,Yolo,113,214977,44713,44152,3805,47957,323
2022-07-09,Yuba,115,75493,17466,17345,1480,18825,125
2022-07-08,Alameda,001,1643700,316414,312651,17938,330589,1912
2022-07-08,Alpine,003,1148,130,129,1,130,0
2022-07-08,Amador,005,37829,9400,9335,789,10124,87
2022-07-08,Butte,007,227075,36543,36165,8052,44217,438
2022-07-08,Calaveras,009,45235,7950,7895,428,8323,125
2022-07-08,Colusa,011,21464,3606,3586,1144,4730,22
2022-07-08,Contra Costa,013,1133247,228151,224718,17704,242422,1351
2022-07-08,Del Norte,015,27424,6838,6666,332,6998,54
2022-07-08,El Dorado,017,186661,30332,30070,3868,33938,218
2022-07-08,Fresno,019,978130,252583,250379,26654,277033,2786
2022-07-08,Glenn,021,27897,5266,5231,1756,6987,48
2022-07-08,Humboldt,023,135768,19903,19677,4108,23785,149
2022-07-08,Imperial,025,180216,60291,59558,12420,71978,944
2022-07-08,Inyo,027,18085,4333,4297,724,5021,56
2022-07-08,Kern,029,883053,205702,204128,52681,256809,2359
2022-07-08,Kings,031,150075,55084,54725,3692,58417,449
2022-07-08,Lake,033,64148,11775,11685,1030,12715,140
2022-07-08,Lassen,035,31185,9396,9362,933,10295,64
2022-07-08,Los Angeles,037,10098052,3034375,3002013,152361,3154374,32151
2022-07-08,Madera,039,155013,40364,40081,6935,47016,372
2022-07-08,Marin,041,260295,41646,41271,4742,46013,302
2022-07-08,Mariposa,043,17540,2846,2805,282,3087,30
2022-07-08,Mendocino,045,87422,14735,14610,3863,18473,128
2022-07-08,Merced,047,269075,67143,66616,9914,76530,832
2022-07-08,Modoc,049,8938,819,789,291,1080,9
2022-07-08,Mono,051,14174,3127,3119,197,3316,7
2022-07-08,Monterey,053,433212,87703,87002,17639,104641,745
2022-07-08,Napa,055,140530,30052,29807,1307,31114,145
2022-07-08,Nevada,057,99092,17874,17693,1543,19236,131
2022-07-08,Orange,059,3164182,615930,610975,51839,662814,7132
2022-07-08,Placer,061,380077,70990,70401,8639,79040,632
2022-07-08,Plumas,063,18699,3376,3339,407,3746,13
2022-07-08,Riverside,065,2383286,644258,638193,31279,669472,6506
2022-07-08,Sacramento,067,1510023,321035,318556,31041,349597,3108
2022-07-08,San Benito,069,59416,14753,14628,763,15391,100
2022-07-08,San Bernardino,071,2135413,616876,610086,27113,637199,7893
2022-07-08,San Diego,073,3302833,851949,844085,63513,907598,5357
2022-07-08,San Francisco,075,870044,163764,161931,10831,172762,914
2022-07-08,San Joaquin,077,732212,183430,181958,12234,194192,2257
2022-07-08,San Luis Obispo,079,281455,59207,58636,5918,64554,498
2022-07-08,San Mateo,081,765935,153968,152319,9739,162058,723
2022-07-08,Santa Barbara,083,443738,97056,96266,5747,102013,697
2022-07-08,Santa Clara,085,1922200,392771,388270,17027,405297,2360
2022-07-08,Santa Cruz,087,273765,57201,56455,2915,59370,266
2022-07-08,Shasta,089,179085,32800,32536,6685,39221,576
2022-07-08,Sierra,091,2930,289,291,58,349,4
2022-07-08,Siskiyou,093,43540,4884,4855,3055,7910,82
2022-07-08,Solano,095,438530,96749,95651,6916,102567,455
2022-07-08,Sonoma,097,501317,99221,98430,4459,102889,496
2022-07-08,Stanislaus,099,539301,127846,126897,19216,146113,1686
2022-07-08,Sutter,101,95872,22294,22165,2342,24507,228
2022-07-08,Tehama,103,63373,12830,12716,2793,15509,205
2022-07-08,Trinity,105,12862,1300,1272,321,1593,20
2022-07-08,Tulare,107,460477,113778,113002,31153,144155,1508
2022-07-08,Tuolumne,109,53932,14182,14019,806,14825,194
2022-07-08,Ventura,111,848112,193164,191462,12528,203990,1518
2022-07-08,Yolo,113,214977,44661,44152,3793,47945,323
2022-07-08,Yuba,115,75493,17450,17345,1479,18824,125
2022-07-07,Alameda,001,1643700,315610,312651,17892,330543,1912
2022-07-07,Alpine,003,1148,129,129,1,130,0
2022-07-07,Amador,005,37829,9384,9335,782,10117,87
2022-07-07,Butte,007,227075,36480,36165,8031,44196,438
2022-07-07,Calaveras,009,45235,7941,7895,423,8318,125
2022-07-07,Colusa,011,21464,3601,3586,1143,4729,22
2022-07-07,Contra Costa,013,1133247,227601,224718,17634,242352,1351
2022-07-07,Del Norte,015,27424,6812,6666,328,6994,54
2022-07-07,El Dorado,017,186661,30281,30070,3857,33927,218
2022-07-07,Fresno,019,978130,252040,250379,26553,276932,2786
2022-07-07,Glenn,021,27897,5260,5231,1754,6985,48
2022-07-07,Humboldt,023,135768,19858,19677,4092,23769,149
2022-07-07,Imperial,025,180216,60124,59558,12306,71864,944
2022-07-07,Inyo,027,18085,4330,4297,716,5013,56
2022-07-07,Kern,029,883053,205410,204128,52535,256663,2359
2022-07-07,Kings,031,150075,55006,54725,3688,58413,449
2022-07-07,Lake,033,64148,11754,11685,1030,12715,140
2022-07-07,Lassen,035,31185,9395,9362,933,10295,64
2022-07-07,Los Angeles,037,10098052,3028076,3002013,151683,3153696,32151
2022-07-07,Madera,039,155013,40286,40081,6919,47000,372
2022-07-07,Marin,041,260295,41566,41271,4731,46002,302
2022-07-07,Mariposa,043,17540,2839,2805,279,3084,30
2022-07-07,Mendocino,045,87422,14719,14610,3858,18468,128
2022-07-07,Merced,047,269075,67031,66616,9881,76497,832
2022-07-07,Modoc,049,8938,814,789,288,1077,9
2022-07-07,Mono,051,14174,3127,3119,195,3314,7
2022-07-07,Monterey,053,433212,87545,87002,17575,104577,745
2022-07-07,Napa,055,140530,29982,29807,1299,31106,145
2022-07-07,Nevada,057,99092,17844,17693,1538,19231,131
2022-07-07,Orange,059,3164182,614542,610975,51636,662611,7132
2022-07-07,Placer,061,380077,70880,70401,8614,79015,632
2022-07-07,Plumas,063,18699,3369,3339,406,3745,13
2022-07-07,Riverside,065,2383286,642942,638193,31216,669409,6506
2022-07-07,Sacramento,067,1510023,320411,318556,30994,349550,3108
2022-07-07,San Benito,069,59416,14723,14628,763,15391,100
2022-07-07,San Bernardino,071,2135413,615584,610086,27053,637139,7893
2022-07-07,San Diego,073,3302833,850040,844085,63291,907376,5357
2022-07-07,San Francisco,075,870044,163383,161931,10778,172709,914
2022-07-07,San Joaquin,077,732212,183098,181958,12211,194169,2257
2022-07-07,San Luis Obispo,079,281455,59130,58636,5886,64522,498
2022-07-07,San Mateo,081,765935,153631,152319,9730,162049,723
2022-07-07,Santa Barbara,083,443738,96862,96266,5732,101998,697
2022-07-07,Santa Clara,085,1922200,391790,388270,16980,405250,2360
2022-07-07,Santa Cruz,087,273765,57045,56455,2901,59356,266
2022-07-07,Shasta,089,179085,32765,32536,6668,39204,576
2022-07-07,Sierra,091,2930,288,291,57,348,4
2022-07-07,Siskiyou,093,43540,4877,4855,3049,7904,82
2022-07-07,Solano,095,438530,96477,95651,6905,102556,455
2022-07-07,Sonoma,097,501317,99088,98430,4440,102870,496
2022-07-07,Stanislaus,099,539301,127646,126897,19181,146078,1686
2022-07-07,Sutter,101,95872,22248,22165,2340,24505,228
2022-07-07,Tehama,103,63373,12813,12716,2784,15500,205
2022-07-07,Trinity,105,12862,1295,1272,320,1592,20
2022-07-07,Tulare,107,460477,113569,113002,31059,144061,1508
2022-07-07,Tuolumne,109,53932,14146,14019,800,14819,194
2022-07-07,Ventura,111,848112,192846,191462,12447,203909,1518
2022-07-07,Yolo,113,214977,44603,44152,3781,47933,323
2022-07-07,Yuba,115,75493,17416,17345,1477,18822,125
2022-07-06,Alameda,001,1643700,314764,310551,17815,328366,1899
2022-07-06,Alpine,003,1148,129,129,1,130,0
2022-07-06,Amador,005,37829,9365,9301,782,10083,87
2022-07-06,Butte,007,227075,36416,36053,8015,44068,436
2022-07-06,Calaveras,009,45235,7932,7873,421,8294,124
2022-07-06,Colusa,011,21464,3598,3579,1142,4721,22
2022-07-06,Contra Costa,013,1133247,227086,223500,17585,241085,1348
2022-07-06,Del Norte,015,27424,6782,6623,326,6949,54
2022-07-06,El Dorado,017,186661,30237,29953,3845,33798,218
2022-07-06,Fresno,019,978130,251485,249480,26483,275963,2786
2022-07-06,Glenn,021,27897,5255,5222,1754,6976,48
2022-07-06,Humboldt,023,135768,19811,19608,4081,23689,149
2022-07-06,Imperial,025,180216,59926,59184,12218,71402,944
2022-07-06,Inyo,027,18085,4324,4282,710,4992,56
2022-07-06,Kern,029,883053,205100,203587,52362,255949,2353
2022-07-06,Kings,031,150075,54890,54560,3683,58243,449
2022-07-06,Lake,033,64148,11735,11659,1030,12689,140
2022-07-06,Lassen,035,31185,9378,9350,933,10283,64
2022-07-06,Los Angeles,037,10098052,3021683,2991161,150970,3142131,32116
2022-07-06,Madera,039,155013,40217,39952,6896,46848,372
2022-07-06,Marin,041,260295,41498,41036,4722,45758,302
2022-07-06,Mariposa,043,17540,2830,2797,279,3076,30
2022-07-06,Mendocino,045,87422,14691,14540,3849,18389,127
2022-07-06,Merced,047,269075,66908,66420,9859,76279,832
2022-07-06,Modoc,049,8938,808,788,286,1074,8
2022-07-06,Mono,051,14174,3126,3109,195,3304,7
2022-07-06,Monterey,053,433212,87385,86639,17509,104148,744
2022-07-06,Napa,055,140530,29921,29690,1297,30987,144
2022-07-06,Nevada,057,99092,17815,17660,1533,19193,131
2022-07-06,Orange,059,3164182,613016,608084,51438,659522,7125
2022-07-06,Placer,061,380077,70766,70113,8593,78706,632
2022-07-06,Plumas,063,18699,3358,3316,405,3721,13
2022-07-06,Riverside,065,2383286,641586,636209,31145,667354,6505
2022-07-06,Sacramento,067,1510023,319727,317315,30950,348265,3104
2022-07-06,San Benito,069,59416,14681,14556,753,15309,100
2022-07-06,San Bernardino,071,2135413,614367,608119,26987,635106,7870
2022-07-06,San Diego,073,3302833,847911,839970,63035,903005,5349
2022-07-06,San Francisco,075,870044,162964,160612,10750,171362,910
2022-07-06,San Joaquin,077,732212,182785,181448,12183,193631,2256
2022-07-06,San Luis Obispo,079,281455,59024,58488,5847,64335,496
2022-07-06,San Mateo,081,765935,153236,151344,9698,161042,723
2022-07-06,Santa Barbara,083,443738,96672,95918,5712,101630,702
2022-07-06,Santa Clara,085,1922200,390698,385553,16914,402467,2358
2022-07-06,Santa Cruz,087,273765,56904,56307,2883,59190,267
2022-07-06,Shasta,089,179085,32712,32444,6645,39089,570
2022-07-06,Sierra,091,2930,288,290,57,347,4
2022-07-06,Siskiyou,093,43540,4870,4841,3043,7884,82
2022-07-06,Solano,095,438530,96226,95181,6882,102063,455
2022-07-06,Sonoma,097,501317,98911,98031,4423,102454,495
2022-07-06,Stanislaus,099,539301,127423,126492,19153,145645,1682
2022-07-06,Sutter,101,95872,22197,22089,2339,24428,228
2022-07-06,Tehama,103,63373,12802,12680,2778,15458,205
2022-07-06,Trinity,105,12862,1287,1263,316,1579,20
2022-07-06,Tulare,107,460477,113350,112684,30966,143650,1500
2022-07-06,Tuolumne,109,53932,14114,13960,787,14747,189
2022-07-06,Ventura,111,848112,192466,190794,12379,203173,1517
2022-07-06,Yolo,113,214977,44520,43171,3762,46933,324
2022-07-06,Yuba,115,75493,17378,17277,1471,18748,124
2022-07-05,Alameda,001,1643700,313775,310551,17738,328289,1899
2022-07-05,Alpine,003,1148,129,129,1,130,0
2022-07-05,Amador,005,37829,9350,9301,778,10079,87
2022-07-05,Butte,007,227075,36331,36053,7993,44046,436
2022-07-05,Calaveras,009,45235,7921,7873,420,8293,124
2022-07-05,Colusa,011,21464,3593,3579,1140,4719,22
2022-07-05,Contra Costa,013,1133247,226455,223500,17515,241015,1348
2022-07-05,Del Norte,015,27424,6756,6623,321,6944,54
2022-07-05,El Dorado,017,186661,30187,29953,3836,33789,218
2022-07-05,Fresno,019,978130,250883,249480,26400,275880,2786
2022-07-05,Glenn,021,27897,5246,5222,1752,6974,48
2022-07-05,Humboldt,023,135768,19771,19608,4071,23679,149
2022-07-05,Imperial,025,180216,59786,59184,12118,71302,944
2022-07-05,Inyo,027,18085,4310,4282,700,4982,56
2022-07-05,Kern,029,883053,204668,203587,52165,255752,2353
2022-07-05,Kings,031,150075,54762,54560,3670,58230,449
2022-07-05,Lake,033,64148,11712,11659,1027,12686,140
2022-07-05,Lassen,035,31185,9367,9350,933,10283,64
2022-07-05,Los Angeles,037,10098052,3014859,2991161,150207,3141368,32116
2022-07-05,Madera,039,155013,40132,39952,6875,46827,372
2022-07-05,Marin,041,260295,41397,41036,4712,45748,302
2022-07-05,Mariposa,043,17540,2820,2797,275,3072,30
2022-07-05,Mendocino,045,87422,14646,14540,3834,18374,127
2022-07-05,Merced,047,269075,66788,66420,9831,76251,832
2022-07-05,Modoc,049,8938,800,788,286,1074,8
2022-07-05,Mono,051,14174,3124,3109,192,3301,7
2022-07-05,Monterey,053,433212,87230,86639,17457,104096,744
2022-07-05,Napa,055,140530,29869,29690,1292,30982,144
2022-07-05,Nevada,057,99092,17776,17660,1523,19183,131
2022-07-05,Orange,059,3164182,611470,608084,51199,659283,7125
2022-07-05,Placer,061,380077,70661,70113,8572,78685,632
2022-07-05,Plumas,063,18699,3348,3316,404,3720,13
2022-07-05,Riverside,065,2383286,640122,636209,31061,667270,6505
2022-07-05,Sacramento,067,1510023,319078,317315,30881,348196,3104
2022-07-05,San Benito,069,59416,14647,14556,746,15302,100
2022-07-05,San Bernardino,071,2135413,613072,608119,26916,635035,7870
2022-07-05,San Diego,073,3302833,845554,839970,62797,902767,5349
2022-07-05,San Francisco,075,870044,162447,160612,10724,171336,910
2022-07-05,San Joaquin,077,732212,182426,181448,12113,193561,2256
2022-07-05,San Luis Obispo,079,281455,58868,58488,5804,64292,496
2022-07-05,San Mateo,081,765935,152759,151344,9675,161019,723
2022-07-05,Santa Barbara,083,443738,96449,95918,5683,101601,702
2022-07-05,Santa Clara,085,1922200,389537,385553,16861,402414,2358
2022-07-05,Santa Cruz,087,273765,56728,56307,2867,59174,267
2022-07-05,Shasta,089,179085,32669,32444,6621,39065,570
2022-07-05,Sierra,091,2930,288,290,57,347,4
2022-07-05,Siskiyou,093,43540,4863,4841,3031,7872,82
2022-07-05,Solano,095,438530,95951,95181,6859,102040,455
2022-07-05,Sonoma,097,501317,98676,98031,4405,102436,495
2022-07-05,Stanislaus,099,539301,127181,126492,19114,145606,1682
2022-07-05,Sutter,101,95872,22155,22089,2337,24426,228
2022-07-05,Tehama,103,63373,12777,12680,2774,15454,205
2022-07-05,Trinity,105,12862,1278,1263,314,1577,20
2022-07-05,Tulare,107,460477,113112,112684,30884,143568,1500
2022-07-05,Tuolumne,109,53932,14080,13960,780,14740,189
2022-07-05,Ventura,111,848112,192069,190794,12317,203111,1517
2022-07-05,Yolo,113,214977,44434,43171,3752,46923,324
2022-07-05,Yuba,115,75493,17349,17277,1470,18747,124
2022-07-04,Alameda,001,1643700,312628,310551,17638,328189,1899
2022-07-04,Alpine,003,1148,129,129,1,130,0
2022-07-04,Amador,005,37829,9337,9301,777,10078,87
2022-07-04,Butte,007,227075,36221,36053,7976,44029,436
2022-07-04,Calaveras,009,45235,7911,7873,420,8293,124
2022-07-04,Colusa,011,21464,3589,3579,1138,4717,22
2022-07-04,Contra Costa,013,1133247,225746,223500,17415,240915,1348
2022-07-04,Del Norte,015,27424,6723,6623,317,6940,54
2022-07-04,El Dorado,017,186661,30101,29953,3818,33771,218
2022-07-04,Fresno,019,978130,250238,249480,26276,275756,2786
2022-07-04,Glenn,021,27897,5238,5222,1746,6968,48
2022-07-04,Humboldt,023,135768,19700,19608,4057,23665,149
2022-07-04,Imperial,025,180216,59578,59184,11997,71181,944
2022-07-04,Inyo,027,18085,4307,4282,690,4972,56
2022-07-04,Kern,029,883053,204228,203587,51911,255498,2353
2022-07-04,Kings,031,150075,54612,54560,3666,58226,449
2022-07-04,Lake,033,64148,11699,11659,1025,12684,140
2022-07-04,Lassen,035,31185,9359,9350,932,10282,64
2022-07-04,Los Angeles,037,10098052,3006480,2991161,149308,3140469,32116
2022-07-04,Madera,039,155013,40038,39952,6849,46801,372
2022-07-04,Marin,041,260295,41279,41036,4702,45738,302
2022-07-04,Mariposa,043,17540,2810,2797,271,3068,30
2022-07-04,Mendocino,045,87422,14610,14540,3794,18334,127
2022-07-04,Merced,047,269075,66659,66420,9784,76204,832
2022-07-04,Modoc,049,8938,792,788,282,1070,8
2022-07-04,Mono,051,14174,3122,3109,190,3299,7
2022-07-04,Monterey,053,433212,87038,86639,17386,104025,744
2022-07-04,Napa,055,140530,29805,29690,1288,30978,144
2022-07-04,Nevada,057,99092,17733,17660,1515,19175,131
2022-07-04,Orange,059,3164182,609665,608084,50910,658994,7125
2022-07-04,Placer,061,380077,70483,70113,8542,78655,632
2022-07-04,Plumas,063,18699,3330,3316,403,3719,13
2022-07-04,Riverside,065,2383286,638484,636209,30966,667175,6505
2022-07-04,Sacramento,067,1510023,318304,317315,30788,348103,3104
2022-07-04,San Benito,069,59416,14591,14556,741,15297,100
2022-07-04,San Bernardino,071,2135413,611503,608119,26851,634970,7870
2022-07-04,San Diego,073,3302833,842917,839970,62470,902440,5349
2022-07-04,San Francisco,075,870044,161837,160612,10663,171275,910
2022-07-04,San Joaquin,077,732212,182029,181448,12049,193497,2256
2022-07-04,San Luis Obispo,079,281455,58683,58488,5730,64218,496
2022-07-04,San Mateo,081,765935,152251,151344,9636,160980,723
2022-07-04,Santa Barbara,083,443738,96227,95918,5661,101579,702
2022-07-04,Santa Clara,085,1922200,388046,385553,16808,402361,2358
2022-07-04,Santa Cruz,087,273765,56529,56307,2845,59152,267
2022-07-04,Shasta,089,179085,32592,32444,6592,39036,570
2022-07-04,Sierra,091,2930,288,290,57,347,4
2022-07-04,Siskiyou,093,43540,4856,4841,3023,7864,82
2022-07-04,Solano,095,438530,95622,95181,6825,102006,455
2022-07-04,Sonoma,097,501317,98384,98031,4379,102410,495
2022-07-04,Stanislaus,099,539301,126891,126492,19064,145556,1682
2022-07-04,Sutter,101,95872,22109,22089,2336,24425,228
2022-07-04,Tehama,103,63373,12751,12680,2760,15440,205
2022-07-04,Trinity,105,12862,1273,1263,312,1575,20
2022-07-04,Tulare,107,460477,112874,112684,30771,143455,1500
2022-07-04,Tuolumne,109,53932,14038,13960,776,14736,189
2022-07-04,Ventura,111,848112,191603,190794,12214,203008,1517
2022-07-04,Yolo,113,214977,44342,43171,3734,46905,324
2022-07-04,Yuba,115,75493,17310,17277,1470,18747,124
2022-07-03,Alameda,001,1643700,312076,307672,17608,325280,1898
2022-07-03,Alpine,003,1148,129,129,1,130,0
2022-07-03,Amador,005,37829,9329,9243,774,10017,87
2022-07-03,Butte,007,227075,36208,35846,7969,43815,436
2022-07-03,Calaveras,009,45235,7895,7836,420,8256,124
2022-07-03,Colusa,011,21464,3587,3566,1136,4702,22
2022-07-03,Contra Costa,013,1133247,225395,221545,17386,238931,1343
2022-07-03,Del Norte,015,27424,6714,6543,316,6859,53
2022-07-03,El Dorado,017,186661,30069,29764,3812,33576,217
2022-07-03,Fresno,019,978130,249995,247952,26241,274193,2783
2022-07-03,Glenn,021,27897,5237,5211,1743,6954,48
2022-07-03,Humboldt,023,135768,19677,19516,4048,23564,149
2022-07-03,Imperial,025,180216,59503,58768,11958,70726,944
2022-07-03,Inyo,027,18085,4303,4261,688,4949,56
2022-07-03,Kern,029,883053,204090,202502,51771,254273,2352
2022-07-03,Kings,031,150075,54587,54262,3664,57926,449
2022-07-03,Lake,033,64148,11688,11595,1025,12620,140
2022-07-03,Lassen,035,31185,9356,9336,931,10267,64
2022-07-03,Los Angeles,037,10098052,3003785,2969395,148952,3118347,32089
2022-07-03,Madera,039,155013,40011,39738,6844,46582,372
2022-07-03,Marin,041,260295,41209,40653,4693,45346,297
2022-07-03,Mariposa,043,17540,2806,2780,270,3050,30
2022-07-03,Mendocino,045,87422,14598,14464,3793,18257,127
2022-07-03,Merced,047,269075,66610,66093,9779,75872,832
2022-07-03,Modoc,049,8938,792,787,282,1069,8
2022-07-03,Mono,051,14174,3121,3099,189,3288,7
2022-07-03,Monterey,053,433212,86931,86212,17331,103543,744
2022-07-03,Napa,055,140530,29785,29486,1285,30771,145
2022-07-03,Nevada,057,99092,17714,17546,1509,19055,131
2022-07-03,Orange,059,3164182,609129,603511,50779,654290,7114
2022-07-03,Placer,061,380077,70396,69606,8528,78134,631
2022-07-03,Plumas,063,18699,3323,3294,403,3697,13
2022-07-03,Riverside,065,2383286,637913,632038,30923,662961,6502
2022-07-03,Sacramento,067,1510023,318032,315165,30768,345933,3100
2022-07-03,San Benito,069,59416,14584,14420,740,15160,100
2022-07-03,San Bernardino,071,2135413,610923,604093,26822,630915,7860
2022-07-03,San Diego,073,3302833,842187,834116,62402,896518,5341
2022-07-03,San Francisco,075,870044,161500,158871,10651,169522,910
2022-07-03,San Joaquin,077,732212,181859,180368,12012,192380,2256
2022-07-03,San Luis Obispo,079,281455,58614,58079,5720,63799,489
2022-07-03,San Mateo,081,765935,151949,149812,9619,159431,723
2022-07-03,Santa Barbara,083,443738,96119,95214,5649,100863,699
2022-07-03,Santa Clara,085,1922200,387321,381630,16778,398408,2355
2022-07-03,Santa Cruz,087,273765,56468,55757,2824,58581,267
2022-07-03,Shasta,089,179085,32557,32280,6582,38862,570
2022-07-03,Sierra,091,2930,287,283,57,340,4
2022-07-03,Siskiyou,093,43540,4852,4808,3021,7829,82
2022-07-03,Solano,095,438530,95546,94437,6821,101258,455
2022-07-03,Sonoma,097,501317,98279,97379,4375,101754,495
2022-07-03,Stanislaus,099,539301,126774,125788,19048,144836,1681
2022-07-03,Sutter,101,95872,22088,21935,2335,24270,228
2022-07-03,Tehama,103,63373,12733,12615,2758,15373,205
2022-07-03,Trinity,105,12862,1272,1256,309,1565,20
2022-07-03,Tulare,107,460477,112776,112118,30733,142851,1500
2022-07-03,Tuolumne,109,53932,14015,13886,773,14659,189
2022-07-03,Ventura,111,848112,191392,189493,12195,201688,1517
2022-07-03,Yolo,113,214977,44298,42760,3725,46485,324
2022-07-03,Yuba,115,75493,17296,17168,1469,18637,124
2022-07-02,Alameda,001,1643700,311699,307672,17580,325252,1898
2022-07-02,Alpine,003,1148,129,129,1,130,0
2022-07-02,Amador,005,37829,9313,9243,773,10016,87
2022-07-02,Butte,007,227075,36183,35846,7956,43802,436
2022-07-02,Calaveras,009,45235,7889,7836,420,8256,124
2022-07-02,Colusa,011,21464,3583,3566,1134,4700,22
2022-07-02,Contra Costa,013,1133247,225047,221545,17334,238879,1343
2022-07-02,Del Norte,015,27424,6704,6543,316,6859,53
2022-07-02,El Dorado,017,186661,30035,29764,3807,33571,217
2022-07-02,Fresno,019,978130,249779,247952,26209,274161,2783
2022-07-02,Glenn,021,27897,5232,5211,1742,6953,48
2022-07-02,Humboldt,023,135768,19651,19516,4044,23560,149
2022-07-02,Imperial,025,180216,59425,58768,11937,70705,944
2022-07-02,Inyo,027,18085,4299,4261,686,4947,56
2022-07-02,Kern,029,883053,203939,202502,51625,254127,2352
2022-07-02,Kings,031,150075,54542,54262,3664,57926,449
2022-07-02,Lake,033,64148,11679,11595,1023,12618,140
2022-07-02,Lassen,035,31185,9355,9336,930,10266,64
2022-07-02,Los Angeles,037,10098052,3001130,2969395,148534,3117929,32089
2022-07-02,Madera,039,155013,39981,39738,6840,46578,372
2022-07-02,Marin,041,260295,41147,40653,4676,45329,297
2022-07-02,Mariposa,043,17540,2803,2780,269,3049,30
2022-07-02,Mendocino,045,87422,14570,14464,3793,18257,127
2022-07-02,Merced,047,269075,66551,66093,9770,75863,832
2022-07-02,Modoc,049,8938,792,787,281,1068,8
2022-07-02,Mono,051,14174,3118,3099,189,3288,7
2022-07-02,Monterey,053,433212,86843,86212,17293,103505,744
2022-07-02,Napa,055,140530,29756,29486,1284,30770,145
2022-07-02,Nevada,057,99092,17699,17546,1503,19049,131
2022-07-02,Orange,059,3164182,608484,603511,50626,654137,7114
2022-07-02,Placer,061,380077,70303,69606,8514,78120,631
2022-07-02,Plumas,063,18699,3314,3294,403,3697,13
2022-07-02,Riverside,065,2383286,637320,632038,30877,662915,6502
2022-07-02,Sacramento,067,1510023,317698,315165,30747,345912,3100
2022-07-02,San Benito,069,59416,14564,14420,731,15151,100
2022-07-02,San Bernardino,071,2135413,610403,604093,26786,630879,7860
2022-07-02,San Diego,073,3302833,841381,834116,62346,896462,5341
2022-07-02,San Francisco,075,870044,161214,158871,10627,169498,910
2022-07-02,San Joaquin,077,732212,181728,180368,11988,192356,2256
2022-07-02,San Luis Obispo,079,281455,58566,58079,5706,63785,489
2022-07-02,San Mateo,081,765935,151694,149812,9599,159411,723
2022-07-02,Santa Barbara,083,443738,95992,95214,5638,100852,699
2022-07-02,Santa Clara,085,1922200,386583,381630,16748,398378,2355
2022-07-02,Santa Cruz,087,273765,56409,55757,2814,58571,267
2022-07-02,Shasta,089,179085,32528,32280,6571,38851,570
2022-07-02,Sierra,091,2930,287,283,57,340,4
2022-07-02,Siskiyou,093,43540,4845,4808,3020,7828,82
2022-07-02,Solano,095,438530,95476,94437,6806,101243,455
2022-07-02,Sonoma,097,501317,98175,97379,4367,101746,495
2022-07-02,Stanislaus,099,539301,126655,125788,19033,144821,1681
2022-07-02,Sutter,101,95872,22069,21935,2335,24270,228
2022-07-02,Tehama,103,63373,12710,12615,2757,15372,205
2022-07-02,Trinity,105,12862,1270,1256,308,1564,20
2022-07-02,Tulare,107,460477,112674,112118,30691,142809,1500
2022-07-02,Tuolumne,109,53932,14002,13886,764,14650,189
2022-07-02,Ventura,111,848112,191219,189493,12170,201663,1517
2022-07-02,Yolo,113,214977,44253,42760,3718,46478,324
2022-07-02,Yuba,115,75493,17284,17168,1469,18637,124
2022-07-01,Alameda,001,1643700,311220,307672,17551,325223,1898
2022-07-01,Alpine,003,1148,129,129,1,130,0
2022-07-01,Amador,005,37829,9308,9243,771,10014,87
2022-07-01,Butte,007,227075,36156,35846,7937,43783,436
2022-07-01,Calaveras,009,45235,7878,7836,420,8256,124
2022-07-01,Colusa,011,21464,3580,3566,1134,4700,22
2022-07-01,Contra Costa,013,1133247,224744,221545,17291,238836,1343
2022-07-01,Del Norte,015,27424,6684,6543,314,6857,53
2022-07-01,El Dorado,017,186661,30010,29764,3799,33563,217
2022-07-01,Fresno,019,978130,249497,247952,26160,274112,2783
2022-07-01,Glenn,021,27897,5232,5211,1742,6953,48
2022-07-01,Humboldt,023,135768,19629,19516,4035,23551,149
2022-07-01,Imperial,025,180216,59349,58768,11910,70678,944
2022-07-01,Inyo,027,18085,4292,4261,680,4941,56
2022-07-01,Kern,029,883053,203737,202502,51505,254007,2352
2022-07-01,Kings,031,150075,54509,54262,3660,57922,449
2022-07-01,Lake,033,64148,11668,11595,1022,12617,140
2022-07-01,Lassen,035,31185,9352,9336,930,10266,64
2022-07-01,Los Angeles,037,10098052,2997695,2969395,148028,3117423,32089
2022-07-01,Madera,039,155013,39938,39738,6827,46565,372
2022-07-01,Marin,041,260295,41075,40653,4663,45316,297
2022-07-01,Mariposa,043,17540,2801,2780,268,3048,30
2022-07-01,Mendocino,045,87422,14550,14464,3789,18253,127
2022-07-01,Merced,047,269075,66467,66093,9766,75859,832
2022-07-01,Modoc,049,8938,792,787,280,1067,8
2022-07-01,Mono,051,14174,3110,3099,189,3288,7
2022-07-01,Monterey,053,433212,86760,86212,17262,103474,744
2022-07-01,Napa,055,140530,29712,29486,1284,30770,145
2022-07-01,Nevada,057,99092,17679,17546,1498,19044,131
2022-07-01,Orange,059,3164182,607774,603511,50470,653981,7114
2022-07-01,Placer,061,380077,70236,69606,8502,78108,631
2022-07-01,Plumas,063,18699,3312,3294,403,3697,13
2022-07-01,Riverside,065,2383286,636608,632038,30824,662862,6502
2022-07-01,Sacramento,067,1510023,317316,315165,30730,345895,3100
2022-07-01,San Benito,069,59416,14546,14420,730,15150,100
2022-07-01,San Bernardino,071,2135413,609780,604093,26752,630845,7860
2022-07-01,San Diego,073,3302833,840348,834116,62208,896324,5341
2022-07-01,San Francisco,075,870044,160935,158871,10587,169458,910
2022-07-01,San Joaquin,077,732212,181586,180368,11959,192327,2256
2022-07-01,San Luis Obispo,079,281455,58538,58079,5697,63776,489
2022-07-01,San Mateo,081,765935,151418,149812,9579,159391,723
2022-07-01,Santa Barbara,083,443738,95876,95214,5629,100843,699
2022-07-01,Santa Clara,085,1922200,385883,381630,16712,398342,2355
2022-07-01,Santa Cruz,087,273765,56344,55757,2800,58557,267
2022-07-01,Shasta,089,179085,32508,32280,6561,38841,570
2022-07-01,Sierra,091,2930,287,283,57,340,4
2022-07-01,Siskiyou,093,43540,4841,4808,3018,7826,82
2022-07-01,Solano,095,438530,95310,94437,6792,101229,455
2022-07-01,Sonoma,097,501317,98061,97379,4345,101724,495
2022-07-01,Stanislaus,099,539301,126526,125788,19007,144795,1681
2022-07-01,Sutter,101,95872,22040,21935,2335,24270,228
2022-07-01,Tehama,103,63373,12701,12615,2755,15370,205
2022-07-01,Trinity,105,12862,1269,1256,308,1564,20
2022-07-01,Tulare,107,460477,112578,112118,30649,142767,1500
2022-07-01,Tuolumne,109,53932,13984,13886,757,14643,189
2022-07-01,Ventura,111,848112,191008,189493,12134,201627,1517
2022-07-01,Yolo,113,214977,44218,42760,3703,46463,324
2022-07-01,Yuba,115,75493,17263,17168,1469,18637,124
2022-06-30,Alameda,001,1643700,310391,307672,17472,325144,1898
2022-06-30,Alpine,003,1148,129,129,1,130,0
2022-06-30,Amador,005,37829,9298,9243,768,10011,87
2022-06-30,Butte,007,227075,36109,35846,7920,43766,436
2022-06-30,Calaveras,009,45235,7867,7836,419,8255,124
2022-06-30,Colusa,011,21464,3576,3566,1132,4698,22
2022-06-30,Contra Costa,013,1133247,224198,221545,17222,238767,1343
2022-06-30,Del Norte,015,27424,6667,6543,311,6854,53
2022-06-30,El Dorado,017,186661,29966,29764,3791,33555,217
2022-06-30,Fresno,019,978130,249103,247952,26116,274068,2783
2022-06-30,Glenn,021,27897,5229,5211,1742,6953,48
2022-06-30,Humboldt,023,135768,19592,19516,4029,23545,149
2022-06-30,Imperial,025,180216,59236,58768,11880,70648,944
2022-06-30,Inyo,027,18085,4286,4261,680,4941,56
2022-06-30,Kern,029,883053,203424,202502,51340,253842,2352
2022-06-30,Kings,031,150075,54433,54262,3657,57919,449
2022-06-30,Lake,033,64148,11649,11595,1019,12614,140
2022-06-30,Lassen,035,31185,9349,9336,929,10265,64
2022-06-30,Los Angeles,037,10098052,2992373,2969395,147443,3116838,32089
2022-06-30,Madera,039,155013,39873,39738,6804,46542,372
2022-06-30,Marin,041,260295,40991,40653,4656,45309,297
2022-06-30,Mariposa,043,17540,2795,2780,266,3046,30
2022-06-30,Mendocino,045,87422,14534,14464,3783,18247,127
2022-06-30,Merced,047,269075,66369,66093,9749,75842,832
2022-06-30,Modoc,049,8938,791,787,279,1066,8
2022-06-30,Mono,051,14174,3108,3099,188,3287,7
2022-06-30,Monterey,053,433212,86615,86212,17199,103411,744
2022-06-30,Napa,055,140530,29653,29486,1278,30764,145
2022-06-30,Nevada,057,99092,17651,17546,1491,19037,131
2022-06-30,Orange,059,3164182,606600,603511,50290,653801,7114
2022-06-30,Placer,061,380077,70088,69606,8485,78091,631
2022-06-30,Plumas,063,18699,3307,3294,402,3696,13
2022-06-30,Riverside,065,2383286,635510,632038,30754,662792,6502
2022-06-30,Sacramento,067,1510023,316735,315165,30688,345853,3100
2022-06-30,San Benito,069,59416,14509,14420,727,15147,100
2022-06-30,San Bernardino,071,2135413,608761,604093,26716,630809,7860
2022-06-30,San Diego,073,3302833,838826,834116,62013,896129,5341
2022-06-30,San Francisco,075,870044,160506,158871,10556,169427,910
2022-06-30,San Joaquin,077,732212,181305,180368,11930,192298,2256
2022-06-30,San Luis Obispo,079,281455,58437,58079,5670,63749,489
2022-06-30,San Mateo,081,765935,151015,149812,9545,159357,723
2022-06-30,Santa Barbara,083,443738,95679,95214,5618,100832,699
2022-06-30,Santa Clara,085,1922200,384788,381630,16669,398299,2355
2022-06-30,Santa Cruz,087,273765,56226,55757,2786,58543,267
2022-06-30,Shasta,089,179085,32469,32280,6542,38822,570
2022-06-30,Sierra,091,2930,287,283,57,340,4
2022-06-30,Siskiyou,093,43540,4833,4808,3011,7819,82
2022-06-30,Solano,095,438530,95110,94437,6763,101200,455
2022-06-30,Sonoma,097,501317,97907,97379,4324,101703,495
2022-06-30,Stanislaus,099,539301,126331,125788,18983,144771,1681
2022-06-30,Sutter,101,95872,22007,21935,2333,24268,228
2022-06-30,Tehama,103,63373,12681,12615,2752,15367,205
2022-06-30,Trinity,105,12862,1263,1256,306,1562,20
2022-06-30,Tulare,107,460477,112428,112118,30574,142692,1500
2022-06-30,Tuolumne,109,53932,13965,13886,751,14637,189
2022-06-30,Ventura,111,848112,190664,189493,12060,201553,1517
2022-06-30,Yolo,113,214977,44147,42760,3685,46445,324
2022-06-30,Yuba,115,75493,17235,17168,1463,18631,124
2022-06-29,Alameda,001,1643700,309594,305288,17431,322719,1895
2022-06-29,Alpine,003,1148,129,129,1,130,0
2022-06-29,Amador,005,37829,9291,9205,768,9973,87
2022-06-29,Butte,007,227075,36060,35651,7906,43557,434
2022-06-29,Calaveras,009,45235,7855,7798,416,8214,124
2022-06-29,Colusa,011,21464,3573,3548,1130,4678,22
2022-06-29,Contra Costa,013,1133247,223714,219921,17168,237089,1339
2022-06-29,Del Norte,015,27424,6641,6484,307,6791,53
2022-06-29,El Dorado,017,186661,29908,29549,3775,33324,216
2022-06-29,Fresno,019,978130,248714,246740,26059,272799,2777
2022-06-29,Glenn,021,27897,5228,5192,1740,6932,48
2022-06-29,Humboldt,023,135768,19566,19411,4019,23430,149
2022-06-29,Imperial,025,180216,59116,58498,11832,70330,944
2022-06-29,Inyo,027,18085,4282,4243,675,4918,56
2022-06-29,Kern,029,883053,203141,201537,51180,252717,2343
2022-06-29,Kings,031,150075,54343,54031,3655,57686,448
2022-06-29,Lake,033,64148,11621,11548,1015,12563,140
2022-06-29,Lassen,035,31185,9344,9310,929,10239,64
2022-06-29,Los Angeles,037,10098052,2986772,2955489,146853,3102342,32062
2022-06-29,Madera,039,155013,39822,39554,6795,46349,372
2022-06-29,Marin,041,260295,40887,40397,4650,45047,297
2022-06-29,Mariposa,043,17540,2793,2753,266,3019,30
2022-06-29,Mendocino,045,87422,14505,14383,3767,18150,127
2022-06-29,Merced,047,269075,66275,65733,9738,75471,830
2022-06-29,Modoc,049,8938,789,780,278,1058,8
2022-06-29,Mono,051,14174,3108,3081,186,3267,7
2022-06-29,Monterey,053,433212,86483,85711,17149,102860,743
2022-06-29,Napa,055,140530,29603,29285,1274,30559,144
2022-06-29,Nevada,057,99092,17617,17439,1487,18926,129
2022-06-29,Orange,059,3164182,605437,599951,50128,650079,7095
2022-06-29,Placer,061,380077,69953,69244,8476,77720,629
2022-06-29,Plumas,063,18699,3304,3267,400,3667,13
2022-06-29,Riverside,065,2383286,634457,629035,30687,659722,6493
2022-06-29,Sacramento,067,1510023,316143,313224,30639,343863,3082
2022-06-29,San Benito,069,59416,14473,14302,719,15021,100
2022-06-29,San Bernardino,071,2135413,607782,600960,26622,627582,7825
2022-06-29,San Diego,073,3302833,837102,828907,61785,890692,5336
2022-06-29,San Francisco,075,870044,160023,157419,10522,167941,902
2022-06-29,San Joaquin,077,732212,181010,179476,11895,191371,2252
2022-06-29,San Luis Obispo,079,281455,58303,57783,5633,63416,486
2022-06-29,San Mateo,081,765935,150638,148533,9524,158057,723
2022-06-29,Santa Barbara,083,443738,95528,94683,5607,100290,699
2022-06-29,Santa Clara,085,1922200,383795,378000,16611,394611,2348
2022-06-29,Santa Cruz,087,273765,56101,55432,2772,58204,266
2022-06-29,Shasta,089,179085,32422,32106,6526,38632,570
2022-06-29,Sierra,091,2930,285,283,57,340,4
2022-06-29,Siskiyou,093,43540,4825,4773,3010,7783,82
2022-06-29,Solano,095,438530,94886,92975,6748,99723,455
2022-06-29,Sonoma,097,501317,97729,96854,4312,101166,493
2022-06-29,Stanislaus,099,539301,126155,125189,18957,144146,1674
2022-06-29,Sutter,101,95872,21954,21836,2328,24164,227
2022-06-29,Tehama,103,63373,12662,12561,2751,15312,205
2022-06-29,Trinity,105,12862,1261,1245,305,1550,20
2022-06-29,Tulare,107,460477,112295,111707,30501,142208,1499
2022-06-29,Tuolumne,109,53932,13942,13779,734,14513,189
2022-06-29,Ventura,111,848112,190357,188519,11999,200518,1514
2022-06-29,Yolo,113,214977,44045,42410,3674,46084,323
2022-06-29,Yuba,115,75493,17206,17082,1461,18543,124
2022-06-28,Alameda,001,1643700,308755,305288,17395,322683,1895
2022-06-28,Alpine,003,1148,129,129,1,130,0
2022-06-28,Amador,005,37829,9286,9205,767,9972,87
2022-06-28,Butte,007,227075,35994,35651,7888,43539,434
2022-06-28,Calaveras,009,45235,7843,7798,416,8214,124
2022-06-28,Colusa,011,21464,3572,3548,1129,4677,22
2022-06-28,Contra Costa,013,1133247,223108,219921,17105,237026,1339
2022-06-28,Del Norte,015,27424,6604,6484,305,6789,53
2022-06-28,El Dorado,017,186661,29860,29549,3764,33313,216
2022-06-28,Fresno,019,978130,248284,246740,26005,272745,2777
2022-06-28,Glenn,021,27897,5220,5192,1735,6927,48
2022-06-28,Humboldt,023,135768,19546,19411,4012,23423,149
2022-06-28,Imperial,025,180216,59017,58498,11755,70253,944
2022-06-28,Inyo,027,18085,4276,4243,669,4912,56
2022-06-28,Kern,029,883053,202854,201537,50976,252513,2343
2022-06-28,Kings,031,150075,54261,54031,3650,57681,448
2022-06-28,Lake,033,64148,11610,11548,1013,12561,140
2022-06-28,Lassen,035,31185,9337,9310,929,10239,64
2022-06-28,Los Angeles,037,10098052,2980871,2955489,146253,3101742,32062
2022-06-28,Madera,039,155013,39764,39554,6778,46332,372
2022-06-28,Marin,041,260295,40779,40397,4643,45040,297
2022-06-28,Mariposa,043,17540,2785,2753,264,3017,30
2022-06-28,Mendocino,045,87422,14477,14383,3755,18138,127
2022-06-28,Merced,047,269075,66173,65733,9720,75453,830
2022-06-28,Modoc,049,8938,787,780,277,1057,8
2022-06-28,Mono,051,14174,3101,3081,184,3265,7
2022-06-28,Monterey,053,433212,86358,85711,17102,102813,743
2022-06-28,Napa,055,140530,29535,29285,1271,30556,144
2022-06-28,Nevada,057,99092,17587,17439,1483,18922,129
2022-06-28,Orange,059,3164182,604093,599951,49959,649910,7095
2022-06-28,Placer,061,380077,69790,69244,8467,77711,629
2022-06-28,Plumas,063,18699,3304,3267,399,3666,13
2022-06-28,Riverside,065,2383286,633261,629035,30641,659676,6493
2022-06-28,Sacramento,067,1510023,315467,313224,30584,343808,3082
2022-06-28,San Benito,069,59416,14433,14302,718,15020,100
2022-06-28,San Bernardino,071,2135413,606673,600960,26577,627537,7825
2022-06-28,San Diego,073,3302833,835240,828907,61547,890454,5336
2022-06-28,San Francisco,075,870044,159502,157419,10497,167916,902
2022-06-28,San Joaquin,077,732212,180702,179476,11860,191336,2252
2022-06-28,San Luis Obispo,079,281455,58186,57783,5596,63379,486
2022-06-28,San Mateo,081,765935,150192,148533,9499,158032,723
2022-06-28,Santa Barbara,083,443738,95358,94683,5590,100273,699
2022-06-28,Santa Clara,085,1922200,382683,378000,16555,394555,2348
2022-06-28,Santa Cruz,087,273765,55969,55432,2764,58196,266
2022-06-28,Shasta,089,179085,32375,32106,6513,38619,570
2022-06-28,Sierra,091,2930,285,283,57,340,4
2022-06-28,Siskiyou,093,43540,4818,4773,3004,7777,82
2022-06-28,Solano,095,438530,94617,92975,6733,99708,455
2022-06-28,Sonoma,097,501317,97525,96854,4297,101151,493
2022-06-28,Stanislaus,099,539301,125953,125189,18940,144129,1674
2022-06-28,Sutter,101,95872,21918,21836,2326,24162,227
2022-06-28,Tehama,103,63373,12642,12561,2747,15308,205
2022-06-28,Trinity,105,12862,1258,1245,303,1548,20
2022-06-28,Tulare,107,460477,112106,111707,30427,142134,1499
2022-06-28,Tuolumne,109,53932,13911,13779,728,14507,189
2022-06-28,Ventura,111,848112,190034,188519,11922,200441,1514
2022-06-28,Yolo,113,214977,43932,42410,3668,46078,323
2022-06-28,Yuba,115,75493,17171,17082,1457,18539,124
2022-06-27,Alameda,001,1643700,307821,305288,17340,322628,1895
2022-06-27,Alpine,003,1148,129,129,1,130,0
2022-06-27,Amador,005,37829,9271,9205,765,9970,87
2022-06-27,Butte,007,227075,35942,35651,7868,43519,434
2022-06-27,Calaveras,009,45235,7828,7798,416,8214,124
2022-06-27,Colusa,011,21464,3568,3548,1127,4675,22
2022-06-27,Contra Costa,013,1133247,222426,219921,17040,236961,1339
2022-06-27,Del Norte,015,27424,6584,6484,299,6783,53
2022-06-27,El Dorado,017,186661,29796,29549,3746,33295,216
2022-06-27,Fresno,019,978130,247819,246740,25940,272680,2777
2022-06-27,Glenn,021,27897,5214,5192,1728,6920,48
2022-06-27,Humboldt,023,135768,19509,19411,4000,23411,149
2022-06-27,Imperial,025,180216,58877,58498,11689,70187,944
2022-06-27,Inyo,027,18085,4266,4243,660,4903,56
2022-06-27,Kern,029,883053,202502,201537,50771,252308,2343
2022-06-27,Kings,031,150075,54174,54031,3647,57678,448
2022-06-27,Lake,033,64148,11591,11548,1008,12556,140
2022-06-27,Lassen,035,31185,9328,9310,929,10239,64
2022-06-27,Los Angeles,037,10098052,2974684,2955489,145694,3101183,32062
2022-06-27,Madera,039,155013,39699,39554,6766,46320,372
2022-06-27,Marin,041,260295,40672,40397,4630,45027,297
2022-06-27,Mariposa,043,17540,2776,2753,262,3015,30
2022-06-27,Mendocino,045,87422,14447,14383,3749,18132,127
2022-06-27,Merced,047,269075,66063,65733,9684,75417,830
2022-06-27,Modoc,049,8938,782,780,276,1056,8
2022-06-27,Mono,051,14174,3100,3081,184,3265,7
2022-06-27,Monterey,053,433212,86208,85711,17041,102752,743
2022-06-27,Napa,055,140530,29465,29285,1268,30553,144
2022-06-27,Nevada,057,99092,17557,17439,1469,18908,129
2022-06-27,Orange,059,3164182,602732,599951,49747,649698,7095
2022-06-27,Placer,061,380077,69677,69244,8443,77687,629
2022-06-27,Plumas,063,18699,3299,3267,398,3665,13
2022-06-27,Riverside,065,2383286,632114,629035,30574,659609,6493
2022-06-27,Sacramento,067,1510023,314740,313224,30535,343759,3082
2022-06-27,San Benito,069,59416,14378,14302,715,15017,100
2022-06-27,San Bernardino,071,2135413,605568,600960,26531,627491,7825
2022-06-27,San Diego,073,3302833,833311,828907,61316,890223,5336
2022-06-27,San Francisco,075,870044,158957,157419,10470,167889,902
2022-06-27,San Joaquin,077,732212,180361,179476,11818,191294,2252
2022-06-27,San Luis Obispo,079,281455,58076,57783,5560,63343,486
2022-06-27,San Mateo,081,765935,149726,148533,9463,157996,723
2022-06-27,Santa Barbara,083,443738,95171,94683,5576,100259,699
2022-06-27,Santa Clara,085,1922200,381257,378000,16501,394501,2348
2022-06-27,Santa Cruz,087,273765,55799,55432,2756,58188,266
2022-06-27,Shasta,089,179085,32314,32106,6495,38601,570
2022-06-27,Sierra,091,2930,285,283,57,340,4
2022-06-27,Siskiyou,093,43540,4808,4773,2997,7770,82
2022-06-27,Solano,095,438530,94307,92975,6701,99676,455
2022-06-27,Sonoma,097,501317,97335,96854,4280,101134,493
2022-06-27,Stanislaus,099,539301,125725,125189,18922,144111,1674
2022-06-27,Sutter,101,95872,21877,21836,2323,24159,227
2022-06-27,Tehama,103,63373,12620,12561,2745,15306,205
2022-06-27,Trinity,105,12862,1256,1245,301,1546,20
2022-06-27,Tulare,107,460477,111925,111707,30341,142048,1499
2022-06-27,Tuolumne,109,53932,13877,13779,718,14497,189
2022-06-27,Ventura,111,848112,189653,188519,11863,200382,1514
2022-06-27,Yolo,113,214977,43806,42410,3660,46070,323
2022-06-27,Yuba,115,75493,17143,17082,1454,18536,124
2022-06-26,Alameda,001,1643700,306742,302071,17260,319331,1891
2022-06-26,Alpine,003,1148,129,129,1,130,0
2022-06-26,Amador,005,37829,9232,9135,763,9898,87
2022-06-26,Butte,007,227075,35866,35406,7843,43249,433
2022-06-26,Calaveras,009,45235,7813,7754,413,8167,124
2022-06-26,Colusa,011,21464,3559,3540,1123,4663,22
2022-06-26,Contra Costa,013,1133247,221804,218053,16960,235013,1335
2022-06-26,Del Norte,015,27424,6562,6398,295,6693,52
2022-06-26,El Dorado,017,186661,29712,29313,3721,33034,216
2022-06-26,Fresno,019,978130,247283,245118,25883,271001,2777
2022-06-26,Glenn,021,27897,5209,5178,1725,6903,48
2022-06-26,Humboldt,023,135768,19475,19234,3989,23223,149
2022-06-26,Imperial,025,180216,58731,58127,11596,69723,944
2022-06-26,Inyo,027,18085,4255,4228,647,4875,56
2022-06-26,Kern,029,883053,202203,200556,50568,251124,2344
2022-06-26,Kings,031,150075,54065,53783,3644,57427,448
2022-06-26,Lake,033,64148,11572,11471,1006,12477,140
2022-06-26,Lassen,035,31185,9319,9287,929,10216,64
2022-06-26,Los Angeles,037,10098052,2968120,2936815,145059,3081874,32036
2022-06-26,Madera,039,155013,39629,39319,6748,46067,372
2022-06-26,Marin,041,260295,40551,39979,4609,44588,297
2022-06-26,Mariposa,043,17540,2768,2713,262,2975,30
2022-06-26,Mendocino,045,87422,14418,14292,3723,18015,127
2022-06-26,Merced,047,269075,65931,65408,9657,75065,828
2022-06-26,Modoc,049,8938,781,777,274,1051,8
2022-06-26,Mono,051,14174,3090,3076,184,3260,7
2022-06-26,Monterey,053,433212,86036,85275,16980,102255,743
2022-06-26,Napa,055,140530,29385,29054,1265,30319,144
2022-06-26,Nevada,057,99092,17513,17339,1465,18804,129
2022-06-26,Orange,059,3164182,601242,595761,49544,645305,7090
2022-06-26,Placer,061,380077,69542,68785,8421,77206,628
2022-06-26,Plumas,063,18699,3287,3241,398,3639,13
2022-06-26,Riverside,065,2383286,630884,625794,30517,656311,6493
2022-06-26,Sacramento,067,1510023,313921,310837,30468,341305,3077
2022-06-26,San Benito,069,59416,14333,14192,712,14904,99
2022-06-26,San Bernardino,071,2135413,604366,598062,26471,624533,7803
2022-06-26,San Diego,073,3302833,831116,822848,61148,883996,5332
2022-06-26,San Francisco,075,870044,158314,155609,10417,166026,899
2022-06-26,San Joaquin,077,732212,179986,178447,11776,190223,2252
2022-06-26,San Luis Obispo,079,281455,57941,57472,5511,62983,485
2022-06-26,San Mateo,081,765935,149219,146955,9433,156388,723
2022-06-26,Santa Barbara,083,443738,94961,94017,5548,99565,699
2022-06-26,Santa Clara,085,1922200,379879,373961,16424,390385,2338
2022-06-26,Santa Cruz,087,273765,55643,54874,2748,57622,265
2022-06-26,Shasta,089,179085,32232,31921,6477,38398,570
2022-06-26,Sierra,091,2930,284,283,57,340,4
2022-06-26,Siskiyou,093,43540,4790,4744,2990,7734,81
2022-06-26,Solano,095,438530,94037,92248,6664,98912,455
2022-06-26,Sonoma,097,501317,97101,95981,4248,100229,493
2022-06-26,Stanislaus,099,539301,125524,124493,18899,143392,1672
2022-06-26,Sutter,101,95872,21837,21733,2322,24055,227
2022-06-26,Tehama,103,63373,12603,12510,2739,15249,205
2022-06-26,Trinity,105,12862,1251,1233,299,1532,20
2022-06-26,Tulare,107,460477,111742,111188,30260,141448,1496
2022-06-26,Tuolumne,109,53932,13849,13688,711,14399,189
2022-06-26,Ventura,111,848112,189259,187389,11787,199176,1514
2022-06-26,Yolo,113,214977,43691,41932,3645,45577,323
2022-06-26,Yuba,115,75493,17106,16994,1445,18439,124
2022-06-25,Alameda,001,1643700,306273,302071,17241,319312,1891
2022-06-25,Alpine,003,1148,129,129,1,130,0
2022-06-25,Amador,005,37829,9222,9135,762,9897,87
2022-06-25,Butte,007,227075,35827,35406,7821,43227,433
2022-06-25,Calaveras,009,45235,7804,7754,413,8167,124
2022-06-25,Colusa,011,21464,3554,3540,1123,4663,22
2022-06-25,Contra Costa,013,1133247,221445,218053,16917,234970,1335
2022-06-25,Del Norte,015,27424,6548,6398,292,6690,52
2022-06-25,El Dorado,017,186661,29672,29313,3715,33028,216
2022-06-25,Fresno,019,978130,247053,245118,25861,270979,2777
2022-06-25,Glenn,021,27897,5204,5178,1723,6901,48
2022-06-25,Humboldt,023,135768,19454,19234,3979,23213,149
2022-06-25,Imperial,025,180216,58651,58127,11570,69697,944
2022-06-25,Inyo,027,18085,4253,4228,643,4871,56
2022-06-25,Kern,029,883053,202046,200556,50463,251019,2344
2022-06-25,Kings,031,150075,54027,53783,3644,57427,448
2022-06-25,Lake,033,64148,11563,11471,1005,12476,140
2022-06-25,Lassen,035,31185,9314,9287,927,10214,64
2022-06-25,Los Angeles,037,10098052,2965118,2936815,144677,3081492,32036
2022-06-25,Madera,039,155013,39596,39319,6745,46064,372
2022-06-25,Marin,041,260295,40498,39979,4602,44581,297
2022-06-25,Mariposa,043,17540,2766,2713,262,2975,30
2022-06-25,Mendocino,045,87422,14406,14292,3719,18011,127
2022-06-25,Merced,047,269075,65854,65408,9654,75062,828
2022-06-25,Modoc,049,8938,781,777,274,1051,8
2022-06-25,Mono,051,14174,3085,3076,184,3260,7
2022-06-25,Monterey,053,433212,85935,85275,16952,102227,743
2022-06-25,Napa,055,140530,29354,29054,1261,30315,144
2022-06-25,Nevada,057,99092,17489,17339,1461,18800,129
2022-06-25,Orange,059,3164182,600545,595761,49408,645169,7090
2022-06-25,Placer,061,380077,69447,68785,8401,77186,628
2022-06-25,Plumas,063,18699,3283,3241,398,3639,13
2022-06-25,Riverside,065,2383286,630241,625794,30475,656269,6493
2022-06-25,Sacramento,067,1510023,313610,310837,30442,341279,3077
2022-06-25,San Benito,069,59416,14308,14192,711,14903,99
2022-06-25,San Bernardino,071,2135413,603781,598062,26442,624504,7803
2022-06-25,San Diego,073,3302833,830212,822848,61086,883934,5332
2022-06-25,San Francisco,075,870044,158017,155609,10394,166003,899
2022-06-25,San Joaquin,077,732212,179838,178447,11761,190208,2252
2022-06-25,San Luis Obispo,079,281455,57870,57472,5501,62973,485
2022-06-25,San Mateo,081,765935,148945,146955,9410,156365,723
2022-06-25,Santa Barbara,083,443738,94818,94017,5536,99553,699
2022-06-25,Santa Clara,085,1922200,379027,373961,16397,390358,2338
2022-06-25,Santa Cruz,087,273765,55573,54874,2745,57619,265
2022-06-25,Shasta,089,179085,32195,31921,6462,38383,570
2022-06-25,Sierra,091,2930,284,283,57,340,4
2022-06-25,Siskiyou,093,43540,4787,4744,2987,7731,81
2022-06-25,Solano,095,438530,93951,92248,6645,98893,455
2022-06-25,Sonoma,097,501317,96991,95981,4238,100219,493
2022-06-25,Stanislaus,099,539301,125394,124493,18881,143374,1672
2022-06-25,Sutter,101,95872,21815,21733,2321,24054,227
2022-06-25,Tehama,103,63373,12592,12510,2734,15244,205
2022-06-25,Trinity,105,12862,1250,1233,297,1530,20
2022-06-25,Tulare,107,460477,111665,111188,30218,141406,1496
2022-06-25,Tuolumne,109,53932,13831,13688,708,14396,189
2022-06-25,Ventura,111,848112,189050,187389,11759,199148,1514
2022-06-25,Yolo,113,214977,43627,41932,3639,45571,323
2022-06-25,Yuba,115,75493,17085,16994,1444,18438,124
2022-06-24,Alameda,001,1643700,305687,302071,17204,319275,1891
2022-06-24,Alpine,003,1148,129,129,1,130,0
2022-06-24,Amador,005,37829,9215,9135,760,9895,87
2022-06-24,Butte,007,227075,35796,35406,7807,43213,433
2022-06-24,Calaveras,009,45235,7799,7754,412,8166,124
2022-06-24,Colusa,011,21464,3553,3540,1120,4660,22
2022-06-24,Contra Costa,013,1133247,221102,218053,16894,234947,1335
2022-06-24,Del Norte,015,27424,6537,6398,290,6688,52
2022-06-24,El Dorado,017,186661,29629,29313,3711,33024,216
2022-06-24,Fresno,019,978130,246767,245118,25833,270951,2777
2022-06-24,Glenn,021,27897,5202,5178,1723,6901,48
2022-06-24,Humboldt,023,135768,19424,19234,3974,23208,149
2022-06-24,Imperial,025,180216,58579,58127,11540,69667,944
2022-06-24,Inyo,027,18085,4251,4228,639,4867,56
2022-06-24,Kern,029,883053,201873,200556,50369,250925,2344
2022-06-24,Kings,031,150075,53983,53783,3640,57423,448
2022-06-24,Lake,033,64148,11552,11471,1005,12476,140
2022-06-24,Lassen,035,31185,9311,9287,926,10213,64
2022-06-24,Los Angeles,037,10098052,2961840,2936815,144348,3081163,32036
2022-06-24,Madera,039,155013,39551,39319,6739,46058,372
2022-06-24,Marin,041,260295,40422,39979,4590,44569,297
2022-06-24,Mariposa,043,17540,2759,2713,262,2975,30
2022-06-24,Mendocino,045,87422,14399,14292,3716,18008,127
2022-06-24,Merced,047,269075,65817,65408,9645,75053,828
2022-06-24,Modoc,049,8938,781,777,274,1051,8
2022-06-24,Mono,051,14174,3081,3076,183,3259,7
2022-06-24,Monterey,053,433212,85855,85275,16925,102200,743
2022-06-24,Napa,055,140530,29327,29054,1260,30314,144
2022-06-24,Nevada,057,99092,17473,17339,1455,18794,129
2022-06-24,Orange,059,3164182,599854,595761,49267,645028,7090
2022-06-24,Placer,061,380077,69371,68785,8389,77174,628
2022-06-24,Plumas,063,18699,3279,3241,398,3639,13
2022-06-24,Riverside,065,2383286,629595,625794,30431,656225,6493
2022-06-24,Sacramento,067,1510023,313214,310837,30420,341257,3077
2022-06-24,San Benito,069,59416,14295,14192,710,14902,99
2022-06-24,San Bernardino,071,2135413,603193,598062,26417,624479,7803
2022-06-24,San Diego,073,3302833,829170,822848,61010,883858,5332
2022-06-24,San Francisco,075,870044,157702,155609,10366,165975,899
2022-06-24,San Joaquin,077,732212,179658,178447,11736,190183,2252
2022-06-24,San Luis Obispo,079,281455,57825,57472,5496,62968,485
2022-06-24,San Mateo,081,765935,148615,146955,9397,156352,723
2022-06-24,Santa Barbara,083,443738,94687,94017,5533,99550,699
2022-06-24,Santa Clara,085,1922200,378202,373961,16348,390309,2338
2022-06-24,Santa Cruz,087,273765,55472,54874,2734,57608,265
2022-06-24,Shasta,089,179085,32165,31921,6453,38374,570
2022-06-24,Sierra,091,2930,284,283,57,340,4
2022-06-24,Siskiyou,093,43540,4779,4744,2986,7730,81
2022-06-24,Solano,095,438530,93800,92248,6631,98879,455
2022-06-24,Sonoma,097,501317,96853,95981,4221,100202,493
2022-06-24,Stanislaus,099,539301,125269,124493,18859,143352,1672
2022-06-24,Sutter,101,95872,21800,21733,2320,24053,227
2022-06-24,Tehama,103,63373,12577,12510,2728,15238,205
2022-06-24,Trinity,105,12862,1247,1233,297,1530,20
2022-06-24,Tulare,107,460477,111566,111188,30161,141349,1496
2022-06-24,Tuolumne,109,53932,13811,13688,702,14390,189
2022-06-24,Ventura,111,848112,188823,187389,11730,199119,1514
2022-06-24,Yolo,113,214977,43533,41932,3630,45562,323
2022-06-24,Yuba,115,75493,17067,16994,1444,18438,124
2022-06-23,Alameda,001,1643700,304868,302071,17132,319203,1891
2022-06-23,Alpine,003,1148,129,129,1,130,0
2022-06-23,Amador,005,37829,9206,9135,759,9894,87
2022-06-23,Butte,007,227075,35738,35406,7789,43195,433
2022-06-23,Calaveras,009,45235,7788,7754,411,8165,124
2022-06-23,Colusa,011,21464,3546,3540,1118,4658,22
2022-06-23,Contra Costa,013,1133247,220590,218053,16801,234854,1335
2022-06-23,Del Norte,015,27424,6505,6398,288,6686,52
2022-06-23,El Dorado,017,186661,29571,29313,3699,33012,216
2022-06-23,Fresno,019,978130,246364,245118,25779,270897,2777
2022-06-23,Glenn,021,27897,5199,5178,1714,6892,48
2022-06-23,Humboldt,023,135768,19401,19234,3971,23205,149
2022-06-23,Imperial,025,180216,58504,58127,11489,69616,944
2022-06-23,Inyo,027,18085,4248,4228,636,4864,56
2022-06-23,Kern,029,883053,201593,200556,50219,250775,2344
2022-06-23,Kings,031,150075,53924,53783,3637,57420,448
2022-06-23,Lake,033,64148,11531,11471,1005,12476,140
2022-06-23,Lassen,035,31185,9301,9287,925,10212,64
2022-06-23,Los Angeles,037,10098052,2957194,2936815,143808,3080623,32036
2022-06-23,Madera,039,155013,39490,39319,6725,46044,372
2022-06-23,Marin,041,260295,40308,39979,4566,44545,297
2022-06-23,Mariposa,043,17540,2747,2713,262,2975,30
2022-06-23,Mendocino,045,87422,14370,14292,3712,18004,127
2022-06-23,Merced,047,269075,65739,65408,9630,75038,828
2022-06-23,Modoc,049,8938,780,777,274,1051,8
2022-06-23,Mono,051,14174,3079,3076,182,3258,7
2022-06-23,Monterey,053,433212,85709,85275,16872,102147,743
2022-06-23,Napa,055,140530,29270,29054,1259,30313,144
2022-06-23,Nevada,057,99092,17440,17339,1455,18794,129
2022-06-23,Orange,059,3164182,598849,595761,49088,644849,7090
2022-06-23,Placer,061,380077,69234,68785,8369,77154,628
2022-06-23,Plumas,063,18699,3274,3241,396,3637,13
2022-06-23,Riverside,065,2383286,628674,625794,30382,656176,6493
2022-06-23,Sacramento,067,1510023,312608,310837,30376,341213,3077
2022-06-23,San Benito,069,59416,14264,14192,708,14900,99
2022-06-23,San Bernardino,071,2135413,602402,598062,26384,624446,7803
2022-06-23,San Diego,073,3302833,827696,822848,60812,883660,5332
2022-06-23,San Francisco,075,870044,157234,155609,10333,165942,899
2022-06-23,San Joaquin,077,732212,179381,178447,11713,190160,2252
2022-06-23,San Luis Obispo,079,281455,57736,57472,5464,62936,485
2022-06-23,San Mateo,081,765935,148267,146955,9362,156317,723
2022-06-23,Santa Barbara,083,443738,94522,94017,5505,99522,699
2022-06-23,Santa Clara,085,1922200,377220,373961,16301,390262,2338
2022-06-23,Santa Cruz,087,273765,55361,54874,2722,57596,265
2022-06-23,Shasta,089,179085,32123,31921,6441,38362,570
2022-06-23,Sierra,091,2930,283,283,57,340,4
2022-06-23,Siskiyou,093,43540,4773,4744,2979,7723,81
2022-06-23,Solano,095,438530,93553,92248,6592,98840,455
2022-06-23,Sonoma,097,501317,96657,95981,4201,100182,493
2022-06-23,Stanislaus,099,539301,125088,124493,18832,143325,1672
2022-06-23,Sutter,101,95872,21766,21733,2320,24053,227
2022-06-23,Tehama,103,63373,12568,12510,2725,15235,205
2022-06-23,Trinity,105,12862,1245,1233,297,1530,20
2022-06-23,Tulare,107,460477,111441,111188,30095,141283,1496
2022-06-23,Tuolumne,109,53932,13784,13688,690,14378,189
2022-06-23,Ventura,111,848112,188523,187389,11693,199082,1514
2022-06-23,Yolo,113,214977,43429,41932,3618,45550,323
2022-06-23,Yuba,115,75493,17046,16994,1438,18432,124
2022-06-22,Alameda,001,1643700,304030,299567,17057,316624,1888
2022-06-22,Alpine,003,1148,129,129,1,130,0
2022-06-22,Amador,005,37829,9200,9049,758,9807,87
2022-06-22,Butte,007,227075,35672,35203,7771,42974,433
2022-06-22,Calaveras,009,45235,7776,7716,411,8127,122
2022-06-22,Colusa,011,21464,3543,3529,1118,4647,21
2022-06-22,Contra Costa,013,1133247,220070,216355,16748,233103,1328
2022-06-22,Del Norte,015,27424,6487,6367,287,6654,52
2022-06-22,El Dorado,017,186661,29508,29139,3686,32825,215
2022-06-22,Fresno,019,978130,245949,244129,25729,269858,2772
2022-06-22,Glenn,021,27897,5197,5161,1709,6870,48
2022-06-22,Humboldt,023,135768,19350,19111,3951,23062,148
2022-06-22,Imperial,025,180216,58404,57866,11457,69323,944
2022-06-22,Inyo,027,18085,4243,4222,635,4857,56
2022-06-22,Kern,029,883053,201322,199721,50083,249804,2341
2022-06-22,Kings,031,150075,53860,53568,3633,57201,448
2022-06-22,Lake,033,64148,11514,11426,999,12425,140
2022-06-22,Lassen,035,31185,9293,9259,923,10182,64
2022-06-22,Los Angeles,037,10098052,2952224,2925667,143354,3069021,32015
2022-06-22,Madera,039,155013,39434,39139,6707,45846,372
2022-06-22,Marin,041,260295,40205,39687,4560,44247,297
2022-06-22,Mariposa,043,17540,2742,2695,259,2954,30
2022-06-22,Mendocino,045,87422,14354,14201,3697,17898,127
2022-06-22,Merced,047,269075,65643,65120,9606,74726,827
2022-06-22,Modoc,049,8938,779,773,270,1043,8
2022-06-22,Mono,051,14174,3078,3073,180,3253,7
2022-06-22,Monterey,053,433212,85583,84752,16829,101581,742
2022-06-22,Napa,055,140530,29199,28894,1255,30149,144
2022-06-22,Nevada,057,99092,17420,17280,1446,18726,129
2022-06-22,Orange,059,3164182,597653,592215,48913,641128,7084
2022-06-22,Placer,061,380077,69118,68447,8359,76806,628
2022-06-22,Plumas,063,18699,3264,3220,396,3616,13
2022-06-22,Riverside,065,2383286,627825,623584,30327,653911,6491
2022-06-22,Sacramento,067,1510023,311983,309105,30340,339445,3071
2022-06-22,San Benito,069,59416,14240,14128,705,14833,99
2022-06-22,San Bernardino,071,2135413,601598,595517,26354,621871,7774
2022-06-22,San Diego,073,3302833,826086,815124,60635,875759,5318
2022-06-22,San Francisco,075,870044,156749,154213,10304,164517,897
2022-06-22,San Joaquin,077,732212,179125,177637,11689,189326,2251
2022-06-22,San Luis Obispo,079,281455,57648,57177,5428,62605,485
2022-06-22,San Mateo,081,765935,147862,145781,9339,155120,723
2022-06-22,Santa Barbara,083,443738,94375,93576,5491,99067,700
2022-06-22,Santa Clara,085,1922200,376132,370678,16193,386871,2340
2022-06-22,Santa Cruz,087,273765,55242,54525,2709,57234,265
2022-06-22,Shasta,089,179085,32078,31786,6426,38212,570
2022-06-22,Sierra,091,2930,283,283,57,340,4
2022-06-22,Siskiyou,093,43540,4766,4711,2976,7687,81
2022-06-22,Solano,095,438530,93305,91528,6527,98055,454
2022-06-22,Sonoma,097,501317,96454,95363,4181,99544,493
2022-06-22,Stanislaus,099,539301,124892,124023,18779,142802,1670
2022-06-22,Sutter,101,95872,21734,21649,2319,23968,227
2022-06-22,Tehama,103,63373,12558,12465,2723,15188,205
2022-06-22,Trinity,105,12862,1243,1223,297,1520,20
2022-06-22,Tulare,107,460477,111305,110768,30014,140782,1496
2022-06-22,Tuolumne,109,53932,13765,13596,684,14280,189
2022-06-22,Ventura,111,848112,188220,186601,11642,198243,1514
2022-06-22,Yolo,113,214977,43307,41689,3607,45296,323
2022-06-22,Yuba,115,75493,17026,16912,1434,18346,124
2022-06-21,Alameda,001,1643700,303234,299567,17023,316590,1888
2022-06-21,Alpine,003,1148,129,129,1,130,0
2022-06-21,Amador,005,37829,9193,9049,755,9804,87
2022-06-21,Butte,007,227075,35598,35203,7760,42963,433
2022-06-21,Calaveras,009,45235,7767,7716,410,8126,122
2022-06-21,Colusa,011,21464,3540,3529,1116,4645,21
2022-06-21,Contra Costa,013,1133247,219509,216355,16699,233054,1328
2022-06-21,Del Norte,015,27424,6457,6367,285,6652,52
2022-06-21,El Dorado,017,186661,29434,29139,3679,32818,215
2022-06-21,Fresno,019,978130,245515,244129,25679,269808,2772
2022-06-21,Glenn,021,27897,5190,5161,1707,6868,48
2022-06-21,Humboldt,023,135768,19298,19111,3938,23049,148
2022-06-21,Imperial,025,180216,58311,57866,11421,69287,944
2022-06-21,Inyo,027,18085,4238,4222,629,4851,56
2022-06-21,Kern,029,883053,201001,199721,49903,249624,2341
2022-06-21,Kings,031,150075,53786,53568,3632,57200,448
2022-06-21,Lake,033,64148,11491,11426,996,12422,140
2022-06-21,Lassen,035,31185,9283,9259,920,10179,64
2022-06-21,Los Angeles,037,10098052,2947422,2925667,142851,3068518,32015
2022-06-21,Madera,039,155013,39350,39139,6697,45836,372
2022-06-21,Marin,041,260295,40115,39687,4548,44235,297
2022-06-21,Mariposa,043,17540,2736,2695,258,2953,30
2022-06-21,Mendocino,045,87422,14325,14201,3688,17889,127
2022-06-21,Merced,047,269075,65543,65120,9575,74695,827
2022-06-21,Modoc,049,8938,776,773,269,1042,8
2022-06-21,Mono,051,14174,3076,3073,179,3252,7
2022-06-21,Monterey,053,433212,85427,84752,16787,101539,742
2022-06-21,Napa,055,140530,29146,28894,1254,30148,144
2022-06-21,Nevada,057,99092,17393,17280,1443,18723,129
2022-06-21,Orange,059,3164182,596458,592215,48774,640989,7084
2022-06-21,Placer,061,380077,68991,68447,8348,76795,628
2022-06-21,Plumas,063,18699,3255,3220,395,3615,13
2022-06-21,Riverside,065,2383286,626863,623584,30269,653853,6491
2022-06-21,Sacramento,067,1510023,311287,309105,30294,339399,3071
2022-06-21,San Benito,069,59416,14204,14128,701,14829,99
2022-06-21,San Bernardino,071,2135413,600771,595517,26307,621824,7774
2022-06-21,San Diego,073,3302833,824400,815124,60436,875560,5318
2022-06-21,San Francisco,075,870044,156265,154213,10273,164486,897
2022-06-21,San Joaquin,077,732212,178806,177637,11661,189298,2251
2022-06-21,San Luis Obispo,079,281455,57537,57177,5383,62560,485
2022-06-21,San Mateo,081,765935,147376,145781,9320,155101,723
2022-06-21,Santa Barbara,083,443738,94208,93576,5477,99053,700
2022-06-21,Santa Clara,085,1922200,374973,370678,16145,386823,2340
2022-06-21,Santa Cruz,087,273765,55112,54525,2701,57226,265
2022-06-21,Shasta,089,179085,32031,31786,6408,38194,570
2022-06-21,Sierra,091,2930,283,283,57,340,4
2022-06-21,Siskiyou,093,43540,4758,4711,2968,7679,81
2022-06-21,Solano,095,438530,93045,91528,6510,98038,454
2022-06-21,Sonoma,097,501317,96220,95363,4158,99521,493
2022-06-21,Stanislaus,099,539301,124699,124023,18755,142778,1670
2022-06-21,Sutter,101,95872,21710,21649,2317,23966,227
2022-06-21,Tehama,103,63373,12544,12465,2723,15188,205
2022-06-21,Trinity,105,12862,1237,1223,297,1520,20
2022-06-21,Tulare,107,460477,111164,110768,29954,140722,1496
2022-06-21,Tuolumne,109,53932,13741,13596,678,14274,189
2022-06-21,Ventura,111,848112,187897,186601,11587,198188,1514
2022-06-21,Yolo,113,214977,43175,41689,3596,45285,323
2022-06-21,Yuba,115,75493,16997,16912,1433,18345,124
2022-06-20,Alameda,001,1643700,302331,299567,16965,316532,1888
2022-06-20,Alpine,003,1148,129,129,1,130,0
2022-06-20,Amador,005,37829,9183,9049,752,9801,87
2022-06-20,Butte,007,227075,35528,35203,7743,42946,433
2022-06-20,Calaveras,009,45235,7760,7716,410,8126,122
2022-06-20,Colusa,011,21464,3539,3529,1115,4644,21
2022-06-20,Contra Costa,013,1133247,218911,216355,16633,232988,1328
2022-06-20,Del Norte,015,27424,6444,6367,281,6648,52
2022-06-20,El Dorado,017,186661,29363,29139,3661,32800,215
2022-06-20,Fresno,019,978130,245028,244129,25620,269749,2772
2022-06-20,Glenn,021,27897,5185,5161,1704,6865,48
2022-06-20,Humboldt,023,135768,19252,19111,3922,23033,148
2022-06-20,Imperial,025,180216,58178,57866,11388,69254,944
2022-06-20,Inyo,027,18085,4234,4222,624,4846,56
2022-06-20,Kern,029,883053,200709,199721,49755,249476,2341
2022-06-20,Kings,031,150075,53705,53568,3630,57198,448
2022-06-20,Lake,033,64148,11470,11426,994,12420,140
2022-06-20,Lassen,035,31185,9278,9259,919,10178,64
2022-06-20,Los Angeles,037,10098052,2942023,2925667,142378,3068045,32015
2022-06-20,Madera,039,155013,39288,39139,6679,45818,372
2022-06-20,Marin,041,260295,40013,39687,4525,44212,297
2022-06-20,Mariposa,043,17540,2723,2695,258,2953,30
2022-06-20,Mendocino,045,87422,14296,14201,3683,17884,127
2022-06-20,Merced,047,269075,65449,65120,9549,74669,827
2022-06-20,Modoc,049,8938,775,773,268,1041,8
2022-06-20,Mono,051,14174,3076,3073,176,3249,7
2022-06-20,Monterey,053,433212,85277,84752,16722,101474,742
2022-06-20,Napa,055,140530,29073,28894,1251,30145,144
2022-06-20,Nevada,057,99092,17368,17280,1434,18714,129
2022-06-20,Orange,059,3164182,595193,592215,48622,640837,7084
2022-06-20,Placer,061,380077,68874,68447,8336,76783,628
2022-06-20,Plumas,063,18699,3249,3220,395,3615,13
2022-06-20,Riverside,065,2383286,625925,623584,30201,653785,6491
2022-06-20,Sacramento,067,1510023,310584,309105,30222,339327,3071
2022-06-20,San Benito,069,59416,14158,14128,695,14823,99
2022-06-20,San Bernardino,071,2135413,599865,595517,26270,621787,7774
2022-06-20,San Diego,073,3302833,822409,815124,60190,875314,5318
2022-06-20,San Francisco,075,870044,155649,154213,10234,164447,897
2022-06-20,San Joaquin,077,732212,178479,177637,11617,189254,2251
2022-06-20,San Luis Obispo,079,281455,57433,57177,5335,62512,485
2022-06-20,San Mateo,081,765935,146870,145781,9295,155076,723
2022-06-20,Santa Barbara,083,443738,94024,93576,5452,99028,700
2022-06-20,Santa Clara,085,1922200,373762,370678,16083,386761,2340
2022-06-20,Santa Cruz,087,273765,54938,54525,2694,57219,265
2022-06-20,Shasta,089,179085,31974,31786,6396,38182,570
2022-06-20,Sierra,091,2930,283,283,56,339,4
2022-06-20,Siskiyou,093,43540,4745,4711,2956,7667,81
2022-06-20,Solano,095,438530,92717,91528,6490,98018,454
2022-06-20,Sonoma,097,501317,95983,95363,4135,99498,493
2022-06-20,Stanislaus,099,539301,124514,124023,18728,142751,1670
2022-06-20,Sutter,101,95872,21679,21649,2299,23948,227
2022-06-20,Tehama,103,63373,12529,12465,2720,15185,205
2022-06-20,Trinity,105,12862,1232,1223,297,1520,20
2022-06-20,Tulare,107,460477,111020,110768,29889,140657,1496
2022-06-20,Tuolumne,109,53932,13703,13596,678,14274,189
2022-06-20,Ventura,111,848112,187561,186601,11550,198151,1514
2022-06-20,Yolo,113,214977,43014,41689,3578,45267,323
2022-06-20,Yuba,115,75493,16972,16912,1427,18339,124
2022-06-19,Alameda,001,1643700,301402,296062,16933,312995,1883
2022-06-19,Alpine,003,1148,129,129,1,130,0
2022-06-19,Amador,005,37829,9133,8985,739,9724,87
2022-06-19,Butte,007,227075,35467,34920,7720,42640,432
2022-06-19,Calaveras,009,45235,7742,7664,409,8073,122
2022-06-19,Colusa,011,21464,3534,3519,1111,4630,21
2022-06-19,Contra Costa,013,1133247,218226,213994,16565,230559,1323
2022-06-19,Del Norte,015,27424,6427,6307,278,6585,52
2022-06-19,El Dorado,017,186661,29281,28904,3645,32549,215
2022-06-19,Fresno,019,978130,244583,242214,25565,267779,2768
2022-06-19,Glenn,021,27897,5176,5131,1702,6833,48
2022-06-19,Humboldt,023,135768,19207,18885,3897,22782,148
2022-06-19,Imperial,025,180216,58055,57450,11354,68804,944
2022-06-19,Inyo,027,18085,4233,4209,623,4832,56
2022-06-19,Kern,029,883053,200348,198567,49585,248152,2340
2022-06-19,Kings,031,150075,53610,53242,3627,56869,448
2022-06-19,Lake,033,64148,11456,11318,993,12311,140
2022-06-19,Lassen,035,31185,9265,9225,919,10144,64
2022-06-19,Los Angeles,037,10098052,2937150,2909197,141823,3051020,31999
2022-06-19,Madera,039,155013,39196,38859,6659,45518,372
2022-06-19,Marin,041,260295,39886,39214,4514,43728,294
2022-06-19,Mariposa,043,17540,2716,2662,257,2919,30
2022-06-19,Mendocino,045,87422,14269,14090,3670,17760,127
2022-06-19,Merced,047,269075,65349,64734,9520,74254,827
2022-06-19,Modoc,049,8938,772,771,267,1038,8
2022-06-19,Mono,051,14174,3074,3066,175,3241,6
2022-06-19,Monterey,053,433212,85129,84032,16676,100708,744
2022-06-19,Napa,055,140530,29013,28619,1247,29866,144
2022-06-19,Nevada,057,99092,17338,17134,1426,18560,129
2022-06-19,Orange,059,3164182,593938,587176,48434,635610,7074
2022-06-19,Placer,061,380077,68755,67961,8315,76276,628
2022-06-19,Plumas,063,18699,3241,3201,395,3596,13
2022-06-19,Riverside,065,2383286,625054,619760,30152,649912,6488
2022-06-19,Sacramento,067,1510023,309856,306215,30165,336380,3072
2022-06-19,San Benito,069,59416,14139,13985,693,14678,99
2022-06-19,San Bernardino,071,2135413,599043,591926,26233,618159,7765
2022-06-19,San Diego,073,3302833,820871,815124,60072,875196,5318
2022-06-19,San Francisco,075,870044,155132,151898,10194,162092,897
2022-06-19,San Joaquin,077,732212,178157,176323,11580,187903,2251
2022-06-19,San Luis Obispo,079,281455,57298,56767,5278,62045,485
2022-06-19,San Mateo,081,765935,146421,143879,9262,153141,723
2022-06-19,Santa Barbara,083,443738,93861,92906,5436,98342,699
2022-06-19,Santa Clara,085,1922200,372590,365638,16022,381660,2328
2022-06-19,Santa Cruz,087,273765,54776,53866,2675,56541,264
2022-06-19,Shasta,089,179085,31915,31647,6385,38032,568
2022-06-19,Sierra,091,2930,283,281,56,337,4
2022-06-19,Siskiyou,093,43540,4733,4672,2950,7622,81
2022-06-19,Solano,095,438530,92463,90548,6478,97026,454
2022-06-19,Sonoma,097,501317,95742,94318,4116,98434,493
2022-06-19,Stanislaus,099,539301,124328,123264,18684,141948,1668
2022-06-19,Sutter,101,95872,21644,21501,2291,23792,227
2022-06-19,Tehama,103,63373,12520,12410,2714,15124,205
2022-06-19,Trinity,105,12862,1229,1220,297,1517,20
2022-06-19,Tulare,107,460477,110835,110041,29834,139875,1496
2022-06-19,Tuolumne,109,53932,13676,13487,678,14165,189
2022-06-19,Ventura,111,848112,187211,185219,11507,196726,1513
2022-06-19,Yolo,113,214977,42925,41135,3565,44700,323
2022-06-19,Yuba,115,75493,16941,16786,1424,18210,124
2022-06-18,Alameda,001,1643700,300937,296062,16913,312975,1883
2022-06-18,Alpine,003,1148,129,129,1,130,0
2022-06-18,Amador,005,37829,9126,8985,735,9720,87
2022-06-18,Butte,007,227075,35415,34920,7709,42629,432
2022-06-18,Calaveras,009,45235,7730,7664,409,8073,122
2022-06-18,Colusa,011,21464,3531,3519,1111,4630,21
2022-06-18,Contra Costa,013,1133247,217914,213994,16536,230530,1323
2022-06-18,Del Norte,015,27424,6421,6307,277,6584,52
2022-06-18,El Dorado,017,186661,29252,28904,3642,32546,215
2022-06-18,Fresno,019,978130,244381,242214,25550,267764,2768
2022-06-18,Glenn,021,27897,5173,5131,1700,6831,48
2022-06-18,Humboldt,023,135768,19178,18885,3890,22775,148
2022-06-18,Imperial,025,180216,57985,57450,11341,68791,944
2022-06-18,Inyo,027,18085,4232,4209,622,4831,56
2022-06-18,Kern,029,883053,200225,198567,49499,248066,2340
2022-06-18,Kings,031,150075,53574,53242,3626,56868,448
2022-06-18,Lake,033,64148,11445,11318,991,12309,140
2022-06-18,Lassen,035,31185,9261,9225,919,10144,64
2022-06-18,Los Angeles,037,10098052,2934724,2909197,141532,3050729,31999
2022-06-18,Madera,039,155013,39172,38859,6653,45512,372
2022-06-18,Marin,041,260295,39821,39214,4504,43718,294
2022-06-18,Mariposa,043,17540,2711,2662,257,2919,30
2022-06-18,Mendocino,045,87422,14247,14090,3667,17757,127
2022-06-18,Merced,047,269075,65286,64734,9511,74245,827
2022-06-18,Modoc,049,8938,772,771,267,1038,8
2022-06-18,Mono,051,14174,3073,3066,175,3241,6
2022-06-18,Monterey,053,433212,85038,84032,16647,100679,744
2022-06-18,Napa,055,140530,28988,28619,1246,29865,144
2022-06-18,Nevada,057,99092,17326,17134,1425,18559,129
2022-06-18,Orange,059,3164182,593321,587176,48324,635500,7074
2022-06-18,Placer,061,380077,68691,67961,8302,76263,628
2022-06-18,Plumas,063,18699,3233,3201,395,3596,13
2022-06-18,Riverside,065,2383286,624520,619760,30137,649897,6488
2022-06-18,Sacramento,067,1510023,309541,306215,30143,336358,3072
2022-06-18,San Benito,069,59416,14124,13985,686,14671,99
2022-06-18,San Bernardino,071,2135413,598612,591926,26212,618138,7765
2022-06-18,San Diego,073,3302833,820152,815124,60029,875153,5318
2022-06-18,San Francisco,075,870044,154799,151898,10174,162072,897
2022-06-18,San Joaquin,077,732212,177994,176323,11572,187895,2251
2022-06-18,San Luis Obispo,079,281455,57253,56767,5270,62037,485
2022-06-18,San Mateo,081,765935,146154,143879,9239,153118,723
2022-06-18,Santa Barbara,083,443738,93750,92906,5426,98332,699
2022-06-18,Santa Clara,085,1922200,371832,365638,15978,381616,2328
2022-06-18,Santa Cruz,087,273765,54700,53866,2665,56531,264
2022-06-18,Shasta,089,179085,31894,31647,6382,38029,568
2022-06-18,Sierra,091,2930,283,281,56,337,4
2022-06-18,Siskiyou,093,43540,4725,4672,2946,7618,81
2022-06-18,Solano,095,438530,92380,90548,6469,97017,454
2022-06-18,Sonoma,097,501317,95606,94318,4098,98416,493
2022-06-18,Stanislaus,099,539301,124220,123264,18667,141931,1668
2022-06-18,Sutter,101,95872,21623,21501,2288,23789,227
2022-06-18,Tehama,103,63373,12511,12410,2710,15120,205
2022-06-18,Trinity,105,12862,1228,1220,297,1517,20
2022-06-18,Tulare,107,460477,110753,110041,29793,139834,1496
2022-06-18,Tuolumne,109,53932,13654,13487,675,14162,189
2022-06-18,Ventura,111,848112,187037,185219,11485,196704,1513
2022-06-18,Yolo,113,214977,42856,41135,3560,44695,323
2022-06-18,Yuba,115,75493,16928,16786,1424,18210,124
2022-06-17,Alameda,001,1643700,300461,296062,16888,312950,1883
2022-06-17,Alpine,003,1148,129,129,1,130,0
2022-06-17,Amador,005,37829,9117,8985,735,9720,87
2022-06-17,Butte,007,227075,35383,34920,7699,42619,432
2022-06-17,Calaveras,009,45235,7722,7664,409,8073,122
2022-06-17,Colusa,011,21464,3530,3519,1106,4625,21
2022-06-17,Contra Costa,013,1133247,217618,213994,16511,230505,1323
2022-06-17,Del Norte,015,27424,6407,6307,277,6584,52
2022-06-17,El Dorado,017,186661,29221,28904,3638,32542,215
2022-06-17,Fresno,019,978130,244139,242214,25524,267738,2768
2022-06-17,Glenn,021,27897,5172,5131,1695,6826,48
2022-06-17,Humboldt,023,135768,19151,18885,3886,22771,148
2022-06-17,Imperial,025,180216,57933,57450,11329,68779,944
2022-06-17,Inyo,027,18085,4228,4209,616,4825,56
2022-06-17,Kern,029,883053,200073,198567,49458,248025,2340
2022-06-17,Kings,031,150075,53547,53242,3625,56867,448
2022-06-17,Lake,033,64148,11437,11318,990,12308,140
2022-06-17,Lassen,035,31185,9260,9225,918,10143,64
2022-06-17,Los Angeles,037,10098052,2931884,2909197,141233,3050430,31999
2022-06-17,Madera,039,155013,39147,38859,6647,45506,372
2022-06-17,Marin,041,260295,39726,39214,4492,43706,294
2022-06-17,Mariposa,043,17540,2708,2662,257,2919,30
2022-06-17,Mendocino,045,87422,14231,14090,3664,17754,127
2022-06-17,Merced,047,269075,65229,64734,9506,74240,827
2022-06-17,Modoc,049,8938,772,771,267,1038,8
2022-06-17,Mono,051,14174,3073,3066,175,3241,6
2022-06-17,Monterey,053,433212,84948,84032,16617,100649,744
2022-06-17,Napa,055,140530,28950,28619,1245,29864,144
2022-06-17,Nevada,057,99092,17307,17134,1420,18554,129
2022-06-17,Orange,059,3164182,592639,587176,48193,635369,7074
2022-06-17,Placer,061,380077,68631,67961,8292,76253,628
2022-06-17,Plumas,063,18699,3232,3201,394,3595,13
2022-06-17,Riverside,065,2383286,623967,619760,30101,649861,6488
2022-06-17,Sacramento,067,1510023,309151,306215,30123,336338,3072
2022-06-17,San Benito,069,59416,14112,13985,686,14671,99
2022-06-17,San Bernardino,071,2135413,598174,591926,26181,618107,7765
2022-06-17,San Diego,073,3302833,819189,815124,59925,875049,5318
2022-06-17,San Francisco,075,870044,154480,151898,10139,162037,897
2022-06-17,San Joaquin,077,732212,177845,176323,11562,187885,2251
2022-06-17,San Luis Obispo,079,281455,57216,56767,5264,62031,485
2022-06-17,San Mateo,081,765935,145853,143879,9221,153100,723
2022-06-17,Santa Barbara,083,443738,93645,92906,5414,98320,699
2022-06-17,Santa Clara,085,1922200,371005,365638,15945,381583,2328
2022-06-17,Santa Cruz,087,273765,54634,53866,2660,56526,264
2022-06-17,Shasta,089,179085,31868,31647,6374,38021,568
2022-06-17,Sierra,091,2930,283,281,56,337,4
2022-06-17,Siskiyou,093,43540,4718,4672,2946,7618,81
2022-06-17,Solano,095,438530,92235,90548,6458,97006,454
2022-06-17,Sonoma,097,501317,95440,94318,4082,98400,493
2022-06-17,Stanislaus,099,539301,124123,123264,18658,141922,1668
2022-06-17,Sutter,101,95872,21601,21501,2282,23783,227
2022-06-17,Tehama,103,63373,12496,12410,2707,15117,205
2022-06-17,Trinity,105,12862,1228,1220,297,1517,20
2022-06-17,Tulare,107,460477,110672,110041,29756,139797,1496
2022-06-17,Tuolumne,109,53932,13641,13487,674,14161,189
2022-06-17,Ventura,111,848112,186857,185219,11465,196684,1513
2022-06-17,Yolo,113,214977,42773,41135,3548,44683,323
2022-06-17,Yuba,115,75493,16921,16786,1421,18207,124
2022-06-16,Alameda,001,1643700,299651,296062,16822,312884,1883
2022-06-16,Alpine,003,1148,129,129,1,130,0
2022-06-16,Amador,005,37829,9110,8985,731,9716,87
2022-06-16,Butte,007,227075,35308,34920,7684,42604,432
2022-06-16,Calaveras,009,45235,7710,7664,408,8072,122
2022-06-16,Colusa,011,21464,3528,3519,1105,4624,21
2022-06-16,Contra Costa,013,1133247,217157,213994,16460,230454,1323
2022-06-16,Del Norte,015,27424,6393,6307,276,6583,52
2022-06-16,El Dorado,017,186661,29169,28904,3626,32530,215
2022-06-16,Fresno,019,978130,243769,242214,25468,267682,2768
2022-06-16,Glenn,021,27897,5164,5131,1691,6822,48
2022-06-16,Humboldt,023,135768,19121,18885,3872,22757,148
2022-06-16,Imperial,025,180216,57833,57450,11300,68750,944
2022-06-16,Inyo,027,18085,4227,4209,613,4822,56
2022-06-16,Kern,029,883053,199862,198567,49343,247910,2340
2022-06-16,Kings,031,150075,53480,53242,3621,56863,448
2022-06-16,Lake,033,64148,11421,11318,990,12308,140
2022-06-16,Lassen,035,31185,9253,9225,918,10143,64
2022-06-16,Los Angeles,037,10098052,2927902,2909197,140878,3050075,31999
2022-06-16,Madera,039,155013,39117,38859,6638,45497,372
2022-06-16,Marin,041,260295,39628,39214,4479,43693,294
2022-06-16,Mariposa,043,17540,2700,2662,256,2918,30
2022-06-16,Mendocino,045,87422,14202,14090,3655,17745,127
2022-06-16,Merced,047,269075,65153,64734,9487,74221,827
2022-06-16,Modoc,049,8938,772,771,267,1038,8
2022-06-16,Mono,051,14174,3072,3066,174,3240,6
2022-06-16,Monterey,053,433212,84799,84032,16563,100595,744
2022-06-16,Napa,055,140530,28906,28619,1242,29861,144
2022-06-16,Nevada,057,99092,17284,17134,1415,18549,129
2022-06-16,Orange,059,3164182,591611,587176,48058,635234,7074
2022-06-16,Placer,061,380077,68547,67961,8270,76231,628
2022-06-16,Plumas,063,18699,3225,3201,393,3594,13
2022-06-16,Riverside,065,2383286,623219,619760,30057,649817,6488
2022-06-16,Sacramento,067,1510023,308568,306215,30090,336305,3072
2022-06-16,San Benito,069,59416,14088,13985,684,14669,99
2022-06-16,San Bernardino,071,2135413,597516,591926,26144,618070,7765
2022-06-16,San Diego,073,3302833,817663,815124,59763,874887,5318
2022-06-16,San Francisco,075,870044,154028,151898,10100,161998,897
2022-06-16,San Joaquin,077,732212,177594,176323,11546,187869,2251
2022-06-16,San Luis Obispo,079,281455,57138,56767,5245,62012,485
2022-06-16,San Mateo,081,765935,145490,143879,9206,153085,723
2022-06-16,Santa Barbara,083,443738,93497,92906,5400,98306,699
2022-06-16,Santa Clara,085,1922200,370063,365638,15896,381534,2328
2022-06-16,Santa Cruz,087,273765,54502,53866,2648,56514,264
2022-06-16,Shasta,089,179085,31838,31647,6363,38010,568
2022-06-16,Sierra,091,2930,282,281,56,337,4
2022-06-16,Siskiyou,093,43540,4709,4672,2937,7609,81
2022-06-16,Solano,095,438530,92043,90548,6446,96994,454
2022-06-16,Sonoma,097,501317,95255,94318,4066,98384,493
2022-06-16,Stanislaus,099,539301,123963,123264,18642,141906,1668
2022-06-16,Sutter,101,95872,21576,21501,2280,23781,227
2022-06-16,Tehama,103,63373,12477,12410,2705,15115,205
2022-06-16,Trinity,105,12862,1226,1220,294,1514,20
2022-06-16,Tulare,107,460477,110540,110041,29713,139754,1496
2022-06-16,Tuolumne,109,53932,13617,13487,670,14157,189
2022-06-16,Ventura,111,848112,186586,185219,11420,196639,1513
2022-06-16,Yolo,113,214977,42682,41135,3537,44672,323
2022-06-16,Yuba,115,75493,16897,16786,1417,18203,124
2022-06-15,Alameda,001,1643700,298847,295002,16764,311766,1880
2022-06-15,Alpine,003,1148,129,129,1,130,0
2022-06-15,Amador,005,37829,9102,8972,731,9703,87
2022-06-15,Butte,007,227075,35244,34841,7665,42506,430
2022-06-15,Calaveras,009,45235,7707,7648,406,8054,122
2022-06-15,Colusa,011,21464,3524,3515,1103,4618,21
2022-06-15,Contra Costa,013,1133247,216704,213219,16419,229638,1321
2022-06-15,Del Norte,015,27424,6382,6298,275,6573,52
2022-06-15,El Dorado,017,186661,29115,28829,3614,32443,215
2022-06-15,Fresno,019,978130,243406,241768,25424,267192,2767
2022-06-15,Glenn,021,27897,5159,5128,1683,6811,48
2022-06-15,Humboldt,023,135768,19083,18836,3847,22683,148
2022-06-15,Imperial,025,180216,57750,57373,11277,68650,941
2022-06-15,Inyo,027,18085,4225,4205,612,4817,56
2022-06-15,Kern,029,883053,199598,198216,49236,247452,2338
2022-06-15,Kings,031,150075,53426,53170,3619,56789,448
2022-06-15,Lake,033,64148,11403,11303,986,12289,140
2022-06-15,Lassen,035,31185,9249,9209,917,10126,64
2022-06-15,Los Angeles,037,10098052,2923604,2897298,140523,3037821,31971
2022-06-15,Madera,039,155013,39073,38776,6622,45398,372
2022-06-15,Marin,041,260295,39539,39027,4472,43499,294
2022-06-15,Mariposa,043,17540,2696,2651,254,2905,30
2022-06-15,Mendocino,045,87422,14176,14052,3652,17704,127
2022-06-15,Merced,047,269075,65072,64595,9475,74070,825
2022-06-15,Modoc,049,8938,771,772,267,1039,8
2022-06-15,Mono,051,14174,3072,3060,173,3233,6
2022-06-15,Monterey,053,433212,84660,83837,16523,100360,741
2022-06-15,Napa,055,140530,28846,28518,1235,29753,144
2022-06-15,Nevada,057,99092,17259,17107,1411,18518,127
2022-06-15,Orange,059,3164182,590574,585496,47889,633385,7067
2022-06-15,Placer,061,380077,68425,67805,8253,76058,628
2022-06-15,Plumas,063,18699,3220,3185,391,3576,13
2022-06-15,Riverside,065,2383286,622496,618584,30005,648589,6482
2022-06-15,Sacramento,067,1510023,307974,305361,30042,335403,3059
2022-06-15,San Benito,069,59416,14051,13953,677,14630,99
2022-06-15,San Bernardino,071,2135413,596863,590328,26106,616434,7735
2022-06-15,San Diego,073,3302833,816111,811093,59597,870690,5316
2022-06-15,San Francisco,075,870044,153590,151170,10075,161245,890
2022-06-15,San Joaquin,077,732212,177351,175966,11515,187481,2244
2022-06-15,San Luis Obispo,079,281455,57053,56535,5208,61743,486
2022-06-15,San Mateo,081,765935,145094,143277,9190,152467,722
2022-06-15,Santa Barbara,083,443738,93364,92710,5393,98103,698
2022-06-15,Santa Clara,085,1922200,369064,364014,15860,379874,2323
2022-06-15,Santa Cruz,087,273765,54387,53718,2643,56361,265
2022-06-15,Shasta,089,179085,31798,31598,6356,37954,568
2022-06-15,Sierra,091,2930,280,280,56,336,4
2022-06-15,Siskiyou,093,43540,4698,4656,2927,7583,81
2022-06-15,Solano,095,438530,91813,90265,6438,96703,453
2022-06-15,Sonoma,097,501317,95061,94041,4055,98096,492
2022-06-15,Stanislaus,099,539301,123820,122944,18619,141563,1668
2022-06-15,Sutter,101,95872,21548,21448,2275,23723,227
2022-06-15,Tehama,103,63373,12469,12392,2699,15091,205
2022-06-15,Trinity,105,12862,1225,1217,292,1509,20
2022-06-15,Tulare,107,460477,110434,109930,29679,139609,1495
2022-06-15,Tuolumne,109,53932,13606,13459,670,14129,189
2022-06-15,Ventura,111,848112,186311,184750,11374,196124,1509
2022-06-15,Yolo,113,214977,42576,40756,3522,44278,322
2022-06-15,Yuba,115,75493,16872,16754,1412,18166,124
2022-06-14,Alameda,001,1643700,298139,295002,16713,311715,1880
2022-06-14,Alpine,003,1148,129,129,1,130,0
2022-06-14,Amador,005,37829,9086,8972,726,9698,87
2022-06-14,Butte,007,227075,35191,34841,7650,42491,430
2022-06-14,Calaveras,009,45235,7697,7648,405,8053,122
2022-06-14,Colusa,011,21464,3522,3515,1102,4617,21
2022-06-14,Contra Costa,013,1133247,216177,213219,16360,229579,1321
2022-06-14,Del Norte,015,27424,6374,6298,272,6570,52
2022-06-14,El Dorado,017,186661,29063,28829,3606,32435,215
2022-06-14,Fresno,019,978130,243014,241768,25370,267138,2767
2022-06-14,Glenn,021,27897,5151,5128,1680,6808,48
2022-06-14,Humboldt,023,135768,19033,18836,3830,22666,148
2022-06-14,Imperial,025,180216,57675,57373,11247,68620,941
2022-06-14,Inyo,027,18085,4220,4205,611,4816,56
2022-06-14,Kern,029,883053,199339,198216,49120,247336,2338
2022-06-14,Kings,031,150075,53356,53170,3617,56787,448
2022-06-14,Lake,033,64148,11377,11303,985,12288,140
2022-06-14,Lassen,035,31185,9243,9209,914,10123,64
2022-06-14,Los Angeles,037,10098052,2919085,2897298,140107,3037405,31971
2022-06-14,Madera,039,155013,39019,38776,6614,45390,372
2022-06-14,Marin,041,260295,39430,39027,4461,43488,294
2022-06-14,Mariposa,043,17540,2685,2651,253,2904,30
2022-06-14,Mendocino,045,87422,14148,14052,3640,17692,127
2022-06-14,Merced,047,269075,64990,64595,9450,74045,825
2022-06-14,Modoc,049,8938,771,772,266,1038,8
2022-06-14,Mono,051,14174,3072,3060,172,3232,6
2022-06-14,Monterey,053,433212,84521,83837,16477,100314,741
2022-06-14,Napa,055,140530,28784,28518,1234,29752,144
2022-06-14,Nevada,057,99092,17227,17107,1406,18513,127
2022-06-14,Orange,059,3164182,589442,585496,47729,633225,7067
2022-06-14,Placer,061,380077,68300,67805,8238,76043,628
2022-06-14,Plumas,063,18699,3215,3185,391,3576,13
2022-06-14,Riverside,065,2383286,621715,618584,29970,648554,6482
2022-06-14,Sacramento,067,1510023,307347,305361,29961,335322,3059
2022-06-14,San Benito,069,59416,14016,13953,675,14628,99
2022-06-14,San Bernardino,071,2135413,596147,590328,26062,616390,7735
2022-06-14,San Diego,073,3302833,814397,811093,59445,870538,5316
2022-06-14,San Francisco,075,870044,153101,151170,10050,161220,890
2022-06-14,San Joaquin,077,732212,177082,175966,11481,187447,2244
2022-06-14,San Luis Obispo,079,281455,56944,56535,5161,61696,486
2022-06-14,San Mateo,081,765935,144716,143277,9177,152454,722
2022-06-14,Santa Barbara,083,443738,93228,92710,5378,98088,698
2022-06-14,Santa Clara,085,1922200,367999,364014,15813,379827,2323
2022-06-14,Santa Cruz,087,273765,54262,53718,2632,56350,265
2022-06-14,Shasta,089,179085,31768,31598,6348,37946,568
2022-06-14,Sierra,091,2930,280,280,56,336,4
2022-06-14,Siskiyou,093,43540,4688,4656,2921,7577,81
2022-06-14,Solano,095,438530,91554,90265,6418,96683,453
2022-06-14,Sonoma,097,501317,94850,94041,4042,98083,492
2022-06-14,Stanislaus,099,539301,123641,122944,18590,141534,1668
2022-06-14,Sutter,101,95872,21510,21448,2271,23719,227
2022-06-14,Tehama,103,63373,12451,12392,2698,15090,205
2022-06-14,Trinity,105,12862,1224,1217,292,1509,20
2022-06-14,Tulare,107,460477,110291,109930,29633,139563,1495
2022-06-14,Tuolumne,109,53932,13586,13459,666,14125,189
2022-06-14,Ventura,111,848112,186018,184750,11337,196087,1509
2022-06-14,Yolo,113,214977,42469,40756,3511,44267,322
2022-06-14,Yuba,115,75493,16842,16754,1409,18163,124
2022-06-13,Alameda,001,1643700,297313,295002,16664,311666,1880
2022-06-13,Alpine,003,1148,129,129,1,130,0
2022-06-13,Amador,005,37829,9079,8972,724,9696,87
2022-06-13,Butte,007,227075,35117,34841,7625,42466,430
2022-06-13,Calaveras,009,45235,7678,7648,405,8053,122
2022-06-13,Colusa,011,21464,3522,3515,1099,4614,21
2022-06-13,Contra Costa,013,1133247,215600,213219,16293,229512,1321
2022-06-13,Del Norte,015,27424,6362,6298,268,6566,52
2022-06-13,El Dorado,017,186661,29013,28829,3594,32423,215
2022-06-13,Fresno,019,978130,242594,241768,25318,267086,2767
2022-06-13,Glenn,021,27897,5147,5128,1676,6804,48
2022-06-13,Humboldt,023,135768,18979,18836,3806,22642,148
2022-06-13,Imperial,025,180216,57575,57373,11203,68576,941
2022-06-13,Inyo,027,18085,4216,4205,606,4811,56
2022-06-13,Kern,029,883053,199071,198216,48985,247201,2338
2022-06-13,Kings,031,150075,53291,53170,3613,56783,448
2022-06-13,Lake,033,64148,11352,11303,984,12287,140
2022-06-13,Lassen,035,31185,9235,9209,911,10120,64
2022-06-13,Los Angeles,037,10098052,2914526,2897298,139717,3037015,31971
2022-06-13,Madera,039,155013,38952,38776,6596,45372,372
2022-06-13,Marin,041,260295,39323,39027,4433,43460,294
2022-06-13,Mariposa,043,17540,2672,2651,252,2903,30
2022-06-13,Mendocino,045,87422,14124,14052,3624,17676,127
2022-06-13,Merced,047,269075,64913,64595,9424,74019,825
2022-06-13,Modoc,049,8938,770,772,266,1038,8
2022-06-13,Mono,051,14174,3070,3060,172,3232,6
2022-06-13,Monterey,053,433212,84388,83837,16426,100263,741
2022-06-13,Napa,055,140530,28714,28518,1230,29748,144
2022-06-13,Nevada,057,99092,17196,17107,1403,18510,127
2022-06-13,Orange,059,3164182,588198,585496,47552,633048,7067
2022-06-13,Placer,061,380077,68204,67805,8216,76021,628
2022-06-13,Plumas,063,18699,3210,3185,390,3575,13
2022-06-13,Riverside,065,2383286,620974,618584,29935,648519,6482
2022-06-13,Sacramento,067,1510023,306672,305361,29897,335258,3059
2022-06-13,San Benito,069,59416,13989,13953,669,14622,99
2022-06-13,San Bernardino,071,2135413,595353,590328,26031,616359,7735
2022-06-13,San Diego,073,3302833,812686,811093,59342,870435,5316
2022-06-13,San Francisco,075,870044,152550,151170,10032,161202,890
2022-06-13,San Joaquin,077,732212,176819,175966,11444,187410,2244
2022-06-13,San Luis Obispo,079,281455,56843,56535,5110,61645,486
2022-06-13,San Mateo,081,765935,144286,143277,9155,152432,722
2022-06-13,Santa Barbara,083,443738,93099,92710,5365,98075,698
2022-06-13,Santa Clara,085,1922200,366985,364014,15761,379775,2323
2022-06-13,Santa Cruz,087,273765,54124,53718,2625,56343,265
2022-06-13,Shasta,089,179085,31734,31598,6341,37939,568
2022-06-13,Sierra,091,2930,280,280,56,336,4
2022-06-13,Siskiyou,093,43540,4684,4656,2913,7569,81
2022-06-13,Solano,095,438530,91317,90265,6393,96658,453
2022-06-13,Sonoma,097,501317,94621,94041,4022,98063,492
2022-06-13,Stanislaus,099,539301,123471,122944,18571,141515,1668
2022-06-13,Sutter,101,95872,21482,21448,2267,23715,227
2022-06-13,Tehama,103,63373,12431,12392,2695,15087,205
2022-06-13,Trinity,105,12862,1222,1217,292,1509,20
2022-06-13,Tulare,107,460477,110140,109930,29584,139514,1495
2022-06-13,Tuolumne,109,53932,13564,13459,663,14122,189
2022-06-13,Ventura,111,848112,185726,184750,11287,196037,1509
2022-06-13,Yolo,113,214977,42331,40756,3499,44255,322
2022-06-13,Yuba,115,75493,16824,16754,1405,18159,124
2022-06-12,Alameda,001,1643700,296497,292112,16605,308717,1877
2022-06-12,Alpine,003,1148,129,129,1,130,0
2022-06-12,Amador,005,37829,9056,8869,723,9592,87
2022-06-12,Butte,007,227075,35059,34596,7604,42200,427
2022-06-12,Calaveras,009,45235,7664,7604,402,8006,122
2022-06-12,Colusa,011,21464,3521,3505,1098,4603,21
2022-06-12,Contra Costa,013,1133247,215012,211229,16221,227450,1315
2022-06-12,Del Norte,015,27424,6348,6253,268,6521,52
2022-06-12,El Dorado,017,186661,28952,28641,3577,32218,215
2022-06-12,Fresno,019,978130,242134,240345,25267,265612,2766
2022-06-12,Glenn,021,27897,5143,5104,1674,6778,48
2022-06-12,Humboldt,023,135768,18913,18696,3770,22466,148
2022-06-12,Imperial,025,180216,57498,57129,11159,68288,941
2022-06-12,Inyo,027,18085,4214,4194,605,4799,56
2022-06-12,Kern,029,883053,198790,197353,48865,246218,2338
2022-06-12,Kings,031,150075,53213,52978,3608,56586,447
2022-06-12,Lake,033,64148,11328,11202,983,12185,139
2022-06-12,Lassen,035,31185,9217,9172,909,10081,64
2022-06-12,Los Angeles,037,10098052,2909585,2878981,139238,3018219,31947
2022-06-12,Madera,039,155013,38859,38567,6572,45139,372
2022-06-12,Marin,041,260295,39215,38593,4409,43002,294
2022-06-12,Mariposa,043,17540,2666,2625,251,2876,30
2022-06-12,Mendocino,045,87422,14101,13945,3618,17563,127
2022-06-12,Merced,047,269075,64798,64286,9395,73681,825
2022-06-12,Modoc,049,8938,770,767,266,1033,8
2022-06-12,Mono,051,14174,3066,3052,171,3223,6
2022-06-12,Monterey,053,433212,84232,83391,16348,99739,739
2022-06-12,Napa,055,140530,28652,28202,1221,29423,143
2022-06-12,Nevada,057,99092,17153,16989,1397,18386,127
2022-06-12,Orange,059,3164182,586922,581624,47369,628993,7057
2022-06-12,Placer,061,380077,68091,67306,8192,75498,628
2022-06-12,Plumas,063,18699,3204,3172,389,3561,13
2022-06-12,Riverside,065,2383286,620030,615556,29867,645423,6481
2022-06-12,Sacramento,067,1510023,305936,302721,29796,332517,3058
2022-06-12,San Benito,069,59416,13954,13832,663,14495,99
2022-06-12,San Bernardino,071,2135413,594436,587385,25981,613366,7708
2022-06-12,San Diego,073,3302833,810952,805360,59208,864568,5315
2022-06-12,San Francisco,075,870044,151990,149278,9986,159264,890
2022-06-12,San Joaquin,077,732212,176465,174822,11418,186240,2244
2022-06-12,San Luis Obispo,079,281455,56706,56160,5049,61209,485
2022-06-12,San Mateo,081,765935,143825,141719,9113,150832,715
2022-06-12,Santa Barbara,083,443738,92926,92177,5351,97528,694
2022-06-12,Santa Clara,085,1922200,365807,359925,15714,375639,2322
2022-06-12,Santa Cruz,087,273765,53963,53171,2620,55791,264
2022-06-12,Shasta,089,179085,31687,31483,6327,37810,566
2022-06-12,Sierra,091,2930,280,278,56,334,4
2022-06-12,Siskiyou,093,43540,4676,4633,2908,7541,81
2022-06-12,Solano,095,438530,91026,89424,6374,95798,453
2022-06-12,Sonoma,097,501317,94369,93218,3999,97217,492
2022-06-12,Stanislaus,099,539301,123272,122267,18534,140801,1665
2022-06-12,Sutter,101,95872,21441,21333,2251,23584,227
2022-06-12,Tehama,103,63373,12413,12343,2690,15033,205
2022-06-12,Trinity,105,12862,1219,1213,292,1505,20
2022-06-12,Tulare,107,460477,109937,109467,29518,138985,1495
2022-06-12,Tuolumne,109,53932,13536,13382,661,14043,189
2022-06-12,Ventura,111,848112,185368,183680,11242,194922,1508
2022-06-12,Yolo,113,214977,42210,40202,3494,43696,323
2022-06-12,Yuba,115,75493,16796,16653,1397,18050,123
2022-06-11,Alameda,001,1643700,296081,292112,16582,308694,1877
2022-06-11,Alpine,003,1148,129,129,1,130,0
2022-06-11,Amador,005,37829,9042,8869,723,9592,87
2022-06-11,Butte,007,227075,35024,34596,7588,42184,427
2022-06-11,Calaveras,009,45235,7657,7604,401,8005,122
2022-06-11,Colusa,011,21464,3519,3505,1097,4602,21
2022-06-11,Contra Costa,013,1133247,214701,211229,16185,227414,1315
2022-06-11,Del Norte,015,27424,6340,6253,268,6521,52
2022-06-11,El Dorado,017,186661,28933,28641,3575,32216,215
2022-06-11,Fresno,019,978130,241940,240345,25248,265593,2766
2022-06-11,Glenn,021,27897,5141,5104,1674,6778,48
2022-06-11,Humboldt,023,135768,18890,18696,3762,22458,148
2022-06-11,Imperial,025,180216,57441,57129,11145,68274,941
2022-06-11,Inyo,027,18085,4214,4194,603,4797,56
2022-06-11,Kern,029,883053,198668,197353,48792,246145,2338
2022-06-11,Kings,031,150075,53181,52978,3607,56585,447
2022-06-11,Lake,033,64148,11320,11202,980,12182,139
2022-06-11,Lassen,035,31185,9212,9172,908,10080,64
2022-06-11,Los Angeles,037,10098052,2907247,2878981,138948,3017929,31947
2022-06-11,Madera,039,155013,38838,38567,6570,45137,372
2022-06-11,Marin,041,260295,39138,38593,4375,42968,294
2022-06-11,Mariposa,043,17540,2662,2625,250,2875,30
2022-06-11,Mendocino,045,87422,14090,13945,3614,17559,127
2022-06-11,Merced,047,269075,64750,64286,9391,73677,825
2022-06-11,Modoc,049,8938,770,767,266,1033,8
2022-06-11,Mono,051,14174,3066,3052,171,3223,6
2022-06-11,Monterey,053,433212,84149,83391,16316,99707,739
2022-06-11,Napa,055,140530,28613,28202,1217,29419,143
2022-06-11,Nevada,057,99092,17140,16989,1395,18384,127
2022-06-11,Orange,059,3164182,586280,581624,47234,628858,7057
2022-06-11,Placer,061,380077,68003,67306,8183,75489,628
2022-06-11,Plumas,063,18699,3201,3172,389,3561,13
2022-06-11,Riverside,065,2383286,619504,615556,29838,645394,6481
2022-06-11,Sacramento,067,1510023,305630,302721,29761,332482,3058
2022-06-11,San Benito,069,59416,13944,13832,660,14492,99
2022-06-11,San Bernardino,071,2135413,594016,587385,25958,613343,7708
2022-06-11,San Diego,073,3302833,810250,805360,59165,864525,5315
2022-06-11,San Francisco,075,870044,151669,149278,9966,159244,890
2022-06-11,San Joaquin,077,732212,176310,174822,11400,186222,2244
2022-06-11,San Luis Obispo,079,281455,56672,56160,5040,61200,485
2022-06-11,San Mateo,081,765935,143602,141719,9091,150810,715
2022-06-11,Santa Barbara,083,443738,92860,92177,5338,97515,694
2022-06-11,Santa Clara,085,1922200,365046,359925,15675,375600,2322
2022-06-11,Santa Cruz,087,273765,53908,53171,2606,55777,264
2022-06-11,Shasta,089,179085,31671,31483,6321,37804,566
2022-06-11,Sierra,091,2930,280,278,56,334,4
2022-06-11,Siskiyou,093,43540,4670,4633,2900,7533,81
2022-06-11,Solano,095,438530,90937,89424,6365,95789,453
2022-06-11,Sonoma,097,501317,94262,93218,3975,97193,492
2022-06-11,Stanislaus,099,539301,123169,122267,18514,140781,1665
2022-06-11,Sutter,101,95872,21424,21333,2249,23582,227
2022-06-11,Tehama,103,63373,12406,12343,2690,15033,205
2022-06-11,Trinity,105,12862,1219,1213,292,1505,20
2022-06-11,Tulare,107,460477,109856,109467,29488,138955,1495
2022-06-11,Tuolumne,109,53932,13510,13382,660,14042,189
2022-06-11,Ventura,111,848112,185190,183680,11211,194891,1508
2022-06-11,Yolo,113,214977,42146,40202,3488,43690,323
2022-06-11,Yuba,115,75493,16777,16653,1393,18046,123
2022-06-10,Alameda,001,1643700,295611,292112,16558,308670,1877
2022-06-10,Alpine,003,1148,129,129,1,130,0
2022-06-10,Amador,005,37829,9029,8869,722,9591,87
2022-06-10,Butte,007,227075,34992,34596,7577,42173,427
2022-06-10,Calaveras,009,45235,7652,7604,400,8004,122
2022-06-10,Colusa,011,21464,3514,3505,1096,4601,21
2022-06-10,Contra Costa,013,1133247,214434,211229,16154,227383,1315
2022-06-10,Del Norte,015,27424,6334,6253,267,6520,52
2022-06-10,El Dorado,017,186661,28903,28641,3572,32213,215
2022-06-10,Fresno,019,978130,241711,240345,25225,265570,2766
2022-06-10,Glenn,021,27897,5139,5104,1671,6775,48
2022-06-10,Humboldt,023,135768,18868,18696,3755,22451,148
2022-06-10,Imperial,025,180216,57395,57129,11142,68271,941
2022-06-10,Inyo,027,18085,4213,4194,600,4794,56
2022-06-10,Kern,029,883053,198522,197353,48701,246054,2338
2022-06-10,Kings,031,150075,53160,52978,3606,56584,447
2022-06-10,Lake,033,64148,11305,11202,979,12181,139
2022-06-10,Lassen,035,31185,9209,9172,906,10078,64
2022-06-10,Los Angeles,037,10098052,2904528,2878981,138678,3017659,31947
2022-06-10,Madera,039,155013,38810,38567,6562,45129,372
2022-06-10,Marin,041,260295,39043,38593,4348,42941,294
2022-06-10,Mariposa,043,17540,2658,2625,249,2874,30
2022-06-10,Mendocino,045,87422,14072,13945,3606,17551,127
2022-06-10,Merced,047,269075,64707,64286,9386,73672,825
2022-06-10,Modoc,049,8938,770,767,266,1033,8
2022-06-10,Mono,051,14174,3066,3052,170,3222,6
2022-06-10,Monterey,053,433212,84058,83391,16276,99667,739
2022-06-10,Napa,055,140530,28582,28202,1216,29418,143
2022-06-10,Nevada,057,99092,17127,16989,1394,18383,127
2022-06-10,Orange,059,3164182,585619,581624,47120,628744,7057
2022-06-10,Placer,061,380077,67932,67306,8165,75471,628
2022-06-10,Plumas,063,18699,3197,3172,389,3561,13
2022-06-10,Riverside,065,2383286,618984,615556,29809,645365,6481
2022-06-10,Sacramento,067,1510023,305234,302721,29738,332459,3058
2022-06-10,San Benito,069,59416,13930,13832,659,14491,99
2022-06-10,San Bernardino,071,2135413,593610,587385,25927,613312,7708
2022-06-10,San Diego,073,3302833,809333,805360,59133,864493,5315
2022-06-10,San Francisco,075,870044,151348,149278,9927,159205,890
2022-06-10,San Joaquin,077,732212,176195,174822,11385,186207,2244
2022-06-10,San Luis Obispo,079,281455,56637,56160,5033,61193,485
2022-06-10,San Mateo,081,765935,143349,141719,9078,150797,715
2022-06-10,Santa Barbara,083,443738,92761,92177,5334,97511,694
2022-06-10,Santa Clara,085,1922200,364301,359925,15641,375566,2322
2022-06-10,Santa Cruz,087,273765,53809,53171,2597,55768,264
2022-06-10,Shasta,089,179085,31651,31483,6312,37795,566
2022-06-10,Sierra,091,2930,279,278,56,334,4
2022-06-10,Siskiyou,093,43540,4663,4633,2894,7527,81
2022-06-10,Solano,095,438530,90776,89424,6353,95777,453
2022-06-10,Sonoma,097,501317,94103,93218,3952,97170,492
2022-06-10,Stanislaus,099,539301,123050,122267,18502,140769,1665
2022-06-10,Sutter,101,95872,21409,21333,2247,23580,227
2022-06-10,Tehama,103,63373,12398,12343,2689,15032,205
2022-06-10,Trinity,105,12862,1217,1213,292,1505,20
2022-06-10,Tulare,107,460477,109789,109467,29467,138934,1495
2022-06-10,Tuolumne,109,53932,13496,13382,658,14040,189
2022-06-10,Ventura,111,848112,185004,183680,11177,194857,1508
2022-06-10,Yolo,113,214977,42056,40202,3480,43682,323
2022-06-10,Yuba,115,75493,16756,16653,1390,18043,123
2022-06-09,Alameda,001,1643700,294700,292112,16502,308614,1877
2022-06-09,Alpine,003,1148,129,129,1,130,0
2022-06-09,Amador,005,37829,9018,8869,720,9589,87
2022-06-09,Butte,007,227075,34932,34596,7566,42162,427
2022-06-09,Calaveras,009,45235,7642,7604,400,8004,122
2022-06-09,Colusa,011,21464,3513,3505,1094,4599,21
2022-06-09,Contra Costa,013,1133247,213921,211229,16108,227337,1315
2022-06-09,Del Norte,015,27424,6321,6253,265,6518,52
2022-06-09,El Dorado,017,186661,28846,28641,3563,32204,215
2022-06-09,Fresno,019,978130,241356,240345,25182,265527,2766
2022-06-09,Glenn,021,27897,5133,5104,1669,6773,48
2022-06-09,Humboldt,023,135768,18820,18696,3744,22440,148
2022-06-09,Imperial,025,180216,57338,57129,11125,68254,941
2022-06-09,Inyo,027,18085,4210,4194,595,4789,56
2022-06-09,Kern,029,883053,198321,197353,48602,245955,2338
2022-06-09,Kings,031,150075,53119,52978,3603,56581,447
2022-06-09,Lake,033,64148,11280,11202,977,12179,139
2022-06-09,Lassen,035,31185,9190,9172,904,10076,64
2022-06-09,Los Angeles,037,10098052,2900139,2878981,138297,3017278,31947
2022-06-09,Madera,039,155013,38756,38567,6548,45115,372
2022-06-09,Marin,041,260295,38941,38593,4323,42916,294
2022-06-09,Mariposa,043,17540,2654,2625,248,2873,30
2022-06-09,Mendocino,045,87422,14044,13945,3604,17549,127
2022-06-09,Merced,047,269075,64629,64286,9377,73663,825
2022-06-09,Modoc,049,8938,769,767,266,1033,8
2022-06-09,Mono,051,14174,3060,3052,168,3220,6
2022-06-09,Monterey,053,433212,83938,83391,16207,99598,739
2022-06-09,Napa,055,140530,28522,28202,1214,29416,143
2022-06-09,Nevada,057,99092,17094,16989,1393,18382,127
2022-06-09,Orange,059,3164182,584550,581624,46973,628597,7057
2022-06-09,Placer,061,380077,67811,67306,8152,75458,628
2022-06-09,Plumas,063,18699,3191,3172,389,3561,13
2022-06-09,Riverside,065,2383286,618291,615556,29769,645325,6481
2022-06-09,Sacramento,067,1510023,304657,302721,29656,332377,3058
2022-06-09,San Benito,069,59416,13912,13832,657,14489,99
2022-06-09,San Bernardino,071,2135413,592938,587385,25894,613279,7708
2022-06-09,San Diego,073,3302833,807921,805360,59000,864360,5315
2022-06-09,San Francisco,075,870044,150947,149278,9897,159175,890
2022-06-09,San Joaquin,077,732212,175902,174822,11367,186189,2244
2022-06-09,San Luis Obispo,079,281455,56550,56160,5005,61165,485
2022-06-09,San Mateo,081,765935,142968,141719,9051,150770,715
2022-06-09,Santa Barbara,083,443738,92630,92177,5329,97506,694
2022-06-09,Santa Clara,085,1922200,363334,359925,15573,375498,2322
2022-06-09,Santa Cruz,087,273765,53677,53171,2587,55758,264
2022-06-09,Shasta,089,179085,31620,31483,6302,37785,566
2022-06-09,Sierra,091,2930,279,278,56,334,4
2022-06-09,Siskiyou,093,43540,4656,4633,2880,7513,81
2022-06-09,Solano,095,438530,90532,89424,6339,95763,453
2022-06-09,Sonoma,097,501317,93947,93218,3934,97152,492
2022-06-09,Stanislaus,099,539301,122882,122267,18488,140755,1665
2022-06-09,Sutter,101,95872,21372,21333,2247,23580,227
2022-06-09,Tehama,103,63373,12380,12343,2688,15031,205
2022-06-09,Trinity,105,12862,1216,1213,292,1505,20
2022-06-09,Tulare,107,460477,109668,109467,29431,138898,1495
2022-06-09,Tuolumne,109,53932,13465,13382,655,14037,189
2022-06-09,Ventura,111,848112,184736,183680,11144,194824,1508
2022-06-09,Yolo,113,214977,41944,40202,3465,43667,323
2022-06-09,Yuba,115,75493,16733,16653,1387,18040,123
2022-06-08,Alameda,001,1643700,293936,289661,16452,306113,1873
2022-06-08,Alpine,003,1148,129,128,1,129,0
2022-06-08,Amador,005,37829,9010,8818,718,9536,87
2022-06-08,Butte,007,227075,34867,34380,7548,41928,427
2022-06-08,Calaveras,009,45235,7628,7564,400,7964,122
2022-06-08,Colusa,011,21464,3511,3495,1091,4586,21
2022-06-08,Contra Costa,013,1133247,213412,209384,16042,225426,1310
2022-06-08,Del Norte,015,27424,6299,6229,265,6494,52
2022-06-08,El Dorado,017,186661,28794,28478,3554,32032,215
2022-06-08,Fresno,019,978130,241020,239376,25111,264487,2766
2022-06-08,Glenn,021,27897,5129,5095,1666,6761,48
2022-06-08,Humboldt,023,135768,18790,18598,3718,22316,147
2022-06-08,Imperial,025,180216,57264,56912,11105,68017,941
2022-06-08,Inyo,027,18085,4208,4189,595,4784,56
2022-06-08,Kern,029,883053,198052,196763,48492,245255,2338
2022-06-08,Kings,031,150075,53049,52821,3599,56420,447
2022-06-08,Lake,033,64148,11259,11158,974,12132,137
2022-06-08,Lassen,035,31185,9177,9148,904,10052,64
2022-06-08,Los Angeles,037,10098052,2895518,2865901,137911,3003812,31920
2022-06-08,Madera,039,155013,38711,38408,6535,44943,372
2022-06-08,Marin,041,260295,38848,38338,4306,42644,294
2022-06-08,Mariposa,043,17540,2644,2614,247,2861,30
2022-06-08,Mendocino,045,87422,14024,13859,3593,17452,127
2022-06-08,Merced,047,269075,64564,64080,9355,73435,825
2022-06-08,Modoc,049,8938,765,761,266,1027,8
2022-06-08,Mono,051,14174,3056,3044,168,3212,6
2022-06-08,Monterey,053,433212,83827,83063,16157,99220,740
2022-06-08,Napa,055,140530,28433,27996,1209,29205,143
2022-06-08,Nevada,057,99092,17068,16907,1389,18296,127
2022-06-08,Orange,059,3164182,583441,578530,46787,625317,7044
2022-06-08,Placer,061,380077,67682,66951,8141,75092,627
2022-06-08,Plumas,063,18699,3188,3150,388,3538,13
2022-06-08,Riverside,065,2383286,617605,613469,29734,643203,6480
2022-06-08,Sacramento,067,1510023,304024,300875,29573,330448,3054
2022-06-08,San Benito,069,59416,13878,13734,655,14389,99
2022-06-08,San Bernardino,071,2135413,592241,585029,25850,610879,7685
2022-06-08,San Diego,073,3302833,806425,800840,58823,859663,5308
2022-06-08,San Francisco,075,870044,150524,147960,9869,157829,885
2022-06-08,San Joaquin,077,732212,175627,173887,11341,185228,2241
2022-06-08,San Luis Obispo,079,281455,56394,55822,4938,60760,484
2022-06-08,San Mateo,081,765935,142571,140569,9004,149573,710
2022-06-08,Santa Barbara,083,443738,92491,91747,5318,97065,693
2022-06-08,Santa Clara,085,1922200,362368,356452,15522,371974,2321
2022-06-08,Santa Cruz,087,273765,53537,52753,2576,55329,264
2022-06-08,Shasta,089,179085,31587,31394,6291,37685,565
2022-06-08,Sierra,091,2930,279,278,56,334,4
2022-06-08,Siskiyou,093,43540,4651,4609,2878,7487,81
2022-06-08,Solano,095,438530,90265,88522,6319,94841,453
2022-06-08,Sonoma,097,501317,93764,92644,3901,96545,491
2022-06-08,Stanislaus,099,539301,122698,121787,18457,140244,1662
2022-06-08,Sutter,101,95872,21348,21256,2241,23497,227
2022-06-08,Tehama,103,63373,12373,12306,2687,14993,205
2022-06-08,Trinity,105,12862,1215,1211,291,1502,20
2022-06-08,Tulare,107,460477,109581,109091,29376,138467,1494
2022-06-08,Tuolumne,109,53932,13449,13335,654,13989,189
2022-06-08,Ventura,111,848112,184461,182847,11095,193942,1506
2022-06-08,Yolo,113,214977,41839,39962,3451,43413,321
2022-06-08,Yuba,115,75493,16708,16558,1379,17937,122
2022-06-07,Alameda,001,1643700,293129,289661,16394,306055,1873
2022-06-07,Alpine,003,1148,129,128,1,129,0
2022-06-07,Amador,005,37829,9000,8818,717,9535,87
2022-06-07,Butte,007,227075,34789,34380,7523,41903,427
2022-06-07,Calaveras,009,45235,7620,7564,399,7963,122
2022-06-07,Colusa,011,21464,3511,3495,1088,4583,21
2022-06-07,Contra Costa,013,1133247,212855,209384,15989,225373,1310
2022-06-07,Del Norte,015,27424,6291,6229,262,6491,52
2022-06-07,El Dorado,017,186661,28730,28478,3545,32023,215
2022-06-07,Fresno,019,978130,240637,239376,25046,264422,2766
2022-06-07,Glenn,021,27897,5122,5095,1666,6761,48
2022-06-07,Humboldt,023,135768,18751,18598,3703,22301,147
2022-06-07,Imperial,025,180216,57206,56912,11072,67984,941
2022-06-07,Inyo,027,18085,4207,4189,587,4776,56
2022-06-07,Kern,029,883053,197797,196763,48384,245147,2338
2022-06-07,Kings,031,150075,52991,52821,3595,56416,447
2022-06-07,Lake,033,64148,11234,11158,969,12127,137
2022-06-07,Lassen,035,31185,9168,9148,903,10051,64
2022-06-07,Los Angeles,037,10098052,2890192,2865901,137474,3003375,31920
2022-06-07,Madera,039,155013,38639,38408,6519,44927,372
2022-06-07,Marin,041,260295,38764,38338,4279,42617,294
2022-06-07,Mariposa,043,17540,2637,2614,245,2859,30
2022-06-07,Mendocino,045,87422,13992,13859,3562,17421,127
2022-06-07,Merced,047,269075,64473,64080,9339,73419,825
2022-06-07,Modoc,049,8938,765,761,264,1025,8
2022-06-07,Mono,051,14174,3054,3044,166,3210,6
2022-06-07,Monterey,053,433212,83699,83063,16104,99167,740
2022-06-07,Napa,055,140530,28359,27996,1201,29197,143
2022-06-07,Nevada,057,99092,17041,16907,1383,18290,127
2022-06-07,Orange,059,3164182,582324,578530,46626,625156,7044
2022-06-07,Placer,061,380077,67530,66951,8122,75073,627
2022-06-07,Plumas,063,18699,3183,3150,387,3537,13
2022-06-07,Riverside,065,2383286,616722,613469,29683,643152,6480
2022-06-07,Sacramento,067,1510023,303306,300875,29471,330346,3054
2022-06-07,San Benito,069,59416,13836,13734,651,14385,99
2022-06-07,San Bernardino,071,2135413,591458,585029,25823,610852,7685
2022-06-07,San Diego,073,3302833,804846,800840,58617,859457,5308
2022-06-07,San Francisco,075,870044,150002,147960,9848,157808,885
2022-06-07,San Joaquin,077,732212,175294,173887,11304,185191,2241
2022-06-07,San Luis Obispo,079,281455,56291,55822,4894,60716,484
2022-06-07,San Mateo,081,765935,142153,140569,8948,149517,710
2022-06-07,Santa Barbara,083,443738,92345,91747,5306,97053,693
2022-06-07,Santa Clara,085,1922200,361235,356452,15441,371893,2321
2022-06-07,Santa Cruz,087,273765,53436,52753,2569,55322,264
2022-06-07,Shasta,089,179085,31550,31394,6284,37678,565
2022-06-07,Sierra,091,2930,278,278,56,334,4
2022-06-07,Siskiyou,093,43540,4644,4609,2874,7483,81
2022-06-07,Solano,095,438530,89940,88522,6302,94824,453
2022-06-07,Sonoma,097,501317,93537,92644,3869,96513,491
2022-06-07,Stanislaus,099,539301,122525,121787,18438,140225,1662
2022-06-07,Sutter,101,95872,21319,21256,2239,23495,227
2022-06-07,Tehama,103,63373,12357,12306,2683,14989,205
2022-06-07,Trinity,105,12862,1214,1211,291,1502,20
2022-06-07,Tulare,107,460477,109456,109091,29325,138416,1494
2022-06-07,Tuolumne,109,53932,13436,13335,652,13987,189
2022-06-07,Ventura,111,848112,184096,182847,11051,193898,1506
2022-06-07,Yolo,113,214977,41722,39962,3442,43404,321
2022-06-07,Yuba,115,75493,16679,16558,1378,17936,122
2022-06-06,Alameda,001,1643700,292244,289661,16336,305997,1873
2022-06-06,Alpine,003,1148,129,128,1,129,0
2022-06-06,Amador,005,37829,8949,8818,715,9533,87
2022-06-06,Butte,007,227075,34725,34380,7509,41889,427
2022-06-06,Calaveras,009,45235,7609,7564,399,7963,122
2022-06-06,Colusa,011,21464,3510,3495,1084,4579,21
2022-06-06,Contra Costa,013,1133247,212206,209384,15908,225292,1310
2022-06-06,Del Norte,015,27424,6283,6229,261,6490,52
2022-06-06,El Dorado,017,186661,28681,28478,3533,32011,215
2022-06-06,Fresno,019,978130,240217,239376,24987,264363,2766
2022-06-06,Glenn,021,27897,5115,5095,1663,6758,48
2022-06-06,Humboldt,023,135768,18713,18598,3690,22288,147
2022-06-06,Imperial,025,180216,57132,56912,11039,67951,941
2022-06-06,Inyo,027,18085,4203,4189,584,4773,56
2022-06-06,Kern,029,883053,197515,196763,48253,245016,2338
2022-06-06,Kings,031,150075,52932,52821,3592,56413,447
2022-06-06,Lake,033,64148,11214,11158,963,12121,137
2022-06-06,Lassen,035,31185,9158,9148,902,10050,64
2022-06-06,Los Angeles,037,10098052,2884564,2865901,137057,3002958,31920
2022-06-06,Madera,039,155013,38571,38408,6492,44900,372
2022-06-06,Marin,041,260295,38639,38338,4242,42580,294
2022-06-06,Mariposa,043,17540,2627,2614,243,2857,30
2022-06-06,Mendocino,045,87422,13963,13859,3551,17410,127
2022-06-06,Merced,047,269075,64351,64080,9315,73395,825
2022-06-06,Modoc,049,8938,763,761,262,1023,8
2022-06-06,Mono,051,14174,3051,3044,165,3209,6
2022-06-06,Monterey,053,433212,83556,83063,16039,99102,740
2022-06-06,Napa,055,140530,28280,27996,1192,29188,143
2022-06-06,Nevada,057,99092,17013,16907,1379,18286,127
2022-06-06,Orange,059,3164182,581202,578530,46467,624997,7044
2022-06-06,Placer,061,380077,67416,66951,8098,75049,627
2022-06-06,Plumas,063,18699,3176,3150,386,3536,13
2022-06-06,Riverside,065,2383286,615928,613469,29633,643102,6480
2022-06-06,Sacramento,067,1510023,302530,300875,29368,330243,3054
2022-06-06,San Benito,069,59416,13788,13734,647,14381,99
2022-06-06,San Bernardino,071,2135413,590687,585029,25781,610810,7685
2022-06-06,San Diego,073,3302833,803058,800840,58384,859224,5308
2022-06-06,San Francisco,075,870044,149473,147960,9826,157786,885
2022-06-06,San Joaquin,077,732212,174912,173887,11274,185161,2241
2022-06-06,San Luis Obispo,079,281455,56182,55822,4861,60683,484
2022-06-06,San Mateo,081,765935,141677,140569,8910,149479,710
2022-06-06,Santa Barbara,083,443738,92168,91747,5288,97035,693
2022-06-06,Santa Clara,085,1922200,359974,356452,15358,371810,2321
2022-06-06,Santa Cruz,087,273765,53282,52753,2558,55311,264
2022-06-06,Shasta,089,179085,31515,31394,6272,37666,565
2022-06-06,Sierra,091,2930,278,278,56,334,4
2022-06-06,Siskiyou,093,43540,4634,4609,2864,7473,81
2022-06-06,Solano,095,438530,89651,88522,6283,94805,453
2022-06-06,Sonoma,097,501317,93300,92644,3841,96485,491
2022-06-06,Stanislaus,099,539301,122339,121787,18418,140205,1662
2022-06-06,Sutter,101,95872,21289,21256,2233,23489,227
2022-06-06,Tehama,103,63373,12345,12306,2681,14987,205
2022-06-06,Trinity,105,12862,1212,1211,291,1502,20
2022-06-06,Tulare,107,460477,109319,109091,29270,138361,1494
2022-06-06,Tuolumne,109,53932,13417,13335,651,13986,189
2022-06-06,Ventura,111,848112,183789,182847,11008,193855,1506
2022-06-06,Yolo,113,214977,41564,39962,3431,43393,321
2022-06-06,Yuba,115,75493,16636,16558,1371,17929,122
2022-06-05,Alameda,001,1643700,291198,285785,16275,302060,1873
2022-06-05,Alpine,003,1148,128,128,1,129,0
2022-06-05,Amador,005,37829,8912,8775,712,9487,87
2022-06-05,Butte,007,227075,34644,34129,7492,41621,427
2022-06-05,Calaveras,009,45235,7593,7525,393,7918,121
2022-06-05,Colusa,011,21464,3502,3484,1084,4568,21
2022-06-05,Contra Costa,013,1133247,211497,206711,15795,222506,1310
2022-06-05,Del Norte,015,27424,6272,6206,257,6463,52
2022-06-05,El Dorado,017,186661,28605,28241,3525,31766,214
2022-06-05,Fresno,019,978130,239756,237945,24902,262847,2766
2022-06-05,Glenn,021,27897,5109,5063,1663,6726,48
2022-06-05,Humboldt,023,135768,18663,18433,3667,22100,147
2022-06-05,Imperial,025,180216,57036,56690,10991,67681,941
2022-06-05,Inyo,027,18085,4199,4176,579,4755,56
2022-06-05,Kern,029,883053,197205,195863,48139,244002,2338
2022-06-05,Kings,031,150075,52858,52597,3586,56183,447
2022-06-05,Lake,033,64148,11195,11064,959,12023,137
2022-06-05,Lassen,035,31185,9150,9106,898,10004,64
2022-06-05,Los Angeles,037,10098052,2878505,2846989,136533,2983522,31899
2022-06-05,Madera,039,155013,38509,38188,6477,44665,372
2022-06-05,Marin,041,260295,38526,37879,4209,42088,294
2022-06-05,Mariposa,043,17540,2625,2557,242,2799,30
2022-06-05,Mendocino,045,87422,13927,13738,3504,17242,125
2022-06-05,Merced,047,269075,64260,63756,9282,73038,825
2022-06-05,Modoc,049,8938,762,759,262,1021,8
2022-06-05,Mono,051,14174,3048,3037,163,3200,6
2022-06-05,Monterey,053,433212,83395,82451,15956,98407,738
2022-06-05,Napa,055,140530,28150,27686,1183,28869,143
2022-06-05,Nevada,057,99092,16970,16728,1363,18091,127
2022-06-05,Orange,059,3164182,579943,574146,46284,620430,7038
2022-06-05,Placer,061,380077,67276,66428,8084,74512,627
2022-06-05,Plumas,063,18699,3168,3138,386,3524,13
2022-06-05,Riverside,065,2383286,614991,610369,29569,639938,6481
2022-06-05,Sacramento,067,1510023,301621,297787,29224,327011,3052
2022-06-05,San Benito,069,59416,13743,13572,641,14213,99
2022-06-05,San Bernardino,071,2135413,589708,582305,25737,608042,7664
2022-06-05,San Diego,073,3302833,801156,794822,58194,853016,5303
2022-06-05,San Francisco,075,870044,148879,145876,9771,155647,881
2022-06-05,San Joaquin,077,732212,174479,172621,11228,183849,2242
2022-06-05,San Luis Obispo,079,281455,56021,55333,4788,60121,484
2022-06-05,San Mateo,081,765935,141170,138536,8864,147400,710
2022-06-05,Santa Barbara,083,443738,91976,90911,5270,96181,693
2022-06-05,Santa Clara,085,1922200,358566,351492,15268,366760,2317
2022-06-05,Santa Cruz,087,273765,53090,52333,2545,54878,263
2022-06-05,Shasta,089,179085,31474,31272,6261,37533,565
2022-06-05,Sierra,091,2930,278,278,56,334,4
2022-06-05,Siskiyou,093,43540,4629,4591,2852,7443,81
2022-06-05,Solano,095,438530,89312,87571,6267,93838,452
2022-06-05,Sonoma,097,501317,93020,91518,3811,95329,491
2022-06-05,Stanislaus,099,539301,122142,121001,18391,139392,1661
2022-06-05,Sutter,101,95872,21257,21125,2226,23351,227
2022-06-05,Tehama,103,63373,12326,12262,2678,14940,204
2022-06-05,Trinity,105,12862,1212,1204,291,1495,20
2022-06-05,Tulare,107,460477,109123,108598,29194,137792,1490
2022-06-05,Tuolumne,109,53932,13388,13251,638,13889,189
2022-06-05,Ventura,111,848112,183436,181709,10956,192665,1505
2022-06-05,Yolo,113,214977,41432,39561,3419,42980,321
2022-06-05,Yuba,115,75493,16596,16467,1363,17830,122
2022-06-04,Alameda,001,1643700,290698,285785,16255,302040,1873
2022-06-04,Alpine,003,1148,128,128,1,129,0
2022-06-04,Amador,005,37829,8903,8775,710,9485,87
2022-06-04,Butte,007,227075,34604,34129,7486,41615,427
2022-06-04,Calaveras,009,45235,7579,7525,393,7918,121
2022-06-04,Colusa,011,21464,3499,3484,1079,4563,21
2022-06-04,Contra Costa,013,1133247,211110,206711,15755,222466,1310
2022-06-04,Del Norte,015,27424,6270,6206,257,6463,52
2022-06-04,El Dorado,017,186661,28566,28241,3521,31762,214
2022-06-04,Fresno,019,978130,239585,237945,24885,262830,2766
2022-06-04,Glenn,021,27897,5105,5063,1662,6725,48
2022-06-04,Humboldt,023,135768,18642,18433,3661,22094,147
2022-06-04,Imperial,025,180216,56985,56690,10979,67669,941
2022-06-04,Inyo,027,18085,4199,4176,578,4754,56
2022-06-04,Kern,029,883053,197083,195863,48071,243934,2338
2022-06-04,Kings,031,150075,52815,52597,3586,56183,447
2022-06-04,Lake,033,64148,11180,11064,953,12017,137
2022-06-04,Lassen,035,31185,9145,9106,897,10003,64
2022-06-04,Los Angeles,037,10098052,2876059,2846989,136257,2983246,31899
2022-06-04,Madera,039,155013,38474,38188,6473,44661,372
2022-06-04,Marin,041,260295,38449,37879,4168,42047,294
2022-06-04,Mariposa,043,17540,2622,2557,242,2799,30
2022-06-04,Mendocino,045,87422,13914,13738,3503,17241,125
2022-06-04,Merced,047,269075,64212,63756,9272,73028,825
2022-06-04,Modoc,049,8938,761,759,261,1020,8
2022-06-04,Mono,051,14174,3048,3037,163,3200,6
2022-06-04,Monterey,053,433212,83310,82451,15921,98372,738
2022-06-04,Napa,055,140530,28108,27686,1181,28867,143
2022-06-04,Nevada,057,99092,16957,16728,1362,18090,127
2022-06-04,Orange,059,3164182,579301,574146,46161,620307,7038
2022-06-04,Placer,061,380077,67194,66428,8076,74504,627
2022-06-04,Plumas,063,18699,3164,3138,385,3523,13
2022-06-04,Riverside,065,2383286,614457,610369,29544,639913,6481
2022-06-04,Sacramento,067,1510023,301266,297787,29197,326984,3052
2022-06-04,San Benito,069,59416,13717,13572,638,14210,99
2022-06-04,San Bernardino,071,2135413,589260,582305,25708,608013,7664
2022-06-04,San Diego,073,3302833,800428,794822,58150,852972,5303
2022-06-04,San Francisco,075,870044,148542,145876,9750,155626,881
2022-06-04,San Joaquin,077,732212,174334,172621,11194,183815,2242
2022-06-04,San Luis Obispo,079,281455,55983,55333,4781,60114,484
2022-06-04,San Mateo,081,765935,140869,138536,8836,147372,710
2022-06-04,Santa Barbara,083,443738,91878,90911,5249,96160,693
2022-06-04,Santa Clara,085,1922200,357687,351492,15227,366719,2317
2022-06-04,Santa Cruz,087,273765,53006,52333,2532,54865,263
2022-06-04,Shasta,089,179085,31450,31272,6258,37530,565
2022-06-04,Sierra,091,2930,278,278,56,334,4
2022-06-04,Siskiyou,093,43540,4625,4591,2846,7437,81
2022-06-04,Solano,095,438530,89229,87571,6254,93825,452
2022-06-04,Sonoma,097,501317,92870,91518,3797,95315,491
2022-06-04,Stanislaus,099,539301,122003,121001,18377,139378,1661
2022-06-04,Sutter,101,95872,21231,21125,2222,23347,227
2022-06-04,Tehama,103,63373,12312,12262,2677,14939,204
2022-06-04,Trinity,105,12862,1212,1204,291,1495,20
2022-06-04,Tulare,107,460477,109057,108598,29152,137750,1490
2022-06-04,Tuolumne,109,53932,13378,13251,635,13886,189
2022-06-04,Ventura,111,848112,183251,181709,10941,192650,1505
2022-06-04,Yolo,113,214977,41354,39561,3414,42975,321
2022-06-04,Yuba,115,75493,16580,16467,1359,17826,122
2022-06-03,Alameda,001,1643700,290168,285785,16224,302009,1873
2022-06-03,Alpine,003,1148,128,128,1,129,0
2022-06-03,Amador,005,37829,8897,8775,708,9483,87
2022-06-03,Butte,007,227075,34554,34129,7476,41605,427
2022-06-03,Calaveras,009,45235,7574,7525,393,7918,121
2022-06-03,Colusa,011,21464,3499,3484,1077,4561,21
2022-06-03,Contra Costa,013,1133247,210799,206711,15726,222437,1310
2022-06-03,Del Norte,015,27424,6266,6206,254,6460,52
2022-06-03,El Dorado,017,186661,28537,28241,3518,31759,214
2022-06-03,Fresno,019,978130,239354,237945,24857,262802,2766
2022-06-03,Glenn,021,27897,5099,5063,1659,6722,48
2022-06-03,Humboldt,023,135768,18622,18433,3655,22088,147
2022-06-03,Imperial,025,180216,56939,56690,10969,67659,941
2022-06-03,Inyo,027,18085,4198,4176,578,4754,56
2022-06-03,Kern,029,883053,196942,195863,48005,243868,2338
2022-06-03,Kings,031,150075,52791,52597,3586,56183,447
2022-06-03,Lake,033,64148,11169,11064,950,12014,137
2022-06-03,Lassen,035,31185,9140,9106,897,10003,64
2022-06-03,Los Angeles,037,10098052,2873162,2846989,135972,2982961,31899
2022-06-03,Madera,039,155013,38430,38188,6466,44654,372
2022-06-03,Marin,041,260295,38380,37879,4133,42012,294
2022-06-03,Mariposa,043,17540,2618,2557,242,2799,30
2022-06-03,Mendocino,045,87422,13892,13738,3502,17240,125
2022-06-03,Merced,047,269075,64159,63756,9269,73025,825
2022-06-03,Modoc,049,8938,761,759,261,1020,8
2022-06-03,Mono,051,14174,3045,3037,163,3200,6
2022-06-03,Monterey,053,433212,83211,82451,15874,98325,738
2022-06-03,Napa,055,140530,28058,27686,1173,28859,143
2022-06-03,Nevada,057,99092,16936,16728,1361,18089,127
2022-06-03,Orange,059,3164182,578613,574146,46057,620203,7038
2022-06-03,Placer,061,380077,67113,66428,8063,74491,627
2022-06-03,Plumas,063,18699,3162,3138,384,3522,13
2022-06-03,Riverside,065,2383286,613929,610369,29514,639883,6481
2022-06-03,Sacramento,067,1510023,300799,297787,29164,326951,3052
2022-06-03,San Benito,069,59416,13704,13572,634,14206,99
2022-06-03,San Bernardino,071,2135413,588802,582305,25673,607978,7664
2022-06-03,San Diego,073,3302833,799478,794822,58032,852854,5303
2022-06-03,San Francisco,075,870044,148169,145876,9718,155594,881
2022-06-03,San Joaquin,077,732212,174171,172621,11176,183797,2242
2022-06-03,San Luis Obispo,079,281455,55938,55333,4773,60106,484
2022-06-03,San Mateo,081,765935,140587,138536,8823,147359,710
2022-06-03,Santa Barbara,083,443738,91759,90911,5247,96158,693
2022-06-03,Santa Clara,085,1922200,356787,351492,15181,366673,2317
2022-06-03,Santa Cruz,087,273765,52875,52333,2519,54852,263
2022-06-03,Shasta,089,179085,31438,31272,6257,37529,565
2022-06-03,Sierra,091,2930,278,278,56,334,4
2022-06-03,Siskiyou,093,43540,4620,4591,2845,7436,81
2022-06-03,Solano,095,438530,89114,87571,6245,93816,452
2022-06-03,Sonoma,097,501317,92726,91518,3789,95307,491
2022-06-03,Stanislaus,099,539301,121897,121001,18360,139361,1661
2022-06-03,Sutter,101,95872,21208,21125,2221,23346,227
2022-06-03,Tehama,103,63373,12306,12262,2676,14938,204
2022-06-03,Trinity,105,12862,1210,1204,291,1495,20
2022-06-03,Tulare,107,460477,108991,108598,29117,137715,1490
2022-06-03,Tuolumne,109,53932,13367,13251,632,13883,189
2022-06-03,Ventura,111,848112,183063,181709,10916,192625,1505
2022-06-03,Yolo,113,214977,41291,39561,3400,42961,321
2022-06-03,Yuba,115,75493,16555,16467,1357,17824,122
2022-06-02,Alameda,001,1643700,289267,285785,16149,301934,1873
2022-06-02,Alpine,003,1148,128,128,1,129,0
2022-06-02,Amador,005,37829,8874,8775,706,9481,87
2022-06-02,Butte,007,227075,34477,34129,7460,41589,427
2022-06-02,Calaveras,009,45235,7561,7525,392,7917,121
2022-06-02,Colusa,011,21464,3497,3484,1077,4561,21
2022-06-02,Contra Costa,013,1133247,210213,206711,15637,222348,1310
2022-06-02,Del Norte,015,27424,6256,6206,253,6459,52
2022-06-02,El Dorado,017,186661,28470,28241,3506,31747,214
2022-06-02,Fresno,019,978130,239013,237945,24802,262747,2766
2022-06-02,Glenn,021,27897,5093,5063,1654,6717,48
2022-06-02,Humboldt,023,135768,18580,18433,3634,22067,147
2022-06-02,Imperial,025,180216,56879,56690,10958,67648,941
2022-06-02,Inyo,027,18085,4198,4176,575,4751,56
2022-06-02,Kern,029,883053,196658,195863,47901,243764,2338
2022-06-02,Kings,031,150075,52738,52597,3581,56178,447
2022-06-02,Lake,033,64148,11147,11064,948,12012,137
2022-06-02,Lassen,035,31185,9129,9106,897,10003,64
2022-06-02,Los Angeles,037,10098052,2868249,2846989,135551,2982540,31899
2022-06-02,Madera,039,155013,38376,38188,6453,44641,372
2022-06-02,Marin,041,260295,38281,37879,4106,41985,294
2022-06-02,Mariposa,043,17540,2613,2557,241,2798,30
2022-06-02,Mendocino,045,87422,13863,13738,3495,17233,125
2022-06-02,Merced,047,269075,64082,63756,9260,73016,825
2022-06-02,Modoc,049,8938,760,759,261,1020,8
2022-06-02,Mono,051,14174,3045,3037,163,3200,6
2022-06-02,Monterey,053,433212,83061,82451,15810,98261,738
2022-06-02,Napa,055,140530,27982,27686,1170,28856,143
2022-06-02,Nevada,057,99092,16899,16728,1358,18086,127
2022-06-02,Orange,059,3164182,577584,574146,45914,620060,7038
2022-06-02,Placer,061,380077,66992,66428,8049,74477,627
2022-06-02,Plumas,063,18699,3153,3138,384,3522,13
2022-06-02,Riverside,065,2383286,613241,610369,29455,639824,6481
2022-06-02,Sacramento,067,1510023,300166,297787,29058,326845,3052
2022-06-02,San Benito,069,59416,13672,13572,631,14203,99
2022-06-02,San Bernardino,071,2135413,588122,582305,25628,607933,7664
2022-06-02,San Diego,073,3302833,798105,794822,57869,852691,5303
2022-06-02,San Francisco,075,870044,147744,145876,9668,155544,881
2022-06-02,San Joaquin,077,732212,173861,172621,11148,183769,2242
2022-06-02,San Luis Obispo,079,281455,55807,55333,4738,60071,484
2022-06-02,San Mateo,081,765935,140210,138536,8770,147306,710
2022-06-02,Santa Barbara,083,443738,91585,90911,5232,96143,693
2022-06-02,Santa Clara,085,1922200,355691,351492,15061,366553,2317
2022-06-02,Santa Cruz,087,273765,52759,52333,2508,54841,263
2022-06-02,Shasta,089,179085,31408,31272,6250,37522,565
2022-06-02,Sierra,091,2930,278,278,56,334,4
2022-06-02,Siskiyou,093,43540,4613,4591,2836,7427,81
2022-06-02,Solano,095,438530,88842,87571,6235,93806,452
2022-06-02,Sonoma,097,501317,92502,91518,3763,95281,491
2022-06-02,Stanislaus,099,539301,121739,121001,18338,139339,1661
2022-06-02,Sutter,101,95872,21180,21125,2215,23340,227
2022-06-02,Tehama,103,63373,12295,12262,2669,14931,204
2022-06-02,Trinity,105,12862,1208,1204,291,1495,20
2022-06-02,Tulare,107,460477,108869,108598,29052,137650,1490
2022-06-02,Tuolumne,109,53932,13348,13251,630,13881,189
2022-06-02,Ventura,111,848112,182789,181709,10884,192593,1505
2022-06-02,Yolo,113,214977,41182,39561,3390,42951,321
2022-06-02,Yuba,115,75493,16534,16467,1350,17817,122
2022-06-01,Alameda,001,1643700,288260,284051,16082,300133,1868
2022-06-01,Alpine,003,1148,128,128,1,129,0
2022-06-01,Amador,005,37829,8868,8741,704,9445,87
2022-06-01,Butte,007,227075,34406,34059,7447,41506,427
2022-06-01,Calaveras,009,45235,7556,7502,389,7891,120
2022-06-01,Colusa,011,21464,3494,3476,1077,4553,21
2022-06-01,Contra Costa,013,1133247,209571,205699,15560,221259,1310
2022-06-01,Del Norte,015,27424,6246,6188,252,6440,51
2022-06-01,El Dorado,017,186661,28408,28133,3488,31621,214
2022-06-01,Fresno,019,978130,238655,237367,24751,262118,2765
2022-06-01,Glenn,021,27897,5088,5059,1654,6713,48
2022-06-01,Humboldt,023,135768,18537,18371,3611,21982,147
2022-06-01,Imperial,025,180216,56812,56445,10931,67376,938
2022-06-01,Inyo,027,18085,4194,4171,569,4740,56
2022-06-01,Kern,029,883053,196433,195438,47822,243260,2336
2022-06-01,Kings,031,150075,52681,52491,3577,56068,447
2022-06-01,Lake,033,64148,11126,11024,943,11967,137
2022-06-01,Lassen,035,31185,9116,9083,896,9979,64
2022-06-01,Los Angeles,037,10098052,2862856,2836856,135122,2971978,31882
2022-06-01,Madera,039,155013,38338,38115,6441,44556,372
2022-06-01,Marin,041,260295,38166,37654,4065,41719,293
2022-06-01,Mariposa,043,17540,2598,2549,240,2789,30
2022-06-01,Mendocino,045,87422,13836,13692,3480,17172,125
2022-06-01,Merced,047,269075,64000,63637,9244,72881,824
2022-06-01,Modoc,049,8938,758,755,259,1014,8
2022-06-01,Mono,051,14174,3043,3035,162,3197,6
2022-06-01,Monterey,053,433212,82906,82215,15747,97962,737
2022-06-01,Napa,055,140530,27905,27580,1162,28742,143
2022-06-01,Nevada,057,99092,16860,16693,1349,18042,127
2022-06-01,Orange,059,3164182,576337,571973,45761,617734,7032
2022-06-01,Placer,061,380077,66850,66199,8018,74217,627
2022-06-01,Plumas,063,18699,3146,3117,383,3500,13
2022-06-01,Riverside,065,2383286,612506,608913,29409,638322,6480
2022-06-01,Sacramento,067,1510023,299415,296457,28953,325410,3045
2022-06-01,San Benito,069,59416,13634,13510,620,14130,98
2022-06-01,San Bernardino,071,2135413,587414,580767,25590,606357,7641
2022-06-01,San Diego,073,3302833,796411,791557,57671,849228,5292
2022-06-01,San Francisco,075,870044,147219,144476,9627,154103,879
2022-06-01,San Joaquin,077,732212,173562,172170,11119,183289,2241
2022-06-01,San Luis Obispo,079,281455,55641,55099,4705,59804,482
2022-06-01,San Mateo,081,765935,139729,137566,8698,146264,710
2022-06-01,Santa Barbara,083,443738,91402,90531,5217,95748,693
2022-06-01,Santa Clara,085,1922200,354522,348742,14978,363720,2317
2022-06-01,Santa Cruz,087,273765,52648,52141,2498,54639,263
2022-06-01,Shasta,089,179085,31377,31247,6247,37494,564
2022-06-01,Sierra,091,2930,278,280,56,336,4
2022-06-01,Siskiyou,093,43540,4608,4574,2831,7405,81
2022-06-01,Solano,095,438530,88609,87206,6208,93414,452
2022-06-01,Sonoma,097,501317,92253,91174,3740,94914,491
2022-06-01,Stanislaus,099,539301,121548,120778,18321,139099,1656
2022-06-01,Sutter,101,95872,21150,21065,2211,23276,227
2022-06-01,Tehama,103,63373,12288,12245,2665,14910,204
2022-06-01,Trinity,105,12862,1207,1200,290,1490,20
2022-06-01,Tulare,107,460477,108755,108401,28995,137396,1490
2022-06-01,Tuolumne,109,53932,13334,13221,629,13850,189
2022-06-01,Ventura,111,848112,182504,181163,10854,192017,1503
2022-06-01,Yolo,113,214977,41098,39371,3379,42750,320
2022-06-01,Yuba,115,75493,16510,16406,1342,17748,122
2022-05-31,Alameda,001,1643700,287156,284051,16027,300078,1868
2022-05-31,Alpine,003,1148,128,128,1,129,0
2022-05-31,Amador,005,37829,8850,8741,698,9439,87
2022-05-31,Butte,007,227075,34345,34059,7429,41488,427
2022-05-31,Calaveras,009,45235,7545,7502,389,7891,120
2022-05-31,Colusa,011,21464,3489,3476,1076,4552,21
2022-05-31,Contra Costa,013,1133247,208825,205699,15465,221164,1310
2022-05-31,Del Norte,015,27424,6236,6188,250,6438,51
2022-05-31,El Dorado,017,186661,28346,28133,3468,31601,214
2022-05-31,Fresno,019,978130,238251,237367,24685,262052,2765
2022-05-31,Glenn,021,27897,5080,5059,1652,6711,48
2022-05-31,Humboldt,023,135768,18506,18371,3591,21962,147
2022-05-31,Imperial,025,180216,56748,56445,10907,67352,938
2022-05-31,Inyo,027,18085,4188,4171,567,4738,56
2022-05-31,Kern,029,883053,196190,195438,47728,243166,2336
2022-05-31,Kings,031,150075,52630,52491,3570,56061,447
2022-05-31,Lake,033,64148,11107,11024,939,11963,137
2022-05-31,Lassen,035,31185,9104,9083,895,9978,64
2022-05-31,Los Angeles,037,10098052,2856787,2836856,134657,2971513,31882
2022-05-31,Madera,039,155013,38273,38115,6422,44537,372
2022-05-31,Marin,041,260295,38028,37654,4029,41683,293
2022-05-31,Mariposa,043,17540,2592,2549,235,2784,30
2022-05-31,Mendocino,045,87422,13801,13692,3463,17155,125
2022-05-31,Merced,047,269075,63913,63637,9221,72858,824
2022-05-31,Modoc,049,8938,756,755,259,1014,8
2022-05-31,Mono,051,14174,3039,3035,162,3197,6
2022-05-31,Monterey,053,433212,82748,82215,15681,97896,737
2022-05-31,Napa,055,140530,27813,27580,1159,28739,143
2022-05-31,Nevada,057,99092,16814,16693,1347,18040,127
2022-05-31,Orange,059,3164182,575108,571973,45580,617553,7032
2022-05-31,Placer,061,380077,66690,66199,7987,74186,627
2022-05-31,Plumas,063,18699,3142,3117,382,3499,13
2022-05-31,Riverside,065,2383286,611590,608913,29347,638260,6480
2022-05-31,Sacramento,067,1510023,298553,296457,28813,325270,3045
2022-05-31,San Benito,069,59416,13578,13510,615,14125,98
2022-05-31,San Bernardino,071,2135413,586526,580767,25555,606322,7641
2022-05-31,San Diego,073,3302833,794532,791557,57470,849027,5292
2022-05-31,San Francisco,075,870044,146573,144476,9585,154061,879
2022-05-31,San Joaquin,077,732212,173183,172170,11080,183250,2241
2022-05-31,San Luis Obispo,079,281455,55491,55099,4641,59740,482
2022-05-31,San Mateo,081,765935,139172,137566,8656,146222,710
2022-05-31,Santa Barbara,083,443738,91178,90531,5194,95725,693
2022-05-31,Santa Clara,085,1922200,353009,348742,14901,363643,2317
2022-05-31,Santa Cruz,087,273765,52528,52141,2478,54619,263
2022-05-31,Shasta,089,179085,31343,31247,6236,37483,564
2022-05-31,Sierra,091,2930,277,280,55,335,4
2022-05-31,Siskiyou,093,43540,4603,4574,2825,7399,81
2022-05-31,Solano,095,438530,88280,87206,6186,93392,452
2022-05-31,Sonoma,097,501317,91965,91174,3700,94874,491
2022-05-31,Stanislaus,099,539301,121343,120778,18299,139077,1656
2022-05-31,Sutter,101,95872,21121,21065,2205,23270,227
2022-05-31,Tehama,103,63373,12279,12245,2660,14905,204
2022-05-31,Trinity,105,12862,1206,1200,290,1490,20
2022-05-31,Tulare,107,460477,108617,108401,28936,137337,1490
2022-05-31,Tuolumne,109,53932,13319,13221,626,13847,189
2022-05-31,Ventura,111,848112,182184,181163,10806,191969,1503
2022-05-31,Yolo,113,214977,40924,39371,3368,42739,320
2022-05-31,Yuba,115,75493,16478,16406,1336,17742,122
2022-05-30,Alameda,001,1643700,285777,284051,15938,299989,1868
2022-05-30,Alpine,003,1148,128,128,1,129,0
2022-05-30,Amador,005,37829,8835,8741,697,9438,87
2022-05-30,Butte,007,227075,34270,34059,7406,41465,427
2022-05-30,Calaveras,009,45235,7536,7502,389,7891,120
2022-05-30,Colusa,011,21464,3487,3476,1075,4551,21
2022-05-30,Contra Costa,013,1133247,207983,205699,15329,221028,1310
2022-05-30,Del Norte,015,27424,6219,6188,249,6437,51
2022-05-30,El Dorado,017,186661,28270,28133,3448,31581,214
2022-05-30,Fresno,019,978130,237781,237367,24614,261981,2765
2022-05-30,Glenn,021,27897,5075,5059,1649,6708,48
2022-05-30,Humboldt,023,135768,18451,18371,3563,21934,147
2022-05-30,Imperial,025,180216,56665,56445,10880,67325,938
2022-05-30,Inyo,027,18085,4183,4171,566,4737,56
2022-05-30,Kern,029,883053,195909,195438,47614,243052,2336
2022-05-30,Kings,031,150075,52534,52491,3570,56061,447
2022-05-30,Lake,033,64148,11078,11024,930,11954,137
2022-05-30,Lassen,035,31185,9090,9083,892,9975,64
2022-05-30,Los Angeles,037,10098052,2849460,2836856,134154,2971010,31882
2022-05-30,Madera,039,155013,38218,38115,6381,44496,372
2022-05-30,Marin,041,260295,37903,37654,3987,41641,293
2022-05-30,Mariposa,043,17540,2569,2549,231,2780,30
2022-05-30,Mendocino,045,87422,13753,13692,3445,17137,125
2022-05-30,Merced,047,269075,63819,63637,9182,72819,824
2022-05-30,Modoc,049,8938,753,755,257,1012,8
2022-05-30,Mono,051,14174,3036,3035,162,3197,6
2022-05-30,Monterey,053,433212,82560,82215,15593,97808,737
2022-05-30,Napa,055,140530,27736,27580,1151,28731,143
2022-05-30,Nevada,057,99092,16767,16693,1342,18035,127
2022-05-30,Orange,059,3164182,573642,571973,45368,617341,7032
2022-05-30,Placer,061,380077,66550,66199,7957,74156,627
2022-05-30,Plumas,063,18699,3136,3117,379,3496,13
2022-05-30,Riverside,065,2383286,610578,608913,29269,638182,6480
2022-05-30,Sacramento,067,1510023,297597,296457,28654,325111,3045
2022-05-30,San Benito,069,59416,13516,13510,607,14117,98
2022-05-30,San Bernardino,071,2135413,585534,580767,25519,606286,7641
2022-05-30,San Diego,073,3302833,792259,791557,57178,848735,5292
2022-05-30,San Francisco,075,870044,145909,144476,9532,154008,879
2022-05-30,San Joaquin,077,732212,172786,172170,11042,183212,2241
2022-05-30,San Luis Obispo,079,281455,55287,55099,4572,59671,482
2022-05-30,San Mateo,081,765935,138496,137566,8604,146170,710
2022-05-30,Santa Barbara,083,443738,90922,90531,5160,95691,693
2022-05-30,Santa Clara,085,1922200,351453,348742,14810,363552,2317
2022-05-30,Santa Cruz,087,273765,52390,52141,2468,54609,263
2022-05-30,Shasta,089,179085,31305,31247,6229,37476,564
2022-05-30,Sierra,091,2930,277,280,55,335,4
2022-05-30,Siskiyou,093,43540,4594,4574,2813,7387,81
2022-05-30,Solano,095,438530,87936,87206,6133,93339,452
2022-05-30,Sonoma,097,501317,91680,91174,3656,94830,491
2022-05-30,Stanislaus,099,539301,121151,120778,18271,139049,1656
2022-05-30,Sutter,101,95872,21082,21065,2199,23264,227
2022-05-30,Tehama,103,63373,12263,12245,2656,14901,204
2022-05-30,Trinity,105,12862,1205,1200,290,1490,20
2022-05-30,Tulare,107,460477,108456,108401,28847,137248,1490
2022-05-30,Tuolumne,109,53932,13295,13221,622,13843,189
2022-05-30,Ventura,111,848112,181811,181163,10756,191919,1503
2022-05-30,Yolo,113,214977,40733,39371,3359,42730,320
2022-05-30,Yuba,115,75493,16450,16406,1332,17738,122
2022-05-29,Alameda,001,1643700,285298,280775,15914,296689,1863
2022-05-29,Alpine,003,1148,128,126,1,127,0
2022-05-29,Amador,005,37829,8830,8696,694,9390,86
2022-05-29,Butte,007,227075,34254,33876,7399,41275,426
2022-05-29,Calaveras,009,45235,7525,7469,389,7858,120
2022-05-29,Colusa,011,21464,3486,3474,1074,4548,21
2022-05-29,Contra Costa,013,1133247,207639,203528,15304,218832,1306
2022-05-29,Del Norte,015,27424,6217,6166,248,6414,51
2022-05-29,El Dorado,017,186661,28243,27898,3445,31343,214
2022-05-29,Fresno,019,978130,237655,236250,24595,260845,2764
2022-05-29,Glenn,021,27897,5070,5048,1649,6697,48
2022-05-29,Humboldt,023,135768,18430,18257,3552,21809,147
2022-05-29,Imperial,025,180216,56628,56323,10866,67189,939
2022-05-29,Inyo,027,18085,4182,4161,566,4727,56
2022-05-29,Kern,029,883053,195810,194687,47550,242237,2334
2022-05-29,Kings,031,150075,52508,52292,3570,55862,447
2022-05-29,Lake,033,64148,11069,10958,928,11886,137
2022-05-29,Lassen,035,31185,9086,9049,892,9941,64
2022-05-29,Los Angeles,037,10098052,2847263,2819145,133887,2953032,31862
2022-05-29,Madera,039,155013,38196,37955,6376,44331,371
2022-05-29,Marin,041,260295,37835,37215,3955,41170,293
2022-05-29,Mariposa,043,17540,2564,2526,231,2757,31
2022-05-29,Mendocino,045,87422,13733,13612,3444,17056,124
2022-05-29,Merced,047,269075,63798,63389,9179,72568,824
2022-05-29,Modoc,049,8938,753,751,257,1008,8
2022-05-29,Mono,051,14174,3035,3030,162,3192,6
2022-05-29,Monterey,053,433212,82496,81875,15549,97424,737
2022-05-29,Napa,055,140530,27708,27376,1150,28526,144
2022-05-29,Nevada,057,99092,16752,16568,1340,17908,127
2022-05-29,Orange,059,3164182,573066,568369,45196,613565,7028
2022-05-29,Placer,061,380077,66480,65672,7948,73620,626
2022-05-29,Plumas,063,18699,3129,3096,379,3475,13
2022-05-29,Riverside,065,2383286,610235,606444,29234,635678,6480
2022-05-29,Sacramento,067,1510023,297144,294000,28632,322632,3032
2022-05-29,San Benito,069,59416,13510,13402,605,14007,98
2022-05-29,San Bernardino,071,2135413,585246,578656,25503,604159,7610
2022-05-29,San Diego,073,3302833,791521,786243,57100,843343,5288
2022-05-29,San Francisco,075,870044,145480,142456,9523,151979,879
2022-05-29,San Joaquin,077,732212,172624,171282,11024,182306,2241
2022-05-29,San Luis Obispo,079,281455,55235,54701,4560,59261,481
2022-05-29,San Mateo,081,765935,138246,135746,8591,144337,710
2022-05-29,Santa Barbara,083,443738,90793,89940,5159,95099,693
2022-05-29,Santa Clara,085,1922200,350656,344223,14771,358994,2304
2022-05-29,Santa Cruz,087,273765,52314,51819,2461,54280,263
2022-05-29,Shasta,089,179085,31293,31165,6225,37390,564
2022-05-29,Sierra,091,2930,277,278,55,333,4
2022-05-29,Siskiyou,093,43540,4589,4537,2811,7348,81
2022-05-29,Solano,095,438530,87883,86565,6122,92687,452
2022-05-29,Sonoma,097,501317,91588,90364,3641,94005,490
2022-05-29,Stanislaus,099,539301,121052,120241,18255,138496,1657
2022-05-29,Sutter,101,95872,21062,20976,2199,23175,227
2022-05-29,Tehama,103,63373,12252,12210,2655,14865,204
2022-05-29,Trinity,105,12862,1204,1196,290,1486,20
2022-05-29,Tulare,107,460477,108375,108029,28802,136831,1484
2022-05-29,Tuolumne,109,53932,13280,13141,622,13763,189
2022-05-29,Ventura,111,848112,181666,179953,10747,190700,1503
2022-05-29,Yolo,113,214977,40683,39016,3356,42372,319
2022-05-29,Yuba,115,75493,16434,16314,1328,17642,122
2022-05-28,Alameda,001,1643700,284924,280775,15888,296663,1863
2022-05-28,Alpine,003,1148,128,126,1,127,0
2022-05-28,Amador,005,37829,8821,8696,694,9390,86
2022-05-28,Butte,007,227075,34231,33876,7383,41259,426
2022-05-28,Calaveras,009,45235,7521,7469,389,7858,120
2022-05-28,Colusa,011,21464,3481,3474,1073,4547,21
2022-05-28,Contra Costa,013,1133247,207374,203528,15278,218806,1306
2022-05-28,Del Norte,015,27424,6214,6166,246,6412,51
2022-05-28,El Dorado,017,186661,28213,27898,3444,31342,214
2022-05-28,Fresno,019,978130,237498,236250,24564,260814,2764
2022-05-28,Glenn,021,27897,5067,5048,1649,6697,48
2022-05-28,Humboldt,023,135768,18406,18257,3542,21799,147
2022-05-28,Imperial,025,180216,56602,56323,10856,67179,939
2022-05-28,Inyo,027,18085,4182,4161,564,4725,56
2022-05-28,Kern,029,883053,195710,194687,47499,242186,2334
2022-05-28,Kings,031,150075,52484,52292,3569,55861,447
2022-05-28,Lake,033,64148,11059,10958,928,11886,137
2022-05-28,Lassen,035,31185,9081,9049,892,9941,64
2022-05-28,Los Angeles,037,10098052,2845283,2819145,133620,2952765,31862
2022-05-28,Madera,039,155013,38179,37955,6373,44328,371
2022-05-28,Marin,041,260295,37768,37215,3925,41140,293
2022-05-28,Mariposa,043,17540,2560,2526,231,2757,31
2022-05-28,Mendocino,045,87422,13721,13612,3444,17056,124
2022-05-28,Merced,047,269075,63767,63389,9172,72561,824
2022-05-28,Modoc,049,8938,753,751,257,1008,8
2022-05-28,Mono,051,14174,3035,3030,161,3191,6
2022-05-28,Monterey,053,433212,82429,81875,15517,97392,737
2022-05-28,Napa,055,140530,27663,27376,1149,28525,144
2022-05-28,Nevada,057,99092,16740,16568,1338,17906,127
2022-05-28,Orange,059,3164182,572551,568369,45078,613447,7028
2022-05-28,Placer,061,380077,66406,65672,7934,73606,626
2022-05-28,Plumas,063,18699,3123,3096,378,3474,13
2022-05-28,Riverside,065,2383286,609856,606444,29206,635650,6480
2022-05-28,Sacramento,067,1510023,296871,294000,28615,322615,3032
2022-05-28,San Benito,069,59416,13495,13402,605,14007,98
2022-05-28,San Bernardino,071,2135413,584880,578656,25476,604132,7610
2022-05-28,San Diego,073,3302833,790862,786243,57053,843296,5288
2022-05-28,San Francisco,075,870044,145175,142456,9502,151958,879
2022-05-28,San Joaquin,077,732212,172520,171282,11008,182290,2241
2022-05-28,San Luis Obispo,079,281455,55200,54701,4557,59258,481
2022-05-28,San Mateo,081,765935,137972,135746,8564,144310,710
2022-05-28,Santa Barbara,083,443738,90693,89940,5149,95089,693
2022-05-28,Santa Clara,085,1922200,349868,344223,14744,358967,2304
2022-05-28,Santa Cruz,087,273765,52273,51819,2452,54271,263
2022-05-28,Shasta,089,179085,31282,31165,6220,37385,564
2022-05-28,Sierra,091,2930,277,278,54,332,4
2022-05-28,Siskiyou,093,43540,4581,4537,2807,7344,81
2022-05-28,Solano,095,438530,87810,86565,6112,92677,452
2022-05-28,Sonoma,097,501317,91447,90364,3630,93994,490
2022-05-28,Stanislaus,099,539301,120953,120241,18249,138490,1657
2022-05-28,Sutter,101,95872,21047,20976,2197,23173,227
2022-05-28,Tehama,103,63373,12240,12210,2652,14862,204
2022-05-28,Trinity,105,12862,1203,1196,290,1486,20
2022-05-28,Tulare,107,460477,108317,108029,28769,136798,1484
2022-05-28,Tuolumne,109,53932,13265,13141,621,13762,189
2022-05-28,Ventura,111,848112,181499,179953,10727,190680,1503
2022-05-28,Yolo,113,214977,40629,39016,3349,42365,319
2022-05-28,Yuba,115,75493,16420,16314,1326,17640,122
2022-05-27,Alameda,001,1643700,284453,280775,15851,296626,1863
2022-05-27,Alpine,003,1148,127,126,1,127,0
2022-05-27,Amador,005,37829,8816,8696,694,9390,86
2022-05-27,Butte,007,227075,34204,33876,7367,41243,426
2022-05-27,Calaveras,009,45235,7514,7469,389,7858,120
2022-05-27,Colusa,011,21464,3481,3474,1073,4547,21
2022-05-27,Contra Costa,013,1133247,207093,203528,15246,218774,1306
2022-05-27,Del Norte,015,27424,6208,6166,246,6412,51
2022-05-27,El Dorado,017,186661,28189,27898,3436,31334,214
2022-05-27,Fresno,019,978130,237326,236250,24532,260782,2764
2022-05-27,Glenn,021,27897,5065,5048,1648,6696,48
2022-05-27,Humboldt,023,135768,18396,18257,3535,21792,147
2022-05-27,Imperial,025,180216,56519,56323,10851,67174,939
2022-05-27,Inyo,027,18085,4180,4161,563,4724,56
2022-05-27,Kern,029,883053,195601,194687,47432,242119,2334
2022-05-27,Kings,031,150075,52456,52292,3566,55858,447
2022-05-27,Lake,033,64148,11053,10958,926,11884,137
2022-05-27,Lassen,035,31185,9077,9049,892,9941,64
2022-05-27,Los Angeles,037,10098052,2842933,2819145,133373,2952518,31862
2022-05-27,Madera,039,155013,38145,37955,6364,44319,371
2022-05-27,Marin,041,260295,37703,37215,3891,41106,293
2022-05-27,Mariposa,043,17540,2554,2526,231,2757,31
2022-05-27,Mendocino,045,87422,13704,13612,3440,17052,124
2022-05-27,Merced,047,269075,63724,63389,9168,72557,824
2022-05-27,Modoc,049,8938,753,751,257,1008,8
2022-05-27,Mono,051,14174,3034,3030,161,3191,6
2022-05-27,Monterey,053,433212,82370,81875,15471,97346,737
2022-05-27,Napa,055,140530,27631,27376,1146,28522,144
2022-05-27,Nevada,057,99092,16729,16568,1334,17902,127
2022-05-27,Orange,059,3164182,571994,568369,44969,613338,7028
2022-05-27,Placer,061,380077,66337,65672,7924,73596,626
2022-05-27,Plumas,063,18699,3120,3096,378,3474,13
2022-05-27,Riverside,065,2383286,609444,606444,29174,635618,6480
2022-05-27,Sacramento,067,1510023,296492,294000,28577,322577,3032
2022-05-27,San Benito,069,59416,13484,13402,605,14007,98
2022-05-27,San Bernardino,071,2135413,584542,578656,25452,604108,7610
2022-05-27,San Diego,073,3302833,789984,786243,56962,843205,5288
2022-05-27,San Francisco,075,870044,144843,142456,9462,151918,879
2022-05-27,San Joaquin,077,732212,172390,171282,10989,182271,2241
2022-05-27,San Luis Obispo,079,281455,55139,54701,4542,59243,481
2022-05-27,San Mateo,081,765935,137723,135746,8539,144285,710
2022-05-27,Santa Barbara,083,443738,90603,89940,5148,95088,693
2022-05-27,Santa Clara,085,1922200,349114,344223,14726,358949,2304
2022-05-27,Santa Cruz,087,273765,52218,51819,2440,54259,263
2022-05-27,Shasta,089,179085,31272,31165,6214,37379,564
2022-05-27,Sierra,091,2930,277,278,54,332,4
2022-05-27,Siskiyou,093,43540,4578,4537,2805,7342,81
2022-05-27,Solano,095,438530,87684,86565,6101,92666,452
2022-05-27,Sonoma,097,501317,91300,90364,3618,93982,490
2022-05-27,Stanislaus,099,539301,120870,120241,18235,138476,1657
2022-05-27,Sutter,101,95872,21030,20976,2196,23172,227
2022-05-27,Tehama,103,63373,12237,12210,2651,14861,204
2022-05-27,Trinity,105,12862,1203,1196,290,1486,20
2022-05-27,Tulare,107,460477,108250,108029,28732,136761,1484
2022-05-27,Tuolumne,109,53932,13255,13141,620,13761,189
2022-05-27,Ventura,111,848112,181323,179953,10703,190656,1503
2022-05-27,Yolo,113,214977,40558,39016,3341,42357,319
2022-05-27,Yuba,115,75493,16406,16314,1325,17639,122
2022-05-26,Alameda,001,1643700,283603,280775,15771,296546,1863
2022-05-26,Alpine,003,1148,127,126,1,127,0
2022-05-26,Amador,005,37829,8803,8696,694,9390,86
2022-05-26,Butte,007,227075,34150,33876,7345,41221,426
2022-05-26,Calaveras,009,45235,7504,7469,389,7858,120
2022-05-26,Colusa,011,21464,3478,3474,1070,4544,21
2022-05-26,Contra Costa,013,1133247,206615,203528,15170,218698,1306
2022-05-26,Del Norte,015,27424,6200,6166,242,6408,51
2022-05-26,El Dorado,017,186661,28140,27898,3425,31323,214
2022-05-26,Fresno,019,978130,237070,236250,24478,260728,2764
2022-05-26,Glenn,021,27897,5060,5048,1648,6696,48
2022-05-26,Humboldt,023,135768,18355,18257,3522,21779,147
2022-05-26,Imperial,025,180216,56486,56323,10836,67159,939
2022-05-26,Inyo,027,18085,4179,4161,560,4721,56
2022-05-26,Kern,029,883053,195437,194687,47358,242045,2334
2022-05-26,Kings,031,150075,52410,52292,3563,55855,447
2022-05-26,Lake,033,64148,11038,10958,926,11884,137
2022-05-26,Lassen,035,31185,9068,9049,892,9941,64
2022-05-26,Los Angeles,037,10098052,2838769,2819145,133039,2952184,31862
2022-05-26,Madera,039,155013,38103,37955,6353,44308,371
2022-05-26,Marin,041,260295,37608,37215,3850,41065,293
2022-05-26,Mariposa,043,17540,2549,2526,229,2755,31
2022-05-26,Mendocino,045,87422,13678,13612,3431,17043,124
2022-05-26,Merced,047,269075,63659,63389,9158,72547,824
2022-05-26,Modoc,049,8938,752,751,257,1008,8
2022-05-26,Mono,051,14174,3033,3030,160,3190,6
2022-05-26,Monterey,053,433212,82291,81875,15417,97292,737
2022-05-26,Napa,055,140530,27579,27376,1144,28520,144
2022-05-26,Nevada,057,99092,16698,16568,1325,17893,127
2022-05-26,Orange,059,3164182,571088,568369,44850,613219,7028
2022-05-26,Placer,061,380077,66201,65672,7904,73576,626
2022-05-26,Plumas,063,18699,3116,3096,377,3473,13
2022-05-26,Riverside,065,2383286,608829,606444,29121,635565,6480
2022-05-26,Sacramento,067,1510023,295837,294000,28489,322489,3032
2022-05-26,San Benito,069,59416,13468,13402,603,14005,98
2022-05-26,San Bernardino,071,2135413,584001,578656,25437,604093,7610
2022-05-26,San Diego,073,3302833,788681,786243,56820,843063,5288
2022-05-26,San Francisco,075,870044,144385,142456,9416,151872,879
2022-05-26,San Joaquin,077,732212,172170,171282,10963,182245,2241
2022-05-26,San Luis Obispo,079,281455,55043,54701,4508,59209,481
2022-05-26,San Mateo,081,765935,137336,135746,8501,144247,710
2022-05-26,Santa Barbara,083,443738,90457,89940,5128,95068,693
2022-05-26,Santa Clara,085,1922200,348143,344223,14638,358861,2304
2022-05-26,Santa Cruz,087,273765,52127,51819,2432,54251,263
2022-05-26,Shasta,089,179085,31246,31165,6211,37376,564
2022-05-26,Sierra,091,2930,277,278,54,332,4
2022-05-26,Siskiyou,093,43540,4574,4537,2803,7340,81
2022-05-26,Solano,095,438530,87484,86565,6094,92659,452
2022-05-26,Sonoma,097,501317,91109,90364,3590,93954,490
2022-05-26,Stanislaus,099,539301,120766,120241,18218,138459,1657
2022-05-26,Sutter,101,95872,21010,20976,2192,23168,227
2022-05-26,Tehama,103,63373,12227,12210,2650,14860,204
2022-05-26,Trinity,105,12862,1201,1196,290,1486,20
2022-05-26,Tulare,107,460477,108181,108029,28676,136705,1484
2022-05-26,Tuolumne,109,53932,13234,13141,616,13757,189
2022-05-26,Ventura,111,848112,181058,179953,10666,190619,1503
2022-05-26,Yolo,113,214977,40453,39016,3332,42348,319
2022-05-26,Yuba,115,75493,16390,16314,1323,17637,122
2022-05-25,Alameda,001,1643700,282700,278228,15708,293936,1860
2022-05-25,Alpine,003,1148,126,126,1,127,0
2022-05-25,Amador,005,37829,8787,8654,692,9346,86
2022-05-25,Butte,007,227075,34087,33755,7321,41076,426
2022-05-25,Calaveras,009,45235,7496,7450,387,7837,120
2022-05-25,Colusa,011,21464,3477,3471,1068,4539,21
2022-05-25,Contra Costa,013,1133247,206064,201866,15097,216963,1306
2022-05-25,Del Norte,015,27424,6194,6145,236,6381,50
2022-05-25,El Dorado,017,186661,28087,27715,3416,31131,213
2022-05-25,Fresno,019,978130,236787,235569,24424,259993,2763
2022-05-25,Glenn,021,27897,5055,5030,1646,6676,48
2022-05-25,Humboldt,023,135768,18328,18133,3501,21634,147
2022-05-25,Imperial,025,180216,56429,56203,10825,67028,923
2022-05-25,Inyo,027,18085,4176,4152,560,4712,56
2022-05-25,Kern,029,883053,195244,194251,47270,241521,2336
2022-05-25,Kings,031,150075,52356,52178,3559,55737,447
2022-05-25,Lake,033,64148,11025,10908,925,11833,137
2022-05-25,Lassen,035,31185,9061,9028,892,9920,64
2022-05-25,Los Angeles,037,10098052,2834149,2806770,132674,2939444,31845
2022-05-25,Madera,039,155013,38064,37867,6340,44207,370
2022-05-25,Marin,041,260295,37508,36890,3822,40712,293
2022-05-25,Mariposa,043,17540,2539,2514,227,2741,30
2022-05-25,Mendocino,045,87422,13663,13545,3425,16970,124
2022-05-25,Merced,047,269075,63592,63220,9128,72348,823
2022-05-25,Modoc,049,8938,751,750,256,1006,8
2022-05-25,Mono,051,14174,3033,3024,159,3183,6
2022-05-25,Monterey,053,433212,82225,81592,15373,96965,737
2022-05-25,Napa,055,140530,27529,27240,1138,28378,143
2022-05-25,Nevada,057,99092,16663,16517,1319,17836,127
2022-05-25,Orange,059,3164182,570079,565564,44697,610261,7026
2022-05-25,Placer,061,380077,66050,65309,7883,73192,626
2022-05-25,Plumas,063,18699,3110,3065,376,3441,13
2022-05-25,Riverside,065,2383286,608153,604465,29069,633534,6480
2022-05-25,Sacramento,067,1510023,295194,292211,28380,320591,3028
2022-05-25,San Benito,069,59416,13433,13338,596,13934,98
2022-05-25,San Bernardino,071,2135413,583463,576982,25411,602393,7568
2022-05-25,San Diego,073,3302833,787214,782420,56638,839058,5284
2022-05-25,San Francisco,075,870044,143884,141015,9389,150404,872
2022-05-25,San Joaquin,077,732212,171933,170626,10943,181569,2238
2022-05-25,San Luis Obispo,079,281455,54937,54342,4454,58796,481
2022-05-25,San Mateo,081,765935,136878,134441,8435,142876,710
2022-05-25,Santa Barbara,083,443738,90290,89426,5113,94539,693
2022-05-25,Santa Clara,085,1922200,347073,340868,14531,355399,2304
2022-05-25,Santa Cruz,087,273765,52045,51644,2417,54061,263
2022-05-25,Shasta,089,179085,31219,31072,6202,37274,564
2022-05-25,Sierra,091,2930,277,277,54,331,4
2022-05-25,Siskiyou,093,43540,4564,4516,2800,7316,81
2022-05-25,Solano,095,438530,87275,86024,6077,92101,451
2022-05-25,Sonoma,097,501317,90916,89810,3552,93362,490
2022-05-25,Stanislaus,099,539301,120628,119894,18196,138090,1654
2022-05-25,Sutter,101,95872,20986,20904,2188,23092,226
2022-05-25,Tehama,103,63373,12221,12189,2646,14835,201
2022-05-25,Trinity,105,12862,1201,1194,290,1484,20
2022-05-25,Tulare,107,460477,108100,107790,28633,136423,1482
2022-05-25,Tuolumne,109,53932,13213,13086,613,13699,182
2022-05-25,Ventura,111,848112,180765,179116,10630,189746,1499
2022-05-25,Yolo,113,214977,40358,38782,3322,42104,319
2022-05-25,Yuba,115,75493,16363,16260,1317,17577,122
2022-05-24,Alameda,001,1643700,281825,278228,15649,293877,1860
2022-05-24,Alpine,003,1148,126,126,1,127,0
2022-05-24,Amador,005,37829,8780,8654,688,9342,86
2022-05-24,Butte,007,227075,34042,33755,7299,41054,426
2022-05-24,Calaveras,009,45235,7489,7450,385,7835,120
2022-05-24,Colusa,011,21464,3475,3471,1066,4537,21
2022-05-24,Contra Costa,013,1133247,205414,201866,14996,216862,1306
2022-05-24,Del Norte,015,27424,6189,6145,234,6379,50
2022-05-24,El Dorado,017,186661,28019,27715,3409,31124,213
2022-05-24,Fresno,019,978130,236470,235569,24388,259957,2763
2022-05-24,Glenn,021,27897,5053,5030,1646,6676,48
2022-05-24,Humboldt,023,135768,18296,18133,3483,21616,147
2022-05-24,Imperial,025,180216,56375,56203,10812,67015,923
2022-05-24,Inyo,027,18085,4168,4152,557,4709,56
2022-05-24,Kern,029,883053,195050,194251,47164,241415,2336
2022-05-24,Kings,031,150075,52288,52178,3554,55732,447
2022-05-24,Lake,033,64148,11008,10908,923,11831,137
2022-05-24,Lassen,035,31185,9048,9028,888,9916,64
2022-05-24,Los Angeles,037,10098052,2828867,2806770,132289,2939059,31845
2022-05-24,Madera,039,155013,38015,37867,6325,44192,370
2022-05-24,Marin,041,260295,37402,36890,3771,40661,293
2022-05-24,Mariposa,043,17540,2532,2514,225,2739,30
2022-05-24,Mendocino,045,87422,13639,13545,3415,16960,124
2022-05-24,Merced,047,269075,63531,63220,9096,72316,823
2022-05-24,Modoc,049,8938,750,750,255,1005,8
2022-05-24,Mono,051,14174,3030,3024,159,3183,6
2022-05-24,Monterey,053,433212,82134,81592,15312,96904,737
2022-05-24,Napa,055,140530,27481,27240,1126,28366,143
2022-05-24,Nevada,057,99092,16621,16517,1312,17829,127
2022-05-24,Orange,059,3164182,569050,565564,44533,610097,7026
2022-05-24,Placer,061,380077,65950,65309,7867,73176,626
2022-05-24,Plumas,063,18699,3104,3065,376,3441,13
2022-05-24,Riverside,065,2383286,607458,604465,29020,633485,6480
2022-05-24,Sacramento,067,1510023,294509,292211,28259,320470,3028
2022-05-24,San Benito,069,59416,13399,13338,593,13931,98
2022-05-24,San Bernardino,071,2135413,582844,576982,25382,602364,7568
2022-05-24,San Diego,073,3302833,785561,782420,56433,838853,5284
2022-05-24,San Francisco,075,870044,143340,141015,9361,150376,872
2022-05-24,San Joaquin,077,732212,171670,170626,10913,181539,2238
2022-05-24,San Luis Obispo,079,281455,54787,54342,4399,58741,481
2022-05-24,San Mateo,081,765935,136347,134441,8380,142821,710
2022-05-24,Santa Barbara,083,443738,90128,89426,5086,94512,693
2022-05-24,Santa Clara,085,1922200,345789,340868,14438,355306,2304
2022-05-24,Santa Cruz,087,273765,51970,51644,2407,54051,263
2022-05-24,Shasta,089,179085,31194,31072,6190,37262,564
2022-05-24,Sierra,091,2930,277,277,54,331,4
2022-05-24,Siskiyou,093,43540,4554,4516,2792,7308,81
2022-05-24,Solano,095,438530,87044,86024,6047,92071,451
2022-05-24,Sonoma,097,501317,90711,89810,3515,93325,490
2022-05-24,Stanislaus,099,539301,120490,119894,18161,138055,1654
2022-05-24,Sutter,101,95872,20965,20904,2184,23088,226
2022-05-24,Tehama,103,63373,12212,12189,2644,14833,201
2022-05-24,Trinity,105,12862,1198,1194,290,1484,20
2022-05-24,Tulare,107,460477,107983,107790,28579,136369,1482
2022-05-24,Tuolumne,109,53932,13198,13086,613,13699,182
2022-05-24,Ventura,111,848112,180449,179116,10581,189697,1499
2022-05-24,Yolo,113,214977,40254,38782,3317,42099,319
2022-05-24,Yuba,115,75493,16335,16260,1309,17569,122
2022-05-23,Alameda,001,1643700,280883,278228,15563,293791,1860
2022-05-23,Alpine,003,1148,126,126,1,127,0
2022-05-23,Amador,005,37829,8748,8654,685,9339,86
2022-05-23,Butte,007,227075,33991,33755,7272,41027,426
2022-05-23,Calaveras,009,45235,7482,7450,383,7833,120
2022-05-23,Colusa,011,21464,3474,3471,1064,4535,21
2022-05-23,Contra Costa,013,1133247,204680,201866,14912,216778,1306
2022-05-23,Del Norte,015,27424,6184,6145,230,6375,50
2022-05-23,El Dorado,017,186661,27937,27715,3400,31115,213
2022-05-23,Fresno,019,978130,236123,235569,24321,259890,2763
2022-05-23,Glenn,021,27897,5049,5030,1642,6672,48
2022-05-23,Humboldt,023,135768,18269,18133,3460,21593,147
2022-05-23,Imperial,025,180216,56329,56203,10792,66995,923
2022-05-23,Inyo,027,18085,4165,4152,556,4708,56
2022-05-23,Kern,029,883053,194832,194251,47078,241329,2336
2022-05-23,Kings,031,150075,52241,52178,3549,55727,447
2022-05-23,Lake,033,64148,10989,10908,921,11829,137
2022-05-23,Lassen,035,31185,9040,9028,885,9913,64
2022-05-23,Los Angeles,037,10098052,2823442,2806770,131921,2938691,31845
2022-05-23,Madera,039,155013,37984,37867,6302,44169,370
2022-05-23,Marin,041,260295,37261,36890,3726,40616,293
2022-05-23,Mariposa,043,17540,2530,2514,223,2737,30
2022-05-23,Mendocino,045,87422,13617,13545,3400,16945,124
2022-05-23,Merced,047,269075,63452,63220,9068,72288,823
2022-05-23,Modoc,049,8938,749,750,255,1005,8
2022-05-23,Mono,051,14174,3030,3024,159,3183,6
2022-05-23,Monterey,053,433212,82035,81592,15247,96839,737
2022-05-23,Napa,055,140530,27424,27240,1119,28359,143
2022-05-23,Nevada,057,99092,16586,16517,1309,17826,127
2022-05-23,Orange,059,3164182,568039,565564,44391,609955,7026
2022-05-23,Placer,061,380077,65805,65309,7834,73143,626
2022-05-23,Plumas,063,18699,3101,3065,375,3440,13
2022-05-23,Riverside,065,2383286,606733,604465,28967,633432,6480
2022-05-23,Sacramento,067,1510023,293759,292211,28136,320347,3028
2022-05-23,San Benito,069,59416,13364,13338,590,13928,98
2022-05-23,San Bernardino,071,2135413,582193,576982,25349,602331,7568
2022-05-23,San Diego,073,3302833,783841,782420,56220,838640,5284
2022-05-23,San Francisco,075,870044,142766,141015,9327,150342,872
2022-05-23,San Joaquin,077,732212,171400,170626,10882,181508,2238
2022-05-23,San Luis Obispo,079,281455,54641,54342,4349,58691,481
2022-05-23,San Mateo,081,765935,135778,134441,8329,142770,710
2022-05-23,Santa Barbara,083,443738,89893,89426,5062,94488,693
2022-05-23,Santa Clara,085,1922200,344416,340868,14350,355218,2304
2022-05-23,Santa Cruz,087,273765,51868,51644,2392,54036,263
2022-05-23,Shasta,089,179085,31171,31072,6184,37256,564
2022-05-23,Sierra,091,2930,277,277,54,331,4
2022-05-23,Siskiyou,093,43540,4540,4516,2788,7304,81
2022-05-23,Solano,095,438530,86772,86024,6027,92051,451
2022-05-23,Sonoma,097,501317,90481,89810,3468,93278,490
2022-05-23,Stanislaus,099,539301,120350,119894,18120,138014,1654
2022-05-23,Sutter,101,95872,20925,20904,2179,23083,226
2022-05-23,Tehama,103,63373,12200,12189,2643,14832,201
2022-05-23,Trinity,105,12862,1197,1194,290,1484,20
2022-05-23,Tulare,107,460477,107861,107790,28510,136300,1482
2022-05-23,Tuolumne,109,53932,13174,13086,609,13695,182
2022-05-23,Ventura,111,848112,180115,179116,10550,189666,1499
2022-05-23,Yolo,113,214977,40121,38782,3301,42083,319
2022-05-23,Yuba,115,75493,16306,16260,1305,17565,122
2022-05-22,Alameda,001,1643700,279792,274996,15455,290451,1858
2022-05-22,Alpine,003,1148,126,126,1,127,0
2022-05-22,Amador,005,37829,8731,8628,679,9307,86
2022-05-22,Butte,007,227075,33937,33606,7248,40854,426
2022-05-22,Calaveras,009,45235,7471,7424,379,7803,120
2022-05-22,Colusa,011,21464,3470,3468,1061,4529,21
2022-05-22,Contra Costa,013,1133247,203954,199703,14780,214483,1305
2022-05-22,Del Norte,015,27424,6169,6045,219,6264,50
2022-05-22,El Dorado,017,186661,27860,27517,3384,30901,213
2022-05-22,Fresno,019,978130,235784,234657,24275,258932,2760
2022-05-22,Glenn,021,27897,5039,5020,1641,6661,48
2022-05-22,Humboldt,023,135768,18216,17984,3432,21416,146
2022-05-22,Imperial,025,180216,56260,56014,10777,66791,923
2022-05-22,Inyo,027,18085,4157,4135,554,4689,56
2022-05-22,Kern,029,883053,194596,193705,46978,240683,2334
2022-05-22,Kings,031,150075,52178,52038,3543,55581,447
2022-05-22,Lake,033,64148,10957,10867,919,11786,137
2022-05-22,Lassen,035,31185,9024,9011,882,9893,64
2022-05-22,Los Angeles,037,10098052,2817561,2791671,131493,2923164,31815
2022-05-22,Madera,039,155013,37938,37744,6266,44010,370
2022-05-22,Marin,041,260295,37114,36394,3682,40076,293
2022-05-22,Mariposa,043,17540,2526,2490,222,2712,30
2022-05-22,Mendocino,045,87422,13589,13461,3371,16832,124
2022-05-22,Merced,047,269075,63373,62969,9037,72006,823
2022-05-22,Modoc,049,8938,748,750,255,1005,8
2022-05-22,Mono,051,14174,3029,3012,159,3171,6
2022-05-22,Monterey,053,433212,81874,81224,15145,96369,735
2022-05-22,Napa,055,140530,27353,27034,1111,28145,143
2022-05-22,Nevada,057,99092,16552,16410,1297,17707,127
2022-05-22,Orange,059,3164182,566945,562531,44214,606745,7025
2022-05-22,Placer,061,380077,65646,64802,7802,72604,626
2022-05-22,Plumas,063,18699,3094,3052,373,3425,13
2022-05-22,Riverside,065,2383286,605899,601808,28900,630708,6476
2022-05-22,Sacramento,067,1510023,292961,289972,27975,317947,3027
2022-05-22,San Benito,069,59416,13332,13234,584,13818,98
2022-05-22,San Bernardino,071,2135413,581474,575194,25310,600504,7523
2022-05-22,San Diego,073,3302833,782223,777404,56026,833430,5282
2022-05-22,San Francisco,075,870044,142074,138922,9310,148232,871
2022-05-22,San Joaquin,077,732212,171099,169745,10843,180588,2237
2022-05-22,San Luis Obispo,079,281455,54486,54012,4285,58297,481
2022-05-22,San Mateo,081,765935,135214,132636,8276,140912,711
2022-05-22,Santa Barbara,083,443738,89662,88783,5027,93810,692
2022-05-22,Santa Clara,085,1922200,342977,336488,14271,350759,2301
2022-05-22,Santa Cruz,087,273765,51777,51333,2378,53711,263
2022-05-22,Shasta,089,179085,31122,30966,6172,37138,564
2022-05-22,Sierra,091,2930,277,276,54,330,4
2022-05-22,Siskiyou,093,43540,4531,4501,2787,7288,81
2022-05-22,Solano,095,438530,86492,85038,5994,91032,451
2022-05-22,Sonoma,097,501317,90192,88889,3414,92303,489
2022-05-22,Stanislaus,099,539301,120177,119396,18097,137493,1653
2022-05-22,Sutter,101,95872,20896,20809,2171,22980,226
2022-05-22,Tehama,103,63373,12191,12162,2638,14800,201
2022-05-22,Trinity,105,12862,1197,1191,289,1480,20
2022-05-22,Tulare,107,460477,107755,107485,28427,135912,1477
2022-05-22,Tuolumne,109,53932,13153,12977,607,13584,182
2022-05-22,Ventura,111,848112,179765,178024,10500,188524,1499
2022-05-22,Yolo,113,214977,39994,38377,3277,41654,319
2022-05-22,Yuba,115,75493,16279,16180,1296,17476,122
2022-05-21,Alameda,001,1643700,279334,274996,15433,290429,1858
2022-05-21,Alpine,003,1148,126,126,1,127,0
2022-05-21,Amador,005,37829,8720,8628,679,9307,86
2022-05-21,Butte,007,227075,33917,33606,7235,40841,426
2022-05-21,Calaveras,009,45235,7465,7424,379,7803,120
2022-05-21,Colusa,011,21464,3470,3468,1060,4528,21
2022-05-21,Contra Costa,013,1133247,203597,199703,14747,214450,1305
2022-05-21,Del Norte,015,27424,6165,6045,217,6262,50
2022-05-21,El Dorado,017,186661,27824,27517,3382,30899,213
2022-05-21,Fresno,019,978130,235652,234657,24254,258911,2760
2022-05-21,Glenn,021,27897,5035,5020,1640,6660,48
2022-05-21,Humboldt,023,135768,18191,17984,3424,21408,146
2022-05-21,Imperial,025,180216,56226,56014,10775,66789,923
2022-05-21,Inyo,027,18085,4155,4135,552,4687,56
2022-05-21,Kern,029,883053,194500,193705,46917,240622,2334
2022-05-21,Kings,031,150075,52155,52038,3542,55580,447
2022-05-21,Lake,033,64148,10949,10867,919,11786,137
2022-05-21,Lassen,035,31185,9021,9011,882,9893,64
2022-05-21,Los Angeles,037,10098052,2815263,2791671,131251,2922922,31815
2022-05-21,Madera,039,155013,37920,37744,6260,44004,370
2022-05-21,Marin,041,260295,37019,36394,3638,40032,293
2022-05-21,Mariposa,043,17540,2524,2490,222,2712,30
2022-05-21,Mendocino,045,87422,13578,13461,3366,16827,124
2022-05-21,Merced,047,269075,63338,62969,9031,72000,823
2022-05-21,Modoc,049,8938,747,750,255,1005,8
2022-05-21,Mono,051,14174,3029,3012,159,3171,6
2022-05-21,Monterey,053,433212,81807,81224,15089,96313,735
2022-05-21,Napa,055,140530,27320,27034,1108,28142,143
2022-05-21,Nevada,057,99092,16546,16410,1297,17707,127
2022-05-21,Orange,059,3164182,566435,562531,44110,606641,7025
2022-05-21,Placer,061,380077,65538,64802,7789,72591,626
2022-05-21,Plumas,063,18699,3087,3052,373,3425,13
2022-05-21,Riverside,065,2383286,605427,601808,28875,630683,6476
2022-05-21,Sacramento,067,1510023,292632,289972,27946,317918,3027
2022-05-21,San Benito,069,59416,13320,13234,576,13810,98
2022-05-21,San Bernardino,071,2135413,581137,575194,25284,600478,7523
2022-05-21,San Diego,073,3302833,781526,777404,55965,833369,5282
2022-05-21,San Francisco,075,870044,141763,138922,9297,148219,871
2022-05-21,San Joaquin,077,732212,170981,169745,10825,180570,2237
2022-05-21,San Luis Obispo,079,281455,54407,54012,4271,58283,481
2022-05-21,San Mateo,081,765935,134903,132636,8248,140884,711
2022-05-21,Santa Barbara,083,443738,89570,88783,5014,93797,692
2022-05-21,Santa Clara,085,1922200,342129,336488,14228,350716,2301
2022-05-21,Santa Cruz,087,273765,51732,51333,2359,53692,263
2022-05-21,Shasta,089,179085,31110,30966,6170,37136,564
2022-05-21,Sierra,091,2930,276,276,54,330,4
2022-05-21,Siskiyou,093,43540,4527,4501,2785,7286,81
2022-05-21,Solano,095,438530,86408,85038,5988,91026,451
2022-05-21,Sonoma,097,501317,90067,88889,3403,92292,489
2022-05-21,Stanislaus,099,539301,120098,119396,18075,137471,1653
2022-05-21,Sutter,101,95872,20886,20809,2166,22975,226
2022-05-21,Tehama,103,63373,12189,12162,2637,14799,201
2022-05-21,Trinity,105,12862,1197,1191,289,1480,20
2022-05-21,Tulare,107,460477,107692,107485,28391,135876,1477
2022-05-21,Tuolumne,109,53932,13146,12977,607,13584,182
2022-05-21,Ventura,111,848112,179592,178024,10481,188505,1499
2022-05-21,Yolo,113,214977,39929,38377,3266,41643,319
2022-05-21,Yuba,115,75493,16266,16180,1294,17474,122
2022-05-20,Alameda,001,1643700,278793,274996,15406,290402,1858
2022-05-20,Alpine,003,1148,126,126,1,127,0
2022-05-20,Amador,005,37829,8713,8628,679,9307,86
2022-05-20,Butte,007,227075,33894,33606,7223,40829,426
2022-05-20,Calaveras,009,45235,7457,7424,379,7803,120
2022-05-20,Colusa,011,21464,3470,3468,1060,4528,21
2022-05-20,Contra Costa,013,1133247,203241,199703,14729,214432,1305
2022-05-20,Del Norte,015,27424,6160,6045,216,6261,50
2022-05-20,El Dorado,017,186661,27792,27517,3379,30896,213
2022-05-20,Fresno,019,978130,235494,234657,24225,258882,2760
2022-05-20,Glenn,021,27897,5032,5020,1640,6660,48
2022-05-20,Humboldt,023,135768,18169,17984,3416,21400,146
2022-05-20,Imperial,025,180216,56201,56014,10772,66786,923
2022-05-20,Inyo,027,18085,4152,4135,548,4683,56
2022-05-20,Kern,029,883053,194397,193705,46868,240573,2334
2022-05-20,Kings,031,150075,52140,52038,3541,55579,447
2022-05-20,Lake,033,64148,10932,10867,919,11786,137
2022-05-20,Lassen,035,31185,9019,9011,882,9893,64
2022-05-20,Los Angeles,037,10098052,2812916,2791671,131027,2922698,31815
2022-05-20,Madera,039,155013,37901,37744,6252,43996,370
2022-05-20,Marin,041,260295,36946,36394,3599,39993,293
2022-05-20,Mariposa,043,17540,2519,2490,222,2712,30
2022-05-20,Mendocino,045,87422,13563,13461,3362,16823,124
2022-05-20,Merced,047,269075,63304,62969,9028,71997,823
2022-05-20,Modoc,049,8938,747,750,255,1005,8
2022-05-20,Mono,051,14174,3025,3012,159,3171,6
2022-05-20,Monterey,053,433212,81747,81224,15048,96272,735
2022-05-20,Napa,055,140530,27290,27034,1104,28138,143
2022-05-20,Nevada,057,99092,16538,16410,1295,17705,127
2022-05-20,Orange,059,3164182,565861,562531,44014,606545,7025
2022-05-20,Placer,061,380077,65463,64802,7773,72575,626
2022-05-20,Plumas,063,18699,3085,3052,373,3425,13
2022-05-20,Riverside,065,2383286,604977,601808,28852,630660,6476
2022-05-20,Sacramento,067,1510023,292253,289972,27925,317897,3027
2022-05-20,San Benito,069,59416,13305,13234,575,13809,98
2022-05-20,San Bernardino,071,2135413,580818,575194,25265,600459,7523
2022-05-20,San Diego,073,3302833,780729,777404,55876,833280,5282
2022-05-20,San Francisco,075,870044,141431,138922,9266,148188,871
2022-05-20,San Joaquin,077,732212,170860,169745,10818,180563,2237
2022-05-20,San Luis Obispo,079,281455,54371,54012,4266,58278,481
2022-05-20,San Mateo,081,765935,134588,132636,8225,140861,711
2022-05-20,Santa Barbara,083,443738,89486,88783,5009,93792,692
2022-05-20,Santa Clara,085,1922200,341335,336488,14174,350662,2301
2022-05-20,Santa Cruz,087,273765,51688,51333,2341,53674,263
2022-05-20,Shasta,089,179085,31096,30966,6167,37133,564
2022-05-20,Sierra,091,2930,276,276,54,330,4
2022-05-20,Siskiyou,093,43540,4524,4501,2783,7284,81
2022-05-20,Solano,095,438530,86267,85038,5981,91019,451
2022-05-20,Sonoma,097,501317,89940,88889,3390,92279,489
2022-05-20,Stanislaus,099,539301,120016,119396,18062,137458,1653
2022-05-20,Sutter,101,95872,20877,20809,2165,22974,226
2022-05-20,Tehama,103,63373,12186,12162,2636,14798,201
2022-05-20,Trinity,105,12862,1197,1191,289,1480,20
2022-05-20,Tulare,107,460477,107635,107485,28352,135837,1477
2022-05-20,Tuolumne,109,53932,13127,12977,605,13582,182
2022-05-20,Ventura,111,848112,179396,178024,10463,188487,1499
2022-05-20,Yolo,113,214977,39859,38377,3260,41637,319
2022-05-20,Yuba,115,75493,16251,16180,1290,17470,122
2022-05-19,Alameda,001,1643700,277955,274996,15334,290330,1858
2022-05-19,Alpine,003,1148,126,126,1,127,0
2022-05-19,Amador,005,37829,8705,8628,679,9307,86
2022-05-19,Butte,007,227075,33860,33606,7213,40819,426
2022-05-19,Calaveras,009,45235,7451,7424,376,7800,120
2022-05-19,Colusa,011,21464,3469,3468,1059,4527,21
2022-05-19,Contra Costa,013,1133247,202700,199703,14654,214357,1305
2022-05-19,Del Norte,015,27424,6155,6045,211,6256,50
2022-05-19,El Dorado,017,186661,27740,27517,3364,30881,213
2022-05-19,Fresno,019,978130,235269,234657,24185,258842,2760
2022-05-19,Glenn,021,27897,5031,5020,1636,6656,48
2022-05-19,Humboldt,023,135768,18135,17984,3401,21385,146
2022-05-19,Imperial,025,180216,56155,56014,10771,66785,923
2022-05-19,Inyo,027,18085,4148,4135,547,4682,56
2022-05-19,Kern,029,883053,194254,193705,46793,240498,2334
2022-05-19,Kings,031,150075,52113,52038,3540,55578,447
2022-05-19,Lake,033,64148,10924,10867,917,11784,137
2022-05-19,Lassen,035,31185,9015,9011,882,9893,64
2022-05-19,Los Angeles,037,10098052,2808960,2791671,130697,2922368,31815
2022-05-19,Madera,039,155013,37865,37744,6235,43979,370
2022-05-19,Marin,041,260295,36850,36394,3566,39960,293
2022-05-19,Mariposa,043,17540,2511,2490,222,2712,30
2022-05-19,Mendocino,045,87422,13540,13461,3355,16816,124
2022-05-19,Merced,047,269075,63242,62969,9012,71981,823
2022-05-19,Modoc,049,8938,747,750,255,1005,8
2022-05-19,Mono,051,14174,3024,3012,155,3167,6
2022-05-19,Monterey,053,433212,81668,81224,14983,96207,735
2022-05-19,Napa,055,140530,27233,27034,1101,28135,143
2022-05-19,Nevada,057,99092,16504,16410,1288,17698,127
2022-05-19,Orange,059,3164182,565028,562531,43890,606421,7025
2022-05-19,Placer,061,380077,65345,64802,7757,72559,626
2022-05-19,Plumas,063,18699,3079,3052,373,3425,13
2022-05-19,Riverside,065,2383286,604345,601808,28810,630618,6476
2022-05-19,Sacramento,067,1510023,291694,289972,27842,317814,3027
2022-05-19,San Benito,069,59416,13277,13234,572,13806,98
2022-05-19,San Bernardino,071,2135413,580301,575194,25244,600438,7523
2022-05-19,San Diego,073,3302833,779492,777404,55718,833122,5282
2022-05-19,San Francisco,075,870044,140957,138922,9231,148153,871
2022-05-19,San Joaquin,077,732212,170618,169745,10801,180546,2237
2022-05-19,San Luis Obispo,079,281455,54268,54012,4234,58246,481
2022-05-19,San Mateo,081,765935,134125,132636,8166,140802,711
2022-05-19,Santa Barbara,083,443738,89332,88783,4982,93765,692
2022-05-19,Santa Clara,085,1922200,340243,336488,14081,350569,2301
2022-05-19,Santa Cruz,087,273765,51610,51333,2327,53660,263
2022-05-19,Shasta,089,179085,31067,30966,6161,37127,564
2022-05-19,Sierra,091,2930,276,276,54,330,4
2022-05-19,Siskiyou,093,43540,4521,4501,2781,7282,81
2022-05-19,Solano,095,438530,86084,85038,5957,90995,451
2022-05-19,Sonoma,097,501317,89736,88889,3356,92245,489
2022-05-19,Stanislaus,099,539301,119888,119396,18040,137436,1653
2022-05-19,Sutter,101,95872,20841,20809,2162,22971,226
2022-05-19,Tehama,103,63373,12176,12162,2633,14795,201
2022-05-19,Trinity,105,12862,1196,1191,289,1480,20
2022-05-19,Tulare,107,460477,107544,107485,28306,135791,1477
2022-05-19,Tuolumne,109,53932,13103,12977,601,13578,182
2022-05-19,Ventura,111,848112,179123,178024,10424,188448,1499
2022-05-19,Yolo,113,214977,39768,38377,3251,41628,319
2022-05-19,Yuba,115,75493,16231,16180,1282,17462,122
2022-05-18,Alameda,001,1643700,277104,272530,15262,287792,1859
2022-05-18,Alpine,003,1148,126,126,1,127,0
2022-05-18,Amador,005,37829,8687,8592,679,9271,86
2022-05-18,Butte,007,227075,33818,33486,7198,40684,426
2022-05-18,Calaveras,009,45235,7443,7400,376,7776,120
2022-05-18,Colusa,011,21464,3469,3467,1059,4526,21
2022-05-18,Contra Costa,013,1133247,202145,198207,14567,212774,1303
2022-05-18,Del Norte,015,27424,6147,6001,207,6208,50
2022-05-18,El Dorado,017,186661,27689,27388,3356,30744,212
2022-05-18,Fresno,019,978130,235008,234055,24143,258198,2759
2022-05-18,Glenn,021,27897,5030,5012,1636,6648,48
2022-05-18,Humboldt,023,135768,18110,17868,3380,21248,146
2022-05-18,Imperial,025,180216,56093,55915,10766,66681,918
2022-05-18,Inyo,027,18085,4144,4120,541,4661,56
2022-05-18,Kern,029,883053,194133,193338,46733,240071,2327
2022-05-18,Kings,031,150075,52084,51903,3537,55440,447
2022-05-18,Lake,033,64148,10915,10831,916,11747,137
2022-05-18,Lassen,035,31185,9009,8994,882,9876,65
2022-05-18,Los Angeles,037,10098052,2804622,2780354,130418,2910772,31789
2022-05-18,Madera,039,155013,37828,37644,6226,43870,365
2022-05-18,Marin,041,260295,36759,36024,3525,39549,293
2022-05-18,Mariposa,043,17540,2504,2481,222,2703,30
2022-05-18,Mendocino,045,87422,13519,13403,3339,16742,124
2022-05-18,Merced,047,269075,63177,62802,8985,71787,818
2022-05-18,Modoc,049,8938,747,748,255,1003,8
2022-05-18,Mono,051,14174,3022,3010,153,3163,6
2022-05-18,Monterey,053,433212,81558,80955,14926,95881,735
2022-05-18,Napa,055,140530,27192,26912,1094,28006,143
2022-05-18,Nevada,057,99092,16484,16361,1283,17644,127
2022-05-18,Orange,059,3164182,564226,560094,43785,603879,7021
2022-05-18,Placer,061,380077,65200,64432,7742,72174,626
2022-05-18,Plumas,063,18699,3071,3022,370,3392,13
2022-05-18,Riverside,065,2383286,603703,599947,28757,628704,6471
2022-05-18,Sacramento,067,1510023,291171,288335,27759,316094,3022
2022-05-18,San Benito,069,59416,13254,13186,568,13754,98
2022-05-18,San Bernardino,071,2135413,579828,573790,25217,599007,7455
2022-05-18,San Diego,073,3302833,778057,773934,55555,829489,5277
2022-05-18,San Francisco,075,870044,140425,137341,9205,146546,869
2022-05-18,San Joaquin,077,732212,170384,169045,10715,179760,2236
2022-05-18,San Luis Obispo,079,281455,54170,53756,4197,57953,478
2022-05-18,San Mateo,081,765935,133701,131330,8097,139427,709
2022-05-18,Santa Barbara,083,443738,89171,88317,4961,93278,693
2022-05-18,Santa Clara,085,1922200,339092,333230,13985,347215,2300
2022-05-18,Santa Cruz,087,273765,51518,51020,2314,53334,263
2022-05-18,Shasta,089,179085,31044,30899,6156,37055,558
2022-05-18,Sierra,091,2930,276,275,54,329,4
2022-05-18,Siskiyou,093,43540,4516,4495,2779,7274,81
2022-05-18,Solano,095,438530,85825,84476,5938,90414,451
2022-05-18,Sonoma,097,501317,89538,88195,3321,91516,489
2022-05-18,Stanislaus,099,539301,119779,119025,18008,137033,1645
2022-05-18,Sutter,101,95872,20819,20763,2153,22916,226
2022-05-18,Tehama,103,63373,12170,12133,2630,14763,201
2022-05-18,Trinity,105,12862,1196,1189,289,1478,20
2022-05-18,Tulare,107,460477,107473,107292,28248,135540,1477
2022-05-18,Tuolumne,109,53932,13084,12917,599,13516,182
2022-05-18,Ventura,111,848112,178853,177233,10385,187618,1497
2022-05-18,Yolo,113,214977,39656,38139,3239,41378,316
2022-05-18,Yuba,115,75493,16207,16109,1273,17382,122
2022-05-17,Alameda,001,1643700,276273,272530,15194,287724,1859
2022-05-17,Alpine,003,1148,126,126,1,127,0
2022-05-17,Amador,005,37829,8679,8592,677,9269,86
2022-05-17,Butte,007,227075,33764,33486,7177,40663,426
2022-05-17,Calaveras,009,45235,7436,7400,376,7776,120
2022-05-17,Colusa,011,21464,3468,3467,1058,4525,21
2022-05-17,Contra Costa,013,1133247,201507,198207,14482,212689,1303
2022-05-17,Del Norte,015,27424,6133,6001,207,6208,50
2022-05-17,El Dorado,017,186661,27634,27388,3350,30738,212
2022-05-17,Fresno,019,978130,234757,234055,24112,258167,2759
2022-05-17,Glenn,021,27897,5027,5012,1635,6647,48
2022-05-17,Humboldt,023,135768,18070,17868,3363,21231,146
2022-05-17,Imperial,025,180216,56049,55915,10756,66671,918
2022-05-17,Inyo,027,18085,4142,4120,532,4652,56
2022-05-17,Kern,029,883053,193976,193338,46677,240015,2327
2022-05-17,Kings,031,150075,52041,51903,3533,55436,447
2022-05-17,Lake,033,64148,10900,10831,914,11745,137
2022-05-17,Lassen,035,31185,9004,8994,881,9875,65
2022-05-17,Los Angeles,037,10098052,2800073,2780354,130115,2910469,31789
2022-05-17,Madera,039,155013,37802,37644,6210,43854,365
2022-05-17,Marin,041,260295,36625,36024,3464,39488,293
2022-05-17,Mariposa,043,17540,2499,2481,221,2702,30
2022-05-17,Mendocino,045,87422,13493,13403,3329,16732,124
2022-05-17,Merced,047,269075,63112,62802,8966,71768,818
2022-05-17,Modoc,049,8938,747,748,255,1003,8
2022-05-17,Mono,051,14174,3018,3010,153,3163,6
2022-05-17,Monterey,053,433212,81442,80955,14858,95813,735
2022-05-17,Napa,055,140530,27144,26912,1085,27997,143
2022-05-17,Nevada,057,99092,16455,16361,1275,17636,127
2022-05-17,Orange,059,3164182,563329,560094,43652,603746,7021
2022-05-17,Placer,061,380077,65035,64432,7704,72136,626
2022-05-17,Plumas,063,18699,3065,3022,369,3391,13
2022-05-17,Riverside,065,2383286,603016,599947,28713,628660,6471
2022-05-17,Sacramento,067,1510023,290541,288335,27657,315992,3022
2022-05-17,San Benito,069,59416,13217,13186,567,13753,98
2022-05-17,San Bernardino,071,2135413,579338,573790,25203,598993,7455
2022-05-17,San Diego,073,3302833,776544,773934,55388,829322,5277
2022-05-17,San Francisco,075,870044,139846,137341,9174,146515,869
2022-05-17,San Joaquin,077,732212,170143,169045,10676,179721,2236
2022-05-17,San Luis Obispo,079,281455,54077,53756,4152,57908,478
2022-05-17,San Mateo,081,765935,133207,131330,8058,139388,709
2022-05-17,Santa Barbara,083,443738,88972,88317,4943,93260,693
2022-05-17,Santa Clara,085,1922200,337910,333230,13911,347141,2300
2022-05-17,Santa Cruz,087,273765,51441,51020,2306,53326,263
2022-05-17,Shasta,089,179085,31006,30899,6153,37052,558
2022-05-17,Sierra,091,2930,276,275,54,329,4
2022-05-17,Siskiyou,093,43540,4514,4495,2777,7272,81
2022-05-17,Solano,095,438530,85547,84476,5909,90385,451
2022-05-17,Sonoma,097,501317,89295,88195,3276,91471,489
2022-05-17,Stanislaus,099,539301,119631,119025,17980,137005,1645
2022-05-17,Sutter,101,95872,20799,20763,2149,22912,226
2022-05-17,Tehama,103,63373,12158,12133,2627,14760,201
2022-05-17,Trinity,105,12862,1195,1189,289,1478,20
2022-05-17,Tulare,107,460477,107379,107292,28207,135499,1477
2022-05-17,Tuolumne,109,53932,13069,12917,599,13516,182
2022-05-17,Ventura,111,848112,178531,177233,10331,187564,1497
2022-05-17,Yolo,113,214977,39518,38139,3231,41370,316
2022-05-17,Yuba,115,75493,16183,16109,1270,17379,122
2022-05-16,Alameda,001,1643700,275269,272530,15113,287643,1859
2022-05-16,Alpine,003,1148,126,126,1,127,0
2022-05-16,Amador,005,37829,8669,8592,676,9268,86
2022-05-16,Butte,007,227075,33707,33486,7161,40647,426
2022-05-16,Calaveras,009,45235,7428,7400,374,7774,120
2022-05-16,Colusa,011,21464,3467,3467,1058,4525,21
2022-05-16,Contra Costa,013,1133247,200869,198207,14400,212607,1303
2022-05-16,Del Norte,015,27424,6120,6001,204,6205,50
2022-05-16,El Dorado,017,186661,27578,27388,3342,30730,212
2022-05-16,Fresno,019,978130,234496,234055,24070,258125,2759
2022-05-16,Glenn,021,27897,5023,5012,1630,6642,48
2022-05-16,Humboldt,023,135768,18025,17868,3347,21215,146
2022-05-16,Imperial,025,180216,55985,55915,10743,66658,918
2022-05-16,Inyo,027,18085,4138,4120,529,4649,56
2022-05-16,Kern,029,883053,193822,193338,46611,239949,2327
2022-05-16,Kings,031,150075,51991,51903,3532,55435,447
2022-05-16,Lake,033,64148,10894,10831,913,11744,137
2022-05-16,Lassen,035,31185,8999,8994,879,9873,65
2022-05-16,Los Angeles,037,10098052,2795628,2780354,129831,2910185,31789
2022-05-16,Madera,039,155013,37771,37644,6188,43832,365
2022-05-16,Marin,041,260295,36461,36024,3416,39440,293
2022-05-16,Mariposa,043,17540,2498,2481,220,2701,30
2022-05-16,Mendocino,045,87422,13467,13403,3317,16720,124
2022-05-16,Merced,047,269075,63042,62802,8930,71732,818
2022-05-16,Modoc,049,8938,747,748,255,1003,8
2022-05-16,Mono,051,14174,3016,3010,153,3163,6
2022-05-16,Monterey,053,433212,81331,80955,14771,95726,735
2022-05-16,Napa,055,140530,27092,26912,1080,27992,143
2022-05-16,Nevada,057,99092,16436,16361,1268,17629,127
2022-05-16,Orange,059,3164182,562473,560094,43528,603622,7021
2022-05-16,Placer,061,380077,64928,64432,7673,72105,626
2022-05-16,Plumas,063,18699,3055,3022,368,3390,13
2022-05-16,Riverside,065,2383286,602302,599947,28657,628604,6471
2022-05-16,Sacramento,067,1510023,289878,288335,27566,315901,3022
2022-05-16,San Benito,069,59416,13199,13186,561,13747,98
2022-05-16,San Bernardino,071,2135413,578871,573790,25172,598962,7455
2022-05-16,San Diego,073,3302833,775002,773934,55221,829155,5277
2022-05-16,San Francisco,075,870044,139136,137341,9142,146483,869
2022-05-16,San Joaquin,077,732212,169864,169045,10491,179536,2236
2022-05-16,San Luis Obispo,079,281455,53974,53756,4121,57877,478
2022-05-16,San Mateo,081,765935,132664,131330,8001,139331,709
2022-05-16,Santa Barbara,083,443738,88829,88317,4932,93249,693
2022-05-16,Santa Clara,085,1922200,336583,333230,13823,347053,2300
2022-05-16,Santa Cruz,087,273765,51365,51020,2290,53310,263
2022-05-16,Shasta,089,179085,30973,30899,6145,37044,558
2022-05-16,Sierra,091,2930,276,275,53,328,4
2022-05-16,Siskiyou,093,43540,4511,4495,2770,7265,81
2022-05-16,Solano,095,438530,85286,84476,5882,90358,451
2022-05-16,Sonoma,097,501317,88994,88195,3241,91436,489
2022-05-16,Stanislaus,099,539301,119486,119025,17948,136973,1645
2022-05-16,Sutter,101,95872,20785,20763,2142,22905,226
2022-05-16,Tehama,103,63373,12150,12133,2624,14757,201
2022-05-16,Trinity,105,12862,1194,1189,289,1478,20
2022-05-16,Tulare,107,460477,107305,107292,28156,135448,1477
2022-05-16,Tuolumne,109,53932,13037,12917,596,13513,182
2022-05-16,Ventura,111,848112,178200,177233,10275,187508,1497
2022-05-16,Yolo,113,214977,39383,38139,3222,41361,316
2022-05-16,Yuba,115,75493,16156,16109,1267,17376,122
2022-05-15,Alameda,001,1643700,274199,268944,15044,283988,1857
2022-05-15,Alpine,003,1148,126,125,1,126,0
2022-05-15,Amador,005,37829,8653,8574,671,9245,86
2022-05-15,Butte,007,227075,33652,33377,7140,40517,424
2022-05-15,Calaveras,009,45235,7409,7378,372,7750,120
2022-05-15,Colusa,011,21464,3464,3463,1056,4519,21
2022-05-15,Contra Costa,013,1133247,200113,195925,14317,210242,1301
2022-05-15,Del Norte,015,27424,6047,5919,202,6121,50
2022-05-15,El Dorado,017,186661,27517,27216,3327,30543,212
2022-05-15,Fresno,019,978130,234229,233305,24035,257340,2757
2022-05-15,Glenn,021,27897,5020,5004,1629,6633,48
2022-05-15,Humboldt,023,135768,17975,17633,3307,20940,146
2022-05-15,Imperial,025,180216,55949,55756,10722,66478,917
2022-05-15,Inyo,027,18085,4134,4114,525,4639,56
2022-05-15,Kern,029,883053,193646,192939,46531,239470,2314
2022-05-15,Kings,031,150075,51931,51779,3528,55307,447
2022-05-15,Lake,033,64148,10877,10790,910,11700,137
2022-05-15,Lassen,035,31185,8991,8987,878,9865,65
2022-05-15,Los Angeles,037,10098052,2791017,2768726,129460,2898186,31768
2022-05-15,Madera,039,155013,37729,37520,6171,43691,365
2022-05-15,Marin,041,260295,36290,35486,3377,38863,293
2022-05-15,Mariposa,043,17540,2493,2463,219,2682,30
2022-05-15,Mendocino,045,87422,13448,13349,3290,16639,124
2022-05-15,Merced,047,269075,62957,62627,8883,71510,818
2022-05-15,Modoc,049,8938,746,747,255,1002,8
2022-05-15,Mono,051,14174,3013,3002,151,3153,6
2022-05-15,Monterey,053,433212,81221,80620,14683,95303,735
2022-05-15,Napa,055,140530,27039,26698,1076,27774,143
2022-05-15,Nevada,057,99092,16406,16240,1265,17505,127
2022-05-15,Orange,059,3164182,561525,557134,43395,600529,7017
2022-05-15,Placer,061,380077,64746,63963,7642,71605,626
2022-05-15,Plumas,063,18699,3049,3006,368,3374,13
2022-05-15,Riverside,065,2383286,601584,597914,28589,626503,6471
2022-05-15,Sacramento,067,1510023,289164,286403,27434,313837,3022
2022-05-15,San Benito,069,59416,13174,13106,559,13665,98
2022-05-15,San Bernardino,071,2135413,578323,572057,25144,597201,7423
2022-05-15,San Diego,073,3302833,773496,770323,55022,825345,5271
2022-05-15,San Francisco,075,870044,138417,134916,9108,144024,866
2022-05-15,San Joaquin,077,732212,169621,168174,10415,178589,2236
2022-05-15,San Luis Obispo,079,281455,53847,53502,4078,57580,478
2022-05-15,San Mateo,081,765935,132133,129480,7927,137407,709
2022-05-15,Santa Barbara,083,443738,88599,87773,4897,92670,693
2022-05-15,Santa Clara,085,1922200,335163,328609,13734,342343,2297
2022-05-15,Santa Cruz,087,273765,51262,50268,2273,52541,263
2022-05-15,Shasta,089,179085,30931,30799,6139,36938,557
2022-05-15,Sierra,091,2930,276,275,53,328,4
2022-05-15,Siskiyou,093,43540,4509,4482,2767,7249,81
2022-05-15,Solano,095,438530,84968,83669,5847,89516,451
2022-05-15,Sonoma,097,501317,88669,87070,3219,90289,488
2022-05-15,Stanislaus,099,539301,119317,118586,17916,136502,1645
2022-05-15,Sutter,101,95872,20758,20690,2132,22822,226
2022-05-15,Tehama,103,63373,12132,12115,2618,14733,201
2022-05-15,Trinity,105,12862,1193,1188,289,1477,20
2022-05-15,Tulare,107,460477,107205,107077,28106,135183,1469
2022-05-15,Tuolumne,109,53932,12987,12851,594,13445,182
2022-05-15,Ventura,111,848112,177853,176317,10213,186530,1497
2022-05-15,Yolo,113,214977,39268,37737,3210,40947,316
2022-05-15,Yuba,115,75493,16122,16028,1258,17286,122
2022-05-14,Alameda,001,1643700,273779,268944,15025,283969,1857
2022-05-14,Alpine,003,1148,125,125,1,126,0
2022-05-14,Amador,005,37829,8647,8574,671,9245,86
2022-05-14,Butte,007,227075,33632,33377,7132,40509,424
2022-05-14,Calaveras,009,45235,7407,7378,372,7750,120
2022-05-14,Colusa,011,21464,3464,3463,1056,4519,21
2022-05-14,Contra Costa,013,1133247,199736,195925,14287,210212,1301
2022-05-14,Del Norte,015,27424,6039,5919,200,6119,50
2022-05-14,El Dorado,017,186661,27487,27216,3322,30538,212
2022-05-14,Fresno,019,978130,234105,233305,24028,257333,2757
2022-05-14,Glenn,021,27897,5019,5004,1625,6629,48
2022-05-14,Humboldt,023,135768,17949,17633,3300,20933,146
2022-05-14,Imperial,025,180216,55918,55756,10719,66475,917
2022-05-14,Inyo,027,18085,4129,4114,525,4639,56
2022-05-14,Kern,029,883053,193576,192939,46486,239425,2314
2022-05-14,Kings,031,150075,51904,51779,3528,55307,447
2022-05-14,Lake,033,64148,10867,10790,905,11695,137
2022-05-14,Lassen,035,31185,8989,8987,878,9865,65
2022-05-14,Los Angeles,037,10098052,2789107,2768726,129239,2897965,31768
2022-05-14,Madera,039,155013,37715,37520,6171,43691,365
2022-05-14,Marin,041,260295,36185,35486,3328,38814,293
2022-05-14,Mariposa,043,17540,2492,2463,219,2682,30
2022-05-14,Mendocino,045,87422,13438,13349,3286,16635,124
2022-05-14,Merced,047,269075,62922,62627,8880,71507,818
2022-05-14,Modoc,049,8938,745,747,255,1002,8
2022-05-14,Mono,051,14174,3013,3002,150,3152,6
2022-05-14,Monterey,053,433212,81157,80620,14629,95249,735
2022-05-14,Napa,055,140530,27016,26698,1069,27767,143
2022-05-14,Nevada,057,99092,16391,16240,1264,17504,127
2022-05-14,Orange,059,3164182,561081,557134,43311,600445,7017
2022-05-14,Placer,061,380077,64640,63963,7620,71583,626
2022-05-14,Plumas,063,18699,3045,3006,368,3374,13
2022-05-14,Riverside,065,2383286,601177,597914,28554,626468,6471
2022-05-14,Sacramento,067,1510023,288894,286403,27413,313816,3022
2022-05-14,San Benito,069,59416,13163,13106,556,13662,98
2022-05-14,San Bernardino,071,2135413,578045,572057,25132,597189,7423
2022-05-14,San Diego,073,3302833,772897,770323,54976,825299,5271
2022-05-14,San Francisco,075,870044,138056,134916,9084,144000,866
2022-05-14,San Joaquin,077,732212,169480,168174,10399,178573,2236
2022-05-14,San Luis Obispo,079,281455,53820,53502,4075,57577,478
2022-05-14,San Mateo,081,765935,131808,129480,7898,137378,709
2022-05-14,Santa Barbara,083,443738,88492,87773,4892,92665,693
2022-05-14,Santa Clara,085,1922200,334330,328609,13695,342304,2297
2022-05-14,Santa Cruz,087,273765,51215,50268,2259,52527,263
2022-05-14,Shasta,089,179085,30926,30799,6138,36937,557
2022-05-14,Sierra,091,2930,276,275,53,328,4
2022-05-14,Siskiyou,093,43540,4506,4482,2765,7247,81
2022-05-14,Solano,095,438530,84907,83669,5837,89506,451
2022-05-14,Sonoma,097,501317,88524,87070,3207,90277,488
2022-05-14,Stanislaus,099,539301,119233,118586,17905,136491,1645
2022-05-14,Sutter,101,95872,20750,20690,2131,22821,226
2022-05-14,Tehama,103,63373,12126,12115,2617,14732,201
2022-05-14,Trinity,105,12862,1193,1188,289,1477,20
2022-05-14,Tulare,107,460477,107160,107077,28078,135155,1469
2022-05-14,Tuolumne,109,53932,12976,12851,594,13445,182
2022-05-14,Ventura,111,848112,177691,176317,10189,186506,1497
2022-05-14,Yolo,113,214977,39198,37737,3203,40940,316
2022-05-14,Yuba,115,75493,16115,16028,1257,17285,122
2022-05-13,Alameda,001,1643700,273303,268944,14993,283937,1857
2022-05-13,Alpine,003,1148,125,125,1,126,0
2022-05-13,Amador,005,37829,8642,8574,670,9244,86
2022-05-13,Butte,007,227075,33615,33377,7129,40506,424
2022-05-13,Calaveras,009,45235,7403,7378,372,7750,120
2022-05-13,Colusa,011,21464,3463,3463,1056,4519,21
2022-05-13,Contra Costa,013,1133247,199392,195925,14258,210183,1301
2022-05-13,Del Norte,015,27424,6036,5919,200,6119,50
2022-05-13,El Dorado,017,186661,27459,27216,3322,30538,212
2022-05-13,Fresno,019,978130,233996,233305,24009,257314,2757
2022-05-13,Glenn,021,27897,5017,5004,1624,6628,48
2022-05-13,Humboldt,023,135768,17925,17633,3292,20925,146
2022-05-13,Imperial,025,180216,55899,55756,10718,66474,917
2022-05-13,Inyo,027,18085,4129,4114,524,4638,56
2022-05-13,Kern,029,883053,193502,192939,46457,239396,2314
2022-05-13,Kings,031,150075,51880,51779,3528,55307,447
2022-05-13,Lake,033,64148,10864,10790,905,11695,137
2022-05-13,Lassen,035,31185,8988,8987,878,9865,65
2022-05-13,Los Angeles,037,10098052,2787166,2768726,129049,2897775,31768
2022-05-13,Madera,039,155013,37695,37520,6162,43682,365
2022-05-13,Marin,041,260295,36083,35486,3285,38771,293
2022-05-13,Mariposa,043,17540,2490,2463,219,2682,30
2022-05-13,Mendocino,045,87422,13424,13349,3279,16628,124
2022-05-13,Merced,047,269075,62887,62627,8872,71499,818
2022-05-13,Modoc,049,8938,745,747,255,1002,8
2022-05-13,Mono,051,14174,3011,3002,149,3151,6
2022-05-13,Monterey,053,433212,81101,80620,14589,95209,735
2022-05-13,Napa,055,140530,26980,26698,1067,27765,143
2022-05-13,Nevada,057,99092,16376,16240,1263,17503,127
2022-05-13,Orange,059,3164182,560617,557134,43241,600375,7017
2022-05-13,Placer,061,380077,64561,63963,7611,71574,626
2022-05-13,Plumas,063,18699,3038,3006,368,3374,13
2022-05-13,Riverside,065,2383286,600789,597914,28525,626439,6471
2022-05-13,Sacramento,067,1510023,288557,286403,27395,313798,3022
2022-05-13,San Benito,069,59416,13159,13106,556,13662,98
2022-05-13,San Bernardino,071,2135413,577807,572057,25124,597181,7423
2022-05-13,San Diego,073,3302833,772258,770323,54897,825220,5271
2022-05-13,San Francisco,075,870044,137701,134916,9064,143980,866
2022-05-13,San Joaquin,077,732212,169361,168174,10387,178561,2236
2022-05-13,San Luis Obispo,079,281455,53784,53502,4071,57573,478
2022-05-13,San Mateo,081,765935,131520,129480,7877,137357,709
2022-05-13,Santa Barbara,083,443738,88399,87773,4889,92662,693
2022-05-13,Santa Clara,085,1922200,333525,328609,13662,342271,2297
2022-05-13,Santa Cruz,087,273765,51128,50268,2251,52519,263
2022-05-13,Shasta,089,179085,30922,30799,6138,36937,557
2022-05-13,Sierra,091,2930,275,275,50,325,4
2022-05-13,Siskiyou,093,43540,4505,4482,2765,7247,81
2022-05-13,Solano,095,438530,84785,83669,5830,89499,451
2022-05-13,Sonoma,097,501317,88347,87070,3193,90263,488
2022-05-13,Stanislaus,099,539301,119139,118586,17896,136482,1645
2022-05-13,Sutter,101,95872,20738,20690,2130,22820,226
2022-05-13,Tehama,103,63373,12124,12115,2615,14730,201
2022-05-13,Trinity,105,12862,1192,1188,289,1477,20
2022-05-13,Tulare,107,460477,107115,107077,28042,135119,1469
2022-05-13,Tuolumne,109,53932,12960,12851,594,13445,182
2022-05-13,Ventura,111,848112,177510,176317,10175,186492,1497
2022-05-13,Yolo,113,214977,39135,37737,3199,40936,316
2022-05-13,Yuba,115,75493,16102,16028,1254,17282,122
2022-05-12,Alameda,001,1643700,272558,268944,14937,283881,1857
2022-05-12,Alpine,003,1148,125,125,1,126,0
2022-05-12,Amador,005,37829,8633,8574,670,9244,86
2022-05-12,Butte,007,227075,33588,33377,7115,40492,424
2022-05-12,Calaveras,009,45235,7399,7378,371,7749,120
2022-05-12,Colusa,011,21464,3463,3463,1055,4518,21
2022-05-12,Contra Costa,013,1133247,198871,195925,14195,210120,1301
2022-05-12,Del Norte,015,27424,6019,5919,199,6118,50
2022-05-12,El Dorado,017,186661,27419,27216,3313,30529,212
2022-05-12,Fresno,019,978130,233845,233305,23991,257296,2757
2022-05-12,Glenn,021,27897,5013,5004,1622,6626,48
2022-05-12,Humboldt,023,135768,17883,17633,3279,20912,146
2022-05-12,Imperial,025,180216,55872,55756,10705,66461,917
2022-05-12,Inyo,027,18085,4125,4114,519,4633,56
2022-05-12,Kern,029,883053,193437,192939,46410,239349,2314
2022-05-12,Kings,031,150075,51859,51779,3526,55305,447
2022-05-12,Lake,033,64148,10846,10790,899,11689,137
2022-05-12,Lassen,035,31185,8987,8987,878,9865,65
2022-05-12,Los Angeles,037,10098052,2783954,2768726,128779,2897505,31768
2022-05-12,Madera,039,155013,37669,37520,6150,43670,365
2022-05-12,Marin,041,260295,35983,35486,3262,38748,293
2022-05-12,Mariposa,043,17540,2485,2463,218,2681,30
2022-05-12,Mendocino,045,87422,13407,13349,3267,16616,124
2022-05-12,Merced,047,269075,62854,62627,8861,71488,818
2022-05-12,Modoc,049,8938,744,747,255,1002,8
2022-05-12,Mono,051,14174,3011,3002,148,3150,6
2022-05-12,Monterey,053,433212,81042,80620,14546,95166,735
2022-05-12,Napa,055,140530,26934,26698,1065,27763,143
2022-05-12,Nevada,057,99092,16354,16240,1262,17502,127
2022-05-12,Orange,059,3164182,559978,557134,43133,600267,7017
2022-05-12,Placer,061,380077,64463,63963,7588,71551,626
2022-05-12,Plumas,063,18699,3032,3006,368,3374,13
2022-05-12,Riverside,065,2383286,600331,597914,28492,626406,6471
2022-05-12,Sacramento,067,1510023,288098,286403,27331,313734,3022
2022-05-12,San Benito,069,59416,13144,13106,555,13661,98
2022-05-12,San Bernardino,071,2135413,577457,572057,25107,597164,7423
2022-05-12,San Diego,073,3302833,771304,770323,54808,825131,5271
2022-05-12,San Francisco,075,870044,137319,134916,9025,143941,866
2022-05-12,San Joaquin,077,732212,169180,168174,10344,178518,2236
2022-05-12,San Luis Obispo,079,281455,53725,53502,4042,57544,478
2022-05-12,San Mateo,081,765935,131112,129480,7826,137306,709
2022-05-12,Santa Barbara,083,443738,88293,87773,4878,92651,693
2022-05-12,Santa Clara,085,1922200,332545,328609,13574,342183,2297
2022-05-12,Santa Cruz,087,273765,50984,50268,2244,52512,263
2022-05-12,Shasta,089,179085,30909,30799,6135,36934,557
2022-05-12,Sierra,091,2930,274,275,50,325,4
2022-05-12,Siskiyou,093,43540,4500,4482,2763,7245,81
2022-05-12,Solano,095,438530,84569,83669,5817,89486,451
2022-05-12,Sonoma,097,501317,88131,87070,3166,90236,488
2022-05-12,Stanislaus,099,539301,119038,118586,17870,136456,1645
2022-05-12,Sutter,101,95872,20722,20690,2129,22819,226
2022-05-12,Tehama,103,63373,12117,12115,2613,14728,201
2022-05-12,Trinity,105,12862,1191,1188,288,1476,20
2022-05-12,Tulare,107,460477,107063,107077,27993,135070,1469
2022-05-12,Tuolumne,109,53932,12939,12851,592,13443,182
2022-05-12,Ventura,111,848112,177279,176317,10133,186450,1497
2022-05-12,Yolo,113,214977,39022,37737,3189,40926,316
2022-05-12,Yuba,115,75493,16086,16028,1251,17279,122
2022-05-11,Alameda,001,1643700,271846,267982,14883,282865,1853
2022-05-11,Alpine,003,1148,125,125,1,126,0
2022-05-11,Amador,005,37829,8626,8564,670,9234,86
2022-05-11,Butte,007,227075,33554,33339,7109,40448,423
2022-05-11,Calaveras,009,45235,7394,7368,367,7735,120
2022-05-11,Colusa,011,21464,3462,3462,1055,4517,21
2022-05-11,Contra Costa,013,1133247,198356,195153,14140,209293,1302
2022-05-11,Del Norte,015,27424,6009,5911,199,6110,50
2022-05-11,El Dorado,017,186661,27383,27172,3306,30478,212
2022-05-11,Fresno,019,978130,233682,233021,23963,256984,2754
2022-05-11,Glenn,021,27897,5013,5001,1620,6621,48
2022-05-11,Humboldt,023,135768,17840,17585,3263,20848,146
2022-05-11,Imperial,025,180216,55845,55751,10695,66446,917
2022-05-11,Inyo,027,18085,4124,4093,518,4611,56
2022-05-11,Kern,029,883053,193340,192795,46365,239160,2292
2022-05-11,Kings,031,150075,51831,51752,3524,55276,447
2022-05-11,Lake,033,64148,10833,10786,898,11684,137
2022-05-11,Lassen,035,31185,8986,8984,877,9861,65
2022-05-11,Los Angeles,037,10098052,2780817,2761410,128550,2889960,31747
2022-05-11,Madera,039,155013,37636,37496,6139,43635,365
2022-05-11,Marin,041,260295,35882,35336,3219,38555,292
2022-05-11,Mariposa,043,17540,2480,2461,218,2679,30
2022-05-11,Mendocino,045,87422,13392,13320,3250,16570,124
2022-05-11,Merced,047,269075,62813,62567,8840,71407,818
2022-05-11,Modoc,049,8938,743,747,255,1002,8
2022-05-11,Mono,051,14174,3011,2999,147,3146,6
2022-05-11,Monterey,053,433212,80978,80534,14495,95029,733
2022-05-11,Napa,055,140530,26882,26660,1063,27723,143
2022-05-11,Nevada,057,99092,16338,16230,1257,17487,127
2022-05-11,Orange,059,3164182,559303,556265,43055,599320,7009
2022-05-11,Placer,061,380077,64365,63823,7573,71396,625
2022-05-11,Plumas,063,18699,3024,2998,368,3366,13
2022-05-11,Riverside,065,2383286,599880,597302,28456,625758,6468
2022-05-11,Sacramento,067,1510023,287683,285799,27284,313083,3020
2022-05-11,San Benito,069,59416,13124,13088,551,13639,98
2022-05-11,San Bernardino,071,2135413,577092,571372,25098,596470,7354
2022-05-11,San Diego,073,3302833,770322,768135,54678,822813,5257
2022-05-11,San Francisco,075,870044,136820,134027,9000,143027,864
2022-05-11,San Joaquin,077,732212,169005,167949,10322,178271,2233
2022-05-11,San Luis Obispo,079,281455,53678,53420,4025,57445,478
2022-05-11,San Mateo,081,765935,130715,128821,7782,136603,711
2022-05-11,Santa Barbara,083,443738,88164,87593,4866,92459,693
2022-05-11,Santa Clara,085,1922200,331535,327177,13526,340703,2294
2022-05-11,Santa Cruz,087,273765,50827,50031,2230,52261,263
2022-05-11,Shasta,089,179085,30877,30768,6132,36900,564
2022-05-11,Sierra,091,2930,274,275,50,325,4
2022-05-11,Siskiyou,093,43540,4498,4478,2763,7241,81
2022-05-11,Solano,095,438530,84372,83464,5806,89270,450
2022-05-11,Sonoma,097,501317,87925,86798,3153,89951,488
2022-05-11,Stanislaus,099,539301,118937,118445,17852,136297,1644
2022-05-11,Sutter,101,95872,20707,20668,2128,22796,225
2022-05-11,Tehama,103,63373,12117,12106,2613,14719,201
2022-05-11,Trinity,105,12862,1189,1188,288,1476,20
2022-05-11,Tulare,107,460477,107007,107068,27961,135029,1468
2022-05-11,Tuolumne,109,53932,12920,12829,592,13421,181
2022-05-11,Ventura,111,848112,177080,175955,10091,186046,1491
2022-05-11,Yolo,113,214977,38907,37654,3184,40838,316
2022-05-11,Yuba,115,75493,16067,15997,1242,17239,122
2022-05-10,Alameda,001,1643700,271066,267982,14830,282812,1853
2022-05-10,Alpine,003,1148,125,125,1,126,0
2022-05-10,Amador,005,37829,8622,8564,669,9233,86
2022-05-10,Butte,007,227075,33529,33339,7105,40444,423
2022-05-10,Calaveras,009,45235,7390,7368,366,7734,120
2022-05-10,Colusa,011,21464,3462,3462,1054,4516,21
2022-05-10,Contra Costa,013,1133247,197874,195153,14098,209251,1302
2022-05-10,Del Norte,015,27424,5956,5911,199,6110,50
2022-05-10,El Dorado,017,186661,27346,27172,3300,30472,212
2022-05-10,Fresno,019,978130,233522,233021,23935,256956,2754
2022-05-10,Glenn,021,27897,5010,5001,1620,6621,48
2022-05-10,Humboldt,023,135768,17802,17585,3246,20831,146
2022-05-10,Imperial,025,180216,55810,55751,10677,66428,917
2022-05-10,Inyo,027,18085,4122,4093,512,4605,56
2022-05-10,Kern,029,883053,193238,192795,46326,239121,2292
2022-05-10,Kings,031,150075,51799,51752,3524,55276,447
2022-05-10,Lake,033,64148,10828,10786,898,11684,137
2022-05-10,Lassen,035,31185,8981,8984,877,9861,65
2022-05-10,Los Angeles,037,10098052,2777520,2761410,128315,2889725,31747
2022-05-10,Madera,039,155013,37604,37496,6126,43622,365
2022-05-10,Marin,041,260295,35769,35336,3176,38512,292
2022-05-10,Mariposa,043,17540,2480,2461,218,2679,30
2022-05-10,Mendocino,045,87422,13380,13320,3237,16557,124
2022-05-10,Merced,047,269075,62767,62567,8821,71388,818
2022-05-10,Modoc,049,8938,743,747,255,1002,8
2022-05-10,Mono,051,14174,3007,2999,143,3142,6
2022-05-10,Monterey,053,433212,80912,80534,14447,94981,733
2022-05-10,Napa,055,140530,26844,26660,1061,27721,143
2022-05-10,Nevada,057,99092,16318,16230,1254,17484,127
2022-05-10,Orange,059,3164182,558595,556265,42964,599229,7009
2022-05-10,Placer,061,380077,64251,63823,7558,71381,625
2022-05-10,Plumas,063,18699,3016,2998,367,3365,13
2022-05-10,Riverside,065,2383286,599453,597302,28427,625729,6468
2022-05-10,Sacramento,067,1510023,287182,285799,27217,313016,3020
2022-05-10,San Benito,069,59416,13107,13088,546,13634,98
2022-05-10,San Bernardino,071,2135413,576736,571372,25072,596444,7354
2022-05-10,San Diego,073,3302833,769302,768135,54560,822695,5257
2022-05-10,San Francisco,075,870044,136268,134027,8974,143001,864
2022-05-10,San Joaquin,077,732212,168847,167949,10261,178210,2233
2022-05-10,San Luis Obispo,079,281455,53602,53420,4000,57420,478
2022-05-10,San Mateo,081,765935,130338,128821,7742,136563,711
2022-05-10,Santa Barbara,083,443738,88048,87593,4851,92444,693
2022-05-10,Santa Clara,085,1922200,330508,327177,13444,340621,2294
2022-05-10,Santa Cruz,087,273765,50701,50031,2219,52250,263
2022-05-10,Shasta,089,179085,30857,30768,6131,36899,564
2022-05-10,Sierra,091,2930,274,275,49,324,4
2022-05-10,Siskiyou,093,43540,4494,4478,2763,7241,81
2022-05-10,Solano,095,438530,84188,83464,5787,89251,450
2022-05-10,Sonoma,097,501317,87685,86798,3116,89914,488
2022-05-10,Stanislaus,099,539301,118843,118445,17834,136279,1644
2022-05-10,Sutter,101,95872,20688,20668,2125,22793,225
2022-05-10,Tehama,103,63373,12114,12106,2606,14712,201
2022-05-10,Trinity,105,12862,1189,1188,288,1476,20
2022-05-10,Tulare,107,460477,106965,107068,27933,135001,1468
2022-05-10,Tuolumne,109,53932,12908,12829,592,13421,181
2022-05-10,Ventura,111,848112,176863,175955,10055,186010,1491
2022-05-10,Yolo,113,214977,38803,37654,3173,40827,316
2022-05-10,Yuba,115,75493,16046,15997,1239,17236,122
2022-05-09,Alameda,001,1643700,270296,267982,14785,282767,1853
2022-05-09,Alpine,003,1148,125,125,1,126,0
2022-05-09,Amador,005,37829,8615,8564,669,9233,86
2022-05-09,Butte,007,227075,33503,33339,7096,40435,423
2022-05-09,Calaveras,009,45235,7384,7368,366,7734,120
2022-05-09,Colusa,011,21464,3460,3462,1052,4514,21
2022-05-09,Contra Costa,013,1133247,197407,195153,14040,209193,1302
2022-05-09,Del Norte,015,27424,5947,5911,198,6109,50
2022-05-09,El Dorado,017,186661,27310,27172,3292,30464,212
2022-05-09,Fresno,019,978130,233363,233021,23913,256934,2754
2022-05-09,Glenn,021,27897,5008,5001,1618,6619,48
2022-05-09,Humboldt,023,135768,17751,17585,3224,20809,146
2022-05-09,Imperial,025,180216,55777,55751,10664,66415,917
2022-05-09,Inyo,027,18085,4119,4093,509,4602,56
2022-05-09,Kern,029,883053,193140,192795,46270,239065,2292
2022-05-09,Kings,031,150075,51768,51752,3523,55275,447
2022-05-09,Lake,033,64148,10820,10786,897,11683,137
2022-05-09,Lassen,035,31185,8979,8984,877,9861,65
2022-05-09,Los Angeles,037,10098052,2774165,2761410,128072,2889482,31747
2022-05-09,Madera,039,155013,37573,37496,6117,43613,365
2022-05-09,Marin,041,260295,35652,35336,3141,38477,292
2022-05-09,Mariposa,043,17540,2475,2461,218,2679,30
2022-05-09,Mendocino,045,87422,13369,13320,3226,16546,124
2022-05-09,Merced,047,269075,62726,62567,8802,71369,818
2022-05-09,Modoc,049,8938,743,747,255,1002,8
2022-05-09,Mono,051,14174,3005,2999,141,3140,6
2022-05-09,Monterey,053,433212,80818,80534,14394,94928,733
2022-05-09,Napa,055,140530,26794,26660,1059,27719,143
2022-05-09,Nevada,057,99092,16290,16230,1248,17478,127
2022-05-09,Orange,059,3164182,557926,556265,42884,599149,7009
2022-05-09,Placer,061,380077,64190,63823,7542,71365,625
2022-05-09,Plumas,063,18699,3007,2998,367,3365,13
2022-05-09,Riverside,065,2383286,598963,597302,28391,625693,6468
2022-05-09,Sacramento,067,1510023,286755,285799,27145,312944,3020
2022-05-09,San Benito,069,59416,13089,13088,544,13632,98
2022-05-09,San Bernardino,071,2135413,576404,571372,25061,596433,7354
2022-05-09,San Diego,073,3302833,768324,768135,54419,822554,5257
2022-05-09,San Francisco,075,870044,135713,134027,8950,142977,864
2022-05-09,San Joaquin,077,732212,168662,167949,10239,178188,2233
2022-05-09,San Luis Obispo,079,281455,53550,53420,3979,57399,478
2022-05-09,San Mateo,081,765935,129912,128821,7704,136525,711
2022-05-09,Santa Barbara,083,443738,87920,87593,4840,92433,693
2022-05-09,Santa Clara,085,1922200,329361,327177,13379,340556,2294
2022-05-09,Santa Cruz,087,273765,50563,50031,2211,52242,263
2022-05-09,Shasta,089,179085,30843,30768,6129,36897,564
2022-05-09,Sierra,091,2930,274,275,49,324,4
2022-05-09,Siskiyou,093,43540,4492,4478,2763,7241,81
2022-05-09,Solano,095,438530,84032,83464,5774,89238,450
2022-05-09,Sonoma,097,501317,87425,86798,3090,89888,488
2022-05-09,Stanislaus,099,539301,118747,118445,17817,136262,1644
2022-05-09,Sutter,101,95872,20675,20668,2124,22792,225
2022-05-09,Tehama,103,63373,12112,12106,2604,14710,201
2022-05-09,Trinity,105,12862,1189,1188,288,1476,20
2022-05-09,Tulare,107,460477,106917,107068,27896,134964,1468
2022-05-09,Tuolumne,109,53932,12900,12829,592,13421,181
2022-05-09,Ventura,111,848112,176646,175955,10007,185962,1491
2022-05-09,Yolo,113,214977,38694,37654,3164,40818,316
2022-05-09,Yuba,115,75493,16037,15997,1238,17235,122
2022-05-08,Alameda,001,1643700,269405,265198,14719,279917,1855
2022-05-08,Alpine,003,1148,125,125,1,126,0
2022-05-08,Amador,005,37829,8604,8556,667,9223,86
2022-05-08,Butte,007,227075,33480,33269,7085,40354,421
2022-05-08,Calaveras,009,45235,7377,7353,365,7718,120
2022-05-08,Colusa,011,21464,3459,3459,1052,4511,21
2022-05-08,Contra Costa,013,1133247,196893,193961,13958,207919,1302
2022-05-08,Del Norte,015,27424,5933,5884,198,6082,50
2022-05-08,El Dorado,017,186661,27272,27081,3286,30367,210
2022-05-08,Fresno,019,978130,233195,232655,23890,256545,2754
2022-05-08,Glenn,021,27897,5006,4996,1618,6614,48
2022-05-08,Humboldt,023,135768,17698,17410,3185,20595,146
2022-05-08,Imperial,025,180216,55743,55683,10655,66338,917
2022-05-08,Inyo,027,18085,4112,4087,509,4596,56
2022-05-08,Kern,029,883053,193046,192590,46225,238815,2287
2022-05-08,Kings,031,150075,51751,51702,3523,55225,447
2022-05-08,Lake,033,64148,10813,10766,897,11663,137
2022-05-08,Lassen,035,31185,8975,8978,877,9855,65
2022-05-08,Los Angeles,037,10098052,2770582,2751478,127782,2879260,31738
2022-05-08,Madera,039,155013,37553,37420,6098,43518,365
2022-05-08,Marin,041,260295,35528,34934,3094,38028,292
2022-05-08,Mariposa,043,17540,2468,2438,217,2655,30
2022-05-08,Mendocino,045,87422,13350,13270,3200,16470,124
2022-05-08,Merced,047,269075,62675,62471,8775,71246,818
2022-05-08,Modoc,049,8938,743,745,255,1000,8
2022-05-08,Mono,051,14174,3004,2997,139,3136,6
2022-05-08,Monterey,053,433212,80726,80246,14311,94557,733
2022-05-08,Napa,055,140530,26753,26524,1056,27580,143
2022-05-08,Nevada,057,99092,16266,16171,1246,17417,127
2022-05-08,Orange,059,3164182,557247,554411,42782,597193,7007
2022-05-08,Placer,061,380077,64073,63577,7515,71092,625
2022-05-08,Plumas,063,18699,3003,2996,367,3363,13
2022-05-08,Riverside,065,2383286,598475,596022,28355,624377,6467
2022-05-08,Sacramento,067,1510023,286250,284564,27073,311637,3016
2022-05-08,San Benito,069,59416,13074,13047,541,13588,98
2022-05-08,San Bernardino,071,2135413,575972,570381,25028,595409,7306
2022-05-08,San Diego,073,3302833,767296,765377,54315,819692,5244
2022-05-08,San Francisco,075,870044,135056,132659,8919,141578,861
2022-05-08,San Joaquin,077,732212,168474,167568,10206,177774,2229
2022-05-08,San Luis Obispo,079,281455,53479,53273,3959,57232,477
2022-05-08,San Mateo,081,765935,129449,127615,7651,135266,709
2022-05-08,Santa Barbara,083,443738,87786,87305,4831,92136,692
2022-05-08,Santa Clara,085,1922200,328284,324946,13304,338250,2287
2022-05-08,Santa Cruz,087,273765,50383,49605,2207,51812,262
2022-05-08,Shasta,089,179085,30815,30721,6125,36846,563
2022-05-08,Sierra,091,2930,274,275,49,324,4
2022-05-08,Siskiyou,093,43540,4489,4470,2758,7228,81
2022-05-08,Solano,095,438530,83862,83038,5749,88787,450
2022-05-08,Sonoma,097,501317,87205,86150,3056,89206,488
2022-05-08,Stanislaus,099,539301,118639,118235,17795,136030,1643
2022-05-08,Sutter,101,95872,20654,20694,2120,22814,225
2022-05-08,Tehama,103,63373,12106,12098,2601,14699,201
2022-05-08,Trinity,105,12862,1188,1180,288,1468,20
2022-05-08,Tulare,107,460477,106876,106987,27861,134848,1468
2022-05-08,Tuolumne,109,53932,12887,12793,588,13381,181
2022-05-08,Ventura,111,848112,176410,175454,9961,185415,1491
2022-05-08,Yolo,113,214977,38588,37456,3150,40606,315
2022-05-08,Yuba,115,75493,16015,15964,1234,17198,122
2022-05-07,Alameda,001,1643700,269032,265198,14701,279899,1855
2022-05-07,Alpine,003,1148,125,125,1,126,0
2022-05-07,Amador,005,37829,8602,8556,667,9223,86
2022-05-07,Butte,007,227075,33472,33269,7078,40347,421
2022-05-07,Calaveras,009,45235,7370,7353,365,7718,120
2022-05-07,Colusa,011,21464,3459,3459,1052,4511,21
2022-05-07,Contra Costa,013,1133247,196652,193961,13941,207902,1302
2022-05-07,Del Norte,015,27424,5931,5884,198,6082,50
2022-05-07,El Dorado,017,186661,27254,27081,3285,30366,210
2022-05-07,Fresno,019,978130,233140,232655,23883,256538,2754
2022-05-07,Glenn,021,27897,5005,4996,1618,6614,48
2022-05-07,Humboldt,023,135768,17669,17410,3177,20587,146
2022-05-07,Imperial,025,180216,55720,55683,10649,66332,917
2022-05-07,Inyo,027,18085,4109,4087,509,4596,56
2022-05-07,Kern,029,883053,193011,192590,46204,238794,2287
2022-05-07,Kings,031,150075,51740,51702,3523,55225,447
2022-05-07,Lake,033,64148,10809,10766,897,11663,137
2022-05-07,Lassen,035,31185,8975,8978,877,9855,65
2022-05-07,Los Angeles,037,10098052,2768990,2751478,127613,2879091,31738
2022-05-07,Madera,039,155013,37546,37420,6098,43518,365
2022-05-07,Marin,041,260295,35454,34934,3062,37996,292
2022-05-07,Mariposa,043,17540,2465,2438,217,2655,30
2022-05-07,Mendocino,045,87422,13341,13270,3197,16467,124
2022-05-07,Merced,047,269075,62662,62471,8775,71246,818
2022-05-07,Modoc,049,8938,743,745,255,1000,8
2022-05-07,Mono,051,14174,3003,2997,139,3136,6
2022-05-07,Monterey,053,433212,80666,80246,14285,94531,733
2022-05-07,Napa,055,140530,26723,26524,1055,27579,143
2022-05-07,Nevada,057,99092,16256,16171,1241,17412,127
2022-05-07,Orange,059,3164182,556918,554411,42733,597144,7007
2022-05-07,Placer,061,380077,64010,63577,7508,71085,625
2022-05-07,Plumas,063,18699,3003,2996,366,3362,13
2022-05-07,Riverside,065,2383286,598220,596022,28328,624350,6467
2022-05-07,Sacramento,067,1510023,286056,284564,27060,311624,3016
2022-05-07,San Benito,069,59416,13065,13047,536,13583,98
2022-05-07,San Bernardino,071,2135413,575759,570381,25023,595404,7306
2022-05-07,San Diego,073,3302833,766810,765377,54285,819662,5244
2022-05-07,San Francisco,075,870044,134724,132659,8899,141558,861
2022-05-07,San Joaquin,077,732212,168369,167568,10198,177766,2229
2022-05-07,San Luis Obispo,079,281455,53467,53273,3948,57221,477
2022-05-07,San Mateo,081,765935,129164,127615,7629,135244,709
2022-05-07,Santa Barbara,083,443738,87706,87305,4828,92133,692
2022-05-07,Santa Clara,085,1922200,327663,324946,13274,338220,2287
2022-05-07,Santa Cruz,087,273765,50330,49605,2197,51802,262
2022-05-07,Shasta,089,179085,30807,30721,6125,36846,563
2022-05-07,Sierra,091,2930,274,275,49,324,4
2022-05-07,Siskiyou,093,43540,4487,4470,2758,7228,81
2022-05-07,Solano,095,438530,83807,83038,5745,88783,450
2022-05-07,Sonoma,097,501317,87080,86150,3047,89197,488
2022-05-07,Stanislaus,099,539301,118592,118235,17788,136023,1643
2022-05-07,Sutter,101,95872,20645,20694,2120,22814,225
2022-05-07,Tehama,103,63373,12104,12098,2600,14698,201
2022-05-07,Trinity,105,12862,1188,1180,288,1468,20
2022-05-07,Tulare,107,460477,106852,106987,27849,134836,1468
2022-05-07,Tuolumne,109,53932,12880,12793,588,13381,181
2022-05-07,Ventura,111,848112,176300,175454,9937,185391,1491
2022-05-07,Yolo,113,214977,38543,37456,3148,40604,315
2022-05-07,Yuba,115,75493,16006,15964,1234,17198,122
2022-05-06,Alameda,001,1643700,268651,265198,14679,279877,1855
2022-05-06,Alpine,003,1148,125,125,1,126,0
2022-05-06,Amador,005,37829,8601,8556,666,9222,86
2022-05-06,Butte,007,227075,33463,33269,7075,40344,421
2022-05-06,Calaveras,009,45235,7367,7353,365,7718,120
2022-05-06,Colusa,011,21464,3459,3459,1052,4511,21
2022-05-06,Contra Costa,013,1133247,196419,193961,13929,207890,1302
2022-05-06,Del Norte,015,27424,5922,5884,198,6082,50
2022-05-06,El Dorado,017,186661,27229,27081,3283,30364,210
2022-05-06,Fresno,019,978130,233064,232655,23874,256529,2754
2022-05-06,Glenn,021,27897,5005,4996,1618,6614,48
2022-05-06,Humboldt,023,135768,17642,17410,3170,20580,146
2022-05-06,Imperial,025,180216,55710,55683,10646,66329,917
2022-05-06,Inyo,027,18085,4099,4087,506,4593,56
2022-05-06,Kern,029,883053,192959,192590,46177,238767,2287
2022-05-06,Kings,031,150075,51732,51702,3523,55225,447
2022-05-06,Lake,033,64148,10807,10766,897,11663,137
2022-05-06,Lassen,035,31185,8975,8978,877,9855,65
2022-05-06,Los Angeles,037,10098052,2767165,2751478,127468,2878946,31738
2022-05-06,Madera,039,155013,37532,37420,6095,43515,365
2022-05-06,Marin,041,260295,35376,34934,3016,37950,292
2022-05-06,Mariposa,043,17540,2464,2438,210,2648,30
2022-05-06,Mendocino,045,87422,13329,13270,3195,16465,124
2022-05-06,Merced,047,269075,62645,62471,8774,71245,818
2022-05-06,Modoc,049,8938,743,745,255,1000,8
2022-05-06,Mono,051,14174,3002,2997,139,3136,6
2022-05-06,Monterey,053,433212,80627,80246,14248,94494,733
2022-05-06,Napa,055,140530,26706,26524,1055,27579,143
2022-05-06,Nevada,057,99092,16244,16171,1239,17410,127
2022-05-06,Orange,059,3164182,556574,554411,42667,597078,7007
2022-05-06,Placer,061,380077,63949,63577,7496,71073,625
2022-05-06,Plumas,063,18699,3001,2996,366,3362,13
2022-05-06,Riverside,065,2383286,597992,596022,28308,624330,6467
2022-05-06,Sacramento,067,1510023,285799,284564,27040,311604,3016
2022-05-06,San Benito,069,59416,13061,13047,536,13583,98
2022-05-06,San Bernardino,071,2135413,575583,570381,25017,595398,7306
2022-05-06,San Diego,073,3302833,766300,765377,54249,819626,5244
2022-05-06,San Francisco,075,870044,134396,132659,8878,141537,861
2022-05-06,San Joaquin,077,732212,168279,167568,10186,177754,2229
2022-05-06,San Luis Obispo,079,281455,53441,53273,3943,57216,477
2022-05-06,San Mateo,081,765935,128937,127615,7620,135235,709
2022-05-06,Santa Barbara,083,443738,87652,87305,4826,92131,692
2022-05-06,Santa Clara,085,1922200,327071,324946,13259,338205,2287
2022-05-06,Santa Cruz,087,273765,50266,49605,2193,51798,262
2022-05-06,Shasta,089,179085,30801,30721,6124,36845,563
2022-05-06,Sierra,091,2930,274,275,49,324,4
2022-05-06,Siskiyou,093,43540,4485,4470,2756,7226,81
2022-05-06,Solano,095,438530,83719,83038,5737,88775,450
2022-05-06,Sonoma,097,501317,86958,86150,3032,89182,488
2022-05-06,Stanislaus,099,539301,118535,118235,17781,136016,1643
2022-05-06,Sutter,101,95872,20639,20694,2120,22814,225
2022-05-06,Tehama,103,63373,12099,12098,2600,14698,201
2022-05-06,Trinity,105,12862,1187,1180,288,1468,20
2022-05-06,Tulare,107,460477,106833,106987,27838,134825,1468
2022-05-06,Tuolumne,109,53932,12873,12793,587,13380,181
2022-05-06,Ventura,111,848112,176183,175454,9907,185361,1491
2022-05-06,Yolo,113,214977,38496,37456,3144,40600,315
2022-05-06,Yuba,115,75493,15995,15964,1233,17197,122
2022-05-05,Alameda,001,1643700,268063,265198,14634,279832,1855
2022-05-05,Alpine,003,1148,125,125,1,126,0
2022-05-05,Amador,005,37829,8599,8556,665,9221,86
2022-05-05,Butte,007,227075,33444,33269,7068,40337,421
2022-05-05,Calaveras,009,45235,7364,7353,363,7716,120
2022-05-05,Colusa,011,21464,3459,3459,1049,4508,21
2022-05-05,Contra Costa,013,1133247,196025,193961,13885,207846,1302
2022-05-05,Del Norte,015,27424,5921,5884,198,6082,50
2022-05-05,El Dorado,017,186661,27204,27081,3276,30357,210
2022-05-05,Fresno,019,978130,232963,232655,23851,256506,2754
2022-05-05,Glenn,021,27897,5005,4996,1618,6614,48
2022-05-05,Humboldt,023,135768,17605,17410,3156,20566,146
2022-05-05,Imperial,025,180216,55703,55683,10635,66318,917
2022-05-05,Inyo,027,18085,4095,4087,505,4592,56
2022-05-05,Kern,029,883053,192902,192590,46139,238729,2287
2022-05-05,Kings,031,150075,51724,51702,3523,55225,447
2022-05-05,Lake,033,64148,10803,10766,897,11663,137
2022-05-05,Lassen,035,31185,8975,8978,877,9855,65
2022-05-05,Los Angeles,037,10098052,2764580,2751478,127244,2878722,31738
2022-05-05,Madera,039,155013,37515,37420,6090,43510,365
2022-05-05,Marin,041,260295,35266,34934,2994,37928,292
2022-05-05,Mariposa,043,17540,2462,2438,209,2647,30
2022-05-05,Mendocino,045,87422,13318,13270,3187,16457,124
2022-05-05,Merced,047,269075,62612,62471,8770,71241,818
2022-05-05,Modoc,049,8938,743,745,253,998,8
2022-05-05,Mono,051,14174,3001,2997,138,3135,6
2022-05-05,Monterey,053,433212,80573,80246,14219,94465,733
2022-05-05,Napa,055,140530,26673,26524,1054,27578,143
2022-05-05,Nevada,057,99092,16234,16171,1236,17407,127
2022-05-05,Orange,059,3164182,556066,554411,42611,597022,7007
2022-05-05,Placer,061,380077,63888,63577,7487,71064,625
2022-05-05,Plumas,063,18699,3000,2996,366,3362,13
2022-05-05,Riverside,065,2383286,597651,596022,28281,624303,6467
2022-05-05,Sacramento,067,1510023,285465,284564,26986,311550,3016
2022-05-05,San Benito,069,59416,13050,13047,534,13581,98
2022-05-05,San Bernardino,071,2135413,575293,570381,25001,595382,7306
2022-05-05,San Diego,073,3302833,765559,765377,54179,819556,5244
2022-05-05,San Francisco,075,870044,133981,132659,8844,141503,861
2022-05-05,San Joaquin,077,732212,168187,167568,10158,177726,2229
2022-05-05,San Luis Obispo,079,281455,53405,53273,3928,57201,477
2022-05-05,San Mateo,081,765935,128599,127615,7595,135210,709
2022-05-05,Santa Barbara,083,443738,87577,87305,4821,92126,692
2022-05-05,Santa Clara,085,1922200,326269,324946,13197,338143,2287
2022-05-05,Santa Cruz,087,273765,50168,49605,2189,51794,262
2022-05-05,Shasta,089,179085,30791,30721,6122,36843,563
2022-05-05,Sierra,091,2930,274,275,49,324,4
2022-05-05,Siskiyou,093,43540,4483,4470,2756,7226,81
2022-05-05,Solano,095,438530,83599,83038,5719,88757,450
2022-05-05,Sonoma,097,501317,86785,86150,3015,89165,488
2022-05-05,Stanislaus,099,539301,118477,118235,17767,136002,1643
2022-05-05,Sutter,101,95872,20637,20694,2118,22812,225
2022-05-05,Tehama,103,63373,12095,12098,2598,14696,201
2022-05-05,Trinity,105,12862,1187,1180,288,1468,20
2022-05-05,Tulare,107,460477,106803,106987,27820,134807,1468
2022-05-05,Tuolumne,109,53932,12855,12793,584,13377,181
2022-05-05,Ventura,111,848112,175995,175454,9864,185318,1491
2022-05-05,Yolo,113,214977,38425,37456,3133,40589,315
2022-05-05,Yuba,115,75493,15985,15964,1230,17194,122
2022-05-04,Alameda,001,1643700,267401,263736,14592,278328,1850
2022-05-04,Alpine,003,1148,125,124,1,125,0
2022-05-04,Amador,005,37829,8596,8546,664,9210,86
2022-05-04,Butte,007,227075,33427,33220,7063,40283,417
2022-05-04,Calaveras,009,45235,7359,7344,363,7707,120
2022-05-04,Colusa,011,21464,3458,3460,1049,4509,21
2022-05-04,Contra Costa,013,1133247,195660,193175,13830,207005,1302
2022-05-04,Del Norte,015,27424,5913,5866,198,6064,50
2022-05-04,El Dorado,017,186661,27179,27021,3269,30290,210
2022-05-04,Fresno,019,978130,232846,232332,23840,256172,2751
2022-05-04,Glenn,021,27897,5003,4995,1618,6613,48
2022-05-04,Humboldt,023,135768,17565,17316,3146,20462,146
2022-05-04,Imperial,025,180216,55681,55548,10627,66175,910
2022-05-04,Inyo,027,18085,4095,4085,502,4587,56
2022-05-04,Kern,029,883053,192837,192432,46103,238535,2281
2022-05-04,Kings,031,150075,51706,51663,3522,55185,447
2022-05-04,Lake,033,64148,10798,10758,897,11655,137
2022-05-04,Lassen,035,31185,8974,8972,875,9847,65
2022-05-04,Los Angeles,037,10098052,2761802,2744894,127053,2871947,31722
2022-05-04,Madera,039,155013,37491,37395,6085,43480,365
2022-05-04,Marin,041,260295,35179,34727,2972,37699,291
2022-05-04,Mariposa,043,17540,2456,2435,204,2639,30
2022-05-04,Mendocino,045,87422,13310,13247,3179,16426,123
2022-05-04,Merced,047,269075,62586,62419,8759,71178,818
2022-05-04,Modoc,049,8938,743,746,253,999,8
2022-05-04,Mono,051,14174,3000,2993,135,3128,6
2022-05-04,Monterey,053,433212,80511,80038,14195,94233,732
2022-05-04,Napa,055,140530,26636,26434,1051,27485,143
2022-05-04,Nevada,057,99092,16218,16136,1232,17368,127
2022-05-04,Orange,059,3164182,555483,553177,42539,595716,7006
2022-05-04,Placer,061,380077,63805,63410,7481,70891,625
2022-05-04,Plumas,063,18699,2998,2947,366,3313,13
2022-05-04,Riverside,065,2383286,597315,594981,28255,623236,6457
2022-05-04,Sacramento,067,1510023,285135,283939,26951,310890,3013
2022-05-04,San Benito,069,59416,13040,13019,528,13547,98
2022-05-04,San Bernardino,071,2135413,575031,569570,24988,594558,7240
2022-05-04,San Diego,073,3302833,764811,763453,54087,817540,5239
2022-05-04,San Francisco,075,870044,133569,131599,8823,140422,860
2022-05-04,San Joaquin,077,732212,168082,167280,10130,177410,2225
2022-05-04,San Luis Obispo,079,281455,53361,53156,3917,57073,477
2022-05-04,San Mateo,081,765935,128276,126800,7560,134360,710
2022-05-04,Santa Barbara,083,443738,87473,87058,4806,91864,688
2022-05-04,Santa Clara,085,1922200,325461,322805,13143,335948,2285
2022-05-04,Santa Cruz,087,273765,50054,49230,2186,51416,262
2022-05-04,Shasta,089,179085,30775,30681,6120,36801,556
2022-05-04,Sierra,091,2930,274,275,49,324,4
2022-05-04,Siskiyou,093,43540,4479,4463,2754,7217,81
2022-05-04,Solano,095,438530,83455,82796,5709,88505,449
2022-05-04,Sonoma,097,501317,86609,85694,2992,88686,488
2022-05-04,Stanislaus,099,539301,118415,118123,17756,135879,1643
2022-05-04,Sutter,101,95872,20626,20672,2116,22788,224
2022-05-04,Tehama,103,63373,12093,12090,2593,14683,201
2022-05-04,Trinity,105,12862,1187,1180,288,1468,20
2022-05-04,Tulare,107,460477,106784,106935,27805,134740,1464
2022-05-04,Tuolumne,109,53932,12848,12757,582,13339,181
2022-05-04,Ventura,111,848112,175828,175066,9822,184888,1486
2022-05-04,Yolo,113,214977,38349,37344,3127,40471,315
2022-05-04,Yuba,115,75493,15976,15940,1227,17167,122
2022-05-03,Alameda,001,1643700,266785,263736,14549,278285,1850
2022-05-03,Alpine,003,1148,125,124,1,125,0
2022-05-03,Amador,005,37829,8593,8546,663,9209,86
2022-05-03,Butte,007,227075,33411,33220,7058,40278,417
2022-05-03,Calaveras,009,45235,7352,7344,363,7707,120
2022-05-03,Colusa,011,21464,3457,3460,1049,4509,21
2022-05-03,Contra Costa,013,1133247,195268,193175,13787,206962,1302
2022-05-03,Del Norte,015,27424,5907,5866,196,6062,50
2022-05-03,El Dorado,017,186661,27157,27021,3265,30286,210
2022-05-03,Fresno,019,978130,232736,232332,23821,256153,2751
2022-05-03,Glenn,021,27897,5002,4995,1616,6611,48
2022-05-03,Humboldt,023,135768,17529,17316,3127,20443,146
2022-05-03,Imperial,025,180216,55660,55548,10621,66169,910
2022-05-03,Inyo,027,18085,4093,4085,502,4587,56
2022-05-03,Kern,029,883053,192759,192432,46071,238503,2281
2022-05-03,Kings,031,150075,51694,51663,3522,55185,447
2022-05-03,Lake,033,64148,10793,10758,896,11654,137
2022-05-03,Lassen,035,31185,8974,8972,875,9847,65
2022-05-03,Los Angeles,037,10098052,2758744,2744894,126821,2871715,31722
2022-05-03,Madera,039,155013,37461,37395,6080,43475,365
2022-05-03,Marin,041,260295,35067,34727,2949,37676,291
2022-05-03,Mariposa,043,17540,2448,2435,204,2639,30
2022-05-03,Mendocino,045,87422,13295,13247,3161,16408,123
2022-05-03,Merced,047,269075,62558,62419,8736,71155,818
2022-05-03,Modoc,049,8938,742,746,253,999,8
2022-05-03,Mono,051,14174,2998,2993,134,3127,6
2022-05-03,Monterey,053,433212,80456,80038,14161,94199,732
2022-05-03,Napa,055,140530,26601,26434,1044,27478,143
2022-05-03,Nevada,057,99092,16207,16136,1232,17368,127
2022-05-03,Orange,059,3164182,554959,553177,42461,595638,7006
2022-05-03,Placer,061,380077,63711,63410,7467,70877,625
2022-05-03,Plumas,063,18699,2994,2947,366,3313,13
2022-05-03,Riverside,065,2383286,596945,594981,28231,623212,6457
2022-05-03,Sacramento,067,1510023,284821,283939,26900,310839,3013
2022-05-03,San Benito,069,59416,13026,13019,525,13544,98
2022-05-03,San Bernardino,071,2135413,574764,569570,24976,594546,7240
2022-05-03,San Diego,073,3302833,763968,763453,53987,817440,5239
2022-05-03,San Francisco,075,870044,133091,131599,8793,140392,860
2022-05-03,San Joaquin,077,732212,167999,167280,10104,177384,2225
2022-05-03,San Luis Obispo,079,281455,53314,53156,3908,57064,477
2022-05-03,San Mateo,081,765935,127932,126800,7522,134322,710
2022-05-03,Santa Barbara,083,443738,87382,87058,4804,91862,688
2022-05-03,Santa Clara,085,1922200,324640,322805,13091,335896,2285
2022-05-03,Santa Cruz,087,273765,49964,49230,2181,51411,262
2022-05-03,Shasta,089,179085,30756,30681,6119,36800,556
2022-05-03,Sierra,091,2930,274,275,49,324,4
2022-05-03,Siskiyou,093,43540,4478,4463,2754,7217,81
2022-05-03,Solano,095,438530,83268,82796,5700,88496,449
2022-05-03,Sonoma,097,501317,86430,85694,2968,88662,488
2022-05-03,Stanislaus,099,539301,118361,118123,17744,135867,1643
2022-05-03,Sutter,101,95872,20621,20672,2114,22786,224
2022-05-03,Tehama,103,63373,12089,12090,2592,14682,201
2022-05-03,Trinity,105,12862,1187,1180,288,1468,20
2022-05-03,Tulare,107,460477,106755,106935,27791,134726,1464
2022-05-03,Tuolumne,109,53932,12835,12757,582,13339,181
2022-05-03,Ventura,111,848112,175659,175066,9781,184847,1486
2022-05-03,Yolo,113,214977,38279,37344,3126,40470,315
2022-05-03,Yuba,115,75493,15965,15940,1219,17159,122
2022-05-02,Alameda,001,1643700,266158,263736,14505,278241,1850
2022-05-02,Alpine,003,1148,125,124,1,125,0
2022-05-02,Amador,005,37829,8590,8546,660,9206,86
2022-05-02,Butte,007,227075,33388,33220,7056,40276,417
2022-05-02,Calaveras,009,45235,7351,7344,362,7706,120
2022-05-02,Colusa,011,21464,3457,3460,1049,4509,21
2022-05-02,Contra Costa,013,1133247,194897,193175,13749,206924,1302
2022-05-02,Del Norte,015,27424,5902,5866,191,6057,50
2022-05-02,El Dorado,017,186661,27134,27021,3259,30280,210
2022-05-02,Fresno,019,978130,232626,232332,23792,256124,2751
2022-05-02,Glenn,021,27897,5000,4995,1616,6611,48
2022-05-02,Humboldt,023,135768,17479,17316,3113,20429,146
2022-05-02,Imperial,025,180216,55647,55548,10614,66162,910
2022-05-02,Inyo,027,18085,4092,4085,500,4585,56
2022-05-02,Kern,029,883053,192675,192432,46042,238474,2281
2022-05-02,Kings,031,150075,51677,51663,3522,55185,447
2022-05-02,Lake,033,64148,10789,10758,896,11654,137
2022-05-02,Lassen,035,31185,8973,8972,875,9847,65
2022-05-02,Los Angeles,037,10098052,2755702,2744894,126607,2871501,31722
2022-05-02,Madera,039,155013,37444,37395,6073,43468,365
2022-05-02,Marin,041,260295,34942,34727,2926,37653,291
2022-05-02,Mariposa,043,17540,2443,2435,204,2639,30
2022-05-02,Mendocino,045,87422,13277,13247,3148,16395,123
2022-05-02,Merced,047,269075,62527,62419,8730,71149,818
2022-05-02,Modoc,049,8938,741,746,253,999,8
2022-05-02,Mono,051,14174,2996,2993,133,3126,6
2022-05-02,Monterey,053,433212,80379,80038,14120,94158,732
2022-05-02,Napa,055,140530,26562,26434,1042,27476,143
2022-05-02,Nevada,057,99092,16189,16136,1230,17366,127
2022-05-02,Orange,059,3164182,554419,553177,42368,595545,7006
2022-05-02,Placer,061,380077,63654,63410,7460,70870,625
2022-05-02,Plumas,063,18699,2994,2947,366,3313,13
2022-05-02,Riverside,065,2383286,596554,594981,28204,623185,6457
2022-05-02,Sacramento,067,1510023,284514,283939,26860,310799,3013
2022-05-02,San Benito,069,59416,13014,13019,525,13544,98
2022-05-02,San Bernardino,071,2135413,574478,569570,24957,594527,7240
2022-05-02,San Diego,073,3302833,763103,763453,53893,817346,5239
2022-05-02,San Francisco,075,870044,132654,131599,8766,140365,860
2022-05-02,San Joaquin,077,732212,167882,167280,10094,177374,2225
2022-05-02,San Luis Obispo,079,281455,53261,53156,3899,57055,477
2022-05-02,San Mateo,081,765935,127608,126800,7507,134307,710
2022-05-02,Santa Barbara,083,443738,87281,87058,4800,91858,688
2022-05-02,Santa Clara,085,1922200,323726,322805,13043,335848,2285
2022-05-02,Santa Cruz,087,273765,49836,49230,2177,51407,262
2022-05-02,Shasta,089,179085,30737,30681,6118,36799,556
2022-05-02,Sierra,091,2930,274,275,49,324,4
2022-05-02,Siskiyou,093,43540,4475,4463,2752,7215,81
2022-05-02,Solano,095,438530,83128,82796,5691,88487,449
2022-05-02,Sonoma,097,501317,86247,85694,2948,88642,488
2022-05-02,Stanislaus,099,539301,118288,118123,17731,135854,1643
2022-05-02,Sutter,101,95872,20614,20672,2111,22783,224
2022-05-02,Tehama,103,63373,12084,12090,2589,14679,201
2022-05-02,Trinity,105,12862,1186,1180,288,1468,20
2022-05-02,Tulare,107,460477,106733,106935,27775,134710,1464
2022-05-02,Tuolumne,109,53932,12829,12757,582,13339,181
2022-05-02,Ventura,111,848112,175495,175066,9749,184815,1486
2022-05-02,Yolo,113,214977,38200,37344,3120,40464,315
2022-05-02,Yuba,115,75493,15960,15940,1217,17157,122
2022-05-01,Alameda,001,1643700,265457,262027,14455,276482,1851
2022-05-01,Alpine,003,1148,125,124,1,125,0
2022-05-01,Amador,005,37829,8590,8533,660,9193,86
2022-05-01,Butte,007,227075,33360,33172,7051,40223,418
2022-05-01,Calaveras,009,45235,7347,7328,356,7684,120
2022-05-01,Colusa,011,21464,3457,3457,1049,4506,21
2022-05-01,Contra Costa,013,1133247,194511,192136,13677,205813,1301
2022-05-01,Del Norte,015,27424,5894,5841,191,6032,50
2022-05-01,El Dorado,017,186661,27102,26946,3255,30201,210
2022-05-01,Fresno,019,978130,232521,232067,23771,255838,2748
2022-05-01,Glenn,021,27897,5000,4995,1616,6611,48
2022-05-01,Humboldt,023,135768,17415,17194,3088,20282,145
2022-05-01,Imperial,025,180216,55623,55503,10611,66114,910
2022-05-01,Inyo,027,18085,4091,4084,499,4583,56
2022-05-01,Kern,029,883053,192612,192250,45997,238247,2265
2022-05-01,Kings,031,150075,51656,51640,3518,55158,447
2022-05-01,Lake,033,64148,10782,10742,894,11636,137
2022-05-01,Lassen,035,31185,8973,8966,875,9841,65
2022-05-01,Los Angeles,037,10098052,2752690,2736900,126371,2863271,31712
2022-05-01,Madera,039,155013,37426,37360,6062,43422,365
2022-05-01,Marin,041,260295,34855,34519,2893,37412,291
2022-05-01,Mariposa,043,17540,2442,2430,204,2634,30
2022-05-01,Mendocino,045,87422,13258,13219,3132,16351,123
2022-05-01,Merced,047,269075,62497,62357,8714,71071,818
2022-05-01,Modoc,049,8938,741,745,253,998,8
2022-05-01,Mono,051,14174,2993,2989,131,3120,6
2022-05-01,Monterey,053,433212,80299,79881,14078,93959,731
2022-05-01,Napa,055,140530,26517,26319,1038,27357,143
2022-05-01,Nevada,057,99092,16170,16100,1229,17329,127
2022-05-01,Orange,059,3164182,553866,551822,42271,594093,6998
2022-05-01,Placer,061,380077,63581,63273,7446,70719,625
2022-05-01,Plumas,063,18699,2993,2946,366,3312,13
2022-05-01,Riverside,065,2383286,596092,593965,28169,622134,6457
2022-05-01,Sacramento,067,1510023,284182,283048,26799,309847,3007
2022-05-01,San Benito,069,59416,13006,12988,525,13513,98
2022-05-01,San Bernardino,071,2135413,574158,568758,24940,593698,7191
2022-05-01,San Diego,073,3302833,762222,761253,53803,815056,5238
2022-05-01,San Francisco,075,870044,132161,130241,8737,138978,860
2022-05-01,San Joaquin,077,732212,167740,167028,10064,177092,2225
2022-05-01,San Luis Obispo,079,281455,53189,53040,3883,56923,477
2022-05-01,San Mateo,081,765935,127240,125807,7468,133275,705
2022-05-01,Santa Barbara,083,443738,87176,86768,4790,91558,688
2022-05-01,Santa Clara,085,1922200,322786,320709,12990,333699,2281
2022-05-01,Santa Cruz,087,273765,49684,48798,2169,50967,262
2022-05-01,Shasta,089,179085,30721,30649,6116,36765,554
2022-05-01,Sierra,091,2930,274,274,49,323,4
2022-05-01,Siskiyou,093,43540,4474,4458,2746,7204,81
2022-05-01,Solano,095,438530,82996,82459,5678,88137,449
2022-05-01,Sonoma,097,501317,86027,85290,2920,88210,488
2022-05-01,Stanislaus,099,539301,118233,117943,17716,135659,1643
2022-05-01,Sutter,101,95872,20606,20644,2104,22748,224
2022-05-01,Tehama,103,63373,12083,12078,2588,14666,202
2022-05-01,Trinity,105,12862,1186,1179,288,1467,20
2022-05-01,Tulare,107,460477,106700,106856,27755,134611,1458
2022-05-01,Tuolumne,109,53932,12809,12713,576,13289,181
2022-05-01,Ventura,111,848112,175323,174679,9697,184376,1486
2022-05-01,Yolo,113,214977,38135,37173,3109,40282,314
2022-05-01,Yuba,115,75493,15950,15917,1215,17132,121
2022-04-30,Alameda,001,1643700,265055,262027,14440,276467,1851
2022-04-30,Alpine,003,1148,125,124,1,125,0
2022-04-30,Amador,005,37829,8588,8533,660,9193,86
2022-04-30,Butte,007,227075,33354,33172,7047,40219,418
2022-04-30,Calaveras,009,45235,7344,7328,355,7683,120
2022-04-30,Colusa,011,21464,3456,3457,1049,4506,21
2022-04-30,Contra Costa,013,1133247,194266,192136,13667,205803,1301
2022-04-30,Del Norte,015,27424,5889,5841,191,6032,50
2022-04-30,El Dorado,017,186661,27084,26946,3251,30197,210
2022-04-30,Fresno,019,978130,232476,232067,23763,255830,2748
2022-04-30,Glenn,021,27897,4999,4995,1615,6610,48
2022-04-30,Humboldt,023,135768,17373,17194,3079,20273,145
2022-04-30,Imperial,025,180216,55610,55503,10609,66112,910
2022-04-30,Inyo,027,18085,4091,4084,499,4583,56
2022-04-30,Kern,029,883053,192576,192250,45979,238229,2265
2022-04-30,Kings,031,150075,51650,51640,3517,55157,447
2022-04-30,Lake,033,64148,10779,10742,894,11636,137
2022-04-30,Lassen,035,31185,8973,8966,875,9841,65
2022-04-30,Los Angeles,037,10098052,2751317,2736900,126197,2863097,31712
2022-04-30,Madera,039,155013,37415,37360,6061,43421,365
2022-04-30,Marin,041,260295,34809,34519,2863,37382,291
2022-04-30,Mariposa,043,17540,2440,2430,203,2633,30
2022-04-30,Mendocino,045,87422,13254,13219,3132,16351,123
2022-04-30,Merced,047,269075,62483,62357,8712,71069,818
2022-04-30,Modoc,049,8938,741,745,253,998,8
2022-04-30,Mono,051,14174,2992,2989,129,3118,6
2022-04-30,Monterey,053,433212,80232,79881,14055,93936,731
2022-04-30,Napa,055,140530,26493,26319,1037,27356,143
2022-04-30,Nevada,057,99092,16155,16100,1228,17328,127
2022-04-30,Orange,059,3164182,553599,551822,42233,594055,6998
2022-04-30,Placer,061,380077,63536,63273,7440,70713,625
2022-04-30,Plumas,063,18699,2990,2946,366,3312,13
2022-04-30,Riverside,065,2383286,595848,593965,28151,622116,6457
2022-04-30,Sacramento,067,1510023,284061,283048,26786,309834,3007
2022-04-30,San Benito,069,59416,13003,12988,525,13513,98
2022-04-30,San Bernardino,071,2135413,573983,568758,24931,593689,7191
2022-04-30,San Diego,073,3302833,761849,761253,53775,815028,5238
2022-04-30,San Francisco,075,870044,131876,130241,8715,138956,860
2022-04-30,San Joaquin,077,732212,167685,167028,10059,177087,2225
2022-04-30,San Luis Obispo,079,281455,53178,53040,3880,56920,477
2022-04-30,San Mateo,081,765935,127022,125807,7449,133256,705
2022-04-30,Santa Barbara,083,443738,87120,86768,4787,91555,688
2022-04-30,Santa Clara,085,1922200,322211,320709,12966,333675,2281
2022-04-30,Santa Cruz,087,273765,49637,48798,2169,50967,262
2022-04-30,Shasta,089,179085,30715,30649,6114,36763,554
2022-04-30,Sierra,091,2930,274,274,49,323,4
2022-04-30,Siskiyou,093,43540,4472,4458,2745,7203,81
2022-04-30,Solano,095,438530,82979,82459,5677,88136,449
2022-04-30,Sonoma,097,501317,85910,85290,2908,88198,488
2022-04-30,Stanislaus,099,539301,118202,117943,17710,135653,1643
2022-04-30,Sutter,101,95872,20601,20644,2104,22748,224
2022-04-30,Tehama,103,63373,12079,12078,2586,14664,202
2022-04-30,Trinity,105,12862,1186,1179,288,1467,20
2022-04-30,Tulare,107,460477,106682,106856,27743,134599,1458
2022-04-30,Tuolumne,109,53932,12800,12713,576,13289,181
2022-04-30,Ventura,111,848112,175239,174679,9665,184344,1486
2022-04-30,Yolo,113,214977,38088,37173,3108,40281,314
2022-04-30,Yuba,115,75493,15943,15917,1214,17131,121
2022-04-29,Alameda,001,1643700,264743,262027,14427,276454,1851
2022-04-29,Alpine,003,1148,124,124,1,125,0
2022-04-29,Amador,005,37829,8581,8533,658,9191,86
2022-04-29,Butte,007,227075,33350,33172,7040,40212,418
2022-04-29,Calaveras,009,45235,7342,7328,355,7683,120
2022-04-29,Colusa,011,21464,3455,3457,1049,4506,21
2022-04-29,Contra Costa,013,1133247,194071,192136,13648,205784,1301
2022-04-29,Del Norte,015,27424,5885,5841,191,6032,50
2022-04-29,El Dorado,017,186661,27072,26946,3249,30195,210
2022-04-29,Fresno,019,978130,232425,232067,23755,255822,2748
2022-04-29,Glenn,021,27897,4999,4995,1614,6609,48
2022-04-29,Humboldt,023,135768,17348,17194,3071,20265,145
2022-04-29,Imperial,025,180216,55594,55503,10608,66111,910
2022-04-29,Inyo,027,18085,4091,4084,497,4581,56
2022-04-29,Kern,029,883053,192549,192250,45967,238217,2265
2022-04-29,Kings,031,150075,51645,51640,3517,55157,447
2022-04-29,Lake,033,64148,10778,10742,894,11636,137
2022-04-29,Lassen,035,31185,8972,8966,875,9841,65
2022-04-29,Los Angeles,037,10098052,2750012,2736900,126047,2862947,31712
2022-04-29,Madera,039,155013,37405,37360,6060,43420,365
2022-04-29,Marin,041,260295,34743,34519,2843,37362,291
2022-04-29,Mariposa,043,17540,2438,2430,203,2633,30
2022-04-29,Mendocino,045,87422,13249,13219,3131,16350,123
2022-04-29,Merced,047,269075,62471,62357,8711,71068,818
2022-04-29,Modoc,049,8938,741,745,253,998,8
2022-04-29,Mono,051,14174,2992,2989,129,3118,6
2022-04-29,Monterey,053,433212,80198,79881,14041,93922,731
2022-04-29,Napa,055,140530,26465,26319,1035,27354,143
2022-04-29,Nevada,057,99092,16148,16100,1227,17327,127
2022-04-29,Orange,059,3164182,553334,551822,42188,594010,6998
2022-04-29,Placer,061,380077,63507,63273,7433,70706,625
2022-04-29,Plumas,063,18699,2989,2946,366,3312,13
2022-04-29,Riverside,065,2383286,595628,593965,28130,622095,6457
2022-04-29,Sacramento,067,1510023,283914,283048,26778,309826,3007
2022-04-29,San Benito,069,59416,12998,12988,525,13513,98
2022-04-29,San Bernardino,071,2135413,573826,568758,24921,593679,7191
2022-04-29,San Diego,073,3302833,761430,761253,53750,815003,5238
2022-04-29,San Francisco,075,870044,131654,130241,8695,138936,860
2022-04-29,San Joaquin,077,732212,167630,167028,10055,177083,2225
2022-04-29,San Luis Obispo,079,281455,53163,53040,3875,56915,477
2022-04-29,San Mateo,081,765935,126824,125807,7435,133242,705
2022-04-29,Santa Barbara,083,443738,87080,86768,4785,91553,688
2022-04-29,Santa Clara,085,1922200,321703,320709,12936,333645,2281
2022-04-29,Santa Cruz,087,273765,49581,48798,2165,50963,262
2022-04-29,Shasta,089,179085,30713,30649,6113,36762,554
2022-04-29,Sierra,091,2930,274,274,49,323,4
2022-04-29,Siskiyou,093,43540,4471,4458,2745,7203,81
2022-04-29,Solano,095,438530,82922,82459,5672,88131,449
2022-04-29,Sonoma,097,501317,85802,85290,2894,88184,488
2022-04-29,Stanislaus,099,539301,118179,117943,17705,135648,1643
2022-04-29,Sutter,101,95872,20594,20644,2103,22747,224
2022-04-29,Tehama,103,63373,12077,12078,2586,14664,202
2022-04-29,Trinity,105,12862,1186,1179,288,1467,20
2022-04-29,Tulare,107,460477,106664,106856,27727,134583,1458
2022-04-29,Tuolumne,109,53932,12793,12713,573,13286,181
2022-04-29,Ventura,111,848112,175163,174679,9643,184322,1486
2022-04-29,Yolo,113,214977,38053,37173,3105,40278,314
2022-04-29,Yuba,115,75493,15938,15917,1214,17131,121
2022-04-28,Alameda,001,1643700,264303,262027,14391,276418,1851
2022-04-28,Alpine,003,1148,124,124,1,125,0
2022-04-28,Amador,005,37829,8578,8533,658,9191,86
2022-04-28,Butte,007,227075,33341,33172,7034,40206,418
2022-04-28,Calaveras,009,45235,7338,7328,355,7683,120
2022-04-28,Colusa,011,21464,3454,3457,1049,4506,21
2022-04-28,Contra Costa,013,1133247,193815,192136,13607,205743,1301
2022-04-28,Del Norte,015,27424,5881,5841,191,6032,50
2022-04-28,El Dorado,017,186661,27050,26946,3245,30191,210
2022-04-28,Fresno,019,978130,232366,232067,23746,255813,2748
2022-04-28,Glenn,021,27897,4996,4995,1614,6609,48
2022-04-28,Humboldt,023,135768,17314,17194,3055,20249,145
2022-04-28,Imperial,025,180216,55582,55503,10603,66106,910
2022-04-28,Inyo,027,18085,4091,4084,497,4581,56
2022-04-28,Kern,029,883053,192510,192250,45953,238203,2265
2022-04-28,Kings,031,150075,51639,51640,3517,55157,447
2022-04-28,Lake,033,64148,10774,10742,894,11636,137
2022-04-28,Lassen,035,31185,8972,8966,875,9841,65
2022-04-28,Los Angeles,037,10098052,2747947,2736900,125866,2862766,31712
2022-04-28,Madera,039,155013,37399,37360,6057,43417,365
2022-04-28,Marin,041,260295,34693,34519,2828,37347,291
2022-04-28,Mariposa,043,17540,2438,2430,203,2633,30
2022-04-28,Mendocino,045,87422,13238,13219,3114,16333,123
2022-04-28,Merced,047,269075,62453,62357,8703,71060,818
2022-04-28,Modoc,049,8938,741,745,253,998,8
2022-04-28,Mono,051,14174,2990,2989,129,3118,6
2022-04-28,Monterey,053,433212,80159,79881,14017,93898,731
2022-04-28,Napa,055,140530,26435,26319,1032,27351,143
2022-04-28,Nevada,057,99092,16140,16100,1224,17324,127
2022-04-28,Orange,059,3164182,552973,551822,42127,593949,6998
2022-04-28,Placer,061,380077,63460,63273,7425,70698,625
2022-04-28,Plumas,063,18699,2988,2946,366,3312,13
2022-04-28,Riverside,065,2383286,595345,593965,28108,622073,6457
2022-04-28,Sacramento,067,1510023,283732,283048,26739,309787,3007
2022-04-28,San Benito,069,59416,12989,12988,523,13511,98
2022-04-28,San Bernardino,071,2135413,573626,568758,24913,593671,7191
2022-04-28,San Diego,073,3302833,760887,761253,53687,814940,5238
2022-04-28,San Francisco,075,870044,131352,130241,8661,138902,860
2022-04-28,San Joaquin,077,732212,167559,167028,10041,177069,2225
2022-04-28,San Luis Obispo,079,281455,53135,53040,3857,56897,477
2022-04-28,San Mateo,081,765935,126579,125807,7408,133215,705
2022-04-28,Santa Barbara,083,443738,87027,86768,4782,91550,688
2022-04-28,Santa Clara,085,1922200,321162,320709,12902,333611,2281
2022-04-28,Santa Cruz,087,273765,49484,48798,2159,50957,262
2022-04-28,Shasta,089,179085,30705,30649,6113,36762,554
2022-04-28,Sierra,091,2930,274,274,49,323,4
2022-04-28,Siskiyou,093,43540,4468,4458,2745,7203,81
2022-04-28,Solano,095,438530,82838,82459,5667,88126,449
2022-04-28,Sonoma,097,501317,85687,85290,2881,88171,488
2022-04-28,Stanislaus,099,539301,118141,117943,17698,135641,1643
2022-04-28,Sutter,101,95872,20584,20644,2100,22744,224
2022-04-28,Tehama,103,63373,12076,12078,2585,14663,202
2022-04-28,Trinity,105,12862,1186,1179,288,1467,20
2022-04-28,Tulare,107,460477,106642,106856,27717,134573,1458
2022-04-28,Tuolumne,109,53932,12781,12713,572,13285,181
2022-04-28,Ventura,111,848112,175074,174679,9607,184286,1486
2022-04-28,Yolo,113,214977,38006,37173,3102,40275,314
2022-04-28,Yuba,115,75493,15929,15917,1212,17129,121
2022-04-27,Alameda,001,1643700,263820,260871,14346,275217,1843
2022-04-27,Alpine,003,1148,124,124,1,125,0
2022-04-27,Amador,005,37829,8577,8518,658,9176,86
2022-04-27,Butte,007,227075,33329,33118,7029,40147,411
2022-04-27,Calaveras,009,45235,7335,7307,355,7662,119
2022-04-27,Colusa,011,21464,3453,3457,1049,4506,21
2022-04-27,Contra Costa,013,1133247,193550,191412,13577,204989,1300
2022-04-27,Del Norte,015,27424,5876,5833,191,6024,50
2022-04-27,El Dorado,017,186661,27039,26898,3240,30138,209
2022-04-27,Fresno,019,978130,232300,231951,23732,255683,2744
2022-04-27,Glenn,021,27897,4996,4993,1614,6607,48
2022-04-27,Humboldt,023,135768,17284,17138,3044,20182,145
2022-04-27,Imperial,025,180216,55564,55480,10599,66079,910
2022-04-27,Inyo,027,18085,4090,4080,496,4576,56
2022-04-27,Kern,029,883053,192474,192157,45934,238091,2271
2022-04-27,Kings,031,150075,51634,51617,3516,55133,444
2022-04-27,Lake,033,64148,10770,10732,894,11626,135
2022-04-27,Lassen,035,31185,8971,8965,875,9840,65
2022-04-27,Los Angeles,037,10098052,2745616,2731988,125681,2857669,31691
2022-04-27,Madera,039,155013,37390,37339,6056,43395,354
2022-04-27,Marin,041,260295,34632,34354,2814,37168,288
2022-04-27,Mariposa,043,17540,2436,2427,203,2630,30
2022-04-27,Mendocino,045,87422,13231,13188,3106,16294,123
2022-04-27,Merced,047,269075,62439,62315,8699,71014,815
2022-04-27,Modoc,049,8938,741,745,253,998,8
2022-04-27,Mono,051,14174,2990,2989,129,3118,6
2022-04-27,Monterey,053,433212,80117,79695,13977,93672,729
2022-04-27,Napa,055,140530,26406,26210,1027,27237,143
2022-04-27,Nevada,057,99092,16124,16080,1221,17301,127
2022-04-27,Orange,059,3164182,552600,550859,42069,592928,6991
2022-04-27,Placer,061,380077,63417,63154,7409,70563,623
2022-04-27,Plumas,063,18699,2987,2934,366,3300,13
2022-04-27,Riverside,065,2383286,595080,593397,28092,621489,6453
2022-04-27,Sacramento,067,1510023,283531,281802,26707,308509,3001
2022-04-27,San Benito,069,59416,12976,12989,521,13510,98
2022-04-27,San Bernardino,071,2135413,573428,568018,24906,592924,7105
2022-04-27,San Diego,073,3302833,760314,759873,53625,813498,5236
2022-04-27,San Francisco,075,870044,131000,129284,8637,137921,857
2022-04-27,San Joaquin,077,732212,167484,166848,10026,176874,2225
2022-04-27,San Luis Obispo,079,281455,53090,52911,3846,56757,476
2022-04-27,San Mateo,081,765935,126349,125018,7355,132373,702
2022-04-27,Santa Barbara,083,443738,86963,86557,4775,91332,685
2022-04-27,Santa Clara,085,1922200,320595,319077,12855,331932,2282
2022-04-27,Santa Cruz,087,273765,49401,48500,2151,50651,262
2022-04-27,Shasta,089,179085,30693,30633,6110,36743,554
2022-04-27,Sierra,091,2930,273,276,49,325,4
2022-04-27,Siskiyou,093,43540,4468,4455,2741,7196,81
2022-04-27,Solano,095,438530,82726,82220,5659,87879,448
2022-04-27,Sonoma,097,501317,85578,84983,2862,87845,487
2022-04-27,Stanislaus,099,539301,118098,117841,17688,135529,1643
2022-04-27,Sutter,101,95872,20580,20627,2096,22723,224
2022-04-27,Tehama,103,63373,12076,12073,2585,14658,201
2022-04-27,Trinity,105,12862,1186,1179,288,1467,20
2022-04-27,Tulare,107,460477,106623,106580,27708,134288,1453
2022-04-27,Tuolumne,109,53932,12764,12684,571,13255,181
2022-04-27,Ventura,111,848112,174971,174425,9592,184017,1480
2022-04-27,Yolo,113,214977,37955,37096,3096,40192,314
2022-04-27,Yuba,115,75493,15925,15902,1207,17109,121
2022-04-26,Alameda,001,1643700,263306,260871,14306,275177,1843
2022-04-26,Alpine,003,1148,124,124,1,125,0
2022-04-26,Amador,005,37829,8574,8518,657,9175,86
2022-04-26,Butte,007,227075,33313,33118,7022,40140,411
2022-04-26,Calaveras,009,45235,7331,7307,354,7661,119
2022-04-26,Colusa,011,21464,3453,3457,1049,4506,21
2022-04-26,Contra Costa,013,1133247,193290,191412,13540,204952,1300
2022-04-26,Del Norte,015,27424,5868,5833,191,6024,50
2022-04-26,El Dorado,017,186661,27018,26898,3236,30134,209
2022-04-26,Fresno,019,978130,232221,231951,23722,255673,2744
2022-04-26,Glenn,021,27897,4996,4993,1613,6606,48
2022-04-26,Humboldt,023,135768,17253,17138,3038,20176,145
2022-04-26,Imperial,025,180216,55544,55480,10594,66074,910
2022-04-26,Inyo,027,18085,4090,4080,496,4576,56
2022-04-26,Kern,029,883053,192426,192157,45910,238067,2271
2022-04-26,Kings,031,150075,51628,51617,3516,55133,444
2022-04-26,Lake,033,64148,10763,10732,894,11626,135
2022-04-26,Lassen,035,31185,8966,8965,875,9840,65
2022-04-26,Los Angeles,037,10098052,2743226,2731988,125496,2857484,31691
2022-04-26,Madera,039,155013,37382,37339,6049,43388,354
2022-04-26,Marin,041,260295,34579,34354,2795,37149,288
2022-04-26,Mariposa,043,17540,2436,2427,203,2630,30
2022-04-26,Mendocino,045,87422,13227,13188,3100,16288,123
2022-04-26,Merced,047,269075,62416,62315,8682,70997,815
2022-04-26,Modoc,049,8938,741,745,253,998,8
2022-04-26,Mono,051,14174,2990,2989,128,3117,6
2022-04-26,Monterey,053,433212,80063,79695,13938,93633,729
2022-04-26,Napa,055,140530,26376,26210,1023,27233,143
2022-04-26,Nevada,057,99092,16115,16080,1221,17301,127
2022-04-26,Orange,059,3164182,552193,550859,42012,592871,6991
2022-04-26,Placer,061,380077,63386,63154,7407,70561,623
2022-04-26,Plumas,063,18699,2987,2934,366,3300,13
2022-04-26,Riverside,065,2383286,594771,593397,28066,621463,6453
2022-04-26,Sacramento,067,1510023,283295,281802,26685,308487,3001
2022-04-26,San Benito,069,59416,12972,12989,520,13509,98
2022-04-26,San Bernardino,071,2135413,573218,568018,24892,592910,7105
2022-04-26,San Diego,073,3302833,759655,759873,53523,813396,5236
2022-04-26,San Francisco,075,870044,130600,129284,8614,137898,857
2022-04-26,San Joaquin,077,732212,167422,166848,10016,176864,2225
2022-04-26,San Luis Obispo,079,281455,53061,52911,3835,56746,476
2022-04-26,San Mateo,081,765935,126079,125018,7321,132339,702
2022-04-26,Santa Barbara,083,443738,86902,86557,4770,91327,685
2022-04-26,Santa Clara,085,1922200,320036,319077,12809,331886,2282
2022-04-26,Santa Cruz,087,273765,49301,48500,2148,50648,262
2022-04-26,Shasta,089,179085,30681,30633,6110,36743,554
2022-04-26,Sierra,091,2930,273,276,49,325,4
2022-04-26,Siskiyou,093,43540,4466,4455,2739,7194,81
2022-04-26,Solano,095,438530,82627,82220,5648,87868,448
2022-04-26,Sonoma,097,501317,85472,84983,2848,87831,487
2022-04-26,Stanislaus,099,539301,118062,117841,17678,135519,1643
2022-04-26,Sutter,101,95872,20570,20627,2096,22723,224
2022-04-26,Tehama,103,63373,12067,12073,2585,14658,201
2022-04-26,Trinity,105,12862,1186,1179,288,1467,20
2022-04-26,Tulare,107,460477,106595,106580,27694,134274,1453
2022-04-26,Tuolumne,109,53932,12745,12684,569,13253,181
2022-04-26,Ventura,111,848112,174860,174425,9567,183992,1480
2022-04-26,Yolo,113,214977,37886,37096,3091,40187,314
2022-04-26,Yuba,115,75493,15923,15902,1207,17109,121
2022-04-25,Alameda,001,1643700,262797,260871,14265,275136,1843
2022-04-25,Alpine,003,1148,124,124,1,125,0
2022-04-25,Amador,005,37829,8571,8518,657,9175,86
2022-04-25,Butte,007,227075,33298,33118,7013,40131,411
2022-04-25,Calaveras,009,45235,7328,7307,354,7661,119
2022-04-25,Colusa,011,21464,3453,3457,1049,4506,21
2022-04-25,Contra Costa,013,1133247,193023,191412,13503,204915,1300
2022-04-25,Del Norte,015,27424,5862,5833,189,6022,50
2022-04-25,El Dorado,017,186661,26997,26898,3234,30132,209
2022-04-25,Fresno,019,978130,232130,231951,23709,255660,2744
2022-04-25,Glenn,021,27897,4995,4993,1613,6606,48
2022-04-25,Humboldt,023,135768,17211,17138,3030,20168,145
2022-04-25,Imperial,025,180216,55524,55480,10589,66069,910
2022-04-25,Inyo,027,18085,4090,4080,496,4576,56
2022-04-25,Kern,029,883053,192382,192157,45892,238049,2271
2022-04-25,Kings,031,150075,51619,51617,3515,55132,444
2022-04-25,Lake,033,64148,10760,10732,893,11625,135
2022-04-25,Lassen,035,31185,8965,8965,875,9840,65
2022-04-25,Los Angeles,037,10098052,2740841,2731988,125330,2857318,31691
2022-04-25,Madera,039,155013,37369,37339,6045,43384,354
2022-04-25,Marin,041,260295,34515,34354,2771,37125,288
2022-04-25,Mariposa,043,17540,2436,2427,202,2629,30
2022-04-25,Mendocino,045,87422,13217,13188,3083,16271,123
2022-04-25,Merced,047,269075,62403,62315,8680,70995,815
2022-04-25,Modoc,049,8938,741,745,253,998,8
2022-04-25,Mono,051,14174,2990,2989,128,3117,6
2022-04-25,Monterey,053,433212,80025,79695,13913,93608,729
2022-04-25,Napa,055,140530,26336,26210,1021,27231,143
2022-04-25,Nevada,057,99092,16109,16080,1219,17299,127
2022-04-25,Orange,059,3164182,551786,550859,41951,592810,6991
2022-04-25,Placer,061,380077,63350,63154,7402,70556,623
2022-04-25,Plumas,063,18699,2985,2934,366,3300,13
2022-04-25,Riverside,065,2383286,594506,593397,28049,621446,6453
2022-04-25,Sacramento,067,1510023,283130,281802,26652,308454,3001
2022-04-25,San Benito,069,59416,12965,12989,520,13509,98
2022-04-25,San Bernardino,071,2135413,572993,568018,24875,592893,7105
2022-04-25,San Diego,073,3302833,758972,759873,53450,813323,5236
2022-04-25,San Francisco,075,870044,130239,129284,8598,137882,857
2022-04-25,San Joaquin,077,732212,167338,166848,10002,176850,2225
2022-04-25,San Luis Obispo,079,281455,53012,52911,3827,56738,476
2022-04-25,San Mateo,081,765935,125807,125018,7301,132319,702
2022-04-25,Santa Barbara,083,443738,86841,86557,4764,91321,685
2022-04-25,Santa Clara,085,1922200,319390,319077,12764,331841,2282
2022-04-25,Santa Cruz,087,273765,49160,48500,2139,50639,262
2022-04-25,Shasta,089,179085,30669,30633,6107,36740,554
2022-04-25,Sierra,091,2930,273,276,49,325,4
2022-04-25,Siskiyou,093,43540,4466,4455,2738,7193,81
2022-04-25,Solano,095,438530,82509,82220,5637,87857,448
2022-04-25,Sonoma,097,501317,85349,84983,2829,87812,487
2022-04-25,Stanislaus,099,539301,118017,117841,17671,135512,1643
2022-04-25,Sutter,101,95872,20567,20627,2096,22723,224
2022-04-25,Tehama,103,63373,12067,12073,2585,14658,201
2022-04-25,Trinity,105,12862,1185,1179,288,1467,20
2022-04-25,Tulare,107,460477,106570,106580,27684,134264,1453
2022-04-25,Tuolumne,109,53932,12736,12684,569,13253,181
2022-04-25,Ventura,111,848112,174750,174425,9544,183969,1480
2022-04-25,Yolo,113,214977,37800,37096,3087,40183,314
2022-04-25,Yuba,115,75493,15913,15902,1206,17108,121
2022-04-24,Alameda,001,1643700,262214,259619,14220,273839,1837
2022-04-24,Alpine,003,1148,124,124,1,125,0
2022-04-24,Amador,005,37829,8562,8509,656,9165,86
2022-04-24,Butte,007,227075,33276,33105,7006,40111,411
2022-04-24,Calaveras,009,45235,7319,7296,352,7648,119
2022-04-24,Colusa,011,21464,3452,3453,1049,4502,21
2022-04-24,Contra Costa,013,1133247,192716,190611,13470,204081,1298
2022-04-24,Del Norte,015,27424,5853,5827,187,6014,50
2022-04-24,El Dorado,017,186661,26979,26837,3232,30069,209
2022-04-24,Fresno,019,978130,232049,231751,23694,255445,2744
2022-04-24,Glenn,021,27897,4995,4989,1611,6600,48
2022-04-24,Humboldt,023,135768,17186,17033,3016,20049,145
2022-04-24,Imperial,025,180216,55512,55434,10581,66015,910
2022-04-24,Inyo,027,18085,4086,4079,495,4574,56
2022-04-24,Kern,029,883053,192330,192012,45878,237890,2267
2022-04-24,Kings,031,150075,51610,51588,3515,55103,444
2022-04-24,Lake,033,64148,10752,10720,890,11610,134
2022-04-24,Lassen,035,31185,8964,8966,875,9841,65
2022-04-24,Los Angeles,037,10098052,2738491,2725630,125183,2850813,31667
2022-04-24,Madera,039,155013,37354,37333,6039,43372,354
2022-04-24,Marin,041,260295,34461,34150,2737,36887,288
2022-04-24,Mariposa,043,17540,2433,2422,202,2624,30
2022-04-24,Mendocino,045,87422,13212,13158,3071,16229,122
2022-04-24,Merced,047,269075,62380,62286,8672,70958,815
2022-04-24,Modoc,049,8938,741,745,253,998,8
2022-04-24,Mono,051,14174,2988,2986,128,3114,6
2022-04-24,Monterey,053,433212,79972,79560,13880,93440,729
2022-04-24,Napa,055,140530,26300,26093,1020,27113,143
2022-04-24,Nevada,057,99092,16093,16052,1217,17269,127
2022-04-24,Orange,059,3164182,551365,549765,41891,591656,6989
2022-04-24,Placer,061,380077,63295,63037,7394,70431,622
2022-04-24,Plumas,063,18699,2983,2934,366,3300,13
2022-04-24,Riverside,065,2383286,594228,592683,28014,620697,6450
2022-04-24,Sacramento,067,1510023,282923,280551,26618,307169,2993
2022-04-24,San Benito,069,59416,12960,12966,520,13486,98
2022-04-24,San Bernardino,071,2135413,572760,566806,24853,591659,7047
2022-04-24,San Diego,073,3302833,758341,758311,53388,811699,5233
2022-04-24,San Francisco,075,870044,129793,128323,8573,136896,857
2022-04-24,San Joaquin,077,732212,167251,166626,9966,176592,2224
2022-04-24,San Luis Obispo,079,281455,52936,52826,3816,56642,476
2022-04-24,San Mateo,081,765935,125499,124106,7267,131373,703
2022-04-24,Santa Barbara,083,443738,86772,86376,4762,91138,685
2022-04-24,Santa Clara,085,1922200,318705,317487,12711,330198,2277
2022-04-24,Santa Cruz,087,273765,49048,48255,2133,50388,261
2022-04-24,Shasta,089,179085,30657,30607,6105,36712,557
2022-04-24,Sierra,091,2930,273,276,49,325,4
2022-04-24,Siskiyou,093,43540,4464,4453,2736,7189,81
2022-04-24,Solano,095,438530,82402,81982,5628,87610,448
2022-04-24,Sonoma,097,501317,85213,84581,2808,87389,486
2022-04-24,Stanislaus,099,539301,117966,117737,17666,135403,1632
2022-04-24,Sutter,101,95872,20558,20605,2093,22698,224
2022-04-24,Tehama,103,63373,12063,12064,2585,14649,201
2022-04-24,Trinity,105,12862,1185,1177,288,1465,20
2022-04-24,Tulare,107,460477,106543,106354,27673,134027,1446
2022-04-24,Tuolumne,109,53932,12723,12664,568,13232,181
2022-04-24,Ventura,111,848112,174638,174091,9523,183614,1479
2022-04-24,Yolo,113,214977,37751,36990,3084,40074,314
2022-04-24,Yuba,115,75493,15909,15888,1206,17094,121
2022-04-23,Alameda,001,1643700,261970,259619,14207,273826,1837
2022-04-23,Alpine,003,1148,124,124,1,125,0
2022-04-23,Amador,005,37829,8556,8509,656,9165,86
2022-04-23,Butte,007,227075,33267,33105,7003,40108,411
2022-04-23,Calaveras,009,45235,7311,7296,352,7648,119
2022-04-23,Colusa,011,21464,3452,3453,1049,4502,21
2022-04-23,Contra Costa,013,1133247,192560,190611,13452,204063,1298
2022-04-23,Del Norte,015,27424,5851,5827,186,6013,50
2022-04-23,El Dorado,017,186661,26969,26837,3231,30068,209
2022-04-23,Fresno,019,978130,232016,231751,23688,255439,2744
2022-04-23,Glenn,021,27897,4995,4989,1611,6600,48
2022-04-23,Humboldt,023,135768,17170,17033,3013,20046,145
2022-04-23,Imperial,025,180216,55501,55434,10580,66014,910
2022-04-23,Inyo,027,18085,4086,4079,494,4573,56
2022-04-23,Kern,029,883053,192302,192012,45864,237876,2267
2022-04-23,Kings,031,150075,51605,51588,3514,55102,444
2022-04-23,Lake,033,64148,10751,10720,890,11610,134
2022-04-23,Lassen,035,31185,8964,8966,875,9841,65
2022-04-23,Los Angeles,037,10098052,2737555,2725630,125088,2850718,31667
2022-04-23,Madera,039,155013,37347,37333,6038,43371,354
2022-04-23,Marin,041,260295,34426,34150,2691,36841,288
2022-04-23,Mariposa,043,17540,2433,2422,202,2624,30
2022-04-23,Mendocino,045,87422,13205,13158,3071,16229,122
2022-04-23,Merced,047,269075,62370,62286,8672,70958,815
2022-04-23,Modoc,049,8938,741,745,253,998,8
2022-04-23,Mono,051,14174,2988,2986,128,3114,6
2022-04-23,Monterey,053,433212,79903,79560,13865,93425,729
2022-04-23,Napa,055,140530,26279,26093,1018,27111,143
2022-04-23,Nevada,057,99092,16087,16052,1215,17267,127
2022-04-23,Orange,059,3164182,551149,549765,41843,591608,6989
2022-04-23,Placer,061,380077,63265,63037,7394,70431,622
2022-04-23,Plumas,063,18699,2983,2934,366,3300,13
2022-04-23,Riverside,065,2383286,594091,592683,28004,620687,6450
2022-04-23,Sacramento,067,1510023,282824,280551,26615,307166,2993
2022-04-23,San Benito,069,59416,12959,12966,520,13486,98
2022-04-23,San Bernardino,071,2135413,572643,566806,24850,591656,7047
2022-04-23,San Diego,073,3302833,758079,758311,53370,811681,5233
2022-04-23,San Francisco,075,870044,129590,128323,8548,136871,857
2022-04-23,San Joaquin,077,732212,167210,166626,9958,176584,2224
2022-04-23,San Luis Obispo,079,281455,52921,52826,3812,56638,476
2022-04-23,San Mateo,081,765935,125341,124106,7257,131363,703
2022-04-23,Santa Barbara,083,443738,86736,86376,4761,91137,685
2022-04-23,Santa Clara,085,1922200,318327,317487,12684,330171,2277
2022-04-23,Santa Cruz,087,273765,48998,48255,2131,50386,261
2022-04-23,Shasta,089,179085,30654,30607,6105,36712,557
2022-04-23,Sierra,091,2930,273,276,49,325,4
2022-04-23,Siskiyou,093,43540,4462,4453,2736,7189,81
2022-04-23,Solano,095,438530,82375,81982,5625,87607,448
2022-04-23,Sonoma,097,501317,85145,84581,2799,87380,486
2022-04-23,Stanislaus,099,539301,117930,117737,17664,135401,1632
2022-04-23,Sutter,101,95872,20552,20605,2093,22698,224
2022-04-23,Tehama,103,63373,12062,12064,2585,14649,201
2022-04-23,Trinity,105,12862,1185,1177,288,1465,20
2022-04-23,Tulare,107,460477,106535,106354,27664,134018,1446
2022-04-23,Tuolumne,109,53932,12718,12664,568,13232,181
2022-04-23,Ventura,111,848112,174576,174091,9517,183608,1479
2022-04-23,Yolo,113,214977,37719,36990,3080,40070,314
2022-04-23,Yuba,115,75493,15907,15888,1206,17094,121
2022-04-22,Alameda,001,1643700,261733,259619,14188,273807,1837
2022-04-22,Alpine,003,1148,124,124,1,125,0
2022-04-22,Amador,005,37829,8555,8509,654,9163,86
2022-04-22,Butte,007,227075,33260,33105,6998,40103,411
2022-04-22,Calaveras,009,45235,7310,7296,352,7648,119
2022-04-22,Colusa,011,21464,3452,3453,1049,4502,21
2022-04-22,Contra Costa,013,1133247,192424,190611,13436,204047,1298
2022-04-22,Del Norte,015,27424,5851,5827,186,6013,50
2022-04-22,El Dorado,017,186661,26956,26837,3227,30064,209
2022-04-22,Fresno,019,978130,231986,231751,23684,255435,2744
2022-04-22,Glenn,021,27897,4994,4989,1611,6600,48
2022-04-22,Humboldt,023,135768,17154,17033,3007,20040,145
2022-04-22,Imperial,025,180216,55495,55434,10580,66014,910
2022-04-22,Inyo,027,18085,4086,4079,493,4572,56
2022-04-22,Kern,029,883053,192282,192012,45861,237873,2267
2022-04-22,Kings,031,150075,51601,51588,3513,55101,444
2022-04-22,Lake,033,64148,10750,10720,890,11610,134
2022-04-22,Lassen,035,31185,8964,8966,875,9841,65
2022-04-22,Los Angeles,037,10098052,2736458,2725630,125029,2850659,31667
2022-04-22,Madera,039,155013,37342,37333,6037,43370,354
2022-04-22,Marin,041,260295,34389,34150,2680,36830,288
2022-04-22,Mariposa,043,17540,2432,2422,202,2624,30
2022-04-22,Mendocino,045,87422,13200,13158,3066,16224,122
2022-04-22,Merced,047,269075,62363,62286,8661,70947,815
2022-04-22,Modoc,049,8938,741,745,253,998,8
2022-04-22,Mono,051,14174,2988,2986,127,3113,6
2022-04-22,Monterey,053,433212,79868,79560,13851,93411,729
2022-04-22,Napa,055,140530,26262,26093,1016,27109,143
2022-04-22,Nevada,057,99092,16087,16052,1215,17267,127
2022-04-22,Orange,059,3164182,550964,549765,41792,591557,6989
2022-04-22,Placer,061,380077,63242,63037,7391,70428,622
2022-04-22,Plumas,063,18699,2983,2934,366,3300,13
2022-04-22,Riverside,065,2383286,593947,592683,27989,620672,6450
2022-04-22,Sacramento,067,1510023,282736,280551,26603,307154,2993
2022-04-22,San Benito,069,59416,12954,12966,520,13486,98
2022-04-22,San Bernardino,071,2135413,572530,566806,24842,591648,7047
2022-04-22,San Diego,073,3302833,757759,758311,53342,811653,5233
2022-04-22,San Francisco,075,870044,129427,128323,8522,136845,857
2022-04-22,San Joaquin,077,732212,167180,166626,9957,176583,2224
2022-04-22,San Luis Obispo,079,281455,52915,52826,3811,56637,476
2022-04-22,San Mateo,081,765935,125179,124106,7244,131350,703
2022-04-22,Santa Barbara,083,443738,86689,86376,4760,91136,685
2022-04-22,Santa Clara,085,1922200,317980,317487,12670,330157,2277
2022-04-22,Santa Cruz,087,273765,48959,48255,2130,50385,261
2022-04-22,Shasta,089,179085,30649,30607,6104,36711,557
2022-04-22,Sierra,091,2930,273,276,48,324,4
2022-04-22,Siskiyou,093,43540,4462,4453,2736,7189,81
2022-04-22,Solano,095,438530,82318,81982,5623,87605,448
2022-04-22,Sonoma,097,501317,85081,84581,2795,87376,486
2022-04-22,Stanislaus,099,539301,117908,117737,17659,135396,1632
2022-04-22,Sutter,101,95872,20546,20605,2093,22698,224
2022-04-22,Tehama,103,63373,12057,12064,2584,14648,201
2022-04-22,Trinity,105,12862,1185,1177,287,1464,20
2022-04-22,Tulare,107,460477,106525,106354,27656,134010,1446
2022-04-22,Tuolumne,109,53932,12712,12664,565,13229,181
2022-04-22,Ventura,111,848112,174500,174091,9506,183597,1479
2022-04-22,Yolo,113,214977,37698,36990,3078,40068,314
2022-04-22,Yuba,115,75493,15904,15888,1205,17093,121
2022-04-21,Alameda,001,1643700,261374,259619,14148,273767,1837
2022-04-21,Alpine,003,1148,124,124,1,125,0
2022-04-21,Amador,005,37829,8552,8509,654,9163,86
2022-04-21,Butte,007,227075,33252,33105,6990,40095,411
2022-04-21,Calaveras,009,45235,7307,7296,352,7648,119
2022-04-21,Colusa,011,21464,3451,3453,1049,4502,21
2022-04-21,Contra Costa,013,1133247,192229,190611,13415,204026,1298
2022-04-21,Del Norte,015,27424,5850,5827,186,6013,50
2022-04-21,El Dorado,017,186661,26940,26837,3226,30063,209
2022-04-21,Fresno,019,978130,231944,231751,23676,255427,2744
2022-04-21,Glenn,021,27897,4994,4989,1610,6599,48
2022-04-21,Humboldt,023,135768,17131,17033,2999,20032,145
2022-04-21,Imperial,025,180216,55486,55434,10580,66014,910
2022-04-21,Inyo,027,18085,4086,4079,493,4572,56
2022-04-21,Kern,029,883053,192249,192012,45846,237858,2267
2022-04-21,Kings,031,150075,51593,51588,3513,55101,444
2022-04-21,Lake,033,64148,10747,10720,890,11610,134
2022-04-21,Lassen,035,31185,8964,8966,875,9841,65
2022-04-21,Los Angeles,037,10098052,2734809,2725630,124915,2850545,31667
2022-04-21,Madera,039,155013,37339,37333,6036,43369,354
2022-04-21,Marin,041,260295,34341,34150,2670,36820,288
2022-04-21,Mariposa,043,17540,2431,2422,202,2624,30
2022-04-21,Mendocino,045,87422,13193,13158,3063,16221,122
2022-04-21,Merced,047,269075,62345,62286,8659,70945,815
2022-04-21,Modoc,049,8938,741,745,253,998,8
2022-04-21,Mono,051,14174,2987,2986,126,3112,6
2022-04-21,Monterey,053,433212,79841,79560,13837,93397,729
2022-04-21,Napa,055,140530,26231,26093,1015,27108,143
2022-04-21,Nevada,057,99092,16083,16052,1215,17267,127
2022-04-21,Orange,059,3164182,550710,549765,41756,591521,6989
2022-04-21,Placer,061,380077,63204,63037,7387,70424,622
2022-04-21,Plumas,063,18699,2983,2934,366,3300,13
2022-04-21,Riverside,065,2383286,593787,592683,27971,620654,6450
2022-04-21,Sacramento,067,1510023,282588,280551,26583,307134,2993
2022-04-21,San Benito,069,59416,12948,12966,520,13486,98
2022-04-21,San Bernardino,071,2135413,572339,566806,24830,591636,7047
2022-04-21,San Diego,073,3302833,757334,758311,53298,811609,5233
2022-04-21,San Francisco,075,870044,129204,128323,8494,136817,857
2022-04-21,San Joaquin,077,732212,167126,166626,9952,176578,2224
2022-04-21,San Luis Obispo,079,281455,52895,52826,3804,56630,476
2022-04-21,San Mateo,081,765935,124978,124106,7224,131330,703
2022-04-21,Santa Barbara,083,443738,86630,86376,4757,91133,685
2022-04-21,Santa Clara,085,1922200,317529,317487,12648,330135,2277
2022-04-21,Santa Cruz,087,273765,48914,48255,2128,50383,261
2022-04-21,Shasta,089,179085,30641,30607,6104,36711,557
2022-04-21,Sierra,091,2930,273,276,48,324,4
2022-04-21,Siskiyou,093,43540,4462,4453,2736,7189,81
2022-04-21,Solano,095,438530,82256,81982,5617,87599,448
2022-04-21,Sonoma,097,501317,84967,84581,2775,87356,486
2022-04-21,Stanislaus,099,539301,117869,117737,17651,135388,1632
2022-04-21,Sutter,101,95872,20537,20605,2091,22696,224
2022-04-21,Tehama,103,63373,12057,12064,2584,14648,201
2022-04-21,Trinity,105,12862,1185,1177,287,1464,20
2022-04-21,Tulare,107,460477,106518,106354,27652,134006,1446
2022-04-21,Tuolumne,109,53932,12707,12664,565,13229,181
2022-04-21,Ventura,111,848112,174417,174091,9500,183591,1479
2022-04-21,Yolo,113,214977,37659,36990,3078,40068,314
2022-04-21,Yuba,115,75493,15902,15888,1205,17093,121
2022-04-20,Alameda,001,1643700,261008,258734,14118,272852,1832
2022-04-20,Alpine,003,1148,124,124,1,125,0
2022-04-20,Amador,005,37829,8550,8494,654,9148,86
2022-04-20,Butte,007,227075,33243,33083,6983,40066,408
2022-04-20,Calaveras,009,45235,7301,7288,351,7639,119
2022-04-20,Colusa,011,21464,3451,3453,1049,4502,21
2022-04-20,Contra Costa,013,1133247,191995,190042,13390,203432,1299
2022-04-20,Del Norte,015,27424,5844,5814,186,6000,50
2022-04-20,El Dorado,017,186661,26925,26821,3221,30042,209
2022-04-20,Fresno,019,978130,231894,231568,23675,255243,2740
2022-04-20,Glenn,021,27897,4993,4988,1607,6595,48
2022-04-20,Humboldt,023,135768,17110,16976,2995,19971,145
2022-04-20,Imperial,025,180216,55478,55405,10577,65982,910
2022-04-20,Inyo,027,18085,4086,4075,492,4567,56
2022-04-20,Kern,029,883053,192214,191915,45830,237745,2262
2022-04-20,Kings,031,150075,51584,51571,3511,55082,445
2022-04-20,Lake,033,64148,10747,10711,890,11601,134
2022-04-20,Lassen,035,31185,8964,8951,875,9826,65
2022-04-20,Los Angeles,037,10098052,2733069,2721699,124796,2846495,31630
2022-04-20,Madera,039,155013,37336,37333,6033,43366,354
2022-04-20,Marin,041,260295,34300,33985,2647,36632,288
2022-04-20,Mariposa,043,17540,2429,2412,202,2614,30
2022-04-20,Mendocino,045,87422,13187,13128,3055,16183,122
2022-04-20,Merced,047,269075,62335,62322,8646,70968,813
2022-04-20,Modoc,049,8938,741,744,253,997,8
2022-04-20,Mono,051,14174,2987,2984,126,3110,6
2022-04-20,Monterey,053,433212,79796,79419,13818,93237,727
2022-04-20,Napa,055,140530,26197,26016,1011,27027,143
2022-04-20,Nevada,057,99092,16073,16034,1212,17246,127
2022-04-20,Orange,059,3164182,550382,549136,41709,590845,6963
2022-04-20,Placer,061,380077,63179,62928,7382,70310,619
2022-04-20,Plumas,063,18699,2983,2932,366,3298,13
2022-04-20,Riverside,065,2383286,593593,592224,27949,620173,6447
2022-04-20,Sacramento,067,1510023,282445,279326,26566,305892,2987
2022-04-20,San Benito,069,59416,12942,12971,517,13488,98
2022-04-20,San Bernardino,071,2135413,572132,565405,24813,590218,6977
2022-04-20,San Diego,073,3302833,756891,757138,53238,810376,5231
2022-04-20,San Francisco,075,870044,128897,127594,8476,136070,854
2022-04-20,San Joaquin,077,732212,167055,166531,9945,176476,2222
2022-04-20,San Luis Obispo,079,281455,52868,52740,3797,56537,476
2022-04-20,San Mateo,081,765935,124760,123279,7192,130471,701
2022-04-20,Santa Barbara,083,443738,86593,86214,4751,90965,685
2022-04-20,Santa Clara,085,1922200,317119,316355,12610,328965,2274
2022-04-20,Santa Cruz,087,273765,48851,47997,2124,50121,261
2022-04-20,Shasta,089,179085,30637,30590,6103,36693,554
2022-04-20,Sierra,091,2930,273,276,48,324,4
2022-04-20,Siskiyou,093,43540,4461,4446,2735,7181,80
2022-04-20,Solano,095,438530,82184,81841,5614,87455,447
2022-04-20,Sonoma,097,501317,84879,84429,2752,87181,485
2022-04-20,Stanislaus,099,539301,117833,117540,17640,135180,1630
2022-04-20,Sutter,101,95872,20530,20632,2091,22723,224
2022-04-20,Tehama,103,63373,12054,12061,2584,14645,199
2022-04-20,Trinity,105,12862,1185,1178,287,1465,20
2022-04-20,Tulare,107,460477,106510,105974,27641,133615,1439
2022-04-20,Tuolumne,109,53932,12702,12648,563,13211,180
2022-04-20,Ventura,111,848112,174329,173904,9491,183395,1475
2022-04-20,Yolo,113,214977,37591,36785,3075,39860,311
2022-04-20,Yuba,115,75493,15898,15868,1203,17071,121
2022-04-19,Alameda,001,1643700,260651,258734,14086,272820,1832
2022-04-19,Alpine,003,1148,124,124,1,125,0
2022-04-19,Amador,005,37829,8546,8494,651,9145,86
2022-04-19,Butte,007,227075,33236,33083,6979,40062,408
2022-04-19,Calaveras,009,45235,7298,7288,351,7639,119
2022-04-19,Colusa,011,21464,3451,3453,1049,4502,21
2022-04-19,Contra Costa,013,1133247,191749,190042,13372,203414,1299
2022-04-19,Del Norte,015,27424,5842,5814,184,5998,50
2022-04-19,El Dorado,017,186661,26910,26821,3218,30039,209
2022-04-19,Fresno,019,978130,231840,231568,23664,255232,2740
2022-04-19,Glenn,021,27897,4992,4988,1607,6595,48
2022-04-19,Humboldt,023,135768,17073,16976,2984,19960,145
2022-04-19,Imperial,025,180216,55471,55405,10574,65979,910
2022-04-19,Inyo,027,18085,4083,4075,492,4567,56
2022-04-19,Kern,029,883053,192178,191915,45820,237735,2262
2022-04-19,Kings,031,150075,51570,51571,3510,55081,445
2022-04-19,Lake,033,64148,10743,10711,889,11600,134
2022-04-19,Lassen,035,31185,8964,8951,875,9826,65
2022-04-19,Los Angeles,037,10098052,2731269,2721699,124670,2846369,31630
2022-04-19,Madera,039,155013,37333,37333,6032,43365,354
2022-04-19,Marin,041,260295,34250,33985,2631,36616,288
2022-04-19,Mariposa,043,17540,2429,2412,201,2613,30
2022-04-19,Mendocino,045,87422,13179,13128,3044,16172,122
2022-04-19,Merced,047,269075,62316,62322,8642,70964,813
2022-04-19,Modoc,049,8938,741,744,253,997,8
2022-04-19,Mono,051,14174,2987,2984,126,3110,6
2022-04-19,Monterey,053,433212,79775,79419,13805,93224,727
2022-04-19,Napa,055,140530,26174,26016,1002,27018,143
2022-04-19,Nevada,057,99092,16067,16034,1210,17244,127
2022-04-19,Orange,059,3164182,550104,549136,41665,590801,6963
2022-04-19,Placer,061,380077,63147,62928,7377,70305,619
2022-04-19,Plumas,063,18699,2983,2932,366,3298,13
2022-04-19,Riverside,065,2383286,593411,592224,27937,620161,6447
2022-04-19,Sacramento,067,1510023,282272,279326,26542,305868,2987
2022-04-19,San Benito,069,59416,12936,12971,516,13487,98
2022-04-19,San Bernardino,071,2135413,571916,565405,24791,590196,6977
2022-04-19,San Diego,073,3302833,756425,757138,53175,810313,5231
2022-04-19,San Francisco,075,870044,128563,127594,8458,136052,854
2022-04-19,San Joaquin,077,732212,167004,166531,9941,176472,2222
2022-04-19,San Luis Obispo,079,281455,52833,52740,3791,56531,476
2022-04-19,San Mateo,081,765935,124529,123279,7171,130450,701
2022-04-19,Santa Barbara,083,443738,86539,86214,4743,90957,685
2022-04-19,Santa Clara,085,1922200,316697,316355,12581,328936,2274
2022-04-19,Santa Cruz,087,273765,48796,47997,2122,50119,261
2022-04-19,Shasta,089,179085,30625,30590,6102,36692,554
2022-04-19,Sierra,091,2930,273,276,48,324,4
2022-04-19,Siskiyou,093,43540,4460,4446,2733,7179,80
2022-04-19,Solano,095,438530,82100,81841,5609,87450,447
2022-04-19,Sonoma,097,501317,84777,84429,2724,87153,485
2022-04-19,Stanislaus,099,539301,117807,117540,17635,135175,1630
2022-04-19,Sutter,101,95872,20530,20632,2091,22723,224
2022-04-19,Tehama,103,63373,12053,12061,2584,14645,199
2022-04-19,Trinity,105,12862,1184,1178,287,1465,20
2022-04-19,Tulare,107,460477,106493,105974,27635,133609,1439
2022-04-19,Tuolumne,109,53932,12700,12648,563,13211,180
2022-04-19,Ventura,111,848112,174235,173904,9478,183382,1475
2022-04-19,Yolo,113,214977,37533,36785,3073,39858,311
2022-04-19,Yuba,115,75493,15891,15868,1203,17071,121
2022-04-18,Alameda,001,1643700,260269,258734,14064,272798,1832
2022-04-18,Alpine,003,1148,124,124,1,125,0
2022-04-18,Amador,005,37829,8545,8494,650,9144,86
2022-04-18,Butte,007,227075,33232,33083,6974,40057,408
2022-04-18,Calaveras,009,45235,7294,7288,350,7638,119
2022-04-18,Colusa,011,21464,3450,3453,1049,4502,21
2022-04-18,Contra Costa,013,1133247,191513,190042,13347,203389,1299
2022-04-18,Del Norte,015,27424,5837,5814,184,5998,50
2022-04-18,El Dorado,017,186661,26893,26821,3215,30036,209
2022-04-18,Fresno,019,978130,231795,231568,23653,255221,2740
2022-04-18,Glenn,021,27897,4991,4988,1606,6594,48
2022-04-18,Humboldt,023,135768,17042,16976,2981,19957,145
2022-04-18,Imperial,025,180216,55459,55405,10572,65977,910
2022-04-18,Inyo,027,18085,4083,4075,492,4567,56
2022-04-18,Kern,029,883053,192133,191915,45808,237723,2262
2022-04-18,Kings,031,150075,51565,51571,3510,55081,445
2022-04-18,Lake,033,64148,10739,10711,888,11599,134
2022-04-18,Lassen,035,31185,8964,8951,875,9826,65
2022-04-18,Los Angeles,037,10098052,2729437,2721699,124555,2846254,31630
2022-04-18,Madera,039,155013,37325,37333,6031,43364,354
2022-04-18,Marin,041,260295,34186,33985,2608,36593,288
2022-04-18,Mariposa,043,17540,2427,2412,201,2613,30
2022-04-18,Mendocino,045,87422,13162,13128,3039,16167,122
2022-04-18,Merced,047,269075,62304,62322,8636,70958,813
2022-04-18,Modoc,049,8938,740,744,253,997,8
2022-04-18,Mono,051,14174,2986,2984,126,3110,6
2022-04-18,Monterey,053,433212,79701,79419,13789,93208,727
2022-04-18,Napa,055,140530,26138,26016,1001,27017,143
2022-04-18,Nevada,057,99092,16057,16034,1208,17242,127
2022-04-18,Orange,059,3164182,549816,549136,41632,590768,6963
2022-04-18,Placer,061,380077,63114,62928,7375,70303,619
2022-04-18,Plumas,063,18699,2983,2932,366,3298,13
2022-04-18,Riverside,065,2383286,593201,592224,27917,620141,6447
2022-04-18,Sacramento,067,1510023,282115,279326,26530,305856,2987
2022-04-18,San Benito,069,59416,12930,12971,516,13487,98
2022-04-18,San Bernardino,071,2135413,571705,565405,24773,590178,6977
2022-04-18,San Diego,073,3302833,755955,757138,53116,810254,5231
2022-04-18,San Francisco,075,870044,128245,127594,8446,136040,854
2022-04-18,San Joaquin,077,732212,166944,166531,9934,176465,2222
2022-04-18,San Luis Obispo,079,281455,52805,52740,3786,56526,476
2022-04-18,San Mateo,081,765935,124297,123279,7151,130430,701
2022-04-18,Santa Barbara,083,443738,86468,86214,4738,90952,685
2022-04-18,Santa Clara,085,1922200,316250,316355,12556,328911,2274
2022-04-18,Santa Cruz,087,273765,48690,47997,2120,50117,261
2022-04-18,Shasta,089,179085,30619,30590,6099,36689,554
2022-04-18,Sierra,091,2930,273,276,48,324,4
2022-04-18,Siskiyou,093,43540,4459,4446,2732,7178,80
2022-04-18,Solano,095,438530,82035,81841,5603,87444,447
2022-04-18,Sonoma,097,501317,84677,84429,2709,87138,485
2022-04-18,Stanislaus,099,539301,117777,117540,17632,135172,1630
2022-04-18,Sutter,101,95872,20528,20632,2089,22721,224
2022-04-18,Tehama,103,63373,12049,12061,2584,14645,199
2022-04-18,Trinity,105,12862,1184,1178,287,1465,20
2022-04-18,Tulare,107,460477,106479,105974,27627,133601,1439
2022-04-18,Tuolumne,109,53932,12693,12648,562,13210,180
2022-04-18,Ventura,111,848112,174143,173904,9468,183372,1475
2022-04-18,Yolo,113,214977,37466,36785,3073,39858,311
2022-04-18,Yuba,115,75493,15882,15868,1202,17070,121
2022-04-17,Alameda,001,1643700,259878,257897,14038,271935,1829
2022-04-17,Alpine,003,1148,124,124,1,125,0
2022-04-17,Amador,005,37829,8540,8491,648,9139,86
2022-04-17,Butte,007,227075,33229,33053,6972,40025,405
2022-04-17,Calaveras,009,45235,7291,7275,349,7624,119
2022-04-17,Colusa,011,21464,3449,3450,1049,4499,21
2022-04-17,Contra Costa,013,1133247,191286,189742,13311,203053,1298
2022-04-17,Del Norte,015,27424,5832,5809,184,5993,50
2022-04-17,El Dorado,017,186661,26881,26796,3213,30009,209
2022-04-17,Fresno,019,978130,231717,231455,23647,255102,2739
2022-04-17,Glenn,021,27897,4991,4991,1606,6597,48
2022-04-17,Humboldt,023,135768,17007,16929,2975,19904,143
2022-04-17,Imperial,025,180216,55450,55371,10570,65941,910
2022-04-17,Inyo,027,18085,4081,4075,492,4567,56
2022-04-17,Kern,029,883053,192098,191866,45793,237659,2258
2022-04-17,Kings,031,150075,51554,51544,3508,55052,445
2022-04-17,Lake,033,64148,10738,10702,888,11590,134
2022-04-17,Lassen,035,31185,8964,8950,875,9825,65
2022-04-17,Los Angeles,037,10098052,2727441,2717479,124437,2841916,31598
2022-04-17,Madera,039,155013,37319,37362,6031,43393,354
2022-04-17,Marin,041,260295,34119,33829,2578,36407,288
2022-04-17,Mariposa,043,17540,2419,2406,201,2607,30
2022-04-17,Mendocino,045,87422,13147,13107,3035,16142,122
2022-04-17,Merced,047,269075,62284,62295,8630,70925,813
2022-04-17,Modoc,049,8938,740,743,253,996,8
2022-04-17,Mono,051,14174,2985,2977,126,3103,6
2022-04-17,Monterey,053,433212,79668,79311,13769,93080,727
2022-04-17,Napa,055,140530,26094,25929,995,26924,143
2022-04-17,Nevada,057,99092,16041,16014,1203,17217,123
2022-04-17,Orange,059,3164182,549452,548311,41584,589895,6945
2022-04-17,Placer,061,380077,63074,62882,7368,70250,618
2022-04-17,Plumas,063,18699,2983,2929,366,3295,13
2022-04-17,Riverside,065,2383286,592981,591772,27897,619669,6443
2022-04-17,Sacramento,067,1510023,281954,278523,26505,305028,2978
2022-04-17,San Benito,069,59416,12927,12926,515,13441,98
2022-04-17,San Bernardino,071,2135413,571466,564397,24759,589156,6948
2022-04-17,San Diego,073,3302833,755464,756165,53048,809213,5229
2022-04-17,San Francisco,075,870044,127927,126976,8430,135406,854
2022-04-17,San Joaquin,077,732212,166894,166645,9928,176573,2220
2022-04-17,San Luis Obispo,079,281455,52736,52698,3781,56479,476
2022-04-17,San Mateo,081,765935,124061,122652,7135,129787,699
2022-04-17,Santa Barbara,083,443738,86410,86030,4732,90762,684
2022-04-17,Santa Clara,085,1922200,315753,315296,12529,327825,2268
2022-04-17,Santa Cruz,087,273765,48568,47895,2118,50013,261
2022-04-17,Shasta,089,179085,30608,30578,6095,36673,554
2022-04-17,Sierra,091,2930,273,276,48,324,4
2022-04-17,Siskiyou,093,43540,4454,4444,2731,7175,80
2022-04-17,Solano,095,438530,81968,81781,5599,87380,447
2022-04-17,Sonoma,097,501317,84565,84172,2702,86874,485
2022-04-17,Stanislaus,099,539301,117747,117567,17625,135192,1619
2022-04-17,Sutter,101,95872,20523,20621,2088,22709,224
2022-04-17,Tehama,103,63373,12048,12061,2584,14645,199
2022-04-17,Trinity,105,12862,1183,1178,287,1465,20
2022-04-17,Tulare,107,460477,106465,105757,27618,133375,1428
2022-04-17,Tuolumne,109,53932,12687,12640,562,13202,180
2022-04-17,Ventura,111,848112,174046,173665,9450,183115,1474
2022-04-17,Yolo,113,214977,37415,36752,3071,39823,311
2022-04-17,Yuba,115,75493,15876,15857,1202,17059,121
2022-04-16,Alameda,001,1643700,259724,257897,14028,271925,1829
2022-04-16,Alpine,003,1148,124,124,1,125,0
2022-04-16,Amador,005,37829,8538,8491,648,9139,86
2022-04-16,Butte,007,227075,33226,33053,6970,40023,405
2022-04-16,Calaveras,009,45235,7289,7275,349,7624,119
2022-04-16,Colusa,011,21464,3449,3450,1049,4499,21
2022-04-16,Contra Costa,013,1133247,191195,189742,13305,203047,1298
2022-04-16,Del Norte,015,27424,5832,5809,184,5993,50
2022-04-16,El Dorado,017,186661,26870,26796,3213,30009,209
2022-04-16,Fresno,019,978130,231689,231455,23646,255101,2739
2022-04-16,Glenn,021,27897,4991,4991,1606,6597,48
2022-04-16,Humboldt,023,135768,16999,16929,2970,19899,143
2022-04-16,Imperial,025,180216,55444,55371,10569,65940,910
2022-04-16,Inyo,027,18085,4081,4075,492,4567,56
2022-04-16,Kern,029,883053,192087,191866,45781,237647,2258
2022-04-16,Kings,031,150075,51551,51544,3508,55052,445
2022-04-16,Lake,033,64148,10736,10702,888,11590,134
2022-04-16,Lassen,035,31185,8964,8950,875,9825,65
2022-04-16,Los Angeles,037,10098052,2726733,2717479,124387,2841866,31598
2022-04-16,Madera,039,155013,37317,37362,6031,43393,354
2022-04-16,Marin,041,260295,34081,33829,2552,36381,288
2022-04-16,Mariposa,043,17540,2418,2406,201,2607,30
2022-04-16,Mendocino,045,87422,13141,13107,3035,16142,122
2022-04-16,Merced,047,269075,62281,62295,8630,70925,813
2022-04-16,Modoc,049,8938,740,743,253,996,8
2022-04-16,Mono,051,14174,2985,2977,126,3103,6
2022-04-16,Monterey,053,433212,79653,79311,13760,93071,727
2022-04-16,Napa,055,140530,26071,25929,993,26922,143
2022-04-16,Nevada,057,99092,16038,16014,1202,17216,123
2022-04-16,Orange,059,3164182,549337,548311,41556,589867,6945
2022-04-16,Placer,061,380077,63058,62882,7366,70248,618
2022-04-16,Plumas,063,18699,2981,2929,366,3295,13
2022-04-16,Riverside,065,2383286,592901,591772,27891,619663,6443
2022-04-16,Sacramento,067,1510023,281903,278523,26500,305023,2978
2022-04-16,San Benito,069,59416,12926,12926,515,13441,98
2022-04-16,San Bernardino,071,2135413,571367,564397,24755,589152,6948
2022-04-16,San Diego,073,3302833,755317,756165,53036,809201,5229
2022-04-16,San Francisco,075,870044,127771,126976,8421,135397,854
2022-04-16,San Joaquin,077,732212,166854,166645,9924,176569,2220
2022-04-16,San Luis Obispo,079,281455,52730,52698,3780,56478,476
2022-04-16,San Mateo,081,765935,123965,122652,7128,129780,699
2022-04-16,Santa Barbara,083,443738,86380,86030,4732,90762,684
2022-04-16,Santa Clara,085,1922200,315511,315296,12521,327817,2268
2022-04-16,Santa Cruz,087,273765,48541,47895,2118,50013,261
2022-04-16,Shasta,089,179085,30604,30578,6095,36673,554
2022-04-16,Sierra,091,2930,273,276,48,324,4
2022-04-16,Siskiyou,093,43540,4454,4444,2731,7175,80
2022-04-16,Solano,095,438530,81953,81781,5597,87378,447
2022-04-16,Sonoma,097,501317,84516,84172,2693,86865,485
2022-04-16,Stanislaus,099,539301,117727,117567,17620,135187,1619
2022-04-16,Sutter,101,95872,20519,20621,2088,22709,224
2022-04-16,Tehama,103,63373,12047,12061,2584,14645,199
2022-04-16,Trinity,105,12862,1183,1178,287,1465,20
2022-04-16,Tulare,107,460477,106455,105757,27616,133373,1428
2022-04-16,Tuolumne,109,53932,12686,12640,562,13202,180
2022-04-16,Ventura,111,848112,174017,173665,9446,183111,1474
2022-04-16,Yolo,113,214977,37406,36752,3070,39822,311
2022-04-16,Yuba,115,75493,15872,15857,1202,17059,121
2022-04-15,Alameda,001,1643700,259540,257897,14020,271917,1829
2022-04-15,Alpine,003,1148,124,124,1,125,0
2022-04-15,Amador,005,37829,8537,8491,646,9137,86
2022-04-15,Butte,007,227075,33224,33053,6968,40021,405
2022-04-15,Calaveras,009,45235,7287,7275,349,7624,119
2022-04-15,Colusa,011,21464,3449,3450,1049,4499,21
2022-04-15,Contra Costa,013,1133247,191078,189742,13298,203040,1298
2022-04-15,Del Norte,015,27424,5831,5809,184,5993,50
2022-04-15,El Dorado,017,186661,26856,26796,3212,30008,209
2022-04-15,Fresno,019,978130,231660,231455,23646,255101,2739
2022-04-15,Glenn,021,27897,4991,4991,1606,6597,48
2022-04-15,Humboldt,023,135768,16987,16929,2969,19898,143
2022-04-15,Imperial,025,180216,55442,55371,10569,65940,910
2022-04-15,Inyo,027,18085,4081,4075,491,4566,56
2022-04-15,Kern,029,883053,192072,191866,45770,237636,2258
2022-04-15,Kings,031,150075,51547,51544,3508,55052,445
2022-04-15,Lake,033,64148,10731,10702,888,11590,134
2022-04-15,Lassen,035,31185,8964,8950,875,9825,65
2022-04-15,Los Angeles,037,10098052,2725960,2717479,124321,2841800,31598
2022-04-15,Madera,039,155013,37315,37362,6031,43393,354
2022-04-15,Marin,041,260295,34047,33829,2531,36360,288
2022-04-15,Mariposa,043,17540,2417,2406,201,2607,30
2022-04-15,Mendocino,045,87422,13135,13107,3033,16140,122
2022-04-15,Merced,047,269075,62277,62295,8630,70925,813
2022-04-15,Modoc,049,8938,740,743,253,996,8
2022-04-15,Mono,051,14174,2980,2977,125,3102,6
2022-04-15,Monterey,053,433212,79626,79311,13754,93065,727
2022-04-15,Napa,055,140530,26054,25929,992,26921,143
2022-04-15,Nevada,057,99092,16036,16014,1201,17215,123
2022-04-15,Orange,059,3164182,549216,548311,41526,589837,6945
2022-04-15,Placer,061,380077,63043,62882,7365,70247,618
2022-04-15,Plumas,063,18699,2981,2929,366,3295,13
2022-04-15,Riverside,065,2383286,592800,591772,27885,619657,6443
2022-04-15,Sacramento,067,1510023,281824,278523,26496,305019,2978
2022-04-15,San Benito,069,59416,12924,12926,514,13440,98
2022-04-15,San Bernardino,071,2135413,571284,564397,24752,589149,6948
2022-04-15,San Diego,073,3302833,755124,756165,53017,809182,5229
2022-04-15,San Francisco,075,870044,127620,126976,8406,135382,854
2022-04-15,San Joaquin,077,732212,166831,166645,9922,176567,2220
2022-04-15,San Luis Obispo,079,281455,52722,52698,3780,56478,476
2022-04-15,San Mateo,081,765935,123834,122652,7117,129769,699
2022-04-15,Santa Barbara,083,443738,86347,86030,4731,90761,684
2022-04-15,Santa Clara,085,1922200,315220,315296,12513,327809,2268
2022-04-15,Santa Cruz,087,273765,48513,47895,2117,50012,261
2022-04-15,Shasta,089,179085,30595,30578,6095,36673,554
2022-04-15,Sierra,091,2930,273,276,48,324,4
2022-04-15,Siskiyou,093,43540,4452,4444,2731,7175,80
2022-04-15,Solano,095,438530,81928,81781,5597,87378,447
2022-04-15,Sonoma,097,501317,84464,84172,2677,86849,485
2022-04-15,Stanislaus,099,539301,117707,117567,17618,135185,1619
2022-04-15,Sutter,101,95872,20516,20621,2088,22709,224
2022-04-15,Tehama,103,63373,12047,12061,2584,14645,199
2022-04-15,Trinity,105,12862,1183,1178,287,1465,20
2022-04-15,Tulare,107,460477,106449,105757,27610,133367,1428
2022-04-15,Tuolumne,109,53932,12683,12640,559,13199,180
2022-04-15,Ventura,111,848112,173988,173665,9440,183105,1474
2022-04-15,Yolo,113,214977,37389,36752,3070,39822,311
2022-04-15,Yuba,115,75493,15869,15857,1202,17059,121
2022-04-14,Alameda,001,1643700,259273,257897,14010,271907,1829
2022-04-14,Alpine,003,1148,124,124,1,125,0
2022-04-14,Amador,005,37829,8537,8491,646,9137,86
2022-04-14,Butte,007,227075,33219,33053,6965,40018,405
2022-04-14,Calaveras,009,45235,7286,7275,349,7624,119
2022-04-14,Colusa,011,21464,3449,3450,1049,4499,21
2022-04-14,Contra Costa,013,1133247,190923,189742,13286,203028,1298
2022-04-14,Del Norte,015,27424,5829,5809,184,5993,50
2022-04-14,El Dorado,017,186661,26853,26796,3210,30006,209
2022-04-14,Fresno,019,978130,231634,231455,23645,255100,2739
2022-04-14,Glenn,021,27897,4990,4991,1604,6595,48
2022-04-14,Humboldt,023,135768,16972,16929,2968,19897,143
2022-04-14,Imperial,025,180216,55432,55371,10569,65940,910
2022-04-14,Inyo,027,18085,4081,4075,490,4565,56
2022-04-14,Kern,029,883053,192053,191866,45762,237628,2258
2022-04-14,Kings,031,150075,51539,51544,3508,55052,445
2022-04-14,Lake,033,64148,10730,10702,888,11590,134
2022-04-14,Lassen,035,31185,8964,8950,874,9824,65
2022-04-14,Los Angeles,037,10098052,2724873,2717479,124233,2841712,31598
2022-04-14,Madera,039,155013,37313,37362,6031,43393,354
2022-04-14,Marin,041,260295,34014,33829,2503,36332,288
2022-04-14,Mariposa,043,17540,2416,2406,201,2607,30
2022-04-14,Mendocino,045,87422,13130,13107,3033,16140,122
2022-04-14,Merced,047,269075,62272,62295,8629,70924,813
2022-04-14,Modoc,049,8938,739,743,253,996,8
2022-04-14,Mono,051,14174,2980,2977,124,3101,6
2022-04-14,Monterey,053,433212,79601,79311,13749,93060,727
2022-04-14,Napa,055,140530,26032,25929,991,26920,143
2022-04-14,Nevada,057,99092,16029,16014,1200,17214,123
2022-04-14,Orange,059,3164182,549027,548311,41500,589811,6945
2022-04-14,Placer,061,380077,63025,62882,7360,70242,618
2022-04-14,Plumas,063,18699,2981,2929,366,3295,13
2022-04-14,Riverside,065,2383286,592681,591772,27875,619647,6443
2022-04-14,Sacramento,067,1510023,281705,278523,26482,305005,2978
2022-04-14,San Benito,069,59416,12918,12926,514,13440,98
2022-04-14,San Bernardino,071,2135413,571113,564397,24747,589144,6948
2022-04-14,San Diego,073,3302833,754846,756165,52979,809144,5229
2022-04-14,San Francisco,075,870044,127418,126976,8395,135371,854
2022-04-14,San Joaquin,077,732212,166799,166645,9921,176566,2220
2022-04-14,San Luis Obispo,079,281455,52706,52698,3776,56474,476
2022-04-14,San Mateo,081,765935,123679,122652,7099,129751,699
2022-04-14,Santa Barbara,083,443738,86302,86030,4729,90759,684
2022-04-14,Santa Clara,085,1922200,314920,315296,12504,327800,2268
2022-04-14,Santa Cruz,087,273765,48483,47895,2116,50011,261
2022-04-14,Shasta,089,179085,30593,30578,6094,36672,554
2022-04-14,Sierra,091,2930,273,276,48,324,4
2022-04-14,Siskiyou,093,43540,4452,4444,2730,7174,80
2022-04-14,Solano,095,438530,81888,81781,5591,87372,447
2022-04-14,Sonoma,097,501317,84373,84172,2672,86844,485
2022-04-14,Stanislaus,099,539301,117687,117567,17615,135182,1619
2022-04-14,Sutter,101,95872,20514,20621,2079,22700,224
2022-04-14,Tehama,103,63373,12046,12061,2583,14644,199
2022-04-14,Trinity,105,12862,1183,1178,287,1465,20
2022-04-14,Tulare,107,460477,106435,105757,27606,133363,1428
2022-04-14,Tuolumne,109,53932,12679,12640,558,13198,180
2022-04-14,Ventura,111,848112,173939,173665,9434,183099,1474
2022-04-14,Yolo,113,214977,37362,36752,3067,39819,311
2022-04-14,Yuba,115,75493,15866,15857,1202,17059,121
2022-04-13,Alameda,001,1643700,259022,257440,13990,271430,1833
2022-04-13,Alpine,003,1148,124,124,1,125,0
2022-04-13,Amador,005,37829,8535,8490,646,9136,86
2022-04-13,Butte,007,227075,33211,33044,6965,40009,402
2022-04-13,Calaveras,009,45235,7285,7270,349,7619,119
2022-04-13,Colusa,011,21464,3449,3451,1049,4500,21
2022-04-13,Contra Costa,013,1133247,190790,189471,13272,202743,1298
2022-04-13,Del Norte,015,27424,5827,5812,184,5996,50
2022-04-13,El Dorado,017,186661,26849,26794,3210,30004,208
2022-04-13,Fresno,019,978130,231602,231325,23633,254958,2738
2022-04-13,Glenn,021,27897,4989,4989,1604,6593,48
2022-04-13,Humboldt,023,135768,16958,16922,2967,19889,143
2022-04-13,Imperial,025,180216,55419,55353,10567,65920,910
2022-04-13,Inyo,027,18085,4081,4074,487,4561,56
2022-04-13,Kern,029,883053,192028,191859,45756,237615,2249
2022-04-13,Kings,031,150075,51533,51535,3508,55043,443
2022-04-13,Lake,033,64148,10728,10695,888,11583,134
2022-04-13,Lassen,035,31185,8963,8949,874,9823,65
2022-04-13,Los Angeles,037,10098052,2723612,2715722,124158,2839880,31578
2022-04-13,Madera,039,155013,37310,37361,6031,43392,354
2022-04-13,Marin,041,260295,33975,33747,2474,36221,288
2022-04-13,Mariposa,043,17540,2410,2402,201,2603,29
2022-04-13,Mendocino,045,87422,13121,13101,3031,16132,120
2022-04-13,Merced,047,269075,62262,62276,8628,70904,811
2022-04-13,Modoc,049,8938,739,743,253,996,8
2022-04-13,Mono,051,14174,2978,2971,124,3095,6
2022-04-13,Monterey,053,433212,79587,79179,13742,92921,727
2022-04-13,Napa,055,140530,26015,25892,988,26880,143
2022-04-13,Nevada,057,99092,16023,16002,1200,17202,123
2022-04-13,Orange,059,3164182,548825,547783,41477,589260,6935
2022-04-13,Placer,061,380077,62998,62851,7356,70207,615
2022-04-13,Plumas,063,18699,2980,2923,366,3289,13
2022-04-13,Riverside,065,2383286,592542,591659,27868,619527,6437
2022-04-13,Sacramento,067,1510023,281619,277866,26479,304345,2974
2022-04-13,San Benito,069,59416,12912,12927,514,13441,98
2022-04-13,San Bernardino,071,2135413,570968,563709,24742,588451,6905
2022-04-13,San Diego,073,3302833,754560,755584,52947,808531,5223
2022-04-13,San Francisco,075,870044,127250,126608,8375,134983,850
2022-04-13,San Joaquin,077,732212,166764,166654,9919,176573,2219
2022-04-13,San Luis Obispo,079,281455,52682,52660,3776,56436,476
2022-04-13,San Mateo,081,765935,123528,122167,7075,129242,699
2022-04-13,Santa Barbara,083,443738,86264,85938,4724,90662,684
2022-04-13,Santa Clara,085,1922200,314651,314863,12487,327350,2267
2022-04-13,Santa Cruz,087,273765,48429,47765,2115,49880,260
2022-04-13,Shasta,089,179085,30591,30569,6094,36663,551
2022-04-13,Sierra,091,2930,273,276,48,324,4
2022-04-13,Siskiyou,093,43540,4451,4444,2729,7173,80
2022-04-13,Solano,095,438530,81850,81843,5588,87431,448
2022-04-13,Sonoma,097,501317,84303,84033,2659,86692,485
2022-04-13,Stanislaus,099,539301,117669,117573,17610,135183,1577
2022-04-13,Sutter,101,95872,20510,20610,2079,22689,223
2022-04-13,Tehama,103,63373,12045,12062,2582,14644,200
2022-04-13,Trinity,105,12862,1183,1177,287,1464,20
2022-04-13,Tulare,107,460477,106427,105519,27601,133120,1426
2022-04-13,Tuolumne,109,53932,12673,12639,558,13197,180
2022-04-13,Ventura,111,848112,173881,173558,9428,182986,1474
2022-04-13,Yolo,113,214977,37323,36684,3065,39749,311
2022-04-13,Yuba,115,75493,15862,15851,1202,17053,121
2022-04-12,Alameda,001,1643700,258781,257440,13981,271421,1833
2022-04-12,Alpine,003,1148,124,124,1,125,0
2022-04-12,Amador,005,37829,8534,8490,646,9136,86
2022-04-12,Butte,007,227075,33199,33044,6958,40002,402
2022-04-12,Calaveras,009,45235,7281,7270,348,7618,119
2022-04-12,Colusa,011,21464,3449,3451,1049,4500,21
2022-04-12,Contra Costa,013,1133247,190633,189471,13258,202729,1298
2022-04-12,Del Norte,015,27424,5824,5812,184,5996,50
2022-04-12,El Dorado,017,186661,26837,26794,3210,30004,208
2022-04-12,Fresno,019,978130,231572,231325,23626,254951,2738
2022-04-12,Glenn,021,27897,4989,4989,1604,6593,48
2022-04-12,Humboldt,023,135768,16950,16922,2965,19887,143
2022-04-12,Imperial,025,180216,55415,55353,10558,65911,910
2022-04-12,Inyo,027,18085,4081,4074,487,4561,56
2022-04-12,Kern,029,883053,192008,191859,45747,237606,2249
2022-04-12,Kings,031,150075,51525,51535,3506,55041,443
2022-04-12,Lake,033,64148,10724,10695,887,11582,134
2022-04-12,Lassen,035,31185,8963,8949,874,9823,65
2022-04-12,Los Angeles,037,10098052,2722366,2715722,124058,2839780,31578
2022-04-12,Madera,039,155013,37309,37361,6031,43392,354
2022-04-12,Marin,041,260295,33930,33747,2447,36194,288
2022-04-12,Mariposa,043,17540,2410,2402,201,2603,29
2022-04-12,Mendocino,045,87422,13113,13101,3025,16126,120
2022-04-12,Merced,047,269075,62248,62276,8626,70902,811
2022-04-12,Modoc,049,8938,739,743,252,995,8
2022-04-12,Mono,051,14174,2978,2971,124,3095,6
2022-04-12,Monterey,053,433212,79563,79179,13735,92914,727
2022-04-12,Napa,055,140530,25992,25892,978,26870,143
2022-04-12,Nevada,057,99092,16020,16002,1199,17201,123
2022-04-12,Orange,059,3164182,548572,547783,41444,589227,6935
2022-04-12,Placer,061,380077,62975,62851,7351,70202,615
2022-04-12,Plumas,063,18699,2979,2923,366,3289,13
2022-04-12,Riverside,065,2383286,592396,591659,27848,619507,6437
2022-04-12,Sacramento,067,1510023,281503,277866,26477,304343,2974
2022-04-12,San Benito,069,59416,12908,12927,513,13440,98
2022-04-12,San Bernardino,071,2135413,570794,563709,24739,588448,6905
2022-04-12,San Diego,073,3302833,754227,755584,52905,808489,5223
2022-04-12,San Francisco,075,870044,127039,126608,8360,134968,850
2022-04-12,San Joaquin,077,732212,166734,166654,9917,176571,2219
2022-04-12,San Luis Obispo,079,281455,52648,52660,3770,56430,476
2022-04-12,San Mateo,081,765935,123371,122167,7054,129221,699
2022-04-12,Santa Barbara,083,443738,86218,85938,4720,90658,684
2022-04-12,Santa Clara,085,1922200,314359,314863,12476,327339,2267
2022-04-12,Santa Cruz,087,273765,48350,47765,2112,49877,260
2022-04-12,Shasta,089,179085,30591,30569,6093,36662,551
2022-04-12,Sierra,091,2930,273,276,48,324,4
2022-04-12,Siskiyou,093,43540,4451,4444,2727,7171,80
2022-04-12,Solano,095,438530,81809,81843,5586,87429,448
2022-04-12,Sonoma,097,501317,84244,84033,2653,86686,485
2022-04-12,Stanislaus,099,539301,117649,117573,17606,135179,1577
2022-04-12,Sutter,101,95872,20507,20610,2079,22689,223
2022-04-12,Tehama,103,63373,12043,12062,2582,14644,200
2022-04-12,Trinity,105,12862,1183,1177,287,1464,20
2022-04-12,Tulare,107,460477,106412,105519,27596,133115,1426
2022-04-12,Tuolumne,109,53932,12671,12639,556,13195,180
2022-04-12,Ventura,111,848112,173832,173558,9422,182980,1474
2022-04-12,Yolo,113,214977,37283,36684,3059,39743,311
2022-04-12,Yuba,115,75493,15857,15851,1202,17053,121
2022-04-11,Alameda,001,1643700,258490,256649,13964,270613,1826
2022-04-11,Alpine,003,1148,124,124,1,125,0
2022-04-11,Amador,005,37829,8533,8489,646,9135,86
2022-04-11,Butte,007,227075,33186,33031,6954,39985,399
2022-04-11,Calaveras,009,45235,7278,7260,348,7608,119
2022-04-11,Colusa,011,21464,3447,3449,1049,4498,21
2022-04-11,Contra Costa,013,1133247,190466,189154,13241,202395,1296
2022-04-11,Del Norte,015,27424,5823,5811,184,5995,50
2022-04-11,El Dorado,017,186661,26824,26757,3209,29966,207
2022-04-11,Fresno,019,978130,231551,231090,23625,254715,2731
2022-04-11,Glenn,021,27897,4988,4988,1603,6591,47
2022-04-11,Humboldt,023,135768,16935,16913,2963,19876,141
2022-04-11,Imperial,025,180216,55410,55267,10556,65823,910
2022-04-11,Inyo,027,18085,4080,4071,487,4558,56
2022-04-11,Kern,029,883053,191983,191542,45745,237287,2244
2022-04-11,Kings,031,150075,51521,51519,3506,55025,443
2022-04-11,Lake,033,64148,10723,10690,886,11576,134
2022-04-11,Lassen,035,31185,8963,8948,874,9822,65
2022-04-11,Los Angeles,037,10098052,2721106,2709735,123986,2833721,31509
2022-04-11,Madera,039,155013,37302,37356,6031,43387,354
2022-04-11,Marin,041,260295,33874,33648,2428,36076,288
2022-04-11,Mariposa,043,17540,2409,2394,201,2595,29
2022-04-11,Mendocino,045,87422,13109,13087,3023,16110,120
2022-04-11,Merced,047,269075,62239,62231,8624,70855,811
2022-04-11,Modoc,049,8938,739,743,252,995,8
2022-04-11,Mono,051,14174,2977,2967,123,3090,6
2022-04-11,Monterey,053,433212,79543,79103,13726,92829,727
2022-04-11,Napa,055,140530,25975,25824,976,26800,144
2022-04-11,Nevada,057,99092,16016,15976,1199,17175,123
2022-04-11,Orange,059,3164182,548364,546983,41410,588393,6912
2022-04-11,Placer,061,380077,62953,62831,7350,70181,616
2022-04-11,Plumas,063,18699,2977,2887,366,3253,13
2022-04-11,Riverside,065,2383286,592269,591268,27831,619099,6429
2022-04-11,Sacramento,067,1510023,281403,277125,26475,303600,2972
2022-04-11,San Benito,069,59416,12906,12917,513,13430,98
2022-04-11,San Bernardino,071,2135413,570643,562571,24731,587302,6892
2022-04-11,San Diego,073,3302833,753900,754281,52866,807147,5210
2022-04-11,San Francisco,075,870044,126807,125963,8348,134311,844
2022-04-11,San Joaquin,077,732212,166696,166547,9911,176458,2212
2022-04-11,San Luis Obispo,079,281455,52625,52609,3769,56378,476
2022-04-11,San Mateo,081,765935,123185,121514,7040,128554,698
2022-04-11,Santa Barbara,083,443738,86170,85754,4715,90469,680
2022-04-11,Santa Clara,085,1922200,314015,313965,12461,326426,2266
2022-04-11,Santa Cruz,087,273765,48256,47624,2109,49733,259
2022-04-11,Shasta,089,179085,30586,30586,6092,36678,549
2022-04-11,Sierra,091,2930,273,272,48,320,4
2022-04-11,Siskiyou,093,43540,4451,4444,2725,7169,80
2022-04-11,Solano,095,438530,81781,81886,5585,87471,448
2022-04-11,Sonoma,097,501317,84176,83600,2642,86242,485
2022-04-11,Stanislaus,099,539301,117615,117528,17598,135126,1578
2022-04-11,Sutter,101,95872,20504,20591,2079,22670,223
2022-04-11,Tehama,103,63373,12042,12059,2581,14640,201
2022-04-11,Trinity,105,12862,1183,1177,287,1464,20
2022-04-11,Tulare,107,460477,106401,105278,27588,132866,1415
2022-04-11,Tuolumne,109,53932,12668,12632,556,13188,180
2022-04-11,Ventura,111,848112,173774,173343,9421,182764,1467
2022-04-11,Yolo,113,214977,37246,36587,3057,39644,312
2022-04-11,Yuba,115,75493,15854,15848,1201,17049,121
2022-04-10,Alameda,001,1643700,258156,256649,13953,270602,1826
2022-04-10,Alpine,003,1148,124,124,1,125,0
2022-04-10,Amador,005,37829,8531,8489,646,9135,86
2022-04-10,Butte,007,227075,33182,33031,6949,39980,399
2022-04-10,Calaveras,009,45235,7275,7260,348,7608,119
2022-04-10,Colusa,011,21464,3446,3449,1049,4498,21
2022-04-10,Contra Costa,013,1133247,190306,189154,13222,202376,1296
2022-04-10,Del Norte,015,27424,5820,5811,184,5995,50
2022-04-10,El Dorado,017,186661,26817,26757,3207,29964,207
2022-04-10,Fresno,019,978130,231513,231090,23623,254713,2731
2022-04-10,Glenn,021,27897,4988,4988,1603,6591,47
2022-04-10,Humboldt,023,135768,16925,16913,2961,19874,141
2022-04-10,Imperial,025,180216,55406,55267,10554,65821,910
2022-04-10,Inyo,027,18085,4080,4071,485,4556,56
2022-04-10,Kern,029,883053,191964,191542,45740,237282,2244
2022-04-10,Kings,031,150075,51519,51519,3506,55025,443
2022-04-10,Lake,033,64148,10719,10690,884,11574,134
2022-04-10,Lassen,035,31185,8962,8948,874,9822,65
2022-04-10,Los Angeles,037,10098052,2719778,2709735,123895,2833630,31509
2022-04-10,Madera,039,155013,37297,37356,6030,43386,354
2022-04-10,Marin,041,260295,33834,33648,2399,36047,288
2022-04-10,Mariposa,043,17540,2407,2394,201,2595,29
2022-04-10,Mendocino,045,87422,13101,13087,3022,16109,120
2022-04-10,Merced,047,269075,62227,62231,8622,70853,811
2022-04-10,Modoc,049,8938,739,743,252,995,8
2022-04-10,Mono,051,14174,2974,2967,123,3090,6
2022-04-10,Monterey,053,433212,79527,79103,13716,92819,727
2022-04-10,Napa,055,140530,25953,25824,974,26798,144
2022-04-10,Nevada,057,99092,15999,15976,1199,17175,123
2022-04-10,Orange,059,3164182,548113,546983,41372,588355,6912
2022-04-10,Placer,061,380077,62919,62831,7349,70180,616
2022-04-10,Plumas,063,18699,2974,2887,366,3253,13
2022-04-10,Riverside,065,2383286,592117,591268,27818,619086,6429
2022-04-10,Sacramento,067,1510023,281305,277125,26465,303590,2972
2022-04-10,San Benito,069,59416,12903,12917,513,13430,98
2022-04-10,San Bernardino,071,2135413,570411,562571,24722,587293,6892
2022-04-10,San Diego,073,3302833,753574,754281,52821,807102,5210
2022-04-10,San Francisco,075,870044,126568,125963,8332,134295,844
2022-04-10,San Joaquin,077,732212,166649,166547,9904,176451,2212
2022-04-10,San Luis Obispo,079,281455,52591,52609,3766,56375,476
2022-04-10,San Mateo,081,765935,123018,121514,7024,128538,698
2022-04-10,Santa Barbara,083,443738,86086,85754,4705,90459,680
2022-04-10,Santa Clara,085,1922200,313686,313965,12447,326412,2266
2022-04-10,Santa Cruz,087,273765,48167,47624,2108,49732,259
2022-04-10,Shasta,089,179085,30579,30586,6092,36678,549
2022-04-10,Sierra,091,2930,273,272,48,320,4
2022-04-10,Siskiyou,093,43540,4451,4444,2724,7168,80
2022-04-10,Solano,095,438530,81734,81886,5580,87466,448
2022-04-10,Sonoma,097,501317,84075,83600,2637,86237,485
2022-04-10,Stanislaus,099,539301,117592,117528,17591,135119,1578
2022-04-10,Sutter,101,95872,20500,20591,2075,22666,223
2022-04-10,Tehama,103,63373,12040,12059,2581,14640,201
2022-04-10,Trinity,105,12862,1183,1177,287,1464,20
2022-04-10,Tulare,107,460477,106386,105278,27581,132859,1415
2022-04-10,Tuolumne,109,53932,12661,12632,556,13188,180
2022-04-10,Ventura,111,848112,173695,173343,9416,182759,1467
2022-04-10,Yolo,113,214977,37215,36587,3052,39639,312
2022-04-10,Yuba,115,75493,15853,15848,1201,17049,121
2022-04-09,Alameda,001,1643700,257982,256649,13948,270597,1826
2022-04-09,Alpine,003,1148,124,124,1,125,0
2022-04-09,Amador,005,37829,8531,8489,645,9134,86
2022-04-09,Butte,007,227075,33179,33031,6949,39980,399
2022-04-09,Calaveras,009,45235,7274,7260,348,7608,119
2022-04-09,Colusa,011,21464,3445,3449,1049,4498,21
2022-04-09,Contra Costa,013,1133247,190209,189154,13215,202369,1296
2022-04-09,Del Norte,015,27424,5819,5811,184,5995,50
2022-04-09,El Dorado,017,186661,26810,26757,3207,29964,207
2022-04-09,Fresno,019,978130,231492,231090,23623,254713,2731
2022-04-09,Glenn,021,27897,4988,4988,1603,6591,47
2022-04-09,Humboldt,023,135768,16918,16913,2961,19874,141
2022-04-09,Imperial,025,180216,55401,55267,10554,65821,910
2022-04-09,Inyo,027,18085,4080,4071,485,4556,56
2022-04-09,Kern,029,883053,191955,191542,45735,237277,2244
2022-04-09,Kings,031,150075,51513,51519,3506,55025,443
2022-04-09,Lake,033,64148,10717,10690,884,11574,134
2022-04-09,Lassen,035,31185,8962,8948,874,9822,65
2022-04-09,Los Angeles,037,10098052,2719100,2709735,123822,2833557,31509
2022-04-09,Madera,039,155013,37294,37356,6030,43386,354
2022-04-09,Marin,041,260295,33801,33648,2356,36004,288
2022-04-09,Mariposa,043,17540,2407,2394,201,2595,29
2022-04-09,Mendocino,045,87422,13099,13087,3022,16109,120
2022-04-09,Merced,047,269075,62212,62231,8620,70851,811
2022-04-09,Modoc,049,8938,739,743,252,995,8
2022-04-09,Mono,051,14174,2973,2967,122,3089,6
2022-04-09,Monterey,053,433212,79518,79103,13712,92815,727
2022-04-09,Napa,055,140530,25929,25824,974,26798,144
2022-04-09,Nevada,057,99092,15996,15976,1199,17175,123
2022-04-09,Orange,059,3164182,547989,546983,41351,588334,6912
2022-04-09,Placer,061,380077,62904,62831,7347,70178,616
2022-04-09,Plumas,063,18699,2974,2887,366,3253,13
2022-04-09,Riverside,065,2383286,592026,591268,27808,619076,6429
2022-04-09,Sacramento,067,1510023,281258,277125,26463,303588,2972
2022-04-09,San Benito,069,59416,12902,12917,512,13429,98
2022-04-09,San Bernardino,071,2135413,570345,562571,24719,587290,6892
2022-04-09,San Diego,073,3302833,753426,754281,52807,807088,5210
2022-04-09,San Francisco,075,870044,126444,125963,8325,134288,844
2022-04-09,San Joaquin,077,732212,166633,166547,9901,176448,2212
2022-04-09,San Luis Obispo,079,281455,52591,52609,3763,56372,476
2022-04-09,San Mateo,081,765935,122928,121514,7017,128531,698
2022-04-09,Santa Barbara,083,443738,86053,85754,4705,90459,680
2022-04-09,Santa Clara,085,1922200,313490,313965,12444,326409,2266
2022-04-09,Santa Cruz,087,273765,48134,47624,2106,49730,259
2022-04-09,Shasta,089,179085,30577,30586,6092,36678,549
2022-04-09,Sierra,091,2930,273,272,48,320,4
2022-04-09,Siskiyou,093,43540,4450,4444,2723,7167,80
2022-04-09,Solano,095,438530,81716,81886,5578,87464,448
2022-04-09,Sonoma,097,501317,84036,83600,2633,86233,485
2022-04-09,Stanislaus,099,539301,117579,117528,17589,135117,1578
2022-04-09,Sutter,101,95872,20500,20591,2075,22666,223
2022-04-09,Tehama,103,63373,12040,12059,2581,14640,201
2022-04-09,Trinity,105,12862,1183,1177,287,1464,20
2022-04-09,Tulare,107,460477,106383,105278,27579,132857,1415
2022-04-09,Tuolumne,109,53932,12659,12632,556,13188,180
2022-04-09,Ventura,111,848112,173658,173343,9413,182756,1467
2022-04-09,Yolo,113,214977,37196,36587,3052,39639,312
2022-04-09,Yuba,115,75493,15852,15848,1201,17049,121
2022-04-08,Alameda,001,1643700,257826,256649,13942,270591,1826
2022-04-08,Alpine,003,1148,124,124,1,125,0
2022-04-08,Amador,005,37829,8529,8489,644,9133,86
2022-04-08,Butte,007,227075,33173,33031,6946,39977,399
2022-04-08,Calaveras,009,45235,7272,7260,348,7608,119
2022-04-08,Colusa,011,21464,3445,3449,1049,4498,21
2022-04-08,Contra Costa,013,1133247,190131,189154,13202,202356,1296
2022-04-08,Del Norte,015,27424,5817,5811,184,5995,50
2022-04-08,El Dorado,017,186661,26808,26757,3207,29964,207
2022-04-08,Fresno,019,978130,231472,231090,23621,254711,2731
2022-04-08,Glenn,021,27897,4988,4988,1603,6591,47
2022-04-08,Humboldt,023,135768,16914,16913,2959,19872,141
2022-04-08,Imperial,025,180216,55397,55267,10554,65821,910
2022-04-08,Inyo,027,18085,4078,4071,484,4555,56
2022-04-08,Kern,029,883053,191936,191542,45734,237276,2244
2022-04-08,Kings,031,150075,51508,51519,3506,55025,443
2022-04-08,Lake,033,64148,10717,10690,884,11574,134
2022-04-08,Lassen,035,31185,8962,8948,874,9822,65
2022-04-08,Los Angeles,037,10098052,2718472,2709735,123767,2833502,31509
2022-04-08,Madera,039,155013,37292,37356,6029,43385,354
2022-04-08,Marin,041,260295,33781,33648,2340,35988,288
2022-04-08,Mariposa,043,17540,2407,2394,200,2594,29
2022-04-08,Mendocino,045,87422,13097,13087,3022,16109,120
2022-04-08,Merced,047,269075,62205,62231,8618,70849,811
2022-04-08,Modoc,049,8938,739,743,252,995,8
2022-04-08,Mono,051,14174,2971,2967,122,3089,6
2022-04-08,Monterey,053,433212,79508,79103,13711,92814,727
2022-04-08,Napa,055,140530,25917,25824,966,26790,144
2022-04-08,Nevada,057,99092,15993,15976,1199,17175,123
2022-04-08,Orange,059,3164182,547870,546983,41337,588320,6912
2022-04-08,Placer,061,380077,62886,62831,7345,70176,616
2022-04-08,Plumas,063,18699,2971,2887,366,3253,13
2022-04-08,Riverside,065,2383286,591950,591268,27805,619073,6429
2022-04-08,Sacramento,067,1510023,281212,277125,26462,303587,2972
2022-04-08,San Benito,069,59416,12902,12917,512,13429,98
2022-04-08,San Bernardino,071,2135413,570292,562571,24716,587287,6892
2022-04-08,San Diego,073,3302833,753256,754281,52797,807078,5210
2022-04-08,San Francisco,075,870044,126348,125963,8321,134284,844
2022-04-08,San Joaquin,077,732212,166615,166547,9899,176446,2212
2022-04-08,San Luis Obispo,079,281455,52586,52609,3763,56372,476
2022-04-08,San Mateo,081,765935,122822,121514,7012,128526,698
2022-04-08,Santa Barbara,083,443738,86032,85754,4705,90459,680
2022-04-08,Santa Clara,085,1922200,313304,313965,12437,326402,2266
2022-04-08,Santa Cruz,087,273765,48117,47624,2103,49727,259
2022-04-08,Shasta,089,179085,30574,30586,6092,36678,549
2022-04-08,Sierra,091,2930,273,272,48,320,4
2022-04-08,Siskiyou,093,43540,4450,4444,2723,7167,80
2022-04-08,Solano,095,438530,81696,81886,5577,87463,448
2022-04-08,Sonoma,097,501317,83985,83600,2629,86229,485
2022-04-08,Stanislaus,099,539301,117564,117528,17588,135116,1578
2022-04-08,Sutter,101,95872,20500,20591,2075,22666,223
2022-04-08,Tehama,103,63373,12040,12059,2581,14640,201
2022-04-08,Trinity,105,12862,1183,1177,287,1464,20
2022-04-08,Tulare,107,460477,106378,105278,27575,132853,1415
2022-04-08,Tuolumne,109,53932,12658,12632,555,13187,180
2022-04-08,Ventura,111,848112,173629,173343,9411,182754,1467
2022-04-08,Yolo,113,214977,37187,36587,3051,39638,312
2022-04-08,Yuba,115,75493,15851,15848,1201,17049,121
2022-04-07,Alameda,001,1643700,257634,256649,13935,270584,1826
2022-04-07,Alpine,003,1148,124,124,1,125,0
2022-04-07,Amador,005,37829,8528,8489,641,9130,86
2022-04-07,Butte,007,227075,33169,33031,6945,39976,399
2022-04-07,Calaveras,009,45235,7270,7260,348,7608,119
2022-04-07,Colusa,011,21464,3444,3449,1049,4498,21
2022-04-07,Contra Costa,013,1133247,190011,189154,13190,202344,1296
2022-04-07,Del Norte,015,27424,5816,5811,184,5995,50
2022-04-07,El Dorado,017,186661,26796,26757,3205,29962,207
2022-04-07,Fresno,019,978130,231446,231090,23620,254710,2731
2022-04-07,Glenn,021,27897,4986,4988,1602,6590,47
2022-04-07,Humboldt,023,135768,16907,16913,2957,19870,141
2022-04-07,Imperial,025,180216,55395,55267,10552,65819,910
2022-04-07,Inyo,027,18085,4078,4071,484,4555,56
2022-04-07,Kern,029,883053,191912,191542,45731,237273,2244
2022-04-07,Kings,031,150075,51500,51519,3506,55025,443
2022-04-07,Lake,033,64148,10713,10690,884,11574,134
2022-04-07,Lassen,035,31185,8962,8948,874,9822,65
2022-04-07,Los Angeles,037,10098052,2717554,2709735,123693,2833428,31509
2022-04-07,Madera,039,155013,37287,37356,6029,43385,354
2022-04-07,Marin,041,260295,33762,33648,2321,35969,288
2022-04-07,Mariposa,043,17540,2404,2394,199,2593,29
2022-04-07,Mendocino,045,87422,13093,13087,3021,16108,120
2022-04-07,Merced,047,269075,62196,62231,8614,70845,811
2022-04-07,Modoc,049,8938,739,743,252,995,8
2022-04-07,Mono,051,14174,2970,2967,122,3089,6
2022-04-07,Monterey,053,433212,79487,79103,13707,92810,727
2022-04-07,Napa,055,140530,25901,25824,962,26786,144
2022-04-07,Nevada,057,99092,15985,15976,1198,17174,123
2022-04-07,Orange,059,3164182,547711,546983,41308,588291,6912
2022-04-07,Placer,061,380077,62869,62831,7342,70173,616
2022-04-07,Plumas,063,18699,2971,2887,366,3253,13
2022-04-07,Riverside,065,2383286,591848,591268,27791,619059,6429
2022-04-07,Sacramento,067,1510023,281146,277125,26455,303580,2972
2022-04-07,San Benito,069,59416,12901,12917,512,13429,98
2022-04-07,San Bernardino,071,2135413,570132,562571,24703,587274,6892
2022-04-07,San Diego,073,3302833,752988,754281,52765,807046,5210
2022-04-07,San Francisco,075,870044,126191,125963,8307,134270,844
2022-04-07,San Joaquin,077,732212,166575,166547,9896,176443,2212
2022-04-07,San Luis Obispo,079,281455,52568,52609,3761,56370,476
2022-04-07,San Mateo,081,765935,122700,121514,6995,128509,698
2022-04-07,Santa Barbara,083,443738,85988,85754,4703,90457,680
2022-04-07,Santa Clara,085,1922200,313081,313965,12425,326390,2266
2022-04-07,Santa Cruz,087,273765,48098,47624,2099,49723,259
2022-04-07,Shasta,089,179085,30572,30586,6092,36678,549
2022-04-07,Sierra,091,2930,273,272,48,320,4
2022-04-07,Siskiyou,093,43540,4450,4444,2722,7166,80
2022-04-07,Solano,095,438530,81666,81886,5577,87463,448
2022-04-07,Sonoma,097,501317,83942,83600,2623,86223,485
2022-04-07,Stanislaus,099,539301,117542,117528,17585,135113,1578
2022-04-07,Sutter,101,95872,20496,20591,2074,22665,223
2022-04-07,Tehama,103,63373,12038,12059,2581,14640,201
2022-04-07,Trinity,105,12862,1183,1177,287,1464,20
2022-04-07,Tulare,107,460477,106372,105278,27574,132852,1415
2022-04-07,Tuolumne,109,53932,12656,12632,554,13186,180
2022-04-07,Ventura,111,848112,173600,173343,9409,182752,1467
2022-04-07,Yolo,113,214977,37168,36587,3051,39638,312
2022-04-07,Yuba,115,75493,15849,15848,1201,17049,121
2022-04-06,Alameda,001,1643700,257448,256143,13928,270071,1814
2022-04-06,Alpine,003,1148,124,124,1,125,0
2022-04-06,Amador,005,37829,8527,8488,641,9129,86
2022-04-06,Butte,007,227075,33164,32997,6943,39940,396
2022-04-06,Calaveras,009,45235,7268,7258,348,7606,120
2022-04-06,Colusa,011,21464,3444,3447,1049,4496,21
2022-04-06,Contra Costa,013,1133247,189944,188850,13175,202025,1296
2022-04-06,Del Norte,015,27424,5816,5809,184,5993,50
2022-04-06,El Dorado,017,186661,26793,26744,3205,29949,205
2022-04-06,Fresno,019,978130,231411,230942,23616,254558,2725
2022-04-06,Glenn,021,27897,4986,4986,1601,6587,47
2022-04-06,Humboldt,023,135768,16903,16904,2956,19860,140
2022-04-06,Imperial,025,180216,55389,55294,10552,65846,908
2022-04-06,Inyo,027,18085,4077,4068,482,4550,56
2022-04-06,Kern,029,883053,191890,191449,45728,237177,2234
2022-04-06,Kings,031,150075,51499,51491,3505,54996,443
2022-04-06,Lake,033,64148,10709,10679,884,11563,136
2022-04-06,Lassen,035,31185,8962,8945,874,9819,65
2022-04-06,Los Angeles,037,10098052,2716505,2707306,123627,2830933,31465
2022-04-06,Madera,039,155013,37283,37349,6029,43378,354
2022-04-06,Marin,041,260295,33742,33566,2313,35879,288
2022-04-06,Mariposa,043,17540,2403,2392,199,2591,29
2022-04-06,Mendocino,045,87422,13089,13074,3020,16094,119
2022-04-06,Merced,047,269075,62187,62195,8611,70806,810
2022-04-06,Modoc,049,8938,739,741,252,993,8
2022-04-06,Mono,051,14174,2969,2967,122,3089,6
2022-04-06,Monterey,053,433212,79474,79019,13699,92718,727
2022-04-06,Napa,055,140530,25882,25790,958,26748,143
2022-04-06,Nevada,057,99092,15983,15974,1198,17172,123
2022-04-06,Orange,059,3164182,547542,546491,41285,587776,6887
2022-04-06,Placer,061,380077,62863,62787,7341,70128,615
2022-04-06,Plumas,063,18699,2971,2850,366,3216,13
2022-04-06,Riverside,065,2383286,591751,590826,27786,618612,6424
2022-04-06,Sacramento,067,1510023,281068,276567,26451,303018,2953
2022-04-06,San Benito,069,59416,12900,12908,512,13420,98
2022-04-06,San Bernardino,071,2135413,570001,561648,24701,586349,6883
2022-04-06,San Diego,073,3302833,752693,753402,52727,806129,5192
2022-04-06,San Francisco,075,870044,126031,125536,8301,133837,843
2022-04-06,San Joaquin,077,732212,166543,166415,9893,176308,2207
2022-04-06,San Luis Obispo,079,281455,52546,52557,3759,56316,475
2022-04-06,San Mateo,081,765935,122592,121041,6983,128024,693
2022-04-06,Santa Barbara,083,443738,85948,85630,4699,90329,679
2022-04-06,Santa Clara,085,1922200,312883,313278,12405,325683,2265
2022-04-06,Santa Cruz,087,273765,48043,47446,2094,49540,259
2022-04-06,Shasta,089,179085,30571,30565,6092,36657,529
2022-04-06,Sierra,091,2930,273,272,48,320,4
2022-04-06,Siskiyou,093,43540,4450,4442,2722,7164,80
2022-04-06,Solano,095,438530,81632,81789,5572,87361,447
2022-04-06,Sonoma,097,501317,83878,83361,2618,85979,485
2022-04-06,Stanislaus,099,539301,117526,117534,17579,135113,1578
2022-04-06,Sutter,101,95872,20491,20581,2074,22655,222
2022-04-06,Tehama,103,63373,12037,12049,2581,14630,198
2022-04-06,Trinity,105,12862,1183,1173,287,1460,20
2022-04-06,Tulare,107,460477,106366,104826,27569,132395,1414
2022-04-06,Tuolumne,109,53932,12654,12621,554,13175,180
2022-04-06,Ventura,111,848112,173546,173179,9404,182583,1460
2022-04-06,Yolo,113,214977,37143,36393,3050,39443,314
2022-04-06,Yuba,115,75493,15844,15839,1201,17040,121
2022-04-05,Alameda,001,1643700,257234,256143,13919,270062,1814
2022-04-05,Alpine,003,1148,124,124,1,125,0
2022-04-05,Amador,005,37829,8525,8488,641,9129,86
2022-04-05,Butte,007,227075,33158,32997,6940,39937,396
2022-04-05,Calaveras,009,45235,7264,7258,348,7606,120
2022-04-05,Colusa,011,21464,3442,3447,1048,4495,21
2022-04-05,Contra Costa,013,1133247,189848,188850,13168,202018,1296
2022-04-05,Del Norte,015,27424,5814,5809,184,5993,50
2022-04-05,El Dorado,017,186661,26781,26744,3205,29949,205
2022-04-05,Fresno,019,978130,231375,230942,23608,254550,2725
2022-04-05,Glenn,021,27897,4986,4986,1600,6586,47
2022-04-05,Humboldt,023,135768,16897,16904,2956,19860,140
2022-04-05,Imperial,025,180216,55387,55294,10552,65846,908
2022-04-05,Inyo,027,18085,4076,4068,481,4549,56
2022-04-05,Kern,029,883053,191870,191449,45725,237174,2234
2022-04-05,Kings,031,150075,51496,51491,3505,54996,443
2022-04-05,Lake,033,64148,10706,10679,884,11563,136
2022-04-05,Lassen,035,31185,8962,8945,874,9819,65
2022-04-05,Los Angeles,037,10098052,2715446,2707306,123553,2830859,31465
2022-04-05,Madera,039,155013,37276,37349,6027,43376,354
2022-04-05,Marin,041,260295,33687,33566,2298,35864,288
2022-04-05,Mariposa,043,17540,2403,2392,199,2591,29
2022-04-05,Mendocino,045,87422,13083,13074,3019,16093,119
2022-04-05,Merced,047,269075,62176,62195,8606,70801,810
2022-04-05,Modoc,049,8938,739,741,252,993,8
2022-04-05,Mono,051,14174,2968,2967,122,3089,6
2022-04-05,Monterey,053,433212,79451,79019,13688,92707,727
2022-04-05,Napa,055,140530,25873,25790,953,26743,143
2022-04-05,Nevada,057,99092,15975,15974,1198,17172,123
2022-04-05,Orange,059,3164182,547357,546491,41256,587747,6887
2022-04-05,Placer,061,380077,62837,62787,7341,70128,615
2022-04-05,Plumas,063,18699,2971,2850,366,3216,13
2022-04-05,Riverside,065,2383286,591630,590826,27774,618600,6424
2022-04-05,Sacramento,067,1510023,280989,276567,26446,303013,2953
2022-04-05,San Benito,069,59416,12892,12908,512,13420,98
2022-04-05,San Bernardino,071,2135413,569874,561648,24691,586339,6883
2022-04-05,San Diego,073,3302833,752385,753402,52683,806085,5192
2022-04-05,San Francisco,075,870044,125827,125536,8293,133829,843
2022-04-05,San Joaquin,077,732212,166501,166415,9890,176305,2207
2022-04-05,San Luis Obispo,079,281455,52529,52557,3754,56311,475
2022-04-05,San Mateo,081,765935,122475,121041,6972,128013,693
2022-04-05,Santa Barbara,083,443738,85912,85630,4698,90328,679
2022-04-05,Santa Clara,085,1922200,312623,313278,12392,325670,2265
2022-04-05,Santa Cruz,087,273765,47976,47446,2091,49537,259
2022-04-05,Shasta,089,179085,30571,30565,6090,36655,529
2022-04-05,Sierra,091,2930,273,272,48,320,4
2022-04-05,Siskiyou,093,43540,4450,4442,2722,7164,80
2022-04-05,Solano,095,438530,81582,81789,5569,87358,447
2022-04-05,Sonoma,097,501317,83814,83361,2609,85970,485
2022-04-05,Stanislaus,099,539301,117512,117534,17570,135104,1578
2022-04-05,Sutter,101,95872,20487,20581,2073,22654,222
2022-04-05,Tehama,103,63373,12035,12049,2580,14629,198
2022-04-05,Trinity,105,12862,1183,1173,287,1460,20
2022-04-05,Tulare,107,460477,106356,104826,27566,132392,1414
2022-04-05,Tuolumne,109,53932,12653,12621,554,13175,180
2022-04-05,Ventura,111,848112,173489,173179,9397,182576,1460
2022-04-05,Yolo,113,214977,37128,36393,3047,39440,314
2022-04-05,Yuba,115,75493,15842,15839,1201,17040,121
2022-04-04,Alameda,001,1643700,257003,256143,13905,270048,1814
2022-04-04,Alpine,003,1148,124,124,1,125,0
2022-04-04,Amador,005,37829,8524,8488,640,9128,86
2022-04-04,Butte,007,227075,33153,32997,6937,39934,396
2022-04-04,Calaveras,009,45235,7264,7258,348,7606,120
2022-04-04,Colusa,011,21464,3441,3447,1048,4495,21
2022-04-04,Contra Costa,013,1133247,189748,188850,13160,202010,1296
2022-04-04,Del Norte,015,27424,5814,5809,184,5993,50
2022-04-04,El Dorado,017,186661,26776,26744,3205,29949,205
2022-04-04,Fresno,019,978130,231357,230942,23603,254545,2725
2022-04-04,Glenn,021,27897,4985,4986,1600,6586,47
2022-04-04,Humboldt,023,135768,16889,16904,2951,19855,140
2022-04-04,Imperial,025,180216,55382,55294,10552,65846,908
2022-04-04,Inyo,027,18085,4076,4068,479,4547,56
2022-04-04,Kern,029,883053,191848,191449,45720,237169,2234
2022-04-04,Kings,031,150075,51489,51491,3505,54996,443
2022-04-04,Lake,033,64148,10701,10679,884,11563,136
2022-04-04,Lassen,035,31185,8962,8945,874,9819,65
2022-04-04,Los Angeles,037,10098052,2714344,2707306,123506,2830812,31465
2022-04-04,Madera,039,155013,37272,37349,6027,43376,354
2022-04-04,Marin,041,260295,33670,33566,2289,35855,288
2022-04-04,Mariposa,043,17540,2402,2392,199,2591,29
2022-04-04,Mendocino,045,87422,13077,13074,3017,16091,119
2022-04-04,Merced,047,269075,62166,62195,8601,70796,810
2022-04-04,Modoc,049,8938,739,741,252,993,8
2022-04-04,Mono,051,14174,2968,2967,122,3089,6
2022-04-04,Monterey,053,433212,79435,79019,13682,92701,727
2022-04-04,Napa,055,140530,25856,25790,952,26742,143
2022-04-04,Nevada,057,99092,15971,15974,1197,17171,123
2022-04-04,Orange,059,3164182,547190,546491,41230,587721,6887
2022-04-04,Placer,061,380077,62827,62787,7340,70127,615
2022-04-04,Plumas,063,18699,2970,2850,366,3216,13
2022-04-04,Riverside,065,2383286,591538,590826,27762,618588,6424
2022-04-04,Sacramento,067,1510023,280898,276567,26438,303005,2953
2022-04-04,San Benito,069,59416,12889,12908,512,13420,98
2022-04-04,San Bernardino,071,2135413,569738,561648,24684,586332,6883
2022-04-04,San Diego,073,3302833,752066,753402,52646,806048,5192
2022-04-04,San Francisco,075,870044,125629,125536,8284,133820,843
2022-04-04,San Joaquin,077,732212,166475,166415,9887,176302,2207
2022-04-04,San Luis Obispo,079,281455,52506,52557,3752,56309,475
2022-04-04,San Mateo,081,765935,122339,121041,6958,127999,693
2022-04-04,Santa Barbara,083,443738,85867,85630,4697,90327,679
2022-04-04,Santa Clara,085,1922200,312354,313278,12380,325658,2265
2022-04-04,Santa Cruz,087,273765,47929,47446,2091,49537,259
2022-04-04,Shasta,089,179085,30568,30565,6089,36654,529
2022-04-04,Sierra,091,2930,273,272,48,320,4
2022-04-04,Siskiyou,093,43540,4450,4442,2722,7164,80
2022-04-04,Solano,095,438530,81537,81789,5566,87355,447
2022-04-04,Sonoma,097,501317,83759,83361,2602,85963,485
2022-04-04,Stanislaus,099,539301,117491,117534,17563,135097,1578
2022-04-04,Sutter,101,95872,20484,20581,2073,22654,222
2022-04-04,Tehama,103,63373,12033,12049,2580,14629,198
2022-04-04,Trinity,105,12862,1183,1173,287,1460,20
2022-04-04,Tulare,107,460477,106347,104826,27563,132389,1414
2022-04-04,Tuolumne,109,53932,12646,12621,554,13175,180
2022-04-04,Ventura,111,848112,173449,173179,9395,182574,1460
2022-04-04,Yolo,113,214977,37114,36393,3045,39438,314
2022-04-04,Yuba,115,75493,15840,15839,1201,17040,121
2022-04-03,Alameda,001,1643700,256748,255650,13903,269553,1813
2022-04-03,Alpine,003,1148,124,124,1,125,0
2022-04-03,Amador,005,37829,8523,8485,640,9125,86
2022-04-03,Butte,007,227075,33146,32981,6935,39916,396
2022-04-03,Calaveras,009,45235,7264,7254,348,7602,119
2022-04-03,Colusa,011,21464,3441,3445,1048,4493,21
2022-04-03,Contra Costa,013,1133247,189642,188658,13150,201808,1291
2022-04-03,Del Norte,015,27424,5814,5812,184,5996,50
2022-04-03,El Dorado,017,186661,26762,26732,3203,29935,200
2022-04-03,Fresno,019,978130,231324,230559,23600,254159,2722
2022-04-03,Glenn,021,27897,4985,4982,1600,6582,47
2022-04-03,Humboldt,023,135768,16884,16898,2951,19849,140
2022-04-03,Imperial,025,180216,55380,55266,10549,65815,908
2022-04-03,Inyo,027,18085,4074,4063,479,4542,56
2022-04-03,Kern,029,883053,191823,191384,45715,237099,2224
2022-04-03,Kings,031,150075,51483,51470,3503,54973,443
2022-04-03,Lake,033,64148,10699,10674,884,11558,136
2022-04-03,Lassen,035,31185,8961,8943,874,9817,65
2022-04-03,Los Angeles,037,10098052,2713151,2703576,123421,2826997,31410
2022-04-03,Madera,039,155013,37270,37333,6026,43359,354
2022-04-03,Marin,041,260295,33635,33493,2281,35774,287
2022-04-03,Mariposa,043,17540,2401,2391,199,2590,29
2022-04-03,Mendocino,045,87422,13071,13058,3016,16074,119
2022-04-03,Merced,047,269075,62151,62149,8597,70746,808
2022-04-03,Modoc,049,8938,738,741,252,993,8
2022-04-03,Mono,051,14174,2968,2967,122,3089,6
2022-04-03,Monterey,053,433212,79417,78964,13657,92621,726
2022-04-03,Napa,055,140530,25836,25757,951,26708,143
2022-04-03,Nevada,057,99092,15965,15962,1196,17158,123
2022-04-03,Orange,059,3164182,546988,546047,41205,587252,6880
2022-04-03,Placer,061,380077,62801,62740,7335,70075,614
2022-04-03,Plumas,063,18699,2969,2803,366,3169,14
2022-04-03,Riverside,065,2383286,591381,590563,27747,618310,6418
2022-04-03,Sacramento,067,1510023,280822,276218,26425,302643,2950
2022-04-03,San Benito,069,59416,12885,12901,512,13413,98
2022-04-03,San Bernardino,071,2135413,569592,561362,24681,586043,6865
2022-04-03,San Diego,073,3302833,751736,752281,52609,804890,5178
2022-04-03,San Francisco,075,870044,125398,125075,8278,133353,843
2022-04-03,San Joaquin,077,732212,166418,166336,9882,176218,2202
2022-04-03,San Luis Obispo,079,281455,52487,52512,3752,56264,475
2022-04-03,San Mateo,081,765935,122199,120717,6951,127668,693
2022-04-03,Santa Barbara,083,443738,85822,85611,4695,90306,678
2022-04-03,Santa Clara,085,1922200,312055,312517,12371,324888,2258
2022-04-03,Santa Cruz,087,273765,47875,47371,2089,49460,259
2022-04-03,Shasta,089,179085,30558,30556,6088,36644,530
2022-04-03,Sierra,091,2930,273,273,48,321,4
2022-04-03,Siskiyou,093,43540,4450,4439,2722,7161,80
2022-04-03,Solano,095,438530,81496,81848,5561,87409,446
2022-04-03,Sonoma,097,501317,83681,83235,2594,85829,485
2022-04-03,Stanislaus,099,539301,117460,117536,17557,135093,1581
2022-04-03,Sutter,101,95872,20481,20570,2073,22643,222
2022-04-03,Tehama,103,63373,12030,12046,2580,14626,198
2022-04-03,Trinity,105,12862,1183,1173,287,1460,20
2022-04-03,Tulare,107,460477,106340,104736,27554,132290,1410
2022-04-03,Tuolumne,109,53932,12645,12618,554,13172,180
2022-04-03,Ventura,111,848112,173396,173044,9392,182436,1460
2022-04-03,Yolo,113,214977,37093,36347,3043,39390,313
2022-04-03,Yuba,115,75493,15838,15835,1201,17036,120
2022-04-02,Alameda,001,1643700,256645,255650,13902,269552,1813
2022-04-02,Alpine,003,1148,124,124,1,125,0
2022-04-02,Amador,005,37829,8523,8485,640,9125,86
2022-04-02,Butte,007,227075,33142,32981,6935,39916,396
2022-04-02,Calaveras,009,45235,7264,7254,348,7602,119
2022-04-02,Colusa,011,21464,3441,3445,1048,4493,21
2022-04-02,Contra Costa,013,1133247,189583,188658,13147,201805,1291
2022-04-02,Del Norte,015,27424,5813,5812,184,5996,50
2022-04-02,El Dorado,017,186661,26759,26732,3203,29935,200
2022-04-02,Fresno,019,978130,231296,230559,23600,254159,2722
2022-04-02,Glenn,021,27897,4985,4982,1600,6582,47
2022-04-02,Humboldt,023,135768,16880,16898,2951,19849,140
2022-04-02,Imperial,025,180216,55377,55266,10549,65815,908
2022-04-02,Inyo,027,18085,4074,4063,479,4542,56
2022-04-02,Kern,029,883053,191809,191384,45711,237095,2224
2022-04-02,Kings,031,150075,51480,51470,3503,54973,443
2022-04-02,Lake,033,64148,10698,10674,884,11558,136
2022-04-02,Lassen,035,31185,8961,8943,874,9817,65
2022-04-02,Los Angeles,037,10098052,2712640,2703576,123380,2826956,31410
2022-04-02,Madera,039,155013,37267,37333,6026,43359,354
2022-04-02,Marin,041,260295,33612,33493,2273,35766,287
2022-04-02,Mariposa,043,17540,2400,2391,199,2590,29
2022-04-02,Mendocino,045,87422,13069,13058,3016,16074,119
2022-04-02,Merced,047,269075,62148,62149,8597,70746,808
2022-04-02,Modoc,049,8938,738,741,252,993,8
2022-04-02,Mono,051,14174,2968,2967,121,3088,6
2022-04-02,Monterey,053,433212,79404,78964,13651,92615,726
2022-04-02,Napa,055,140530,25822,25757,950,26707,143
2022-04-02,Nevada,057,99092,15961,15962,1195,17157,123
2022-04-02,Orange,059,3164182,546882,546047,41193,587240,6880
2022-04-02,Placer,061,380077,62790,62740,7333,70073,614
2022-04-02,Plumas,063,18699,2969,2803,366,3169,14
2022-04-02,Riverside,065,2383286,591307,590563,27742,618305,6418
2022-04-02,Sacramento,067,1510023,280783,276218,26424,302642,2950
2022-04-02,San Benito,069,59416,12884,12901,512,13413,98
2022-04-02,San Bernardino,071,2135413,569541,561362,24678,586040,6865
2022-04-02,San Diego,073,3302833,751612,752281,52600,804881,5178
2022-04-02,San Francisco,075,870044,125294,125075,8270,133345,843
2022-04-02,San Joaquin,077,732212,166397,166336,9880,176216,2202
2022-04-02,San Luis Obispo,079,281455,52482,52512,3752,56264,475
2022-04-02,San Mateo,081,765935,122104,120717,6942,127659,693
2022-04-02,Santa Barbara,083,443738,85803,85611,4694,90305,678
2022-04-02,Santa Clara,085,1922200,311889,312517,12367,324884,2258
2022-04-02,Santa Cruz,087,273765,47863,47371,2088,49459,259
2022-04-02,Shasta,089,179085,30557,30556,6088,36644,530
2022-04-02,Sierra,091,2930,273,273,48,321,4
2022-04-02,Siskiyou,093,43540,4449,4439,2721,7160,80
2022-04-02,Solano,095,438530,81481,81848,5561,87409,446
2022-04-02,Sonoma,097,501317,83633,83235,2588,85823,485
2022-04-02,Stanislaus,099,539301,117451,117536,17555,135091,1581
2022-04-02,Sutter,101,95872,20476,20570,2073,22643,222
2022-04-02,Tehama,103,63373,12030,12046,2580,14626,198
2022-04-02,Trinity,105,12862,1183,1173,287,1460,20
2022-04-02,Tulare,107,460477,106336,104736,27554,132290,1410
2022-04-02,Tuolumne,109,53932,12643,12618,554,13172,180
2022-04-02,Ventura,111,848112,173356,173044,9392,182436,1460
2022-04-02,Yolo,113,214977,37081,36347,3040,39387,313
2022-04-02,Yuba,115,75493,15837,15835,1201,17036,120
2022-04-01,Alameda,001,1643700,256530,255650,13898,269548,1813
2022-04-01,Alpine,003,1148,124,124,1,125,0
2022-04-01,Amador,005,37829,8523,8485,640,9125,86
2022-04-01,Butte,007,227075,33138,32981,6932,39913,396
2022-04-01,Calaveras,009,45235,7262,7254,348,7602,119
2022-04-01,Colusa,011,21464,3440,3445,1048,4493,21
2022-04-01,Contra Costa,013,1133247,189530,188658,13146,201804,1291
2022-04-01,Del Norte,015,27424,5811,5812,184,5996,50
2022-04-01,El Dorado,017,186661,26756,26732,3202,29934,200
2022-04-01,Fresno,019,978130,231270,230559,23598,254157,2722
2022-04-01,Glenn,021,27897,4985,4982,1600,6582,47
2022-04-01,Humboldt,023,135768,16878,16898,2951,19849,140
2022-04-01,Imperial,025,180216,55375,55266,10549,65815,908
2022-04-01,Inyo,027,18085,4072,4063,478,4541,56
2022-04-01,Kern,029,883053,191798,191384,45708,237092,2224
2022-04-01,Kings,031,150075,51477,51470,3503,54973,443
2022-04-01,Lake,033,64148,10695,10674,884,11558,136
2022-04-01,Lassen,035,31185,8960,8943,874,9817,65
2022-04-01,Los Angeles,037,10098052,2712143,2703576,123337,2826913,31410
2022-04-01,Madera,039,155013,37266,37333,6026,43359,354
2022-04-01,Marin,041,260295,33594,33493,2266,35759,287
2022-04-01,Mariposa,043,17540,2397,2391,199,2590,29
2022-04-01,Mendocino,045,87422,13066,13058,3015,16073,119
2022-04-01,Merced,047,269075,62141,62149,8596,70745,808
2022-04-01,Modoc,049,8938,738,741,252,993,8
2022-04-01,Mono,051,14174,2968,2967,121,3088,6
2022-04-01,Monterey,053,433212,79386,78964,13648,92612,726
2022-04-01,Napa,055,140530,25813,25757,950,26707,143
2022-04-01,Nevada,057,99092,15961,15962,1194,17156,123
2022-04-01,Orange,059,3164182,546774,546047,41185,587232,6880
2022-04-01,Placer,061,380077,62776,62740,7333,70073,614
2022-04-01,Plumas,063,18699,2969,2803,365,3168,14
2022-04-01,Riverside,065,2383286,591241,590563,27729,618292,6418
2022-04-01,Sacramento,067,1510023,280744,276218,26420,302638,2950
2022-04-01,San Benito,069,59416,12883,12901,512,13413,98
2022-04-01,San Bernardino,071,2135413,569485,561362,24674,586036,6865
2022-04-01,San Diego,073,3302833,751465,752281,52585,804866,5178
2022-04-01,San Francisco,075,870044,125183,125075,8264,133339,843
2022-04-01,San Joaquin,077,732212,166377,166336,9878,176214,2202
2022-04-01,San Luis Obispo,079,281455,52476,52512,3751,56263,475
2022-04-01,San Mateo,081,765935,122042,120717,6936,127653,693
2022-04-01,Santa Barbara,083,443738,85783,85611,4694,90305,678
2022-04-01,Santa Clara,085,1922200,311739,312517,12366,324883,2258
2022-04-01,Santa Cruz,087,273765,47848,47371,2086,49457,259
2022-04-01,Shasta,089,179085,30556,30556,6088,36644,530
2022-04-01,Sierra,091,2930,273,273,48,321,4
2022-04-01,Siskiyou,093,43540,4449,4439,2720,7159,80
2022-04-01,Solano,095,438530,81466,81848,5561,87409,446
2022-04-01,Sonoma,097,501317,83589,83235,2587,85822,485
2022-04-01,Stanislaus,099,539301,117439,117536,17552,135088,1581
2022-04-01,Sutter,101,95872,20476,20570,2073,22643,222
2022-04-01,Tehama,103,63373,12030,12046,2580,14626,198
2022-04-01,Trinity,105,12862,1183,1173,287,1460,20
2022-04-01,Tulare,107,460477,106331,104736,27550,132286,1410
2022-04-01,Tuolumne,109,53932,12642,12618,554,13172,180
2022-04-01,Ventura,111,848112,173325,173044,9388,182432,1460
2022-04-01,Yolo,113,214977,37067,36347,3039,39386,313
2022-04-01,Yuba,115,75493,15836,15835,1201,17036,120
2022-03-31,Alameda,001,1643700,256355,255650,13885,269535,1813
2022-03-31,Alpine,003,1148,124,124,1,125,0
2022-03-31,Amador,005,37829,8523,8485,640,9125,86
2022-03-31,Butte,007,227075,33134,32981,6929,39910,396
2022-03-31,Calaveras,009,45235,7259,7254,348,7602,119
2022-03-31,Colusa,011,21464,3439,3445,1048,4493,21
2022-03-31,Contra Costa,013,1133247,189434,188658,13140,201798,1291
2022-03-31,Del Norte,015,27424,5810,5812,184,5996,50
2022-03-31,El Dorado,017,186661,26748,26732,3202,29934,200
2022-03-31,Fresno,019,978130,231235,230559,23577,254136,2722
2022-03-31,Glenn,021,27897,4983,4982,1600,6582,47
2022-03-31,Humboldt,023,135768,16874,16898,2951,19849,140
2022-03-31,Imperial,025,180216,55372,55266,10548,65814,908
2022-03-31,Inyo,027,18085,4071,4063,475,4538,56
2022-03-31,Kern,029,883053,191782,191384,45699,237083,2224
2022-03-31,Kings,031,150075,51468,51470,3503,54973,443
2022-03-31,Lake,033,64148,10694,10674,883,11557,136
2022-03-31,Lassen,035,31185,8958,8943,874,9817,65
2022-03-31,Los Angeles,037,10098052,2711400,2703576,123283,2826859,31410
2022-03-31,Madera,039,155013,37263,37333,6026,43359,354
2022-03-31,Marin,041,260295,33568,33493,2254,35747,287
2022-03-31,Mariposa,043,17540,2396,2391,198,2589,29
2022-03-31,Mendocino,045,87422,13062,13058,3015,16073,119
2022-03-31,Merced,047,269075,62136,62149,8593,70742,808
2022-03-31,Modoc,049,8938,738,741,252,993,8
2022-03-31,Mono,051,14174,2968,2967,121,3088,6
2022-03-31,Monterey,053,433212,79369,78964,13637,92601,726
2022-03-31,Napa,055,140530,25804,25757,948,26705,143
2022-03-31,Nevada,057,99092,15954,15962,1193,17155,123
2022-03-31,Orange,059,3164182,546627,546047,41171,587218,6880
2022-03-31,Placer,061,380077,62751,62740,7330,70070,614
2022-03-31,Plumas,063,18699,2969,2803,364,3167,14
2022-03-31,Riverside,065,2383286,591131,590563,27726,618289,6418
2022-03-31,Sacramento,067,1510023,280671,276218,26412,302630,2950
2022-03-31,San Benito,069,59416,12882,12901,512,13413,98
2022-03-31,San Bernardino,071,2135413,569388,561362,24663,586025,6865
2022-03-31,San Diego,073,3302833,751229,752281,52558,804839,5178
2022-03-31,San Francisco,075,870044,125025,125075,8252,133327,843
2022-03-31,San Joaquin,077,732212,166343,166336,9864,176200,2202
2022-03-31,San Luis Obispo,079,281455,52462,52512,3750,56262,475
2022-03-31,San Mateo,081,765935,121932,120717,6934,127651,693
2022-03-31,Santa Barbara,083,443738,85754,85611,4694,90305,678
2022-03-31,Santa Clara,085,1922200,311511,312517,12354,324871,2258
2022-03-31,Santa Cruz,087,273765,47829,47371,2084,49455,259
2022-03-31,Shasta,089,179085,30550,30556,6088,36644,530
2022-03-31,Sierra,091,2930,270,273,48,321,4
2022-03-31,Siskiyou,093,43540,4447,4439,2720,7159,80
2022-03-31,Solano,095,438530,81437,81848,5558,87406,446
2022-03-31,Sonoma,097,501317,83546,83235,2581,85816,485
2022-03-31,Stanislaus,099,539301,117421,117536,17547,135083,1581
2022-03-31,Sutter,101,95872,20473,20570,2072,22642,222
2022-03-31,Tehama,103,63373,12030,12046,2579,14625,198
2022-03-31,Trinity,105,12862,1183,1173,287,1460,20
2022-03-31,Tulare,107,460477,106322,104736,27542,132278,1410
2022-03-31,Tuolumne,109,53932,12641,12618,554,13172,180
2022-03-31,Ventura,111,848112,173285,173044,9385,182429,1460
2022-03-31,Yolo,113,214977,37051,36347,3039,39386,313
2022-03-31,Yuba,115,75493,15836,15835,1198,17033,120
2022-03-30,Alameda,001,1643700,256222,255467,13877,269344,1812
2022-03-30,Alpine,003,1148,124,124,1,125,0
2022-03-30,Amador,005,37829,8523,8485,640,9125,86
2022-03-30,Butte,007,227075,33129,32968,6923,39891,396
2022-03-30,Calaveras,009,45235,7257,7253,347,7600,119
2022-03-30,Colusa,011,21464,3439,3445,1048,4493,21
2022-03-30,Contra Costa,013,1133247,189372,188496,13129,201625,1291
2022-03-30,Del Norte,015,27424,5808,5808,184,5992,50
2022-03-30,El Dorado,017,186661,26740,26722,3202,29924,200
2022-03-30,Fresno,019,978130,231224,230448,23571,254019,2720
2022-03-30,Glenn,021,27897,4982,4982,1600,6582,47
2022-03-30,Humboldt,023,135768,16871,16894,2951,19845,140
2022-03-30,Imperial,025,180216,55368,55252,10545,65797,908
2022-03-30,Inyo,027,18085,4070,4062,473,4535,56
2022-03-30,Kern,029,883053,191754,191363,45694,237057,2219
2022-03-30,Kings,031,150075,51462,51446,3501,54947,443
2022-03-30,Lake,033,64148,10693,10674,883,11557,136
2022-03-30,Lassen,035,31185,8958,8943,874,9817,65
2022-03-30,Los Angeles,037,10098052,2710575,2702536,123228,2825764,31384
2022-03-30,Madera,039,155013,37258,37330,6025,43355,354
2022-03-30,Marin,041,260295,33548,33453,2235,35688,287
2022-03-30,Mariposa,043,17540,2396,2390,198,2588,27
2022-03-30,Mendocino,045,87422,13058,13055,3012,16067,118
2022-03-30,Merced,047,269075,62130,62136,8588,70724,808
2022-03-30,Modoc,049,8938,738,739,252,991,8
2022-03-30,Mono,051,14174,2967,2967,121,3088,6
2022-03-30,Monterey,053,433212,79352,78911,13630,92541,726
2022-03-30,Napa,055,140530,25792,25745,947,26692,141
2022-03-30,Nevada,057,99092,15951,15960,1191,17151,123
2022-03-30,Orange,059,3164182,546474,545895,41149,587044,6876
2022-03-30,Placer,061,380077,62736,62705,7326,70031,614
2022-03-30,Plumas,063,18699,2969,2762,362,3124,13
2022-03-30,Riverside,065,2383286,591048,590437,27713,618150,6411
2022-03-30,Sacramento,067,1510023,280603,276081,26405,302486,2949
2022-03-30,San Benito,069,59416,12878,12898,512,13410,98
2022-03-30,San Bernardino,071,2135413,569304,561153,24659,585812,6863
2022-03-30,San Diego,073,3302833,750997,751684,52532,804216,5169
2022-03-30,San Francisco,075,870044,124920,124930,8243,133173,841
2022-03-30,San Joaquin,077,732212,166315,166299,9858,176157,2201
2022-03-30,San Luis Obispo,079,281455,52449,52484,3746,56230,475
2022-03-30,San Mateo,081,765935,121830,120548,6934,127482,693
2022-03-30,Santa Barbara,083,443738,85732,85488,4691,90179,677
2022-03-30,Santa Clara,085,1922200,311328,312253,12334,324587,2258
2022-03-30,Santa Cruz,087,273765,47773,47340,2083,49423,259
2022-03-30,Shasta,089,179085,30547,30555,6088,36643,530
2022-03-30,Sierra,091,2930,270,273,48,321,4
2022-03-30,Siskiyou,093,43540,4447,4439,2720,7159,80
2022-03-30,Solano,095,438530,81418,81816,5554,87370,443
2022-03-30,Sonoma,097,501317,83509,83163,2580,85743,485
2022-03-30,Stanislaus,099,539301,117408,117593,17544,135137,1559
2022-03-30,Sutter,101,95872,20468,20565,2072,22637,222
2022-03-30,Tehama,103,63373,12029,12045,2578,14623,198
2022-03-30,Trinity,105,12862,1182,1173,287,1460,20
2022-03-30,Tulare,107,460477,106316,104667,27536,132203,1410
2022-03-30,Tuolumne,109,53932,12639,12616,554,13170,180
2022-03-30,Ventura,111,848112,173244,172984,9377,182361,1460
2022-03-30,Yolo,113,214977,37041,36325,3036,39361,313
2022-03-30,Yuba,115,75493,15834,15830,1198,17028,120
2022-03-29,Alameda,001,1643700,256096,255261,13867,269128,1810
2022-03-29,Alpine,003,1148,124,124,1,125,0
2022-03-29,Amador,005,37829,8523,8483,640,9123,86
2022-03-29,Butte,007,227075,33126,32954,6923,39877,396
2022-03-29,Calaveras,009,45235,7256,7250,346,7596,119
2022-03-29,Colusa,011,21464,3439,3445,1048,4493,21
2022-03-29,Contra Costa,013,1133247,189283,188359,13121,201480,1290
2022-03-29,Del Norte,015,27424,5808,5806,183,5989,50
2022-03-29,El Dorado,017,186661,26735,26706,3202,29908,200
2022-03-29,Fresno,019,978130,231196,230256,23567,253823,2718
2022-03-29,Glenn,021,27897,4981,4983,1600,6583,47
2022-03-29,Humboldt,023,135768,16868,16892,2948,19840,140
2022-03-29,Imperial,025,180216,55354,55233,10544,65777,908
2022-03-29,Inyo,027,18085,4068,4062,472,4534,56
2022-03-29,Kern,029,883053,191722,191338,45687,237025,2220
2022-03-29,Kings,031,150075,51454,51416,3500,54916,443
2022-03-29,Lake,033,64148,10689,10674,883,11557,136
2022-03-29,Lassen,035,31185,8957,8943,874,9817,65
2022-03-29,Los Angeles,037,10098052,2709746,2702005,123182,2825187,31378
2022-03-29,Madera,039,155013,37250,37325,6022,43347,354
2022-03-29,Marin,041,260295,33528,33431,2230,35661,287
2022-03-29,Mariposa,043,17540,2396,2388,198,2586,23
2022-03-29,Mendocino,045,87422,13054,13053,3011,16064,119
2022-03-29,Merced,047,269075,62118,62123,8587,70710,806
2022-03-29,Modoc,049,8938,736,737,252,989,8
2022-03-29,Mono,051,14174,2967,2966,121,3087,5
2022-03-29,Monterey,053,433212,79339,78774,13622,92396,725
2022-03-29,Napa,055,140530,25785,25732,947,26679,141
2022-03-29,Nevada,057,99092,15943,15956,1191,17147,123
2022-03-29,Orange,059,3164182,546326,545832,41133,586965,6871
2022-03-29,Placer,061,380077,62718,62687,7321,70008,614
2022-03-29,Plumas,063,18699,2967,2761,362,3123,13
2022-03-29,Riverside,065,2383286,590948,590359,27705,618064,6403
2022-03-29,Sacramento,067,1510023,280537,276040,26394,302434,2946
2022-03-29,San Benito,069,59416,12876,12892,512,13404,97
2022-03-29,San Bernardino,071,2135413,569207,561026,24651,585677,6860
2022-03-29,San Diego,073,3302833,750753,751240,52510,803750,5159
2022-03-29,San Francisco,075,870044,124769,124789,8237,133026,840
2022-03-29,San Joaquin,077,732212,166278,166241,9850,176091,2198
2022-03-29,San Luis Obispo,079,281455,52433,52455,3742,56197,472
2022-03-29,San Mateo,081,765935,121736,120435,6931,127366,686
2022-03-29,Santa Barbara,083,443738,85709,85464,4691,90155,676
2022-03-29,Santa Clara,085,1922200,311088,312067,12317,324384,2259
2022-03-29,Santa Cruz,087,273765,47753,47323,2082,49405,259
2022-03-29,Shasta,089,179085,30540,30552,6086,36638,529
2022-03-29,Sierra,091,2930,270,273,48,321,4
2022-03-29,Siskiyou,093,43540,4447,4439,2719,7158,80
2022-03-29,Solano,095,438530,81396,81713,5551,87264,441
2022-03-29,Sonoma,097,501317,83476,83130,2574,85704,485
2022-03-29,Stanislaus,099,539301,117389,117683,17538,135221,1559
2022-03-29,Sutter,101,95872,20466,20556,2071,22627,221
2022-03-29,Tehama,103,63373,12027,12045,2578,14623,198
2022-03-29,Trinity,105,12862,1182,1173,287,1460,20
2022-03-29,Tulare,107,460477,106311,104622,27531,132153,1406
2022-03-29,Tuolumne,109,53932,12637,12615,554,13169,180
2022-03-29,Ventura,111,848112,173189,172946,9376,182322,1460
2022-03-29,Yolo,113,214977,37028,36296,3035,39331,313
2022-03-29,Yuba,115,75493,15830,15824,1197,17021,117
2022-03-28,Alameda,001,1643700,255944,255192,13857,269049,1808
2022-03-28,Alpine,003,1148,124,124,1,125,0
2022-03-28,Amador,005,37829,8522,8480,640,9120,86
2022-03-28,Butte,007,227075,33109,32947,6923,39870,392
2022-03-28,Calaveras,009,45235,7256,7247,346,7593,119
2022-03-28,Colusa,011,21464,3439,3445,1048,4493,21
2022-03-28,Contra Costa,013,1133247,189202,188305,13116,201421,1290
2022-03-28,Del Norte,015,27424,5806,5834,183,6017,50
2022-03-28,El Dorado,017,186661,26728,26703,3200,29903,200
2022-03-28,Fresno,019,978130,231168,230144,23550,253694,2717
2022-03-28,Glenn,021,27897,4981,4983,1600,6583,47
2022-03-28,Humboldt,023,135768,16867,16916,2948,19864,140
2022-03-28,Imperial,025,180216,55343,55245,10544,65789,909
2022-03-28,Inyo,027,18085,4067,4062,472,4534,56
2022-03-28,Kern,029,883053,191698,191333,45678,237011,2212
2022-03-28,Kings,031,150075,51441,51405,3500,54905,443
2022-03-28,Lake,033,64148,10687,10673,883,11556,136
2022-03-28,Lassen,035,31185,8957,8946,874,9820,63
2022-03-28,Los Angeles,037,10098052,2708866,2700997,123143,2824140,31349
2022-03-28,Madera,039,155013,37246,37324,6022,43346,354
2022-03-28,Marin,041,260295,33503,33391,2225,35616,287
2022-03-28,Mariposa,043,17540,2395,2388,198,2586,23
2022-03-28,Mendocino,045,87422,13052,13046,3010,16056,118
2022-03-28,Merced,047,269075,62108,62116,8582,70698,805
2022-03-28,Modoc,049,8938,735,736,252,988,7
2022-03-28,Mono,051,14174,2967,2966,121,3087,5
2022-03-28,Monterey,053,433212,79306,78784,13618,92402,724
2022-03-28,Napa,055,140530,25779,25723,946,26669,140
2022-03-28,Nevada,057,99092,15941,15969,1191,17160,123
2022-03-28,Orange,059,3164182,546195,545700,41106,586806,6860
2022-03-28,Placer,061,380077,62698,62687,7320,70007,613
2022-03-28,Plumas,063,18699,2966,2760,362,3122,13
2022-03-28,Riverside,065,2383286,590848,590298,27697,617995,6397
2022-03-28,Sacramento,067,1510023,280468,275889,26382,302271,2946
2022-03-28,San Benito,069,59416,12876,12889,512,13401,97
2022-03-28,San Bernardino,071,2135413,569123,560836,24640,585476,6858
2022-03-28,San Diego,073,3302833,750514,750659,52476,803135,5155
2022-03-28,San Francisco,075,870044,124629,124678,8227,132905,839
2022-03-28,San Joaquin,077,732212,166246,166247,9848,176095,2196
2022-03-28,San Luis Obispo,079,281455,52408,52434,3739,56173,470
2022-03-28,San Mateo,081,765935,121622,120337,6924,127261,686
2022-03-28,Santa Barbara,083,443738,85681,85442,4689,90131,675
2022-03-28,Santa Clara,085,1922200,310859,311953,12308,324261,2257
2022-03-28,Santa Cruz,087,273765,47720,47324,2082,49406,259
2022-03-28,Shasta,089,179085,30539,30550,6085,36635,527
2022-03-28,Sierra,091,2930,270,273,48,321,4
2022-03-28,Siskiyou,093,43540,4446,4438,2719,7157,80
2022-03-28,Solano,095,438530,81368,81704,5546,87250,441
2022-03-28,Sonoma,097,501317,83431,83105,2569,85674,485
2022-03-28,Stanislaus,099,539301,117377,117783,17533,135316,1562
2022-03-28,Sutter,101,95872,20461,20549,2071,22620,221
2022-03-28,Tehama,103,63373,12027,12041,2578,14619,200
2022-03-28,Trinity,105,12862,1182,1173,287,1460,20
2022-03-28,Tulare,107,460477,106299,104576,27525,132101,1404
2022-03-28,Tuolumne,109,53932,12637,12627,554,13181,180
2022-03-28,Ventura,111,848112,173149,172867,9375,182242,1455
2022-03-28,Yolo,113,214977,37010,36282,3033,39315,312
2022-03-28,Yuba,115,75493,15829,15821,1195,17016,117
2022-03-27,Alameda,001,1643700,255758,255132,13848,268980,1809
2022-03-27,Alpine,003,1148,124,124,1,125,0
2022-03-27,Amador,005,37829,8519,8480,640,9120,86
2022-03-27,Butte,007,227075,33096,32943,6917,39860,392
2022-03-27,Calaveras,009,45235,7254,7245,346,7591,119
2022-03-27,Colusa,011,21464,3439,3445,1048,4493,21
2022-03-27,Contra Costa,013,1133247,189087,188251,13100,201351,1290
2022-03-27,Del Norte,015,27424,5805,5836,183,6019,50
2022-03-27,El Dorado,017,186661,26714,26699,3197,29896,200
2022-03-27,Fresno,019,978130,231121,230049,23532,253581,2717
2022-03-27,Glenn,021,27897,4980,4983,1600,6583,47
2022-03-27,Humboldt,023,135768,16863,16920,2948,19868,140
2022-03-27,Imperial,025,180216,55330,55240,10543,65783,909
2022-03-27,Inyo,027,18085,4066,4062,470,4532,56
2022-03-27,Kern,029,883053,191660,191332,45672,237004,2213
2022-03-27,Kings,031,150075,51432,51400,3500,54900,443
2022-03-27,Lake,033,64148,10686,10672,882,11554,136
2022-03-27,Lassen,035,31185,8957,8946,874,9820,63
2022-03-27,Los Angeles,037,10098052,2708057,2700983,123096,2824079,31348
2022-03-27,Madera,039,155013,37242,37323,6020,43343,354
2022-03-27,Marin,041,260295,33466,33391,2215,35606,287
2022-03-27,Mariposa,043,17540,2395,2390,198,2588,23
2022-03-27,Mendocino,045,87422,13048,13046,3008,16054,118
2022-03-27,Merced,047,269075,62098,62110,8581,70691,805
2022-03-27,Modoc,049,8938,734,736,250,986,7
2022-03-27,Mono,051,14174,2967,2966,121,3087,5
2022-03-27,Monterey,053,433212,79285,78778,13606,92384,724
2022-03-27,Napa,055,140530,25764,25723,946,26669,140
2022-03-27,Nevada,057,99092,15937,15967,1189,17156,123
2022-03-27,Orange,059,3164182,546061,545644,41072,586716,6860
2022-03-27,Placer,061,380077,62680,62680,7319,69999,613
2022-03-27,Plumas,063,18699,2965,2760,360,3120,13
2022-03-27,Riverside,065,2383286,590762,590251,27686,617937,6395
2022-03-27,Sacramento,067,1510023,280387,275854,26375,302229,2941
2022-03-27,San Benito,069,59416,12871,12889,511,13400,97
2022-03-27,San Bernardino,071,2135413,569007,560853,24638,585491,6862
2022-03-27,San Diego,073,3302833,750258,750659,52453,803112,5155
2022-03-27,San Francisco,075,870044,124443,124619,8216,132835,839
2022-03-27,San Joaquin,077,732212,166210,166238,9844,176082,2196
2022-03-27,San Luis Obispo,079,281455,52387,52430,3737,56167,470
2022-03-27,San Mateo,081,765935,121518,120324,6918,127242,686
2022-03-27,Santa Barbara,083,443738,85645,85434,4687,90121,675
2022-03-27,Santa Clara,085,1922200,310648,311822,12301,324123,2257
2022-03-27,Santa Cruz,087,273765,47687,47321,2080,49401,259
2022-03-27,Shasta,089,179085,30535,30550,6083,36633,527
2022-03-27,Sierra,091,2930,270,273,48,321,4
2022-03-27,Siskiyou,093,43540,4446,4436,2718,7154,80
2022-03-27,Solano,095,438530,81327,81691,5543,87234,441
2022-03-27,Sonoma,097,501317,83378,83088,2565,85653,485
2022-03-27,Stanislaus,099,539301,117357,117778,17530,135308,1562
2022-03-27,Sutter,101,95872,20455,20545,2071,22616,221
2022-03-27,Tehama,103,63373,12027,12040,2578,14618,200
2022-03-27,Trinity,105,12862,1182,1173,287,1460,20
2022-03-27,Tulare,107,460477,106290,104582,27516,132098,1404
2022-03-27,Tuolumne,109,53932,12636,12628,554,13182,180
2022-03-27,Ventura,111,848112,173104,172831,9373,182204,1455
2022-03-27,Yolo,113,214977,36989,36232,3030,39262,312
2022-03-27,Yuba,115,75493,15826,15821,1188,17009,117
2022-03-26,Alameda,001,1643700,255678,254691,13847,268538,1803
2022-03-26,Alpine,003,1148,124,124,1,125,0
2022-03-26,Amador,005,37829,8519,8476,640,9116,86
2022-03-26,Butte,007,227075,33092,32929,6915,39844,391
2022-03-26,Calaveras,009,45235,7252,7240,346,7586,120
2022-03-26,Colusa,011,21464,3437,3445,1048,4493,21
2022-03-26,Contra Costa,013,1133247,189033,187990,13097,201087,1285
2022-03-26,Del Norte,015,27424,5803,5831,183,6014,50
2022-03-26,El Dorado,017,186661,26706,26674,3195,29869,200
2022-03-26,Fresno,019,978130,231098,229799,23531,253330,2710
2022-03-26,Glenn,021,27897,4980,4978,1600,6578,47
2022-03-26,Humboldt,023,135768,16859,16911,2948,19859,139
2022-03-26,Imperial,025,180216,55324,55230,10542,65772,913
2022-03-26,Inyo,027,18085,4066,4060,469,4529,56
2022-03-26,Kern,029,883053,191646,191288,45668,236956,2201
2022-03-26,Kings,031,150075,51431,51397,3500,54897,444
2022-03-26,Lake,033,64148,10686,10659,882,11541,136
2022-03-26,Lassen,035,31185,8957,8944,874,9818,63
2022-03-26,Los Angeles,037,10098052,2707601,2698028,123054,2821082,31291
2022-03-26,Madera,039,155013,37239,37321,6018,43339,354
2022-03-26,Marin,041,260295,33456,33317,2211,35528,287
2022-03-26,Mariposa,043,17540,2395,2386,198,2584,23
2022-03-26,Mendocino,045,87422,13044,13038,3008,16046,118
2022-03-26,Merced,047,269075,62092,62083,8579,70662,805
2022-03-26,Modoc,049,8938,734,736,250,986,7
2022-03-26,Mono,051,14174,2967,2966,121,3087,5
2022-03-26,Monterey,053,433212,79278,78688,13604,92292,724
2022-03-26,Napa,055,140530,25761,25701,946,26647,139
2022-03-26,Nevada,057,99092,15933,15960,1189,17149,123
2022-03-26,Orange,059,3164182,545984,545294,41061,586355,6853
2022-03-26,Placer,061,380077,62668,62634,7315,69949,613
2022-03-26,Plumas,063,18699,2965,2758,359,3117,13
2022-03-26,Riverside,065,2383286,590692,590060,27685,617745,6397
2022-03-26,Sacramento,067,1510023,280354,275529,26373,301902,2935
2022-03-26,San Benito,069,59416,12871,12885,511,13396,97
2022-03-26,San Bernardino,071,2135413,568948,560742,24634,585376,6840
2022-03-26,San Diego,073,3302833,750134,750170,52446,802616,5146
2022-03-26,San Francisco,075,870044,124337,124265,8210,132475,839
2022-03-26,San Joaquin,077,732212,166189,166079,9843,175922,2195
2022-03-26,San Luis Obispo,079,281455,52381,52369,3737,56106,469
2022-03-26,San Mateo,081,765935,121459,120165,6910,127075,684
2022-03-26,Santa Barbara,083,443738,85625,85477,4685,90162,674
2022-03-26,Santa Clara,085,1922200,310490,311189,12294,323483,2250
2022-03-26,Santa Cruz,087,273765,47676,47329,2080,49409,259
2022-03-26,Shasta,089,179085,30534,30542,6082,36624,527
2022-03-26,Sierra,091,2930,270,273,48,321,4
2022-03-26,Siskiyou,093,43540,4445,4433,2718,7151,80
2022-03-26,Solano,095,438530,81318,81659,5543,87202,441
2022-03-26,Sonoma,097,501317,83348,83113,2560,85673,485
2022-03-26,Stanislaus,099,539301,117350,117962,17529,135491,1565
2022-03-26,Sutter,101,95872,20453,20536,2071,22607,221
2022-03-26,Tehama,103,63373,12027,12036,2577,14613,195
2022-03-26,Trinity,105,12862,1182,1174,287,1461,20
2022-03-26,Tulare,107,460477,106283,104538,27515,132053,1400
2022-03-26,Tuolumne,109,53932,12634,12628,554,13182,180
2022-03-26,Ventura,111,848112,173063,172690,9369,182059,1455
2022-03-26,Yolo,113,214977,36980,36234,3030,39264,311
2022-03-26,Yuba,115,75493,15825,15807,1188,16995,117
2022-03-25,Alameda,001,1643700,255613,254691,13845,268536,1803
2022-03-25,Alpine,003,1148,124,124,1,125,0
2022-03-25,Amador,005,37829,8518,8476,640,9116,86
2022-03-25,Butte,007,227075,33087,32929,6915,39844,391
2022-03-25,Calaveras,009,45235,7251,7240,346,7586,120
2022-03-25,Colusa,011,21464,3437,3445,1048,4493,21
2022-03-25,Contra Costa,013,1133247,188985,187990,13093,201083,1285
2022-03-25,Del Norte,015,27424,5803,5831,183,6014,50
2022-03-25,El Dorado,017,186661,26702,26674,3195,29869,200
2022-03-25,Fresno,019,978130,231070,229799,23523,253322,2710
2022-03-25,Glenn,021,27897,4980,4978,1600,6578,47
2022-03-25,Humboldt,023,135768,16859,16911,2948,19859,139
2022-03-25,Imperial,025,180216,55319,55230,10541,65771,913
2022-03-25,Inyo,027,18085,4065,4060,469,4529,56
2022-03-25,Kern,029,883053,191636,191288,45667,236955,2201
2022-03-25,Kings,031,150075,51430,51397,3500,54897,444
2022-03-25,Lake,033,64148,10686,10659,882,11541,136
2022-03-25,Lassen,035,31185,8956,8944,874,9818,63
2022-03-25,Los Angeles,037,10098052,2707182,2698028,123023,2821051,31291
2022-03-25,Madera,039,155013,37238,37321,6017,43338,354
2022-03-25,Marin,041,260295,33441,33317,2202,35519,287
2022-03-25,Mariposa,043,17540,2395,2386,198,2584,23
2022-03-25,Mendocino,045,87422,13044,13038,3008,16046,118
2022-03-25,Merced,047,269075,62085,62083,8578,70661,805
2022-03-25,Modoc,049,8938,734,736,250,986,7
2022-03-25,Mono,051,14174,2966,2966,121,3087,5
2022-03-25,Monterey,053,433212,79267,78688,13601,92289,724
2022-03-25,Napa,055,140530,25754,25701,946,26647,139
2022-03-25,Nevada,057,99092,15932,15960,1189,17149,123
2022-03-25,Orange,059,3164182,545910,545294,41045,586339,6853
2022-03-25,Placer,061,380077,62662,62634,7312,69946,613
2022-03-25,Plumas,063,18699,2964,2758,359,3117,13
2022-03-25,Riverside,065,2383286,590632,590060,27674,617734,6397
2022-03-25,Sacramento,067,1510023,280312,275529,26371,301900,2935
2022-03-25,San Benito,069,59416,12871,12885,511,13396,97
2022-03-25,San Bernardino,071,2135413,568909,560742,24631,585373,6840
2022-03-25,San Diego,073,3302833,750011,750170,52436,802606,5146
2022-03-25,San Francisco,075,870044,124256,124265,8197,132462,839
2022-03-25,San Joaquin,077,732212,166175,166079,9840,175919,2195
2022-03-25,San Luis Obispo,079,281455,52378,52369,3736,56105,469
2022-03-25,San Mateo,081,765935,121407,120165,6910,127075,684
2022-03-25,Santa Barbara,083,443738,85610,85477,4683,90160,674
2022-03-25,Santa Clara,085,1922200,310339,311189,12289,323478,2250
2022-03-25,Santa Cruz,087,273765,47668,47329,2080,49409,259
2022-03-25,Shasta,089,179085,30530,30542,6081,36623,527
2022-03-25,Sierra,091,2930,270,273,48,321,4
2022-03-25,Siskiyou,093,43540,4443,4433,2716,7149,80
2022-03-25,Solano,095,438530,81304,81659,5541,87200,441
2022-03-25,Sonoma,097,501317,83311,83113,2560,85673,485
2022-03-25,Stanislaus,099,539301,117336,117962,17528,135490,1565
2022-03-25,Sutter,101,95872,20448,20536,2071,22607,221
2022-03-25,Tehama,103,63373,12025,12036,2577,14613,195
2022-03-25,Trinity,105,12862,1182,1174,287,1461,20
2022-03-25,Tulare,107,460477,106279,104538,27515,132053,1400
2022-03-25,Tuolumne,109,53932,12633,12628,554,13182,180
2022-03-25,Ventura,111,848112,173025,172690,9369,182059,1455
2022-03-25,Yolo,113,214977,36968,36234,3030,39264,311
2022-03-25,Yuba,115,75493,15820,15807,1187,16994,117
2022-03-24,Alameda,001,1643700,255496,254691,13829,268520,1803
2022-03-24,Alpine,003,1148,124,124,1,125,0
2022-03-24,Amador,005,37829,8518,8476,640,9116,86
2022-03-24,Butte,007,227075,33079,32929,6915,39844,391
2022-03-24,Calaveras,009,45235,7248,7240,346,7586,120
2022-03-24,Colusa,011,21464,3437,3445,1048,4493,21
2022-03-24,Contra Costa,013,1133247,188906,187990,13090,201080,1285
2022-03-24,Del Norte,015,27424,5799,5831,183,6014,50
2022-03-24,El Dorado,017,186661,26691,26674,3195,29869,200
2022-03-24,Fresno,019,978130,231029,229799,23514,253313,2710
2022-03-24,Glenn,021,27897,4979,4978,1600,6578,47
2022-03-24,Humboldt,023,135768,16854,16911,2946,19857,139
2022-03-24,Imperial,025,180216,55312,55230,10541,65771,913
2022-03-24,Inyo,027,18085,4064,4060,469,4529,56
2022-03-24,Kern,029,883053,191626,191288,45665,236953,2201
2022-03-24,Kings,031,150075,51421,51397,3498,54895,444
2022-03-24,Lake,033,64148,10685,10659,882,11541,136
2022-03-24,Lassen,035,31185,8955,8944,874,9818,63
2022-03-24,Los Angeles,037,10098052,2706613,2698028,122978,2821006,31291
2022-03-24,Madera,039,155013,37236,37321,6015,43336,354
2022-03-24,Marin,041,260295,33419,33317,2193,35510,287
2022-03-24,Mariposa,043,17540,2395,2386,198,2584,23
2022-03-24,Mendocino,045,87422,13038,13038,3005,16043,118
2022-03-24,Merced,047,269075,62078,62083,8577,70660,805
2022-03-24,Modoc,049,8938,734,736,250,986,7
2022-03-24,Mono,051,14174,2966,2966,121,3087,5
2022-03-24,Monterey,053,433212,79241,78688,13587,92275,724
2022-03-24,Napa,055,140530,25745,25701,946,26647,139
2022-03-24,Nevada,057,99092,15928,15960,1188,17148,123
2022-03-24,Orange,059,3164182,545808,545294,41030,586324,6853
2022-03-24,Placer,061,380077,62642,62634,7311,69945,613
2022-03-24,Plumas,063,18699,2964,2758,359,3117,13
2022-03-24,Riverside,065,2383286,590556,590060,27666,617726,6397
2022-03-24,Sacramento,067,1510023,280243,275529,26366,301895,2935
2022-03-24,San Benito,069,59416,12870,12885,510,13395,97
2022-03-24,San Bernardino,071,2135413,568827,560742,24627,585369,6840
2022-03-24,San Diego,073,3302833,749802,750170,52423,802593,5146
2022-03-24,San Francisco,075,870044,124174,124265,8191,132456,839
2022-03-24,San Joaquin,077,732212,166147,166079,9840,175919,2195
2022-03-24,San Luis Obispo,079,281455,52363,52369,3735,56104,469
2022-03-24,San Mateo,081,765935,121359,120165,6906,127071,684
2022-03-24,Santa Barbara,083,443738,85595,85477,4680,90157,674
2022-03-24,Santa Clara,085,1922200,310193,311189,12272,323461,2250
2022-03-24,Santa Cruz,087,273765,47651,47329,2079,49408,259
2022-03-24,Shasta,089,179085,30522,30542,6081,36623,527
2022-03-24,Sierra,091,2930,270,273,48,321,4
2022-03-24,Siskiyou,093,43540,4440,4433,2716,7149,80
2022-03-24,Solano,095,438530,81285,81659,5540,87199,441
2022-03-24,Sonoma,097,501317,83276,83113,2558,85671,485
2022-03-24,Stanislaus,099,539301,117328,117962,17525,135487,1565
2022-03-24,Sutter,101,95872,20444,20536,2071,22607,221
2022-03-24,Tehama,103,63373,12023,12036,2576,14612,195
2022-03-24,Trinity,105,12862,1182,1174,287,1461,20
2022-03-24,Tulare,107,460477,106268,104538,27510,132048,1400
2022-03-24,Tuolumne,109,53932,12631,12628,554,13182,180
2022-03-24,Ventura,111,848112,172982,172690,9368,182058,1455
2022-03-24,Yolo,113,214977,36962,36234,3026,39260,311
2022-03-24,Yuba,115,75493,15816,15807,1185,16992,117
2022-03-23,Alameda,001,1643700,255361,254559,13818,268377,1802
2022-03-23,Alpine,003,1148,124,124,1,125,0
2022-03-23,Amador,005,37829,8518,8475,640,9115,86
2022-03-23,Butte,007,227075,33065,32920,6914,39834,387
2022-03-23,Calaveras,009,45235,7243,7237,346,7583,120
2022-03-23,Colusa,011,21464,3436,3444,1048,4492,21
2022-03-23,Contra Costa,013,1133247,188807,187898,13079,200977,1279
2022-03-23,Del Norte,015,27424,5797,5830,183,6013,50
2022-03-23,El Dorado,017,186661,26685,26670,3195,29865,200
2022-03-23,Fresno,019,978130,230993,229656,23501,253157,2710
2022-03-23,Glenn,021,27897,4979,4975,1600,6575,47
2022-03-23,Humboldt,023,135768,16853,16908,2945,19853,139
2022-03-23,Imperial,025,180216,55306,55211,10540,65751,909
2022-03-23,Inyo,027,18085,4064,4060,469,4529,56
2022-03-23,Kern,029,883053,191609,191241,45660,236901,2196
2022-03-23,Kings,031,150075,51410,51384,3498,54882,442
2022-03-23,Lake,033,64148,10681,10658,881,11539,135
2022-03-23,Lassen,035,31185,8954,8944,873,9817,63
2022-03-23,Los Angeles,037,10098052,2705933,2697227,122948,2820175,31267
2022-03-23,Madera,039,155013,37231,37317,6012,43329,354
2022-03-23,Marin,041,260295,33393,33274,2188,35462,287
2022-03-23,Mariposa,043,17540,2393,2382,197,2579,11
2022-03-23,Mendocino,045,87422,13034,13033,3004,16037,118
2022-03-23,Merced,047,269075,62068,62056,8574,70630,805
2022-03-23,Modoc,049,8938,734,736,250,986,7
2022-03-23,Mono,051,14174,2966,2966,121,3087,5
2022-03-23,Monterey,053,433212,79224,78655,13563,92218,724
2022-03-23,Napa,055,140530,25732,25691,944,26635,139
2022-03-23,Nevada,057,99092,15926,15958,1188,17146,123
2022-03-23,Orange,059,3164182,545678,545158,41018,586176,6852
2022-03-23,Placer,061,380077,62623,62622,7309,69931,613
2022-03-23,Plumas,063,18699,2964,2747,359,3106,13
2022-03-23,Riverside,065,2383286,590483,589947,27661,617608,6388
2022-03-23,Sacramento,067,1510023,280180,275398,26359,301757,2934
2022-03-23,San Benito,069,59416,12869,12884,510,13394,97
2022-03-23,San Bernardino,071,2135413,568753,560550,24623,585173,6828
2022-03-23,San Diego,073,3302833,749609,749871,52400,802271,5143
2022-03-23,San Francisco,075,870044,124061,124110,8184,132294,838
2022-03-23,San Joaquin,077,732212,166110,166041,9833,175874,2187
2022-03-23,San Luis Obispo,079,281455,52346,52344,3730,56074,469
2022-03-23,San Mateo,081,765935,121275,120080,6896,126976,685
2022-03-23,Santa Barbara,083,443738,85578,85464,4679,90143,673
2022-03-23,Santa Clara,085,1922200,310029,310956,12260,323216,2250
2022-03-23,Santa Cruz,087,273765,47632,47314,2075,49389,259
2022-03-23,Shasta,089,179085,30518,30524,6080,36604,526
2022-03-23,Sierra,091,2930,270,273,48,321,4
2022-03-23,Siskiyou,093,43540,4439,4433,2716,7149,80
2022-03-23,Solano,095,438530,81251,81615,5539,87154,441
2022-03-23,Sonoma,097,501317,83243,83074,2555,85629,482
2022-03-23,Stanislaus,099,539301,117311,118041,17522,135563,1568
2022-03-23,Sutter,101,95872,20441,20532,2071,22603,218
2022-03-23,Tehama,103,63373,12020,12035,2576,14611,195
2022-03-23,Trinity,105,12862,1182,1174,287,1461,20
2022-03-23,Tulare,107,460477,106251,104489,27505,131994,1394
2022-03-23,Tuolumne,109,53932,12630,12629,554,13183,180
2022-03-23,Ventura,111,848112,172934,172647,9366,182013,1455
2022-03-23,Yolo,113,214977,36942,36197,3024,39221,308
2022-03-23,Yuba,115,75493,15809,15801,1184,16985,117
2022-03-22,Alameda,001,1643700,255239,254467,13509,267976,1802
2022-03-22,Alpine,003,1148,124,122,1,123,0
2022-03-22,Amador,005,37829,8517,8462,639,9101,86
2022-03-22,Butte,007,227075,33055,32907,6910,39817,387
2022-03-22,Calaveras,009,45235,7241,7237,346,7583,120
2022-03-22,Colusa,011,21464,3435,3445,1048,4493,21
2022-03-22,Contra Costa,013,1133247,188731,187813,13058,200871,1279
2022-03-22,Del Norte,015,27424,5791,5824,183,6007,50
2022-03-22,El Dorado,017,186661,26678,26661,3195,29856,200
2022-03-22,Fresno,019,978130,230944,229551,23492,253043,2708
2022-03-22,Glenn,021,27897,4976,4971,1600,6571,47
2022-03-22,Humboldt,023,135768,16850,16911,2945,19856,139
2022-03-22,Imperial,025,180216,55295,55170,10537,65707,908
2022-03-22,Inyo,027,18085,4064,4060,469,4529,56
2022-03-22,Kern,029,883053,191586,191213,45652,236865,2195
2022-03-22,Kings,031,150075,51398,51369,3497,54866,442
2022-03-22,Lake,033,64148,10679,10657,880,11537,135
2022-03-22,Lassen,035,31185,8954,8940,873,9813,63
2022-03-22,Los Angeles,037,10098052,2705271,2696746,122901,2819647,31250
2022-03-22,Madera,039,155013,37227,37304,6009,43313,354
2022-03-22,Marin,041,260295,33368,33253,2184,35437,287
2022-03-22,Mariposa,043,17540,2391,2382,197,2579,6
2022-03-22,Mendocino,045,87422,13029,13030,3002,16032,118
2022-03-22,Merced,047,269075,62058,62056,8570,70626,805
2022-03-22,Modoc,049,8938,734,735,250,985,7
2022-03-22,Mono,051,14174,2966,2963,121,3084,5
2022-03-22,Monterey,053,433212,79207,78614,13553,92167,724
2022-03-22,Napa,055,140530,25722,25688,943,26631,139
2022-03-22,Nevada,057,99092,15918,15950,1188,17138,123
2022-03-22,Orange,059,3164182,545534,545075,40999,586074,6843
2022-03-22,Placer,061,380077,62610,62604,7307,69911,610
2022-03-22,Plumas,063,18699,2963,2744,359,3103,13
2022-03-22,Riverside,065,2383286,590408,589816,27658,617474,6383
2022-03-22,Sacramento,067,1510023,280104,275374,26348,301722,2927
2022-03-22,San Benito,069,59416,12868,12884,509,13393,97
2022-03-22,San Bernardino,071,2135413,568671,560371,24603,584974,6811
2022-03-22,San Diego,073,3302833,749409,749647,52380,802027,5141
2022-03-22,San Francisco,075,870044,123954,123998,8178,132176,838
2022-03-22,San Joaquin,077,732212,166082,165992,9830,175822,2187
2022-03-22,San Luis Obispo,079,281455,52338,52257,3730,55987,465
2022-03-22,San Mateo,081,765935,121201,119975,6893,126868,686
2022-03-22,Santa Barbara,083,443738,85561,85457,4678,90135,672
2022-03-22,Santa Clara,085,1922200,309860,310787,12248,323035,2249
2022-03-22,Santa Cruz,087,273765,47612,47287,2074,49361,259
2022-03-22,Shasta,089,179085,30512,30528,6080,36608,525
2022-03-22,Sierra,091,2930,270,273,48,321,4
2022-03-22,Siskiyou,093,43540,4439,4429,2715,7144,80
2022-03-22,Solano,095,438530,81228,81587,5538,87125,440
2022-03-22,Sonoma,097,501317,83214,83042,2552,85594,482
2022-03-22,Stanislaus,099,539301,117294,118025,17519,135544,1568
2022-03-22,Sutter,101,95872,20440,20525,2068,22593,218
2022-03-22,Tehama,103,63373,12018,12034,2576,14610,162
2022-03-22,Trinity,105,12862,1182,1174,287,1461,20
2022-03-22,Tulare,107,460477,106240,104431,27497,131928,1391
2022-03-22,Tuolumne,109,53932,12630,12628,554,13182,180
2022-03-22,Ventura,111,848112,172885,172590,9364,181954,1455
2022-03-22,Yolo,113,214977,36922,36184,3023,39207,308
2022-03-22,Yuba,115,75493,15806,15795,1183,16978,117
2022-03-21,Alameda,001,1643700,255018,254354,13501,267855,1799
2022-03-21,Alpine,003,1148,124,122,1,123,0
2022-03-21,Amador,005,37829,8514,8461,638,9099,85
2022-03-21,Butte,007,227075,33044,32895,6907,39802,385
2022-03-21,Calaveras,009,45235,7240,7237,346,7583,119
2022-03-21,Colusa,011,21464,3435,3445,1048,4493,21
2022-03-21,Contra Costa,013,1133247,188667,187509,13043,200552,1276
2022-03-21,Del Norte,015,27424,5790,5824,183,6007,50
2022-03-21,El Dorado,017,186661,26667,26610,3195,29805,199
2022-03-21,Fresno,019,978130,230895,229374,23484,252858,2707
2022-03-21,Glenn,021,27897,4974,4972,1595,6567,46
2022-03-21,Humboldt,023,135768,16840,16912,2932,19844,139
2022-03-21,Imperial,025,180216,55282,55133,10536,65669,908
2022-03-21,Inyo,027,18085,4063,4060,469,4529,56
2022-03-21,Kern,029,883053,191553,191184,45646,236830,2187
2022-03-21,Kings,031,150075,51384,51366,3495,54861,441
2022-03-21,Lake,033,64148,10677,10655,880,11535,135
2022-03-21,Lassen,035,31185,8953,8939,873,9812,63
2022-03-21,Los Angeles,037,10098052,2704405,2694711,122852,2817563,31218
2022-03-21,Madera,039,155013,37222,37288,6006,43294,354
2022-03-21,Marin,041,260295,33324,33242,2179,35421,287
2022-03-21,Mariposa,043,17540,2390,2383,196,2579,6
2022-03-21,Mendocino,045,87422,13021,13028,3000,16028,118
2022-03-21,Merced,047,269075,62044,62048,8565,70613,803
2022-03-21,Modoc,049,8938,732,734,250,984,7
2022-03-21,Mono,051,14174,2966,2962,121,3083,5
2022-03-21,Monterey,053,433212,79158,78572,13540,92112,724
2022-03-21,Napa,055,140530,25714,25684,941,26625,138
2022-03-21,Nevada,057,99092,15914,15963,1187,17150,123
2022-03-21,Orange,059,3164182,545380,544943,40982,585925,6841
2022-03-21,Placer,061,380077,62591,62550,7306,69856,610
2022-03-21,Plumas,063,18699,2963,2744,359,3103,13
2022-03-21,Riverside,065,2383286,590327,589707,27654,617361,6376
2022-03-21,Sacramento,067,1510023,280014,275334,26334,301668,2925
2022-03-21,San Benito,069,59416,12862,12872,509,13381,97
2022-03-21,San Bernardino,071,2135413,568582,560210,24590,584800,6807
2022-03-21,San Diego,073,3302833,749184,748833,52360,801193,5138
2022-03-21,San Francisco,075,870044,123786,123912,8169,132081,835
2022-03-21,San Joaquin,077,732212,166056,165939,9827,175766,2185
2022-03-21,San Luis Obispo,079,281455,52313,52219,3725,55944,463
2022-03-21,San Mateo,081,765935,121042,119899,6891,126790,684
2022-03-21,Santa Barbara,083,443738,85546,85416,4676,90092,672
2022-03-21,Santa Clara,085,1922200,309600,310509,12245,322754,2245
2022-03-21,Santa Cruz,087,273765,47576,47267,2073,49340,259
2022-03-21,Shasta,089,179085,30506,30523,6078,36601,525
2022-03-21,Sierra,091,2930,270,273,48,321,4
2022-03-21,Siskiyou,093,43540,4439,4426,2715,7141,80
2022-03-21,Solano,095,438530,81200,81399,5538,86937,441
2022-03-21,Sonoma,097,501317,83175,82979,2547,85526,482
2022-03-21,Stanislaus,099,539301,117261,118144,17517,135661,1571
2022-03-21,Sutter,101,95872,20437,20523,2056,22579,218
2022-03-21,Tehama,103,63373,12014,12030,2576,14606,160
2022-03-21,Trinity,105,12862,1182,1174,287,1461,20
2022-03-21,Tulare,107,460477,106220,104350,27492,131842,1389
2022-03-21,Tuolumne,109,53932,12630,12620,554,13174,180
2022-03-21,Ventura,111,848112,172815,172537,9360,181897,1452
2022-03-21,Yolo,113,214977,36906,36141,3021,39162,307
2022-03-21,Yuba,115,75493,15803,15790,1182,16972,117
2022-03-20,Alameda,001,1643700,254881,254293,13491,267784,1801
2022-03-20,Alpine,003,1148,122,122,1,123,0
2022-03-20,Amador,005,37829,8511,8460,638,9098,85
2022-03-20,Butte,007,227075,33029,32892,6903,39795,385
2022-03-20,Calaveras,009,45235,7239,7233,343,7576,119
2022-03-20,Colusa,011,21464,3435,3446,1048,4494,21
2022-03-20,Contra Costa,013,1133247,188564,187467,13033,200500,1276
2022-03-20,Del Norte,015,27424,5788,5821,183,6004,50
2022-03-20,El Dorado,017,186661,26659,26608,3195,29803,199
2022-03-20,Fresno,019,978130,230818,229297,23473,252770,2707
2022-03-20,Glenn,021,27897,4973,4972,1595,6567,46
2022-03-20,Humboldt,023,135768,16838,16913,2930,19843,139
2022-03-20,Imperial,025,180216,55271,55133,10535,65668,908
2022-03-20,Inyo,027,18085,4063,4060,469,4529,56
2022-03-20,Kern,029,883053,191509,191170,45641,236811,2187
2022-03-20,Kings,031,150075,51373,51360,3495,54855,441
2022-03-20,Lake,033,64148,10673,10652,880,11532,135
2022-03-20,Lassen,035,31185,8951,8938,873,9811,63
2022-03-20,Los Angeles,037,10098052,2703610,2694698,122808,2817506,31219
2022-03-20,Madera,039,155013,37217,37284,6003,43287,354
2022-03-20,Marin,041,260295,33308,33232,2178,35410,275
2022-03-20,Mariposa,043,17540,2390,2383,196,2579,6
2022-03-20,Mendocino,045,87422,13014,13027,2995,16022,118
2022-03-20,Merced,047,269075,62033,62041,8562,70603,803
2022-03-20,Modoc,049,8938,732,734,250,984,7
2022-03-20,Mono,051,14174,2964,2962,121,3083,5
2022-03-20,Monterey,053,433212,79125,78566,13529,92095,723
2022-03-20,Napa,055,140530,25702,25682,940,26622,138
2022-03-20,Nevada,057,99092,15910,15964,1187,17151,123
2022-03-20,Orange,059,3164182,545259,544862,40964,585826,6841
2022-03-20,Placer,061,380077,62571,62525,7306,69831,610
2022-03-20,Plumas,063,18699,2963,2744,359,3103,13
2022-03-20,Riverside,065,2383286,590230,589657,27650,617307,6376
2022-03-20,Sacramento,067,1510023,279936,275317,26319,301636,2927
2022-03-20,San Benito,069,59416,12862,12869,508,13377,97
2022-03-20,San Bernardino,071,2135413,568501,560220,24581,584801,6805
2022-03-20,San Diego,073,3302833,748948,748833,52327,801160,5138
2022-03-20,San Francisco,075,870044,123637,123858,8157,132015,835
2022-03-20,San Joaquin,077,732212,166023,165927,9823,175750,2185
2022-03-20,San Luis Obispo,079,281455,52289,52217,3722,55939,463
2022-03-20,San Mateo,081,765935,120982,119901,6885,126786,684
2022-03-20,Santa Barbara,083,443738,85521,85412,4675,90087,672
2022-03-20,Santa Clara,085,1922200,309391,310412,12237,322649,2243
2022-03-20,Santa Cruz,087,273765,47549,47265,2072,49337,259
2022-03-20,Shasta,089,179085,30496,30522,6077,36599,525
2022-03-20,Sierra,091,2930,270,273,48,321,4
2022-03-20,Siskiyou,093,43540,4438,4426,2715,7141,80
2022-03-20,Solano,095,438530,81170,81393,5536,86929,441
2022-03-20,Sonoma,097,501317,83132,82965,2546,85511,481
2022-03-20,Stanislaus,099,539301,117235,118146,17514,135660,1572
2022-03-20,Sutter,101,95872,20430,20519,2048,22567,218
2022-03-20,Tehama,103,63373,12012,12030,2576,14606,160
2022-03-20,Trinity,105,12862,1182,1174,287,1461,20
2022-03-20,Tulare,107,460477,106199,104353,27479,131832,1389
2022-03-20,Tuolumne,109,53932,12625,12617,554,13171,180
2022-03-20,Ventura,111,848112,172765,172514,9355,181869,1451
2022-03-20,Yolo,113,214977,36887,36135,3020,39155,307
2022-03-20,Yuba,115,75493,15794,15787,1180,16967,117
2022-03-19,Alameda,001,1643700,254803,253936,13489,267425,1797
2022-03-19,Alpine,003,1148,122,122,1,123,0
2022-03-19,Amador,005,37829,8508,8456,638,9094,85
2022-03-19,Butte,007,227075,33021,32856,6903,39759,385
2022-03-19,Calaveras,009,45235,7239,7229,343,7572,119
2022-03-19,Colusa,011,21464,3433,3445,1048,4493,21
2022-03-19,Contra Costa,013,1133247,188528,187225,13032,200257,1276
2022-03-19,Del Norte,015,27424,5785,5815,183,5998,48
2022-03-19,El Dorado,017,186661,26655,26618,3195,29813,199
2022-03-19,Fresno,019,978130,230795,228965,23472,252437,2694
2022-03-19,Glenn,021,27897,4973,4971,1595,6566,44
2022-03-19,Humboldt,023,135768,16832,16901,2930,19831,138
2022-03-19,Imperial,025,180216,55270,55038,10534,65572,898
2022-03-19,Inyo,027,18085,4063,4061,469,4530,56
2022-03-19,Kern,029,883053,191494,190943,45633,236576,2184
2022-03-19,Kings,031,150075,51368,51334,3495,54829,441
2022-03-19,Lake,033,64148,10673,10641,880,11521,135
2022-03-19,Lassen,035,31185,8951,8925,873,9798,63
2022-03-19,Los Angeles,037,10098052,2703238,2686759,122774,2809533,31133
2022-03-19,Madera,039,155013,37217,37273,6003,43276,354
2022-03-19,Marin,041,260295,33290,33163,2174,35337,272
2022-03-19,Mariposa,043,17540,2389,2378,196,2574,6
2022-03-19,Mendocino,045,87422,13014,13012,2995,16007,117
2022-03-19,Merced,047,269075,62027,61985,8560,70545,800
2022-03-19,Modoc,049,8938,732,734,250,984,7
2022-03-19,Mono,051,14174,2964,2961,121,3082,5
2022-03-19,Monterey,053,433212,79114,78483,13522,92005,720
2022-03-19,Napa,055,140530,25699,25654,940,26594,138
2022-03-19,Nevada,057,99092,15908,15960,1187,17147,123
2022-03-19,Orange,059,3164182,545187,543907,40948,584855,6817
2022-03-19,Placer,061,380077,62557,62483,7306,69789,605
2022-03-19,Plumas,063,18699,2963,2724,359,3083,13
2022-03-19,Riverside,065,2383286,590179,589017,27643,616660,6359
2022-03-19,Sacramento,067,1510023,279895,274855,26315,301170,2913
2022-03-19,San Benito,069,59416,12861,12859,508,13367,97
2022-03-19,San Bernardino,071,2135413,568455,559935,24579,584514,6778
2022-03-19,San Diego,073,3302833,748848,747344,52315,799659,5133
2022-03-19,San Francisco,075,870044,123567,123587,8155,131742,833
2022-03-19,San Joaquin,077,732212,165998,165765,9820,175585,2181
2022-03-19,San Luis Obispo,079,281455,52283,52174,3722,55896,463
2022-03-19,San Mateo,081,765935,120945,119782,6884,126666,667
2022-03-19,Santa Barbara,083,443738,85507,85336,4674,90010,671
2022-03-19,Santa Clara,085,1922200,309269,309918,12228,322146,2225
2022-03-19,Santa Cruz,087,273765,47541,47203,2068,49271,256
2022-03-19,Shasta,089,179085,30492,30495,6077,36572,525
2022-03-19,Sierra,091,2930,270,273,48,321,4
2022-03-19,Siskiyou,093,43540,4437,4422,2715,7137,76
2022-03-19,Solano,095,438530,81161,81340,5533,86873,441
2022-03-19,Sonoma,097,501317,83115,82838,2543,85381,472
2022-03-19,Stanislaus,099,539301,117225,118138,17512,135650,1568
2022-03-19,Sutter,101,95872,20427,20503,2048,22551,218
2022-03-19,Tehama,103,63373,12012,12007,2576,14583,160
2022-03-19,Trinity,105,12862,1182,1173,287,1460,20
2022-03-19,Tulare,107,460477,106190,104290,27474,131764,1384
2022-03-19,Tuolumne,109,53932,12624,12617,554,13171,180
2022-03-19,Ventura,111,848112,172734,172380,9354,181734,1451
2022-03-19,Yolo,113,214977,36878,36086,3020,39106,306
2022-03-19,Yuba,115,75493,15790,15768,1179,16947,117
2022-03-18,Alameda,001,1643700,254744,253936,13486,267422,1797
2022-03-18,Alpine,003,1148,122,122,1,123,0
2022-03-18,Amador,005,37829,8508,8456,638,9094,85
2022-03-18,Butte,007,227075,33016,32856,6900,39756,385
2022-03-18,Calaveras,009,45235,7239,7229,343,7572,119
2022-03-18,Colusa,011,21464,3433,3445,1048,4493,21
2022-03-18,Contra Costa,013,1133247,188496,187225,13030,200255,1276
2022-03-18,Del Norte,015,27424,5783,5815,183,5998,48
2022-03-18,El Dorado,017,186661,26650,26618,3193,29811,199
2022-03-18,Fresno,019,978130,230763,228965,23472,252437,2694
2022-03-18,Glenn,021,27897,4973,4971,1595,6566,44
2022-03-18,Humboldt,023,135768,16829,16901,2929,19830,138
2022-03-18,Imperial,025,180216,55268,55038,10534,65572,898
2022-03-18,Inyo,027,18085,4063,4061,469,4530,56
2022-03-18,Kern,029,883053,191483,190943,45630,236573,2184
2022-03-18,Kings,031,150075,51360,51334,3495,54829,441
2022-03-18,Lake,033,64148,10671,10641,879,11520,135
2022-03-18,Lassen,035,31185,8950,8925,873,9798,63
2022-03-18,Los Angeles,037,10098052,2702889,2686759,122748,2809507,31133
2022-03-18,Madera,039,155013,37212,37273,6003,43276,354
2022-03-18,Marin,041,260295,33276,33163,2174,35337,272
2022-03-18,Mariposa,043,17540,2388,2378,196,2574,6
2022-03-18,Mendocino,045,87422,13010,13012,2995,16007,117
2022-03-18,Merced,047,269075,62016,61985,8560,70545,800
2022-03-18,Modoc,049,8938,732,734,250,984,7
2022-03-18,Mono,051,14174,2963,2961,121,3082,5
2022-03-18,Monterey,053,433212,79096,78483,13520,92003,720
2022-03-18,Napa,055,140530,25696,25654,940,26594,138
2022-03-18,Nevada,057,99092,15905,15960,1186,17146,123
2022-03-18,Orange,059,3164182,545120,543907,40939,584846,6817
2022-03-18,Placer,061,380077,62548,62483,7306,69789,605
2022-03-18,Plumas,063,18699,2963,2724,359,3083,13
2022-03-18,Riverside,065,2383286,590119,589017,27639,616656,6359
2022-03-18,Sacramento,067,1510023,279859,274855,26311,301166,2913
2022-03-18,San Benito,069,59416,12859,12859,508,13367,97
2022-03-18,San Bernardino,071,2135413,568417,559935,24577,584512,6778
2022-03-18,San Diego,073,3302833,748740,747344,52300,799644,5133
2022-03-18,San Francisco,075,870044,123488,123587,8150,131737,833
2022-03-18,San Joaquin,077,732212,165983,165765,9815,175580,2181
2022-03-18,San Luis Obispo,079,281455,52277,52174,3722,55896,463
2022-03-18,San Mateo,081,765935,120910,119782,6881,126663,667
2022-03-18,Santa Barbara,083,443738,85497,85336,4673,90009,671
2022-03-18,Santa Clara,085,1922200,309165,309918,12225,322143,2225
2022-03-18,Santa Cruz,087,273765,47529,47203,2067,49270,256
2022-03-18,Shasta,089,179085,30491,30495,6077,36572,525
2022-03-18,Sierra,091,2930,270,273,48,321,4
2022-03-18,Siskiyou,093,43540,4437,4422,2715,7137,76
2022-03-18,Solano,095,438530,81150,81340,5527,86867,441
2022-03-18,Sonoma,097,501317,83094,82838,2542,85380,472
2022-03-18,Stanislaus,099,539301,117212,118138,17512,135650,1568
2022-03-18,Sutter,101,95872,20424,20503,2048,22551,218
2022-03-18,Tehama,103,63373,12011,12007,2576,14583,160
2022-03-18,Trinity,105,12862,1182,1173,287,1460,20
2022-03-18,Tulare,107,460477,106184,104290,27469,131759,1384
2022-03-18,Tuolumne,109,53932,12623,12617,554,13171,180
2022-03-18,Ventura,111,848112,172714,172380,9349,181729,1451
2022-03-18,Yolo,113,214977,36867,36086,3020,39106,306
2022-03-18,Yuba,115,75493,15788,15768,1179,16947,117
2022-03-17,Alameda,001,1643700,254644,253936,13480,267416,1797
2022-03-17,Alpine,003,1148,122,122,1,123,0
2022-03-17,Amador,005,37829,8501,8456,638,9094,85
2022-03-17,Butte,007,227075,33003,32856,6898,39754,385
2022-03-17,Calaveras,009,45235,7236,7229,343,7572,119
2022-03-17,Colusa,011,21464,3433,3445,1048,4493,21
2022-03-17,Contra Costa,013,1133247,188432,187225,13019,200244,1276
2022-03-17,Del Norte,015,27424,5781,5815,183,5998,48
2022-03-17,El Dorado,017,186661,26644,26618,3193,29811,199
2022-03-17,Fresno,019,978130,230714,228965,23469,252434,2694
2022-03-17,Glenn,021,27897,4973,4971,1595,6566,44
2022-03-17,Humboldt,023,135768,16825,16901,2927,19828,138
2022-03-17,Imperial,025,180216,55257,55038,10534,65572,898
2022-03-17,Inyo,027,18085,4063,4061,469,4530,56
2022-03-17,Kern,029,883053,191454,190943,45627,236570,2184
2022-03-17,Kings,031,150075,51357,51334,3494,54828,441
2022-03-17,Lake,033,64148,10668,10641,879,11520,135
2022-03-17,Lassen,035,31185,8948,8925,873,9798,63
2022-03-17,Los Angeles,037,10098052,2702226,2686759,122713,2809472,31133
2022-03-17,Madera,039,155013,37208,37273,6003,43276,354
2022-03-17,Marin,041,260295,33264,33163,2173,35336,272
2022-03-17,Mariposa,043,17540,2388,2378,196,2574,6
2022-03-17,Mendocino,045,87422,13006,13012,2992,16004,117
2022-03-17,Merced,047,269075,62010,61985,8558,70543,800
2022-03-17,Modoc,049,8938,732,734,250,984,7
2022-03-17,Mono,051,14174,2963,2961,120,3081,5
2022-03-17,Monterey,053,433212,79073,78483,13514,91997,720
2022-03-17,Napa,055,140530,25691,25654,940,26594,138
2022-03-17,Nevada,057,99092,15902,15960,1186,17146,123
2022-03-17,Orange,059,3164182,545026,543907,40929,584836,6817
2022-03-17,Placer,061,380077,62532,62483,7304,69787,605
2022-03-17,Plumas,063,18699,2962,2724,359,3083,13
2022-03-17,Riverside,065,2383286,590039,589017,27632,616649,6359
2022-03-17,Sacramento,067,1510023,279793,274855,26305,301160,2913
2022-03-17,San Benito,069,59416,12858,12859,508,13367,97
2022-03-17,San Bernardino,071,2135413,568353,559935,24574,584509,6778
2022-03-17,San Diego,073,3302833,748564,747344,52286,799630,5133
2022-03-17,San Francisco,075,870044,123407,123587,8145,131732,833
2022-03-17,San Joaquin,077,732212,165963,165765,9813,175578,2181
2022-03-17,San Luis Obispo,079,281455,52262,52174,3720,55894,463
2022-03-17,San Mateo,081,765935,120862,119782,6877,126659,667
2022-03-17,Santa Barbara,083,443738,85481,85336,4673,90009,671
2022-03-17,Santa Clara,085,1922200,309045,309918,12220,322138,2225
2022-03-17,Santa Cruz,087,273765,47513,47203,2065,49268,256
2022-03-17,Shasta,089,179085,30487,30495,6075,36570,525
2022-03-17,Sierra,091,2930,270,273,48,321,4
2022-03-17,Siskiyou,093,43540,4436,4422,2715,7137,76
2022-03-17,Solano,095,438530,81121,81340,5524,86864,441
2022-03-17,Sonoma,097,501317,83066,82838,2540,85378,472
2022-03-17,Stanislaus,099,539301,117198,118138,17507,135645,1568
2022-03-17,Sutter,101,95872,20414,20503,2037,22540,218
2022-03-17,Tehama,103,63373,12011,12007,2576,14583,160
2022-03-17,Trinity,105,12862,1182,1173,287,1460,20
2022-03-17,Tulare,107,460477,106168,104290,27459,131749,1384
2022-03-17,Tuolumne,109,53932,12620,12617,553,13170,180
2022-03-17,Ventura,111,848112,172665,172380,9347,181727,1451
2022-03-17,Yolo,113,214977,36853,36086,3020,39106,306
2022-03-17,Yuba,115,75493,15786,15768,1178,16946,117
2022-03-16,Alameda,001,1643700,254545,253792,13477,267269,1794
2022-03-16,Alpine,003,1148,122,122,1,123,0
2022-03-16,Amador,005,37829,8493,8449,638,9087,85
2022-03-16,Butte,007,227075,32992,32837,6893,39730,385
2022-03-16,Calaveras,009,45235,7234,7229,343,7572,120
2022-03-16,Colusa,011,21464,3433,3445,1048,4493,22
2022-03-16,Contra Costa,013,1133247,188374,187100,13008,200108,1266
2022-03-16,Del Norte,015,27424,5780,5811,181,5992,48
2022-03-16,El Dorado,017,186661,26631,26602,3192,29794,199
2022-03-16,Fresno,019,978130,230667,228786,23458,252244,2689
2022-03-16,Glenn,021,27897,4973,4969,1595,6564,44
2022-03-16,Humboldt,023,135768,16822,16893,2927,19820,138
2022-03-16,Imperial,025,180216,55245,55002,10533,65535,897
2022-03-16,Inyo,027,18085,4062,4061,469,4530,56
2022-03-16,Kern,029,883053,191412,190835,45620,236455,2170
2022-03-16,Kings,031,150075,51342,51321,3494,54815,437
2022-03-16,Lake,033,64148,10666,10633,878,11511,133
2022-03-16,Lassen,035,31185,8945,8924,873,9797,62
2022-03-16,Los Angeles,037,10098052,2701598,2685789,122671,2808460,31102
2022-03-16,Madera,039,155013,37198,37262,6002,43264,354
2022-03-16,Marin,041,260295,33243,33136,2171,35307,272
2022-03-16,Mariposa,043,17540,2386,2376,196,2572,6
2022-03-16,Mendocino,045,87422,13003,13011,2991,16002,117
2022-03-16,Merced,047,269075,61995,61959,8554,70513,798
2022-03-16,Modoc,049,8938,731,734,250,984,7
2022-03-16,Mono,051,14174,2963,2960,120,3080,5
2022-03-16,Monterey,053,433212,79051,78416,13509,91925,720
2022-03-16,Napa,055,140530,25682,25638,940,26578,138
2022-03-16,Nevada,057,99092,15900,15960,1186,17146,123
2022-03-16,Orange,059,3164182,544903,543326,40906,584232,6791
2022-03-16,Placer,061,380077,62516,62435,7302,69737,605
2022-03-16,Plumas,063,18699,2962,2723,359,3082,13
2022-03-16,Riverside,065,2383286,589942,588761,27629,616390,6351
2022-03-16,Sacramento,067,1510023,279728,274709,26298,301007,2910
2022-03-16,San Benito,069,59416,12853,12854,508,13362,97
2022-03-16,San Bernardino,071,2135413,568273,559746,24567,584313,6775
2022-03-16,San Diego,073,3302833,748359,746970,52262,799232,5126
2022-03-16,San Francisco,075,870044,123307,123446,8138,131584,831
2022-03-16,San Joaquin,077,732212,165916,165703,9810,175513,2169
2022-03-16,San Luis Obispo,079,281455,52244,52132,3716,55848,462
2022-03-16,San Mateo,081,765935,120799,119680,6869,126549,660
2022-03-16,Santa Barbara,083,443738,85448,85322,4669,89991,670
2022-03-16,Santa Clara,085,1922200,308859,309689,12205,321894,2224
2022-03-16,Santa Cruz,087,273765,47484,47161,2065,49226,255
2022-03-16,Shasta,089,179085,30478,30489,6071,36560,527
2022-03-16,Sierra,091,2930,270,273,48,321,4
2022-03-16,Siskiyou,093,43540,4433,4419,2713,7132,76
2022-03-16,Solano,095,438530,81098,81277,5522,86799,440
2022-03-16,Sonoma,097,501317,83023,82791,2531,85322,472
2022-03-16,Stanislaus,099,539301,117172,118072,17505,135577,1567
2022-03-16,Sutter,101,95872,20412,20494,2036,22530,218
2022-03-16,Tehama,103,63373,12009,11999,2576,14575,160
2022-03-16,Trinity,105,12862,1182,1173,287,1460,20
2022-03-16,Tulare,107,460477,106155,104217,27453,131670,1377
2022-03-16,Tuolumne,109,53932,12615,12610,553,13163,180
2022-03-16,Ventura,111,848112,172624,172212,9343,181555,1451
2022-03-16,Yolo,113,214977,36830,36079,3019,39098,307
2022-03-16,Yuba,115,75493,15781,15758,1178,16936,117
2022-03-15,Alameda,001,1643700,254413,253694,13468,267162,1793
2022-03-15,Alpine,003,1148,122,122,1,123,0
2022-03-15,Amador,005,37829,8490,8448,638,9086,85
2022-03-15,Butte,007,227075,32979,32822,6892,39714,385
2022-03-15,Calaveras,009,45235,7232,7236,343,7579,118
2022-03-15,Colusa,011,21464,3433,3445,1048,4493,21
2022-03-15,Contra Costa,013,1133247,188293,187021,13001,200022,1265
2022-03-15,Del Norte,015,27424,5777,5806,178,5984,48
2022-03-15,El Dorado,017,186661,26628,26596,3192,29788,199
2022-03-15,Fresno,019,978130,230624,228631,23449,252080,2689
2022-03-15,Glenn,021,27897,4971,4966,1595,6561,44
2022-03-15,Humboldt,023,135768,16816,16889,2926,19815,138
2022-03-15,Imperial,025,180216,55235,54981,10529,65510,896
2022-03-15,Inyo,027,18085,4062,4062,468,4530,56
2022-03-15,Kern,029,883053,191383,190645,45610,236255,2168
2022-03-15,Kings,031,150075,51323,51317,3490,54807,437
2022-03-15,Lake,033,64148,10662,10631,878,11509,131
2022-03-15,Lassen,035,31185,8943,8926,873,9799,62
2022-03-15,Los Angeles,037,10098052,2700914,2685071,122615,2807686,31077
2022-03-15,Madera,039,155013,37189,37258,6001,43259,354
2022-03-15,Marin,041,260295,33220,33111,2170,35281,272
2022-03-15,Mariposa,043,17540,2384,2377,196,2573,6
2022-03-15,Mendocino,045,87422,12998,13005,2990,15995,117
2022-03-15,Merced,047,269075,61977,61916,8545,70461,798
2022-03-15,Modoc,049,8938,731,733,250,983,7
2022-03-15,Mono,051,14174,2963,2961,120,3081,5
2022-03-15,Monterey,053,433212,79021,78400,13501,91901,718
2022-03-15,Napa,055,140530,25674,25657,938,26595,138
2022-03-15,Nevada,057,99092,15898,15960,1184,17144,123
2022-03-15,Orange,059,3164182,544762,543197,40899,584096,6780
2022-03-15,Placer,061,380077,62499,62398,7298,69696,604
2022-03-15,Plumas,063,18699,2961,2722,359,3081,13
2022-03-15,Riverside,065,2383286,589842,588622,27621,616243,6333
2022-03-15,Sacramento,067,1510023,279642,274633,26292,300925,2907
2022-03-15,San Benito,069,59416,12849,12849,508,13357,95
2022-03-15,San Bernardino,071,2135413,568198,559605,24564,584169,6770
2022-03-15,San Diego,073,3302833,748116,746474,52240,798714,5116
2022-03-15,San Francisco,075,870044,123190,123526,8129,131655,831
2022-03-15,San Joaquin,077,732212,165873,165664,9804,175468,2161
2022-03-15,San Luis Obispo,079,281455,52234,52060,3712,55772,458
2022-03-15,San Mateo,081,765935,120748,119586,6863,126449,649
2022-03-15,Santa Barbara,083,443738,85423,85353,4665,90018,668
2022-03-15,Santa Clara,085,1922200,308698,309535,12193,321728,2224
2022-03-15,Santa Cruz,087,273765,47431,47117,2065,49182,255
2022-03-15,Shasta,089,179085,30469,30476,6068,36544,524
2022-03-15,Sierra,091,2930,270,273,48,321,4
2022-03-15,Siskiyou,093,43540,4433,4420,2713,7133,76
2022-03-15,Solano,095,438530,81063,81260,5521,86781,440
2022-03-15,Sonoma,097,501317,82983,82737,2531,85268,472
2022-03-15,Stanislaus,099,539301,117154,118085,17502,135587,1567
2022-03-15,Sutter,101,95872,20409,20480,2027,22507,217
2022-03-15,Tehama,103,63373,12006,11997,2576,14573,160
2022-03-15,Trinity,105,12862,1182,1173,287,1460,20
2022-03-15,Tulare,107,460477,106136,104153,27441,131594,1375
2022-03-15,Tuolumne,109,53932,12611,12602,553,13155,180
2022-03-15,Ventura,111,848112,172579,172150,9340,181490,1451
2022-03-15,Yolo,113,214977,36814,36079,3015,39094,308
2022-03-15,Yuba,115,75493,15773,15756,1178,16934,116
2022-03-14,Alameda,001,1643700,254302,253629,13464,267093,1791
2022-03-14,Alpine,003,1148,122,122,1,123,0
2022-03-14,Amador,005,37829,8485,8448,638,9086,85
2022-03-14,Butte,007,227075,32961,32812,6892,39704,385
2022-03-14,Calaveras,009,45235,7231,7245,343,7588,118
2022-03-14,Colusa,011,21464,3432,3445,1048,4493,21
2022-03-14,Contra Costa,013,1133247,188200,186969,12993,199962,1265
2022-03-14,Del Norte,015,27424,5771,5807,178,5985,48
2022-03-14,El Dorado,017,186661,26623,26570,3192,29762,199
2022-03-14,Fresno,019,978130,230550,228470,23439,251909,2682
2022-03-14,Glenn,021,27897,4969,4966,1595,6561,44
2022-03-14,Humboldt,023,135768,16809,16890,2924,19814,137
2022-03-14,Imperial,025,180216,55224,54933,10528,65461,897
2022-03-14,Inyo,027,18085,4062,4062,468,4530,56
2022-03-14,Kern,029,883053,191348,190526,45599,236125,2166
2022-03-14,Kings,031,150075,51305,51293,3489,54782,437
2022-03-14,Lake,033,64148,10659,10631,878,11509,131
2022-03-14,Lassen,035,31185,8943,8927,872,9799,62
2022-03-14,Los Angeles,037,10098052,2700282,2683369,122548,2805917,31034
2022-03-14,Madera,039,155013,37182,37255,6000,43255,354
2022-03-14,Marin,041,260295,33191,33099,2170,35269,272
2022-03-14,Mariposa,043,17540,2383,2376,196,2572,6
2022-03-14,Mendocino,045,87422,12993,12992,2983,15975,117
2022-03-14,Merced,047,269075,61958,61905,8543,70448,795
2022-03-14,Modoc,049,8938,730,731,250,981,7
2022-03-14,Mono,051,14174,2962,2961,120,3081,5
2022-03-14,Monterey,053,433212,79006,78376,13466,91842,718
2022-03-14,Napa,055,140530,25660,25649,938,26587,138
2022-03-14,Nevada,057,99092,15896,15954,1184,17138,123
2022-03-14,Orange,059,3164182,544624,543099,40891,583990,6775
2022-03-14,Placer,061,380077,62481,62389,7296,69685,601
2022-03-14,Plumas,063,18699,2961,2711,359,3070,13
2022-03-14,Riverside,065,2383286,589707,588531,27611,616142,6332
2022-03-14,Sacramento,067,1510023,279561,274682,26287,300969,2899
2022-03-14,San Benito,069,59416,12844,12846,507,13353,95
2022-03-14,San Bernardino,071,2135413,568111,559505,24559,584064,6767
2022-03-14,San Diego,073,3302833,747813,745515,52212,797727,5108
2022-03-14,San Francisco,075,870044,123099,123575,8123,131698,824
2022-03-14,San Joaquin,077,732212,165834,165662,9803,175465,2142
2022-03-14,San Luis Obispo,079,281455,52206,52046,3709,55755,458
2022-03-14,San Mateo,081,765935,120675,119564,6861,126425,649
2022-03-14,Santa Barbara,083,443738,85386,85396,4664,90060,667
2022-03-14,Santa Clara,085,1922200,308514,309600,12189,321789,2223
2022-03-14,Santa Cruz,087,273765,47393,47107,2063,49170,255
2022-03-14,Shasta,089,179085,30464,30462,6065,36527,520
2022-03-14,Sierra,091,2930,270,273,48,321,4
2022-03-14,Siskiyou,093,43540,4428,4419,2712,7131,76
2022-03-14,Solano,095,438530,81015,81233,5516,86749,440
2022-03-14,Sonoma,097,501317,82947,82731,2527,85258,473
2022-03-14,Stanislaus,099,539301,117118,118088,17498,135586,1567
2022-03-14,Sutter,101,95872,20402,20478,2027,22505,217
2022-03-14,Tehama,103,63373,12004,11996,2576,14572,160
2022-03-14,Trinity,105,12862,1182,1172,287,1459,20
2022-03-14,Tulare,107,460477,106107,104121,27434,131555,1365
2022-03-14,Tuolumne,109,53932,12610,12567,552,13119,180
2022-03-14,Ventura,111,848112,172526,172107,9338,181445,1442
2022-03-14,Yolo,113,214977,36798,36059,3013,39072,308
2022-03-14,Yuba,115,75493,15761,15748,1178,16926,116
2022-03-13,Alameda,001,1643700,254178,253547,13456,267003,1792
2022-03-13,Alpine,003,1148,122,122,1,123,0
2022-03-13,Amador,005,37829,8483,8444,638,9082,85
2022-03-13,Butte,007,227075,32941,32806,6889,39695,384
2022-03-13,Calaveras,009,45235,7226,7253,343,7596,118
2022-03-13,Colusa,011,21464,3432,3444,1046,4490,21
2022-03-13,Contra Costa,013,1133247,188103,186911,12980,199891,1265
2022-03-13,Del Norte,015,27424,5767,5808,178,5986,48
2022-03-13,El Dorado,017,186661,26618,26563,3191,29754,199
2022-03-13,Fresno,019,978130,230470,228421,23425,251846,2683
2022-03-13,Glenn,021,27897,4965,4966,1594,6560,44
2022-03-13,Humboldt,023,135768,16801,16883,2924,19807,137
2022-03-13,Imperial,025,180216,55213,54934,10526,65460,897
2022-03-13,Inyo,027,18085,4062,4062,467,4529,56
2022-03-13,Kern,029,883053,191294,190495,45587,236082,2166
2022-03-13,Kings,031,150075,51297,51273,3489,54762,437
2022-03-13,Lake,033,64148,10656,10626,878,11504,131
2022-03-13,Lassen,035,31185,8942,8929,871,9800,62
2022-03-13,Los Angeles,037,10098052,2699558,2683351,122505,2805856,31034
2022-03-13,Madera,039,155013,37174,37248,6000,43248,354
2022-03-13,Marin,041,260295,33167,33083,2168,35251,272
2022-03-13,Mariposa,043,17540,2381,2376,196,2572,6
2022-03-13,Mendocino,045,87422,12987,12987,2978,15965,117
2022-03-13,Merced,047,269075,61935,61895,8534,70429,795
2022-03-13,Modoc,049,8938,730,731,250,981,7
2022-03-13,Mono,051,14174,2962,2961,120,3081,5
2022-03-13,Monterey,053,433212,78970,78366,13418,91784,718
2022-03-13,Napa,055,140530,25646,25639,937,26576,138
2022-03-13,Nevada,057,99092,15889,15959,1184,17143,123
2022-03-13,Orange,059,3164182,544502,543036,40867,583903,6774
2022-03-13,Placer,061,380077,62454,62372,7293,69665,601
2022-03-13,Plumas,063,18699,2961,2711,359,3070,13
2022-03-13,Riverside,065,2383286,589574,588487,27605,616092,6332
2022-03-13,Sacramento,067,1510023,279463,274715,26275,300990,2899
2022-03-13,San Benito,069,59416,12838,12844,505,13349,95
2022-03-13,San Bernardino,071,2135413,568019,559450,24549,583999,6767
2022-03-13,San Diego,073,3302833,747472,745515,52178,797693,5108
2022-03-13,San Francisco,075,870044,122978,123622,8117,131739,824
2022-03-13,San Joaquin,077,732212,165785,165641,9801,175442,2142
2022-03-13,San Luis Obispo,079,281455,52177,52040,3706,55746,458
2022-03-13,San Mateo,081,765935,120597,119521,6852,126373,649
2022-03-13,Santa Barbara,083,443738,85346,85453,4662,90115,667
2022-03-13,Santa Clara,085,1922200,308343,309493,12181,321674,2225
2022-03-13,Santa Cruz,087,273765,47342,47087,2063,49150,255
2022-03-13,Shasta,089,179085,30447,30457,6063,36520,520
2022-03-13,Sierra,091,2930,270,273,48,321,4
2022-03-13,Siskiyou,093,43540,4428,4418,2712,7130,76
2022-03-13,Solano,095,438530,80980,81217,5512,86729,440
2022-03-13,Sonoma,097,501317,82912,82711,2524,85235,473
2022-03-13,Stanislaus,099,539301,117084,118075,17495,135570,1567
2022-03-13,Sutter,101,95872,20398,20474,2027,22501,217
2022-03-13,Tehama,103,63373,12003,11997,2575,14572,160
2022-03-13,Trinity,105,12862,1182,1172,287,1459,20
2022-03-13,Tulare,107,460477,106074,104119,27426,131545,1365
2022-03-13,Tuolumne,109,53932,12607,12565,552,13117,180
2022-03-13,Ventura,111,848112,172468,172080,9331,181411,1442
2022-03-13,Yolo,113,214977,36779,36019,3011,39030,308
2022-03-13,Yuba,115,75493,15756,15741,1178,16919,116
2022-03-12,Alameda,001,1643700,254110,253079,13451,266530,1783
2022-03-12,Alpine,003,1148,122,122,1,123,0
2022-03-12,Amador,005,37829,8479,8427,638,9065,84
2022-03-12,Butte,007,227075,32937,32774,6887,39661,380
2022-03-12,Calaveras,009,45235,7225,7253,343,7596,118
2022-03-12,Colusa,011,21464,3432,3440,1046,4486,21
2022-03-12,Contra Costa,013,1133247,188061,186618,12979,199597,1256
2022-03-12,Del Norte,015,27424,5766,5791,178,5969,48
2022-03-12,El Dorado,017,186661,26614,26538,3191,29729,199
2022-03-12,Fresno,019,978130,230448,228041,23425,251466,2653
2022-03-12,Glenn,021,27897,4965,4955,1594,6549,44
2022-03-12,Humboldt,023,135768,16797,16862,2923,19785,137
2022-03-12,Imperial,025,180216,55208,54837,10523,65360,896
2022-03-12,Inyo,027,18085,4062,4056,467,4523,56
2022-03-12,Kern,029,883053,191277,190330,45582,235912,2162
2022-03-12,Kings,031,150075,51291,51145,3489,54634,436
2022-03-12,Lake,033,64148,10654,10594,877,11471,131
2022-03-12,Lassen,035,31185,8941,8915,871,9786,62
2022-03-12,Los Angeles,037,10098052,2699228,2678858,122485,2801343,30901
2022-03-12,Madera,039,155013,37169,37223,6000,43223,354
2022-03-12,Marin,041,260295,33143,33015,2167,35182,272
2022-03-12,Mariposa,043,17540,2381,2372,196,2568,6
2022-03-12,Mendocino,045,87422,12983,12965,2978,15943,117
2022-03-12,Merced,047,269075,61928,61840,8533,70373,795
2022-03-12,Modoc,049,8938,730,730,250,980,7
2022-03-12,Mono,051,14174,2962,2960,119,3079,5
2022-03-12,Monterey,053,433212,78963,78285,13416,91701,716
2022-03-12,Napa,055,140530,25636,25584,936,26520,138
2022-03-12,Nevada,057,99092,15883,15947,1184,17131,123
2022-03-12,Orange,059,3164182,544436,542354,40858,583212,6718
2022-03-12,Placer,061,380077,62445,62282,7293,69575,598
2022-03-12,Plumas,063,18699,2961,2707,359,3066,13
2022-03-12,Riverside,065,2383286,589509,588022,27600,615622,6317
2022-03-12,Sacramento,067,1510023,279423,274519,26271,300790,2886
2022-03-12,San Benito,069,59416,12835,12868,505,13373,95
2022-03-12,San Bernardino,071,2135413,567975,559013,24548,583561,6734
2022-03-12,San Diego,073,3302833,747350,744386,52156,796542,5090
2022-03-12,San Francisco,075,870044,122913,123610,8111,131721,823
2022-03-12,San Joaquin,077,732212,165768,165516,9798,175314,2117
2022-03-12,San Luis Obispo,079,281455,52168,51947,3703,55650,457
2022-03-12,San Mateo,081,765935,120561,119288,6851,126139,641
2022-03-12,Santa Barbara,083,443738,85327,85421,4662,90083,664
2022-03-12,Santa Clara,085,1922200,308245,308989,12176,321165,2208
2022-03-12,Santa Cruz,087,273765,47329,46982,2062,49044,254
2022-03-12,Shasta,089,179085,30435,30419,6061,36480,517
2022-03-12,Sierra,091,2930,270,273,48,321,4
2022-03-12,Siskiyou,093,43540,4428,4405,2712,7117,75
2022-03-12,Solano,095,438530,80966,81058,5512,86570,436
2022-03-12,Sonoma,097,501317,82895,82622,2522,85144,473
2022-03-12,Stanislaus,099,539301,117070,117884,17494,135378,1564
2022-03-12,Sutter,101,95872,20397,20429,2027,22456,217
2022-03-12,Tehama,103,63373,12003,11983,2575,14558,159
2022-03-12,Trinity,105,12862,1181,1172,287,1459,20
2022-03-12,Tulare,107,460477,106069,103994,27422,131416,1358
2022-03-12,Tuolumne,109,53932,12606,12476,552,13028,180
2022-03-12,Ventura,111,848112,172443,171932,9330,181262,1442
2022-03-12,Yolo,113,214977,36772,35982,3009,38991,308
2022-03-12,Yuba,115,75493,15756,15722,1178,16900,116
2022-03-11,Alameda,001,1643700,254045,253079,13451,266530,1783
2022-03-11,Alpine,003,1148,122,122,1,123,0
2022-03-11,Amador,005,37829,8477,8427,638,9065,84
2022-03-11,Butte,007,227075,32933,32774,6886,39660,380
2022-03-11,Calaveras,009,45235,7225,7253,343,7596,118
2022-03-11,Colusa,011,21464,3432,3440,1046,4486,21
2022-03-11,Contra Costa,013,1133247,188013,186618,12977,199595,1256
2022-03-11,Del Norte,015,27424,5762,5791,178,5969,48
2022-03-11,El Dorado,017,186661,26610,26538,3191,29729,199
2022-03-11,Fresno,019,978130,230392,228041,23421,251462,2653
2022-03-11,Glenn,021,27897,4965,4955,1594,6549,44
2022-03-11,Humboldt,023,135768,16792,16862,2922,19784,137
2022-03-11,Imperial,025,180216,55202,54837,10522,65359,896
2022-03-11,Inyo,027,18085,4062,4056,467,4523,56
2022-03-11,Kern,029,883053,191256,190330,45577,235907,2162
2022-03-11,Kings,031,150075,51271,51145,3489,54634,436
2022-03-11,Lake,033,64148,10650,10594,877,11471,131
2022-03-11,Lassen,035,31185,8940,8915,871,9786,62
2022-03-11,Los Angeles,037,10098052,2698906,2678858,122460,2801318,30901
2022-03-11,Madera,039,155013,37164,37223,6000,43223,354
2022-03-11,Marin,041,260295,33127,33015,2166,35181,272
2022-03-11,Mariposa,043,17540,2380,2372,196,2568,6
2022-03-11,Mendocino,045,87422,12977,12965,2978,15943,117
2022-03-11,Merced,047,269075,61918,61840,8531,70371,795
2022-03-11,Modoc,049,8938,730,730,250,980,7
2022-03-11,Mono,051,14174,2961,2960,119,3079,5
2022-03-11,Monterey,053,433212,78950,78285,13409,91694,716
2022-03-11,Napa,055,140530,25625,25584,936,26520,138
2022-03-11,Nevada,057,99092,15880,15947,1184,17131,123
2022-03-11,Orange,059,3164182,544366,542354,40844,583198,6718
2022-03-11,Placer,061,380077,62434,62282,7292,69574,598
2022-03-11,Plumas,063,18699,2959,2707,359,3066,13
2022-03-11,Riverside,065,2383286,589431,588022,27596,615618,6317
2022-03-11,Sacramento,067,1510023,279355,274519,26268,300787,2886
2022-03-11,San Benito,069,59416,12834,12868,505,13373,95
2022-03-11,San Bernardino,071,2135413,567918,559013,24543,583556,6734
2022-03-11,San Diego,073,3302833,747184,744386,52142,796528,5090
2022-03-11,San Francisco,075,870044,122862,123610,8107,131717,823
2022-03-11,San Joaquin,077,732212,165734,165516,9795,175311,2117
2022-03-11,San Luis Obispo,079,281455,52160,51947,3702,55649,457
2022-03-11,San Mateo,081,765935,120512,119288,6848,126136,641
2022-03-11,Santa Barbara,083,443738,85307,85421,4661,90082,664
2022-03-11,Santa Clara,085,1922200,308145,308989,12173,321162,2208
2022-03-11,Santa Cruz,087,273765,47314,46982,2062,49044,254
2022-03-11,Shasta,089,179085,30430,30419,6058,36477,517
2022-03-11,Sierra,091,2930,270,273,48,321,4
2022-03-11,Siskiyou,093,43540,4426,4405,2710,7115,75
2022-03-11,Solano,095,438530,80952,81058,5511,86569,436
2022-03-11,Sonoma,097,501317,82870,82622,2520,85142,473
2022-03-11,Stanislaus,099,539301,117056,117884,17493,135377,1564
2022-03-11,Sutter,101,95872,20395,20429,2027,22456,217
2022-03-11,Tehama,103,63373,12001,11983,2575,14558,159
2022-03-11,Trinity,105,12862,1181,1172,287,1459,20
2022-03-11,Tulare,107,460477,106055,103994,27416,131410,1358
2022-03-11,Tuolumne,109,53932,12604,12476,552,13028,180
2022-03-11,Ventura,111,848112,172407,171932,9325,181257,1442
2022-03-11,Yolo,113,214977,36761,35982,3009,38991,308
2022-03-11,Yuba,115,75493,15753,15722,1178,16900,116
2022-03-10,Alameda,001,1643700,253935,253079,13445,266524,1783
2022-03-10,Alpine,003,1148,122,122,1,123,0
2022-03-10,Amador,005,37829,8476,8427,638,9065,84
2022-03-10,Butte,007,227075,32919,32774,6884,39658,380
2022-03-10,Calaveras,009,45235,7224,7253,342,7595,118
2022-03-10,Colusa,011,21464,3432,3440,1046,4486,21
2022-03-10,Contra Costa,013,1133247,187929,186618,12967,199585,1256
2022-03-10,Del Norte,015,27424,5753,5791,178,5969,48
2022-03-10,El Dorado,017,186661,26598,26538,3190,29728,199
2022-03-10,Fresno,019,978130,230318,228041,23411,251452,2653
2022-03-10,Glenn,021,27897,4963,4955,1594,6549,44
2022-03-10,Humboldt,023,135768,16783,16862,2921,19783,137
2022-03-10,Imperial,025,180216,55192,54837,10521,65358,896
2022-03-10,Inyo,027,18085,4061,4056,467,4523,56
2022-03-10,Kern,029,883053,191223,190330,45563,235893,2162
2022-03-10,Kings,031,150075,51242,51145,3488,54633,436
2022-03-10,Lake,033,64148,10640,10594,876,11470,131
2022-03-10,Lassen,035,31185,8940,8915,871,9786,62
2022-03-10,Los Angeles,037,10098052,2698351,2678858,122421,2801279,30901
2022-03-10,Madera,039,155013,37158,37223,5993,43216,354
2022-03-10,Marin,041,260295,33114,33015,2162,35177,272
2022-03-10,Mariposa,043,17540,2380,2372,196,2568,6
2022-03-10,Mendocino,045,87422,12974,12965,2978,15943,117
2022-03-10,Merced,047,269075,61902,61840,8526,70366,795
2022-03-10,Modoc,049,8938,729,730,250,980,7
2022-03-10,Mono,051,14174,2961,2960,119,3079,5
2022-03-10,Monterey,053,433212,78927,78285,13384,91669,716
2022-03-10,Napa,055,140530,25616,25584,935,26519,138
2022-03-10,Nevada,057,99092,15873,15947,1184,17131,123
2022-03-10,Orange,059,3164182,544241,542354,40827,583181,6718
2022-03-10,Placer,061,380077,62412,62282,7287,69569,598
2022-03-10,Plumas,063,18699,2958,2707,359,3066,13
2022-03-10,Riverside,065,2383286,589316,588022,27591,615613,6317
2022-03-10,Sacramento,067,1510023,279278,274519,26262,300781,2886
2022-03-10,San Benito,069,59416,12833,12868,504,13372,95
2022-03-10,San Bernardino,071,2135413,567845,559013,24539,583552,6734
2022-03-10,San Diego,073,3302833,746926,744386,52111,796497,5090
2022-03-10,San Francisco,075,870044,122794,123610,8101,131711,823
2022-03-10,San Joaquin,077,732212,165703,165516,9793,175309,2117
2022-03-10,San Luis Obispo,079,281455,52137,51947,3699,55646,457
2022-03-10,San Mateo,081,765935,120449,119288,6846,126134,641
2022-03-10,Santa Barbara,083,443738,85275,85421,4660,90081,664
2022-03-10,Santa Clara,085,1922200,308019,308989,12165,321154,2208
2022-03-10,Santa Cruz,087,273765,47282,46982,2062,49044,254
2022-03-10,Shasta,089,179085,30421,30419,6056,36475,517
2022-03-10,Sierra,091,2930,270,273,48,321,4
2022-03-10,Siskiyou,093,43540,4426,4405,2710,7115,75
2022-03-10,Solano,095,438530,80916,81058,5506,86564,436
2022-03-10,Sonoma,097,501317,82843,82622,2520,85142,473
2022-03-10,Stanislaus,099,539301,117021,117884,17491,135375,1564
2022-03-10,Sutter,101,95872,20391,20429,2027,22456,217
2022-03-10,Tehama,103,63373,12000,11983,2575,14558,159
2022-03-10,Trinity,105,12862,1181,1172,287,1459,20
2022-03-10,Tulare,107,460477,106036,103994,27410,131404,1358
2022-03-10,Tuolumne,109,53932,12601,12476,552,13028,180
2022-03-10,Ventura,111,848112,172366,171932,9322,181254,1442
2022-03-10,Yolo,113,214977,36748,35982,3008,38990,308
2022-03-10,Yuba,115,75493,15743,15722,1177,16899,116
2022-03-09,Alameda,001,1643700,253812,252893,13440,266333,1781
2022-03-09,Alpine,003,1148,122,125,1,126,0
2022-03-09,Amador,005,37829,8470,8409,638,9047,84
2022-03-09,Butte,007,227075,32910,32767,6880,39647,380
2022-03-09,Calaveras,009,45235,7222,7249,342,7591,117
2022-03-09,Colusa,011,21464,3431,3439,1046,4485,21
2022-03-09,Contra Costa,013,1133247,187835,186483,12952,199435,1256
2022-03-09,Del Norte,015,27424,5749,5765,178,5943,48
2022-03-09,El Dorado,017,186661,26593,26515,3190,29705,198
2022-03-09,Fresno,019,978130,230220,227885,23404,251289,2653
2022-03-09,Glenn,021,27897,4961,4953,1593,6546,44
2022-03-09,Humboldt,023,135768,16778,16854,2918,19772,137
2022-03-09,Imperial,025,180216,55187,54764,10519,65283,894
2022-03-09,Inyo,027,18085,4061,4056,467,4523,56
2022-03-09,Kern,029,883053,191175,190254,45551,235805,2159
2022-03-09,Kings,031,150075,51221,51122,3488,54610,435
2022-03-09,Lake,033,64148,10633,10586,876,11462,130
2022-03-09,Lassen,035,31185,8940,8901,871,9772,62
2022-03-09,Los Angeles,037,10098052,2697704,2677901,122382,2800283,30842
2022-03-09,Madera,039,155013,37151,37207,5992,43199,354
2022-03-09,Marin,041,260295,33096,32967,2162,35129,272
2022-03-09,Mariposa,043,17540,2377,2372,196,2568,6
2022-03-09,Mendocino,045,87422,12970,12957,2973,15930,117
2022-03-09,Merced,047,269075,61887,61792,8520,70312,792
2022-03-09,Modoc,049,8938,728,730,249,979,7
2022-03-09,Mono,051,14174,2961,2962,119,3081,5
2022-03-09,Monterey,053,433212,78905,78258,13341,91599,716
2022-03-09,Napa,055,140530,25595,25561,934,26495,138
2022-03-09,Nevada,057,99092,15864,15938,1183,17121,123
2022-03-09,Orange,059,3164182,544110,542278,40815,583093,6700
2022-03-09,Placer,061,380077,62391,62242,7283,69525,598
2022-03-09,Plumas,063,18699,2957,2708,359,3067,13
2022-03-09,Riverside,065,2383286,589220,587833,27581,615414,6305
2022-03-09,Sacramento,067,1510023,279193,274373,26246,300619,2877
2022-03-09,San Benito,069,59416,12830,12864,504,13368,95
2022-03-09,San Bernardino,071,2135413,567753,558795,24528,583323,6723
2022-03-09,San Diego,073,3302833,746655,743956,52084,796040,5083
2022-03-09,San Francisco,075,870044,122704,123676,8097,131773,812
2022-03-09,San Joaquin,077,732212,165663,165444,9787,175231,2113
2022-03-09,San Luis Obispo,079,281455,52118,51923,3697,55620,457
2022-03-09,San Mateo,081,765935,120391,119194,6834,126028,639
2022-03-09,Santa Barbara,083,443738,85260,85382,4658,90040,661
2022-03-09,Santa Clara,085,1922200,307882,308765,12155,320920,2206
2022-03-09,Santa Cruz,087,273765,47242,46917,2061,48978,254
2022-03-09,Shasta,089,179085,30399,30407,6055,36462,493
2022-03-09,Sierra,091,2930,270,273,48,321,4
2022-03-09,Siskiyou,093,43540,4424,4403,2709,7112,75
2022-03-09,Solano,095,438530,80880,80984,5505,86489,436
2022-03-09,Sonoma,097,501317,82810,82574,2518,85092,473
2022-03-09,Stanislaus,099,539301,116984,117827,17486,135313,1541
2022-03-09,Sutter,101,95872,20380,20409,2023,22432,217
2022-03-09,Tehama,103,63373,11996,11980,2575,14555,159
2022-03-09,Trinity,105,12862,1181,1174,287,1461,20
2022-03-09,Tulare,107,460477,106008,103932,27397,131329,1350
2022-03-09,Tuolumne,109,53932,12599,12444,552,12996,180
2022-03-09,Ventura,111,848112,172316,171852,9319,181171,1448
2022-03-09,Yolo,113,214977,36729,35973,2996,38969,308
2022-03-09,Yuba,115,75493,15738,15714,1176,16890,115
2022-03-08,Alameda,001,1643700,253658,252744,13428,266172,1769
2022-03-08,Alpine,003,1148,122,125,1,126,0
2022-03-08,Amador,005,37829,8456,8407,638,9045,84
2022-03-08,Butte,007,227075,32897,32759,6876,39635,380
2022-03-08,Calaveras,009,45235,7218,7245,342,7587,117
2022-03-08,Colusa,011,21464,3428,3439,1045,4484,21
2022-03-08,Contra Costa,013,1133247,187748,186396,12939,199335,1256
2022-03-08,Del Norte,015,27424,5744,5763,178,5941,48
2022-03-08,El Dorado,017,186661,26583,26503,3184,29687,197
2022-03-08,Fresno,019,978130,230122,227808,23395,251203,2653
2022-03-08,Glenn,021,27897,4960,4944,1592,6536,43
2022-03-08,Humboldt,023,135768,16766,16837,2905,19742,137
2022-03-08,Imperial,025,180216,55172,54721,10517,65238,890
2022-03-08,Inyo,027,18085,4058,4056,467,4523,56
2022-03-08,Kern,029,883053,191111,190208,45537,235745,2154
2022-03-08,Kings,031,150075,51179,51089,3486,54575,434
2022-03-08,Lake,033,64148,10623,10571,876,11447,130
2022-03-08,Lassen,035,31185,8939,8897,871,9768,62
2022-03-08,Los Angeles,037,10098052,2697012,2677166,122344,2799510,30803
2022-03-08,Madera,039,155013,37141,37185,5991,43176,354
2022-03-08,Marin,041,260295,33059,32943,2161,35104,272
2022-03-08,Mariposa,043,17540,2375,2371,196,2567,6
2022-03-08,Mendocino,045,87422,12966,12950,2972,15922,117
2022-03-08,Merced,047,269075,61867,61767,8510,70277,791
2022-03-08,Modoc,049,8938,727,729,249,978,7
2022-03-08,Mono,051,14174,2960,2961,119,3080,5
2022-03-08,Monterey,053,433212,78885,78247,13304,91551,711
2022-03-08,Napa,055,140530,25569,25528,933,26461,137
2022-03-08,Nevada,057,99092,15853,15939,1182,17121,122
2022-03-08,Orange,059,3164182,543960,542164,40795,582959,6692
2022-03-08,Placer,061,380077,62364,62221,7282,69503,594
2022-03-08,Plumas,063,18699,2957,2703,359,3062,13
2022-03-08,Riverside,065,2383286,589111,587686,27574,615260,6294
2022-03-08,Sacramento,067,1510023,279099,274276,26227,300503,2872
2022-03-08,San Benito,069,59416,12828,12855,504,13359,94
2022-03-08,San Bernardino,071,2135413,567659,558512,24519,583031,6715
2022-03-08,San Diego,073,3302833,746311,743604,52067,795671,5077
2022-03-08,San Francisco,075,870044,122615,123675,8092,131767,807
2022-03-08,San Joaquin,077,732212,165628,165381,9783,175164,2104
2022-03-08,San Luis Obispo,079,281455,52091,51900,3694,55594,451
2022-03-08,San Mateo,081,765935,120310,119103,6824,125927,638
2022-03-08,Santa Barbara,083,443738,85228,85363,4658,90021,659
2022-03-08,Santa Clara,085,1922200,307673,308528,12147,320675,2206
2022-03-08,Santa Cruz,087,273765,47206,46875,2060,48935,254
2022-03-08,Shasta,089,179085,30380,30372,6052,36424,493
2022-03-08,Sierra,091,2930,270,273,48,321,4
2022-03-08,Siskiyou,093,43540,4420,4404,2709,7113,74
2022-03-08,Solano,095,438530,80852,80924,5502,86426,434
2022-03-08,Sonoma,097,501317,82762,82571,2517,85088,473
2022-03-08,Stanislaus,099,539301,116940,117782,17477,135259,1541
2022-03-08,Sutter,101,95872,20372,20403,2023,22426,217
2022-03-08,Tehama,103,63373,11992,11972,2574,14546,158
2022-03-08,Trinity,105,12862,1181,1174,287,1461,20
2022-03-08,Tulare,107,460477,105969,103893,27386,131279,1334
2022-03-08,Tuolumne,109,53932,12594,12427,550,12977,180
2022-03-08,Ventura,111,848112,172252,171806,9312,181118,1447
2022-03-08,Yolo,113,214977,36703,35946,2995,38941,306
2022-03-08,Yuba,115,75493,15733,15705,1175,16880,115
2022-03-07,Alameda,001,1643700,253455,252578,13413,265991,1766
2022-03-07,Alpine,003,1148,122,125,1,126,0
2022-03-07,Amador,005,37829,8453,8368,638,9006,84
2022-03-07,Butte,007,227075,32882,32734,6872,39606,378
2022-03-07,Calaveras,009,45235,7214,7242,342,7584,116
2022-03-07,Colusa,011,21464,3426,3437,1045,4482,21
2022-03-07,Contra Costa,013,1133247,187649,186087,12918,199005,1256
2022-03-07,Del Norte,015,27424,5740,5758,178,5936,48
2022-03-07,El Dorado,017,186661,26577,26487,3183,29670,196
2022-03-07,Fresno,019,978130,230032,227670,23372,251042,2653
2022-03-07,Glenn,021,27897,4954,4939,1592,6531,43
2022-03-07,Humboldt,023,135768,16753,16829,2900,19729,137
2022-03-07,Imperial,025,180216,55150,54712,10512,65224,890
2022-03-07,Inyo,027,18085,4056,4054,467,4521,56
2022-03-07,Kern,029,883053,191054,190163,45514,235677,2152
2022-03-07,Kings,031,150075,51149,51065,3481,54546,433
2022-03-07,Lake,033,64148,10611,10562,875,11437,130
2022-03-07,Lassen,035,31185,8938,8896,871,9767,62
2022-03-07,Los Angeles,037,10098052,2696202,2675497,122305,2797802,30759
2022-03-07,Madera,039,155013,37131,37164,5989,43153,354
2022-03-07,Marin,041,260295,33021,32919,2158,35077,272
2022-03-07,Mariposa,043,17540,2374,2369,196,2565,6
2022-03-07,Mendocino,045,87422,12959,12940,2971,15911,117
2022-03-07,Merced,047,269075,61827,61751,8503,70254,791
2022-03-07,Modoc,049,8938,727,729,249,978,7
2022-03-07,Mono,051,14174,2960,2960,119,3079,5
2022-03-07,Monterey,053,433212,78851,78161,13256,91417,706
2022-03-07,Napa,055,140530,25539,25500,933,26433,136
2022-03-07,Nevada,057,99092,15846,15935,1176,17111,122
2022-03-07,Orange,059,3164182,543785,542028,40769,582797,6687
2022-03-07,Placer,061,380077,62335,62215,7281,69496,591
2022-03-07,Plumas,063,18699,2957,2702,359,3061,13
2022-03-07,Riverside,065,2383286,588981,587537,27566,615103,6279
2022-03-07,Sacramento,067,1510023,278998,274079,26214,300293,2866
2022-03-07,San Benito,069,59416,12822,12843,504,13347,94
2022-03-07,San Bernardino,071,2135413,567554,558265,24509,582774,6703
2022-03-07,San Diego,073,3302833,745969,742287,52024,794311,5068
2022-03-07,San Francisco,075,870044,122503,123655,8086,131741,807
2022-03-07,San Joaquin,077,732212,165577,165343,9776,175119,2091
2022-03-07,San Luis Obispo,079,281455,52049,51874,3691,55565,448
2022-03-07,San Mateo,081,765935,120234,119035,6817,125852,630
2022-03-07,Santa Barbara,083,443738,85190,85345,4657,90002,659
2022-03-07,Santa Clara,085,1922200,307486,308517,12141,320658,2202
2022-03-07,Santa Cruz,087,273765,47156,46823,2059,48882,254
2022-03-07,Shasta,089,179085,30367,30352,6049,36401,493
2022-03-07,Sierra,091,2930,270,273,48,321,4
2022-03-07,Siskiyou,093,43540,4416,4398,2708,7106,74
2022-03-07,Solano,095,438530,80795,80886,5500,86386,435
2022-03-07,Sonoma,097,501317,82719,82530,2516,85046,473
2022-03-07,Stanislaus,099,539301,116901,117713,17470,135183,1537
2022-03-07,Sutter,101,95872,20361,20400,2022,22422,217
2022-03-07,Tehama,103,63373,11986,11966,2573,14539,158
2022-03-07,Trinity,105,12862,1179,1173,287,1460,20
2022-03-07,Tulare,107,460477,105933,103834,27376,131210,1316
2022-03-07,Tuolumne,109,53932,12588,12408,549,12957,179
2022-03-07,Ventura,111,848112,172201,171886,9310,181196,1436
2022-03-07,Yolo,113,214977,36680,35934,2989,38923,306
2022-03-07,Yuba,115,75493,15726,15701,1174,16875,115
2022-03-06,Alameda,001,1643700,253268,252460,13404,265864,1766
2022-03-06,Alpine,003,1148,122,125,1,126,0
2022-03-06,Amador,005,37829,8450,8367,636,9003,84
2022-03-06,Butte,007,227075,32871,32714,6867,39581,376
2022-03-06,Calaveras,009,45235,7212,7236,341,7577,116
2022-03-06,Colusa,011,21464,3426,3435,1044,4479,21
2022-03-06,Contra Costa,013,1133247,187535,185974,12893,198867,1256
2022-03-06,Del Norte,015,27424,5724,5744,177,5921,48
2022-03-06,El Dorado,017,186661,26568,26478,3181,29659,196
2022-03-06,Fresno,019,978130,229889,227514,23362,250876,2653
2022-03-06,Glenn,021,27897,4950,4939,1592,6531,43
2022-03-06,Humboldt,023,135768,16743,16813,2897,19710,137
2022-03-06,Imperial,025,180216,55132,54719,10502,65221,890
2022-03-06,Inyo,027,18085,4054,4053,467,4520,56
2022-03-06,Kern,029,883053,190999,190088,45494,235582,2152
2022-03-06,Kings,031,150075,51080,51050,3479,54529,432
2022-03-06,Lake,033,64148,10597,10539,874,11413,130
2022-03-06,Lassen,035,31185,8925,8887,870,9757,62
2022-03-06,Los Angeles,037,10098052,2695272,2675456,122248,2797704,30759
2022-03-06,Madera,039,155013,37101,37135,5982,43117,354
2022-03-06,Marin,041,260295,32995,32879,2157,35036,272
2022-03-06,Mariposa,043,17540,2373,2365,195,2560,6
2022-03-06,Mendocino,045,87422,12947,12923,2967,15890,116
2022-03-06,Merced,047,269075,61795,61722,8486,70208,791
2022-03-06,Modoc,049,8938,727,729,249,978,7
2022-03-06,Mono,051,14174,2960,2959,119,3078,5
2022-03-06,Monterey,053,433212,78805,78154,13225,91379,706
2022-03-06,Napa,055,140530,25504,25457,931,26388,136
2022-03-06,Nevada,057,99092,15835,15924,1175,17099,122
2022-03-06,Orange,059,3164182,543626,541903,40723,582626,6688
2022-03-06,Placer,061,380077,62302,62185,7277,69462,591
2022-03-06,Plumas,063,18699,2952,2704,359,3063,13
2022-03-06,Riverside,065,2383286,588819,587388,27546,614934,6279
2022-03-06,Sacramento,067,1510023,278863,273935,26191,300126,2869
2022-03-06,San Benito,069,59416,12811,12835,503,13338,94
2022-03-06,San Bernardino,071,2135413,567431,558139,24497,582636,6701
2022-03-06,San Diego,073,3302833,745574,742287,51975,794262,5068
2022-03-06,San Francisco,075,870044,122370,123742,8083,131825,806
2022-03-06,San Joaquin,077,732212,165495,165252,9770,175022,2091
2022-03-06,San Luis Obispo,079,281455,52011,51828,3689,55517,448
2022-03-06,San Mateo,081,765935,120151,118916,6808,125724,630
2022-03-06,Santa Barbara,083,443738,85150,85317,4652,89969,659
2022-03-06,Santa Clara,085,1922200,307227,308250,12139,320389,2201
2022-03-06,Santa Cruz,087,273765,47105,46755,2058,48813,254
2022-03-06,Shasta,089,179085,30344,30332,6033,36365,493
2022-03-06,Sierra,091,2930,270,273,48,321,4
2022-03-06,Siskiyou,093,43540,4412,4398,2706,7104,74
2022-03-06,Solano,095,438530,80739,80833,5494,86327,435
2022-03-06,Sonoma,097,501317,82684,82458,2512,84970,473
2022-03-06,Stanislaus,099,539301,116855,117680,17460,135140,1536
2022-03-06,Sutter,101,95872,20350,20390,2018,22408,217
2022-03-06,Tehama,103,63373,11978,11963,2573,14536,158
2022-03-06,Trinity,105,12862,1179,1172,286,1458,20
2022-03-06,Tulare,107,460477,105875,103794,27364,131158,1316
2022-03-06,Tuolumne,109,53932,12582,12379,547,12926,179
2022-03-06,Ventura,111,848112,172132,171819,9308,181127,1436
2022-03-06,Yolo,113,214977,36654,35882,2986,38868,306
2022-03-06,Yuba,115,75493,15722,15694,1173,16867,115
2022-03-05,Alameda,001,1643700,253152,251988,13399,265387,1760
2022-03-05,Alpine,003,1148,122,125,1,126,0
2022-03-05,Amador,005,37829,8447,8344,636,8980,83
2022-03-05,Butte,007,227075,32863,32663,6863,39526,372
2022-03-05,Calaveras,009,45235,7209,7236,341,7577,116
2022-03-05,Colusa,011,21464,3426,3433,1044,4477,21
2022-03-05,Contra Costa,013,1133247,187472,185734,12888,198622,1235
2022-03-05,Del Norte,015,27424,5721,5725,177,5902,48
2022-03-05,El Dorado,017,186661,26562,26446,3178,29624,193
2022-03-05,Fresno,019,978130,229837,227154,23361,250515,2640
2022-03-05,Glenn,021,27897,4948,4927,1592,6519,43
2022-03-05,Humboldt,023,135768,16737,16781,2895,19676,136
2022-03-05,Imperial,025,180216,55122,54650,10500,65150,880
2022-03-05,Inyo,027,18085,4053,4043,466,4509,56
2022-03-05,Kern,029,883053,190967,189817,45476,235293,2141
2022-03-05,Kings,031,150075,51073,50926,3478,54404,431
2022-03-05,Lake,033,64148,10589,10512,873,11385,130
2022-03-05,Lassen,035,31185,8917,8818,870,9688,62
2022-03-05,Los Angeles,037,10098052,2694913,2671564,122211,2793775,30608
2022-03-05,Madera,039,155013,37086,37100,5982,43082,354
2022-03-05,Marin,041,260295,32983,32829,2157,34986,272
2022-03-05,Mariposa,043,17540,2373,2363,195,2558,6
2022-03-05,Mendocino,045,87422,12944,12845,2967,15812,113
2022-03-05,Merced,047,269075,61785,61653,8486,70139,789
2022-03-05,Modoc,049,8938,727,729,249,978,7
2022-03-05,Mono,051,14174,2960,2961,119,3080,5
2022-03-05,Monterey,053,433212,78786,78028,13218,91246,704
2022-03-05,Napa,055,140530,25486,25405,931,26336,134
2022-03-05,Nevada,057,99092,15831,15907,1175,17082,122
2022-03-05,Orange,059,3164182,543501,541463,40712,582175,6638
2022-03-05,Placer,061,380077,62288,62117,7270,69387,591
2022-03-05,Plumas,063,18699,2951,2701,359,3060,13
2022-03-05,Riverside,065,2383286,588728,586785,27542,614327,6239
2022-03-05,Sacramento,067,1510023,278799,273487,26186,299673,2847
2022-03-05,San Benito,069,59416,12809,12820,503,13323,94
2022-03-05,San Bernardino,071,2135413,567373,557421,24491,581912,6641
2022-03-05,San Diego,073,3302833,745384,740747,51964,792711,5045
2022-03-05,San Francisco,075,870044,122301,123537,8080,131617,798
2022-03-05,San Joaquin,077,732212,165454,165085,9762,174847,2069
2022-03-05,San Luis Obispo,079,281455,52003,51739,3688,55427,446
2022-03-05,San Mateo,081,765935,120096,118646,6804,125450,621
2022-03-05,Santa Barbara,083,443738,85135,85249,4652,89901,655
2022-03-05,Santa Clara,085,1922200,307110,307689,12136,319825,2195
2022-03-05,Santa Cruz,087,273765,47085,46622,2058,48680,253
2022-03-05,Shasta,089,179085,30332,30282,6033,36315,492
2022-03-05,Sierra,091,2930,270,273,47,320,4
2022-03-05,Siskiyou,093,43540,4411,4389,2705,7094,74
2022-03-05,Solano,095,438530,80722,80690,5494,86184,435
2022-03-05,Sonoma,097,501317,82662,82313,2512,84825,473
2022-03-05,Stanislaus,099,539301,116829,117501,17458,134959,1531
2022-03-05,Sutter,101,95872,20342,20346,2018,22364,217
2022-03-05,Tehama,103,63373,11976,11939,2573,14512,158
2022-03-05,Trinity,105,12862,1179,1170,284,1454,20
2022-03-05,Tulare,107,460477,105862,103534,27355,130889,1305
2022-03-05,Tuolumne,109,53932,12578,12325,546,12871,178
2022-03-05,Ventura,111,848112,172091,171666,9306,180972,1436
2022-03-05,Yolo,113,214977,36640,35856,2986,38842,306
2022-03-05,Yuba,115,75493,15714,15666,1173,16839,115
2022-03-04,Alameda,001,1643700,253056,251988,13391,265379,1760
2022-03-04,Alpine,003,1148,122,125,1,126,0
2022-03-04,Amador,005,37829,8446,8344,636,8980,83
2022-03-04,Butte,007,227075,32857,32663,6858,39521,372
2022-03-04,Calaveras,009,45235,7208,7236,341,7577,116
2022-03-04,Colusa,011,21464,3424,3433,1044,4477,21
2022-03-04,Contra Costa,013,1133247,187404,185734,12885,198619,1235
2022-03-04,Del Norte,015,27424,5711,5725,177,5902,48
2022-03-04,El Dorado,017,186661,26558,26446,3178,29624,193
2022-03-04,Fresno,019,978130,229774,227154,23354,250508,2640
2022-03-04,Glenn,021,27897,4947,4927,1592,6519,43
2022-03-04,Humboldt,023,135768,16733,16781,2895,19676,136
2022-03-04,Imperial,025,180216,55115,54650,10496,65146,880
2022-03-04,Inyo,027,18085,4053,4043,466,4509,56
2022-03-04,Kern,029,883053,190926,189817,45466,235283,2141
2022-03-04,Kings,031,150075,51060,50926,3478,54404,431
2022-03-04,Lake,033,64148,10588,10512,873,11385,130
2022-03-04,Lassen,035,31185,8915,8818,870,9688,62
2022-03-04,Los Angeles,037,10098052,2694385,2671564,122182,2793746,30608
2022-03-04,Madera,039,155013,37077,37100,5982,43082,354
2022-03-04,Marin,041,260295,32961,32829,2155,34984,272
2022-03-04,Mariposa,043,17540,2368,2363,195,2558,6
2022-03-04,Mendocino,045,87422,12938,12845,2967,15812,113
2022-03-04,Merced,047,269075,61773,61653,8484,70137,789
2022-03-04,Modoc,049,8938,727,729,249,978,7
2022-03-04,Mono,051,14174,2960,2961,119,3080,5
2022-03-04,Monterey,053,433212,78766,78028,13212,91240,704
2022-03-04,Napa,055,140530,25471,25405,930,26335,134
2022-03-04,Nevada,057,99092,15826,15907,1175,17082,122
2022-03-04,Orange,059,3164182,543382,541463,40694,582157,6638
2022-03-04,Placer,061,380077,62276,62117,7267,69384,591
2022-03-04,Plumas,063,18699,2951,2701,358,3059,13
2022-03-04,Riverside,065,2383286,588641,586785,27541,614326,6239
2022-03-04,Sacramento,067,1510023,278726,273487,26183,299670,2847
2022-03-04,San Benito,069,59416,12805,12820,503,13323,94
2022-03-04,San Bernardino,071,2135413,567291,557421,24490,581911,6641
2022-03-04,San Diego,073,3302833,745145,740747,51947,792694,5045
2022-03-04,San Francisco,075,870044,122237,123537,8073,131610,798
2022-03-04,San Joaquin,077,732212,165422,165085,9761,174846,2069
2022-03-04,San Luis Obispo,079,281455,51995,51739,3687,55426,446
2022-03-04,San Mateo,081,765935,120038,118646,6802,125448,621
2022-03-04,Santa Barbara,083,443738,85112,85249,4652,89901,655
2022-03-04,Santa Clara,085,1922200,306960,307689,12133,319822,2195
2022-03-04,Santa Cruz,087,273765,47063,46622,2058,48680,253
2022-03-04,Shasta,089,179085,30324,30282,6030,36312,492
2022-03-04,Sierra,091,2930,270,273,47,320,4
2022-03-04,Siskiyou,093,43540,4409,4389,2701,7090,74
2022-03-04,Solano,095,438530,80689,80690,5491,86181,435
2022-03-04,Sonoma,097,501317,82631,82313,2511,84824,473
2022-03-04,Stanislaus,099,539301,116810,117501,17456,134957,1531
2022-03-04,Sutter,101,95872,20338,20346,2018,22364,217
2022-03-04,Tehama,103,63373,11973,11939,2573,14512,158
2022-03-04,Trinity,105,12862,1179,1170,284,1454,20
2022-03-04,Tulare,107,460477,105843,103534,27350,130884,1305
2022-03-04,Tuolumne,109,53932,12573,12325,546,12871,178
2022-03-04,Ventura,111,848112,172044,171666,9303,180969,1436
2022-03-04,Yolo,113,214977,36623,35856,2986,38842,306
2022-03-04,Yuba,115,75493,15709,15666,1172,16838,115
2022-03-03,Alameda,001,1643700,252937,251988,13379,265367,1760
2022-03-03,Alpine,003,1148,122,125,1,126,0
2022-03-03,Amador,005,37829,8445,8344,636,8980,83
2022-03-03,Butte,007,227075,32840,32663,6851,39514,372
2022-03-03,Calaveras,009,45235,7195,7236,341,7577,116
2022-03-03,Colusa,011,21464,3424,3433,1044,4477,21
2022-03-03,Contra Costa,013,1133247,187329,185734,12870,198604,1235
2022-03-03,Del Norte,015,27424,5704,5725,177,5902,48
2022-03-03,El Dorado,017,186661,26540,26446,3177,29623,193
2022-03-03,Fresno,019,978130,229647,227154,23346,250500,2640
2022-03-03,Glenn,021,27897,4945,4927,1591,6518,43
2022-03-03,Humboldt,023,135768,16718,16781,2894,19675,136
2022-03-03,Imperial,025,180216,55098,54650,10494,65144,880
2022-03-03,Inyo,027,18085,4052,4043,466,4509,56
2022-03-03,Kern,029,883053,190858,189817,45448,235265,2141
2022-03-03,Kings,031,150075,51037,50926,3476,54402,431
2022-03-03,Lake,033,64148,10583,10512,871,11383,130
2022-03-03,Lassen,035,31185,8907,8818,870,9688,62
2022-03-03,Los Angeles,037,10098052,2693658,2671564,122141,2793705,30608
2022-03-03,Madera,039,155013,37061,37100,5977,43077,354
2022-03-03,Marin,041,260295,32935,32829,2154,34983,272
2022-03-03,Mariposa,043,17540,2367,2363,195,2558,6
2022-03-03,Mendocino,045,87422,12927,12845,2965,15810,113
2022-03-03,Merced,047,269075,61754,61653,8478,70131,789
2022-03-03,Modoc,049,8938,727,729,249,978,7
2022-03-03,Mono,051,14174,2959,2961,119,3080,5
2022-03-03,Monterey,053,433212,78736,78028,13195,91223,704
2022-03-03,Napa,055,140530,25447,25405,929,26334,134
2022-03-03,Nevada,057,99092,15821,15907,1170,17077,122
2022-03-03,Orange,059,3164182,543205,541463,40668,582131,6638
2022-03-03,Placer,061,380077,62254,62117,7264,69381,591
2022-03-03,Plumas,063,18699,2950,2701,358,3059,13
2022-03-03,Riverside,065,2383286,588508,586785,27536,614321,6239
2022-03-03,Sacramento,067,1510023,278617,273487,26166,299653,2847
2022-03-03,San Benito,069,59416,12802,12820,503,13323,94
2022-03-03,San Bernardino,071,2135413,567188,557421,24484,581905,6641
2022-03-03,San Diego,073,3302833,744802,740747,51929,792676,5045
2022-03-03,San Francisco,075,870044,122163,123537,8062,131599,798
2022-03-03,San Joaquin,077,732212,165348,165085,9758,174843,2069
2022-03-03,San Luis Obispo,079,281455,51940,51739,3679,55418,446
2022-03-03,San Mateo,081,765935,119963,118646,6792,125438,621
2022-03-03,Santa Barbara,083,443738,85093,85249,4643,89892,655
2022-03-03,Santa Clara,085,1922200,306778,307689,12118,319807,2195
2022-03-03,Santa Cruz,087,273765,47015,46622,2056,48678,253
2022-03-03,Shasta,089,179085,30306,30282,6028,36310,492
2022-03-03,Sierra,091,2930,270,273,47,320,4
2022-03-03,Siskiyou,093,43540,4406,4389,2701,7090,74
2022-03-03,Solano,095,438530,80640,80690,5489,86179,435
2022-03-03,Sonoma,097,501317,82583,82313,2506,84819,473
2022-03-03,Stanislaus,099,539301,116777,117501,17448,134949,1531
2022-03-03,Sutter,101,95872,20330,20346,2018,22364,217
2022-03-03,Tehama,103,63373,11970,11939,2573,14512,158
2022-03-03,Trinity,105,12862,1178,1170,284,1454,20
2022-03-03,Tulare,107,460477,105800,103534,27342,130876,1305
2022-03-03,Tuolumne,109,53932,12562,12325,546,12871,178
2022-03-03,Ventura,111,848112,171991,171666,9301,180967,1436
2022-03-03,Yolo,113,214977,36599,35856,2981,38837,306
2022-03-03,Yuba,115,75493,15703,15666,1167,16833,115
2022-03-02,Alameda,001,1643700,252759,251886,13362,265248,1759
2022-03-02,Alpine,003,1148,122,125,1,126,0
2022-03-02,Amador,005,37829,8433,8341,636,8977,83
2022-03-02,Butte,007,227075,32828,32636,6847,39483,372
2022-03-02,Calaveras,009,45235,7194,7225,341,7566,116
2022-03-02,Colusa,011,21464,3421,3428,1044,4472,21
2022-03-02,Contra Costa,013,1133247,187236,185589,12852,198441,1236
2022-03-02,Del Norte,015,27424,5697,5708,175,5883,47
2022-03-02,El Dorado,017,186661,26529,26433,3174,29607,192
2022-03-02,Fresno,019,978130,229515,226932,23336,250268,2629
2022-03-02,Glenn,021,27897,4945,4922,1590,6512,43
2022-03-02,Humboldt,023,135768,16708,16747,2887,19634,135
2022-03-02,Imperial,025,180216,55072,54629,10489,65118,878
2022-03-02,Inyo,027,18085,4050,4041,465,4506,56
2022-03-02,Kern,029,883053,190792,189656,45429,235085,2136
2022-03-02,Kings,031,150075,51011,50819,3473,54292,431
2022-03-02,Lake,033,64148,10570,10495,869,11364,130
2022-03-02,Lassen,035,31185,8904,8811,869,9680,62
2022-03-02,Los Angeles,037,10098052,2692777,2670287,122095,2792382,30535
2022-03-02,Madera,039,155013,37044,37077,5975,43052,354
2022-03-02,Marin,041,260295,32917,32794,2153,34947,272
2022-03-02,Mariposa,043,17540,2367,2359,195,2554,6
2022-03-02,Mendocino,045,87422,12914,12832,2960,15792,112
2022-03-02,Merced,047,269075,61728,61606,8468,70074,785
2022-03-02,Modoc,049,8938,727,729,249,978,7
2022-03-02,Mono,051,14174,2959,2961,119,3080,5
2022-03-02,Monterey,053,433212,78700,77963,13172,91135,703
2022-03-02,Napa,055,140530,25398,25382,928,26310,134
2022-03-02,Nevada,057,99092,15810,15920,1169,17089,122
2022-03-02,Orange,059,3164182,543000,541230,40642,581872,6623
2022-03-02,Placer,061,380077,62232,62066,7261,69327,589
2022-03-02,Plumas,063,18699,2950,2700,358,3058,13
2022-03-02,Riverside,065,2383286,588358,586513,27526,614039,6229
2022-03-02,Sacramento,067,1510023,278499,273291,26155,299446,2837
2022-03-02,San Benito,069,59416,12791,12814,503,13317,94
2022-03-02,San Bernardino,071,2135413,567079,557082,24478,581560,6619
2022-03-02,San Diego,073,3302833,744441,739803,51881,791684,5034
2022-03-02,San Francisco,075,870044,122068,123442,8060,131502,792
2022-03-02,San Joaquin,077,732212,165289,164968,9753,174721,2063
2022-03-02,San Luis Obispo,079,281455,51902,51686,3674,55360,446
2022-03-02,San Mateo,081,765935,119876,118518,6776,125294,617
2022-03-02,Santa Barbara,083,443738,85068,85183,4642,89825,655
2022-03-02,Santa Clara,085,1922200,306564,307354,12104,319458,2184
2022-03-02,Santa Cruz,087,273765,46945,46534,2055,48589,253
2022-03-02,Shasta,089,179085,30281,30253,6018,36271,490
2022-03-02,Sierra,091,2930,270,273,47,320,4
2022-03-02,Siskiyou,093,43540,4404,4384,2698,7082,74
2022-03-02,Solano,095,438530,80574,80626,5486,86112,433
2022-03-02,Sonoma,097,501317,82537,82208,2502,84710,473
2022-03-02,Stanislaus,099,539301,116741,117411,17423,134834,1519
2022-03-02,Sutter,101,95872,20308,20317,2001,22318,216
2022-03-02,Tehama,103,63373,11965,11930,2572,14502,158
2022-03-02,Trinity,105,12862,1176,1160,284,1444,20
2022-03-02,Tulare,107,460477,105759,103451,27327,130778,1302
2022-03-02,Tuolumne,109,53932,12557,12297,546,12843,179
2022-03-02,Ventura,111,848112,171938,171770,9297,181067,1427
2022-03-02,Yolo,113,214977,36581,35799,2976,38775,305
2022-03-02,Yuba,115,75493,15690,15653,1162,16815,115
2022-03-01,Alameda,001,1643700,252594,251830,13351,265181,1749
2022-03-01,Alpine,003,1148,122,125,1,126,0
2022-03-01,Amador,005,37829,8385,8334,634,8968,83
2022-03-01,Butte,007,227075,32804,32575,6842,39417,372
2022-03-01,Calaveras,009,45235,7191,7223,340,7563,116
2022-03-01,Colusa,011,21464,3420,3423,1044,4467,21
2022-03-01,Contra Costa,013,1133247,187125,185378,12837,198215,1231
2022-03-01,Del Norte,015,27424,5694,5701,174,5875,45
2022-03-01,El Dorado,017,186661,26510,26413,3172,29585,192
2022-03-01,Fresno,019,978130,229375,226594,23323,249917,2628
2022-03-01,Glenn,021,27897,4944,4919,1588,6507,40
2022-03-01,Humboldt,023,135768,16687,16727,2880,19607,135
2022-03-01,Imperial,025,180216,55055,54570,10483,65053,875
2022-03-01,Inyo,027,18085,4046,4041,464,4505,56
2022-03-01,Kern,029,883053,190718,189365,45405,234770,2120
2022-03-01,Kings,031,150075,50989,50763,3469,54232,427
2022-03-01,Lake,033,64148,10559,10471,867,11338,128
2022-03-01,Lassen,035,31185,8900,8801,869,9670,61
2022-03-01,Los Angeles,037,10098052,2691825,2669489,122037,2791526,30486
2022-03-01,Madera,039,155013,37024,37046,5969,43015,354
2022-03-01,Marin,041,260295,32892,32764,2152,34916,272
2022-03-01,Mariposa,043,17540,2366,2357,194,2551,6
2022-03-01,Mendocino,045,87422,12903,12818,2958,15776,112
2022-03-01,Merced,047,269075,61699,61549,8455,70004,781
2022-03-01,Modoc,049,8938,727,729,249,978,7
2022-03-01,Mono,051,14174,2958,2960,119,3079,6
2022-03-01,Monterey,053,433212,78674,77911,13162,91073,696
2022-03-01,Napa,055,140530,25367,25344,928,26272,134
2022-03-01,Nevada,057,99092,15802,15916,1166,17082,121
2022-03-01,Orange,059,3164182,542780,541054,40607,581661,6612
2022-03-01,Placer,061,380077,62204,62021,7256,69277,583
2022-03-01,Plumas,063,18699,2950,2694,358,3052,13
2022-03-01,Riverside,065,2383286,588192,586184,27525,613709,6198
2022-03-01,Sacramento,067,1510023,278368,273089,26142,299231,2831
2022-03-01,San Benito,069,59416,12787,12806,503,13309,94
2022-03-01,San Bernardino,071,2135413,566951,556743,24475,581218,6588
2022-03-01,San Diego,073,3302833,744015,739136,51839,790975,5029
2022-03-01,San Francisco,075,870044,121965,123481,8054,131535,792
2022-03-01,San Joaquin,077,732212,165222,164894,9749,174643,2062
2022-03-01,San Luis Obispo,079,281455,51866,51592,3670,55262,445
2022-03-01,San Mateo,081,765935,119799,118358,6769,125127,613
2022-03-01,Santa Barbara,083,443738,85030,85134,4638,89772,654
2022-03-01,Santa Clara,085,1922200,306313,306978,12092,319070,2190
2022-03-01,Santa Cruz,087,273765,46895,46471,2052,48523,253
2022-03-01,Shasta,089,179085,30252,30227,6015,36242,489
2022-03-01,Sierra,091,2930,270,274,47,321,5
2022-03-01,Siskiyou,093,43540,4400,4384,2693,7077,74
2022-03-01,Solano,095,438530,80512,80556,5483,86039,434
2022-03-01,Sonoma,097,501317,82467,82103,2496,84599,477
2022-03-01,Stanislaus,099,539301,116689,117308,17399,134707,1521
2022-03-01,Sutter,101,95872,20294,20288,1997,22285,217
2022-03-01,Tehama,103,63373,11959,11923,2569,14492,158
2022-03-01,Trinity,105,12862,1175,1159,284,1443,20
2022-03-01,Tulare,107,460477,105677,103371,27307,130678,1302
2022-03-01,Tuolumne,109,53932,12550,12276,544,12820,175
2022-03-01,Ventura,111,848112,171868,171672,9290,180962,1427
2022-03-01,Yolo,113,214977,36556,35801,2970,38771,299
2022-03-01,Yuba,115,75493,15682,15637,1162,16799,116
2022-02-28,Alameda,001,1643700,252375,251714,13336,265050,1742
2022-02-28,Alpine,003,1148,122,125,1,126,0
2022-02-28,Amador,005,37829,8379,8308,633,8941,83
2022-02-28,Butte,007,227075,32782,32550,6836,39386,368
2022-02-28,Calaveras,009,45235,7188,7220,339,7559,110
2022-02-28,Colusa,011,21464,3417,3422,1042,4464,21
2022-02-28,Contra Costa,013,1133247,187017,185272,12818,198090,1231
2022-02-28,Del Norte,015,27424,5689,5699,173,5872,45
2022-02-28,El Dorado,017,186661,26500,26409,3167,29576,191
2022-02-28,Fresno,019,978130,229174,226519,23302,249821,2622
2022-02-28,Glenn,021,27897,4940,4918,1588,6506,40
2022-02-28,Humboldt,023,135768,16672,16717,2876,19593,135
2022-02-28,Imperial,025,180216,55029,54517,10479,64996,875
2022-02-28,Inyo,027,18085,4046,4041,463,4504,56
2022-02-28,Kern,029,883053,190627,189245,45376,234621,2115
2022-02-28,Kings,031,150075,50950,50741,3468,54209,427
2022-02-28,Lake,033,64148,10547,10468,863,11331,128
2022-02-28,Lassen,035,31185,8843,8794,869,9663,55
2022-02-28,Los Angeles,037,10098052,2690651,2666804,121941,2788745,30410
2022-02-28,Madera,039,155013,36997,37023,5953,42976,354
2022-02-28,Marin,041,260295,32867,32775,2152,34927,272
2022-02-28,Mariposa,043,17540,2363,2354,192,2546,6
2022-02-28,Mendocino,045,87422,12894,12800,2950,15750,112
2022-02-28,Merced,047,269075,61655,61519,8438,69957,781
2022-02-28,Modoc,049,8938,727,727,249,976,7
2022-02-28,Mono,051,14174,2958,2961,119,3080,5
2022-02-28,Monterey,053,433212,78607,77865,13141,91006,693
2022-02-28,Napa,055,140530,25340,25317,928,26245,129
2022-02-28,Nevada,057,99092,15796,15908,1160,17068,121
2022-02-28,Orange,059,3164182,542527,540839,40593,581432,6605
2022-02-28,Placer,061,380077,62173,61976,7251,69227,577
2022-02-28,Plumas,063,18699,2950,2691,357,3048,13
2022-02-28,Riverside,065,2383286,587996,585891,27493,613384,6179
2022-02-28,Sacramento,067,1510023,278229,273038,26118,299156,2825
2022-02-28,San Benito,069,59416,12783,12798,503,13301,94
2022-02-28,San Bernardino,071,2135413,566765,556540,24461,581001,6576
2022-02-28,San Diego,073,3302833,743627,737760,51809,789569,5018
2022-02-28,San Francisco,075,870044,121805,123402,8047,131449,792
2022-02-28,San Joaquin,077,732212,165136,164833,9739,174572,2060
2022-02-28,San Luis Obispo,079,281455,51807,51565,3663,55228,440
2022-02-28,San Mateo,081,765935,119699,118301,6763,125064,611
2022-02-28,Santa Barbara,083,443738,84987,85076,4633,89709,653
2022-02-28,Santa Clara,085,1922200,306037,306930,12070,319000,2180
2022-02-28,Santa Cruz,087,273765,46825,46447,2051,48498,253
2022-02-28,Shasta,089,179085,30227,30213,6011,36224,488
2022-02-28,Sierra,091,2930,270,273,47,320,4
2022-02-28,Siskiyou,093,43540,4397,4382,2688,7070,74
2022-02-28,Solano,095,438530,80446,80544,5472,86016,430
2022-02-28,Sonoma,097,501317,82399,82058,2493,84551,477
2022-02-28,Stanislaus,099,539301,116625,117231,17383,134614,1521
2022-02-28,Sutter,101,95872,20281,20285,1994,22279,214
2022-02-28,Tehama,103,63373,11946,11917,2569,14486,158
2022-02-28,Trinity,105,12862,1175,1160,284,1444,20
2022-02-28,Tulare,107,460477,105628,103304,27291,130595,1300
2022-02-28,Tuolumne,109,53932,12540,12247,544,12791,175
2022-02-28,Ventura,111,848112,171784,171614,9289,180903,1423
2022-02-28,Yolo,113,214977,36520,35754,2963,38717,299
2022-02-28,Yuba,115,75493,15667,15625,1161,16786,115
2022-02-27,Alameda,001,1643700,252099,251624,13327,264951,1744
2022-02-27,Alpine,003,1148,122,125,1,126,0
2022-02-27,Amador,005,37829,8375,8305,630,8935,83
2022-02-27,Butte,007,227075,32745,32551,6823,39374,368
2022-02-27,Calaveras,009,45235,7181,7214,339,7553,110
2022-02-27,Colusa,011,21464,3416,3422,1042,4464,21
2022-02-27,Contra Costa,013,1133247,186891,185185,12798,197983,1230
2022-02-27,Del Norte,015,27424,5672,5691,171,5862,45
2022-02-27,El Dorado,017,186661,26482,26410,3165,29575,191
2022-02-27,Fresno,019,978130,228976,226397,23275,249672,2621
2022-02-27,Glenn,021,27897,4938,4915,1588,6503,40
2022-02-27,Humboldt,023,135768,16650,16713,2869,19582,135
2022-02-27,Imperial,025,180216,54981,54509,10462,64971,875
2022-02-27,Inyo,027,18085,4045,4041,459,4500,56
2022-02-27,Kern,029,883053,190509,189219,45338,234557,2115
2022-02-27,Kings,031,150075,50922,50733,3467,54200,428
2022-02-27,Lake,033,64148,10528,10463,863,11326,128
2022-02-27,Lassen,035,31185,8835,8786,869,9655,55
2022-02-27,Los Angeles,037,10098052,2689344,2666789,121858,2788647,30410
2022-02-27,Madera,039,155013,36971,37009,5945,42954,354
2022-02-27,Marin,041,260295,32829,32756,2150,34906,272
2022-02-27,Mariposa,043,17540,2360,2352,192,2544,6
2022-02-27,Mendocino,045,87422,12878,12798,2937,15735,112
2022-02-27,Merced,047,269075,61603,61491,8421,69912,779
2022-02-27,Modoc,049,8938,726,727,249,976,7
2022-02-27,Mono,051,14174,2957,2960,119,3079,5
2022-02-27,Monterey,053,433212,78549,77851,13117,90968,693
2022-02-27,Napa,055,140530,25302,25316,928,26244,129
2022-02-27,Nevada,057,99092,15788,15900,1156,17056,121
2022-02-27,Orange,059,3164182,542280,540659,40564,581223,6605
2022-02-27,Placer,061,380077,62133,61965,7247,69212,577
2022-02-27,Plumas,063,18699,2947,2691,357,3048,13
2022-02-27,Riverside,065,2383286,587755,585833,27469,613302,6179
2022-02-27,Sacramento,067,1510023,278043,272927,26089,299016,2822
2022-02-27,San Benito,069,59416,12776,12798,503,13301,94
2022-02-27,San Bernardino,071,2135413,566580,556457,24451,580908,6572
2022-02-27,San Diego,073,3302833,743154,737760,51764,789524,5018
2022-02-27,San Francisco,075,870044,121682,123327,8036,131363,791
2022-02-27,San Joaquin,077,732212,165032,164814,9735,174549,2060
2022-02-27,San Luis Obispo,079,281455,51715,51564,3656,55220,439
2022-02-27,San Mateo,081,765935,119586,118244,6758,125002,611
2022-02-27,Santa Barbara,083,443738,84949,85050,4629,89679,653
2022-02-27,Santa Clara,085,1922200,305749,306756,12042,318798,2180
2022-02-27,Santa Cruz,087,273765,46765,46411,2051,48462,253
2022-02-27,Shasta,089,179085,30195,30206,6006,36212,488
2022-02-27,Sierra,091,2930,270,273,47,320,4
2022-02-27,Siskiyou,093,43540,4392,4378,2676,7054,74
2022-02-27,Solano,095,438530,80370,80515,5459,85974,430
2022-02-27,Sonoma,097,501317,82317,82041,2487,84528,476
2022-02-27,Stanislaus,099,539301,116558,117200,17364,134564,1522
2022-02-27,Sutter,101,95872,20264,20280,1988,22268,214
2022-02-27,Tehama,103,63373,11933,11915,2568,14483,158
2022-02-27,Trinity,105,12862,1174,1158,284,1442,20
2022-02-27,Tulare,107,460477,105559,103270,27242,130512,1300
2022-02-27,Tuolumne,109,53932,12527,12243,543,12786,175
2022-02-27,Ventura,111,848112,171709,171660,9285,180945,1423
2022-02-27,Yolo,113,214977,36492,35744,2958,38702,299
2022-02-27,Yuba,115,75493,15657,15619,1159,16778,113
2022-02-26,Alameda,001,1643700,251991,250867,13322,264189,1716
2022-02-26,Alpine,003,1148,122,125,1,126,0
2022-02-26,Amador,005,37829,8373,8282,629,8911,83
2022-02-26,Butte,007,227075,32731,32466,6820,39286,368
2022-02-26,Calaveras,009,45235,7180,7192,339,7531,110
2022-02-26,Colusa,011,21464,3416,3414,1042,4456,21
2022-02-26,Contra Costa,013,1133247,186822,184686,12780,197466,1209
2022-02-26,Del Norte,015,27424,5667,5639,171,5810,45
2022-02-26,El Dorado,017,186661,26471,26355,3162,29517,191
2022-02-26,Fresno,019,978130,228886,225679,23275,248954,2597
2022-02-26,Glenn,021,27897,4936,4909,1587,6496,40
2022-02-26,Humboldt,023,135768,16625,16619,2868,19487,133
2022-02-26,Imperial,025,180216,54954,54367,10460,64827,871
2022-02-26,Inyo,027,18085,4044,4034,454,4488,56
2022-02-26,Kern,029,883053,190456,188584,45319,233903,2106
2022-02-26,Kings,031,150075,50909,50579,3467,54046,423
2022-02-26,Lake,033,64148,10523,10383,863,11246,128
2022-02-26,Lassen,035,31185,8834,8761,869,9630,55
2022-02-26,Los Angeles,037,10098052,2688770,2660973,121818,2782791,30202
2022-02-26,Madera,039,155013,36956,36933,5942,42875,330
2022-02-26,Marin,041,260295,32813,32651,2148,34799,267
2022-02-26,Mariposa,043,17540,2359,2332,192,2524,6
2022-02-26,Mendocino,045,87422,12871,12762,2937,15699,111
2022-02-26,Merced,047,269075,61582,61348,8420,69768,775
2022-02-26,Modoc,049,8938,726,726,249,975,7
2022-02-26,Mono,051,14174,2957,2959,118,3077,5
2022-02-26,Monterey,053,433212,78517,77610,13111,90721,692
2022-02-26,Napa,055,140530,25287,25221,927,26148,130
2022-02-26,Nevada,057,99092,15784,15850,1154,17004,121
2022-02-26,Orange,059,3164182,542169,539992,40547,580539,6540
2022-02-26,Placer,061,380077,62114,61803,7244,69047,573
2022-02-26,Plumas,063,18699,2947,2673,357,3030,13
2022-02-26,Riverside,065,2383286,587635,584835,27460,612295,6143
2022-02-26,Sacramento,067,1510023,277947,272339,26079,298418,2793
2022-02-26,San Benito,069,59416,12772,12770,503,13273,92
2022-02-26,San Bernardino,071,2135413,566489,555668,24445,580113,6505
2022-02-26,San Diego,073,3302833,742931,736049,51742,787791,5002
2022-02-26,San Francisco,075,870044,121612,123079,8028,131107,769
2022-02-26,San Joaquin,077,732212,164998,164418,9734,174152,2048
2022-02-26,San Luis Obispo,079,281455,51702,51358,3654,55012,438
2022-02-26,San Mateo,081,765935,119532,117860,6757,124617,603
2022-02-26,Santa Barbara,083,443738,84918,84830,4629,89459,652
2022-02-26,Santa Clara,085,1922200,305600,305895,12039,317934,2166
2022-02-26,Santa Cruz,087,273765,46742,46186,2051,48237,251
2022-02-26,Shasta,089,179085,30186,30108,6000,36108,485
2022-02-26,Sierra,091,2930,270,270,47,317,1
2022-02-26,Siskiyou,093,43540,4392,4359,2674,7033,72
2022-02-26,Solano,095,438530,80335,80225,5455,85680,428
2022-02-26,Sonoma,097,501317,82283,81702,2485,84187,432
2022-02-26,Stanislaus,099,539301,116520,116896,17359,134255,1503
2022-02-26,Sutter,101,95872,20255,20230,1988,22218,214
2022-02-26,Tehama,103,63373,11927,11878,2566,14444,158
2022-02-26,Trinity,105,12862,1173,1156,284,1440,20
2022-02-26,Tulare,107,460477,105523,102983,27227,130210,1295
2022-02-26,Tuolumne,109,53932,12524,12169,543,12712,175
2022-02-26,Ventura,111,848112,171677,171292,9282,180574,1411
2022-02-26,Yolo,113,214977,36471,35615,2955,38570,296
2022-02-26,Yuba,115,75493,15645,15587,1159,16746,113
2022-02-25,Alameda,001,1643700,251868,250867,13313,264180,1716
2022-02-25,Alpine,003,1148,122,125,1,126,0
2022-02-25,Amador,005,37829,8362,8282,629,8911,83
2022-02-25,Butte,007,227075,32718,32466,6817,39283,368
2022-02-25,Calaveras,009,45235,7178,7192,339,7531,110
2022-02-25,Colusa,011,21464,3416,3414,1042,4456,21
2022-02-25,Contra Costa,013,1133247,186738,184686,12759,197445,1209
2022-02-25,Del Norte,015,27424,5658,5639,171,5810,45
2022-02-25,El Dorado,017,186661,26462,26355,3162,29517,191
2022-02-25,Fresno,019,978130,228788,225679,23268,248947,2597
2022-02-25,Glenn,021,27897,4934,4909,1587,6496,40
2022-02-25,Humboldt,023,135768,16614,16619,2868,19487,133
2022-02-25,Imperial,025,180216,54936,54367,10459,64826,871
2022-02-25,Inyo,027,18085,4043,4034,454,4488,56
2022-02-25,Kern,029,883053,190391,188584,45306,233890,2106
2022-02-25,Kings,031,150075,50895,50579,3465,54044,423
2022-02-25,Lake,033,64148,10505,10383,863,11246,128
2022-02-25,Lassen,035,31185,8831,8761,869,9630,55
2022-02-25,Los Angeles,037,10098052,2688182,2660973,121787,2782760,30202
2022-02-25,Madera,039,155013,36936,36933,5941,42874,330
2022-02-25,Marin,041,260295,32799,32651,2148,34799,267
2022-02-25,Mariposa,043,17540,2356,2332,192,2524,6
2022-02-25,Mendocino,045,87422,12869,12762,2937,15699,111
2022-02-25,Merced,047,269075,61550,61348,8416,69764,775
2022-02-25,Modoc,049,8938,726,726,249,975,7
2022-02-25,Mono,051,14174,2956,2959,118,3077,5
2022-02-25,Monterey,053,433212,78489,77610,13105,90715,692
2022-02-25,Napa,055,140530,25278,25221,927,26148,130
2022-02-25,Nevada,057,99092,15773,15850,1151,17001,121
2022-02-25,Orange,059,3164182,542034,539992,40524,580516,6540
2022-02-25,Placer,061,380077,62099,61803,7238,69041,573
2022-02-25,Plumas,063,18699,2945,2673,357,3030,13
2022-02-25,Riverside,065,2383286,587480,584835,27448,612283,6143
2022-02-25,Sacramento,067,1510023,277845,272339,26074,298413,2793
2022-02-25,San Benito,069,59416,12770,12770,503,13273,92
2022-02-25,San Bernardino,071,2135413,566382,555668,24438,580106,6505
2022-02-25,San Diego,073,3302833,742649,736049,51723,787772,5002
2022-02-25,San Francisco,075,870044,121532,123079,8025,131104,769
2022-02-25,San Joaquin,077,732212,164957,164418,9729,174147,2048
2022-02-25,San Luis Obispo,079,281455,51698,51358,3645,55003,438
2022-02-25,San Mateo,081,765935,119470,117860,6753,124613,603
2022-02-25,Santa Barbara,083,443738,84881,84830,4629,89459,652
2022-02-25,Santa Clara,085,1922200,305415,305895,12036,317931,2166
2022-02-25,Santa Cruz,087,273765,46708,46186,2049,48235,251
2022-02-25,Shasta,089,179085,30177,30108,5998,36106,485
2022-02-25,Sierra,091,2930,270,270,47,317,1
2022-02-25,Siskiyou,093,43540,4392,4359,2673,7032,72
2022-02-25,Solano,095,438530,80306,80225,5454,85679,428
2022-02-25,Sonoma,097,501317,82232,81702,2483,84185,432
2022-02-25,Stanislaus,099,539301,116492,116896,17355,134251,1503
2022-02-25,Sutter,101,95872,20246,20230,1988,22218,214
2022-02-25,Tehama,103,63373,11925,11878,2566,14444,158
2022-02-25,Trinity,105,12862,1173,1156,284,1440,20
2022-02-25,Tulare,107,460477,105489,102983,27205,130188,1295
2022-02-25,Tuolumne,109,53932,12521,12169,543,12712,175
2022-02-25,Ventura,111,848112,171626,171292,9281,180573,1411
2022-02-25,Yolo,113,214977,36456,35615,2955,38570,296
2022-02-25,Yuba,115,75493,15638,15587,1159,16746,113
2022-02-24,Alameda,001,1643700,251663,250867,13304,264171,1716
2022-02-24,Alpine,003,1148,122,125,1,126,0
2022-02-24,Amador,005,37829,8357,8282,628,8910,83
2022-02-24,Butte,007,227075,32697,32466,6813,39279,368
2022-02-24,Calaveras,009,45235,7176,7192,337,7529,110
2022-02-24,Colusa,011,21464,3415,3414,1041,4455,21
2022-02-24,Contra Costa,013,1133247,186608,184686,12751,197437,1209
2022-02-24,Del Norte,015,27424,5643,5639,170,5809,45
2022-02-24,El Dorado,017,186661,26447,26355,3162,29517,191
2022-02-24,Fresno,019,978130,228592,225679,23253,248932,2597
2022-02-24,Glenn,021,27897,4932,4909,1586,6495,40
2022-02-24,Humboldt,023,135768,16597,16619,2867,19486,133
2022-02-24,Imperial,025,180216,54896,54367,10450,64817,871
2022-02-24,Inyo,027,18085,4042,4034,453,4487,56
2022-02-24,Kern,029,883053,190250,188584,45273,233857,2106
2022-02-24,Kings,031,150075,50865,50579,3460,54039,423
2022-02-24,Lake,033,64148,10488,10383,863,11246,128
2022-02-24,Lassen,035,31185,8827,8761,868,9629,55
2022-02-24,Los Angeles,037,10098052,2687022,2660973,121731,2782704,30202
2022-02-24,Madera,039,155013,36910,36933,5939,42872,330
2022-02-24,Marin,041,260295,32779,32651,2147,34798,267
2022-02-24,Mariposa,043,17540,2350,2332,191,2523,6
2022-02-24,Mendocino,045,87422,12862,12762,2933,15695,111
2022-02-24,Merced,047,269075,61520,61348,8408,69756,775
2022-02-24,Modoc,049,8938,725,726,249,975,7
2022-02-24,Mono,051,14174,2955,2959,118,3077,5
2022-02-24,Monterey,053,433212,78437,77610,13097,90707,692
2022-02-24,Napa,055,140530,25238,25221,923,26144,130
2022-02-24,Nevada,057,99092,15759,15850,1151,17001,121
2022-02-24,Orange,059,3164182,541784,539992,40490,580482,6540
2022-02-24,Placer,061,380077,62062,61803,7236,69039,573
2022-02-24,Plumas,063,18699,2940,2673,356,3029,13
2022-02-24,Riverside,065,2383286,587228,584835,27422,612257,6143
2022-02-24,Sacramento,067,1510023,277672,272339,26058,298397,2793
2022-02-24,San Benito,069,59416,12759,12770,503,13273,92
2022-02-24,San Bernardino,071,2135413,566189,555668,24426,580094,6505
2022-02-24,San Diego,073,3302833,742236,736049,51676,787725,5002
2022-02-24,San Francisco,075,870044,121410,123079,8018,131097,769
2022-02-24,San Joaquin,077,732212,164828,164418,9725,174143,2048
2022-02-24,San Luis Obispo,079,281455,51652,51358,3643,55001,438
2022-02-24,San Mateo,081,765935,119378,117860,6746,124606,603
2022-02-24,Santa Barbara,083,443738,84816,84830,4628,89458,652
2022-02-24,Santa Clara,085,1922200,305180,305895,12023,317918,2166
2022-02-24,Santa Cruz,087,273765,46628,46186,2047,48233,251
2022-02-24,Shasta,089,179085,30158,30108,5992,36100,485
2022-02-24,Sierra,091,2930,270,270,47,317,1
2022-02-24,Siskiyou,093,43540,4389,4359,2670,7029,72
2022-02-24,Solano,095,438530,80227,80225,5450,85675,428
2022-02-24,Sonoma,097,501317,82178,81702,2478,84180,432
2022-02-24,Stanislaus,099,539301,116416,116896,17346,134242,1503
2022-02-24,Sutter,101,95872,20232,20230,1972,22202,214
2022-02-24,Tehama,103,63373,11919,11878,2565,14443,158
2022-02-24,Trinity,105,12862,1171,1156,284,1440,20
2022-02-24,Tulare,107,460477,105433,102983,27175,130158,1295
2022-02-24,Tuolumne,109,53932,12511,12169,541,12710,175
2022-02-24,Ventura,111,848112,171547,171292,9278,180570,1411
2022-02-24,Yolo,113,214977,36430,35615,2953,38568,296
2022-02-24,Yuba,115,75493,15624,15587,1159,16746,113
2022-02-23,Alameda,001,1643700,251438,247686,13285,260971,1713
2022-02-23,Alpine,003,1148,122,125,1,126,0
2022-02-23,Amador,005,37829,8339,8274,628,8902,79
2022-02-23,Butte,007,227075,32670,32417,6810,39227,367
2022-02-23,Calaveras,009,45235,7166,7182,336,7518,107
2022-02-23,Colusa,011,21464,3411,3411,1041,4452,21
2022-02-23,Contra Costa,013,1133247,186464,184013,12738,196751,1209
2022-02-23,Del Norte,015,27424,5632,5625,169,5794,45
2022-02-23,El Dorado,017,186661,26431,26317,3158,29475,189
2022-02-23,Fresno,019,978130,228403,225308,23231,248539,2596
2022-02-23,Glenn,021,27897,4928,4909,1584,6493,40
2022-02-23,Humboldt,023,135768,16581,16601,2864,19465,132
2022-02-23,Imperial,025,180216,54857,54292,10438,64730,871
2022-02-23,Inyo,027,18085,4041,4031,450,4481,54
2022-02-23,Kern,029,883053,190147,188432,45226,233658,2106
2022-02-23,Kings,031,150075,50832,50416,3459,53875,423
2022-02-23,Lake,033,64148,10470,10368,862,11230,126
2022-02-23,Lassen,035,31185,8811,8749,868,9617,55
2022-02-23,Los Angeles,037,10098052,2685652,2659569,121685,2781254,30167
2022-02-23,Madera,039,155013,36878,36876,5929,42805,330
2022-02-23,Marin,041,260295,32756,32625,2146,34771,267
2022-02-23,Mariposa,043,17540,2345,2325,190,2515,6
2022-02-23,Mendocino,045,87422,12852,12747,2929,15676,111
2022-02-23,Merced,047,269075,61490,61295,8403,69698,772
2022-02-23,Modoc,049,8938,725,723,248,971,7
2022-02-23,Mono,051,14174,2954,2960,118,3078,5
2022-02-23,Monterey,053,433212,78399,77472,13074,90546,691
2022-02-23,Napa,055,140530,25214,25185,918,26103,128
2022-02-23,Nevada,057,99092,15753,15825,1148,16973,121
2022-02-23,Orange,059,3164182,541479,539631,40468,580099,6520
2022-02-23,Placer,061,380077,62015,61758,7229,68987,573
2022-02-23,Plumas,063,18699,2936,2663,356,3019,13
2022-02-23,Riverside,065,2383286,586936,584381,27386,611767,6119
2022-02-23,Sacramento,067,1510023,277514,272057,26038,298095,2796
2022-02-23,San Benito,069,59416,12752,12756,502,13258,92
2022-02-23,San Bernardino,071,2135413,566028,555238,24410,579648,6479
2022-02-23,San Diego,073,3302833,741733,735406,51626,787032,4988
2022-02-23,San Francisco,075,870044,121283,122127,8016,130143,769
2022-02-23,San Joaquin,077,732212,164735,164257,9720,173977,2042
2022-02-23,San Luis Obispo,079,281455,51604,51264,3641,54905,434
2022-02-23,San Mateo,081,765935,119287,117585,6737,124322,603
2022-02-23,Santa Barbara,083,443738,84755,84760,4624,89384,651
2022-02-23,Santa Clara,085,1922200,304924,305484,12014,317498,2157
2022-02-23,Santa Cruz,087,273765,46558,46059,2046,48105,251
2022-02-23,Shasta,089,179085,30131,30066,5989,36055,481
2022-02-23,Sierra,091,2930,270,270,47,317,1
2022-02-23,Siskiyou,093,43540,4386,4356,2668,7024,71
2022-02-23,Solano,095,438530,80137,80103,5448,85551,427
2022-02-23,Sonoma,097,501317,82124,81594,2476,84070,432
2022-02-23,Stanislaus,099,539301,116339,116789,17337,134126,1482
2022-02-23,Sutter,101,95872,20215,20194,1968,22162,213
2022-02-23,Tehama,103,63373,11909,11863,2565,14428,154
2022-02-23,Trinity,105,12862,1171,1156,284,1440,20
2022-02-23,Tulare,107,460477,105367,102812,27152,129964,1290
2022-02-23,Tuolumne,109,53932,12502,12158,540,12698,175
2022-02-23,Ventura,111,848112,171459,171163,9271,180434,1401
2022-02-23,Yolo,113,214977,36393,35590,2946,38536,296
2022-02-23,Yuba,115,75493,15621,15571,1157,16728,113
2022-02-22,Alameda,001,1643700,251194,247434,13271,260705,1706
2022-02-22,Alpine,003,1148,122,124,1,125,0
2022-02-22,Amador,005,37829,8329,8243,628,8871,79
2022-02-22,Butte,007,227075,32635,32359,6803,39162,366
2022-02-22,Calaveras,009,45235,7157,7178,336,7514,107
2022-02-22,Colusa,011,21464,3411,3402,1039,4441,21
2022-02-22,Contra Costa,013,1133247,186311,183812,12719,196531,1201
2022-02-22,Del Norte,015,27424,5623,5611,168,5779,45
2022-02-22,El Dorado,017,186661,26421,26289,3158,29447,189
2022-02-22,Fresno,019,978130,228176,225104,23205,248309,2592
2022-02-22,Glenn,021,27897,4927,4900,1583,6483,40
2022-02-22,Humboldt,023,135768,16559,16559,2860,19419,132
2022-02-22,Imperial,025,180216,54825,54227,10434,64661,864
2022-02-22,Inyo,027,18085,4039,4026,448,4474,54
2022-02-22,Kern,029,883053,190027,188237,45190,233427,2102
2022-02-22,Kings,031,150075,50770,50359,3457,53816,423
2022-02-22,Lake,033,64148,10459,10353,860,11213,126
2022-02-22,Lassen,035,31185,8807,8730,868,9598,55
2022-02-22,Los Angeles,037,10098052,2684187,2658230,121598,2779828,30129
2022-02-22,Madera,039,155013,36845,36833,5919,42752,330
2022-02-22,Marin,041,260295,32731,32591,2145,34736,267
2022-02-22,Mariposa,043,17540,2337,2322,190,2512,6
2022-02-22,Mendocino,045,87422,12838,12714,2919,15633,110
2022-02-22,Merced,047,269075,61429,61241,8397,69638,770
2022-02-22,Modoc,049,8938,722,720,248,968,6
2022-02-22,Mono,051,14174,2954,2961,118,3079,5
2022-02-22,Monterey,053,433212,78346,77359,13055,90414,690
2022-02-22,Napa,055,140530,25185,25151,917,26068,128
2022-02-22,Nevada,057,99092,15736,15815,1146,16961,121
2022-02-22,Orange,059,3164182,541191,539390,40435,579825,6502
2022-02-22,Placer,061,380077,61977,61709,7224,68933,572
2022-02-22,Plumas,063,18699,2930,2659,355,3014,13
2022-02-22,Riverside,065,2383286,586680,583969,27366,611335,6097
2022-02-22,Sacramento,067,1510023,277325,271789,26015,297804,2775
2022-02-22,San Benito,069,59416,12741,12742,501,13243,92
2022-02-22,San Bernardino,071,2135413,565825,554903,24391,579294,6451
2022-02-22,San Diego,073,3302833,741208,734536,51571,786107,4974
2022-02-22,San Francisco,075,870044,121154,121954,8012,129966,769
2022-02-22,San Joaquin,077,732212,164611,164111,9710,173821,2040
2022-02-22,San Luis Obispo,079,281455,51519,51193,3635,54828,431
2022-02-22,San Mateo,081,765935,119193,117418,6732,124150,603
2022-02-22,Santa Barbara,083,443738,84694,84701,4620,89321,650
2022-02-22,Santa Clara,085,1922200,304642,305045,12008,317053,2155
2022-02-22,Santa Cruz,087,273765,46493,45958,2046,48004,251
2022-02-22,Shasta,089,179085,30106,30024,5984,36008,479
2022-02-22,Sierra,091,2930,270,269,46,315,0
2022-02-22,Siskiyou,093,43540,4383,4350,2663,7013,70
2022-02-22,Solano,095,438530,80061,79968,5446,85414,425
2022-02-22,Sonoma,097,501317,82058,81412,2472,83884,431
2022-02-22,Stanislaus,099,539301,116258,116676,17319,133995,1475
2022-02-22,Sutter,101,95872,20199,20164,1966,22130,210
2022-02-22,Tehama,103,63373,11900,11852,2564,14416,152
2022-02-22,Trinity,105,12862,1171,1147,283,1430,20
2022-02-22,Tulare,107,460477,105260,102717,27122,129839,1287
2022-02-22,Tuolumne,109,53932,12484,12136,539,12675,175
2022-02-22,Ventura,111,848112,171374,171064,9265,180329,1401
2022-02-22,Yolo,113,214977,36356,35527,2941,38468,292
2022-02-22,Yuba,115,75493,15611,15550,1156,16706,110
2022-02-21,Alameda,001,1643700,250907,247434,13255,260689,1704
2022-02-21,Alpine,003,1148,122,124,1,125,0
2022-02-21,Amador,005,37829,8323,8246,628,8874,79
2022-02-21,Butte,007,227075,32594,32356,6779,39135,366
2022-02-21,Calaveras,009,45235,7149,7175,336,7511,107
2022-02-21,Colusa,011,21464,3409,3401,1037,4438,21
2022-02-21,Contra Costa,013,1133247,186085,183701,12705,196406,1201
2022-02-21,Del Norte,015,27424,5605,5601,167,5768,45
2022-02-21,El Dorado,017,186661,26393,26273,3153,29426,189
2022-02-21,Fresno,019,978130,227863,224923,23149,248072,2592
2022-02-21,Glenn,021,27897,4922,4897,1583,6480,40
2022-02-21,Humboldt,023,135768,16515,16548,2852,19400,132
2022-02-21,Imperial,025,180216,54765,54208,10421,64629,864
2022-02-21,Inyo,027,18085,4036,4023,448,4471,54
2022-02-21,Kern,029,883053,189834,188188,45138,233326,2102
2022-02-21,Kings,031,150075,50704,50188,3454,53642,422
2022-02-21,Lake,033,64148,10437,10334,858,11192,126
2022-02-21,Lassen,035,31185,8799,8705,863,9568,55
2022-02-21,Los Angeles,037,10098052,2682407,2656873,121502,2778375,30108
2022-02-21,Madera,039,155013,36807,36796,5898,42694,330
2022-02-21,Marin,041,260295,32708,32570,2145,34715,258
2022-02-21,Mariposa,043,17540,2334,2321,190,2511,6
2022-02-21,Mendocino,045,87422,12812,12706,2907,15613,110
2022-02-21,Merced,047,269075,61372,61209,8380,69589,770
2022-02-21,Modoc,049,8938,721,718,248,966,6
2022-02-21,Mono,051,14174,2953,2960,118,3078,5
2022-02-21,Monterey,053,433212,78252,77354,13014,90368,690
2022-02-21,Napa,055,140530,25146,25126,917,26043,128
2022-02-21,Nevada,057,99092,15725,15810,1143,16953,121
2022-02-21,Orange,059,3164182,540839,539068,40410,579478,6502
2022-02-21,Placer,061,380077,61923,61727,7220,68947,572
2022-02-21,Plumas,063,18699,2926,2657,350,3007,13
2022-02-21,Riverside,065,2383286,586313,583712,27319,611031,6097
2022-02-21,Sacramento,067,1510023,277070,271588,25982,297570,2769
2022-02-21,San Benito,069,59416,12728,12731,501,13232,92
2022-02-21,San Bernardino,071,2135413,565587,554662,24370,579032,6441
2022-02-21,San Diego,073,3302833,740591,732298,51493,783791,4974
2022-02-21,San Francisco,075,870044,120973,121865,8008,129873,769
2022-02-21,San Joaquin,077,732212,164467,164036,9699,173735,2040
2022-02-21,San Luis Obispo,079,281455,51428,51184,3628,54812,429
2022-02-21,San Mateo,081,765935,119100,117259,6724,123983,605
2022-02-21,Santa Barbara,083,443738,84617,84626,4612,89238,650
2022-02-21,Santa Clara,085,1922200,304314,304858,12002,316860,2158
2022-02-21,Santa Cruz,087,273765,46367,45941,2045,47986,251
2022-02-21,Shasta,089,179085,30060,30004,5976,35980,479
2022-02-21,Sierra,091,2930,270,269,46,315,0
2022-02-21,Siskiyou,093,43540,4371,4337,2658,6995,70
2022-02-21,Solano,095,438530,79968,79906,5441,85347,425
2022-02-21,Sonoma,097,501317,81944,81361,2466,83827,431
2022-02-21,Stanislaus,099,539301,116146,116597,17295,133892,1475
2022-02-21,Sutter,101,95872,20174,20152,1964,22116,210
2022-02-21,Tehama,103,63373,11887,11842,2563,14405,152
2022-02-21,Trinity,105,12862,1170,1147,283,1430,20
2022-02-21,Tulare,107,460477,105164,102614,27078,129692,1287
2022-02-21,Tuolumne,109,53932,12473,12126,536,12662,175
2022-02-21,Ventura,111,848112,171235,170939,9256,180195,1401
2022-02-21,Yolo,113,214977,36313,35518,2932,38450,292
2022-02-21,Yuba,115,75493,15592,15546,1147,16693,110
2022-02-20,Alameda,001,1643700,250677,246028,13247,259275,1700
2022-02-20,Alpine,003,1148,122,124,1,125,0
2022-02-20,Amador,005,37829,8312,8203,628,8831,79
2022-02-20,Butte,007,227075,32565,32173,6774,38947,364
2022-02-20,Calaveras,009,45235,7146,7136,335,7471,107
2022-02-20,Colusa,011,21464,3406,3389,1036,4425,21
2022-02-20,Contra Costa,013,1133247,185957,182797,12700,195497,1190
2022-02-20,Del Norte,015,27424,5590,5511,167,5678,45
2022-02-20,El Dorado,017,186661,26372,26101,3152,29253,189
2022-02-20,Fresno,019,978130,227672,223594,23134,246728,2544
2022-02-20,Glenn,021,27897,4919,4881,1583,6464,39
2022-02-20,Humboldt,023,135768,16503,16393,2848,19241,132
2022-02-20,Imperial,025,180216,54700,53967,10411,64378,862
2022-02-20,Inyo,027,18085,4036,4018,447,4465,52
2022-02-20,Kern,029,883053,189699,187158,45094,232252,2095
2022-02-20,Kings,031,150075,50676,49724,3451,53175,421
2022-02-20,Lake,033,64148,10404,10184,857,11041,126
2022-02-20,Lassen,035,31185,8787,8640,863,9503,55
2022-02-20,Los Angeles,037,10098052,2681084,2642878,121417,2764295,29842
2022-02-20,Madera,039,155013,36776,36526,5894,42420,330
2022-02-20,Marin,041,260295,32691,32441,2145,34586,258
2022-02-20,Mariposa,043,17540,2328,2310,188,2498,6
2022-02-20,Mendocino,045,87422,12802,12625,2904,15529,110
2022-02-20,Merced,047,269075,61344,60886,8379,69265,769
2022-02-20,Modoc,049,8938,720,714,248,962,6
2022-02-20,Mono,051,14174,2953,2956,118,3074,5
2022-02-20,Monterey,053,433212,78192,76765,13001,89766,682
2022-02-20,Napa,055,140530,25124,24970,915,25885,127
2022-02-20,Nevada,057,99092,15714,15715,1142,16857,121
2022-02-20,Orange,059,3164182,540520,538019,40374,578393,6416
2022-02-20,Placer,061,380077,61891,61417,7212,68629,560
2022-02-20,Plumas,063,18699,2922,2646,348,2994,13
2022-02-20,Riverside,065,2383286,586046,581788,27293,609081,6087
2022-02-20,Sacramento,067,1510023,276890,270080,25958,296038,2747
2022-02-20,San Benito,069,59416,12725,12665,501,13166,92
2022-02-20,San Bernardino,071,2135413,565378,553151,24353,577504,6400
2022-02-20,San Diego,073,3302833,740020,729549,51430,780979,4947
2022-02-20,San Francisco,075,870044,120833,121197,7998,129195,756
2022-02-20,San Joaquin,077,732212,164348,163083,9688,172771,2033
2022-02-20,San Luis Obispo,079,281455,51399,50823,3624,54447,424
2022-02-20,San Mateo,081,765935,119026,116648,6717,123365,598
2022-02-20,Santa Barbara,083,443738,84573,83988,4610,88598,642
2022-02-20,Santa Clara,085,1922200,304034,303077,11994,315071,2138
2022-02-20,Santa Cruz,087,273765,46301,45532,2042,47574,250
2022-02-20,Shasta,089,179085,30030,29847,5969,35816,479
2022-02-20,Sierra,091,2930,270,269,46,315,0
2022-02-20,Siskiyou,093,43540,4366,4307,2657,6964,70
2022-02-20,Solano,095,438530,79893,78914,5437,84351,424
2022-02-20,Sonoma,097,501317,81869,80843,2463,83306,431
2022-02-20,Stanislaus,099,539301,116080,115976,17278,133254,1454
2022-02-20,Sutter,101,95872,20162,20060,1961,22021,210
2022-02-20,Tehama,103,63373,11875,11760,2560,14320,152
2022-02-20,Trinity,105,12862,1169,1130,283,1413,20
2022-02-20,Tulare,107,460477,105077,101996,27052,129048,1286
2022-02-20,Tuolumne,109,53932,12452,12036,536,12572,175
2022-02-20,Ventura,111,848112,171139,170331,9249,179580,1384
2022-02-20,Yolo,113,214977,36287,35363,2929,38292,293
2022-02-20,Yuba,115,75493,15577,15449,1146,16595,112
2022-02-19,Alameda,001,1643700,250502,246028,13243,259271,1700
2022-02-19,Alpine,003,1148,122,124,1,125,0
2022-02-19,Amador,005,37829,8308,8203,628,8831,79
2022-02-19,Butte,007,227075,32541,32173,6771,38944,364
2022-02-19,Calaveras,009,45235,7146,7136,335,7471,107
2022-02-19,Colusa,011,21464,3405,3389,1034,4423,21
2022-02-19,Contra Costa,013,1133247,185860,182797,12699,195496,1190
2022-02-19,Del Norte,015,27424,5580,5511,167,5678,45
2022-02-19,El Dorado,017,186661,26354,26101,3150,29251,189
2022-02-19,Fresno,019,978130,227556,223594,23126,246720,2544
2022-02-19,Glenn,021,27897,4915,4881,1583,6464,39
2022-02-19,Humboldt,023,135768,16488,16393,2848,19241,132
2022-02-19,Imperial,025,180216,54684,53967,10406,64373,862
2022-02-19,Inyo,027,18085,4035,4018,446,4464,52
2022-02-19,Kern,029,883053,189596,187158,45070,232228,2095
2022-02-19,Kings,031,150075,50653,49724,3450,53174,421
2022-02-19,Lake,033,64148,10395,10184,857,11041,126
2022-02-19,Lassen,035,31185,8775,8640,862,9502,55
2022-02-19,Los Angeles,037,10098052,2680292,2642878,121376,2764254,29842
2022-02-19,Madera,039,155013,36754,36526,5892,42418,330
2022-02-19,Marin,041,260295,32668,32441,2144,34585,258
2022-02-19,Mariposa,043,17540,2325,2310,188,2498,6
2022-02-19,Mendocino,045,87422,12792,12625,2904,15529,110
2022-02-19,Merced,047,269075,61299,60886,8375,69261,769
2022-02-19,Modoc,049,8938,720,714,247,961,6
2022-02-19,Mono,051,14174,2952,2956,118,3074,5
2022-02-19,Monterey,053,433212,78103,76765,12990,89755,682
2022-02-19,Napa,055,140530,25114,24970,915,25885,127
2022-02-19,Nevada,057,99092,15706,15715,1142,16857,121
2022-02-19,Orange,059,3164182,540318,538019,40349,578368,6416
2022-02-19,Placer,061,380077,61844,61417,7212,68629,560
2022-02-19,Plumas,063,18699,2921,2646,348,2994,13
2022-02-19,Riverside,065,2383286,585863,581788,27281,609069,6087
2022-02-19,Sacramento,067,1510023,276747,270080,25947,296027,2747
2022-02-19,San Benito,069,59416,12712,12665,500,13165,92
2022-02-19,San Bernardino,071,2135413,565215,553151,24346,577497,6400
2022-02-19,San Diego,073,3302833,739675,729549,51383,780932,4947
2022-02-19,San Francisco,075,870044,120747,121197,7994,129191,756
2022-02-19,San Joaquin,077,732212,164274,163083,9677,172760,2033
2022-02-19,San Luis Obispo,079,281455,51386,50823,3620,54443,424
2022-02-19,San Mateo,081,765935,118985,116648,6716,123364,598
2022-02-19,Santa Barbara,083,443738,84506,83988,4609,88597,642
2022-02-19,Santa Clara,085,1922200,303840,303077,11992,315069,2138
2022-02-19,Santa Cruz,087,273765,46263,45532,2040,47572,250
2022-02-19,Shasta,089,179085,30016,29847,5966,35813,479
2022-02-19,Sierra,091,2930,270,269,46,315,0
2022-02-19,Siskiyou,093,43540,4363,4307,2657,6964,70
2022-02-19,Solano,095,438530,79851,78914,5436,84350,424
2022-02-19,Sonoma,097,501317,81827,80843,2463,83306,431
2022-02-19,Stanislaus,099,539301,116009,115976,17272,133248,1454
2022-02-19,Sutter,101,95872,20154,20060,1961,22021,210
2022-02-19,Tehama,103,63373,11868,11760,2560,14320,152
2022-02-19,Trinity,105,12862,1167,1130,283,1413,20
2022-02-19,Tulare,107,460477,105030,101996,27027,129023,1286
2022-02-19,Tuolumne,109,53932,12443,12036,536,12572,175
2022-02-19,Ventura,111,848112,171064,170331,9245,179576,1384
2022-02-19,Yolo,113,214977,36256,35363,2925,38288,293
2022-02-19,Yuba,115,75493,15568,15449,1146,16595,112
2022-02-18,Alameda,001,1643700,250335,246028,13235,259263,1700
2022-02-18,Alpine,003,1148,121,124,1,125,0
2022-02-18,Amador,005,37829,8301,8203,626,8829,79
2022-02-18,Butte,007,227075,32520,32173,6765,38938,364
2022-02-18,Calaveras,009,45235,7141,7136,334,7470,107
2022-02-18,Colusa,011,21464,3403,3389,1034,4423,21
2022-02-18,Contra Costa,013,1133247,185753,182797,12693,195490,1190
2022-02-18,Del Norte,015,27424,5569,5511,167,5678,45
2022-02-18,El Dorado,017,186661,26343,26101,3150,29251,189
2022-02-18,Fresno,019,978130,227368,223594,23115,246709,2544
2022-02-18,Glenn,021,27897,4914,4881,1582,6463,39
2022-02-18,Humboldt,023,135768,16471,16393,2843,19236,132
2022-02-18,Imperial,025,180216,54658,53967,10395,64362,862
2022-02-18,Inyo,027,18085,4033,4018,446,4464,52
2022-02-18,Kern,029,883053,189484,187158,45025,232183,2095
2022-02-18,Kings,031,150075,50566,49724,3450,53174,421
2022-02-18,Lake,033,64148,10377,10184,855,11039,126
2022-02-18,Lassen,035,31185,8755,8640,861,9501,55
2022-02-18,Los Angeles,037,10098052,2679307,2642878,121321,2764199,29842
2022-02-18,Madera,039,155013,36731,36526,5890,42416,330
2022-02-18,Marin,041,260295,32650,32441,2142,34583,258
2022-02-18,Mariposa,043,17540,2323,2310,188,2498,6
2022-02-18,Mendocino,045,87422,12782,12625,2904,15529,110
2022-02-18,Merced,047,269075,61256,60886,8365,69251,769
2022-02-18,Modoc,049,8938,720,714,247,961,6
2022-02-18,Mono,051,14174,2952,2956,118,3074,5
2022-02-18,Monterey,053,433212,78030,76765,12982,89747,682
2022-02-18,Napa,055,140530,25096,24970,915,25885,127
2022-02-18,Nevada,057,99092,15698,15715,1142,16857,121
2022-02-18,Orange,059,3164182,540082,538019,40310,578329,6416
2022-02-18,Placer,061,380077,61815,61417,7205,68622,560
2022-02-18,Plumas,063,18699,2918,2646,348,2994,13
2022-02-18,Riverside,065,2383286,585683,581788,27273,609061,6087
2022-02-18,Sacramento,067,1510023,276555,270080,25939,296019,2747
2022-02-18,San Benito,069,59416,12704,12665,500,13165,92
2022-02-18,San Bernardino,071,2135413,565037,553151,24341,577492,6400
2022-02-18,San Diego,073,3302833,739251,729549,51358,780907,4947
2022-02-18,San Francisco,075,870044,120659,121197,7986,129183,756
2022-02-18,San Joaquin,077,732212,164204,163083,9670,172753,2033
2022-02-18,San Luis Obispo,079,281455,51370,50823,3617,54440,424
2022-02-18,San Mateo,081,765935,118920,116648,6713,123361,598
2022-02-18,Santa Barbara,083,443738,84466,83988,4607,88595,642
2022-02-18,Santa Clara,085,1922200,303604,303077,11991,315068,2138
2022-02-18,Santa Cruz,087,273765,46229,45532,2039,47571,250
2022-02-18,Shasta,089,179085,30003,29847,5965,35812,479
2022-02-18,Sierra,091,2930,270,269,46,315,0
2022-02-18,Siskiyou,093,43540,4360,4307,2655,6962,70
2022-02-18,Solano,095,438530,79781,78914,5435,84349,424
2022-02-18,Sonoma,097,501317,81771,80843,2462,83305,431
2022-02-18,Stanislaus,099,539301,115959,115976,17258,133234,1454
2022-02-18,Sutter,101,95872,20142,20060,1961,22021,210
2022-02-18,Tehama,103,63373,11857,11760,2560,14320,152
2022-02-18,Trinity,105,12862,1166,1130,282,1412,20
2022-02-18,Tulare,107,460477,104979,101996,26986,128982,1286
2022-02-18,Tuolumne,109,53932,12437,12036,535,12571,175
2022-02-18,Ventura,111,848112,170974,170331,9240,179571,1384
2022-02-18,Yolo,113,214977,36228,35363,2923,38286,293
2022-02-18,Yuba,115,75493,15553,15449,1146,16595,112
2022-02-17,Alameda,001,1643700,250072,246028,13215,259243,1700
2022-02-17,Alpine,003,1148,121,124,1,125,0
2022-02-17,Amador,005,37829,8297,8203,624,8827,79
2022-02-17,Butte,007,227075,32482,32173,6761,38934,364
2022-02-17,Calaveras,009,45235,7132,7136,331,7467,107
2022-02-17,Colusa,011,21464,3400,3389,1034,4423,21
2022-02-17,Contra Costa,013,1133247,185558,182797,12661,195458,1190
2022-02-17,Del Norte,015,27424,5548,5511,167,5678,45
2022-02-17,El Dorado,017,186661,26317,26101,3140,29241,189
2022-02-17,Fresno,019,978130,227075,223594,23085,246679,2544
2022-02-17,Glenn,021,27897,4912,4881,1579,6460,39
2022-02-17,Humboldt,023,135768,16431,16393,2842,19235,132
2022-02-17,Imperial,025,180216,54587,53967,10379,64346,862
2022-02-17,Inyo,027,18085,4031,4018,445,4463,52
2022-02-17,Kern,029,883053,189330,187158,44976,232134,2095
2022-02-17,Kings,031,150075,50502,49724,3445,53169,421
2022-02-17,Lake,033,64148,10347,10184,851,11035,126
2022-02-17,Lassen,035,31185,8745,8640,859,9499,55
2022-02-17,Los Angeles,037,10098052,2677468,2642878,121240,2764118,29842
2022-02-17,Madera,039,155013,36688,36526,5883,42409,330
2022-02-17,Marin,041,260295,32624,32441,2141,34582,258
2022-02-17,Mariposa,043,17540,2321,2310,187,2497,6
2022-02-17,Mendocino,045,87422,12765,12625,2901,15526,110
2022-02-17,Merced,047,269075,61181,60886,8349,69235,769
2022-02-17,Modoc,049,8938,719,714,247,961,6
2022-02-17,Mono,051,14174,2950,2956,118,3074,5
2022-02-17,Monterey,053,433212,77918,76765,12940,89705,682
2022-02-17,Napa,055,140530,25064,24970,913,25883,127
2022-02-17,Nevada,057,99092,15686,15715,1141,16856,121
2022-02-17,Orange,059,3164182,539743,538019,40283,578302,6416
2022-02-17,Placer,061,380077,61773,61417,7197,68614,560
2022-02-17,Plumas,063,18699,2915,2646,348,2994,13
2022-02-17,Riverside,065,2383286,585306,581788,27246,609034,6087
2022-02-17,Sacramento,067,1510023,276270,270080,25891,295971,2747
2022-02-17,San Benito,069,59416,12693,12665,500,13165,92
2022-02-17,San Bernardino,071,2135413,564736,553151,24327,577478,6400
2022-02-17,San Diego,073,3302833,738655,729549,51307,780856,4947
2022-02-17,San Francisco,075,870044,120525,121197,7976,129173,756
2022-02-17,San Joaquin,077,732212,164040,163083,9656,172739,2033
2022-02-17,San Luis Obispo,079,281455,51265,50823,3609,54432,424
2022-02-17,San Mateo,081,765935,118826,116648,6704,123352,598
2022-02-17,Santa Barbara,083,443738,84366,83988,4600,88588,642
2022-02-17,Santa Clara,085,1922200,303239,303077,11977,315054,2138
2022-02-17,Santa Cruz,087,273765,46148,45532,2037,47569,250
2022-02-17,Shasta,089,179085,29976,29847,5962,35809,479
2022-02-17,Sierra,091,2930,270,269,46,315,0
2022-02-17,Siskiyou,093,43540,4351,4307,2651,6958,70
2022-02-17,Solano,095,438530,79700,78914,5428,84342,424
2022-02-17,Sonoma,097,501317,81705,80843,2455,83298,431
2022-02-17,Stanislaus,099,539301,115856,115976,17241,133217,1454
2022-02-17,Sutter,101,95872,20127,20060,1953,22013,210
2022-02-17,Tehama,103,63373,11849,11760,2559,14319,152
2022-02-17,Trinity,105,12862,1164,1130,280,1410,20
2022-02-17,Tulare,107,460477,104866,101996,26962,128958,1286
2022-02-17,Tuolumne,109,53932,12426,12036,535,12571,175
2022-02-17,Ventura,111,848112,170834,170331,9239,179570,1384
2022-02-17,Yolo,113,214977,36190,35363,2922,38285,293
2022-02-17,Yuba,115,75493,15538,15449,1146,16595,112
2022-02-16,Alameda,001,1643700,249762,245662,13176,258838,1691
2022-02-16,Alpine,003,1148,121,124,1,125,0
2022-02-16,Amador,005,37829,8279,8197,623,8820,77
2022-02-16,Butte,007,227075,32439,32095,6748,38843,363
2022-02-16,Calaveras,009,45235,7128,7129,328,7457,107
2022-02-16,Colusa,011,21464,3395,3384,1034,4418,21
2022-02-16,Contra Costa,013,1133247,185323,182423,12625,195048,1179
2022-02-16,Del Norte,015,27424,5528,5473,164,5637,45
2022-02-16,El Dorado,017,186661,26290,26061,3136,29197,189
2022-02-16,Fresno,019,978130,226715,223056,23036,246092,2542
2022-02-16,Glenn,021,27897,4908,4873,1574,6447,39
2022-02-16,Humboldt,023,135768,16407,16342,2832,19174,132
2022-02-16,Imperial,025,180216,54509,53901,10351,64252,861
2022-02-16,Inyo,027,18085,4028,4013,444,4457,52
2022-02-16,Kern,029,883053,189113,186740,44891,231631,2084
2022-02-16,Kings,031,150075,50449,49575,3437,53012,420
2022-02-16,Lake,033,64148,10321,10145,851,10996,125
2022-02-16,Lassen,035,31185,8712,8618,859,9477,55
2022-02-16,Los Angeles,037,10098052,2675373,2640005,121131,2761136,29749
2022-02-16,Madera,039,155013,36620,36382,5869,42251,330
2022-02-16,Marin,041,260295,32588,32381,2139,34520,257
2022-02-16,Mariposa,043,17540,2319,2305,187,2492,6
2022-02-16,Mendocino,045,87422,12743,12605,2891,15496,108
2022-02-16,Merced,047,269075,61115,60776,8317,69093,767
2022-02-16,Modoc,049,8938,719,711,243,954,6
2022-02-16,Mono,051,14174,2948,2953,118,3071,5
2022-02-16,Monterey,053,433212,77771,76624,12899,89523,682
2022-02-16,Napa,055,140530,25025,24897,910,25807,128
2022-02-16,Nevada,057,99092,15669,15677,1137,16814,121
2022-02-16,Orange,059,3164182,539341,537934,40239,578173,6392
2022-02-16,Placer,061,380077,61730,61278,7185,68463,556
2022-02-16,Plumas,063,18699,2912,2644,346,2990,13
2022-02-16,Riverside,065,2383286,584907,580828,27200,608028,6064
2022-02-16,Sacramento,067,1510023,275945,269416,25835,295251,2736
2022-02-16,San Benito,069,59416,12666,12644,500,13144,92
2022-02-16,San Bernardino,071,2135413,564464,552353,24305,576658,6379
2022-02-16,San Diego,073,3302833,737895,728610,51232,779842,4931
2022-02-16,San Francisco,075,870044,120352,120987,7973,128960,756
2022-02-16,San Joaquin,077,732212,163873,162752,9646,172398,2032
2022-02-16,San Luis Obispo,079,281455,51193,50704,3597,54301,425
2022-02-16,San Mateo,081,765935,118708,116438,6686,123124,595
2022-02-16,Santa Barbara,083,443738,84290,83968,4588,88556,642
2022-02-16,Santa Clara,085,1922200,302852,302439,11944,314383,2130
2022-02-16,Santa Cruz,087,273765,46058,45274,2035,47309,250
2022-02-16,Shasta,089,179085,29938,29767,5950,35717,477
2022-02-16,Sierra,091,2930,269,269,46,315,0
2022-02-16,Siskiyou,093,43540,4344,4302,2645,6947,71
2022-02-16,Solano,095,438530,79585,78742,5422,84164,422
2022-02-16,Sonoma,097,501317,81577,80642,2445,83087,431
2022-02-16,Stanislaus,099,539301,115737,115751,17210,132961,1443
2022-02-16,Sutter,101,95872,20110,20020,1950,21970,210
2022-02-16,Tehama,103,63373,11832,11738,2557,14295,152
2022-02-16,Trinity,105,12862,1164,1130,279,1409,20
2022-02-16,Tulare,107,460477,104746,101817,26912,128729,1281
2022-02-16,Tuolumne,109,53932,12414,11991,534,12525,171
2022-02-16,Ventura,111,848112,170697,170117,9231,179348,1372
2022-02-16,Yolo,113,214977,36139,35284,2920,38204,292
2022-02-16,Yuba,115,75493,15516,15405,1143,16548,110
2022-02-15,Alameda,001,1643700,249410,245265,13148,258413,1683
2022-02-15,Alpine,003,1148,121,124,1,125,0
2022-02-15,Amador,005,37829,8269,8183,622,8805,77
2022-02-15,Butte,007,227075,32389,32011,6734,38745,361
2022-02-15,Calaveras,009,45235,7118,7115,328,7443,106
2022-02-15,Colusa,011,21464,3387,3374,1033,4407,21
2022-02-15,Contra Costa,013,1133247,185065,182041,12595,194636,1179
2022-02-15,Del Norte,015,27424,5500,5439,163,5602,45
2022-02-15,El Dorado,017,186661,26271,25988,3131,29119,189
2022-02-15,Fresno,019,978130,226339,222673,22977,245650,2543
2022-02-15,Glenn,021,27897,4899,4862,1573,6435,39
2022-02-15,Humboldt,023,135768,16363,16297,2817,19114,132
2022-02-15,Imperial,025,180216,54446,53813,10336,64149,860
2022-02-15,Inyo,027,18085,4027,4009,443,4452,52
2022-02-15,Kern,029,883053,188893,186324,44801,231125,2072
2022-02-15,Kings,031,150075,50356,49473,3428,52901,418
2022-02-15,Lake,033,64148,10289,10112,845,10957,123
2022-02-15,Lassen,035,31185,8698,8587,857,9444,55
2022-02-15,Los Angeles,037,10098052,2673115,2638266,120999,2759265,29691
2022-02-15,Madera,039,155013,36553,36260,5849,42109,330
2022-02-15,Marin,041,260295,32546,32355,2137,34492,255
2022-02-15,Mariposa,043,17540,2318,2302,187,2489,6
2022-02-15,Mendocino,045,87422,12726,12580,2872,15452,108
2022-02-15,Merced,047,269075,61032,60674,8286,68960,763
2022-02-15,Modoc,049,8938,717,710,240,950,6
2022-02-15,Mono,051,14174,2947,2952,118,3070,5
2022-02-15,Monterey,053,433212,77645,75530,12841,88371,682
2022-02-15,Napa,055,140530,24975,24832,903,25735,127
2022-02-15,Nevada,057,99092,15643,15643,1136,16779,121
2022-02-15,Orange,059,3164182,538883,537478,40197,577675,6374
2022-02-15,Placer,061,380077,61669,61170,7174,68344,554
2022-02-15,Plumas,063,18699,2908,2638,346,2984,13
2022-02-15,Riverside,065,2383286,584420,579940,27141,607081,6049
2022-02-15,Sacramento,067,1510023,275558,268950,25757,294707,2721
2022-02-15,San Benito,069,59416,12647,12616,500,13116,91
2022-02-15,San Bernardino,071,2135413,564102,551803,24285,576088,6372
2022-02-15,San Diego,073,3302833,736933,727486,51134,778620,4914
2022-02-15,San Francisco,075,870044,120181,120759,7962,128721,756
2022-02-15,San Joaquin,077,732212,163653,162518,9633,172151,2021
2022-02-15,San Luis Obispo,079,281455,51096,50534,3582,54116,419
2022-02-15,San Mateo,081,765935,118572,116253,6666,122919,595
2022-02-15,Santa Barbara,083,443738,84155,83734,4574,88308,640
2022-02-15,Santa Clara,085,1922200,302360,301831,11907,313738,2130
2022-02-15,Santa Cruz,087,273765,45954,45171,2030,47201,250
2022-02-15,Shasta,089,179085,29887,29684,5936,35620,477
2022-02-15,Sierra,091,2930,269,269,46,315,0
2022-02-15,Siskiyou,093,43540,4337,4288,2638,6926,70
2022-02-15,Solano,095,438530,79451,78626,5417,84043,426
2022-02-15,Sonoma,097,501317,81456,80433,2439,82872,431
2022-02-15,Stanislaus,099,539301,115596,115549,17179,132728,1429
2022-02-15,Sutter,101,95872,20082,19980,1945,21925,208
2022-02-15,Tehama,103,63373,11814,11717,2555,14272,151
2022-02-15,Trinity,105,12862,1158,1125,276,1401,20
2022-02-15,Tulare,107,460477,104593,101645,26857,128502,1278
2022-02-15,Tuolumne,109,53932,12395,11945,532,12477,171
2022-02-15,Ventura,111,848112,170523,169942,9224,179166,1372
2022-02-15,Yolo,113,214977,36088,35241,2912,38153,289
2022-02-15,Yuba,115,75493,15488,15372,1138,16510,109
2022-02-14,Alameda,001,1643700,248975,244315,13116,257431,1677
2022-02-14,Alpine,003,1148,121,125,1,126,0
2022-02-14,Amador,005,37829,8254,8164,619,8783,77
2022-02-14,Butte,007,227075,32332,31946,6719,38665,360
2022-02-14,Calaveras,009,45235,7105,7097,326,7423,106
2022-02-14,Colusa,011,21464,3384,3367,1029,4396,21
2022-02-14,Contra Costa,013,1133247,184782,181753,12557,194310,1167
2022-02-14,Del Norte,015,27424,5477,5426,162,5588,45
2022-02-14,El Dorado,017,186661,26236,25915,3122,29037,188
2022-02-14,Fresno,019,978130,225859,222360,22889,245249,2538
2022-02-14,Glenn,021,27897,4893,4854,1573,6427,39
2022-02-14,Humboldt,023,135768,16323,16264,2792,19056,132
2022-02-14,Imperial,025,180216,54375,53765,10310,64075,860
2022-02-14,Inyo,027,18085,4026,4010,442,4452,52
2022-02-14,Kern,029,883053,188549,186037,44693,230730,2063
2022-02-14,Kings,031,150075,50250,49395,3419,52814,419
2022-02-14,Lake,033,64148,10252,10090,842,10932,123
2022-02-14,Lassen,035,31185,8688,8539,855,9394,55
2022-02-14,Los Angeles,037,10098052,2670533,2636064,120871,2756935,29650
2022-02-14,Madera,039,155013,36488,36194,5826,42020,330
2022-02-14,Marin,041,260295,32510,32304,2134,34438,255
2022-02-14,Mariposa,043,17540,2311,2295,187,2482,6
2022-02-14,Mendocino,045,87422,12699,12541,2840,15381,108
2022-02-14,Merced,047,269075,60943,60591,8244,68835,758
2022-02-14,Modoc,049,8938,712,707,240,947,6
2022-02-14,Mono,051,14174,2946,2954,118,3072,5
2022-02-14,Monterey,053,433212,77474,75407,12761,88168,678
2022-02-14,Napa,055,140530,24916,24776,903,25679,127
2022-02-14,Nevada,057,99092,15624,15629,1135,16764,121
2022-02-14,Orange,059,3164182,538378,536924,40132,577056,6355
2022-02-14,Placer,061,380077,61599,61123,7159,68282,554
2022-02-14,Plumas,063,18699,2906,2631,346,2977,13
2022-02-14,Riverside,065,2383286,583873,579174,27073,606247,5994
2022-02-14,Sacramento,067,1510023,275119,268547,25646,294193,2717
2022-02-14,San Benito,069,59416,12623,12598,499,13097,91
2022-02-14,San Bernardino,071,2135413,563687,551338,24265,575603,6372
2022-02-14,San Diego,073,3302833,735965,723902,51036,774938,4894
2022-02-14,San Francisco,075,870044,119990,120581,7952,128533,756
2022-02-14,San Joaquin,077,732212,163413,162363,9610,171973,2018
2022-02-14,San Luis Obispo,079,281455,50988,50465,3572,54037,416
2022-02-14,San Mateo,081,765935,118408,116129,6658,122787,592
2022-02-14,Santa Barbara,083,443738,84009,83697,4564,88261,636
2022-02-14,Santa Clara,085,1922200,301826,301319,11883,313202,2127
2022-02-14,Santa Cruz,087,273765,45791,45042,2026,47068,250
2022-02-14,Shasta,089,179085,29801,29595,5919,35514,474
2022-02-14,Sierra,091,2930,269,269,46,315,0
2022-02-14,Siskiyou,093,43540,4324,4278,2624,6902,69
2022-02-14,Solano,095,438530,79272,78533,5405,83938,427
2022-02-14,Sonoma,097,501317,81315,80336,2428,82764,431
2022-02-14,Stanislaus,099,539301,115419,115426,17138,132564,1406
2022-02-14,Sutter,101,95872,20054,19957,1939,21896,209
2022-02-14,Tehama,103,63373,11791,11686,2554,14240,151
2022-02-14,Trinity,105,12862,1155,1123,276,1399,20
2022-02-14,Tulare,107,460477,104386,101448,26762,128210,1276
2022-02-14,Tuolumne,109,53932,12366,11920,529,12449,170
2022-02-14,Ventura,111,848112,170346,169725,9212,178937,1361
2022-02-14,Yolo,113,214977,36029,35112,2902,38014,286
2022-02-14,Yuba,115,75493,15458,15375,1134,16509,108
2022-02-13,Alameda,001,1643700,248485,243681,13081,256762,1677
2022-02-13,Alpine,003,1148,121,125,1,126,0
2022-02-13,Amador,005,37829,8225,8146,616,8762,77
2022-02-13,Butte,007,227075,32259,31865,6697,38562,360
2022-02-13,Calaveras,009,45235,7098,7083,323,7406,106
2022-02-13,Colusa,011,21464,3381,3366,1027,4393,21
2022-02-13,Contra Costa,013,1133247,184416,181313,12493,193806,1159
2022-02-13,Del Norte,015,27424,5444,5379,162,5541,45
2022-02-13,El Dorado,017,186661,26199,25871,3114,28985,188
2022-02-13,Fresno,019,978130,225319,221686,22827,244513,2537
2022-02-13,Glenn,021,27897,4883,4847,1570,6417,39
2022-02-13,Humboldt,023,135768,16276,16210,2764,18974,132
2022-02-13,Imperial,025,180216,54277,53658,10275,63933,860
2022-02-13,Inyo,027,18085,4023,4006,440,4446,52
2022-02-13,Kern,029,883053,188297,185640,44608,230248,2063
2022-02-13,Kings,031,150075,50123,49243,3408,52651,416
2022-02-13,Lake,033,64148,10189,10042,835,10877,123
2022-02-13,Lassen,035,31185,8663,8503,853,9356,55
2022-02-13,Los Angeles,037,10098052,2667360,2631267,120732,2751999,29595
2022-02-13,Madera,039,155013,36370,36054,5798,41852,330
2022-02-13,Marin,041,260295,32439,32222,2127,34349,255
2022-02-13,Mariposa,043,17540,2305,2292,185,2477,6
2022-02-13,Mendocino,045,87422,12670,12521,2801,15322,108
2022-02-13,Merced,047,269075,60801,60460,8191,68651,758
2022-02-13,Modoc,049,8938,710,704,233,937,6
2022-02-13,Mono,051,14174,2945,2949,118,3067,5
2022-02-13,Monterey,053,433212,77267,75295,12687,87982,678
2022-02-13,Napa,055,140530,24839,24743,900,25643,127
2022-02-13,Nevada,057,99092,15590,15590,1128,16718,121
2022-02-13,Orange,059,3164182,537750,536134,40070,576204,6355
2022-02-13,Placer,061,380077,61522,61020,7138,68158,554
2022-02-13,Plumas,063,18699,2898,2626,343,2969,13
2022-02-13,Riverside,065,2383286,583282,578363,27032,605395,5995
2022-02-13,Sacramento,067,1510023,274609,267947,25517,293464,2699
2022-02-13,San Benito,069,59416,12590,12578,498,13076,91
2022-02-13,San Bernardino,071,2135413,563199,550632,24232,574864,6367
2022-02-13,San Diego,073,3302833,734826,723902,50917,774819,4894
2022-02-13,San Francisco,075,870044,119738,120295,7940,128235,756
2022-02-13,San Joaquin,077,732212,163106,162028,9582,171610,2018
2022-02-13,San Luis Obispo,079,281455,50843,50384,3564,53948,415
2022-02-13,San Mateo,081,765935,118187,115876,6633,122509,592
2022-02-13,Santa Barbara,083,443738,83845,83547,4557,88104,635
2022-02-13,Santa Clara,085,1922200,301186,300412,11846,312258,2114
2022-02-13,Santa Cruz,087,273765,45636,44887,2024,46911,240
2022-02-13,Shasta,089,179085,29722,29531,5896,35427,474
2022-02-13,Sierra,091,2930,269,269,46,315,0
2022-02-13,Siskiyou,093,43540,4317,4264,2608,6872,69
2022-02-13,Solano,095,438530,79116,78424,5381,83805,426
2022-02-13,Sonoma,097,501317,81149,80172,2416,82588,431
2022-02-13,Stanislaus,099,539301,115223,115156,17098,132254,1406
2022-02-13,Sutter,101,95872,20015,19900,1939,21839,209
2022-02-13,Tehama,103,63373,11765,11644,2551,14195,151
2022-02-13,Trinity,105,12862,1152,1120,273,1393,20
2022-02-13,Tulare,107,460477,104170,101135,26674,127809,1276
2022-02-13,Tuolumne,109,53932,12341,11891,524,12415,170
2022-02-13,Ventura,111,848112,170152,169422,9192,178614,1361
2022-02-13,Yolo,113,214977,35962,35057,2890,37947,286
2022-02-13,Yuba,115,75493,15424,15346,1133,16479,107
2022-02-12,Alameda,001,1643700,248263,242137,13067,255204,1668
2022-02-12,Alpine,003,1148,121,124,1,125,0
2022-02-12,Amador,005,37829,8219,8091,616,8707,76
2022-02-12,Butte,007,227075,32232,31601,6691,38292,360
2022-02-12,Calaveras,009,45235,7095,7022,322,7344,106
2022-02-12,Colusa,011,21464,3378,3345,1027,4372,21
2022-02-12,Contra Costa,013,1133247,184225,180270,12486,192756,1141
2022-02-12,Del Norte,015,27424,5425,5262,162,5424,45
2022-02-12,El Dorado,017,186661,26183,25692,3114,28806,188
2022-02-12,Fresno,019,978130,225106,219909,22812,242721,2509
2022-02-12,Glenn,021,27897,4882,4818,1569,6387,39
2022-02-12,Humboldt,023,135768,16252,16058,2761,18819,132
2022-02-12,Imperial,025,180216,54233,53304,10265,63569,860
2022-02-12,Inyo,027,18085,4021,3991,440,4431,52
2022-02-12,Kern,029,883053,188186,184639,44571,229210,2037
2022-02-12,Kings,031,150075,50083,48893,3401,52294,415
2022-02-12,Lake,033,64148,10168,9926,831,10757,123
2022-02-12,Lassen,035,31185,8640,8477,852,9329,55
2022-02-12,Los Angeles,037,10098052,2666200,2616426,120659,2737085,29364
2022-02-12,Madera,039,155013,36336,35710,5791,41501,330
2022-02-12,Marin,041,260295,32407,32048,2124,34172,255
2022-02-12,Mariposa,043,17540,2305,2286,185,2471,6
2022-02-12,Mendocino,045,87422,12654,12439,2801,15240,107
2022-02-12,Merced,047,269075,60747,60187,8186,68373,758
2022-02-12,Modoc,049,8938,710,697,233,930,6
2022-02-12,Mono,051,14174,2944,2939,118,3057,5
2022-02-12,Monterey,053,433212,77206,74842,12665,87507,672
2022-02-12,Napa,055,140530,24811,24530,900,25430,124
2022-02-12,Nevada,057,99092,15577,15499,1127,16626,119
2022-02-12,Orange,059,3164182,537461,534503,40034,574537,6305
2022-02-12,Placer,061,380077,61465,60636,7135,67771,554
2022-02-12,Plumas,063,18699,2897,2617,342,2959,13
2022-02-12,Riverside,065,2383286,582920,575566,27009,602575,5961
2022-02-12,Sacramento,067,1510023,274373,266347,25508,291855,2686
2022-02-12,San Benito,069,59416,12578,12526,498,13024,91
2022-02-12,San Bernardino,071,2135413,562966,548822,24220,573042,6360
2022-02-12,San Diego,073,3302833,734326,720287,50868,771155,4854
2022-02-12,San Francisco,075,870044,119616,119113,7929,127042,740
2022-02-12,San Joaquin,077,732212,162975,161234,9576,170810,2014
2022-02-12,San Luis Obispo,079,281455,50807,50064,3561,53625,416
2022-02-12,San Mateo,081,765935,118099,115235,6626,121861,589
2022-02-12,Santa Barbara,083,443738,83759,83390,4550,87940,631
2022-02-12,Santa Clara,085,1922200,300847,298176,11838,310014,2093
2022-02-12,Santa Cruz,087,273765,45600,44447,2022,46469,239
2022-02-12,Shasta,089,179085,29693,29370,5892,35262,473
2022-02-12,Sierra,091,2930,269,268,46,314,0
2022-02-12,Siskiyou,093,43540,4310,4231,2605,6836,68
2022-02-12,Solano,095,438530,79074,77865,5376,83241,424
2022-02-12,Sonoma,097,501317,81045,79533,2414,81947,431
2022-02-12,Stanislaus,099,539301,115098,114531,17086,131617,1406
2022-02-12,Sutter,101,95872,20000,19800,1939,21739,211
2022-02-12,Tehama,103,63373,11750,11580,2551,14131,151
2022-02-12,Trinity,105,12862,1151,1115,273,1388,20
2022-02-12,Tulare,107,460477,104074,100434,26637,127071,1273
2022-02-12,Tuolumne,109,53932,12323,11754,524,12278,125
2022-02-12,Ventura,111,848112,170044,168736,9187,177923,1340
2022-02-12,Yolo,113,214977,35921,34773,2887,37660,286
2022-02-12,Yuba,115,75493,15410,15242,1132,16374,107
2022-02-11,Alameda,001,1643700,247982,242137,13052,255189,1668
2022-02-11,Alpine,003,1148,121,124,1,125,0
2022-02-11,Amador,005,37829,8207,8091,616,8707,76
2022-02-11,Butte,007,227075,32188,31601,6680,38281,360
2022-02-11,Calaveras,009,45235,7092,7022,322,7344,106
2022-02-11,Colusa,011,21464,3376,3345,1026,4371,21
2022-02-11,Contra Costa,013,1133247,184020,180270,12467,192737,1141
2022-02-11,Del Norte,015,27424,5409,5262,161,5423,45
2022-02-11,El Dorado,017,186661,26164,25692,3113,28805,188
2022-02-11,Fresno,019,978130,224811,219909,22794,242703,2509
2022-02-11,Glenn,021,27897,4878,4818,1569,6387,39
2022-02-11,Humboldt,023,135768,16223,16058,2756,18814,132
2022-02-11,Imperial,025,180216,54203,53304,10254,63558,860
2022-02-11,Inyo,027,18085,4017,3991,436,4427,52
2022-02-11,Kern,029,883053,188028,184639,44520,229159,2037
2022-02-11,Kings,031,150075,50043,48893,3400,52293,415
2022-02-11,Lake,033,64148,10143,9926,829,10755,123
2022-02-11,Lassen,035,31185,8600,8477,852,9329,55
2022-02-11,Los Angeles,037,10098052,2664572,2616426,120569,2736995,29364
2022-02-11,Madera,039,155013,36294,35710,5785,41495,330
2022-02-11,Marin,041,260295,32375,32048,2121,34169,255
2022-02-11,Mariposa,043,17540,2300,2286,185,2471,6
2022-02-11,Mendocino,045,87422,12638,12439,2801,15240,107
2022-02-11,Merced,047,269075,60697,60187,8179,68366,758
2022-02-11,Modoc,049,8938,708,697,233,930,6
2022-02-11,Mono,051,14174,2943,2939,118,3057,5
2022-02-11,Monterey,053,433212,77090,74842,12652,87494,672
2022-02-11,Napa,055,140530,24784,24530,900,25430,124
2022-02-11,Nevada,057,99092,15563,15499,1124,16623,119
2022-02-11,Orange,059,3164182,537110,534503,39974,574477,6305
2022-02-11,Placer,061,380077,61413,60636,7133,67769,554
2022-02-11,Plumas,063,18699,2893,2617,340,2957,13
2022-02-11,Riverside,065,2383286,582501,575566,26993,602559,5961
2022-02-11,Sacramento,067,1510023,274109,266347,25496,291843,2686
2022-02-11,San Benito,069,59416,12573,12526,498,13024,91
2022-02-11,San Bernardino,071,2135413,562652,548822,24206,573028,6360
2022-02-11,San Diego,073,3302833,733623,720287,50809,771096,4854
2022-02-11,San Francisco,075,870044,119495,119113,7913,127026,740
2022-02-11,San Joaquin,077,732212,162807,161234,9564,170798,2014
2022-02-11,San Luis Obispo,079,281455,50770,50064,3557,53621,416
2022-02-11,San Mateo,081,765935,117981,115235,6617,121852,589
2022-02-11,Santa Barbara,083,443738,83675,83390,4549,87939,631
2022-02-11,Santa Clara,085,1922200,300422,298176,11821,309997,2093
2022-02-11,Santa Cruz,087,273765,45509,44447,2022,46469,239
2022-02-11,Shasta,089,179085,29662,29370,5884,35254,473
2022-02-11,Sierra,091,2930,268,268,45,313,0
2022-02-11,Siskiyou,093,43540,4299,4231,2599,6830,68
2022-02-11,Solano,095,438530,78949,77865,5370,83235,424
2022-02-11,Sonoma,097,501317,80958,79533,2409,81942,431
2022-02-11,Stanislaus,099,539301,114996,114531,17072,131603,1406
2022-02-11,Sutter,101,95872,19977,19800,1937,21737,211
2022-02-11,Tehama,103,63373,11737,11580,2551,14131,151
2022-02-11,Trinity,105,12862,1150,1115,272,1387,20
2022-02-11,Tulare,107,460477,103956,100434,26586,127020,1273
2022-02-11,Tuolumne,109,53932,12308,11754,522,12276,125
2022-02-11,Ventura,111,848112,169905,168736,9182,177918,1340
2022-02-11,Yolo,113,214977,35888,34773,2885,37658,286
2022-02-11,Yuba,115,75493,15393,15242,1131,16373,107
2022-02-10,Alameda,001,1643700,247456,242137,13005,255142,1668
2022-02-10,Alpine,003,1148,121,124,1,125,0
2022-02-10,Amador,005,37829,8195,8091,610,8701,76
2022-02-10,Butte,007,227075,32136,31601,6666,38267,360
2022-02-10,Calaveras,009,45235,7080,7022,320,7342,106
2022-02-10,Colusa,011,21464,3370,3345,1024,4369,21
2022-02-10,Contra Costa,013,1133247,183657,180270,12403,192673,1141
2022-02-10,Del Norte,015,27424,5380,5262,159,5421,45
2022-02-10,El Dorado,017,186661,26119,25692,3106,28798,188
2022-02-10,Fresno,019,978130,224230,219909,22708,242617,2509
2022-02-10,Glenn,021,27897,4874,4818,1567,6385,39
2022-02-10,Humboldt,023,135768,16173,16058,2734,18792,132
2022-02-10,Imperial,025,180216,54134,53304,10211,63515,860
2022-02-10,Inyo,027,18085,4013,3991,436,4427,52
2022-02-10,Kern,029,883053,187720,184639,44411,229050,2037
2022-02-10,Kings,031,150075,49932,48893,3389,52282,415
2022-02-10,Lake,033,64148,10112,9926,827,10753,123
2022-02-10,Lassen,035,31185,8586,8477,850,9327,55
2022-02-10,Los Angeles,037,10098052,2661418,2616426,120383,2736809,29364
2022-02-10,Madera,039,155013,36197,35710,5754,41464,330
2022-02-10,Marin,041,260295,32317,32048,2109,34157,255
2022-02-10,Mariposa,043,17540,2296,2286,184,2470,6
2022-02-10,Mendocino,045,87422,12616,12439,2778,15217,107
2022-02-10,Merced,047,269075,60573,60187,8126,68313,758
2022-02-10,Modoc,049,8938,707,697,232,929,6
2022-02-10,Mono,051,14174,2941,2939,117,3056,5
2022-02-10,Monterey,053,433212,76908,74842,12572,87414,672
2022-02-10,Napa,055,140530,24720,24530,898,25428,124
2022-02-10,Nevada,057,99092,15538,15499,1123,16622,119
2022-02-10,Orange,059,3164182,536461,534503,39907,574410,6305
2022-02-10,Placer,061,380077,61332,60636,7124,67760,554
2022-02-10,Plumas,063,18699,2890,2617,333,2950,13
2022-02-10,Riverside,065,2383286,581775,575566,26937,602503,5961
2022-02-10,Sacramento,067,1510023,273627,266347,25408,291755,2686
2022-02-10,San Benito,069,59416,12552,12526,496,13022,91
2022-02-10,San Bernardino,071,2135413,562110,548822,24176,572998,6360
2022-02-10,San Diego,073,3302833,732516,720287,50689,770976,4854
2022-02-10,San Francisco,075,870044,119282,119113,7896,127009,740
2022-02-10,San Joaquin,077,732212,162494,161234,9556,170790,2014
2022-02-10,San Luis Obispo,079,281455,50671,50064,3546,53610,416
2022-02-10,San Mateo,081,765935,117756,115235,6600,121835,589
2022-02-10,Santa Barbara,083,443738,83491,83390,4543,87933,631
2022-02-10,Santa Clara,085,1922200,299755,298176,11765,309941,2093
2022-02-10,Santa Cruz,087,273765,45365,44447,2021,46468,239
2022-02-10,Shasta,089,179085,29600,29370,5864,35234,473
2022-02-10,Sierra,091,2930,268,268,45,313,0
2022-02-10,Siskiyou,093,43540,4294,4231,2586,6817,68
2022-02-10,Solano,095,438530,78756,77865,5351,83216,424
2022-02-10,Sonoma,097,501317,80822,79533,2394,81927,431
2022-02-10,Stanislaus,099,539301,114817,114531,17034,131565,1406
2022-02-10,Sutter,101,95872,19938,19800,1922,21722,211
2022-02-10,Tehama,103,63373,11707,11580,2548,14128,151
2022-02-10,Trinity,105,12862,1147,1115,271,1386,20
2022-02-10,Tulare,107,460477,103769,100434,26509,126943,1273
2022-02-10,Tuolumne,109,53932,12286,11754,517,12271,125
2022-02-10,Ventura,111,848112,169624,168736,9168,177904,1340
2022-02-10,Yolo,113,214977,35811,34773,2879,37652,286
2022-02-10,Yuba,115,75493,15361,15242,1126,16368,107
2022-02-09,Alameda,001,1643700,246923,241141,12949,254090,1668
2022-02-09,Alpine,003,1148,120,124,1,125,0
2022-02-09,Amador,005,37829,8181,8069,605,8674,76
2022-02-09,Butte,007,227075,32043,31433,6652,38085,359
2022-02-09,Calaveras,009,45235,7066,7005,316,7321,106
2022-02-09,Colusa,011,21464,3367,3331,1023,4354,21
2022-02-09,Contra Costa,013,1133247,183304,179695,12357,192052,1132
2022-02-09,Del Norte,015,27424,5333,5204,158,5362,45
2022-02-09,El Dorado,017,186661,26082,25572,3094,28666,186
2022-02-09,Fresno,019,978130,223617,218989,22620,241609,2502
2022-02-09,Glenn,021,27897,4861,4804,1566,6370,39
2022-02-09,Humboldt,023,135768,16126,15929,2709,18638,131
2022-02-09,Imperial,025,180216,54031,53102,10138,63240,858
2022-02-09,Inyo,027,18085,4007,3989,435,4424,52
2022-02-09,Kern,029,883053,187344,184068,44297,228365,2021
2022-02-09,Kings,031,150075,49821,48718,3383,52101,410
2022-02-09,Lake,033,64148,10072,9880,822,10702,124
2022-02-09,Lassen,035,31185,8561,8459,849,9308,55
2022-02-09,Los Angeles,037,10098052,2657737,2611611,120249,2731860,29263
2022-02-09,Madera,039,155013,36099,35559,5724,41283,330
2022-02-09,Marin,041,260295,32267,31965,2102,34067,255
2022-02-09,Mariposa,043,17540,2293,2279,184,2463,6
2022-02-09,Mendocino,045,87422,12582,12378,2749,15127,107
2022-02-09,Merced,047,269075,60443,59952,8074,68026,755
2022-02-09,Modoc,049,8938,704,691,231,922,6
2022-02-09,Mono,051,14174,2939,2937,117,3054,5
2022-02-09,Monterey,053,433212,76706,74500,12486,86986,670
2022-02-09,Napa,055,140530,24674,24429,893,25322,123
2022-02-09,Nevada,057,99092,15517,15446,1121,16567,119
2022-02-09,Orange,059,3164182,535831,534316,39828,574144,6263
2022-02-09,Placer,061,380077,61237,60490,7104,67594,553
2022-02-09,Plumas,063,18699,2885,2609,329,2938,13
2022-02-09,Riverside,065,2383286,581032,573907,26892,600799,5911
2022-02-09,Sacramento,067,1510023,273061,265624,25292,290916,2673
2022-02-09,San Benito,069,59416,12528,12492,496,12988,91
2022-02-09,San Bernardino,071,2135413,561502,547768,24150,571918,6349
2022-02-09,San Diego,073,3302833,731159,717896,50579,768475,4832
2022-02-09,San Francisco,075,870044,119033,118550,7885,126435,731
2022-02-09,San Joaquin,077,732212,162189,160618,9546,170164,2014
2022-02-09,San Luis Obispo,079,281455,50525,49833,3541,53374,414
2022-02-09,San Mateo,081,765935,117568,114890,6560,121450,589
2022-02-09,Santa Barbara,083,443738,83309,82830,4537,87367,629
2022-02-09,Santa Clara,085,1922200,299037,297157,11707,308864,2090
2022-02-09,Santa Cruz,087,273765,45184,44200,2014,46214,239
2022-02-09,Shasta,089,179085,29531,29215,5843,35058,471
2022-02-09,Sierra,091,2930,267,268,44,312,0
2022-02-09,Siskiyou,093,43540,4280,4217,2580,6797,68
2022-02-09,Solano,095,438530,78565,77299,5340,82639,423
2022-02-09,Sonoma,097,501317,80648,79165,2387,81552,431
2022-02-09,Stanislaus,099,539301,114568,114039,16802,130841,1406
2022-02-09,Sutter,101,95872,19896,19758,1909,21667,207
2022-02-09,Tehama,103,63373,11680,11542,2544,14086,149
2022-02-09,Trinity,105,12862,1143,1110,270,1380,20
2022-02-09,Tulare,107,460477,103555,100049,26423,126472,1271
2022-02-09,Tuolumne,109,53932,12248,11702,514,12216,95
2022-02-09,Ventura,111,848112,169387,168253,9155,177408,1325
2022-02-09,Yolo,113,214977,35741,34588,2863,37451,285
2022-02-09,Yuba,115,75493,15330,15187,1115,16302,105
2022-02-08,Alameda,001,1643700,246289,240587,12876,253463,1651
2022-02-08,Alpine,003,1148,120,124,1,125,0
2022-02-08,Amador,005,37829,8173,8050,598,8648,76
2022-02-08,Butte,007,227075,31958,31353,6627,37980,359
2022-02-08,Calaveras,009,45235,7049,6981,314,7295,101
2022-02-08,Colusa,011,21464,3359,3320,1022,4342,21
2022-02-08,Contra Costa,013,1133247,182876,179078,12280,191358,1132
2022-02-08,Del Norte,015,27424,5308,5156,153,5309,44
2022-02-08,El Dorado,017,186661,26037,25446,3083,28529,186
2022-02-08,Fresno,019,978130,222870,218416,22515,240931,2502
2022-02-08,Glenn,021,27897,4844,4784,1562,6346,39
2022-02-08,Humboldt,023,135768,16065,15865,2677,18542,130
2022-02-08,Imperial,025,180216,53903,52977,10094,63071,855
2022-02-08,Inyo,027,18085,4002,3983,435,4418,52
2022-02-08,Kern,029,883053,187008,183519,44167,227686,2010
2022-02-08,Kings,031,150075,49661,48479,3371,51850,411
2022-02-08,Lake,033,64148,10042,9806,816,10622,125
2022-02-08,Lassen,035,31185,8552,8423,845,9268,55
2022-02-08,Los Angeles,037,10098052,2653397,2611204,120061,2731265,29259
2022-02-08,Madera,039,155013,35991,35381,5668,41049,330
2022-02-08,Marin,041,260295,32193,31878,2097,33975,255
2022-02-08,Mariposa,043,17540,2291,2266,176,2442,6
2022-02-08,Mendocino,045,87422,12550,12336,2718,15054,107
2022-02-08,Merced,047,269075,60334,59789,8015,67804,751
2022-02-08,Modoc,049,8938,700,684,231,915,6
2022-02-08,Mono,051,14174,2938,2932,117,3049,5
2022-02-08,Monterey,053,433212,76499,74316,12400,86716,670
2022-02-08,Napa,055,140530,24601,24346,886,25232,121
2022-02-08,Nevada,057,99092,15490,15383,1118,16501,117
2022-02-08,Orange,059,3164182,535144,533507,39740,573247,6205
2022-02-08,Placer,061,380077,61129,60301,7092,67393,553
2022-02-08,Plumas,063,18699,2874,2596,322,2918,13
2022-02-08,Riverside,065,2383286,580202,571892,26820,598712,5908
2022-02-08,Sacramento,067,1510023,272391,264479,25117,289596,2664
2022-02-08,San Benito,069,59416,12504,12434,494,12928,91
2022-02-08,San Bernardino,071,2135413,560790,544658,24106,568764,6335
2022-02-08,San Diego,073,3302833,729586,717896,50449,768345,4832
2022-02-08,San Francisco,075,870044,118721,117942,7876,125818,731
2022-02-08,San Joaquin,077,732212,161806,160147,9528,169675,2005
2022-02-08,San Luis Obispo,079,281455,50359,49556,3511,53067,410
2022-02-08,San Mateo,081,765935,117350,114541,6531,121072,589
2022-02-08,Santa Barbara,083,443738,83141,82461,4512,86973,627
2022-02-08,Santa Clara,085,1922200,298156,295679,11660,307339,2091
2022-02-08,Santa Cruz,087,273765,45029,43884,2009,45893,239
2022-02-08,Shasta,089,179085,29448,29084,5815,34899,470
2022-02-08,Sierra,091,2930,267,267,44,311,0
2022-02-08,Siskiyou,093,43540,4270,4191,2571,6762,68
2022-02-08,Solano,095,438530,78335,77031,5325,82356,421
2022-02-08,Sonoma,097,501317,80434,78798,2365,81163,431
2022-02-08,Stanislaus,099,539301,114315,113733,16727,130460,1406
2022-02-08,Sutter,101,95872,19858,19717,1897,21614,203
2022-02-08,Tehama,103,63373,11653,11491,2537,14028,149
2022-02-08,Trinity,105,12862,1137,1110,270,1380,20
2022-02-08,Tulare,107,460477,103264,99694,26292,125986,1267
2022-02-08,Tuolumne,109,53932,12224,11665,512,12177,92
2022-02-08,Ventura,111,848112,169150,167830,9140,176970,1325
2022-02-08,Yolo,113,214977,35659,34462,2850,37312,281
2022-02-08,Yuba,115,75493,15285,15126,1093,16219,107
2022-02-07,Alameda,001,1643700,245577,238678,12810,251488,1643
2022-02-07,Alpine,003,1148,120,124,1,125,0
2022-02-07,Amador,005,37829,8145,7980,590,8570,75
2022-02-07,Butte,007,227075,31869,31184,6598,37782,355
2022-02-07,Calaveras,009,45235,7027,6910,313,7223,100
2022-02-07,Colusa,011,21464,3348,3283,1018,4301,21
2022-02-07,Contra Costa,013,1133247,182411,177767,12208,189975,1130
2022-02-07,Del Norte,015,27424,5267,5093,148,5241,44
2022-02-07,El Dorado,017,186661,25974,25257,3072,28329,185
2022-02-07,Fresno,019,978130,222018,216495,22370,238865,2493
2022-02-07,Glenn,021,27897,4837,4762,1558,6320,39
2022-02-07,Humboldt,023,135768,15990,15764,2652,18416,129
2022-02-07,Imperial,025,180216,53789,52689,10025,62714,853
2022-02-07,Inyo,027,18085,3997,3976,429,4405,51
2022-02-07,Kern,029,883053,186535,182047,44003,226050,1998
2022-02-07,Kings,031,150075,49477,48147,3354,51501,403
2022-02-07,Lake,033,64148,9996,9519,808,10327,125
2022-02-07,Lassen,035,31185,8534,8362,839,9201,55
2022-02-07,Los Angeles,037,10098052,2648936,2607438,119846,2727284,29210
2022-02-07,Madera,039,155013,35867,35083,5621,40704,330
2022-02-07,Marin,041,260295,32127,31670,2086,33756,255
2022-02-07,Mariposa,043,17540,2286,2253,172,2425,6
2022-02-07,Mendocino,045,87422,12492,12237,2680,14917,107
2022-02-07,Merced,047,269075,60207,59472,7922,67394,748
2022-02-07,Modoc,049,8938,696,679,231,910,6
2022-02-07,Mono,051,14174,2936,2917,117,3034,5
2022-02-07,Monterey,053,433212,76245,69433,12293,81726,670
2022-02-07,Napa,055,140530,24515,23237,877,24114,120
2022-02-07,Nevada,057,99092,15455,15268,1112,16380,113
2022-02-07,Orange,059,3164182,534381,531442,39659,571101,6179
2022-02-07,Placer,061,380077,61005,59894,7077,66971,546
2022-02-07,Plumas,063,18699,2863,2573,313,2886,13
2022-02-07,Riverside,065,2383286,579258,568874,26736,595610,5868
2022-02-07,Sacramento,067,1510023,271709,262834,24935,287769,2631
2022-02-07,San Benito,069,59416,12466,12285,492,12777,90
2022-02-07,San Bernardino,071,2135413,559994,542846,24068,566914,6335
2022-02-07,San Diego,073,3302833,727866,716244,50266,766510,4811
2022-02-07,San Francisco,075,870044,118382,113945,7851,121796,727
2022-02-07,San Joaquin,077,732212,161424,159358,9509,168867,1998
2022-02-07,San Luis Obispo,079,281455,50189,48994,3492,52486,406
2022-02-07,San Mateo,081,765935,117064,107060,6502,113562,589
2022-02-07,Santa Barbara,083,443738,82953,81608,4497,86105,624
2022-02-07,Santa Clara,085,1922200,297205,293360,11613,304973,2085
2022-02-07,Santa Cruz,087,273765,44813,43244,2005,45249,239
2022-02-07,Shasta,089,179085,29358,28900,5789,34689,468
2022-02-07,Sierra,091,2930,267,265,44,309,0
2022-02-07,Siskiyou,093,43540,4259,4157,2555,6712,68
2022-02-07,Solano,095,438530,78078,73934,5296,79230,420
2022-02-07,Sonoma,097,501317,80177,78296,2352,80648,431
2022-02-07,Stanislaus,099,539301,114057,113029,16585,129614,1406
2022-02-07,Sutter,101,95872,19826,19599,1869,21468,203
2022-02-07,Tehama,103,63373,11612,11418,2529,13947,146
2022-02-07,Trinity,105,12862,1133,1109,267,1376,20
2022-02-07,Tulare,107,460477,102905,98774,26162,124936,1263
2022-02-07,Tuolumne,109,53932,12176,11578,508,12086,92
2022-02-07,Ventura,111,848112,168832,166904,9125,176029,1324
2022-02-07,Yolo,113,214977,35548,34007,2836,36843,281
2022-02-07,Yuba,115,75493,15238,14998,1086,16084,105
2022-02-06,Alameda,001,1643700,244660,237188,12727,249915,1643
2022-02-06,Alpine,003,1148,120,123,1,124,0
2022-02-06,Amador,005,37829,8114,7922,578,8500,73
2022-02-06,Butte,007,227075,31743,31021,6546,37567,355
2022-02-06,Calaveras,009,45235,7000,6870,308,7178,99
2022-02-06,Colusa,011,21464,3338,3282,1017,4299,21
2022-02-06,Contra Costa,013,1133247,181781,176863,12053,188916,1128
2022-02-06,Del Norte,015,27424,5211,5038,146,5184,44
2022-02-06,El Dorado,017,186661,25911,25165,3060,28225,185
2022-02-06,Fresno,019,978130,221172,214726,22114,236840,2489
2022-02-06,Glenn,021,27897,4823,4738,1549,6287,39
2022-02-06,Humboldt,023,135768,15906,15658,2612,18270,128
2022-02-06,Imperial,025,180216,53602,52396,9979,62375,853
2022-02-06,Inyo,027,18085,3995,3970,426,4396,51
2022-02-06,Kern,029,883053,185983,181188,43763,224951,1996
2022-02-06,Kings,031,150075,49254,47669,3329,50998,401
2022-02-06,Lake,033,64148,9927,9468,791,10259,125
2022-02-06,Lassen,035,31185,8514,8326,834,9160,55
2022-02-06,Los Angeles,037,10098052,2643394,2602620,119587,2722207,29180
2022-02-06,Madera,039,155013,35683,34901,5529,40430,330
2022-02-06,Marin,041,260295,32030,31488,2073,33561,255
2022-02-06,Mariposa,043,17540,2278,2244,161,2405,6
2022-02-06,Mendocino,045,87422,12449,12169,2610,14779,107
2022-02-06,Merced,047,269075,59990,59112,7761,66873,748
2022-02-06,Modoc,049,8938,691,675,230,905,6
2022-02-06,Mono,051,14174,2931,2901,115,3016,5
2022-02-06,Monterey,053,433212,75879,67912,12136,80048,670
2022-02-06,Napa,055,140530,24396,23230,870,24100,120
2022-02-06,Nevada,057,99092,15390,15192,1099,16291,113
2022-02-06,Orange,059,3164182,533429,527906,39558,567464,6171
2022-02-06,Placer,061,380077,60829,59507,7051,66558,544
2022-02-06,Plumas,063,18699,2850,2559,304,2863,13
2022-02-06,Riverside,065,2383286,578117,568276,26659,594935,5865
2022-02-06,Sacramento,067,1510023,270840,261353,24675,286028,2631
2022-02-06,San Benito,069,59416,12411,12186,484,12670,90
2022-02-06,San Bernardino,071,2135413,559016,541103,23998,565101,6334
2022-02-06,San Diego,073,3302833,725805,709938,50027,759965,4786
2022-02-06,San Francisco,075,870044,117999,113115,7825,120940,728
2022-02-06,San Joaquin,077,732212,160859,158510,9470,167980,1997
2022-02-06,San Luis Obispo,079,281455,49964,48843,3435,52278,405
2022-02-06,San Mateo,081,765935,116725,105556,6463,112019,587
2022-02-06,Santa Barbara,083,443738,82635,81118,4460,85578,623
2022-02-06,Santa Clara,085,1922200,296097,291732,11497,303229,2075
2022-02-06,Santa Cruz,087,273765,44500,42952,1991,44943,239
2022-02-06,Shasta,089,179085,29235,28762,5740,34502,468
2022-02-06,Sierra,091,2930,267,265,44,309,0
2022-02-06,Siskiyou,093,43540,4238,4118,2529,6647,68
2022-02-06,Solano,095,438530,77780,73475,5253,78728,419
2022-02-06,Sonoma,097,501317,79842,77887,2337,80224,431
2022-02-06,Stanislaus,099,539301,113660,112521,16440,128961,1406
2022-02-06,Sutter,101,95872,19784,19523,1831,21354,203
2022-02-06,Tehama,103,63373,11572,11366,2509,13875,146
2022-02-06,Trinity,105,12862,1132,1102,266,1368,20
2022-02-06,Tulare,107,460477,102468,98260,25979,124239,1262
2022-02-06,Tuolumne,109,53932,12124,11507,491,11998,92
2022-02-06,Ventura,111,848112,168456,166235,9114,175349,1323
2022-02-06,Yolo,113,214977,35409,33784,2820,36604,281
2022-02-06,Yuba,115,75493,15193,14917,1077,15994,104
2022-02-05,Alameda,001,1643700,244244,235698,12718,248416,1638
2022-02-05,Alpine,003,1148,120,124,1,125,0
2022-02-05,Amador,005,37829,8105,7855,576,8431,71
2022-02-05,Butte,007,227075,31689,30733,6531,37264,355
2022-02-05,Calaveras,009,45235,6984,6789,308,7097,99
2022-02-05,Colusa,011,21464,3331,3234,1017,4251,21
2022-02-05,Contra Costa,013,1133247,181510,175871,12037,187908,1115
2022-02-05,Del Norte,015,27424,5169,4978,146,5124,44
2022-02-05,El Dorado,017,186661,25880,24813,3058,27871,185
2022-02-05,Fresno,019,978130,220828,213539,22093,235632,2477
2022-02-05,Glenn,021,27897,4821,4691,1542,6233,39
2022-02-05,Humboldt,023,135768,15858,15514,2609,18123,127
2022-02-05,Imperial,025,180216,53539,52153,9966,62119,853
2022-02-05,Inyo,027,18085,3992,3948,426,4374,51
2022-02-05,Kern,029,883053,185774,180296,43662,223958,1987
2022-02-05,Kings,031,150075,49167,47538,3322,50860,402
2022-02-05,Lake,033,64148,9908,9289,784,10073,124
2022-02-05,Lassen,035,31185,8503,8288,832,9120,55
2022-02-05,Los Angeles,037,10098052,2641210,2572702,119462,2692164,28947
2022-02-05,Madera,039,155013,35630,34471,5516,39987,329
2022-02-05,Marin,041,260295,31983,31299,2069,33368,255
2022-02-05,Mariposa,043,17540,2277,2222,160,2382,6
2022-02-05,Mendocino,045,87422,12421,12066,2608,14674,107
2022-02-05,Merced,047,269075,59897,58908,7754,66662,744
2022-02-05,Modoc,049,8938,690,664,230,894,6
2022-02-05,Mono,051,14174,2930,2904,115,3019,5
2022-02-05,Monterey,053,433212,75763,67342,12092,79434,666
2022-02-05,Napa,055,140530,24340,22973,869,23842,118
2022-02-05,Nevada,057,99092,15369,15002,1094,16096,113
2022-02-05,Orange,059,3164182,532987,527516,39468,566984,6134
2022-02-05,Placer,061,380077,60704,59043,7038,66081,533
2022-02-05,Plumas,063,18699,2849,2550,303,2853,13
2022-02-05,Riverside,065,2383286,577513,563991,26589,590580,5827
2022-02-05,Sacramento,067,1510023,270448,259437,24641,284078,2610
2022-02-05,San Benito,069,59416,12366,12142,484,12626,90
2022-02-05,San Bernardino,071,2135413,558505,539312,23978,563290,6322
2022-02-05,San Diego,073,3302833,724945,703957,49953,753910,4735
2022-02-05,San Francisco,075,870044,117790,112481,7798,120279,720
2022-02-05,San Joaquin,077,732212,160673,157420,9459,166879,1989
2022-02-05,San Luis Obispo,079,281455,49927,48361,3433,51794,404
2022-02-05,San Mateo,081,765935,116537,104810,6455,111265,587
2022-02-05,Santa Barbara,083,443738,82472,80478,4448,84926,617
2022-02-05,Santa Clara,085,1922200,295442,289262,11481,300743,2067
2022-02-05,Santa Cruz,087,273765,44426,42553,1988,44541,239
2022-02-05,Shasta,089,179085,29192,28604,5731,34335,466
2022-02-05,Sierra,091,2930,267,262,44,306,0
2022-02-05,Siskiyou,093,43540,4231,4106,2516,6622,67
2022-02-05,Solano,095,438530,77705,73112,5244,78356,415
2022-02-05,Sonoma,097,501317,79676,77213,2333,79546,431
2022-02-05,Stanislaus,099,539301,113457,111783,16417,128200,1406
2022-02-05,Sutter,101,95872,19754,19406,1825,21231,203
2022-02-05,Tehama,103,63373,11553,11259,2502,13761,146
2022-02-05,Trinity,105,12862,1130,1085,266,1351,20
2022-02-05,Tulare,107,460477,102299,97414,25898,123312,1254
2022-02-05,Tuolumne,109,53932,12099,11409,488,11897,91
2022-02-05,Ventura,111,848112,168230,165532,9098,174630,1308
2022-02-05,Yolo,113,214977,35324,33614,2805,36419,281
2022-02-05,Yuba,115,75493,15162,14801,1069,15870,105
2022-02-04,Alameda,001,1643700,243755,235698,12708,248406,1638
2022-02-04,Alpine,003,1148,120,124,1,125,0
2022-02-04,Amador,005,37829,8089,7855,572,8427,71
2022-02-04,Butte,007,227075,31629,30733,6519,37252,355
2022-02-04,Calaveras,009,45235,6974,6789,306,7095,99
2022-02-04,Colusa,011,21464,3326,3234,1015,4249,21
2022-02-04,Contra Costa,013,1133247,181185,175871,12009,187880,1115
2022-02-04,Del Norte,015,27424,5148,4978,146,5124,44
2022-02-04,El Dorado,017,186661,25844,24813,3055,27868,185
2022-02-04,Fresno,019,978130,220347,213539,22062,235601,2477
2022-02-04,Glenn,021,27897,4812,4691,1539,6230,39
2022-02-04,Humboldt,023,135768,15831,15514,2606,18120,127
2022-02-04,Imperial,025,180216,53462,52153,9949,62102,853
2022-02-04,Inyo,027,18085,3989,3948,426,4374,51
2022-02-04,Kern,029,883053,185549,180296,43538,223834,1987
2022-02-04,Kings,031,150075,49092,47538,3315,50853,402
2022-02-04,Lake,033,64148,9886,9289,781,10070,124
2022-02-04,Lassen,035,31185,8480,8288,832,9120,55
2022-02-04,Los Angeles,037,10098052,2638574,2572702,119332,2692034,28947
2022-02-04,Madera,039,155013,35547,34471,5508,39979,329
2022-02-04,Marin,041,260295,31919,31299,2060,33359,255
2022-02-04,Mariposa,043,17540,2275,2222,158,2380,6
2022-02-04,Mendocino,045,87422,12390,12066,2606,14672,107
2022-02-04,Merced,047,269075,59816,58908,7744,66652,744
2022-02-04,Modoc,049,8938,690,664,230,894,6
2022-02-04,Mono,051,14174,2928,2904,115,3019,5
2022-02-04,Monterey,053,433212,75573,67342,12049,79391,666
2022-02-04,Napa,055,140530,24293,22973,865,23838,118
2022-02-04,Nevada,057,99092,15335,15002,1090,16092,113
2022-02-04,Orange,059,3164182,532437,527516,39411,566927,6134
2022-02-04,Placer,061,380077,60600,59043,7027,66070,533
2022-02-04,Plumas,063,18699,2842,2550,302,2852,13
2022-02-04,Riverside,065,2383286,576801,563991,26577,590568,5827
2022-02-04,Sacramento,067,1510023,269945,259437,24618,284055,2610
2022-02-04,San Benito,069,59416,12347,12142,482,12624,90
2022-02-04,San Bernardino,071,2135413,557925,539312,23957,563269,6322
2022-02-04,San Diego,073,3302833,723812,703957,49879,753836,4735
2022-02-04,San Francisco,075,870044,117549,112481,7773,120254,720
2022-02-04,San Joaquin,077,732212,160443,157420,9448,166868,1989
2022-02-04,San Luis Obispo,079,281455,49866,48361,3426,51787,404
2022-02-04,San Mateo,081,765935,116307,104810,6441,111251,587
2022-02-04,Santa Barbara,083,443738,82322,80478,4447,84925,617
2022-02-04,Santa Clara,085,1922200,294774,289262,11460,300722,2067
2022-02-04,Santa Cruz,087,273765,44221,42553,1984,44537,239
2022-02-04,Shasta,089,179085,29139,28604,5720,34324,466
2022-02-04,Sierra,091,2930,267,262,44,306,0
2022-02-04,Siskiyou,093,43540,4223,4106,2509,6615,67
2022-02-04,Solano,095,438530,77513,73112,5206,78318,415
2022-02-04,Sonoma,097,501317,79517,77213,2252,79465,431
2022-02-04,Stanislaus,099,539301,113276,111783,16392,128175,1406
2022-02-04,Sutter,101,95872,19730,19406,1818,21224,203
2022-02-04,Tehama,103,63373,11538,11259,2501,13760,146
2022-02-04,Trinity,105,12862,1129,1085,265,1350,20
2022-02-04,Tulare,107,460477,102115,97414,25817,123231,1254
2022-02-04,Tuolumne,109,53932,12087,11409,487,11896,91
2022-02-04,Ventura,111,848112,167961,165532,9090,174622,1308
2022-02-04,Yolo,113,214977,35231,33614,2799,36413,281
2022-02-04,Yuba,115,75493,15144,14801,1069,15870,105
2022-02-03,Alameda,001,1643700,242985,235698,12646,248344,1638
2022-02-03,Alpine,003,1148,120,124,1,125,0
2022-02-03,Amador,005,37829,8069,7855,567,8422,71
2022-02-03,Butte,007,227075,31520,30733,6490,37223,355
2022-02-03,Calaveras,009,45235,6944,6789,303,7092,99
2022-02-03,Colusa,011,21464,3313,3234,1013,4247,21
2022-02-03,Contra Costa,013,1133247,180586,175871,11911,187782,1115
2022-02-03,Del Norte,015,27424,5104,4978,143,5121,44
2022-02-03,El Dorado,017,186661,25773,24813,3049,27862,185
2022-02-03,Fresno,019,978130,219417,213539,21896,235435,2477
2022-02-03,Glenn,021,27897,4795,4691,1522,6213,39
2022-02-03,Humboldt,023,135768,15755,15514,2570,18084,127
2022-02-03,Imperial,025,180216,53318,52153,9899,62052,853
2022-02-03,Inyo,027,18085,3986,3948,422,4370,51
2022-02-03,Kern,029,883053,185086,180296,43324,223620,1987
2022-02-03,Kings,031,150075,48935,47538,3308,50846,402
2022-02-03,Lake,033,64148,9832,9289,775,10064,124
2022-02-03,Lassen,035,31185,8456,8288,831,9119,55
2022-02-03,Los Angeles,037,10098052,2633145,2572702,119069,2691771,28947
2022-02-03,Madera,039,155013,35410,34471,5464,39935,329
2022-02-03,Marin,041,260295,31823,31299,2055,33354,255
2022-02-03,Mariposa,043,17540,2263,2222,155,2377,6
2022-02-03,Mendocino,045,87422,12346,12066,2583,14649,107
2022-02-03,Merced,047,269075,59666,58908,7648,66556,744
2022-02-03,Modoc,049,8938,687,664,230,894,6
2022-02-03,Mono,051,14174,2923,2904,114,3018,5
2022-02-03,Monterey,053,433212,75286,67342,11857,79199,666
2022-02-03,Napa,055,140530,24161,22973,865,23838,118
2022-02-03,Nevada,057,99092,15294,15002,1080,16082,113
2022-02-03,Orange,059,3164182,531513,527516,39319,566835,6134
2022-02-03,Placer,061,380077,60403,59043,7004,66047,533
2022-02-03,Plumas,063,18699,2828,2550,298,2848,13
2022-02-03,Riverside,065,2383286,575603,563991,26506,590497,5827
2022-02-03,Sacramento,067,1510023,268990,259437,24430,283867,2610
2022-02-03,San Benito,069,59416,12320,12142,479,12621,90
2022-02-03,San Bernardino,071,2135413,556909,539312,23918,563230,6322
2022-02-03,San Diego,073,3302833,721840,703957,49716,753673,4735
2022-02-03,San Francisco,075,870044,117213,112481,7743,120224,720
2022-02-03,San Joaquin,077,732212,159961,157420,9419,166839,1989
2022-02-03,San Luis Obispo,079,281455,49667,48361,3411,51772,404
2022-02-03,San Mateo,081,765935,115955,104810,6408,111218,587
2022-02-03,Santa Barbara,083,443738,81964,80478,4418,84896,617
2022-02-03,Santa Clara,085,1922200,293606,289262,11351,300613,2067
2022-02-03,Santa Cruz,087,273765,43881,42553,1977,44530,239
2022-02-03,Shasta,089,179085,29035,28604,5693,34297,466
2022-02-03,Sierra,091,2930,267,262,44,306,0
2022-02-03,Siskiyou,093,43540,4208,4106,2493,6599,67
2022-02-03,Solano,095,438530,77182,73112,5187,78299,415
2022-02-03,Sonoma,097,501317,79220,77213,2245,79458,431
2022-02-03,Stanislaus,099,539301,112898,111783,16308,128091,1406
2022-02-03,Sutter,101,95872,19678,19406,1802,21208,203
2022-02-03,Tehama,103,63373,11507,11259,2493,13752,146
2022-02-03,Trinity,105,12862,1127,1085,264,1349,20
2022-02-03,Tulare,107,460477,101711,97414,25678,123092,1254
2022-02-03,Tuolumne,109,53932,12046,11409,475,11884,91
2022-02-03,Ventura,111,848112,167576,165532,9078,174610,1308
2022-02-03,Yolo,113,214977,35122,33614,2785,36399,281
2022-02-03,Yuba,115,75493,15094,14801,1053,15854,105
2022-02-02,Alameda,001,1643700,242039,234300,12543,246843,1632
2022-02-02,Alpine,003,1148,120,123,1,124,0
2022-02-02,Amador,005,37829,8039,7781,558,8339,71
2022-02-02,Butte,007,227075,31410,30550,6454,37004,355
2022-02-02,Calaveras,009,45235,6918,6753,299,7052,99
2022-02-02,Colusa,011,21464,3298,3211,1012,4223,21
2022-02-02,Contra Costa,013,1133247,179989,174876,11820,186696,1113
2022-02-02,Del Norte,015,27424,5062,4924,139,5063,44
2022-02-02,El Dorado,017,186661,25706,24690,3031,27721,185
2022-02-02,Fresno,019,978130,218406,211976,21765,233741,2463
2022-02-02,Glenn,021,27897,4771,4667,1512,6179,39
2022-02-02,Humboldt,023,135768,15694,15392,2531,17923,127
2022-02-02,Imperial,025,180216,53123,51875,9772,61647,853
2022-02-02,Inyo,027,18085,3980,3944,421,4365,51
2022-02-02,Kern,029,883053,184490,179386,43110,222496,1974
2022-02-02,Kings,031,150075,48744,47061,3283,50344,401
2022-02-02,Lake,033,64148,9774,9235,768,10003,120
2022-02-02,Lassen,035,31185,8443,8258,822,9080,55
2022-02-02,Los Angeles,037,10098052,2626919,2561902,118684,2680586,28850
2022-02-02,Madera,039,155013,35242,34265,5392,39657,329
2022-02-02,Marin,041,260295,31720,31149,2045,33194,255
2022-02-02,Mariposa,043,17540,2252,2215,151,2366,6
2022-02-02,Mendocino,045,87422,12293,11996,2544,14540,105
2022-02-02,Merced,047,269075,59490,58532,7565,66097,744
2022-02-02,Modoc,049,8938,681,662,230,892,6
2022-02-02,Mono,051,14174,2912,2887,114,3001,5
2022-02-02,Monterey,053,433212,74895,66852,11677,78529,666
2022-02-02,Napa,055,140530,24040,22859,852,23711,117
2022-02-02,Nevada,057,99092,15236,14895,1058,15953,112
2022-02-02,Orange,059,3164182,530457,524418,39226,563644,6127
2022-02-02,Placer,061,380077,60211,58654,6975,65629,533
2022-02-02,Plumas,063,18699,2812,2540,295,2835,12
2022-02-02,Riverside,065,2383286,574326,561220,26459,587679,5827
2022-02-02,Sacramento,067,1510023,267986,258078,24225,282303,2602
2022-02-02,San Benito,069,59416,12281,12058,475,12533,90
2022-02-02,San Bernardino,071,2135413,555898,537485,23857,561342,6317
2022-02-02,San Diego,073,3302833,719638,703957,49535,753492,4735
2022-02-02,San Francisco,075,870044,116845,112008,7727,119735,714
2022-02-02,San Joaquin,077,732212,159385,156537,9396,165933,1986
2022-02-02,San Luis Obispo,079,281455,49469,48119,3398,51517,403
2022-02-02,San Mateo,081,765935,115580,104201,6344,110545,587
2022-02-02,Santa Barbara,083,443738,81621,79979,4387,84366,612
2022-02-02,Santa Clara,085,1922200,292460,287443,11238,298681,2051
2022-02-02,Santa Cruz,087,273765,43591,42127,1966,44093,239
2022-02-02,Shasta,089,179085,28933,28429,5648,34077,465
2022-02-02,Sierra,091,2930,267,262,44,306,0
2022-02-02,Siskiyou,093,43540,4198,4078,2464,6542,67
2022-02-02,Solano,095,438530,76825,72711,5160,77871,414
2022-02-02,Sonoma,097,501317,78907,76681,2232,78913,431
2022-02-02,Stanislaus,099,539301,112502,111167,16180,127347,1403
2022-02-02,Sutter,101,95872,19613,19290,1773,21063,203
2022-02-02,Tehama,103,63373,11451,11193,2474,13667,146
2022-02-02,Trinity,105,12862,1124,1074,262,1336,20
2022-02-02,Tulare,107,460477,101321,96820,25526,122346,1249
2022-02-02,Tuolumne,109,53932,11969,11342,472,11814,91
2022-02-02,Ventura,111,848112,167177,164905,9059,173964,1292
2022-02-02,Yolo,113,214977,34996,33332,2762,36094,281
2022-02-02,Yuba,115,75493,15029,14720,1045,15765,104
2022-02-01,Alameda,001,1643700,240962,233782,12440,246222,1620
2022-02-01,Alpine,003,1148,120,123,1,124,0
2022-02-01,Amador,005,37829,7993,7783,552,8335,73
2022-02-01,Butte,007,227075,31273,30496,6411,36907,355
2022-02-01,Calaveras,009,45235,6881,6749,295,7044,98
2022-02-01,Colusa,011,21464,3282,3202,993,4195,21
2022-02-01,Contra Costa,013,1133247,179250,174379,11681,186060,1115
2022-02-01,Del Norte,015,27424,5014,4907,136,5043,44
2022-02-01,El Dorado,017,186661,25647,24664,3014,27678,184
2022-02-01,Fresno,019,978130,217242,211352,21606,232958,2464
2022-02-01,Glenn,021,27897,4757,4649,1502,6151,39
2022-02-01,Humboldt,023,135768,15611,15354,2503,17857,127
2022-02-01,Imperial,025,180216,52910,51675,9707,61382,846
2022-02-01,Inyo,027,18085,3970,3928,418,4346,51
2022-02-01,Kern,029,883053,183843,178987,42865,221852,1967
2022-02-01,Kings,031,150075,48485,46959,3260,50219,400
2022-02-01,Lake,033,64148,9718,9211,761,9972,119
2022-02-01,Lassen,035,31185,8425,8231,818,9049,55
2022-02-01,Los Angeles,037,10098052,2619729,2548794,118312,2667106,28752
2022-02-01,Madera,039,155013,35021,34124,5311,39435,329
2022-02-01,Marin,041,260295,31596,31099,2029,33128,255
2022-02-01,Mariposa,043,17540,2245,2210,150,2360,6
2022-02-01,Mendocino,045,87422,12231,11978,2507,14485,105
2022-02-01,Merced,047,269075,59306,58362,7442,65804,743
2022-02-01,Modoc,049,8938,674,664,230,894,6
2022-02-01,Mono,051,14174,2906,2888,114,3002,5
2022-02-01,Monterey,053,433212,74474,66553,11482,78035,665
2022-02-01,Napa,055,140530,23941,22795,836,23631,116
2022-02-01,Nevada,057,99092,15175,14863,1045,15908,112
2022-02-01,Orange,059,3164182,529307,523741,39083,562824,6108
2022-02-01,Placer,061,380077,59963,58486,6937,65423,532
2022-02-01,Plumas,063,18699,2797,2526,292,2818,12
2022-02-01,Riverside,065,2383286,572937,560010,26411,586421,5825
2022-02-01,Sacramento,067,1510023,266935,257504,23961,281465,2593
2022-02-01,San Benito,069,59416,12215,12053,472,12525,90
2022-02-01,San Bernardino,071,2135413,554626,536591,23793,560384,6311
2022-02-01,San Diego,073,3302833,717117,701009,49317,750326,4710
2022-02-01,San Francisco,075,870044,116379,111606,7708,119314,713
2022-02-01,San Joaquin,077,732212,158855,156300,9373,165673,1987
2022-02-01,San Luis Obispo,079,281455,49240,47842,3336,51178,403
2022-02-01,San Mateo,081,765935,115112,103868,6302,110170,589
2022-02-01,Santa Barbara,083,443738,81176,79659,4351,84010,608
2022-02-01,Santa Clara,085,1922200,290940,286109,11133,297242,2070
2022-02-01,Santa Cruz,087,273765,43292,41782,1950,43732,239
2022-02-01,Shasta,089,179085,28814,28382,5595,33977,465
2022-02-01,Sierra,091,2930,265,262,44,306,0
2022-02-01,Siskiyou,093,43540,4184,4072,2437,6509,66
2022-02-01,Solano,095,438530,76555,72494,5139,77633,415
2022-02-01,Sonoma,097,501317,78547,76379,2210,78589,431
2022-02-01,Stanislaus,099,539301,112092,110925,16080,127005,1403
2022-02-01,Sutter,101,95872,19545,19256,1741,20997,202
2022-02-01,Tehama,103,63373,11394,11165,2461,13626,146
2022-02-01,Trinity,105,12862,1120,1073,262,1335,19
2022-02-01,Tulare,107,460477,100829,96467,25328,121795,1247
2022-02-01,Tuolumne,109,53932,11919,11318,463,11781,91
2022-02-01,Ventura,111,848112,166672,164721,9034,173755,1293
2022-02-01,Yolo,113,214977,34844,33257,2736,35993,275
2022-02-01,Yuba,115,75493,14968,14693,1038,15731,103
2022-01-31,Alameda,001,1643700,239609,232743,12325,245068,1607
2022-01-31,Alpine,003,1148,119,123,1,124,0
2022-01-31,Amador,005,37829,7940,7682,535,8217,73
2022-01-31,Butte,007,227075,31105,30371,6363,36734,354
2022-01-31,Calaveras,009,45235,6845,6700,284,6984,96
2022-01-31,Colusa,011,21464,3270,3187,984,4171,21
2022-01-31,Contra Costa,013,1133247,178440,173466,11557,185023,1115
2022-01-31,Del Norte,015,27424,4980,4879,133,5012,43
2022-01-31,El Dorado,017,186661,25545,24545,2985,27530,184
2022-01-31,Fresno,019,978130,215756,210589,21411,232000,2464
2022-01-31,Glenn,021,27897,4721,4641,1490,6131,39
2022-01-31,Humboldt,023,135768,15522,15308,2470,17778,126
2022-01-31,Imperial,025,180216,52694,51472,9598,61070,846
2022-01-31,Inyo,027,18085,3959,3922,412,4334,50
2022-01-31,Kern,029,883053,183062,178375,42549,220924,1967
2022-01-31,Kings,031,150075,48128,46845,3226,50071,398
2022-01-31,Lake,033,64148,9645,9141,749,9890,119
2022-01-31,Lassen,035,31185,8394,8162,812,8974,55
2022-01-31,Los Angeles,037,10098052,2611494,2541189,117908,2659097,28718
2022-01-31,Madera,039,155013,34806,33886,5215,39101,329
2022-01-31,Marin,041,260295,31471,31023,2012,33035,253
2022-01-31,Mariposa,043,17540,2235,2203,141,2344,6
2022-01-31,Mendocino,045,87422,12165,11896,2466,14362,104
2022-01-31,Merced,047,269075,59027,58198,7253,65451,740
2022-01-31,Modoc,049,8938,671,661,230,891,6
2022-01-31,Mono,051,14174,2892,2889,114,3003,5
2022-01-31,Monterey,053,433212,74023,66117,11269,77386,661
2022-01-31,Napa,055,140530,23773,22707,819,23526,113
2022-01-31,Nevada,057,99092,15099,14813,1032,15845,112
2022-01-31,Orange,059,3164182,527983,522358,38948,561306,6098
2022-01-31,Placer,061,380077,59715,58252,6906,65158,523
2022-01-31,Plumas,063,18699,2784,2513,290,2803,12
2022-01-31,Riverside,065,2383286,571121,558166,26347,584513,5785
2022-01-31,Sacramento,067,1510023,265640,256594,23709,280303,2571
2022-01-31,San Benito,069,59416,12156,11976,471,12447,90
2022-01-31,San Bernardino,071,2135413,552990,535276,23712,558988,6302
2022-01-31,San Diego,073,3302833,714210,698571,49056,747627,4686
2022-01-31,San Francisco,075,870044,115971,111119,7674,118793,712
2022-01-31,San Joaquin,077,732212,158097,155736,9342,165078,1985
2022-01-31,San Luis Obispo,079,281455,48986,47656,3279,50935,395
2022-01-31,San Mateo,081,765935,114602,103313,6244,109557,589
2022-01-31,Santa Barbara,083,443738,80668,79267,4309,83576,606
2022-01-31,Santa Clara,085,1922200,289266,284562,11026,295588,2041
2022-01-31,Santa Cruz,087,273765,42913,41630,1943,43573,239
2022-01-31,Shasta,089,179085,28683,28190,5554,33744,462
2022-01-31,Sierra,091,2930,265,261,44,305,0
2022-01-31,Siskiyou,093,43540,4168,4054,2421,6475,66
2022-01-31,Solano,095,438530,75852,72258,5092,77350,414
2022-01-31,Sonoma,097,501317,78092,76199,2180,78379,431
2022-01-31,Stanislaus,099,539301,111565,110493,15911,126404,1403
2022-01-31,Sutter,101,95872,19465,19189,1691,20880,202
2022-01-31,Tehama,103,63373,11332,11112,2432,13544,145
2022-01-31,Trinity,105,12862,1115,1071,259,1330,19
2022-01-31,Tulare,107,460477,100190,96053,25095,121148,1245
2022-01-31,Tuolumne,109,53932,11828,11278,456,11734,91
2022-01-31,Ventura,111,848112,166136,164060,9009,173069,1286
2022-01-31,Yolo,113,214977,34683,33175,2709,35884,274
2022-01-31,Yuba,115,75493,14905,14652,1018,15670,103
2022-01-30,Alameda,001,1643700,238052,231838,12174,244012,1607
2022-01-30,Alpine,003,1148,119,123,1,124,0
2022-01-30,Amador,005,37829,7889,7644,512,8156,73
2022-01-30,Butte,007,227075,30902,30255,6282,36537,354
2022-01-30,Calaveras,009,45235,6790,6676,273,6949,96
2022-01-30,Colusa,011,21464,3250,3168,975,4143,21
2022-01-30,Contra Costa,013,1133247,177481,172902,11358,184260,1102
2022-01-30,Del Norte,015,27424,4939,4833,130,4963,43
2022-01-30,El Dorado,017,186661,25424,24491,2958,27449,184
2022-01-30,Fresno,019,978130,214196,209645,21156,230801,2463
2022-01-30,Glenn,021,27897,4690,4619,1481,6100,39
2022-01-30,Humboldt,023,135768,15410,15247,2414,17661,126
2022-01-30,Imperial,025,180216,52368,51415,9428,60843,846
2022-01-30,Inyo,027,18085,3942,3921,409,4330,50
2022-01-30,Kern,029,883053,182197,177924,42228,220152,1967
2022-01-30,Kings,031,150075,47776,46654,3169,49823,398
2022-01-30,Lake,033,64148,9556,9080,728,9808,119
2022-01-30,Lassen,035,31185,8370,8158,804,8962,55
2022-01-30,Los Angeles,037,10098052,2601417,2530739,117434,2648173,28678
2022-01-30,Madera,039,155013,34507,33752,5031,38783,329
2022-01-30,Marin,041,260295,31323,30875,1998,32873,253
2022-01-30,Mariposa,043,17540,2223,2177,136,2313,6
2022-01-30,Mendocino,045,87422,12092,11860,2360,14220,104
2022-01-30,Merced,047,269075,58662,58006,6962,64968,740
2022-01-30,Modoc,049,8938,668,661,230,891,6
2022-01-30,Mono,051,14174,2886,2888,114,3002,5
2022-01-30,Monterey,053,433212,73436,65996,10990,76986,661
2022-01-30,Napa,055,140530,23605,22588,802,23390,114
2022-01-30,Nevada,057,99092,15011,14741,1016,15757,112
2022-01-30,Orange,059,3164182,526350,521334,38800,560134,6098
2022-01-30,Placer,061,380077,59385,58030,6866,64896,523
2022-01-30,Plumas,063,18699,2759,2510,276,2786,12
2022-01-30,Riverside,065,2383286,569057,557088,26247,583335,5767
2022-01-30,Sacramento,067,1510023,264181,255715,23217,278932,2572
2022-01-30,San Benito,069,59416,12090,11945,466,12411,90
2022-01-30,San Bernardino,071,2135413,551241,534050,23605,557655,6302
2022-01-30,San Diego,073,3302833,710671,687145,48632,735777,4665
2022-01-30,San Francisco,075,870044,115422,110772,7640,118412,712
2022-01-30,San Joaquin,077,732212,157111,155165,9307,164472,1985
2022-01-30,San Luis Obispo,079,281455,48589,47599,3243,50842,394
2022-01-30,San Mateo,081,765935,114028,102979,6199,109178,589
2022-01-30,Santa Barbara,083,443738,79991,79072,4248,83320,606
2022-01-30,Santa Clara,085,1922200,287302,282846,10895,293741,2035
2022-01-30,Santa Cruz,087,273765,42454,41330,1935,43265,239
2022-01-30,Shasta,089,179085,28523,28105,5470,33575,462
2022-01-30,Sierra,091,2930,265,261,44,305,0
2022-01-30,Siskiyou,093,43540,4138,4039,2374,6413,66
2022-01-30,Solano,095,438530,75327,71857,5040,76897,414
2022-01-30,Sonoma,097,501317,77574,75890,2152,78042,431
2022-01-30,Stanislaus,099,539301,110910,110111,15714,125825,1403
2022-01-30,Sutter,101,95872,19373,19108,1595,20703,202
2022-01-30,Tehama,103,63373,11260,11071,2402,13473,145
2022-01-30,Trinity,105,12862,1109,1068,259,1327,19
2022-01-30,Tulare,107,460477,99448,95676,24835,120511,1245
2022-01-30,Tuolumne,109,53932,11720,11242,419,11661,91
2022-01-30,Ventura,111,848112,165556,163521,8979,172500,1286
2022-01-30,Yolo,113,214977,34464,33043,2676,35719,274
2022-01-30,Yuba,115,75493,14815,14584,998,15582,103
2022-01-29,Alameda,001,1643700,237376,225602,12157,237759,1605
2022-01-29,Alpine,003,1148,119,123,1,124,0
2022-01-29,Amador,005,37829,7867,7505,509,8014,73
2022-01-29,Butte,007,227075,30814,29557,6251,35808,353
2022-01-29,Calaveras,009,45235,6771,6484,273,6757,96
2022-01-29,Colusa,011,21464,3245,3107,971,4078,21
2022-01-29,Contra Costa,013,1133247,176956,168003,11328,179331,1101
2022-01-29,Del Norte,015,27424,4921,4589,128,4717,43
2022-01-29,El Dorado,017,186661,25381,24008,2951,26959,184
2022-01-29,Fresno,019,978130,213739,202691,21115,223806,2457
2022-01-29,Glenn,021,27897,4683,4516,1474,5990,39
2022-01-29,Humboldt,023,135768,15363,14812,2407,17219,126
2022-01-29,Imperial,025,180216,52252,50153,9372,59525,845
2022-01-29,Inyo,027,18085,3940,3895,401,4296,50
2022-01-29,Kern,029,883053,181857,174456,42066,216522,1962
2022-01-29,Kings,031,150075,47658,45047,3162,48209,397
2022-01-29,Lake,033,64148,9523,8747,724,9471,119
2022-01-29,Lassen,035,31185,8349,7961,801,8762,55
2022-01-29,Los Angeles,037,10098052,2597515,2473332,117168,2590500,28467
2022-01-29,Madera,039,155013,34397,32753,5003,37756,329
2022-01-29,Marin,041,260295,31258,30137,1996,32133,253
2022-01-29,Mariposa,043,17540,2221,2117,134,2251,6
2022-01-29,Mendocino,045,87422,12068,11591,2344,13935,104
2022-01-29,Merced,047,269075,58555,56472,6957,63429,735
2022-01-29,Modoc,049,8938,668,654,230,884,6
2022-01-29,Mono,051,14174,2884,2860,114,2974,5
2022-01-29,Monterey,053,433212,73281,64090,10928,75018,658
2022-01-29,Napa,055,140530,23548,22121,800,22921,113
2022-01-29,Nevada,057,99092,14977,14337,1013,15350,112
2022-01-29,Orange,059,3164182,525647,511255,38694,549949,6038
2022-01-29,Placer,061,380077,59193,56562,6850,63412,523
2022-01-29,Plumas,063,18699,2749,2463,272,2735,12
2022-01-29,Riverside,065,2383286,568035,548121,26205,574326,5726
2022-01-29,Sacramento,067,1510023,263536,249130,23171,272301,2558
2022-01-29,San Benito,069,59416,12033,11670,465,12135,90
2022-01-29,San Bernardino,071,2135413,550493,525249,23562,548811,6297
2022-01-29,San Diego,073,3302833,709335,683027,48534,731561,4643
2022-01-29,San Francisco,075,870044,115147,108265,7592,115857,712
2022-01-29,San Joaquin,077,732212,156866,150849,9285,160134,1971
2022-01-29,San Luis Obispo,079,281455,48499,46374,3240,49614,391
2022-01-29,San Mateo,081,765935,113691,100306,6176,106482,586
2022-01-29,Santa Barbara,083,443738,79769,76546,4242,80788,604
2022-01-29,Santa Clara,085,1922200,286366,273879,10867,284746,2019
2022-01-29,Santa Cruz,087,273765,42323,39228,1933,41161,240
2022-01-29,Shasta,089,179085,28463,27504,5457,32961,452
2022-01-29,Sierra,091,2930,265,260,43,303,0
2022-01-29,Siskiyou,093,43540,4128,3987,2367,6354,66
2022-01-29,Solano,095,438530,75182,69862,5027,74889,407
2022-01-29,Sonoma,097,501317,77360,73439,2147,75586,427
2022-01-29,Stanislaus,099,539301,110661,107668,15667,123335,1403
2022-01-29,Sutter,101,95872,19325,18797,1579,20376,202
2022-01-29,Tehama,103,63373,11225,10880,2393,13273,145
2022-01-29,Trinity,105,12862,1106,1033,258,1291,19
2022-01-29,Tulare,107,460477,99192,93154,24763,117917,1237
2022-01-29,Tuolumne,109,53932,11695,10806,411,11217,91
2022-01-29,Ventura,111,848112,165226,160466,8960,169426,1271
2022-01-29,Yolo,113,214977,34349,32123,2660,34783,275
2022-01-29,Yuba,115,75493,14774,14295,996,15291,103
2022-01-28,Alameda,001,1643700,236429,225602,12140,237742,1605
2022-01-28,Alpine,003,1148,119,123,1,124,0
2022-01-28,Amador,005,37829,7841,7505,508,8013,73
2022-01-28,Butte,007,227075,30738,29557,6229,35786,353
2022-01-28,Calaveras,009,45235,6753,6484,272,6756,96
2022-01-28,Colusa,011,21464,3240,3107,970,4077,21
2022-01-28,Contra Costa,013,1133247,176430,168003,11291,179294,1101
2022-01-28,Del Norte,015,27424,4897,4589,127,4716,43
2022-01-28,El Dorado,017,186661,25334,24008,2945,26953,184
2022-01-28,Fresno,019,978130,212871,202691,21060,223751,2457
2022-01-28,Glenn,021,27897,4670,4516,1472,5988,39
2022-01-28,Humboldt,023,135768,15327,14812,2397,17209,126
2022-01-28,Imperial,025,180216,52123,50153,9342,59495,845
2022-01-28,Inyo,027,18085,3936,3895,398,4293,50
2022-01-28,Kern,029,883053,181446,174456,41908,216364,1962
2022-01-28,Kings,031,150075,47527,45047,3152,48199,397
2022-01-28,Lake,033,64148,9491,8747,722,9469,119
2022-01-28,Lassen,035,31185,8279,7961,799,8760,55
2022-01-28,Los Angeles,037,10098052,2591790,2473332,116954,2590286,28467
2022-01-28,Madera,039,155013,34269,32753,4987,37740,329
2022-01-28,Marin,041,260295,31165,30137,1976,32113,253
2022-01-28,Mariposa,043,17540,2211,2117,132,2249,6
2022-01-28,Mendocino,045,87422,12025,11591,2342,13933,104
2022-01-28,Merced,047,269075,58459,56472,6943,63415,735
2022-01-28,Modoc,049,8938,667,654,230,884,6
2022-01-28,Mono,051,14174,2879,2860,113,2973,5
2022-01-28,Monterey,053,433212,73079,64090,10879,74969,658
2022-01-28,Napa,055,140530,23470,22121,798,22919,113
2022-01-28,Nevada,057,99092,14940,14337,1011,15348,112
2022-01-28,Orange,059,3164182,524578,511255,38605,549860,6038
2022-01-28,Placer,061,380077,58990,56562,6827,63389,523
2022-01-28,Plumas,063,18699,2741,2463,270,2733,12
2022-01-28,Riverside,065,2383286,566712,548121,26164,574285,5726
2022-01-28,Sacramento,067,1510023,262756,249130,23118,272248,2558
2022-01-28,San Benito,069,59416,12011,11670,460,12130,90
2022-01-28,San Bernardino,071,2135413,549453,525249,23525,548774,6297
2022-01-28,San Diego,073,3302833,707511,683027,48457,731484,4643
2022-01-28,San Francisco,075,870044,114792,108265,7543,115808,712
2022-01-28,San Joaquin,077,732212,156577,150849,9271,160120,1971
2022-01-28,San Luis Obispo,079,281455,48415,46374,3233,49607,391
2022-01-28,San Mateo,081,765935,113339,100306,6155,106461,586
2022-01-28,Santa Barbara,083,443738,79520,76546,4240,80786,604
2022-01-28,Santa Clara,085,1922200,285183,273879,10818,284697,2019
2022-01-28,Santa Cruz,087,273765,42131,39228,1922,41150,240
2022-01-28,Shasta,089,179085,28403,27504,5443,32947,452
2022-01-28,Sierra,091,2930,265,260,43,303,0
2022-01-28,Siskiyou,093,43540,4118,3987,2363,6350,66
2022-01-28,Solano,095,438530,74630,69862,4961,74823,407
2022-01-28,Sonoma,097,501317,77154,73439,2140,75579,427
2022-01-28,Stanislaus,099,539301,110388,107668,15625,123293,1403
2022-01-28,Sutter,101,95872,19280,18797,1577,20374,202
2022-01-28,Tehama,103,63373,11193,10880,2386,13266,145
2022-01-28,Trinity,105,12862,1097,1033,258,1291,19
2022-01-28,Tulare,107,460477,98917,93154,24657,117811,1237
2022-01-28,Tuolumne,109,53932,11662,10806,407,11213,91
2022-01-28,Ventura,111,848112,164771,160466,8941,169407,1271
2022-01-28,Yolo,113,214977,34244,32123,2654,34777,275
2022-01-28,Yuba,115,75493,14735,14295,992,15287,103
2022-01-27,Alameda,001,1643700,234847,225602,12006,237608,1605
2022-01-27,Alpine,003,1148,119,123,1,124,0
2022-01-27,Amador,005,37829,7794,7505,497,8002,73
2022-01-27,Butte,007,227075,30584,29557,6176,35733,353
2022-01-27,Calaveras,009,45235,6727,6484,256,6740,96
2022-01-27,Colusa,011,21464,3225,3107,966,4073,21
2022-01-27,Contra Costa,013,1133247,175414,168003,11121,179124,1101
2022-01-27,Del Norte,015,27424,4853,4589,123,4712,43
2022-01-27,El Dorado,017,186661,25223,24008,2925,26933,184
2022-01-27,Fresno,019,978130,211242,202691,20846,223537,2457
2022-01-27,Glenn,021,27897,4639,4516,1464,5980,39
2022-01-27,Humboldt,023,135768,15239,14812,2360,17172,126
2022-01-27,Imperial,025,180216,51854,50153,9230,59383,845
2022-01-27,Inyo,027,18085,3929,3895,388,4283,50
2022-01-27,Kern,029,883053,180666,174456,41548,216004,1962
2022-01-27,Kings,031,150075,47185,45047,3114,48161,397
2022-01-27,Lake,033,64148,9438,8747,705,9452,119
2022-01-27,Lassen,035,31185,8238,7961,793,8754,55
2022-01-27,Los Angeles,037,10098052,2580645,2473332,116445,2589777,28467
2022-01-27,Madera,039,155013,34059,32753,4885,37638,329
2022-01-27,Marin,041,260295,31002,30137,1961,32098,253
2022-01-27,Mariposa,043,17540,2188,2117,129,2246,6
2022-01-27,Mendocino,045,87422,11974,11591,2293,13884,104
2022-01-27,Merced,047,269075,58197,56472,6780,63252,735
2022-01-27,Modoc,049,8938,665,654,229,883,6
2022-01-27,Mono,051,14174,2874,2860,113,2973,5
2022-01-27,Monterey,053,433212,72458,64090,10634,74724,658
2022-01-27,Napa,055,140530,23313,22121,771,22892,113
2022-01-27,Nevada,057,99092,14867,14337,984,15321,112
2022-01-27,Orange,059,3164182,522852,511255,38469,549724,6038
2022-01-27,Placer,061,380077,58673,56562,6775,63337,523
2022-01-27,Plumas,063,18699,2730,2463,258,2721,12
2022-01-27,Riverside,065,2383286,564538,548121,26095,574216,5726
2022-01-27,Sacramento,067,1510023,261475,249130,22792,271922,2558
2022-01-27,San Benito,069,59416,11956,11670,455,12125,90
2022-01-27,San Bernardino,071,2135413,547553,525249,23425,548674,6297
2022-01-27,San Diego,073,3302833,704166,683027,48100,731127,4643
2022-01-27,San Francisco,075,870044,114285,108265,7484,115749,712
2022-01-27,San Joaquin,077,732212,155718,150849,9205,160054,1971
2022-01-27,San Luis Obispo,079,281455,48144,46374,3198,49572,391
2022-01-27,San Mateo,081,765935,112755,100306,6086,106392,586
2022-01-27,Santa Barbara,083,443738,79041,76546,4185,80731,604
2022-01-27,Santa Clara,085,1922200,283122,273879,10671,284550,2019
2022-01-27,Santa Cruz,087,273765,41467,39228,1904,41132,240
2022-01-27,Shasta,089,179085,28277,27504,5394,32898,452
2022-01-27,Sierra,091,2930,264,260,42,302,0
2022-01-27,Siskiyou,093,43540,4097,3987,2326,6313,66
2022-01-27,Solano,095,438530,73991,69862,4904,74766,407
2022-01-27,Sonoma,097,501317,76687,73439,2127,75566,427
2022-01-27,Stanislaus,099,539301,109861,107668,15482,123150,1403
2022-01-27,Sutter,101,95872,19175,18797,1552,20349,202
2022-01-27,Tehama,103,63373,11141,10880,2370,13250,145
2022-01-27,Trinity,105,12862,1093,1033,257,1290,19
2022-01-27,Tulare,107,460477,98253,93154,24395,117549,1237
2022-01-27,Tuolumne,109,53932,11609,10806,398,11204,91
2022-01-27,Ventura,111,848112,164120,160466,8905,169371,1271
2022-01-27,Yolo,113,214977,34099,32123,2639,34762,275
2022-01-27,Yuba,115,75493,14657,14295,976,15271,103
2022-01-26,Alameda,001,1643700,232946,222680,11837,234517,1596
2022-01-26,Alpine,003,1148,119,123,1,124,0
2022-01-26,Amador,005,37829,7720,7427,482,7909,73
2022-01-26,Butte,007,227075,30386,29229,6112,35341,353
2022-01-26,Calaveras,009,45235,6689,6387,250,6637,96
2022-01-26,Colusa,011,21464,3207,3094,961,4055,21
2022-01-26,Contra Costa,013,1133247,174269,165972,10955,176927,1095
2022-01-26,Del Norte,015,27424,4795,4542,122,4664,43
2022-01-26,El Dorado,017,186661,25104,23819,2902,26721,181
2022-01-26,Fresno,019,978130,209390,199689,20633,220322,2452
2022-01-26,Glenn,021,27897,4606,4472,1459,5931,39
2022-01-26,Humboldt,023,135768,15140,14715,2317,17032,126
2022-01-26,Imperial,025,180216,51497,49477,9086,58563,839
2022-01-26,Inyo,027,18085,3926,3889,358,4247,50
2022-01-26,Kern,029,883053,179728,173052,41209,214261,1953
2022-01-26,Kings,031,150075,46780,44367,3085,47452,396
2022-01-26,Lake,033,64148,9356,8645,695,9340,119
2022-01-26,Lassen,035,31185,8198,7888,793,8681,55
2022-01-26,Los Angeles,037,10098052,2568443,2450620,115997,2566617,28382
2022-01-26,Madera,039,155013,33821,32323,4748,37071,329
2022-01-26,Marin,041,260295,30820,29813,1944,31757,253
2022-01-26,Mariposa,043,17540,2171,2108,122,2230,6
2022-01-26,Mendocino,045,87422,11927,11453,2242,13695,103
2022-01-26,Merced,047,269075,57828,56060,6604,62664,733
2022-01-26,Modoc,049,8938,664,652,228,880,6
2022-01-26,Mono,051,14174,2871,2852,113,2965,4
2022-01-26,Monterey,053,433212,71902,63264,10345,73609,659
2022-01-26,Napa,055,140530,23157,21864,761,22625,112
2022-01-26,Nevada,057,99092,14773,14128,973,15101,112
2022-01-26,Orange,059,3164182,520864,506419,38307,544726,6007
2022-01-26,Placer,061,380077,58334,55892,6713,62605,524
2022-01-26,Plumas,063,18699,2703,2425,256,2681,12
2022-01-26,Riverside,065,2383286,562013,543788,25979,569767,5701
2022-01-26,Sacramento,067,1510023,259782,246416,22465,268881,2559
2022-01-26,San Benito,069,59416,11885,11563,443,12006,90
2022-01-26,San Bernardino,071,2135413,545306,521699,23318,545017,6291
2022-01-26,San Diego,073,3302833,699945,676392,47742,724134,4622
2022-01-26,San Francisco,075,870044,113650,107174,7451,114625,704
2022-01-26,San Joaquin,077,732212,154728,148770,9151,157921,1971
2022-01-26,San Luis Obispo,079,281455,47840,45716,3171,48887,391
2022-01-26,San Mateo,081,765935,112089,99016,5961,104977,586
2022-01-26,Santa Barbara,083,443738,78512,75548,4125,79673,600
2022-01-26,Santa Clara,085,1922200,281034,270470,10501,280971,2015
2022-01-26,Santa Cruz,087,273765,40949,38298,1890,40188,239
2022-01-26,Shasta,089,179085,28129,27255,5348,32603,452
2022-01-26,Sierra,091,2930,264,260,41,301,0
2022-01-26,Siskiyou,093,43540,4081,3971,2301,6272,66
2022-01-26,Solano,095,438530,73296,69150,4837,73987,401
2022-01-26,Sonoma,097,501317,76127,72509,2092,74601,423
2022-01-26,Stanislaus,099,539301,109304,106582,15269,121851,1396
2022-01-26,Sutter,101,95872,19065,18670,1508,20178,202
2022-01-26,Tehama,103,63373,11087,10749,2356,13105,145
2022-01-26,Trinity,105,12862,1088,1008,257,1265,19
2022-01-26,Tulare,107,460477,97443,91904,24156,116060,1234
2022-01-26,Tuolumne,109,53932,11426,10699,387,11086,91
2022-01-26,Ventura,111,848112,163408,159077,8863,167940,1263
2022-01-26,Yolo,113,214977,33882,31913,2601,34514,275
2022-01-26,Yuba,115,75493,14572,14171,954,15125,103
2022-01-25,Alameda,001,1643700,231054,219753,11660,231413,1589
2022-01-25,Alpine,003,1148,119,122,1,123,0
2022-01-25,Amador,005,37829,7643,7352,471,7823,73
2022-01-25,Butte,007,227075,30179,28887,6037,34924,351
2022-01-25,Calaveras,009,45235,6631,6266,237,6503,95
2022-01-25,Colusa,011,21464,3187,3074,959,4033,21
2022-01-25,Contra Costa,013,1133247,172940,163792,10739,174531,1092
2022-01-25,Del Norte,015,27424,4725,4514,117,4631,43
2022-01-25,El Dorado,017,186661,24968,23339,2876,26215,179
2022-01-25,Fresno,019,978130,207247,198262,20349,218611,2434
2022-01-25,Glenn,021,27897,4574,4418,1443,5861,39
2022-01-25,Humboldt,023,135768,15048,14574,2291,16865,126
2022-01-25,Imperial,025,180216,51042,48913,8865,57778,832
2022-01-25,Inyo,027,18085,3911,3857,315,4172,50
2022-01-25,Kern,029,883053,178723,171695,40761,212456,1947
2022-01-25,Kings,031,150075,46310,43853,3040,46893,396
2022-01-25,Lake,033,64148,9277,8543,683,9226,118
2022-01-25,Lassen,035,31185,8167,7834,784,8618,55
2022-01-25,Los Angeles,037,10098052,2553506,2433516,115361,2548877,28293
2022-01-25,Madera,039,155013,33499,31794,4615,36409,329
2022-01-25,Marin,041,260295,30642,29589,1931,31520,253
2022-01-25,Mariposa,043,17540,2159,2069,116,2185,6
2022-01-25,Mendocino,045,87422,11807,11280,2139,13419,103
2022-01-25,Merced,047,269075,57446,55555,6467,62022,733
2022-01-25,Modoc,049,8938,662,652,228,880,6
2022-01-25,Mono,051,14174,2861,2826,112,2938,4
2022-01-25,Monterey,053,433212,71328,62498,9944,72442,654
2022-01-25,Napa,055,140530,22962,21668,727,22395,111
2022-01-25,Nevada,057,99092,14661,13944,951,14895,112
2022-01-25,Orange,059,3164182,518583,504274,38114,542388,5980
2022-01-25,Placer,061,380077,57932,55465,6640,62105,518
2022-01-25,Plumas,063,18699,2678,2397,252,2649,12
2022-01-25,Riverside,065,2383286,558921,540723,25815,566538,5686
2022-01-25,Sacramento,067,1510023,257844,244468,21939,266407,2545
2022-01-25,San Benito,069,59416,11785,11446,439,11885,88
2022-01-25,San Bernardino,071,2135413,542749,519150,23204,542354,6288
2022-01-25,San Diego,073,3302833,694947,670110,47291,717401,4604
2022-01-25,San Francisco,075,870044,112889,106254,7409,113663,703
2022-01-25,San Joaquin,077,732212,153736,147271,9087,156358,1972
2022-01-25,San Luis Obispo,079,281455,47478,45130,3123,48253,391
2022-01-25,San Mateo,081,765935,111255,98010,5850,103860,586
2022-01-25,Santa Barbara,083,443738,77844,74686,4046,78732,594
2022-01-25,Santa Clara,085,1922200,278421,268031,10299,278330,2006
2022-01-25,Santa Cruz,087,273765,40277,37850,1875,39725,237
2022-01-25,Shasta,089,179085,27967,27090,5282,32372,452
2022-01-25,Sierra,091,2930,264,260,37,297,0
2022-01-25,Siskiyou,093,43540,4057,3958,2266,6224,65
2022-01-25,Solano,095,438530,72728,68657,4778,73435,399
2022-01-25,Sonoma,097,501317,75437,71633,2052,73685,423
2022-01-25,Stanislaus,099,539301,108634,105965,15051,121016,1396
2022-01-25,Sutter,101,95872,18962,18508,1468,19976,200
2022-01-25,Tehama,103,63373,11024,10669,2332,13001,145
2022-01-25,Trinity,105,12862,1081,999,255,1254,19
2022-01-25,Tulare,107,460477,96573,91237,23837,115074,1229
2022-01-25,Tuolumne,109,53932,11244,10516,364,10880,91
2022-01-25,Ventura,111,848112,162554,157971,8814,166785,1263
2022-01-25,Yolo,113,214977,33623,31677,2557,34234,274
2022-01-25,Yuba,115,75493,14487,14038,927,14965,103
2022-01-24,Alameda,001,1643700,228596,216252,11393,227645,1581
2022-01-24,Alpine,003,1148,119,120,1,121,0
2022-01-24,Amador,005,37829,7592,7166,434,7600,73
2022-01-24,Butte,007,227075,29951,28607,5971,34578,350
2022-01-24,Calaveras,009,45235,6583,6172,223,6395,95
2022-01-24,Colusa,011,21464,3168,3052,943,3995,21
2022-01-24,Contra Costa,013,1133247,171442,162161,10525,172686,1092
2022-01-24,Del Norte,015,27424,4665,4460,117,4577,43
2022-01-24,El Dorado,017,186661,24801,23128,2847,25975,179
2022-01-24,Fresno,019,978130,204946,196092,20044,216136,2430
2022-01-24,Glenn,021,27897,4533,4367,1434,5801,39
2022-01-24,Humboldt,023,135768,14936,14416,2246,16662,126
2022-01-24,Imperial,025,180216,50498,48228,8583,56811,824
2022-01-24,Inyo,027,18085,3905,3805,291,4096,50
2022-01-24,Kern,029,883053,177417,169892,40292,210184,1946
2022-01-24,Kings,031,150075,45737,43260,2969,46229,396
2022-01-24,Lake,033,64148,9168,8423,668,9091,118
2022-01-24,Lassen,035,31185,8083,7732,765,8497,55
2022-01-24,Los Angeles,037,10098052,2536982,2391045,114586,2505631,28230
2022-01-24,Madera,039,155013,33063,31339,4431,35770,329
2022-01-24,Marin,041,260295,30411,29301,1894,31195,253
2022-01-24,Mariposa,043,17540,2134,2033,112,2145,6
2022-01-24,Mendocino,045,87422,11703,11002,2060,13062,103
2022-01-24,Merced,047,269075,56954,54970,6186,61156,730
2022-01-24,Modoc,049,8938,659,648,227,875,6
2022-01-24,Mono,051,14174,2851,2802,111,2913,4
2022-01-24,Monterey,053,433212,70468,61975,9589,71564,654
2022-01-24,Napa,055,140530,22782,21494,715,22209,111
2022-01-24,Nevada,057,99092,14534,13774,928,14702,112
2022-01-24,Orange,059,3164182,516009,501634,37851,539485,5969
2022-01-24,Placer,061,380077,57451,54933,6591,61524,518
2022-01-24,Plumas,063,18699,2647,2370,238,2608,12
2022-01-24,Riverside,065,2383286,555193,535962,25607,561569,5661
2022-01-24,Sacramento,067,1510023,255478,241522,21383,262905,2526
2022-01-24,San Benito,069,59416,11688,11331,426,11757,88
2022-01-24,San Bernardino,071,2135413,539817,515604,23043,538647,6285
2022-01-24,San Diego,073,3302833,689289,663580,46741,710321,4586
2022-01-24,San Francisco,075,870044,111929,105418,7313,112731,703
2022-01-24,San Joaquin,077,732212,152424,145984,9012,154996,1959
2022-01-24,San Luis Obispo,079,281455,47007,44616,3069,47685,387
2022-01-24,San Mateo,081,765935,110292,96968,5737,102705,586
2022-01-24,Santa Barbara,083,443738,77033,73866,3953,77819,591
2022-01-24,Santa Clara,085,1922200,275549,265341,10088,275429,2006
2022-01-24,Santa Cruz,087,273765,39479,37188,1857,39045,237
2022-01-24,Shasta,089,179085,27784,26871,5194,32065,452
2022-01-24,Sierra,091,2930,264,258,37,295,0
2022-01-24,Siskiyou,093,43540,4048,3934,2227,6161,64
2022-01-24,Solano,095,438530,72046,68094,4701,72795,400
2022-01-24,Sonoma,097,501317,74522,70733,2021,72754,423
2022-01-24,Stanislaus,099,539301,107877,104933,14780,119713,1395
2022-01-24,Sutter,101,95872,18846,18336,1382,19718,200
2022-01-24,Tehama,103,63373,10954,10567,2312,12879,145
2022-01-24,Trinity,105,12862,1072,978,253,1231,19
2022-01-24,Tulare,107,460477,95505,90089,23477,113566,1219
2022-01-24,Tuolumne,109,53932,11123,10374,356,10730,91
2022-01-24,Ventura,111,848112,161531,156551,8769,165320,1261
2022-01-24,Yolo,113,214977,33330,31480,2528,34008,273
2022-01-24,Yuba,115,75493,14380,13862,888,14750,103
2022-01-23,Alameda,001,1643700,225884,214003,11067,225070,1583
2022-01-23,Alpine,003,1148,119,120,1,121,0
2022-01-23,Amador,005,37829,7536,7090,394,7484,73
2022-01-23,Butte,007,227075,29656,28340,5845,34185,350
2022-01-23,Calaveras,009,45235,6518,6095,202,6297,95
2022-01-23,Colusa,011,21464,3144,3040,936,3976,21
2022-01-23,Contra Costa,013,1133247,169584,160798,10170,170968,1092
2022-01-23,Del Norte,015,27424,4597,4419,111,4530,43
2022-01-23,El Dorado,017,186661,24610,22925,2800,25725,179
2022-01-23,Fresno,019,978130,202477,193642,19578,213220,2430
2022-01-23,Glenn,021,27897,4482,4340,1412,5752,39
2022-01-23,Humboldt,023,135768,14814,14296,2164,16460,126
2022-01-23,Imperial,025,180216,49900,47935,8299,56234,824
2022-01-23,Inyo,027,18085,3878,3781,277,4058,50
2022-01-23,Kern,029,883053,176054,168585,39767,208352,1946
2022-01-23,Kings,031,150075,45102,42622,2867,45489,397
2022-01-23,Lake,033,64148,8998,8363,642,9005,118
2022-01-23,Lassen,035,31185,8034,7710,741,8451,55
2022-01-23,Los Angeles,037,10098052,2516674,2390590,113442,2504032,28231
2022-01-23,Madera,039,155013,32704,30962,4195,35157,329
2022-01-23,Marin,041,260295,30158,29025,1856,30881,253
2022-01-23,Mariposa,043,17540,2119,2011,109,2120,6
2022-01-23,Mendocino,045,87422,11578,10889,1932,12821,103
2022-01-23,Merced,047,269075,56401,54644,5740,60384,730
2022-01-23,Modoc,049,8938,657,645,224,869,6
2022-01-23,Mono,051,14174,2843,2788,109,2897,4
2022-01-23,Monterey,053,433212,69631,61522,9157,70679,654
2022-01-23,Napa,055,140530,22520,21281,702,21983,111
2022-01-23,Nevada,057,99092,14372,13629,899,14528,112
2022-01-23,Orange,059,3164182,512911,498968,37560,536528,5970
2022-01-23,Placer,061,380077,56880,54568,6503,61071,518
2022-01-23,Plumas,063,18699,2614,2368,209,2577,12
2022-01-23,Riverside,065,2383286,550752,532273,25305,557578,5661
2022-01-23,Sacramento,067,1510023,252837,239589,20444,260033,2530
2022-01-23,San Benito,069,59416,11566,11225,415,11640,88
2022-01-23,San Bernardino,071,2135413,536358,512657,22768,535425,6281
2022-01-23,San Diego,073,3302833,682679,640215,45940,686155,4566
2022-01-23,San Francisco,075,870044,110863,104485,7206,111691,704
2022-01-23,San Joaquin,077,732212,150809,144621,8930,153551,1959
2022-01-23,San Luis Obispo,079,281455,46311,44183,2995,47178,386
2022-01-23,San Mateo,081,765935,109176,95940,5593,101533,586
2022-01-23,Santa Barbara,083,443738,75910,73041,3830,76871,590
2022-01-23,Santa Clara,085,1922200,272251,261991,9769,271760,2005
2022-01-23,Santa Cruz,087,273765,38948,36547,1826,38373,237
2022-01-23,Shasta,089,179085,27504,26732,5074,31806,452
2022-01-23,Sierra,091,2930,263,252,37,289,0
2022-01-23,Siskiyou,093,43540,4023,3916,2170,6086,64
2022-01-23,Solano,095,438530,71249,67457,4607,72064,400
2022-01-23,Sonoma,097,501317,73567,69791,1966,71757,423
2022-01-23,Stanislaus,099,539301,107018,104067,14500,118567,1395
2022-01-23,Sutter,101,95872,18689,18175,1269,19444,200
2022-01-23,Tehama,103,63373,10856,10481,2280,12761,145
2022-01-23,Trinity,105,12862,1069,961,251,1212,19
2022-01-23,Tulare,107,460477,94246,89120,23065,112185,1219
2022-01-23,Tuolumne,109,53932,10931,10243,339,10582,91
2022-01-23,Ventura,111,848112,160349,155052,8692,163744,1261
2022-01-23,Yolo,113,214977,32952,30908,2488,33396,273
2022-01-23,Yuba,115,75493,14256,13762,835,14597,103
2022-01-22,Alameda,001,1643700,224793,203927,11036,214963,1575
2022-01-22,Alpine,003,1148,118,119,1,120,0
2022-01-22,Amador,005,37829,7502,6845,389,7234,73
2022-01-22,Butte,007,227075,29536,27232,5814,33046,350
2022-01-22,Calaveras,009,45235,6488,5835,201,6036,95
2022-01-22,Colusa,011,21464,3127,2954,933,3887,21
2022-01-22,Contra Costa,013,1133247,168649,154111,10140,164251,1091
2022-01-22,Del Norte,015,27424,4558,4269,107,4376,43
2022-01-22,El Dorado,017,186661,24541,22273,2790,25063,179
2022-01-22,Fresno,019,978130,201659,185292,19512,204804,2429
2022-01-22,Glenn,021,27897,4476,4174,1409,5583,39
2022-01-22,Humboldt,023,135768,14747,13628,2151,15779,125
2022-01-22,Imperial,025,180216,49710,45741,8240,53981,820
2022-01-22,Inyo,027,18085,3874,3706,253,3959,50
2022-01-22,Kern,029,883053,175428,162902,39467,202369,1946
2022-01-22,Kings,031,150075,44894,40580,2854,43434,396
2022-01-22,Lake,033,64148,8964,8056,634,8690,118
2022-01-22,Lassen,035,31185,8000,7545,734,8279,55
2022-01-22,Los Angeles,037,10098052,2509276,2286280,112934,2399214,28038
2022-01-22,Madera,039,155013,32585,29595,4180,33775,329
2022-01-22,Marin,041,260295,30031,27893,1851,29744,253
2022-01-22,Mariposa,043,17540,2115,1920,109,2029,6
2022-01-22,Mendocino,045,87422,11528,10395,1910,12305,103
2022-01-22,Merced,047,269075,56248,53025,5733,58758,727
2022-01-22,Modoc,049,8938,656,639,224,863,6
2022-01-22,Mono,051,14174,2842,2723,105,2828,4
2022-01-22,Monterey,053,433212,69425,59038,9115,68153,651
2022-01-22,Napa,055,140530,22425,20402,692,21094,111
2022-01-22,Nevada,057,99092,14304,12957,891,13848,112
2022-01-22,Orange,059,3164182,511306,480329,37312,517641,5946
2022-01-22,Placer,061,380077,56610,52557,6466,59023,512
2022-01-22,Plumas,063,18699,2597,2289,205,2494,12
2022-01-22,Riverside,065,2383286,548836,513567,25232,538799,5623
2022-01-22,Sacramento,067,1510023,251788,230206,20344,250550,2510
2022-01-22,San Benito,069,59416,11508,10743,410,11153,88
2022-01-22,San Bernardino,071,2135413,534839,495209,22676,517885,6267
2022-01-22,San Diego,073,3302833,680187,628904,45726,674630,4559
2022-01-22,San Francisco,075,870044,110207,100238,7058,107296,702
2022-01-22,San Joaquin,077,732212,150369,138264,8889,147153,1960
2022-01-22,San Luis Obispo,079,281455,46192,42154,2989,45143,385
2022-01-22,San Mateo,081,765935,108591,91440,5531,96971,585
2022-01-22,Santa Barbara,083,443738,75488,69555,3824,73379,589
2022-01-22,Santa Clara,085,1922200,270572,249205,9703,258908,1993
2022-01-22,Santa Cruz,087,273765,38766,33741,1820,35561,237
2022-01-22,Shasta,089,179085,27408,25919,5052,30971,450
2022-01-22,Sierra,091,2930,263,248,36,284,0
2022-01-22,Siskiyou,093,43540,4005,3845,2149,5994,62
2022-01-22,Solano,095,438530,71026,63882,4569,68451,391
2022-01-22,Sonoma,097,501317,73147,66013,1956,67969,422
2022-01-22,Stanislaus,099,539301,106560,100092,14409,114501,1393
2022-01-22,Sutter,101,95872,18621,17616,1256,18872,199
2022-01-22,Tehama,103,63373,10821,10171,2269,12440,142
2022-01-22,Trinity,105,12862,1067,925,251,1176,19
2022-01-22,Tulare,107,460477,93866,85223,22943,108166,1211
2022-01-22,Tuolumne,109,53932,10863,9731,333,10064,91
2022-01-22,Ventura,111,848112,159658,148742,8652,157394,1250
2022-01-22,Yolo,113,214977,32773,30061,2471,32532,273
2022-01-22,Yuba,115,75493,14167,13288,831,14119,103
2022-01-21,Alameda,001,1643700,223216,203927,11005,214932,1575
2022-01-21,Alpine,003,1148,118,119,1,120,0
2022-01-21,Amador,005,37829,7445,6845,386,7231,73
2022-01-21,Butte,007,227075,29410,27232,5771,33003,350
2022-01-21,Calaveras,009,45235,6442,5835,201,6036,95
2022-01-21,Colusa,011,21464,3120,2954,928,3882,21
2022-01-21,Contra Costa,013,1133247,167590,154111,10062,164173,1091
2022-01-21,Del Norte,015,27424,4518,4269,107,4376,43
2022-01-21,El Dorado,017,186661,24458,22273,2776,25049,179
2022-01-21,Fresno,019,978130,200415,185292,19417,204709,2429
2022-01-21,Glenn,021,27897,4456,4174,1404,5578,39
2022-01-21,Humboldt,023,135768,14678,13628,2132,15760,125
2022-01-21,Imperial,025,180216,49520,45741,8164,53905,820
2022-01-21,Inyo,027,18085,3861,3706,248,3954,50
2022-01-21,Kern,029,883053,174710,162902,39097,201999,1946
2022-01-21,Kings,031,150075,44697,40580,2846,43426,396
2022-01-21,Lake,033,64148,8907,8056,622,8678,118
2022-01-21,Lassen,035,31185,7951,7545,730,8275,55
2022-01-21,Los Angeles,037,10098052,2497975,2286280,112475,2398755,28038
2022-01-21,Madera,039,155013,32294,29595,4152,33747,329
2022-01-21,Marin,041,260295,29854,27893,1832,29725,253
2022-01-21,Mariposa,043,17540,2103,1920,108,2028,6
2022-01-21,Mendocino,045,87422,11447,10395,1907,12302,103
2022-01-21,Merced,047,269075,56089,53025,5729,58754,727
2022-01-21,Modoc,049,8938,655,639,224,863,6
2022-01-21,Mono,051,14174,2828,2723,102,2825,4
2022-01-21,Monterey,053,433212,68954,59038,8989,68027,651
2022-01-21,Napa,055,140530,22305,20402,684,21086,111
2022-01-21,Nevada,057,99092,14206,12957,887,13844,112
2022-01-21,Orange,059,3164182,509068,480329,37067,517396,5946
2022-01-21,Placer,061,380077,56217,52557,6404,58961,512
2022-01-21,Plumas,063,18699,2585,2289,200,2489,12
2022-01-21,Riverside,065,2383286,546180,513567,25153,538720,5623
2022-01-21,Sacramento,067,1510023,250344,230206,20243,250449,2510
2022-01-21,San Benito,069,59416,11472,10743,407,11150,88
2022-01-21,San Bernardino,071,2135413,532794,495209,22603,517812,6267
2022-01-21,San Diego,073,3302833,676018,628904,45549,674453,4559
2022-01-21,San Francisco,075,870044,109448,100238,6970,107208,702
2022-01-21,San Joaquin,077,732212,149771,138264,8834,147098,1960
2022-01-21,San Luis Obispo,079,281455,46066,42154,2986,45140,385
2022-01-21,San Mateo,081,765935,107919,91440,5493,96933,585
2022-01-21,Santa Barbara,083,443738,74986,69555,3815,73370,589
2022-01-21,Santa Clara,085,1922200,268747,249205,9595,258800,1993
2022-01-21,Santa Cruz,087,273765,38047,33741,1807,35548,237
2022-01-21,Shasta,089,179085,27319,25919,5005,30924,450
2022-01-21,Sierra,091,2930,261,248,35,283,0
2022-01-21,Siskiyou,093,43540,3996,3845,2131,5976,62
2022-01-21,Solano,095,438530,70615,63882,4487,68369,391
2022-01-21,Sonoma,097,501317,72622,66013,1946,67959,422
2022-01-21,Stanislaus,099,539301,106057,100092,14348,114440,1393
2022-01-21,Sutter,101,95872,18535,17616,1242,18858,199
2022-01-21,Tehama,103,63373,10785,10171,2267,12438,142
2022-01-21,Trinity,105,12862,1061,925,250,1175,19
2022-01-21,Tulare,107,460477,93389,85223,22789,108012,1211
2022-01-21,Tuolumne,109,53932,10780,9731,326,10057,91
2022-01-21,Ventura,111,848112,158849,148742,8621,157363,1250
2022-01-21,Yolo,113,214977,32610,30061,2450,32511,273
2022-01-21,Yuba,115,75493,14095,13288,824,14112,103
2022-01-20,Alameda,001,1643700,220143,203927,10769,214696,1575
2022-01-20,Alpine,003,1148,118,119,1,120,0
2022-01-20,Amador,005,37829,7381,6845,368,7213,73
2022-01-20,Butte,007,227075,29155,27232,5691,32923,350
2022-01-20,Calaveras,009,45235,6338,5835,192,6027,95
2022-01-20,Colusa,011,21464,3090,2954,916,3870,21
2022-01-20,Contra Costa,013,1133247,165613,154111,9798,163909,1091
2022-01-20,Del Norte,015,27424,4478,4269,104,4373,43
2022-01-20,El Dorado,017,186661,24254,22273,2733,25006,179
2022-01-20,Fresno,019,978130,197816,185292,19055,204347,2429
2022-01-20,Glenn,021,27897,4421,4174,1395,5569,39
2022-01-20,Humboldt,023,135768,14549,13628,2081,15709,125
2022-01-20,Imperial,025,180216,49003,45741,7988,53729,820
2022-01-20,Inyo,027,18085,3849,3706,237,3943,50
2022-01-20,Kern,029,883053,173186,162902,38559,201461,1946
2022-01-20,Kings,031,150075,44141,40580,2806,43386,396
2022-01-20,Lake,033,64148,8811,8056,594,8650,118
2022-01-20,Lassen,035,31185,7898,7545,715,8260,55
2022-01-20,Los Angeles,037,10098052,2473247,2286280,111501,2397781,28038
2022-01-20,Madera,039,155013,31906,29595,4027,33622,329
2022-01-20,Marin,041,260295,29561,27893,1796,29689,253
2022-01-20,Mariposa,043,17540,2076,1920,105,2025,6
2022-01-20,Mendocino,045,87422,11349,10395,1829,12224,103
2022-01-20,Merced,047,269075,55659,53025,5500,58525,727
2022-01-20,Modoc,049,8938,653,639,224,863,6
2022-01-20,Mono,051,14174,2820,2723,101,2824,4
2022-01-20,Monterey,053,433212,68189,59038,8576,67614,651
2022-01-20,Napa,055,140530,22039,20402,645,21047,111
2022-01-20,Nevada,057,99092,14058,12957,865,13822,112
2022-01-20,Orange,059,3164182,505130,480329,36699,517028,5946
2022-01-20,Placer,061,380077,55730,52557,6344,58901,512
2022-01-20,Plumas,063,18699,2558,2289,196,2485,12
2022-01-20,Riverside,065,2383286,541609,513567,24922,538489,5623
2022-01-20,Sacramento,067,1510023,248054,230206,19613,249819,2510
2022-01-20,San Benito,069,59416,11361,10743,394,11137,88
2022-01-20,San Bernardino,071,2135413,528627,495209,22327,517536,6267
2022-01-20,San Diego,073,3302833,668917,628904,44846,673750,4559
2022-01-20,San Francisco,075,870044,108298,100238,6830,107068,702
2022-01-20,San Joaquin,077,732212,148135,138264,8709,146973,1960
2022-01-20,San Luis Obispo,079,281455,45554,42154,2952,45106,385
2022-01-20,San Mateo,081,765935,106694,91440,5290,96730,585
2022-01-20,Santa Barbara,083,443738,74088,69555,3703,73258,589
2022-01-20,Santa Clara,085,1922200,265439,249205,9268,258473,1993
2022-01-20,Santa Cruz,087,273765,37163,33741,1784,35525,237
2022-01-20,Shasta,089,179085,27129,25919,4938,30857,450
2022-01-20,Sierra,091,2930,261,248,33,281,0
2022-01-20,Siskiyou,093,43540,3984,3845,2098,5943,62
2022-01-20,Solano,095,438530,69668,63882,4398,68280,391
2022-01-20,Sonoma,097,501317,71596,66013,1896,67909,422
2022-01-20,Stanislaus,099,539301,105100,100092,14144,114236,1393
2022-01-20,Sutter,101,95872,18370,17616,1214,18830,199
2022-01-20,Tehama,103,63373,10712,10171,2249,12420,142
2022-01-20,Trinity,105,12862,1047,925,249,1174,19
2022-01-20,Tulare,107,460477,92340,85223,22505,107728,1211
2022-01-20,Tuolumne,109,53932,10638,9731,316,10047,91
2022-01-20,Ventura,111,848112,157464,148742,8544,157286,1250
2022-01-20,Yolo,113,214977,32321,30061,2417,32478,273
2022-01-20,Yuba,115,75493,13989,13288,791,14079,103
2022-01-19,Alameda,001,1643700,216750,199739,10440,210179,1571
2022-01-19,Alpine,003,1148,117,119,1,120,0
2022-01-19,Amador,005,37829,7300,6789,326,7115,73
2022-01-19,Butte,007,227075,28852,26839,5606,32445,351
2022-01-19,Calaveras,009,45235,6248,5765,183,5948,95
2022-01-19,Colusa,011,21464,3065,2938,909,3847,21
2022-01-19,Contra Costa,013,1133247,163278,151543,9559,161102,1091
2022-01-19,Del Norte,015,27424,4439,4240,103,4343,43
2022-01-19,El Dorado,017,186661,23999,21953,2691,24644,177
2022-01-19,Fresno,019,978130,194915,181526,18739,200265,2430
2022-01-19,Glenn,021,27897,4370,4127,1385,5512,39
2022-01-19,Humboldt,023,135768,14391,13391,2029,15420,125
2022-01-19,Imperial,025,180216,48269,45156,7788,52944,820
2022-01-19,Inyo,027,18085,3826,3680,198,3878,49
2022-01-19,Kern,029,883053,171422,160747,37882,198629,1946
2022-01-19,Kings,031,150075,43445,40027,2738,42765,395
2022-01-19,Lake,033,64148,8684,7972,581,8553,118
2022-01-19,Lassen,035,31185,7841,7507,693,8200,55
2022-01-19,Los Angeles,037,10098052,2444863,2251718,110078,2361796,27934
2022-01-19,Madera,039,155013,31525,29021,3857,32878,329
2022-01-19,Marin,041,260295,29265,27375,1753,29128,251
2022-01-19,Mariposa,043,17540,2051,1896,99,1995,6
2022-01-19,Mendocino,045,87422,11178,10252,1736,11988,103
2022-01-19,Merced,047,269075,55114,52355,5144,57499,724
2022-01-19,Modoc,049,8938,651,635,223,858,6
2022-01-19,Mono,051,14174,2798,2677,99,2776,4
2022-01-19,Monterey,053,433212,67281,58426,8120,66546,651
2022-01-19,Napa,055,140530,21786,20090,618,20708,110
2022-01-19,Nevada,057,99092,13901,12703,838,13541,112
2022-01-19,Orange,059,3164182,500646,468460,36330,504790,5943
2022-01-19,Placer,061,380077,55166,51545,6276,57821,511
2022-01-19,Plumas,063,18699,2518,2239,190,2429,12
2022-01-19,Riverside,065,2383286,536085,503575,24687,528262,5604
2022-01-19,Sacramento,067,1510023,245165,226035,18897,244932,2512
2022-01-19,San Benito,069,59416,11220,10639,382,11021,88
2022-01-19,San Bernardino,071,2135413,523976,487846,21955,509801,6265
2022-01-19,San Diego,073,3302833,660140,614709,44113,658822,4553
2022-01-19,San Francisco,075,870044,106926,98652,6753,105405,694
2022-01-19,San Joaquin,077,732212,146242,135953,8586,144539,1959
2022-01-19,San Luis Obispo,079,281455,44955,41374,2886,44260,382
2022-01-19,San Mateo,081,765935,105283,89715,5026,94741,585
2022-01-19,Santa Barbara,083,443738,73091,68531,3604,72135,586
2022-01-19,Santa Clara,085,1922200,261712,244922,8908,253830,1991
2022-01-19,Santa Cruz,087,273765,35861,33026,1760,34786,237
2022-01-19,Shasta,089,179085,26862,25355,4866,30221,450
2022-01-19,Sierra,091,2930,261,245,32,277,0
2022-01-19,Siskiyou,093,43540,3960,3821,2045,5866,62
2022-01-19,Solano,095,438530,68827,63003,4268,67271,392
2022-01-19,Sonoma,097,501317,70497,64689,1851,66540,420
2022-01-19,Stanislaus,099,539301,104048,98952,13855,112807,1381
2022-01-19,Sutter,101,95872,18203,17436,1125,18561,199
2022-01-19,Tehama,103,63373,10598,10064,2201,12265,142
2022-01-19,Trinity,105,12862,1035,916,248,1164,19
2022-01-19,Tulare,107,460477,91055,83743,22038,105781,1200
2022-01-19,Tuolumne,109,53932,10479,9613,292,9905,91
2022-01-19,Ventura,111,848112,155948,144738,8469,153207,1234
2022-01-19,Yolo,113,214977,31957,29392,2381,31773,273
2022-01-19,Yuba,115,75493,13827,13114,778,13892,104
2022-01-18,Alameda,001,1643700,213387,195728,10132,205860,1566
2022-01-18,Alpine,003,1148,117,118,1,119,0
2022-01-18,Amador,005,37829,7162,6691,290,6981,73
2022-01-18,Butte,007,227075,28461,26514,5526,32040,347
2022-01-18,Calaveras,009,45235,6159,5684,168,5852,94
2022-01-18,Colusa,011,21464,3021,2903,904,3807,21
2022-01-18,Contra Costa,013,1133247,161245,149446,9188,158634,1085
2022-01-18,Del Norte,015,27424,4369,4229,98,4327,43
2022-01-18,El Dorado,017,186661,23619,21707,2646,24353,175
2022-01-18,Fresno,019,978130,191410,178922,18315,197237,2425
2022-01-18,Glenn,021,27897,4337,4070,1373,5443,39
2022-01-18,Humboldt,023,135768,14224,13218,1957,15175,125
2022-01-18,Imperial,025,180216,47573,44742,7606,52348,819
2022-01-18,Inyo,027,18085,3785,3654,188,3842,49
2022-01-18,Kern,029,883053,169399,158864,37131,195995,1943
2022-01-18,Kings,031,150075,42571,39440,2660,42100,392
2022-01-18,Lake,033,64148,8571,7919,562,8481,117
2022-01-18,Lassen,035,31185,7758,7461,654,8115,55
2022-01-18,Los Angeles,037,10098052,2411451,2227360,108645,2336005,27871
2022-01-18,Madera,039,155013,31003,28717,3668,32385,329
2022-01-18,Marin,041,260295,28962,27036,1710,28746,251
2022-01-18,Mariposa,043,17540,2026,1872,95,1967,6
2022-01-18,Mendocino,045,87422,11009,10114,1651,11765,103
2022-01-18,Merced,047,269075,54502,51746,4857,56603,718
2022-01-18,Modoc,049,8938,649,633,218,851,6
2022-01-18,Mono,051,14174,2777,2643,98,2741,4
2022-01-18,Monterey,053,433212,66506,57846,7641,65487,650
2022-01-18,Napa,055,140530,21453,19911,603,20514,109
2022-01-18,Nevada,057,99092,13717,12584,796,13380,111
2022-01-18,Orange,059,3164182,495302,461324,35826,497150,5938
2022-01-18,Placer,061,380077,54523,50983,6203,57186,508
2022-01-18,Plumas,063,18699,2480,2218,184,2402,12
2022-01-18,Riverside,065,2383286,530108,497278,24380,521658,5599
2022-01-18,Sacramento,067,1510023,242079,223745,17917,241662,2496
2022-01-18,San Benito,069,59416,11079,10520,368,10888,88
2022-01-18,San Bernardino,071,2135413,518600,483753,21533,505286,6258
2022-01-18,San Diego,073,3302833,649936,605137,43075,648212,4547
2022-01-18,San Francisco,075,870044,105461,96505,6637,103142,694
2022-01-18,San Joaquin,077,732212,144301,134365,8379,142744,1957
2022-01-18,San Luis Obispo,079,281455,44272,40848,2800,43648,381
2022-01-18,San Mateo,081,765935,103772,88225,4829,93054,585
2022-01-18,Santa Barbara,083,443738,71873,67216,3431,70647,581
2022-01-18,Santa Clara,085,1922200,257598,240281,8511,248792,1986
2022-01-18,Santa Cruz,087,273765,35211,32203,1725,33928,237
2022-01-18,Shasta,089,179085,26580,25162,4772,29934,448
2022-01-18,Sierra,091,2930,257,244,32,276,0
2022-01-18,Siskiyou,093,43540,3927,3799,1992,5791,62
2022-01-18,Solano,095,438530,67977,62204,4158,66362,391
2022-01-18,Sonoma,097,501317,69109,63714,1796,65510,419
2022-01-18,Stanislaus,099,539301,102831,98000,13487,111487,1379
2022-01-18,Sutter,101,95872,18012,17295,1054,18349,198
2022-01-18,Tehama,103,63373,10502,9975,2149,12124,142
2022-01-18,Trinity,105,12862,1022,907,247,1154,19
2022-01-18,Tulare,107,460477,89592,82667,21635,104302,1196
2022-01-18,Tuolumne,109,53932,10312,9528,281,9809,91
2022-01-18,Ventura,111,848112,154234,143384,8383,151767,1233
2022-01-18,Yolo,113,214977,31559,28786,2331,31117,270
2022-01-18,Yuba,115,75493,13666,12971,753,13724,101
2022-01-17,Alameda,001,1643700,208687,193276,9546,202822,1565
2022-01-17,Alpine,003,1148,116,118,0,118,0
2022-01-17,Amador,005,37829,7047,6640,232,6872,73
2022-01-17,Butte,007,227075,28075,26303,5420,31723,348
2022-01-17,Calaveras,009,45235,6028,5584,140,5724,94
2022-01-17,Colusa,011,21464,2997,2905,897,3802,21
2022-01-17,Contra Costa,013,1133247,158456,147993,8703,156696,1086
2022-01-17,Del Norte,015,27424,4318,4209,91,4300,43
2022-01-17,El Dorado,017,186661,23372,21540,2564,24104,175
2022-01-17,Fresno,019,978130,187704,176959,17822,194781,2426
2022-01-17,Glenn,021,27897,4284,4055,1360,5415,39
2022-01-17,Humboldt,023,135768,14020,13120,1791,14911,125
2022-01-17,Imperial,025,180216,46886,44412,7444,51856,821
2022-01-17,Inyo,027,18085,3763,3650,162,3812,49
2022-01-17,Kern,029,883053,166854,157645,36256,193901,1944
2022-01-17,Kings,031,150075,41438,39143,2540,41683,392
2022-01-17,Lake,033,64148,8422,7864,522,8386,117
2022-01-17,Lassen,035,31185,7665,7417,617,8034,55
2022-01-17,Los Angeles,037,10098052,2372261,2205740,106684,2312424,27832
2022-01-17,Madera,039,155013,30352,28568,3488,32056,329
2022-01-17,Marin,041,260295,28556,26633,1655,28288,251
2022-01-17,Mariposa,043,17540,2000,1862,89,1951,6
2022-01-17,Mendocino,045,87422,10786,10030,1511,11541,103
2022-01-17,Merced,047,269075,53823,51227,4296,55523,718
2022-01-17,Modoc,049,8938,645,630,218,848,6
2022-01-17,Mono,051,14174,2754,2642,97,2739,4
2022-01-17,Monterey,053,433212,65387,57318,7226,64544,647
2022-01-17,Napa,055,140530,21108,19647,580,20227,109
2022-01-17,Nevada,057,99092,13531,12414,759,13173,111
2022-01-17,Orange,059,3164182,489342,457418,35351,492769,5933
2022-01-17,Placer,061,380077,53790,50511,6060,56571,508
2022-01-17,Plumas,063,18699,2434,2205,152,2357,12
2022-01-17,Riverside,065,2383286,523297,491322,23928,515250,5600
2022-01-17,Sacramento,067,1510023,237999,221143,16573,237716,2497
2022-01-17,San Benito,069,59416,10912,10432,340,10772,88
2022-01-17,San Bernardino,071,2135413,512253,480243,20996,501239,6259
2022-01-17,San Diego,073,3302833,637716,569241,41868,611109,4545
2022-01-17,San Francisco,075,870044,103832,95292,6442,101734,694
2022-01-17,San Joaquin,077,732212,141466,133414,8189,141603,1958
2022-01-17,San Luis Obispo,079,281455,43443,40425,2699,43124,379
2022-01-17,San Mateo,081,765935,101802,87013,4575,91588,585
2022-01-17,Santa Barbara,083,443738,70551,66704,3231,69935,581
2022-01-17,Santa Clara,085,1922200,253109,237934,8076,246010,1985
2022-01-17,Santa Cruz,087,273765,34442,31714,1688,33402,237
2022-01-17,Shasta,089,179085,26300,25025,4651,29676,448
2022-01-17,Sierra,091,2930,256,242,32,274,0
2022-01-17,Siskiyou,093,43540,3888,3764,1912,5676,62
2022-01-17,Solano,095,438530,66938,61497,3899,65396,391
2022-01-17,Sonoma,097,501317,67606,62763,1734,64497,419
2022-01-17,Stanislaus,099,539301,101518,96951,13007,109958,1379
2022-01-17,Sutter,101,95872,17803,17159,918,18077,198
2022-01-17,Tehama,103,63373,10379,9912,2091,12003,142
2022-01-17,Trinity,105,12862,1009,906,243,1149,19
2022-01-17,Tulare,107,460477,87842,81741,21086,102827,1199
2022-01-17,Tuolumne,109,53932,10175,9416,249,9665,91
2022-01-17,Ventura,111,848112,152118,142070,8265,150335,1234
2022-01-17,Yolo,113,214977,31029,28638,2265,30903,270
2022-01-17,Yuba,115,75493,13470,12871,697,13568,101
2022-01-16,Alameda,001,1643700,205618,190691,9290,199981,1564
2022-01-16,Alpine,003,1148,116,118,0,118,0
2022-01-16,Amador,005,37829,6974,6618,224,6842,73
2022-01-16,Butte,007,227075,27731,26139,5367,31506,348
2022-01-16,Calaveras,009,45235,5927,5537,136,5673,94
2022-01-16,Colusa,011,21464,2980,2886,885,3771,21
2022-01-16,Contra Costa,013,1133247,156532,146307,8501,154808,1086
2022-01-16,Del Norte,015,27424,4276,4177,89,4266,43
2022-01-16,El Dorado,017,186661,23097,21303,2525,23828,175
2022-01-16,Fresno,019,978130,184991,174818,17471,192289,2425
2022-01-16,Glenn,021,27897,4229,4049,1338,5387,39
2022-01-16,Humboldt,023,135768,13873,13075,1772,14847,125
2022-01-16,Imperial,025,180216,46314,44035,7279,51314,821
2022-01-16,Inyo,027,18085,3726,3602,140,3742,49
2022-01-16,Kern,029,883053,165583,156655,35469,192124,1944
2022-01-16,Kings,031,150075,41065,38861,2520,41381,392
2022-01-16,Lake,033,64148,8318,7823,488,8311,117
2022-01-16,Lassen,035,31185,7620,7391,605,7996,55
2022-01-16,Los Angeles,037,10098052,2349090,2174403,105159,2279562,27805
2022-01-16,Madera,039,155013,29982,28313,3438,31751,329
2022-01-16,Marin,041,260295,28262,26292,1641,27933,251
2022-01-16,Mariposa,043,17540,1973,1851,84,1935,6
2022-01-16,Mendocino,045,87422,10639,9992,1395,11387,102
2022-01-16,Merced,047,269075,53232,50882,4271,55153,718
2022-01-16,Modoc,049,8938,642,629,218,847,6
2022-01-16,Mono,051,14174,2750,2614,95,2709,4
2022-01-16,Monterey,053,433212,64621,57012,7081,64093,647
2022-01-16,Napa,055,140530,20841,19521,569,20090,109
2022-01-16,Nevada,057,99092,13316,12307,741,13048,111
2022-01-16,Orange,059,3164182,483947,451962,34804,486766,5932
2022-01-16,Placer,061,380077,53083,50076,5948,56024,508
2022-01-16,Plumas,063,18699,2399,2204,142,2346,12
2022-01-16,Riverside,065,2383286,517794,485191,23708,508899,5600
2022-01-16,Sacramento,067,1510023,235042,218819,15857,234676,2491
2022-01-16,San Benito,069,59416,10754,10377,338,10715,88
2022-01-16,San Bernardino,071,2135413,508333,474425,20744,495169,6259
2022-01-16,San Diego,073,3302833,630129,569241,41431,610672,4545
2022-01-16,San Francisco,075,870044,102316,94139,6304,100443,694
2022-01-16,San Joaquin,077,732212,139682,132214,8048,140262,1958
2022-01-16,San Luis Obispo,079,281455,42786,40113,2660,42773,379
2022-01-16,San Mateo,081,765935,100276,85966,4482,90448,585
2022-01-16,Santa Barbara,083,443738,69524,66111,3191,69302,582
2022-01-16,Santa Clara,085,1922200,249444,234293,7922,242215,1984
2022-01-16,Santa Cruz,087,273765,33813,31469,1666,33135,237
2022-01-16,Shasta,089,179085,26045,24980,4583,29563,449
2022-01-16,Sierra,091,2930,252,238,31,269,0
2022-01-16,Siskiyou,093,43540,3860,3748,1873,5621,62
2022-01-16,Solano,095,438530,66262,60885,3768,64653,391
2022-01-16,Sonoma,097,501317,66528,61842,1717,63559,419
2022-01-16,Stanislaus,099,539301,100454,96370,12853,109223,1379
2022-01-16,Sutter,101,95872,17603,16996,896,17892,198
2022-01-16,Tehama,103,63373,10295,9868,2070,11938,142
2022-01-16,Trinity,105,12862,1004,889,241,1130,19
2022-01-16,Tulare,107,460477,86527,80867,20832,101699,1199
2022-01-16,Tuolumne,109,53932,10070,9369,241,9610,91
2022-01-16,Ventura,111,848112,150543,140715,8186,148901,1234
2022-01-16,Yolo,113,214977,30637,28481,2212,30693,270
2022-01-16,Yuba,115,75493,13292,12760,691,13451,101
2022-01-15,Alameda,001,1643700,204250,177768,9238,187006,1561
2022-01-15,Alpine,003,1148,116,117,0,117,0
2022-01-15,Amador,005,37829,6942,6434,210,6644,72
2022-01-15,Butte,007,227075,27576,25032,5317,30349,348
2022-01-15,Calaveras,009,45235,5895,5258,136,5394,93
2022-01-15,Colusa,011,21464,2966,2796,878,3674,21
2022-01-15,Contra Costa,013,1133247,155315,137643,8457,146100,1082
2022-01-15,Del Norte,015,27424,4261,4065,87,4152,43
2022-01-15,El Dorado,017,186661,22998,20434,2508,22942,175
2022-01-15,Fresno,019,978130,184062,167361,17386,184747,2415
2022-01-15,Glenn,021,27897,4222,3906,1329,5235,39
2022-01-15,Humboldt,023,135768,13769,12419,1756,14175,123
2022-01-15,Imperial,025,180216,46176,42508,7170,49678,817
2022-01-15,Inyo,027,18085,3716,3395,140,3535,49
2022-01-15,Kern,029,883053,164739,150085,35080,185165,1938
2022-01-15,Kings,031,150075,40816,37221,2508,39729,391
2022-01-15,Lake,033,64148,8279,7641,475,8116,117
2022-01-15,Lassen,035,31185,7579,7274,599,7873,55
2022-01-15,Los Angeles,037,10098052,2337563,2047927,104210,2152137,27641
2022-01-15,Madera,039,155013,29836,27294,3414,30708,329
2022-01-15,Marin,041,260295,28076,25248,1634,26882,251
2022-01-15,Mariposa,043,17540,1966,1762,84,1846,6
2022-01-15,Mendocino,045,87422,10566,9534,1389,10923,102
2022-01-15,Merced,047,269075,53065,48904,4260,53164,715
2022-01-15,Modoc,049,8938,640,628,218,846,6
2022-01-15,Mono,051,14174,2745,2508,94,2602,4
2022-01-15,Monterey,053,433212,64107,55315,7017,62332,647
2022-01-15,Napa,055,140530,20720,17648,565,18213,109
2022-01-15,Nevada,057,99092,13257,11773,728,12501,111
2022-01-15,Orange,059,3164182,481356,433141,34532,467673,5914
2022-01-15,Placer,061,380077,52792,47780,5912,53692,501
2022-01-15,Plumas,063,18699,2378,2158,136,2294,12
2022-01-15,Riverside,065,2383286,515111,466381,23573,489954,5578
2022-01-15,Sacramento,067,1510023,233885,208156,15758,223914,2491
2022-01-15,San Benito,069,59416,10655,9868,333,10201,87
2022-01-15,San Bernardino,071,2135413,506007,454395,20596,474991,6233
2022-01-15,San Diego,073,3302833,626340,559385,41175,600560,4540
2022-01-15,San Francisco,075,870044,101320,88004,6169,94173,692
2022-01-15,San Joaquin,077,732212,139117,125136,7951,133087,1954
2022-01-15,San Luis Obispo,079,281455,42597,38231,2647,40878,374
2022-01-15,San Mateo,081,765935,99320,80494,4441,84935,582
2022-01-15,Santa Barbara,083,443738,68928,62312,3180,65492,579
2022-01-15,Santa Clara,085,1922200,247240,218986,7802,226788,1974
2022-01-15,Santa Cruz,087,273765,33459,29414,1658,31072,235
2022-01-15,Shasta,089,179085,25954,24482,4551,29033,445
2022-01-15,Sierra,091,2930,251,232,30,262,0
2022-01-15,Siskiyou,093,43540,3848,3661,1863,5524,62
2022-01-15,Solano,095,438530,65983,58061,3719,61780,389
2022-01-15,Sonoma,097,501317,65942,58181,1711,59892,418
2022-01-15,Stanislaus,099,539301,99872,92986,12754,105740,1379
2022-01-15,Sutter,101,95872,17512,16345,886,17231,197
2022-01-15,Tehama,103,63373,10245,9572,2052,11624,141
2022-01-15,Trinity,105,12862,1001,872,241,1113,19
2022-01-15,Tulare,107,460477,86081,77769,20721,98490,1192
2022-01-15,Tuolumne,109,53932,9970,9042,236,9278,91
2022-01-15,Ventura,111,848112,149768,134736,8148,142884,1227
2022-01-15,Yolo,113,214977,30457,27311,2192,29503,270
2022-01-15,Yuba,115,75493,13229,12200,687,12887,101
2022-01-14,Alameda,001,1643700,202205,177768,9190,186958,1561
2022-01-14,Alpine,003,1148,116,117,0,117,0
2022-01-14,Amador,005,37829,6866,6434,201,6635,72
2022-01-14,Butte,007,227075,27395,25032,5285,30317,348
2022-01-14,Calaveras,009,45235,5858,5258,135,5393,93
2022-01-14,Colusa,011,21464,2957,2796,868,3664,21
2022-01-14,Contra Costa,013,1133247,153857,137643,8356,145999,1082
2022-01-14,Del Norte,015,27424,4236,4065,86,4151,43
2022-01-14,El Dorado,017,186661,22843,20434,2490,22924,175
2022-01-14,Fresno,019,978130,182406,167361,17310,184671,2415
2022-01-14,Glenn,021,27897,4200,3906,1321,5227,39
2022-01-14,Humboldt,023,135768,13662,12419,1723,14142,123
2022-01-14,Imperial,025,180216,46005,42508,7150,49658,817
2022-01-14,Inyo,027,18085,3691,3395,136,3531,49
2022-01-14,Kern,029,883053,163739,150085,34647,184732,1938
2022-01-14,Kings,031,150075,40565,37221,2500,39721,391
2022-01-14,Lake,033,64148,8222,7641,463,8104,117
2022-01-14,Lassen,035,31185,7545,7274,587,7861,55
2022-01-14,Los Angeles,037,10098052,2318240,2047927,103178,2151105,27641
2022-01-14,Madera,039,155013,29599,27294,3386,30680,329
2022-01-14,Marin,041,260295,27817,25248,1599,26847,251
2022-01-14,Mariposa,043,17540,1951,1762,84,1846,6
2022-01-14,Mendocino,045,87422,10454,9534,1376,10910,102
2022-01-14,Merced,047,269075,52882,48904,4245,53149,715
2022-01-14,Modoc,049,8938,639,628,218,846,6
2022-01-14,Mono,051,14174,2724,2508,92,2600,4
2022-01-14,Monterey,053,433212,63410,55315,6924,62239,647
2022-01-14,Napa,055,140530,20550,17648,560,18208,109
2022-01-14,Nevada,057,99092,13135,11773,715,12488,111
2022-01-14,Orange,059,3164182,477624,433141,34216,467357,5914
2022-01-14,Placer,061,380077,52356,47780,5826,53606,501
2022-01-14,Plumas,063,18699,2370,2158,129,2287,12
2022-01-14,Riverside,065,2383286,511586,466381,23430,489811,5578
2022-01-14,Sacramento,067,1510023,231938,208156,15609,223765,2491
2022-01-14,San Benito,069,59416,10603,9868,332,10200,87
2022-01-14,San Bernardino,071,2135413,502854,454395,20410,474805,6233
2022-01-14,San Diego,073,3302833,620688,559385,40867,600252,4540
2022-01-14,San Francisco,075,870044,100149,88004,5995,93999,692
2022-01-14,San Joaquin,077,732212,138268,125136,7871,133007,1954
2022-01-14,San Luis Obispo,079,281455,42430,38231,2626,40857,374
2022-01-14,San Mateo,081,765935,98091,80494,4412,84906,582
2022-01-14,Santa Barbara,083,443738,68409,62312,3170,65482,579
2022-01-14,Santa Clara,085,1922200,244666,218986,7696,226682,1974
2022-01-14,Santa Cruz,087,273765,33082,29414,1649,31063,235
2022-01-14,Shasta,089,179085,25833,24482,4518,29000,445
2022-01-14,Sierra,091,2930,249,232,28,260,0
2022-01-14,Siskiyou,093,43540,3837,3661,1850,5511,62
2022-01-14,Solano,095,438530,65138,58061,3631,61692,389
2022-01-14,Sonoma,097,501317,65402,58181,1685,59866,418
2022-01-14,Stanislaus,099,539301,99266,92986,12653,105639,1379
2022-01-14,Sutter,101,95872,17386,16345,878,17223,197
2022-01-14,Tehama,103,63373,10192,9572,2040,11612,141
2022-01-14,Trinity,105,12862,996,872,239,1111,19
2022-01-14,Tulare,107,460477,85551,77769,20560,98329,1192
2022-01-14,Tuolumne,109,53932,9847,9042,232,9274,91
2022-01-14,Ventura,111,848112,148661,134736,8089,142825,1227
2022-01-14,Yolo,113,214977,30216,27311,2164,29475,270
2022-01-14,Yuba,115,75493,13126,12200,682,12882,101
2022-01-13,Alameda,001,1643700,197878,177768,8839,186607,1561
2022-01-13,Alpine,003,1148,115,117,0,117,0
2022-01-13,Amador,005,37829,6806,6434,180,6614,72
2022-01-13,Butte,007,227075,27093,25032,5169,30201,348
2022-01-13,Calaveras,009,45235,5768,5258,132,5390,93
2022-01-13,Colusa,011,21464,2926,2796,858,3654,21
2022-01-13,Contra Costa,013,1133247,151317,137643,7903,145546,1082
2022-01-13,Del Norte,015,27424,4200,4065,85,4150,43
2022-01-13,El Dorado,017,186661,22594,20434,2444,22878,175
2022-01-13,Fresno,019,978130,179601,167361,16949,184310,2415
2022-01-13,Glenn,021,27897,4153,3906,1295,5201,39
2022-01-13,Humboldt,023,135768,13509,12419,1661,14080,123
2022-01-13,Imperial,025,180216,45461,42508,6937,49445,817
2022-01-13,Inyo,027,18085,3635,3395,119,3514,49
2022-01-13,Kern,029,883053,162154,150085,34058,184143,1938
2022-01-13,Kings,031,150075,40084,37221,2456,39677,391
2022-01-13,Lake,033,64148,8121,7641,442,8083,117
2022-01-13,Lassen,035,31185,7511,7274,571,7845,55
2022-01-13,Los Angeles,037,10098052,2281773,2047927,101392,2149319,27641
2022-01-13,Madera,039,155013,29132,27294,3293,30587,329
2022-01-13,Marin,041,260295,27473,25248,1556,26804,251
2022-01-13,Mariposa,043,17540,1928,1762,81,1843,6
2022-01-13,Mendocino,045,87422,10363,9534,1308,10842,102
2022-01-13,Merced,047,269075,52224,48904,3985,52889,715
2022-01-13,Modoc,049,8938,636,628,218,846,6
2022-01-13,Mono,051,14174,2701,2508,89,2597,4
2022-01-13,Monterey,053,433212,62473,55315,6639,61954,647
2022-01-13,Napa,055,140530,20252,17648,550,18198,109
2022-01-13,Nevada,057,99092,12942,11773,685,12458,111
2022-01-13,Orange,059,3164182,471183,433141,33760,466901,5914
2022-01-13,Placer,061,380077,51726,47780,5711,53491,501
2022-01-13,Plumas,063,18699,2350,2158,119,2277,12
2022-01-13,Riverside,065,2383286,505289,466381,23103,489484,5578
2022-01-13,Sacramento,067,1510023,228840,208156,14825,222981,2491
2022-01-13,San Benito,069,59416,10499,9868,324,10192,87
2022-01-13,San Bernardino,071,2135413,497106,454395,19951,474346,6233
2022-01-13,San Diego,073,3302833,612170,559385,39992,599377,4540
2022-01-13,San Francisco,075,870044,98413,88004,5801,93805,692
2022-01-13,San Joaquin,077,732212,136202,125136,7724,132860,1954
2022-01-13,San Luis Obispo,079,281455,41827,38231,2521,40752,374
2022-01-13,San Mateo,081,765935,96310,80494,4176,84670,582
2022-01-13,Santa Barbara,083,443738,67412,62312,2994,65306,579
2022-01-13,Santa Clara,085,1922200,240414,218986,7366,226352,1974
2022-01-13,Santa Cruz,087,273765,32266,29414,1627,31041,235
2022-01-13,Shasta,089,179085,25624,24482,4446,28928,445
2022-01-13,Sierra,091,2930,248,232,28,260,0
2022-01-13,Siskiyou,093,43540,3815,3661,1810,5471,62
2022-01-13,Solano,095,438530,64007,58061,3520,61581,389
2022-01-13,Sonoma,097,501317,64337,58181,1629,59810,418
2022-01-13,Stanislaus,099,539301,98149,92986,12375,105361,1379
2022-01-13,Sutter,101,95872,17190,16345,815,17160,197
2022-01-13,Tehama,103,63373,10093,9572,1991,11563,141
2022-01-13,Trinity,105,12862,988,872,239,1111,19
2022-01-13,Tulare,107,460477,84270,77769,20270,98039,1192
2022-01-13,Tuolumne,109,53932,9708,9042,214,9256,91
2022-01-13,Ventura,111,848112,146878,134736,7995,142731,1227
2022-01-13,Yolo,113,214977,29801,27311,2120,29431,270
2022-01-13,Yuba,115,75493,12991,12200,653,12853,101
2022-01-12,Alameda,001,1643700,193258,173001,8382,181383,1563
2022-01-12,Alpine,003,1148,115,117,0,117,0
2022-01-12,Amador,005,37829,6758,6354,166,6520,71
2022-01-12,Butte,007,227075,26766,24631,5078,29709,348
2022-01-12,Calaveras,009,45235,5691,5151,126,5277,93
2022-01-12,Colusa,011,21464,2887,2772,845,3617,21
2022-01-12,Contra Costa,013,1133247,148755,134579,7541,142120,1077
2022-01-12,Del Norte,015,27424,4174,4019,83,4102,43
2022-01-12,El Dorado,017,186661,22271,20092,2404,22496,175
2022-01-12,Fresno,019,978130,176870,165316,16543,181859,2413
2022-01-12,Glenn,021,27897,4102,3859,1273,5132,39
2022-01-12,Humboldt,023,135768,13337,12081,1579,13660,122
2022-01-12,Imperial,025,180216,44805,41985,6635,48620,814
2022-01-12,Inyo,027,18085,3589,3334,103,3437,49
2022-01-12,Kern,029,883053,160015,148435,33336,181771,1933
2022-01-12,Kings,031,150075,39453,36780,2414,39194,391
2022-01-12,Lake,033,64148,8005,7535,398,7933,117
2022-01-12,Lassen,035,31185,7469,7223,544,7767,55
2022-01-12,Los Angeles,037,10098052,2242040,2005065,99150,2104215,27601
2022-01-12,Madera,039,155013,28815,26952,3193,30145,329
2022-01-12,Marin,041,260295,26983,24704,1505,26209,251
2022-01-12,Mariposa,043,17540,1899,1725,79,1804,6
2022-01-12,Mendocino,045,87422,10199,9379,1210,10589,103
2022-01-12,Merced,047,269075,51524,48441,3712,52153,710
2022-01-12,Modoc,049,8938,634,627,218,845,6
2022-01-12,Mono,051,14174,2665,2466,85,2551,4
2022-01-12,Monterey,053,433212,61487,54524,6278,60802,647
2022-01-12,Napa,055,140530,19994,17347,527,17874,109
2022-01-12,Nevada,057,99092,12729,11552,639,12191,111
2022-01-12,Orange,059,3164182,464399,425737,33175,458912,5912
2022-01-12,Placer,061,380077,51066,47004,5596,52600,501
2022-01-12,Plumas,063,18699,2310,2135,108,2243,12
2022-01-12,Riverside,065,2383286,498078,458881,22763,481644,5565
2022-01-12,Sacramento,067,1510023,225263,204696,13953,218649,2479
2022-01-12,San Benito,069,59416,10368,9737,312,10049,87
2022-01-12,San Bernardino,071,2135413,490739,447869,19339,467208,6222
2022-01-12,San Diego,073,3302833,601667,551669,39134,590803,4529
2022-01-12,San Francisco,075,870044,96578,85700,5688,91388,691
2022-01-12,San Joaquin,077,732212,133918,122850,7597,130447,1948
2022-01-12,San Luis Obispo,079,281455,41100,37727,2438,40165,373
2022-01-12,San Mateo,081,765935,94277,78476,3802,82278,582
2022-01-12,Santa Barbara,083,443738,66269,60815,2892,63707,578
2022-01-12,Santa Clara,085,1922200,235918,213177,6987,220164,1971
2022-01-12,Santa Cruz,087,273765,31611,28463,1579,30042,235
2022-01-12,Shasta,089,179085,25411,24324,4381,28705,446
2022-01-12,Sierra,091,2930,247,228,28,256,0
2022-01-12,Siskiyou,093,43540,3787,3639,1763,5402,62
2022-01-12,Solano,095,438530,62960,57052,3399,60451,386
2022-01-12,Sonoma,097,501317,63053,56394,1546,57940,417
2022-01-12,Stanislaus,099,539301,96918,91738,12035,103773,1373
2022-01-12,Sutter,101,95872,16995,16135,782,16917,197
2022-01-12,Tehama,103,63373,10004,9475,1930,11405,141
2022-01-12,Trinity,105,12862,984,868,238,1106,19
2022-01-12,Tulare,107,460477,83149,76943,19891,96834,1192
2022-01-12,Tuolumne,109,53932,9578,8870,197,9067,91
2022-01-12,Ventura,111,848112,144967,132180,7909,140089,1220
2022-01-12,Yolo,113,214977,29386,26888,2047,28935,270
2022-01-12,Yuba,115,75493,12831,12015,626,12641,101
2022-01-11,Alameda,001,1643700,188730,169181,7987,177168,1561
2022-01-11,Alpine,003,1148,115,116,0,116,0
2022-01-11,Amador,005,37829,6674,6317,151,6468,71
2022-01-11,Butte,007,227075,26375,24479,4985,29464,347
2022-01-11,Calaveras,009,45235,5562,5083,112,5195,93
2022-01-11,Colusa,011,21464,2864,2766,832,3598,21
2022-01-11,Contra Costa,013,1133247,145745,132410,7059,139469,1077
2022-01-11,Del Norte,015,27424,4141,4006,81,4087,43
2022-01-11,El Dorado,017,186661,21925,19842,2331,22173,174
2022-01-11,Fresno,019,978130,173828,163509,16203,179712,2404
2022-01-11,Glenn,021,27897,4040,3844,1229,5073,39
2022-01-11,Humboldt,023,135768,13116,11960,1486,13446,122
2022-01-11,Imperial,025,180216,44200,41444,6435,47879,813
2022-01-11,Inyo,027,18085,3491,3278,96,3374,49
2022-01-11,Kern,029,883053,157733,146942,32514,179456,1929
2022-01-11,Kings,031,150075,38865,36524,2383,38907,389
2022-01-11,Lake,033,64148,7927,7494,382,7876,117
2022-01-11,Lassen,035,31185,7419,7210,530,7740,55
2022-01-11,Los Angeles,037,10098052,2199597,1966319,96920,2063239,27563
2022-01-11,Madera,039,155013,28400,26688,3114,29802,329
2022-01-11,Marin,041,260295,26626,24387,1460,25847,251
2022-01-11,Mariposa,043,17540,1877,1718,75,1793,6
2022-01-11,Mendocino,045,87422,10038,9301,1112,10413,102
2022-01-11,Merced,047,269075,50758,48068,3531,51599,708
2022-01-11,Modoc,049,8938,633,626,217,843,6
2022-01-11,Mono,051,14174,2622,2425,84,2509,4
2022-01-11,Monterey,053,433212,60444,53911,5930,59841,646
2022-01-11,Napa,055,140530,19554,17020,480,17500,109
2022-01-11,Nevada,057,99092,12503,11467,604,12071,110
2022-01-11,Orange,059,3164182,456723,417703,32543,450246,5909
2022-01-11,Placer,061,380077,50311,46459,5452,51911,500
2022-01-11,Plumas,063,18699,2275,2099,100,2199,12
2022-01-11,Riverside,065,2383286,490354,453766,22449,476215,5551
2022-01-11,Sacramento,067,1510023,221084,201058,12930,213988,2489
2022-01-11,San Benito,069,59416,10232,9624,299,9923,83
2022-01-11,San Bernardino,071,2135413,482961,442960,18747,461707,6198
2022-01-11,San Diego,073,3302833,589660,536954,38023,574977,4520
2022-01-11,San Francisco,075,870044,94375,83678,5530,89208,691
2022-01-11,San Joaquin,077,732212,131539,121139,7431,128570,1944
2022-01-11,San Luis Obispo,079,281455,40325,37183,2319,39502,372
2022-01-11,San Mateo,081,765935,91985,76756,3580,80336,582
2022-01-11,Santa Barbara,083,443738,64964,59758,2755,62513,578
2022-01-11,Santa Clara,085,1922200,230534,208425,6536,214961,1971
2022-01-11,Santa Cruz,087,273765,31103,27709,1529,29238,232
2022-01-11,Shasta,089,179085,25152,24132,4288,28420,446
2022-01-11,Sierra,091,2930,245,228,28,256,0
2022-01-11,Siskiyou,093,43540,3763,3621,1713,5334,62
2022-01-11,Solano,095,438530,61561,56349,3246,59595,388
2022-01-11,Sonoma,097,501317,61536,55411,1466,56877,416
2022-01-11,Stanislaus,099,539301,95550,90998,11668,102666,1372
2022-01-11,Sutter,101,95872,16794,15993,728,16721,197
2022-01-11,Tehama,103,63373,9876,9406,1882,11288,140
2022-01-11,Trinity,105,12862,972,858,236,1094,19
2022-01-11,Tulare,107,460477,81843,76267,19491,95758,1188
2022-01-11,Tuolumne,109,53932,9419,8811,190,9001,91
2022-01-11,Ventura,111,848112,142736,129548,7763,137311,1220
2022-01-11,Yolo,113,214977,28809,26482,1986,28468,270
2022-01-11,Yuba,115,75493,12657,11912,605,12517,101
2022-01-10,Alameda,001,1643700,183605,165657,7466,173123,1559
2022-01-10,Alpine,003,1148,115,116,0,116,0
2022-01-10,Amador,005,37829,6571,6279,136,6415,71
2022-01-10,Butte,007,227075,26036,24217,4888,29105,347
2022-01-10,Calaveras,009,45235,5464,5025,106,5131,93
2022-01-10,Colusa,011,21464,2835,2758,823,3581,21
2022-01-10,Contra Costa,013,1133247,142951,129951,6547,136498,1077
2022-01-10,Del Norte,015,27424,4118,3970,81,4051,43
2022-01-10,El Dorado,017,186661,21358,19606,2274,21880,172
2022-01-10,Fresno,019,978130,170784,161593,15813,177406,2404
2022-01-10,Glenn,021,27897,3981,3807,1215,5022,39
2022-01-10,Humboldt,023,135768,12873,11778,1353,13131,121
2022-01-10,Imperial,025,180216,43474,41080,6218,47298,811
2022-01-10,Inyo,027,18085,3436,3227,84,3311,49
2022-01-10,Kern,029,883053,155163,145744,31772,177516,1929
2022-01-10,Kings,031,150075,38249,36286,2357,38643,389
2022-01-10,Lake,033,64148,7838,7416,358,7774,117
2022-01-10,Lassen,035,31185,7381,7192,508,7700,55
2022-01-10,Los Angeles,037,10098052,2154071,1932475,94445,2026920,27546
2022-01-10,Madera,039,155013,27950,26501,3011,29512,328
2022-01-10,Marin,041,260295,26137,24023,1386,25409,251
2022-01-10,Mariposa,043,17540,1837,1684,70,1754,6
2022-01-10,Mendocino,045,87422,9865,9163,1025,10188,101
2022-01-10,Merced,047,269075,49950,47632,3249,50881,707
2022-01-10,Modoc,049,8938,632,622,215,837,6
2022-01-10,Mono,051,14174,2556,2415,79,2494,4
2022-01-10,Monterey,053,433212,59490,53485,5616,59101,645
2022-01-10,Napa,055,140530,19177,16775,466,17241,109
2022-01-10,Nevada,057,99092,12279,11300,566,11866,110
2022-01-10,Orange,059,3164182,448025,406170,31695,437865,5906
2022-01-10,Placer,061,380077,49464,45642,5290,50932,498
2022-01-10,Plumas,063,18699,2240,2086,98,2184,12
2022-01-10,Riverside,065,2383286,482103,445536,22000,467536,5546
2022-01-10,Sacramento,067,1510023,216577,198023,11887,209910,2474
2022-01-10,San Benito,069,59416,10061,9467,289,9756,83
2022-01-10,San Bernardino,071,2135413,474681,437207,18035,455242,6184
2022-01-10,San Diego,073,3302833,576968,530506,36885,567391,4500
2022-01-10,San Francisco,075,870044,92583,82209,5271,87480,690
2022-01-10,San Joaquin,077,732212,128874,119587,7147,126734,1927
2022-01-10,San Luis Obispo,079,281455,39509,36618,2224,38842,371
2022-01-10,San Mateo,081,765935,89338,75210,3324,78534,582
2022-01-10,Santa Barbara,083,443738,63703,58957,2566,61523,578
2022-01-10,Santa Clara,085,1922200,224752,203540,6057,209597,1971
2022-01-10,Santa Cruz,087,273765,30262,26906,1491,28397,232
2022-01-10,Shasta,089,179085,24955,23983,4211,28194,446
2022-01-10,Sierra,091,2930,242,223,28,251,0
2022-01-10,Siskiyou,093,43540,3730,3592,1669,5261,62
2022-01-10,Solano,095,438530,60522,55663,3049,58712,385
2022-01-10,Sonoma,097,501317,59989,54478,1420,55898,412
2022-01-10,Stanislaus,099,539301,94215,89997,11323,101320,1372
2022-01-10,Sutter,101,95872,16550,15823,682,16505,196
2022-01-10,Tehama,103,63373,9763,9360,1827,11187,140
2022-01-10,Trinity,105,12862,968,849,234,1083,19
2022-01-10,Tulare,107,460477,80351,75498,19105,94603,1186
2022-01-10,Tuolumne,109,53932,9293,8685,178,8863,91
2022-01-10,Ventura,111,848112,140128,126240,7613,133853,1217
2022-01-10,Yolo,113,214977,28212,26065,1933,27998,270
2022-01-10,Yuba,115,75493,12409,11776,571,12347,101
2022-01-09,Alameda,001,1643700,179094,162701,6798,169499,1561
2022-01-09,Alpine,003,1148,115,116,0,116,0
2022-01-09,Amador,005,37829,6483,6215,124,6339,71
2022-01-09,Butte,007,227075,25648,24018,4769,28787,347
2022-01-09,Calaveras,009,45235,5334,4976,97,5073,93
2022-01-09,Colusa,011,21464,2808,2750,800,3550,21
2022-01-09,Contra Costa,013,1133247,140030,128050,5890,133940,1077
2022-01-09,Del Norte,015,27424,4078,3950,77,4027,43
2022-01-09,El Dorado,017,186661,20996,19430,2208,21638,172
2022-01-09,Fresno,019,978130,168204,159989,15437,175426,2405
2022-01-09,Glenn,021,27897,3925,3797,1194,4991,39
2022-01-09,Humboldt,023,135768,12629,11582,1230,12812,121
2022-01-09,Imperial,025,180216,42635,40608,5958,46566,811
2022-01-09,Inyo,027,18085,3333,3149,75,3224,49
2022-01-09,Kern,029,883053,152709,144819,31033,175852,1927
2022-01-09,Kings,031,150075,37572,36041,2321,38362,389
2022-01-09,Lake,033,64148,7727,7393,314,7707,117
2022-01-09,Lassen,035,31185,7317,7172,479,7651,55
2022-01-09,Los Angeles,037,10098052,2106053,1887830,91450,1979280,27532
2022-01-09,Madera,039,155013,27571,26325,2914,29239,328
2022-01-09,Marin,041,260295,25687,23708,1295,25003,251
2022-01-09,Mariposa,043,17540,1787,1660,69,1729,6
2022-01-09,Mendocino,045,87422,9658,9097,913,10010,101
2022-01-09,Merced,047,269075,49079,47294,2977,50271,706
2022-01-09,Modoc,049,8938,630,619,215,834,6
2022-01-09,Mono,051,14174,2521,2390,72,2462,4
2022-01-09,Monterey,053,433212,58430,53251,5348,58599,645
2022-01-09,Napa,055,140530,18682,16614,450,17064,109
2022-01-09,Nevada,057,99092,12025,11152,505,11657,110
2022-01-09,Orange,059,3164182,438026,400563,30745,431308,5905
2022-01-09,Placer,061,380077,48472,45081,5140,50221,498
2022-01-09,Plumas,063,18699,2201,2081,78,2159,12
2022-01-09,Riverside,065,2383286,473119,440413,21458,461871,5546
2022-01-09,Sacramento,067,1510023,211784,195444,10774,206218,2475
2022-01-09,San Benito,069,59416,9875,9363,261,9624,83
2022-01-09,San Bernardino,071,2135413,466425,430257,17233,447490,6180
2022-01-09,San Diego,073,3302833,563849,478206,35029,513235,4500
2022-01-09,San Francisco,075,870044,90718,80463,5025,85488,690
2022-01-09,San Joaquin,077,732212,125796,118422,6980,125402,1927
2022-01-09,San Luis Obispo,079,281455,38704,36291,2118,38409,371
2022-01-09,San Mateo,081,765935,86828,73867,2997,76864,582
2022-01-09,Santa Barbara,083,443738,62019,58280,2304,60584,578
2022-01-09,Santa Clara,085,1922200,218703,199889,5522,205411,1976
2022-01-09,Santa Cruz,087,273765,29512,26513,1459,27972,232
2022-01-09,Shasta,089,179085,24715,23926,4124,28050,446
2022-01-09,Sierra,091,2930,239,223,26,249,0
2022-01-09,Siskiyou,093,43540,3701,3580,1610,5190,62
2022-01-09,Solano,095,438530,59367,54985,2768,57753,384
2022-01-09,Sonoma,097,501317,58314,53543,1383,54926,412
2022-01-09,Stanislaus,099,539301,92846,89248,11042,100290,1372
2022-01-09,Sutter,101,95872,16262,15695,602,16297,196
2022-01-09,Tehama,103,63373,9646,9306,1776,11082,140
2022-01-09,Trinity,105,12862,964,848,232,1080,19
2022-01-09,Tulare,107,460477,78941,75085,18736,93821,1186
2022-01-09,Tuolumne,109,53932,9136,8595,159,8754,91
2022-01-09,Ventura,111,848112,137075,124269,7370,131639,1217
2022-01-09,Yolo,113,214977,27604,25632,1888,27520,270
2022-01-09,Yuba,115,75493,12211,11666,540,12206,101
2022-01-08,Alameda,001,1643700,177206,148560,6660,155220,1558
2022-01-08,Alpine,003,1148,115,114,0,114,0
2022-01-08,Amador,005,37829,6452,6091,119,6210,71
2022-01-08,Butte,007,227075,25460,23429,4731,28160,347
2022-01-08,Calaveras,009,45235,5288,4823,93,4916,93
2022-01-08,Colusa,011,21464,2800,2713,797,3510,21
2022-01-08,Contra Costa,013,1133247,138503,119907,5808,125715,1077
2022-01-08,Del Norte,015,27424,4061,3902,77,3979,43
2022-01-08,El Dorado,017,186661,20815,18599,2175,20774,172
2022-01-08,Fresno,019,978130,167319,155394,15304,170698,2393
2022-01-08,Glenn,021,27897,3917,3732,1189,4921,39
2022-01-08,Humboldt,023,135768,12508,11149,1204,12353,121
2022-01-08,Imperial,025,180216,42447,39429,5816,45245,800
2022-01-08,Inyo,027,18085,3319,3020,72,3092,49
2022-01-08,Kern,029,883053,151572,140410,30605,171015,1921
2022-01-08,Kings,031,150075,37331,35275,2304,37579,390
2022-01-08,Lake,033,64148,7687,7209,306,7515,117
2022-01-08,Lassen,035,31185,7287,7127,463,7590,55
2022-01-08,Los Angeles,037,10098052,2087662,1765787,89718,1855505,27476
2022-01-08,Madera,039,155013,27404,25767,2876,28643,328
2022-01-08,Marin,041,260295,25403,22377,1284,23661,251
2022-01-08,Mariposa,043,17540,1777,1588,69,1657,6
2022-01-08,Mendocino,045,87422,9584,8792,911,9703,101
2022-01-08,Merced,047,269075,48906,46094,2953,49047,703
2022-01-08,Modoc,049,8938,630,610,215,825,6
2022-01-08,Mono,051,14174,2510,2240,67,2307,4
2022-01-08,Monterey,053,433212,58045,51721,5255,56976,644
2022-01-08,Napa,055,140530,18528,15819,424,16243,109
2022-01-08,Nevada,057,99092,11939,10765,492,11257,110
2022-01-08,Orange,059,3164182,434231,375124,29899,405023,5903
2022-01-08,Placer,061,380077,48029,43172,5098,48270,495
2022-01-08,Plumas,063,18699,2191,2053,73,2126,12
2022-01-08,Riverside,065,2383286,469604,422591,21191,443782,5535
2022-01-08,Sacramento,067,1510023,210350,185118,10617,195735,2470
2022-01-08,San Benito,069,59416,9714,9016,258,9274,83
2022-01-08,San Bernardino,071,2135413,463021,411724,16843,428567,6122
2022-01-08,San Diego,073,3302833,558945,472273,34486,506759,4495
2022-01-08,San Francisco,075,870044,89519,73660,4745,78405,690
2022-01-08,San Joaquin,077,732212,124828,112514,6879,119393,1916
2022-01-08,San Luis Obispo,079,281455,38502,34489,2075,36564,369
2022-01-08,San Mateo,081,765935,85445,67918,2910,70828,582
2022-01-08,Santa Barbara,083,443738,61324,54617,2270,56887,575
2022-01-08,Santa Clara,085,1922200,215663,183842,5314,189156,1966
2022-01-08,Santa Cruz,087,273765,29086,24678,1439,26117,230
2022-01-08,Shasta,089,179085,24624,23585,4093,27678,445
2022-01-08,Sierra,091,2930,235,215,25,240,0
2022-01-08,Siskiyou,093,43540,3689,3545,1596,5141,62
2022-01-08,Solano,095,438530,58959,52452,2696,55148,383
2022-01-08,Sonoma,097,501317,57791,50130,1349,51479,411
2022-01-08,Stanislaus,099,539301,92206,87049,10919,97968,1372
2022-01-08,Sutter,101,95872,16143,15261,589,15850,195
2022-01-08,Tehama,103,63373,9615,9109,1768,10877,140
2022-01-08,Trinity,105,12862,958,836,232,1068,19
2022-01-08,Tulare,107,460477,78548,73600,18602,92202,1185
2022-01-08,Tuolumne,109,53932,9030,8360,156,8516,91
2022-01-08,Ventura,111,848112,135905,117229,7236,124465,1216
2022-01-08,Yolo,113,214977,27310,24006,1860,25866,270
2022-01-08,Yuba,115,75493,12124,11277,537,11814,101
2022-01-07,Alameda,001,1643700,174522,148560,6547,155107,1558
2022-01-07,Alpine,003,1148,115,114,0,114,0
2022-01-07,Amador,005,37829,6403,6091,116,6207,71
2022-01-07,Butte,007,227075,25256,23429,4696,28125,347
2022-01-07,Calaveras,009,45235,5249,4823,93,4916,93
2022-01-07,Colusa,011,21464,2791,2713,786,3499,21
2022-01-07,Contra Costa,013,1133247,136604,119907,5687,125594,1077
2022-01-07,Del Norte,015,27424,4045,3902,76,3978,43
2022-01-07,El Dorado,017,186661,20652,18599,2162,20761,172
2022-01-07,Fresno,019,978130,165959,155394,15211,170605,2393
2022-01-07,Glenn,021,27897,3897,3732,1186,4918,39
2022-01-07,Humboldt,023,135768,12365,11149,1177,12326,121
2022-01-07,Imperial,025,180216,42288,39429,5732,45161,800
2022-01-07,Inyo,027,18085,3300,3020,70,3090,49
2022-01-07,Kern,029,883053,150602,140410,30163,170573,1921
2022-01-07,Kings,031,150075,37150,35275,2290,37565,390
2022-01-07,Lake,033,64148,7639,7209,281,7490,117
2022-01-07,Lassen,035,31185,7271,7127,460,7587,55
2022-01-07,Los Angeles,037,10098052,2056488,1765787,88257,1854044,27476
2022-01-07,Madera,039,155013,27222,25767,2840,28607,328
2022-01-07,Marin,041,260295,25022,22377,1266,23643,251
2022-01-07,Mariposa,043,17540,1761,1588,69,1657,6
2022-01-07,Mendocino,045,87422,9491,8792,910,9702,101
2022-01-07,Merced,047,269075,48740,46094,2929,49023,703
2022-01-07,Modoc,049,8938,629,610,215,825,6
2022-01-07,Mono,051,14174,2472,2240,61,2301,4
2022-01-07,Monterey,053,433212,57625,51721,5160,56881,644
2022-01-07,Napa,055,140530,18301,15819,403,16222,109
2022-01-07,Nevada,057,99092,11810,10765,471,11236,110
2022-01-07,Orange,059,3164182,429420,375124,29282,404406,5903
2022-01-07,Placer,061,380077,47524,43172,5048,48220,495
2022-01-07,Plumas,063,18699,2182,2053,72,2125,12
2022-01-07,Riverside,065,2383286,465775,422591,20962,443553,5535
2022-01-07,Sacramento,067,1510023,208080,185118,10464,195582,2470
2022-01-07,San Benito,069,59416,9669,9016,257,9273,83
2022-01-07,San Bernardino,071,2135413,459031,411724,16616,428340,6122
2022-01-07,San Diego,073,3302833,551826,472273,33939,506212,4495
2022-01-07,San Francisco,075,870044,88078,73660,4486,78146,690
2022-01-07,San Joaquin,077,732212,123877,112514,6818,119332,1916
2022-01-07,San Luis Obispo,079,281455,38287,34489,2020,36509,369
2022-01-07,San Mateo,081,765935,83979,67918,2851,70769,582
2022-01-07,Santa Barbara,083,443738,60628,54617,2249,56866,575
2022-01-07,Santa Clara,085,1922200,212416,183842,5205,189047,1966
2022-01-07,Santa Cruz,087,273765,28606,24678,1423,26101,230
2022-01-07,Shasta,089,179085,24525,23585,4059,27644,445
2022-01-07,Sierra,091,2930,232,215,25,240,0
2022-01-07,Siskiyou,093,43540,3678,3545,1584,5129,62
2022-01-07,Solano,095,438530,58277,52452,2651,55103,383
2022-01-07,Sonoma,097,501317,57189,50130,1264,51394,411
2022-01-07,Stanislaus,099,539301,91678,87049,10820,97869,1372
2022-01-07,Sutter,101,95872,15993,15261,576,15837,195
2022-01-07,Tehama,103,63373,9579,9109,1755,10864,140
2022-01-07,Trinity,105,12862,951,836,231,1067,19
2022-01-07,Tulare,107,460477,78122,73600,18463,92063,1185
2022-01-07,Tuolumne,109,53932,8941,8360,152,8512,91
2022-01-07,Ventura,111,848112,134276,117229,7101,124330,1216
2022-01-07,Yolo,113,214977,26935,24006,1841,25847,270
2022-01-07,Yuba,115,75493,12019,11277,532,11809,101
2022-01-06,Alameda,001,1643700,169147,148560,6142,154702,1558
2022-01-06,Alpine,003,1148,114,114,0,114,0
2022-01-06,Amador,005,37829,6352,6091,111,6202,71
2022-01-06,Butte,007,227075,24960,23429,4612,28041,347
2022-01-06,Calaveras,009,45235,5132,4823,91,4914,93
2022-01-06,Colusa,011,21464,2771,2713,777,3490,21
2022-01-06,Contra Costa,013,1133247,133673,119907,5271,125178,1077
2022-01-06,Del Norte,015,27424,4011,3902,74,3976,43
2022-01-06,El Dorado,017,186661,20319,18599,2122,20721,172
2022-01-06,Fresno,019,978130,163835,155394,14951,170345,2393
2022-01-06,Glenn,021,27897,3870,3732,1160,4892,39
2022-01-06,Humboldt,023,135768,12139,11149,1136,12285,121
2022-01-06,Imperial,025,180216,41703,39429,5532,44961,800
2022-01-06,Inyo,027,18085,3262,3020,70,3090,49
2022-01-06,Kern,029,883053,148933,140410,29497,169907,1921
2022-01-06,Kings,031,150075,36825,35275,2265,37540,390
2022-01-06,Lake,033,64148,7565,7209,270,7479,117
2022-01-06,Lassen,035,31185,7248,7127,454,7581,55
2022-01-06,Los Angeles,037,10098052,2002337,1765787,85903,1851690,27476
2022-01-06,Madera,039,155013,26917,25767,2782,28549,328
2022-01-06,Marin,041,260295,24620,22377,1233,23610,251
2022-01-06,Mariposa,043,17540,1742,1588,69,1657,6
2022-01-06,Mendocino,045,87422,9394,8792,871,9663,101
2022-01-06,Merced,047,269075,48191,46094,2791,48885,703
2022-01-06,Modoc,049,8938,628,610,215,825,6
2022-01-06,Mono,051,14174,2449,2240,58,2298,4
2022-01-06,Monterey,053,433212,56904,51721,4909,56630,644
2022-01-06,Napa,055,140530,17903,15819,394,16213,109
2022-01-06,Nevada,057,99092,11612,10765,459,11224,110
2022-01-06,Orange,059,3164182,419973,375124,28543,403667,5903
2022-01-06,Placer,061,380077,46787,43172,4960,48132,495
2022-01-06,Plumas,063,18699,2164,2053,64,2117,12
2022-01-06,Riverside,065,2383286,458302,422591,20674,443265,5535
2022-01-06,Sacramento,067,1510023,204025,185118,9728,194846,2470
2022-01-06,San Benito,069,59416,9568,9016,250,9266,83
2022-01-06,San Bernardino,071,2135413,451546,411724,16139,427863,6122
2022-01-06,San Diego,073,3302833,540188,472273,32936,505209,4495
2022-01-06,San Francisco,075,870044,85759,73660,4232,77892,690
2022-01-06,San Joaquin,077,732212,121711,112514,6731,119245,1916
2022-01-06,San Luis Obispo,079,281455,37588,34489,1950,36439,369
2022-01-06,San Mateo,081,765935,81556,67918,2671,70589,582
2022-01-06,Santa Barbara,083,443738,59460,54617,2190,56807,575
2022-01-06,Santa Clara,085,1922200,207524,183842,4819,188661,1966
2022-01-06,Santa Cruz,087,273765,28046,24678,1399,26077,230
2022-01-06,Shasta,089,179085,24378,23585,4009,27594,445
2022-01-06,Sierra,091,2930,229,215,25,240,0
2022-01-06,Siskiyou,093,43540,3662,3545,1538,5083,62
2022-01-06,Solano,095,438530,57265,52452,2466,54918,383
2022-01-06,Sonoma,097,501317,55797,50130,1231,51361,411
2022-01-06,Stanislaus,099,539301,90528,87049,10651,97700,1372
2022-01-06,Sutter,101,95872,15816,15261,548,15809,195
2022-01-06,Tehama,103,63373,9501,9109,1728,10837,140
2022-01-06,Trinity,105,12862,944,836,230,1066,19
2022-01-06,Tulare,107,460477,77414,73600,18287,91887,1185
2022-01-06,Tuolumne,109,53932,8830,8360,146,8506,91
2022-01-06,Ventura,111,848112,131580,117229,6941,124170,1216
2022-01-06,Yolo,113,214977,26377,24006,1798,25804,270
2022-01-06,Yuba,115,75493,11883,11277,515,11792,101
2022-01-05,Alameda,001,1643700,164011,144824,5728,150552,1548
2022-01-05,Alpine,003,1148,114,112,0,112,0
2022-01-05,Amador,005,37829,6309,6012,108,6120,70
2022-01-05,Butte,007,227075,24653,23134,4551,27685,343
2022-01-05,Calaveras,009,45235,5077,4758,89,4847,90
2022-01-05,Colusa,011,21464,2759,2704,766,3470,21
2022-01-05,Contra Costa,013,1133247,130602,117188,4827,122015,1071
2022-01-05,Del Norte,015,27424,3991,3862,72,3934,43
2022-01-05,El Dorado,017,186661,19933,18367,2092,20459,171
2022-01-05,Fresno,019,978130,161826,153033,14681,167714,2377
2022-01-05,Glenn,021,27897,3822,3700,1150,4850,39
2022-01-05,Humboldt,023,135768,11935,10938,1088,12026,120
2022-01-05,Imperial,025,180216,41075,38789,5379,44168,800
2022-01-05,Inyo,027,18085,3180,2939,66,3005,49
2022-01-05,Kern,029,883053,147155,138186,28927,167113,1913
2022-01-05,Kings,031,150075,36482,34893,2246,37139,387
2022-01-05,Lake,033,64148,7482,7129,254,7383,117
2022-01-05,Lassen,035,31185,7228,7077,446,7523,55
2022-01-05,Los Angeles,037,10098052,1946040,1729640,83519,1813159,27443
2022-01-05,Madera,039,155013,26677,25392,2690,28082,327
2022-01-05,Marin,041,260295,24274,21829,1183,23012,251
2022-01-05,Mariposa,043,17540,1716,1564,68,1632,6
2022-01-05,Mendocino,045,87422,9263,8625,836,9461,101
2022-01-05,Merced,047,269075,47615,45721,2657,48378,700
2022-01-05,Modoc,049,8938,625,603,215,818,6
2022-01-05,Mono,051,14174,2430,2201,54,2255,4
2022-01-05,Monterey,053,433212,56080,51241,4709,55950,639
2022-01-05,Napa,055,140530,17540,15494,362,15856,108
2022-01-05,Nevada,057,99092,11416,10624,442,11066,110
2022-01-05,Orange,059,3164182,409934,366139,27494,393633,5869
2022-01-05,Placer,061,380077,45904,42456,4867,47323,492
2022-01-05,Plumas,063,18699,2144,2020,62,2082,12
2022-01-05,Riverside,065,2383286,450847,415253,20323,435576,5502
2022-01-05,Sacramento,067,1510023,199255,181488,8780,190268,2455
2022-01-05,San Benito,069,59416,9374,8829,238,9067,83
2022-01-05,San Bernardino,071,2135413,443087,405323,15598,420921,6085
2022-01-05,San Diego,073,3302833,526599,466602,31955,498557,4495
2022-01-05,San Francisco,075,870044,83179,71405,4094,75499,686
2022-01-05,San Joaquin,077,732212,119180,110497,6651,117148,1903
2022-01-05,San Luis Obispo,079,281455,36791,34066,1873,35939,369
2022-01-05,San Mateo,081,765935,79387,66018,2473,68491,578
2022-01-05,Santa Barbara,083,443738,58154,53082,2111,55193,570
2022-01-05,Santa Clara,085,1922200,201764,178629,4402,183031,1961
2022-01-05,Santa Cruz,087,273765,27291,24394,1378,25772,229
2022-01-05,Shasta,089,179085,24222,23361,3980,27341,441
2022-01-05,Sierra,091,2930,226,210,23,233,0
2022-01-05,Siskiyou,093,43540,3652,3513,1509,5022,60
2022-01-05,Solano,095,438530,56219,51505,2331,53836,380
2022-01-05,Sonoma,097,501317,54533,49120,1074,50194,412
2022-01-05,Stanislaus,099,539301,89543,86248,10480,96728,1360
2022-01-05,Sutter,101,95872,15614,15117,509,15626,193
2022-01-05,Tehama,103,63373,9404,9011,1697,10708,140
2022-01-05,Trinity,105,12862,940,822,228,1050,19
2022-01-05,Tulare,107,460477,76635,72718,18113,90831,1173
2022-01-05,Tuolumne,109,53932,8738,8223,139,8362,90
2022-01-05,Ventura,111,848112,128828,114752,6733,121485,1211
2022-01-05,Yolo,113,214977,25765,23401,1759,25160,269
2022-01-05,Yuba,115,75493,11701,11138,489,11627,100
2022-01-04,Alameda,001,1643700,158488,143360,5325,148685,1532
2022-01-04,Alpine,003,1148,114,113,0,113,0
2022-01-04,Amador,005,37829,6242,6025,102,6127,71
2022-01-04,Butte,007,227075,24353,23094,4481,27575,346
2022-01-04,Calaveras,009,45235,5003,4767,86,4853,93
2022-01-04,Colusa,011,21464,2742,2689,760,3449,21
2022-01-04,Contra Costa,013,1133247,127459,116005,4469,120474,1075
2022-01-04,Del Norte,015,27424,3959,3882,69,3951,43
2022-01-04,El Dorado,017,186661,19575,18339,2072,20411,172
2022-01-04,Fresno,019,978130,159671,153244,14438,167682,2380
2022-01-04,Glenn,021,27897,3792,3705,1135,4840,39
2022-01-04,Humboldt,023,135768,11685,10865,1037,11902,120
2022-01-04,Imperial,025,180216,40473,38596,5118,43714,800
2022-01-04,Inyo,027,18085,3097,2870,65,2935,49
2022-01-04,Kern,029,883053,145227,138245,28346,166591,1916
2022-01-04,Kings,031,150075,36160,34931,2229,37160,388
2022-01-04,Lake,033,64148,7441,7152,245,7397,117
2022-01-04,Lassen,035,31185,7205,7111,442,7553,55
2022-01-04,Los Angeles,037,10098052,1886097,1705253,81178,1786431,27419
2022-01-04,Madera,039,155013,26333,25425,2619,28044,328
2022-01-04,Marin,041,260295,23793,21675,1124,22799,251
2022-01-04,Mariposa,043,17540,1680,1564,67,1631,6
2022-01-04,Mendocino,045,87422,9140,8636,812,9448,101
2022-01-04,Merced,047,269075,47004,45583,2528,48111,700
2022-01-04,Modoc,049,8938,622,611,215,826,6
2022-01-04,Mono,051,14174,2381,2190,44,2234,4
2022-01-04,Monterey,053,433212,55347,51176,4485,55661,643
2022-01-04,Napa,055,140530,17036,15370,332,15702,107
2022-01-04,Nevada,057,99092,11258,10608,429,11037,110
2022-01-04,Orange,059,3164182,399183,362051,26360,388411,5897
2022-01-04,Placer,061,380077,45069,42285,4751,47036,494
2022-01-04,Plumas,063,18699,2118,2014,60,2074,12
2022-01-04,Riverside,065,2383286,442318,413366,19975,433341,5504
2022-01-04,Sacramento,067,1510023,194280,181271,8060,189331,2453
2022-01-04,San Benito,069,59416,9187,8763,230,8993,79
2022-01-04,San Bernardino,071,2135413,434183,404409,15069,419478,6060
2022-01-04,San Diego,073,3302833,510259,458499,30987,489486,4487
2022-01-04,San Francisco,075,870044,80325,70666,3951,74617,688
2022-01-04,San Joaquin,077,732212,116766,110374,6497,116871,1911
2022-01-04,San Luis Obispo,079,281455,35984,33788,1786,35574,371
2022-01-04,San Mateo,081,765935,77081,65157,2286,67443,582
2022-01-04,Santa Barbara,083,443738,56630,52449,2034,54483,574
2022-01-04,Santa Clara,085,1922200,195800,176854,3935,180789,1964
2022-01-04,Santa Cruz,087,273765,26529,23904,1343,25247,228
2022-01-04,Shasta,089,179085,24077,23366,3926,27292,442
2022-01-04,Sierra,091,2930,225,214,22,236,0
2022-01-04,Siskiyou,093,43540,3636,3509,1490,4999,61
2022-01-04,Solano,095,438530,54915,51300,2134,53434,383
2022-01-04,Sonoma,097,501317,52825,48653,954,49607,410
2022-01-04,Stanislaus,099,539301,88482,86107,10311,96418,1361
2022-01-04,Sutter,101,95872,15461,15032,485,15517,193
2022-01-04,Tehama,103,63373,9326,9020,1675,10695,140
2022-01-04,Trinity,105,12862,935,833,224,1057,18
2022-01-04,Tulare,107,460477,75846,72893,17916,90809,1172
2022-01-04,Tuolumne,109,53932,8626,8235,134,8369,91
2022-01-04,Ventura,111,848112,125762,114079,6503,120582,1213
2022-01-04,Yolo,113,214977,25113,22938,1715,24653,270
2022-01-04,Yuba,115,75493,11521,11104,473,11577,101
2022-01-03,Alameda,001,1643700,152546,142090,4890,146980,1529
2022-01-03,Alpine,003,1148,113,113,0,113,0
2022-01-03,Amador,005,37829,6180,6004,97,6101,71
2022-01-03,Butte,007,227075,24058,22924,4425,27349,345
2022-01-03,Calaveras,009,45235,4941,4742,80,4822,93
2022-01-03,Colusa,011,21464,2733,2683,753,3436,21
2022-01-03,Contra Costa,013,1133247,124132,114966,3888,118854,1073
2022-01-03,Del Norte,015,27424,3939,3873,65,3938,43
2022-01-03,El Dorado,017,186661,19182,18183,2045,20228,172
2022-01-03,Fresno,019,978130,157691,152674,14242,166916,2379
2022-01-03,Glenn,021,27897,3763,3703,1100,4803,39
2022-01-03,Humboldt,023,135768,11477,10784,989,11773,119
2022-01-03,Imperial,025,180216,39842,38411,4942,43353,800
2022-01-03,Inyo,027,18085,3028,2845,61,2906,49
2022-01-03,Kern,029,883053,143232,137773,27751,165524,1916
2022-01-03,Kings,031,150075,35837,34817,2200,37017,387
2022-01-03,Lake,033,64148,7339,7134,227,7361,117
2022-01-03,Lassen,035,31185,7187,7103,439,7542,55
2022-01-03,Los Angeles,037,10098052,1825299,1686203,78426,1764629,27394
2022-01-03,Madera,039,155013,26040,25323,2575,27898,320
2022-01-03,Marin,041,260295,23200,21532,1085,22617,251
2022-01-03,Mariposa,043,17540,1638,1559,67,1626,6
2022-01-03,Mendocino,045,87422,8992,8573,762,9335,101
2022-01-03,Merced,047,269075,46409,45459,2418,47877,696
2022-01-03,Modoc,049,8938,619,602,215,817,6
2022-01-03,Mono,051,14174,2303,2172,39,2211,4
2022-01-03,Monterey,053,433212,54520,51047,4278,55325,644
2022-01-03,Napa,055,140530,16528,15260,299,15559,107
2022-01-03,Nevada,057,99092,11093,10572,420,10992,110
2022-01-03,Orange,059,3164182,388012,358052,25178,383230,5894
2022-01-03,Placer,061,380077,44246,42054,4690,46744,489
2022-01-03,Plumas,063,18699,2098,2005,60,2065,12
2022-01-03,Riverside,065,2383286,433843,410155,19481,429636,5504
2022-01-03,Sacramento,067,1510023,189121,179992,7508,187500,2452
2022-01-03,San Benito,069,59416,9024,8688,223,8911,79
2022-01-03,San Bernardino,071,2135413,425559,401938,14615,416553,6056
2022-01-03,San Diego,073,3302833,494161,451154,30025,481179,4476
2022-01-03,San Francisco,075,870044,77514,69315,3699,73014,686
2022-01-03,San Joaquin,077,732212,114449,109757,6371,116128,1903
2022-01-03,San Luis Obispo,079,281455,35174,33667,1693,35360,367
2022-01-03,San Mateo,081,765935,74366,64470,2129,66599,582
2022-01-03,Santa Barbara,083,443738,55169,51912,1941,53853,571
2022-01-03,Santa Clara,085,1922200,189863,174215,3462,177677,1963
2022-01-03,Santa Cruz,087,273765,25721,23765,1312,25077,228
2022-01-03,Shasta,089,179085,23900,23301,3899,27200,440
2022-01-03,Sierra,091,2930,218,213,21,234,0
2022-01-03,Siskiyou,093,43540,3610,3500,1468,4968,61
2022-01-03,Solano,095,438530,53618,51030,1948,52978,380
2022-01-03,Sonoma,097,501317,51126,48391,858,49249,410
2022-01-03,Stanislaus,099,539301,87491,85793,10127,95920,1332
2022-01-03,Sutter,101,95872,15304,14973,465,15438,193
2022-01-03,Tehama,103,63373,9251,9005,1649,10654,140
2022-01-03,Trinity,105,12862,930,833,223,1056,18
2022-01-03,Tulare,107,460477,75151,72664,17716,90380,1167
2022-01-03,Tuolumne,109,53932,8489,8179,130,8309,91
2022-01-03,Ventura,111,848112,122589,112762,6264,119026,1211
2022-01-03,Yolo,113,214977,24431,22563,1652,24215,270
2022-01-03,Yuba,115,75493,11388,11037,454,11491,99
2022-01-02,Alameda,001,1643700,148130,133486,4409,137895,1528
2022-01-02,Alpine,003,1148,111,113,0,113,0
2022-01-02,Amador,005,37829,6112,5913,92,6005,70
2022-01-02,Butte,007,227075,23723,22469,4362,26831,341
2022-01-02,Calaveras,009,45235,4871,4668,72,4740,93
2022-01-02,Colusa,011,21464,2727,2659,742,3401,21
2022-01-02,Contra Costa,013,1133247,120564,109593,3452,113045,1073
2022-01-02,Del Norte,015,27424,3907,3841,63,3904,43
2022-01-02,El Dorado,017,186661,18847,17621,1994,19615,172
2022-01-02,Fresno,019,978130,155972,149927,14020,163947,2379
2022-01-02,Glenn,021,27897,3744,3663,1091,4754,39
2022-01-02,Humboldt,023,135768,11235,10381,914,11295,119
2022-01-02,Imperial,025,180216,39186,37672,4733,42405,800
2022-01-02,Inyo,027,18085,2958,2726,50,2776,49
2022-01-02,Kern,029,883053,141314,136123,27159,163282,1917
2022-01-02,Kings,031,150075,35513,34318,2166,36484,386
2022-01-02,Lake,033,64148,7268,7060,213,7273,117
2022-01-02,Lassen,035,31185,7171,7089,437,7526,55
2022-01-02,Los Angeles,037,10098052,1774137,1596123,75553,1671676,27371
2022-01-02,Madera,039,155013,25788,25002,2522,27524,320
2022-01-02,Marin,041,260295,22636,20475,1014,21489,249
2022-01-02,Mariposa,043,17540,1607,1509,65,1574,6
2022-01-02,Mendocino,045,87422,8868,8422,744,9166,101
2022-01-02,Merced,047,269075,45870,44769,2322,47091,694
2022-01-02,Modoc,049,8938,617,601,214,815,6
2022-01-02,Mono,051,14174,2274,2101,34,2135,4
2022-01-02,Monterey,053,433212,53894,50251,4069,54320,643
2022-01-02,Napa,055,140530,15988,14439,288,14727,107
2022-01-02,Nevada,057,99092,10905,10299,405,10704,110
2022-01-02,Orange,059,3164182,377001,339526,24030,363556,5890
2022-01-02,Placer,061,380077,43520,40857,4603,45460,489
2022-01-02,Plumas,063,18699,2083,1994,56,2050,12
2022-01-02,Riverside,065,2383286,425503,397124,18965,416089,5501
2022-01-02,Sacramento,067,1510023,185044,173562,6676,180238,2448
2022-01-02,San Benito,069,59416,8842,8320,208,8528,79
2022-01-02,San Bernardino,071,2135413,417670,386278,14068,400346,6051
2022-01-02,San Diego,073,3302833,479139,427087,28846,455933,4469
2022-01-02,San Francisco,075,870044,74570,64498,3459,67957,682
2022-01-02,San Joaquin,077,732212,112570,106640,6227,112867,1902
2022-01-02,San Luis Obispo,079,281455,34439,32342,1610,33952,365
2022-01-02,San Mateo,081,765935,71798,60504,1889,62393,581
2022-01-02,Santa Barbara,083,443738,53735,49555,1880,51435,568
2022-01-02,Santa Clara,085,1922200,183718,164547,3062,167609,1969
2022-01-02,Santa Cruz,087,273765,25054,22980,1279,24259,228
2022-01-02,Shasta,089,179085,23708,23161,3850,27011,435
2022-01-02,Sierra,091,2930,217,206,21,227,0
2022-01-02,Siskiyou,093,43540,3585,3474,1445,4919,61
2022-01-02,Solano,095,438530,52675,48957,1784,50741,379
2022-01-02,Sonoma,097,501317,49807,46040,821,46861,410
2022-01-02,Stanislaus,099,539301,86636,84367,9990,94357,1332
2022-01-02,Sutter,101,95872,15131,14741,446,15187,193
2022-01-02,Tehama,103,63373,9188,8944,1626,10570,139
2022-01-02,Trinity,105,12862,928,832,222,1054,17
2022-01-02,Tulare,107,460477,74493,71941,17528,89469,1160
2022-01-02,Tuolumne,109,53932,8383,8044,125,8169,91
2022-01-02,Ventura,111,848112,119665,107992,6044,114036,1211
2022-01-02,Yolo,113,214977,23754,21747,1586,23333,270
2022-01-02,Yuba,115,75493,11264,10844,438,11282,99
2022-01-01,Alameda,001,1643700,146310,133486,4156,137642,1528
2022-01-01,Alpine,003,1148,111,113,0,113,0
2022-01-01,Amador,005,37829,6076,5913,87,6000,70
2022-01-01,Butte,007,227075,23528,22469,4324,26793,341
2022-01-01,Calaveras,009,45235,4832,4668,70,4738,93
2022-01-01,Colusa,011,21464,2723,2659,732,3391,21
2022-01-01,Contra Costa,013,1133247,119198,109593,3327,112920,1073
2022-01-01,Del Norte,015,27424,3902,3841,63,3904,43
2022-01-01,El Dorado,017,186661,18699,17621,1979,19600,172
2022-01-01,Fresno,019,978130,155309,149927,13941,163868,2379
2022-01-01,Glenn,021,27897,3737,3663,1091,4754,39
2022-01-01,Humboldt,023,135768,11097,10381,893,11274,119
2022-01-01,Imperial,025,180216,39038,37672,4685,42357,800
2022-01-01,Inyo,027,18085,2929,2726,48,2774,49
2022-01-01,Kern,029,883053,140614,136123,26854,162977,1917
2022-01-01,Kings,031,150075,35372,34318,2139,36457,386
2022-01-01,Lake,033,64148,7230,7060,208,7268,117
2022-01-01,Lassen,035,31185,7165,7089,432,7521,55
2022-01-01,Los Angeles,037,10098052,1754017,1596123,73604,1669727,27371
2022-01-01,Madera,039,155013,25704,25002,2507,27509,320
2022-01-01,Marin,041,260295,22323,20475,973,21448,249
2022-01-01,Mariposa,043,17540,1596,1509,65,1574,6
2022-01-01,Mendocino,045,87422,8776,8422,738,9160,101
2022-01-01,Merced,047,269075,45737,44769,2309,47078,694
2022-01-01,Modoc,049,8938,614,601,214,815,6
2022-01-01,Mono,051,14174,2250,2101,29,2130,4
2022-01-01,Monterey,053,433212,53584,50251,3982,54233,643
2022-01-01,Napa,055,140530,15838,14439,273,14712,107
2022-01-01,Nevada,057,99092,10830,10299,398,10697,110
2022-01-01,Orange,059,3164182,372779,339526,23322,362848,5890
2022-01-01,Placer,061,380077,43217,40857,4537,45394,489
2022-01-01,Plumas,063,18699,2071,1994,56,2050,12
2022-01-01,Riverside,065,2383286,422012,397124,18763,415887,5501
2022-01-01,Sacramento,067,1510023,183770,173562,6420,179982,2448
2022-01-01,San Benito,069,59416,8752,8320,208,8528,79
2022-01-01,San Bernardino,071,2135413,414477,386278,13790,400068,6051
2022-01-01,San Diego,073,3302833,473194,427087,28327,455414,4469
2022-01-01,San Francisco,075,870044,73166,64498,3248,67746,682
2022-01-01,San Joaquin,077,732212,111865,106640,6154,112794,1902
2022-01-01,San Luis Obispo,079,281455,34236,32342,1601,33943,365
2022-01-01,San Mateo,081,765935,70331,60504,1740,62244,581
2022-01-01,Santa Barbara,083,443738,52995,49555,1845,51400,568
2022-01-01,Santa Clara,085,1922200,180683,164547,2866,167413,1969
2022-01-01,Santa Cruz,087,273765,24734,22980,1261,24241,228
2022-01-01,Shasta,089,179085,23624,23161,3832,26993,435
2022-01-01,Sierra,091,2930,216,206,21,227,0
2022-01-01,Siskiyou,093,43540,3582,3474,1435,4909,61
2022-01-01,Solano,095,438530,52408,48957,1727,50684,379
2022-01-01,Sonoma,097,501317,49413,46040,791,46831,410
2022-01-01,Stanislaus,099,539301,86229,84367,9904,94271,1332
2022-01-01,Sutter,101,95872,15054,14741,444,15185,193
2022-01-01,Tehama,103,63373,9156,8944,1614,10558,139
2022-01-01,Trinity,105,12862,925,832,222,1054,17
2022-01-01,Tulare,107,460477,74248,71941,17429,89370,1160
2022-01-01,Tuolumne,109,53932,8323,8044,122,8166,91
2022-01-01,Ventura,111,848112,118278,107992,5915,113907,1211
2022-01-01,Yolo,113,214977,23333,21747,1546,23293,270
2022-01-01,Yuba,115,75493,11198,10844,432,11276,99
2021-12-31,Alameda,001,1643700,145552,133486,4060,137546,1528
2021-12-31,Alpine,003,1148,111,113,0,113,0
2021-12-31,Amador,005,37829,6052,5913,86,5999,70
2021-12-31,Butte,007,227075,23422,22469,4288,26757,341
2021-12-31,Calaveras,009,45235,4799,4668,70,4738,93
2021-12-31,Colusa,011,21464,2714,2659,726,3385,21
2021-12-31,Contra Costa,013,1133247,118310,109593,3248,112841,1073
2021-12-31,Del Norte,015,27424,3893,3841,61,3902,43
2021-12-31,El Dorado,017,186661,18617,17621,1961,19582,172
2021-12-31,Fresno,019,978130,155004,149927,13919,163846,2379
2021-12-31,Glenn,021,27897,3736,3663,1089,4752,39
2021-12-31,Humboldt,023,135768,11010,10381,874,11255,119
2021-12-31,Imperial,025,180216,38907,37672,4669,42341,800
2021-12-31,Inyo,027,18085,2902,2726,48,2774,49
2021-12-31,Kern,029,883053,140109,136123,26717,162840,1917
2021-12-31,Kings,031,150075,35262,34318,2129,36447,386
2021-12-31,Lake,033,64148,7207,7060,203,7263,117
2021-12-31,Lassen,035,31185,7151,7089,432,7521,55
2021-12-31,Los Angeles,037,10098052,1743245,1596123,72852,1668975,27371
2021-12-31,Madera,039,155013,25635,25002,2490,27492,320
2021-12-31,Marin,041,260295,22167,20475,942,21417,249
2021-12-31,Mariposa,043,17540,1589,1509,64,1573,6
2021-12-31,Mendocino,045,87422,8743,8422,735,9157,101
2021-12-31,Merced,047,269075,45653,44769,2291,47060,694
2021-12-31,Modoc,049,8938,610,601,212,813,6
2021-12-31,Mono,051,14174,2238,2101,28,2129,4
2021-12-31,Monterey,053,433212,53457,50251,3916,54167,643
2021-12-31,Napa,055,140530,15726,14439,263,14702,107
2021-12-31,Nevada,057,99092,10763,10299,392,10691,110
2021-12-31,Orange,059,3164182,370269,339526,22900,362426,5890
2021-12-31,Placer,061,380077,42984,40857,4471,45328,489
2021-12-31,Plumas,063,18699,2066,1994,56,2050,12
2021-12-31,Riverside,065,2383286,420324,397124,18608,415732,5501
2021-12-31,Sacramento,067,1510023,182905,173562,6314,179876,2448
2021-12-31,San Benito,069,59416,8738,8320,207,8527,79
2021-12-31,San Bernardino,071,2135413,412215,386278,13601,399879,6051
2021-12-31,San Diego,073,3302833,469976,427087,28009,455096,4469
2021-12-31,San Francisco,075,870044,72241,64498,3191,67689,682
2021-12-31,San Joaquin,077,732212,111238,106640,6088,112728,1902
2021-12-31,San Luis Obispo,079,281455,34128,32342,1589,33931,365
2021-12-31,San Mateo,081,765935,69452,60504,1688,62192,581
2021-12-31,Santa Barbara,083,443738,52596,49555,1833,51388,568
2021-12-31,Santa Clara,085,1922200,178731,164547,2727,167274,1969
2021-12-31,Santa Cruz,087,273765,24496,22980,1240,24220,228
2021-12-31,Shasta,089,179085,23561,23161,3811,26972,435
2021-12-31,Sierra,091,2930,216,206,21,227,0
2021-12-31,Siskiyou,093,43540,3575,3474,1424,4898,61
2021-12-31,Solano,095,438530,52250,48957,1701,50658,379
2021-12-31,Sonoma,097,501317,49160,46040,778,46818,410
2021-12-31,Stanislaus,099,539301,85901,84367,9844,94211,1332
2021-12-31,Sutter,101,95872,14993,14741,438,15179,193
2021-12-31,Tehama,103,63373,9124,8944,1605,10549,139
2021-12-31,Trinity,105,12862,924,832,222,1054,17
2021-12-31,Tulare,107,460477,74045,71941,17345,89286,1160
2021-12-31,Tuolumne,109,53932,8279,8044,121,8165,91
2021-12-31,Ventura,111,848112,117304,107992,5833,113825,1211
2021-12-31,Yolo,113,214977,23112,21747,1524,23271,270
2021-12-31,Yuba,115,75493,11141,10844,426,11270,99
2021-12-30,Alameda,001,1643700,144281,133486,3927,137413,1528
2021-12-30,Alpine,003,1148,110,113,0,113,0
2021-12-30,Amador,005,37829,6033,5913,85,5998,70
2021-12-30,Butte,007,227075,23290,22469,4263,26732,341
2021-12-30,Calaveras,009,45235,4780,4668,70,4738,93
2021-12-30,Colusa,011,21464,2713,2659,724,3383,21
2021-12-30,Contra Costa,013,1133247,117218,109593,3138,112731,1073
2021-12-30,Del Norte,015,27424,3882,3841,60,3901,43
2021-12-30,El Dorado,017,186661,18512,17621,1940,19561,172
2021-12-30,Fresno,019,978130,154476,149927,13849,163776,2379
2021-12-30,Glenn,021,27897,3731,3663,1086,4749,39
2021-12-30,Humboldt,023,135768,10941,10381,862,11243,119
2021-12-30,Imperial,025,180216,38739,37672,4558,42230,800
2021-12-30,Inyo,027,18085,2883,2726,46,2772,49
2021-12-30,Kern,029,883053,139575,136123,26417,162540,1917
2021-12-30,Kings,031,150075,35144,34318,2114,36432,386
2021-12-30,Lake,033,64148,7192,7060,198,7258,117
2021-12-30,Lassen,035,31185,7145,7089,432,7521,55
2021-12-30,Los Angeles,037,10098052,1719932,1596123,71597,1667720,27371
2021-12-30,Madera,039,155013,25558,25002,2470,27472,320
2021-12-30,Marin,041,260295,21989,20475,918,21393,249
2021-12-30,Mariposa,043,17540,1583,1509,64,1573,6
2021-12-30,Mendocino,045,87422,8726,8422,724,9146,101
2021-12-30,Merced,047,269075,45551,44769,2276,47045,694
2021-12-30,Modoc,049,8938,609,601,212,813,6
2021-12-30,Mono,051,14174,2233,2101,27,2128,4
2021-12-30,Monterey,053,433212,53145,50251,3856,54107,643
2021-12-30,Napa,055,140530,15582,14439,254,14693,107
2021-12-30,Nevada,057,99092,10699,10299,383,10682,110
2021-12-30,Orange,059,3164182,365179,339526,22349,361875,5890
2021-12-30,Placer,061,380077,42708,40857,4424,45281,489
2021-12-30,Plumas,063,18699,2062,1994,55,2049,12
2021-12-30,Riverside,065,2383286,417053,397124,18456,415580,5501
2021-12-30,Sacramento,067,1510023,181649,173562,6169,179731,2448
2021-12-30,San Benito,069,59416,8692,8320,205,8525,79
2021-12-30,San Bernardino,071,2135413,409660,386278,13457,399735,6051
2021-12-30,San Diego,073,3302833,464832,427087,27498,454585,4469
2021-12-30,San Francisco,075,870044,71152,64498,3119,67617,682
2021-12-30,San Joaquin,077,732212,110644,106640,6044,112684,1902
2021-12-30,San Luis Obispo,079,281455,34007,32342,1576,33918,365
2021-12-30,San Mateo,081,765935,68408,60504,1559,62063,581
2021-12-30,Santa Barbara,083,443738,52118,49555,1814,51369,568
2021-12-30,Santa Clara,085,1922200,176452,164547,2603,167150,1969
2021-12-30,Santa Cruz,087,273765,24258,22980,1206,24186,228
2021-12-30,Shasta,089,179085,23508,23161,3805,26966,435
2021-12-30,Sierra,091,2930,216,206,21,227,0
2021-12-30,Siskiyou,093,43540,3566,3474,1422,4896,61
2021-12-30,Solano,095,438530,51901,48957,1654,50611,379
2021-12-30,Sonoma,097,501317,48824,46040,769,46809,410
2021-12-30,Stanislaus,099,539301,85587,84367,9788,94155,1332
2021-12-30,Sutter,101,95872,14931,14741,437,15178,193
2021-12-30,Tehama,103,63373,9096,8944,1599,10543,139
2021-12-30,Trinity,105,12862,921,832,222,1054,17
2021-12-30,Tulare,107,460477,73862,71941,17268,89209,1160
2021-12-30,Tuolumne,109,53932,8240,8044,121,8165,91
2021-12-30,Ventura,111,848112,116045,107992,5730,113722,1211
2021-12-30,Yolo,113,214977,22973,21747,1498,23245,270
2021-12-30,Yuba,115,75493,11094,10844,424,11268,99
2021-12-29,Alameda,001,1643700,141107,131586,3776,135362,1529
2021-12-29,Alpine,003,1148,110,113,0,113,0
2021-12-29,Amador,005,37829,6010,5905,82,5987,70
2021-12-29,Butte,007,227075,23147,22353,4225,26578,338
2021-12-29,Calaveras,009,45235,4752,4646,68,4714,93
2021-12-29,Colusa,011,21464,2703,2657,719,3376,21
2021-12-29,Contra Costa,013,1133247,115125,108165,3015,111180,1072
2021-12-29,Del Norte,015,27424,3868,3826,58,3884,43
2021-12-29,El Dorado,017,186661,18289,17489,1922,19411,172
2021-12-29,Fresno,019,978130,153350,149318,13738,163056,2364
2021-12-29,Glenn,021,27897,3721,3653,1083,4736,39
2021-12-29,Humboldt,023,135768,10832,10249,840,11089,119
2021-12-29,Imperial,025,180216,38503,37460,4491,41951,800
2021-12-29,Inyo,027,18085,2850,2703,46,2749,49
2021-12-29,Kern,029,883053,138772,135648,26031,161679,1913
2021-12-29,Kings,031,150075,35029,34216,2108,36324,386
2021-12-29,Lake,033,64148,7161,7048,196,7244,117
2021-12-29,Lassen,035,31185,7141,7085,431,7516,55
2021-12-29,Los Angeles,037,10098052,1689944,1576414,69883,1646297,27349
2021-12-29,Madera,039,155013,25454,24923,2459,27382,320
2021-12-29,Marin,041,260295,21633,20025,897,20922,249
2021-12-29,Mariposa,043,17540,1561,1507,64,1571,6
2021-12-29,Mendocino,045,87422,8667,8386,720,9106,99
2021-12-29,Merced,047,269075,45335,44548,2262,46810,693
2021-12-29,Modoc,049,8938,606,600,212,812,6
2021-12-29,Mono,051,14174,2209,2056,26,2082,4
2021-12-29,Monterey,053,433212,52736,50097,3751,53848,641
2021-12-29,Napa,055,140530,15258,14247,235,14482,107
2021-12-29,Nevada,057,99092,10608,10274,382,10656,110
2021-12-29,Orange,059,3164182,357642,334557,21674,356231,5887
2021-12-29,Placer,061,380077,42221,40545,4349,44894,489
2021-12-29,Plumas,063,18699,2050,1990,55,2045,12
2021-12-29,Riverside,065,2383286,411632,392989,18249,411238,5486
2021-12-29,Sacramento,067,1510023,179320,172145,6011,178156,2437
2021-12-29,San Benito,069,59416,8549,8239,204,8443,79
2021-12-29,San Bernardino,071,2135413,404249,382872,13247,396119,6049
2021-12-29,San Diego,073,3302833,453999,421045,26780,447825,4461
2021-12-29,San Francisco,075,870044,69452,63117,3048,66165,684
2021-12-29,San Joaquin,077,732212,109461,106063,5973,112036,1891
2021-12-29,San Luis Obispo,079,281455,33612,31936,1527,33463,365
2021-12-29,San Mateo,081,765935,66779,59478,1451,60929,581
2021-12-29,Santa Barbara,083,443738,51277,49003,1789,50792,568
2021-12-29,Santa Clara,085,1922200,173300,162008,2472,164480,1962
2021-12-29,Santa Cruz,087,273765,23979,22669,1174,23843,228
2021-12-29,Shasta,089,179085,23433,23083,3793,26876,435
2021-12-29,Sierra,091,2930,215,206,21,227,0
2021-12-29,Siskiyou,093,43540,3554,3472,1411,4883,61
2021-12-29,Solano,095,438530,51196,48562,1601,50163,379
2021-12-29,Sonoma,097,501317,48022,45479,747,46226,410
2021-12-29,Stanislaus,099,539301,85105,84083,9732,93815,1332
2021-12-29,Sutter,101,95872,14862,14688,435,15123,193
2021-12-29,Tehama,103,63373,9071,8914,1586,10500,138
2021-12-29,Trinity,105,12862,919,832,222,1054,17
2021-12-29,Tulare,107,460477,73571,71752,17152,88904,1160
2021-12-29,Tuolumne,109,53932,8187,8012,120,8132,91
2021-12-29,Ventura,111,848112,114103,106974,5552,112526,1207
2021-12-29,Yolo,113,214977,22734,21564,1467,23031,270
2021-12-29,Yuba,115,75493,11033,10808,420,11228,99
2021-12-28,Alameda,001,1643700,138005,130427,3620,134047,1522
2021-12-28,Alpine,003,1148,110,113,0,113,0
2021-12-28,Amador,005,37829,5990,5900,81,5981,70
2021-12-28,Butte,007,227075,23003,22285,4208,26493,338
2021-12-28,Calaveras,009,45235,4734,4641,67,4708,91
2021-12-28,Colusa,011,21464,2697,2653,717,3370,21
2021-12-28,Contra Costa,013,1133247,112825,107160,2901,110061,1072
2021-12-28,Del Norte,015,27424,3862,3815,58,3873,43
2021-12-28,El Dorado,017,186661,18065,17419,1912,19331,172
2021-12-28,Fresno,019,978130,152270,148987,13657,162644,2365
2021-12-28,Glenn,021,27897,3695,3639,1079,4718,39
2021-12-28,Humboldt,023,135768,10711,10198,816,11014,119
2021-12-28,Imperial,025,180216,38207,37223,4390,41613,800
2021-12-28,Inyo,027,18085,2792,2676,45,2721,48
2021-12-28,Kern,029,883053,138051,135346,25681,161027,1909
2021-12-28,Kings,031,150075,34893,34165,2093,36258,386
2021-12-28,Lake,033,64148,7142,7044,191,7235,116
2021-12-28,Lassen,035,31185,7132,7083,431,7514,55
2021-12-28,Los Angeles,037,10098052,1657707,1561791,68231,1630022,27323
2021-12-28,Madera,039,155013,25328,24865,2439,27304,320
2021-12-28,Marin,041,260295,21221,19739,867,20606,249
2021-12-28,Mariposa,043,17540,1550,1499,63,1562,6
2021-12-28,Mendocino,045,87422,8607,8366,712,9078,98
2021-12-28,Merced,047,269075,45095,44434,2252,46686,691
2021-12-28,Modoc,049,8938,606,599,211,810,6
2021-12-28,Mono,051,14174,2186,2045,24,2069,4
2021-12-28,Monterey,053,433212,52361,49973,3678,53651,639
2021-12-28,Napa,055,140530,14941,14131,208,14339,107
2021-12-28,Nevada,057,99092,10517,10250,379,10629,110
2021-12-28,Orange,059,3164182,349975,331279,20939,352218,5882
2021-12-28,Placer,061,380077,41752,40410,4279,44689,489
2021-12-28,Plumas,063,18699,2047,1989,55,2044,12
2021-12-28,Riverside,065,2383286,406390,390343,18006,408349,5470
2021-12-28,Sacramento,067,1510023,177037,171290,5882,177172,2426
2021-12-28,San Benito,069,59416,8406,8170,202,8372,79
2021-12-28,San Bernardino,071,2135413,398561,381316,13036,394352,6047
2021-12-28,San Diego,073,3302833,443310,417383,26222,443605,4450
2021-12-28,San Francisco,075,870044,67831,61745,2990,64735,682
2021-12-28,San Joaquin,077,732212,108409,105572,5929,111501,1884
2021-12-28,San Luis Obispo,079,281455,33147,31759,1511,33270,365
2021-12-28,San Mateo,081,765935,65266,58712,1363,60075,582
2021-12-28,Santa Barbara,083,443738,50632,48493,1769,50262,568
2021-12-28,Santa Clara,085,1922200,170163,160811,2377,163188,1962
2021-12-28,Santa Cruz,087,273765,23606,22513,1135,23648,228
2021-12-28,Shasta,089,179085,23363,23035,3788,26823,434
2021-12-28,Sierra,091,2930,212,206,21,227,0
2021-12-28,Siskiyou,093,43540,3545,3468,1406,4874,60
2021-12-28,Solano,095,438530,50281,48318,1547,49865,378
2021-12-28,Sonoma,097,501317,47162,45086,722,45808,410
2021-12-28,Stanislaus,099,539301,84625,83946,9672,93618,1331
2021-12-28,Sutter,101,95872,14813,14662,432,15094,193
2021-12-28,Tehama,103,63373,9054,8893,1584,10477,138
2021-12-28,Trinity,105,12862,917,831,221,1052,17
2021-12-28,Tulare,107,460477,73291,71630,17035,88665,1156
2021-12-28,Tuolumne,109,53932,8145,8006,120,8126,91
2021-12-28,Ventura,111,848112,111993,105883,5422,111305,1207
2021-12-28,Yolo,113,214977,22398,21320,1418,22738,270
2021-12-28,Yuba,115,75493,10977,10778,417,11195,99
2021-12-27,Alameda,001,1643700,135416,129910,3489,133399,1530
2021-12-27,Alpine,003,1148,110,113,0,113,0
2021-12-27,Amador,005,37829,5962,5891,81,5972,70
2021-12-27,Butte,007,227075,22866,22234,4181,26415,335
2021-12-27,Calaveras,009,45235,4708,4630,66,4696,91
2021-12-27,Colusa,011,21464,2686,2652,711,3363,21
2021-12-27,Contra Costa,013,1133247,110664,106692,2820,109512,1071
2021-12-27,Del Norte,015,27424,3853,3802,57,3859,43
2021-12-27,El Dorado,017,186661,17906,17361,1900,19261,172
2021-12-27,Fresno,019,978130,151313,148826,13576,162402,2364
2021-12-27,Glenn,021,27897,3687,3634,1073,4707,39
2021-12-27,Humboldt,023,135768,10598,10164,794,10958,119
2021-12-27,Imperial,025,180216,37966,37180,4296,41476,800
2021-12-27,Inyo,027,18085,2763,2662,43,2705,48
2021-12-27,Kern,029,883053,137400,135119,25379,160498,1907
2021-12-27,Kings,031,150075,34744,34126,2080,36206,382
2021-12-27,Lake,033,64148,7119,7037,181,7218,116
2021-12-27,Lassen,035,31185,7126,7080,431,7511,55
2021-12-27,Los Angeles,037,10098052,1621376,1554074,66487,1620561,27300
2021-12-27,Madera,039,155013,25208,24840,2420,27260,320
2021-12-27,Marin,041,260295,20832,19601,840,20441,249
2021-12-27,Mariposa,043,17540,1535,1495,63,1558,6
2021-12-27,Mendocino,045,87422,8540,8351,707,9058,98
2021-12-27,Merced,047,269075,44865,44383,2235,46618,690
2021-12-27,Modoc,049,8938,604,599,211,810,6
2021-12-27,Mono,051,14174,2123,2026,24,2050,4
2021-12-27,Monterey,053,433212,52060,49918,3627,53545,639
2021-12-27,Napa,055,140530,14671,14083,199,14282,107
2021-12-27,Nevada,057,99092,10448,10239,371,10610,110
2021-12-27,Orange,059,3164182,342496,329222,20137,349359,5875
2021-12-27,Placer,061,380077,41375,40263,4231,44494,489
2021-12-27,Plumas,063,18699,2045,1988,53,2041,12
2021-12-27,Riverside,065,2383286,401805,389096,17750,406846,5470
2021-12-27,Sacramento,067,1510023,175011,170858,5713,176571,2422
2021-12-27,San Benito,069,59416,8288,8133,198,8331,79
2021-12-27,San Bernardino,071,2135413,392761,380526,12840,393366,6047
2021-12-27,San Diego,073,3302833,433107,414968,25730,440698,4445
2021-12-27,San Francisco,075,870044,66089,60920,2925,63845,682
2021-12-27,San Joaquin,077,732212,107490,105413,5865,111278,1876
2021-12-27,San Luis Obispo,079,281455,32703,31671,1490,33161,365
2021-12-27,San Mateo,081,765935,63741,58397,1264,59661,581
2021-12-27,Santa Barbara,083,443738,49846,48209,1749,49958,568
2021-12-27,Santa Clara,085,1922200,167190,159904,2252,162156,1961
2021-12-27,Santa Cruz,087,273765,23319,22456,1117,23573,228
2021-12-27,Shasta,089,179085,23301,23015,3777,26792,432
2021-12-27,Sierra,091,2930,212,206,21,227,0
2021-12-27,Siskiyou,093,43540,3536,3466,1401,4867,60
2021-12-27,Solano,095,438530,49548,48172,1500,49672,378
2021-12-27,Sonoma,097,501317,46586,44990,704,45694,410
2021-12-27,Stanislaus,099,539301,84176,83833,9631,93464,1331
2021-12-27,Sutter,101,95872,14757,14642,427,15069,191
2021-12-27,Tehama,103,63373,9039,8887,1577,10464,136
2021-12-27,Trinity,105,12862,917,827,221,1048,17
2021-12-27,Tulare,107,460477,73026,71562,16940,88502,1146
2021-12-27,Tuolumne,109,53932,8107,7978,119,8097,91
2021-12-27,Ventura,111,848112,109905,105212,5287,110499,1206
2021-12-27,Yolo,113,214977,22105,21300,1384,22684,270
2021-12-27,Yuba,115,75493,10916,10759,416,11175,98
2021-12-26,Alameda,001,1643700,133346,127221,3416,130637,1525
2021-12-26,Alpine,003,1148,110,113,0,113,0
2021-12-26,Amador,005,37829,5946,5861,79,5940,70
2021-12-26,Butte,007,227075,22710,22087,4151,26238,330
2021-12-26,Calaveras,009,45235,4686,4591,66,4657,91
2021-12-26,Colusa,011,21464,2675,2647,705,3352,21
2021-12-26,Contra Costa,013,1133247,108902,105022,2721,107743,1071
2021-12-26,Del Norte,015,27424,3848,3795,57,3852,43
2021-12-26,El Dorado,017,186661,17751,17188,1892,19080,172
2021-12-26,Fresno,019,978130,150610,148027,13497,161524,2358
2021-12-26,Glenn,021,27897,3678,3611,1060,4671,39
2021-12-26,Humboldt,023,135768,10455,10052,771,10823,119
2021-12-26,Imperial,025,180216,37664,36878,4206,41084,800
2021-12-26,Inyo,027,18085,2739,2636,40,2676,47
2021-12-26,Kern,029,883053,136677,134591,25124,159715,1908
2021-12-26,Kings,031,150075,34591,34009,2074,36083,379
2021-12-26,Lake,033,64148,7097,7019,178,7197,116
2021-12-26,Lassen,035,31185,7120,7072,430,7502,55
2021-12-26,Los Angeles,037,10098052,1591524,1515469,64697,1580166,27257
2021-12-26,Madera,039,155013,25089,24741,2404,27145,320
2021-12-26,Marin,041,260295,20453,19085,781,19866,249
2021-12-26,Mariposa,043,17540,1529,1480,63,1543,6
2021-12-26,Mendocino,045,87422,8489,8314,705,9019,98
2021-12-26,Merced,047,269075,44614,44208,2223,46431,690
2021-12-26,Modoc,049,8938,603,597,209,806,6
2021-12-26,Mono,051,14174,2097,2000,24,2024,4
2021-12-26,Monterey,053,433212,51779,49709,3578,53287,638
2021-12-26,Napa,055,140530,14434,13809,194,14003,107
2021-12-26,Nevada,057,99092,10388,10153,364,10517,110
2021-12-26,Orange,059,3164182,336159,322991,19341,342332,5863
2021-12-26,Placer,061,380077,41024,39852,4161,44013,489
2021-12-26,Plumas,063,18699,2037,1987,52,2039,12
2021-12-26,Riverside,065,2383286,397617,384567,17581,402148,5470
2021-12-26,Sacramento,067,1510023,173287,169144,5567,174711,2418
2021-12-26,San Benito,069,59416,8199,7991,194,8185,79
2021-12-26,San Bernardino,071,2135413,388050,376052,12665,388717,6043
2021-12-26,San Diego,073,3302833,424117,406616,25237,431853,4442
2021-12-26,San Francisco,075,870044,64509,58229,2863,61092,682
2021-12-26,San Joaquin,077,732212,106676,104590,5812,110402,1872
2021-12-26,San Luis Obispo,079,281455,32256,31290,1472,32762,365
2021-12-26,San Mateo,081,765935,62340,56973,1217,58190,581
2021-12-26,Santa Barbara,083,443738,49170,47553,1719,49272,567
2021-12-26,Santa Clara,085,1922200,164489,156872,2120,158992,1967
2021-12-26,Santa Cruz,087,273765,23035,22176,1103,23279,228
2021-12-26,Shasta,089,179085,23218,22959,3765,26724,432
2021-12-26,Sierra,091,2930,212,202,21,223,0
2021-12-26,Siskiyou,093,43540,3528,3460,1392,4852,60
2021-12-26,Solano,095,438530,49046,47646,1463,49109,377
2021-12-26,Sonoma,097,501317,46089,44358,672,45030,408
2021-12-26,Stanislaus,099,539301,83804,83368,9589,92957,1331
2021-12-26,Sutter,101,95872,14692,14533,424,14957,191
2021-12-26,Tehama,103,63373,9006,8861,1573,10434,136
2021-12-26,Trinity,105,12862,917,826,220,1046,17
2021-12-26,Tulare,107,460477,72778,71292,16833,88125,1137
2021-12-26,Tuolumne,109,53932,8070,7919,119,8038,91
2021-12-26,Ventura,111,848112,108068,103498,5139,108637,1206
2021-12-26,Yolo,113,214977,21819,21084,1345,22429,270
2021-12-26,Yuba,115,75493,10865,10694,414,11108,98
2021-12-25,Alameda,001,1643700,132270,127221,3352,130573,1525
2021-12-25,Alpine,003,1148,110,113,0,113,0
2021-12-25,Amador,005,37829,5927,5861,79,5940,70
2021-12-25,Butte,007,227075,22612,22087,4134,26221,330
2021-12-25,Calaveras,009,45235,4657,4591,65,4656,91
2021-12-25,Colusa,011,21464,2670,2647,699,3346,21
2021-12-25,Contra Costa,013,1133247,108080,105022,2668,107690,1071
2021-12-25,Del Norte,015,27424,3841,3795,56,3851,43
2021-12-25,El Dorado,017,186661,17698,17188,1881,19069,172
2021-12-25,Fresno,019,978130,150297,148027,13449,161476,2358
2021-12-25,Glenn,021,27897,3667,3611,1056,4667,39
2021-12-25,Humboldt,023,135768,10374,10052,764,10816,119
2021-12-25,Imperial,025,180216,37542,36878,4184,41062,800
2021-12-25,Inyo,027,18085,2719,2636,40,2676,47
2021-12-25,Kern,029,883053,136330,134591,24998,159589,1908
2021-12-25,Kings,031,150075,34501,34009,2067,36076,379
2021-12-25,Lake,033,64148,7085,7019,176,7195,116
2021-12-25,Lassen,035,31185,7118,7072,430,7502,55
2021-12-25,Los Angeles,037,10098052,1578710,1515469,63379,1578848,27257
2021-12-25,Madera,039,155013,25039,24741,2398,27139,320
2021-12-25,Marin,041,260295,20111,19085,732,19817,249
2021-12-25,Mariposa,043,17540,1523,1480,63,1543,6
2021-12-25,Mendocino,045,87422,8451,8314,705,9019,98
2021-12-25,Merced,047,269075,44514,44208,2221,46429,690
2021-12-25,Modoc,049,8938,603,597,209,806,6
2021-12-25,Mono,051,14174,2080,2000,24,2024,4
2021-12-25,Monterey,053,433212,51612,49709,3544,53253,638
2021-12-25,Napa,055,140530,14319,13809,186,13995,107
2021-12-25,Nevada,057,99092,10359,10153,364,10517,110
2021-12-25,Orange,059,3164182,333290,322991,18772,341763,5863
2021-12-25,Placer,061,380077,40841,39852,4127,43979,489
2021-12-25,Plumas,063,18699,2035,1987,52,2039,12
2021-12-25,Riverside,065,2383286,395336,384567,17462,402029,5470
2021-12-25,Sacramento,067,1510023,172471,169144,5462,174606,2418
2021-12-25,San Benito,069,59416,8134,7991,194,8185,79
2021-12-25,San Bernardino,071,2135413,385841,376052,12533,388585,6043
2021-12-25,San Diego,073,3302833,420053,406616,24967,431583,4442
2021-12-25,San Francisco,075,870044,63479,58229,2827,61056,682
2021-12-25,San Joaquin,077,732212,106339,104590,5780,110370,1872
2021-12-25,San Luis Obispo,079,281455,32103,31290,1463,32753,365
2021-12-25,San Mateo,081,765935,61309,56973,1174,58147,581
2021-12-25,Santa Barbara,083,443738,48806,47553,1707,49260,567
2021-12-25,Santa Clara,085,1922200,163012,156872,2053,158925,1967
2021-12-25,Santa Cruz,087,273765,22875,22176,1097,23273,228
2021-12-25,Shasta,089,179085,23185,22959,3759,26718,432
2021-12-25,Sierra,091,2930,212,202,21,223,0
2021-12-25,Siskiyou,093,43540,3525,3460,1386,4846,60
2021-12-25,Solano,095,438530,48921,47646,1445,49091,377
2021-12-25,Sonoma,097,501317,45704,44358,646,45004,408
2021-12-25,Stanislaus,099,539301,83591,83368,9563,92931,1331
2021-12-25,Sutter,101,95872,14651,14533,422,14955,191
2021-12-25,Tehama,103,63373,8986,8861,1569,10430,136
2021-12-25,Trinity,105,12862,916,826,220,1046,17
2021-12-25,Tulare,107,460477,72642,71292,16756,88048,1137
2021-12-25,Tuolumne,109,53932,8039,7919,119,8038,91
2021-12-25,Ventura,111,848112,106895,103498,5033,108531,1206
2021-12-25,Yolo,113,214977,21709,21084,1324,22408,270
2021-12-25,Yuba,115,75493,10838,10694,413,11107,98
2021-12-24,Alameda,001,1643700,131656,127221,3336,130557,1525
2021-12-24,Alpine,003,1148,110,113,0,113,0
2021-12-24,Amador,005,37829,5919,5861,78,5939,70
2021-12-24,Butte,007,227075,22555,22087,4117,26204,330
2021-12-24,Calaveras,009,45235,4651,4591,65,4656,91
2021-12-24,Colusa,011,21464,2668,2647,698,3345,21
2021-12-24,Contra Costa,013,1133247,107764,105022,2637,107659,1071
2021-12-24,Del Norte,015,27424,3834,3795,56,3851,43
2021-12-24,El Dorado,017,186661,17645,17188,1876,19064,172
2021-12-24,Fresno,019,978130,150131,148027,13436,161463,2358
2021-12-24,Glenn,021,27897,3666,3611,1056,4667,39
2021-12-24,Humboldt,023,135768,10318,10052,759,10811,119
2021-12-24,Imperial,025,180216,37459,36878,4180,41058,800
2021-12-24,Inyo,027,18085,2699,2636,40,2676,47
2021-12-24,Kern,029,883053,136207,134591,24956,159547,1908
2021-12-24,Kings,031,150075,34433,34009,2066,36075,379
2021-12-24,Lake,033,64148,7081,7019,176,7195,116
2021-12-24,Lassen,035,31185,7115,7072,430,7502,55
2021-12-24,Los Angeles,037,10098052,1573844,1515469,62852,1578321,27257
2021-12-24,Madera,039,155013,25004,24741,2393,27134,320
2021-12-24,Marin,041,260295,19965,19085,701,19786,249
2021-12-24,Mariposa,043,17540,1521,1480,63,1543,6
2021-12-24,Mendocino,045,87422,8434,8314,705,9019,98
2021-12-24,Merced,047,269075,44464,44208,2219,46427,690
2021-12-24,Modoc,049,8938,603,597,209,806,6
2021-12-24,Mono,051,14174,2067,2000,24,2024,4
2021-12-24,Monterey,053,433212,51515,49709,3518,53227,638
2021-12-24,Napa,055,140530,14253,13809,182,13991,107
2021-12-24,Nevada,057,99092,10333,10153,362,10515,110
2021-12-24,Orange,059,3164182,332238,322991,18614,341605,5863
2021-12-24,Placer,061,380077,40721,39852,4111,43963,489
2021-12-24,Plumas,063,18699,2034,1987,52,2039,12
2021-12-24,Riverside,065,2383286,394339,384567,17372,401939,5470
2021-12-24,Sacramento,067,1510023,172155,169144,5427,174571,2418
2021-12-24,San Benito,069,59416,8125,7991,193,8184,79
2021-12-24,San Bernardino,071,2135413,384716,376052,12461,388513,6043
2021-12-24,San Diego,073,3302833,418929,406616,24840,431456,4442
2021-12-24,San Francisco,075,870044,62970,58229,2810,61039,682
2021-12-24,San Joaquin,077,732212,106144,104590,5772,110362,1872
2021-12-24,San Luis Obispo,079,281455,32041,31290,1453,32743,365
2021-12-24,San Mateo,081,765935,60877,56973,1151,58124,581
2021-12-24,Santa Barbara,083,443738,48601,47553,1700,49253,567
2021-12-24,Santa Clara,085,1922200,162188,156872,2019,158891,1967
2021-12-24,Santa Cruz,087,273765,22792,22176,1094,23270,228
2021-12-24,Shasta,089,179085,23151,22959,3755,26714,432
2021-12-24,Sierra,091,2930,211,202,21,223,0
2021-12-24,Siskiyou,093,43540,3520,3460,1382,4842,60
2021-12-24,Solano,095,438530,48869,47646,1443,49089,377
2021-12-24,Sonoma,097,501317,45538,44358,638,44996,408
2021-12-24,Stanislaus,099,539301,83479,83368,9540,92908,1331
2021-12-24,Sutter,101,95872,14631,14533,419,14952,191
2021-12-24,Tehama,103,63373,8977,8861,1566,10427,136
2021-12-24,Trinity,105,12862,914,826,220,1046,17
2021-12-24,Tulare,107,460477,72575,71292,16713,88005,1137
2021-12-24,Tuolumne,109,53932,8014,7919,119,8038,91
2021-12-24,Ventura,111,848112,106448,103498,4977,108475,1206
2021-12-24,Yolo,113,214977,21635,21084,1306,22390,270
2021-12-24,Yuba,115,75493,10815,10694,412,11106,98
2021-12-23,Alameda,001,1643700,130954,127221,3302,130523,1525
2021-12-23,Alpine,003,1148,110,113,0,113,0
2021-12-23,Amador,005,37829,5907,5861,76,5937,70
2021-12-23,Butte,007,227075,22503,22087,4106,26193,330
2021-12-23,Calaveras,009,45235,4640,4591,65,4656,91
2021-12-23,Colusa,011,21464,2662,2647,694,3341,21
2021-12-23,Contra Costa,013,1133247,107335,105022,2593,107615,1071
2021-12-23,Del Norte,015,27424,3831,3795,56,3851,43
2021-12-23,El Dorado,017,186661,17582,17188,1870,19058,172
2021-12-23,Fresno,019,978130,149926,148027,13417,161444,2358
2021-12-23,Glenn,021,27897,3662,3611,1056,4667,39
2021-12-23,Humboldt,023,135768,10265,10052,756,10808,119
2021-12-23,Imperial,025,180216,37385,36878,4153,41031,800
2021-12-23,Inyo,027,18085,2686,2636,40,2676,47
2021-12-23,Kern,029,883053,136057,134591,24860,159451,1908
2021-12-23,Kings,031,150075,34392,34009,2065,36074,379
2021-12-23,Lake,033,64148,7069,7019,174,7193,116
2021-12-23,Lassen,035,31185,7114,7072,430,7502,55
2021-12-23,Los Angeles,037,10098052,1564305,1515469,61765,1577234,27257
2021-12-23,Madera,039,155013,24971,24741,2389,27130,320
2021-12-23,Marin,041,260295,19831,19085,684,19769,249
2021-12-23,Mariposa,043,17540,1516,1480,63,1543,6
2021-12-23,Mendocino,045,87422,8425,8314,705,9019,98
2021-12-23,Merced,047,269075,44415,44208,2217,46425,690
2021-12-23,Modoc,049,8938,603,597,209,806,6
2021-12-23,Mono,051,14174,2046,2000,23,2023,4
2021-12-23,Monterey,053,433212,51393,49709,3497,53206,638
2021-12-23,Napa,055,140530,14172,13809,177,13986,107
2021-12-23,Nevada,057,99092,10309,10153,361,10514,110
2021-12-23,Orange,059,3164182,330547,322991,18284,341275,5863
2021-12-23,Placer,061,380077,40598,39852,4095,43947,489
2021-12-23,Plumas,063,18699,2034,1987,52,2039,12
2021-12-23,Riverside,065,2383286,393122,384567,17303,401870,5470
2021-12-23,Sacramento,067,1510023,171699,169144,5380,174524,2418
2021-12-23,San Benito,069,59416,8106,7991,191,8182,79
2021-12-23,San Bernardino,071,2135413,383544,376052,12356,388408,6043
2021-12-23,San Diego,073,3302833,417076,406616,24642,431258,4442
2021-12-23,San Francisco,075,870044,62241,58229,2782,61011,682
2021-12-23,San Joaquin,077,732212,105926,104590,5759,110349,1872
2021-12-23,San Luis Obispo,079,281455,31969,31290,1449,32739,365
2021-12-23,San Mateo,081,765935,60315,56973,1131,58104,581
2021-12-23,Santa Barbara,083,443738,48402,47553,1698,49251,567
2021-12-23,Santa Clara,085,1922200,161281,156872,1960,158832,1967
2021-12-23,Santa Cruz,087,273765,22677,22176,1082,23258,228
2021-12-23,Shasta,089,179085,23121,22959,3752,26711,432
2021-12-23,Sierra,091,2930,208,202,21,223,0
2021-12-23,Siskiyou,093,43540,3520,3460,1380,4840,60
2021-12-23,Solano,095,438530,48762,47646,1427,49073,377
2021-12-23,Sonoma,097,501317,45361,44358,637,44995,408
2021-12-23,Stanislaus,099,539301,83350,83368,9520,92888,1331
2021-12-23,Sutter,101,95872,14614,14533,418,14951,191
2021-12-23,Tehama,103,63373,8965,8861,1562,10423,136
2021-12-23,Trinity,105,12862,914,826,220,1046,17
2021-12-23,Tulare,107,460477,72500,71292,16670,87962,1137
2021-12-23,Tuolumne,109,53932,7996,7919,118,8037,91
2021-12-23,Ventura,111,848112,105912,103498,4911,108409,1206
2021-12-23,Yolo,113,214977,21563,21084,1288,22372,270
2021-12-23,Yuba,115,75493,10802,10694,412,11106,98
2021-12-22,Alameda,001,1643700,130031,126533,3220,129753,1522
2021-12-22,Alpine,003,1148,110,112,0,112,0
2021-12-22,Amador,005,37829,5894,5850,75,5925,70
2021-12-22,Butte,007,227075,22453,22070,4092,26162,330
2021-12-22,Calaveras,009,45235,4631,4580,65,4645,91
2021-12-22,Colusa,011,21464,2662,2645,691,3336,21
2021-12-22,Contra Costa,013,1133247,106698,104559,2551,107110,1070
2021-12-22,Del Norte,015,27424,3831,3794,56,3850,43
2021-12-22,El Dorado,017,186661,17520,17140,1861,19001,172
2021-12-22,Fresno,019,978130,149645,147838,13386,161224,2349
2021-12-22,Glenn,021,27897,3657,3604,1056,4660,39
2021-12-22,Humboldt,023,135768,10204,10022,751,10773,119
2021-12-22,Imperial,025,180216,37299,36755,4116,40871,798
2021-12-22,Inyo,027,18085,2668,2632,40,2672,47
2021-12-22,Kern,029,883053,135822,134433,24778,159211,1900
2021-12-22,Kings,031,150075,34342,33953,2058,36011,376
2021-12-22,Lake,033,64148,7062,7008,172,7180,116
2021-12-22,Lassen,035,31185,7109,7069,429,7498,55
2021-12-22,Los Angeles,037,10098052,1550759,1507110,60606,1567716,27234
2021-12-22,Madera,039,155013,24933,24702,2385,27087,320
2021-12-22,Marin,041,260295,19610,18927,661,19588,249
2021-12-22,Mariposa,043,17540,1509,1480,63,1543,6
2021-12-22,Mendocino,045,87422,8416,8299,705,9004,99
2021-12-22,Merced,047,269075,44344,44137,2215,46352,689
2021-12-22,Modoc,049,8938,603,595,209,804,6
2021-12-22,Mono,051,14174,2042,1979,23,2002,4
2021-12-22,Monterey,053,433212,51236,49650,3480,53130,639
2021-12-22,Napa,055,140530,14045,13746,167,13913,107
2021-12-22,Nevada,057,99092,10281,10101,356,10457,110
2021-12-22,Orange,059,3164182,328253,321765,17856,339621,5858
2021-12-22,Placer,061,380077,40415,39758,4058,43816,489
2021-12-22,Plumas,063,18699,2030,1986,52,2038,12
2021-12-22,Riverside,065,2383286,391290,383319,17190,400509,5472
2021-12-22,Sacramento,067,1510023,171040,168695,5320,174015,2422
2021-12-22,San Benito,069,59416,8054,7971,189,8160,79
2021-12-22,San Bernardino,071,2135413,381868,375044,12273,387317,6039
2021-12-22,San Diego,073,3302833,412958,404269,24313,428582,4434
2021-12-22,San Francisco,075,870044,61254,57520,2739,60259,682
2021-12-22,San Joaquin,077,732212,105656,104385,5745,110130,1870
2021-12-22,San Luis Obispo,079,281455,31828,31175,1429,32604,365
2021-12-22,San Mateo,081,765935,59632,56604,1101,57705,581
2021-12-22,Santa Barbara,083,443738,48145,47372,1682,49054,566
2021-12-22,Santa Clara,085,1922200,160160,156258,1919,158177,1954
2021-12-22,Santa Cruz,087,273765,22570,22075,1077,23152,228
2021-12-22,Shasta,089,179085,23092,22937,3747,26684,432
2021-12-22,Sierra,091,2930,208,202,21,223,0
2021-12-22,Siskiyou,093,43540,3517,3458,1377,4835,59
2021-12-22,Solano,095,438530,48533,47531,1414,48945,375
2021-12-22,Sonoma,097,501317,45086,44201,626,44827,408
2021-12-22,Stanislaus,099,539301,83209,83245,9500,92745,1331
2021-12-22,Sutter,101,95872,14578,14513,415,14928,191
2021-12-22,Tehama,103,63373,8952,8853,1558,10411,136
2021-12-22,Trinity,105,12862,914,826,220,1046,17
2021-12-22,Tulare,107,460477,72400,71226,16621,87847,1137
2021-12-22,Tuolumne,109,53932,7975,7903,118,8021,91
2021-12-22,Ventura,111,848112,105306,103089,4806,107895,1206
2021-12-22,Yolo,113,214977,21487,21012,1274,22286,270
2021-12-22,Yuba,115,75493,10785,10681,412,11093,98
2021-12-21,Alameda,001,1643700,129032,126007,3165,129172,1518
2021-12-21,Alpine,003,1148,110,112,0,112,0
2021-12-21,Amador,005,37829,5884,5845,75,5920,70
2021-12-21,Butte,007,227075,22390,22041,4078,26119,330
2021-12-21,Calaveras,009,45235,4618,4575,65,4640,91
2021-12-21,Colusa,011,21464,2660,2643,690,3333,21
2021-12-21,Contra Costa,013,1133247,106069,104255,2487,106742,1068
2021-12-21,Del Norte,015,27424,3830,3793,56,3849,43
2021-12-21,El Dorado,017,186661,17455,17098,1849,18947,172
2021-12-21,Fresno,019,978130,149358,147707,13351,161058,2341
2021-12-21,Glenn,021,27897,3643,3602,1056,4658,39
2021-12-21,Humboldt,023,135768,10140,9989,746,10735,118
2021-12-21,Imperial,025,180216,37201,36580,4075,40655,792
2021-12-21,Inyo,027,18085,2657,2627,40,2667,47
2021-12-21,Kern,029,883053,135613,134321,24673,158994,1892
2021-12-21,Kings,031,150075,34282,33914,2057,35971,376
2021-12-21,Lake,033,64148,7057,7004,170,7174,116
2021-12-21,Lassen,035,31185,7107,7069,429,7498,55
2021-12-21,Los Angeles,037,10098052,1536858,1501169,59584,1560753,27220
2021-12-21,Madera,039,155013,24896,24688,2378,27066,320
2021-12-21,Marin,041,260295,19440,18828,626,19454,249
2021-12-21,Mariposa,043,17540,1508,1480,62,1542,6
2021-12-21,Mendocino,045,87422,8400,8282,703,8985,97
2021-12-21,Merced,047,269075,44272,44096,2212,46308,688
2021-12-21,Modoc,049,8938,601,595,207,802,6
2021-12-21,Mono,051,14174,2023,1979,23,2002,4
2021-12-21,Monterey,053,433212,51145,49586,3463,53049,638
2021-12-21,Napa,055,140530,13944,13703,156,13859,107
2021-12-21,Nevada,057,99092,10252,10095,356,10451,110
2021-12-21,Orange,059,3164182,326129,320705,17408,338113,5855
2021-12-21,Placer,061,380077,40274,39649,4029,43678,487
2021-12-21,Plumas,063,18699,2030,1975,52,2027,12
2021-12-21,Riverside,065,2383286,389565,382415,17071,399486,5465
2021-12-21,Sacramento,067,1510023,170390,168422,5265,173687,2419
2021-12-21,San Benito,069,59416,8015,7950,186,8136,79
2021-12-21,San Bernardino,071,2135413,380229,374219,12165,386384,6026
2021-12-21,San Diego,073,3302833,409229,402386,23976,426362,4424
2021-12-21,San Francisco,075,870044,60294,56950,2706,59656,681
2021-12-21,San Joaquin,077,732212,105370,104238,5726,109964,1870
2021-12-21,San Luis Obispo,079,281455,31664,31103,1417,32520,365
2021-12-21,San Mateo,081,765935,59015,56381,1078,57459,581
2021-12-21,Santa Barbara,083,443738,47917,47194,1667,48861,564
2021-12-21,Santa Clara,085,1922200,159135,155769,1877,157646,1951
2021-12-21,Santa Cruz,087,273765,22453,22028,1067,23095,228
2021-12-21,Shasta,089,179085,23061,22920,3743,26663,429
2021-12-21,Sierra,091,2930,206,201,21,222,0
2021-12-21,Siskiyou,093,43540,3516,3455,1377,4832,59
2021-12-21,Solano,095,438530,48379,47474,1407,48881,372
2021-12-21,Sonoma,097,501317,44863,44051,616,44667,408
2021-12-21,Stanislaus,099,539301,83054,83167,9469,92636,1331
2021-12-21,Sutter,101,95872,14555,14492,414,14906,190
2021-12-21,Tehama,103,63373,8944,8849,1553,10402,136
2021-12-21,Trinity,105,12862,913,826,220,1046,17
2021-12-21,Tulare,107,460477,72307,71166,16580,87746,1137
2021-12-21,Tuolumne,109,53932,7951,7893,118,8011,91
2021-12-21,Ventura,111,848112,104687,102631,4693,107324,1205
2021-12-21,Yolo,113,214977,21378,20944,1270,22214,267
2021-12-21,Yuba,115,75493,10768,10668,412,11080,98
2021-12-20,Alameda,001,1643700,128099,125762,3097,128859,1515
2021-12-20,Alpine,003,1148,110,112,0,112,0
2021-12-20,Amador,005,37829,5870,5838,75,5913,70
2021-12-20,Butte,007,227075,22328,22030,4066,26096,329
2021-12-20,Calaveras,009,45235,4608,4569,65,4634,91
2021-12-20,Colusa,011,21464,2659,2644,690,3334,21
2021-12-20,Contra Costa,013,1133247,105535,104051,2440,106491,1068
2021-12-20,Del Norte,015,27424,3828,3792,56,3848,43
2021-12-20,El Dorado,017,186661,17394,17083,1841,18924,172
2021-12-20,Fresno,019,978130,149115,147605,13322,160927,2341
2021-12-20,Glenn,021,27897,3637,3597,1056,4653,39
2021-12-20,Humboldt,023,135768,10098,9973,742,10715,118
2021-12-20,Imperial,025,180216,37085,36532,4045,40577,792
2021-12-20,Inyo,027,18085,2654,2615,40,2655,47
2021-12-20,Kern,029,883053,135414,134203,24613,158816,1883
2021-12-20,Kings,031,150075,34240,33898,2056,35954,376
2021-12-20,Lake,033,64148,7052,6999,170,7169,116
2021-12-20,Lassen,035,31185,7105,7065,428,7493,55
2021-12-20,Los Angeles,037,10098052,1525383,1495251,58858,1554109,27188
2021-12-20,Madera,039,155013,24867,24668,2374,27042,313
2021-12-20,Marin,041,260295,19225,18747,608,19355,249
2021-12-20,Mariposa,043,17540,1499,1479,62,1541,6
2021-12-20,Mendocino,045,87422,8388,8264,701,8965,96
2021-12-20,Merced,047,269075,44215,44071,2207,46278,687
2021-12-20,Modoc,049,8938,601,595,204,799,6
2021-12-20,Mono,051,14174,2000,1973,23,1996,4
2021-12-20,Monterey,053,433212,51049,49556,3443,52999,636
2021-12-20,Napa,055,140530,13859,13672,146,13818,107
2021-12-20,Nevada,057,99092,10212,10079,355,10434,109
2021-12-20,Orange,059,3164182,324524,320235,17093,337328,5852
2021-12-20,Placer,061,380077,40144,39579,3999,43578,485
2021-12-20,Plumas,063,18699,2027,1971,50,2021,12
2021-12-20,Riverside,065,2383286,388115,381841,16981,398822,5452
2021-12-20,Sacramento,067,1510023,169820,168153,5225,173378,2414
2021-12-20,San Benito,069,59416,7971,7934,184,8118,79
2021-12-20,San Bernardino,071,2135413,378729,373881,12081,385962,6023
2021-12-20,San Diego,073,3302833,406015,401483,23736,425219,4412
2021-12-20,San Francisco,075,870044,59235,56661,2649,59310,681
2021-12-20,San Joaquin,077,732212,105127,104188,5717,109905,1865
2021-12-20,San Luis Obispo,079,281455,31550,31075,1409,32484,365
2021-12-20,San Mateo,081,765935,58467,56247,1059,57306,581
2021-12-20,Santa Barbara,083,443738,47707,47131,1662,48793,562
2021-12-20,Santa Clara,085,1922200,158175,155427,1829,157256,1950
2021-12-20,Santa Cruz,087,273765,22373,21989,1062,23051,227
2021-12-20,Shasta,089,179085,23040,22888,3738,26626,429
2021-12-20,Sierra,091,2930,205,201,21,222,0
2021-12-20,Siskiyou,093,43540,3515,3453,1375,4828,59
2021-12-20,Solano,095,438530,48251,47394,1399,48793,370
2021-12-20,Sonoma,097,501317,44672,43982,608,44590,408
2021-12-20,Stanislaus,099,539301,82929,83110,9440,92550,1331
2021-12-20,Sutter,101,95872,14532,14480,414,14894,190
2021-12-20,Tehama,103,63373,8936,8840,1550,10390,136
2021-12-20,Trinity,105,12862,913,826,220,1046,17
2021-12-20,Tulare,107,460477,72213,71124,16522,87646,1129
2021-12-20,Tuolumne,109,53932,7937,7867,114,7981,91
2021-12-20,Ventura,111,848112,104179,102452,4617,107069,1203
2021-12-20,Yolo,113,214977,21285,20903,1258,22161,267
2021-12-20,Yuba,115,75493,10752,10656,409,11065,97
2021-12-19,Alameda,001,1643700,127213,125464,3057,128521,1519
2021-12-19,Alpine,003,1148,110,112,0,112,0
2021-12-19,Amador,005,37829,5858,5832,74,5906,70
2021-12-19,Butte,007,227075,22273,22022,4058,26080,329
2021-12-19,Calaveras,009,45235,4592,4563,64,4627,91
2021-12-19,Colusa,011,21464,2659,2643,687,3330,21
2021-12-19,Contra Costa,013,1133247,105044,103906,2406,106312,1068
2021-12-19,Del Norte,015,27424,3824,3797,56,3853,43
2021-12-19,El Dorado,017,186661,17337,17067,1839,18906,172
2021-12-19,Fresno,019,978130,148874,147505,13297,160802,2341
2021-12-19,Glenn,021,27897,3633,3596,1055,4651,39
2021-12-19,Humboldt,023,135768,10056,9957,737,10694,118
2021-12-19,Imperial,025,180216,36956,36501,4002,40503,792
2021-12-19,Inyo,027,18085,2645,2613,40,2653,47
2021-12-19,Kern,029,883053,135215,134136,24545,158681,1883
2021-12-19,Kings,031,150075,34182,33874,2052,35926,378
2021-12-19,Lake,033,64148,7043,6999,167,7166,116
2021-12-19,Lassen,035,31185,7101,7065,428,7493,55
2021-12-19,Los Angeles,037,10098052,1516391,1495082,58257,1553339,27189
2021-12-19,Madera,039,155013,24843,24642,2368,27010,313
2021-12-19,Marin,041,260295,19049,18707,585,19292,249
2021-12-19,Mariposa,043,17540,1493,1475,62,1537,6
2021-12-19,Mendocino,045,87422,8371,8257,698,8955,96
2021-12-19,Merced,047,269075,44120,44045,2200,46245,687
2021-12-19,Modoc,049,8938,600,595,204,799,6
2021-12-19,Mono,051,14174,1989,1968,22,1990,4
2021-12-19,Monterey,053,433212,50948,49516,3422,52938,636
2021-12-19,Napa,055,140530,13786,13659,137,13796,107
2021-12-19,Nevada,057,99092,10176,10057,352,10409,109
2021-12-19,Orange,059,3164182,323118,319615,16867,336482,5852
2021-12-19,Placer,061,380077,40023,39525,3983,43508,485
2021-12-19,Plumas,063,18699,2024,1971,50,2021,12
2021-12-19,Riverside,065,2383286,386671,381305,16906,398211,5452
2021-12-19,Sacramento,067,1510023,169326,167933,5196,173129,2415
2021-12-19,San Benito,069,59416,7946,7929,183,8112,79
2021-12-19,San Bernardino,071,2135413,377423,373480,12043,385523,6023
2021-12-19,San Diego,073,3302833,403535,398197,23540,421737,4406
2021-12-19,San Francisco,075,870044,58357,56358,2593,58951,681
2021-12-19,San Joaquin,077,732212,104870,104125,5703,109828,1865
2021-12-19,San Luis Obispo,079,281455,31427,31035,1397,32432,366
2021-12-19,San Mateo,081,765935,58002,56132,1044,57176,581
2021-12-19,Santa Barbara,083,443738,47484,47070,1655,48725,562
2021-12-19,Santa Clara,085,1922200,157288,155049,1803,156852,1950
2021-12-19,Santa Cruz,087,273765,22274,21960,1057,23017,227
2021-12-19,Shasta,089,179085,23003,22875,3734,26609,429
2021-12-19,Sierra,091,2930,204,201,21,222,0
2021-12-19,Siskiyou,093,43540,3512,3452,1375,4827,59
2021-12-19,Solano,095,438530,48129,47341,1393,48734,370
2021-12-19,Sonoma,097,501317,44488,43944,606,44550,408
2021-12-19,Stanislaus,099,539301,82791,83040,9408,92448,1331
2021-12-19,Sutter,101,95872,14492,14475,413,14888,190
2021-12-19,Tehama,103,63373,8928,8840,1550,10390,136
2021-12-19,Trinity,105,12862,913,826,220,1046,17
2021-12-19,Tulare,107,460477,72120,71085,16480,87565,1129
2021-12-19,Tuolumne,109,53932,7920,7865,113,7978,91
2021-12-19,Ventura,111,848112,103599,102170,4552,106722,1203
2021-12-19,Yolo,113,214977,21204,20887,1239,22126,267
2021-12-19,Yuba,115,75493,10735,10646,407,11053,97
2021-12-18,Alameda,001,1643700,126808,124583,3032,127615,1512
2021-12-18,Alpine,003,1148,110,110,0,110,0
2021-12-18,Amador,005,37829,5852,5821,74,5895,69
2021-12-18,Butte,007,227075,22257,21956,4053,26009,328
2021-12-18,Calaveras,009,45235,4585,4534,64,4598,91
2021-12-18,Colusa,011,21464,2655,2635,685,3320,21
2021-12-18,Contra Costa,013,1133247,104829,103380,2392,105772,1065
2021-12-18,Del Norte,015,27424,3821,3791,56,3847,43
2021-12-18,El Dorado,017,186661,17309,16968,1836,18804,171
2021-12-18,Fresno,019,978130,148771,147038,13284,160322,2335
2021-12-18,Glenn,021,27897,3630,3590,1055,4645,39
2021-12-18,Humboldt,023,135768,10040,9889,737,10626,118
2021-12-18,Imperial,025,180216,36883,36280,3990,40270,790
2021-12-18,Inyo,027,18085,2639,2607,40,2647,47
2021-12-18,Kern,029,883053,135125,133754,24500,158254,1873
2021-12-18,Kings,031,150075,34149,33783,2048,35831,374
2021-12-18,Lake,033,64148,7042,6976,167,7143,115
2021-12-18,Lassen,035,31185,7099,7061,427,7488,55
2021-12-18,Los Angeles,037,10098052,1512301,1484840,57944,1542784,27135
2021-12-18,Madera,039,155013,24828,24575,2366,26941,313
2021-12-18,Marin,041,260295,18948,18537,573,19110,249
2021-12-18,Mariposa,043,17540,1492,1468,62,1530,6
2021-12-18,Mendocino,045,87422,8365,8219,698,8917,95
2021-12-18,Merced,047,269075,44085,43929,2199,46128,686
2021-12-18,Modoc,049,8938,598,595,204,799,6
2021-12-18,Mono,051,14174,1987,1956,22,1978,4
2021-12-18,Monterey,053,433212,50890,49343,3417,52760,635
2021-12-18,Napa,055,140530,13760,13581,135,13716,107
2021-12-18,Nevada,057,99092,10154,9991,350,10341,108
2021-12-18,Orange,059,3164182,322454,318149,16731,334880,5844
2021-12-18,Placer,061,380077,39922,39336,3969,43305,485
2021-12-18,Plumas,063,18699,2024,1964,50,2014,13
2021-12-18,Riverside,065,2383286,385973,379354,16865,396219,5439
2021-12-18,Sacramento,067,1510023,169091,167046,5177,172223,2404
2021-12-18,San Benito,069,59416,7931,7894,183,8077,79
2021-12-18,San Bernardino,071,2135413,376759,371658,12015,383673,6017
2021-12-18,San Diego,073,3302833,402570,397130,23488,420618,4399
2021-12-18,San Francisco,075,870044,57862,55562,2563,58125,679
2021-12-18,San Joaquin,077,732212,104783,103698,5693,109391,1858
2021-12-18,San Luis Obispo,079,281455,31385,30873,1391,32264,365
2021-12-18,San Mateo,081,765935,57762,55730,1039,56769,580
2021-12-18,Santa Barbara,083,443738,47388,46776,1653,48429,562
2021-12-18,Santa Clara,085,1922200,156832,154243,1790,156033,1946
2021-12-18,Santa Cruz,087,273765,22222,21805,1055,22860,225
2021-12-18,Shasta,089,179085,22982,22811,3734,26545,429
2021-12-18,Sierra,091,2930,204,199,21,220,0
2021-12-18,Siskiyou,093,43540,3510,3441,1374,4815,58
2021-12-18,Solano,095,438530,48083,47174,1391,48565,369
2021-12-18,Sonoma,097,501317,44378,43658,602,44260,407
2021-12-18,Stanislaus,099,539301,82709,82736,9396,92132,1330
2021-12-18,Sutter,101,95872,14474,14435,413,14848,190
2021-12-18,Tehama,103,63373,8922,8814,1549,10363,136
2021-12-18,Trinity,105,12862,913,823,220,1043,17
2021-12-18,Tulare,107,460477,72082,70922,16455,87377,1120
2021-12-18,Tuolumne,109,53932,7906,7834,113,7947,91
2021-12-18,Ventura,111,848112,103314,101612,4530,106142,1201
2021-12-18,Yolo,113,214977,21164,20793,1233,22026,267
2021-12-18,Yuba,115,75493,10724,10599,407,11006,96
2021-12-17,Alameda,001,1643700,126474,124583,3013,127596,1512
2021-12-17,Alpine,003,1148,110,110,0,110,0
2021-12-17,Amador,005,37829,5845,5821,74,5895,69
2021-12-17,Butte,007,227075,22236,21956,4046,26002,328
2021-12-17,Calaveras,009,45235,4581,4534,64,4598,91
2021-12-17,Colusa,011,21464,2654,2635,684,3319,21
2021-12-17,Contra Costa,013,1133247,104627,103380,2388,105768,1065
2021-12-17,Del Norte,015,27424,3820,3791,56,3847,43
2021-12-17,El Dorado,017,186661,17281,16968,1833,18801,171
2021-12-17,Fresno,019,978130,148668,147038,13284,160322,2335
2021-12-17,Glenn,021,27897,3623,3590,1055,4645,39
2021-12-17,Humboldt,023,135768,10020,9889,735,10624,118
2021-12-17,Imperial,025,180216,36820,36280,3972,40252,790
2021-12-17,Inyo,027,18085,2634,2607,40,2647,47
2021-12-17,Kern,029,883053,135034,133754,24459,158213,1873
2021-12-17,Kings,031,150075,34130,33783,2048,35831,374
2021-12-17,Lake,033,64148,7038,6976,167,7143,115
2021-12-17,Lassen,035,31185,7099,7061,426,7487,55
2021-12-17,Los Angeles,037,10098052,1508361,1484840,57705,1542545,27135
2021-12-17,Madera,039,155013,24812,24575,2361,26936,313
2021-12-17,Marin,041,260295,18872,18537,569,19106,249
2021-12-17,Mariposa,043,17540,1488,1468,62,1530,6
2021-12-17,Mendocino,045,87422,8354,8219,698,8917,95
2021-12-17,Merced,047,269075,44059,43929,2198,46127,686
2021-12-17,Modoc,049,8938,598,595,204,799,6
2021-12-17,Mono,051,14174,1984,1956,22,1978,4
2021-12-17,Monterey,053,433212,50832,49343,3412,52755,635
2021-12-17,Napa,055,140530,13733,13581,134,13715,107
2021-12-17,Nevada,057,99092,10143,9991,350,10341,108
2021-12-17,Orange,059,3164182,321891,318149,16663,334812,5844
2021-12-17,Placer,061,380077,39867,39336,3963,43299,485
2021-12-17,Plumas,063,18699,2023,1964,50,2014,13
2021-12-17,Riverside,065,2383286,385321,379354,16855,396209,5439
2021-12-17,Sacramento,067,1510023,168858,167046,5164,172210,2404
2021-12-17,San Benito,069,59416,7929,7894,183,8077,79
2021-12-17,San Bernardino,071,2135413,376203,371658,11998,383656,6017
2021-12-17,San Diego,073,3302833,401641,397130,23440,420570,4399
2021-12-17,San Francisco,075,870044,57535,55562,2533,58095,679
2021-12-17,San Joaquin,077,732212,104708,103698,5676,109374,1858
2021-12-17,San Luis Obispo,079,281455,31356,30873,1387,32260,365
2021-12-17,San Mateo,081,765935,57574,55730,1032,56762,580
2021-12-17,Santa Barbara,083,443738,47311,46776,1647,48423,562
2021-12-17,Santa Clara,085,1922200,156460,154243,1776,156019,1946
2021-12-17,Santa Cruz,087,273765,22175,21805,1051,22856,225
2021-12-17,Shasta,089,179085,22970,22811,3732,26543,429
2021-12-17,Sierra,091,2930,203,199,21,220,0
2021-12-17,Siskiyou,093,43540,3506,3441,1372,4813,58
2021-12-17,Solano,095,438530,48015,47174,1387,48561,369
2021-12-17,Sonoma,097,501317,44281,43658,599,44257,407
2021-12-17,Stanislaus,099,539301,82658,82736,9389,92125,1330
2021-12-17,Sutter,101,95872,14462,14435,411,14846,190
2021-12-17,Tehama,103,63373,8915,8814,1548,10362,136
2021-12-17,Trinity,105,12862,913,823,220,1043,17
2021-12-17,Tulare,107,460477,72040,70922,16425,87347,1120
2021-12-17,Tuolumne,109,53932,7894,7834,113,7947,91
2021-12-17,Ventura,111,848112,103064,101612,4518,106130,1201
2021-12-17,Yolo,113,214977,21131,20793,1228,22021,267
2021-12-17,Yuba,115,75493,10713,10599,405,11004,96
2021-12-16,Alameda,001,1643700,126099,124583,2998,127581,1512
2021-12-16,Alpine,003,1148,108,110,0,110,0
2021-12-16,Amador,005,37829,5837,5821,74,5895,69
2021-12-16,Butte,007,227075,22216,21956,4042,25998,328
2021-12-16,Calaveras,009,45235,4574,4534,64,4598,91
2021-12-16,Colusa,011,21464,2654,2635,684,3319,21
2021-12-16,Contra Costa,013,1133247,104404,103380,2378,105758,1065
2021-12-16,Del Norte,015,27424,3817,3791,56,3847,43
2021-12-16,El Dorado,017,186661,17246,16968,1828,18796,171
2021-12-16,Fresno,019,978130,148509,147038,13277,160315,2335
2021-12-16,Glenn,021,27897,3622,3590,1052,4642,39
2021-12-16,Humboldt,023,135768,9996,9889,725,10614,118
2021-12-16,Imperial,025,180216,36736,36280,3944,40224,790
2021-12-16,Inyo,027,18085,2630,2607,39,2646,47
2021-12-16,Kern,029,883053,134890,133754,24410,158164,1873
2021-12-16,Kings,031,150075,34106,33783,2047,35830,374
2021-12-16,Lake,033,64148,7034,6976,167,7143,115
2021-12-16,Lassen,035,31185,7096,7061,425,7486,55
2021-12-16,Los Angeles,037,10098052,1504146,1484840,57440,1542280,27135
2021-12-16,Madera,039,155013,24783,24575,2357,26932,313
2021-12-16,Marin,041,260295,18826,18537,562,19099,249
2021-12-16,Mariposa,043,17540,1486,1468,62,1530,6
2021-12-16,Mendocino,045,87422,8343,8219,693,8912,95
2021-12-16,Merced,047,269075,44020,43929,2197,46126,686
2021-12-16,Modoc,049,8938,598,595,204,799,6
2021-12-16,Mono,051,14174,1981,1956,22,1978,4
2021-12-16,Monterey,053,433212,50761,49343,3395,52738,635
2021-12-16,Napa,055,140530,13701,13581,134,13715,107
2021-12-16,Nevada,057,99092,10117,9991,350,10341,108
2021-12-16,Orange,059,3164182,321283,318149,16585,334734,5844
2021-12-16,Placer,061,380077,39790,39336,3958,43294,485
2021-12-16,Plumas,063,18699,2023,1964,50,2014,13
2021-12-16,Riverside,065,2383286,384514,379354,16841,396195,5439
2021-12-16,Sacramento,067,1510023,168575,167046,5140,172186,2404
2021-12-16,San Benito,069,59416,7922,7894,183,8077,79
2021-12-16,San Bernardino,071,2135413,375549,371658,11979,383637,6017
2021-12-16,San Diego,073,3302833,400472,397130,23374,420504,4399
2021-12-16,San Francisco,075,870044,57159,55562,2511,58073,679
2021-12-16,San Joaquin,077,732212,104584,103698,5669,109367,1858
2021-12-16,San Luis Obispo,079,281455,31286,30873,1381,32254,365
2021-12-16,San Mateo,081,765935,57374,55730,1029,56759,580
2021-12-16,Santa Barbara,083,443738,47190,46776,1643,48419,562
2021-12-16,Santa Clara,085,1922200,156129,154243,1766,156009,1946
2021-12-16,Santa Cruz,087,273765,22129,21805,1050,22855,225
2021-12-16,Shasta,089,179085,22940,22811,3730,26541,429
2021-12-16,Sierra,091,2930,203,199,21,220,0
2021-12-16,Siskiyou,093,43540,3505,3441,1368,4809,58
2021-12-16,Solano,095,438530,47947,47174,1380,48554,369
2021-12-16,Sonoma,097,501317,44182,43658,597,44255,407
2021-12-16,Stanislaus,099,539301,82571,82736,9375,92111,1330
2021-12-16,Sutter,101,95872,14448,14435,410,14845,190
2021-12-16,Tehama,103,63373,8908,8814,1547,10361,136
2021-12-16,Trinity,105,12862,913,823,220,1043,17
2021-12-16,Tulare,107,460477,71992,70922,16400,87322,1120
2021-12-16,Tuolumne,109,53932,7875,7834,113,7947,91
2021-12-16,Ventura,111,848112,102796,101612,4511,106123,1201
2021-12-16,Yolo,113,214977,21080,20793,1223,22016,267
2021-12-16,Yuba,115,75493,10697,10599,404,11003,96
2021-12-15,Alameda,001,1643700,125773,124342,2987,127329,1509
2021-12-15,Alpine,003,1148,108,109,0,109,0
2021-12-15,Amador,005,37829,5831,5810,74,5884,69
2021-12-15,Butte,007,227075,22192,21922,4041,25963,327
2021-12-15,Calaveras,009,45235,4568,4523,64,4587,89
2021-12-15,Colusa,011,21464,2653,2632,683,3315,21
2021-12-15,Contra Costa,013,1133247,104185,103236,2375,105611,1064
2021-12-15,Del Norte,015,27424,3816,3789,55,3844,43
2021-12-15,El Dorado,017,186661,17215,16936,1822,18758,171
2021-12-15,Fresno,019,978130,148382,146859,13263,160122,2319
2021-12-15,Glenn,021,27897,3622,3589,1052,4641,39
2021-12-15,Humboldt,023,135768,9976,9854,724,10578,118
2021-12-15,Imperial,025,180216,36656,36187,3900,40087,789
2021-12-15,Inyo,027,18085,2625,2606,39,2645,47
2021-12-15,Kern,029,883053,134751,133590,24364,157954,1866
2021-12-15,Kings,031,150075,34077,33716,2043,35759,374
2021-12-15,Lake,033,64148,7026,6968,166,7134,115
2021-12-15,Lassen,035,31185,7096,7062,425,7487,55
2021-12-15,Los Angeles,037,10098052,1500252,1482735,57245,1539980,27116
2021-12-15,Madera,039,155013,24765,24549,2351,26900,313
2021-12-15,Marin,041,260295,18767,18514,557,19071,249
2021-12-15,Mariposa,043,17540,1483,1463,62,1525,6
2021-12-15,Mendocino,045,87422,8338,8209,690,8899,95
2021-12-15,Merced,047,269075,43978,43890,2185,46075,685
2021-12-15,Modoc,049,8938,598,595,204,799,6
2021-12-15,Mono,051,14174,1977,1955,22,1977,4
2021-12-15,Monterey,053,433212,50706,49279,3377,52656,635
2021-12-15,Napa,055,140530,13672,13557,132,13689,107
2021-12-15,Nevada,057,99092,10096,9958,350,10308,107
2021-12-15,Orange,059,3164182,320702,317808,16543,334351,5838
2021-12-15,Placer,061,380077,39734,39264,3948,43212,485
2021-12-15,Plumas,063,18699,2019,1957,50,2007,12
2021-12-15,Riverside,065,2383286,383793,378769,16830,395599,5438
2021-12-15,Sacramento,067,1510023,168267,166793,5120,171913,2401
2021-12-15,San Benito,069,59416,7907,7877,183,8060,79
2021-12-15,San Bernardino,071,2135413,374995,371122,11946,383068,6013
2021-12-15,San Diego,073,3302833,399277,396546,23304,419850,4395
2021-12-15,San Francisco,075,870044,56841,55414,2493,57907,679
2021-12-15,San Joaquin,077,732212,104427,103579,5659,109238,1853
2021-12-15,San Luis Obispo,079,281455,31237,30784,1374,32158,365
2021-12-15,San Mateo,081,765935,57232,55657,1019,56676,580
2021-12-15,Santa Barbara,083,443738,47109,46681,1641,48322,562
2021-12-15,Santa Clara,085,1922200,155818,153928,1746,155674,1944
2021-12-15,Santa Cruz,087,273765,22089,21753,1043,22796,225
2021-12-15,Shasta,089,179085,22925,22778,3726,26504,427
2021-12-15,Sierra,091,2930,203,199,21,220,0
2021-12-15,Siskiyou,093,43540,3504,3434,1367,4801,58
2021-12-15,Solano,095,438530,47876,47098,1374,48472,367
2021-12-15,Sonoma,097,501317,44100,43580,592,44172,407
2021-12-15,Stanislaus,099,539301,82465,82628,9367,91995,1298
2021-12-15,Sutter,101,95872,14428,14428,409,14837,189
2021-12-15,Tehama,103,63373,8901,8806,1546,10352,136
2021-12-15,Trinity,105,12862,912,822,220,1042,17
2021-12-15,Tulare,107,460477,71941,70846,16371,87217,1120
2021-12-15,Tuolumne,109,53932,7866,7818,112,7930,91
2021-12-15,Ventura,111,848112,102581,101447,4505,105952,1199
2021-12-15,Yolo,113,214977,21052,20749,1218,21967,267
2021-12-15,Yuba,115,75493,10686,10587,403,10990,96
2021-12-14,Alameda,001,1643700,125443,124272,2975,127247,1506
2021-12-14,Alpine,003,1148,107,109,0,109,0
2021-12-14,Amador,005,37829,5825,5808,73,5881,69
2021-12-14,Butte,007,227075,22159,21901,4039,25940,326
2021-12-14,Calaveras,009,45235,4556,4517,64,4581,89
2021-12-14,Colusa,011,21464,2651,2628,683,3311,21
2021-12-14,Contra Costa,013,1133247,104001,103135,2371,105506,1064
2021-12-14,Del Norte,015,27424,3813,3788,55,3843,43
2021-12-14,El Dorado,017,186661,17180,16915,1820,18735,170
2021-12-14,Fresno,019,978130,148212,146756,13255,160011,2316
2021-12-14,Glenn,021,27897,3621,3589,1052,4641,39
2021-12-14,Humboldt,023,135768,9964,9836,716,10552,118
2021-12-14,Imperial,025,180216,36583,36049,3857,39906,789
2021-12-14,Inyo,027,18085,2624,2601,39,2640,46
2021-12-14,Kern,029,883053,134613,133498,24315,157813,1863
2021-12-14,Kings,031,150075,34040,33693,2040,35733,373
2021-12-14,Lake,033,64148,7017,6961,166,7127,115
2021-12-14,Lassen,035,31185,7095,7061,425,7486,55
2021-12-14,Los Angeles,037,10098052,1496589,1481131,57067,1538198,27099
2021-12-14,Madera,039,155013,24738,24535,2343,26878,313
2021-12-14,Marin,041,260295,18719,18491,555,19046,249
2021-12-14,Mariposa,043,17540,1480,1463,61,1524,6
2021-12-14,Mendocino,045,87422,8310,8206,688,8894,95
2021-12-14,Merced,047,269075,43932,43870,2183,46053,684
2021-12-14,Modoc,049,8938,597,595,204,799,6
2021-12-14,Mono,051,14174,1970,1955,22,1977,4
2021-12-14,Monterey,053,433212,50622,49237,3366,52603,635
2021-12-14,Napa,055,140530,13643,13528,132,13660,107
2021-12-14,Nevada,057,99092,10070,9956,349,10305,106
2021-12-14,Orange,059,3164182,320149,317465,16489,333954,5827
2021-12-14,Placer,061,380077,39659,39221,3943,43164,482
2021-12-14,Plumas,063,18699,2015,1950,48,1998,12
2021-12-14,Riverside,065,2383286,383102,378227,16813,395040,5427
2021-12-14,Sacramento,067,1510023,167957,166605,5097,171702,2394
2021-12-14,San Benito,069,59416,7888,7871,183,8054,79
2021-12-14,San Bernardino,071,2135413,374368,370604,11916,382520,6013
2021-12-14,San Diego,073,3302833,398138,395876,23253,419129,4393
2021-12-14,San Francisco,075,870044,56525,55278,2482,57760,679
2021-12-14,San Joaquin,077,732212,104281,103488,5642,109130,1848
2021-12-14,San Luis Obispo,079,281455,31177,30753,1370,32123,363
2021-12-14,San Mateo,081,765935,57068,55601,1012,56613,580
2021-12-14,Santa Barbara,083,443738,47007,46648,1637,48285,560
2021-12-14,Santa Clara,085,1922200,155496,153814,1733,155547,1945
2021-12-14,Santa Cruz,087,273765,22024,21737,1038,22775,225
2021-12-14,Shasta,089,179085,22898,22756,3725,26481,427
2021-12-14,Sierra,091,2930,201,199,21,220,0
2021-12-14,Siskiyou,093,43540,3499,3430,1366,4796,58
2021-12-14,Solano,095,438530,47829,47065,1368,48433,367
2021-12-14,Sonoma,097,501317,44017,43538,590,44128,407
2021-12-14,Stanislaus,099,539301,82379,82581,9351,91932,1293
2021-12-14,Sutter,101,95872,14416,14421,408,14829,189
2021-12-14,Tehama,103,63373,8897,8805,1546,10351,134
2021-12-14,Trinity,105,12862,912,821,220,1041,17
2021-12-14,Tulare,107,460477,71869,70803,16341,87144,1120
2021-12-14,Tuolumne,109,53932,7853,7815,112,7927,91
2021-12-14,Ventura,111,848112,102356,101343,4498,105841,1199
2021-12-14,Yolo,113,214977,21018,20734,1205,21939,267
2021-12-14,Yuba,115,75493,10669,10574,403,10977,92
2021-12-13,Alameda,001,1643700,125158,124174,2958,127132,1501
2021-12-13,Alpine,003,1148,107,109,0,109,0
2021-12-13,Amador,005,37829,5821,5797,73,5870,69
2021-12-13,Butte,007,227075,22135,21889,4035,25924,326
2021-12-13,Calaveras,009,45235,4549,4507,63,4570,89
2021-12-13,Colusa,011,21464,2649,2627,683,3310,21
2021-12-13,Contra Costa,013,1133247,103850,103041,2360,105401,1064
2021-12-13,Del Norte,015,27424,3809,3787,55,3842,42
2021-12-13,El Dorado,017,186661,17157,16896,1818,18714,170
2021-12-13,Fresno,019,978130,148061,146641,13245,159886,2312
2021-12-13,Glenn,021,27897,3616,3589,1050,4639,37
2021-12-13,Humboldt,023,135768,9935,9821,712,10533,118
2021-12-13,Imperial,025,180216,36499,35974,3836,39810,787
2021-12-13,Inyo,027,18085,2623,2592,39,2631,46
2021-12-13,Kern,029,883053,134487,133381,24262,157643,1863
2021-12-13,Kings,031,150075,33997,33680,2035,35715,372
2021-12-13,Lake,033,64148,7015,6958,164,7122,115
2021-12-13,Lassen,035,31185,7094,7057,425,7482,55
2021-12-13,Los Angeles,037,10098052,1493806,1480195,56906,1537101,27085
2021-12-13,Madera,039,155013,24709,24527,2338,26865,311
2021-12-13,Marin,041,260295,18659,18471,552,19023,249
2021-12-13,Mariposa,043,17540,1478,1462,61,1523,6
2021-12-13,Mendocino,045,87422,8297,8196,686,8882,95
2021-12-13,Merced,047,269075,43893,43848,2179,46027,682
2021-12-13,Modoc,049,8938,596,595,204,799,6
2021-12-13,Mono,051,14174,1963,1952,22,1974,4
2021-12-13,Monterey,053,433212,50570,49222,3347,52569,631
2021-12-13,Napa,055,140530,13630,13518,132,13650,107
2021-12-13,Nevada,057,99092,10051,9946,348,10294,106
2021-12-13,Orange,059,3164182,319679,317112,16436,333548,5824
2021-12-13,Placer,061,380077,39598,39168,3932,43100,481
2021-12-13,Plumas,063,18699,2011,1943,48,1991,12
2021-12-13,Riverside,065,2383286,382519,377728,16798,394526,5414
2021-12-13,Sacramento,067,1510023,167679,166439,5065,171504,2392
2021-12-13,San Benito,069,59416,7879,7856,183,8039,79
2021-12-13,San Bernardino,071,2135413,373792,370274,11909,382183,6011
2021-12-13,San Diego,073,3302833,397333,395266,23200,418466,4389
2021-12-13,San Francisco,075,870044,56255,55245,2469,57714,678
2021-12-13,San Joaquin,077,732212,104165,103449,5633,109082,1846
2021-12-13,San Luis Obispo,079,281455,31127,30746,1366,32112,363
2021-12-13,San Mateo,081,765935,56909,55569,1003,56572,580
2021-12-13,Santa Barbara,083,443738,46919,46608,1632,48240,560
2021-12-13,Santa Clara,085,1922200,155231,153672,1722,155394,1944
2021-12-13,Santa Cruz,087,273765,21969,21698,1035,22733,225
2021-12-13,Shasta,089,179085,22877,22731,3723,26454,426
2021-12-13,Sierra,091,2930,201,199,21,220,0
2021-12-13,Siskiyou,093,43540,3495,3426,1363,4789,57
2021-12-13,Solano,095,438530,47755,47045,1363,48408,365
2021-12-13,Sonoma,097,501317,43921,43492,588,44080,407
2021-12-13,Stanislaus,099,539301,82263,82507,9328,91835,1282
2021-12-13,Sutter,101,95872,14409,14408,408,14816,188
2021-12-13,Tehama,103,63373,8884,8800,1546,10346,134
2021-12-13,Trinity,105,12862,912,820,220,1040,17
2021-12-13,Tulare,107,460477,71811,70758,16317,87075,1114
2021-12-13,Tuolumne,109,53932,7842,7804,112,7916,91
2021-12-13,Ventura,111,848112,102131,101180,4487,105667,1197
2021-12-13,Yolo,113,214977,20969,20706,1200,21906,267
2021-12-13,Yuba,115,75493,10652,10570,403,10973,92
2021-12-12,Alameda,001,1643700,124872,124075,2946,127021,1503
2021-12-12,Alpine,003,1148,107,109,0,109,0
2021-12-12,Amador,005,37829,5813,5797,72,5869,69
2021-12-12,Butte,007,227075,22111,21874,4029,25903,326
2021-12-12,Calaveras,009,45235,4538,4501,63,4564,89
2021-12-12,Colusa,011,21464,2644,2627,680,3307,21
2021-12-12,Contra Costa,013,1133247,103663,102976,2358,105334,1065
2021-12-12,Del Norte,015,27424,3806,3793,55,3848,42
2021-12-12,El Dorado,017,186661,17121,16890,1810,18700,170
2021-12-12,Fresno,019,978130,147899,146518,13230,159748,2310
2021-12-12,Glenn,021,27897,3613,3589,1050,4639,37
2021-12-12,Humboldt,023,135768,9910,9804,705,10509,118
2021-12-12,Imperial,025,180216,36365,35926,3805,39731,787
2021-12-12,Inyo,027,18085,2618,2592,39,2631,46
2021-12-12,Kern,029,883053,134321,133314,24221,157535,1861
2021-12-12,Kings,031,150075,33946,33661,2033,35694,372
2021-12-12,Lake,033,64148,7008,6955,162,7117,115
2021-12-12,Lassen,035,31185,7093,7057,425,7482,55
2021-12-12,Los Angeles,037,10098052,1490895,1479054,56725,1535779,27074
2021-12-12,Madera,039,155013,24680,24493,2331,26824,311
2021-12-12,Marin,041,260295,18606,18451,548,18999,249
2021-12-12,Mariposa,043,17540,1477,1461,61,1522,6
2021-12-12,Mendocino,045,87422,8284,8190,685,8875,95
2021-12-12,Merced,047,269075,43859,43821,2172,45993,682
2021-12-12,Modoc,049,8938,596,595,203,798,6
2021-12-12,Mono,051,14174,1959,1947,22,1969,4
2021-12-12,Monterey,053,433212,50517,49192,3321,52513,631
2021-12-12,Napa,055,140530,13587,13508,130,13638,107
2021-12-12,Nevada,057,99092,10024,9938,347,10285,106
2021-12-12,Orange,059,3164182,319173,316918,16371,333289,5825
2021-12-12,Placer,061,380077,39533,39139,3926,43065,481
2021-12-12,Plumas,063,18699,2007,1942,46,1988,12
2021-12-12,Riverside,065,2383286,381843,377467,16773,394240,5414
2021-12-12,Sacramento,067,1510023,167412,166291,5044,171335,2392
2021-12-12,San Benito,069,59416,7859,7853,183,8036,79
2021-12-12,San Bernardino,071,2135413,373149,369977,11885,381862,6011
2021-12-12,San Diego,073,3302833,396438,393307,23162,416469,4378
2021-12-12,San Francisco,075,870044,55999,55180,2457,57637,678
2021-12-12,San Joaquin,077,732212,104026,103405,5623,109028,1846
2021-12-12,San Luis Obispo,079,281455,31074,30719,1364,32083,363
2021-12-12,San Mateo,081,765935,56792,55505,999,56504,580
2021-12-12,Santa Barbara,083,443738,46844,46586,1630,48216,560
2021-12-12,Santa Clara,085,1922200,154951,153452,1708,155160,1945
2021-12-12,Santa Cruz,087,273765,21920,21671,1033,22704,225
2021-12-12,Shasta,089,179085,22849,22732,3722,26454,426
2021-12-12,Sierra,091,2930,201,199,21,220,0
2021-12-12,Siskiyou,093,43540,3495,3424,1363,4787,57
2021-12-12,Solano,095,438530,47689,47021,1360,48381,365
2021-12-12,Sonoma,097,501317,43828,43424,585,44009,407
2021-12-12,Stanislaus,099,539301,82165,82460,9315,91775,1282
2021-12-12,Sutter,101,95872,14398,14396,408,14804,189
2021-12-12,Tehama,103,63373,8873,8796,1544,10340,134
2021-12-12,Trinity,105,12862,910,820,220,1040,17
2021-12-12,Tulare,107,460477,71734,70733,16275,87008,1115
2021-12-12,Tuolumne,109,53932,7825,7794,112,7906,91
2021-12-12,Ventura,111,848112,101938,101105,4473,105578,1197
2021-12-12,Yolo,113,214977,20919,20685,1188,21873,267
2021-12-12,Yuba,115,75493,10638,10565,400,10965,92
2021-12-11,Alameda,001,1643700,124735,123572,2944,126516,1496
2021-12-11,Alpine,003,1148,107,109,0,109,0
2021-12-11,Amador,005,37829,5808,5787,72,5859,69
2021-12-11,Butte,007,227075,22097,21819,4027,25846,326
2021-12-11,Calaveras,009,45235,4530,4469,62,4531,89
2021-12-11,Colusa,011,21464,2640,2619,679,3298,21
2021-12-11,Contra Costa,013,1133247,103577,102618,2356,104974,1061
2021-12-11,Del Norte,015,27424,3806,3778,55,3833,42
2021-12-11,El Dorado,017,186661,17101,16796,1809,18605,170
2021-12-11,Fresno,019,978130,147812,145988,13221,159209,2294
2021-12-11,Glenn,021,27897,3612,3585,1050,4635,37
2021-12-11,Humboldt,023,135768,9893,9721,702,10423,118
2021-12-11,Imperial,025,180216,36307,35635,3796,39431,782
2021-12-11,Inyo,027,18085,2613,2576,39,2615,46
2021-12-11,Kern,029,883053,134252,132852,24187,157039,1854
2021-12-11,Kings,031,150075,33933,33530,2031,35561,371
2021-12-11,Lake,033,64148,7007,6932,160,7092,114
2021-12-11,Lassen,035,31185,7092,7049,425,7474,55
2021-12-11,Los Angeles,037,10098052,1489682,1474030,56633,1530663,27031
2021-12-11,Madera,039,155013,24674,24417,2330,26747,311
2021-12-11,Marin,041,260295,18573,18339,545,18884,249
2021-12-11,Mariposa,043,17540,1476,1450,61,1511,6
2021-12-11,Mendocino,045,87422,8277,8130,685,8815,95
2021-12-11,Merced,047,269075,43840,43690,2171,45861,681
2021-12-11,Modoc,049,8938,596,594,203,797,6
2021-12-11,Mono,051,14174,1955,1926,22,1948,4
2021-12-11,Monterey,053,433212,50489,49008,3318,52326,631
2021-12-11,Napa,055,140530,13570,13459,130,13589,107
2021-12-11,Nevada,057,99092,10011,9880,347,10227,106
2021-12-11,Orange,059,3164182,318922,315759,16344,332103,5805
2021-12-11,Placer,061,380077,39475,38959,3919,42878,481
2021-12-11,Plumas,063,18699,2001,1934,46,1980,12
2021-12-11,Riverside,065,2383286,381423,375649,16758,392407,5408
2021-12-11,Sacramento,067,1510023,167281,165530,5037,170567,2386
2021-12-11,San Benito,069,59416,7845,7808,183,7991,79
2021-12-11,San Bernardino,071,2135413,372786,368145,11875,380020,6007
2021-12-11,San Diego,073,3302833,396015,392274,23124,415398,4374
2021-12-11,San Francisco,075,870044,55846,54869,2452,57321,678
2021-12-11,San Joaquin,077,732212,103965,103013,5619,108632,1842
2021-12-11,San Luis Obispo,079,281455,31052,30567,1360,31927,362
2021-12-11,San Mateo,081,765935,56713,55284,997,56281,580
2021-12-11,Santa Barbara,083,443738,46809,46309,1630,47939,559
2021-12-11,Santa Clara,085,1922200,154753,152846,1696,154542,1941
2021-12-11,Santa Cruz,087,273765,21896,21557,1033,22590,225
2021-12-11,Shasta,089,179085,22834,22660,3718,26378,419
2021-12-11,Sierra,091,2930,201,199,21,220,0
2021-12-11,Siskiyou,093,43540,3489,3418,1360,4778,57
2021-12-11,Solano,095,438530,47660,46891,1356,48247,365
2021-12-11,Sonoma,097,501317,43780,43227,585,43812,407
2021-12-11,Stanislaus,099,539301,82116,82133,9306,91439,1264
2021-12-11,Sutter,101,95872,14389,14354,408,14762,187
2021-12-11,Tehama,103,63373,8870,8776,1542,10318,134
2021-12-11,Trinity,105,12862,910,819,220,1039,17
2021-12-11,Tulare,107,460477,71690,70523,16265,86788,1103
2021-12-11,Tuolumne,109,53932,7816,7760,112,7872,91
2021-12-11,Ventura,111,848112,101863,100711,4466,105177,1195
2021-12-11,Yolo,113,214977,20900,20608,1184,21792,267
2021-12-11,Yuba,115,75493,10626,10519,399,10918,92
2021-12-10,Alameda,001,1643700,124610,123572,2937,126509,1496
2021-12-10,Alpine,003,1148,106,109,0,109,0
2021-12-10,Amador,005,37829,5801,5787,72,5859,69
2021-12-10,Butte,007,227075,22084,21819,4025,25844,326
2021-12-10,Calaveras,009,45235,4527,4469,62,4531,89
2021-12-10,Colusa,011,21464,2639,2619,679,3298,21
2021-12-10,Contra Costa,013,1133247,103481,102618,2355,104973,1061
2021-12-10,Del Norte,015,27424,3806,3778,55,3833,42
2021-12-10,El Dorado,017,186661,17088,16796,1809,18605,170
2021-12-10,Fresno,019,978130,147724,145988,13210,159198,2294
2021-12-10,Glenn,021,27897,3612,3585,1050,4635,37
2021-12-10,Humboldt,023,135768,9876,9721,700,10421,118
2021-12-10,Imperial,025,180216,36252,35635,3781,39416,782
2021-12-10,Inyo,027,18085,2610,2576,39,2615,46
2021-12-10,Kern,029,883053,134163,132852,24163,157015,1854
2021-12-10,Kings,031,150075,33918,33530,2029,35559,371
2021-12-10,Lake,033,64148,7000,6932,160,7092,114
2021-12-10,Lassen,035,31185,7091,7049,425,7474,55
2021-12-10,Los Angeles,037,10098052,1488595,1474030,56546,1530576,27031
2021-12-10,Madera,039,155013,24656,24417,2328,26745,311
2021-12-10,Marin,041,260295,18551,18339,545,18884,249
2021-12-10,Mariposa,043,17540,1473,1450,61,1511,6
2021-12-10,Mendocino,045,87422,8270,8130,684,8814,95
2021-12-10,Merced,047,269075,43822,43690,2169,45859,681
2021-12-10,Modoc,049,8938,596,594,203,797,6
2021-12-10,Mono,051,14174,1952,1926,22,1948,4
2021-12-10,Monterey,053,433212,50452,49008,3312,52320,631
2021-12-10,Napa,055,140530,13558,13459,129,13588,107
2021-12-10,Nevada,057,99092,10002,9880,347,10227,106
2021-12-10,Orange,059,3164182,318650,315759,16312,332071,5805
2021-12-10,Placer,061,380077,39432,38959,3916,42875,481
2021-12-10,Plumas,063,18699,1999,1934,46,1980,12
2021-12-10,Riverside,065,2383286,381016,375649,16748,392397,5408
2021-12-10,Sacramento,067,1510023,167128,165530,5035,170565,2386
2021-12-10,San Benito,069,59416,7841,7808,183,7991,79
2021-12-10,San Bernardino,071,2135413,372416,368145,11852,379997,6007
2021-12-10,San Diego,073,3302833,395535,392274,23110,415384,4374
2021-12-10,San Francisco,075,870044,55761,54869,2446,57315,678
2021-12-10,San Joaquin,077,732212,103910,103013,5615,108628,1842
2021-12-10,San Luis Obispo,079,281455,31042,30567,1357,31924,362
2021-12-10,San Mateo,081,765935,56656,55284,994,56278,580
2021-12-10,Santa Barbara,083,443738,46773,46309,1629,47938,559
2021-12-10,Santa Clara,085,1922200,154583,152846,1683,154529,1941
2021-12-10,Santa Cruz,087,273765,21876,21557,1032,22589,225
2021-12-10,Shasta,089,179085,22823,22660,3715,26375,419
2021-12-10,Sierra,091,2930,201,199,21,220,0
2021-12-10,Siskiyou,093,43540,3482,3418,1360,4778,57
2021-12-10,Solano,095,438530,47618,46891,1352,48243,365
2021-12-10,Sonoma,097,501317,43746,43227,584,43811,407
2021-12-10,Stanislaus,099,539301,82050,82133,9300,91433,1264
2021-12-10,Sutter,101,95872,14381,14354,408,14762,187
2021-12-10,Tehama,103,63373,8868,8776,1540,10316,134
2021-12-10,Trinity,105,12862,910,819,220,1039,17
2021-12-10,Tulare,107,460477,71661,70523,16241,86764,1103
2021-12-10,Tuolumne,109,53932,7810,7760,112,7872,91
2021-12-10,Ventura,111,848112,101759,100711,4463,105174,1195
2021-12-10,Yolo,113,214977,20886,20608,1182,21790,267
2021-12-10,Yuba,115,75493,10614,10519,398,10917,92
2021-12-09,Alameda,001,1643700,124465,123572,2932,126504,1496
2021-12-09,Alpine,003,1148,106,109,0,109,0
2021-12-09,Amador,005,37829,5798,5787,71,5858,69
2021-12-09,Butte,007,227075,22064,21819,4021,25840,326
2021-12-09,Calaveras,009,45235,4518,4469,62,4531,89
2021-12-09,Colusa,011,21464,2637,2619,679,3298,21
2021-12-09,Contra Costa,013,1133247,103362,102618,2349,104967,1061
2021-12-09,Del Norte,015,27424,3805,3778,55,3833,42
2021-12-09,El Dorado,017,186661,17060,16796,1804,18600,170
2021-12-09,Fresno,019,978130,147578,145988,13198,159186,2294
2021-12-09,Glenn,021,27897,3612,3585,1050,4635,37
2021-12-09,Humboldt,023,135768,9853,9721,699,10420,118
2021-12-09,Imperial,025,180216,36181,35635,3752,39387,782
2021-12-09,Inyo,027,18085,2608,2576,39,2615,46
2021-12-09,Kern,029,883053,134037,132852,24130,156982,1854
2021-12-09,Kings,031,150075,33891,33530,2026,35556,371
2021-12-09,Lake,033,64148,6992,6932,160,7092,114
2021-12-09,Lassen,035,31185,7089,7049,425,7474,55
2021-12-09,Los Angeles,037,10098052,1487056,1474030,56461,1530491,27031
2021-12-09,Madera,039,155013,24631,24417,2325,26742,311
2021-12-09,Marin,041,260295,18537,18339,543,18882,249
2021-12-09,Mariposa,043,17540,1472,1450,61,1511,6
2021-12-09,Mendocino,045,87422,8257,8130,681,8811,95
2021-12-09,Merced,047,269075,43784,43690,2157,45847,681
2021-12-09,Modoc,049,8938,596,594,203,797,6
2021-12-09,Mono,051,14174,1948,1926,22,1948,4
2021-12-09,Monterey,053,433212,50405,49008,3301,52309,631
2021-12-09,Napa,055,140530,13538,13459,125,13584,107
2021-12-09,Nevada,057,99092,9983,9880,347,10227,106
2021-12-09,Orange,059,3164182,318317,315759,16273,332032,5805
2021-12-09,Placer,061,380077,39388,38959,3903,42862,481
2021-12-09,Plumas,063,18699,1991,1934,46,1980,12
2021-12-09,Riverside,065,2383286,380466,375649,16732,392381,5408
2021-12-09,Sacramento,067,1510023,166907,165530,5020,170550,2386
2021-12-09,San Benito,069,59416,7829,7808,182,7990,79
2021-12-09,San Bernardino,071,2135413,371907,368145,11828,379973,6007
2021-12-09,San Diego,073,3302833,394888,392274,23080,415354,4374
2021-12-09,San Francisco,075,870044,55676,54869,2439,57308,678
2021-12-09,San Joaquin,077,732212,103818,103013,5609,108622,1842
2021-12-09,San Luis Obispo,079,281455,31014,30567,1355,31922,362
2021-12-09,San Mateo,081,765935,56568,55284,992,56276,580
2021-12-09,Santa Barbara,083,443738,46693,46309,1623,47932,559
2021-12-09,Santa Clara,085,1922200,154368,152846,1672,154518,1941
2021-12-09,Santa Cruz,087,273765,21848,21557,1032,22589,225
2021-12-09,Shasta,089,179085,22807,22660,3714,26374,419
2021-12-09,Sierra,091,2930,201,199,21,220,0
2021-12-09,Siskiyou,093,43540,3478,3418,1359,4777,57
2021-12-09,Solano,095,438530,47581,46891,1350,48241,365
2021-12-09,Sonoma,097,501317,43689,43227,583,43810,407
2021-12-09,Stanislaus,099,539301,81980,82133,9285,91418,1264
2021-12-09,Sutter,101,95872,14366,14354,408,14762,187
2021-12-09,Tehama,103,63373,8861,8776,1538,10314,134
2021-12-09,Trinity,105,12862,910,819,220,1039,17
2021-12-09,Tulare,107,460477,71605,70523,16212,86735,1103
2021-12-09,Tuolumne,109,53932,7799,7760,112,7872,91
2021-12-09,Ventura,111,848112,101614,100711,4451,105162,1195
2021-12-09,Yolo,113,214977,20862,20608,1174,21782,267
2021-12-09,Yuba,115,75493,10606,10519,395,10914,92
2021-12-08,Alameda,001,1643700,124315,123438,2922,126360,1496
2021-12-08,Alpine,003,1148,106,108,0,108,0
2021-12-08,Amador,005,37829,5793,5781,71,5852,69
2021-12-08,Butte,007,227075,22047,21780,4018,25798,326
2021-12-08,Calaveras,009,45235,4510,4455,62,4517,89
2021-12-08,Colusa,011,21464,2634,2619,678,3297,21
2021-12-08,Contra Costa,013,1133247,103233,102506,2349,104855,1058
2021-12-08,Del Norte,015,27424,3804,3767,55,3822,42
2021-12-08,El Dorado,017,186661,17028,16757,1804,18561,170
2021-12-08,Fresno,019,978130,147417,145830,13184,159014,2293
2021-12-08,Glenn,021,27897,3612,3584,1046,4630,37
2021-12-08,Humboldt,023,135768,9831,9704,697,10401,117
2021-12-08,Imperial,025,180216,36101,35537,3721,39258,782
2021-12-08,Inyo,027,18085,2605,2570,39,2609,46
2021-12-08,Kern,029,883053,133914,132709,24082,156791,1846
2021-12-08,Kings,031,150075,33856,33468,2025,35493,371
2021-12-08,Lake,033,64148,6986,6927,159,7086,114
2021-12-08,Lassen,035,31185,7088,7041,423,7464,55
2021-12-08,Los Angeles,037,10098052,1485508,1472410,56350,1528760,27018
2021-12-08,Madera,039,155013,24610,24396,2318,26714,311
2021-12-08,Marin,041,260295,18516,18305,540,18845,249
2021-12-08,Mariposa,043,17540,1469,1447,61,1508,6
2021-12-08,Mendocino,045,87422,8244,8118,680,8798,95
2021-12-08,Merced,047,269075,43752,43631,2150,45781,680
2021-12-08,Modoc,049,8938,596,594,203,797,6
2021-12-08,Mono,051,14174,1942,1924,22,1946,4
2021-12-08,Monterey,053,433212,50340,48957,3286,52243,631
2021-12-08,Napa,055,140530,13524,13421,125,13546,107
2021-12-08,Nevada,057,99092,9967,9862,347,10209,106
2021-12-08,Orange,059,3164182,317968,315421,16236,331657,5795
2021-12-08,Placer,061,380077,39337,38934,3899,42833,478
2021-12-08,Plumas,063,18699,1989,1924,46,1970,12
2021-12-08,Riverside,065,2383286,379953,375099,16709,391808,5404
2021-12-08,Sacramento,067,1510023,166653,165278,4993,170271,2373
2021-12-08,San Benito,069,59416,7820,7793,182,7975,79
2021-12-08,San Bernardino,071,2135413,371430,367516,11803,379319,6006
2021-12-08,San Diego,073,3302833,394239,391676,23048,414724,4369
2021-12-08,San Francisco,075,870044,55589,54792,2431,57223,677
2021-12-08,San Joaquin,077,732212,103716,102877,5600,108477,1841
2021-12-08,San Luis Obispo,079,281455,30965,30519,1350,31869,361
2021-12-08,San Mateo,081,765935,56501,55220,986,56206,580
2021-12-08,Santa Barbara,083,443738,46638,46250,1620,47870,558
2021-12-08,Santa Clara,085,1922200,154204,152674,1661,154335,1937
2021-12-08,Santa Cruz,087,273765,21802,21505,1030,22535,224
2021-12-08,Shasta,089,179085,22787,22616,3708,26324,419
2021-12-08,Sierra,091,2930,201,199,21,220,0
2021-12-08,Siskiyou,093,43540,3477,3415,1357,4772,57
2021-12-08,Solano,095,438530,47551,46837,1349,48186,365
2021-12-08,Sonoma,097,501317,43627,43179,582,43761,405
2021-12-08,Stanislaus,099,539301,81898,82038,9272,91310,1264
2021-12-08,Sutter,101,95872,14350,14336,406,14742,187
2021-12-08,Tehama,103,63373,8852,8768,1538,10306,133
2021-12-08,Trinity,105,12862,910,818,220,1038,17
2021-12-08,Tulare,107,460477,71542,70472,16187,86659,1102
2021-12-08,Tuolumne,109,53932,7786,7749,112,7861,91
2021-12-08,Ventura,111,848112,101485,100647,4448,105095,1194
2021-12-08,Yolo,113,214977,20836,20575,1168,21743,267
2021-12-08,Yuba,115,75493,10592,10499,392,10891,92
2021-12-07,Alameda,001,1643700,124140,123325,2914,126239,1497
2021-12-07,Alpine,003,1148,106,108,0,108,0
2021-12-07,Amador,005,37829,5790,5778,70,5848,69
2021-12-07,Butte,007,227075,22022,21761,4012,25773,324
2021-12-07,Calaveras,009,45235,4493,4445,62,4507,88
2021-12-07,Colusa,011,21464,2632,2619,678,3297,21
2021-12-07,Contra Costa,013,1133247,103114,102421,2341,104762,1058
2021-12-07,Del Norte,015,27424,3803,3766,55,3821,42
2021-12-07,El Dorado,017,186661,17002,16742,1801,18543,170
2021-12-07,Fresno,019,978130,147269,145715,13170,158885,2289
2021-12-07,Glenn,021,27897,3611,3579,1046,4625,36
2021-12-07,Humboldt,023,135768,9805,9693,692,10385,117
2021-12-07,Imperial,025,180216,36023,35502,3700,39202,778
2021-12-07,Inyo,027,18085,2602,2567,39,2606,46
2021-12-07,Kern,029,883053,133754,132564,24029,156593,1838
2021-12-07,Kings,031,150075,33824,33441,2022,35463,372
2021-12-07,Lake,033,64148,6981,6925,159,7084,113
2021-12-07,Lassen,035,31185,7086,7040,422,7462,55
2021-12-07,Los Angeles,037,10098052,1483728,1470904,56250,1527154,27007
2021-12-07,Madera,039,155013,24587,24367,2311,26678,311
2021-12-07,Marin,041,260295,18483,18284,534,18818,249
2021-12-07,Mariposa,043,17540,1467,1446,61,1507,6
2021-12-07,Mendocino,045,87422,8225,8107,680,8787,95
2021-12-07,Merced,047,269075,43711,43600,2143,45743,675
2021-12-07,Modoc,049,8938,596,594,202,796,6
2021-12-07,Mono,051,14174,1940,1921,22,1943,4
2021-12-07,Monterey,053,433212,50257,48880,3269,52149,631
2021-12-07,Napa,055,140530,13506,13409,125,13534,107
2021-12-07,Nevada,057,99092,9952,9858,346,10204,105
2021-12-07,Orange,059,3164182,317635,315138,16187,331325,5784
2021-12-07,Placer,061,380077,39261,38860,3895,42755,474
2021-12-07,Plumas,063,18699,1985,1915,46,1961,12
2021-12-07,Riverside,065,2383286,379420,374552,16693,391245,5397
2021-12-07,Sacramento,067,1510023,166406,165148,4979,170127,2375
2021-12-07,San Benito,069,59416,7803,7776,182,7958,78
2021-12-07,San Bernardino,071,2135413,370843,366981,11785,378766,6007
2021-12-07,San Diego,073,3302833,393396,391110,23010,414120,4357
2021-12-07,San Francisco,075,870044,55478,54729,2426,57155,676
2021-12-07,San Joaquin,077,732212,103598,102797,5588,108385,1839
2021-12-07,San Luis Obispo,079,281455,30925,30495,1348,31843,361
2021-12-07,San Mateo,081,765935,56409,55163,980,56143,580
2021-12-07,Santa Barbara,083,443738,46566,46205,1618,47823,556
2021-12-07,Santa Clara,085,1922200,154018,152465,1652,154117,1941
2021-12-07,Santa Cruz,087,273765,21755,21493,1030,22523,224
2021-12-07,Shasta,089,179085,22765,22594,3705,26299,418
2021-12-07,Sierra,091,2930,201,199,21,220,0
2021-12-07,Siskiyou,093,43540,3475,3412,1357,4769,57
2021-12-07,Solano,095,438530,47511,46812,1347,48159,365
2021-12-07,Sonoma,097,501317,43553,43154,581,43735,405
2021-12-07,Stanislaus,099,539301,81821,81980,9261,91241,1258
2021-12-07,Sutter,101,95872,14342,14322,405,14727,186
2021-12-07,Tehama,103,63373,8844,8765,1537,10302,133
2021-12-07,Trinity,105,12862,910,818,220,1038,17
2021-12-07,Tulare,107,460477,71486,70411,16159,86570,1103
2021-12-07,Tuolumne,109,53932,7778,7743,112,7855,91
2021-12-07,Ventura,111,848112,101388,100569,4438,105007,1194
2021-12-07,Yolo,113,214977,20810,20560,1165,21725,263
2021-12-07,Yuba,115,75493,10574,10491,391,10882,91
2021-12-06,Alameda,001,1643700,123975,123227,2911,126138,1496
2021-12-06,Alpine,003,1148,106,108,0,108,0
2021-12-06,Amador,005,37829,5783,5769,69,5838,67
2021-12-06,Butte,007,227075,22004,21732,4009,25741,321
2021-12-06,Calaveras,009,45235,4486,4443,62,4505,88
2021-12-06,Colusa,011,21464,2631,2615,674,3289,21
2021-12-06,Contra Costa,013,1133247,102993,102327,2337,104664,1058
2021-12-06,Del Norte,015,27424,3801,3744,55,3799,42
2021-12-06,El Dorado,017,186661,16977,16726,1799,18525,168
2021-12-06,Fresno,019,978130,147071,145539,13160,158699,2285
2021-12-06,Glenn,021,27897,3608,3577,1045,4622,36
2021-12-06,Humboldt,023,135768,9785,9671,685,10356,117
2021-12-06,Imperial,025,180216,35942,35453,3682,39135,778
2021-12-06,Inyo,027,18085,2596,2562,38,2600,46
2021-12-06,Kern,029,883053,133567,132366,23973,156339,1835
2021-12-06,Kings,031,150075,33791,33399,2017,35416,368
2021-12-06,Lake,033,64148,6977,6922,159,7081,113
2021-12-06,Lassen,035,31185,7081,7032,420,7452,51
2021-12-06,Los Angeles,037,10098052,1482065,1470059,56158,1526217,26993
2021-12-06,Madera,039,155013,24560,24334,2308,26642,307
2021-12-06,Marin,041,260295,18455,18252,532,18784,249
2021-12-06,Mariposa,043,17540,1464,1443,61,1504,6
2021-12-06,Mendocino,045,87422,8212,8079,676,8755,95
2021-12-06,Merced,047,269075,43671,43549,2133,45682,672
2021-12-06,Modoc,049,8938,596,593,202,795,6
2021-12-06,Mono,051,14174,1935,1913,22,1935,4
2021-12-06,Monterey,053,433212,50180,48831,3250,52081,626
2021-12-06,Napa,055,140530,13483,13387,123,13510,107
2021-12-06,Nevada,057,99092,9924,9847,345,10192,105
2021-12-06,Orange,059,3164182,317254,314859,16145,331004,5771
2021-12-06,Placer,061,380077,39203,38785,3890,42675,473
2021-12-06,Plumas,063,18699,1977,1913,46,1959,10
2021-12-06,Riverside,065,2383286,378895,374116,16679,390795,5388
2021-12-06,Sacramento,067,1510023,166130,164926,4958,169884,2367
2021-12-06,San Benito,069,59416,7787,7755,182,7937,78
2021-12-06,San Bernardino,071,2135413,370282,366606,11758,378364,5998
2021-12-06,San Diego,073,3302833,392550,390389,22965,413354,4352
2021-12-06,San Francisco,075,870044,55370,54659,2421,57080,674
2021-12-06,San Joaquin,077,732212,103471,102728,5581,108309,1837
2021-12-06,San Luis Obispo,079,281455,30888,30464,1346,31810,361
2021-12-06,San Mateo,081,765935,56335,55112,977,56089,580
2021-12-06,Santa Barbara,083,443738,46473,46146,1617,47763,556
2021-12-06,Santa Clara,085,1922200,153809,152310,1635,153945,1937
2021-12-06,Santa Cruz,087,273765,21720,21450,1027,22477,224
2021-12-06,Shasta,089,179085,22742,22556,3697,26253,416
2021-12-06,Sierra,091,2930,200,198,21,219,0
2021-12-06,Siskiyou,093,43540,3473,3409,1352,4761,57
2021-12-06,Solano,095,438530,47466,46748,1346,48094,360
2021-12-06,Sonoma,097,501317,43483,43114,573,43687,405
2021-12-06,Stanislaus,099,539301,81727,81889,9227,91116,1241
2021-12-06,Sutter,101,95872,14330,14319,405,14724,186
2021-12-06,Tehama,103,63373,8836,8760,1537,10297,133
2021-12-06,Trinity,105,12862,910,815,219,1034,17
2021-12-06,Tulare,107,460477,71409,70285,16120,86405,1101
2021-12-06,Tuolumne,109,53932,7764,7726,112,7838,91
2021-12-06,Ventura,111,848112,101286,100426,4430,104856,1194
2021-12-06,Yolo,113,214977,20786,20548,1164,21712,263
2021-12-06,Yuba,115,75493,10559,10480,386,10866,91
2021-12-05,Alameda,001,1643700,123789,123104,2904,126008,1496
2021-12-05,Alpine,003,1148,105,108,0,108,0
2021-12-05,Amador,005,37829,5780,5761,69,5830,67
2021-12-05,Butte,007,227075,21971,21720,4003,25723,320
2021-12-05,Calaveras,009,45235,4469,4434,62,4496,88
2021-12-05,Colusa,011,21464,2630,2615,673,3288,21
2021-12-05,Contra Costa,013,1133247,102861,102251,2327,104578,1058
2021-12-05,Del Norte,015,27424,3799,3751,55,3806,42
2021-12-05,El Dorado,017,186661,16939,16717,1794,18511,168
2021-12-05,Fresno,019,978130,146897,145452,13139,158591,2284
2021-12-05,Glenn,021,27897,3606,3577,1044,4621,36
2021-12-05,Humboldt,023,135768,9755,9662,682,10344,117
2021-12-05,Imperial,025,180216,35848,35422,3653,39075,778
2021-12-05,Inyo,027,18085,2589,2559,38,2597,46
2021-12-05,Kern,029,883053,133403,132286,23921,156207,1833
2021-12-05,Kings,031,150075,33728,33360,2017,35377,369
2021-12-05,Lake,033,64148,6972,6919,158,7077,113
2021-12-05,Lassen,035,31185,7079,7031,420,7451,51
2021-12-05,Los Angeles,037,10098052,1480217,1468937,56020,1524957,26991
2021-12-05,Madera,039,155013,24519,24311,2305,26616,307
2021-12-05,Marin,041,260295,18408,18216,524,18740,249
2021-12-05,Mariposa,043,17540,1461,1440,60,1500,6
2021-12-05,Mendocino,045,87422,8193,8069,670,8739,95
2021-12-05,Merced,047,269075,43626,43534,2124,45658,672
2021-12-05,Modoc,049,8938,596,593,202,795,6
2021-12-05,Mono,051,14174,1928,1907,22,1929,4
2021-12-05,Monterey,053,433212,50108,48813,3218,52031,626
2021-12-05,Napa,055,140530,13457,13382,120,13502,107
2021-12-05,Nevada,057,99092,9903,9827,345,10172,105
2021-12-05,Orange,059,3164182,316819,314560,16103,330663,5771
2021-12-05,Placer,061,380077,39145,38738,3881,42619,473
2021-12-05,Plumas,063,18699,1973,1913,45,1958,9
2021-12-05,Riverside,065,2383286,378238,373827,16649,390476,5388
2021-12-05,Sacramento,067,1510023,165825,164721,4940,169661,2367
2021-12-05,San Benito,069,59416,7770,7748,181,7929,78
2021-12-05,San Bernardino,071,2135413,369576,366282,11711,377993,5998
2021-12-05,San Diego,073,3302833,391755,387979,22916,410895,4351
2021-12-05,San Francisco,075,870044,55269,54603,2419,57022,674
2021-12-05,San Joaquin,077,732212,103330,102698,5576,108274,1837
2021-12-05,San Luis Obispo,079,281455,30818,30454,1343,31797,360
2021-12-05,San Mateo,081,765935,56246,55050,967,56017,580
2021-12-05,Santa Barbara,083,443738,46390,46097,1609,47706,555
2021-12-05,Santa Clara,085,1922200,153556,152114,1616,153730,1933
2021-12-05,Santa Cruz,087,273765,21670,21424,1027,22451,224
2021-12-05,Shasta,089,179085,22685,22550,3696,26246,416
2021-12-05,Sierra,091,2930,200,198,21,219,0
2021-12-05,Siskiyou,093,43540,3471,3409,1351,4760,57
2021-12-05,Solano,095,438530,47403,46715,1344,48059,360
2021-12-05,Sonoma,097,501317,43406,43038,568,43606,405
2021-12-05,Stanislaus,099,539301,81594,81847,9217,91064,1241
2021-12-05,Sutter,101,95872,14307,14303,400,14703,186
2021-12-05,Tehama,103,63373,8828,8755,1535,10290,133
2021-12-05,Trinity,105,12862,909,815,219,1034,17
2021-12-05,Tulare,107,460477,71328,70254,16072,86326,1102
2021-12-05,Tuolumne,109,53932,7751,7718,112,7830,91
2021-12-05,Ventura,111,848112,101150,100367,4417,104784,1194
2021-12-05,Yolo,113,214977,20744,20512,1162,21674,263
2021-12-05,Yuba,115,75493,10546,10467,379,10846,91
2021-12-04,Alameda,001,1643700,123676,122508,2900,125408,1494
2021-12-04,Alpine,003,1148,105,108,0,108,0
2021-12-04,Amador,005,37829,5777,5729,69,5798,67
2021-12-04,Butte,007,227075,21952,21638,3999,25637,318
2021-12-04,Calaveras,009,45235,4461,4392,61,4453,88
2021-12-04,Colusa,011,21464,2630,2600,671,3271,21
2021-12-04,Contra Costa,013,1133247,102789,101824,2321,104145,1056
2021-12-04,Del Norte,015,27424,3796,3726,55,3781,42
2021-12-04,El Dorado,017,186661,16930,16621,1793,18414,168
2021-12-04,Fresno,019,978130,146808,144734,13130,157864,2270
2021-12-04,Glenn,021,27897,3606,3559,1044,4603,36
2021-12-04,Humboldt,023,135768,9740,9596,678,10274,117
2021-12-04,Imperial,025,180216,35795,35206,3640,38846,776
2021-12-04,Inyo,027,18085,2584,2538,38,2576,46
2021-12-04,Kern,029,883053,133323,131771,23898,155669,1817
2021-12-04,Kings,031,150075,33704,33183,2016,35199,367
2021-12-04,Lake,033,64148,6963,6903,158,7061,113
2021-12-04,Lassen,035,31185,7078,7014,418,7432,51
2021-12-04,Los Angeles,037,10098052,1479341,1463270,55943,1519213,26952
2021-12-04,Madera,039,155013,24505,24188,2301,26489,307
2021-12-04,Marin,041,260295,18387,18075,523,18598,249
2021-12-04,Mariposa,043,17540,1457,1421,60,1481,6
2021-12-04,Mendocino,045,87422,8188,7981,670,8651,91
2021-12-04,Merced,047,269075,43599,43337,2122,45459,671
2021-12-04,Modoc,049,8938,596,591,202,793,6
2021-12-04,Mono,051,14174,1928,1883,22,1905,4
2021-12-04,Monterey,053,433212,50076,48682,3211,51893,626
2021-12-04,Napa,055,140530,13447,13327,119,13446,106
2021-12-04,Nevada,057,99092,9895,9752,345,10097,105
2021-12-04,Orange,059,3164182,316588,313112,16077,329189,5748
2021-12-04,Placer,061,380077,39105,38460,3875,42335,473
2021-12-04,Plumas,063,18699,1970,1903,45,1948,7
2021-12-04,Riverside,065,2383286,377879,371768,16643,388411,5381
2021-12-04,Sacramento,067,1510023,165681,163900,4932,168832,2365
2021-12-04,San Benito,069,59416,7744,7688,181,7869,78
2021-12-04,San Bernardino,071,2135413,369187,364154,11698,375852,5983
2021-12-04,San Diego,073,3302833,391275,386710,22886,409596,4350
2021-12-04,San Francisco,075,870044,55201,54286,2416,56702,674
2021-12-04,San Joaquin,077,732212,103276,102286,5574,107860,1835
2021-12-04,San Luis Obispo,079,281455,30797,30318,1339,31657,360
2021-12-04,San Mateo,081,765935,56197,54774,964,55738,579
2021-12-04,Santa Barbara,083,443738,46345,45774,1609,47383,555
2021-12-04,Santa Clara,085,1922200,153402,151275,1602,152877,1928
2021-12-04,Santa Cruz,087,273765,21644,21286,1026,22312,224
2021-12-04,Shasta,089,179085,22668,22418,3694,26112,414
2021-12-04,Sierra,091,2930,200,196,21,217,0
2021-12-04,Siskiyou,093,43540,3469,3398,1351,4749,57
2021-12-04,Solano,095,438530,47383,46529,1343,47872,360
2021-12-04,Sonoma,097,501317,43361,42778,565,43343,405
2021-12-04,Stanislaus,099,539301,81523,81462,9210,90672,1231
2021-12-04,Sutter,101,95872,14299,14258,399,14657,186
2021-12-04,Tehama,103,63373,8826,8742,1535,10277,131
2021-12-04,Trinity,105,12862,908,801,219,1020,17
2021-12-04,Tulare,107,460477,71290,70014,16044,86058,1100
2021-12-04,Tuolumne,109,53932,7746,7676,112,7788,91
2021-12-04,Ventura,111,848112,101059,99751,4413,104164,1192
2021-12-04,Yolo,113,214977,20721,20442,1160,21602,261
2021-12-04,Yuba,115,75493,10535,10418,378,10796,91
2021-12-03,Alameda,001,1643700,123583,122508,2890,125398,1494
2021-12-03,Alpine,003,1148,105,108,0,108,0
2021-12-03,Amador,005,37829,5772,5729,68,5797,67
2021-12-03,Butte,007,227075,21939,21638,3994,25632,318
2021-12-03,Calaveras,009,45235,4452,4392,61,4453,88
2021-12-03,Colusa,011,21464,2628,2600,671,3271,21
2021-12-03,Contra Costa,013,1133247,102716,101824,2315,104139,1056
2021-12-03,Del Norte,015,27424,3794,3726,55,3781,42
2021-12-03,El Dorado,017,186661,16900,16621,1791,18412,168
2021-12-03,Fresno,019,978130,146694,144734,13127,157861,2270
2021-12-03,Glenn,021,27897,3605,3559,1043,4602,36
2021-12-03,Humboldt,023,135768,9723,9596,676,10272,117
2021-12-03,Imperial,025,180216,35753,35206,3610,38816,776
2021-12-03,Inyo,027,18085,2577,2538,38,2576,46
2021-12-03,Kern,029,883053,133251,131771,23863,155634,1817
2021-12-03,Kings,031,150075,33677,33183,2016,35199,367
2021-12-03,Lake,033,64148,6963,6903,158,7061,113
2021-12-03,Lassen,035,31185,7076,7014,417,7431,51
2021-12-03,Los Angeles,037,10098052,1478397,1463270,55866,1519136,26952
2021-12-03,Madera,039,155013,24479,24188,2297,26485,307
2021-12-03,Marin,041,260295,18354,18075,519,18594,249
2021-12-03,Mariposa,043,17540,1455,1421,60,1481,6
2021-12-03,Mendocino,045,87422,8181,7981,670,8651,91
2021-12-03,Merced,047,269075,43576,43337,2119,45456,671
2021-12-03,Modoc,049,8938,596,591,202,793,6
2021-12-03,Mono,051,14174,1922,1883,22,1905,4
2021-12-03,Monterey,053,433212,50037,48682,3200,51882,626
2021-12-03,Napa,055,140530,13435,13327,119,13446,106
2021-12-03,Nevada,057,99092,9884,9752,345,10097,105
2021-12-03,Orange,059,3164182,316317,313112,16045,329157,5748
2021-12-03,Placer,061,380077,39068,38460,3868,42328,473
2021-12-03,Plumas,063,18699,1967,1903,45,1948,7
2021-12-03,Riverside,065,2383286,377486,371768,16637,388405,5381
2021-12-03,Sacramento,067,1510023,165501,163900,4918,168818,2365
2021-12-03,San Benito,069,59416,7737,7688,181,7869,78
2021-12-03,San Bernardino,071,2135413,368739,364154,11687,375841,5983
2021-12-03,San Diego,073,3302833,390799,386710,22862,409572,4350
2021-12-03,San Francisco,075,870044,55131,54286,2412,56698,674
2021-12-03,San Joaquin,077,732212,103220,102286,5573,107859,1835
2021-12-03,San Luis Obispo,079,281455,30771,30318,1336,31654,360
2021-12-03,San Mateo,081,765935,56132,54774,961,55735,579
2021-12-03,Santa Barbara,083,443738,46309,45774,1609,47383,555
2021-12-03,Santa Clara,085,1922200,153220,151275,1587,152862,1928
2021-12-03,Santa Cruz,087,273765,21617,21286,1026,22312,224
2021-12-03,Shasta,089,179085,22653,22418,3694,26112,414
2021-12-03,Sierra,091,2930,200,196,21,217,0
2021-12-03,Siskiyou,093,43540,3466,3398,1349,4747,57
2021-12-03,Solano,095,438530,47341,46529,1342,47871,360
2021-12-03,Sonoma,097,501317,43325,42778,563,43341,405
2021-12-03,Stanislaus,099,539301,81466,81462,9201,90663,1231
2021-12-03,Sutter,101,95872,14286,14258,397,14655,186
2021-12-03,Tehama,103,63373,8825,8742,1534,10276,131
2021-12-03,Trinity,105,12862,908,801,219,1020,17
2021-12-03,Tulare,107,460477,71251,70014,16013,86027,1100
2021-12-03,Tuolumne,109,53932,7737,7676,112,7788,91
2021-12-03,Ventura,111,848112,100973,99751,4406,104157,1192
2021-12-03,Yolo,113,214977,20704,20442,1159,21601,261
2021-12-03,Yuba,115,75493,10527,10418,378,10796,91
2021-12-02,Alameda,001,1643700,123425,122508,2882,125390,1494
2021-12-02,Alpine,003,1148,105,108,0,108,0
2021-12-02,Amador,005,37829,5767,5729,67,5796,67
2021-12-02,Butte,007,227075,21914,21638,3989,25627,318
2021-12-02,Calaveras,009,45235,4442,4392,60,4452,88
2021-12-02,Colusa,011,21464,2627,2600,671,3271,21
2021-12-02,Contra Costa,013,1133247,102602,101824,2311,104135,1056
2021-12-02,Del Norte,015,27424,3786,3726,55,3781,42
2021-12-02,El Dorado,017,186661,16879,16621,1789,18410,168
2021-12-02,Fresno,019,978130,146525,144734,13115,157849,2270
2021-12-02,Glenn,021,27897,3605,3559,1040,4599,36
2021-12-02,Humboldt,023,135768,9704,9596,675,10271,117
2021-12-02,Imperial,025,180216,35685,35206,3588,38794,776
2021-12-02,Inyo,027,18085,2572,2538,38,2576,46
2021-12-02,Kern,029,883053,133080,131771,23811,155582,1817
2021-12-02,Kings,031,150075,33624,33183,2014,35197,367
2021-12-02,Lake,033,64148,6959,6903,158,7061,113
2021-12-02,Lassen,035,31185,7072,7014,417,7431,51
2021-12-02,Los Angeles,037,10098052,1476874,1463270,55779,1519049,26952
2021-12-02,Madera,039,155013,24442,24188,2288,26476,307
2021-12-02,Marin,041,260295,18323,18075,515,18590,249
2021-12-02,Mariposa,043,17540,1453,1421,60,1481,6
2021-12-02,Mendocino,045,87422,8165,7981,669,8650,91
2021-12-02,Merced,047,269075,43530,43337,2114,45451,671
2021-12-02,Modoc,049,8938,595,591,202,793,6
2021-12-02,Mono,051,14174,1916,1883,22,1905,4
2021-12-02,Monterey,053,433212,49961,48682,3178,51860,626
2021-12-02,Napa,055,140530,13422,13327,119,13446,106
2021-12-02,Nevada,057,99092,9866,9752,344,10096,105
2021-12-02,Orange,059,3164182,315972,313112,16008,329120,5748
2021-12-02,Placer,061,380077,39002,38460,3863,42323,473
2021-12-02,Plumas,063,18699,1964,1903,45,1948,7
2021-12-02,Riverside,065,2383286,376960,371768,16627,388395,5381
2021-12-02,Sacramento,067,1510023,165274,163900,4908,168808,2365
2021-12-02,San Benito,069,59416,7717,7688,181,7869,78
2021-12-02,San Bernardino,071,2135413,368194,364154,11667,375821,5983
2021-12-02,San Diego,073,3302833,390158,386710,22807,409517,4350
2021-12-02,San Francisco,075,870044,55036,54286,2407,56693,674
2021-12-02,San Joaquin,077,732212,103106,102286,5568,107854,1835
2021-12-02,San Luis Obispo,079,281455,30737,30318,1329,31647,360
2021-12-02,San Mateo,081,765935,56051,54774,953,55727,579
2021-12-02,Santa Barbara,083,443738,46228,45774,1606,47380,555
2021-12-02,Santa Clara,085,1922200,152974,151275,1570,152845,1928
2021-12-02,Santa Cruz,087,273765,21566,21286,1025,22311,224
2021-12-02,Shasta,089,179085,22620,22418,3693,26111,414
2021-12-02,Sierra,091,2930,200,196,21,217,0
2021-12-02,Siskiyou,093,43540,3465,3398,1342,4740,57
2021-12-02,Solano,095,438530,47291,46529,1340,47869,360
2021-12-02,Sonoma,097,501317,43251,42778,563,43341,405
2021-12-02,Stanislaus,099,539301,81374,81462,9193,90655,1231
2021-12-02,Sutter,101,95872,14273,14258,394,14652,186
2021-12-02,Tehama,103,63373,8818,8742,1532,10274,131
2021-12-02,Trinity,105,12862,908,801,219,1020,17
2021-12-02,Tulare,107,460477,71164,70014,15963,85977,1100
2021-12-02,Tuolumne,109,53932,7722,7676,111,7787,91
2021-12-02,Ventura,111,848112,100848,99751,4404,104155,1192
2021-12-02,Yolo,113,214977,20680,20442,1155,21597,261
2021-12-02,Yuba,115,75493,10511,10418,375,10793,91
2021-12-01,Alameda,001,1643700,123274,122298,2872,125170,1492
2021-12-01,Alpine,003,1148,105,108,0,108,0
2021-12-01,Amador,005,37829,5760,5723,67,5790,67
2021-12-01,Butte,007,227075,21896,21600,3984,25584,318
2021-12-01,Calaveras,009,45235,4437,4371,60,4431,88
2021-12-01,Colusa,011,21464,2620,2595,669,3264,20
2021-12-01,Contra Costa,013,1133247,102494,101651,2301,103952,1048
2021-12-01,Del Norte,015,27424,3784,3722,55,3777,42
2021-12-01,El Dorado,017,186661,16858,16575,1787,18362,166
2021-12-01,Fresno,019,978130,146318,144507,13107,157614,2264
2021-12-01,Glenn,021,27897,3598,3556,1039,4595,36
2021-12-01,Humboldt,023,135768,9680,9573,670,10243,117
2021-12-01,Imperial,025,180216,35605,35085,3561,38646,776
2021-12-01,Inyo,027,18085,2568,2533,38,2571,46
2021-12-01,Kern,029,883053,132933,131580,23756,155336,1804
2021-12-01,Kings,031,150075,33574,33112,2013,35125,364
2021-12-01,Lake,033,64148,6951,6896,157,7053,112
2021-12-01,Lassen,035,31185,7067,7008,415,7423,51
2021-12-01,Los Angeles,037,10098052,1475283,1461394,55684,1517078,26928
2021-12-01,Madera,039,155013,24411,24134,2279,26413,307
2021-12-01,Marin,041,260295,18285,18038,509,18547,249
2021-12-01,Mariposa,043,17540,1449,1415,60,1475,6
2021-12-01,Mendocino,045,87422,8151,7966,664,8630,90
2021-12-01,Merced,047,269075,43474,43259,2093,45352,670
2021-12-01,Modoc,049,8938,595,576,202,778,5
2021-12-01,Mono,051,14174,1911,1876,22,1898,4
2021-12-01,Monterey,053,433212,49912,48611,3169,51780,626
2021-12-01,Napa,055,140530,13405,13319,116,13435,107
2021-12-01,Nevada,057,99092,9853,9706,344,10050,105
2021-12-01,Orange,059,3164182,315607,312772,15971,328743,5735
2021-12-01,Placer,061,380077,38947,38373,3857,42230,472
2021-12-01,Plumas,063,18699,1960,1893,45,1938,7
2021-12-01,Riverside,065,2383286,376435,371189,16610,387799,5369
2021-12-01,Sacramento,067,1510023,165061,163616,4891,168507,2360
2021-12-01,San Benito,069,59416,7703,7669,181,7850,78
2021-12-01,San Bernardino,071,2135413,367604,363368,11641,375009,5973
2021-12-01,San Diego,073,3302833,389361,386056,22751,408807,4346
2021-12-01,San Francisco,075,870044,54954,54199,2400,56599,672
2021-12-01,San Joaquin,077,732212,102998,102109,5567,107676,1834
2021-12-01,San Luis Obispo,079,281455,30694,30238,1325,31563,360
2021-12-01,San Mateo,081,765935,55970,54711,950,55661,579
2021-12-01,Santa Barbara,083,443738,46158,45681,1604,47285,554
2021-12-01,Santa Clara,085,1922200,152754,150961,1553,152514,1925
2021-12-01,Santa Cruz,087,273765,21537,21191,1024,22215,224
2021-12-01,Shasta,089,179085,22589,22375,3687,26062,410
2021-12-01,Sierra,091,2930,200,195,21,216,0
2021-12-01,Siskiyou,093,43540,3462,3391,1342,4733,55
2021-12-01,Solano,095,438530,47246,46485,1340,47825,360
2021-12-01,Sonoma,097,501317,43175,42713,562,43275,405
2021-12-01,Stanislaus,099,539301,81281,81330,9180,90510,1231
2021-12-01,Sutter,101,95872,14258,14229,393,14622,186
2021-12-01,Tehama,103,63373,8808,8728,1532,10260,130
2021-12-01,Trinity,105,12862,903,801,219,1020,17
2021-12-01,Tulare,107,460477,71088,69953,15923,85876,1098
2021-12-01,Tuolumne,109,53932,7714,7655,111,7766,91
2021-12-01,Ventura,111,848112,100742,99680,4393,104073,1191
2021-12-01,Yolo,113,214977,20652,20393,1155,21548,260
2021-12-01,Yuba,115,75493,10500,10401,375,10776,89
2021-11-30,Alameda,001,1643700,123103,122196,2863,125059,1489
2021-11-30,Alpine,003,1148,105,108,0,108,0
2021-11-30,Amador,005,37829,5752,5716,67,5783,66
2021-11-30,Butte,007,227075,21867,21565,3973,25538,318
2021-11-30,Calaveras,009,45235,4419,4360,60,4420,88
2021-11-30,Colusa,011,21464,2619,2592,669,3261,21
2021-11-30,Contra Costa,013,1133247,102358,101538,2294,103832,1046
2021-11-30,Del Norte,015,27424,3778,3718,55,3773,42
2021-11-30,El Dorado,017,186661,16830,16558,1781,18339,166
2021-11-30,Fresno,019,978130,146118,144384,13099,157483,2259
2021-11-30,Glenn,021,27897,3594,3555,1038,4593,36
2021-11-30,Humboldt,023,135768,9649,9539,664,10203,116
2021-11-30,Imperial,025,180216,35497,34999,3534,38533,773
2021-11-30,Inyo,027,18085,2559,2530,38,2568,46
2021-11-30,Kern,029,883053,132762,131451,23699,155150,1799
2021-11-30,Kings,031,150075,33522,33074,2009,35083,362
2021-11-30,Lake,033,64148,6945,6892,155,7047,110
2021-11-30,Lassen,035,31185,7063,7003,414,7417,51
2021-11-30,Los Angeles,037,10098052,1473480,1460177,55584,1515761,26913
2021-11-30,Madera,039,155013,24377,24108,2274,26382,307
2021-11-30,Marin,041,260295,18241,18010,507,18517,249
2021-11-30,Mariposa,043,17540,1443,1412,60,1472,6
2021-11-30,Mendocino,045,87422,8122,7960,658,8618,89
2021-11-30,Merced,047,269075,43406,43200,2085,45285,668
2021-11-30,Modoc,049,8938,594,576,202,778,5
2021-11-30,Mono,051,14174,1908,1873,22,1895,4
2021-11-30,Monterey,053,433212,49849,48581,3159,51740,626
2021-11-30,Napa,055,140530,13385,13308,116,13424,105
2021-11-30,Nevada,057,99092,9837,9699,343,10042,105
2021-11-30,Orange,059,3164182,315186,312451,15929,328380,5724
2021-11-30,Placer,061,380077,38844,38324,3849,42173,470
2021-11-30,Plumas,063,18699,1955,1887,44,1931,7
2021-11-30,Riverside,065,2383286,375749,370739,16585,387324,5358
2021-11-30,Sacramento,067,1510023,164780,163420,4869,168289,2353
2021-11-30,San Benito,069,59416,7681,7645,180,7825,78
2021-11-30,San Bernardino,071,2135413,366922,363006,11618,374624,5967
2021-11-30,San Diego,073,3302833,388433,385405,22704,408109,4340
2021-11-30,San Francisco,075,870044,54848,54147,2391,56538,672
2021-11-30,San Joaquin,077,732212,102872,101972,5559,107531,1834
2021-11-30,San Luis Obispo,079,281455,30669,30200,1323,31523,360
2021-11-30,San Mateo,081,765935,55865,54656,940,55596,579
2021-11-30,Santa Barbara,083,443738,46062,45628,1598,47226,553
2021-11-30,Santa Clara,085,1922200,152495,150799,1535,152334,1929
2021-11-30,Santa Cruz,087,273765,21479,21169,1020,22189,224
2021-11-30,Shasta,089,179085,22559,22347,3684,26031,401
2021-11-30,Sierra,091,2930,197,195,21,216,0
2021-11-30,Siskiyou,093,43540,3458,3385,1339,4724,55
2021-11-30,Solano,095,438530,47183,46434,1334,47768,358
2021-11-30,Sonoma,097,501317,43096,42663,560,43223,405
2021-11-30,Stanislaus,099,539301,81181,81276,9153,90429,1227
2021-11-30,Sutter,101,95872,14247,14210,390,14600,186
2021-11-30,Tehama,103,63373,8801,8727,1531,10258,130
2021-11-30,Trinity,105,12862,902,799,219,1018,17
2021-11-30,Tulare,107,460477,71001,69900,15878,85778,1099
2021-11-30,Tuolumne,109,53932,7699,7643,111,7754,91
2021-11-30,Ventura,111,848112,100588,99601,4382,103983,1191
2021-11-30,Yolo,113,214977,20610,20376,1149,21525,260
2021-11-30,Yuba,115,75493,10481,10398,370,10768,89
2021-11-29,Alameda,001,1643700,122946,122136,2854,124990,1489
2021-11-29,Alpine,003,1148,105,108,0,108,0
2021-11-29,Amador,005,37829,5745,5706,67,5773,66
2021-11-29,Butte,007,227075,21836,21544,3965,25509,314
2021-11-29,Calaveras,009,45235,4403,4353,60,4413,88
2021-11-29,Colusa,011,21464,2617,2585,666,3251,20
2021-11-29,Contra Costa,013,1133247,102209,101441,2286,103727,1046
2021-11-29,Del Norte,015,27424,3775,3704,55,3759,42
2021-11-29,El Dorado,017,186661,16812,16534,1776,18310,166
2021-11-29,Fresno,019,978130,145912,144282,13076,157358,2254
2021-11-29,Glenn,021,27897,3591,3555,1037,4592,36
2021-11-29,Humboldt,023,135768,9632,9514,657,10171,115
2021-11-29,Imperial,025,180216,35432,34960,3513,38473,773
2021-11-29,Inyo,027,18085,2554,2529,38,2567,46
2021-11-29,Kern,029,883053,132578,131362,23658,155020,1789
2021-11-29,Kings,031,150075,33469,33059,2005,35064,363
2021-11-29,Lake,033,64148,6933,6889,155,7044,110
2021-11-29,Lassen,035,31185,7060,7003,412,7415,51
2021-11-29,Los Angeles,037,10098052,1471634,1459446,55498,1514944,26889
2021-11-29,Madera,039,155013,24341,24069,2266,26335,307
2021-11-29,Marin,041,260295,18194,17980,502,18482,249
2021-11-29,Mariposa,043,17540,1435,1409,60,1469,6
2021-11-29,Mendocino,045,87422,8105,7954,654,8608,89
2021-11-29,Merced,047,269075,43332,43167,2077,45244,667
2021-11-29,Modoc,049,8938,593,569,202,771,5
2021-11-29,Mono,051,14174,1891,1859,22,1881,4
2021-11-29,Monterey,053,433212,49788,48548,3143,51691,626
2021-11-29,Napa,055,140530,13375,13304,116,13420,104
2021-11-29,Nevada,057,99092,9823,9689,343,10032,105
2021-11-29,Orange,059,3164182,314783,312203,15883,328086,5709
2021-11-29,Placer,061,380077,38779,38261,3844,42105,470
2021-11-29,Plumas,063,18699,1952,1884,44,1928,7
2021-11-29,Riverside,065,2383286,375211,370334,16574,386908,5358
2021-11-29,Sacramento,067,1510023,164532,163282,4837,168119,2342
2021-11-29,San Benito,069,59416,7662,7631,179,7810,77
2021-11-29,San Bernardino,071,2135413,366321,362694,11584,374278,5962
2021-11-29,San Diego,073,3302833,387545,384853,22670,407523,4335
2021-11-29,San Francisco,075,870044,54749,54125,2387,56512,669
2021-11-29,San Joaquin,077,732212,102733,101927,5552,107479,1834
2021-11-29,San Luis Obispo,079,281455,30635,30165,1319,31484,359
2021-11-29,San Mateo,081,765935,55762,54622,936,55558,579
2021-11-29,Santa Barbara,083,443738,45965,45576,1594,47170,549
2021-11-29,Santa Clara,085,1922200,152221,150620,1529,152149,1925
2021-11-29,Santa Cruz,087,273765,21441,21149,1019,22168,224
2021-11-29,Shasta,089,179085,22524,22315,3680,25995,399
2021-11-29,Sierra,091,2930,197,195,21,216,0
2021-11-29,Siskiyou,093,43540,3455,3374,1332,4706,55
2021-11-29,Solano,095,438530,47131,46412,1332,47744,357
2021-11-29,Sonoma,097,501317,43019,42624,557,43181,405
2021-11-29,Stanislaus,099,539301,81099,81227,9135,90362,1223
2021-11-29,Sutter,101,95872,14231,14204,387,14591,186
2021-11-29,Tehama,103,63373,8796,8720,1526,10246,130
2021-11-29,Trinity,105,12862,897,798,219,1017,17
2021-11-29,Tulare,107,460477,70921,69850,15844,85694,1096
2021-11-29,Tuolumne,109,53932,7686,7627,111,7738,90
2021-11-29,Ventura,111,848112,100468,99520,4373,103893,1190
2021-11-29,Yolo,113,214977,20565,20344,1147,21491,257
2021-11-29,Yuba,115,75493,10464,10395,369,10764,89
2021-11-28,Alameda,001,1643700,122727,122082,2848,124930,1491
2021-11-28,Alpine,003,1148,105,108,0,108,0
2021-11-28,Amador,005,37829,5735,5703,67,5770,66
2021-11-28,Butte,007,227075,21795,21530,3963,25493,313
2021-11-28,Calaveras,009,45235,4382,4350,60,4410,88
2021-11-28,Colusa,011,21464,2613,2586,665,3251,19
2021-11-28,Contra Costa,013,1133247,102036,101355,2276,103631,1046
2021-11-28,Del Norte,015,27424,3770,3703,55,3758,42
2021-11-28,El Dorado,017,186661,16771,16527,1775,18302,166
2021-11-28,Fresno,019,978130,145666,144164,13050,157214,2252
2021-11-28,Glenn,021,27897,3588,3547,1035,4582,36
2021-11-28,Humboldt,023,135768,9600,9499,653,10152,115
2021-11-28,Imperial,025,180216,35324,34929,3489,38418,773
2021-11-28,Inyo,027,18085,2547,2531,38,2569,46
2021-11-28,Kern,029,883053,132372,131279,23601,154880,1789
2021-11-28,Kings,031,150075,33396,33057,1999,35056,364
2021-11-28,Lake,033,64148,6923,6885,154,7039,110
2021-11-28,Lassen,035,31185,7051,7002,408,7410,51
2021-11-28,Los Angeles,037,10098052,1469463,1458646,55411,1514057,26878
2021-11-28,Madera,039,155013,24293,24055,2259,26314,307
2021-11-28,Marin,041,260295,18146,17962,498,18460,249
2021-11-28,Mariposa,043,17540,1431,1406,60,1466,6
2021-11-28,Mendocino,045,87422,8075,7943,649,8592,89
2021-11-28,Merced,047,269075,43266,43166,2062,45228,667
2021-11-28,Modoc,049,8938,592,569,202,771,5
2021-11-28,Mono,051,14174,1885,1841,22,1863,4
2021-11-28,Monterey,053,433212,49723,48537,3124,51661,626
2021-11-28,Napa,055,140530,13362,13303,116,13419,104
2021-11-28,Nevada,057,99092,9797,9684,342,10026,105
2021-11-28,Orange,059,3164182,314397,312028,15841,327869,5693
2021-11-28,Placer,061,380077,38697,38240,3825,42065,470
2021-11-28,Plumas,063,18699,1946,1884,43,1927,7
2021-11-28,Riverside,065,2383286,374550,370051,16552,386603,5358
2021-11-28,Sacramento,067,1510023,164175,163170,4814,167984,2335
2021-11-28,San Benito,069,59416,7643,7623,178,7801,77
2021-11-28,San Bernardino,071,2135413,365584,362407,11556,373963,5958
2021-11-28,San Diego,073,3302833,386656,383025,22606,405631,4325
2021-11-28,San Francisco,075,870044,54673,54082,2382,56464,669
2021-11-28,San Joaquin,077,732212,102552,101895,5535,107430,1834
2021-11-28,San Luis Obispo,079,281455,30572,30152,1315,31467,358
2021-11-28,San Mateo,081,765935,55668,54567,932,55499,579
2021-11-28,Santa Barbara,083,443738,45886,45551,1583,47134,549
2021-11-28,Santa Clara,085,1922200,151920,150436,1514,151950,1920
2021-11-28,Santa Cruz,087,273765,21370,21110,1018,22128,224
2021-11-28,Shasta,089,179085,22485,22316,3678,25994,400
2021-11-28,Sierra,091,2930,197,195,21,216,0
2021-11-28,Siskiyou,093,43540,3449,3372,1328,4700,55
2021-11-28,Solano,095,438530,47069,46385,1331,47716,356
2021-11-28,Sonoma,097,501317,42933,42583,554,43137,405
2021-11-28,Stanislaus,099,539301,80980,81181,9113,90294,1223
2021-11-28,Sutter,101,95872,14209,14192,381,14573,186
2021-11-28,Tehama,103,63373,8788,8720,1522,10242,130
2021-11-28,Trinity,105,12862,896,797,219,1016,17
2021-11-28,Tulare,107,460477,70824,69833,15792,85625,1095
2021-11-28,Tuolumne,109,53932,7665,7620,111,7731,90
2021-11-28,Ventura,111,848112,100312,99486,4362,103848,1190
2021-11-28,Yolo,113,214977,20522,20333,1146,21479,257
2021-11-28,Yuba,115,75493,10446,10391,367,10758,89
2021-11-27,Alameda,001,1643700,122629,121618,2845,124463,1477
2021-11-27,Alpine,003,1148,105,106,0,106,0
2021-11-27,Amador,005,37829,5734,5670,67,5737,66
2021-11-27,Butte,007,227075,21772,21384,3958,25342,309
2021-11-27,Calaveras,009,45235,4376,4294,60,4354,85
2021-11-27,Colusa,011,21464,2612,2568,663,3231,19
2021-11-27,Contra Costa,013,1133247,101951,100961,2275,103236,1045
2021-11-27,Del Norte,015,27424,3763,3661,55,3716,42
2021-11-27,El Dorado,017,186661,16737,16399,1774,18173,161
2021-11-27,Fresno,019,978130,145554,143386,13044,156430,2246
2021-11-27,Glenn,021,27897,3584,3532,1034,4566,36
2021-11-27,Humboldt,023,135768,9572,9399,651,10050,115
2021-11-27,Imperial,025,180216,35242,34611,3473,38084,769
2021-11-27,Inyo,027,18085,2544,2506,38,2544,45
2021-11-27,Kern,029,883053,132288,130245,23572,153817,1773
2021-11-27,Kings,031,150075,33374,32891,1996,34887,358
2021-11-27,Lake,033,64148,6920,6836,153,6989,110
2021-11-27,Lassen,035,31185,7049,6959,407,7366,47
2021-11-27,Los Angeles,037,10098052,1468457,1454495,55342,1509837,26817
2021-11-27,Madera,039,155013,24272,23880,2254,26134,296
2021-11-27,Marin,041,260295,18107,17857,493,18350,248
2021-11-27,Mariposa,043,17540,1429,1374,60,1434,6
2021-11-27,Mendocino,045,87422,8056,7871,649,8520,89
2021-11-27,Merced,047,269075,43231,42921,2059,44980,664
2021-11-27,Modoc,049,8938,590,551,202,753,5
2021-11-27,Mono,051,14174,1883,1810,22,1832,4
2021-11-27,Monterey,053,433212,49690,48400,3110,51510,625
2021-11-27,Napa,055,140530,13348,13256,116,13372,104
2021-11-27,Nevada,057,99092,9775,9584,341,9925,103
2021-11-27,Orange,059,3164182,314146,310809,15805,326614,5665
2021-11-27,Placer,061,380077,38636,38001,3819,41820,468
2021-11-27,Plumas,063,18699,1942,1860,43,1903,7
2021-11-27,Riverside,065,2383286,374192,367601,16545,384146,5306
2021-11-27,Sacramento,067,1510023,164017,162328,4811,167139,2335
2021-11-27,San Benito,069,59416,7627,7575,178,7753,77
2021-11-27,San Bernardino,071,2135413,365150,360033,11547,371580,5932
2021-11-27,San Diego,073,3302833,386161,382634,22580,405214,4319
2021-11-27,San Francisco,075,870044,54623,53830,2379,56209,669
2021-11-27,San Joaquin,077,732212,102485,101368,5532,106900,1833
2021-11-27,San Luis Obispo,079,281455,30537,29983,1311,31294,358
2021-11-27,San Mateo,081,765935,55611,54360,929,55289,577
2021-11-27,Santa Barbara,083,443738,45832,45318,1581,46899,548
2021-11-27,Santa Clara,085,1922200,151713,149700,1507,151207,1922
2021-11-27,Santa Cruz,087,273765,21330,20929,1015,21944,222
2021-11-27,Shasta,089,179085,22462,22151,3677,25828,396
2021-11-27,Sierra,091,2930,196,194,21,215,0
2021-11-27,Siskiyou,093,43540,3446,3336,1326,4662,54
2021-11-27,Solano,095,438530,47033,46163,1328,47491,356
2021-11-27,Sonoma,097,501317,42870,42368,554,42922,405
2021-11-27,Stanislaus,099,539301,80912,80782,9096,89878,1220
2021-11-27,Sutter,101,95872,14201,14127,380,14507,181
2021-11-27,Tehama,103,63373,8786,8675,1521,10196,129
2021-11-27,Trinity,105,12862,896,789,219,1008,17
2021-11-27,Tulare,107,460477,70772,69377,15776,85153,1082
2021-11-27,Tuolumne,109,53932,7652,7574,111,7685,90
2021-11-27,Ventura,111,848112,100239,99163,4355,103518,1188
2021-11-27,Yolo,113,214977,20501,20237,1137,21374,257
2021-11-27,Yuba,115,75493,10435,10335,367,10702,88
2021-11-26,Alameda,001,1643700,122518,121618,2843,124461,1477
2021-11-26,Alpine,003,1148,105,106,0,106,0
2021-11-26,Amador,005,37829,5730,5670,67,5737,66
2021-11-26,Butte,007,227075,21748,21384,3953,25337,309
2021-11-26,Calaveras,009,45235,4367,4294,60,4354,85
2021-11-26,Colusa,011,21464,2610,2568,662,3230,19
2021-11-26,Contra Costa,013,1133247,101863,100961,2271,103232,1045
2021-11-26,Del Norte,015,27424,3760,3661,55,3716,42
2021-11-26,El Dorado,017,186661,16720,16399,1771,18170,161
2021-11-26,Fresno,019,978130,145422,143386,13034,156420,2246
2021-11-26,Glenn,021,27897,3581,3532,1034,4566,36
2021-11-26,Humboldt,023,135768,9553,9399,647,10046,115
2021-11-26,Imperial,025,180216,35185,34611,3460,38071,769
2021-11-26,Inyo,027,18085,2544,2506,38,2544,45
2021-11-26,Kern,029,883053,132205,130245,23528,153773,1773
2021-11-26,Kings,031,150075,33350,32891,1994,34885,358
2021-11-26,Lake,033,64148,6918,6836,153,6989,110
2021-11-26,Lassen,035,31185,7043,6959,407,7366,47
2021-11-26,Los Angeles,037,10098052,1467609,1454495,55281,1509776,26817
2021-11-26,Madera,039,155013,24245,23880,2252,26132,296
2021-11-26,Marin,041,260295,18078,17857,493,18350,248
2021-11-26,Mariposa,043,17540,1423,1374,59,1433,6
2021-11-26,Mendocino,045,87422,8046,7871,649,8520,89
2021-11-26,Merced,047,269075,43201,42921,2055,44976,664
2021-11-26,Modoc,049,8938,588,551,202,753,5
2021-11-26,Mono,051,14174,1872,1810,22,1832,4
2021-11-26,Monterey,053,433212,49647,48400,3103,51503,625
2021-11-26,Napa,055,140530,13332,13256,116,13372,104
2021-11-26,Nevada,057,99092,9763,9584,341,9925,103
2021-11-26,Orange,059,3164182,313877,310809,15773,326582,5665
2021-11-26,Placer,061,380077,38591,38001,3811,41812,468
2021-11-26,Plumas,063,18699,1937,1860,43,1903,7
2021-11-26,Riverside,065,2383286,373791,367601,16538,384139,5306
2021-11-26,Sacramento,067,1510023,163904,162328,4806,167134,2335
2021-11-26,San Benito,069,59416,7619,7575,178,7753,77
2021-11-26,San Bernardino,071,2135413,364720,360033,11540,371573,5932
2021-11-26,San Diego,073,3302833,385616,382634,22568,405202,4319
2021-11-26,San Francisco,075,870044,54576,53830,2377,56207,669
2021-11-26,San Joaquin,077,732212,102428,101368,5531,106899,1833
2021-11-26,San Luis Obispo,079,281455,30495,29983,1308,31291,358
2021-11-26,San Mateo,081,765935,55547,54360,928,55288,577
2021-11-26,Santa Barbara,083,443738,45785,45318,1580,46898,548
2021-11-26,Santa Clara,085,1922200,151544,149700,1499,151199,1922
2021-11-26,Santa Cruz,087,273765,21290,20929,1015,21944,222
2021-11-26,Shasta,089,179085,22442,22151,3675,25826,396
2021-11-26,Sierra,091,2930,196,194,21,215,0
2021-11-26,Siskiyou,093,43540,3443,3336,1325,4661,54
2021-11-26,Solano,095,438530,46992,46163,1327,47490,356
2021-11-26,Sonoma,097,501317,42820,42368,552,42920,405
2021-11-26,Stanislaus,099,539301,80839,80782,9085,89867,1220
2021-11-26,Sutter,101,95872,14188,14127,379,14506,181
2021-11-26,Tehama,103,63373,8784,8675,1520,10195,129
2021-11-26,Trinity,105,12862,895,789,219,1008,17
2021-11-26,Tulare,107,460477,70726,69377,15744,85121,1082
2021-11-26,Tuolumne,109,53932,7642,7574,111,7685,90
2021-11-26,Ventura,111,848112,100159,99163,4350,103513,1188
2021-11-26,Yolo,113,214977,20482,20237,1130,21367,257
2021-11-26,Yuba,115,75493,10429,10335,367,10702,88
2021-11-25,Alameda,001,1643700,122410,121618,2838,124456,1477
2021-11-25,Alpine,003,1148,105,106,0,106,0
2021-11-25,Amador,005,37829,5722,5670,67,5737,66
2021-11-25,Butte,007,227075,21730,21384,3951,25335,309
2021-11-25,Calaveras,009,45235,4362,4294,60,4354,85
2021-11-25,Colusa,011,21464,2607,2568,660,3228,19
2021-11-25,Contra Costa,013,1133247,101759,100961,2268,103229,1045
2021-11-25,Del Norte,015,27424,3755,3661,55,3716,42
2021-11-25,El Dorado,017,186661,16701,16399,1771,18170,161
2021-11-25,Fresno,019,978130,145288,143386,13025,156411,2246
2021-11-25,Glenn,021,27897,3578,3532,1033,4565,36
2021-11-25,Humboldt,023,135768,9534,9399,644,10043,115
2021-11-25,Imperial,025,180216,35140,34611,3449,38060,769
2021-11-25,Inyo,027,18085,2542,2506,38,2544,45
2021-11-25,Kern,029,883053,132107,130245,23482,153727,1773
2021-11-25,Kings,031,150075,33322,32891,1993,34884,358
2021-11-25,Lake,033,64148,6911,6836,153,6989,110
2021-11-25,Lassen,035,31185,7041,6959,406,7365,47
2021-11-25,Los Angeles,037,10098052,1466640,1454495,55224,1509719,26817
2021-11-25,Madera,039,155013,24209,23880,2251,26131,296
2021-11-25,Marin,041,260295,18051,17857,487,18344,248
2021-11-25,Mariposa,043,17540,1420,1374,59,1433,6
2021-11-25,Mendocino,045,87422,8028,7871,649,8520,89
2021-11-25,Merced,047,269075,43162,42921,2049,44970,664
2021-11-25,Modoc,049,8938,587,551,202,753,5
2021-11-25,Mono,051,14174,1861,1810,22,1832,4
2021-11-25,Monterey,053,433212,49603,48400,3094,51494,625
2021-11-25,Napa,055,140530,13324,13256,116,13372,104
2021-11-25,Nevada,057,99092,9744,9584,338,9922,103
2021-11-25,Orange,059,3164182,313614,310809,15742,326551,5665
2021-11-25,Placer,061,380077,38545,38001,3805,41806,468
2021-11-25,Plumas,063,18699,1935,1860,43,1903,7
2021-11-25,Riverside,065,2383286,373376,367601,16531,384132,5306
2021-11-25,Sacramento,067,1510023,163725,162328,4800,167128,2335
2021-11-25,San Benito,069,59416,7612,7575,178,7753,77
2021-11-25,San Bernardino,071,2135413,364323,360033,11523,371556,5932
2021-11-25,San Diego,073,3302833,385174,382634,22549,405183,4319
2021-11-25,San Francisco,075,870044,54526,53830,2374,56204,669
2021-11-25,San Joaquin,077,732212,102345,101368,5527,106895,1833
2021-11-25,San Luis Obispo,079,281455,30465,29983,1306,31289,358
2021-11-25,San Mateo,081,765935,55498,54360,926,55286,577
2021-11-25,Santa Barbara,083,443738,45746,45318,1578,46896,548
2021-11-25,Santa Clara,085,1922200,151387,149700,1494,151194,1922
2021-11-25,Santa Cruz,087,273765,21257,20929,1015,21944,222
2021-11-25,Shasta,089,179085,22416,22151,3675,25826,396
2021-11-25,Sierra,091,2930,196,194,21,215,0
2021-11-25,Siskiyou,093,43540,3440,3336,1325,4661,54
2021-11-25,Solano,095,438530,46955,46163,1326,47489,356
2021-11-25,Sonoma,097,501317,42763,42368,548,42916,405
2021-11-25,Stanislaus,099,539301,80774,80782,9071,89853,1220
2021-11-25,Sutter,101,95872,14172,14127,378,14505,181
2021-11-25,Tehama,103,63373,8776,8675,1520,10195,129
2021-11-25,Trinity,105,12862,895,789,219,1008,17
2021-11-25,Tulare,107,460477,70658,69377,15718,85095,1082
2021-11-25,Tuolumne,109,53932,7630,7574,111,7685,90
2021-11-25,Ventura,111,848112,100093,99163,4347,103510,1188
2021-11-25,Yolo,113,214977,20452,20237,1126,21363,257
2021-11-25,Yuba,115,75493,10420,10335,366,10701,88
2021-11-24,Alameda,001,1643700,122347,121618,2834,124452,1477
2021-11-24,Alpine,003,1148,105,106,0,106,0
2021-11-24,Amador,005,37829,5712,5670,67,5737,66
2021-11-24,Butte,007,227075,21714,21384,3950,25334,309
2021-11-24,Calaveras,009,45235,4355,4294,60,4354,85
2021-11-24,Colusa,011,21464,2607,2568,659,3227,19
2021-11-24,Contra Costa,013,1133247,101720,100961,2265,103226,1045
2021-11-24,Del Norte,015,27424,3752,3661,55,3716,42
2021-11-24,El Dorado,017,186661,16690,16399,1770,18169,161
2021-11-24,Fresno,019,978130,145233,143386,13024,156410,2246
2021-11-24,Glenn,021,27897,3573,3532,1032,4564,36
2021-11-24,Humboldt,023,135768,9519,9399,644,10043,115
2021-11-24,Imperial,025,180216,35111,34611,3443,38054,769
2021-11-24,Inyo,027,18085,2539,2506,38,2544,45
2021-11-24,Kern,029,883053,132045,130245,23470,153715,1773
2021-11-24,Kings,031,150075,33308,32891,1992,34883,358
2021-11-24,Lake,033,64148,6907,6836,153,6989,110
2021-11-24,Lassen,035,31185,7041,6959,406,7365,47
2021-11-24,Los Angeles,037,10098052,1466155,1454495,55182,1509677,26817
2021-11-24,Madera,039,155013,24186,23880,2245,26125,296
2021-11-24,Marin,041,260295,18039,17857,485,18342,248
2021-11-24,Mariposa,043,17540,1420,1374,59,1433,6
2021-11-24,Mendocino,045,87422,8016,7871,649,8520,89
2021-11-24,Merced,047,269075,43130,42921,2046,44967,664
2021-11-24,Modoc,049,8938,587,551,202,753,5
2021-11-24,Mono,051,14174,1858,1810,22,1832,4
2021-11-24,Monterey,053,433212,49590,48400,3093,51493,625
2021-11-24,Napa,055,140530,13320,13256,116,13372,104
2021-11-24,Nevada,057,99092,9729,9584,338,9922,103
2021-11-24,Orange,059,3164182,313459,310809,15727,326536,5665
2021-11-24,Placer,061,380077,38512,38001,3803,41804,468
2021-11-24,Plumas,063,18699,1933,1860,43,1903,7
2021-11-24,Riverside,065,2383286,373197,367601,16525,384126,5306
2021-11-24,Sacramento,067,1510023,163654,162328,4800,167128,2335
2021-11-24,San Benito,069,59416,7610,7575,178,7753,77
2021-11-24,San Bernardino,071,2135413,364112,360033,11513,371546,5932
2021-11-24,San Diego,073,3302833,384916,382634,22536,405170,4319
2021-11-24,San Francisco,075,870044,54495,53830,2372,56202,669
2021-11-24,San Joaquin,077,732212,102304,101368,5524,106892,1833
2021-11-24,San Luis Obispo,079,281455,30446,29983,1306,31289,358
2021-11-24,San Mateo,081,765935,55468,54360,925,55285,577
2021-11-24,Santa Barbara,083,443738,45719,45318,1578,46896,548
2021-11-24,Santa Clara,085,1922200,151291,149700,1493,151193,1922
2021-11-24,Santa Cruz,087,273765,21234,20929,1014,21943,222
2021-11-24,Shasta,089,179085,22405,22151,3672,25823,396
2021-11-24,Sierra,091,2930,196,194,21,215,0
2021-11-24,Siskiyou,093,43540,3437,3336,1325,4661,54
2021-11-24,Solano,095,438530,46927,46163,1324,47487,356
2021-11-24,Sonoma,097,501317,42731,42368,546,42914,405
2021-11-24,Stanislaus,099,539301,80737,80782,9066,89848,1220
2021-11-24,Sutter,101,95872,14159,14127,376,14503,181
2021-11-24,Tehama,103,63373,8773,8675,1519,10194,129
2021-11-24,Trinity,105,12862,895,789,219,1008,17
2021-11-24,Tulare,107,460477,70634,69377,15699,85076,1082
2021-11-24,Tuolumne,109,53932,7626,7574,111,7685,90
2021-11-24,Ventura,111,848112,100058,99163,4343,103506,1188
2021-11-24,Yolo,113,214977,20444,20237,1125,21362,257
2021-11-24,Yuba,115,75493,10416,10335,365,10700,88
2021-11-23,Alameda,001,1643700,122229,121618,2827,124445,1477
2021-11-23,Alpine,003,1148,105,106,0,106,0
2021-11-23,Amador,005,37829,5705,5670,67,5737,66
2021-11-23,Butte,007,227075,21685,21384,3946,25330,309
2021-11-23,Calaveras,009,45235,4349,4294,59,4353,85
2021-11-23,Colusa,011,21464,2603,2568,657,3225,19
2021-11-23,Contra Costa,013,1133247,101613,100961,2263,103224,1045
2021-11-23,Del Norte,015,27424,3749,3661,55,3716,42
2021-11-23,El Dorado,017,186661,16659,16399,1767,18166,161
2021-11-23,Fresno,019,978130,145095,143386,13015,156401,2246
2021-11-23,Glenn,021,27897,3568,3532,1032,4564,36
2021-11-23,Humboldt,023,135768,9497,9399,641,10040,115
2021-11-23,Imperial,025,180216,35042,34611,3424,38035,769
2021-11-23,Inyo,027,18085,2535,2506,38,2544,45
2021-11-23,Kern,029,883053,131937,130245,23421,153666,1773
2021-11-23,Kings,031,150075,33266,32891,1991,34882,358
2021-11-23,Lake,033,64148,6902,6836,153,6989,110
2021-11-23,Lassen,035,31185,7038,6959,403,7362,47
2021-11-23,Los Angeles,037,10098052,1465147,1454495,55114,1509609,26817
2021-11-23,Madera,039,155013,24160,23880,2243,26123,296
2021-11-23,Marin,041,260295,18008,17857,482,18339,248
2021-11-23,Mariposa,043,17540,1417,1374,59,1433,6
2021-11-23,Mendocino,045,87422,7995,7871,646,8517,89
2021-11-23,Merced,047,269075,43092,42921,2045,44966,664
2021-11-23,Modoc,049,8938,585,551,202,753,5
2021-11-23,Mono,051,14174,1844,1810,22,1832,4
2021-11-23,Monterey,053,433212,49554,48400,3087,51487,625
2021-11-23,Napa,055,140530,13311,13256,116,13372,104
2021-11-23,Nevada,057,99092,9700,9584,337,9921,103
2021-11-23,Orange,059,3164182,313209,310809,15691,326500,5665
2021-11-23,Placer,061,380077,38453,38001,3786,41787,468
2021-11-23,Plumas,063,18699,1929,1860,43,1903,7
2021-11-23,Riverside,065,2383286,372814,367601,16512,384113,5306
2021-11-23,Sacramento,067,1510023,163467,162328,4789,167117,2335
2021-11-23,San Benito,069,59416,7601,7575,176,7751,77
2021-11-23,San Bernardino,071,2135413,363694,360033,11498,371531,5932
2021-11-23,San Diego,073,3302833,384432,382634,22513,405147,4319
2021-11-23,San Francisco,075,870044,54436,53830,2370,56200,669
2021-11-23,San Joaquin,077,732212,102195,101368,5513,106881,1833
2021-11-23,San Luis Obispo,079,281455,30411,29983,1303,31286,358
2021-11-23,San Mateo,081,765935,55418,54360,924,55284,577
2021-11-23,Santa Barbara,083,443738,45666,45318,1578,46896,548
2021-11-23,Santa Clara,085,1922200,151081,149700,1481,151181,1922
2021-11-23,Santa Cruz,087,273765,21196,20929,1014,21943,222
2021-11-23,Shasta,089,179085,22369,22151,3670,25821,396
2021-11-23,Sierra,091,2930,196,194,21,215,0
2021-11-23,Siskiyou,093,43540,3432,3336,1324,4660,54
2021-11-23,Solano,095,438530,46873,46163,1320,47483,356
2021-11-23,Sonoma,097,501317,42680,42368,543,42911,405
2021-11-23,Stanislaus,099,539301,80667,80782,9054,89836,1220
2021-11-23,Sutter,101,95872,14143,14127,375,14502,181
2021-11-23,Tehama,103,63373,8760,8675,1518,10193,129
2021-11-23,Trinity,105,12862,894,789,219,1008,17
2021-11-23,Tulare,107,460477,70587,69377,15669,85046,1082
2021-11-23,Tuolumne,109,53932,7614,7574,110,7684,90
2021-11-23,Ventura,111,848112,99975,99163,4337,103500,1188
2021-11-23,Yolo,113,214977,20423,20237,1117,21354,257
2021-11-23,Yuba,115,75493,10404,10335,365,10700,88
2021-11-22,Alameda,001,1643700,122116,121566,2825,124391,1475
2021-11-22,Alpine,003,1148,105,106,0,106,0
2021-11-22,Amador,005,37829,5692,5670,67,5737,66
2021-11-22,Butte,007,227075,21646,21363,3941,25304,305
2021-11-22,Calaveras,009,45235,4337,4294,59,4353,84
2021-11-22,Colusa,011,21464,2600,2565,657,3222,19
2021-11-22,Contra Costa,013,1133247,101525,100877,2258,103135,1045
2021-11-22,Del Norte,015,27424,3746,3659,55,3714,42
2021-11-22,El Dorado,017,186661,16636,16378,1764,18142,161
2021-11-22,Fresno,019,978130,144962,143290,13007,156297,2243
2021-11-22,Glenn,021,27897,3563,3530,1031,4561,36
2021-11-22,Humboldt,023,135768,9471,9389,636,10025,115
2021-11-22,Imperial,025,180216,34981,34562,3410,37972,766
2021-11-22,Inyo,027,18085,2529,2501,38,2539,44
2021-11-22,Kern,029,883053,131776,130091,23372,153463,1762
2021-11-22,Kings,031,150075,33229,32867,1986,34853,358
2021-11-22,Lake,033,64148,6897,6837,153,6990,110
2021-11-22,Lassen,035,31185,7036,6954,402,7356,47
2021-11-22,Los Angeles,037,10098052,1464083,1453945,55031,1508976,26800
2021-11-22,Madera,039,155013,24126,23872,2235,26107,296
2021-11-22,Marin,041,260295,17977,17842,480,18322,248
2021-11-22,Mariposa,043,17540,1413,1372,59,1431,6
2021-11-22,Mendocino,045,87422,7979,7859,645,8504,89
2021-11-22,Merced,047,269075,43041,42898,2034,44932,660
2021-11-22,Modoc,049,8938,584,551,202,753,5
2021-11-22,Mono,051,14174,1837,1809,22,1831,4
2021-11-22,Monterey,053,433212,49526,48374,3083,51457,611
2021-11-22,Napa,055,140530,13303,13255,115,13370,104
2021-11-22,Nevada,057,99092,9683,9575,335,9910,96
2021-11-22,Orange,059,3164182,312968,310654,15665,326319,5663
2021-11-22,Placer,061,380077,38408,37956,3778,41734,465
2021-11-22,Plumas,063,18699,1926,1858,43,1901,7
2021-11-22,Riverside,065,2383286,372377,367301,16503,383804,5283
2021-11-22,Sacramento,067,1510023,163275,162222,4780,167002,2328
2021-11-22,San Benito,069,59416,7581,7567,176,7743,77
2021-11-22,San Bernardino,071,2135413,363279,359851,11488,371339,5916
2021-11-22,San Diego,073,3302833,383937,382132,22489,404621,4317
2021-11-22,San Francisco,075,870044,54344,53778,2364,56142,669
2021-11-22,San Joaquin,077,732212,102070,101299,5508,106807,1833
2021-11-22,San Luis Obispo,079,281455,30385,29963,1300,31263,358
2021-11-22,San Mateo,081,765935,55361,54330,922,55252,577
2021-11-22,Santa Barbara,083,443738,45590,45279,1578,46857,546
2021-11-22,Santa Clara,085,1922200,150896,149541,1471,151012,1919
2021-11-22,Santa Cruz,087,273765,21155,20891,1014,21905,222
2021-11-22,Shasta,089,179085,22355,22116,3665,25781,393
2021-11-22,Sierra,091,2930,196,193,21,214,0
2021-11-22,Siskiyou,093,43540,3427,3336,1322,4658,54
2021-11-22,Solano,095,438530,46824,46153,1318,47471,356
2021-11-22,Sonoma,097,501317,42619,42344,542,42886,404
2021-11-22,Stanislaus,099,539301,80579,80718,9044,89762,1209
2021-11-22,Sutter,101,95872,14127,14125,373,14498,181
2021-11-22,Tehama,103,63373,8753,8669,1513,10182,127
2021-11-22,Trinity,105,12862,893,785,219,1004,17
2021-11-22,Tulare,107,460477,70526,69314,15633,84947,1075
2021-11-22,Tuolumne,109,53932,7599,7567,110,7677,90
2021-11-22,Ventura,111,848112,99909,99114,4334,103448,1186
2021-11-22,Yolo,113,214977,20400,20227,1115,21342,257
2021-11-22,Yuba,115,75493,10395,10332,364,10696,88
2021-11-21,Alameda,001,1643700,121985,121443,2821,124264,1475
2021-11-21,Alpine,003,1148,103,106,0,106,0
2021-11-21,Amador,005,37829,5687,5662,66,5728,66
2021-11-21,Butte,007,227075,21604,21342,3936,25278,306
2021-11-21,Calaveras,009,45235,4328,4287,59,4346,84
2021-11-21,Colusa,011,21464,2596,2562,656,3218,19
2021-11-21,Contra Costa,013,1133247,101423,100807,2251,103058,1045
2021-11-21,Del Norte,015,27424,3742,3659,55,3714,42
2021-11-21,El Dorado,017,186661,16609,16370,1758,18128,161
2021-11-21,Fresno,019,978130,144790,143203,12987,156190,2242
2021-11-21,Glenn,021,27897,3559,3529,1031,4560,36
2021-11-21,Humboldt,023,135768,9448,9378,635,10013,115
2021-11-21,Imperial,025,180216,34893,34527,3400,37927,766
2021-11-21,Inyo,027,18085,2522,2501,38,2539,44
2021-11-21,Kern,029,883053,131613,130020,23326,153346,1762
2021-11-21,Kings,031,150075,33191,32843,1982,34825,356
2021-11-21,Lake,033,64148,6890,6834,153,6987,110
2021-11-21,Lassen,035,31185,7027,6953,402,7355,47
2021-11-21,Los Angeles,037,10098052,1463015,1453181,54976,1508157,26793
2021-11-21,Madera,039,155013,24101,23856,2230,26086,296
2021-11-21,Marin,041,260295,17948,17829,477,18306,248
2021-11-21,Mariposa,043,17540,1412,1371,58,1429,6
2021-11-21,Mendocino,045,87422,7973,7846,642,8488,89
2021-11-21,Merced,047,269075,42986,42881,2031,44912,660
2021-11-21,Modoc,049,8938,580,551,202,753,5
2021-11-21,Mono,051,14174,1827,1799,21,1820,4
2021-11-21,Monterey,053,433212,49480,48358,3074,51432,611
2021-11-21,Napa,055,140530,13290,13250,115,13365,104
2021-11-21,Nevada,057,99092,9657,9556,334,9890,96
2021-11-21,Orange,059,3164182,312711,310477,15634,326111,5663
2021-11-21,Placer,061,380077,38326,37929,3777,41706,465
2021-11-21,Plumas,063,18699,1921,1858,43,1901,7
2021-11-21,Riverside,065,2383286,371885,367093,16495,383588,5283
2021-11-21,Sacramento,067,1510023,163058,162087,4770,166857,2327
2021-11-21,San Benito,069,59416,7567,7563,175,7738,77
2021-11-21,San Bernardino,071,2135413,362787,359621,11452,371073,5912
2021-11-21,San Diego,073,3302833,383406,380747,22464,403211,4317
2021-11-21,San Francisco,075,870044,54275,53741,2359,56100,669
2021-11-21,San Joaquin,077,732212,101964,101264,5495,106759,1833
2021-11-21,San Luis Obispo,079,281455,30347,29948,1300,31248,358
2021-11-21,San Mateo,081,765935,55309,54290,920,55210,577
2021-11-21,Santa Barbara,083,443738,45530,45237,1575,46812,546
2021-11-21,Santa Clara,085,1922200,150691,149387,1452,150839,1918
2021-11-21,Santa Cruz,087,273765,21111,20866,1012,21878,222
2021-11-21,Shasta,089,179085,22324,22112,3663,25775,393
2021-11-21,Sierra,091,2930,196,193,21,214,0
2021-11-21,Siskiyou,093,43540,3422,3333,1321,4654,54
2021-11-21,Solano,095,438530,46768,46122,1311,47433,356
2021-11-21,Sonoma,097,501317,42559,42298,541,42839,404
2021-11-21,Stanislaus,099,539301,80484,80687,9029,89716,1209
2021-11-21,Sutter,101,95872,14113,14111,373,14484,181
2021-11-21,Tehama,103,63373,8747,8669,1512,10181,127
2021-11-21,Trinity,105,12862,891,784,217,1001,17
2021-11-21,Tulare,107,460477,70443,69285,15594,84879,1075
2021-11-21,Tuolumne,109,53932,7591,7560,109,7669,90
2021-11-21,Ventura,111,848112,99818,99081,4331,103412,1186
2021-11-21,Yolo,113,214977,20372,20209,1112,21321,257
2021-11-21,Yuba,115,75493,10386,10326,364,10690,88
2021-11-20,Alameda,001,1643700,121892,121059,2815,123874,1473
2021-11-20,Alpine,003,1148,103,105,0,105,0
2021-11-20,Amador,005,37829,5681,5652,65,5717,66
2021-11-20,Butte,007,227075,21589,21265,3932,25197,300
2021-11-20,Calaveras,009,45235,4318,4268,59,4327,84
2021-11-20,Colusa,011,21464,2595,2549,655,3204,19
2021-11-20,Contra Costa,013,1133247,101346,100491,2247,102738,1043
2021-11-20,Del Norte,015,27424,3739,3637,55,3692,42
2021-11-20,El Dorado,017,186661,16588,16308,1756,18064,161
2021-11-20,Fresno,019,978130,144721,142579,12978,155557,2233
2021-11-20,Glenn,021,27897,3558,3526,1030,4556,35
2021-11-20,Humboldt,023,135768,9435,9302,633,9935,115
2021-11-20,Imperial,025,180216,34841,34312,3394,37706,766
2021-11-20,Inyo,027,18085,2521,2467,38,2505,44
2021-11-20,Kern,029,883053,131512,129488,23289,152777,1750
2021-11-20,Kings,031,150075,33181,32720,1982,34702,354
2021-11-20,Lake,033,64148,6887,6808,153,6961,110
2021-11-20,Lassen,035,31185,7026,6931,402,7333,47
2021-11-20,Los Angeles,037,10098052,1462395,1448963,54928,1503891,26741
2021-11-20,Madera,039,155013,24087,23720,2226,25946,296
2021-11-20,Marin,041,260295,17933,17774,477,18251,248
2021-11-20,Mariposa,043,17540,1411,1354,58,1412,6
2021-11-20,Mendocino,045,87422,7965,7773,642,8415,89
2021-11-20,Merced,047,269075,42960,42692,2031,44723,656
2021-11-20,Modoc,049,8938,579,550,202,752,5
2021-11-20,Mono,051,14174,1821,1767,21,1788,4
2021-11-20,Monterey,053,433212,49467,48260,3069,51329,609
2021-11-20,Napa,055,140530,13287,13184,115,13299,103
2021-11-20,Nevada,057,99092,9641,9480,334,9814,92
2021-11-20,Orange,059,3164182,312512,309672,15617,325289,5658
2021-11-20,Placer,061,380077,38286,37800,3772,41572,462
2021-11-20,Plumas,063,18699,1917,1841,43,1884,7
2021-11-20,Riverside,065,2383286,371612,365809,16483,382292,5265
2021-11-20,Sacramento,067,1510023,162954,161533,4766,166299,2316
2021-11-20,San Benito,069,59416,7563,7533,175,7708,77
2021-11-20,San Bernardino,071,2135413,362510,358322,11441,369763,5897
2021-11-20,San Diego,073,3302833,383080,380147,22438,402585,4311
2021-11-20,San Francisco,075,870044,54236,53525,2358,55883,669
2021-11-20,San Joaquin,077,732212,101914,100922,5490,106412,1832
2021-11-20,San Luis Obispo,079,281455,30333,29815,1299,31114,355
2021-11-20,San Mateo,081,765935,55275,54132,919,55051,577
2021-11-20,Santa Barbara,083,443738,45498,45074,1575,46649,544
2021-11-20,Santa Clara,085,1922200,150584,148829,1451,150280,1917
2021-11-20,Santa Cruz,087,273765,21093,20756,1012,21768,222
2021-11-20,Shasta,089,179085,22300,21968,3662,25630,383
2021-11-20,Sierra,091,2930,196,191,21,212,0
2021-11-20,Siskiyou,093,43540,3419,3313,1321,4634,54
2021-11-20,Solano,095,438530,46747,46006,1311,47317,356
2021-11-20,Sonoma,097,501317,42528,42151,541,42692,403
2021-11-20,Stanislaus,099,539301,80438,80412,9025,89437,1205
2021-11-20,Sutter,101,95872,14105,14074,373,14447,181
2021-11-20,Tehama,103,63373,8742,8648,1512,10160,125
2021-11-20,Trinity,105,12862,887,771,217,988,17
2021-11-20,Tulare,107,460477,70404,69074,15573,84647,1054
2021-11-20,Tuolumne,109,53932,7583,7511,109,7620,90
2021-11-20,Ventura,111,848112,99769,98893,4324,103217,1186
2021-11-20,Yolo,113,214977,20364,20139,1108,21247,257
2021-11-20,Yuba,115,75493,10380,10290,363,10653,88
2021-11-19,Alameda,001,1643700,121816,121059,2812,123871,1473
2021-11-19,Alpine,003,1148,103,105,0,105,0
2021-11-19,Amador,005,37829,5671,5652,65,5717,66
2021-11-19,Butte,007,227075,21566,21265,3926,25191,300
2021-11-19,Calaveras,009,45235,4311,4268,59,4327,84
2021-11-19,Colusa,011,21464,2593,2549,654,3203,19
2021-11-19,Contra Costa,013,1133247,101289,100491,2242,102733,1043
2021-11-19,Del Norte,015,27424,3734,3637,55,3692,42
2021-11-19,El Dorado,017,186661,16566,16308,1754,18062,161
2021-11-19,Fresno,019,978130,144604,142579,12969,155548,2233
2021-11-19,Glenn,021,27897,3557,3526,1029,4555,35
2021-11-19,Humboldt,023,135768,9422,9302,630,9932,115
2021-11-19,Imperial,025,180216,34804,34312,3387,37699,766
2021-11-19,Inyo,027,18085,2517,2467,38,2505,44
2021-11-19,Kern,029,883053,131409,129488,23246,152734,1750
2021-11-19,Kings,031,150075,33156,32720,1980,34700,354
2021-11-19,Lake,033,64148,6884,6808,153,6961,110
2021-11-19,Lassen,035,31185,7021,6931,401,7332,47
2021-11-19,Los Angeles,037,10098052,1461706,1448963,54874,1503837,26741
2021-11-19,Madera,039,155013,24066,23720,2221,25941,296
2021-11-19,Marin,041,260295,17915,17774,475,18249,248
2021-11-19,Mariposa,043,17540,1409,1354,58,1412,6
2021-11-19,Mendocino,045,87422,7945,7773,642,8415,89
2021-11-19,Merced,047,269075,42934,42692,2030,44722,656
2021-11-19,Modoc,049,8938,578,550,202,752,5
2021-11-19,Mono,051,14174,1810,1767,21,1788,4
2021-11-19,Monterey,053,433212,49445,48260,3069,51329,609
2021-11-19,Napa,055,140530,13277,13184,114,13298,103
2021-11-19,Nevada,057,99092,9628,9480,334,9814,92
2021-11-19,Orange,059,3164182,312358,309672,15592,325264,5658
2021-11-19,Placer,061,380077,38249,37800,3768,41568,462
2021-11-19,Plumas,063,18699,1913,1841,43,1884,7
2021-11-19,Riverside,065,2383286,371338,365809,16479,382288,5265
2021-11-19,Sacramento,067,1510023,162829,161533,4762,166295,2316
2021-11-19,San Benito,069,59416,7557,7533,173,7706,77
2021-11-19,San Bernardino,071,2135413,362186,358322,11432,369754,5897
2021-11-19,San Diego,073,3302833,382689,380147,22412,402559,4311
2021-11-19,San Francisco,075,870044,54198,53525,2358,55883,669
2021-11-19,San Joaquin,077,732212,101857,100922,5486,106408,1832
2021-11-19,San Luis Obispo,079,281455,30315,29815,1297,31112,355
2021-11-19,San Mateo,081,765935,55227,54132,915,55047,577
2021-11-19,Santa Barbara,083,443738,45461,45074,1575,46649,544
2021-11-19,Santa Clara,085,1922200,150436,148829,1448,150277,1917
2021-11-19,Santa Cruz,087,273765,21066,20756,1009,21765,222
2021-11-19,Shasta,089,179085,22288,21968,3661,25629,383
2021-11-19,Sierra,091,2930,196,191,21,212,0
2021-11-19,Siskiyou,093,43540,3416,3313,1321,4634,54
2021-11-19,Solano,095,438530,46717,46006,1307,47313,356
2021-11-19,Sonoma,097,501317,42495,42151,538,42689,403
2021-11-19,Stanislaus,099,539301,80381,80412,9016,89428,1205
2021-11-19,Sutter,101,95872,14103,14074,373,14447,181
2021-11-19,Tehama,103,63373,8739,8648,1512,10160,125
2021-11-19,Trinity,105,12862,885,771,217,988,17
2021-11-19,Tulare,107,460477,70363,69074,15547,84621,1054
2021-11-19,Tuolumne,109,53932,7572,7511,109,7620,90
2021-11-19,Ventura,111,848112,99704,98893,4321,103214,1186
2021-11-19,Yolo,113,214977,20353,20139,1106,21245,257
2021-11-19,Yuba,115,75493,10377,10290,363,10653,88
2021-11-18,Alameda,001,1643700,121691,121059,2805,123864,1473
2021-11-18,Alpine,003,1148,103,105,0,105,0
2021-11-18,Amador,005,37829,5669,5652,65,5717,66
2021-11-18,Butte,007,227075,21549,21265,3918,25183,300
2021-11-18,Calaveras,009,45235,4304,4268,58,4326,84
2021-11-18,Colusa,011,21464,2585,2549,654,3203,19
2021-11-18,Contra Costa,013,1133247,101187,100491,2234,102725,1043
2021-11-18,Del Norte,015,27424,3731,3637,55,3692,42
2021-11-18,El Dorado,017,186661,16546,16308,1751,18059,161
2021-11-18,Fresno,019,978130,144464,142579,12959,155538,2233
2021-11-18,Glenn,021,27897,3556,3526,1028,4554,35
2021-11-18,Humboldt,023,135768,9406,9302,625,9927,115
2021-11-18,Imperial,025,180216,34749,34312,3371,37683,766
2021-11-18,Inyo,027,18085,2509,2467,38,2505,44
2021-11-18,Kern,029,883053,131263,129488,23199,152687,1750
2021-11-18,Kings,031,150075,33119,32720,1977,34697,354
2021-11-18,Lake,033,64148,6879,6808,153,6961,110
2021-11-18,Lassen,035,31185,7018,6931,396,7327,47
2021-11-18,Los Angeles,037,10098052,1460715,1448963,54813,1503776,26741
2021-11-18,Madera,039,155013,24041,23720,2217,25937,296
2021-11-18,Marin,041,260295,17898,17774,471,18245,248
2021-11-18,Mariposa,043,17540,1406,1354,58,1412,6
2021-11-18,Mendocino,045,87422,7923,7773,633,8406,89
2021-11-18,Merced,047,269075,42877,42692,2028,44720,656
2021-11-18,Modoc,049,8938,566,550,202,752,5
2021-11-18,Mono,051,14174,1802,1767,21,1788,4
2021-11-18,Monterey,053,433212,49420,48260,3064,51324,609
2021-11-18,Napa,055,140530,13265,13184,113,13297,103
2021-11-18,Nevada,057,99092,9604,9480,334,9814,92
2021-11-18,Orange,059,3164182,312121,309672,15572,325244,5658
2021-11-18,Placer,061,380077,38206,37800,3757,41557,462
2021-11-18,Plumas,063,18699,1912,1841,43,1884,7
2021-11-18,Riverside,065,2383286,370965,365809,16466,382275,5265
2021-11-18,Sacramento,067,1510023,162601,161533,4747,166280,2316
2021-11-18,San Benito,069,59416,7547,7533,173,7706,77
2021-11-18,San Bernardino,071,2135413,361754,358322,11413,369735,5897
2021-11-18,San Diego,073,3302833,382191,380147,22396,402543,4311
2021-11-18,San Francisco,075,870044,54146,53525,2354,55879,669
2021-11-18,San Joaquin,077,732212,101764,100922,5477,106399,1832
2021-11-18,San Luis Obispo,079,281455,30285,29815,1296,31111,355
2021-11-18,San Mateo,081,765935,55168,54132,912,55044,577
2021-11-18,Santa Barbara,083,443738,45415,45074,1568,46642,544
2021-11-18,Santa Clara,085,1922200,150249,148829,1440,150269,1917
2021-11-18,Santa Cruz,087,273765,21015,20756,1008,21764,222
2021-11-18,Shasta,089,179085,22252,21968,3656,25624,383
2021-11-18,Sierra,091,2930,195,191,21,212,0
2021-11-18,Siskiyou,093,43540,3416,3313,1317,4630,54
2021-11-18,Solano,095,438530,46675,46006,1304,47310,356
2021-11-18,Sonoma,097,501317,42446,42151,536,42687,403
2021-11-18,Stanislaus,099,539301,80314,80412,9008,89420,1205
2021-11-18,Sutter,101,95872,14092,14074,372,14446,181
2021-11-18,Tehama,103,63373,8734,8648,1512,10160,125
2021-11-18,Trinity,105,12862,884,771,217,988,17
2021-11-18,Tulare,107,460477,70289,69074,15503,84577,1054
2021-11-18,Tuolumne,109,53932,7562,7511,109,7620,90
2021-11-18,Ventura,111,848112,99627,98893,4317,103210,1186
2021-11-18,Yolo,113,214977,20336,20139,1102,21241,257
2021-11-18,Yuba,115,75493,10371,10290,363,10653,88
2021-11-17,Alameda,001,1643700,121569,120913,2804,123717,1472
2021-11-17,Alpine,003,1148,103,105,0,105,0
2021-11-17,Amador,005,37829,5663,5646,65,5711,66
2021-11-17,Butte,007,227075,21523,21230,3915,25145,300
2021-11-17,Calaveras,009,45235,4297,4259,58,4317,84
2021-11-17,Colusa,011,21464,2582,2546,653,3199,19
2021-11-17,Contra Costa,013,1133247,101095,100387,2230,102617,1039
2021-11-17,Del Norte,015,27424,3728,3630,55,3685,42
2021-11-17,El Dorado,017,186661,16526,16269,1750,18019,161
2021-11-17,Fresno,019,978130,144282,142366,12946,155312,2230
2021-11-17,Glenn,021,27897,3554,3527,1026,4553,34
2021-11-17,Humboldt,023,135768,9395,9270,622,9892,115
2021-11-17,Imperial,025,180216,34693,34256,3350,37606,766
2021-11-17,Inyo,027,18085,2503,2457,38,2495,44
2021-11-17,Kern,029,883053,131090,129307,23157,152464,1743
2021-11-17,Kings,031,150075,33092,32669,1973,34642,352
2021-11-17,Lake,033,64148,6875,6795,152,6947,110
2021-11-17,Lassen,035,31185,7016,6918,396,7314,47
2021-11-17,Los Angeles,037,10098052,1459615,1447947,54746,1502693,26721
2021-11-17,Madera,039,155013,24008,23673,2215,25888,287
2021-11-17,Marin,041,260295,17878,17757,469,18226,248
2021-11-17,Mariposa,043,17540,1402,1353,58,1411,6
2021-11-17,Mendocino,045,87422,7915,7735,632,8367,89
2021-11-17,Merced,047,269075,42818,42612,2023,44635,654
2021-11-17,Modoc,049,8938,562,540,202,742,5
2021-11-17,Mono,051,14174,1798,1765,21,1786,5
2021-11-17,Monterey,053,433212,49372,48221,3053,51274,609
2021-11-17,Napa,055,140530,13242,13167,113,13280,103
2021-11-17,Nevada,057,99092,9591,9447,334,9781,92
2021-11-17,Orange,059,3164182,311874,309396,15538,324934,5651
2021-11-17,Placer,061,380077,38158,37725,3749,41474,460
2021-11-17,Plumas,063,18699,1907,1833,43,1876,7
2021-11-17,Riverside,065,2383286,370554,365406,16453,381859,5229
2021-11-17,Sacramento,067,1510023,162431,161269,4740,166009,2302
2021-11-17,San Benito,069,59416,7540,7524,173,7697,77
2021-11-17,San Bernardino,071,2135413,361390,357947,11396,369343,5893
2021-11-17,San Diego,073,3302833,381700,379769,22370,402139,4301
2021-11-17,San Francisco,075,870044,54091,53469,2351,55820,667
2021-11-17,San Joaquin,077,732212,101662,100764,5472,106236,1828
2021-11-17,San Luis Obispo,079,281455,30259,29731,1293,31024,354
2021-11-17,San Mateo,081,765935,55100,54092,909,55001,577
2021-11-17,Santa Barbara,083,443738,45376,45000,1568,46568,542
2021-11-17,Santa Clara,085,1922200,150085,148626,1432,150058,1915
2021-11-17,Santa Cruz,087,273765,20980,20700,1008,21708,222
2021-11-17,Shasta,089,179085,22219,21883,3654,25537,382
2021-11-17,Sierra,091,2930,194,189,21,210,0
2021-11-17,Siskiyou,093,43540,3412,3307,1314,4621,54
2021-11-17,Solano,095,438530,46642,45948,1303,47251,353
2021-11-17,Sonoma,097,501317,42400,42093,533,42626,403
2021-11-17,Stanislaus,099,539301,80225,80276,8998,89274,1199
2021-11-17,Sutter,101,95872,14078,14064,370,14434,181
2021-11-17,Tehama,103,63373,8724,8633,1509,10142,125
2021-11-17,Trinity,105,12862,883,765,217,982,17
2021-11-17,Tulare,107,460477,70218,68977,15476,84453,1047
2021-11-17,Tuolumne,109,53932,7545,7485,109,7594,90
2021-11-17,Ventura,111,848112,99565,98812,4311,103123,1183
2021-11-17,Yolo,113,214977,20317,20100,1099,21199,257
2021-11-17,Yuba,115,75493,10359,10275,359,10634,88
2021-11-16,Alameda,001,1643700,121460,120809,2800,123609,1467
2021-11-16,Alpine,003,1148,103,105,0,105,0
2021-11-16,Amador,005,37829,5657,5644,65,5709,66
2021-11-16,Butte,007,227075,21497,21208,3910,25118,297
2021-11-16,Calaveras,009,45235,4288,4249,58,4307,83
2021-11-16,Colusa,011,21464,2576,2538,653,3191,19
2021-11-16,Contra Costa,013,1133247,100974,100320,2227,102547,1038
2021-11-16,Del Norte,015,27424,3722,3630,55,3685,42
2021-11-16,El Dorado,017,186661,16501,16248,1748,17996,159
2021-11-16,Fresno,019,978130,144096,142200,12924,155124,2218
2021-11-16,Glenn,021,27897,3553,3527,1023,4550,34
2021-11-16,Humboldt,023,135768,9374,9252,618,9870,115
2021-11-16,Imperial,025,180216,34609,34177,3336,37513,766
2021-11-16,Inyo,027,18085,2496,2449,38,2487,42
2021-11-16,Kern,029,883053,130930,129136,23096,152232,1735
2021-11-16,Kings,031,150075,33039,32614,1966,34580,350
2021-11-16,Lake,033,64148,6870,6789,152,6941,110
2021-11-16,Lassen,035,31185,7006,6915,396,7311,47
2021-11-16,Los Angeles,037,10098052,1458439,1446815,54674,1501489,26703
2021-11-16,Madera,039,155013,23970,23642,2209,25851,287
2021-11-16,Marin,041,260295,17859,17736,468,18204,248
2021-11-16,Mariposa,043,17540,1394,1349,57,1406,6
2021-11-16,Mendocino,045,87422,7873,7723,628,8351,89
2021-11-16,Merced,047,269075,42781,42578,2016,44594,653
2021-11-16,Modoc,049,8938,561,539,201,740,5
2021-11-16,Mono,051,14174,1789,1767,21,1788,4
2021-11-16,Monterey,053,433212,49342,48195,3039,51234,609
2021-11-16,Napa,055,140530,13231,13151,113,13264,103
2021-11-16,Nevada,057,99092,9574,9435,333,9768,92
2021-11-16,Orange,059,3164182,311607,309170,15504,324674,5651
2021-11-16,Placer,061,380077,38116,37676,3743,41419,459
2021-11-16,Plumas,063,18699,1898,1832,43,1875,7
2021-11-16,Riverside,065,2383286,370132,365078,16431,381509,5208
2021-11-16,Sacramento,067,1510023,162251,161102,4728,165830,2299
2021-11-16,San Benito,069,59416,7526,7513,173,7686,77
2021-11-16,San Bernardino,071,2135413,360973,357528,11343,368871,5901
2021-11-16,San Diego,073,3302833,381145,379435,22343,401778,4287
2021-11-16,San Francisco,075,870044,54018,53415,2343,55758,667
2021-11-16,San Joaquin,077,732212,101522,100637,5457,106094,1807
2021-11-16,San Luis Obispo,079,281455,30227,29703,1290,30993,356
2021-11-16,San Mateo,081,765935,55038,54034,907,54941,577
2021-11-16,Santa Barbara,083,443738,45308,44932,1565,46497,539
2021-11-16,Santa Clara,085,1922200,149904,148452,1420,149872,1916
2021-11-16,Santa Cruz,087,273765,20935,20684,1006,21690,222
2021-11-16,Shasta,089,179085,22180,21853,3650,25503,379
2021-11-16,Sierra,091,2930,194,189,21,210,0
2021-11-16,Siskiyou,093,43540,3409,3304,1312,4616,54
2021-11-16,Solano,095,438530,46602,45908,1302,47210,351
2021-11-16,Sonoma,097,501317,42351,42056,532,42588,401
2021-11-16,Stanislaus,099,539301,80130,80214,8975,89189,1196
2021-11-16,Sutter,101,95872,14066,14058,369,14427,181
2021-11-16,Tehama,103,63373,8717,8621,1502,10123,125
2021-11-16,Trinity,105,12862,883,762,216,978,17
2021-11-16,Tulare,107,460477,70138,68881,15441,84322,1039
2021-11-16,Tuolumne,109,53932,7535,7478,109,7587,90
2021-11-16,Ventura,111,848112,99490,98731,4308,103039,1183
2021-11-16,Yolo,113,214977,20278,20077,1097,21174,257
2021-11-16,Yuba,115,75493,10351,10262,357,10619,85
2021-11-15,Alameda,001,1643700,121304,120731,2796,123527,1464
2021-11-15,Alpine,003,1148,103,105,0,105,0
2021-11-15,Amador,005,37829,5652,5637,65,5702,66
2021-11-15,Butte,007,227075,21473,21182,3905,25087,296
2021-11-15,Calaveras,009,45235,4274,4237,58,4295,83
2021-11-15,Colusa,011,21464,2569,2535,650,3185,19
2021-11-15,Contra Costa,013,1133247,100868,100251,2224,102475,1038
2021-11-15,Del Norte,015,27424,3717,3630,54,3684,42
2021-11-15,El Dorado,017,186661,16477,16236,1744,17980,159
2021-11-15,Fresno,019,978130,143874,142015,12902,154917,2210
2021-11-15,Glenn,021,27897,3551,3526,1023,4549,34
2021-11-15,Humboldt,023,135768,9352,9230,610,9840,115
2021-11-15,Imperial,025,180216,34536,34130,3320,37450,766
2021-11-15,Inyo,027,18085,2491,2442,38,2480,42
2021-11-15,Kern,029,883053,130721,128928,23025,151953,1730
2021-11-15,Kings,031,150075,33005,32584,1961,34545,348
2021-11-15,Lake,033,64148,6866,6784,152,6936,109
2021-11-15,Lassen,035,31185,6995,6915,394,7309,47
2021-11-15,Los Angeles,037,10098052,1457248,1446114,54611,1500725,26677
2021-11-15,Madera,039,155013,23932,23605,2198,25803,287
2021-11-15,Marin,041,260295,17842,17723,467,18190,248
2021-11-15,Mariposa,043,17540,1393,1347,55,1402,6
2021-11-15,Mendocino,045,87422,7853,7694,622,8316,89
2021-11-15,Merced,047,269075,42724,42552,2005,44557,648
2021-11-15,Modoc,049,8938,560,538,200,738,5
2021-11-15,Mono,051,14174,1784,1763,21,1784,4
2021-11-15,Monterey,053,433212,49310,48154,3033,51187,609
2021-11-15,Napa,055,140530,13223,13143,113,13256,103
2021-11-15,Nevada,057,99092,9545,9420,332,9752,92
2021-11-15,Orange,059,3164182,311330,308859,15479,324338,5646
2021-11-15,Placer,061,380077,38052,37610,3739,41349,452
2021-11-15,Plumas,063,18699,1891,1829,43,1872,7
2021-11-15,Riverside,065,2383286,369686,364750,16412,381162,5199
2021-11-15,Sacramento,067,1510023,162031,160937,4716,165653,2293
2021-11-15,San Benito,069,59416,7521,7511,172,7683,77
2021-11-15,San Bernardino,071,2135413,360547,357306,11324,368630,5898
2021-11-15,San Diego,073,3302833,380608,378845,22318,401163,4284
2021-11-15,San Francisco,075,870044,53951,53374,2340,55714,667
2021-11-15,San Joaquin,077,732212,101368,100587,5446,106033,1799
2021-11-15,San Luis Obispo,079,281455,30184,29669,1278,30947,351
2021-11-15,San Mateo,081,765935,54985,54010,905,54915,576
2021-11-15,Santa Barbara,083,443738,45252,44879,1559,46438,539
2021-11-15,Santa Clara,085,1922200,149687,148313,1413,149726,1914
2021-11-15,Santa Cruz,087,273765,20893,20630,1005,21635,223
2021-11-15,Shasta,089,179085,22135,21779,3645,25424,374
2021-11-15,Sierra,091,2930,194,189,21,210,0
2021-11-15,Siskiyou,093,43540,3402,3302,1310,4612,54
2021-11-15,Solano,095,438530,46563,45885,1297,47182,351
2021-11-15,Sonoma,097,501317,42300,42021,531,42552,401
2021-11-15,Stanislaus,099,539301,80045,80129,8961,89090,1174
2021-11-15,Sutter,101,95872,14053,14043,368,14411,181
2021-11-15,Tehama,103,63373,8711,8615,1501,10116,125
2021-11-15,Trinity,105,12862,881,757,214,971,17
2021-11-15,Tulare,107,460477,70051,68826,15396,84222,1039
2021-11-15,Tuolumne,109,53932,7524,7461,109,7570,90
2021-11-15,Ventura,111,848112,99406,98605,4303,102908,1183
2021-11-15,Yolo,113,214977,20248,20065,1092,21157,255
2021-11-15,Yuba,115,75493,10332,10254,353,10607,85
2021-11-14,Alameda,001,1643700,121130,120629,2792,123421,1461
2021-11-14,Alpine,003,1148,102,105,0,105,0
2021-11-14,Amador,005,37829,5645,5632,64,5696,66
2021-11-14,Butte,007,227075,21441,21146,3896,25042,296
2021-11-14,Calaveras,009,45235,4263,4222,58,4280,83
2021-11-14,Colusa,011,21464,2567,2532,647,3179,19
2021-11-14,Contra Costa,013,1133247,100760,100188,2222,102410,1038
2021-11-14,Del Norte,015,27424,3714,3629,54,3683,42
2021-11-14,El Dorado,017,186661,16435,16212,1739,17951,159
2021-11-14,Fresno,019,978130,143592,141869,12869,154738,2209
2021-11-14,Glenn,021,27897,3549,3521,1023,4544,34
2021-11-14,Humboldt,023,135768,9322,9215,600,9815,115
2021-11-14,Imperial,025,180216,34433,34078,3305,37383,766
2021-11-14,Inyo,027,18085,2479,2441,38,2479,42
2021-11-14,Kern,029,883053,130481,128842,22955,151797,1730
2021-11-14,Kings,031,150075,32948,32545,1954,34499,349
2021-11-14,Lake,033,64148,6858,6777,152,6929,109
2021-11-14,Lassen,035,31185,6985,6911,393,7304,47
2021-11-14,Los Angeles,037,10098052,1455880,1445284,54535,1499819,26667
2021-11-14,Madera,039,155013,23882,23566,2189,25755,287
2021-11-14,Marin,041,260295,17827,17712,467,18179,247
2021-11-14,Mariposa,043,17540,1383,1337,51,1388,6
2021-11-14,Mendocino,045,87422,7820,7684,617,8301,89
2021-11-14,Merced,047,269075,42634,42513,1999,44512,648
2021-11-14,Modoc,049,8938,558,538,200,738,5
2021-11-14,Mono,051,14174,1772,1760,21,1781,4
2021-11-14,Monterey,053,433212,49255,48135,3015,51150,609
2021-11-14,Napa,055,140530,13205,13132,113,13245,103
2021-11-14,Nevada,057,99092,9517,9408,332,9740,92
2021-11-14,Orange,059,3164182,311010,308699,15458,324157,5646
2021-11-14,Placer,061,380077,37972,37569,3729,41298,452
2021-11-14,Plumas,063,18699,1888,1829,42,1871,7
2021-11-14,Riverside,065,2383286,369188,364490,16395,380885,5199
2021-11-14,Sacramento,067,1510023,161794,160761,4699,165460,2295
2021-11-14,San Benito,069,59416,7510,7507,171,7678,77
2021-11-14,San Bernardino,071,2135413,359967,357014,11307,368321,5897
2021-11-14,San Diego,073,3302833,380011,377633,22287,399920,4280
2021-11-14,San Francisco,075,870044,53875,53338,2335,55673,667
2021-11-14,San Joaquin,077,732212,101240,100518,5441,105959,1799
2021-11-14,San Luis Obispo,079,281455,30103,29645,1274,30919,352
2021-11-14,San Mateo,081,765935,54932,53978,903,54881,576
2021-11-14,Santa Barbara,083,443738,45173,44842,1556,46398,539
2021-11-14,Santa Clara,085,1922200,149489,148152,1405,149557,1913
2021-11-14,Santa Cruz,087,273765,20839,20609,1003,21612,223
2021-11-14,Shasta,089,179085,22083,21771,3632,25403,373
2021-11-14,Sierra,091,2930,194,189,21,210,0
2021-11-14,Siskiyou,093,43540,3393,3302,1309,4611,54
2021-11-14,Solano,095,438530,46508,45860,1290,47150,351
2021-11-14,Sonoma,097,501317,42234,41974,529,42503,401
2021-11-14,Stanislaus,099,539301,79910,80076,8943,89019,1174
2021-11-14,Sutter,101,95872,14036,14031,363,14394,181
2021-11-14,Tehama,103,63373,8701,8607,1499,10106,125
2021-11-14,Trinity,105,12862,878,754,212,966,17
2021-11-14,Tulare,107,460477,69933,68772,15338,84110,1037
2021-11-14,Tuolumne,109,53932,7506,7439,108,7547,90
2021-11-14,Ventura,111,848112,99291,98550,4302,102852,1183
2021-11-14,Yolo,113,214977,20221,20040,1086,21126,255
2021-11-14,Yuba,115,75493,10325,10238,352,10590,85
2021-11-13,Alameda,001,1643700,121059,120407,2790,123197,1454
2021-11-13,Alpine,003,1148,102,105,0,105,0
2021-11-13,Amador,005,37829,5644,5614,64,5678,66
2021-11-13,Butte,007,227075,21420,21104,3893,24997,296
2021-11-13,Calaveras,009,45235,4252,4203,58,4261,83
2021-11-13,Colusa,011,21464,2565,2522,647,3169,19
2021-11-13,Contra Costa,013,1133247,100688,100004,2216,102220,1028
2021-11-13,Del Norte,015,27424,3714,3629,54,3683,42
2021-11-13,El Dorado,017,186661,16422,16163,1736,17899,159
2021-11-13,Fresno,019,978130,143485,141452,12855,154307,2205
2021-11-13,Glenn,021,27897,3549,3514,1022,4536,34
2021-11-13,Humboldt,023,135768,9306,9177,595,9772,115
2021-11-13,Imperial,025,180216,34383,33990,3288,37278,766
2021-11-13,Inyo,027,18085,2473,2436,38,2474,42
2021-11-13,Kern,029,883053,130379,128472,22911,151383,1719
2021-11-13,Kings,031,150075,32931,32452,1953,34405,347
2021-11-13,Lake,033,64148,6853,6769,152,6921,109
2021-11-13,Lassen,035,31185,6980,6897,393,7290,47
2021-11-13,Los Angeles,037,10098052,1455225,1443088,54496,1497584,26649
2021-11-13,Madera,039,155013,23851,23462,2184,25646,287
2021-11-13,Marin,041,260295,17814,17684,465,18149,247
2021-11-13,Mariposa,043,17540,1380,1323,51,1374,6
2021-11-13,Mendocino,045,87422,7801,7652,616,8268,89
2021-11-13,Merced,047,269075,42596,42411,1996,44407,644
2021-11-13,Modoc,049,8938,557,536,200,736,5
2021-11-13,Mono,051,14174,1768,1750,21,1771,4
2021-11-13,Monterey,053,433212,49229,48087,3013,51100,609
2021-11-13,Napa,055,140530,13197,13110,113,13223,103
2021-11-13,Nevada,057,99092,9497,9369,330,9699,92
2021-11-13,Orange,059,3164182,310844,308211,15430,323641,5641
2021-11-13,Placer,061,380077,37922,37453,3726,41179,445
2021-11-13,Plumas,063,18699,1885,1828,42,1870,8
2021-11-13,Riverside,065,2383286,368882,363801,16388,380189,5187
2021-11-13,Sacramento,067,1510023,161657,160397,4687,165084,2291
2021-11-13,San Benito,069,59416,7497,7491,170,7661,77
2021-11-13,San Bernardino,071,2135413,359714,356325,11300,367625,5873
2021-11-13,San Diego,073,3302833,379681,377633,22259,399892,4280
2021-11-13,San Francisco,075,870044,53843,53195,2334,55529,667
2021-11-13,San Joaquin,077,732212,101183,100263,5432,105695,1799
2021-11-13,San Luis Obispo,079,281455,30073,29589,1272,30861,351
2021-11-13,San Mateo,081,765935,54894,53853,902,54755,574
2021-11-13,Santa Barbara,083,443738,45140,44734,1556,46290,537
2021-11-13,Santa Clara,085,1922200,149369,147821,1400,149221,1905
2021-11-13,Santa Cruz,087,273765,20824,20565,1002,21567,223
2021-11-13,Shasta,089,179085,22052,21713,3628,25341,366
2021-11-13,Sierra,091,2930,193,188,21,209,0
2021-11-13,Siskiyou,093,43540,3384,3299,1308,4607,54
2021-11-13,Solano,095,438530,46479,45774,1286,47060,350
2021-11-13,Sonoma,097,501317,42200,41882,528,42410,399
2021-11-13,Stanislaus,099,539301,79835,79872,8929,88801,1174
2021-11-13,Sutter,101,95872,14026,14017,362,14379,181
2021-11-13,Tehama,103,63373,8695,8592,1495,10087,125
2021-11-13,Trinity,105,12862,877,749,212,961,17
2021-11-13,Tulare,107,460477,69868,68619,15315,83934,1033
2021-11-13,Tuolumne,109,53932,7488,7392,108,7500,90
2021-11-13,Ventura,111,848112,99233,98452,4299,102751,1183
2021-11-13,Yolo,113,214977,20207,20009,1081,21090,255
2021-11-13,Yuba,115,75493,10315,10218,350,10568,85
2021-11-12,Alameda,001,1643700,120975,120407,2787,123194,1454
2021-11-12,Alpine,003,1148,102,105,0,105,0
2021-11-12,Amador,005,37829,5640,5614,63,5677,66
2021-11-12,Butte,007,227075,21402,21104,3889,24993,296
2021-11-12,Calaveras,009,45235,4241,4203,58,4261,83
2021-11-12,Colusa,011,21464,2561,2522,646,3168,19
2021-11-12,Contra Costa,013,1133247,100634,100004,2215,102219,1028
2021-11-12,Del Norte,015,27424,3714,3629,54,3683,42
2021-11-12,El Dorado,017,186661,16403,16163,1735,17898,159
2021-11-12,Fresno,019,978130,143342,141452,12842,154294,2205
2021-11-12,Glenn,021,27897,3546,3514,1021,4535,34
2021-11-12,Humboldt,023,135768,9299,9177,593,9770,115
2021-11-12,Imperial,025,180216,34357,33990,3278,37268,766
2021-11-12,Inyo,027,18085,2469,2436,38,2474,42
2021-11-12,Kern,029,883053,130242,128472,22879,151351,1719
2021-11-12,Kings,031,150075,32905,32452,1951,34403,347
2021-11-12,Lake,033,64148,6849,6769,152,6921,109
2021-11-12,Lassen,035,31185,6976,6897,392,7289,47
2021-11-12,Los Angeles,037,10098052,1454498,1443088,54451,1497539,26649
2021-11-12,Madera,039,155013,23822,23462,2179,25641,287
2021-11-12,Marin,041,260295,17798,17684,464,18148,247
2021-11-12,Mariposa,043,17540,1373,1323,51,1374,6
2021-11-12,Mendocino,045,87422,7789,7652,613,8265,89
2021-11-12,Merced,047,269075,42567,42411,1994,44405,644
2021-11-12,Modoc,049,8938,556,536,200,736,5
2021-11-12,Mono,051,14174,1766,1750,21,1771,4
2021-11-12,Monterey,053,433212,49197,48087,3007,51094,609
2021-11-12,Napa,055,140530,13188,13110,113,13223,103
2021-11-12,Nevada,057,99092,9483,9369,329,9698,92
2021-11-12,Orange,059,3164182,310656,308211,15412,323623,5641
2021-11-12,Placer,061,380077,37883,37453,3723,41176,445
2021-11-12,Plumas,063,18699,1879,1828,42,1870,8
2021-11-12,Riverside,065,2383286,368615,363801,16384,380185,5187
2021-11-12,Sacramento,067,1510023,161498,160397,4682,165079,2291
2021-11-12,San Benito,069,59416,7497,7491,170,7661,77
2021-11-12,San Bernardino,071,2135413,359405,356325,11290,367615,5873
2021-11-12,San Diego,073,3302833,379314,377633,22237,399870,4280
2021-11-12,San Francisco,075,870044,53809,53195,2330,55525,667
2021-11-12,San Joaquin,077,732212,101138,100263,5426,105689,1799
2021-11-12,San Luis Obispo,079,281455,30044,29589,1271,30860,351
2021-11-12,San Mateo,081,765935,54844,53853,899,54752,574
2021-11-12,Santa Barbara,083,443738,45085,44734,1555,46289,537
2021-11-12,Santa Clara,085,1922200,149227,147821,1396,149217,1905
2021-11-12,Santa Cruz,087,273765,20796,20565,1000,21565,223
2021-11-12,Shasta,089,179085,22019,21713,3625,25338,366
2021-11-12,Sierra,091,2930,192,188,21,209,0
2021-11-12,Siskiyou,093,43540,3383,3299,1306,4605,54
2021-11-12,Solano,095,438530,46452,45774,1282,47056,350
2021-11-12,Sonoma,097,501317,42160,41882,528,42410,399
2021-11-12,Stanislaus,099,539301,79783,79872,8921,88793,1174
2021-11-12,Sutter,101,95872,14019,14017,362,14379,181
2021-11-12,Tehama,103,63373,8691,8592,1494,10086,125
2021-11-12,Trinity,105,12862,870,749,212,961,17
2021-11-12,Tulare,107,460477,69826,68619,15280,83899,1033
2021-11-12,Tuolumne,109,53932,7475,7392,107,7499,90
2021-11-12,Ventura,111,848112,99168,98452,4298,102750,1183
2021-11-12,Yolo,113,214977,20193,20009,1075,21084,255
2021-11-12,Yuba,115,75493,10306,10218,349,10567,85
2021-11-11,Alameda,001,1643700,120861,120147,2779,122926,1453
2021-11-11,Alpine,003,1148,102,105,0,105,0
2021-11-11,Amador,005,37829,5637,5603,62,5665,66
2021-11-11,Butte,007,227075,21359,21047,3882,24929,293
2021-11-11,Calaveras,009,45235,4223,4179,58,4237,83
2021-11-11,Colusa,011,21464,2553,2518,644,3162,19
2021-11-11,Contra Costa,013,1133247,100530,99808,2211,102019,1028
2021-11-11,Del Norte,015,27424,3712,3622,54,3676,42
2021-11-11,El Dorado,017,186661,16369,16085,1732,17817,159
2021-11-11,Fresno,019,978130,143137,140833,12808,153641,2202
2021-11-11,Glenn,021,27897,3544,3503,1020,4523,34
2021-11-11,Humboldt,023,135768,9276,9125,590,9715,115
2021-11-11,Imperial,025,180216,34288,33844,3256,37100,766
2021-11-11,Inyo,027,18085,2464,2428,38,2466,42
2021-11-11,Kern,029,883053,130057,128023,22816,150839,1709
2021-11-11,Kings,031,150075,32855,32318,1949,34267,345
2021-11-11,Lake,033,64148,6842,6745,152,6897,107
2021-11-11,Lassen,035,31185,6970,6875,392,7267,47
2021-11-11,Los Angeles,037,10098052,1453403,1440436,54393,1494829,26614
2021-11-11,Madera,039,155013,23774,23316,2171,25487,287
2021-11-11,Marin,041,260295,17788,17639,464,18103,247
2021-11-11,Mariposa,043,17540,1363,1317,51,1368,6
2021-11-11,Mendocino,045,87422,7774,7612,604,8216,89
2021-11-11,Merced,047,269075,42511,42292,1991,44283,643
2021-11-11,Modoc,049,8938,554,536,200,736,5
2021-11-11,Mono,051,14174,1762,1743,21,1764,4
2021-11-11,Monterey,053,433212,49162,48008,2995,51003,609
2021-11-11,Napa,055,140530,13180,13075,113,13188,103
2021-11-11,Nevada,057,99092,9461,9308,329,9637,92
2021-11-11,Orange,059,3164182,310382,307674,15375,323049,5633
2021-11-11,Placer,061,380077,37832,37333,3715,41048,440
2021-11-11,Plumas,063,18699,1875,1814,42,1856,7
2021-11-11,Riverside,065,2383286,368181,362930,16366,379296,5175
2021-11-11,Sacramento,067,1510023,161286,159962,4663,164625,2289
2021-11-11,San Benito,069,59416,7489,7473,170,7643,76
2021-11-11,San Bernardino,071,2135413,358975,355413,11277,366690,5849
2021-11-11,San Diego,073,3302833,378805,376428,22214,398642,4272
2021-11-11,San Francisco,075,870044,53750,53063,2329,55392,666
2021-11-11,San Joaquin,077,732212,101043,99937,5411,105348,1799
2021-11-11,San Luis Obispo,079,281455,29993,29532,1269,30801,351
2021-11-11,San Mateo,081,765935,54795,53722,894,54616,574
2021-11-11,Santa Barbara,083,443738,45028,44603,1552,46155,534
2021-11-11,Santa Clara,085,1922200,149045,147458,1390,148848,1901
2021-11-11,Santa Cruz,087,273765,20751,20479,1000,21479,222
2021-11-11,Shasta,089,179085,21972,21600,3623,25223,364
2021-11-11,Sierra,091,2930,191,186,21,207,0
2021-11-11,Siskiyou,093,43540,3377,3297,1305,4602,53
2021-11-11,Solano,095,438530,46415,45679,1281,46960,350
2021-11-11,Sonoma,097,501317,42123,41774,528,42302,395
2021-11-11,Stanislaus,099,539301,79701,79570,8905,88475,1166
2021-11-11,Sutter,101,95872,14005,13993,361,14354,181
2021-11-11,Tehama,103,63373,8679,8565,1492,10057,125
2021-11-11,Trinity,105,12862,869,748,212,960,17
2021-11-11,Tulare,107,460477,69733,68367,15244,83611,1028
2021-11-11,Tuolumne,109,53932,7462,7354,107,7461,90
2021-11-11,Ventura,111,848112,99090,98297,4291,102588,1182
2021-11-11,Yolo,113,214977,20166,19946,1073,21019,255
2021-11-11,Yuba,115,75493,10290,10191,349,10540,85
2021-11-10,Alameda,001,1643700,120752,120147,2770,122917,1453
2021-11-10,Alpine,003,1148,102,105,0,105,0
2021-11-10,Amador,005,37829,5631,5603,62,5665,66
2021-11-10,Butte,007,227075,21333,21047,3878,24925,293
2021-11-10,Calaveras,009,45235,4212,4179,58,4237,83
2021-11-10,Colusa,011,21464,2547,2518,644,3162,19
2021-11-10,Contra Costa,013,1133247,100447,99808,2207,102015,1028
2021-11-10,Del Norte,015,27424,3711,3622,54,3676,42
2021-11-10,El Dorado,017,186661,16353,16085,1731,17816,159
2021-11-10,Fresno,019,978130,142959,140833,12795,153628,2202
2021-11-10,Glenn,021,27897,3544,3503,1019,4522,34
2021-11-10,Humboldt,023,135768,9258,9125,590,9715,115
2021-11-10,Imperial,025,180216,34240,33844,3237,37081,766
2021-11-10,Inyo,027,18085,2457,2428,38,2466,42
2021-11-10,Kern,029,883053,129907,128023,22761,150784,1709
2021-11-10,Kings,031,150075,32822,32318,1947,34265,345
2021-11-10,Lake,033,64148,6832,6745,152,6897,107
2021-11-10,Lassen,035,31185,6965,6875,392,7267,47
2021-11-10,Los Angeles,037,10098052,1452454,1440436,54335,1494771,26614
2021-11-10,Madera,039,155013,23724,23316,2165,25481,287
2021-11-10,Marin,041,260295,17775,17639,462,18101,247
2021-11-10,Mariposa,043,17540,1357,1317,51,1368,6
2021-11-10,Mendocino,045,87422,7762,7612,603,8215,89
2021-11-10,Merced,047,269075,42476,42292,1989,44281,643
2021-11-10,Modoc,049,8938,553,536,199,735,5
2021-11-10,Mono,051,14174,1760,1743,21,1764,4
2021-11-10,Monterey,053,433212,49128,48008,2984,50992,609
2021-11-10,Napa,055,140530,13166,13075,112,13187,103
2021-11-10,Nevada,057,99092,9454,9308,327,9635,92
2021-11-10,Orange,059,3164182,310119,307674,15343,323017,5633
2021-11-10,Placer,061,380077,37786,37333,3708,41041,440
2021-11-10,Plumas,063,18699,1869,1814,41,1855,7
2021-11-10,Riverside,065,2383286,367800,362930,16360,379290,5175
2021-11-10,Sacramento,067,1510023,161131,159962,4653,164615,2289
2021-11-10,San Benito,069,59416,7481,7473,170,7643,76
2021-11-10,San Bernardino,071,2135413,358635,355413,11270,366683,5849
2021-11-10,San Diego,073,3302833,378401,376428,22192,398620,4272
2021-11-10,San Francisco,075,870044,53689,53063,2326,55389,666
2021-11-10,San Joaquin,077,732212,100937,99937,5406,105343,1799
2021-11-10,San Luis Obispo,079,281455,29962,29532,1268,30800,351
2021-11-10,San Mateo,081,765935,54742,53722,893,54615,574
2021-11-10,Santa Barbara,083,443738,44990,44603,1551,46154,534
2021-11-10,Santa Clara,085,1922200,148898,147458,1384,148842,1901
2021-11-10,Santa Cruz,087,273765,20724,20479,999,21478,222
2021-11-10,Shasta,089,179085,21936,21600,3621,25221,364
2021-11-10,Sierra,091,2930,190,186,21,207,0
2021-11-10,Siskiyou,093,43540,3375,3297,1305,4602,53
2021-11-10,Solano,095,438530,46385,45679,1279,46958,350
2021-11-10,Sonoma,097,501317,42072,41774,528,42302,395
2021-11-10,Stanislaus,099,539301,79599,79570,8889,88459,1166
2021-11-10,Sutter,101,95872,13997,13993,361,14354,181
2021-11-10,Tehama,103,63373,8667,8565,1486,10051,125
2021-11-10,Trinity,105,12862,865,748,211,959,17
2021-11-10,Tulare,107,460477,69673,68367,15205,83572,1028
2021-11-10,Tuolumne,109,53932,7438,7354,107,7461,90
2021-11-10,Ventura,111,848112,99019,98297,4291,102588,1182
2021-11-10,Yolo,113,214977,20147,19946,1072,21018,255
2021-11-10,Yuba,115,75493,10281,10191,349,10540,85
2021-11-09,Alameda,001,1643700,120615,120051,2761,122812,1450
2021-11-09,Alpine,003,1148,102,105,0,105,0
2021-11-09,Amador,005,37829,5625,5596,62,5658,66
2021-11-09,Butte,007,227075,21310,21022,3874,24896,291
2021-11-09,Calaveras,009,45235,4208,4174,58,4232,84
2021-11-09,Colusa,011,21464,2542,2517,643,3160,19
2021-11-09,Contra Costa,013,1133247,100352,99732,2199,101931,1028
2021-11-09,Del Norte,015,27424,3710,3620,54,3674,42
2021-11-09,El Dorado,017,186661,16315,16073,1726,17799,160
2021-11-09,Fresno,019,978130,142713,140666,12780,153446,2188
2021-11-09,Glenn,021,27897,3539,3499,1018,4517,34
2021-11-09,Humboldt,023,135768,9237,9112,585,9697,115
2021-11-09,Imperial,025,180216,34187,33751,3223,36974,766
2021-11-09,Inyo,027,18085,2453,2404,38,2442,42
2021-11-09,Kern,029,883053,129661,127901,22699,150600,1694
2021-11-09,Kings,031,150075,32755,32279,1943,34222,344
2021-11-09,Lake,033,64148,6823,6743,152,6895,106
2021-11-09,Lassen,035,31185,6953,6846,392,7238,47
2021-11-09,Los Angeles,037,10098052,1451192,1439125,54273,1493398,26581
2021-11-09,Madera,039,155013,23674,23285,2156,25441,287
2021-11-09,Marin,041,260295,17756,17630,460,18090,247
2021-11-09,Mariposa,043,17540,1349,1317,51,1368,5
2021-11-09,Mendocino,045,87422,7739,7598,597,8195,85
2021-11-09,Merced,047,269075,42435,42251,1983,44234,613
2021-11-09,Modoc,049,8938,552,536,197,733,5
2021-11-09,Mono,051,14174,1755,1738,21,1759,4
2021-11-09,Monterey,053,433212,49092,47975,2960,50935,609
2021-11-09,Napa,055,140530,13148,13051,112,13163,103
2021-11-09,Nevada,057,99092,9435,9288,327,9615,92
2021-11-09,Orange,059,3164182,309835,307412,15316,322728,5621
2021-11-09,Placer,061,380077,37731,37291,3691,40982,440
2021-11-09,Plumas,063,18699,1867,1802,41,1843,7
2021-11-09,Riverside,065,2383286,367334,362557,16346,378903,5160
2021-11-09,Sacramento,067,1510023,160889,159856,4644,164500,2286
2021-11-09,San Benito,069,59416,7471,7471,169,7640,76
2021-11-09,San Bernardino,071,2135413,358187,354972,11253,366225,5839
2021-11-09,San Diego,073,3302833,377906,375997,22166,398163,4272
2021-11-09,San Francisco,075,870044,53615,52996,2320,55316,666
2021-11-09,San Joaquin,077,732212,100763,99848,5393,105241,1794
2021-11-09,San Luis Obispo,079,281455,29920,29488,1267,30755,350
2021-11-09,San Mateo,081,765935,54695,53697,884,54581,574
2021-11-09,Santa Barbara,083,443738,44923,44579,1544,46123,533
2021-11-09,Santa Clara,085,1922200,148692,147281,1377,148658,1901
2021-11-09,Santa Cruz,087,273765,20690,20463,998,21461,222
2021-11-09,Shasta,089,179085,21881,21558,3616,25174,364
2021-11-09,Sierra,091,2930,190,186,21,207,0
2021-11-09,Siskiyou,093,43540,3373,3295,1303,4598,52
2021-11-09,Solano,095,438530,46330,45639,1278,46917,350
2021-11-09,Sonoma,097,501317,42015,41727,526,42253,395
2021-11-09,Stanislaus,099,539301,79493,79505,8872,88377,1165
2021-11-09,Sutter,101,95872,13982,13988,359,14347,180
2021-11-09,Tehama,103,63373,8649,8555,1484,10039,125
2021-11-09,Trinity,105,12862,864,746,211,957,17
2021-11-09,Tulare,107,460477,69567,68298,15165,83463,1024
2021-11-09,Tuolumne,109,53932,7418,7347,107,7454,90
2021-11-09,Ventura,111,848112,98941,98202,4286,102488,1182
2021-11-09,Yolo,113,214977,20123,19931,1068,20999,255
2021-11-09,Yuba,115,75493,10264,10175,343,10518,85
2021-11-08,Alameda,001,1643700,120472,119983,2755,122738,1447
2021-11-08,Alpine,003,1148,102,105,0,105,0
2021-11-08,Amador,005,37829,5619,5590,62,5652,66
2021-11-08,Butte,007,227075,21282,21000,3865,24865,288
2021-11-08,Calaveras,009,45235,4200,4166,58,4224,82
2021-11-08,Colusa,011,21464,2541,2514,642,3156,19
2021-11-08,Contra Costa,013,1133247,100248,99669,2195,101864,1028
2021-11-08,Del Norte,015,27424,3706,3619,54,3673,42
2021-11-08,El Dorado,017,186661,16296,16055,1721,17776,156
2021-11-08,Fresno,019,978130,142412,140466,12758,153224,2179
2021-11-08,Glenn,021,27897,3537,3496,1014,4510,34
2021-11-08,Humboldt,023,135768,9210,9095,575,9670,109
2021-11-08,Imperial,025,180216,34107,33690,3205,36895,766
2021-11-08,Inyo,027,18085,2446,2398,38,2436,41
2021-11-08,Kern,029,883053,129425,127722,22616,150338,1692
2021-11-08,Kings,031,150075,32709,32248,1942,34190,344
2021-11-08,Lake,033,64148,6817,6737,152,6889,106
2021-11-08,Lassen,035,31185,6946,6830,390,7220,46
2021-11-08,Los Angeles,037,10098052,1449848,1438322,54215,1492537,26575
2021-11-08,Madera,039,155013,23625,23253,2145,25398,287
2021-11-08,Marin,041,260295,17739,17617,457,18074,247
2021-11-08,Mariposa,043,17540,1341,1316,50,1366,5
2021-11-08,Mendocino,045,87422,7726,7581,591,8172,85
2021-11-08,Merced,047,269075,42365,42224,1973,44197,607
2021-11-08,Modoc,049,8938,551,529,197,726,5
2021-11-08,Mono,051,14174,1751,1739,21,1760,4
2021-11-08,Monterey,053,433212,49051,47942,2940,50882,602
2021-11-08,Napa,055,140530,13134,13045,112,13157,103
2021-11-08,Nevada,057,99092,9416,9278,325,9603,92
2021-11-08,Orange,059,3164182,309563,307156,15285,322441,5616
2021-11-08,Placer,061,380077,37677,37250,3688,40938,439
2021-11-08,Plumas,063,18699,1866,1788,40,1828,7
2021-11-08,Riverside,065,2383286,366879,362201,16332,378533,5152
2021-11-08,Sacramento,067,1510023,160673,159735,4624,164359,2275
2021-11-08,San Benito,069,59416,7469,7461,169,7630,75
2021-11-08,San Bernardino,071,2135413,357675,354741,11235,365976,5836
2021-11-08,San Diego,073,3302833,377344,375557,22119,397676,4259
2021-11-08,San Francisco,075,870044,53562,52942,2314,55256,666
2021-11-08,San Joaquin,077,732212,100647,99736,5391,105127,1794
2021-11-08,San Luis Obispo,079,281455,29868,29464,1262,30726,350
2021-11-08,San Mateo,081,765935,54622,53658,879,54537,574
2021-11-08,Santa Barbara,083,443738,44869,44548,1543,46091,532
2021-11-08,Santa Clara,085,1922200,148466,147183,1371,148554,1899
2021-11-08,Santa Cruz,087,273765,20661,20435,998,21433,222
2021-11-08,Shasta,089,179085,21834,21504,3610,25114,354
2021-11-08,Sierra,091,2930,190,183,21,204,0
2021-11-08,Siskiyou,093,43540,3369,3290,1292,4582,50
2021-11-08,Solano,095,438530,46289,45613,1274,46887,350
2021-11-08,Sonoma,097,501317,41947,41669,525,42194,395
2021-11-08,Stanislaus,099,539301,79341,79417,8858,88275,1150
2021-11-08,Sutter,101,95872,13974,13976,355,14331,180
2021-11-08,Tehama,103,63373,8640,8534,1484,10018,123
2021-11-08,Trinity,105,12862,864,743,210,953,13
2021-11-08,Tulare,107,460477,69450,68199,15127,83326,1020
2021-11-08,Tuolumne,109,53932,7399,7328,106,7434,90
2021-11-08,Ventura,111,848112,98848,98144,4284,102428,1182
2021-11-08,Yolo,113,214977,20085,19916,1063,20979,255
2021-11-08,Yuba,115,75493,10253,10172,340,10512,83
2021-11-07,Alameda,001,1643700,120315,119902,2749,122651,1444
2021-11-07,Alpine,003,1148,102,105,0,105,0
2021-11-07,Amador,005,37829,5611,5580,60,5640,66
2021-11-07,Butte,007,227075,21241,20969,3856,24825,288
2021-11-07,Calaveras,009,45235,4173,4158,57,4215,82
2021-11-07,Colusa,011,21464,2535,2511,640,3151,19
2021-11-07,Contra Costa,013,1133247,100137,99596,2186,101782,1028
2021-11-07,Del Norte,015,27424,3704,3617,54,3671,42
2021-11-07,El Dorado,017,186661,16259,16040,1718,17758,156
2021-11-07,Fresno,019,978130,142070,140263,12731,152994,2179
2021-11-07,Glenn,021,27897,3530,3493,1013,4506,34
2021-11-07,Humboldt,023,135768,9185,9074,571,9645,109
2021-11-07,Imperial,025,180216,34034,33674,3186,36860,766
2021-11-07,Inyo,027,18085,2433,2394,38,2432,41
2021-11-07,Kern,029,883053,129153,127583,22525,150108,1692
2021-11-07,Kings,031,150075,32618,32221,1939,34160,343
2021-11-07,Lake,033,64148,6801,6734,151,6885,106
2021-11-07,Lassen,035,31185,6938,6819,386,7205,46
2021-11-07,Los Angeles,037,10098052,1448354,1437314,54140,1491454,26573
2021-11-07,Madera,039,155013,23580,23225,2137,25362,287
2021-11-07,Marin,041,260295,17719,17594,456,18050,247
2021-11-07,Mariposa,043,17540,1339,1306,50,1356,5
2021-11-07,Mendocino,045,87422,7698,7567,587,8154,85
2021-11-07,Merced,047,269075,42287,42186,1942,44128,607
2021-11-07,Modoc,049,8938,548,528,196,724,5
2021-11-07,Mono,051,14174,1745,1739,21,1760,4
2021-11-07,Monterey,053,433212,48999,47924,2936,50860,602
2021-11-07,Napa,055,140530,13113,13041,112,13153,103
2021-11-07,Nevada,057,99092,9368,9254,325,9579,92
2021-11-07,Orange,059,3164182,309239,306954,15247,322201,5616
2021-11-07,Placer,061,380077,37601,37202,3673,40875,439
2021-11-07,Plumas,063,18699,1859,1787,39,1826,7
2021-11-07,Riverside,065,2383286,366342,361960,16312,378272,5152
2021-11-07,Sacramento,067,1510023,160441,159549,4607,164156,2277
2021-11-07,San Benito,069,59416,7456,7460,169,7629,75
2021-11-07,San Bernardino,071,2135413,357166,354488,11212,365700,5832
2021-11-07,San Diego,073,3302833,376763,375165,22086,397251,4250
2021-11-07,San Francisco,075,870044,53478,52868,2308,55176,666
2021-11-07,San Joaquin,077,732212,100462,99696,5385,105081,1794
2021-11-07,San Luis Obispo,079,281455,29818,29454,1258,30712,350
2021-11-07,San Mateo,081,765935,54563,53600,877,54477,574
2021-11-07,Santa Barbara,083,443738,44806,44501,1542,46043,532
2021-11-07,Santa Clara,085,1922200,148262,147054,1358,148412,1898
2021-11-07,Santa Cruz,087,273765,20603,20397,997,21394,222
2021-11-07,Shasta,089,179085,21786,21479,3604,25083,354
2021-11-07,Sierra,091,2930,188,183,21,204,0
2021-11-07,Siskiyou,093,43540,3363,3289,1290,4579,51
2021-11-07,Solano,095,438530,46234,45582,1267,46849,350
2021-11-07,Sonoma,097,501317,41897,41630,524,42154,395
2021-11-07,Stanislaus,099,539301,79186,79351,8836,88187,1150
2021-11-07,Sutter,101,95872,13961,13964,352,14316,180
2021-11-07,Tehama,103,63373,8615,8528,1482,10010,121
2021-11-07,Trinity,105,12862,863,742,209,951,13
2021-11-07,Tulare,107,460477,69297,68145,15085,83230,1020
2021-11-07,Tuolumne,109,53932,7381,7300,104,7404,90
2021-11-07,Ventura,111,848112,98757,98085,4282,102367,1182
2021-11-07,Yolo,113,214977,20065,19899,1058,20957,255
2021-11-07,Yuba,115,75493,10236,10162,335,10497,83
2021-11-06,Alameda,001,1643700,120251,119499,2746,122245,1436
2021-11-06,Alpine,003,1148,102,105,0,105,0
2021-11-06,Amador,005,37829,5605,5557,60,5617,66
2021-11-06,Butte,007,227075,21221,20796,3852,24648,288
2021-11-06,Calaveras,009,45235,4165,4105,57,4162,82
2021-11-06,Colusa,011,21464,2534,2501,639,3140,19
2021-11-06,Contra Costa,013,1133247,100082,99282,2184,101466,1025
2021-11-06,Del Norte,015,27424,3701,3607,54,3661,42
2021-11-06,El Dorado,017,186661,16242,15958,1718,17676,156
2021-11-06,Fresno,019,978130,141952,139249,12726,151975,2170
2021-11-06,Glenn,021,27897,3527,3479,1013,4492,33
2021-11-06,Humboldt,023,135768,9173,8972,567,9539,109
2021-11-06,Imperial,025,180216,33990,33471,3180,36651,766
2021-11-06,Inyo,027,18085,2427,2353,38,2391,41
2021-11-06,Kern,029,883053,129019,126848,22473,149321,1684
2021-11-06,Kings,031,150075,32585,32018,1934,33952,342
2021-11-06,Lake,033,64148,6799,6695,151,6846,106
2021-11-06,Lassen,035,31185,6933,6796,385,7181,46
2021-11-06,Los Angeles,037,10098052,1447583,1433081,54097,1487178,26533
2021-11-06,Madera,039,155013,23544,22994,2127,25121,287
2021-11-06,Marin,041,260295,17700,17520,453,17973,247
2021-11-06,Mariposa,043,17540,1337,1282,50,1332,5
2021-11-06,Mendocino,045,87422,7676,7486,587,8073,85
2021-11-06,Merced,047,269075,42263,41958,1934,43892,604
2021-11-06,Modoc,049,8938,547,523,196,719,5
2021-11-06,Mono,051,14174,1743,1725,21,1746,4
2021-11-06,Monterey,053,433212,48967,47830,2926,50756,602
2021-11-06,Napa,055,140530,13103,12950,112,13062,103
2021-11-06,Nevada,057,99092,9346,9169,324,9493,91
2021-11-06,Orange,059,3164182,309032,306049,15221,321270,5611
2021-11-06,Placer,061,380077,37560,36967,3670,40637,438
2021-11-06,Plumas,063,18699,1855,1755,38,1793,7
2021-11-06,Riverside,065,2383286,366024,360584,16304,376888,5138
2021-11-06,Sacramento,067,1510023,160348,158766,4602,163368,2263
2021-11-06,San Benito,069,59416,7449,7429,169,7598,75
2021-11-06,San Bernardino,071,2135413,356897,353142,11208,364350,5813
2021-11-06,San Diego,073,3302833,376427,373423,22068,395491,4246
2021-11-06,San Francisco,075,870044,53425,52556,2305,54861,666
2021-11-06,San Joaquin,077,732212,100404,99372,5384,104756,1782
2021-11-06,San Luis Obispo,079,281455,29790,29335,1254,30589,350
2021-11-06,San Mateo,081,765935,54528,53442,876,54318,574
2021-11-06,Santa Barbara,083,443738,44770,44301,1541,45842,532
2021-11-06,Santa Clara,085,1922200,148117,146519,1353,147872,1894
2021-11-06,Santa Cruz,087,273765,20584,20311,995,21306,222
2021-11-06,Shasta,089,179085,21767,21281,3599,24880,349
2021-11-06,Sierra,091,2930,188,181,21,202,0
2021-11-06,Siskiyou,093,43540,3363,3279,1288,4567,48
2021-11-06,Solano,095,438530,46204,45465,1266,46731,350
2021-11-06,Sonoma,097,501317,41847,41398,523,41921,395
2021-11-06,Stanislaus,099,539301,79118,78902,8828,87730,1193
2021-11-06,Sutter,101,95872,13957,13908,351,14259,180
2021-11-06,Tehama,103,63373,8604,8474,1480,9954,120
2021-11-06,Trinity,105,12862,860,732,209,941,11
2021-11-06,Tulare,107,460477,69247,67767,15056,82823,1010
2021-11-06,Tuolumne,109,53932,7369,7245,104,7349,90
2021-11-06,Ventura,111,848112,98690,97770,4277,102047,1180
2021-11-06,Yolo,113,214977,20048,19827,1054,20881,255
2021-11-06,Yuba,115,75493,10222,10107,335,10442,83
2021-11-05,Alameda,001,1643700,120167,119499,2744,122243,1436
2021-11-05,Alpine,003,1148,102,105,0,105,0
2021-11-05,Amador,005,37829,5600,5557,60,5617,66
2021-11-05,Butte,007,227075,21208,20796,3851,24647,288
2021-11-05,Calaveras,009,45235,4160,4105,57,4162,82
2021-11-05,Colusa,011,21464,2534,2501,638,3139,19
2021-11-05,Contra Costa,013,1133247,100017,99282,2182,101464,1025
2021-11-05,Del Norte,015,27424,3699,3607,54,3661,42
2021-11-05,El Dorado,017,186661,16225,15958,1712,17670,156
2021-11-05,Fresno,019,978130,141774,139249,12716,151965,2170
2021-11-05,Glenn,021,27897,3527,3479,1012,4491,33
2021-11-05,Humboldt,023,135768,9159,8972,567,9539,109
2021-11-05,Imperial,025,180216,33954,33471,3177,36648,766
2021-11-05,Inyo,027,18085,2419,2353,38,2391,41
2021-11-05,Kern,029,883053,128892,126848,22418,149266,1684
2021-11-05,Kings,031,150075,32561,32018,1933,33951,342
2021-11-05,Lake,033,64148,6793,6695,151,6846,106
2021-11-05,Lassen,035,31185,6929,6796,384,7180,46
2021-11-05,Los Angeles,037,10098052,1446761,1433081,54059,1487140,26533
2021-11-05,Madera,039,155013,23506,22994,2126,25120,287
2021-11-05,Marin,041,260295,17678,17520,452,17972,247
2021-11-05,Mariposa,043,17540,1334,1282,49,1331,5
2021-11-05,Mendocino,045,87422,7665,7486,586,8072,85
2021-11-05,Merced,047,269075,42237,41958,1925,43883,604
2021-11-05,Modoc,049,8938,547,523,196,719,5
2021-11-05,Mono,051,14174,1742,1725,21,1746,4
2021-11-05,Monterey,053,433212,48937,47830,2924,50754,602
2021-11-05,Napa,055,140530,13081,12950,112,13062,103
2021-11-05,Nevada,057,99092,9333,9169,324,9493,91
2021-11-05,Orange,059,3164182,308835,306049,15199,321248,5611
2021-11-05,Placer,061,380077,37533,36967,3661,40628,438
2021-11-05,Plumas,063,18699,1847,1755,38,1793,7
2021-11-05,Riverside,065,2383286,365683,360584,16294,376878,5138
2021-11-05,Sacramento,067,1510023,160226,158766,4596,163362,2263
2021-11-05,San Benito,069,59416,7447,7429,168,7597,75
2021-11-05,San Bernardino,071,2135413,356567,353142,11198,364340,5813
2021-11-05,San Diego,073,3302833,376074,373423,22056,395479,4246
2021-11-05,San Francisco,075,870044,53374,52556,2302,54858,666
2021-11-05,San Joaquin,077,732212,100351,99372,5375,104747,1782
2021-11-05,San Luis Obispo,079,281455,29767,29335,1254,30589,350
2021-11-05,San Mateo,081,765935,54486,53442,874,54316,574
2021-11-05,Santa Barbara,083,443738,44725,44301,1540,45841,532
2021-11-05,Santa Clara,085,1922200,147980,146519,1352,147871,1894
2021-11-05,Santa Cruz,087,273765,20560,20311,994,21305,222
2021-11-05,Shasta,089,179085,21735,21281,3594,24875,349
2021-11-05,Sierra,091,2930,188,181,21,202,0
2021-11-05,Siskiyou,093,43540,3358,3279,1287,4566,48
2021-11-05,Solano,095,438530,46159,45465,1264,46729,350
2021-11-05,Sonoma,097,501317,41807,41398,523,41921,395
2021-11-05,Stanislaus,099,539301,79060,78902,8816,87718,1193
2021-11-05,Sutter,101,95872,13949,13908,350,14258,180
2021-11-05,Tehama,103,63373,8597,8474,1479,9953,120
2021-11-05,Trinity,105,12862,860,732,209,941,11
2021-11-05,Tulare,107,460477,69175,67767,15019,82786,1010
2021-11-05,Tuolumne,109,53932,7352,7245,103,7348,90
2021-11-05,Ventura,111,848112,98650,97770,4274,102044,1180
2021-11-05,Yolo,113,214977,20037,19827,1053,20880,255
2021-11-05,Yuba,115,75493,10209,10107,333,10440,83
2021-11-04,Alameda,001,1643700,120051,119499,2738,122237,1436
2021-11-04,Alpine,003,1148,102,105,0,105,0
2021-11-04,Amador,005,37829,5592,5557,60,5617,66
2021-11-04,Butte,007,227075,21166,20796,3840,24636,288
2021-11-04,Calaveras,009,45235,4146,4105,55,4160,82
2021-11-04,Colusa,011,21464,2528,2501,637,3138,19
2021-11-04,Contra Costa,013,1133247,99926,99282,2177,101459,1025
2021-11-04,Del Norte,015,27424,3696,3607,54,3661,42
2021-11-04,El Dorado,017,186661,16199,15958,1708,17666,156
2021-11-04,Fresno,019,978130,141492,139249,12707,151956,2170
2021-11-04,Glenn,021,27897,3522,3479,1011,4490,33
2021-11-04,Humboldt,023,135768,9134,8972,564,9536,109
2021-11-04,Imperial,025,180216,33897,33471,3168,36639,766
2021-11-04,Inyo,027,18085,2411,2353,38,2391,41
2021-11-04,Kern,029,883053,128660,126848,22350,149198,1684
2021-11-04,Kings,031,150075,32482,32018,1924,33942,342
2021-11-04,Lake,033,64148,6783,6695,149,6844,106
2021-11-04,Lassen,035,31185,6919,6796,379,7175,46
2021-11-04,Los Angeles,037,10098052,1445442,1433081,53978,1487059,26533
2021-11-04,Madera,039,155013,23451,22994,2115,25109,287
2021-11-04,Marin,041,260295,17666,17520,450,17970,247
2021-11-04,Mariposa,043,17540,1327,1282,49,1331,5
2021-11-04,Mendocino,045,87422,7652,7486,580,8066,85
2021-11-04,Merced,047,269075,42183,41958,1921,43879,604
2021-11-04,Modoc,049,8938,546,523,196,719,5
2021-11-04,Mono,051,14174,1737,1725,21,1746,4
2021-11-04,Monterey,053,433212,48893,47830,2908,50738,602
2021-11-04,Napa,055,140530,13060,12950,112,13062,103
2021-11-04,Nevada,057,99092,9302,9169,323,9492,91
2021-11-04,Orange,059,3164182,308587,306049,15181,321230,5611
2021-11-04,Placer,061,380077,37461,36967,3652,40619,438
2021-11-04,Plumas,063,18699,1839,1755,34,1789,7
2021-11-04,Riverside,065,2383286,365285,360584,16285,376869,5138
2021-11-04,Sacramento,067,1510023,159992,158766,4576,163342,2263
2021-11-04,San Benito,069,59416,7441,7429,168,7597,75
2021-11-04,San Bernardino,071,2135413,356130,353142,11190,364332,5813
2021-11-04,San Diego,073,3302833,375605,373423,22035,395458,4246
2021-11-04,San Francisco,075,870044,53293,52556,2298,54854,666
2021-11-04,San Joaquin,077,732212,100244,99372,5363,104735,1782
2021-11-04,San Luis Obispo,079,281455,29743,29335,1248,30583,350
2021-11-04,San Mateo,081,765935,54427,53442,868,54310,574
2021-11-04,Santa Barbara,083,443738,44669,44301,1540,45841,532
2021-11-04,Santa Clara,085,1922200,147826,146519,1348,147867,1894
2021-11-04,Santa Cruz,087,273765,20525,20311,994,21305,222
2021-11-04,Shasta,089,179085,21677,21281,3588,24869,349
2021-11-04,Sierra,091,2930,186,181,21,202,0
2021-11-04,Siskiyou,093,43540,3354,3279,1280,4559,48
2021-11-04,Solano,095,438530,46117,45465,1263,46728,350
2021-11-04,Sonoma,097,501317,41747,41398,523,41921,395
2021-11-04,Stanislaus,099,539301,78922,78902,8808,87710,1193
2021-11-04,Sutter,101,95872,13938,13908,348,14256,180
2021-11-04,Tehama,103,63373,8588,8474,1475,9949,120
2021-11-04,Trinity,105,12862,859,732,209,941,11
2021-11-04,Tulare,107,460477,69060,67767,14973,82740,1010
2021-11-04,Tuolumne,109,53932,7330,7245,101,7346,90
2021-11-04,Ventura,111,848112,98562,97770,4271,102041,1180
2021-11-04,Yolo,113,214977,20012,19827,1048,20875,255
2021-11-04,Yuba,115,75493,10195,10107,331,10438,83
2021-11-03,Alameda,001,1643700,119910,119356,2734,122090,1428
2021-11-03,Alpine,003,1148,102,105,0,105,0
2021-11-03,Amador,005,37829,5586,5545,59,5604,66
2021-11-03,Butte,007,227075,21121,20769,3831,24600,284
2021-11-03,Calaveras,009,45235,4128,4087,54,4141,82
2021-11-03,Colusa,011,21464,2522,2499,637,3136,20
2021-11-03,Contra Costa,013,1133247,99827,99168,2172,101340,1025
2021-11-03,Del Norte,015,27424,3694,3600,53,3653,42
2021-11-03,El Dorado,017,186661,16172,15915,1704,17619,156
2021-11-03,Fresno,019,978130,141130,138873,12685,151558,2166
2021-11-03,Glenn,021,27897,3518,3470,1011,4481,33
2021-11-03,Humboldt,023,135768,9117,8949,559,9508,109
2021-11-03,Imperial,025,180216,33825,33402,3158,36560,766
2021-11-03,Inyo,027,18085,2390,2344,38,2382,41
2021-11-03,Kern,029,883053,128400,126523,22250,148773,1681
2021-11-03,Kings,031,150075,32428,31923,1917,33840,341
2021-11-03,Lake,033,64148,6767,6685,149,6834,106
2021-11-03,Lassen,035,31185,6902,6782,374,7156,46
2021-11-03,Los Angeles,037,10098052,1444088,1431209,53895,1485104,26517
2021-11-03,Madera,039,155013,23383,22893,2106,24999,287
2021-11-03,Marin,041,260295,17645,17491,446,17937,247
2021-11-03,Mariposa,043,17540,1317,1276,49,1325,5
2021-11-03,Mendocino,045,87422,7636,7457,572,8029,84
2021-11-03,Merced,047,269075,42122,41849,1911,43760,597
2021-11-03,Modoc,049,8938,546,521,194,715,5
2021-11-03,Mono,051,14174,1733,1719,21,1740,4
2021-11-03,Monterey,053,433212,48843,47794,2895,50689,601
2021-11-03,Napa,055,140530,13048,12937,111,13048,103
2021-11-03,Nevada,057,99092,9275,9131,322,9453,91
2021-11-03,Orange,059,3164182,308276,305661,15149,320810,5607
2021-11-03,Placer,061,380077,37391,36868,3647,40515,438
2021-11-03,Plumas,063,18699,1828,1739,33,1772,7
2021-11-03,Riverside,065,2383286,364827,360060,16281,376341,5131
2021-11-03,Sacramento,067,1510023,159768,158311,4566,162877,2259
2021-11-03,San Benito,069,59416,7433,7419,168,7587,75
2021-11-03,San Bernardino,071,2135413,355654,352225,11170,363395,5813
2021-11-03,San Diego,073,3302833,375105,372951,22012,394963,4241
2021-11-03,San Francisco,075,870044,53201,52493,2293,54786,663
2021-11-03,San Joaquin,077,732212,100132,99188,5353,104541,1776
2021-11-03,San Luis Obispo,079,281455,29701,29276,1242,30518,348
2021-11-03,San Mateo,081,765935,54363,53396,862,54258,571
2021-11-03,Santa Barbara,083,443738,44612,44220,1537,45757,531
2021-11-03,Santa Clara,085,1922200,147656,146259,1341,147600,1897
2021-11-03,Santa Cruz,087,273765,20490,20275,994,21269,222
2021-11-03,Shasta,089,179085,21619,21215,3581,24796,346
2021-11-03,Sierra,091,2930,184,180,21,201,0
2021-11-03,Siskiyou,093,43540,3350,3276,1278,4554,46
2021-11-03,Solano,095,438530,46090,45411,1261,46672,351
2021-11-03,Sonoma,097,501317,41670,41326,521,41847,395
2021-11-03,Stanislaus,099,539301,78791,78736,8792,87528,1193
2021-11-03,Sutter,101,95872,13925,13876,346,14222,179
2021-11-03,Tehama,103,63373,8576,8438,1475,9913,118
2021-11-03,Trinity,105,12862,858,730,209,939,11
2021-11-03,Tulare,107,460477,68932,67588,14932,82520,1007
2021-11-03,Tuolumne,109,53932,7312,7218,99,7317,90
2021-11-03,Ventura,111,848112,98454,97682,4267,101949,1178
2021-11-03,Yolo,113,214977,19994,19758,1040,20798,250
2021-11-03,Yuba,115,75493,10183,10092,331,10423,83
2021-11-02,Alameda,001,1643700,119765,119241,2728,121969,1425
2021-11-02,Alpine,003,1148,101,105,0,105,0
2021-11-02,Amador,005,37829,5581,5535,59,5594,66
2021-11-02,Butte,007,227075,21077,20744,3819,24563,282
2021-11-02,Calaveras,009,45235,4105,4075,54,4129,82
2021-11-02,Colusa,011,21464,2517,2497,636,3133,19
2021-11-02,Contra Costa,013,1133247,99723,99080,2160,101240,1025
2021-11-02,Del Norte,015,27424,3692,3596,53,3649,42
2021-11-02,El Dorado,017,186661,16143,15883,1704,17587,154
2021-11-02,Fresno,019,978130,140806,138644,12654,151298,2158
2021-11-02,Glenn,021,27897,3510,3469,1008,4477,33
2021-11-02,Humboldt,023,135768,9075,8937,558,9495,109
2021-11-02,Imperial,025,180216,33752,33371,3146,36517,766
2021-11-02,Inyo,027,18085,2383,2324,38,2362,41
2021-11-02,Kern,029,883053,128145,126311,22130,148441,1665
2021-11-02,Kings,031,150075,32369,31896,1912,33808,339
2021-11-02,Lake,033,64148,6762,6681,148,6829,106
2021-11-02,Lassen,035,31185,6890,6777,371,7148,45
2021-11-02,Los Angeles,037,10098052,1442642,1429601,53819,1483420,26496
2021-11-02,Madera,039,155013,23302,22837,2095,24932,287
2021-11-02,Marin,041,260295,17617,17482,446,17928,247
2021-11-02,Mariposa,043,17540,1306,1270,48,1318,5
2021-11-02,Mendocino,045,87422,7612,7447,560,8007,84
2021-11-02,Merced,047,269075,42055,41785,1903,43688,596
2021-11-02,Modoc,049,8938,543,520,193,713,5
2021-11-02,Mono,051,14174,1729,1718,21,1739,4
2021-11-02,Monterey,053,433212,48792,47775,2877,50652,599
2021-11-02,Napa,055,140530,13030,12930,111,13041,104
2021-11-02,Nevada,057,99092,9245,9122,321,9443,91
2021-11-02,Orange,059,3164182,307960,305369,15104,320473,5600
2021-11-02,Placer,061,380077,37319,36817,3632,40449,438
2021-11-02,Plumas,063,18699,1817,1721,33,1754,7
2021-11-02,Riverside,065,2383286,364373,359586,16262,375848,5116
2021-11-02,Sacramento,067,1510023,159512,158112,4544,162656,2250
2021-11-02,San Benito,069,59416,7417,7407,168,7575,75
2021-11-02,San Bernardino,071,2135413,355180,351832,11117,362949,5813
2021-11-02,San Diego,073,3302833,374520,372440,21982,394422,4232
2021-11-02,San Francisco,075,870044,53082,52450,2289,54739,663
2021-11-02,San Joaquin,077,732212,99998,99076,5342,104418,1772
2021-11-02,San Luis Obispo,079,281455,29668,29224,1238,30462,348
2021-11-02,San Mateo,081,765935,54291,53351,859,54210,571
2021-11-02,Santa Barbara,083,443738,44556,44177,1534,45711,531
2021-11-02,Santa Clara,085,1922200,147462,146115,1334,147449,1896
2021-11-02,Santa Cruz,087,273765,20457,20266,993,21259,222
2021-11-02,Shasta,089,179085,21545,21127,3571,24698,344
2021-11-02,Sierra,091,2930,184,180,20,200,0
2021-11-02,Siskiyou,093,43540,3348,3272,1275,4547,46
2021-11-02,Solano,095,438530,46050,45378,1255,46633,350
2021-11-02,Sonoma,097,501317,41589,41288,520,41808,395
2021-11-02,Stanislaus,099,539301,78636,78629,8772,87401,1193
2021-11-02,Sutter,101,95872,13905,13868,346,14214,179
2021-11-02,Tehama,103,63373,8560,8422,1472,9894,116
2021-11-02,Trinity,105,12862,858,729,209,938,11
2021-11-02,Tulare,107,460477,68807,67502,14884,82386,1002
2021-11-02,Tuolumne,109,53932,7291,7204,97,7301,90
2021-11-02,Ventura,111,848112,98349,97574,4263,101837,1178
2021-11-02,Yolo,113,214977,19964,19736,1038,20774,250
2021-11-02,Yuba,115,75493,10160,10080,329,10409,83
2021-11-01,Alameda,001,1643700,119626,119159,2725,121884,1421
2021-11-01,Alpine,003,1148,101,105,0,105,0
2021-11-01,Amador,005,37829,5579,5532,59,5591,64
2021-11-01,Butte,007,227075,21027,20710,3813,24523,281
2021-11-01,Calaveras,009,45235,4095,4059,53,4112,82
2021-11-01,Colusa,011,21464,2515,2494,633,3127,19
2021-11-01,Contra Costa,013,1133247,99599,99011,2152,101163,1025
2021-11-01,Del Norte,015,27424,3690,3594,53,3647,42
2021-11-01,El Dorado,017,186661,16119,15858,1699,17557,154
2021-11-01,Fresno,019,978130,140430,138421,12618,151039,2149
2021-11-01,Glenn,021,27897,3502,3461,1006,4467,33
2021-11-01,Humboldt,023,135768,9047,8929,555,9484,108
2021-11-01,Imperial,025,180216,33702,33342,3137,36479,766
2021-11-01,Inyo,027,18085,2371,2307,38,2345,41
2021-11-01,Kern,029,883053,127845,126092,22015,148107,1660
2021-11-01,Kings,031,150075,32316,31866,1908,33774,337
2021-11-01,Lake,033,64148,6751,6676,147,6823,106
2021-11-01,Lassen,035,31185,6875,6775,368,7143,42
2021-11-01,Los Angeles,037,10098052,1441259,1428891,53728,1482619,26483
2021-11-01,Madera,039,155013,23223,22801,2090,24891,283
2021-11-01,Marin,041,260295,17597,17460,445,17905,247
2021-11-01,Mariposa,043,17540,1298,1266,47,1313,5
2021-11-01,Mendocino,045,87422,7579,7422,542,7964,84
2021-11-01,Merced,047,269075,41964,41740,1901,43641,594
2021-11-01,Modoc,049,8938,538,520,191,711,5
2021-11-01,Mono,051,14174,1725,1714,21,1735,3
2021-11-01,Monterey,053,433212,48749,47756,2865,50621,597
2021-11-01,Napa,055,140530,13003,12916,110,13026,101
2021-11-01,Nevada,057,99092,9222,9108,320,9428,91
2021-11-01,Orange,059,3164182,307618,305192,15063,320255,5596
2021-11-01,Placer,061,380077,37236,36747,3620,40367,435
2021-11-01,Plumas,063,18699,1798,1719,33,1752,7
2021-11-01,Riverside,065,2383286,363871,359263,16240,375503,5115
2021-11-01,Sacramento,067,1510023,159240,157893,4521,162414,2239
2021-11-01,San Benito,069,59416,7407,7406,167,7573,73
2021-11-01,San Bernardino,071,2135413,354692,351620,11097,362717,5815
2021-11-01,San Diego,073,3302833,373955,372043,21964,394007,4232
2021-11-01,San Francisco,075,870044,52997,52418,2282,54700,661
2021-11-01,San Joaquin,077,732212,99835,98969,5335,104304,1772
2021-11-01,San Luis Obispo,079,281455,29624,29199,1233,30432,343
2021-11-01,San Mateo,081,765935,54224,53314,855,54169,571
2021-11-01,Santa Barbara,083,443738,44489,44146,1530,45676,529
2021-11-01,Santa Clara,085,1922200,147265,145978,1329,147307,1907
2021-11-01,Santa Cruz,087,273765,20422,20238,993,21231,221
2021-11-01,Shasta,089,179085,21492,21104,3564,24668,338
2021-11-01,Sierra,091,2930,184,180,20,200,0
2021-11-01,Siskiyou,093,43540,3341,3272,1270,4542,46
2021-11-01,Solano,095,438530,45996,45358,1255,46613,350
2021-11-01,Sonoma,097,501317,41516,41234,519,41753,395
2021-11-01,Stanislaus,099,539301,78506,78534,8757,87291,1193
2021-11-01,Sutter,101,95872,13881,13852,344,14196,179
2021-11-01,Tehama,103,63373,8532,8412,1469,9881,116
2021-11-01,Trinity,105,12862,856,727,209,936,11
2021-11-01,Tulare,107,460477,68664,67388,14832,82220,1002
2021-11-01,Tuolumne,109,53932,7275,7175,96,7271,90
2021-11-01,Ventura,111,848112,98259,97507,4261,101768,1178
2021-11-01,Yolo,113,214977,19944,19708,1031,20739,250
2021-11-01,Yuba,115,75493,10142,10066,327,10393,83
2021-10-31,Alameda,001,1643700,119481,119071,2722,121793,1419
2021-10-31,Alpine,003,1148,101,105,0,105,0
2021-10-31,Amador,005,37829,5568,5518,59,5577,64
2021-10-31,Butte,007,227075,20966,20689,3801,24490,281
2021-10-31,Calaveras,009,45235,4077,4052,52,4104,82
2021-10-31,Colusa,011,21464,2513,2493,630,3123,18
2021-10-31,Contra Costa,013,1133247,99471,98936,2150,101086,1025
2021-10-31,Del Norte,015,27424,3684,3591,53,3644,42
2021-10-31,El Dorado,017,186661,16073,15841,1696,17537,154
2021-10-31,Fresno,019,978130,140025,138165,12581,150746,2147
2021-10-31,Glenn,021,27897,3497,3459,1006,4465,33
2021-10-31,Humboldt,023,135768,8999,8919,549,9468,108
2021-10-31,Imperial,025,180216,33627,33334,3125,36459,766
2021-10-31,Inyo,027,18085,2352,2309,38,2347,41
2021-10-31,Kern,029,883053,127476,125917,21891,147808,1666
2021-10-31,Kings,031,150075,32230,31814,1896,33710,338
2021-10-31,Lake,033,64148,6740,6665,145,6810,106
2021-10-31,Lassen,035,31185,6860,6768,363,7131,42
2021-10-31,Los Angeles,037,10098052,1439708,1427933,53646,1481579,26474
2021-10-31,Madera,039,155013,23127,22744,2077,24821,283
2021-10-31,Marin,041,260295,17569,17443,444,17887,247
2021-10-31,Mariposa,043,17540,1292,1257,46,1303,5
2021-10-31,Mendocino,045,87422,7538,7403,525,7928,84
2021-10-31,Merced,047,269075,41871,41699,1881,43580,589
2021-10-31,Modoc,049,8938,532,517,188,705,5
2021-10-31,Mono,051,14174,1721,1711,21,1732,3
2021-10-31,Monterey,053,433212,48708,47744,2847,50591,596
2021-10-31,Napa,055,140530,12985,12906,108,13014,101
2021-10-31,Nevada,057,99092,9185,9084,315,9399,91
2021-10-31,Orange,059,3164182,307270,305032,14980,320012,5596
2021-10-31,Placer,061,380077,37139,36698,3607,40305,435
2021-10-31,Plumas,063,18699,1780,1716,33,1749,7
2021-10-31,Riverside,065,2383286,363292,359005,16226,375231,5104
2021-10-31,Sacramento,067,1510023,158888,157667,4508,162175,2243
2021-10-31,San Benito,069,59416,7398,7397,165,7562,73
2021-10-31,San Bernardino,071,2135413,354162,351411,11083,362494,5810
2021-10-31,San Diego,073,3302833,373402,371603,21933,393536,4218
2021-10-31,San Francisco,075,870044,52888,52370,2276,54646,661
2021-10-31,San Joaquin,077,732212,99672,98893,5320,104213,1772
2021-10-31,San Luis Obispo,079,281455,29571,29176,1232,30408,343
2021-10-31,San Mateo,081,765935,54165,53284,853,54137,571
2021-10-31,Santa Barbara,083,443738,44419,44113,1525,45638,529
2021-10-31,Santa Clara,085,1922200,147050,145829,1315,147144,1908
2021-10-31,Santa Cruz,087,273765,20387,20218,992,21210,221
2021-10-31,Shasta,089,179085,21409,21086,3552,24638,338
2021-10-31,Sierra,091,2930,184,180,20,200,0
2021-10-31,Siskiyou,093,43540,3335,3271,1269,4540,46
2021-10-31,Solano,095,438530,45948,45310,1248,46558,350
2021-10-31,Sonoma,097,501317,41446,41183,516,41699,395
2021-10-31,Stanislaus,099,539301,78317,78426,8740,87166,1193
2021-10-31,Sutter,101,95872,13862,13838,341,14179,179
2021-10-31,Tehama,103,63373,8501,8391,1465,9856,116
2021-10-31,Trinity,105,12862,856,724,209,933,11
2021-10-31,Tulare,107,460477,68469,67310,14744,82054,1002
2021-10-31,Tuolumne,109,53932,7246,7141,95,7236,90
2021-10-31,Ventura,111,848112,98137,97460,4256,101716,1178
2021-10-31,Yolo,113,214977,19900,19662,1025,20687,250
2021-10-31,Yuba,115,75493,10124,10051,317,10368,83
2021-10-30,Alameda,001,1643700,119421,118632,2719,121351,1419
2021-10-30,Alpine,003,1148,101,105,0,105,0
2021-10-30,Amador,005,37829,5559,5480,58,5538,64
2021-10-30,Butte,007,227075,20951,20516,3794,24310,277
2021-10-30,Calaveras,009,45235,4070,3992,52,4044,82
2021-10-30,Colusa,011,21464,2513,2484,629,3113,19
2021-10-30,Contra Costa,013,1133247,99409,98562,2149,100711,1024
2021-10-30,Del Norte,015,27424,3681,3574,53,3627,42
2021-10-30,El Dorado,017,186661,16057,15752,1692,17444,154
2021-10-30,Fresno,019,978130,139879,136901,12569,149470,2131
2021-10-30,Glenn,021,27897,3493,3442,1006,4448,33
2021-10-30,Humboldt,023,135768,8984,8871,547,9418,105
2021-10-30,Imperial,025,180216,33581,33156,3121,36277,766
2021-10-30,Inyo,027,18085,2349,2249,38,2287,41
2021-10-30,Kern,029,883053,127323,124892,21822,146714,1653
2021-10-30,Kings,031,150075,32196,31578,1892,33470,337
2021-10-30,Lake,033,64148,6735,6610,145,6755,106
2021-10-30,Lassen,035,31185,6854,6719,361,7080,42
2021-10-30,Los Angeles,037,10098052,1438986,1424257,53593,1477850,26625
2021-10-30,Madera,039,155013,23083,22524,2072,24596,283
2021-10-30,Marin,041,260295,17554,17380,442,17822,247
2021-10-30,Mariposa,043,17540,1289,1228,46,1274,5
2021-10-30,Mendocino,045,87422,7515,7338,523,7861,84
2021-10-30,Merced,047,269075,41831,41428,1879,43307,586
2021-10-30,Modoc,049,8938,530,513,187,700,5
2021-10-30,Mono,051,14174,1721,1684,21,1705,3
2021-10-30,Monterey,053,433212,48691,47649,2841,50490,588
2021-10-30,Napa,055,140530,12971,12863,107,12970,101
2021-10-30,Nevada,057,99092,9166,9015,315,9330,91
2021-10-30,Orange,059,3164182,307091,304120,14958,319078,5588
2021-10-30,Placer,061,380077,37093,36400,3601,40001,434
2021-10-30,Plumas,063,18699,1775,1695,33,1728,7
2021-10-30,Riverside,065,2383286,362990,357645,16218,373863,5088
2021-10-30,Sacramento,067,1510023,158730,157125,4499,161624,2233
2021-10-30,San Benito,069,59416,7391,7362,165,7527,71
2021-10-30,San Bernardino,071,2135413,353886,350076,11069,361145,5777
2021-10-30,San Diego,073,3302833,373039,370006,21911,391917,4213
2021-10-30,San Francisco,075,870044,52859,52161,2274,54435,661
2021-10-30,San Joaquin,077,732212,99616,98314,5319,103633,1768
2021-10-30,San Luis Obispo,079,281455,29539,29053,1229,30282,341
2021-10-30,San Mateo,081,765935,54126,53083,853,53936,571
2021-10-30,Santa Barbara,083,443738,44384,43972,1524,45496,528
2021-10-30,Santa Clara,085,1922200,146945,145262,1311,146573,1903
2021-10-30,Santa Cruz,087,273765,20369,20134,990,21124,221
2021-10-30,Shasta,089,179085,21365,20878,3546,24424,332
2021-10-30,Sierra,091,2930,184,175,20,195,0
2021-10-30,Siskiyou,093,43540,3334,3257,1266,4523,46
2021-10-30,Solano,095,438530,45927,45146,1246,46392,346
2021-10-30,Sonoma,097,501317,41407,40924,516,41440,393
2021-10-30,Stanislaus,099,539301,78247,77871,8733,86604,1191
2021-10-30,Sutter,101,95872,13848,13773,341,14114,178
2021-10-30,Tehama,103,63373,8490,8307,1460,9767,114
2021-10-30,Trinity,105,12862,854,708,208,916,11
2021-10-30,Tulare,107,460477,68398,66745,14700,81445,995
2021-10-30,Tuolumne,109,53932,7222,7050,94,7144,90
2021-10-30,Ventura,111,848112,98088,97182,4253,101435,1174
2021-10-30,Yolo,113,214977,19881,19568,1023,20591,250
2021-10-30,Yuba,115,75493,10113,9969,317,10286,82
2021-10-29,Alameda,001,1643700,119341,118632,2714,121346,1419
2021-10-29,Alpine,003,1148,101,105,0,105,0
2021-10-29,Amador,005,37829,5548,5480,58,5538,64
2021-10-29,Butte,007,227075,20927,20516,3783,24299,277
2021-10-29,Calaveras,009,45235,4063,3992,52,4044,82
2021-10-29,Colusa,011,21464,2513,2484,627,3111,19
2021-10-29,Contra Costa,013,1133247,99341,98562,2147,100709,1024
2021-10-29,Del Norte,015,27424,3674,3574,53,3627,42
2021-10-29,El Dorado,017,186661,16043,15752,1692,17444,154
2021-10-29,Fresno,019,978130,139665,136901,12555,149456,2131
2021-10-29,Glenn,021,27897,3492,3442,1005,4447,33
2021-10-29,Humboldt,023,135768,8979,8871,546,9417,105
2021-10-29,Imperial,025,180216,33554,33156,3118,36274,766
2021-10-29,Inyo,027,18085,2346,2249,38,2287,41
2021-10-29,Kern,029,883053,127146,124892,21732,146624,1653
2021-10-29,Kings,031,150075,32162,31578,1890,33468,337
2021-10-29,Lake,033,64148,6726,6610,142,6752,106
2021-10-29,Lassen,035,31185,6845,6719,358,7077,42
2021-10-29,Los Angeles,037,10098052,1438145,1424257,53549,1477806,26625
2021-10-29,Madera,039,155013,23031,22524,2067,24591,283
2021-10-29,Marin,041,260295,17538,17380,441,17821,247
2021-10-29,Mariposa,043,17540,1285,1228,46,1274,5
2021-10-29,Mendocino,045,87422,7507,7338,523,7861,84
2021-10-29,Merced,047,269075,41781,41428,1873,43301,586
2021-10-29,Modoc,049,8938,528,513,186,699,5
2021-10-29,Mono,051,14174,1719,1684,21,1705,3
2021-10-29,Monterey,053,433212,48668,47649,2841,50490,588
2021-10-29,Napa,055,140530,12950,12863,107,12970,101
2021-10-29,Nevada,057,99092,9154,9015,315,9330,91
2021-10-29,Orange,059,3164182,306867,304120,14938,319058,5588
2021-10-29,Placer,061,380077,37057,36400,3591,39991,434
2021-10-29,Plumas,063,18699,1769,1695,33,1728,7
2021-10-29,Riverside,065,2383286,362656,357645,16213,373858,5088
2021-10-29,Sacramento,067,1510023,158541,157125,4490,161615,2233
2021-10-29,San Benito,069,59416,7388,7362,165,7527,71
2021-10-29,San Bernardino,071,2135413,353586,350076,11058,361134,5777
2021-10-29,San Diego,073,3302833,372667,370006,21883,391889,4213
2021-10-29,San Francisco,075,870044,52799,52161,2268,54429,661
2021-10-29,San Joaquin,077,732212,99557,98314,5314,103628,1768
2021-10-29,San Luis Obispo,079,281455,29513,29053,1227,30280,341
2021-10-29,San Mateo,081,765935,54083,53083,851,53934,571
2021-10-29,Santa Barbara,083,443738,44344,43972,1521,45493,528
2021-10-29,Santa Clara,085,1922200,146831,145262,1304,146566,1903
2021-10-29,Santa Cruz,087,273765,20362,20134,989,21123,221
2021-10-29,Shasta,089,179085,21327,20878,3540,24418,332
2021-10-29,Sierra,091,2930,182,175,20,195,0
2021-10-29,Siskiyou,093,43540,3334,3257,1265,4522,46
2021-10-29,Solano,095,438530,45890,45146,1245,46391,346
2021-10-29,Sonoma,097,501317,41386,40924,516,41440,393
2021-10-29,Stanislaus,099,539301,78162,77871,8721,86592,1191
2021-10-29,Sutter,101,95872,13829,13773,341,14114,178
2021-10-29,Tehama,103,63373,8477,8307,1459,9766,114
2021-10-29,Trinity,105,12862,853,708,208,916,11
2021-10-29,Tulare,107,460477,68293,66745,14657,81402,995
2021-10-29,Tuolumne,109,53932,7209,7050,94,7144,90
2021-10-29,Ventura,111,848112,98033,97182,4249,101431,1174
2021-10-29,Yolo,113,214977,19862,19568,1018,20586,250
2021-10-29,Yuba,115,75493,10105,9969,313,10282,82
2021-10-28,Alameda,001,1643700,119220,118632,2707,121339,1419
2021-10-28,Alpine,003,1148,101,105,0,105,0
2021-10-28,Amador,005,37829,5535,5480,58,5538,64
2021-10-28,Butte,007,227075,20884,20516,3771,24287,277
2021-10-28,Calaveras,009,45235,4050,3992,52,4044,82
2021-10-28,Colusa,011,21464,2510,2484,626,3110,19
2021-10-28,Contra Costa,013,1133247,99211,98562,2143,100705,1024
2021-10-28,Del Norte,015,27424,3673,3574,53,3627,42
2021-10-28,El Dorado,017,186661,16017,15752,1689,17441,154
2021-10-28,Fresno,019,978130,139332,136901,12524,149425,2131
2021-10-28,Glenn,021,27897,3489,3442,1003,4445,33
2021-10-28,Humboldt,023,135768,8963,8871,541,9412,105
2021-10-28,Imperial,025,180216,33488,33156,3111,36267,766
2021-10-28,Inyo,027,18085,2329,2249,38,2287,41
2021-10-28,Kern,029,883053,126899,124892,21619,146511,1653
2021-10-28,Kings,031,150075,32093,31578,1885,33463,337
2021-10-28,Lake,033,64148,6716,6610,142,6752,106
2021-10-28,Lassen,035,31185,6835,6719,355,7074,42
2021-10-28,Los Angeles,037,10098052,1437007,1424257,53475,1477732,26625
2021-10-28,Madera,039,155013,22977,22524,2056,24580,283
2021-10-28,Marin,041,260295,17520,17380,440,17820,247
2021-10-28,Mariposa,043,17540,1281,1228,46,1274,5
2021-10-28,Mendocino,045,87422,7494,7338,512,7850,84
2021-10-28,Merced,047,269075,41696,41428,1863,43291,586
2021-10-28,Modoc,049,8938,527,513,186,699,5
2021-10-28,Mono,051,14174,1713,1684,21,1705,3
2021-10-28,Monterey,053,433212,48637,47649,2824,50473,588
2021-10-28,Napa,055,140530,12941,12863,106,12969,101
2021-10-28,Nevada,057,99092,9136,9015,315,9330,91
2021-10-28,Orange,059,3164182,306580,304120,14875,318995,5588
2021-10-28,Placer,061,380077,36978,36400,3582,39982,434
2021-10-28,Plumas,063,18699,1761,1695,33,1728,7
2021-10-28,Riverside,065,2383286,362218,357645,16190,373835,5088
2021-10-28,Sacramento,067,1510023,158275,157125,4479,161604,2233
2021-10-28,San Benito,069,59416,7380,7362,165,7527,71
2021-10-28,San Bernardino,071,2135413,353172,350076,11035,361111,5777
2021-10-28,San Diego,073,3302833,372211,370006,21860,391866,4213
2021-10-28,San Francisco,075,870044,52753,52161,2261,54422,661
2021-10-28,San Joaquin,077,732212,99429,98314,5313,103627,1768
2021-10-28,San Luis Obispo,079,281455,29484,29053,1224,30277,341
2021-10-28,San Mateo,081,765935,54038,53083,849,53932,571
2021-10-28,Santa Barbara,083,443738,44305,43972,1519,45491,528
2021-10-28,Santa Clara,085,1922200,146674,145262,1299,146561,1903
2021-10-28,Santa Cruz,087,273765,20338,20134,989,21123,221
2021-10-28,Shasta,089,179085,21253,20878,3533,24411,332
2021-10-28,Sierra,091,2930,181,175,20,195,0
2021-10-28,Siskiyou,093,43540,3333,3257,1265,4522,46
2021-10-28,Solano,095,438530,45851,45146,1244,46390,346
2021-10-28,Sonoma,097,501317,41318,40924,515,41439,393
2021-10-28,Stanislaus,099,539301,78009,77871,8705,86576,1191
2021-10-28,Sutter,101,95872,13816,13773,337,14110,178
2021-10-28,Tehama,103,63373,8440,8307,1456,9763,114
2021-10-28,Trinity,105,12862,850,708,208,916,11
2021-10-28,Tulare,107,460477,68154,66745,14601,81346,995
2021-10-28,Tuolumne,109,53932,7178,7050,94,7144,90
2021-10-28,Ventura,111,848112,97948,97182,4246,101428,1174
2021-10-28,Yolo,113,214977,19824,19568,1014,20582,250
2021-10-28,Yuba,115,75493,10076,9969,310,10279,82
2021-10-27,Alameda,001,1643700,119098,118487,2705,121192,1414
2021-10-27,Alpine,003,1148,101,105,0,105,0
2021-10-27,Amador,005,37829,5523,5470,57,5527,64
2021-10-27,Butte,007,227075,20839,20446,3756,24202,274
2021-10-27,Calaveras,009,45235,4032,3970,51,4021,82
2021-10-27,Colusa,011,21464,2509,2480,625,3105,18
2021-10-27,Contra Costa,013,1133247,99103,98442,2131,100573,1018
2021-10-27,Del Norte,015,27424,3666,3571,52,3623,42
2021-10-27,El Dorado,017,186661,15986,15723,1684,17407,154
2021-10-27,Fresno,019,978130,138950,136447,12490,148937,2128
2021-10-27,Glenn,021,27897,3487,3435,1002,4437,33
2021-10-27,Humboldt,023,135768,8943,8851,539,9390,105
2021-10-27,Imperial,025,180216,33448,33068,3106,36174,766
2021-10-27,Inyo,027,18085,2309,2236,38,2274,41
2021-10-27,Kern,029,883053,126630,124557,21519,146076,1647
2021-10-27,Kings,031,150075,32027,31437,1879,33316,335
2021-10-27,Lake,033,64148,6690,6589,142,6731,105
2021-10-27,Lassen,035,31185,6822,6706,353,7059,42
2021-10-27,Los Angeles,037,10098052,1435779,1422615,53417,1476032,26604
2021-10-27,Madera,039,155013,22893,22413,2032,24445,283
2021-10-27,Marin,041,260295,17505,17362,440,17802,247
2021-10-27,Mariposa,043,17540,1268,1228,46,1274,5
2021-10-27,Mendocino,045,87422,7480,7321,505,7826,84
2021-10-27,Merced,047,269075,41599,41310,1849,43159,583
2021-10-27,Modoc,049,8938,523,513,186,699,5
2021-10-27,Mono,051,14174,1710,1682,21,1703,3
2021-10-27,Monterey,053,433212,48600,47610,2803,50413,588
2021-10-27,Napa,055,140530,12926,12856,106,12962,101
2021-10-27,Nevada,057,99092,9118,8987,314,9301,90
2021-10-27,Orange,059,3164182,306258,303825,14826,318651,5584
2021-10-27,Placer,061,380077,36913,36296,3575,39871,434
2021-10-27,Plumas,063,18699,1753,1686,33,1719,7
2021-10-27,Riverside,065,2383286,361788,357152,16182,373334,5081
2021-10-27,Sacramento,067,1510023,158007,156830,4458,161288,2230
2021-10-27,San Benito,069,59416,7373,7337,165,7502,71
2021-10-27,San Bernardino,071,2135413,352748,349624,11013,360637,5770
2021-10-27,San Diego,073,3302833,371654,369579,21836,391415,4207
2021-10-27,San Francisco,075,870044,52702,52108,2257,54365,655
2021-10-27,San Joaquin,077,732212,99271,98168,5298,103466,1753
2021-10-27,San Luis Obispo,079,281455,29445,29002,1222,30224,341
2021-10-27,San Mateo,081,765935,53983,53032,841,53873,571
2021-10-27,Santa Barbara,083,443738,44252,43901,1516,45417,527
2021-10-27,Santa Clara,085,1922200,146497,145081,1291,146372,1902
2021-10-27,Santa Cruz,087,273765,20311,20091,987,21078,221
2021-10-27,Shasta,089,179085,21177,20813,3525,24338,331
2021-10-27,Sierra,091,2930,180,176,20,196,0
2021-10-27,Siskiyou,093,43540,3330,3256,1261,4517,46
2021-10-27,Solano,095,438530,45806,45089,1237,46326,346
2021-10-27,Sonoma,097,501317,41242,40829,513,41342,393
2021-10-27,Stanislaus,099,539301,77849,77687,8690,86377,1191
2021-10-27,Sutter,101,95872,13802,13754,337,14091,177
2021-10-27,Tehama,103,63373,8418,8265,1454,9719,113
2021-10-27,Trinity,105,12862,850,706,207,913,11
2021-10-27,Tulare,107,460477,68000,66568,14545,81113,991
2021-10-27,Tuolumne,109,53932,7151,7009,93,7102,90
2021-10-27,Ventura,111,848112,97856,97108,4241,101349,1172
2021-10-27,Yolo,113,214977,19795,19517,1007,20524,250
2021-10-27,Yuba,115,75493,10055,9945,308,10253,82
2021-10-26,Alameda,001,1643700,118964,118360,2703,121063,1407
2021-10-26,Alpine,003,1148,101,105,0,105,0
2021-10-26,Amador,005,37829,5515,5465,56,5521,64
2021-10-26,Butte,007,227075,20780,20387,3739,24126,274
2021-10-26,Calaveras,009,45235,4021,3966,51,4017,81
2021-10-26,Colusa,011,21464,2507,2478,624,3102,18
2021-10-26,Contra Costa,013,1133247,98980,98352,2120,100472,1017
2021-10-26,Del Norte,015,27424,3661,3563,52,3615,42
2021-10-26,El Dorado,017,186661,15957,15690,1675,17365,153
2021-10-26,Fresno,019,978130,138501,136211,12445,148656,2122
2021-10-26,Glenn,021,27897,3472,3431,999,4430,33
2021-10-26,Humboldt,023,135768,8925,8830,533,9363,105
2021-10-26,Imperial,025,180216,33383,33012,3101,36113,766
2021-10-26,Inyo,027,18085,2294,2200,38,2238,41
2021-10-26,Kern,029,883053,126287,124351,21401,145752,1645
2021-10-26,Kings,031,150075,31960,31382,1872,33254,336
2021-10-26,Lake,033,64148,6680,6584,140,6724,105
2021-10-26,Lassen,035,31185,6801,6689,351,7040,42
2021-10-26,Los Angeles,037,10098052,1434437,1421795,53347,1475142,26599
2021-10-26,Madera,039,155013,22803,22363,2021,24384,283
2021-10-26,Marin,041,260295,17488,17354,439,17793,244
2021-10-26,Mariposa,043,17540,1263,1225,45,1270,5
2021-10-26,Mendocino,045,87422,7451,7308,489,7797,83
2021-10-26,Merced,047,269075,41521,41267,1842,43109,583
2021-10-26,Modoc,049,8938,523,513,186,699,5
2021-10-26,Mono,051,14174,1705,1680,21,1701,3
2021-10-26,Monterey,053,433212,48561,47572,2793,50365,588
2021-10-26,Napa,055,140530,12914,12849,106,12955,101
2021-10-26,Nevada,057,99092,9087,8971,313,9284,90
2021-10-26,Orange,059,3164182,305988,303533,14787,318320,5580
2021-10-26,Placer,061,380077,36816,36245,3569,39814,434
2021-10-26,Plumas,063,18699,1744,1645,33,1678,7
2021-10-26,Riverside,065,2383286,361298,356775,16172,372947,5068
2021-10-26,Sacramento,067,1510023,157706,156643,4441,161084,2228
2021-10-26,San Benito,069,59416,7350,7325,165,7490,71
2021-10-26,San Bernardino,071,2135413,352322,349346,10998,360344,5764
2021-10-26,San Diego,073,3302833,371137,369043,21806,390849,4198
2021-10-26,San Francisco,075,870044,52628,52063,2254,54317,655
2021-10-26,San Joaquin,077,732212,99092,98036,5283,103319,1748
2021-10-26,San Luis Obispo,079,281455,29406,28928,1216,30144,337
2021-10-26,San Mateo,081,765935,53911,52974,838,53812,571
2021-10-26,Santa Barbara,083,443738,44206,43835,1515,45350,525
2021-10-26,Santa Clara,085,1922200,146297,144932,1285,146217,1903
2021-10-26,Santa Cruz,087,273765,20280,20067,987,21054,221
2021-10-26,Shasta,089,179085,21116,20725,3507,24232,330
2021-10-26,Sierra,091,2930,180,169,20,189,0
2021-10-26,Siskiyou,093,43540,3324,3254,1259,4513,46
2021-10-26,Solano,095,438530,45750,45044,1236,46280,344
2021-10-26,Sonoma,097,501317,41160,40794,511,41305,393
2021-10-26,Stanislaus,099,539301,77675,77552,8665,86217,1157
2021-10-26,Sutter,101,95872,13773,13739,336,14075,176
2021-10-26,Tehama,103,63373,8390,8247,1449,9696,112
2021-10-26,Trinity,105,12862,846,705,207,912,11
2021-10-26,Tulare,107,460477,67840,66476,14488,80964,991
2021-10-26,Tuolumne,109,53932,7125,6995,91,7086,90
2021-10-26,Ventura,111,848112,97747,97014,4238,101252,1170
2021-10-26,Yolo,113,214977,19766,19490,1004,20494,248
2021-10-26,Yuba,115,75493,10037,9927,303,10230,82
2021-10-25,Alameda,001,1643700,118820,118319,2702,121021,1404
2021-10-25,Alpine,003,1148,101,105,0,105,0
2021-10-25,Amador,005,37829,5501,5455,56,5511,64
2021-10-25,Butte,007,227075,20707,20331,3731,24062,273
2021-10-25,Calaveras,009,45235,3991,3942,50,3992,82
2021-10-25,Colusa,011,21464,2505,2471,622,3093,18
2021-10-25,Contra Costa,013,1133247,98863,98267,2116,100383,1017
2021-10-25,Del Norte,015,27424,3654,3562,52,3614,42
2021-10-25,El Dorado,017,186661,15922,15663,1673,17336,149
2021-10-25,Fresno,019,978130,138067,135974,12410,148384,2112
2021-10-25,Glenn,021,27897,3469,3421,998,4419,33
2021-10-25,Humboldt,023,135768,8902,8825,528,9353,105
2021-10-25,Imperial,025,180216,33322,32968,3090,36058,766
2021-10-25,Inyo,027,18085,2276,2183,38,2221,41
2021-10-25,Kern,029,883053,125935,124078,21262,145340,1649
2021-10-25,Kings,031,150075,31871,31329,1863,33192,335
2021-10-25,Lake,033,64148,6667,6571,140,6711,105
2021-10-25,Lassen,035,31185,6790,6688,349,7037,42
2021-10-25,Los Angeles,037,10098052,1433082,1421061,53281,1474342,26579
2021-10-25,Madera,039,155013,22749,22325,2014,24339,281
2021-10-25,Marin,041,260295,17466,17334,437,17771,244
2021-10-25,Mariposa,043,17540,1249,1220,45,1265,5
2021-10-25,Mendocino,045,87422,7421,7296,485,7781,82
2021-10-25,Merced,047,269075,41453,41207,1815,43022,583
2021-10-25,Modoc,049,8938,521,512,184,696,5
2021-10-25,Mono,051,14174,1697,1677,21,1698,3
2021-10-25,Monterey,053,433212,48528,47547,2791,50338,587
2021-10-25,Napa,055,140530,12901,12841,106,12947,100
2021-10-25,Nevada,057,99092,9061,8958,313,9271,90
2021-10-25,Orange,059,3164182,305690,303279,14750,318029,5574
2021-10-25,Placer,061,380077,36708,36153,3559,39712,431
2021-10-25,Plumas,063,18699,1732,1641,33,1674,7
2021-10-25,Riverside,065,2383286,360871,356381,16157,372538,5056
2021-10-25,Sacramento,067,1510023,157402,156516,4418,160934,2235
2021-10-25,San Benito,069,59416,7337,7314,164,7478,71
2021-10-25,San Bernardino,071,2135413,351821,349075,10986,360061,5748
2021-10-25,San Diego,073,3302833,370568,368386,21778,390164,4196
2021-10-25,San Francisco,075,870044,52555,52041,2248,54289,649
2021-10-25,San Joaquin,077,732212,98890,97980,5274,103254,1740
2021-10-25,San Luis Obispo,079,281455,29358,28907,1211,30118,336
2021-10-25,San Mateo,081,765935,53850,52927,834,53761,571
2021-10-25,Santa Barbara,083,443738,44147,43775,1515,45290,525
2021-10-25,Santa Clara,085,1922200,146106,144895,1280,146175,1901
2021-10-25,Santa Cruz,087,273765,20251,20053,986,21039,221
2021-10-25,Shasta,089,179085,21044,20666,3500,24166,326
2021-10-25,Sierra,091,2930,180,168,20,188,0
2021-10-25,Siskiyou,093,43540,3320,3248,1254,4502,46
2021-10-25,Solano,095,438530,45689,45022,1234,46256,344
2021-10-25,Sonoma,097,501317,41087,40746,509,41255,393
2021-10-25,Stanislaus,099,539301,77483,77452,8637,86089,1145
2021-10-25,Sutter,101,95872,13760,13721,333,14054,176
2021-10-25,Tehama,103,63373,8363,8224,1445,9669,111
2021-10-25,Trinity,105,12862,841,699,206,905,11
2021-10-25,Tulare,107,460477,67645,66357,14426,80783,986
2021-10-25,Tuolumne,109,53932,7091,6952,90,7042,90
2021-10-25,Ventura,111,848112,97656,96932,4235,101167,1167
2021-10-25,Yolo,113,214977,19717,19457,1000,20457,248
2021-10-25,Yuba,115,75493,10021,9924,299,10223,82
2021-10-24,Alameda,001,1643700,118689,117816,2697,120513,1397
2021-10-24,Alpine,003,1148,101,105,0,105,0
2021-10-24,Amador,005,37829,5496,5412,56,5468,64
2021-10-24,Butte,007,227075,20635,20101,3719,23820,273
2021-10-24,Calaveras,009,45235,3972,3865,49,3914,81
2021-10-24,Colusa,011,21464,2501,2458,619,3077,18
2021-10-24,Contra Costa,013,1133247,98745,97855,2107,99962,1008
2021-10-24,Del Norte,015,27424,3650,3540,52,3592,42
2021-10-24,El Dorado,017,186661,15886,15540,1669,17209,149
2021-10-24,Fresno,019,978130,137630,134466,12361,146827,2094
2021-10-24,Glenn,021,27897,3462,3399,996,4395,33
2021-10-24,Humboldt,023,135768,8889,8753,522,9275,105
2021-10-24,Imperial,025,180216,33244,32777,3084,35861,766
2021-10-24,Inyo,027,18085,2244,2108,38,2146,41
2021-10-24,Kern,029,883053,125601,122939,21146,144085,1636
2021-10-24,Kings,031,150075,31742,30942,1848,32790,325
2021-10-24,Lake,033,64148,6644,6501,139,6640,105
2021-10-24,Lassen,035,31185,6773,6632,348,6980,27
2021-10-24,Los Angeles,037,10098052,1431647,1415919,53213,1469132,26527
2021-10-24,Madera,039,155013,22672,22062,2002,24064,281
2021-10-24,Marin,041,260295,17450,17264,436,17700,244
2021-10-24,Mariposa,043,17540,1246,1184,45,1229,5
2021-10-24,Mendocino,045,87422,7397,7220,475,7695,82
2021-10-24,Merced,047,269075,41332,40808,1809,42617,581
2021-10-24,Modoc,049,8938,520,507,184,691,5
2021-10-24,Mono,051,14174,1692,1655,21,1676,3
2021-10-24,Monterey,053,433212,48480,47456,2781,50237,586
2021-10-24,Napa,055,140530,12890,12789,106,12895,100
2021-10-24,Nevada,057,99092,9038,8861,310,9171,90
2021-10-24,Orange,059,3164182,305339,302237,14713,316950,5546
2021-10-24,Placer,061,380077,36604,35822,3545,39367,426
2021-10-24,Plumas,063,18699,1722,1623,32,1655,7
2021-10-24,Riverside,065,2383286,360397,354688,16137,370825,5041
2021-10-24,Sacramento,067,1510023,157061,155125,4395,159520,2232
2021-10-24,San Benito,069,59416,7317,7280,164,7444,71
2021-10-24,San Bernardino,071,2135413,351265,347681,10974,358655,5688
2021-10-24,San Diego,073,3302833,369985,366085,21747,387832,4183
2021-10-24,San Francisco,075,870044,52492,51820,2242,54062,649
2021-10-24,San Joaquin,077,732212,98717,97440,5268,102708,1721
2021-10-24,San Luis Obispo,079,281455,29297,28755,1204,29959,333
2021-10-24,San Mateo,081,765935,53778,52719,834,53553,571
2021-10-24,Santa Barbara,083,443738,44080,43552,1513,45065,523
2021-10-24,Santa Clara,085,1922200,145915,144276,1270,145546,1897
2021-10-24,Santa Cruz,087,273765,20213,19967,985,20952,221
2021-10-24,Shasta,089,179085,20945,20386,3494,23880,321
2021-10-24,Sierra,091,2930,180,168,20,188,0
2021-10-24,Siskiyou,093,43540,3313,3231,1250,4481,46
2021-10-24,Solano,095,438530,45639,44861,1229,46090,341
2021-10-24,Sonoma,097,501317,41004,40476,509,40985,393
2021-10-24,Stanislaus,099,539301,77292,76812,8626,85438,1145
2021-10-24,Sutter,101,95872,13733,13616,325,13941,175
2021-10-24,Tehama,103,63373,8315,8105,1434,9539,110
2021-10-24,Trinity,105,12862,837,696,204,900,11
2021-10-24,Tulare,107,460477,67473,65585,14355,79940,978
2021-10-24,Tuolumne,109,53932,7051,6840,88,6928,90
2021-10-24,Ventura,111,848112,97549,96664,4234,100898,1167
2021-10-24,Yolo,113,214977,19668,19280,998,20278,248
2021-10-24,Yuba,115,75493,9996,9838,298,10136,82
2021-10-23,Alameda,001,1643700,118601,117816,2692,120508,1397
2021-10-23,Alpine,003,1148,101,105,0,105,0
2021-10-23,Amador,005,37829,5489,5412,56,5468,64
2021-10-23,Butte,007,227075,20598,20101,3711,23812,273
2021-10-23,Calaveras,009,45235,3965,3865,48,3913,81
2021-10-23,Colusa,011,21464,2499,2458,618,3076,18
2021-10-23,Contra Costa,013,1133247,98693,97855,2103,99958,1008
2021-10-23,Del Norte,015,27424,3648,3540,52,3592,42
2021-10-23,El Dorado,017,186661,15860,15540,1667,17207,149
2021-10-23,Fresno,019,978130,137452,134466,12348,146814,2094
2021-10-23,Glenn,021,27897,3460,3399,995,4394,33
2021-10-23,Humboldt,023,135768,8875,8753,517,9270,105
2021-10-23,Imperial,025,180216,33197,32777,3080,35857,766
2021-10-23,Inyo,027,18085,2233,2108,38,2146,41
2021-10-23,Kern,029,883053,125441,122939,21059,143998,1636
2021-10-23,Kings,031,150075,31696,30942,1846,32788,325
2021-10-23,Lake,033,64148,6639,6501,139,6640,105
2021-10-23,Lassen,035,31185,6770,6632,346,6978,27
2021-10-23,Los Angeles,037,10098052,1430965,1415919,53159,1469078,26527
2021-10-23,Madera,039,155013,22623,22062,1994,24056,281
2021-10-23,Marin,041,260295,17433,17264,436,17700,244
2021-10-23,Mariposa,043,17540,1243,1184,44,1228,5
2021-10-23,Mendocino,045,87422,7390,7220,474,7694,82
2021-10-23,Merced,047,269075,41291,40808,1804,42612,581
2021-10-23,Modoc,049,8938,518,507,184,691,5
2021-10-23,Mono,051,14174,1686,1655,21,1676,3
2021-10-23,Monterey,053,433212,48463,47456,2777,50233,586
2021-10-23,Napa,055,140530,12885,12789,106,12895,100
2021-10-23,Nevada,057,99092,9027,8861,308,9169,90
2021-10-23,Orange,059,3164182,305153,302237,14698,316935,5546
2021-10-23,Placer,061,380077,36542,35822,3539,39361,426
2021-10-23,Plumas,063,18699,1721,1623,32,1655,7
2021-10-23,Riverside,065,2383286,360076,354688,16130,370818,5041
2021-10-23,Sacramento,067,1510023,156932,155125,4387,159512,2232
2021-10-23,San Benito,069,59416,7307,7280,164,7444,71
2021-10-23,San Bernardino,071,2135413,350995,347681,10966,358647,5688
2021-10-23,San Diego,073,3302833,369644,366085,21716,387801,4183
2021-10-23,San Francisco,075,870044,52456,51820,2241,54061,649
2021-10-23,San Joaquin,077,732212,98649,97440,5259,102699,1721
2021-10-23,San Luis Obispo,079,281455,29260,28755,1202,29957,333
2021-10-23,San Mateo,081,765935,53740,52719,833,53552,571
2021-10-23,Santa Barbara,083,443738,44049,43552,1511,45063,523
2021-10-23,Santa Clara,085,1922200,145807,144276,1266,145542,1897
2021-10-23,Santa Cruz,087,273765,20201,19967,985,20952,221
2021-10-23,Shasta,089,179085,20909,20386,3482,23868,321
2021-10-23,Sierra,091,2930,179,168,20,188,0
2021-10-23,Siskiyou,093,43540,3311,3231,1250,4481,46
2021-10-23,Solano,095,438530,45614,44861,1226,46087,341
2021-10-23,Sonoma,097,501317,40964,40476,509,40985,393
2021-10-23,Stanislaus,099,539301,77203,76812,8606,85418,1145
2021-10-23,Sutter,101,95872,13727,13616,324,13940,175
2021-10-23,Tehama,103,63373,8303,8105,1433,9538,110
2021-10-23,Trinity,105,12862,836,696,204,900,11
2021-10-23,Tulare,107,460477,67385,65585,14296,79881,978
2021-10-23,Tuolumne,109,53932,7030,6840,88,6928,90
2021-10-23,Ventura,111,848112,97488,96664,4234,100898,1167
2021-10-23,Yolo,113,214977,19651,19280,995,20275,248
2021-10-23,Yuba,115,75493,9988,9838,298,10136,82
2021-10-22,Alameda,001,1643700,118519,117816,2689,120505,1397
2021-10-22,Alpine,003,1148,101,105,0,105,0
2021-10-22,Amador,005,37829,5478,5412,56,5468,64
2021-10-22,Butte,007,227075,20566,20101,3707,23808,273
2021-10-22,Calaveras,009,45235,3957,3865,48,3913,81
2021-10-22,Colusa,011,21464,2496,2458,618,3076,18
2021-10-22,Contra Costa,013,1133247,98602,97855,2101,99956,1008
2021-10-22,Del Norte,015,27424,3644,3540,52,3592,42
2021-10-22,El Dorado,017,186661,15847,15540,1665,17205,149
2021-10-22,Fresno,019,978130,137237,134466,12326,146792,2094
2021-10-22,Glenn,021,27897,3450,3399,995,4394,33
2021-10-22,Humboldt,023,135768,8861,8753,516,9269,105
2021-10-22,Imperial,025,180216,33154,32777,3080,35857,766
2021-10-22,Inyo,027,18085,2220,2108,38,2146,41
2021-10-22,Kern,029,883053,125254,122939,20986,143925,1636
2021-10-22,Kings,031,150075,31661,30942,1845,32787,325
2021-10-22,Lake,033,64148,6629,6501,139,6640,105
2021-10-22,Lassen,035,31185,6763,6632,343,6975,27
2021-10-22,Los Angeles,037,10098052,1430202,1415919,53100,1469019,26527
2021-10-22,Madera,039,155013,22573,22062,1982,24044,281
2021-10-22,Marin,041,260295,17421,17264,436,17700,244
2021-10-22,Mariposa,043,17540,1240,1184,44,1228,5
2021-10-22,Mendocino,045,87422,7376,7220,473,7693,82
2021-10-22,Merced,047,269075,41254,40808,1797,42605,581
2021-10-22,Modoc,049,8938,518,507,184,691,5
2021-10-22,Mono,051,14174,1684,1655,21,1676,3
2021-10-22,Monterey,053,433212,48430,47456,2775,50231,586
2021-10-22,Napa,055,140530,12879,12789,106,12895,100
2021-10-22,Nevada,057,99092,9010,8861,307,9168,90
2021-10-22,Orange,059,3164182,304937,302237,14668,316905,5546
2021-10-22,Placer,061,380077,36514,35822,3530,39352,426
2021-10-22,Plumas,063,18699,1715,1623,32,1655,7
2021-10-22,Riverside,065,2383286,359765,354688,16125,370813,5041
2021-10-22,Sacramento,067,1510023,156745,155125,4378,159503,2232
2021-10-22,San Benito,069,59416,7302,7280,164,7444,71
2021-10-22,San Bernardino,071,2135413,350666,347681,10951,358632,5688
2021-10-22,San Diego,073,3302833,369246,366085,21698,387783,4183
2021-10-22,San Francisco,075,870044,52420,51820,2234,54054,649
2021-10-22,San Joaquin,077,732212,98590,97440,5256,102696,1721
2021-10-22,San Luis Obispo,079,281455,29230,28755,1202,29957,333
2021-10-22,San Mateo,081,765935,53689,52719,827,53546,571
2021-10-22,Santa Barbara,083,443738,44008,43552,1511,45063,523
2021-10-22,Santa Clara,085,1922200,145651,144276,1259,145535,1897
2021-10-22,Santa Cruz,087,273765,20179,19967,985,20952,221
2021-10-22,Shasta,089,179085,20876,20386,3479,23865,321
2021-10-22,Sierra,091,2930,178,168,19,187,0
2021-10-22,Siskiyou,093,43540,3309,3231,1247,4478,46
2021-10-22,Solano,095,438530,45579,44861,1222,46083,341
2021-10-22,Sonoma,097,501317,40907,40476,509,40985,393
2021-10-22,Stanislaus,099,539301,77100,76812,8589,85401,1145
2021-10-22,Sutter,101,95872,13712,13616,324,13940,175
2021-10-22,Tehama,103,63373,8281,8105,1428,9533,110
2021-10-22,Trinity,105,12862,835,696,204,900,11
2021-10-22,Tulare,107,460477,67299,65585,14243,79828,978
2021-10-22,Tuolumne,109,53932,6995,6840,88,6928,90
2021-10-22,Ventura,111,848112,97435,96664,4228,100892,1167
2021-10-22,Yolo,113,214977,19624,19280,993,20273,248
2021-10-22,Yuba,115,75493,9974,9838,296,10134,82
2021-10-21,Alameda,001,1643700,118404,117816,2684,120500,1397
2021-10-21,Alpine,003,1148,101,105,0,105,0
2021-10-21,Amador,005,37829,5470,5412,56,5468,64
2021-10-21,Butte,007,227075,20482,20101,3693,23794,273
2021-10-21,Calaveras,009,45235,3938,3865,48,3913,81
2021-10-21,Colusa,011,21464,2492,2458,614,3072,18
2021-10-21,Contra Costa,013,1133247,98485,97855,2096,99951,1008
2021-10-21,Del Norte,015,27424,3638,3540,51,3591,42
2021-10-21,El Dorado,017,186661,15818,15540,1658,17198,149
2021-10-21,Fresno,019,978130,136887,134466,12282,146748,2094
2021-10-21,Glenn,021,27897,3446,3399,992,4391,33
2021-10-21,Humboldt,023,135768,8847,8753,512,9265,105
2021-10-21,Imperial,025,180216,33099,32777,3076,35853,766
2021-10-21,Inyo,027,18085,2198,2108,38,2146,41
2021-10-21,Kern,029,883053,125006,122939,20877,143816,1636
2021-10-21,Kings,031,150075,31563,30942,1839,32781,325
2021-10-21,Lake,033,64148,6615,6501,138,6639,105
2021-10-21,Lassen,035,31185,6750,6632,339,6971,27
2021-10-21,Los Angeles,037,10098052,1429083,1415919,53051,1468970,26527
2021-10-21,Madera,039,155013,22515,22062,1972,24034,281
2021-10-21,Marin,041,260295,17403,17264,436,17700,244
2021-10-21,Mariposa,043,17540,1234,1184,43,1227,5
2021-10-21,Mendocino,045,87422,7358,7220,466,7686,82
2021-10-21,Merced,047,269075,41157,40808,1786,42594,581
2021-10-21,Modoc,049,8938,518,507,184,691,5
2021-10-21,Mono,051,14174,1675,1655,21,1676,3
2021-10-21,Monterey,053,433212,48396,47456,2764,50220,586
2021-10-21,Napa,055,140530,12867,12789,106,12895,100
2021-10-21,Nevada,057,99092,8985,8861,307,9168,90
2021-10-21,Orange,059,3164182,304665,302237,14632,316869,5546
2021-10-21,Placer,061,380077,36425,35822,3517,39339,426
2021-10-21,Plumas,063,18699,1701,1623,32,1655,7
2021-10-21,Riverside,065,2383286,359320,354688,16115,370803,5041
2021-10-21,Sacramento,067,1510023,156426,155125,4352,159477,2232
2021-10-21,San Benito,069,59416,7295,7280,162,7442,71
2021-10-21,San Bernardino,071,2135413,350288,347681,10917,358598,5688
2021-10-21,San Diego,073,3302833,368734,366085,21668,387753,4183
2021-10-21,San Francisco,075,870044,52365,51820,2233,54053,649
2021-10-21,San Joaquin,077,732212,98451,97440,5249,102689,1721
2021-10-21,San Luis Obispo,079,281455,29188,28755,1200,29955,333
2021-10-21,San Mateo,081,765935,53642,52719,826,53545,571
2021-10-21,Santa Barbara,083,443738,43942,43552,1509,45061,523
2021-10-21,Santa Clara,085,1922200,145480,144276,1255,145531,1897
2021-10-21,Santa Cruz,087,273765,20155,19967,983,20950,221
2021-10-21,Shasta,089,179085,20815,20386,3464,23850,321
2021-10-21,Sierra,091,2930,177,168,18,186,0
2021-10-21,Siskiyou,093,43540,3304,3231,1245,4476,46
2021-10-21,Solano,095,438530,45527,44861,1220,46081,341
2021-10-21,Sonoma,097,501317,40838,40476,507,40983,393
2021-10-21,Stanislaus,099,539301,76931,76812,8578,85390,1145
2021-10-21,Sutter,101,95872,13684,13616,320,13936,175
2021-10-21,Tehama,103,63373,8254,8105,1421,9526,110
2021-10-21,Trinity,105,12862,833,696,204,900,11
2021-10-21,Tulare,107,460477,67110,65585,14174,79759,978
2021-10-21,Tuolumne,109,53932,6957,6840,87,6927,90
2021-10-21,Ventura,111,848112,97344,96664,4226,100890,1167
2021-10-21,Yolo,113,214977,19577,19280,991,20271,248
2021-10-21,Yuba,115,75493,9950,9838,295,10133,82
2021-10-20,Alameda,001,1643700,118284,117654,2684,120338,1390
2021-10-20,Alpine,003,1148,101,103,0,103,0
2021-10-20,Amador,005,37829,5462,5379,56,5435,64
2021-10-20,Butte,007,227075,20427,20021,3677,23698,270
2021-10-20,Calaveras,009,45235,3918,3844,47,3891,81
2021-10-20,Colusa,011,21464,2488,2454,612,3066,18
2021-10-20,Contra Costa,013,1133247,98369,97721,2092,99813,1008
2021-10-20,Del Norte,015,27424,3634,3536,51,3587,42
2021-10-20,El Dorado,017,186661,15788,15502,1655,17157,149
2021-10-20,Fresno,019,978130,136485,134025,12245,146270,2084
2021-10-20,Glenn,021,27897,3438,3382,991,4373,33
2021-10-20,Humboldt,023,135768,8825,8727,510,9237,105
2021-10-20,Imperial,025,180216,33025,32705,3068,35773,766
2021-10-20,Inyo,027,18085,2178,2077,37,2114,40
2021-10-20,Kern,029,883053,124712,122630,20758,143388,1623
2021-10-20,Kings,031,150075,31486,30805,1829,32634,322
2021-10-20,Lake,033,64148,6593,6475,137,6612,104
2021-10-20,Lassen,035,31185,6735,6622,339,6961,27
2021-10-20,Los Angeles,037,10098052,1427965,1414931,52981,1467912,26506
2021-10-20,Madera,039,155013,22445,21983,1963,23946,281
2021-10-20,Marin,041,260295,17382,17250,434,17684,244
2021-10-20,Mariposa,043,17540,1227,1174,43,1217,5
2021-10-20,Mendocino,045,87422,7330,7189,463,7652,82
2021-10-20,Merced,047,269075,41076,40685,1770,42455,581
2021-10-20,Modoc,049,8938,518,504,184,688,5
2021-10-20,Mono,051,14174,1675,1653,21,1674,3
2021-10-20,Monterey,053,433212,48364,47430,2755,50185,587
2021-10-20,Napa,055,140530,12853,12773,105,12878,100
2021-10-20,Nevada,057,99092,8957,8836,307,9143,90
2021-10-20,Orange,059,3164182,304379,301957,14610,316567,5534
2021-10-20,Placer,061,380077,36336,35729,3508,39237,425
2021-10-20,Plumas,063,18699,1694,1604,32,1636,7
2021-10-20,Riverside,065,2383286,358876,354311,16098,370409,5030
2021-10-20,Sacramento,067,1510023,156127,154822,4329,159151,2222
2021-10-20,San Benito,069,59416,7292,7275,160,7435,71
2021-10-20,San Bernardino,071,2135413,349888,347217,10886,358103,5663
2021-10-20,San Diego,073,3302833,368225,365698,21649,387347,4178
2021-10-20,San Francisco,075,870044,52316,51755,2232,53987,646
2021-10-20,San Joaquin,077,732212,98306,97246,5241,102487,1721
2021-10-20,San Luis Obispo,079,281455,29143,28727,1196,29923,332
2021-10-20,San Mateo,081,765935,53571,52663,818,53481,571
2021-10-20,Santa Barbara,083,443738,43879,43489,1508,44997,523
2021-10-20,Santa Clara,085,1922200,145345,144124,1250,145374,1896
2021-10-20,Santa Cruz,087,273765,20142,19951,983,20934,219
2021-10-20,Shasta,089,179085,20753,20313,3437,23750,320
2021-10-20,Sierra,091,2930,177,168,18,186,0
2021-10-20,Siskiyou,093,43540,3304,3224,1239,4463,46
2021-10-20,Solano,095,438530,45495,44819,1218,46037,341
2021-10-20,Sonoma,097,501317,40791,40404,507,40911,393
2021-10-20,Stanislaus,099,539301,76781,76631,8559,85190,1145
2021-10-20,Sutter,101,95872,13660,13592,314,13906,175
2021-10-20,Tehama,103,63373,8223,8081,1410,9491,110
2021-10-20,Trinity,105,12862,833,693,203,896,11
2021-10-20,Tulare,107,460477,66935,65413,14130,79543,967
2021-10-20,Tuolumne,109,53932,6934,6803,87,6890,89
2021-10-20,Ventura,111,848112,97262,96610,4222,100832,1166
2021-10-20,Yolo,113,214977,19532,19236,989,20225,248
2021-10-20,Yuba,115,75493,9933,9808,292,10100,82
2021-10-19,Alameda,001,1643700,118163,117542,2678,120220,1383
2021-10-19,Alpine,003,1148,101,103,0,103,0
2021-10-19,Amador,005,37829,5446,5367,56,5423,64
2021-10-19,Butte,007,227075,20374,19974,3669,23643,268
2021-10-19,Calaveras,009,45235,3901,3826,46,3872,80
2021-10-19,Colusa,011,21464,2485,2447,610,3057,18
2021-10-19,Contra Costa,013,1133247,98278,97613,2087,99700,1004
2021-10-19,Del Norte,015,27424,3627,3531,51,3582,42
2021-10-19,El Dorado,017,186661,15763,15478,1650,17128,149
2021-10-19,Fresno,019,978130,136121,133813,12197,146010,2073
2021-10-19,Glenn,021,27897,3435,3380,989,4369,33
2021-10-19,Humboldt,023,135768,8801,8714,504,9218,105
2021-10-19,Imperial,025,180216,32959,32632,3064,35696,764
2021-10-19,Inyo,027,18085,2147,2045,37,2082,40
2021-10-19,Kern,029,883053,124395,122391,20634,143025,1613
2021-10-19,Kings,031,150075,31393,30757,1822,32579,322
2021-10-19,Lake,033,64148,6589,6465,137,6602,104
2021-10-19,Lassen,035,31185,6729,6612,335,6947,27
2021-10-19,Los Angeles,037,10098052,1426719,1413882,52907,1466789,26473
2021-10-19,Madera,039,155013,22382,21950,1955,23905,281
2021-10-19,Marin,041,260295,17368,17241,431,17672,244
2021-10-19,Mariposa,043,17540,1221,1171,41,1212,5
2021-10-19,Mendocino,045,87422,7315,7172,460,7632,82
2021-10-19,Merced,047,269075,40961,40628,1749,42377,580
2021-10-19,Modoc,049,8938,516,502,184,686,5
2021-10-19,Mono,051,14174,1671,1651,21,1672,3
2021-10-19,Monterey,053,433212,48327,47412,2744,50156,583
2021-10-19,Napa,055,140530,12846,12769,105,12874,100
2021-10-19,Nevada,057,99092,8936,8829,306,9135,90
2021-10-19,Orange,059,3164182,304122,301700,14577,316277,5527
2021-10-19,Placer,061,380077,36215,35663,3493,39156,422
2021-10-19,Plumas,063,18699,1676,1586,32,1618,8
2021-10-19,Riverside,065,2383286,358454,353891,16091,369982,5020
2021-10-19,Sacramento,067,1510023,155821,154570,4303,158873,2227
2021-10-19,San Benito,069,59416,7277,7264,160,7424,71
2021-10-19,San Bernardino,071,2135413,349487,346814,10857,357671,5627
2021-10-19,San Diego,073,3302833,367644,365285,21618,386903,4170
2021-10-19,San Francisco,075,870044,52253,51704,2230,53934,645
2021-10-19,San Joaquin,077,732212,98139,97105,5230,102335,1721
2021-10-19,San Luis Obispo,079,281455,29095,28670,1193,29863,332
2021-10-19,San Mateo,081,765935,53513,52617,816,53433,571
2021-10-19,Santa Barbara,083,443738,43812,43413,1507,44920,522
2021-10-19,Santa Clara,085,1922200,145172,143989,1243,145232,1898
2021-10-19,Santa Cruz,087,273765,20118,19895,981,20876,218
2021-10-19,Shasta,089,179085,20677,20209,3429,23638,319
2021-10-19,Sierra,091,2930,174,168,18,186,0
2021-10-19,Siskiyou,093,43540,3300,3216,1234,4450,46
2021-10-19,Solano,095,438530,45453,44782,1212,45994,341
2021-10-19,Sonoma,097,501317,40717,40379,506,40885,392
2021-10-19,Stanislaus,099,539301,76639,76526,8547,85073,1145
2021-10-19,Sutter,101,95872,13636,13569,313,13882,174
2021-10-19,Tehama,103,63373,8193,8057,1394,9451,108
2021-10-19,Trinity,105,12862,826,691,203,894,11
2021-10-19,Tulare,107,460477,66748,65253,14062,79315,958
2021-10-19,Tuolumne,109,53932,6905,6782,86,6868,89
2021-10-19,Ventura,111,848112,97186,96539,4217,100756,1166
2021-10-19,Yolo,113,214977,19487,19206,984,20190,248
2021-10-19,Yuba,115,75493,9915,9796,291,10087,82
2021-10-18,Alameda,001,1643700,118026,117506,2669,120175,1381
2021-10-18,Alpine,003,1148,101,103,0,103,0
2021-10-18,Amador,005,37829,5435,5345,56,5401,64
2021-10-18,Butte,007,227075,20323,19921,3657,23578,265
2021-10-18,Calaveras,009,45235,3876,3819,45,3864,80
2021-10-18,Colusa,011,21464,2484,2444,608,3052,18
2021-10-18,Contra Costa,013,1133247,98167,97585,2083,99668,995
2021-10-18,Del Norte,015,27424,3620,3529,51,3580,41
2021-10-18,El Dorado,017,186661,15733,15452,1648,17100,149
2021-10-18,Fresno,019,978130,135719,133688,12155,145843,2063
2021-10-18,Glenn,021,27897,3431,3370,985,4355,32
2021-10-18,Humboldt,023,135768,8782,8699,496,9195,104
2021-10-18,Imperial,025,180216,32868,32558,3064,35622,764
2021-10-18,Inyo,027,18085,2129,2020,37,2057,40
2021-10-18,Kern,029,883053,124096,122231,20540,142771,1605
2021-10-18,Kings,031,150075,31279,30698,1809,32507,320
2021-10-18,Lake,033,64148,6570,6455,133,6588,104
2021-10-18,Lassen,035,31185,6709,6607,332,6939,26
2021-10-18,Los Angeles,037,10098052,1425474,1413291,52831,1466122,26446
2021-10-18,Madera,039,155013,22328,21909,1942,23851,277
2021-10-18,Marin,041,260295,17348,17232,428,17660,244
2021-10-18,Mariposa,043,17540,1213,1160,41,1201,5
2021-10-18,Mendocino,045,87422,7296,7156,452,7608,82
2021-10-18,Merced,047,269075,40838,40573,1739,42312,579
2021-10-18,Modoc,049,8938,516,498,184,682,5
2021-10-18,Mono,051,14174,1665,1648,20,1668,3
2021-10-18,Monterey,053,433212,48305,47389,2739,50128,583
2021-10-18,Napa,055,140530,12831,12762,105,12867,100
2021-10-18,Nevada,057,99092,8917,8816,306,9122,90
2021-10-18,Orange,059,3164182,303783,301573,14542,316115,5524
2021-10-18,Placer,061,380077,36138,35598,3489,39087,420
2021-10-18,Plumas,063,18699,1668,1579,32,1611,6
2021-10-18,Riverside,065,2383286,358039,353699,16077,369776,5008
2021-10-18,Sacramento,067,1510023,155516,154428,4273,158701,2203
2021-10-18,San Benito,069,59416,7265,7253,160,7413,71
2021-10-18,San Bernardino,071,2135413,349067,346742,10843,357585,5606
2021-10-18,San Diego,073,3302833,367088,364948,21580,386528,4169
2021-10-18,San Francisco,075,870044,52190,51671,2224,53895,644
2021-10-18,San Joaquin,077,732212,97974,97041,5220,102261,1721
2021-10-18,San Luis Obispo,079,281455,29056,28644,1190,29834,331
2021-10-18,San Mateo,081,765935,53448,52594,815,53409,571
2021-10-18,Santa Barbara,083,443738,43753,43386,1505,44891,522
2021-10-18,Santa Clara,085,1922200,145017,143891,1235,145126,1895
2021-10-18,Santa Cruz,087,273765,20104,19876,979,20855,218
2021-10-18,Shasta,089,179085,20597,20146,3418,23564,313
2021-10-18,Sierra,091,2930,174,166,18,184,0
2021-10-18,Siskiyou,093,43540,3297,3210,1226,4436,42
2021-10-18,Solano,095,438530,45409,44758,1209,45967,339
2021-10-18,Sonoma,097,501317,40653,40349,503,40852,392
2021-10-18,Stanislaus,099,539301,76474,76466,8533,84999,1145
2021-10-18,Sutter,101,95872,13602,13557,311,13868,172
2021-10-18,Tehama,103,63373,8158,8042,1382,9424,107
2021-10-18,Trinity,105,12862,825,688,203,891,11
2021-10-18,Tulare,107,460477,66572,65171,13998,79169,958
2021-10-18,Tuolumne,109,53932,6876,6755,86,6841,89
2021-10-18,Ventura,111,848112,97091,96506,4214,100720,1165
2021-10-18,Yolo,113,214977,19449,19197,981,20178,248
2021-10-18,Yuba,115,75493,9888,9782,289,10071,82
2021-10-17,Alameda,001,1643700,117875,117423,2664,120087,1376
2021-10-17,Alpine,003,1148,101,103,0,103,0
2021-10-17,Amador,005,37829,5412,5341,56,5397,64
2021-10-17,Butte,007,227075,20239,19897,3647,23544,265
2021-10-17,Calaveras,009,45235,3860,3805,45,3850,80
2021-10-17,Colusa,011,21464,2479,2442,601,3043,18
2021-10-17,Contra Costa,013,1133247,98046,97485,2072,99557,995
2021-10-17,Del Norte,015,27424,3615,3526,51,3577,41
2021-10-17,El Dorado,017,186661,15675,15438,1641,17079,149
2021-10-17,Fresno,019,978130,135252,133429,12112,145541,2063
2021-10-17,Glenn,021,27897,3421,3364,980,4344,32
2021-10-17,Humboldt,023,135768,8762,8690,493,9183,104
2021-10-17,Imperial,025,180216,32785,32520,3057,35577,764
2021-10-17,Inyo,027,18085,2101,2000,37,2037,40
2021-10-17,Kern,029,883053,123746,122085,20442,142527,1603
2021-10-17,Kings,031,150075,31166,30636,1801,32437,315
2021-10-17,Lake,033,64148,6554,6437,133,6570,104
2021-10-17,Lassen,035,31185,6697,6605,328,6933,26
2021-10-17,Los Angeles,037,10098052,1424134,1412371,52756,1465127,26443
2021-10-17,Madera,039,155013,22266,21869,1931,23800,277
2021-10-17,Marin,041,260295,17326,17211,428,17639,243
2021-10-17,Mariposa,043,17540,1206,1150,41,1191,5
2021-10-17,Mendocino,045,87422,7267,7148,446,7594,82
2021-10-17,Merced,047,269075,40712,40531,1723,42254,579
2021-10-17,Modoc,049,8938,513,498,182,680,5
2021-10-17,Mono,051,14174,1663,1640,19,1659,3
2021-10-17,Monterey,053,433212,48264,47369,2729,50098,583
2021-10-17,Napa,055,140530,12816,12753,102,12855,100
2021-10-17,Nevada,057,99092,8900,8794,305,9099,90
2021-10-17,Orange,059,3164182,303468,301414,14509,315923,5524
2021-10-17,Placer,061,380077,36038,35559,3474,39033,420
2021-10-17,Plumas,063,18699,1644,1571,31,1602,6
2021-10-17,Riverside,065,2383286,357555,353500,16063,369563,5008
2021-10-17,Sacramento,067,1510023,155116,154080,4256,158336,2213
2021-10-17,San Benito,069,59416,7256,7250,159,7409,71
2021-10-17,San Bernardino,071,2135413,348633,346524,10823,357347,5597
2021-10-17,San Diego,073,3302833,366497,364675,21552,386227,4163
2021-10-17,San Francisco,075,870044,52118,51625,2215,53840,644
2021-10-17,San Joaquin,077,732212,97801,96950,5211,102161,1721
2021-10-17,San Luis Obispo,079,281455,29004,28604,1182,29786,331
2021-10-17,San Mateo,081,765935,53396,52541,811,53352,571
2021-10-17,Santa Barbara,083,443738,43690,43344,1504,44848,522
2021-10-17,Santa Clara,085,1922200,144840,143768,1226,144994,1895
2021-10-17,Santa Cruz,087,273765,20076,19861,977,20838,218
2021-10-17,Shasta,089,179085,20507,20116,3408,23524,312
2021-10-17,Sierra,091,2930,172,165,18,183,0
2021-10-17,Siskiyou,093,43540,3289,3204,1223,4427,42
2021-10-17,Solano,095,438530,45352,44722,1208,45930,340
2021-10-17,Sonoma,097,501317,40577,40306,502,40808,392
2021-10-17,Stanislaus,099,539301,76275,76354,8519,84873,1145
2021-10-17,Sutter,101,95872,13585,13543,309,13852,172
2021-10-17,Tehama,103,63373,8126,8015,1366,9381,107
2021-10-17,Trinity,105,12862,822,686,202,888,11
2021-10-17,Tulare,107,460477,66389,65057,13926,78983,958
2021-10-17,Tuolumne,109,53932,6842,6735,85,6820,89
2021-10-17,Ventura,111,848112,96991,96458,4211,100669,1165
2021-10-17,Yolo,113,214977,19407,19171,972,20143,248
2021-10-17,Yuba,115,75493,9862,9771,287,10058,82
2021-10-16,Alameda,001,1643700,117785,117027,2662,119689,1365
2021-10-16,Alpine,003,1148,100,102,0,102,0
2021-10-16,Amador,005,37829,5405,5310,56,5366,64
2021-10-16,Butte,007,227075,20208,19612,3638,23250,260
2021-10-16,Calaveras,009,45235,3853,3771,45,3816,80
2021-10-16,Colusa,011,21464,2475,2431,598,3029,18
2021-10-16,Contra Costa,013,1133247,97954,97107,2065,99172,982
2021-10-16,Del Norte,015,27424,3612,3516,51,3567,41
2021-10-16,El Dorado,017,186661,15654,15315,1639,16954,149
2021-10-16,Fresno,019,978130,135098,132433,12095,144528,2051
2021-10-16,Glenn,021,27897,3415,3331,980,4311,26
2021-10-16,Humboldt,023,135768,8750,8621,488,9109,104
2021-10-16,Imperial,025,180216,32770,32368,3055,35423,764
2021-10-16,Inyo,027,18085,2087,1932,37,1969,39
2021-10-16,Kern,029,883053,123590,121354,20361,141715,1590
2021-10-16,Kings,031,150075,31120,30418,1798,32216,314
2021-10-16,Lake,033,64148,6543,6378,133,6511,104
2021-10-16,Lassen,035,31185,6688,6559,324,6883,26
2021-10-16,Los Angeles,037,10098052,1423479,1409418,52702,1462120,26398
2021-10-16,Madera,039,155013,22222,21707,1927,23634,277
2021-10-16,Marin,041,260295,17316,17148,428,17576,243
2021-10-16,Mariposa,043,17540,1203,1096,41,1137,5
2021-10-16,Mendocino,045,87422,7256,7099,446,7545,82
2021-10-16,Merced,047,269075,40680,40265,1721,41986,577
2021-10-16,Modoc,049,8938,510,492,182,674,5
2021-10-16,Mono,051,14174,1659,1628,19,1647,3
2021-10-16,Monterey,053,433212,48247,47293,2721,50014,582
2021-10-16,Napa,055,140530,12805,12706,102,12808,100
2021-10-16,Nevada,057,99092,8880,8739,305,9044,90
2021-10-16,Orange,059,3164182,303292,300722,14484,315206,5509
2021-10-16,Placer,061,380077,35954,35343,3468,38811,412
2021-10-16,Plumas,063,18699,1639,1542,30,1572,6
2021-10-16,Riverside,065,2383286,357285,352435,16051,368486,4990
2021-10-16,Sacramento,067,1510023,154917,153264,4252,157516,2192
2021-10-16,San Benito,069,59416,7243,7210,158,7368,71
2021-10-16,San Bernardino,071,2135413,348426,345418,10815,356233,5566
2021-10-16,San Diego,073,3302833,366181,363109,21536,384645,4151
2021-10-16,San Francisco,075,870044,52071,51436,2211,53647,645
2021-10-16,San Joaquin,077,732212,97729,96507,5208,101715,1708
2021-10-16,San Luis Obispo,079,281455,28978,28460,1181,29641,329
2021-10-16,San Mateo,081,765935,53347,52399,810,53209,569
2021-10-16,Santa Barbara,083,443738,43654,43175,1503,44678,521
2021-10-16,Santa Clara,085,1922200,144740,143282,1218,144500,1890
2021-10-16,Santa Cruz,087,273765,20061,19794,976,20770,218
2021-10-16,Shasta,089,179085,20457,19932,3397,23329,309
2021-10-16,Sierra,091,2930,170,160,18,178,0
2021-10-16,Siskiyou,093,43540,3287,3173,1216,4389,42
2021-10-16,Solano,095,438530,45326,44585,1204,45789,334
2021-10-16,Sonoma,097,501317,40537,40195,502,40697,390
2021-10-16,Stanislaus,099,539301,76189,75868,8509,84377,1142
2021-10-16,Sutter,101,95872,13566,13471,308,13779,169
2021-10-16,Tehama,103,63373,8113,7907,1361,9268,104
2021-10-16,Trinity,105,12862,822,679,202,881,11
2021-10-16,Tulare,107,460477,66251,64489,13895,78384,951
2021-10-16,Tuolumne,109,53932,6810,6666,85,6751,89
2021-10-16,Ventura,111,848112,96959,96181,4206,100387,1164
2021-10-16,Yolo,113,214977,19380,19078,966,20044,247
2021-10-16,Yuba,115,75493,9838,9705,284,9989,82
2021-10-15,Alameda,001,1643700,117713,117027,2658,119685,1365
2021-10-15,Alpine,003,1148,100,102,0,102,0
2021-10-15,Amador,005,37829,5381,5310,56,5366,64
2021-10-15,Butte,007,227075,20172,19612,3631,23243,260
2021-10-15,Calaveras,009,45235,3847,3771,45,3816,80
2021-10-15,Colusa,011,21464,2473,2431,595,3026,18
2021-10-15,Contra Costa,013,1133247,97872,97107,2062,99169,982
2021-10-15,Del Norte,015,27424,3610,3516,51,3567,41
2021-10-15,El Dorado,017,186661,15634,15315,1634,16949,149
2021-10-15,Fresno,019,978130,134845,132433,12086,144519,2051
2021-10-15,Glenn,021,27897,3409,3331,979,4310,26
2021-10-15,Humboldt,023,135768,8741,8621,486,9107,104
2021-10-15,Imperial,025,180216,32723,32368,3051,35419,764
2021-10-15,Inyo,027,18085,2069,1932,37,1969,39
2021-10-15,Kern,029,883053,123454,121354,20287,141641,1590
2021-10-15,Kings,031,150075,31065,30418,1794,32212,314
2021-10-15,Lake,033,64148,6534,6378,133,6511,104
2021-10-15,Lassen,035,31185,6676,6559,323,6882,26
2021-10-15,Los Angeles,037,10098052,1422786,1409418,52654,1462072,26398
2021-10-15,Madera,039,155013,22178,21707,1919,23626,277
2021-10-15,Marin,041,260295,17305,17148,428,17576,243
2021-10-15,Mariposa,043,17540,1195,1096,41,1137,5
2021-10-15,Mendocino,045,87422,7241,7099,446,7545,82
2021-10-15,Merced,047,269075,40650,40265,1718,41983,577
2021-10-15,Modoc,049,8938,509,492,182,674,5
2021-10-15,Mono,051,14174,1656,1628,19,1647,3
2021-10-15,Monterey,053,433212,48225,47293,2719,50012,582
2021-10-15,Napa,055,140530,12801,12706,102,12808,100
2021-10-15,Nevada,057,99092,8865,8739,305,9044,90
2021-10-15,Orange,059,3164182,303123,300722,14466,315188,5509
2021-10-15,Placer,061,380077,35900,35343,3462,38805,412
2021-10-15,Plumas,063,18699,1631,1542,30,1572,6
2021-10-15,Riverside,065,2383286,357043,352435,16046,368481,4990
2021-10-15,Sacramento,067,1510023,154730,153264,4242,157506,2192
2021-10-15,San Benito,069,59416,7240,7210,158,7368,71
2021-10-15,San Bernardino,071,2135413,348194,345418,10812,356230,5566
2021-10-15,San Diego,073,3302833,365821,363109,21511,384620,4151
2021-10-15,San Francisco,075,870044,52031,51436,2204,53640,645
2021-10-15,San Joaquin,077,732212,97651,96507,5201,101708,1708
2021-10-15,San Luis Obispo,079,281455,28957,28460,1179,29639,329
2021-10-15,San Mateo,081,765935,53303,52399,809,53208,569
2021-10-15,Santa Barbara,083,443738,43616,43175,1503,44678,521
2021-10-15,Santa Clara,085,1922200,144618,143282,1210,144492,1890
2021-10-15,Santa Cruz,087,273765,20050,19794,976,20770,218
2021-10-15,Shasta,089,179085,20401,19932,3389,23321,309
2021-10-15,Sierra,091,2930,170,160,18,178,0
2021-10-15,Siskiyou,093,43540,3286,3173,1213,4386,42
2021-10-15,Solano,095,438530,45300,44585,1204,45789,334
2021-10-15,Sonoma,097,501317,40503,40195,501,40696,390
2021-10-15,Stanislaus,099,539301,76109,75868,8493,84361,1142
2021-10-15,Sutter,101,95872,13549,13471,306,13777,169
2021-10-15,Tehama,103,63373,8092,7907,1355,9262,104
2021-10-15,Trinity,105,12862,822,679,202,881,11
2021-10-15,Tulare,107,460477,66172,64489,13858,78347,951
2021-10-15,Tuolumne,109,53932,6787,6666,83,6749,89
2021-10-15,Ventura,111,848112,96917,96181,4203,100384,1164
2021-10-15,Yolo,113,214977,19365,19078,962,20040,247
2021-10-15,Yuba,115,75493,9828,9705,283,9988,82
2021-10-14,Alameda,001,1643700,117604,117027,2653,119680,1365
2021-10-14,Alpine,003,1148,100,102,0,102,0
2021-10-14,Amador,005,37829,5370,5310,56,5366,64
2021-10-14,Butte,007,227075,20120,19612,3625,23237,260
2021-10-14,Calaveras,009,45235,3834,3771,44,3815,80
2021-10-14,Colusa,011,21464,2471,2431,593,3024,18
2021-10-14,Contra Costa,013,1133247,97738,97107,2055,99162,982
2021-10-14,Del Norte,015,27424,3604,3516,51,3567,41
2021-10-14,El Dorado,017,186661,15596,15315,1631,16946,149
2021-10-14,Fresno,019,978130,134550,132433,12057,144490,2051
2021-10-14,Glenn,021,27897,3404,3331,978,4309,26
2021-10-14,Humboldt,023,135768,8724,8621,483,9104,104
2021-10-14,Imperial,025,180216,32660,32368,3044,35412,764
2021-10-14,Inyo,027,18085,2050,1932,37,1969,39
2021-10-14,Kern,029,883053,123182,121354,20188,141542,1590
2021-10-14,Kings,031,150075,31000,30418,1786,32204,314
2021-10-14,Lake,033,64148,6513,6378,132,6510,104
2021-10-14,Lassen,035,31185,6670,6559,322,6881,26
2021-10-14,Los Angeles,037,10098052,1421795,1409418,52603,1462021,26398
2021-10-14,Madera,039,155013,22113,21707,1913,23620,277
2021-10-14,Marin,041,260295,17300,17148,426,17574,243
2021-10-14,Mariposa,043,17540,1182,1096,40,1136,5
2021-10-14,Mendocino,045,87422,7227,7099,444,7543,82
2021-10-14,Merced,047,269075,40562,40265,1704,41969,577
2021-10-14,Modoc,049,8938,509,492,182,674,5
2021-10-14,Mono,051,14174,1649,1628,19,1647,3
2021-10-14,Monterey,053,433212,48199,47293,2714,50007,582
2021-10-14,Napa,055,140530,12786,12706,102,12808,100
2021-10-14,Nevada,057,99092,8838,8739,303,9042,90
2021-10-14,Orange,059,3164182,302915,300722,14449,315171,5509
2021-10-14,Placer,061,380077,35833,35343,3448,38791,412
2021-10-14,Plumas,063,18699,1616,1542,30,1572,6
2021-10-14,Riverside,065,2383286,356646,352435,16035,368470,4990
2021-10-14,Sacramento,067,1510023,154479,153264,4222,157486,2192
2021-10-14,San Benito,069,59416,7229,7210,158,7368,71
2021-10-14,San Bernardino,071,2135413,347837,345418,10805,356223,5566
2021-10-14,San Diego,073,3302833,365381,363109,21484,384593,4151
2021-10-14,San Francisco,075,870044,51974,51436,2200,53636,645
2021-10-14,San Joaquin,077,732212,97522,96507,5192,101699,1708
2021-10-14,San Luis Obispo,079,281455,28912,28460,1175,29635,329
2021-10-14,San Mateo,081,765935,53255,52399,808,53207,569
2021-10-14,Santa Barbara,083,443738,43560,43175,1498,44673,521
2021-10-14,Santa Clara,085,1922200,144477,143282,1204,144486,1890
2021-10-14,Santa Cruz,087,273765,20027,19794,976,20770,218
2021-10-14,Shasta,089,179085,20344,19932,3377,23309,309
2021-10-14,Sierra,091,2930,169,160,18,178,0
2021-10-14,Siskiyou,093,43540,3283,3173,1205,4378,42
2021-10-14,Solano,095,438530,45250,44585,1196,45781,334
2021-10-14,Sonoma,097,501317,40453,40195,498,40693,390
2021-10-14,Stanislaus,099,539301,75963,75868,8480,84348,1142
2021-10-14,Sutter,101,95872,13529,13471,305,13776,169
2021-10-14,Tehama,103,63373,8061,7907,1348,9255,104
2021-10-14,Trinity,105,12862,821,679,201,880,11
2021-10-14,Tulare,107,460477,65987,64489,13811,78300,951
2021-10-14,Tuolumne,109,53932,6755,6666,82,6748,89
2021-10-14,Ventura,111,848112,96849,96181,4197,100378,1164
2021-10-14,Yolo,113,214977,19332,19078,955,20033,247
2021-10-14,Yuba,115,75493,9814,9705,274,9979,82
2021-10-13,Alameda,001,1643700,117498,116914,2647,119561,1360
2021-10-13,Alpine,003,1148,100,102,0,102,0
2021-10-13,Amador,005,37829,5356,5305,56,5361,63
2021-10-13,Butte,007,227075,20045,19546,3620,23166,257
2021-10-13,Calaveras,009,45235,3813,3756,42,3798,79
2021-10-13,Colusa,011,21464,2464,2430,589,3019,18
2021-10-13,Contra Costa,013,1133247,97622,96975,2054,99029,969
2021-10-13,Del Norte,015,27424,3599,3512,51,3563,39
2021-10-13,El Dorado,017,186661,15572,15302,1626,16928,149
2021-10-13,Fresno,019,978130,134216,132055,12026,144081,2048
2021-10-13,Glenn,021,27897,3399,3327,974,4301,26
2021-10-13,Humboldt,023,135768,8713,8604,479,9083,102
2021-10-13,Imperial,025,180216,32600,32317,3042,35359,762
2021-10-13,Inyo,027,18085,2013,1907,37,1944,39
2021-10-13,Kern,029,883053,122938,120956,20096,141052,1586
2021-10-13,Kings,031,150075,30919,30246,1779,32025,312
2021-10-13,Lake,033,64148,6493,6371,132,6503,103
2021-10-13,Lassen,035,31185,6659,6535,316,6851,25
2021-10-13,Los Angeles,037,10098052,1420743,1408384,52547,1460931,26379
2021-10-13,Madera,039,155013,22060,21609,1899,23508,277
2021-10-13,Marin,041,260295,17276,17137,425,17562,243
2021-10-13,Mariposa,043,17540,1168,1090,40,1130,5
2021-10-13,Mendocino,045,87422,7211,7088,436,7524,82
2021-10-13,Merced,047,269075,40477,40164,1693,41857,577
2021-10-13,Modoc,049,8938,507,490,180,670,5
2021-10-13,Mono,051,14174,1649,1612,19,1631,3
2021-10-13,Monterey,053,433212,48180,47273,2707,49980,582
2021-10-13,Napa,055,140530,12775,12695,100,12795,100
2021-10-13,Nevada,057,99092,8816,8725,303,9028,90
2021-10-13,Orange,059,3164182,302707,300468,14433,314901,5503
2021-10-13,Placer,061,380077,35766,35254,3439,38693,412
2021-10-13,Plumas,063,18699,1602,1514,30,1544,6
2021-10-13,Riverside,065,2383286,356316,352044,16022,368066,4978
2021-10-13,Sacramento,067,1510023,154230,153141,4201,157342,2182
2021-10-13,San Benito,069,59416,7223,7196,157,7353,71
2021-10-13,San Bernardino,071,2135413,347513,344951,10788,355739,5562
2021-10-13,San Diego,073,3302833,364950,362564,21462,384026,4141
2021-10-13,San Francisco,075,870044,51931,51379,2196,53575,644
2021-10-13,San Joaquin,077,732212,97379,96343,5188,101531,1696
2021-10-13,San Luis Obispo,079,281455,28874,28397,1172,29569,330
2021-10-13,San Mateo,081,765935,53203,52352,804,53156,569
2021-10-13,Santa Barbara,083,443738,43508,43109,1498,44607,518
2021-10-13,Santa Clara,085,1922200,144339,143064,1203,144267,1886
2021-10-13,Santa Cruz,087,273765,20001,19763,975,20738,217
2021-10-13,Shasta,089,179085,20274,19802,3357,23159,307
2021-10-13,Sierra,091,2930,169,155,18,173,0
2021-10-13,Siskiyou,093,43540,3275,3173,1204,4377,42
2021-10-13,Solano,095,438530,45211,44558,1193,45751,334
2021-10-13,Sonoma,097,501317,40397,40122,498,40620,390
2021-10-13,Stanislaus,099,539301,75821,75698,8470,84168,1136
2021-10-13,Sutter,101,95872,13499,13458,303,13761,169
2021-10-13,Tehama,103,63373,8025,7849,1342,9191,103
2021-10-13,Trinity,105,12862,818,677,201,878,11
2021-10-13,Tulare,107,460477,65807,64297,13757,78054,945
2021-10-13,Tuolumne,109,53932,6741,6644,81,6725,89
2021-10-13,Ventura,111,848112,96775,96099,4191,100290,1162
2021-10-13,Yolo,113,214977,19304,19023,953,19976,247
2021-10-13,Yuba,115,75493,9789,9690,261,9951,80
2021-10-12,Alameda,001,1643700,117395,116813,2643,119456,1357
2021-10-12,Alpine,003,1148,100,102,0,102,0
2021-10-12,Amador,005,37829,5345,5301,56,5357,63
2021-10-12,Butte,007,227075,19973,19506,3609,23115,256
2021-10-12,Calaveras,009,45235,3798,3750,42,3792,75
2021-10-12,Colusa,011,21464,2461,2428,587,3015,18
2021-10-12,Contra Costa,013,1133247,97509,96894,2045,98939,960
2021-10-12,Del Norte,015,27424,3593,3511,51,3562,39
2021-10-12,El Dorado,017,186661,15538,15287,1624,16911,148
2021-10-12,Fresno,019,978130,133855,131848,11995,143843,2042
2021-10-12,Glenn,021,27897,3385,3321,973,4294,26
2021-10-12,Humboldt,023,135768,8686,8587,473,9060,102
2021-10-12,Imperial,025,180216,32548,32267,3040,35307,762
2021-10-12,Inyo,027,18085,1981,1889,37,1926,39
2021-10-12,Kern,029,883053,122651,120826,19987,140813,1580
2021-10-12,Kings,031,150075,30845,30200,1768,31968,312
2021-10-12,Lake,033,64148,6478,6372,130,6502,97
2021-10-12,Lassen,035,31185,6649,6526,315,6841,25
2021-10-12,Los Angeles,037,10098052,1419683,1407462,52501,1459963,26362
2021-10-12,Madera,039,155013,21989,21574,1886,23460,277
2021-10-12,Marin,041,260295,17253,17126,425,17551,242
2021-10-12,Mariposa,043,17540,1154,1088,40,1128,5
2021-10-12,Mendocino,045,87422,7182,7077,433,7510,82
2021-10-12,Merced,047,269075,40398,40113,1687,41800,567
2021-10-12,Modoc,049,8938,502,485,179,664,5
2021-10-12,Mono,051,14174,1647,1608,19,1627,3
2021-10-12,Monterey,053,433212,48149,47254,2699,49953,582
2021-10-12,Napa,055,140530,12761,12671,100,12771,97
2021-10-12,Nevada,057,99092,8804,8720,302,9022,89
2021-10-12,Orange,059,3164182,302452,300256,14407,314663,5499
2021-10-12,Placer,061,380077,35703,35214,3431,38645,404
2021-10-12,Plumas,063,18699,1588,1488,29,1517,6
2021-10-12,Riverside,065,2383286,355990,351771,16008,367779,4973
2021-10-12,Sacramento,067,1510023,153925,152935,4176,157111,2170
2021-10-12,San Benito,069,59416,7209,7193,157,7350,71
2021-10-12,San Bernardino,071,2135413,347202,344788,10778,355566,5563
2021-10-12,San Diego,073,3302833,364437,362256,21433,383689,4137
2021-10-12,San Francisco,075,870044,51867,51301,2195,53496,643
2021-10-12,San Joaquin,077,732212,97242,96237,5183,101420,1690
2021-10-12,San Luis Obispo,079,281455,28827,28379,1171,29550,327
2021-10-12,San Mateo,081,765935,53152,52328,803,53131,569
2021-10-12,Santa Barbara,083,443738,43447,43076,1498,44574,515
2021-10-12,Santa Clara,085,1922200,144186,142954,1201,144155,1882
2021-10-12,Santa Cruz,087,273765,19976,19757,975,20732,218
2021-10-12,Shasta,089,179085,20200,19731,3336,23067,304
2021-10-12,Sierra,091,2930,169,153,18,171,0
2021-10-12,Siskiyou,093,43540,3264,3166,1198,4364,42
2021-10-12,Solano,095,438530,45169,44516,1187,45703,329
2021-10-12,Sonoma,097,501317,40356,40105,497,40602,390
2021-10-12,Stanislaus,099,539301,75669,75589,8458,84047,1126
2021-10-12,Sutter,101,95872,13476,13436,299,13735,168
2021-10-12,Tehama,103,63373,7993,7820,1338,9158,103
2021-10-12,Trinity,105,12862,815,676,201,877,11
2021-10-12,Tulare,107,460477,65622,64216,13702,77918,944
2021-10-12,Tuolumne,109,53932,6724,6637,80,6717,89
2021-10-12,Ventura,111,848112,96674,96022,4186,100208,1160
2021-10-12,Yolo,113,214977,19277,18987,945,19932,247
2021-10-12,Yuba,115,75493,9774,9676,257,9933,70
2021-10-11,Alameda,001,1643700,117253,116759,2642,119401,1358
2021-10-11,Alpine,003,1148,100,102,0,102,0
2021-10-11,Amador,005,37829,5333,5286,56,5342,62
2021-10-11,Butte,007,227075,19914,19452,3604,23056,253
2021-10-11,Calaveras,009,45235,3777,3750,42,3792,75
2021-10-11,Colusa,011,21464,2457,2427,579,3006,18
2021-10-11,Contra Costa,013,1133247,97373,96832,2040,98872,960
2021-10-11,Del Norte,015,27424,3590,3510,47,3557,39
2021-10-11,El Dorado,017,186661,15509,15273,1620,16893,146
2021-10-11,Fresno,019,978130,133525,131703,11960,143663,2036
2021-10-11,Glenn,021,27897,3368,3308,971,4279,26
2021-10-11,Humboldt,023,135768,8661,8571,466,9037,101
2021-10-11,Imperial,025,180216,32498,32207,3034,35241,762
2021-10-11,Inyo,027,18085,1958,1862,36,1898,39
2021-10-11,Kern,029,883053,122415,120684,19892,140576,1575
2021-10-11,Kings,031,150075,30756,30180,1758,31938,309
2021-10-11,Lake,033,64148,6462,6361,126,6487,97
2021-10-11,Lassen,035,31185,6629,6499,312,6811,25
2021-10-11,Los Angeles,037,10098052,1418636,1406826,52450,1459276,26346
2021-10-11,Madera,039,155013,21931,21555,1869,23424,272
2021-10-11,Marin,041,260295,17235,17121,421,17542,242
2021-10-11,Mariposa,043,17540,1124,1083,39,1122,5
2021-10-11,Mendocino,045,87422,7166,7064,429,7493,82
2021-10-11,Merced,047,269075,40282,40064,1662,41726,566
2021-10-11,Modoc,049,8938,499,482,176,658,5
2021-10-11,Mono,051,14174,1637,1604,19,1623,3
2021-10-11,Monterey,053,433212,48120,47241,2692,49933,580
2021-10-11,Napa,055,140530,12738,12654,98,12752,96
2021-10-11,Nevada,057,99092,8784,8716,301,9017,90
2021-10-11,Orange,059,3164182,302222,299941,14377,314318,5499
2021-10-11,Placer,061,380077,35634,35173,3414,38587,404
2021-10-11,Plumas,063,18699,1570,1469,27,1496,6
2021-10-11,Riverside,065,2383286,355645,351444,16003,367447,4973
2021-10-11,Sacramento,067,1510023,153636,152681,4145,156826,2169
2021-10-11,San Benito,069,59416,7188,7184,155,7339,71
2021-10-11,San Bernardino,071,2135413,346819,344594,10770,355364,5549
2021-10-11,San Diego,073,3302833,363925,361712,21401,383113,4124
2021-10-11,San Francisco,075,870044,51796,51275,2192,53467,643
2021-10-11,San Joaquin,077,732212,97087,96152,5172,101324,1681
2021-10-11,San Luis Obispo,079,281455,28779,28355,1166,29521,327
2021-10-11,San Mateo,081,765935,53104,52298,803,53101,569
2021-10-11,Santa Barbara,083,443738,43400,43018,1497,44515,515
2021-10-11,Santa Clara,085,1922200,144025,142836,1197,144033,1882
2021-10-11,Santa Cruz,087,273765,19952,19745,974,20719,217
2021-10-11,Shasta,089,179085,20121,19662,3320,22982,295
2021-10-11,Sierra,091,2930,166,147,17,164,0
2021-10-11,Siskiyou,093,43540,3257,3159,1194,4353,42
2021-10-11,Solano,095,438530,45120,44474,1184,45658,329
2021-10-11,Sonoma,097,501317,40311,40067,497,40564,390
2021-10-11,Stanislaus,099,539301,75498,75478,8437,83915,1118
2021-10-11,Sutter,101,95872,13457,13427,297,13724,165
2021-10-11,Tehama,103,63373,7952,7795,1329,9124,102
2021-10-11,Trinity,105,12862,809,675,200,875,11
2021-10-11,Tulare,107,460477,65442,64094,13636,77730,942
2021-10-11,Tuolumne,109,53932,6686,6602,80,6682,89
2021-10-11,Ventura,111,848112,96577,95876,4179,100055,1160
2021-10-11,Yolo,113,214977,19230,18977,942,19919,247
2021-10-11,Yuba,115,75493,9757,9657,245,9902,69
2021-10-10,Alameda,001,1643700,117134,116679,2638,119317,1358
2021-10-10,Alpine,003,1148,100,102,0,102,0
2021-10-10,Amador,005,37829,5319,5278,56,5334,62
2021-10-10,Butte,007,227075,19849,19430,3588,23018,253
2021-10-10,Calaveras,009,45235,3765,3747,42,3789,75
2021-10-10,Colusa,011,21464,2456,2425,578,3003,18
2021-10-10,Contra Costa,013,1133247,97274,96760,2034,98794,960
2021-10-10,Del Norte,015,27424,3586,3507,47,3554,39
2021-10-10,El Dorado,017,186661,15479,15250,1614,16864,146
2021-10-10,Fresno,019,978130,133195,131434,11929,143363,2035
2021-10-10,Glenn,021,27897,3363,3297,969,4266,26
2021-10-10,Humboldt,023,135768,8639,8554,462,9016,101
2021-10-10,Imperial,025,180216,32423,32167,3033,35200,762
2021-10-10,Inyo,027,18085,1937,1857,36,1893,39
2021-10-10,Kern,029,883053,122089,120552,19789,140341,1573
2021-10-10,Kings,031,150075,30667,30122,1748,31870,308
2021-10-10,Lake,033,64148,6446,6349,125,6474,97
2021-10-10,Lassen,035,31185,6609,6495,311,6806,26
2021-10-10,Los Angeles,037,10098052,1417448,1406034,52375,1458409,26338
2021-10-10,Madera,039,155013,21885,21486,1860,23346,272
2021-10-10,Marin,041,260295,17218,17112,421,17533,242
2021-10-10,Mariposa,043,17540,1121,1074,39,1113,5
2021-10-10,Mendocino,045,87422,7151,7060,421,7481,81
2021-10-10,Merced,047,269075,40199,40036,1643,41679,566
2021-10-10,Modoc,049,8938,499,482,176,658,5
2021-10-10,Mono,051,14174,1636,1596,19,1615,3
2021-10-10,Monterey,053,433212,48090,47228,2691,49919,580
2021-10-10,Napa,055,140530,12715,12641,98,12739,96
2021-10-10,Nevada,057,99092,8772,8689,301,8990,90
2021-10-10,Orange,059,3164182,301960,299787,14349,314136,5499
2021-10-10,Placer,061,380077,35541,35128,3402,38530,404
2021-10-10,Plumas,063,18699,1554,1468,25,1493,6
2021-10-10,Riverside,065,2383286,355271,351248,15985,367233,4973
2021-10-10,Sacramento,067,1510023,153369,152405,4128,156533,2178
2021-10-10,San Benito,069,59416,7183,7180,154,7334,71
2021-10-10,San Bernardino,071,2135413,346507,344423,10762,355185,5551
2021-10-10,San Diego,073,3302833,363409,361038,21354,382392,4113
2021-10-10,San Francisco,075,870044,51749,51216,2190,53406,643
2021-10-10,San Joaquin,077,732212,96916,96084,5158,101242,1681
2021-10-10,San Luis Obispo,079,281455,28735,28343,1166,29509,326
2021-10-10,San Mateo,081,765935,53062,52273,802,53075,569
2021-10-10,Santa Barbara,083,443738,43353,42987,1496,44483,515
2021-10-10,Santa Clara,085,1922200,143860,142768,1190,143958,1881
2021-10-10,Santa Cruz,087,273765,19932,19727,974,20701,217
2021-10-10,Shasta,089,179085,20033,19635,3311,22946,296
2021-10-10,Sierra,091,2930,164,147,17,164,0
2021-10-10,Siskiyou,093,43540,3243,3155,1187,4342,42
2021-10-10,Solano,095,438530,45064,44431,1184,45615,329
2021-10-10,Sonoma,097,501317,40259,40027,497,40524,390
2021-10-10,Stanislaus,099,539301,75320,75403,8423,83826,1118
2021-10-10,Sutter,101,95872,13433,13412,292,13704,165
2021-10-10,Tehama,103,63373,7914,7764,1320,9084,102
2021-10-10,Trinity,105,12862,808,669,199,868,11
2021-10-10,Tulare,107,460477,65270,63930,13587,77517,940
2021-10-10,Tuolumne,109,53932,6662,6580,79,6659,89
2021-10-10,Ventura,111,848112,96488,95829,4179,100008,1160
2021-10-10,Yolo,113,214977,19198,18952,937,19889,247
2021-10-10,Yuba,115,75493,9741,9641,240,9881,69
2021-10-09,Alameda,001,1643700,117036,116253,2636,118889,1356
2021-10-09,Alpine,003,1148,99,102,0,102,0
2021-10-09,Amador,005,37829,5317,5237,55,5292,62
2021-10-09,Butte,007,227075,19818,19277,3584,22861,250
2021-10-09,Calaveras,009,45235,3761,3716,42,3758,75
2021-10-09,Colusa,011,21464,2452,2419,577,2996,18
2021-10-09,Contra Costa,013,1133247,97205,96378,2028,98406,958
2021-10-09,Del Norte,015,27424,3585,3495,47,3542,39
2021-10-09,El Dorado,017,186661,15461,15153,1611,16764,144
2021-10-09,Fresno,019,978130,133063,130508,11911,142419,2018
2021-10-09,Glenn,021,27897,3359,3277,967,4244,26
2021-10-09,Humboldt,023,135768,8625,8448,460,8908,97
2021-10-09,Imperial,025,180216,32389,31989,3031,35020,760
2021-10-09,Inyo,027,18085,1928,1808,36,1844,39
2021-10-09,Kern,029,883053,121948,119795,19762,139557,1559
2021-10-09,Kings,031,150075,30618,29894,1746,31640,308
2021-10-09,Lake,033,64148,6427,6283,124,6407,97
2021-10-09,Lassen,035,31185,6604,6442,310,6752,25
2021-10-09,Los Angeles,037,10098052,1416860,1402810,52338,1455148,26280
2021-10-09,Madera,039,155013,21852,21313,1846,23159,271
2021-10-09,Marin,041,260295,17213,17049,419,17468,242
2021-10-09,Mariposa,043,17540,1114,1042,38,1080,5
2021-10-09,Mendocino,045,87422,7144,7011,420,7431,82
2021-10-09,Merced,047,269075,40156,39784,1643,41427,565
2021-10-09,Modoc,049,8938,497,477,175,652,5
2021-10-09,Mono,051,14174,1633,1577,19,1596,3
2021-10-09,Monterey,053,433212,48078,47168,2688,49856,577
2021-10-09,Napa,055,140530,12711,12586,98,12684,96
2021-10-09,Nevada,057,99092,8761,8613,300,8913,90
2021-10-09,Orange,059,3164182,301779,299089,14330,313419,5457
2021-10-09,Placer,061,380077,35503,34877,3395,38272,393
2021-10-09,Plumas,063,18699,1543,1418,25,1443,6
2021-10-09,Riverside,065,2383286,355019,350082,15969,366051,4965
2021-10-09,Sacramento,067,1510023,153159,151566,4115,155681,2160
2021-10-09,San Benito,069,59416,7175,7123,154,7277,71
2021-10-09,San Bernardino,071,2135413,346321,343452,10758,354210,5556
2021-10-09,San Diego,073,3302833,363103,359909,21349,381258,4111
2021-10-09,San Francisco,075,870044,51701,50960,2183,53143,643
2021-10-09,San Joaquin,077,732212,96850,95606,5153,100759,1669
2021-10-09,San Luis Obispo,079,281455,28718,28197,1164,29361,324
2021-10-09,San Mateo,081,765935,53031,52121,801,52922,569
2021-10-09,Santa Barbara,083,443738,43326,42735,1496,44231,514
2021-10-09,Santa Clara,085,1922200,143736,142298,1184,143482,1873
2021-10-09,Santa Cruz,087,273765,19922,19635,973,20608,217
2021-10-09,Shasta,089,179085,19982,19437,3306,22743,290
2021-10-09,Sierra,091,2930,161,141,17,158,0
2021-10-09,Siskiyou,093,43540,3242,3124,1186,4310,42
2021-10-09,Solano,095,438530,45047,44265,1183,45448,329
2021-10-09,Sonoma,097,501317,40215,39848,497,40345,387
2021-10-09,Stanislaus,099,539301,75230,74899,8412,83311,1114
2021-10-09,Sutter,101,95872,13424,13314,290,13604,165
2021-10-09,Tehama,103,63373,7903,7670,1315,8985,99
2021-10-09,Trinity,105,12862,807,660,199,859,11
2021-10-09,Tulare,107,460477,65162,63398,13566,76964,932
2021-10-09,Tuolumne,109,53932,6643,6521,79,6600,89
2021-10-09,Ventura,111,848112,96434,95542,4176,99718,1158
2021-10-09,Yolo,113,214977,19176,18850,935,19785,247
2021-10-09,Yuba,115,75493,9729,9551,239,9790,69
2021-10-08,Alameda,001,1643700,116955,116253,2633,118886,1356
2021-10-08,Alpine,003,1148,99,102,0,102,0
2021-10-08,Amador,005,37829,5304,5237,55,5292,62
2021-10-08,Butte,007,227075,19789,19277,3580,22857,250
2021-10-08,Calaveras,009,45235,3756,3716,42,3758,75
2021-10-08,Colusa,011,21464,2450,2419,577,2996,18
2021-10-08,Contra Costa,013,1133247,97161,96378,2023,98401,958
2021-10-08,Del Norte,015,27424,3584,3495,47,3542,39
2021-10-08,El Dorado,017,186661,15441,15153,1607,16760,144
2021-10-08,Fresno,019,978130,132867,130508,11890,142398,2018
2021-10-08,Glenn,021,27897,3351,3277,965,4242,26
2021-10-08,Humboldt,023,135768,8614,8448,457,8905,97
2021-10-08,Imperial,025,180216,32360,31989,3027,35016,760
2021-10-08,Inyo,027,18085,1910,1808,36,1844,39
2021-10-08,Kern,029,883053,121811,119795,19720,139515,1559
2021-10-08,Kings,031,150075,30524,29894,1745,31639,308
2021-10-08,Lake,033,64148,6419,6283,124,6407,97
2021-10-08,Lassen,035,31185,6590,6442,307,6749,25
2021-10-08,Los Angeles,037,10098052,1416200,1402810,52304,1455114,26280
2021-10-08,Madera,039,155013,21793,21313,1839,23152,271
2021-10-08,Marin,041,260295,17202,17049,418,17467,242
2021-10-08,Mariposa,043,17540,1107,1042,36,1078,5
2021-10-08,Mendocino,045,87422,7131,7011,420,7431,82
2021-10-08,Merced,047,269075,40124,39784,1640,41424,565
2021-10-08,Modoc,049,8938,495,477,175,652,5
2021-10-08,Mono,051,14174,1630,1577,19,1596,3
2021-10-08,Monterey,053,433212,48051,47168,2686,49854,577
2021-10-08,Napa,055,140530,12695,12586,98,12684,96
2021-10-08,Nevada,057,99092,8748,8613,300,8913,90
2021-10-08,Orange,059,3164182,301632,299089,14310,313399,5457
2021-10-08,Placer,061,380077,35465,34877,3388,38265,393
2021-10-08,Plumas,063,18699,1531,1418,25,1443,6
2021-10-08,Riverside,065,2383286,354750,350082,15958,366040,4965
2021-10-08,Sacramento,067,1510023,152994,151566,4101,155667,2160
2021-10-08,San Benito,069,59416,7171,7123,152,7275,71
2021-10-08,San Bernardino,071,2135413,346111,343452,10750,354202,5556
2021-10-08,San Diego,073,3302833,362777,359909,21330,381239,4111
2021-10-08,San Francisco,075,870044,51654,50960,2176,53136,643
2021-10-08,San Joaquin,077,732212,96782,95606,5147,100753,1669
2021-10-08,San Luis Obispo,079,281455,28691,28197,1163,29360,324
2021-10-08,San Mateo,081,765935,53003,52121,801,52922,569
2021-10-08,Santa Barbara,083,443738,43291,42735,1495,44230,514
2021-10-08,Santa Clara,085,1922200,143623,142298,1179,143477,1873
2021-10-08,Santa Cruz,087,273765,19907,19635,973,20608,217
2021-10-08,Shasta,089,179085,19940,19437,3300,22737,290
2021-10-08,Sierra,091,2930,159,141,15,156,0
2021-10-08,Siskiyou,093,43540,3234,3124,1185,4309,42
2021-10-08,Solano,095,438530,45008,44265,1183,45448,329
2021-10-08,Sonoma,097,501317,40179,39848,497,40345,387
2021-10-08,Stanislaus,099,539301,75161,74899,8403,83302,1114
2021-10-08,Sutter,101,95872,13410,13314,288,13602,165
2021-10-08,Tehama,103,63373,7886,7670,1313,8983,99
2021-10-08,Trinity,105,12862,806,660,199,859,11
2021-10-08,Tulare,107,460477,65044,63398,13534,76932,932
2021-10-08,Tuolumne,109,53932,6620,6521,79,6600,89
2021-10-08,Ventura,111,848112,96383,95542,4170,99712,1158
2021-10-08,Yolo,113,214977,19163,18850,931,19781,247
2021-10-08,Yuba,115,75493,9709,9551,238,9789,69
2021-10-07,Alameda,001,1643700,116835,116253,2632,118885,1356
2021-10-07,Alpine,003,1148,99,102,0,102,0
2021-10-07,Amador,005,37829,5297,5237,55,5292,62
2021-10-07,Butte,007,227075,19740,19277,3569,22846,250
2021-10-07,Calaveras,009,45235,3744,3716,42,3758,75
2021-10-07,Colusa,011,21464,2447,2419,571,2990,18
2021-10-07,Contra Costa,013,1133247,97038,96378,2020,98398,958
2021-10-07,Del Norte,015,27424,3581,3495,47,3542,39
2021-10-07,El Dorado,017,186661,15404,15153,1603,16756,144
2021-10-07,Fresno,019,978130,132593,130508,11866,142374,2018
2021-10-07,Glenn,021,27897,3344,3277,962,4239,26
2021-10-07,Humboldt,023,135768,8588,8448,454,8902,97
2021-10-07,Imperial,025,180216,32289,31989,3014,35003,760
2021-10-07,Inyo,027,18085,1891,1808,36,1844,39
2021-10-07,Kern,029,883053,121580,119795,19655,139450,1559
2021-10-07,Kings,031,150075,30459,29894,1739,31633,308
2021-10-07,Lake,033,64148,6408,6283,124,6407,97
2021-10-07,Lassen,035,31185,6572,6442,305,6747,25
2021-10-07,Los Angeles,037,10098052,1415244,1402810,52259,1455069,26280
2021-10-07,Madera,039,155013,21720,21313,1825,23138,271
2021-10-07,Marin,041,260295,17184,17049,418,17467,242
2021-10-07,Mariposa,043,17540,1099,1042,36,1078,5
2021-10-07,Mendocino,045,87422,7121,7011,416,7427,82
2021-10-07,Merced,047,269075,40057,39784,1623,41407,565
2021-10-07,Modoc,049,8938,492,477,174,651,5
2021-10-07,Mono,051,14174,1622,1577,19,1596,3
2021-10-07,Monterey,053,433212,48026,47168,2677,49845,577
2021-10-07,Napa,055,140530,12680,12586,98,12684,96
2021-10-07,Nevada,057,99092,8720,8613,300,8913,90
2021-10-07,Orange,059,3164182,301406,299089,14296,313385,5457
2021-10-07,Placer,061,380077,35403,34877,3381,38258,393
2021-10-07,Plumas,063,18699,1514,1418,25,1443,6
2021-10-07,Riverside,065,2383286,354418,350082,15946,366028,4965
2021-10-07,Sacramento,067,1510023,152712,151566,4074,155640,2160
2021-10-07,San Benito,069,59416,7155,7123,150,7273,71
2021-10-07,San Bernardino,071,2135413,345837,343452,10742,354194,5556
2021-10-07,San Diego,073,3302833,362382,359909,21309,381218,4111
2021-10-07,San Francisco,075,870044,51583,50960,2173,53133,643
2021-10-07,San Joaquin,077,732212,96628,95606,5139,100745,1669
2021-10-07,San Luis Obispo,079,281455,28640,28197,1161,29358,324
2021-10-07,San Mateo,081,765935,52963,52121,800,52921,569
2021-10-07,Santa Barbara,083,443738,43223,42735,1489,44224,514
2021-10-07,Santa Clara,085,1922200,143474,142298,1173,143471,1873
2021-10-07,Santa Cruz,087,273765,19887,19635,972,20607,217
2021-10-07,Shasta,089,179085,19851,19437,3285,22722,290
2021-10-07,Sierra,091,2930,158,141,15,156,0
2021-10-07,Siskiyou,093,43540,3230,3124,1180,4304,42
2021-10-07,Solano,095,438530,44963,44265,1179,45444,329
2021-10-07,Sonoma,097,501317,40142,39848,495,40343,387
2021-10-07,Stanislaus,099,539301,74999,74899,8378,83277,1114
2021-10-07,Sutter,101,95872,13388,13314,285,13599,165
2021-10-07,Tehama,103,63373,7853,7670,1307,8977,99
2021-10-07,Trinity,105,12862,804,660,199,859,11
2021-10-07,Tulare,107,460477,64877,63398,13498,76896,932
2021-10-07,Tuolumne,109,53932,6598,6521,79,6600,89
2021-10-07,Ventura,111,848112,96310,95542,4167,99709,1158
2021-10-07,Yolo,113,214977,19130,18850,927,19777,247
2021-10-07,Yuba,115,75493,9683,9551,231,9782,69
2021-10-06,Alameda,001,1643700,116698,116058,2626,118684,1353
2021-10-06,Alpine,003,1148,99,102,0,102,0
2021-10-06,Amador,005,37829,5294,5205,55,5260,62
2021-10-06,Butte,007,227075,19678,19208,3562,22770,247
2021-10-06,Calaveras,009,45235,3735,3669,42,3711,75
2021-10-06,Colusa,011,21464,2445,2414,564,2978,18
2021-10-06,Contra Costa,013,1133247,96913,96184,2016,98200,953
2021-10-06,Del Norte,015,27424,3578,3490,44,3534,39
2021-10-06,El Dorado,017,186661,15378,15078,1600,16678,140
2021-10-06,Fresno,019,978130,132303,130074,11841,141915,2008
2021-10-06,Glenn,021,27897,3335,3270,960,4230,26
2021-10-06,Humboldt,023,135768,8573,8416,448,8864,94
2021-10-06,Imperial,025,180216,32236,31930,3004,34934,760
2021-10-06,Inyo,027,18085,1876,1806,36,1842,39
2021-10-06,Kern,029,883053,121323,119491,19564,139055,1552
2021-10-06,Kings,031,150075,30393,29785,1731,31516,308
2021-10-06,Lake,033,64148,6394,6271,124,6395,97
2021-10-06,Lassen,035,31185,6556,6429,304,6733,25
2021-10-06,Los Angeles,037,10098052,1414288,1401675,52210,1453885,26252
2021-10-06,Madera,039,155013,21665,21230,1815,23045,269
2021-10-06,Marin,041,260295,17175,17042,415,17457,242
2021-10-06,Mariposa,043,17540,1092,1036,36,1072,5
2021-10-06,Mendocino,045,87422,7112,6986,414,7400,81
2021-10-06,Merced,047,269075,39982,39666,1611,41277,563
2021-10-06,Modoc,049,8938,492,477,172,649,5
2021-10-06,Mono,051,14174,1610,1568,19,1587,3
2021-10-06,Monterey,053,433212,47993,47136,2672,49808,577
2021-10-06,Napa,055,140530,12656,12552,97,12649,96
2021-10-06,Nevada,057,99092,8704,8582,299,8881,90
2021-10-06,Orange,059,3164182,301168,298785,14284,313069,5448
2021-10-06,Placer,061,380077,35352,34764,3375,38139,390
2021-10-06,Plumas,063,18699,1491,1383,25,1408,6
2021-10-06,Riverside,065,2383286,354062,349645,15925,365570,4953
2021-10-06,Sacramento,067,1510023,152459,151164,4043,155207,2141
2021-10-06,San Benito,069,59416,7140,7108,150,7258,69
2021-10-06,San Bernardino,071,2135413,345547,343022,10735,353757,5551
2021-10-06,San Diego,073,3302833,361890,359564,21283,380847,4104
2021-10-06,San Francisco,075,870044,51520,50894,2170,53064,641
2021-10-06,San Joaquin,077,732212,96494,95418,5127,100545,1658
2021-10-06,San Luis Obispo,079,281455,28590,28170,1155,29325,323
2021-10-06,San Mateo,081,765935,52913,52056,795,52851,569
2021-10-06,Santa Barbara,083,443738,43140,42687,1487,44174,513
2021-10-06,Santa Clara,085,1922200,143323,142124,1168,143292,1872
2021-10-06,Santa Cruz,087,273765,19858,19604,970,20574,217
2021-10-06,Shasta,089,179085,19776,19325,3272,22597,287
2021-10-06,Sierra,091,2930,156,138,15,153,0
2021-10-06,Siskiyou,093,43540,3220,3116,1173,4289,42
2021-10-06,Solano,095,438530,44929,44185,1178,45363,328
2021-10-06,Sonoma,097,501317,40092,39787,494,40281,383
2021-10-06,Stanislaus,099,539301,74857,74699,8365,83064,1114
2021-10-06,Sutter,101,95872,13367,13284,283,13567,164
2021-10-06,Tehama,103,63373,7817,7629,1299,8928,99
2021-10-06,Trinity,105,12862,801,656,199,855,11
2021-10-06,Tulare,107,460477,64698,63198,13442,76640,926
2021-10-06,Tuolumne,109,53932,6573,6486,79,6565,89
2021-10-06,Ventura,111,848112,96219,95449,4159,99608,1158
2021-10-06,Yolo,113,214977,19098,18815,923,19738,247
2021-10-06,Yuba,115,75493,9659,9520,230,9750,69
2021-10-05,Alameda,001,1643700,116554,115968,2621,118589,1350
2021-10-05,Alpine,003,1148,99,102,0,102,0
2021-10-05,Amador,005,37829,5273,5194,54,5248,61
2021-10-05,Butte,007,227075,19629,19137,3547,22684,246
2021-10-05,Calaveras,009,45235,3719,3657,42,3699,73
2021-10-05,Colusa,011,21464,2438,2414,563,2977,18
2021-10-05,Contra Costa,013,1133247,96796,96108,2011,98119,941
2021-10-05,Del Norte,015,27424,3576,3485,43,3528,39
2021-10-05,El Dorado,017,186661,15339,15052,1597,16649,140
2021-10-05,Fresno,019,978130,131963,129957,11805,141762,1987
2021-10-05,Glenn,021,27897,3325,3270,955,4225,26
2021-10-05,Humboldt,023,135768,8542,8398,444,8842,94
2021-10-05,Imperial,025,180216,32189,31909,2999,34908,759
2021-10-05,Inyo,027,18085,1859,1800,36,1836,39
2021-10-05,Kern,029,883053,121058,119260,19464,138724,1540
2021-10-05,Kings,031,150075,30318,29749,1726,31475,301
2021-10-05,Lake,033,64148,6373,6264,123,6387,97
2021-10-05,Lassen,035,31185,6537,6417,302,6719,25
2021-10-05,Los Angeles,037,10098052,1413146,1400300,52156,1452456,26223
2021-10-05,Madera,039,155013,21607,21183,1803,22986,269
2021-10-05,Marin,041,260295,17163,17024,415,17439,242
2021-10-05,Mariposa,043,17540,1073,1033,33,1066,5
2021-10-05,Mendocino,045,87422,7096,6972,407,7379,79
2021-10-05,Merced,047,269075,39916,39608,1603,41211,562
2021-10-05,Modoc,049,8938,488,475,171,646,5
2021-10-05,Mono,051,14174,1602,1565,19,1584,3
2021-10-05,Monterey,053,433212,47976,47087,2662,49749,573
2021-10-05,Napa,055,140530,12632,12533,97,12630,96
2021-10-05,Nevada,057,99092,8674,8576,299,8875,90
2021-10-05,Orange,059,3164182,300891,298589,14252,312841,5441
2021-10-05,Placer,061,380077,35272,34728,3368,38096,382
2021-10-05,Plumas,063,18699,1466,1357,25,1382,6
2021-10-05,Riverside,065,2383286,353702,349365,15910,365275,4942
2021-10-05,Sacramento,067,1510023,152185,151111,4015,155126,2126
2021-10-05,San Benito,069,59416,7122,7103,148,7251,69
2021-10-05,San Bernardino,071,2135413,345219,342711,10728,353439,5557
2021-10-05,San Diego,073,3302833,361315,359194,21256,380450,4092
2021-10-05,San Francisco,075,870044,51423,50826,2167,52993,641
2021-10-05,San Joaquin,077,732212,96341,95276,5101,100377,1651
2021-10-05,San Luis Obispo,079,281455,28546,28113,1153,29266,324
2021-10-05,San Mateo,081,765935,52866,52008,795,52803,569
2021-10-05,Santa Barbara,083,443738,43062,42595,1483,44078,511
2021-10-05,Santa Clara,085,1922200,143163,141971,1161,143132,1873
2021-10-05,Santa Cruz,087,273765,19816,19582,970,20552,216
2021-10-05,Shasta,089,179085,19702,19285,3259,22544,286
2021-10-05,Sierra,091,2930,152,136,15,151,0
2021-10-05,Siskiyou,093,43540,3206,3107,1173,4280,42
2021-10-05,Solano,095,438530,44858,44149,1177,45326,325
2021-10-05,Sonoma,097,501317,40037,39756,489,40245,383
2021-10-05,Stanislaus,099,539301,74695,74599,8348,82947,1114
2021-10-05,Sutter,101,95872,13339,13270,282,13552,164
2021-10-05,Tehama,103,63373,7787,7607,1290,8897,98
2021-10-05,Trinity,105,12862,798,655,199,854,11
2021-10-05,Tulare,107,460477,64491,63093,13389,76482,920
2021-10-05,Tuolumne,109,53932,6558,6473,78,6551,89
2021-10-05,Ventura,111,848112,96113,95351,4158,99509,1155
2021-10-05,Yolo,113,214977,19061,18782,917,19699,245
2021-10-05,Yuba,115,75493,9627,9504,227,9731,69
2021-10-04,Alameda,001,1643700,116392,115845,2618,118463,1347
2021-10-04,Alpine,003,1148,99,102,0,102,0
2021-10-04,Amador,005,37829,5263,5163,53,5216,61
2021-10-04,Butte,007,227075,19551,19081,3536,22617,245
2021-10-04,Calaveras,009,45235,3710,3641,42,3683,73
2021-10-04,Colusa,011,21464,2437,2414,561,2975,18
2021-10-04,Contra Costa,013,1133247,96655,95958,2006,97964,937
2021-10-04,Del Norte,015,27424,3574,3485,39,3524,39
2021-10-04,El Dorado,017,186661,15292,15031,1590,16621,138
2021-10-04,Fresno,019,978130,131653,129665,11775,141440,1978
2021-10-04,Glenn,021,27897,3318,3270,952,4222,26
2021-10-04,Humboldt,023,135768,8510,8355,437,8792,94
2021-10-04,Imperial,025,180216,32140,31866,2992,34858,757
2021-10-04,Inyo,027,18085,1847,1792,34,1826,39
2021-10-04,Kern,029,883053,120767,118984,19344,138328,1531
2021-10-04,Kings,031,150075,30225,29702,1723,31425,303
2021-10-04,Lake,033,64148,6360,6248,123,6371,97
2021-10-04,Lassen,035,31185,6520,6405,302,6707,25
2021-10-04,Los Angeles,037,10098052,1412028,1399604,52098,1451702,26186
2021-10-04,Madera,039,155013,21543,21126,1791,22917,266
2021-10-04,Marin,041,260295,17147,17008,414,17422,242
2021-10-04,Mariposa,043,17540,1061,1024,33,1057,5
2021-10-04,Mendocino,045,87422,7078,6947,404,7351,79
2021-10-04,Merced,047,269075,39800,39565,1587,41152,558
2021-10-04,Modoc,049,8938,485,473,171,644,5
2021-10-04,Mono,051,14174,1594,1561,19,1580,3
2021-10-04,Monterey,053,433212,47955,47058,2655,49713,571
2021-10-04,Napa,055,140530,12608,12506,97,12603,96
2021-10-04,Nevada,057,99092,8654,8563,299,8862,90
2021-10-04,Orange,059,3164182,300595,298165,14220,312385,5438
2021-10-04,Placer,061,380077,35190,34630,3341,37971,379
2021-10-04,Plumas,063,18699,1444,1329,25,1354,6
2021-10-04,Riverside,065,2383286,353322,348828,15900,364728,4923
2021-10-04,Sacramento,067,1510023,151862,150887,3988,154875,2115
2021-10-04,San Benito,069,59416,7109,7099,148,7247,69
2021-10-04,San Bernardino,071,2135413,344859,342418,10716,353134,5551
2021-10-04,San Diego,073,3302833,360749,358525,21225,379750,4090
2021-10-04,San Francisco,075,870044,51328,50798,2163,52961,638
2021-10-04,San Joaquin,077,732212,96144,95198,5081,100279,1649
2021-10-04,San Luis Obispo,079,281455,28501,28090,1147,29237,323
2021-10-04,San Mateo,081,765935,52806,51958,794,52752,569
2021-10-04,Santa Barbara,083,443738,42977,42585,1482,44067,511
2021-10-04,Santa Clara,085,1922200,143018,141840,1155,142995,1869
2021-10-04,Santa Cruz,087,273765,19787,19559,969,20528,216
2021-10-04,Shasta,089,179085,19595,19170,3245,22415,279
2021-10-04,Sierra,091,2930,145,136,14,150,0
2021-10-04,Siskiyou,093,43540,3197,3103,1158,4261,42
2021-10-04,Solano,095,438530,44799,44092,1173,45265,322
2021-10-04,Sonoma,097,501317,39971,39720,489,40209,381
2021-10-04,Stanislaus,099,539301,74544,74444,8329,82773,1106
2021-10-04,Sutter,101,95872,13310,13261,281,13542,164
2021-10-04,Tehama,103,63373,7746,7585,1284,8869,95
2021-10-04,Trinity,105,12862,797,649,198,847,11
2021-10-04,Tulare,107,460477,64304,62957,13321,76278,920
2021-10-04,Tuolumne,109,53932,6532,6442,78,6520,89
2021-10-04,Ventura,111,848112,96021,95170,4152,99322,1153
2021-10-04,Yolo,113,214977,19017,18761,913,19674,242
2021-10-04,Yuba,115,75493,9588,9481,225,9706,68
2021-10-03,Alameda,001,1643700,116249,115751,2608,118359,1349
2021-10-03,Alpine,003,1148,99,102,0,102,0
2021-10-03,Amador,005,37829,5245,5160,51,5211,61
2021-10-03,Butte,007,227075,19478,19066,3519,22585,245
2021-10-03,Calaveras,009,45235,3693,3632,42,3674,73
2021-10-03,Colusa,011,21464,2436,2413,558,2971,18
2021-10-03,Contra Costa,013,1133247,96523,95890,1999,97889,937
2021-10-03,Del Norte,015,27424,3568,3483,38,3521,39
2021-10-03,El Dorado,017,186661,15233,15014,1583,16597,139
2021-10-03,Fresno,019,978130,131272,129365,11734,141099,1978
2021-10-03,Glenn,021,27897,3311,3266,944,4210,26
2021-10-03,Humboldt,023,135768,8465,8352,433,8785,94
2021-10-03,Imperial,025,180216,32073,31844,2984,34828,757
2021-10-03,Inyo,027,18085,1826,1788,34,1822,39
2021-10-03,Kern,029,883053,120462,118851,19222,138073,1535
2021-10-03,Kings,031,150075,30126,29623,1716,31339,300
2021-10-03,Lake,033,64148,6334,6239,123,6362,97
2021-10-03,Lassen,035,31185,6498,6400,300,6700,25
2021-10-03,Los Angeles,037,10098052,1410767,1398790,52044,1450834,26179
2021-10-03,Madera,039,155013,21471,21066,1781,22847,266
2021-10-03,Marin,041,260295,17124,16995,409,17404,242
2021-10-03,Mariposa,043,17540,1054,1011,33,1044,5
2021-10-03,Mendocino,045,87422,7058,6939,396,7335,79
2021-10-03,Merced,047,269075,39693,39516,1567,41083,558
2021-10-03,Modoc,049,8938,484,472,170,642,5
2021-10-03,Mono,051,14174,1590,1554,19,1573,3
2021-10-03,Monterey,053,433212,47930,47049,2644,49693,571
2021-10-03,Napa,055,140530,12580,12489,95,12584,96
2021-10-03,Nevada,057,99092,8619,8545,299,8844,90
2021-10-03,Orange,059,3164182,300313,298027,14200,312227,5447
2021-10-03,Placer,061,380077,35052,34596,3325,37921,379
2021-10-03,Plumas,063,18699,1416,1328,25,1353,6
2021-10-03,Riverside,065,2383286,352891,348593,15880,364473,4924
2021-10-03,Sacramento,067,1510023,151574,150664,3959,154623,2120
2021-10-03,San Benito,069,59416,7100,7095,148,7243,69
2021-10-03,San Bernardino,071,2135413,344444,342302,10709,353011,5555
2021-10-03,San Diego,073,3302833,360169,358153,21193,379346,4081
2021-10-03,San Francisco,075,870044,51241,50733,2160,52893,638
2021-10-03,San Joaquin,077,732212,95955,95133,5073,100206,1649
2021-10-03,San Luis Obispo,079,281455,28434,28065,1142,29207,325
2021-10-03,San Mateo,081,765935,52739,51923,793,52716,569
2021-10-03,Santa Barbara,083,443738,42881,42550,1474,44024,511
2021-10-03,Santa Clara,085,1922200,142848,141737,1147,142884,1869
2021-10-03,Santa Cruz,087,273765,19747,19548,967,20515,216
2021-10-03,Shasta,089,179085,19490,19132,3217,22349,279
2021-10-03,Sierra,091,2930,142,136,14,150,0
2021-10-03,Siskiyou,093,43540,3184,3096,1148,4244,42
2021-10-03,Solano,095,438530,44735,44051,1170,45221,322
2021-10-03,Sonoma,097,501317,39905,39679,489,40168,381
2021-10-03,Stanislaus,099,539301,74356,74366,8311,82677,1106
2021-10-03,Sutter,101,95872,13295,13248,277,13525,164
2021-10-03,Tehama,103,63373,7703,7564,1279,8843,94
2021-10-03,Trinity,105,12862,793,647,196,843,11
2021-10-03,Tulare,107,460477,64100,62860,13249,76109,924
2021-10-03,Tuolumne,109,53932,6503,6430,76,6506,89
2021-10-03,Ventura,111,848112,95916,95108,4149,99257,1153
2021-10-03,Yolo,113,214977,18988,18720,905,19625,242
2021-10-03,Yuba,115,75493,9571,9462,224,9686,68
2021-10-02,Alameda,001,1643700,116141,115185,2604,117789,1343
2021-10-02,Alpine,003,1148,99,102,0,102,0
2021-10-02,Amador,005,37829,5236,5105,51,5156,61
2021-10-02,Butte,007,227075,19448,18911,3512,22423,243
2021-10-02,Calaveras,009,45235,3686,3585,42,3627,72
2021-10-02,Colusa,011,21464,2435,2403,556,2959,18
2021-10-02,Contra Costa,013,1133247,96452,95369,1995,97364,933
2021-10-02,Del Norte,015,27424,3563,3468,38,3506,39
2021-10-02,El Dorado,017,186661,15207,14887,1582,16469,136
2021-10-02,Fresno,019,978130,131101,128450,11721,140171,1964
2021-10-02,Glenn,021,27897,3306,3234,944,4178,26
2021-10-02,Humboldt,023,135768,8446,8244,433,8677,94
2021-10-02,Imperial,025,180216,32038,31674,2981,34655,757
2021-10-02,Inyo,027,18085,1817,1746,34,1780,39
2021-10-02,Kern,029,883053,120329,117962,19141,137103,1524
2021-10-02,Kings,031,150075,30077,29339,1712,31051,301
2021-10-02,Lake,033,64148,6325,6191,123,6314,97
2021-10-02,Lassen,035,31185,6493,6360,300,6660,25
2021-10-02,Los Angeles,037,10098052,1410156,1395070,52008,1447078,26126
2021-10-02,Madera,039,155013,21446,20931,1772,22703,266
2021-10-02,Marin,041,260295,17119,16936,406,17342,242
2021-10-02,Mariposa,043,17540,1052,967,33,1000,5
2021-10-02,Mendocino,045,87422,7048,6869,396,7265,78
2021-10-02,Merced,047,269075,39666,39196,1563,40759,552
2021-10-02,Modoc,049,8938,482,468,170,638,5
2021-10-02,Mono,051,14174,1588,1540,19,1559,3
2021-10-02,Monterey,053,433212,47875,46964,2643,49607,571
2021-10-02,Napa,055,140530,12569,12433,95,12528,96
2021-10-02,Nevada,057,99092,8608,8474,298,8772,87
2021-10-02,Orange,059,3164182,300148,297307,14180,311487,5435
2021-10-02,Placer,061,380077,34986,34377,3316,37693,381
2021-10-02,Plumas,063,18699,1405,1298,25,1323,6
2021-10-02,Riverside,065,2383286,352650,347227,15869,363096,4895
2021-10-02,Sacramento,067,1510023,151401,149897,3951,153848,2099
2021-10-02,San Benito,069,59416,7093,7055,148,7203,69
2021-10-02,San Bernardino,071,2135413,344257,341212,10657,351869,5540
2021-10-02,San Diego,073,3302833,359852,356454,21171,377625,4078
2021-10-02,San Francisco,075,870044,51192,50393,2155,52548,634
2021-10-02,San Joaquin,077,732212,95890,94599,5067,99666,1646
2021-10-02,San Luis Obispo,079,281455,28410,27915,1142,29057,323
2021-10-02,San Mateo,081,765935,52698,51767,789,52556,573
2021-10-02,Santa Barbara,083,443738,42841,42423,1474,43897,508
2021-10-02,Santa Clara,085,1922200,142734,141231,1143,142374,1862
2021-10-02,Santa Cruz,087,273765,19730,19461,966,20427,214
2021-10-02,Shasta,089,179085,19444,18912,3211,22123,270
2021-10-02,Sierra,091,2930,141,131,14,145,0
2021-10-02,Siskiyou,093,43540,3183,3053,1145,4198,42
2021-10-02,Solano,095,438530,44690,43800,1169,44969,321
2021-10-02,Sonoma,097,501317,39871,39497,488,39985,382
2021-10-02,Stanislaus,099,539301,74270,73859,8298,82157,1099
2021-10-02,Sutter,101,95872,13286,13160,276,13436,160
2021-10-02,Tehama,103,63373,7688,7453,1279,8732,93
2021-10-02,Trinity,105,12862,790,625,196,821,10
2021-10-02,Tulare,107,460477,64024,62247,13223,75470,908
2021-10-02,Tuolumne,109,53932,6489,6369,76,6445,89
2021-10-02,Ventura,111,848112,95844,94854,4144,98998,1148
2021-10-02,Yolo,113,214977,18963,18640,901,19541,242
2021-10-02,Yuba,115,75493,9552,9370,223,9593,66
2021-10-01,Alameda,001,1643700,116064,115185,2598,117783,1343
2021-10-01,Alpine,003,1148,99,102,0,102,0
2021-10-01,Amador,005,37829,5216,5105,51,5156,61
2021-10-01,Butte,007,227075,19407,18911,3505,22416,243
2021-10-01,Calaveras,009,45235,3676,3585,42,3627,72
2021-10-01,Colusa,011,21464,2433,2403,556,2959,18
2021-10-01,Contra Costa,013,1133247,96356,95369,1991,97360,933
2021-10-01,Del Norte,015,27424,3560,3468,37,3505,39
2021-10-01,El Dorado,017,186661,15190,14887,1578,16465,136
2021-10-01,Fresno,019,978130,130913,128450,11711,140161,1964
2021-10-01,Glenn,021,27897,3304,3234,943,4177,26
2021-10-01,Humboldt,023,135768,8429,8244,433,8677,94
2021-10-01,Imperial,025,180216,32019,31674,2972,34646,757
2021-10-01,Inyo,027,18085,1808,1746,34,1780,39
2021-10-01,Kern,029,883053,120176,117962,19085,137047,1524
2021-10-01,Kings,031,150075,30043,29339,1707,31046,301
2021-10-01,Lake,033,64148,6315,6191,123,6314,97
2021-10-01,Lassen,035,31185,6482,6360,299,6659,25
2021-10-01,Los Angeles,037,10098052,1409392,1395070,51964,1447034,26126
2021-10-01,Madera,039,155013,21396,20931,1763,22694,266
2021-10-01,Marin,041,260295,17104,16936,405,17341,242
2021-10-01,Mariposa,043,17540,1045,967,33,1000,5
2021-10-01,Mendocino,045,87422,7036,6869,396,7265,78
2021-10-01,Merced,047,269075,39622,39196,1554,40750,552
2021-10-01,Modoc,049,8938,481,468,170,638,5
2021-10-01,Mono,051,14174,1585,1540,19,1559,3
2021-10-01,Monterey,053,433212,47854,46964,2640,49604,571
2021-10-01,Napa,055,140530,12559,12433,94,12527,96
2021-10-01,Nevada,057,99092,8594,8474,297,8771,87
2021-10-01,Orange,059,3164182,299964,297307,14160,311467,5435
2021-10-01,Placer,061,380077,34952,34377,3312,37689,381
2021-10-01,Plumas,063,18699,1396,1298,25,1323,6
2021-10-01,Riverside,065,2383286,352357,347227,15862,363089,4895
2021-10-01,Sacramento,067,1510023,151249,149897,3940,153837,2099
2021-10-01,San Benito,069,59416,7091,7055,146,7201,69
2021-10-01,San Bernardino,071,2135413,344057,341212,10654,351866,5540
2021-10-01,San Diego,073,3302833,359492,356454,21150,377604,4078
2021-10-01,San Francisco,075,870044,51151,50393,2154,52547,634
2021-10-01,San Joaquin,077,732212,95820,94599,5063,99662,1646
2021-10-01,San Luis Obispo,079,281455,28386,27915,1139,29054,323
2021-10-01,San Mateo,081,765935,52658,51767,786,52553,573
2021-10-01,Santa Barbara,083,443738,42805,42423,1474,43897,508
2021-10-01,Santa Clara,085,1922200,142641,141231,1138,142369,1862
2021-10-01,Santa Cruz,087,273765,19710,19461,965,20426,214
2021-10-01,Shasta,089,179085,19390,18912,3204,22116,270
2021-10-01,Sierra,091,2930,141,131,14,145,0
2021-10-01,Siskiyou,093,43540,3182,3053,1142,4195,42
2021-10-01,Solano,095,438530,44638,43800,1163,44963,321
2021-10-01,Sonoma,097,501317,39839,39497,487,39984,382
2021-10-01,Stanislaus,099,539301,74186,73859,8287,82146,1099
2021-10-01,Sutter,101,95872,13270,13160,274,13434,160
2021-10-01,Tehama,103,63373,7676,7453,1277,8730,93
2021-10-01,Trinity,105,12862,788,625,196,821,10
2021-10-01,Tulare,107,460477,63921,62247,13188,75435,908
2021-10-01,Tuolumne,109,53932,6472,6369,76,6445,89
2021-10-01,Ventura,111,848112,95777,94854,4139,98993,1148
2021-10-01,Yolo,113,214977,18939,18640,899,19539,242
2021-10-01,Yuba,115,75493,9530,9370,223,9593,66
2021-09-30,Alameda,001,1643700,115918,115185,2595,117780,1343
2021-09-30,Alpine,003,1148,99,102,0,102,0
2021-09-30,Amador,005,37829,5204,5105,51,5156,61
2021-09-30,Butte,007,227075,19358,18911,3496,22407,243
2021-09-30,Calaveras,009,45235,3662,3585,42,3627,72
2021-09-30,Colusa,011,21464,2430,2403,555,2958,18
2021-09-30,Contra Costa,013,1133247,96251,95369,1986,97355,933
2021-09-30,Del Norte,015,27424,3556,3468,34,3502,39
2021-09-30,El Dorado,017,186661,15164,14887,1570,16457,136
2021-09-30,Fresno,019,978130,130637,128450,11677,140127,1964
2021-09-30,Glenn,021,27897,3294,3234,940,4174,26
2021-09-30,Humboldt,023,135768,8397,8244,427,8671,94
2021-09-30,Imperial,025,180216,31967,31674,2970,34644,757
2021-09-30,Inyo,027,18085,1798,1746,34,1780,39
2021-09-30,Kern,029,883053,119932,117962,19004,136966,1524
2021-09-30,Kings,031,150075,29953,29339,1703,31042,301
2021-09-30,Lake,033,64148,6297,6191,123,6314,97
2021-09-30,Lassen,035,31185,6468,6360,299,6659,25
2021-09-30,Los Angeles,037,10098052,1408184,1395070,51904,1446974,26126
2021-09-30,Madera,039,155013,21313,20931,1748,22679,266
2021-09-30,Marin,041,260295,17084,16936,404,17340,242
2021-09-30,Mariposa,043,17540,1023,967,33,1000,5
2021-09-30,Mendocino,045,87422,7027,6869,387,7256,78
2021-09-30,Merced,047,269075,39526,39196,1550,40746,552
2021-09-30,Modoc,049,8938,481,468,169,637,5
2021-09-30,Mono,051,14174,1577,1540,19,1559,3
2021-09-30,Monterey,053,433212,47824,46964,2629,49593,571
2021-09-30,Napa,055,140530,12539,12433,94,12527,96
2021-09-30,Nevada,057,99092,8577,8474,296,8770,87
2021-09-30,Orange,059,3164182,299692,297307,14122,311429,5435
2021-09-30,Placer,061,380077,34898,34377,3292,37669,381
2021-09-30,Plumas,063,18699,1378,1298,25,1323,6
2021-09-30,Riverside,065,2383286,351923,347227,15841,363068,4895
2021-09-30,Sacramento,067,1510023,150988,149897,3914,153811,2099
2021-09-30,San Benito,069,59416,7085,7055,146,7201,69
2021-09-30,San Bernardino,071,2135413,343745,341212,10640,351852,5540
2021-09-30,San Diego,073,3302833,359011,356454,21124,377578,4078
2021-09-30,San Francisco,075,870044,51074,50393,2150,52543,634
2021-09-30,San Joaquin,077,732212,95690,94599,5055,99654,1646
2021-09-30,San Luis Obispo,079,281455,28338,27915,1135,29050,323
2021-09-30,San Mateo,081,765935,52609,51767,783,52550,573
2021-09-30,Santa Barbara,083,443738,42747,42423,1473,43896,508
2021-09-30,Santa Clara,085,1922200,142491,141231,1135,142366,1862
2021-09-30,Santa Cruz,087,273765,19670,19461,964,20425,214
2021-09-30,Shasta,089,179085,19328,18912,3189,22101,270
2021-09-30,Sierra,091,2930,140,131,14,145,0
2021-09-30,Siskiyou,093,43540,3174,3053,1137,4190,42
2021-09-30,Solano,095,438530,44584,43800,1160,44960,321
2021-09-30,Sonoma,097,501317,39790,39497,487,39984,382
2021-09-30,Stanislaus,099,539301,74026,73859,8268,82127,1099
2021-09-30,Sutter,101,95872,13249,13160,274,13434,160
2021-09-30,Tehama,103,63373,7639,7453,1265,8718,93
2021-09-30,Trinity,105,12862,784,625,196,821,10
2021-09-30,Tulare,107,460477,63745,62247,13131,75378,908
2021-09-30,Tuolumne,109,53932,6449,6369,76,6445,89
2021-09-30,Ventura,111,848112,95672,94854,4132,98986,1148
2021-09-30,Yolo,113,214977,18900,18640,896,19536,242
2021-09-30,Yuba,115,75493,9507,9370,222,9592,66
2021-09-29,Alameda,001,1643700,115774,114998,2592,117590,1339
2021-09-29,Alpine,003,1148,99,101,0,101,0
2021-09-29,Amador,005,37829,5182,5058,51,5109,61
2021-09-29,Butte,007,227075,19304,18835,3489,22324,242
2021-09-29,Calaveras,009,45235,3645,3553,41,3594,72
2021-09-29,Colusa,011,21464,2428,2401,555,2956,18
2021-09-29,Contra Costa,013,1133247,96137,95213,1978,97191,929
2021-09-29,Del Norte,015,27424,3550,3467,34,3501,39
2021-09-29,El Dorado,017,186661,15130,14834,1563,16397,136
2021-09-29,Fresno,019,978130,130337,128068,11656,139724,1957
2021-09-29,Glenn,021,27897,3289,3213,938,4151,26
2021-09-29,Humboldt,023,135768,8373,8203,426,8629,94
2021-09-29,Imperial,025,180216,31901,31600,2965,34565,757
2021-09-29,Inyo,027,18085,1788,1740,33,1773,39
2021-09-29,Kern,029,883053,119697,117605,18928,136533,1513
2021-09-29,Kings,031,150075,29871,29195,1688,30883,299
2021-09-29,Lake,033,64148,6277,6164,123,6287,97
2021-09-29,Lassen,035,31185,6454,6347,299,6646,25
2021-09-29,Los Angeles,037,10098052,1406965,1393617,51834,1445451,26098
2021-09-29,Madera,039,155013,21269,20818,1732,22550,266
2021-09-29,Marin,041,260295,17066,16921,402,17323,242
2021-09-29,Mariposa,043,17540,1008,963,33,996,5
2021-09-29,Mendocino,045,87422,7015,6821,379,7200,78
2021-09-29,Merced,047,269075,39432,39026,1539,40565,552
2021-09-29,Modoc,049,8938,479,468,169,637,5
2021-09-29,Mono,051,14174,1575,1527,19,1546,3
2021-09-29,Monterey,053,433212,47786,46917,2615,49532,571
2021-09-29,Napa,055,140530,12519,12416,91,12507,96
2021-09-29,Nevada,057,99092,8564,8434,296,8730,87
2021-09-29,Orange,059,3164182,299424,296936,14086,311022,5429
2021-09-29,Placer,061,380077,34834,34271,3270,37541,379
2021-09-29,Plumas,063,18699,1359,1289,25,1314,6
2021-09-29,Riverside,065,2383286,351489,346558,15828,362386,4886
2021-09-29,Sacramento,067,1510023,150737,149686,3904,153590,2099
2021-09-29,San Benito,069,59416,7074,7039,146,7185,69
2021-09-29,San Bernardino,071,2135413,343425,340672,10626,351298,5539
2021-09-29,San Diego,073,3302833,358524,355899,21094,376993,4066
2021-09-29,San Francisco,075,870044,50990,50286,2146,52432,629
2021-09-29,San Joaquin,077,732212,95532,94356,5033,99389,1645
2021-09-29,San Luis Obispo,079,281455,28292,27800,1129,28929,323
2021-09-29,San Mateo,081,765935,52549,51673,781,52454,573
2021-09-29,Santa Barbara,083,443738,42675,42328,1470,43798,507
2021-09-29,Santa Clara,085,1922200,142356,141036,1129,142165,1861
2021-09-29,Santa Cruz,087,273765,19652,19425,963,20388,214
2021-09-29,Shasta,089,179085,19262,18805,3178,21983,271
2021-09-29,Sierra,091,2930,136,130,14,144,0
2021-09-29,Siskiyou,093,43540,3161,3043,1130,4173,42
2021-09-29,Solano,095,438530,44528,43724,1153,44877,321
2021-09-29,Sonoma,097,501317,39729,39426,485,39911,370
2021-09-29,Stanislaus,099,539301,73895,73634,8257,81891,1096
2021-09-29,Sutter,101,95872,13222,13135,271,13406,155
2021-09-29,Tehama,103,63373,7609,7409,1250,8659,88
2021-09-29,Trinity,105,12862,780,616,196,812,10
2021-09-29,Tulare,107,460477,63571,62046,13072,75118,908
2021-09-29,Tuolumne,109,53932,6432,6336,76,6412,89
2021-09-29,Ventura,111,848112,95582,94753,4128,98881,1144
2021-09-29,Yolo,113,214977,18867,18587,891,19478,239
2021-09-29,Yuba,115,75493,9476,9351,218,9569,66
2021-09-28,Alameda,001,1643700,115616,114869,2586,117455,1333
2021-09-28,Alpine,003,1148,99,101,0,101,0
2021-09-28,Amador,005,37829,5160,5049,51,5100,61
2021-09-28,Butte,007,227075,19255,18764,3474,22238,241
2021-09-28,Calaveras,009,45235,3625,3530,41,3571,72
2021-09-28,Colusa,011,21464,2425,2399,553,2952,18
2021-09-28,Contra Costa,013,1133247,95996,95115,1973,97088,929
2021-09-28,Del Norte,015,27424,3547,3462,34,3496,39
2021-09-28,El Dorado,017,186661,15084,14793,1559,16352,133
2021-09-28,Fresno,019,978130,129992,127877,11622,139499,1948
2021-09-28,Glenn,021,27897,3284,3205,937,4142,26
2021-09-28,Humboldt,023,135768,8332,8159,423,8582,91
2021-09-28,Imperial,025,180216,31856,31543,2961,34504,757
2021-09-28,Inyo,027,18085,1774,1708,32,1740,39
2021-09-28,Kern,029,883053,119428,117420,18833,136253,1506
2021-09-28,Kings,031,150075,29769,29141,1680,30821,295
2021-09-28,Lake,033,64148,6262,6155,123,6278,95
2021-09-28,Lassen,035,31185,6448,6340,295,6635,25
2021-09-28,Los Angeles,037,10098052,1405676,1392445,51766,1444211,26068
2021-09-28,Madera,039,155013,21215,20764,1717,22481,266
2021-09-28,Marin,041,260295,17047,16887,400,17287,242
2021-09-28,Mariposa,043,17540,1003,952,33,985,5
2021-09-28,Mendocino,045,87422,6993,6804,377,7181,78
2021-09-28,Merced,047,269075,39346,38953,1526,40479,551
2021-09-28,Modoc,049,8938,478,467,169,636,5
2021-09-28,Mono,051,14174,1565,1527,19,1546,3
2021-09-28,Monterey,053,433212,47749,46859,2606,49465,571
2021-09-28,Napa,055,140530,12502,12388,90,12478,96
2021-09-28,Nevada,057,99092,8541,8409,295,8704,84
2021-09-28,Orange,059,3164182,299171,296596,14057,310653,5421
2021-09-28,Placer,061,380077,34769,34187,3252,37439,370
2021-09-28,Plumas,063,18699,1350,1276,25,1301,6
2021-09-28,Riverside,065,2383286,351030,346096,15807,361903,4874
2021-09-28,Sacramento,067,1510023,150447,149310,3882,153192,2086
2021-09-28,San Benito,069,59416,7057,7028,145,7173,69
2021-09-28,San Bernardino,071,2135413,343078,340342,10609,350951,5540
2021-09-28,San Diego,073,3302833,357977,355373,21062,376435,4054
2021-09-28,San Francisco,075,870044,50889,50234,2145,52379,627
2021-09-28,San Joaquin,077,732212,95378,94194,5020,99214,1639
2021-09-28,San Luis Obispo,079,281455,28258,27755,1124,28879,321
2021-09-28,San Mateo,081,765935,52504,51620,781,52401,571
2021-09-28,Santa Barbara,083,443738,42602,42226,1469,43695,506
2021-09-28,Santa Clara,085,1922200,142195,140886,1120,142006,1858
2021-09-28,Santa Cruz,087,273765,19611,19324,962,20286,214
2021-09-28,Shasta,089,179085,19201,18701,3164,21865,267
2021-09-28,Sierra,091,2930,135,130,13,143,0
2021-09-28,Siskiyou,093,43540,3149,3032,1127,4159,42
2021-09-28,Solano,095,438530,44455,43652,1150,44802,316
2021-09-28,Sonoma,097,501317,39682,39395,484,39879,370
2021-09-28,Stanislaus,099,539301,73724,73528,8245,81773,1094
2021-09-28,Sutter,101,95872,13203,13102,267,13369,155
2021-09-28,Tehama,103,63373,7591,7382,1235,8617,88
2021-09-28,Trinity,105,12862,777,613,196,809,10
2021-09-28,Tulare,107,460477,63410,61916,13014,74930,905
2021-09-28,Tuolumne,109,53932,6406,6308,76,6384,89
2021-09-28,Ventura,111,848112,95456,94632,4125,98757,1143
2021-09-28,Yolo,113,214977,18841,18564,887,19451,239
2021-09-28,Yuba,115,75493,9457,9323,217,9540,66
2021-09-27,Alameda,001,1643700,115422,114731,2577,117308,1327
2021-09-27,Alpine,003,1148,99,101,0,101,0
2021-09-27,Amador,005,37829,5146,5017,51,5068,59
2021-09-27,Butte,007,227075,19195,18687,3457,22144,239
2021-09-27,Calaveras,009,45235,3605,3514,40,3554,70
2021-09-27,Colusa,011,21464,2424,2393,552,2945,18
2021-09-27,Contra Costa,013,1133247,95865,94979,1964,96943,924
2021-09-27,Del Norte,015,27424,3545,3468,32,3500,37
2021-09-27,El Dorado,017,186661,15045,14764,1552,16316,132
2021-09-27,Fresno,019,978130,129672,127475,11589,139064,1942
2021-09-27,Glenn,021,27897,3271,3189,933,4122,26
2021-09-27,Humboldt,023,135768,8292,8118,423,8541,91
2021-09-27,Imperial,025,180216,31793,31491,2954,34445,756
2021-09-27,Inyo,027,18085,1762,1698,32,1730,39
2021-09-27,Kern,029,883053,119153,117064,18738,135802,1503
2021-09-27,Kings,031,150075,29671,28998,1668,30666,297
2021-09-27,Lake,033,64148,6242,6126,122,6248,95
2021-09-27,Lassen,035,31185,6433,6327,291,6618,25
2021-09-27,Los Angeles,037,10098052,1404339,1391538,51698,1443236,26040
2021-09-27,Madera,039,155013,21150,20691,1709,22400,262
2021-09-27,Marin,041,260295,17026,16861,399,17260,242
2021-09-27,Mariposa,043,17540,993,931,33,964,5
2021-09-27,Mendocino,045,87422,6967,6761,370,7131,74
2021-09-27,Merced,047,269075,39246,38840,1520,40360,548
2021-09-27,Modoc,049,8938,477,465,167,632,5
2021-09-27,Mono,051,14174,1553,1525,19,1544,3
2021-09-27,Monterey,053,433212,47706,46811,2595,49406,571
2021-09-27,Napa,055,140530,12478,12354,89,12443,95
2021-09-27,Nevada,057,99092,8517,8379,292,8671,84
2021-09-27,Orange,059,3164182,298865,296334,14027,310361,5409
2021-09-27,Placer,061,380077,34682,34087,3247,37334,370
2021-09-27,Plumas,063,18699,1340,1269,25,1294,6
2021-09-27,Riverside,065,2383286,350588,345529,15797,361326,4864
2021-09-27,Sacramento,067,1510023,150130,149096,3860,152956,2076
2021-09-27,San Benito,069,59416,7040,7017,145,7162,67
2021-09-27,San Bernardino,071,2135413,342664,339952,10585,350537,5544
2021-09-27,San Diego,073,3302833,357325,354755,21037,375792,4054
2021-09-27,San Francisco,075,870044,50805,50157,2142,52299,622
2021-09-27,San Joaquin,077,732212,95194,94085,5017,99102,1633
2021-09-27,San Luis Obispo,079,281455,28203,27674,1121,28795,320
2021-09-27,San Mateo,081,765935,52428,51552,781,52333,571
2021-09-27,Santa Barbara,083,443738,42535,42012,1465,43477,505
2021-09-27,Santa Clara,085,1922200,142014,140802,1110,141912,1853
2021-09-27,Santa Cruz,087,273765,19587,19292,961,20253,214
2021-09-27,Shasta,089,179085,19120,18599,3137,21736,267
2021-09-27,Sierra,091,2930,135,128,13,141,0
2021-09-27,Siskiyou,093,43540,3137,3015,1122,4137,42
2021-09-27,Solano,095,438530,44380,43582,1144,44726,314
2021-09-27,Sonoma,097,501317,39628,39347,484,39831,370
2021-09-27,Stanislaus,099,539301,73570,73370,8225,81595,1091
2021-09-27,Sutter,101,95872,13172,13082,264,13346,155
2021-09-27,Tehama,103,63373,7551,7345,1226,8571,88
2021-09-27,Trinity,105,12862,766,605,195,800,9
2021-09-27,Tulare,107,460477,63211,61708,12943,74651,904
2021-09-27,Tuolumne,109,53932,6385,6264,76,6340,89
2021-09-27,Ventura,111,848112,95331,94477,4121,98598,1138
2021-09-27,Yolo,113,214977,18807,18524,886,19410,239
2021-09-27,Yuba,115,75493,9420,9292,213,9505,64
2021-09-26,Alameda,001,1643700,115227,114601,2570,117171,1326
2021-09-26,Alpine,003,1148,99,101,0,101,0
2021-09-26,Amador,005,37829,5114,5001,50,5051,59
2021-09-26,Butte,007,227075,19120,18634,3439,22073,238
2021-09-26,Calaveras,009,45235,3583,3505,40,3545,70
2021-09-26,Colusa,011,21464,2419,2392,550,2942,18
2021-09-26,Contra Costa,013,1133247,95690,94877,1951,96828,924
2021-09-26,Del Norte,015,27424,3540,3466,31,3497,37
2021-09-26,El Dorado,017,186661,15003,14738,1544,16282,132
2021-09-26,Fresno,019,978130,129315,127235,11543,138778,1939
2021-09-26,Glenn,021,27897,3263,3182,929,4111,26
2021-09-26,Humboldt,023,135768,8257,8098,422,8520,91
2021-09-26,Imperial,025,180216,31733,31462,2953,34415,756
2021-09-26,Inyo,027,18085,1747,1685,32,1717,39
2021-09-26,Kern,029,883053,118815,116927,18628,135555,1502
2021-09-26,Kings,031,150075,29570,28930,1657,30587,293
2021-09-26,Lake,033,64148,6225,6113,122,6235,95
2021-09-26,Lassen,035,31185,6423,6319,286,6605,25
2021-09-26,Los Angeles,037,10098052,1402850,1390577,51629,1442206,26035
2021-09-26,Madera,039,155013,21075,20629,1690,22319,262
2021-09-26,Marin,041,260295,17003,16860,399,17259,242
2021-09-26,Mariposa,043,17540,987,929,33,962,5
2021-09-26,Mendocino,045,87422,6933,6744,355,7099,74
2021-09-26,Merced,047,269075,39085,38717,1512,40229,548
2021-09-26,Modoc,049,8938,477,465,166,631,5
2021-09-26,Mono,051,14174,1549,1516,19,1535,3
2021-09-26,Monterey,053,433212,47659,46792,2582,49374,571
2021-09-26,Napa,055,140530,12454,12340,88,12428,95
2021-09-26,Nevada,057,99092,8486,8356,287,8643,84
2021-09-26,Orange,059,3164182,298526,296085,13994,310079,5409
2021-09-26,Placer,061,380077,34588,34043,3238,37281,370
2021-09-26,Plumas,063,18699,1322,1268,25,1293,6
2021-09-26,Riverside,065,2383286,350056,345257,15783,361040,4864
2021-09-26,Sacramento,067,1510023,149724,148745,3841,152586,2071
2021-09-26,San Benito,069,59416,7023,7012,144,7156,67
2021-09-26,San Bernardino,071,2135413,342207,339771,10571,350342,5545
2021-09-26,San Diego,073,3302833,356703,354414,20996,375410,4051
2021-09-26,San Francisco,075,870044,50679,50092,2133,52225,622
2021-09-26,San Joaquin,077,732212,94991,93935,5003,98938,1633
2021-09-26,San Luis Obispo,079,281455,28129,27624,1116,28740,319
2021-09-26,San Mateo,081,765935,52359,51496,779,52275,571
2021-09-26,Santa Barbara,083,443738,42449,41946,1462,43408,505
2021-09-26,Santa Clara,085,1922200,141813,140667,1107,141774,1852
2021-09-26,Santa Cruz,087,273765,19562,19279,961,20240,214
2021-09-26,Shasta,089,179085,19011,18566,3114,21680,266
2021-09-26,Sierra,091,2930,135,128,13,141,0
2021-09-26,Siskiyou,093,43540,3123,2998,1112,4110,42
2021-09-26,Solano,095,438530,44313,43537,1143,44680,314
2021-09-26,Sonoma,097,501317,39569,39302,484,39786,370
2021-09-26,Stanislaus,099,539301,73370,73243,8197,81440,1091
2021-09-26,Sutter,101,95872,13135,13045,263,13308,155
2021-09-26,Tehama,103,63373,7494,7323,1215,8538,88
2021-09-26,Trinity,105,12862,763,591,195,786,9
2021-09-26,Tulare,107,460477,62990,61560,12866,74426,904
2021-09-26,Tuolumne,109,53932,6357,6236,74,6310,89
2021-09-26,Ventura,111,848112,95217,94391,4114,98505,1138
2021-09-26,Yolo,113,214977,18770,18496,878,19374,239
2021-09-26,Yuba,115,75493,9393,9275,213,9488,64
2021-09-25,Alameda,001,1643700,115148,114014,2567,116581,1324
2021-09-25,Alpine,003,1148,99,101,0,101,0
2021-09-25,Amador,005,37829,5100,4934,50,4984,59
2021-09-25,Butte,007,227075,19091,18396,3431,21827,236
2021-09-25,Calaveras,009,45235,3580,3461,40,3501,70
2021-09-25,Colusa,011,21464,2416,2387,548,2935,16
2021-09-25,Contra Costa,013,1133247,95619,94337,1947,96284,924
2021-09-25,Del Norte,015,27424,3539,3404,31,3435,35
2021-09-25,El Dorado,017,186661,14980,14641,1540,16181,130
2021-09-25,Fresno,019,978130,129170,126299,11527,137826,1927
2021-09-25,Glenn,021,27897,3258,3144,928,4072,25
2021-09-25,Humboldt,023,135768,8238,8014,420,8434,88
2021-09-25,Imperial,025,180216,31706,31280,2953,34233,755
2021-09-25,Inyo,027,18085,1739,1657,32,1689,39
2021-09-25,Kern,029,883053,118660,116021,18561,134582,1485
2021-09-25,Kings,031,150075,29519,28636,1654,30290,293
2021-09-25,Lake,033,64148,6220,6046,120,6166,92
2021-09-25,Lassen,035,31185,6411,6248,285,6533,25
2021-09-25,Los Angeles,037,10098052,1402140,1386417,51588,1438005,25964
2021-09-25,Madera,039,155013,21050,20432,1684,22116,262
2021-09-25,Marin,041,260295,16994,16802,397,17199,242
2021-09-25,Mariposa,043,17540,982,906,33,939,5
2021-09-25,Mendocino,045,87422,6914,6657,354,7011,74
2021-09-25,Merced,047,269075,39039,38393,1510,39903,546
2021-09-25,Modoc,049,8938,477,460,166,626,5
2021-09-25,Mono,051,14174,1546,1501,19,1520,3
2021-09-25,Monterey,053,433212,47629,46653,2580,49233,567
2021-09-25,Napa,055,140530,12434,12266,88,12354,95
2021-09-25,Nevada,057,99092,8469,8285,287,8572,84
2021-09-25,Orange,059,3164182,298353,294514,13977,308491,5374
2021-09-25,Placer,061,380077,34524,33764,3236,37000,367
2021-09-25,Plumas,063,18699,1318,1238,25,1263,6
2021-09-25,Riverside,065,2383286,349733,343463,15775,359238,4843
2021-09-25,Sacramento,067,1510023,149549,147728,3833,151561,2049
2021-09-25,San Benito,069,59416,7018,6965,144,7109,67
2021-09-25,San Bernardino,071,2135413,341970,338413,10558,348971,5540
2021-09-25,San Diego,073,3302833,356358,352017,20970,372987,4039
2021-09-25,San Francisco,075,870044,50635,49840,2132,51972,615
2021-09-25,San Joaquin,077,732212,94905,93273,5001,98274,1628
2021-09-25,San Luis Obispo,079,281455,28091,27447,1112,28559,318
2021-09-25,San Mateo,081,765935,52295,51266,777,52043,568
2021-09-25,Santa Barbara,083,443738,42391,41728,1462,43190,505
2021-09-25,Santa Clara,085,1922200,141707,140023,1105,141128,1844
2021-09-25,Santa Cruz,087,273765,19546,19200,959,20159,214
2021-09-25,Shasta,089,179085,18960,18256,3105,21361,262
2021-09-25,Sierra,091,2930,134,127,13,140,0
2021-09-25,Siskiyou,093,43540,3116,2956,1102,4058,41
2021-09-25,Solano,095,438530,44272,43331,1140,44471,312
2021-09-25,Sonoma,097,501317,39528,39112,484,39596,369
2021-09-25,Stanislaus,099,539301,73260,72628,8183,80811,1091
2021-09-25,Sutter,101,95872,13117,12976,260,13236,154
2021-09-25,Tehama,103,63373,7478,7200,1213,8413,86
2021-09-25,Trinity,105,12862,763,576,195,771,9
2021-09-25,Tulare,107,460477,62908,60909,12823,73732,898
2021-09-25,Tuolumne,109,53932,6345,6168,74,6242,89
2021-09-25,Ventura,111,848112,95150,94059,4110,98169,1129
2021-09-25,Yolo,113,214977,18748,18393,877,19270,239
2021-09-25,Yuba,115,75493,9373,9191,213,9404,61
2021-09-24,Alameda,001,1643700,115043,114014,2563,116577,1324
2021-09-24,Alpine,003,1148,99,101,0,101,0
2021-09-24,Amador,005,37829,5070,4934,50,4984,59
2021-09-24,Butte,007,227075,19039,18396,3420,21816,236
2021-09-24,Calaveras,009,45235,3573,3461,39,3500,70
2021-09-24,Colusa,011,21464,2413,2387,547,2934,16
2021-09-24,Contra Costa,013,1133247,95509,94337,1943,96280,924
2021-09-24,Del Norte,015,27424,3536,3404,31,3435,35
2021-09-24,El Dorado,017,186661,14962,14641,1538,16179,130
2021-09-24,Fresno,019,978130,128972,126299,11515,137814,1927
2021-09-24,Glenn,021,27897,3250,3144,928,4072,25
2021-09-24,Humboldt,023,135768,8219,8014,417,8431,88
2021-09-24,Imperial,025,180216,31668,31280,2951,34231,755
2021-09-24,Inyo,027,18085,1730,1657,32,1689,39
2021-09-24,Kern,029,883053,118524,116021,18495,134516,1485
2021-09-24,Kings,031,150075,29478,28636,1650,30286,293
2021-09-24,Lake,033,64148,6212,6046,120,6166,92
2021-09-24,Lassen,035,31185,6403,6248,284,6532,25
2021-09-24,Los Angeles,037,10098052,1401254,1386417,51546,1437963,25964
2021-09-24,Madera,039,155013,21019,20432,1675,22107,262
2021-09-24,Marin,041,260295,16980,16802,396,17198,242
2021-09-24,Mariposa,043,17540,970,906,33,939,5
2021-09-24,Mendocino,045,87422,6901,6657,354,7011,74
2021-09-24,Merced,047,269075,38995,38393,1510,39903,546
2021-09-24,Modoc,049,8938,477,460,165,625,5
2021-09-24,Mono,051,14174,1541,1501,19,1520,3
2021-09-24,Monterey,053,433212,47608,46653,2572,49225,567
2021-09-24,Napa,055,140530,12415,12266,88,12354,95
2021-09-24,Nevada,057,99092,8455,8285,284,8569,84
2021-09-24,Orange,059,3164182,298146,294514,13959,308473,5374
2021-09-24,Placer,061,380077,34469,33764,3224,36988,367
2021-09-24,Plumas,063,18699,1314,1238,25,1263,6
2021-09-24,Riverside,065,2383286,349399,343463,15768,359231,4843
2021-09-24,Sacramento,067,1510023,149364,147728,3829,151557,2049
2021-09-24,San Benito,069,59416,7012,6965,144,7109,67
2021-09-24,San Bernardino,071,2135413,341702,338413,10548,348961,5540
2021-09-24,San Diego,073,3302833,356007,352017,20955,372972,4039
2021-09-24,San Francisco,075,870044,50571,49840,2125,51965,615
2021-09-24,San Joaquin,077,732212,94792,93273,4999,98272,1628
2021-09-24,San Luis Obispo,079,281455,28060,27447,1107,28554,318
2021-09-24,San Mateo,081,765935,52235,51266,776,52042,568
2021-09-24,Santa Barbara,083,443738,42351,41728,1461,43189,505
2021-09-24,Santa Clara,085,1922200,141595,140023,1104,141127,1844
2021-09-24,Santa Cruz,087,273765,19523,19200,958,20158,214
2021-09-24,Shasta,089,179085,18906,18256,3091,21347,262
2021-09-24,Sierra,091,2930,133,127,13,140,0
2021-09-24,Siskiyou,093,43540,3107,2956,1096,4052,41
2021-09-24,Solano,095,438530,44235,43331,1138,44469,312
2021-09-24,Sonoma,097,501317,39495,39112,484,39596,369
2021-09-24,Stanislaus,099,539301,73144,72628,8168,80796,1091
2021-09-24,Sutter,101,95872,13098,12976,259,13235,154
2021-09-24,Tehama,103,63373,7466,7200,1208,8408,86
2021-09-24,Trinity,105,12862,760,576,195,771,9
2021-09-24,Tulare,107,460477,62817,60909,12781,73690,898
2021-09-24,Tuolumne,109,53932,6316,6168,74,6242,89
2021-09-24,Ventura,111,848112,95072,94059,4103,98162,1129
2021-09-24,Yolo,113,214977,18716,18393,873,19266,239
2021-09-24,Yuba,115,75493,9354,9191,213,9404,61
2021-09-23,Alameda,001,1643700,114885,114014,2557,116571,1324
2021-09-23,Alpine,003,1148,99,101,0,101,0
2021-09-23,Amador,005,37829,5057,4934,50,4984,59
2021-09-23,Butte,007,227075,18977,18396,3395,21791,236
2021-09-23,Calaveras,009,45235,3552,3461,39,3500,70
2021-09-23,Colusa,011,21464,2411,2387,544,2931,16
2021-09-23,Contra Costa,013,1133247,95368,94337,1936,96273,924
2021-09-23,Del Norte,015,27424,3527,3404,30,3434,35
2021-09-23,El Dorado,017,186661,14936,14641,1532,16173,130
2021-09-23,Fresno,019,978130,128675,126299,11496,137795,1927
2021-09-23,Glenn,021,27897,3236,3144,925,4069,25
2021-09-23,Humboldt,023,135768,8194,8014,415,8429,88
2021-09-23,Imperial,025,180216,31632,31280,2951,34231,755
2021-09-23,Inyo,027,18085,1716,1657,32,1689,39
2021-09-23,Kern,029,883053,118266,116021,18415,134436,1485
2021-09-23,Kings,031,150075,29374,28636,1641,30277,293
2021-09-23,Lake,033,64148,6202,6046,120,6166,92
2021-09-23,Lassen,035,31185,6394,6248,279,6527,25
2021-09-23,Los Angeles,037,10098052,1400059,1386417,51482,1437899,25964
2021-09-23,Madera,039,155013,20935,20432,1671,22103,262
2021-09-23,Marin,041,260295,16965,16802,393,17195,242
2021-09-23,Mariposa,043,17540,957,906,33,939,5
2021-09-23,Mendocino,045,87422,6878,6657,349,7006,74
2021-09-23,Merced,047,269075,38891,38393,1503,39896,546
2021-09-23,Modoc,049,8938,476,460,165,625,5
2021-09-23,Mono,051,14174,1538,1501,19,1520,3
2021-09-23,Monterey,053,433212,47559,46653,2561,49214,567
2021-09-23,Napa,055,140530,12398,12266,88,12354,95
2021-09-23,Nevada,057,99092,8428,8285,284,8569,84
2021-09-23,Orange,059,3164182,297849,294514,13935,308449,5374
2021-09-23,Placer,061,380077,34393,33764,3218,36982,367
2021-09-23,Plumas,063,18699,1297,1238,24,1262,6
2021-09-23,Riverside,065,2383286,348946,343463,15761,359224,4843
2021-09-23,Sacramento,067,1510023,149041,147728,3810,151538,2049
2021-09-23,San Benito,069,59416,7001,6965,144,7109,67
2021-09-23,San Bernardino,071,2135413,341337,338413,10533,348946,5540
2021-09-23,San Diego,073,3302833,355551,352017,20916,372933,4039
2021-09-23,San Francisco,075,870044,50498,49840,2123,51963,615
2021-09-23,San Joaquin,077,732212,94619,93273,4984,98257,1628
2021-09-23,San Luis Obispo,079,281455,28017,27447,1105,28552,318
2021-09-23,San Mateo,081,765935,52160,51266,775,52041,568
2021-09-23,Santa Barbara,083,443738,42273,41728,1458,43186,505
2021-09-23,Santa Clara,085,1922200,141443,140023,1097,141120,1844
2021-09-23,Santa Cruz,087,273765,19492,19200,958,20158,214
2021-09-23,Shasta,089,179085,18826,18256,3074,21330,262
2021-09-23,Sierra,091,2930,133,127,13,140,0
2021-09-23,Siskiyou,093,43540,3103,2956,1085,4041,41
2021-09-23,Solano,095,438530,44167,43331,1135,44466,312
2021-09-23,Sonoma,097,501317,39436,39112,481,39593,369
2021-09-23,Stanislaus,099,539301,72987,72628,8136,80764,1091
2021-09-23,Sutter,101,95872,13069,12976,259,13235,154
2021-09-23,Tehama,103,63373,7425,7200,1203,8403,86
2021-09-23,Trinity,105,12862,746,576,194,770,9
2021-09-23,Tulare,107,460477,62640,60909,12727,73636,898
2021-09-23,Tuolumne,109,53932,6291,6168,73,6241,89
2021-09-23,Ventura,111,848112,94968,94059,4096,98155,1129
2021-09-23,Yolo,113,214977,18685,18393,868,19261,239
2021-09-23,Yuba,115,75493,9325,9191,212,9403,61
2021-09-22,Alameda,001,1643700,114729,113862,2553,116415,1322
2021-09-22,Alpine,003,1148,99,100,0,100,0
2021-09-22,Amador,005,37829,5041,4915,50,4965,59
2021-09-22,Butte,007,227075,18916,18337,3377,21714,235
2021-09-22,Calaveras,009,45235,3536,3448,39,3487,70
2021-09-22,Colusa,011,21464,2406,2384,543,2927,16
2021-09-22,Contra Costa,013,1133247,95182,94209,1927,96136,924
2021-09-22,Del Norte,015,27424,3516,3386,29,3415,35
2021-09-22,El Dorado,017,186661,14900,14605,1526,16131,127
2021-09-22,Fresno,019,978130,128419,126006,11481,137487,1908
2021-09-22,Glenn,021,27897,3229,3138,924,4062,25
2021-09-22,Humboldt,023,135768,8172,7998,407,8405,80
2021-09-22,Imperial,025,180216,31580,31243,2944,34187,755
2021-09-22,Inyo,027,18085,1706,1651,32,1683,39
2021-09-22,Kern,029,883053,118025,115757,18293,134050,1477
2021-09-22,Kings,031,150075,29289,28589,1635,30224,292
2021-09-22,Lake,033,64148,6190,6035,120,6155,93
2021-09-22,Lassen,035,31185,6374,6209,275,6484,25
2021-09-22,Los Angeles,037,10098052,1398736,1384719,51427,1436146,25930
2021-09-22,Madera,039,155013,20878,20382,1661,22043,262
2021-09-22,Marin,041,260295,16954,16782,390,17172,242
2021-09-22,Mariposa,043,17540,951,901,33,934,5
2021-09-22,Mendocino,045,87422,6851,6624,343,6967,70
2021-09-22,Merced,047,269075,38758,38305,1501,39806,541
2021-09-22,Modoc,049,8938,473,458,165,623,5
2021-09-22,Mono,051,14174,1529,1496,18,1514,3
2021-09-22,Monterey,053,433212,47508,46615,2554,49169,566
2021-09-22,Napa,055,140530,12375,12248,87,12335,95
2021-09-22,Nevada,057,99092,8405,8273,281,8554,84
2021-09-22,Orange,059,3164182,297573,294214,13918,308132,5366
2021-09-22,Placer,061,380077,34305,33661,3205,36866,367
2021-09-22,Plumas,063,18699,1284,1230,24,1254,6
2021-09-22,Riverside,065,2383286,348411,342946,15736,358682,4830
2021-09-22,Sacramento,067,1510023,148736,147533,3781,151314,2043
2021-09-22,San Benito,069,59416,6990,6961,142,7103,67
2021-09-22,San Bernardino,071,2135413,340944,337938,10524,348462,5528
2021-09-22,San Diego,073,3302833,355100,351132,20892,372024,4027
2021-09-22,San Francisco,075,870044,50413,49734,2118,51852,610
2021-09-22,San Joaquin,077,732212,94388,93010,4960,97970,1626
2021-09-22,San Luis Obispo,079,281455,27967,27398,1101,28499,315
2021-09-22,San Mateo,081,765935,52087,51197,771,51968,568
2021-09-22,Santa Barbara,083,443738,42210,41678,1457,43135,504
2021-09-22,Santa Clara,085,1922200,141279,139803,1090,140893,1844
2021-09-22,Santa Cruz,087,273765,19454,19177,958,20135,214
2021-09-22,Shasta,089,179085,18736,18153,3063,21216,260
2021-09-22,Sierra,091,2930,133,127,13,140,0
2021-09-22,Siskiyou,093,43540,3086,2947,1075,4022,41
2021-09-22,Solano,095,438530,44102,43269,1134,44403,312
2021-09-22,Sonoma,097,501317,39383,39063,480,39543,369
2021-09-22,Stanislaus,099,539301,72822,72355,8117,80472,1091
2021-09-22,Sutter,101,95872,13049,12960,256,13216,153
2021-09-22,Tehama,103,63373,7398,7173,1200,8373,86
2021-09-22,Trinity,105,12862,745,572,194,766,9
2021-09-22,Tulare,107,460477,62429,60776,12658,73434,896
2021-09-22,Tuolumne,109,53932,6270,6155,72,6227,89
2021-09-22,Ventura,111,848112,94863,93978,4091,98069,1122
2021-09-22,Yolo,113,214977,18646,18342,861,19203,239
2021-09-22,Yuba,115,75493,9296,9169,207,9376,61
2021-09-21,Alameda,001,1643700,114575,113765,2553,116318,1321
2021-09-21,Alpine,003,1148,99,100,0,100,0
2021-09-21,Amador,005,37829,5019,4897,50,4947,59
2021-09-21,Butte,007,227075,18820,18229,3338,21567,232
2021-09-21,Calaveras,009,45235,3519,3437,39,3476,70
2021-09-21,Colusa,011,21464,2403,2378,542,2920,16
2021-09-21,Contra Costa,013,1133247,94988,94101,1913,96014,924
2021-09-21,Del Norte,015,27424,3504,3378,29,3407,34
2021-09-21,El Dorado,017,186661,14870,14578,1519,16097,127
2021-09-21,Fresno,019,978130,128068,125789,11454,137243,1892
2021-09-21,Glenn,021,27897,3222,3134,920,4054,25
2021-09-21,Humboldt,023,135768,8140,7955,402,8357,80
2021-09-21,Imperial,025,180216,31524,31185,2942,34127,755
2021-09-21,Inyo,027,18085,1696,1646,32,1678,39
2021-09-21,Kern,029,883053,117732,115534,18180,133714,1467
2021-09-21,Kings,031,150075,29201,28545,1627,30172,291
2021-09-21,Lake,033,64148,6167,6013,120,6133,90
2021-09-21,Lassen,035,31185,6356,6159,271,6430,25
2021-09-21,Los Angeles,037,10098052,1397280,1383277,51372,1434649,25893
2021-09-21,Madera,039,155013,20818,20317,1651,21968,262
2021-09-21,Marin,041,260295,16939,16748,389,17137,242
2021-09-21,Mariposa,043,17540,946,894,32,926,5
2021-09-21,Mendocino,045,87422,6813,6580,332,6912,68
2021-09-21,Merced,047,269075,38636,38225,1497,39722,539
2021-09-21,Modoc,049,8938,470,458,165,623,5
2021-09-21,Mono,051,14174,1527,1495,17,1512,3
2021-09-21,Monterey,053,433212,47440,46583,2542,49125,565
2021-09-21,Napa,055,140530,12354,12238,87,12325,95
2021-09-21,Nevada,057,99092,8378,8259,273,8532,84
2021-09-21,Orange,059,3164182,297242,293898,13888,307786,5357
2021-09-21,Placer,061,380077,34204,33609,3194,36803,365
2021-09-21,Plumas,063,18699,1277,1225,24,1249,5
2021-09-21,Riverside,065,2383286,347851,342460,15712,358172,4817
2021-09-21,Sacramento,067,1510023,148355,147378,3753,151131,2027
2021-09-21,San Benito,069,59416,6979,6950,141,7091,67
2021-09-21,San Bernardino,071,2135413,340507,337387,10507,347894,5520
2021-09-21,San Diego,073,3302833,354494,350265,20866,371131,4021
2021-09-21,San Francisco,075,870044,50316,49653,2114,51767,609
2021-09-21,San Joaquin,077,732212,94154,92762,4949,97711,1621
2021-09-21,San Luis Obispo,079,281455,27908,27318,1097,28415,314
2021-09-21,San Mateo,081,765935,52018,51136,771,51907,568
2021-09-21,Santa Barbara,083,443738,42141,41644,1453,43097,503
2021-09-21,Santa Clara,085,1922200,141062,139657,1086,140743,1843
2021-09-21,Santa Cruz,087,273765,19424,19140,957,20097,212
2021-09-21,Shasta,089,179085,18608,18027,3039,21066,258
2021-09-21,Sierra,091,2930,133,127,13,140,0
2021-09-21,Siskiyou,093,43540,3072,2927,1061,3988,36
2021-09-21,Solano,095,438530,44026,43220,1134,44354,311
2021-09-21,Sonoma,097,501317,39330,39042,480,39522,369
2021-09-21,Stanislaus,099,539301,72638,72211,8097,80308,1091
2021-09-21,Sutter,101,95872,13026,12930,253,13183,153
2021-09-21,Tehama,103,63373,7352,7151,1196,8347,85
2021-09-21,Trinity,105,12862,734,572,192,764,9
2021-09-21,Tulare,107,460477,62214,60607,12597,73204,896
2021-09-21,Tuolumne,109,53932,6237,6139,72,6211,89
2021-09-21,Ventura,111,848112,94758,93818,4083,97901,1120
2021-09-21,Yolo,113,214977,18610,18313,858,19171,239
2021-09-21,Yuba,115,75493,9268,9135,207,9342,61
2021-09-20,Alameda,001,1643700,114394,113637,2549,116186,1320
2021-09-20,Alpine,003,1148,99,100,0,100,0
2021-09-20,Amador,005,37829,5001,4883,49,4932,59
2021-09-20,Butte,007,227075,18738,18135,3323,21458,231
2021-09-20,Calaveras,009,45235,3497,3395,38,3433,66
2021-09-20,Colusa,011,21464,2401,2376,539,2915,16
2021-09-20,Contra Costa,013,1133247,94838,93919,1907,95826,924
2021-09-20,Del Norte,015,27424,3496,3374,28,3402,34
2021-09-20,El Dorado,017,186661,14837,14545,1507,16052,127
2021-09-20,Fresno,019,978130,127655,125287,11428,136715,1889
2021-09-20,Glenn,021,27897,3211,3112,917,4029,25
2021-09-20,Humboldt,023,135768,8104,7938,397,8335,80
2021-09-20,Imperial,025,180216,31441,31146,2941,34087,755
2021-09-20,Inyo,027,18085,1688,1641,31,1672,39
2021-09-20,Kern,029,883053,117393,115271,18049,133320,1459
2021-09-20,Kings,031,150075,29114,28471,1621,30092,285
2021-09-20,Lake,033,64148,6152,5984,119,6103,87
2021-09-20,Lassen,035,31185,6326,6132,271,6403,25
2021-09-20,Los Angeles,037,10098052,1395757,1382206,51292,1433498,25858
2021-09-20,Madera,039,155013,20765,20203,1644,21847,257
2021-09-20,Marin,041,260295,16914,16732,387,17119,242
2021-09-20,Mariposa,043,17540,935,887,32,919,5
2021-09-20,Mendocino,045,87422,6779,6568,327,6895,67
2021-09-20,Merced,047,269075,38525,38144,1486,39630,536
2021-09-20,Modoc,049,8938,469,457,163,620,5
2021-09-20,Mono,051,14174,1521,1480,17,1497,3
2021-09-20,Monterey,053,433212,47398,46506,2524,49030,565
2021-09-20,Napa,055,140530,12329,12209,86,12295,95
2021-09-20,Nevada,057,99092,8358,8228,271,8499,84
2021-09-20,Orange,059,3164182,296898,293642,13861,307503,5354
2021-09-20,Placer,061,380077,34114,33531,3179,36710,364
2021-09-20,Plumas,063,18699,1272,1211,24,1235,5
2021-09-20,Riverside,065,2383286,347351,341961,15699,357660,4802
2021-09-20,Sacramento,067,1510023,147982,147016,3720,150736,2016
2021-09-20,San Benito,069,59416,6970,6947,140,7087,67
2021-09-20,San Bernardino,071,2135413,340110,337059,10491,347550,5507
2021-09-20,San Diego,073,3302833,353822,349579,20829,370408,4009
2021-09-20,San Francisco,075,870044,50209,49559,2113,51672,605
2021-09-20,San Joaquin,077,732212,93911,92614,4936,97550,1615
2021-09-20,San Luis Obispo,079,281455,27832,27259,1089,28348,313
2021-09-20,San Mateo,081,765935,51931,51100,768,51868,567
2021-09-20,Santa Barbara,083,443738,42042,41589,1449,43038,500
2021-09-20,Santa Clara,085,1922200,140862,139578,1084,140662,1841
2021-09-20,Santa Cruz,087,273765,19392,19121,957,20078,211
2021-09-20,Shasta,089,179085,18509,17893,3009,20902,258
2021-09-20,Sierra,091,2930,131,126,13,139,0
2021-09-20,Siskiyou,093,43540,3050,2902,1048,3950,35
2021-09-20,Solano,095,438530,43958,43152,1126,44278,312
2021-09-20,Sonoma,097,501317,39284,38991,480,39471,369
2021-09-20,Stanislaus,099,539301,72439,72031,8078,80109,1091
2021-09-20,Sutter,101,95872,12990,12896,248,13144,153
2021-09-20,Tehama,103,63373,7320,7121,1184,8305,84
2021-09-20,Trinity,105,12862,728,568,191,759,7
2021-09-20,Tulare,107,460477,62012,60302,12544,72846,896
2021-09-20,Tuolumne,109,53932,6211,6113,72,6185,89
2021-09-20,Ventura,111,848112,94645,93700,4077,97777,1120
2021-09-20,Yolo,113,214977,18564,18287,856,19143,239
2021-09-20,Yuba,115,75493,9233,9107,205,9312,61
2021-09-19,Alameda,001,1643700,114180,113446,2544,115990,1320
2021-09-19,Alpine,003,1148,99,100,0,100,0
2021-09-19,Amador,005,37829,4961,4875,48,4923,59
2021-09-19,Butte,007,227075,18644,18063,3294,21357,230
2021-09-19,Calaveras,009,45235,3473,3390,35,3425,66
2021-09-19,Colusa,011,21464,2399,2375,537,2912,16
2021-09-19,Contra Costa,013,1133247,94652,93788,1897,95685,924
2021-09-19,Del Norte,015,27424,3470,3344,27,3371,34
2021-09-19,El Dorado,017,186661,14784,14512,1501,16013,127
2021-09-19,Fresno,019,978130,127250,124985,11383,136368,1888
2021-09-19,Glenn,021,27897,3202,3102,914,4016,25
2021-09-19,Humboldt,023,135768,8059,7914,395,8309,80
2021-09-19,Imperial,025,180216,31372,31122,2938,34060,755
2021-09-19,Inyo,027,18085,1679,1639,31,1670,39
2021-09-19,Kern,029,883053,117081,115074,17943,133017,1459
2021-09-19,Kings,031,150075,28987,28416,1612,30028,284
2021-09-19,Lake,033,64148,6121,5962,119,6081,87
2021-09-19,Lassen,035,31185,6306,6129,265,6394,25
2021-09-19,Los Angeles,037,10098052,1393778,1381200,51198,1432398,25852
2021-09-19,Madera,039,155013,20687,20161,1634,21795,257
2021-09-19,Marin,041,260295,16885,16711,385,17096,242
2021-09-19,Mariposa,043,17540,927,881,32,913,5
2021-09-19,Mendocino,045,87422,6734,6538,321,6859,67
2021-09-19,Merced,047,269075,38368,38068,1477,39545,535
2021-09-19,Modoc,049,8938,466,457,161,618,5
2021-09-19,Mono,051,14174,1516,1480,17,1497,3
2021-09-19,Monterey,053,433212,47343,46486,2521,49007,565
2021-09-19,Napa,055,140530,12308,12190,84,12274,95
2021-09-19,Nevada,057,99092,8330,8203,269,8472,84
2021-09-19,Orange,059,3164182,296530,293258,13839,307097,5354
2021-09-19,Placer,061,380077,34001,33406,3161,36567,364
2021-09-19,Plumas,063,18699,1264,1211,24,1235,5
2021-09-19,Riverside,065,2383286,346758,341566,15690,357256,4804
2021-09-19,Sacramento,067,1510023,147622,146603,3676,150279,2012
2021-09-19,San Benito,069,59416,6951,6942,140,7082,67
2021-09-19,San Bernardino,071,2135413,339619,336688,10480,347168,5506
2021-09-19,San Diego,073,3302833,353119,349225,20792,370017,4006
2021-09-19,San Francisco,075,870044,50102,49458,2104,51562,605
2021-09-19,San Joaquin,077,732212,93615,92467,4925,97392,1615
2021-09-19,San Luis Obispo,079,281455,27731,27208,1080,28288,313
2021-09-19,San Mateo,081,765935,51833,51028,767,51795,567
2021-09-19,Santa Barbara,083,443738,41936,41512,1449,42961,500
2021-09-19,Santa Clara,085,1922200,140675,139410,1079,140489,1841
2021-09-19,Santa Cruz,087,273765,19353,19096,957,20053,211
2021-09-19,Shasta,089,179085,18395,17813,2974,20787,258
2021-09-19,Sierra,091,2930,130,126,13,139,0
2021-09-19,Siskiyou,093,43540,3024,2882,1039,3921,35
2021-09-19,Solano,095,438530,43869,43056,1121,44177,312
2021-09-19,Sonoma,097,501317,39212,38956,476,39432,369
2021-09-19,Stanislaus,099,539301,72194,71830,8053,79883,1091
2021-09-19,Sutter,101,95872,12963,12868,241,13109,153
2021-09-19,Tehama,103,63373,7266,7081,1175,8256,84
2021-09-19,Trinity,105,12862,717,562,189,751,7
2021-09-19,Tulare,107,460477,61751,60160,12451,72611,896
2021-09-19,Tuolumne,109,53932,6170,6097,72,6169,89
2021-09-19,Ventura,111,848112,94483,93491,4068,97559,1120
2021-09-19,Yolo,113,214977,18515,18238,850,19088,239
2021-09-19,Yuba,115,75493,9207,9087,204,9291,61
2021-09-18,Alameda,001,1643700,114080,113300,2543,115843,1320
2021-09-18,Alpine,003,1148,99,100,0,100,0
2021-09-18,Amador,005,37829,4951,4850,48,4898,59
2021-09-18,Butte,007,227075,18605,17961,3278,21239,230
2021-09-18,Calaveras,009,45235,3468,3361,34,3395,66
2021-09-18,Colusa,011,21464,2399,2373,536,2909,16
2021-09-18,Contra Costa,013,1133247,94562,93656,1893,95549,924
2021-09-18,Del Norte,015,27424,3462,3326,25,3351,34
2021-09-18,El Dorado,017,186661,14761,14472,1498,15970,127
2021-09-18,Fresno,019,978130,127108,124771,11365,136136,1889
2021-09-18,Glenn,021,27897,3193,3086,911,3997,25
2021-09-18,Humboldt,023,135768,8045,7881,394,8275,80
2021-09-18,Imperial,025,180216,31348,31096,2937,34033,755
2021-09-18,Inyo,027,18085,1673,1636,31,1667,39
2021-09-18,Kern,029,883053,116926,114781,17879,132660,1459
2021-09-18,Kings,031,150075,28939,28330,1607,29937,285
2021-09-18,Lake,033,64148,6104,5936,119,6055,87
2021-09-18,Lassen,035,31185,6296,6121,263,6384,25
2021-09-18,Los Angeles,037,10098052,1393018,1379880,51148,1431028,25849
2021-09-18,Madera,039,155013,20643,20126,1624,21750,257
2021-09-18,Marin,041,260295,16868,16685,384,17069,242
2021-09-18,Mariposa,043,17540,924,871,32,903,5
2021-09-18,Mendocino,045,87422,6713,6523,321,6844,67
2021-09-18,Merced,047,269075,38332,37977,1471,39448,535
2021-09-18,Modoc,049,8938,466,457,160,617,5
2021-09-18,Mono,051,14174,1513,1480,17,1497,3
2021-09-18,Monterey,053,433212,47305,46466,2518,48984,565
2021-09-18,Napa,055,140530,12296,12168,84,12252,95
2021-09-18,Nevada,057,99092,8313,8183,269,8452,84
2021-09-18,Orange,059,3164182,296336,293005,13825,306830,5354
2021-09-18,Placer,061,380077,33929,33309,3158,36467,364
2021-09-18,Plumas,063,18699,1263,1204,24,1228,5
2021-09-18,Riverside,065,2383286,346374,341136,15676,356812,4802
2021-09-18,Sacramento,067,1510023,147440,146162,3667,149829,2016
2021-09-18,San Benito,069,59416,6947,6937,140,7077,67
2021-09-18,San Bernardino,071,2135413,339347,336380,10467,346847,5501
2021-09-18,San Diego,073,3302833,352728,348848,20779,369627,4006
2021-09-18,San Francisco,075,870044,50039,49359,2099,51458,605
2021-09-18,San Joaquin,077,732212,93504,92242,4913,97155,1615
2021-09-18,San Luis Obispo,079,281455,27694,27181,1077,28258,313
2021-09-18,San Mateo,081,765935,51783,50961,765,51726,567
2021-09-18,Santa Barbara,083,443738,41871,41465,1449,42914,500
2021-09-18,Santa Clara,085,1922200,140555,139233,1076,140309,1841
2021-09-18,Santa Cruz,087,273765,19333,19079,957,20036,211
2021-09-18,Shasta,089,179085,18332,17777,2958,20735,258
2021-09-18,Sierra,091,2930,129,125,13,138,0
2021-09-18,Siskiyou,093,43540,3021,2875,1033,3908,35
2021-09-18,Solano,095,438530,43829,42966,1118,44084,312
2021-09-18,Sonoma,097,501317,39177,38891,474,39365,369
2021-09-18,Stanislaus,099,539301,72049,71587,8031,79618,1091
2021-09-18,Sutter,101,95872,12949,12829,241,13070,153
2021-09-18,Tehama,103,63373,7252,7055,1168,8223,84
2021-09-18,Trinity,105,12862,715,561,189,750,7
2021-09-18,Tulare,107,460477,61675,60003,12401,72404,896
2021-09-18,Tuolumne,109,53932,6155,6069,72,6141,89
2021-09-18,Ventura,111,848112,94415,93424,4063,97487,1120
2021-09-18,Yolo,113,214977,18488,18213,845,19058,239
2021-09-18,Yuba,115,75493,9193,9061,203,9264,61
2021-09-17,Alameda,001,1643700,113954,113070,2541,115611,1320
2021-09-17,Alpine,003,1148,99,99,0,99,0
2021-09-17,Amador,005,37829,4935,4835,47,4882,58
2021-09-17,Butte,007,227075,18553,17870,3269,21139,230
2021-09-17,Calaveras,009,45235,3456,3338,33,3371,66
2021-09-17,Colusa,011,21464,2398,2369,531,2900,16
2021-09-17,Contra Costa,013,1133247,94460,93485,1890,95375,924
2021-09-17,Del Norte,015,27424,3457,3311,23,3334,34
2021-09-17,El Dorado,017,186661,14742,14421,1496,15917,127
2021-09-17,Fresno,019,978130,126889,124296,11349,135645,1882
2021-09-17,Glenn,021,27897,3176,3072,907,3979,25
2021-09-17,Humboldt,023,135768,8024,7850,394,8244,80
2021-09-17,Imperial,025,180216,31322,31031,2936,33967,755
2021-09-17,Inyo,027,18085,1665,1634,31,1665,39
2021-09-17,Kern,029,883053,116735,114303,17782,132085,1456
2021-09-17,Kings,031,150075,28874,28240,1605,29845,281
2021-09-17,Lake,033,64148,6091,5915,119,6034,87
2021-09-17,Lassen,035,31185,6281,6080,261,6341,25
2021-09-17,Los Angeles,037,10098052,1392039,1377905,51082,1428987,25820
2021-09-17,Madera,039,155013,20592,20040,1612,21652,257
2021-09-17,Marin,041,260295,16855,16658,382,17040,242
2021-09-17,Mariposa,043,17540,922,869,32,901,5
2021-09-17,Mendocino,045,87422,6694,6498,321,6819,67
2021-09-17,Merced,047,269075,38285,37803,1469,39272,533
2021-09-17,Modoc,049,8938,466,456,160,616,5
2021-09-17,Mono,051,14174,1509,1457,17,1474,3
2021-09-17,Monterey,053,433212,47282,46421,2517,48938,564
2021-09-17,Napa,055,140530,12275,12153,84,12237,95
2021-09-17,Nevada,057,99092,8298,8157,269,8426,84
2021-09-17,Orange,059,3164182,296117,292685,13807,306492,5346
2021-09-17,Placer,061,380077,33869,33188,3148,36336,362
2021-09-17,Plumas,063,18699,1254,1192,23,1215,5
2021-09-17,Riverside,065,2383286,345974,340445,15665,356110,4792
2021-09-17,Sacramento,067,1510023,147241,145985,3656,149641,1999
2021-09-17,San Benito,069,59416,6944,6929,140,7069,67
2021-09-17,San Bernardino,071,2135413,338989,335810,10460,346270,5488
2021-09-17,San Diego,073,3302833,352304,348098,20762,368860,4002
2021-09-17,San Francisco,075,870044,49987,49249,2094,51343,605
2021-09-17,San Joaquin,077,732212,93366,91977,4902,96879,1610
2021-09-17,San Luis Obispo,079,281455,27660,27102,1066,28168,311
2021-09-17,San Mateo,081,765935,51730,50854,764,51618,564
2021-09-17,Santa Barbara,083,443738,41808,41354,1448,42802,498
2021-09-17,Santa Clara,085,1922200,140406,138939,1075,140014,1838
2021-09-17,Santa Cruz,087,273765,19309,19039,957,19996,211
2021-09-17,Shasta,089,179085,18262,17617,2945,20562,254
2021-09-17,Sierra,091,2930,129,124,13,137,0
2021-09-17,Siskiyou,093,43540,3006,2852,1033,3885,35
2021-09-17,Solano,095,438530,43766,42898,1114,44012,312
2021-09-17,Sonoma,097,501317,39140,38808,473,39281,369
2021-09-17,Stanislaus,099,539301,71942,71408,8013,79421,1091
2021-09-17,Sutter,101,95872,12933,12799,238,13037,153
2021-09-17,Tehama,103,63373,7229,7020,1156,8176,84
2021-09-17,Trinity,105,12862,710,556,188,744,7
2021-09-17,Tulare,107,460477,61560,59689,12366,72055,895
2021-09-17,Tuolumne,109,53932,6136,6047,72,6119,89
2021-09-17,Ventura,111,848112,94303,93273,4061,97334,1116
2021-09-17,Yolo,113,214977,18457,18177,841,19018,239
2021-09-17,Yuba,115,75493,9166,9019,202,9221,61
2021-09-16,Alameda,001,1643700,113777,112770,2538,115308,1318
2021-09-16,Alpine,003,1148,99,99,0,99,0
2021-09-16,Amador,005,37829,4915,4819,47,4866,58
2021-09-16,Butte,007,227075,18478,17750,3253,21003,230
2021-09-16,Calaveras,009,45235,3425,3313,33,3346,66
2021-09-16,Colusa,011,21464,2396,2363,529,2892,16
2021-09-16,Contra Costa,013,1133247,94288,93213,1882,95095,917
2021-09-16,Del Norte,015,27424,3439,3285,23,3308,34
2021-09-16,El Dorado,017,186661,14701,14372,1488,15860,127
2021-09-16,Fresno,019,978130,126532,123853,11308,135161,1868
2021-09-16,Glenn,021,27897,3166,3068,905,3973,24
2021-09-16,Humboldt,023,135768,7990,7809,386,8195,80
2021-09-16,Imperial,025,180216,31279,30966,2928,33894,753
2021-09-16,Inyo,027,18085,1663,1623,31,1654,39
2021-09-16,Kern,029,883053,116463,113828,17715,131543,1448
2021-09-16,Kings,031,150075,28788,28114,1597,29711,280
2021-09-16,Lake,033,64148,6067,5890,116,6006,87
2021-09-16,Lassen,035,31185,6246,6028,256,6284,25
2021-09-16,Los Angeles,037,10098052,1390646,1376277,51017,1427294,25796
2021-09-16,Madera,039,155013,20514,19974,1607,21581,257
2021-09-16,Marin,041,260295,16828,16625,381,17006,242
2021-09-16,Mariposa,043,17540,916,849,32,881,6
2021-09-16,Mendocino,045,87422,6656,6445,310,6755,67
2021-09-16,Merced,047,269075,38178,37675,1467,39142,532
2021-09-16,Modoc,049,8938,464,455,160,615,5
2021-09-16,Mono,051,14174,1503,1449,17,1466,3
2021-09-16,Monterey,053,433212,47228,46342,2511,48853,562
2021-09-16,Napa,055,140530,12250,12115,80,12195,95
2021-09-16,Nevada,057,99092,8271,8121,268,8389,84
2021-09-16,Orange,059,3164182,295771,292183,13787,305970,5340
2021-09-16,Placer,061,380077,33773,33037,3128,36165,354
2021-09-16,Plumas,063,18699,1245,1178,23,1201,5
2021-09-16,Riverside,065,2383286,345444,339770,15651,355421,4786
2021-09-16,Sacramento,067,1510023,146885,145754,3624,149378,1996
2021-09-16,San Benito,069,59416,6932,6913,139,7052,67
2021-09-16,San Bernardino,071,2135413,338564,335129,10453,345582,5474
2021-09-16,San Diego,073,3302833,351690,347472,20723,368195,3994
2021-09-16,San Francisco,075,870044,49901,49133,2086,51219,605
2021-09-16,San Joaquin,077,732212,93128,91650,4859,96509,1608
2021-09-16,San Luis Obispo,079,281455,27587,27044,1062,28106,310
2021-09-16,San Mateo,081,765935,51653,50773,762,51535,564
2021-09-16,Santa Barbara,083,443738,41742,41272,1445,42717,497
2021-09-16,Santa Clara,085,1922200,140252,138685,1071,139756,1835
2021-09-16,Santa Cruz,087,273765,19282,19011,957,19968,211
2021-09-16,Shasta,089,179085,18137,17438,2912,20350,251
2021-09-16,Sierra,091,2930,129,123,13,136,0
2021-09-16,Siskiyou,093,43540,2986,2819,1026,3845,35
2021-09-16,Solano,095,438530,43694,42792,1105,43897,312
2021-09-16,Sonoma,097,501317,39077,38707,472,39179,369
2021-09-16,Stanislaus,099,539301,71709,71105,7997,79102,1091
2021-09-16,Sutter,101,95872,12889,12729,233,12962,152
2021-09-16,Tehama,103,63373,7189,6953,1145,8098,83
2021-09-16,Trinity,105,12862,707,547,187,734,7
2021-09-16,Tulare,107,460477,61338,59459,12293,71752,894
2021-09-16,Tuolumne,109,53932,6116,5999,71,6070,89
2021-09-16,Ventura,111,848112,94163,93087,4057,97144,1110
2021-09-16,Yolo,113,214977,18425,18135,839,18974,239
2021-09-16,Yuba,115,75493,9132,8981,199,9180,61
2021-09-15,Alameda,001,1643700,113612,112498,2531,115029,1317
2021-09-15,Alpine,003,1148,99,99,0,99,0
2021-09-15,Amador,005,37829,4907,4792,47,4839,58
2021-09-15,Butte,007,227075,18380,17664,3233,20897,228
2021-09-15,Calaveras,009,45235,3396,3293,31,3324,66
2021-09-15,Colusa,011,21464,2394,2352,526,2878,16
2021-09-15,Contra Costa,013,1133247,94107,92989,1871,94860,913
2021-09-15,Del Norte,015,27424,3426,3271,21,3292,34
2021-09-15,El Dorado,017,186661,14675,14309,1478,15787,127
2021-09-15,Fresno,019,978130,126153,123370,11252,134622,1867
2021-09-15,Glenn,021,27897,3154,3051,900,3951,20
2021-09-15,Humboldt,023,135768,7955,7754,381,8135,52
2021-09-15,Imperial,025,180216,31224,30891,2923,33814,753
2021-09-15,Inyo,027,18085,1659,1614,31,1645,39
2021-09-15,Kern,029,883053,116116,113546,17617,131163,1434
2021-09-15,Kings,031,150075,28709,27991,1589,29580,279
2021-09-15,Lake,033,64148,6035,5852,115,5967,85
2021-09-15,Lassen,035,31185,6186,6018,251,6269,25
2021-09-15,Los Angeles,037,10098052,1389145,1374307,50948,1425255,25767
2021-09-15,Madera,039,155013,20439,19880,1600,21480,257
2021-09-15,Marin,041,260295,16793,16592,376,16968,242
2021-09-15,Mariposa,043,17540,904,843,32,875,5
2021-09-15,Mendocino,045,87422,6626,6399,305,6704,66
2021-09-15,Merced,047,269075,38070,37508,1465,38973,529
2021-09-15,Modoc,049,8938,464,454,160,614,5
2021-09-15,Mono,051,14174,1497,1445,17,1462,3
2021-09-15,Monterey,053,433212,47157,46317,2500,48817,562
2021-09-15,Napa,055,140530,12229,12082,80,12162,95
2021-09-15,Nevada,057,99092,8249,8081,265,8346,84
2021-09-15,Orange,059,3164182,295447,291834,13768,305602,5328
2021-09-15,Placer,061,380077,33661,32860,3107,35967,352
2021-09-15,Plumas,063,18699,1240,1164,22,1186,5
2021-09-15,Riverside,065,2383286,344861,339077,15627,354704,4769
2021-09-15,Sacramento,067,1510023,146459,145202,3593,148795,1981
2021-09-15,San Benito,069,59416,6929,6902,139,7041,67
2021-09-15,San Bernardino,071,2135413,338101,334556,10439,344995,5470
2021-09-15,San Diego,073,3302833,351071,346933,20695,367628,3983
2021-09-15,San Francisco,075,870044,49790,48999,2081,51080,605
2021-09-15,San Joaquin,077,732212,92852,91322,4819,96141,1607
2021-09-15,San Luis Obispo,079,281455,27504,26943,1056,27999,306
2021-09-15,San Mateo,081,765935,51571,50691,759,51450,564
2021-09-15,Santa Barbara,083,443738,41639,41077,1440,42517,497
2021-09-15,Santa Clara,085,1922200,140078,138410,1066,139476,1833
2021-09-15,Santa Cruz,087,273765,19244,18984,955,19939,210
2021-09-15,Shasta,089,179085,18026,17317,2891,20208,250
2021-09-15,Sierra,091,2930,129,123,13,136,0
2021-09-15,Siskiyou,093,43540,2966,2804,996,3800,35
2021-09-15,Solano,095,438530,43622,42682,1100,43782,312
2021-09-15,Sonoma,097,501317,39019,38629,472,39101,369
2021-09-15,Stanislaus,099,539301,71485,70852,7975,78827,1091
2021-09-15,Sutter,101,95872,12856,12699,228,12927,151
2021-09-15,Tehama,103,63373,7148,6894,1136,8030,79
2021-09-15,Trinity,105,12862,705,541,185,726,7
2021-09-15,Tulare,107,460477,61079,59149,12232,71381,890
2021-09-15,Tuolumne,109,53932,6090,5969,71,6040,89
2021-09-15,Ventura,111,848112,94020,92960,4050,97010,1109
2021-09-15,Yolo,113,214977,18391,18064,833,18897,239
2021-09-15,Yuba,115,75493,9098,8953,199,9152,61
2021-09-14,Alameda,001,1643700,113405,112329,2528,114857,1316
2021-09-14,Alpine,003,1148,99,98,0,98,0
2021-09-14,Amador,005,37829,4887,4790,47,4837,57
2021-09-14,Butte,007,227075,18246,17516,3209,20725,226
2021-09-14,Calaveras,009,45235,3376,3280,28,3308,66
2021-09-14,Colusa,011,21464,2390,2344,523,2867,16
2021-09-14,Contra Costa,013,1133247,93909,92822,1863,94685,908
2021-09-14,Del Norte,015,27424,3410,3252,21,3273,32
2021-09-14,El Dorado,017,186661,14622,14247,1470,15717,123
2021-09-14,Fresno,019,978130,125678,123151,11200,134351,1856
2021-09-14,Glenn,021,27897,3137,3045,896,3941,20
2021-09-14,Humboldt,023,135768,7921,7717,376,8093,52
2021-09-14,Imperial,025,180216,31175,30845,2920,33765,752
2021-09-14,Inyo,027,18085,1650,1605,30,1635,39
2021-09-14,Kern,029,883053,115733,113250,17494,130744,1428
2021-09-14,Kings,031,150075,28633,27955,1581,29536,278
2021-09-14,Lake,033,64148,6003,5845,115,5960,83
2021-09-14,Lassen,035,31185,6172,5977,246,6223,25
2021-09-14,Los Angeles,037,10098052,1387308,1372831,50866,1423697,25729
2021-09-14,Madera,039,155013,20357,19800,1589,21389,254
2021-09-14,Marin,041,260295,16765,16584,374,16958,242
2021-09-14,Mariposa,043,17540,893,834,31,865,5
2021-09-14,Mendocino,045,87422,6590,6372,294,6666,65
2021-09-14,Merced,047,269075,37920,37430,1461,38891,526
2021-09-14,Modoc,049,8938,463,453,160,613,5
2021-09-14,Mono,051,14174,1493,1440,17,1457,4
2021-09-14,Monterey,053,433212,47116,46224,2489,48713,558
2021-09-14,Napa,055,140530,12196,12070,79,12149,91
2021-09-14,Nevada,057,99092,8215,8056,265,8321,83
2021-09-14,Orange,059,3164182,295054,291423,13744,305167,5319
2021-09-14,Placer,061,380077,33529,32735,3087,35822,350
2021-09-14,Plumas,063,18699,1225,1148,22,1170,5
2021-09-14,Riverside,065,2383286,344220,338534,15596,354130,4748
2021-09-14,Sacramento,067,1510023,146074,145051,3545,148596,1977
2021-09-14,San Benito,069,59416,6919,6887,139,7026,64
2021-09-14,San Bernardino,071,2135413,337604,333968,10414,344382,5465
2021-09-14,San Diego,073,3302833,350411,346204,20644,366848,3966
2021-09-14,San Francisco,075,870044,49656,48998,2079,51077,603
2021-09-14,San Joaquin,077,732212,92613,91128,4810,95938,1596
2021-09-14,San Luis Obispo,079,281455,27431,26845,1051,27896,304
2021-09-14,San Mateo,081,765935,51474,50602,756,51358,564
2021-09-14,Santa Barbara,083,443738,41543,40783,1431,42214,495
2021-09-14,Santa Clara,085,1922200,139843,138321,1063,139384,1828
2021-09-14,Santa Cruz,087,273765,19204,18965,953,19918,210
2021-09-14,Shasta,089,179085,17895,17152,2870,20022,246
2021-09-14,Sierra,091,2930,129,123,13,136,0
2021-09-14,Siskiyou,093,43540,2942,2756,979,3735,35
2021-09-14,Solano,095,438530,43539,42599,1097,43696,307
2021-09-14,Sonoma,097,501317,38950,38595,468,39063,369
2021-09-14,Stanislaus,099,539301,71225,70697,7947,78644,1091
2021-09-14,Sutter,101,95872,12814,12670,221,12891,149
2021-09-14,Tehama,103,63373,7094,6859,1128,7987,80
2021-09-14,Trinity,105,12862,699,538,184,722,7
2021-09-14,Tulare,107,460477,60826,58961,12161,71122,888
2021-09-14,Tuolumne,109,53932,6069,5951,69,6020,89
2021-09-14,Ventura,111,848112,93835,92841,4033,96874,1107
2021-09-14,Yolo,113,214977,18347,18039,828,18867,239
2021-09-14,Yuba,115,75493,9062,8928,199,9127,61
2021-09-13,Alameda,001,1643700,113191,112159,2523,114682,1309
2021-09-13,Alpine,003,1148,98,98,0,98,0
2021-09-13,Amador,005,37829,4869,4761,47,4808,56
2021-09-13,Butte,007,227075,18121,17393,3181,20574,225
2021-09-13,Calaveras,009,45235,3350,3253,27,3280,65
2021-09-13,Colusa,011,21464,2381,2346,519,2865,16
2021-09-13,Contra Costa,013,1133247,93664,92658,1858,94516,908
2021-09-13,Del Norte,015,27424,3374,3232,21,3253,28
2021-09-13,El Dorado,017,186661,14561,14194,1462,15656,119
2021-09-13,Fresno,019,978130,125211,122650,11134,133784,1853
2021-09-13,Glenn,021,27897,3123,3026,890,3916,20
2021-09-13,Humboldt,023,135768,7889,7659,373,8032,52
2021-09-13,Imperial,025,180216,31122,30802,2917,33719,751
2021-09-13,Inyo,027,18085,1643,1602,30,1632,39
2021-09-13,Kern,029,883053,115350,112930,17372,130302,1424
2021-09-13,Kings,031,150075,28523,27858,1569,29427,275
2021-09-13,Lake,033,64148,5981,5809,115,5924,82
2021-09-13,Lassen,035,31185,6137,5953,245,6198,25
2021-09-13,Los Angeles,037,10098052,1385444,1371423,50799,1422222,25703
2021-09-13,Madera,039,155013,20287,19735,1574,21309,252
2021-09-13,Marin,041,260295,16729,16557,373,16930,242
2021-09-13,Mariposa,043,17540,879,825,31,856,5
2021-09-13,Mendocino,045,87422,6555,6323,285,6608,61
2021-09-13,Merced,047,269075,37770,37291,1456,38747,521
2021-09-13,Modoc,049,8938,462,451,160,611,5
2021-09-13,Mono,051,14174,1487,1435,17,1452,3
2021-09-13,Monterey,053,433212,47025,46188,2476,48664,558
2021-09-13,Napa,055,140530,12178,12039,79,12118,91
2021-09-13,Nevada,057,99092,8189,8021,263,8284,83
2021-09-13,Orange,059,3164182,294622,291128,13723,304851,5312
2021-09-13,Placer,061,380077,33364,32617,3070,35687,343
2021-09-13,Plumas,063,18699,1216,1142,22,1164,5
2021-09-13,Riverside,065,2383286,343575,337876,15578,353454,4731
2021-09-13,Sacramento,067,1510023,145587,144537,3512,148049,1956
2021-09-13,San Benito,069,59416,6904,6867,138,7005,64
2021-09-13,San Bernardino,071,2135413,337113,333613,10389,344002,5441
2021-09-13,San Diego,073,3302833,349624,345647,20592,366239,3961
2021-09-13,San Francisco,075,870044,49527,48914,2073,50987,603
2021-09-13,San Joaquin,077,732212,92328,90966,4792,95758,1581
2021-09-13,San Luis Obispo,079,281455,27334,26805,1048,27853,300
2021-09-13,San Mateo,081,765935,51382,50525,751,51276,564
2021-09-13,Santa Barbara,083,443738,41424,40661,1424,42085,494
2021-09-13,Santa Clara,085,1922200,139598,138152,1058,139210,1820
2021-09-13,Santa Cruz,087,273765,19164,18917,952,19869,210
2021-09-13,Shasta,089,179085,17765,17033,2830,19863,243
2021-09-13,Sierra,091,2930,129,123,13,136,0
2021-09-13,Siskiyou,093,43540,2927,2745,967,3712,35
2021-09-13,Solano,095,438530,43435,42501,1094,43595,306
2021-09-13,Sonoma,097,501317,38883,38513,465,38978,368
2021-09-13,Stanislaus,099,539301,70971,70477,7911,78388,1091
2021-09-13,Sutter,101,95872,12756,12624,217,12841,145
2021-09-13,Tehama,103,63373,7031,6803,1116,7919,79
2021-09-13,Trinity,105,12862,697,533,182,715,7
2021-09-13,Tulare,107,460477,60543,58768,12101,70869,887
2021-09-13,Tuolumne,109,53932,6038,5909,69,5978,89
2021-09-13,Ventura,111,848112,93673,92679,4026,96705,1107
2021-09-13,Yolo,113,214977,18302,17974,822,18796,239
2021-09-13,Yuba,115,75493,9017,8884,198,9082,61
2021-09-12,Alameda,001,1643700,112929,111961,2520,114481,1309
2021-09-12,Alpine,003,1148,98,98,0,98,0
2021-09-12,Amador,005,37829,4848,4752,47,4799,56
2021-09-12,Butte,007,227075,17976,17257,3133,20390,221
2021-09-12,Calaveras,009,45235,3319,3236,23,3259,65
2021-09-12,Colusa,011,21464,2378,2344,518,2862,16
2021-09-12,Contra Costa,013,1133247,93396,92498,1846,94344,908
2021-09-12,Del Norte,015,27424,3339,3200,21,3221,28
2021-09-12,El Dorado,017,186661,14488,14167,1446,15613,119
2021-09-12,Fresno,019,978130,124693,122407,11077,133484,1853
2021-09-12,Glenn,021,27897,3106,3016,884,3900,20
2021-09-12,Humboldt,023,135768,7819,7636,362,7998,52
2021-09-12,Imperial,025,180216,31059,30790,2912,33702,751
2021-09-12,Inyo,027,18085,1633,1596,30,1626,39
2021-09-12,Kern,029,883053,114938,112602,17213,129815,1424
2021-09-12,Kings,031,150075,28412,27764,1552,29316,274
2021-09-12,Lake,033,64148,5941,5781,113,5894,82
2021-09-12,Lassen,035,31185,6100,5943,236,6179,25
2021-09-12,Los Angeles,037,10098052,1383387,1365968,50726,1416694,25630
2021-09-12,Madera,039,155013,20200,19691,1562,21253,252
2021-09-12,Marin,041,260295,16706,16526,373,16899,242
2021-09-12,Mariposa,043,17540,868,811,29,840,5
2021-09-12,Mendocino,045,87422,6515,6283,276,6559,61
2021-09-12,Merced,047,269075,37598,37172,1445,38617,521
2021-09-12,Modoc,049,8938,462,451,159,610,5
2021-09-12,Mono,051,14174,1480,1431,17,1448,3
2021-09-12,Monterey,053,433212,46926,46167,2466,48633,558
2021-09-12,Napa,055,140530,12148,12011,79,12090,91
2021-09-12,Nevada,057,99092,8149,7987,262,8249,83
2021-09-12,Orange,059,3164182,294158,290718,13702,304420,5312
2021-09-12,Placer,061,380077,33215,32520,3048,35568,343
2021-09-12,Plumas,063,18699,1197,1138,22,1160,5
2021-09-12,Riverside,065,2383286,342891,337332,15544,352876,4731
2021-09-12,Sacramento,067,1510023,145081,144030,3473,147503,1959
2021-09-12,San Benito,069,59416,6885,6852,137,6989,64
2021-09-12,San Bernardino,071,2135413,336500,333049,10376,343425,5439
2021-09-12,San Diego,073,3302833,348814,345058,20516,365574,3942
2021-09-12,San Francisco,075,870044,49416,48819,2066,50885,603
2021-09-12,San Joaquin,077,732212,91999,90730,4784,95514,1581
2021-09-12,San Luis Obispo,079,281455,27215,26729,1035,27764,299
2021-09-12,San Mateo,081,765935,51272,50432,747,51179,564
2021-09-12,Santa Barbara,083,443738,41312,40600,1417,42017,494
2021-09-12,Santa Clara,085,1922200,139341,137899,1055,138954,1820
2021-09-12,Santa Cruz,087,273765,19131,18892,951,19843,210
2021-09-12,Shasta,089,179085,17600,16957,2772,19729,243
2021-09-12,Sierra,091,2930,129,123,13,136,0
2021-09-12,Siskiyou,093,43540,2899,2730,952,3682,35
2021-09-12,Solano,095,438530,43329,42409,1091,43500,306
2021-09-12,Sonoma,097,501317,38803,38456,463,38919,368
2021-09-12,Stanislaus,099,539301,70672,70184,7872,78056,1091
2021-09-12,Sutter,101,95872,12714,12589,211,12800,145
2021-09-12,Tehama,103,63373,6967,6732,1104,7836,79
2021-09-12,Trinity,105,12862,693,529,180,709,7
2021-09-12,Tulare,107,460477,60190,58582,12041,70623,887
2021-09-12,Tuolumne,109,53932,6005,5888,69,5957,89
2021-09-12,Ventura,111,848112,93546,92496,4020,96516,1107
2021-09-12,Yolo,113,214977,18236,17943,814,18757,239
2021-09-12,Yuba,115,75493,8982,8842,198,9040,61
2021-09-11,Alameda,001,1643700,112805,111715,2518,114233,1309
2021-09-11,Alpine,003,1148,98,98,0,98,0
2021-09-11,Amador,005,37829,4835,4728,46,4774,56
2021-09-11,Butte,007,227075,17893,17218,3106,20324,221
2021-09-11,Calaveras,009,45235,3311,3208,22,3230,65
2021-09-11,Colusa,011,21464,2377,2338,515,2853,16
2021-09-11,Contra Costa,013,1133247,93277,92269,1842,94111,908
2021-09-11,Del Norte,015,27424,3323,3184,21,3205,28
2021-09-11,El Dorado,017,186661,14469,14117,1439,15556,119
2021-09-11,Fresno,019,978130,124514,122224,11052,133276,1853
2021-09-11,Glenn,021,27897,3096,3007,881,3888,20
2021-09-11,Humboldt,023,135768,7797,7615,359,7974,52
2021-09-11,Imperial,025,180216,31034,30760,2909,33669,751
2021-09-11,Inyo,027,18085,1630,1590,30,1620,39
2021-09-11,Kern,029,883053,114688,112205,17099,129304,1424
2021-09-11,Kings,031,150075,28363,27631,1546,29177,275
2021-09-11,Lake,033,64148,5920,5761,113,5874,82
2021-09-11,Lassen,035,31185,6085,5930,232,6162,25
2021-09-11,Los Angeles,037,10098052,1382416,1365831,50662,1416493,25630
2021-09-11,Madera,039,155013,20147,19648,1557,21205,252
2021-09-11,Marin,041,260295,16678,16496,372,16868,242
2021-09-11,Mariposa,043,17540,863,799,29,828,5
2021-09-11,Mendocino,045,87422,6491,6257,276,6533,61
2021-09-11,Merced,047,269075,37544,37042,1442,38484,521
2021-09-11,Modoc,049,8938,462,449,159,608,5
2021-09-11,Mono,051,14174,1474,1431,17,1448,3
2021-09-11,Monterey,053,433212,46889,46140,2463,48603,558
2021-09-11,Napa,055,140530,12125,11991,79,12070,91
2021-09-11,Nevada,057,99092,8134,7967,262,8229,83
2021-09-11,Orange,059,3164182,293856,290429,13686,304115,5306
2021-09-11,Placer,061,380077,33132,32414,3037,35451,344
2021-09-11,Plumas,063,18699,1190,1112,22,1134,5
2021-09-11,Riverside,065,2383286,342453,336585,15531,352116,4731
2021-09-11,Sacramento,067,1510023,144780,143557,3461,147018,1955
2021-09-11,San Benito,069,59416,6872,6844,137,6981,64
2021-09-11,San Bernardino,071,2135413,336157,332512,10362,342874,5430
2021-09-11,San Diego,073,3302833,348330,344355,20492,364847,3942
2021-09-11,San Francisco,075,870044,49361,48660,2061,50721,603
2021-09-11,San Joaquin,077,732212,91856,90482,4777,95259,1581
2021-09-11,San Luis Obispo,079,281455,27169,26651,1034,27685,299
2021-09-11,San Mateo,081,765935,51200,50341,746,51087,564
2021-09-11,Santa Barbara,083,443738,41239,40451,1417,41868,494
2021-09-11,Santa Clara,085,1922200,139189,137659,1052,138711,1820
2021-09-11,Santa Cruz,087,273765,19102,18865,951,19816,210
2021-09-11,Shasta,089,179085,17506,16877,2752,19629,243
2021-09-11,Sierra,091,2930,129,123,13,136,0
2021-09-11,Siskiyou,093,43540,2882,2717,949,3666,35
2021-09-11,Solano,095,438530,43278,42344,1088,43432,306
2021-09-11,Sonoma,097,501317,38756,38399,461,38860,368
2021-09-11,Stanislaus,099,539301,70547,69974,7859,77833,1091
2021-09-11,Sutter,101,95872,12688,12538,208,12746,145
2021-09-11,Tehama,103,63373,6946,6703,1096,7799,79
2021-09-11,Trinity,105,12862,686,526,180,706,7
2021-09-11,Tulare,107,460477,60078,58321,11995,70316,889
2021-09-11,Tuolumne,109,53932,5986,5879,66,5945,89
2021-09-11,Ventura,111,848112,93464,92328,4015,96343,1107
2021-09-11,Yolo,113,214977,18212,17906,810,18716,239
2021-09-11,Yuba,115,75493,8957,8813,198,9011,61
2021-09-10,Alameda,001,1643700,112614,111386,2517,113903,1306
2021-09-10,Alpine,003,1148,97,97,0,97,0
2021-09-10,Amador,005,37829,4823,4706,46,4752,56
2021-09-10,Butte,007,227075,17818,17051,3088,20139,222
2021-09-10,Calaveras,009,45235,3303,3183,22,3205,65
2021-09-10,Colusa,011,21464,2373,2327,512,2839,16
2021-09-10,Contra Costa,013,1133247,93154,92024,1840,93864,908
2021-09-10,Del Norte,015,27424,3308,3128,20,3148,28
2021-09-10,El Dorado,017,186661,14439,14051,1435,15486,119
2021-09-10,Fresno,019,978130,124191,121659,11023,132682,1846
2021-09-10,Glenn,021,27897,3089,2977,880,3857,20
2021-09-10,Humboldt,023,135768,7765,7543,355,7898,52
2021-09-10,Imperial,025,180216,31011,30716,2907,33623,751
2021-09-10,Inyo,027,18085,1626,1590,30,1620,39
2021-09-10,Kern,029,883053,114434,111832,16983,128815,1419
2021-09-10,Kings,031,150075,28289,27473,1539,29012,274
2021-09-10,Lake,033,64148,5904,5713,111,5824,79
2021-09-10,Lassen,035,31185,6077,5914,229,6143,25
2021-09-10,Los Angeles,037,10098052,1381212,1365709,50597,1416306,25630
2021-09-10,Madera,039,155013,20101,19520,1550,21070,252
2021-09-10,Marin,041,260295,16658,16458,369,16827,242
2021-09-10,Mariposa,043,17540,858,795,29,824,5
2021-09-10,Mendocino,045,87422,6459,6184,275,6459,61
2021-09-10,Merced,047,269075,37492,36884,1441,38325,521
2021-09-10,Modoc,049,8938,462,448,159,607,5
2021-09-10,Mono,051,14174,1469,1422,17,1439,3
2021-09-10,Monterey,053,433212,46845,46084,2461,48545,557
2021-09-10,Napa,055,140530,12100,11948,79,12027,90
2021-09-10,Nevada,057,99092,8116,7932,261,8193,83
2021-09-10,Orange,059,3164182,293548,290022,13676,303698,5302
2021-09-10,Placer,061,380077,33030,32264,3024,35288,343
2021-09-10,Plumas,063,18699,1182,1111,22,1133,5
2021-09-10,Riverside,065,2383286,341980,335988,15524,351512,4720
2021-09-10,Sacramento,067,1510023,144437,143244,3453,146697,1950
2021-09-10,San Benito,069,59416,6868,6824,137,6961,64
2021-09-10,San Bernardino,071,2135413,335738,331894,10353,342247,5422
2021-09-10,San Diego,073,3302833,347783,343173,20455,363628,3941
2021-09-10,San Francisco,075,870044,49282,48518,2054,50572,602
2021-09-10,San Joaquin,077,732212,91676,90208,4771,94979,1573
2021-09-10,San Luis Obispo,079,281455,27136,26526,1032,27558,299
2021-09-10,San Mateo,081,765935,51133,50251,745,50996,564
2021-09-10,Santa Barbara,083,443738,41186,40321,1414,41735,492
2021-09-10,Santa Clara,085,1922200,139005,137337,1051,138388,1817
2021-09-10,Santa Cruz,087,273765,19083,18785,950,19735,210
2021-09-10,Shasta,089,179085,17412,16667,2724,19391,242
2021-09-10,Sierra,091,2930,129,117,13,130,0
2021-09-10,Siskiyou,093,43540,2870,2702,945,3647,35
2021-09-10,Solano,095,438530,43204,42230,1081,43311,305
2021-09-10,Sonoma,097,501317,38698,38271,460,38731,368
2021-09-10,Stanislaus,099,539301,70391,69617,7835,77452,1091
2021-09-10,Sutter,101,95872,12654,12468,208,12676,145
2021-09-10,Tehama,103,63373,6913,6652,1090,7742,77
2021-09-10,Trinity,105,12862,682,524,180,704,7
2021-09-10,Tulare,107,460477,59930,57930,11948,69878,883
2021-09-10,Tuolumne,109,53932,5967,5842,66,5908,89
2021-09-10,Ventura,111,848112,93367,92145,4011,96156,1104
2021-09-10,Yolo,113,214977,18187,17825,805,18630,239
2021-09-10,Yuba,115,75493,8938,8760,197,8957,62
2021-09-09,Alameda,001,1643700,112396,111014,2513,113527,1306
2021-09-09,Alpine,003,1148,97,94,0,94,0
2021-09-09,Amador,005,37829,4802,4698,45,4743,56
2021-09-09,Butte,007,227075,17671,16874,3061,19935,221
2021-09-09,Calaveras,009,45235,3269,3165,22,3187,65
2021-09-09,Colusa,011,21464,2366,2321,511,2832,16
2021-09-09,Contra Costa,013,1133247,92944,91687,1835,93522,904
2021-09-09,Del Norte,015,27424,3285,3102,20,3122,28
2021-09-09,El Dorado,017,186661,14382,13970,1425,15395,119
2021-09-09,Fresno,019,978130,123715,121040,10977,132017,1838
2021-09-09,Glenn,021,27897,3077,2947,876,3823,20
2021-09-09,Humboldt,023,135768,7715,7471,349,7820,52
2021-09-09,Imperial,025,180216,30973,30661,2904,33565,751
2021-09-09,Inyo,027,18085,1619,1586,30,1616,39
2021-09-09,Kern,029,883053,114087,111390,16827,128217,1414
2021-09-09,Kings,031,150075,28188,27282,1528,28810,273
2021-09-09,Lake,033,64148,5880,5638,109,5747,79
2021-09-09,Lassen,035,31185,6027,5860,223,6083,25
2021-09-09,Los Angeles,037,10098052,1379345,1363735,50523,1414258,25583
2021-09-09,Madera,039,155013,20028,19401,1537,20938,252
2021-09-09,Marin,041,260295,16635,16416,366,16782,242
2021-09-09,Mariposa,043,17540,845,779,28,807,5
2021-09-09,Mendocino,045,87422,6425,6089,266,6355,61
2021-09-09,Merced,047,269075,37338,36634,1428,38062,516
2021-09-09,Modoc,049,8938,462,448,159,607,5
2021-09-09,Mono,051,14174,1459,1420,17,1437,3
2021-09-09,Monterey,053,433212,46791,45991,2450,48441,556
2021-09-09,Napa,055,140530,12068,11878,79,11957,90
2021-09-09,Nevada,057,99092,8078,7855,261,8116,82
2021-09-09,Orange,059,3164182,293139,289109,13645,302754,5299
2021-09-09,Placer,061,380077,32912,32048,3009,35057,342
2021-09-09,Plumas,063,18699,1171,1098,22,1120,5
2021-09-09,Riverside,065,2383286,341341,334774,15506,350280,4701
2021-09-09,Sacramento,067,1510023,143957,142728,3408,146136,1929
2021-09-09,San Benito,069,59416,6858,6820,136,6956,64
2021-09-09,San Bernardino,071,2135413,335169,331040,10340,341380,5417
2021-09-09,San Diego,073,3302833,347069,342149,20398,362547,3929
2021-09-09,San Francisco,075,870044,49168,48404,2045,50449,597
2021-09-09,San Joaquin,077,732212,91403,89874,4753,94627,1570
2021-09-09,San Luis Obispo,079,281455,27054,26472,1029,27501,296
2021-09-09,San Mateo,081,765935,51012,50143,742,50885,561
2021-09-09,Santa Barbara,083,443738,41080,40180,1410,41590,490
2021-09-09,Santa Clara,085,1922200,138782,137017,1046,138063,1816
2021-09-09,Santa Cruz,087,273765,19037,18728,950,19678,210
2021-09-09,Shasta,089,179085,17266,16401,2683,19084,238
2021-09-09,Sierra,091,2930,129,115,13,128,0
2021-09-09,Siskiyou,093,43540,2847,2683,931,3614,35
2021-09-09,Solano,095,438530,43088,42081,1077,43158,303
2021-09-09,Sonoma,097,501317,38630,38171,459,38630,360
2021-09-09,Stanislaus,099,539301,70112,69178,7803,76981,1074
2021-09-09,Sutter,101,95872,12599,12396,206,12602,144
2021-09-09,Tehama,103,63373,6859,6554,1085,7639,75
2021-09-09,Trinity,105,12862,676,523,178,701,6
2021-09-09,Tulare,107,460477,59688,57564,11889,69453,879
2021-09-09,Tuolumne,109,53932,5939,5802,65,5867,89
2021-09-09,Ventura,111,848112,93222,91610,4002,95612,1098
2021-09-09,Yolo,113,214977,18129,17724,802,18526,239
2021-09-09,Yuba,115,75493,8893,8707,194,8901,55
2021-09-08,Alameda,001,1643700,112149,110781,2511,113292,1305
2021-09-08,Alpine,003,1148,97,94,0,94,0
2021-09-08,Amador,005,37829,4790,4693,45,4738,56
2021-09-08,Butte,007,227075,17536,16775,3042,19817,220
2021-09-08,Calaveras,009,45235,3251,3157,22,3179,63
2021-09-08,Colusa,011,21464,2364,2308,511,2819,16
2021-09-08,Contra Costa,013,1133247,92664,91471,1830,93301,900
2021-09-08,Del Norte,015,27424,3262,3085,20,3105,25
2021-09-08,El Dorado,017,186661,14302,13928,1405,15333,119
2021-09-08,Fresno,019,978130,123217,120644,10914,131558,1831
2021-09-08,Glenn,021,27897,3062,2942,867,3809,20
2021-09-08,Humboldt,023,135768,7671,7438,341,7779,52
2021-09-08,Imperial,025,180216,30940,30609,2891,33500,751
2021-09-08,Inyo,027,18085,1608,1580,30,1610,39
2021-09-08,Kern,029,883053,113689,110933,16689,127622,1409
2021-09-08,Kings,031,150075,28059,27235,1514,28749,267
2021-09-08,Lake,033,64148,5849,5618,107,5725,79
2021-09-08,Lassen,035,31185,6009,5848,216,6064,25
2021-09-08,Los Angeles,037,10098052,1377278,1362029,50434,1412463,25533
2021-09-08,Madera,039,155013,19968,19352,1524,20876,252
2021-09-08,Marin,041,260295,16607,16386,365,16751,242
2021-09-08,Mariposa,043,17540,833,777,27,804,5
2021-09-08,Mendocino,045,87422,6381,6069,257,6326,61
2021-09-08,Merced,047,269075,37177,36500,1416,37916,516
2021-09-08,Modoc,049,8938,462,448,159,607,5
2021-09-08,Mono,051,14174,1453,1418,17,1435,3
2021-09-08,Monterey,053,433212,46742,45959,2444,48403,554
2021-09-08,Napa,055,140530,12033,11842,77,11919,90
2021-09-08,Nevada,057,99092,8043,7843,260,8103,82
2021-09-08,Orange,059,3164182,292730,288511,13622,302133,5290
2021-09-08,Placer,061,380077,32775,31852,2992,34844,337
2021-09-08,Plumas,063,18699,1164,1072,22,1094,5
2021-09-08,Riverside,065,2383286,340582,334037,15481,349518,4683
2021-09-08,Sacramento,067,1510023,143478,142448,3360,145808,1921
2021-09-08,San Benito,069,59416,6840,6800,136,6936,64
2021-09-08,San Bernardino,071,2135413,334566,330279,10323,340602,5411
2021-09-08,San Diego,073,3302833,346152,341437,20347,361784,3926
2021-09-08,San Francisco,075,870044,49030,48263,2041,50304,589
2021-09-08,San Joaquin,077,732212,91123,89631,4729,94360,1561
2021-09-08,San Luis Obispo,079,281455,26960,26303,1024,27327,294
2021-09-08,San Mateo,081,765935,50907,50051,742,50793,561
2021-09-08,Santa Barbara,083,443738,40968,40000,1406,41406,490
2021-09-08,Santa Clara,085,1922200,138549,136836,1042,137878,1810
2021-09-08,Santa Cruz,087,273765,19000,18699,950,19649,210
2021-09-08,Shasta,089,179085,17111,16227,2636,18863,234
2021-09-08,Sierra,091,2930,129,113,13,126,0
2021-09-08,Siskiyou,093,43540,2814,2643,920,3563,35
2021-09-08,Solano,095,438530,42996,41971,1074,43045,302
2021-09-08,Sonoma,097,501317,38546,38075,458,38533,360
2021-09-08,Stanislaus,099,539301,69881,68945,7764,76709,1074
2021-09-08,Sutter,101,95872,12534,12349,203,12552,144
2021-09-08,Tehama,103,63373,6792,6520,1067,7587,75
2021-09-08,Trinity,105,12862,673,520,174,694,6
2021-09-08,Tulare,107,460477,59364,57425,11834,69259,876
2021-09-08,Tuolumne,109,53932,5907,5783,63,5846,89
2021-09-08,Ventura,111,848112,93070,91345,3984,95329,1096
2021-09-08,Yolo,113,214977,18048,17680,797,18477,239
2021-09-08,Yuba,115,75493,8851,8675,192,8867,55
2021-09-07,Alameda,001,1643700,111849,110550,2504,113054,1301
2021-09-07,Alpine,003,1148,96,94,0,94,0
2021-09-07,Amador,005,37829,4763,4679,45,4724,53
2021-09-07,Butte,007,227075,17380,16723,3005,19728,220
2021-09-07,Calaveras,009,45235,3210,3140,20,3160,63
2021-09-07,Colusa,011,21464,2354,2306,509,2815,16
2021-09-07,Contra Costa,013,1133247,92400,91167,1824,92991,891
2021-09-07,Del Norte,015,27424,3248,3081,20,3101,24
2021-09-07,El Dorado,017,186661,14230,13892,1390,15282,119
2021-09-07,Fresno,019,978130,122659,120268,10821,131089,1828
2021-09-07,Glenn,021,27897,3050,2937,861,3798,20
2021-09-07,Humboldt,023,135768,7611,7397,324,7721,52
2021-09-07,Imperial,025,180216,30900,30584,2883,33467,751
2021-09-07,Inyo,027,18085,1602,1579,29,1608,39
2021-09-07,Kern,029,883053,113257,110674,16531,127205,1408
2021-09-07,Kings,031,150075,27935,27169,1496,28665,267
2021-09-07,Lake,033,64148,5806,5597,99,5696,78
2021-09-07,Lassen,035,31185,5991,5842,210,6052,21
2021-09-07,Los Angeles,037,10098052,1375048,1360407,50343,1410750,25486
2021-09-07,Madera,039,155013,19881,19316,1516,20832,249
2021-09-07,Marin,041,260295,16568,16363,365,16728,242
2021-09-07,Mariposa,043,17540,817,771,27,798,5
2021-09-07,Mendocino,045,87422,6321,6036,247,6283,61
2021-09-07,Merced,047,269075,37003,36400,1410,37810,513
2021-09-07,Modoc,049,8938,460,449,159,608,5
2021-09-07,Mono,051,14174,1444,1416,17,1433,3
2021-09-07,Monterey,053,433212,46659,45911,2432,48343,543
2021-09-07,Napa,055,140530,11992,11814,77,11891,90
2021-09-07,Nevada,057,99092,8016,7829,260,8089,82
2021-09-07,Orange,059,3164182,292301,288225,13591,301816,5274
2021-09-07,Placer,061,380077,32622,31710,2964,34674,337
2021-09-07,Plumas,063,18699,1149,1071,22,1093,5
2021-09-07,Riverside,065,2383286,339795,333390,15462,348852,4666
2021-09-07,Sacramento,067,1510023,142940,142364,3314,145678,1905
2021-09-07,San Benito,069,59416,6822,6786,136,6922,64
2021-09-07,San Bernardino,071,2135413,333819,329962,10298,340260,5407
2021-09-07,San Diego,073,3302833,345154,340709,20281,360990,3922
2021-09-07,San Francisco,075,870044,48890,48175,2036,50211,589
2021-09-07,San Joaquin,077,732212,90787,89468,4715,94183,1548
2021-09-07,San Luis Obispo,079,281455,26843,26253,1015,27268,287
2021-09-07,San Mateo,081,765935,50812,49913,741,50654,561
2021-09-07,Santa Barbara,083,443738,40842,39957,1401,41358,489
2021-09-07,Santa Clara,085,1922200,138261,136631,1037,137668,1807
2021-09-07,Santa Cruz,087,273765,18951,18669,948,19617,210
2021-09-07,Shasta,089,179085,16955,16096,2584,18680,226
2021-09-07,Sierra,091,2930,129,111,13,124,0
2021-09-07,Siskiyou,093,43540,2788,2607,903,3510,34
2021-09-07,Solano,095,438530,42866,41862,1070,42932,300
2021-09-07,Sonoma,097,501317,38462,38013,456,38469,358
2021-09-07,Stanislaus,099,539301,69610,68831,7737,76568,1074
2021-09-07,Sutter,101,95872,12460,12310,197,12507,138
2021-09-07,Tehama,103,63373,6740,6482,1047,7529,74
2021-09-07,Trinity,105,12862,667,517,174,691,6
2021-09-07,Tulare,107,460477,59014,57228,11756,68984,874
2021-09-07,Tuolumne,109,53932,5870,5759,63,5822,88
2021-09-07,Ventura,111,848112,92859,91246,3974,95220,1093
2021-09-07,Yolo,113,214977,17979,17653,792,18445,235
2021-09-07,Yuba,115,75493,8808,8642,187,8829,55
2021-09-06,Alameda,001,1643700,111538,110357,2496,112853,1301
2021-09-06,Alpine,003,1148,94,94,0,94,0
2021-09-06,Amador,005,37829,4747,4648,44,4692,53
2021-09-06,Butte,007,227075,17188,16588,2962,19550,218
2021-09-06,Calaveras,009,45235,3188,3122,20,3142,63
2021-09-06,Colusa,011,21464,2347,2306,505,2811,16
2021-09-06,Contra Costa,013,1133247,92104,90971,1814,92785,891
2021-09-06,Del Norte,015,27424,3207,3037,19,3056,24
2021-09-06,El Dorado,017,186661,14161,13848,1374,15222,119
2021-09-06,Fresno,019,978130,122087,119738,10746,130484,1828
2021-09-06,Glenn,021,27897,3021,2912,853,3765,20
2021-09-06,Humboldt,023,135768,7535,7320,306,7626,52
2021-09-06,Imperial,025,180216,30837,30576,2877,33453,751
2021-09-06,Inyo,027,18085,1593,1578,17,1595,39
2021-09-06,Kern,029,883053,112743,110347,16343,126690,1408
2021-09-06,Kings,031,150075,27792,27094,1481,28575,264
2021-09-06,Lake,033,64148,5742,5548,92,5640,78
2021-09-06,Lassen,035,31185,5965,5822,200,6022,21
2021-09-06,Los Angeles,037,10098052,1372673,1359348,50228,1409576,25477
2021-09-06,Madera,039,155013,19778,19191,1493,20684,249
2021-09-06,Marin,041,260295,16528,16356,365,16721,242
2021-09-06,Mariposa,043,17540,805,764,27,791,5
2021-09-06,Mendocino,045,87422,6251,5984,234,6218,61
2021-09-06,Merced,047,269075,36789,36300,1396,37696,513
2021-09-06,Modoc,049,8938,457,449,159,608,5
2021-09-06,Mono,051,14174,1440,1416,17,1433,3
2021-09-06,Monterey,053,433212,46564,45833,2416,48249,541
2021-09-06,Napa,055,140530,11949,11792,76,11868,90
2021-09-06,Nevada,057,99092,7968,7748,258,8006,82
2021-09-06,Orange,059,3164182,291807,287948,13540,301488,5274
2021-09-06,Placer,061,380077,32445,31595,2926,34521,337
2021-09-06,Plumas,063,18699,1128,1068,19,1087,5
2021-09-06,Riverside,065,2383286,338979,333052,15442,348494,4666
2021-09-06,Sacramento,067,1510023,142305,141730,3246,144976,1905
2021-09-06,San Benito,069,59416,6799,6777,133,6910,64
2021-09-06,San Bernardino,071,2135413,332935,329693,10268,339961,5398
2021-09-06,San Diego,073,3302833,344155,340222,20184,360406,3922
2021-09-06,San Francisco,075,870044,48755,48120,2031,50151,589
2021-09-06,San Joaquin,077,732212,90443,89293,4689,93982,1548
2021-09-06,San Luis Obispo,079,281455,26714,26183,1011,27194,286
2021-09-06,San Mateo,081,765935,50682,49859,739,50598,561
2021-09-06,Santa Barbara,083,443738,40711,39876,1392,41268,489
2021-09-06,Santa Clara,085,1922200,137969,136458,1035,137493,1807
2021-09-06,Santa Cruz,087,273765,18902,18615,945,19560,210
2021-09-06,Shasta,089,179085,16774,15985,2530,18515,226
2021-09-06,Sierra,091,2930,129,109,13,122,0
2021-09-06,Siskiyou,093,43540,2744,2595,869,3464,34
2021-09-06,Solano,095,438530,42718,41774,1064,42838,300
2021-09-06,Sonoma,097,501317,38341,37929,455,38384,358
2021-09-06,Stanislaus,099,539301,69268,68596,7693,76289,1074
2021-09-06,Sutter,101,95872,12398,12238,188,12426,138
2021-09-06,Tehama,103,63373,6678,6413,1020,7433,74
2021-09-06,Trinity,105,12862,664,515,172,687,6
2021-09-06,Tulare,107,460477,58655,57068,11676,68744,874
2021-09-06,Tuolumne,109,53932,5834,5697,63,5760,88
2021-09-06,Ventura,111,848112,92682,91132,3962,95094,1093
2021-09-06,Yolo,113,214977,17893,17576,787,18363,235
2021-09-06,Yuba,115,75493,8758,8584,183,8767,55
2021-09-05,Alameda,001,1643700,111345,110173,2493,112666,1301
2021-09-05,Alpine,003,1148,94,94,0,94,0
2021-09-05,Amador,005,37829,4735,4642,44,4686,53
2021-09-05,Butte,007,227075,17098,16504,2934,19438,218
2021-09-05,Calaveras,009,45235,3182,3106,20,3126,63
2021-09-05,Colusa,011,21464,2339,2305,503,2808,16
2021-09-05,Contra Costa,013,1133247,91919,90862,1809,92671,891
2021-09-05,Del Norte,015,27424,3187,3023,19,3042,24
2021-09-05,El Dorado,017,186661,14132,13827,1361,15188,119
2021-09-05,Fresno,019,978130,121788,119384,10705,130089,1828
2021-09-05,Glenn,021,27897,3007,2899,851,3750,20
2021-09-05,Humboldt,023,135768,7502,7312,303,7615,52
2021-09-05,Imperial,025,180216,30808,30548,2875,33423,751
2021-09-05,Inyo,027,18085,1590,1572,17,1589,39
2021-09-05,Kern,029,883053,112443,110073,16184,126257,1408
2021-09-05,Kings,031,150075,27715,26989,1477,28466,264
2021-09-05,Lake,033,64148,5722,5525,92,5617,78
2021-09-05,Lassen,035,31185,5943,5820,196,6016,21
2021-09-05,Los Angeles,037,10098052,1371378,1357748,50160,1407908,25465
2021-09-05,Madera,039,155013,19737,19155,1482,20637,249
2021-09-05,Marin,041,260295,16509,16342,364,16706,242
2021-09-05,Mariposa,043,17540,801,761,27,788,5
2021-09-05,Mendocino,045,87422,6217,5965,234,6199,61
2021-09-05,Merced,047,269075,36714,36243,1394,37637,513
2021-09-05,Modoc,049,8938,457,447,159,606,5
2021-09-05,Mono,051,14174,1440,1416,17,1433,3
2021-09-05,Monterey,053,433212,46536,45795,2407,48202,540
2021-09-05,Napa,055,140530,11924,11770,76,11846,90
2021-09-05,Nevada,057,99092,7946,7722,257,7979,82
2021-09-05,Orange,059,3164182,291519,287614,13523,301137,5274
2021-09-05,Placer,061,380077,32317,31487,2912,34399,337
2021-09-05,Plumas,063,18699,1121,1067,19,1086,5
2021-09-05,Riverside,065,2383286,338524,332604,15430,348034,4654
2021-09-05,Sacramento,067,1510023,141868,141276,3229,144505,1905
2021-09-05,San Benito,069,59416,6798,6764,133,6897,64
2021-09-05,San Bernardino,071,2135413,332551,329062,10252,339314,5392
2021-09-05,San Diego,073,3302833,343603,339427,20143,359570,3914
2021-09-05,San Francisco,075,870044,48677,48035,2027,50062,589
2021-09-05,San Joaquin,077,732212,90277,89121,4672,93793,1548
2021-09-05,San Luis Obispo,079,281455,26664,26098,1010,27108,285
2021-09-05,San Mateo,081,765935,50614,49809,735,50544,561
2021-09-05,Santa Barbara,083,443738,40644,39762,1390,41152,489
2021-09-05,Santa Clara,085,1922200,137759,136146,1033,137179,1807
2021-09-05,Santa Cruz,087,273765,18882,18588,943,19531,210
2021-09-05,Shasta,089,179085,16691,15960,2504,18464,226
2021-09-05,Sierra,091,2930,128,109,13,122,0
2021-09-05,Siskiyou,093,43540,2727,2585,855,3440,34
2021-09-05,Solano,095,438530,42623,41687,1059,42746,300
2021-09-05,Sonoma,097,501317,38256,37881,454,38335,358
2021-09-05,Stanislaus,099,539301,69129,68434,7669,76103,1074
2021-09-05,Sutter,101,95872,12368,12179,182,12361,138
2021-09-05,Tehama,103,63373,6651,6400,1014,7414,74
2021-09-05,Trinity,105,12862,658,505,171,676,6
2021-09-05,Tulare,107,460477,58486,56915,11632,68547,874
2021-09-05,Tuolumne,109,53932,5822,5688,63,5751,88
2021-09-05,Ventura,111,848112,92546,91004,3958,94962,1093
2021-09-05,Yolo,113,214977,17856,17557,782,18339,235
2021-09-05,Yuba,115,75493,8731,8521,181,8702,55
2021-09-04,Alameda,001,1643700,111222,109944,2486,112430,1301
2021-09-04,Alpine,003,1148,94,94,0,94,0
2021-09-04,Amador,005,37829,4717,4637,43,4680,53
2021-09-04,Butte,007,227075,17040,16403,2919,19322,218
2021-09-04,Calaveras,009,45235,3170,3087,19,3106,63
2021-09-04,Colusa,011,21464,2337,2301,503,2804,16
2021-09-04,Contra Costa,013,1133247,91802,90623,1806,92429,891
2021-09-04,Del Norte,015,27424,3176,2984,19,3003,24
2021-09-04,El Dorado,017,186661,14106,13782,1353,15135,119
2021-09-04,Fresno,019,978130,121592,119033,10684,129717,1828
2021-09-04,Glenn,021,27897,2997,2878,845,3723,20
2021-09-04,Humboldt,023,135768,7471,7298,297,7595,52
2021-09-04,Imperial,025,180216,30785,30526,2873,33399,751
2021-09-04,Inyo,027,18085,1588,1571,17,1588,39
2021-09-04,Kern,029,883053,112200,109751,16054,125805,1408
2021-09-04,Kings,031,150075,27628,26896,1471,28367,263
2021-09-04,Lake,033,64148,5704,5507,92,5599,78
2021-09-04,Lassen,035,31185,5928,5814,188,6002,21
2021-09-04,Los Angeles,037,10098052,1370424,1355634,50101,1405735,25454
2021-09-04,Madera,039,155013,19704,19112,1475,20587,249
2021-09-04,Marin,041,260295,16493,16319,363,16682,242
2021-09-04,Mariposa,043,17540,796,759,27,786,5
2021-09-04,Mendocino,045,87422,6181,5933,234,6167,61
2021-09-04,Merced,047,269075,36670,36083,1389,37472,513
2021-09-04,Modoc,049,8938,457,447,159,606,5
2021-09-04,Mono,051,14174,1437,1417,17,1434,3
2021-09-04,Monterey,053,433212,46505,45756,2403,48159,540
2021-09-04,Napa,055,140530,11899,11760,74,11834,90
2021-09-04,Nevada,057,99092,7931,7691,256,7947,82
2021-09-04,Orange,059,3164182,291256,287244,13502,300746,5274
2021-09-04,Placer,061,380077,32213,31374,2895,34269,337
2021-09-04,Plumas,063,18699,1113,1067,19,1086,5
2021-09-04,Riverside,065,2383286,338054,331958,15418,347376,4654
2021-09-04,Sacramento,067,1510023,141575,140735,3221,143956,1896
2021-09-04,San Benito,069,59416,6789,6758,133,6891,64
2021-09-04,San Bernardino,071,2135413,332219,328425,10238,338663,5393
2021-09-04,San Diego,073,3302833,343168,338748,20121,358869,3914
2021-09-04,San Francisco,075,870044,48602,47937,2019,49956,589
2021-09-04,San Joaquin,077,732212,90161,88846,4664,93510,1548
2021-09-04,San Luis Obispo,079,281455,26632,26020,1010,27030,285
2021-09-04,San Mateo,081,765935,50560,49721,735,50456,560
2021-09-04,Santa Barbara,083,443738,40578,39667,1388,41055,489
2021-09-04,Santa Clara,085,1922200,137574,135845,1030,136875,1806
2021-09-04,Santa Cruz,087,273765,18864,18579,939,19518,210
2021-09-04,Shasta,089,179085,16614,15924,2478,18402,226
2021-09-04,Sierra,091,2930,126,108,13,121,0
2021-09-04,Siskiyou,093,43540,2701,2563,844,3407,34
2021-09-04,Solano,095,438530,42550,41614,1057,42671,300
2021-09-04,Sonoma,097,501317,38223,37809,454,38263,358
2021-09-04,Stanislaus,099,539301,68982,68210,7644,75854,1074
2021-09-04,Sutter,101,95872,12327,12137,181,12318,138
2021-09-04,Tehama,103,63373,6626,6367,996,7363,74
2021-09-04,Trinity,105,12862,656,497,171,668,6
2021-09-04,Tulare,107,460477,58378,56719,11589,68308,874
2021-09-04,Tuolumne,109,53932,5803,5667,61,5728,88
2021-09-04,Ventura,111,848112,92411,90904,3955,94859,1090
2021-09-04,Yolo,113,214977,17820,17522,778,18300,235
2021-09-04,Yuba,115,75493,8702,8475,180,8655,55
2021-09-03,Alameda,001,1643700,111061,109636,2483,112119,1301
2021-09-03,Alpine,003,1148,94,94,0,94,0
2021-09-03,Amador,005,37829,4695,4614,43,4657,53
2021-09-03,Butte,007,227075,16949,16259,2893,19152,215
2021-09-03,Calaveras,009,45235,3160,3069,19,3088,63
2021-09-03,Colusa,011,21464,2332,2295,502,2797,16
2021-09-03,Contra Costa,013,1133247,91650,90299,1803,92102,886
2021-09-03,Del Norte,015,27424,3148,2943,18,2961,24
2021-09-03,El Dorado,017,186661,14073,13710,1348,15058,119
2021-09-03,Fresno,019,978130,121257,118508,10662,129170,1822
2021-09-03,Glenn,021,27897,2988,2867,838,3705,20
2021-09-03,Humboldt,023,135768,7446,7194,292,7486,52
2021-09-03,Imperial,025,180216,30762,30475,2868,33343,751
2021-09-03,Inyo,027,18085,1583,1567,17,1584,39
2021-09-03,Kern,029,883053,111984,109296,15943,125239,1407
2021-09-03,Kings,031,150075,27544,26753,1468,28221,263
2021-09-03,Lake,033,64148,5684,5479,90,5569,78
2021-09-03,Lassen,035,31185,5911,5789,184,5973,21
2021-09-03,Los Angeles,037,10098052,1369093,1351185,50035,1401220,25384
2021-09-03,Madera,039,155013,19619,19021,1469,20490,247
2021-09-03,Marin,041,260295,16471,16293,362,16655,242
2021-09-03,Mariposa,043,17540,789,753,25,778,5
2021-09-03,Mendocino,045,87422,6146,5891,234,6125,61
2021-09-03,Merced,047,269075,36616,35941,1380,37321,512
2021-09-03,Modoc,049,8938,457,445,159,604,5
2021-09-03,Mono,051,14174,1436,1410,17,1427,3
2021-09-03,Monterey,053,433212,46467,45707,2399,48106,540
2021-09-03,Napa,055,140530,11878,11733,74,11807,89
2021-09-03,Nevada,057,99092,7897,7632,256,7888,82
2021-09-03,Orange,059,3164182,290939,286818,13475,300293,5253
2021-09-03,Placer,061,380077,32106,31238,2871,34109,335
2021-09-03,Plumas,063,18699,1102,1057,19,1076,5
2021-09-03,Riverside,065,2383286,337522,331011,15402,346413,4653
2021-09-03,Sacramento,067,1510023,141211,139982,3203,143185,1886
2021-09-03,San Benito,069,59416,6783,6746,133,6879,64
2021-09-03,San Bernardino,071,2135413,331803,327599,10227,337826,5381
2021-09-03,San Diego,073,3302833,342548,337627,20088,357715,3911
2021-09-03,San Francisco,075,870044,48526,47822,2013,49835,589
2021-09-03,San Joaquin,077,732212,90008,88366,4656,93022,1540
2021-09-03,San Luis Obispo,079,281455,26556,25917,1008,26925,283
2021-09-03,San Mateo,081,765935,50465,49617,733,50350,560
2021-09-03,Santa Barbara,083,443738,40511,39507,1385,40892,489
2021-09-03,Santa Clara,085,1922200,137372,135522,1026,136548,1801
2021-09-03,Santa Cruz,087,273765,18839,18532,939,19471,210
2021-09-03,Shasta,089,179085,16539,15778,2454,18232,226
2021-09-03,Sierra,091,2930,124,105,13,118,0
2021-09-03,Siskiyou,093,43540,2689,2529,831,3360,34
2021-09-03,Solano,095,438530,42454,41457,1054,42511,300
2021-09-03,Sonoma,097,501317,38160,37699,454,38153,358
2021-09-03,Stanislaus,099,539301,68807,67887,7618,75505,1074
2021-09-03,Sutter,101,95872,12288,12073,180,12253,139
2021-09-03,Tehama,103,63373,6587,6334,989,7323,72
2021-09-03,Trinity,105,12862,654,490,167,657,6
2021-09-03,Tulare,107,460477,58252,56401,11537,67938,872
2021-09-03,Tuolumne,109,53932,5761,5630,61,5691,88
2021-09-03,Ventura,111,848112,92277,90742,3951,94693,1088
2021-09-03,Yolo,113,214977,17797,17446,773,18219,235
2021-09-03,Yuba,115,75493,8671,8412,180,8592,55
2021-09-02,Alameda,001,1643700,110801,109377,2480,111857,1301
2021-09-02,Alpine,003,1148,93,92,0,92,0
2021-09-02,Amador,005,37829,4679,4606,43,4649,53
2021-09-02,Butte,007,227075,16822,16154,2874,19028,215
2021-09-02,Calaveras,009,45235,3147,3042,19,3061,62
2021-09-02,Colusa,011,21464,2328,2290,502,2792,16
2021-09-02,Contra Costa,013,1133247,91468,90038,1792,91830,886
2021-09-02,Del Norte,015,27424,3117,2891,18,2909,24
2021-09-02,El Dorado,017,186661,14014,13641,1323,14964,119
2021-09-02,Fresno,019,978130,120769,117974,10608,128582,1804
2021-09-02,Glenn,021,27897,2972,2855,832,3687,20
2021-09-02,Humboldt,023,135768,7399,7141,281,7422,52
2021-09-02,Imperial,025,180216,30718,30449,2863,33312,751
2021-09-02,Inyo,027,18085,1578,1564,16,1580,39
2021-09-02,Kern,029,883053,111572,108930,15799,124729,1404
2021-09-02,Kings,031,150075,27451,26638,1458,28096,263
2021-09-02,Lake,033,64148,5654,5432,86,5518,78
2021-09-02,Lassen,035,31185,5897,5747,177,5924,21
2021-09-02,Los Angeles,037,10098052,1367237,1351105,49942,1401047,25382
2021-09-02,Madera,039,155013,19528,18937,1451,20388,247
2021-09-02,Marin,041,260295,16458,16244,360,16604,242
2021-09-02,Mariposa,043,17540,782,745,22,767,5
2021-09-02,Mendocino,045,87422,6104,5848,231,6079,61
2021-09-02,Merced,047,269075,36453,35820,1373,37193,508
2021-09-02,Modoc,049,8938,457,437,159,596,5
2021-09-02,Mono,051,14174,1436,1409,17,1426,3
2021-09-02,Monterey,053,433212,46401,45648,2384,48032,539
2021-09-02,Napa,055,140530,11849,11684,74,11758,88
2021-09-02,Nevada,057,99092,7845,7575,255,7830,82
2021-09-02,Orange,059,3164182,290479,286326,13441,299767,5240
2021-09-02,Placer,061,380077,31969,31067,2842,33909,330
2021-09-02,Plumas,063,18699,1091,1045,18,1063,5
2021-09-02,Riverside,065,2383286,336807,330190,15378,345568,4644
2021-09-02,Sacramento,067,1510023,140630,139274,3164,142438,1882
2021-09-02,San Benito,069,59416,6778,6734,132,6866,64
2021-09-02,San Bernardino,071,2135413,331197,326940,10154,337094,5369
2021-09-02,San Diego,073,3302833,341590,336382,20035,356417,3909
2021-09-02,San Francisco,075,870044,48418,47674,2009,49683,587
2021-09-02,San Joaquin,077,732212,89724,88056,4632,92688,1540
2021-09-02,San Luis Obispo,079,281455,26470,25851,1003,26854,283
2021-09-02,San Mateo,081,765935,50364,49490,731,50221,558
2021-09-02,Santa Barbara,083,443738,40421,39386,1372,40758,486
2021-09-02,Santa Clara,085,1922200,137071,135216,1020,136236,1799
2021-09-02,Santa Cruz,087,273765,18805,18473,936,19409,210
2021-09-02,Shasta,089,179085,16401,15670,2425,18095,224
2021-09-02,Sierra,091,2930,124,105,13,118,0
2021-09-02,Siskiyou,093,43540,2668,2513,803,3316,34
2021-09-02,Solano,095,438530,42348,41293,1051,42344,294
2021-09-02,Sonoma,097,501317,38079,37558,454,38012,352
2021-09-02,Stanislaus,099,539301,68566,67576,7598,75174,1074
2021-09-02,Sutter,101,95872,12219,11995,176,12171,138
2021-09-02,Tehama,103,63373,6529,6265,970,7235,72
2021-09-02,Trinity,105,12862,650,484,165,649,6
2021-09-02,Tulare,107,460477,58022,56105,11486,67591,872
2021-09-02,Tuolumne,109,53932,5705,5578,61,5639,88
2021-09-02,Ventura,111,848112,92094,90610,3946,94556,1084
2021-09-02,Yolo,113,214977,17727,17357,762,18119,235
2021-09-02,Yuba,115,75493,8611,8363,180,8543,55
2021-09-01,Alameda,001,1643700,110534,109075,2475,111550,1299
2021-09-01,Alpine,003,1148,93,92,0,92,0
2021-09-01,Amador,005,37829,4663,4599,42,4641,53
2021-09-01,Butte,007,227075,16707,16046,2846,18892,215
2021-09-01,Calaveras,009,45235,3135,3023,19,3042,59
2021-09-01,Colusa,011,21464,2323,2281,501,2782,16
2021-09-01,Contra Costa,013,1133247,91233,89834,1785,91619,877
2021-09-01,Del Norte,015,27424,3084,2860,18,2878,24
2021-09-01,El Dorado,017,186661,13958,13577,1294,14871,119
2021-09-01,Fresno,019,978130,120278,117492,10539,128031,1800
2021-09-01,Glenn,021,27897,2947,2846,824,3670,20
2021-09-01,Humboldt,023,135768,7352,7090,274,7364,52
2021-09-01,Imperial,025,180216,30680,30393,2858,33251,750
2021-09-01,Inyo,027,18085,1574,1561,15,1576,39
2021-09-01,Kern,029,883053,111141,108449,15661,124110,1400
2021-09-01,Kings,031,150075,27338,26443,1447,27890,263
2021-09-01,Lake,033,64148,5613,5396,81,5477,77
2021-09-01,Lassen,035,31185,5875,5731,173,5904,21
2021-09-01,Los Angeles,037,10098052,1364973,1348589,49839,1398428,25341
2021-09-01,Madera,039,155013,19450,18852,1436,20288,247
2021-09-01,Marin,041,260295,16436,16224,355,16579,240
2021-09-01,Mariposa,043,17540,774,735,22,757,5
2021-09-01,Mendocino,045,87422,6061,5821,226,6047,59
2021-09-01,Merced,047,269075,36276,35686,1363,37049,500
2021-09-01,Modoc,049,8938,451,436,157,593,5
2021-09-01,Mono,051,14174,1436,1400,17,1417,3
2021-09-01,Monterey,053,433212,46321,45590,2369,47959,539
2021-09-01,Napa,055,140530,11816,11653,74,11727,88
2021-09-01,Nevada,057,99092,7792,7508,254,7762,82
2021-09-01,Orange,059,3164182,290004,285840,13404,299244,5233
2021-09-01,Placer,061,380077,31814,30902,2828,33730,330
2021-09-01,Plumas,063,18699,1083,1033,18,1051,5
2021-09-01,Riverside,065,2383286,335991,329388,15348,344736,4634
2021-09-01,Sacramento,067,1510023,140022,138499,3119,141618,1875
2021-09-01,San Benito,069,59416,6761,6716,132,6848,64
2021-09-01,San Bernardino,071,2135413,330548,326250,10125,336375,5364
2021-09-01,San Diego,073,3302833,340568,335302,19979,355281,3908
2021-09-01,San Francisco,075,870044,48310,47538,2002,49540,584
2021-09-01,San Joaquin,077,732212,89402,87640,4609,92249,1540
2021-09-01,San Luis Obispo,079,281455,26374,25691,998,26689,283
2021-09-01,San Mateo,081,765935,50244,49394,725,50119,558
2021-09-01,Santa Barbara,083,443738,40303,39263,1356,40619,483
2021-09-01,Santa Clara,085,1922200,136803,134855,1014,135869,1796
2021-09-01,Santa Cruz,087,273765,18758,18453,934,19387,210
2021-09-01,Shasta,089,179085,16269,15552,2385,17937,221
2021-09-01,Sierra,091,2930,123,98,13,111,0
2021-09-01,Siskiyou,093,43540,2638,2482,783,3265,34
2021-09-01,Solano,095,438530,42197,41194,1045,42239,293
2021-09-01,Sonoma,097,501317,37985,37454,453,37907,352
2021-09-01,Stanislaus,099,539301,68281,67287,7567,74854,1075
2021-09-01,Sutter,101,95872,12155,11945,169,12114,136
2021-09-01,Tehama,103,63373,6495,6228,953,7181,72
2021-09-01,Trinity,105,12862,649,482,162,644,5
2021-09-01,Tulare,107,460477,57739,55768,11449,67217,870
2021-09-01,Tuolumne,109,53932,5666,5553,61,5614,88
2021-09-01,Ventura,111,848112,91879,90471,3930,94401,1089
2021-09-01,Yolo,113,214977,17671,17264,756,18020,235
2021-09-01,Yuba,115,75493,8549,8308,180,8488,55
2021-08-31,Alameda,001,1643700,110238,108837,2469,111306,1297
2021-08-31,Alpine,003,1148,91,92,0,92,0
2021-08-31,Amador,005,37829,4642,4555,42,4597,53
2021-08-31,Butte,007,227075,16565,15896,2805,18701,216
2021-08-31,Calaveras,009,45235,3095,3008,19,3027,59
2021-08-31,Colusa,011,21464,2321,2275,499,2774,16
2021-08-31,Contra Costa,013,1133247,90938,89546,1773,91319,871
2021-08-31,Del Norte,015,27424,3048,2830,18,2848,19
2021-08-31,El Dorado,017,186661,13887,13539,1276,14815,119
2021-08-31,Fresno,019,978130,119702,117155,10460,127615,1801
2021-08-31,Glenn,021,27897,2931,2829,814,3643,20
2021-08-31,Humboldt,023,135768,7277,7030,261,7291,52
2021-08-31,Imperial,025,180216,30643,30348,2850,33198,750
2021-08-31,Inyo,027,18085,1570,1550,15,1565,39
2021-08-31,Kern,029,883053,110639,108151,15482,123633,1393
2021-08-31,Kings,031,150075,27196,26405,1433,27838,260
2021-08-31,Lake,033,64148,5569,5359,80,5439,74
2021-08-31,Lassen,035,31185,5849,5702,170,5872,21
2021-08-31,Los Angeles,037,10098052,1362382,1346686,49761,1396447,25303
2021-08-31,Madera,039,155013,19360,18811,1419,20230,247
2021-08-31,Marin,041,260295,16407,16215,352,16567,240
2021-08-31,Mariposa,043,17540,766,732,22,754,5
2021-08-31,Mendocino,045,87422,6019,5777,225,6002,59
2021-08-31,Merced,047,269075,36106,35512,1358,36870,498
2021-08-31,Modoc,049,8938,450,436,157,593,5
2021-08-31,Mono,051,14174,1424,1398,17,1415,3
2021-08-31,Monterey,053,433212,46237,45550,2356,47906,539
2021-08-31,Napa,055,140530,11769,11618,74,11692,88
2021-08-31,Nevada,057,99092,7726,7460,254,7714,82
2021-08-31,Orange,059,3164182,289406,285310,13372,298682,5229
2021-08-31,Placer,061,380077,31624,30745,2791,33536,325
2021-08-31,Plumas,063,18699,1079,1018,17,1035,5
2021-08-31,Riverside,065,2383286,335017,328556,15315,343871,4627
2021-08-31,Sacramento,067,1510023,139338,137879,3087,140966,1863
2021-08-31,San Benito,069,59416,6749,6694,130,6824,64
2021-08-31,San Bernardino,071,2135413,329800,325446,10105,335551,5350
2021-08-31,San Diego,073,3302833,339315,334377,19921,354298,3888
2021-08-31,San Francisco,075,870044,48159,47440,1991,49431,581
2021-08-31,San Joaquin,077,732212,88958,87365,4594,91959,1540
2021-08-31,San Luis Obispo,079,281455,26251,25518,994,26512,282
2021-08-31,San Mateo,081,765935,50132,49299,725,50024,556
2021-08-31,Santa Barbara,083,443738,40152,39091,1350,40441,481
2021-08-31,Santa Clara,085,1922200,136452,134637,1007,135644,1793
2021-08-31,Santa Cruz,087,273765,18720,18419,931,19350,210
2021-08-31,Shasta,089,179085,16117,15368,2358,17726,220
2021-08-31,Sierra,091,2930,120,95,13,108,0
2021-08-31,Siskiyou,093,43540,2618,2435,767,3202,33
2021-08-31,Solano,095,438530,42058,41067,1039,42106,289
2021-08-31,Sonoma,097,501317,37889,37379,452,37831,352
2021-08-31,Stanislaus,099,539301,67927,67004,7532,74536,1075
2021-08-31,Sutter,101,95872,12090,11901,165,12066,136
2021-08-31,Tehama,103,63373,6434,6169,922,7091,72
2021-08-31,Trinity,105,12862,643,480,162,642,3
2021-08-31,Tulare,107,460477,57405,55567,11379,66946,870
2021-08-31,Tuolumne,109,53932,5630,5516,61,5577,88
2021-08-31,Ventura,111,848112,91660,90292,3918,94210,1081
2021-08-31,Yolo,113,214977,17590,17205,748,17953,234
2021-08-31,Yuba,115,75493,8495,8253,180,8433,54
2021-08-30,Alameda,001,1643700,109916,107734,2458,110192,1296
2021-08-30,Alpine,003,1148,91,92,0,92,0
2021-08-30,Amador,005,37829,4631,4507,42,4549,53
2021-08-30,Butte,007,227075,16414,15719,2771,18490,214
2021-08-30,Calaveras,009,45235,3080,2975,19,2994,59
2021-08-30,Colusa,011,21464,2312,2271,496,2767,16
2021-08-30,Contra Costa,013,1133247,90678,87679,1763,89442,872
2021-08-30,Del Norte,015,27424,3006,2796,17,2813,11
2021-08-30,El Dorado,017,186661,13818,13217,1259,14476,119
2021-08-30,Fresno,019,978130,119130,115867,10388,126255,1790
2021-08-30,Glenn,021,27897,2920,2804,808,3612,20
2021-08-30,Humboldt,023,135768,7223,6930,255,7185,52
2021-08-30,Imperial,025,180216,30605,30311,2845,33156,750
2021-08-30,Inyo,027,18085,1565,1544,15,1559,39
2021-08-30,Kern,029,883053,110160,107615,15320,122935,1389
2021-08-30,Kings,031,150075,27080,26236,1418,27654,259
2021-08-30,Lake,033,64148,5534,5323,77,5400,74
2021-08-30,Lassen,035,31185,5827,5667,164,5831,21
2021-08-30,Los Angeles,037,10098052,1359921,1344949,49676,1394625,25269
2021-08-30,Madera,039,155013,19278,18622,1399,20021,247
2021-08-30,Marin,041,260295,16376,16160,352,16512,240
2021-08-30,Mariposa,043,17540,760,715,21,736,5
2021-08-30,Mendocino,045,87422,5985,5721,221,5942,55
2021-08-30,Merced,047,269075,35978,35335,1354,36689,497
2021-08-30,Modoc,049,8938,448,436,156,592,5
2021-08-30,Mono,051,14174,1423,1390,17,1407,3
2021-08-30,Monterey,053,433212,46175,45463,2339,47802,539
2021-08-30,Napa,055,140530,11720,11579,72,11651,87
2021-08-30,Nevada,057,99092,7667,7356,251,7607,82
2021-08-30,Orange,059,3164182,288825,284750,13323,298073,5223
2021-08-30,Placer,061,380077,31459,29825,2768,32593,319
2021-08-30,Plumas,063,18699,1062,998,17,1015,5
2021-08-30,Riverside,065,2383286,334121,327593,15284,342877,4623
2021-08-30,Sacramento,067,1510023,138680,134571,3041,137612,1847
2021-08-30,San Benito,069,59416,6740,6663,130,6793,64
2021-08-30,San Bernardino,071,2135413,329122,324870,10075,334945,5348
2021-08-30,San Diego,073,3302833,338044,333011,19841,352852,3885
2021-08-30,San Francisco,075,870044,48020,46966,1978,48944,581
2021-08-30,San Joaquin,077,732212,88627,86203,4573,90776,1528
2021-08-30,San Luis Obispo,079,281455,26126,25422,987,26409,280
2021-08-30,San Mateo,081,765935,50006,48839,719,49558,554
2021-08-30,Santa Barbara,083,443738,40000,38998,1345,40343,481
2021-08-30,Santa Clara,085,1922200,136131,133281,1000,134281,1789
2021-08-30,Santa Cruz,087,273765,18666,18326,927,19253,210
2021-08-30,Shasta,089,179085,15988,15238,2319,17557,217
2021-08-30,Sierra,091,2930,118,91,13,104,0
2021-08-30,Siskiyou,093,43540,2605,2411,756,3167,33
2021-08-30,Solano,095,438530,41897,39986,1035,41021,290
2021-08-30,Sonoma,097,501317,37784,36764,452,37216,352
2021-08-30,Stanislaus,099,539301,67588,66173,7501,73674,1074
2021-08-30,Sutter,101,95872,12020,11791,158,11949,136
2021-08-30,Tehama,103,63373,6355,6085,898,6983,71
2021-08-30,Trinity,105,12862,632,468,159,627,3
2021-08-30,Tulare,107,460477,57093,55140,11304,66444,870
2021-08-30,Tuolumne,109,53932,5584,5492,61,5553,74
2021-08-30,Ventura,111,848112,91444,90149,3906,94055,1082
2021-08-30,Yolo,113,214977,17528,17071,744,17815,231
2021-08-30,Yuba,115,75493,8421,8129,179,8308,54
2021-08-29,Alameda,001,1643700,109578,107494,2447,109941,1296
2021-08-29,Alpine,003,1148,91,92,0,92,0
2021-08-29,Amador,005,37829,4617,4501,42,4543,53
2021-08-29,Butte,007,227075,16244,15602,2734,18336,214
2021-08-29,Calaveras,009,45235,3048,2970,19,2989,59
2021-08-29,Colusa,011,21464,2305,2260,490,2750,16
2021-08-29,Contra Costa,013,1133247,90382,87439,1758,89197,872
2021-08-29,Del Norte,015,27424,2963,2752,17,2769,11
2021-08-29,El Dorado,017,186661,13762,13166,1248,14414,119
2021-08-29,Fresno,019,978130,118533,115502,10319,125821,1790
2021-08-29,Glenn,021,27897,2902,2778,801,3579,20
2021-08-29,Humboldt,023,135768,7179,6922,240,7162,52
2021-08-29,Imperial,025,180216,30544,30293,2834,33127,750
2021-08-29,Inyo,027,18085,1555,1543,14,1557,39
2021-08-29,Kern,029,883053,109709,107324,15150,122474,1389
2021-08-29,Kings,031,150075,26926,26143,1404,27547,259
2021-08-29,Lake,033,64148,5494,5293,67,5360,74
2021-08-29,Lassen,035,31185,5804,5666,160,5826,21
2021-08-29,Los Angeles,037,10098052,1357172,1342541,49565,1392106,25263
2021-08-29,Madera,039,155013,19191,18594,1383,19977,247
2021-08-29,Marin,041,260295,16345,16134,350,16484,240
2021-08-29,Mariposa,043,17540,754,709,19,728,5
2021-08-29,Mendocino,045,87422,5927,5689,208,5897,55
2021-08-29,Merced,047,269075,35739,35250,1342,36592,497
2021-08-29,Modoc,049,8938,445,436,156,592,5
2021-08-29,Mono,051,14174,1416,1387,17,1404,3
2021-08-29,Monterey,053,433212,46069,45424,2316,47740,539
2021-08-29,Napa,055,140530,11689,11552,72,11624,87
2021-08-29,Nevada,057,99092,7610,7294,250,7544,82
2021-08-29,Orange,059,3164182,288196,284432,13281,297713,5223
2021-08-29,Placer,061,380077,31287,29674,2727,32401,319
2021-08-29,Plumas,063,18699,1051,996,17,1013,5
2021-08-29,Riverside,065,2383286,333264,326987,15263,342250,4623
2021-08-29,Sacramento,067,1510023,137927,133981,2992,136973,1843
2021-08-29,San Benito,069,59416,6715,6646,130,6776,64
2021-08-29,San Bernardino,071,2135413,328337,324266,10041,334307,5347
2021-08-29,San Diego,073,3302833,336938,332014,19745,351759,3880
2021-08-29,San Francisco,075,870044,47885,46885,1966,48851,581
2021-08-29,San Joaquin,077,732212,88178,85922,4553,90475,1528
2021-08-29,San Luis Obispo,079,281455,25928,25288,979,26267,280
2021-08-29,San Mateo,081,765935,49893,48737,714,49451,554
2021-08-29,Santa Barbara,083,443738,39834,38900,1341,40241,481
2021-08-29,Santa Clara,085,1922200,135778,132979,994,133973,1789
2021-08-29,Santa Cruz,087,273765,18619,18285,925,19210,210
2021-08-29,Shasta,089,179085,15834,15198,2292,17490,217
2021-08-29,Sierra,091,2930,116,91,13,104,0
2021-08-29,Siskiyou,093,43540,2558,2407,736,3143,33
2021-08-29,Solano,095,438530,41743,39887,1028,40915,290
2021-08-29,Sonoma,097,501317,37649,36650,448,37098,352
2021-08-29,Stanislaus,099,539301,67243,65956,7465,73421,1074
2021-08-29,Sutter,101,95872,11961,11719,151,11870,136
2021-08-29,Tehama,103,63373,6284,6040,875,6915,71
2021-08-29,Trinity,105,12862,629,468,156,624,3
2021-08-29,Tulare,107,460477,56760,54974,11220,66194,870
2021-08-29,Tuolumne,109,53932,5559,5478,60,5538,74
2021-08-29,Ventura,111,848112,91186,90114,3897,94011,1082
2021-08-29,Yolo,113,214977,17428,17015,731,17746,231
2021-08-29,Yuba,115,75493,8357,8042,179,8221,54
2021-08-28,Alameda,001,1643700,109413,107007,2438,109445,1296
2021-08-28,Alpine,003,1148,91,92,0,92,0
2021-08-28,Amador,005,37829,4598,4484,41,4525,53
2021-08-28,Butte,007,227075,16184,15487,2706,18193,214
2021-08-28,Calaveras,009,45235,3038,2926,19,2945,59
2021-08-28,Colusa,011,21464,2301,2252,488,2740,16
2021-08-28,Contra Costa,013,1133247,90170,86938,1755,88693,872
2021-08-28,Del Norte,015,27424,2936,2734,16,2750,11
2021-08-28,El Dorado,017,186661,13723,13089,1242,14331,119
2021-08-28,Fresno,019,978130,118292,115079,10288,125367,1792
2021-08-28,Glenn,021,27897,2893,2773,794,3567,20
2021-08-28,Humboldt,023,135768,7144,6887,235,7122,52
2021-08-28,Imperial,025,180216,30517,30260,2831,33091,750
2021-08-28,Inyo,027,18085,1553,1539,14,1553,39
2021-08-28,Kern,029,883053,109471,107012,15010,122022,1389
2021-08-28,Kings,031,150075,26859,26059,1401,27460,257
2021-08-28,Lake,033,64148,5471,5267,63,5330,74
2021-08-28,Lassen,035,31185,5789,5665,159,5824,21
2021-08-28,Los Angeles,037,10098052,1355960,1337097,49493,1386590,25234
2021-08-28,Madera,039,155013,19140,18553,1369,19922,247
2021-08-28,Marin,041,260295,16330,16106,350,16456,240
2021-08-28,Mariposa,043,17540,752,704,19,723,5
2021-08-28,Mendocino,045,87422,5902,5658,208,5866,55
2021-08-28,Merced,047,269075,35687,35108,1339,36447,497
2021-08-28,Modoc,049,8938,445,436,155,591,5
2021-08-28,Mono,051,14174,1413,1385,17,1402,3
2021-08-28,Monterey,053,433212,46027,45394,2311,47705,539
2021-08-28,Napa,055,140530,11666,11512,71,11583,88
2021-08-28,Nevada,057,99092,7586,7238,248,7486,82
2021-08-28,Orange,059,3164182,287838,283953,13233,297186,5222
2021-08-28,Placer,061,380077,31178,29428,2714,32142,319
2021-08-28,Plumas,063,18699,1044,991,17,1008,5
2021-08-28,Riverside,065,2383286,332676,326222,15253,341475,4623
2021-08-28,Sacramento,067,1510023,137536,132985,2976,135961,1844
2021-08-28,San Benito,069,59416,6708,6636,130,6766,64
2021-08-28,San Bernardino,071,2135413,327889,323672,10033,333705,5348
2021-08-28,San Diego,073,3302833,336354,331330,19709,351039,3880
2021-08-28,San Francisco,075,870044,47813,46654,1959,48613,581
2021-08-28,San Joaquin,077,732212,88008,85481,4544,90025,1527
2021-08-28,San Luis Obispo,079,281455,25861,25138,974,26112,280
2021-08-28,San Mateo,081,765935,49819,48575,710,49285,554
2021-08-28,Santa Barbara,083,443738,39763,38780,1341,40121,481
2021-08-28,Santa Clara,085,1922200,135571,132488,992,133480,1789
2021-08-28,Santa Cruz,087,273765,18601,18240,922,19162,210
2021-08-28,Shasta,089,179085,15731,15147,2274,17421,217
2021-08-28,Sierra,091,2930,112,91,13,104,0
2021-08-28,Siskiyou,093,43540,2550,2402,725,3127,33
2021-08-28,Solano,095,438530,41694,39610,1027,40637,290
2021-08-28,Sonoma,097,501317,37576,36466,446,36912,352
2021-08-28,Stanislaus,099,539301,67085,65670,7448,73118,1074
2021-08-28,Sutter,101,95872,11940,11669,150,11819,136
2021-08-28,Tehama,103,63373,6259,6004,864,6868,71
2021-08-28,Trinity,105,12862,625,463,155,618,3
2021-08-28,Tulare,107,460477,56630,54746,11178,65924,870
2021-08-28,Tuolumne,109,53932,5543,5469,60,5529,74
2021-08-28,Ventura,111,848112,91068,89934,3895,93829,1081
2021-08-28,Yolo,113,214977,17392,16907,724,17631,231
2021-08-28,Yuba,115,75493,8326,7985,178,8163,55
2021-08-27,Alameda,001,1643700,109202,106622,2436,109058,1296
2021-08-27,Alpine,003,1148,91,92,0,92,0
2021-08-27,Amador,005,37829,4582,4458,40,4498,53
2021-08-27,Butte,007,227075,16104,15277,2684,17961,214
2021-08-27,Calaveras,009,45235,3024,2903,19,2922,59
2021-08-27,Colusa,011,21464,2295,2240,486,2726,16
2021-08-27,Contra Costa,013,1133247,89972,86386,1752,88138,872
2021-08-27,Del Norte,015,27424,2904,2695,16,2711,11
2021-08-27,El Dorado,017,186661,13684,12968,1238,14206,119
2021-08-27,Fresno,019,978130,117858,114481,10266,124747,1774
2021-08-27,Glenn,021,27897,2875,2754,785,3539,20
2021-08-27,Humboldt,023,135768,7111,6782,232,7014,52
2021-08-27,Imperial,025,180216,30497,30201,2829,33030,750
2021-08-27,Inyo,027,18085,1552,1529,14,1543,39
2021-08-27,Kern,029,883053,109177,106570,14900,121470,1385
2021-08-27,Kings,031,150075,26780,25957,1399,27356,257
2021-08-27,Lake,033,64148,5446,5228,62,5290,74
2021-08-27,Lassen,035,31185,5773,5646,154,5800,21
2021-08-27,Los Angeles,037,10098052,1354433,1337006,49430,1386436,25230
2021-08-27,Madera,039,155013,19084,18476,1356,19832,247
2021-08-27,Marin,041,260295,16314,16055,348,16403,240
2021-08-27,Mariposa,043,17540,746,690,19,709,5
2021-08-27,Mendocino,045,87422,5871,5602,207,5809,55
2021-08-27,Merced,047,269075,35633,34906,1330,36236,495
2021-08-27,Modoc,049,8938,445,434,155,589,5
2021-08-27,Mono,051,14174,1408,1385,17,1402,3
2021-08-27,Monterey,053,433212,45978,45337,2303,47640,539
2021-08-27,Napa,055,140530,11632,11460,71,11531,87
2021-08-27,Nevada,057,99092,7546,7169,246,7415,82
2021-08-27,Orange,059,3164182,287477,283407,13194,296601,5206
2021-08-27,Placer,061,380077,31048,29157,2695,31852,320
2021-08-27,Plumas,063,18699,1038,984,17,1001,5
2021-08-27,Riverside,065,2383286,332158,325379,15238,340617,4622
2021-08-27,Sacramento,067,1510023,137101,131921,2963,134884,1838
2021-08-27,San Benito,069,59416,6702,6622,130,6752,64
2021-08-27,San Bernardino,071,2135413,327364,322893,10015,332908,5342
2021-08-27,San Diego,073,3302833,335573,330162,19655,349817,3877
2021-08-27,San Francisco,075,870044,47737,46456,1941,48397,581
2021-08-27,San Joaquin,077,732212,87825,84949,4525,89474,1524
2021-08-27,San Luis Obispo,079,281455,25812,24952,971,25923,280
2021-08-27,San Mateo,081,765935,49744,48424,706,49130,553
2021-08-27,Santa Barbara,083,443738,39671,38675,1339,40014,480
2021-08-27,Santa Clara,085,1922200,135341,132011,989,133000,1783
2021-08-27,Santa Cruz,087,273765,18562,18163,918,19081,210
2021-08-27,Shasta,089,179085,15651,14996,2258,17254,217
2021-08-27,Sierra,091,2930,111,91,13,104,0
2021-08-27,Siskiyou,093,43540,2535,2358,711,3069,33
2021-08-27,Solano,095,438530,41580,39347,1023,40370,287
2021-08-27,Sonoma,097,501317,37505,36326,445,36771,342
2021-08-27,Stanislaus,099,539301,66876,65167,7411,72578,1061
2021-08-27,Sutter,101,95872,11894,11590,148,11738,135
2021-08-27,Tehama,103,63373,6227,5964,849,6813,71
2021-08-27,Trinity,105,12862,625,458,154,612,3
2021-08-27,Tulare,107,460477,56495,54443,11133,65576,870
2021-08-27,Tuolumne,109,53932,5511,5438,60,5498,74
2021-08-27,Ventura,111,848112,90939,89774,3891,93665,1076
2021-08-27,Yolo,113,214977,17349,16805,719,17524,231
2021-08-27,Yuba,115,75493,8269,7926,178,8104,54
2021-08-26,Alameda,001,1643700,108931,106146,2427,108573,1296
2021-08-26,Alpine,003,1148,91,92,0,92,0
2021-08-26,Amador,005,37829,4567,4442,39,4481,53
2021-08-26,Butte,007,227075,15969,15159,2646,17805,214
2021-08-26,Calaveras,009,45235,3013,2873,19,2892,59
2021-08-26,Colusa,011,21464,2288,2234,482,2716,16
2021-08-26,Contra Costa,013,1133247,89612,85808,1746,87554,866
2021-08-26,Del Norte,015,27424,2868,2625,16,2641,8
2021-08-26,El Dorado,017,186661,13615,12863,1224,14087,118
2021-08-26,Fresno,019,978130,117357,113854,10213,124067,1770
2021-08-26,Glenn,021,27897,2857,2740,776,3516,20
2021-08-26,Humboldt,023,135768,7053,6695,222,6917,53
2021-08-26,Imperial,025,180216,30448,30121,2822,32943,748
2021-08-26,Inyo,027,18085,1542,1521,13,1534,39
2021-08-26,Kern,029,883053,108749,106051,14758,120809,1380
2021-08-26,Kings,031,150075,26657,25838,1391,27229,260
2021-08-26,Lake,033,64148,5400,5196,59,5255,74
2021-08-26,Lassen,035,31185,5761,5626,152,5778,21
2021-08-26,Los Angeles,037,10098052,1352157,1334372,49337,1383709,25199
2021-08-26,Madera,039,155013,19014,18393,1343,19736,247
2021-08-26,Marin,041,260295,16285,15983,345,16328,240
2021-08-26,Mariposa,043,17540,736,677,19,696,5
2021-08-26,Mendocino,045,87422,5833,5533,202,5735,55
2021-08-26,Merced,047,269075,35466,34755,1309,36064,495
2021-08-26,Modoc,049,8938,445,433,155,588,5
2021-08-26,Mono,051,14174,1404,1385,17,1402,3
2021-08-26,Monterey,053,433212,45905,45265,2292,47557,539
2021-08-26,Napa,055,140530,11610,11394,70,11464,87
2021-08-26,Nevada,057,99092,7488,7086,243,7329,80
2021-08-26,Orange,059,3164182,286985,282814,13170,295984,5200
2021-08-26,Placer,061,380077,30878,28898,2669,31567,319
2021-08-26,Plumas,063,18699,1031,971,16,987,5
2021-08-26,Riverside,065,2383286,331367,324486,15218,339704,4615
2021-08-26,Sacramento,067,1510023,136567,130977,2922,133899,1827
2021-08-26,San Benito,069,59416,6692,6604,130,6734,64
2021-08-26,San Bernardino,071,2135413,326708,322100,9992,332092,5339
2021-08-26,San Diego,073,3302833,334546,328276,19589,347865,3869
2021-08-26,San Francisco,075,870044,47610,46288,1936,48224,581
2021-08-26,San Joaquin,077,732212,87447,84429,4504,88933,1513
2021-08-26,San Luis Obispo,079,281455,25662,24831,964,25795,278
2021-08-26,San Mateo,081,765935,49616,48263,704,48967,553
2021-08-26,Santa Barbara,083,443738,39587,38566,1338,39904,479
2021-08-26,Santa Clara,085,1922200,135016,131443,985,132428,1782
2021-08-26,Santa Cruz,087,273765,18502,18072,916,18988,210
2021-08-26,Shasta,089,179085,15529,14891,2230,17121,217
2021-08-26,Sierra,091,2930,109,90,13,103,0
2021-08-26,Siskiyou,093,43540,2513,2342,698,3040,33
2021-08-26,Solano,095,438530,41431,39027,1015,40042,286
2021-08-26,Sonoma,097,501317,37416,36102,445,36547,337
2021-08-26,Stanislaus,099,539301,66577,64785,7370,72155,1061
2021-08-26,Sutter,101,95872,11834,11499,145,11644,135
2021-08-26,Tehama,103,63373,6169,5913,836,6749,68
2021-08-26,Trinity,105,12862,620,450,152,602,3
2021-08-26,Tulare,107,460477,56238,54157,11087,65244,870
2021-08-26,Tuolumne,109,53932,5491,5387,60,5447,74
2021-08-26,Ventura,111,848112,90753,89595,3882,93477,1080
2021-08-26,Yolo,113,214977,17284,16727,708,17435,231
2021-08-26,Yuba,115,75493,8196,7834,176,8010,54
2021-08-25,Alameda,001,1643700,108606,105636,2420,108056,1296
2021-08-25,Alpine,003,1148,91,92,0,92,0
2021-08-25,Amador,005,37829,4552,4415,39,4454,53
2021-08-25,Butte,007,227075,15861,15039,2605,17644,214
2021-08-25,Calaveras,009,45235,2994,2851,19,2870,59
2021-08-25,Colusa,011,21464,2281,2227,473,2700,16
2021-08-25,Contra Costa,013,1133247,89228,85322,1740,87062,863
2021-08-25,Del Norte,015,27424,2823,2573,16,2589,8
2021-08-25,El Dorado,017,186661,13555,12787,1209,13996,118
2021-08-25,Fresno,019,978130,116816,113384,10171,123555,1761
2021-08-25,Glenn,021,27897,2839,2728,761,3489,20
2021-08-25,Humboldt,023,135768,6984,6653,213,6866,52
2021-08-25,Imperial,025,180216,30411,30085,2816,32901,748
2021-08-25,Inyo,027,18085,1538,1518,13,1531,39
2021-08-25,Kern,029,883053,108318,105687,14603,120290,1379
2021-08-25,Kings,031,150075,26550,25676,1385,27061,258
2021-08-25,Lake,033,64148,5370,5163,56,5219,74
2021-08-25,Lassen,035,31185,5744,5583,151,5734,21
2021-08-25,Los Angeles,037,10098052,1349558,1331400,49239,1380639,25170
2021-08-25,Madera,039,155013,18950,18311,1321,19632,247
2021-08-25,Marin,041,260295,16263,15938,339,16277,240
2021-08-25,Mariposa,043,17540,730,676,19,695,5
2021-08-25,Mendocino,045,87422,5799,5486,196,5682,53
2021-08-25,Merced,047,269075,35334,34600,1296,35896,492
2021-08-25,Modoc,049,8938,445,433,155,588,5
2021-08-25,Mono,051,14174,1400,1382,17,1399,3
2021-08-25,Monterey,053,433212,45831,45196,2277,47473,539
2021-08-25,Napa,055,140530,11576,11348,69,11417,87
2021-08-25,Nevada,057,99092,7422,7000,242,7242,77
2021-08-25,Orange,059,3164182,286459,282061,13136,295197,5193
2021-08-25,Placer,061,380077,30702,28740,2637,31377,319
2021-08-25,Plumas,063,18699,1016,962,16,978,5
2021-08-25,Riverside,065,2383286,330523,323548,15196,338744,4610
2021-08-25,Sacramento,067,1510023,135887,130046,2884,132930,1827
2021-08-25,San Benito,069,59416,6671,6587,129,6716,64
2021-08-25,San Bernardino,071,2135413,326015,321228,9971,331199,5337
2021-08-25,San Diego,073,3302833,333278,327166,19504,346670,3859
2021-08-25,San Francisco,075,870044,47461,46107,1931,48038,578
2021-08-25,San Joaquin,077,732212,87062,84002,4487,88489,1510
2021-08-25,San Luis Obispo,079,281455,25470,24607,960,25567,276
2021-08-25,San Mateo,081,765935,49493,48153,701,48854,553
2021-08-25,Santa Barbara,083,443738,39458,38450,1338,39788,479
2021-08-25,Santa Clara,085,1922200,134648,130995,983,131978,1783
2021-08-25,Santa Cruz,087,273765,18442,17987,913,18900,210
2021-08-25,Shasta,089,179085,15402,14752,2198,16950,217
2021-08-25,Sierra,091,2930,106,90,13,103,0
2021-08-25,Siskiyou,093,43540,2468,2322,680,3002,33
2021-08-25,Solano,095,438530,41259,38848,1003,39851,286
2021-08-25,Sonoma,097,501317,37292,35986,442,36428,336
2021-08-25,Stanislaus,099,539301,66295,64441,7338,71779,1061
2021-08-25,Sutter,101,95872,11766,11451,141,11592,134
2021-08-25,Tehama,103,63373,6110,5861,819,6680,68
2021-08-25,Trinity,105,12862,614,450,151,601,3
2021-08-25,Tulare,107,460477,55954,53877,11017,64894,866
2021-08-25,Tuolumne,109,53932,5465,5354,60,5414,74
2021-08-25,Ventura,111,848112,90569,89379,3868,93247,1068
2021-08-25,Yolo,113,214977,17219,16667,698,17365,231
2021-08-25,Yuba,115,75493,8130,7771,175,7946,54
2021-08-24,Alameda,001,1643700,108293,105319,2408,107727,1296
2021-08-24,Alpine,003,1148,91,92,0,92,0
2021-08-24,Amador,005,37829,4533,4380,39,4419,50
2021-08-24,Butte,007,227075,15707,14964,2572,17536,214
2021-08-24,Calaveras,009,45235,2955,2811,19,2830,59
2021-08-24,Colusa,011,21464,2273,2221,468,2689,16
2021-08-24,Contra Costa,013,1133247,88865,84963,1735,86698,857
2021-08-24,Del Norte,015,27424,2796,2543,16,2559,8
2021-08-24,El Dorado,017,186661,13478,12732,1194,13926,118
2021-08-24,Fresno,019,978130,116210,113024,10109,123133,1761
2021-08-24,Glenn,021,27897,2824,2717,754,3471,20
2021-08-24,Humboldt,023,135768,6921,6585,200,6785,52
2021-08-24,Imperial,025,180216,30350,30045,2811,32856,748
2021-08-24,Inyo,027,18085,1533,1512,13,1525,39
2021-08-24,Kern,029,883053,107854,105399,14439,119838,1375
2021-08-24,Kings,031,150075,26429,25629,1370,26999,258
2021-08-24,Lake,033,64148,5335,5135,56,5191,72
2021-08-24,Lassen,035,31185,5728,5576,149,5725,21
2021-08-24,Los Angeles,037,10098052,1346693,1328777,49132,1377909,25135
2021-08-24,Madera,039,155013,18874,18251,1304,19555,247
2021-08-24,Marin,041,260295,16227,15900,335,16235,240
2021-08-24,Mariposa,043,17540,723,670,19,689,5
2021-08-24,Mendocino,045,87422,5756,5416,189,5605,52
2021-08-24,Merced,047,269075,35166,34490,1285,35775,491
2021-08-24,Modoc,049,8938,445,432,155,587,5
2021-08-24,Mono,051,14174,1398,1382,17,1399,3
2021-08-24,Monterey,053,433212,45765,45126,2260,47386,539
2021-08-24,Napa,055,140530,11543,11299,68,11367,85
2021-08-24,Nevada,057,99092,7352,6981,240,7221,77
2021-08-24,Orange,059,3164182,285859,281461,13112,294573,5187
2021-08-24,Placer,061,380077,30497,28618,2598,31216,318
2021-08-24,Plumas,063,18699,1006,953,16,969,5
2021-08-24,Riverside,065,2383286,329650,322620,15167,337787,4605
2021-08-24,Sacramento,067,1510023,135203,129542,2838,132380,1812
2021-08-24,San Benito,069,59416,6658,6576,129,6705,64
2021-08-24,San Bernardino,071,2135413,325260,320300,9941,330241,5328
2021-08-24,San Diego,073,3302833,331835,325823,19395,345218,3851
2021-08-24,San Francisco,075,870044,47286,46010,1921,47931,574
2021-08-24,San Joaquin,077,732212,86622,83684,4450,88134,1508
2021-08-24,San Luis Obispo,079,281455,25293,24443,949,25392,274
2021-08-24,San Mateo,081,765935,49344,48050,699,48749,553
2021-08-24,Santa Barbara,083,443738,39327,38307,1337,39644,478
2021-08-24,Santa Clara,085,1922200,134224,130763,979,131742,1779
2021-08-24,Santa Cruz,087,273765,18367,17928,907,18835,209
2021-08-24,Shasta,089,179085,15294,14664,2167,16831,217
2021-08-24,Sierra,091,2930,103,90,13,103,0
2021-08-24,Siskiyou,093,43540,2446,2294,665,2959,33
2021-08-24,Solano,095,438530,41050,38724,991,39715,283
2021-08-24,Sonoma,097,501317,37164,35849,440,36289,336
2021-08-24,Stanislaus,099,539301,65966,64195,7284,71479,1058
2021-08-24,Sutter,101,95872,11699,11384,138,11522,134
2021-08-24,Tehama,103,63373,6064,5826,805,6631,67
2021-08-24,Trinity,105,12862,603,446,143,589,3
2021-08-24,Tulare,107,460477,55603,53702,10927,64629,856
2021-08-24,Tuolumne,109,53932,5434,5287,60,5347,74
2021-08-24,Ventura,111,848112,90385,89167,3857,93024,1068
2021-08-24,Yolo,113,214977,17141,16492,685,17177,231
2021-08-24,Yuba,115,75493,8047,7723,173,7896,54
2021-08-23,Alameda,001,1643700,107882,104922,2395,107317,1294
2021-08-23,Alpine,003,1148,91,91,0,91,0
2021-08-23,Amador,005,37829,4519,4369,39,4408,50
2021-08-23,Butte,007,227075,15561,14847,2534,17381,211
2021-08-23,Calaveras,009,45235,2928,2803,19,2822,59
2021-08-23,Colusa,011,21464,2269,2206,465,2671,16
2021-08-23,Contra Costa,013,1133247,88486,84651,1728,86379,857
2021-08-23,Del Norte,015,27424,2750,2499,16,2515,8
2021-08-23,El Dorado,017,186661,13375,12684,1172,13856,118
2021-08-23,Fresno,019,978130,115648,112445,10059,122504,1759
2021-08-23,Glenn,021,27897,2808,2696,744,3440,20
2021-08-23,Humboldt,023,135768,6848,6498,186,6684,52
2021-08-23,Imperial,025,180216,30299,30011,2808,32819,748
2021-08-23,Inyo,027,18085,1526,1509,13,1522,39
2021-08-23,Kern,029,883053,107399,104995,14285,119280,1375
2021-08-23,Kings,031,150075,26298,25465,1364,26829,257
2021-08-23,Lake,033,64148,5295,5099,54,5153,69
2021-08-23,Lassen,035,31185,5716,5562,149,5711,21
2021-08-23,Los Angeles,037,10098052,1343723,1326412,49002,1375414,25096
2021-08-23,Madera,039,155013,18788,18155,1289,19444,246
2021-08-23,Marin,041,260295,16179,15856,331,16187,240
2021-08-23,Mariposa,043,17540,712,645,19,664,5
2021-08-23,Mendocino,045,87422,5689,5374,182,5556,51
2021-08-23,Merced,047,269075,34984,34322,1280,35602,488
2021-08-23,Modoc,049,8938,442,431,154,585,6
2021-08-23,Mono,051,14174,1394,1384,17,1401,3
2021-08-23,Monterey,053,433212,45665,45047,2250,47297,538
2021-08-23,Napa,055,140530,11505,11257,68,11325,85
2021-08-23,Nevada,057,99092,7271,6930,238,7168,77
2021-08-23,Orange,059,3164182,285227,280891,13079,293970,5181
2021-08-23,Placer,061,380077,30297,28540,2560,31100,314
2021-08-23,Plumas,063,18699,998,934,16,950,5
2021-08-23,Riverside,065,2383286,328737,321650,15141,336791,4598
2021-08-23,Sacramento,067,1510023,134415,128969,2771,131740,1807
2021-08-23,San Benito,069,59416,6640,6562,127,6689,64
2021-08-23,San Bernardino,071,2135413,324456,319577,9902,329479,5324
2021-08-23,San Diego,073,3302833,330402,324536,19272,343808,3848
2021-08-23,San Francisco,075,870044,47131,45945,1912,47857,573
2021-08-23,San Joaquin,077,732212,86190,83466,4417,87883,1499
2021-08-23,San Luis Obispo,079,281455,25111,24317,947,25264,274
2021-08-23,San Mateo,081,765935,49206,47935,696,48631,553
2021-08-23,Santa Barbara,083,443738,39148,38181,1335,39516,478
2021-08-23,Santa Clara,085,1922200,133824,130489,975,131464,1778
2021-08-23,Santa Cruz,087,273765,18310,17871,906,18777,209
2021-08-23,Shasta,089,179085,15167,14537,2129,16666,216
2021-08-23,Sierra,091,2930,103,90,13,103,0
2021-08-23,Siskiyou,093,43540,2425,2274,644,2918,33
2021-08-23,Solano,095,438530,40896,38612,982,39594,283
2021-08-23,Sonoma,097,501317,37044,35769,439,36208,336
2021-08-23,Stanislaus,099,539301,65632,63922,7245,71167,1058
2021-08-23,Sutter,101,95872,11610,11314,130,11444,133
2021-08-23,Tehama,103,63373,6010,5805,789,6594,67
2021-08-23,Trinity,105,12862,600,435,140,575,3
2021-08-23,Tulare,107,460477,55296,53370,10855,64225,856
2021-08-23,Tuolumne,109,53932,5392,5240,60,5300,73
2021-08-23,Ventura,111,848112,90167,88960,3845,92805,1063
2021-08-23,Yolo,113,214977,17053,16445,671,17116,226
2021-08-23,Yuba,115,75493,7976,7653,171,7824,54
2021-08-22,Alameda,001,1643700,107434,104539,2368,106907,1294
2021-08-22,Alpine,003,1148,91,91,0,91,0
2021-08-22,Amador,005,37829,4489,4349,39,4388,50
2021-08-22,Butte,007,227075,15421,14791,2500,17291,211
2021-08-22,Calaveras,009,45235,2890,2771,19,2790,59
2021-08-22,Colusa,011,21464,2262,2201,459,2660,16
2021-08-22,Contra Costa,013,1133247,87945,84371,1715,86086,857
2021-08-22,Del Norte,015,27424,2690,2455,16,2471,8
2021-08-22,El Dorado,017,186661,13271,12629,1152,13781,118
2021-08-22,Fresno,019,978130,115049,112057,9991,122048,1759
2021-08-22,Glenn,021,27897,2781,2678,731,3409,20
2021-08-22,Humboldt,023,135768,6770,6483,168,6651,52
2021-08-22,Imperial,025,180216,30241,29993,2803,32796,748
2021-08-22,Inyo,027,18085,1520,1505,13,1518,39
2021-08-22,Kern,029,883053,106873,104691,14133,118824,1375
2021-08-22,Kings,031,150075,26140,25391,1347,26738,257
2021-08-22,Lake,033,64148,5250,5069,51,5120,69
2021-08-22,Lassen,035,31185,5684,5556,145,5701,21
2021-08-22,Los Angeles,037,10098052,1340403,1324151,48872,1373023,25089
2021-08-22,Madera,039,155013,18669,18120,1275,19395,246
2021-08-22,Marin,041,260295,16127,15822,323,16145,240
2021-08-22,Mariposa,043,17540,702,638,17,655,5
2021-08-22,Mendocino,045,87422,5630,5336,182,5518,51
2021-08-22,Merced,047,269075,34781,34234,1267,35501,488
2021-08-22,Modoc,049,8938,440,431,154,585,6
2021-08-22,Mono,051,14174,1392,1378,17,1395,3
2021-08-22,Monterey,053,433212,45566,45017,2236,47253,538
2021-08-22,Napa,055,140530,11460,11231,68,11299,85
2021-08-22,Nevada,057,99092,7197,6864,236,7100,77
2021-08-22,Orange,059,3164182,284533,280390,13035,293425,5181
2021-08-22,Placer,061,380077,30089,28395,2524,30919,314
2021-08-22,Plumas,063,18699,980,923,15,938,5
2021-08-22,Riverside,065,2383286,327716,320836,15094,335930,4594
2021-08-22,Sacramento,067,1510023,133640,128231,2731,130962,1802
2021-08-22,San Benito,069,59416,6624,6550,127,6677,64
2021-08-22,San Bernardino,071,2135413,323487,318839,9867,328706,5324
2021-08-22,San Diego,073,3302833,329080,323591,19166,342757,3848
2021-08-22,San Francisco,075,870044,46965,45831,1903,47734,573
2021-08-22,San Joaquin,077,732212,85732,83121,4382,87503,1498
2021-08-22,San Luis Obispo,079,281455,24905,24250,940,25190,274
2021-08-22,San Mateo,081,765935,49030,47821,691,48512,553
2021-08-22,Santa Barbara,083,443738,38967,38099,1327,39426,478
2021-08-22,Santa Clara,085,1922200,133407,130189,968,131157,1778
2021-08-22,Santa Cruz,087,273765,18252,17823,901,18724,209
2021-08-22,Shasta,089,179085,15030,14478,2093,16571,216
2021-08-22,Sierra,091,2930,103,87,13,100,0
2021-08-22,Siskiyou,093,43540,2396,2261,626,2887,33
2021-08-22,Solano,095,438530,40698,38489,969,39458,283
2021-08-22,Sonoma,097,501317,36887,35676,437,36113,336
2021-08-22,Stanislaus,099,539301,65279,63683,7155,70838,1058
2021-08-22,Sutter,101,95872,11528,11251,126,11377,133
2021-08-22,Tehama,103,63373,5964,5791,770,6561,67
2021-08-22,Trinity,105,12862,593,433,138,571,3
2021-08-22,Tulare,107,460477,54977,53220,10772,63992,856
2021-08-22,Tuolumne,109,53932,5350,5214,60,5274,73
2021-08-22,Ventura,111,848112,89958,88791,3828,92619,1063
2021-08-22,Yolo,113,214977,16950,16374,663,17037,226
2021-08-22,Yuba,115,75493,7903,7626,170,7796,54
2021-08-21,Alameda,001,1643700,107231,104281,2361,106642,1294
2021-08-21,Alpine,003,1148,91,91,0,91,0
2021-08-21,Amador,005,37829,4479,4338,38,4376,50
2021-08-21,Butte,007,227075,15353,14714,2481,17195,211
2021-08-21,Calaveras,009,45235,2874,2744,19,2763,59
2021-08-21,Colusa,011,21464,2256,2192,455,2647,16
2021-08-21,Contra Costa,013,1133247,87686,84136,1707,85843,857
2021-08-21,Del Norte,015,27424,2667,2409,16,2425,8
2021-08-21,El Dorado,017,186661,13227,12590,1148,13738,118
2021-08-21,Fresno,019,978130,114849,111765,9979,121744,1759
2021-08-21,Glenn,021,27897,2768,2654,723,3377,20
2021-08-21,Humboldt,023,135768,6732,6446,163,6609,52
2021-08-21,Imperial,025,180216,30198,29976,2800,32776,748
2021-08-21,Inyo,027,18085,1517,1500,13,1513,39
2021-08-21,Kern,029,883053,106618,104443,14010,118453,1375
2021-08-21,Kings,031,150075,26069,25313,1342,26655,257
2021-08-21,Lake,033,64148,5230,5055,49,5104,69
2021-08-21,Lassen,035,31185,5670,5553,145,5698,21
2021-08-21,Los Angeles,037,10098052,1339106,1321308,48780,1370088,25080
2021-08-21,Madera,039,155013,18631,18067,1269,19336,246
2021-08-21,Marin,041,260295,16093,15775,321,16096,240
2021-08-21,Mariposa,043,17540,692,634,17,651,5
2021-08-21,Mendocino,045,87422,5584,5307,181,5488,51
2021-08-21,Merced,047,269075,34676,34148,1262,35410,488
2021-08-21,Modoc,049,8938,440,430,154,584,6
2021-08-21,Mono,051,14174,1392,1378,17,1395,3
2021-08-21,Monterey,053,433212,45519,44969,2229,47198,538
2021-08-21,Napa,055,140530,11425,11211,68,11279,85
2021-08-21,Nevada,057,99092,7153,6810,235,7045,77
2021-08-21,Orange,059,3164182,284081,279855,13001,292856,5181
2021-08-21,Placer,061,380077,29951,28289,2500,30789,314
2021-08-21,Plumas,063,18699,976,916,14,930,5
2021-08-21,Riverside,065,2383286,327136,320086,15081,335167,4594
2021-08-21,Sacramento,067,1510023,133145,127751,2720,130471,1809
2021-08-21,San Benito,069,59416,6614,6542,126,6668,64
2021-08-21,San Bernardino,071,2135413,323038,318293,9846,328139,5324
2021-08-21,San Diego,073,3302833,328424,322620,19117,341737,3848
2021-08-21,San Francisco,075,870044,46863,45637,1896,47533,573
2021-08-21,San Joaquin,077,732212,85515,82825,4367,87192,1498
2021-08-21,San Luis Obispo,079,281455,24847,24169,940,25109,273
2021-08-21,San Mateo,081,765935,48935,47685,691,48376,553
2021-08-21,Santa Barbara,083,443738,38885,37951,1323,39274,478
2021-08-21,Santa Clara,085,1922200,133142,129911,964,130875,1778
2021-08-21,Santa Cruz,087,273765,18215,17763,896,18659,209
2021-08-21,Shasta,089,179085,14956,14417,2079,16496,217
2021-08-21,Sierra,091,2930,98,85,13,98,0
2021-08-21,Siskiyou,093,43540,2382,2246,615,2861,33
2021-08-21,Solano,095,438530,40587,38423,959,39382,281
2021-08-21,Sonoma,097,501317,36800,35582,436,36018,336
2021-08-21,Stanislaus,099,539301,65097,63512,7138,70650,1058
2021-08-21,Sutter,101,95872,11483,11204,124,11328,133
2021-08-21,Tehama,103,63373,5939,5757,763,6520,67
2021-08-21,Trinity,105,12862,588,431,136,567,3
2021-08-21,Tulare,107,460477,54833,53045,10729,63774,857
2021-08-21,Tuolumne,109,53932,5319,5193,60,5253,73
2021-08-21,Ventura,111,848112,89813,88558,3813,92371,1063
2021-08-21,Yolo,113,214977,16903,16322,657,16979,226
2021-08-21,Yuba,115,75493,7857,7580,169,7749,54
2021-08-20,Alameda,001,1643700,106992,103812,2353,106165,1294
2021-08-20,Alpine,003,1148,91,91,0,91,0
2021-08-20,Amador,005,37829,4453,4323,38,4361,50
2021-08-20,Butte,007,227075,15280,14617,2459,17076,211
2021-08-20,Calaveras,009,45235,2854,2717,19,2736,59
2021-08-20,Colusa,011,21464,2251,2178,453,2631,16
2021-08-20,Contra Costa,013,1133247,87411,83721,1700,85421,857
2021-08-20,Del Norte,015,27424,2635,2316,16,2332,8
2021-08-20,El Dorado,017,186661,13189,12495,1140,13635,118
2021-08-20,Fresno,019,978130,114492,111315,9945,121260,1759
2021-08-20,Glenn,021,27897,2761,2642,713,3355,20
2021-08-20,Humboldt,023,135768,6680,6349,158,6507,52
2021-08-20,Imperial,025,180216,30175,29934,2800,32734,747
2021-08-20,Inyo,027,18085,1511,1495,13,1508,39
2021-08-20,Kern,029,883053,106334,104048,13884,117932,1373
2021-08-20,Kings,031,150075,26003,25241,1340,26581,256
2021-08-20,Lake,033,64148,5215,5024,46,5070,69
2021-08-20,Lassen,035,31185,5650,5539,145,5684,21
2021-08-20,Los Angeles,037,10098052,1337229,1317541,48679,1366220,25049
2021-08-20,Madera,039,155013,18582,18018,1254,19272,246
2021-08-20,Marin,041,260295,16075,15727,317,16044,240
2021-08-20,Mariposa,043,17540,687,630,17,647,5
2021-08-20,Mendocino,045,87422,5538,5241,180,5421,51
2021-08-20,Merced,047,269075,34612,34035,1252,35287,486
2021-08-20,Modoc,049,8938,440,429,154,583,6
2021-08-20,Mono,051,14174,1391,1368,17,1385,3
2021-08-20,Monterey,053,433212,45481,44890,2223,47113,538
2021-08-20,Napa,055,140530,11393,11152,68,11220,83
2021-08-20,Nevada,057,99092,7111,6753,229,6982,77
2021-08-20,Orange,059,3164182,283636,279193,12980,292173,5179
2021-08-20,Placer,061,380077,29856,28156,2471,30627,313
2021-08-20,Plumas,063,18699,966,908,14,922,5
2021-08-20,Riverside,065,2383286,326440,319072,15050,334122,4594
2021-08-20,Sacramento,067,1510023,132669,127226,2703,129929,1797
2021-08-20,San Benito,069,59416,6600,6508,126,6634,64
2021-08-20,San Bernardino,071,2135413,322425,317372,9817,327189,5322
2021-08-20,San Diego,073,3302833,327515,321102,19047,340149,3846
2021-08-20,San Francisco,075,870044,46766,45432,1881,47313,573
2021-08-20,San Joaquin,077,732212,85284,82419,4348,86767,1496
2021-08-20,San Luis Obispo,079,281455,24769,23986,936,24922,273
2021-08-20,San Mateo,081,765935,48822,47561,688,48249,551
2021-08-20,Santa Barbara,083,443738,38800,37794,1318,39112,477
2021-08-20,Santa Clara,085,1922200,132859,129510,959,130469,1774
2021-08-20,Santa Cruz,087,273765,18175,17701,893,18594,209
2021-08-20,Shasta,089,179085,14876,14277,2061,16338,215
2021-08-20,Sierra,091,2930,97,83,13,96,0
2021-08-20,Siskiyou,093,43540,2366,2226,610,2836,33
2021-08-20,Solano,095,438530,40446,38214,948,39162,277
2021-08-20,Sonoma,097,501317,36732,35416,435,35851,336
2021-08-20,Stanislaus,099,539301,64908,63219,7114,70333,1047
2021-08-20,Sutter,101,95872,11427,11136,123,11259,133
2021-08-20,Tehama,103,63373,5923,5730,751,6481,66
2021-08-20,Trinity,105,12862,588,422,135,557,3
2021-08-20,Tulare,107,460477,54703,52855,10686,63541,856
2021-08-20,Tuolumne,109,53932,5295,5153,59,5212,73
2021-08-20,Ventura,111,848112,89645,88285,3810,92095,1061
2021-08-20,Yolo,113,214977,16848,16236,651,16887,225
2021-08-20,Yuba,115,75493,7816,7523,169,7692,54
2021-08-19,Alameda,001,1643700,106542,103276,2331,105607,1294
2021-08-19,Alpine,003,1148,91,91,0,91,0
2021-08-19,Amador,005,37829,4446,4317,38,4355,50
2021-08-19,Butte,007,227075,15146,14518,2431,16949,211
2021-08-19,Calaveras,009,45235,2832,2673,19,2692,59
2021-08-19,Colusa,011,21464,2242,2167,448,2615,16
2021-08-19,Contra Costa,013,1133247,86973,83296,1687,84983,852
2021-08-19,Del Norte,015,27424,2585,2257,16,2273,8
2021-08-19,El Dorado,017,186661,13103,12410,1121,13531,118
2021-08-19,Fresno,019,978130,114054,110947,9891,120838,1759
2021-08-19,Glenn,021,27897,2743,2629,706,3335,20
2021-08-19,Humboldt,023,135768,6619,6246,152,6398,52
2021-08-19,Imperial,025,180216,30129,29865,2795,32660,747
2021-08-19,Inyo,027,18085,1504,1494,13,1507,39
2021-08-19,Kern,029,883053,105938,103731,13743,117474,1371
2021-08-19,Kings,031,150075,25872,25128,1328,26456,256
2021-08-19,Lake,033,64148,5183,4991,42,5033,69
2021-08-19,Lassen,035,31185,5632,5520,144,5664,21
2021-08-19,Los Angeles,037,10098052,1334244,1314453,48538,1362991,25020
2021-08-19,Madera,039,155013,18520,17947,1239,19186,246
2021-08-19,Marin,041,260295,16042,15672,314,15986,240
2021-08-19,Mariposa,043,17540,672,618,17,635,5
2021-08-19,Mendocino,045,87422,5505,5167,177,5344,51
2021-08-19,Merced,047,269075,34477,33851,1239,35090,486
2021-08-19,Modoc,049,8938,440,427,154,581,6
2021-08-19,Mono,051,14174,1387,1349,17,1366,3
2021-08-19,Monterey,053,433212,45408,44821,2213,47034,538
2021-08-19,Napa,055,140530,11341,11104,68,11172,83
2021-08-19,Nevada,057,99092,7047,6695,227,6922,77
2021-08-19,Orange,059,3164182,282999,278562,12929,291491,5172
2021-08-19,Placer,061,380077,29676,27953,2454,30407,313
2021-08-19,Plumas,063,18699,953,896,14,910,5
2021-08-19,Riverside,065,2383286,325412,318056,15021,333077,4589
2021-08-19,Sacramento,067,1510023,131965,126720,2668,129388,1801
2021-08-19,San Benito,069,59416,6583,6493,125,6618,64
2021-08-19,San Bernardino,071,2135413,321602,316398,9794,326192,5318
2021-08-19,San Diego,073,3302833,326264,319582,18949,338531,3839
2021-08-19,San Francisco,075,870044,46603,45220,1868,47088,571
2021-08-19,San Joaquin,077,732212,84835,82047,4299,86346,1491
2021-08-19,San Luis Obispo,079,281455,24631,23878,929,24807,271
2021-08-19,San Mateo,081,765935,48690,47431,687,48118,551
2021-08-19,Santa Barbara,083,443738,38655,37693,1315,39008,477
2021-08-19,Santa Clara,085,1922200,132469,129133,952,130085,1774
2021-08-19,Santa Cruz,087,273765,18112,17644,886,18530,209
2021-08-19,Shasta,089,179085,14752,14200,2038,16238,214
2021-08-19,Sierra,091,2930,93,83,13,96,0
2021-08-19,Siskiyou,093,43540,2351,2218,598,2816,33
2021-08-19,Solano,095,438530,40288,38025,937,38962,273
2021-08-19,Sonoma,097,501317,36644,35233,434,35667,336
2021-08-19,Stanislaus,099,539301,64564,62928,7070,69998,1047
2021-08-19,Sutter,101,95872,11342,11057,122,11179,133
2021-08-19,Tehama,103,63373,5887,5683,725,6408,66
2021-08-19,Trinity,105,12862,584,414,133,547,3
2021-08-19,Tulare,107,460477,54471,52685,10623,63308,856
2021-08-19,Tuolumne,109,53932,5259,5112,58,5170,64
2021-08-19,Ventura,111,848112,89442,88073,3796,91869,1060
2021-08-19,Yolo,113,214977,16763,16153,643,16796,225
2021-08-19,Yuba,115,75493,7763,7458,168,7626,51
2021-08-18,Alameda,001,1643700,106134,102696,2309,105005,1294
2021-08-18,Alpine,003,1148,90,91,0,91,0
2021-08-18,Amador,005,37829,4430,4279,37,4316,50
2021-08-18,Butte,007,227075,15036,14426,2403,16829,208
2021-08-18,Calaveras,009,45235,2795,2643,18,2661,59
2021-08-18,Colusa,011,21464,2234,2160,444,2604,16
2021-08-18,Contra Costa,013,1133247,86474,82767,1681,84448,851
2021-08-18,Del Norte,015,27424,2528,2219,16,2235,8
2021-08-18,El Dorado,017,186661,13013,12306,1107,13413,118
2021-08-18,Fresno,019,978130,113599,110523,9830,120353,1759
2021-08-18,Glenn,021,27897,2710,2623,698,3321,20
2021-08-18,Humboldt,023,135768,6548,6195,147,6342,52
2021-08-18,Imperial,025,180216,30096,29821,2793,32614,746
2021-08-18,Inyo,027,18085,1501,1494,13,1507,39
2021-08-18,Kern,029,883053,105591,103440,13649,117089,1370
2021-08-18,Kings,031,150075,25763,24984,1320,26304,256
2021-08-18,Lake,033,64148,5142,4957,41,4998,69
2021-08-18,Lassen,035,31185,5613,5506,143,5649,21
2021-08-18,Los Angeles,037,10098052,1331091,1311477,48406,1359883,24984
2021-08-18,Madera,039,155013,18461,17871,1226,19097,246
2021-08-18,Marin,041,260295,16004,15610,311,15921,240
2021-08-18,Mariposa,043,17540,659,615,16,631,5
2021-08-18,Mendocino,045,87422,5454,5129,175,5304,51
2021-08-18,Merced,047,269075,34313,33708,1228,34936,484
2021-08-18,Modoc,049,8938,440,427,153,580,6
2021-08-18,Mono,051,14174,1384,1344,17,1361,3
2021-08-18,Monterey,053,433212,45324,44735,2196,46931,532
2021-08-18,Napa,055,140530,11302,11060,67,11127,83
2021-08-18,Nevada,057,99092,6981,6633,227,6860,76
2021-08-18,Orange,059,3164182,282362,277795,12877,290672,5168
2021-08-18,Placer,061,380077,29449,27741,2426,30167,312
2021-08-18,Plumas,063,18699,944,874,14,888,5
2021-08-18,Riverside,065,2383286,324414,317107,14988,332095,4585
2021-08-18,Sacramento,067,1510023,131203,125599,2636,128235,1781
2021-08-18,San Benito,069,59416,6572,6481,124,6605,64
2021-08-18,San Bernardino,071,2135413,320803,315477,9775,325252,5304
2021-08-18,San Diego,073,3302833,324924,318152,18883,337035,3834
2021-08-18,San Francisco,075,870044,46401,44957,1859,46816,568
2021-08-18,San Joaquin,077,732212,84382,81601,4268,85869,1491
2021-08-18,San Luis Obispo,079,281455,24481,23726,916,24642,270
2021-08-18,San Mateo,081,765935,48526,47255,686,47941,551
2021-08-18,Santa Barbara,083,443738,38524,37599,1309,38908,475
2021-08-18,Santa Clara,085,1922200,132105,128563,949,129512,1773
2021-08-18,Santa Cruz,087,273765,18057,17566,882,18448,209
2021-08-18,Shasta,089,179085,14653,14087,2019,16106,213
2021-08-18,Sierra,091,2930,92,83,13,96,0
2021-08-18,Siskiyou,093,43540,2322,2204,586,2790,33
2021-08-18,Solano,095,438530,40082,37812,922,38734,271
2021-08-18,Sonoma,097,501317,36500,35063,433,35496,333
2021-08-18,Stanislaus,099,539301,64233,62613,7027,69640,1047
2021-08-18,Sutter,101,95872,11270,11004,117,11121,130
2021-08-18,Tehama,103,63373,5852,5653,715,6368,66
2021-08-18,Trinity,105,12862,577,409,130,539,3
2021-08-18,Tulare,107,460477,54231,52486,10554,63040,856
2021-08-18,Tuolumne,109,53932,5223,5081,56,5137,64
2021-08-18,Ventura,111,848112,89210,87835,3786,91621,1055
2021-08-18,Yolo,113,214977,16680,16047,625,16672,225
2021-08-18,Yuba,115,75493,7698,7391,168,7559,51
2021-08-17,Alameda,001,1643700,105735,102379,2294,104673,1290
2021-08-17,Alpine,003,1148,90,91,0,91,0
2021-08-17,Amador,005,37829,4401,4266,37,4303,50
2021-08-17,Butte,007,227075,14929,14357,2367,16724,206
2021-08-17,Calaveras,009,45235,2761,2624,18,2642,59
2021-08-17,Colusa,011,21464,2225,2156,440,2596,16
2021-08-17,Contra Costa,013,1133247,86027,82482,1670,84152,848
2021-08-17,Del Norte,015,27424,2474,2188,16,2204,8
2021-08-17,El Dorado,017,186661,12926,12242,1094,13336,118
2021-08-17,Fresno,019,978130,113115,110263,9767,120030,1755
2021-08-17,Glenn,021,27897,2696,2608,689,3297,20
2021-08-17,Humboldt,023,135768,6468,6155,145,6300,52
2021-08-17,Imperial,025,180216,30045,29768,2789,32557,746
2021-08-17,Inyo,027,18085,1498,1492,13,1505,39
2021-08-17,Kern,029,883053,105197,103048,13527,116575,1367
2021-08-17,Kings,031,150075,25657,24930,1309,26239,254
2021-08-17,Lake,033,64148,5099,4930,35,4965,68
2021-08-17,Lassen,035,31185,5596,5499,141,5640,21
2021-08-17,Los Angeles,037,10098052,1327526,1307999,48276,1356275,24952
2021-08-17,Madera,039,155013,18387,17838,1208,19046,246
2021-08-17,Marin,041,260295,15948,15570,311,15881,240
2021-08-17,Mariposa,043,17540,651,609,15,624,5
2021-08-17,Mendocino,045,87422,5399,5097,175,5272,51
2021-08-17,Merced,047,269075,34163,33508,1218,34726,482
2021-08-17,Modoc,049,8938,437,424,151,575,6
2021-08-17,Mono,051,14174,1379,1341,17,1358,3
2021-08-17,Monterey,053,433212,45240,44672,2186,46858,528
2021-08-17,Napa,055,140530,11261,11007,66,11073,83
2021-08-17,Nevada,057,99092,6906,6605,225,6830,75
2021-08-17,Orange,059,3164182,281716,277121,12841,289962,5164
2021-08-17,Placer,061,380077,29234,27634,2397,30031,312
2021-08-17,Plumas,063,18699,932,860,14,874,5
2021-08-17,Riverside,065,2383286,323402,316051,14945,330996,4582
2021-08-17,Sacramento,067,1510023,130409,125151,2594,127745,1774
2021-08-17,San Benito,069,59416,6553,6470,124,6594,64
2021-08-17,San Bernardino,071,2135413,319864,314402,9735,324137,5302
2021-08-17,San Diego,073,3302833,323314,317058,18785,335843,3824
2021-08-17,San Francisco,075,870044,46201,44820,1853,46673,567
2021-08-17,San Joaquin,077,732212,83914,81300,4234,85534,1489
2021-08-17,San Luis Obispo,079,281455,24325,23556,913,24469,268
2021-08-17,San Mateo,081,765935,48371,47127,681,47808,551
2021-08-17,Santa Barbara,083,443738,38365,37478,1302,38780,475
2021-08-17,Santa Clara,085,1922200,131702,128354,943,129297,1773
2021-08-17,Santa Cruz,087,273765,17972,17528,881,18409,209
2021-08-17,Shasta,089,179085,14522,14012,2000,16012,214
2021-08-17,Sierra,091,2930,91,82,13,95,0
2021-08-17,Siskiyou,093,43540,2306,2183,573,2756,33
2021-08-17,Solano,095,438530,39853,37662,909,38571,269
2021-08-17,Sonoma,097,501317,36352,34943,429,35372,333
2021-08-17,Stanislaus,099,539301,63892,62385,6968,69353,1047
2021-08-17,Sutter,101,95872,11198,10973,117,11090,130
2021-08-17,Tehama,103,63373,5818,5612,693,6305,66
2021-08-17,Trinity,105,12862,572,406,128,534,3
2021-08-17,Tulare,107,460477,53963,52362,10489,62851,856
2021-08-17,Tuolumne,109,53932,5180,5042,55,5097,64
2021-08-17,Ventura,111,848112,88972,87601,3765,91366,1053
2021-08-17,Yolo,113,214977,16591,15975,611,16586,225
2021-08-17,Yuba,115,75493,7627,7355,168,7523,51
2021-08-16,Alameda,001,1643700,105237,102052,2285,104337,1287
2021-08-16,Alpine,003,1148,90,91,0,91,0
2021-08-16,Amador,005,37829,4391,4235,37,4272,50
2021-08-16,Butte,007,227075,14809,14283,2331,16614,206
2021-08-16,Calaveras,009,45235,2701,2609,17,2626,57
2021-08-16,Colusa,011,21464,2214,2147,436,2583,16
2021-08-16,Contra Costa,013,1133247,85485,82070,1660,83730,848
2021-08-16,Del Norte,015,27424,2397,2125,16,2141,8
2021-08-16,El Dorado,017,186661,12825,12139,1081,13220,118
2021-08-16,Fresno,019,978130,112617,109623,9715,119338,1753
2021-08-16,Glenn,021,27897,2677,2593,683,3276,20
2021-08-16,Humboldt,023,135768,6397,6064,124,6188,52
2021-08-16,Imperial,025,180216,30004,29737,2775,32512,746
2021-08-16,Inyo,027,18085,1495,1490,13,1503,39
2021-08-16,Kern,029,883053,104822,102690,13411,116101,1367
2021-08-16,Kings,031,150075,25554,24817,1300,26117,254
2021-08-16,Lake,033,64148,5072,4898,34,4932,68
2021-08-16,Lassen,035,31185,5580,5481,133,5614,21
2021-08-16,Los Angeles,037,10098052,1324145,1305330,48134,1353464,24923
2021-08-16,Madera,039,155013,18312,17756,1187,18943,246
2021-08-16,Marin,041,260295,15889,15497,310,15807,239
2021-08-16,Mariposa,043,17540,634,597,15,612,5
2021-08-16,Mendocino,045,87422,5343,5037,173,5210,49
2021-08-16,Merced,047,269075,33962,33364,1205,34569,481
2021-08-16,Modoc,049,8938,435,421,150,571,5
2021-08-16,Mono,051,14174,1374,1339,17,1356,3
2021-08-16,Monterey,053,433212,45161,44595,2174,46769,527
2021-08-16,Napa,055,140530,11232,10946,66,11012,83
2021-08-16,Nevada,057,99092,6851,6535,224,6759,74
2021-08-16,Orange,059,3164182,280922,275985,12795,288780,5161
2021-08-16,Placer,061,380077,29051,27384,2365,29749,306
2021-08-16,Plumas,063,18699,921,851,14,865,5
2021-08-16,Riverside,065,2383286,322311,314774,14908,329682,4582
2021-08-16,Sacramento,067,1510023,129598,124554,2551,127105,1762
2021-08-16,San Benito,069,59416,6529,6452,124,6576,64
2021-08-16,San Bernardino,071,2135413,318898,313617,9708,323325,5301
2021-08-16,San Diego,073,3302833,321715,315348,18645,333993,3824
2021-08-16,San Francisco,075,870044,45997,44681,1846,46527,567
2021-08-16,San Joaquin,077,732212,83410,81087,4206,85293,1488
2021-08-16,San Luis Obispo,079,281455,24175,23452,905,24357,265
2021-08-16,San Mateo,081,765935,48188,47024,675,47699,548
2021-08-16,Santa Barbara,083,443738,38194,37358,1297,38655,475
2021-08-16,Santa Clara,085,1922200,131238,127978,939,128917,1773
2021-08-16,Santa Cruz,087,273765,17908,17491,875,18366,209
2021-08-16,Shasta,089,179085,14433,13862,1984,15846,211
2021-08-16,Sierra,091,2930,88,82,13,95,0
2021-08-16,Siskiyou,093,43540,2289,2169,553,2722,33
2021-08-16,Solano,095,438530,39572,37436,897,38333,263
2021-08-16,Sonoma,097,501317,36184,34844,427,35271,333
2021-08-16,Stanislaus,099,539301,63553,62033,6916,68949,1039
2021-08-16,Sutter,101,95872,11129,10902,116,11018,130
2021-08-16,Tehama,103,63373,5755,5565,688,6253,66
2021-08-16,Trinity,105,12862,566,400,127,527,3
2021-08-16,Tulare,107,460477,53720,52162,10421,62583,856
2021-08-16,Tuolumne,109,53932,5141,4984,54,5038,64
2021-08-16,Ventura,111,848112,88727,86954,3747,90701,1052
2021-08-16,Yolo,113,214977,16490,15922,603,16525,225
2021-08-16,Yuba,115,75493,7543,7314,167,7481,51
2021-08-15,Alameda,001,1643700,104750,101660,2268,103928,1287
2021-08-15,Alpine,003,1148,90,91,0,91,0
2021-08-15,Amador,005,37829,4363,4231,37,4268,49
2021-08-15,Butte,007,227075,14684,14263,2308,16571,206
2021-08-15,Calaveras,009,45235,2659,2599,17,2616,57
2021-08-15,Colusa,011,21464,2202,2140,426,2566,16
2021-08-15,Contra Costa,013,1133247,85002,81781,1645,83426,848
2021-08-15,Del Norte,015,27424,2330,2060,16,2076,8
2021-08-15,El Dorado,017,186661,12690,12057,1064,13121,118
2021-08-15,Fresno,019,978130,112138,109382,9649,119031,1753
2021-08-15,Glenn,021,27897,2654,2592,671,3263,20
2021-08-15,Humboldt,023,135768,6323,6024,118,6142,52
2021-08-15,Imperial,025,180216,29938,29711,2771,32482,746
2021-08-15,Inyo,027,18085,1494,1489,13,1502,39
2021-08-15,Kern,029,883053,104378,102524,13299,115823,1367
2021-08-15,Kings,031,150075,25409,24736,1290,26026,254
2021-08-15,Lake,033,64148,5013,4886,33,4919,68
2021-08-15,Lassen,035,31185,5563,5482,132,5614,21
2021-08-15,Los Angeles,037,10098052,1320608,1302882,47965,1350847,24918
2021-08-15,Madera,039,155013,18224,17714,1171,18885,246
2021-08-15,Marin,041,260295,15830,15461,308,15769,239
2021-08-15,Mariposa,043,17540,627,591,14,605,5
2021-08-15,Mendocino,045,87422,5286,5022,167,5189,49
2021-08-15,Merced,047,269075,33718,33305,1194,34499,481
2021-08-15,Modoc,049,8938,433,421,150,571,5
2021-08-15,Mono,051,14174,1370,1334,17,1351,3
2021-08-15,Monterey,053,433212,45039,44567,2153,46720,527
2021-08-15,Napa,055,140530,11177,10919,66,10985,83
2021-08-15,Nevada,057,99092,6766,6486,224,6710,74
2021-08-15,Orange,059,3164182,280151,275447,12755,288202,5161
2021-08-15,Placer,061,380077,28829,27220,2317,29537,306
2021-08-15,Plumas,063,18699,909,850,14,864,5
2021-08-15,Riverside,065,2383286,321173,314133,14881,329014,4582
2021-08-15,Sacramento,067,1510023,128782,123924,2519,126443,1761
2021-08-15,San Benito,069,59416,6511,6446,123,6569,64
2021-08-15,San Bernardino,071,2135413,317825,313120,9677,322797,5301
2021-08-15,San Diego,073,3302833,320243,314247,18518,332765,3824
2021-08-15,San Francisco,075,870044,45773,44531,1831,46362,567
2021-08-15,San Joaquin,077,732212,82923,80832,4167,84999,1488
2021-08-15,San Luis Obispo,079,281455,23979,23404,895,24299,265
2021-08-15,San Mateo,081,765935,48001,46897,669,47566,548
2021-08-15,Santa Barbara,083,443738,38022,37276,1290,38566,475
2021-08-15,Santa Clara,085,1922200,130805,127715,933,128648,1773
2021-08-15,Santa Cruz,087,273765,17838,17440,868,18308,209
2021-08-15,Shasta,089,179085,14330,13835,1959,15794,211
2021-08-15,Sierra,091,2930,87,82,12,94,0
2021-08-15,Siskiyou,093,43540,2268,2169,539,2708,33
2021-08-15,Solano,095,438530,39316,37320,886,38206,263
2021-08-15,Sonoma,097,501317,35988,34706,419,35125,333
2021-08-15,Stanislaus,099,539301,63184,61795,6839,68634,1039
2021-08-15,Sutter,101,95872,11038,10863,116,10979,130
2021-08-15,Tehama,103,63373,5706,5550,682,6232,66
2021-08-15,Trinity,105,12862,562,400,126,526,3
2021-08-15,Tulare,107,460477,53464,52046,10362,62408,856
2021-08-15,Tuolumne,109,53932,5103,4934,52,4986,64
2021-08-15,Ventura,111,848112,88422,86797,3733,90530,1052
2021-08-15,Yolo,113,214977,16393,15873,593,16466,225
2021-08-15,Yuba,115,75493,7466,7265,166,7431,51
2021-08-14,Alameda,001,1643700,104533,101305,2264,103569,1287
2021-08-14,Alpine,003,1148,90,91,0,91,0
2021-08-14,Amador,005,37829,4345,4206,37,4243,49
2021-08-14,Butte,007,227075,14648,14192,2292,16484,206
2021-08-14,Calaveras,009,45235,2652,2579,17,2596,57
2021-08-14,Colusa,011,21464,2191,2134,422,2556,16
2021-08-14,Contra Costa,013,1133247,84754,81458,1637,83095,848
2021-08-14,Del Norte,015,27424,2303,2015,16,2031,8
2021-08-14,El Dorado,017,186661,12654,12019,1056,13075,118
2021-08-14,Fresno,019,978130,111976,109056,9619,118675,1753
2021-08-14,Glenn,021,27897,2643,2583,668,3251,20
2021-08-14,Humboldt,023,135768,6270,5998,115,6113,52
2021-08-14,Imperial,025,180216,29911,29671,2771,32442,746
2021-08-14,Inyo,027,18085,1492,1487,13,1500,39
2021-08-14,Kern,029,883053,104183,102306,13203,115509,1367
2021-08-14,Kings,031,150075,25311,24647,1282,25929,254
2021-08-14,Lake,033,64148,4996,4850,32,4882,68
2021-08-14,Lassen,035,31185,5556,5475,131,5606,21
2021-08-14,Los Angeles,037,10098052,1318839,1299346,47826,1347172,24911
2021-08-14,Madera,039,155013,18177,17691,1166,18857,246
2021-08-14,Marin,041,260295,15796,15441,308,15749,239
2021-08-14,Mariposa,043,17540,623,584,14,598,5
2021-08-14,Mendocino,045,87422,5250,4977,164,5141,49
2021-08-14,Merced,047,269075,33654,33234,1188,34422,481
2021-08-14,Modoc,049,8938,433,421,150,571,5
2021-08-14,Mono,051,14174,1365,1332,17,1349,3
2021-08-14,Monterey,053,433212,44994,44514,2150,46664,527
2021-08-14,Napa,055,140530,11147,10878,65,10943,83
2021-08-14,Nevada,057,99092,6731,6419,223,6642,74
2021-08-14,Orange,059,3164182,279717,274732,12728,287460,5161
2021-08-14,Placer,061,380077,28683,27115,2293,29408,306
2021-08-14,Plumas,063,18699,899,849,14,863,5
2021-08-14,Riverside,065,2383286,320457,313264,14860,328124,4582
2021-08-14,Sacramento,067,1510023,128288,123438,2501,125939,1758
2021-08-14,San Benito,069,59416,6498,6428,123,6551,64
2021-08-14,San Bernardino,071,2135413,317274,312142,9656,321798,5301
2021-08-14,San Diego,073,3302833,319572,313589,18450,332039,3824
2021-08-14,San Francisco,075,870044,45644,44353,1812,46165,567
2021-08-14,San Joaquin,077,732212,82707,80585,4152,84737,1488
2021-08-14,San Luis Obispo,079,281455,23918,23328,892,24220,265
2021-08-14,San Mateo,081,765935,47882,46792,665,47457,548
2021-08-14,Santa Barbara,083,443738,37928,37118,1288,38406,475
2021-08-14,Santa Clara,085,1922200,130526,127432,930,128362,1772
2021-08-14,Santa Cruz,087,273765,17799,17384,867,18251,209
2021-08-14,Shasta,089,179085,14255,13813,1938,15751,211
2021-08-14,Sierra,091,2930,86,81,12,93,0
2021-08-14,Siskiyou,093,43540,2258,2160,529,2689,33
2021-08-14,Solano,095,438530,39229,37237,874,38111,263
2021-08-14,Sonoma,097,501317,35865,34606,417,35023,333
2021-08-14,Stanislaus,099,539301,63009,61564,6795,68359,1039
2021-08-14,Sutter,101,95872,10993,10808,115,10923,130
2021-08-14,Tehama,103,63373,5682,5530,678,6208,66
2021-08-14,Trinity,105,12862,556,399,126,525,3
2021-08-14,Tulare,107,460477,53328,51951,10317,62268,856
2021-08-14,Tuolumne,109,53932,5068,4924,52,4976,64
2021-08-14,Ventura,111,848112,88266,86569,3713,90282,1052
2021-08-14,Yolo,113,214977,16348,15815,584,16399,225
2021-08-14,Yuba,115,75493,7417,7223,166,7389,51
2021-08-13,Alameda,001,1643700,104237,100930,2256,103186,1284
2021-08-13,Alpine,003,1148,90,91,0,91,0
2021-08-13,Amador,005,37829,4317,4169,37,4206,49
2021-08-13,Butte,007,227075,14578,14100,2276,16376,206
2021-08-13,Calaveras,009,45235,2646,2564,17,2581,57
2021-08-13,Colusa,011,21464,2184,2123,417,2540,16
2021-08-13,Contra Costa,013,1133247,84443,81046,1630,82676,848
2021-08-13,Del Norte,015,27424,2262,1973,16,1989,8
2021-08-13,El Dorado,017,186661,12614,11951,1044,12995,118
2021-08-13,Fresno,019,978130,111684,108638,9596,118234,1753
2021-08-13,Glenn,021,27897,2632,2574,665,3239,20
2021-08-13,Humboldt,023,135768,6223,5882,112,5994,52
2021-08-13,Imperial,025,180216,29884,29654,2770,32424,745
2021-08-13,Inyo,027,18085,1491,1484,13,1497,39
2021-08-13,Kern,029,883053,103974,102029,13094,115123,1364
2021-08-13,Kings,031,150075,25226,24531,1275,25806,253
2021-08-13,Lake,033,64148,4973,4811,31,4842,68
2021-08-13,Lassen,035,31185,5548,5455,130,5585,21
2021-08-13,Los Angeles,037,10098052,1316517,1295406,47689,1343095,24891
2021-08-13,Madera,039,155013,18128,17614,1157,18771,246
2021-08-13,Marin,041,260295,15765,15380,308,15688,239
2021-08-13,Mariposa,043,17540,617,577,14,591,5
2021-08-13,Mendocino,045,87422,5197,4924,162,5086,49
2021-08-13,Merced,047,269075,33607,33111,1182,34293,480
2021-08-13,Modoc,049,8938,432,421,149,570,5
2021-08-13,Mono,051,14174,1362,1331,17,1348,3
2021-08-13,Monterey,053,433212,44934,44450,2148,46598,527
2021-08-13,Napa,055,140530,11111,10830,65,10895,83
2021-08-13,Nevada,057,99092,6690,6356,222,6578,74
2021-08-13,Orange,059,3164182,279223,274004,12679,286683,5159
2021-08-13,Placer,061,380077,28582,26987,2266,29253,306
2021-08-13,Plumas,063,18699,885,842,14,856,5
2021-08-13,Riverside,065,2383286,319718,312408,14835,327243,4581
2021-08-13,Sacramento,067,1510023,127818,122868,2476,125344,1758
2021-08-13,San Benito,069,59416,6492,6422,121,6543,64
2021-08-13,San Bernardino,071,2135413,316606,311378,9637,321015,5301
2021-08-13,San Diego,073,3302833,318526,312293,18371,330664,3821
2021-08-13,San Francisco,075,870044,45508,44196,1789,45985,567
2021-08-13,San Joaquin,077,732212,82490,80232,4136,84368,1481
2021-08-13,San Luis Obispo,079,281455,23855,23226,889,24115,265
2021-08-13,San Mateo,081,765935,47763,46660,664,47324,548
2021-08-13,Santa Barbara,083,443738,37843,37023,1284,38307,474
2021-08-13,Santa Clara,085,1922200,130239,126958,924,127882,1769
2021-08-13,Santa Cruz,087,273765,17759,17332,860,18192,209
2021-08-13,Shasta,089,179085,14192,13698,1924,15622,211
2021-08-13,Sierra,091,2930,85,81,12,93,0
2021-08-13,Siskiyou,093,43540,2249,2147,525,2672,33
2021-08-13,Solano,095,438530,39095,37104,866,37970,264
2021-08-13,Sonoma,097,501317,35760,34464,417,34881,333
2021-08-13,Stanislaus,099,539301,62837,61294,6754,68048,1039
2021-08-13,Sutter,101,95872,10949,10751,114,10865,130
2021-08-13,Tehama,103,63373,5658,5496,676,6172,66
2021-08-13,Trinity,105,12862,552,392,126,518,3
2021-08-13,Tulare,107,460477,53224,51770,10244,62014,856
2021-08-13,Tuolumne,109,53932,5035,4899,51,4950,64
2021-08-13,Ventura,111,848112,88108,86368,3700,90068,1052
2021-08-13,Yolo,113,214977,16294,15761,574,16335,225
2021-08-13,Yuba,115,75493,7379,7184,166,7350,51
2021-08-12,Alameda,001,1643700,103747,100472,2243,102715,1284
2021-08-12,Alpine,003,1148,90,91,0,91,0
2021-08-12,Amador,005,37829,4287,4161,36,4197,49
2021-08-12,Butte,007,227075,14508,14006,2258,16264,206
2021-08-12,Calaveras,009,45235,2630,2531,17,2548,57
2021-08-12,Colusa,011,21464,2179,2111,416,2527,17
2021-08-12,Contra Costa,013,1133247,83960,80738,1615,82353,846
2021-08-12,Del Norte,015,27424,2190,1923,16,1939,8
2021-08-12,El Dorado,017,186661,12500,11880,1035,12915,118
2021-08-12,Fresno,019,978130,111262,108193,9528,117721,1753
2021-08-12,Glenn,021,27897,2624,2559,653,3212,20
2021-08-12,Humboldt,023,135768,6154,5845,108,5953,52
2021-08-12,Imperial,025,180216,29828,29585,2764,32349,745
2021-08-12,Inyo,027,18085,1489,1483,13,1496,39
2021-08-12,Kern,029,883053,103685,101698,13015,114713,1364
2021-08-12,Kings,031,150075,25126,24423,1267,25690,252
2021-08-12,Lake,033,64148,4947,4774,31,4805,68
2021-08-12,Lassen,035,31185,5526,5428,129,5557,21
2021-08-12,Los Angeles,037,10098052,1313326,1291875,47554,1339429,24874
2021-08-12,Madera,039,155013,18064,17564,1145,18709,246
2021-08-12,Marin,041,260295,15716,15277,305,15582,239
2021-08-12,Mariposa,043,17540,608,568,13,581,5
2021-08-12,Mendocino,045,87422,5167,4873,156,5029,49
2021-08-12,Merced,047,269075,33483,32960,1175,34135,480
2021-08-12,Modoc,049,8938,431,423,149,572,5
2021-08-12,Mono,051,14174,1357,1325,17,1342,3
2021-08-12,Monterey,053,433212,44858,44383,2133,46516,527
2021-08-12,Napa,055,140530,11062,10780,64,10844,83
2021-08-12,Nevada,057,99092,6629,6283,222,6505,74
2021-08-12,Orange,059,3164182,278545,273167,12621,285788,5158
2021-08-12,Placer,061,380077,28383,26856,2243,29099,306
2021-08-12,Plumas,063,18699,877,829,14,843,5
2021-08-12,Riverside,065,2383286,318709,311304,14803,326107,4575
2021-08-12,Sacramento,067,1510023,127047,122222,2446,124668,1758
2021-08-12,San Benito,069,59416,6475,6398,119,6517,64
2021-08-12,San Bernardino,071,2135413,315731,310420,9607,320027,5297
2021-08-12,San Diego,073,3302833,317156,310596,18282,328878,3821
2021-08-12,San Francisco,075,870044,45301,43774,1776,45550,564
2021-08-12,San Joaquin,077,732212,82095,79945,4112,84057,1479
2021-08-12,San Luis Obispo,079,281455,23755,23101,876,23977,264
2021-08-12,San Mateo,081,765935,47619,46435,661,47096,548
2021-08-12,Santa Barbara,083,443738,37706,36881,1276,38157,473
2021-08-12,Santa Clara,085,1922200,129790,126614,918,127532,1769
2021-08-12,Santa Cruz,087,273765,17695,17261,859,18120,209
2021-08-12,Shasta,089,179085,14106,13621,1897,15518,211
2021-08-12,Sierra,091,2930,85,81,12,93,0
2021-08-12,Siskiyou,093,43540,2242,2134,516,2650,33
2021-08-12,Solano,095,438530,38866,36980,857,37837,262
2021-08-12,Sonoma,097,501317,35612,34299,414,34713,333
2021-08-12,Stanislaus,099,539301,62572,61026,6695,67721,1039
2021-08-12,Sutter,101,95872,10888,10695,112,10807,130
2021-08-12,Tehama,103,63373,5628,5462,667,6129,66
2021-08-12,Trinity,105,12862,548,386,125,511,3
2021-08-12,Tulare,107,460477,53079,51632,10195,61827,856
2021-08-12,Tuolumne,109,53932,4988,4845,49,4894,64
2021-08-12,Ventura,111,848112,87871,86106,3676,89782,1052
2021-08-12,Yolo,113,214977,16222,15686,560,16246,224
2021-08-12,Yuba,115,75493,7331,7128,165,7293,51
2021-08-11,Alameda,001,1643700,103236,100040,2240,102280,1281
2021-08-11,Alpine,003,1148,90,91,0,91,0
2021-08-11,Amador,005,37829,4263,4127,36,4163,49
2021-08-11,Butte,007,227075,14407,13905,2233,16138,206
2021-08-11,Calaveras,009,45235,2608,2505,17,2522,57
2021-08-11,Colusa,011,21464,2169,2101,414,2515,16
2021-08-11,Contra Costa,013,1133247,83460,80275,1597,81872,843
2021-08-11,Del Norte,015,27424,2131,1893,16,1909,8
2021-08-11,El Dorado,017,186661,12389,11799,1023,12822,119
2021-08-11,Fresno,019,978130,110808,107773,9482,117255,1751
2021-08-11,Glenn,021,27897,2615,2547,643,3190,20
2021-08-11,Humboldt,023,135768,6107,5765,107,5872,52
2021-08-11,Imperial,025,180216,29785,29565,2760,32325,745
2021-08-11,Inyo,027,18085,1489,1483,13,1496,39
2021-08-11,Kern,029,883053,103371,101448,12908,114356,1363
2021-08-11,Kings,031,150075,25013,24304,1258,25562,250
2021-08-11,Lake,033,64148,4910,4713,30,4743,68
2021-08-11,Lassen,035,31185,5517,5408,127,5535,21
2021-08-11,Los Angeles,037,10098052,1309998,1288238,47368,1335606,24851
2021-08-11,Madera,039,155013,18014,17511,1134,18645,245
2021-08-11,Marin,041,260295,15667,15235,305,15540,239
2021-08-11,Mariposa,043,17540,598,554,12,566,5
2021-08-11,Mendocino,045,87422,5098,4796,147,4943,49
2021-08-11,Merced,047,269075,33350,32802,1171,33973,479
2021-08-11,Modoc,049,8938,431,421,149,570,5
2021-08-11,Mono,051,14174,1352,1320,17,1337,3
2021-08-11,Monterey,053,433212,44759,44314,2115,46429,527
2021-08-11,Napa,055,140530,11021,10732,64,10796,83
2021-08-11,Nevada,057,99092,6576,6172,219,6391,74
2021-08-11,Orange,059,3164182,277688,272212,12576,284788,5155
2021-08-11,Placer,061,380077,28171,26687,2217,28904,305
2021-08-11,Plumas,063,18699,868,824,14,838,5
2021-08-11,Riverside,065,2383286,317716,310265,14768,325033,4570
2021-08-11,Sacramento,067,1510023,126254,121603,2407,124010,1757
2021-08-11,San Benito,069,59416,6462,6381,119,6500,64
2021-08-11,San Bernardino,071,2135413,314839,309498,9588,319086,5296
2021-08-11,San Diego,073,3302833,315686,309406,18178,327584,3818
2021-08-11,San Francisco,075,870044,45076,43555,1768,45323,564
2021-08-11,San Joaquin,077,732212,81688,79641,4085,83726,1478
2021-08-11,San Luis Obispo,079,281455,23651,22920,869,23789,264
2021-08-11,San Mateo,081,765935,47451,46300,658,46958,548
2021-08-11,Santa Barbara,083,443738,37543,36699,1268,37967,472
2021-08-11,Santa Clara,085,1922200,129309,126301,910,127211,1769
2021-08-11,Santa Cruz,087,273765,17630,17191,856,18047,209
2021-08-11,Shasta,089,179085,14032,13546,1882,15428,211
2021-08-11,Sierra,091,2930,84,81,12,93,0
2021-08-11,Siskiyou,093,43540,2228,2124,509,2633,33
2021-08-11,Solano,095,438530,38631,36862,843,37705,262
2021-08-11,Sonoma,097,501317,35433,34188,409,34597,333
2021-08-11,Stanislaus,099,539301,62241,60767,6665,67432,1037
2021-08-11,Sutter,101,95872,10816,10628,112,10740,130
2021-08-11,Tehama,103,63373,5599,5410,651,6061,66
2021-08-11,Trinity,105,12862,546,385,125,510,3
2021-08-11,Tulare,107,460477,52911,51464,10150,61614,854
2021-08-11,Tuolumne,109,53932,4956,4794,49,4843,64
2021-08-11,Ventura,111,848112,87619,85863,3655,89518,1051
2021-08-11,Yolo,113,214977,16147,15593,544,16137,218
2021-08-11,Yuba,115,75493,7272,7063,164,7227,53
2021-08-10,Alameda,001,1643700,102762,99771,2233,102004,1281
2021-08-10,Alpine,003,1148,90,91,0,91,0
2021-08-10,Amador,005,37829,4247,4093,36,4129,49
2021-08-10,Butte,007,227075,14323,13853,2212,16065,205
2021-08-10,Calaveras,009,45235,2584,2491,15,2506,57
2021-08-10,Colusa,011,21464,2156,2088,405,2493,16
2021-08-10,Contra Costa,013,1133247,82916,80018,1587,81605,840
2021-08-10,Del Norte,015,27424,2087,1870,16,1886,8
2021-08-10,El Dorado,017,186661,12288,11734,1011,12745,117
2021-08-10,Fresno,019,978130,110352,107616,9427,117043,1747
2021-08-10,Glenn,021,27897,2602,2538,633,3171,20
2021-08-10,Humboldt,023,135768,6053,5718,104,5822,52
2021-08-10,Imperial,025,180216,29750,29522,2753,32275,745
2021-08-10,Inyo,027,18085,1489,1482,13,1495,39
2021-08-10,Kern,029,883053,103043,101254,12812,114066,1359
2021-08-10,Kings,031,150075,24887,24252,1242,25494,251
2021-08-10,Lake,033,64148,4869,4700,30,4730,67
2021-08-10,Lassen,035,31185,5499,5401,127,5528,21
2021-08-10,Los Angeles,037,10098052,1306242,1285140,47203,1332343,24821
2021-08-10,Madera,039,155013,17941,17481,1124,18605,245
2021-08-10,Marin,041,260295,15620,15194,305,15499,239
2021-08-10,Mariposa,043,17540,585,550,12,562,5
2021-08-10,Mendocino,045,87422,5053,4775,143,4918,49
2021-08-10,Merced,047,269075,33203,32721,1162,33883,477
2021-08-10,Modoc,049,8938,430,421,149,570,5
2021-08-10,Mono,051,14174,1347,1320,17,1337,3
2021-08-10,Monterey,053,433212,44697,44259,2100,46359,527
2021-08-10,Napa,055,140530,10965,10703,63,10766,83
2021-08-10,Nevada,057,99092,6511,6151,218,6369,73
2021-08-10,Orange,059,3164182,276808,271688,12529,284217,5155
2021-08-10,Placer,061,380077,27952,26561,2175,28736,305
2021-08-10,Plumas,063,18699,859,816,14,830,5
2021-08-10,Riverside,065,2383286,316601,309529,14742,324271,4564
2021-08-10,Sacramento,067,1510023,125401,121159,2377,123536,1755
2021-08-10,San Benito,069,59416,6448,6371,119,6490,64
2021-08-10,San Bernardino,071,2135413,313914,308672,9570,318242,5295
2021-08-10,San Diego,073,3302833,314044,308288,18086,326374,3815
2021-08-10,San Francisco,075,870044,44822,43389,1753,45142,564
2021-08-10,San Joaquin,077,732212,81290,79391,4067,83458,1478
2021-08-10,San Luis Obispo,079,281455,23525,22776,867,23643,264
2021-08-10,San Mateo,081,765935,47279,46184,656,46840,548
2021-08-10,Santa Barbara,083,443738,37378,36574,1261,37835,472
2021-08-10,Santa Clara,085,1922200,128846,126019,903,126922,1770
2021-08-10,Santa Cruz,087,273765,17547,17142,854,17996,209
2021-08-10,Shasta,089,179085,13954,13461,1859,15320,211
2021-08-10,Sierra,091,2930,84,76,12,88,0
2021-08-10,Siskiyou,093,43540,2219,2088,502,2590,33
2021-08-10,Solano,095,438530,38385,36767,832,37599,262
2021-08-10,Sonoma,097,501317,35288,34054,406,34460,333
2021-08-10,Stanislaus,099,539301,61896,60605,6628,67233,1037
2021-08-10,Sutter,101,95872,10751,10569,112,10681,130
2021-08-10,Tehama,103,63373,5570,5392,646,6038,66
2021-08-10,Trinity,105,12862,546,384,125,509,3
2021-08-10,Tulare,107,460477,52746,51390,10098,61488,854
2021-08-10,Tuolumne,109,53932,4927,4780,47,4827,64
2021-08-10,Ventura,111,848112,87329,85714,3634,89348,1051
2021-08-10,Yolo,113,214977,16060,15568,534,16102,218
2021-08-10,Yuba,115,75493,7223,7028,164,7192,50
2021-08-09,Alameda,001,1643700,102208,99496,2229,101725,1276
2021-08-09,Alpine,003,1148,90,91,0,91,0
2021-08-09,Amador,005,37829,4221,4078,36,4114,48
2021-08-09,Butte,007,227075,14224,13813,2183,15996,205
2021-08-09,Calaveras,009,45235,2559,2472,15,2487,57
2021-08-09,Colusa,011,21464,2146,2075,398,2473,16
2021-08-09,Contra Costa,013,1133247,82373,79740,1575,81315,840
2021-08-09,Del Norte,015,27424,2019,1848,16,1864,8
2021-08-09,El Dorado,017,186661,12181,11672,998,12670,117
2021-08-09,Fresno,019,978130,109858,107310,9389,116699,1747
2021-08-09,Glenn,021,27897,2591,2532,621,3153,20
2021-08-09,Humboldt,023,135768,5962,5632,102,5734,52
2021-08-09,Imperial,025,180216,29705,29512,2749,32261,745
2021-08-09,Inyo,027,18085,1489,1481,13,1494,39
2021-08-09,Kern,029,883053,102731,101069,12726,113795,1359
2021-08-09,Kings,031,150075,24780,24155,1228,25383,250
2021-08-09,Lake,033,64148,4834,4670,28,4698,66
2021-08-09,Lassen,035,31185,5477,5393,126,5519,21
2021-08-09,Los Angeles,037,10098052,1302231,1282891,46998,1329889,24798
2021-08-09,Madera,039,155013,17882,17429,1104,18533,245
2021-08-09,Marin,041,260295,15567,15154,304,15458,239
2021-08-09,Mariposa,043,17540,572,545,12,557,5
2021-08-09,Mendocino,045,87422,5002,4732,135,4867,49
2021-08-09,Merced,047,269075,33057,32666,1155,33821,477
2021-08-09,Modoc,049,8938,430,419,149,568,5
2021-08-09,Mono,051,14174,1344,1337,17,1354,3
2021-08-09,Monterey,053,433212,44625,44190,2085,46275,527
2021-08-09,Napa,055,140530,10918,10679,63,10742,83
2021-08-09,Nevada,057,99092,6439,6088,217,6305,73
2021-08-09,Orange,059,3164182,275768,271036,12474,283510,5153
2021-08-09,Placer,061,380077,27729,26457,2144,28601,305
2021-08-09,Plumas,063,18699,842,803,14,817,5
2021-08-09,Riverside,065,2383286,315525,308678,14724,323402,4562
2021-08-09,Sacramento,067,1510023,124566,120812,2352,123164,1748
2021-08-09,San Benito,069,59416,6428,6359,117,6476,63
2021-08-09,San Bernardino,071,2135413,312929,308038,9547,317585,5295
2021-08-09,San Diego,073,3302833,312384,306855,17987,324842,3811
2021-08-09,San Francisco,075,870044,44576,43261,1737,44998,564
2021-08-09,San Joaquin,077,732212,80908,79198,4049,83247,1469
2021-08-09,San Luis Obispo,079,281455,23386,22695,858,23553,264
2021-08-09,San Mateo,081,765935,47107,46040,653,46693,548
2021-08-09,Santa Barbara,083,443738,37194,36474,1253,37727,470
2021-08-09,Santa Clara,085,1922200,128343,125791,894,126685,2187
2021-08-09,Santa Cruz,087,273765,17485,17082,854,17936,209
2021-08-09,Shasta,089,179085,13837,13397,1848,15245,210
2021-08-09,Sierra,091,2930,83,75,12,87,0
2021-08-09,Siskiyou,093,43540,2207,2047,487,2534,32
2021-08-09,Solano,095,438530,38109,36653,830,37483,262
2021-08-09,Sonoma,097,501317,35107,33933,404,34337,333
2021-08-09,Stanislaus,099,539301,61617,60410,6579,66989,1037
2021-08-09,Sutter,101,95872,10702,10525,109,10634,129
2021-08-09,Tehama,103,63373,5528,5373,645,6018,66
2021-08-09,Trinity,105,12862,544,378,123,501,3
2021-08-09,Tulare,107,460477,52585,51274,10036,61310,854
2021-08-09,Tuolumne,109,53932,4885,4745,47,4792,64
2021-08-09,Ventura,111,848112,87057,85514,3623,89137,1047
2021-08-09,Yolo,113,214977,15982,15521,513,16034,218
2021-08-09,Yuba,115,75493,7164,6994,164,7158,50
2021-08-08,Alameda,001,1643700,101655,99135,2223,101358,1276
2021-08-08,Alpine,003,1148,90,91,0,91,0
2021-08-08,Amador,005,37829,4187,4057,35,4092,48
2021-08-08,Butte,007,227075,14142,13791,2163,15954,205
2021-08-08,Calaveras,009,45235,2526,2462,15,2477,57
2021-08-08,Colusa,011,21464,2129,2070,391,2461,16
2021-08-08,Contra Costa,013,1133247,81849,79454,1568,81022,840
2021-08-08,Del Norte,015,27424,1973,1810,16,1826,8
2021-08-08,El Dorado,017,186661,12060,11631,987,12618,117
2021-08-08,Fresno,019,978130,109415,107078,9352,116430,1747
2021-08-08,Glenn,021,27897,2583,2527,614,3141,20
2021-08-08,Humboldt,023,135768,5873,5571,102,5673,52
2021-08-08,Imperial,025,180216,29681,29485,2739,32224,745
2021-08-08,Inyo,027,18085,1489,1481,13,1494,39
2021-08-08,Kern,029,883053,102411,100909,12614,113523,1359
2021-08-08,Kings,031,150075,24666,24095,1219,25314,250
2021-08-08,Lake,033,64148,4784,4636,27,4663,66
2021-08-08,Lassen,035,31185,5462,5391,125,5516,21
2021-08-08,Los Angeles,037,10098052,1297979,1279982,46814,1326796,24793
2021-08-08,Madera,039,155013,17803,17398,1087,18485,245
2021-08-08,Marin,041,260295,15514,15124,302,15426,239
2021-08-08,Mariposa,043,17540,568,538,12,550,5
2021-08-08,Mendocino,045,87422,4940,4702,122,4824,49
2021-08-08,Merced,047,269075,32910,32634,1146,33780,477
2021-08-08,Modoc,049,8938,429,419,148,567,5
2021-08-08,Mono,051,14174,1340,1336,17,1353,3
2021-08-08,Monterey,053,433212,44555,44171,2074,46245,527
2021-08-08,Napa,055,140530,10882,10668,63,10731,83
2021-08-08,Nevada,057,99092,6355,6009,215,6224,73
2021-08-08,Orange,059,3164182,274855,270532,12432,282964,5153
2021-08-08,Placer,061,380077,27520,26332,2103,28435,305
2021-08-08,Plumas,063,18699,833,803,14,817,5
2021-08-08,Riverside,065,2383286,314404,308042,14701,322743,4562
2021-08-08,Sacramento,067,1510023,123738,120109,2340,122449,1744
2021-08-08,San Benito,069,59416,6411,6350,116,6466,63
2021-08-08,San Bernardino,071,2135413,311783,307378,9518,316896,5295
2021-08-08,San Diego,073,3302833,311043,305983,17889,323872,3811
2021-08-08,San Francisco,075,870044,44316,43098,1714,44812,564
2021-08-08,San Joaquin,077,732212,80459,79002,4033,83035,1469
2021-08-08,San Luis Obispo,079,281455,23212,22668,850,23518,263
2021-08-08,San Mateo,081,765935,46917,45927,650,46577,548
2021-08-08,Santa Barbara,083,443738,37017,36417,1246,37663,470
2021-08-08,Santa Clara,085,1922200,127892,125553,889,126442,2187
2021-08-08,Santa Cruz,087,273765,17414,17035,849,17884,209
2021-08-08,Shasta,089,179085,13752,13381,1837,15218,210
2021-08-08,Sierra,091,2930,83,74,12,86,0
2021-08-08,Siskiyou,093,43540,2191,2041,482,2523,32
2021-08-08,Solano,095,438530,37857,36551,826,37377,262
2021-08-08,Sonoma,097,501317,34863,33805,403,34208,333
2021-08-08,Stanislaus,099,539301,61291,60269,6534,66803,1037
2021-08-08,Sutter,101,95872,10642,10481,108,10589,129
2021-08-08,Tehama,103,63373,5491,5359,642,6001,66
2021-08-08,Trinity,105,12862,539,378,123,501,3
2021-08-08,Tulare,107,460477,52406,51220,9977,61197,854
2021-08-08,Tuolumne,109,53932,4846,4731,47,4778,64
2021-08-08,Ventura,111,848112,86766,85382,3613,88995,1047
2021-08-08,Yolo,113,214977,15890,15477,506,15983,218
2021-08-08,Yuba,115,75493,7125,6967,164,7131,50
2021-08-07,Alameda,001,1643700,101405,98812,2217,101029,1276
2021-08-07,Alpine,003,1148,90,91,0,91,0
2021-08-07,Amador,005,37829,4170,4041,34,4075,48
2021-08-07,Butte,007,227075,14090,13714,2151,15865,205
2021-08-07,Calaveras,009,45235,2516,2446,15,2461,57
2021-08-07,Colusa,011,21464,2124,2067,382,2449,16
2021-08-07,Contra Costa,013,1133247,81553,79168,1565,80733,840
2021-08-07,Del Norte,015,27424,1941,1791,16,1807,8
2021-08-07,El Dorado,017,186661,12012,11575,980,12555,117
2021-08-07,Fresno,019,978130,109212,106861,9326,116187,1747
2021-08-07,Glenn,021,27897,2575,2515,613,3128,20
2021-08-07,Humboldt,023,135768,5823,5510,99,5609,52
2021-08-07,Imperial,025,180216,29662,29470,2739,32209,745
2021-08-07,Inyo,027,18085,1487,1476,13,1489,39
2021-08-07,Kern,029,883053,102253,100693,12559,113252,1359
2021-08-07,Kings,031,150075,24605,24048,1213,25261,250
2021-08-07,Lake,033,64148,4763,4613,27,4640,66
2021-08-07,Lassen,035,31185,5458,5386,125,5511,21
2021-08-07,Los Angeles,037,10098052,1295942,1276853,46667,1323520,24786
2021-08-07,Madera,039,155013,17768,17366,1083,18449,245
2021-08-07,Marin,041,260295,15480,15085,301,15386,239
2021-08-07,Mariposa,043,17540,565,530,12,542,5
2021-08-07,Mendocino,045,87422,4904,4690,120,4810,49
2021-08-07,Merced,047,269075,32846,32569,1143,33712,477
2021-08-07,Modoc,049,8938,429,419,148,567,5
2021-08-07,Mono,051,14174,1337,1329,17,1346,3
2021-08-07,Monterey,053,433212,44503,44124,2069,46193,527
2021-08-07,Napa,055,140530,10861,10658,62,10720,83
2021-08-07,Nevada,057,99092,6305,5967,213,6180,73
2021-08-07,Orange,059,3164182,274262,269900,12402,282302,5153
2021-08-07,Placer,061,380077,27331,26244,2095,28339,305
2021-08-07,Plumas,063,18699,828,801,14,815,5
2021-08-07,Riverside,065,2383286,313732,307326,14694,322020,4562
2021-08-07,Sacramento,067,1510023,123237,119636,2336,121972,1744
2021-08-07,San Benito,069,59416,6401,6332,116,6448,63
2021-08-07,San Bernardino,071,2135413,311195,306663,9501,316164,5295
2021-08-07,San Diego,073,3302833,310288,304974,17854,322828,3811
2021-08-07,San Francisco,075,870044,44145,42926,1696,44622,564
2021-08-07,San Joaquin,077,732212,80295,78769,4018,82787,1469
2021-08-07,San Luis Obispo,079,281455,23143,22579,849,23428,263
2021-08-07,San Mateo,081,765935,46789,45804,648,46452,548
2021-08-07,Santa Barbara,083,443738,36921,36303,1240,37543,470
2021-08-07,Santa Clara,085,1922200,127621,125196,884,126080,2188
2021-08-07,Santa Cruz,087,273765,17371,16994,847,17841,209
2021-08-07,Shasta,089,179085,13696,13361,1830,15191,210
2021-08-07,Sierra,091,2930,83,74,12,86,0
2021-08-07,Siskiyou,093,43540,2179,2039,480,2519,32
2021-08-07,Solano,095,438530,37741,36458,818,37276,262
2021-08-07,Sonoma,097,501317,34741,33716,403,34119,333
2021-08-07,Stanislaus,099,539301,61120,60093,6504,66597,1037
2021-08-07,Sutter,101,95872,10605,10447,108,10555,129
2021-08-07,Tehama,103,63373,5480,5343,637,5980,66
2021-08-07,Trinity,105,12862,535,377,122,499,3
2021-08-07,Tulare,107,460477,52320,51133,9939,61072,854
2021-08-07,Tuolumne,109,53932,4816,4721,47,4768,64
2021-08-07,Ventura,111,848112,86586,85232,3599,88831,1047
2021-08-07,Yolo,113,214977,15846,15423,499,15922,218
2021-08-07,Yuba,115,75493,7100,6937,162,7099,50
2021-08-06,Alameda,001,1643700,101076,98487,2211,100698,1275
2021-08-06,Alpine,003,1148,90,91,0,91,0
2021-08-06,Amador,005,37829,4149,4002,34,4036,48
2021-08-06,Butte,007,227075,14040,13626,2136,15762,205
2021-08-06,Calaveras,009,45235,2505,2419,15,2434,57
2021-08-06,Colusa,011,21464,2117,2045,376,2421,16
2021-08-06,Contra Costa,013,1133247,81258,78796,1560,80356,840
2021-08-06,Del Norte,015,27424,1914,1755,15,1770,8
2021-08-06,El Dorado,017,186661,11962,11498,968,12466,117
2021-08-06,Fresno,019,978130,108947,106542,9299,115841,1747
2021-08-06,Glenn,021,27897,2560,2504,610,3114,20
2021-08-06,Humboldt,023,135768,5772,5421,96,5517,52
2021-08-06,Imperial,025,180216,29651,29404,2735,32139,745
2021-08-06,Inyo,027,18085,1484,1471,13,1484,39
2021-08-06,Kern,029,883053,102076,100427,12474,112901,1359
2021-08-06,Kings,031,150075,24550,23974,1209,25183,250
2021-08-06,Lake,033,64148,4740,4557,27,4584,66
2021-08-06,Lassen,035,31185,5436,5368,125,5493,21
2021-08-06,Los Angeles,037,10098052,1293452,1273081,46515,1319596,24772
2021-08-06,Madera,039,155013,17729,17324,1074,18398,245
2021-08-06,Marin,041,260295,15447,15051,301,15352,239
2021-08-06,Mariposa,043,17540,556,511,12,523,5
2021-08-06,Mendocino,045,87422,4862,4649,119,4768,49
2021-08-06,Merced,047,269075,32786,32456,1140,33596,477
2021-08-06,Modoc,049,8938,429,419,148,567,5
2021-08-06,Mono,051,14174,1336,1328,17,1345,3
2021-08-06,Monterey,053,433212,44435,44058,2056,46114,527
2021-08-06,Napa,055,140530,10834,10620,62,10682,83
2021-08-06,Nevada,057,99092,6249,5874,213,6087,73
2021-08-06,Orange,059,3164182,273697,269077,12385,281462,5151
2021-08-06,Placer,061,380077,27208,26086,2074,28160,305
2021-08-06,Plumas,063,18699,819,795,14,809,5
2021-08-06,Riverside,065,2383286,313022,306304,14683,320987,4562
2021-08-06,Sacramento,067,1510023,122745,119169,2317,121486,1740
2021-08-06,San Benito,069,59416,6384,6315,116,6431,63
2021-08-06,San Bernardino,071,2135413,310495,305806,9492,315298,5286
2021-08-06,San Diego,073,3302833,309249,303691,17805,321496,3810
2021-08-06,San Francisco,075,870044,43988,42659,1678,44337,565
2021-08-06,San Joaquin,077,732212,80145,78405,4006,82411,1469
2021-08-06,San Luis Obispo,079,281455,23075,22472,844,23316,263
2021-08-06,San Mateo,081,765935,46637,45665,643,46308,548
2021-08-06,Santa Barbara,083,443738,36832,36208,1236,37444,470
2021-08-06,Santa Clara,085,1922200,127331,124767,879,125646,2185
2021-08-06,Santa Cruz,087,273765,17327,16924,843,17767,207
2021-08-06,Shasta,089,179085,13630,13284,1824,15108,210
2021-08-06,Sierra,091,2930,83,73,12,85,0
2021-08-06,Siskiyou,093,43540,2169,2030,476,2506,32
2021-08-06,Solano,095,438530,37631,36351,809,37160,262
2021-08-06,Sonoma,097,501317,34655,33594,402,33996,333
2021-08-06,Stanislaus,099,539301,60982,59854,6484,66338,1037
2021-08-06,Sutter,101,95872,10562,10391,108,10499,128
2021-08-06,Tehama,103,63373,5456,5325,635,5960,66
2021-08-06,Trinity,105,12862,534,371,121,492,3
2021-08-06,Tulare,107,460477,52219,51018,9892,60910,854
2021-08-06,Tuolumne,109,53932,4789,4674,47,4721,64
2021-08-06,Ventura,111,848112,86415,85046,3587,88633,1047
2021-08-06,Yolo,113,214977,15793,15299,494,15793,218
2021-08-06,Yuba,115,75493,7077,6904,162,7066,50
2021-08-05,Alameda,001,1643700,100590,98052,2206,100258,1275
2021-08-05,Alpine,003,1148,90,91,0,91,0
2021-08-05,Amador,005,37829,4129,3992,34,4026,48
2021-08-05,Butte,007,227075,13979,13564,2113,15677,206
2021-08-05,Calaveras,009,45235,2486,2397,15,2412,57
2021-08-05,Colusa,011,21464,2105,2036,372,2408,16
2021-08-05,Contra Costa,013,1133247,80831,78514,1553,80067,840
2021-08-05,Del Norte,015,27424,1887,1731,15,1746,8
2021-08-05,El Dorado,017,186661,11877,11408,957,12365,117
2021-08-05,Fresno,019,978130,108576,106219,9263,115482,1747
2021-08-05,Glenn,021,27897,2554,2494,607,3101,20
2021-08-05,Humboldt,023,135768,5698,5328,95,5423,52
2021-08-05,Imperial,025,180216,29620,29383,2731,32114,745
2021-08-05,Inyo,027,18085,1480,1468,13,1481,38
2021-08-05,Kern,029,883053,101854,100091,12389,112480,1358
2021-08-05,Kings,031,150075,24466,23906,1204,25110,249
2021-08-05,Lake,033,64148,4701,4490,25,4515,66
2021-08-05,Lassen,035,31185,5428,5344,125,5469,21
2021-08-05,Los Angeles,037,10098052,1290232,1269445,46384,1315829,24756
2021-08-05,Madera,039,155013,17688,17301,1066,18367,245
2021-08-05,Marin,041,260295,15403,15005,297,15302,239
2021-08-05,Mariposa,043,17540,545,504,11,515,5
2021-08-05,Mendocino,045,87422,4819,4597,110,4707,49
2021-08-05,Merced,047,269075,32719,32381,1129,33510,477
2021-08-05,Modoc,049,8938,428,418,148,566,5
2021-08-05,Mono,051,14174,1328,1309,17,1326,3
2021-08-05,Monterey,053,433212,44378,43992,2038,46030,527
2021-08-05,Napa,055,140530,10798,10591,60,10651,83
2021-08-05,Nevada,057,99092,6167,5778,210,5988,73
2021-08-05,Orange,059,3164182,272916,268329,12359,280688,5149
2021-08-05,Placer,061,380077,27008,25965,2047,28012,305
2021-08-05,Plumas,063,18699,810,787,14,801,5
2021-08-05,Riverside,065,2383286,312105,305415,14657,320072,4562
2021-08-05,Sacramento,067,1510023,122036,118590,2304,120894,1739
2021-08-05,San Benito,069,59416,6366,6305,116,6421,63
2021-08-05,San Bernardino,071,2135413,309659,304956,9471,314427,5284
2021-08-05,San Diego,073,3302833,307977,302220,17723,319943,3806
2021-08-05,San Francisco,075,870044,43777,42301,1669,43970,564
2021-08-05,San Joaquin,077,732212,79783,78151,3988,82139,1468
2021-08-05,San Luis Obispo,079,281455,22960,22362,838,23200,263
2021-08-05,San Mateo,081,765935,46464,45554,641,46195,548
2021-08-05,Santa Barbara,083,443738,36725,36112,1233,37345,470
2021-08-05,Santa Clara,085,1922200,126998,124490,879,125369,2185
2021-08-05,Santa Cruz,087,273765,17283,16867,840,17707,207
2021-08-05,Shasta,089,179085,13572,13217,1816,15033,210
2021-08-05,Sierra,091,2930,78,73,12,85,0
2021-08-05,Siskiyou,093,43540,2148,2024,467,2491,32
2021-08-05,Solano,095,438530,37450,36250,802,37052,262
2021-08-05,Sonoma,097,501317,34520,33455,401,33856,330
2021-08-05,Stanislaus,099,539301,60760,59692,6445,66137,1037
2021-08-05,Sutter,101,95872,10507,10349,108,10457,127
2021-08-05,Tehama,103,63373,5438,5305,632,5937,66
2021-08-05,Trinity,105,12862,528,367,121,488,3
2021-08-05,Tulare,107,460477,52102,50889,9838,60727,854
2021-08-05,Tuolumne,109,53932,4759,4619,47,4666,64
2021-08-05,Ventura,111,848112,86164,84837,3573,88410,1047
2021-08-05,Yolo,113,214977,15726,15250,484,15734,218
2021-08-05,Yuba,115,75493,7034,6872,160,7032,50
2021-08-04,Alameda,001,1643700,100088,97477,2195,99672,1274
2021-08-04,Alpine,003,1148,90,91,0,91,0
2021-08-04,Amador,005,37829,4099,3962,33,3995,48
2021-08-04,Butte,007,227075,13911,13509,2096,15605,205
2021-08-04,Calaveras,009,45235,2461,2374,15,2389,57
2021-08-04,Colusa,011,21464,2093,2025,366,2391,16
2021-08-04,Contra Costa,013,1133247,80314,77966,1548,79514,840
2021-08-04,Del Norte,015,27424,1864,1701,15,1716,8
2021-08-04,El Dorado,017,186661,11797,11319,946,12265,117
2021-08-04,Fresno,019,978130,108208,105899,9224,115123,1747
2021-08-04,Glenn,021,27897,2546,2487,605,3092,20
2021-08-04,Humboldt,023,135768,5622,5271,94,5365,52
2021-08-04,Imperial,025,180216,29572,29375,2729,32104,745
2021-08-04,Inyo,027,18085,1479,1465,13,1478,38
2021-08-04,Kern,029,883053,101604,99868,12306,112174,1358
2021-08-04,Kings,031,150075,24394,23840,1196,25036,250
2021-08-04,Lake,033,64148,4671,4423,20,4443,65
2021-08-04,Lassen,035,31185,5420,5340,125,5465,21
2021-08-04,Los Angeles,037,10098052,1286739,1265788,46225,1312013,24737
2021-08-04,Madera,039,155013,17653,17251,1059,18310,245
2021-08-04,Marin,041,260295,15356,14950,295,15245,239
2021-08-04,Mariposa,043,17540,530,497,11,508,5
2021-08-04,Mendocino,045,87422,4795,4560,106,4666,49
2021-08-04,Merced,047,269075,32581,32274,1124,33398,476
2021-08-04,Modoc,049,8938,428,416,148,564,5
2021-08-04,Mono,051,14174,1324,1307,17,1324,3
2021-08-04,Monterey,053,433212,44313,43926,2027,45953,526
2021-08-04,Napa,055,140530,10761,10544,60,10604,82
2021-08-04,Nevada,057,99092,6103,5702,209,5911,73
2021-08-04,Orange,059,3164182,272042,267199,12322,279521,5146
2021-08-04,Placer,061,380077,26791,25688,2027,27715,305
2021-08-04,Plumas,063,18699,804,784,14,798,5
2021-08-04,Riverside,065,2383286,311180,304272,14632,318904,4562
2021-08-04,Sacramento,067,1510023,121279,117882,2278,120160,1736
2021-08-04,San Benito,069,59416,6351,6300,116,6416,63
2021-08-04,San Bernardino,071,2135413,308803,304164,9452,313616,5285
2021-08-04,San Diego,073,3302833,306464,301100,17656,318756,3805
2021-08-04,San Francisco,075,870044,43522,41913,1657,43570,562
2021-08-04,San Joaquin,077,732212,79426,77846,3976,81822,1466
2021-08-04,San Luis Obispo,079,281455,22851,22245,832,23077,262
2021-08-04,San Mateo,081,765935,46292,45392,640,46032,548
2021-08-04,Santa Barbara,083,443738,36596,36013,1225,37238,470
2021-08-04,Santa Clara,085,1922200,126607,124127,872,124999,2183
2021-08-04,Santa Cruz,087,273765,17221,16820,833,17653,208
2021-08-04,Shasta,089,179085,13521,13134,1805,14939,211
2021-08-04,Sierra,091,2930,78,73,12,85,0
2021-08-04,Siskiyou,093,43540,2128,2010,463,2473,32
2021-08-04,Solano,095,438530,37249,36025,793,36818,262
2021-08-04,Sonoma,097,501317,34348,33311,399,33710,330
2021-08-04,Stanislaus,099,539301,60534,59396,6407,65803,1037
2021-08-04,Sutter,101,95872,10470,10294,108,10402,127
2021-08-04,Tehama,103,63373,5412,5281,626,5907,66
2021-08-04,Trinity,105,12862,526,362,118,480,3
2021-08-04,Tulare,107,460477,51992,50797,9794,60591,855
2021-08-04,Tuolumne,109,53932,4734,4584,47,4631,64
2021-08-04,Ventura,111,848112,85906,84406,3551,87957,1047
2021-08-04,Yolo,113,214977,15646,15189,471,15660,215
2021-08-04,Yuba,115,75493,6994,6827,159,6986,50
2021-08-03,Alameda,001,1643700,99641,97275,2190,99465,1270
2021-08-03,Alpine,003,1148,90,91,0,91,0
2021-08-03,Amador,005,37829,4063,3953,33,3986,48
2021-08-03,Butte,007,227075,13843,13468,2081,15549,205
2021-08-03,Calaveras,009,45235,2439,2356,15,2371,57
2021-08-03,Colusa,011,21464,2080,2023,360,2383,16
2021-08-03,Contra Costa,013,1133247,79832,77739,1541,79280,836
2021-08-03,Del Norte,015,27424,1832,1691,14,1705,8
2021-08-03,El Dorado,017,186661,11704,11255,936,12191,117
2021-08-03,Fresno,019,978130,107846,105732,9193,114925,1746
2021-08-03,Glenn,021,27897,2539,2481,599,3080,20
2021-08-03,Humboldt,023,135768,5557,5199,89,5288,52
2021-08-03,Imperial,025,180216,29550,29333,2722,32055,745
2021-08-03,Inyo,027,18085,1476,1459,13,1472,38
2021-08-03,Kern,029,883053,101342,99708,12227,111935,1358
2021-08-03,Kings,031,150075,24306,23780,1189,24969,249
2021-08-03,Lake,033,64148,4615,4408,16,4424,66
2021-08-03,Lassen,035,31185,5410,5341,125,5466,21
2021-08-03,Los Angeles,037,10098052,1282996,1262678,46047,1308725,24721
2021-08-03,Madera,039,155013,17612,17220,1044,18264,245
2021-08-03,Marin,041,260295,15307,14906,292,15198,243
2021-08-03,Mariposa,043,17540,519,495,11,506,5
2021-08-03,Mendocino,045,87422,4746,4546,105,4651,49
2021-08-03,Merced,047,269075,32498,32197,1122,33319,476
2021-08-03,Modoc,049,8938,428,416,148,564,5
2021-08-03,Mono,051,14174,1319,1303,17,1320,3
2021-08-03,Monterey,053,433212,44250,43872,2014,45886,525
2021-08-03,Napa,055,140530,10718,10527,59,10586,82
2021-08-03,Nevada,057,99092,6022,5685,208,5893,73
2021-08-03,Orange,059,3164182,271303,266649,12292,278941,5146
2021-08-03,Placer,061,380077,26590,25624,2003,27627,305
2021-08-03,Plumas,063,18699,797,779,14,793,5
2021-08-03,Riverside,065,2383286,310256,303499,14605,318104,4562
2021-08-03,Sacramento,067,1510023,120534,117591,2258,119849,1732
2021-08-03,San Benito,069,59416,6336,6284,115,6399,63
2021-08-03,San Bernardino,071,2135413,307882,303386,9434,312820,5265
2021-08-03,San Diego,073,3302833,305025,300189,17546,317735,3803
2021-08-03,San Francisco,075,870044,43240,41758,1637,43395,562
2021-08-03,San Joaquin,077,732212,79076,77615,3955,81570,1461
2021-08-03,San Luis Obispo,079,281455,22711,22166,825,22991,264
2021-08-03,San Mateo,081,765935,46100,45255,635,45890,548
2021-08-03,Santa Barbara,083,443738,36477,35912,1219,37131,469
2021-08-03,Santa Clara,085,1922200,126186,123914,866,124780,2183
2021-08-03,Santa Cruz,087,273765,17155,16778,830,17608,207
2021-08-03,Shasta,089,179085,13446,13091,1794,14885,211
2021-08-03,Sierra,091,2930,78,72,12,84,0
2021-08-03,Siskiyou,093,43540,2117,1998,458,2456,32
2021-08-03,Solano,095,438530,37029,35953,781,36734,261
2021-08-03,Sonoma,097,501317,34167,33243,398,33641,330
2021-08-03,Stanislaus,099,539301,60312,59282,6388,65670,1037
2021-08-03,Sutter,101,95872,10430,10263,107,10370,127
2021-08-03,Tehama,103,63373,5386,5269,621,5890,66
2021-08-03,Trinity,105,12862,523,361,115,476,3
2021-08-03,Tulare,107,460477,51897,50729,9748,60477,854
2021-08-03,Tuolumne,109,53932,4699,4563,47,4610,64
2021-08-03,Ventura,111,848112,85662,84270,3530,87800,1046
2021-08-03,Yolo,113,214977,15554,15149,456,15605,215
2021-08-03,Yuba,115,75493,6957,6781,157,6938,50
2021-08-02,Alameda,001,1643700,99083,96954,2186,99140,1270
2021-08-02,Alpine,003,1148,90,91,0,91,0
2021-08-02,Amador,005,37829,4043,3927,33,3960,48
2021-08-02,Butte,007,227075,13763,13442,2062,15504,205
2021-08-02,Calaveras,009,45235,2414,2347,15,2362,57
2021-08-02,Colusa,011,21464,2068,2019,357,2376,16
2021-08-02,Contra Costa,013,1133247,79323,77516,1527,79043,836
2021-08-02,Del Norte,015,27424,1802,1653,14,1667,8
2021-08-02,El Dorado,017,186661,11601,11226,922,12148,116
2021-08-02,Fresno,019,978130,107500,105471,9156,114627,1744
2021-08-02,Glenn,021,27897,2531,2477,596,3073,20
2021-08-02,Humboldt,023,135768,5474,5161,87,5248,52
2021-08-02,Imperial,025,180216,29517,29302,2719,32021,743
2021-08-02,Inyo,027,18085,1470,1455,13,1468,38
2021-08-02,Kern,029,883053,101087,99556,12136,111692,1357
2021-08-02,Kings,031,150075,24236,23722,1183,24905,249
2021-08-02,Lake,033,64148,4572,4375,16,4391,66
2021-08-02,Lassen,035,31185,5387,5338,123,5461,21
2021-08-02,Los Angeles,037,10098052,1279276,1260807,45841,1306648,24705
2021-08-02,Madera,039,155013,17568,17158,1031,18189,245
2021-08-02,Marin,041,260295,15264,14859,291,15150,239
2021-08-02,Mariposa,043,17540,510,490,11,501,5
2021-08-02,Mendocino,045,87422,4706,4512,102,4614,49
2021-08-02,Merced,047,269075,32400,32163,1115,33278,474
2021-08-02,Modoc,049,8938,428,415,148,563,5
2021-08-02,Mono,051,14174,1312,1296,17,1313,3
2021-08-02,Monterey,053,433212,44190,43842,2006,45848,525
2021-08-02,Napa,055,140530,10675,10490,56,10546,82
2021-08-02,Nevada,057,99092,5951,5611,207,5818,73
2021-08-02,Orange,059,3164182,270389,266050,12247,278297,5146
2021-08-02,Placer,061,380077,26443,25516,1969,27485,306
2021-08-02,Plumas,063,18699,790,762,14,776,5
2021-08-02,Riverside,065,2383286,309318,302756,14590,317346,4562
2021-08-02,Sacramento,067,1510023,119837,117183,2238,119421,1728
2021-08-02,San Benito,069,59416,6317,6276,114,6390,63
2021-08-02,San Bernardino,071,2135413,307006,303000,9401,312401,5253
2021-08-02,San Diego,073,3302833,303545,299021,17466,316487,3798
2021-08-02,San Francisco,075,870044,42954,41553,1614,43167,562
2021-08-02,San Joaquin,077,732212,78733,77447,3930,81377,1461
2021-08-02,San Luis Obispo,079,281455,22617,22093,818,22911,261
2021-08-02,San Mateo,081,765935,45923,45154,623,45777,548
2021-08-02,Santa Barbara,083,443738,36339,35851,1213,37064,469
2021-08-02,Santa Clara,085,1922200,125716,123655,858,124513,2183
2021-08-02,Santa Cruz,087,273765,17097,16746,826,17572,207
2021-08-02,Shasta,089,179085,13384,13049,1780,14829,212
2021-08-02,Sierra,091,2930,78,71,12,83,0
2021-08-02,Siskiyou,093,43540,2106,1992,444,2436,31
2021-08-02,Solano,095,438530,36781,35852,768,36620,260
2021-08-02,Sonoma,097,501317,33941,33132,393,33525,330
2021-08-02,Stanislaus,099,539301,60093,59160,6361,65521,1037
2021-08-02,Sutter,101,95872,10384,10220,107,10327,127
2021-08-02,Tehama,103,63373,5362,5260,617,5877,66
2021-08-02,Trinity,105,12862,518,359,114,473,3
2021-08-02,Tulare,107,460477,51796,50640,9676,60316,854
2021-08-02,Tuolumne,109,53932,4632,4524,47,4571,64
2021-08-02,Ventura,111,848112,85477,84143,3507,87650,1044
2021-08-02,Yolo,113,214977,15456,15072,439,15511,215
2021-08-02,Yuba,115,75493,6915,6743,154,6897,50
2021-08-01,Alameda,001,1643700,98550,96775,2180,98955,1270
2021-08-01,Alpine,003,1148,90,91,0,91,0
2021-08-01,Amador,005,37829,4005,3923,33,3956,48
2021-08-01,Butte,007,227075,13685,13406,2045,15451,205
2021-08-01,Calaveras,009,45235,2390,2341,15,2356,57
2021-08-01,Colusa,011,21464,2057,2014,355,2369,16
2021-08-01,Contra Costa,013,1133247,78888,77360,1520,78880,836
2021-08-01,Del Norte,015,27424,1770,1642,14,1656,8
2021-08-01,El Dorado,017,186661,11501,11189,911,12100,116
2021-08-01,Fresno,019,978130,107174,105339,9111,114450,1744
2021-08-01,Glenn,021,27897,2525,2476,593,3069,20
2021-08-01,Humboldt,023,135768,5397,5118,83,5201,52
2021-08-01,Imperial,025,180216,29482,29297,2715,32012,743
2021-08-01,Inyo,027,18085,1468,1454,13,1467,38
2021-08-01,Kern,029,883053,100809,99396,12061,111457,1357
2021-08-01,Kings,031,150075,24149,23700,1178,24878,249
2021-08-01,Lake,033,64148,4493,4356,16,4372,66
2021-08-01,Lassen,035,31185,5374,5336,121,5457,21
2021-08-01,Los Angeles,037,10098052,1275586,1258461,45616,1304077,24700
2021-08-01,Madera,039,155013,17512,17146,1026,18172,245
2021-08-01,Marin,041,260295,15187,14844,290,15134,239
2021-08-01,Mariposa,043,17540,503,482,11,493,5
2021-08-01,Mendocino,045,87422,4660,4476,98,4574,49
2021-08-01,Merced,047,269075,32309,32144,1109,33253,474
2021-08-01,Modoc,049,8938,426,413,148,561,5
2021-08-01,Mono,051,14174,1309,1294,17,1311,3
2021-08-01,Monterey,053,433212,44143,43808,1993,45801,525
2021-08-01,Napa,055,140530,10627,10473,54,10527,82
2021-08-01,Nevada,057,99092,5864,5561,206,5767,73
2021-08-01,Orange,059,3164182,269575,265467,12204,277671,5146
2021-08-01,Placer,061,380077,26228,25464,1939,27403,306
2021-08-01,Plumas,063,18699,784,761,14,775,5
2021-08-01,Riverside,065,2383286,308385,302256,14572,316828,4562
2021-08-01,Sacramento,067,1510023,119102,116923,2224,119147,1727
2021-08-01,San Benito,069,59416,6300,6271,114,6385,63
2021-08-01,San Bernardino,071,2135413,306072,302542,9390,311932,5248
2021-08-01,San Diego,073,3302833,302359,298002,17401,315403,3798
2021-08-01,San Francisco,075,870044,42617,41432,1601,43033,562
2021-08-01,San Joaquin,077,732212,78366,77338,3905,81243,1461
2021-08-01,San Luis Obispo,079,281455,22515,22083,813,22896,261
2021-08-01,San Mateo,081,765935,45741,45036,616,45652,548
2021-08-01,Santa Barbara,083,443738,36215,35809,1209,37018,469
2021-08-01,Santa Clara,085,1922200,125304,123511,850,124361,2183
2021-08-01,Santa Cruz,087,273765,17018,16709,819,17528,207
2021-08-01,Shasta,089,179085,13313,13036,1771,14807,212
2021-08-01,Sierra,091,2930,76,71,12,83,0
2021-08-01,Siskiyou,093,43540,2100,1989,438,2427,31
2021-08-01,Solano,095,438530,36546,35800,759,36559,260
2021-08-01,Sonoma,097,501317,33749,33076,390,33466,330
2021-08-01,Stanislaus,099,539301,59856,59078,6329,65407,1037
2021-08-01,Sutter,101,95872,10329,10198,104,10302,127
2021-08-01,Tehama,103,63373,5345,5252,613,5865,66
2021-08-01,Trinity,105,12862,515,359,113,472,3
2021-08-01,Tulare,107,460477,51639,50600,9615,60215,854
2021-08-01,Tuolumne,109,53932,4594,4489,47,4536,64
2021-08-01,Ventura,111,848112,85247,84040,3492,87532,1044
2021-08-01,Yolo,113,214977,15384,15042,429,15471,215
2021-08-01,Yuba,115,75493,6878,6721,153,6874,50
2021-07-31,Alameda,001,1643700,98218,95279,2175,97454,1265
2021-07-31,Alpine,003,1148,90,89,0,89,0
2021-07-31,Amador,005,37829,3985,3877,33,3910,48
2021-07-31,Butte,007,227075,13651,13235,2025,15260,205
2021-07-31,Calaveras,009,45235,2381,2294,15,2309,57
2021-07-31,Colusa,011,21464,2051,2006,353,2359,16
2021-07-31,Contra Costa,013,1133247,78609,75866,1518,77384,832
2021-07-31,Del Norte,015,27424,1744,1576,14,1590,8
2021-07-31,El Dorado,017,186661,11448,11017,905,11922,116
2021-07-31,Fresno,019,978130,107015,104639,9098,113737,1744
2021-07-31,Glenn,021,27897,2520,2465,588,3053,20
2021-07-31,Humboldt,023,135768,5342,4978,82,5060,52
2021-07-31,Imperial,025,180216,29465,29164,2712,31876,743
2021-07-31,Inyo,027,18085,1465,1442,13,1455,38
2021-07-31,Kern,029,883053,100644,98903,12002,110905,1357
2021-07-31,Kings,031,150075,24096,23548,1173,24721,248
2021-07-31,Lake,033,64148,4468,4238,16,4254,66
2021-07-31,Lassen,035,31185,5367,5320,121,5441,21
2021-07-31,Los Angeles,037,10098052,1273384,1248545,45474,1294019,24691
2021-07-31,Madera,039,155013,17479,17058,1020,18078,245
2021-07-31,Marin,041,260295,15143,14701,289,14990,239
2021-07-31,Mariposa,043,17540,494,470,11,481,5
2021-07-31,Mendocino,045,87422,4635,4400,95,4495,49
2021-07-31,Merced,047,269075,32261,31959,1104,33063,474
2021-07-31,Modoc,049,8938,426,413,148,561,5
2021-07-31,Mono,051,14174,1307,1287,17,1304,3
2021-07-31,Monterey,053,433212,44103,43720,1983,45703,525
2021-07-31,Napa,055,140530,10607,10401,53,10454,82
2021-07-31,Nevada,057,99092,5825,5373,205,5578,72
2021-07-31,Orange,059,3164182,269001,263446,12186,275632,5144
2021-07-31,Placer,061,380077,26095,25104,1932,27036,306
2021-07-31,Plumas,063,18699,781,743,14,757,5
2021-07-31,Riverside,065,2383286,307769,300315,14562,314877,4554
2021-07-31,Sacramento,067,1510023,118690,115259,2218,117477,1720
2021-07-31,San Benito,069,59416,6289,6251,114,6365,63
2021-07-31,San Bernardino,071,2135413,305498,300726,9387,310113,5240
2021-07-31,San Diego,073,3302833,301686,295054,17355,312409,3798
2021-07-31,San Francisco,075,870044,42389,40412,1581,41993,562
2021-07-31,San Joaquin,077,732212,78201,76575,3892,80467,1443
2021-07-31,San Luis Obispo,079,281455,22461,21922,811,22733,260
2021-07-31,San Mateo,081,765935,45584,44622,611,45233,548
2021-07-31,Santa Barbara,083,443738,36134,35531,1208,36739,467
2021-07-31,Santa Clara,085,1922200,125049,122614,848,123462,2099
2021-07-31,Santa Cruz,087,273765,16979,16576,818,17394,207
2021-07-31,Shasta,089,179085,13276,12918,1763,14681,212
2021-07-31,Sierra,091,2930,76,68,12,80,0
2021-07-31,Siskiyou,093,43540,2091,1976,432,2408,31
2021-07-31,Solano,095,438530,36445,35340,752,36092,263
2021-07-31,Sonoma,097,501317,33623,32601,390,32991,329
2021-07-31,Stanislaus,099,539301,59697,58586,6307,64893,1035
2021-07-31,Sutter,101,95872,10295,10068,103,10171,127
2021-07-31,Tehama,103,63373,5330,5216,610,5826,66
2021-07-31,Trinity,105,12862,514,354,112,466,3
2021-07-31,Tulare,107,460477,51549,50409,9562,59971,854
2021-07-31,Tuolumne,109,53932,4555,4362,47,4409,64
2021-07-31,Ventura,111,848112,85086,83509,3476,86985,1044
2021-07-31,Yolo,113,214977,15336,14863,418,15281,215
2021-07-31,Yuba,115,75493,6855,6615,149,6764,50
2021-07-30,Alameda,001,1643700,97887,95279,2171,97450,1265
2021-07-30,Alpine,003,1148,90,89,0,89,0
2021-07-30,Amador,005,37829,3962,3877,33,3910,48
2021-07-30,Butte,007,227075,13596,13235,2012,15247,205
2021-07-30,Calaveras,009,45235,2371,2294,15,2309,57
2021-07-30,Colusa,011,21464,2047,2006,351,2357,16
2021-07-30,Contra Costa,013,1133247,78363,75866,1514,77380,832
2021-07-30,Del Norte,015,27424,1726,1576,14,1590,8
2021-07-30,El Dorado,017,186661,11414,11017,899,11916,116
2021-07-30,Fresno,019,978130,106821,104639,9086,113725,1744
2021-07-30,Glenn,021,27897,2515,2465,587,3052,20
2021-07-30,Humboldt,023,135768,5279,4978,79,5057,52
2021-07-30,Imperial,025,180216,29451,29164,2709,31873,743
2021-07-30,Inyo,027,18085,1464,1442,13,1455,38
2021-07-30,Kern,029,883053,100520,98903,11955,110858,1357
2021-07-30,Kings,031,150075,24056,23548,1169,24717,248
2021-07-30,Lake,033,64148,4440,4238,16,4254,66
2021-07-30,Lassen,035,31185,5363,5320,121,5441,21
2021-07-30,Los Angeles,037,10098052,1271054,1248545,45324,1293869,24691
2021-07-30,Madera,039,155013,17437,17058,1017,18075,245
2021-07-30,Marin,041,260295,15109,14701,289,14990,239
2021-07-30,Mariposa,043,17540,490,470,11,481,5
2021-07-30,Mendocino,045,87422,4605,4400,94,4494,49
2021-07-30,Merced,047,269075,32220,31959,1100,33059,474
2021-07-30,Modoc,049,8938,424,413,148,561,5
2021-07-30,Mono,051,14174,1302,1287,17,1304,3
2021-07-30,Monterey,053,433212,44069,43720,1974,45694,525
2021-07-30,Napa,055,140530,10585,10401,52,10453,82
2021-07-30,Nevada,057,99092,5768,5373,205,5578,72
2021-07-30,Orange,059,3164182,268376,263446,12160,275606,5144
2021-07-30,Placer,061,380077,26006,25104,1914,27018,306
2021-07-30,Plumas,063,18699,776,743,14,757,5
2021-07-30,Riverside,065,2383286,307132,300315,14552,314867,4554
2021-07-30,Sacramento,067,1510023,118238,115259,2214,117473,1720
2021-07-30,San Benito,069,59416,6282,6251,114,6365,63
2021-07-30,San Bernardino,071,2135413,304985,300726,9380,310106,5240
2021-07-30,San Diego,073,3302833,300912,295054,17297,312351,3798
2021-07-30,San Francisco,075,870044,42176,40412,1567,41979,562
2021-07-30,San Joaquin,077,732212,78047,76575,3887,80462,1443
2021-07-30,San Luis Obispo,079,281455,22423,21922,807,22729,260
2021-07-30,San Mateo,081,765935,45459,44622,598,45220,548
2021-07-30,Santa Barbara,083,443738,36065,35531,1202,36733,467
2021-07-30,Santa Clara,085,1922200,124826,122614,846,123460,2099
2021-07-30,Santa Cruz,087,273765,16953,16576,816,17392,207
2021-07-30,Shasta,089,179085,13231,12918,1763,14681,212
2021-07-30,Sierra,091,2930,75,68,12,80,0
2021-07-30,Siskiyou,093,43540,2082,1976,431,2407,31
2021-07-30,Solano,095,438530,36354,35340,736,36076,263
2021-07-30,Sonoma,097,501317,33528,32601,390,32991,329
2021-07-30,Stanislaus,099,539301,59553,58586,6287,64873,1035
2021-07-30,Sutter,101,95872,10260,10068,103,10171,127
2021-07-30,Tehama,103,63373,5319,5216,610,5826,66
2021-07-30,Trinity,105,12862,514,354,112,466,3
2021-07-30,Tulare,107,460477,51506,50409,9527,59936,854
2021-07-30,Tuolumne,109,53932,4537,4362,47,4409,64
2021-07-30,Ventura,111,848112,84922,83509,3461,86970,1044
2021-07-30,Yolo,113,214977,15275,14863,414,15277,215
2021-07-30,Yuba,115,75493,6819,6615,148,6763,50
2021-07-29,Alameda,001,1643700,97470,95279,2165,97444,1265
2021-07-29,Alpine,003,1148,90,89,0,89,0
2021-07-29,Amador,005,37829,3943,3877,33,3910,48
2021-07-29,Butte,007,227075,13547,13235,2004,15239,205
2021-07-29,Calaveras,009,45235,2356,2294,15,2309,57
2021-07-29,Colusa,011,21464,2040,2006,351,2357,16
2021-07-29,Contra Costa,013,1133247,77923,75866,1512,77378,832
2021-07-29,Del Norte,015,27424,1702,1576,14,1590,8
2021-07-29,El Dorado,017,186661,11350,11017,887,11904,116
2021-07-29,Fresno,019,978130,106557,104639,9060,113699,1744
2021-07-29,Glenn,021,27897,2505,2465,586,3051,20
2021-07-29,Humboldt,023,135768,5219,4978,77,5055,52
2021-07-29,Imperial,025,180216,29406,29164,2707,31871,743
2021-07-29,Inyo,027,18085,1460,1442,13,1455,38
2021-07-29,Kern,029,883053,100313,98903,11878,110781,1357
2021-07-29,Kings,031,150075,24010,23548,1165,24713,248
2021-07-29,Lake,033,64148,4405,4238,16,4254,66
2021-07-29,Lassen,035,31185,5355,5320,118,5438,21
2021-07-29,Los Angeles,037,10098052,1267958,1248545,45142,1293687,24691
2021-07-29,Madera,039,155013,17390,17058,1013,18071,245
2021-07-29,Marin,041,260295,15066,14701,289,14990,239
2021-07-29,Mariposa,043,17540,486,470,11,481,5
2021-07-29,Mendocino,045,87422,4582,4400,92,4492,49
2021-07-29,Merced,047,269075,32165,31959,1100,33059,474
2021-07-29,Modoc,049,8938,424,413,148,561,5
2021-07-29,Mono,051,14174,1300,1287,17,1304,3
2021-07-29,Monterey,053,433212,44020,43720,1964,45684,525
2021-07-29,Napa,055,140530,10553,10401,50,10451,82
2021-07-29,Nevada,057,99092,5716,5373,204,5577,72
2021-07-29,Orange,059,3164182,267664,263446,12128,275574,5144
2021-07-29,Placer,061,380077,25883,25104,1899,27003,306
2021-07-29,Plumas,063,18699,768,743,14,757,5
2021-07-29,Riverside,065,2383286,306427,300315,14528,314843,4554
2021-07-29,Sacramento,067,1510023,117683,115259,2201,117460,1720
2021-07-29,San Benito,069,59416,6271,6251,114,6365,63
2021-07-29,San Bernardino,071,2135413,304348,300726,9371,310097,5240
2021-07-29,San Diego,073,3302833,299855,295054,17229,312283,3798
2021-07-29,San Francisco,075,870044,41928,40412,1546,41958,562
2021-07-29,San Joaquin,077,732212,77792,76575,3879,80454,1443
2021-07-29,San Luis Obispo,079,281455,22368,21922,805,22727,260
2021-07-29,San Mateo,081,765935,45332,44622,588,45210,548
2021-07-29,Santa Barbara,083,443738,35979,35531,1201,36732,467
2021-07-29,Santa Clara,085,1922200,124529,122614,843,123457,2099
2021-07-29,Santa Cruz,087,273765,16900,16576,814,17390,207
2021-07-29,Shasta,089,179085,13177,12918,1754,14672,212
2021-07-29,Sierra,091,2930,75,68,12,80,0
2021-07-29,Siskiyou,093,43540,2077,1976,429,2405,31
2021-07-29,Solano,095,438530,36194,35340,726,36066,263
2021-07-29,Sonoma,097,501317,33354,32601,388,32989,329
2021-07-29,Stanislaus,099,539301,59381,58586,6272,64858,1035
2021-07-29,Sutter,101,95872,10214,10068,102,10170,127
2021-07-29,Tehama,103,63373,5307,5216,604,5820,66
2021-07-29,Trinity,105,12862,512,354,111,465,3
2021-07-29,Tulare,107,460477,51416,50409,9487,59896,854
2021-07-29,Tuolumne,109,53932,4497,4362,46,4408,64
2021-07-29,Ventura,111,848112,84756,83509,3454,86963,1044
2021-07-29,Yolo,113,214977,15207,14863,400,15263,215
2021-07-29,Yuba,115,75493,6770,6615,145,6760,50
2021-07-28,Alameda,001,1643700,97010,94965,2158,97123,1262
2021-07-28,Alpine,003,1148,90,89,0,89,0
2021-07-28,Amador,005,37829,3929,3870,33,3903,48
2021-07-28,Butte,007,227075,13490,13184,1991,15175,205
2021-07-28,Calaveras,009,45235,2335,2289,15,2304,57
2021-07-28,Colusa,011,21464,2037,2001,350,2351,16
2021-07-28,Contra Costa,013,1133247,77434,75487,1504,76991,832
2021-07-28,Del Norte,015,27424,1669,1545,14,1559,8
2021-07-28,El Dorado,017,186661,11300,10967,878,11845,116
2021-07-28,Fresno,019,978130,106308,104458,9040,113498,1744
2021-07-28,Glenn,021,27897,2502,2464,583,3047,20
2021-07-28,Humboldt,023,135768,5168,4946,76,5022,52
2021-07-28,Imperial,025,180216,29359,29096,2707,31803,743
2021-07-28,Inyo,027,18085,1454,1439,12,1451,38
2021-07-28,Kern,029,883053,100157,98781,11832,110613,1352
2021-07-28,Kings,031,150075,23946,23503,1155,24658,248
2021-07-28,Lake,033,64148,4359,4191,15,4206,65
2021-07-28,Lassen,035,31185,5347,5318,118,5436,21
2021-07-28,Los Angeles,037,10098052,1264783,1245485,44956,1290441,24673
2021-07-28,Madera,039,155013,17349,17024,1007,18031,245
2021-07-28,Marin,041,260295,15011,14652,289,14941,239
2021-07-28,Mariposa,043,17540,479,469,11,480,5
2021-07-28,Mendocino,045,87422,4554,4377,92,4469,49
2021-07-28,Merced,047,269075,32109,31886,1096,32982,474
2021-07-28,Modoc,049,8938,422,413,148,561,5
2021-07-28,Mono,051,14174,1299,1286,17,1303,3
2021-07-28,Monterey,053,433212,43973,43668,1955,45623,524
2021-07-28,Napa,055,140530,10513,10376,48,10424,82
2021-07-28,Nevada,057,99092,5662,5320,204,5524,72
2021-07-28,Orange,059,3164182,266872,262735,12099,274834,5143
2021-07-28,Placer,061,380077,25736,24978,1884,26862,306
2021-07-28,Plumas,063,18699,763,754,14,768,5
2021-07-28,Riverside,065,2383286,305660,299611,14509,314120,4554
2021-07-28,Sacramento,067,1510023,117031,114665,2182,116847,1714
2021-07-28,San Benito,069,59416,6260,6236,114,6350,63
2021-07-28,San Bernardino,071,2135413,303727,300121,9359,309480,5236
2021-07-28,San Diego,073,3302833,298581,294176,17156,311332,3798
2021-07-28,San Francisco,075,870044,41624,40144,1520,41664,561
2021-07-28,San Joaquin,077,732212,77541,76312,3849,80161,1443
2021-07-28,San Luis Obispo,079,281455,22309,21865,804,22669,260
2021-07-28,San Mateo,081,765935,45182,44477,579,45056,547
2021-07-28,Santa Barbara,083,443738,35904,35431,1196,36627,467
2021-07-28,Santa Clara,085,1922200,124267,122345,841,123186,2099
2021-07-28,Santa Cruz,087,273765,16862,16551,813,17364,207
2021-07-28,Shasta,089,179085,13132,12882,1744,14626,212
2021-07-28,Sierra,091,2930,71,67,12,79,0
2021-07-28,Siskiyou,093,43540,2068,1971,426,2397,31
2021-07-28,Solano,095,438530,36020,35204,719,35923,262
2021-07-28,Sonoma,097,501317,33211,32434,385,32819,328
2021-07-28,Stanislaus,099,539301,59184,58427,6256,64683,1035
2021-07-28,Sutter,101,95872,10182,10033,101,10134,126
2021-07-28,Tehama,103,63373,5295,5209,601,5810,66
2021-07-28,Trinity,105,12862,511,352,111,463,3
2021-07-28,Tulare,107,460477,51328,50363,9440,59803,854
2021-07-28,Tuolumne,109,53932,4458,4313,46,4359,64
2021-07-28,Ventura,111,848112,84560,83360,3438,86798,1043
2021-07-28,Yolo,113,214977,15135,14801,391,15192,215
2021-07-28,Yuba,115,75493,6737,6591,144,6735,51
2021-07-27,Alameda,001,1643700,96606,94682,2150,96832,1256
2021-07-27,Alpine,003,1148,90,89,0,89,0
2021-07-27,Amador,005,37829,3913,3861,33,3894,48
2021-07-27,Butte,007,227075,13442,13127,1980,15107,205
2021-07-27,Calaveras,009,45235,2324,2280,15,2295,57
2021-07-27,Colusa,011,21464,2028,1999,349,2348,16
2021-07-27,Contra Costa,013,1133247,76949,75227,1500,76727,830
2021-07-27,Del Norte,015,27424,1649,1538,14,1552,8
2021-07-27,El Dorado,017,186661,11240,10941,868,11809,116
2021-07-27,Fresno,019,978130,106015,104288,9017,113305,1746
2021-07-27,Glenn,021,27897,2494,2460,581,3041,20
2021-07-27,Humboldt,023,135768,5114,4925,75,5000,52
2021-07-27,Imperial,025,180216,29314,29048,2706,31754,743
2021-07-27,Inyo,027,18085,1452,1430,12,1442,38
2021-07-27,Kern,029,883053,99987,98724,11777,110501,1352
2021-07-27,Kings,031,150075,23889,23463,1145,24608,248
2021-07-27,Lake,033,64148,4320,4157,15,4172,65
2021-07-27,Lassen,035,31185,5341,5315,118,5433,21
2021-07-27,Los Angeles,037,10098052,1261318,1243336,44749,1288085,24658
2021-07-27,Madera,039,155013,17296,16998,1001,17999,245
2021-07-27,Marin,041,260295,14963,14631,286,14917,239
2021-07-27,Mariposa,043,17540,476,468,11,479,5
2021-07-27,Mendocino,045,87422,4531,4371,92,4463,49
2021-07-27,Merced,047,269075,32042,31825,1093,32918,473
2021-07-27,Modoc,049,8938,421,413,148,561,5
2021-07-27,Mono,051,14174,1295,1288,17,1305,3
2021-07-27,Monterey,053,433212,43933,43646,1944,45590,523
2021-07-27,Napa,055,140530,10483,10354,48,10402,82
2021-07-27,Nevada,057,99092,5585,5305,202,5507,72
2021-07-27,Orange,059,3164182,266129,262193,12073,274266,5143
2021-07-27,Placer,061,380077,25577,24916,1858,26774,306
2021-07-27,Plumas,063,18699,760,752,14,766,5
2021-07-27,Riverside,065,2383286,304931,299160,14490,313650,4554
2021-07-27,Sacramento,067,1510023,116428,114413,2173,116586,1710
2021-07-27,San Benito,069,59416,6251,6229,114,6343,63
2021-07-27,San Bernardino,071,2135413,303042,299593,9337,308930,5236
2021-07-27,San Diego,073,3302833,297492,293408,17077,310485,3798
2021-07-27,San Francisco,075,870044,41268,39939,1502,41441,561
2021-07-27,San Joaquin,077,732212,77278,76166,3830,79996,1442
2021-07-27,San Luis Obispo,079,281455,22254,21803,795,22598,260
2021-07-27,San Mateo,081,765935,45031,44378,576,44954,547
2021-07-27,Santa Barbara,083,443738,35809,35355,1194,36549,467
2021-07-27,Santa Clara,085,1922200,123973,122154,839,122993,2099
2021-07-27,Santa Cruz,087,273765,16816,16523,812,17335,207
2021-07-27,Shasta,089,179085,13082,12846,1731,14577,212
2021-07-27,Sierra,091,2930,71,65,12,77,0
2021-07-27,Siskiyou,093,43540,2063,1964,423,2387,31
2021-07-27,Solano,095,438530,35888,35093,709,35802,261
2021-07-27,Sonoma,097,501317,33067,32367,383,32750,328
2021-07-27,Stanislaus,099,539301,59016,58333,6228,64561,1033
2021-07-27,Sutter,101,95872,10141,9998,101,10099,115
2021-07-27,Tehama,103,63373,5274,5192,599,5791,66
2021-07-27,Trinity,105,12862,510,351,111,462,3
2021-07-27,Tulare,107,460477,51262,50324,9409,59733,854
2021-07-27,Tuolumne,109,53932,4406,4282,46,4328,64
2021-07-27,Ventura,111,848112,84352,83189,3426,86615,1043
2021-07-27,Yolo,113,214977,15061,14759,385,15144,215
2021-07-27,Yuba,115,75493,6715,6564,142,6706,51
2021-07-26,Alameda,001,1643700,96161,94436,2146,96582,1259
2021-07-26,Alpine,003,1148,90,89,0,89,0
2021-07-26,Amador,005,37829,3903,3854,33,3887,48
2021-07-26,Butte,007,227075,13387,13082,1969,15051,203
2021-07-26,Calaveras,009,45235,2318,2276,15,2291,57
2021-07-26,Colusa,011,21464,2021,1996,347,2343,16
2021-07-26,Contra Costa,013,1133247,76452,74854,1493,76347,830
2021-07-26,Del Norte,015,27424,1628,1530,14,1544,8
2021-07-26,El Dorado,017,186661,11176,10899,865,11764,116
2021-07-26,Fresno,019,978130,105811,104143,8994,113137,1742
2021-07-26,Glenn,021,27897,2492,2461,580,3041,20
2021-07-26,Humboldt,023,135768,5075,4906,73,4979,52
2021-07-26,Imperial,025,180216,29274,29034,2706,31740,743
2021-07-26,Inyo,027,18085,1447,1429,12,1441,38
2021-07-26,Kern,029,883053,99821,98633,11712,110345,1351
2021-07-26,Kings,031,150075,23840,23426,1141,24567,247
2021-07-26,Lake,033,64148,4299,4133,15,4148,65
2021-07-26,Lassen,035,31185,5337,5314,118,5432,21
2021-07-26,Los Angeles,037,10098052,1257971,1241527,44577,1286104,24647
2021-07-26,Madera,039,155013,17268,16971,994,17965,245
2021-07-26,Marin,041,260295,14906,14579,285,14864,239
2021-07-26,Mariposa,043,17540,475,467,11,478,5
2021-07-26,Mendocino,045,87422,4510,4354,92,4446,49
2021-07-26,Merced,047,269075,31951,31774,1089,32863,473
2021-07-26,Modoc,049,8938,421,413,148,561,5
2021-07-26,Mono,051,14174,1294,1286,17,1303,3
2021-07-26,Monterey,053,433212,43890,43595,1932,45527,521
2021-07-26,Napa,055,140530,10460,10332,48,10380,82
2021-07-26,Nevada,057,99092,5499,5280,202,5482,72
2021-07-26,Orange,059,3164182,265490,261803,12053,273856,5142
2021-07-26,Placer,061,380077,25441,24842,1837,26679,304
2021-07-26,Plumas,063,18699,756,750,14,764,5
2021-07-26,Riverside,065,2383286,304239,298626,14476,313102,4553
2021-07-26,Sacramento,067,1510023,115829,113986,2157,116143,1705
2021-07-26,San Benito,069,59416,6245,6222,114,6336,63
2021-07-26,San Bernardino,071,2135413,302428,299238,9324,308562,5237
2021-07-26,San Diego,073,3302833,296384,292688,16995,309683,3793
2021-07-26,San Francisco,075,870044,40907,39800,1476,41276,561
2021-07-26,San Joaquin,077,732212,77043,76033,3826,79859,1440
2021-07-26,San Luis Obispo,079,281455,22205,21752,792,22544,260
2021-07-26,San Mateo,081,765935,44883,44297,568,44865,547
2021-07-26,Santa Barbara,083,443738,35736,35311,1182,36493,467
2021-07-26,Santa Clara,085,1922200,123664,121978,830,122808,2099
2021-07-26,Santa Cruz,087,273765,16776,16493,809,17302,207
2021-07-26,Shasta,089,179085,13033,12819,1720,14539,211
2021-07-26,Sierra,091,2930,70,65,12,77,0
2021-07-26,Siskiyou,093,43540,2060,1962,421,2383,31
2021-07-26,Solano,095,438530,35733,34990,702,35692,259
2021-07-26,Sonoma,097,501317,32931,32283,381,32664,328
2021-07-26,Stanislaus,099,539301,58871,58219,6209,64428,1033
2021-07-26,Sutter,101,95872,10101,9963,98,10061,115
2021-07-26,Tehama,103,63373,5264,5183,595,5778,66
2021-07-26,Trinity,105,12862,510,351,110,461,3
2021-07-26,Tulare,107,460477,51196,50265,9380,59645,854
2021-07-26,Tuolumne,109,53932,4376,4271,46,4317,64
2021-07-26,Ventura,111,848112,84179,83072,3411,86483,1041
2021-07-26,Yolo,113,214977,15000,14727,373,15100,215
2021-07-26,Yuba,115,75493,6681,6538,140,6678,51
2021-07-25,Alameda,001,1643700,95669,94146,2140,96286,1259
2021-07-25,Alpine,003,1148,88,89,0,89,0
2021-07-25,Amador,005,37829,3888,3848,33,3881,48
2021-07-25,Butte,007,227075,13348,13074,1959,15033,203
2021-07-25,Calaveras,009,45235,2308,2275,15,2290,57
2021-07-25,Colusa,011,21464,2012,1996,343,2339,16
2021-07-25,Contra Costa,013,1133247,75967,74634,1479,76113,830
2021-07-25,Del Norte,015,27424,1607,1526,14,1540,8
2021-07-25,El Dorado,017,186661,11119,10878,861,11739,116
2021-07-25,Fresno,019,978130,105570,104019,8978,112997,1742
2021-07-25,Glenn,021,27897,2483,2461,578,3039,20
2021-07-25,Humboldt,023,135768,5016,4892,72,4964,52
2021-07-25,Imperial,025,180216,29238,29037,2706,31743,743
2021-07-25,Inyo,027,18085,1442,1427,12,1439,38
2021-07-25,Kern,029,883053,99649,98503,11641,110144,1351
2021-07-25,Kings,031,150075,23786,23396,1137,24533,247
2021-07-25,Lake,033,64148,4246,4109,14,4123,65
2021-07-25,Lassen,035,31185,5332,5314,118,5432,21
2021-07-25,Los Angeles,037,10098052,1254551,1239596,44383,1283979,24643
2021-07-25,Madera,039,155013,17231,16947,987,17934,245
2021-07-25,Marin,041,260295,14856,14558,282,14840,239
2021-07-25,Mariposa,043,17540,472,465,11,476,5
2021-07-25,Mendocino,045,87422,4481,4335,90,4425,49
2021-07-25,Merced,047,269075,31878,31760,1087,32847,473
2021-07-25,Modoc,049,8938,421,413,148,561,5
2021-07-25,Mono,051,14174,1291,1286,17,1303,3
2021-07-25,Monterey,053,433212,43852,43590,1924,45514,521
2021-07-25,Napa,055,140530,10424,10316,47,10363,82
2021-07-25,Nevada,057,99092,5434,5256,199,5455,72
2021-07-25,Orange,059,3164182,264782,261351,12030,273381,5142
2021-07-25,Placer,061,380077,25319,24755,1816,26571,304
2021-07-25,Plumas,063,18699,754,750,14,764,5
2021-07-25,Riverside,065,2383286,303475,298181,14459,312640,4553
2021-07-25,Sacramento,067,1510023,115279,113611,2142,115753,1704
2021-07-25,San Benito,069,59416,6238,6217,114,6331,63
2021-07-25,San Bernardino,071,2135413,301767,298982,9317,308299,5237
2021-07-25,San Diego,073,3302833,295322,290626,16921,307547,3793
2021-07-25,San Francisco,075,870044,40557,39663,1451,41114,561
2021-07-25,San Joaquin,077,732212,76787,75926,3807,79733,1440
2021-07-25,San Luis Obispo,079,281455,22132,21741,789,22530,260
2021-07-25,San Mateo,081,765935,44721,44189,562,44751,547
2021-07-25,Santa Barbara,083,443738,35656,35261,1179,36440,467
2021-07-25,Santa Clara,085,1922200,123334,121800,825,122625,2099
2021-07-25,Santa Cruz,087,273765,16729,16474,808,17282,207
2021-07-25,Shasta,089,179085,12986,12815,1715,14530,211
2021-07-25,Sierra,091,2930,70,65,12,77,0
2021-07-25,Siskiyou,093,43540,2052,1963,418,2381,31
2021-07-25,Solano,095,438530,35541,34863,699,35562,259
2021-07-25,Sonoma,097,501317,32806,32202,378,32580,328
2021-07-25,Stanislaus,099,539301,58705,58154,6204,64358,1033
2021-07-25,Sutter,101,95872,10048,9937,96,10033,115
2021-07-25,Tehama,103,63373,5248,5181,594,5775,66
2021-07-25,Trinity,105,12862,508,351,108,459,3
2021-07-25,Tulare,107,460477,51121,50221,9342,59563,854
2021-07-25,Tuolumne,109,53932,4325,4267,46,4313,64
2021-07-25,Ventura,111,848112,83965,82986,3388,86374,1041
2021-07-25,Yolo,113,214977,14939,14693,359,15052,215
2021-07-25,Yuba,115,75493,6648,6519,140,6659,51
2021-07-24,Alameda,001,1643700,95388,93170,2136,95306,1259
2021-07-24,Alpine,003,1148,88,89,0,89,0
2021-07-24,Amador,005,37829,3879,3816,33,3849,48
2021-07-24,Butte,007,227075,13319,12982,1957,14939,203
2021-07-24,Calaveras,009,45235,2303,2267,15,2282,57
2021-07-24,Colusa,011,21464,2011,1992,341,2333,16
2021-07-24,Contra Costa,013,1133247,75739,73682,1476,75158,830
2021-07-24,Del Norte,015,27424,1596,1497,14,1511,8
2021-07-24,El Dorado,017,186661,11085,10773,858,11631,116
2021-07-24,Fresno,019,978130,105452,103637,8968,112605,1736
2021-07-24,Glenn,021,27897,2481,2457,578,3035,20
2021-07-24,Humboldt,023,135768,4981,4780,71,4851,52
2021-07-24,Imperial,025,180216,29218,28996,2706,31702,742
2021-07-24,Inyo,027,18085,1439,1424,12,1436,38
2021-07-24,Kern,029,883053,99571,98261,11619,109880,1350
2021-07-24,Kings,031,150075,23755,23304,1134,24438,246
2021-07-24,Lake,033,64148,4223,3963,14,3977,64
2021-07-24,Lassen,035,31185,5331,5311,118,5429,21
2021-07-24,Los Angeles,037,10098052,1252775,1232164,44254,1276418,24623
2021-07-24,Madera,039,155013,17207,16885,985,17870,245
2021-07-24,Marin,041,260295,14817,14454,282,14736,238
2021-07-24,Mariposa,043,17540,472,453,11,464,5
2021-07-24,Mendocino,045,87422,4456,4293,90,4383,49
2021-07-24,Merced,047,269075,31856,31661,1086,32747,473
2021-07-24,Modoc,049,8938,421,413,148,561,5
2021-07-24,Mono,051,14174,1289,1284,17,1301,3
2021-07-24,Monterey,053,433212,43827,43525,1917,45442,521
2021-07-24,Napa,055,140530,10408,10230,47,10277,81
2021-07-24,Nevada,057,99092,5402,5183,199,5382,72
2021-07-24,Orange,059,3164182,264317,259973,12018,271991,5141
2021-07-24,Placer,061,380077,25236,24530,1811,26341,303
2021-07-24,Plumas,063,18699,753,737,14,751,4
2021-07-24,Riverside,065,2383286,303007,296912,14449,311361,4552
2021-07-24,Sacramento,067,1510023,114965,112438,2138,114576,1698
2021-07-24,San Benito,069,59416,6234,6200,113,6313,63
2021-07-24,San Bernardino,071,2135413,301375,297899,9308,307207,5236
2021-07-24,San Diego,073,3302833,294856,289368,16893,306261,3788
2021-07-24,San Francisco,075,870044,40383,38954,1435,40389,561
2021-07-24,San Joaquin,077,732212,76659,75461,3796,79257,1436
2021-07-24,San Luis Obispo,079,281455,22101,21616,787,22403,260
2021-07-24,San Mateo,081,765935,44604,43880,556,44436,542
2021-07-24,Santa Barbara,083,443738,35597,35071,1175,36246,465
2021-07-24,Santa Clara,085,1922200,123122,121092,824,121916,2099
2021-07-24,Santa Cruz,087,273765,16706,16416,808,17224,207
2021-07-24,Shasta,089,179085,12958,12759,1712,14471,211
2021-07-24,Sierra,091,2930,69,64,12,76,0
2021-07-24,Siskiyou,093,43540,2052,1951,418,2369,31
2021-07-24,Solano,095,438530,35449,34499,690,35189,259
2021-07-24,Sonoma,097,501317,32681,31928,376,32304,327
2021-07-24,Stanislaus,099,539301,58613,57879,6194,64073,1030
2021-07-24,Sutter,101,95872,10021,9890,96,9986,115
2021-07-24,Tehama,103,63373,5241,5166,592,5758,65
2021-07-24,Trinity,105,12862,508,345,108,453,3
2021-07-24,Tulare,107,460477,51078,50104,9325,59429,854
2021-07-24,Tuolumne,109,53932,4299,4216,46,4262,64
2021-07-24,Ventura,111,848112,83838,82687,3372,86059,1041
2021-07-24,Yolo,113,214977,14901,14557,355,14912,214
2021-07-24,Yuba,115,75493,6629,6449,140,6589,51
2021-07-23,Alameda,001,1643700,95135,93170,2132,95302,1259
2021-07-23,Alpine,003,1148,88,89,0,89,0
2021-07-23,Amador,005,37829,3872,3816,33,3849,48
2021-07-23,Butte,007,227075,13290,12982,1949,14931,203
2021-07-23,Calaveras,009,45235,2293,2267,15,2282,57
2021-07-23,Colusa,011,21464,2010,1992,341,2333,16
2021-07-23,Contra Costa,013,1133247,75479,73682,1467,75149,830
2021-07-23,Del Norte,015,27424,1588,1497,14,1511,8
2021-07-23,El Dorado,017,186661,11056,10773,854,11627,116
2021-07-23,Fresno,019,978130,105320,103637,8958,112595,1736
2021-07-23,Glenn,021,27897,2479,2457,575,3032,20
2021-07-23,Humboldt,023,135768,4959,4780,68,4848,52
2021-07-23,Imperial,025,180216,29206,28996,2706,31702,742
2021-07-23,Inyo,027,18085,1436,1424,12,1436,38
2021-07-23,Kern,029,883053,99489,98261,11594,109855,1350
2021-07-23,Kings,031,150075,23724,23304,1131,24435,246
2021-07-23,Lake,033,64148,4194,3963,14,3977,64
2021-07-23,Lassen,035,31185,5329,5311,118,5429,21
2021-07-23,Los Angeles,037,10098052,1250834,1232164,44145,1276309,24623
2021-07-23,Madera,039,155013,17177,16885,980,17865,245
2021-07-23,Marin,041,260295,14780,14454,280,14734,238
2021-07-23,Mariposa,043,17540,469,453,11,464,5
2021-07-23,Mendocino,045,87422,4443,4293,90,4383,49
2021-07-23,Merced,047,269075,31831,31661,1086,32747,473
2021-07-23,Modoc,049,8938,421,413,148,561,5
2021-07-23,Mono,051,14174,1288,1284,17,1301,3
2021-07-23,Monterey,053,433212,43801,43525,1917,45442,521
2021-07-23,Napa,055,140530,10387,10230,47,10277,81
2021-07-23,Nevada,057,99092,5358,5183,199,5382,72
2021-07-23,Orange,059,3164182,263867,259973,11995,271968,5141
2021-07-23,Placer,061,380077,25156,24530,1795,26325,303
2021-07-23,Plumas,063,18699,751,737,14,751,4
2021-07-23,Riverside,065,2383286,302542,296912,14437,311349,4552
2021-07-23,Sacramento,067,1510023,114611,112438,2136,114574,1698
2021-07-23,San Benito,069,59416,6228,6200,113,6313,63
2021-07-23,San Bernardino,071,2135413,300993,297899,9299,307198,5236
2021-07-23,San Diego,073,3302833,294248,289368,16845,306213,3788
2021-07-23,San Francisco,075,870044,40197,38954,1423,40377,561
2021-07-23,San Joaquin,077,732212,76555,75461,3781,79242,1436
2021-07-23,San Luis Obispo,079,281455,22062,21616,787,22403,260
2021-07-23,San Mateo,081,765935,44500,43880,552,44432,542
2021-07-23,Santa Barbara,083,443738,35532,35071,1174,36245,465
2021-07-23,Santa Clara,085,1922200,122903,121092,821,121913,2099
2021-07-23,Santa Cruz,087,273765,16681,16416,808,17224,207
2021-07-23,Shasta,089,179085,12931,12759,1709,14468,211
2021-07-23,Sierra,091,2930,69,64,12,76,0
2021-07-23,Siskiyou,093,43540,2050,1951,418,2369,31
2021-07-23,Solano,095,438530,35357,34499,686,35185,259
2021-07-23,Sonoma,097,501317,32586,31928,375,32303,327
2021-07-23,Stanislaus,099,539301,58537,57879,6185,64064,1030
2021-07-23,Sutter,101,95872,9992,9890,96,9986,115
2021-07-23,Tehama,103,63373,5232,5166,592,5758,65
2021-07-23,Trinity,105,12862,507,345,107,452,3
2021-07-23,Tulare,107,460477,51032,50104,9304,59408,854
2021-07-23,Tuolumne,109,53932,4277,4216,46,4262,64
2021-07-23,Ventura,111,848112,83676,82687,3354,86041,1041
2021-07-23,Yolo,113,214977,14864,14557,348,14905,214
2021-07-23,Yuba,115,75493,6603,6449,139,6588,51
2021-07-22,Alameda,001,1643700,94781,93170,2128,95298,1259
2021-07-22,Alpine,003,1148,88,89,0,89,0
2021-07-22,Amador,005,37829,3863,3816,33,3849,48
2021-07-22,Butte,007,227075,13256,12982,1940,14922,203
2021-07-22,Calaveras,009,45235,2283,2267,15,2282,57
2021-07-22,Colusa,011,21464,2008,1992,338,2330,16
2021-07-22,Contra Costa,013,1133247,75140,73682,1462,75144,830
2021-07-22,Del Norte,015,27424,1571,1497,14,1511,8
2021-07-22,El Dorado,017,186661,11020,10773,846,11619,116
2021-07-22,Fresno,019,978130,105191,103637,8948,112585,1736
2021-07-22,Glenn,021,27897,2475,2457,575,3032,20
2021-07-22,Humboldt,023,135768,4928,4780,66,4846,52
2021-07-22,Imperial,025,180216,29176,28996,2706,31702,742
2021-07-22,Inyo,027,18085,1434,1424,12,1436,38
2021-07-22,Kern,029,883053,99374,98261,11553,109814,1350
2021-07-22,Kings,031,150075,23685,23304,1129,24433,246
2021-07-22,Lake,033,64148,4143,3963,14,3977,64
2021-07-22,Lassen,035,31185,5326,5311,118,5429,21
2021-07-22,Los Angeles,037,10098052,1248401,1232164,43963,1276127,24623
2021-07-22,Madera,039,155013,17142,16885,978,17863,245
2021-07-22,Marin,041,260295,14739,14454,279,14733,238
2021-07-22,Mariposa,043,17540,462,453,11,464,5
2021-07-22,Mendocino,045,87422,4430,4293,89,4382,49
2021-07-22,Merced,047,269075,31789,31661,1085,32746,473
2021-07-22,Modoc,049,8938,421,413,148,561,5
2021-07-22,Mono,051,14174,1287,1284,17,1301,3
2021-07-22,Monterey,053,433212,43773,43525,1911,45436,521
2021-07-22,Napa,055,140530,10369,10230,47,10277,81
2021-07-22,Nevada,057,99092,5332,5183,198,5381,72
2021-07-22,Orange,059,3164182,263314,259973,11986,271959,5141
2021-07-22,Placer,061,380077,25062,24530,1784,26314,303
2021-07-22,Plumas,063,18699,750,737,14,751,4
2021-07-22,Riverside,065,2383286,302034,296912,14416,311328,4552
2021-07-22,Sacramento,067,1510023,114173,112438,2127,114565,1698
2021-07-22,San Benito,069,59416,6221,6200,113,6313,63
2021-07-22,San Bernardino,071,2135413,300590,297899,9284,307183,5236
2021-07-22,San Diego,073,3302833,293518,289368,16785,306153,3788
2021-07-22,San Francisco,075,870044,39984,38954,1411,40365,561
2021-07-22,San Joaquin,077,732212,76412,75461,3769,79230,1436
2021-07-22,San Luis Obispo,079,281455,22024,21616,783,22399,260
2021-07-22,San Mateo,081,765935,44388,43880,547,44427,542
2021-07-22,Santa Barbara,083,443738,35466,35071,1172,36243,465
2021-07-22,Santa Clara,085,1922200,122662,121092,818,121910,2099
2021-07-22,Santa Cruz,087,273765,16644,16416,807,17223,207
2021-07-22,Shasta,089,179085,12907,12759,1705,14464,211
2021-07-22,Sierra,091,2930,67,64,12,76,0
2021-07-22,Siskiyou,093,43540,2047,1951,418,2369,31
2021-07-22,Solano,095,438530,35211,34499,679,35178,259
2021-07-22,Sonoma,097,501317,32476,31928,373,32301,327
2021-07-22,Stanislaus,099,539301,58409,57879,6173,64052,1030
2021-07-22,Sutter,101,95872,9971,9890,96,9986,115
2021-07-22,Tehama,103,63373,5226,5166,592,5758,65
2021-07-22,Trinity,105,12862,507,345,107,452,3
2021-07-22,Tulare,107,460477,50989,50104,9276,59380,854
2021-07-22,Tuolumne,109,53932,4265,4216,46,4262,64
2021-07-22,Ventura,111,848112,83542,82687,3341,86028,1041
2021-07-22,Yolo,113,214977,14826,14557,348,14905,214
2021-07-22,Yuba,115,75493,6572,6449,136,6585,51
2021-07-21,Alameda,001,1643700,94461,92840,2125,94965,1256
2021-07-21,Alpine,003,1148,88,89,0,89,0
2021-07-21,Amador,005,37829,3850,3813,33,3846,48
2021-07-21,Butte,007,227075,13215,12939,1935,14874,203
2021-07-21,Calaveras,009,45235,2279,2257,15,2272,57
2021-07-21,Colusa,011,21464,2004,1988,337,2325,16
2021-07-21,Contra Costa,013,1133247,74876,73320,1453,74773,827
2021-07-21,Del Norte,015,27424,1561,1492,14,1506,8
2021-07-21,El Dorado,017,186661,10983,10742,842,11584,116
2021-07-21,Fresno,019,978130,105043,103504,8939,112443,1736
2021-07-21,Glenn,021,27897,2473,2455,574,3029,20
2021-07-21,Humboldt,023,135768,4896,4763,64,4827,52
2021-07-21,Imperial,025,180216,29164,28964,2703,31667,742
2021-07-21,Inyo,027,18085,1434,1423,12,1435,38
2021-07-21,Kern,029,883053,99256,98152,11512,109664,1350
2021-07-21,Kings,031,150075,23657,23270,1125,24395,246
2021-07-21,Lake,033,64148,4077,3896,14,3910,64
2021-07-21,Lassen,035,31185,5323,5310,118,5428,21
2021-07-21,Los Angeles,037,10098052,1245889,1229598,43825,1273423,24609
2021-07-21,Madera,039,155013,17118,16858,976,17834,245
2021-07-21,Marin,041,260295,14690,14427,279,14706,238
2021-07-21,Mariposa,043,17540,458,449,11,460,5
2021-07-21,Mendocino,045,87422,4412,4274,89,4363,49
2021-07-21,Merced,047,269075,31750,31607,1081,32688,473
2021-07-21,Modoc,049,8938,421,413,148,561,5
2021-07-21,Mono,051,14174,1284,1282,17,1299,3
2021-07-21,Monterey,053,433212,43743,43502,1908,45410,515
2021-07-21,Napa,055,140530,10343,10209,47,10256,81
2021-07-21,Nevada,057,99092,5297,5152,198,5350,72
2021-07-21,Orange,059,3164182,262761,259615,11956,271571,5139
2021-07-21,Placer,061,380077,24953,24441,1773,26214,303
2021-07-21,Plumas,063,18699,750,736,14,750,4
2021-07-21,Riverside,065,2383286,301521,296419,14399,310818,4552
2021-07-21,Sacramento,067,1510023,113751,112043,2116,114159,1696
2021-07-21,San Benito,069,59416,6211,6196,113,6309,63
2021-07-21,San Bernardino,071,2135413,300135,297519,9276,306795,5230
2021-07-21,San Diego,073,3302833,292669,288682,16722,305404,3787
2021-07-21,San Francisco,075,870044,39759,38699,1406,40105,559
2021-07-21,San Joaquin,077,732212,76223,75288,3757,79045,1434
2021-07-21,San Luis Obispo,079,281455,21987,21579,780,22359,260
2021-07-21,San Mateo,081,765935,44296,43755,543,44298,542
2021-07-21,Santa Barbara,083,443738,35407,34998,1156,36154,465
2021-07-21,Santa Clara,085,1922200,122452,120838,816,121654,2099
2021-07-21,Santa Cruz,087,273765,16610,16407,807,17214,207
2021-07-21,Shasta,089,179085,12874,12751,1702,14453,211
2021-07-21,Sierra,091,2930,67,64,12,76,0
2021-07-21,Siskiyou,093,43540,2045,1943,416,2359,31
2021-07-21,Solano,095,438530,35053,34374,674,35048,258
2021-07-21,Sonoma,097,501317,32360,31789,373,32162,327
2021-07-21,Stanislaus,099,539301,58307,57774,6163,63937,1028
2021-07-21,Sutter,101,95872,9947,9862,96,9958,113
2021-07-21,Tehama,103,63373,5222,5161,592,5753,65
2021-07-21,Trinity,105,12862,505,345,106,451,3
2021-07-21,Tulare,107,460477,50929,50066,9251,59317,854
2021-07-21,Tuolumne,109,53932,4228,4156,46,4202,64
2021-07-21,Ventura,111,848112,83420,82573,3329,85902,1041
2021-07-21,Yolo,113,214977,14784,14525,347,14872,213
2021-07-21,Yuba,115,75493,6544,6425,136,6561,52
2021-07-20,Alameda,001,1643700,94089,92625,2111,94736,1256
2021-07-20,Alpine,003,1148,88,89,0,89,0
2021-07-20,Amador,005,37829,3839,3807,33,3840,48
2021-07-20,Butte,007,227075,13178,12916,1930,14846,203
2021-07-20,Calaveras,009,45235,2276,2249,15,2264,57
2021-07-20,Colusa,011,21464,2004,1985,337,2322,16
2021-07-20,Contra Costa,013,1133247,74592,73143,1435,74578,825
2021-07-20,Del Norte,015,27424,1551,1490,14,1504,8
2021-07-20,El Dorado,017,186661,10943,10727,838,11565,116
2021-07-20,Fresno,019,978130,104908,103438,8920,112358,1736
2021-07-20,Glenn,021,27897,2473,2453,574,3027,20
2021-07-20,Humboldt,023,135768,4851,4735,62,4797,52
2021-07-20,Imperial,025,180216,29144,28933,2703,31636,742
2021-07-20,Inyo,027,18085,1430,1420,12,1432,36
2021-07-20,Kern,029,883053,99143,98082,11484,109566,1350
2021-07-20,Kings,031,150075,23616,23254,1120,24374,246
2021-07-20,Lake,033,64148,4052,3871,14,3885,64
2021-07-20,Lassen,035,31185,5323,5306,118,5424,21
2021-07-20,Los Angeles,037,10098052,1243093,1227404,43660,1271064,24603
2021-07-20,Madera,039,155013,17097,16856,972,17828,245
2021-07-20,Marin,041,260295,14654,14396,276,14672,234
2021-07-20,Mariposa,043,17540,456,448,11,459,5
2021-07-20,Mendocino,045,87422,4395,4259,89,4348,49
2021-07-20,Merced,047,269075,31711,31578,1074,32652,473
2021-07-20,Modoc,049,8938,421,413,148,561,5
2021-07-20,Mono,051,14174,1280,1281,17,1298,3
2021-07-20,Monterey,053,433212,43712,43481,1905,45386,515
2021-07-20,Napa,055,140530,10320,10191,47,10238,81
2021-07-20,Nevada,057,99092,5278,5148,197,5345,72
2021-07-20,Orange,059,3164182,262204,259303,11926,271229,5139
2021-07-20,Placer,061,380077,24861,24408,1751,26159,303
2021-07-20,Plumas,063,18699,748,736,14,750,4
2021-07-20,Riverside,065,2383286,300986,296118,14385,310503,4543
2021-07-20,Sacramento,067,1510023,113311,111796,2086,113882,1695
2021-07-20,San Benito,069,59416,6204,6196,113,6309,63
2021-07-20,San Bernardino,071,2135413,299725,297222,9251,306473,5231
2021-07-20,San Diego,073,3302833,291743,288209,16626,304835,3786
2021-07-20,San Francisco,075,870044,39501,38536,1395,39931,558
2021-07-20,San Joaquin,077,732212,76051,75198,3744,78942,1433
2021-07-20,San Luis Obispo,079,281455,21941,21556,779,22335,259
2021-07-20,San Mateo,081,765935,44177,43670,542,44212,542
2021-07-20,Santa Barbara,083,443738,35337,34935,1150,36085,462
2021-07-20,Santa Clara,085,1922200,122195,120704,814,121518,2098
2021-07-20,Santa Cruz,087,273765,16581,16399,807,17206,207
2021-07-20,Shasta,089,179085,12848,12734,1698,14432,211
2021-07-20,Sierra,091,2930,67,64,12,76,0
2021-07-20,Siskiyou,093,43540,2041,1931,415,2346,31
2021-07-20,Solano,095,438530,34918,34337,667,35004,258
2021-07-20,Sonoma,097,501317,32241,31763,372,32135,326
2021-07-20,Stanislaus,099,539301,58192,57706,6158,63864,1028
2021-07-20,Sutter,101,95872,9920,9854,93,9947,114
2021-07-20,Tehama,103,63373,5220,5153,592,5745,65
2021-07-20,Trinity,105,12862,503,344,105,449,3
2021-07-20,Tulare,107,460477,50887,50047,9234,59281,854
2021-07-20,Tuolumne,109,53932,4209,4156,46,4202,64
2021-07-20,Ventura,111,848112,83267,82504,3314,85818,1041
2021-07-20,Yolo,113,214977,14719,14495,344,14839,213
2021-07-20,Yuba,115,75493,6519,6393,133,6526,52
2021-07-19,Alameda,001,1643700,93715,92357,2095,94452,1256
2021-07-19,Alpine,003,1148,88,89,0,89,0
2021-07-19,Amador,005,37829,3835,3802,33,3835,48
2021-07-19,Butte,007,227075,13134,12901,1925,14826,202
2021-07-19,Calaveras,009,45235,2272,2245,15,2260,57
2021-07-19,Colusa,011,21464,2002,1981,337,2318,16
2021-07-19,Contra Costa,013,1133247,74280,72935,1415,74350,825
2021-07-19,Del Norte,015,27424,1538,1484,14,1498,8
2021-07-19,El Dorado,017,186661,10913,10703,830,11533,114
2021-07-19,Fresno,019,978130,104778,103350,8907,112257,1731
2021-07-19,Glenn,021,27897,2473,2452,573,3025,20
2021-07-19,Humboldt,023,135768,4821,4719,60,4779,52
2021-07-19,Imperial,025,180216,29117,28888,2702,31590,742
2021-07-19,Inyo,027,18085,1429,1417,12,1429,36
2021-07-19,Kern,029,883053,99029,97999,11451,109450,1349
2021-07-19,Kings,031,150075,23586,23221,1114,24335,246
2021-07-19,Lake,033,64148,4016,3848,14,3862,64
2021-07-19,Lassen,035,31185,5322,5305,118,5423,21
2021-07-19,Los Angeles,037,10098052,1240491,1225946,43470,1269416,24600
2021-07-19,Madera,039,155013,17074,16846,969,17815,244
2021-07-19,Marin,041,260295,14619,14369,273,14642,234
2021-07-19,Mariposa,043,17540,450,447,11,458,5
2021-07-19,Mendocino,045,87422,4377,4251,89,4340,49
2021-07-19,Merced,047,269075,31647,31565,1067,32632,472
2021-07-19,Modoc,049,8938,420,413,148,561,5
2021-07-19,Mono,051,14174,1278,1280,17,1297,3
2021-07-19,Monterey,053,433212,43688,43436,1904,45340,515
2021-07-19,Napa,055,140530,10295,10180,45,10225,81
2021-07-19,Nevada,057,99092,5250,5133,196,5329,72
2021-07-19,Orange,059,3164182,261681,258927,11894,270821,5138
2021-07-19,Placer,061,380077,24762,24359,1729,26088,303
2021-07-19,Plumas,063,18699,748,730,14,744,4
2021-07-19,Riverside,065,2383286,300496,295736,14347,310083,4543
2021-07-19,Sacramento,067,1510023,112947,111470,2062,113532,1696
2021-07-19,San Benito,069,59416,6201,6193,113,6306,63
2021-07-19,San Bernardino,071,2135413,299351,296929,9232,306161,5235
2021-07-19,San Diego,073,3302833,290843,287695,16521,304216,3786
2021-07-19,San Francisco,075,870044,39228,38463,1382,39845,560
2021-07-19,San Joaquin,077,732212,75886,75086,3739,78825,1431
2021-07-19,San Luis Obispo,079,281455,21896,21531,775,22306,259
2021-07-19,San Mateo,081,765935,44035,43563,533,44096,542
2021-07-19,Santa Barbara,083,443738,35265,34904,1148,36052,461
2021-07-19,Santa Clara,085,1922200,121937,120554,813,121367,2098
2021-07-19,Santa Cruz,087,273765,16565,16387,807,17194,207
2021-07-19,Shasta,089,179085,12830,12723,1696,14419,209
2021-07-19,Sierra,091,2930,66,64,12,76,0
2021-07-19,Siskiyou,093,43540,2036,1927,413,2340,31
2021-07-19,Solano,095,438530,34743,34262,656,34918,261
2021-07-19,Sonoma,097,501317,32120,31713,371,32084,325
2021-07-19,Stanislaus,099,539301,58091,57644,6148,63792,1027
2021-07-19,Sutter,101,95872,9904,9834,93,9927,114
2021-07-19,Tehama,103,63373,5214,5152,590,5742,65
2021-07-19,Trinity,105,12862,503,344,104,448,3
2021-07-19,Tulare,107,460477,50840,49994,9218,59212,855
2021-07-19,Tuolumne,109,53932,4199,4151,46,4197,64
2021-07-19,Ventura,111,848112,83171,82409,3292,85701,1041
2021-07-19,Yolo,113,214977,14687,14439,342,14781,213
2021-07-19,Yuba,115,75493,6495,6370,133,6503,52
2021-07-18,Alameda,001,1643700,93356,92162,2083,94245,1256
2021-07-18,Alpine,003,1148,88,89,0,89,0
2021-07-18,Amador,005,37829,3824,3799,33,3832,48
2021-07-18,Butte,007,227075,13091,12888,1920,14808,202
2021-07-18,Calaveras,009,45235,2269,2243,15,2258,57
2021-07-18,Colusa,011,21464,2002,1981,336,2317,16
2021-07-18,Contra Costa,013,1133247,73964,72849,1397,74246,825
2021-07-18,Del Norte,015,27424,1529,1482,14,1496,8
2021-07-18,El Dorado,017,186661,10876,10687,822,11509,114
2021-07-18,Fresno,019,978130,104624,103298,8889,112187,1731
2021-07-18,Glenn,021,27897,2472,2452,572,3024,20
2021-07-18,Humboldt,023,135768,4785,4714,60,4774,52
2021-07-18,Imperial,025,180216,29080,28877,2701,31578,742
2021-07-18,Inyo,027,18085,1425,1417,12,1429,36
2021-07-18,Kern,029,883053,98903,97963,11409,109372,1349
2021-07-18,Kings,031,150075,23565,23203,1110,24313,246
2021-07-18,Lake,033,64148,3980,3825,14,3839,64
2021-07-18,Lassen,035,31185,5322,5305,118,5423,21
2021-07-18,Los Angeles,037,10098052,1237805,1224691,43280,1267971,24598
2021-07-18,Madera,039,155013,17049,16838,965,17803,244
2021-07-18,Marin,041,260295,14583,14358,271,14629,234
2021-07-18,Mariposa,043,17540,449,447,11,458,5
2021-07-18,Mendocino,045,87422,4356,4246,89,4335,49
2021-07-18,Merced,047,269075,31616,31537,1065,32602,471
2021-07-18,Modoc,049,8938,420,413,148,561,5
2021-07-18,Mono,051,14174,1277,1280,17,1297,3
2021-07-18,Monterey,053,433212,43670,43422,1894,45316,515
2021-07-18,Napa,055,140530,10278,10174,42,10216,81
2021-07-18,Nevada,057,99092,5224,5124,196,5320,72
2021-07-18,Orange,059,3164182,261197,258724,11866,270590,5138
2021-07-18,Placer,061,380077,24695,24313,1702,26015,303
2021-07-18,Plumas,063,18699,748,730,14,744,4
2021-07-18,Riverside,065,2383286,300004,295522,14305,309827,4543
2021-07-18,Sacramento,067,1510023,112516,111255,2029,113284,1696
2021-07-18,San Benito,069,59416,6193,6191,113,6304,63
2021-07-18,San Bernardino,071,2135413,298877,296739,9217,305956,5233
2021-07-18,San Diego,073,3302833,290027,286287,16437,302724,3786
2021-07-18,San Francisco,075,870044,38992,38367,1371,39738,560
2021-07-18,San Joaquin,077,732212,75709,74997,3726,78723,1431
2021-07-18,San Luis Obispo,079,281455,21861,21527,772,22299,259
2021-07-18,San Mateo,081,765935,43922,43506,527,44033,542
2021-07-18,Santa Barbara,083,443738,35200,34880,1146,36026,461
2021-07-18,Santa Clara,085,1922200,121723,120438,806,121244,2098
2021-07-18,Santa Cruz,087,273765,16533,16372,806,17178,207
2021-07-18,Shasta,089,179085,12805,12714,1692,14406,209
2021-07-18,Sierra,091,2930,66,64,12,76,0
2021-07-18,Siskiyou,093,43540,2030,1927,408,2335,31
2021-07-18,Solano,095,438530,34615,34215,652,34867,261
2021-07-18,Sonoma,097,501317,32015,31675,370,32045,325
2021-07-18,Stanislaus,099,539301,57980,57600,6123,63723,1028
2021-07-18,Sutter,101,95872,9872,9826,93,9919,114
2021-07-18,Tehama,103,63373,5211,5150,589,5739,65
2021-07-18,Trinity,105,12862,503,344,104,448,3
2021-07-18,Tulare,107,460477,50787,49985,9195,59180,855
2021-07-18,Tuolumne,109,53932,4181,4149,46,4195,64
2021-07-18,Ventura,111,848112,83057,82361,3268,85629,1041
2021-07-18,Yolo,113,214977,14628,14425,336,14761,213
2021-07-18,Yuba,115,75493,6454,6357,133,6490,52
2021-07-17,Alameda,001,1643700,93139,91346,2071,93417,1255
2021-07-17,Alpine,003,1148,88,89,0,89,0
2021-07-17,Amador,005,37829,3815,3785,33,3818,48
2021-07-17,Butte,007,227075,13076,12824,1916,14740,202
2021-07-17,Calaveras,009,45235,2263,2237,15,2252,57
2021-07-17,Colusa,011,21464,1999,1976,336,2312,16
2021-07-17,Contra Costa,013,1133247,73782,72254,1384,73638,824
2021-07-17,Del Norte,015,27424,1521,1475,14,1489,8
2021-07-17,El Dorado,017,186661,10849,10622,818,11440,114
2021-07-17,Fresno,019,978130,104551,103055,8875,111930,1730
2021-07-17,Glenn,021,27897,2471,2451,572,3023,20
2021-07-17,Humboldt,023,135768,4772,4654,59,4713,52
2021-07-17,Imperial,025,180216,29064,28840,2701,31541,742
2021-07-17,Inyo,027,18085,1425,1416,12,1428,36
2021-07-17,Kern,029,883053,98846,97796,11373,109169,1348
2021-07-17,Kings,031,150075,23545,23163,1109,24272,246
2021-07-17,Lake,033,64148,3955,3760,14,3774,64
2021-07-17,Lassen,035,31185,5322,5302,118,5420,21
2021-07-17,Los Angeles,037,10098052,1236270,1219733,43138,1262871,24582
2021-07-17,Madera,039,155013,17041,16804,965,17769,240
2021-07-17,Marin,041,260295,14565,14297,269,14566,234
2021-07-17,Mariposa,043,17540,449,445,11,456,5
2021-07-17,Mendocino,045,87422,4344,4209,89,4298,49
2021-07-17,Merced,047,269075,31595,31451,1061,32512,471
2021-07-17,Modoc,049,8938,420,412,148,560,5
2021-07-17,Mono,051,14174,1275,1277,17,1294,3
2021-07-17,Monterey,053,433212,43647,43367,1889,45256,515
2021-07-17,Napa,055,140530,10262,10129,42,10171,81
2021-07-17,Nevada,057,99092,5209,5066,196,5262,72
2021-07-17,Orange,059,3164182,260890,257805,11827,269632,5136
2021-07-17,Placer,061,380077,24628,24169,1688,25857,303
2021-07-17,Plumas,063,18699,743,721,14,735,4
2021-07-17,Riverside,065,2383286,299698,294751,14273,309024,4542
2021-07-17,Sacramento,067,1510023,112281,110432,2009,112441,1694
2021-07-17,San Benito,069,59416,6187,6181,113,6294,63
2021-07-17,San Bernardino,071,2135413,298640,296048,9198,305246,5218
2021-07-17,San Diego,073,3302833,289620,285698,16369,302067,3786
2021-07-17,San Francisco,075,870044,38871,37978,1368,39346,560
2021-07-17,San Joaquin,077,732212,75622,74695,3720,78415,1430
2021-07-17,San Luis Obispo,079,281455,21834,21462,772,22234,258
2021-07-17,San Mateo,081,765935,43851,43324,526,43850,542
2021-07-17,Santa Barbara,083,443738,35159,34769,1143,35912,461
2021-07-17,Santa Clara,085,1922200,121551,119980,803,120783,2097
2021-07-17,Santa Cruz,087,273765,16526,16337,806,17143,207
2021-07-17,Shasta,089,179085,12790,12683,1687,14370,210
2021-07-17,Sierra,091,2930,66,62,12,74,0
2021-07-17,Siskiyou,093,43540,2025,1922,405,2327,29
2021-07-17,Solano,095,438530,34550,34015,644,34659,263
2021-07-17,Sonoma,097,501317,31947,31536,369,31905,322
2021-07-17,Stanislaus,099,539301,57903,57400,6109,63509,1028
2021-07-17,Sutter,101,95872,9862,9778,93,9871,114
2021-07-17,Tehama,103,63373,5208,5145,589,5734,64
2021-07-17,Trinity,105,12862,502,341,104,445,3
2021-07-17,Tulare,107,460477,50766,49937,9183,59120,854
2021-07-17,Tuolumne,109,53932,4171,4131,46,4177,64
2021-07-17,Ventura,111,848112,82988,82125,3257,85382,1041
2021-07-17,Yolo,113,214977,14596,14356,329,14685,213
2021-07-17,Yuba,115,75493,6443,6309,133,6442,52
2021-07-16,Alameda,001,1643700,92897,91346,2060,93406,1255
2021-07-16,Alpine,003,1148,88,89,0,89,0
2021-07-16,Amador,005,37829,3812,3785,33,3818,48
2021-07-16,Butte,007,227075,13051,12824,1913,14737,202
2021-07-16,Calaveras,009,45235,2262,2237,15,2252,57
2021-07-16,Colusa,011,21464,1997,1976,335,2311,16
2021-07-16,Contra Costa,013,1133247,73594,72254,1380,73634,824
2021-07-16,Del Norte,015,27424,1519,1475,14,1489,8
2021-07-16,El Dorado,017,186661,10830,10622,817,11439,114
2021-07-16,Fresno,019,978130,104499,103055,8855,111910,1730
2021-07-16,Glenn,021,27897,2471,2451,572,3023,20
2021-07-16,Humboldt,023,135768,4750,4654,59,4713,52
2021-07-16,Imperial,025,180216,29052,28840,2701,31541,742
2021-07-16,Inyo,027,18085,1423,1416,12,1428,36
2021-07-16,Kern,029,883053,98784,97796,11333,109129,1348
2021-07-16,Kings,031,150075,23520,23163,1108,24271,246
2021-07-16,Lake,033,64148,3928,3760,14,3774,64
2021-07-16,Lassen,035,31185,5321,5302,118,5420,21
2021-07-16,Los Angeles,037,10098052,1234768,1219733,42993,1262726,24582
2021-07-16,Madera,039,155013,17023,16804,965,17769,240
2021-07-16,Marin,041,260295,14541,14297,266,14563,234
2021-07-16,Mariposa,043,17540,449,445,11,456,5
2021-07-16,Mendocino,045,87422,4335,4209,88,4297,49
2021-07-16,Merced,047,269075,31573,31451,1059,32510,471
2021-07-16,Modoc,049,8938,420,412,148,560,5
2021-07-16,Mono,051,14174,1274,1277,17,1294,3
2021-07-16,Monterey,053,433212,43625,43367,1888,45255,515
2021-07-16,Napa,055,140530,10238,10129,41,10170,81
2021-07-16,Nevada,057,99092,5199,5066,196,5262,72
2021-07-16,Orange,059,3164182,260617,257805,11786,269591,5136
2021-07-16,Placer,061,380077,24575,24169,1683,25852,303
2021-07-16,Plumas,063,18699,742,721,14,735,4
2021-07-16,Riverside,065,2383286,299422,294751,14247,308998,4542
2021-07-16,Sacramento,067,1510023,112064,110432,1996,112428,1694
2021-07-16,San Benito,069,59416,6185,6181,113,6294,63
2021-07-16,San Bernardino,071,2135413,298363,296048,9181,305229,5218
2021-07-16,San Diego,073,3302833,289178,285698,16322,302020,3786
2021-07-16,San Francisco,075,870044,38754,37978,1363,39341,560
2021-07-16,San Joaquin,077,732212,75528,74695,3717,78412,1430
2021-07-16,San Luis Obispo,079,281455,21817,21462,772,22234,258
2021-07-16,San Mateo,081,765935,43798,43324,525,43849,542
2021-07-16,Santa Barbara,083,443738,35121,34769,1143,35912,461
2021-07-16,Santa Clara,085,1922200,121404,119980,796,120776,2097
2021-07-16,Santa Cruz,087,273765,16513,16337,806,17143,207
2021-07-16,Shasta,089,179085,12780,12683,1686,14369,210
2021-07-16,Sierra,091,2930,66,62,12,74,0
2021-07-16,Siskiyou,093,43540,2023,1922,403,2325,29
2021-07-16,Solano,095,438530,34483,34015,636,34651,263
2021-07-16,Sonoma,097,501317,31895,31536,366,31902,322
2021-07-16,Stanislaus,099,539301,57853,57400,6099,63499,1028
2021-07-16,Sutter,101,95872,9850,9778,93,9871,114
2021-07-16,Tehama,103,63373,5206,5145,589,5734,64
2021-07-16,Trinity,105,12862,502,341,103,444,3
2021-07-16,Tulare,107,460477,50742,49937,9173,59110,854
2021-07-16,Tuolumne,109,53932,4165,4131,46,4177,64
2021-07-16,Ventura,111,848112,82923,82125,3250,85375,1041
2021-07-16,Yolo,113,214977,14570,14356,326,14682,213
2021-07-16,Yuba,115,75493,6421,6309,132,6441,52
2021-07-15,Alameda,001,1643700,92600,91346,2050,93396,1255
2021-07-15,Alpine,003,1148,88,89,0,89,0
2021-07-15,Amador,005,37829,3809,3785,33,3818,48
2021-07-15,Butte,007,227075,13025,12824,1911,14735,202
2021-07-15,Calaveras,009,45235,2259,2237,15,2252,57
2021-07-15,Colusa,011,21464,1996,1976,334,2310,16
2021-07-15,Contra Costa,013,1133247,73381,72254,1373,73627,824
2021-07-15,Del Norte,015,27424,1516,1475,14,1489,8
2021-07-15,El Dorado,017,186661,10803,10622,815,11437,114
2021-07-15,Fresno,019,978130,104402,103055,8835,111890,1730
2021-07-15,Glenn,021,27897,2471,2451,572,3023,20
2021-07-15,Humboldt,023,135768,4732,4654,58,4712,52
2021-07-15,Imperial,025,180216,29029,28840,2701,31541,742
2021-07-15,Inyo,027,18085,1423,1416,12,1428,36
2021-07-15,Kern,029,883053,98714,97796,11305,109101,1348
2021-07-15,Kings,031,150075,23482,23163,1105,24268,246
2021-07-15,Lake,033,64148,3889,3760,14,3774,64
2021-07-15,Lassen,035,31185,5320,5302,118,5420,21
2021-07-15,Los Angeles,037,10098052,1232783,1219733,42835,1262568,24582
2021-07-15,Madera,039,155013,17001,16804,961,17765,240
2021-07-15,Marin,041,260295,14516,14297,266,14563,234
2021-07-15,Mariposa,043,17540,449,445,11,456,5
2021-07-15,Mendocino,045,87422,4327,4209,87,4296,49
2021-07-15,Merced,047,269075,31543,31451,1059,32510,471
2021-07-15,Modoc,049,8938,420,412,148,560,5
2021-07-15,Mono,051,14174,1274,1277,17,1294,3
2021-07-15,Monterey,053,433212,43596,43367,1885,45252,515
2021-07-15,Napa,055,140530,10213,10129,40,10169,81
2021-07-15,Nevada,057,99092,5182,5066,195,5261,72
2021-07-15,Orange,059,3164182,260266,257805,11755,269560,5136
2021-07-15,Placer,061,380077,24515,24169,1666,25835,303
2021-07-15,Plumas,063,18699,741,721,14,735,4
2021-07-15,Riverside,065,2383286,299101,294751,14232,308983,4542
2021-07-15,Sacramento,067,1510023,111760,110432,1979,112411,1694
2021-07-15,San Benito,069,59416,6183,6181,113,6294,63
2021-07-15,San Bernardino,071,2135413,298056,296048,9167,305215,5218
2021-07-15,San Diego,073,3302833,288540,285698,16244,301942,3786
2021-07-15,San Francisco,075,870044,38602,37978,1355,39333,560
2021-07-15,San Joaquin,077,732212,75411,74695,3712,78407,1430
2021-07-15,San Luis Obispo,079,281455,21785,21462,772,22234,258
2021-07-15,San Mateo,081,765935,43693,43324,520,43844,542
2021-07-15,Santa Barbara,083,443738,35065,34769,1142,35911,461
2021-07-15,Santa Clara,085,1922200,121282,119980,793,120773,2097
2021-07-15,Santa Cruz,087,273765,16500,16337,806,17143,207
2021-07-15,Shasta,089,179085,12772,12683,1682,14365,210
2021-07-15,Sierra,091,2930,66,62,12,74,0
2021-07-15,Siskiyou,093,43540,2022,1922,403,2325,29
2021-07-15,Solano,095,438530,34408,34015,630,34645,263
2021-07-15,Sonoma,097,501317,31834,31536,366,31902,322
2021-07-15,Stanislaus,099,539301,57784,57400,6086,63486,1028
2021-07-15,Sutter,101,95872,9830,9778,92,9870,114
2021-07-15,Tehama,103,63373,5200,5145,588,5733,64
2021-07-15,Trinity,105,12862,502,341,103,444,3
2021-07-15,Tulare,107,460477,50722,49937,9156,59093,854
2021-07-15,Tuolumne,109,53932,4153,4131,46,4177,64
2021-07-15,Ventura,111,848112,82847,82125,3245,85370,1041
2021-07-15,Yolo,113,214977,14543,14356,325,14681,213
2021-07-15,Yuba,115,75493,6406,6309,131,6440,52
2021-07-14,Alameda,001,1643700,92340,91092,2033,93125,1255
2021-07-14,Alpine,003,1148,88,89,0,89,0
2021-07-14,Amador,005,37829,3801,3784,33,3817,48
2021-07-14,Butte,007,227075,12998,12813,1904,14717,202
2021-07-14,Calaveras,009,45235,2252,2234,15,2249,57
2021-07-14,Colusa,011,21464,1993,1974,334,2308,16
2021-07-14,Contra Costa,013,1133247,73153,72091,1361,73452,823
2021-07-14,Del Norte,015,27424,1515,1472,14,1486,8
2021-07-14,El Dorado,017,186661,10777,10598,812,11410,114
2021-07-14,Fresno,019,978130,104322,102966,8824,111790,1728
2021-07-14,Glenn,021,27897,2471,2449,572,3021,20
2021-07-14,Humboldt,023,135768,4709,4644,56,4700,52
2021-07-14,Imperial,025,180216,29000,28822,2701,31523,742
2021-07-14,Inyo,027,18085,1422,1415,12,1427,36
2021-07-14,Kern,029,883053,98650,97736,11280,109016,1346
2021-07-14,Kings,031,150075,23469,23142,1105,24247,246
2021-07-14,Lake,033,64148,3856,3739,14,3753,63
2021-07-14,Lassen,035,31185,5319,5298,118,5416,21
2021-07-14,Los Angeles,037,10098052,1230767,1218265,42694,1260959,24578
2021-07-14,Madera,039,155013,16989,16786,959,17745,240
2021-07-14,Marin,041,260295,14482,14269,264,14533,233
2021-07-14,Mariposa,043,17540,447,445,11,456,5
2021-07-14,Mendocino,045,87422,4314,4193,87,4280,49
2021-07-14,Merced,047,269075,31506,31412,1056,32468,471
2021-07-14,Modoc,049,8938,420,412,148,560,4
2021-07-14,Mono,051,14174,1274,1278,17,1295,3
2021-07-14,Monterey,053,433212,43572,43347,1883,45230,504
2021-07-14,Napa,055,140530,10191,10121,40,10161,81
2021-07-14,Nevada,057,99092,5162,5058,195,5253,72
2021-07-14,Orange,059,3164182,259949,257558,11725,269283,5137
2021-07-14,Placer,061,380077,24462,24125,1654,25779,303
2021-07-14,Plumas,063,18699,734,719,14,733,4
2021-07-14,Riverside,065,2383286,298777,294511,14216,308727,4542
2021-07-14,Sacramento,067,1510023,111432,110193,1955,112148,1688
2021-07-14,San Benito,069,59416,6180,6177,113,6290,63
2021-07-14,San Bernardino,071,2135413,297756,295820,9152,304972,5193
2021-07-14,San Diego,073,3302833,287968,285269,16164,301433,3786
2021-07-14,San Francisco,075,870044,38463,37836,1350,39186,559
2021-07-14,San Joaquin,077,732212,75319,74599,3703,78302,1416
2021-07-14,San Luis Obispo,079,281455,21763,21444,770,22214,258
2021-07-14,San Mateo,081,765935,43594,43249,516,43765,542
2021-07-14,Santa Barbara,083,443738,35023,34719,1140,35859,461
2021-07-14,Santa Clara,085,1922200,121132,119844,790,120634,2098
2021-07-14,Santa Cruz,087,273765,16488,16326,806,17132,207
2021-07-14,Shasta,089,179085,12752,12669,1679,14348,209
2021-07-14,Sierra,091,2930,66,62,12,74,0
2021-07-14,Siskiyou,093,43540,2015,1922,400,2322,29
2021-07-14,Solano,095,438530,34335,33948,630,34578,268
2021-07-14,Sonoma,097,501317,31782,31470,366,31836,322
2021-07-14,Stanislaus,099,539301,57709,57340,6074,63414,1028
2021-07-14,Sutter,101,95872,9808,9766,92,9858,114
2021-07-14,Tehama,103,63373,5198,5142,588,5730,64
2021-07-14,Trinity,105,12862,502,341,103,444,3
2021-07-14,Tulare,107,460477,50705,49908,9142,59050,853
2021-07-14,Tuolumne,109,53932,4150,4128,45,4173,64
2021-07-14,Ventura,111,848112,82753,82041,3234,85275,1040
2021-07-14,Yolo,113,214977,14510,14332,322,14654,213
2021-07-14,Yuba,115,75493,6388,6294,131,6425,52
2021-07-13,Alameda,001,1643700,92075,90874,2023,92897,1255
2021-07-13,Alpine,003,1148,88,89,0,89,0
2021-07-13,Amador,005,37829,3794,3783,33,3816,48
2021-07-13,Butte,007,227075,12984,12802,1903,14705,202
2021-07-13,Calaveras,009,45235,2248,2230,15,2245,57
2021-07-13,Colusa,011,21464,1991,1972,331,2303,16
2021-07-13,Contra Costa,013,1133247,72928,71963,1352,73315,823
2021-07-13,Del Norte,015,27424,1511,1471,14,1485,8
2021-07-13,El Dorado,017,186661,10760,10581,810,11391,114
2021-07-13,Fresno,019,978130,104247,102909,8814,111723,1727
2021-07-13,Glenn,021,27897,2469,2448,572,3020,20
2021-07-13,Humboldt,023,135768,4694,4634,56,4690,51
2021-07-13,Imperial,025,180216,28989,28792,2701,31493,741
2021-07-13,Inyo,027,18085,1421,1415,12,1427,36
2021-07-13,Kern,029,883053,98561,97698,11241,108939,1346
2021-07-13,Kings,031,150075,23451,23132,1105,24237,246
2021-07-13,Lake,033,64148,3829,3719,13,3732,63
2021-07-13,Lassen,035,31185,5317,5292,118,5410,21
2021-07-13,Los Angeles,037,10098052,1228917,1217184,42524,1259708,24569
2021-07-13,Madera,039,155013,16979,16773,955,17728,240
2021-07-13,Marin,041,260295,14453,14254,263,14517,233
2021-07-13,Mariposa,043,17540,446,443,11,454,5
2021-07-13,Mendocino,045,87422,4307,4185,87,4272,49
2021-07-13,Merced,047,269075,31485,31379,1053,32432,471
2021-07-13,Modoc,049,8938,420,411,148,559,4
2021-07-13,Mono,051,14174,1273,1277,17,1294,3
2021-07-13,Monterey,053,433212,43554,43333,1879,45212,504
2021-07-13,Napa,055,140530,10170,10118,40,10158,81
2021-07-13,Nevada,057,99092,5137,5053,195,5248,72
2021-07-13,Orange,059,3164182,259619,257339,11697,269036,5136
2021-07-13,Placer,061,380077,24416,24091,1641,25732,303
2021-07-13,Plumas,063,18699,733,716,14,730,4
2021-07-13,Riverside,065,2383286,298454,294302,14189,308491,4541
2021-07-13,Sacramento,067,1510023,111122,109990,1932,111922,1687
2021-07-13,San Benito,069,59416,6178,6173,113,6286,63
2021-07-13,San Bernardino,071,2135413,297479,295596,9130,304726,5183
2021-07-13,San Diego,073,3302833,287420,284997,16085,301082,3785
2021-07-13,San Francisco,075,870044,38319,37725,1344,39069,559
2021-07-13,San Joaquin,077,732212,75203,74500,3700,78200,1417
2021-07-13,San Luis Obispo,079,281455,21737,21423,767,22190,258
2021-07-13,San Mateo,081,765935,43525,43180,515,43695,542
2021-07-13,Santa Barbara,083,443738,34974,34679,1137,35816,461
2021-07-13,Santa Clara,085,1922200,120979,119727,786,120513,2098
2021-07-13,Santa Cruz,087,273765,16479,16315,804,17119,207
2021-07-13,Shasta,089,179085,12739,12659,1672,14331,209
2021-07-13,Sierra,091,2930,66,62,12,74,0
2021-07-13,Siskiyou,093,43540,2014,1916,398,2314,29
2021-07-13,Solano,095,438530,34270,33918,624,34542,268
2021-07-13,Sonoma,097,501317,31723,31431,366,31797,322
2021-07-13,Stanislaus,099,539301,57639,57282,6059,63341,1028
2021-07-13,Sutter,101,95872,9790,9752,91,9843,114
2021-07-13,Tehama,103,63373,5191,5144,588,5732,64
2021-07-13,Trinity,105,12862,502,341,102,443,3
2021-07-13,Tulare,107,460477,50680,49891,9126,59017,853
2021-07-13,Tuolumne,109,53932,4142,4122,44,4166,64
2021-07-13,Ventura,111,848112,82668,81982,3209,85191,1040
2021-07-13,Yolo,113,214977,14482,14320,315,14635,213
2021-07-13,Yuba,115,75493,6371,6279,131,6410,52
2021-07-12,Alameda,001,1643700,91816,90720,2016,92736,1254
2021-07-12,Alpine,003,1148,88,89,0,89,0
2021-07-12,Amador,005,37829,3787,3781,33,3814,47
2021-07-12,Butte,007,227075,12964,12796,1901,14697,202
2021-07-12,Calaveras,009,45235,2246,2228,15,2243,57
2021-07-12,Colusa,011,21464,1987,1971,330,2301,16
2021-07-12,Contra Costa,013,1133247,72725,71833,1347,73180,823
2021-07-12,Del Norte,015,27424,1508,1469,14,1483,8
2021-07-12,El Dorado,017,186661,10731,10569,808,11377,114
2021-07-12,Fresno,019,978130,104153,102853,8802,111655,1728
2021-07-12,Glenn,021,27897,2469,2446,572,3018,20
2021-07-12,Humboldt,023,135768,4678,4621,56,4677,51
2021-07-12,Imperial,025,180216,28959,28789,2701,31490,741
2021-07-12,Inyo,027,18085,1421,1415,12,1427,36
2021-07-12,Kern,029,883053,98492,97660,11216,108876,1346
2021-07-12,Kings,031,150075,23431,23124,1103,24227,246
2021-07-12,Lake,033,64148,3808,3706,13,3719,63
2021-07-12,Lassen,035,31185,5316,5292,118,5410,21
2021-07-12,Los Angeles,037,10098052,1227120,1216230,42391,1258621,24559
2021-07-12,Madera,039,155013,16968,16772,955,17727,240
2021-07-12,Marin,041,260295,14428,14238,262,14500,233
2021-07-12,Mariposa,043,17540,446,442,11,453,5
2021-07-12,Mendocino,045,87422,4296,4175,87,4262,49
2021-07-12,Merced,047,269075,31454,31374,1052,32426,471
2021-07-12,Modoc,049,8938,419,411,148,559,4
2021-07-12,Mono,051,14174,1271,1275,17,1292,3
2021-07-12,Monterey,053,433212,43533,43315,1875,45190,504
2021-07-12,Napa,055,140530,10152,10104,39,10143,81
2021-07-12,Nevada,057,99092,5114,5046,195,5241,72
2021-07-12,Orange,059,3164182,259266,257171,11674,268845,5136
2021-07-12,Placer,061,380077,24365,24052,1635,25687,302
2021-07-12,Plumas,063,18699,733,716,14,730,4
2021-07-12,Riverside,065,2383286,298146,294108,14160,308268,4541
2021-07-12,Sacramento,067,1510023,110907,109849,1906,111755,1685
2021-07-12,San Benito,069,59416,6175,6166,113,6279,63
2021-07-12,San Bernardino,071,2135413,297207,295447,9115,304562,5171
2021-07-12,San Diego,073,3302833,286951,284648,16009,300657,3785
2021-07-12,San Francisco,075,870044,38173,37656,1341,38997,559
2021-07-12,San Joaquin,077,732212,75109,74424,3690,78114,1415
2021-07-12,San Luis Obispo,079,281455,21718,21408,766,22174,258
2021-07-12,San Mateo,081,765935,43431,43138,508,43646,542
2021-07-12,Santa Barbara,083,443738,34931,34664,1135,35799,461
2021-07-12,Santa Clara,085,1922200,120814,119634,783,120417,2098
2021-07-12,Santa Cruz,087,273765,16454,16310,803,17113,207
2021-07-12,Shasta,089,179085,12732,12648,1669,14317,208
2021-07-12,Sierra,091,2930,66,62,12,74,0
2021-07-12,Siskiyou,093,43540,2009,1916,393,2309,29
2021-07-12,Solano,095,438530,34180,33859,615,34474,268
2021-07-12,Sonoma,097,501317,31675,31377,365,31742,322
2021-07-12,Stanislaus,099,539301,57570,57243,6052,63295,1028
2021-07-12,Sutter,101,95872,9773,9736,90,9826,114
2021-07-12,Tehama,103,63373,5186,5138,587,5725,63
2021-07-12,Trinity,105,12862,498,340,100,440,3
2021-07-12,Tulare,107,460477,50652,49882,9113,58995,853
2021-07-12,Tuolumne,109,53932,4138,4116,44,4160,64
2021-07-12,Ventura,111,848112,82567,81919,3188,85107,1040
2021-07-12,Yolo,113,214977,14454,14303,311,14614,213
2021-07-12,Yuba,115,75493,6356,6266,131,6397,52
2021-07-11,Alameda,001,1643700,91486,90597,2004,92601,1254
2021-07-11,Alpine,003,1148,88,89,0,89,0
2021-07-11,Amador,005,37829,3785,3779,33,3812,47
2021-07-11,Butte,007,227075,12942,12794,1895,14689,202
2021-07-11,Calaveras,009,45235,2244,2226,14,2240,57
2021-07-11,Colusa,011,21464,1986,1971,329,2300,16
2021-07-11,Contra Costa,013,1133247,72515,71744,1340,73084,823
2021-07-11,Del Norte,015,27424,1504,1467,13,1480,8
2021-07-11,El Dorado,017,186661,10702,10554,806,11360,114
2021-07-11,Fresno,019,978130,104058,102813,8782,111595,1728
2021-07-11,Glenn,021,27897,2468,2446,572,3018,20
2021-07-11,Humboldt,023,135768,4665,4611,55,4666,51
2021-07-11,Imperial,025,180216,28941,28787,2700,31487,741
2021-07-11,Inyo,027,18085,1419,1415,12,1427,36
2021-07-11,Kern,029,883053,98419,97637,11200,108837,1346
2021-07-11,Kings,031,150075,23400,23116,1100,24216,246
2021-07-11,Lake,033,64148,3777,3699,13,3712,63
2021-07-11,Lassen,035,31185,5313,5291,118,5409,21
2021-07-11,Los Angeles,037,10098052,1225365,1215182,42235,1257417,24558
2021-07-11,Madera,039,155013,16949,16766,954,17720,240
2021-07-11,Marin,041,260295,14402,14231,262,14493,233
2021-07-11,Mariposa,043,17540,445,442,11,453,5
2021-07-11,Mendocino,045,87422,4276,4167,87,4254,49
2021-07-11,Merced,047,269075,31430,31366,1047,32413,471
2021-07-11,Modoc,049,8938,418,411,148,559,4
2021-07-11,Mono,051,14174,1271,1275,17,1292,3
2021-07-11,Monterey,053,433212,43514,43307,1871,45178,504
2021-07-11,Napa,055,140530,10148,10100,39,10139,81
2021-07-11,Nevada,057,99092,5103,5035,194,5229,72
2021-07-11,Orange,059,3164182,258953,257009,11646,268655,5136
2021-07-11,Placer,061,380077,24308,24017,1623,25640,302
2021-07-11,Plumas,063,18699,733,716,14,730,4
2021-07-11,Riverside,065,2383286,297882,293969,14142,308111,4541
2021-07-11,Sacramento,067,1510023,110628,109696,1896,111592,1685
2021-07-11,San Benito,069,59416,6170,6163,113,6276,63
2021-07-11,San Bernardino,071,2135413,296900,295342,9090,304432,5167
2021-07-11,San Diego,073,3302833,286537,283819,15923,299742,3784
2021-07-11,San Francisco,075,870044,38045,37596,1335,38931,559
2021-07-11,San Joaquin,077,732212,74992,74376,3673,78049,1415
2021-07-11,San Luis Obispo,079,281455,21685,21403,765,22168,258
2021-07-11,San Mateo,081,765935,43352,43107,502,43609,542
2021-07-11,Santa Barbara,083,443738,34884,34646,1135,35781,461
2021-07-11,Santa Clara,085,1922200,120660,119549,782,120331,2098
2021-07-11,Santa Cruz,087,273765,16438,16303,803,17106,207
2021-07-11,Shasta,089,179085,12715,12647,1667,14314,208
2021-07-11,Sierra,091,2930,66,62,12,74,0
2021-07-11,Siskiyou,093,43540,2005,1915,391,2306,29
2021-07-11,Solano,095,438530,34098,33837,611,34448,268
2021-07-11,Sonoma,097,501317,31593,31352,365,31717,322
2021-07-11,Stanislaus,099,539301,57504,57230,6041,63271,1028
2021-07-11,Sutter,101,95872,9759,9728,90,9818,114
2021-07-11,Tehama,103,63373,5183,5138,587,5725,63
2021-07-11,Trinity,105,12862,497,340,100,440,3
2021-07-11,Tulare,107,460477,50627,49877,9095,58972,853
2021-07-11,Tuolumne,109,53932,4132,4116,44,4160,64
2021-07-11,Ventura,111,848112,82494,81875,3168,85043,1040
2021-07-11,Yolo,113,214977,14429,14285,305,14590,213
2021-07-11,Yuba,115,75493,6345,6260,131,6391,52
2021-07-10,Alameda,001,1643700,91335,90090,2000,92090,1252
2021-07-10,Alpine,003,1148,88,89,0,89,0
2021-07-10,Amador,005,37829,3779,3773,33,3806,47
2021-07-10,Butte,007,227075,12931,12764,1892,14656,202
2021-07-10,Calaveras,009,45235,2243,2214,14,2228,57
2021-07-10,Colusa,011,21464,1984,1969,329,2298,16
2021-07-10,Contra Costa,013,1133247,72415,71376,1339,72715,821
2021-07-10,Del Norte,015,27424,1502,1451,13,1464,8
2021-07-10,El Dorado,017,186661,10685,10508,803,11311,114
2021-07-10,Fresno,019,978130,104025,102675,8775,111450,1730
2021-07-10,Glenn,021,27897,2465,2440,571,3011,20
2021-07-10,Humboldt,023,135768,4656,4574,55,4629,51
2021-07-10,Imperial,025,180216,28928,28729,2700,31429,741
2021-07-10,Inyo,027,18085,1418,1415,12,1427,36
2021-07-10,Kern,029,883053,98379,97538,11183,108721,1346
2021-07-10,Kings,031,150075,23393,23090,1099,24189,246
2021-07-10,Lake,033,64148,3760,3667,13,3680,63
2021-07-10,Lassen,035,31185,5313,5290,118,5408,21
2021-07-10,Los Angeles,037,10098052,1224338,1212043,42133,1254176,24542
2021-07-10,Madera,039,155013,16943,16744,951,17695,241
2021-07-10,Marin,041,260295,14388,14194,262,14456,233
2021-07-10,Mariposa,043,17540,445,442,11,453,5
2021-07-10,Mendocino,045,87422,4269,4153,86,4239,49
2021-07-10,Merced,047,269075,31417,31328,1047,32375,470
2021-07-10,Modoc,049,8938,418,410,148,558,4
2021-07-10,Mono,051,14174,1271,1275,17,1292,3
2021-07-10,Monterey,053,433212,43500,43251,1869,45120,499
2021-07-10,Napa,055,140530,10136,10077,39,10116,81
2021-07-10,Nevada,057,99092,5094,5000,194,5194,72
2021-07-10,Orange,059,3164182,258775,256438,11630,268068,5135
2021-07-10,Placer,061,380077,24279,23916,1613,25529,302
2021-07-10,Plumas,063,18699,732,717,14,731,4
2021-07-10,Riverside,065,2383286,297692,293474,14129,307603,4541
2021-07-10,Sacramento,067,1510023,110479,109091,1891,110982,1682
2021-07-10,San Benito,069,59416,6165,6141,113,6254,63
2021-07-10,San Bernardino,071,2135413,296712,294932,9078,304010,5117
2021-07-10,San Diego,073,3302833,286247,283577,15870,299447,3783
2021-07-10,San Francisco,075,870044,37962,37338,1332,38670,559
2021-07-10,San Joaquin,077,732212,74935,74150,3667,77817,1412
2021-07-10,San Luis Obispo,079,281455,21674,21375,764,22139,258
2021-07-10,San Mateo,081,765935,43300,42948,500,43448,542
2021-07-10,Santa Barbara,083,443738,34857,34595,1135,35730,460
2021-07-10,Santa Clara,085,1922200,120557,119330,779,120109,2094
2021-07-10,Santa Cruz,087,273765,16431,16286,803,17089,207
2021-07-10,Shasta,089,179085,12702,12623,1662,14285,206
2021-07-10,Sierra,091,2930,66,61,12,73,0
2021-07-10,Siskiyou,093,43540,2003,1909,388,2297,29
2021-07-10,Solano,095,438530,34056,33678,605,34283,268
2021-07-10,Sonoma,097,501317,31542,31231,365,31596,317
2021-07-10,Stanislaus,099,539301,57468,57104,6031,63135,1026
2021-07-10,Sutter,101,95872,9747,9692,90,9782,114
2021-07-10,Tehama,103,63373,5180,5131,587,5718,63
2021-07-10,Trinity,105,12862,497,341,100,441,3
2021-07-10,Tulare,107,460477,50617,49850,9089,58939,853
2021-07-10,Tuolumne,109,53932,4130,4114,44,4158,64
2021-07-10,Ventura,111,848112,82449,81713,3150,84863,1039
2021-07-10,Yolo,113,214977,14408,14250,302,14552,213
2021-07-10,Yuba,115,75493,6335,6238,131,6369,52
2021-07-09,Alameda,001,1643700,91176,90090,1995,92085,1252
2021-07-09,Alpine,003,1148,88,89,0,89,0
2021-07-09,Amador,005,37829,3778,3773,33,3806,47
2021-07-09,Butte,007,227075,12920,12764,1890,14654,202
2021-07-09,Calaveras,009,45235,2241,2214,14,2228,57
2021-07-09,Colusa,011,21464,1983,1969,329,2298,16
2021-07-09,Contra Costa,013,1133247,72289,71376,1337,72713,821
2021-07-09,Del Norte,015,27424,1497,1451,13,1464,8
2021-07-09,El Dorado,017,186661,10670,10508,802,11310,114
2021-07-09,Fresno,019,978130,103969,102675,8768,111443,1730
2021-07-09,Glenn,021,27897,2464,2440,569,3009,20
2021-07-09,Humboldt,023,135768,4637,4574,55,4629,51
2021-07-09,Imperial,025,180216,28920,28729,2699,31428,741
2021-07-09,Inyo,027,18085,1417,1415,12,1427,36
2021-07-09,Kern,029,883053,98341,97538,11171,108709,1346
2021-07-09,Kings,031,150075,23382,23090,1098,24188,246
2021-07-09,Lake,033,64148,3746,3667,13,3680,63
2021-07-09,Lassen,035,31185,5311,5290,117,5407,21
2021-07-09,Los Angeles,037,10098052,1223334,1212043,42062,1254105,24542
2021-07-09,Madera,039,155013,16933,16744,950,17694,241
2021-07-09,Marin,041,260295,14367,14194,261,14455,233
2021-07-09,Mariposa,043,17540,445,442,11,453,5
2021-07-09,Mendocino,045,87422,4262,4153,86,4239,49
2021-07-09,Merced,047,269075,31402,31328,1047,32375,470
2021-07-09,Modoc,049,8938,418,410,148,558,4
2021-07-09,Mono,051,14174,1271,1275,17,1292,3
2021-07-09,Monterey,053,433212,43491,43251,1869,45120,499
2021-07-09,Napa,055,140530,10129,10077,39,10116,81
2021-07-09,Nevada,057,99092,5085,5000,194,5194,72
2021-07-09,Orange,059,3164182,258570,256438,11616,268054,5135
2021-07-09,Placer,061,380077,24257,23916,1607,25523,302
2021-07-09,Plumas,063,18699,730,717,14,731,4
2021-07-09,Riverside,065,2383286,297506,293474,14116,307590,4541
2021-07-09,Sacramento,067,1510023,110325,109091,1882,110973,1682
2021-07-09,San Benito,069,59416,6163,6141,113,6254,63
2021-07-09,San Bernardino,071,2135413,296560,294932,9071,304003,5117
2021-07-09,San Diego,073,3302833,285958,283577,15822,299399,3783
2021-07-09,San Francisco,075,870044,37882,37338,1325,38663,559
2021-07-09,San Joaquin,077,732212,74861,74150,3660,77810,1412
2021-07-09,San Luis Obispo,079,281455,21662,21375,764,22139,258
2021-07-09,San Mateo,081,765935,43256,42948,496,43444,542
2021-07-09,Santa Barbara,083,443738,34836,34595,1134,35729,460
2021-07-09,Santa Clara,085,1922200,120447,119330,779,120109,2094
2021-07-09,Santa Cruz,087,273765,16428,16286,803,17089,207
2021-07-09,Shasta,089,179085,12696,12623,1657,14280,206
2021-07-09,Sierra,091,2930,66,61,12,73,0
2021-07-09,Siskiyou,093,43540,2001,1909,387,2296,29
2021-07-09,Solano,095,438530,34020,33678,601,34279,268
2021-07-09,Sonoma,097,501317,31506,31231,365,31596,317
2021-07-09,Stanislaus,099,539301,57439,57104,6029,63133,1026
2021-07-09,Sutter,101,95872,9738,9692,90,9782,114
2021-07-09,Tehama,103,63373,5178,5131,587,5718,63
2021-07-09,Trinity,105,12862,496,341,97,438,3
2021-07-09,Tulare,107,460477,50604,49850,9083,58933,853
2021-07-09,Tuolumne,109,53932,4126,4114,44,4158,64
2021-07-09,Ventura,111,848112,82394,81713,3141,84854,1039
2021-07-09,Yolo,113,214977,14393,14250,298,14548,213
2021-07-09,Yuba,115,75493,6322,6238,131,6369,52
2021-07-08,Alameda,001,1643700,90969,90090,1992,92082,1252
2021-07-08,Alpine,003,1148,88,89,0,89,0
2021-07-08,Amador,005,37829,3776,3773,33,3806,47
2021-07-08,Butte,007,227075,12907,12764,1887,14651,202
2021-07-08,Calaveras,009,45235,2238,2214,13,2227,57
2021-07-08,Colusa,011,21464,1983,1969,329,2298,16
2021-07-08,Contra Costa,013,1133247,72161,71376,1332,72708,821
2021-07-08,Del Norte,015,27424,1495,1451,13,1464,8
2021-07-08,El Dorado,017,186661,10653,10508,795,11303,114
2021-07-08,Fresno,019,978130,103907,102675,8757,111432,1730
2021-07-08,Glenn,021,27897,2464,2440,569,3009,20
2021-07-08,Humboldt,023,135768,4621,4574,54,4628,51
2021-07-08,Imperial,025,180216,28908,28729,2698,31427,741
2021-07-08,Inyo,027,18085,1417,1415,12,1427,36
2021-07-08,Kern,029,883053,98293,97538,11156,108694,1346
2021-07-08,Kings,031,150075,23373,23090,1098,24188,246
2021-07-08,Lake,033,64148,3732,3667,13,3680,63
2021-07-08,Lassen,035,31185,5308,5290,117,5407,21
2021-07-08,Los Angeles,037,10098052,1222121,1212043,41968,1254011,24542
2021-07-08,Madera,039,155013,16917,16744,950,17694,241
2021-07-08,Marin,041,260295,14353,14194,261,14455,233
2021-07-08,Mariposa,043,17540,444,442,11,453,5
2021-07-08,Mendocino,045,87422,4259,4153,86,4239,49
2021-07-08,Merced,047,269075,31388,31328,1045,32373,470
2021-07-08,Modoc,049,8938,418,410,148,558,4
2021-07-08,Mono,051,14174,1271,1275,17,1292,3
2021-07-08,Monterey,053,433212,43471,43251,1863,45114,499
2021-07-08,Napa,055,140530,10125,10077,39,10116,81
2021-07-08,Nevada,057,99092,5079,5000,194,5194,72
2021-07-08,Orange,059,3164182,258375,256438,11594,268032,5135
2021-07-08,Placer,061,380077,24218,23916,1599,25515,302
2021-07-08,Plumas,063,18699,729,717,14,731,4
2021-07-08,Riverside,065,2383286,297305,293474,14100,307574,4541
2021-07-08,Sacramento,067,1510023,110103,109091,1877,110968,1682
2021-07-08,San Benito,069,59416,6160,6141,113,6254,63
2021-07-08,San Bernardino,071,2135413,296385,294932,9062,303994,5117
2021-07-08,San Diego,073,3302833,285631,283577,15774,299351,3783
2021-07-08,San Francisco,075,870044,37802,37338,1321,38659,559
2021-07-08,San Joaquin,077,732212,74773,74150,3647,77797,1412
2021-07-08,San Luis Obispo,079,281455,21650,21375,761,22136,258
2021-07-08,San Mateo,081,765935,43205,42948,495,43443,542
2021-07-08,Santa Barbara,083,443738,34809,34595,1132,35727,460
2021-07-08,Santa Clara,085,1922200,120354,119330,778,120108,2094
2021-07-08,Santa Cruz,087,273765,16422,16286,803,17089,207
2021-07-08,Shasta,089,179085,12690,12623,1653,14276,206
2021-07-08,Sierra,091,2930,66,61,12,73,0
2021-07-08,Siskiyou,093,43540,1996,1909,384,2293,29
2021-07-08,Solano,095,438530,33965,33678,595,34273,268
2021-07-08,Sonoma,097,501317,31475,31231,364,31595,317
2021-07-08,Stanislaus,099,539301,57412,57104,6025,63129,1026
2021-07-08,Sutter,101,95872,9724,9692,88,9780,114
2021-07-08,Tehama,103,63373,5175,5131,586,5717,63
2021-07-08,Trinity,105,12862,496,341,97,438,3
2021-07-08,Tulare,107,460477,50586,49850,9076,58926,853
2021-07-08,Tuolumne,109,53932,4124,4114,44,4158,64
2021-07-08,Ventura,111,848112,82330,81713,3125,84838,1039
2021-07-08,Yolo,113,214977,14373,14250,296,14546,213
2021-07-08,Yuba,115,75493,6314,6238,131,6369,52
2021-07-07,Alameda,001,1643700,90784,89995,1986,91981,1253
2021-07-07,Alpine,003,1148,88,89,0,89,0
2021-07-07,Amador,005,37829,3771,3770,33,3803,47
2021-07-07,Butte,007,227075,12894,12750,1882,14632,202
2021-07-07,Calaveras,009,45235,2231,2212,13,2225,57
2021-07-07,Colusa,011,21464,1979,1969,329,2298,16
2021-07-07,Contra Costa,013,1133247,72014,71308,1330,72638,821
2021-07-07,Del Norte,015,27424,1490,1446,13,1459,8
2021-07-07,El Dorado,017,186661,10633,10494,793,11287,114
2021-07-07,Fresno,019,978130,103857,102639,8750,111389,1729
2021-07-07,Glenn,021,27897,2464,2441,569,3010,20
2021-07-07,Humboldt,023,135768,4607,4566,54,4620,51
2021-07-07,Imperial,025,180216,28901,28701,2698,31399,740
2021-07-07,Inyo,027,18085,1416,1415,12,1427,36
2021-07-07,Kern,029,883053,98249,97507,11141,108648,1348
2021-07-07,Kings,031,150075,23360,23085,1095,24180,245
2021-07-07,Lake,033,64148,3713,3660,13,3673,63
2021-07-07,Lassen,035,31185,5308,5286,117,5403,21
2021-07-07,Los Angeles,037,10098052,1220941,1211316,41864,1253180,24531
2021-07-07,Madera,039,155013,16906,16733,948,17681,241
2021-07-07,Marin,041,260295,14334,14183,260,14443,233
2021-07-07,Mariposa,043,17540,442,442,11,453,5
2021-07-07,Mendocino,045,87422,4250,4145,86,4231,49
2021-07-07,Merced,047,269075,31373,31317,1045,32362,470
2021-07-07,Modoc,049,8938,418,410,148,558,4
2021-07-07,Mono,051,14174,1270,1274,17,1291,3
2021-07-07,Monterey,053,433212,43447,43233,1861,45094,494
2021-07-07,Napa,055,140530,10114,10078,39,10117,81
2021-07-07,Nevada,057,99092,5072,4996,194,5190,72
2021-07-07,Orange,059,3164182,258149,256301,11573,267874,5132
2021-07-07,Placer,061,380077,24182,23901,1589,25490,302
2021-07-07,Plumas,063,18699,729,710,14,724,4
2021-07-07,Riverside,065,2383286,297091,293331,14090,307421,4538
2021-07-07,Sacramento,067,1510023,109913,108954,1869,110823,1682
2021-07-07,San Benito,069,59416,6155,6137,113,6250,63
2021-07-07,San Bernardino,071,2135413,296216,294787,9055,303842,5087
2021-07-07,San Diego,073,3302833,285311,283377,15734,299111,3782
2021-07-07,San Francisco,075,870044,37710,37284,1318,38602,558
2021-07-07,San Joaquin,077,732212,74697,74095,3632,77727,1410
2021-07-07,San Luis Obispo,079,281455,21641,21360,759,22119,258
2021-07-07,San Mateo,081,765935,43151,42908,492,43400,542
2021-07-07,Santa Barbara,083,443738,34783,34582,1132,35714,460
2021-07-07,Santa Clara,085,1922200,120256,119250,777,120027,2094
2021-07-07,Santa Cruz,087,273765,16413,16279,802,17081,207
2021-07-07,Shasta,089,179085,12682,12613,1650,14263,206
2021-07-07,Sierra,091,2930,66,60,12,72,0
2021-07-07,Siskiyou,093,43540,1990,1908,380,2288,29
2021-07-07,Solano,095,438530,33916,33659,588,34247,268
2021-07-07,Sonoma,097,501317,31429,31172,364,31536,316
2021-07-07,Stanislaus,099,539301,57380,57102,6020,63122,1028
2021-07-07,Sutter,101,95872,9714,9683,88,9771,114
2021-07-07,Tehama,103,63373,5174,5129,586,5715,63
2021-07-07,Trinity,105,12862,496,341,97,438,3
2021-07-07,Tulare,107,460477,50582,49835,9067,58902,853
2021-07-07,Tuolumne,109,53932,4120,4115,43,4158,64
2021-07-07,Ventura,111,848112,82286,81608,3111,84719,1036
2021-07-07,Yolo,113,214977,14362,14236,293,14529,213
2021-07-07,Yuba,115,75493,6298,6233,131,6364,51
2021-07-06,Alameda,001,1643700,90587,89918,1978,91896,1253
2021-07-06,Alpine,003,1148,88,89,0,89,0
2021-07-06,Amador,005,37829,3770,3768,32,3800,47
2021-07-06,Butte,007,227075,12881,12744,1879,14623,201
2021-07-06,Calaveras,009,45235,2231,2211,13,2224,55
2021-07-06,Colusa,011,21464,1978,1967,326,2293,16
2021-07-06,Contra Costa,013,1133247,71885,71262,1327,72589,820
2021-07-06,Del Norte,015,27424,1486,1445,13,1458,8
2021-07-06,El Dorado,017,186661,10615,10484,791,11275,113
2021-07-06,Fresno,019,978130,103805,102616,8738,111354,1727
2021-07-06,Glenn,021,27897,2463,2438,569,3007,20
2021-07-06,Humboldt,023,135768,4593,4565,53,4618,49
2021-07-06,Imperial,025,180216,28886,28693,2696,31389,739
2021-07-06,Inyo,027,18085,1416,1412,12,1424,36
2021-07-06,Kern,029,883053,98207,97491,11130,108621,1346
2021-07-06,Kings,031,150075,23352,23077,1094,24171,245
2021-07-06,Lake,033,64148,3703,3659,13,3672,63
2021-07-06,Lassen,035,31185,5307,5288,116,5404,21
2021-07-06,Los Angeles,037,10098052,1219724,1210965,41766,1252731,24525
2021-07-06,Madera,039,155013,16894,16730,948,17678,241
2021-07-06,Marin,041,260295,14320,14181,260,14441,233
2021-07-06,Mariposa,043,17540,442,442,11,453,5
2021-07-06,Mendocino,045,87422,4243,4143,86,4229,49
2021-07-06,Merced,047,269075,31356,31317,1044,32361,470
2021-07-06,Modoc,049,8938,418,411,148,559,4
2021-07-06,Mono,051,14174,1269,1274,17,1291,3
2021-07-06,Monterey,053,433212,43425,43224,1859,45083,494
2021-07-06,Napa,055,140530,10103,10081,39,10120,81
2021-07-06,Nevada,057,99092,5063,4988,194,5182,72
2021-07-06,Orange,059,3164182,257905,256227,11556,267783,5129
2021-07-06,Placer,061,380077,24141,23876,1583,25459,302
2021-07-06,Plumas,063,18699,728,708,14,722,4
2021-07-06,Riverside,065,2383286,296889,293227,14072,307299,4539
2021-07-06,Sacramento,067,1510023,109702,108850,1861,110711,1679
2021-07-06,San Benito,069,59416,6151,6137,113,6250,63
2021-07-06,San Bernardino,071,2135413,296037,294712,9042,303754,5056
2021-07-06,San Diego,073,3302833,284953,283278,15675,298953,3782
2021-07-06,San Francisco,075,870044,37595,37251,1317,38568,558
2021-07-06,San Joaquin,077,732212,74627,74019,3620,77639,1410
2021-07-06,San Luis Obispo,079,281455,21624,21354,757,22111,257
2021-07-06,San Mateo,081,765935,43076,42895,492,43387,541
2021-07-06,Santa Barbara,083,443738,34764,34572,1131,35703,460
2021-07-06,Santa Clara,085,1922200,120138,119194,774,119968,2095
2021-07-06,Santa Cruz,087,273765,16408,16274,801,17075,207
2021-07-06,Shasta,089,179085,12672,12606,1648,14254,205
2021-07-06,Sierra,091,2930,65,60,12,72,0
2021-07-06,Siskiyou,093,43540,1987,1905,376,2281,29
2021-07-06,Solano,095,438530,33865,33619,585,34204,268
2021-07-06,Sonoma,097,501317,31366,31130,363,31493,316
2021-07-06,Stanislaus,099,539301,57332,57120,6009,63129,1029
2021-07-06,Sutter,101,95872,9705,9674,87,9761,114
2021-07-06,Tehama,103,63373,5171,5126,585,5711,63
2021-07-06,Trinity,105,12862,496,341,97,438,3
2021-07-06,Tulare,107,460477,50567,49826,9057,58883,853
2021-07-06,Tuolumne,109,53932,4118,4113,43,4156,64
2021-07-06,Ventura,111,848112,82246,81534,3086,84620,1033
2021-07-06,Yolo,113,214977,14340,14227,290,14517,213
2021-07-06,Yuba,115,75493,6287,6231,131,6362,51
2021-07-05,Alameda,001,1643700,90409,89892,1973,91865,1253
2021-07-05,Alpine,003,1148,88,89,0,89,0
2021-07-05,Amador,005,37829,3768,3768,32,3800,47
2021-07-05,Butte,007,227075,12873,12740,1870,14610,201
2021-07-05,Calaveras,009,45235,2229,2211,13,2224,55
2021-07-05,Colusa,011,21464,1976,1966,325,2291,16
2021-07-05,Contra Costa,013,1133247,71757,71235,1327,72562,820
2021-07-05,Del Norte,015,27424,1482,1446,13,1459,8
2021-07-05,El Dorado,017,186661,10590,10481,791,11272,113
2021-07-05,Fresno,019,978130,103746,102592,8723,111315,1727
2021-07-05,Glenn,021,27897,2460,2438,568,3006,20
2021-07-05,Humboldt,023,135768,4579,4563,53,4616,49
2021-07-05,Imperial,025,180216,28867,28689,2696,31385,739
2021-07-05,Inyo,027,18085,1416,1412,12,1424,36
2021-07-05,Kern,029,883053,98159,97479,11109,108588,1346
2021-07-05,Kings,031,150075,23344,23065,1091,24156,245
2021-07-05,Lake,033,64148,3685,3645,13,3658,63
2021-07-05,Lassen,035,31185,5304,5288,115,5403,21
2021-07-05,Los Angeles,037,10098052,1218528,1210653,41664,1252317,24522
2021-07-05,Madera,039,155013,16883,16722,947,17669,241
2021-07-05,Marin,041,260295,14299,14178,260,14438,233
2021-07-05,Mariposa,043,17540,442,441,11,452,5
2021-07-05,Mendocino,045,87422,4238,4139,86,4225,49
2021-07-05,Merced,047,269075,31336,31312,1044,32356,470
2021-07-05,Modoc,049,8938,418,410,148,558,4
2021-07-05,Mono,051,14174,1269,1273,17,1290,3
2021-07-05,Monterey,053,433212,43404,43218,1854,45072,494
2021-07-05,Napa,055,140530,10097,10074,39,10113,81
2021-07-05,Nevada,057,99092,5045,4980,193,5173,72
2021-07-05,Orange,059,3164182,257704,256173,11538,267711,5129
2021-07-05,Placer,061,380077,24094,23867,1575,25442,302
2021-07-05,Plumas,063,18699,727,708,14,722,4
2021-07-05,Riverside,065,2383286,296698,293193,14060,307253,4539
2021-07-05,Sacramento,067,1510023,109520,108758,1852,110610,1679
2021-07-05,San Benito,069,59416,6144,6137,113,6250,63
2021-07-05,San Bernardino,071,2135413,295875,294647,9036,303683,5037
2021-07-05,San Diego,073,3302833,284590,282834,15631,298465,3782
2021-07-05,San Francisco,075,870044,37508,37237,1312,38549,558
2021-07-05,San Joaquin,077,732212,74557,73999,3615,77614,1410
2021-07-05,San Luis Obispo,079,281455,21611,21351,756,22107,257
2021-07-05,San Mateo,081,765935,43024,42876,489,43365,541
2021-07-05,Santa Barbara,083,443738,34744,34569,1131,35700,460
2021-07-05,Santa Clara,085,1922200,120032,119184,772,119956,2095
2021-07-05,Santa Cruz,087,273765,16399,16273,800,17073,208
2021-07-05,Shasta,089,179085,12663,12603,1646,14249,205
2021-07-05,Sierra,091,2930,65,60,12,72,0
2021-07-05,Siskiyou,093,43540,1985,1904,375,2279,29
2021-07-05,Solano,095,438530,33795,33612,579,34191,268
2021-07-05,Sonoma,097,501317,31313,31116,363,31479,316
2021-07-05,Stanislaus,099,539301,57302,57109,5998,63107,1029
2021-07-05,Sutter,101,95872,9693,9667,87,9754,114
2021-07-05,Tehama,103,63373,5170,5125,585,5710,63
2021-07-05,Trinity,105,12862,495,341,96,437,3
2021-07-05,Tulare,107,460477,50549,49818,9054,58872,853
2021-07-05,Tuolumne,109,53932,4114,4112,43,4155,64
2021-07-05,Ventura,111,848112,82195,81519,3067,84586,1033
2021-07-05,Yolo,113,214977,14320,14225,282,14507,213
2021-07-05,Yuba,115,75493,6279,6223,131,6354,51
2021-07-04,Alameda,001,1643700,90245,89683,1970,91653,1253
2021-07-04,Alpine,003,1148,88,89,0,89,0
2021-07-04,Amador,005,37829,3767,3758,32,3790,46
2021-07-04,Butte,007,227075,12863,12684,1870,14554,201
2021-07-04,Calaveras,009,45235,2225,2200,13,2213,55
2021-07-04,Colusa,011,21464,1976,1969,325,2294,15
2021-07-04,Contra Costa,013,1133247,71651,70941,1322,72263,818
2021-07-04,Del Norte,015,27424,1479,1439,13,1452,8
2021-07-04,El Dorado,017,186661,10581,10433,790,11223,113
2021-07-04,Fresno,019,978130,103700,102512,8708,111220,1727
2021-07-04,Glenn,021,27897,2458,2442,567,3009,20
2021-07-04,Humboldt,023,135768,4571,4530,53,4583,49
2021-07-04,Imperial,025,180216,28861,28661,2696,31357,739
2021-07-04,Inyo,027,18085,1416,1412,12,1424,35
2021-07-04,Kern,029,883053,98140,97421,11100,108521,1347
2021-07-04,Kings,031,150075,23336,23051,1091,24142,245
2021-07-04,Lake,033,64148,3675,3623,13,3636,62
2021-07-04,Lassen,035,31185,5303,5277,115,5392,20
2021-07-04,Los Angeles,037,10098052,1217667,1208705,41579,1250284,24506
2021-07-04,Madera,039,155013,16871,16696,946,17642,240
2021-07-04,Marin,041,260295,14284,14143,260,14403,233
2021-07-04,Mariposa,043,17540,442,441,11,452,5
2021-07-04,Mendocino,045,87422,4228,4122,86,4208,49
2021-07-04,Merced,047,269075,31325,31297,1044,32341,469
2021-07-04,Modoc,049,8938,418,410,148,558,4
2021-07-04,Mono,051,14174,1269,1275,17,1292,3
2021-07-04,Monterey,053,433212,43388,43212,1853,45065,492
2021-07-04,Napa,055,140530,10089,10045,38,10083,81
2021-07-04,Nevada,057,99092,5035,4966,193,5159,72
2021-07-04,Orange,059,3164182,257529,255823,11518,267341,5126
2021-07-04,Placer,061,380077,24057,23764,1569,25333,299
2021-07-04,Plumas,063,18699,727,707,14,721,4
2021-07-04,Riverside,065,2383286,296538,293260,14054,307314,4536
2021-07-04,Sacramento,067,1510023,109350,108257,1846,110103,1676
2021-07-04,San Benito,069,59416,6137,6108,113,6221,63
2021-07-04,San Bernardino,071,2135413,295708,294294,9029,303323,5003
2021-07-04,San Diego,073,3302833,284365,282692,15594,298286,3780
2021-07-04,San Francisco,075,870044,37449,37107,1306,38413,558
2021-07-04,San Joaquin,077,732212,74491,73841,3607,77448,1409
2021-07-04,San Luis Obispo,079,281455,21605,21330,755,22085,256
2021-07-04,San Mateo,081,765935,42990,42691,489,43180,541
2021-07-04,Santa Barbara,083,443738,34721,34526,1130,35656,456
2021-07-04,Santa Clara,085,1922200,119942,118966,771,119737,2090
2021-07-04,Santa Cruz,087,273765,16388,16254,800,17054,208
2021-07-04,Shasta,089,179085,12659,12582,1645,14227,204
2021-07-04,Sierra,091,2930,64,60,12,72,0
2021-07-04,Siskiyou,093,43540,1981,1899,374,2273,29
2021-07-04,Solano,095,438530,33754,33486,577,34063,268
2021-07-04,Sonoma,097,501317,31283,31000,363,31363,316
2021-07-04,Stanislaus,099,539301,57287,57018,5992,63010,1018
2021-07-04,Sutter,101,95872,9682,9644,87,9731,114
2021-07-04,Tehama,103,63373,5166,5124,585,5709,63
2021-07-04,Trinity,105,12862,494,341,96,437,3
2021-07-04,Tulare,107,460477,50539,49789,9051,58840,853
2021-07-04,Tuolumne,109,53932,4106,4113,43,4156,64
2021-07-04,Ventura,111,848112,82137,81425,3056,84481,1033
2021-07-04,Yolo,113,214977,14299,14188,279,14467,213
2021-07-04,Yuba,115,75493,6271,6197,131,6328,51
2021-07-03,Alameda,001,1643700,90158,89683,1962,91645,1253
2021-07-03,Alpine,003,1148,88,89,0,89,0
2021-07-03,Amador,005,37829,3767,3758,32,3790,46
2021-07-03,Butte,007,227075,12859,12684,1869,14553,201
2021-07-03,Calaveras,009,45235,2223,2200,13,2213,55
2021-07-03,Colusa,011,21464,1975,1969,325,2294,15
2021-07-03,Contra Costa,013,1133247,71591,70941,1319,72260,818
2021-07-03,Del Norte,015,27424,1476,1439,13,1452,8
2021-07-03,El Dorado,017,186661,10575,10433,788,11221,113
2021-07-03,Fresno,019,978130,103676,102512,8699,111211,1727
2021-07-03,Glenn,021,27897,2458,2442,567,3009,20
2021-07-03,Humboldt,023,135768,4566,4530,53,4583,49
2021-07-03,Imperial,025,180216,28851,28661,2696,31357,739
2021-07-03,Inyo,027,18085,1416,1412,12,1424,35
2021-07-03,Kern,029,883053,98120,97421,11092,108513,1347
2021-07-03,Kings,031,150075,23336,23051,1090,24141,245
2021-07-03,Lake,033,64148,3665,3623,13,3636,62
2021-07-03,Lassen,035,31185,5302,5277,115,5392,20
2021-07-03,Los Angeles,037,10098052,1217238,1208705,41548,1250253,24506
2021-07-03,Madera,039,155013,16862,16696,943,17639,240
2021-07-03,Marin,041,260295,14280,14143,260,14403,233
2021-07-03,Mariposa,043,17540,442,441,11,452,5
2021-07-03,Mendocino,045,87422,4227,4122,86,4208,49
2021-07-03,Merced,047,269075,31312,31297,1043,32340,469
2021-07-03,Modoc,049,8938,417,410,148,558,4
2021-07-03,Mono,051,14174,1268,1275,17,1292,3
2021-07-03,Monterey,053,433212,43376,43212,1851,45063,492
2021-07-03,Napa,055,140530,10084,10045,38,10083,81
2021-07-03,Nevada,057,99092,5021,4966,193,5159,72
2021-07-03,Orange,059,3164182,257445,255823,11511,267334,5126
2021-07-03,Placer,061,380077,24038,23764,1566,25330,299
2021-07-03,Plumas,063,18699,727,707,14,721,4
2021-07-03,Riverside,065,2383286,296446,293260,14050,307310,4536
2021-07-03,Sacramento,067,1510023,109276,108257,1843,110100,1676
2021-07-03,San Benito,069,59416,6130,6108,113,6221,63
2021-07-03,San Bernardino,071,2135413,295618,294294,9026,303320,5003
2021-07-03,San Diego,073,3302833,284234,282692,15575,298267,3780
2021-07-03,San Francisco,075,870044,37408,37107,1303,38410,558
2021-07-03,San Joaquin,077,732212,74455,73841,3602,77443,1409
2021-07-03,San Luis Obispo,079,281455,21593,21330,755,22085,256
2021-07-03,San Mateo,081,765935,42965,42691,488,43179,541
2021-07-03,Santa Barbara,083,443738,34712,34526,1129,35655,456
2021-07-03,Santa Clara,085,1922200,119895,118966,771,119737,2090
2021-07-03,Santa Cruz,087,273765,16381,16254,800,17054,208
2021-07-03,Shasta,089,179085,12655,12582,1643,14225,204
2021-07-03,Sierra,091,2930,64,60,12,72,0
2021-07-03,Siskiyou,093,43540,1980,1899,373,2272,29
2021-07-03,Solano,095,438530,33710,33486,577,34063,268
2021-07-03,Sonoma,097,501317,31249,31000,363,31363,316
2021-07-03,Stanislaus,099,539301,57276,57018,5985,63003,1018
2021-07-03,Sutter,101,95872,9672,9644,87,9731,114
2021-07-03,Tehama,103,63373,5164,5124,585,5709,63
2021-07-03,Trinity,105,12862,494,341,96,437,3
2021-07-03,Tulare,107,460477,50533,49789,9045,58834,853
2021-07-03,Tuolumne,109,53932,4105,4113,43,4156,64
2021-07-03,Ventura,111,848112,82107,81425,3048,84473,1033
2021-07-03,Yolo,113,214977,14289,14188,276,14464,213
2021-07-03,Yuba,115,75493,6265,6197,131,6328,51
2021-07-02,Alameda,001,1643700,90075,89683,1961,91644,1253
2021-07-02,Alpine,003,1148,88,89,0,89,0
2021-07-02,Amador,005,37829,3765,3758,32,3790,46
2021-07-02,Butte,007,227075,12852,12684,1869,14553,201
2021-07-02,Calaveras,009,45235,2221,2200,13,2213,55
2021-07-02,Colusa,011,21464,1974,1969,324,2293,15
2021-07-02,Contra Costa,013,1133247,71521,70941,1315,72256,818
2021-07-02,Del Norte,015,27424,1476,1439,13,1452,8
2021-07-02,El Dorado,017,186661,10567,10433,788,11221,113
2021-07-02,Fresno,019,978130,103648,102512,8693,111205,1727
2021-07-02,Glenn,021,27897,2457,2442,566,3008,20
2021-07-02,Humboldt,023,135768,4563,4530,52,4582,49
2021-07-02,Imperial,025,180216,28845,28661,2695,31356,739
2021-07-02,Inyo,027,18085,1416,1412,12,1424,35
2021-07-02,Kern,029,883053,98102,97421,11084,108505,1347
2021-07-02,Kings,031,150075,23326,23051,1090,24141,245
2021-07-02,Lake,033,64148,3659,3623,13,3636,62
2021-07-02,Lassen,035,31185,5302,5277,115,5392,20
2021-07-02,Los Angeles,037,10098052,1216765,1208705,41509,1250214,24506
2021-07-02,Madera,039,155013,16853,16696,942,17638,240
2021-07-02,Marin,041,260295,14276,14143,260,14403,233
2021-07-02,Mariposa,043,17540,442,441,11,452,5
2021-07-02,Mendocino,045,87422,4223,4122,85,4207,49
2021-07-02,Merced,047,269075,31303,31297,1043,32340,469
2021-07-02,Modoc,049,8938,417,410,148,558,4
2021-07-02,Mono,051,14174,1267,1275,17,1292,3
2021-07-02,Monterey,053,433212,43368,43212,1850,45062,492
2021-07-02,Napa,055,140530,10079,10045,38,10083,81
2021-07-02,Nevada,057,99092,5012,4966,193,5159,72
2021-07-02,Orange,059,3164182,257334,255823,11504,267327,5126
2021-07-02,Placer,061,380077,24021,23764,1559,25323,299
2021-07-02,Plumas,063,18699,727,707,14,721,4
2021-07-02,Riverside,065,2383286,296348,293260,14045,307305,4536
2021-07-02,Sacramento,067,1510023,109198,108257,1842,110099,1676
2021-07-02,San Benito,069,59416,6127,6108,113,6221,63
2021-07-02,San Bernardino,071,2135413,295531,294294,9024,303318,5003
2021-07-02,San Diego,073,3302833,284089,282692,15549,298241,3780
2021-07-02,San Francisco,075,870044,37360,37107,1301,38408,558
2021-07-02,San Joaquin,077,732212,74423,73841,3596,77437,1409
2021-07-02,San Luis Obispo,079,281455,21587,21330,754,22084,256
2021-07-02,San Mateo,081,765935,42929,42691,488,43179,541
2021-07-02,Santa Barbara,083,443738,34702,34526,1129,35655,456
2021-07-02,Santa Clara,085,1922200,119817,118966,771,119737,2090
2021-07-02,Santa Cruz,087,273765,16377,16254,800,17054,208
2021-07-02,Shasta,089,179085,12651,12582,1643,14225,204
2021-07-02,Sierra,091,2930,63,60,12,72,0
2021-07-02,Siskiyou,093,43540,1977,1899,372,2271,29
2021-07-02,Solano,095,438530,33685,33486,577,34063,268
2021-07-02,Sonoma,097,501317,31226,31000,363,31363,316
2021-07-02,Stanislaus,099,539301,57259,57018,5984,63002,1018
2021-07-02,Sutter,101,95872,9668,9644,87,9731,114
2021-07-02,Tehama,103,63373,5162,5124,583,5707,63
2021-07-02,Trinity,105,12862,494,341,96,437,3
2021-07-02,Tulare,107,460477,50523,49789,9037,58826,853
2021-07-02,Tuolumne,109,53932,4102,4113,43,4156,64
2021-07-02,Ventura,111,848112,82064,81425,3040,84465,1033
2021-07-02,Yolo,113,214977,14273,14188,274,14462,213
2021-07-02,Yuba,115,75493,6257,6197,131,6328,51
2021-07-01,Alameda,001,1643700,89975,89683,1959,91642,1253
2021-07-01,Alpine,003,1148,88,89,0,89,0
2021-07-01,Amador,005,37829,3764,3758,32,3790,46
2021-07-01,Butte,007,227075,12840,12684,1867,14551,201
2021-07-01,Calaveras,009,45235,2219,2200,13,2213,55
2021-07-01,Colusa,011,21464,1974,1969,322,2291,15
2021-07-01,Contra Costa,013,1133247,71449,70941,1315,72256,818
2021-07-01,Del Norte,015,27424,1475,1439,13,1452,8
2021-07-01,El Dorado,017,186661,10555,10433,788,11221,113
2021-07-01,Fresno,019,978130,103609,102512,8688,111200,1727
2021-07-01,Glenn,021,27897,2457,2442,566,3008,20
2021-07-01,Humboldt,023,135768,4561,4530,52,4582,49
2021-07-01,Imperial,025,180216,28828,28661,2695,31356,739
2021-07-01,Inyo,027,18085,1416,1412,12,1424,35
2021-07-01,Kern,029,883053,98076,97421,11074,108495,1347
2021-07-01,Kings,031,150075,23312,23051,1090,24141,245
2021-07-01,Lake,033,64148,3656,3623,13,3636,62
2021-07-01,Lassen,035,31185,5300,5277,115,5392,20
2021-07-01,Los Angeles,037,10098052,1216161,1208705,41454,1250159,24506
2021-07-01,Madera,039,155013,16844,16696,941,17637,240
2021-07-01,Marin,041,260295,14272,14143,260,14403,233
2021-07-01,Mariposa,043,17540,442,441,11,452,5
2021-07-01,Mendocino,045,87422,4219,4122,84,4206,49
2021-07-01,Merced,047,269075,31297,31297,1043,32340,469
2021-07-01,Modoc,049,8938,417,410,148,558,4
2021-07-01,Mono,051,14174,1266,1275,17,1292,3
2021-07-01,Monterey,053,433212,43360,43212,1847,45059,492
2021-07-01,Napa,055,140530,10072,10045,38,10083,81
2021-07-01,Nevada,057,99092,5007,4966,193,5159,72
2021-07-01,Orange,059,3164182,257213,255823,11485,267308,5126
2021-07-01,Placer,061,380077,24002,23764,1556,25320,299
2021-07-01,Plumas,063,18699,724,707,12,719,4
2021-07-01,Riverside,065,2383286,296239,293260,14037,307297,4536
2021-07-01,Sacramento,067,1510023,109072,108257,1835,110092,1676
2021-07-01,San Benito,069,59416,6123,6108,113,6221,63
2021-07-01,San Bernardino,071,2135413,295410,294294,9019,303313,5003
2021-07-01,San Diego,073,3302833,283911,282692,15512,298204,3780
2021-07-01,San Francisco,075,870044,37324,37107,1299,38406,558
2021-07-01,San Joaquin,077,732212,74372,73841,3592,77433,1409
2021-07-01,San Luis Obispo,079,281455,21572,21330,753,22083,256
2021-07-01,San Mateo,081,765935,42901,42691,487,43178,541
2021-07-01,Santa Barbara,083,443738,34689,34526,1129,35655,456
2021-07-01,Santa Clara,085,1922200,119768,118966,771,119737,2090
2021-07-01,Santa Cruz,087,273765,16372,16254,800,17054,208
2021-07-01,Shasta,089,179085,12643,12582,1642,14224,204
2021-07-01,Sierra,091,2930,63,60,12,72,0
2021-07-01,Siskiyou,093,43540,1977,1899,372,2271,29
2021-07-01,Solano,095,438530,33644,33486,576,34062,268
2021-07-01,Sonoma,097,501317,31182,31000,363,31363,316
2021-07-01,Stanislaus,099,539301,57241,57018,5980,62998,1018
2021-07-01,Sutter,101,95872,9659,9644,87,9731,114
2021-07-01,Tehama,103,63373,5162,5124,582,5706,63
2021-07-01,Trinity,105,12862,494,341,96,437,3
2021-07-01,Tulare,107,460477,50514,49789,9030,58819,853
2021-07-01,Tuolumne,109,53932,4095,4113,43,4156,64
2021-07-01,Ventura,111,848112,82033,81425,3030,84455,1033
2021-07-01,Yolo,113,214977,14257,14188,272,14460,213
2021-07-01,Yuba,115,75493,6250,6197,131,6328,51
2021-06-30,Alameda,001,1643700,89896,89597,1955,91552,1256
2021-06-30,Alpine,003,1148,88,89,0,89,0
2021-06-30,Amador,005,37829,3762,3756,32,3788,46
2021-06-30,Butte,007,227075,12833,12676,1858,14534,201
2021-06-30,Calaveras,009,45235,2213,2198,13,2211,55
2021-06-30,Colusa,011,21464,1972,1967,319,2286,15
2021-06-30,Contra Costa,013,1133247,71384,70869,1312,72181,818
2021-06-30,Del Norte,015,27424,1470,1435,13,1448,8
2021-06-30,El Dorado,017,186661,10535,10420,788,11208,113
2021-06-30,Fresno,019,978130,103572,102490,8685,111175,1727
2021-06-30,Glenn,021,27897,2455,2440,566,3006,20
2021-06-30,Humboldt,023,135768,4545,4522,50,4572,49
2021-06-30,Imperial,025,180216,28820,28651,2695,31346,739
2021-06-30,Inyo,027,18085,1416,1409,12,1421,35
2021-06-30,Kern,029,883053,98035,97267,11062,108329,1348
2021-06-30,Kings,031,150075,23307,23038,1089,24127,245
2021-06-30,Lake,033,64148,3643,3601,13,3614,56
2021-06-30,Lassen,035,31185,5295,5269,115,5384,20
2021-06-30,Los Angeles,037,10098052,1215487,1208246,41409,1249655,24499
2021-06-30,Madera,039,155013,16836,16688,939,17627,240
2021-06-30,Marin,041,260295,14263,14133,259,14392,232
2021-06-30,Mariposa,043,17540,441,441,11,452,5
2021-06-30,Mendocino,045,87422,4209,4115,84,4199,49
2021-06-30,Merced,047,269075,31287,31286,1043,32329,469
2021-06-30,Modoc,049,8938,417,410,148,558,4
2021-06-30,Mono,051,14174,1266,1275,17,1292,3
2021-06-30,Monterey,053,433212,43355,43209,1845,45054,492
2021-06-30,Napa,055,140530,10064,10039,38,10077,81
2021-06-30,Nevada,057,99092,4996,4958,193,5151,72
2021-06-30,Orange,059,3164182,257086,255764,11475,267239,5125
2021-06-30,Placer,061,380077,23978,23721,1553,25274,299
2021-06-30,Plumas,063,18699,724,705,12,717,4
2021-06-30,Riverside,065,2383286,296125,293280,14029,307309,4535
2021-06-30,Sacramento,067,1510023,108933,108137,1831,109968,1676
2021-06-30,San Benito,069,59416,6119,6105,113,6218,63
2021-06-30,San Bernardino,071,2135413,295250,294211,9014,303225,4975
2021-06-30,San Diego,073,3302833,283775,282583,15484,298067,3780
2021-06-30,San Francisco,075,870044,37275,37065,1294,38359,558
2021-06-30,San Joaquin,077,732212,74310,73777,3591,77368,1409
2021-06-30,San Luis Obispo,079,281455,21559,21326,752,22078,256
2021-06-30,San Mateo,081,765935,42864,42599,486,43085,537
2021-06-30,Santa Barbara,083,443738,34673,34521,1129,35650,456
2021-06-30,Santa Clara,085,1922200,119721,118930,768,119698,2090
2021-06-30,Santa Cruz,087,273765,16366,16250,800,17050,208
2021-06-30,Shasta,089,179085,12637,12564,1642,14206,204
2021-06-30,Sierra,091,2930,63,60,12,72,0
2021-06-30,Siskiyou,093,43540,1975,1900,369,2269,29
2021-06-30,Solano,095,438530,33605,33453,574,34027,268
2021-06-30,Sonoma,097,501317,31152,30947,363,31310,316
2021-06-30,Stanislaus,099,539301,57224,56997,5979,62976,1018
2021-06-30,Sutter,101,95872,9649,9638,87,9725,114
2021-06-30,Tehama,103,63373,5160,5124,582,5706,63
2021-06-30,Trinity,105,12862,494,341,96,437,3
2021-06-30,Tulare,107,460477,50503,49764,9019,58783,853
2021-06-30,Tuolumne,109,53932,4092,4112,43,4155,64
2021-06-30,Ventura,111,848112,81990,81392,3025,84417,1032
2021-06-30,Yolo,113,214977,14251,14178,269,14447,213
2021-06-30,Yuba,115,75493,6243,6191,131,6322,51
2021-06-29,Alameda,001,1643700,89790,89519,1953,91472,1257
2021-06-29,Alpine,003,1148,88,89,0,89,0
2021-06-29,Amador,005,37829,3758,3754,32,3786,46
2021-06-29,Butte,007,227075,12825,12669,1858,14527,201
2021-06-29,Calaveras,009,45235,2207,2198,13,2211,55
2021-06-29,Colusa,011,21464,1970,1967,319,2286,15
2021-06-29,Contra Costa,013,1133247,71310,70775,1311,72086,817
2021-06-29,Del Norte,015,27424,1469,1435,13,1448,8
2021-06-29,El Dorado,017,186661,10522,10403,784,11187,113
2021-06-29,Fresno,019,978130,103539,102464,8682,111146,1725
2021-06-29,Glenn,021,27897,2454,2439,566,3005,20
2021-06-29,Humboldt,023,135768,4541,4514,49,4563,49
2021-06-29,Imperial,025,180216,28811,28645,2694,31339,737
2021-06-29,Inyo,027,18085,1416,1408,12,1420,35
2021-06-29,Kern,029,883053,98014,97173,11056,108229,1347
2021-06-29,Kings,031,150075,23298,23035,1088,24123,245
2021-06-29,Lake,033,64148,3637,3594,13,3607,56
2021-06-29,Lassen,035,31185,5288,5268,115,5383,20
2021-06-29,Los Angeles,037,10098052,1214872,1207895,41381,1249276,24498
2021-06-29,Madera,039,155013,16832,16680,938,17618,240
2021-06-29,Marin,041,260295,14251,14127,259,14386,232
2021-06-29,Mariposa,043,17540,441,441,11,452,5
2021-06-29,Mendocino,045,87422,4205,4107,83,4190,49
2021-06-29,Merced,047,269075,31275,31277,1043,32320,469
2021-06-29,Modoc,049,8938,416,408,148,556,3
2021-06-29,Mono,051,14174,1266,1275,17,1292,3
2021-06-29,Monterey,053,433212,43345,43196,1843,45039,471
2021-06-29,Napa,055,140530,10058,10033,38,10071,81
2021-06-29,Nevada,057,99092,4989,4952,193,5145,72
2021-06-29,Orange,059,3164182,256986,255686,11460,267146,5124
2021-06-29,Placer,061,380077,23958,23693,1551,25244,299
2021-06-29,Plumas,063,18699,724,704,12,716,4
2021-06-29,Riverside,065,2383286,296026,292962,14022,306984,4524
2021-06-29,Sacramento,067,1510023,108780,108067,1828,109895,1677
2021-06-29,San Benito,069,59416,6108,6099,113,6212,63
2021-06-29,San Bernardino,071,2135413,295138,294118,9013,303131,4940
2021-06-29,San Diego,073,3302833,283619,282499,15457,297956,3780
2021-06-29,San Francisco,075,870044,37237,37041,1291,38332,558
2021-06-29,San Joaquin,077,732212,74262,73724,3588,77312,1409
2021-06-29,San Luis Obispo,079,281455,21549,21324,751,22075,256
2021-06-29,San Mateo,081,765935,42830,42540,486,43026,540
2021-06-29,Santa Barbara,083,443738,34663,34507,1128,35635,455
2021-06-29,Santa Clara,085,1922200,119667,118893,767,119660,2090
2021-06-29,Santa Cruz,087,273765,16360,16249,800,17049,208
2021-06-29,Shasta,089,179085,12625,12564,1641,14205,204
2021-06-29,Sierra,091,2930,63,59,12,71,0
2021-06-29,Siskiyou,093,43540,1972,1897,365,2262,29
2021-06-29,Solano,095,438530,33572,33440,572,34012,268
2021-06-29,Sonoma,097,501317,31110,30950,361,31311,316
2021-06-29,Stanislaus,099,539301,57203,56980,5972,62952,1018
2021-06-29,Sutter,101,95872,9638,9634,87,9721,114
2021-06-29,Tehama,103,63373,5160,5124,582,5706,63
2021-06-29,Trinity,105,12862,494,341,96,437,3
2021-06-29,Tulare,107,460477,50490,49751,9014,58765,852
2021-06-29,Tuolumne,109,53932,4090,4111,43,4154,64
2021-06-29,Ventura,111,848112,81952,81363,3019,84382,1032
2021-06-29,Yolo,113,214977,14239,14171,268,14439,213
2021-06-29,Yuba,115,75493,6233,6188,131,6319,51
2021-06-28,Alameda,001,1643700,89696,89638,1950,91588,1259
2021-06-28,Alpine,003,1148,88,89,0,89,0
2021-06-28,Amador,005,37829,3757,3753,32,3785,46
2021-06-28,Butte,007,227075,12816,12697,1856,14553,198
2021-06-28,Calaveras,009,45235,2204,2203,13,2216,55
2021-06-28,Colusa,011,21464,1968,1974,319,2293,15
2021-06-28,Contra Costa,013,1133247,71236,70807,1309,72116,816
2021-06-28,Del Norte,015,27424,1469,1436,13,1449,8
2021-06-28,El Dorado,017,186661,10512,10422,780,11202,115
2021-06-28,Fresno,019,978130,103508,103121,8680,111801,1727
2021-06-28,Glenn,021,27897,2454,2439,566,3005,20
2021-06-28,Humboldt,023,135768,4534,4520,48,4568,49
2021-06-28,Imperial,025,180216,28803,28981,2693,31674,741
2021-06-28,Inyo,027,18085,1413,1407,12,1419,35
2021-06-28,Kern,029,883053,97995,97252,11051,108303,1348
2021-06-28,Kings,031,150075,23292,23134,1088,24222,246
2021-06-28,Lake,033,64148,3629,3591,13,3604,56
2021-06-28,Lassen,035,31185,5286,5268,115,5383,20
2021-06-28,Los Angeles,037,10098052,1214353,1207714,41346,1249060,24496
2021-06-28,Madera,039,155013,16821,16683,937,17620,240
2021-06-28,Marin,041,260295,14236,14186,259,14445,232
2021-06-28,Mariposa,043,17540,441,440,11,451,5
2021-06-28,Mendocino,045,87422,4196,4102,82,4184,49
2021-06-28,Merced,047,269075,31263,31277,1043,32320,469
2021-06-28,Modoc,049,8938,416,411,147,558,3
2021-06-28,Mono,051,14174,1266,1276,17,1293,3
2021-06-28,Monterey,053,433212,43341,43202,1842,45044,462
2021-06-28,Napa,055,140530,10049,10050,37,10087,81
2021-06-28,Nevada,057,99092,4985,4951,193,5144,72
2021-06-28,Orange,059,3164182,256896,255755,11446,267201,5123
2021-06-28,Placer,061,380077,23938,23756,1547,25303,299
2021-06-28,Plumas,063,18699,722,704,12,716,4
2021-06-28,Riverside,065,2383286,295900,292647,14010,306657,4507
2021-06-28,Sacramento,067,1510023,108648,108342,1823,110165,1675
2021-06-28,San Benito,069,59416,6106,6101,113,6214,63
2021-06-28,San Bernardino,071,2135413,295037,294151,9008,303159,4928
2021-06-28,San Diego,073,3302833,283455,282417,15428,297845,3780
2021-06-28,San Francisco,075,870044,37201,37372,1289,38661,559
2021-06-28,San Joaquin,077,732212,74215,73973,3585,77558,1411
2021-06-28,San Luis Obispo,079,281455,21545,21340,750,22090,256
2021-06-28,San Mateo,081,765935,42796,42927,485,43412,540
2021-06-28,Santa Barbara,083,443738,34656,34534,1126,35660,455
2021-06-28,Santa Clara,085,1922200,119603,120377,766,121143,2103
2021-06-28,Santa Cruz,087,273765,16355,16245,800,17045,208
2021-06-28,Shasta,089,179085,12621,12642,1639,14281,203
2021-06-28,Sierra,091,2930,63,58,12,70,0
2021-06-28,Siskiyou,093,43540,1971,1896,365,2261,29
2021-06-28,Solano,095,438530,33536,33524,570,34094,267
2021-06-28,Sonoma,097,501317,31073,31137,360,31497,315
2021-06-28,Stanislaus,099,539301,57185,57047,5968,63015,1018
2021-06-28,Sutter,101,95872,9634,9682,87,9769,114
2021-06-28,Tehama,103,63373,5158,5122,582,5704,63
2021-06-28,Trinity,105,12862,494,341,96,437,3
2021-06-28,Tulare,107,460477,50480,49751,9010,58761,850
2021-06-28,Tuolumne,109,53932,4082,4121,43,4164,64
2021-06-28,Ventura,111,848112,81895,81393,3014,84407,1032
2021-06-28,Yolo,113,214977,14230,14199,265,14464,213
2021-06-28,Yuba,115,75493,6228,6207,131,6338,51
2021-06-27,Alameda,001,1643700,89609,89611,1946,91557,1259
2021-06-27,Alpine,003,1148,88,89,0,89,0
2021-06-27,Amador,005,37829,3756,3752,32,3784,46
2021-06-27,Butte,007,227075,12807,12696,1855,14551,198
2021-06-27,Calaveras,009,45235,2203,2203,13,2216,55
2021-06-27,Colusa,011,21464,1968,1974,319,2293,15
2021-06-27,Contra Costa,013,1133247,71150,70762,1305,72067,816
2021-06-27,Del Norte,015,27424,1466,1436,13,1449,8
2021-06-27,El Dorado,017,186661,10500,10418,777,11195,115
2021-06-27,Fresno,019,978130,103479,103110,8678,111788,1727
2021-06-27,Glenn,021,27897,2453,2439,565,3004,20
2021-06-27,Humboldt,023,135768,4522,4513,45,4558,49
2021-06-27,Imperial,025,180216,28789,28987,2693,31680,741
2021-06-27,Inyo,027,18085,1413,1407,12,1419,35
2021-06-27,Kern,029,883053,97969,97249,11044,108293,1348
2021-06-27,Kings,031,150075,23282,23132,1088,24220,246
2021-06-27,Lake,033,64148,3622,3581,13,3594,56
2021-06-27,Lassen,035,31185,5285,5265,115,5380,20
2021-06-27,Los Angeles,037,10098052,1213801,1207461,41306,1248767,24493
2021-06-27,Madera,039,155013,16813,16680,937,17617,240
2021-06-27,Marin,041,260295,14227,14182,259,14441,232
2021-06-27,Mariposa,043,17540,441,440,11,451,5
2021-06-27,Mendocino,045,87422,4189,4100,82,4182,49
2021-06-27,Merced,047,269075,31251,31266,1043,32309,469
2021-06-27,Modoc,049,8938,416,411,147,558,3
2021-06-27,Mono,051,14174,1266,1279,17,1296,3
2021-06-27,Monterey,053,433212,43328,43199,1842,45041,462
2021-06-27,Napa,055,140530,10043,10046,37,10083,81
2021-06-27,Nevada,057,99092,4979,4946,193,5139,72
2021-06-27,Orange,059,3164182,256782,255710,11435,267145,5123
2021-06-27,Placer,061,380077,23905,23731,1544,25275,299
2021-06-27,Plumas,063,18699,722,704,12,716,4
2021-06-27,Riverside,065,2383286,295798,292641,14004,306645,4507
2021-06-27,Sacramento,067,1510023,108513,108279,1819,110098,1675
2021-06-27,San Benito,069,59416,6100,6101,113,6214,63
2021-06-27,San Bernardino,071,2135413,294924,294115,9006,303121,4927
2021-06-27,San Diego,073,3302833,283315,282359,15402,297761,3780
2021-06-27,San Francisco,075,870044,37164,37360,1288,38648,559
2021-06-27,San Joaquin,077,732212,74179,73960,3583,77543,1411
2021-06-27,San Luis Obispo,079,281455,21538,21340,749,22089,256
2021-06-27,San Mateo,081,765935,42767,42925,482,43407,539
2021-06-27,Santa Barbara,083,443738,34642,34533,1124,35657,455
2021-06-27,Santa Clara,085,1922200,119552,120352,765,121117,2103
2021-06-27,Santa Cruz,087,273765,16346,16241,800,17041,208
2021-06-27,Shasta,089,179085,12615,12640,1638,14278,203
2021-06-27,Sierra,091,2930,63,58,12,70,0
2021-06-27,Siskiyou,093,43540,1969,1896,364,2260,29
2021-06-27,Solano,095,438530,33508,33516,570,34086,267
2021-06-27,Sonoma,097,501317,31035,31129,360,31489,315
2021-06-27,Stanislaus,099,539301,57145,57021,5965,62986,1018
2021-06-27,Sutter,101,95872,9628,9678,87,9765,114
2021-06-27,Tehama,103,63373,5154,5122,582,5704,63
2021-06-27,Trinity,105,12862,494,341,95,436,3
2021-06-27,Tulare,107,460477,50467,49749,9003,58752,850
2021-06-27,Tuolumne,109,53932,4080,4121,43,4164,64
2021-06-27,Ventura,111,848112,81861,81361,3005,84366,1032
2021-06-27,Yolo,113,214977,14215,14194,261,14455,213
2021-06-27,Yuba,115,75493,6222,6205,131,6336,51
2021-06-26,Alameda,001,1643700,89552,89560,1944,91504,1259
2021-06-26,Alpine,003,1148,88,89,0,89,0
2021-06-26,Amador,005,37829,3756,3748,32,3780,46
2021-06-26,Butte,007,227075,12803,12693,1852,14545,198
2021-06-26,Calaveras,009,45235,2201,2202,13,2215,55
2021-06-26,Colusa,011,21464,1968,1973,319,2292,15
2021-06-26,Contra Costa,013,1133247,71107,70712,1304,72016,816
2021-06-26,Del Norte,015,27424,1465,1432,13,1445,8
2021-06-26,El Dorado,017,186661,10492,10414,775,11189,115
2021-06-26,Fresno,019,978130,103459,103091,8676,111767,1727
2021-06-26,Glenn,021,27897,2451,2441,565,3006,20
2021-06-26,Humboldt,023,135768,4519,4509,45,4554,49
2021-06-26,Imperial,025,180216,28785,28970,2693,31663,741
2021-06-26,Inyo,027,18085,1413,1407,12,1419,35
2021-06-26,Kern,029,883053,97943,97239,11035,108274,1348
2021-06-26,Kings,031,150075,23278,23128,1087,24215,246
2021-06-26,Lake,033,64148,3611,3576,13,3589,56
2021-06-26,Lassen,035,31185,5282,5263,115,5378,20
2021-06-26,Los Angeles,037,10098052,1213496,1207198,41274,1248472,24490
2021-06-26,Madera,039,155013,16806,16679,936,17615,240
2021-06-26,Marin,041,260295,14218,14180,259,14439,232
2021-06-26,Mariposa,043,17540,441,440,11,451,5
2021-06-26,Mendocino,045,87422,4187,4096,82,4178,49
2021-06-26,Merced,047,269075,31245,31259,1042,32301,469
2021-06-26,Modoc,049,8938,416,411,147,558,3
2021-06-26,Mono,051,14174,1266,1279,17,1296,3
2021-06-26,Monterey,053,433212,43325,43192,1842,45034,462
2021-06-26,Napa,055,140530,10036,10043,37,10080,81
2021-06-26,Nevada,057,99092,4974,4939,193,5132,72
2021-06-26,Orange,059,3164182,256703,255640,11428,267068,5123
2021-06-26,Placer,061,380077,23891,23702,1542,25244,299
2021-06-26,Plumas,063,18699,722,704,12,716,4
2021-06-26,Riverside,065,2383286,295740,292480,13998,306478,4505
2021-06-26,Sacramento,067,1510023,108442,108179,1817,109996,1675
2021-06-26,San Benito,069,59416,6096,6100,113,6213,63
2021-06-26,San Bernardino,071,2135413,294830,294034,9002,303036,4928
2021-06-26,San Diego,073,3302833,283230,282263,15384,297647,3780
2021-06-26,San Francisco,075,870044,37132,37348,1287,38635,559
2021-06-26,San Joaquin,077,732212,74150,73928,3582,77510,1411
2021-06-26,San Luis Obispo,079,281455,21537,21330,748,22078,256
2021-06-26,San Mateo,081,765935,42747,42898,482,43380,539
2021-06-26,Santa Barbara,083,443738,34633,34525,1124,35649,455
2021-06-26,Santa Clara,085,1922200,119519,120321,765,121086,2103
2021-06-26,Santa Cruz,087,273765,16343,16239,800,17039,208
2021-06-26,Shasta,089,179085,12611,12635,1634,14269,203
2021-06-26,Sierra,091,2930,63,58,12,70,0
2021-06-26,Siskiyou,093,43540,1968,1896,363,2259,29
2021-06-26,Solano,095,438530,33490,33489,568,34057,267
2021-06-26,Sonoma,097,501317,31009,31088,360,31448,315
2021-06-26,Stanislaus,099,539301,57129,57006,5962,62968,1018
2021-06-26,Sutter,101,95872,9627,9669,87,9756,114
2021-06-26,Tehama,103,63373,5154,5119,582,5701,63
2021-06-26,Trinity,105,12862,494,341,95,436,3
2021-06-26,Tulare,107,460477,50461,49745,9003,58748,850
2021-06-26,Tuolumne,109,53932,4080,4121,43,4164,64
2021-06-26,Ventura,111,848112,81837,81352,3004,84356,1032
2021-06-26,Yolo,113,214977,14207,14184,261,14445,213
2021-06-26,Yuba,115,75493,6219,6200,131,6331,51
2021-06-25,Alameda,001,1643700,89484,89453,1942,91395,1271
2021-06-25,Alpine,003,1148,88,89,0,89,0
2021-06-25,Amador,005,37829,3755,3746,32,3778,46
2021-06-25,Butte,007,227075,12798,12682,1849,14531,198
2021-06-25,Calaveras,009,45235,2200,2201,13,2214,55
2021-06-25,Colusa,011,21464,1968,1972,319,2291,15
2021-06-25,Contra Costa,013,1133247,71071,70659,1304,71963,815
2021-06-25,Del Norte,015,27424,1465,1426,13,1439,8
2021-06-25,El Dorado,017,186661,10484,10406,772,11178,115
2021-06-25,Fresno,019,978130,103441,103073,8672,111745,1727
2021-06-25,Glenn,021,27897,2451,2441,565,3006,20
2021-06-25,Humboldt,023,135768,4513,4503,43,4546,49
2021-06-25,Imperial,025,180216,28782,28968,2693,31661,740
2021-06-25,Inyo,027,18085,1412,1406,12,1418,35
2021-06-25,Kern,029,883053,97924,97182,11031,108213,1347
2021-06-25,Kings,031,150075,23272,23118,1087,24205,246
2021-06-25,Lake,033,64148,3605,3571,13,3584,56
2021-06-25,Lassen,035,31185,5281,5259,115,5374,20
2021-06-25,Los Angeles,037,10098052,1213213,1206909,41257,1248166,24483
2021-06-25,Madera,039,155013,16803,16670,936,17606,240
2021-06-25,Marin,041,260295,14215,14179,259,14438,232
2021-06-25,Mariposa,043,17540,441,440,11,451,5
2021-06-25,Mendocino,045,87422,4184,4089,82,4171,49
2021-06-25,Merced,047,269075,31237,31256,1042,32298,467
2021-06-25,Modoc,049,8938,416,411,147,558,3
2021-06-25,Mono,051,14174,1266,1279,17,1296,3
2021-06-25,Monterey,053,433212,43320,43184,1841,45025,462
2021-06-25,Napa,055,140530,10031,10037,37,10074,81
2021-06-25,Nevada,057,99092,4971,4932,193,5125,72
2021-06-25,Orange,059,3164182,256632,255574,11426,267000,5119
2021-06-25,Placer,061,380077,23872,23672,1541,25213,299
2021-06-25,Plumas,063,18699,722,702,11,713,4
2021-06-25,Riverside,065,2383286,295672,291663,13991,305654,4490
2021-06-25,Sacramento,067,1510023,108370,108034,1814,109848,1673
2021-06-25,San Benito,069,59416,6092,6098,113,6211,63
2021-06-25,San Bernardino,071,2135413,294775,293941,9000,302941,4911
2021-06-25,San Diego,073,3302833,283170,282157,15371,297528,3779
2021-06-25,San Francisco,075,870044,37109,37338,1286,38624,559
2021-06-25,San Joaquin,077,732212,74117,73860,3580,77440,1410
2021-06-25,San Luis Obispo,079,281455,21534,21325,747,22072,256
2021-06-25,San Mateo,081,765935,42729,42849,482,43331,537
2021-06-25,Santa Barbara,083,443738,34624,34518,1123,35641,454
2021-06-25,Santa Clara,085,1922200,119499,120272,765,121037,2103
2021-06-25,Santa Cruz,087,273765,16340,16230,798,17028,208
2021-06-25,Shasta,089,179085,12601,12633,1633,14266,202
2021-06-25,Sierra,091,2930,63,58,12,70,0
2021-06-25,Siskiyou,093,43540,1967,1894,363,2257,29
2021-06-25,Solano,095,438530,33470,33449,568,34017,267
2021-06-25,Sonoma,097,501317,30986,31043,360,31403,314
2021-06-25,Stanislaus,099,539301,57113,56973,5955,62928,1018
2021-06-25,Sutter,101,95872,9620,9664,87,9751,114
2021-06-25,Tehama,103,63373,5153,5119,582,5701,63
2021-06-25,Trinity,105,12862,494,338,95,433,3
2021-06-25,Tulare,107,460477,50454,49731,9000,58731,850
2021-06-25,Tuolumne,109,53932,4079,4121,43,4164,64
2021-06-25,Ventura,111,848112,81808,81342,2998,84340,1032
2021-06-25,Yolo,113,214977,14201,14172,261,14433,213
2021-06-25,Yuba,115,75493,6215,6195,131,6326,51
2021-06-24,Alameda,001,1643700,89412,89358,1939,91297,1268
2021-06-24,Alpine,003,1148,88,89,0,89,0
2021-06-24,Amador,005,37829,3751,3745,32,3777,46
2021-06-24,Butte,007,227075,12792,12673,1847,14520,198
2021-06-24,Calaveras,009,45235,2197,2202,13,2215,55
2021-06-24,Colusa,011,21464,1967,1972,319,2291,15
2021-06-24,Contra Costa,013,1133247,71012,70590,1304,71894,813
2021-06-24,Del Norte,015,27424,1464,1421,13,1434,8
2021-06-24,El Dorado,017,186661,10477,10402,772,11174,115
2021-06-24,Fresno,019,978130,103421,103061,8670,111731,1727
2021-06-24,Glenn,021,27897,2450,2439,565,3004,20
2021-06-24,Humboldt,023,135768,4508,4493,43,4536,49
2021-06-24,Imperial,025,180216,28779,28981,2693,31674,740
2021-06-24,Inyo,027,18085,1411,1406,12,1418,35
2021-06-24,Kern,029,883053,97905,97129,11018,108147,1346
2021-06-24,Kings,031,150075,23268,23114,1086,24200,246
2021-06-24,Lake,033,64148,3599,3571,13,3584,56
2021-06-24,Lassen,035,31185,5280,5258,115,5373,20
2021-06-24,Los Angeles,037,10098052,1212889,1206590,41233,1247823,24480
2021-06-24,Madera,039,155013,16792,16662,935,17597,240
2021-06-24,Marin,041,260295,14211,14180,259,14439,232
2021-06-24,Mariposa,043,17540,441,440,11,451,5
2021-06-24,Mendocino,045,87422,4176,4085,82,4167,49
2021-06-24,Merced,047,269075,31227,31248,1041,32289,466
2021-06-24,Modoc,049,8938,416,411,147,558,3
2021-06-24,Mono,051,14174,1266,1276,17,1293,3
2021-06-24,Monterey,053,433212,43313,43180,1841,45021,451
2021-06-24,Napa,055,140530,10029,10036,37,10073,80
2021-06-24,Nevada,057,99092,4969,4927,193,5120,72
2021-06-24,Orange,059,3164182,256568,255520,11418,266938,5117
2021-06-24,Placer,061,380077,23847,23659,1539,25198,299
2021-06-24,Plumas,063,18699,721,702,11,713,4
2021-06-24,Riverside,065,2383286,295592,291067,13980,305047,4473
2021-06-24,Sacramento,067,1510023,108282,107965,1812,109777,1672
2021-06-24,San Benito,069,59416,6089,6098,113,6211,63
2021-06-24,San Bernardino,071,2135413,294704,293895,8995,302890,4898
2021-06-24,San Diego,073,3302833,283066,282053,15358,297411,3778
2021-06-24,San Francisco,075,870044,37087,37320,1284,38604,559
2021-06-24,San Joaquin,077,732212,74069,73814,3580,77394,1408
2021-06-24,San Luis Obispo,079,281455,21528,21326,747,22073,256
2021-06-24,San Mateo,081,765935,42703,42814,481,43295,542
2021-06-24,Santa Barbara,083,443738,34618,34512,1122,35634,454
2021-06-24,Santa Clara,085,1922200,119468,120274,764,121038,2103
2021-06-24,Santa Cruz,087,273765,16339,16227,798,17025,208
2021-06-24,Shasta,089,179085,12596,12629,1629,14258,202
2021-06-24,Sierra,091,2930,63,58,12,70,0
2021-06-24,Siskiyou,093,43540,1967,1892,363,2255,28
2021-06-24,Solano,095,438530,33447,33432,566,33998,267
2021-06-24,Sonoma,097,501317,30957,31020,360,31380,314
2021-06-24,Stanislaus,099,539301,57087,56946,5955,62901,1018
2021-06-24,Sutter,101,95872,9613,9660,87,9747,113
2021-06-24,Tehama,103,63373,5150,5115,582,5697,63
2021-06-24,Trinity,105,12862,493,338,95,433,3
2021-06-24,Tulare,107,460477,50443,49730,8998,58728,850
2021-06-24,Tuolumne,109,53932,4077,4120,43,4163,64
2021-06-24,Ventura,111,848112,81780,81332,2997,84329,1032
2021-06-24,Yolo,113,214977,14192,14169,258,14427,213
2021-06-24,Yuba,115,75493,6210,6195,131,6326,51
2021-06-23,Alameda,001,1643700,89340,89338,1938,91276,1266
2021-06-23,Alpine,003,1148,88,88,0,88,0
2021-06-23,Amador,005,37829,3749,3743,32,3775,46
2021-06-23,Butte,007,227075,12785,12666,1847,14513,198
2021-06-23,Calaveras,009,45235,2196,2199,13,2212,55
2021-06-23,Colusa,011,21464,1966,1972,319,2291,15
2021-06-23,Contra Costa,013,1133247,70947,70526,1303,71829,813
2021-06-23,Del Norte,015,27424,1460,1418,13,1431,8
2021-06-23,El Dorado,017,186661,10467,10395,769,11164,115
2021-06-23,Fresno,019,978130,103392,103020,8668,111688,1724
2021-06-23,Glenn,021,27897,2450,2437,564,3001,20
2021-06-23,Humboldt,023,135768,4499,4490,43,4533,48
2021-06-23,Imperial,025,180216,28772,28908,2693,31601,740
2021-06-23,Inyo,027,18085,1411,1406,12,1418,35
2021-06-23,Kern,029,883053,97877,97078,11005,108083,1345
2021-06-23,Kings,031,150075,23261,23105,1084,24189,245
2021-06-23,Lake,033,64148,3590,3566,13,3579,53
2021-06-23,Lassen,035,31185,5277,5257,115,5372,20
2021-06-23,Los Angeles,037,10098052,1212552,1206358,41223,1247581,24472
2021-06-23,Madera,039,155013,16785,16660,935,17595,240
2021-06-23,Marin,041,260295,14205,14177,259,14436,230
2021-06-23,Mariposa,043,17540,441,439,11,450,5
2021-06-23,Mendocino,045,87422,4172,4078,82,4160,49
2021-06-23,Merced,047,269075,31218,31260,1041,32301,465
2021-06-23,Modoc,049,8938,414,407,147,554,3
2021-06-23,Mono,051,14174,1266,1279,17,1296,3
2021-06-23,Monterey,053,433212,43304,43166,1841,45007,439
2021-06-23,Napa,055,140530,10020,10032,37,10069,80
2021-06-23,Nevada,057,99092,4966,4924,193,5117,72
2021-06-23,Orange,059,3164182,256502,255479,11410,266889,5116
2021-06-23,Placer,061,380077,23818,23630,1534,25164,299
2021-06-23,Plumas,063,18699,720,701,11,712,4
2021-06-23,Riverside,065,2383286,295509,290343,13978,304321,4462
2021-06-23,Sacramento,067,1510023,108190,107868,1807,109675,1671
2021-06-23,San Benito,069,59416,6085,6097,113,6210,63
2021-06-23,San Bernardino,071,2135413,294625,293816,8990,302806,4886
2021-06-23,San Diego,073,3302833,282966,281937,15337,297274,3777
2021-06-23,San Francisco,075,870044,37063,37304,1282,38586,559
2021-06-23,San Joaquin,077,732212,74030,73764,3578,77342,1405
2021-06-23,San Luis Obispo,079,281455,21524,21323,746,22069,257
2021-06-23,San Mateo,081,765935,42687,42756,481,43237,542
2021-06-23,Santa Barbara,083,443738,34608,34505,1122,35627,454
2021-06-23,Santa Clara,085,1922200,119439,120233,764,120997,2098
2021-06-23,Santa Cruz,087,273765,16335,16215,798,17013,209
2021-06-23,Shasta,089,179085,12589,12604,1627,14231,202
2021-06-23,Sierra,091,2930,63,57,12,69,0
2021-06-23,Siskiyou,093,43540,1965,1892,363,2255,28
2021-06-23,Solano,095,438530,33403,33408,566,33974,267
2021-06-23,Sonoma,097,501317,30917,30959,358,31317,314
2021-06-23,Stanislaus,099,539301,57057,56926,5954,62880,1017
2021-06-23,Sutter,101,95872,9607,9653,87,9740,113
2021-06-23,Tehama,103,63373,5150,5119,581,5700,63
2021-06-23,Trinity,105,12862,493,338,95,433,3
2021-06-23,Tulare,107,460477,50436,49711,8995,58706,850
2021-06-23,Tuolumne,109,53932,4074,4120,43,4163,64
2021-06-23,Ventura,111,848112,81757,81312,2994,84306,1032
2021-06-23,Yolo,113,214977,14182,14161,258,14419,212
2021-06-23,Yuba,115,75493,6207,6190,131,6321,51
2021-06-22,Alameda,001,1643700,89273,89308,1938,91246,1263
2021-06-22,Alpine,003,1148,88,88,0,88,0
2021-06-22,Amador,005,37829,3746,3743,32,3775,46
2021-06-22,Butte,007,227075,12781,12662,1844,14506,198
2021-06-22,Calaveras,009,45235,2195,2198,13,2211,55
2021-06-22,Colusa,011,21464,1965,1971,319,2290,15
2021-06-22,Contra Costa,013,1133247,70891,70480,1302,71782,813
2021-06-22,Del Norte,015,27424,1457,1417,13,1430,8
2021-06-22,El Dorado,017,186661,10462,10380,768,11148,113
2021-06-22,Fresno,019,978130,103373,102996,8664,111660,1724
2021-06-22,Glenn,021,27897,2449,2435,562,2997,19
2021-06-22,Humboldt,023,135768,4489,4483,43,4526,42
2021-06-22,Imperial,025,180216,28767,28880,2693,31573,740
2021-06-22,Inyo,027,18085,1411,1405,12,1417,35
2021-06-22,Kern,029,883053,97864,97013,11001,108014,1342
2021-06-22,Kings,031,150075,23253,23098,1083,24181,245
2021-06-22,Lake,033,64148,3588,3564,13,3577,45
2021-06-22,Lassen,035,31185,5272,5254,115,5369,20
2021-06-22,Los Angeles,037,10098052,1212236,1206146,41211,1247357,24461
2021-06-22,Madera,039,155013,16780,16652,935,17587,240
2021-06-22,Marin,041,260295,14203,14174,259,14433,230
2021-06-22,Mariposa,043,17540,441,439,11,450,5
2021-06-22,Mendocino,045,87422,4166,4072,82,4154,49
2021-06-22,Merced,047,269075,31207,31267,1041,32308,464
2021-06-22,Modoc,049,8938,412,405,146,551,3
2021-06-22,Mono,051,14174,1266,1277,17,1294,3
2021-06-22,Monterey,053,433212,43301,43162,1840,45002,427
2021-06-22,Napa,055,140530,10016,10029,37,10066,80
2021-06-22,Nevada,057,99092,4960,4923,193,5116,72
2021-06-22,Orange,059,3164182,256433,255452,11399,266851,5114
2021-06-22,Placer,061,380077,23796,23603,1534,25137,299
2021-06-22,Plumas,063,18699,720,697,11,708,4
2021-06-22,Riverside,065,2383286,295448,289839,13974,303813,4456
2021-06-22,Sacramento,067,1510023,108089,107801,1802,109603,1670
2021-06-22,San Benito,069,59416,6084,6098,113,6211,63
2021-06-22,San Bernardino,071,2135413,294550,293770,8984,302754,4873
2021-06-22,San Diego,073,3302833,282862,281867,15314,297181,3771
2021-06-22,San Francisco,075,870044,37049,37287,1282,38569,556
2021-06-22,San Joaquin,077,732212,74000,73723,3576,77299,1405
2021-06-22,San Luis Obispo,079,281455,21521,21321,745,22066,257
2021-06-22,San Mateo,081,765935,42673,42725,476,43201,542
2021-06-22,Santa Barbara,083,443738,34597,34500,1121,35621,454
2021-06-22,Santa Clara,085,1922200,119407,120194,764,120958,2095
2021-06-22,Santa Cruz,087,273765,16330,16218,798,17016,209
2021-06-22,Shasta,089,179085,12578,12616,1624,14240,202
2021-06-22,Sierra,091,2930,62,57,12,69,0
2021-06-22,Siskiyou,093,43540,1965,1892,363,2255,28
2021-06-22,Solano,095,438530,33385,33397,565,33962,267
2021-06-22,Sonoma,097,501317,30877,30933,358,31291,314
2021-06-22,Stanislaus,099,539301,57041,56915,5952,62867,1017
2021-06-22,Sutter,101,95872,9600,9649,87,9736,113
2021-06-22,Tehama,103,63373,5148,5118,580,5698,63
2021-06-22,Trinity,105,12862,491,337,95,432,3
2021-06-22,Tulare,107,460477,50427,49706,8990,58696,850
2021-06-22,Tuolumne,109,53932,4072,4119,43,4162,64
2021-06-22,Ventura,111,848112,81743,81300,2993,84293,1032
2021-06-22,Yolo,113,214977,14177,14157,256,14413,212
2021-06-22,Yuba,115,75493,6203,6181,131,6312,51
2021-06-21,Alameda,001,1643700,89217,89281,1937,91218,1262
2021-06-21,Alpine,003,1148,88,88,0,88,0
2021-06-21,Amador,005,37829,3740,3742,32,3774,46
2021-06-21,Butte,007,227075,12775,12668,1842,14510,195
2021-06-21,Calaveras,009,45235,2193,2194,13,2207,55
2021-06-21,Colusa,011,21464,1964,1970,318,2288,15
2021-06-21,Contra Costa,013,1133247,70820,70439,1301,71740,813
2021-06-21,Del Norte,015,27424,1453,1416,13,1429,8
2021-06-21,El Dorado,017,186661,10456,10375,767,11142,113
2021-06-21,Fresno,019,978130,103353,102971,8661,111632,1724
2021-06-21,Glenn,021,27897,2448,2433,562,2995,19
2021-06-21,Humboldt,023,135768,4480,4478,42,4520,42
2021-06-21,Imperial,025,180216,28763,28855,2693,31548,740
2021-06-21,Inyo,027,18085,1410,1405,12,1417,35
2021-06-21,Kern,029,883053,97835,96995,10993,107988,1342
2021-06-21,Kings,031,150075,23246,23091,1080,24171,245
2021-06-21,Lake,033,64148,3582,3563,13,3576,45
2021-06-21,Lassen,035,31185,5270,5233,115,5348,19
2021-06-21,Los Angeles,037,10098052,1211941,1205994,41189,1247183,24459
2021-06-21,Madera,039,155013,16771,16647,935,17582,240
2021-06-21,Marin,041,260295,14199,14173,259,14432,230
2021-06-21,Mariposa,043,17540,441,439,11,450,5
2021-06-21,Mendocino,045,87422,4163,4085,82,4167,49
2021-06-21,Merced,047,269075,31197,31264,1040,32304,465
2021-06-21,Modoc,049,8938,412,405,146,551,3
2021-06-21,Mono,051,14174,1266,1277,17,1294,3
2021-06-21,Monterey,053,433212,43298,43157,1840,44997,427
2021-06-21,Napa,055,140530,10011,10028,37,10065,80
2021-06-21,Nevada,057,99092,4956,4921,193,5114,72
2021-06-21,Orange,059,3164182,256360,255400,11392,266792,5113
2021-06-21,Placer,061,380077,23772,23577,1534,25111,298
2021-06-21,Plumas,063,18699,718,697,11,708,4
2021-06-21,Riverside,065,2383286,295372,289797,13969,303766,4456
2021-06-21,Sacramento,067,1510023,107978,107757,1801,109558,1669
2021-06-21,San Benito,069,59416,6080,6098,113,6211,63
2021-06-21,San Bernardino,071,2135413,294463,293736,8980,302716,4850
2021-06-21,San Diego,073,3302833,282757,281811,15294,297105,3771
2021-06-21,San Francisco,075,870044,37033,37275,1281,38556,556
2021-06-21,San Joaquin,077,732212,73959,73687,3575,77262,1405
2021-06-21,San Luis Obispo,079,281455,21512,21316,745,22061,257
2021-06-21,San Mateo,081,765935,42657,42685,475,43160,542
2021-06-21,Santa Barbara,083,443738,34592,34492,1121,35613,455
2021-06-21,Santa Clara,085,1922200,119374,120192,763,120955,2093
2021-06-21,Santa Cruz,087,273765,16328,16212,798,17010,208
2021-06-21,Shasta,089,179085,12565,12617,1621,14238,201
2021-06-21,Sierra,091,2930,62,57,12,69,0
2021-06-21,Siskiyou,093,43540,1965,1892,363,2255,27
2021-06-21,Solano,095,438530,33362,33383,564,33947,266
2021-06-21,Sonoma,097,501317,30854,30912,358,31270,314
2021-06-21,Stanislaus,099,539301,57011,56891,5947,62838,1017
2021-06-21,Sutter,101,95872,9597,9649,87,9736,113
2021-06-21,Tehama,103,63373,5148,5115,579,5694,63
2021-06-21,Trinity,105,12862,491,337,95,432,3
2021-06-21,Tulare,107,460477,50416,49689,8986,58675,849
2021-06-21,Tuolumne,109,53932,4068,4119,43,4162,63
2021-06-21,Ventura,111,848112,81715,81291,2989,84280,1031
2021-06-21,Yolo,113,214977,14171,14165,256,14421,212
2021-06-21,Yuba,115,75493,6202,6172,131,6303,51
2021-06-20,Alameda,001,1643700,89152,89255,1936,91191,1263
2021-06-20,Alpine,003,1148,88,88,0,88,0
2021-06-20,Amador,005,37829,3737,3740,32,3772,46
2021-06-20,Butte,007,227075,12768,12668,1841,14509,194
2021-06-20,Calaveras,009,45235,2192,2193,13,2206,55
2021-06-20,Colusa,011,21464,1964,1970,318,2288,15
2021-06-20,Contra Costa,013,1133247,70763,70401,1299,71700,813
2021-06-20,Del Norte,015,27424,1449,1416,13,1429,8
2021-06-20,El Dorado,017,186661,10442,10372,764,11136,113
2021-06-20,Fresno,019,978130,103312,102947,8658,111605,1724
2021-06-20,Glenn,021,27897,2448,2434,562,2996,19
2021-06-20,Humboldt,023,135768,4474,4472,42,4514,42
2021-06-20,Imperial,025,180216,28754,28855,2693,31548,740
2021-06-20,Inyo,027,18085,1409,1405,12,1417,35
2021-06-20,Kern,029,883053,97814,96985,10982,107967,1342
2021-06-20,Kings,031,150075,23241,23088,1078,24166,245
2021-06-20,Lake,033,64148,3580,3563,13,3576,45
2021-06-20,Lassen,035,31185,5267,5230,115,5345,19
2021-06-20,Los Angeles,037,10098052,1211636,1205874,41181,1247055,24456
2021-06-20,Madera,039,155013,16763,16638,933,17571,240
2021-06-20,Marin,041,260295,14196,14166,259,14425,230
2021-06-20,Mariposa,043,17540,439,439,11,450,5
2021-06-20,Mendocino,045,87422,4156,4080,82,4162,49
2021-06-20,Merced,047,269075,31184,31265,1040,32305,465
2021-06-20,Modoc,049,8938,412,405,146,551,3
2021-06-20,Mono,051,14174,1266,1275,17,1292,3
2021-06-20,Monterey,053,433212,43289,43156,1839,44995,427
2021-06-20,Napa,055,140530,10004,10026,36,10062,80
2021-06-20,Nevada,057,99092,4949,4919,193,5112,72
2021-06-20,Orange,059,3164182,256296,255377,11381,266758,5113
2021-06-20,Placer,061,380077,23738,23562,1530,25092,298
2021-06-20,Plumas,063,18699,717,697,11,708,4
2021-06-20,Riverside,065,2383286,295293,289770,13958,303728,4456
2021-06-20,Sacramento,067,1510023,107867,107700,1798,109498,1669
2021-06-20,San Benito,069,59416,6080,6098,113,6211,63
2021-06-20,San Bernardino,071,2135413,294363,293713,8976,302689,4845
2021-06-20,San Diego,073,3302833,282651,281750,15272,297022,3771
2021-06-20,San Francisco,075,870044,37010,37269,1281,38550,556
2021-06-20,San Joaquin,077,732212,73914,73676,3566,77242,1405
2021-06-20,San Luis Obispo,079,281455,21510,21313,745,22058,257
2021-06-20,San Mateo,081,765935,42628,42681,475,43156,542
2021-06-20,Santa Barbara,083,443738,34583,34487,1121,35608,455
2021-06-20,Santa Clara,085,1922200,119339,120163,763,120926,2093
2021-06-20,Santa Cruz,087,273765,16322,16210,798,17008,208
2021-06-20,Shasta,089,179085,12560,12617,1619,14236,201
2021-06-20,Sierra,091,2930,62,57,12,69,0
2021-06-20,Siskiyou,093,43540,1964,1891,363,2254,27
2021-06-20,Solano,095,438530,33340,33361,562,33923,266
2021-06-20,Sonoma,097,501317,30807,30884,355,31239,314
2021-06-20,Stanislaus,099,539301,56978,56868,5946,62814,1017
2021-06-20,Sutter,101,95872,9594,9645,87,9732,113
2021-06-20,Tehama,103,63373,5144,5115,579,5694,63
2021-06-20,Trinity,105,12862,491,337,95,432,3
2021-06-20,Tulare,107,460477,50407,49685,8984,58669,849
2021-06-20,Tuolumne,109,53932,4065,4117,43,4160,63
2021-06-20,Ventura,111,848112,81699,81282,2987,84269,1031
2021-06-20,Yolo,113,214977,14164,14160,256,14416,212
2021-06-20,Yuba,115,75493,6195,6167,131,6298,51
2021-06-19,Alameda,001,1643700,89117,89202,1936,91138,1263
2021-06-19,Alpine,003,1148,88,88,0,88,0
2021-06-19,Amador,005,37829,3735,3739,32,3771,46
2021-06-19,Butte,007,227075,12764,12659,1841,14500,194
2021-06-19,Calaveras,009,45235,2192,2192,13,2205,55
2021-06-19,Colusa,011,21464,1964,1969,318,2287,15
2021-06-19,Contra Costa,013,1133247,70732,70334,1298,71632,813
2021-06-19,Del Norte,015,27424,1448,1416,13,1429,8
2021-06-19,El Dorado,017,186661,10441,10363,763,11126,113
2021-06-19,Fresno,019,978130,103299,102922,8657,111579,1724
2021-06-19,Glenn,021,27897,2447,2434,561,2995,19
2021-06-19,Humboldt,023,135768,4463,4463,42,4505,42
2021-06-19,Imperial,025,180216,28753,28813,2693,31506,740
2021-06-19,Inyo,027,18085,1409,1405,12,1417,35
2021-06-19,Kern,029,883053,97798,96966,10978,107944,1342
2021-06-19,Kings,031,150075,23238,23086,1078,24164,245
2021-06-19,Lake,033,64148,3576,3563,13,3576,45
2021-06-19,Lassen,035,31185,5266,5225,115,5340,19
2021-06-19,Los Angeles,037,10098052,1211433,1205602,41165,1246767,24454
2021-06-19,Madera,039,155013,16761,16632,933,17565,240
2021-06-19,Marin,041,260295,14188,14152,259,14411,230
2021-06-19,Mariposa,043,17540,439,439,11,450,5
2021-06-19,Mendocino,045,87422,4151,4077,82,4159,49
2021-06-19,Merced,047,269075,31182,31256,1040,32296,465
2021-06-19,Modoc,049,8938,411,402,146,548,3
2021-06-19,Mono,051,14174,1266,1275,17,1292,3
2021-06-19,Monterey,053,433212,43283,43153,1839,44992,427
2021-06-19,Napa,055,140530,10000,10025,36,10061,80
2021-06-19,Nevada,057,99092,4944,4910,193,5103,72
2021-06-19,Orange,059,3164182,256249,255329,11378,266707,5112
2021-06-19,Placer,061,380077,23722,23537,1527,25064,298
2021-06-19,Plumas,063,18699,716,697,11,708,4
2021-06-19,Riverside,065,2383286,295247,289720,13958,303678,4456
2021-06-19,Sacramento,067,1510023,107821,107631,1795,109426,1669
2021-06-19,San Benito,069,59416,6079,6098,113,6211,63
2021-06-19,San Bernardino,071,2135413,294320,293673,8974,302647,4844
2021-06-19,San Diego,073,3302833,282591,281682,15258,296940,3771
2021-06-19,San Francisco,075,870044,36997,37256,1281,38537,556
2021-06-19,San Joaquin,077,732212,73898,73652,3562,77214,1405
2021-06-19,San Luis Obispo,079,281455,21508,21308,743,22051,257
2021-06-19,San Mateo,081,765935,42610,42646,473,43119,542
2021-06-19,Santa Barbara,083,443738,34581,34472,1121,35593,455
2021-06-19,Santa Clara,085,1922200,119316,120110,762,120872,2093
2021-06-19,Santa Cruz,087,273765,16317,16206,798,17004,208
2021-06-19,Shasta,089,179085,12558,12615,1618,14233,201
2021-06-19,Sierra,091,2930,62,57,12,69,0
2021-06-19,Siskiyou,093,43540,1964,1891,363,2254,27
2021-06-19,Solano,095,438530,33330,33341,561,33902,266
2021-06-19,Sonoma,097,501317,30766,30841,355,31196,314
2021-06-19,Stanislaus,099,539301,56959,56847,5943,62790,1017
2021-06-19,Sutter,101,95872,9591,9645,87,9732,113
2021-06-19,Tehama,103,63373,5143,5115,579,5694,63
2021-06-19,Trinity,105,12862,491,337,95,432,3
2021-06-19,Tulare,107,460477,50400,49681,8979,58660,849
2021-06-19,Tuolumne,109,53932,4065,4117,43,4160,63
2021-06-19,Ventura,111,848112,81686,81270,2986,84256,1031
2021-06-19,Yolo,113,214977,14160,14156,255,14411,212
2021-06-19,Yuba,115,75493,6194,6157,131,6288,51
2021-06-18,Alameda,001,1643700,89080,89123,1936,91059,1263
2021-06-18,Alpine,003,1148,88,88,0,88,0
2021-06-18,Amador,005,37829,3735,3739,32,3771,46
2021-06-18,Butte,007,227075,12761,12653,1838,14491,194
2021-06-18,Calaveras,009,45235,2192,2191,13,2204,55
2021-06-18,Colusa,011,21464,1963,1969,318,2287,15
2021-06-18,Contra Costa,013,1133247,70690,70271,1296,71567,813
2021-06-18,Del Norte,015,27424,1448,1415,13,1428,8
2021-06-18,El Dorado,017,186661,10438,10348,761,11109,113
2021-06-18,Fresno,019,978130,103283,102894,8655,111549,1722
2021-06-18,Glenn,021,27897,2446,2430,561,2991,19
2021-06-18,Humboldt,023,135768,4455,4450,42,4492,42
2021-06-18,Imperial,025,180216,28751,28809,2693,31502,740
2021-06-18,Inyo,027,18085,1409,1405,12,1417,35
2021-06-18,Kern,029,883053,97787,96948,10972,107920,1341
2021-06-18,Kings,031,150075,23233,23082,1078,24160,245
2021-06-18,Lake,033,64148,3572,3563,13,3576,45
2021-06-18,Lassen,035,31185,5265,5224,115,5339,19
2021-06-18,Los Angeles,037,10098052,1211267,1205472,41148,1246620,24451
2021-06-18,Madera,039,155013,16755,16625,933,17558,241
2021-06-18,Marin,041,260295,14185,14147,259,14406,230
2021-06-18,Mariposa,043,17540,439,439,11,450,5
2021-06-18,Mendocino,045,87422,4146,4068,82,4150,49
2021-06-18,Merced,047,269075,31180,31262,1040,32302,464
2021-06-18,Modoc,049,8938,411,402,146,548,3
2021-06-18,Mono,051,14174,1265,1275,16,1291,3
2021-06-18,Monterey,053,433212,43280,43148,1839,44987,427
2021-06-18,Napa,055,140530,9996,10021,36,10057,80
2021-06-18,Nevada,057,99092,4936,4903,193,5096,72
2021-06-18,Orange,059,3164182,256212,255274,11375,266649,5108
2021-06-18,Placer,061,380077,23714,23500,1524,25024,298
2021-06-18,Plumas,063,18699,716,697,11,708,4
2021-06-18,Riverside,065,2383286,295199,289676,13957,303633,4457
2021-06-18,Sacramento,067,1510023,107773,107570,1795,109365,1669
2021-06-18,San Benito,069,59416,6078,6097,113,6210,63
2021-06-18,San Bernardino,071,2135413,294275,293629,8970,302599,4826
2021-06-18,San Diego,073,3302833,282515,281608,15247,296855,3771
2021-06-18,San Francisco,075,870044,36988,37246,1281,38527,556
2021-06-18,San Joaquin,077,732212,73880,73623,3560,77183,1403
2021-06-18,San Luis Obispo,079,281455,21504,21301,742,22043,257
2021-06-18,San Mateo,081,765935,42599,42630,472,43102,542
2021-06-18,Santa Barbara,083,443738,34571,34469,1121,35590,455
2021-06-18,Santa Clara,085,1922200,119295,120081,760,120841,2093
2021-06-18,Santa Cruz,087,273765,16313,16202,798,17000,208
2021-06-18,Shasta,089,179085,12554,12607,1616,14223,201
2021-06-18,Sierra,091,2930,61,57,12,69,0
2021-06-18,Siskiyou,093,43540,1964,1890,363,2253,27
2021-06-18,Solano,095,438530,33316,33323,561,33884,266
2021-06-18,Sonoma,097,501317,30748,30816,354,31170,313
2021-06-18,Stanislaus,099,539301,56944,56803,5941,62744,1012
2021-06-18,Sutter,101,95872,9588,9643,87,9730,113
2021-06-18,Tehama,103,63373,5141,5114,579,5693,63
2021-06-18,Trinity,105,12862,491,337,94,431,3
2021-06-18,Tulare,107,460477,50398,49664,8972,58636,849
2021-06-18,Tuolumne,109,53932,4062,4116,43,4159,63
2021-06-18,Ventura,111,848112,81676,81256,2981,84237,1031
2021-06-18,Yolo,113,214977,14157,14148,253,14401,212
2021-06-18,Yuba,115,75493,6188,6150,131,6281,51
2021-06-17,Alameda,001,1643700,89033,89087,1936,91023,1262
2021-06-17,Alpine,003,1148,88,88,0,88,0
2021-06-17,Amador,005,37829,3733,3731,32,3763,46
2021-06-17,Butte,007,227075,12751,12644,1837,14481,194
2021-06-17,Calaveras,009,45235,2191,2189,13,2202,55
2021-06-17,Colusa,011,21464,1962,1969,318,2287,15
2021-06-17,Contra Costa,013,1133247,70651,70190,1292,71482,810
2021-06-17,Del Norte,015,27424,1446,1413,13,1426,8
2021-06-17,El Dorado,017,186661,10428,10341,761,11102,113
2021-06-17,Fresno,019,978130,103257,102867,8651,111518,1722
2021-06-17,Glenn,021,27897,2446,2430,561,2991,19
2021-06-17,Humboldt,023,135768,4446,4438,42,4480,42
2021-06-17,Imperial,025,180216,28743,28801,2693,31494,741
2021-06-17,Inyo,027,18085,1409,1405,12,1417,35
2021-06-17,Kern,029,883053,97772,96840,10966,107806,1340
2021-06-17,Kings,031,150075,23229,23078,1077,24155,245
2021-06-17,Lake,033,64148,3569,3563,9,3572,45
2021-06-17,Lassen,035,31185,5261,5223,115,5338,19
2021-06-17,Los Angeles,037,10098052,1211052,1205301,41121,1246422,24444
2021-06-17,Madera,039,155013,16750,16618,933,17551,241
2021-06-17,Marin,041,260295,14185,14141,259,14400,229
2021-06-17,Mariposa,043,17540,439,439,11,450,5
2021-06-17,Mendocino,045,87422,4139,4054,82,4136,49
2021-06-17,Merced,047,269075,31175,31262,1040,32302,464
2021-06-17,Modoc,049,8938,410,401,146,547,3
2021-06-17,Mono,051,14174,1264,1275,16,1291,3
2021-06-17,Monterey,053,433212,43272,43140,1839,44979,416
2021-06-17,Napa,055,140530,9996,10014,36,10050,80
2021-06-17,Nevada,057,99092,4932,4898,193,5091,72
2021-06-17,Orange,059,3164182,256166,255240,11364,266604,5109
2021-06-17,Placer,061,380077,23698,23461,1522,24983,298
2021-06-17,Plumas,063,18699,715,697,11,708,4
2021-06-17,Riverside,065,2383286,295145,289627,13955,303582,4458
2021-06-17,Sacramento,067,1510023,107709,107492,1793,109285,1666
2021-06-17,San Benito,069,59416,6078,6097,113,6210,63
2021-06-17,San Bernardino,071,2135413,294234,293560,8970,302530,4811
2021-06-17,San Diego,073,3302833,282439,281531,15233,296764,3771
2021-06-17,San Francisco,075,870044,36977,37243,1280,38523,556
2021-06-17,San Joaquin,077,732212,73857,73560,3555,77115,1403
2021-06-17,San Luis Obispo,079,281455,21502,21297,742,22039,257
2021-06-17,San Mateo,081,765935,42593,42615,472,43087,542
2021-06-17,Santa Barbara,083,443738,34565,34466,1121,35587,453
2021-06-17,Santa Clara,085,1922200,119270,120032,759,120791,2093
2021-06-17,Santa Cruz,087,273765,16309,16197,798,16995,208
2021-06-17,Shasta,089,179085,12546,12597,1616,14213,201
2021-06-17,Sierra,091,2930,61,56,12,68,0
2021-06-17,Siskiyou,093,43540,1963,1889,363,2252,27
2021-06-17,Solano,095,438530,33295,33296,560,33856,266
2021-06-17,Sonoma,097,501317,30718,30793,354,31147,323
2021-06-17,Stanislaus,099,539301,56913,56752,5936,62688,1012
2021-06-17,Sutter,101,95872,9585,9629,87,9716,113
2021-06-17,Tehama,103,63373,5140,5112,577,5689,63
2021-06-17,Trinity,105,12862,490,337,94,431,3
2021-06-17,Tulare,107,460477,50393,49649,8964,58613,849
2021-06-17,Tuolumne,109,53932,4061,4116,43,4159,63
2021-06-17,Ventura,111,848112,81667,81248,2978,84226,1030
2021-06-17,Yolo,113,214977,14149,14141,253,14394,212
2021-06-17,Yuba,115,75493,6179,6140,131,6271,51
2021-06-16,Alameda,001,1643700,88984,89045,1935,90980,1265
2021-06-16,Alpine,003,1148,88,88,0,88,0
2021-06-16,Amador,005,37829,3732,3730,32,3762,46
2021-06-16,Butte,007,227075,12749,12635,1835,14470,194
2021-06-16,Calaveras,009,45235,2189,2188,13,2201,55
2021-06-16,Colusa,011,21464,1962,1967,318,2285,15
2021-06-16,Contra Costa,013,1133247,70599,70136,1291,71427,810
2021-06-16,Del Norte,015,27424,1443,1413,13,1426,8
2021-06-16,El Dorado,017,186661,10422,10334,760,11094,113
2021-06-16,Fresno,019,978130,103226,102842,8647,111489,1722
2021-06-16,Glenn,021,27897,2446,2430,561,2991,19
2021-06-16,Humboldt,023,135768,4437,4427,41,4468,42
2021-06-16,Imperial,025,180216,28740,28796,2693,31489,741
2021-06-16,Inyo,027,18085,1408,1405,12,1417,35
2021-06-16,Kern,029,883053,97750,96789,10959,107748,1339
2021-06-16,Kings,031,150075,23228,23072,1076,24148,245
2021-06-16,Lake,033,64148,3569,3562,9,3571,45
2021-06-16,Lassen,035,31185,5258,5216,115,5331,19
2021-06-16,Los Angeles,037,10098052,1210829,1205102,41111,1246213,24439
2021-06-16,Madera,039,155013,16746,16603,933,17536,240
2021-06-16,Marin,041,260295,14183,14137,259,14396,229
2021-06-16,Mariposa,043,17540,439,437,11,448,5
2021-06-16,Mendocino,045,87422,4131,4041,82,4123,49
2021-06-16,Merced,047,269075,31167,31250,1040,32290,463
2021-06-16,Modoc,049,8938,409,383,145,528,3
2021-06-16,Mono,051,14174,1264,1275,16,1291,3
2021-06-16,Monterey,053,433212,43269,43122,1839,44961,416
2021-06-16,Napa,055,140530,9992,10011,36,10047,80
2021-06-16,Nevada,057,99092,4927,4894,193,5087,72
2021-06-16,Orange,059,3164182,256112,255188,11356,266544,5109
2021-06-16,Placer,061,380077,23688,23425,1518,24943,298
2021-06-16,Plumas,063,18699,715,697,11,708,4
2021-06-16,Riverside,065,2383286,295084,289539,13953,303492,4457
2021-06-16,Sacramento,067,1510023,107639,107422,1789,109211,1665
2021-06-16,San Benito,069,59416,6078,6090,113,6203,63
2021-06-16,San Bernardino,071,2135413,294185,293499,8968,302467,4797
2021-06-16,San Diego,073,3302833,282360,281423,15220,296643,3770
2021-06-16,San Francisco,075,870044,36964,37222,1278,38500,555
2021-06-16,San Joaquin,077,732212,73819,73530,3551,77081,1399
2021-06-16,San Luis Obispo,079,281455,21497,21294,742,22036,257
2021-06-16,San Mateo,081,765935,42577,42601,472,43073,542
2021-06-16,Santa Barbara,083,443738,34559,34459,1121,35580,460
2021-06-16,Santa Clara,085,1922200,119238,119982,759,120741,2087
2021-06-16,Santa Cruz,087,273765,16306,16187,798,16985,208
2021-06-16,Shasta,089,179085,12541,12592,1615,14207,200
2021-06-16,Sierra,091,2930,61,56,12,68,0
2021-06-16,Siskiyou,093,43540,1962,1886,363,2249,26
2021-06-16,Solano,095,438530,33267,33276,560,33836,266
2021-06-16,Sonoma,097,501317,30682,30741,354,31095,323
2021-06-16,Stanislaus,099,539301,56882,56738,5934,62672,984
2021-06-16,Sutter,101,95872,9581,9620,87,9707,113
2021-06-16,Tehama,103,63373,5138,5106,577,5683,63
2021-06-16,Trinity,105,12862,489,332,94,426,3
2021-06-16,Tulare,107,460477,50388,49578,8960,58538,849
2021-06-16,Tuolumne,109,53932,4061,4110,43,4153,63
2021-06-16,Ventura,111,848112,81653,81229,2976,84205,1029
2021-06-16,Yolo,113,214977,14140,14135,252,14387,212
2021-06-16,Yuba,115,75493,6169,6134,131,6265,51
2021-06-15,Alameda,001,1643700,88942,89008,1935,90943,1262
2021-06-15,Alpine,003,1148,88,88,0,88,0
2021-06-15,Amador,005,37829,3729,3723,32,3755,46
2021-06-15,Butte,007,227075,12741,12620,1834,14454,194
2021-06-15,Calaveras,009,45235,2188,2188,13,2201,55
2021-06-15,Colusa,011,21464,1962,1967,316,2283,15
2021-06-15,Contra Costa,013,1133247,70537,70101,1291,71392,810
2021-06-15,Del Norte,015,27424,1442,1411,13,1424,8
2021-06-15,El Dorado,017,186661,10413,10330,760,11090,113
2021-06-15,Fresno,019,978130,103194,102828,8646,111474,1722
2021-06-15,Glenn,021,27897,2445,2426,561,2987,19
2021-06-15,Humboldt,023,135768,4428,4414,40,4454,42
2021-06-15,Imperial,025,180216,28734,28789,2693,31482,741
2021-06-15,Inyo,027,18085,1408,1405,12,1417,35
2021-06-15,Kern,029,883053,97722,96782,10951,107733,1338
2021-06-15,Kings,031,150075,23222,23070,1074,24144,245
2021-06-15,Lake,033,64148,3568,3559,9,3568,45
2021-06-15,Lassen,035,31185,5257,5211,115,5326,19
2021-06-15,Los Angeles,037,10098052,1210604,1204926,41103,1246029,24435
2021-06-15,Madera,039,155013,16739,16600,932,17532,240
2021-06-15,Marin,041,260295,14175,14135,259,14394,229
2021-06-15,Mariposa,043,17540,439,437,11,448,5
2021-06-15,Mendocino,045,87422,4124,4034,82,4116,49
2021-06-15,Merced,047,269075,31161,31244,1040,32284,461
2021-06-15,Modoc,049,8938,408,383,145,528,3
2021-06-15,Mono,051,14174,1264,1275,16,1291,3
2021-06-15,Monterey,053,433212,43263,43118,1839,44957,416
2021-06-15,Napa,055,140530,9990,10010,36,10046,80
2021-06-15,Nevada,057,99092,4924,4888,193,5081,72
2021-06-15,Orange,059,3164182,256071,255127,11347,266474,5105
2021-06-15,Placer,061,380077,23666,23396,1517,24913,298
2021-06-15,Plumas,063,18699,714,697,11,708,4
2021-06-15,Riverside,065,2383286,295024,289508,13949,303457,4455
2021-06-15,Sacramento,067,1510023,107564,107370,1783,109153,1662
2021-06-15,San Benito,069,59416,6077,6089,113,6202,63
2021-06-15,San Bernardino,071,2135413,294135,293463,8962,302425,4790
2021-06-15,San Diego,073,3302833,282276,281375,15205,296580,3770
2021-06-15,San Francisco,075,870044,36955,37210,1277,38487,555
2021-06-15,San Joaquin,077,732212,73779,73494,3546,77040,1399
2021-06-15,San Luis Obispo,079,281455,21492,21293,741,22034,257
2021-06-15,San Mateo,081,765935,42564,42593,472,43065,543
2021-06-15,Santa Barbara,083,443738,34554,34451,1121,35572,460
2021-06-15,Santa Clara,085,1922200,119200,119963,759,120722,2086
2021-06-15,Santa Cruz,087,273765,16300,16180,797,16977,208
2021-06-15,Shasta,089,179085,12535,12583,1615,14198,201
2021-06-15,Sierra,091,2930,60,55,12,67,0
2021-06-15,Siskiyou,093,43540,1961,1887,363,2250,26
2021-06-15,Solano,095,438530,33248,33264,560,33824,266
2021-06-15,Sonoma,097,501317,30643,30707,353,31060,323
2021-06-15,Stanislaus,099,539301,56854,56724,5931,62655,979
2021-06-15,Sutter,101,95872,9572,9616,87,9703,113
2021-06-15,Tehama,103,63373,5136,5102,577,5679,63
2021-06-15,Trinity,105,12862,488,332,93,425,3
2021-06-15,Tulare,107,460477,50382,49561,8957,58518,848
2021-06-15,Tuolumne,109,53932,4061,4111,43,4154,63
2021-06-15,Ventura,111,848112,81642,81215,2973,84188,1029
2021-06-15,Yolo,113,214977,14136,14127,250,14377,212
2021-06-15,Yuba,115,75493,6158,6130,131,6261,51
2021-06-14,Alameda,001,1643700,88894,88966,1935,90901,1264
2021-06-14,Alpine,003,1148,88,88,0,88,0
2021-06-14,Amador,005,37829,3728,3722,32,3754,46
2021-06-14,Butte,007,227075,12730,12613,1830,14443,194
2021-06-14,Calaveras,009,45235,2187,2190,13,2203,55
2021-06-14,Colusa,011,21464,1961,1966,316,2282,15
2021-06-14,Contra Costa,013,1133247,70484,70069,1289,71358,810
2021-06-14,Del Norte,015,27424,1442,1411,13,1424,8
2021-06-14,El Dorado,017,186661,10404,10327,758,11085,113
2021-06-14,Fresno,019,978130,103172,102812,8644,111456,1719
2021-06-14,Glenn,021,27897,2445,2426,561,2987,19
2021-06-14,Humboldt,023,135768,4420,4407,39,4446,42
2021-06-14,Imperial,025,180216,28722,28836,2693,31529,741
2021-06-14,Inyo,027,18085,1407,1405,12,1417,35
2021-06-14,Kern,029,883053,97702,96760,10941,107701,1337
2021-06-14,Kings,031,150075,23219,23071,1073,24144,245
2021-06-14,Lake,033,64148,3567,3557,9,3566,45
2021-06-14,Lassen,035,31185,5254,5209,114,5323,19
2021-06-14,Los Angeles,037,10098052,1210362,1204748,41093,1245841,24434
2021-06-14,Madera,039,155013,16733,16597,931,17528,240
2021-06-14,Marin,041,260295,14173,14133,259,14392,229
2021-06-14,Mariposa,043,17540,438,437,11,448,5
2021-06-14,Mendocino,045,87422,4118,4028,82,4110,49
2021-06-14,Merced,047,269075,31152,31241,1039,32280,461
2021-06-14,Modoc,049,8938,399,382,143,525,3
2021-06-14,Mono,051,14174,1264,1275,16,1291,3
2021-06-14,Monterey,053,433212,43260,43110,1839,44949,415
2021-06-14,Napa,055,140530,9986,10000,36,10036,80
2021-06-14,Nevada,057,99092,4917,4885,193,5078,72
2021-06-14,Orange,059,3164182,256033,255069,11343,266412,5103
2021-06-14,Placer,061,380077,23641,23379,1516,24895,298
2021-06-14,Plumas,063,18699,714,696,11,707,4
2021-06-14,Riverside,065,2383286,294970,289476,13949,303425,4453
2021-06-14,Sacramento,067,1510023,107510,107334,1778,109112,1661
2021-06-14,San Benito,069,59416,6077,6087,113,6200,63
2021-06-14,San Bernardino,071,2135413,294079,293446,8958,302404,4790
2021-06-14,San Diego,073,3302833,282170,281314,15185,296499,3770
2021-06-14,San Francisco,075,870044,36943,37206,1277,38483,555
2021-06-14,San Joaquin,077,732212,73750,73453,3546,76999,1398
2021-06-14,San Luis Obispo,079,281455,21490,21302,741,22043,256
2021-06-14,San Mateo,081,765935,42551,42619,471,43090,543
2021-06-14,Santa Barbara,083,443738,34551,34449,1121,35570,460
2021-06-14,Santa Clara,085,1922200,119169,119957,758,120715,2085
2021-06-14,Santa Cruz,087,273765,16297,16175,797,16972,208
2021-06-14,Shasta,089,179085,12524,12561,1612,14173,201
2021-06-14,Sierra,091,2930,59,55,12,67,0
2021-06-14,Siskiyou,093,43540,1961,1886,363,2249,26
2021-06-14,Solano,095,438530,33231,33243,559,33802,266
2021-06-14,Sonoma,097,501317,30611,30679,352,31031,323
2021-06-14,Stanislaus,099,539301,56817,56689,5928,62617,975
2021-06-14,Sutter,101,95872,9569,9607,87,9694,112
2021-06-14,Tehama,103,63373,5134,5102,577,5679,63
2021-06-14,Trinity,105,12862,488,332,93,425,3
2021-06-14,Tulare,107,460477,50377,49538,8954,58492,848
2021-06-14,Tuolumne,109,53932,4058,4108,43,4151,63
2021-06-14,Ventura,111,848112,81632,81209,2973,84182,1028
2021-06-14,Yolo,113,214977,14128,14123,250,14373,212
2021-06-14,Yuba,115,75493,6151,6127,131,6258,50
2021-06-13,Alameda,001,1643700,88837,88947,1934,90881,1264
2021-06-13,Alpine,003,1148,87,88,0,88,0
2021-06-13,Amador,005,37829,3724,3721,32,3753,46
2021-06-13,Butte,007,227075,12719,12586,1827,14413,194
2021-06-13,Calaveras,009,45235,2187,2189,13,2202,55
2021-06-13,Colusa,011,21464,1961,1965,315,2280,15
2021-06-13,Contra Costa,013,1133247,70430,70040,1287,71327,810
2021-06-13,Del Norte,015,27424,1440,1412,13,1425,8
2021-06-13,El Dorado,017,186661,10395,10324,758,11082,113
2021-06-13,Fresno,019,978130,103142,102795,8639,111434,1719
2021-06-13,Glenn,021,27897,2444,2425,559,2984,19
2021-06-13,Humboldt,023,135768,4407,4401,39,4440,42
2021-06-13,Imperial,025,180216,28713,28800,2693,31493,741
2021-06-13,Inyo,027,18085,1407,1405,12,1417,35
2021-06-13,Kern,029,883053,97678,96743,10929,107672,1337
2021-06-13,Kings,031,150075,23214,23069,1072,24141,245
2021-06-13,Lake,033,64148,3567,3556,9,3565,45
2021-06-13,Lassen,035,31185,5249,5209,114,5323,19
2021-06-13,Los Angeles,037,10098052,1210095,1204614,41081,1245695,24433
2021-06-13,Madera,039,155013,16719,16590,931,17521,240
2021-06-13,Marin,041,260295,14167,14126,259,14385,229
2021-06-13,Mariposa,043,17540,438,434,11,445,5
2021-06-13,Mendocino,045,87422,4111,4026,82,4108,49
2021-06-13,Merced,047,269075,31146,31240,1038,32278,461
2021-06-13,Modoc,049,8938,397,382,141,523,3
2021-06-13,Mono,051,14174,1264,1275,16,1291,3
2021-06-13,Monterey,053,433212,43252,43108,1839,44947,415
2021-06-13,Napa,055,140530,9980,9995,36,10031,80
2021-06-13,Nevada,057,99092,4912,4883,193,5076,72
2021-06-13,Orange,059,3164182,255978,255043,11340,266383,5103
2021-06-13,Placer,061,380077,23615,23365,1514,24879,295
2021-06-13,Plumas,063,18699,713,696,11,707,4
2021-06-13,Riverside,065,2383286,294903,289447,13946,303393,4453
2021-06-13,Sacramento,067,1510023,107434,107289,1775,109064,1658
2021-06-13,San Benito,069,59416,6077,6086,113,6199,63
2021-06-13,San Bernardino,071,2135413,294027,293416,8953,302369,4788
2021-06-13,San Diego,073,3302833,282091,281268,15169,296437,3770
2021-06-13,San Francisco,075,870044,36931,37197,1277,38474,555
2021-06-13,San Joaquin,077,732212,73715,73438,3544,76982,1398
2021-06-13,San Luis Obispo,079,281455,21484,21298,740,22038,256
2021-06-13,San Mateo,081,765935,42538,42611,471,43082,542
2021-06-13,Santa Barbara,083,443738,34540,34449,1120,35569,460
2021-06-13,Santa Clara,085,1922200,119145,119946,758,120704,2085
2021-06-13,Santa Cruz,087,273765,16290,16172,797,16969,208
2021-06-13,Shasta,089,179085,12515,12560,1611,14171,201
2021-06-13,Sierra,091,2930,59,55,12,67,0
2021-06-13,Siskiyou,093,43540,1960,1885,363,2248,26
2021-06-13,Solano,095,438530,33210,33234,559,33793,266
2021-06-13,Sonoma,097,501317,30576,30663,350,31013,323
2021-06-13,Stanislaus,099,539301,56791,56671,5925,62596,975
2021-06-13,Sutter,101,95872,9562,9603,87,9690,112
2021-06-13,Tehama,103,63373,5132,5100,577,5677,63
2021-06-13,Trinity,105,12862,487,332,93,425,3
2021-06-13,Tulare,107,460477,50368,49537,8949,58486,848
2021-06-13,Tuolumne,109,53932,4056,4107,42,4149,63
2021-06-13,Ventura,111,848112,81618,81201,2973,84174,1028
2021-06-13,Yolo,113,214977,14119,14120,248,14368,212
2021-06-13,Yuba,115,75493,6144,6125,131,6256,50
2021-06-12,Alameda,001,1643700,88809,88901,1934,90835,1271
2021-06-12,Alpine,003,1148,87,88,0,88,0
2021-06-12,Amador,005,37829,3723,3721,32,3753,46
2021-06-12,Butte,007,227075,12715,12576,1827,14403,194
2021-06-12,Calaveras,009,45235,2187,2189,13,2202,55
2021-06-12,Colusa,011,21464,1961,1965,315,2280,15
2021-06-12,Contra Costa,013,1133247,70399,69989,1285,71274,810
2021-06-12,Del Norte,015,27424,1440,1412,13,1425,8
2021-06-12,El Dorado,017,186661,10390,10320,757,11077,113
2021-06-12,Fresno,019,978130,103132,102783,8638,111421,1720
2021-06-12,Glenn,021,27897,2442,2425,559,2984,19
2021-06-12,Humboldt,023,135768,4399,4396,39,4435,42
2021-06-12,Imperial,025,180216,28710,28799,2693,31492,741
2021-06-12,Inyo,027,18085,1407,1405,12,1417,35
2021-06-12,Kern,029,883053,97663,96731,10925,107656,1337
2021-06-12,Kings,031,150075,23212,23067,1072,24139,245
2021-06-12,Lake,033,64148,3566,3552,9,3561,45
2021-06-12,Lassen,035,31185,5249,5208,114,5322,19
2021-06-12,Los Angeles,037,10098052,1209954,1204439,41075,1245514,24434
2021-06-12,Madera,039,155013,16715,16586,931,17517,240
2021-06-12,Marin,041,260295,14164,14121,259,14380,229
2021-06-12,Mariposa,043,17540,438,434,11,445,5
2021-06-12,Mendocino,045,87422,4108,4024,82,4106,49
2021-06-12,Merced,047,269075,31143,31236,1038,32274,461
2021-06-12,Modoc,049,8938,396,382,141,523,3
2021-06-12,Mono,051,14174,1264,1275,16,1291,3
2021-06-12,Monterey,053,433212,43247,43103,1839,44942,415
2021-06-12,Napa,055,140530,9976,9986,36,10022,80
2021-06-12,Nevada,057,99092,4906,4878,193,5071,72
2021-06-12,Orange,059,3164182,255945,255004,11338,266342,5103
2021-06-12,Placer,061,380077,23596,23345,1514,24859,295
2021-06-12,Plumas,063,18699,713,696,11,707,4
2021-06-12,Riverside,065,2383286,294861,289413,13943,303356,4453
2021-06-12,Sacramento,067,1510023,107375,107199,1772,108971,1658
2021-06-12,San Benito,069,59416,6075,6083,113,6196,63
2021-06-12,San Bernardino,071,2135413,293992,293375,8951,302326,4788
2021-06-12,San Diego,073,3302833,282034,281203,15160,296363,3770
2021-06-12,San Francisco,075,870044,36921,37189,1277,38466,555
2021-06-12,San Joaquin,077,732212,73696,73413,3543,76956,1398
2021-06-12,San Luis Obispo,079,281455,21481,21293,740,22033,256
2021-06-12,San Mateo,081,765935,42532,42604,471,43075,542
2021-06-12,Santa Barbara,083,443738,34535,34450,1120,35570,460
2021-06-12,Santa Clara,085,1922200,119105,119894,758,120652,2085
2021-06-12,Santa Cruz,087,273765,16282,16170,797,16967,208
2021-06-12,Shasta,089,179085,12512,12556,1610,14166,201
2021-06-12,Sierra,091,2930,59,55,12,67,0
2021-06-12,Siskiyou,093,43540,1959,1884,363,2247,25
2021-06-12,Solano,095,438530,33201,33219,559,33778,266
2021-06-12,Sonoma,097,501317,30547,30647,350,30997,323
2021-06-12,Stanislaus,099,539301,56774,56649,5924,62573,974
2021-06-12,Sutter,101,95872,9558,9603,87,9690,112
2021-06-12,Tehama,103,63373,5132,5099,576,5675,63
2021-06-12,Trinity,105,12862,487,332,93,425,3
2021-06-12,Tulare,107,460477,50363,49533,8942,58475,848
2021-06-12,Tuolumne,109,53932,4055,4105,42,4147,63
2021-06-12,Ventura,111,848112,81606,81197,2973,84170,1028
2021-06-12,Yolo,113,214977,14116,14118,247,14365,212
2021-06-12,Yuba,115,75493,6139,6120,131,6251,50
2021-06-11,Alameda,001,1643700,88781,88844,1934,90778,1278
2021-06-11,Alpine,003,1148,87,88,0,88,0
2021-06-11,Amador,005,37829,3722,3710,32,3742,46
2021-06-11,Butte,007,227075,12711,12576,1825,14401,194
2021-06-11,Calaveras,009,45235,2187,2188,13,2201,55
2021-06-11,Colusa,011,21464,1960,1964,315,2279,15
2021-06-11,Contra Costa,013,1133247,70366,69940,1283,71223,808
2021-06-11,Del Norte,015,27424,1440,1409,13,1422,8
2021-06-11,El Dorado,017,186661,10387,10316,757,11073,113
2021-06-11,Fresno,019,978130,103113,102770,8637,111407,1720
2021-06-11,Glenn,021,27897,2442,2425,559,2984,19
2021-06-11,Humboldt,023,135768,4395,4389,39,4428,42
2021-06-11,Imperial,025,180216,28705,28793,2693,31486,741
2021-06-11,Inyo,027,18085,1407,1405,12,1417,35
2021-06-11,Kern,029,883053,97651,96718,10922,107640,1340
2021-06-11,Kings,031,150075,23208,23069,1071,24140,245
2021-06-11,Lake,033,64148,3565,3550,9,3559,45
2021-06-11,Lassen,035,31185,5248,5204,114,5318,18
2021-06-11,Los Angeles,037,10098052,1209804,1204259,41060,1245319,24434
2021-06-11,Madera,039,155013,16712,16582,931,17513,240
2021-06-11,Marin,041,260295,14161,14116,259,14375,229
2021-06-11,Mariposa,043,17540,438,434,11,445,5
2021-06-11,Mendocino,045,87422,4105,4022,82,4104,49
2021-06-11,Merced,047,269075,31138,31231,1038,32269,461
2021-06-11,Modoc,049,8938,396,382,140,522,3
2021-06-11,Mono,051,14174,1264,1274,16,1290,3
2021-06-11,Monterey,053,433212,43243,43097,1839,44936,415
2021-06-11,Napa,055,140530,9973,9977,36,10013,80
2021-06-11,Nevada,057,99092,4904,4873,193,5066,72
2021-06-11,Orange,059,3164182,255911,254975,11335,266310,5101
2021-06-11,Placer,061,380077,23591,23330,1514,24844,294
2021-06-11,Plumas,063,18699,713,696,11,707,4
2021-06-11,Riverside,065,2383286,294823,289376,13938,303314,4451
2021-06-11,Sacramento,067,1510023,107315,107119,1771,108890,1659
2021-06-11,San Benito,069,59416,6074,6082,113,6195,63
2021-06-11,San Bernardino,071,2135413,293956,293335,8947,302282,4788
2021-06-11,San Diego,073,3302833,281994,281144,15153,296297,3768
2021-06-11,San Francisco,075,870044,36917,37177,1277,38454,555
2021-06-11,San Joaquin,077,732212,73679,73347,3540,76887,1397
2021-06-11,San Luis Obispo,079,281455,21480,21288,740,22028,256
2021-06-11,San Mateo,081,765935,42518,42585,471,43056,542
2021-06-11,Santa Barbara,083,443738,34532,34438,1120,35558,460
2021-06-11,Santa Clara,085,1922200,119085,119860,758,120618,2083
2021-06-11,Santa Cruz,087,273765,16274,16164,797,16961,208
2021-06-11,Shasta,089,179085,12504,12550,1608,14158,201
2021-06-11,Sierra,091,2930,59,55,12,67,0
2021-06-11,Siskiyou,093,43540,1958,1882,363,2245,25
2021-06-11,Solano,095,438530,33181,33179,558,33737,266
2021-06-11,Sonoma,097,501317,30529,30624,350,30974,323
2021-06-11,Stanislaus,099,539301,56748,56617,5920,62537,974
2021-06-11,Sutter,101,95872,9555,9600,86,9686,112
2021-06-11,Tehama,103,63373,5131,5099,576,5675,63
2021-06-11,Trinity,105,12862,487,331,93,424,3
2021-06-11,Tulare,107,460477,50357,49516,8941,58457,848
2021-06-11,Tuolumne,109,53932,4052,4104,42,4146,63
2021-06-11,Ventura,111,848112,81596,81189,2973,84162,1026
2021-06-11,Yolo,113,214977,14109,14111,243,14354,212
2021-06-11,Yuba,115,75493,6135,6113,131,6244,50
2021-06-10,Alameda,001,1643700,88737,88806,1933,90739,1275
2021-06-10,Alpine,003,1148,87,88,0,88,0
2021-06-10,Amador,005,37829,3718,3709,32,3741,46
2021-06-10,Butte,007,227075,12694,12565,1825,14390,194
2021-06-10,Calaveras,009,45235,2186,2188,13,2201,55
2021-06-10,Colusa,011,21464,1958,1964,315,2279,15
2021-06-10,Contra Costa,013,1133247,70312,69876,1283,71159,807
2021-06-10,Del Norte,015,27424,1440,1405,13,1418,8
2021-06-10,El Dorado,017,186661,10380,10314,753,11067,113
2021-06-10,Fresno,019,978130,103087,102724,8636,111360,1717
2021-06-10,Glenn,021,27897,2442,2425,559,2984,19
2021-06-10,Humboldt,023,135768,4387,4384,39,4423,42
2021-06-10,Imperial,025,180216,28699,28779,2693,31472,739
2021-06-10,Inyo,027,18085,1407,1405,12,1417,35
2021-06-10,Kern,029,883053,97637,96706,10917,107623,1336
2021-06-10,Kings,031,150075,23207,23067,1071,24138,245
2021-06-10,Lake,033,64148,3560,3550,9,3559,45
2021-06-10,Lassen,035,31185,5246,5201,114,5315,18
2021-06-10,Los Angeles,037,10098052,1209639,1204110,41044,1245154,24440
2021-06-10,Madera,039,155013,16705,16581,930,17511,240
2021-06-10,Marin,041,260295,14158,14118,259,14377,229
2021-06-10,Mariposa,043,17540,436,434,11,445,5
2021-06-10,Mendocino,045,87422,4100,4016,82,4098,48
2021-06-10,Merced,047,269075,31130,31231,1035,32266,461
2021-06-10,Modoc,049,8938,395,381,140,521,3
2021-06-10,Mono,051,14174,1263,1274,16,1290,3
2021-06-10,Monterey,053,433212,43237,43090,1839,44929,415
2021-06-10,Napa,055,140530,9972,9974,36,10010,80
2021-06-10,Nevada,057,99092,4899,4866,193,5059,72
2021-06-10,Orange,059,3164182,255881,254950,11328,266278,5097
2021-06-10,Placer,061,380077,23578,23296,1514,24810,293
2021-06-10,Plumas,063,18699,713,696,11,707,4
2021-06-10,Riverside,065,2383286,294781,289335,13933,303268,4450
2021-06-10,Sacramento,067,1510023,107253,107049,1771,108820,1658
2021-06-10,San Benito,069,59416,6074,6079,113,6192,63
2021-06-10,San Bernardino,071,2135413,293915,293281,8944,302225,4782
2021-06-10,San Diego,073,3302833,281936,281052,15136,296188,3766
2021-06-10,San Francisco,075,870044,36907,37159,1275,38434,552
2021-06-10,San Joaquin,077,732212,73645,73276,3539,76815,1393
2021-06-10,San Luis Obispo,079,281455,21477,21280,740,22020,256
2021-06-10,San Mateo,081,765935,42511,42562,471,43033,666
2021-06-10,Santa Barbara,083,443738,34528,34434,1120,35554,460
2021-06-10,Santa Clara,085,1922200,119050,119832,757,120589,2075
2021-06-10,Santa Cruz,087,273765,16273,16159,797,16956,208
2021-06-10,Shasta,089,179085,12494,12536,1608,14144,201
2021-06-10,Sierra,091,2930,58,55,12,67,0
2021-06-10,Siskiyou,093,43540,1958,1881,363,2244,25
2021-06-10,Solano,095,438530,33164,33150,557,33707,265
2021-06-10,Sonoma,097,501317,30493,30571,348,30919,323
2021-06-10,Stanislaus,099,539301,56727,56588,5916,62504,974
2021-06-10,Sutter,101,95872,9548,9594,86,9680,112
2021-06-10,Tehama,103,63373,5131,5096,576,5672,63
2021-06-10,Trinity,105,12862,487,331,93,424,3
2021-06-10,Tulare,107,460477,50349,49503,8941,58444,848
2021-06-10,Tuolumne,109,53932,4052,4100,42,4142,63
2021-06-10,Ventura,111,848112,81585,81172,2972,84144,1026
2021-06-10,Yolo,113,214977,14106,14107,243,14350,212
2021-06-10,Yuba,115,75493,6131,6112,131,6243,50
2021-06-09,Alameda,001,1643700,88694,88762,1932,90694,1271
2021-06-09,Alpine,003,1148,87,88,0,88,0
2021-06-09,Amador,005,37829,3714,3706,32,3738,46
2021-06-09,Butte,007,227075,12688,12555,1823,14378,194
2021-06-09,Calaveras,009,45235,2184,2184,13,2197,55
2021-06-09,Colusa,011,21464,1958,1962,314,2276,15
2021-06-09,Contra Costa,013,1133247,70275,69829,1282,71111,803
2021-06-09,Del Norte,015,27424,1436,1403,13,1416,8
2021-06-09,El Dorado,017,186661,10377,10312,752,11064,113
2021-06-09,Fresno,019,978130,103067,102690,8632,111322,1717
2021-06-09,Glenn,021,27897,2441,2424,559,2983,19
2021-06-09,Humboldt,023,135768,4382,4379,38,4417,42
2021-06-09,Imperial,025,180216,28696,28754,2693,31447,739
2021-06-09,Inyo,027,18085,1407,1405,12,1417,35
2021-06-09,Kern,029,883053,97623,96697,10908,107605,1328
2021-06-09,Kings,031,150075,23205,23061,1071,24132,245
2021-06-09,Lake,033,64148,3557,3541,9,3550,45
2021-06-09,Lassen,035,31185,5245,5200,114,5314,18
2021-06-09,Los Angeles,037,10098052,1209451,1203955,41031,1244986,24432
2021-06-09,Madera,039,155013,16700,16580,930,17510,240
2021-06-09,Marin,041,260295,14153,14114,259,14373,229
2021-06-09,Mariposa,043,17540,436,434,11,445,5
2021-06-09,Mendocino,045,87422,4094,4008,82,4090,47
2021-06-09,Merced,047,269075,31126,31225,1035,32260,461
2021-06-09,Modoc,049,8938,393,377,139,516,3
2021-06-09,Mono,051,14174,1263,1274,16,1290,3
2021-06-09,Monterey,053,433212,43230,43082,1839,44921,415
2021-06-09,Napa,055,140530,9966,9971,36,10007,80
2021-06-09,Nevada,057,99092,4889,4863,192,5055,72
2021-06-09,Orange,059,3164182,255837,254893,11323,266216,5080
2021-06-09,Placer,061,380077,23559,23237,1514,24751,293
2021-06-09,Plumas,063,18699,712,697,11,708,4
2021-06-09,Riverside,065,2383286,294735,289299,13931,303230,4450
2021-06-09,Sacramento,067,1510023,107190,106971,1768,108739,1657
2021-06-09,San Benito,069,59416,6071,6078,113,6191,63
2021-06-09,San Bernardino,071,2135413,293873,293222,8944,302166,4782
2021-06-09,San Diego,073,3302833,281872,280941,15124,296065,3765
2021-06-09,San Francisco,075,870044,36894,37143,1274,38417,552
2021-06-09,San Joaquin,077,732212,73619,73232,3539,76771,1392
2021-06-09,San Luis Obispo,079,281455,21476,21259,740,21999,256
2021-06-09,San Mateo,081,765935,42495,42502,470,42972,666
2021-06-09,Santa Barbara,083,443738,34517,34422,1120,35542,460
2021-06-09,Santa Clara,085,1922200,119012,119793,756,120549,2068
2021-06-09,Santa Cruz,087,273765,16270,16155,797,16952,208
2021-06-09,Shasta,089,179085,12484,12521,1606,14127,201
2021-06-09,Sierra,091,2930,57,55,12,67,0
2021-06-09,Siskiyou,093,43540,1957,1871,363,2234,25
2021-06-09,Solano,095,438530,33148,33137,556,33693,264
2021-06-09,Sonoma,097,501317,30471,30540,348,30888,323
2021-06-09,Stanislaus,099,539301,56707,56560,5913,62473,974
2021-06-09,Sutter,101,95872,9539,9586,85,9671,111
2021-06-09,Tehama,103,63373,5130,5093,576,5669,63
2021-06-09,Trinity,105,12862,486,331,93,424,3
2021-06-09,Tulare,107,460477,50345,49496,8939,58435,847
2021-06-09,Tuolumne,109,53932,4049,4100,42,4142,63
2021-06-09,Ventura,111,848112,81575,81154,2971,84125,1026
2021-06-09,Yolo,113,214977,14104,14102,242,14344,212
2021-06-09,Yuba,115,75493,6127,6109,131,6240,50
2021-06-08,Alameda,001,1643700,88646,88731,1932,90663,1267
2021-06-08,Alpine,003,1148,87,88,0,88,0
2021-06-08,Amador,005,37829,3713,3704,32,3736,46
2021-06-08,Butte,007,227075,12682,12540,1821,14361,194
2021-06-08,Calaveras,009,45235,2183,2181,13,2194,55
2021-06-08,Colusa,011,21464,1958,1961,314,2275,15
2021-06-08,Contra Costa,013,1133247,70227,69762,1281,71043,803
2021-06-08,Del Norte,015,27424,1434,1402,13,1415,8
2021-06-08,El Dorado,017,186661,10372,10306,750,11056,113
2021-06-08,Fresno,019,978130,103042,102680,8630,111310,1717
2021-06-08,Glenn,021,27897,2440,2423,559,2982,19
2021-06-08,Humboldt,023,135768,4377,4363,38,4401,42
2021-06-08,Imperial,025,180216,28687,28752,2693,31445,738
2021-06-08,Inyo,027,18085,1407,1405,12,1417,35
2021-06-08,Kern,029,883053,97604,96671,10901,107572,1325
2021-06-08,Kings,031,150075,23204,23036,1071,24107,245
2021-06-08,Lake,033,64148,3556,3540,9,3549,45
2021-06-08,Lassen,035,31185,5245,5200,114,5314,18
2021-06-08,Los Angeles,037,10098052,1209253,1203794,41019,1244813,24426
2021-06-08,Madera,039,155013,16694,16579,929,17508,240
2021-06-08,Marin,041,260295,14151,14111,258,14369,229
2021-06-08,Mariposa,043,17540,436,434,11,445,5
2021-06-08,Mendocino,045,87422,4087,4002,82,4084,47
2021-06-08,Merced,047,269075,31118,31225,1035,32260,461
2021-06-08,Modoc,049,8938,387,377,138,515,3
2021-06-08,Mono,051,14174,1263,1274,16,1290,3
2021-06-08,Monterey,053,433212,43224,43078,1838,44916,415
2021-06-08,Napa,055,140530,9962,9962,36,9998,80
2021-06-08,Nevada,057,99092,4884,4861,192,5053,72
2021-06-08,Orange,059,3164182,255795,254852,11316,266168,5078
2021-06-08,Placer,061,380077,23541,23209,1510,24719,293
2021-06-08,Plumas,063,18699,712,692,11,703,4
2021-06-08,Riverside,065,2383286,294699,289268,13923,303191,4452
2021-06-08,Sacramento,067,1510023,107128,106901,1765,108666,1654
2021-06-08,San Benito,069,59416,6069,6076,113,6189,63
2021-06-08,San Bernardino,071,2135413,293824,293186,8940,302126,4778
2021-06-08,San Diego,073,3302833,281809,280879,15115,295994,3764
2021-06-08,San Francisco,075,870044,36879,37134,1273,38407,552
2021-06-08,San Joaquin,077,732212,73575,73186,3534,76720,1390
2021-06-08,San Luis Obispo,079,281455,21470,21251,739,21990,255
2021-06-08,San Mateo,081,765935,42482,42488,470,42958,663
2021-06-08,Santa Barbara,083,443738,34513,34418,1120,35538,459
2021-06-08,Santa Clara,085,1922200,118991,119770,755,120525,2068
2021-06-08,Santa Cruz,087,273765,16267,16160,797,16957,208
2021-06-08,Shasta,089,179085,12469,12498,1606,14104,201
2021-06-08,Sierra,091,2930,57,55,12,67,0
2021-06-08,Siskiyou,093,43540,1955,1870,361,2231,21
2021-06-08,Solano,095,438530,33127,33130,556,33686,259
2021-06-08,Sonoma,097,501317,30445,30523,346,30869,323
2021-06-08,Stanislaus,099,539301,56680,56548,5911,62459,973
2021-06-08,Sutter,101,95872,9536,9581,85,9666,111
2021-06-08,Tehama,103,63373,5127,5093,576,5669,63
2021-06-08,Trinity,105,12862,486,330,92,422,3
2021-06-08,Tulare,107,460477,50333,49485,8935,58420,847
2021-06-08,Tuolumne,109,53932,4045,4099,42,4141,63
2021-06-08,Ventura,111,848112,81559,81142,2970,84112,1026
2021-06-08,Yolo,113,214977,14099,14099,241,14340,212
2021-06-08,Yuba,115,75493,6125,6103,131,6234,50
2021-06-07,Alameda,001,1643700,88589,88688,1932,90620,1267
2021-06-07,Alpine,003,1148,87,88,0,88,0
2021-06-07,Amador,005,37829,3703,3697,32,3729,46
2021-06-07,Butte,007,227075,12675,12533,1820,14353,194
2021-06-07,Calaveras,009,45235,2182,2181,13,2194,55
2021-06-07,Colusa,011,21464,1957,1960,314,2274,15
2021-06-07,Contra Costa,013,1133247,70170,69718,1280,70998,817
2021-06-07,Del Norte,015,27424,1434,1401,13,1414,8
2021-06-07,El Dorado,017,186661,10367,10305,750,11055,113
2021-06-07,Fresno,019,978130,103011,102659,8622,111281,1717
2021-06-07,Glenn,021,27897,2440,2423,559,2982,19
2021-06-07,Humboldt,023,135768,4369,4354,38,4392,42
2021-06-07,Imperial,025,180216,28685,28754,2693,31447,738
2021-06-07,Inyo,027,18085,1407,1404,12,1416,35
2021-06-07,Kern,029,883053,97588,96645,10894,107539,1324
2021-06-07,Kings,031,150075,23200,23023,1071,24094,244
2021-06-07,Lake,033,64148,3554,3540,9,3549,45
2021-06-07,Lassen,035,31185,5240,5198,114,5312,18
2021-06-07,Los Angeles,037,10098052,1209028,1203664,41005,1244669,24413
2021-06-07,Madera,039,155013,16687,16572,929,17501,240
2021-06-07,Marin,041,260295,14147,14108,257,14365,229
2021-06-07,Mariposa,043,17540,436,434,11,445,5
2021-06-07,Mendocino,045,87422,4081,3998,82,4080,47
2021-06-07,Merced,047,269075,31106,31212,1034,32246,459
2021-06-07,Modoc,049,8938,386,375,135,510,3
2021-06-07,Mono,051,14174,1263,1275,16,1291,3
2021-06-07,Monterey,053,433212,43217,43077,1838,44915,415
2021-06-07,Napa,055,140530,9954,9962,36,9998,80
2021-06-07,Nevada,057,99092,4882,4860,192,5052,72
2021-06-07,Orange,059,3164182,255755,254808,11308,266116,5073
2021-06-07,Placer,061,380077,23522,23176,1508,24684,293
2021-06-07,Plumas,063,18699,712,692,11,703,4
2021-06-07,Riverside,065,2383286,294656,289232,13919,303151,4451
2021-06-07,Sacramento,067,1510023,107052,106841,1762,108603,1655
2021-06-07,San Benito,069,59416,6068,6074,113,6187,63
2021-06-07,San Bernardino,071,2135413,293786,293129,8939,302068,4775
2021-06-07,San Diego,073,3302833,281727,280808,15102,295910,3764
2021-06-07,San Francisco,075,870044,36863,37122,1273,38395,552
2021-06-07,San Joaquin,077,732212,73530,73130,3527,76657,1388
2021-06-07,San Luis Obispo,079,281455,21457,21252,739,21991,255
2021-06-07,San Mateo,081,765935,42466,42479,470,42949,664
2021-06-07,Santa Barbara,083,443738,34507,34407,1120,35527,459
2021-06-07,Santa Clara,085,1922200,118959,119743,755,120498,2066
2021-06-07,Santa Cruz,087,273765,16266,16159,797,16956,208
2021-06-07,Shasta,089,179085,12455,12483,1601,14084,200
2021-06-07,Sierra,091,2930,57,55,12,67,0
2021-06-07,Siskiyou,093,43540,1955,1869,361,2230,21
2021-06-07,Solano,095,438530,33105,33124,555,33679,258
2021-06-07,Sonoma,097,501317,30409,30504,345,30849,323
2021-06-07,Stanislaus,099,539301,56647,56521,5909,62430,972
2021-06-07,Sutter,101,95872,9532,9571,85,9656,111
2021-06-07,Tehama,103,63373,5123,5092,574,5666,63
2021-06-07,Trinity,105,12862,486,329,92,421,3
2021-06-07,Tulare,107,460477,50327,49471,8935,58406,847
2021-06-07,Tuolumne,109,53932,4044,4098,42,4140,63
2021-06-07,Ventura,111,848112,81542,81137,2968,84105,1025
2021-06-07,Yolo,113,214977,14094,14097,240,14337,211
2021-06-07,Yuba,115,75493,6123,6099,128,6227,49
2021-06-06,Alameda,001,1643700,88551,88636,1931,90567,1267
2021-06-06,Alpine,003,1148,87,88,0,88,0
2021-06-06,Amador,005,37829,3700,3696,32,3728,46
2021-06-06,Butte,007,227075,12664,12527,1819,14346,194
2021-06-06,Calaveras,009,45235,2181,2181,13,2194,55
2021-06-06,Colusa,011,21464,1955,1959,314,2273,15
2021-06-06,Contra Costa,013,1133247,70105,69659,1278,70937,817
2021-06-06,Del Norte,015,27424,1429,1401,13,1414,8
2021-06-06,El Dorado,017,186661,10360,10294,750,11044,113
2021-06-06,Fresno,019,978130,102978,102642,8619,111261,1717
2021-06-06,Glenn,021,27897,2439,2423,559,2982,19
2021-06-06,Humboldt,023,135768,4358,4353,38,4391,42
2021-06-06,Imperial,025,180216,28679,28762,2693,31455,738
2021-06-06,Inyo,027,18085,1406,1404,12,1416,35
2021-06-06,Kern,029,883053,97570,96623,10887,107510,1324
2021-06-06,Kings,031,150075,23194,23021,1071,24092,244
2021-06-06,Lake,033,64148,3554,3535,9,3544,45
2021-06-06,Lassen,035,31185,5238,5191,114,5305,18
2021-06-06,Los Angeles,037,10098052,1208829,1203539,40991,1244530,24410
2021-06-06,Madera,039,155013,16680,16567,929,17496,240
2021-06-06,Marin,041,260295,14141,14106,256,14362,229
2021-06-06,Mariposa,043,17540,435,435,11,446,5
2021-06-06,Mendocino,045,87422,4077,3993,82,4075,47
2021-06-06,Merced,047,269075,31100,31215,1033,32248,459
2021-06-06,Modoc,049,8938,386,375,134,509,3
2021-06-06,Mono,051,14174,1263,1275,16,1291,3
2021-06-06,Monterey,053,433212,43212,43078,1838,44916,415
2021-06-06,Napa,055,140530,9948,9963,36,9999,80
2021-06-06,Nevada,057,99092,4875,4854,191,5045,72
2021-06-06,Orange,059,3164182,255719,254782,11303,266085,5073
2021-06-06,Placer,061,380077,23497,23156,1505,24661,293
2021-06-06,Plumas,063,18699,712,692,11,703,4
2021-06-06,Riverside,065,2383286,294617,289201,13913,303114,4451
2021-06-06,Sacramento,067,1510023,106966,106749,1761,108510,1655
2021-06-06,San Benito,069,59416,6062,6074,113,6187,63
2021-06-06,San Bernardino,071,2135413,293730,293117,8930,302047,4773
2021-06-06,San Diego,073,3302833,281647,280743,15085,295828,3764
2021-06-06,San Francisco,075,870044,36850,37118,1271,38389,552
2021-06-06,San Joaquin,077,732212,73498,73105,3523,76628,1388
2021-06-06,San Luis Obispo,079,281455,21454,21246,739,21985,255
2021-06-06,San Mateo,081,765935,42449,42457,470,42927,664
2021-06-06,Santa Barbara,083,443738,34503,34403,1119,35522,459
2021-06-06,Santa Clara,085,1922200,118937,119711,755,120466,2066
2021-06-06,Santa Cruz,087,273765,16265,16158,797,16955,208
2021-06-06,Shasta,089,179085,12440,12478,1598,14076,200
2021-06-06,Sierra,091,2930,57,55,12,67,0
2021-06-06,Siskiyou,093,43540,1952,1869,361,2230,21
2021-06-06,Solano,095,438530,33078,33093,555,33648,258
2021-06-06,Sonoma,097,501317,30378,30478,344,30822,323
2021-06-06,Stanislaus,099,539301,56611,56486,5906,62392,972
2021-06-06,Sutter,101,95872,9525,9567,85,9652,111
2021-06-06,Tehama,103,63373,5113,5092,572,5664,63
2021-06-06,Trinity,105,12862,486,328,92,420,3
2021-06-06,Tulare,107,460477,50319,49466,8930,58396,847
2021-06-06,Tuolumne,109,53932,4041,4097,42,4139,63
2021-06-06,Ventura,111,848112,81531,81130,2965,84095,1025
2021-06-06,Yolo,113,214977,14086,14089,239,14328,210
2021-06-06,Yuba,115,75493,6115,6096,128,6224,49
2021-06-05,Alameda,001,1643700,88518,88612,1931,90543,1268
2021-06-05,Alpine,003,1148,87,88,0,88,0
2021-06-05,Amador,005,37829,3700,3694,32,3726,46
2021-06-05,Butte,007,227075,12658,12514,1818,14332,194
2021-06-05,Calaveras,009,45235,2181,2181,13,2194,55
2021-06-05,Colusa,011,21464,1955,1959,314,2273,15
2021-06-05,Contra Costa,013,1133247,70076,69601,1278,70879,817
2021-06-05,Del Norte,015,27424,1429,1400,13,1413,8
2021-06-05,El Dorado,017,186661,10358,10288,749,11037,113
2021-06-05,Fresno,019,978130,102969,102626,8619,111245,1717
2021-06-05,Glenn,021,27897,2438,2423,559,2982,19
2021-06-05,Humboldt,023,135768,4353,4346,38,4384,42
2021-06-05,Imperial,025,180216,28676,28764,2693,31457,738
2021-06-05,Inyo,027,18085,1406,1405,12,1417,35
2021-06-05,Kern,029,883053,97557,96597,10883,107480,1324
2021-06-05,Kings,031,150075,23191,23017,1071,24088,244
2021-06-05,Lake,033,64148,3551,3534,9,3543,45
2021-06-05,Lassen,035,31185,5237,5191,114,5305,18
2021-06-05,Los Angeles,037,10098052,1208700,1203338,40980,1244318,24411
2021-06-05,Madera,039,155013,16676,16563,929,17492,240
2021-06-05,Marin,041,260295,14139,14101,256,14357,229
2021-06-05,Mariposa,043,17540,435,435,11,446,5
2021-06-05,Mendocino,045,87422,4074,3989,82,4071,47
2021-06-05,Merced,047,269075,31098,31212,1032,32244,459
2021-06-05,Modoc,049,8938,386,375,133,508,3
2021-06-05,Mono,051,14174,1263,1274,16,1290,3
2021-06-05,Monterey,053,433212,43208,43071,1837,44908,415
2021-06-05,Napa,055,140530,9943,9960,36,9996,80
2021-06-05,Nevada,057,99092,4873,4849,191,5040,72
2021-06-05,Orange,059,3164182,255695,254752,11300,266052,5069
2021-06-05,Placer,061,380077,23481,23133,1505,24638,293
2021-06-05,Plumas,063,18699,712,692,11,703,4
2021-06-05,Riverside,065,2383286,294582,289157,13909,303066,4451
2021-06-05,Sacramento,067,1510023,106914,106688,1759,108447,1655
2021-06-05,San Benito,069,59416,6060,6074,113,6187,63
2021-06-05,San Bernardino,071,2135413,293697,293081,8929,302010,4772
2021-06-05,San Diego,073,3302833,281606,280676,15072,295748,3764
2021-06-05,San Francisco,075,870044,36841,37111,1271,38382,552
2021-06-05,San Joaquin,077,732212,73482,73078,3517,76595,1388
2021-06-05,San Luis Obispo,079,281455,21451,21236,739,21975,255
2021-06-05,San Mateo,081,765935,42439,42433,470,42903,664
2021-06-05,Santa Barbara,083,443738,34500,34399,1118,35517,459
2021-06-05,Santa Clara,085,1922200,118915,119676,753,120429,2066
2021-06-05,Santa Cruz,087,273765,16265,16154,797,16951,208
2021-06-05,Shasta,089,179085,12430,12472,1597,14069,200
2021-06-05,Sierra,091,2930,57,55,12,67,0
2021-06-05,Siskiyou,093,43540,1952,1867,361,2228,21
2021-06-05,Solano,095,438530,33063,33074,555,33629,257
2021-06-05,Sonoma,097,501317,30351,30450,342,30792,323
2021-06-05,Stanislaus,099,539301,56603,56463,5904,62367,973
2021-06-05,Sutter,101,95872,9522,9559,85,9644,111
2021-06-05,Tehama,103,63373,5112,5092,571,5663,63
2021-06-05,Trinity,105,12862,486,328,92,420,3
2021-06-05,Tulare,107,460477,50313,49463,8930,58393,847
2021-06-05,Tuolumne,109,53932,4039,4098,42,4140,63
2021-06-05,Ventura,111,848112,81522,81119,2963,84082,1025
2021-06-05,Yolo,113,214977,14084,14088,239,14327,210
2021-06-05,Yuba,115,75493,6114,6087,128,6215,49
2021-06-04,Alameda,001,1643700,88491,88585,1928,90513,1263
2021-06-04,Alpine,003,1148,87,88,0,88,0
2021-06-04,Amador,005,37829,3700,3690,32,3722,46
2021-06-04,Butte,007,227075,12647,12494,1815,14309,193
2021-06-04,Calaveras,009,45235,2181,2179,13,2192,55
2021-06-04,Colusa,011,21464,1955,1959,314,2273,15
2021-06-04,Contra Costa,013,1133247,70041,69540,1275,70815,816
2021-06-04,Del Norte,015,27424,1429,1398,13,1411,8
2021-06-04,El Dorado,017,186661,10354,10284,747,11031,112
2021-06-04,Fresno,019,978130,102953,102601,8619,111220,1712
2021-06-04,Glenn,021,27897,2438,2423,558,2981,19
2021-06-04,Humboldt,023,135768,4348,4327,38,4365,42
2021-06-04,Imperial,025,180216,28672,28753,2693,31446,738
2021-06-04,Inyo,027,18085,1406,1404,12,1416,35
2021-06-04,Kern,029,883053,97539,96573,10881,107454,1327
2021-06-04,Kings,031,150075,23190,23002,1071,24073,244
2021-06-04,Lake,033,64148,3549,3528,9,3537,45
2021-06-04,Lassen,035,31185,5237,5180,114,5294,18
2021-06-04,Los Angeles,037,10098052,1208579,1203106,40971,1244077,24400
2021-06-04,Madera,039,155013,16674,16557,929,17486,240
2021-06-04,Marin,041,260295,14138,14099,255,14354,229
2021-06-04,Mariposa,043,17540,435,435,11,446,5
2021-06-04,Mendocino,045,87422,4065,3983,82,4065,47
2021-06-04,Merced,047,269075,31093,31204,1031,32235,459
2021-06-04,Modoc,049,8938,384,375,133,508,3
2021-06-04,Mono,051,14174,1263,1275,16,1291,3
2021-06-04,Monterey,053,433212,43204,43068,1837,44905,415
2021-06-04,Napa,055,140530,9939,9958,36,9994,80
2021-06-04,Nevada,057,99092,4869,4844,191,5035,72
2021-06-04,Orange,059,3164182,255658,254730,11296,266026,5059
2021-06-04,Placer,061,380077,23465,23110,1504,24614,293
2021-06-04,Plumas,063,18699,712,691,11,702,4
2021-06-04,Riverside,065,2383286,294556,289098,13905,303003,4452
2021-06-04,Sacramento,067,1510023,106860,106616,1758,108374,1654
2021-06-04,San Benito,069,59416,6058,6073,113,6186,63
2021-06-04,San Bernardino,071,2135413,293673,293056,8927,301983,4768
2021-06-04,San Diego,073,3302833,281563,280556,15065,295621,3763
2021-06-04,San Francisco,075,870044,36836,37079,1270,38349,551
2021-06-04,San Joaquin,077,732212,73463,73039,3515,76554,1388
2021-06-04,San Luis Obispo,079,281455,21448,21234,738,21972,255
2021-06-04,San Mateo,081,765935,42427,42413,470,42883,478
2021-06-04,Santa Barbara,083,443738,34494,34402,1117,35519,459
2021-06-04,Santa Clara,085,1922200,118885,119619,753,120372,2065
2021-06-04,Santa Cruz,087,273765,16262,16150,797,16947,207
2021-06-04,Shasta,089,179085,12424,12458,1592,14050,200
2021-06-04,Sierra,091,2930,57,55,12,67,0
2021-06-04,Siskiyou,093,43540,1951,1865,361,2226,21
2021-06-04,Solano,095,438530,33052,33058,555,33613,256
2021-06-04,Sonoma,097,501317,30330,30411,342,30753,323
2021-06-04,Stanislaus,099,539301,56588,56442,5902,62344,973
2021-06-04,Sutter,101,95872,9517,9554,85,9639,111
2021-06-04,Tehama,103,63373,5107,5090,571,5661,63
2021-06-04,Trinity,105,12862,486,328,92,420,3
2021-06-04,Tulare,107,460477,50304,49452,8928,58380,847
2021-06-04,Tuolumne,109,53932,4038,4095,42,4137,63
2021-06-04,Ventura,111,848112,81515,81104,2961,84065,1023
2021-06-04,Yolo,113,214977,14082,14083,239,14322,210
2021-06-04,Yuba,115,75493,6111,6084,128,6212,49
2021-06-03,Alameda,001,1643700,88453,88555,1925,90480,1257
2021-06-03,Alpine,003,1148,87,88,0,88,0
2021-06-03,Amador,005,37829,3692,3688,32,3720,46
2021-06-03,Butte,007,227075,12643,12478,1814,14292,193
2021-06-03,Calaveras,009,45235,2181,2179,13,2192,55
2021-06-03,Colusa,011,21464,1955,1957,314,2271,15
2021-06-03,Contra Costa,013,1133247,69987,69500,1270,70770,816
2021-06-03,Del Norte,015,27424,1427,1397,13,1410,8
2021-06-03,El Dorado,017,186661,10348,10284,744,11028,112
2021-06-03,Fresno,019,978130,102936,102566,8619,111185,1709
2021-06-03,Glenn,021,27897,2438,2421,558,2979,19
2021-06-03,Humboldt,023,135768,4340,4314,38,4352,42
2021-06-03,Imperial,025,180216,28661,28737,2693,31430,738
2021-06-03,Inyo,027,18085,1406,1404,12,1416,35
2021-06-03,Kern,029,883053,97512,96507,10867,107374,1326
2021-06-03,Kings,031,150075,23186,22982,1071,24053,244
2021-06-03,Lake,033,64148,3547,3526,9,3535,45
2021-06-03,Lassen,035,31185,5228,5177,114,5291,12
2021-06-03,Los Angeles,037,10098052,1208408,1202923,40963,1243886,24386
2021-06-03,Madera,039,155013,16667,16554,929,17483,240
2021-06-03,Marin,041,260295,14133,14095,255,14350,230
2021-06-03,Mariposa,043,17540,435,435,11,446,5
2021-06-03,Mendocino,045,87422,4058,3978,82,4060,47
2021-06-03,Merced,047,269075,31090,31199,1031,32230,459
2021-06-03,Modoc,049,8938,383,376,132,508,3
2021-06-03,Mono,051,14174,1263,1275,16,1291,3
2021-06-03,Monterey,053,433212,43201,43063,1837,44900,415
2021-06-03,Napa,055,140530,9932,9957,36,9993,81
2021-06-03,Nevada,057,99092,4865,4837,191,5028,72
2021-06-03,Orange,059,3164182,255630,254676,11286,265962,5056
2021-06-03,Placer,061,380077,23456,23100,1503,24603,293
2021-06-03,Plumas,063,18699,712,691,11,702,4
2021-06-03,Riverside,065,2383286,294501,289035,13901,302936,4447
2021-06-03,Sacramento,067,1510023,106781,106526,1756,108282,1654
2021-06-03,San Benito,069,59416,6058,6073,113,6186,63
2021-06-03,San Bernardino,071,2135413,293642,293021,8927,301948,4762
2021-06-03,San Diego,073,3302833,281499,280430,15055,295485,3761
2021-06-03,San Francisco,075,870044,36830,37072,1270,38342,551
2021-06-03,San Joaquin,077,732212,73435,72989,3511,76500,1388
2021-06-03,San Luis Obispo,079,281455,21443,21224,738,21962,255
2021-06-03,San Mateo,081,765935,42414,42396,470,42866,467
2021-06-03,Santa Barbara,083,443738,34491,34391,1117,35508,459
2021-06-03,Santa Clara,085,1922200,118863,119592,751,120343,2058
2021-06-03,Santa Cruz,087,273765,16260,16144,797,16941,207
2021-06-03,Shasta,089,179085,12409,12441,1589,14030,199
2021-06-03,Sierra,091,2930,57,55,12,67,0
2021-06-03,Siskiyou,093,43540,1951,1862,360,2222,21
2021-06-03,Solano,095,438530,33038,33019,555,33574,256
2021-06-03,Sonoma,097,501317,30308,30383,341,30724,322
2021-06-03,Stanislaus,099,539301,56569,56401,5896,62297,973
2021-06-03,Sutter,101,95872,9508,9539,85,9624,111
2021-06-03,Tehama,103,63373,5107,5087,571,5658,63
2021-06-03,Trinity,105,12862,486,328,92,420,3
2021-06-03,Tulare,107,460477,50301,49442,8924,58366,848
2021-06-03,Tuolumne,109,53932,4036,4095,42,4137,63
2021-06-03,Ventura,111,848112,81503,81078,2959,84037,1023
2021-06-03,Yolo,113,214977,14078,14078,237,14315,210
2021-06-03,Yuba,115,75493,6104,6077,128,6205,49
2021-06-02,Alameda,001,1643700,88408,88525,1923,90448,1254
2021-06-02,Alpine,003,1148,87,88,0,88,0
2021-06-02,Amador,005,37829,3690,3687,32,3719,46
2021-06-02,Butte,007,227075,12623,12432,1811,14243,193
2021-06-02,Calaveras,009,45235,2178,2174,13,2187,55
2021-06-02,Colusa,011,21464,1954,1957,314,2271,15
2021-06-02,Contra Costa,013,1133247,69936,69455,1268,70723,814
2021-06-02,Del Norte,015,27424,1425,1395,13,1408,8
2021-06-02,El Dorado,017,186661,10344,10275,744,11019,110
2021-06-02,Fresno,019,978130,102912,102547,8616,111163,1707
2021-06-02,Glenn,021,27897,2438,2421,558,2979,19
2021-06-02,Humboldt,023,135768,4325,4302,38,4340,42
2021-06-02,Imperial,025,180216,28655,28737,2692,31429,738
2021-06-02,Inyo,027,18085,1405,1403,12,1415,35
2021-06-02,Kern,029,883053,97485,96481,10860,107341,1326
2021-06-02,Kings,031,150075,23184,22981,1070,24051,244
2021-06-02,Lake,033,64148,3542,3522,9,3531,45
2021-06-02,Lassen,035,31185,5227,5177,114,5291,6
2021-06-02,Los Angeles,037,10098052,1208203,1202760,40954,1243714,24375
2021-06-02,Madera,039,155013,16659,16550,929,17479,240
2021-06-02,Marin,041,260295,14131,14091,254,14345,229
2021-06-02,Mariposa,043,17540,435,434,11,445,5
2021-06-02,Mendocino,045,87422,4052,3970,82,4052,47
2021-06-02,Merced,047,269075,31077,31195,1030,32225,458
2021-06-02,Modoc,049,8938,382,375,131,506,3
2021-06-02,Mono,051,14174,1263,1275,16,1291,3
2021-06-02,Monterey,053,433212,43199,43056,1837,44893,380
2021-06-02,Napa,055,140530,9931,9953,36,9989,82
2021-06-02,Nevada,057,99092,4862,4833,191,5024,72
2021-06-02,Orange,059,3164182,255581,254637,11279,265916,5055
2021-06-02,Placer,061,380077,23435,23058,1501,24559,293
2021-06-02,Plumas,063,18699,712,690,11,701,4
2021-06-02,Riverside,065,2383286,294443,289012,13891,302903,4445
2021-06-02,Sacramento,067,1510023,106716,106435,1750,108185,1649
2021-06-02,San Benito,069,59416,6057,6073,113,6186,63
2021-06-02,San Bernardino,071,2135413,293594,293004,8922,301926,4760
2021-06-02,San Diego,073,3302833,281419,280347,15034,295381,3760
2021-06-02,San Francisco,075,870044,36810,37050,1269,38319,550
2021-06-02,San Joaquin,077,732212,73404,72893,3508,76401,1387
2021-06-02,San Luis Obispo,079,281455,21436,21214,737,21951,255
2021-06-02,San Mateo,081,765935,42404,42383,469,42852,464
2021-06-02,Santa Barbara,083,443738,34484,34381,1117,35498,456
2021-06-02,Santa Clara,085,1922200,118835,119553,750,120303,2058
2021-06-02,Santa Cruz,087,273765,16257,16144,797,16941,207
2021-06-02,Shasta,089,179085,12391,12426,1584,14010,199
2021-06-02,Sierra,091,2930,57,55,12,67,0
2021-06-02,Siskiyou,093,43540,1951,1861,358,2219,21
2021-06-02,Solano,095,438530,33026,33007,554,33561,256
2021-06-02,Sonoma,097,501317,30289,30359,336,30695,322
2021-06-02,Stanislaus,099,539301,56550,56377,5891,62268,973
2021-06-02,Sutter,101,95872,9505,9533,85,9618,111
2021-06-02,Tehama,103,63373,5104,5081,571,5652,63
2021-06-02,Trinity,105,12862,484,328,92,420,3
2021-06-02,Tulare,107,460477,50293,49434,8920,58354,846
2021-06-02,Tuolumne,109,53932,4035,4095,42,4137,63
2021-06-02,Ventura,111,848112,81478,81033,2959,83992,1020
2021-06-02,Yolo,113,214977,14075,14074,236,14310,210
2021-06-02,Yuba,115,75493,6098,6072,128,6200,48
2021-06-01,Alameda,001,1643700,88373,88472,1921,90393,1253
2021-06-01,Alpine,003,1148,87,88,0,88,0
2021-06-01,Amador,005,37829,3688,3687,32,3719,46
2021-06-01,Butte,007,227075,12609,12427,1810,14237,193
2021-06-01,Calaveras,009,45235,2176,2173,13,2186,55
2021-06-01,Colusa,011,21464,1953,1955,313,2268,15
2021-06-01,Contra Costa,013,1133247,69878,69404,1268,70672,813
2021-06-01,Del Norte,015,27424,1424,1394,13,1407,8
2021-06-01,El Dorado,017,186661,10338,10271,744,11015,110
2021-06-01,Fresno,019,978130,102888,102534,8613,111147,1706
2021-06-01,Glenn,021,27897,2438,2422,558,2980,18
2021-06-01,Humboldt,023,135768,4315,4299,38,4337,42
2021-06-01,Imperial,025,180216,28651,28722,2690,31412,736
2021-06-01,Inyo,027,18085,1405,1403,12,1415,35
2021-06-01,Kern,029,883053,97458,96477,10852,107329,1319
2021-06-01,Kings,031,150075,23180,22977,1070,24047,244
2021-06-01,Lake,033,64148,3541,3523,9,3532,45
2021-06-01,Lassen,035,31185,5220,5172,114,5286,6
2021-06-01,Los Angeles,037,10098052,1207966,1202673,40940,1243613,24367
2021-06-01,Madera,039,155013,16650,16549,928,17477,240
2021-06-01,Marin,041,260295,14129,14081,254,14335,229
2021-06-01,Mariposa,043,17540,435,431,11,442,5
2021-06-01,Mendocino,045,87422,4045,3966,82,4048,47
2021-06-01,Merced,047,269075,31067,31195,1030,32225,456
2021-06-01,Modoc,049,8938,380,375,131,506,3
2021-06-01,Mono,051,14174,1263,1275,16,1291,3
2021-06-01,Monterey,053,433212,43193,43051,1837,44888,379
2021-06-01,Napa,055,140530,9929,9949,36,9985,82
2021-06-01,Nevada,057,99092,4857,4825,191,5016,72
2021-06-01,Orange,059,3164182,255545,254603,11271,265874,5051
2021-06-01,Placer,061,380077,23405,23021,1499,24520,293
2021-06-01,Plumas,063,18699,711,690,11,701,4
2021-06-01,Riverside,065,2383286,294390,288996,13885,302881,4442
2021-06-01,Sacramento,067,1510023,106644,106330,1748,108078,1644
2021-06-01,San Benito,069,59416,6056,6073,112,6185,63
2021-06-01,San Bernardino,071,2135413,293569,292990,8921,301911,4758
2021-06-01,San Diego,073,3302833,281315,280305,15017,295322,3756
2021-06-01,San Francisco,075,870044,36794,37031,1269,38300,550
2021-06-01,San Joaquin,077,732212,73372,72858,3507,76365,1383
2021-06-01,San Luis Obispo,079,281455,21431,21217,737,21954,256
2021-06-01,San Mateo,081,765935,42388,42383,468,42851,462
2021-06-01,Santa Barbara,083,443738,34480,34374,1117,35491,456
2021-06-01,Santa Clara,085,1922200,118807,119528,750,120278,2057
2021-06-01,Santa Cruz,087,273765,16253,16143,796,16939,207
2021-06-01,Shasta,089,179085,12382,12409,1579,13988,199
2021-06-01,Sierra,091,2930,57,55,12,67,0
2021-06-01,Siskiyou,093,43540,1944,1860,357,2217,21
2021-06-01,Solano,095,438530,33001,32974,553,33527,256
2021-06-01,Sonoma,097,501317,30250,30324,335,30659,322
2021-06-01,Stanislaus,099,539301,56534,56348,5889,62237,973
2021-06-01,Sutter,101,95872,9498,9528,85,9613,111
2021-06-01,Tehama,103,63373,5102,5079,571,5650,63
2021-06-01,Trinity,105,12862,483,328,91,419,3
2021-06-01,Tulare,107,460477,50285,49419,8916,58335,845
2021-06-01,Tuolumne,109,53932,4035,4094,42,4136,63
2021-06-01,Ventura,111,848112,81462,81018,2958,83976,1021
2021-06-01,Yolo,113,214977,14069,14067,236,14303,210
2021-06-01,Yuba,115,75493,6094,6067,128,6195,48
2021-05-31,Alameda,001,1643700,88337,88458,1917,90375,1253
2021-05-31,Alpine,003,1148,87,88,0,88,0
2021-05-31,Amador,005,37829,3682,3687,32,3719,46
2021-05-31,Butte,007,227075,12596,12429,1810,14239,193
2021-05-31,Calaveras,009,45235,2175,2171,13,2184,55
2021-05-31,Colusa,011,21464,1953,1956,312,2268,15
2021-05-31,Contra Costa,013,1133247,69841,69390,1267,70657,813
2021-05-31,Del Norte,015,27424,1421,1394,13,1407,8
2021-05-31,El Dorado,017,186661,10332,10271,742,11013,110
2021-05-31,Fresno,019,978130,102851,102507,8613,111120,1706
2021-05-31,Glenn,021,27897,2437,2422,557,2979,18
2021-05-31,Humboldt,023,135768,4303,4295,38,4333,42
2021-05-31,Imperial,025,180216,28645,28732,2687,31419,736
2021-05-31,Inyo,027,18085,1404,1403,12,1415,35
2021-05-31,Kern,029,883053,97422,96457,10843,107300,1319
2021-05-31,Kings,031,150075,23176,22977,1070,24047,244
2021-05-31,Lake,033,64148,3536,3523,9,3532,45
2021-05-31,Lassen,035,31185,5218,5172,113,5285,6
2021-05-31,Los Angeles,037,10098052,1207723,1202567,40931,1243498,24364
2021-05-31,Madera,039,155013,16649,16543,927,17470,240
2021-05-31,Marin,041,260295,14127,14080,254,14334,229
2021-05-31,Mariposa,043,17540,435,430,11,441,5
2021-05-31,Mendocino,045,87422,4035,3961,82,4043,47
2021-05-31,Merced,047,269075,31062,31194,1030,32224,456
2021-05-31,Modoc,049,8938,379,374,131,505,3
2021-05-31,Mono,051,14174,1263,1275,16,1291,3
2021-05-31,Monterey,053,433212,43189,43051,1837,44888,379
2021-05-31,Napa,055,140530,9922,9948,36,9984,82
2021-05-31,Nevada,057,99092,4847,4823,190,5013,72
2021-05-31,Orange,059,3164182,255517,254572,11263,265835,5051
2021-05-31,Placer,061,380077,23378,23019,1495,24514,293
2021-05-31,Plumas,063,18699,710,690,11,701,4
2021-05-31,Riverside,065,2383286,294333,288970,13873,302843,4442
2021-05-31,Sacramento,067,1510023,106547,106278,1743,108021,1644
2021-05-31,San Benito,069,59416,6056,6072,112,6184,63
2021-05-31,San Bernardino,071,2135413,293521,292973,8920,301893,4758
2021-05-31,San Diego,073,3302833,281211,280254,15005,295259,3756
2021-05-31,San Francisco,075,870044,36779,37022,1268,38290,550
2021-05-31,San Joaquin,077,732212,73322,72856,3501,76357,1383
2021-05-31,San Luis Obispo,079,281455,21423,21215,737,21952,256
2021-05-31,San Mateo,081,765935,42372,42389,468,42857,442
2021-05-31,Santa Barbara,083,443738,34467,34369,1115,35484,456
2021-05-31,Santa Clara,085,1922200,118763,119515,750,120265,2057
2021-05-31,Santa Cruz,087,273765,16250,16139,796,16935,207
2021-05-31,Shasta,089,179085,12366,12408,1576,13984,199
2021-05-31,Sierra,091,2930,57,55,12,67,0
2021-05-31,Siskiyou,093,43540,1943,1856,356,2212,21
2021-05-31,Solano,095,438530,32951,32973,553,33526,256
2021-05-31,Sonoma,097,501317,30207,30314,335,30649,322
2021-05-31,Stanislaus,099,539301,56493,56335,5886,62221,973
2021-05-31,Sutter,101,95872,9479,9523,85,9608,111
2021-05-31,Tehama,103,63373,5099,5076,570,5646,63
2021-05-31,Trinity,105,12862,483,328,91,419,3
2021-05-31,Tulare,107,460477,50274,49404,8911,58315,845
2021-05-31,Tuolumne,109,53932,4033,4095,42,4137,63
2021-05-31,Ventura,111,848112,81447,81017,2955,83972,1021
2021-05-31,Yolo,113,214977,14065,14064,236,14300,210
2021-05-31,Yuba,115,75493,6088,6063,125,6188,48
2021-05-30,Alameda,001,1643700,88314,88429,1917,90346,1253
2021-05-30,Alpine,003,1148,87,88,0,88,0
2021-05-30,Amador,005,37829,3678,3685,32,3717,46
2021-05-30,Butte,007,227075,12586,12427,1808,14235,190
2021-05-30,Calaveras,009,45235,2171,2166,13,2179,55
2021-05-30,Colusa,011,21464,1953,1954,312,2266,15
2021-05-30,Contra Costa,013,1133247,69807,69381,1265,70646,813
2021-05-30,Del Norte,015,27424,1420,1393,13,1406,8
2021-05-30,El Dorado,017,186661,10329,10271,742,11013,110
2021-05-30,Fresno,019,978130,102834,102499,8609,111108,1706
2021-05-30,Glenn,021,27897,2437,2422,556,2978,18
2021-05-30,Humboldt,023,135768,4295,4291,38,4329,42
2021-05-30,Imperial,025,180216,28641,28732,2686,31418,736
2021-05-30,Inyo,027,18085,1404,1403,12,1415,35
2021-05-30,Kern,029,883053,97406,96443,10840,107283,1319
2021-05-30,Kings,031,150075,23175,22974,1070,24044,244
2021-05-30,Lake,033,64148,3536,3517,9,3526,45
2021-05-30,Lassen,035,31185,5216,5171,113,5284,6
2021-05-30,Los Angeles,037,10098052,1207608,1202425,40924,1243349,24360
2021-05-30,Madera,039,155013,16645,16538,927,17465,240
2021-05-30,Marin,041,260295,14123,14083,253,14336,229
2021-05-30,Mariposa,043,17540,435,430,11,441,5
2021-05-30,Mendocino,045,87422,4028,3955,82,4037,47
2021-05-30,Merced,047,269075,31058,31189,1029,32218,456
2021-05-30,Modoc,049,8938,379,374,131,505,3
2021-05-30,Mono,051,14174,1263,1275,16,1291,3
2021-05-30,Monterey,053,433212,43186,43049,1837,44886,379
2021-05-30,Napa,055,140530,9921,9948,36,9984,82
2021-05-30,Nevada,057,99092,4841,4818,190,5008,72
2021-05-30,Orange,059,3164182,255494,254559,11262,265821,5051
2021-05-30,Placer,061,380077,23372,23016,1495,24511,293
2021-05-30,Plumas,063,18699,708,690,11,701,4
2021-05-30,Riverside,065,2383286,294312,288961,13871,302832,4442
2021-05-30,Sacramento,067,1510023,106501,106252,1741,107993,1644
2021-05-30,San Benito,069,59416,6056,6072,112,6184,63
2021-05-30,San Bernardino,071,2135413,293495,292981,8919,301900,4758
2021-05-30,San Diego,073,3302833,281155,280209,15000,295209,3756
2021-05-30,San Francisco,075,870044,36760,37016,1268,38284,550
2021-05-30,San Joaquin,077,732212,73305,72853,3500,76353,1383
2021-05-30,San Luis Obispo,079,281455,21414,21211,736,21947,256
2021-05-30,San Mateo,081,765935,42364,42386,468,42854,439
2021-05-30,Santa Barbara,083,443738,34463,34369,1115,35484,456
2021-05-30,Santa Clara,085,1922200,118741,119510,746,120256,2057
2021-05-30,Santa Cruz,087,273765,16248,16140,796,16936,207
2021-05-30,Shasta,089,179085,12364,12408,1573,13981,199
2021-05-30,Sierra,091,2930,57,55,12,67,0
2021-05-30,Siskiyou,093,43540,1943,1856,356,2212,21
2021-05-30,Solano,095,438530,32940,32952,552,33504,256
2021-05-30,Sonoma,097,501317,30190,30310,334,30644,322
2021-05-30,Stanislaus,099,539301,56482,56323,5885,62208,973
2021-05-30,Sutter,101,95872,9478,9519,84,9603,111
2021-05-30,Tehama,103,63373,5099,5073,570,5643,63
2021-05-30,Trinity,105,12862,483,328,91,419,3
2021-05-30,Tulare,107,460477,50267,49397,8903,58300,845
2021-05-30,Tuolumne,109,53932,4033,4094,42,4136,63
2021-05-30,Ventura,111,848112,81443,81012,2954,83966,1021
2021-05-30,Yolo,113,214977,14060,14059,235,14294,210
2021-05-30,Yuba,115,75493,6081,6063,124,6187,48
2021-05-29,Alameda,001,1643700,88291,88433,1915,90348,1253
2021-05-29,Alpine,003,1148,87,88,0,88,0
2021-05-29,Amador,005,37829,3677,3683,32,3715,46
2021-05-29,Butte,007,227075,12580,12425,1808,14233,190
2021-05-29,Calaveras,009,45235,2170,2166,13,2179,55
2021-05-29,Colusa,011,21464,1950,1954,312,2266,15
2021-05-29,Contra Costa,013,1133247,69774,69351,1265,70616,813
2021-05-29,Del Norte,015,27424,1420,1391,13,1404,8
2021-05-29,El Dorado,017,186661,10328,10269,740,11009,110
2021-05-29,Fresno,019,978130,102822,102470,8606,111076,1706
2021-05-29,Glenn,021,27897,2437,2422,555,2977,18
2021-05-29,Humboldt,023,135768,4289,4283,38,4321,42
2021-05-29,Imperial,025,180216,28638,28729,2685,31414,736
2021-05-29,Inyo,027,18085,1404,1404,12,1416,35
2021-05-29,Kern,029,883053,97395,96424,10827,107251,1319
2021-05-29,Kings,031,150075,23174,22970,1069,24039,244
2021-05-29,Lake,033,64148,3536,3515,9,3524,45
2021-05-29,Lassen,035,31185,5216,5171,113,5284,6
2021-05-29,Los Angeles,037,10098052,1207485,1202264,40921,1243185,24359
2021-05-29,Madera,039,155013,16643,16535,927,17462,240
2021-05-29,Marin,041,260295,14119,14071,252,14323,229
2021-05-29,Mariposa,043,17540,434,428,11,439,5
2021-05-29,Mendocino,045,87422,4022,3952,82,4034,47
2021-05-29,Merced,047,269075,31046,31187,1029,32216,456
2021-05-29,Modoc,049,8938,379,374,131,505,3
2021-05-29,Mono,051,14174,1263,1275,16,1291,3
2021-05-29,Monterey,053,433212,43184,43042,1837,44879,379
2021-05-29,Napa,055,140530,9918,9948,36,9984,82
2021-05-29,Nevada,057,99092,4840,4816,190,5006,72
2021-05-29,Orange,059,3164182,255472,254537,11252,265789,5049
2021-05-29,Placer,061,380077,23357,23009,1494,24503,293
2021-05-29,Plumas,063,18699,708,689,11,700,4
2021-05-29,Riverside,065,2383286,294292,288908,13870,302778,4442
2021-05-29,Sacramento,067,1510023,106471,106218,1740,107958,1643
2021-05-29,San Benito,069,59416,6055,6072,112,6184,63
2021-05-29,San Bernardino,071,2135413,293463,292961,8918,301879,4757
2021-05-29,San Diego,073,3302833,281096,280151,14995,295146,3756
2021-05-29,San Francisco,075,870044,36751,37008,1268,38276,550
2021-05-29,San Joaquin,077,732212,73289,72827,3498,76325,1383
2021-05-29,San Luis Obispo,079,281455,21412,21201,736,21937,256
2021-05-29,San Mateo,081,765935,42356,42375,467,42842,439
2021-05-29,Santa Barbara,083,443738,34459,34367,1115,35482,456
2021-05-29,Santa Clara,085,1922200,118717,119498,745,120243,2056
2021-05-29,Santa Cruz,087,273765,16247,16137,796,16933,207
2021-05-29,Shasta,089,179085,12356,12401,1572,13973,199
2021-05-29,Sierra,091,2930,57,55,12,67,0
2021-05-29,Siskiyou,093,43540,1938,1856,356,2212,21
2021-05-29,Solano,095,438530,32931,32917,552,33469,256
2021-05-29,Sonoma,097,501317,30167,30298,333,30631,322
2021-05-29,Stanislaus,099,539301,56464,56305,5883,62188,974
2021-05-29,Sutter,101,95872,9474,9516,84,9600,111
2021-05-29,Tehama,103,63373,5098,5070,570,5640,63
2021-05-29,Trinity,105,12862,483,328,91,419,3
2021-05-29,Tulare,107,460477,50257,49392,8899,58291,845
2021-05-29,Tuolumne,109,53932,4033,4093,42,4135,63
2021-05-29,Ventura,111,848112,81435,81008,2954,83962,1021
2021-05-29,Yolo,113,214977,14059,14055,235,14290,210
2021-05-29,Yuba,115,75493,6081,6059,124,6183,48
2021-05-28,Alameda,001,1643700,88267,88391,1911,90302,1261
2021-05-28,Alpine,003,1148,87,88,0,88,0
2021-05-28,Amador,005,37829,3677,3680,32,3712,46
2021-05-28,Butte,007,227075,12577,12407,1807,14214,190
2021-05-28,Calaveras,009,45235,2169,2165,13,2178,55
2021-05-28,Colusa,011,21464,1950,1954,310,2264,15
2021-05-28,Contra Costa,013,1133247,69738,69290,1264,70554,813
2021-05-28,Del Norte,015,27424,1419,1390,13,1403,8
2021-05-28,El Dorado,017,186661,10325,10265,740,11005,110
2021-05-28,Fresno,019,978130,102807,102437,8606,111043,1705
2021-05-28,Glenn,021,27897,2437,2419,555,2974,18
2021-05-28,Humboldt,023,135768,4282,4265,38,4303,42
2021-05-28,Imperial,025,180216,28635,28722,2685,31407,736
2021-05-28,Inyo,027,18085,1404,1404,12,1416,35
2021-05-28,Kern,029,883053,97378,96396,10819,107215,1320
2021-05-28,Kings,031,150075,23172,22962,1069,24031,244
2021-05-28,Lake,033,64148,3534,3515,9,3524,45
2021-05-28,Lassen,035,31185,5216,5169,113,5282,6
2021-05-28,Los Angeles,037,10098052,1207374,1202103,40911,1243014,24357
2021-05-28,Madera,039,155013,16641,16530,927,17457,240
2021-05-28,Marin,041,260295,14118,14063,251,14314,229
2021-05-28,Mariposa,043,17540,434,428,11,439,5
2021-05-28,Mendocino,045,87422,4017,3947,82,4029,47
2021-05-28,Merced,047,269075,31043,31176,1029,32205,455
2021-05-28,Modoc,049,8938,379,374,131,505,3
2021-05-28,Mono,051,14174,1263,1274,16,1290,3
2021-05-28,Monterey,053,433212,43183,43036,1837,44873,379
2021-05-28,Napa,055,140530,9918,9941,36,9977,82
2021-05-28,Nevada,057,99092,4838,4813,190,5003,71
2021-05-28,Orange,059,3164182,255452,254494,11250,265744,5047
2021-05-28,Placer,061,380077,23347,22987,1492,24479,293
2021-05-28,Plumas,063,18699,706,688,11,699,4
2021-05-28,Riverside,065,2383286,294270,288872,13868,302740,4442
2021-05-28,Sacramento,067,1510023,106415,106131,1738,107869,1642
2021-05-28,San Benito,069,59416,6055,6074,112,6186,63
2021-05-28,San Bernardino,071,2135413,293440,292905,8918,301823,4757
2021-05-28,San Diego,073,3302833,281033,280043,14984,295027,3756
2021-05-28,San Francisco,075,870044,36745,36987,1268,38255,546
2021-05-28,San Joaquin,077,732212,73259,72793,3496,76289,1383
2021-05-28,San Luis Obispo,079,281455,21407,21190,734,21924,256
2021-05-28,San Mateo,081,765935,42350,42364,467,42831,439
2021-05-28,Santa Barbara,083,443738,34458,34371,1115,35486,455
2021-05-28,Santa Clara,085,1922200,118693,119462,745,120207,2056
2021-05-28,Santa Cruz,087,273765,16246,16129,796,16925,207
2021-05-28,Shasta,089,179085,12347,12383,1570,13953,198
2021-05-28,Sierra,091,2930,57,54,12,66,0
2021-05-28,Siskiyou,093,43540,1936,1850,356,2206,19
2021-05-28,Solano,095,438530,32916,32892,552,33444,256
2021-05-28,Sonoma,097,501317,30148,30270,333,30603,321
2021-05-28,Stanislaus,099,539301,56446,56278,5880,62158,974
2021-05-28,Sutter,101,95872,9470,9511,84,9595,111
2021-05-28,Tehama,103,63373,5092,5064,570,5634,63
2021-05-28,Trinity,105,12862,483,328,91,419,3
2021-05-28,Tulare,107,460477,50252,49375,8890,58265,846
2021-05-28,Tuolumne,109,53932,4033,4090,42,4132,63
2021-05-28,Ventura,111,848112,81424,80985,2953,83938,1021
2021-05-28,Yolo,113,214977,14056,14050,234,14284,210
2021-05-28,Yuba,115,75493,6079,6050,123,6173,48
2021-05-27,Alameda,001,1643700,88232,88342,1911,90253,1274
2021-05-27,Alpine,003,1148,87,88,0,88,0
2021-05-27,Amador,005,37829,3674,3680,32,3712,46
2021-05-27,Butte,007,227075,12572,12401,1806,14207,190
2021-05-27,Calaveras,009,45235,2168,2163,13,2176,55
2021-05-27,Colusa,011,21464,1947,1952,310,2262,15
2021-05-27,Contra Costa,013,1133247,69696,69245,1262,70507,813
2021-05-27,Del Norte,015,27424,1419,1388,13,1401,8
2021-05-27,El Dorado,017,186661,10324,10248,740,10988,112
2021-05-27,Fresno,019,978130,102791,102413,8603,111016,1704
2021-05-27,Glenn,021,27897,2437,2415,555,2970,18
2021-05-27,Humboldt,023,135768,4274,4260,38,4298,42
2021-05-27,Imperial,025,180216,28624,28728,2685,31413,736
2021-05-27,Inyo,027,18085,1404,1404,12,1416,35
2021-05-27,Kern,029,883053,97362,96364,10811,107175,1322
2021-05-27,Kings,031,150075,23169,22953,1069,24022,245
2021-05-27,Lake,033,64148,3529,3509,9,3518,45
2021-05-27,Lassen,035,31185,5215,5170,112,5282,6
2021-05-27,Los Angeles,037,10098052,1207205,1201927,40898,1242825,24348
2021-05-27,Madera,039,155013,16632,16527,927,17454,240
2021-05-27,Marin,041,260295,14114,14061,251,14312,229
2021-05-27,Mariposa,043,17540,432,427,11,438,5
2021-05-27,Mendocino,045,87422,4011,3945,82,4027,47
2021-05-27,Merced,047,269075,31031,31161,1029,32190,455
2021-05-27,Modoc,049,8938,378,374,131,505,3
2021-05-27,Mono,051,14174,1263,1276,16,1292,3
2021-05-27,Monterey,053,433212,43177,43032,1837,44869,379
2021-05-27,Napa,055,140530,9917,9934,36,9970,82
2021-05-27,Nevada,057,99092,4834,4807,188,4995,71
2021-05-27,Orange,059,3164182,255415,254438,11246,265684,5059
2021-05-27,Placer,061,380077,23338,22966,1492,24458,293
2021-05-27,Plumas,063,18699,706,687,11,698,4
2021-05-27,Riverside,065,2383286,294234,288835,13863,302698,4443
2021-05-27,Sacramento,067,1510023,106340,106015,1736,107751,1642
2021-05-27,San Benito,069,59416,6054,6074,112,6186,63
2021-05-27,San Bernardino,071,2135413,293404,292755,8916,301671,4756
2021-05-27,San Diego,073,3302833,280959,279960,14970,294930,3756
2021-05-27,San Francisco,075,870044,36739,36980,1265,38245,546
2021-05-27,San Joaquin,077,732212,73227,72714,3493,76207,1388
2021-05-27,San Luis Obispo,079,281455,21402,21171,734,21905,256
2021-05-27,San Mateo,081,765935,42341,42345,467,42812,436
2021-05-27,Santa Barbara,083,443738,34453,34355,1115,35470,456
2021-05-27,Santa Clara,085,1922200,118672,119452,745,120197,2053
2021-05-27,Santa Cruz,087,273765,16244,16134,796,16930,207
2021-05-27,Shasta,089,179085,12337,12380,1570,13950,202
2021-05-27,Sierra,091,2930,57,54,12,66,0
2021-05-27,Siskiyou,093,43540,1933,1846,356,2202,18
2021-05-27,Solano,095,438530,32875,32855,551,33406,257
2021-05-27,Sonoma,097,501317,30121,30253,329,30582,321
2021-05-27,Stanislaus,099,539301,56421,56207,5879,62086,974
2021-05-27,Sutter,101,95872,9466,9501,84,9585,111
2021-05-27,Tehama,103,63373,5089,5064,569,5633,63
2021-05-27,Trinity,105,12862,483,328,91,419,3
2021-05-27,Tulare,107,460477,50238,49366,8881,58247,840
2021-05-27,Tuolumne,109,53932,4032,4090,42,4132,66
2021-05-27,Ventura,111,848112,81411,80965,2950,83915,1023
2021-05-27,Yolo,113,214977,14053,14036,234,14270,213
2021-05-27,Yuba,115,75493,6074,6040,122,6162,48
2021-05-26,Alameda,001,1643700,88203,88297,1911,90208,1266
2021-05-26,Alpine,003,1148,87,88,0,88,0
2021-05-26,Amador,005,37829,3674,3679,32,3711,46
2021-05-26,Butte,007,227075,12563,12332,1805,14137,190
2021-05-26,Calaveras,009,45235,2167,2154,13,2167,55
2021-05-26,Colusa,011,21464,1946,1952,310,2262,15
2021-05-26,Contra Costa,013,1133247,69659,69210,1262,70472,812
2021-05-26,Del Norte,015,27424,1419,1386,12,1398,8
2021-05-26,El Dorado,017,186661,10320,10242,739,10981,112
2021-05-26,Fresno,019,978130,102758,102374,8598,110972,1702
2021-05-26,Glenn,021,27897,2436,2415,555,2970,18
2021-05-26,Humboldt,023,135768,4269,4246,38,4284,42
2021-05-26,Imperial,025,180216,28619,28712,2683,31395,734
2021-05-26,Inyo,027,18085,1404,1403,12,1415,36
2021-05-26,Kern,029,883053,97337,96343,10804,107147,1320
2021-05-26,Kings,031,150075,23165,22950,1068,24018,245
2021-05-26,Lake,033,64148,3528,3508,9,3517,45
2021-05-26,Lassen,035,31185,5214,5164,112,5276,6
2021-05-26,Los Angeles,037,10098052,1207037,1198100,40882,1238982,24221
2021-05-26,Madera,039,155013,16629,16520,927,17447,240
2021-05-26,Marin,041,260295,14111,14061,250,14311,227
2021-05-26,Mariposa,043,17540,432,427,11,438,5
2021-05-26,Mendocino,045,87422,4005,3938,82,4020,47
2021-05-26,Merced,047,269075,31022,31139,1029,32168,455
2021-05-26,Modoc,049,8938,378,371,130,501,3
2021-05-26,Mono,051,14174,1263,1274,16,1290,3
2021-05-26,Monterey,053,433212,43171,43018,1836,44854,379
2021-05-26,Napa,055,140530,9910,9932,34,9966,82
2021-05-26,Nevada,057,99092,4829,4803,188,4991,70
2021-05-26,Orange,059,3164182,255379,254368,11243,265611,5058
2021-05-26,Placer,061,380077,23314,22940,1492,24432,293
2021-05-26,Plumas,063,18699,705,685,11,696,4
2021-05-26,Riverside,065,2383286,294188,288782,13856,302638,4443
2021-05-26,Sacramento,067,1510023,106254,105919,1732,107651,1637
2021-05-26,San Benito,069,59416,6054,6074,112,6186,63
2021-05-26,San Bernardino,071,2135413,293369,292662,8915,301577,4755
2021-05-26,San Diego,073,3302833,280884,279859,14960,294819,3755
2021-05-26,San Francisco,075,870044,36727,36954,1265,38219,546
2021-05-26,San Joaquin,077,732212,73185,72681,3490,76171,1388
2021-05-26,San Luis Obispo,079,281455,21396,21163,734,21897,256
2021-05-26,San Mateo,081,765935,42333,42331,467,42798,436
2021-05-26,Santa Barbara,083,443738,34444,34348,1115,35463,459
2021-05-26,Santa Clara,085,1922200,118645,119421,744,120165,2031
2021-05-26,Santa Cruz,087,273765,16243,16139,796,16935,207
2021-05-26,Shasta,089,179085,12322,12357,1567,13924,202
2021-05-26,Sierra,091,2930,57,54,12,66,0
2021-05-26,Siskiyou,093,43540,1931,1847,354,2201,18
2021-05-26,Solano,095,438530,32839,32831,551,33382,257
2021-05-26,Sonoma,097,501317,30094,30230,329,30559,321
2021-05-26,Stanislaus,099,539301,56399,56193,5877,62070,974
2021-05-26,Sutter,101,95872,9461,9495,84,9579,112
2021-05-26,Tehama,103,63373,5088,5054,566,5620,63
2021-05-26,Trinity,105,12862,483,328,91,419,3
2021-05-26,Tulare,107,460477,50231,49352,8877,58229,839
2021-05-26,Tuolumne,109,53932,4028,4088,41,4129,66
2021-05-26,Ventura,111,848112,81388,80944,2948,83892,1023
2021-05-26,Yolo,113,214977,14050,14025,234,14259,213
2021-05-26,Yuba,115,75493,6069,6036,122,6158,49
2021-05-25,Alameda,001,1643700,88172,88237,1911,90148,1263
2021-05-25,Alpine,003,1148,87,88,0,88,0
2021-05-25,Amador,005,37829,3669,3676,32,3708,46
2021-05-25,Butte,007,227075,12552,12295,1804,14099,189
2021-05-25,Calaveras,009,45235,2165,2148,13,2161,55
2021-05-25,Colusa,011,21464,1945,1949,310,2259,15
2021-05-25,Contra Costa,013,1133247,69607,69167,1257,70424,809
2021-05-25,Del Norte,015,27424,1419,1385,12,1397,8
2021-05-25,El Dorado,017,186661,10313,10240,738,10978,112
2021-05-25,Fresno,019,978130,102737,102329,8596,110925,1701
2021-05-25,Glenn,021,27897,2435,2414,554,2968,17
2021-05-25,Humboldt,023,135768,4262,4231,36,4267,42
2021-05-25,Imperial,025,180216,28612,28586,2683,31269,735
2021-05-25,Inyo,027,18085,1404,1402,12,1414,36
2021-05-25,Kern,029,883053,97306,96319,10790,107109,1319
2021-05-25,Kings,031,150075,23158,22944,1068,24012,245
2021-05-25,Lake,033,64148,3527,3508,9,3517,44
2021-05-25,Lassen,035,31185,5210,5164,112,5276,6
2021-05-25,Los Angeles,037,10098052,1206851,1197940,40864,1238804,24212
2021-05-25,Madera,039,155013,16624,16519,926,17445,240
2021-05-25,Marin,041,260295,14105,14053,250,14303,227
2021-05-25,Mariposa,043,17540,431,427,11,438,5
2021-05-25,Mendocino,045,87422,4000,3928,82,4010,47
2021-05-25,Merced,047,269075,31001,31132,1029,32161,455
2021-05-25,Modoc,049,8938,377,367,130,497,3
2021-05-25,Mono,051,14174,1263,1274,16,1290,3
2021-05-25,Monterey,053,433212,43167,43012,1835,44847,379
2021-05-25,Napa,055,140530,9908,9926,34,9960,82
2021-05-25,Nevada,057,99092,4823,4795,188,4983,70
2021-05-25,Orange,059,3164182,255350,254321,11242,265563,5057
2021-05-25,Placer,061,380077,23303,22920,1490,24410,292
2021-05-25,Plumas,063,18699,705,684,11,695,4
2021-05-25,Riverside,065,2383286,294149,288725,13853,302578,4443
2021-05-25,Sacramento,067,1510023,106173,105828,1729,107557,1633
2021-05-25,San Benito,069,59416,6054,6073,112,6185,63
2021-05-25,San Bernardino,071,2135413,293309,292485,8914,301399,4755
2021-05-25,San Diego,073,3302833,280802,279786,14955,294741,3753
2021-05-25,San Francisco,075,870044,36704,36939,1265,38204,546
2021-05-25,San Joaquin,077,732212,73143,72628,3487,76115,1387
2021-05-25,San Luis Obispo,079,281455,21393,21153,734,21887,256
2021-05-25,San Mateo,081,765935,42323,42268,467,42735,435
2021-05-25,Santa Barbara,083,443738,34441,34337,1115,35452,459
2021-05-25,Santa Clara,085,1922200,118621,119393,743,120136,2032
2021-05-25,Santa Cruz,087,273765,16238,16141,796,16937,207
2021-05-25,Shasta,089,179085,12313,12328,1565,13893,202
2021-05-25,Sierra,091,2930,56,54,12,66,0
2021-05-25,Siskiyou,093,43540,1930,1845,353,2198,18
2021-05-25,Solano,095,438530,32820,32817,550,33367,256
2021-05-25,Sonoma,097,501317,30065,30207,328,30535,321
2021-05-25,Stanislaus,099,539301,56363,56168,5874,62042,974
2021-05-25,Sutter,101,95872,9457,9495,84,9579,112
2021-05-25,Tehama,103,63373,5086,5048,565,5613,63
2021-05-25,Trinity,105,12862,483,328,90,418,3
2021-05-25,Tulare,107,460477,50221,49326,8869,58195,838
2021-05-25,Tuolumne,109,53932,4028,4084,41,4125,66
2021-05-25,Ventura,111,848112,81370,80905,2948,83853,1022
2021-05-25,Yolo,113,214977,14042,14018,232,14250,213
2021-05-25,Yuba,115,75493,6062,6028,122,6150,49
2021-05-24,Alameda,001,1643700,88132,88182,1910,90092,1263
2021-05-24,Alpine,003,1148,87,88,0,88,0
2021-05-24,Amador,005,37829,3667,3675,32,3707,46
2021-05-24,Butte,007,227075,12539,12279,1801,14080,189
2021-05-24,Calaveras,009,45235,2163,2146,13,2159,54
2021-05-24,Colusa,011,21464,1945,1949,310,2259,15
2021-05-24,Contra Costa,013,1133247,69566,69107,1253,70360,809
2021-05-24,Del Norte,015,27424,1418,1384,12,1396,8
2021-05-24,El Dorado,017,186661,10303,10227,737,10964,112
2021-05-24,Fresno,019,978130,102695,102289,8595,110884,1698
2021-05-24,Glenn,021,27897,2435,2413,554,2967,17
2021-05-24,Humboldt,023,135768,4255,4225,36,4261,42
2021-05-24,Imperial,025,180216,28610,28575,2683,31258,735
2021-05-24,Inyo,027,18085,1404,1402,12,1414,36
2021-05-24,Kern,029,883053,97279,96296,10785,107081,1319
2021-05-24,Kings,031,150075,23154,22940,1068,24008,246
2021-05-24,Lake,033,64148,3525,3506,9,3515,43
2021-05-24,Lassen,035,31185,5206,5163,112,5275,6
2021-05-24,Los Angeles,037,10098052,1206679,1197782,40850,1238632,24201
2021-05-24,Madera,039,155013,16620,16513,925,17438,239
2021-05-24,Marin,041,260295,14103,14051,250,14301,227
2021-05-24,Mariposa,043,17540,430,427,11,438,5
2021-05-24,Mendocino,045,87422,3998,3919,82,4001,47
2021-05-24,Merced,047,269075,30991,31128,1028,32156,455
2021-05-24,Modoc,049,8938,377,366,129,495,3
2021-05-24,Mono,051,14174,1263,1270,16,1286,3
2021-05-24,Monterey,053,433212,43162,43005,1834,44839,379
2021-05-24,Napa,055,140530,9908,9924,34,9958,82
2021-05-24,Nevada,057,99092,4820,4790,188,4978,70
2021-05-24,Orange,059,3164182,255316,254287,11232,265519,5056
2021-05-24,Placer,061,380077,23284,22895,1489,24384,292
2021-05-24,Plumas,063,18699,704,683,11,694,4
2021-05-24,Riverside,065,2383286,294092,288669,13843,302512,4442
2021-05-24,Sacramento,067,1510023,106058,105716,1728,107444,1632
2021-05-24,San Benito,069,59416,6054,6072,112,6184,63
2021-05-24,San Bernardino,071,2135413,293269,292343,8913,301256,4747
2021-05-24,San Diego,073,3302833,280694,279715,14945,294660,3749
2021-05-24,San Francisco,075,870044,36684,36934,1263,38197,547
2021-05-24,San Joaquin,077,732212,73111,72586,3487,76073,1371
2021-05-24,San Luis Obispo,079,281455,21375,21146,733,21879,256
2021-05-24,San Mateo,081,765935,42313,42249,467,42716,433
2021-05-24,Santa Barbara,083,443738,34436,34322,1115,35437,459
2021-05-24,Santa Clara,085,1922200,118589,119358,743,120101,2030
2021-05-24,Santa Cruz,087,273765,16232,16135,796,16931,207
2021-05-24,Shasta,089,179085,12296,12315,1562,13877,201
2021-05-24,Sierra,091,2930,56,54,12,66,0
2021-05-24,Siskiyou,093,43540,1927,1840,353,2193,17
2021-05-24,Solano,095,438530,32795,32792,549,33341,254
2021-05-24,Sonoma,097,501317,30050,30187,328,30515,321
2021-05-24,Stanislaus,099,539301,56329,56128,5870,61998,974
2021-05-24,Sutter,101,95872,9451,9486,84,9570,113
2021-05-24,Tehama,103,63373,5083,5043,563,5606,63
2021-05-24,Trinity,105,12862,483,328,90,418,3
2021-05-24,Tulare,107,460477,50214,49318,8865,58183,838
2021-05-24,Tuolumne,109,53932,4028,4083,41,4124,65
2021-05-24,Ventura,111,848112,81357,80876,2946,83822,1022
2021-05-24,Yolo,113,214977,14025,14012,230,14242,213
2021-05-24,Yuba,115,75493,6053,6022,122,6144,49
2021-05-23,Alameda,001,1643700,88069,88157,1907,90064,1263
2021-05-23,Alpine,003,1148,87,88,0,88,0
2021-05-23,Amador,005,37829,3666,3673,32,3705,46
2021-05-23,Butte,007,227075,12525,12271,1800,14071,189
2021-05-23,Calaveras,009,45235,2155,2144,13,2157,54
2021-05-23,Colusa,011,21464,1945,1949,308,2257,15
2021-05-23,Contra Costa,013,1133247,69522,69075,1251,70326,809
2021-05-23,Del Norte,015,27424,1414,1383,12,1395,8
2021-05-23,El Dorado,017,186661,10297,10222,737,10959,112
2021-05-23,Fresno,019,978130,102650,102270,8590,110860,1698
2021-05-23,Glenn,021,27897,2433,2413,554,2967,17
2021-05-23,Humboldt,023,135768,4238,4216,36,4252,42
2021-05-23,Imperial,025,180216,28604,28569,2682,31251,735
2021-05-23,Inyo,027,18085,1404,1402,12,1414,36
2021-05-23,Kern,029,883053,97255,96282,10777,107059,1319
2021-05-23,Kings,031,150075,23141,22939,1066,24005,246
2021-05-23,Lake,033,64148,3522,3504,9,3513,43
2021-05-23,Lassen,035,31185,5202,5163,111,5274,6
2021-05-23,Los Angeles,037,10098052,1206490,1197633,40839,1238472,24197
2021-05-23,Madera,039,155013,16614,16504,925,17429,239
2021-05-23,Marin,041,260295,14094,14048,249,14297,227
2021-05-23,Mariposa,043,17540,430,427,11,438,5
2021-05-23,Mendocino,045,87422,3992,3913,81,3994,47
2021-05-23,Merced,047,269075,30982,31118,1028,32146,455
2021-05-23,Modoc,049,8938,373,366,129,495,3
2021-05-23,Mono,051,14174,1262,1270,16,1286,3
2021-05-23,Monterey,053,433212,43152,43003,1834,44837,379
2021-05-23,Napa,055,140530,9904,9923,34,9957,82
2021-05-23,Nevada,057,99092,4810,4790,188,4978,70
2021-05-23,Orange,059,3164182,255278,254277,11226,265503,5050
2021-05-23,Placer,061,380077,23264,22888,1489,24377,292
2021-05-23,Plumas,063,18699,703,683,11,694,4
2021-05-23,Riverside,065,2383286,294024,288641,13839,302480,4442
2021-05-23,Sacramento,067,1510023,105942,105663,1725,107388,1632
2021-05-23,San Benito,069,59416,6053,6072,112,6184,63
2021-05-23,San Bernardino,071,2135413,293218,292327,8912,301239,4747
2021-05-23,San Diego,073,3302833,280604,279690,14934,294624,3751
2021-05-23,San Francisco,075,870044,36673,36927,1262,38189,547
2021-05-23,San Joaquin,077,732212,73062,72571,3485,76056,1371
2021-05-23,San Luis Obispo,079,281455,21365,21141,732,21873,256
2021-05-23,San Mateo,081,765935,42296,42248,467,42715,433
2021-05-23,Santa Barbara,083,443738,34429,34319,1115,35434,459
2021-05-23,Santa Clara,085,1922200,118565,119333,743,120076,2030
2021-05-23,Santa Cruz,087,273765,16229,16130,796,16926,207
2021-05-23,Shasta,089,179085,12279,12313,1558,13871,201
2021-05-23,Sierra,091,2930,56,54,12,66,0
2021-05-23,Siskiyou,093,43540,1922,1826,346,2172,17
2021-05-23,Solano,095,438530,32777,32780,548,33328,254
2021-05-23,Sonoma,097,501317,30021,30168,327,30495,321
2021-05-23,Stanislaus,099,539301,56281,56104,5867,61971,974
2021-05-23,Sutter,101,95872,9442,9479,84,9563,113
2021-05-23,Tehama,103,63373,5076,5041,561,5602,63
2021-05-23,Trinity,105,12862,483,328,90,418,3
2021-05-23,Tulare,107,460477,50200,49310,8861,58171,838
2021-05-23,Tuolumne,109,53932,4025,4081,41,4122,65
2021-05-23,Ventura,111,848112,81327,80872,2945,83817,1022
2021-05-23,Yolo,113,214977,14013,14004,227,14231,213
2021-05-23,Yuba,115,75493,6048,6017,122,6139,49
2021-05-22,Alameda,001,1643700,88042,88101,1907,90008,1263
2021-05-22,Alpine,003,1148,87,88,0,88,0
2021-05-22,Amador,005,37829,3665,3672,32,3704,46
2021-05-22,Butte,007,227075,12513,12265,1799,14064,189
2021-05-22,Calaveras,009,45235,2151,2141,13,2154,54
2021-05-22,Colusa,011,21464,1941,1949,307,2256,15
2021-05-22,Contra Costa,013,1133247,69489,69004,1250,70254,809
2021-05-22,Del Norte,015,27424,1413,1381,12,1393,8
2021-05-22,El Dorado,017,186661,10292,10215,736,10951,112
2021-05-22,Fresno,019,978130,102636,102238,8588,110826,1698
2021-05-22,Glenn,021,27897,2433,2412,554,2966,17
2021-05-22,Humboldt,023,135768,4229,4194,35,4229,42
2021-05-22,Imperial,025,180216,28595,28574,2682,31256,735
2021-05-22,Inyo,027,18085,1404,1402,12,1414,36
2021-05-22,Kern,029,883053,97243,96260,10770,107030,1319
2021-05-22,Kings,031,150075,23141,22936,1066,24002,246
2021-05-22,Lake,033,64148,3519,3502,9,3511,43
2021-05-22,Lassen,035,31185,5202,5163,111,5274,6
2021-05-22,Los Angeles,037,10098052,1206381,1197454,40831,1238285,24192
2021-05-22,Madera,039,155013,16611,16503,925,17428,239
2021-05-22,Marin,041,260295,14091,14043,249,14292,227
2021-05-22,Mariposa,043,17540,430,427,11,438,5
2021-05-22,Mendocino,045,87422,3986,3908,81,3989,47
2021-05-22,Merced,047,269075,30972,31099,1028,32127,455
2021-05-22,Modoc,049,8938,373,366,129,495,3
2021-05-22,Mono,051,14174,1260,1270,16,1286,3
2021-05-22,Monterey,053,433212,43146,42998,1834,44832,379
2021-05-22,Napa,055,140530,9902,9918,34,9952,82
2021-05-22,Nevada,057,99092,4803,4787,187,4974,70
2021-05-22,Orange,059,3164182,255257,254238,11221,265459,5048
2021-05-22,Placer,061,380077,23250,22865,1488,24353,292
2021-05-22,Plumas,063,18699,702,683,11,694,4
2021-05-22,Riverside,065,2383286,293992,288580,13838,302418,4442
2021-05-22,Sacramento,067,1510023,105867,105551,1722,107273,1632
2021-05-22,San Benito,069,59416,6053,6071,112,6183,63
2021-05-22,San Bernardino,071,2135413,293193,292292,8912,301204,4747
2021-05-22,San Diego,073,3302833,280545,279614,14926,294540,3751
2021-05-22,San Francisco,075,870044,36663,36906,1260,38166,547
2021-05-22,San Joaquin,077,732212,73040,72528,3482,76010,1371
2021-05-22,San Luis Obispo,079,281455,21357,21134,731,21865,256
2021-05-22,San Mateo,081,765935,42286,42218,467,42685,433
2021-05-22,Santa Barbara,083,443738,34425,34313,1114,35427,459
2021-05-22,Santa Clara,085,1922200,118541,119292,743,120035,2030
2021-05-22,Santa Cruz,087,273765,16229,16125,796,16921,207
2021-05-22,Shasta,089,179085,12272,12307,1555,13862,201
2021-05-22,Sierra,091,2930,56,54,12,66,0
2021-05-22,Siskiyou,093,43540,1921,1824,345,2169,17
2021-05-22,Solano,095,438530,32764,32753,548,33301,254
2021-05-22,Sonoma,097,501317,30009,30154,327,30481,321
2021-05-22,Stanislaus,099,539301,56258,56069,5866,61935,974
2021-05-22,Sutter,101,95872,9437,9476,84,9560,113
2021-05-22,Tehama,103,63373,5075,5036,561,5597,63
2021-05-22,Trinity,105,12862,483,328,90,418,3
2021-05-22,Tulare,107,460477,50195,49299,8856,58155,838
2021-05-22,Tuolumne,109,53932,4025,4078,41,4119,65
2021-05-22,Ventura,111,848112,81323,80859,2945,83804,1022
2021-05-22,Yolo,113,214977,14011,13997,227,14224,213
2021-05-22,Yuba,115,75493,6045,6010,122,6132,49
2021-05-21,Alameda,001,1643700,88016,88041,1906,89947,1263
2021-05-21,Alpine,003,1148,87,88,0,88,0
2021-05-21,Amador,005,37829,3662,3672,32,3704,46
2021-05-21,Butte,007,227075,12507,12236,1797,14033,188
2021-05-21,Calaveras,009,45235,2149,2138,13,2151,54
2021-05-21,Colusa,011,21464,1941,1947,307,2254,15
2021-05-21,Contra Costa,013,1133247,69446,68965,1249,70214,810
2021-05-21,Del Norte,015,27424,1412,1376,12,1388,8
2021-05-21,El Dorado,017,186661,10288,10204,736,10940,112
2021-05-21,Fresno,019,978130,102608,102189,8586,110775,1698
2021-05-21,Glenn,021,27897,2432,2408,554,2962,17
2021-05-21,Humboldt,023,135768,4222,4175,35,4210,42
2021-05-21,Imperial,025,180216,28588,28572,2681,31253,732
2021-05-21,Inyo,027,18085,1404,1402,12,1414,36
2021-05-21,Kern,029,883053,97229,96233,10763,106996,1318
2021-05-21,Kings,031,150075,23141,22927,1066,23993,246
2021-05-21,Lake,033,64148,3517,3500,9,3509,43
2021-05-21,Lassen,035,31185,5201,5161,111,5272,6
2021-05-21,Los Angeles,037,10098052,1206263,1197263,40823,1238086,24180
2021-05-21,Madera,039,155013,16610,16500,924,17424,238
2021-05-21,Marin,041,260295,14086,14042,249,14291,227
2021-05-21,Mariposa,043,17540,429,427,11,438,5
2021-05-21,Mendocino,045,87422,3981,3897,81,3978,47
2021-05-21,Merced,047,269075,30964,31076,1028,32104,455
2021-05-21,Modoc,049,8938,373,365,129,494,3
2021-05-21,Mono,051,14174,1260,1269,16,1285,3
2021-05-21,Monterey,053,433212,43144,42995,1834,44829,379
2021-05-21,Napa,055,140530,9898,9913,34,9947,82
2021-05-21,Nevada,057,99092,4802,4779,187,4966,70
2021-05-21,Orange,059,3164182,255237,254171,11219,265390,5042
2021-05-21,Placer,061,380077,23241,22853,1488,24341,292
2021-05-21,Plumas,063,18699,702,683,10,693,4
2021-05-21,Riverside,065,2383286,293965,288499,13831,302330,4442
2021-05-21,Sacramento,067,1510023,105800,105476,1719,107195,1632
2021-05-21,San Benito,069,59416,6053,6068,112,6180,63
2021-05-21,San Bernardino,071,2135413,293161,292205,8910,301115,4744
2021-05-21,San Diego,073,3302833,280472,279554,14916,294470,3748
2021-05-21,San Francisco,075,870044,36658,36879,1260,38139,546
2021-05-21,San Joaquin,077,732212,73020,72467,3480,75947,1371
2021-05-21,San Luis Obispo,079,281455,21351,21128,728,21856,256
2021-05-21,San Mateo,081,765935,42273,42163,466,42629,432
2021-05-21,Santa Barbara,083,443738,34420,34302,1114,35416,459
2021-05-21,Santa Clara,085,1922200,118514,119247,743,119990,2029
2021-05-21,Santa Cruz,087,273765,16225,16120,796,16916,207
2021-05-21,Shasta,089,179085,12255,12289,1553,13842,201
2021-05-21,Sierra,091,2930,56,54,12,66,0
2021-05-21,Siskiyou,093,43540,1920,1815,345,2160,16
2021-05-21,Solano,095,438530,32749,32742,548,33290,254
2021-05-21,Sonoma,097,501317,29996,30126,327,30453,321
2021-05-21,Stanislaus,099,539301,56229,56036,5864,61900,975
2021-05-21,Sutter,101,95872,9435,9470,84,9554,113
2021-05-21,Tehama,103,63373,5069,5030,561,5591,63
2021-05-21,Trinity,105,12862,483,329,89,418,3
2021-05-21,Tulare,107,460477,50190,49271,8854,58125,838
2021-05-21,Tuolumne,109,53932,4023,4079,41,4120,65
2021-05-21,Ventura,111,848112,81315,80821,2942,83763,1021
2021-05-21,Yolo,113,214977,14005,13983,227,14210,213
2021-05-21,Yuba,115,75493,6039,6006,122,6128,49
2021-05-20,Alameda,001,1643700,87972,87975,1905,89880,1264
2021-05-20,Alpine,003,1148,87,88,0,88,0
2021-05-20,Amador,005,37829,3661,3671,32,3703,46
2021-05-20,Butte,007,227075,12500,12220,1794,14014,188
2021-05-20,Calaveras,009,45235,2145,2138,13,2151,54
2021-05-20,Colusa,011,21464,1940,1946,305,2251,15
2021-05-20,Contra Costa,013,1133247,69401,68913,1247,70160,809
2021-05-20,Del Norte,015,27424,1412,1373,12,1385,8
2021-05-20,El Dorado,017,186661,10278,10188,736,10924,112
2021-05-20,Fresno,019,978130,102586,102135,8584,110719,1696
2021-05-20,Glenn,021,27897,2429,2406,554,2960,17
2021-05-20,Humboldt,023,135768,4205,4162,34,4196,42
2021-05-20,Imperial,025,180216,28583,28551,2681,31232,732
2021-05-20,Inyo,027,18085,1404,1402,12,1414,36
2021-05-20,Kern,029,883053,97208,96204,10756,106960,1317
2021-05-20,Kings,031,150075,23139,22922,1066,23988,246
2021-05-20,Lake,033,64148,3514,3500,9,3509,43
2021-05-20,Lassen,035,31185,5199,5160,110,5270,6
2021-05-20,Los Angeles,037,10098052,1206107,1197073,40813,1237886,24168
2021-05-20,Madera,039,155013,16604,16499,922,17421,238
2021-05-20,Marin,041,260295,14082,14036,248,14284,227
2021-05-20,Mariposa,043,17540,429,426,11,437,5
2021-05-20,Mendocino,045,87422,3974,3897,81,3978,47
2021-05-20,Merced,047,269075,30951,31046,1027,32073,454
2021-05-20,Modoc,049,8938,373,365,129,494,3
2021-05-20,Mono,051,14174,1259,1269,16,1285,3
2021-05-20,Monterey,053,433212,43138,42984,1833,44817,379
2021-05-20,Napa,055,140530,9895,9913,34,9947,82
2021-05-20,Nevada,057,99092,4801,4775,187,4962,70
2021-05-20,Orange,059,3164182,255194,254127,11216,265343,5038
2021-05-20,Placer,061,380077,23228,22823,1487,24310,292
2021-05-20,Plumas,063,18699,700,682,10,692,4
2021-05-20,Riverside,065,2383286,293917,288453,13826,302279,4442
2021-05-20,Sacramento,067,1510023,105704,105414,1716,107130,1629
2021-05-20,San Benito,069,59416,6052,6067,112,6179,63
2021-05-20,San Bernardino,071,2135413,293115,292153,8909,301062,4728
2021-05-20,San Diego,073,3302833,280384,279490,14904,294394,3749
2021-05-20,San Francisco,075,870044,36649,36860,1260,38120,546
2021-05-20,San Joaquin,077,732212,72982,72388,3478,75866,1371
2021-05-20,San Luis Obispo,079,281455,21339,21095,726,21821,256
2021-05-20,San Mateo,081,765935,42259,42152,464,42616,432
2021-05-20,Santa Barbara,083,443738,34416,34293,1114,35407,459
2021-05-20,Santa Clara,085,1922200,118493,119222,743,119965,2029
2021-05-20,Santa Cruz,087,273765,16220,16119,796,16915,207
2021-05-20,Shasta,089,179085,12242,12266,1550,13816,200
2021-05-20,Sierra,091,2930,56,54,12,66,0
2021-05-20,Siskiyou,093,43540,1913,1811,344,2155,16
2021-05-20,Solano,095,438530,32734,32725,548,33273,253
2021-05-20,Sonoma,097,501317,29979,30107,326,30433,321
2021-05-20,Stanislaus,099,539301,56204,55979,5862,61841,970
2021-05-20,Sutter,101,95872,9431,9467,84,9551,113
2021-05-20,Tehama,103,63373,5067,5029,561,5590,63
2021-05-20,Trinity,105,12862,483,329,88,417,3
2021-05-20,Tulare,107,460477,50179,49217,8851,58068,837
2021-05-20,Tuolumne,109,53932,4022,4077,41,4118,65
2021-05-20,Ventura,111,848112,81304,80800,2942,83742,1019
2021-05-20,Yolo,113,214977,14000,13973,227,14200,211
2021-05-20,Yuba,115,75493,6030,6002,122,6124,49
2021-05-19,Alameda,001,1643700,87933,87889,1904,89793,1260
2021-05-19,Alpine,003,1148,87,88,0,88,0
2021-05-19,Amador,005,37829,3661,3669,32,3701,46
2021-05-19,Butte,007,227075,12489,12198,1794,13992,188
2021-05-19,Calaveras,009,45235,2141,2132,13,2145,54
2021-05-19,Colusa,011,21464,1940,1945,303,2248,15
2021-05-19,Contra Costa,013,1133247,69354,68836,1247,70083,808
2021-05-19,Del Norte,015,27424,1410,1371,12,1383,8
2021-05-19,El Dorado,017,186661,10273,10179,735,10914,112
2021-05-19,Fresno,019,978130,102556,102085,8581,110666,1693
2021-05-19,Glenn,021,27897,2429,2404,554,2958,17
2021-05-19,Humboldt,023,135768,4195,4143,34,4177,42
2021-05-19,Imperial,025,180216,28574,28550,2681,31231,732
2021-05-19,Inyo,027,18085,1404,1402,12,1414,36
2021-05-19,Kern,029,883053,97179,96173,10749,106922,1316
2021-05-19,Kings,031,150075,23133,22919,1066,23985,246
2021-05-19,Lake,033,64148,3514,3497,9,3506,43
2021-05-19,Lassen,035,31185,5198,5157,110,5267,6
2021-05-19,Los Angeles,037,10098052,1205910,1196856,40799,1237655,24143
2021-05-19,Madera,039,155013,16601,16496,922,17418,238
2021-05-19,Marin,041,260295,14078,14033,246,14279,227
2021-05-19,Mariposa,043,17540,429,425,11,436,5
2021-05-19,Mendocino,045,87422,3970,3886,81,3967,47
2021-05-19,Merced,047,269075,30935,31044,1027,32071,452
2021-05-19,Modoc,049,8938,373,364,126,490,3
2021-05-19,Mono,051,14174,1259,1266,16,1282,3
2021-05-19,Monterey,053,433212,43133,42973,1832,44805,379
2021-05-19,Napa,055,140530,9892,9906,34,9940,82
2021-05-19,Nevada,057,99092,4799,4769,187,4956,70
2021-05-19,Orange,059,3164182,255157,254087,11206,265293,5035
2021-05-19,Placer,061,380077,23209,22784,1482,24266,291
2021-05-19,Plumas,063,18699,700,682,10,692,4
2021-05-19,Riverside,065,2383286,293871,288398,13824,302222,4442
2021-05-19,Sacramento,067,1510023,105626,105225,1715,106940,1629
2021-05-19,San Benito,069,59416,6051,6064,112,6176,63
2021-05-19,San Bernardino,071,2135413,293071,292078,8906,300984,4725
2021-05-19,San Diego,073,3302833,280299,279345,14883,294228,3746
2021-05-19,San Francisco,075,870044,36636,36835,1259,38094,546
2021-05-19,San Joaquin,077,732212,72939,72338,3473,75811,1369
2021-05-19,San Luis Obispo,079,281455,21331,21085,725,21810,256
2021-05-19,San Mateo,081,765935,42252,42126,464,42590,429
2021-05-19,Santa Barbara,083,443738,34408,34292,1114,35406,459
2021-05-19,Santa Clara,085,1922200,118453,119176,742,119918,2015
2021-05-19,Santa Cruz,087,273765,16216,16121,795,16916,207
2021-05-19,Shasta,089,179085,12224,12233,1547,13780,200
2021-05-19,Sierra,091,2930,56,54,12,66,0
2021-05-19,Siskiyou,093,43540,1910,1803,343,2146,16
2021-05-19,Solano,095,438530,32707,32678,546,33224,253
2021-05-19,Sonoma,097,501317,29964,30080,326,30406,321
2021-05-19,Stanislaus,099,539301,56185,55912,5857,61769,967
2021-05-19,Sutter,101,95872,9424,9459,83,9542,113
2021-05-19,Tehama,103,63373,5058,5026,557,5583,63
2021-05-19,Trinity,105,12862,483,329,88,417,3
2021-05-19,Tulare,107,460477,50166,49163,8846,58009,837
2021-05-19,Tuolumne,109,53932,4022,4074,41,4115,64
2021-05-19,Ventura,111,848112,81289,80747,2941,83688,1019
2021-05-19,Yolo,113,214977,13993,13961,226,14187,211
2021-05-19,Yuba,115,75493,6026,5993,122,6115,49
2021-05-18,Alameda,001,1643700,87859,87816,1904,89720,1254
2021-05-18,Alpine,003,1148,87,88,0,88,0
2021-05-18,Amador,005,37829,3661,3669,32,3701,46
2021-05-18,Butte,007,227075,12476,12164,1791,13955,191
2021-05-18,Calaveras,009,45235,2137,2131,13,2144,54
2021-05-18,Colusa,011,21464,1940,1943,303,2246,14
2021-05-18,Contra Costa,013,1133247,69297,68750,1246,69996,808
2021-05-18,Del Norte,015,27424,1407,1371,12,1383,8
2021-05-18,El Dorado,017,186661,10262,10169,734,10903,112
2021-05-18,Fresno,019,978130,102520,102056,8578,110634,1690
2021-05-18,Glenn,021,27897,2423,2403,553,2956,17
2021-05-18,Humboldt,023,135768,4177,4132,34,4166,42
2021-05-18,Imperial,025,180216,28569,28538,2679,31217,730
2021-05-18,Inyo,027,18085,1404,1401,12,1413,36
2021-05-18,Kern,029,883053,97146,96128,10735,106863,1315
2021-05-18,Kings,031,150075,23127,22916,1066,23982,247
2021-05-18,Lake,033,64148,3512,3495,9,3504,43
2021-05-18,Lassen,035,31185,5197,5157,109,5266,6
2021-05-18,Los Angeles,037,10098052,1205730,1196668,40788,1237456,24133
2021-05-18,Madera,039,155013,16591,16491,921,17412,238
2021-05-18,Marin,041,260295,14075,14026,246,14272,227
2021-05-18,Mariposa,043,17540,429,424,11,435,5
2021-05-18,Mendocino,045,87422,3958,3877,80,3957,47
2021-05-18,Merced,047,269075,30916,31036,1027,32063,452
2021-05-18,Modoc,049,8938,372,364,125,489,3
2021-05-18,Mono,051,14174,1258,1265,16,1281,3
2021-05-18,Monterey,053,433212,43127,43001,1832,44833,379
2021-05-18,Napa,055,140530,9892,9905,34,9939,82
2021-05-18,Nevada,057,99092,4792,4762,187,4949,70
2021-05-18,Orange,059,3164182,255116,254041,11196,265237,5031
2021-05-18,Placer,061,380077,23176,22726,1478,24204,291
2021-05-18,Plumas,063,18699,700,682,10,692,4
2021-05-18,Riverside,065,2383286,293816,288354,13817,302171,4438
2021-05-18,Sacramento,067,1510023,105524,105083,1713,106796,1629
2021-05-18,San Benito,069,59416,6050,6065,112,6177,63
2021-05-18,San Bernardino,071,2135413,293013,292014,8901,300915,4722
2021-05-18,San Diego,073,3302833,280191,279254,14874,294128,3742
2021-05-18,San Francisco,075,870044,36616,36818,1259,38077,546
2021-05-18,San Joaquin,077,732212,72892,72282,3469,75751,1368
2021-05-18,San Luis Obispo,079,281455,21321,21080,723,21803,256
2021-05-18,San Mateo,081,765935,42240,42099,463,42562,428
2021-05-18,Santa Barbara,083,443738,34399,34278,1114,35392,459
2021-05-18,Santa Clara,085,1922200,118426,119171,742,119913,2014
2021-05-18,Santa Cruz,087,273765,16208,16137,795,16932,207
2021-05-18,Shasta,089,179085,12206,12197,1541,13738,200
2021-05-18,Sierra,091,2930,56,54,12,66,0
2021-05-18,Siskiyou,093,43540,1909,1799,343,2142,16
2021-05-18,Solano,095,438530,32682,32644,546,33190,253
2021-05-18,Sonoma,097,501317,29944,30054,325,30379,321
2021-05-18,Stanislaus,099,539301,56150,55860,5857,61717,959
2021-05-18,Sutter,101,95872,9416,9453,83,9536,113
2021-05-18,Tehama,103,63373,5052,5020,555,5575,63
2021-05-18,Trinity,105,12862,483,329,87,416,3
2021-05-18,Tulare,107,460477,50158,49142,8841,57983,836
2021-05-18,Tuolumne,109,53932,4020,4073,41,4114,64
2021-05-18,Ventura,111,848112,81273,80726,2939,83665,1017
2021-05-18,Yolo,113,214977,13986,13951,225,14176,211
2021-05-18,Yuba,115,75493,6022,5989,122,6111,49
2021-05-17,Alameda,001,1643700,87806,87766,1901,89667,1253
2021-05-17,Alpine,003,1148,87,88,0,88,0
2021-05-17,Amador,005,37829,3658,3668,32,3700,46
2021-05-17,Butte,007,227075,12468,12144,1791,13935,192
2021-05-17,Calaveras,009,45235,2137,2131,13,2144,53
2021-05-17,Colusa,011,21464,1940,1943,303,2246,14
2021-05-17,Contra Costa,013,1133247,69242,68720,1245,69965,805
2021-05-17,Del Norte,015,27424,1402,1369,12,1381,8
2021-05-17,El Dorado,017,186661,10245,10163,734,10897,112
2021-05-17,Fresno,019,978130,102476,102013,8570,110583,1690
2021-05-17,Glenn,021,27897,2423,2401,553,2954,17
2021-05-17,Humboldt,023,135768,4166,4112,34,4146,42
2021-05-17,Imperial,025,180216,28563,28533,2677,31210,729
2021-05-17,Inyo,027,18085,1404,1401,12,1413,36
2021-05-17,Kern,029,883053,97117,96095,10718,106813,1315
2021-05-17,Kings,031,150075,23124,22918,1066,23984,246
2021-05-17,Lake,033,64148,3507,3489,9,3498,43
2021-05-17,Lassen,035,31185,5194,5156,108,5264,6
2021-05-17,Los Angeles,037,10098052,1205549,1196556,40782,1237338,24123
2021-05-17,Madera,039,155013,16584,16486,921,17407,238
2021-05-17,Marin,041,260295,14069,14021,246,14267,227
2021-05-17,Mariposa,043,17540,428,423,11,434,5
2021-05-17,Mendocino,045,87422,3949,3868,80,3948,46
2021-05-17,Merced,047,269075,30901,31031,1027,32058,450
2021-05-17,Modoc,049,8938,371,362,125,487,3
2021-05-17,Mono,051,14174,1254,1265,16,1281,3
2021-05-17,Monterey,053,433212,43120,42995,1832,44827,379
2021-05-17,Napa,055,140530,9891,9894,34,9928,82
2021-05-17,Nevada,057,99092,4788,4761,186,4947,70
2021-05-17,Orange,059,3164182,255069,253993,11189,265182,5031
2021-05-17,Placer,061,380077,23153,22706,1471,24177,289
2021-05-17,Plumas,063,18699,700,682,10,692,4
2021-05-17,Riverside,065,2383286,293747,288304,13813,302117,4433
2021-05-17,Sacramento,067,1510023,105416,105035,1711,106746,1629
2021-05-17,San Benito,069,59416,6047,6067,112,6179,63
2021-05-17,San Bernardino,071,2135413,292963,291989,8893,300882,4724
2021-05-17,San Diego,073,3302833,280059,279146,14852,293998,3742
2021-05-17,San Francisco,075,870044,36604,36816,1257,38073,546
2021-05-17,San Joaquin,077,732212,72854,72234,3466,75700,1359
2021-05-17,San Luis Obispo,079,281455,21312,21079,721,21800,256
2021-05-17,San Mateo,081,765935,42212,42083,463,42546,428
2021-05-17,Santa Barbara,083,443738,34392,34275,1114,35389,459
2021-05-17,Santa Clara,085,1922200,118389,119116,740,119856,2015
2021-05-17,Santa Cruz,087,273765,16205,16151,795,16946,206
2021-05-17,Shasta,089,179085,12184,12163,1540,13703,200
2021-05-17,Sierra,091,2930,56,54,12,66,0
2021-05-17,Siskiyou,093,43540,1900,1795,340,2135,15
2021-05-17,Solano,095,438530,32664,32627,545,33172,253
2021-05-17,Sonoma,097,501317,29921,30043,324,30367,321
2021-05-17,Stanislaus,099,539301,56104,55839,5850,61689,951
2021-05-17,Sutter,101,95872,9409,9447,83,9530,113
2021-05-17,Tehama,103,63373,5048,5016,554,5570,63
2021-05-17,Trinity,105,12862,483,328,87,415,3
2021-05-17,Tulare,107,460477,50136,49107,8836,57943,836
2021-05-17,Tuolumne,109,53932,4020,4071,41,4112,64
2021-05-17,Ventura,111,848112,81253,80699,2939,83638,1017
2021-05-17,Yolo,113,214977,13979,13941,225,14166,211
2021-05-17,Yuba,115,75493,6014,5987,122,6109,49
2021-05-16,Alameda,001,1643700,87742,87743,1901,89644,1253
2021-05-16,Alpine,003,1148,87,88,0,88,0
2021-05-16,Amador,005,37829,3657,3667,32,3699,46
2021-05-16,Butte,007,227075,12454,12140,1790,13930,192
2021-05-16,Calaveras,009,45235,2135,2129,13,2142,53
2021-05-16,Colusa,011,21464,1938,1943,303,2246,14
2021-05-16,Contra Costa,013,1133247,69174,68694,1243,69937,805
2021-05-16,Del Norte,015,27424,1399,1365,12,1377,8
2021-05-16,El Dorado,017,186661,10229,10159,733,10892,112
2021-05-16,Fresno,019,978130,102432,101987,8564,110551,1690
2021-05-16,Glenn,021,27897,2423,2401,552,2953,17
2021-05-16,Humboldt,023,135768,4152,4104,34,4138,42
2021-05-16,Imperial,025,180216,28552,28516,2676,31192,729
2021-05-16,Inyo,027,18085,1404,1401,12,1413,36
2021-05-16,Kern,029,883053,97084,96083,10698,106781,1315
2021-05-16,Kings,031,150075,23120,22918,1063,23981,246
2021-05-16,Lake,033,64148,3504,3489,9,3498,43
2021-05-16,Lassen,035,31185,5193,5156,108,5264,6
2021-05-16,Los Angeles,037,10098052,1205324,1196397,40766,1237163,24120
2021-05-16,Madera,039,155013,16579,16483,918,17401,238
2021-05-16,Marin,041,260295,14066,14015,246,14261,227
2021-05-16,Mariposa,043,17540,428,423,11,434,5
2021-05-16,Mendocino,045,87422,3939,3863,80,3943,46
2021-05-16,Merced,047,269075,30880,31023,1025,32048,450
2021-05-16,Modoc,049,8938,371,362,125,487,3
2021-05-16,Mono,051,14174,1254,1265,16,1281,3
2021-05-16,Monterey,053,433212,43115,42991,1832,44823,379
2021-05-16,Napa,055,140530,9888,9891,34,9925,82
2021-05-16,Nevada,057,99092,4784,4755,186,4941,70
2021-05-16,Orange,059,3164182,255037,253962,11186,265148,5031
2021-05-16,Placer,061,380077,23121,22696,1465,24161,289
2021-05-16,Plumas,063,18699,699,682,10,692,4
2021-05-16,Riverside,065,2383286,293671,288259,13805,302064,4433
2021-05-16,Sacramento,067,1510023,105302,105013,1709,106722,1628
2021-05-16,San Benito,069,59416,6046,6067,111,6178,63
2021-05-16,San Bernardino,071,2135413,292891,291940,8891,300831,4724
2021-05-16,San Diego,073,3302833,279941,279099,14839,293938,3742
2021-05-16,San Francisco,075,870044,36581,36808,1256,38064,546
2021-05-16,San Joaquin,077,732212,72805,72218,3461,75679,1359
2021-05-16,San Luis Obispo,079,281455,21304,21072,720,21792,256
2021-05-16,San Mateo,081,765935,42201,42063,462,42525,428
2021-05-16,Santa Barbara,083,443738,34385,34270,1114,35384,459
2021-05-16,Santa Clara,085,1922200,118360,119098,739,119837,2015
2021-05-16,Santa Cruz,087,273765,16203,16143,795,16938,206
2021-05-16,Shasta,089,179085,12168,12156,1536,13692,200
2021-05-16,Sierra,091,2930,56,54,12,66,0
2021-05-16,Siskiyou,093,43540,1896,1790,339,2129,15
2021-05-16,Solano,095,438530,32631,32619,543,33162,253
2021-05-16,Sonoma,097,501317,29902,30033,324,30357,321
2021-05-16,Stanislaus,099,539301,56054,55814,5839,61653,951
2021-05-16,Sutter,101,95872,9402,9445,83,9528,113
2021-05-16,Tehama,103,63373,5044,5013,553,5566,63
2021-05-16,Trinity,105,12862,483,328,87,415,3
2021-05-16,Tulare,107,460477,50119,49091,8833,57924,837
2021-05-16,Tuolumne,109,53932,4016,4070,41,4111,64
2021-05-16,Ventura,111,848112,81222,80689,2939,83628,1017
2021-05-16,Yolo,113,214977,13964,13938,225,14163,211
2021-05-16,Yuba,115,75493,6011,5987,122,6109,49
2021-05-15,Alameda,001,1643700,87716,87677,1900,89577,1252
2021-05-15,Alpine,003,1148,87,88,0,88,0
2021-05-15,Amador,005,37829,3657,3666,32,3698,46
2021-05-15,Butte,007,227075,12447,12095,1789,13884,192
2021-05-15,Calaveras,009,45235,2134,2126,13,2139,53
2021-05-15,Colusa,011,21464,1938,1941,301,2242,14
2021-05-15,Contra Costa,013,1133247,69128,68658,1243,69901,805
2021-05-15,Del Norte,015,27424,1394,1359,12,1371,8
2021-05-15,El Dorado,017,186661,10217,10156,732,10888,112
2021-05-15,Fresno,019,978130,102395,101957,8562,110519,1690
2021-05-15,Glenn,021,27897,2423,2400,552,2952,17
2021-05-15,Humboldt,023,135768,4142,4080,34,4114,42
2021-05-15,Imperial,025,180216,28549,28504,2675,31179,729
2021-05-15,Inyo,027,18085,1404,1402,12,1414,36
2021-05-15,Kern,029,883053,97070,96061,10684,106745,1315
2021-05-15,Kings,031,150075,23119,22913,1063,23976,246
2021-05-15,Lake,033,64148,3503,3485,9,3494,43
2021-05-15,Lassen,035,31185,5190,5156,107,5263,6
2021-05-15,Los Angeles,037,10098052,1205201,1196255,40753,1237008,24115
2021-05-15,Madera,039,155013,16576,16482,918,17400,238
2021-05-15,Marin,041,260295,14062,14012,246,14258,227
2021-05-15,Mariposa,043,17540,428,423,11,434,5
2021-05-15,Mendocino,045,87422,3936,3861,80,3941,46
2021-05-15,Merced,047,269075,30859,31012,1025,32037,450
2021-05-15,Modoc,049,8938,371,362,125,487,3
2021-05-15,Mono,051,14174,1254,1265,16,1281,3
2021-05-15,Monterey,053,433212,43111,42982,1832,44814,379
2021-05-15,Napa,055,140530,9885,9887,34,9921,82
2021-05-15,Nevada,057,99092,4783,4755,186,4941,70
2021-05-15,Orange,059,3164182,255010,253919,11179,265098,5030
2021-05-15,Placer,061,380077,23100,22688,1465,24153,289
2021-05-15,Plumas,063,18699,699,681,10,691,4
2021-05-15,Riverside,065,2383286,293629,288203,13800,302003,4433
2021-05-15,Sacramento,067,1510023,105230,104929,1706,106635,1628
2021-05-15,San Benito,069,59416,6046,6066,111,6177,63
2021-05-15,San Bernardino,071,2135413,292849,291892,8889,300781,4724
2021-05-15,San Diego,073,3302833,279870,278991,14824,293815,3737
2021-05-15,San Francisco,075,870044,36565,36795,1254,38049,546
2021-05-15,San Joaquin,077,732212,72779,72197,3459,75656,1359
2021-05-15,San Luis Obispo,079,281455,21301,21061,719,21780,256
2021-05-15,San Mateo,081,765935,42185,42059,462,42521,428
2021-05-15,Santa Barbara,083,443738,34377,34259,1114,35373,459
2021-05-15,Santa Clara,085,1922200,118339,119060,739,119799,2016
2021-05-15,Santa Cruz,087,273765,16199,16137,795,16932,206
2021-05-15,Shasta,089,179085,12156,12152,1533,13685,200
2021-05-15,Sierra,091,2930,56,54,12,66,0
2021-05-15,Siskiyou,093,43540,1890,1788,337,2125,15
2021-05-15,Solano,095,438530,32622,32604,542,33146,253
2021-05-15,Sonoma,097,501317,29883,30020,324,30344,321
2021-05-15,Stanislaus,099,539301,56023,55795,5832,61627,952
2021-05-15,Sutter,101,95872,9400,9436,83,9519,113
2021-05-15,Tehama,103,63373,5040,5012,552,5564,63
2021-05-15,Trinity,105,12862,483,328,87,415,3
2021-05-15,Tulare,107,460477,50109,49080,8829,57909,837
2021-05-15,Tuolumne,109,53932,4014,4064,41,4105,63
2021-05-15,Ventura,111,848112,81211,80662,2939,83601,1017
2021-05-15,Yolo,113,214977,13957,13932,224,14156,211
2021-05-15,Yuba,115,75493,6008,5979,121,6100,49
2021-05-14,Alameda,001,1643700,87682,87621,1898,89519,1249
2021-05-14,Alpine,003,1148,87,88,0,88,0
2021-05-14,Amador,005,37829,3657,3665,32,3697,46
2021-05-14,Butte,007,227075,12438,12076,1786,13862,192
2021-05-14,Calaveras,009,45235,2130,2121,13,2134,53
2021-05-14,Colusa,011,21464,1937,1940,300,2240,14
2021-05-14,Contra Costa,013,1133247,69086,68589,1241,69830,806
2021-05-14,Del Norte,015,27424,1394,1355,12,1367,8
2021-05-14,El Dorado,017,186661,10210,10143,731,10874,113
2021-05-14,Fresno,019,978130,102366,101917,8556,110473,1688
2021-05-14,Glenn,021,27897,2422,2398,552,2950,17
2021-05-14,Humboldt,023,135768,4135,4050,34,4084,37
2021-05-14,Imperial,025,180216,28542,28485,2674,31159,728
2021-05-14,Inyo,027,18085,1404,1400,12,1412,36
2021-05-14,Kern,029,883053,97040,96033,10675,106708,1311
2021-05-14,Kings,031,150075,23118,22910,1063,23973,246
2021-05-14,Lake,033,64148,3499,3483,9,3492,43
2021-05-14,Lassen,035,31185,5190,5154,107,5261,6
2021-05-14,Los Angeles,037,10098052,1205066,1196038,40748,1236786,24101
2021-05-14,Madera,039,155013,16573,16474,918,17392,238
2021-05-14,Marin,041,260295,14058,14010,246,14256,227
2021-05-14,Mariposa,043,17540,428,422,11,433,5
2021-05-14,Mendocino,045,87422,3934,3855,80,3935,46
2021-05-14,Merced,047,269075,30849,31010,1025,32035,450
2021-05-14,Modoc,049,8938,371,362,125,487,3
2021-05-14,Mono,051,14174,1253,1265,16,1281,3
2021-05-14,Monterey,053,433212,43106,42973,1832,44805,380
2021-05-14,Napa,055,140530,9882,9883,34,9917,82
2021-05-14,Nevada,057,99092,4778,4745,186,4931,70
2021-05-14,Orange,059,3164182,254976,253855,11172,265027,5028
2021-05-14,Placer,061,380077,23081,22660,1459,24119,287
2021-05-14,Plumas,063,18699,698,680,10,690,4
2021-05-14,Riverside,065,2383286,293579,288140,13797,301937,4433
2021-05-14,Sacramento,067,1510023,105141,104828,1705,106533,1627
2021-05-14,San Benito,069,59416,6046,6064,111,6175,63
2021-05-14,San Bernardino,071,2135413,292801,291834,8889,300723,4721
2021-05-14,San Diego,073,3302833,279797,278853,14813,293666,3732
2021-05-14,San Francisco,075,870044,36556,36771,1250,38021,545
2021-05-14,San Joaquin,077,732212,72747,72160,3452,75612,1359
2021-05-14,San Luis Obispo,079,281455,21297,21051,719,21770,256
2021-05-14,San Mateo,081,765935,42175,42041,462,42503,428
2021-05-14,Santa Barbara,083,443738,34367,34243,1114,35357,456
2021-05-14,Santa Clara,085,1922200,118310,119006,739,119745,2014
2021-05-14,Santa Cruz,087,273765,16194,16130,795,16925,207
2021-05-14,Shasta,089,179085,12150,12130,1528,13658,200
2021-05-14,Sierra,091,2930,56,54,12,66,0
2021-05-14,Siskiyou,093,43540,1883,1779,336,2115,14
2021-05-14,Solano,095,438530,32602,32585,541,33126,252
2021-05-14,Sonoma,097,501317,29864,30007,324,30331,321
2021-05-14,Stanislaus,099,539301,55990,55752,5826,61578,950
2021-05-14,Sutter,101,95872,9391,9433,81,9514,113
2021-05-14,Tehama,103,63373,5033,5005,552,5557,63
2021-05-14,Trinity,105,12862,483,328,87,415,3
2021-05-14,Tulare,107,460477,50092,49060,8824,57884,836
2021-05-14,Tuolumne,109,53932,4014,4060,41,4101,63
2021-05-14,Ventura,111,848112,81197,80628,2939,83567,1014
2021-05-14,Yolo,113,214977,13952,13922,220,14142,210
2021-05-14,Yuba,115,75493,6004,5970,121,6091,47
2021-05-13,Alameda,001,1643700,87639,87557,1897,89454,1250
2021-05-13,Alpine,003,1148,87,88,0,88,0
2021-05-13,Amador,005,37829,3657,3662,32,3694,46
2021-05-13,Butte,007,227075,12423,12051,1785,13836,196
2021-05-13,Calaveras,009,45235,2128,2120,13,2133,53
2021-05-13,Colusa,011,21464,1936,1939,296,2235,14
2021-05-13,Contra Costa,013,1133247,69038,68522,1240,69762,806
2021-05-13,Del Norte,015,27424,1392,1354,12,1366,8
2021-05-13,El Dorado,017,186661,10207,10133,731,10864,112
2021-05-13,Fresno,019,978130,102337,101862,8555,110417,1687
2021-05-13,Glenn,021,27897,2421,2395,552,2947,17
2021-05-13,Humboldt,023,135768,4117,4027,34,4061,37
2021-05-13,Imperial,025,180216,28527,28468,2672,31140,729
2021-05-13,Inyo,027,18085,1404,1400,12,1412,36
2021-05-13,Kern,029,883053,97016,95996,10657,106653,1311
2021-05-13,Kings,031,150075,23117,22904,1063,23967,246
2021-05-13,Lake,033,64148,3498,3479,9,3488,43
2021-05-13,Lassen,035,31185,5190,5152,106,5258,6
2021-05-13,Los Angeles,037,10098052,1204877,1195504,40734,1236238,24083
2021-05-13,Madera,039,155013,16565,16467,918,17385,238
2021-05-13,Marin,041,260295,14053,14004,244,14248,227
2021-05-13,Mariposa,043,17540,428,422,11,433,5
2021-05-13,Mendocino,045,87422,3930,3846,80,3926,46
2021-05-13,Merced,047,269075,30842,30989,1024,32013,450
2021-05-13,Modoc,049,8938,371,362,125,487,3
2021-05-13,Mono,051,14174,1253,1265,16,1281,3
2021-05-13,Monterey,053,433212,43091,42966,1832,44798,380
2021-05-13,Napa,055,140530,9875,9877,34,9911,82
2021-05-13,Nevada,057,99092,4774,4743,185,4928,70
2021-05-13,Orange,059,3164182,254931,253778,11170,264948,5026
2021-05-13,Placer,061,380077,23054,22668,1452,24120,288
2021-05-13,Plumas,063,18699,698,680,10,690,4
2021-05-13,Riverside,065,2383286,293513,288067,13792,301859,4433
2021-05-13,Sacramento,067,1510023,105055,104711,1703,106414,1626
2021-05-13,San Benito,069,59416,6044,6062,111,6173,63
2021-05-13,San Bernardino,071,2135413,292735,291765,8889,300654,4722
2021-05-13,San Diego,073,3302833,279683,278592,14796,293388,3729
2021-05-13,San Francisco,075,870044,36532,36741,1248,37989,544
2021-05-13,San Joaquin,077,732212,72705,72096,3448,75544,1357
2021-05-13,San Luis Obispo,079,281455,21282,21043,718,21761,255
2021-05-13,San Mateo,081,765935,42158,42059,462,42521,426
2021-05-13,Santa Barbara,083,443738,34355,34242,1114,35356,456
2021-05-13,Santa Clara,085,1922200,118283,118952,739,119691,2013
2021-05-13,Santa Cruz,087,273765,16188,16129,795,16924,208
2021-05-13,Shasta,089,179085,12130,12111,1524,13635,200
2021-05-13,Sierra,091,2930,56,54,12,66,0
2021-05-13,Siskiyou,093,43540,1876,1769,333,2102,14
2021-05-13,Solano,095,438530,32589,32548,539,33087,252
2021-05-13,Sonoma,097,501317,29839,29991,324,30315,321
2021-05-13,Stanislaus,099,539301,55953,55678,5820,61498,949
2021-05-13,Sutter,101,95872,9386,9431,80,9511,112
2021-05-13,Tehama,103,63373,5028,4997,552,5549,63
2021-05-13,Trinity,105,12862,482,327,86,413,3
2021-05-13,Tulare,107,460477,50066,49032,8816,57848,837
2021-05-13,Tuolumne,109,53932,4013,4059,41,4100,63
2021-05-13,Ventura,111,848112,81167,80615,2938,83553,1012
2021-05-13,Yolo,113,214977,13943,13914,218,14132,210
2021-05-13,Yuba,115,75493,5995,5962,121,6083,47
2021-05-12,Alameda,001,1643700,87607,87482,1895,89377,1261
2021-05-12,Alpine,003,1148,87,88,0,88,0
2021-05-12,Amador,005,37829,3657,3658,32,3690,46
2021-05-12,Butte,007,227075,12413,12026,1785,13811,199
2021-05-12,Calaveras,009,45235,2125,2119,13,2132,53
2021-05-12,Colusa,011,21464,1934,1939,295,2234,14
2021-05-12,Contra Costa,013,1133247,68979,68462,1234,69696,805
2021-05-12,Del Norte,015,27424,1390,1352,12,1364,8
2021-05-12,El Dorado,017,186661,10197,10123,731,10854,112
2021-05-12,Fresno,019,978130,102288,101838,8544,110382,1688
2021-05-12,Glenn,021,27897,2418,2391,552,2943,17
2021-05-12,Humboldt,023,135768,4089,3982,34,4016,37
2021-05-12,Imperial,025,180216,28509,28443,2669,31112,726
2021-05-12,Inyo,027,18085,1404,1400,12,1412,36
2021-05-12,Kern,029,883053,96980,95955,10650,106605,1310
2021-05-12,Kings,031,150075,23115,22896,1063,23959,246
2021-05-12,Lake,033,64148,3496,3476,9,3485,43
2021-05-12,Lassen,035,31185,5188,5151,106,5257,6
2021-05-12,Los Angeles,037,10098052,1204694,1195318,40717,1236035,24067
2021-05-12,Madera,039,155013,16558,16462,917,17379,238
2021-05-12,Marin,041,260295,14048,13997,244,14241,227
2021-05-12,Mariposa,043,17540,428,422,11,433,5
2021-05-12,Mendocino,045,87422,3920,3836,80,3916,46
2021-05-12,Merced,047,269075,30826,30941,1024,31965,450
2021-05-12,Modoc,049,8938,370,362,125,487,3
2021-05-12,Mono,051,14174,1253,1265,16,1281,3
2021-05-12,Monterey,053,433212,43079,42950,1831,44781,380
2021-05-12,Napa,055,140530,9869,9870,34,9904,82
2021-05-12,Nevada,057,99092,4770,4738,185,4923,70
2021-05-12,Orange,059,3164182,254880,253587,11166,264753,5024
2021-05-12,Placer,061,380077,23036,22652,1445,24097,288
2021-05-12,Plumas,063,18699,698,681,10,691,4
2021-05-12,Riverside,065,2383286,293443,287830,13788,301618,4431
2021-05-12,Sacramento,067,1510023,104960,104592,1701,106293,1621
2021-05-12,San Benito,069,59416,6044,6062,111,6173,63
2021-05-12,San Bernardino,071,2135413,292686,291505,8884,300389,4715
2021-05-12,San Diego,073,3302833,279579,278402,14775,293177,3729
2021-05-12,San Francisco,075,870044,36512,36720,1247,37967,544
2021-05-12,San Joaquin,077,732212,72651,72043,3444,75487,1356
2021-05-12,San Luis Obispo,079,281455,21272,21021,718,21739,255
2021-05-12,San Mateo,081,765935,42149,42038,461,42499,426
2021-05-12,Santa Barbara,083,443738,34347,34218,1114,35332,456
2021-05-12,Santa Clara,085,1922200,118239,118897,739,119636,2005
2021-05-12,Santa Cruz,087,273765,16182,16123,795,16918,207
2021-05-12,Shasta,089,179085,12110,12092,1522,13614,200
2021-05-12,Sierra,091,2930,56,54,12,66,0
2021-05-12,Siskiyou,093,43540,1872,1760,332,2092,13
2021-05-12,Solano,095,438530,32565,32519,539,33058,252
2021-05-12,Sonoma,097,501317,29827,29976,324,30300,320
2021-05-12,Stanislaus,099,539301,55913,55632,5813,61445,919
2021-05-12,Sutter,101,95872,9383,9427,80,9507,112
2021-05-12,Tehama,103,63373,5023,4989,552,5541,62
2021-05-12,Trinity,105,12862,482,327,86,413,3
2021-05-12,Tulare,107,460477,50050,49001,8808,57809,838
2021-05-12,Tuolumne,109,53932,4012,4056,41,4097,63
2021-05-12,Ventura,111,848112,81148,80577,2938,83515,1010
2021-05-12,Yolo,113,214977,13935,13910,217,14127,210
2021-05-12,Yuba,115,75493,5992,5956,121,6077,47
2021-05-11,Alameda,001,1643700,87541,87413,1891,89304,1290
2021-05-11,Alpine,003,1148,87,88,0,88,0
2021-05-11,Amador,005,37829,3655,3657,32,3689,46
2021-05-11,Butte,007,227075,12398,12008,1782,13790,199
2021-05-11,Calaveras,009,45235,2125,2118,13,2131,52
2021-05-11,Colusa,011,21464,1933,1939,295,2234,14
2021-05-11,Contra Costa,013,1133247,68919,68406,1233,69639,806
2021-05-11,Del Norte,015,27424,1388,1347,12,1359,8
2021-05-11,El Dorado,017,186661,10191,10108,730,10838,112
2021-05-11,Fresno,019,978130,102242,101792,8539,110331,1686
2021-05-11,Glenn,021,27897,2417,2387,551,2938,17
2021-05-11,Humboldt,023,135768,4068,3964,33,3997,37
2021-05-11,Imperial,025,180216,28501,28413,2665,31078,722
2021-05-11,Inyo,027,18085,1403,1402,12,1414,36
2021-05-11,Kern,029,883053,96952,95938,10637,106575,1310
2021-05-11,Kings,031,150075,23107,22887,1063,23950,246
2021-05-11,Lake,033,64148,3496,3473,9,3482,43
2021-05-11,Lassen,035,31185,5186,5148,106,5254,6
2021-05-11,Los Angeles,037,10098052,1204457,1195100,40700,1235800,24048
2021-05-11,Madera,039,155013,16554,16459,916,17375,238
2021-05-11,Marin,041,260295,14041,13987,244,14231,227
2021-05-11,Mariposa,043,17540,428,421,11,432,5
2021-05-11,Mendocino,045,87422,3912,3821,80,3901,46
2021-05-11,Merced,047,269075,30817,30893,1024,31917,449
2021-05-11,Modoc,049,8938,370,362,124,486,3
2021-05-11,Mono,051,14174,1253,1265,16,1281,3
2021-05-11,Monterey,053,433212,43071,42934,1830,44764,380
2021-05-11,Napa,055,140530,9862,9870,34,9904,81
2021-05-11,Nevada,057,99092,4766,4737,185,4922,70
2021-05-11,Orange,059,3164182,254817,253545,11159,264704,5017
2021-05-11,Placer,061,380077,23014,22615,1441,24056,287
2021-05-11,Plumas,063,18699,696,679,10,689,4
2021-05-11,Riverside,065,2383286,293381,287757,13783,301540,4429
2021-05-11,Sacramento,067,1510023,104861,104496,1698,106194,1616
2021-05-11,San Benito,069,59416,6041,6058,111,6169,63
2021-05-11,San Bernardino,071,2135413,292626,291421,8882,300303,4707
2021-05-11,San Diego,073,3302833,279444,278308,14756,293064,3725
2021-05-11,San Francisco,075,870044,36492,36707,1247,37954,543
2021-05-11,San Joaquin,077,732212,72603,71999,3441,75440,1356
2021-05-11,San Luis Obispo,079,281455,21265,21008,716,21724,255
2021-05-11,San Mateo,081,765935,42130,41985,460,42445,425
2021-05-11,Santa Barbara,083,443738,34337,34207,1114,35321,456
2021-05-11,Santa Clara,085,1922200,118192,118857,738,119595,2005
2021-05-11,Santa Cruz,087,273765,16178,16113,795,16908,206
2021-05-11,Shasta,089,179085,12087,12050,1516,13566,200
2021-05-11,Sierra,091,2930,56,54,12,66,0
2021-05-11,Siskiyou,093,43540,1862,1756,330,2086,13
2021-05-11,Solano,095,438530,32547,32499,537,33036,250
2021-05-11,Sonoma,097,501317,29812,29966,324,30290,318
2021-05-11,Stanislaus,099,539301,55866,55589,5809,61398,909
2021-05-11,Sutter,101,95872,9376,9417,80,9497,112
2021-05-11,Tehama,103,63373,5019,4985,551,5536,62
2021-05-11,Trinity,105,12862,482,327,85,412,3
2021-05-11,Tulare,107,460477,50023,48974,8794,57768,837
2021-05-11,Tuolumne,109,53932,4011,4056,41,4097,63
2021-05-11,Ventura,111,848112,81124,80544,2935,83479,1008
2021-05-11,Yolo,113,214977,13922,13902,214,14116,210
2021-05-11,Yuba,115,75493,5983,5950,121,6071,46
2021-05-10,Alameda,001,1643700,87470,87366,1890,89256,1284
2021-05-10,Alpine,003,1148,87,88,0,88,0
2021-05-10,Amador,005,37829,3654,3657,32,3689,46
2021-05-10,Butte,007,227075,12382,11993,1778,13771,199
2021-05-10,Calaveras,009,45235,2118,2118,13,2131,52
2021-05-10,Colusa,011,21464,1933,1939,295,2234,14
2021-05-10,Contra Costa,013,1133247,68855,68357,1233,69590,806
2021-05-10,Del Norte,015,27424,1385,1339,12,1351,8
2021-05-10,El Dorado,017,186661,10177,10093,730,10823,113
2021-05-10,Fresno,019,978130,102210,101755,8532,110287,1682
2021-05-10,Glenn,021,27897,2416,2384,550,2934,17
2021-05-10,Humboldt,023,135768,4038,3961,33,3994,36
2021-05-10,Imperial,025,180216,28487,28397,2661,31058,722
2021-05-10,Inyo,027,18085,1403,1401,12,1413,36
2021-05-10,Kern,029,883053,96909,95920,10623,106543,1310
2021-05-10,Kings,031,150075,23096,22884,1062,23946,246
2021-05-10,Lake,033,64148,3488,3471,9,3480,43
2021-05-10,Lassen,035,31185,5182,5148,106,5254,5
2021-05-10,Los Angeles,037,10098052,1204190,1194976,40685,1235661,24030
2021-05-10,Madera,039,155013,16544,16450,916,17366,238
2021-05-10,Marin,041,260295,14038,13981,244,14225,228
2021-05-10,Mariposa,043,17540,427,420,11,431,5
2021-05-10,Mendocino,045,87422,3906,3818,80,3898,46
2021-05-10,Merced,047,269075,30807,30880,1024,31904,448
2021-05-10,Modoc,049,8938,370,361,124,485,3
2021-05-10,Mono,051,14174,1253,1265,16,1281,3
2021-05-10,Monterey,053,433212,43065,42927,1825,44752,380
2021-05-10,Napa,055,140530,9860,9860,34,9894,81
2021-05-10,Nevada,057,99092,4759,4735,185,4920,70
2021-05-10,Orange,059,3164182,254764,253484,11153,264637,5008
2021-05-10,Placer,061,380077,22992,22590,1438,24028,286
2021-05-10,Plumas,063,18699,695,679,10,689,4
2021-05-10,Riverside,065,2383286,293312,287689,13777,301466,4427
2021-05-10,Sacramento,067,1510023,104748,104378,1693,106071,1613
2021-05-10,San Benito,069,59416,6040,6058,111,6169,63
2021-05-10,San Bernardino,071,2135413,292575,291360,8881,300241,4707
2021-05-10,San Diego,073,3302833,279280,278183,14729,292912,3725
2021-05-10,San Francisco,075,870044,36473,36683,1247,37930,543
2021-05-10,San Joaquin,077,732212,72567,71954,3427,75381,1356
2021-05-10,San Luis Obispo,079,281455,21247,20993,715,21708,256
2021-05-10,San Mateo,081,765935,42113,41926,460,42386,424
2021-05-10,Santa Barbara,083,443738,34329,34201,1114,35315,456
2021-05-10,Santa Clara,085,1922200,118133,118822,738,119560,2003
2021-05-10,Santa Cruz,087,273765,16173,16114,795,16909,206
2021-05-10,Shasta,089,179085,12073,12036,1512,13548,200
2021-05-10,Sierra,091,2930,56,54,12,66,0
2021-05-10,Siskiyou,093,43540,1852,1752,328,2080,13
2021-05-10,Solano,095,438530,32527,32466,535,33001,250
2021-05-10,Sonoma,097,501317,29797,29955,323,30278,318
2021-05-10,Stanislaus,099,539301,55791,55541,5803,61344,898
2021-05-10,Sutter,101,95872,9370,9412,80,9492,111
2021-05-10,Tehama,103,63373,5015,4980,551,5531,62
2021-05-10,Trinity,105,12862,482,327,83,410,3
2021-05-10,Tulare,107,460477,50000,48956,8788,57744,837
2021-05-10,Tuolumne,109,53932,4007,4054,40,4094,63
2021-05-10,Ventura,111,848112,81108,80501,2934,83435,1008
2021-05-10,Yolo,113,214977,13910,13898,212,14110,209
2021-05-10,Yuba,115,75493,5981,5942,121,6063,46
2021-05-09,Alameda,001,1643700,87400,87292,1887,89179,1284
2021-05-09,Alpine,003,1148,87,88,0,88,0
2021-05-09,Amador,005,37829,3652,3655,32,3687,46
2021-05-09,Butte,007,227075,12364,11985,1774,13759,199
2021-05-09,Calaveras,009,45235,2117,2116,13,2129,52
2021-05-09,Colusa,011,21464,1932,1940,295,2235,14
2021-05-09,Contra Costa,013,1133247,68792,68302,1231,69533,806
2021-05-09,Del Norte,015,27424,1378,1338,12,1350,8
2021-05-09,El Dorado,017,186661,10163,10089,726,10815,113
2021-05-09,Fresno,019,978130,102172,101729,8523,110252,1682
2021-05-09,Glenn,021,27897,2409,2382,547,2929,17
2021-05-09,Humboldt,023,135768,4018,3950,33,3983,36
2021-05-09,Imperial,025,180216,28464,28388,2653,31041,722
2021-05-09,Inyo,027,18085,1403,1401,11,1412,36
2021-05-09,Kern,029,883053,96881,95903,10613,106516,1310
2021-05-09,Kings,031,150075,23087,22878,1062,23940,246
2021-05-09,Lake,033,64148,3484,3471,9,3480,43
2021-05-09,Lassen,035,31185,5180,5147,106,5253,5
2021-05-09,Los Angeles,037,10098052,1203932,1194820,40670,1235490,24026
2021-05-09,Madera,039,155013,16535,16444,910,17354,238
2021-05-09,Marin,041,260295,14027,13979,243,14222,228
2021-05-09,Mariposa,043,17540,424,420,11,431,5
2021-05-09,Mendocino,045,87422,3896,3814,80,3894,46
2021-05-09,Merced,047,269075,30784,30883,1024,31907,448
2021-05-09,Modoc,049,8938,370,360,124,484,3
2021-05-09,Mono,051,14174,1253,1264,16,1280,3
2021-05-09,Monterey,053,433212,43047,42918,1825,44743,380
2021-05-09,Napa,055,140530,9849,9857,34,9891,81
2021-05-09,Nevada,057,99092,4752,4727,185,4912,70
2021-05-09,Orange,059,3164182,254710,253451,11145,264596,5008
2021-05-09,Placer,061,380077,22966,22566,1435,24001,286
2021-05-09,Plumas,063,18699,694,679,10,689,4
2021-05-09,Riverside,065,2383286,293232,287644,13771,301415,4427
2021-05-09,Sacramento,067,1510023,104599,104309,1687,105996,1612
2021-05-09,San Benito,069,59416,6038,6056,111,6167,63
2021-05-09,San Bernardino,071,2135413,292492,291337,8875,300212,4707
2021-05-09,San Diego,073,3302833,279113,277950,14707,292657,3725
2021-05-09,San Francisco,075,870044,36447,36669,1245,37914,543
2021-05-09,San Joaquin,077,732212,72521,71927,3426,75353,1356
2021-05-09,San Luis Obispo,079,281455,21236,20999,715,21714,256
2021-05-09,San Mateo,081,765935,42083,41903,460,42363,424
2021-05-09,Santa Barbara,083,443738,34316,34196,1113,35309,456
2021-05-09,Santa Clara,085,1922200,118079,118798,737,119535,2003
2021-05-09,Santa Cruz,087,273765,16167,16094,795,16889,206
2021-05-09,Shasta,089,179085,12043,12034,1507,13541,200
2021-05-09,Sierra,091,2930,56,54,12,66,0
2021-05-09,Siskiyou,093,43540,1845,1741,325,2066,13
2021-05-09,Solano,095,438530,32488,32434,533,32967,250
2021-05-09,Sonoma,097,501317,29783,29953,322,30275,318
2021-05-09,Stanislaus,099,539301,55725,55511,5799,61310,898
2021-05-09,Sutter,101,95872,9364,9413,80,9493,111
2021-05-09,Tehama,103,63373,5010,4979,551,5530,62
2021-05-09,Trinity,105,12862,482,327,83,410,3
2021-05-09,Tulare,107,460477,49973,48948,8783,57731,837
2021-05-09,Tuolumne,109,53932,4005,4053,40,4093,63
2021-05-09,Ventura,111,848112,81093,80487,2933,83420,1008
2021-05-09,Yolo,113,214977,13900,13897,211,14108,209
2021-05-09,Yuba,115,75493,5975,5934,121,6055,46
2021-05-08,Alameda,001,1643700,87358,87213,1883,89096,1284
2021-05-08,Alpine,003,1148,87,88,0,88,0
2021-05-08,Amador,005,37829,3650,3652,32,3684,46
2021-05-08,Butte,007,227075,12352,11962,1773,13735,199
2021-05-08,Calaveras,009,45235,2116,2114,13,2127,52
2021-05-08,Colusa,011,21464,1932,1939,295,2234,14
2021-05-08,Contra Costa,013,1133247,68759,68223,1229,69452,803
2021-05-08,Del Norte,015,27424,1375,1335,12,1347,8
2021-05-08,El Dorado,017,186661,10149,10079,726,10805,113
2021-05-08,Fresno,019,978130,102136,101676,8518,110194,1682
2021-05-08,Glenn,021,27897,2407,2382,545,2927,17
2021-05-08,Humboldt,023,135768,4002,3939,33,3972,36
2021-05-08,Imperial,025,180216,28456,28373,2653,31026,721
2021-05-08,Inyo,027,18085,1403,1402,11,1413,36
2021-05-08,Kern,029,883053,96856,95880,10600,106480,1310
2021-05-08,Kings,031,150075,23084,22872,1061,23933,246
2021-05-08,Lake,033,64148,3483,3470,9,3479,43
2021-05-08,Lassen,035,31185,5179,5145,106,5251,5
2021-05-08,Los Angeles,037,10098052,1203778,1194584,40654,1235238,24022
2021-05-08,Madera,039,155013,16531,16442,910,17352,238
2021-05-08,Marin,041,260295,14024,13974,242,14216,228
2021-05-08,Mariposa,043,17540,424,420,11,431,5
2021-05-08,Mendocino,045,87422,3891,3810,79,3889,46
2021-05-08,Merced,047,269075,30775,30876,1024,31900,448
2021-05-08,Modoc,049,8938,370,360,123,483,3
2021-05-08,Mono,051,14174,1253,1262,16,1278,3
2021-05-08,Monterey,053,433212,43042,42914,1824,44738,380
2021-05-08,Napa,055,140530,9842,9853,34,9887,81
2021-05-08,Nevada,057,99092,4749,4716,185,4901,70
2021-05-08,Orange,059,3164182,254676,253412,11141,264553,5006
2021-05-08,Placer,061,380077,22948,22547,1433,23980,286
2021-05-08,Plumas,063,18699,693,679,10,689,4
2021-05-08,Riverside,065,2383286,293189,287574,13769,301343,4427
2021-05-08,Sacramento,067,1510023,104514,104208,1684,105892,1610
2021-05-08,San Benito,069,59416,6037,6048,111,6159,63
2021-05-08,San Bernardino,071,2135413,292449,291296,8875,300171,4707
2021-05-08,San Diego,073,3302833,279030,277760,14689,292449,3725
2021-05-08,San Francisco,075,870044,36424,36642,1245,37887,543
2021-05-08,San Joaquin,077,732212,72492,71869,3417,75286,1356
2021-05-08,San Luis Obispo,079,281455,21225,20992,715,21707,256
2021-05-08,San Mateo,081,765935,42072,41871,460,42331,424
2021-05-08,Santa Barbara,083,443738,34303,34185,1113,35298,456
2021-05-08,Santa Clara,085,1922200,118048,118751,737,119488,2003
2021-05-08,Santa Cruz,087,273765,16164,16089,795,16884,206
2021-05-08,Shasta,089,179085,12033,12030,1503,13533,200
2021-05-08,Sierra,091,2930,56,54,12,66,0
2021-05-08,Siskiyou,093,43540,1844,1741,321,2062,13
2021-05-08,Solano,095,438530,32464,32395,531,32926,249
2021-05-08,Sonoma,097,501317,29770,29942,322,30264,318
2021-05-08,Stanislaus,099,539301,55694,55467,5795,61262,898
2021-05-08,Sutter,101,95872,9361,9413,80,9493,111
2021-05-08,Tehama,103,63373,5008,4977,551,5528,62
2021-05-08,Trinity,105,12862,482,327,83,410,3
2021-05-08,Tulare,107,460477,49959,48929,8773,57702,837
2021-05-08,Tuolumne,109,53932,4004,4050,40,4090,63
2021-05-08,Ventura,111,848112,81082,80481,2930,83411,1008
2021-05-08,Yolo,113,214977,13897,13894,210,14104,209
2021-05-08,Yuba,115,75493,5967,5928,121,6049,46
2021-05-07,Alameda,001,1643700,87305,87128,1883,89011,1280
2021-05-07,Alpine,003,1148,87,88,0,88,0
2021-05-07,Amador,005,37829,3647,3651,32,3683,46
2021-05-07,Butte,007,227075,12331,11943,1770,13713,199
2021-05-07,Calaveras,009,45235,2114,2114,13,2127,52
2021-05-07,Colusa,011,21464,1932,1937,295,2232,14
2021-05-07,Contra Costa,013,1133247,68712,68156,1227,69383,804
2021-05-07,Del Norte,015,27424,1370,1329,12,1341,8
2021-05-07,El Dorado,017,186661,10136,10065,724,10789,112
2021-05-07,Fresno,019,978130,102103,101625,8517,110142,1684
2021-05-07,Glenn,021,27897,2404,2381,544,2925,17
2021-05-07,Humboldt,023,135768,3987,3919,33,3952,36
2021-05-07,Imperial,025,180216,28448,28352,2653,31005,721
2021-05-07,Inyo,027,18085,1403,1402,11,1413,36
2021-05-07,Kern,029,883053,96843,95839,10588,106427,1308
2021-05-07,Kings,031,150075,23083,22857,1060,23917,246
2021-05-07,Lake,033,64148,3481,3467,9,3476,43
2021-05-07,Lassen,035,31185,5178,5144,105,5249,5
2021-05-07,Los Angeles,037,10098052,1203598,1194294,40647,1234941,24008
2021-05-07,Madera,039,155013,16526,16439,910,17349,238
2021-05-07,Marin,041,260295,14020,13968,242,14210,228
2021-05-07,Mariposa,043,17540,423,419,11,430,5
2021-05-07,Mendocino,045,87422,3885,3805,79,3884,46
2021-05-07,Merced,047,269075,30772,30862,1024,31886,446
2021-05-07,Modoc,049,8938,370,360,123,483,3
2021-05-07,Mono,051,14174,1252,1261,16,1277,3
2021-05-07,Monterey,053,433212,43036,42909,1822,44731,380
2021-05-07,Napa,055,140530,9841,9849,34,9883,81
2021-05-07,Nevada,057,99092,4745,4704,185,4889,70
2021-05-07,Orange,059,3164182,254636,253338,11133,264471,5000
2021-05-07,Placer,061,380077,22928,22524,1431,23955,286
2021-05-07,Plumas,063,18699,693,678,10,688,4
2021-05-07,Riverside,065,2383286,293131,287479,13768,301247,4426
2021-05-07,Sacramento,067,1510023,104442,104068,1679,105747,1609
2021-05-07,San Benito,069,59416,6036,6048,111,6159,63
2021-05-07,San Bernardino,071,2135413,292407,291185,8870,300055,4697
2021-05-07,San Diego,073,3302833,278944,277534,14673,292207,3718
2021-05-07,San Francisco,075,870044,36411,36616,1244,37860,543
2021-05-07,San Joaquin,077,732212,72452,71804,3415,75219,1351
2021-05-07,San Luis Obispo,079,281455,21218,20979,715,21694,256
2021-05-07,San Mateo,081,765935,42057,41844,460,42304,424
2021-05-07,Santa Barbara,083,443738,34293,34166,1113,35279,453
2021-05-07,Santa Clara,085,1922200,118015,118691,736,119427,2002
2021-05-07,Santa Cruz,087,273765,16161,16074,795,16869,206
2021-05-07,Shasta,089,179085,12011,12005,1501,13506,200
2021-05-07,Sierra,091,2930,56,54,12,66,0
2021-05-07,Siskiyou,093,43540,1841,1723,321,2044,13
2021-05-07,Solano,095,438530,32436,32352,529,32881,249
2021-05-07,Sonoma,097,501317,29752,29925,320,30245,318
2021-05-07,Stanislaus,099,539301,55653,55407,5790,61197,896
2021-05-07,Sutter,101,95872,9361,9407,80,9487,111
2021-05-07,Tehama,103,63373,5001,4974,551,5525,57
2021-05-07,Trinity,105,12862,482,327,83,410,3
2021-05-07,Tulare,107,460477,49942,48913,8768,57681,837
2021-05-07,Tuolumne,109,53932,4002,4048,40,4088,63
2021-05-07,Ventura,111,848112,81058,80444,2930,83374,1008
2021-05-07,Yolo,113,214977,13891,13875,209,14084,209
2021-05-07,Yuba,115,75493,5957,5910,121,6031,46
2021-05-06,Alameda,001,1643700,87229,87028,1880,88908,1278
2021-05-06,Alpine,003,1148,87,88,0,88,0
2021-05-06,Amador,005,37829,3645,3650,32,3682,46
2021-05-06,Butte,007,227075,12311,11929,1765,13694,198
2021-05-06,Calaveras,009,45235,2114,2111,13,2124,52
2021-05-06,Colusa,011,21464,1932,1935,295,2230,14
2021-05-06,Contra Costa,013,1133247,68657,68076,1224,69300,802
2021-05-06,Del Norte,015,27424,1362,1324,12,1336,6
2021-05-06,El Dorado,017,186661,10129,10048,724,10772,112
2021-05-06,Fresno,019,978130,102059,101536,8513,110049,1680
2021-05-06,Glenn,021,27897,2403,2380,543,2923,17
2021-05-06,Humboldt,023,135768,3962,3898,33,3931,36
2021-05-06,Imperial,025,180216,28437,28311,2652,30963,720
2021-05-06,Inyo,027,18085,1403,1401,11,1412,36
2021-05-06,Kern,029,883053,96818,95801,10571,106372,1307
2021-05-06,Kings,031,150075,23076,22848,1059,23907,246
2021-05-06,Lake,033,64148,3480,3465,9,3474,43
2021-05-06,Lassen,035,31185,5177,5143,105,5248,1
2021-05-06,Los Angeles,037,10098052,1203356,1193954,40631,1234585,23991
2021-05-06,Madera,039,155013,16518,16430,910,17340,238
2021-05-06,Marin,041,260295,14016,13956,242,14198,228
2021-05-06,Mariposa,043,17540,422,419,11,430,5
2021-05-06,Mendocino,045,87422,3874,3802,79,3881,46
2021-05-06,Merced,047,269075,30757,30863,1023,31886,444
2021-05-06,Modoc,049,8938,370,360,123,483,3
2021-05-06,Mono,051,14174,1250,1261,16,1277,3
2021-05-06,Monterey,053,433212,43021,42899,1822,44721,379
2021-05-06,Napa,055,140530,9835,9843,34,9877,81
2021-05-06,Nevada,057,99092,4744,4687,185,4872,70
2021-05-06,Orange,059,3164182,254568,253286,11127,264413,4991
2021-05-06,Placer,061,380077,22906,22493,1431,23924,286
2021-05-06,Plumas,063,18699,693,678,10,688,4
2021-05-06,Riverside,065,2383286,293058,287399,13763,301162,4422
2021-05-06,Sacramento,067,1510023,104326,103956,1676,105632,1609
2021-05-06,San Benito,069,59416,6035,6045,111,6156,63
2021-05-06,San Bernardino,071,2135413,292337,291085,8869,299954,4683
2021-05-06,San Diego,073,3302833,278817,277324,14650,291974,3716
2021-05-06,San Francisco,075,870044,36396,36599,1244,37843,543
2021-05-06,San Joaquin,077,732212,72397,71729,3412,75141,1350
2021-05-06,San Luis Obispo,079,281455,21206,20965,713,21678,256
2021-05-06,San Mateo,081,765935,42038,41802,459,42261,424
2021-05-06,Santa Barbara,083,443738,34280,34152,1113,35265,453
2021-05-06,Santa Clara,085,1922200,117974,118591,736,119327,2001
2021-05-06,Santa Cruz,087,273765,16154,16050,795,16845,206
2021-05-06,Shasta,089,179085,11989,11983,1495,13478,199
2021-05-06,Sierra,091,2930,56,54,12,66,0
2021-05-06,Siskiyou,093,43540,1831,1711,320,2031,12
2021-05-06,Solano,095,438530,32410,32320,521,32841,249
2021-05-06,Sonoma,097,501317,29744,29911,320,30231,318
2021-05-06,Stanislaus,099,539301,55597,55323,5785,61108,834
2021-05-06,Sutter,101,95872,9355,9396,80,9476,111
2021-05-06,Tehama,103,63373,4996,4970,551,5521,53
2021-05-06,Trinity,105,12862,482,327,83,410,3
2021-05-06,Tulare,107,460477,49917,48890,8753,57643,836
2021-05-06,Tuolumne,109,53932,3998,4047,40,4087,63
2021-05-06,Ventura,111,848112,81027,80411,2927,83338,1005
2021-05-06,Yolo,113,214977,13883,13871,206,14077,209
2021-05-06,Yuba,115,75493,5945,5901,121,6022,46
2021-05-05,Alameda,001,1643700,87167,86950,1878,88828,1278
2021-05-05,Alpine,003,1148,87,88,0,88,0
2021-05-05,Amador,005,37829,3642,3650,32,3682,46
2021-05-05,Butte,007,227075,12293,11907,1762,13669,198
2021-05-05,Calaveras,009,45235,2110,2103,13,2116,52
2021-05-05,Colusa,011,21464,1931,1933,295,2228,14
2021-05-05,Contra Costa,013,1133247,68592,67997,1220,69217,803
2021-05-05,Del Norte,015,27424,1359,1317,12,1329,6
2021-05-05,El Dorado,017,186661,10118,10020,723,10743,111
2021-05-05,Fresno,019,978130,102010,101491,8504,109995,1680
2021-05-05,Glenn,021,27897,2400,2380,542,2922,17
2021-05-05,Humboldt,023,135768,3943,3886,32,3918,36
2021-05-05,Imperial,025,180216,28396,28295,2645,30940,720
2021-05-05,Inyo,027,18085,1402,1401,11,1412,36
2021-05-05,Kern,029,883053,96774,95753,10567,106320,1304
2021-05-05,Kings,031,150075,23070,22840,1058,23898,246
2021-05-05,Lake,033,64148,3477,3458,9,3467,43
2021-05-05,Lassen,035,31185,5177,5143,104,5247,1
2021-05-05,Los Angeles,037,10098052,1203089,1193608,40617,1234225,23977
2021-05-05,Madera,039,155013,16516,16423,910,17333,235
2021-05-05,Marin,041,260295,14008,13950,241,14191,228
2021-05-05,Mariposa,043,17540,422,418,11,429,5
2021-05-05,Mendocino,045,87422,3870,3799,79,3878,46
2021-05-05,Merced,047,269075,30736,30844,1023,31867,444
2021-05-05,Modoc,049,8938,369,361,122,483,3
2021-05-05,Mono,051,14174,1250,1260,16,1276,3
2021-05-05,Monterey,053,433212,43008,42870,1819,44689,379
2021-05-05,Napa,055,140530,9829,9833,34,9867,81
2021-05-05,Nevada,057,99092,4741,4666,185,4851,70
2021-05-05,Orange,059,3164182,254510,253237,11122,264359,4978
2021-05-05,Placer,061,380077,22874,22362,1427,23789,287
2021-05-05,Plumas,063,18699,693,677,10,687,4
2021-05-05,Riverside,065,2383286,292963,287353,13754,301107,4414
2021-05-05,Sacramento,067,1510023,104238,103476,1671,105147,1607
2021-05-05,San Benito,069,59416,6026,6046,111,6157,63
2021-05-05,San Bernardino,071,2135413,292262,291008,8865,299873,4677
2021-05-05,San Diego,073,3302833,278680,277098,14631,291729,3716
2021-05-05,San Francisco,075,870044,36382,36577,1243,37820,543
2021-05-05,San Joaquin,077,732212,72344,71638,3409,75047,1345
2021-05-05,San Luis Obispo,079,281455,21198,20958,713,21671,256
2021-05-05,San Mateo,081,765935,42009,41755,458,42213,415
2021-05-05,Santa Barbara,083,443738,34265,34139,1112,35251,453
2021-05-05,Santa Clara,085,1922200,117944,118482,733,119215,1992
2021-05-05,Santa Cruz,087,273765,16148,16013,795,16808,207
2021-05-05,Shasta,089,179085,11973,11939,1491,13430,200
2021-05-05,Sierra,091,2930,56,54,12,66,0
2021-05-05,Siskiyou,093,43540,1814,1706,312,2018,11
2021-05-05,Solano,095,438530,32375,32250,519,32769,249
2021-05-05,Sonoma,097,501317,29731,29879,320,30199,318
2021-05-05,Stanislaus,099,539301,55540,55231,5783,61014,807
2021-05-05,Sutter,101,95872,9349,9387,80,9467,111
2021-05-05,Tehama,103,63373,4992,4968,551,5519,53
2021-05-05,Trinity,105,12862,482,326,83,409,3
2021-05-05,Tulare,107,460477,49893,48875,8746,57621,835
2021-05-05,Tuolumne,109,53932,3995,4040,40,4080,63
2021-05-05,Ventura,111,848112,80999,80372,2923,83295,1005
2021-05-05,Yolo,113,214977,13879,13846,204,14050,209
2021-05-05,Yuba,115,75493,5935,5895,120,6015,44
2021-05-04,Alameda,001,1643700,87075,86894,1878,88772,1277
2021-05-04,Alpine,003,1148,87,88,0,88,0
2021-05-04,Amador,005,37829,3642,3650,32,3682,46
2021-05-04,Butte,007,227075,12269,11883,1761,13644,198
2021-05-04,Calaveras,009,45235,2106,2100,13,2113,52
2021-05-04,Colusa,011,21464,1930,1933,295,2228,14
2021-05-04,Contra Costa,013,1133247,68512,67931,1218,69149,799
2021-05-04,Del Norte,015,27424,1359,1314,12,1326,6
2021-05-04,El Dorado,017,186661,10107,10009,719,10728,110
2021-05-04,Fresno,019,978130,101955,101451,8497,109948,1677
2021-05-04,Glenn,021,27897,2397,2379,539,2918,17
2021-05-04,Humboldt,023,135768,3917,3877,32,3909,36
2021-05-04,Imperial,025,180216,28376,28276,2642,30918,720
2021-05-04,Inyo,027,18085,1402,1399,11,1410,36
2021-05-04,Kern,029,883053,96738,95720,10549,106269,1301
2021-05-04,Kings,031,150075,23056,22822,1055,23877,246
2021-05-04,Lake,033,64148,3476,3454,9,3463,43
2021-05-04,Lassen,035,31185,5176,5142,104,5246,1
2021-05-04,Los Angeles,037,10098052,1202799,1193453,40604,1234057,23957
2021-05-04,Madera,039,155013,16515,16418,910,17328,235
2021-05-04,Marin,041,260295,14000,13935,241,14176,228
2021-05-04,Mariposa,043,17540,422,418,11,429,5
2021-05-04,Mendocino,045,87422,3865,3794,79,3873,46
2021-05-04,Merced,047,269075,30719,30829,1023,31852,444
2021-05-04,Modoc,049,8938,368,360,121,481,3
2021-05-04,Mono,051,14174,1250,1260,16,1276,3
2021-05-04,Monterey,053,433212,42996,42845,1818,44663,380
2021-05-04,Napa,055,140530,9820,9824,34,9858,81
2021-05-04,Nevada,057,99092,4734,4656,185,4841,70
2021-05-04,Orange,059,3164182,254442,253177,11114,264291,4977
2021-05-04,Placer,061,380077,22846,22326,1424,23750,287
2021-05-04,Plumas,063,18699,692,675,10,685,4
2021-05-04,Riverside,065,2383286,292879,287285,13747,301032,4411
2021-05-04,Sacramento,067,1510023,104109,103383,1666,105049,1604
2021-05-04,San Benito,069,59416,6025,6039,111,6150,63
2021-05-04,San Bernardino,071,2135413,292185,290934,8858,299792,4668
2021-05-04,San Diego,073,3302833,278513,276879,14614,291493,3713
2021-05-04,San Francisco,075,870044,36365,36550,1243,37793,541
2021-05-04,San Joaquin,077,732212,72283,71582,3404,74986,1342
2021-05-04,San Luis Obispo,079,281455,21192,20923,711,21634,255
2021-05-04,San Mateo,081,765935,41983,41708,458,42166,415
2021-05-04,Santa Barbara,083,443738,34250,34131,1111,35242,453
2021-05-04,Santa Clara,085,1922200,117881,118431,732,119163,1988
2021-05-04,Santa Cruz,087,273765,16142,16005,795,16800,207
2021-05-04,Shasta,089,179085,11953,11923,1485,13408,198
2021-05-04,Sierra,091,2930,56,54,12,66,0
2021-05-04,Siskiyou,093,43540,1807,1694,310,2004,11
2021-05-04,Solano,095,438530,32334,32220,517,32737,249
2021-05-04,Sonoma,097,501317,29711,29867,319,30186,318
2021-05-04,Stanislaus,099,539301,55484,55165,5780,60945,807
2021-05-04,Sutter,101,95872,9344,9375,80,9455,111
2021-05-04,Tehama,103,63373,4989,4959,550,5509,53
2021-05-04,Trinity,105,12862,482,326,83,409,3
2021-05-04,Tulare,107,460477,49866,48857,8738,57595,835
2021-05-04,Tuolumne,109,53932,3993,4041,40,4081,61
2021-05-04,Ventura,111,848112,80970,80351,2921,83272,1005
2021-05-04,Yolo,113,214977,13866,13820,202,14022,208
2021-05-04,Yuba,115,75493,5929,5891,120,6011,44
2021-05-03,Alameda,001,1643700,86999,86845,1873,88718,1272
2021-05-03,Alpine,003,1148,87,88,0,88,0
2021-05-03,Amador,005,37829,3642,3651,32,3683,46
2021-05-03,Butte,007,227075,12259,11864,1758,13622,198
2021-05-03,Calaveras,009,45235,2104,2099,13,2112,50
2021-05-03,Colusa,011,21464,1929,1931,293,2224,14
2021-05-03,Contra Costa,013,1133247,68453,67895,1214,69109,799
2021-05-03,Del Norte,015,27424,1354,1306,11,1317,6
2021-05-03,El Dorado,017,186661,10089,9984,714,10698,110
2021-05-03,Fresno,019,978130,101899,101405,8486,109891,1678
2021-05-03,Glenn,021,27897,2397,2375,538,2913,17
2021-05-03,Humboldt,023,135768,3902,3865,32,3897,36
2021-05-03,Imperial,025,180216,28354,28280,2639,30919,720
2021-05-03,Inyo,027,18085,1401,1398,11,1409,36
2021-05-03,Kern,029,883053,96701,95693,10538,106231,1299
2021-05-03,Kings,031,150075,23047,22821,1055,23876,246
2021-05-03,Lake,033,64148,3474,3446,9,3455,43
2021-05-03,Lassen,035,31185,5175,5142,104,5246,1
2021-05-03,Los Angeles,037,10098052,1202531,1193261,40578,1233839,23942
2021-05-03,Madera,039,155013,16510,16414,909,17323,235
2021-05-03,Marin,041,260295,13994,13927,241,14168,228
2021-05-03,Mariposa,043,17540,422,418,11,429,5
2021-05-03,Mendocino,045,87422,3858,3792,79,3871,46
2021-05-03,Merced,047,269075,30708,30814,1021,31835,444
2021-05-03,Modoc,049,8938,368,360,121,481,3
2021-05-03,Mono,051,14174,1250,1259,16,1275,3
2021-05-03,Monterey,053,433212,42984,42837,1816,44653,380
2021-05-03,Napa,055,140530,9815,9815,34,9849,81
2021-05-03,Nevada,057,99092,4726,4650,185,4835,70
2021-05-03,Orange,059,3164182,254383,253107,11105,264212,4968
2021-05-03,Placer,061,380077,22815,22289,1418,23707,287
2021-05-03,Plumas,063,18699,691,675,10,685,4
2021-05-03,Riverside,065,2383286,292805,287233,13746,300979,4412
2021-05-03,Sacramento,067,1510023,103956,103303,1656,104959,1602
2021-05-03,San Benito,069,59416,6024,6038,111,6149,63
2021-05-03,San Bernardino,071,2135413,292117,290886,8855,299741,4659
2021-05-03,San Diego,073,3302833,278350,276693,14589,291282,3712
2021-05-03,San Francisco,075,870044,36339,36538,1243,37781,541
2021-05-03,San Joaquin,077,732212,72233,71504,3401,74905,1325
2021-05-03,San Luis Obispo,079,281455,21176,20915,708,21623,254
2021-05-03,San Mateo,081,765935,41960,41689,457,42146,413
2021-05-03,Santa Barbara,083,443738,34238,34119,1111,35230,453
2021-05-03,Santa Clara,085,1922200,117827,118373,731,119104,1988
2021-05-03,Santa Cruz,087,273765,16139,16000,795,16795,207
2021-05-03,Shasta,089,179085,11930,11890,1480,13370,197
2021-05-03,Sierra,091,2930,56,54,12,66,0
2021-05-03,Siskiyou,093,43540,1801,1683,304,1987,11
2021-05-03,Solano,095,438530,32293,32201,516,32717,249
2021-05-03,Sonoma,097,501317,29699,29855,316,30171,318
2021-05-03,Stanislaus,099,539301,55418,55116,5771,60887,774
2021-05-03,Sutter,101,95872,9332,9370,80,9450,111
2021-05-03,Tehama,103,63373,4981,4952,550,5502,53
2021-05-03,Trinity,105,12862,482,326,83,409,3
2021-05-03,Tulare,107,460477,49848,48844,8728,57572,835
2021-05-03,Tuolumne,109,53932,3992,4038,40,4078,61
2021-05-03,Ventura,111,848112,80948,80291,2921,83212,1005
2021-05-03,Yolo,113,214977,13853,13809,200,14009,208
2021-05-03,Yuba,115,75493,5924,5880,120,6000,44
2021-05-02,Alameda,001,1643700,86914,86784,1871,88655,1272
2021-05-02,Alpine,003,1148,87,88,0,88,0
2021-05-02,Amador,005,37829,3642,3650,32,3682,46
2021-05-02,Butte,007,227075,12235,11859,1756,13615,198
2021-05-02,Calaveras,009,45235,2100,2098,13,2111,50
2021-05-02,Colusa,011,21464,1928,1931,292,2223,14
2021-05-02,Contra Costa,013,1133247,68368,67843,1212,69055,800
2021-05-02,Del Norte,015,27424,1347,1305,11,1316,6
2021-05-02,El Dorado,017,186661,10074,9962,713,10675,110
2021-05-02,Fresno,019,978130,101827,101372,8475,109847,1678
2021-05-02,Glenn,021,27897,2396,2374,536,2910,17
2021-05-02,Humboldt,023,135768,3890,3858,31,3889,36
2021-05-02,Imperial,025,180216,28320,28275,2630,30905,721
2021-05-02,Inyo,027,18085,1399,1398,11,1409,36
2021-05-02,Kern,029,883053,96643,95668,10531,106199,1299
2021-05-02,Kings,031,150075,23029,22816,1054,23870,246
2021-05-02,Lake,033,64148,3472,3443,9,3452,43
2021-05-02,Lassen,035,31185,5174,5142,103,5245,1
2021-05-02,Los Angeles,037,10098052,1202179,1193056,40557,1233613,23943
2021-05-02,Madera,039,155013,16504,16410,909,17319,235
2021-05-02,Marin,041,260295,13984,13917,241,14158,228
2021-05-02,Mariposa,043,17540,422,419,11,430,5
2021-05-02,Mendocino,045,87422,3853,3787,79,3866,46
2021-05-02,Merced,047,269075,30688,30793,1017,31810,444
2021-05-02,Modoc,049,8938,367,360,121,481,3
2021-05-02,Mono,051,14174,1249,1259,16,1275,3
2021-05-02,Monterey,053,433212,42970,42837,1815,44652,380
2021-05-02,Napa,055,140530,9811,9805,34,9839,81
2021-05-02,Nevada,057,99092,4710,4635,185,4820,70
2021-05-02,Orange,059,3164182,254309,253025,11091,264116,4968
2021-05-02,Placer,061,380077,22786,22264,1415,23679,287
2021-05-02,Plumas,063,18699,691,675,10,685,4
2021-05-02,Riverside,065,2383286,292705,287197,13736,300933,4412
2021-05-02,Sacramento,067,1510023,103816,103153,1649,104802,1602
2021-05-02,San Benito,069,59416,6019,6037,111,6148,63
2021-05-02,San Bernardino,071,2135413,292018,290859,8853,299712,4655
2021-05-02,San Diego,073,3302833,278154,276521,14562,291083,3712
2021-05-02,San Francisco,075,870044,36313,36522,1243,37765,541
2021-05-02,San Joaquin,077,732212,72169,71447,3395,74842,1325
2021-05-02,San Luis Obispo,079,281455,21155,20910,707,21617,254
2021-05-02,San Mateo,081,765935,41944,41656,456,42112,412
2021-05-02,Santa Barbara,083,443738,34224,34106,1111,35217,453
2021-05-02,Santa Clara,085,1922200,117753,118321,731,119052,1988
2021-05-02,Santa Cruz,087,273765,16134,15995,794,16789,207
2021-05-02,Shasta,089,179085,11914,11885,1472,13357,197
2021-05-02,Sierra,091,2930,56,54,12,66,0
2021-05-02,Siskiyou,093,43540,1790,1661,303,1964,11
2021-05-02,Solano,095,438530,32254,32151,512,32663,249
2021-05-02,Sonoma,097,501317,29677,29842,316,30158,318
2021-05-02,Stanislaus,099,539301,55344,55057,5764,60821,774
2021-05-02,Sutter,101,95872,9326,9363,80,9443,111
2021-05-02,Tehama,103,63373,4976,4950,548,5498,53
2021-05-02,Trinity,105,12862,482,326,83,409,3
2021-05-02,Tulare,107,460477,49830,48834,8720,57554,835
2021-05-02,Tuolumne,109,53932,3989,4038,40,4078,61
2021-05-02,Ventura,111,848112,80910,80284,2920,83204,1005
2021-05-02,Yolo,113,214977,13841,13799,199,13998,208
2021-05-02,Yuba,115,75493,5914,5879,120,5999,44
2021-05-01,Alameda,001,1643700,86871,86704,1868,88572,1270
2021-05-01,Alpine,003,1148,87,88,0,88,0
2021-05-01,Amador,005,37829,3642,3650,32,3682,46
2021-05-01,Butte,007,227075,12221,11845,1751,13596,198
2021-05-01,Calaveras,009,45235,2098,2096,13,2109,50
2021-05-01,Colusa,011,21464,1927,1931,292,2223,14
2021-05-01,Contra Costa,013,1133247,68316,67779,1209,68988,800
2021-05-01,Del Norte,015,27424,1346,1292,11,1303,6
2021-05-01,El Dorado,017,186661,10060,9944,711,10655,110
2021-05-01,Fresno,019,978130,101782,101326,8469,109795,1678
2021-05-01,Glenn,021,27897,2393,2369,535,2904,17
2021-05-01,Humboldt,023,135768,3876,3845,31,3876,36
2021-05-01,Imperial,025,180216,28313,28262,2630,30892,721
2021-05-01,Inyo,027,18085,1399,1397,11,1408,36
2021-05-01,Kern,029,883053,96616,95645,10520,106165,1299
2021-05-01,Kings,031,150075,23026,22797,1053,23850,246
2021-05-01,Lake,033,64148,3470,3441,9,3450,43
2021-05-01,Lassen,035,31185,5172,5142,103,5245,1
2021-05-01,Los Angeles,037,10098052,1202009,1192781,40543,1233324,23946
2021-05-01,Madera,039,155013,16500,16408,909,17317,235
2021-05-01,Marin,041,260295,13977,13902,241,14143,228
2021-05-01,Mariposa,043,17540,422,418,11,429,5
2021-05-01,Mendocino,045,87422,3851,3782,79,3861,46
2021-05-01,Merced,047,269075,30671,30771,1016,31787,444
2021-05-01,Modoc,049,8938,367,361,121,482,3
2021-05-01,Mono,051,14174,1249,1258,16,1274,3
2021-05-01,Monterey,053,433212,42964,42828,1815,44643,379
2021-05-01,Napa,055,140530,9808,9800,34,9834,81
2021-05-01,Nevada,057,99092,4705,4625,185,4810,70
2021-05-01,Orange,059,3164182,254266,252969,11081,264050,4964
2021-05-01,Placer,061,380077,22760,22240,1413,23653,287
2021-05-01,Plumas,063,18699,690,675,10,685,4
2021-05-01,Riverside,065,2383286,292666,287129,13734,300863,4412
2021-05-01,Sacramento,067,1510023,103735,103043,1648,104691,1602
2021-05-01,San Benito,069,59416,6016,6030,111,6141,63
2021-05-01,San Bernardino,071,2135413,291975,290802,8852,299654,4652
2021-05-01,San Diego,073,3302833,278030,276367,14541,290908,3706
2021-05-01,San Francisco,075,870044,36298,36496,1243,37739,541
2021-05-01,San Joaquin,077,732212,72120,71389,3393,74782,1325
2021-05-01,San Luis Obispo,079,281455,21150,20896,707,21603,254
2021-05-01,San Mateo,081,765935,41915,41617,455,42072,411
2021-05-01,Santa Barbara,083,443738,34219,34085,1110,35195,453
2021-05-01,Santa Clara,085,1922200,117701,118265,729,118994,1988
2021-05-01,Santa Cruz,087,273765,16131,15984,794,16778,207
2021-05-01,Shasta,089,179085,11894,11878,1465,13343,197
2021-05-01,Sierra,091,2930,56,53,12,65,0
2021-05-01,Siskiyou,093,43540,1782,1653,302,1955,11
2021-05-01,Solano,095,438530,32224,32124,504,32628,249
2021-05-01,Sonoma,097,501317,29674,29835,316,30151,318
2021-05-01,Stanislaus,099,539301,55309,55005,5758,60763,774
2021-05-01,Sutter,101,95872,9323,9358,80,9438,110
2021-05-01,Tehama,103,63373,4975,4950,547,5497,53
2021-05-01,Trinity,105,12862,482,326,82,408,3
2021-05-01,Tulare,107,460477,49823,48818,8714,57532,835
2021-05-01,Tuolumne,109,53932,3983,4035,40,4075,61
2021-05-01,Ventura,111,848112,80892,80268,2920,83188,1005
2021-05-01,Yolo,113,214977,13834,13784,197,13981,208
2021-05-01,Yuba,115,75493,5912,5875,120,5995,44
2021-04-30,Alameda,001,1643700,86810,86602,1865,88467,1268
2021-04-30,Alpine,003,1148,87,88,0,88,0
2021-04-30,Amador,005,37829,3640,3650,32,3682,46
2021-04-30,Butte,007,227075,12202,11812,1747,13559,197
2021-04-30,Calaveras,009,45235,2097,2087,13,2100,50
2021-04-30,Colusa,011,21464,1927,1931,291,2222,14
2021-04-30,Contra Costa,013,1133247,68268,67684,1206,68890,800
2021-04-30,Del Norte,015,27424,1334,1276,11,1287,6
2021-04-30,El Dorado,017,186661,10046,9906,711,10617,110
2021-04-30,Fresno,019,978130,101736,101263,8465,109728,1670
2021-04-30,Glenn,021,27897,2392,2369,535,2904,17
2021-04-30,Humboldt,023,135768,3863,3834,31,3865,36
2021-04-30,Imperial,025,180216,28304,28244,2627,30871,721
2021-04-30,Inyo,027,18085,1399,1397,11,1408,36
2021-04-30,Kern,029,883053,96599,95605,10516,106121,1298
2021-04-30,Kings,031,150075,23023,22793,1052,23845,246
2021-04-30,Lake,033,64148,3466,3440,9,3449,43
2021-04-30,Lassen,035,31185,5171,5140,103,5243,1
2021-04-30,Los Angeles,037,10098052,1201797,1192393,40530,1232923,23919
2021-04-30,Madera,039,155013,16494,16395,909,17304,235
2021-04-30,Marin,041,260295,13969,13895,239,14134,228
2021-04-30,Mariposa,043,17540,422,417,11,428,5
2021-04-30,Mendocino,045,87422,3847,3777,79,3856,46
2021-04-30,Merced,047,269075,30658,30740,1015,31755,444
2021-04-30,Modoc,049,8938,366,360,121,481,3
2021-04-30,Mono,051,14174,1249,1258,16,1274,3
2021-04-30,Monterey,053,433212,42950,42810,1814,44624,379
2021-04-30,Napa,055,140530,9804,9792,34,9826,81
2021-04-30,Nevada,057,99092,4697,4608,185,4793,70
2021-04-30,Orange,059,3164182,254209,252883,11075,263958,4956
2021-04-30,Placer,061,380077,22741,22190,1409,23599,287
2021-04-30,Plumas,063,18699,690,677,10,687,4
2021-04-30,Riverside,065,2383286,292608,287030,13727,300757,4412
2021-04-30,Sacramento,067,1510023,103634,102864,1644,104508,1596
2021-04-30,San Benito,069,59416,6012,6024,110,6134,63
2021-04-30,San Bernardino,071,2135413,291915,290704,8851,299555,4640
2021-04-30,San Diego,073,3302833,277934,276157,14530,290687,3702
2021-04-30,San Francisco,075,870044,36287,36453,1242,37695,538
2021-04-30,San Joaquin,077,732212,72068,71311,3390,74701,1306
2021-04-30,San Luis Obispo,079,281455,21144,20884,707,21591,255
2021-04-30,San Mateo,081,765935,41901,41583,454,42037,380
2021-04-30,Santa Barbara,083,443738,34206,34061,1110,35171,451
2021-04-30,Santa Clara,085,1922200,117643,118170,725,118895,1988
2021-04-30,Santa Cruz,087,273765,16126,15975,794,16769,207
2021-04-30,Shasta,089,179085,11873,11848,1462,13310,197
2021-04-30,Sierra,091,2930,56,53,12,65,0
2021-04-30,Siskiyou,093,43540,1771,1628,299,1927,11
2021-04-30,Solano,095,438530,32192,32050,501,32551,249
2021-04-30,Sonoma,097,501317,29664,29816,314,30130,318
2021-04-30,Stanislaus,099,539301,55258,54938,5755,60693,774
2021-04-30,Sutter,101,95872,9321,9353,80,9433,110
2021-04-30,Tehama,103,63373,4972,4944,547,5491,53
2021-04-30,Trinity,105,12862,482,326,82,408,3
2021-04-30,Tulare,107,460477,49813,48797,8698,57495,836
2021-04-30,Tuolumne,109,53932,3982,4033,40,4073,61
2021-04-30,Ventura,111,848112,80852,80232,2915,83147,1004
2021-04-30,Yolo,113,214977,13822,13756,197,13953,208
2021-04-30,Yuba,115,75493,5904,5870,120,5990,44
2021-04-29,Alameda,001,1643700,86743,86490,1864,88354,1263
2021-04-29,Alpine,003,1148,87,88,0,88,0
2021-04-29,Amador,005,37829,3640,3649,32,3681,46
2021-04-29,Butte,007,227075,12187,11787,1745,13532,196
2021-04-29,Calaveras,009,45235,2094,2082,13,2095,50
2021-04-29,Colusa,011,21464,1927,1929,291,2220,14
2021-04-29,Contra Costa,013,1133247,68213,67606,1203,68809,795
2021-04-29,Del Norte,015,27424,1330,1271,11,1282,6
2021-04-29,El Dorado,017,186661,10026,9884,708,10592,107
2021-04-29,Fresno,019,978130,101682,101189,8454,109643,1667
2021-04-29,Glenn,021,27897,2389,2369,535,2904,17
2021-04-29,Humboldt,023,135768,3849,3815,31,3846,36
2021-04-29,Imperial,025,180216,28292,28235,2626,30861,720
2021-04-29,Inyo,027,18085,1399,1396,11,1407,36
2021-04-29,Kern,029,883053,96566,95547,10512,106059,1295
2021-04-29,Kings,031,150075,23013,22777,1047,23824,245
2021-04-29,Lake,033,64148,3458,3438,9,3447,43
2021-04-29,Lassen,035,31185,5171,5140,103,5243,1
2021-04-29,Los Angeles,037,10098052,1201519,1192068,40509,1232577,23899
2021-04-29,Madera,039,155013,16489,16383,908,17291,235
2021-04-29,Marin,041,260295,13965,13884,231,14115,228
2021-04-29,Mariposa,043,17540,421,416,11,427,5
2021-04-29,Mendocino,045,87422,3841,3774,79,3853,46
2021-04-29,Merced,047,269075,30639,30706,1014,31720,444
2021-04-29,Modoc,049,8938,366,360,121,481,3
2021-04-29,Mono,051,14174,1246,1259,16,1275,3
2021-04-29,Monterey,053,433212,42933,42797,1813,44610,379
2021-04-29,Napa,055,140530,9790,9789,34,9823,81
2021-04-29,Nevada,057,99092,4686,4590,185,4775,70
2021-04-29,Orange,059,3164182,254139,252823,11060,263883,4934
2021-04-29,Placer,061,380077,22716,22161,1407,23568,286
2021-04-29,Plumas,063,18699,689,676,10,686,4
2021-04-29,Riverside,065,2383286,292540,286947,13725,300672,4409
2021-04-29,Sacramento,067,1510023,103501,102686,1635,104321,1593
2021-04-29,San Benito,069,59416,6011,6023,110,6133,63
2021-04-29,San Bernardino,071,2135413,291843,290606,8846,299452,4609
2021-04-29,San Diego,073,3302833,277783,275961,14513,290474,3700
2021-04-29,San Francisco,075,870044,36262,36412,1242,37654,537
2021-04-29,San Joaquin,077,732212,72002,71225,3385,74610,1301
2021-04-29,San Luis Obispo,079,281455,21133,20876,707,21583,255
2021-04-29,San Mateo,081,765935,41873,41538,453,41991,358
2021-04-29,Santa Barbara,083,443738,34190,34039,1108,35147,448
2021-04-29,Santa Clara,085,1922200,117588,118082,722,118804,1984
2021-04-29,Santa Cruz,087,273765,16120,15961,794,16755,205
2021-04-29,Shasta,089,179085,11842,11836,1454,13290,193
2021-04-29,Sierra,091,2930,56,53,12,65,0
2021-04-29,Siskiyou,093,43540,1762,1615,296,1911,11
2021-04-29,Solano,095,438530,32151,32002,497,32499,248
2021-04-29,Sonoma,097,501317,29649,29785,311,30096,318
2021-04-29,Stanislaus,099,539301,55191,54836,5750,60586,774
2021-04-29,Sutter,101,95872,9314,9346,80,9426,110
2021-04-29,Tehama,103,63373,4964,4939,547,5486,53
2021-04-29,Trinity,105,12862,482,326,82,408,3
2021-04-29,Tulare,107,460477,49795,48785,8687,57472,832
2021-04-29,Tuolumne,109,53932,3981,4030,40,4070,58
2021-04-29,Ventura,111,848112,80818,80188,2913,83101,1002
2021-04-29,Yolo,113,214977,13802,13745,196,13941,205
2021-04-29,Yuba,115,75493,5894,5865,120,5985,44
2021-04-28,Alameda,001,1643700,86671,86390,1860,88250,1260
2021-04-28,Alpine,003,1148,87,88,0,88,0
2021-04-28,Amador,005,37829,3640,3646,32,3678,46
2021-04-28,Butte,007,227075,12167,11762,1740,13502,196
2021-04-28,Calaveras,009,45235,2090,2078,12,2090,50
2021-04-28,Colusa,011,21464,1924,1927,290,2217,14
2021-04-28,Contra Costa,013,1133247,68153,67539,1201,68740,795
2021-04-28,Del Norte,015,27424,1322,1267,11,1278,6
2021-04-28,El Dorado,017,186661,10001,9873,708,10581,107
2021-04-28,Fresno,019,978130,101635,101161,8444,109605,1666
2021-04-28,Glenn,021,27897,2386,2368,535,2903,17
2021-04-28,Humboldt,023,135768,3833,3796,31,3827,36
2021-04-28,Imperial,025,180216,28278,28177,2625,30802,720
2021-04-28,Inyo,027,18085,1399,1396,10,1406,36
2021-04-28,Kern,029,883053,96537,95494,10503,105997,1295
2021-04-28,Kings,031,150075,23001,22767,1045,23812,245
2021-04-28,Lake,033,64148,3455,3433,9,3442,43
2021-04-28,Lassen,035,31185,5171,5138,103,5241,1
2021-04-28,Los Angeles,037,10098052,1201217,1191729,40482,1232211,23858
2021-04-28,Madera,039,155013,16485,16372,908,17280,235
2021-04-28,Marin,041,260295,13954,13866,231,14097,227
2021-04-28,Mariposa,043,17540,418,415,11,426,5
2021-04-28,Mendocino,045,87422,3835,3770,77,3847,46
2021-04-28,Merced,047,269075,30621,30649,1014,31663,443
2021-04-28,Modoc,049,8938,366,360,121,481,3
2021-04-28,Mono,051,14174,1246,1258,16,1274,3
2021-04-28,Monterey,053,433212,42928,42776,1813,44589,379
2021-04-28,Napa,055,140530,9779,9777,34,9811,81
2021-04-28,Nevada,057,99092,4666,4570,185,4755,70
2021-04-28,Orange,059,3164182,254059,252747,11048,263795,4931
2021-04-28,Placer,061,380077,22689,22115,1406,23521,285
2021-04-28,Plumas,063,18699,689,676,10,686,4
2021-04-28,Riverside,065,2383286,292484,286868,13719,300587,4407
2021-04-28,Sacramento,067,1510023,103379,102613,1631,104244,1591
2021-04-28,San Benito,069,59416,6009,6021,110,6131,63
2021-04-28,San Bernardino,071,2135413,291764,290548,8836,299384,4582
2021-04-28,San Diego,073,3302833,277629,275821,14499,290320,3698
2021-04-28,San Francisco,075,870044,36232,36382,1241,37623,534
2021-04-28,San Joaquin,077,732212,71922,71171,3377,74548,1301
2021-04-28,San Luis Obispo,079,281455,21125,20851,707,21558,255
2021-04-28,San Mateo,081,765935,41848,41498,451,41949,358
2021-04-28,Santa Barbara,083,443738,34176,34003,1108,35111,448
2021-04-28,Santa Clara,085,1922200,117519,117997,720,118717,1969
2021-04-28,Santa Cruz,087,273765,16116,15943,793,16736,205
2021-04-28,Shasta,089,179085,11826,11815,1447,13262,192
2021-04-28,Sierra,091,2930,56,51,12,63,0
2021-04-28,Siskiyou,093,43540,1749,1603,293,1896,11
2021-04-28,Solano,095,438530,32119,31982,492,32474,248
2021-04-28,Sonoma,097,501317,29635,29773,307,30080,318
2021-04-28,Stanislaus,099,539301,55136,54745,5747,60492,774
2021-04-28,Sutter,101,95872,9309,9343,80,9423,110
2021-04-28,Tehama,103,63373,4959,4930,546,5476,53
2021-04-28,Trinity,105,12862,482,326,82,408,3
2021-04-28,Tulare,107,460477,49777,48754,8672,57426,832
2021-04-28,Tuolumne,109,53932,3978,4029,40,4069,58
2021-04-28,Ventura,111,848112,80783,80172,2911,83083,1000
2021-04-28,Yolo,113,214977,13788,13721,195,13916,205
2021-04-28,Yuba,115,75493,5888,5857,120,5977,44
2021-04-27,Alameda,001,1643700,86581,86301,1854,88155,1260
2021-04-27,Alpine,003,1148,87,88,0,88,0
2021-04-27,Amador,005,37829,3640,3645,32,3677,46
2021-04-27,Butte,007,227075,12142,11738,1734,13472,196
2021-04-27,Calaveras,009,45235,2088,2076,12,2088,50
2021-04-27,Colusa,011,21464,1923,1926,290,2216,14
2021-04-27,Contra Costa,013,1133247,68084,67470,1197,68667,791
2021-04-27,Del Norte,015,27424,1310,1266,11,1277,6
2021-04-27,El Dorado,017,186661,9972,9866,705,10571,106
2021-04-27,Fresno,019,978130,101570,101138,8434,109572,1663
2021-04-27,Glenn,021,27897,2386,2368,535,2903,17
2021-04-27,Humboldt,023,135768,3821,3780,31,3811,35
2021-04-27,Imperial,025,180216,28262,28149,2619,30768,720
2021-04-27,Inyo,027,18085,1399,1396,10,1406,36
2021-04-27,Kern,029,883053,96480,95466,10493,105959,1295
2021-04-27,Kings,031,150075,22986,22759,1043,23802,244
2021-04-27,Lake,033,64148,3454,3431,9,3440,43
2021-04-27,Lassen,035,31185,5171,5137,103,5240,1
2021-04-27,Los Angeles,037,10098052,1200894,1191504,40452,1231956,23825
2021-04-27,Madera,039,155013,16478,16365,908,17273,235
2021-04-27,Marin,041,260295,13932,13855,231,14086,227
2021-04-27,Mariposa,043,17540,417,413,11,424,5
2021-04-27,Mendocino,045,87422,3831,3765,77,3842,46
2021-04-27,Merced,047,269075,30580,30620,1014,31634,443
2021-04-27,Modoc,049,8938,365,360,121,481,3
2021-04-27,Mono,051,14174,1246,1257,16,1273,3
2021-04-27,Monterey,053,433212,42910,42752,1810,44562,379
2021-04-27,Napa,055,140530,9772,9774,32,9806,81
2021-04-27,Nevada,057,99092,4651,4557,185,4742,70
2021-04-27,Orange,059,3164182,253989,252667,11043,263710,4925
2021-04-27,Placer,061,380077,22660,22050,1402,23452,285
2021-04-27,Plumas,063,18699,688,675,10,685,4
2021-04-27,Riverside,065,2383286,292408,286820,13715,300535,4405
2021-04-27,Sacramento,067,1510023,103250,102595,1621,104216,1589
2021-04-27,San Benito,069,59416,6004,6016,110,6126,63
2021-04-27,San Bernardino,071,2135413,291696,290461,8831,299292,4575
2021-04-27,San Diego,073,3302833,277472,275685,14479,290164,3692
2021-04-27,San Francisco,075,870044,36204,36358,1240,37598,533
2021-04-27,San Joaquin,077,732212,71869,71104,3371,74475,1301
2021-04-27,San Luis Obispo,079,281455,21118,20841,707,21548,255
2021-04-27,San Mateo,081,765935,41813,41474,450,41924,358
2021-04-27,Santa Barbara,083,443738,34152,33973,1107,35080,448
2021-04-27,Santa Clara,085,1922200,117469,117945,719,118664,1969
2021-04-27,Santa Cruz,087,273765,16109,15905,792,16697,205
2021-04-27,Shasta,089,179085,11798,11802,1440,13242,192
2021-04-27,Sierra,091,2930,56,51,12,63,0
2021-04-27,Siskiyou,093,43540,1734,1597,292,1889,11
2021-04-27,Solano,095,438530,32071,31964,491,32455,248
2021-04-27,Sonoma,097,501317,29617,29761,306,30067,318
2021-04-27,Stanislaus,099,539301,55066,54695,5739,60434,752
2021-04-27,Sutter,101,95872,9304,9342,80,9422,110
2021-04-27,Tehama,103,63373,4956,4922,542,5464,53
2021-04-27,Trinity,105,12862,482,326,82,408,3
2021-04-27,Tulare,107,460477,49761,48744,8663,57407,832
2021-04-27,Tuolumne,109,53932,3975,4028,40,4068,58
2021-04-27,Ventura,111,848112,80754,80152,2909,83061,1000
2021-04-27,Yolo,113,214977,13775,13697,193,13890,205
2021-04-27,Yuba,115,75493,5888,5853,120,5973,44
2021-04-26,Alameda,001,1643700,86487,86230,1851,88081,1256
2021-04-26,Alpine,003,1148,87,88,0,88,0
2021-04-26,Amador,005,37829,3639,3645,32,3677,46
2021-04-26,Butte,007,227075,12118,11720,1730,13450,196
2021-04-26,Calaveras,009,45235,2082,2074,12,2086,50
2021-04-26,Colusa,011,21464,1923,1925,289,2214,14
2021-04-26,Contra Costa,013,1133247,68017,67392,1193,68585,789
2021-04-26,Del Norte,015,27424,1301,1263,11,1274,6
2021-04-26,El Dorado,017,186661,9951,9849,704,10553,106
2021-04-26,Fresno,019,978130,101515,101099,8421,109520,1662
2021-04-26,Glenn,021,27897,2384,2367,535,2902,17
2021-04-26,Humboldt,023,135768,3811,3764,30,3794,35
2021-04-26,Imperial,025,180216,28249,28148,2616,30764,720
2021-04-26,Inyo,027,18085,1398,1396,10,1406,36
2021-04-26,Kern,029,883053,96453,95429,10487,105916,1295
2021-04-26,Kings,031,150075,22983,22756,1040,23796,244
2021-04-26,Lake,033,64148,3449,3428,9,3437,43
2021-04-26,Lassen,035,31185,5171,5138,103,5241,1
2021-04-26,Los Angeles,037,10098052,1200565,1191253,40433,1231686,23802
2021-04-26,Madera,039,155013,16466,16353,907,17260,231
2021-04-26,Marin,041,260295,13917,13849,231,14080,227
2021-04-26,Mariposa,043,17540,416,410,11,421,5
2021-04-26,Mendocino,045,87422,3829,3757,76,3833,46
2021-04-26,Merced,047,269075,30563,30611,1011,31622,443
2021-04-26,Modoc,049,8938,365,360,121,481,3
2021-04-26,Mono,051,14174,1246,1258,16,1274,3
2021-04-26,Monterey,053,433212,42894,42740,1809,44549,379
2021-04-26,Napa,055,140530,9760,9769,32,9801,79
2021-04-26,Nevada,057,99092,4630,4548,185,4733,70
2021-04-26,Orange,059,3164182,253905,252592,11033,263625,4919
2021-04-26,Placer,061,380077,22632,22032,1397,23429,285
2021-04-26,Plumas,063,18699,688,670,10,680,4
2021-04-26,Riverside,065,2383286,292346,286724,13707,300431,4401
2021-04-26,Sacramento,067,1510023,103078,102459,1609,104068,1587
2021-04-26,San Benito,069,59416,6002,6013,110,6123,63
2021-04-26,San Bernardino,071,2135413,291644,290394,8830,299224,4572
2021-04-26,San Diego,073,3302833,277297,275541,14451,289992,3692
2021-04-26,San Francisco,075,870044,36176,36330,1239,37569,532
2021-04-26,San Joaquin,077,732212,71803,71050,3363,74413,1301
2021-04-26,San Luis Obispo,079,281455,21110,20830,706,21536,255
2021-04-26,San Mateo,081,765935,41783,41457,450,41907,357
2021-04-26,Santa Barbara,083,443738,34121,33948,1107,35055,448
2021-04-26,Santa Clara,085,1922200,117369,117874,716,118590,1968
2021-04-26,Santa Cruz,087,273765,16100,15877,792,16669,205
2021-04-26,Shasta,089,179085,11781,11787,1434,13221,192
2021-04-26,Sierra,091,2930,55,51,12,63,0
2021-04-26,Siskiyou,093,43540,1724,1592,289,1881,11
2021-04-26,Solano,095,438530,32026,31913,489,32402,247
2021-04-26,Sonoma,097,501317,29594,29755,304,30059,318
2021-04-26,Stanislaus,099,539301,54976,54638,5733,60371,744
2021-04-26,Sutter,101,95872,9299,9328,80,9408,110
2021-04-26,Tehama,103,63373,4951,4920,539,5459,53
2021-04-26,Trinity,105,12862,482,326,82,408,3
2021-04-26,Tulare,107,460477,49741,48735,8654,57389,831
2021-04-26,Tuolumne,109,53932,3974,4024,40,4064,58
2021-04-26,Ventura,111,848112,80729,80137,2906,83043,999
2021-04-26,Yolo,113,214977,13755,13684,190,13874,205
2021-04-26,Yuba,115,75493,5886,5851,120,5971,44
2021-04-25,Alameda,001,1643700,86386,86162,1845,88007,1256
2021-04-25,Alpine,003,1148,87,87,0,87,0
2021-04-25,Amador,005,37829,3638,3643,32,3675,46
2021-04-25,Butte,007,227075,12089,11709,1723,13432,196
2021-04-25,Calaveras,009,45235,2077,2072,11,2083,50
2021-04-25,Colusa,011,21464,1922,1924,289,2213,14
2021-04-25,Contra Costa,013,1133247,67925,67316,1192,68508,789
2021-04-25,Del Norte,015,27424,1295,1259,11,1270,6
2021-04-25,El Dorado,017,186661,9934,9837,702,10539,106
2021-04-25,Fresno,019,978130,101456,101061,8409,109470,1662
2021-04-25,Glenn,021,27897,2384,2366,535,2901,17
2021-04-25,Humboldt,023,135768,3798,3751,30,3781,35
2021-04-25,Imperial,025,180216,28223,28136,2614,30750,720
2021-04-25,Inyo,027,18085,1398,1396,10,1406,36
2021-04-25,Kern,029,883053,96387,95398,10475,105873,1295
2021-04-25,Kings,031,150075,22969,22755,1038,23793,244
2021-04-25,Lake,033,64148,3447,3427,9,3436,43
2021-04-25,Lassen,035,31185,5169,5138,103,5241,1
2021-04-25,Los Angeles,037,10098052,1200229,1190970,40413,1231383,23799
2021-04-25,Madera,039,155013,16454,16346,907,17253,231
2021-04-25,Marin,041,260295,13908,13852,231,14083,227
2021-04-25,Mariposa,043,17540,416,410,11,421,5
2021-04-25,Mendocino,045,87422,3822,3757,76,3833,46
2021-04-25,Merced,047,269075,30529,30586,1010,31596,443
2021-04-25,Modoc,049,8938,365,360,121,481,3
2021-04-25,Mono,051,14174,1246,1257,16,1273,3
2021-04-25,Monterey,053,433212,42881,42737,1807,44544,379
2021-04-25,Napa,055,140530,9755,9762,32,9794,79
2021-04-25,Nevada,057,99092,4618,4536,185,4721,70
2021-04-25,Orange,059,3164182,253829,252531,11027,263558,4919
2021-04-25,Placer,061,380077,22586,22011,1389,23400,285
2021-04-25,Plumas,063,18699,687,670,10,680,4
2021-04-25,Riverside,065,2383286,292252,286651,13701,300352,4401
2021-04-25,Sacramento,067,1510023,102910,102319,1599,103918,1587
2021-04-25,San Benito,069,59416,6000,6014,109,6123,63
2021-04-25,San Bernardino,071,2135413,291569,290357,8822,299179,4571
2021-04-25,San Diego,073,3302833,277084,275412,14418,289830,3692
2021-04-25,San Francisco,075,870044,36145,36310,1239,37549,532
2021-04-25,San Joaquin,077,732212,71708,70987,3353,74340,1301
2021-04-25,San Luis Obispo,079,281455,21091,20820,704,21524,255
2021-04-25,San Mateo,081,765935,41748,41465,449,41914,356
2021-04-25,Santa Barbara,083,443738,34095,33931,1107,35038,448
2021-04-25,Santa Clara,085,1922200,117290,117778,714,118492,1968
2021-04-25,Santa Cruz,087,273765,16094,15868,790,16658,205
2021-04-25,Shasta,089,179085,11758,11784,1429,13213,192
2021-04-25,Sierra,091,2930,55,51,12,63,0
2021-04-25,Siskiyou,093,43540,1713,1580,287,1867,11
2021-04-25,Solano,095,438530,31979,31864,481,32345,247
2021-04-25,Sonoma,097,501317,29576,29756,304,30060,318
2021-04-25,Stanislaus,099,539301,54880,54543,5725,60268,744
2021-04-25,Sutter,101,95872,9293,9326,80,9406,110
2021-04-25,Tehama,103,63373,4947,4916,537,5453,53
2021-04-25,Trinity,105,12862,482,326,82,408,3
2021-04-25,Tulare,107,460477,49725,48728,8641,57369,831
2021-04-25,Tuolumne,109,53932,3971,4022,40,4062,58
2021-04-25,Ventura,111,848112,80705,80110,2906,83016,999
2021-04-25,Yolo,113,214977,13730,13667,188,13855,205
2021-04-25,Yuba,115,75493,5883,5849,119,5968,44
2021-04-24,Alameda,001,1643700,86331,86016,1843,87859,1257
2021-04-24,Alpine,003,1148,87,86,0,86,0
2021-04-24,Amador,005,37829,3637,3640,32,3672,46
2021-04-24,Butte,007,227075,12073,11678,1721,13399,196
2021-04-24,Calaveras,009,45235,2073,2067,11,2078,50
2021-04-24,Colusa,011,21464,1921,1921,289,2210,14
2021-04-24,Contra Costa,013,1133247,67854,67222,1190,68412,789
2021-04-24,Del Norte,015,27424,1290,1255,11,1266,6
2021-04-24,El Dorado,017,186661,9923,9814,701,10515,106
2021-04-24,Fresno,019,978130,101425,100991,8403,109394,1662
2021-04-24,Glenn,021,27897,2384,2363,535,2898,17
2021-04-24,Humboldt,023,135768,3784,3722,30,3752,35
2021-04-24,Imperial,025,180216,28216,28124,2613,30737,720
2021-04-24,Inyo,027,18085,1397,1396,10,1406,36
2021-04-24,Kern,029,883053,96368,95365,10465,105830,1295
2021-04-24,Kings,031,150075,22966,22749,1038,23787,244
2021-04-24,Lake,033,64148,3446,3426,9,3435,43
2021-04-24,Lassen,035,31185,5168,5137,103,5240,1
2021-04-24,Los Angeles,037,10098052,1199997,1190603,40397,1231000,23802
2021-04-24,Madera,039,155013,16451,16338,907,17245,231
2021-04-24,Marin,041,260295,13900,13847,231,14078,227
2021-04-24,Mariposa,043,17540,416,409,11,420,5
2021-04-24,Mendocino,045,87422,3820,3754,74,3828,46
2021-04-24,Merced,047,269075,30509,30559,1010,31569,443
2021-04-24,Modoc,049,8938,365,360,121,481,3
2021-04-24,Mono,051,14174,1246,1256,16,1272,3
2021-04-24,Monterey,053,433212,42869,42727,1806,44533,379
2021-04-24,Napa,055,140530,9749,9756,32,9788,79
2021-04-24,Nevada,057,99092,4611,4522,185,4707,70
2021-04-24,Orange,059,3164182,253785,252441,11021,263462,4910
2021-04-24,Placer,061,380077,22573,21983,1388,23371,285
2021-04-24,Plumas,063,18699,686,670,10,680,4
2021-04-24,Riverside,065,2383286,292184,286552,13697,300249,4400
2021-04-24,Sacramento,067,1510023,102827,102179,1592,103771,1587
2021-04-24,San Benito,069,59416,5998,6007,109,6116,63
2021-04-24,San Bernardino,071,2135413,291520,290264,8821,299085,4568
2021-04-24,San Diego,073,3302833,276981,275252,14398,289650,3688
2021-04-24,San Francisco,075,870044,36116,36285,1235,37520,532
2021-04-24,San Joaquin,077,732212,71665,70911,3350,74261,1301
2021-04-24,San Luis Obispo,079,281455,21081,20797,703,21500,255
2021-04-24,San Mateo,081,765935,41735,41424,447,41871,355
2021-04-24,Santa Barbara,083,443738,34080,33911,1106,35017,448
2021-04-24,Santa Clara,085,1922200,117235,117674,712,118386,1968
2021-04-24,Santa Cruz,087,273765,16086,15840,790,16630,205
2021-04-24,Shasta,089,179085,11740,11770,1426,13196,192
2021-04-24,Sierra,091,2930,55,51,12,63,0
2021-04-24,Siskiyou,093,43540,1703,1574,286,1860,11
2021-04-24,Solano,095,438530,31956,31821,478,32299,247
2021-04-24,Sonoma,097,501317,29574,29739,304,30043,318
2021-04-24,Stanislaus,099,539301,54831,54455,5722,60177,744
2021-04-24,Sutter,101,95872,9290,9316,80,9396,110
2021-04-24,Tehama,103,63373,4942,4907,537,5444,53
2021-04-24,Trinity,105,12862,482,326,82,408,3
2021-04-24,Tulare,107,460477,49714,48705,8631,57336,830
2021-04-24,Tuolumne,109,53932,3967,4020,40,4060,58
2021-04-24,Ventura,111,848112,80692,80097,2904,83001,999
2021-04-24,Yolo,113,214977,13719,13653,188,13841,205
2021-04-24,Yuba,115,75493,5881,5837,119,5956,44
2021-04-23,Alameda,001,1643700,86257,85935,1840,87775,1256
2021-04-23,Alpine,003,1148,86,86,0,86,0
2021-04-23,Amador,005,37829,3636,3637,32,3669,46
2021-04-23,Butte,007,227075,12052,11672,1716,13388,196
2021-04-23,Calaveras,009,45235,2070,2064,11,2075,50
2021-04-23,Colusa,011,21464,1920,1921,289,2210,14
2021-04-23,Contra Costa,013,1133247,67800,67164,1188,68352,785
2021-04-23,Del Norte,015,27424,1289,1254,11,1265,6
2021-04-23,El Dorado,017,186661,9905,9788,698,10486,106
2021-04-23,Fresno,019,978130,101384,100928,8397,109325,1662
2021-04-23,Glenn,021,27897,2384,2361,534,2895,17
2021-04-23,Humboldt,023,135768,3774,3698,30,3728,35
2021-04-23,Imperial,025,180216,28201,28108,2612,30720,720
2021-04-23,Inyo,027,18085,1397,1395,10,1405,36
2021-04-23,Kern,029,883053,96343,95330,10459,105789,1295
2021-04-23,Kings,031,150075,22963,22735,1038,23773,244
2021-04-23,Lake,033,64148,3444,3425,9,3434,43
2021-04-23,Lassen,035,31185,5168,5141,103,5244,1
2021-04-23,Los Angeles,037,10098052,1199727,1190264,40373,1230637,23785
2021-04-23,Madera,039,155013,16442,16328,907,17235,231
2021-04-23,Marin,041,260295,13895,13838,231,14069,227
2021-04-23,Mariposa,043,17540,415,405,11,416,5
2021-04-23,Mendocino,045,87422,3818,3745,73,3818,46
2021-04-23,Merced,047,269075,30492,30530,1009,31539,443
2021-04-23,Modoc,049,8938,365,360,121,481,3
2021-04-23,Mono,051,14174,1244,1256,16,1272,3
2021-04-23,Monterey,053,433212,42863,42722,1806,44528,377
2021-04-23,Napa,055,140530,9744,9752,32,9784,79
2021-04-23,Nevada,057,99092,4602,4510,185,4695,70
2021-04-23,Orange,059,3164182,253741,252399,11014,263413,4904
2021-04-23,Placer,061,380077,22550,21959,1387,23346,282
2021-04-23,Plumas,063,18699,685,670,10,680,4
2021-04-23,Riverside,065,2383286,292125,286456,13692,300148,4399
2021-04-23,Sacramento,067,1510023,102740,102041,1589,103630,1586
2021-04-23,San Benito,069,59416,5996,6005,109,6114,63
2021-04-23,San Bernardino,071,2135413,291469,290189,8820,299009,4568
2021-04-23,San Diego,073,3302833,276842,275097,14375,289472,3684
2021-04-23,San Francisco,075,870044,36100,36252,1234,37486,532
2021-04-23,San Joaquin,077,732212,71609,70840,3347,74187,1295
2021-04-23,San Luis Obispo,079,281455,21072,20781,702,21483,255
2021-04-23,San Mateo,081,765935,41709,41386,447,41833,355
2021-04-23,Santa Barbara,083,443738,34070,33895,1104,34999,447
2021-04-23,Santa Clara,085,1922200,117173,117593,711,118304,1965
2021-04-23,Santa Cruz,087,273765,16079,15802,790,16592,205
2021-04-23,Shasta,089,179085,11733,11759,1425,13184,192
2021-04-23,Sierra,091,2930,55,51,12,63,0
2021-04-23,Siskiyou,093,43540,1691,1567,285,1852,11
2021-04-23,Solano,095,438530,31924,31784,474,32258,247
2021-04-23,Sonoma,097,501317,29560,29727,304,30031,318
2021-04-23,Stanislaus,099,539301,54769,54391,5714,60105,744
2021-04-23,Sutter,101,95872,9288,9312,80,9392,110
2021-04-23,Tehama,103,63373,4939,4906,537,5443,53
2021-04-23,Trinity,105,12862,482,326,82,408,3
2021-04-23,Tulare,107,460477,49697,48694,8624,57318,829
2021-04-23,Tuolumne,109,53932,3966,4020,40,4060,58
2021-04-23,Ventura,111,848112,80673,80095,2904,82999,996
2021-04-23,Yolo,113,214977,13708,13647,187,13834,205
2021-04-23,Yuba,115,75493,5878,5828,119,5947,44
2021-04-22,Alameda,001,1643700,86167,85829,1839,87668,1253
2021-04-22,Alpine,003,1148,86,86,0,86,0
2021-04-22,Amador,005,37829,3635,3633,32,3665,46
2021-04-22,Butte,007,227075,12038,11656,1713,13369,196
2021-04-22,Calaveras,009,45235,2068,2059,11,2070,50
2021-04-22,Colusa,011,21464,1918,1920,287,2207,14
2021-04-22,Contra Costa,013,1133247,67728,67029,1184,68213,782
2021-04-22,Del Norte,015,27424,1284,1252,11,1263,6
2021-04-22,El Dorado,017,186661,9893,9773,695,10468,106
2021-04-22,Fresno,019,978130,101339,100864,8386,109250,1657
2021-04-22,Glenn,021,27897,2383,2361,534,2895,17
2021-04-22,Humboldt,023,135768,3765,3680,30,3710,35
2021-04-22,Imperial,025,180216,28180,28096,2609,30705,720
2021-04-22,Inyo,027,18085,1396,1394,10,1404,36
2021-04-22,Kern,029,883053,96300,95292,10444,105736,1299
2021-04-22,Kings,031,150075,22953,22725,1038,23763,243
2021-04-22,Lake,033,64148,3442,3423,9,3432,43
2021-04-22,Lassen,035,31185,5168,5155,103,5258,1
2021-04-22,Los Angeles,037,10098052,1199405,1189878,40352,1230230,23762
2021-04-22,Madera,039,155013,16423,16316,907,17223,231
2021-04-22,Marin,041,260295,13887,13832,231,14063,227
2021-04-22,Mariposa,043,17540,414,403,11,414,5
2021-04-22,Mendocino,045,87422,3812,3729,73,3802,46
2021-04-22,Merced,047,269075,30457,30490,1008,31498,443
2021-04-22,Modoc,049,8938,365,360,121,481,3
2021-04-22,Mono,051,14174,1244,1254,16,1270,3
2021-04-22,Monterey,053,433212,42856,42708,1804,44512,377
2021-04-22,Napa,055,140530,9734,9734,32,9766,79
2021-04-22,Nevada,057,99092,4592,4504,183,4687,70
2021-04-22,Orange,059,3164182,253668,252307,11001,263308,4898
2021-04-22,Placer,061,380077,22519,21916,1383,23299,282
2021-04-22,Plumas,063,18699,684,670,10,680,4
2021-04-22,Riverside,065,2383286,292026,286362,13683,300045,4398
2021-04-22,Sacramento,067,1510023,102591,101870,1580,103450,1585
2021-04-22,San Benito,069,59416,5992,5998,109,6107,63
2021-04-22,San Bernardino,071,2135413,291400,290125,8811,298936,4571
2021-04-22,San Diego,073,3302833,276676,275913,14353,290266,3684
2021-04-22,San Francisco,075,870044,36077,36218,1231,37449,532
2021-04-22,San Joaquin,077,732212,71550,70751,3340,74091,1295
2021-04-22,San Luis Obispo,079,281455,21058,20761,702,21463,255
2021-04-22,San Mateo,081,765935,41683,41345,445,41790,355
2021-04-22,Santa Barbara,083,443738,34047,33870,1103,34973,446
2021-04-22,Santa Clara,085,1922200,117085,117457,707,118164,1954
2021-04-22,Santa Cruz,087,273765,16076,15737,789,16526,205
2021-04-22,Shasta,089,179085,11718,11738,1423,13161,192
2021-04-22,Sierra,091,2930,55,51,12,63,0
2021-04-22,Siskiyou,093,43540,1687,1564,284,1848,11
2021-04-22,Solano,095,438530,31878,31731,471,32202,247
2021-04-22,Sonoma,097,501317,29545,29705,300,30005,318
2021-04-22,Stanislaus,099,539301,54696,54313,5708,60021,744
2021-04-22,Sutter,101,95872,9284,9302,80,9382,110
2021-04-22,Tehama,103,63373,4933,4896,533,5429,53
2021-04-22,Trinity,105,12862,482,326,82,408,3
2021-04-22,Tulare,107,460477,49677,48669,8615,57284,828
2021-04-22,Tuolumne,109,53932,3962,4020,40,4060,58
2021-04-22,Ventura,111,848112,80647,80073,2902,82975,996
2021-04-22,Yolo,113,214977,13687,13616,187,13803,205
2021-04-22,Yuba,115,75493,5868,5825,119,5944,44
2021-04-21,Alameda,001,1643700,86088,85762,1837,87599,1249
2021-04-21,Alpine,003,1148,86,86,0,86,0
2021-04-21,Amador,005,37829,3632,3632,32,3664,46
2021-04-21,Butte,007,227075,12018,11643,1711,13354,196
2021-04-21,Calaveras,009,45235,2060,2057,11,2068,50
2021-04-21,Colusa,011,21464,1916,1920,286,2206,14
2021-04-21,Contra Costa,013,1133247,67662,66981,1183,68164,782
2021-04-21,Del Norte,015,27424,1280,1252,11,1263,6
2021-04-21,El Dorado,017,186661,9876,9760,692,10452,106
2021-04-21,Fresno,019,978130,101283,100838,8380,109218,1654
2021-04-21,Glenn,021,27897,2382,2361,534,2895,17
2021-04-21,Humboldt,023,135768,3746,3642,30,3672,35
2021-04-21,Imperial,025,180216,28168,28052,2608,30660,719
2021-04-21,Inyo,027,18085,1396,1392,10,1402,36
2021-04-21,Kern,029,883053,96254,95257,10434,105691,1297
2021-04-21,Kings,031,150075,22946,22713,1037,23750,243
2021-04-21,Lake,033,64148,3439,3421,9,3430,43
2021-04-21,Lassen,035,31185,5167,5156,103,5259,1
2021-04-21,Los Angeles,037,10098052,1199063,1189530,40333,1229863,23729
2021-04-21,Madera,039,155013,16418,16309,907,17216,231
2021-04-21,Marin,041,260295,13872,13822,231,14053,227
2021-04-21,Mariposa,043,17540,413,402,11,413,5
2021-04-21,Mendocino,045,87422,3810,3729,73,3802,46
2021-04-21,Merced,047,269075,30437,30471,1006,31477,442
2021-04-21,Modoc,049,8938,365,360,121,481,3
2021-04-21,Mono,051,14174,1244,1254,16,1270,3
2021-04-21,Monterey,053,433212,42841,42699,1802,44501,377
2021-04-21,Napa,055,140530,9728,9727,32,9759,79
2021-04-21,Nevada,057,99092,4578,4499,183,4682,70
2021-04-21,Orange,059,3164182,253592,252243,10988,263231,4889
2021-04-21,Placer,061,380077,22488,21896,1378,23274,282
2021-04-21,Plumas,063,18699,684,670,10,680,4
2021-04-21,Riverside,065,2383286,291932,286299,13676,299975,4388
2021-04-21,Sacramento,067,1510023,102462,101803,1574,103377,1579
2021-04-21,San Benito,069,59416,5989,5998,109,6107,63
2021-04-21,San Bernardino,071,2135413,291324,290049,8809,298858,4572
2021-04-21,San Diego,073,3302833,276467,275632,14315,289947,3681
2021-04-21,San Francisco,075,870044,36057,36194,1230,37424,529
2021-04-21,San Joaquin,077,732212,71495,70687,3330,74017,1295
2021-04-21,San Luis Obispo,079,281455,21043,20724,701,21425,255
2021-04-21,San Mateo,081,765935,41652,41318,444,41762,355
2021-04-21,Santa Barbara,083,443738,34028,33830,1102,34932,445
2021-04-21,Santa Clara,085,1922200,117007,117318,701,118019,1946
2021-04-21,Santa Cruz,087,273765,16067,15698,789,16487,204
2021-04-21,Shasta,089,179085,11699,11722,1421,13143,192
2021-04-21,Sierra,091,2930,55,51,12,63,0
2021-04-21,Siskiyou,093,43540,1680,1557,284,1841,11
2021-04-21,Solano,095,438530,31839,31712,470,32182,244
2021-04-21,Sonoma,097,501317,29533,29697,299,29996,318
2021-04-21,Stanislaus,099,539301,54635,54290,5702,59992,742
2021-04-21,Sutter,101,95872,9276,9297,80,9377,110
2021-04-21,Tehama,103,63373,4926,4893,532,5425,53
2021-04-21,Trinity,105,12862,482,326,82,408,3
2021-04-21,Tulare,107,460477,49662,48653,8602,57255,828
2021-04-21,Tuolumne,109,53932,3959,4019,40,4059,58
2021-04-21,Ventura,111,848112,80615,80039,2899,82938,996
2021-04-21,Yolo,113,214977,13667,13606,186,13792,200
2021-04-21,Yuba,115,75493,5861,5822,118,5940,44
2021-04-20,Alameda,001,1643700,85993,85652,1835,87487,1248
2021-04-20,Alpine,003,1148,85,85,0,85,0
2021-04-20,Amador,005,37829,3631,3631,32,3663,46
2021-04-20,Butte,007,227075,11999,11619,1709,13328,196
2021-04-20,Calaveras,009,45235,2059,2053,11,2064,50
2021-04-20,Colusa,011,21464,1916,1915,285,2200,14
2021-04-20,Contra Costa,013,1133247,67578,66889,1180,68069,782
2021-04-20,Del Norte,015,27424,1279,1250,11,1261,6
2021-04-20,El Dorado,017,186661,9848,9743,690,10433,106
2021-04-20,Fresno,019,978130,101225,100768,8370,109138,1650
2021-04-20,Glenn,021,27897,2380,2359,533,2892,17
2021-04-20,Humboldt,023,135768,3728,3612,30,3642,35
2021-04-20,Imperial,025,180216,28149,28024,2604,30628,719
2021-04-20,Inyo,027,18085,1396,1393,10,1403,36
2021-04-20,Kern,029,883053,96218,95223,10418,105641,1295
2021-04-20,Kings,031,150075,22940,22693,1034,23727,243
2021-04-20,Lake,033,64148,3437,3418,9,3427,43
2021-04-20,Lassen,035,31185,5167,5155,103,5258,1
2021-04-20,Los Angeles,037,10098052,1198715,1189256,40303,1229559,23694
2021-04-20,Madera,039,155013,16412,16301,907,17208,231
2021-04-20,Marin,041,260295,13858,13807,231,14038,227
2021-04-20,Mariposa,043,17540,412,402,11,413,5
2021-04-20,Mendocino,045,87422,3809,3726,73,3799,46
2021-04-20,Merced,047,269075,30410,30439,1005,31444,441
2021-04-20,Modoc,049,8938,365,359,121,480,3
2021-04-20,Mono,051,14174,1243,1254,16,1270,3
2021-04-20,Monterey,053,433212,42830,42663,1800,44463,363
2021-04-20,Napa,055,140530,9724,9711,32,9743,79
2021-04-20,Nevada,057,99092,4560,4485,183,4668,70
2021-04-20,Orange,059,3164182,253502,252134,10976,263110,4887
2021-04-20,Placer,061,380077,22454,21846,1374,23220,282
2021-04-20,Plumas,063,18699,683,670,10,680,4
2021-04-20,Riverside,065,2383286,291835,286194,13671,299865,4388
2021-04-20,Sacramento,067,1510023,102324,101629,1566,103195,1574
2021-04-20,San Benito,069,59416,5986,5988,109,6097,63
2021-04-20,San Bernardino,071,2135413,291243,289905,8807,298712,4569
2021-04-20,San Diego,073,3302833,276236,275369,14282,289651,3674
2021-04-20,San Francisco,075,870044,36038,36117,1229,37346,529
2021-04-20,San Joaquin,077,732212,71422,70590,3321,73911,1289
2021-04-20,San Luis Obispo,079,281455,21020,20691,693,21384,254
2021-04-20,San Mateo,081,765935,41621,41251,444,41695,355
2021-04-20,Santa Barbara,083,443738,34009,33803,1102,34905,445
2021-04-20,Santa Clara,085,1922200,116909,117228,697,117925,1944
2021-04-20,Santa Cruz,087,273765,16055,15647,789,16436,204
2021-04-20,Shasta,089,179085,11683,11677,1418,13095,189
2021-04-20,Sierra,091,2930,55,51,12,63,0
2021-04-20,Siskiyou,093,43540,1672,1551,283,1834,10
2021-04-20,Solano,095,438530,31784,31673,466,32139,243
2021-04-20,Sonoma,097,501317,29524,29676,297,29973,311
2021-04-20,Stanislaus,099,539301,54570,54236,5689,59925,735
2021-04-20,Sutter,101,95872,9272,9279,80,9359,109
2021-04-20,Tehama,103,63373,4921,4887,531,5418,52
2021-04-20,Trinity,105,12862,482,326,82,408,3
2021-04-20,Tulare,107,460477,49640,48650,8594,57244,831
2021-04-20,Tuolumne,109,53932,3959,4014,40,4054,58
2021-04-20,Ventura,111,848112,80587,80018,2897,82915,995
2021-04-20,Yolo,113,214977,13647,13581,185,13766,200
2021-04-20,Yuba,115,75493,5851,5814,118,5932,44
2021-04-19,Alameda,001,1643700,85875,85583,1831,87414,1247
2021-04-19,Alpine,003,1148,85,85,0,85,0
2021-04-19,Amador,005,37829,3630,3629,32,3661,46
2021-04-19,Butte,007,227075,11981,11601,1704,13305,196
2021-04-19,Calaveras,009,45235,2057,2050,11,2061,50
2021-04-19,Colusa,011,21464,1916,1913,284,2197,14
2021-04-19,Contra Costa,013,1133247,67500,66833,1178,68011,782
2021-04-19,Del Norte,015,27424,1277,1247,11,1258,6
2021-04-19,El Dorado,017,186661,9832,9726,685,10411,106
2021-04-19,Fresno,019,978130,101157,100702,8358,109060,1646
2021-04-19,Glenn,021,27897,2380,2358,532,2890,17
2021-04-19,Humboldt,023,135768,3708,3602,28,3630,35
2021-04-19,Imperial,025,180216,28128,27995,2604,30599,719
2021-04-19,Inyo,027,18085,1396,1392,10,1402,36
2021-04-19,Kern,029,883053,96188,95162,10403,105565,1290
2021-04-19,Kings,031,150075,22925,22688,1034,23722,243
2021-04-19,Lake,033,64148,3436,3416,9,3425,43
2021-04-19,Lassen,035,31185,5166,5156,103,5259,1
2021-04-19,Los Angeles,037,10098052,1198335,1188945,40279,1229224,23666
2021-04-19,Madera,039,155013,16401,16289,906,17195,231
2021-04-19,Marin,041,260295,13847,13804,230,14034,226
2021-04-19,Mariposa,043,17540,411,401,11,412,5
2021-04-19,Mendocino,045,87422,3807,3722,73,3795,46
2021-04-19,Merced,047,269075,30381,30422,1004,31426,441
2021-04-19,Modoc,049,8938,365,359,121,480,3
2021-04-19,Mono,051,14174,1242,1254,16,1270,3
2021-04-19,Monterey,053,433212,42817,42642,1795,44437,356
2021-04-19,Napa,055,140530,9716,9680,32,9712,79
2021-04-19,Nevada,057,99092,4544,4477,183,4660,70
2021-04-19,Orange,059,3164182,253384,252013,10961,262974,4883
2021-04-19,Placer,061,380077,22431,21814,1370,23184,282
2021-04-19,Plumas,063,18699,683,665,10,675,4
2021-04-19,Riverside,065,2383286,291740,286087,13661,299748,4371
2021-04-19,Sacramento,067,1510023,102188,101482,1556,103038,1572
2021-04-19,San Benito,069,59416,5978,5989,109,6098,63
2021-04-19,San Bernardino,071,2135413,291158,289738,8801,298539,4561
2021-04-19,San Diego,073,3302833,275988,275113,14249,289362,3674
2021-04-19,San Francisco,075,870044,36001,36094,1227,37321,529
2021-04-19,San Joaquin,077,732212,71342,70514,3315,73829,1289
2021-04-19,San Luis Obispo,079,281455,20994,20669,687,21356,254
2021-04-19,San Mateo,081,765935,41588,41226,443,41669,355
2021-04-19,Santa Barbara,083,443738,33995,33786,1102,34888,446
2021-04-19,Santa Clara,085,1922200,116798,117099,693,117792,1944
2021-04-19,Santa Cruz,087,273765,16043,15600,789,16389,204
2021-04-19,Shasta,089,179085,11668,11662,1410,13072,189
2021-04-19,Sierra,091,2930,55,51,12,63,0
2021-04-19,Siskiyou,093,43540,1662,1544,283,1827,10
2021-04-19,Solano,095,438530,31745,31643,461,32104,239
2021-04-19,Sonoma,097,501317,29505,29667,297,29964,311
2021-04-19,Stanislaus,099,539301,54494,54179,5685,59864,728
2021-04-19,Sutter,101,95872,9261,9269,80,9349,109
2021-04-19,Tehama,103,63373,4915,4878,531,5409,52
2021-04-19,Trinity,105,12862,482,326,81,407,3
2021-04-19,Tulare,107,460477,49624,48630,8581,57211,831
2021-04-19,Tuolumne,109,53932,3958,4010,40,4050,58
2021-04-19,Ventura,111,848112,80561,80000,2895,82895,996
2021-04-19,Yolo,113,214977,13635,13572,182,13754,200
2021-04-19,Yuba,115,75493,5844,5804,117,5921,44
2021-04-18,Alameda,001,1643700,85760,85481,1823,87304,1247
2021-04-18,Alpine,003,1148,85,85,0,85,0
2021-04-18,Amador,005,37829,3627,3627,32,3659,46
2021-04-18,Butte,007,227075,11963,11591,1699,13290,196
2021-04-18,Calaveras,009,45235,2051,2047,11,2058,50
2021-04-18,Colusa,011,21464,1912,1912,283,2195,14
2021-04-18,Contra Costa,013,1133247,67397,66750,1174,67924,782
2021-04-18,Del Norte,015,27424,1277,1240,11,1251,6
2021-04-18,El Dorado,017,186661,9809,9710,683,10393,106
2021-04-18,Fresno,019,978130,101099,100621,8352,108973,1646
2021-04-18,Glenn,021,27897,2375,2358,532,2890,17
2021-04-18,Humboldt,023,135768,3680,3590,28,3618,35
2021-04-18,Imperial,025,180216,28113,27991,2599,30590,719
2021-04-18,Inyo,027,18085,1395,1392,10,1402,36
2021-04-18,Kern,029,883053,96152,95129,10388,105517,1290
2021-04-18,Kings,031,150075,22916,22685,1034,23719,243
2021-04-18,Lake,033,64148,3435,3413,9,3422,43
2021-04-18,Lassen,035,31185,5163,5156,103,5259,1
2021-04-18,Los Angeles,037,10098052,1197875,1188620,40256,1228876,23648
2021-04-18,Madera,039,155013,16390,16277,905,17182,231
2021-04-18,Marin,041,260295,13840,13801,229,14030,226
2021-04-18,Mariposa,043,17540,410,400,10,410,5
2021-04-18,Mendocino,045,87422,3804,3722,73,3795,46
2021-04-18,Merced,047,269075,30344,30405,1003,31408,441
2021-04-18,Modoc,049,8938,365,359,121,480,3
2021-04-18,Mono,051,14174,1242,1254,16,1270,3
2021-04-18,Monterey,053,433212,42805,42638,1794,44432,356
2021-04-18,Napa,055,140530,9700,9674,32,9706,79
2021-04-18,Nevada,057,99092,4529,4464,183,4647,70
2021-04-18,Orange,059,3164182,253270,251940,10954,262894,4883
2021-04-18,Placer,061,380077,22388,21783,1365,23148,282
2021-04-18,Plumas,063,18699,682,665,10,675,4
2021-04-18,Riverside,065,2383286,291650,286043,13657,299700,4371
2021-04-18,Sacramento,067,1510023,102013,101354,1550,102904,1572
2021-04-18,San Benito,069,59416,5976,5989,109,6098,63
2021-04-18,San Bernardino,071,2135413,291065,289691,8792,298483,4556
2021-04-18,San Diego,073,3302833,275709,274961,14214,289175,3674
2021-04-18,San Francisco,075,870044,35964,36073,1223,37296,525
2021-04-18,San Joaquin,077,732212,71261,70466,3306,73772,1289
2021-04-18,San Luis Obispo,079,281455,20972,20656,681,21337,254
2021-04-18,San Mateo,081,765935,41559,41201,442,41643,352
2021-04-18,Santa Barbara,083,443738,33960,33769,1101,34870,446
2021-04-18,Santa Clara,085,1922200,116631,116996,688,117684,1944
2021-04-18,Santa Cruz,087,273765,16033,15580,788,16368,204
2021-04-18,Shasta,089,179085,11647,11658,1407,13065,189
2021-04-18,Sierra,091,2930,55,51,12,63,0
2021-04-18,Siskiyou,093,43540,1651,1538,282,1820,10
2021-04-18,Solano,095,438530,31695,31606,460,32066,239
2021-04-18,Sonoma,097,501317,29489,29660,295,29955,311
2021-04-18,Stanislaus,099,539301,54412,54132,5679,59811,728
2021-04-18,Sutter,101,95872,9247,9261,80,9341,109
2021-04-18,Tehama,103,63373,4906,4877,530,5407,52
2021-04-18,Trinity,105,12862,482,326,81,407,3
2021-04-18,Tulare,107,460477,49611,48618,8576,57194,829
2021-04-18,Tuolumne,109,53932,3957,4008,39,4047,58
2021-04-18,Ventura,111,848112,80530,79984,2892,82876,996
2021-04-18,Yolo,113,214977,13623,13562,180,13742,200
2021-04-18,Yuba,115,75493,5837,5804,117,5921,44
2021-04-17,Alameda,001,1643700,85685,85367,1821,87188,1247
2021-04-17,Alpine,003,1148,85,85,0,85,0
2021-04-17,Amador,005,37829,3625,3625,32,3657,46
2021-04-17,Butte,007,227075,11943,11573,1695,13268,196
2021-04-17,Calaveras,009,45235,2049,2045,11,2056,50
2021-04-17,Colusa,011,21464,1912,1912,283,2195,14
2021-04-17,Contra Costa,013,1133247,67349,66657,1166,67823,782
2021-04-17,Del Norte,015,27424,1277,1238,11,1249,6
2021-04-17,El Dorado,017,186661,9794,9692,680,10372,106
2021-04-17,Fresno,019,978130,101066,100562,8347,108909,1646
2021-04-17,Glenn,021,27897,2375,2357,532,2889,17
2021-04-17,Humboldt,023,135768,3656,3579,28,3607,35
2021-04-17,Imperial,025,180216,28102,27987,2599,30586,719
2021-04-17,Inyo,027,18085,1392,1392,10,1402,36
2021-04-17,Kern,029,883053,96134,95102,10384,105486,1290
2021-04-17,Kings,031,150075,22911,22678,1033,23711,243
2021-04-17,Lake,033,64148,3434,3409,9,3418,43
2021-04-17,Lassen,035,31185,5163,5154,103,5257,1
2021-04-17,Los Angeles,037,10098052,1197617,1188262,40224,1228486,23653
2021-04-17,Madera,039,155013,16386,16260,904,17164,231
2021-04-17,Marin,041,260295,13836,13797,229,14026,226
2021-04-17,Mariposa,043,17540,409,398,10,408,5
2021-04-17,Mendocino,045,87422,3801,3721,73,3794,46
2021-04-17,Merced,047,269075,30328,30392,1002,31394,441
2021-04-17,Modoc,049,8938,365,357,121,478,3
2021-04-17,Mono,051,14174,1242,1253,16,1269,3
2021-04-17,Monterey,053,433212,42796,42630,1792,44422,356
2021-04-17,Napa,055,140530,9696,9666,32,9698,79
2021-04-17,Nevada,057,99092,4521,4457,183,4640,70
2021-04-17,Orange,059,3164182,253201,251873,10942,262815,4878
2021-04-17,Placer,061,380077,22365,21736,1360,23096,282
2021-04-17,Plumas,063,18699,681,666,10,676,4
2021-04-17,Riverside,065,2383286,291581,285963,13649,299612,4371
2021-04-17,Sacramento,067,1510023,101903,101172,1539,102711,1572
2021-04-17,San Benito,069,59416,5970,5986,109,6095,63
2021-04-17,San Bernardino,071,2135413,291010,289624,8789,298413,4555
2021-04-17,San Diego,073,3302833,275562,274812,14180,288992,3674
2021-04-17,San Francisco,075,870044,35942,36032,1220,37252,523
2021-04-17,San Joaquin,077,732212,71221,70372,3296,73668,1288
2021-04-17,San Luis Obispo,079,281455,20959,20642,678,21320,254
2021-04-17,San Mateo,081,765935,41536,41157,442,41599,352
2021-04-17,Santa Barbara,083,443738,33929,33738,1099,34837,446
2021-04-17,Santa Clara,085,1922200,116539,116887,686,117573,1944
2021-04-17,Santa Cruz,087,273765,16027,15571,788,16359,204
2021-04-17,Shasta,089,179085,11632,11647,1406,13053,189
2021-04-17,Sierra,091,2930,55,51,12,63,0
2021-04-17,Siskiyou,093,43540,1646,1539,279,1818,10
2021-04-17,Solano,095,438530,31664,31541,457,31998,239
2021-04-17,Sonoma,097,501317,29482,29637,295,29932,311
2021-04-17,Stanislaus,099,539301,54375,54058,5674,59732,728
2021-04-17,Sutter,101,95872,9241,9252,80,9332,109
2021-04-17,Tehama,103,63373,4900,4875,529,5404,52
2021-04-17,Trinity,105,12862,482,326,81,407,3
2021-04-17,Tulare,107,460477,49599,48603,8572,57175,829
2021-04-17,Tuolumne,109,53932,3955,4005,39,4044,58
2021-04-17,Ventura,111,848112,80509,79964,2892,82856,996
2021-04-17,Yolo,113,214977,13613,13580,180,13760,200
2021-04-17,Yuba,115,75493,5832,5802,116,5918,44
2021-04-16,Alameda,001,1643700,85606,85243,1819,87062,1245
2021-04-16,Alpine,003,1148,85,85,0,85,0
2021-04-16,Amador,005,37829,3620,3621,32,3653,46
2021-04-16,Butte,007,227075,11931,11549,1693,13242,196
2021-04-16,Calaveras,009,45235,2047,2042,11,2053,50
2021-04-16,Colusa,011,21464,1910,1911,283,2194,14
2021-04-16,Contra Costa,013,1133247,67295,66569,1163,67732,782
2021-04-16,Del Norte,015,27424,1276,1237,11,1248,6
2021-04-16,El Dorado,017,186661,9774,9665,676,10341,106
2021-04-16,Fresno,019,978130,101016,100500,8341,108841,1643
2021-04-16,Glenn,021,27897,2375,2355,532,2887,17
2021-04-16,Humboldt,023,135768,3635,3570,27,3597,35
2021-04-16,Imperial,025,180216,28092,27962,2599,30561,719
2021-04-16,Inyo,027,18085,1392,1392,10,1402,36
2021-04-16,Kern,029,883053,96105,95066,10381,105447,1288
2021-04-16,Kings,031,150075,22907,22667,1032,23699,243
2021-04-16,Lake,033,64148,3428,3406,9,3415,43
2021-04-16,Lassen,035,31185,5162,5155,103,5258,1
2021-04-16,Los Angeles,037,10098052,1197316,1187818,40188,1228006,23627
2021-04-16,Madera,039,155013,16380,16250,903,17153,231
2021-04-16,Marin,041,260295,13833,13788,229,14017,226
2021-04-16,Mariposa,043,17540,408,396,9,405,5
2021-04-16,Mendocino,045,87422,3799,3719,73,3792,46
2021-04-16,Merced,047,269075,30313,30355,1002,31357,438
2021-04-16,Modoc,049,8938,365,355,121,476,3
2021-04-16,Mono,051,14174,1242,1253,16,1269,3
2021-04-16,Monterey,053,433212,42785,42620,1789,44409,351
2021-04-16,Napa,055,140530,9688,9653,32,9685,79
2021-04-16,Nevada,057,99092,4512,4443,183,4626,70
2021-04-16,Orange,059,3164182,253137,251770,10933,262703,4873
2021-04-16,Placer,061,380077,22338,21680,1356,23036,282
2021-04-16,Plumas,063,18699,680,665,10,675,4
2021-04-16,Riverside,065,2383286,291504,285818,13647,299465,4369
2021-04-16,Sacramento,067,1510023,101806,100993,1534,102527,1572
2021-04-16,San Benito,069,59416,5968,5982,109,6091,63
2021-04-16,San Bernardino,071,2135413,290963,289424,8788,298212,4550
2021-04-16,San Diego,073,3302833,275408,274567,14162,288729,3662
2021-04-16,San Francisco,075,870044,35917,35993,1217,37210,517
2021-04-16,San Joaquin,077,732212,71154,70280,3288,73568,1288
2021-04-16,San Luis Obispo,079,281455,20947,20623,677,21300,253
2021-04-16,San Mateo,081,765935,41507,41107,441,41548,352
2021-04-16,Santa Barbara,083,443738,33911,33703,1099,34802,446
2021-04-16,Santa Clara,085,1922200,116439,116693,683,117376,1941
2021-04-16,Santa Cruz,087,273765,16025,15539,788,16327,204
2021-04-16,Shasta,089,179085,11620,11623,1405,13028,189
2021-04-16,Sierra,091,2930,55,51,12,63,0
2021-04-16,Siskiyou,093,43540,1642,1530,277,1807,10
2021-04-16,Solano,095,438530,31625,31470,454,31924,239
2021-04-16,Sonoma,097,501317,29471,29617,295,29912,311
2021-04-16,Stanislaus,099,539301,54327,53983,5672,59655,728
2021-04-16,Sutter,101,95872,9235,9247,80,9327,109
2021-04-16,Tehama,103,63373,4899,4866,529,5395,52
2021-04-16,Trinity,105,12862,482,326,81,407,3
2021-04-16,Tulare,107,460477,49587,48583,8568,57151,830
2021-04-16,Tuolumne,109,53932,3952,4005,39,4044,58
2021-04-16,Ventura,111,848112,80484,79942,2887,82829,994
2021-04-16,Yolo,113,214977,13600,13559,178,13737,198
2021-04-16,Yuba,115,75493,5829,5795,115,5910,44
2021-04-15,Alameda,001,1643700,85499,85089,1817,86906,1246
2021-04-15,Alpine,003,1148,85,85,0,85,0
2021-04-15,Amador,005,37829,3619,3616,32,3648,46
2021-04-15,Butte,007,227075,11916,11529,1689,13218,196
2021-04-15,Calaveras,009,45235,2046,2039,11,2050,50
2021-04-15,Colusa,011,21464,1908,1909,282,2191,14
2021-04-15,Contra Costa,013,1133247,67222,66480,1159,67639,781
2021-04-15,Del Norte,015,27424,1269,1235,11,1246,6
2021-04-15,El Dorado,017,186661,9760,9639,674,10313,106
2021-04-15,Fresno,019,978130,100954,100431,8335,108766,1642
2021-04-15,Glenn,021,27897,2375,2354,532,2886,17
2021-04-15,Humboldt,023,135768,3614,3561,27,3588,35
2021-04-15,Imperial,025,180216,28064,27920,2596,30516,718
2021-04-15,Inyo,027,18085,1392,1393,10,1403,36
2021-04-15,Kern,029,883053,96072,94989,10368,105357,1289
2021-04-15,Kings,031,150075,22893,22648,1032,23680,242
2021-04-15,Lake,033,64148,3427,3399,9,3408,43
2021-04-15,Lassen,035,31185,5161,5152,103,5255,1
2021-04-15,Los Angeles,037,10098052,1196911,1187274,40152,1227426,23598
2021-04-15,Madera,039,155013,16365,16234,903,17137,231
2021-04-15,Marin,041,260295,13829,13783,228,14011,226
2021-04-15,Mariposa,043,17540,406,395,9,404,5
2021-04-15,Mendocino,045,87422,3798,3714,73,3787,46
2021-04-15,Merced,047,269075,30287,30325,1001,31326,437
2021-04-15,Modoc,049,8938,365,355,121,476,3
2021-04-15,Mono,051,14174,1241,1253,16,1269,3
2021-04-15,Monterey,053,433212,42775,42604,1787,44391,347
2021-04-15,Napa,055,140530,9680,9645,32,9677,79
2021-04-15,Nevada,057,99092,4500,4434,182,4616,70
2021-04-15,Orange,059,3164182,253042,251679,10921,262600,4857
2021-04-15,Placer,061,380077,22307,21614,1349,22963,281
2021-04-15,Plumas,063,18699,678,665,10,675,4
2021-04-15,Riverside,065,2383286,291400,285698,13640,299338,4363
2021-04-15,Sacramento,067,1510023,101676,100782,1520,102302,1570
2021-04-15,San Benito,069,59416,5965,5969,108,6077,63
2021-04-15,San Bernardino,071,2135413,290873,289288,8781,298069,4544
2021-04-15,San Diego,073,3302833,275161,274250,14103,288353,3653
2021-04-15,San Francisco,075,870044,35898,35947,1215,37162,510
2021-04-15,San Joaquin,077,732212,71073,70189,3280,73469,1288
2021-04-15,San Luis Obispo,079,281455,20931,20591,674,21265,253
2021-04-15,San Mateo,081,765935,41468,41050,440,41490,352
2021-04-15,Santa Barbara,083,443738,33893,33672,1095,34767,446
2021-04-15,Santa Clara,085,1922200,116333,116602,679,117281,1927
2021-04-15,Santa Cruz,087,273765,16015,15509,788,16297,203
2021-04-15,Shasta,089,179085,11606,11597,1401,12998,191
2021-04-15,Sierra,091,2930,55,51,12,63,0
2021-04-15,Siskiyou,093,43540,1636,1524,276,1800,10
2021-04-15,Solano,095,438530,31587,31394,453,31847,239
2021-04-15,Sonoma,097,501317,29457,29587,295,29882,311
2021-04-15,Stanislaus,099,539301,54273,53918,5663,59581,728
2021-04-15,Sutter,101,95872,9228,9237,80,9317,109
2021-04-15,Tehama,103,63373,4898,4854,528,5382,52
2021-04-15,Trinity,105,12862,482,326,81,407,3
2021-04-15,Tulare,107,460477,49566,48556,8568,57124,829
2021-04-15,Tuolumne,109,53932,3952,4003,39,4042,57
2021-04-15,Ventura,111,848112,80465,79917,2885,82802,989
2021-04-15,Yolo,113,214977,13581,13547,176,13723,198
2021-04-15,Yuba,115,75493,5826,5788,115,5903,44
2021-04-14,Alameda,001,1643700,85402,85009,1816,86825,1247
2021-04-14,Alpine,003,1148,85,85,0,85,0
2021-04-14,Amador,005,37829,3618,3613,32,3645,46
2021-04-14,Butte,007,227075,11903,11513,1688,13201,196
2021-04-14,Calaveras,009,45235,2045,2037,11,2048,50
2021-04-14,Colusa,011,21464,1908,1905,282,2187,14
2021-04-14,Contra Costa,013,1133247,67136,66400,1153,67553,781
2021-04-14,Del Norte,015,27424,1269,1228,11,1239,6
2021-04-14,El Dorado,017,186661,9745,9625,669,10294,106
2021-04-14,Fresno,019,978130,100897,100376,8322,108698,1640
2021-04-14,Glenn,021,27897,2375,2353,532,2885,17
2021-04-14,Humboldt,023,135768,3592,3551,26,3577,35
2021-04-14,Imperial,025,180216,28042,27907,2594,30501,718
2021-04-14,Inyo,027,18085,1392,1392,10,1402,36
2021-04-14,Kern,029,883053,96047,94947,10361,105308,1287
2021-04-14,Kings,031,150075,22884,22641,1030,23671,243
2021-04-14,Lake,033,64148,3422,3396,9,3405,43
2021-04-14,Lassen,035,31185,5160,5151,103,5254,1
2021-04-14,Los Angeles,037,10098052,1196512,1186821,40107,1226928,23579
2021-04-14,Madera,039,155013,16356,16218,903,17121,231
2021-04-14,Marin,041,260295,13827,13768,227,13995,226
2021-04-14,Mariposa,043,17540,405,394,9,403,5
2021-04-14,Mendocino,045,87422,3793,3711,73,3784,46
2021-04-14,Merced,047,269075,30271,30296,999,31295,436
2021-04-14,Modoc,049,8938,365,355,121,476,3
2021-04-14,Mono,051,14174,1240,1252,16,1268,3
2021-04-14,Monterey,053,433212,42759,42595,1783,44378,347
2021-04-14,Napa,055,140530,9669,9643,32,9675,79
2021-04-14,Nevada,057,99092,4493,4421,182,4603,70
2021-04-14,Orange,059,3164182,252937,251568,10902,262470,4849
2021-04-14,Placer,061,380077,22274,21575,1348,22923,280
2021-04-14,Plumas,063,18699,678,665,10,675,4
2021-04-14,Riverside,065,2383286,291290,285583,13634,299217,4358
2021-04-14,Sacramento,067,1510023,101501,100645,1506,102151,1570
2021-04-14,San Benito,069,59416,5963,5960,108,6068,62
2021-04-14,San Bernardino,071,2135413,290805,289078,8779,297857,4523
2021-04-14,San Diego,073,3302833,274950,273969,14074,288043,3648
2021-04-14,San Francisco,075,870044,35860,35898,1214,37112,510
2021-04-14,San Joaquin,077,732212,71003,70095,3274,73369,1288
2021-04-14,San Luis Obispo,079,281455,20908,20561,664,21225,253
2021-04-14,San Mateo,081,765935,41428,40982,437,41419,352
2021-04-14,Santa Barbara,083,443738,33864,33650,1095,34745,445
2021-04-14,Santa Clara,085,1922200,116216,116488,676,117164,1922
2021-04-14,Santa Cruz,087,273765,16005,15481,788,16269,203
2021-04-14,Shasta,089,179085,11580,11581,1399,12980,190
2021-04-14,Sierra,091,2930,55,51,12,63,0
2021-04-14,Siskiyou,093,43540,1628,1518,275,1793,10
2021-04-14,Solano,095,438530,31534,31357,446,31803,239
2021-04-14,Sonoma,097,501317,29449,29572,293,29865,311
2021-04-14,Stanislaus,099,539301,54202,53836,5654,59490,727
2021-04-14,Sutter,101,95872,9220,9230,80,9310,106
2021-04-14,Tehama,103,63373,4892,4853,527,5380,52
2021-04-14,Trinity,105,12862,482,326,81,407,3
2021-04-14,Tulare,107,460477,49540,48527,8565,57092,827
2021-04-14,Tuolumne,109,53932,3951,3997,39,4036,57
2021-04-14,Ventura,111,848112,80429,79891,2883,82774,986
2021-04-14,Yolo,113,214977,13565,13530,174,13704,198
2021-04-14,Yuba,115,75493,5824,5778,115,5893,44
2021-04-13,Alameda,001,1643700,85296,84921,1813,86734,1239
2021-04-13,Alpine,003,1148,85,85,0,85,0
2021-04-13,Amador,005,37829,3615,3609,32,3641,46
2021-04-13,Butte,007,227075,11885,11497,1685,13182,196
2021-04-13,Calaveras,009,45235,2043,2035,11,2046,50
2021-04-13,Colusa,011,21464,1906,1905,280,2185,14
2021-04-13,Contra Costa,013,1133247,67048,66304,1153,67457,778
2021-04-13,Del Norte,015,27424,1264,1221,11,1232,6
2021-04-13,El Dorado,017,186661,9719,9609,666,10275,106
2021-04-13,Fresno,019,978130,100816,100357,8316,108673,1636
2021-04-13,Glenn,021,27897,2374,2351,532,2883,17
2021-04-13,Humboldt,023,135768,3575,3540,26,3566,35
2021-04-13,Imperial,025,180216,28023,27887,2586,30473,718
2021-04-13,Inyo,027,18085,1392,1391,10,1401,36
2021-04-13,Kern,029,883053,96003,94908,10349,105257,1285
2021-04-13,Kings,031,150075,22868,22636,1029,23665,243
2021-04-13,Lake,033,64148,3419,3390,9,3399,43
2021-04-13,Lassen,035,31185,5159,5147,103,5250,1
2021-04-13,Los Angeles,037,10098052,1196058,1186482,40066,1226548,23526
2021-04-13,Madera,039,155013,16346,16207,901,17108,231
2021-04-13,Marin,041,260295,13819,13760,226,13986,224
2021-04-13,Mariposa,043,17540,404,394,6,400,5
2021-04-13,Mendocino,045,87422,3787,3702,73,3775,46
2021-04-13,Merced,047,269075,30241,30276,996,31272,435
2021-04-13,Modoc,049,8938,365,355,121,476,3
2021-04-13,Mono,051,14174,1240,1251,16,1267,3
2021-04-13,Monterey,053,433212,42748,42577,1783,44360,347
2021-04-13,Napa,055,140530,9659,9627,32,9659,79
2021-04-13,Nevada,057,99092,4481,4415,182,4597,69
2021-04-13,Orange,059,3164182,252842,251491,10885,262376,4836
2021-04-13,Placer,061,380077,22237,21534,1345,22879,280
2021-04-13,Plumas,063,18699,677,665,10,675,4
2021-04-13,Riverside,065,2383286,291171,285505,13628,299133,4348
2021-04-13,Sacramento,067,1510023,101326,100551,1501,102052,1569
2021-04-13,San Benito,069,59416,5960,5946,108,6054,62
2021-04-13,San Bernardino,071,2135413,290689,288929,8773,297702,4521
2021-04-13,San Diego,073,3302833,274696,273709,14039,287748,3623
2021-04-13,San Francisco,075,870044,35824,35869,1210,37079,506
2021-04-13,San Joaquin,077,732212,70895,70034,3266,73300,1288
2021-04-13,San Luis Obispo,079,281455,20881,20536,654,21190,253
2021-04-13,San Mateo,081,765935,41383,40955,437,41392,353
2021-04-13,Santa Barbara,083,443738,33841,33613,1092,34705,444
2021-04-13,Santa Clara,085,1922200,116087,116363,675,117038,1923
2021-04-13,Santa Cruz,087,273765,15998,15449,788,16237,203
2021-04-13,Shasta,089,179085,11560,11536,1396,12932,189
2021-04-13,Sierra,091,2930,55,51,12,63,0
2021-04-13,Siskiyou,093,43540,1620,1511,272,1783,10
2021-04-13,Solano,095,438530,31485,31335,442,31777,239
2021-04-13,Sonoma,097,501317,29441,29544,292,29836,311
2021-04-13,Stanislaus,099,539301,54130,53797,5645,59442,722
2021-04-13,Sutter,101,95872,9216,9226,80,9306,106
2021-04-13,Tehama,103,63373,4885,4850,524,5374,52
2021-04-13,Trinity,105,12862,482,326,81,407,3
2021-04-13,Tulare,107,460477,49527,48511,8562,57073,825
2021-04-13,Tuolumne,109,53932,3949,3995,39,4034,57
2021-04-13,Ventura,111,848112,80397,79854,2881,82735,986
2021-04-13,Yolo,113,214977,13553,13516,173,13689,198
2021-04-13,Yuba,115,75493,5815,5776,115,5891,44
2021-04-12,Alameda,001,1643700,85194,84817,1812,86629,1238
2021-04-12,Alpine,003,1148,85,85,0,85,0
2021-04-12,Amador,005,37829,3614,3607,32,3639,46
2021-04-12,Butte,007,227075,11870,11488,1681,13169,193
2021-04-12,Calaveras,009,45235,2039,2033,11,2044,50
2021-04-12,Colusa,011,21464,1904,1904,278,2182,14
2021-04-12,Contra Costa,013,1133247,66968,66176,1153,67329,777
2021-04-12,Del Norte,015,27424,1261,1216,11,1227,6
2021-04-12,El Dorado,017,186661,9702,9588,664,10252,106
2021-04-12,Fresno,019,978130,100755,100277,8293,108570,1633
2021-04-12,Glenn,021,27897,2373,2349,532,2881,17
2021-04-12,Humboldt,023,135768,3561,3533,25,3558,35
2021-04-12,Imperial,025,180216,27993,27851,2582,30433,717
2021-04-12,Inyo,027,18085,1392,1390,10,1400,36
2021-04-12,Kern,029,883053,95966,94861,10339,105200,1283
2021-04-12,Kings,031,150075,22860,22621,1028,23649,241
2021-04-12,Lake,033,64148,3415,3380,9,3389,43
2021-04-12,Lassen,035,31185,5158,5147,103,5250,1
2021-04-12,Los Angeles,037,10098052,1195554,1186145,40029,1226174,23505
2021-04-12,Madera,039,155013,16334,16174,899,17073,231
2021-04-12,Marin,041,260295,13806,13751,224,13975,224
2021-04-12,Mariposa,043,17540,403,394,6,400,5
2021-04-12,Mendocino,045,87422,3786,3699,73,3772,46
2021-04-12,Merced,047,269075,30210,30261,993,31254,435
2021-04-12,Modoc,049,8938,363,352,121,473,3
2021-04-12,Mono,051,14174,1240,1251,16,1267,3
2021-04-12,Monterey,053,433212,42734,42555,1781,44336,346
2021-04-12,Napa,055,140530,9645,9603,32,9635,80
2021-04-12,Nevada,057,99092,4470,4408,182,4590,69
2021-04-12,Orange,059,3164182,252756,251350,10864,262214,4826
2021-04-12,Placer,061,380077,22186,21475,1342,22817,278
2021-04-12,Plumas,063,18699,675,666,10,676,4
2021-04-12,Riverside,065,2383286,291060,285361,13622,298983,4336
2021-04-12,Sacramento,067,1510023,101152,100394,1496,101890,1566
2021-04-12,San Benito,069,59416,5952,5942,107,6049,62
2021-04-12,San Bernardino,071,2135413,290582,288736,8761,297497,4493
2021-04-12,San Diego,073,3302833,274435,273431,14010,287441,3621
2021-04-12,San Francisco,075,870044,35790,35841,1209,37050,506
2021-04-12,San Joaquin,077,732212,70823,69968,3259,73227,1288
2021-04-12,San Luis Obispo,079,281455,20836,20515,641,21156,253
2021-04-12,San Mateo,081,765935,41341,40920,433,41353,353
2021-04-12,Santa Barbara,083,443738,33809,33606,1092,34698,444
2021-04-12,Santa Clara,085,1922200,115959,116252,673,116925,1923
2021-04-12,Santa Cruz,087,273765,15978,15406,788,16194,203
2021-04-12,Shasta,089,179085,11543,11509,1392,12901,189
2021-04-12,Sierra,091,2930,55,51,12,63,0
2021-04-12,Siskiyou,093,43540,1609,1511,269,1780,7
2021-04-12,Solano,095,438530,31443,31305,439,31744,238
2021-04-12,Sonoma,097,501317,29413,29500,292,29792,310
2021-04-12,Stanislaus,099,539301,54064,53722,5638,59360,707
2021-04-12,Sutter,101,95872,9205,9221,80,9301,106
2021-04-12,Tehama,103,63373,4876,4834,520,5354,52
2021-04-12,Trinity,105,12862,482,324,81,405,3
2021-04-12,Tulare,107,460477,49507,48495,8552,57047,824
2021-04-12,Tuolumne,109,53932,3945,3993,39,4032,57
2021-04-12,Ventura,111,848112,80364,79818,2879,82697,985
2021-04-12,Yolo,113,214977,13539,13510,172,13682,198
2021-04-12,Yuba,115,75493,5809,5773,115,5888,43
2021-04-11,Alameda,001,1643700,85057,84756,1807,86563,1238
2021-04-11,Alpine,003,1148,85,85,0,85,0
2021-04-11,Amador,005,37829,3612,3605,32,3637,46
2021-04-11,Butte,007,227075,11836,11487,1677,13164,193
2021-04-11,Calaveras,009,45235,2035,2036,11,2047,50
2021-04-11,Colusa,011,21464,1903,1904,277,2181,14
2021-04-11,Contra Costa,013,1133247,66859,66107,1151,67258,777
2021-04-11,Del Norte,015,27424,1255,1214,11,1225,6
2021-04-11,El Dorado,017,186661,9688,9575,661,10236,106
2021-04-11,Fresno,019,978130,100687,100230,8283,108513,1633
2021-04-11,Glenn,021,27897,2368,2348,532,2880,17
2021-04-11,Humboldt,023,135768,3551,3523,25,3548,35
2021-04-11,Imperial,025,180216,27969,27841,2580,30421,717
2021-04-11,Inyo,027,18085,1392,1390,10,1400,36
2021-04-11,Kern,029,883053,95905,94830,10331,105161,1283
2021-04-11,Kings,031,150075,22851,22618,1025,23643,241
2021-04-11,Lake,033,64148,3411,3377,9,3386,43
2021-04-11,Lassen,035,31185,5154,5147,103,5250,1
2021-04-11,Los Angeles,037,10098052,1195042,1185757,39987,1225744,23503
2021-04-11,Madera,039,155013,16315,16166,898,17064,231
2021-04-11,Marin,041,260295,13799,13741,223,13964,226
2021-04-11,Mariposa,043,17540,403,394,6,400,5
2021-04-11,Mendocino,045,87422,3784,3696,73,3769,46
2021-04-11,Merced,047,269075,30172,30249,992,31241,435
2021-04-11,Modoc,049,8938,362,352,119,471,3
2021-04-11,Mono,051,14174,1239,1250,16,1266,3
2021-04-11,Monterey,053,433212,42728,42547,1774,44321,346
2021-04-11,Napa,055,140530,9634,9592,32,9624,80
2021-04-11,Nevada,057,99092,4456,4394,182,4576,69
2021-04-11,Orange,059,3164182,252629,251233,10853,262086,4826
2021-04-11,Placer,061,380077,22129,21458,1337,22795,278
2021-04-11,Plumas,063,18699,675,666,10,676,4
2021-04-11,Riverside,065,2383286,290926,285269,13612,298881,4336
2021-04-11,Sacramento,067,1510023,100982,100296,1484,101780,1566
2021-04-11,San Benito,069,59416,5944,5941,106,6047,62
2021-04-11,San Bernardino,071,2135413,290475,288686,8755,297441,4492
2021-04-11,San Diego,073,3302833,274137,273287,13951,287238,3621
2021-04-11,San Francisco,075,870044,35754,35815,1206,37021,498
2021-04-11,San Joaquin,077,732212,70737,69939,3248,73187,1288
2021-04-11,San Luis Obispo,079,281455,20810,20501,638,21139,253
2021-04-11,San Mateo,081,765935,41283,40901,432,41333,353
2021-04-11,Santa Barbara,083,443738,33774,33591,1091,34682,444
2021-04-11,Santa Clara,085,1922200,115823,116161,670,116831,1923
2021-04-11,Santa Cruz,087,273765,15966,15382,788,16170,203
2021-04-11,Shasta,089,179085,11499,11504,1391,12895,189
2021-04-11,Sierra,091,2930,55,51,12,63,0
2021-04-11,Siskiyou,093,43540,1602,1509,266,1775,7
2021-04-11,Solano,095,438530,31390,31268,435,31703,238
2021-04-11,Sonoma,097,501317,29387,29496,288,29784,310
2021-04-11,Stanislaus,099,539301,53981,53683,5629,59312,707
2021-04-11,Sutter,101,95872,9196,9222,80,9302,106
2021-04-11,Tehama,103,63373,4873,4832,519,5351,52
2021-04-11,Trinity,105,12862,482,324,81,405,3
2021-04-11,Tulare,107,460477,49493,48479,8545,57024,824
2021-04-11,Tuolumne,109,53932,3943,3993,39,4032,57
2021-04-11,Ventura,111,848112,80316,79800,2874,82674,985
2021-04-11,Yolo,113,214977,13519,13496,170,13666,198
2021-04-11,Yuba,115,75493,5799,5768,115,5883,43
2021-04-10,Alameda,001,1643700,84993,84626,1807,86433,1238
2021-04-10,Alpine,003,1148,85,85,0,85,0
2021-04-10,Amador,005,37829,3610,3603,32,3635,46
2021-04-10,Butte,007,227075,11825,11482,1676,13158,193
2021-04-10,Calaveras,009,45235,2033,2032,11,2043,50
2021-04-10,Colusa,011,21464,1903,1902,277,2179,14
2021-04-10,Contra Costa,013,1133247,66798,66001,1148,67149,778
2021-04-10,Del Norte,015,27424,1252,1212,11,1223,6
2021-04-10,El Dorado,017,186661,9676,9549,658,10207,106
2021-04-10,Fresno,019,978130,100654,100135,8276,108411,1633
2021-04-10,Glenn,021,27897,2368,2343,532,2875,17
2021-04-10,Humboldt,023,135768,3541,3508,25,3533,35
2021-04-10,Imperial,025,180216,27955,27816,2580,30396,717
2021-04-10,Inyo,027,18085,1392,1387,10,1397,36
2021-04-10,Kern,029,883053,95891,94802,10325,105127,1284
2021-04-10,Kings,031,150075,22847,22614,1023,23637,241
2021-04-10,Lake,033,64148,3406,3368,9,3377,43
2021-04-10,Lassen,035,31185,5154,5146,102,5248,1
2021-04-10,Los Angeles,037,10098052,1194767,1185246,39970,1225216,23493
2021-04-10,Madera,039,155013,16307,16143,897,17040,231
2021-04-10,Marin,041,260295,13794,13731,223,13954,226
2021-04-10,Mariposa,043,17540,400,393,6,399,5
2021-04-10,Mendocino,045,87422,3782,3696,73,3769,46
2021-04-10,Merced,047,269075,30152,30225,991,31216,435
2021-04-10,Modoc,049,8938,362,352,119,471,3
2021-04-10,Mono,051,14174,1239,1249,16,1265,3
2021-04-10,Monterey,053,433212,42717,42527,1773,44300,346
2021-04-10,Napa,055,140530,9627,9569,32,9601,79
2021-04-10,Nevada,057,99092,4449,4379,182,4561,69
2021-04-10,Orange,059,3164182,252536,251139,10847,261986,4818
2021-04-10,Placer,061,380077,22098,21402,1331,22733,278
2021-04-10,Plumas,063,18699,675,666,10,676,4
2021-04-10,Riverside,065,2383286,290846,285082,13604,298686,4336
2021-04-10,Sacramento,067,1510023,100879,100048,1482,101530,1566
2021-04-10,San Benito,069,59416,5933,5932,105,6037,62
2021-04-10,San Bernardino,071,2135413,290411,288590,8748,297338,4489
2021-04-10,San Diego,073,3302833,273921,273058,13931,286989,3613
2021-04-10,San Francisco,075,870044,35724,35774,1203,36977,498
2021-04-10,San Joaquin,077,732212,70702,69852,3238,73090,1288
2021-04-10,San Luis Obispo,079,281455,20794,20461,637,21098,253
2021-04-10,San Mateo,081,765935,41250,40878,432,41310,350
2021-04-10,Santa Barbara,083,443738,33746,33541,1089,34630,444
2021-04-10,Santa Clara,085,1922200,115727,116015,669,116684,1923
2021-04-10,Santa Cruz,087,273765,15960,15360,788,16148,203
2021-04-10,Shasta,089,179085,11490,11492,1388,12880,189
2021-04-10,Sierra,091,2930,55,51,12,63,0
2021-04-10,Siskiyou,093,43540,1599,1512,266,1778,7
2021-04-10,Solano,095,438530,31356,31218,431,31649,238
2021-04-10,Sonoma,097,501317,29372,29469,288,29757,310
2021-04-10,Stanislaus,099,539301,53946,53596,5623,59219,707
2021-04-10,Sutter,101,95872,9194,9214,80,9294,106
2021-04-10,Tehama,103,63373,4871,4820,517,5337,52
2021-04-10,Trinity,105,12862,482,324,81,405,3
2021-04-10,Tulare,107,460477,49484,48470,8539,57009,824
2021-04-10,Tuolumne,109,53932,3940,3991,39,4030,57
2021-04-10,Ventura,111,848112,80288,79758,2872,82630,985
2021-04-10,Yolo,113,214977,13511,13494,169,13663,198
2021-04-10,Yuba,115,75493,5796,5757,114,5871,43
2021-04-09,Alameda,001,1643700,84926,84404,1799,86203,1237
2021-04-09,Alpine,003,1148,85,85,0,85,0
2021-04-09,Amador,005,37829,3609,3600,32,3632,46
2021-04-09,Butte,007,227075,11815,11454,1675,13129,193
2021-04-09,Calaveras,009,45235,2032,2028,11,2039,50
2021-04-09,Colusa,011,21464,1903,1898,277,2175,14
2021-04-09,Contra Costa,013,1133247,66705,65857,1142,66999,777
2021-04-09,Del Norte,015,27424,1251,1207,11,1218,6
2021-04-09,El Dorado,017,186661,9654,9528,654,10182,106
2021-04-09,Fresno,019,978130,100620,100027,8271,108298,1630
2021-04-09,Glenn,021,27897,2368,2337,532,2869,17
2021-04-09,Humboldt,023,135768,3532,3496,25,3521,35
2021-04-09,Imperial,025,180216,27940,27764,2578,30342,717
2021-04-09,Inyo,027,18085,1391,1386,10,1396,36
2021-04-09,Kern,029,883053,95853,94675,10323,104998,1282
2021-04-09,Kings,031,150075,22838,22595,1020,23615,242
2021-04-09,Lake,033,64148,3402,3362,9,3371,43
2021-04-09,Lassen,035,31185,5154,5140,102,5242,1
2021-04-09,Los Angeles,037,10098052,1194398,1184501,39942,1224443,23458
2021-04-09,Madera,039,155013,16304,16118,897,17015,231
2021-04-09,Marin,041,260295,13787,13721,223,13944,226
2021-04-09,Mariposa,043,17540,400,393,6,399,5
2021-04-09,Mendocino,045,87422,3780,3693,73,3766,46
2021-04-09,Merced,047,269075,30123,30179,990,31169,435
2021-04-09,Modoc,049,8938,361,352,119,471,3
2021-04-09,Mono,051,14174,1239,1247,16,1263,3
2021-04-09,Monterey,053,433212,42708,42481,1769,44250,344
2021-04-09,Napa,055,140530,9608,9574,32,9606,80
2021-04-09,Nevada,057,99092,4441,4373,182,4555,69
2021-04-09,Orange,059,3164182,252462,250852,10842,261694,4813
2021-04-09,Placer,061,380077,22067,21327,1323,22650,278
2021-04-09,Plumas,063,18699,674,666,10,676,4
2021-04-09,Riverside,065,2383286,290763,284562,13598,298160,4325
2021-04-09,Sacramento,067,1510023,100724,99722,1476,101198,1564
2021-04-09,San Benito,069,59416,5928,5925,104,6029,62
2021-04-09,San Bernardino,071,2135413,290342,288000,8745,296745,4467
2021-04-09,San Diego,073,3302833,273723,272697,13889,286586,3600
2021-04-09,San Francisco,075,870044,35683,35716,1198,36914,497
2021-04-09,San Joaquin,077,732212,70638,69675,3226,72901,1281
2021-04-09,San Luis Obispo,079,281455,20779,20427,637,21064,252
2021-04-09,San Mateo,081,765935,41214,40800,431,41231,350
2021-04-09,Santa Barbara,083,443738,33723,33424,1086,34510,444
2021-04-09,Santa Clara,085,1922200,115643,115749,667,116416,1923
2021-04-09,Santa Cruz,087,273765,15955,15331,788,16119,203
2021-04-09,Shasta,089,179085,11480,11478,1385,12863,188
2021-04-09,Sierra,091,2930,55,51,12,63,0
2021-04-09,Siskiyou,093,43540,1596,1510,265,1775,7
2021-04-09,Solano,095,438530,31323,31166,426,31592,238
2021-04-09,Sonoma,097,501317,29359,29433,288,29721,310
2021-04-09,Stanislaus,099,539301,53891,53504,5614,59118,705
2021-04-09,Sutter,101,95872,9187,9201,80,9281,106
2021-04-09,Tehama,103,63373,4865,4806,517,5323,52
2021-04-09,Trinity,105,12862,481,324,81,405,3
2021-04-09,Tulare,107,460477,49480,48430,8533,56963,824
2021-04-09,Tuolumne,109,53932,3939,3986,39,4025,57
2021-04-09,Ventura,111,848112,80260,79698,2872,82570,987
2021-04-09,Yolo,113,214977,13499,13478,167,13645,198
2021-04-09,Yuba,115,75493,5789,5754,114,5868,43
2021-04-08,Alameda,001,1643700,84820,84213,1796,86009,1232
2021-04-08,Alpine,003,1148,85,85,0,85,0
2021-04-08,Amador,005,37829,3605,3595,32,3627,46
2021-04-08,Butte,007,227075,11804,11414,1674,13088,193
2021-04-08,Calaveras,009,45235,2030,2027,11,2038,50
2021-04-08,Colusa,011,21464,1902,1897,277,2174,14
2021-04-08,Contra Costa,013,1133247,66595,65706,1139,66845,775
2021-04-08,Del Norte,015,27424,1245,1201,11,1212,6
2021-04-08,El Dorado,017,186661,9638,9513,649,10162,106
2021-04-08,Fresno,019,978130,100557,99935,8264,108199,1627
2021-04-08,Glenn,021,27897,2367,2337,532,2869,17
2021-04-08,Humboldt,023,135768,3522,3486,25,3511,35
2021-04-08,Imperial,025,180216,27912,27744,2575,30319,713
2021-04-08,Inyo,027,18085,1390,1386,10,1396,36
2021-04-08,Kern,029,883053,95807,94493,10310,104803,1281
2021-04-08,Kings,031,150075,22831,22589,1018,23607,243
2021-04-08,Lake,033,64148,3395,3360,9,3369,43
2021-04-08,Lassen,035,31185,5153,5136,102,5238,1
2021-04-08,Los Angeles,037,10098052,1193899,1184443,39904,1224347,23416
2021-04-08,Madera,039,155013,16292,16103,897,17000,231
2021-04-08,Marin,041,260295,13780,13704,223,13927,226
2021-04-08,Mariposa,043,17540,399,393,6,399,5
2021-04-08,Mendocino,045,87422,3778,3690,73,3763,45
2021-04-08,Merced,047,269075,30101,30163,990,31153,430
2021-04-08,Modoc,049,8938,361,352,119,471,3
2021-04-08,Mono,051,14174,1237,1247,16,1263,3
2021-04-08,Monterey,053,433212,42686,42437,1764,44201,342
2021-04-08,Napa,055,140530,9591,9569,32,9601,80
2021-04-08,Nevada,057,99092,4430,4367,182,4549,69
2021-04-08,Orange,059,3164182,252352,250529,10827,261356,4797
2021-04-08,Placer,061,380077,22025,21258,1314,22572,277
2021-04-08,Plumas,063,18699,674,665,10,675,4
2021-04-08,Riverside,065,2383286,290649,283853,13593,297446,4296
2021-04-08,Sacramento,067,1510023,100584,99319,1465,100784,1561
2021-04-08,San Benito,069,59416,5925,5914,102,6016,62
2021-04-08,San Bernardino,071,2135413,290245,287190,8742,295932,4445
2021-04-08,San Diego,073,3302833,273493,272495,13853,286348,3592
2021-04-08,San Francisco,075,870044,35660,35657,1197,36854,494
2021-04-08,San Joaquin,077,732212,70566,69479,3220,72699,1279
2021-04-08,San Luis Obispo,079,281455,20760,20402,635,21037,252
2021-04-08,San Mateo,081,765935,41174,40749,431,41180,350
2021-04-08,Santa Barbara,083,443738,33699,33309,1085,34394,444
2021-04-08,Santa Clara,085,1922200,115537,115487,666,116153,1905
2021-04-08,Santa Cruz,087,273765,15948,15296,788,16084,203
2021-04-08,Shasta,089,179085,11470,11466,1381,12847,186
2021-04-08,Sierra,091,2930,55,51,12,63,0
2021-04-08,Siskiyou,093,43540,1593,1511,265,1776,7
2021-04-08,Solano,095,438530,31274,31120,426,31546,238
2021-04-08,Sonoma,097,501317,29339,29410,287,29697,310
2021-04-08,Stanislaus,099,539301,53813,53401,5604,59005,706
2021-04-08,Sutter,101,95872,9183,9195,80,9275,106
2021-04-08,Tehama,103,63373,4861,4802,517,5319,52
2021-04-08,Trinity,105,12862,481,324,81,405,3
2021-04-08,Tulare,107,460477,49467,48409,8523,56932,821
2021-04-08,Tuolumne,109,53932,3939,3986,39,4025,57
2021-04-08,Ventura,111,848112,80223,79626,2868,82494,986
2021-04-08,Yolo,113,214977,13490,13468,166,13634,198
2021-04-08,Yuba,115,75493,5785,5743,114,5857,43
2021-04-07,Alameda,001,1643700,84736,84130,1794,85924,1224
2021-04-07,Alpine,003,1148,85,85,0,85,0
2021-04-07,Amador,005,37829,3602,3590,32,3622,46
2021-04-07,Butte,007,227075,11800,11405,1671,13076,193
2021-04-07,Calaveras,009,45235,2029,2022,11,2033,50
2021-04-07,Colusa,011,21464,1898,1894,276,2170,14
2021-04-07,Contra Costa,013,1133247,66509,65619,1138,66757,775
2021-04-07,Del Norte,015,27424,1243,1198,11,1209,6
2021-04-07,El Dorado,017,186661,9617,9500,643,10143,106
2021-04-07,Fresno,019,978130,100492,99865,8253,108118,1627
2021-04-07,Glenn,021,27897,2365,2337,531,2868,17
2021-04-07,Humboldt,023,135768,3509,3484,25,3509,35
2021-04-07,Imperial,025,180216,27888,27704,2569,30273,713
2021-04-07,Inyo,027,18085,1389,1386,10,1396,36
2021-04-07,Kern,029,883053,95771,94456,10295,104751,1275
2021-04-07,Kings,031,150075,22829,22589,1018,23607,243
2021-04-07,Lake,033,64148,3393,3358,9,3367,43
2021-04-07,Lassen,035,31185,5153,5137,102,5239,1
2021-04-07,Los Angeles,037,10098052,1193458,1183862,39884,1223746,23372
2021-04-07,Madera,039,155013,16273,16090,896,16986,231
2021-04-07,Marin,041,260295,13769,13688,222,13910,225
2021-04-07,Mariposa,043,17540,398,391,6,397,5
2021-04-07,Mendocino,045,87422,3777,3691,73,3764,45
2021-04-07,Merced,047,269075,30078,30132,986,31118,430
2021-04-07,Modoc,049,8938,361,351,119,470,3
2021-04-07,Mono,051,14174,1237,1246,16,1262,3
2021-04-07,Monterey,053,433212,42668,42427,1763,44190,341
2021-04-07,Napa,055,140530,9577,9556,32,9588,80
2021-04-07,Nevada,057,99092,4424,4364,182,4546,69
2021-04-07,Orange,059,3164182,252227,250378,10805,261183,4778
2021-04-07,Placer,061,380077,21981,21227,1306,22533,276
2021-04-07,Plumas,063,18699,674,665,10,675,4
2021-04-07,Riverside,065,2383286,290529,283749,13583,297332,4285
2021-04-07,Sacramento,067,1510023,100416,99202,1459,100661,1544
2021-04-07,San Benito,069,59416,5920,5912,101,6013,62
2021-04-07,San Bernardino,071,2135413,290126,286978,8737,295715,4433
2021-04-07,San Diego,073,3302833,273267,272195,13824,286019,3588
2021-04-07,San Francisco,075,870044,35620,35618,1193,36811,493
2021-04-07,San Joaquin,077,732212,70496,69375,3215,72590,1278
2021-04-07,San Luis Obispo,079,281455,20734,20373,632,21005,252
2021-04-07,San Mateo,081,765935,41130,40693,431,41124,350
2021-04-07,Santa Barbara,083,443738,33673,33289,1082,34371,444
2021-04-07,Santa Clara,085,1922200,115405,115311,664,115975,1900
2021-04-07,Santa Cruz,087,273765,15937,15275,788,16063,203
2021-04-07,Shasta,089,179085,11458,11456,1377,12833,184
2021-04-07,Sierra,091,2930,55,51,12,63,0
2021-04-07,Siskiyou,093,43540,1587,1512,264,1776,7
2021-04-07,Solano,095,438530,31223,31097,425,31522,238
2021-04-07,Sonoma,097,501317,29321,29394,286,29680,310
2021-04-07,Stanislaus,099,539301,53745,53344,5594,58938,686
2021-04-07,Sutter,101,95872,9180,9188,80,9268,106
2021-04-07,Tehama,103,63373,4853,4802,515,5317,52
2021-04-07,Trinity,105,12862,481,322,81,403,3
2021-04-07,Tulare,107,460477,49452,48386,8513,56899,820
2021-04-07,Tuolumne,109,53932,3937,3982,39,4021,57
2021-04-07,Ventura,111,848112,80189,79595,2866,82461,986
2021-04-07,Yolo,113,214977,13475,13450,164,13614,198
2021-04-07,Yuba,115,75493,5781,5737,114,5851,43
2021-04-06,Alameda,001,1643700,84623,84091,1791,85882,1223
2021-04-06,Alpine,003,1148,85,85,0,85,0
2021-04-06,Amador,005,37829,3601,3587,32,3619,45
2021-04-06,Butte,007,227075,11785,11396,1669,13065,193
2021-04-06,Calaveras,009,45235,2025,2021,11,2032,50
2021-04-06,Colusa,011,21464,1896,1894,274,2168,14
2021-04-06,Contra Costa,013,1133247,66431,65575,1137,66712,774
2021-04-06,Del Norte,015,27424,1238,1197,11,1208,6
2021-04-06,El Dorado,017,186661,9587,9489,641,10130,106
2021-04-06,Fresno,019,978130,100428,99814,8247,108061,1626
2021-04-06,Glenn,021,27897,2364,2335,530,2865,17
2021-04-06,Humboldt,023,135768,3500,3477,25,3502,35
2021-04-06,Imperial,025,180216,27854,27661,2560,30221,713
2021-04-06,Inyo,027,18085,1389,1379,10,1389,36
2021-04-06,Kern,029,883053,95727,94422,10289,104711,1259
2021-04-06,Kings,031,150075,22823,22587,1018,23605,240
2021-04-06,Lake,033,64148,3390,3358,9,3367,43
2021-04-06,Lassen,035,31185,5151,5137,102,5239,1
2021-04-06,Los Angeles,037,10098052,1192947,1183499,39845,1223344,23323
2021-04-06,Madera,039,155013,16253,16085,891,16976,230
2021-04-06,Marin,041,260295,13760,13675,218,13893,224
2021-04-06,Mariposa,043,17540,398,390,6,396,5
2021-04-06,Mendocino,045,87422,3775,3686,73,3759,45
2021-04-06,Merced,047,269075,30049,30100,981,31081,430
2021-04-06,Modoc,049,8938,360,351,119,470,3
2021-04-06,Mono,051,14174,1237,1246,16,1262,3
2021-04-06,Monterey,053,433212,42659,42412,1762,44174,341
2021-04-06,Napa,055,140530,9558,9509,32,9541,78
2021-04-06,Nevada,057,99092,4414,4356,180,4536,69
2021-04-06,Orange,059,3164182,252118,250304,10792,261096,4771
2021-04-06,Placer,061,380077,21933,21184,1304,22488,276
2021-04-06,Plumas,063,18699,674,665,10,675,4
2021-04-06,Riverside,065,2383286,290348,283622,13572,297194,4264
2021-04-06,Sacramento,067,1510023,100208,99110,1453,100563,1537
2021-04-06,San Benito,069,59416,5911,5907,101,6008,62
2021-04-06,San Bernardino,071,2135413,290013,286792,8727,295519,4428
2021-04-06,San Diego,073,3302833,273005,271867,13796,285663,3585
2021-04-06,San Francisco,075,870044,35577,35572,1193,36765,488
2021-04-06,San Joaquin,077,732212,70413,69316,3203,72519,1278
2021-04-06,San Luis Obispo,079,281455,20712,20350,629,20979,252
2021-04-06,San Mateo,081,765935,41082,40649,430,41079,350
2021-04-06,Santa Barbara,083,443738,33655,33257,1081,34338,443
2021-04-06,Santa Clara,085,1922200,115234,115184,663,115847,1900
2021-04-06,Santa Cruz,087,273765,15927,15252,788,16040,203
2021-04-06,Shasta,089,179085,11437,11443,1375,12818,184
2021-04-06,Sierra,091,2930,55,51,12,63,0
2021-04-06,Siskiyou,093,43540,1583,1510,263,1773,7
2021-04-06,Solano,095,438530,31176,31078,424,31502,237
2021-04-06,Sonoma,097,501317,29296,29386,284,29670,311
2021-04-06,Stanislaus,099,539301,53688,53304,5588,58892,686
2021-04-06,Sutter,101,95872,9170,9179,80,9259,106
2021-04-06,Tehama,103,63373,4844,4798,515,5313,52
2021-04-06,Trinity,105,12862,481,321,81,402,3
2021-04-06,Tulare,107,460477,49409,48372,8509,56881,819
2021-04-06,Tuolumne,109,53932,3937,3981,39,4020,57
2021-04-06,Ventura,111,848112,80152,79556,2864,82420,983
2021-04-06,Yolo,113,214977,13462,13443,163,13606,198
2021-04-06,Yuba,115,75493,5777,5733,113,5846,43
2021-04-05,Alameda,001,1643700,84507,84007,1787,85794,1219
2021-04-05,Alpine,003,1148,85,85,0,85,0
2021-04-05,Amador,005,37829,3598,3584,32,3616,45
2021-04-05,Butte,007,227075,11770,11384,1669,13053,193
2021-04-05,Calaveras,009,45235,2023,2019,11,2030,50
2021-04-05,Colusa,011,21464,1896,1894,273,2167,14
2021-04-05,Contra Costa,013,1133247,66365,65457,1135,66592,774
2021-04-05,Del Norte,015,27424,1236,1189,11,1200,6
2021-04-05,El Dorado,017,186661,9572,9463,641,10104,106
2021-04-05,Fresno,019,978130,100340,99755,8239,107994,1622
2021-04-05,Glenn,021,27897,2363,2335,530,2865,17
2021-04-05,Humboldt,023,135768,3491,3475,25,3500,35
2021-04-05,Imperial,025,180216,27822,27604,2555,30159,710
2021-04-05,Inyo,027,18085,1386,1377,10,1387,36
2021-04-05,Kern,029,883053,95672,94401,10264,104665,1249
2021-04-05,Kings,031,150075,22819,22580,1018,23598,239
2021-04-05,Lake,033,64148,3382,3359,9,3368,43
2021-04-05,Lassen,035,31185,5151,5138,101,5239,1
2021-04-05,Los Angeles,037,10098052,1192413,1183200,39795,1222995,23302
2021-04-05,Madera,039,155013,16239,16065,890,16955,230
2021-04-05,Marin,041,260295,13746,13666,214,13880,221
2021-04-05,Mariposa,043,17540,398,390,6,396,5
2021-04-05,Mendocino,045,87422,3773,3687,73,3760,45
2021-04-05,Merced,047,269075,30023,30068,979,31047,427
2021-04-05,Modoc,049,8938,358,346,119,465,3
2021-04-05,Mono,051,14174,1237,1246,16,1262,3
2021-04-05,Monterey,053,433212,42646,42396,1758,44154,341
2021-04-05,Napa,055,140530,9535,9492,32,9524,78
2021-04-05,Nevada,057,99092,4403,4346,180,4526,69
2021-04-05,Orange,059,3164182,252003,250177,10768,260945,4759
2021-04-05,Placer,061,380077,21887,21133,1297,22430,276
2021-04-05,Plumas,063,18699,674,666,10,676,4
2021-04-05,Riverside,065,2383286,290211,283549,13560,297109,4237
2021-04-05,Sacramento,067,1510023,100046,98908,1445,100353,1533
2021-04-05,San Benito,069,59416,5905,5904,101,6005,61
2021-04-05,San Bernardino,071,2135413,289903,286597,8724,295321,4425
2021-04-05,San Diego,073,3302833,272756,271655,13755,285410,3583
2021-04-05,San Francisco,075,870044,35546,35538,1193,36731,488
2021-04-05,San Joaquin,077,732212,70324,69214,3194,72408,1268
2021-04-05,San Luis Obispo,079,281455,20675,20333,629,20962,252
2021-04-05,San Mateo,081,765935,41038,40609,429,41038,350
2021-04-05,Santa Barbara,083,443738,33620,33235,1081,34316,443
2021-04-05,Santa Clara,085,1922200,115067,115091,660,115751,1893
2021-04-05,Santa Cruz,087,273765,15920,15228,788,16016,201
2021-04-05,Shasta,089,179085,11416,11435,1372,12807,184
2021-04-05,Sierra,091,2930,55,50,12,62,0
2021-04-05,Siskiyou,093,43540,1580,1509,261,1770,7
2021-04-05,Solano,095,438530,31135,31026,422,31448,237
2021-04-05,Sonoma,097,501317,29264,29361,282,29643,311
2021-04-05,Stanislaus,099,539301,53608,53238,5585,58823,686
2021-04-05,Sutter,101,95872,9163,9169,80,9249,106
2021-04-05,Tehama,103,63373,4838,4794,515,5309,52
2021-04-05,Trinity,105,12862,480,321,81,402,3
2021-04-05,Tulare,107,460477,49397,48356,8502,56858,818
2021-04-05,Tuolumne,109,53932,3936,3980,39,4019,57
2021-04-05,Ventura,111,848112,80121,79549,2861,82410,983
2021-04-05,Yolo,113,214977,13448,13427,162,13589,198
2021-04-05,Yuba,115,75493,5772,5728,112,5840,43
2021-04-04,Alameda,001,1643700,84389,83951,1783,85734,1219
2021-04-04,Alpine,003,1148,85,85,0,85,0
2021-04-04,Amador,005,37829,3592,3582,32,3614,45
2021-04-04,Butte,007,227075,11755,11375,1668,13043,193
2021-04-04,Calaveras,009,45235,2019,2020,11,2031,50
2021-04-04,Colusa,011,21464,1895,1893,273,2166,14
2021-04-04,Contra Costa,013,1133247,66259,65408,1130,66538,774
2021-04-04,Del Norte,015,27424,1228,1186,11,1197,6
2021-04-04,El Dorado,017,186661,9553,9455,638,10093,106
2021-04-04,Fresno,019,978130,100266,99702,8227,107929,1622
2021-04-04,Glenn,021,27897,2360,2335,529,2864,17
2021-04-04,Humboldt,023,135768,3480,3472,25,3497,35
2021-04-04,Imperial,025,180216,27766,27588,2553,30141,710
2021-04-04,Inyo,027,18085,1382,1377,10,1387,36
2021-04-04,Kern,029,883053,95628,94388,10243,104631,1247
2021-04-04,Kings,031,150075,22817,22580,1017,23597,239
2021-04-04,Lake,033,64148,3376,3355,8,3363,43
2021-04-04,Lassen,035,31185,5149,5138,101,5239,1
2021-04-04,Los Angeles,037,10098052,1191869,1182872,39751,1222623,23301
2021-04-04,Madera,039,155013,16213,16052,886,16938,230
2021-04-04,Marin,041,260295,13733,13663,213,13876,221
2021-04-04,Mariposa,043,17540,398,390,6,396,5
2021-04-04,Mendocino,045,87422,3770,3684,73,3757,45
2021-04-04,Merced,047,269075,29980,30048,976,31024,427
2021-04-04,Modoc,049,8938,358,346,119,465,3
2021-04-04,Mono,051,14174,1236,1245,16,1261,3
2021-04-04,Monterey,053,433212,42629,42391,1757,44148,341
2021-04-04,Napa,055,140530,9523,9486,32,9518,78
2021-04-04,Nevada,057,99092,4391,4337,180,4517,69
2021-04-04,Orange,059,3164182,251869,250117,10752,260869,4759
2021-04-04,Placer,061,380077,21840,21104,1279,22383,276
2021-04-04,Plumas,063,18699,674,666,10,676,4
2021-04-04,Riverside,065,2383286,290085,283537,13556,297093,4237
2021-04-04,Sacramento,067,1510023,99847,98821,1436,100257,1531
2021-04-04,San Benito,069,59416,5895,5901,97,5998,61
2021-04-04,San Bernardino,071,2135413,289763,286561,8716,295277,4423
2021-04-04,San Diego,073,3302833,272444,271528,13714,285242,3583
2021-04-04,San Francisco,075,870044,35492,35525,1190,36715,488
2021-04-04,San Joaquin,077,732212,70223,69147,3182,72329,1268
2021-04-04,San Luis Obispo,079,281455,20643,20328,621,20949,252
2021-04-04,San Mateo,081,765935,40995,40587,427,41014,350
2021-04-04,Santa Barbara,083,443738,33584,33213,1081,34294,443
2021-04-04,Santa Clara,085,1922200,114901,114976,653,115629,1893
2021-04-04,Santa Cruz,087,273765,15911,15219,788,16007,201
2021-04-04,Shasta,089,179085,11390,11433,1371,12804,184
2021-04-04,Sierra,091,2930,55,50,12,62,0
2021-04-04,Siskiyou,093,43540,1577,1509,257,1766,7
2021-04-04,Solano,095,438530,31088,31002,420,31422,237
2021-04-04,Sonoma,097,501317,29232,29340,280,29620,311
2021-04-04,Stanislaus,099,539301,53515,53181,5577,58758,686
2021-04-04,Sutter,101,95872,9156,9164,80,9244,106
2021-04-04,Tehama,103,63373,4826,4792,514,5306,52
2021-04-04,Trinity,105,12862,478,321,81,402,3
2021-04-04,Tulare,107,460477,49383,48343,8494,56837,818
2021-04-04,Tuolumne,109,53932,3928,3980,39,4019,57
2021-04-04,Ventura,111,848112,80078,79526,2859,82385,983
2021-04-04,Yolo,113,214977,13427,13425,161,13586,198
2021-04-04,Yuba,115,75493,5765,5722,112,5834,43
2021-04-03,Alameda,001,1643700,84322,83861,1781,85642,1218
2021-04-03,Alpine,003,1148,85,85,0,85,0
2021-04-03,Amador,005,37829,3589,3577,32,3609,45
2021-04-03,Butte,007,227075,11751,11359,1664,13023,193
2021-04-03,Calaveras,009,45235,2017,2019,11,2030,50
2021-04-03,Colusa,011,21464,1895,1891,273,2164,14
2021-04-03,Contra Costa,013,1133247,66187,65338,1130,66468,774
2021-04-03,Del Norte,015,27424,1223,1183,11,1194,6
2021-04-03,El Dorado,017,186661,9544,9448,637,10085,106
2021-04-03,Fresno,019,978130,100209,99602,8221,107823,1622
2021-04-03,Glenn,021,27897,2359,2334,528,2862,17
2021-04-03,Humboldt,023,135768,3478,3467,25,3492,35
2021-04-03,Imperial,025,180216,27750,27572,2550,30122,710
2021-04-03,Inyo,027,18085,1381,1376,10,1386,36
2021-04-03,Kern,029,883053,95602,94369,10227,104596,1243
2021-04-03,Kings,031,150075,22815,22580,1017,23597,239
2021-04-03,Lake,033,64148,3375,3350,8,3358,43
2021-04-03,Lassen,035,31185,5148,5136,101,5237,1
2021-04-03,Los Angeles,037,10098052,1191562,1182402,39734,1222136,23301
2021-04-03,Madera,039,155013,16204,16051,884,16935,230
2021-04-03,Marin,041,260295,13725,13658,212,13870,221
2021-04-03,Mariposa,043,17540,398,390,5,395,5
2021-04-03,Mendocino,045,87422,3769,3684,73,3757,45
2021-04-03,Merced,047,269075,29965,30031,976,31007,427
2021-04-03,Modoc,049,8938,358,346,119,465,3
2021-04-03,Mono,051,14174,1236,1245,16,1261,3
2021-04-03,Monterey,053,433212,42616,42376,1755,44131,341
2021-04-03,Napa,055,140530,9514,9473,32,9505,78
2021-04-03,Nevada,057,99092,4387,4323,180,4503,69
2021-04-03,Orange,059,3164182,251789,249982,10734,260716,4755
2021-04-03,Placer,061,380077,21809,21060,1275,22335,276
2021-04-03,Plumas,063,18699,674,666,10,676,4
2021-04-03,Riverside,065,2383286,290007,283423,13553,296976,4237
2021-04-03,Sacramento,067,1510023,99739,98660,1430,100090,1531
2021-04-03,San Benito,069,59416,5892,5893,96,5989,61
2021-04-03,San Bernardino,071,2135413,289697,286473,8710,295183,4422
2021-04-03,San Diego,073,3302833,272275,271335,13697,285032,3571
2021-04-03,San Francisco,075,870044,35473,35488,1188,36676,489
2021-04-03,San Joaquin,077,732212,70182,69100,3166,72266,1268
2021-04-03,San Luis Obispo,079,281455,20624,20301,621,20922,252
2021-04-03,San Mateo,081,765935,40970,40560,427,40987,350
2021-04-03,Santa Barbara,083,443738,33558,33172,1080,34252,443
2021-04-03,Santa Clara,085,1922200,114793,114865,651,115516,1893
2021-04-03,Santa Cruz,087,273765,15904,15205,788,15993,201
2021-04-03,Shasta,089,179085,11382,11418,1371,12789,184
2021-04-03,Sierra,091,2930,55,50,12,62,0
2021-04-03,Siskiyou,093,43540,1576,1509,257,1766,7
2021-04-03,Solano,095,438530,31067,30970,417,31387,237
2021-04-03,Sonoma,097,501317,29216,29315,279,29594,311
2021-04-03,Stanislaus,099,539301,53480,53137,5571,58708,686
2021-04-03,Sutter,101,95872,9150,9158,80,9238,106
2021-04-03,Tehama,103,63373,4818,4788,514,5302,52
2021-04-03,Trinity,105,12862,478,321,81,402,3
2021-04-03,Tulare,107,460477,49373,48327,8490,56817,818
2021-04-03,Tuolumne,109,53932,3928,3980,39,4019,57
2021-04-03,Ventura,111,848112,80057,79489,2857,82346,983
2021-04-03,Yolo,113,214977,13421,13414,161,13575,198
2021-04-03,Yuba,115,75493,5759,5716,112,5828,43
2021-04-02,Alameda,001,1643700,84249,83776,1778,85554,1217
2021-04-02,Alpine,003,1148,85,85,0,85,0
2021-04-02,Amador,005,37829,3585,3573,31,3604,45
2021-04-02,Butte,007,227075,11743,11350,1664,13014,193
2021-04-02,Calaveras,009,45235,2015,2010,11,2021,50
2021-04-02,Colusa,011,21464,1895,1891,273,2164,14
2021-04-02,Contra Costa,013,1133247,66123,65299,1129,66428,774
2021-04-02,Del Norte,015,27424,1220,1174,11,1185,6
2021-04-02,El Dorado,017,186661,9531,9437,634,10071,106
2021-04-02,Fresno,019,978130,100155,99551,8210,107761,1620
2021-04-02,Glenn,021,27897,2359,2331,528,2859,17
2021-04-02,Humboldt,023,135768,3474,3465,25,3490,35
2021-04-02,Imperial,025,180216,27738,27553,2544,30097,710
2021-04-02,Inyo,027,18085,1381,1377,10,1387,36
2021-04-02,Kern,029,883053,95584,94348,10224,104572,1233
2021-04-02,Kings,031,150075,22815,22571,1014,23585,239
2021-04-02,Lake,033,64148,3373,3348,8,3356,43
2021-04-02,Lassen,035,31185,5148,5134,101,5235,1
2021-04-02,Los Angeles,037,10098052,1191251,1181682,39713,1221395,23264
2021-04-02,Madera,039,155013,16195,16036,883,16919,230
2021-04-02,Marin,041,260295,13717,13649,212,13861,221
2021-04-02,Mariposa,043,17540,396,390,5,395,5
2021-04-02,Mendocino,045,87422,3766,3682,73,3755,45
2021-04-02,Merced,047,269075,29940,29998,976,30974,426
2021-04-02,Modoc,049,8938,355,346,119,465,3
2021-04-02,Mono,051,14174,1236,1246,16,1262,3
2021-04-02,Monterey,053,433212,42606,42359,1752,44111,341
2021-04-02,Napa,055,140530,9499,9453,32,9485,78
2021-04-02,Nevada,057,99092,4383,4323,180,4503,69
2021-04-02,Orange,059,3164182,251693,249891,10722,260613,4748
2021-04-02,Placer,061,380077,21773,21035,1269,22304,275
2021-04-02,Plumas,063,18699,674,666,10,676,4
2021-04-02,Riverside,065,2383286,289921,283328,13544,296872,4213
2021-04-02,Sacramento,067,1510023,99632,98648,1423,100071,1527
2021-04-02,San Benito,069,59416,5890,5888,94,5982,61
2021-04-02,San Bernardino,071,2135413,289624,286308,8706,295014,4417
2021-04-02,San Diego,073,3302833,272088,271036,13671,284707,3568
2021-04-02,San Francisco,075,870044,35438,35451,1186,36637,488
2021-04-02,San Joaquin,077,732212,70117,68996,3151,72147,1268
2021-04-02,San Luis Obispo,079,281455,20607,20271,620,20891,252
2021-04-02,San Mateo,081,765935,40928,40514,427,40941,350
2021-04-02,Santa Barbara,083,443738,33530,33145,1080,34225,443
2021-04-02,Santa Clara,085,1922200,114682,114777,649,115426,1882
2021-04-02,Santa Cruz,087,273765,15896,15216,788,16004,202
2021-04-02,Shasta,089,179085,11377,11377,1364,12741,181
2021-04-02,Sierra,091,2930,55,50,12,62,0
2021-04-02,Siskiyou,093,43540,1576,1508,256,1764,7
2021-04-02,Solano,095,438530,31038,30951,414,31365,237
2021-04-02,Sonoma,097,501317,29195,29288,278,29566,311
2021-04-02,Stanislaus,099,539301,53435,53073,5565,58638,687
2021-04-02,Sutter,101,95872,9142,9131,80,9211,106
2021-04-02,Tehama,103,63373,4811,4775,513,5288,52
2021-04-02,Trinity,105,12862,478,320,81,401,3
2021-04-02,Tulare,107,460477,49367,48306,8484,56790,818
2021-04-02,Tuolumne,109,53932,3925,3980,39,4019,57
2021-04-02,Ventura,111,848112,80030,79434,2855,82289,982
2021-04-02,Yolo,113,214977,13411,13381,161,13542,197
2021-04-02,Yuba,115,75493,5755,5709,112,5821,44
2021-04-01,Alameda,001,1643700,84170,83574,1773,85347,1216
2021-04-01,Alpine,003,1148,85,85,0,85,0
2021-04-01,Amador,005,37829,3581,3558,31,3589,45
2021-04-01,Butte,007,227075,11725,11328,1662,12990,193
2021-04-01,Calaveras,009,45235,2012,2006,11,2017,50
2021-04-01,Colusa,011,21464,1892,1890,273,2163,14
2021-04-01,Contra Costa,013,1133247,66063,65176,1127,66303,771
2021-04-01,Del Norte,015,27424,1215,1138,11,1149,6
2021-04-01,El Dorado,017,186661,9522,9393,630,10023,106
2021-04-01,Fresno,019,978130,100102,99317,8202,107519,1616
2021-04-01,Glenn,021,27897,2359,2322,527,2849,17
2021-04-01,Humboldt,023,135768,3470,3464,25,3489,35
2021-04-01,Imperial,025,180216,27708,27520,2539,30059,710
2021-04-01,Inyo,027,18085,1380,1374,10,1384,36
2021-04-01,Kern,029,883053,95548,94244,10212,104456,1233
2021-04-01,Kings,031,150075,22808,22560,1013,23573,239
2021-04-01,Lake,033,64148,3368,3337,8,3345,43
2021-04-01,Lassen,035,31185,5147,5132,101,5233,1
2021-04-01,Los Angeles,037,10098052,1190757,1181101,39684,1220785,23220
2021-04-01,Madera,039,155013,16179,16023,883,16906,230
2021-04-01,Marin,041,260295,13707,13635,212,13847,221
2021-04-01,Mariposa,043,17540,394,389,5,394,5
2021-04-01,Mendocino,045,87422,3766,3680,73,3753,45
2021-04-01,Merced,047,269075,29907,29820,976,30796,425
2021-04-01,Modoc,049,8938,354,346,119,465,3
2021-04-01,Mono,051,14174,1236,1245,16,1261,3
2021-04-01,Monterey,053,433212,42598,42324,1750,44074,339
2021-04-01,Napa,055,140530,9487,9410,32,9442,78
2021-04-01,Nevada,057,99092,4373,4288,179,4467,68
2021-04-01,Orange,059,3164182,251573,249617,10705,260322,4742
2021-04-01,Placer,061,380077,21734,20909,1257,22166,274
2021-04-01,Plumas,063,18699,674,664,10,674,4
2021-04-01,Riverside,065,2383286,289816,283128,13541,296669,4193
2021-04-01,Sacramento,067,1510023,99488,97952,1410,99362,1521
2021-04-01,San Benito,069,59416,5882,5878,93,5971,61
2021-04-01,San Bernardino,071,2135413,289507,286086,8697,294783,4404
2021-04-01,San Diego,073,3302833,271865,270540,13641,284181,3555
2021-04-01,San Francisco,075,870044,35417,35386,1183,36569,488
2021-04-01,San Joaquin,077,732212,70035,68802,3143,71945,1262
2021-04-01,San Luis Obispo,079,281455,20578,20235,619,20854,252
2021-04-01,San Mateo,081,765935,40887,40454,427,40881,350
2021-04-01,Santa Barbara,083,443738,33483,33096,1075,34171,443
2021-04-01,Santa Clara,085,1922200,114569,114606,648,115254,1874
2021-04-01,Santa Cruz,087,273765,15881,15271,788,16059,202
2021-04-01,Shasta,089,179085,11362,11355,1359,12714,181
2021-04-01,Sierra,091,2930,55,50,12,62,0
2021-04-01,Siskiyou,093,43540,1574,1507,255,1762,7
2021-04-01,Solano,095,438530,31005,30850,411,31261,237
2021-04-01,Sonoma,097,501317,29164,29241,271,29512,311
2021-04-01,Stanislaus,099,539301,53372,52825,5559,58384,687
2021-04-01,Sutter,101,95872,9130,9105,80,9185,106
2021-04-01,Tehama,103,63373,4805,4764,510,5274,52
2021-04-01,Trinity,105,12862,478,319,81,400,3
2021-04-01,Tulare,107,460477,49344,48279,8474,56753,817
2021-04-01,Tuolumne,109,53932,3923,3978,39,4017,57
2021-04-01,Ventura,111,848112,80006,79369,2854,82223,977
2021-04-01,Yolo,113,214977,13398,13342,161,13503,197
2021-04-01,Yuba,115,75493,5750,5694,112,5806,44
2021-03-31,Alameda,001,1643700,84089,83475,1768,85243,1215
2021-03-31,Alpine,003,1148,85,85,0,85,0
2021-03-31,Amador,005,37829,3578,3556,31,3587,45
2021-03-31,Butte,007,227075,11715,11321,1659,12980,193
2021-03-31,Calaveras,009,45235,2010,2005,11,2016,50
2021-03-31,Colusa,011,21464,1892,1890,273,2163,14
2021-03-31,Contra Costa,013,1133247,65978,65109,1126,66235,769
2021-03-31,Del Norte,015,27424,1206,1129,11,1140,6
2021-03-31,El Dorado,017,186661,9505,9390,630,10020,106
2021-03-31,Fresno,019,978130,100009,99240,8186,107426,1616
2021-03-31,Glenn,021,27897,2355,2318,525,2843,17
2021-03-31,Humboldt,023,135768,3464,3460,25,3485,35
2021-03-31,Imperial,025,180216,27688,27506,2538,30044,710
2021-03-31,Inyo,027,18085,1377,1373,9,1382,35
2021-03-31,Kern,029,883053,95505,94205,10203,104408,1229
2021-03-31,Kings,031,150075,22805,22540,1013,23553,239
2021-03-31,Lake,033,64148,3364,3332,8,3340,43
2021-03-31,Lassen,035,31185,5143,5132,101,5233,1
2021-03-31,Los Angeles,037,10098052,1190287,1180538,39645,1220183,23171
2021-03-31,Madera,039,155013,16165,16015,882,16897,229
2021-03-31,Marin,041,260295,13696,13624,212,13836,221
2021-03-31,Mariposa,043,17540,394,389,5,394,5
2021-03-31,Mendocino,045,87422,3760,3675,73,3748,45
2021-03-31,Merced,047,269075,29878,29780,976,30756,423
2021-03-31,Modoc,049,8938,354,346,119,465,3
2021-03-31,Mono,051,14174,1236,1245,16,1261,3
2021-03-31,Monterey,053,433212,42581,42309,1748,44057,338
2021-03-31,Napa,055,140530,9469,9401,32,9433,78
2021-03-31,Nevada,057,99092,4367,4283,179,4462,68
2021-03-31,Orange,059,3164182,251462,249518,10690,260208,4731
2021-03-31,Placer,061,380077,21684,20885,1250,22135,271
2021-03-31,Plumas,063,18699,673,663,10,673,4
2021-03-31,Riverside,065,2383286,289714,283006,13531,296537,4171
2021-03-31,Sacramento,067,1510023,99313,97760,1403,99163,1519
2021-03-31,San Benito,069,59416,5872,5875,93,5968,61
2021-03-31,San Bernardino,071,2135413,289413,285916,8694,294610,4356
2021-03-31,San Diego,073,3302833,271633,270288,13606,283894,3555
2021-03-31,San Francisco,075,870044,35372,35347,1182,36529,474
2021-03-31,San Joaquin,077,732212,69946,68685,3127,71812,1259
2021-03-31,San Luis Obispo,079,281455,20556,20215,618,20833,251
2021-03-31,San Mateo,081,765935,40857,40423,427,40850,350
2021-03-31,Santa Barbara,083,443738,33451,33052,1073,34125,443
2021-03-31,Santa Clara,085,1922200,114442,114499,648,115147,1874
2021-03-31,Santa Cruz,087,273765,15868,15295,787,16082,201
2021-03-31,Shasta,089,179085,11350,11327,1351,12678,179
2021-03-31,Sierra,091,2930,55,50,12,62,0
2021-03-31,Siskiyou,093,43540,1573,1505,255,1760,7
2021-03-31,Solano,095,438530,30959,30824,410,31234,235
2021-03-31,Sonoma,097,501317,29137,29216,271,29487,311
2021-03-31,Stanislaus,099,539301,53304,52782,5547,58329,687
2021-03-31,Sutter,101,95872,9119,9111,80,9191,106
2021-03-31,Tehama,103,63373,4800,4762,508,5270,52
2021-03-31,Trinity,105,12862,478,319,81,400,3
2021-03-31,Tulare,107,460477,49324,48261,8458,56719,816
2021-03-31,Tuolumne,109,53932,3922,3976,39,4015,57
2021-03-31,Ventura,111,848112,79974,79326,2850,82176,969
2021-03-31,Yolo,113,214977,13381,13359,160,13519,197
2021-03-31,Yuba,115,75493,5743,5686,112,5798,44
2021-03-30,Alameda,001,1643700,83989,83395,1765,85160,1211
2021-03-30,Alpine,003,1148,85,85,0,85,0
2021-03-30,Amador,005,37829,3575,3551,31,3582,45
2021-03-30,Butte,007,227075,11703,11296,1656,12952,193
2021-03-30,Calaveras,009,45235,2006,1997,11,2008,50
2021-03-30,Colusa,011,21464,1891,1890,272,2162,14
2021-03-30,Contra Costa,013,1133247,65889,65041,1124,66165,767
2021-03-30,Del Norte,015,27424,1198,1118,10,1128,6
2021-03-30,El Dorado,017,186661,9486,9381,627,10008,105
2021-03-30,Fresno,019,978130,99944,99156,8173,107329,1609
2021-03-30,Glenn,021,27897,2355,2310,524,2834,17
2021-03-30,Humboldt,023,135768,3462,3461,25,3486,35
2021-03-30,Imperial,025,180216,27660,27471,2536,30007,706
2021-03-30,Inyo,027,18085,1377,1374,9,1383,35
2021-03-30,Kern,029,883053,95463,94151,10194,104345,1221
2021-03-30,Kings,031,150075,22801,22530,1011,23541,238
2021-03-30,Lake,033,64148,3358,3330,8,3338,43
2021-03-30,Lassen,035,31185,5143,5132,101,5233,1
2021-03-30,Los Angeles,037,10098052,1189791,1180044,39623,1219667,23136
2021-03-30,Madera,039,155013,16155,16003,878,16881,229
2021-03-30,Marin,041,260295,13687,13611,204,13815,221
2021-03-30,Mariposa,043,17540,394,388,5,393,5
2021-03-30,Mendocino,045,87422,3758,3670,73,3743,45
2021-03-30,Merced,047,269075,29841,29731,976,30707,423
2021-03-30,Modoc,049,8938,353,346,119,465,3
2021-03-30,Mono,051,14174,1235,1245,16,1261,3
2021-03-30,Monterey,053,433212,42555,42308,1746,44054,338
2021-03-30,Napa,055,140530,9454,9391,32,9423,78
2021-03-30,Nevada,057,99092,4355,4266,178,4444,68
2021-03-30,Orange,059,3164182,251333,249412,10663,260075,4727
2021-03-30,Placer,061,380077,21644,20866,1244,22110,271
2021-03-30,Plumas,063,18699,673,661,10,671,4
2021-03-30,Riverside,065,2383286,289589,282930,13522,296452,4154
2021-03-30,Sacramento,067,1510023,99176,97718,1400,99118,1516
2021-03-30,San Benito,069,59416,5866,5870,93,5963,61
2021-03-30,San Bernardino,071,2135413,289305,285758,8685,294443,4343
2021-03-30,San Diego,073,3302833,271394,269998,13568,283566,3555
2021-03-30,San Francisco,075,870044,35322,35325,1181,36506,474
2021-03-30,San Joaquin,077,732212,69858,68613,3117,71730,1232
2021-03-30,San Luis Obispo,079,281455,20536,20194,618,20812,251
2021-03-30,San Mateo,081,765935,40813,40377,427,40804,349
2021-03-30,Santa Barbara,083,443738,33426,33016,1073,34089,441
2021-03-30,Santa Clara,085,1922200,114320,114413,647,115060,1873
2021-03-30,Santa Cruz,087,273765,15862,15278,787,16065,201
2021-03-30,Shasta,089,179085,11342,11316,1350,12666,184
2021-03-30,Sierra,091,2930,55,50,12,62,0
2021-03-30,Siskiyou,093,43540,1572,1501,255,1756,7
2021-03-30,Solano,095,438530,30929,30802,409,31211,232
2021-03-30,Sonoma,097,501317,29105,29198,271,29469,311
2021-03-30,Stanislaus,099,539301,53226,52690,5539,58229,677
2021-03-30,Sutter,101,95872,9115,9107,79,9186,106
2021-03-30,Tehama,103,63373,4791,4748,507,5255,52
2021-03-30,Trinity,105,12862,478,316,81,397,3
2021-03-30,Tulare,107,460477,49309,48249,8449,56698,815
2021-03-30,Tuolumne,109,53932,3917,3972,39,4011,57
2021-03-30,Ventura,111,848112,79930,79282,2847,82129,958
2021-03-30,Yolo,113,214977,13368,13353,160,13513,195
2021-03-30,Yuba,115,75493,5732,5679,106,5785,42
2021-03-29,Alameda,001,1643700,83887,83338,1763,85101,1211
2021-03-29,Alpine,003,1148,85,85,0,85,0
2021-03-29,Amador,005,37829,3569,3549,31,3580,45
2021-03-29,Butte,007,227075,11694,11291,1653,12944,191
2021-03-29,Calaveras,009,45235,2004,1998,11,2009,50
2021-03-29,Colusa,011,21464,1891,1889,271,2160,14
2021-03-29,Contra Costa,013,1133247,65820,64971,1123,66094,767
2021-03-29,Del Norte,015,27424,1193,1116,9,1125,6
2021-03-29,El Dorado,017,186661,9466,9374,622,9996,105
2021-03-29,Fresno,019,978130,99861,99085,8158,107243,1606
2021-03-29,Glenn,021,27897,2348,2310,524,2834,17
2021-03-29,Humboldt,023,135768,3457,3459,25,3484,34
2021-03-29,Imperial,025,180216,27639,27442,2534,29976,704
2021-03-29,Inyo,027,18085,1377,1372,9,1381,35
2021-03-29,Kern,029,883053,95416,94098,10175,104273,1220
2021-03-29,Kings,031,150075,22789,22522,1010,23532,238
2021-03-29,Lake,033,64148,3355,3325,8,3333,43
2021-03-29,Lassen,035,31185,5143,5131,101,5232,1
2021-03-29,Los Angeles,037,10098052,1189295,1179736,39583,1219319,23108
2021-03-29,Madera,039,155013,16135,15987,876,16863,210
2021-03-29,Marin,041,260295,13675,13600,201,13801,220
2021-03-29,Mariposa,043,17540,393,388,5,393,5
2021-03-29,Mendocino,045,87422,3755,3667,73,3740,45
2021-03-29,Merced,047,269075,29817,29699,976,30675,422
2021-03-29,Modoc,049,8938,352,344,119,463,3
2021-03-29,Mono,051,14174,1234,1243,16,1259,3
2021-03-29,Monterey,053,433212,42539,42305,1741,44046,337
2021-03-29,Napa,055,140530,9438,9379,32,9411,78
2021-03-29,Nevada,057,99092,4348,4258,178,4436,68
2021-03-29,Orange,059,3164182,251221,249295,10651,259946,4713
2021-03-29,Placer,061,380077,21609,20827,1237,22064,267
2021-03-29,Plumas,063,18699,672,660,10,670,4
2021-03-29,Riverside,065,2383286,289486,282867,13521,296388,4133
2021-03-29,Sacramento,067,1510023,98982,97577,1392,98969,1514
2021-03-29,San Benito,069,59416,5859,5865,93,5958,61
2021-03-29,San Bernardino,071,2135413,289208,285615,8681,294296,4335
2021-03-29,San Diego,073,3302833,271128,269771,13542,283313,3547
2021-03-29,San Francisco,075,870044,35287,35291,1178,36469,474
2021-03-29,San Joaquin,077,732212,69772,68537,3104,71641,1211
2021-03-29,San Luis Obispo,079,281455,20501,20176,617,20793,250
2021-03-29,San Mateo,081,765935,40771,40357,426,40783,348
2021-03-29,Santa Barbara,083,443738,33392,32983,1072,34055,439
2021-03-29,Santa Clara,085,1922200,114212,114335,642,114977,1871
2021-03-29,Santa Cruz,087,273765,15851,15249,786,16035,201
2021-03-29,Shasta,089,179085,11324,11313,1348,12661,183
2021-03-29,Sierra,091,2930,55,50,12,62,0
2021-03-29,Siskiyou,093,43540,1570,1497,255,1752,6
2021-03-29,Solano,095,438530,30890,30762,407,31169,232
2021-03-29,Sonoma,097,501317,29082,29184,268,29452,310
2021-03-29,Stanislaus,099,539301,53143,52614,5532,58146,677
2021-03-29,Sutter,101,95872,9108,9105,79,9184,106
2021-03-29,Tehama,103,63373,4783,4742,506,5248,52
2021-03-29,Trinity,105,12862,478,314,81,395,3
2021-03-29,Tulare,107,460477,49281,48226,8438,56664,815
2021-03-29,Tuolumne,109,53932,3915,3969,39,4008,57
2021-03-29,Ventura,111,848112,79888,79252,2847,82099,956
2021-03-29,Yolo,113,214977,13349,13346,160,13506,195
2021-03-29,Yuba,115,75493,5725,5671,105,5776,42
2021-03-28,Alameda,001,1643700,83766,83239,1761,85000,1212
2021-03-28,Alpine,003,1148,85,85,0,85,0
2021-03-28,Amador,005,37829,3565,3541,31,3572,45
2021-03-28,Butte,007,227075,11681,11285,1651,12936,191
2021-03-28,Calaveras,009,45235,2002,1995,11,2006,50
2021-03-28,Colusa,011,21464,1890,1889,271,2160,14
2021-03-28,Contra Costa,013,1133247,65746,64878,1119,65997,767
2021-03-28,Del Norte,015,27424,1186,1107,7,1114,6
2021-03-28,El Dorado,017,186661,9451,9371,620,9991,105
2021-03-28,Fresno,019,978130,99779,99004,8146,107150,1606
2021-03-28,Glenn,021,27897,2344,2309,522,2831,17
2021-03-28,Humboldt,023,135768,3454,3452,24,3476,34
2021-03-28,Imperial,025,180216,27612,27426,2531,29957,704
2021-03-28,Inyo,027,18085,1376,1372,9,1381,35
2021-03-28,Kern,029,883053,95371,94084,10164,104248,1219
2021-03-28,Kings,031,150075,22784,22514,1007,23521,238
2021-03-28,Lake,033,64148,3350,3320,8,3328,43
2021-03-28,Lassen,035,31185,5143,5131,100,5231,1
2021-03-28,Los Angeles,037,10098052,1188742,1179316,39525,1218841,23101
2021-03-28,Madera,039,155013,16120,15973,875,16848,210
2021-03-28,Marin,041,260295,13662,13594,199,13793,221
2021-03-28,Mariposa,043,17540,393,388,5,393,5
2021-03-28,Mendocino,045,87422,3753,3666,73,3739,45
2021-03-28,Merced,047,269075,29760,29679,976,30655,422
2021-03-28,Modoc,049,8938,352,344,119,463,3
2021-03-28,Mono,051,14174,1233,1242,16,1258,3
2021-03-28,Monterey,053,433212,42516,42294,1737,44031,337
2021-03-28,Napa,055,140530,9424,9368,32,9400,78
2021-03-28,Nevada,057,99092,4334,4239,178,4417,68
2021-03-28,Orange,059,3164182,251066,249238,10641,259879,4713
2021-03-28,Placer,061,380077,21565,20796,1231,22027,267
2021-03-28,Plumas,063,18699,670,657,10,667,4
2021-03-28,Riverside,065,2383286,289372,282811,13513,296324,4132
2021-03-28,Sacramento,067,1510023,98808,97425,1386,98811,1514
2021-03-28,San Benito,069,59416,5854,5862,93,5955,61
2021-03-28,San Bernardino,071,2135413,289088,285570,8673,294243,4332
2021-03-28,San Diego,073,3302833,270852,269476,13513,282989,3547
2021-03-28,San Francisco,075,870044,35241,35286,1174,36460,474
2021-03-28,San Joaquin,077,732212,69647,68459,3085,71544,1211
2021-03-28,San Luis Obispo,079,281455,20466,20172,614,20786,250
2021-03-28,San Mateo,081,765935,40726,40305,426,40731,348
2021-03-28,Santa Barbara,083,443738,33350,32953,1071,34024,439
2021-03-28,Santa Clara,085,1922200,114112,114232,638,114870,1871
2021-03-28,Santa Cruz,087,273765,15836,15238,785,16023,201
2021-03-28,Shasta,089,179085,11298,11308,1337,12645,183
2021-03-28,Sierra,091,2930,55,50,12,62,0
2021-03-28,Siskiyou,093,43540,1570,1497,254,1751,6
2021-03-28,Solano,095,438530,30853,30719,405,31124,232
2021-03-28,Sonoma,097,501317,29046,29161,266,29427,310
2021-03-28,Stanislaus,099,539301,53055,52567,5519,58086,678
2021-03-28,Sutter,101,95872,9099,9094,79,9173,106
2021-03-28,Tehama,103,63373,4773,4740,504,5244,52
2021-03-28,Trinity,105,12862,476,314,80,394,3
2021-03-28,Tulare,107,460477,49252,48218,8432,56650,815
2021-03-28,Tuolumne,109,53932,3912,3969,38,4007,57
2021-03-28,Ventura,111,848112,79837,79222,2842,82064,956
2021-03-28,Yolo,113,214977,13332,13325,159,13484,194
2021-03-28,Yuba,115,75493,5721,5662,105,5767,42
2021-03-27,Alameda,001,1643700,83695,83169,1757,84926,1211
2021-03-27,Alpine,003,1148,85,85,0,85,0
2021-03-27,Amador,005,37829,3560,3538,31,3569,45
2021-03-27,Butte,007,227075,11674,11278,1650,12928,191
2021-03-27,Calaveras,009,45235,1999,1992,11,2003,50
2021-03-27,Colusa,011,21464,1890,1889,271,2160,14
2021-03-27,Contra Costa,013,1133247,65676,64804,1116,65920,767
2021-03-27,Del Norte,015,27424,1176,1104,7,1111,6
2021-03-27,El Dorado,017,186661,9437,9367,620,9987,105
2021-03-27,Fresno,019,978130,99726,98901,8140,107041,1606
2021-03-27,Glenn,021,27897,2343,2308,522,2830,17
2021-03-27,Humboldt,023,135768,3449,3442,24,3466,34
2021-03-27,Imperial,025,180216,27600,27406,2528,29934,704
2021-03-27,Inyo,027,18085,1374,1372,9,1381,35
2021-03-27,Kern,029,883053,95351,94041,10153,104194,1217
2021-03-27,Kings,031,150075,22781,22502,1007,23509,238
2021-03-27,Lake,033,64148,3348,3317,8,3325,43
2021-03-27,Lassen,035,31185,5143,5129,100,5229,1
2021-03-27,Los Angeles,037,10098052,1188428,1178831,39499,1218330,23103
2021-03-27,Madera,039,155013,16113,15968,873,16841,210
2021-03-27,Marin,041,260295,13657,13579,199,13778,222
2021-03-27,Mariposa,043,17540,393,386,5,391,5
2021-03-27,Mendocino,045,87422,3751,3666,73,3739,45
2021-03-27,Merced,047,269075,29727,29647,974,30621,422
2021-03-27,Modoc,049,8938,352,344,119,463,3
2021-03-27,Mono,051,14174,1231,1241,16,1257,3
2021-03-27,Monterey,053,433212,42506,42271,1737,44008,337
2021-03-27,Napa,055,140530,9412,9360,32,9392,78
2021-03-27,Nevada,057,99092,4324,4231,178,4409,68
2021-03-27,Orange,059,3164182,250973,249160,10625,259785,4698
2021-03-27,Placer,061,380077,21545,20717,1224,21941,267
2021-03-27,Plumas,063,18699,669,655,10,665,4
2021-03-27,Riverside,065,2383286,289310,282707,13505,296212,4132
2021-03-27,Sacramento,067,1510023,98718,97247,1384,98631,1513
2021-03-27,San Benito,069,59416,5852,5862,91,5953,61
2021-03-27,San Bernardino,071,2135413,289026,285480,8672,294152,4325
2021-03-27,San Diego,073,3302833,270681,269271,13491,282762,3540
2021-03-27,San Francisco,075,870044,35218,35244,1172,36416,474
2021-03-27,San Joaquin,077,732212,69587,68365,3077,71442,1211
2021-03-27,San Luis Obispo,079,281455,20455,20153,611,20764,250
2021-03-27,San Mateo,081,765935,40703,40264,426,40690,348
2021-03-27,Santa Barbara,083,443738,33327,32921,1071,33992,439
2021-03-27,Santa Clara,085,1922200,114016,114124,636,114760,1871
2021-03-27,Santa Cruz,087,273765,15830,15215,785,16000,201
2021-03-27,Shasta,089,179085,11287,11288,1335,12623,183
2021-03-27,Sierra,091,2930,55,50,12,62,0
2021-03-27,Siskiyou,093,43540,1570,1497,254,1751,6
2021-03-27,Solano,095,438530,30825,30669,404,31073,232
2021-03-27,Sonoma,097,501317,29031,29133,264,29397,310
2021-03-27,Stanislaus,099,539301,52990,52497,5511,58008,678
2021-03-27,Sutter,101,95872,9092,9093,79,9172,106
2021-03-27,Tehama,103,63373,4767,4738,502,5240,52
2021-03-27,Trinity,105,12862,476,313,80,393,3
2021-03-27,Tulare,107,460477,49236,48203,8425,56628,813
2021-03-27,Tuolumne,109,53932,3909,3968,38,4006,57
2021-03-27,Ventura,111,848112,79810,79184,2840,82024,956
2021-03-27,Yolo,113,214977,13327,13317,158,13475,194
2021-03-27,Yuba,115,75493,5719,5657,105,5762,42
2021-03-26,Alameda,001,1643700,83633,83043,1755,84798,1208
2021-03-26,Alpine,003,1148,85,85,0,85,0
2021-03-26,Amador,005,37829,3555,3532,31,3563,45
2021-03-26,Butte,007,227075,11663,11278,1650,12928,191
2021-03-26,Calaveras,009,45235,1996,1989,11,2000,50
2021-03-26,Colusa,011,21464,1890,1889,271,2160,14
2021-03-26,Contra Costa,013,1133247,65616,64699,1113,65812,761
2021-03-26,Del Norte,015,27424,1173,1101,7,1108,6
2021-03-26,El Dorado,017,186661,9432,9353,620,9973,105
2021-03-26,Fresno,019,978130,99664,98731,8130,106861,1601
2021-03-26,Glenn,021,27897,2343,2307,521,2828,17
2021-03-26,Humboldt,023,135768,3447,3431,24,3455,34
2021-03-26,Imperial,025,180216,27576,27374,2528,29902,701
2021-03-26,Inyo,027,18085,1373,1369,9,1378,35
2021-03-26,Kern,029,883053,95325,93949,10147,104096,1211
2021-03-26,Kings,031,150075,22773,22493,1005,23498,239
2021-03-26,Lake,033,64148,3347,3314,8,3322,43
2021-03-26,Lassen,035,31185,5142,5131,100,5231,1
2021-03-26,Los Angeles,037,10098052,1188092,1178213,39486,1217699,23080
2021-03-26,Madera,039,155013,16103,15952,873,16825,210
2021-03-26,Marin,041,260295,13651,13553,194,13747,221
2021-03-26,Mariposa,043,17540,393,386,5,391,5
2021-03-26,Mendocino,045,87422,3750,3664,73,3737,45
2021-03-26,Merced,047,269075,29704,29613,973,30586,419
2021-03-26,Modoc,049,8938,352,344,119,463,3
2021-03-26,Mono,051,14174,1230,1236,16,1252,3
2021-03-26,Monterey,053,433212,42493,42241,1733,43974,338
2021-03-26,Napa,055,140530,9402,9349,32,9381,78
2021-03-26,Nevada,057,99092,4304,4222,178,4400,83
2021-03-26,Orange,059,3164182,250910,248995,10611,259606,4671
2021-03-26,Placer,061,380077,21519,20679,1223,21902,259
2021-03-26,Plumas,063,18699,668,654,10,664,4
2021-03-26,Riverside,065,2383286,289232,282602,13499,296101,4109
2021-03-26,Sacramento,067,1510023,98618,97040,1379,98419,1509
2021-03-26,San Benito,069,59416,5849,5855,91,5946,61
2021-03-26,San Bernardino,071,2135413,288970,285313,8670,293983,4288
2021-03-26,San Diego,073,3302833,270503,269045,13465,282510,3525
2021-03-26,San Francisco,075,870044,35192,35186,1172,36358,472
2021-03-26,San Joaquin,077,732212,69524,68249,3073,71322,1202
2021-03-26,San Luis Obispo,079,281455,20442,20118,611,20729,250
2021-03-26,San Mateo,081,765935,40668,40199,426,40625,348
2021-03-26,Santa Barbara,083,443738,33297,32895,1070,33965,439
2021-03-26,Santa Clara,085,1922200,113918,113959,635,114594,1868
2021-03-26,Santa Cruz,087,273765,15815,15199,784,15983,201
2021-03-26,Shasta,089,179085,11278,11276,1329,12605,182
2021-03-26,Sierra,091,2930,55,50,12,62,0
2021-03-26,Siskiyou,093,43540,1570,1493,253,1746,6
2021-03-26,Solano,095,438530,30800,30640,404,31044,205
2021-03-26,Sonoma,097,501317,29015,29101,261,29362,310
2021-03-26,Stanislaus,099,539301,52922,52420,5507,57927,678
2021-03-26,Sutter,101,95872,9089,9082,79,9161,104
2021-03-26,Tehama,103,63373,4766,4722,501,5223,51
2021-03-26,Trinity,105,12862,476,311,80,391,3
2021-03-26,Tulare,107,460477,49221,48179,8418,56597,813
2021-03-26,Tuolumne,109,53932,3908,3965,38,4003,57
2021-03-26,Ventura,111,848112,79776,79122,2838,81960,953
2021-03-26,Yolo,113,214977,13320,13299,156,13455,194
2021-03-26,Yuba,115,75493,5709,5653,105,5758,42
2021-03-25,Alameda,001,1643700,83538,82945,1753,84698,1206
2021-03-25,Alpine,003,1148,85,84,0,84,0
2021-03-25,Amador,005,37829,3553,3530,31,3561,45
2021-03-25,Butte,007,227075,11653,11270,1650,12920,188
2021-03-25,Calaveras,009,45235,1995,1982,11,1993,50
2021-03-25,Colusa,011,21464,1890,1888,271,2159,14
2021-03-25,Contra Costa,013,1133247,65549,64606,1110,65716,757
2021-03-25,Del Norte,015,27424,1167,1095,7,1102,6
2021-03-25,El Dorado,017,186661,9422,9331,620,9951,105
2021-03-25,Fresno,019,978130,99546,98602,8117,106719,1593
2021-03-25,Glenn,021,27897,2342,2302,520,2822,17
2021-03-25,Humboldt,023,135768,3442,3423,24,3447,34
2021-03-25,Imperial,025,180216,27560,27352,2527,29879,699
2021-03-25,Inyo,027,18085,1373,1369,9,1378,35
2021-03-25,Kern,029,883053,95293,93857,10142,103999,1206
2021-03-25,Kings,031,150075,22763,22472,1005,23477,237
2021-03-25,Lake,033,64148,3342,3312,8,3320,43
2021-03-25,Lassen,035,31185,5142,5129,100,5229,1
2021-03-25,Los Angeles,037,10098052,1187656,1177490,39451,1216941,23051
2021-03-25,Madera,039,155013,16084,15937,871,16808,210
2021-03-25,Marin,041,260295,13641,13538,191,13729,219
2021-03-25,Mariposa,043,17540,393,386,5,391,5
2021-03-25,Mendocino,045,87422,3749,3664,73,3737,45
2021-03-25,Merced,047,269075,29670,29576,966,30542,416
2021-03-25,Modoc,049,8938,352,343,119,462,3
2021-03-25,Mono,051,14174,1230,1235,16,1251,3
2021-03-25,Monterey,053,433212,42472,42220,1728,43948,336
2021-03-25,Napa,055,140530,9383,9321,32,9353,78
2021-03-25,Nevada,057,99092,4286,4202,176,4378,84
2021-03-25,Orange,059,3164182,250794,248871,10591,259462,4655
2021-03-25,Placer,061,380077,21478,20639,1216,21855,252
2021-03-25,Plumas,063,18699,668,654,10,664,4
2021-03-25,Riverside,065,2383286,289135,282492,13488,295980,4078
2021-03-25,Sacramento,067,1510023,98473,96823,1377,98200,1505
2021-03-25,San Benito,069,59416,5846,5850,91,5941,61
2021-03-25,San Bernardino,071,2135413,288889,285134,8665,293799,4222
2021-03-25,San Diego,073,3302833,270275,268623,13434,282057,3520
2021-03-25,San Francisco,075,870044,35152,35154,1170,36324,468
2021-03-25,San Joaquin,077,732212,69427,68089,3035,71124,1196
2021-03-25,San Luis Obispo,079,281455,20424,20076,611,20687,250
2021-03-25,San Mateo,081,765935,40628,40147,426,40573,348
2021-03-25,Santa Barbara,083,443738,33270,32857,1070,33927,439
2021-03-25,Santa Clara,085,1922200,113814,113877,633,114510,1868
2021-03-25,Santa Cruz,087,273765,15794,15170,784,15954,201
2021-03-25,Shasta,089,179085,11261,11262,1326,12588,181
2021-03-25,Sierra,091,2930,55,50,12,62,0
2021-03-25,Siskiyou,093,43540,1568,1491,252,1743,6
2021-03-25,Solano,095,438530,30739,30583,402,30985,193
2021-03-25,Sonoma,097,501317,28981,29060,257,29317,310
2021-03-25,Stanislaus,099,539301,52855,52321,5500,57821,678
2021-03-25,Sutter,101,95872,9080,9069,79,9148,104
2021-03-25,Tehama,103,63373,4764,4719,500,5219,52
2021-03-25,Trinity,105,12862,476,310,80,390,3
2021-03-25,Tulare,107,460477,49194,48148,8406,56554,811
2021-03-25,Tuolumne,109,53932,3907,3962,38,4000,57
2021-03-25,Ventura,111,848112,79735,79045,2834,81879,952
2021-03-25,Yolo,113,214977,13314,13287,156,13443,194
2021-03-25,Yuba,115,75493,5703,5647,99,5746,42
2021-03-24,Alameda,001,1643700,83444,82871,1750,84621,1199
2021-03-24,Alpine,003,1148,85,84,0,84,0
2021-03-24,Amador,005,37829,3547,3529,31,3560,45
2021-03-24,Butte,007,227075,11643,11252,1646,12898,187
2021-03-24,Calaveras,009,45235,1992,1975,11,1986,50
2021-03-24,Colusa,011,21464,1890,1886,271,2157,14
2021-03-24,Contra Costa,013,1133247,65469,64539,1109,65648,755
2021-03-24,Del Norte,015,27424,1162,1087,7,1094,6
2021-03-24,El Dorado,017,186661,9416,9319,619,9938,105
2021-03-24,Fresno,019,978130,99456,98437,8102,106539,1585
2021-03-24,Glenn,021,27897,2341,2297,519,2816,17
2021-03-24,Humboldt,023,135768,3439,3414,24,3438,34
2021-03-24,Imperial,025,180216,27551,27325,2527,29852,699
2021-03-24,Inyo,027,18085,1373,1368,9,1377,35
2021-03-24,Kern,029,883053,95245,93800,10133,103933,1198
2021-03-24,Kings,031,150075,22748,22456,1003,23459,237
2021-03-24,Lake,033,64148,3338,3307,8,3315,43
2021-03-24,Lassen,035,31185,5140,5130,99,5229,1
2021-03-24,Los Angeles,037,10098052,1187170,1177015,39418,1216433,22993
2021-03-24,Madera,039,155013,16075,15918,870,16788,210
2021-03-24,Marin,041,260295,13627,13526,189,13715,219
2021-03-24,Mariposa,043,17540,393,384,5,389,5
2021-03-24,Mendocino,045,87422,3746,3660,73,3733,45
2021-03-24,Merced,047,269075,29629,29525,966,30491,415
2021-03-24,Modoc,049,8938,351,341,119,460,3
2021-03-24,Mono,051,14174,1229,1243,16,1259,3
2021-03-24,Monterey,053,433212,42450,42201,1725,43926,335
2021-03-24,Napa,055,140530,9363,9310,32,9342,78
2021-03-24,Nevada,057,99092,4271,4191,175,4366,85
2021-03-24,Orange,059,3164182,250680,248775,10573,259348,4638
2021-03-24,Placer,061,380077,21448,20606,1208,21814,250
2021-03-24,Plumas,063,18699,666,652,10,662,4
2021-03-24,Riverside,065,2383286,289051,282410,13485,295895,4058
2021-03-24,Sacramento,067,1510023,98298,96628,1366,97994,1500
2021-03-24,San Benito,069,59416,5845,5847,91,5938,61
2021-03-24,San Bernardino,071,2135413,288802,284983,8663,293646,4170
2021-03-24,San Diego,073,3302833,270061,268413,13406,281819,3509
2021-03-24,San Francisco,075,870044,35124,35103,1167,36270,462
2021-03-24,San Joaquin,077,732212,69356,67978,3023,71001,1196
2021-03-24,San Luis Obispo,079,281455,20394,20021,610,20631,250
2021-03-24,San Mateo,081,765935,40578,40083,426,40509,348
2021-03-24,Santa Barbara,083,443738,33242,32810,1070,33880,438
2021-03-24,Santa Clara,085,1922200,113698,113757,630,114387,1851
2021-03-24,Santa Cruz,087,273765,15780,15138,783,15921,202
2021-03-24,Shasta,089,179085,11242,11243,1324,12567,181
2021-03-24,Sierra,091,2930,55,50,12,62,0
2021-03-24,Siskiyou,093,43540,1566,1490,252,1742,6
2021-03-24,Solano,095,438530,30702,30552,401,30953,178
2021-03-24,Sonoma,097,501317,28961,29034,253,29287,310
2021-03-24,Stanislaus,099,539301,52779,52259,5491,57750,677
2021-03-24,Sutter,101,95872,9064,9049,79,9128,104
2021-03-24,Tehama,103,63373,4758,4719,499,5218,49
2021-03-24,Trinity,105,12862,475,310,80,390,3
2021-03-24,Tulare,107,460477,49183,48109,8393,56502,808
2021-03-24,Tuolumne,109,53932,3906,3961,38,3999,57
2021-03-24,Ventura,111,848112,79683,78993,2827,81820,944
2021-03-24,Yolo,113,214977,13302,13269,156,13425,194
2021-03-24,Yuba,115,75493,5697,5634,96,5730,42
2021-03-23,Alameda,001,1643700,83342,82799,1746,84545,1190
2021-03-23,Alpine,003,1148,85,84,0,84,0
2021-03-23,Amador,005,37829,3541,3524,31,3555,45
2021-03-23,Butte,007,227075,11631,11227,1645,12872,187
2021-03-23,Calaveras,009,45235,1990,1971,11,1982,50
2021-03-23,Colusa,011,21464,1888,1885,270,2155,14
2021-03-23,Contra Costa,013,1133247,65369,64491,1108,65599,750
2021-03-23,Del Norte,015,27424,1157,1082,7,1089,6
2021-03-23,El Dorado,017,186661,9406,9318,616,9934,105
2021-03-23,Fresno,019,978130,99342,98362,8078,106440,1575
2021-03-23,Glenn,021,27897,2336,2293,517,2810,17
2021-03-23,Humboldt,023,135768,3430,3405,24,3429,34
2021-03-23,Imperial,025,180216,27543,27320,2527,29847,699
2021-03-23,Inyo,027,18085,1371,1364,9,1373,35
2021-03-23,Kern,029,883053,95138,93728,10126,103854,1191
2021-03-23,Kings,031,150075,22737,22439,1001,23440,237
2021-03-23,Lake,033,64148,3336,3294,8,3302,43
2021-03-23,Lassen,035,31185,5140,5130,99,5229,1
2021-03-23,Los Angeles,037,10098052,1186650,1176572,39380,1215952,22904
2021-03-23,Madera,039,155013,16059,15908,869,16777,210
2021-03-23,Marin,041,260295,13604,13514,187,13701,221
2021-03-23,Mariposa,043,17540,392,384,5,389,5
2021-03-23,Mendocino,045,87422,3744,3652,73,3725,45
2021-03-23,Merced,047,269075,29596,29485,966,30451,415
2021-03-23,Modoc,049,8938,350,342,119,461,3
2021-03-23,Mono,051,14174,1228,1263,16,1279,3
2021-03-23,Monterey,053,433212,42439,42180,1723,43903,335
2021-03-23,Napa,055,140530,9338,9299,32,9331,78
2021-03-23,Nevada,057,99092,4252,4179,174,4353,89
2021-03-23,Orange,059,3164182,250554,248661,10555,259216,4626
2021-03-23,Placer,061,380077,21413,20567,1204,21771,248
2021-03-23,Plumas,063,18699,666,652,10,662,4
2021-03-23,Riverside,065,2383286,288951,282317,13479,295796,4035
2021-03-23,Sacramento,067,1510023,98106,96521,1362,97883,1496
2021-03-23,San Benito,069,59416,5840,5845,90,5935,61
2021-03-23,San Bernardino,071,2135413,288717,284875,8655,293530,4134
2021-03-23,San Diego,073,3302833,269816,268156,13374,281530,3498
2021-03-23,San Francisco,075,870044,35066,35071,1162,36233,462
2021-03-23,San Joaquin,077,732212,69260,67903,3005,70908,1182
2021-03-23,San Luis Obispo,079,281455,20354,20009,609,20618,250
2021-03-23,San Mateo,081,765935,40522,40032,425,40457,348
2021-03-23,Santa Barbara,083,443738,33204,32771,1069,33840,438
2021-03-23,Santa Clara,085,1922200,113582,113645,627,114272,1848
2021-03-23,Santa Cruz,087,273765,15765,15106,783,15889,201
2021-03-23,Shasta,089,179085,11229,11234,1323,12557,175
2021-03-23,Sierra,091,2930,55,50,12,62,0
2021-03-23,Siskiyou,093,43540,1561,1485,250,1735,6
2021-03-23,Solano,095,438530,30661,30524,400,30924,178
2021-03-23,Sonoma,097,501317,28924,29020,252,29272,310
2021-03-23,Stanislaus,099,539301,52680,52148,5484,57632,677
2021-03-23,Sutter,101,95872,9056,9039,79,9118,104
2021-03-23,Tehama,103,63373,4749,4707,498,5205,46
2021-03-23,Trinity,105,12862,475,310,80,390,3
2021-03-23,Tulare,107,460477,49156,48095,8377,56472,808
2021-03-23,Tuolumne,109,53932,3903,3957,38,3995,57
2021-03-23,Ventura,111,848112,79622,78930,2824,81754,932
2021-03-23,Yolo,113,214977,13291,13255,156,13411,194
2021-03-23,Yuba,115,75493,5692,5628,96,5724,42
2021-03-22,Alameda,001,1643700,83249,82748,1740,84488,1189
2021-03-22,Alpine,003,1148,84,83,0,83,0
2021-03-22,Amador,005,37829,3533,3522,31,3553,44
2021-03-22,Butte,007,227075,11622,11211,1643,12854,185
2021-03-22,Calaveras,009,45235,1986,1963,11,1974,49
2021-03-22,Colusa,011,21464,1886,1885,270,2155,13
2021-03-22,Contra Costa,013,1133247,65274,64432,1106,65538,740
2021-03-22,Del Norte,015,27424,1151,1082,7,1089,6
2021-03-22,El Dorado,017,186661,9390,9310,612,9922,105
2021-03-22,Fresno,019,978130,99244,98276,8066,106342,1556
2021-03-22,Glenn,021,27897,2328,2291,517,2808,17
2021-03-22,Humboldt,023,135768,3425,3403,24,3427,34
2021-03-22,Imperial,025,180216,27528,27302,2524,29826,699
2021-03-22,Inyo,027,18085,1368,1363,9,1372,35
2021-03-22,Kern,029,883053,95067,93675,10110,103785,1178
2021-03-22,Kings,031,150075,22724,22433,996,23429,236
2021-03-22,Lake,033,64148,3335,3290,8,3298,43
2021-03-22,Lassen,035,31185,5138,5129,99,5228,1
2021-03-22,Los Angeles,037,10098052,1186133,1176205,39350,1215555,22843
2021-03-22,Madera,039,155013,16044,15904,869,16773,210
2021-03-22,Marin,041,260295,13595,13501,186,13687,221
2021-03-22,Mariposa,043,17540,391,381,5,386,5
2021-03-22,Mendocino,045,87422,3742,3653,73,3726,45
2021-03-22,Merced,047,269075,29553,29468,963,30431,413
2021-03-22,Modoc,049,8938,348,342,119,461,3
2021-03-22,Mono,051,14174,1223,1263,16,1279,3
2021-03-22,Monterey,053,433212,42423,42161,1721,43882,335
2021-03-22,Napa,055,140530,9327,9288,32,9320,77
2021-03-22,Nevada,057,99092,4242,4174,170,4344,89
2021-03-22,Orange,059,3164182,250403,248517,10521,259038,4599
2021-03-22,Placer,061,380077,21378,20543,1199,21742,242
2021-03-22,Plumas,063,18699,666,652,10,662,4
2021-03-22,Riverside,065,2383286,288851,282242,13468,295710,4009
2021-03-22,Sacramento,067,1510023,97928,96385,1352,97737,1493
2021-03-22,San Benito,069,59416,5837,5844,89,5933,61
2021-03-22,San Bernardino,071,2135413,288629,284771,8643,293414,4107
2021-03-22,San Diego,073,3302833,269604,267913,13354,281267,3494
2021-03-22,San Francisco,075,870044,35024,35040,1158,36198,462
2021-03-22,San Joaquin,077,732212,69168,67815,2988,70803,1182
2021-03-22,San Luis Obispo,079,281455,20330,20000,608,20608,250
2021-03-22,San Mateo,081,765935,40471,40024,424,40448,348
2021-03-22,Santa Barbara,083,443738,33160,32756,1067,33823,437
2021-03-22,Santa Clara,085,1922200,113462,113575,627,114202,1845
2021-03-22,Santa Cruz,087,273765,15753,15077,782,15859,201
2021-03-22,Shasta,089,179085,11215,11218,1322,12540,150
2021-03-22,Sierra,091,2930,55,50,12,62,0
2021-03-22,Siskiyou,093,43540,1560,1487,249,1736,5
2021-03-22,Solano,095,438530,30621,30490,396,30886,171
2021-03-22,Sonoma,097,501317,28895,29010,248,29258,310
2021-03-22,Stanislaus,099,539301,52596,52083,5479,57562,677
2021-03-22,Sutter,101,95872,9043,9024,79,9103,104
2021-03-22,Tehama,103,63373,4741,4704,498,5202,45
2021-03-22,Trinity,105,12862,475,310,80,390,3
2021-03-22,Tulare,107,460477,49141,48074,8357,56431,807
2021-03-22,Tuolumne,109,53932,3900,3954,38,3992,57
2021-03-22,Ventura,111,848112,79576,78890,2821,81711,927
2021-03-22,Yolo,113,214977,13279,13243,155,13398,190
2021-03-22,Yuba,115,75493,5681,5627,94,5721,42
2021-03-21,Alameda,001,1643700,83160,82684,1737,84421,1187
2021-03-21,Alpine,003,1148,84,83,0,83,0
2021-03-21,Amador,005,37829,3529,3519,31,3550,44
2021-03-21,Butte,007,227075,11606,11208,1638,12846,185
2021-03-21,Calaveras,009,45235,1980,1962,11,1973,49
2021-03-21,Colusa,011,21464,1886,1885,270,2155,13
2021-03-21,Contra Costa,013,1133247,65192,64382,1102,65484,740
2021-03-21,Del Norte,015,27424,1136,1076,7,1083,6
2021-03-21,El Dorado,017,186661,9380,9302,607,9909,105
2021-03-21,Fresno,019,978130,99130,98211,8043,106254,1556
2021-03-21,Glenn,021,27897,2325,2288,516,2804,17
2021-03-21,Humboldt,023,135768,3420,3402,24,3426,34
2021-03-21,Imperial,025,180216,27511,27267,2519,29786,699
2021-03-21,Inyo,027,18085,1368,1363,9,1372,35
2021-03-21,Kern,029,883053,95001,93649,10101,103750,1170
2021-03-21,Kings,031,150075,22707,22422,996,23418,236
2021-03-21,Lake,033,64148,3331,3286,8,3294,43
2021-03-21,Lassen,035,31185,5138,5129,99,5228,1
2021-03-21,Los Angeles,037,10098052,1185597,1175684,39303,1214987,22834
2021-03-21,Madera,039,155013,16024,15895,867,16762,210
2021-03-21,Marin,041,260295,13579,13495,185,13680,220
2021-03-21,Mariposa,043,17540,391,381,5,386,5
2021-03-21,Mendocino,045,87422,3739,3651,73,3724,45
2021-03-21,Merced,047,269075,29493,29446,957,30403,413
2021-03-21,Modoc,049,8938,348,341,119,460,3
2021-03-21,Mono,051,14174,1218,1263,16,1279,3
2021-03-21,Monterey,053,433212,42398,42153,1718,43871,335
2021-03-21,Napa,055,140530,9307,9282,32,9314,77
2021-03-21,Nevada,057,99092,4229,4169,170,4339,89
2021-03-21,Orange,059,3164182,250270,248442,10494,258936,4598
2021-03-21,Placer,061,380077,21342,20520,1191,21711,242
2021-03-21,Plumas,063,18699,666,653,10,663,4
2021-03-21,Riverside,065,2383286,288744,282187,13457,295644,4009
2021-03-21,Sacramento,067,1510023,97734,96269,1345,97614,1489
2021-03-21,San Benito,069,59416,5831,5842,89,5931,61
2021-03-21,San Bernardino,071,2135413,288539,284732,8637,293369,4094
2021-03-21,San Diego,073,3302833,269344,267724,13328,281052,3494
2021-03-21,San Francisco,075,870044,34977,35012,1152,36164,460
2021-03-21,San Joaquin,077,732212,69046,67729,2970,70699,1182
2021-03-21,San Luis Obispo,079,281455,20298,19979,606,20585,250
2021-03-21,San Mateo,081,765935,40426,39988,423,40411,344
2021-03-21,Santa Barbara,083,443738,33121,32743,1066,33809,437
2021-03-21,Santa Clara,085,1922200,113332,113487,624,114111,1840
2021-03-21,Santa Cruz,087,273765,15746,15064,782,15846,199
2021-03-21,Shasta,089,179085,11195,11215,1321,12536,150
2021-03-21,Sierra,091,2930,55,50,12,62,0
2021-03-21,Siskiyou,093,43540,1560,1486,248,1734,5
2021-03-21,Solano,095,438530,30581,30474,393,30867,171
2021-03-21,Sonoma,097,501317,28866,28986,247,29233,310
2021-03-21,Stanislaus,099,539301,52506,52014,5477,57491,677
2021-03-21,Sutter,101,95872,9030,9021,79,9100,104
2021-03-21,Tehama,103,63373,4737,4701,498,5199,45
2021-03-21,Trinity,105,12862,473,310,80,390,3
2021-03-21,Tulare,107,460477,49125,48060,8345,56405,807
2021-03-21,Tuolumne,109,53932,3898,3953,38,3991,57
2021-03-21,Ventura,111,848112,79513,78863,2816,81679,927
2021-03-21,Yolo,113,214977,13257,13235,155,13390,190
2021-03-21,Yuba,115,75493,5671,5624,94,5718,42
2021-03-20,Alameda,001,1643700,83092,82614,1735,84349,1178
2021-03-20,Alpine,003,1148,84,83,0,83,0
2021-03-20,Amador,005,37829,3527,3518,31,3549,44
2021-03-20,Butte,007,227075,11600,11199,1636,12835,185
2021-03-20,Calaveras,009,45235,1976,1961,11,1972,49
2021-03-20,Colusa,011,21464,1886,1883,270,2153,12
2021-03-20,Contra Costa,013,1133247,65132,64313,1102,65415,713
2021-03-20,Del Norte,015,27424,1135,1075,7,1082,6
2021-03-20,El Dorado,017,186661,9374,9290,607,9897,105
2021-03-20,Fresno,019,978130,99070,98112,8036,106148,1532
2021-03-20,Glenn,021,27897,2324,2288,514,2802,17
2021-03-20,Humboldt,023,135768,3413,3399,24,3423,33
2021-03-20,Imperial,025,180216,27505,27239,2517,29756,695
2021-03-20,Inyo,027,18085,1368,1362,9,1371,35
2021-03-20,Kern,029,883053,94972,93606,10097,103703,1155
2021-03-20,Kings,031,150075,22702,22415,995,23410,236
2021-03-20,Lake,033,64148,3327,3280,8,3288,43
2021-03-20,Lassen,035,31185,5138,5128,99,5227,1
2021-03-20,Los Angeles,037,10098052,1185298,1175290,39279,1214569,22810
2021-03-20,Madera,039,155013,16016,15891,866,16757,210
2021-03-20,Marin,041,260295,13567,13470,181,13651,220
2021-03-20,Mariposa,043,17540,390,381,5,386,5
2021-03-20,Mendocino,045,87422,3738,3639,73,3712,43
2021-03-20,Merced,047,269075,29462,29411,954,30365,412
2021-03-20,Modoc,049,8938,347,341,119,460,3
2021-03-20,Mono,051,14174,1218,1256,16,1272,3
2021-03-20,Monterey,053,433212,42389,42146,1717,43863,334
2021-03-20,Napa,055,140530,9299,9274,32,9306,77
2021-03-20,Nevada,057,99092,4218,4164,169,4333,89
2021-03-20,Orange,059,3164182,250189,248348,10483,258831,4522
2021-03-20,Placer,061,380077,21319,20505,1189,21694,242
2021-03-20,Plumas,063,18699,663,652,10,662,4
2021-03-20,Riverside,065,2383286,288669,282081,13453,295534,4000
2021-03-20,Sacramento,067,1510023,97623,96126,1342,97468,1488
2021-03-20,San Benito,069,59416,5827,5840,89,5929,61
2021-03-20,San Bernardino,071,2135413,288473,284690,8633,293323,3965
2021-03-20,San Diego,073,3302833,269173,267532,13321,280853,3493
2021-03-20,San Francisco,075,870044,34955,34968,1145,36113,453
2021-03-20,San Joaquin,077,732212,69005,67662,2963,70625,1161
2021-03-20,San Luis Obispo,079,281455,20282,19951,600,20551,250
2021-03-20,San Mateo,081,765935,40392,39958,422,40380,344
2021-03-20,Santa Barbara,083,443738,33096,32723,1065,33788,434
2021-03-20,Santa Clara,085,1922200,113240,113384,623,114007,1799
2021-03-20,Santa Cruz,087,273765,15730,15053,782,15835,199
2021-03-20,Shasta,089,179085,11189,11211,1321,12532,147
2021-03-20,Sierra,091,2930,55,50,12,62,0
2021-03-20,Siskiyou,093,43540,1560,1483,248,1731,5
2021-03-20,Solano,095,438530,30551,30439,393,30832,170
2021-03-20,Sonoma,097,501317,28851,28962,247,29209,309
2021-03-20,Stanislaus,099,539301,52450,51925,5470,57395,673
2021-03-20,Sutter,101,95872,9022,9014,79,9093,103
2021-03-20,Tehama,103,63373,4732,4696,496,5192,33
2021-03-20,Trinity,105,12862,472,310,80,390,3
2021-03-20,Tulare,107,460477,49110,48030,8328,56358,804
2021-03-20,Tuolumne,109,53932,3895,3950,38,3988,57
2021-03-20,Ventura,111,848112,79478,78818,2814,81632,922
2021-03-20,Yolo,113,214977,13253,13226,155,13381,190
2021-03-20,Yuba,115,75493,5668,5621,93,5714,42
2021-03-19,Alameda,001,1643700,83020,82499,1734,84233,1187
2021-03-19,Alpine,003,1148,83,82,0,82,0
2021-03-19,Amador,005,37829,3524,3515,31,3546,44
2021-03-19,Butte,007,227075,11592,11191,1633,12824,185
2021-03-19,Calaveras,009,45235,1975,1957,11,1968,49
2021-03-19,Colusa,011,21464,1885,1883,270,2153,12
2021-03-19,Contra Costa,013,1133247,65073,64195,1099,65294,737
2021-03-19,Del Norte,015,27424,1129,1071,5,1076,6
2021-03-19,El Dorado,017,186661,9365,9274,607,9881,105
2021-03-19,Fresno,019,978130,98986,97969,8023,105992,1527
2021-03-19,Glenn,021,27897,2324,2282,514,2796,17
2021-03-19,Humboldt,023,135768,3404,3388,24,3412,33
2021-03-19,Imperial,025,180216,27493,27218,2514,29732,695
2021-03-19,Inyo,027,18085,1366,1356,9,1365,35
2021-03-19,Kern,029,883053,94939,93534,10084,103618,1152
2021-03-19,Kings,031,150075,22693,22369,992,23361,235
2021-03-19,Lake,033,64148,3321,3262,8,3270,43
2021-03-19,Lassen,035,31185,5138,5126,99,5225,1
2021-03-19,Los Angeles,037,10098052,1184958,1174818,39262,1214080,22752
2021-03-19,Madera,039,155013,16009,15877,865,16742,210
2021-03-19,Marin,041,260295,13555,13441,181,13622,220
2021-03-19,Mariposa,043,17540,389,380,5,385,5
2021-03-19,Mendocino,045,87422,3737,3639,73,3712,45
2021-03-19,Merced,047,269075,29435,29376,952,30328,412
2021-03-19,Modoc,049,8938,347,341,119,460,3
2021-03-19,Mono,051,14174,1216,1244,16,1260,3
2021-03-19,Monterey,053,433212,42380,42125,1715,43840,335
2021-03-19,Napa,055,140530,9287,9256,32,9288,77
2021-03-19,Nevada,057,99092,4207,4156,169,4325,88
2021-03-19,Orange,059,3164182,250089,248146,10474,258620,4501
2021-03-19,Placer,061,380077,21301,20451,1187,21638,242
2021-03-19,Plumas,063,18699,663,650,10,660,4
2021-03-19,Riverside,065,2383286,288586,281937,13448,295385,3989
2021-03-19,Sacramento,067,1510023,97520,95934,1339,97273,1486
2021-03-19,San Benito,069,59416,5827,5845,89,5934,61
2021-03-19,San Bernardino,071,2135413,288402,284501,8631,293132,4017
2021-03-19,San Diego,073,3302833,269038,267173,13311,280484,3491
2021-03-19,San Francisco,075,870044,34910,34936,1142,36078,461
2021-03-19,San Joaquin,077,732212,68935,67515,2949,70464,1180
2021-03-19,San Luis Obispo,079,281455,20262,19913,598,20511,249
2021-03-19,San Mateo,081,765935,40368,39893,422,40315,344
2021-03-19,Santa Barbara,083,443738,33066,32685,1064,33749,435
2021-03-19,Santa Clara,085,1922200,113165,113232,622,113854,1797
2021-03-19,Santa Cruz,087,273765,15723,15026,782,15808,199
2021-03-19,Shasta,089,179085,11182,11104,1319,12423,103
2021-03-19,Sierra,091,2930,54,49,12,61,0
2021-03-19,Siskiyou,093,43540,1560,1480,247,1727,5
2021-03-19,Solano,095,438530,30521,30395,391,30786,172
2021-03-19,Sonoma,097,501317,28830,28932,245,29177,292
2021-03-19,Stanislaus,099,539301,52392,51755,5467,57222,679
2021-03-19,Sutter,101,95872,9020,9005,79,9084,103
2021-03-19,Tehama,103,63373,4725,4685,496,5181,33
2021-03-19,Trinity,105,12862,472,310,80,390,3
2021-03-19,Tulare,107,460477,49087,47989,8305,56294,805
2021-03-19,Tuolumne,109,53932,3892,3946,38,3984,57
2021-03-19,Ventura,111,848112,79445,78753,2810,81563,920
2021-03-19,Yolo,113,214977,13245,13197,155,13352,189
2021-03-19,Yuba,115,75493,5665,5615,92,5707,42
2021-03-18,Alameda,001,1643700,82940,82419,1731,84150,1189
2021-03-18,Alpine,003,1148,83,82,0,82,0
2021-03-18,Amador,005,37829,3520,3513,31,3544,44
2021-03-18,Butte,007,227075,11581,11179,1631,12810,185
2021-03-18,Calaveras,009,45235,1973,1954,11,1965,49
2021-03-18,Colusa,011,21464,1885,1882,270,2152,12
2021-03-18,Contra Costa,013,1133247,65000,64103,1096,65199,739
2021-03-18,Del Norte,015,27424,1120,1059,5,1064,6
2021-03-18,El Dorado,017,186661,9352,9261,606,9867,105
2021-03-18,Fresno,019,978130,98889,97856,8008,105864,1527
2021-03-18,Glenn,021,27897,2320,2275,513,2788,17
2021-03-18,Humboldt,023,135768,3396,3381,24,3405,34
2021-03-18,Imperial,025,180216,27478,27190,2509,29699,695
2021-03-18,Inyo,027,18085,1363,1354,9,1363,35
2021-03-18,Kern,029,883053,94882,93458,10070,103528,1158
2021-03-18,Kings,031,150075,22686,22354,991,23345,235
2021-03-18,Lake,033,64148,3318,3260,8,3268,43
2021-03-18,Lassen,035,31185,5137,5126,99,5225,1
2021-03-18,Los Angeles,037,10098052,1184525,1174205,39233,1213438,22689
2021-03-18,Madera,039,155013,15997,15860,862,16722,211
2021-03-18,Marin,041,260295,13537,13435,180,13615,219
2021-03-18,Mariposa,043,17540,387,380,5,385,5
2021-03-18,Mendocino,045,87422,3727,3630,73,3703,45
2021-03-18,Merced,047,269075,29400,29317,952,30269,410
2021-03-18,Modoc,049,8938,347,341,119,460,3
2021-03-18,Mono,051,14174,1212,1215,15,1230,3
2021-03-18,Monterey,053,433212,42368,42105,1715,43820,335
2021-03-18,Napa,055,140530,9278,9243,32,9275,77
2021-03-18,Nevada,057,99092,4200,4154,169,4323,74
2021-03-18,Orange,059,3164182,249986,248050,10461,258511,4514
2021-03-18,Placer,061,380077,21269,20421,1184,21605,243
2021-03-18,Plumas,063,18699,661,648,10,658,4
2021-03-18,Riverside,065,2383286,288505,281789,13441,295230,3957
2021-03-18,Sacramento,067,1510023,97372,95819,1335,97154,1481
2021-03-18,San Benito,069,59416,5825,5842,89,5931,61
2021-03-18,San Bernardino,071,2135413,288319,284294,8601,292895,4076
2021-03-18,San Diego,073,3302833,268885,266752,13301,280053,3478
2021-03-18,San Francisco,075,870044,34871,34904,1141,36045,461
2021-03-18,San Joaquin,077,732212,68835,67301,2937,70238,1169
2021-03-18,San Luis Obispo,079,281455,20233,19894,597,20491,249
2021-03-18,San Mateo,081,765935,40327,39874,422,40296,344
2021-03-18,Santa Barbara,083,443738,33025,32640,1064,33704,434
2021-03-18,Santa Clara,085,1922200,113048,113119,618,113737,1808
2021-03-18,Santa Cruz,087,273765,15713,14998,782,15780,198
2021-03-18,Shasta,089,179085,11168,11059,1317,12376,100
2021-03-18,Sierra,091,2930,54,49,12,61,0
2021-03-18,Siskiyou,093,43540,1557,1480,246,1726,5
2021-03-18,Solano,095,438530,30479,30352,388,30740,172
2021-03-18,Sonoma,097,501317,28809,28915,243,29158,292
2021-03-18,Stanislaus,099,539301,52320,51615,5463,57078,682
2021-03-18,Sutter,101,95872,9008,8999,79,9078,103
2021-03-18,Tehama,103,63373,4719,4683,495,5178,35
2021-03-18,Trinity,105,12862,472,310,80,390,3
2021-03-18,Tulare,107,460477,49068,47964,8290,56254,805
2021-03-18,Tuolumne,109,53932,3891,3942,38,3980,57
2021-03-18,Ventura,111,848112,79385,78697,2810,81507,918
2021-03-18,Yolo,113,214977,13232,13183,155,13338,191
2021-03-18,Yuba,115,75493,5661,5612,92,5704,42
2021-03-17,Alameda,001,1643700,82864,82353,1726,84079,1185
2021-03-17,Alpine,003,1148,83,82,0,82,0
2021-03-17,Amador,005,37829,3518,3511,31,3542,44
2021-03-17,Butte,007,227075,11572,11170,1629,12799,185
2021-03-17,Calaveras,009,45235,1970,1946,11,1957,49
2021-03-17,Colusa,011,21464,1884,1882,270,2152,12
2021-03-17,Contra Costa,013,1133247,64931,64026,1095,65121,737
2021-03-17,Del Norte,015,27424,1116,1053,5,1058,6
2021-03-17,El Dorado,017,186661,9342,9252,606,9858,105
2021-03-17,Fresno,019,978130,98778,97727,7990,105717,1507
2021-03-17,Glenn,021,27897,2313,2269,512,2781,17
2021-03-17,Humboldt,023,135768,3388,3365,24,3389,33
2021-03-17,Imperial,025,180216,27461,27168,2506,29674,691
2021-03-17,Inyo,027,18085,1361,1351,9,1360,35
2021-03-17,Kern,029,883053,94826,93392,10057,103449,1149
2021-03-17,Kings,031,150075,22670,22336,990,23326,233
2021-03-17,Lake,033,64148,3311,3251,8,3259,43
2021-03-17,Lassen,035,31185,5136,5125,99,5224,1
2021-03-17,Los Angeles,037,10098052,1184071,1173416,39200,1212616,22602
2021-03-17,Madera,039,155013,15990,15835,862,16697,214
2021-03-17,Marin,041,260295,13520,13428,179,13607,218
2021-03-17,Mariposa,043,17540,387,379,5,384,5
2021-03-17,Mendocino,045,87422,3723,3625,73,3698,44
2021-03-17,Merced,047,269075,29372,29250,948,30198,408
2021-03-17,Modoc,049,8938,347,341,119,460,3
2021-03-17,Mono,051,14174,1210,1212,15,1227,3
2021-03-17,Monterey,053,433212,42350,42061,1712,43773,334
2021-03-17,Napa,055,140530,9263,9219,32,9251,76
2021-03-17,Nevada,057,99092,4190,4145,169,4314,74
2021-03-17,Orange,059,3164182,249867,247943,10433,258376,4502
2021-03-17,Placer,061,380077,21241,20369,1183,21552,243
2021-03-17,Plumas,063,18699,660,645,10,655,4
2021-03-17,Riverside,065,2383286,288390,281649,13433,295082,3925
2021-03-17,Sacramento,067,1510023,97244,95650,1330,96980,1477
2021-03-17,San Benito,069,59416,5822,5841,89,5930,61
2021-03-17,San Bernardino,071,2135413,288202,284170,8596,292766,4049
2021-03-17,San Diego,073,3302833,268674,266313,13283,279596,3470
2021-03-17,San Francisco,075,870044,34836,34873,1140,36013,457
2021-03-17,San Joaquin,077,732212,68750,67093,2921,70014,1164
2021-03-17,San Luis Obispo,079,281455,20210,19858,593,20451,249
2021-03-17,San Mateo,081,765935,40297,39838,421,40259,344
2021-03-17,Santa Barbara,083,443738,33003,32585,1063,33648,433
2021-03-17,Santa Clara,085,1922200,112955,112983,617,113600,1805
2021-03-17,Santa Cruz,087,273765,15705,14967,782,15749,199
2021-03-17,Shasta,089,179085,11163,11045,1314,12359,100
2021-03-17,Sierra,091,2930,54,49,12,61,0
2021-03-17,Siskiyou,093,43540,1556,1479,245,1724,5
2021-03-17,Solano,095,438530,30453,30320,386,30706,171
2021-03-17,Sonoma,097,501317,28785,28877,242,29119,292
2021-03-17,Stanislaus,099,539301,52245,51524,5456,56980,682
2021-03-17,Sutter,101,95872,8998,8982,79,9061,103
2021-03-17,Tehama,103,63373,4714,4670,495,5165,34
2021-03-17,Trinity,105,12862,472,308,80,388,3
2021-03-17,Tulare,107,460477,49048,47929,8280,56209,805
2021-03-17,Tuolumne,109,53932,3888,3938,38,3976,57
2021-03-17,Ventura,111,848112,79329,78648,2807,81455,916
2021-03-17,Yolo,113,214977,13215,13169,155,13324,190
2021-03-17,Yuba,115,75493,5658,5603,92,5695,42
2021-03-16,Alameda,001,1643700,82753,82259,1724,83983,1177
2021-03-16,Alpine,003,1148,83,82,0,82,0
2021-03-16,Amador,005,37829,3516,3510,31,3541,44
2021-03-16,Butte,007,227075,11560,11154,1628,12782,184
2021-03-16,Calaveras,009,45235,1965,1945,11,1956,49
2021-03-16,Colusa,011,21464,1883,1882,270,2152,12
2021-03-16,Contra Costa,013,1133247,64848,63951,1092,65043,736
2021-03-16,Del Norte,015,27424,1108,1048,5,1053,6
2021-03-16,El Dorado,017,186661,9327,9249,606,9855,105
2021-03-16,Fresno,019,978130,98640,97638,7970,105608,1498
2021-03-16,Glenn,021,27897,2305,2267,508,2775,17
2021-03-16,Humboldt,023,135768,3384,3351,24,3375,33
2021-03-16,Imperial,025,180216,27450,27143,2503,29646,689
2021-03-16,Inyo,027,18085,1360,1346,9,1355,35
2021-03-16,Kern,029,883053,94760,93340,10042,103382,1144
2021-03-16,Kings,031,150075,22634,22320,989,23309,233
2021-03-16,Lake,033,64148,3303,3246,8,3254,43
2021-03-16,Lassen,035,31185,5135,5126,99,5225,1
2021-03-16,Los Angeles,037,10098052,1183538,1172676,39162,1211838,22527
2021-03-16,Madera,039,155013,15974,15822,860,16682,214
2021-03-16,Marin,041,260295,13502,13419,179,13598,218
2021-03-16,Mariposa,043,17540,384,379,5,384,5
2021-03-16,Mendocino,045,87422,3718,3623,73,3696,44
2021-03-16,Merced,047,269075,29319,29198,947,30145,407
2021-03-16,Modoc,049,8938,347,341,119,460,3
2021-03-16,Mono,051,14174,1209,1207,15,1222,3
2021-03-16,Monterey,053,433212,42331,42023,1712,43735,334
2021-03-16,Napa,055,140530,9253,9209,32,9241,75
2021-03-16,Nevada,057,99092,4181,4132,168,4300,67
2021-03-16,Orange,059,3164182,249728,247843,10414,258257,4479
2021-03-16,Placer,061,380077,21209,20339,1179,21518,240
2021-03-16,Plumas,063,18699,659,643,10,653,4
2021-03-16,Riverside,065,2383286,288276,281540,13421,294961,3893
2021-03-16,Sacramento,067,1510023,97101,95522,1326,96848,1466
2021-03-16,San Benito,069,59416,5817,5831,89,5920,61
2021-03-16,San Bernardino,071,2135413,288072,283980,8589,292569,4032
2021-03-16,San Diego,073,3302833,268442,265903,13270,279173,3462
2021-03-16,San Francisco,075,870044,34807,34833,1135,35968,456
2021-03-16,San Joaquin,077,732212,68648,66856,2909,69765,1163
2021-03-16,San Luis Obispo,079,281455,20180,19832,591,20423,248
2021-03-16,San Mateo,081,765935,40263,39806,419,40225,344
2021-03-16,Santa Barbara,083,443738,32971,32556,1062,33618,433
2021-03-16,Santa Clara,085,1922200,112837,112845,614,113459,1797
2021-03-16,Santa Cruz,087,273765,15699,14926,782,15708,199
2021-03-16,Shasta,089,179085,11147,11035,1312,12347,100
2021-03-16,Sierra,091,2930,53,49,12,61,0
2021-03-16,Siskiyou,093,43540,1553,1477,245,1722,5
2021-03-16,Solano,095,438530,30419,30298,384,30682,171
2021-03-16,Sonoma,097,501317,28752,28850,240,29090,291
2021-03-16,Stanislaus,099,539301,52165,51410,5449,56859,683
2021-03-16,Sutter,101,95872,8990,8970,79,9049,102
2021-03-16,Tehama,103,63373,4711,4660,494,5154,34
2021-03-16,Trinity,105,12862,472,308,79,387,3
2021-03-16,Tulare,107,460477,49000,47895,8272,56167,803
2021-03-16,Tuolumne,109,53932,3885,3938,38,3976,57
2021-03-16,Ventura,111,848112,79263,78671,2800,81471,916
2021-03-16,Yolo,113,214977,13200,13162,155,13317,190
2021-03-16,Yuba,115,75493,5655,5596,91,5687,42
2021-03-15,Alameda,001,1643700,82664,82159,1724,83883,1167
2021-03-15,Alpine,003,1148,83,82,0,82,0
2021-03-15,Amador,005,37829,3515,3506,31,3537,44
2021-03-15,Butte,007,227075,11547,11141,1624,12765,185
2021-03-15,Calaveras,009,45235,1964,1941,11,1952,49
2021-03-15,Colusa,011,21464,1883,1883,270,2153,12
2021-03-15,Contra Costa,013,1133247,64786,63847,1091,64938,732
2021-03-15,Del Norte,015,27424,1105,1048,5,1053,6
2021-03-15,El Dorado,017,186661,9321,9235,606,9841,103
2021-03-15,Fresno,019,978130,98513,97520,7955,105475,1496
2021-03-15,Glenn,021,27897,2300,2261,505,2766,15
2021-03-15,Humboldt,023,135768,3378,3337,24,3361,32
2021-03-15,Imperial,025,180216,27430,27122,2500,29622,684
2021-03-15,Inyo,027,18085,1360,1346,9,1355,35
2021-03-15,Kern,029,883053,94700,93266,10035,103301,1141
2021-03-15,Kings,031,150075,22617,22294,983,23277,233
2021-03-15,Lake,033,64148,3291,3237,8,3245,43
2021-03-15,Lassen,035,31185,5135,5125,99,5224,1
2021-03-15,Los Angeles,037,10098052,1182967,1172445,39130,1211575,22477
2021-03-15,Madera,039,155013,15963,15806,858,16664,214
2021-03-15,Marin,041,260295,13496,13408,178,13586,218
2021-03-15,Mariposa,043,17540,384,376,5,381,5
2021-03-15,Mendocino,045,87422,3714,3615,73,3688,44
2021-03-15,Merced,047,269075,29281,29169,945,30114,407
2021-03-15,Modoc,049,8938,347,340,119,459,3
2021-03-15,Mono,051,14174,1208,1206,15,1221,3
2021-03-15,Monterey,053,433212,42303,42011,1709,43720,333
2021-03-15,Napa,055,140530,9242,9196,32,9228,75
2021-03-15,Nevada,057,99092,4176,4123,167,4290,66
2021-03-15,Orange,059,3164182,249615,247697,10395,258092,4481
2021-03-15,Placer,061,380077,21186,20308,1179,21487,238
2021-03-15,Plumas,063,18699,659,642,10,652,4
2021-03-15,Riverside,065,2383286,288124,281367,13411,294778,3856
2021-03-15,Sacramento,067,1510023,96948,95414,1320,96734,1463
2021-03-15,San Benito,069,59416,5814,5831,89,5920,61
2021-03-15,San Bernardino,071,2135413,287981,283815,8581,292396,4004
2021-03-15,San Diego,073,3302833,268193,265646,13254,278900,3452
2021-03-15,San Francisco,075,870044,34772,34820,1131,35951,456
2021-03-15,San Joaquin,077,732212,68544,66622,2897,69519,1140
2021-03-15,San Luis Obispo,079,281455,20149,19813,587,20400,247
2021-03-15,San Mateo,081,765935,40209,39765,419,40184,344
2021-03-15,Santa Barbara,083,443738,32948,32529,1059,33588,431
2021-03-15,Santa Clara,085,1922200,112736,112729,612,113341,1798
2021-03-15,Santa Cruz,087,273765,15693,14899,781,15680,200
2021-03-15,Shasta,089,179085,11131,11019,1307,12326,92
2021-03-15,Sierra,091,2930,53,49,12,61,0
2021-03-15,Siskiyou,093,43540,1553,1475,245,1720,5
2021-03-15,Solano,095,438530,30390,30258,383,30641,171
2021-03-15,Sonoma,097,501317,28734,28814,237,29051,285
2021-03-15,Stanislaus,099,539301,52087,51357,5442,56799,683
2021-03-15,Sutter,101,95872,8984,8962,79,9041,102
2021-03-15,Tehama,103,63373,4696,4650,493,5143,34
2021-03-15,Trinity,105,12862,472,308,79,387,3
2021-03-15,Tulare,107,460477,48970,47857,8257,56114,800
2021-03-15,Tuolumne,109,53932,3883,3937,37,3974,57
2021-03-15,Ventura,111,848112,79207,78626,2799,81425,910
2021-03-15,Yolo,113,214977,13181,13131,155,13286,190
2021-03-15,Yuba,115,75493,5650,5585,90,5675,42
2021-03-14,Alameda,001,1643700,82581,82116,1721,83837,1168
2021-03-14,Alpine,003,1148,83,82,0,82,0
2021-03-14,Amador,005,37829,3510,3504,31,3535,44
2021-03-14,Butte,007,227075,11534,11140,1620,12760,185
2021-03-14,Calaveras,009,45235,1960,1939,11,1950,49
2021-03-14,Colusa,011,21464,1883,1883,270,2153,12
2021-03-14,Contra Costa,013,1133247,64682,63808,1090,64898,731
2021-03-14,Del Norte,015,27424,1091,1048,5,1053,6
2021-03-14,El Dorado,017,186661,9311,9231,606,9837,103
2021-03-14,Fresno,019,978130,98405,97461,7937,105398,1496
2021-03-14,Glenn,021,27897,2295,2260,502,2762,15
2021-03-14,Humboldt,023,135768,3364,3335,24,3359,32
2021-03-14,Imperial,025,180216,27415,27122,2495,29617,685
2021-03-14,Inyo,027,18085,1356,1346,9,1355,35
2021-03-14,Kern,029,883053,94617,93252,10017,103269,1141
2021-03-14,Kings,031,150075,22598,22292,981,23273,232
2021-03-14,Lake,033,64148,3286,3237,8,3245,43
2021-03-14,Lassen,035,31185,5133,5125,99,5224,1
2021-03-14,Los Angeles,037,10098052,1182392,1172100,39098,1211198,22476
2021-03-14,Madera,039,155013,15938,15804,858,16662,214
2021-03-14,Marin,041,260295,13480,13405,176,13581,218
2021-03-14,Mariposa,043,17540,382,376,5,381,5
2021-03-14,Mendocino,045,87422,3709,3613,73,3686,44
2021-03-14,Merced,047,269075,29213,29149,941,30090,407
2021-03-14,Modoc,049,8938,347,340,119,459,3
2021-03-14,Mono,051,14174,1202,1206,15,1221,3
2021-03-14,Monterey,053,433212,42279,42007,1706,43713,333
2021-03-14,Napa,055,140530,9224,9194,32,9226,75
2021-03-14,Nevada,057,99092,4170,4122,165,4287,66
2021-03-14,Orange,059,3164182,249481,247656,10375,258031,4460
2021-03-14,Placer,061,380077,21151,20288,1171,21459,238
2021-03-14,Plumas,063,18699,657,642,10,652,4
2021-03-14,Riverside,065,2383286,287966,281332,13403,294735,3845
2021-03-14,Sacramento,067,1510023,96770,95343,1315,96658,1462
2021-03-14,San Benito,069,59416,5805,5829,89,5918,61
2021-03-14,San Bernardino,071,2135413,287858,283791,8570,292361,3996
2021-03-14,San Diego,073,3302833,267958,265468,13241,278709,3452
2021-03-14,San Francisco,075,870044,34733,34810,1128,35938,455
2021-03-14,San Joaquin,077,732212,68416,66563,2880,69443,1140
2021-03-14,San Luis Obispo,079,281455,20121,19806,585,20391,247
2021-03-14,San Mateo,081,765935,40170,39744,419,40163,342
2021-03-14,Santa Barbara,083,443738,32904,32514,1057,33571,431
2021-03-14,Santa Clara,085,1922200,112608,112648,611,113259,1796
2021-03-14,Santa Cruz,087,273765,15677,14887,779,15666,200
2021-03-14,Shasta,089,179085,11115,11019,1300,12319,92
2021-03-14,Sierra,091,2930,53,49,12,61,0
2021-03-14,Siskiyou,093,43540,1550,1473,245,1718,5
2021-03-14,Solano,095,438530,30358,30230,378,30608,171
2021-03-14,Sonoma,097,501317,28699,28798,233,29031,284
2021-03-14,Stanislaus,099,539301,51967,51306,5434,56740,690
2021-03-14,Sutter,101,95872,8968,8958,79,9037,102
2021-03-14,Tehama,103,63373,4689,4650,492,5142,34
2021-03-14,Trinity,105,12862,471,308,78,386,3
2021-03-14,Tulare,107,460477,48937,47845,8236,56081,800
2021-03-14,Tuolumne,109,53932,3881,3937,37,3974,57
2021-03-14,Ventura,111,848112,79159,78611,2793,81404,910
2021-03-14,Yolo,113,214977,13158,13128,152,13280,189
2021-03-14,Yuba,115,75493,5640,5583,90,5673,42
2021-03-13,Alameda,001,1643700,82521,82010,1721,83731,1168
2021-03-13,Alpine,003,1148,83,82,0,82,0
2021-03-13,Amador,005,37829,3507,3504,31,3535,44
2021-03-13,Butte,007,227075,11525,11131,1619,12750,185
2021-03-13,Calaveras,009,45235,1959,1939,11,1950,49
2021-03-13,Colusa,011,21464,1883,1882,270,2152,12
2021-03-13,Contra Costa,013,1133247,64621,63689,1090,64779,731
2021-03-13,Del Norte,015,27424,1087,1041,5,1046,6
2021-03-13,El Dorado,017,186661,9303,9221,606,9827,103
2021-03-13,Fresno,019,978130,98346,97324,7917,105241,1495
2021-03-13,Glenn,021,27897,2294,2260,501,2761,15
2021-03-13,Humboldt,023,135768,3357,3325,24,3349,32
2021-03-13,Imperial,025,180216,27409,27099,2491,29590,677
2021-03-13,Inyo,027,18085,1355,1344,9,1353,35
2021-03-13,Kern,029,883053,94578,93197,10011,103208,1140
2021-03-13,Kings,031,150075,22582,22265,980,23245,232
2021-03-13,Lake,033,64148,3279,3234,7,3241,43
2021-03-13,Lassen,035,31185,5133,5125,99,5224,1
2021-03-13,Los Angeles,037,10098052,1182074,1171505,39056,1210561,22451
2021-03-13,Madera,039,155013,15926,15780,858,16638,214
2021-03-13,Marin,041,260295,13474,13391,174,13565,218
2021-03-13,Mariposa,043,17540,381,376,5,381,5
2021-03-13,Mendocino,045,87422,3705,3611,73,3684,44
2021-03-13,Merced,047,269075,29182,29106,941,30047,406
2021-03-13,Modoc,049,8938,347,340,118,458,3
2021-03-13,Mono,051,14174,1202,1207,15,1222,3
2021-03-13,Monterey,053,433212,42269,41989,1704,43693,332
2021-03-13,Napa,055,140530,9218,9190,32,9222,75
2021-03-13,Nevada,057,99092,4163,4111,164,4275,66
2021-03-13,Orange,059,3164182,249400,247514,10359,257873,4423
2021-03-13,Placer,061,380077,21130,20238,1168,21406,239
2021-03-13,Plumas,063,18699,655,642,10,652,4
2021-03-13,Riverside,065,2383286,287874,281191,13395,294586,3848
2021-03-13,Sacramento,067,1510023,96684,95192,1313,96505,1461
2021-03-13,San Benito,069,59416,5802,5823,89,5912,61
2021-03-13,San Bernardino,071,2135413,287804,283727,8564,292291,3972
2021-03-13,San Diego,073,3302833,267803,265270,13227,278497,3444
2021-03-13,San Francisco,075,870044,34716,34784,1119,35903,455
2021-03-13,San Joaquin,077,732212,68360,66480,2858,69338,1141
2021-03-13,San Luis Obispo,079,281455,20103,19789,584,20373,247
2021-03-13,San Mateo,081,765935,40143,39689,418,40107,341
2021-03-13,Santa Barbara,083,443738,32879,32486,1056,33542,431
2021-03-13,Santa Clara,085,1922200,112523,112531,610,113141,1790
2021-03-13,Santa Cruz,087,273765,15670,14875,779,15654,199
2021-03-13,Shasta,089,179085,11107,11021,1297,12318,108
2021-03-13,Sierra,091,2930,52,49,12,61,0
2021-03-13,Siskiyou,093,43540,1548,1470,245,1715,5
2021-03-13,Solano,095,438530,30341,30198,378,30576,171
2021-03-13,Sonoma,097,501317,28679,28762,229,28991,285
2021-03-13,Stanislaus,099,539301,51916,51257,5430,56687,695
2021-03-13,Sutter,101,95872,8961,8948,79,9027,102
2021-03-13,Tehama,103,63373,4687,4647,492,5139,33
2021-03-13,Trinity,105,12862,471,306,78,384,3
2021-03-13,Tulare,107,460477,48911,47818,8228,56046,798
2021-03-13,Tuolumne,109,53932,3878,3937,37,3974,57
2021-03-13,Ventura,111,848112,79107,78693,2793,81486,906
2021-03-13,Yolo,113,214977,13149,13087,152,13239,189
2021-03-13,Yuba,115,75493,5639,5577,90,5667,42
2021-03-12,Alameda,001,1643700,82444,81898,1720,83618,1164
2021-03-12,Alpine,003,1148,83,82,0,82,0
2021-03-12,Amador,005,37829,3504,3503,31,3534,44
2021-03-12,Butte,007,227075,11515,11126,1617,12743,184
2021-03-12,Calaveras,009,45235,1959,1916,11,1927,49
2021-03-12,Colusa,011,21464,1883,1883,270,2153,12
2021-03-12,Contra Costa,013,1133247,64545,63583,1090,64673,728
2021-03-12,Del Norte,015,27424,1081,1033,5,1038,6
2021-03-12,El Dorado,017,186661,9294,9219,606,9825,103
2021-03-12,Fresno,019,978130,98249,97185,7906,105091,1489
2021-03-12,Glenn,021,27897,2293,2258,500,2758,15
2021-03-12,Humboldt,023,135768,3352,3315,24,3339,32
2021-03-12,Imperial,025,180216,27398,27071,2489,29560,677
2021-03-12,Inyo,027,18085,1353,1339,9,1348,35
2021-03-12,Kern,029,883053,94544,93142,9995,103137,1132
2021-03-12,Kings,031,150075,22563,22233,980,23213,232
2021-03-12,Lake,033,64148,3273,3226,6,3232,43
2021-03-12,Lassen,035,31185,5133,5125,98,5223,1
2021-03-12,Los Angeles,037,10098052,1181679,1170860,39039,1209899,22409
2021-03-12,Madera,039,155013,15914,15761,855,16616,214
2021-03-12,Marin,041,260295,13467,13375,174,13549,218
2021-03-12,Mariposa,043,17540,379,376,5,381,5
2021-03-12,Mendocino,045,87422,3702,3605,73,3678,43
2021-03-12,Merced,047,269075,29151,29064,941,30005,403
2021-03-12,Modoc,049,8938,347,340,118,458,3
2021-03-12,Mono,051,14174,1201,1206,15,1221,3
2021-03-12,Monterey,053,433212,42255,41964,1699,43663,329
2021-03-12,Napa,055,140530,9209,9180,32,9212,75
2021-03-12,Nevada,057,99092,4153,4101,164,4265,66
2021-03-12,Orange,059,3164182,249308,247388,10348,257736,4401
2021-03-12,Placer,061,380077,21097,20210,1163,21373,239
2021-03-12,Plumas,063,18699,654,641,10,651,4
2021-03-12,Riverside,065,2383286,287775,281037,13388,294425,3854
2021-03-12,Sacramento,067,1510023,96560,95061,1307,96368,1460
2021-03-12,San Benito,069,59416,5799,5817,89,5906,61
2021-03-12,San Bernardino,071,2135413,287748,283558,8559,292117,3917
2021-03-12,San Diego,073,3302833,267640,264886,13219,278105,3434
2021-03-12,San Francisco,075,870044,34695,34758,1116,35874,452
2021-03-12,San Joaquin,077,732212,68289,66482,2849,69331,1144
2021-03-12,San Luis Obispo,079,281455,20090,19769,582,20351,247
2021-03-12,San Mateo,081,765935,40107,39638,416,40054,341
2021-03-12,Santa Barbara,083,443738,32856,32457,1053,33510,429
2021-03-12,Santa Clara,085,1922200,112428,112396,609,113005,1766
2021-03-12,Santa Cruz,087,273765,15658,14846,777,15623,195
2021-03-12,Shasta,089,179085,11098,11143,1295,12438,153
2021-03-12,Sierra,091,2930,52,49,12,61,0
2021-03-12,Siskiyou,093,43540,1548,1468,244,1712,5
2021-03-12,Solano,095,438530,30322,30180,377,30557,171
2021-03-12,Sonoma,097,501317,28652,28714,229,28943,285
2021-03-12,Stanislaus,099,539301,51857,51146,5424,56570,701
2021-03-12,Sutter,101,95872,8955,8940,79,9019,101
2021-03-12,Tehama,103,63373,4683,4638,491,5129,33
2021-03-12,Trinity,105,12862,470,306,78,384,3
2021-03-12,Tulare,107,460477,48886,47772,8222,55994,798
2021-03-12,Tuolumne,109,53932,3877,3936,37,3973,57
2021-03-12,Ventura,111,848112,79061,78698,2789,81487,899
2021-03-12,Yolo,113,214977,13139,13061,145,13206,189
2021-03-12,Yuba,115,75493,5632,5563,89,5652,42
2021-03-11,Alameda,001,1643700,82353,81809,1715,83524,1164
2021-03-11,Alpine,003,1148,83,78,0,78,0
2021-03-11,Amador,005,37829,3503,3498,31,3529,42
2021-03-11,Butte,007,227075,11504,11110,1615,12725,185
2021-03-11,Calaveras,009,45235,1956,1915,11,1926,49
2021-03-11,Colusa,011,21464,1883,1883,270,2153,12
2021-03-11,Contra Costa,013,1133247,64472,63469,1088,64557,728
2021-03-11,Del Norte,015,27424,1076,1027,5,1032,6
2021-03-11,El Dorado,017,186661,9280,9211,606,9817,101
2021-03-11,Fresno,019,978130,98133,97026,7877,104903,1481
2021-03-11,Glenn,021,27897,2290,2255,500,2755,15
2021-03-11,Humboldt,023,135768,3335,3302,24,3326,32
2021-03-11,Imperial,025,180216,27391,27045,2486,29531,675
2021-03-11,Inyo,027,18085,1348,1335,9,1344,35
2021-03-11,Kern,029,883053,94488,93052,9956,103008,1121
2021-03-11,Kings,031,150075,22548,22183,977,23160,230
2021-03-11,Lake,033,64148,3269,3214,6,3220,42
2021-03-11,Lassen,035,31185,5132,5124,98,5222,1
2021-03-11,Los Angeles,037,10098052,1181148,1170111,39008,1209119,22316
2021-03-11,Madera,039,155013,15903,15725,853,16578,214
2021-03-11,Marin,041,260295,13455,13356,173,13529,217
2021-03-11,Mariposa,043,17540,379,376,5,381,5
2021-03-11,Mendocino,045,87422,3695,3604,73,3677,42
2021-03-11,Merced,047,269075,29103,29001,940,29941,401
2021-03-11,Modoc,049,8938,347,340,118,458,3
2021-03-11,Mono,051,14174,1200,1206,15,1221,3
2021-03-11,Monterey,053,433212,42232,41936,1693,43629,329
2021-03-11,Napa,055,140530,9196,9173,32,9205,75
2021-03-11,Nevada,057,99092,4141,4085,162,4247,66
2021-03-11,Orange,059,3164182,249170,247217,10330,257547,4373
2021-03-11,Placer,061,380077,21055,20178,1159,21337,239
2021-03-11,Plumas,063,18699,653,640,10,650,4
2021-03-11,Riverside,065,2383286,287605,280881,13375,294256,3842
2021-03-11,Sacramento,067,1510023,96419,94912,1304,96216,1455
2021-03-11,San Benito,069,59416,5796,5816,89,5905,61
2021-03-11,San Bernardino,071,2135413,287651,283312,8553,291865,3869
2021-03-11,San Diego,073,3302833,267475,264524,13203,277727,3422
2021-03-11,San Francisco,075,870044,34659,34722,1110,35832,452
2021-03-11,San Joaquin,077,732212,68177,66522,2841,69363,1157
2021-03-11,San Luis Obispo,079,281455,20065,19748,581,20329,247
2021-03-11,San Mateo,081,765935,40070,39590,415,40005,341
2021-03-11,Santa Barbara,083,443738,32828,32408,1048,33456,430
2021-03-11,Santa Clara,085,1922200,112299,112246,606,112852,1765
2021-03-11,Santa Cruz,087,273765,15646,14812,776,15588,193
2021-03-11,Shasta,089,179085,11088,11139,1290,12429,158
2021-03-11,Sierra,091,2930,52,48,12,60,0
2021-03-11,Siskiyou,093,43540,1545,1466,243,1709,5
2021-03-11,Solano,095,438530,30294,30138,376,30514,171
2021-03-11,Sonoma,097,501317,28623,28677,229,28906,285
2021-03-11,Stanislaus,099,539301,51772,51038,5416,56454,707
2021-03-11,Sutter,101,95872,8949,8933,79,9012,101
2021-03-11,Tehama,103,63373,4675,4632,491,5123,33
2021-03-11,Trinity,105,12862,469,304,77,381,3
2021-03-11,Tulare,107,460477,48849,47709,8211,55920,797
2021-03-11,Tuolumne,109,53932,3875,3934,37,3971,57
2021-03-11,Ventura,111,848112,79011,78697,2785,81482,889
2021-03-11,Yolo,113,214977,13121,13041,144,13185,190
2021-03-11,Yuba,115,75493,5628,5553,89,5642,42
2021-03-10,Alameda,001,1643700,82247,81701,1710,83411,1160
2021-03-10,Alpine,003,1148,82,78,0,78,0
2021-03-10,Amador,005,37829,3501,3496,31,3527,42
2021-03-10,Butte,007,227075,11494,11096,1615,12711,185
2021-03-10,Calaveras,009,45235,1950,1913,11,1924,48
2021-03-10,Colusa,011,21464,1883,1882,270,2152,12
2021-03-10,Contra Costa,013,1133247,64372,63372,1084,64456,725
2021-03-10,Del Norte,015,27424,1074,1020,5,1025,5
2021-03-10,El Dorado,017,186661,9267,9203,606,9809,100
2021-03-10,Fresno,019,978130,98026,96866,7861,104727,1471
2021-03-10,Glenn,021,27897,2287,2253,498,2751,15
2021-03-10,Humboldt,023,135768,3325,3296,23,3319,32
2021-03-10,Imperial,025,180216,27376,27051,2486,29537,675
2021-03-10,Inyo,027,18085,1348,1328,9,1337,35
2021-03-10,Kern,029,883053,94422,92965,9935,102900,1102
2021-03-10,Kings,031,150075,22529,22166,976,23142,226
2021-03-10,Lake,033,64148,3259,3207,6,3213,42
2021-03-10,Lassen,035,31185,5132,5120,98,5218,1
2021-03-10,Los Angeles,037,10098052,1180603,1169079,38981,1208060,22199
2021-03-10,Madera,039,155013,15882,15705,850,16555,212
2021-03-10,Marin,041,260295,13445,13348,172,13520,216
2021-03-10,Mariposa,043,17540,379,376,5,381,5
2021-03-10,Mendocino,045,87422,3690,3602,73,3675,42
2021-03-10,Merced,047,269075,29065,28927,937,29864,401
2021-03-10,Modoc,049,8938,346,338,118,456,3
2021-03-10,Mono,051,14174,1196,1204,15,1219,3
2021-03-10,Monterey,053,433212,42210,41920,1689,43609,329
2021-03-10,Napa,055,140530,9187,9165,32,9197,75
2021-03-10,Nevada,057,99092,4137,4074,162,4236,66
2021-03-10,Orange,059,3164182,249022,247075,10315,257390,4342
2021-03-10,Placer,061,380077,21021,20144,1153,21297,239
2021-03-10,Plumas,063,18699,652,639,10,649,4
2021-03-10,Riverside,065,2383286,287464,280708,13361,294069,3822
2021-03-10,Sacramento,067,1510023,96289,94796,1298,96094,1452
2021-03-10,San Benito,069,59416,5787,5811,89,5900,61
2021-03-10,San Bernardino,071,2135413,287558,283140,8547,291687,3841
2021-03-10,San Diego,073,3302833,267253,264094,13191,277285,3413
2021-03-10,San Francisco,075,870044,34624,34688,1102,35790,450
2021-03-10,San Joaquin,077,732212,68075,66483,2824,69307,1156
2021-03-10,San Luis Obispo,079,281455,20041,19710,577,20287,247
2021-03-10,San Mateo,081,765935,40046,39571,415,39986,338
2021-03-10,Santa Barbara,083,443738,32801,32356,1045,33401,429
2021-03-10,Santa Clara,085,1922200,112190,112103,602,112705,1759
2021-03-10,Santa Cruz,087,273765,15631,14790,775,15565,192
2021-03-10,Shasta,089,179085,11078,11125,1287,12412,155
2021-03-10,Sierra,091,2930,52,48,12,60,0
2021-03-10,Siskiyou,093,43540,1543,1458,243,1701,5
2021-03-10,Solano,095,438530,30264,30111,375,30486,170
2021-03-10,Sonoma,097,501317,28588,28638,228,28866,286
2021-03-10,Stanislaus,099,539301,51685,50968,5397,56365,706
2021-03-10,Sutter,101,95872,8938,8918,79,8997,101
2021-03-10,Tehama,103,63373,4664,4623,490,5113,33
2021-03-10,Trinity,105,12862,469,304,77,381,3
2021-03-10,Tulare,107,460477,48801,47659,8193,55852,793
2021-03-10,Tuolumne,109,53932,3874,3931,37,3968,57
2021-03-10,Ventura,111,848112,78934,78609,2783,81392,878
2021-03-10,Yolo,113,214977,13097,13021,144,13165,189
2021-03-10,Yuba,115,75493,5615,5545,88,5633,42
2021-03-09,Alameda,001,1643700,82161,81618,1710,83328,1151
2021-03-09,Alpine,003,1148,82,78,0,78,0
2021-03-09,Amador,005,37829,3499,3494,31,3525,42
2021-03-09,Butte,007,227075,11481,11092,1614,12706,185
2021-03-09,Calaveras,009,45235,1948,1913,11,1924,48
2021-03-09,Colusa,011,21464,1883,1880,270,2150,11
2021-03-09,Contra Costa,013,1133247,64282,63314,1082,64396,723
2021-03-09,Del Norte,015,27424,1066,1017,5,1022,5
2021-03-09,El Dorado,017,186661,9259,9198,606,9804,98
2021-03-09,Fresno,019,978130,97907,96744,7835,104579,1463
2021-03-09,Glenn,021,27897,2283,2251,496,2747,15
2021-03-09,Humboldt,023,135768,3313,3288,22,3310,32
2021-03-09,Imperial,025,180216,27366,27045,2482,29527,675
2021-03-09,Inyo,027,18085,1346,1324,9,1333,35
2021-03-09,Kern,029,883053,94343,92924,9917,102841,1088
2021-03-09,Kings,031,150075,22504,22143,974,23117,226
2021-03-09,Lake,033,64148,3253,3202,6,3208,42
2021-03-09,Lassen,035,31185,5132,5120,98,5218,1
2021-03-09,Los Angeles,037,10098052,1180006,1167967,38948,1206915,22080
2021-03-09,Madera,039,155013,15871,15701,848,16549,211
2021-03-09,Marin,041,260295,13427,13335,170,13505,214
2021-03-09,Mariposa,043,17540,379,376,5,381,5
2021-03-09,Mendocino,045,87422,3686,3595,73,3668,42
2021-03-09,Merced,047,269075,29005,28876,934,29810,399
2021-03-09,Modoc,049,8938,346,338,117,455,3
2021-03-09,Mono,051,14174,1195,1203,15,1218,3
2021-03-09,Monterey,053,433212,42191,41894,1681,43575,329
2021-03-09,Napa,055,140530,9173,9155,32,9187,75
2021-03-09,Nevada,057,99092,4129,4062,162,4224,66
2021-03-09,Orange,059,3164182,248880,246989,10296,257285,4310
2021-03-09,Placer,061,380077,20979,20122,1148,21270,239
2021-03-09,Plumas,063,18699,649,639,10,649,4
2021-03-09,Riverside,065,2383286,287329,280562,13357,293919,3821
2021-03-09,Sacramento,067,1510023,96122,94720,1292,96012,1442
2021-03-09,San Benito,069,59416,5783,5800,89,5889,61
2021-03-09,San Bernardino,071,2135413,287443,282971,8541,291512,3823
2021-03-09,San Diego,073,3302833,267021,263745,13170,276915,3405
2021-03-09,San Francisco,075,870044,34593,34654,1098,35752,450
2021-03-09,San Joaquin,077,732212,67947,66383,2814,69197,1150
2021-03-09,San Luis Obispo,079,281455,20024,19672,570,20242,245
2021-03-09,San Mateo,081,765935,39999,39535,413,39948,336
2021-03-09,Santa Barbara,083,443738,32760,32314,1043,33357,428
2021-03-09,Santa Clara,085,1922200,112079,111963,597,112560,1756
2021-03-09,Santa Cruz,087,273765,15609,14764,774,15538,188
2021-03-09,Shasta,089,179085,11071,11113,1282,12395,155
2021-03-09,Sierra,091,2930,52,48,12,60,0
2021-03-09,Siskiyou,093,43540,1539,1447,241,1688,5
2021-03-09,Solano,095,438530,30228,30090,373,30463,169
2021-03-09,Sonoma,097,501317,28538,28601,225,28826,284
2021-03-09,Stanislaus,099,539301,51587,50884,5388,56272,703
2021-03-09,Sutter,101,95872,8925,8914,79,8993,101
2021-03-09,Tehama,103,63373,4659,4620,490,5110,33
2021-03-09,Trinity,105,12862,469,304,77,381,3
2021-03-09,Tulare,107,460477,48774,47637,8174,55811,792
2021-03-09,Tuolumne,109,53932,3872,3929,37,3966,56
2021-03-09,Ventura,111,848112,78871,78526,2781,81307,863
2021-03-09,Yolo,113,214977,13085,13015,142,13157,189
2021-03-09,Yuba,115,75493,5608,5539,88,5627,42
2021-03-08,Alameda,001,1643700,82050,81543,1709,83252,1142
2021-03-08,Alpine,003,1148,82,78,0,78,0
2021-03-08,Amador,005,37829,3496,3490,31,3521,42
2021-03-08,Butte,007,227075,11468,11082,1613,12695,185
2021-03-08,Calaveras,009,45235,1944,1909,11,1920,48
2021-03-08,Colusa,011,21464,1883,1877,270,2147,11
2021-03-08,Contra Costa,013,1133247,64186,63240,1082,64322,719
2021-03-08,Del Norte,015,27424,1061,1012,5,1017,5
2021-03-08,El Dorado,017,186661,9256,9188,605,9793,97
2021-03-08,Fresno,019,978130,97809,96665,7814,104479,1442
2021-03-08,Glenn,021,27897,2282,2249,496,2745,15
2021-03-08,Humboldt,023,135768,3299,3278,22,3300,31
2021-03-08,Imperial,025,180216,27358,27033,2479,29512,663
2021-03-08,Inyo,027,18085,1344,1320,9,1329,35
2021-03-08,Kern,029,883053,94277,92857,9897,102754,1087
2021-03-08,Kings,031,150075,22483,22130,972,23102,226
2021-03-08,Lake,033,64148,3241,3195,6,3201,42
2021-03-08,Lassen,035,31185,5132,5119,98,5217,1
2021-03-08,Los Angeles,037,10098052,1179386,1163409,38916,1202325,21868
2021-03-08,Madera,039,155013,15861,15691,846,16537,211
2021-03-08,Marin,041,260295,13407,13328,168,13496,214
2021-03-08,Mariposa,043,17540,379,376,5,381,5
2021-03-08,Mendocino,045,87422,3684,3590,72,3662,42
2021-03-08,Merced,047,269075,28945,28841,933,29774,398
2021-03-08,Modoc,049,8938,346,338,117,455,3
2021-03-08,Mono,051,14174,1194,1200,15,1215,3
2021-03-08,Monterey,053,433212,42170,41863,1680,43543,328
2021-03-08,Napa,055,140530,9170,9146,32,9178,75
2021-03-08,Nevada,057,99092,4121,4059,162,4221,66
2021-03-08,Orange,059,3164182,248707,246900,10264,257164,4243
2021-03-08,Placer,061,380077,20944,20102,1137,21239,239
2021-03-08,Plumas,063,18699,648,635,10,645,4
2021-03-08,Riverside,065,2383286,287177,280463,13347,293810,3783
2021-03-08,Sacramento,067,1510023,95952,94654,1287,95941,1438
2021-03-08,San Benito,069,59416,5780,5797,89,5886,61
2021-03-08,San Bernardino,071,2135413,287332,282894,8534,291428,3811
2021-03-08,San Diego,073,3302833,266780,263272,13155,276427,3390
2021-03-08,San Francisco,075,870044,34567,34634,1094,35728,446
2021-03-08,San Joaquin,077,732212,67831,66307,2805,69112,1139
2021-03-08,San Luis Obispo,079,281455,19981,19656,567,20223,245
2021-03-08,San Mateo,081,765935,39950,39492,411,39903,335
2021-03-08,Santa Barbara,083,443738,32728,32293,1043,33336,427
2021-03-08,Santa Clara,085,1922200,111951,111882,595,112477,1756
2021-03-08,Santa Cruz,087,273765,15589,14729,774,15503,188
2021-03-08,Shasta,089,179085,11063,11088,1277,12365,155
2021-03-08,Sierra,091,2930,52,48,12,60,0
2021-03-08,Siskiyou,093,43540,1538,1440,241,1681,5
2021-03-08,Solano,095,438530,30188,30068,371,30439,169
2021-03-08,Sonoma,097,501317,28494,28571,224,28795,284
2021-03-08,Stanislaus,099,539301,51508,50825,5383,56208,690
2021-03-08,Sutter,101,95872,8922,8905,79,8984,100
2021-03-08,Tehama,103,63373,4655,4615,490,5105,33
2021-03-08,Trinity,105,12862,468,302,77,379,3
2021-03-08,Tulare,107,460477,48733,47587,8149,55736,791
2021-03-08,Tuolumne,109,53932,3871,3921,37,3958,56
2021-03-08,Ventura,111,848112,78798,78526,2773,81299,852
2021-03-08,Yolo,113,214977,13062,13000,142,13142,189
2021-03-08,Yuba,115,75493,5598,5530,88,5618,42
2021-03-07,Alameda,001,1643700,81930,81413,1708,83121,1145
2021-03-07,Alpine,003,1148,82,78,0,78,0
2021-03-07,Amador,005,37829,3493,3489,31,3520,42
2021-03-07,Butte,007,227075,11452,11075,1612,12687,185
2021-03-07,Calaveras,009,45235,1940,1906,11,1917,48
2021-03-07,Colusa,011,21464,1883,1876,270,2146,11
2021-03-07,Contra Costa,013,1133247,64087,63148,1080,64228,719
2021-03-07,Del Norte,015,27424,1056,1010,5,1015,5
2021-03-07,El Dorado,017,186661,9253,9184,604,9788,97
2021-03-07,Fresno,019,978130,97631,96549,7792,104341,1442
2021-03-07,Glenn,021,27897,2280,2244,496,2740,15
2021-03-07,Humboldt,023,135768,3289,3274,22,3296,31
2021-03-07,Imperial,025,180216,27349,27019,2477,29496,658
2021-03-07,Inyo,027,18085,1341,1320,9,1329,35
2021-03-07,Kern,029,883053,94190,92746,9867,102613,1086
2021-03-07,Kings,031,150075,22461,22103,972,23075,224
2021-03-07,Lake,033,64148,3235,3192,6,3198,42
2021-03-07,Lassen,035,31185,5131,5119,98,5217,1
2021-03-07,Los Angeles,037,10098052,1178660,1162749,38881,1201630,21857
2021-03-07,Madera,039,155013,15842,15675,846,16521,211
2021-03-07,Marin,041,260295,13399,13313,166,13479,214
2021-03-07,Mariposa,043,17540,378,376,5,381,5
2021-03-07,Mendocino,045,87422,3680,3581,72,3653,42
2021-03-07,Merced,047,269075,28871,28829,929,29758,399
2021-03-07,Modoc,049,8938,346,338,117,455,3
2021-03-07,Mono,051,14174,1192,1199,15,1214,3
2021-03-07,Monterey,053,433212,42149,41858,1677,43535,328
2021-03-07,Napa,055,140530,9160,9137,32,9169,75
2021-03-07,Nevada,057,99092,4107,4052,161,4213,66
2021-03-07,Orange,059,3164182,248515,246771,10236,257007,4218
2021-03-07,Placer,061,380077,20903,20070,1133,21203,239
2021-03-07,Plumas,063,18699,647,635,10,645,4
2021-03-07,Riverside,065,2383286,287028,280379,13338,293717,3779
2021-03-07,Sacramento,067,1510023,95775,94513,1280,95793,1437
2021-03-07,San Benito,069,59416,5773,5795,89,5884,61
2021-03-07,San Bernardino,071,2135413,287181,282860,8529,291389,3810
2021-03-07,San Diego,073,3302833,266499,262965,13131,276096,3390
2021-03-07,San Francisco,075,870044,34533,34594,1089,35683,445
2021-03-07,San Joaquin,077,732212,67695,66252,2792,69044,1139
2021-03-07,San Luis Obispo,079,281455,19944,19614,565,20179,245
2021-03-07,San Mateo,081,765935,39910,39436,408,39844,329
2021-03-07,Santa Barbara,083,443738,32682,32218,1042,33260,425
2021-03-07,Santa Clara,085,1922200,111806,111745,591,112336,1752
2021-03-07,Santa Cruz,087,273765,15567,14715,773,15488,189
2021-03-07,Shasta,089,179085,11050,11083,1269,12352,156
2021-03-07,Sierra,091,2930,51,48,12,60,0
2021-03-07,Siskiyou,093,43540,1537,1435,237,1672,5
2021-03-07,Solano,095,438530,30151,30027,371,30398,169
2021-03-07,Sonoma,097,501317,28445,28533,222,28755,284
2021-03-07,Stanislaus,099,539301,51376,50783,5367,56150,699
2021-03-07,Sutter,101,95872,8912,8900,79,8979,100
2021-03-07,Tehama,103,63373,4648,4614,489,5103,33
2021-03-07,Trinity,105,12862,468,302,77,379,3
2021-03-07,Tulare,107,460477,48674,47569,8118,55687,790
2021-03-07,Tuolumne,109,53932,3870,3922,36,3958,56
2021-03-07,Ventura,111,848112,78706,78487,2771,81258,851
2021-03-07,Yolo,113,214977,13043,12988,142,13130,189
2021-03-07,Yuba,115,75493,5593,5516,88,5604,42
2021-03-06,Alameda,001,1643700,81873,81310,1707,83017,1143
2021-03-06,Alpine,003,1148,82,78,0,78,0
2021-03-06,Amador,005,37829,3489,3487,31,3518,42
2021-03-06,Butte,007,227075,11447,11065,1611,12676,185
2021-03-06,Calaveras,009,45235,1936,1904,11,1915,48
2021-03-06,Colusa,011,21464,1881,1874,270,2144,11
2021-03-06,Contra Costa,013,1133247,64026,63040,1076,64116,719
2021-03-06,Del Norte,015,27424,1051,1000,5,1005,5
2021-03-06,El Dorado,017,186661,9249,9166,604,9770,97
2021-03-06,Fresno,019,978130,97536,96366,7781,104147,1440
2021-03-06,Glenn,021,27897,2280,2241,496,2737,15
2021-03-06,Humboldt,023,135768,3279,3260,22,3282,31
2021-03-06,Imperial,025,180216,27344,27009,2472,29481,658
2021-03-06,Inyo,027,18085,1338,1312,9,1321,35
2021-03-06,Kern,029,883053,94144,92684,9847,102531,1082
2021-03-06,Kings,031,150075,22446,22094,972,23066,224
2021-03-06,Lake,033,64148,3233,3189,6,3195,42
2021-03-06,Lassen,035,31185,5131,5119,98,5217,1
2021-03-06,Los Angeles,037,10098052,1178220,1161745,38853,1200598,21843
2021-03-06,Madera,039,155013,15833,15646,845,16491,211
2021-03-06,Marin,041,260295,13390,13289,166,13455,213
2021-03-06,Mariposa,043,17540,378,376,5,381,5
2021-03-06,Mendocino,045,87422,3678,3579,72,3651,42
2021-03-06,Merced,047,269075,28829,28771,929,29700,399
2021-03-06,Modoc,049,8938,345,338,117,455,3
2021-03-06,Mono,051,14174,1191,1198,15,1213,3
2021-03-06,Monterey,053,433212,42144,41838,1674,43512,327
2021-03-06,Napa,055,140530,9152,9129,32,9161,75
2021-03-06,Nevada,057,99092,4101,4044,161,4205,66
2021-03-06,Orange,059,3164182,248422,246634,10222,256856,4165
2021-03-06,Placer,061,380077,20880,20030,1131,21161,239
2021-03-06,Plumas,063,18699,647,634,10,644,4
2021-03-06,Riverside,065,2383286,286935,280225,13330,293555,3781
2021-03-06,Sacramento,067,1510023,95687,94332,1271,95603,1436
2021-03-06,San Benito,069,59416,5768,5793,89,5882,61
2021-03-06,San Bernardino,071,2135413,287097,282737,8527,291264,3791
2021-03-06,San Diego,073,3302833,266312,262778,13114,275892,3385
2021-03-06,San Francisco,075,870044,34502,34560,1085,35645,435
2021-03-06,San Joaquin,077,732212,67621,66162,2782,68944,1138
2021-03-06,San Luis Obispo,079,281455,19924,19592,563,20155,245
2021-03-06,San Mateo,081,765935,39885,39384,408,39792,329
2021-03-06,Santa Barbara,083,443738,32652,32176,1042,33218,424
2021-03-06,Santa Clara,085,1922200,111711,111570,588,112158,1749
2021-03-06,Santa Cruz,087,273765,15556,14701,773,15474,188
2021-03-06,Shasta,089,179085,11041,11076,1267,12343,158
2021-03-06,Sierra,091,2930,51,48,12,60,0
2021-03-06,Siskiyou,093,43540,1535,1432,237,1669,5
2021-03-06,Solano,095,438530,30122,30000,370,30370,169
2021-03-06,Sonoma,097,501317,28422,28484,220,28704,284
2021-03-06,Stanislaus,099,539301,51306,50691,5361,56052,711
2021-03-06,Sutter,101,95872,8906,8887,79,8966,100
2021-03-06,Tehama,103,63373,4646,4610,486,5096,33
2021-03-06,Trinity,105,12862,468,302,77,379,3
2021-03-06,Tulare,107,460477,48642,47515,8090,55605,789
2021-03-06,Tuolumne,109,53932,3868,3920,36,3956,56
2021-03-06,Ventura,111,848112,78650,78439,2770,81209,848
2021-03-06,Yolo,113,214977,13037,12951,141,13092,189
2021-03-06,Yuba,115,75493,5584,5504,88,5592,42
2021-03-05,Alameda,001,1643700,81786,81215,1706,82921,1141
2021-03-05,Alpine,003,1148,82,78,0,78,0
2021-03-05,Amador,005,37829,3488,3484,31,3515,42
2021-03-05,Butte,007,227075,11436,11050,1610,12660,185
2021-03-05,Calaveras,009,45235,1933,1902,11,1913,48
2021-03-05,Colusa,011,21464,1881,1874,270,2144,11
2021-03-05,Contra Costa,013,1133247,63946,62886,1073,63959,711
2021-03-05,Del Norte,015,27424,1047,995,5,1000,5
2021-03-05,El Dorado,017,186661,9244,9150,603,9753,97
2021-03-05,Fresno,019,978130,97428,96184,7762,103946,1432
2021-03-05,Glenn,021,27897,2277,2241,495,2736,15
2021-03-05,Humboldt,023,135768,3272,3234,22,3256,31
2021-03-05,Imperial,025,180216,27334,26970,2463,29433,651
2021-03-05,Inyo,027,18085,1334,1309,9,1318,35
2021-03-05,Kern,029,883053,94104,92601,9834,102435,1076
2021-03-05,Kings,031,150075,22428,22063,971,23034,224
2021-03-05,Lake,033,64148,3231,3185,6,3191,42
2021-03-05,Lassen,035,31185,5131,5117,96,5213,1
2021-03-05,Los Angeles,037,10098052,1177729,1160688,38824,1199512,21745
2021-03-05,Madera,039,155013,15823,15624,843,16467,211
2021-03-05,Marin,041,260295,13378,13275,165,13440,215
2021-03-05,Mariposa,043,17540,378,375,5,380,4
2021-03-05,Mendocino,045,87422,3675,3577,72,3649,42
2021-03-05,Merced,047,269075,28796,28734,928,29662,399
2021-03-05,Modoc,049,8938,345,337,117,454,3
2021-03-05,Mono,051,14174,1190,1197,15,1212,3
2021-03-05,Monterey,053,433212,42131,41802,1674,43476,325
2021-03-05,Napa,055,140530,9144,9109,32,9141,75
2021-03-05,Nevada,057,99092,4098,4033,161,4194,66
2021-03-05,Orange,059,3164182,248309,246489,10209,256698,4108
2021-03-05,Placer,061,380077,20854,19973,1127,21100,239
2021-03-05,Plumas,063,18699,647,635,10,645,4
2021-03-05,Riverside,065,2383286,286824,280075,13325,293400,3781
2021-03-05,Sacramento,067,1510023,95591,94182,1264,95446,1430
2021-03-05,San Benito,069,59416,5765,5790,89,5879,61
2021-03-05,San Bernardino,071,2135413,287004,282640,8523,291163,3774
2021-03-05,San Diego,073,3302833,266079,262357,13097,275454,3371
2021-03-05,San Francisco,075,870044,34462,34526,1081,35607,430
2021-03-05,San Joaquin,077,732212,67541,66041,2773,68814,1133
2021-03-05,San Luis Obispo,079,281455,19903,19557,561,20118,244
2021-03-05,San Mateo,081,765935,39853,39305,408,39713,326
2021-03-05,Santa Barbara,083,443738,32615,32139,1037,33176,424
2021-03-05,Santa Clara,085,1922200,111616,111384,588,111972,1745
2021-03-05,Santa Cruz,087,273765,15545,14694,773,15467,188
2021-03-05,Shasta,089,179085,11029,11062,1261,12323,148
2021-03-05,Sierra,091,2930,51,48,12,60,0
2021-03-05,Siskiyou,093,43540,1530,1429,236,1665,5
2021-03-05,Solano,095,438530,30105,29951,368,30319,168
2021-03-05,Sonoma,097,501317,28396,28417,220,28637,279
2021-03-05,Stanislaus,099,539301,51255,50606,5351,55957,721
2021-03-05,Sutter,101,95872,8899,8876,79,8955,100
2021-03-05,Tehama,103,63373,4637,4606,486,5092,33
2021-03-05,Trinity,105,12862,468,302,77,379,3
2021-03-05,Tulare,107,460477,48613,47469,8071,55540,789
2021-03-05,Tuolumne,109,53932,3866,3917,36,3953,56
2021-03-05,Ventura,111,848112,78583,78368,2769,81137,839
2021-03-05,Yolo,113,214977,13025,12920,140,13060,188
2021-03-05,Yuba,115,75493,5572,5496,88,5584,42
2021-03-04,Alameda,001,1643700,81677,81115,1706,82821,1136
2021-03-04,Alpine,003,1148,82,78,0,78,0
2021-03-04,Amador,005,37829,3487,3480,31,3511,42
2021-03-04,Butte,007,227075,11429,11033,1609,12642,185
2021-03-04,Calaveras,009,45235,1932,1896,11,1907,48
2021-03-04,Colusa,011,21464,1879,1873,265,2138,11
2021-03-04,Contra Costa,013,1133247,63846,62789,1071,63860,708
2021-03-04,Del Norte,015,27424,1039,989,5,994,5
2021-03-04,El Dorado,017,186661,9229,9133,603,9736,97
2021-03-04,Fresno,019,978130,97264,96023,7743,103766,1422
2021-03-04,Glenn,021,27897,2270,2236,494,2730,15
2021-03-04,Humboldt,023,135768,3258,3212,22,3234,31
2021-03-04,Imperial,025,180216,27321,26946,2460,29406,646
2021-03-04,Inyo,027,18085,1331,1300,9,1309,35
2021-03-04,Kern,029,883053,94015,92525,9815,102340,1070
2021-03-04,Kings,031,150075,22402,22025,968,22993,224
2021-03-04,Lake,033,64148,3223,3181,6,3187,42
2021-03-04,Lassen,035,31185,5131,5116,96,5212,1
2021-03-04,Los Angeles,037,10098052,1177117,1159405,38774,1198179,21610
2021-03-04,Madera,039,155013,15788,15596,840,16436,208
2021-03-04,Marin,041,260295,13362,13240,162,13402,215
2021-03-04,Mariposa,043,17540,378,376,5,381,4
2021-03-04,Mendocino,045,87422,3672,3569,72,3641,42
2021-03-04,Merced,047,269075,28745,28671,926,29597,396
2021-03-04,Modoc,049,8938,344,336,117,453,3
2021-03-04,Mono,051,14174,1190,1197,15,1212,3
2021-03-04,Monterey,053,433212,42111,41771,1672,43443,325
2021-03-04,Napa,055,140530,9136,9094,32,9126,74
2021-03-04,Nevada,057,99092,4088,4020,161,4181,66
2021-03-04,Orange,059,3164182,248152,246354,10192,256546,4096
2021-03-04,Placer,061,380077,20822,19900,1121,21021,239
2021-03-04,Plumas,063,18699,647,634,10,644,4
2021-03-04,Riverside,065,2383286,286694,279871,13312,293183,3766
2021-03-04,Sacramento,067,1510023,95456,93982,1261,95243,1426
2021-03-04,San Benito,069,59416,5765,5781,89,5870,61
2021-03-04,San Bernardino,071,2135413,286874,282407,8519,290926,3757
2021-03-04,San Diego,073,3302833,265818,261858,13053,274911,3359
2021-03-04,San Francisco,075,870044,34427,34480,1078,35558,426
2021-03-04,San Joaquin,077,732212,67447,65931,2764,68695,1129
2021-03-04,San Luis Obispo,079,281455,19866,19520,559,20079,243
2021-03-04,San Mateo,081,765935,39809,39225,407,39632,322
2021-03-04,Santa Barbara,083,443738,32578,32090,1036,33126,423
2021-03-04,Santa Clara,085,1922200,111482,111194,586,111780,1723
2021-03-04,Santa Cruz,087,273765,15526,14669,773,15442,186
2021-03-04,Shasta,089,179085,11026,11050,1252,12302,150
2021-03-04,Sierra,091,2930,51,48,12,60,0
2021-03-04,Siskiyou,093,43540,1523,1427,236,1663,5
2021-03-04,Solano,095,438530,30078,29905,367,30272,168
2021-03-04,Sonoma,097,501317,28341,28379,219,28598,279
2021-03-04,Stanislaus,099,539301,51168,50521,5343,55864,731
2021-03-04,Sutter,101,95872,8887,8849,79,8928,100
2021-03-04,Tehama,103,63373,4629,4604,486,5090,33
2021-03-04,Trinity,105,12862,468,302,77,379,3
2021-03-04,Tulare,107,460477,48568,47398,8046,55444,784
2021-03-04,Tuolumne,109,53932,3860,3916,36,3952,56
2021-03-04,Ventura,111,848112,78493,78184,2766,80950,831
2021-03-04,Yolo,113,214977,13005,12895,140,13035,189
2021-03-04,Yuba,115,75493,5560,5483,88,5571,41
2021-03-03,Alameda,001,1643700,81557,80972,1705,82677,1127
2021-03-03,Alpine,003,1148,82,77,0,77,0
2021-03-03,Amador,005,37829,3485,3478,30,3508,42
2021-03-03,Butte,007,227075,11421,11014,1608,12622,184
2021-03-03,Calaveras,009,45235,1931,1893,11,1904,48
2021-03-03,Colusa,011,21464,1878,1873,265,2138,11
2021-03-03,Contra Costa,013,1133247,63748,62668,1068,63736,708
2021-03-03,Del Norte,015,27424,1036,988,5,993,5
2021-03-03,El Dorado,017,186661,9219,9121,603,9724,97
2021-03-03,Fresno,019,978130,97120,95893,7726,103619,1415
2021-03-03,Glenn,021,27897,2270,2233,494,2727,15
2021-03-03,Humboldt,023,135768,3247,3196,22,3218,30
2021-03-03,Imperial,025,180216,27305,26939,2456,29395,640
2021-03-03,Inyo,027,18085,1323,1294,9,1303,35
2021-03-03,Kern,029,883053,93939,92434,9798,102232,1063
2021-03-03,Kings,031,150075,22386,22009,967,22976,223
2021-03-03,Lake,033,64148,3216,3175,6,3181,40
2021-03-03,Lassen,035,31185,5131,5115,96,5211,1
2021-03-03,Los Angeles,037,10098052,1176477,1157911,38735,1196646,21500
2021-03-03,Madera,039,155013,15769,15553,834,16387,203
2021-03-03,Marin,041,260295,13348,13216,162,13378,214
2021-03-03,Mariposa,043,17540,377,376,5,381,4
2021-03-03,Mendocino,045,87422,3664,3564,72,3636,42
2021-03-03,Merced,047,269075,28693,28625,926,29551,393
2021-03-03,Modoc,049,8938,344,333,116,449,3
2021-03-03,Mono,051,14174,1190,1191,15,1206,3
2021-03-03,Monterey,053,433212,42079,41731,1669,43400,325
2021-03-03,Napa,055,140530,9128,9090,32,9122,72
2021-03-03,Nevada,057,99092,4078,4009,161,4170,66
2021-03-03,Orange,059,3164182,248007,246120,10178,256298,4072
2021-03-03,Placer,061,380077,20796,19851,1118,20969,239
2021-03-03,Plumas,063,18699,646,631,10,641,4
2021-03-03,Riverside,065,2383286,286561,279626,13306,292932,3735
2021-03-03,Sacramento,067,1510023,95295,93819,1253,95072,1419
2021-03-03,San Benito,069,59416,5764,5774,89,5863,61
2021-03-03,San Bernardino,071,2135413,286733,282138,8513,290651,3664
2021-03-03,San Diego,073,3302833,265554,261350,13022,274372,3342
2021-03-03,San Francisco,075,870044,34395,34443,1075,35518,426
2021-03-03,San Joaquin,077,732212,67334,65855,2757,68612,1115
2021-03-03,San Luis Obispo,079,281455,19840,19479,556,20035,241
2021-03-03,San Mateo,081,765935,39763,39189,406,39595,319
2021-03-03,Santa Barbara,083,443738,32540,32027,1036,33063,421
2021-03-03,Santa Clara,085,1922200,111328,110991,584,111575,1720
2021-03-03,Santa Cruz,087,273765,15515,14645,773,15418,185
2021-03-03,Shasta,089,179085,11016,11023,1245,12268,150
2021-03-03,Sierra,091,2930,51,48,12,60,0
2021-03-03,Siskiyou,093,43540,1521,1424,236,1660,5
2021-03-03,Solano,095,438530,30042,29866,366,30232,167
2021-03-03,Sonoma,097,501317,28302,28307,218,28525,279
2021-03-03,Stanislaus,099,539301,51090,50438,5336,55774,730
2021-03-03,Sutter,101,95872,8879,8840,79,8919,99
2021-03-03,Tehama,103,63373,4627,4601,486,5087,32
2021-03-03,Trinity,105,12862,468,302,77,379,3
2021-03-03,Tulare,107,460477,48517,47348,8017,55365,778
2021-03-03,Tuolumne,109,53932,3858,3914,35,3949,56
2021-03-03,Ventura,111,848112,78409,78057,2761,80818,822
2021-03-03,Yolo,113,214977,12992,12890,140,13030,189
2021-03-03,Yuba,115,75493,5547,5479,88,5567,41
2021-03-02,Alameda,001,1643700,81435,80904,1703,82607,1116
2021-03-02,Alpine,003,1148,82,77,0,77,0
2021-03-02,Amador,005,37829,3483,3474,30,3504,42
2021-03-02,Butte,007,227075,11411,11007,1605,12612,182
2021-03-02,Calaveras,009,45235,1923,1890,11,1901,48
2021-03-02,Colusa,011,21464,1878,1872,264,2136,11
2021-03-02,Contra Costa,013,1133247,63637,62557,1064,63621,694
2021-03-02,Del Norte,015,27424,1029,983,5,988,5
2021-03-02,El Dorado,017,186661,9211,9116,603,9719,98
2021-03-02,Fresno,019,978130,96974,95785,7700,103485,1410
2021-03-02,Glenn,021,27897,2264,2232,493,2725,15
2021-03-02,Humboldt,023,135768,3228,3184,22,3206,30
2021-03-02,Imperial,025,180216,27295,26926,2454,29380,637
2021-03-02,Inyo,027,18085,1319,1292,9,1301,35
2021-03-02,Kern,029,883053,93833,92313,9771,102084,1046
2021-03-02,Kings,031,150075,22334,21999,964,22963,217
2021-03-02,Lake,033,64148,3210,3169,6,3175,40
2021-03-02,Lassen,035,31185,5126,5115,95,5210,1
2021-03-02,Los Angeles,037,10098052,1175838,1156826,38690,1195516,21395
2021-03-02,Madera,039,155013,15749,15523,831,16354,194
2021-03-02,Marin,041,260295,13325,13186,161,13347,214
2021-03-02,Mariposa,043,17540,377,376,5,381,4
2021-03-02,Mendocino,045,87422,3661,3562,71,3633,41
2021-03-02,Merced,047,269075,28636,28598,926,29524,389
2021-03-02,Modoc,049,8938,344,332,116,448,3
2021-03-02,Mono,051,14174,1189,1191,15,1206,3
2021-03-02,Monterey,053,433212,42052,41716,1669,43385,325
2021-03-02,Napa,055,140530,9117,9080,32,9112,71
2021-03-02,Nevada,057,99092,4069,3983,160,4143,66
2021-03-02,Orange,059,3164182,247862,246004,10160,256164,4037
2021-03-02,Placer,061,380077,20743,19828,1115,20943,239
2021-03-02,Plumas,063,18699,643,628,10,638,4
2021-03-02,Riverside,065,2383286,286388,279486,13298,292784,3721
2021-03-02,Sacramento,067,1510023,95128,93690,1252,94942,1411
2021-03-02,San Benito,069,59416,5757,5770,89,5859,60
2021-03-02,San Bernardino,071,2135413,286599,281919,8507,290426,3604
2021-03-02,San Diego,073,3302833,265310,260998,13000,273998,3317
2021-03-02,San Francisco,075,870044,34355,34387,1071,35458,424
2021-03-02,San Joaquin,077,732212,67226,65769,2740,68509,1111
2021-03-02,San Luis Obispo,079,281455,19808,19452,556,20008,241
2021-03-02,San Mateo,081,765935,39711,39148,405,39553,317
2021-03-02,Santa Barbara,083,443738,32491,31964,1032,32996,416
2021-03-02,Santa Clara,085,1922200,111149,110832,583,111415,1706
2021-03-02,Santa Cruz,087,273765,15501,14611,771,15382,185
2021-03-02,Shasta,089,179085,11002,11012,1234,12246,149
2021-03-02,Sierra,091,2930,51,48,12,60,0
2021-03-02,Siskiyou,093,43540,1517,1412,234,1646,5
2021-03-02,Solano,095,438530,30009,29827,364,30191,167
2021-03-02,Sonoma,097,501317,28247,28261,218,28479,279
2021-03-02,Stanislaus,099,539301,51003,50359,5324,55683,724
2021-03-02,Sutter,101,95872,8870,8832,79,8911,99
2021-03-02,Tehama,103,63373,4623,4597,485,5082,32
2021-03-02,Trinity,105,12862,468,301,77,378,3
2021-03-02,Tulare,107,460477,48454,47326,7997,55323,783
2021-03-02,Tuolumne,109,53932,3854,3908,35,3943,53
2021-03-02,Ventura,111,848112,78316,77952,2757,80709,780
2021-03-02,Yolo,113,214977,12976,12867,140,13007,189
2021-03-02,Yuba,115,75493,5539,5475,88,5563,41
2021-03-01,Alameda,001,1643700,81308,80805,1701,82506,1105
2021-03-01,Alpine,003,1148,80,77,0,77,0
2021-03-01,Amador,005,37829,3480,3469,30,3499,42
2021-03-01,Butte,007,227075,11396,10981,1601,12582,180
2021-03-01,Calaveras,009,45235,1918,1885,11,1896,46
2021-03-01,Colusa,011,21464,1877,1871,264,2135,11
2021-03-01,Contra Costa,013,1133247,63529,62458,1063,63521,694
2021-03-01,Del Norte,015,27424,1024,982,5,987,5
2021-03-01,El Dorado,017,186661,9187,9085,603,9688,98
2021-03-01,Fresno,019,978130,96836,95677,7677,103354,1405
2021-03-01,Glenn,021,27897,2259,2232,492,2724,15
2021-03-01,Humboldt,023,135768,3209,3179,22,3201,30
2021-03-01,Imperial,025,180216,27285,26913,2446,29359,636
2021-03-01,Inyo,027,18085,1316,1285,9,1294,35
2021-03-01,Kern,029,883053,93744,92219,9745,101964,1041
2021-03-01,Kings,031,150075,22317,21988,958,22946,217
2021-03-01,Lake,033,64148,3205,3164,6,3170,40
2021-03-01,Lassen,035,31185,5124,5111,95,5206,1
2021-03-01,Los Angeles,037,10098052,1175181,1155984,38648,1194632,21293
2021-03-01,Madera,039,155013,15720,15505,821,16326,194
2021-03-01,Marin,041,260295,13297,13161,160,13321,214
2021-03-01,Mariposa,043,17540,377,375,5,380,4
2021-03-01,Mendocino,045,87422,3654,3561,71,3632,41
2021-03-01,Merced,047,269075,28591,28575,922,29497,385
2021-03-01,Modoc,049,8938,341,331,115,446,3
2021-03-01,Mono,051,14174,1188,1192,15,1207,3
2021-03-01,Monterey,053,433212,42027,41697,1667,43364,324
2021-03-01,Napa,055,140530,9108,9056,32,9088,70
2021-03-01,Nevada,057,99092,4050,3979,160,4139,66
2021-03-01,Orange,059,3164182,247667,245852,10146,255998,3976
2021-03-01,Placer,061,380077,20704,19803,1112,20915,239
2021-03-01,Plumas,063,18699,643,628,10,638,4
2021-03-01,Riverside,065,2383286,286171,279323,13291,292614,3680
2021-03-01,Sacramento,067,1510023,94983,93546,1250,94796,1401
2021-03-01,San Benito,069,59416,5752,5772,89,5861,57
2021-03-01,San Bernardino,071,2135413,286455,281685,8503,290188,3603
2021-03-01,San Diego,073,3302833,264993,260622,12967,273589,3303
2021-03-01,San Francisco,075,870044,34311,34318,1063,35381,424
2021-03-01,San Joaquin,077,732212,67117,65699,2730,68429,1097
2021-03-01,San Luis Obispo,079,281455,19786,19429,554,19983,239
2021-03-01,San Mateo,081,765935,39659,39096,405,39501,314
2021-03-01,Santa Barbara,083,443738,32448,31909,1031,32940,413
2021-03-01,Santa Clara,085,1922200,110990,110684,580,111264,1704
2021-03-01,Santa Cruz,087,273765,15482,14575,770,15345,185
2021-03-01,Shasta,089,179085,10990,10990,1231,12221,149
2021-03-01,Sierra,091,2930,51,48,12,60,0
2021-03-01,Siskiyou,093,43540,1513,1408,232,1640,5
2021-03-01,Solano,095,438530,29966,29779,363,30142,166
2021-03-01,Sonoma,097,501317,28199,28222,216,28438,278
2021-03-01,Stanislaus,099,539301,50929,50293,5318,55611,722
2021-03-01,Sutter,101,95872,8859,8825,79,8904,99
2021-03-01,Tehama,103,63373,4617,4595,485,5080,32
2021-03-01,Trinity,105,12862,468,298,76,374,3
2021-03-01,Tulare,107,460477,48416,47275,7964,55239,781
2021-03-01,Tuolumne,109,53932,3851,3907,35,3942,53
2021-03-01,Ventura,111,848112,78235,77849,2756,80605,775
2021-03-01,Yolo,113,214977,12959,12854,138,12992,188
2021-03-01,Yuba,115,75493,5527,5466,88,5554,41
2021-02-28,Alameda,001,1643700,81187,80727,1699,82426,1105
2021-02-28,Alpine,003,1148,80,77,0,77,0
2021-02-28,Amador,005,37829,3475,3466,29,3495,42
2021-02-28,Butte,007,227075,11381,10970,1601,12571,180
2021-02-28,Calaveras,009,45235,1914,1881,11,1892,46
2021-02-28,Colusa,011,21464,1877,1871,263,2134,11
2021-02-28,Contra Costa,013,1133247,63402,62386,1058,63444,694
2021-02-28,Del Norte,015,27424,1022,981,5,986,5
2021-02-28,El Dorado,017,186661,9176,9082,603,9685,98
2021-02-28,Fresno,019,978130,96654,95548,7643,103191,1405
2021-02-28,Glenn,021,27897,2257,2230,490,2720,15
2021-02-28,Humboldt,023,135768,3186,3179,22,3201,30
2021-02-28,Imperial,025,180216,27259,26909,2442,29351,636
2021-02-28,Inyo,027,18085,1311,1282,9,1291,35
2021-02-28,Kern,029,883053,93629,92169,9725,101894,1012
2021-02-28,Kings,031,150075,22296,21967,957,22924,217
2021-02-28,Lake,033,64148,3200,3164,6,3170,40
2021-02-28,Lassen,035,31185,5123,5106,95,5201,1
2021-02-28,Los Angeles,037,10098052,1174393,1155141,38586,1193727,21261
2021-02-28,Madera,039,155013,15678,15496,818,16314,199
2021-02-28,Marin,041,260295,13274,13152,158,13310,214
2021-02-28,Mariposa,043,17540,377,374,5,379,4
2021-02-28,Mendocino,045,87422,3648,3558,71,3629,41
2021-02-28,Merced,047,269075,28528,28546,921,29467,384
2021-02-28,Modoc,049,8938,341,331,115,446,3
2021-02-28,Mono,051,14174,1185,1192,15,1207,3
2021-02-28,Monterey,053,433212,41995,41683,1665,43348,323
2021-02-28,Napa,055,140530,9089,9053,32,9085,70
2021-02-28,Nevada,057,99092,4037,3972,160,4132,66
2021-02-28,Orange,059,3164182,247469,245706,10139,255845,3970
2021-02-28,Placer,061,380077,20658,19775,1110,20885,239
2021-02-28,Plumas,063,18699,643,628,10,638,4
2021-02-28,Riverside,065,2383286,285938,279214,13280,292494,3661
2021-02-28,Sacramento,067,1510023,94799,93463,1245,94708,1398
2021-02-28,San Benito,069,59416,5741,5772,89,5861,57
2021-02-28,San Bernardino,071,2135413,286314,281620,8491,290111,3595
2021-02-28,San Diego,073,3302833,264696,260353,12933,273286,3303
2021-02-28,San Francisco,075,870044,34269,34291,1057,35348,417
2021-02-28,San Joaquin,077,732212,67009,65662,2721,68383,1097
2021-02-28,San Luis Obispo,079,281455,19750,19422,552,19974,237
2021-02-28,San Mateo,081,765935,39606,39059,404,39463,314
2021-02-28,Santa Barbara,083,443738,32396,31877,1031,32908,413
2021-02-28,Santa Clara,085,1922200,110791,110556,577,111133,1704
2021-02-28,Santa Cruz,087,273765,15453,14571,767,15338,185
2021-02-28,Shasta,089,179085,10969,10990,1227,12217,149
2021-02-28,Sierra,091,2930,51,48,12,60,0
2021-02-28,Siskiyou,093,43540,1505,1408,232,1640,5
2021-02-28,Solano,095,438530,29911,29758,357,30115,166
2021-02-28,Sonoma,097,501317,28136,28193,215,28408,279
2021-02-28,Stanislaus,099,539301,50838,50228,5306,55534,728
2021-02-28,Sutter,101,95872,8844,8825,79,8904,99
2021-02-28,Tehama,103,63373,4612,4590,485,5075,32
2021-02-28,Trinity,105,12862,468,298,76,374,3
2021-02-28,Tulare,107,460477,48354,47258,7933,55191,780
2021-02-28,Tuolumne,109,53932,3846,3905,35,3940,53
2021-02-28,Ventura,111,848112,78123,77749,2753,80502,775
2021-02-28,Yolo,113,214977,12936,12851,138,12989,188
2021-02-28,Yuba,115,75493,5517,5461,88,5549,41
2021-02-27,Alameda,001,1643700,81114,80565,1697,82262,1108
2021-02-27,Alpine,003,1148,80,77,0,77,0
2021-02-27,Amador,005,37829,3473,3463,29,3492,42
2021-02-27,Butte,007,227075,11369,10962,1601,12563,180
2021-02-27,Calaveras,009,45235,1909,1875,11,1886,46
2021-02-27,Colusa,011,21464,1876,1869,263,2132,11
2021-02-27,Contra Costa,013,1133247,63332,62248,1055,63303,693
2021-02-27,Del Norte,015,27424,1020,978,5,983,5
2021-02-27,El Dorado,017,186661,9172,9072,603,9675,98
2021-02-27,Fresno,019,978130,96577,95393,7632,103025,1400
2021-02-27,Glenn,021,27897,2256,2225,489,2714,15
2021-02-27,Humboldt,023,135768,3180,3167,22,3189,30
2021-02-27,Imperial,025,180216,27251,26903,2440,29343,633
2021-02-27,Inyo,027,18085,1308,1275,9,1284,35
2021-02-27,Kern,029,883053,93568,92053,9710,101763,996
2021-02-27,Kings,031,150075,22286,21955,954,22909,216
2021-02-27,Lake,033,64148,3197,3156,6,3162,40
2021-02-27,Lassen,035,31185,5123,5106,95,5201,1
2021-02-27,Los Angeles,037,10098052,1173891,1154275,38559,1192834,21158
2021-02-27,Madera,039,155013,15661,15467,817,16284,199
2021-02-27,Marin,041,260295,13250,13134,158,13292,214
2021-02-27,Mariposa,043,17540,377,374,5,379,4
2021-02-27,Mendocino,045,87422,3645,3555,71,3626,41
2021-02-27,Merced,047,269075,28486,28501,913,29414,384
2021-02-27,Modoc,049,8938,341,331,114,445,3
2021-02-27,Mono,051,14174,1183,1191,15,1206,3
2021-02-27,Monterey,053,433212,41986,41665,1664,43329,322
2021-02-27,Napa,055,140530,9078,9038,32,9070,71
2021-02-27,Nevada,057,99092,4031,3960,160,4120,66
2021-02-27,Orange,059,3164182,247342,245542,10128,255670,3960
2021-02-27,Placer,061,380077,20622,19726,1107,20833,239
2021-02-27,Plumas,063,18699,643,628,10,638,4
2021-02-27,Riverside,065,2383286,285828,279048,13270,292318,3663
2021-02-27,Sacramento,067,1510023,94716,93281,1235,94516,1396
2021-02-27,San Benito,069,59416,5740,5767,88,5855,57
2021-02-27,San Bernardino,071,2135413,286235,281471,8486,289957,3527
2021-02-27,San Diego,073,3302833,264506,260091,12895,272986,3284
2021-02-27,San Francisco,075,870044,34235,34260,1054,35314,413
2021-02-27,San Joaquin,077,732212,66963,65578,2719,68297,1100
2021-02-27,San Luis Obispo,079,281455,19729,19411,551,19962,237
2021-02-27,San Mateo,081,765935,39565,38998,403,39401,313
2021-02-27,Santa Barbara,083,443738,32362,31805,1030,32835,411
2021-02-27,Santa Clara,085,1922200,110643,110361,575,110936,1703
2021-02-27,Santa Cruz,087,273765,15444,14552,766,15318,185
2021-02-27,Shasta,089,179085,10963,10985,1223,12208,149
2021-02-27,Sierra,091,2930,51,48,12,60,0
2021-02-27,Siskiyou,093,43540,1503,1407,231,1638,5
2021-02-27,Solano,095,438530,29883,29718,356,30074,165
2021-02-27,Sonoma,097,501317,28092,28141,210,28351,281
2021-02-27,Stanislaus,099,539301,50783,50147,5296,55443,733
2021-02-27,Sutter,101,95872,8839,8820,79,8899,99
2021-02-27,Tehama,103,63373,4607,4584,484,5068,32
2021-02-27,Trinity,105,12862,468,298,76,374,3
2021-02-27,Tulare,107,460477,48317,47209,7907,55116,770
2021-02-27,Tuolumne,109,53932,3843,3899,35,3934,53
2021-02-27,Ventura,111,848112,78050,77623,2750,80373,771
2021-02-27,Yolo,113,214977,12924,12834,138,12972,188
2021-02-27,Yuba,115,75493,5514,5450,88,5538,39
2021-02-26,Alameda,001,1643700,81019,80387,1692,82079,1106
2021-02-26,Alpine,003,1148,80,77,0,77,0
2021-02-26,Amador,005,37829,3467,3457,29,3486,42
2021-02-26,Butte,007,227075,11359,10941,1601,12542,180
2021-02-26,Calaveras,009,45235,1907,1873,11,1884,46
2021-02-26,Colusa,011,21464,1876,1865,263,2128,11
2021-02-26,Contra Costa,013,1133247,63250,62114,1055,63169,685
2021-02-26,Del Norte,015,27424,1016,968,5,973,5
2021-02-26,El Dorado,017,186661,9167,9038,601,9639,98
2021-02-26,Fresno,019,978130,96475,95202,7624,102826,1391
2021-02-26,Glenn,021,27897,2253,2220,489,2709,15
2021-02-26,Humboldt,023,135768,3174,3152,22,3174,30
2021-02-26,Imperial,025,180216,27244,26888,2438,29326,631
2021-02-26,Inyo,027,18085,1306,1271,9,1280,34
2021-02-26,Kern,029,883053,93489,91884,9694,101578,997
2021-02-26,Kings,031,150075,22270,21917,951,22868,216
2021-02-26,Lake,033,64148,3192,3153,6,3159,40
2021-02-26,Lassen,035,31185,5123,5102,95,5197,1
2021-02-26,Los Angeles,037,10098052,1173313,1153131,38499,1191630,21070
2021-02-26,Madera,039,155013,15645,15436,815,16251,199
2021-02-26,Marin,041,260295,13237,13091,158,13249,214
2021-02-26,Mariposa,043,17540,377,375,5,380,4
2021-02-26,Mendocino,045,87422,3640,3549,71,3620,41
2021-02-26,Merced,047,269075,28452,28455,912,29367,382
2021-02-26,Modoc,049,8938,340,330,114,444,3
2021-02-26,Mono,051,14174,1181,1191,15,1206,3
2021-02-26,Monterey,053,433212,41960,41607,1663,43270,322
2021-02-26,Napa,055,140530,9072,9014,32,9046,70
2021-02-26,Nevada,057,99092,4020,3952,160,4112,66
2021-02-26,Orange,059,3164182,247203,245278,10118,255396,3918
2021-02-26,Placer,061,380077,20596,19712,1101,20813,239
2021-02-26,Plumas,063,18699,643,628,10,638,4
2021-02-26,Riverside,065,2383286,285684,278772,13264,292036,3653
2021-02-26,Sacramento,067,1510023,94593,93180,1232,94412,1390
2021-02-26,San Benito,069,59416,5739,5759,88,5847,57
2021-02-26,San Bernardino,071,2135413,286135,281132,8484,289616,3461
2021-02-26,San Diego,073,3302833,264278,259641,12874,272515,3271
2021-02-26,San Francisco,075,870044,34205,34213,1051,35264,413
2021-02-26,San Joaquin,077,732212,66882,65492,2713,68205,1070
2021-02-26,San Luis Obispo,079,281455,19713,19359,549,19908,234
2021-02-26,San Mateo,081,765935,39520,38922,403,39325,313
2021-02-26,Santa Barbara,083,443738,32318,31724,1029,32753,410
2021-02-26,Santa Clara,085,1922200,110511,110168,573,110741,1700
2021-02-26,Santa Cruz,087,273765,15432,14528,765,15293,185
2021-02-26,Shasta,089,179085,10956,10972,1214,12186,149
2021-02-26,Sierra,091,2930,51,47,12,59,0
2021-02-26,Siskiyou,093,43540,1503,1401,230,1631,5
2021-02-26,Solano,095,438530,29849,29651,355,30006,165
2021-02-26,Sonoma,097,501317,28063,28063,209,28272,280
2021-02-26,Stanislaus,099,539301,50727,50054,5288,55342,737
2021-02-26,Sutter,101,95872,8830,8806,79,8885,99
2021-02-26,Tehama,103,63373,4605,4581,484,5065,32
2021-02-26,Trinity,105,12862,467,298,76,374,3
2021-02-26,Tulare,107,460477,48282,47135,7878,55013,770
2021-02-26,Tuolumne,109,53932,3842,3896,35,3931,53
2021-02-26,Ventura,111,848112,77950,77534,2746,80280,765
2021-02-26,Yolo,113,214977,12917,12816,138,12954,188
2021-02-26,Yuba,115,75493,5509,5438,88,5526,39
2021-02-25,Alameda,001,1643700,80898,80181,1691,81872,1093
2021-02-25,Alpine,003,1148,80,77,0,77,0
2021-02-25,Amador,005,37829,3464,3448,29,3477,41
2021-02-25,Butte,007,227075,11338,10922,1596,12518,178
2021-02-25,Calaveras,009,45235,1899,1868,11,1879,46
2021-02-25,Colusa,011,21464,1873,1863,262,2125,11
2021-02-25,Contra Costa,013,1133247,63148,61910,1055,62965,686
2021-02-25,Del Norte,015,27424,1006,966,5,971,5
2021-02-25,El Dorado,017,186661,9151,9012,601,9613,98
2021-02-25,Fresno,019,978130,96331,95015,7603,102618,1377
2021-02-25,Glenn,021,27897,2250,2219,488,2707,15
2021-02-25,Humboldt,023,135768,3167,3129,22,3151,30
2021-02-25,Imperial,025,180216,27237,26855,2434,29289,628
2021-02-25,Inyo,027,18085,1300,1264,9,1273,33
2021-02-25,Kern,029,883053,93373,91735,9669,101404,992
2021-02-25,Kings,031,150075,22261,21900,948,22848,216
2021-02-25,Lake,033,64148,3183,3141,6,3147,40
2021-02-25,Lassen,035,31185,5122,5097,94,5191,1
2021-02-25,Los Angeles,037,10098052,1172566,1151846,38441,1190287,20931
2021-02-25,Madera,039,155013,15610,15414,811,16225,194
2021-02-25,Marin,041,260295,13214,13067,158,13225,214
2021-02-25,Mariposa,043,17540,377,375,5,380,4
2021-02-25,Mendocino,045,87422,3635,3542,71,3613,41
2021-02-25,Merced,047,269075,28403,28383,910,29293,382
2021-02-25,Modoc,049,8938,340,329,114,443,3
2021-02-25,Mono,051,14174,1180,1190,15,1205,3
2021-02-25,Monterey,053,433212,41935,41564,1658,43222,321
2021-02-25,Napa,055,140530,9046,8998,32,9030,70
2021-02-25,Nevada,057,99092,4003,3940,159,4099,66
2021-02-25,Orange,059,3164182,247030,245000,10108,255108,3882
2021-02-25,Placer,061,380077,20557,19661,1099,20760,239
2021-02-25,Plumas,063,18699,643,626,10,636,4
2021-02-25,Riverside,065,2383286,285496,278544,13244,291788,3646
2021-02-25,Sacramento,067,1510023,94435,92961,1220,94181,1386
2021-02-25,San Benito,069,59416,5734,5752,88,5840,58
2021-02-25,San Bernardino,071,2135413,285999,280946,8476,289422,3409
2021-02-25,San Diego,073,3302833,263984,258979,12844,271823,3260
2021-02-25,San Francisco,075,870044,34162,34138,1049,35187,408
2021-02-25,San Joaquin,077,732212,66798,65389,2701,68090,1047
2021-02-25,San Luis Obispo,079,281455,19692,19335,547,19882,234
2021-02-25,San Mateo,081,765935,39473,38872,403,39275,300
2021-02-25,Santa Barbara,083,443738,32241,31631,1028,32659,408
2021-02-25,Santa Clara,085,1922200,110346,109923,572,110495,1677
2021-02-25,Santa Cruz,087,273765,15413,14492,764,15256,185
2021-02-25,Shasta,089,179085,10944,10947,1209,12156,148
2021-02-25,Sierra,091,2930,51,47,12,59,0
2021-02-25,Siskiyou,093,43540,1498,1390,227,1617,4
2021-02-25,Solano,095,438530,29817,29616,355,29971,161
2021-02-25,Sonoma,097,501317,28009,28004,206,28210,278
2021-02-25,Stanislaus,099,539301,50636,49964,5278,55242,738
2021-02-25,Sutter,101,95872,8816,8789,78,8867,99
2021-02-25,Tehama,103,63373,4602,4578,482,5060,32
2021-02-25,Trinity,105,12862,467,297,76,373,3
2021-02-25,Tulare,107,460477,48232,47052,7852,54904,765
2021-02-25,Tuolumne,109,53932,3839,3894,35,3929,53
2021-02-25,Ventura,111,848112,77842,77395,2740,80135,751
2021-02-25,Yolo,113,214977,12900,12787,138,12925,188
2021-02-25,Yuba,115,75493,5502,5429,88,5517,39
2021-02-24,Alameda,001,1643700,80778,80070,1687,81757,1082
2021-02-24,Alpine,003,1148,79,77,0,77,0
2021-02-24,Amador,005,37829,3459,3444,29,3473,41
2021-02-24,Butte,007,227075,11325,10915,1592,12507,178
2021-02-24,Calaveras,009,45235,1895,1864,11,1875,31
2021-02-24,Colusa,011,21464,1871,1863,262,2125,11
2021-02-24,Contra Costa,013,1133247,63040,61776,1055,62831,663
2021-02-24,Del Norte,015,27424,1005,960,4,964,5
2021-02-24,El Dorado,017,186661,9138,8993,601,9594,98
2021-02-24,Fresno,019,978130,96183,94794,7587,102381,1369
2021-02-24,Glenn,021,27897,2249,2210,488,2698,14
2021-02-24,Humboldt,023,135768,3155,3123,22,3145,29
2021-02-24,Imperial,025,180216,27224,26843,2429,29272,596
2021-02-24,Inyo,027,18085,1295,1253,9,1262,32
2021-02-24,Kern,029,883053,93240,91525,9653,101178,992
2021-02-24,Kings,031,150075,22236,21871,946,22817,216
2021-02-24,Lake,033,64148,3176,3134,6,3140,40
2021-02-24,Lassen,035,31185,5118,5095,93,5188,1
2021-02-24,Los Angeles,037,10098052,1171803,1150322,38402,1188724,20817
2021-02-24,Madera,039,155013,15583,15390,811,16201,194
2021-02-24,Marin,041,260295,13191,13044,157,13201,214
2021-02-24,Mariposa,043,17540,377,374,5,379,4
2021-02-24,Mendocino,045,87422,3628,3540,71,3611,41
2021-02-24,Merced,047,269075,28365,28295,906,29201,383
2021-02-24,Modoc,049,8938,339,329,114,443,3
2021-02-24,Mono,051,14174,1178,1189,15,1204,3
2021-02-24,Monterey,053,433212,41910,41495,1656,43151,320
2021-02-24,Napa,055,140530,9029,8976,31,9007,70
2021-02-24,Nevada,057,99092,3993,3927,159,4086,66
2021-02-24,Orange,059,3164182,246812,244743,10095,254838,3835
2021-02-24,Placer,061,380077,20518,19648,1093,20741,239
2021-02-24,Plumas,063,18699,641,626,10,636,4
2021-02-24,Riverside,065,2383286,285268,278293,13235,291528,3603
2021-02-24,Sacramento,067,1510023,94281,92742,1215,93957,1375
2021-02-24,San Benito,069,59416,5733,5743,88,5831,57
2021-02-24,San Bernardino,071,2135413,285847,280583,8472,289055,3360
2021-02-24,San Diego,073,3302833,263688,258460,12828,271288,3230
2021-02-24,San Francisco,075,870044,34116,34061,1046,35107,406
2021-02-24,San Joaquin,077,732212,66688,65274,2699,67973,1019
2021-02-24,San Luis Obispo,079,281455,19669,19309,545,19854,233
2021-02-24,San Mateo,081,765935,39436,38763,403,39166,300
2021-02-24,Santa Barbara,083,443738,32189,31563,1025,32588,405
2021-02-24,Santa Clara,085,1922200,110198,109671,571,110242,1674
2021-02-24,Santa Cruz,087,273765,15392,14458,764,15222,185
2021-02-24,Shasta,089,179085,10931,10922,1206,12128,148
2021-02-24,Sierra,091,2930,51,47,12,59,0
2021-02-24,Siskiyou,093,43540,1491,1385,223,1608,4
2021-02-24,Solano,095,438530,29777,29577,353,29930,158
2021-02-24,Sonoma,097,501317,27945,27954,202,28156,278
2021-02-24,Stanislaus,099,539301,50565,49851,5271,55122,732
2021-02-24,Sutter,101,95872,8806,8778,78,8856,99
2021-02-24,Tehama,103,63373,4599,4566,482,5048,31
2021-02-24,Trinity,105,12862,467,294,75,369,3
2021-02-24,Tulare,107,460477,48176,46976,7824,54800,759
2021-02-24,Tuolumne,109,53932,3836,3887,35,3922,53
2021-02-24,Ventura,111,848112,77734,77238,2739,79977,718
2021-02-24,Yolo,113,214977,12887,12760,138,12898,188
2021-02-24,Yuba,115,75493,5491,5425,86,5511,39
2021-02-23,Alameda,001,1643700,80640,79948,1685,81633,1070
2021-02-23,Alpine,003,1148,78,77,0,77,0
2021-02-23,Amador,005,37829,3457,3440,29,3469,41
2021-02-23,Butte,007,227075,11309,10887,1589,12476,176
2021-02-23,Calaveras,009,45235,1894,1863,11,1874,21
2021-02-23,Colusa,011,21464,1868,1862,262,2124,11
2021-02-23,Contra Costa,013,1133247,62906,61613,1052,62665,661
2021-02-23,Del Norte,015,27424,1003,953,4,957,3
2021-02-23,El Dorado,017,186661,9125,8969,601,9570,96
2021-02-23,Fresno,019,978130,96022,94741,7573,102314,1356
2021-02-23,Glenn,021,27897,2247,2209,488,2697,14
2021-02-23,Humboldt,023,135768,3138,3108,22,3130,29
2021-02-23,Imperial,025,180216,27204,26816,2424,29240,591
2021-02-23,Inyo,027,18085,1291,1250,9,1259,32
2021-02-23,Kern,029,883053,93101,91390,9625,101015,982
2021-02-23,Kings,031,150075,22221,21839,942,22781,216
2021-02-23,Lake,033,64148,3168,3121,6,3127,40
2021-02-23,Lassen,035,31185,5115,5092,93,5185,1
2021-02-23,Los Angeles,037,10098052,1170929,1148965,38349,1187314,19887
2021-02-23,Madera,039,155013,15569,15352,805,16157,193
2021-02-23,Marin,041,260295,13171,13015,156,13171,214
2021-02-23,Mariposa,043,17540,377,374,5,379,4
2021-02-23,Mendocino,045,87422,3626,3540,70,3610,41
2021-02-23,Merced,047,269075,28285,28209,899,29108,381
2021-02-23,Modoc,049,8938,338,328,113,441,3
2021-02-23,Mono,051,14174,1178,1189,15,1204,3
2021-02-23,Monterey,053,433212,41871,41439,1651,43090,317
2021-02-23,Napa,055,140530,9017,8967,31,8998,70
2021-02-23,Nevada,057,99092,3985,3912,159,4071,66
2021-02-23,Orange,059,3164182,246614,244566,10077,254643,3843
2021-02-23,Placer,061,380077,20493,19608,1089,20697,238
2021-02-23,Plumas,063,18699,640,626,10,636,4
2021-02-23,Riverside,065,2383286,285031,278075,13221,291296,3599
2021-02-23,Sacramento,067,1510023,94124,92632,1209,93841,1370
2021-02-23,San Benito,069,59416,5727,5731,87,5818,57
2021-02-23,San Bernardino,071,2135413,285659,280279,8467,288746,3283
2021-02-23,San Diego,073,3302833,263311,257802,12798,270600,3218
2021-02-23,San Francisco,075,870044,34068,33994,1045,35039,405
2021-02-23,San Joaquin,077,732212,66588,65141,2692,67833,1004
2021-02-23,San Luis Obispo,079,281455,19640,19233,544,19777,230
2021-02-23,San Mateo,081,765935,39375,38662,403,39065,299
2021-02-23,Santa Barbara,083,443738,32134,31483,1024,32507,402
2021-02-23,Santa Clara,085,1922200,110001,109449,568,110017,1661
2021-02-23,Santa Cruz,087,273765,15363,14435,762,15197,178
2021-02-23,Shasta,089,179085,10919,10903,1202,12105,146
2021-02-23,Sierra,091,2930,51,47,12,59,0
2021-02-23,Siskiyou,093,43540,1486,1380,221,1601,4
2021-02-23,Solano,095,438530,29737,29545,350,29895,154
2021-02-23,Sonoma,097,501317,27902,27882,199,28081,278
2021-02-23,Stanislaus,099,539301,50487,49749,5255,55004,722
2021-02-23,Sutter,101,95872,8793,8766,78,8844,98
2021-02-23,Tehama,103,63373,4593,4556,481,5037,30
2021-02-23,Trinity,105,12862,467,292,74,366,3
2021-02-23,Tulare,107,460477,48098,46937,7791,54728,757
2021-02-23,Tuolumne,109,53932,3832,3864,35,3899,53
2021-02-23,Ventura,111,848112,77618,77093,2730,79823,689
2021-02-23,Yolo,113,214977,12858,12729,138,12867,188
2021-02-23,Yuba,115,75493,5478,5417,85,5502,38
2021-02-22,Alameda,001,1643700,80489,79796,1681,81477,1062
2021-02-22,Alpine,003,1148,78,77,0,77,0
2021-02-22,Amador,005,37829,3452,3438,29,3467,39
2021-02-22,Butte,007,227075,11296,10855,1584,12439,176
2021-02-22,Calaveras,009,45235,1892,1862,11,1873,21
2021-02-22,Colusa,011,21464,1868,1860,262,2122,11
2021-02-22,Contra Costa,013,1133247,62778,61478,1051,62529,661
2021-02-22,Del Norte,015,27424,1002,948,4,952,3
2021-02-22,El Dorado,017,186661,9108,8940,601,9541,96
2021-02-22,Fresno,019,978130,95860,94584,7556,102140,1351
2021-02-22,Glenn,021,27897,2242,2207,486,2693,14
2021-02-22,Humboldt,023,135768,3126,3095,22,3117,29
2021-02-22,Imperial,025,180216,27182,26778,2417,29195,590
2021-02-22,Inyo,027,18085,1286,1248,9,1257,32
2021-02-22,Kern,029,883053,92984,91201,9603,100804,982
2021-02-22,Kings,031,150075,22198,21801,939,22740,214
2021-02-22,Lake,033,64148,3162,3107,6,3113,40
2021-02-22,Lassen,035,31185,5115,5088,92,5180,1
2021-02-22,Los Angeles,037,10098052,1170060,1147541,38291,1185832,19730
2021-02-22,Madera,039,155013,15544,15325,801,16126,193
2021-02-22,Marin,041,260295,13146,12991,153,13144,213
2021-02-22,Mariposa,043,17540,376,374,5,379,4
2021-02-22,Mendocino,045,87422,3620,3535,70,3605,41
2021-02-22,Merced,047,269075,28222,28166,896,29062,379
2021-02-22,Modoc,049,8938,338,329,113,442,3
2021-02-22,Mono,051,14174,1174,1189,15,1204,3
2021-02-22,Monterey,053,433212,41826,41397,1645,43042,311
2021-02-22,Napa,055,140530,8990,8950,31,8981,69
2021-02-22,Nevada,057,99092,3976,3900,157,4057,66
2021-02-22,Orange,059,3164182,246378,244118,10059,254177,3843
2021-02-22,Placer,061,380077,20456,19587,1081,20668,238
2021-02-22,Plumas,063,18699,640,625,10,635,4
2021-02-22,Riverside,065,2383286,284768,277730,13213,290943,3567
2021-02-22,Sacramento,067,1510023,93957,92476,1199,93675,1359
2021-02-22,San Benito,069,59416,5725,5723,87,5810,57
2021-02-22,San Bernardino,071,2135413,285480,279984,8454,288438,3259
2021-02-22,San Diego,073,3302833,262901,257348,12765,270113,3189
2021-02-22,San Francisco,075,870044,34008,33947,1040,34987,405
2021-02-22,San Joaquin,077,732212,66492,65060,2679,67739,1001
2021-02-22,San Luis Obispo,079,281455,19603,19198,542,19740,229
2021-02-22,San Mateo,081,765935,39318,38542,400,38942,282
2021-02-22,Santa Barbara,083,443738,32068,31421,1021,32442,399
2021-02-22,Santa Clara,085,1922200,109792,109213,557,109770,1655
2021-02-22,Santa Cruz,087,273765,15337,14417,762,15179,176
2021-02-22,Shasta,089,179085,10904,10872,1197,12069,145
2021-02-22,Sierra,091,2930,51,47,12,59,0
2021-02-22,Siskiyou,093,43540,1480,1373,220,1593,4
2021-02-22,Solano,095,438530,29698,29508,349,29857,150
2021-02-22,Sonoma,097,501317,27857,27845,198,28043,278
2021-02-22,Stanislaus,099,539301,50385,49630,5237,54867,722
2021-02-22,Sutter,101,95872,8785,8698,78,8776,98
2021-02-22,Tehama,103,63373,4590,4550,480,5030,30
2021-02-22,Trinity,105,12862,467,287,73,360,3
2021-02-22,Tulare,107,460477,48036,46879,7759,54638,751
2021-02-22,Tuolumne,109,53932,3828,3856,35,3891,53
2021-02-22,Ventura,111,848112,77490,76947,2725,79672,677
2021-02-22,Yolo,113,214977,12831,12689,138,12827,183
2021-02-22,Yuba,115,75493,5475,5404,84,5488,38
2021-02-21,Alameda,001,1643700,80296,79649,1676,81325,1061
2021-02-21,Alpine,003,1148,78,77,0,77,0
2021-02-21,Amador,005,37829,3444,3435,29,3464,39
2021-02-21,Butte,007,227075,11278,10855,1582,12437,176
2021-02-21,Calaveras,009,45235,1891,1860,11,1871,21
2021-02-21,Colusa,011,21464,1867,1860,258,2118,11
2021-02-21,Contra Costa,013,1133247,62623,61364,1048,62412,661
2021-02-21,Del Norte,015,27424,996,942,4,946,3
2021-02-21,El Dorado,017,186661,9090,8927,600,9527,96
2021-02-21,Fresno,019,978130,95718,94374,7540,101914,1349
2021-02-21,Glenn,021,27897,2240,2201,484,2685,14
2021-02-21,Humboldt,023,135768,3114,3096,22,3118,29
2021-02-21,Imperial,025,180216,27168,26779,2415,29194,590
2021-02-21,Inyo,027,18085,1280,1232,9,1241,32
2021-02-21,Kern,029,883053,92859,91141,9565,100706,980
2021-02-21,Kings,031,150075,22162,21784,937,22721,213
2021-02-21,Lake,033,64148,3154,3100,6,3106,40
2021-02-21,Lassen,035,31185,5107,5077,92,5169,1
2021-02-21,Los Angeles,037,10098052,1169020,1146756,38245,1185001,19711
2021-02-21,Madera,039,155013,15511,15298,798,16096,192
2021-02-21,Marin,041,260295,13117,12968,153,13121,212
2021-02-21,Mariposa,043,17540,376,373,5,378,4
2021-02-21,Mendocino,045,87422,3615,3535,70,3605,41
2021-02-21,Merced,047,269075,28148,28106,881,28987,379
2021-02-21,Modoc,049,8938,335,329,113,442,3
2021-02-21,Mono,051,14174,1174,1189,15,1204,3
2021-02-21,Monterey,053,433212,41770,41373,1638,43011,309
2021-02-21,Napa,055,140530,8976,8929,31,8960,69
2021-02-21,Nevada,057,99092,3963,3895,157,4052,66
2021-02-21,Orange,059,3164182,246081,243985,10042,254027,3801
2021-02-21,Placer,061,380077,20420,19553,1077,20630,238
2021-02-21,Plumas,063,18699,640,625,10,635,4
2021-02-21,Riverside,065,2383286,284535,277555,13200,290755,3564
2021-02-21,Sacramento,067,1510023,93747,92288,1188,93476,1354
2021-02-21,San Benito,069,59416,5715,5716,84,5800,57
2021-02-21,San Bernardino,071,2135413,285256,279870,8440,288310,3247
2021-02-21,San Diego,073,3302833,262467,257027,12719,269746,3190
2021-02-21,San Francisco,075,870044,33944,33891,1036,34927,405
2021-02-21,San Joaquin,077,732212,66353,64997,2667,67664,1001
2021-02-21,San Luis Obispo,079,281455,19570,19178,540,19718,229
2021-02-21,San Mateo,081,765935,39256,38448,396,38844,282
2021-02-21,Santa Barbara,083,443738,32006,31374,1018,32392,399
2021-02-21,Santa Clara,085,1922200,109566,108992,549,109541,1654
2021-02-21,Santa Cruz,087,273765,15314,14401,761,15162,176
2021-02-21,Shasta,089,179085,10890,10867,1192,12059,145
2021-02-21,Sierra,091,2930,51,47,12,59,0
2021-02-21,Siskiyou,093,43540,1474,1371,220,1591,4
2021-02-21,Solano,095,438530,29643,29471,348,29819,150
2021-02-21,Sonoma,097,501317,27793,27793,191,27984,278
2021-02-21,Stanislaus,099,539301,50272,49527,5223,54750,726
2021-02-21,Sutter,101,95872,8768,8687,77,8764,97
2021-02-21,Tehama,103,63373,4581,4547,480,5027,30
2021-02-21,Trinity,105,12862,465,286,73,359,3
2021-02-21,Tulare,107,460477,47968,46830,7724,54554,749
2021-02-21,Tuolumne,109,53932,3814,3828,35,3863,53
2021-02-21,Ventura,111,848112,77341,76862,2712,79574,677
2021-02-21,Yolo,113,214977,12800,12670,137,12807,183
2021-02-21,Yuba,115,75493,5467,5396,83,5479,38
2021-02-20,Alameda,001,1643700,80204,79496,1671,81167,1055
2021-02-20,Alpine,003,1148,78,77,0,77,0
2021-02-20,Amador,005,37829,3442,3432,29,3461,39
2021-02-20,Butte,007,227075,11270,10838,1581,12419,176
2021-02-20,Calaveras,009,45235,1890,1858,11,1869,21
2021-02-20,Colusa,011,21464,1866,1858,258,2116,11
2021-02-20,Contra Costa,013,1133247,62539,61205,1046,62251,663
2021-02-20,Del Norte,015,27424,992,937,4,941,3
2021-02-20,El Dorado,017,186661,9080,8911,600,9511,96
2021-02-20,Fresno,019,978130,95634,94234,7520,101754,1341
2021-02-20,Glenn,021,27897,2236,2199,483,2682,14
2021-02-20,Humboldt,023,135768,3106,3073,22,3095,29
2021-02-20,Imperial,025,180216,27158,26771,2415,29186,590
2021-02-20,Inyo,027,18085,1276,1226,9,1235,32
2021-02-20,Kern,029,883053,92788,91025,9533,100558,968
2021-02-20,Kings,031,150075,22144,21773,936,22709,212
2021-02-20,Lake,033,64148,3147,3089,6,3095,40
2021-02-20,Lassen,035,31185,5105,5067,92,5159,1
2021-02-20,Los Angeles,037,10098052,1168451,1145594,38204,1183798,19630
2021-02-20,Madera,039,155013,15491,15274,797,16071,191
2021-02-20,Marin,041,260295,13096,12945,151,13096,211
2021-02-20,Mariposa,043,17540,376,372,5,377,4
2021-02-20,Mendocino,045,87422,3613,3533,70,3603,40
2021-02-20,Merced,047,269075,28105,28066,878,28944,379
2021-02-20,Modoc,049,8938,335,328,113,441,3
2021-02-20,Mono,051,14174,1173,1187,15,1202,3
2021-02-20,Monterey,053,433212,41748,41313,1636,42949,309
2021-02-20,Napa,055,140530,8967,8910,31,8941,69
2021-02-20,Nevada,057,99092,3953,3887,156,4043,66
2021-02-20,Orange,059,3164182,245912,243761,10028,253789,3755
2021-02-20,Placer,061,380077,20379,19509,1073,20582,236
2021-02-20,Plumas,063,18699,640,626,10,636,4
2021-02-20,Riverside,065,2383286,284381,277267,13191,290458,3559
2021-02-20,Sacramento,067,1510023,93624,92057,1186,93243,1352
2021-02-20,San Benito,069,59416,5704,5709,84,5793,57
2021-02-20,San Bernardino,071,2135413,285154,279608,8435,288043,3203
2021-02-20,San Diego,073,3302833,262225,256510,12690,269200,3188
2021-02-20,San Francisco,075,870044,33902,33820,1028,34848,399
2021-02-20,San Joaquin,077,732212,66283,64916,2662,67578,1001
2021-02-20,San Luis Obispo,079,281455,19546,19138,539,19677,229
2021-02-20,San Mateo,081,765935,39212,38371,395,38766,282
2021-02-20,Santa Barbara,083,443738,31972,31289,1017,32306,396
2021-02-20,Santa Clara,085,1922200,109388,108728,546,109274,1649
2021-02-20,Santa Cruz,087,273765,15303,14378,759,15137,176
2021-02-20,Shasta,089,179085,10876,10850,1187,12037,146
2021-02-20,Sierra,091,2930,51,47,12,59,0
2021-02-20,Siskiyou,093,43540,1471,1366,220,1586,4
2021-02-20,Solano,095,438530,29629,29440,346,29786,150
2021-02-20,Sonoma,097,501317,27764,27703,189,27892,278
2021-02-20,Stanislaus,099,539301,50221,49445,5209,54654,733
2021-02-20,Sutter,101,95872,8762,8681,77,8758,97
2021-02-20,Tehama,103,63373,4576,4545,480,5025,30
2021-02-20,Trinity,105,12862,464,285,72,357,3
2021-02-20,Tulare,107,460477,47932,46769,7702,54471,739
2021-02-20,Tuolumne,109,53932,3809,3823,35,3858,53
2021-02-20,Ventura,111,848112,77246,76757,2709,79466,671
2021-02-20,Yolo,113,214977,12786,12639,137,12776,183
2021-02-20,Yuba,115,75493,5464,5386,83,5469,38
2021-02-19,Alameda,001,1643700,80102,79318,1667,80985,1047
2021-02-19,Alpine,003,1148,78,77,0,77,0
2021-02-19,Amador,005,37829,3438,3427,29,3456,39
2021-02-19,Butte,007,227075,11256,10823,1574,12397,176
2021-02-19,Calaveras,009,45235,1889,1856,11,1867,21
2021-02-19,Colusa,011,21464,1866,1858,258,2116,11
2021-02-19,Contra Costa,013,1133247,62427,61017,1043,62060,651
2021-02-19,Del Norte,015,27424,987,932,4,936,2
2021-02-19,El Dorado,017,186661,9071,8882,599,9481,96
2021-02-19,Fresno,019,978130,95504,93973,7504,101477,1330
2021-02-19,Glenn,021,27897,2231,2199,482,2681,14
2021-02-19,Humboldt,023,135768,3094,3037,22,3059,29
2021-02-19,Imperial,025,180216,27152,26751,2412,29163,589
2021-02-19,Inyo,027,18085,1271,1212,9,1221,32
2021-02-19,Kern,029,883053,92719,90807,9493,100300,963
2021-02-19,Kings,031,150075,22130,21724,934,22658,211
2021-02-19,Lake,033,64148,3141,3078,6,3084,40
2021-02-19,Lassen,035,31185,5104,5057,92,5149,1
2021-02-19,Los Angeles,037,10098052,1167701,1143828,38164,1181992,19498
2021-02-19,Madera,039,155013,15474,15222,795,16017,188
2021-02-19,Marin,041,260295,13078,12919,150,13069,210
2021-02-19,Mariposa,043,17540,376,371,5,376,4
2021-02-19,Mendocino,045,87422,3611,3526,70,3596,39
2021-02-19,Merced,047,269075,28075,27985,875,28860,376
2021-02-19,Modoc,049,8938,335,328,113,441,3
2021-02-19,Mono,051,14174,1173,1186,15,1201,3
2021-02-19,Monterey,053,433212,41721,41209,1632,42841,309
2021-02-19,Napa,055,140530,8954,8899,31,8930,69
2021-02-19,Nevada,057,99092,3947,3863,156,4019,66
2021-02-19,Orange,059,3164182,245736,243397,10016,253413,3715
2021-02-19,Placer,061,380077,20357,19457,1073,20530,236
2021-02-19,Plumas,063,18699,638,624,10,634,4
2021-02-19,Riverside,065,2383286,284212,276941,13174,290115,3541
2021-02-19,Sacramento,067,1510023,93504,91815,1182,92997,1351
2021-02-19,San Benito,069,59416,5699,5699,84,5783,57
2021-02-19,San Bernardino,071,2135413,285018,279209,8430,287639,3117
2021-02-19,San Diego,073,3302833,261934,255799,12667,268466,3169
2021-02-19,San Francisco,075,870044,33854,33746,1022,34768,387
2021-02-19,San Joaquin,077,732212,66207,64774,2654,67428,988
2021-02-19,San Luis Obispo,079,281455,19515,19061,537,19598,230
2021-02-19,San Mateo,081,765935,39154,38256,393,38649,282
2021-02-19,Santa Barbara,083,443738,31908,31204,1016,32220,392
2021-02-19,Santa Clara,085,1922200,109176,108400,544,108944,1634
2021-02-19,Santa Cruz,087,273765,15288,14354,759,15113,176
2021-02-19,Shasta,089,179085,10865,10833,1184,12017,140
2021-02-19,Sierra,091,2930,51,47,12,59,0
2021-02-19,Siskiyou,093,43540,1467,1363,218,1581,4
2021-02-19,Solano,095,438530,29604,29383,345,29728,150
2021-02-19,Sonoma,097,501317,27717,27595,187,27782,280
2021-02-19,Stanislaus,099,539301,50159,49282,5193,54475,739
2021-02-19,Sutter,101,95872,8752,8665,77,8742,96
2021-02-19,Tehama,103,63373,4574,4535,480,5015,30
2021-02-19,Trinity,105,12862,462,282,70,352,3
2021-02-19,Tulare,107,460477,47887,46662,7677,54339,736
2021-02-19,Tuolumne,109,53932,3802,3817,35,3852,52
2021-02-19,Ventura,111,848112,77167,76582,2706,79288,667
2021-02-19,Yolo,113,214977,12770,12606,137,12743,183
2021-02-19,Yuba,115,75493,5454,5376,83,5459,38
2021-02-18,Alameda,001,1643700,79968,79111,1660,80771,1012
2021-02-18,Alpine,003,1148,78,77,0,77,0
2021-02-18,Amador,005,37829,3434,3417,28,3445,38
2021-02-18,Butte,007,227075,11238,10791,1572,12363,175
2021-02-18,Calaveras,009,45235,1884,1873,11,1884,21
2021-02-18,Colusa,011,21464,1864,1856,256,2112,11
2021-02-18,Contra Costa,013,1133247,62313,60868,1041,61909,640
2021-02-18,Del Norte,015,27424,982,929,4,933,2
2021-02-18,El Dorado,017,186661,9056,8850,598,9448,94
2021-02-18,Fresno,019,978130,95334,93734,7479,101213,1323
2021-02-18,Glenn,021,27897,2225,2195,482,2677,14
2021-02-18,Humboldt,023,135768,3082,3023,22,3045,29
2021-02-18,Imperial,025,180216,27126,26731,2405,29136,591
2021-02-18,Inyo,027,18085,1267,1213,8,1221,32
2021-02-18,Kern,029,883053,92565,90655,9463,100118,961
2021-02-18,Kings,031,150075,22106,21648,933,22581,211
2021-02-18,Lake,033,64148,3136,3066,6,3072,40
2021-02-18,Lassen,035,31185,5095,5052,92,5144,1
2021-02-18,Los Angeles,037,10098052,1166747,1141930,38101,1180031,19358
2021-02-18,Madera,039,155013,15452,15175,790,15965,188
2021-02-18,Marin,041,260295,13065,12895,149,13044,209
2021-02-18,Mariposa,043,17540,375,369,5,374,4
2021-02-18,Mendocino,045,87422,3608,3519,69,3588,39
2021-02-18,Merced,047,269075,28026,27870,869,28739,372
2021-02-18,Modoc,049,8938,333,327,112,439,3
2021-02-18,Mono,051,14174,1173,1182,15,1197,3
2021-02-18,Monterey,053,433212,41663,41091,1623,42714,307
2021-02-18,Napa,055,140530,8937,8877,31,8908,68
2021-02-18,Nevada,057,99092,3938,3836,155,3991,66
2021-02-18,Orange,059,3164182,245513,243098,9999,253097,3673
2021-02-18,Placer,061,380077,20330,19429,1072,20501,232
2021-02-18,Plumas,063,18699,638,624,10,634,4
2021-02-18,Riverside,065,2383286,283924,276595,13153,289748,3510
2021-02-18,Sacramento,067,1510023,93342,91476,1176,92652,1334
2021-02-18,San Benito,069,59416,5696,5697,83,5780,58
2021-02-18,San Bernardino,071,2135413,284808,278887,8416,287303,3066
2021-02-18,San Diego,073,3302833,261579,254987,12644,267631,3135
2021-02-18,San Francisco,075,870044,33796,33650,1019,34669,386
2021-02-18,San Joaquin,077,732212,66124,64634,2644,67278,982
2021-02-18,San Luis Obispo,079,281455,19473,18987,534,19521,230
2021-02-18,San Mateo,081,765935,39092,38185,389,38574,282
2021-02-18,Santa Barbara,083,443738,31830,31054,1009,32063,387
2021-02-18,Santa Clara,085,1922200,108951,108210,541,108751,1605
2021-02-18,Santa Cruz,087,273765,15262,14314,759,15073,176
2021-02-18,Shasta,089,179085,10847,10811,1181,11992,139
2021-02-18,Sierra,091,2930,50,47,12,59,0
2021-02-18,Siskiyou,093,43540,1462,1359,217,1576,4
2021-02-18,Solano,095,438530,29578,29349,344,29693,150
2021-02-18,Sonoma,097,501317,27650,27512,186,27698,281
2021-02-18,Stanislaus,099,539301,50059,49150,5176,54326,738
2021-02-18,Sutter,101,95872,8744,8654,77,8731,96
2021-02-18,Tehama,103,63373,4571,4528,480,5008,30
2021-02-18,Trinity,105,12862,461,282,70,352,3
2021-02-18,Tulare,107,460477,47824,46591,7638,54229,728
2021-02-18,Tuolumne,109,53932,3765,3811,35,3846,52
2021-02-18,Ventura,111,848112,77035,76442,2698,79140,659
2021-02-18,Yolo,113,214977,12744,12549,137,12686,183
2021-02-18,Yuba,115,75493,5437,5358,83,5441,38
2021-02-17,Alameda,001,1643700,79806,78895,1658,80553,1002
2021-02-17,Alpine,003,1148,78,77,0,77,0
2021-02-17,Amador,005,37829,3430,3415,28,3443,38
2021-02-17,Butte,007,227075,11220,10770,1568,12338,174
2021-02-17,Calaveras,009,45235,1884,1876,11,1887,21
2021-02-17,Colusa,011,21464,1861,1854,256,2110,10
2021-02-17,Contra Costa,013,1133247,62175,60723,1038,61761,635
2021-02-17,Del Norte,015,27424,975,920,4,924,2
2021-02-17,El Dorado,017,186661,9045,8847,598,9445,94
2021-02-17,Fresno,019,978130,95195,93555,7452,101007,1307
2021-02-17,Glenn,021,27897,2224,2189,481,2670,14
2021-02-17,Humboldt,023,135768,3067,3006,22,3028,29
2021-02-17,Imperial,025,180216,27112,26726,2401,29127,580
2021-02-17,Inyo,027,18085,1259,1197,8,1205,32
2021-02-17,Kern,029,883053,92447,90454,9419,99873,962
2021-02-17,Kings,031,150075,22068,21617,929,22546,211
2021-02-17,Lake,033,64148,3126,3057,2,3059,38
2021-02-17,Lassen,035,31185,5090,5052,91,5143,1
2021-02-17,Los Angeles,037,10098052,1165690,1139786,38039,1177825,19213
2021-02-17,Madera,039,155013,15427,15135,781,15916,177
2021-02-17,Marin,041,260295,13040,12881,149,13030,207
2021-02-17,Mariposa,043,17540,375,368,4,372,4
2021-02-17,Mendocino,045,87422,3606,3494,68,3562,39
2021-02-17,Merced,047,269075,27971,27824,860,28684,372
2021-02-17,Modoc,049,8938,333,327,112,439,3
2021-02-17,Mono,051,14174,1173,1180,15,1195,3
2021-02-17,Monterey,053,433212,41608,41014,1612,42626,304
2021-02-17,Napa,055,140530,8923,8865,31,8896,68
2021-02-17,Nevada,057,99092,3919,3822,152,3974,52
2021-02-17,Orange,059,3164182,245251,242716,9966,252682,3626
2021-02-17,Placer,061,380077,20296,19405,1068,20473,230
2021-02-17,Plumas,063,18699,637,623,10,633,4
2021-02-17,Riverside,065,2383286,283635,276289,13132,289421,3491
2021-02-17,Sacramento,067,1510023,93183,91309,1169,92478,1326
2021-02-17,San Benito,069,59416,5690,5661,83,5744,57
2021-02-17,San Bernardino,071,2135413,284605,278461,8396,286857,3020
2021-02-17,San Diego,073,3302833,261201,254177,12623,266800,3099
2021-02-17,San Francisco,075,870044,33720,33558,1014,34572,379
2021-02-17,San Joaquin,077,732212,66018,64556,2638,67194,979
2021-02-17,San Luis Obispo,079,281455,19428,18964,534,19498,230
2021-02-17,San Mateo,081,765935,39028,38124,389,38513,282
2021-02-17,Santa Barbara,083,443738,31762,30927,1008,31935,384
2021-02-17,Santa Clara,085,1922200,108719,107949,539,108488,1592
2021-02-17,Santa Cruz,087,273765,15229,14268,756,15024,174
2021-02-17,Shasta,089,179085,10827,10770,1180,11950,139
2021-02-17,Sierra,091,2930,50,47,12,59,0
2021-02-17,Siskiyou,093,43540,1456,1352,214,1566,4
2021-02-17,Solano,095,438530,29521,29288,344,29632,149
2021-02-17,Sonoma,097,501317,27578,27408,181,27589,281
2021-02-17,Stanislaus,099,539301,49946,49050,5160,54210,730
2021-02-17,Sutter,101,95872,8734,8681,77,8758,95
2021-02-17,Tehama,103,63373,4568,4511,480,4991,30
2021-02-17,Trinity,105,12862,461,277,68,345,3
2021-02-17,Tulare,107,460477,47759,46495,7613,54108,726
2021-02-17,Tuolumne,109,53932,3756,3806,35,3841,49
2021-02-17,Ventura,111,848112,76913,76234,2692,78926,646
2021-02-17,Yolo,113,214977,12725,12506,135,12641,182
2021-02-17,Yuba,115,75493,5428,5345,83,5428,38
2021-02-16,Alameda,001,1643700,79637,78756,1655,80411,997
2021-02-16,Alpine,003,1148,78,76,0,76,0
2021-02-16,Amador,005,37829,3423,3413,28,3441,39
2021-02-16,Butte,007,227075,11194,10748,1565,12313,164
2021-02-16,Calaveras,009,45235,1882,1872,11,1883,21
2021-02-16,Colusa,011,21464,1858,1852,254,2106,10
2021-02-16,Contra Costa,013,1133247,62024,60564,1033,61597,631
2021-02-16,Del Norte,015,27424,967,913,4,917,2
2021-02-16,El Dorado,017,186661,9035,8836,596,9432,94
2021-02-16,Fresno,019,978130,95030,93363,7422,100785,1293
2021-02-16,Glenn,021,27897,2220,2189,477,2666,14
2021-02-16,Humboldt,023,135768,3044,2994,21,3015,29
2021-02-16,Imperial,025,180216,27099,26711,2397,29108,580
2021-02-16,Inyo,027,18085,1251,1191,8,1199,32
2021-02-16,Kern,029,883053,92315,90267,9389,99656,959
2021-02-16,Kings,031,150075,22022,21583,925,22508,206
2021-02-16,Lake,033,64148,3119,3041,2,3043,38
2021-02-16,Lassen,035,31185,5078,5047,91,5138,1
2021-02-16,Los Angeles,037,10098052,1164437,1138262,37978,1176240,19044
2021-02-16,Madera,039,155013,15389,15120,776,15896,172
2021-02-16,Marin,041,260295,13012,12832,149,12981,205
2021-02-16,Mariposa,043,17540,375,367,4,371,4
2021-02-16,Mendocino,045,87422,3602,3489,68,3557,39
2021-02-16,Merced,047,269075,27890,27724,854,28578,368
2021-02-16,Modoc,049,8938,333,326,112,438,3
2021-02-16,Mono,051,14174,1173,1180,15,1195,3
2021-02-16,Monterey,053,433212,41532,40962,1603,42565,303
2021-02-16,Napa,055,140530,8910,8854,31,8885,66
2021-02-16,Nevada,057,99092,3906,3774,151,3925,47
2021-02-16,Orange,059,3164182,244929,242382,9950,252332,3612
2021-02-16,Placer,061,380077,20263,19367,1065,20432,230
2021-02-16,Plumas,063,18699,637,619,10,629,4
2021-02-16,Riverside,065,2383286,283331,275954,13110,289064,3471
2021-02-16,Sacramento,067,1510023,92929,91246,1163,92409,1305
2021-02-16,San Benito,069,59416,5682,5659,82,5741,56
2021-02-16,San Bernardino,071,2135413,284381,277947,8387,286334,2978
2021-02-16,San Diego,073,3302833,260736,253638,12584,266222,3042
2021-02-16,San Francisco,075,870044,33648,33491,1009,34500,373
2021-02-16,San Joaquin,077,732212,65888,64448,2635,67083,979
2021-02-16,San Luis Obispo,079,281455,19383,18925,531,19456,229
2021-02-16,San Mateo,081,765935,38969,38041,387,38428,277
2021-02-16,Santa Barbara,083,443738,31688,30865,1005,31870,378
2021-02-16,Santa Clara,085,1922200,108467,107754,536,108290,1591
2021-02-16,Santa Cruz,087,273765,15209,14256,755,15011,174
2021-02-16,Shasta,089,179085,10812,10736,1178,11914,139
2021-02-16,Sierra,091,2930,50,47,12,59,0
2021-02-16,Siskiyou,093,43540,1452,1351,214,1565,4
2021-02-16,Solano,095,438530,29483,29246,343,29589,148
2021-02-16,Sonoma,097,501317,27519,27380,175,27555,279
2021-02-16,Stanislaus,099,539301,49822,48927,5146,54073,716
2021-02-16,Sutter,101,95872,8711,8671,77,8748,95
2021-02-16,Tehama,103,63373,4559,4501,478,4979,30
2021-02-16,Trinity,105,12862,457,275,68,343,3
2021-02-16,Tulare,107,460477,47695,46444,7570,54014,716
2021-02-16,Tuolumne,109,53932,3754,3796,35,3831,49
2021-02-16,Ventura,111,848112,76771,76043,2689,78732,631
2021-02-16,Yolo,113,214977,12696,12457,135,12592,175
2021-02-16,Yuba,115,75493,5421,5332,82,5414,38
2021-02-15,Alameda,001,1643700,79441,78647,1644,80291,996
2021-02-15,Alpine,003,1148,78,76,0,76,0
2021-02-15,Amador,005,37829,3419,3409,28,3437,39
2021-02-15,Butte,007,227075,11176,10723,1561,12284,155
2021-02-15,Calaveras,009,45235,1878,1871,11,1882,21
2021-02-15,Colusa,011,21464,1858,1849,250,2099,10
2021-02-15,Contra Costa,013,1133247,61853,60444,1028,61472,631
2021-02-15,Del Norte,015,27424,963,913,4,917,2
2021-02-15,El Dorado,017,186661,9018,8816,596,9412,94
2021-02-15,Fresno,019,978130,94831,93231,7383,100614,1288
2021-02-15,Glenn,021,27897,2218,2185,476,2661,14
2021-02-15,Humboldt,023,135768,3037,2997,21,3018,29
2021-02-15,Imperial,025,180216,27079,26700,2394,29094,580
2021-02-15,Inyo,027,18085,1232,1184,8,1192,32
2021-02-15,Kern,029,883053,92171,90181,9359,99540,959
2021-02-15,Kings,031,150075,21977,21574,921,22495,205
2021-02-15,Lake,033,64148,3105,3030,1,3031,38
2021-02-15,Lassen,035,31185,5076,5047,90,5137,1
2021-02-15,Los Angeles,037,10098052,1163049,1137164,37916,1175080,18925
2021-02-15,Madera,039,155013,15358,15108,774,15882,106
2021-02-15,Marin,041,260295,12991,12810,146,12956,203
2021-02-15,Mariposa,043,17540,373,367,4,371,4
2021-02-15,Mendocino,045,87422,3590,3481,68,3549,39
2021-02-15,Merced,047,269075,27816,27656,847,28503,368
2021-02-15,Modoc,049,8938,333,326,112,438,3
2021-02-15,Mono,051,14174,1170,1178,15,1193,3
2021-02-15,Monterey,053,433212,41468,40911,1591,42502,302
2021-02-15,Napa,055,140530,8896,8837,31,8868,57
2021-02-15,Nevada,057,99092,3889,3767,150,3917,47
2021-02-15,Orange,059,3164182,244610,242176,9922,252098,3586
2021-02-15,Placer,061,380077,20237,19361,1064,20425,230
2021-02-15,Plumas,063,18699,637,620,10,630,4
2021-02-15,Riverside,065,2383286,282978,275771,13091,288862,3468
2021-02-15,Sacramento,067,1510023,92602,91091,1158,92249,1304
2021-02-15,San Benito,069,59416,5676,5649,82,5731,56
2021-02-15,San Bernardino,071,2135413,284130,277869,8379,286248,2945
2021-02-15,San Diego,073,3302833,260223,252940,12553,265493,3037
2021-02-15,San Francisco,075,870044,33575,33454,1003,34457,373
2021-02-15,San Joaquin,077,732212,65723,64382,2628,67010,979
2021-02-15,San Luis Obispo,079,281455,19330,18891,529,19420,227
2021-02-15,San Mateo,081,765935,38890,37969,384,38353,277
2021-02-15,Santa Barbara,083,443738,31585,30810,1002,31812,378
2021-02-15,Santa Clara,085,1922200,108237,107630,534,108164,1588
2021-02-15,Santa Cruz,087,273765,15177,14239,752,14991,175
2021-02-15,Shasta,089,179085,10792,10730,1173,11903,139
2021-02-15,Sierra,091,2930,50,47,12,59,0
2021-02-15,Siskiyou,093,43540,1444,1345,213,1558,4
2021-02-15,Solano,095,438530,29428,29225,343,29568,148
2021-02-15,Sonoma,097,501317,27435,27359,171,27530,276
2021-02-15,Stanislaus,099,539301,49695,48808,5133,53941,716
2021-02-15,Sutter,101,95872,8696,8652,77,8729,95
2021-02-15,Tehama,103,63373,4550,4492,477,4969,30
2021-02-15,Trinity,105,12862,456,274,68,342,3
2021-02-15,Tulare,107,460477,47624,46344,7531,53875,715
2021-02-15,Tuolumne,109,53932,3744,3794,35,3829,49
2021-02-15,Ventura,111,848112,76616,75889,2686,78575,629
2021-02-15,Yolo,113,214977,12661,12412,134,12546,175
2021-02-15,Yuba,115,75493,5404,5320,81,5401,38
2021-02-14,Alameda,001,1643700,79290,78442,1643,80085,995
2021-02-14,Alpine,003,1148,78,76,0,76,0
2021-02-14,Amador,005,37829,3414,3398,28,3426,39
2021-02-14,Butte,007,227075,11152,10717,1558,12275,155
2021-02-14,Calaveras,009,45235,1874,1866,11,1877,21
2021-02-14,Colusa,011,21464,1854,1845,247,2092,10
2021-02-14,Contra Costa,013,1133247,61703,60272,1025,61297,631
2021-02-14,Del Norte,015,27424,959,911,4,915,2
2021-02-14,El Dorado,017,186661,8986,8790,595,9385,94
2021-02-14,Fresno,019,978130,94660,93065,7360,100425,1287
2021-02-14,Glenn,021,27897,2215,2184,476,2660,14
2021-02-14,Humboldt,023,135768,3024,2992,21,3013,29
2021-02-14,Imperial,025,180216,27072,26696,2393,29089,580
2021-02-14,Inyo,027,18085,1226,1177,8,1185,32
2021-02-14,Kern,029,883053,92011,90038,9306,99344,959
2021-02-14,Kings,031,150075,21951,21538,919,22457,205
2021-02-14,Lake,033,64148,3094,3030,1,3031,38
2021-02-14,Lassen,035,31185,5072,5037,90,5127,1
2021-02-14,Los Angeles,037,10098052,1161702,1135450,37834,1173284,18898
2021-02-14,Madera,039,155013,15326,15089,770,15859,106
2021-02-14,Marin,041,260295,12967,12784,146,12930,201
2021-02-14,Mariposa,043,17540,373,365,4,369,4
2021-02-14,Mendocino,045,87422,3584,3475,68,3543,39
2021-02-14,Merced,047,269075,27734,27601,842,28443,368
2021-02-14,Modoc,049,8938,333,326,112,438,3
2021-02-14,Mono,051,14174,1169,1180,15,1195,3
2021-02-14,Monterey,053,433212,41417,40842,1586,42428,302
2021-02-14,Napa,055,140530,8876,8826,31,8857,57
2021-02-14,Nevada,057,99092,3873,3761,150,3911,47
2021-02-14,Orange,059,3164182,244297,241859,9904,251763,3564
2021-02-14,Placer,061,380077,20198,19313,1059,20372,230
2021-02-14,Plumas,063,18699,636,620,10,630,4
2021-02-14,Riverside,065,2383286,282647,275518,13072,288590,3471
2021-02-14,Sacramento,067,1510023,92395,90856,1154,92010,1304
2021-02-14,San Benito,069,59416,5667,5641,81,5722,56
2021-02-14,San Bernardino,071,2135413,283824,277664,8359,286023,2929
2021-02-14,San Diego,073,3302833,259731,252247,12506,264753,3037
2021-02-14,San Francisco,075,870044,33501,33374,995,34369,372
2021-02-14,San Joaquin,077,732212,65625,64243,2614,66857,979
2021-02-14,San Luis Obispo,079,281455,19292,18868,526,19394,225
2021-02-14,San Mateo,081,765935,38805,37859,384,38243,277
2021-02-14,Santa Barbara,083,443738,31493,30744,998,31742,377
2021-02-14,Santa Clara,085,1922200,108038,107412,530,107942,1582
2021-02-14,Santa Cruz,087,273765,15149,14225,747,14972,175
2021-02-14,Shasta,089,179085,10760,10720,1169,11889,139
2021-02-14,Sierra,091,2930,50,47,12,59,0
2021-02-14,Siskiyou,093,43540,1440,1340,213,1553,4
2021-02-14,Solano,095,438530,29386,29150,340,29490,148
2021-02-14,Sonoma,097,501317,27360,27266,169,27435,276
2021-02-14,Stanislaus,099,539301,49585,48672,5118,53790,716
2021-02-14,Sutter,101,95872,8673,8642,77,8719,95
2021-02-14,Tehama,103,63373,4544,4490,474,4964,30
2021-02-14,Trinity,105,12862,456,272,68,340,3
2021-02-14,Tulare,107,460477,47539,46263,7482,53745,715
2021-02-14,Tuolumne,109,53932,3743,3764,35,3799,49
2021-02-14,Ventura,111,848112,76447,75742,2675,78417,629
2021-02-14,Yolo,113,214977,12632,12399,133,12532,175
2021-02-14,Yuba,115,75493,5394,5314,81,5395,38
2021-02-13,Alameda,001,1643700,79168,78246,1640,79886,995
2021-02-13,Alpine,003,1148,78,76,0,76,0
2021-02-13,Amador,005,37829,3411,3387,28,3415,38
2021-02-13,Butte,007,227075,11136,10699,1556,12255,155
2021-02-13,Calaveras,009,45235,1871,1863,11,1874,21
2021-02-13,Colusa,011,21464,1854,1837,247,2084,10
2021-02-13,Contra Costa,013,1133247,61582,60100,1025,61125,629
2021-02-13,Del Norte,015,27424,957,908,4,912,2
2021-02-13,El Dorado,017,186661,8974,8758,594,9352,93
2021-02-13,Fresno,019,978130,94546,92807,7338,100145,1287
2021-02-13,Glenn,021,27897,2214,2182,474,2656,14
2021-02-13,Humboldt,023,135768,3011,2974,20,2994,29
2021-02-13,Imperial,025,180216,27065,26680,2391,29071,580
2021-02-13,Inyo,027,18085,1222,1168,8,1176,32
2021-02-13,Kern,029,883053,91922,89915,9280,99195,957
2021-02-13,Kings,031,150075,21936,21513,917,22430,205
2021-02-13,Lake,033,64148,3085,3025,1,3026,37
2021-02-13,Lassen,035,31185,5069,5028,90,5118,1
2021-02-13,Los Angeles,037,10098052,1160844,1133752,37787,1171539,18822
2021-02-13,Madera,039,155013,15317,15053,766,15819,106
2021-02-13,Marin,041,260295,12943,12757,146,12903,201
2021-02-13,Mariposa,043,17540,373,365,4,369,4
2021-02-13,Mendocino,045,87422,3574,3466,68,3534,38
2021-02-13,Merced,047,269075,27690,27541,839,28380,368
2021-02-13,Modoc,049,8938,333,325,112,437,3
2021-02-13,Mono,051,14174,1169,1176,15,1191,3
2021-02-13,Monterey,053,433212,41385,40731,1585,42316,301
2021-02-13,Napa,055,140530,8867,8809,31,8840,57
2021-02-13,Nevada,057,99092,3864,3742,149,3891,47
2021-02-13,Orange,059,3164182,244091,241545,9885,251430,3520
2021-02-13,Placer,061,380077,20178,19214,1059,20273,230
2021-02-13,Plumas,063,18699,636,616,10,626,4
2021-02-13,Riverside,065,2383286,282418,275276,13063,288339,3462
2021-02-13,Sacramento,067,1510023,92228,90401,1151,91552,1302
2021-02-13,San Benito,069,59416,5650,5633,81,5714,56
2021-02-13,San Bernardino,071,2135413,283672,277405,8346,285751,2899
2021-02-13,San Diego,073,3302833,259399,251679,12494,264173,3009
2021-02-13,San Francisco,075,870044,33451,33291,985,34276,364
2021-02-13,San Joaquin,077,732212,65556,64105,2604,66709,977
2021-02-13,San Luis Obispo,079,281455,19264,18803,520,19323,225
2021-02-13,San Mateo,081,765935,38752,37745,384,38129,277
2021-02-13,Santa Barbara,083,443738,31441,30594,997,31591,374
2021-02-13,Santa Clara,085,1922200,107849,107125,526,107651,1570
2021-02-13,Santa Cruz,087,273765,15122,14198,746,14944,173
2021-02-13,Shasta,089,179085,10747,10713,1164,11877,139
2021-02-13,Sierra,091,2930,50,47,12,59,0
2021-02-13,Siskiyou,093,43540,1437,1336,213,1549,4
2021-02-13,Solano,095,438530,29350,29084,340,29424,148
2021-02-13,Sonoma,097,501317,27312,27157,167,27324,276
2021-02-13,Stanislaus,099,539301,49514,48568,5112,53680,697
2021-02-13,Sutter,101,95872,8661,8626,77,8703,94
2021-02-13,Tehama,103,63373,4534,4484,473,4957,30
2021-02-13,Trinity,105,12862,455,272,67,339,3
2021-02-13,Tulare,107,460477,47488,46162,7451,53613,709
2021-02-13,Tuolumne,109,53932,3742,3752,35,3787,49
2021-02-13,Ventura,111,848112,76307,75481,2669,78150,618
2021-02-13,Yolo,113,214977,12619,12374,132,12506,175
2021-02-13,Yuba,115,75493,5386,5289,81,5370,38
2021-02-12,Alameda,001,1643700,79019,77958,1634,79592,974
2021-02-12,Alpine,003,1148,78,76,0,76,0
2021-02-12,Amador,005,37829,3407,3381,28,3409,38
2021-02-12,Butte,007,227075,11123,10655,1549,12204,155
2021-02-12,Calaveras,009,45235,1868,1860,11,1871,21
2021-02-12,Colusa,011,21464,1854,1836,247,2083,10
2021-02-12,Contra Costa,013,1133247,61432,59878,1021,60899,620
2021-02-12,Del Norte,015,27424,947,901,4,905,2
2021-02-12,El Dorado,017,186661,8959,8725,591,9316,92
2021-02-12,Fresno,019,978130,94392,92520,7318,99838,1273
2021-02-12,Glenn,021,27897,2211,2175,474,2649,14
2021-02-12,Humboldt,023,135768,3003,2961,20,2981,29
2021-02-12,Imperial,025,180216,27057,26646,2388,29034,585
2021-02-12,Inyo,027,18085,1216,1156,8,1164,32
2021-02-12,Kern,029,883053,91808,89532,9248,98780,949
2021-02-12,Kings,031,150075,21904,21462,912,22374,202
2021-02-12,Lake,033,64148,3080,3012,1,3013,36
2021-02-12,Lassen,035,31185,5067,5015,90,5105,1
2021-02-12,Los Angeles,037,10098052,1159635,1131185,37718,1168903,18637
2021-02-12,Madera,039,155013,15290,15022,763,15785,106
2021-02-12,Marin,041,260295,12917,12720,146,12866,200
2021-02-12,Mariposa,043,17540,372,365,4,369,4
2021-02-12,Mendocino,045,87422,3572,3447,68,3515,38
2021-02-12,Merced,047,269075,27639,27453,836,28289,367
2021-02-12,Modoc,049,8938,333,324,112,436,3
2021-02-12,Mono,051,14174,1168,1172,15,1187,3
2021-02-12,Monterey,053,433212,41337,40633,1576,42209,297
2021-02-12,Napa,055,140530,8855,8785,31,8816,55
2021-02-12,Nevada,057,99092,3859,3728,149,3877,47
2021-02-12,Orange,059,3164182,243852,241075,9870,250945,3505
2021-02-12,Placer,061,380077,20136,19174,1054,20228,230
2021-02-12,Plumas,063,18699,635,614,10,624,4
2021-02-12,Riverside,065,2383286,282140,274792,13048,287840,3438
2021-02-12,Sacramento,067,1510023,92026,90252,1150,91402,1295
2021-02-12,San Benito,069,59416,5634,5622,80,5702,56
2021-02-12,San Bernardino,071,2135413,283482,276890,8335,285225,2827
2021-02-12,San Diego,073,3302833,259011,250788,12468,263256,2979
2021-02-12,San Francisco,075,870044,33391,33179,981,34160,359
2021-02-12,San Joaquin,077,732212,65460,63966,2596,66562,975
2021-02-12,San Luis Obispo,079,281455,19223,18687,519,19206,224
2021-02-12,San Mateo,081,765935,38680,37560,384,37944,254
2021-02-12,Santa Barbara,083,443738,31370,30454,992,31446,372
2021-02-12,Santa Clara,085,1922200,107677,106759,523,107282,1543
2021-02-12,Santa Cruz,087,273765,15102,14147,746,14893,170
2021-02-12,Shasta,089,179085,10729,10693,1154,11847,142
2021-02-12,Sierra,091,2930,49,45,12,57,0
2021-02-12,Siskiyou,093,43540,1433,1324,210,1534,4
2021-02-12,Solano,095,438530,29318,28996,337,29333,147
2021-02-12,Sonoma,097,501317,27257,27064,163,27227,275
2021-02-12,Stanislaus,099,539301,49426,48418,5090,53508,697
2021-02-12,Sutter,101,95872,8648,8609,77,8686,93
2021-02-12,Tehama,103,63373,4527,4470,472,4942,27
2021-02-12,Trinity,105,12862,455,269,67,336,3
2021-02-12,Tulare,107,460477,47410,46016,7425,53441,710
2021-02-12,Tuolumne,109,53932,3739,3736,34,3770,49
2021-02-12,Ventura,111,848112,76137,75210,2663,77873,605
2021-02-12,Yolo,113,214977,12598,12340,132,12472,175
2021-02-12,Yuba,115,75493,5378,5274,81,5355,38
2021-02-11,Alameda,001,1643700,78790,77564,1629,79193,960
2021-02-11,Alpine,003,1148,77,76,0,76,0
2021-02-11,Amador,005,37829,3403,3368,28,3396,35
2021-02-11,Butte,007,227075,11100,10624,1548,12172,155
2021-02-11,Calaveras,009,45235,1865,1856,11,1867,21
2021-02-11,Colusa,011,21464,1849,1823,245,2068,10
2021-02-11,Contra Costa,013,1133247,61265,59633,1017,60650,605
2021-02-11,Del Norte,015,27424,942,894,4,898,2
2021-02-11,El Dorado,017,186661,8938,8698,591,9289,92
2021-02-11,Fresno,019,978130,94239,92168,7295,99463,1255
2021-02-11,Glenn,021,27897,2206,2166,473,2639,14
2021-02-11,Humboldt,023,135768,2990,2954,19,2973,29
2021-02-11,Imperial,025,180216,27033,26545,2386,28931,578
2021-02-11,Inyo,027,18085,1207,1144,8,1152,32
2021-02-11,Kern,029,883053,91617,89224,9205,98429,941
2021-02-11,Kings,031,150075,21874,21373,909,22282,202
2021-02-11,Lake,033,64148,3070,3002,1,3003,36
2021-02-11,Lassen,035,31185,5056,5004,87,5091,1
2021-02-11,Los Angeles,037,10098052,1158006,1128437,37650,1166087,18500
2021-02-11,Madera,039,155013,15269,14984,761,15745,106
2021-02-11,Marin,041,260295,12880,12682,146,12828,200
2021-02-11,Mariposa,043,17540,372,361,4,365,4
2021-02-11,Mendocino,045,87422,3565,3420,68,3488,38
2021-02-11,Merced,047,269075,27573,27325,832,28157,363
2021-02-11,Modoc,049,8938,332,317,112,429,3
2021-02-11,Mono,051,14174,1164,1173,15,1188,3
2021-02-11,Monterey,053,433212,41231,40469,1570,42039,295
2021-02-11,Napa,055,140530,8834,8777,31,8808,55
2021-02-11,Nevada,057,99092,3843,3720,149,3869,47
2021-02-11,Orange,059,3164182,243485,240590,9846,250436,3476
2021-02-11,Placer,061,380077,20096,19118,1053,20171,224
2021-02-11,Plumas,063,18699,634,592,10,602,4
2021-02-11,Riverside,065,2383286,281774,274313,13033,287346,3394
2021-02-11,Sacramento,067,1510023,91783,89988,1144,91132,1286
2021-02-11,San Benito,069,59416,5625,5609,80,5689,56
2021-02-11,San Bernardino,071,2135413,283184,276349,8321,284670,2774
2021-02-11,San Diego,073,3302833,258458,249971,12434,262405,2955
2021-02-11,San Francisco,075,870044,33307,33076,972,34048,356
2021-02-11,San Joaquin,077,732212,65292,63719,2586,66305,971
2021-02-11,San Luis Obispo,079,281455,19158,18615,515,19130,219
2021-02-11,San Mateo,081,765935,38589,37439,382,37821,253
2021-02-11,Santa Barbara,083,443738,31272,30375,987,31362,370
2021-02-11,Santa Clara,085,1922200,107417,106392,518,106910,1507
2021-02-11,Santa Cruz,087,273765,15079,14088,741,14829,165
2021-02-11,Shasta,089,179085,10705,10672,1150,11822,140
2021-02-11,Sierra,091,2930,49,45,12,57,0
2021-02-11,Siskiyou,093,43540,1418,1320,210,1530,4
2021-02-11,Solano,095,438530,29265,28885,337,29222,138
2021-02-11,Sonoma,097,501317,27172,26971,160,27131,272
2021-02-11,Stanislaus,099,539301,49281,48205,5078,53283,697
2021-02-11,Sutter,101,95872,8634,8590,76,8666,93
2021-02-11,Tehama,103,63373,4521,4463,472,4935,26
2021-02-11,Trinity,105,12862,455,269,67,336,3
2021-02-11,Tulare,107,460477,47315,45897,7385,53282,706
2021-02-11,Tuolumne,109,53932,3702,3716,34,3750,48
2021-02-11,Ventura,111,848112,75935,74959,2654,77613,590
2021-02-11,Yolo,113,214977,12574,12303,132,12435,173
2021-02-11,Yuba,115,75493,5364,5261,80,5341,38
2021-02-10,Alameda,001,1643700,78588,77344,1628,78972,944
2021-02-10,Alpine,003,1148,77,76,0,76,0
2021-02-10,Amador,005,37829,3391,3348,28,3376,35
2021-02-10,Butte,007,227075,11072,10594,1547,12141,155
2021-02-10,Calaveras,009,45235,1863,1850,11,1861,21
2021-02-10,Colusa,011,21464,1842,1815,243,2058,10
2021-02-10,Contra Costa,013,1133247,61090,59488,1015,60503,590
2021-02-10,Del Norte,015,27424,936,888,4,892,2
2021-02-10,El Dorado,017,186661,8907,8682,587,9269,87
2021-02-10,Fresno,019,978130,94064,91876,7270,99146,1247
2021-02-10,Glenn,021,27897,2202,2160,471,2631,14
2021-02-10,Humboldt,023,135768,2982,2924,19,2943,29
2021-02-10,Imperial,025,180216,26995,26522,2383,28905,578
2021-02-10,Inyo,027,18085,1195,1138,8,1146,30
2021-02-10,Kern,029,883053,91411,88933,9151,98084,926
2021-02-10,Kings,031,150075,21831,21294,907,22201,197
2021-02-10,Lake,033,64148,3057,2975,1,2976,36
2021-02-10,Lassen,035,31185,5052,4993,87,5080,1
2021-02-10,Los Angeles,037,10098052,1156259,1125437,37522,1162959,18338
2021-02-10,Madera,039,155013,15230,14925,759,15684,105
2021-02-10,Marin,041,260295,12843,12651,146,12797,199
2021-02-10,Mariposa,043,17540,370,360,4,364,4
2021-02-10,Mendocino,045,87422,3550,3395,68,3463,38
2021-02-10,Merced,047,269075,27490,27246,821,28067,359
2021-02-10,Modoc,049,8938,331,315,110,425,3
2021-02-10,Mono,051,14174,1159,1170,15,1185,3
2021-02-10,Monterey,053,433212,41154,40366,1556,41922,288
2021-02-10,Napa,055,140530,8815,8769,31,8800,55
2021-02-10,Nevada,057,99092,3828,3693,147,3840,47
2021-02-10,Orange,059,3164182,243068,239974,9815,249789,3439
2021-02-10,Placer,061,380077,20057,19062,1048,20110,220
2021-02-10,Plumas,063,18699,631,589,10,599,2
2021-02-10,Riverside,065,2383286,281347,273721,13023,286744,3374
2021-02-10,Sacramento,067,1510023,91532,89653,1140,90793,1275
2021-02-10,San Benito,069,59416,5611,5591,80,5671,55
2021-02-10,San Bernardino,071,2135413,282829,275616,8305,283921,2696
2021-02-10,San Diego,073,3302833,257876,248858,12396,261254,2904
2021-02-10,San Francisco,075,870044,33224,32955,969,33924,351
2021-02-10,San Joaquin,077,732212,65150,63484,2572,66056,954
2021-02-10,San Luis Obispo,079,281455,19079,18549,513,19062,216
2021-02-10,San Mateo,081,765935,38498,37323,382,37705,245
2021-02-10,Santa Barbara,083,443738,31181,30216,982,31198,359
2021-02-10,Santa Clara,085,1922200,107177,106048,515,106563,1489
2021-02-10,Santa Cruz,087,273765,15043,14007,739,14746,165
2021-02-10,Shasta,089,179085,10682,10645,1147,11792,142
2021-02-10,Sierra,091,2930,49,45,12,57,0
2021-02-10,Siskiyou,093,43540,1413,1314,209,1523,4
2021-02-10,Solano,095,438530,29190,28835,335,29170,137
2021-02-10,Sonoma,097,501317,27076,26881,158,27039,271
2021-02-10,Stanislaus,099,539301,49164,48016,5062,53078,696
2021-02-10,Sutter,101,95872,8617,8571,76,8647,93
2021-02-10,Tehama,103,63373,4513,4445,472,4917,23
2021-02-10,Trinity,105,12862,452,268,67,335,3
2021-02-10,Tulare,107,460477,47198,45782,7347,53129,696
2021-02-10,Tuolumne,109,53932,3694,3691,34,3725,48
2021-02-10,Ventura,111,848112,75707,74651,2637,77288,580
2021-02-10,Yolo,113,214977,12550,12276,132,12408,174
2021-02-10,Yuba,115,75493,5346,5241,80,5321,38
2021-02-09,Alameda,001,1643700,78325,77018,1624,78642,936
2021-02-09,Alpine,003,1148,77,76,0,76,0
2021-02-09,Amador,005,37829,3383,3347,28,3375,35
2021-02-09,Butte,007,227075,11046,10563,1544,12107,153
2021-02-09,Calaveras,009,45235,1859,1847,11,1858,21
2021-02-09,Colusa,011,21464,1833,1812,238,2050,10
2021-02-09,Contra Costa,013,1133247,60900,59307,1009,60316,583
2021-02-09,Del Norte,015,27424,930,886,4,890,2
2021-02-09,El Dorado,017,186661,8879,8663,585,9248,87
2021-02-09,Fresno,019,978130,93822,91730,7242,98972,1211
2021-02-09,Glenn,021,27897,2198,2156,471,2627,14
2021-02-09,Humboldt,023,135768,2974,2904,19,2923,29
2021-02-09,Imperial,025,180216,26964,26509,2380,28889,568
2021-02-09,Inyo,027,18085,1187,1137,8,1145,30
2021-02-09,Kern,029,883053,91159,88684,9105,97789,920
2021-02-09,Kings,031,150075,21789,21275,905,22180,196
2021-02-09,Lake,033,64148,3046,2955,1,2956,36
2021-02-09,Lassen,035,31185,5045,4983,87,5070,1
2021-02-09,Los Angeles,037,10098052,1154281,1122745,37439,1160184,18198
2021-02-09,Madera,039,155013,15210,14912,756,15668,105
2021-02-09,Marin,041,260295,12810,12623,145,12768,197
2021-02-09,Mariposa,043,17540,368,355,4,359,4
2021-02-09,Mendocino,045,87422,3532,3369,68,3437,38
2021-02-09,Merced,047,269075,27392,27166,816,27982,354
2021-02-09,Modoc,049,8938,330,316,110,426,3
2021-02-09,Mono,051,14174,1158,1167,15,1182,3
2021-02-09,Monterey,053,433212,41046,40279,1543,41822,285
2021-02-09,Napa,055,140530,8802,8749,31,8780,55
2021-02-09,Nevada,057,99092,3812,3687,147,3834,44
2021-02-09,Orange,059,3164182,242656,239169,9784,248953,3406
2021-02-09,Placer,061,380077,19992,19008,1041,20049,220
2021-02-09,Plumas,063,18699,631,584,10,594,2
2021-02-09,Riverside,065,2383286,280853,273465,13006,286471,3334
2021-02-09,Sacramento,067,1510023,91222,89378,1139,90517,1265
2021-02-09,San Benito,069,59416,5599,5566,79,5645,54
2021-02-09,San Bernardino,071,2135413,282456,274998,8292,283290,2613
2021-02-09,San Diego,073,3302833,257218,248048,12353,260401,2853
2021-02-09,San Francisco,075,870044,33145,32782,959,33741,349
2021-02-09,San Joaquin,077,732212,64975,63341,2567,65908,937
2021-02-09,San Luis Obispo,079,281455,19020,18489,512,19001,216
2021-02-09,San Mateo,081,765935,38367,37227,381,37608,235
2021-02-09,Santa Barbara,083,443738,31069,30118,976,31094,351
2021-02-09,Santa Clara,085,1922200,106871,105762,512,106274,1463
2021-02-09,Santa Cruz,087,273765,14992,13958,734,14692,162
2021-02-09,Shasta,089,179085,10654,10595,1145,11740,139
2021-02-09,Sierra,091,2930,49,44,12,56,0
2021-02-09,Siskiyou,093,43540,1405,1306,207,1513,4
2021-02-09,Solano,095,438530,29111,28769,332,29101,131
2021-02-09,Sonoma,097,501317,26986,26826,156,26982,267
2021-02-09,Stanislaus,099,539301,49004,47906,5047,52953,679
2021-02-09,Sutter,101,95872,8601,8541,76,8617,92
2021-02-09,Tehama,103,63373,4506,4416,471,4887,22
2021-02-09,Trinity,105,12862,452,266,67,333,3
2021-02-09,Tulare,107,460477,47064,45704,7295,52999,686
2021-02-09,Tuolumne,109,53932,3675,3673,34,3707,48
2021-02-09,Ventura,111,848112,75455,74333,2629,76962,567
2021-02-09,Yolo,113,214977,12508,12220,132,12352,174
2021-02-09,Yuba,115,75493,5337,5235,80,5315,35
2021-02-08,Alameda,001,1643700,78063,76735,1619,78354,924
2021-02-08,Alpine,003,1148,77,73,0,73,0
2021-02-08,Amador,005,37829,3376,3344,27,3371,33
2021-02-08,Butte,007,227075,11024,10524,1540,12064,152
2021-02-08,Calaveras,009,45235,1858,1840,11,1851,21
2021-02-08,Colusa,011,21464,1825,1802,234,2036,10
2021-02-08,Contra Costa,013,1133247,60689,59039,1007,60046,567
2021-02-08,Del Norte,015,27424,927,885,4,889,2
2021-02-08,El Dorado,017,186661,8847,8627,582,9209,86
2021-02-08,Fresno,019,978130,93609,91430,7216,98646,1207
2021-02-08,Glenn,021,27897,2194,2148,469,2617,14
2021-02-08,Humboldt,023,135768,2966,2902,19,2921,29
2021-02-08,Imperial,025,180216,26942,26526,2378,28904,567
2021-02-08,Inyo,027,18085,1174,1126,8,1134,30
2021-02-08,Kern,029,883053,90942,88380,9045,97425,920
2021-02-08,Kings,031,150075,21727,21232,902,22134,195
2021-02-08,Lake,033,64148,3027,2949,1,2950,36
2021-02-08,Lassen,035,31185,5032,4976,87,5063,1
2021-02-08,Los Angeles,037,10098052,1152183,1120179,37319,1157498,17977
2021-02-08,Madera,039,155013,15174,14887,749,15636,93
2021-02-08,Marin,041,260295,12780,12591,145,12736,194
2021-02-08,Mariposa,043,17540,368,355,4,359,4
2021-02-08,Mendocino,045,87422,3518,3355,68,3423,38
2021-02-08,Merced,047,269075,27309,27082,811,27893,346
2021-02-08,Modoc,049,8938,328,318,110,428,3
2021-02-08,Mono,051,14174,1158,1165,15,1180,3
2021-02-08,Monterey,053,433212,40926,40186,1524,41710,283
2021-02-08,Napa,055,140530,8787,8719,31,8750,55
2021-02-08,Nevada,057,99092,3800,3671,147,3818,44
2021-02-08,Orange,059,3164182,242189,238715,9761,248476,3361
2021-02-08,Placer,061,380077,19950,18944,1035,19979,211
2021-02-08,Plumas,063,18699,630,584,10,594,2
2021-02-08,Riverside,065,2383286,280285,272904,12980,285884,3301
2021-02-08,Sacramento,067,1510023,90936,89267,1136,90403,1247
2021-02-08,San Benito,069,59416,5594,5553,78,5631,52
2021-02-08,San Bernardino,071,2135413,282053,274661,8286,282947,2587
2021-02-08,San Diego,073,3302833,256475,247259,12312,259571,2821
2021-02-08,San Francisco,075,870044,33051,32679,951,33630,348
2021-02-08,San Joaquin,077,732212,64814,63148,2557,65705,929
2021-02-08,San Luis Obispo,079,281455,18963,18421,507,18928,214
2021-02-08,San Mateo,081,765935,38258,37084,381,37465,232
2021-02-08,Santa Barbara,083,443738,30954,29978,969,30947,340
2021-02-08,Santa Clara,085,1922200,106548,105413,504,105917,1456
2021-02-08,Santa Cruz,087,273765,14953,13921,728,14649,161
2021-02-08,Shasta,089,179085,10627,10574,1139,11713,137
2021-02-08,Sierra,091,2930,49,44,12,56,0
2021-02-08,Siskiyou,093,43540,1402,1303,207,1510,4
2021-02-08,Solano,095,438530,29045,28644,330,28974,130
2021-02-08,Sonoma,097,501317,26895,26760,155,26915,259
2021-02-08,Stanislaus,099,539301,48849,47704,5019,52723,679
2021-02-08,Sutter,101,95872,8582,8526,76,8602,92
2021-02-08,Tehama,103,63373,4496,4403,468,4871,22
2021-02-08,Trinity,105,12862,450,266,67,333,3
2021-02-08,Tulare,107,460477,46956,45617,7255,52872,673
2021-02-08,Tuolumne,109,53932,3667,3647,34,3681,48
2021-02-08,Ventura,111,848112,75198,74068,2624,76692,565
2021-02-08,Yolo,113,214977,12476,12169,131,12300,162
2021-02-08,Yuba,115,75493,5321,5215,80,5295,35
2021-02-07,Alameda,001,1643700,77762,76500,1611,78111,924
2021-02-07,Alpine,003,1148,74,72,0,72,0
2021-02-07,Amador,005,37829,3355,3343,27,3370,33
2021-02-07,Butte,007,227075,10992,10513,1532,12045,152
2021-02-07,Calaveras,009,45235,1854,1837,11,1848,21
2021-02-07,Colusa,011,21464,1814,1795,232,2027,10
2021-02-07,Contra Costa,013,1133247,60445,58836,1002,59838,566
2021-02-07,Del Norte,015,27424,923,881,4,885,2
2021-02-07,El Dorado,017,186661,8818,8596,580,9176,86
2021-02-07,Fresno,019,978130,93379,91184,7178,98362,1207
2021-02-07,Glenn,021,27897,2190,2141,464,2605,14
2021-02-07,Humboldt,023,135768,2945,2895,19,2914,28
2021-02-07,Imperial,025,180216,26915,26518,2373,28891,567
2021-02-07,Inyo,027,18085,1163,1124,8,1132,27
2021-02-07,Kern,029,883053,90695,88146,8987,97133,920
2021-02-07,Kings,031,150075,21666,21180,899,22079,192
2021-02-07,Lake,033,64148,3012,2940,1,2941,36
2021-02-07,Lassen,035,31185,5021,4973,87,5060,1
2021-02-07,Los Angeles,037,10098052,1149426,1117551,37192,1154743,17889
2021-02-07,Madera,039,155013,15140,14850,745,15595,93
2021-02-07,Marin,041,260295,12747,12571,143,12714,194
2021-02-07,Mariposa,043,17540,367,355,4,359,4
2021-02-07,Mendocino,045,87422,3501,3348,68,3416,38
2021-02-07,Merced,047,269075,27197,26977,799,27776,346
2021-02-07,Modoc,049,8938,328,317,106,423,3
2021-02-07,Mono,051,14174,1155,1165,15,1180,3
2021-02-07,Monterey,053,433212,40790,40113,1505,41618,283
2021-02-07,Napa,055,140530,8764,8701,31,8732,55
2021-02-07,Nevada,057,99092,3789,3643,147,3790,44
2021-02-07,Orange,059,3164182,241591,238155,9728,247883,3336
2021-02-07,Placer,061,380077,19903,18903,1022,19925,211
2021-02-07,Plumas,063,18699,630,584,10,594,2
2021-02-07,Riverside,065,2383286,279757,272301,12959,285260,3267
2021-02-07,Sacramento,067,1510023,90603,88919,1129,90048,1246
2021-02-07,San Benito,069,59416,5575,5548,77,5625,52
2021-02-07,San Bernardino,071,2135413,281460,274316,8261,282577,2587
2021-02-07,San Diego,073,3302833,255689,246561,12248,258809,2821
2021-02-07,San Francisco,075,870044,32931,32609,939,33548,348
2021-02-07,San Joaquin,077,732212,64540,63051,2543,65594,929
2021-02-07,San Luis Obispo,079,281455,18891,18349,500,18849,214
2021-02-07,San Mateo,081,765935,38124,36984,379,37363,232
2021-02-07,Santa Barbara,083,443738,30814,29815,958,30773,340
2021-02-07,Santa Clara,085,1922200,106209,105118,494,105612,1450
2021-02-07,Santa Cruz,087,273765,14899,13887,723,14610,161
2021-02-07,Shasta,089,179085,10607,10570,1131,11701,137
2021-02-07,Sierra,091,2930,49,43,12,55,0
2021-02-07,Siskiyou,093,43540,1395,1295,205,1500,4
2021-02-07,Solano,095,438530,28934,28567,329,28896,130
2021-02-07,Sonoma,097,501317,26788,26684,151,26835,257
2021-02-07,Stanislaus,099,539301,48659,47551,4987,52538,679
2021-02-07,Sutter,101,95872,8554,8515,76,8591,92
2021-02-07,Tehama,103,63373,4480,4396,467,4863,22
2021-02-07,Trinity,105,12862,447,264,65,329,3
2021-02-07,Tulare,107,460477,46834,45520,7177,52697,671
2021-02-07,Tuolumne,109,53932,3643,3619,33,3652,48
2021-02-07,Ventura,111,848112,74887,73759,2612,76371,561
2021-02-07,Yolo,113,214977,12431,12135,131,12266,162
2021-02-07,Yuba,115,75493,5306,5198,78,5276,35
2021-02-06,Alameda,001,1643700,77608,76170,1600,77770,922
2021-02-06,Alpine,003,1148,74,72,0,72,0
2021-02-06,Amador,005,37829,3349,3306,27,3333,33
2021-02-06,Butte,007,227075,10975,10480,1528,12008,150
2021-02-06,Calaveras,009,45235,1852,1832,11,1843,21
2021-02-06,Colusa,011,21464,1812,1791,231,2022,10
2021-02-06,Contra Costa,013,1133247,60298,58567,996,59563,566
2021-02-06,Del Norte,015,27424,919,879,4,883,2
2021-02-06,El Dorado,017,186661,8811,8575,576,9151,86
2021-02-06,Fresno,019,978130,93266,90944,7157,98101,1207
2021-02-06,Glenn,021,27897,2188,2136,463,2599,14
2021-02-06,Humboldt,023,135768,2934,2880,19,2899,28
2021-02-06,Imperial,025,180216,26903,26514,2372,28886,567
2021-02-06,Inyo,027,18085,1160,1113,8,1121,27
2021-02-06,Kern,029,883053,90541,87919,8941,96860,912
2021-02-06,Kings,031,150075,21636,21156,899,22055,190
2021-02-06,Lake,033,64148,3007,2920,1,2921,34
2021-02-06,Lassen,035,31185,5017,4964,86,5050,1
2021-02-06,Los Angeles,037,10098052,1148069,1114718,37095,1151813,17793
2021-02-06,Madera,039,155013,15119,14807,743,15550,93
2021-02-06,Marin,041,260295,12727,12531,143,12674,194
2021-02-06,Mariposa,043,17540,366,355,3,358,4
2021-02-06,Mendocino,045,87422,3483,3316,67,3383,38
2021-02-06,Merced,047,269075,27111,26881,791,27672,346
2021-02-06,Modoc,049,8938,328,313,106,419,3
2021-02-06,Mono,051,14174,1154,1159,15,1174,3
2021-02-06,Monterey,053,433212,40732,39995,1497,41492,282
2021-02-06,Napa,055,140530,8751,8639,31,8670,55
2021-02-06,Nevada,057,99092,3777,3624,147,3771,43
2021-02-06,Orange,059,3164182,241228,237391,9694,247085,3293
2021-02-06,Placer,061,380077,19866,18836,1019,19855,211
2021-02-06,Plumas,063,18699,630,584,10,594,2
2021-02-06,Riverside,065,2383286,279388,271741,12940,284681,3243
2021-02-06,Sacramento,067,1510023,90386,88532,1119,89651,1237
2021-02-06,San Benito,069,59416,5557,5516,77,5593,52
2021-02-06,San Bernardino,071,2135413,281151,273718,8239,281957,2564
2021-02-06,San Diego,073,3302833,255193,245331,12213,257544,2812
2021-02-06,San Francisco,075,870044,32857,32437,929,33366,346
2021-02-06,San Joaquin,077,732212,64461,62840,2532,65372,906
2021-02-06,San Luis Obispo,079,281455,18849,18284,496,18780,214
2021-02-06,San Mateo,081,765935,38056,36824,376,37200,232
2021-02-06,Santa Barbara,083,443738,30738,29645,956,30601,337
2021-02-06,Santa Clara,085,1922200,105987,104639,489,105128,1439
2021-02-06,Santa Cruz,087,273765,14868,13845,719,14564,161
2021-02-06,Shasta,089,179085,10596,10561,1129,11690,137
2021-02-06,Sierra,091,2930,49,43,12,55,0
2021-02-06,Siskiyou,093,43540,1392,1289,204,1493,4
2021-02-06,Solano,095,438530,28898,28446,328,28774,129
2021-02-06,Sonoma,097,501317,26751,26564,149,26713,257
2021-02-06,Stanislaus,099,539301,48563,47325,4972,52297,679
2021-02-06,Sutter,101,95872,8546,8485,76,8561,92
2021-02-06,Tehama,103,63373,4470,4380,466,4846,22
2021-02-06,Trinity,105,12862,447,263,65,328,3
2021-02-06,Tulare,107,460477,46766,45349,7132,52481,664
2021-02-06,Tuolumne,109,53932,3636,3612,33,3645,48
2021-02-06,Ventura,111,848112,74707,73431,2606,76037,552
2021-02-06,Yolo,113,214977,12408,12061,131,12192,161
2021-02-06,Yuba,115,75493,5296,5177,77,5254,35
2021-02-05,Alameda,001,1643700,77379,75716,1598,77314,916
2021-02-05,Alpine,003,1148,74,72,0,72,0
2021-02-05,Amador,005,37829,3344,3299,26,3325,33
2021-02-05,Butte,007,227075,10956,10421,1521,11942,150
2021-02-05,Calaveras,009,45235,1848,1818,11,1829,21
2021-02-05,Colusa,011,21464,1808,1785,231,2016,10
2021-02-05,Contra Costa,013,1133247,60137,58195,994,59189,560
2021-02-05,Del Norte,015,27424,918,874,4,878,2
2021-02-05,El Dorado,017,186661,8791,8527,574,9101,86
2021-02-05,Fresno,019,978130,93064,90513,7136,97649,1194
2021-02-05,Glenn,021,27897,2185,2122,458,2580,14
2021-02-05,Humboldt,023,135768,2924,2857,19,2876,28
2021-02-05,Imperial,025,180216,26884,26474,2371,28845,557
2021-02-05,Inyo,027,18085,1156,1104,8,1112,27
2021-02-05,Kern,029,883053,90372,87470,8875,96345,906
2021-02-05,Kings,031,150075,21598,21021,896,21917,190
2021-02-05,Lake,033,64148,2995,2906,1,2907,33
2021-02-05,Lassen,035,31185,5013,4936,86,5022,1
2021-02-05,Los Angeles,037,10098052,1145970,1110384,36963,1147347,17608
2021-02-05,Madera,039,155013,15085,14752,738,15490,95
2021-02-05,Marin,041,260295,12692,12479,143,12622,193
2021-02-05,Mariposa,043,17540,366,352,3,355,4
2021-02-05,Mendocino,045,87422,3469,3272,67,3339,38
2021-02-05,Merced,047,269075,27051,26760,790,27550,345
2021-02-05,Modoc,049,8938,328,312,106,418,3
2021-02-05,Mono,051,14174,1153,1157,15,1172,3
2021-02-05,Monterey,053,433212,40665,39840,1486,41326,281
2021-02-05,Napa,055,140530,8737,8598,31,8629,55
2021-02-05,Nevada,057,99092,3774,3607,147,3754,43
2021-02-05,Orange,059,3164182,240801,236335,9667,246002,3260
2021-02-05,Placer,061,380077,19830,18756,1017,19773,211
2021-02-05,Plumas,063,18699,628,578,10,588,2
2021-02-05,Riverside,065,2383286,278974,270666,12921,283587,3235
2021-02-05,Sacramento,067,1510023,90206,87992,1112,89104,1231
2021-02-05,San Benito,069,59416,5546,5502,77,5579,51
2021-02-05,San Bernardino,071,2135413,280806,272938,8222,281160,2495
2021-02-05,San Diego,073,3302833,254617,244066,12178,256244,2777
2021-02-05,San Francisco,075,870044,32767,32229,918,33147,337
2021-02-05,San Joaquin,077,732212,64312,62565,2524,65089,902
2021-02-05,San Luis Obispo,079,281455,18788,18152,492,18644,213
2021-02-05,San Mateo,081,765935,37973,36582,375,36957,227
2021-02-05,Santa Barbara,083,443738,30641,29455,943,30398,334
2021-02-05,Santa Clara,085,1922200,105739,104112,487,104599,1421
2021-02-05,Santa Cruz,087,273765,14847,13776,717,14493,161
2021-02-05,Shasta,089,179085,10580,10507,1122,11629,136
2021-02-05,Sierra,091,2930,49,42,12,54,0
2021-02-05,Siskiyou,093,43540,1385,1276,202,1478,4
2021-02-05,Solano,095,438530,28848,28283,328,28611,127
2021-02-05,Sonoma,097,501317,26682,26423,146,26569,252
2021-02-05,Stanislaus,099,539301,48418,47024,4954,51978,678
2021-02-05,Sutter,101,95872,8526,8443,76,8519,92
2021-02-05,Tehama,103,63373,4461,4355,465,4820,22
2021-02-05,Trinity,105,12862,446,260,65,325,3
2021-02-05,Tulare,107,460477,46690,45138,7084,52222,663
2021-02-05,Tuolumne,109,53932,3610,3595,33,3628,45
2021-02-05,Ventura,111,848112,74462,72953,2594,75547,546
2021-02-05,Yolo,113,214977,12389,12025,128,12153,162
2021-02-05,Yuba,115,75493,5279,5145,77,5222,35
2021-02-04,Alameda,001,1643700,77094,75422,1592,77014,899
2021-02-04,Alpine,003,1148,73,72,0,72,0
2021-02-04,Amador,005,37829,3341,3288,26,3314,33
2021-02-04,Butte,007,227075,10923,10386,1513,11899,147
2021-02-04,Calaveras,009,45235,1846,1808,11,1819,21
2021-02-04,Colusa,011,21464,1804,1777,229,2006,10
2021-02-04,Contra Costa,013,1133247,59950,57991,990,58981,550
2021-02-04,Del Norte,015,27424,912,870,4,874,2
2021-02-04,El Dorado,017,186661,8765,8490,571,9061,86
2021-02-04,Fresno,019,978130,92849,90126,7109,97235,1114
2021-02-04,Glenn,021,27897,2180,2102,457,2559,14
2021-02-04,Humboldt,023,135768,2914,2827,19,2846,28
2021-02-04,Imperial,025,180216,26839,26411,2369,28780,556
2021-02-04,Inyo,027,18085,1144,1084,8,1092,27
2021-02-04,Kern,029,883053,90098,87156,8798,95954,898
2021-02-04,Kings,031,150075,21548,20918,890,21808,187
2021-02-04,Lake,033,64148,2983,2882,1,2883,34
2021-02-04,Lassen,035,31185,5010,4927,86,5013,1
2021-02-04,Los Angeles,037,10098052,1143171,1106323,36839,1143162,17396
2021-02-04,Madera,039,155013,15055,14706,735,15441,95
2021-02-04,Marin,041,260295,12656,12431,143,12574,192
2021-02-04,Mariposa,043,17540,366,348,3,351,4
2021-02-04,Mendocino,045,87422,3451,3240,65,3305,38
2021-02-04,Merced,047,269075,26957,26629,787,27416,345
2021-02-04,Modoc,049,8938,328,309,106,415,3
2021-02-04,Mono,051,14174,1151,1153,15,1168,3
2021-02-04,Monterey,053,433212,40554,39619,1469,41088,279
2021-02-04,Napa,055,140530,8708,8573,31,8604,55
2021-02-04,Nevada,057,99092,3754,3590,146,3736,37
2021-02-04,Orange,059,3164182,240158,235677,9625,245302,3238
2021-02-04,Placer,061,380077,19770,18711,1008,19719,210
2021-02-04,Plumas,063,18699,625,562,10,572,2
2021-02-04,Riverside,065,2383286,278210,269851,12882,282733,3230
2021-02-04,Sacramento,067,1510023,89905,87658,1102,88760,1222
2021-02-04,San Benito,069,59416,5532,5488,76,5564,51
2021-02-04,San Bernardino,071,2135413,280257,272223,8202,280425,2409
2021-02-04,San Diego,073,3302833,253829,242613,12112,254725,2738
2021-02-04,San Francisco,075,870044,32653,32116,909,33025,326
2021-02-04,San Joaquin,077,732212,64087,62374,2516,64890,883
2021-02-04,San Luis Obispo,079,281455,18721,18058,490,18548,211
2021-02-04,San Mateo,081,765935,37852,36437,372,36809,226
2021-02-04,Santa Barbara,083,443738,30506,29344,926,30270,322
2021-02-04,Santa Clara,085,1922200,105396,103781,484,104265,1404
2021-02-04,Santa Cruz,087,273765,14814,13713,709,14422,156
2021-02-04,Shasta,089,179085,10554,10466,1117,11583,131
2021-02-04,Sierra,091,2930,49,42,12,54,0
2021-02-04,Siskiyou,093,43540,1376,1273,202,1475,4
2021-02-04,Solano,095,438530,28745,28192,327,28519,120
2021-02-04,Sonoma,097,501317,26600,26276,143,26419,249
2021-02-04,Stanislaus,099,539301,48257,46822,4935,51757,678
2021-02-04,Sutter,101,95872,8506,8401,76,8477,92
2021-02-04,Tehama,103,63373,4444,4327,464,4791,21
2021-02-04,Trinity,105,12862,445,260,64,324,3
2021-02-04,Tulare,107,460477,46563,44983,7026,52009,656
2021-02-04,Tuolumne,109,53932,3570,3585,33,3618,45
2021-02-04,Ventura,111,848112,74130,72595,2581,75176,537
2021-02-04,Yolo,113,214977,12355,11982,127,12109,161
2021-02-04,Yuba,115,75493,5253,5135,77,5212,34
2021-02-03,Alameda,001,1643700,76771,74968,1588,76556,880
2021-02-03,Alpine,003,1148,73,72,0,72,0
2021-02-03,Amador,005,37829,3337,3281,26,3307,33
2021-02-03,Butte,007,227075,10891,10355,1506,11861,144
2021-02-03,Calaveras,009,45235,1831,1799,11,1810,21
2021-02-03,Colusa,011,21464,1799,1773,228,2001,10
2021-02-03,Contra Costa,013,1133247,59709,57762,978,58740,537
2021-02-03,Del Norte,015,27424,907,869,4,873,2
2021-02-03,El Dorado,017,186661,8744,8428,570,8998,86
2021-02-03,Fresno,019,978130,92628,89748,7070,96818,1015
2021-02-03,Glenn,021,27897,2170,2098,456,2554,14
2021-02-03,Humboldt,023,135768,2904,2800,19,2819,27
2021-02-03,Imperial,025,180216,26803,26363,2363,28726,547
2021-02-03,Inyo,027,18085,1134,1071,8,1079,27
2021-02-03,Kern,029,883053,89855,86771,8757,95528,877
2021-02-03,Kings,031,150075,21487,20831,888,21719,172
2021-02-03,Lake,033,64148,2965,2869,1,2870,33
2021-02-03,Lassen,035,31185,4998,4910,86,4996,1
2021-02-03,Los Angeles,037,10098052,1140088,1101890,36718,1138608,17163
2021-02-03,Madera,039,155013,15015,14605,733,15338,94
2021-02-03,Marin,041,260295,12621,12406,143,12549,190
2021-02-03,Mariposa,043,17540,365,347,3,350,4
2021-02-03,Mendocino,045,87422,3425,3236,64,3300,38
2021-02-03,Merced,047,269075,26842,26520,783,27303,343
2021-02-03,Modoc,049,8938,327,308,106,414,3
2021-02-03,Mono,051,14174,1144,1146,15,1161,3
2021-02-03,Monterey,053,433212,40427,39500,1452,40952,279
2021-02-03,Napa,055,140530,8673,8534,31,8565,54
2021-02-03,Nevada,057,99092,3740,3572,146,3718,35
2021-02-03,Orange,059,3164182,239414,234738,9593,244331,3189
2021-02-03,Placer,061,380077,19715,18646,1006,19652,210
2021-02-03,Plumas,063,18699,625,559,10,569,2
2021-02-03,Riverside,065,2383286,277469,269019,12852,281871,3195
2021-02-03,Sacramento,067,1510023,89582,87415,1098,88513,1212
2021-02-03,San Benito,069,59416,5514,5463,73,5536,51
2021-02-03,San Bernardino,071,2135413,279771,271477,8179,279656,2308
2021-02-03,San Diego,073,3302833,252927,241015,12066,253081,2683
2021-02-03,San Francisco,075,870044,32523,31983,904,32887,325
2021-02-03,San Joaquin,077,732212,63859,61976,2506,64482,880
2021-02-03,San Luis Obispo,079,281455,18643,17922,487,18409,206
2021-02-03,San Mateo,081,765935,37714,36227,368,36595,225
2021-02-03,Santa Barbara,083,443738,30357,29121,917,30038,315
2021-02-03,Santa Clara,085,1922200,105080,103278,482,103760,1364
2021-02-03,Santa Cruz,087,273765,14759,13611,703,14314,154
2021-02-03,Shasta,089,179085,10511,10422,1112,11534,130
2021-02-03,Sierra,091,2930,49,42,12,54,0
2021-02-03,Siskiyou,093,43540,1365,1268,201,1469,4
2021-02-03,Solano,095,438530,28623,28057,327,28384,119
2021-02-03,Sonoma,097,501317,26516,26155,142,26297,248
2021-02-03,Stanislaus,099,539301,48081,46598,4916,51514,662
2021-02-03,Sutter,101,95872,8481,8379,76,8455,90
2021-02-03,Tehama,103,63373,4426,4309,461,4770,21
2021-02-03,Trinity,105,12862,445,260,63,323,3
2021-02-03,Tulare,107,460477,46392,44838,6970,51808,640
2021-02-03,Tuolumne,109,53932,3559,3568,33,3601,45
2021-02-03,Ventura,111,848112,73793,72124,2571,74695,526
2021-02-03,Yolo,113,214977,12330,11933,127,12060,161
2021-02-03,Yuba,115,75493,5235,5124,77,5201,34
2021-02-02,Alameda,001,1643700,76427,74642,1576,76218,869
2021-02-02,Alpine,003,1148,73,72,0,72,0
2021-02-02,Amador,005,37829,3306,3275,26,3301,33
2021-02-02,Butte,007,227075,10865,10307,1497,11804,141
2021-02-02,Calaveras,009,45235,1822,1786,11,1797,21
2021-02-02,Colusa,011,21464,1791,1769,223,1992,9
2021-02-02,Contra Costa,013,1133247,59429,57551,975,58526,536
2021-02-02,Del Norte,015,27424,901,868,4,872,2
2021-02-02,El Dorado,017,186661,8704,8405,570,8975,84
2021-02-02,Fresno,019,978130,92327,89542,7035,96577,1009
2021-02-02,Glenn,021,27897,2158,2090,453,2543,14
2021-02-02,Humboldt,023,135768,2892,2784,19,2803,25
2021-02-02,Imperial,025,180216,26750,26317,2357,28674,535
2021-02-02,Inyo,027,18085,1131,1074,8,1082,27
2021-02-02,Kern,029,883053,89552,86485,8681,95166,867
2021-02-02,Kings,031,150075,21409,20785,880,21665,172
2021-02-02,Lake,033,64148,2945,2857,1,2858,33
2021-02-02,Lassen,035,31185,4991,4908,86,4994,1
2021-02-02,Los Angeles,037,10098052,1136703,1097573,36556,1134129,16913
2021-02-02,Madera,039,155013,14964,14595,728,15323,94
2021-02-02,Marin,041,260295,12592,12367,143,12510,189
2021-02-02,Mariposa,043,17540,362,345,3,348,4
2021-02-02,Mendocino,045,87422,3392,3210,64,3274,38
2021-02-02,Merced,047,269075,26745,26427,777,27204,340
2021-02-02,Modoc,049,8938,322,306,106,412,3
2021-02-02,Mono,051,14174,1142,1147,15,1162,3
2021-02-02,Monterey,053,433212,40292,39371,1438,40809,278
2021-02-02,Napa,055,140530,8644,8505,31,8536,53
2021-02-02,Nevada,057,99092,3725,3548,146,3694,20
2021-02-02,Orange,059,3164182,238612,233783,9558,243341,3152
2021-02-02,Placer,061,380077,19657,18615,1002,19617,205
2021-02-02,Plumas,063,18699,625,560,10,570,2
2021-02-02,Riverside,065,2383286,276610,267901,12818,280719,3169
2021-02-02,Sacramento,067,1510023,89292,87107,1087,88194,1202
2021-02-02,San Benito,069,59416,5500,5444,72,5516,50
2021-02-02,San Bernardino,071,2135413,279093,270486,8150,278636,2244
2021-02-02,San Diego,073,3302833,251888,240047,11979,252026,2629
2021-02-02,San Francisco,075,870044,32369,31788,894,32682,324
2021-02-02,San Joaquin,077,732212,63638,61708,2493,64201,878
2021-02-02,San Luis Obispo,079,281455,18549,17811,485,18296,201
2021-02-02,San Mateo,081,765935,37550,36004,362,36366,225
2021-02-02,Santa Barbara,083,443738,30186,28951,910,29861,304
2021-02-02,Santa Clara,085,1922200,104615,102872,477,103349,1349
2021-02-02,Santa Cruz,087,273765,14700,13572,699,14271,150
2021-02-02,Shasta,089,179085,10485,10371,1102,11473,128
2021-02-02,Sierra,091,2930,49,42,12,54,0
2021-02-02,Siskiyou,093,43540,1358,1252,198,1450,4
2021-02-02,Solano,095,438530,28527,27963,323,28286,118
2021-02-02,Sonoma,097,501317,26400,26054,142,26196,247
2021-02-02,Stanislaus,099,539301,47862,46306,4884,51190,641
2021-02-02,Sutter,101,95872,8458,8340,76,8416,89
2021-02-02,Tehama,103,63373,4412,4289,460,4749,21
2021-02-02,Trinity,105,12862,445,260,63,323,3
2021-02-02,Tulare,107,460477,46236,44720,6905,51625,625
2021-02-02,Tuolumne,109,53932,3547,3548,33,3581,39
2021-02-02,Ventura,111,848112,73377,71557,2561,74118,514
2021-02-02,Yolo,113,214977,12285,11886,126,12012,158
2021-02-02,Yuba,115,75493,5217,5111,76,5187,34
2021-02-01,Alameda,001,1643700,76072,74374,1571,75945,858
2021-02-01,Alpine,003,1148,73,72,0,72,0
2021-02-01,Amador,005,37829,3295,3234,26,3260,32
2021-02-01,Butte,007,227075,10821,10263,1493,11756,141
2021-02-01,Calaveras,009,45235,1815,1785,11,1796,21
2021-02-01,Colusa,011,21464,1786,1763,214,1977,9
2021-02-01,Contra Costa,013,1133247,59186,57324,974,58298,531
2021-02-01,Del Norte,015,27424,897,865,4,869,2
2021-02-01,El Dorado,017,186661,8665,8337,570,8907,83
2021-02-01,Fresno,019,978130,91995,89272,7000,96272,994
2021-02-01,Glenn,021,27897,2142,2086,445,2531,14
2021-02-01,Humboldt,023,135768,2871,2773,18,2791,25
2021-02-01,Imperial,025,180216,26706,26224,2355,28579,530
2021-02-01,Inyo,027,18085,1121,1072,8,1080,27
2021-02-01,Kern,029,883053,89155,86170,8613,94783,862
2021-02-01,Kings,031,150075,21318,20746,872,21618,172
2021-02-01,Lake,033,64148,2929,2843,1,2844,33
2021-02-01,Lassen,035,31185,4971,4907,86,4993,1
2021-02-01,Los Angeles,037,10098052,1132876,1094341,36391,1130732,16695
2021-02-01,Madera,039,155013,14929,14572,725,15297,94
2021-02-01,Marin,041,260295,12553,12341,142,12483,188
2021-02-01,Mariposa,043,17540,360,344,3,347,4
2021-02-01,Mendocino,045,87422,3359,3192,64,3256,37
2021-02-01,Merced,047,269075,26621,26282,768,27050,337
2021-02-01,Modoc,049,8938,316,303,102,405,1
2021-02-01,Mono,051,14174,1139,1145,15,1160,3
2021-02-01,Monterey,053,433212,40108,39196,1417,40613,278
2021-02-01,Napa,055,140530,8612,8449,31,8480,52
2021-02-01,Nevada,057,99092,3708,3535,145,3680,20
2021-02-01,Orange,059,3164182,237700,233155,9513,242668,3100
2021-02-01,Placer,061,380077,19590,18574,995,19569,204
2021-02-01,Plumas,063,18699,623,554,10,564,2
2021-02-01,Riverside,065,2383286,275672,267025,12783,279808,3092
2021-02-01,Sacramento,067,1510023,88890,86856,1076,87932,1193
2021-02-01,San Benito,069,59416,5482,5432,72,5504,48
2021-02-01,San Bernardino,071,2135413,278397,270012,8111,278123,2172
2021-02-01,San Diego,073,3302833,250663,239121,11903,251024,2619
2021-02-01,San Francisco,075,870044,32234,31703,882,32585,324
2021-02-01,San Joaquin,077,732212,63432,61542,2482,64024,877
2021-02-01,San Luis Obispo,079,281455,18429,17690,478,18168,199
2021-02-01,San Mateo,081,765935,37401,35843,362,36205,220
2021-02-01,Santa Barbara,083,443738,30017,28837,902,29739,297
2021-02-01,Santa Clara,085,1922200,104198,102462,476,102938,1343
2021-02-01,Santa Cruz,087,273765,14647,13524,697,14221,149
2021-02-01,Shasta,089,179085,10460,10329,1096,11425,112
2021-02-01,Sierra,091,2930,49,42,12,54,0
2021-02-01,Siskiyou,093,43540,1351,1238,195,1433,4
2021-02-01,Solano,095,438530,28422,27844,322,28166,117
2021-02-01,Sonoma,097,501317,26312,26011,141,26152,243
2021-02-01,Stanislaus,099,539301,47605,46112,4856,50968,642
2021-02-01,Sutter,101,95872,8419,8313,76,8389,89
2021-02-01,Tehama,103,63373,4386,4263,460,4723,21
2021-02-01,Trinity,105,12862,443,260,63,323,3
2021-02-01,Tulare,107,460477,46091,44569,6825,51394,618
2021-02-01,Tuolumne,109,53932,3539,3534,33,3567,39
2021-02-01,Ventura,111,848112,72972,71104,2544,73648,502
2021-02-01,Yolo,113,214977,12237,11824,126,11950,151
2021-02-01,Yuba,115,75493,5203,5084,75,5159,33
2021-01-31,Alameda,001,1643700,75646,73979,1563,75542,857
2021-01-31,Alpine,003,1148,73,72,0,72,0
2021-01-31,Amador,005,37829,3285,3212,25,3237,32
2021-01-31,Butte,007,227075,10776,10215,1483,11698,140
2021-01-31,Calaveras,009,45235,1795,1778,11,1789,21
2021-01-31,Colusa,011,21464,1780,1754,209,1963,9
2021-01-31,Contra Costa,013,1133247,58853,57079,974,58053,531
2021-01-31,Del Norte,015,27424,895,865,4,869,2
2021-01-31,El Dorado,017,186661,8628,8317,568,8885,83
2021-01-31,Fresno,019,978130,91683,88852,6946,95798,994
2021-01-31,Glenn,021,27897,2132,2083,444,2527,14
2021-01-31,Humboldt,023,135768,2855,2767,18,2785,25
2021-01-31,Imperial,025,180216,26634,26206,2346,28552,530
2021-01-31,Inyo,027,18085,1108,1072,8,1080,27
2021-01-31,Kern,029,883053,88659,85872,8529,94401,861
2021-01-31,Kings,031,150075,21234,20709,860,21569,172
2021-01-31,Lake,033,64148,2908,2826,1,2827,33
2021-01-31,Lassen,035,31185,4955,4900,86,4986,1
2021-01-31,Los Angeles,037,10098052,1128246,1090304,36190,1126494,16609
2021-01-31,Madera,039,155013,14875,14496,717,15213,94
2021-01-31,Marin,041,260295,12506,12297,138,12435,185
2021-01-31,Mariposa,043,17540,358,344,3,347,4
2021-01-31,Mendocino,045,87422,3336,3181,63,3244,37
2021-01-31,Merced,047,269075,26477,26222,763,26985,337
2021-01-31,Modoc,049,8938,313,304,100,404,1
2021-01-31,Mono,051,14174,1136,1146,15,1161,3
2021-01-31,Monterey,053,433212,39929,39035,1390,40425,278
2021-01-31,Napa,055,140530,8570,8404,31,8435,52
2021-01-31,Nevada,057,99092,3686,3518,143,3661,20
2021-01-31,Orange,059,3164182,236683,232347,9473,241820,3053
2021-01-31,Placer,061,380077,19512,18506,984,19490,204
2021-01-31,Plumas,063,18699,622,554,10,564,2
2021-01-31,Riverside,065,2383286,274656,266145,12736,278881,3074
2021-01-31,Sacramento,067,1510023,88448,86560,1062,87622,1186
2021-01-31,San Benito,069,59416,5460,5425,70,5495,48
2021-01-31,San Bernardino,071,2135413,277376,269533,8082,277615,2156
2021-01-31,San Diego,073,3302833,249350,238039,11789,249828,2619
2021-01-31,San Francisco,075,870044,32043,31563,871,32434,323
2021-01-31,San Joaquin,077,732212,63031,61379,2473,63852,877
2021-01-31,San Luis Obispo,079,281455,18296,17615,473,18088,199
2021-01-31,San Mateo,081,765935,37211,35659,359,36018,219
2021-01-31,Santa Barbara,083,443738,29773,28570,893,29463,297
2021-01-31,Santa Clara,085,1922200,103646,101986,467,102453,1330
2021-01-31,Santa Cruz,087,273765,14552,13469,683,14152,149
2021-01-31,Shasta,089,179085,10415,10313,1088,11401,112
2021-01-31,Sierra,091,2930,48,43,12,55,0
2021-01-31,Siskiyou,093,43540,1341,1238,195,1433,4
2021-01-31,Solano,095,438530,28292,27678,322,28000,118
2021-01-31,Sonoma,097,501317,26209,25925,140,26065,243
2021-01-31,Stanislaus,099,539301,47321,45971,4826,50797,642
2021-01-31,Sutter,101,95872,8374,8289,76,8365,89
2021-01-31,Tehama,103,63373,4364,4256,459,4715,21
2021-01-31,Trinity,105,12862,441,260,63,323,3
2021-01-31,Tulare,107,460477,45923,44440,6745,51185,618
2021-01-31,Tuolumne,109,53932,3501,3519,33,3552,39
2021-01-31,Ventura,111,848112,72377,70635,2531,73166,502
2021-01-31,Yolo,113,214977,12176,11771,126,11897,151
2021-01-31,Yuba,115,75493,5183,5071,75,5146,33
2021-01-30,Alameda,001,1643700,75442,73622,1558,75180,850
2021-01-30,Alpine,003,1148,73,72,0,72,0
2021-01-30,Amador,005,37829,3281,3181,25,3206,32
2021-01-30,Butte,007,227075,10742,10177,1474,11651,139
2021-01-30,Calaveras,009,45235,1782,1763,11,1774,21
2021-01-30,Colusa,011,21464,1778,1748,209,1957,9
2021-01-30,Contra Costa,013,1133247,58670,56763,970,57733,531
2021-01-30,Del Norte,015,27424,894,865,4,869,2
2021-01-30,El Dorado,017,186661,8608,8299,567,8866,83
2021-01-30,Fresno,019,978130,91503,88476,6926,95402,964
2021-01-30,Glenn,021,27897,2129,2074,442,2516,14
2021-01-30,Humboldt,023,135768,2844,2742,18,2760,24
2021-01-30,Imperial,025,180216,26610,26160,2344,28504,530
2021-01-30,Inyo,027,18085,1104,1068,8,1076,27
2021-01-30,Kern,029,883053,88458,85572,8464,94036,848
2021-01-30,Kings,031,150075,21163,20605,855,21460,169
2021-01-30,Lake,033,64148,2902,2809,1,2810,33
2021-01-30,Lassen,035,31185,4951,4890,86,4976,1
2021-01-30,Los Angeles,037,10098052,1125847,1084763,36048,1120811,16484
2021-01-30,Madera,039,155013,14833,14443,712,15155,94
2021-01-30,Marin,041,260295,12478,12225,137,12362,185
2021-01-30,Mariposa,043,17540,356,344,3,347,4
2021-01-30,Mendocino,045,87422,3322,3153,62,3215,36
2021-01-30,Merced,047,269075,26403,26078,761,26839,335
2021-01-30,Modoc,049,8938,313,303,100,403,1
2021-01-30,Mono,051,14174,1136,1143,15,1158,3
2021-01-30,Monterey,053,433212,39869,38847,1388,40235,277
2021-01-30,Napa,055,140530,8554,8342,31,8373,52
2021-01-30,Nevada,057,99092,3667,3499,143,3642,20
2021-01-30,Orange,059,3164182,236138,231358,9436,240794,3013
2021-01-30,Placer,061,380077,19459,18430,978,19408,205
2021-01-30,Plumas,063,18699,620,554,10,564,2
2021-01-30,Riverside,065,2383286,274059,265137,12705,277842,3061
2021-01-30,Sacramento,067,1510023,88257,86388,1057,87445,1184
2021-01-30,San Benito,069,59416,5442,5401,69,5470,48
2021-01-30,San Bernardino,071,2135413,276949,268660,8063,276723,2122
2021-01-30,San Diego,073,3302833,248585,236765,11744,248509,2603
2021-01-30,San Francisco,075,870044,31942,31427,868,32295,316
2021-01-30,San Joaquin,077,732212,62899,61120,2464,63584,864
2021-01-30,San Luis Obispo,079,281455,18216,17522,472,17994,198
2021-01-30,San Mateo,081,765935,37072,35451,358,35809,219
2021-01-30,Santa Barbara,083,443738,29631,28342,891,29233,296
2021-01-30,Santa Clara,085,1922200,103300,101471,465,101936,1307
2021-01-30,Santa Cruz,087,273765,14512,13383,682,14065,149
2021-01-30,Shasta,089,179085,10396,10283,1085,11368,112
2021-01-30,Sierra,091,2930,48,43,12,55,0
2021-01-30,Siskiyou,093,43540,1338,1236,194,1430,4
2021-01-30,Solano,095,438530,28209,27511,321,27832,118
2021-01-30,Sonoma,097,501317,26161,25810,137,25947,243
2021-01-30,Stanislaus,099,539301,47191,45697,4799,50496,642
2021-01-30,Sutter,101,95872,8358,8226,76,8302,87
2021-01-30,Tehama,103,63373,4351,4229,458,4687,21
2021-01-30,Trinity,105,12862,441,259,63,322,3
2021-01-30,Tulare,107,460477,45787,44203,6709,50912,615
2021-01-30,Tuolumne,109,53932,3497,3508,33,3541,36
2021-01-30,Ventura,111,848112,72064,69931,2517,72448,493
2021-01-30,Yolo,113,214977,12162,11698,125,11823,151
2021-01-30,Yuba,115,75493,5173,5042,74,5116,33
2021-01-29,Alameda,001,1643700,75175,73210,1551,74761,841
2021-01-29,Alpine,003,1148,73,72,0,72,0
2021-01-29,Amador,005,37829,3269,3134,24,3158,32
2021-01-29,Butte,007,227075,10710,10122,1465,11587,138
2021-01-29,Calaveras,009,45235,1771,1757,11,1768,21
2021-01-29,Colusa,011,21464,1774,1734,208,1942,8
2021-01-29,Contra Costa,013,1133247,58500,56318,968,57286,529
2021-01-29,Del Norte,015,27424,893,865,4,869,2
2021-01-29,El Dorado,017,186661,8591,8231,566,8797,83
2021-01-29,Fresno,019,978130,91288,87936,6889,94825,962
2021-01-29,Glenn,021,27897,2124,2061,441,2502,14
2021-01-29,Humboldt,023,135768,2831,2707,18,2725,24
2021-01-29,Imperial,025,180216,26595,26045,2341,28386,521
2021-01-29,Inyo,027,18085,1092,1048,8,1056,27
2021-01-29,Kern,029,883053,88231,85044,8413,93457,836
2021-01-29,Kings,031,150075,21124,20466,850,21316,169
2021-01-29,Lake,033,64148,2892,2792,1,2793,32
2021-01-29,Lassen,035,31185,4948,4874,86,4960,1
2021-01-29,Los Angeles,037,10098052,1122352,1078329,35898,1114227,16190
2021-01-29,Madera,039,155013,14782,14377,712,15089,94
2021-01-29,Marin,041,260295,12433,12145,136,12281,185
2021-01-29,Mariposa,043,17540,355,342,3,345,4
2021-01-29,Mendocino,045,87422,3313,3131,61,3192,36
2021-01-29,Merced,047,269075,26329,25865,756,26621,334
2021-01-29,Modoc,049,8938,312,297,100,397,1
2021-01-29,Mono,051,14174,1134,1139,15,1154,3
2021-01-29,Monterey,053,433212,39755,38539,1380,39919,277
2021-01-29,Napa,055,140530,8523,8276,31,8307,52
2021-01-29,Nevada,057,99092,3658,3487,142,3629,20
2021-01-29,Orange,059,3164182,235461,229917,9399,239316,2967
2021-01-29,Placer,061,380077,19406,18367,974,19341,203
2021-01-29,Plumas,063,18699,619,548,10,558,2
2021-01-29,Riverside,065,2383286,273257,263504,12673,276177,3008
2021-01-29,Sacramento,067,1510023,88003,86320,1053,87373,1169
2021-01-29,San Benito,069,59416,5434,5386,69,5455,48
2021-01-29,San Bernardino,071,2135413,276437,267490,8025,275515,2095
2021-01-29,San Diego,073,3302833,247643,234637,11666,246303,2571
2021-01-29,San Francisco,075,870044,31802,31294,860,32154,307
2021-01-29,San Joaquin,077,732212,62754,60899,2450,63349,858
2021-01-29,San Luis Obispo,079,281455,18156,17440,467,17907,193
2021-01-29,San Mateo,081,765935,36939,35223,355,35578,218
2021-01-29,Santa Barbara,083,443738,29498,28105,885,28990,291
2021-01-29,Santa Clara,085,1922200,102940,101010,463,101473,1273
2021-01-29,Santa Cruz,087,273765,14459,13311,679,13990,148
2021-01-29,Shasta,089,179085,10379,10220,1081,11301,112
2021-01-29,Sierra,091,2930,48,43,12,55,0
2021-01-29,Siskiyou,093,43540,1337,1227,194,1421,4
2021-01-29,Solano,095,438530,28126,27352,319,27671,116
2021-01-29,Sonoma,097,501317,26105,25710,136,25846,243
2021-01-29,Stanislaus,099,539301,47048,45466,4777,50243,642
2021-01-29,Sutter,101,95872,8339,8181,76,8257,87
2021-01-29,Tehama,103,63373,4339,4191,456,4647,20
2021-01-29,Trinity,105,12862,441,260,63,323,3
2021-01-29,Tulare,107,460477,45680,43925,6670,50595,606
2021-01-29,Tuolumne,109,53932,3487,3483,33,3516,36
2021-01-29,Ventura,111,848112,71640,69511,2504,72015,484
2021-01-29,Yolo,113,214977,12124,11612,125,11737,151
2021-01-29,Yuba,115,75493,5157,5018,74,5092,32
2021-01-28,Alameda,001,1643700,74751,72758,1543,74301,833
2021-01-28,Alpine,003,1148,73,72,0,72,0
2021-01-28,Amador,005,37829,3232,3124,24,3148,31
2021-01-28,Butte,007,227075,10669,10037,1455,11492,138
2021-01-28,Calaveras,009,45235,1758,1747,10,1757,21
2021-01-28,Colusa,011,21464,1767,1731,204,1935,8
2021-01-28,Contra Costa,013,1133247,58259,55999,958,56957,525
2021-01-28,Del Norte,015,27424,892,862,4,866,2
2021-01-28,El Dorado,017,186661,8576,8198,561,8759,79
2021-01-28,Fresno,019,978130,91001,87401,6841,94242,949
2021-01-28,Glenn,021,27897,2119,2043,434,2477,14
2021-01-28,Humboldt,023,135768,2814,2686,18,2704,24
2021-01-28,Imperial,025,180216,26551,25984,2334,28318,517
2021-01-28,Inyo,027,18085,1087,1039,8,1047,27
2021-01-28,Kern,029,883053,87902,84708,8330,93038,817
2021-01-28,Kings,031,150075,21064,20328,847,21175,167
2021-01-28,Lake,033,64148,2877,2772,1,2773,32
2021-01-28,Lassen,035,31185,4942,4865,86,4951,1
2021-01-28,Los Angeles,037,10098052,1118438,1072412,35711,1108123,15967
2021-01-28,Madera,039,155013,14726,14301,708,15009,94
2021-01-28,Marin,041,260295,12380,12079,135,12214,183
2021-01-28,Mariposa,043,17540,355,334,3,337,4
2021-01-28,Mendocino,045,87422,3296,3110,61,3171,36
2021-01-28,Merced,047,269075,26207,25620,744,26364,328
2021-01-28,Modoc,049,8938,311,297,100,397,0
2021-01-28,Mono,051,14174,1132,1131,15,1146,3
2021-01-28,Monterey,053,433212,39561,38312,1361,39673,274
2021-01-28,Napa,055,140530,8476,8233,31,8264,50
2021-01-28,Nevada,057,99092,3643,3452,141,3593,19
2021-01-28,Orange,059,3164182,234484,228636,9369,238005,2860
2021-01-28,Placer,061,380077,19346,18246,971,19217,198
2021-01-28,Plumas,063,18699,618,547,10,557,2
2021-01-28,Riverside,065,2383286,272476,262342,12625,274967,2981
2021-01-28,Sacramento,067,1510023,87640,85698,1042,86740,1149
2021-01-28,San Benito,069,59416,5416,5344,68,5412,47
2021-01-28,San Bernardino,071,2135413,275736,266456,8004,274460,2057
2021-01-28,San Diego,073,3302833,246490,232967,11577,244544,2534
2021-01-28,San Francisco,075,870044,31665,31193,844,32037,290
2021-01-28,San Joaquin,077,732212,62489,60627,2436,63063,854
2021-01-28,San Luis Obispo,079,281455,18056,17279,465,17744,189
2021-01-28,San Mateo,081,765935,36770,34931,339,35270,218
2021-01-28,Santa Barbara,083,443738,29274,27674,872,28546,284
2021-01-28,Santa Clara,085,1922200,102474,100470,461,100931,1219
2021-01-28,Santa Cruz,087,273765,14370,13188,673,13861,145
2021-01-28,Shasta,089,179085,10345,10176,1073,11249,110
2021-01-28,Sierra,091,2930,48,43,12,55,0
2021-01-28,Siskiyou,093,43540,1330,1218,192,1410,4
2021-01-28,Solano,095,438530,27966,27163,318,27481,114
2021-01-28,Sonoma,097,501317,26014,25564,136,25700,236
2021-01-28,Stanislaus,099,539301,46840,45162,4758,49920,640
2021-01-28,Sutter,101,95872,8292,8136,76,8212,85
2021-01-28,Tehama,103,63373,4316,4163,453,4616,20
2021-01-28,Trinity,105,12862,439,260,63,323,3
2021-01-28,Tulare,107,460477,45524,43742,6595,50337,595
2021-01-28,Tuolumne,109,53932,3473,3472,33,3505,32
2021-01-28,Ventura,111,848112,71127,68896,2488,71384,475
2021-01-28,Yolo,113,214977,12081,11500,121,11621,151
2021-01-28,Yuba,115,75493,5141,4994,73,5067,32
2021-01-27,Alameda,001,1643700,74333,72188,1536,73724,815
2021-01-27,Alpine,003,1148,73,72,0,72,0
2021-01-27,Amador,005,37829,3216,3116,24,3140,31
2021-01-27,Butte,007,227075,10630,9988,1443,11431,138
2021-01-27,Calaveras,009,45235,1749,1737,10,1747,21
2021-01-27,Colusa,011,21464,1761,1724,202,1926,8
2021-01-27,Contra Costa,013,1133247,57960,55578,955,56533,507
2021-01-27,Del Norte,015,27424,891,859,4,863,2
2021-01-27,El Dorado,017,186661,8550,8141,560,8701,76
2021-01-27,Fresno,019,978130,90710,86886,6799,93685,938
2021-01-27,Glenn,021,27897,2115,2042,433,2475,14
2021-01-27,Humboldt,023,135768,2792,2630,18,2648,24
2021-01-27,Imperial,025,180216,26497,25861,2320,28181,504
2021-01-27,Inyo,027,18085,1083,1023,8,1031,27
2021-01-27,Kern,029,883053,87592,84244,8260,92504,809
2021-01-27,Kings,031,150075,20958,20211,839,21050,167
2021-01-27,Lake,033,64148,2857,2750,1,2751,32
2021-01-27,Lassen,035,31185,4936,4851,86,4937,1
2021-01-27,Los Angeles,037,10098052,1113629,1066569,35505,1102074,15757
2021-01-27,Madera,039,155013,14685,14194,703,14897,86
2021-01-27,Marin,041,260295,12343,12028,134,12162,180
2021-01-27,Mariposa,043,17540,355,333,3,336,4
2021-01-27,Mendocino,045,87422,3276,3095,61,3156,36
2021-01-27,Merced,047,269075,26048,25439,733,26172,315
2021-01-27,Modoc,049,8938,311,297,97,394,0
2021-01-27,Mono,051,14174,1130,1131,15,1146,3
2021-01-27,Monterey,053,433212,39353,38139,1342,39481,268
2021-01-27,Napa,055,140530,8403,8187,31,8218,46
2021-01-27,Nevada,057,99092,3621,3431,141,3572,18
2021-01-27,Orange,059,3164182,233367,227110,9317,236427,2832
2021-01-27,Placer,061,380077,19276,18106,960,19066,198
2021-01-27,Plumas,063,18699,618,544,10,554,2
2021-01-27,Riverside,065,2383286,271280,260796,12574,273370,2931
2021-01-27,Sacramento,067,1510023,87280,85428,1031,86459,1142
2021-01-27,San Benito,069,59416,5401,5284,68,5352,47
2021-01-27,San Bernardino,071,2135413,274885,265153,7971,273124,2019
2021-01-27,San Diego,073,3302833,245161,231478,11472,242950,2465
2021-01-27,San Francisco,075,870044,31521,31082,837,31919,287
2021-01-27,San Joaquin,077,732212,62218,60131,2417,62548,853
2021-01-27,San Luis Obispo,079,281455,17948,17119,461,17580,188
2021-01-27,San Mateo,081,765935,36615,34619,336,34955,216
2021-01-27,Santa Barbara,083,443738,29097,27435,866,28301,282
2021-01-27,Santa Clara,085,1922200,102069,99732,457,100189,1184
2021-01-27,Santa Cruz,087,273765,14300,13111,670,13781,143
2021-01-27,Shasta,089,179085,10311,10106,1067,11173,105
2021-01-27,Sierra,091,2930,48,44,12,56,0
2021-01-27,Siskiyou,093,43540,1325,1214,189,1403,4
2021-01-27,Solano,095,438530,27789,26982,311,27293,112
2021-01-27,Sonoma,097,501317,25915,25361,132,25493,237
2021-01-27,Stanislaus,099,539301,46656,44874,4733,49607,624
2021-01-27,Sutter,101,95872,8249,8093,76,8169,83
2021-01-27,Tehama,103,63373,4296,4133,449,4582,20
2021-01-27,Trinity,105,12862,439,260,63,323,3
2021-01-27,Tulare,107,460477,45337,43462,6524,49986,583
2021-01-27,Tuolumne,109,53932,3463,3464,33,3497,32
2021-01-27,Ventura,111,848112,70654,68291,2463,70754,468
2021-01-27,Yolo,113,214977,12033,11427,119,11546,151
2021-01-27,Yuba,115,75493,5125,4968,73,5041,32
2021-01-26,Alameda,001,1643700,73959,71851,1519,73370,789
2021-01-26,Alpine,003,1148,73,72,0,72,0
2021-01-26,Amador,005,37829,3205,3113,24,3137,31
2021-01-26,Butte,007,227075,10588,9943,1437,11380,136
2021-01-26,Calaveras,009,45235,1739,1723,10,1733,21
2021-01-26,Colusa,011,21464,1754,1719,199,1918,8
2021-01-26,Contra Costa,013,1133247,57682,55337,947,56284,491
2021-01-26,Del Norte,015,27424,890,856,4,860,2
2021-01-26,El Dorado,017,186661,8524,8115,558,8673,71
2021-01-26,Fresno,019,978130,90352,86673,6756,93429,923
2021-01-26,Glenn,021,27897,2105,2034,428,2462,13
2021-01-26,Humboldt,023,135768,2771,2612,17,2629,24
2021-01-26,Imperial,025,180216,26424,25812,2308,28120,498
2021-01-26,Inyo,027,18085,1076,1018,8,1026,27
2021-01-26,Kern,029,883053,87169,83868,8185,92053,790
2021-01-26,Kings,031,150075,20900,20156,834,20990,159
2021-01-26,Lake,033,64148,2848,2748,1,2749,32
2021-01-26,Lassen,035,31185,4930,4844,86,4930,1
2021-01-26,Los Angeles,037,10098052,1108341,1060492,35304,1095796,15458
2021-01-26,Madera,039,155013,14628,14130,697,14827,86
2021-01-26,Marin,041,260295,12298,11993,132,12125,179
2021-01-26,Mariposa,043,17540,353,332,3,335,3
2021-01-26,Mendocino,045,87422,3250,3076,60,3136,36
2021-01-26,Merced,047,269075,25908,25359,725,26084,309
2021-01-26,Modoc,049,8938,304,291,96,387,0
2021-01-26,Mono,051,14174,1128,1120,15,1135,3
2021-01-26,Monterey,053,433212,39159,37963,1322,39285,255
2021-01-26,Napa,055,140530,8346,8145,31,8176,43
2021-01-26,Nevada,057,99092,3614,3410,140,3550,18
2021-01-26,Orange,059,3164182,232243,225987,9271,235258,2760
2021-01-26,Placer,061,380077,19200,18016,958,18974,193
2021-01-26,Plumas,063,18699,616,536,10,546,2
2021-01-26,Riverside,065,2383286,269912,259399,12511,271910,2898
2021-01-26,Sacramento,067,1510023,86922,85062,1024,86086,1127
2021-01-26,San Benito,069,59416,5387,5251,67,5318,45
2021-01-26,San Bernardino,071,2135413,273882,263736,7929,271665,1970
2021-01-26,San Diego,073,3302833,243666,230063,11370,241433,2421
2021-01-26,San Francisco,075,870044,31389,30874,818,31692,286
2021-01-26,San Joaquin,077,732212,61964,59889,2401,62290,847
2021-01-26,San Luis Obispo,079,281455,17867,17016,458,17474,186
2021-01-26,San Mateo,081,765935,36421,34441,325,34766,213
2021-01-26,Santa Barbara,083,443738,28922,27321,854,28175,273
2021-01-26,Santa Clara,085,1922200,101590,99215,454,99669,1171
2021-01-26,Santa Cruz,087,273765,14234,13045,664,13709,134
2021-01-26,Shasta,089,179085,10276,10036,1059,11095,103
2021-01-26,Sierra,091,2930,48,43,12,55,0
2021-01-26,Siskiyou,093,43540,1310,1208,187,1395,4
2021-01-26,Solano,095,438530,27633,26858,304,27162,110
2021-01-26,Sonoma,097,501317,25796,25273,130,25403,236
2021-01-26,Stanislaus,099,539301,46474,44703,4693,49396,599
2021-01-26,Sutter,101,95872,8206,8067,76,8143,83
2021-01-26,Tehama,103,63373,4263,4115,449,4564,20
2021-01-26,Trinity,105,12862,439,260,63,323,3
2021-01-26,Tulare,107,460477,45133,43394,6457,49851,579
2021-01-26,Tuolumne,109,53932,3453,3451,33,3484,30
2021-01-26,Ventura,111,848112,70121,67526,2437,69963,448
2021-01-26,Yolo,113,214977,11988,11361,116,11477,148
2021-01-26,Yuba,115,75493,5100,4944,71,5015,31
2021-01-25,Alameda,001,1643700,73533,71255,1509,72764,780
2021-01-25,Alpine,003,1148,73,72,0,72,0
2021-01-25,Amador,005,37829,3165,3074,24,3098,30
2021-01-25,Butte,007,227075,10521,9865,1429,11294,133
2021-01-25,Calaveras,009,45235,1724,1713,10,1723,21
2021-01-25,Colusa,011,21464,1742,1709,195,1904,8
2021-01-25,Contra Costa,013,1133247,57328,54989,940,55929,488
2021-01-25,Del Norte,015,27424,889,855,4,859,2
2021-01-25,El Dorado,017,186661,8499,8060,558,8618,66
2021-01-25,Fresno,019,978130,89981,86336,6725,93061,913
2021-01-25,Glenn,021,27897,2096,2028,428,2456,13
2021-01-25,Humboldt,023,135768,2737,2587,17,2604,24
2021-01-25,Imperial,025,180216,26375,25745,2300,28045,491
2021-01-25,Inyo,027,18085,1070,1015,8,1023,27
2021-01-25,Kern,029,883053,86783,83401,8100,91501,787
2021-01-25,Kings,031,150075,20780,20067,830,20897,159
2021-01-25,Lake,033,64148,2829,2729,1,2730,32
2021-01-25,Lassen,035,31185,4903,4835,86,4921,1
2021-01-25,Los Angeles,037,10098052,1102376,1055181,35081,1090262,15163
2021-01-25,Madera,039,155013,14574,14068,692,14760,86
2021-01-25,Marin,041,260295,12246,11923,128,12051,177
2021-01-25,Mariposa,043,17540,350,331,3,334,3
2021-01-25,Mendocino,045,87422,3239,3054,60,3114,35
2021-01-25,Merced,047,269075,25769,25181,716,25897,305
2021-01-25,Modoc,049,8938,303,288,92,380,0
2021-01-25,Mono,051,14174,1125,1114,14,1128,3
2021-01-25,Monterey,053,433212,38906,37726,1303,39029,255
2021-01-25,Napa,055,140530,8312,8057,30,8087,43
2021-01-25,Nevada,057,99092,3600,3365,140,3505,18
2021-01-25,Orange,059,3164182,231035,225105,9226,234331,2696
2021-01-25,Placer,061,380077,19112,17936,943,18879,193
2021-01-25,Plumas,063,18699,613,533,10,543,2
2021-01-25,Riverside,065,2383286,268173,258082,12458,270540,2789
2021-01-25,Sacramento,067,1510023,86480,84653,1016,85669,1118
2021-01-25,San Benito,069,59416,5352,5238,66,5304,43
2021-01-25,San Bernardino,071,2135413,272939,263174,7893,271067,1947
2021-01-25,San Diego,073,3302833,242053,228630,11298,239928,2375
2021-01-25,San Francisco,075,870044,31239,30734,795,31529,288
2021-01-25,San Joaquin,077,732212,61670,59291,2376,61667,838
2021-01-25,San Luis Obispo,079,281455,17733,16868,453,17321,179
2021-01-25,San Mateo,081,765935,36188,34187,319,34506,213
2021-01-25,Santa Barbara,083,443738,28688,27065,844,27909,269
2021-01-25,Santa Clara,085,1922200,101027,98647,446,99093,1143
2021-01-25,Santa Cruz,087,273765,14147,12973,660,13633,133
2021-01-25,Shasta,089,179085,10235,9991,1048,11039,103
2021-01-25,Sierra,091,2930,48,42,12,54,0
2021-01-25,Siskiyou,093,43540,1302,1205,184,1389,4
2021-01-25,Solano,095,438530,27465,26648,303,26951,109
2021-01-25,Sonoma,097,501317,25689,25160,128,25288,233
2021-01-25,Stanislaus,099,539301,46228,44293,4651,48944,599
2021-01-25,Sutter,101,95872,8163,8023,76,8099,83
2021-01-25,Tehama,103,63373,4236,4082,445,4527,20
2021-01-25,Trinity,105,12862,439,262,63,325,3
2021-01-25,Tulare,107,460477,44916,43124,6355,49479,578
2021-01-25,Tuolumne,109,53932,3444,3422,33,3455,29
2021-01-25,Ventura,111,848112,69487,66910,2420,69330,439
2021-01-25,Yolo,113,214977,11902,11276,115,11391,140
2021-01-25,Yuba,115,75493,5078,4900,69,4969,31
2021-01-24,Alameda,001,1643700,73029,70823,1498,72321,780
2021-01-24,Alpine,003,1148,73,72,0,72,0
2021-01-24,Amador,005,37829,3132,3054,24,3078,30
2021-01-24,Butte,007,227075,10437,9820,1413,11233,133
2021-01-24,Calaveras,009,45235,1711,1704,10,1714,21
2021-01-24,Colusa,011,21464,1731,1689,189,1878,8
2021-01-24,Contra Costa,013,1133247,56940,54694,927,55621,488
2021-01-24,Del Norte,015,27424,885,855,4,859,2
2021-01-24,El Dorado,017,186661,8464,8003,554,8557,66
2021-01-24,Fresno,019,978130,89543,85808,6686,92494,911
2021-01-24,Glenn,021,27897,2088,2026,427,2453,13
2021-01-24,Humboldt,023,135768,2698,2562,17,2579,24
2021-01-24,Imperial,025,180216,26280,25707,2278,27985,488
2021-01-24,Inyo,027,18085,1054,1007,8,1015,27
2021-01-24,Kern,029,883053,86347,83125,7993,91118,785
2021-01-24,Kings,031,150075,20652,19988,814,20802,159
2021-01-24,Lake,033,64148,2812,2724,0,2724,32
2021-01-24,Lassen,035,31185,4892,4828,83,4911,1
2021-01-24,Los Angeles,037,10098052,1095961,1048757,34776,1083533,15119
2021-01-24,Madera,039,155013,14484,14000,686,14686,86
2021-01-24,Marin,041,260295,12179,11872,127,11999,177
2021-01-24,Mariposa,043,17540,346,322,3,325,3
2021-01-24,Mendocino,045,87422,3218,3037,59,3096,33
2021-01-24,Merced,047,269075,25558,25047,707,25754,305
2021-01-24,Modoc,049,8938,303,285,92,377,0
2021-01-24,Mono,051,14174,1118,1113,14,1127,3
2021-01-24,Monterey,053,433212,38635,37527,1269,38796,254
2021-01-24,Napa,055,140530,8270,8005,30,8035,43
2021-01-24,Nevada,057,99092,3558,3349,138,3487,18
2021-01-24,Orange,059,3164182,229602,223853,9158,233011,2632
2021-01-24,Placer,061,380077,18999,17839,923,18762,193
2021-01-24,Plumas,063,18699,610,532,10,542,2
2021-01-24,Riverside,065,2383286,266531,256767,12382,269149,2761
2021-01-24,Sacramento,067,1510023,85926,84110,1008,85118,1112
2021-01-24,San Benito,069,59416,5310,5223,63,5286,43
2021-01-24,San Bernardino,071,2135413,271616,262370,7841,270211,1935
2021-01-24,San Diego,073,3302833,240359,227193,11167,238360,2375
2021-01-24,San Francisco,075,870044,31051,30559,773,31332,275
2021-01-24,San Joaquin,077,732212,61243,59021,2362,61383,838
2021-01-24,San Luis Obispo,079,281455,17609,16758,451,17209,179
2021-01-24,San Mateo,081,765935,35943,33956,314,34270,213
2021-01-24,Santa Barbara,083,443738,28372,26735,834,27569,269
2021-01-24,Santa Clara,085,1922200,100379,98103,441,98544,1109
2021-01-24,Santa Cruz,087,273765,14061,12905,652,13557,133
2021-01-24,Shasta,089,179085,10164,9978,1039,11017,103
2021-01-24,Sierra,091,2930,47,42,12,54,0
2021-01-24,Siskiyou,093,43540,1295,1195,184,1379,4
2021-01-24,Solano,095,438530,27277,26515,299,26814,109
2021-01-24,Sonoma,097,501317,25527,25045,127,25172,233
2021-01-24,Stanislaus,099,539301,45919,44031,4592,48623,599
2021-01-24,Sutter,101,95872,8099,7980,76,8056,83
2021-01-24,Tehama,103,63373,4196,4062,440,4502,20
2021-01-24,Trinity,105,12862,439,262,63,325,3
2021-01-24,Tulare,107,460477,44697,43006,6266,49272,577
2021-01-24,Tuolumne,109,53932,3433,3416,33,3449,29
2021-01-24,Ventura,111,848112,68776,66347,2398,68745,439
2021-01-24,Yolo,113,214977,11818,11210,111,11321,140
2021-01-24,Yuba,115,75493,5038,4875,68,4943,31
2021-01-23,Alameda,001,1643700,72781,70080,1491,71571,780
2021-01-23,Alpine,003,1148,73,72,0,72,0
2021-01-23,Amador,005,37829,3129,3049,24,3073,30
2021-01-23,Butte,007,227075,10408,9757,1410,11167,133
2021-01-23,Calaveras,009,45235,1708,1695,10,1705,21
2021-01-23,Colusa,011,21464,1727,1672,188,1860,8
2021-01-23,Contra Costa,013,1133247,56727,54162,920,55082,487
2021-01-23,Del Norte,015,27424,884,855,4,859,2
2021-01-23,El Dorado,017,186661,8448,7984,552,8536,66
2021-01-23,Fresno,019,978130,89357,85274,6658,91932,910
2021-01-23,Glenn,021,27897,2085,2015,423,2438,13
2021-01-23,Humboldt,023,135768,2679,2493,16,2509,23
2021-01-23,Imperial,025,180216,26246,25581,2268,27849,487
2021-01-23,Inyo,027,18085,1045,987,8,995,27
2021-01-23,Kern,029,883053,86103,82602,7925,90527,783
2021-01-23,Kings,031,150075,20608,19904,812,20716,159
2021-01-23,Lake,033,64148,2804,2673,0,2673,32
2021-01-23,Lassen,035,31185,4891,4816,80,4896,1
2021-01-23,Los Angeles,037,10098052,1092727,1040961,34616,1075577,15034
2021-01-23,Madera,039,155013,14448,13858,683,14541,86
2021-01-23,Marin,041,260295,12123,11796,125,11921,177
2021-01-23,Mariposa,043,17540,346,323,3,326,3
2021-01-23,Mendocino,045,87422,3204,2991,59,3050,32
2021-01-23,Merced,047,269075,25466,24787,693,25480,303
2021-01-23,Modoc,049,8938,303,285,92,377,0
2021-01-23,Mono,051,14174,1116,1111,14,1125,3
2021-01-23,Monterey,053,433212,38552,37165,1264,38429,253
2021-01-23,Napa,055,140530,8245,7893,30,7923,43
2021-01-23,Nevada,057,99092,3547,3332,137,3469,18
2021-01-23,Orange,059,3164182,228834,221722,9118,230840,2618
2021-01-23,Placer,061,380077,18948,17617,918,18535,193
2021-01-23,Plumas,063,18699,609,528,10,538,2
2021-01-23,Riverside,065,2383286,265631,253636,12332,265968,2733
2021-01-23,Sacramento,067,1510023,85698,83408,1005,84413,1108
2021-01-23,San Benito,069,59416,5286,5166,62,5228,43
2021-01-23,San Bernardino,071,2135413,271066,260381,7811,268192,1922
2021-01-23,San Diego,073,3302833,239298,225556,11095,236651,2344
2021-01-23,San Francisco,075,870044,30947,30308,744,31052,268
2021-01-23,San Joaquin,077,732212,61117,58164,2352,60516,836
2021-01-23,San Luis Obispo,079,281455,17545,16652,448,17100,176
2021-01-23,San Mateo,081,765935,35767,33696,303,33999,213
2021-01-23,Santa Barbara,083,443738,28187,26234,825,27059,264
2021-01-23,Santa Clara,085,1922200,100023,97189,440,97629,1086
2021-01-23,Santa Cruz,087,273765,14003,12771,649,13420,127
2021-01-23,Shasta,089,179085,10135,9951,1038,10989,103
2021-01-23,Sierra,091,2930,47,41,12,53,0
2021-01-23,Siskiyou,093,43540,1285,1190,183,1373,4
2021-01-23,Solano,095,438530,27184,26261,297,26558,107
2021-01-23,Sonoma,097,501317,25447,24790,127,24917,232
2021-01-23,Stanislaus,099,539301,45752,43723,4561,48284,599
2021-01-23,Sutter,101,95872,8081,7943,75,8018,80
2021-01-23,Tehama,103,63373,4177,4006,439,4445,20
2021-01-23,Trinity,105,12862,439,262,63,325,3
2021-01-23,Tulare,107,460477,44544,42661,6206,48867,575
2021-01-23,Tuolumne,109,53932,3426,3407,33,3440,29
2021-01-23,Ventura,111,848112,68326,65581,2375,67956,438
2021-01-23,Yolo,113,214977,11776,11087,110,11197,141
2021-01-23,Yuba,115,75493,5026,4831,67,4898,30
2021-01-22,Alameda,001,1643700,72460,69693,1485,71178,751
2021-01-22,Alpine,003,1148,73,71,0,71,0
2021-01-22,Amador,005,37829,3124,3042,24,3066,30
2021-01-22,Butte,007,227075,10364,9711,1397,11108,133
2021-01-22,Calaveras,009,45235,1699,1672,10,1682,21
2021-01-22,Colusa,011,21464,1725,1668,188,1856,7
2021-01-22,Contra Costa,013,1133247,56490,53887,914,54801,485
2021-01-22,Del Norte,015,27424,883,852,4,856,2
2021-01-22,El Dorado,017,186661,8414,7877,549,8426,64
2021-01-22,Fresno,019,978130,89016,84744,6630,91374,892
2021-01-22,Glenn,021,27897,2080,1985,417,2402,13
2021-01-22,Humboldt,023,135768,2655,2452,16,2468,23
2021-01-22,Imperial,025,180216,26211,25562,2253,27815,474
2021-01-22,Inyo,027,18085,1034,961,8,969,26
2021-01-22,Kern,029,883053,85806,82101,7849,89950,771
2021-01-22,Kings,031,150075,20532,19760,808,20568,159
2021-01-22,Lake,033,64148,2792,2681,0,2681,32
2021-01-22,Lassen,035,31185,4882,4765,79,4844,1
2021-01-22,Los Angeles,037,10098052,1088261,1031177,34427,1065604,14777
2021-01-22,Madera,039,155013,14388,13781,682,14463,86
2021-01-22,Marin,041,260295,12087,11769,123,11892,177
2021-01-22,Mariposa,043,17540,346,323,3,326,3
2021-01-22,Mendocino,045,87422,3179,2994,58,3052,32
2021-01-22,Merced,047,269075,25343,24616,686,25302,290
2021-01-22,Modoc,049,8938,303,285,92,377,0
2021-01-22,Mono,051,14174,1116,1108,14,1122,3
2021-01-22,Monterey,053,433212,38400,36909,1259,38168,253
2021-01-22,Napa,055,140530,8199,7828,30,7858,40
2021-01-22,Nevada,057,99092,3522,3296,136,3432,18
2021-01-22,Orange,059,3164182,227882,220384,9071,229455,2542
2021-01-22,Placer,061,380077,18891,17636,903,18539,193
2021-01-22,Plumas,063,18699,607,522,10,532,2
2021-01-22,Riverside,065,2383286,264486,252440,12266,264706,2710
2021-01-22,Sacramento,067,1510023,85368,82861,997,83858,1094
2021-01-22,San Benito,069,59416,5260,5143,62,5205,43
2021-01-22,San Bernardino,071,2135413,270254,259121,7781,266902,1849
2021-01-22,San Diego,073,3302833,238058,222576,11030,233606,2301
2021-01-22,San Francisco,075,870044,30834,30027,727,30754,266
2021-01-22,San Joaquin,077,732212,60935,58485,2340,60825,812
2021-01-22,San Luis Obispo,079,281455,17456,16336,445,16781,172
2021-01-22,San Mateo,081,765935,35545,33401,300,33701,211
2021-01-22,Santa Barbara,083,443738,27986,25989,814,26803,256
2021-01-22,Santa Clara,085,1922200,99584,96435,437,96872,1062
2021-01-22,Santa Cruz,087,273765,13945,12687,645,13332,123
2021-01-22,Shasta,089,179085,10115,9866,1036,10902,103
2021-01-22,Sierra,091,2930,47,40,12,52,0
2021-01-22,Siskiyou,093,43540,1281,1182,181,1363,4
2021-01-22,Solano,095,438530,27094,26048,295,26343,107
2021-01-22,Sonoma,097,501317,25362,24659,127,24786,232
2021-01-22,Stanislaus,099,539301,45586,43489,4535,48024,599
2021-01-22,Sutter,101,95872,8056,7878,75,7953,80
2021-01-22,Tehama,103,63373,4161,3993,437,4430,19
2021-01-22,Trinity,105,12862,438,263,63,326,3
2021-01-22,Tulare,107,460477,44364,42307,6139,48446,573
2021-01-22,Tuolumne,109,53932,3398,3379,33,3412,29
2021-01-22,Ventura,111,848112,67820,64404,2357,66761,426
2021-01-22,Yolo,113,214977,11742,11014,108,11122,141
2021-01-22,Yuba,115,75493,5002,4789,65,4854,29
2021-01-21,Alameda,001,1643700,72024,69314,1468,70782,739
2021-01-21,Alpine,003,1148,73,71,0,71,0
2021-01-21,Amador,005,37829,3102,3038,24,3062,29
2021-01-21,Butte,007,227075,10300,9643,1390,11033,130
2021-01-21,Calaveras,009,45235,1690,1647,10,1657,21
2021-01-21,Colusa,011,21464,1718,1662,185,1847,7
2021-01-21,Contra Costa,013,1133247,56082,53595,901,54496,478
2021-01-21,Del Norte,015,27424,881,850,3,853,2
2021-01-21,El Dorado,017,186661,8365,7823,546,8369,58
2021-01-21,Fresno,019,978130,88612,84137,6590,90727,889
2021-01-21,Glenn,021,27897,2072,1964,412,2376,13
2021-01-21,Humboldt,023,135768,2632,2423,16,2439,23
2021-01-21,Imperial,025,180216,26121,25509,2240,27749,463
2021-01-21,Inyo,027,18085,1025,946,8,954,26
2021-01-21,Kern,029,883053,85394,81328,7734,89062,769
2021-01-21,Kings,031,150075,20461,19633,791,20424,158
2021-01-21,Lake,033,64148,2777,2669,0,2669,32
2021-01-21,Lassen,035,31185,4875,4763,79,4842,1
2021-01-21,Los Angeles,037,10098052,1081596,1023055,34112,1057167,14537
2021-01-21,Madera,039,155013,14320,13664,674,14338,86
2021-01-21,Marin,041,260295,12032,11732,121,11853,173
2021-01-21,Mariposa,043,17540,342,322,3,325,3
2021-01-21,Mendocino,045,87422,3156,2967,56,3023,32
2021-01-21,Merced,047,269075,25188,24426,679,25105,245
2021-01-21,Modoc,049,8938,300,284,91,375,0
2021-01-21,Mono,051,14174,1111,1104,14,1118,3
2021-01-21,Monterey,053,433212,38120,36149,1250,37399,253
2021-01-21,Napa,055,140530,8135,7774,30,7804,40
2021-01-21,Nevada,057,99092,3493,3274,135,3409,18
2021-01-21,Orange,059,3164182,226506,218867,9017,227884,2540
2021-01-21,Placer,061,380077,18812,17553,899,18452,190
2021-01-21,Plumas,063,18699,603,518,10,528,2
2021-01-21,Riverside,065,2383286,262764,251007,12188,263195,2676
2021-01-21,Sacramento,067,1510023,84889,82303,977,83280,1084
2021-01-21,San Benito,069,59416,5230,5100,57,5157,43
2021-01-21,San Bernardino,071,2135413,268914,257754,7717,265471,1832
2021-01-21,San Diego,073,3302833,236283,219729,10923,230652,2222
2021-01-21,San Francisco,075,870044,30658,29801,693,30494,266
2021-01-21,San Joaquin,077,732212,60625,58270,2322,60592,806
2021-01-21,San Luis Obispo,079,281455,17370,16153,437,16590,169
2021-01-21,San Mateo,081,765935,35299,33156,287,33443,210
2021-01-21,Santa Barbara,083,443738,27698,25654,801,26455,253
2021-01-21,Santa Clara,085,1922200,98961,96028,431,96459,1062
2021-01-21,Santa Cruz,087,273765,13861,12548,635,13183,119
2021-01-21,Shasta,089,179085,10072,9795,1021,10816,98
2021-01-21,Sierra,091,2930,47,40,12,52,0
2021-01-21,Siskiyou,093,43540,1278,1178,179,1357,4
2021-01-21,Solano,095,438530,26914,25885,291,26176,106
2021-01-21,Sonoma,097,501317,25222,24440,125,24565,230
2021-01-21,Stanislaus,099,539301,45288,43223,4491,47714,599
2021-01-21,Sutter,101,95872,8022,7822,75,7897,80
2021-01-21,Tehama,103,63373,4122,3938,437,4375,19
2021-01-21,Trinity,105,12862,438,261,63,324,3
2021-01-21,Tulare,107,460477,44153,42082,6065,48147,569
2021-01-21,Tuolumne,109,53932,3388,3365,32,3397,29
2021-01-21,Ventura,111,848112,67126,63995,2336,66331,420
2021-01-21,Yolo,113,214977,11651,10940,100,11040,141
2021-01-21,Yuba,115,75493,4970,4757,64,4821,29
2021-01-20,Alameda,001,1643700,71550,68785,1452,70237,702
2021-01-20,Alpine,003,1148,73,71,0,71,0
2021-01-20,Amador,005,37829,3071,3036,24,3060,29
2021-01-20,Butte,007,227075,10244,9582,1380,10962,130
2021-01-20,Calaveras,009,45235,1668,1637,9,1646,21
2021-01-20,Colusa,011,21464,1701,1630,180,1810,7
2021-01-20,Contra Costa,013,1133247,55625,53108,894,54002,461
2021-01-20,Del Norte,015,27424,880,848,3,851,2
2021-01-20,El Dorado,017,186661,8315,7785,543,8328,53
2021-01-20,Fresno,019,978130,88194,83591,6537,90128,872
2021-01-20,Glenn,021,27897,2053,1955,410,2365,13
2021-01-20,Humboldt,023,135768,2589,2390,16,2406,22
2021-01-20,Imperial,025,180216,26049,25380,2206,27586,461
2021-01-20,Inyo,027,18085,1015,901,8,909,26
2021-01-20,Kern,029,883053,84944,80701,7627,88328,754
2021-01-20,Kings,031,150075,20371,19522,783,20305,146
2021-01-20,Lake,033,64148,2756,2646,0,2646,31
2021-01-20,Lassen,035,31185,4867,4758,77,4835,1
2021-01-20,Los Angeles,037,10098052,1074094,1015608,33831,1049439,14299
2021-01-20,Madera,039,155013,14256,13585,670,14255,86
2021-01-20,Marin,041,260295,11978,11684,119,11803,171
2021-01-20,Mariposa,043,17540,340,322,3,325,3
2021-01-20,Mendocino,045,87422,3141,2957,56,3013,32
2021-01-20,Merced,047,269075,25015,24220,657,24877,243
2021-01-20,Modoc,049,8938,299,282,91,373,0
2021-01-20,Mono,051,14174,1104,1105,13,1118,3
2021-01-20,Monterey,053,433212,37808,35960,1230,37190,249
2021-01-20,Napa,055,140530,8066,7731,30,7761,40
2021-01-20,Nevada,057,99092,3461,3238,135,3373,18
2021-01-20,Orange,059,3164182,224971,216893,8956,225849,2500
2021-01-20,Placer,061,380077,18718,17455,881,18336,186
2021-01-20,Plumas,063,18699,601,512,10,522,2
2021-01-20,Riverside,065,2383286,260720,248686,12105,260791,2615
2021-01-20,Sacramento,067,1510023,84329,81687,967,82654,1072
2021-01-20,San Benito,069,59416,5199,5036,56,5092,35
2021-01-20,San Bernardino,071,2135413,267571,255921,7670,263591,1801
2021-01-20,San Diego,073,3302833,234428,218553,10819,229372,2174
2021-01-20,San Francisco,075,870044,30470,29665,673,30338,262
2021-01-20,San Joaquin,077,732212,60221,58025,2313,60338,783
2021-01-20,San Luis Obispo,079,281455,17188,15936,428,16364,164
2021-01-20,San Mateo,081,765935,35072,32929,286,33215,210
2021-01-20,Santa Barbara,083,443738,27380,25312,789,26101,248
2021-01-20,Santa Clara,085,1922200,98280,94995,429,95424,1040
2021-01-20,Santa Cruz,087,273765,13754,12460,622,13082,107
2021-01-20,Shasta,089,179085,10020,9697,1011,10708,98
2021-01-20,Sierra,091,2930,47,40,12,52,0
2021-01-20,Siskiyou,093,43540,1271,1163,178,1341,4
2021-01-20,Solano,095,438530,26721,25659,287,25946,106
2021-01-20,Sonoma,097,501317,25085,24262,123,24385,223
2021-01-20,Stanislaus,099,539301,45008,42955,4453,47408,585
2021-01-20,Sutter,101,95872,7971,7772,73,7845,80
2021-01-20,Tehama,103,63373,4096,3892,435,4327,19
2021-01-20,Trinity,105,12862,438,260,63,323,3
2021-01-20,Tulare,107,460477,43895,41799,5975,47774,559
2021-01-20,Tuolumne,109,53932,3374,3355,31,3386,29
2021-01-20,Ventura,111,848112,66165,63413,2307,65720,395
2021-01-20,Yolo,113,214977,11583,10852,97,10949,141
2021-01-20,Yuba,115,75493,4943,4729,64,4793,29
2021-01-19,Alameda,001,1643700,70908,68434,1443,69877,680
2021-01-19,Alpine,003,1148,73,71,0,71,0
2021-01-19,Amador,005,37829,3062,3024,24,3048,28
2021-01-19,Butte,007,227075,10181,9528,1366,10894,129
2021-01-19,Calaveras,009,45235,1653,1621,8,1629,21
2021-01-19,Colusa,011,21464,1679,1617,177,1794,7
2021-01-19,Contra Costa,013,1133247,55132,52730,883,53613,448
2021-01-19,Del Norte,015,27424,878,843,3,846,2
2021-01-19,El Dorado,017,186661,8254,7743,535,8278,47
2021-01-19,Fresno,019,978130,87672,83200,6487,89687,857
2021-01-19,Glenn,021,27897,2041,1948,405,2353,13
2021-01-19,Humboldt,023,135768,2565,2359,13,2372,22
2021-01-19,Imperial,025,180216,25968,25333,2190,27523,452
2021-01-19,Inyo,027,18085,1008,891,8,899,26
2021-01-19,Kern,029,883053,84355,80272,7522,87794,742
2021-01-19,Kings,031,150075,20232,19375,773,20148,143
2021-01-19,Lake,033,64148,2741,2625,0,2625,31
2021-01-19,Lassen,035,31185,4860,4753,77,4830,1
2021-01-19,Los Angeles,037,10098052,1065416,1010375,33564,1043939,14014
2021-01-19,Madera,039,155013,14140,13528,663,14191,86
2021-01-19,Marin,041,260295,11921,11654,115,11769,169
2021-01-19,Mariposa,043,17540,340,322,3,325,3
2021-01-19,Mendocino,045,87422,3124,2930,56,2986,32
2021-01-19,Merced,047,269075,24803,24108,648,24756,242
2021-01-19,Modoc,049,8938,298,281,91,372,0
2021-01-19,Mono,051,14174,1103,1106,13,1119,3
2021-01-19,Monterey,053,433212,37506,35840,1209,37049,248
2021-01-19,Napa,055,140530,8007,7672,30,7702,38
2021-01-19,Nevada,057,99092,3442,3216,133,3349,18
2021-01-19,Orange,059,3164182,223237,215244,8889,224133,2468
2021-01-19,Placer,061,380077,18621,17348,871,18219,182
2021-01-19,Plumas,063,18699,594,509,10,519,2
2021-01-19,Riverside,065,2383286,258633,246248,12027,258275,2585
2021-01-19,Sacramento,067,1510023,83792,81183,947,82130,1053
2021-01-19,San Benito,069,59416,5153,4988,55,5043,35
2021-01-19,San Bernardino,071,2135413,265854,253651,7614,261265,1777
2021-01-19,San Diego,073,3302833,232005,216833,10721,227554,2109
2021-01-19,San Francisco,075,870044,30251,29502,642,30144,261
2021-01-19,San Joaquin,077,732212,59838,57655,2302,59957,782
2021-01-19,San Luis Obispo,079,281455,16925,15855,425,16280,161
2021-01-19,San Mateo,081,765935,34787,32730,275,33005,208
2021-01-19,Santa Barbara,083,443738,26996,24991,773,25764,236
2021-01-19,Santa Clara,085,1922200,97509,94483,428,94911,1010
2021-01-19,Santa Cruz,087,273765,13637,12410,614,13024,106
2021-01-19,Shasta,089,179085,9984,9614,1001,10615,93
2021-01-19,Sierra,091,2930,47,40,10,50,0
2021-01-19,Siskiyou,093,43540,1263,1149,176,1325,4
2021-01-19,Solano,095,438530,26474,25520,286,25806,106
2021-01-19,Sonoma,097,501317,24905,24133,121,24254,223
2021-01-19,Stanislaus,099,539301,44660,42723,4408,47131,561
2021-01-19,Sutter,101,95872,7921,7709,67,7776,80
2021-01-19,Tehama,103,63373,4064,3876,433,4309,19
2021-01-19,Trinity,105,12862,437,260,63,323,3
2021-01-19,Tulare,107,460477,43617,41559,5880,47439,549
2021-01-19,Tuolumne,109,53932,3347,3328,31,3359,29
2021-01-19,Ventura,111,848112,65486,62656,2280,64936,383
2021-01-19,Yolo,113,214977,11496,10789,97,10886,134
2021-01-19,Yuba,115,75493,4910,4695,63,4758,29
2021-01-18,Alameda,001,1643700,70276,67938,1425,69363,680
2021-01-18,Alpine,003,1148,73,71,0,71,0
2021-01-18,Amador,005,37829,3048,3016,24,3040,28
2021-01-18,Butte,007,227075,10096,9474,1354,10828,129
2021-01-18,Calaveras,009,45235,1632,1617,7,1624,21
2021-01-18,Colusa,011,21464,1662,1608,176,1784,7
2021-01-18,Contra Costa,013,1133247,54614,52323,875,53198,448
2021-01-18,Del Norte,015,27424,877,840,3,843,2
2021-01-18,El Dorado,017,186661,8186,7707,533,8240,47
2021-01-18,Fresno,019,978130,87061,82485,6421,88906,857
2021-01-18,Glenn,021,27897,2024,1935,401,2336,13
2021-01-18,Humboldt,023,135768,2527,2343,13,2356,22
2021-01-18,Imperial,025,180216,25899,25317,2166,27483,452
2021-01-18,Inyo,027,18085,996,872,8,880,26
2021-01-18,Kern,029,883053,83718,79930,7431,87361,740
2021-01-18,Kings,031,150075,20062,19267,761,20028,141
2021-01-18,Lake,033,64148,2724,2591,0,2591,30
2021-01-18,Lassen,035,31185,4824,4749,76,4825,1
2021-01-18,Los Angeles,037,10098052,1055912,1002614,33277,1035891,13828
2021-01-18,Madera,039,155013,14027,13443,655,14098,85
2021-01-18,Marin,041,260295,11874,11607,113,11720,165
2021-01-18,Mariposa,043,17540,337,320,2,322,3
2021-01-18,Mendocino,045,87422,3101,2919,56,2975,31
2021-01-18,Merced,047,269075,24558,23927,632,24559,242
2021-01-18,Modoc,049,8938,295,281,88,369,0
2021-01-18,Mono,051,14174,1100,1101,13,1114,3
2021-01-18,Monterey,053,433212,37064,35549,1195,36744,247
2021-01-18,Napa,055,140530,7933,7601,30,7631,38
2021-01-18,Nevada,057,99092,3404,3199,133,3332,17
2021-01-18,Orange,059,3164182,221340,213866,8835,222701,2405
2021-01-18,Placer,061,380077,18505,17263,862,18125,182
2021-01-18,Plumas,063,18699,591,506,10,516,2
2021-01-18,Riverside,065,2383286,256321,244151,11934,256085,2568
2021-01-18,Sacramento,067,1510023,83122,80546,931,81477,1046
2021-01-18,San Benito,069,59416,5105,4963,53,5016,35
2021-01-18,San Bernardino,071,2135413,264106,252808,7559,260367,1775
2021-01-18,San Diego,073,3302833,229357,214335,10592,224927,2103
2021-01-18,San Francisco,075,870044,30045,29321,618,29939,259
2021-01-18,San Joaquin,077,732212,59322,57405,2280,59685,782
2021-01-18,San Luis Obispo,079,281455,16738,15742,415,16157,158
2021-01-18,San Mateo,081,765935,34474,32515,256,32771,208
2021-01-18,Santa Barbara,083,443738,26617,24638,760,25398,235
2021-01-18,Santa Clara,085,1922200,96631,93688,424,94112,992
2021-01-18,Santa Cruz,087,273765,13504,12298,601,12899,106
2021-01-18,Shasta,089,179085,9945,9600,991,10591,92
2021-01-18,Sierra,091,2930,46,40,10,50,0
2021-01-18,Siskiyou,093,43540,1251,1144,175,1319,4
2021-01-18,Solano,095,438530,26197,25344,282,25626,105
2021-01-18,Sonoma,097,501317,24637,24068,120,24188,223
2021-01-18,Stanislaus,099,539301,44303,42413,4352,46765,562
2021-01-18,Sutter,101,95872,7864,7680,65,7745,78
2021-01-18,Tehama,103,63373,4020,3854,426,4280,19
2021-01-18,Trinity,105,12862,437,260,63,323,3
2021-01-18,Tulare,107,460477,43328,41196,5774,46970,549
2021-01-18,Tuolumne,109,53932,3323,3318,30,3348,28
2021-01-18,Ventura,111,848112,65056,61859,2258,64117,379
2021-01-18,Yolo,113,214977,11367,10620,94,10714,134
2021-01-18,Yuba,115,75493,4883,4671,61,4732,29
2021-01-17,Alameda,001,1643700,69712,67375,1407,68782,676
2021-01-17,Alpine,003,1148,73,71,0,71,0
2021-01-17,Amador,005,37829,3041,3001,24,3025,28
2021-01-17,Butte,007,227075,10021,9411,1330,10741,129
2021-01-17,Calaveras,009,45235,1619,1608,7,1615,21
2021-01-17,Colusa,011,21464,1648,1588,172,1760,7
2021-01-17,Contra Costa,013,1133247,54123,51932,865,52797,447
2021-01-17,Del Norte,015,27424,877,838,3,841,2
2021-01-17,El Dorado,017,186661,8130,7659,522,8181,47
2021-01-17,Fresno,019,978130,86508,82039,6345,88384,857
2021-01-17,Glenn,021,27897,2013,1924,396,2320,9
2021-01-17,Humboldt,023,135768,2491,2322,11,2333,22
2021-01-17,Imperial,025,180216,25829,25253,2123,27376,451
2021-01-17,Inyo,027,18085,990,864,8,872,26
2021-01-17,Kern,029,883053,83168,79489,7346,86835,738
2021-01-17,Kings,031,150075,19926,19201,747,19948,131
2021-01-17,Lake,033,64148,2708,2572,0,2572,30
2021-01-17,Lassen,035,31185,4816,4740,75,4815,1
2021-01-17,Los Angeles,037,10098052,1049256,993028,32885,1025913,13741
2021-01-17,Madera,039,155013,13935,13328,650,13978,85
2021-01-17,Marin,041,260295,11821,11552,111,11663,164
2021-01-17,Mariposa,043,17540,337,319,2,321,3
2021-01-17,Mendocino,045,87422,3073,2912,55,2967,31
2021-01-17,Merced,047,269075,24346,23800,614,24414,242
2021-01-17,Modoc,049,8938,294,279,88,367,0
2021-01-17,Mono,051,14174,1093,1091,12,1103,3
2021-01-17,Monterey,053,433212,36820,35340,1169,36509,244
2021-01-17,Napa,055,140530,7877,7521,30,7551,38
2021-01-17,Nevada,057,99092,3379,3176,131,3307,17
2021-01-17,Orange,059,3164182,219342,212389,8760,221149,2359
2021-01-17,Placer,061,380077,18399,17194,847,18041,181
2021-01-17,Plumas,063,18699,589,505,9,514,2
2021-01-17,Riverside,065,2383286,254212,242206,11818,254024,2534
2021-01-17,Sacramento,067,1510023,82520,80154,919,81073,1045
2021-01-17,San Benito,069,59416,5067,4941,53,4994,35
2021-01-17,San Bernardino,071,2135413,261989,251487,7472,258959,1775
2021-01-17,San Diego,073,3302833,227163,211785,10485,222270,2103
2021-01-17,San Francisco,075,870044,29858,29139,581,29720,255
2021-01-17,San Joaquin,077,732212,58964,57094,2266,59360,780
2021-01-17,San Luis Obispo,079,281455,16616,15658,406,16064,157
2021-01-17,San Mateo,081,765935,34222,32186,233,32419,208
2021-01-17,Santa Barbara,083,443738,26157,24401,748,25149,235
2021-01-17,Santa Clara,085,1922200,95880,92752,421,93173,976
2021-01-17,Santa Cruz,087,273765,13392,12196,598,12794,106
2021-01-17,Shasta,089,179085,9887,9588,983,10571,92
2021-01-17,Sierra,091,2930,46,38,9,47,0
2021-01-17,Siskiyou,093,43540,1244,1136,172,1308,4
2021-01-17,Solano,095,438530,25968,25216,280,25496,105
2021-01-17,Sonoma,097,501317,24463,23871,120,23991,223
2021-01-17,Stanislaus,099,539301,43984,42221,4289,46510,562
2021-01-17,Sutter,101,95872,7801,7604,64,7668,77
2021-01-17,Tehama,103,63373,3989,3837,422,4259,18
2021-01-17,Trinity,105,12862,437,261,63,324,3
2021-01-17,Tulare,107,460477,43037,41016,5658,46674,549
2021-01-17,Tuolumne,109,53932,3306,3287,30,3317,27
2021-01-17,Ventura,111,848112,64208,61257,2211,63468,376
2021-01-17,Yolo,113,214977,11267,10519,92,10611,134
2021-01-17,Yuba,115,75493,4833,4640,58,4698,28
2021-01-16,Alameda,001,1643700,69390,66583,1395,67978,673
2021-01-16,Alpine,003,1148,73,71,0,71,0
2021-01-16,Amador,005,37829,3038,2986,24,3010,28
2021-01-16,Butte,007,227075,9990,9359,1310,10669,129
2021-01-16,Calaveras,009,45235,1606,1596,7,1603,21
2021-01-16,Colusa,011,21464,1636,1578,172,1750,7
2021-01-16,Contra Costa,013,1133247,53857,51363,858,52221,443
2021-01-16,Del Norte,015,27424,872,833,3,836,2
2021-01-16,El Dorado,017,186661,8108,7575,521,8096,47
2021-01-16,Fresno,019,978130,86234,81294,6291,87585,846
2021-01-16,Glenn,021,27897,2009,1894,393,2287,9
2021-01-16,Humboldt,023,135768,2471,2294,9,2303,22
2021-01-16,Imperial,025,180216,25794,25140,2116,27256,451
2021-01-16,Inyo,027,18085,986,845,8,853,25
2021-01-16,Kern,029,883053,82802,78865,7292,86157,733
2021-01-16,Kings,031,150075,19870,19072,744,19816,131
2021-01-16,Lake,033,64148,2697,2504,0,2504,30
2021-01-16,Lassen,035,31185,4804,4719,75,4794,1
2021-01-16,Los Angeles,037,10098052,1045174,982684,32647,1015331,13654
2021-01-16,Madera,039,155013,13868,13193,645,13838,85
2021-01-16,Marin,041,260295,11778,11482,111,11593,164
2021-01-16,Mariposa,043,17540,336,317,2,319,3
2021-01-16,Mendocino,045,87422,3059,2890,52,2942,31
2021-01-16,Merced,047,269075,24258,23478,600,24078,242
2021-01-16,Modoc,049,8938,294,278,88,366,0
2021-01-16,Mono,051,14174,1091,1079,12,1091,3
2021-01-16,Monterey,053,433212,36709,34972,1153,36125,243
2021-01-16,Napa,055,140530,7838,7356,30,7386,39
2021-01-16,Nevada,057,99092,3346,3144,131,3275,17
2021-01-16,Orange,059,3164182,218309,210111,8704,218815,2312
2021-01-16,Placer,061,380077,18335,16995,845,17840,177
2021-01-16,Plumas,063,18699,587,502,9,511,2
2021-01-16,Riverside,065,2383286,252855,239412,11703,251115,2506
2021-01-16,Sacramento,067,1510023,82146,79122,902,80024,1033
2021-01-16,San Benito,069,59416,5034,4875,53,4928,35
2021-01-16,San Bernardino,071,2135413,261194,249401,7405,256806,1755
2021-01-16,San Diego,073,3302833,225865,209895,10388,220283,2065
2021-01-16,San Francisco,075,870044,29730,28853,550,29403,244
2021-01-16,San Joaquin,077,732212,58715,56642,2234,58876,776
2021-01-16,San Luis Obispo,079,281455,16515,15466,404,15870,152
2021-01-16,San Mateo,081,765935,34058,31805,227,32032,208
2021-01-16,Santa Barbara,083,443738,25956,24088,744,24832,229
2021-01-16,Santa Clara,085,1922200,95409,91584,414,91998,954
2021-01-16,Santa Cruz,087,273765,13333,12026,596,12622,106
2021-01-16,Shasta,089,179085,9854,9547,979,10526,92
2021-01-16,Sierra,091,2930,45,38,9,47,0
2021-01-16,Siskiyou,093,43540,1239,1124,172,1296,4
2021-01-16,Solano,095,438530,25860,24732,276,25008,103
2021-01-16,Sonoma,097,501317,24372,23607,119,23726,223
2021-01-16,Stanislaus,099,539301,43796,41809,4239,46048,562
2021-01-16,Sutter,101,95872,7769,7560,64,7624,76
2021-01-16,Tehama,103,63373,3975,3783,422,4205,18
2021-01-16,Trinity,105,12862,437,261,63,324,3
2021-01-16,Tulare,107,460477,42858,40655,5585,46240,542
2021-01-16,Tuolumne,109,53932,3298,3269,30,3299,27
2021-01-16,Ventura,111,848112,63656,60368,2181,62549,369
2021-01-16,Yolo,113,214977,11218,10406,91,10497,134
2021-01-16,Yuba,115,75493,4802,4602,58,4660,27
2021-01-15,Alameda,001,1643700,68965,65416,1384,66800,672
2021-01-15,Alpine,003,1148,73,71,0,71,0
2021-01-15,Amador,005,37829,3031,2953,24,2977,28
2021-01-15,Butte,007,227075,9948,9233,1295,10528,129
2021-01-15,Calaveras,009,45235,1599,1538,7,1545,21
2021-01-15,Colusa,011,21464,1625,1541,167,1708,7
2021-01-15,Contra Costa,013,1133247,53527,50408,851,51259,428
2021-01-15,Del Norte,015,27424,868,828,2,830,2
2021-01-15,El Dorado,017,186661,8059,7439,513,7952,47
2021-01-15,Fresno,019,978130,85697,79950,6255,86205,832
2021-01-15,Glenn,021,27897,2005,1824,390,2214,9
2021-01-15,Humboldt,023,135768,2444,2218,8,2226,22
2021-01-15,Imperial,025,180216,25760,24944,2110,27054,446
2021-01-15,Inyo,027,18085,968,814,8,822,25
2021-01-15,Kern,029,883053,82386,77873,7227,85100,719
2021-01-15,Kings,031,150075,19761,18661,738,19399,131
2021-01-15,Lake,033,64148,2671,2434,0,2434,28
2021-01-15,Lassen,035,31185,4793,4693,73,4766,1
2021-01-15,Los Angeles,037,10098052,1038123,968979,32363,1001342,13404
2021-01-15,Madera,039,155013,13783,12883,642,13525,85
2021-01-15,Marin,041,260295,11727,11310,111,11421,160
2021-01-15,Mariposa,043,17540,334,307,2,309,3
2021-01-15,Mendocino,045,87422,3048,2835,52,2887,31
2021-01-15,Merced,047,269075,24145,23060,596,23656,239
2021-01-15,Modoc,049,8938,294,278,86,364,0
2021-01-15,Mono,051,14174,1088,1057,12,1069,3
2021-01-15,Monterey,053,433212,36492,34460,1096,35556,243
2021-01-15,Napa,055,140530,7776,7231,30,7261,38
2021-01-15,Nevada,057,99092,3333,3099,128,3227,17
2021-01-15,Orange,059,3164182,216957,207129,8652,215781,2254
2021-01-15,Placer,061,380077,18231,16712,836,17548,173
2021-01-15,Plumas,063,18699,584,499,9,508,2
2021-01-15,Riverside,065,2383286,250990,235235,11624,246859,2458
2021-01-15,Sacramento,067,1510023,81724,80279,894,81173,1023
2021-01-15,San Benito,069,59416,4995,4766,51,4817,35
2021-01-15,San Bernardino,071,2135413,260018,246182,7343,253525,1726
2021-01-15,San Diego,073,3302833,224116,206868,10323,217191,2037
2021-01-15,San Francisco,075,870044,29555,28574,530,29104,242
2021-01-15,San Joaquin,077,732212,58482,55885,2220,58105,748
2021-01-15,San Luis Obispo,079,281455,16382,15129,399,15528,148
2021-01-15,San Mateo,081,765935,33813,31291,223,31514,208
2021-01-15,Santa Barbara,083,443738,25673,23487,740,24227,226
2021-01-15,Santa Clara,085,1922200,94754,90103,409,90512,942
2021-01-15,Santa Cruz,087,273765,13224,11776,583,12359,105
2021-01-15,Shasta,089,179085,9815,9459,972,10431,91
2021-01-15,Sierra,091,2930,44,36,7,43,0
2021-01-15,Siskiyou,093,43540,1235,1119,172,1291,4
2021-01-15,Solano,095,438530,25710,24222,274,24496,103
2021-01-15,Sonoma,097,501317,24241,23204,118,23322,222
2021-01-15,Stanislaus,099,539301,43546,41178,4197,45375,562
2021-01-15,Sutter,101,95872,7722,7484,63,7547,75
2021-01-15,Tehama,103,63373,3953,3714,421,4135,17
2021-01-15,Trinity,105,12862,437,262,63,325,3
2021-01-15,Tulare,107,460477,42615,39951,5502,45453,535
2021-01-15,Tuolumne,109,53932,3282,3231,30,3261,27
2021-01-15,Ventura,111,848112,62912,59061,2148,61209,353
2021-01-15,Yolo,113,214977,11162,10240,90,10330,134
2021-01-15,Yuba,115,75493,4782,4549,58,4607,27
2021-01-14,Alameda,001,1643700,68336,64364,1368,65732,686
2021-01-14,Alpine,003,1148,73,71,0,71,0
2021-01-14,Amador,005,37829,3025,2940,24,2964,28
2021-01-14,Butte,007,227075,9860,9127,1273,10400,129
2021-01-14,Calaveras,009,45235,1582,1513,7,1520,21
2021-01-14,Colusa,011,21464,1610,1535,161,1696,7
2021-01-14,Contra Costa,013,1133247,52972,49545,838,50383,415
2021-01-14,Del Norte,015,27424,862,821,2,823,2
2021-01-14,El Dorado,017,186661,7985,7321,506,7827,45
2021-01-14,Fresno,019,978130,85064,79033,6175,85208,814
2021-01-14,Glenn,021,27897,1993,1798,385,2183,9
2021-01-14,Humboldt,023,135768,2401,2169,8,2177,22
2021-01-14,Imperial,025,180216,25651,24882,2077,26959,447
2021-01-14,Inyo,027,18085,961,790,8,798,25
2021-01-14,Kern,029,883053,81715,77070,7126,84196,705
2021-01-14,Kings,031,150075,19631,18405,734,19139,108
2021-01-14,Lake,033,64148,2628,2378,0,2378,27
2021-01-14,Lassen,035,31185,4783,4673,71,4744,1
2021-01-14,Los Angeles,037,10098052,1028094,954652,31995,986647,13147
2021-01-14,Madera,039,155013,13669,12742,631,13373,85
2021-01-14,Marin,041,260295,11653,11155,110,11265,159
2021-01-14,Mariposa,043,17540,331,302,2,304,3
2021-01-14,Mendocino,045,87422,3034,2801,50,2851,31
2021-01-14,Merced,047,269075,23918,22780,586,23366,239
2021-01-14,Modoc,049,8938,294,273,86,359,0
2021-01-14,Mono,051,14174,1080,1020,12,1032,3
2021-01-14,Monterey,053,433212,36071,34105,1074,35179,242
2021-01-14,Napa,055,140530,7690,7117,30,7147,38
2021-01-14,Nevada,057,99092,3306,3075,126,3201,17
2021-01-14,Orange,059,3164182,215027,204442,8568,213010,2162
2021-01-14,Placer,061,380077,18069,16488,829,17317,169
2021-01-14,Plumas,063,18699,576,496,9,505,2
2021-01-14,Riverside,065,2383286,248345,231684,11523,243207,2357
2021-01-14,Sacramento,067,1510023,81087,79137,871,80008,1007
2021-01-14,San Benito,069,59416,4959,4678,50,4728,35
2021-01-14,San Bernardino,071,2135413,258047,243379,7272,250651,1750
2021-01-14,San Diego,073,3302833,221722,204173,10203,214376,2005
2021-01-14,San Francisco,075,870044,29310,28200,484,28684,238
2021-01-14,San Joaquin,077,732212,57965,55058,2207,57265,739
2021-01-14,San Luis Obispo,079,281455,16220,14851,390,15241,146
2021-01-14,San Mateo,081,765935,33444,30694,214,30908,208
2021-01-14,Santa Barbara,083,443738,25252,23126,723,23849,219
2021-01-14,Santa Clara,085,1922200,93827,88505,403,88908,910
2021-01-14,Santa Cruz,087,273765,13077,11583,568,12151,109
2021-01-14,Shasta,089,179085,9766,9334,956,10290,90
2021-01-14,Sierra,091,2930,44,35,6,41,0
2021-01-14,Siskiyou,093,43540,1223,1108,169,1277,3
2021-01-14,Solano,095,438530,25451,23782,270,24052,103
2021-01-14,Sonoma,097,501317,24001,22910,118,23028,202
2021-01-14,Stanislaus,099,539301,43219,40597,4156,44753,574
2021-01-14,Sutter,101,95872,7663,7416,60,7476,74
2021-01-14,Tehama,103,63373,3925,3664,417,4081,17
2021-01-14,Trinity,105,12862,437,261,62,323,3
2021-01-14,Tulare,107,460477,42232,39565,5393,44958,533
2021-01-14,Tuolumne,109,53932,3261,3215,30,3245,28
2021-01-14,Ventura,111,848112,62040,57941,2111,60052,347
2021-01-14,Yolo,113,214977,11054,10097,86,10183,135
2021-01-14,Yuba,115,75493,4749,4496,58,4554,27
2021-01-13,Alameda,001,1643700,67585,63568,1352,64920,690
2021-01-13,Alpine,003,1148,73,71,0,71,0
2021-01-13,Amador,005,37829,3011,2914,24,2938,26
2021-01-13,Butte,007,227075,9778,9013,1258,10271,126
2021-01-13,Calaveras,009,45235,1560,1493,7,1500,21
2021-01-13,Colusa,011,21464,1598,1524,153,1677,7
2021-01-13,Contra Costa,013,1133247,52395,48877,826,49703,403
2021-01-13,Del Norte,015,27424,858,820,2,822,2
2021-01-13,El Dorado,017,186661,7892,7247,498,7745,43
2021-01-13,Fresno,019,978130,84345,78278,6134,84412,804
2021-01-13,Glenn,021,27897,1977,1792,376,2168,9
2021-01-13,Humboldt,023,135768,2368,2114,8,2122,22
2021-01-13,Imperial,025,180216,25527,24717,2044,26761,463
2021-01-13,Inyo,027,18085,949,785,8,793,25
2021-01-13,Kern,029,883053,81056,76049,7036,83085,704
2021-01-13,Kings,031,150075,19464,18121,713,18834,108
2021-01-13,Lake,033,64148,2585,2305,0,2305,27
2021-01-13,Lassen,035,31185,4776,4663,70,4733,1
2021-01-13,Los Angeles,037,10098052,1017302,937985,31595,969580,12873
2021-01-13,Madera,039,155013,13543,12570,626,13196,85
2021-01-13,Marin,041,260295,11597,11039,110,11149,161
2021-01-13,Mariposa,043,17540,329,304,2,306,3
2021-01-13,Mendocino,045,87422,3014,2790,50,2840,31
2021-01-13,Merced,047,269075,23680,22497,572,23069,241
2021-01-13,Modoc,049,8938,293,274,83,357,0
2021-01-13,Mono,051,14174,1076,1017,12,1029,3
2021-01-13,Monterey,053,433212,35647,33748,1050,34798,241
2021-01-13,Napa,055,140530,7576,7028,30,7058,36
2021-01-13,Nevada,057,99092,3282,3037,123,3160,17
2021-01-13,Orange,059,3164182,212938,201158,8499,209657,2172
2021-01-13,Placer,061,380077,17943,16272,815,17087,172
2021-01-13,Plumas,063,18699,574,490,9,499,2
2021-01-13,Riverside,065,2383286,245199,228192,11410,239602,2278
2021-01-13,Sacramento,067,1510023,80426,78268,864,79132,996
2021-01-13,San Benito,069,59416,4903,4583,49,4632,35
2021-01-13,San Bernardino,071,2135413,255660,240191,7199,247390,1759
2021-01-13,San Diego,073,3302833,219108,201578,10100,211678,1952
2021-01-13,San Francisco,075,870044,29071,27863,464,28327,238
2021-01-13,San Joaquin,077,732212,57345,54373,2178,56551,738
2021-01-13,San Luis Obispo,079,281455,16065,14625,379,15004,140
2021-01-13,San Mateo,081,765935,33105,30195,212,30407,207
2021-01-13,Santa Barbara,083,443738,24810,22714,707,23421,216
2021-01-13,Santa Clara,085,1922200,92850,87187,400,87587,911
2021-01-13,Santa Cruz,087,273765,12904,11423,554,11977,110
2021-01-13,Shasta,089,179085,9702,9180,942,10122,93
2021-01-13,Sierra,091,2930,44,33,6,39,0
2021-01-13,Siskiyou,093,43540,1217,1102,165,1267,3
2021-01-13,Solano,095,438530,25167,23503,267,23770,105
2021-01-13,Sonoma,097,501317,23751,22610,117,22727,206
2021-01-13,Stanislaus,099,539301,42827,40167,4103,44270,574
2021-01-13,Sutter,101,95872,7617,7350,59,7409,73
2021-01-13,Tehama,103,63373,3875,3589,412,4001,17
2021-01-13,Trinity,105,12862,437,260,62,322,3
2021-01-13,Tulare,107,460477,41828,39129,5293,44422,522
2021-01-13,Tuolumne,109,53932,3247,3196,30,3226,28
2021-01-13,Ventura,111,848112,61029,56453,2071,58524,338
2021-01-13,Yolo,113,214977,10954,9933,84,10017,135
2021-01-13,Yuba,115,75493,4706,4448,55,4503,27
2021-01-12,Alameda,001,1643700,66753,62642,1334,63976,677
2021-01-12,Alpine,003,1148,73,71,0,71,0
2021-01-12,Amador,005,37829,2994,2897,24,2921,26
2021-01-12,Butte,007,227075,9690,8883,1243,10126,124
2021-01-12,Calaveras,009,45235,1524,1475,7,1482,21
2021-01-12,Colusa,011,21464,1586,1510,149,1659,7
2021-01-12,Contra Costa,013,1133247,51754,48242,812,49054,399
2021-01-12,Del Norte,015,27424,853,816,2,818,2
2021-01-12,El Dorado,017,186661,7808,7156,487,7643,41
2021-01-12,Fresno,019,978130,83473,77651,6066,83717,796
2021-01-12,Glenn,021,27897,1952,1781,372,2153,9
2021-01-12,Humboldt,023,135768,2314,2077,7,2084,22
2021-01-12,Imperial,025,180216,25437,24566,2004,26570,457
2021-01-12,Inyo,027,18085,931,773,8,781,25
2021-01-12,Kern,029,883053,80351,75320,6941,82261,689
2021-01-12,Kings,031,150075,19252,18072,703,18775,108
2021-01-12,Lake,033,64148,2537,2260,0,2260,27
2021-01-12,Lassen,035,31185,4754,4659,68,4727,1
2021-01-12,Los Angeles,037,10098052,1005640,926295,31196,957491,12610
2021-01-12,Madera,039,155013,13403,12485,617,13102,85
2021-01-12,Marin,041,260295,11488,10960,110,11070,157
2021-01-12,Mariposa,043,17540,326,302,2,304,3
2021-01-12,Mendocino,045,87422,2994,2762,46,2808,31
2021-01-12,Merced,047,269075,23429,22172,550,22722,239
2021-01-12,Modoc,049,8938,291,274,83,357,0
2021-01-12,Mono,051,14174,1066,1008,12,1020,3
2021-01-12,Monterey,053,433212,35156,33381,1033,34414,240
2021-01-12,Napa,055,140530,7493,6936,30,6966,36
2021-01-12,Nevada,057,99092,3254,3014,121,3135,17
2021-01-12,Orange,059,3164182,210646,198260,8413,206673,2142
2021-01-12,Placer,061,380077,17773,16087,809,16896,163
2021-01-12,Plumas,063,18699,568,483,9,492,2
2021-01-12,Riverside,065,2383286,242067,225580,11271,236851,2266
2021-01-12,Sacramento,067,1510023,79698,77201,856,78057,985
2021-01-12,San Benito,069,59416,4834,4515,49,4564,35
2021-01-12,San Bernardino,071,2135413,253094,237008,7129,244137,1739
2021-01-12,San Diego,073,3302833,216194,198317,9983,208300,1898
2021-01-12,San Francisco,075,870044,28796,27531,431,27962,238
2021-01-12,San Joaquin,077,732212,56704,53630,2150,55780,725
2021-01-12,San Luis Obispo,079,281455,15820,14367,371,14738,132
2021-01-12,San Mateo,081,765935,32714,29747,200,29947,206
2021-01-12,Santa Barbara,083,443738,24388,22182,687,22869,209
2021-01-12,Santa Clara,085,1922200,91771,86075,392,86467,904
2021-01-12,Santa Cruz,087,273765,12689,11267,539,11806,110
2021-01-12,Shasta,089,179085,9629,9086,929,10015,84
2021-01-12,Sierra,091,2930,43,33,6,39,0
2021-01-12,Siskiyou,093,43540,1207,1091,158,1249,3
2021-01-12,Solano,095,438530,24864,23160,263,23423,102
2021-01-12,Sonoma,097,501317,23446,22403,117,22520,205
2021-01-12,Stanislaus,099,539301,42388,39615,4068,43683,571
2021-01-12,Sutter,101,95872,7554,7276,58,7334,73
2021-01-12,Tehama,103,63373,3837,3567,407,3974,17
2021-01-12,Trinity,105,12862,437,258,62,320,3
2021-01-12,Tulare,107,460477,41369,38797,5177,43974,509
2021-01-12,Tuolumne,109,53932,3214,3178,30,3208,28
2021-01-12,Ventura,111,848112,60057,55342,2039,57381,324
2021-01-12,Yolo,113,214977,10818,9857,82,9939,133
2021-01-12,Yuba,115,75493,4664,4389,55,4444,27
2021-01-11,Alameda,001,1643700,65893,61949,1316,63265,652
2021-01-11,Alpine,003,1148,73,70,0,70,0
2021-01-11,Amador,005,37829,2980,2867,24,2891,24
2021-01-11,Butte,007,227075,9577,8757,1225,9982,119
2021-01-11,Calaveras,009,45235,1505,1460,7,1467,21
2021-01-11,Colusa,011,21464,1569,1494,144,1638,7
2021-01-11,Contra Costa,013,1133247,51076,47728,802,48530,398
2021-01-11,Del Norte,015,27424,849,810,2,812,2
2021-01-11,El Dorado,017,186661,7714,6987,480,7467,36
2021-01-11,Fresno,019,978130,82594,76581,5990,82571,775
2021-01-11,Glenn,021,27897,1925,1763,366,2129,9
2021-01-11,Humboldt,023,135768,2275,2069,7,2076,22
2021-01-11,Imperial,025,180216,25322,24418,1968,26386,453
2021-01-11,Inyo,027,18085,913,763,8,771,25
2021-01-11,Kern,029,883053,79490,74489,6842,81331,682
2021-01-11,Kings,031,150075,18990,17909,695,18604,108
2021-01-11,Lake,033,64148,2486,2205,0,2205,26
2021-01-11,Lassen,035,31185,4731,4647,68,4715,1
2021-01-11,Los Angeles,037,10098052,992414,914434,30733,945167,12304
2021-01-11,Madera,039,155013,13269,12366,606,12972,85
2021-01-11,Marin,041,260295,11391,10814,109,10923,156
2021-01-11,Mariposa,043,17540,319,296,2,298,3
2021-01-11,Mendocino,045,87422,2966,2728,46,2774,31
2021-01-11,Merced,047,269075,23106,21884,536,22420,238
2021-01-11,Modoc,049,8938,290,271,82,353,0
2021-01-11,Mono,051,14174,1060,1006,12,1018,3
2021-01-11,Monterey,053,433212,34617,32858,971,33829,239
2021-01-11,Napa,055,140530,7391,6822,30,6852,36
2021-01-11,Nevada,057,99092,3226,2980,121,3101,17
2021-01-11,Orange,059,3164182,208061,196340,8314,204654,2113
2021-01-11,Placer,061,380077,17593,15919,800,16719,163
2021-01-11,Plumas,063,18699,564,477,9,486,2
2021-01-11,Riverside,065,2383286,238555,222907,11127,234034,2222
2021-01-11,Sacramento,067,1510023,78766,76009,840,76849,974
2021-01-11,San Benito,069,59416,4761,4482,42,4524,34
2021-01-11,San Bernardino,071,2135413,250295,235543,7031,242574,1739
2021-01-11,San Diego,073,3302833,212925,194793,9823,204616,1857
2021-01-11,San Francisco,075,870044,28520,27264,411,27675,238
2021-01-11,San Joaquin,077,732212,56091,53002,2121,55123,725
2021-01-11,San Luis Obispo,079,281455,15449,14213,364,14577,126
2021-01-11,San Mateo,081,765935,32270,29355,188,29543,206
2021-01-11,Santa Barbara,083,443738,23938,21740,675,22415,200
2021-01-11,Santa Clara,085,1922200,90561,84851,383,85234,877
2021-01-11,Santa Cruz,087,273765,12509,11093,516,11609,106
2021-01-11,Shasta,089,179085,9531,8977,916,9893,81
2021-01-11,Sierra,091,2930,41,33,6,39,0
2021-01-11,Siskiyou,093,43540,1198,1087,156,1243,3
2021-01-11,Solano,095,438530,24544,22893,257,23150,101
2021-01-11,Sonoma,097,501317,23199,22191,117,22308,205
2021-01-11,Stanislaus,099,539301,41897,39149,4019,43168,571
2021-01-11,Sutter,101,95872,7495,7204,57,7261,71
2021-01-11,Tehama,103,63373,3774,3524,386,3910,17
2021-01-11,Trinity,105,12862,437,256,62,318,2
2021-01-11,Tulare,107,460477,40954,38380,5097,43477,497
2021-01-11,Tuolumne,109,53932,3203,3165,30,3195,27
2021-01-11,Ventura,111,848112,58921,54202,2016,56218,320
2021-01-11,Yolo,113,214977,10610,9699,81,9780,129
2021-01-11,Yuba,115,75493,4626,4349,48,4397,27
2021-01-10,Alameda,001,1643700,64907,61111,1288,62399,650
2021-01-10,Alpine,003,1148,73,70,0,70,0
2021-01-10,Amador,005,37829,2956,2861,24,2885,24
2021-01-10,Butte,007,227075,9456,8665,1199,9864,119
2021-01-10,Calaveras,009,45235,1482,1449,7,1456,21
2021-01-10,Colusa,011,21464,1547,1478,142,1620,7
2021-01-10,Contra Costa,013,1133247,50292,47109,785,47894,398
2021-01-10,Del Norte,015,27424,846,809,2,811,2
2021-01-10,El Dorado,017,186661,7627,6904,463,7367,36
2021-01-10,Fresno,019,978130,81783,75621,5869,81490,775
2021-01-10,Glenn,021,27897,1906,1746,358,2104,9
2021-01-10,Humboldt,023,135768,2214,2049,7,2056,22
2021-01-10,Imperial,025,180216,25162,24233,1918,26151,453
2021-01-10,Inyo,027,18085,885,748,8,756,25
2021-01-10,Kern,029,883053,78659,73712,6712,80424,679
2021-01-10,Kings,031,150075,18771,17812,688,18500,108
2021-01-10,Lake,033,64148,2433,2174,0,2174,26
2021-01-10,Lassen,035,31185,4709,4642,68,4710,1
2021-01-10,Los Angeles,037,10098052,977804,901783,30113,931896,12170
2021-01-10,Madera,039,155013,13080,12179,591,12770,85
2021-01-10,Marin,041,260295,11270,10737,108,10845,155
2021-01-10,Mariposa,043,17540,319,291,2,293,3
2021-01-10,Mendocino,045,87422,2935,2706,42,2748,31
2021-01-10,Merced,047,269075,22834,21691,525,22216,238
2021-01-10,Modoc,049,8938,290,271,80,351,0
2021-01-10,Mono,051,14174,1042,965,12,977,3
2021-01-10,Monterey,053,433212,34177,32571,939,33510,237
2021-01-10,Napa,055,140530,7287,6687,28,6715,36
2021-01-10,Nevada,057,99092,3207,2959,117,3076,17
2021-01-10,Orange,059,3164182,205292,193766,8192,201958,2104
2021-01-10,Placer,061,380077,17404,15779,780,16559,163
2021-01-10,Plumas,063,18699,554,477,9,486,2
2021-01-10,Riverside,065,2383286,235190,219486,10938,230424,2216
2021-01-10,Sacramento,067,1510023,77805,75394,813,76207,965
2021-01-10,San Benito,069,59416,4659,4434,41,4475,34
2021-01-10,San Bernardino,071,2135413,246793,232171,6928,239099,1736
2021-01-10,San Diego,073,3302833,209257,191886,9656,201542,1857
2021-01-10,San Francisco,075,870044,28135,27054,380,27434,238
2021-01-10,San Joaquin,077,732212,55231,52535,2088,54623,725
2021-01-10,San Luis Obispo,079,281455,15120,13968,352,14320,122
2021-01-10,San Mateo,081,765935,31780,28972,174,29146,206
2021-01-10,Santa Barbara,083,443738,23379,21290,660,21950,200
2021-01-10,Santa Clara,085,1922200,89383,83779,374,84153,858
2021-01-10,Santa Cruz,087,273765,12296,10951,498,11449,106
2021-01-10,Shasta,089,179085,9419,8936,901,9837,81
2021-01-10,Sierra,091,2930,40,32,6,38,0
2021-01-10,Siskiyou,093,43540,1192,1075,153,1228,3
2021-01-10,Solano,095,438530,24141,22621,254,22875,101
2021-01-10,Sonoma,097,501317,22923,21925,116,22041,204
2021-01-10,Stanislaus,099,539301,41323,38809,3942,42751,571
2021-01-10,Sutter,101,95872,7434,7133,54,7187,71
2021-01-10,Tehama,103,63373,3701,3504,373,3877,17
2021-01-10,Trinity,105,12862,437,253,60,313,2
2021-01-10,Tulare,107,460477,40535,38012,4980,42992,497
2021-01-10,Tuolumne,109,53932,3169,3143,29,3172,27
2021-01-10,Ventura,111,848112,57652,53095,1973,55068,319
2021-01-10,Yolo,113,214977,10457,9610,81,9691,129
2021-01-10,Yuba,115,75493,4573,4300,45,4345,27
2021-01-09,Alameda,001,1643700,64364,60125,1272,61397,649
2021-01-09,Alpine,003,1148,73,70,0,70,0
2021-01-09,Amador,005,37829,2949,2809,24,2833,24
2021-01-09,Butte,007,227075,9377,8552,1175,9727,118
2021-01-09,Calaveras,009,45235,1472,1425,7,1432,21
2021-01-09,Colusa,011,21464,1540,1468,141,1609,7
2021-01-09,Contra Costa,013,1133247,49940,46406,770,47176,393
2021-01-09,Del Norte,015,27424,844,802,2,804,2
2021-01-09,El Dorado,017,186661,7595,6800,460,7260,36
2021-01-09,Fresno,019,978130,81374,74816,5829,80645,773
2021-01-09,Glenn,021,27897,1891,1707,355,2062,9
2021-01-09,Humboldt,023,135768,2196,2026,7,2033,22
2021-01-09,Imperial,025,180216,25094,24028,1904,25932,448
2021-01-09,Inyo,027,18085,875,734,8,742,25
2021-01-09,Kern,029,883053,78190,73015,6635,79650,677
2021-01-09,Kings,031,150075,18676,17679,684,18363,108
2021-01-09,Lake,033,64148,2398,2144,0,2144,26
2021-01-09,Lassen,035,31185,4697,4613,68,4681,1
2021-01-09,Los Angeles,037,10098052,972229,887949,29680,917629,12011
2021-01-09,Madera,039,155013,12989,12063,586,12649,85
2021-01-09,Marin,041,260295,11209,10634,107,10741,154
2021-01-09,Mariposa,043,17540,316,287,2,289,3
2021-01-09,Mendocino,045,87422,2917,2664,42,2706,31
2021-01-09,Merced,047,269075,22692,21357,516,21873,237
2021-01-09,Modoc,049,8938,290,271,79,350,0
2021-01-09,Mono,051,14174,1037,964,12,976,3
2021-01-09,Monterey,053,433212,34026,31948,929,32877,235
2021-01-09,Napa,055,140530,7217,6594,25,6619,36
2021-01-09,Nevada,057,99092,3185,2932,114,3046,17
2021-01-09,Orange,059,3164182,203780,191004,8100,199104,2034
2021-01-09,Placer,061,380077,17297,15609,778,16387,162
2021-01-09,Plumas,063,18699,552,477,9,486,2
2021-01-09,Riverside,065,2383286,233434,216076,10802,226878,2201
2021-01-09,Sacramento,067,1510023,77272,74482,808,75290,953
2021-01-09,San Benito,069,59416,4608,4335,41,4376,34
2021-01-09,San Bernardino,071,2135413,245594,228857,6861,235718,1714
2021-01-09,San Diego,073,3302833,207563,188598,9536,198134,1824
2021-01-09,San Francisco,075,870044,27963,26708,339,27047,235
2021-01-09,San Joaquin,077,732212,54882,51927,2069,53996,724
2021-01-09,San Luis Obispo,079,281455,14996,13647,341,13988,121
2021-01-09,San Mateo,081,765935,31481,28512,167,28679,205
2021-01-09,Santa Barbara,083,443738,23167,20971,655,21626,197
2021-01-09,Santa Clara,085,1922200,88544,82269,362,82631,808
2021-01-09,Santa Cruz,087,273765,12200,10717,492,11209,107
2021-01-09,Shasta,089,179085,9386,8893,897,9790,81
2021-01-09,Sierra,091,2930,38,32,6,38,0
2021-01-09,Siskiyou,093,43540,1188,1062,148,1210,3
2021-01-09,Solano,095,438530,23984,22226,252,22478,101
2021-01-09,Sonoma,097,501317,22801,21393,116,21509,202
2021-01-09,Stanislaus,099,539301,41032,38403,3908,42311,567
2021-01-09,Sutter,101,95872,7398,7072,53,7125,69
2021-01-09,Tehama,103,63373,3669,3451,363,3814,15
2021-01-09,Trinity,105,12862,437,252,60,312,2
2021-01-09,Tulare,107,460477,40281,37684,4916,42600,496
2021-01-09,Tuolumne,109,53932,3161,3117,28,3145,26
2021-01-09,Ventura,111,848112,56823,51988,1947,53935,306
2021-01-09,Yolo,113,214977,10384,9524,80,9604,129
2021-01-09,Yuba,115,75493,4543,4265,45,4310,27
2021-01-08,Alameda,001,1643700,63804,59172,1263,60435,646
2021-01-08,Alpine,003,1148,73,70,0,70,0
2021-01-08,Amador,005,37829,2942,2792,24,2816,24
2021-01-08,Butte,007,227075,9317,8430,1161,9591,115
2021-01-08,Calaveras,009,45235,1458,1385,7,1392,21
2021-01-08,Colusa,011,21464,1527,1448,140,1588,7
2021-01-08,Contra Costa,013,1133247,49411,45667,766,46433,381
2021-01-08,Del Norte,015,27424,842,795,2,797,2
2021-01-08,El Dorado,017,186661,7525,6690,448,7138,36
2021-01-08,Fresno,019,978130,80560,73689,5771,79460,771
2021-01-08,Glenn,021,27897,1876,1680,350,2030,9
2021-01-08,Humboldt,023,135768,2172,1988,7,1995,22
2021-01-08,Imperial,025,180216,25028,23751,1889,25640,446
2021-01-08,Inyo,027,18085,861,682,8,690,24
2021-01-08,Kern,029,883053,77626,71978,6562,78540,674
2021-01-08,Kings,031,150075,18548,17441,679,18120,108
2021-01-08,Lake,033,64148,2373,2098,0,2098,26
2021-01-08,Lassen,035,31185,4689,4598,66,4664,1
2021-01-08,Los Angeles,037,10098052,961418,871188,29256,900444,11796
2021-01-08,Madera,039,155013,12838,11846,577,12423,85
2021-01-08,Marin,041,260295,11115,10531,107,10638,153
2021-01-08,Mariposa,043,17540,315,273,2,275,3
2021-01-08,Mendocino,045,87422,2898,2634,39,2673,31
2021-01-08,Merced,047,269075,22497,20862,511,21373,236
2021-01-08,Modoc,049,8938,290,266,79,345,0
2021-01-08,Mono,051,14174,1027,951,12,963,3
2021-01-08,Monterey,053,433212,33774,31543,919,32462,224
2021-01-08,Napa,055,140530,7147,6544,25,6569,32
2021-01-08,Nevada,057,99092,3163,2888,114,3002,17
2021-01-08,Orange,059,3164182,201785,186608,8014,194622,1991
2021-01-08,Placer,061,380077,17166,15401,771,16172,161
2021-01-08,Plumas,063,18699,546,465,9,474,2
2021-01-08,Riverside,065,2383286,231028,212122,10679,222801,2184
2021-01-08,Sacramento,067,1510023,76699,73245,802,74047,939
2021-01-08,San Benito,069,59416,4571,4225,40,4265,33
2021-01-08,San Bernardino,071,2135413,243725,224267,6791,231058,1703
2021-01-08,San Diego,073,3302833,205025,185060,9442,194502,1771
2021-01-08,San Francisco,075,870044,27713,26378,317,26695,207
2021-01-08,San Joaquin,077,732212,54548,50990,2041,53031,710
2021-01-08,San Luis Obispo,079,281455,14863,13286,329,13615,119
2021-01-08,San Mateo,081,765935,31131,28072,165,28237,204
2021-01-08,Santa Barbara,083,443738,22881,20461,650,21111,189
2021-01-08,Santa Clara,085,1922200,87542,80561,359,80920,789
2021-01-08,Santa Cruz,087,273765,12059,10486,484,10970,106
2021-01-08,Shasta,089,179085,9336,8772,882,9654,81
2021-01-08,Sierra,091,2930,38,31,6,37,0
2021-01-08,Siskiyou,093,43540,1185,1027,147,1174,3
2021-01-08,Solano,095,438530,23813,21832,249,22081,100
2021-01-08,Sonoma,097,501317,22659,21178,116,21294,201
2021-01-08,Stanislaus,099,539301,40733,37858,3874,41732,566
2021-01-08,Sutter,101,95872,7348,6982,53,7035,68
2021-01-08,Tehama,103,63373,3646,3406,360,3766,15
2021-01-08,Trinity,105,12862,437,247,60,307,2
2021-01-08,Tulare,107,460477,40009,36946,4821,41767,491
2021-01-08,Tuolumne,109,53932,3153,3099,28,3127,19
2021-01-08,Ventura,111,848112,55957,50553,1923,52476,294
2021-01-08,Yolo,113,214977,10295,9391,80,9471,129
2021-01-08,Yuba,115,75493,4501,4195,44,4239,26
2021-01-07,Alameda,001,1643700,62949,57921,1237,59158,632
2021-01-07,Alpine,003,1148,71,70,0,70,0
2021-01-07,Amador,005,37829,2929,2740,23,2763,24
2021-01-07,Butte,007,227075,9220,8278,1140,9418,112
2021-01-07,Calaveras,009,45235,1441,1342,6,1348,21
2021-01-07,Colusa,011,21464,1515,1420,133,1553,7
2021-01-07,Contra Costa,013,1133247,48636,44756,751,45507,376
2021-01-07,Del Norte,015,27424,840,791,2,793,2
2021-01-07,El Dorado,017,186661,7424,6545,438,6983,36
2021-01-07,Fresno,019,978130,79605,72557,5671,78228,765
2021-01-07,Glenn,021,27897,1858,1639,340,1979,9
2021-01-07,Humboldt,023,135768,2145,1954,7,1961,22
2021-01-07,Imperial,025,180216,24838,23608,1840,25448,431
2021-01-07,Inyo,027,18085,848,656,8,664,20
2021-01-07,Kern,029,883053,76764,70953,6414,77367,660
2021-01-07,Kings,031,150075,18422,17238,670,17908,108
2021-01-07,Lake,033,64148,2318,2054,0,2054,26
2021-01-07,Lassen,035,31185,4684,4581,64,4645,1
2021-01-07,Los Angeles,037,10098052,946500,853187,28725,881912,11480
2021-01-07,Madera,039,155013,12681,11644,566,12210,76
2021-01-07,Marin,041,260295,11026,10364,105,10469,153
2021-01-07,Mariposa,043,17540,313,264,2,266,3
2021-01-07,Mendocino,045,87422,2843,2585,34,2619,30
2021-01-07,Merced,047,269075,22176,20510,495,21005,234
2021-01-07,Modoc,049,8938,290,265,79,344,0
2021-01-07,Mono,051,14174,1016,905,12,917,3
2021-01-07,Monterey,053,433212,33269,30903,896,31799,222
2021-01-07,Napa,055,140530,7037,6408,25,6433,32
2021-01-07,Nevada,057,99092,3129,2847,109,2956,17
2021-01-07,Orange,059,3164182,198944,181922,7915,189837,1974
2021-01-07,Placer,061,380077,16988,15155,743,15898,144
2021-01-07,Plumas,063,18699,544,454,9,463,2
2021-01-07,Riverside,065,2383286,227566,208177,10529,218706,2156
2021-01-07,Sacramento,067,1510023,75793,72342,781,73123,919
2021-01-07,San Benito,069,59416,4510,4112,38,4150,33
2021-01-07,San Bernardino,071,2135413,240275,219691,6707,226398,1666
2021-01-07,San Diego,073,3302833,201719,180510,9264,189774,1738
2021-01-07,San Francisco,075,870044,27385,25885,304,26189,202
2021-01-07,San Joaquin,077,732212,53867,50156,2012,52168,689
2021-01-07,San Luis Obispo,079,281455,14625,12810,316,13126,118
2021-01-07,San Mateo,081,765935,30622,27494,162,27656,201
2021-01-07,Santa Barbara,083,443738,22454,19931,639,20570,187
2021-01-07,Santa Clara,085,1922200,86374,78808,356,79164,775
2021-01-07,Santa Cruz,087,273765,11850,10228,476,10704,104
2021-01-07,Shasta,089,179085,9248,8612,874,9486,81
2021-01-07,Sierra,091,2930,38,31,6,37,0
2021-01-07,Siskiyou,093,43540,1180,1010,146,1156,3
2021-01-07,Solano,095,438530,23421,21384,245,21629,100
2021-01-07,Sonoma,097,501317,22398,20857,115,20972,200
2021-01-07,Stanislaus,099,539301,40316,37296,3821,41117,553
2021-01-07,Sutter,101,95872,7289,6890,52,6942,65
2021-01-07,Tehama,103,63373,3622,3330,352,3682,15
2021-01-07,Trinity,105,12862,437,247,60,307,2
2021-01-07,Tulare,107,460477,39609,36397,4691,41088,482
2021-01-07,Tuolumne,109,53932,3133,3068,27,3095,14
2021-01-07,Ventura,111,848112,54796,49083,1895,50978,288
2021-01-07,Yolo,113,214977,10155,9207,78,9285,128
2021-01-07,Yuba,115,75493,4459,4128,44,4172,25
2021-01-06,Alameda,001,1643700,62095,57081,1210,58291,616
2021-01-06,Alpine,003,1148,71,70,0,70,0
2021-01-06,Amador,005,37829,2908,2717,22,2739,24
2021-01-06,Butte,007,227075,9105,8147,1121,9268,110
2021-01-06,Calaveras,009,45235,1418,1321,6,1327,21
2021-01-06,Colusa,011,21464,1494,1385,128,1513,7
2021-01-06,Contra Costa,013,1133247,47843,44054,735,44789,358
2021-01-06,Del Norte,015,27424,834,780,2,782,2
2021-01-06,El Dorado,017,186661,7312,6397,424,6821,35
2021-01-06,Fresno,019,978130,78762,71404,5569,76973,752
2021-01-06,Glenn,021,27897,1832,1622,336,1958,9
2021-01-06,Humboldt,023,135768,2119,1912,7,1919,22
2021-01-06,Imperial,025,180216,24593,23400,1800,25200,431
2021-01-06,Inyo,027,18085,832,630,8,638,20
2021-01-06,Kern,029,883053,75821,69893,6287,76180,646
2021-01-06,Kings,031,150075,18224,17019,651,17670,108
2021-01-06,Lake,033,64148,2281,2033,0,2033,26
2021-01-06,Lassen,035,31185,4672,4560,60,4620,1
2021-01-06,Los Angeles,037,10098052,930541,835052,28039,863091,11285
2021-01-06,Madera,039,155013,12545,11407,560,11967,67
2021-01-06,Marin,041,260295,10898,10282,104,10386,153
2021-01-06,Mariposa,043,17540,310,259,2,261,3
2021-01-06,Mendocino,045,87422,2813,2561,34,2595,30
2021-01-06,Merced,047,269075,21840,20258,480,20738,232
2021-01-06,Modoc,049,8938,290,263,79,342,0
2021-01-06,Mono,051,14174,985,905,12,917,3
2021-01-06,Monterey,053,433212,32668,30387,865,31252,222
2021-01-06,Napa,055,140530,6907,6342,25,6367,32
2021-01-06,Nevada,057,99092,3109,2805,108,2913,15
2021-01-06,Orange,059,3164182,195498,177686,7774,185460,1935
2021-01-06,Placer,061,380077,16800,14940,725,15665,134
2021-01-06,Plumas,063,18699,536,445,9,454,2
2021-01-06,Riverside,065,2383286,223545,203714,10343,214057,2121
2021-01-06,Sacramento,067,1510023,74770,71572,764,72336,909
2021-01-06,San Benito,069,59416,4434,4031,37,4068,32
2021-01-06,San Bernardino,071,2135413,236574,215286,6604,221890,1634
2021-01-06,San Diego,073,3302833,198219,176660,9093,185753,1691
2021-01-06,San Francisco,075,870044,27015,25424,296,25720,199
2021-01-06,San Joaquin,077,732212,53114,49286,1971,51257,673
2021-01-06,San Luis Obispo,079,281455,14232,12305,309,12614,115
2021-01-06,San Mateo,081,765935,30197,27050,159,27209,200
2021-01-06,Santa Barbara,083,443738,21965,19453,630,20083,177
2021-01-06,Santa Clara,085,1922200,85014,77485,349,77834,746
2021-01-06,Santa Cruz,087,273765,11631,9954,458,10412,97
2021-01-06,Shasta,089,179085,9178,8482,867,9349,78
2021-01-06,Sierra,091,2930,37,31,6,37,0
2021-01-06,Siskiyou,093,43540,1168,998,142,1140,3
2021-01-06,Solano,095,438530,23038,21102,242,21344,99
2021-01-06,Sonoma,097,501317,22091,20558,115,20673,196
2021-01-06,Stanislaus,099,539301,39749,36751,3762,40513,553
2021-01-06,Sutter,101,95872,7208,6839,51,6890,59
2021-01-06,Tehama,103,63373,3594,3306,346,3652,15
2021-01-06,Trinity,105,12862,437,246,60,306,2
2021-01-06,Tulare,107,460477,39063,35882,4596,40478,465
2021-01-06,Tuolumne,109,53932,3112,3008,27,3035,14
2021-01-06,Ventura,111,848112,53553,47428,1871,49299,280
2021-01-06,Yolo,113,214977,9990,9083,75,9158,127
2021-01-06,Yuba,115,75493,4410,4097,44,4141,25
2021-01-05,Alameda,001,1643700,60982,56432,1180,57612,602
2021-01-05,Alpine,003,1148,71,70,0,70,0
2021-01-05,Amador,005,37829,2868,2695,22,2717,24
2021-01-05,Butte,007,227075,8964,8008,1094,9102,107
2021-01-05,Calaveras,009,45235,1371,1292,6,1298,21
2021-01-05,Colusa,011,21464,1470,1376,122,1498,7
2021-01-05,Contra Costa,013,1133247,46975,43442,723,44165,353
2021-01-05,Del Norte,015,27424,827,770,2,772,2
2021-01-05,El Dorado,017,186661,7194,6270,403,6673,32
2021-01-05,Fresno,019,978130,77541,70971,5478,76449,741
2021-01-05,Glenn,021,27897,1809,1608,320,1928,9
2021-01-05,Humboldt,023,135768,2083,1884,7,1891,22
2021-01-05,Imperial,025,180216,24420,23165,1758,24923,421
2021-01-05,Inyo,027,18085,818,627,8,635,20
2021-01-05,Kern,029,883053,74744,68257,6152,74409,624
2021-01-05,Kings,031,150075,18026,16860,629,17489,108
2021-01-05,Lake,033,64148,2233,2015,0,2015,25
2021-01-05,Lassen,035,31185,4657,4554,56,4610,1
2021-01-05,Los Angeles,037,10098052,911807,823783,27375,851158,11028
2021-01-05,Madera,039,155013,12369,11359,548,11907,67
2021-01-05,Marin,041,260295,10746,10214,103,10317,151
2021-01-05,Mariposa,043,17540,304,257,2,259,3
2021-01-05,Mendocino,045,87422,2777,2501,34,2535,30
2021-01-05,Merced,047,269075,21489,20051,468,20519,230
2021-01-05,Modoc,049,8938,290,254,79,333,0
2021-01-05,Mono,051,14174,979,896,12,908,3
2021-01-05,Monterey,053,433212,32118,30045,832,30877,213
2021-01-05,Napa,055,140530,6820,6264,25,6289,29
2021-01-05,Nevada,057,99092,3081,2781,106,2887,15
2021-01-05,Orange,059,3164182,191864,174869,7583,182452,1918
2021-01-05,Placer,061,380077,16577,14723,702,15425,133
2021-01-05,Plumas,063,18699,529,428,9,437,2
2021-01-05,Riverside,065,2383286,219419,200439,10174,210613,2069
2021-01-05,Sacramento,067,1510023,73842,70677,738,71415,888
2021-01-05,San Benito,069,59416,4333,3961,35,3996,28
2021-01-05,San Bernardino,071,2135413,232636,212522,6488,219010,1615
2021-01-05,San Diego,073,3302833,194079,172845,8879,181724,1654
2021-01-05,San Francisco,075,870044,26647,24989,279,25268,196
2021-01-05,San Joaquin,077,732212,52244,48969,1927,50896,663
2021-01-05,San Luis Obispo,079,281455,13834,12027,299,12326,106
2021-01-05,San Mateo,081,765935,29716,26486,157,26643,198
2021-01-05,Santa Barbara,083,443738,21519,19063,622,19685,172
2021-01-05,Santa Clara,085,1922200,83483,76355,337,76692,729
2021-01-05,Santa Cruz,087,273765,11358,9753,434,10187,93
2021-01-05,Shasta,089,179085,9071,8345,849,9194,73
2021-01-05,Sierra,091,2930,37,31,6,37,0
2021-01-05,Siskiyou,093,43540,1156,985,140,1125,3
2021-01-05,Solano,095,438530,22630,20860,237,21097,97
2021-01-05,Sonoma,097,501317,21732,20247,114,20361,194
2021-01-05,Stanislaus,099,539301,39205,36363,3711,40074,553
2021-01-05,Sutter,101,95872,7111,6769,50,6819,59
2021-01-05,Tehama,103,63373,3539,3255,341,3596,9
2021-01-05,Trinity,105,12862,437,246,60,306,2
2021-01-05,Tulare,107,460477,38451,35585,4455,40040,455
2021-01-05,Tuolumne,109,53932,3088,2996,22,3018,13
2021-01-05,Ventura,111,848112,52309,46456,1849,48305,264
2021-01-05,Yolo,113,214977,9815,8980,75,9055,127
2021-01-05,Yuba,115,75493,4351,4053,43,4096,21
2021-01-04,Alameda,001,1643700,59764,55899,1147,57046,583
2021-01-04,Alpine,003,1148,71,68,0,68,0
2021-01-04,Amador,005,37829,2828,2596,22,2618,24
2021-01-04,Butte,007,227075,8805,7893,1073,8966,105
2021-01-04,Calaveras,009,45235,1330,1276,5,1281,21
2021-01-04,Colusa,011,21464,1446,1368,108,1476,7
2021-01-04,Contra Costa,013,1133247,46116,43019,697,43716,353
2021-01-04,Del Norte,015,27424,817,770,2,772,2
2021-01-04,El Dorado,017,186661,7060,6152,388,6540,27
2021-01-04,Fresno,019,978130,76273,69871,5380,75251,726
2021-01-04,Glenn,021,27897,1776,1590,315,1905,9
2021-01-04,Humboldt,023,135768,2047,1845,7,1852,22
2021-01-04,Imperial,025,180216,24270,23035,1706,24741,420
2021-01-04,Inyo,027,18085,792,623,8,631,20
2021-01-04,Kern,029,883053,73661,67418,5959,73377,623
2021-01-04,Kings,031,150075,17750,16801,605,17406,108
2021-01-04,Lake,033,64148,2194,1984,0,1984,25
2021-01-04,Lassen,035,31185,4635,4550,55,4605,1
2021-01-04,Los Angeles,037,10098052,891682,813022,26521,839543,10790
2021-01-04,Madera,039,155013,12149,11204,526,11730,67
2021-01-04,Marin,041,260295,10609,10115,100,10215,151
2021-01-04,Mariposa,043,17540,298,253,2,255,3
2021-01-04,Mendocino,045,87422,2737,2460,30,2490,28
2021-01-04,Merced,047,269075,21075,19804,449,20253,230
2021-01-04,Modoc,049,8938,274,250,77,327,0
2021-01-04,Mono,051,14174,968,895,12,907,3
2021-01-04,Monterey,053,433212,31499,29659,811,30470,212
2021-01-04,Napa,055,140530,6679,6187,25,6212,29
2021-01-04,Nevada,057,99092,3043,2765,103,2868,15
2021-01-04,Orange,059,3164182,187974,172458,7461,179919,1918
2021-01-04,Placer,061,380077,16318,14622,689,15311,133
2021-01-04,Plumas,063,18699,519,419,9,428,1
2021-01-04,Riverside,065,2383286,214868,196809,9988,206797,2066
2021-01-04,Sacramento,067,1510023,72787,70164,729,70893,870
2021-01-04,San Benito,069,59416,4220,3914,35,3949,28
2021-01-04,San Bernardino,071,2135413,228373,210868,6340,217208,1615
2021-01-04,San Diego,073,3302833,189505,171031,8683,179714,1598
2021-01-04,San Francisco,075,870044,26259,24753,273,25026,191
2021-01-04,San Joaquin,077,732212,51342,48644,1886,50530,661
2021-01-04,San Luis Obispo,079,281455,13348,11945,292,12237,96
2021-01-04,San Mateo,081,765935,29152,26150,152,26302,198
2021-01-04,Santa Barbara,083,443738,20996,18735,593,19328,165
2021-01-04,Santa Clara,085,1922200,81729,75297,329,75626,727
2021-01-04,Santa Cruz,087,273765,11070,9680,417,10097,85
2021-01-04,Shasta,089,179085,8966,8224,832,9056,72
2021-01-04,Sierra,091,2930,36,30,6,36,0
2021-01-04,Siskiyou,093,43540,1139,980,137,1117,3
2021-01-04,Solano,095,438530,22130,20588,229,20817,97
2021-01-04,Sonoma,097,501317,21394,20210,113,20323,194
2021-01-04,Stanislaus,099,539301,38643,36141,3656,39797,553
2021-01-04,Sutter,101,95872,7015,6712,49,6761,56
2021-01-04,Tehama,103,63373,3470,3190,336,3526,9
2021-01-04,Trinity,105,12862,434,245,60,305,2
2021-01-04,Tulare,107,460477,37899,35060,4355,39415,455
2021-01-04,Tuolumne,109,53932,3063,2987,22,3009,13
2021-01-04,Ventura,111,848112,50806,45014,1829,46843,255
2021-01-04,Yolo,113,214977,9620,8834,75,8909,121
2021-01-04,Yuba,115,75493,4294,4023,43,4066,21
2021-01-03,Alameda,001,1643700,58512,55082,1119,56201,580
2021-01-03,Alpine,003,1148,69,68,0,68,0
2021-01-03,Amador,005,37829,2771,2565,22,2587,24
2021-01-03,Butte,007,227075,8611,7837,1027,8864,105
2021-01-03,Calaveras,009,45235,1293,1249,3,1252,21
2021-01-03,Colusa,011,21464,1416,1337,102,1439,7
2021-01-03,Contra Costa,013,1133247,45226,42432,673,43105,352
2021-01-03,Del Norte,015,27424,805,768,2,770,2
2021-01-03,El Dorado,017,186661,6932,6034,371,6405,27
2021-01-03,Fresno,019,978130,75125,69326,5264,74590,719
2021-01-03,Glenn,021,27897,1751,1581,309,1890,9
2021-01-03,Humboldt,023,135768,2010,1833,7,1840,21
2021-01-03,Imperial,025,180216,24023,22951,1629,24580,419
2021-01-03,Inyo,027,18085,774,615,8,623,20
2021-01-03,Kern,029,883053,72399,66895,5784,72679,609
2021-01-03,Kings,031,150075,17474,16593,576,17169,108
2021-01-03,Lake,033,64148,2141,1976,0,1976,24
2021-01-03,Lassen,035,31185,4602,4531,54,4585,1
2021-01-03,Los Angeles,037,10098052,869626,792168,25474,817642,10633
2021-01-03,Madera,039,155013,11926,11152,503,11655,67
2021-01-03,Marin,041,260295,10458,10034,95,10129,150
2021-01-03,Mariposa,043,17540,291,248,2,250,3
2021-01-03,Mendocino,045,87422,2697,2445,28,2473,24
2021-01-03,Merced,047,269075,20608,19600,423,20023,230
2021-01-03,Modoc,049,8938,270,245,76,321,0
2021-01-03,Mono,051,14174,943,893,12,905,3
2021-01-03,Monterey,053,433212,30907,29357,776,30133,191
2021-01-03,Napa,055,140530,6578,6094,25,6119,29
2021-01-03,Nevada,057,99092,2982,2742,100,2842,15
2021-01-03,Orange,059,3164182,183785,169881,7272,177153,1919
2021-01-03,Placer,061,380077,16069,14319,666,14985,133
2021-01-03,Plumas,063,18699,506,416,9,425,1
2021-01-03,Riverside,065,2383286,209991,195048,9740,204788,2005
2021-01-03,Sacramento,067,1510023,71579,68558,708,69266,859
2021-01-03,San Benito,069,59416,4123,3882,34,3916,28
2021-01-03,San Bernardino,071,2135413,223073,208294,6170,214464,1592
2021-01-03,San Diego,073,3302833,184245,168018,8454,176472,1592
2021-01-03,San Francisco,075,870044,25761,24588,255,24843,193
2021-01-03,San Joaquin,077,732212,50222,47899,1830,49729,661
2021-01-03,San Luis Obispo,079,281455,12880,11636,284,11920,95
2021-01-03,San Mateo,081,765935,28558,25770,145,25915,196
2021-01-03,Santa Barbara,083,443738,20263,18267,578,18845,164
2021-01-03,Santa Clara,085,1922200,80138,74534,323,74857,720
2021-01-03,Santa Cruz,087,273765,10766,9528,402,9930,84
2021-01-03,Shasta,089,179085,8840,8192,792,8984,72
2021-01-03,Sierra,091,2930,36,30,6,36,0
2021-01-03,Siskiyou,093,43540,1106,976,128,1104,3
2021-01-03,Solano,095,438530,21601,20105,223,20328,97
2021-01-03,Sonoma,097,501317,21007,19982,111,20093,193
2021-01-03,Stanislaus,099,539301,37936,35762,3573,39335,553
2021-01-03,Sutter,101,95872,6918,6664,48,6712,53
2021-01-03,Tehama,103,63373,3414,3176,329,3505,9
2021-01-03,Trinity,105,12862,429,243,58,301,2
2021-01-03,Tulare,107,460477,37336,34747,4210,38957,455
2021-01-03,Tuolumne,109,53932,3002,2978,19,2997,13
2021-01-03,Ventura,111,848112,48981,43748,1812,45560,254
2021-01-03,Yolo,113,214977,9463,8674,74,8748,121
2021-01-03,Yuba,115,75493,4242,3966,42,4008,20
2021-01-02,Alameda,001,1643700,57889,54518,1088,55606,581
2021-01-02,Alpine,003,1148,69,68,0,68,0
2021-01-02,Amador,005,37829,2752,2540,22,2562,24
2021-01-02,Butte,007,227075,8505,7750,1006,8756,105
2021-01-02,Calaveras,009,45235,1273,1230,3,1233,21
2021-01-02,Colusa,011,21464,1405,1332,101,1433,7
2021-01-02,Contra Costa,013,1133247,44688,41993,663,42656,352
2021-01-02,Del Norte,015,27424,803,764,2,766,2
2021-01-02,El Dorado,017,186661,6877,5959,367,6326,27
2021-01-02,Fresno,019,978130,74581,68740,5153,73893,717
2021-01-02,Glenn,021,27897,1734,1546,308,1854,9
2021-01-02,Humboldt,023,135768,1983,1815,7,1822,21
2021-01-02,Imperial,025,180216,23937,22867,1594,24461,420
2021-01-02,Inyo,027,18085,761,609,8,617,20
2021-01-02,Kern,029,883053,71679,66457,5672,72129,610
2021-01-02,Kings,031,150075,17380,16515,572,17087,108
2021-01-02,Lake,033,64148,2105,1925,0,1925,24
2021-01-02,Lassen,035,31185,4591,4457,53,4510,1
2021-01-02,Los Angeles,037,10098052,861265,791892,24784,816676,10633
2021-01-02,Madera,039,155013,11815,11039,491,11530,67
2021-01-02,Marin,041,260295,10411,9924,92,10016,151
2021-01-02,Mariposa,043,17540,284,243,2,245,3
2021-01-02,Mendocino,045,87422,2654,2428,27,2455,24
2021-01-02,Merced,047,269075,20466,19395,406,19801,230
2021-01-02,Modoc,049,8938,269,245,76,321,0
2021-01-02,Mono,051,14174,932,884,12,896,3
2021-01-02,Monterey,053,433212,30694,28991,764,29755,191
2021-01-02,Napa,055,140530,6519,5994,25,6019,29
2021-01-02,Nevada,057,99092,2953,2706,96,2802,15
2021-01-02,Orange,059,3164182,181572,168457,7124,175581,1918
2021-01-02,Placer,061,380077,15896,14182,657,14839,133
2021-01-02,Plumas,063,18699,503,413,9,422,1
2021-01-02,Riverside,065,2383286,207348,192069,9513,201582,2008
2021-01-02,Sacramento,067,1510023,70945,67810,691,68501,858
2021-01-02,San Benito,069,59416,4040,3829,34,3863,28
2021-01-02,San Bernardino,071,2135413,221413,206939,6048,212987,1597
2021-01-02,San Diego,073,3302833,181646,164498,8257,172755,1592
2021-01-02,San Francisco,075,870044,25503,24414,248,24662,194
2021-01-02,San Joaquin,077,732212,49840,47310,1802,49112,662
2021-01-02,San Luis Obispo,079,281455,12746,11467,278,11745,95
2021-01-02,San Mateo,081,765935,28223,25483,137,25620,196
2021-01-02,Santa Barbara,083,443738,19974,18135,575,18710,164
2021-01-02,Santa Clara,085,1922200,78953,73662,317,73979,720
2021-01-02,Santa Cruz,087,273765,10611,9340,394,9734,85
2021-01-02,Shasta,089,179085,8774,8154,781,8935,72
2021-01-02,Sierra,091,2930,36,28,6,34,0
2021-01-02,Siskiyou,093,43540,1095,949,126,1075,3
2021-01-02,Solano,095,438530,21401,19805,214,20019,97
2021-01-02,Sonoma,097,501317,20838,19761,111,19872,194
2021-01-02,Stanislaus,099,539301,37603,35431,3509,38940,553
2021-01-02,Sutter,101,95872,6866,6621,48,6669,53
2021-01-02,Tehama,103,63373,3386,3146,325,3471,9
2021-01-02,Trinity,105,12862,426,243,58,301,2
2021-01-02,Tulare,107,460477,37014,34479,4136,38615,455
2021-01-02,Tuolumne,109,53932,2988,2942,17,2959,13
2021-01-02,Ventura,111,848112,47826,43397,1779,45176,254
2021-01-02,Yolo,113,214977,9364,8571,72,8643,122
2021-01-02,Yuba,115,75493,4203,3930,42,3972,21
2021-01-01,Alameda,001,1643700,57242,53518,1074,54592,579
2021-01-01,Alpine,003,1148,69,68,0,68,0
2021-01-01,Amador,005,37829,2726,2513,20,2533,24
2021-01-01,Butte,007,227075,8403,7589,984,8573,105
2021-01-01,Calaveras,009,45235,1258,1186,3,1189,21
2021-01-01,Colusa,011,21464,1396,1314,99,1413,7
2021-01-01,Contra Costa,013,1133247,44208,41412,646,42058,351
2021-01-01,Del Norte,015,27424,796,758,2,760,2
2021-01-01,El Dorado,017,186661,6784,5832,359,6191,27
2021-01-01,Fresno,019,978130,73508,67484,5069,72553,717
2021-01-01,Glenn,021,27897,1717,1520,299,1819,9
2021-01-01,Humboldt,023,135768,1944,1783,7,1790,21
2021-01-01,Imperial,025,180216,23848,22715,1546,24261,418
2021-01-01,Inyo,027,18085,737,606,8,614,20
2021-01-01,Kern,029,883053,70853,65571,5565,71136,609
2021-01-01,Kings,031,150075,17197,16358,565,16923,108
2021-01-01,Lake,033,64148,2072,1888,0,1888,24
2021-01-01,Lassen,035,31185,4585,4377,53,4430,1
2021-01-01,Los Angeles,037,10098052,847058,775578,24102,799680,10515
2021-01-01,Madera,039,155013,11655,10752,482,11234,66
2021-01-01,Marin,041,260295,10304,9821,91,9912,148
2021-01-01,Mariposa,043,17540,276,236,2,238,3
2021-01-01,Mendocino,045,87422,2600,2400,27,2427,24
2021-01-01,Merced,047,269075,20282,19118,390,19508,229
2021-01-01,Modoc,049,8938,269,241,76,317,0
2021-01-01,Mono,051,14174,914,884,11,895,3
2021-01-01,Monterey,053,433212,30454,28465,755,29220,191
2021-01-01,Napa,055,140530,6433,5899,25,5924,28
2021-01-01,Nevada,057,99092,2929,2663,96,2759,15
2021-01-01,Orange,059,3164182,178776,165440,6982,172422,1893
2021-01-01,Placer,061,380077,15706,13987,642,14629,133
2021-01-01,Plumas,063,18699,498,412,9,421,1
2021-01-01,Riverside,065,2383286,204160,188674,9260,197934,1990
2021-01-01,Sacramento,067,1510023,70349,66956,674,67630,848
2021-01-01,San Benito,069,59416,4002,3773,34,3807,28
2021-01-01,San Bernardino,071,2135413,218606,203651,5918,209569,1590
2021-01-01,San Diego,073,3302833,178573,160071,8078,168149,1592
2021-01-01,San Francisco,075,870044,25228,24145,237,24382,187
2021-01-01,San Joaquin,077,732212,49546,46640,1758,48398,657
2021-01-01,San Luis Obispo,079,281455,12519,11160,270,11430,94
2021-01-01,San Mateo,081,765935,27774,25041,133,25174,194
2021-01-01,Santa Barbara,083,443738,19654,17759,565,18324,164
2021-01-01,Santa Clara,085,1922200,77678,71904,312,72216,680
2021-01-01,Santa Cruz,087,273765,10431,9146,384,9530,84
2021-01-01,Shasta,089,179085,8693,8102,764,8866,72
2021-01-01,Sierra,091,2930,36,26,6,32,0
2021-01-01,Siskiyou,093,43540,1081,944,121,1065,3
2021-01-01,Solano,095,438530,21186,19393,212,19605,97
2021-01-01,Sonoma,097,501317,20642,19513,111,19624,189
2021-01-01,Stanislaus,099,539301,37315,34978,3447,38425,553
2021-01-01,Sutter,101,95872,6809,6553,47,6600,52
2021-01-01,Tehama,103,63373,3328,3079,318,3397,9
2021-01-01,Trinity,105,12862,426,243,58,301,2
2021-01-01,Tulare,107,460477,36601,33994,4048,38042,454
2021-01-01,Tuolumne,109,53932,2972,2909,17,2926,13
2021-01-01,Ventura,111,848112,46333,42026,1753,43779,253
2021-01-01,Yolo,113,214977,9253,8461,69,8530,120
2021-01-01,Yuba,115,75493,4149,3845,41,3886,19
2020-12-31,Alameda,001,1643700,56694,52475,1042,53517,579
2020-12-31,Alpine,003,1148,69,66,0,66,0
2020-12-31,Amador,005,37829,2712,2493,20,2513,24
2020-12-31,Butte,007,227075,8328,7405,964,8369,105
2020-12-31,Calaveras,009,45235,1247,1161,3,1164,21
2020-12-31,Colusa,011,21464,1386,1301,96,1397,7
2020-12-31,Contra Costa,013,1133247,43818,40512,631,41143,336
2020-12-31,Del Norte,015,27424,795,748,2,750,2
2020-12-31,El Dorado,017,186661,6732,5662,350,6012,26
2020-12-31,Fresno,019,978130,73075,66442,5007,71449,711
2020-12-31,Glenn,021,27897,1689,1484,291,1775,9
2020-12-31,Humboldt,023,135768,1927,1713,7,1720,21
2020-12-31,Imperial,025,180216,23777,22494,1530,24024,417
2020-12-31,Inyo,027,18085,729,591,8,599,20
2020-12-31,Kern,029,883053,70381,64904,5477,70381,609
2020-12-31,Kings,031,150075,17122,16077,557,16634,108
2020-12-31,Lake,033,64148,2057,1848,0,1848,23
2020-12-31,Lassen,035,31185,4579,4340,52,4392,1
2020-12-31,Los Angeles,037,10098052,841715,755844,23647,779491,10320
2020-12-31,Madera,039,155013,11582,10609,474,11083,64
2020-12-31,Marin,041,260295,10261,9731,90,9821,148
2020-12-31,Mariposa,043,17540,274,217,2,219,3
2020-12-31,Mendocino,045,87422,2585,2367,23,2390,24
2020-12-31,Merced,047,269075,20192,18808,380,19188,226
2020-12-31,Modoc,049,8938,269,238,76,314,0
2020-12-31,Mono,051,14174,906,868,11,879,3
2020-12-31,Monterey,053,433212,30225,27720,743,28463,188
2020-12-31,Napa,055,140530,6370,5801,25,5826,28
2020-12-31,Nevada,057,99092,2906,2619,95,2714,15
2020-12-31,Orange,059,3164182,176887,161586,6853,168439,1866
2020-12-31,Placer,061,380077,15550,13708,639,14347,126
2020-12-31,Plumas,063,18699,494,401,8,409,1
2020-12-31,Riverside,065,2383286,202481,184193,9132,193325,1958
2020-12-31,Sacramento,067,1510023,69819,65817,664,66481,830
2020-12-31,San Benito,069,59416,3978,3673,34,3707,28
2020-12-31,San Bernardino,071,2135413,216949,199115,5846,204961,1586
2020-12-31,San Diego,073,3302833,176810,155593,7979,163572,1534
2020-12-31,San Francisco,075,870044,24997,23740,230,23970,183
2020-12-31,San Joaquin,077,732212,49227,45764,1721,47485,646
2020-12-31,San Luis Obispo,079,281455,12405,10846,270,11116,89
2020-12-31,San Mateo,081,765935,27444,24570,127,24697,192
2020-12-31,Santa Barbara,083,443738,19410,17434,558,17992,161
2020-12-31,Santa Clara,085,1922200,76861,70032,307,70339,665
2020-12-31,Santa Cruz,087,273765,10313,8909,372,9281,84
2020-12-31,Shasta,089,179085,8627,7996,754,8750,69
2020-12-31,Sierra,091,2930,36,26,6,32,0
2020-12-31,Siskiyou,093,43540,1065,940,118,1058,3
2020-12-31,Solano,095,438530,20955,18942,211,19153,97
2020-12-31,Sonoma,097,501317,20521,19129,110,19239,188
2020-12-31,Stanislaus,099,539301,37007,34398,3400,37798,552
2020-12-31,Sutter,101,95872,6778,6432,47,6479,51
2020-12-31,Tehama,103,63373,3292,3036,317,3353,9
2020-12-31,Trinity,105,12862,425,241,58,299,2
2020-12-31,Tulare,107,460477,36423,33412,3987,37399,446
2020-12-31,Tuolumne,109,53932,2963,2902,17,2919,12
2020-12-31,Ventura,111,848112,45822,40854,1736,42590,251
2020-12-31,Yolo,113,214977,9166,8295,68,8363,117
2020-12-31,Yuba,115,75493,4108,3799,40,3839,18
2020-12-30,Alameda,001,1643700,55910,50158,989,51147,573
2020-12-30,Alpine,003,1148,69,66,0,66,0
2020-12-30,Amador,005,37829,2692,2418,19,2437,24
2020-12-30,Butte,007,227075,8167,7140,944,8084,103
2020-12-30,Calaveras,009,45235,1222,1135,3,1138,21
2020-12-30,Colusa,011,21464,1370,1289,90,1379,7
2020-12-30,Contra Costa,013,1133247,43234,39601,619,40220,337
2020-12-30,Del Norte,015,27424,790,726,2,728,2
2020-12-30,El Dorado,017,186661,6631,5595,340,5935,27
2020-12-30,Fresno,019,978130,72229,65566,4858,70424,711
2020-12-30,Glenn,021,27897,1658,1471,279,1750,9
2020-12-30,Humboldt,023,135768,1893,1654,7,1661,22
2020-12-30,Imperial,025,180216,23608,22098,1455,23553,412
2020-12-30,Inyo,027,18085,722,572,8,580,20
2020-12-30,Kern,029,883053,69653,63292,5333,68625,604
2020-12-30,Kings,031,150075,17003,15862,549,16411,108
2020-12-30,Lake,033,64148,2035,1731,0,1731,23
2020-12-30,Lassen,035,31185,4570,4300,52,4352,1
2020-12-30,Los Angeles,037,10098052,830798,741907,22973,764880,10046
2020-12-30,Madera,039,155013,11472,10249,463,10712,65
2020-12-30,Marin,041,260295,10171,9569,84,9653,148
2020-12-30,Mariposa,043,17540,270,214,2,216,3
2020-12-30,Mendocino,045,87422,2567,2291,20,2311,24
2020-12-30,Merced,047,269075,19902,18519,370,18889,225
2020-12-30,Modoc,049,8938,266,234,76,310,0
2020-12-30,Mono,051,14174,903,868,11,879,3
2020-12-30,Monterey,053,433212,29595,26977,721,27698,186
2020-12-30,Napa,055,140530,6264,5754,25,5779,28
2020-12-30,Nevada,057,99092,2871,2595,93,2688,15
2020-12-30,Orange,059,3164182,174228,153951,6667,160618,1863
2020-12-30,Placer,061,380077,15318,13540,627,14167,127
2020-12-30,Plumas,063,18699,489,397,8,405,1
2020-12-30,Riverside,065,2383286,199534,176402,8948,185350,1919
2020-12-30,Sacramento,067,1510023,68946,64119,647,64766,847
2020-12-30,San Benito,069,59416,3897,3464,30,3494,29
2020-12-30,San Bernardino,071,2135413,214385,192648,5760,198408,1591
2020-12-30,San Diego,073,3302833,173177,152510,7804,160314,1472
2020-12-30,San Francisco,075,870044,24704,23099,225,23324,182
2020-12-30,San Joaquin,077,732212,48532,44465,1680,46145,634
2020-12-30,San Luis Obispo,079,281455,12136,10542,262,10804,89
2020-12-30,San Mateo,081,765935,27015,24150,123,24273,190
2020-12-30,Santa Barbara,083,443738,19008,16895,537,17432,161
2020-12-30,Santa Clara,085,1922200,75616,67218,303,67521,661
2020-12-30,Santa Cruz,087,273765,10119,8787,363,9150,86
2020-12-30,Shasta,089,179085,8513,7818,740,8558,69
2020-12-30,Sierra,091,2930,36,25,6,31,0
2020-12-30,Siskiyou,093,43540,1058,913,110,1023,3
2020-12-30,Solano,095,438530,20563,18300,208,18508,96
2020-12-30,Sonoma,097,501317,20264,18947,110,19057,191
2020-12-30,Stanislaus,099,539301,36543,33730,3325,37055,526
2020-12-30,Sutter,101,95872,6717,6328,45,6373,51
2020-12-30,Tehama,103,63373,3248,2969,313,3282,9
2020-12-30,Trinity,105,12862,424,231,57,288,2
2020-12-30,Tulare,107,460477,35876,32413,3923,36336,430
2020-12-30,Tuolumne,109,53932,2953,2772,15,2787,12
2020-12-30,Ventura,111,848112,44534,39039,1712,40751,251
2020-12-30,Yolo,113,214977,9058,8067,66,8133,117
2020-12-30,Yuba,115,75493,4037,3612,40,3652,18
2020-12-29,Alameda,001,1643700,54842,50946,954,51900,552
2020-12-29,Alpine,003,1148,69,65,0,65,0
2020-12-29,Amador,005,37829,2640,2388,18,2406,23
2020-12-29,Butte,007,227075,7994,7178,920,8098,98
2020-12-29,Calaveras,009,45235,1178,1111,2,1113,21
2020-12-29,Colusa,011,21464,1349,1272,85,1357,7
2020-12-29,Contra Costa,013,1133247,42432,39225,588,39813,325
2020-12-29,Del Norte,015,27424,783,724,2,726,2
2020-12-29,El Dorado,017,186661,6501,5551,327,5878,22
2020-12-29,Fresno,019,978130,70853,65149,4708,69857,688
2020-12-29,Glenn,021,27897,1624,1454,272,1726,9
2020-12-29,Humboldt,023,135768,1845,1616,7,1623,19
2020-12-29,Imperial,025,180216,23395,22105,1370,23475,407
2020-12-29,Inyo,027,18085,705,571,8,579,19
2020-12-29,Kern,029,883053,68487,63096,5165,68261,589
2020-12-29,Kings,031,150075,16834,15777,537,16314,108
2020-12-29,Lake,033,64148,2004,1805,0,1805,22
2020-12-29,Lassen,035,31185,4555,4288,52,4340,1
2020-12-29,Los Angeles,037,10098052,810594,731907,22133,754040,9786
2020-12-29,Madera,039,155013,11158,10251,450,10701,64
2020-12-29,Marin,041,260295,10019,9595,80,9675,146
2020-12-29,Mariposa,043,17540,262,212,2,214,3
2020-12-29,Mendocino,045,87422,2524,2249,19,2268,24
2020-12-29,Merced,047,269075,19552,18464,354,18818,221
2020-12-29,Modoc,049,8938,263,232,76,308,0
2020-12-29,Mono,051,14174,894,868,11,879,3
2020-12-29,Monterey,053,433212,28946,26894,696,27590,185
2020-12-29,Napa,055,140530,6146,5663,25,5688,28
2020-12-29,Nevada,057,99092,2823,2550,92,2642,15
2020-12-29,Orange,059,3164182,170437,154411,6503,160914,1839
2020-12-29,Placer,061,380077,15105,13392,606,13998,126
2020-12-29,Plumas,063,18699,480,395,8,403,1
2020-12-29,Riverside,065,2383286,194934,177624,8698,186322,1904
2020-12-29,Sacramento,067,1510023,67895,65078,635,65713,820
2020-12-29,San Benito,069,59416,3778,3474,29,3503,25
2020-12-29,San Bernardino,071,2135413,209562,190476,5624,196100,1557
2020-12-29,San Diego,073,3302833,168954,150062,7573,157635,1435
2020-12-29,San Francisco,075,870044,24366,22996,218,23214,178
2020-12-29,San Joaquin,077,732212,47612,44699,1627,46326,622
2020-12-29,San Luis Obispo,079,281455,11840,10387,254,10641,80
2020-12-29,San Mateo,081,765935,26473,23773,111,23884,189
2020-12-29,Santa Barbara,083,443738,18539,16797,511,17308,155
2020-12-29,Santa Clara,085,1922200,74071,67581,300,67881,621
2020-12-29,Santa Cruz,087,273765,9848,8492,354,8846,84
2020-12-29,Shasta,089,179085,8409,7782,725,8507,65
2020-12-29,Sierra,091,2930,34,24,5,29,0
2020-12-29,Siskiyou,093,43540,1043,926,108,1034,3
2020-12-29,Solano,095,438530,20181,18412,203,18615,96
2020-12-29,Sonoma,097,501317,19930,18790,108,18898,187
2020-12-29,Stanislaus,099,539301,36067,33775,3255,37030,508
2020-12-29,Sutter,101,95872,6650,6302,45,6347,50
2020-12-29,Tehama,103,63373,3179,2962,301,3263,9
2020-12-29,Trinity,105,12862,423,241,57,298,2
2020-12-29,Tulare,107,460477,35220,32545,3794,36339,419
2020-12-29,Tuolumne,109,53932,2911,2797,15,2812,12
2020-12-29,Ventura,111,848112,43279,38669,1686,40355,235
2020-12-29,Yolo,113,214977,8929,8124,64,8188,111
2020-12-29,Yuba,115,75493,3955,3723,40,3763,18
2020-12-28,Alameda,001,1643700,53798,50405,934,51339,551
2020-12-28,Alpine,003,1148,68,65,0,65,0
2020-12-28,Amador,005,37829,2570,2255,18,2273,23
2020-12-28,Butte,007,227075,7827,7053,890,7943,86
2020-12-28,Calaveras,009,45235,1155,1102,2,1104,21
2020-12-28,Colusa,011,21464,1324,1255,74,1329,7
2020-12-28,Contra Costa,013,1133247,41494,38872,562,39434,324
2020-12-28,Del Norte,015,27424,773,718,2,720,2
2020-12-28,El Dorado,017,186661,6345,5441,315,5756,18
2020-12-28,Fresno,019,978130,69584,64274,4559,68833,679
2020-12-28,Glenn,021,27897,1590,1435,260,1695,9
2020-12-28,Humboldt,023,135768,1810,1579,7,1586,19
2020-12-28,Imperial,025,180216,23136,22003,1297,23300,405
2020-12-28,Inyo,027,18085,698,569,8,577,19
2020-12-28,Kern,029,883053,67420,62392,4965,67357,579
2020-12-28,Kings,031,150075,16617,15733,520,16253,108
2020-12-28,Lake,033,64148,1963,1785,0,1785,22
2020-12-28,Lassen,035,31185,4448,4284,51,4335,1
2020-12-28,Los Angeles,037,10098052,788240,720699,21340,742039,9544
2020-12-28,Madera,039,155013,10984,10123,428,10551,64
2020-12-28,Marin,041,260295,9911,9546,74,9620,145
2020-12-28,Mariposa,043,17540,238,211,2,213,3
2020-12-28,Mendocino,045,87422,2489,2214,19,2233,23
2020-12-28,Merced,047,269075,19232,18245,336,18581,213
2020-12-28,Modoc,049,8938,258,220,75,295,0
2020-12-28,Mono,051,14174,890,848,11,859,3
2020-12-28,Monterey,053,433212,28098,26529,687,27216,182
2020-12-28,Napa,055,140530,6037,5576,25,5601,26
2020-12-28,Nevada,057,99092,2775,2532,88,2620,15
2020-12-28,Orange,059,3164182,166332,152089,6328,158417,1839
2020-12-28,Placer,061,380077,14765,13234,579,13813,126
2020-12-28,Plumas,063,18699,476,391,8,399,0
2020-12-28,Riverside,065,2383286,190037,174029,8410,182439,1855
2020-12-28,Sacramento,067,1510023,66659,64322,611,64933,813
2020-12-28,San Benito,069,59416,3709,3429,29,3458,24
2020-12-28,San Bernardino,071,2135413,204468,188919,5511,194430,1552
2020-12-28,San Diego,073,3302833,164210,147528,7391,154919,1404
2020-12-28,San Francisco,075,870044,24006,22726,213,22939,178
2020-12-28,San Joaquin,077,732212,46679,44172,1595,45767,618
2020-12-28,San Luis Obispo,079,281455,11490,10260,250,10510,76
2020-12-28,San Mateo,081,765935,25999,23467,107,23574,189
2020-12-28,Santa Barbara,083,443738,18071,16579,499,17078,155
2020-12-28,Santa Clara,085,1922200,72585,66418,293,66711,619
2020-12-28,Santa Cruz,087,273765,9582,8310,344,8654,81
2020-12-28,Shasta,089,179085,8292,7688,712,8400,65
2020-12-28,Sierra,091,2930,32,24,4,28,0
2020-12-28,Siskiyou,093,43540,1027,915,103,1018,3
2020-12-28,Solano,095,438530,19609,18171,196,18367,96
2020-12-28,Sonoma,097,501317,19583,18667,106,18773,185
2020-12-28,Stanislaus,099,539301,35520,33473,3193,36666,507
2020-12-28,Sutter,101,95872,6570,6253,45,6298,49
2020-12-28,Tehama,103,63373,3126,2934,294,3228,9
2020-12-28,Trinity,105,12862,421,240,57,297,2
2020-12-28,Tulare,107,460477,34539,32010,3688,35698,404
2020-12-28,Tuolumne,109,53932,2894,2777,15,2792,12
2020-12-28,Ventura,111,848112,41610,37151,1641,38792,230
2020-12-28,Yolo,113,214977,8775,8031,63,8094,111
2020-12-28,Yuba,115,75493,3893,3679,39,3718,18
2020-12-27,Alameda,001,1643700,52555,49764,907,50671,551
2020-12-27,Alpine,003,1148,66,65,0,65,0
2020-12-27,Amador,005,37829,2450,2218,18,2236,23
2020-12-27,Butte,007,227075,7672,7016,852,7868,86
2020-12-27,Calaveras,009,45235,1109,1097,2,1099,21
2020-12-27,Colusa,011,21464,1299,1253,71,1324,7
2020-12-27,Contra Costa,013,1133247,40562,38428,536,38964,324
2020-12-27,Del Norte,015,27424,750,712,2,714,2
2020-12-27,El Dorado,017,186661,6131,5388,292,5680,18
2020-12-27,Fresno,019,978130,68337,63811,4356,68167,679
2020-12-27,Glenn,021,27897,1562,1434,246,1680,9
2020-12-27,Humboldt,023,135768,1766,1575,7,1582,17
2020-12-27,Imperial,025,180216,22837,21934,1188,23122,405
2020-12-27,Inyo,027,18085,676,565,7,572,18
2020-12-27,Kern,029,883053,66139,61914,4799,66713,568
2020-12-27,Kings,031,150075,16381,15593,486,16079,108
2020-12-27,Lake,033,64148,1908,1769,0,1769,22
2020-12-27,Lassen,035,31185,4371,4230,44,4274,1
2020-12-27,Los Angeles,037,10098052,766723,707260,20464,727724,9476
2020-12-27,Madera,039,155013,10727,10005,418,10423,64
2020-12-27,Marin,041,260295,9788,9477,70,9547,144
2020-12-27,Mariposa,043,17540,231,208,2,210,3
2020-12-27,Mendocino,045,87422,2442,2209,19,2228,23
2020-12-27,Merced,047,269075,18864,18075,320,18395,213
2020-12-27,Modoc,049,8938,249,221,71,292,0
2020-12-27,Mono,051,14174,878,849,11,860,3
2020-12-27,Monterey,053,433212,27537,26322,670,26992,181
2020-12-27,Napa,055,140530,5903,5496,25,5521,26
2020-12-27,Nevada,057,99092,2739,2519,88,2607,15
2020-12-27,Orange,059,3164182,161933,149276,6139,155415,1839
2020-12-27,Placer,061,380077,14470,13017,547,13564,126
2020-12-27,Plumas,063,18699,470,390,8,398,0
2020-12-27,Riverside,065,2383286,185123,171995,8110,180105,1836
2020-12-27,Sacramento,067,1510023,65452,63416,589,64005,811
2020-12-27,San Benito,069,59416,3624,3394,29,3423,24
2020-12-27,San Bernardino,071,2135413,199389,186776,5374,192150,1551
2020-12-27,San Diego,073,3302833,159803,145777,7204,152981,1402
2020-12-27,San Francisco,075,870044,23660,22514,205,22719,178
2020-12-27,San Joaquin,077,732212,45643,43529,1546,45075,618
2020-12-27,San Luis Obispo,079,281455,11082,10154,245,10399,76
2020-12-27,San Mateo,081,765935,25435,23136,104,23240,187
2020-12-27,Santa Barbara,083,443738,17542,16364,472,16836,155
2020-12-27,Santa Clara,085,1922200,70954,65288,288,65576,619
2020-12-27,Santa Cruz,087,273765,9317,8234,336,8570,81
2020-12-27,Shasta,089,179085,8165,7671,690,8361,65
2020-12-27,Sierra,091,2930,32,24,3,27,0
2020-12-27,Siskiyou,093,43540,1017,914,98,1012,3
2020-12-27,Solano,095,438530,19115,17840,190,18030,96
2020-12-27,Sonoma,097,501317,19292,18487,105,18592,185
2020-12-27,Stanislaus,099,539301,34902,33076,3101,36177,506
2020-12-27,Sutter,101,95872,6489,6218,43,6261,48
2020-12-27,Tehama,103,63373,3055,2922,278,3200,9
2020-12-27,Trinity,105,12862,414,240,55,295,2
2020-12-27,Tulare,107,460477,33942,31864,3570,35434,400
2020-12-27,Tuolumne,109,53932,2788,2750,13,2763,12
2020-12-27,Ventura,111,848112,40547,36661,1590,38251,230
2020-12-27,Yolo,113,214977,8586,7919,59,7978,111
2020-12-27,Yuba,115,75493,3828,3665,37,3702,18
2020-12-26,Alameda,001,1643700,51934,49084,894,49978,551
2020-12-26,Alpine,003,1148,66,65,0,65,0
2020-12-26,Amador,005,37829,2436,2189,18,2207,23
2020-12-26,Butte,007,227075,7577,6968,828,7796,86
2020-12-26,Calaveras,009,45235,1103,1084,2,1086,21
2020-12-26,Colusa,011,21464,1289,1240,71,1311,7
2020-12-26,Contra Costa,013,1133247,40095,38008,522,38530,324
2020-12-26,Del Norte,015,27424,744,709,2,711,2
2020-12-26,El Dorado,017,186661,6076,5279,288,5567,18
2020-12-26,Fresno,019,978130,67867,63080,4293,67373,679
2020-12-26,Glenn,021,27897,1541,1413,241,1654,9
2020-12-26,Humboldt,023,135768,1728,1545,7,1552,17
2020-12-26,Imperial,025,180216,22745,21734,1136,22870,405
2020-12-26,Inyo,027,18085,663,554,7,561,18
2020-12-26,Kern,029,883053,65469,61174,4652,65826,564
2020-12-26,Kings,031,150075,16263,15517,482,15999,108
2020-12-26,Lake,033,64148,1867,1710,0,1710,22
2020-12-26,Lassen,035,31185,4350,3981,44,4025,1
2020-12-26,Los Angeles,037,10098052,758157,694149,19969,714118,9424
2020-12-26,Madera,039,155013,10650,9908,406,10314,64
2020-12-26,Marin,041,260295,9753,9413,69,9482,143
2020-12-26,Mariposa,043,17540,230,206,2,208,3
2020-12-26,Mendocino,045,87422,2396,2194,19,2213,23
2020-12-26,Merced,047,269075,18705,17890,315,18205,213
2020-12-26,Modoc,049,8938,246,222,71,293,0
2020-12-26,Mono,051,14174,872,850,11,861,3
2020-12-26,Monterey,053,433212,27400,26010,661,26671,182
2020-12-26,Napa,055,140530,5845,5427,25,5452,26
2020-12-26,Nevada,057,99092,2711,2480,88,2568,15
2020-12-26,Orange,059,3164182,159727,147304,6048,153352,1838
2020-12-26,Placer,061,380077,14299,12816,532,13348,122
2020-12-26,Plumas,063,18699,467,381,8,389,0
2020-12-26,Riverside,065,2383286,182638,169360,7952,177312,1834
2020-12-26,Sacramento,067,1510023,64829,62435,579,63014,807
2020-12-26,San Benito,069,59416,3551,3330,29,3359,24
2020-12-26,San Bernardino,071,2135413,197714,185111,5292,190403,1551
2020-12-26,San Diego,073,3302833,157278,142644,7057,149701,1402
2020-12-26,San Francisco,075,870044,23422,22319,205,22524,177
2020-12-26,San Joaquin,077,732212,45256,42887,1498,44385,618
2020-12-26,San Luis Obispo,079,281455,10995,9945,240,10185,76
2020-12-26,San Mateo,081,765935,25097,22908,99,23007,187
2020-12-26,Santa Barbara,083,443738,17303,16159,466,16625,155
2020-12-26,Santa Clara,085,1922200,69883,64185,286,64471,618
2020-12-26,Santa Cruz,087,273765,9191,8113,327,8440,81
2020-12-26,Shasta,089,179085,8105,7641,678,8319,65
2020-12-26,Sierra,091,2930,32,24,3,27,0
2020-12-26,Siskiyou,093,43540,1010,909,94,1003,2
2020-12-26,Solano,095,438530,18870,17528,190,17718,96
2020-12-26,Sonoma,097,501317,19089,18261,103,18364,184
2020-12-26,Stanislaus,099,539301,34602,32678,3048,35726,505
2020-12-26,Sutter,101,95872,6431,6121,43,6164,48
2020-12-26,Tehama,103,63373,3026,2884,272,3156,9
2020-12-26,Trinity,105,12862,412,237,54,291,2
2020-12-26,Tulare,107,460477,33636,31665,3513,35178,398
2020-12-26,Tuolumne,109,53932,2777,2703,13,2716,12
2020-12-26,Ventura,111,848112,39582,36064,1560,37624,230
2020-12-26,Yolo,113,214977,8483,7785,57,7842,111
2020-12-26,Yuba,115,75493,3799,3599,37,3636,18
2020-12-25,Alameda,001,1643700,51364,48365,879,49244,542
2020-12-25,Alpine,003,1148,66,64,0,64,0
2020-12-25,Amador,005,37829,2393,2172,18,2190,23
2020-12-25,Butte,007,227075,7478,6873,809,7682,85
2020-12-25,Calaveras,009,45235,1100,1062,2,1064,21
2020-12-25,Colusa,011,21464,1277,1219,70,1289,7
2020-12-25,Contra Costa,013,1133247,39627,37480,497,37977,324
2020-12-25,Del Norte,015,27424,741,692,2,694,2
2020-12-25,El Dorado,017,186661,6011,5170,275,5445,16
2020-12-25,Fresno,019,978130,67003,62251,4213,66464,679
2020-12-25,Glenn,021,27897,1525,1390,234,1624,9
2020-12-25,Humboldt,023,135768,1688,1532,7,1539,16
2020-12-25,Imperial,025,180216,22650,21646,1125,22771,405
2020-12-25,Inyo,027,18085,653,546,7,553,18
2020-12-25,Kern,029,883053,64738,60417,4506,64923,562
2020-12-25,Kings,031,150075,16152,15460,478,15938,108
2020-12-25,Lake,033,64148,1847,1669,0,1669,20
2020-12-25,Lassen,035,31185,4335,3926,44,3970,1
2020-12-25,Los Angeles,037,10098052,744493,665600,19308,684908,9292
2020-12-25,Madera,039,155013,10482,9770,400,10170,64
2020-12-25,Marin,041,260295,9704,9375,67,9442,143
2020-12-25,Mariposa,043,17540,224,203,2,205,3
2020-12-25,Mendocino,045,87422,2353,2176,19,2195,23
2020-12-25,Merced,047,269075,18544,17726,307,18033,213
2020-12-25,Modoc,049,8938,245,221,71,292,0
2020-12-25,Mono,051,14174,870,843,11,854,3
2020-12-25,Monterey,053,433212,27123,25788,652,26440,182
2020-12-25,Napa,055,140530,5768,5351,25,5376,26
2020-12-25,Nevada,057,99092,2685,2458,86,2544,15
2020-12-25,Orange,059,3164182,157045,144542,5858,150400,1814
2020-12-25,Placer,061,380077,14113,12660,510,13170,122
2020-12-25,Plumas,063,18699,460,381,8,389,0
2020-12-25,Riverside,065,2383286,179354,166690,7641,174331,1825
2020-12-25,Sacramento,067,1510023,64135,61630,554,62184,796
2020-12-25,San Benito,069,59416,3510,3281,27,3308,24
2020-12-25,San Bernardino,071,2135413,195090,181812,5177,186989,1546
2020-12-25,San Diego,073,3302833,154798,139958,6879,146837,1402
2020-12-25,San Francisco,075,870044,23145,22130,200,22330,175
2020-12-25,San Joaquin,077,732212,44949,42089,1444,43533,614
2020-12-25,San Luis Obispo,079,281455,10812,9749,233,9982,76
2020-12-25,San Mateo,081,765935,24775,22568,97,22665,187
2020-12-25,Santa Barbara,083,443738,17079,15936,459,16395,155
2020-12-25,Santa Clara,085,1922200,68768,63173,277,63450,612
2020-12-25,Santa Cruz,087,273765,9048,8018,306,8324,81
2020-12-25,Shasta,089,179085,8031,7612,655,8267,65
2020-12-25,Sierra,091,2930,32,24,3,27,0
2020-12-25,Siskiyou,093,43540,1004,905,92,997,2
2020-12-25,Solano,095,438530,18698,17280,188,17468,96
2020-12-25,Sonoma,097,501317,18914,18035,101,18136,184
2020-12-25,Stanislaus,099,539301,34302,32290,2997,35287,498
2020-12-25,Sutter,101,95872,6372,6051,42,6093,47
2020-12-25,Tehama,103,63373,2977,2839,259,3098,9
2020-12-25,Trinity,105,12862,408,236,54,290,2
2020-12-25,Tulare,107,460477,33243,31323,3448,34771,398
2020-12-25,Tuolumne,109,53932,2758,2674,13,2687,12
2020-12-25,Ventura,111,848112,38426,35514,1512,37026,230
2020-12-25,Yolo,113,214977,8387,7700,55,7755,111
2020-12-25,Yuba,115,75493,3763,3549,36,3585,17
2020-12-24,Alameda,001,1643700,51007,47527,861,48388,541
2020-12-24,Alpine,003,1148,66,64,0,64,0
2020-12-24,Amador,005,37829,2381,2145,18,2163,23
2020-12-24,Butte,007,227075,7439,6716,794,7510,84
2020-12-24,Calaveras,009,45235,1097,1032,2,1034,21
2020-12-24,Colusa,011,21464,1272,1188,68,1256,7
2020-12-24,Contra Costa,013,1133247,39387,36623,485,37108,311
2020-12-24,Del Norte,015,27424,741,678,2,680,2
2020-12-24,El Dorado,017,186661,5985,5042,267,5309,16
2020-12-24,Fresno,019,978130,66780,61435,4199,65634,663
2020-12-24,Glenn,021,27897,1514,1363,226,1589,9
2020-12-24,Humboldt,023,135768,1665,1516,7,1523,16
2020-12-24,Imperial,025,180216,22600,21545,1116,22661,402
2020-12-24,Inyo,027,18085,651,532,7,539,17
2020-12-24,Kern,029,883053,64451,59601,4493,64094,556
2020-12-24,Kings,031,150075,16112,15211,477,15688,108
2020-12-24,Lake,033,64148,1832,1629,0,1629,20
2020-12-24,Lassen,035,31185,4322,3894,44,3938,1
2020-12-24,Los Angeles,037,10098052,740307,664840,19061,683901,9288
2020-12-24,Madera,039,155013,10442,9547,393,9940,63
2020-12-24,Marin,041,260295,9670,9287,67,9354,143
2020-12-24,Mariposa,043,17540,220,197,2,199,3
2020-12-24,Mendocino,045,87422,2342,2150,19,2169,23
2020-12-24,Merced,047,269075,18474,17485,303,17788,212
2020-12-24,Modoc,049,8938,245,220,70,290,0
2020-12-24,Mono,051,14174,868,817,11,828,3
2020-12-24,Monterey,053,433212,27011,25131,645,25776,180
2020-12-24,Napa,055,140530,5713,5265,25,5290,26
2020-12-24,Nevada,057,99092,2661,2429,86,2515,15
2020-12-24,Orange,059,3164182,155562,141205,5807,147012,1775
2020-12-24,Placer,061,380077,14023,12457,503,12960,121
2020-12-24,Plumas,063,18699,457,376,8,384,0
2020-12-24,Riverside,065,2383286,178419,162435,7601,170036,1816
2020-12-24,Sacramento,067,1510023,63860,60596,552,61148,788
2020-12-24,San Benito,069,59416,3479,3183,27,3210,24
2020-12-24,San Bernardino,071,2135413,194028,176866,5144,182010,1533
2020-12-24,San Diego,073,3302833,153714,136952,6847,143799,1382
2020-12-24,San Francisco,075,870044,22977,21830,197,22027,175
2020-12-24,San Joaquin,077,732212,44784,41324,1426,42750,611
2020-12-24,San Luis Obispo,079,281455,10743,9504,231,9735,77
2020-12-24,San Mateo,081,765935,24580,22093,97,22190,186
2020-12-24,Santa Barbara,083,443738,16974,15644,451,16095,153
2020-12-24,Santa Clara,085,1922200,68156,61742,270,62012,591
2020-12-24,Santa Cruz,087,273765,8976,7856,294,8150,82
2020-12-24,Shasta,089,179085,7990,7540,638,8178,65
2020-12-24,Sierra,091,2930,29,23,1,24,0
2020-12-24,Siskiyou,093,43540,999,900,86,986,2
2020-12-24,Solano,095,438530,18557,16872,183,17055,96
2020-12-24,Sonoma,097,501317,18814,17710,101,17811,183
2020-12-24,Stanislaus,099,539301,34098,31848,2971,34819,498
2020-12-24,Sutter,101,95872,6331,5960,41,6001,47
2020-12-24,Tehama,103,63373,2959,2779,257,3036,9
2020-12-24,Trinity,105,12862,407,235,54,289,2
2020-12-24,Tulare,107,460477,33123,30827,3423,34250,390
2020-12-24,Tuolumne,109,53932,2750,2653,13,2666,12
2020-12-24,Ventura,111,848112,38146,34400,1505,35905,224
2020-12-24,Yolo,113,214977,8345,7566,54,7620,113
2020-12-24,Yuba,115,75493,3738,3483,36,3519,16
2020-12-23,Alameda,001,1643700,50429,46753,834,47587,537
2020-12-23,Alpine,003,1148,66,64,0,64,0
2020-12-23,Amador,005,37829,2312,2108,17,2125,23
2020-12-23,Butte,007,227075,7350,6588,768,7356,84
2020-12-23,Calaveras,009,45235,1089,1002,1,1003,21
2020-12-23,Colusa,011,21464,1261,1167,67,1234,7
2020-12-23,Contra Costa,013,1133247,38986,36190,472,36662,311
2020-12-23,Del Norte,015,27424,734,670,2,672,2
2020-12-23,El Dorado,017,186661,5910,4967,259,5226,14
2020-12-23,Fresno,019,978130,66170,60488,4134,64622,654
2020-12-23,Glenn,021,27897,1500,1349,222,1571,9
2020-12-23,Humboldt,023,135768,1640,1458,7,1465,16
2020-12-23,Imperial,025,180216,22505,21323,1087,22410,399
2020-12-23,Inyo,027,18085,639,517,7,524,17
2020-12-23,Kern,029,883053,63933,58656,4402,63058,549
2020-12-23,Kings,031,150075,16035,14923,474,15397,105
2020-12-23,Lake,033,64148,1819,1595,0,1595,20
2020-12-23,Lassen,035,31185,4312,3865,41,3906,1
2020-12-23,Los Angeles,037,10098052,731239,651958,18540,670498,9146
2020-12-23,Madera,039,155013,10283,9371,379,9750,63
2020-12-23,Marin,041,260295,9612,9199,64,9263,142
2020-12-23,Mariposa,043,17540,218,194,2,196,3
2020-12-23,Mendocino,045,87422,2330,2121,19,2140,23
2020-12-23,Merced,047,269075,18318,17250,295,17545,203
2020-12-23,Modoc,049,8938,241,197,69,266,0
2020-12-23,Mono,051,14174,865,814,11,825,3
2020-12-23,Monterey,053,433212,26711,24856,640,25496,176
2020-12-23,Napa,055,140530,5645,5172,25,5197,25
2020-12-23,Nevada,057,99092,2616,2406,85,2491,15
2020-12-23,Orange,059,3164182,153111,138050,5645,143695,1771
2020-12-23,Placer,061,380077,13813,12213,495,12708,111
2020-12-23,Plumas,063,18699,450,369,8,377,0
2020-12-23,Riverside,065,2383286,176148,158110,7446,165556,1790
2020-12-23,Sacramento,067,1510023,63210,59661,539,60200,779
2020-12-23,San Benito,069,59416,3425,3073,25,3098,24
2020-12-23,San Bernardino,071,2135413,191975,172888,5076,177964,1509
2020-12-23,San Diego,073,3302833,151288,134695,6710,141405,1350
2020-12-23,San Francisco,075,870044,22756,21498,194,21692,174
2020-12-23,San Joaquin,077,732212,44261,35664,1385,37049,602
2020-12-23,San Luis Obispo,079,281455,10601,9267,226,9493,74
2020-12-23,San Mateo,081,765935,24278,21780,95,21875,186
2020-12-23,Santa Barbara,083,443738,16766,15399,426,15825,152
2020-12-23,Santa Clara,085,1922200,67242,60455,265,60720,579
2020-12-23,Santa Cruz,087,273765,8816,7637,276,7913,75
2020-12-23,Shasta,089,179085,7918,7487,632,8119,66
2020-12-23,Sierra,091,2930,27,23,1,24,0
2020-12-23,Siskiyou,093,43540,978,891,85,976,2
2020-12-23,Solano,095,438530,18349,16626,179,16805,95
2020-12-23,Sonoma,097,501317,18610,17397,101,17498,182
2020-12-23,Stanislaus,099,539301,33745,31492,2919,34411,499
2020-12-23,Sutter,101,95872,6265,5871,41,5912,46
2020-12-23,Tehama,103,63373,2941,2737,250,2987,9
2020-12-23,Trinity,105,12862,407,234,53,287,2
2020-12-23,Tulare,107,460477,32829,30315,3386,33701,385
2020-12-23,Tuolumne,109,53932,2711,2540,13,2553,12
2020-12-23,Ventura,111,848112,37749,33377,1476,34853,216
2020-12-23,Yolo,113,214977,8267,7508,54,7562,112
2020-12-23,Yuba,115,75493,3685,3438,36,3474,14
2020-12-22,Alameda,001,1643700,49538,45751,804,46555,534
2020-12-22,Alpine,003,1148,66,64,0,64,0
2020-12-22,Amador,005,37829,2301,1839,17,1856,23
2020-12-22,Butte,007,227075,7222,6467,754,7221,85
2020-12-22,Calaveras,009,45235,1062,988,0,988,21
2020-12-22,Colusa,011,21464,1238,1150,64,1214,7
2020-12-22,Contra Costa,013,1133247,38361,35681,460,36141,301
2020-12-22,Del Norte,015,27424,727,666,2,668,2
2020-12-22,El Dorado,017,186661,5787,4885,247,5132,12
2020-12-22,Fresno,019,978130,65137,59640,4032,63672,640
2020-12-22,Glenn,021,27897,1477,1337,211,1548,9
2020-12-22,Humboldt,023,135768,1607,1440,7,1447,16
2020-12-22,Imperial,025,180216,22318,21128,1047,22175,398
2020-12-22,Inyo,027,18085,619,506,7,513,17
2020-12-22,Kern,029,883053,62980,57816,4267,62083,547
2020-12-22,Kings,031,150075,15893,14855,468,15323,102
2020-12-22,Lake,033,64148,1795,1569,0,1569,20
2020-12-22,Lassen,035,31185,4170,3848,39,3887,1
2020-12-22,Los Angeles,037,10098052,713968,635931,17877,653808,9013
2020-12-22,Madera,039,155013,10165,9187,363,9550,63
2020-12-22,Marin,041,260295,9548,9115,63,9178,142
2020-12-22,Mariposa,043,17540,215,194,2,196,3
2020-12-22,Mendocino,045,87422,2297,2092,19,2111,23
2020-12-22,Merced,047,269075,18072,17012,290,17302,201
2020-12-22,Modoc,049,8938,233,182,68,250,0
2020-12-22,Mono,051,14174,859,786,11,797,3
2020-12-22,Monterey,053,433212,26041,24152,619,24771,176
2020-12-22,Napa,055,140530,5556,5059,25,5084,23
2020-12-22,Nevada,057,99092,2588,2367,84,2451,14
2020-12-22,Orange,059,3164182,149773,134850,5477,140327,1774
2020-12-22,Placer,061,380077,13569,11943,475,12418,105
2020-12-22,Plumas,063,18699,444,360,8,368,0
2020-12-22,Riverside,065,2383286,172337,155059,7180,162239,1777
2020-12-22,Sacramento,067,1510023,62282,57966,520,58486,772
2020-12-22,San Benito,069,59416,3347,2998,25,3023,24
2020-12-22,San Bernardino,071,2135413,187383,169266,4932,174198,1500
2020-12-22,San Diego,073,3302833,147929,132097,6548,138645,1311
2020-12-22,San Francisco,075,870044,22486,21232,190,21422,174
2020-12-22,San Joaquin,077,732212,43503,39423,1338,40761,592
2020-12-22,San Luis Obispo,079,281455,10255,9174,221,9395,69
2020-12-22,San Mateo,081,765935,23952,21382,79,21461,186
2020-12-22,Santa Barbara,083,443738,16500,15189,416,15605,150
2020-12-22,Santa Clara,085,1922200,66070,59192,258,59450,569
2020-12-22,Santa Cruz,087,273765,8636,7471,250,7721,72
2020-12-22,Shasta,089,179085,7839,7371,615,7986,64
2020-12-22,Sierra,091,2930,27,23,0,23,0
2020-12-22,Siskiyou,093,43540,972,880,84,964,2
2020-12-22,Solano,095,438530,17946,16229,176,16405,95
2020-12-22,Sonoma,097,501317,18290,17216,101,17317,180
2020-12-22,Stanislaus,099,539301,33361,30914,2847,33761,499
2020-12-22,Sutter,101,95872,6206,5791,40,5831,46
2020-12-22,Tehama,103,63373,2891,2688,244,2932,9
2020-12-22,Trinity,105,12862,406,231,53,284,2
2020-12-22,Tulare,107,460477,32361,30025,3321,33346,377
2020-12-22,Tuolumne,109,53932,2660,2526,13,2539,12
2020-12-22,Ventura,111,848112,36984,32488,1433,33921,213
2020-12-22,Yolo,113,214977,8153,7388,53,7441,113
2020-12-22,Yuba,115,75493,3634,3379,36,3415,14
2020-12-21,Alameda,001,1643700,48642,44756,778,45534,518
2020-12-21,Alpine,003,1148,65,64,0,64,0
2020-12-21,Amador,005,37829,2224,1815,17,1832,23
2020-12-21,Butte,007,227075,7067,6335,731,7066,81
2020-12-21,Calaveras,009,45235,1032,963,0,963,21
2020-12-21,Colusa,011,21464,1211,1135,59,1194,7
2020-12-21,Contra Costa,013,1133247,37606,35207,423,35630,300
2020-12-21,Del Norte,015,27424,712,660,2,662,2
2020-12-21,El Dorado,017,186661,5641,4805,235,5040,10
2020-12-21,Fresno,019,978130,63987,58568,3890,62458,634
2020-12-21,Glenn,021,27897,1445,1323,203,1526,9
2020-12-21,Humboldt,023,135768,1584,1419,7,1426,16
2020-12-21,Imperial,025,180216,22049,20994,1005,21999,395
2020-12-21,Inyo,027,18085,598,482,7,489,17
2020-12-21,Kern,029,883053,62090,56836,4134,60970,541
2020-12-21,Kings,031,150075,15643,14760,453,15213,100
2020-12-21,Lake,033,64148,1741,1538,0,1538,20
2020-12-21,Lassen,035,31185,4010,3798,37,3835,1
2020-12-21,Los Angeles,037,10098052,694868,624129,17210,641339,8918
2020-12-21,Madera,039,155013,9971,9069,343,9412,63
2020-12-21,Marin,041,260295,9479,9035,63,9098,142
2020-12-21,Mariposa,043,17540,210,186,2,188,3
2020-12-21,Mendocino,045,87422,2266,2066,19,2085,23
2020-12-21,Merced,047,269075,17822,16710,275,16985,198
2020-12-21,Modoc,049,8938,219,181,67,248,0
2020-12-21,Mono,051,14174,847,781,11,792,3
2020-12-21,Monterey,053,433212,25510,23673,605,24278,174
2020-12-21,Napa,055,140530,5469,4952,25,4977,23
2020-12-21,Nevada,057,99092,2555,2337,84,2421,13
2020-12-21,Orange,059,3164182,146363,130444,5326,135770,1772
2020-12-21,Placer,061,380077,13337,11715,456,12171,105
2020-12-21,Plumas,063,18699,440,353,8,361,0
2020-12-21,Riverside,065,2383286,168110,151713,6861,158574,1743
2020-12-21,Sacramento,067,1510023,61262,57064,503,57567,759
2020-12-21,San Benito,069,59416,3279,2921,25,2946,22
2020-12-21,San Bernardino,071,2135413,182584,165086,4766,169852,1476
2020-12-21,San Diego,073,3302833,144478,129716,6384,136100,1284
2020-12-21,San Francisco,075,870044,22200,21086,188,21274,174
2020-12-21,San Joaquin,077,732212,42709,38811,1289,40100,586
2020-12-21,San Luis Obispo,079,281455,10066,9006,216,9222,64
2020-12-21,San Mateo,081,765935,23548,21035,76,21111,185
2020-12-21,Santa Barbara,083,443738,16225,14988,411,15399,149
2020-12-21,Santa Clara,085,1922200,64876,57699,246,57945,570
2020-12-21,Santa Cruz,087,273765,8425,7315,237,7552,69
2020-12-21,Shasta,089,179085,7774,7299,605,7904,64
2020-12-21,Sierra,091,2930,24,23,0,23,0
2020-12-21,Siskiyou,093,43540,965,878,83,961,2
2020-12-21,Solano,095,438530,17476,15878,171,16049,95
2020-12-21,Sonoma,097,501317,18017,17075,98,17173,176
2020-12-21,Stanislaus,099,539301,32903,30437,2773,33210,499
2020-12-21,Sutter,101,95872,6111,5708,40,5748,46
2020-12-21,Tehama,103,63373,2826,2656,235,2891,9
2020-12-21,Trinity,105,12862,404,226,51,277,2
2020-12-21,Tulare,107,460477,31867,29482,3233,32715,373
2020-12-21,Tuolumne,109,53932,2635,2423,11,2434,12
2020-12-21,Ventura,111,848112,35904,31759,1396,33155,212
2020-12-21,Yolo,113,214977,8008,7266,49,7315,109
2020-12-21,Yuba,115,75493,3575,3329,36,3365,14
2020-12-20,Alameda,001,1643700,47763,44004,757,44761,516
2020-12-20,Alpine,003,1148,65,64,0,64,0
2020-12-20,Amador,005,37829,2166,1771,17,1788,23
2020-12-20,Butte,007,227075,6920,6228,695,6923,81
2020-12-20,Calaveras,009,45235,1008,926,0,926,21
2020-12-20,Colusa,011,21464,1183,1121,53,1174,7
2020-12-20,Contra Costa,013,1133247,37018,34798,407,35205,301
2020-12-20,Del Norte,015,27424,690,652,2,654,2
2020-12-20,El Dorado,017,186661,5517,4697,226,4923,10
2020-12-20,Fresno,019,978130,62997,57616,3755,61371,634
2020-12-20,Glenn,021,27897,1436,1295,196,1491,9
2020-12-20,Humboldt,023,135768,1547,1386,6,1392,15
2020-12-20,Imperial,025,180216,21809,20882,903,21785,395
2020-12-20,Inyo,027,18085,583,476,7,483,17
2020-12-20,Kern,029,883053,60992,55983,3980,59963,540
2020-12-20,Kings,031,150075,15423,14629,437,15066,100
2020-12-20,Lake,033,64148,1695,1463,0,1463,20
2020-12-20,Lassen,035,31185,3956,3669,35,3704,1
2020-12-20,Los Angeles,037,10098052,676768,612975,16488,629463,8862
2020-12-20,Madera,039,155013,9761,8871,334,9205,63
2020-12-20,Marin,041,260295,9381,8948,60,9008,142
2020-12-20,Mariposa,043,17540,209,179,2,181,3
2020-12-20,Mendocino,045,87422,2241,2033,19,2052,23
2020-12-20,Merced,047,269075,17506,16435,268,16703,198
2020-12-20,Modoc,049,8938,219,181,65,246,0
2020-12-20,Mono,051,14174,829,774,11,785,3
2020-12-20,Monterey,053,433212,25027,23250,567,23817,173
2020-12-20,Napa,055,140530,5348,4865,23,4888,23
2020-12-20,Nevada,057,99092,2509,2289,78,2367,13
2020-12-20,Orange,059,3164182,142863,128780,5178,133958,1763
2020-12-20,Placer,061,380077,13112,11496,438,11934,105
2020-12-20,Plumas,063,18699,432,347,8,355,0
2020-12-20,Riverside,065,2383286,163904,148714,6574,155288,1742
2020-12-20,Sacramento,067,1510023,60262,56017,483,56500,755
2020-12-20,San Benito,069,59416,3207,2885,24,2909,21
2020-12-20,San Bernardino,071,2135413,177591,162810,4610,167420,1458
2020-12-20,San Diego,073,3302833,140760,126465,6214,132679,1280
2020-12-20,San Francisco,075,870044,21884,20937,185,21122,174
2020-12-20,San Joaquin,077,732212,41865,38268,1229,39497,587
2020-12-20,San Luis Obispo,079,281455,9774,8881,210,9091,63
2020-12-20,San Mateo,081,765935,23114,20764,72,20836,185
2020-12-20,Santa Barbara,083,443738,15903,14817,393,15210,148
2020-12-20,Santa Clara,085,1922200,63467,56860,240,57100,566
2020-12-20,Santa Cruz,087,273765,8217,7178,224,7402,69
2020-12-20,Shasta,089,179085,7660,7256,591,7847,64
2020-12-20,Sierra,091,2930,24,22,0,22,0
2020-12-20,Siskiyou,093,43540,956,870,82,952,2
2020-12-20,Solano,095,438530,17098,15533,160,15693,95
2020-12-20,Sonoma,097,501317,17741,16802,97,16899,175
2020-12-20,Stanislaus,099,539301,32377,29995,2672,32667,498
2020-12-20,Sutter,101,95872,6024,5601,40,5641,43
2020-12-20,Tehama,103,63373,2778,2602,216,2818,9
2020-12-20,Trinity,105,12862,396,221,50,271,2
2020-12-20,Tulare,107,460477,31349,29078,3138,32216,373
2020-12-20,Tuolumne,109,53932,2527,2152,10,2162,12
2020-12-20,Ventura,111,848112,35202,31335,1364,32699,210
2020-12-20,Yolo,113,214977,7855,7121,46,7167,109
2020-12-20,Yuba,115,75493,3528,3254,34,3288,12
2020-12-19,Alameda,001,1643700,47316,43109,750,43859,516
2020-12-19,Alpine,003,1148,65,64,0,64,0
2020-12-19,Amador,005,37829,2142,1754,17,1771,23
2020-12-19,Butte,007,227075,6820,6118,672,6790,81
2020-12-19,Calaveras,009,45235,991,900,0,900,21
2020-12-19,Colusa,011,21464,1175,1096,50,1146,7
2020-12-19,Contra Costa,013,1133247,36701,34321,393,34714,301
2020-12-19,Del Norte,015,27424,688,641,1,642,2
2020-12-19,El Dorado,017,186661,5450,4588,218,4806,10
2020-12-19,Fresno,019,978130,62672,55428,3689,59117,634
2020-12-19,Glenn,021,27897,1401,1286,195,1481,9
2020-12-19,Humboldt,023,135768,1530,1357,6,1363,15
2020-12-19,Imperial,025,180216,21716,20711,857,21568,395
2020-12-19,Inyo,027,18085,576,475,7,482,17
2020-12-19,Kern,029,883053,60507,55118,3874,58992,540
2020-12-19,Kings,031,150075,15344,14474,435,14909,100
2020-12-19,Lake,033,64148,1660,1438,0,1438,20
2020-12-19,Lassen,035,31185,3928,3595,35,3630,1
2020-12-19,Los Angeles,037,10098052,669650,599888,15963,615851,8804
2020-12-19,Madera,039,155013,9669,8717,323,9040,63
2020-12-19,Marin,041,260295,9341,8864,60,8924,142
2020-12-19,Mariposa,043,17540,207,177,2,179,3
2020-12-19,Mendocino,045,87422,2216,2008,19,2027,23
2020-12-19,Merced,047,269075,17367,16230,260,16490,198
2020-12-19,Modoc,049,8938,216,181,65,246,0
2020-12-19,Mono,051,14174,822,766,11,777,3
2020-12-19,Monterey,053,433212,24913,22799,562,23361,172
2020-12-19,Napa,055,140530,5286,4772,23,4795,23
2020-12-19,Nevada,057,99092,2487,2260,78,2338,13
2020-12-19,Orange,059,3164182,140941,125574,5030,130604,1733
2020-12-19,Placer,061,380077,12957,11246,432,11678,105
2020-12-19,Plumas,063,18699,429,343,8,351,0
2020-12-19,Riverside,065,2383286,161917,146703,6343,153046,1737
2020-12-19,Sacramento,067,1510023,59730,55169,469,55638,746
2020-12-19,San Benito,069,59416,3161,2820,23,2843,21
2020-12-19,San Bernardino,071,2135413,176017,159883,4502,164385,1433
2020-12-19,San Diego,073,3302833,138993,122972,6075,129047,1280
2020-12-19,San Francisco,075,870044,21734,20643,185,20828,174
2020-12-19,San Joaquin,077,732212,41463,37340,1181,38521,586
2020-12-19,San Luis Obispo,079,281455,9703,8788,207,8995,63
2020-12-19,San Mateo,081,765935,22905,20393,65,20458,182
2020-12-19,Santa Barbara,083,443738,15747,14667,387,15054,148
2020-12-19,Santa Clara,085,1922200,62650,55540,236,55776,558
2020-12-19,Santa Cruz,087,273765,8112,7054,220,7274,68
2020-12-19,Shasta,089,179085,7608,7221,579,7800,63
2020-12-19,Sierra,091,2930,24,23,0,23,0
2020-12-19,Siskiyou,093,43540,952,853,81,934,2
2020-12-19,Solano,095,438530,16932,15204,156,15360,95
2020-12-19,Sonoma,097,501317,17632,16553,97,16650,175
2020-12-19,Stanislaus,099,539301,32057,29555,2600,32155,498
2020-12-19,Sutter,101,95872,5968,5506,40,5546,41
2020-12-19,Tehama,103,63373,2729,2574,214,2788,9
2020-12-19,Trinity,105,12862,395,219,50,269,2
2020-12-19,Tulare,107,460477,31126,28734,3072,31806,375
2020-12-19,Tuolumne,109,53932,2514,2107,10,2117,12
2020-12-19,Ventura,111,848112,34921,30843,1334,32177,209
2020-12-19,Yolo,113,214977,7786,7025,45,7070,109
2020-12-19,Yuba,115,75493,3497,3168,34,3202,11
2020-12-18,Alameda,001,1643700,46779,42196,734,42930,515
2020-12-18,Alpine,003,1148,65,64,0,64,0
2020-12-18,Amador,005,37829,2125,1727,15,1742,20
2020-12-18,Butte,007,227075,6735,5891,646,6537,81
2020-12-18,Calaveras,009,45235,981,870,0,870,21
2020-12-18,Colusa,011,21464,1166,1068,50,1118,7
2020-12-18,Contra Costa,013,1133247,36416,33610,382,33992,300
2020-12-18,Del Norte,015,27424,683,627,0,627,2
2020-12-18,El Dorado,017,186661,5388,4494,209,4703,10
2020-12-18,Fresno,019,978130,61845,52643,3628,56271,613
2020-12-18,Glenn,021,27897,1384,1264,190,1454,9
2020-12-18,Humboldt,023,135768,1515,1331,6,1337,15
2020-12-18,Imperial,025,180216,21637,20430,811,21241,393
2020-12-18,Inyo,027,18085,556,454,7,461,17
2020-12-18,Kern,029,883053,59847,54220,3789,58009,533
2020-12-18,Kings,031,150075,15218,14284,429,14713,98
2020-12-18,Lake,033,64148,1648,1397,0,1397,20
2020-12-18,Lassen,035,31185,3920,3486,35,3521,1
2020-12-18,Los Angeles,037,10098052,657501,586413,15475,601888,8744
2020-12-18,Madera,039,155013,9567,8609,318,8927,63
2020-12-18,Marin,041,260295,9257,8799,60,8859,142
2020-12-18,Mariposa,043,17540,204,176,2,178,3
2020-12-18,Mendocino,045,87422,2198,1977,19,1996,24
2020-12-18,Merced,047,269075,17286,15956,258,16214,195
2020-12-18,Modoc,049,8938,216,179,65,244,0
2020-12-18,Mono,051,14174,814,731,11,742,3
2020-12-18,Monterey,053,433212,24619,22336,557,22893,165
2020-12-18,Napa,055,140530,5237,4688,23,4711,23
2020-12-18,Nevada,057,99092,2470,2220,77,2297,13
2020-12-18,Orange,059,3164182,138503,121681,4882,126563,1725
2020-12-18,Placer,061,380077,12786,10995,424,11419,104
2020-12-18,Plumas,063,18699,423,336,8,344,0
2020-12-18,Riverside,065,2383286,159078,142375,6081,148456,1733
2020-12-18,Sacramento,067,1510023,59104,53980,453,54433,736
2020-12-18,San Benito,069,59416,3112,2744,23,2767,21
2020-12-18,San Bernardino,071,2135413,173717,154272,4368,158640,1430
2020-12-18,San Diego,073,3302833,136815,120463,5936,126399,1253
2020-12-18,San Francisco,075,870044,21568,20315,179,20494,173
2020-12-18,San Joaquin,077,732212,41105,36484,1152,37636,559
2020-12-18,San Luis Obispo,079,281455,9605,8598,202,8800,62
2020-12-18,San Mateo,081,765935,22592,19971,61,20032,182
2020-12-18,Santa Barbara,083,443738,15606,14361,374,14735,148
2020-12-18,Santa Clara,085,1922200,61777,53992,227,54219,539
2020-12-18,Santa Cruz,087,273765,7996,6838,212,7050,68
2020-12-18,Shasta,089,179085,7570,7114,568,7682,62
2020-12-18,Sierra,091,2930,24,23,0,23,0
2020-12-18,Siskiyou,093,43540,950,840,81,921,2
2020-12-18,Solano,095,438530,16779,14667,152,14819,95
2020-12-18,Sonoma,097,501317,17513,16261,97,16358,173
2020-12-18,Stanislaus,099,539301,31784,28967,2564,31531,490
2020-12-18,Sutter,101,95872,5884,5399,40,5439,39
2020-12-18,Tehama,103,63373,2714,2523,204,2727,9
2020-12-18,Trinity,105,12862,394,215,50,265,2
2020-12-18,Tulare,107,460477,30850,28322,2995,31317,370
2020-12-18,Tuolumne,109,53932,2503,2067,10,2077,12
2020-12-18,Ventura,111,848112,34417,29907,1291,31198,209
2020-12-18,Yolo,113,214977,7718,6901,44,6945,109
2020-12-18,Yuba,115,75493,3439,3097,34,3131,11
2020-12-17,Alameda,001,1643700,45970,41548,709,42257,508
2020-12-17,Alpine,003,1148,65,64,0,64,0
2020-12-17,Amador,005,37829,2077,1703,13,1716,19
2020-12-17,Butte,007,227075,6609,5746,628,6374,78
2020-12-17,Calaveras,009,45235,958,848,0,848,21
2020-12-17,Colusa,011,21464,1155,1053,48,1101,7
2020-12-17,Contra Costa,013,1133247,35891,33006,352,33358,293
2020-12-17,Del Norte,015,27424,678,583,0,583,1
2020-12-17,El Dorado,017,186661,5242,4327,196,4523,9
2020-12-17,Fresno,019,978130,60984,49918,3502,53420,597
2020-12-17,Glenn,021,27897,1360,1244,183,1427,9
2020-12-17,Humboldt,023,135768,1482,1322,6,1328,14
2020-12-17,Imperial,025,180216,21476,20208,745,20953,391
2020-12-17,Inyo,027,18085,538,450,6,456,16
2020-12-17,Kern,029,883053,58890,53683,3654,57337,526
2020-12-17,Kings,031,150075,15115,14057,414,14471,98
2020-12-17,Lake,033,64148,1623,1374,0,1374,20
2020-12-17,Lassen,035,31185,3884,3417,35,3452,1
2020-12-17,Los Angeles,037,10098052,641834,571093,14933,586026,8657
2020-12-17,Madera,039,155013,9454,8465,314,8779,62
2020-12-17,Marin,041,260295,9195,8721,58,8779,142
2020-12-17,Mariposa,043,17540,200,172,2,174,3
2020-12-17,Mendocino,045,87422,2164,1942,19,1961,23
2020-12-17,Merced,047,269075,17024,15648,250,15898,192
2020-12-17,Modoc,049,8938,213,179,65,244,0
2020-12-17,Mono,051,14174,800,718,11,729,3
2020-12-17,Monterey,053,433212,24101,21951,542,22493,163
2020-12-17,Napa,055,140530,5125,4612,23,4635,23
2020-12-17,Nevada,057,99092,2429,2173,74,2247,13
2020-12-17,Orange,059,3164182,135133,118367,4750,123117,1725
2020-12-17,Placer,061,380077,12512,10756,410,11166,99
2020-12-17,Plumas,063,18699,414,324,8,332,0
2020-12-17,Riverside,065,2383286,155200,139325,5867,145192,1696
2020-12-17,Sacramento,067,1510023,58198,53189,431,53620,721
2020-12-17,San Benito,069,59416,3043,2645,22,2667,20
2020-12-17,San Bernardino,071,2135413,169777,149838,4253,154091,1425
2020-12-17,San Diego,073,3302833,134014,116852,5780,122632,1239
2020-12-17,San Francisco,075,870044,21281,19939,174,20113,170
2020-12-17,San Joaquin,077,732212,40378,35894,1118,37012,554
2020-12-17,San Luis Obispo,079,281455,9486,8365,201,8566,59
2020-12-17,San Mateo,081,765935,22222,19647,61,19708,181
2020-12-17,Santa Barbara,083,443738,15373,14207,367,14574,147
2020-12-17,Santa Clara,085,1922200,60613,52559,221,52780,527
2020-12-17,Santa Cruz,087,273765,7842,6687,199,6886,64
2020-12-17,Shasta,089,179085,7493,7000,549,7549,62
2020-12-17,Sierra,091,2930,23,23,0,23,0
2020-12-17,Siskiyou,093,43540,942,827,80,907,2
2020-12-17,Solano,095,438530,16473,14361,150,14511,96
2020-12-17,Sonoma,097,501317,17241,15993,96,16089,171
2020-12-17,Stanislaus,099,539301,31362,28582,2505,31087,489
2020-12-17,Sutter,101,95872,5786,5309,38,5347,39
2020-12-17,Tehama,103,63373,2665,2480,198,2678,9
2020-12-17,Trinity,105,12862,389,213,50,263,2
2020-12-17,Tulare,107,460477,30466,27852,2917,30769,358
2020-12-17,Tuolumne,109,53932,2212,1992,10,2002,11
2020-12-17,Ventura,111,848112,33807,29404,1255,30659,208
2020-12-17,Yolo,113,214977,7595,6800,43,6843,105
2020-12-17,Yuba,115,75493,3380,3035,32,3067,12
2020-12-16,Alameda,001,1643700,45116,40751,684,41435,497
2020-12-16,Alpine,003,1148,65,64,0,64,0
2020-12-16,Amador,005,37829,2030,1693,12,1705,19
2020-12-16,Butte,007,227075,6420,5659,600,6259,76
2020-12-16,Calaveras,009,45235,923,821,0,821,21
2020-12-16,Colusa,011,21464,1142,1038,45,1083,7
2020-12-16,Contra Costa,013,1133247,35336,32429,333,32762,293
2020-12-16,Del Norte,015,27424,676,575,0,575,1
2020-12-16,El Dorado,017,186661,5121,4237,187,4424,9
2020-12-16,Fresno,019,978130,60027,49173,3406,52579,584
2020-12-16,Glenn,021,27897,1342,1236,172,1408,9
2020-12-16,Humboldt,023,135768,1450,1308,5,1313,12
2020-12-16,Imperial,025,180216,21297,19980,681,20661,388
2020-12-16,Inyo,027,18085,525,444,6,450,16
2020-12-16,Kern,029,883053,58013,52896,3524,56420,522
2020-12-16,Kings,031,150075,14935,13734,398,14132,99
2020-12-16,Lake,033,64148,1583,1363,0,1363,20
2020-12-16,Lassen,035,31185,3851,3396,34,3430,1
2020-12-16,Los Angeles,037,10098052,625292,557907,14263,572170,8561
2020-12-16,Madera,039,155013,9329,8278,306,8584,62
2020-12-16,Marin,041,260295,9124,8641,58,8699,142
2020-12-16,Mariposa,043,17540,197,175,2,177,3
2020-12-16,Mendocino,045,87422,2129,1929,19,1948,23
2020-12-16,Merced,047,269075,16739,15443,247,15690,190
2020-12-16,Modoc,049,8938,210,178,65,243,0
2020-12-16,Mono,051,14174,781,702,11,713,3
2020-12-16,Monterey,053,433212,23542,21107,531,21638,163
2020-12-16,Napa,055,140530,5028,4544,23,4567,23
2020-12-16,Nevada,057,99092,2393,2149,72,2221,13
2020-12-16,Orange,059,3164182,131659,115260,4585,119845,1712
2020-12-16,Placer,061,380077,12275,10554,389,10943,96
2020-12-16,Plumas,063,18699,405,319,8,327,0
2020-12-16,Riverside,065,2383286,151082,135751,5622,141373,1664
2020-12-16,Sacramento,067,1510023,57226,52166,406,52572,715
2020-12-16,San Benito,069,59416,2953,2582,22,2604,20
2020-12-16,San Bernardino,071,2135413,165170,143565,4119,147684,1403
2020-12-16,San Diego,073,3302833,130910,114248,5626,119874,1217
2020-12-16,San Francisco,075,870044,21024,19624,174,19798,170
2020-12-16,San Joaquin,077,732212,39559,35010,1078,36088,547
2020-12-16,San Luis Obispo,079,281455,9291,8252,192,8444,58
2020-12-16,San Mateo,081,765935,21897,19292,57,19349,179
2020-12-16,Santa Barbara,083,443738,15123,13966,355,14321,144
2020-12-16,Santa Clara,085,1922200,59374,51502,218,51720,523
2020-12-16,Santa Cruz,087,273765,7659,6536,188,6724,63
2020-12-16,Shasta,089,179085,7420,6914,526,7440,62
2020-12-16,Sierra,091,2930,23,23,0,23,0
2020-12-16,Siskiyou,093,43540,934,818,80,898,2
2020-12-16,Solano,095,438530,16006,14157,146,14303,96
2020-12-16,Sonoma,097,501317,16985,15768,96,15864,170
2020-12-16,Stanislaus,099,539301,30868,28279,2434,30713,489
2020-12-16,Sutter,101,95872,5707,5223,38,5261,39
2020-12-16,Tehama,103,63373,2631,2441,174,2615,9
2020-12-16,Trinity,105,12862,383,212,50,262,2
2020-12-16,Tulare,107,460477,30047,27500,2824,30324,352
2020-12-16,Tuolumne,109,53932,2169,1941,10,1951,11
2020-12-16,Ventura,111,848112,33034,28566,1213,29779,203
2020-12-16,Yolo,113,214977,7471,6649,42,6691,103
2020-12-16,Yuba,115,75493,3294,2980,31,3011,11
2020-12-15,Alameda,001,1643700,44261,40026,663,40689,492
2020-12-15,Alpine,003,1148,65,64,0,64,0
2020-12-15,Amador,005,37829,1917,1669,10,1679,19
2020-12-15,Butte,007,227075,6281,5565,572,6137,75
2020-12-15,Calaveras,009,45235,891,799,0,799,21
2020-12-15,Colusa,011,21464,1129,1026,44,1070,7
2020-12-15,Contra Costa,013,1133247,34682,31423,319,31742,281
2020-12-15,Del Norte,015,27424,669,564,0,564,1
2020-12-15,El Dorado,017,186661,5013,4113,173,4286,9
2020-12-15,Fresno,019,978130,58655,47316,3272,50588,574
2020-12-15,Glenn,021,27897,1329,1207,156,1363,9
2020-12-15,Humboldt,023,135768,1430,1276,5,1281,12
2020-12-15,Imperial,025,180216,21077,19756,603,20359,380
2020-12-15,Inyo,027,18085,514,394,6,400,16
2020-12-15,Kern,029,883053,57001,52002,3418,55420,511
2020-12-15,Kings,031,150075,14771,13652,379,14031,97
2020-12-15,Lake,033,64148,1559,1341,0,1341,21
2020-12-15,Lassen,035,31185,3679,3378,33,3411,1
2020-12-15,Los Angeles,037,10098052,608896,536258,13630,549888,8429
2020-12-15,Madera,039,155013,9177,8118,299,8417,60
2020-12-15,Marin,041,260295,9019,8528,57,8585,141
2020-12-15,Mariposa,043,17540,193,171,2,173,3
2020-12-15,Mendocino,045,87422,2102,1883,19,1902,24
2020-12-15,Merced,047,269075,16443,15120,243,15363,190
2020-12-15,Modoc,049,8938,208,179,65,244,0
2020-12-15,Mono,051,14174,765,702,11,713,3
2020-12-15,Monterey,053,433212,22944,19905,470,20375,161
2020-12-15,Napa,055,140530,4925,4440,23,4463,23
2020-12-15,Nevada,057,99092,2360,2117,70,2187,11
2020-12-15,Orange,059,3164182,128016,112893,4436,117329,1689
2020-12-15,Placer,061,380077,12041,10301,367,10668,95
2020-12-15,Plumas,063,18699,400,313,8,321,0
2020-12-15,Riverside,065,2383286,147033,131822,5347,137169,1624
2020-12-15,Sacramento,067,1510023,56210,51076,393,51469,703
2020-12-15,San Benito,069,59416,2874,2520,21,2541,19
2020-12-15,San Bernardino,071,2135413,160713,137548,3969,141517,1351
2020-12-15,San Diego,073,3302833,127343,111441,5463,116904,1194
2020-12-15,San Francisco,075,870044,20715,19283,171,19454,171
2020-12-15,San Joaquin,077,732212,38633,33849,1044,34893,537
2020-12-15,San Luis Obispo,079,281455,9182,8074,189,8263,55
2020-12-15,San Mateo,081,765935,21488,18907,55,18962,178
2020-12-15,Santa Barbara,083,443738,14896,13782,347,14129,144
2020-12-15,Santa Clara,085,1922200,57953,50311,215,50526,505
2020-12-15,Santa Cruz,087,273765,7474,6361,175,6536,59
2020-12-15,Shasta,089,179085,7361,6794,501,7295,54
2020-12-15,Sierra,091,2930,23,23,0,23,0
2020-12-15,Siskiyou,093,43540,926,812,79,891,2
2020-12-15,Solano,095,438530,15658,13796,146,13942,95
2020-12-15,Sonoma,097,501317,16764,15406,96,15502,167
2020-12-15,Stanislaus,099,539301,30368,27823,2355,30178,485
2020-12-15,Sutter,101,95872,5609,5080,37,5117,36
2020-12-15,Tehama,103,63373,2593,2392,168,2560,9
2020-12-15,Trinity,105,12862,375,213,48,261,1
2020-12-15,Tulare,107,460477,29563,27026,2736,29762,342
2020-12-15,Tuolumne,109,53932,2139,1874,10,1884,8
2020-12-15,Ventura,111,848112,32412,27936,1166,29102,201
2020-12-15,Yolo,113,214977,7346,6531,40,6571,104
2020-12-15,Yuba,115,75493,3200,2891,30,2921,11
2020-12-14,Alameda,001,1643700,43361,39252,644,39896,487
2020-12-14,Alpine,003,1148,65,63,0,63,0
2020-12-14,Amador,005,37829,1845,1609,10,1619,19
2020-12-14,Butte,007,227075,6113,5202,555,5757,75
2020-12-14,Calaveras,009,45235,853,718,0,718,21
2020-12-14,Colusa,011,21464,1105,949,43,992,7
2020-12-14,Contra Costa,013,1133247,33995,30594,305,30899,281
2020-12-14,Del Norte,015,27424,663,560,0,560,1
2020-12-14,El Dorado,017,186661,4857,4018,157,4175,9
2020-12-14,Fresno,019,978130,57632,44726,3098,47824,560
2020-12-14,Glenn,021,27897,1303,1186,148,1334,9
2020-12-14,Humboldt,023,135768,1417,1256,5,1261,9
2020-12-14,Imperial,025,180216,20838,19608,529,20137,379
2020-12-14,Inyo,027,18085,501,382,6,388,16
2020-12-14,Kern,029,883053,55964,50538,3297,53835,510
2020-12-14,Kings,031,150075,14586,13491,352,13843,97
2020-12-14,Lake,033,64148,1512,1301,0,1301,21
2020-12-14,Lassen,035,31185,3581,2905,30,2935,1
2020-12-14,Los Angeles,037,10098052,591266,524668,13000,537668,8340
2020-12-14,Madera,039,155013,8912,8011,290,8301,60
2020-12-14,Marin,041,260295,8936,8475,56,8531,141
2020-12-14,Mariposa,043,17540,192,171,2,173,3
2020-12-14,Mendocino,045,87422,2081,1845,19,1864,24
2020-12-14,Merced,047,269075,16037,14572,229,14801,189
2020-12-14,Modoc,049,8938,202,180,63,243,0
2020-12-14,Mono,051,14174,757,685,11,696,3
2020-12-14,Monterey,053,433212,22422,19154,464,19618,155
2020-12-14,Napa,055,140530,4832,4289,23,4312,22
2020-12-14,Nevada,057,99092,2323,2070,67,2137,11
2020-12-14,Orange,059,3164182,124131,108602,4300,112902,1688
2020-12-14,Placer,061,380077,11760,9551,356,9907,95
2020-12-14,Plumas,063,18699,388,309,8,317,0
2020-12-14,Riverside,065,2383286,142911,123715,5085,128800,1588
2020-12-14,Sacramento,067,1510023,55103,50304,368,50672,691
2020-12-14,San Benito,069,59416,2808,2467,20,2487,19
2020-12-14,San Bernardino,071,2135413,156267,129151,3841,132992,1347
2020-12-14,San Diego,073,3302833,123607,109578,5278,114856,1162
2020-12-14,San Francisco,075,870044,20345,18904,169,19073,171
2020-12-14,San Joaquin,077,732212,37799,32522,998,33520,534
2020-12-14,San Luis Obispo,079,281455,8936,7791,185,7976,52
2020-12-14,San Mateo,081,765935,20991,18361,52,18413,178
2020-12-14,Santa Barbara,083,443738,14623,13587,339,13926,144
2020-12-14,Santa Clara,085,1922200,56458,49180,204,49384,502
2020-12-14,Santa Cruz,087,273765,7293,6049,160,6209,54
2020-12-14,Shasta,089,179085,7272,6665,483,7148,54
2020-12-14,Sierra,091,2930,23,21,0,21,0
2020-12-14,Siskiyou,093,43540,903,764,73,837,2
2020-12-14,Solano,095,438530,15303,13352,145,13497,93
2020-12-14,Sonoma,097,501317,16458,14807,95,14902,167
2020-12-14,Stanislaus,099,539301,29843,27311,2307,29618,485
2020-12-14,Sutter,101,95872,5505,5001,30,5031,35
2020-12-14,Tehama,103,63373,2551,2344,165,2509,9
2020-12-14,Trinity,105,12862,371,205,46,251,1
2020-12-14,Tulare,107,460477,29093,25735,2647,28382,341
2020-12-14,Tuolumne,109,53932,2086,1647,10,1657,8
2020-12-14,Ventura,111,848112,31489,27436,1108,28544,202
2020-12-14,Yolo,113,214977,7188,6389,39,6428,95
2020-12-14,Yuba,115,75493,3138,2851,30,2881,11
2020-12-13,Alameda,001,1643700,42160,38064,620,38684,486
2020-12-13,Alpine,003,1148,65,63,0,63,0
2020-12-13,Amador,005,37829,1789,1457,9,1466,19
2020-12-13,Butte,007,227075,5965,5103,517,5620,75
2020-12-13,Calaveras,009,45235,819,710,0,710,21
2020-12-13,Colusa,011,21464,1089,945,40,985,7
2020-12-13,Contra Costa,013,1133247,33272,29667,299,29966,281
2020-12-13,Del Norte,015,27424,611,542,0,542,1
2020-12-13,El Dorado,017,186661,4756,3770,148,3918,9
2020-12-13,Fresno,019,978130,56525,44114,2943,47057,559
2020-12-13,Glenn,021,27897,1290,1171,137,1308,9
2020-12-13,Humboldt,023,135768,1394,1238,4,1242,9
2020-12-13,Imperial,025,180216,20555,19472,409,19881,379
2020-12-13,Inyo,027,18085,480,380,6,386,16
2020-12-13,Kern,029,883053,54934,49051,3143,52194,510
2020-12-13,Kings,031,150075,14306,13357,334,13691,97
2020-12-13,Lake,033,64148,1473,1271,0,1271,21
2020-12-13,Lassen,035,31185,3474,2867,25,2892,1
2020-12-13,Los Angeles,037,10098052,573636,517472,12310,529782,8294
2020-12-13,Madera,039,155013,8729,7909,277,8186,60
2020-12-13,Marin,041,260295,8816,8409,56,8465,141
2020-12-13,Mariposa,043,17540,188,167,2,169,3
2020-12-13,Mendocino,045,87422,2047,1793,19,1812,24
2020-12-13,Merced,047,269075,15685,14384,226,14610,189
2020-12-13,Modoc,049,8938,192,179,57,236,0
2020-12-13,Mono,051,14174,741,675,11,686,3
2020-12-13,Monterey,053,433212,22001,18913,450,19363,153
2020-12-13,Napa,055,140530,4726,4194,23,4217,22
2020-12-13,Nevada,057,99092,2276,2030,65,2095,11
2020-12-13,Orange,059,3164182,120204,104768,4127,108895,1688
2020-12-13,Placer,061,380077,11446,9405,338,9743,95
2020-12-13,Plumas,063,18699,382,291,8,299,0
2020-12-13,Riverside,065,2383286,138786,119691,4825,124516,1581
2020-12-13,Sacramento,067,1510023,53834,49480,340,49820,682
2020-12-13,San Benito,069,59416,2739,2408,19,2427,19
2020-12-13,San Bernardino,071,2135413,151370,126718,3685,130403,1333
2020-12-13,San Diego,073,3302833,120007,107372,5109,112481,1162
2020-12-13,San Francisco,075,870044,20005,18686,160,18846,167
2020-12-13,San Joaquin,077,732212,36999,32170,958,33128,534
2020-12-13,San Luis Obispo,079,281455,8745,7625,177,7802,52
2020-12-13,San Mateo,081,765935,20500,18090,46,18136,177
2020-12-13,Santa Barbara,083,443738,14354,13249,325,13574,144
2020-12-13,Santa Clara,085,1922200,55046,47920,196,48116,499
2020-12-13,Santa Cruz,087,273765,7045,5986,150,6136,54
2020-12-13,Shasta,089,179085,7198,6647,457,7104,54
2020-12-13,Sierra,091,2930,23,21,0,21,0
2020-12-13,Siskiyou,093,43540,890,762,68,830,2
2020-12-13,Solano,095,438530,14869,13276,142,13418,93
2020-12-13,Sonoma,097,501317,16144,14495,94,14589,167
2020-12-13,Stanislaus,099,539301,29284,26569,2247,28816,485
2020-12-13,Sutter,101,95872,5378,4798,26,4824,34
2020-12-13,Tehama,103,63373,2506,2325,150,2475,9
2020-12-13,Trinity,105,12862,365,204,46,250,1
2020-12-13,Tulare,107,460477,28610,25496,2563,28059,340
2020-12-13,Tuolumne,109,53932,2024,1611,10,1621,8
2020-12-13,Ventura,111,848112,30489,26588,1048,27636,202
2020-12-13,Yolo,113,214977,7004,6265,33,6298,95
2020-12-13,Yuba,115,75493,3074,2754,27,2781,11
2020-12-12,Alameda,001,1643700,41718,37027,601,37628,486
2020-12-12,Alpine,003,1148,65,63,0,63,0
2020-12-12,Amador,005,37829,1761,1236,8,1244,19
2020-12-12,Butte,007,227075,5892,4972,504,5476,73
2020-12-12,Calaveras,009,45235,809,708,0,708,21
2020-12-12,Colusa,011,21464,1069,945,39,984,7
2020-12-12,Contra Costa,013,1133247,32925,29506,290,29796,281
2020-12-12,Del Norte,015,27424,602,529,0,529,1
2020-12-12,El Dorado,017,186661,4681,3706,132,3838,9
2020-12-12,Fresno,019,978130,56174,43756,2884,46640,559
2020-12-12,Glenn,021,27897,1282,1143,133,1276,8
2020-12-12,Humboldt,023,135768,1375,1208,4,1212,9
2020-12-12,Imperial,025,180216,20466,18947,355,19302,379
2020-12-12,Inyo,027,18085,475,380,6,386,16
2020-12-12,Kern,029,883053,54414,48194,3057,51251,507
2020-12-12,Kings,031,150075,14217,13205,330,13535,96
2020-12-12,Lake,033,64148,1457,1232,0,1232,21
2020-12-12,Lassen,035,31185,3451,2866,22,2888,1
2020-12-12,Los Angeles,037,10098052,566825,504317,11813,516130,8269
2020-12-12,Madera,039,155013,8602,7765,274,8039,59
2020-12-12,Marin,041,260295,8761,8363,55,8418,141
2020-12-12,Mariposa,043,17540,187,164,2,166,3
2020-12-12,Mendocino,045,87422,2011,1771,19,1790,24
2020-12-12,Merced,047,269075,15593,14181,222,14403,188
2020-12-12,Modoc,049,8938,191,169,54,223,0
2020-12-12,Mono,051,14174,734,640,11,651,3
2020-12-12,Monterey,053,433212,21888,18596,421,19017,151
2020-12-12,Napa,055,140530,4681,4113,23,4136,22
2020-12-12,Nevada,057,99092,2258,1981,63,2044,10
2020-12-12,Orange,059,3164182,118315,100468,3982,104450,1674
2020-12-12,Placer,061,380077,11281,9390,333,9723,95
2020-12-12,Plumas,063,18699,376,291,8,299,0
2020-12-12,Riverside,065,2383286,136727,118335,4624,122959,1579
2020-12-12,Sacramento,067,1510023,53253,48319,327,48646,673
2020-12-12,San Benito,069,59416,2684,2355,19,2374,19
2020-12-12,San Bernardino,071,2135413,149735,125741,3583,129324,1321
2020-12-12,San Diego,073,3302833,118386,104958,5012,109970,1151
2020-12-12,San Francisco,075,870044,19810,18413,156,18569,167
2020-12-12,San Joaquin,077,732212,36671,32200,928,33128,534
2020-12-12,San Luis Obispo,079,281455,8646,7462,171,7633,50
2020-12-12,San Mateo,081,765935,20279,17574,45,17619,177
2020-12-12,Santa Barbara,083,443738,14202,13174,317,13491,144
2020-12-12,Santa Clara,085,1922200,54105,45892,193,46085,498
2020-12-12,Santa Cruz,087,273765,6947,5905,141,6046,54
2020-12-12,Shasta,089,179085,7165,6551,439,6990,54
2020-12-12,Sierra,091,2930,23,21,0,21,0
2020-12-12,Siskiyou,093,43540,888,762,65,827,2
2020-12-12,Solano,095,438530,14672,12748,135,12883,93
2020-12-12,Sonoma,097,501317,16023,14466,94,14560,166
2020-12-12,Stanislaus,099,539301,28976,26246,2198,28444,483
2020-12-12,Sutter,101,95872,5316,4717,26,4743,32
2020-12-12,Tehama,103,63373,2488,2252,145,2397,9
2020-12-12,Trinity,105,12862,363,204,44,248,1
2020-12-12,Tulare,107,460477,28351,25333,2506,27839,341
2020-12-12,Tuolumne,109,53932,1980,1536,10,1546,8
2020-12-12,Ventura,111,848112,30045,25955,1015,26970,202
2020-12-12,Yolo,113,214977,6921,6116,31,6147,95
2020-12-12,Yuba,115,75493,3047,2692,26,2718,10
2020-12-11,Alameda,001,1643700,41151,36281,589,36870,482
2020-12-11,Alpine,003,1148,65,63,0,63,0
2020-12-11,Amador,005,37829,1745,1213,8,1221,19
2020-12-11,Butte,007,227075,5819,4941,486,5427,73
2020-12-11,Calaveras,009,45235,793,697,0,697,21
2020-12-11,Colusa,011,21464,1059,923,37,960,7
2020-12-11,Contra Costa,013,1133247,32495,29036,286,29322,282
2020-12-11,Del Norte,015,27424,594,505,0,505,1
2020-12-11,El Dorado,017,186661,4600,3669,117,3786,9
2020-12-11,Fresno,019,978130,55161,43071,2818,45889,550
2020-12-11,Glenn,021,27897,1266,1135,129,1264,8
2020-12-11,Humboldt,023,135768,1357,1190,4,1194,9
2020-12-11,Imperial,025,180216,20375,18599,311,18910,377
2020-12-11,Inyo,027,18085,464,372,6,378,16
2020-12-11,Kern,029,883053,53736,47664,2994,50658,502
2020-12-11,Kings,031,150075,14073,13118,326,13444,94
2020-12-11,Lake,033,64148,1440,1205,0,1205,21
2020-12-11,Lassen,035,31185,3439,2790,21,2811,1
2020-12-11,Los Angeles,037,10098052,555014,493592,11403,504995,8198
2020-12-11,Madera,039,155013,8511,7648,264,7912,59
2020-12-11,Marin,041,260295,8668,8317,54,8371,141
2020-12-11,Mariposa,043,17540,186,164,2,166,3
2020-12-11,Mendocino,045,87422,1987,1769,19,1788,24
2020-12-11,Merced,047,269075,15473,14038,214,14252,186
2020-12-11,Modoc,049,8938,191,168,53,221,0
2020-12-11,Mono,051,14174,724,631,11,642,3
2020-12-11,Monterey,053,433212,21587,18421,416,18837,150
2020-12-11,Napa,055,140530,4626,4054,23,4077,22
2020-12-11,Nevada,057,99092,2241,1959,60,2019,10
2020-12-11,Orange,059,3164182,115998,98357,3881,102238,1656
2020-12-11,Placer,061,380077,11119,8904,317,9221,93
2020-12-11,Plumas,063,18699,368,286,8,294,0
2020-12-11,Riverside,065,2383286,133650,115329,4406,119735,1573
2020-12-11,Sacramento,067,1510023,52591,47468,319,47787,669
2020-12-11,San Benito,069,59416,2633,2319,19,2338,19
2020-12-11,San Bernardino,071,2135413,147042,123092,3470,126562,1313
2020-12-11,San Diego,073,3302833,116426,102468,4929,107397,1137
2020-12-11,San Francisco,075,870044,19578,18246,155,18401,165
2020-12-11,San Joaquin,077,732212,36324,32044,901,32945,534
2020-12-11,San Luis Obispo,079,281455,8485,7415,169,7584,49
2020-12-11,San Mateo,081,765935,20009,17240,34,17274,177
2020-12-11,Santa Barbara,083,443738,14059,12997,309,13306,144
2020-12-11,Santa Clara,085,1922200,53092,45101,184,45285,494
2020-12-11,Santa Cruz,087,273765,6831,5764,132,5896,50
2020-12-11,Shasta,089,179085,7120,6459,432,6891,54
2020-12-11,Sierra,091,2930,23,19,0,19,0
2020-12-11,Siskiyou,093,43540,881,753,62,815,2
2020-12-11,Solano,095,438530,14484,12554,131,12685,92
2020-12-11,Sonoma,097,501317,15856,14298,92,14390,166
2020-12-11,Stanislaus,099,539301,28701,25928,2153,28081,464
2020-12-11,Sutter,101,95872,5253,4600,25,4625,30
2020-12-11,Tehama,103,63373,2458,2232,141,2373,9
2020-12-11,Trinity,105,12862,360,204,44,248,1
2020-12-11,Tulare,107,460477,27988,24953,2457,27410,338
2020-12-11,Tuolumne,109,53932,1965,1510,10,1520,8
2020-12-11,Ventura,111,848112,29438,24999,993,25992,202
2020-12-11,Yolo,113,214977,6817,6006,30,6036,95
2020-12-11,Yuba,115,75493,2987,2649,25,2674,10
2020-12-10,Alameda,001,1643700,40383,35686,569,36255,477
2020-12-10,Alpine,003,1148,65,63,0,63,0
2020-12-10,Amador,005,37829,1688,1191,8,1199,18
2020-12-10,Butte,007,227075,5704,4863,461,5324,72
2020-12-10,Calaveras,009,45235,775,684,0,684,21
2020-12-10,Colusa,011,21464,1036,909,34,943,7
2020-12-10,Contra Costa,013,1133247,31813,28413,280,28693,276
2020-12-10,Del Norte,015,27424,583,501,0,501,1
2020-12-10,El Dorado,017,186661,4482,3557,112,3669,9
2020-12-10,Fresno,019,978130,54183,42461,2678,45139,540
2020-12-10,Glenn,021,27897,1246,1126,120,1246,8
2020-12-10,Humboldt,023,135768,1337,1140,4,1144,9
2020-12-10,Imperial,025,180216,20162,18333,236,18569,370
2020-12-10,Inyo,027,18085,443,365,6,371,15
2020-12-10,Kern,029,883053,52754,47176,2831,50007,499
2020-12-10,Kings,031,150075,13915,12993,320,13313,92
2020-12-10,Lake,033,64148,1399,1167,0,1167,21
2020-12-10,Lassen,035,31185,3417,2764,17,2781,0
2020-12-10,Los Angeles,037,10098052,541032,480354,10878,491232,8149
2020-12-10,Madera,039,155013,8403,7445,249,7694,59
2020-12-10,Marin,041,260295,8615,8245,53,8298,140
2020-12-10,Mariposa,043,17540,185,160,2,162,3
2020-12-10,Mendocino,045,87422,1961,1748,16,1764,24
2020-12-10,Merced,047,269075,15227,13756,211,13967,186
2020-12-10,Modoc,049,8938,186,165,51,216,0
2020-12-10,Mono,051,14174,719,601,11,612,3
2020-12-10,Monterey,053,433212,21105,18266,406,18672,145
2020-12-10,Napa,055,140530,4540,3974,22,3996,22
2020-12-10,Nevada,057,99092,2205,1919,60,1979,10
2020-12-10,Orange,059,3164182,112898,95297,3721,99018,1651
2020-12-10,Placer,061,380077,10866,8906,300,9206,90
2020-12-10,Plumas,063,18699,357,281,8,289,0
2020-12-10,Riverside,065,2383286,129959,112794,4139,116933,1552
2020-12-10,Sacramento,067,1510023,51690,46471,298,46769,664
2020-12-10,San Benito,069,59416,2572,2268,18,2286,19
2020-12-10,San Bernardino,071,2135413,142803,120186,3297,123483,1306
2020-12-10,San Diego,073,3302833,113901,99601,4780,104381,1114
2020-12-10,San Francisco,075,870044,19266,17945,148,18093,164
2020-12-10,San Joaquin,077,732212,35688,31228,872,32100,534
2020-12-10,San Luis Obispo,079,281455,8322,7245,158,7403,49
2020-12-10,San Mateo,081,765935,19567,16701,24,16725,177
2020-12-10,Santa Barbara,083,443738,13880,12788,301,13089,143
2020-12-10,Santa Clara,085,1922200,51936,43939,170,44109,491
2020-12-10,Santa Cruz,087,273765,6663,5645,120,5765,48
2020-12-10,Shasta,089,179085,7053,6312,407,6719,53
2020-12-10,Sierra,091,2930,23,18,0,18,0
2020-12-10,Siskiyou,093,43540,871,712,61,773,2
2020-12-10,Solano,095,438530,14116,12017,125,12142,90
2020-12-10,Sonoma,097,501317,15601,14282,90,14372,167
2020-12-10,Stanislaus,099,539301,28233,25582,2083,27665,464
2020-12-10,Sutter,101,95872,5123,4528,23,4551,27
2020-12-10,Tehama,103,63373,2414,2190,133,2323,9
2020-12-10,Trinity,105,12862,356,202,42,244,1
2020-12-10,Tulare,107,460477,27523,24506,2394,26900,337
2020-12-10,Tuolumne,109,53932,1723,1451,10,1461,8
2020-12-10,Ventura,111,848112,28588,24075,949,25024,202
2020-12-10,Yolo,113,214977,6695,5896,29,5925,95
2020-12-10,Yuba,115,75493,2923,2604,24,2628,10
2020-12-09,Alameda,001,1643700,39542,35047,548,35595,470
2020-12-09,Alpine,003,1148,65,58,0,58,0
2020-12-09,Amador,005,37829,1645,1121,8,1129,19
2020-12-09,Butte,007,227075,5561,4733,441,5174,70
2020-12-09,Calaveras,009,45235,746,670,0,670,21
2020-12-09,Colusa,011,21464,1021,896,33,929,7
2020-12-09,Contra Costa,013,1133247,31108,28308,269,28577,273
2020-12-09,Del Norte,015,27424,570,481,0,481,2
2020-12-09,El Dorado,017,186661,4347,3449,104,3553,8
2020-12-09,Fresno,019,978130,53183,41954,2525,44479,533
2020-12-09,Glenn,021,27897,1232,1107,114,1221,8
2020-12-09,Humboldt,023,135768,1305,1086,4,1090,10
2020-12-09,Imperial,025,180216,19907,17757,200,17957,368
2020-12-09,Inyo,027,18085,430,356,6,362,15
2020-12-09,Kern,029,883053,51597,46379,2689,49068,494
2020-12-09,Kings,031,150075,13770,12716,312,13028,92
2020-12-09,Lake,033,64148,1370,1158,0,1158,20
2020-12-09,Lassen,035,31185,3348,2331,15,2346,0
2020-12-09,Los Angeles,037,10098052,527532,467971,10340,478311,8075
2020-12-09,Madera,039,155013,8288,7216,246,7462,59
2020-12-09,Marin,041,260295,8552,8182,52,8234,138
2020-12-09,Mariposa,043,17540,183,154,2,156,3
2020-12-09,Mendocino,045,87422,1935,1703,15,1718,24
2020-12-09,Merced,047,269075,14986,13588,205,13793,183
2020-12-09,Modoc,049,8938,181,146,42,188,0
2020-12-09,Mono,051,14174,707,601,11,612,3
2020-12-09,Monterey,053,433212,20704,17891,398,18289,143
2020-12-09,Napa,055,140530,4454,3858,21,3879,21
2020-12-09,Nevada,057,99092,2152,1864,60,1924,10
2020-12-09,Orange,059,3164182,109808,93763,3553,97316,1629
2020-12-09,Placer,061,380077,10605,8588,286,8874,85
2020-12-09,Plumas,063,18699,349,271,8,279,0
2020-12-09,Riverside,065,2383286,126260,110376,3938,114314,1543
2020-12-09,Sacramento,067,1510023,50627,45284,273,45557,659
2020-12-09,San Benito,069,59416,2500,2217,16,2233,19
2020-12-09,San Bernardino,071,2135413,138522,114516,3101,117617,1305
2020-12-09,San Diego,073,3302833,110921,97551,4641,102192,1103
2020-12-09,San Francisco,075,870044,18962,17628,147,17775,163
2020-12-09,San Joaquin,077,732212,34871,30539,847,31386,531
2020-12-09,San Luis Obispo,079,281455,8104,7105,150,7255,47
2020-12-09,San Mateo,081,765935,19118,16422,23,16445,175
2020-12-09,Santa Barbara,083,443738,13680,12630,291,12921,142
2020-12-09,Santa Clara,085,1922200,50750,42912,155,43067,489
2020-12-09,Santa Cruz,087,273765,6502,5527,105,5632,47
2020-12-09,Shasta,089,179085,6988,6105,393,6498,52
2020-12-09,Sierra,091,2930,23,18,0,18,0
2020-12-09,Siskiyou,093,43540,860,713,60,773,2
2020-12-09,Solano,095,438530,13766,11862,117,11979,90
2020-12-09,Sonoma,097,501317,15345,13994,87,14081,164
2020-12-09,Stanislaus,099,539301,27734,25157,2023,27180,463
2020-12-09,Sutter,101,95872,5005,4418,19,4437,24
2020-12-09,Tehama,103,63373,2378,2102,129,2231,9
2020-12-09,Trinity,105,12862,348,199,39,238,0
2020-12-09,Tulare,107,460477,26921,24124,2317,26441,334
2020-12-09,Tuolumne,109,53932,1690,1319,10,1329,8
2020-12-09,Ventura,111,848112,27724,23830,907,24737,201
2020-12-09,Yolo,113,214977,6569,5760,27,5787,95
2020-12-09,Yuba,115,75493,2854,2513,23,2536,10
2020-12-08,Alameda,001,1643700,38639,34373,532,34905,469
2020-12-08,Alpine,003,1148,64,53,0,53,0
2020-12-08,Amador,005,37829,1359,1043,8,1051,17
2020-12-08,Butte,007,227075,5403,4651,401,5052,70
2020-12-08,Calaveras,009,45235,722,657,0,657,21
2020-12-08,Colusa,011,21464,1005,875,32,907,6
2020-12-08,Contra Costa,013,1133247,30405,27926,252,28178,270
2020-12-08,Del Norte,015,27424,554,465,0,465,2
2020-12-08,El Dorado,017,186661,4223,3296,91,3387,8
2020-12-08,Fresno,019,978130,51919,41574,2371,43945,529
2020-12-08,Glenn,021,27897,1212,1094,106,1200,8
2020-12-08,Humboldt,023,135768,1279,1059,4,1063,10
2020-12-08,Imperial,025,180216,19390,17568,193,17761,363
2020-12-08,Inyo,027,18085,406,333,6,339,15
2020-12-08,Kern,029,883053,50303,45116,2537,47653,487
2020-12-08,Kings,031,150075,13616,12623,303,12926,90
2020-12-08,Lake,033,64148,1326,1127,0,1127,20
2020-12-08,Lassen,035,31185,3192,2165,15,2180,0
2020-12-08,Los Angeles,037,10098052,514828,459738,9867,469605,8004
2020-12-08,Madera,039,155013,8156,7082,233,7315,59
2020-12-08,Marin,041,260295,8472,8099,51,8150,137
2020-12-08,Mariposa,043,17540,179,150,2,152,2
2020-12-08,Mendocino,045,87422,1893,1666,15,1681,23
2020-12-08,Merced,047,269075,14674,13380,204,13584,181
2020-12-08,Modoc,049,8938,173,138,39,177,0
2020-12-08,Mono,051,14174,693,597,11,608,3
2020-12-08,Monterey,053,433212,20133,17752,391,18143,134
2020-12-08,Napa,055,140530,4367,3778,19,3797,22
2020-12-08,Nevada,057,99092,2098,1809,57,1866,11
2020-12-08,Orange,059,3164182,106586,91406,3389,94795,1629
2020-12-08,Placer,061,380077,10337,8224,281,8505,82
2020-12-08,Plumas,063,18699,339,258,8,266,0
2020-12-08,Riverside,065,2383286,122894,107620,3761,111381,1514
2020-12-08,Sacramento,067,1510023,49562,44635,258,44893,649
2020-12-08,San Benito,069,59416,2446,2180,16,2196,18
2020-12-08,San Bernardino,071,2135413,134178,110676,2979,113655,1301
2020-12-08,San Diego,073,3302833,107550,95447,4484,99931,1088
2020-12-08,San Francisco,075,870044,18653,17384,145,17529,162
2020-12-08,San Joaquin,077,732212,33978,30225,814,31039,530
2020-12-08,San Luis Obispo,079,281455,7975,6903,139,7042,45
2020-12-08,San Mateo,081,765935,18719,16305,23,16328,175
2020-12-08,Santa Barbara,083,443738,13496,12516,282,12798,141
2020-12-08,Santa Clara,085,1922200,49423,41309,147,41456,484
2020-12-08,Santa Cruz,087,273765,6321,5374,103,5477,45
2020-12-08,Shasta,089,179085,6878,5946,385,6331,50
2020-12-08,Sierra,091,2930,22,18,0,18,0
2020-12-08,Siskiyou,093,43540,846,704,58,762,2
2020-12-08,Solano,095,438530,13361,11669,115,11784,89
2020-12-08,Sonoma,097,501317,15086,13601,86,13687,164
2020-12-08,Stanislaus,099,539301,27243,24793,1958,26751,461
2020-12-08,Sutter,101,95872,4909,4342,18,4360,24
2020-12-08,Tehama,103,63373,2304,2057,121,2178,9
2020-12-08,Trinity,105,12862,339,198,38,236,0
2020-12-08,Tulare,107,460477,26314,23607,2254,25861,330
2020-12-08,Tuolumne,109,53932,1666,1264,10,1274,7
2020-12-08,Ventura,111,848112,27061,23665,865,24530,195
2020-12-08,Yolo,113,214977,6437,5560,27,5587,90
2020-12-08,Yuba,115,75493,2777,2477,23,2500,10
2020-12-07,Alameda,001,1643700,37772,33887,498,34385,466
2020-12-07,Alpine,003,1148,63,53,0,53,0
2020-12-07,Amador,005,37829,1284,993,7,1000,17
2020-12-07,Butte,007,227075,5267,4604,380,4984,67
2020-12-07,Calaveras,009,45235,692,606,0,606,21
2020-12-07,Colusa,011,21464,980,825,27,852,6
2020-12-07,Contra Costa,013,1133247,29790,27307,239,27546,270
2020-12-07,Del Norte,015,27424,542,424,0,424,2
2020-12-07,El Dorado,017,186661,4044,3275,84,3359,8
2020-12-07,Fresno,019,978130,50445,41098,2250,43348,526
2020-12-07,Glenn,021,27897,1193,1085,100,1185,8
2020-12-07,Humboldt,023,135768,1244,1023,4,1027,9
2020-12-07,Imperial,025,180216,18968,17234,183,17417,364
2020-12-07,Inyo,027,18085,390,333,6,339,15
2020-12-07,Kern,029,883053,49278,44409,2403,46812,486
2020-12-07,Kings,031,150075,13473,12412,295,12707,90
2020-12-07,Lake,033,64148,1299,1090,0,1090,20
2020-12-07,Lassen,035,31185,3095,2167,15,2182,0
2020-12-07,Los Angeles,037,10098052,501157,451052,9437,460489,7937
2020-12-07,Madera,039,155013,7890,6935,228,7163,59
2020-12-07,Marin,041,260295,8412,8049,50,8099,136
2020-12-07,Mariposa,043,17540,176,146,2,148,2
2020-12-07,Mendocino,045,87422,1857,1638,14,1652,23
2020-12-07,Merced,047,269075,14315,13250,195,13445,179
2020-12-07,Modoc,049,8938,166,128,36,164,0
2020-12-07,Mono,051,14174,680,590,11,601,3
2020-12-07,Monterey,053,433212,19652,17746,380,18126,132
2020-12-07,Napa,055,140530,4276,3684,19,3703,21
2020-12-07,Nevada,057,99092,2049,1777,56,1833,11
2020-12-07,Orange,059,3164182,103321,89793,3270,93063,1628
2020-12-07,Placer,061,380077,10011,7911,267,8178,82
2020-12-07,Plumas,063,18699,327,256,5,261,0
2020-12-07,Riverside,065,2383286,119694,102363,3580,105943,1491
2020-12-07,Sacramento,067,1510023,48467,43419,241,43660,638
2020-12-07,San Benito,069,59416,2395,2165,15,2180,18
2020-12-07,San Bernardino,071,2135413,130228,108161,2864,111025,1295
2020-12-07,San Diego,073,3302833,104761,94171,4303,98474,1062
2020-12-07,San Francisco,075,870044,18362,17220,138,17358,161
2020-12-07,San Joaquin,077,732212,33101,28188,788,28976,530
2020-12-07,San Luis Obispo,079,281455,7793,6782,132,6914,45
2020-12-07,San Mateo,081,765935,18280,16029,22,16051,175
2020-12-07,Santa Barbara,083,443738,13255,12362,272,12634,141
2020-12-07,Santa Clara,085,1922200,48030,40621,138,40759,484
2020-12-07,Santa Cruz,087,273765,6156,5152,96,5248,41
2020-12-07,Shasta,089,179085,6755,5742,370,6112,50
2020-12-07,Sierra,091,2930,20,18,0,18,0
2020-12-07,Siskiyou,093,43540,819,652,58,710,2
2020-12-07,Solano,095,438530,13021,11354,111,11465,89
2020-12-07,Sonoma,097,501317,14802,13376,86,13462,164
2020-12-07,Stanislaus,099,539301,26678,24479,1906,26385,454
2020-12-07,Sutter,101,95872,4768,4106,18,4124,24
2020-12-07,Tehama,103,63373,2253,2030,116,2146,9
2020-12-07,Trinity,105,12862,335,194,38,232,0
2020-12-07,Tulare,107,460477,25775,22760,2197,24957,328
2020-12-07,Tuolumne,109,53932,1581,1256,9,1265,7
2020-12-07,Ventura,111,848112,26473,23354,829,24183,191
2020-12-07,Yolo,113,214977,6275,5537,26,5563,90
2020-12-07,Yuba,115,75493,2709,2428,21,2449,10
2020-12-06,Alameda,001,1643700,36781,33477,478,33955,465
2020-12-06,Alpine,003,1148,59,53,0,53,0
2020-12-06,Amador,005,37829,1221,952,6,958,17
2020-12-06,Butte,007,227075,5114,4527,346,4873,67
2020-12-06,Calaveras,009,45235,672,606,0,606,21
2020-12-06,Colusa,011,21464,963,824,23,847,6
2020-12-06,Contra Costa,013,1133247,29184,26566,233,26799,270
2020-12-06,Del Norte,015,27424,486,414,0,414,2
2020-12-06,El Dorado,017,186661,3907,3086,79,3165,8
2020-12-06,Fresno,019,978130,49490,40869,2135,43004,526
2020-12-06,Glenn,021,27897,1183,1067,96,1163,8
2020-12-06,Humboldt,023,135768,1219,1004,4,1008,9
2020-12-06,Imperial,025,180216,18653,16922,174,17096,364
2020-12-06,Inyo,027,18085,377,333,6,339,15
2020-12-06,Kern,029,883053,48288,43899,2236,46135,486
2020-12-06,Kings,031,150075,13201,12056,278,12334,90
2020-12-06,Lake,033,64148,1261,1075,0,1075,20
2020-12-06,Lassen,035,31185,2991,2168,13,2181,0
2020-12-06,Los Angeles,037,10098052,487560,443230,9003,452233,7910
2020-12-06,Madera,039,155013,7717,6826,219,7045,59
2020-12-06,Marin,041,260295,8331,8013,47,8060,136
2020-12-06,Mariposa,043,17540,175,144,2,146,2
2020-12-06,Mendocino,045,87422,1817,1614,14,1628,23
2020-12-06,Merced,047,269075,13979,12928,186,13114,179
2020-12-06,Modoc,049,8938,153,125,29,154,0
2020-12-06,Mono,051,14174,658,586,10,596,3
2020-12-06,Monterey,053,433212,19034,17426,370,17796,130
2020-12-06,Napa,055,140530,4164,3644,19,3663,21
2020-12-06,Nevada,057,99092,1990,1710,53,1763,10
2020-12-06,Orange,059,3164182,100256,87737,3140,90877,1627
2020-12-06,Placer,061,380077,9729,7837,247,8084,82
2020-12-06,Plumas,063,18699,314,254,4,258,0
2020-12-06,Riverside,065,2383286,116598,100088,3359,103447,1482
2020-12-06,Sacramento,067,1510023,47228,42808,227,43035,638
2020-12-06,San Benito,069,59416,2358,2135,15,2150,18
2020-12-06,San Bernardino,071,2135413,126077,106927,2709,109636,1286
2020-12-06,San Diego,073,3302833,101728,92173,4149,96322,1062
2020-12-06,San Francisco,075,870044,18039,17107,131,17238,161
2020-12-06,San Joaquin,077,732212,32263,28188,760,28948,530
2020-12-06,San Luis Obispo,079,281455,7628,6723,127,6850,45
2020-12-06,San Mateo,081,765935,17776,15855,20,15875,175
2020-12-06,Santa Barbara,083,443738,13023,12252,263,12515,141
2020-12-06,Santa Clara,085,1922200,46648,39112,133,39245,482
2020-12-06,Santa Cruz,087,273765,5982,5069,90,5159,40
2020-12-06,Shasta,089,179085,6614,5743,349,6092,49
2020-12-06,Sierra,091,2930,20,17,0,17,0
2020-12-06,Siskiyou,093,43540,801,652,56,708,2
2020-12-06,Solano,095,438530,12735,11354,101,11455,88
2020-12-06,Sonoma,097,501317,14513,13238,85,13323,164
2020-12-06,Stanislaus,099,539301,26124,24036,1843,25879,454
2020-12-06,Sutter,101,95872,4652,4009,17,4026,21
2020-12-06,Tehama,103,63373,2194,1982,107,2089,9
2020-12-06,Trinity,105,12862,328,181,36,217,0
2020-12-06,Tulare,107,460477,25249,22756,2132,24888,327
2020-12-06,Tuolumne,109,53932,1485,1210,9,1219,7
2020-12-06,Ventura,111,848112,25932,23035,804,23839,191
2020-12-06,Yolo,113,214977,6113,5465,22,5487,90
2020-12-06,Yuba,115,75493,2665,2340,20,2360,10
2020-12-05,Alameda,001,1643700,36422,32781,467,33248,465
2020-12-05,Alpine,003,1148,58,53,0,53,0
2020-12-05,Amador,005,37829,1197,847,6,853,17
2020-12-05,Butte,007,227075,5046,4455,327,4782,66
2020-12-05,Calaveras,009,45235,660,606,0,606,21
2020-12-05,Colusa,011,21464,945,825,20,845,6
2020-12-05,Contra Costa,013,1133247,28889,26217,226,26443,270
2020-12-05,Del Norte,015,27424,480,408,0,408,2
2020-12-05,El Dorado,017,186661,3842,3061,74,3135,8
2020-12-05,Fresno,019,978130,49171,40568,2081,42649,525
2020-12-05,Glenn,021,27897,1170,1056,90,1146,8
2020-12-05,Humboldt,023,135768,1186,979,4,983,9
2020-12-05,Imperial,025,180216,18485,16544,173,16717,362
2020-12-05,Inyo,027,18085,372,332,6,338,15
2020-12-05,Kern,029,883053,47825,43332,2151,45483,484
2020-12-05,Kings,031,150075,13120,11898,275,12173,90
2020-12-05,Lake,033,64148,1234,1069,0,1069,20
2020-12-05,Lassen,035,31185,2800,2168,11,2179,0
2020-12-05,Los Angeles,037,10098052,481760,433120,8688,441808,7888
2020-12-05,Madera,039,155013,7624,6619,212,6831,59
2020-12-05,Marin,041,260295,8304,7961,47,8008,136
2020-12-05,Mariposa,043,17540,170,143,2,145,2
2020-12-05,Mendocino,045,87422,1778,1585,14,1599,23
2020-12-05,Merced,047,269075,13872,12747,175,12922,180
2020-12-05,Modoc,049,8938,153,118,28,146,0
2020-12-05,Mono,051,14174,653,554,10,564,3
2020-12-05,Monterey,053,433212,18888,17077,366,17443,127
2020-12-05,Napa,055,140530,4093,3565,19,3584,21
2020-12-05,Nevada,057,99092,1975,1642,51,1693,10
2020-12-05,Orange,059,3164182,98791,85735,3044,88779,1612
2020-12-05,Placer,061,380077,9609,7811,238,8049,78
2020-12-05,Plumas,063,18699,307,246,1,247,0
2020-12-05,Riverside,065,2383286,114986,98612,3185,101797,1477
2020-12-05,Sacramento,067,1510023,46563,41878,213,42091,625
2020-12-05,San Benito,069,59416,2314,2073,15,2088,18
2020-12-05,San Bernardino,071,2135413,124551,105382,2581,107963,1283
2020-12-05,San Diego,073,3302833,100376,90470,4068,94538,1055
2020-12-05,San Francisco,075,870044,17855,16786,127,16913,161
2020-12-05,San Joaquin,077,732212,31996,28105,727,28832,523
2020-12-05,San Luis Obispo,079,281455,7561,6623,124,6747,44
2020-12-05,San Mateo,081,765935,17519,15512,20,15532,175
2020-12-05,Santa Barbara,083,443738,12923,12107,257,12364,141
2020-12-05,Santa Clara,085,1922200,45900,38339,128,38467,474
2020-12-05,Santa Cruz,087,273765,5909,4997,89,5086,40
2020-12-05,Shasta,089,179085,6553,5653,338,5991,49
2020-12-05,Sierra,091,2930,20,17,0,17,0
2020-12-05,Siskiyou,093,43540,793,649,55,704,2
2020-12-05,Solano,095,438530,12566,11351,99,11450,87
2020-12-05,Sonoma,097,501317,14417,13137,85,13222,164
2020-12-05,Stanislaus,099,539301,25810,23662,1809,25471,454
2020-12-05,Sutter,101,95872,4587,3937,17,3954,20
2020-12-05,Tehama,103,63373,2178,1926,105,2031,9
2020-12-05,Trinity,105,12862,327,177,36,213,0
2020-12-05,Tulare,107,460477,25035,22660,2075,24735,324
2020-12-05,Tuolumne,109,53932,1428,1180,9,1189,7
2020-12-05,Ventura,111,848112,25560,22710,790,23500,191
2020-12-05,Yolo,113,214977,6036,5351,21,5372,90
2020-12-05,Yuba,115,75493,2628,2275,20,2295,10
2020-12-04,Alameda,001,1643700,35873,31871,454,32325,465
2020-12-04,Alpine,003,1148,58,53,0,53,0
2020-12-04,Amador,005,37829,1183,766,3,769,16
2020-12-04,Butte,007,227075,4974,4336,307,4643,65
2020-12-04,Calaveras,009,45235,655,585,0,585,21
2020-12-04,Colusa,011,21464,931,790,18,808,6
2020-12-04,Contra Costa,013,1133247,28545,25705,214,25919,264
2020-12-04,Del Norte,015,27424,469,401,0,401,2
2020-12-04,El Dorado,017,186661,3754,2933,71,3004,7
2020-12-04,Fresno,019,978130,48462,40108,2013,42121,522
2020-12-04,Glenn,021,27897,1164,1017,82,1099,8
2020-12-04,Humboldt,023,135768,1168,960,4,964,9
2020-12-04,Imperial,025,180216,18243,16484,173,16657,362
2020-12-04,Inyo,027,18085,364,324,6,330,15
2020-12-04,Kern,029,883053,47274,42497,2049,44546,485
2020-12-04,Kings,031,150075,13027,11767,269,12036,88
2020-12-04,Lake,033,64148,1206,1018,0,1018,20
2020-12-04,Lassen,035,31185,2793,2167,10,2177,0
2020-12-04,Los Angeles,037,10098052,473136,424164,8397,432561,7845
2020-12-04,Madera,039,155013,7533,6479,209,6688,58
2020-12-04,Marin,041,260295,8252,7896,44,7940,136
2020-12-04,Mariposa,043,17540,170,136,2,138,2
2020-12-04,Mendocino,045,87422,1759,1563,13,1576,23
2020-12-04,Merced,047,269075,13757,12474,167,12641,177
2020-12-04,Modoc,049,8938,153,115,28,143,0
2020-12-04,Mono,051,14174,648,549,10,559,3
2020-12-04,Monterey,053,433212,18676,16737,357,17094,127
2020-12-04,Napa,055,140530,4039,3432,19,3451,19
2020-12-04,Nevada,057,99092,1950,1560,48,1608,10
2020-12-04,Orange,059,3164182,96869,83738,2980,86718,1597
2020-12-04,Placer,061,380077,9485,7461,225,7686,76
2020-12-04,Plumas,063,18699,300,232,0,232,0
2020-12-04,Riverside,065,2383286,112789,95255,3028,98283,1475
2020-12-04,Sacramento,067,1510023,45799,41061,196,41257,618
2020-12-04,San Benito,069,59416,2281,2006,15,2021,17
2020-12-04,San Bernardino,071,2135413,122278,102418,2473,104891,1290
2020-12-04,San Diego,073,3302833,98892,88183,3981,92164,1047
2020-12-04,San Francisco,075,870044,17664,16499,127,16626,161
2020-12-04,San Joaquin,077,732212,31560,27806,690,28496,522
2020-12-04,San Luis Obispo,079,281455,7476,6473,121,6594,42
2020-12-04,San Mateo,081,765935,17231,15112,19,15131,173
2020-12-04,Santa Barbara,083,443738,12816,11947,251,12198,141
2020-12-04,Santa Clara,085,1922200,44980,37465,122,37587,468
2020-12-04,Santa Cruz,087,273765,5821,4985,87,5072,32
2020-12-04,Shasta,089,179085,6465,5439,329,5768,49
2020-12-04,Sierra,091,2930,19,17,0,17,0
2020-12-04,Siskiyou,093,43540,786,639,52,691,2
2020-12-04,Solano,095,438530,12420,11037,96,11133,87
2020-12-04,Sonoma,097,501317,14269,12962,84,13046,164
2020-12-04,Stanislaus,099,539301,25538,23206,1765,24971,448
2020-12-04,Sutter,101,95872,4515,3791,12,3803,20
2020-12-04,Tehama,103,63373,2138,1876,100,1976,9
2020-12-04,Trinity,105,12862,325,172,36,208,0
2020-12-04,Tulare,107,460477,24749,22273,2003,24276,322
2020-12-04,Tuolumne,109,53932,1397,1134,9,1143,7
2020-12-04,Ventura,111,848112,25183,22024,774,22798,189
2020-12-04,Yolo,113,214977,5962,5294,20,5314,87
2020-12-04,Yuba,115,75493,2586,2225,19,2244,10
2020-12-03,Alameda,001,1643700,35108,31184,437,31621,465
2020-12-03,Alpine,003,1148,57,53,0,53,0
2020-12-03,Amador,005,37829,1132,653,3,656,16
2020-12-03,Butte,007,227075,4879,4305,288,4593,65
2020-12-03,Calaveras,009,45235,635,572,0,572,21
2020-12-03,Colusa,011,21464,918,774,17,791,6
2020-12-03,Contra Costa,013,1133247,28042,25464,207,25671,265
2020-12-03,Del Norte,015,27424,465,388,0,388,2
2020-12-03,El Dorado,017,186661,3628,2740,69,2809,6
2020-12-03,Fresno,019,978130,47709,39680,1941,41621,516
2020-12-03,Glenn,021,27897,1146,997,74,1071,8
2020-12-03,Humboldt,023,135768,1138,923,4,927,9
2020-12-03,Imperial,025,180216,18035,16436,161,16597,359
2020-12-03,Inyo,027,18085,361,321,6,327,15
2020-12-03,Kern,029,883053,46428,42062,1948,44010,483
2020-12-03,Kings,031,150075,12928,11658,258,11916,87
2020-12-03,Lake,033,64148,1191,991,0,991,20
2020-12-03,Lassen,035,31185,2753,2128,9,2137,0
2020-12-03,Los Angeles,037,10098052,463034,415805,8037,423842,7787
2020-12-03,Madera,039,155013,7410,6398,204,6602,58
2020-12-03,Marin,041,260295,8192,7861,40,7901,136
2020-12-03,Mariposa,043,17540,166,132,2,134,2
2020-12-03,Mendocino,045,87422,1742,1547,10,1557,23
2020-12-03,Merced,047,269075,13512,12310,160,12470,177
2020-12-03,Modoc,049,8938,151,114,28,142,0
2020-12-03,Mono,051,14174,626,527,10,537,3
2020-12-03,Monterey,053,433212,18215,16218,348,16566,125
2020-12-03,Napa,055,140530,3925,3360,19,3379,19
2020-12-03,Nevada,057,99092,1872,1472,47,1519,10
2020-12-03,Orange,059,3164182,94336,82187,2911,85098,1591
2020-12-03,Placer,061,380077,9283,7270,209,7479,73
2020-12-03,Plumas,063,18699,285,223,0,223,0
2020-12-03,Riverside,065,2383286,110027,92489,2869,95358,1461
2020-12-03,Sacramento,067,1510023,44740,40280,183,40463,614
2020-12-03,San Benito,069,59416,2235,1967,15,1982,16
2020-12-03,San Bernardino,071,2135413,118949,100787,2390,103177,1283
2020-12-03,San Diego,073,3302833,97077,86144,3863,90007,1040
2020-12-03,San Francisco,075,870044,17442,16236,126,16362,161
2020-12-03,San Joaquin,077,732212,30839,27239,648,27887,522
2020-12-03,San Luis Obispo,079,281455,7308,6388,120,6508,42
2020-12-03,San Mateo,081,765935,16878,14909,19,14928,173
2020-12-03,Santa Barbara,083,443738,12687,11829,245,12074,141
2020-12-03,Santa Clara,085,1922200,43778,36621,116,36737,465
2020-12-03,Santa Cruz,087,273765,5677,4850,83,4933,28
2020-12-03,Shasta,089,179085,6356,5330,322,5652,48
2020-12-03,Sierra,091,2930,19,17,0,17,0
2020-12-03,Siskiyou,093,43540,771,629,49,678,2
2020-12-03,Solano,095,438530,12206,10857,93,10950,87
2020-12-03,Sonoma,097,501317,14026,12772,83,12855,164
2020-12-03,Stanislaus,099,539301,25124,22821,1717,24538,447
2020-12-03,Sutter,101,95872,4431,3727,12,3739,20
2020-12-03,Tehama,103,63373,2086,1832,93,1925,9
2020-12-03,Trinity,105,12862,322,166,36,202,0
2020-12-03,Tulare,107,460477,24349,21993,1913,23906,321
2020-12-03,Tuolumne,109,53932,1355,1105,9,1114,7
2020-12-03,Ventura,111,848112,24480,21555,761,22316,187
2020-12-03,Yolo,113,214977,5824,5069,20,5089,87
2020-12-03,Yuba,115,75493,2516,2182,18,2200,10
2020-12-02,Alameda,001,1643700,34483,30697,428,31125,463
2020-12-02,Alpine,003,1148,56,52,0,52,0
2020-12-02,Amador,005,37829,1060,585,3,588,16
2020-12-02,Butte,007,227075,4756,4243,278,4521,65
2020-12-02,Calaveras,009,45235,619,553,0,553,21
2020-12-02,Colusa,011,21464,902,756,16,772,6
2020-12-02,Contra Costa,013,1133247,27584,25147,195,25342,264
2020-12-02,Del Norte,015,27424,451,384,0,384,2
2020-12-02,El Dorado,017,186661,3527,2638,64,2702,5
2020-12-02,Fresno,019,978130,46953,39324,1843,41167,507
2020-12-02,Glenn,021,27897,1129,995,66,1061,7
2020-12-02,Humboldt,023,135768,1112,899,4,903,9
2020-12-02,Imperial,025,180216,17613,16360,154,16514,356
2020-12-02,Inyo,027,18085,354,314,6,320,15
2020-12-02,Kern,029,883053,45531,41660,1853,43513,479
2020-12-02,Kings,031,150075,12575,11531,244,11775,86
2020-12-02,Lake,033,64148,1160,971,0,971,20
2020-12-02,Lassen,035,31185,2694,2115,9,2124,0
2020-12-02,Los Angeles,037,10098052,452983,408289,7706,415995,7739
2020-12-02,Madera,039,155013,7286,6370,198,6568,57
2020-12-02,Marin,041,260295,8145,7819,38,7857,136
2020-12-02,Mariposa,043,17540,163,131,2,133,2
2020-12-02,Mendocino,045,87422,1709,1524,10,1534,23
2020-12-02,Merced,047,269075,13268,12168,152,12320,173
2020-12-02,Modoc,049,8938,148,113,28,141,0
2020-12-02,Mono,051,14174,617,520,10,530,3
2020-12-02,Monterey,053,433212,17735,16064,309,16373,121
2020-12-02,Napa,055,140530,3822,3298,18,3316,19
2020-12-02,Nevada,057,99092,1810,1430,46,1476,9
2020-12-02,Orange,059,3164182,92138,81046,2832,83878,1569
2020-12-02,Placer,061,380077,9049,6941,196,7137,73
2020-12-02,Plumas,063,18699,272,218,0,218,0
2020-12-02,Riverside,065,2383286,107310,90089,2690,92779,1451
2020-12-02,Sacramento,067,1510023,43701,39334,172,39506,597
2020-12-02,San Benito,069,59416,2170,1921,15,1936,16
2020-12-02,San Bernardino,071,2135413,115380,98567,2285,100852,1240
2020-12-02,San Diego,073,3302833,95161,84640,3748,88388,1035
2020-12-02,San Francisco,075,870044,17205,16058,124,16182,157
2020-12-02,San Joaquin,077,732212,30219,26740,625,27365,519
2020-12-02,San Luis Obispo,079,281455,7209,6324,118,6442,42
2020-12-02,San Mateo,081,765935,16515,14757,18,14775,170
2020-12-02,Santa Barbara,083,443738,12536,11705,233,11938,140
2020-12-02,Santa Clara,085,1922200,42662,35878,116,35994,458
2020-12-02,Santa Cruz,087,273765,5545,4766,80,4846,27
2020-12-02,Shasta,089,179085,6233,5188,305,5493,47
2020-12-02,Sierra,091,2930,19,17,0,17,0
2020-12-02,Siskiyou,093,43540,755,624,47,671,1
2020-12-02,Solano,095,438530,11960,10701,89,10790,87
2020-12-02,Sonoma,097,501317,13787,12635,82,12717,163
2020-12-02,Stanislaus,099,539301,24623,22615,1662,24277,448
2020-12-02,Sutter,101,95872,4272,3604,12,3616,18
2020-12-02,Tehama,103,63373,2041,1800,78,1878,9
2020-12-02,Trinity,105,12862,312,165,35,200,0
2020-12-02,Tulare,107,460477,23968,21789,1836,23625,321
2020-12-02,Tuolumne,109,53932,1314,1076,9,1085,7
2020-12-02,Ventura,111,848112,24068,21208,743,21951,186
2020-12-02,Yolo,113,214977,5713,5053,19,5072,87
2020-12-02,Yuba,115,75493,2438,2119,17,2136,10
2020-12-01,Alameda,001,1643700,33791,30252,418,30670,460
2020-12-01,Alpine,003,1148,56,41,0,41,0
2020-12-01,Amador,005,37829,913,575,2,577,16
2020-12-01,Butte,007,227075,4650,4177,264,4441,65
2020-12-01,Calaveras,009,45235,601,544,0,544,21
2020-12-01,Colusa,011,21464,885,747,16,763,6
2020-12-01,Contra Costa,013,1133247,27013,24788,187,24975,264
2020-12-01,Del Norte,015,27424,423,357,0,357,2
2020-12-01,El Dorado,017,186661,3383,2542,59,2601,4
2020-12-01,Fresno,019,978130,46051,39004,1767,40771,505
2020-12-01,Glenn,021,27897,1108,989,62,1051,7
2020-12-01,Humboldt,023,135768,1082,886,4,890,9
2020-12-01,Imperial,025,180216,17295,16278,151,16429,356
2020-12-01,Inyo,027,18085,347,304,6,310,15
2020-12-01,Kern,029,883053,44729,41345,1726,43071,478
2020-12-01,Kings,031,150075,12260,11415,230,11645,86
2020-12-01,Lake,033,64148,1141,969,0,969,19
2020-12-01,Lassen,035,31185,2528,2047,8,2055,0
2020-12-01,Los Angeles,037,10098052,442610,403266,7391,410657,7704
2020-12-01,Madera,039,155013,7169,6270,188,6458,57
2020-12-01,Marin,041,260295,8075,7787,37,7824,136
2020-12-01,Mariposa,043,17540,158,128,2,130,2
2020-12-01,Mendocino,045,87422,1675,1497,10,1507,23
2020-12-01,Merced,047,269075,13025,12032,143,12175,172
2020-12-01,Modoc,049,8938,143,113,24,137,0
2020-12-01,Mono,051,14174,604,520,10,530,3
2020-12-01,Monterey,053,433212,17228,15835,298,16133,121
2020-12-01,Napa,055,140530,3738,3124,17,3141,19
2020-12-01,Nevada,057,99092,1748,1411,45,1456,9
2020-12-01,Orange,059,3164182,90037,79468,2743,82211,1567
2020-12-01,Placer,061,380077,8725,6794,189,6983,72
2020-12-01,Plumas,063,18699,260,201,0,201,0
2020-12-01,Riverside,065,2383286,104501,88530,2530,91060,1448
2020-12-01,Sacramento,067,1510023,42652,38966,169,39135,589
2020-12-01,San Benito,069,59416,2115,1888,15,1903,15
2020-12-01,San Bernardino,071,2135413,111909,95854,2162,98016,1220
2020-12-01,San Diego,073,3302833,92904,83423,3638,87061,1019
2020-12-01,San Francisco,075,870044,16922,15797,121,15918,157
2020-12-01,San Joaquin,077,732212,29418,26432,604,27036,514
2020-12-01,San Luis Obispo,079,281455,7067,6264,113,6377,40
2020-12-01,San Mateo,081,765935,16190,14495,18,14513,170
2020-12-01,Santa Barbara,083,443738,12397,11611,223,11834,140
2020-12-01,Santa Clara,085,1922200,41408,35397,110,35507,452
2020-12-01,Santa Cruz,087,273765,5387,4638,72,4710,27
2020-12-01,Shasta,089,179085,6108,5077,285,5362,47
2020-12-01,Sierra,091,2930,19,17,0,17,0
2020-12-01,Siskiyou,093,43540,741,608,43,651,1
2020-12-01,Solano,095,438530,11699,10604,84,10688,87
2020-12-01,Sonoma,097,501317,13583,12491,79,12570,163
2020-12-01,Stanislaus,099,539301,24167,22351,1604,23955,447
2020-12-01,Sutter,101,95872,4130,3538,12,3550,17
2020-12-01,Tehama,103,63373,1975,1773,68,1841,9
2020-12-01,Trinity,105,12862,298,165,29,194,0
2020-12-01,Tulare,107,460477,23513,21645,1768,23413,319
2020-12-01,Tuolumne,109,53932,1278,1052,7,1059,7
2020-12-01,Ventura,111,848112,23455,20604,721,21325,186
2020-12-01,Yolo,113,214977,5573,4928,19,4947,86
2020-12-01,Yuba,115,75493,2372,2088,16,2104,10
2020-11-30,Alameda,001,1643700,32971,29972,401,30373,457
2020-11-30,Alpine,003,1148,54,41,0,41,0
2020-11-30,Amador,005,37829,872,559,2,561,16
2020-11-30,Butte,007,227075,4532,4148,248,4396,65
2020-11-30,Calaveras,009,45235,580,478,0,478,21
2020-11-30,Colusa,011,21464,858,737,12,749,6
2020-11-30,Contra Costa,013,1133247,26430,24365,183,24548,264
2020-11-30,Del Norte,015,27424,400,339,0,339,2
2020-11-30,El Dorado,017,186661,3209,2488,53,2541,4
2020-11-30,Fresno,019,978130,44941,38712,1656,40368,500
2020-11-30,Glenn,021,27897,1085,954,57,1011,5
2020-11-30,Humboldt,023,135768,1035,870,4,874,9
2020-11-30,Imperial,025,180216,17041,16212,130,16342,356
2020-11-30,Inyo,027,18085,342,304,5,309,15
2020-11-30,Kern,029,883053,43970,40941,1594,42535,473
2020-11-30,Kings,031,150075,12112,11346,215,11561,85
2020-11-30,Lake,033,64148,1109,939,0,939,18
2020-11-30,Lassen,035,31185,2436,1793,8,1801,0
2020-11-30,Los Angeles,037,10098052,431928,396202,7067,403269,7658
2020-11-30,Madera,039,155013,7003,6210,174,6384,57
2020-11-30,Marin,041,260295,8032,7764,36,7800,136
2020-11-30,Mariposa,043,17540,151,123,2,125,2
2020-11-30,Mendocino,045,87422,1647,1482,10,1492,23
2020-11-30,Merced,047,269075,12750,11913,132,12045,172
2020-11-30,Modoc,049,8938,133,113,24,137,0
2020-11-30,Mono,051,14174,582,519,10,529,3
2020-11-30,Monterey,053,433212,16798,15837,290,16127,119
2020-11-30,Napa,055,140530,3638,3091,17,3108,18
2020-11-30,Nevada,057,99092,1662,1347,42,1389,9
2020-11-30,Orange,059,3164182,87928,78711,2647,81358,1568
2020-11-30,Placer,061,380077,8429,6575,176,6751,72
2020-11-30,Plumas,063,18699,249,192,0,192,0
2020-11-30,Riverside,065,2383286,101507,87722,2385,90107,1446
2020-11-30,Sacramento,067,1510023,41572,37834,160,37994,586
2020-11-30,San Benito,069,59416,2068,1875,14,1889,15
2020-11-30,San Bernardino,071,2135413,108175,92704,2051,94755,1220
2020-11-30,San Diego,073,3302833,90541,82045,3511,85556,997
2020-11-30,San Francisco,075,870044,16624,15638,118,15756,157
2020-11-30,San Joaquin,077,732212,28710,25742,578,26320,509
2020-11-30,San Luis Obispo,079,281455,6933,6224,111,6335,36
2020-11-30,San Mateo,081,765935,15831,14276,18,14294,170
2020-11-30,Santa Barbara,083,443738,12219,11572,215,11787,140
2020-11-30,Santa Clara,085,1922200,40200,35019,109,35128,451
2020-11-30,Santa Cruz,087,273765,5249,4558,69,4627,26
2020-11-30,Shasta,089,179085,5963,4933,257,5190,44
2020-11-30,Sierra,091,2930,19,16,0,16,0
2020-11-30,Siskiyou,093,43540,732,605,39,644,1
2020-11-30,Solano,095,438530,11437,10392,79,10471,87
2020-11-30,Sonoma,097,501317,13338,12232,75,12307,163
2020-11-30,Stanislaus,099,539301,23704,22110,1562,23672,446
2020-11-30,Sutter,101,95872,3974,3430,12,3442,16
2020-11-30,Tehama,103,63373,1926,1724,61,1785,9
2020-11-30,Trinity,105,12862,292,162,29,191,0
2020-11-30,Tulare,107,460477,23127,20833,1675,22508,319
2020-11-30,Tuolumne,109,53932,1234,1027,7,1034,7
2020-11-30,Ventura,111,848112,22699,20308,705,21013,180
2020-11-30,Yolo,113,214977,5461,4894,19,4913,81
2020-11-30,Yuba,115,75493,2312,2028,14,2042,10
2020-11-29,Alameda,001,1643700,32184,29918,379,30297,457
2020-11-29,Alpine,003,1148,51,41,0,41,0
2020-11-29,Amador,005,37829,721,548,2,550,16
2020-11-29,Butte,007,227075,4431,4008,232,4240,65
2020-11-29,Calaveras,009,45235,549,478,0,478,21
2020-11-29,Colusa,011,21464,829,723,8,731,6
2020-11-29,Contra Costa,013,1133247,25927,24165,177,24342,264
2020-11-29,Del Norte,015,27424,394,339,0,339,2
2020-11-29,El Dorado,017,186661,3078,2447,51,2498,4
2020-11-29,Fresno,019,978130,43990,38568,1585,40153,500
2020-11-29,Glenn,021,27897,1062,951,55,1006,4
2020-11-29,Humboldt,023,135768,1006,856,4,860,9
2020-11-29,Imperial,025,180216,16810,16138,105,16243,356
2020-11-29,Inyo,027,18085,327,289,5,294,15
2020-11-29,Kern,029,883053,43207,40596,1446,42042,473
2020-11-29,Kings,031,150075,11961,11247,197,11444,85
2020-11-29,Lake,033,64148,1085,927,0,927,18
2020-11-29,Lassen,035,31185,2333,1793,8,1801,0
2020-11-29,Los Angeles,037,10098052,421523,391162,6773,397935,7642
2020-11-29,Madera,039,155013,6860,6184,168,6352,57
2020-11-29,Marin,041,260295,7966,7739,33,7772,135
2020-11-29,Mariposa,043,17540,147,123,2,125,2
2020-11-29,Mendocino,045,87422,1613,1473,10,1483,23
2020-11-29,Merced,047,269075,12511,11773,123,11896,172
2020-11-29,Modoc,049,8938,129,105,22,127,0
2020-11-29,Mono,051,14174,559,515,9,524,3
2020-11-29,Monterey,053,433212,16485,15621,283,15904,119
2020-11-29,Napa,055,140530,3533,3090,16,3106,18
2020-11-29,Nevada,057,99092,1582,1311,40,1351,9
2020-11-29,Orange,059,3164182,85909,78057,2601,80658,1567
2020-11-29,Placer,061,380077,8131,6535,164,6699,72
2020-11-29,Plumas,063,18699,244,191,0,191,0
2020-11-29,Riverside,065,2383286,99113,87383,2233,89616,1442
2020-11-29,Sacramento,067,1510023,40494,37415,151,37566,585
2020-11-29,San Benito,069,59416,2024,1860,14,1874,15
2020-11-29,San Bernardino,071,2135413,104826,92052,1935,93987,1223
2020-11-29,San Diego,073,3302833,88130,81086,3358,84444,997
2020-11-29,San Francisco,075,870044,16342,15571,112,15683,153
2020-11-29,San Joaquin,077,732212,27965,25740,572,26312,509
2020-11-29,San Luis Obispo,079,281455,6810,6145,111,6256,36
2020-11-29,San Mateo,081,765935,15499,14177,18,14195,169
2020-11-29,Santa Barbara,083,443738,12064,11520,211,11731,140
2020-11-29,Santa Clara,085,1922200,38994,34234,103,34337,451
2020-11-29,Santa Cruz,087,273765,5090,4490,67,4557,26
2020-11-29,Shasta,089,179085,5791,4935,229,5164,43
2020-11-29,Sierra,091,2930,19,16,0,16,0
2020-11-29,Siskiyou,093,43540,709,590,37,627,1
2020-11-29,Solano,095,438530,11205,10393,75,10468,87
2020-11-29,Sonoma,097,501317,13086,12052,71,12123,163
2020-11-29,Stanislaus,099,539301,23208,21701,1528,23229,446
2020-11-29,Sutter,101,95872,3859,3297,12,3309,16
2020-11-29,Tehama,103,63373,1875,1710,47,1757,9
2020-11-29,Trinity,105,12862,289,159,27,186,0
2020-11-29,Tulare,107,460477,22758,20793,1600,22393,319
2020-11-29,Tuolumne,109,53932,1197,988,7,995,7
2020-11-29,Ventura,111,848112,22015,19952,693,20645,179
2020-11-29,Yolo,113,214977,5323,4830,18,4848,80
2020-11-29,Yuba,115,75493,2256,1959,14,1973,10
2020-11-28,Alameda,001,1643700,31874,29368,374,29742,456
2020-11-28,Alpine,003,1148,51,41,0,41,0
2020-11-28,Amador,005,37829,644,536,2,538,16
2020-11-28,Butte,007,227075,4373,3894,228,4122,65
2020-11-28,Calaveras,009,45235,543,478,0,478,21
2020-11-28,Colusa,011,21464,820,711,6,717,6
2020-11-28,Contra Costa,013,1133247,25595,23798,173,23971,264
2020-11-28,Del Norte,015,27424,384,328,0,328,2
2020-11-28,El Dorado,017,186661,3010,2415,45,2460,4
2020-11-28,Fresno,019,978130,43643,38288,1547,39835,500
2020-11-28,Glenn,021,27897,1051,925,51,976,4
2020-11-28,Humboldt,023,135768,971,844,4,848,9
2020-11-28,Imperial,025,180216,16744,16019,103,16122,356
2020-11-28,Inyo,027,18085,319,289,5,294,15
2020-11-28,Kern,029,883053,42844,40255,1358,41613,473
2020-11-28,Kings,031,150075,11896,11070,190,11260,85
2020-11-28,Lake,033,64148,1070,920,0,920,18
2020-11-28,Lassen,035,31185,2266,1714,8,1722,0
2020-11-28,Los Angeles,037,10098052,416601,386194,6617,392811,7625
2020-11-28,Madera,039,155013,6758,6119,161,6280,57
2020-11-28,Marin,041,260295,7936,7696,29,7725,135
2020-11-28,Mariposa,043,17540,144,120,2,122,2
2020-11-28,Mendocino,045,87422,1582,1458,10,1468,22
2020-11-28,Merced,047,269075,12413,11688,117,11805,172
2020-11-28,Modoc,049,8938,126,103,22,125,0
2020-11-28,Mono,051,14174,553,505,9,514,3
2020-11-28,Monterey,053,433212,16319,15328,279,15607,118
2020-11-28,Napa,055,140530,3481,3033,16,3049,18
2020-11-28,Nevada,057,99092,1553,1272,38,1310,9
2020-11-28,Orange,059,3164182,84812,76882,2555,79437,1568
2020-11-28,Placer,061,380077,7970,6497,161,6658,70
2020-11-28,Plumas,063,18699,237,188,0,188,0
2020-11-28,Riverside,065,2383286,97704,86854,2132,88986,1440
2020-11-28,Sacramento,067,1510023,39916,36905,147,37052,580
2020-11-28,San Benito,069,59416,1979,1835,14,1849,15
2020-11-28,San Bernardino,071,2135413,103424,91183,1832,93015,1224
2020-11-28,San Diego,073,3302833,86876,80020,3274,83294,997
2020-11-28,San Francisco,075,870044,16166,15450,105,15555,153
2020-11-28,San Joaquin,077,732212,27764,25742,557,26299,509
2020-11-28,San Luis Obispo,079,281455,6740,6106,107,6213,36
2020-11-28,San Mateo,081,765935,15309,14040,18,14058,169
2020-11-28,Santa Barbara,083,443738,11962,11481,206,11687,140
2020-11-28,Santa Clara,085,1922200,38248,33701,101,33802,449
2020-11-28,Santa Cruz,087,273765,5013,4426,67,4493,26
2020-11-28,Shasta,089,179085,5714,4882,222,5104,43
2020-11-28,Sierra,091,2930,19,16,0,16,0
2020-11-28,Siskiyou,093,43540,699,558,34,592,1
2020-11-28,Solano,095,438530,11086,10252,73,10325,87
2020-11-28,Sonoma,097,501317,12982,12008,62,12070,162
2020-11-28,Stanislaus,099,539301,22969,21574,1494,23068,446
2020-11-28,Sutter,101,95872,3775,3244,12,3256,15
2020-11-28,Tehama,103,63373,1856,1678,43,1721,9
2020-11-28,Trinity,105,12862,286,157,25,182,0
2020-11-28,Tulare,107,460477,22560,20701,1558,22259,319
2020-11-28,Tuolumne,109,53932,1175,976,7,983,7
2020-11-28,Ventura,111,848112,21717,19510,683,20193,179
2020-11-28,Yolo,113,214977,5249,4739,16,4755,80
2020-11-28,Yuba,115,75493,2202,1912,14,1926,10
2020-11-27,Alameda,001,1643700,31433,29064,364,29428,450
2020-11-27,Alpine,003,1148,51,41,0,41,0
2020-11-27,Amador,005,37829,597,498,1,499,16
2020-11-27,Butte,007,227075,4332,3894,222,4116,65
2020-11-27,Calaveras,009,45235,534,478,0,478,21
2020-11-27,Colusa,011,21464,803,694,4,698,6
2020-11-27,Contra Costa,013,1133247,25335,23463,167,23630,264
2020-11-27,Del Norte,015,27424,378,307,0,307,2
2020-11-27,El Dorado,017,186661,2939,2238,42,2280,4
2020-11-27,Fresno,019,978130,43237,37994,1491,39485,500
2020-11-27,Glenn,021,27897,1038,891,46,937,4
2020-11-27,Humboldt,023,135768,952,795,3,798,9
2020-11-27,Imperial,025,180216,16677,15960,95,16055,356
2020-11-27,Inyo,027,18085,313,289,5,294,15
2020-11-27,Kern,029,883053,42421,39707,1288,40995,473
2020-11-27,Kings,031,150075,11811,10667,172,10839,85
2020-11-27,Lake,033,64148,1034,909,0,909,18
2020-11-27,Lassen,035,31185,2254,1714,8,1722,0
2020-11-27,Los Angeles,037,10098052,410087,382740,6465,389205,7606
2020-11-27,Madera,039,155013,6686,6050,156,6206,57
2020-11-27,Marin,041,260295,7893,7660,29,7689,135
2020-11-27,Mariposa,043,17540,142,118,2,120,2
2020-11-27,Mendocino,045,87422,1568,1387,9,1396,22
2020-11-27,Merced,047,269075,12307,11550,110,11660,172
2020-11-27,Modoc,049,8938,125,100,22,122,0
2020-11-27,Mono,051,14174,549,498,9,507,3
2020-11-27,Monterey,053,433212,16151,14753,279,15032,113
2020-11-27,Napa,055,140530,3441,2988,16,3004,18
2020-11-27,Nevada,057,99092,1523,1184,36,1220,9
2020-11-27,Orange,059,3164182,83523,75151,2516,77667,1568
2020-11-27,Placer,061,380077,7810,6283,151,6434,68
2020-11-27,Plumas,063,18699,234,188,0,188,0
2020-11-27,Riverside,065,2383286,96094,85769,1980,87749,1440
2020-11-27,Sacramento,067,1510023,39295,36579,143,36722,579
2020-11-27,San Benito,069,59416,1945,1805,13,1818,15
2020-11-27,San Bernardino,071,2135413,101908,90254,1751,92005,1224
2020-11-27,San Diego,073,3302833,85682,78161,3185,81346,996
2020-11-27,San Francisco,075,870044,16010,15377,103,15480,153
2020-11-27,San Joaquin,077,732212,27543,25741,537,26278,509
2020-11-27,San Luis Obispo,079,281455,6657,6039,104,6143,36
2020-11-27,San Mateo,081,765935,15107,13872,17,13889,169
2020-11-27,Santa Barbara,083,443738,11869,11340,203,11543,140
2020-11-27,Santa Clara,085,1922200,37571,32935,94,33029,449
2020-11-27,Santa Cruz,087,273765,4942,4358,65,4423,26
2020-11-27,Shasta,089,179085,5637,4710,209,4919,43
2020-11-27,Sierra,091,2930,18,16,0,16,0
2020-11-27,Siskiyou,093,43540,684,554,31,585,1
2020-11-27,Solano,095,438530,10967,10044,70,10114,87
2020-11-27,Sonoma,097,501317,12849,11924,60,11984,162
2020-11-27,Stanislaus,099,539301,22741,21185,1465,22650,446
2020-11-27,Sutter,101,95872,3707,3101,12,3113,15
2020-11-27,Tehama,103,63373,1828,1649,39,1688,9
2020-11-27,Trinity,105,12862,282,151,25,176,0
2020-11-27,Tulare,107,460477,22372,20634,1501,22135,319
2020-11-27,Tuolumne,109,53932,1143,881,7,888,7
2020-11-27,Ventura,111,848112,21393,19379,661,20040,179
2020-11-27,Yolo,113,214977,5199,4737,16,4753,79
2020-11-27,Yuba,115,75493,2173,1864,13,1877,10
2020-11-26,Alameda,001,1643700,31020,28797,346,29143,447
2020-11-26,Alpine,003,1148,51,41,0,41,0
2020-11-26,Amador,005,37829,589,488,1,489,16
2020-11-26,Butte,007,227075,4269,3894,216,4110,65
2020-11-26,Calaveras,009,45235,507,478,0,478,21
2020-11-26,Colusa,011,21464,789,694,4,698,6
2020-11-26,Contra Costa,013,1133247,25002,23468,161,23629,264
2020-11-26,Del Norte,015,27424,367,307,0,307,2
2020-11-26,El Dorado,017,186661,2858,2217,40,2257,4
2020-11-26,Fresno,019,978130,42831,37724,1446,39170,500
2020-11-26,Glenn,021,27897,1022,892,44,936,4
2020-11-26,Humboldt,023,135768,929,795,2,797,9
2020-11-26,Imperial,025,180216,16566,15722,92,15814,355
2020-11-26,Inyo,027,18085,312,289,5,294,15
2020-11-26,Kern,029,883053,41971,39123,1228,40351,471
2020-11-26,Kings,031,150075,11756,10475,160,10635,85
2020-11-26,Lake,033,64148,1021,890,0,890,18
2020-11-26,Lassen,035,31185,2239,1714,8,1722,0
2020-11-26,Los Angeles,037,10098052,404928,378340,6228,384568,7581
2020-11-26,Madera,039,155013,6611,6003,151,6154,57
2020-11-26,Marin,041,260295,7856,7610,29,7639,135
2020-11-26,Mariposa,043,17540,137,116,2,118,2
2020-11-26,Mendocino,045,87422,1554,1387,7,1394,22
2020-11-26,Merced,047,269075,12160,11440,108,11548,172
2020-11-26,Modoc,049,8938,123,100,22,122,0
2020-11-26,Mono,051,14174,541,485,9,494,2
2020-11-26,Monterey,053,433212,15915,14750,271,15021,113
2020-11-26,Napa,055,140530,3377,2988,16,3004,18
2020-11-26,Nevada,057,99092,1478,1184,36,1220,9
2020-11-26,Orange,059,3164182,82136,74264,2456,76720,1563
2020-11-26,Placer,061,380077,7648,6278,142,6420,68
2020-11-26,Plumas,063,18699,226,188,0,188,0
2020-11-26,Riverside,065,2383286,94491,85774,1856,87630,1440
2020-11-26,Sacramento,067,1510023,38654,35854,135,35989,580
2020-11-26,San Benito,069,59416,1918,1769,13,1782,15
2020-11-26,San Bernardino,071,2135413,100254,89727,1659,91386,1223
2020-11-26,San Diego,073,3302833,84072,76359,3081,79440,996
2020-11-26,San Francisco,075,870044,15875,15156,99,15255,153
2020-11-26,San Joaquin,077,732212,27286,25738,525,26263,509
2020-11-26,San Luis Obispo,079,281455,6564,5964,101,6065,36
2020-11-26,San Mateo,081,765935,14918,13715,16,13731,169
2020-11-26,Santa Barbara,083,443738,11788,11277,202,11479,139
2020-11-26,Santa Clara,085,1922200,36925,32411,87,32498,446
2020-11-26,Santa Cruz,087,273765,4811,4269,59,4328,26
2020-11-26,Shasta,089,179085,5554,4712,198,4910,43
2020-11-26,Sierra,091,2930,18,15,0,15,0
2020-11-26,Siskiyou,093,43540,674,526,31,557,1
2020-11-26,Solano,095,438530,10824,9941,68,10009,87
2020-11-26,Sonoma,097,501317,12701,11922,58,11980,162
2020-11-26,Stanislaus,099,539301,22509,21186,1425,22611,445
2020-11-26,Sutter,101,95872,3613,3101,11,3112,15
2020-11-26,Tehama,103,63373,1785,1612,36,1648,9
2020-11-26,Trinity,105,12862,278,139,25,164,0
2020-11-26,Tulare,107,460477,22133,20649,1440,22089,319
2020-11-26,Tuolumne,109,53932,1115,871,7,878,7
2020-11-26,Ventura,111,848112,20897,19058,647,19705,179
2020-11-26,Yolo,113,214977,5112,4566,16,4582,76
2020-11-26,Yuba,115,75493,2113,1865,11,1876,10
2020-11-25,Alameda,001,1643700,30805,28378,338,28716,447
2020-11-25,Alpine,003,1148,51,41,0,41,0
2020-11-25,Amador,005,37829,579,484,1,485,16
2020-11-25,Butte,007,227075,4238,3848,213,4061,64
2020-11-25,Calaveras,009,45235,504,475,0,475,21
2020-11-25,Colusa,011,21464,772,693,4,697,6
2020-11-25,Contra Costa,013,1133247,24847,23307,160,23467,263
2020-11-25,Del Norte,015,27424,366,304,0,304,2
2020-11-25,El Dorado,017,186661,2822,2154,40,2194,4
2020-11-25,Fresno,019,978130,42598,37349,1424,38773,494
2020-11-25,Glenn,021,27897,1005,891,42,933,4
2020-11-25,Humboldt,023,135768,921,777,2,779,9
2020-11-25,Imperial,025,180216,16494,15640,91,15731,355
2020-11-25,Inyo,027,18085,310,289,5,294,15
2020-11-25,Kern,029,883053,41815,38878,1211,40089,467
2020-11-25,Kings,031,150075,11721,10417,156,10573,85
2020-11-25,Lake,033,64148,1004,878,0,878,18
2020-11-25,Lassen,035,31185,2196,1701,8,1709,0
2020-11-25,Los Angeles,037,10098052,401900,373919,6126,380045,7545
2020-11-25,Madera,039,155013,6589,5989,148,6137,57
2020-11-25,Marin,041,260295,7829,7601,28,7629,135
2020-11-25,Mariposa,043,17540,136,114,2,116,2
2020-11-25,Mendocino,045,87422,1535,1373,7,1380,22
2020-11-25,Merced,047,269075,12102,11346,108,11454,172
2020-11-25,Modoc,049,8938,123,96,22,118,0
2020-11-25,Mono,051,14174,536,487,9,496,2
2020-11-25,Monterey,053,433212,15799,14695,269,14964,113
2020-11-25,Napa,055,140530,3344,2945,16,2961,17
2020-11-25,Nevada,057,99092,1460,1170,34,1204,9
2020-11-25,Orange,059,3164182,81380,73014,2436,75450,1551
2020-11-25,Placer,061,380077,7571,6221,141,6362,68
2020-11-25,Plumas,063,18699,221,183,0,183,0
2020-11-25,Riverside,065,2383286,93948,85077,1838,86915,1438
2020-11-25,Sacramento,067,1510023,38318,35687,132,35819,574
2020-11-25,San Benito,069,59416,1895,1764,13,1777,15
2020-11-25,San Bernardino,071,2135413,99413,88469,1630,90099,1225
2020-11-25,San Diego,073,3302833,83415,75307,3045,78352,988
2020-11-25,San Francisco,075,870044,15770,15053,97,15150,153
2020-11-25,San Joaquin,077,732212,27159,25556,513,26069,515
2020-11-25,San Luis Obispo,079,281455,6521,5913,101,6014,34
2020-11-25,San Mateo,081,765935,14803,13614,16,13630,170
2020-11-25,Santa Barbara,083,443738,11738,11183,202,11385,138
2020-11-25,Santa Clara,085,1922200,36478,32032,86,32118,442
2020-11-25,Santa Cruz,087,273765,4758,4202,58,4260,25
2020-11-25,Shasta,089,179085,5508,4588,191,4779,43
2020-11-25,Sierra,091,2930,18,15,0,15,0
2020-11-25,Siskiyou,093,43540,667,499,31,530,1
2020-11-25,Solano,095,438530,10719,9832,67,9899,87
2020-11-25,Sonoma,097,501317,12638,11775,57,11832,162
2020-11-25,Stanislaus,099,539301,22378,21022,1398,22420,445
2020-11-25,Sutter,101,95872,3569,3064,11,3075,14
2020-11-25,Tehama,103,63373,1773,1587,30,1617,9
2020-11-25,Trinity,105,12862,276,135,25,160,0
2020-11-25,Tulare,107,460477,22043,20528,1410,21938,318
2020-11-25,Tuolumne,109,53932,1098,842,7,849,7
2020-11-25,Ventura,111,848112,20802,18914,641,19555,179
2020-11-25,Yolo,113,214977,5075,4527,16,4543,76
2020-11-25,Yuba,115,75493,2087,1840,11,1851,10
2020-11-24,Alameda,001,1643700,30327,28030,327,28357,444
2020-11-24,Alpine,003,1148,51,41,0,41,0
2020-11-24,Amador,005,37829,554,470,1,471,16
2020-11-24,Butte,007,227075,4152,3798,205,4003,63
2020-11-24,Calaveras,009,45235,498,466,0,466,21
2020-11-24,Colusa,011,21464,754,682,4,686,6
2020-11-24,Contra Costa,013,1133247,24495,23072,154,23226,259
2020-11-24,Del Norte,015,27424,357,298,0,298,2
2020-11-24,El Dorado,017,186661,2717,2005,39,2044,4
2020-11-24,Fresno,019,978130,42196,37021,1349,38370,493
2020-11-24,Glenn,021,27897,987,883,38,921,4
2020-11-24,Humboldt,023,135768,902,774,2,776,9
2020-11-24,Imperial,025,180216,16391,15600,86,15686,355
2020-11-24,Inyo,027,18085,309,282,5,287,15
2020-11-24,Kern,029,883053,41341,38551,1135,39686,465
2020-11-24,Kings,031,150075,11454,10338,143,10481,85
2020-11-24,Lake,033,64148,988,872,0,872,18
2020-11-24,Lassen,035,31185,2173,1657,8,1665,0
2020-11-24,Los Angeles,037,10098052,395592,370008,5893,375901,7501
2020-11-24,Madera,039,155013,6505,5881,142,6023,57
2020-11-24,Marin,041,260295,7782,7591,28,7619,135
2020-11-24,Mariposa,043,17540,126,114,1,115,2
2020-11-24,Mendocino,045,87422,1513,1346,6,1352,22
2020-11-24,Merced,047,269075,11914,11268,102,11370,171
2020-11-24,Modoc,049,8938,119,91,22,113,0
2020-11-24,Mono,051,14174,532,483,9,492,2
2020-11-24,Monterey,053,433212,15537,14354,260,14614,113
2020-11-24,Napa,055,140530,3278,2904,16,2920,17
2020-11-24,Nevada,057,99092,1396,1156,32,1188,9
2020-11-24,Orange,059,3164182,79940,71975,2359,74334,1547
2020-11-24,Placer,061,380077,7390,6147,134,6281,67
2020-11-24,Plumas,063,18699,218,180,0,180,0
2020-11-24,Riverside,065,2383286,92189,83685,1712,85397,1420
2020-11-24,Sacramento,067,1510023,37637,35097,125,35222,568
2020-11-24,San Benito,069,59416,1864,1740,12,1752,15
2020-11-24,San Bernardino,071,2135413,97074,86645,1529,88174,1226
2020-11-24,San Diego,073,3302833,82005,74363,2974,77337,984
2020-11-24,San Francisco,075,870044,15576,14874,93,14967,153
2020-11-24,San Joaquin,077,732212,26844,25318,486,25804,517
2020-11-24,San Luis Obispo,079,281455,6458,5805,100,5905,34
2020-11-24,San Mateo,081,765935,14594,13558,15,13573,170
2020-11-24,Santa Barbara,083,443738,11632,11154,201,11355,138
2020-11-24,Santa Clara,085,1922200,35690,31564,82,31646,438
2020-11-24,Santa Cruz,087,273765,4644,4132,57,4189,25
2020-11-24,Shasta,089,179085,5408,4410,172,4582,43
2020-11-24,Sierra,091,2930,18,15,0,15,0
2020-11-24,Siskiyou,093,43540,649,473,28,501,1
2020-11-24,Solano,095,438530,10548,9716,66,9782,86
2020-11-24,Sonoma,097,501317,12458,11644,54,11698,162
2020-11-24,Stanislaus,099,539301,22136,20830,1356,22186,438
2020-11-24,Sutter,101,95872,3463,2974,11,2985,14
2020-11-24,Tehama,103,63373,1724,1565,25,1590,9
2020-11-24,Trinity,105,12862,269,129,24,153,0
2020-11-24,Tulare,107,460477,21794,20319,1349,21668,315
2020-11-24,Tuolumne,109,53932,1069,832,7,839,7
2020-11-24,Ventura,111,848112,20421,18637,631,19268,179
2020-11-24,Yolo,113,214977,4991,4420,16,4436,76
2020-11-24,Yuba,115,75493,2036,1804,9,1813,10
2020-11-23,Alameda,001,1643700,29913,27718,315,28033,444
2020-11-23,Alpine,003,1148,49,41,0,41,0
2020-11-23,Amador,005,37829,513,457,1,458,16
2020-11-23,Butte,007,227075,4088,3765,199,3964,61
2020-11-23,Calaveras,009,45235,481,434,0,434,21
2020-11-23,Colusa,011,21464,740,662,4,666,6
2020-11-23,Contra Costa,013,1133247,24225,22674,149,22823,260
2020-11-23,Del Norte,015,27424,335,296,0,296,2
2020-11-23,El Dorado,017,186661,2597,2005,38,2043,4
2020-11-23,Fresno,019,978130,41748,36688,1288,37976,488
2020-11-23,Glenn,021,27897,961,853,38,891,4
2020-11-23,Humboldt,023,135768,889,746,2,748,9
2020-11-23,Imperial,025,180216,16222,15104,81,15185,355
2020-11-23,Inyo,027,18085,301,279,5,284,15
2020-11-23,Kern,029,883053,40827,38245,1072,39317,463
2020-11-23,Kings,031,150075,11034,10204,137,10341,85
2020-11-23,Lake,033,64148,965,840,0,840,18
2020-11-23,Lassen,035,31185,2093,1271,7,1278,0
2020-11-23,Los Angeles,037,10098052,389491,366374,5646,372020,7447
2020-11-23,Madera,039,155013,6379,5787,138,5925,56
2020-11-23,Marin,041,260295,7740,7543,28,7571,135
2020-11-23,Mariposa,043,17540,125,97,1,98,2
2020-11-23,Mendocino,045,87422,1483,1330,6,1336,22
2020-11-23,Merced,047,269075,11726,11148,99,11247,169
2020-11-23,Modoc,049,8938,105,91,21,112,0
2020-11-23,Mono,051,14174,519,480,9,489,2
2020-11-23,Monterey,053,433212,15258,14265,254,14519,112
2020-11-23,Napa,055,140530,3212,2811,16,2827,17
2020-11-23,Nevada,057,99092,1307,1087,32,1119,9
2020-11-23,Orange,059,3164182,78536,71074,2315,73389,1546
2020-11-23,Placer,061,380077,7188,5999,133,6132,66
2020-11-23,Plumas,063,18699,214,172,0,172,0
2020-11-23,Riverside,065,2383286,90411,82175,1648,83823,1415
2020-11-23,Sacramento,067,1510023,37067,34141,119,34260,556
2020-11-23,San Benito,069,59416,1837,1729,11,1740,15
2020-11-23,San Bernardino,071,2135413,94965,84387,1465,85852,1224
2020-11-23,San Diego,073,3302833,80542,72817,2886,75703,968
2020-11-23,San Francisco,075,870044,15418,14646,91,14737,153
2020-11-23,San Joaquin,077,732212,26495,24622,482,25104,517
2020-11-23,San Luis Obispo,079,281455,6376,5772,98,5870,34
2020-11-23,San Mateo,081,765935,14404,13364,15,13379,170
2020-11-23,Santa Barbara,083,443738,11525,10944,197,11141,137
2020-11-23,Santa Clara,085,1922200,35039,31064,79,31143,435
2020-11-23,Santa Cruz,087,273765,4534,4003,53,4056,25
2020-11-23,Shasta,089,179085,5290,4100,160,4260,43
2020-11-23,Sierra,091,2930,17,15,0,15,0
2020-11-23,Siskiyou,093,43540,622,460,28,488,0
2020-11-23,Solano,095,438530,10391,9394,63,9457,86
2020-11-23,Sonoma,097,501317,12285,11507,50,11557,160
2020-11-23,Stanislaus,099,539301,21843,20487,1323,21810,436
2020-11-23,Sutter,101,95872,3326,2840,10,2850,14
2020-11-23,Tehama,103,63373,1674,1526,21,1547,9
2020-11-23,Trinity,105,12862,260,120,22,142,0
2020-11-23,Tulare,107,460477,21500,19818,1284,21102,315
2020-11-23,Tuolumne,109,53932,1029,774,7,781,7
2020-11-23,Ventura,111,848112,20046,18480,618,19098,179
2020-11-23,Yolo,113,214977,4910,4265,15,4280,75
2020-11-23,Yuba,115,75493,1969,1702,9,1711,10
2020-11-22,Alameda,001,1643700,29477,27472,304,27776,444
2020-11-22,Alpine,003,1148,46,41,0,41,0
2020-11-22,Amador,005,37829,501,450,1,451,16
2020-11-22,Butte,007,227075,4037,3712,192,3904,61
2020-11-22,Calaveras,009,45235,473,434,0,434,21
2020-11-22,Colusa,011,21464,722,642,3,645,6
2020-11-22,Contra Costa,013,1133247,23921,22407,144,22551,260
2020-11-22,Del Norte,015,27424,311,271,0,271,2
2020-11-22,El Dorado,017,186661,2487,1917,34,1951,4
2020-11-22,Fresno,019,978130,41266,36315,1233,37548,488
2020-11-22,Glenn,021,27897,939,832,34,866,4
2020-11-22,Humboldt,023,135768,873,729,2,731,9
2020-11-22,Imperial,025,180216,16016,15109,36,15145,355
2020-11-22,Inyo,027,18085,295,279,5,284,15
2020-11-22,Kern,029,883053,40248,37904,1039,38943,463
2020-11-22,Kings,031,150075,10935,10035,128,10163,85
2020-11-22,Lake,033,64148,943,834,0,834,18
2020-11-22,Lassen,035,31185,1928,1211,6,1217,0
2020-11-22,Los Angeles,037,10098052,383211,360341,5402,365743,7438
2020-11-22,Madera,039,155013,6299,5745,127,5872,56
2020-11-22,Marin,041,260295,7705,7506,27,7533,135
2020-11-22,Mariposa,043,17540,124,95,1,96,2
2020-11-22,Mendocino,045,87422,1459,1285,5,1290,22
2020-11-22,Merced,047,269075,11577,10939,99,11038,169
2020-11-22,Modoc,049,8938,104,87,19,106,0
2020-11-22,Mono,051,14174,504,481,9,490,2
2020-11-22,Monterey,053,433212,15017,13887,249,14136,111
2020-11-22,Napa,055,140530,3131,2778,16,2794,17
2020-11-22,Nevada,057,99092,1249,1052,32,1084,9
2020-11-22,Orange,059,3164182,77124,69913,2277,72190,1546
2020-11-22,Placer,061,380077,6961,5880,123,6003,66
2020-11-22,Plumas,063,18699,201,172,0,172,0
2020-11-22,Riverside,065,2383286,88816,81565,1589,83154,1409
2020-11-22,Sacramento,067,1510023,36335,33421,106,33527,555
2020-11-22,San Benito,069,59416,1808,1704,11,1715,15
2020-11-22,San Bernardino,071,2135413,92624,83505,1395,84900,1224
2020-11-22,San Diego,073,3302833,78805,71649,2811,74460,968
2020-11-22,San Francisco,075,870044,15247,14515,90,14605,153
2020-11-22,San Joaquin,077,732212,26196,24619,470,25089,517
2020-11-22,San Luis Obispo,079,281455,6269,5664,97,5761,34
2020-11-22,San Mateo,081,765935,14199,13228,15,13243,170
2020-11-22,Santa Barbara,083,443738,11390,10946,192,11138,137
2020-11-22,Santa Clara,085,1922200,34361,30633,77,30710,434
2020-11-22,Santa Cruz,087,273765,4452,3896,46,3942,25
2020-11-22,Shasta,089,179085,5134,4100,142,4242,43
2020-11-22,Sierra,091,2930,17,13,0,13,0
2020-11-22,Siskiyou,093,43540,591,411,28,439,0
2020-11-22,Solano,095,438530,10219,9363,59,9422,86
2020-11-22,Sonoma,097,501317,12127,11415,48,11463,159
2020-11-22,Stanislaus,099,539301,21516,20223,1293,21516,436
2020-11-22,Sutter,101,95872,3209,2677,10,2687,13
2020-11-22,Tehama,103,63373,1640,1457,17,1474,9
2020-11-22,Trinity,105,12862,254,114,22,136,0
2020-11-22,Tulare,107,460477,21247,19818,1218,21036,314
2020-11-22,Tuolumne,109,53932,1003,689,7,696,7
2020-11-22,Ventura,111,848112,19685,18105,605,18710,179
2020-11-22,Yolo,113,214977,4810,4206,15,4221,75
2020-11-22,Yuba,115,75493,1916,1672,9,1681,10
2020-11-21,Alameda,001,1643700,29290,27424,302,27726,444
2020-11-21,Alpine,003,1148,46,41,0,41,0
2020-11-21,Amador,005,37829,487,450,1,451,16
2020-11-21,Butte,007,227075,3989,3664,189,3853,61
2020-11-21,Calaveras,009,45235,465,434,0,434,21
2020-11-21,Colusa,011,21464,713,642,3,645,6
2020-11-21,Contra Costa,013,1133247,23769,22338,142,22480,260
2020-11-21,Del Norte,015,27424,306,271,0,271,2
2020-11-21,El Dorado,017,186661,2438,1900,33,1933,4
2020-11-21,Fresno,019,978130,41010,35973,1199,37172,482
2020-11-21,Glenn,021,27897,934,829,32,861,4
2020-11-21,Humboldt,023,135768,863,728,2,730,9
2020-11-21,Imperial,025,180216,15939,15053,36,15089,355
2020-11-21,Inyo,027,18085,293,283,5,288,15
2020-11-21,Kern,029,883053,39992,37403,1004,38407,463
2020-11-21,Kings,031,150075,10887,10019,124,10143,85
2020-11-21,Lake,033,64148,930,832,0,832,18
2020-11-21,Lassen,035,31185,1861,1211,6,1217,0
2020-11-21,Los Angeles,037,10098052,380027,357754,5261,363015,7428
2020-11-21,Madera,039,155013,6262,5706,127,5833,56
2020-11-21,Marin,041,260295,7682,7488,26,7514,134
2020-11-21,Mariposa,043,17540,124,92,1,93,2
2020-11-21,Mendocino,045,87422,1428,1282,5,1287,22
2020-11-21,Merced,047,269075,11516,10849,98,10947,169
2020-11-21,Modoc,049,8938,100,87,18,105,0
2020-11-21,Mono,051,14174,499,469,9,478,2
2020-11-21,Monterey,053,433212,14919,13886,244,14130,110
2020-11-21,Napa,055,140530,3097,2757,16,2773,17
2020-11-21,Nevada,057,99092,1237,1018,31,1049,9
2020-11-21,Orange,059,3164182,76322,69021,2247,71268,1543
2020-11-21,Placer,061,380077,6847,5778,120,5898,65
2020-11-21,Plumas,063,18699,196,172,0,172,0
2020-11-21,Riverside,065,2383286,88040,80676,1543,82219,1407
2020-11-21,Sacramento,067,1510023,35939,33133,98,33231,548
2020-11-21,San Benito,069,59416,1789,1691,11,1702,15
2020-11-21,San Bernardino,071,2135413,91749,83206,1319,84525,1222
2020-11-21,San Diego,073,3302833,78026,70711,2756,73467,966
2020-11-21,San Francisco,075,870044,15144,14445,89,14534,153
2020-11-21,San Joaquin,077,732212,26063,24620,455,25075,517
2020-11-21,San Luis Obispo,079,281455,6216,5618,94,5712,34
2020-11-21,San Mateo,081,765935,14098,13138,15,13153,170
2020-11-21,Santa Barbara,083,443738,11338,10922,189,11111,137
2020-11-21,Santa Clara,085,1922200,33977,30377,74,30451,433
2020-11-21,Santa Cruz,087,273765,4395,3898,46,3944,25
2020-11-21,Shasta,089,179085,5060,4095,139,4234,42
2020-11-21,Sierra,091,2930,17,13,0,13,0
2020-11-21,Siskiyou,093,43540,575,403,28,431,0
2020-11-21,Solano,095,438530,10129,9290,56,9346,86
2020-11-21,Sonoma,097,501317,12052,11394,47,11441,158
2020-11-21,Stanislaus,099,539301,21373,20111,1269,21380,435
2020-11-21,Sutter,101,95872,3149,2615,9,2624,13
2020-11-21,Tehama,103,63373,1620,1435,16,1451,9
2020-11-21,Trinity,105,12862,251,110,22,132,0
2020-11-21,Tulare,107,460477,21121,19752,1184,20936,313
2020-11-21,Tuolumne,109,53932,984,690,7,697,7
2020-11-21,Ventura,111,848112,19522,18040,595,18635,177
2020-11-21,Yolo,113,214977,4736,4147,14,4161,75
2020-11-21,Yuba,115,75493,1884,1643,9,1652,10
2020-11-20,Alameda,001,1643700,29076,27221,295,27516,444
2020-11-20,Alpine,003,1148,46,20,0,20,0
2020-11-20,Amador,005,37829,483,446,1,447,16
2020-11-20,Butte,007,227075,3957,3618,185,3803,60
2020-11-20,Calaveras,009,45235,455,424,0,424,21
2020-11-20,Colusa,011,21464,705,631,2,633,6
2020-11-20,Contra Costa,013,1133247,23582,22116,138,22254,260
2020-11-20,Del Norte,015,27424,302,264,0,264,2
2020-11-20,El Dorado,017,186661,2342,1868,31,1899,4
2020-11-20,Fresno,019,978130,40716,35635,1170,36805,480
2020-11-20,Glenn,021,27897,922,826,30,856,4
2020-11-20,Humboldt,023,135768,854,714,1,715,9
2020-11-20,Imperial,025,180216,15877,14864,32,14896,353
2020-11-20,Inyo,027,18085,291,262,5,267,15
2020-11-20,Kern,029,883053,39698,37143,979,38122,462
2020-11-20,Kings,031,150075,10839,9903,123,10026,85
2020-11-20,Lake,033,64148,921,820,0,820,18
2020-11-20,Lassen,035,31185,1776,1212,5,1217,0
2020-11-20,Los Angeles,037,10098052,376131,353554,5099,358653,7398
2020-11-20,Madera,039,155013,6168,5635,126,5761,54
2020-11-20,Marin,041,260295,7658,7467,25,7492,134
2020-11-20,Mariposa,043,17540,116,89,1,90,2
2020-11-20,Mendocino,045,87422,1408,1269,5,1274,22
2020-11-20,Merced,047,269075,11430,10729,98,10827,167
2020-11-20,Modoc,049,8938,100,83,18,101,0
2020-11-20,Mono,051,14174,497,469,9,478,2
2020-11-20,Monterey,053,433212,14794,13738,235,13973,110
2020-11-20,Napa,055,140530,3067,2718,16,2734,17
2020-11-20,Nevada,057,99092,1219,990,30,1020,9
2020-11-20,Orange,059,3164182,75487,68212,2210,70422,1532
2020-11-20,Placer,061,380077,6712,5687,105,5792,66
2020-11-20,Plumas,063,18699,194,163,0,163,0
2020-11-20,Riverside,065,2383286,87029,79613,1483,81096,1405
2020-11-20,Sacramento,067,1510023,35563,32832,91,32923,549
2020-11-20,San Benito,069,59416,1777,1668,11,1679,15
2020-11-20,San Bernardino,071,2135413,90380,81203,1237,82440,1220
2020-11-20,San Diego,073,3302833,77028,69233,2674,71907,960
2020-11-20,San Francisco,075,870044,15041,14327,88,14415,153
2020-11-20,San Joaquin,077,732212,25909,24460,442,24902,515
2020-11-20,San Luis Obispo,079,281455,6161,5524,91,5615,34
2020-11-20,San Mateo,081,765935,13965,12980,14,12994,169
2020-11-20,Santa Barbara,083,443738,11282,10825,183,11008,136
2020-11-20,Santa Clara,085,1922200,33556,30002,69,30071,431
2020-11-20,Santa Cruz,087,273765,4329,3815,46,3861,25
2020-11-20,Shasta,089,179085,4987,3861,134,3995,42
2020-11-20,Sierra,091,2930,17,12,0,12,0
2020-11-20,Siskiyou,093,43540,561,387,27,414,0
2020-11-20,Solano,095,438530,10037,9216,54,9270,85
2020-11-20,Sonoma,097,501317,11968,11316,46,11362,158
2020-11-20,Stanislaus,099,539301,21218,19889,1243,21132,433
2020-11-20,Sutter,101,95872,3099,2580,9,2589,13
2020-11-20,Tehama,103,63373,1604,1410,13,1423,9
2020-11-20,Trinity,105,12862,250,102,22,124,0
2020-11-20,Tulare,107,460477,20988,19568,1146,20714,311
2020-11-20,Tuolumne,109,53932,945,662,7,669,7
2020-11-20,Ventura,111,848112,19354,17741,568,18309,175
2020-11-20,Yolo,113,214977,4658,4081,13,4094,74
2020-11-20,Yuba,115,75493,1856,1611,9,1620,10
2020-11-19,Alameda,001,1643700,28731,26971,287,27258,441
2020-11-19,Alpine,003,1148,43,20,0,20,0
2020-11-19,Amador,005,37829,479,436,1,437,16
2020-11-19,Butte,007,227075,3908,3576,178,3754,60
2020-11-19,Calaveras,009,45235,444,417,0,417,21
2020-11-19,Colusa,011,21464,687,621,2,623,6
2020-11-19,Contra Costa,013,1133247,23310,21886,135,22021,259
2020-11-19,Del Norte,015,27424,294,251,0,251,2
2020-11-19,El Dorado,017,186661,2268,1825,27,1852,4
2020-11-19,Fresno,019,978130,40267,35278,1114,36392,478
2020-11-19,Glenn,021,27897,900,806,29,835,4
2020-11-19,Humboldt,023,135768,834,693,1,694,9
2020-11-19,Imperial,025,180216,15668,14507,32,14539,349
2020-11-19,Inyo,027,18085,289,262,5,267,15
2020-11-19,Kern,029,883053,39278,36779,937,37716,459
2020-11-19,Kings,031,150075,10691,9763,116,9879,85
2020-11-19,Lake,033,64148,907,809,0,809,18
2020-11-19,Lassen,035,31185,1659,1201,3,1204,0
2020-11-19,Los Angeles,037,10098052,371106,349493,4933,354426,7365
2020-11-19,Madera,039,155013,6097,5540,118,5658,54
2020-11-19,Marin,041,260295,7627,7451,25,7476,134
2020-11-19,Mariposa,043,17540,109,88,0,88,2
2020-11-19,Mendocino,045,87422,1387,1237,5,1242,23
2020-11-19,Merced,047,269075,11289,10634,92,10726,167
2020-11-19,Modoc,049,8938,97,82,18,100,0
2020-11-19,Mono,051,14174,489,468,9,477,2
2020-11-19,Monterey,053,433212,14580,13369,224,13593,108
2020-11-19,Napa,055,140530,3013,2641,16,2657,17
2020-11-19,Nevada,057,99092,1178,945,29,974,9
2020-11-19,Orange,059,3164182,74223,66998,2167,69165,1530
2020-11-19,Placer,061,380077,6521,5612,104,5716,65
2020-11-19,Plumas,063,18699,189,158,0,158,0
2020-11-19,Riverside,065,2383286,85546,78535,1412,79947,1402
2020-11-19,Sacramento,067,1510023,35049,32367,89,32456,546
2020-11-19,San Benito,069,59416,1754,1643,11,1654,15
2020-11-19,San Bernardino,071,2135413,88481,79244,1159,80403,1215
2020-11-19,San Diego,073,3302833,75778,68142,2570,70712,952
2020-11-19,San Francisco,075,870044,14884,14178,82,14260,153
2020-11-19,San Joaquin,077,732212,25590,24270,432,24702,516
2020-11-19,San Luis Obispo,079,281455,6084,5410,87,5497,34
2020-11-19,San Mateo,081,765935,13827,12714,14,12728,169
2020-11-19,Santa Barbara,083,443738,11202,10741,180,10921,136
2020-11-19,Santa Clara,085,1922200,32999,29630,68,29698,424
2020-11-19,Santa Cruz,087,273765,4239,3679,44,3723,25
2020-11-19,Shasta,089,179085,4849,3685,124,3809,42
2020-11-19,Sierra,091,2930,17,11,0,11,0
2020-11-19,Siskiyou,093,43540,536,360,26,386,0
2020-11-19,Solano,095,438530,9900,9093,50,9143,84
2020-11-19,Sonoma,097,501317,11798,11205,44,11249,156
2020-11-19,Stanislaus,099,539301,20977,19736,1201,20937,433
2020-11-19,Sutter,101,95872,3000,2509,9,2518,13
2020-11-19,Tehama,103,63373,1570,1373,10,1383,9
2020-11-19,Trinity,105,12862,244,97,22,119,0
2020-11-19,Tulare,107,460477,20766,19384,1083,20467,304
2020-11-19,Tuolumne,109,53932,913,602,7,609,7
2020-11-19,Ventura,111,848112,19001,17300,555,17855,174
2020-11-19,Yolo,113,214977,4564,3973,13,3986,72
2020-11-19,Yuba,115,75493,1816,1568,9,1577,10
2020-11-18,Alameda,001,1643700,28466,26610,282,26892,440
2020-11-18,Alpine,003,1148,42,16,0,16,0
2020-11-18,Amador,005,37829,474,430,1,431,16
2020-11-18,Butte,007,227075,3855,3537,165,3702,59
2020-11-18,Calaveras,009,45235,438,409,0,409,21
2020-11-18,Colusa,011,21464,674,611,2,613,6
2020-11-18,Contra Costa,013,1133247,23045,21685,132,21817,258
2020-11-18,Del Norte,015,27424,281,240,0,240,2
2020-11-18,El Dorado,017,186661,2180,1799,26,1825,4
2020-11-18,Fresno,019,978130,39828,34997,1065,36062,474
2020-11-18,Glenn,021,27897,883,803,27,830,4
2020-11-18,Humboldt,023,135768,820,690,1,691,9
2020-11-18,Imperial,025,180216,15445,14428,32,14460,348
2020-11-18,Inyo,027,18085,287,262,5,267,15
2020-11-18,Kern,029,883053,38889,36537,888,37425,456
2020-11-18,Kings,031,150075,10543,9696,113,9809,85
2020-11-18,Lake,033,64148,894,802,0,802,18
2020-11-18,Lassen,035,31185,1559,1124,3,1127,0
2020-11-18,Los Angeles,037,10098052,366231,344675,4753,349428,7338
2020-11-18,Madera,039,155013,6010,5519,106,5625,54
2020-11-18,Marin,041,260295,7603,7435,25,7460,134
2020-11-18,Mariposa,043,17540,106,88,0,88,2
2020-11-18,Mendocino,045,87422,1367,1237,5,1242,23
2020-11-18,Merced,047,269075,11173,10536,91,10627,166
2020-11-18,Modoc,049,8938,94,77,18,95,0
2020-11-18,Mono,051,14174,484,468,9,477,2
2020-11-18,Monterey,053,433212,14385,13340,210,13550,108
2020-11-18,Napa,055,140530,2967,2607,16,2623,17
2020-11-18,Nevada,057,99092,1138,933,27,960,9
2020-11-18,Orange,059,3164182,73129,66381,2142,68523,1521
2020-11-18,Placer,061,380077,6343,5543,99,5642,64
2020-11-18,Plumas,063,18699,184,143,0,143,0
2020-11-18,Riverside,065,2383286,84082,77739,1311,79050,1387
2020-11-18,Sacramento,067,1510023,34424,31816,81,31897,541
2020-11-18,San Benito,069,59416,1729,1632,10,1642,15
2020-11-18,San Bernardino,071,2135413,86722,77400,1079,78479,1206
2020-11-18,San Diego,073,3302833,74484,67243,2510,69753,945
2020-11-18,San Francisco,075,870044,14740,14057,80,14137,153
2020-11-18,San Joaquin,077,732212,25327,24146,418,24564,517
2020-11-18,San Luis Obispo,079,281455,6008,5322,86,5408,34
2020-11-18,San Mateo,081,765935,13674,12631,13,12644,169
2020-11-18,Santa Barbara,083,443738,11123,10684,173,10857,136
2020-11-18,Santa Clara,085,1922200,32533,29285,64,29349,421
2020-11-18,Santa Cruz,087,273765,4149,3618,42,3660,25
2020-11-18,Shasta,089,179085,4715,3547,120,3667,42
2020-11-18,Sierra,091,2930,17,11,0,11,0
2020-11-18,Siskiyou,093,43540,504,351,25,376,0
2020-11-18,Solano,095,438530,9768,8994,48,9042,84
2020-11-18,Sonoma,097,501317,11691,11129,41,11170,155
2020-11-18,Stanislaus,099,539301,20735,19609,1177,20786,431
2020-11-18,Sutter,101,95872,2882,2442,9,2451,13
2020-11-18,Tehama,103,63373,1531,1338,10,1348,8
2020-11-18,Trinity,105,12862,230,95,21,116,0
2020-11-18,Tulare,107,460477,20556,19286,1032,20318,306
2020-11-18,Tuolumne,109,53932,878,590,7,597,7
2020-11-18,Ventura,111,848112,18676,17169,540,17709,173
2020-11-18,Yolo,113,214977,4490,3929,13,3942,71
2020-11-18,Yuba,115,75493,1762,1540,9,1549,10
2020-11-17,Alameda,001,1643700,28140,26425,272,26697,439
2020-11-17,Alpine,003,1148,40,12,0,12,0
2020-11-17,Amador,005,37829,463,423,1,424,16
2020-11-17,Butte,007,227075,3813,3500,155,3655,59
2020-11-17,Calaveras,009,45235,421,405,0,405,21
2020-11-17,Colusa,011,21464,663,606,1,607,6
2020-11-17,Contra Costa,013,1133247,22773,21557,127,21684,256
2020-11-17,Del Norte,015,27424,275,233,0,233,2
2020-11-17,El Dorado,017,186661,2121,1758,26,1784,4
2020-11-17,Fresno,019,978130,39230,34765,1006,35771,472
2020-11-17,Glenn,021,27897,872,795,26,821,4
2020-11-17,Humboldt,023,135768,798,685,1,686,9
2020-11-17,Imperial,025,180216,15208,14204,30,14234,346
2020-11-17,Inyo,027,18085,286,263,5,268,15
2020-11-17,Kern,029,883053,38439,36164,835,36999,455
2020-11-17,Kings,031,150075,10470,9653,106,9759,85
2020-11-17,Lake,033,64148,874,792,0,792,18
2020-11-17,Lassen,035,31185,1480,1124,3,1127,0
2020-11-17,Los Angeles,037,10098052,361279,340933,4595,345528,7302
2020-11-17,Madera,039,155013,5921,5485,99,5584,54
2020-11-17,Marin,041,260295,7571,7404,24,7428,134
2020-11-17,Mariposa,043,17540,103,87,0,87,2
2020-11-17,Mendocino,045,87422,1346,1216,5,1221,23
2020-11-17,Merced,047,269075,11029,10457,85,10542,162
2020-11-17,Modoc,049,8938,88,71,17,88,0
2020-11-17,Mono,051,14174,479,459,9,468,2
2020-11-17,Monterey,053,433212,14156,13220,200,13420,108
2020-11-17,Napa,055,140530,2913,2568,16,2584,17
2020-11-17,Nevada,057,99092,1097,918,26,944,9
2020-11-17,Orange,059,3164182,71978,65757,2115,67872,1519
2020-11-17,Placer,061,380077,6181,5435,93,5528,63
2020-11-17,Plumas,063,18699,176,142,0,142,0
2020-11-17,Riverside,065,2383286,82696,77079,1220,78299,1379
2020-11-17,Sacramento,067,1510023,33825,31341,77,31418,538
2020-11-17,San Benito,069,59416,1713,1611,4,1615,15
2020-11-17,San Bernardino,071,2135413,84913,76134,990,77124,1188
2020-11-17,San Diego,073,3302833,73231,66321,2454,68775,933
2020-11-17,San Francisco,075,870044,14574,13952,79,14031,153
2020-11-17,San Joaquin,077,732212,25054,23997,398,24395,516
2020-11-17,San Luis Obispo,079,281455,5912,5235,86,5321,34
2020-11-17,San Mateo,081,765935,13513,12491,12,12503,169
2020-11-17,Santa Barbara,083,443738,11038,10597,168,10765,136
2020-11-17,Santa Clara,085,1922200,31986,29013,63,29076,419
2020-11-17,Santa Cruz,087,273765,4063,3548,39,3587,25
2020-11-17,Shasta,089,179085,4557,3457,108,3565,40
2020-11-17,Sierra,091,2930,15,11,0,11,0
2020-11-17,Siskiyou,093,43540,456,333,24,357,0
2020-11-17,Solano,095,438530,9623,8905,47,8952,84
2020-11-17,Sonoma,097,501317,11557,11084,40,11124,155
2020-11-17,Stanislaus,099,539301,20511,19466,1150,20616,425
2020-11-17,Sutter,101,95872,2799,2370,8,2378,12
2020-11-17,Tehama,103,63373,1481,1290,10,1300,7
2020-11-17,Trinity,105,12862,213,83,21,104,0
2020-11-17,Tulare,107,460477,20326,19176,971,20147,305
2020-11-17,Tuolumne,109,53932,840,568,7,575,7
2020-11-17,Ventura,111,848112,18404,16797,522,17319,173
2020-11-17,Yolo,113,214977,4313,3887,12,3899,70
2020-11-17,Yuba,115,75493,1714,1519,9,1528,10
2020-11-16,Alameda,001,1643700,27793,26063,267,26330,436
2020-11-16,Alpine,003,1148,37,12,0,12,0
2020-11-16,Amador,005,37829,455,414,1,415,16
2020-11-16,Butte,007,227075,3774,3490,147,3637,58
2020-11-16,Calaveras,009,45235,413,402,0,402,21
2020-11-16,Colusa,011,21464,654,601,1,602,6
2020-11-16,Contra Costa,013,1133247,22505,21386,122,21508,256
2020-11-16,Del Norte,015,27424,268,225,0,225,2
2020-11-16,El Dorado,017,186661,2061,1694,24,1718,4
2020-11-16,Fresno,019,978130,38741,34593,954,35547,471
2020-11-16,Glenn,021,27897,860,786,25,811,4
2020-11-16,Humboldt,023,135768,782,660,1,661,9
2020-11-16,Imperial,025,180216,14960,14111,30,14141,346
2020-11-16,Inyo,027,18085,283,263,5,268,15
2020-11-16,Kern,029,883053,38045,36049,792,36841,455
2020-11-16,Kings,031,150075,10203,9569,102,9671,85
2020-11-16,Lake,033,64148,862,784,0,784,18
2020-11-16,Lassen,035,31185,1299,1124,3,1127,0
2020-11-16,Los Angeles,037,10098052,356526,338778,4425,343203,7277
2020-11-16,Madera,039,155013,5834,5433,93,5526,54
2020-11-16,Marin,041,260295,7541,7359,24,7383,134
2020-11-16,Mariposa,043,17540,100,86,0,86,2
2020-11-16,Mendocino,045,87422,1321,1209,5,1214,23
2020-11-16,Merced,047,269075,10891,10399,82,10481,162
2020-11-16,Modoc,049,8938,86,71,17,88,0
2020-11-16,Mono,051,14174,477,453,9,462,2
2020-11-16,Monterey,053,433212,13910,13089,190,13279,107
2020-11-16,Napa,055,140530,2837,2536,16,2552,17
2020-11-16,Nevada,057,99092,1054,889,24,913,9
2020-11-16,Orange,059,3164182,70881,65396,2101,67497,1519
2020-11-16,Placer,061,380077,6062,5387,85,5472,63
2020-11-16,Plumas,063,18699,169,127,0,127,0
2020-11-16,Riverside,065,2383286,81323,76449,1156,77605,1379
2020-11-16,Sacramento,067,1510023,33187,30954,70,31024,534
2020-11-16,San Benito,069,59416,1695,1603,3,1606,15
2020-11-16,San Bernardino,071,2135413,83085,74401,924,75325,1186
2020-11-16,San Diego,073,3302833,71920,65603,2382,67985,926
2020-11-16,San Francisco,075,870044,14415,13847,76,13923,153
2020-11-16,San Joaquin,077,732212,24766,23515,388,23903,513
2020-11-16,San Luis Obispo,079,281455,5809,5161,82,5243,34
2020-11-16,San Mateo,081,765935,13353,12398,12,12410,169
2020-11-16,Santa Barbara,083,443738,10973,10565,164,10729,135
2020-11-16,Santa Clara,085,1922200,31421,28673,62,28735,419
2020-11-16,Santa Cruz,087,273765,3990,3520,39,3559,25
2020-11-16,Shasta,089,179085,4409,3284,103,3387,37
2020-11-16,Sierra,091,2930,15,11,0,11,0
2020-11-16,Siskiyou,093,43540,429,294,24,318,0
2020-11-16,Solano,095,438530,9424,8827,47,8874,84
2020-11-16,Sonoma,097,501317,11466,10961,39,11000,155
2020-11-16,Stanislaus,099,539301,20275,19333,1123,20456,425
2020-11-16,Sutter,101,95872,2693,2322,8,2330,12
2020-11-16,Tehama,103,63373,1435,1261,7,1268,7
2020-11-16,Trinity,105,12862,201,67,21,88,0
2020-11-16,Tulare,107,460477,20147,18891,918,19809,305
2020-11-16,Tuolumne,109,53932,804,543,7,550,7
2020-11-16,Ventura,111,848112,18066,16691,514,17205,172
2020-11-16,Yolo,113,214977,4218,3858,12,3870,70
2020-11-16,Yuba,115,75493,1678,1500,8,1508,10
2020-11-15,Alameda,001,1643700,27475,25879,262,26141,436
2020-11-15,Alpine,003,1148,35,12,0,12,0
2020-11-15,Amador,005,37829,443,409,1,410,16
2020-11-15,Butte,007,227075,3720,3452,138,3590,58
2020-11-15,Calaveras,009,45235,398,386,0,386,21
2020-11-15,Colusa,011,21464,645,601,1,602,6
2020-11-15,Contra Costa,013,1133247,22205,21179,121,21300,256
2020-11-15,Del Norte,015,27424,254,224,0,224,2
2020-11-15,El Dorado,017,186661,1999,1683,23,1706,4
2020-11-15,Fresno,019,978130,38228,34297,916,35213,471
2020-11-15,Glenn,021,27897,848,783,24,807,4
2020-11-15,Humboldt,023,135768,754,653,1,654,9
2020-11-15,Imperial,025,180216,14723,13940,30,13970,346
2020-11-15,Inyo,027,18085,273,263,5,268,15
2020-11-15,Kern,029,883053,37639,35911,757,36668,455
2020-11-15,Kings,031,150075,10010,9533,99,9632,85
2020-11-15,Lake,033,64148,853,777,0,777,17
2020-11-15,Lassen,035,31185,1252,1124,3,1127,0
2020-11-15,Los Angeles,037,10098052,351478,336035,4257,340292,7271
2020-11-15,Madera,039,155013,5737,5391,87,5478,54
2020-11-15,Marin,041,260295,7515,7347,24,7371,133
2020-11-15,Mariposa,043,17540,97,86,0,86,2
2020-11-15,Mendocino,045,87422,1302,1197,5,1202,22
2020-11-15,Merced,047,269075,10758,10350,82,10432,162
2020-11-15,Modoc,049,8938,85,68,17,85,0
2020-11-15,Mono,051,14174,475,453,9,462,2
2020-11-15,Monterey,053,433212,13714,12999,177,13176,107
2020-11-15,Napa,055,140530,2778,2509,14,2523,17
2020-11-15,Nevada,057,99092,999,859,24,883,9
2020-11-15,Orange,059,3164182,69838,65008,2085,67093,1519
2020-11-15,Placer,061,380077,5907,5330,77,5407,63
2020-11-15,Plumas,063,18699,163,127,0,127,0
2020-11-15,Riverside,065,2383286,80002,75531,1098,76629,1374
2020-11-15,Sacramento,067,1510023,32561,30601,65,30666,534
2020-11-15,San Benito,069,59416,1670,1589,2,1591,15
2020-11-15,San Bernardino,071,2135413,80936,73769,849,74618,1185
2020-11-15,San Diego,073,3302833,70419,64770,2325,67095,926
2020-11-15,San Francisco,075,870044,14240,13757,75,13832,153
2020-11-15,San Joaquin,077,732212,24557,23516,373,23889,513
2020-11-15,San Luis Obispo,079,281455,5688,5120,80,5200,34
2020-11-15,San Mateo,081,765935,13176,12348,12,12360,169
2020-11-15,Santa Barbara,083,443738,10878,10516,162,10678,135
2020-11-15,Santa Clara,085,1922200,30967,28289,61,28350,418
2020-11-15,Santa Cruz,087,273765,3851,3439,38,3477,25
2020-11-15,Shasta,089,179085,4236,3290,94,3384,37
2020-11-15,Sierra,091,2930,15,11,0,11,0
2020-11-15,Siskiyou,093,43540,410,294,24,318,0
2020-11-15,Solano,095,438530,9263,8713,44,8757,84
2020-11-15,Sonoma,097,501317,11348,10833,38,10871,154
2020-11-15,Stanislaus,099,539301,20003,19228,1098,20326,425
2020-11-15,Sutter,101,95872,2603,2230,8,2238,12
2020-11-15,Tehama,103,63373,1384,1222,6,1228,7
2020-11-15,Trinity,105,12862,191,67,19,86,0
2020-11-15,Tulare,107,460477,19930,18891,866,19757,305
2020-11-15,Tuolumne,109,53932,762,486,7,493,7
2020-11-15,Ventura,111,848112,17792,16564,506,17070,172
2020-11-15,Yolo,113,214977,4115,3819,12,3831,67
2020-11-15,Yuba,115,75493,1637,1470,7,1477,10
2020-11-14,Alameda,001,1643700,27208,25714,260,25974,435
2020-11-14,Alpine,003,1148,35,12,0,12,0
2020-11-14,Amador,005,37829,434,404,0,404,16
2020-11-14,Butte,007,227075,3684,3434,124,3558,58
2020-11-14,Calaveras,009,45235,397,386,0,386,21
2020-11-14,Colusa,011,21464,633,601,1,602,6
2020-11-14,Contra Costa,013,1133247,22066,20975,114,21089,256
2020-11-14,Del Norte,015,27424,247,219,0,219,2
2020-11-14,El Dorado,017,186661,1955,1648,23,1671,4
2020-11-14,Fresno,019,978130,37978,33969,880,34849,471
2020-11-14,Glenn,021,27897,839,772,21,793,3
2020-11-14,Humboldt,023,135768,739,643,1,644,9
2020-11-14,Imperial,025,180216,14630,13932,29,13961,346
2020-11-14,Inyo,027,18085,272,263,5,268,15
2020-11-14,Kern,029,883053,37429,35626,738,36364,454
2020-11-14,Kings,031,150075,9975,9490,96,9586,85
2020-11-14,Lake,033,64148,844,773,0,773,17
2020-11-14,Lassen,035,31185,1238,833,3,836,0
2020-11-14,Los Angeles,037,10098052,348772,333021,4148,337169,7269
2020-11-14,Madera,039,155013,5707,5371,85,5456,54
2020-11-14,Marin,041,260295,7499,7325,24,7349,133
2020-11-14,Mariposa,043,17540,96,86,0,86,2
2020-11-14,Mendocino,045,87422,1286,1181,5,1186,22
2020-11-14,Merced,047,269075,10702,10286,80,10366,161
2020-11-14,Modoc,049,8938,84,64,16,80,0
2020-11-14,Mono,051,14174,475,453,9,462,2
2020-11-14,Monterey,053,433212,13618,12854,167,13021,105
2020-11-14,Napa,055,140530,2744,2473,14,2487,17
2020-11-14,Nevada,057,99092,983,835,24,859,9
2020-11-14,Orange,059,3164182,69217,64340,2074,66414,1517
2020-11-14,Placer,061,380077,5831,5215,71,5286,63
2020-11-14,Plumas,063,18699,158,128,0,128,0
2020-11-14,Riverside,065,2383286,79262,74910,1059,75969,1373
2020-11-14,Sacramento,067,1510023,32236,30298,65,30363,532
2020-11-14,San Benito,069,59416,1655,1573,2,1575,15
2020-11-14,San Bernardino,071,2135413,80002,72868,819,73687,1184
2020-11-14,San Diego,073,3302833,69654,63715,2273,65988,926
2020-11-14,San Francisco,075,870044,14152,13661,74,13735,153
2020-11-14,San Joaquin,077,732212,24465,23516,366,23882,511
2020-11-14,San Luis Obispo,079,281455,5625,5073,75,5148,34
2020-11-14,San Mateo,081,765935,13068,12293,12,12305,169
2020-11-14,Santa Barbara,083,443738,10824,10482,160,10642,135
2020-11-14,Santa Clara,085,1922200,30681,27962,59,28021,416
2020-11-14,Santa Cruz,087,273765,3796,3402,38,3440,25
2020-11-14,Shasta,089,179085,4155,3195,92,3287,37
2020-11-14,Sierra,091,2930,15,11,0,11,0
2020-11-14,Siskiyou,093,43540,397,292,24,316,0
2020-11-14,Solano,095,438530,9183,8655,44,8699,84
2020-11-14,Sonoma,097,501317,11295,10769,38,10807,154
2020-11-14,Stanislaus,099,539301,19860,19068,1076,20144,424
2020-11-14,Sutter,101,95872,2558,2182,8,2190,12
2020-11-14,Tehama,103,63373,1363,1206,5,1211,7
2020-11-14,Trinity,105,12862,186,67,19,86,0
2020-11-14,Tulare,107,460477,19835,18853,838,19691,305
2020-11-14,Tuolumne,109,53932,734,448,7,455,7
2020-11-14,Ventura,111,848112,17646,16297,495,16792,172
2020-11-14,Yolo,113,214977,4072,3765,10,3775,65
2020-11-14,Yuba,115,75493,1608,1453,7,1460,10
2020-11-13,Alameda,001,1643700,26992,25515,255,25770,434
2020-11-13,Alpine,003,1148,35,12,0,12,0
2020-11-13,Amador,005,37829,431,397,0,397,16
2020-11-13,Butte,007,227075,3660,3402,115,3517,58
2020-11-13,Calaveras,009,45235,393,378,0,378,21
2020-11-13,Colusa,011,21464,625,598,1,599,6
2020-11-13,Contra Costa,013,1133247,21893,20799,114,20913,256
2020-11-13,Del Norte,015,27424,244,208,0,208,2
2020-11-13,El Dorado,017,186661,1910,1611,22,1633,4
2020-11-13,Fresno,019,978130,37732,33693,866,34559,470
2020-11-13,Glenn,021,27897,825,755,17,772,3
2020-11-13,Humboldt,023,135768,724,638,1,639,9
2020-11-13,Imperial,025,180216,14560,13790,28,13818,341
2020-11-13,Inyo,027,18085,271,262,5,267,15
2020-11-13,Kern,029,883053,37227,35431,721,36152,453
2020-11-13,Kings,031,150075,9916,9428,95,9523,85
2020-11-13,Lake,033,64148,838,770,0,770,17
2020-11-13,Lassen,035,31185,1229,832,3,835,0
2020-11-13,Los Angeles,037,10098052,345645,329364,4044,333408,7248
2020-11-13,Madera,039,155013,5667,5340,84,5424,54
2020-11-13,Marin,041,260295,7486,7307,23,7330,133
2020-11-13,Mariposa,043,17540,94,86,0,86,2
2020-11-13,Mendocino,045,87422,1274,1173,5,1178,22
2020-11-13,Merced,047,269075,10646,10185,77,10262,159
2020-11-13,Modoc,049,8938,84,63,14,77,0
2020-11-13,Mono,051,14174,475,448,8,456,2
2020-11-13,Monterey,053,433212,13423,12681,155,12836,104
2020-11-13,Napa,055,140530,2705,2440,14,2454,17
2020-11-13,Nevada,057,99092,964,798,24,822,9
2020-11-13,Orange,059,3164182,68619,63804,2054,65858,1514
2020-11-13,Placer,061,380077,5726,5122,65,5187,63
2020-11-13,Plumas,063,18699,152,125,0,125,0
2020-11-13,Riverside,065,2383286,78524,74138,1030,75168,1372
2020-11-13,Sacramento,067,1510023,31918,29787,60,29847,524
2020-11-13,San Benito,069,59416,1643,1553,1,1554,15
2020-11-13,San Bernardino,071,2135413,78952,71895,798,72693,1184
2020-11-13,San Diego,073,3302833,68807,62978,2235,65213,921
2020-11-13,San Francisco,075,870044,14059,13516,72,13588,146
2020-11-13,San Joaquin,077,732212,24370,23314,360,23674,510
2020-11-13,San Luis Obispo,079,281455,5558,4960,72,5032,34
2020-11-13,San Mateo,081,765935,12975,12182,12,12194,169
2020-11-13,Santa Barbara,083,443738,10772,10405,158,10563,134
2020-11-13,Santa Clara,085,1922200,30353,27609,57,27666,415
2020-11-13,Santa Cruz,087,273765,3722,3343,38,3381,25
2020-11-13,Shasta,089,179085,4071,2983,88,3071,37
2020-11-13,Sierra,091,2930,15,11,0,11,0
2020-11-13,Siskiyou,093,43540,392,280,23,303,0
2020-11-13,Solano,095,438530,9092,8525,44,8569,84
2020-11-13,Sonoma,097,501317,11234,10685,36,10721,151
2020-11-13,Stanislaus,099,539301,19735,18936,1049,19985,422
2020-11-13,Sutter,101,95872,2512,2121,7,2128,12
2020-11-13,Tehama,103,63373,1336,1167,5,1172,7
2020-11-13,Trinity,105,12862,184,64,19,83,0
2020-11-13,Tulare,107,460477,19711,18714,798,19512,305
2020-11-13,Tuolumne,109,53932,701,427,7,434,7
2020-11-13,Ventura,111,848112,17500,16172,481,16653,171
2020-11-13,Yolo,113,214977,4021,3716,10,3726,65
2020-11-13,Yuba,115,75493,1581,1435,7,1442,10
2020-11-12,Alameda,001,1643700,26725,25345,255,25600,432
2020-11-12,Alpine,003,1148,34,12,0,12,0
2020-11-12,Amador,005,37829,430,392,0,392,16
2020-11-12,Butte,007,227075,3611,3347,112,3459,58
2020-11-12,Calaveras,009,45235,388,373,0,373,21
2020-11-12,Colusa,011,21464,620,591,1,592,6
2020-11-12,Contra Costa,013,1133247,21686,20619,112,20731,255
2020-11-12,Del Norte,015,27424,237,203,0,203,2
2020-11-12,El Dorado,017,186661,1864,1573,18,1591,4
2020-11-12,Fresno,019,978130,37383,33459,825,34284,468
2020-11-12,Glenn,021,27897,806,727,17,744,3
2020-11-12,Humboldt,023,135768,711,625,1,626,9
2020-11-12,Imperial,025,180216,14395,13619,28,13647,341
2020-11-12,Inyo,027,18085,270,255,5,260,15
2020-11-12,Kern,029,883053,36963,35207,707,35914,451
2020-11-12,Kings,031,150075,9849,9335,94,9429,85
2020-11-12,Lake,033,64148,829,764,0,764,17
2020-11-12,Lassen,035,31185,1160,832,2,834,0
2020-11-12,Los Angeles,037,10098052,341903,327001,3944,330945,7223
2020-11-12,Madera,039,155013,5632,5273,80,5353,54
2020-11-12,Marin,041,260295,7457,7268,23,7291,133
2020-11-12,Mariposa,043,17540,92,84,0,84,2
2020-11-12,Mendocino,045,87422,1255,1142,5,1147,22
2020-11-12,Merced,047,269075,10532,10107,74,10181,158
2020-11-12,Modoc,049,8938,84,63,14,77,0
2020-11-12,Mono,051,14174,474,442,8,450,2
2020-11-12,Monterey,053,433212,13302,12489,141,12630,100
2020-11-12,Napa,055,140530,2643,2398,14,2412,16
2020-11-12,Nevada,057,99092,942,780,23,803,9
2020-11-12,Orange,059,3164182,67874,63232,2035,65267,1514
2020-11-12,Placer,061,380077,5616,5044,56,5100,62
2020-11-12,Plumas,063,18699,148,121,0,121,0
2020-11-12,Riverside,065,2383286,77593,73381,987,74368,1362
2020-11-12,Sacramento,067,1510023,31427,29459,52,29511,520
2020-11-12,San Benito,069,59416,1623,1525,1,1526,15
2020-11-12,San Bernardino,071,2135413,77585,70758,759,71517,1183
2020-11-12,San Diego,073,3302833,67827,62336,2184,64520,918
2020-11-12,San Francisco,075,870044,13961,13289,71,13360,146
2020-11-12,San Joaquin,077,732212,24177,23002,339,23341,509
2020-11-12,San Luis Obispo,079,281455,5494,4898,71,4969,33
2020-11-12,San Mateo,081,765935,12850,12086,11,12097,169
2020-11-12,Santa Barbara,083,443738,10710,10325,153,10478,134
2020-11-12,Santa Clara,085,1922200,29977,27261,56,27317,414
2020-11-12,Santa Cruz,087,273765,3639,3317,36,3353,25
2020-11-12,Shasta,089,179085,3934,2825,77,2902,37
2020-11-12,Sierra,091,2930,15,11,0,11,0
2020-11-12,Siskiyou,093,43540,375,275,19,294,0
2020-11-12,Solano,095,438530,8992,8417,43,8460,85
2020-11-12,Sonoma,097,501317,11132,10602,35,10637,151
2020-11-12,Stanislaus,099,539301,19566,18787,1020,19807,422
2020-11-12,Sutter,101,95872,2429,2075,6,2081,12
2020-11-12,Tehama,103,63373,1309,1117,5,1122,7
2020-11-12,Trinity,105,12862,176,62,18,80,0
2020-11-12,Tulare,107,460477,19599,18545,760,19305,305
2020-11-12,Tuolumne,109,53932,662,353,7,360,7
2020-11-12,Ventura,111,848112,17250,16013,475,16488,158
2020-11-12,Yolo,113,214977,3977,3646,10,3656,63
2020-11-12,Yuba,115,75493,1546,1410,7,1417,10
2020-11-11,Alameda,001,1643700,26481,25140,253,25393,429
2020-11-11,Alpine,003,1148,29,12,0,12,0
2020-11-11,Amador,005,37829,423,389,0,389,16
2020-11-11,Butte,007,227075,3585,3348,99,3447,58
2020-11-11,Calaveras,009,45235,378,373,0,373,21
2020-11-11,Colusa,011,21464,614,591,1,592,6
2020-11-11,Contra Costa,013,1133247,21469,20452,110,20562,255
2020-11-11,Del Norte,015,27424,230,203,0,203,2
2020-11-11,El Dorado,017,186661,1818,1564,17,1581,4
2020-11-11,Fresno,019,978130,37064,33287,790,34077,468
2020-11-11,Glenn,021,27897,790,722,16,738,3
2020-11-11,Humboldt,023,135768,697,623,1,624,9
2020-11-11,Imperial,025,180216,14225,13623,26,13649,340
2020-11-11,Inyo,027,18085,268,255,5,260,15
2020-11-11,Kern,029,883053,36688,35014,690,35704,449
2020-11-11,Kings,031,150075,9743,9263,91,9354,85
2020-11-11,Lake,033,64148,819,763,0,763,17
2020-11-11,Lassen,035,31185,1135,831,2,833,0
2020-11-11,Los Angeles,037,10098052,338536,324567,3861,328428,7220
2020-11-11,Madera,039,155013,5597,5248,79,5327,54
2020-11-11,Marin,041,260295,7434,7268,23,7291,133
2020-11-11,Mariposa,043,17540,92,84,0,84,2
2020-11-11,Mendocino,045,87422,1243,1142,5,1147,22
2020-11-11,Merced,047,269075,10461,10074,72,10146,157
2020-11-11,Modoc,049,8938,80,62,13,75,0
2020-11-11,Mono,051,14174,472,443,8,451,2
2020-11-11,Monterey,053,433212,13159,12417,137,12554,100
2020-11-11,Napa,055,140530,2594,2365,12,2377,15
2020-11-11,Nevada,057,99092,900,741,23,764,9
2020-11-11,Orange,059,3164182,67234,62929,2011,64940,1506
2020-11-11,Placer,061,380077,5532,4981,48,5029,60
2020-11-11,Plumas,063,18699,146,111,0,111,0
2020-11-11,Riverside,065,2383286,76691,72953,941,73894,1361
2020-11-11,Sacramento,067,1510023,30970,28968,50,29018,520
2020-11-11,San Benito,069,59416,1609,1512,1,1513,15
2020-11-11,San Bernardino,071,2135413,76299,70374,733,71107,1182
2020-11-11,San Diego,073,3302833,66892,61746,2123,63869,918
2020-11-11,San Francisco,075,870044,13854,13287,70,13357,146
2020-11-11,San Joaquin,077,732212,24017,23001,334,23335,509
2020-11-11,San Luis Obispo,079,281455,5419,4832,68,4900,33
2020-11-11,San Mateo,081,765935,12736,12008,11,12019,169
2020-11-11,Santa Barbara,083,443738,10644,10278,153,10431,134
2020-11-11,Santa Clara,085,1922200,29625,27075,55,27130,413
2020-11-11,Santa Cruz,087,273765,3571,3247,36,3283,25
2020-11-11,Shasta,089,179085,3810,2766,67,2833,36
2020-11-11,Sierra,091,2930,13,11,0,11,0
2020-11-11,Siskiyou,093,43540,344,261,16,277,0
2020-11-11,Solano,095,438530,8874,8353,41,8394,85
2020-11-11,Sonoma,097,501317,11058,10498,35,10533,150
2020-11-11,Stanislaus,099,539301,19429,18671,990,19661,422
2020-11-11,Sutter,101,95872,2381,2049,5,2054,12
2020-11-11,Tehama,103,63373,1267,1105,4,1109,7
2020-11-11,Trinity,105,12862,165,62,18,80,0
2020-11-11,Tulare,107,460477,19468,18500,730,19230,305
2020-11-11,Tuolumne,109,53932,606,354,6,360,7
2020-11-11,Ventura,111,848112,17035,15801,462,16263,158
2020-11-11,Yolo,113,214977,3926,3606,10,3616,63
2020-11-11,Yuba,115,75493,1531,1400,7,1407,10
2020-11-10,Alameda,001,1643700,26251,25008,250,25258,424
2020-11-10,Alpine,003,1148,29,9,0,9,0
2020-11-10,Amador,005,37829,417,384,0,384,16
2020-11-10,Butte,007,227075,3549,3327,95,3422,58
2020-11-10,Calaveras,009,45235,373,367,0,367,21
2020-11-10,Colusa,011,21464,606,590,1,591,6
2020-11-10,Contra Costa,013,1133247,21262,20326,108,20434,255
2020-11-10,Del Norte,015,27424,224,196,0,196,2
2020-11-10,El Dorado,017,186661,1758,1551,17,1568,4
2020-11-10,Fresno,019,978130,36794,33024,754,33778,465
2020-11-10,Glenn,021,27897,782,719,12,731,3
2020-11-10,Humboldt,023,135768,680,610,1,611,9
2020-11-10,Imperial,025,180216,14095,13570,26,13596,338
2020-11-10,Inyo,027,18085,267,252,5,257,14
2020-11-10,Kern,029,883053,36412,34858,671,35529,448
2020-11-10,Kings,031,150075,9696,9236,84,9320,85
2020-11-10,Lake,033,64148,809,762,0,762,16
2020-11-10,Lassen,035,31185,1120,830,2,832,0
2020-11-10,Los Angeles,037,10098052,335288,322569,3746,326315,7205
2020-11-10,Madera,039,155013,5555,5229,73,5302,54
2020-11-10,Marin,041,260295,7415,7259,23,7282,133
2020-11-10,Mariposa,043,17540,90,84,0,84,2
2020-11-10,Mendocino,045,87422,1235,1137,5,1142,22
2020-11-10,Merced,047,269075,10399,9992,66,10058,157
2020-11-10,Modoc,049,8938,78,61,13,74,0
2020-11-10,Mono,051,14174,470,443,8,451,2
2020-11-10,Monterey,053,433212,13024,12335,129,12464,100
2020-11-10,Napa,055,140530,2556,2341,10,2351,15
2020-11-10,Nevada,057,99092,884,734,23,757,9
2020-11-10,Orange,059,3164182,66684,62597,2001,64598,1504
2020-11-10,Placer,061,380077,5452,4902,47,4949,60
2020-11-10,Plumas,063,18699,142,108,0,108,0
2020-11-10,Riverside,065,2383286,76049,72316,916,73232,1359
2020-11-10,Sacramento,067,1510023,30563,28677,47,28724,519
2020-11-10,San Benito,069,59416,1594,1508,1,1509,15
2020-11-10,San Bernardino,071,2135413,75129,69666,700,70366,1182
2020-11-10,San Diego,073,3302833,66001,61085,2086,63171,915
2020-11-10,San Francisco,075,870044,13737,13210,70,13280,146
2020-11-10,San Joaquin,077,732212,23852,22865,327,23192,508
2020-11-10,San Luis Obispo,079,281455,5356,4780,65,4845,33
2020-11-10,San Mateo,081,765935,12636,11939,11,11950,169
2020-11-10,Santa Barbara,083,443738,10577,10252,149,10401,134
2020-11-10,Santa Clara,085,1922200,29280,26917,54,26971,409
2020-11-10,Santa Cruz,087,273765,3509,3221,36,3257,25
2020-11-10,Shasta,089,179085,3667,2686,59,2745,36
2020-11-10,Sierra,091,2930,12,10,0,10,0
2020-11-10,Siskiyou,093,43540,327,263,15,278,0
2020-11-10,Solano,095,438530,8776,8299,41,8340,85
2020-11-10,Sonoma,097,501317,10971,10414,35,10449,150
2020-11-10,Stanislaus,099,539301,19295,18592,966,19558,420
2020-11-10,Sutter,101,95872,2286,2035,4,2039,12
2020-11-10,Tehama,103,63373,1243,1099,3,1102,7
2020-11-10,Trinity,105,12862,156,62,16,78,0
2020-11-10,Tulare,107,460477,19353,18430,707,19137,305
2020-11-10,Tuolumne,109,53932,557,353,6,359,7
2020-11-10,Ventura,111,848112,16852,15625,460,16085,158
2020-11-10,Yolo,113,214977,3865,3573,10,3583,63
2020-11-10,Yuba,115,75493,1508,1392,7,1399,10
2020-11-09,Alameda,001,1643700,26005,24899,246,25145,424
2020-11-09,Alpine,003,1148,27,6,0,6,0
2020-11-09,Amador,005,37829,408,380,0,380,16
2020-11-09,Butte,007,227075,3504,3301,86,3387,57
2020-11-09,Calaveras,009,45235,369,360,0,360,21
2020-11-09,Colusa,011,21464,600,583,1,584,6
2020-11-09,Contra Costa,013,1133247,21089,20193,106,20299,255
2020-11-09,Del Norte,015,27424,218,195,0,195,2
2020-11-09,El Dorado,017,186661,1717,1515,17,1532,4
2020-11-09,Fresno,019,978130,36483,32755,714,33469,465
2020-11-09,Glenn,021,27897,776,714,9,723,3
2020-11-09,Humboldt,023,135768,667,607,1,608,9
2020-11-09,Imperial,025,180216,13976,13508,25,13533,338
2020-11-09,Inyo,027,18085,267,252,5,257,14
2020-11-09,Kern,029,883053,36182,34764,635,35399,448
2020-11-09,Kings,031,150075,9626,9141,82,9223,84
2020-11-09,Lake,033,64148,800,755,0,755,16
2020-11-09,Lassen,035,31185,1024,799,2,801,0
2020-11-09,Los Angeles,037,10098052,332191,320370,3671,324041,7180
2020-11-09,Madera,039,155013,5509,5209,70,5279,54
2020-11-09,Marin,041,260295,7389,7237,22,7259,131
2020-11-09,Mariposa,043,17540,90,84,0,84,2
2020-11-09,Mendocino,045,87422,1223,1132,5,1137,22
2020-11-09,Merced,047,269075,10296,9922,63,9985,157
2020-11-09,Modoc,049,8938,74,54,12,66,0
2020-11-09,Mono,051,14174,467,352,8,360,2
2020-11-09,Monterey,053,433212,12877,12148,121,12269,98
2020-11-09,Napa,055,140530,2513,2309,10,2319,15
2020-11-09,Nevada,057,99092,847,729,22,751,9
2020-11-09,Orange,059,3164182,66043,62335,1988,64323,1501
2020-11-09,Placer,061,380077,5367,4843,36,4879,60
2020-11-09,Plumas,063,18699,135,102,0,102,0
2020-11-09,Riverside,065,2383286,75267,72059,882,72941,1346
2020-11-09,Sacramento,067,1510023,30091,28200,46,28246,516
2020-11-09,San Benito,069,59416,1585,1506,1,1507,15
2020-11-09,San Bernardino,071,2135413,74075,69015,657,69672,1182
2020-11-09,San Diego,073,3302833,65146,60572,2046,62618,908
2020-11-09,San Francisco,075,870044,13617,12984,67,13051,146
2020-11-09,San Joaquin,077,732212,23687,22512,322,22834,505
2020-11-09,San Luis Obispo,079,281455,5269,4746,63,4809,32
2020-11-09,San Mateo,081,765935,12529,11857,11,11868,169
2020-11-09,Santa Barbara,083,443738,10520,10214,144,10358,134
2020-11-09,Santa Clara,085,1922200,28885,26693,54,26747,409
2020-11-09,Santa Cruz,087,273765,3451,3194,36,3230,25
2020-11-09,Shasta,089,179085,3513,2581,50,2631,36
2020-11-09,Sierra,091,2930,10,10,0,10,0
2020-11-09,Siskiyou,093,43540,316,257,13,270,0
2020-11-09,Solano,095,438530,8660,8254,40,8294,85
2020-11-09,Sonoma,097,501317,10863,10310,35,10345,150
2020-11-09,Stanislaus,099,539301,19141,18482,951,19433,418
2020-11-09,Sutter,101,95872,2219,2010,3,2013,12
2020-11-09,Tehama,103,63373,1206,1071,2,1073,7
2020-11-09,Trinity,105,12862,149,46,16,62,0
2020-11-09,Tulare,107,460477,19233,18272,676,18948,304
2020-11-09,Tuolumne,109,53932,502,346,5,351,7
2020-11-09,Ventura,111,848112,16650,15568,457,16025,156
2020-11-09,Yolo,113,214977,3804,3522,10,3532,62
2020-11-09,Yuba,115,75493,1475,1380,7,1387,10
2020-11-08,Alameda,001,1643700,25775,24731,246,24977,424
2020-11-08,Alpine,003,1148,24,6,0,6,0
2020-11-08,Amador,005,37829,401,376,0,376,16
2020-11-08,Butte,007,227075,3466,3285,79,3364,57
2020-11-08,Calaveras,009,45235,367,360,0,360,21
2020-11-08,Colusa,011,21464,597,583,1,584,6
2020-11-08,Contra Costa,013,1133247,20919,20031,104,20135,254
2020-11-08,Del Norte,015,27424,210,195,0,195,2
2020-11-08,El Dorado,017,186661,1680,1502,17,1519,4
2020-11-08,Fresno,019,978130,36148,32619,676,33295,465
2020-11-08,Glenn,021,27897,770,707,8,715,3
2020-11-08,Humboldt,023,135768,651,605,1,606,9
2020-11-08,Imperial,025,180216,13860,13428,25,13453,338
2020-11-08,Inyo,027,18085,263,252,5,257,14
2020-11-08,Kern,029,883053,35963,34644,617,35261,448
2020-11-08,Kings,031,150075,9493,9026,79,9105,84
2020-11-08,Lake,033,64148,792,754,0,754,16
2020-11-08,Lassen,035,31185,876,799,2,801,0
2020-11-08,Los Angeles,037,10098052,329065,318960,3605,322565,7176
2020-11-08,Madera,039,155013,5440,5196,67,5263,54
2020-11-08,Marin,041,260295,7369,7227,22,7249,131
2020-11-08,Mariposa,043,17540,90,83,0,83,2
2020-11-08,Mendocino,045,87422,1214,1129,5,1134,22
2020-11-08,Merced,047,269075,10221,9885,61,9946,157
2020-11-08,Modoc,049,8938,70,54,12,66,0
2020-11-08,Mono,051,14174,461,352,8,360,2
2020-11-08,Monterey,053,433212,12732,12122,111,12233,98
2020-11-08,Napa,055,140530,2474,2274,10,2284,15
2020-11-08,Nevada,057,99092,831,715,22,737,9
2020-11-08,Orange,059,3164182,65454,62034,1974,64008,1501
2020-11-08,Placer,061,380077,5264,4800,31,4831,60
2020-11-08,Plumas,063,18699,130,102,0,102,0
2020-11-08,Riverside,065,2383286,74613,71442,841,72283,1345
2020-11-08,Sacramento,067,1510023,29532,28059,43,28102,515
2020-11-08,San Benito,069,59416,1570,1496,1,1497,15
2020-11-08,San Bernardino,071,2135413,72821,68412,618,69030,1182
2020-11-08,San Diego,073,3302833,64301,60199,2002,62201,908
2020-11-08,San Francisco,075,870044,13486,12985,63,13048,146
2020-11-08,San Joaquin,077,732212,23493,22514,318,22832,505
2020-11-08,San Luis Obispo,079,281455,5203,4698,58,4756,32
2020-11-08,San Mateo,081,765935,12411,11783,11,11794,169
2020-11-08,Santa Barbara,083,443738,10450,10180,142,10322,134
2020-11-08,Santa Clara,085,1922200,28511,26442,53,26495,410
2020-11-08,Santa Cruz,087,273765,3394,3134,36,3170,25
2020-11-08,Shasta,089,179085,3377,2582,44,2626,36
2020-11-08,Sierra,091,2930,10,7,0,7,0
2020-11-08,Siskiyou,093,43540,304,246,12,258,0
2020-11-08,Solano,095,438530,8539,8132,39,8171,85
2020-11-08,Sonoma,097,501317,10756,10229,35,10264,149
2020-11-08,Stanislaus,099,539301,18967,18413,930,19343,418
2020-11-08,Sutter,101,95872,2161,1980,3,1983,12
2020-11-08,Tehama,103,63373,1181,1054,2,1056,7
2020-11-08,Trinity,105,12862,146,46,15,61,0
2020-11-08,Tulare,107,460477,19091,18272,647,18919,304
2020-11-08,Tuolumne,109,53932,475,341,5,346,7
2020-11-08,Ventura,111,848112,16455,15504,449,15953,156
2020-11-08,Yolo,113,214977,3743,3492,10,3502,61
2020-11-08,Yuba,115,75493,1454,1369,7,1376,10
2020-11-07,Alameda,001,1643700,25665,24578,244,24822,424
2020-11-07,Alpine,003,1148,24,6,0,6,0
2020-11-07,Amador,005,37829,398,375,0,375,16
2020-11-07,Butte,007,227075,3454,3277,74,3351,57
2020-11-07,Calaveras,009,45235,365,360,0,360,21
2020-11-07,Colusa,011,21464,597,583,1,584,6
2020-11-07,Contra Costa,013,1133247,20818,19943,103,20046,254
2020-11-07,Del Norte,015,27424,206,194,0,194,2
2020-11-07,El Dorado,017,186661,1655,1495,16,1511,4
2020-11-07,Fresno,019,978130,35994,32497,653,33150,465
2020-11-07,Glenn,021,27897,762,707,8,715,3
2020-11-07,Humboldt,023,135768,640,590,1,591,9
2020-11-07,Imperial,025,180216,13802,13388,24,13412,338
2020-11-07,Inyo,027,18085,261,252,5,257,14
2020-11-07,Kern,029,883053,35808,34513,607,35120,448
2020-11-07,Kings,031,150075,9460,9005,73,9078,84
2020-11-07,Lake,033,64148,788,751,0,751,16
2020-11-07,Lassen,035,31185,860,799,2,801,0
2020-11-07,Los Angeles,037,10098052,327551,316756,3538,320294,7174
2020-11-07,Madera,039,155013,5418,5177,65,5242,54
2020-11-07,Marin,041,260295,7358,7215,22,7237,131
2020-11-07,Mariposa,043,17540,90,81,0,81,2
2020-11-07,Mendocino,045,87422,1203,1118,5,1123,22
2020-11-07,Merced,047,269075,10189,9855,57,9912,157
2020-11-07,Modoc,049,8938,70,51,12,63,0
2020-11-07,Mono,051,14174,458,352,8,360,2
2020-11-07,Monterey,053,433212,12662,12030,107,12137,98
2020-11-07,Napa,055,140530,2444,2260,9,2269,15
2020-11-07,Nevada,057,99092,814,710,22,732,9
2020-11-07,Orange,059,3164182,65167,62038,1968,64006,1505
2020-11-07,Placer,061,380077,5201,4745,31,4776,60
2020-11-07,Plumas,063,18699,127,94,0,94,0
2020-11-07,Riverside,065,2383286,74218,71153,814,71967,1345
2020-11-07,Sacramento,067,1510023,29282,27773,43,27816,515
2020-11-07,San Benito,069,59416,1558,1489,1,1490,15
2020-11-07,San Bernardino,071,2135413,72304,67935,607,68542,1182
2020-11-07,San Diego,073,3302833,63789,59682,1970,61652,909
2020-11-07,San Francisco,075,870044,13425,12980,62,13042,146
2020-11-07,San Joaquin,077,732212,23385,22517,312,22829,505
2020-11-07,San Luis Obispo,079,281455,5154,4668,55,4723,32
2020-11-07,San Mateo,081,765935,12348,11711,11,11722,169
2020-11-07,Santa Barbara,083,443738,10408,10157,140,10297,134
2020-11-07,Santa Clara,085,1922200,28307,26244,52,26296,410
2020-11-07,Santa Cruz,087,273765,3356,3130,36,3166,25
2020-11-07,Shasta,089,179085,3310,2547,42,2589,36
2020-11-07,Sierra,091,2930,10,7,0,7,0
2020-11-07,Siskiyou,093,43540,300,241,12,253,0
2020-11-07,Solano,095,438530,8487,8066,39,8105,85
2020-11-07,Sonoma,097,501317,10710,10200,35,10235,149
2020-11-07,Stanislaus,099,539301,18858,18386,914,19300,418
2020-11-07,Sutter,101,95872,2121,1973,3,1976,12
2020-11-07,Tehama,103,63373,1157,1043,2,1045,7
2020-11-07,Trinity,105,12862,146,42,14,56,0
2020-11-07,Tulare,107,460477,19035,18229,630,18859,304
2020-11-07,Tuolumne,109,53932,464,327,5,332,7
2020-11-07,Ventura,111,848112,16395,15364,444,15808,156
2020-11-07,Yolo,113,214977,3712,3486,10,3496,61
2020-11-07,Yuba,115,75493,1439,1349,7,1356,10
2020-11-06,Alameda,001,1643700,25533,24389,242,24631,420
2020-11-06,Alpine,003,1148,24,6,0,6,0
2020-11-06,Amador,005,37829,396,369,0,369,16
2020-11-06,Butte,007,227075,3429,3254,66,3320,57
2020-11-06,Calaveras,009,45235,364,359,0,359,21
2020-11-06,Colusa,011,21464,595,580,1,581,6
2020-11-06,Contra Costa,013,1133247,20669,19744,103,19847,252
2020-11-06,Del Norte,015,27424,203,194,0,194,2
2020-11-06,El Dorado,017,186661,1629,1475,16,1491,4
2020-11-06,Fresno,019,978130,35806,32278,637,32915,460
2020-11-06,Glenn,021,27897,756,707,7,714,3
2020-11-06,Humboldt,023,135768,637,587,1,588,9
2020-11-06,Imperial,025,180216,13749,13230,24,13254,338
2020-11-06,Inyo,027,18085,259,246,5,251,14
2020-11-06,Kern,029,883053,35644,34360,590,34950,443
2020-11-06,Kings,031,150075,9436,8883,71,8954,83
2020-11-06,Lake,033,64148,787,741,0,741,16
2020-11-06,Lassen,035,31185,852,794,2,796,0
2020-11-06,Los Angeles,037,10098052,325581,314356,3486,317842,7160
2020-11-06,Madera,039,155013,5402,5136,64,5200,54
2020-11-06,Marin,041,260295,7337,7184,22,7206,131
2020-11-06,Mariposa,043,17540,89,79,0,79,2
2020-11-06,Mendocino,045,87422,1198,1113,5,1118,22
2020-11-06,Merced,047,269075,10149,9778,54,9832,157
2020-11-06,Modoc,049,8938,70,48,12,60,0
2020-11-06,Mono,051,14174,452,308,8,316,1
2020-11-06,Monterey,053,433212,12545,11914,106,12020,96
2020-11-06,Napa,055,140530,2419,2189,9,2198,15
2020-11-06,Nevada,057,99092,801,692,21,713,9
2020-11-06,Orange,059,3164182,64864,61049,1958,63007,1494
2020-11-06,Placer,061,380077,5128,4680,31,4711,60
2020-11-06,Plumas,063,18699,122,90,0,90,0
2020-11-06,Riverside,065,2383286,73769,70409,773,71182,1341
2020-11-06,Sacramento,067,1510023,28990,27489,41,27530,514
2020-11-06,San Benito,069,59416,1549,1479,1,1480,15
2020-11-06,San Bernardino,071,2135413,71706,66740,587,67327,1179
2020-11-06,San Diego,073,3302833,63265,59143,1938,61081,907
2020-11-06,San Francisco,075,870044,13355,12825,61,12886,146
2020-11-06,San Joaquin,077,732212,23300,22424,302,22726,502
2020-11-06,San Luis Obispo,079,281455,5089,4531,49,4580,32
2020-11-06,San Mateo,081,765935,12273,11587,11,11598,168
2020-11-06,Santa Barbara,083,443738,10372,10118,136,10254,133
2020-11-06,Santa Clara,085,1922200,28065,25831,52,25883,402
2020-11-06,Santa Cruz,087,273765,3318,3063,36,3099,25
2020-11-06,Shasta,089,179085,3237,2475,41,2516,35
2020-11-06,Sierra,091,2930,9,7,0,7,0
2020-11-06,Siskiyou,093,43540,287,237,11,248,0
2020-11-06,Solano,095,438530,8422,7959,39,7998,85
2020-11-06,Sonoma,097,501317,10660,10142,35,10177,149
2020-11-06,Stanislaus,099,539301,18771,18250,906,19156,417
2020-11-06,Sutter,101,95872,2094,1937,2,1939,12
2020-11-06,Tehama,103,63373,1136,1024,2,1026,6
2020-11-06,Trinity,105,12862,143,41,14,55,0
2020-11-06,Tulare,107,460477,18971,18136,605,18741,300
2020-11-06,Tuolumne,109,53932,443,316,5,321,5
2020-11-06,Ventura,111,848112,16309,15222,441,15663,154
2020-11-06,Yolo,113,214977,3683,3420,10,3430,62
2020-11-06,Yuba,115,75493,1426,1335,7,1342,10
2020-11-05,Alameda,001,1643700,25357,24270,242,24512,420
2020-11-05,Alpine,003,1148,24,6,0,6,0
2020-11-05,Amador,005,37829,393,363,0,363,16
2020-11-05,Butte,007,227075,3406,3239,60,3299,57
2020-11-05,Calaveras,009,45235,357,333,0,333,19
2020-11-05,Colusa,011,21464,591,574,1,575,6
2020-11-05,Contra Costa,013,1133247,20487,19656,101,19757,252
2020-11-05,Del Norte,015,27424,201,192,0,192,2
2020-11-05,El Dorado,017,186661,1605,1466,16,1482,4
2020-11-05,Fresno,019,978130,35563,32056,613,32669,460
2020-11-05,Glenn,021,27897,736,702,7,709,3
2020-11-05,Humboldt,023,135768,627,581,1,582,9
2020-11-05,Imperial,025,180216,13657,13178,23,13201,337
2020-11-05,Inyo,027,18085,259,247,5,252,14
2020-11-05,Kern,029,883053,35443,34232,577,34809,443
2020-11-05,Kings,031,150075,9281,8846,68,8914,83
2020-11-05,Lake,033,64148,783,739,0,739,16
2020-11-05,Lassen,035,31185,821,782,2,784,0
2020-11-05,Los Angeles,037,10098052,323225,312381,3433,315814,7146
2020-11-05,Madera,039,155013,5363,5129,61,5190,54
2020-11-05,Marin,041,260295,7315,7171,22,7193,131
2020-11-05,Mariposa,043,17540,88,79,0,79,2
2020-11-05,Mendocino,045,87422,1186,1112,5,1117,22
2020-11-05,Merced,047,269075,10090,9753,49,9802,155
2020-11-05,Modoc,049,8938,69,47,11,58,0
2020-11-05,Mono,051,14174,450,307,8,315,1
2020-11-05,Monterey,053,433212,12435,11784,102,11886,96
2020-11-05,Napa,055,140530,2392,2158,9,2167,15
2020-11-05,Nevada,057,99092,779,687,20,707,9
2020-11-05,Orange,059,3164182,64417,60740,1948,62688,1484
2020-11-05,Placer,061,380077,5059,4627,26,4653,60
2020-11-05,Plumas,063,18699,114,90,0,90,0
2020-11-05,Riverside,065,2383286,73058,70094,717,70811,1338
2020-11-05,Sacramento,067,1510023,28610,27232,40,27272,512
2020-11-05,San Benito,069,59416,1534,1477,1,1478,15
2020-11-05,San Bernardino,071,2135413,70879,66407,575,66982,1174
2020-11-05,San Diego,073,3302833,62639,58659,1912,60571,904
2020-11-05,San Francisco,075,870044,13243,12726,60,12786,146
2020-11-05,San Joaquin,077,732212,23136,22318,298,22616,502
2020-11-05,San Luis Obispo,079,281455,5022,4459,47,4506,32
2020-11-05,San Mateo,081,765935,12179,11535,11,11546,168
2020-11-05,Santa Barbara,083,443738,10328,10080,133,10213,133
2020-11-05,Santa Clara,085,1922200,27798,25651,52,25703,402
2020-11-05,Santa Cruz,087,273765,3280,3023,36,3059,25
2020-11-05,Shasta,089,179085,3147,2401,40,2441,34
2020-11-05,Sierra,091,2930,9,6,0,6,0
2020-11-05,Siskiyou,093,43540,276,228,11,239,0
2020-11-05,Solano,095,438530,8339,7842,39,7881,85
2020-11-05,Sonoma,097,501317,10548,10064,34,10098,145
2020-11-05,Stanislaus,099,539301,18658,18194,893,19087,417
2020-11-05,Sutter,101,95872,2062,1925,2,1927,12
2020-11-05,Tehama,103,63373,1114,1015,2,1017,6
2020-11-05,Trinity,105,12862,127,41,14,55,0
2020-11-05,Tulare,107,460477,18882,18049,579,18628,301
2020-11-05,Tuolumne,109,53932,414,312,5,317,5
2020-11-05,Ventura,111,848112,16143,15113,430,15543,155
2020-11-05,Yolo,113,214977,3633,3391,10,3401,61
2020-11-05,Yuba,115,75493,1408,1322,7,1329,10
2020-11-04,Alameda,001,1643700,25180,24172,240,24412,418
2020-11-04,Alpine,003,1148,20,5,0,5,0
2020-11-04,Amador,005,37829,390,362,0,362,16
2020-11-04,Butte,007,227075,3380,3218,57,3275,57
2020-11-04,Calaveras,009,45235,354,290,0,290,19
2020-11-04,Colusa,011,21464,589,571,1,572,6
2020-11-04,Contra Costa,013,1133247,20320,19472,98,19570,251
2020-11-04,Del Norte,015,27424,197,188,0,188,2
2020-11-04,El Dorado,017,186661,1590,1448,13,1461,4
2020-11-04,Fresno,019,978130,35331,31952,585,32537,457
2020-11-04,Glenn,021,27897,732,701,6,707,3
2020-11-04,Humboldt,023,135768,618,571,1,572,9
2020-11-04,Imperial,025,180216,13559,13087,23,13110,335
2020-11-04,Inyo,027,18085,258,247,5,252,14
2020-11-04,Kern,029,883053,35288,34027,566,34593,439
2020-11-04,Kings,031,150075,9247,8817,66,8883,83
2020-11-04,Lake,033,64148,776,735,0,735,16
2020-11-04,Lassen,035,31185,816,781,2,783,0
2020-11-04,Los Angeles,037,10098052,320914,310456,3354,313810,7124
2020-11-04,Madera,039,155013,5343,5083,57,5140,54
2020-11-04,Marin,041,260295,7303,7157,22,7179,131
2020-11-04,Mariposa,043,17540,88,79,0,79,2
2020-11-04,Mendocino,045,87422,1168,1089,5,1094,22
2020-11-04,Merced,047,269075,10041,9717,47,9764,153
2020-11-04,Modoc,049,8938,59,47,11,58,0
2020-11-04,Mono,051,14174,447,237,7,244,1
2020-11-04,Monterey,053,433212,12231,11743,96,11839,96
2020-11-04,Napa,055,140530,2338,2133,9,2142,15
2020-11-04,Nevada,057,99092,760,675,20,695,9
2020-11-04,Orange,059,3164182,63983,60463,1927,62390,1483
2020-11-04,Placer,061,380077,4981,4526,23,4549,60
2020-11-04,Plumas,063,18699,112,88,0,88,0
2020-11-04,Riverside,065,2383286,72441,69562,658,70220,1335
2020-11-04,Sacramento,067,1510023,28260,27005,39,27044,510
2020-11-04,San Benito,069,59416,1519,1464,1,1465,15
2020-11-04,San Bernardino,071,2135413,70083,65891,552,66443,1169
2020-11-04,San Diego,073,3302833,61993,58126,1886,60012,904
2020-11-04,San Francisco,075,870044,13160,12649,57,12706,146
2020-11-04,San Joaquin,077,732212,22999,22197,285,22482,500
2020-11-04,San Luis Obispo,079,281455,4955,4389,45,4434,32
2020-11-04,San Mateo,081,765935,12085,11456,11,11467,168
2020-11-04,Santa Barbara,083,443738,10290,10026,132,10158,132
2020-11-04,Santa Clara,085,1922200,27536,25487,52,25539,393
2020-11-04,Santa Cruz,087,273765,3243,2997,36,3033,25
2020-11-04,Shasta,089,179085,3016,2321,35,2356,34
2020-11-04,Sierra,091,2930,9,6,0,6,0
2020-11-04,Siskiyou,093,43540,267,222,11,233,0
2020-11-04,Solano,095,438530,8240,7733,39,7772,85
2020-11-04,Sonoma,097,501317,10454,9965,34,9999,142
2020-11-04,Stanislaus,099,539301,18541,18114,878,18992,416
2020-11-04,Sutter,101,95872,2028,1916,2,1918,12
2020-11-04,Tehama,103,63373,1088,997,2,999,6
2020-11-04,Trinity,105,12862,123,37,14,51,0
2020-11-04,Tulare,107,460477,18772,17952,551,18503,298
2020-11-04,Tuolumne,109,53932,390,310,5,315,5
2020-11-04,Ventura,111,848112,16003,14936,427,15363,155
2020-11-04,Yolo,113,214977,3592,3361,10,3371,62
2020-11-04,Yuba,115,75493,1387,1312,7,1319,10
2020-11-03,Alameda,001,1643700,24996,24055,238,24293,418
2020-11-03,Alpine,003,1148,19,4,0,4,0
2020-11-03,Amador,005,37829,385,361,0,361,16
2020-11-03,Butte,007,227075,3356,3211,52,3263,57
2020-11-03,Calaveras,009,45235,350,287,0,287,19
2020-11-03,Colusa,011,21464,584,572,1,573,6
2020-11-03,Contra Costa,013,1133247,20165,19416,98,19514,250
2020-11-03,Del Norte,015,27424,196,187,0,187,2
2020-11-03,El Dorado,017,186661,1568,1445,12,1457,4
2020-11-03,Fresno,019,978130,35065,31856,562,32418,457
2020-11-03,Glenn,021,27897,726,698,6,704,3
2020-11-03,Humboldt,023,135768,612,570,1,571,8
2020-11-03,Imperial,025,180216,13470,13044,22,13066,335
2020-11-03,Inyo,027,18085,257,244,5,249,14
2020-11-03,Kern,029,883053,35097,33957,555,34512,439
2020-11-03,Kings,031,150075,9084,8783,61,8844,83
2020-11-03,Lake,033,64148,766,732,0,732,16
2020-11-03,Lassen,035,31185,807,782,2,784,0
2020-11-03,Los Angeles,037,10098052,318458,308812,3287,312099,7104
2020-11-03,Madera,039,155013,5306,5058,56,5114,54
2020-11-03,Marin,041,260295,7283,7147,21,7168,131
2020-11-03,Mariposa,043,17540,87,79,0,79,2
2020-11-03,Mendocino,045,87422,1153,1084,5,1089,22
2020-11-03,Merced,047,269075,9988,9713,46,9759,153
2020-11-03,Modoc,049,8938,57,47,9,56,0
2020-11-03,Mono,051,14174,443,210,7,217,1
2020-11-03,Monterey,053,433212,12162,11703,91,11794,94
2020-11-03,Napa,055,140530,2302,2130,9,2139,15
2020-11-03,Nevada,057,99092,740,670,19,689,9
2020-11-03,Orange,059,3164182,63553,60283,1915,62198,1477
2020-11-03,Placer,061,380077,4907,4514,23,4537,60
2020-11-03,Plumas,063,18699,109,86,0,86,0
2020-11-03,Riverside,065,2383286,71822,69300,633,69933,1325
2020-11-03,Sacramento,067,1510023,27880,26841,38,26879,510
2020-11-03,San Benito,069,59416,1509,1463,1,1464,15
2020-11-03,San Bernardino,071,2135413,69272,65320,545,65865,1159
2020-11-03,San Diego,073,3302833,61317,57722,1842,59564,901
2020-11-03,San Francisco,075,870044,13038,12585,57,12642,146
2020-11-03,San Joaquin,077,732212,22865,22109,279,22388,500
2020-11-03,San Luis Obispo,079,281455,4871,4371,43,4414,32
2020-11-03,San Mateo,081,765935,11990,11406,11,11417,162
2020-11-03,Santa Barbara,083,443738,10236,10008,128,10136,132
2020-11-03,Santa Clara,085,1922200,27264,25386,51,25437,393
2020-11-03,Santa Cruz,087,273765,3193,2980,35,3015,25
2020-11-03,Shasta,089,179085,2922,2288,28,2316,33
2020-11-03,Sierra,091,2930,7,6,0,6,0
2020-11-03,Siskiyou,093,43540,263,219,11,230,0
2020-11-03,Solano,095,438530,8157,7691,39,7730,85
2020-11-03,Sonoma,097,501317,10352,9906,34,9940,142
2020-11-03,Stanislaus,099,539301,18420,18080,867,18947,416
2020-11-03,Sutter,101,95872,1995,1914,2,1916,12
2020-11-03,Tehama,103,63373,1067,988,2,990,6
2020-11-03,Trinity,105,12862,116,36,13,49,0
2020-11-03,Tulare,107,460477,18666,17890,526,18416,297
2020-11-03,Tuolumne,109,53932,367,302,5,307,5
2020-11-03,Ventura,111,848112,15876,14816,420,15236,155
2020-11-03,Yolo,113,214977,3541,3343,10,3353,61
2020-11-03,Yuba,115,75493,1374,1295,7,1302,10
2020-11-02,Alameda,001,1643700,24800,23991,236,24227,419
2020-11-02,Alpine,003,1148,16,4,0,4,0
2020-11-02,Amador,005,37829,377,357,0,357,16
2020-11-02,Butte,007,227075,3336,3198,49,3247,57
2020-11-02,Calaveras,009,45235,350,282,0,282,18
2020-11-02,Colusa,011,21464,579,571,1,572,6
2020-11-02,Contra Costa,013,1133247,20012,19339,97,19436,250
2020-11-02,Del Norte,015,27424,193,175,0,175,2
2020-11-02,El Dorado,017,186661,1544,1405,12,1417,4
2020-11-02,Fresno,019,978130,34796,31738,545,32283,451
2020-11-02,Glenn,021,27897,720,692,5,697,3
2020-11-02,Humboldt,023,135768,603,569,1,570,8
2020-11-02,Imperial,025,180216,13390,13004,21,13025,334
2020-11-02,Inyo,027,18085,254,243,5,248,14
2020-11-02,Kern,029,883053,34939,33834,545,34379,437
2020-11-02,Kings,031,150075,9054,8654,58,8712,82
2020-11-02,Lake,033,64148,760,728,0,728,17
2020-11-02,Lassen,035,31185,799,782,2,784,0
2020-11-02,Los Angeles,037,10098052,316111,307620,3212,310832,7079
2020-11-02,Madera,039,155013,5275,5033,55,5088,54
2020-11-02,Marin,041,260295,7265,7132,20,7152,125
2020-11-02,Mariposa,043,17540,87,79,0,79,2
2020-11-02,Mendocino,045,87422,1139,1076,5,1081,21
2020-11-02,Merced,047,269075,9926,9664,40,9704,152
2020-11-02,Modoc,049,8938,54,45,5,50,0
2020-11-02,Mono,051,14174,441,211,7,218,1
2020-11-02,Monterey,053,433212,12055,11602,88,11690,93
2020-11-02,Napa,055,140530,2260,2081,9,2090,15
2020-11-02,Nevada,057,99092,724,656,19,675,9
2020-11-02,Orange,059,3164182,63148,59996,1900,61896,1474
2020-11-02,Placer,061,380077,4839,4461,21,4482,60
2020-11-02,Plumas,063,18699,101,86,0,86,0
2020-11-02,Riverside,065,2383286,71191,68833,592,69425,1321
2020-11-02,Sacramento,067,1510023,27538,26676,36,26712,508
2020-11-02,San Benito,069,59416,1497,1459,1,1460,15
2020-11-02,San Bernardino,071,2135413,68416,64629,534,65163,1157
2020-11-02,San Diego,073,3302833,60594,57429,1797,59226,891
2020-11-02,San Francisco,075,870044,12941,12436,56,12492,145
2020-11-02,San Joaquin,077,732212,22725,21919,271,22190,500
2020-11-02,San Luis Obispo,079,281455,4771,4303,40,4343,31
2020-11-02,San Mateo,081,765935,11881,11328,11,11339,161
2020-11-02,Santa Barbara,083,443738,10195,9985,123,10108,130
2020-11-02,Santa Clara,085,1922200,26975,25222,51,25273,387
2020-11-02,Santa Cruz,087,273765,3151,2943,35,2978,25
2020-11-02,Shasta,089,179085,2819,2174,24,2198,33
2020-11-02,Sierra,091,2930,7,6,0,6,0
2020-11-02,Siskiyou,093,43540,253,216,11,227,0
2020-11-02,Solano,095,438530,8039,7665,39,7704,84
2020-11-02,Sonoma,097,501317,10270,9796,33,9829,140
2020-11-02,Stanislaus,099,539301,18324,18005,858,18863,412
2020-11-02,Sutter,101,95872,1971,1895,2,1897,12
2020-11-02,Tehama,103,63373,1044,971,2,973,6
2020-11-02,Trinity,105,12862,110,30,13,43,0
2020-11-02,Tulare,107,460477,18573,17774,506,18280,299
2020-11-02,Tuolumne,109,53932,346,302,5,307,5
2020-11-02,Ventura,111,848112,15735,14767,406,15173,156
2020-11-02,Yolo,113,214977,3493,3318,10,3328,61
2020-11-02,Yuba,115,75493,1361,1280,7,1287,10
2020-11-01,Alameda,001,1643700,24637,23892,234,24126,419
2020-11-01,Alpine,003,1148,10,4,0,4,0
2020-11-01,Amador,005,37829,374,352,0,352,16
2020-11-01,Butte,007,227075,3313,3185,48,3233,57
2020-11-01,Calaveras,009,45235,349,282,0,282,18
2020-11-01,Colusa,011,21464,577,567,1,568,6
2020-11-01,Contra Costa,013,1133247,19839,19246,96,19342,250
2020-11-01,Del Norte,015,27424,189,175,0,175,2
2020-11-01,El Dorado,017,186661,1528,1394,12,1406,4
2020-11-01,Fresno,019,978130,34539,31613,525,32138,451
2020-11-01,Glenn,021,27897,711,688,3,691,3
2020-11-01,Humboldt,023,135768,595,568,1,569,8
2020-11-01,Imperial,025,180216,13299,12969,19,12988,334
2020-11-01,Inyo,027,18085,252,241,5,246,14
2020-11-01,Kern,029,883053,34758,33760,465,34225,437
2020-11-01,Kings,031,150075,9016,8641,57,8698,82
2020-11-01,Lake,033,64148,754,727,0,727,17
2020-11-01,Lassen,035,31185,799,782,2,784,0
2020-11-01,Los Angeles,037,10098052,313541,306217,3121,309338,7077
2020-11-01,Madera,039,155013,5227,5019,53,5072,54
2020-11-01,Marin,041,260295,7248,7124,20,7144,125
2020-11-01,Mariposa,043,17540,83,79,0,79,2
2020-11-01,Mendocino,045,87422,1126,1074,5,1079,21
2020-11-01,Merced,047,269075,9865,9626,40,9666,152
2020-11-01,Modoc,049,8938,53,45,5,50,0
2020-11-01,Mono,051,14174,412,211,6,217,1
2020-11-01,Monterey,053,433212,11948,11587,85,11672,93
2020-11-01,Napa,055,140530,2226,2067,9,2076,15
2020-11-01,Nevada,057,99092,708,646,18,664,9
2020-11-01,Orange,059,3164182,62746,59733,1874,61607,1475
2020-11-01,Placer,061,380077,4773,4422,20,4442,58
2020-11-01,Plumas,063,18699,96,86,0,86,0
2020-11-01,Riverside,065,2383286,70561,68493,557,69050,1319
2020-11-01,Sacramento,067,1510023,27217,26442,36,26478,508
2020-11-01,San Benito,069,59416,1482,1451,1,1452,15
2020-11-01,San Bernardino,071,2135413,67574,64339,513,64852,1157
2020-11-01,San Diego,073,3302833,59906,57122,1757,58879,891
2020-11-01,San Francisco,075,870044,12818,12436,51,12487,145
2020-11-01,San Joaquin,077,732212,22597,21919,265,22184,500
2020-11-01,San Luis Obispo,079,281455,4691,4303,39,4342,31
2020-11-01,San Mateo,081,765935,11800,11280,11,11291,160
2020-11-01,Santa Barbara,083,443738,10144,9969,107,10076,130
2020-11-01,Santa Clara,085,1922200,26696,25090,51,25141,386
2020-11-01,Santa Cruz,087,273765,3098,2921,35,2956,25
2020-11-01,Shasta,089,179085,2684,2172,23,2195,33
2020-11-01,Sierra,091,2930,7,6,0,6,0
2020-11-01,Siskiyou,093,43540,248,205,11,216,0
2020-11-01,Solano,095,438530,7949,7591,39,7630,84
2020-11-01,Sonoma,097,501317,10178,9688,33,9721,140
2020-11-01,Stanislaus,099,539301,18223,17961,839,18800,412
2020-11-01,Sutter,101,95872,1945,1888,1,1889,12
2020-11-01,Tehama,103,63373,1027,965,2,967,5
2020-11-01,Trinity,105,12862,108,30,12,42,0
2020-11-01,Tulare,107,460477,18461,17774,475,18249,299
2020-11-01,Tuolumne,109,53932,324,295,5,300,5
2020-11-01,Ventura,111,848112,15587,14686,377,15063,156
2020-11-01,Yolo,113,214977,3445,3303,10,3313,60
2020-11-01,Yuba,115,75493,1344,1273,7,1280,10
2020-10-31,Alameda,001,1643700,24521,23780,230,24010,416
2020-10-31,Alpine,003,1148,10,4,0,4,0
2020-10-31,Amador,005,37829,370,347,0,347,16
2020-10-31,Butte,007,227075,3300,3172,46,3218,57
2020-10-31,Calaveras,009,45235,349,280,0,280,18
2020-10-31,Colusa,011,21464,575,555,1,556,6
2020-10-31,Contra Costa,013,1133247,19734,19161,96,19257,249
2020-10-31,Del Norte,015,27424,188,175,0,175,2
2020-10-31,El Dorado,017,186661,1519,1390,12,1402,4
2020-10-31,Fresno,019,978130,34402,31558,522,32080,451
2020-10-31,Glenn,021,27897,709,678,3,681,3
2020-10-31,Humboldt,023,135768,592,561,1,562,8
2020-10-31,Imperial,025,180216,13257,12912,19,12931,334
2020-10-31,Inyo,027,18085,251,241,5,246,14
2020-10-31,Kern,029,883053,34655,33666,456,34122,437
2020-10-31,Kings,031,150075,8995,8612,56,8668,82
2020-10-31,Lake,033,64148,750,724,0,724,16
2020-10-31,Lassen,035,31185,794,782,2,784,0
2020-10-31,Los Angeles,037,10098052,312166,304704,3080,307784,7073
2020-10-31,Madera,039,155013,5209,5013,50,5063,54
2020-10-31,Marin,041,260295,7232,7112,20,7132,125
2020-10-31,Mariposa,043,17540,83,79,0,79,2
2020-10-31,Mendocino,045,87422,1118,1066,5,1071,21
2020-10-31,Merced,047,269075,9832,9597,39,9636,151
2020-10-31,Modoc,049,8938,52,34,4,38,0
2020-10-31,Mono,051,14174,263,194,5,199,1
2020-10-31,Monterey,053,433212,11880,11539,81,11620,93
2020-10-31,Napa,055,140530,2207,2040,9,2049,15
2020-10-31,Nevada,057,99092,690,644,18,662,9
2020-10-31,Orange,059,3164182,62488,59488,1856,61344,1473
2020-10-31,Placer,061,380077,4723,4374,19,4393,58
2020-10-31,Plumas,063,18699,95,85,0,85,0
2020-10-31,Riverside,065,2383286,70204,68178,534,68712,1319
2020-10-31,Sacramento,067,1510023,27018,26316,34,26350,507
2020-10-31,San Benito,069,59416,1475,1448,1,1449,15
2020-10-31,San Bernardino,071,2135413,67148,64016,503,64519,1157
2020-10-31,San Diego,073,3302833,59453,56769,1729,58498,891
2020-10-31,San Francisco,075,870044,12744,12438,50,12488,145
2020-10-31,San Joaquin,077,732212,22522,21918,256,22174,500
2020-10-31,San Luis Obispo,079,281455,4622,4285,36,4321,31
2020-10-31,San Mateo,081,765935,11749,11253,11,11264,160
2020-10-31,Santa Barbara,083,443738,10115,9957,99,10056,130
2020-10-31,Santa Clara,085,1922200,26527,24957,51,25008,379
2020-10-31,Santa Cruz,087,273765,3063,2895,34,2929,25
2020-10-31,Shasta,089,179085,2630,2122,22,2144,33
2020-10-31,Sierra,091,2930,7,6,0,6,0
2020-10-31,Siskiyou,093,43540,246,200,11,211,0
2020-10-31,Solano,095,438530,7885,7545,39,7584,84
2020-10-31,Sonoma,097,501317,10125,9648,33,9681,140
2020-10-31,Stanislaus,099,539301,18160,17920,823,18743,412
2020-10-31,Sutter,101,95872,1936,1876,1,1877,12
2020-10-31,Tehama,103,63373,1017,953,2,955,5
2020-10-31,Trinity,105,12862,105,30,12,42,0
2020-10-31,Tulare,107,460477,18412,17758,468,18226,299
2020-10-31,Tuolumne,109,53932,317,290,5,295,5
2020-10-31,Ventura,111,848112,15503,14635,359,14994,155
2020-10-31,Yolo,113,214977,3410,3290,10,3300,60
2020-10-31,Yuba,115,75493,1328,1260,6,1266,10
2020-10-30,Alameda,001,1643700,24442,23676,228,23904,401
2020-10-30,Alpine,003,1148,10,4,0,4,0
2020-10-30,Amador,005,37829,370,344,0,344,16
2020-10-30,Butte,007,227075,3295,3160,46,3206,57
2020-10-30,Calaveras,009,45235,348,279,0,279,18
2020-10-30,Colusa,011,21464,573,554,1,555,6
2020-10-30,Contra Costa,013,1133247,19662,19074,96,19170,249
2020-10-30,Del Norte,015,27424,187,175,0,175,2
2020-10-30,El Dorado,017,186661,1506,1386,12,1398,4
2020-10-30,Fresno,019,978130,34280,31409,514,31923,446
2020-10-30,Glenn,021,27897,703,674,2,676,3
2020-10-30,Humboldt,023,135768,591,561,1,562,7
2020-10-30,Imperial,025,180216,13216,12853,19,12872,334
2020-10-30,Inyo,027,18085,250,241,5,246,14
2020-10-30,Kern,029,883053,34562,33583,455,34038,437
2020-10-30,Kings,031,150075,8985,8564,54,8618,82
2020-10-30,Lake,033,64148,750,720,0,720,16
2020-10-30,Lassen,035,31185,788,777,2,779,0
2020-10-30,Los Angeles,037,10098052,310730,303425,3045,306470,7060
2020-10-30,Madera,039,155013,5197,4991,48,5039,54
2020-10-30,Marin,041,260295,7212,7097,20,7117,125
2020-10-30,Mariposa,043,17540,83,78,0,78,2
2020-10-30,Mendocino,045,87422,1116,1062,5,1067,21
2020-10-30,Merced,047,269075,9800,9539,39,9578,150
2020-10-30,Modoc,049,8938,51,34,3,37,0
2020-10-30,Mono,051,14174,262,193,5,198,1
2020-10-30,Monterey,053,433212,11817,11491,76,11567,92
2020-10-30,Napa,055,140530,2189,2028,9,2037,15
2020-10-30,Nevada,057,99092,684,634,18,652,9
2020-10-30,Orange,059,3164182,62247,59334,1844,61178,1469
2020-10-30,Placer,061,380077,4676,4335,19,4354,58
2020-10-30,Plumas,063,18699,92,80,0,80,0
2020-10-30,Riverside,065,2383286,69866,67752,514,68266,1317
2020-10-30,Sacramento,067,1510023,26870,26147,34,26181,505
2020-10-30,San Benito,069,59416,1469,1440,1,1441,15
2020-10-30,San Bernardino,071,2135413,66732,63512,500,64012,1156
2020-10-30,San Diego,073,3302833,59048,56387,1707,58094,888
2020-10-30,San Francisco,075,870044,12689,12384,50,12434,145
2020-10-30,San Joaquin,077,732212,22455,21849,250,22099,500
2020-10-30,San Luis Obispo,079,281455,4580,4256,36,4292,31
2020-10-30,San Mateo,081,765935,11690,11207,11,11218,159
2020-10-30,Santa Barbara,083,443738,10092,9937,99,10036,128
2020-10-30,Santa Clara,085,1922200,26379,24811,51,24862,378
2020-10-30,Santa Cruz,087,273765,3045,2874,34,2908,25
2020-10-30,Shasta,089,179085,2586,2048,21,2069,32
2020-10-30,Sierra,091,2930,7,6,0,6,0
2020-10-30,Siskiyou,093,43540,246,192,11,203,0
2020-10-30,Solano,095,438530,7824,7497,39,7536,84
2020-10-30,Sonoma,097,501317,10050,9602,33,9635,140
2020-10-30,Stanislaus,099,539301,18112,17861,808,18669,410
2020-10-30,Sutter,101,95872,1923,1860,1,1861,12
2020-10-30,Tehama,103,63373,1013,932,2,934,5
2020-10-30,Trinity,105,12862,105,29,12,41,0
2020-10-30,Tulare,107,460477,18368,17682,453,18135,299
2020-10-30,Tuolumne,109,53932,310,286,5,291,4
2020-10-30,Ventura,111,848112,15430,14578,348,14926,154
2020-10-30,Yolo,113,214977,3393,3263,10,3273,60
2020-10-30,Yuba,115,75493,1320,1256,6,1262,10
2020-10-29,Alameda,001,1643700,24279,23530,227,23757,401
2020-10-29,Alpine,003,1148,7,4,0,4,0
2020-10-29,Amador,005,37829,366,338,0,338,16
2020-10-29,Butte,007,227075,3277,3143,45,3188,57
2020-10-29,Calaveras,009,45235,346,278,0,278,13
2020-10-29,Colusa,011,21464,569,552,1,553,6
2020-10-29,Contra Costa,013,1133247,19564,18933,95,19028,249
2020-10-29,Del Norte,015,27424,185,174,0,174,2
2020-10-29,El Dorado,017,186661,1484,1370,12,1382,4
2020-10-29,Fresno,019,978130,34123,31321,507,31828,445
2020-10-29,Glenn,021,27897,701,673,2,675,3
2020-10-29,Humboldt,023,135768,586,559,1,560,7
2020-10-29,Imperial,025,180216,13172,12769,19,12788,334
2020-10-29,Inyo,027,18085,248,238,5,243,14
2020-10-29,Kern,029,883053,34461,33460,451,33911,437
2020-10-29,Kings,031,150075,8831,8502,53,8555,82
2020-10-29,Lake,033,64148,747,702,0,702,16
2020-10-29,Lassen,035,31185,787,772,2,774,0
2020-10-29,Los Angeles,037,10098052,309102,302246,2999,305245,7046
2020-10-29,Madera,039,155013,5167,4970,46,5016,53
2020-10-29,Marin,041,260295,7198,7083,20,7103,125
2020-10-29,Mariposa,043,17540,81,78,0,78,2
2020-10-29,Mendocino,045,87422,1110,1058,5,1063,21
2020-10-29,Merced,047,269075,9748,9496,39,9535,150
2020-10-29,Modoc,049,8938,49,31,3,34,0
2020-10-29,Mono,051,14174,255,176,5,181,1
2020-10-29,Monterey,053,433212,11736,11425,74,11499,92
2020-10-29,Napa,055,140530,2165,2009,9,2018,15
2020-10-29,Nevada,057,99092,677,632,18,650,9
2020-10-29,Orange,059,3164182,61979,59046,1824,60870,1464
2020-10-29,Placer,061,380077,4631,4270,18,4288,58
2020-10-29,Plumas,063,18699,90,69,0,69,0
2020-10-29,Riverside,065,2383286,69490,67268,484,67752,1304
2020-10-29,Sacramento,067,1510023,26657,25978,33,26011,507
2020-10-29,San Benito,069,59416,1464,1431,1,1432,15
2020-10-29,San Bernardino,071,2135413,66164,62968,490,63458,1150
2020-10-29,San Diego,073,3302833,58582,55916,1678,57594,885
2020-10-29,San Francisco,075,870044,12611,12312,50,12362,145
2020-10-29,San Joaquin,077,732212,22371,21736,238,21974,498
2020-10-29,San Luis Obispo,079,281455,4549,4223,35,4258,31
2020-10-29,San Mateo,081,765935,11645,11145,11,11156,157
2020-10-29,Santa Barbara,083,443738,10059,9902,97,9999,128
2020-10-29,Santa Clara,085,1922200,26228,24614,51,24665,377
2020-10-29,Santa Cruz,087,273765,3020,2850,34,2884,24
2020-10-29,Shasta,089,179085,2523,2008,21,2029,32
2020-10-29,Sierra,091,2930,6,6,0,6,0
2020-10-29,Siskiyou,093,43540,230,185,11,196,0
2020-10-29,Solano,095,438530,7762,7453,39,7492,78
2020-10-29,Sonoma,097,501317,9985,9533,33,9566,140
2020-10-29,Stanislaus,099,539301,18059,17790,787,18577,410
2020-10-29,Sutter,101,95872,1916,1852,1,1853,12
2020-10-29,Tehama,103,63373,995,925,2,927,5
2020-10-29,Trinity,105,12862,100,28,11,39,0
2020-10-29,Tulare,107,460477,18290,17627,435,18062,299
2020-10-29,Tuolumne,109,53932,305,279,5,284,4
2020-10-29,Ventura,111,848112,15339,14486,344,14830,154
2020-10-29,Yolo,113,214977,3364,3246,10,3256,60
2020-10-29,Yuba,115,75493,1309,1248,6,1254,10
2020-10-28,Alameda,001,1643700,24179,23468,226,23694,400
2020-10-28,Alpine,003,1148,6,4,0,4,0
2020-10-28,Amador,005,37829,363,337,0,337,16
2020-10-28,Butte,007,227075,3261,3134,42,3176,56
2020-10-28,Calaveras,009,45235,345,278,0,278,13
2020-10-28,Colusa,011,21464,566,551,1,552,6
2020-10-28,Contra Costa,013,1133247,19477,18828,94,18922,246
2020-10-28,Del Norte,015,27424,182,173,0,173,2
2020-10-28,El Dorado,017,186661,1472,1363,12,1375,4
2020-10-28,Fresno,019,978130,34002,31195,501,31696,444
2020-10-28,Glenn,021,27897,697,673,2,675,3
2020-10-28,Humboldt,023,135768,582,559,1,560,7
2020-10-28,Imperial,025,180216,13123,12730,19,12749,333
2020-10-28,Inyo,027,18085,248,238,5,243,14
2020-10-28,Kern,029,883053,34359,33424,433,33857,436
2020-10-28,Kings,031,150075,8809,8486,53,8539,82
2020-10-28,Lake,033,64148,744,700,0,700,15
2020-10-28,Lassen,035,31185,783,771,2,773,0
2020-10-28,Los Angeles,037,10098052,307646,300726,2957,303683,7031
2020-10-28,Madera,039,155013,5150,4954,45,4999,53
2020-10-28,Marin,041,260295,7187,7079,20,7099,126
2020-10-28,Mariposa,043,17540,81,78,0,78,2
2020-10-28,Mendocino,045,87422,1109,1037,5,1042,20
2020-10-28,Merced,047,269075,9722,9480,38,9518,150
2020-10-28,Modoc,049,8938,48,31,2,33,0
2020-10-28,Mono,051,14174,237,176,5,181,1
2020-10-28,Monterey,053,433212,11678,11330,72,11402,89
2020-10-28,Napa,055,140530,2139,1998,8,2006,15
2020-10-28,Nevada,057,99092,669,629,18,647,9
2020-10-28,Orange,059,3164182,61715,58801,1808,60609,1459
2020-10-28,Placer,061,380077,4575,4236,18,4254,57
2020-10-28,Plumas,063,18699,89,67,0,67,0
2020-10-28,Riverside,065,2383286,69092,67003,460,67463,1302
2020-10-28,Sacramento,067,1510023,26461,25838,32,25870,506
2020-10-28,San Benito,069,59416,1456,1429,1,1430,15
2020-10-28,San Bernardino,071,2135413,65705,62778,481,63259,1154
2020-10-28,San Diego,073,3302833,58199,55556,1649,57205,881
2020-10-28,San Francisco,075,870044,12553,12261,49,12310,145
2020-10-28,San Joaquin,077,732212,22287,21707,227,21934,498
2020-10-28,San Luis Obispo,079,281455,4505,4197,32,4229,31
2020-10-28,San Mateo,081,765935,11578,11101,11,11112,157
2020-10-28,Santa Barbara,083,443738,10036,9872,95,9967,127
2020-10-28,Santa Clara,085,1922200,26084,24503,51,24554,375
2020-10-28,Santa Cruz,087,273765,2989,2836,34,2870,24
2020-10-28,Shasta,089,179085,2443,1996,20,2016,31
2020-10-28,Sierra,091,2930,6,6,0,6,0
2020-10-28,Siskiyou,093,43540,227,182,10,192,0
2020-10-28,Solano,095,438530,7703,7362,39,7401,77
2020-10-28,Sonoma,097,501317,9895,9457,28,9485,140
2020-10-28,Stanislaus,099,539301,17994,17765,778,18543,409
2020-10-28,Sutter,101,95872,1907,1840,1,1841,12
2020-10-28,Tehama,103,63373,984,921,2,923,5
2020-10-28,Trinity,105,12862,93,28,10,38,0
2020-10-28,Tulare,107,460477,18233,17569,420,17989,297
2020-10-28,Tuolumne,109,53932,302,277,5,282,4
2020-10-28,Ventura,111,848112,15266,14409,335,14744,153
2020-10-28,Yolo,113,214977,3339,3230,10,3240,60
2020-10-28,Yuba,115,75493,1297,1245,6,1251,10
2020-10-27,Alameda,001,1643700,24063,23365,224,23589,400
2020-10-27,Alpine,003,1148,6,3,0,3,0
2020-10-27,Amador,005,37829,360,335,0,335,16
2020-10-27,Butte,007,227075,3245,3107,39,3146,56
2020-10-27,Calaveras,009,45235,343,277,0,277,13
2020-10-27,Colusa,011,21464,561,549,1,550,6
2020-10-27,Contra Costa,013,1133247,19371,18766,94,18860,246
2020-10-27,Del Norte,015,27424,179,173,0,173,2
2020-10-27,El Dorado,017,186661,1459,1351,12,1363,4
2020-10-27,Fresno,019,978130,33883,31096,496,31592,442
2020-10-27,Glenn,021,27897,695,667,1,668,3
2020-10-27,Humboldt,023,135768,579,559,1,560,7
2020-10-27,Imperial,025,180216,13074,12680,19,12699,333
2020-10-27,Inyo,027,18085,248,231,5,236,14
2020-10-27,Kern,029,883053,34242,33328,429,33757,436
2020-10-27,Kings,031,150075,8778,8411,53,8464,83
2020-10-27,Lake,033,64148,741,700,0,700,15
2020-10-27,Lassen,035,31185,781,764,2,766,0
2020-10-27,Los Angeles,037,10098052,306258,299438,2928,302366,7008
2020-10-27,Madera,039,155013,5120,4942,44,4986,53
2020-10-27,Marin,041,260295,7171,7070,20,7090,126
2020-10-27,Mariposa,043,17540,80,78,0,78,2
2020-10-27,Mendocino,045,87422,1103,1033,4,1037,20
2020-10-27,Merced,047,269075,9681,9449,38,9487,150
2020-10-27,Modoc,049,8938,46,31,2,33,0
2020-10-27,Mono,051,14174,223,169,5,174,1
2020-10-27,Monterey,053,433212,11622,11261,70,11331,88
2020-10-27,Napa,055,140530,2123,1979,8,1987,15
2020-10-27,Nevada,057,99092,663,622,18,640,8
2020-10-27,Orange,059,3164182,61443,58550,1792,60342,1448
2020-10-27,Placer,061,380077,4526,4197,16,4213,57
2020-10-27,Plumas,063,18699,86,63,0,63,0
2020-10-27,Riverside,065,2383286,68739,66699,415,67114,1299
2020-10-27,Sacramento,067,1510023,26274,25701,31,25732,501
2020-10-27,San Benito,069,59416,1451,1428,1,1429,15
2020-10-27,San Bernardino,071,2135413,65244,62357,468,62825,1154
2020-10-27,San Diego,073,3302833,57726,55226,1626,56852,877
2020-10-27,San Francisco,075,870044,12478,12218,48,12266,140
2020-10-27,San Joaquin,077,732212,22196,21637,218,21855,496
2020-10-27,San Luis Obispo,079,281455,4478,4148,28,4176,31
2020-10-27,San Mateo,081,765935,11530,11074,11,11085,156
2020-10-27,Santa Barbara,083,443738,10006,9874,94,9968,125
2020-10-27,Santa Clara,085,1922200,25942,24368,51,24419,367
2020-10-27,Santa Cruz,087,273765,2959,2815,33,2848,24
2020-10-27,Shasta,089,179085,2357,1962,20,1982,29
2020-10-27,Sierra,091,2930,6,6,0,6,0
2020-10-27,Siskiyou,093,43540,218,181,10,191,0
2020-10-27,Solano,095,438530,7634,7298,39,7337,77
2020-10-27,Sonoma,097,501317,9828,9389,28,9417,140
2020-10-27,Stanislaus,099,539301,17926,17720,771,18491,408
2020-10-27,Sutter,101,95872,1894,1832,1,1833,12
2020-10-27,Tehama,103,63373,970,913,2,915,5
2020-10-27,Trinity,105,12862,90,28,10,38,0
2020-10-27,Tulare,107,460477,18170,17520,397,17917,296
2020-10-27,Tuolumne,109,53932,298,275,5,280,4
2020-10-27,Ventura,111,848112,15183,14347,328,14675,153
2020-10-27,Yolo,113,214977,3326,3216,10,3226,58
2020-10-27,Yuba,115,75493,1284,1235,6,1241,10
2020-10-26,Alameda,001,1643700,23950,23284,223,23507,398
2020-10-26,Alpine,003,1148,4,3,0,3,0
2020-10-26,Amador,005,37829,356,331,0,331,16
2020-10-26,Butte,007,227075,3234,3095,37,3132,56
2020-10-26,Calaveras,009,45235,340,274,0,274,13
2020-10-26,Colusa,011,21464,559,548,1,549,6
2020-10-26,Contra Costa,013,1133247,19276,18718,93,18811,245
2020-10-26,Del Norte,015,27424,179,171,0,171,2
2020-10-26,El Dorado,017,186661,1445,1336,12,1348,4
2020-10-26,Fresno,019,978130,33770,30969,489,31458,441
2020-10-26,Glenn,021,27897,688,660,1,661,3
2020-10-26,Humboldt,023,135768,571,554,1,555,7
2020-10-26,Imperial,025,180216,13020,12654,16,12670,333
2020-10-26,Inyo,027,18085,248,226,5,231,14
2020-10-26,Kern,029,883053,34158,33233,424,33657,432
2020-10-26,Kings,031,150075,8757,8264,51,8315,82
2020-10-26,Lake,033,64148,739,697,0,697,15
2020-10-26,Lassen,035,31185,778,764,2,766,0
2020-10-26,Los Angeles,037,10098052,304831,297961,2887,300848,6979
2020-10-26,Madera,039,155013,5099,4922,43,4965,53
2020-10-26,Marin,041,260295,7165,7064,19,7083,104
2020-10-26,Mariposa,043,17540,80,77,0,77,2
2020-10-26,Mendocino,045,87422,1095,1026,4,1030,20
2020-10-26,Merced,047,269075,9634,9375,37,9412,150
2020-10-26,Modoc,049,8938,44,28,0,28,0
2020-10-26,Mono,051,14174,217,167,5,172,1
2020-10-26,Monterey,053,433212,11571,11207,66,11273,87
2020-10-26,Napa,055,140530,2091,1966,8,1974,14
2020-10-26,Nevada,057,99092,656,618,18,636,8
2020-10-26,Orange,059,3164182,61239,58377,1774,60151,1442
2020-10-26,Placer,061,380077,4484,4161,15,4176,57
2020-10-26,Plumas,063,18699,84,63,0,63,0
2020-10-26,Riverside,065,2383286,68288,66475,389,66864,1294
2020-10-26,Sacramento,067,1510023,26093,25555,29,25584,496
2020-10-26,San Benito,069,59416,1443,1424,1,1425,15
2020-10-26,San Bernardino,071,2135413,64773,61871,465,62336,1153
2020-10-26,San Diego,073,3302833,57333,54957,1588,56545,870
2020-10-26,San Francisco,075,870044,12418,12072,48,12120,138
2020-10-26,San Joaquin,077,732212,22113,21459,212,21671,495
2020-10-26,San Luis Obispo,079,281455,4452,4133,28,4161,31
2020-10-26,San Mateo,081,765935,11486,11037,11,11048,156
2020-10-26,Santa Barbara,083,443738,9983,9827,94,9921,122
2020-10-26,Santa Clara,085,1922200,25752,24258,50,24308,365
2020-10-26,Santa Cruz,087,273765,2933,2808,33,2841,24
2020-10-26,Shasta,089,179085,2303,1889,20,1909,29
2020-10-26,Sierra,091,2930,6,6,0,6,0
2020-10-26,Siskiyou,093,43540,210,179,10,189,0
2020-10-26,Solano,095,438530,7554,7271,39,7310,62
2020-10-26,Sonoma,097,501317,9751,9315,28,9343,140
2020-10-26,Stanislaus,099,539301,17876,17666,761,18427,400
2020-10-26,Sutter,101,95872,1886,1817,1,1818,12
2020-10-26,Tehama,103,63373,950,892,2,894,5
2020-10-26,Trinity,105,12862,89,26,10,36,0
2020-10-26,Tulare,107,460477,18093,17432,374,17806,296
2020-10-26,Tuolumne,109,53932,289,271,5,276,4
2020-10-26,Ventura,111,848112,15114,14330,325,14655,154
2020-10-26,Yolo,113,214977,3307,3206,10,3216,58
2020-10-26,Yuba,115,75493,1268,1226,6,1232,10
2020-10-25,Alameda,001,1643700,23844,23192,223,23415,398
2020-10-25,Alpine,003,1148,3,3,0,3,0
2020-10-25,Amador,005,37829,345,330,0,330,16
2020-10-25,Butte,007,227075,3215,3087,37,3124,56
2020-10-25,Calaveras,009,45235,339,274,0,274,13
2020-10-25,Colusa,011,21464,555,548,1,549,6
2020-10-25,Contra Costa,013,1133247,19174,18640,93,18733,245
2020-10-25,Del Norte,015,27424,175,171,0,171,2
2020-10-25,El Dorado,017,186661,1430,1328,12,1340,4
2020-10-25,Fresno,019,978130,33636,30858,476,31334,441
2020-10-25,Glenn,021,27897,685,652,1,653,3
2020-10-25,Humboldt,023,135768,568,554,1,555,7
2020-10-25,Imperial,025,180216,12971,12572,16,12588,333
2020-10-25,Inyo,027,18085,245,226,5,231,14
2020-10-25,Kern,029,883053,34051,33185,420,33605,432
2020-10-25,Kings,031,150075,8724,8246,49,8295,82
2020-10-25,Lake,033,64148,722,695,0,695,15
2020-10-25,Lassen,035,31185,776,764,2,766,0
2020-10-25,Los Angeles,037,10098052,303266,297110,2851,299961,6973
2020-10-25,Madera,039,155013,5069,4909,38,4947,53
2020-10-25,Marin,041,260295,7155,7052,19,7071,102
2020-10-25,Mariposa,043,17540,80,77,0,77,2
2020-10-25,Mendocino,045,87422,1088,1024,4,1028,20
2020-10-25,Merced,047,269075,9569,9352,35,9387,150
2020-10-25,Modoc,049,8938,39,28,0,28,0
2020-10-25,Mono,051,14174,209,167,5,172,1
2020-10-25,Monterey,053,433212,11488,11182,61,11243,87
2020-10-25,Napa,055,140530,2061,1962,8,1970,14
2020-10-25,Nevada,057,99092,648,616,18,634,8
2020-10-25,Orange,059,3164182,60951,58185,1765,59950,1443
2020-10-25,Placer,061,380077,4432,4140,15,4155,57
2020-10-25,Plumas,063,18699,84,63,0,63,0
2020-10-25,Riverside,065,2383286,67837,66192,373,66565,1289
2020-10-25,Sacramento,067,1510023,25878,25445,27,25472,496
2020-10-25,San Benito,069,59416,1436,1423,1,1424,15
2020-10-25,San Bernardino,071,2135413,64233,61551,453,62004,1153
2020-10-25,San Diego,073,3302833,56870,54599,1556,56155,870
2020-10-25,San Francisco,075,870044,12345,12072,48,12120,137
2020-10-25,San Joaquin,077,732212,22005,21459,204,21663,495
2020-10-25,San Luis Obispo,079,281455,4410,4126,26,4152,31
2020-10-25,San Mateo,081,765935,11441,10987,11,10998,156
2020-10-25,Santa Barbara,083,443738,9963,9814,94,9908,122
2020-10-25,Santa Clara,085,1922200,25564,24087,50,24137,365
2020-10-25,Santa Cruz,087,273765,2906,2789,33,2822,24
2020-10-25,Shasta,089,179085,2239,1889,20,1909,29
2020-10-25,Sierra,091,2930,6,6,0,6,0
2020-10-25,Siskiyou,093,43540,207,176,10,186,0
2020-10-25,Solano,095,438530,7476,7197,39,7236,60
2020-10-25,Sonoma,097,501317,9658,9235,27,9262,140
2020-10-25,Stanislaus,099,539301,17819,17641,752,18393,400
2020-10-25,Sutter,101,95872,1868,1811,1,1812,12
2020-10-25,Tehama,103,63373,933,880,2,882,5
2020-10-25,Trinity,105,12862,85,26,10,36,0
2020-10-25,Tulare,107,460477,18019,17431,364,17795,296
2020-10-25,Tuolumne,109,53932,284,271,5,276,4
2020-10-25,Ventura,111,848112,15021,14300,319,14619,154
2020-10-25,Yolo,113,214977,3286,3190,10,3200,58
2020-10-25,Yuba,115,75493,1260,1219,6,1225,10
2020-10-24,Alameda,001,1643700,23773,23099,220,23319,398
2020-10-24,Alpine,003,1148,3,3,0,3,0
2020-10-24,Amador,005,37829,344,328,0,328,16
2020-10-24,Butte,007,227075,3206,3078,37,3115,56
2020-10-24,Calaveras,009,45235,337,274,0,274,13
2020-10-24,Colusa,011,21464,550,548,1,549,6
2020-10-24,Contra Costa,013,1133247,19107,18567,93,18660,244
2020-10-24,Del Norte,015,27424,174,171,0,171,2
2020-10-24,El Dorado,017,186661,1414,1317,12,1329,4
2020-10-24,Fresno,019,978130,33575,30752,471,31223,441
2020-10-24,Glenn,021,27897,682,650,1,651,3
2020-10-24,Humboldt,023,135768,566,553,1,554,7
2020-10-24,Imperial,025,180216,12944,12469,16,12485,333
2020-10-24,Inyo,027,18085,245,226,5,231,14
2020-10-24,Kern,029,883053,33993,33105,415,33520,432
2020-10-24,Kings,031,150075,8714,8228,48,8276,82
2020-10-24,Lake,033,64148,717,696,0,696,15
2020-10-24,Lassen,035,31185,775,764,2,766,0
2020-10-24,Los Angeles,037,10098052,302448,296323,2829,299152,6969
2020-10-24,Madera,039,155013,5056,4898,37,4935,53
2020-10-24,Marin,041,260295,7146,7042,19,7061,102
2020-10-24,Mariposa,043,17540,80,77,0,77,2
2020-10-24,Mendocino,045,87422,1076,1022,4,1026,20
2020-10-24,Merced,047,269075,9545,9351,35,9386,150
2020-10-24,Modoc,049,8938,38,28,0,28,0
2020-10-24,Mono,051,14174,195,167,5,172,1
2020-10-24,Monterey,053,433212,11419,11153,60,11213,87
2020-10-24,Napa,055,140530,2044,1957,8,1965,14
2020-10-24,Nevada,057,99092,644,608,18,626,8
2020-10-24,Orange,059,3164182,60796,57928,1755,59683,1441
2020-10-24,Placer,061,380077,4401,4093,15,4108,57
2020-10-24,Plumas,063,18699,78,63,0,63,0
2020-10-24,Riverside,065,2383286,67629,65902,359,66261,1288
2020-10-24,Sacramento,067,1510023,25797,25372,27,25399,496
2020-10-24,San Benito,069,59416,1431,1417,1,1418,15
2020-10-24,San Bernardino,071,2135413,63994,61351,445,61796,1153
2020-10-24,San Diego,073,3302833,56593,54330,1543,55873,868
2020-10-24,San Francisco,075,870044,12287,12073,47,12120,137
2020-10-24,San Joaquin,077,732212,21952,21458,199,21657,495
2020-10-24,San Luis Obispo,079,281455,4387,4119,25,4144,31
2020-10-24,San Mateo,081,765935,11402,10942,11,10953,155
2020-10-24,Santa Barbara,083,443738,9946,9781,94,9875,122
2020-10-24,Santa Clara,085,1922200,25477,23978,50,24028,365
2020-10-24,Santa Cruz,087,273765,2887,2775,33,2808,24
2020-10-24,Shasta,089,179085,2194,1878,20,1898,29
2020-10-24,Sierra,091,2930,6,6,0,6,0
2020-10-24,Siskiyou,093,43540,206,174,10,184,0
2020-10-24,Solano,095,438530,7423,7189,39,7228,60
2020-10-24,Sonoma,097,501317,9624,9179,27,9206,140
2020-10-24,Stanislaus,099,539301,17776,17574,737,18311,400
2020-10-24,Sutter,101,95872,1859,1804,1,1805,12
2020-10-24,Tehama,103,63373,925,872,2,874,5
2020-10-24,Trinity,105,12862,85,25,10,35,0
2020-10-24,Tulare,107,460477,17996,17406,353,17759,295
2020-10-24,Tuolumne,109,53932,281,269,5,274,4
2020-10-24,Ventura,111,848112,14968,14240,318,14558,154
2020-10-24,Yolo,113,214977,3274,3164,10,3174,57
2020-10-24,Yuba,115,75493,1257,1210,6,1216,10
2020-10-23,Alameda,001,1643700,23700,23047,218,23265,393
2020-10-23,Alpine,003,1148,3,3,0,3,0
2020-10-23,Amador,005,37829,343,324,0,324,16
2020-10-23,Butte,007,227075,3197,3059,37,3096,55
2020-10-23,Calaveras,009,45235,336,273,0,273,13
2020-10-23,Colusa,011,21464,550,547,1,548,6
2020-10-23,Contra Costa,013,1133247,19037,18483,92,18575,244
2020-10-23,Del Norte,015,27424,174,171,0,171,2
2020-10-23,El Dorado,017,186661,1405,1310,12,1322,4
2020-10-23,Fresno,019,978130,33508,30590,468,31058,441
2020-10-23,Glenn,021,27897,679,644,1,645,3
2020-10-23,Humboldt,023,135768,564,553,1,554,7
2020-10-23,Imperial,025,180216,12913,12398,15,12413,333
2020-10-23,Inyo,027,18085,244,226,5,231,14
2020-10-23,Kern,029,883053,33925,33077,410,33487,431
2020-10-23,Kings,031,150075,8705,8218,48,8266,82
2020-10-23,Lake,033,64148,715,689,0,689,15
2020-10-23,Lassen,035,31185,774,764,2,766,0
2020-10-23,Los Angeles,037,10098052,301364,294287,2801,297088,6956
2020-10-23,Madera,039,155013,5051,4888,37,4925,53
2020-10-23,Marin,041,260295,7133,7029,19,7048,102
2020-10-23,Mariposa,043,17540,80,77,0,77,2
2020-10-23,Mendocino,045,87422,1073,1019,4,1023,20
2020-10-23,Merced,047,269075,9531,9327,35,9362,149
2020-10-23,Modoc,049,8938,38,28,0,28,0
2020-10-23,Mono,051,14174,194,159,5,164,1
2020-10-23,Monterey,053,433212,11372,11099,56,11155,86
2020-10-23,Napa,055,140530,2036,1942,8,1950,14
2020-10-23,Nevada,057,99092,641,604,18,622,8
2020-10-23,Orange,059,3164182,60626,57595,1740,59335,1430
2020-10-23,Placer,061,380077,4354,4073,15,4088,57
2020-10-23,Plumas,063,18699,75,63,0,63,0
2020-10-23,Riverside,065,2383286,67390,65512,351,65863,1279
2020-10-23,Sacramento,067,1510023,25692,25224,27,25251,496
2020-10-23,San Benito,069,59416,1429,1412,1,1413,15
2020-10-23,San Bernardino,071,2135413,63709,60854,431,61285,1150
2020-10-23,San Diego,073,3302833,56287,53944,1516,55460,867
2020-10-23,San Francisco,075,870044,12256,12015,47,12062,137
2020-10-23,San Joaquin,077,732212,21896,21361,193,21554,495
2020-10-23,San Luis Obispo,079,281455,4362,4102,25,4127,31
2020-10-23,San Mateo,081,765935,11353,10872,11,10883,155
2020-10-23,Santa Barbara,083,443738,9930,9751,94,9845,121
2020-10-23,Santa Clara,085,1922200,25375,23822,50,23872,364
2020-10-23,Santa Cruz,087,273765,2873,2757,33,2790,24
2020-10-23,Shasta,089,179085,2157,1846,19,1865,29
2020-10-23,Sierra,091,2930,6,6,0,6,0
2020-10-23,Siskiyou,093,43540,202,172,10,182,0
2020-10-23,Solano,095,438530,7392,7174,39,7213,59
2020-10-23,Sonoma,097,501317,9567,9112,27,9139,139
2020-10-23,Stanislaus,099,539301,17739,17496,730,18226,395
2020-10-23,Sutter,101,95872,1852,1797,1,1798,12
2020-10-23,Tehama,103,63373,916,862,2,864,5
2020-10-23,Trinity,105,12862,85,26,10,36,0
2020-10-23,Tulare,107,460477,17951,17334,342,17676,295
2020-10-23,Tuolumne,109,53932,279,254,5,259,4
2020-10-23,Ventura,111,848112,14939,14192,318,14510,155
2020-10-23,Yolo,113,214977,3262,3140,10,3150,57
2020-10-23,Yuba,115,75493,1253,1206,6,1212,10
2020-10-22,Alameda,001,1643700,23599,22915,218,23133,393
2020-10-22,Alpine,003,1148,3,3,0,3,0
2020-10-22,Amador,005,37829,339,317,0,317,16
2020-10-22,Butte,007,227075,3187,3046,35,3081,55
2020-10-22,Calaveras,009,45235,333,273,0,273,13
2020-10-22,Colusa,011,21464,550,547,1,548,6
2020-10-22,Contra Costa,013,1133247,18966,18393,92,18485,243
2020-10-22,Del Norte,015,27424,173,168,0,168,2
2020-10-22,El Dorado,017,186661,1395,1308,12,1320,4
2020-10-22,Fresno,019,978130,33398,30471,460,30931,438
2020-10-22,Glenn,021,27897,672,643,1,644,3
2020-10-22,Humboldt,023,135768,562,548,1,549,7
2020-10-22,Imperial,025,180216,12860,12311,15,12326,333
2020-10-22,Inyo,027,18085,241,220,5,225,14
2020-10-22,Kern,029,883053,33844,32991,407,33398,431
2020-10-22,Kings,031,150075,8454,8201,48,8249,82
2020-10-22,Lake,033,64148,711,678,0,678,15
2020-10-22,Lassen,035,31185,771,764,2,766,0
2020-10-22,Los Angeles,037,10098052,299987,291599,2744,294343,6935
2020-10-22,Madera,039,155013,5030,4847,37,4884,52
2020-10-22,Marin,041,260295,7126,7014,19,7033,102
2020-10-22,Mariposa,043,17540,80,77,0,77,2
2020-10-22,Mendocino,045,87422,1068,1016,4,1020,20
2020-10-22,Merced,047,269075,9503,9323,35,9358,149
2020-10-22,Modoc,049,8938,34,26,0,26,0
2020-10-22,Mono,051,14174,189,156,5,161,1
2020-10-22,Monterey,053,433212,11313,11059,53,11112,84
2020-10-22,Napa,055,140530,2021,1928,8,1936,14
2020-10-22,Nevada,057,99092,635,600,18,618,8
2020-10-22,Orange,059,3164182,60411,57418,1723,59141,1422
2020-10-22,Placer,061,380077,4305,4036,15,4051,57
2020-10-22,Plumas,063,18699,72,62,0,62,0
2020-10-22,Riverside,065,2383286,67055,65104,333,65437,1279
2020-10-22,Sacramento,067,1510023,25552,25054,27,25081,492
2020-10-22,San Benito,069,59416,1425,1403,1,1404,15
2020-10-22,San Bernardino,071,2135413,63307,60402,416,60818,1149
2020-10-22,San Diego,073,3302833,55900,53514,1497,55011,866
2020-10-22,San Francisco,075,870044,12198,11991,45,12036,137
2020-10-22,San Joaquin,077,732212,21823,21282,187,21469,495
2020-10-22,San Luis Obispo,079,281455,4346,4081,25,4106,31
2020-10-22,San Mateo,081,765935,11297,10796,11,10807,155
2020-10-22,Santa Barbara,083,443738,9896,9710,92,9802,120
2020-10-22,Santa Clara,085,1922200,25221,23621,50,23671,363
2020-10-22,Santa Cruz,087,273765,2855,2738,32,2770,24
2020-10-22,Shasta,089,179085,2111,1799,19,1818,29
2020-10-22,Sierra,091,2930,6,6,0,6,0
2020-10-22,Siskiyou,093,43540,201,169,10,179,0
2020-10-22,Solano,095,438530,7346,7116,39,7155,59
2020-10-22,Sonoma,097,501317,9501,9052,26,9078,139
2020-10-22,Stanislaus,099,539301,17685,17440,718,18158,395
2020-10-22,Sutter,101,95872,1838,1794,1,1795,12
2020-10-22,Tehama,103,63373,905,852,2,854,5
2020-10-22,Trinity,105,12862,84,26,10,36,0
2020-10-22,Tulare,107,460477,17885,17265,329,17594,293
2020-10-22,Tuolumne,109,53932,277,252,5,257,4
2020-10-22,Ventura,111,848112,14892,14124,316,14440,154
2020-10-22,Yolo,113,214977,3250,3116,10,3126,58
2020-10-22,Yuba,115,75493,1246,1199,5,1204,10
2020-10-21,Alameda,001,1643700,23511,22853,216,23069,392
2020-10-21,Alpine,003,1148,3,3,0,3,0
2020-10-21,Amador,005,37829,334,313,0,313,16
2020-10-21,Butte,007,227075,3175,3041,35,3076,55
2020-10-21,Calaveras,009,45235,332,272,0,272,13
2020-10-21,Colusa,011,21464,550,546,1,547,6
2020-10-21,Contra Costa,013,1133247,18892,18299,92,18391,243
2020-10-21,Del Norte,015,27424,173,169,0,169,2
2020-10-21,El Dorado,017,186661,1383,1305,11,1316,4
2020-10-21,Fresno,019,978130,33303,30328,455,30783,433
2020-10-21,Glenn,021,27897,667,640,1,641,3
2020-10-21,Humboldt,023,135768,561,548,1,549,7
2020-10-21,Imperial,025,180216,12803,12210,15,12225,331
2020-10-21,Inyo,027,18085,237,220,5,225,14
2020-10-21,Kern,029,883053,33769,32956,405,33361,430
2020-10-21,Kings,031,150075,8427,8186,48,8234,80
2020-10-21,Lake,033,64148,710,676,0,676,15
2020-10-21,Lassen,035,31185,770,764,2,766,0
2020-10-21,Los Angeles,037,10098052,298646,288096,2702,290798,6923
2020-10-21,Madera,039,155013,5005,4831,37,4868,52
2020-10-21,Marin,041,260295,7117,7002,19,7021,102
2020-10-21,Mariposa,043,17540,80,77,0,77,2
2020-10-21,Mendocino,045,87422,1066,1011,4,1015,21
2020-10-21,Merced,047,269075,9479,9319,33,9352,149
2020-10-21,Modoc,049,8938,33,26,0,26,0
2020-10-21,Mono,051,14174,187,156,5,161,1
2020-10-21,Monterey,053,433212,11275,11005,52,11057,83
2020-10-21,Napa,055,140530,2006,1918,8,1926,13
2020-10-21,Nevada,057,99092,629,597,18,615,8
2020-10-21,Orange,059,3164182,60199,57189,1714,58903,1409
2020-10-21,Placer,061,380077,4268,4007,15,4022,56
2020-10-21,Plumas,063,18699,69,58,0,58,0
2020-10-21,Riverside,065,2383286,66759,64778,309,65087,1278
2020-10-21,Sacramento,067,1510023,25359,24908,27,24935,490
2020-10-21,San Benito,069,59416,1424,1401,1,1402,14
2020-10-21,San Bernardino,071,2135413,62897,59948,409,60357,1141
2020-10-21,San Diego,073,3302833,55548,53279,1469,54748,863
2020-10-21,San Francisco,075,870044,12149,11976,44,12020,137
2020-10-21,San Joaquin,077,732212,21747,21201,181,21382,495
2020-10-21,San Luis Obispo,079,281455,4319,4055,23,4078,31
2020-10-21,San Mateo,081,765935,11248,10730,11,10741,155
2020-10-21,Santa Barbara,083,443738,9879,9681,91,9772,121
2020-10-21,Santa Clara,085,1922200,25095,23537,50,23587,361
2020-10-21,Santa Cruz,087,273765,2832,2729,32,2761,24
2020-10-21,Shasta,089,179085,2075,1777,19,1796,27
2020-10-21,Sierra,091,2930,6,6,0,6,0
2020-10-21,Siskiyou,093,43540,197,169,10,179,0
2020-10-21,Solano,095,438530,7300,7088,39,7127,59
2020-10-21,Sonoma,097,501317,9421,8987,26,9013,138
2020-10-21,Stanislaus,099,539301,17635,17419,710,18129,392
2020-10-21,Sutter,101,95872,1824,1786,1,1787,12
2020-10-21,Tehama,103,63373,889,824,2,826,5
2020-10-21,Trinity,105,12862,78,25,9,34,0
2020-10-21,Tulare,107,460477,17847,17204,315,17519,292
2020-10-21,Tuolumne,109,53932,276,251,5,256,4
2020-10-21,Ventura,111,848112,14829,14050,313,14363,153
2020-10-21,Yolo,113,214977,3231,3095,10,3105,58
2020-10-21,Yuba,115,75493,1237,1194,5,1199,10
2020-10-20,Alameda,001,1643700,23408,22750,212,22962,391
2020-10-20,Alpine,003,1148,3,3,0,3,0
2020-10-20,Amador,005,37829,333,313,0,313,16
2020-10-20,Butte,007,227075,3163,3027,35,3062,56
2020-10-20,Calaveras,009,45235,330,273,0,273,13
2020-10-20,Colusa,011,21464,547,546,1,547,6
2020-10-20,Contra Costa,013,1133247,18800,18246,92,18338,241
2020-10-20,Del Norte,015,27424,172,169,0,169,2
2020-10-20,El Dorado,017,186661,1377,1295,11,1306,4
2020-10-20,Fresno,019,978130,33200,30220,449,30669,431
2020-10-20,Glenn,021,27897,662,638,1,639,3
2020-10-20,Humboldt,023,135768,557,545,1,546,7
2020-10-20,Imperial,025,180216,12735,12114,15,12129,330
2020-10-20,Inyo,027,18085,237,218,5,223,14
2020-10-20,Kern,029,883053,33694,32889,392,33281,429
2020-10-20,Kings,031,150075,8409,8178,47,8225,80
2020-10-20,Lake,033,64148,708,675,0,675,15
2020-10-20,Lassen,035,31185,769,757,2,759,0
2020-10-20,Los Angeles,037,10098052,297152,287727,2653,290380,6891
2020-10-20,Madera,039,155013,4988,4823,37,4860,52
2020-10-20,Marin,041,260295,7102,6994,19,7013,101
2020-10-20,Mariposa,043,17540,79,77,0,77,2
2020-10-20,Mendocino,045,87422,1064,1004,4,1008,21
2020-10-20,Merced,047,269075,9457,9323,33,9356,149
2020-10-20,Modoc,049,8938,32,26,0,26,0
2020-10-20,Mono,051,14174,187,156,5,161,1
2020-10-20,Monterey,053,433212,11232,10942,49,10991,81
2020-10-20,Napa,055,140530,1987,1912,8,1920,13
2020-10-20,Nevada,057,99092,619,596,18,614,8
2020-10-20,Orange,059,3164182,59935,56914,1704,58618,1397
2020-10-20,Placer,061,380077,4230,3997,15,4012,56
2020-10-20,Plumas,063,18699,66,53,0,53,0
2020-10-20,Riverside,065,2383286,66380,64452,297,64749,1275
2020-10-20,Sacramento,067,1510023,25231,24767,26,24793,485
2020-10-20,San Benito,069,59416,1421,1398,1,1399,14
2020-10-20,San Bernardino,071,2135413,62513,59571,407,59978,1109
2020-10-20,San Diego,073,3302833,55212,53004,1449,54453,857
2020-10-20,San Francisco,075,870044,12102,12013,43,12056,126
2020-10-20,San Joaquin,077,732212,21668,21173,172,21345,490
2020-10-20,San Luis Obispo,079,281455,4301,4043,22,4065,31
2020-10-20,San Mateo,081,765935,11201,10659,11,10670,155
2020-10-20,Santa Barbara,083,443738,9850,9664,89,9753,121
2020-10-20,Santa Clara,085,1922200,24957,23406,50,23456,358
2020-10-20,Santa Cruz,087,273765,2809,2710,32,2742,23
2020-10-20,Shasta,089,179085,2052,1747,19,1766,20
2020-10-20,Sierra,091,2930,6,6,0,6,0
2020-10-20,Siskiyou,093,43540,189,168,10,178,0
2020-10-20,Solano,095,438530,7251,7044,39,7083,57
2020-10-20,Sonoma,097,501317,9358,8904,24,8928,135
2020-10-20,Stanislaus,099,539301,17581,17367,706,18073,393
2020-10-20,Sutter,101,95872,1815,1783,1,1784,12
2020-10-20,Tehama,103,63373,874,813,2,815,5
2020-10-20,Trinity,105,12862,77,25,9,34,0
2020-10-20,Tulare,107,460477,17780,17156,310,17466,289
2020-10-20,Tuolumne,109,53932,274,250,5,255,4
2020-10-20,Ventura,111,848112,14765,13980,311,14291,152
2020-10-20,Yolo,113,214977,3208,3083,10,3093,56
2020-10-20,Yuba,115,75493,1227,1191,5,1196,10
2020-10-19,Alameda,001,1643700,23298,22647,211,22858,392
2020-10-19,Alpine,003,1148,3,3,0,3,0
2020-10-19,Amador,005,37829,327,313,0,313,16
2020-10-19,Butte,007,227075,3152,3026,35,3061,55
2020-10-19,Calaveras,009,45235,329,268,0,268,13
2020-10-19,Colusa,011,21464,547,544,1,545,6
2020-10-19,Contra Costa,013,1133247,18702,18173,92,18265,239
2020-10-19,Del Norte,015,27424,169,167,0,167,2
2020-10-19,El Dorado,017,186661,1356,1287,11,1298,4
2020-10-19,Fresno,019,978130,33091,30152,443,30595,431
2020-10-19,Glenn,021,27897,657,635,0,635,3
2020-10-19,Humboldt,023,135768,557,543,1,544,7
2020-10-19,Imperial,025,180216,12681,12036,14,12050,330
2020-10-19,Inyo,027,18085,236,218,5,223,14
2020-10-19,Kern,029,883053,33618,32840,389,33229,428
2020-10-19,Kings,031,150075,8391,8173,47,8220,80
2020-10-19,Lake,033,64148,705,673,0,673,15
2020-10-19,Lassen,035,31185,768,757,2,759,0
2020-10-19,Los Angeles,037,10098052,295668,287119,2615,289734,6858
2020-10-19,Madera,039,155013,4973,4787,37,4824,52
2020-10-19,Marin,041,260295,7084,6981,19,7000,100
2020-10-19,Mariposa,043,17540,79,77,0,77,2
2020-10-19,Mendocino,045,87422,1059,1001,4,1005,21
2020-10-19,Merced,047,269075,9432,9305,30,9335,148
2020-10-19,Modoc,049,8938,31,26,0,26,0
2020-10-19,Mono,051,14174,182,156,5,161,1
2020-10-19,Monterey,053,433212,11171,10907,49,10956,80
2020-10-19,Napa,055,140530,1975,1892,8,1900,12
2020-10-19,Nevada,057,99092,616,590,18,608,8
2020-10-19,Orange,059,3164182,59652,56652,1689,58341,1396
2020-10-19,Placer,061,380077,4181,3962,15,3977,49
2020-10-19,Plumas,063,18699,64,52,0,52,0
2020-10-19,Riverside,065,2383286,65949,64016,281,64297,1272
2020-10-19,Sacramento,067,1510023,25092,24542,26,24568,483
2020-10-19,San Benito,069,59416,1414,1395,1,1396,14
2020-10-19,San Bernardino,071,2135413,62061,59265,395,59660,1100
2020-10-19,San Diego,073,3302833,54826,52739,1424,54163,853
2020-10-19,San Francisco,075,870044,12058,11879,43,11922,126
2020-10-19,San Joaquin,077,732212,21593,20930,164,21094,489
2020-10-19,San Luis Obispo,079,281455,4285,4016,22,4038,31
2020-10-19,San Mateo,081,765935,11155,10568,11,10579,154
2020-10-19,Santa Barbara,083,443738,9814,9632,89,9721,121
2020-10-19,Santa Clara,085,1922200,24807,23301,50,23351,352
2020-10-19,Santa Cruz,087,273765,2792,2705,32,2737,19
2020-10-19,Shasta,089,179085,2008,1709,18,1727,20
2020-10-19,Sierra,091,2930,6,6,0,6,0
2020-10-19,Siskiyou,093,43540,182,167,10,177,0
2020-10-19,Solano,095,438530,7210,7003,39,7042,57
2020-10-19,Sonoma,097,501317,9271,8830,24,8854,135
2020-10-19,Stanislaus,099,539301,17530,17342,696,18038,390
2020-10-19,Sutter,101,95872,1810,1773,1,1774,12
2020-10-19,Tehama,103,63373,871,793,2,795,5
2020-10-19,Trinity,105,12862,75,23,9,32,0
2020-10-19,Tulare,107,460477,17730,17047,303,17350,291
2020-10-19,Tuolumne,109,53932,272,247,5,252,4
2020-10-19,Ventura,111,848112,14700,13930,308,14238,152
2020-10-19,Yolo,113,214977,3195,3069,10,3079,56
2020-10-19,Yuba,115,75493,1220,1183,5,1188,10
2020-10-18,Alameda,001,1643700,23194,22546,210,22756,392
2020-10-18,Alpine,003,1148,3,3,0,3,0
2020-10-18,Amador,005,37829,316,313,0,313,16
2020-10-18,Butte,007,227075,3139,3019,35,3054,55
2020-10-18,Calaveras,009,45235,328,267,0,267,13
2020-10-18,Colusa,011,21464,545,544,1,545,6
2020-10-18,Contra Costa,013,1133247,18604,18120,92,18212,237
2020-10-18,Del Norte,015,27424,169,167,0,167,2
2020-10-18,El Dorado,017,186661,1347,1283,11,1294,4
2020-10-18,Fresno,019,978130,32962,30051,435,30486,430
2020-10-18,Glenn,021,27897,655,634,0,634,3
2020-10-18,Humboldt,023,135768,554,540,1,541,7
2020-10-18,Imperial,025,180216,12618,11987,13,12000,330
2020-10-18,Inyo,027,18085,233,215,5,220,14
2020-10-18,Kern,029,883053,33545,32799,382,33181,428
2020-10-18,Kings,031,150075,8376,8159,47,8206,80
2020-10-18,Lake,033,64148,698,670,0,670,15
2020-10-18,Lassen,035,31185,768,757,2,759,0
2020-10-18,Los Angeles,037,10098052,293959,286187,2573,288760,6857
2020-10-18,Madera,039,155013,4948,4770,36,4806,52
2020-10-18,Marin,041,260295,7063,6969,19,6988,99
2020-10-18,Mariposa,043,17540,79,77,0,77,2
2020-10-18,Mendocino,045,87422,1057,988,4,992,21
2020-10-18,Merced,047,269075,9397,9292,30,9322,148
2020-10-18,Modoc,049,8938,30,26,0,26,0
2020-10-18,Mono,051,14174,177,155,5,160,1
2020-10-18,Monterey,053,433212,11118,10872,49,10921,80
2020-10-18,Napa,055,140530,1962,1882,8,1890,12
2020-10-18,Nevada,057,99092,610,582,18,600,8
2020-10-18,Orange,059,3164182,59355,56394,1672,58066,1396
2020-10-18,Placer,061,380077,4133,3938,15,3953,49
2020-10-18,Plumas,063,18699,62,52,0,52,0
2020-10-18,Riverside,065,2383286,65636,63765,260,64025,1270
2020-10-18,Sacramento,067,1510023,24936,24425,26,24451,482
2020-10-18,San Benito,069,59416,1407,1395,1,1396,14
2020-10-18,San Bernardino,071,2135413,61562,58893,387,59280,1098
2020-10-18,San Diego,073,3302833,54437,52359,1403,53762,853
2020-10-18,San Francisco,075,870044,12019,11878,43,11921,126
2020-10-18,San Joaquin,077,732212,21510,20931,151,21082,489
2020-10-18,San Luis Obispo,079,281455,4254,4009,20,4029,31
2020-10-18,San Mateo,081,765935,11096,10503,11,10514,154
2020-10-18,Santa Barbara,083,443738,9775,9608,88,9696,121
2020-10-18,Santa Clara,085,1922200,24634,23169,50,23219,352
2020-10-18,Santa Cruz,087,273765,2778,2692,32,2724,19
2020-10-18,Shasta,089,179085,1983,1708,18,1726,20
2020-10-18,Sierra,091,2930,6,6,0,6,0
2020-10-18,Siskiyou,093,43540,182,167,10,177,0
2020-10-18,Solano,095,438530,7163,6962,39,7001,57
2020-10-18,Sonoma,097,501317,9194,8781,23,8804,134
2020-10-18,Stanislaus,099,539301,17474,17290,687,17977,390
2020-10-18,Sutter,101,95872,1801,1764,1,1765,12
2020-10-18,Tehama,103,63373,839,774,2,776,5
2020-10-18,Trinity,105,12862,75,20,9,29,0
2020-10-18,Tulare,107,460477,17636,17048,294,17342,290
2020-10-18,Tuolumne,109,53932,266,245,5,250,4
2020-10-18,Ventura,111,848112,14620,13901,307,14208,151
2020-10-18,Yolo,113,214977,3156,3059,10,3069,55
2020-10-18,Yuba,115,75493,1209,1176,5,1181,10
2020-10-17,Alameda,001,1643700,23149,22394,208,22602,398
2020-10-17,Alpine,003,1148,3,3,0,3,0
2020-10-17,Amador,005,37829,314,309,0,309,16
2020-10-17,Butte,007,227075,3131,3012,33,3045,55
2020-10-17,Calaveras,009,45235,328,267,0,267,13
2020-10-17,Colusa,011,21464,544,544,1,545,6
2020-10-17,Contra Costa,013,1133247,18550,18005,92,18097,237
2020-10-17,Del Norte,015,27424,169,167,0,167,2
2020-10-17,El Dorado,017,186661,1343,1277,11,1288,4
2020-10-17,Fresno,019,978130,32908,29911,433,30344,430
2020-10-17,Glenn,021,27897,652,633,0,633,3
2020-10-17,Humboldt,023,135768,551,535,1,536,7
2020-10-17,Imperial,025,180216,12590,11962,13,11975,330
2020-10-17,Inyo,027,18085,228,212,5,217,14
2020-10-17,Kern,029,883053,33494,32710,379,33089,428
2020-10-17,Kings,031,150075,8370,8151,46,8197,80
2020-10-17,Lake,033,64148,695,663,0,663,15
2020-10-17,Lassen,035,31185,768,757,2,759,0
2020-10-17,Los Angeles,037,10098052,293205,285858,2546,288404,6844
2020-10-17,Madera,039,155013,4942,4759,36,4795,53
2020-10-17,Marin,041,260295,7060,6958,19,6977,99
2020-10-17,Mariposa,043,17540,78,77,0,77,2
2020-10-17,Mendocino,045,87422,1050,977,4,981,21
2020-10-17,Merced,047,269075,9383,9275,30,9305,148
2020-10-17,Modoc,049,8938,30,26,0,26,0
2020-10-17,Mono,051,14174,176,155,5,160,1
2020-10-17,Monterey,053,433212,11079,10807,48,10855,80
2020-10-17,Napa,055,140530,1953,1866,8,1874,12
2020-10-17,Nevada,057,99092,609,580,18,598,8
2020-10-17,Orange,059,3164182,59213,56197,1666,57863,1396
2020-10-17,Placer,061,380077,4106,3898,15,3913,49
2020-10-17,Plumas,063,18699,62,52,0,52,0
2020-10-17,Riverside,065,2383286,65438,63171,251,63422,1270
2020-10-17,Sacramento,067,1510023,24852,24304,26,24330,482
2020-10-17,San Benito,069,59416,1403,1389,1,1390,14
2020-10-17,San Bernardino,071,2135413,61291,58415,380,58795,1097
2020-10-17,San Diego,073,3302833,54212,51986,1392,53378,853
2020-10-17,San Francisco,075,870044,11992,11877,42,11919,126
2020-10-17,San Joaquin,077,732212,21456,20932,145,21077,489
2020-10-17,San Luis Obispo,079,281455,4239,3979,20,3999,31
2020-10-17,San Mateo,081,765935,11068,10423,11,10434,153
2020-10-17,Santa Barbara,083,443738,9756,9588,86,9674,121
2020-10-17,Santa Clara,085,1922200,24544,22997,50,23047,349
2020-10-17,Santa Cruz,087,273765,2764,2680,32,2712,19
2020-10-17,Shasta,089,179085,1957,1679,18,1697,20
2020-10-17,Sierra,091,2930,6,6,0,6,0
2020-10-17,Siskiyou,093,43540,181,167,10,177,0
2020-10-17,Solano,095,438530,7137,6929,39,6968,57
2020-10-17,Sonoma,097,501317,9151,8725,23,8748,134
2020-10-17,Stanislaus,099,539301,17434,17232,678,17910,390
2020-10-17,Sutter,101,95872,1799,1762,1,1763,12
2020-10-17,Tehama,103,63373,823,764,2,766,5
2020-10-17,Trinity,105,12862,75,20,9,29,0
2020-10-17,Tulare,107,460477,17606,16995,285,17280,290
2020-10-17,Tuolumne,109,53932,266,241,5,246,4
2020-10-17,Ventura,111,848112,14575,13845,304,14149,151
2020-10-17,Yolo,113,214977,3141,3045,9,3054,55
2020-10-17,Yuba,115,75493,1204,1164,5,1169,10
2020-10-16,Alameda,001,1643700,23095,22315,208,22523,397
2020-10-16,Alpine,003,1148,3,3,0,3,0
2020-10-16,Amador,005,37829,314,309,0,309,16
2020-10-16,Butte,007,227075,3120,3004,33,3037,54
2020-10-16,Calaveras,009,45235,328,267,0,267,13
2020-10-16,Colusa,011,21464,543,544,1,545,6
2020-10-16,Contra Costa,013,1133247,18497,17956,92,18048,237
2020-10-16,Del Norte,015,27424,169,166,0,166,2
2020-10-16,El Dorado,017,186661,1337,1273,11,1284,4
2020-10-16,Fresno,019,978130,32833,29796,432,30228,427
2020-10-16,Glenn,021,27897,647,632,0,632,3
2020-10-16,Humboldt,023,135768,551,533,1,534,7
2020-10-16,Imperial,025,180216,12550,11885,13,11898,330
2020-10-16,Inyo,027,18085,224,212,5,217,14
2020-10-16,Kern,029,883053,33451,32660,377,33037,428
2020-10-16,Kings,031,150075,8361,8146,45,8191,80
2020-10-16,Lake,033,64148,693,644,0,644,14
2020-10-16,Lassen,035,31185,768,757,2,759,0
2020-10-16,Los Angeles,037,10098052,292141,284988,2525,287513,6835
2020-10-16,Madera,039,155013,4930,4736,35,4771,53
2020-10-16,Marin,041,260295,7050,6933,19,6952,99
2020-10-16,Mariposa,043,17540,78,76,0,76,2
2020-10-16,Mendocino,045,87422,1043,974,4,978,21
2020-10-16,Merced,047,269075,9366,9246,30,9276,148
2020-10-16,Modoc,049,8938,30,26,0,26,0
2020-10-16,Mono,051,14174,174,155,5,160,1
2020-10-16,Monterey,053,433212,11044,10727,48,10775,79
2020-10-16,Napa,055,140530,1944,1855,8,1863,12
2020-10-16,Nevada,057,99092,607,579,18,597,8
2020-10-16,Orange,059,3164182,59035,56091,1660,57751,1388
2020-10-16,Placer,061,380077,4086,3864,15,3879,49
2020-10-16,Plumas,063,18699,61,52,0,52,0
2020-10-16,Riverside,065,2383286,65212,62986,250,63236,1267
2020-10-16,Sacramento,067,1510023,24758,24144,26,24170,479
2020-10-16,San Benito,069,59416,1400,1388,1,1389,14
2020-10-16,San Bernardino,071,2135413,61022,58233,380,58613,1069
2020-10-16,San Diego,073,3302833,53970,51785,1378,53163,850
2020-10-16,San Francisco,075,870044,11970,11840,41,11881,126
2020-10-16,San Joaquin,077,732212,21411,20910,144,21054,489
2020-10-16,San Luis Obispo,079,281455,4223,3952,20,3972,32
2020-10-16,San Mateo,081,765935,11042,10405,11,10416,153
2020-10-16,Santa Barbara,083,443738,9737,9549,86,9635,119
2020-10-16,Santa Clara,085,1922200,24456,22920,50,22970,345
2020-10-16,Santa Cruz,087,273765,2751,2666,32,2698,20
2020-10-16,Shasta,089,179085,1935,1660,18,1678,20
2020-10-16,Sierra,091,2930,6,6,0,6,0
2020-10-16,Siskiyou,093,43540,179,167,10,177,0
2020-10-16,Solano,095,438530,7114,6879,39,6918,55
2020-10-16,Sonoma,097,501317,9095,8652,23,8675,133
2020-10-16,Stanislaus,099,539301,17400,17201,670,17871,366
2020-10-16,Sutter,101,95872,1791,1756,1,1757,12
2020-10-16,Tehama,103,63373,822,737,2,739,3
2020-10-16,Trinity,105,12862,75,20,9,29,0
2020-10-16,Tulare,107,460477,17574,16965,277,17242,290
2020-10-16,Tuolumne,109,53932,264,237,5,242,4
2020-10-16,Ventura,111,848112,14532,13805,299,14104,152
2020-10-16,Yolo,113,214977,3132,3030,9,3039,55
2020-10-16,Yuba,115,75493,1204,1155,5,1160,10
2020-10-15,Alameda,001,1643700,23027,22267,207,22474,390
2020-10-15,Alpine,003,1148,3,3,0,3,0
2020-10-15,Amador,005,37829,314,309,0,309,16
2020-10-15,Butte,007,227075,3108,3000,32,3032,54
2020-10-15,Calaveras,009,45235,327,267,0,267,13
2020-10-15,Colusa,011,21464,542,543,1,544,6
2020-10-15,Contra Costa,013,1133247,18430,17893,91,17984,237
2020-10-15,Del Norte,015,27424,169,164,0,164,2
2020-10-15,El Dorado,017,186661,1332,1265,11,1276,4
2020-10-15,Fresno,019,978130,32736,29727,429,30156,425
2020-10-15,Glenn,021,27897,642,632,0,632,3
2020-10-15,Humboldt,023,135768,547,531,1,532,7
2020-10-15,Imperial,025,180216,12509,11820,12,11832,330
2020-10-15,Inyo,027,18085,224,210,5,215,14
2020-10-15,Kern,029,883053,33370,32593,374,32967,427
2020-10-15,Kings,031,150075,8346,8134,45,8179,80
2020-10-15,Lake,033,64148,691,642,0,642,14
2020-10-15,Lassen,035,31185,767,752,2,754,0
2020-10-15,Los Angeles,037,10098052,290856,284019,2492,286511,6807
2020-10-15,Madera,039,155013,4918,4723,34,4757,50
2020-10-15,Marin,041,260295,7042,6912,19,6931,99
2020-10-15,Mariposa,043,17540,78,76,0,76,2
2020-10-15,Mendocino,045,87422,1037,963,4,967,21
2020-10-15,Merced,047,269075,9339,9213,30,9243,147
2020-10-15,Modoc,049,8938,30,26,0,26,0
2020-10-15,Mono,051,14174,174,155,5,160,1
2020-10-15,Monterey,053,433212,10977,10677,47,10724,79
2020-10-15,Napa,055,140530,1931,1842,8,1850,12
2020-10-15,Nevada,057,99092,603,575,18,593,8
2020-10-15,Orange,059,3164182,58819,55952,1648,57600,1379
2020-10-15,Placer,061,380077,4057,3848,15,3863,48
2020-10-15,Plumas,063,18699,58,52,0,52,0
2020-10-15,Riverside,065,2383286,64879,62819,247,63066,1266
2020-10-15,Sacramento,067,1510023,24642,24068,26,24094,474
2020-10-15,San Benito,069,59416,1397,1384,1,1385,14
2020-10-15,San Bernardino,071,2135413,60683,58068,377,58445,1067
2020-10-15,San Diego,073,3302833,53686,51472,1362,52834,847
2020-10-15,San Francisco,075,870044,11942,11808,38,11846,126
2020-10-15,San Joaquin,077,732212,21338,20880,138,21018,487
2020-10-15,San Luis Obispo,079,281455,4207,3934,20,3954,32
2020-10-15,San Mateo,081,765935,11002,10340,11,10351,152
2020-10-15,Santa Barbara,083,443738,9713,9526,85,9611,117
2020-10-15,Santa Clara,085,1922200,24341,22808,50,22858,343
2020-10-15,Santa Cruz,087,273765,2737,2656,32,2688,13
2020-10-15,Shasta,089,179085,1924,1635,18,1653,20
2020-10-15,Sierra,091,2930,6,6,0,6,0
2020-10-15,Siskiyou,093,43540,175,166,10,176,0
2020-10-15,Solano,095,438530,7075,6830,39,6869,55
2020-10-15,Sonoma,097,501317,9003,8571,23,8594,133
2020-10-15,Stanislaus,099,539301,17362,17151,656,17807,366
2020-10-15,Sutter,101,95872,1788,1752,1,1753,12
2020-10-15,Tehama,103,63373,795,726,2,728,3
2020-10-15,Trinity,105,12862,75,20,9,29,0
2020-10-15,Tulare,107,460477,17514,16918,262,17180,289
2020-10-15,Tuolumne,109,53932,262,236,5,241,4
2020-10-15,Ventura,111,848112,14476,13750,294,14044,152
2020-10-15,Yolo,113,214977,3112,3014,9,3023,55
2020-10-15,Yuba,115,75493,1197,1151,5,1156,10
2020-10-14,Alameda,001,1643700,22928,22227,206,22433,398
2020-10-14,Alpine,003,1148,3,3,0,3,0
2020-10-14,Amador,005,37829,312,308,0,308,16
2020-10-14,Butte,007,227075,3100,2995,32,3027,54
2020-10-14,Calaveras,009,45235,327,266,0,266,12
2020-10-14,Colusa,011,21464,542,543,1,544,6
2020-10-14,Contra Costa,013,1133247,18372,17820,89,17909,236
2020-10-14,Del Norte,015,27424,168,163,0,163,2
2020-10-14,El Dorado,017,186661,1326,1264,10,1274,4
2020-10-14,Fresno,019,978130,32621,29650,423,30073,424
2020-10-14,Glenn,021,27897,641,629,0,629,3
2020-10-14,Humboldt,023,135768,544,531,1,532,7
2020-10-14,Imperial,025,180216,12472,11765,10,11775,330
2020-10-14,Inyo,027,18085,223,209,4,213,14
2020-10-14,Kern,029,883053,33295,32528,372,32900,425
2020-10-14,Kings,031,150075,8328,8118,45,8163,80
2020-10-14,Lake,033,64148,690,642,0,642,14
2020-10-14,Lassen,035,31185,765,752,2,754,0
2020-10-14,Los Angeles,037,10098052,289542,282918,2448,285366,6786
2020-10-14,Madera,039,155013,4903,4713,33,4746,50
2020-10-14,Marin,041,260295,7036,6907,19,6926,99
2020-10-14,Mariposa,043,17540,77,76,0,76,2
2020-10-14,Mendocino,045,87422,1031,955,4,959,21
2020-10-14,Merced,047,269075,9314,9201,28,9229,147
2020-10-14,Modoc,049,8938,30,27,0,27,0
2020-10-14,Mono,051,14174,174,155,5,160,1
2020-10-14,Monterey,053,433212,10927,10616,47,10663,78
2020-10-14,Napa,055,140530,1914,1837,8,1845,12
2020-10-14,Nevada,057,99092,601,573,18,591,7
2020-10-14,Orange,059,3164182,58606,55756,1639,57395,1348
2020-10-14,Placer,061,380077,4034,3829,15,3844,48
2020-10-14,Plumas,063,18699,54,52,0,52,0
2020-10-14,Riverside,065,2383286,64596,62607,246,62853,1261
2020-10-14,Sacramento,067,1510023,24498,24013,26,24039,472
2020-10-14,San Benito,069,59416,1395,1381,0,1381,14
2020-10-14,San Bernardino,071,2135413,60356,57774,373,58147,1063
2020-10-14,San Diego,073,3302833,53367,51329,1338,52667,844
2020-10-14,San Francisco,075,870044,11910,11783,37,11820,123
2020-10-14,San Joaquin,077,732212,21259,20845,124,20969,487
2020-10-14,San Luis Obispo,079,281455,4184,3901,19,3920,32
2020-10-14,San Mateo,081,765935,10951,10309,11,10320,132
2020-10-14,Santa Barbara,083,443738,9679,9509,85,9594,117
2020-10-14,Santa Clara,085,1922200,24192,22735,50,22785,343
2020-10-14,Santa Cruz,087,273765,2727,2618,32,2650,13
2020-10-14,Shasta,089,179085,1886,1553,18,1571,20
2020-10-14,Sierra,091,2930,6,6,0,6,0
2020-10-14,Siskiyou,093,43540,175,166,10,176,0
2020-10-14,Solano,095,438530,7019,6786,39,6825,55
2020-10-14,Sonoma,097,501317,8950,8514,23,8537,133
2020-10-14,Stanislaus,099,539301,17317,17105,653,17758,365
2020-10-14,Sutter,101,95872,1779,1747,1,1748,12
2020-10-14,Tehama,103,63373,784,721,2,723,3
2020-10-14,Trinity,105,12862,74,20,9,29,0
2020-10-14,Tulare,107,460477,17452,16863,249,17112,287
2020-10-14,Tuolumne,109,53932,261,236,5,241,4
2020-10-14,Ventura,111,848112,14423,13697,290,13987,152
2020-10-14,Yolo,113,214977,3094,3007,8,3015,55
2020-10-14,Yuba,115,75493,1189,1147,5,1152,10
2020-10-13,Alameda,001,1643700,22823,22185,204,22389,389
2020-10-13,Alpine,003,1148,3,3,0,3,0
2020-10-13,Amador,005,37829,310,306,0,306,16
2020-10-13,Butte,007,227075,3091,2992,32,3024,54
2020-10-13,Calaveras,009,45235,323,262,0,262,12
2020-10-13,Colusa,011,21464,542,541,1,542,6
2020-10-13,Contra Costa,013,1133247,18315,17783,89,17872,234
2020-10-13,Del Norte,015,27424,168,163,0,163,2
2020-10-13,El Dorado,017,186661,1317,1262,10,1272,4
2020-10-13,Fresno,019,978130,32499,29579,419,29998,424
2020-10-13,Glenn,021,27897,640,629,0,629,3
2020-10-13,Humboldt,023,135768,542,523,1,524,7
2020-10-13,Imperial,025,180216,12437,11727,10,11737,327
2020-10-13,Inyo,027,18085,220,207,4,211,14
2020-10-13,Kern,029,883053,33220,32497,370,32867,419
2020-10-13,Kings,031,150075,8319,8111,45,8156,80
2020-10-13,Lake,033,64148,687,639,0,639,12
2020-10-13,Lassen,035,31185,763,752,2,754,0
2020-10-13,Los Angeles,037,10098052,288261,281716,2407,284123,6767
2020-10-13,Madera,039,155013,4885,4700,33,4733,50
2020-10-13,Marin,041,260295,7014,6900,18,6918,97
2020-10-13,Mariposa,043,17540,77,76,0,76,2
2020-10-13,Mendocino,045,87422,1022,950,4,954,21
2020-10-13,Merced,047,269075,9297,9181,28,9209,146
2020-10-13,Modoc,049,8938,29,28,0,28,0
2020-10-13,Mono,051,14174,174,155,4,159,1
2020-10-13,Monterey,053,433212,10866,10574,46,10620,78
2020-10-13,Napa,055,140530,1905,1825,8,1833,12
2020-10-13,Nevada,057,99092,594,572,18,590,7
2020-10-13,Orange,059,3164182,58393,55515,1626,57141,1326
2020-10-13,Placer,061,380077,3996,3825,15,3840,48
2020-10-13,Plumas,063,18699,52,51,0,51,0
2020-10-13,Riverside,065,2383286,64277,62279,244,62523,1254
2020-10-13,Sacramento,067,1510023,24421,23930,26,23956,466
2020-10-13,San Benito,069,59416,1387,1380,0,1380,14
2020-10-13,San Bernardino,071,2135413,60017,57411,371,57782,1061
2020-10-13,San Diego,073,3302833,53074,51026,1321,52347,840
2020-10-13,San Francisco,075,870044,11875,11659,37,11696,122
2020-10-13,San Joaquin,077,732212,21198,20822,120,20942,481
2020-10-13,San Luis Obispo,079,281455,4167,3892,18,3910,32
2020-10-13,San Mateo,081,765935,10908,10286,11,10297,130
2020-10-13,Santa Barbara,083,443738,9648,9489,85,9574,117
2020-10-13,Santa Clara,085,1922200,24065,22678,50,22728,343
2020-10-13,Santa Cruz,087,273765,2709,2603,32,2635,13
2020-10-13,Shasta,089,179085,1862,1606,18,1624,20
2020-10-13,Sierra,091,2930,6,6,0,6,0
2020-10-13,Siskiyou,093,43540,174,163,10,173,0
2020-10-13,Solano,095,438530,6984,6761,39,6800,55
2020-10-13,Sonoma,097,501317,8867,8456,23,8479,133
2020-10-13,Stanislaus,099,539301,17272,17082,648,17730,362
2020-10-13,Sutter,101,95872,1770,1748,1,1749,12
2020-10-13,Tehama,103,63373,776,717,2,719,3
2020-10-13,Trinity,105,12862,70,19,8,27,0
2020-10-13,Tulare,107,460477,17394,16822,241,17063,286
2020-10-13,Tuolumne,109,53932,259,235,5,240,4
2020-10-13,Ventura,111,848112,14368,13645,286,13931,151
2020-10-13,Yolo,113,214977,3086,2983,7,2990,55
2020-10-13,Yuba,115,75493,1184,1143,5,1148,10
2020-10-12,Alameda,001,1643700,22743,22126,203,22329,389
2020-10-12,Alpine,003,1148,3,3,0,3,0
2020-10-12,Amador,005,37829,309,305,0,305,16
2020-10-12,Butte,007,227075,3085,2975,32,3007,54
2020-10-12,Calaveras,009,45235,323,262,0,262,12
2020-10-12,Colusa,011,21464,542,541,1,542,6
2020-10-12,Contra Costa,013,1133247,18240,17728,89,17817,233
2020-10-12,Del Norte,015,27424,168,161,0,161,2
2020-10-12,El Dorado,017,186661,1314,1254,10,1264,4
2020-10-12,Fresno,019,978130,32366,29523,415,29938,421
2020-10-12,Glenn,021,27897,639,626,0,626,3
2020-10-12,Humboldt,023,135768,539,522,1,523,7
2020-10-12,Imperial,025,180216,12398,11689,10,11699,328
2020-10-12,Inyo,027,18085,217,201,4,205,14
2020-10-12,Kern,029,883053,33127,32425,367,32792,419
2020-10-12,Kings,031,150075,8313,8106,45,8151,80
2020-10-12,Lake,033,64148,681,633,0,633,12
2020-10-12,Lassen,035,31185,763,752,2,754,0
2020-10-12,Los Angeles,037,10098052,287041,280961,2380,283341,6747
2020-10-12,Madera,039,155013,4866,4689,33,4722,50
2020-10-12,Marin,041,260295,6997,6886,18,6904,97
2020-10-12,Mariposa,043,17540,77,76,0,76,2
2020-10-12,Mendocino,045,87422,1016,947,4,951,21
2020-10-12,Merced,047,269075,9276,9141,28,9169,146
2020-10-12,Modoc,049,8938,29,27,0,27,0
2020-10-12,Mono,051,14174,174,154,4,158,1
2020-10-12,Monterey,053,433212,10800,10473,46,10519,77
2020-10-12,Napa,055,140530,1897,1819,8,1827,11
2020-10-12,Nevada,057,99092,590,570,18,588,7
2020-10-12,Orange,059,3164182,58164,55373,1616,56989,1326
2020-10-12,Placer,061,380077,3964,3808,14,3822,48
2020-10-12,Plumas,063,18699,52,51,0,51,0
2020-10-12,Riverside,065,2383286,63966,62279,240,62519,1254
2020-10-12,Sacramento,067,1510023,24315,23807,26,23833,466
2020-10-12,San Benito,069,59416,1384,1376,0,1376,13
2020-10-12,San Bernardino,071,2135413,59642,57235,370,57605,1061
2020-10-12,San Diego,073,3302833,52784,50748,1294,52042,826
2020-10-12,San Francisco,075,870044,11843,11659,37,11696,122
2020-10-12,San Joaquin,077,732212,21135,20701,114,20815,480
2020-10-12,San Luis Obispo,079,281455,4139,3874,18,3892,32
2020-10-12,San Mateo,081,765935,10860,10262,11,10273,130
2020-10-12,Santa Barbara,083,443738,9610,9462,85,9547,117
2020-10-12,Santa Clara,085,1922200,23949,22578,50,22628,343
2020-10-12,Santa Cruz,087,273765,2692,2590,32,2622,13
2020-10-12,Shasta,089,179085,1837,1515,18,1533,20
2020-10-12,Sierra,091,2930,6,6,0,6,0
2020-10-12,Siskiyou,093,43540,173,162,10,172,0
2020-10-12,Solano,095,438530,6945,6742,39,6781,55
2020-10-12,Sonoma,097,501317,8796,8377,23,8400,133
2020-10-12,Stanislaus,099,539301,17223,17051,639,17690,361
2020-10-12,Sutter,101,95872,1762,1741,1,1742,12
2020-10-12,Tehama,103,63373,760,708,2,710,3
2020-10-12,Trinity,105,12862,69,19,8,27,0
2020-10-12,Tulare,107,460477,17342,16742,234,16976,286
2020-10-12,Tuolumne,109,53932,254,234,5,239,4
2020-10-12,Ventura,111,848112,14306,13617,282,13899,151
2020-10-12,Yolo,113,214977,3071,2964,7,2971,55
2020-10-12,Yuba,115,75493,1173,1141,5,1146,10
2020-10-11,Alameda,001,1643700,22653,22057,199,22256,392
2020-10-11,Alpine,003,1148,3,3,0,3,0
2020-10-11,Amador,005,37829,307,305,0,305,16
2020-10-11,Butte,007,227075,3077,2967,31,2998,54
2020-10-11,Calaveras,009,45235,321,262,0,262,12
2020-10-11,Colusa,011,21464,540,541,1,542,6
2020-10-11,Contra Costa,013,1133247,18156,17678,89,17767,233
2020-10-11,Del Norte,015,27424,166,161,0,161,2
2020-10-11,El Dorado,017,186661,1305,1242,10,1252,4
2020-10-11,Fresno,019,978130,32228,29419,407,29826,421
2020-10-11,Glenn,021,27897,637,625,0,625,3
2020-10-11,Humboldt,023,135768,538,521,1,522,7
2020-10-11,Imperial,025,180216,12338,11614,10,11624,328
2020-10-11,Inyo,027,18085,213,201,4,205,14
2020-10-11,Kern,029,883053,33040,32399,358,32757,418
2020-10-11,Kings,031,150075,8296,8094,44,8138,80
2020-10-11,Lake,033,64148,668,631,0,631,12
2020-10-11,Lassen,035,31185,762,752,2,754,0
2020-10-11,Los Angeles,037,10098052,285601,280190,2339,282529,6745
2020-10-11,Madera,039,155013,4838,4680,32,4712,50
2020-10-11,Marin,041,260295,6988,6870,18,6888,97
2020-10-11,Mariposa,043,17540,77,76,0,76,2
2020-10-11,Mendocino,045,87422,1009,944,4,948,21
2020-10-11,Merced,047,269075,9258,9124,28,9152,146
2020-10-11,Modoc,049,8938,29,27,0,27,0
2020-10-11,Mono,051,14174,174,154,4,158,1
2020-10-11,Monterey,053,433212,10749,10445,44,10489,77
2020-10-11,Napa,055,140530,1881,1811,8,1819,11
2020-10-11,Nevada,057,99092,588,569,18,587,7
2020-10-11,Orange,059,3164182,57934,55202,1610,56812,1326
2020-10-11,Placer,061,380077,3943,3787,14,3801,48
2020-10-11,Plumas,063,18699,52,51,0,51,0
2020-10-11,Riverside,065,2383286,63678,62112,236,62348,1254
2020-10-11,Sacramento,067,1510023,24172,23778,26,23804,466
2020-10-11,San Benito,069,59416,1383,1374,0,1374,13
2020-10-11,San Bernardino,071,2135413,59190,56997,368,57365,1061
2020-10-11,San Diego,073,3302833,52434,50553,1272,51825,826
2020-10-11,San Francisco,075,870044,11800,11659,37,11696,122
2020-10-11,San Joaquin,077,732212,21060,20700,104,20804,480
2020-10-11,San Luis Obispo,079,281455,4122,3874,17,3891,32
2020-10-11,San Mateo,081,765935,10828,10240,11,10251,130
2020-10-11,Santa Barbara,083,443738,9579,9440,84,9524,117
2020-10-11,Santa Clara,085,1922200,23807,22487,49,22536,336
2020-10-11,Santa Cruz,087,273765,2678,2578,32,2610,13
2020-10-11,Shasta,089,179085,1807,1515,17,1532,20
2020-10-11,Sierra,091,2930,6,6,0,6,0
2020-10-11,Siskiyou,093,43540,172,162,10,172,0
2020-10-11,Solano,095,438530,6891,6685,39,6724,53
2020-10-11,Sonoma,097,501317,8739,8319,23,8342,133
2020-10-11,Stanislaus,099,539301,17159,17007,623,17630,360
2020-10-11,Sutter,101,95872,1759,1742,1,1743,12
2020-10-11,Tehama,103,63373,736,702,2,704,3
2020-10-11,Trinity,105,12862,69,19,8,27,0
2020-10-11,Tulare,107,460477,17278,16741,226,16967,286
2020-10-11,Tuolumne,109,53932,249,234,5,239,4
2020-10-11,Ventura,111,848112,14245,13604,277,13881,151
2020-10-11,Yolo,113,214977,3041,2952,7,2959,55
2020-10-11,Yuba,115,75493,1162,1137,5,1142,10
2020-10-10,Alameda,001,1643700,22603,21979,198,22177,398
2020-10-10,Alpine,003,1148,3,3,0,3,0
2020-10-10,Amador,005,37829,306,304,0,304,16
2020-10-10,Butte,007,227075,3072,2962,30,2992,54
2020-10-10,Calaveras,009,45235,320,262,0,262,12
2020-10-10,Colusa,011,21464,540,541,1,542,6
2020-10-10,Contra Costa,013,1133247,18120,17566,88,17654,233
2020-10-10,Del Norte,015,27424,166,161,0,161,2
2020-10-10,El Dorado,017,186661,1303,1240,10,1250,4
2020-10-10,Fresno,019,978130,32164,29286,405,29691,421
2020-10-10,Glenn,021,27897,637,623,0,623,3
2020-10-10,Humboldt,023,135768,535,518,1,519,7
2020-10-10,Imperial,025,180216,12323,11591,10,11601,327
2020-10-10,Inyo,027,18085,210,201,4,205,14
2020-10-10,Kern,029,883053,33003,32338,358,32696,418
2020-10-10,Kings,031,150075,8292,8078,44,8122,80
2020-10-10,Lake,033,64148,667,630,0,630,11
2020-10-10,Lassen,035,31185,762,752,2,754,0
2020-10-10,Los Angeles,037,10098052,284883,279213,2305,281518,6743
2020-10-10,Madera,039,155013,4825,4662,32,4694,50
2020-10-10,Marin,041,260295,6979,6852,18,6870,97
2020-10-10,Mariposa,043,17540,77,76,0,76,2
2020-10-10,Mendocino,045,87422,1002,935,4,939,21
2020-10-10,Merced,047,269075,9252,9105,27,9132,146
2020-10-10,Modoc,049,8938,29,27,0,27,0
2020-10-10,Mono,051,14174,174,154,4,158,1
2020-10-10,Monterey,053,433212,10716,10410,44,10454,75
2020-10-10,Napa,055,140530,1874,1804,8,1812,11
2020-10-10,Nevada,057,99092,585,564,18,582,6
2020-10-10,Orange,059,3164182,57813,54965,1605,56570,1324
2020-10-10,Placer,061,380077,3926,3757,14,3771,48
2020-10-10,Plumas,063,18699,52,51,0,51,0
2020-10-10,Riverside,065,2383286,63475,61845,234,62079,1254
2020-10-10,Sacramento,067,1510023,24105,23689,26,23715,466
2020-10-10,San Benito,069,59416,1381,1370,0,1370,13
2020-10-10,San Bernardino,071,2135413,59027,56683,366,57049,1061
2020-10-10,San Diego,073,3302833,52204,50145,1254,51399,825
2020-10-10,San Francisco,075,870044,11779,11663,37,11700,122
2020-10-10,San Joaquin,077,732212,21032,20700,100,20800,481
2020-10-10,San Luis Obispo,079,281455,4102,3832,17,3849,32
2020-10-10,San Mateo,081,765935,10791,10218,11,10229,130
2020-10-10,Santa Barbara,083,443738,9568,9417,84,9501,116
2020-10-10,Santa Clara,085,1922200,23716,22354,49,22403,330
2020-10-10,Santa Cruz,087,273765,2664,2572,32,2604,13
2020-10-10,Shasta,089,179085,1790,1473,17,1490,20
2020-10-10,Sierra,091,2930,6,6,0,6,0
2020-10-10,Siskiyou,093,43540,172,161,10,171,0
2020-10-10,Solano,095,438530,6865,6655,39,6694,53
2020-10-10,Sonoma,097,501317,8719,8235,23,8258,133
2020-10-10,Stanislaus,099,539301,17124,16960,615,17575,360
2020-10-10,Sutter,101,95872,1756,1735,1,1736,12
2020-10-10,Tehama,103,63373,729,693,2,695,3
2020-10-10,Trinity,105,12862,69,19,8,27,0
2020-10-10,Tulare,107,460477,17243,16709,221,16930,286
2020-10-10,Tuolumne,109,53932,249,233,5,238,4
2020-10-10,Ventura,111,848112,14220,13520,277,13797,151
2020-10-10,Yolo,113,214977,3032,2939,7,2946,55
2020-10-10,Yuba,115,75493,1160,1134,5,1139,10
2020-10-09,Alameda,001,1643700,22555,21924,198,22122,399
2020-10-09,Alpine,003,1148,3,3,0,3,0
2020-10-09,Amador,005,37829,306,303,0,303,16
2020-10-09,Butte,007,227075,3069,2956,30,2986,51
2020-10-09,Calaveras,009,45235,318,262,0,262,11
2020-10-09,Colusa,011,21464,540,541,1,542,6
2020-10-09,Contra Costa,013,1133247,18070,17487,88,17575,229
2020-10-09,Del Norte,015,27424,165,161,0,161,2
2020-10-09,El Dorado,017,186661,1299,1234,10,1244,4
2020-10-09,Fresno,019,978130,32091,29208,403,29611,417
2020-10-09,Glenn,021,27897,632,617,0,617,3
2020-10-09,Humboldt,023,135768,533,516,1,517,7
2020-10-09,Imperial,025,180216,12296,11516,10,11526,330
2020-10-09,Inyo,027,18085,207,200,4,204,14
2020-10-09,Kern,029,883053,32960,32237,356,32593,417
2020-10-09,Kings,031,150075,8285,7993,42,8035,80
2020-10-09,Lake,033,64148,657,610,0,610,11
2020-10-09,Lassen,035,31185,762,751,2,753,0
2020-10-09,Los Angeles,037,10098052,283748,278039,2280,280319,6715
2020-10-09,Madera,039,155013,4815,4646,32,4678,50
2020-10-09,Marin,041,260295,6965,6838,18,6856,96
2020-10-09,Mariposa,043,17540,77,76,0,76,2
2020-10-09,Mendocino,045,87422,992,933,4,937,20
2020-10-09,Merced,047,269075,9238,9095,27,9122,145
2020-10-09,Modoc,049,8938,29,27,0,27,0
2020-10-09,Mono,051,14174,174,154,4,158,1
2020-10-09,Monterey,053,433212,10682,10369,44,10413,75
2020-10-09,Napa,055,140530,1864,1795,8,1803,11
2020-10-09,Nevada,057,99092,580,561,18,579,6
2020-10-09,Orange,059,3164182,57642,54746,1600,56346,1305
2020-10-09,Placer,061,380077,3912,3737,13,3750,48
2020-10-09,Plumas,063,18699,52,50,0,50,0
2020-10-09,Riverside,065,2383286,63239,61529,233,61762,1252
2020-10-09,Sacramento,067,1510023,24035,23606,26,23632,457
2020-10-09,San Benito,069,59416,1376,1367,0,1367,13
2020-10-09,San Bernardino,071,2135413,58787,56434,364,56798,1057
2020-10-09,San Diego,073,3302833,51928,49825,1243,51068,821
2020-10-09,San Francisco,075,870044,11749,11620,37,11657,120
2020-10-09,San Joaquin,077,732212,21002,20648,92,20740,481
2020-10-09,San Luis Obispo,079,281455,4083,3810,17,3827,32
2020-10-09,San Mateo,081,765935,10763,10140,11,10151,130
2020-10-09,Santa Barbara,083,443738,9540,9396,84,9480,116
2020-10-09,Santa Clara,085,1922200,23614,22251,48,22299,328
2020-10-09,Santa Cruz,087,273765,2655,2555,32,2587,13
2020-10-09,Shasta,089,179085,1764,1353,16,1369,20
2020-10-09,Sierra,091,2930,6,6,0,6,0
2020-10-09,Siskiyou,093,43540,170,156,10,166,0
2020-10-09,Solano,095,438530,6826,6614,39,6653,53
2020-10-09,Sonoma,097,501317,8665,8133,23,8156,133
2020-10-09,Stanislaus,099,539301,17100,16904,608,17512,362
2020-10-09,Sutter,101,95872,1752,1732,1,1733,12
2020-10-09,Tehama,103,63373,723,682,2,684,3
2020-10-09,Trinity,105,12862,69,25,8,33,0
2020-10-09,Tulare,107,460477,17203,16644,212,16856,286
2020-10-09,Tuolumne,109,53932,246,230,5,235,4
2020-10-09,Ventura,111,848112,14184,13469,274,13743,151
2020-10-09,Yolo,113,214977,3025,2928,7,2935,55
2020-10-09,Yuba,115,75493,1159,1129,5,1134,10
2020-10-08,Alameda,001,1643700,22474,21826,197,22023,395
2020-10-08,Alpine,003,1148,3,3,0,3,0
2020-10-08,Amador,005,37829,305,302,0,302,16
2020-10-08,Butte,007,227075,3059,2935,30,2965,51
2020-10-08,Calaveras,009,45235,317,262,0,262,11
2020-10-08,Colusa,011,21464,540,539,1,540,6
2020-10-08,Contra Costa,013,1133247,18010,17418,87,17505,228
2020-10-08,Del Norte,015,27424,165,151,0,151,2
2020-10-08,El Dorado,017,186661,1298,1230,10,1240,4
2020-10-08,Fresno,019,978130,31986,29111,403,29514,416
2020-10-08,Glenn,021,27897,629,616,0,616,3
2020-10-08,Humboldt,023,135768,529,515,1,516,7
2020-10-08,Imperial,025,180216,12257,11405,10,11415,330
2020-10-08,Inyo,027,18085,204,199,4,203,14
2020-10-08,Kern,029,883053,32902,32169,351,32520,411
2020-10-08,Kings,031,150075,8279,7968,42,8010,80
2020-10-08,Lake,033,64148,652,604,0,604,11
2020-10-08,Lassen,035,31185,757,751,2,753,0
2020-10-08,Los Angeles,037,10098052,282547,276763,2240,279003,6699
2020-10-08,Madera,039,155013,4796,4637,32,4669,50
2020-10-08,Marin,041,260295,6951,6810,18,6828,96
2020-10-08,Mariposa,043,17540,77,76,0,76,2
2020-10-08,Mendocino,045,87422,987,930,4,934,20
2020-10-08,Merced,047,269075,9218,9069,27,9096,144
2020-10-08,Modoc,049,8938,29,27,0,27,0
2020-10-08,Mono,051,14174,174,153,4,157,1
2020-10-08,Monterey,053,433212,10615,10343,44,10387,75
2020-10-08,Napa,055,140530,1849,1779,8,1787,11
2020-10-08,Nevada,057,99092,577,556,18,574,6
2020-10-08,Orange,059,3164182,57449,54523,1589,56112,1293
2020-10-08,Placer,061,380077,3894,3715,13,3728,48
2020-10-08,Plumas,063,18699,52,50,0,50,0
2020-10-08,Riverside,065,2383286,62971,61105,232,61337,1244
2020-10-08,Sacramento,067,1510023,23928,23482,26,23508,454
2020-10-08,San Benito,069,59416,1371,1367,0,1367,13
2020-10-08,San Bernardino,071,2135413,58422,56152,363,56515,1048
2020-10-08,San Diego,073,3302833,51648,49468,1211,50679,819
2020-10-08,San Francisco,075,870044,11711,11608,37,11645,115
2020-10-08,San Joaquin,077,732212,20950,20576,87,20663,478
2020-10-08,San Luis Obispo,079,281455,4067,3785,17,3802,32
2020-10-08,San Mateo,081,765935,10731,10044,11,10055,130
2020-10-08,Santa Barbara,083,443738,9512,9374,84,9458,116
2020-10-08,Santa Clara,085,1922200,23512,22095,48,22143,323
2020-10-08,Santa Cruz,087,273765,2643,2535,32,2567,13
2020-10-08,Shasta,089,179085,1730,1305,16,1321,20
2020-10-08,Sierra,091,2930,6,6,0,6,0
2020-10-08,Siskiyou,093,43540,170,156,10,166,0
2020-10-08,Solano,095,438530,6802,6556,39,6595,53
2020-10-08,Sonoma,097,501317,8599,8063,23,8086,132
2020-10-08,Stanislaus,099,539301,17054,16821,600,17421,360
2020-10-08,Sutter,101,95872,1752,1725,1,1726,12
2020-10-08,Tehama,103,63373,714,676,2,678,3
2020-10-08,Trinity,105,12862,68,25,8,33,0
2020-10-08,Tulare,107,460477,17142,16573,204,16777,283
2020-10-08,Tuolumne,109,53932,245,230,5,235,4
2020-10-08,Ventura,111,848112,14136,13399,272,13671,151
2020-10-08,Yolo,113,214977,3008,2914,7,2921,55
2020-10-08,Yuba,115,75493,1154,1126,5,1131,10
2020-10-07,Alameda,001,1643700,22397,21736,197,21933,395
2020-10-07,Alpine,003,1148,3,3,0,3,0
2020-10-07,Amador,005,37829,305,302,0,302,16
2020-10-07,Butte,007,227075,3047,2927,30,2957,47
2020-10-07,Calaveras,009,45235,315,262,0,262,11
2020-10-07,Colusa,011,21464,539,539,0,539,6
2020-10-07,Contra Costa,013,1133247,17940,17346,86,17432,225
2020-10-07,Del Norte,015,27424,164,149,0,149,2
2020-10-07,El Dorado,017,186661,1290,1219,10,1229,4
2020-10-07,Fresno,019,978130,31865,29069,398,29467,413
2020-10-07,Glenn,021,27897,629,615,0,615,3
2020-10-07,Humboldt,023,135768,526,512,1,513,7
2020-10-07,Imperial,025,180216,12220,11289,9,11298,330
2020-10-07,Inyo,027,18085,204,199,4,203,14
2020-10-07,Kern,029,883053,32829,32068,350,32418,410
2020-10-07,Kings,031,150075,8264,7948,42,7990,80
2020-10-07,Lake,033,64148,651,599,0,599,11
2020-10-07,Lassen,035,31185,757,751,2,753,0
2020-10-07,Los Angeles,037,10098052,281366,275559,2207,277766,6681
2020-10-07,Madera,039,155013,4776,4618,32,4650,50
2020-10-07,Marin,041,260295,6924,6790,18,6808,95
2020-10-07,Mariposa,043,17540,77,75,0,75,2
2020-10-07,Mendocino,045,87422,981,927,4,931,19
2020-10-07,Merced,047,269075,9181,9045,26,9071,144
2020-10-07,Modoc,049,8938,29,27,0,27,0
2020-10-07,Mono,051,14174,173,153,3,156,1
2020-10-07,Monterey,053,433212,10556,10272,44,10316,75
2020-10-07,Napa,055,140530,1836,1774,8,1782,11
2020-10-07,Nevada,057,99092,573,552,18,570,6
2020-10-07,Orange,059,3164182,57232,54332,1578,55910,1277
2020-10-07,Placer,061,380077,3878,3693,13,3706,48
2020-10-07,Plumas,063,18699,52,50,0,50,0
2020-10-07,Riverside,065,2383286,62624,60857,228,61085,1241
2020-10-07,Sacramento,067,1510023,23831,23380,26,23406,452
2020-10-07,San Benito,069,59416,1368,1363,0,1363,13
2020-10-07,San Bernardino,071,2135413,58073,55738,362,56100,1043
2020-10-07,San Diego,073,3302833,51332,49177,1187,50364,813
2020-10-07,San Francisco,075,870044,11676,11551,37,11588,115
2020-10-07,San Joaquin,077,732212,20898,20527,80,20607,478
2020-10-07,San Luis Obispo,079,281455,4037,3749,17,3766,32
2020-10-07,San Mateo,081,765935,10688,9980,11,9991,130
2020-10-07,Santa Barbara,083,443738,9486,9350,83,9433,116
2020-10-07,Santa Clara,085,1922200,23384,21993,48,22041,320
2020-10-07,Santa Cruz,087,273765,2631,2518,32,2550,14
2020-10-07,Shasta,089,179085,1687,1268,16,1284,20
2020-10-07,Sierra,091,2930,6,6,0,6,0
2020-10-07,Siskiyou,093,43540,168,154,10,164,0
2020-10-07,Solano,095,438530,6767,6526,39,6565,53
2020-10-07,Sonoma,097,501317,8524,7993,22,8015,130
2020-10-07,Stanislaus,099,539301,17019,16786,594,17380,357
2020-10-07,Sutter,101,95872,1749,1723,1,1724,12
2020-10-07,Tehama,103,63373,705,666,2,668,3
2020-10-07,Trinity,105,12862,64,25,8,33,0
2020-10-07,Tulare,107,460477,17099,16483,196,16679,282
2020-10-07,Tuolumne,109,53932,245,227,5,232,3
2020-10-07,Ventura,111,848112,14086,13333,266,13599,150
2020-10-07,Yolo,113,214977,2982,2904,7,2911,55
2020-10-07,Yuba,115,75493,1148,1120,5,1125,10
2020-10-06,Alameda,001,1643700,22306,21698,195,21893,385
2020-10-06,Alpine,003,1148,3,3,0,3,0
2020-10-06,Amador,005,37829,303,301,0,301,16
2020-10-06,Butte,007,227075,3040,2925,30,2955,47
2020-10-06,Calaveras,009,45235,315,261,0,261,11
2020-10-06,Colusa,011,21464,538,538,0,538,6
2020-10-06,Contra Costa,013,1133247,17861,17295,86,17381,219
2020-10-06,Del Norte,015,27424,164,144,0,144,2
2020-10-06,El Dorado,017,186661,1286,1211,10,1221,4
2020-10-06,Fresno,019,978130,31721,29022,395,29417,412
2020-10-06,Glenn,021,27897,626,604,0,604,3
2020-10-06,Humboldt,023,135768,523,508,1,509,7
2020-10-06,Imperial,025,180216,12182,11196,9,11205,327
2020-10-06,Inyo,027,18085,202,198,4,202,14
2020-10-06,Kern,029,883053,32752,32006,348,32354,407
2020-10-06,Kings,031,150075,8248,7943,42,7985,81
2020-10-06,Lake,033,64148,645,596,0,596,11
2020-10-06,Lassen,035,31185,757,743,2,745,0
2020-10-06,Los Angeles,037,10098052,280128,274115,2158,276273,6657
2020-10-06,Madera,039,155013,4764,4608,32,4640,50
2020-10-06,Marin,041,260295,6909,6766,18,6784,91
2020-10-06,Mariposa,043,17540,77,75,0,75,2
2020-10-06,Mendocino,045,87422,974,920,4,924,19
2020-10-06,Merced,047,269075,9145,9034,25,9059,143
2020-10-06,Modoc,049,8938,29,26,0,26,0
2020-10-06,Mono,051,14174,173,153,3,156,1
2020-10-06,Monterey,053,433212,10501,10235,42,10277,72
2020-10-06,Napa,055,140530,1830,1770,8,1778,11
2020-10-06,Nevada,057,99092,570,551,18,569,6
2020-10-06,Orange,059,3164182,57016,54203,1569,55772,1273
2020-10-06,Placer,061,380077,3856,3680,13,3693,48
2020-10-06,Plumas,063,18699,52,49,0,49,0
2020-10-06,Riverside,065,2383286,62359,60593,226,60819,1238
2020-10-06,Sacramento,067,1510023,23744,23322,26,23348,442
2020-10-06,San Benito,069,59416,1367,1358,0,1358,12
2020-10-06,San Bernardino,071,2135413,57759,55416,358,55774,1040
2020-10-06,San Diego,073,3302833,50995,48823,1170,49993,806
2020-10-06,San Francisco,075,870044,11650,11513,36,11549,115
2020-10-06,San Joaquin,077,732212,20858,20481,77,20558,477
2020-10-06,San Luis Obispo,079,281455,4003,3723,17,3740,32
2020-10-06,San Mateo,081,765935,10656,9934,11,9945,129
2020-10-06,Santa Barbara,083,443738,9457,9331,82,9413,116
2020-10-06,Santa Clara,085,1922200,23289,21914,48,21962,320
2020-10-06,Santa Cruz,087,273765,2609,2510,32,2542,12
2020-10-06,Shasta,089,179085,1647,1242,16,1258,18
2020-10-06,Sierra,091,2930,6,6,0,6,0
2020-10-06,Siskiyou,093,43540,168,154,10,164,0
2020-10-06,Solano,095,438530,6721,6506,39,6545,52
2020-10-06,Sonoma,097,501317,8431,7895,22,7917,130
2020-10-06,Stanislaus,099,539301,16974,16759,588,17347,354
2020-10-06,Sutter,101,95872,1747,1722,1,1723,12
2020-10-06,Tehama,103,63373,696,660,2,662,3
2020-10-06,Trinity,105,12862,64,25,8,33,0
2020-10-06,Tulare,107,460477,17057,16456,188,16644,280
2020-10-06,Tuolumne,109,53932,244,227,5,232,2
2020-10-06,Ventura,111,848112,14019,13242,261,13503,150
2020-10-06,Yolo,113,214977,2968,2899,7,2906,56
2020-10-06,Yuba,115,75493,1147,1114,5,1119,10
2020-10-05,Alameda,001,1643700,22218,21637,192,21829,383
2020-10-05,Alpine,003,1148,3,2,0,2,0
2020-10-05,Amador,005,37829,303,299,0,299,16
2020-10-05,Butte,007,227075,3030,2910,30,2940,46
2020-10-05,Calaveras,009,45235,315,259,0,259,11
2020-10-05,Colusa,011,21464,538,537,0,537,6
2020-10-05,Contra Costa,013,1133247,17784,17250,86,17336,216
2020-10-05,Del Norte,015,27424,161,142,0,142,2
2020-10-05,El Dorado,017,186661,1282,1202,9,1211,4
2020-10-05,Fresno,019,978130,31604,29136,395,29531,408
2020-10-05,Glenn,021,27897,624,603,0,603,3
2020-10-05,Humboldt,023,135768,522,506,1,507,6
2020-10-05,Imperial,025,180216,12142,11169,9,11178,327
2020-10-05,Inyo,027,18085,202,197,4,201,14
2020-10-05,Kern,029,883053,32673,31933,344,32277,404
2020-10-05,Kings,031,150075,8151,7932,42,7974,80
2020-10-05,Lake,033,64148,641,592,0,592,10
2020-10-05,Lassen,035,31185,756,743,2,745,0
2020-10-05,Los Angeles,037,10098052,279034,273200,2119,275319,6632
2020-10-05,Madera,039,155013,4756,4598,30,4628,50
2020-10-05,Marin,041,260295,6892,6751,18,6769,91
2020-10-05,Mariposa,043,17540,77,75,0,75,2
2020-10-05,Mendocino,045,87422,966,913,4,917,19
2020-10-05,Merced,047,269075,9126,9021,24,9045,143
2020-10-05,Modoc,049,8938,29,26,0,26,0
2020-10-05,Mono,051,14174,173,152,3,155,1
2020-10-05,Monterey,053,433212,10454,10187,42,10229,72
2020-10-05,Napa,055,140530,1819,1760,8,1768,11
2020-10-05,Nevada,057,99092,567,550,17,567,6
2020-10-05,Orange,059,3164182,56800,54103,1556,55659,1271
2020-10-05,Placer,061,380077,3830,3670,13,3683,46
2020-10-05,Plumas,063,18699,51,49,0,49,0
2020-10-05,Riverside,065,2383286,62039,60454,222,60676,1232
2020-10-05,Sacramento,067,1510023,23640,23207,26,23233,438
2020-10-05,San Benito,069,59416,1364,1356,0,1356,12
2020-10-05,San Bernardino,071,2135413,57452,55100,357,55457,1031
2020-10-05,San Diego,073,3302833,50659,48662,1146,49808,803
2020-10-05,San Francisco,075,870044,11611,11476,34,11510,110
2020-10-05,San Joaquin,077,732212,20788,20319,74,20393,476
2020-10-05,San Luis Obispo,079,281455,3976,3710,17,3727,32
2020-10-05,San Mateo,081,765935,10629,9896,11,9907,128
2020-10-05,Santa Barbara,083,443738,9435,9309,82,9391,116
2020-10-05,Santa Clara,085,1922200,23172,21861,48,21909,319
2020-10-05,Santa Cruz,087,273765,2597,2492,32,2524,9
2020-10-05,Shasta,089,179085,1615,1158,16,1174,18
2020-10-05,Sierra,091,2930,6,6,0,6,0
2020-10-05,Siskiyou,093,43540,168,153,10,163,0
2020-10-05,Solano,095,438530,6682,6475,39,6514,52
2020-10-05,Sonoma,097,501317,8339,7817,22,7839,130
2020-10-05,Stanislaus,099,539301,16938,16730,581,17311,351
2020-10-05,Sutter,101,95872,1739,1719,1,1720,12
2020-10-05,Tehama,103,63373,688,642,2,644,3
2020-10-05,Trinity,105,12862,62,22,8,30,0
2020-10-05,Tulare,107,460477,16998,16343,183,16526,278
2020-10-05,Tuolumne,109,53932,241,226,5,231,2
2020-10-05,Ventura,111,848112,13950,13224,242,13466,149
2020-10-05,Yolo,113,214977,2949,2889,7,2896,56
2020-10-05,Yuba,115,75493,1134,1108,5,1113,9
2020-10-04,Alameda,001,1643700,22122,21597,192,21789,383
2020-10-04,Alpine,003,1148,3,2,0,2,0
2020-10-04,Amador,005,37829,302,297,0,297,16
2020-10-04,Butte,007,227075,3016,2903,30,2933,46
2020-10-04,Calaveras,009,45235,315,259,0,259,11
2020-10-04,Colusa,011,21464,537,537,0,537,6
2020-10-04,Contra Costa,013,1133247,17719,17192,86,17278,214
2020-10-04,Del Norte,015,27424,157,142,0,142,2
2020-10-04,El Dorado,017,186661,1278,1196,9,1205,4
2020-10-04,Fresno,019,978130,31481,29065,395,29460,408
2020-10-04,Glenn,021,27897,622,601,0,601,3
2020-10-04,Humboldt,023,135768,521,506,1,507,6
2020-10-04,Imperial,025,180216,12103,11127,9,11136,327
2020-10-04,Inyo,027,18085,199,195,4,199,14
2020-10-04,Kern,029,883053,32599,31906,341,32247,404
2020-10-04,Kings,031,150075,8136,7919,42,7961,80
2020-10-04,Lake,033,64148,627,589,0,589,10
2020-10-04,Lassen,035,31185,756,743,2,745,0
2020-10-04,Los Angeles,037,10098052,277648,272822,2071,274893,6625
2020-10-04,Madera,039,155013,4740,4587,30,4617,50
2020-10-04,Marin,041,260295,6872,6741,18,6759,91
2020-10-04,Mariposa,043,17540,77,75,0,75,2
2020-10-04,Mendocino,045,87422,953,905,4,909,18
2020-10-04,Merced,047,269075,9101,9006,24,9030,140
2020-10-04,Modoc,049,8938,29,26,0,26,0
2020-10-04,Mono,051,14174,172,152,2,154,1
2020-10-04,Monterey,053,433212,10413,10141,41,10182,72
2020-10-04,Napa,055,140530,1807,1759,8,1767,11
2020-10-04,Nevada,057,99092,563,547,16,563,6
2020-10-04,Orange,059,3164182,56564,53966,1547,55513,1270
2020-10-04,Placer,061,380077,3809,3664,13,3677,46
2020-10-04,Plumas,063,18699,51,49,0,49,0
2020-10-04,Riverside,065,2383286,61753,60251,218,60469,1226
2020-10-04,Sacramento,067,1510023,23527,23162,26,23188,438
2020-10-04,San Benito,069,59416,1364,1355,0,1355,12
2020-10-04,San Bernardino,071,2135413,57004,55100,355,55455,1031
2020-10-04,San Diego,073,3302833,50292,48438,1121,49559,803
2020-10-04,San Francisco,075,870044,11579,11474,32,11506,110
2020-10-04,San Joaquin,077,732212,20711,20320,68,20388,476
2020-10-04,San Luis Obispo,079,281455,3951,3688,17,3705,31
2020-10-04,San Mateo,081,765935,10569,9858,11,9869,128
2020-10-04,Santa Barbara,083,443738,9409,9276,80,9356,116
2020-10-04,Santa Clara,085,1922200,23035,21780,48,21828,316
2020-10-04,Santa Cruz,087,273765,2581,2483,32,2515,9
2020-10-04,Shasta,089,179085,1517,1158,15,1173,18
2020-10-04,Sierra,091,2930,6,6,0,6,0
2020-10-04,Siskiyou,093,43540,168,153,10,163,0
2020-10-04,Solano,095,438530,6631,6445,39,6484,52
2020-10-04,Sonoma,097,501317,8251,7794,22,7816,129
2020-10-04,Stanislaus,099,539301,16888,16711,572,17283,351
2020-10-04,Sutter,101,95872,1736,1711,1,1712,11
2020-10-04,Tehama,103,63373,673,637,2,639,3
2020-10-04,Trinity,105,12862,61,21,8,29,0
2020-10-04,Tulare,107,460477,16921,16343,172,16515,278
2020-10-04,Tuolumne,109,53932,239,226,5,231,2
2020-10-04,Ventura,111,848112,13868,13197,225,13422,149
2020-10-04,Yolo,113,214977,2938,2875,7,2882,56
2020-10-04,Yuba,115,75493,1130,1103,5,1108,9
2020-10-03,Alameda,001,1643700,22076,21510,191,21701,386
2020-10-03,Alpine,003,1148,3,2,0,2,0
2020-10-03,Amador,005,37829,301,296,0,296,16
2020-10-03,Butte,007,227075,3010,2894,30,2924,46
2020-10-03,Calaveras,009,45235,315,259,0,259,11
2020-10-03,Colusa,011,21464,536,537,0,537,6
2020-10-03,Contra Costa,013,1133247,17669,17087,84,17171,213
2020-10-03,Del Norte,015,27424,153,142,0,142,2
2020-10-03,El Dorado,017,186661,1271,1188,9,1197,4
2020-10-03,Fresno,019,978130,31421,28975,394,29369,408
2020-10-03,Glenn,021,27897,620,601,0,601,3
2020-10-03,Humboldt,023,135768,520,504,1,505,6
2020-10-03,Imperial,025,180216,12080,11090,9,11099,327
2020-10-03,Inyo,027,18085,199,194,4,198,14
2020-10-03,Kern,029,883053,32549,31864,337,32201,403
2020-10-03,Kings,031,150075,8132,7887,42,7929,80
2020-10-03,Lake,033,64148,617,588,0,588,10
2020-10-03,Lassen,035,31185,756,743,2,745,0
2020-10-03,Los Angeles,037,10098052,276942,271869,2042,273911,6620
2020-10-03,Madera,039,155013,4723,4565,30,4595,50
2020-10-03,Marin,041,260295,6866,6728,18,6746,91
2020-10-03,Mariposa,043,17540,77,75,0,75,2
2020-10-03,Mendocino,045,87422,951,898,4,902,18
2020-10-03,Merced,047,269075,9088,8986,24,9010,139
2020-10-03,Modoc,049,8938,29,26,0,26,0
2020-10-03,Mono,051,14174,171,152,2,154,1
2020-10-03,Monterey,053,433212,10379,10092,38,10130,72
2020-10-03,Napa,055,140530,1803,1752,8,1760,11
2020-10-03,Nevada,057,99092,562,544,16,560,6
2020-10-03,Orange,059,3164182,56447,53573,1542,55115,1268
2020-10-03,Placer,061,380077,3798,3648,13,3661,47
2020-10-03,Plumas,063,18699,51,48,0,48,0
2020-10-03,Riverside,065,2383286,61601,59991,216,60207,1226
2020-10-03,Sacramento,067,1510023,23476,23076,26,23102,437
2020-10-03,San Benito,069,59416,1364,1351,0,1351,12
2020-10-03,San Bernardino,071,2135413,56831,55004,352,55356,1031
2020-10-03,San Diego,073,3302833,50061,48202,1104,49306,798
2020-10-03,San Francisco,075,870044,11554,11475,30,11505,110
2020-10-03,San Joaquin,077,732212,20685,20322,68,20390,476
2020-10-03,San Luis Obispo,079,281455,3927,3670,17,3687,31
2020-10-03,San Mateo,081,765935,10542,9822,10,9832,128
2020-10-03,Santa Barbara,083,443738,9396,9256,80,9336,116
2020-10-03,Santa Clara,085,1922200,22955,21672,48,21720,309
2020-10-03,Santa Cruz,087,273765,2573,2476,32,2508,9
2020-10-03,Shasta,089,179085,1489,1117,14,1131,18
2020-10-03,Sierra,091,2930,6,6,0,6,0
2020-10-03,Siskiyou,093,43540,168,152,10,162,0
2020-10-03,Solano,095,438530,6605,6419,39,6458,52
2020-10-03,Sonoma,097,501317,8209,7747,22,7769,129
2020-10-03,Stanislaus,099,539301,16855,16645,568,17213,351
2020-10-03,Sutter,101,95872,1732,1705,1,1706,11
2020-10-03,Tehama,103,63373,667,630,2,632,3
2020-10-03,Trinity,105,12862,61,15,8,23,0
2020-10-03,Tulare,107,460477,16877,16322,168,16490,278
2020-10-03,Tuolumne,109,53932,238,224,5,229,2
2020-10-03,Ventura,111,848112,13830,13150,221,13371,148
2020-10-03,Yolo,113,214977,2931,2863,7,2870,56
2020-10-03,Yuba,115,75493,1122,1097,5,1102,8
2020-10-02,Alameda,001,1643700,22021,21404,190,21594,382
2020-10-02,Alpine,003,1148,3,2,0,2,0
2020-10-02,Amador,005,37829,300,296,0,296,16
2020-10-02,Butte,007,227075,3000,2879,30,2909,46
2020-10-02,Calaveras,009,45235,314,259,0,259,11
2020-10-02,Colusa,011,21464,535,537,0,537,6
2020-10-02,Contra Costa,013,1133247,17626,17002,83,17085,213
2020-10-02,Del Norte,015,27424,152,141,0,141,2
2020-10-02,El Dorado,017,186661,1264,1168,9,1177,4
2020-10-02,Fresno,019,978130,31338,28855,394,29249,403
2020-10-02,Glenn,021,27897,615,594,0,594,3
2020-10-02,Humboldt,023,135768,519,503,1,504,6
2020-10-02,Imperial,025,180216,12058,11024,9,11033,327
2020-10-02,Inyo,027,18085,197,191,4,195,14
2020-10-02,Kern,029,883053,32497,31790,335,32125,399
2020-10-02,Kings,031,150075,8123,7716,42,7758,79
2020-10-02,Lake,033,64148,611,579,0,579,10
2020-10-02,Lassen,035,31185,756,742,2,744,0
2020-10-02,Los Angeles,037,10098052,276040,270935,2016,272951,6602
2020-10-02,Madera,039,155013,4714,4537,30,4567,49
2020-10-02,Marin,041,260295,6849,6717,18,6735,91
2020-10-02,Mariposa,043,17540,77,75,0,75,2
2020-10-02,Mendocino,045,87422,946,883,4,887,18
2020-10-02,Merced,047,269075,9078,8961,24,8985,139
2020-10-02,Modoc,049,8938,29,26,0,26,0
2020-10-02,Mono,051,14174,171,150,2,152,1
2020-10-02,Monterey,053,433212,10345,9997,38,10035,71
2020-10-02,Napa,055,140530,1797,1737,8,1745,11
2020-10-02,Nevada,057,99092,559,543,16,559,6
2020-10-02,Orange,059,3164182,56316,53299,1535,54834,1262
2020-10-02,Placer,061,380077,3778,3612,13,3625,46
2020-10-02,Plumas,063,18699,51,48,0,48,0
2020-10-02,Riverside,065,2383286,61380,59673,213,59886,1223
2020-10-02,Sacramento,067,1510023,23411,22818,26,22844,436
2020-10-02,San Benito,069,59416,1360,1347,0,1347,12
2020-10-02,San Bernardino,071,2135413,56644,54613,352,54965,1028
2020-10-02,San Diego,073,3302833,49809,47793,1088,48881,794
2020-10-02,San Francisco,075,870044,11531,11398,30,11428,110
2020-10-02,San Joaquin,077,732212,20651,20235,67,20302,474
2020-10-02,San Luis Obispo,079,281455,3904,3654,17,3671,31
2020-10-02,San Mateo,081,765935,10501,9745,10,9755,128
2020-10-02,Santa Barbara,083,443738,9373,9234,80,9314,116
2020-10-02,Santa Clara,085,1922200,22869,21545,47,21592,305
2020-10-02,Santa Cruz,087,273765,2556,2463,32,2495,9
2020-10-02,Shasta,089,179085,1454,1046,14,1060,18
2020-10-02,Sierra,091,2930,6,6,0,6,0
2020-10-02,Siskiyou,093,43540,168,151,10,161,0
2020-10-02,Solano,095,438530,6575,6385,39,6424,52
2020-10-02,Sonoma,097,501317,8152,7662,22,7684,125
2020-10-02,Stanislaus,099,539301,16814,16609,559,17168,349
2020-10-02,Sutter,101,95872,1731,1693,1,1694,11
2020-10-02,Tehama,103,63373,662,619,2,621,3
2020-10-02,Trinity,105,12862,61,15,8,23,0
2020-10-02,Tulare,107,460477,16836,16245,161,16406,278
2020-10-02,Tuolumne,109,53932,236,225,5,230,2
2020-10-02,Ventura,111,848112,13791,13120,216,13336,146
2020-10-02,Yolo,113,214977,2926,2845,7,2852,55
2020-10-02,Yuba,115,75493,1120,1090,5,1095,8
2020-10-01,Alameda,001,1643700,21960,21349,186,21535,383
2020-10-01,Alpine,003,1148,3,2,0,2,0
2020-10-01,Amador,005,37829,300,294,0,294,16
2020-10-01,Butte,007,227075,2992,2865,30,2895,45
2020-10-01,Calaveras,009,45235,314,257,0,257,11
2020-10-01,Colusa,011,21464,535,536,0,536,6
2020-10-01,Contra Costa,013,1133247,17563,16898,83,16981,211
2020-10-01,Del Norte,015,27424,147,140,0,140,2
2020-10-01,El Dorado,017,186661,1260,1162,8,1170,4
2020-10-01,Fresno,019,978130,31258,28796,392,29188,397
2020-10-01,Glenn,021,27897,611,593,0,593,3
2020-10-01,Humboldt,023,135768,519,499,1,500,6
2020-10-01,Imperial,025,180216,12015,10928,9,10937,325
2020-10-01,Inyo,027,18085,197,191,4,195,14
2020-10-01,Kern,029,883053,32434,31678,330,32008,399
2020-10-01,Kings,031,150075,8112,7688,39,7727,79
2020-10-01,Lake,033,64148,605,572,0,572,11
2020-10-01,Lassen,035,31185,753,742,2,744,0
2020-10-01,Los Angeles,037,10098052,274994,271513,1983,273496,6621
2020-10-01,Madera,039,155013,4691,4508,30,4538,48
2020-10-01,Marin,041,260295,6835,6710,18,6728,92
2020-10-01,Mariposa,043,17540,77,76,0,76,2
2020-10-01,Mendocino,045,87422,941,874,4,878,19
2020-10-01,Merced,047,269075,9050,8942,24,8966,138
2020-10-01,Modoc,049,8938,29,26,0,26,0
2020-10-01,Mono,051,14174,169,150,2,152,1
2020-10-01,Monterey,053,433212,10269,9958,38,9996,71
2020-10-01,Napa,055,140530,1789,1729,8,1737,11
2020-10-01,Nevada,057,99092,558,543,16,559,6
2020-10-01,Orange,059,3164182,56151,53088,1522,54610,1257
2020-10-01,Placer,061,380077,3751,3599,13,3612,45
2020-10-01,Plumas,063,18699,51,48,0,48,0
2020-10-01,Riverside,065,2383286,61128,59293,207,59500,1223
2020-10-01,Sacramento,067,1510023,23299,22714,25,22739,433
2020-10-01,San Benito,069,59416,1358,1346,0,1346,12
2020-10-01,San Bernardino,071,2135413,56350,54350,349,54699,1021
2020-10-01,San Diego,073,3302833,49527,47487,1068,48555,792
2020-10-01,San Francisco,075,870044,11500,11284,28,11312,110
2020-10-01,San Joaquin,077,732212,20604,20204,64,20268,471
2020-10-01,San Luis Obispo,079,281455,3877,3625,17,3642,31
2020-10-01,San Mateo,081,765935,10456,9681,10,9691,128
2020-10-01,Santa Barbara,083,443738,9333,9215,80,9295,118
2020-10-01,Santa Clara,085,1922200,22768,21398,47,21445,305
2020-10-01,Santa Cruz,087,273765,2541,2418,32,2450,10
2020-10-01,Shasta,089,179085,1403,991,14,1005,18
2020-10-01,Sierra,091,2930,6,6,0,6,0
2020-10-01,Siskiyou,093,43540,165,150,10,160,0
2020-10-01,Solano,095,438530,6537,6352,39,6391,52
2020-10-01,Sonoma,097,501317,8085,7569,22,7591,125
2020-10-01,Stanislaus,099,539301,16781,16555,553,17108,346
2020-10-01,Sutter,101,95872,1726,1684,1,1685,11
2020-10-01,Tehama,103,63373,652,606,2,608,3
2020-10-01,Trinity,105,12862,61,15,8,23,0
2020-10-01,Tulare,107,460477,16761,16182,158,16340,275
2020-10-01,Tuolumne,109,53932,236,223,5,228,2
2020-10-01,Ventura,111,848112,13739,13057,203,13260,146
2020-10-01,Yolo,113,214977,2908,2833,7,2840,55
2020-10-01,Yuba,115,75493,1116,1082,5,1087,8
2020-09-30,Alameda,001,1643700,21882,21271,183,21454,380
2020-09-30,Alpine,003,1148,3,2,0,2,0
2020-09-30,Amador,005,37829,300,294,0,294,16
2020-09-30,Butte,007,227075,2984,2858,30,2888,44
2020-09-30,Calaveras,009,45235,313,258,0,258,11
2020-09-30,Colusa,011,21464,534,534,0,534,6
2020-09-30,Contra Costa,013,1133247,17495,16819,83,16902,211
2020-09-30,Del Norte,015,27424,146,140,0,140,2
2020-09-30,El Dorado,017,186661,1248,1157,8,1165,4
2020-09-30,Fresno,019,978130,31168,28706,389,29095,395
2020-09-30,Glenn,021,27897,606,592,0,592,3
2020-09-30,Humboldt,023,135768,517,497,1,498,6
2020-09-30,Imperial,025,180216,11990,10868,9,10877,287
2020-09-30,Inyo,027,18085,196,189,4,193,14
2020-09-30,Kern,029,883053,32359,31601,329,31930,398
2020-09-30,Kings,031,150075,8084,7685,39,7724,79
2020-09-30,Lake,033,64148,599,567,0,567,10
2020-09-30,Lassen,035,31185,750,742,2,744,0
2020-09-30,Los Angeles,037,10098052,273772,270260,1950,272210,6568
2020-09-30,Madera,039,155013,4682,4477,30,4507,47
2020-09-30,Marin,041,260295,6811,6700,17,6717,91
2020-09-30,Mariposa,043,17540,77,76,0,76,2
2020-09-30,Mendocino,045,87422,935,867,4,871,17
2020-09-30,Merced,047,269075,9030,8926,24,8950,136
2020-09-30,Modoc,049,8938,29,26,0,26,0
2020-09-30,Mono,051,14174,169,150,2,152,1
2020-09-30,Monterey,053,433212,10219,9898,37,9935,70
2020-09-30,Napa,055,140530,1775,1728,8,1736,11
2020-09-30,Nevada,057,99092,556,540,16,556,6
2020-09-30,Orange,059,3164182,55960,52916,1506,54422,1251
2020-09-30,Placer,061,380077,3730,3585,13,3598,43
2020-09-30,Plumas,063,18699,51,48,0,48,0
2020-09-30,Riverside,065,2383286,60773,59074,203,59277,1220
2020-09-30,Sacramento,067,1510023,23195,22613,25,22638,429
2020-09-30,San Benito,069,59416,1355,1342,0,1342,12
2020-09-30,San Bernardino,071,2135413,56072,53988,348,54336,1018
2020-09-30,San Diego,073,3302833,49223,47182,1047,48229,783
2020-09-30,San Francisco,075,870044,11470,11247,28,11275,106
2020-09-30,San Joaquin,077,732212,20521,20150,62,20212,461
2020-09-30,San Luis Obispo,079,281455,3852,3597,17,3614,31
2020-09-30,San Mateo,081,765935,10414,9634,10,9644,128
2020-09-30,Santa Barbara,083,443738,9307,9186,80,9266,115
2020-09-30,Santa Clara,085,1922200,22663,21318,47,21365,302
2020-09-30,Santa Cruz,087,273765,2528,2405,32,2437,10
2020-09-30,Shasta,089,179085,1347,976,13,989,17
2020-09-30,Sierra,091,2930,6,6,0,6,0
2020-09-30,Siskiyou,093,43540,163,150,10,160,0
2020-09-30,Solano,095,438530,6495,6315,39,6354,51
2020-09-30,Sonoma,097,501317,7996,7494,22,7516,125
2020-09-30,Stanislaus,099,539301,16734,16531,547,17078,343
2020-09-30,Sutter,101,95872,1710,1680,1,1681,10
2020-09-30,Tehama,103,63373,646,594,2,596,3
2020-09-30,Trinity,105,12862,58,15,8,23,0
2020-09-30,Tulare,107,460477,16695,16117,151,16268,274
2020-09-30,Tuolumne,109,53932,234,224,5,229,2
2020-09-30,Ventura,111,848112,13704,12968,187,13155,145
2020-09-30,Yolo,113,214977,2895,2822,7,2829,55
2020-09-30,Yuba,115,75493,1113,1075,5,1080,8
2020-09-29,Alameda,001,1643700,21807,21241,180,21421,374
2020-09-29,Alpine,003,1148,3,2,0,2,0
2020-09-29,Amador,005,37829,298,294,0,294,16
2020-09-29,Butte,007,227075,2970,2848,30,2878,44
2020-09-29,Calaveras,009,45235,311,261,0,261,11
2020-09-29,Colusa,011,21464,534,534,0,534,6
2020-09-29,Contra Costa,013,1133247,17440,16716,81,16797,209
2020-09-29,Del Norte,015,27424,142,142,0,142,2
2020-09-29,El Dorado,017,186661,1239,1151,8,1159,4
2020-09-29,Fresno,019,978130,31073,28621,388,29009,394
2020-09-29,Glenn,021,27897,602,589,0,589,3
2020-09-29,Humboldt,023,135768,515,497,1,498,6
2020-09-29,Imperial,025,180216,11956,10811,9,10820,283
2020-09-29,Inyo,027,18085,195,188,4,192,14
2020-09-29,Kern,029,883053,32304,31534,328,31862,397
2020-09-29,Kings,031,150075,8028,7681,39,7720,78
2020-09-29,Lake,033,64148,597,566,0,566,11
2020-09-29,Lassen,035,31185,750,741,2,743,0
2020-09-29,Los Angeles,037,10098052,272557,269246,1922,271168,6545
2020-09-29,Madera,039,155013,4658,4453,30,4483,47
2020-09-29,Marin,041,260295,6790,6692,17,6709,91
2020-09-29,Mariposa,043,17540,77,74,0,74,2
2020-09-29,Mendocino,045,87422,925,854,4,858,17
2020-09-29,Merced,047,269075,9017,8892,22,8914,136
2020-09-29,Modoc,049,8938,29,26,0,26,0
2020-09-29,Mono,051,14174,169,149,2,151,1
2020-09-29,Monterey,053,433212,10164,9826,35,9861,70
2020-09-29,Napa,055,140530,1772,1727,8,1735,11
2020-09-29,Nevada,057,99092,551,539,16,555,6
2020-09-29,Orange,059,3164182,55774,52755,1495,54250,1231
2020-09-29,Placer,061,380077,3708,3570,13,3583,42
2020-09-29,Plumas,063,18699,51,48,0,48,0
2020-09-29,Riverside,065,2383286,60443,58863,196,59059,1208
2020-09-29,Sacramento,067,1510023,23074,22547,25,22572,425
2020-09-29,San Benito,069,59416,1350,1341,0,1341,12
2020-09-29,San Bernardino,071,2135413,55762,53753,347,54100,1012
2020-09-29,San Diego,073,3302833,48946,46987,1024,48011,781
2020-09-29,San Francisco,075,870044,11434,11142,28,11170,104
2020-09-29,San Joaquin,077,732212,20455,20094,60,20154,454
2020-09-29,San Luis Obispo,079,281455,3830,3581,17,3598,31
2020-09-29,San Mateo,081,765935,10367,9619,10,9629,127
2020-09-29,Santa Barbara,083,443738,9287,9149,79,9228,114
2020-09-29,Santa Clara,085,1922200,22527,21233,46,21279,302
2020-09-29,Santa Cruz,087,273765,2513,2383,31,2414,10
2020-09-29,Shasta,089,179085,1286,943,13,956,17
2020-09-29,Sierra,091,2930,6,6,0,6,0
2020-09-29,Siskiyou,093,43540,157,150,10,160,0
2020-09-29,Solano,095,438530,6461,6303,39,6342,51
2020-09-29,Sonoma,097,501317,7924,7426,22,7448,125
2020-09-29,Stanislaus,099,539301,16704,16505,541,17046,341
2020-09-29,Sutter,101,95872,1704,1677,1,1678,10
2020-09-29,Tehama,103,63373,628,585,2,587,2
2020-09-29,Trinity,105,12862,56,16,8,24,0
2020-09-29,Tulare,107,460477,16631,16055,144,16199,270
2020-09-29,Tuolumne,109,53932,234,224,5,229,2
2020-09-29,Ventura,111,848112,13647,12875,184,13059,145
2020-09-29,Yolo,113,214977,2882,2818,7,2825,55
2020-09-29,Yuba,115,75493,1111,1071,5,1076,8
2020-09-28,Alameda,001,1643700,21720,21133,180,21313,370
2020-09-28,Alpine,003,1148,3,2,0,2,0
2020-09-28,Amador,005,37829,296,294,0,294,16
2020-09-28,Butte,007,227075,2955,2837,30,2867,44
2020-09-28,Calaveras,009,45235,311,257,0,257,11
2020-09-28,Colusa,011,21464,533,531,0,531,6
2020-09-28,Contra Costa,013,1133247,17376,16653,81,16734,195
2020-09-28,Del Norte,015,27424,142,138,0,138,2
2020-09-28,El Dorado,017,186661,1232,1144,8,1152,4
2020-09-28,Fresno,019,978130,30992,28517,382,28899,389
2020-09-28,Glenn,021,27897,600,585,0,585,3
2020-09-28,Humboldt,023,135768,509,495,1,496,6
2020-09-28,Imperial,025,180216,11921,10777,9,10786,283
2020-09-28,Inyo,027,18085,194,188,4,192,14
2020-09-28,Kern,029,883053,32239,31481,324,31805,395
2020-09-28,Kings,031,150075,7887,7661,37,7698,78
2020-09-28,Lake,033,64148,593,559,0,559,10
2020-09-28,Lassen,035,31185,749,737,2,739,0
2020-09-28,Los Angeles,037,10098052,271450,268404,1892,270296,6508
2020-09-28,Madera,039,155013,4637,4438,30,4468,47
2020-09-28,Marin,041,260295,6774,6676,17,6693,91
2020-09-28,Mariposa,043,17540,77,74,0,74,2
2020-09-28,Mendocino,045,87422,910,850,4,854,17
2020-09-28,Merced,047,269075,8989,8869,22,8891,136
2020-09-28,Modoc,049,8938,29,26,0,26,0
2020-09-28,Mono,051,14174,169,148,2,150,1
2020-09-28,Monterey,053,433212,10099,9780,33,9813,69
2020-09-28,Napa,055,140530,1760,1705,8,1713,11
2020-09-28,Nevada,057,99092,543,538,16,554,6
2020-09-28,Orange,059,3164182,55568,52633,1486,54119,1196
2020-09-28,Placer,061,380077,3687,3572,13,3585,42
2020-09-28,Plumas,063,18699,50,48,0,48,0
2020-09-28,Riverside,065,2383286,60145,58570,187,58757,1198
2020-09-28,Sacramento,067,1510023,22927,22392,25,22417,423
2020-09-28,San Benito,069,59416,1347,1336,0,1336,11
2020-09-28,San Bernardino,071,2135413,55414,53501,347,53848,988
2020-09-28,San Diego,073,3302833,48628,46736,1004,47740,776
2020-09-28,San Francisco,075,870044,11400,11114,28,11142,100
2020-09-28,San Joaquin,077,732212,20407,19982,59,20041,448
2020-09-28,San Luis Obispo,079,281455,3809,3567,17,3584,31
2020-09-28,San Mateo,081,765935,10317,9582,10,9592,127
2020-09-28,Santa Barbara,083,443738,9269,9121,79,9200,114
2020-09-28,Santa Clara,085,1922200,22410,21180,46,21226,271
2020-09-28,Santa Cruz,087,273765,2503,2359,31,2390,9
2020-09-28,Shasta,089,179085,1232,883,10,893,17
2020-09-28,Sierra,091,2930,6,6,0,6,0
2020-09-28,Siskiyou,093,43540,157,149,10,159,0
2020-09-28,Solano,095,438530,6425,6254,39,6293,51
2020-09-28,Sonoma,097,501317,7848,7369,22,7391,125
2020-09-28,Stanislaus,099,539301,16665,16467,534,17001,336
2020-09-28,Sutter,101,95872,1697,1676,1,1677,10
2020-09-28,Tehama,103,63373,620,579,2,581,2
2020-09-28,Trinity,105,12862,56,16,8,24,0
2020-09-28,Tulare,107,460477,16578,15918,139,16057,270
2020-09-28,Tuolumne,109,53932,234,225,5,230,2
2020-09-28,Ventura,111,848112,13569,12812,178,12990,139
2020-09-28,Yolo,113,214977,2865,2809,7,2816,55
2020-09-28,Yuba,115,75493,1108,1062,5,1067,7
2020-09-27,Alameda,001,1643700,21638,21077,176,21253,370
2020-09-27,Alpine,003,1148,3,2,0,2,0
2020-09-27,Amador,005,37829,296,291,0,291,16
2020-09-27,Butte,007,227075,2943,2833,30,2863,44
2020-09-27,Calaveras,009,45235,310,257,0,257,11
2020-09-27,Colusa,011,21464,532,531,0,531,6
2020-09-27,Contra Costa,013,1133247,17274,16596,80,16676,195
2020-09-27,Del Norte,015,27424,142,138,0,138,2
2020-09-27,El Dorado,017,186661,1217,1130,8,1138,4
2020-09-27,Fresno,019,978130,30887,28441,382,28823,389
2020-09-27,Glenn,021,27897,596,576,0,576,3
2020-09-27,Humboldt,023,135768,507,492,1,493,6
2020-09-27,Imperial,025,180216,11887,10743,9,10752,283
2020-09-27,Inyo,027,18085,192,188,4,192,14
2020-09-27,Kern,029,883053,32120,31462,321,31783,395
2020-09-27,Kings,031,150075,7867,7641,37,7678,78
2020-09-27,Lake,033,64148,589,555,0,555,10
2020-09-27,Lassen,035,31185,749,737,2,739,0
2020-09-27,Los Angeles,037,10098052,270271,267754,1872,269626,6507
2020-09-27,Madera,039,155013,4608,4416,30,4446,47
2020-09-27,Marin,041,260295,6764,6663,17,6680,91
2020-09-27,Mariposa,043,17540,77,74,0,74,2
2020-09-27,Mendocino,045,87422,904,846,4,850,17
2020-09-27,Merced,047,269075,8955,8853,22,8875,136
2020-09-27,Modoc,049,8938,29,26,0,26,0
2020-09-27,Mono,051,14174,169,148,2,150,1
2020-09-27,Monterey,053,433212,10039,9724,32,9756,69
2020-09-27,Napa,055,140530,1755,1690,8,1698,11
2020-09-27,Nevada,057,99092,542,537,16,553,6
2020-09-27,Orange,059,3164182,55293,52458,1477,53935,1195
2020-09-27,Placer,061,380077,3674,3562,13,3575,42
2020-09-27,Plumas,063,18699,50,48,0,48,0
2020-09-27,Riverside,065,2383286,59849,58509,179,58688,1191
2020-09-27,Sacramento,067,1510023,22829,22356,25,22381,422
2020-09-27,San Benito,069,59416,1347,1331,0,1331,11
2020-09-27,San Bernardino,071,2135413,54978,53127,347,53474,988
2020-09-27,San Diego,073,3302833,48284,46612,987,47599,776
2020-09-27,San Francisco,075,870044,11348,11114,28,11142,100
2020-09-27,San Joaquin,077,732212,20347,19981,59,20040,448
2020-09-27,San Luis Obispo,079,281455,3789,3562,17,3579,31
2020-09-27,San Mateo,081,765935,10249,9566,10,9576,127
2020-09-27,Santa Barbara,083,443738,9248,9090,78,9168,114
2020-09-27,Santa Clara,085,1922200,22301,21091,46,21137,271
2020-09-27,Santa Cruz,087,273765,2481,2359,31,2390,9
2020-09-27,Shasta,089,179085,1189,883,9,892,17
2020-09-27,Sierra,091,2930,6,6,0,6,0
2020-09-27,Siskiyou,093,43540,156,149,10,159,0
2020-09-27,Solano,095,438530,6390,6211,39,6250,51
2020-09-27,Sonoma,097,501317,7767,7336,22,7358,124
2020-09-27,Stanislaus,099,539301,16614,16448,528,16976,336
2020-09-27,Sutter,101,95872,1690,1672,1,1673,10
2020-09-27,Tehama,103,63373,603,573,2,575,2
2020-09-27,Trinity,105,12862,56,16,8,24,0
2020-09-27,Tulare,107,460477,16500,15918,130,16048,270
2020-09-27,Tuolumne,109,53932,233,224,5,229,2
2020-09-27,Ventura,111,848112,13480,12775,169,12944,139
2020-09-27,Yolo,113,214977,2851,2796,7,2803,55
2020-09-27,Yuba,115,75493,1098,1059,5,1064,7
2020-09-26,Alameda,001,1643700,21580,21019,175,21194,370
2020-09-26,Alpine,003,1148,3,2,0,2,0
2020-09-26,Amador,005,37829,295,291,0,291,16
2020-09-26,Butte,007,227075,2935,2827,30,2857,44
2020-09-26,Calaveras,009,45235,310,257,0,257,11
2020-09-26,Colusa,011,21464,532,529,0,529,6
2020-09-26,Contra Costa,013,1133247,17231,16508,80,16588,194
2020-09-26,Del Norte,015,27424,142,138,0,138,2
2020-09-26,El Dorado,017,186661,1212,1127,8,1135,4
2020-09-26,Fresno,019,978130,30820,28336,382,28718,389
2020-09-26,Glenn,021,27897,596,576,0,576,3
2020-09-26,Humboldt,023,135768,507,491,1,492,6
2020-09-26,Imperial,025,180216,11870,10721,9,10730,283
2020-09-26,Inyo,027,18085,191,187,4,191,14
2020-09-26,Kern,029,883053,32069,31410,321,31731,394
2020-09-26,Kings,031,150075,7855,7537,37,7574,78
2020-09-26,Lake,033,64148,586,549,0,549,10
2020-09-26,Lassen,035,31185,749,737,2,739,0
2020-09-26,Los Angeles,037,10098052,269639,266931,1858,268789,6497
2020-09-26,Madera,039,155013,4592,4410,30,4440,47
2020-09-26,Marin,041,260295,6751,6641,17,6658,91
2020-09-26,Mariposa,043,17540,76,74,0,74,2
2020-09-26,Mendocino,045,87422,899,836,4,840,17
2020-09-26,Merced,047,269075,8943,8841,21,8862,136
2020-09-26,Modoc,049,8938,29,26,0,26,0
2020-09-26,Mono,051,14174,169,148,2,150,1
2020-09-26,Monterey,053,433212,10012,9651,32,9683,68
2020-09-26,Napa,055,140530,1753,1681,8,1689,11
2020-09-26,Nevada,057,99092,542,534,16,550,6
2020-09-26,Orange,059,3164182,55154,52203,1471,53674,1194
2020-09-26,Placer,061,380077,3661,3551,13,3564,42
2020-09-26,Plumas,063,18699,49,48,0,48,0
2020-09-26,Riverside,065,2383286,59714,58076,177,58253,1190
2020-09-26,Sacramento,067,1510023,22773,22269,25,22294,421
2020-09-26,San Benito,069,59416,1345,1325,0,1325,11
2020-09-26,San Bernardino,071,2135413,54845,53122,347,53469,988
2020-09-26,San Diego,073,3302833,48079,46333,973,47306,775
2020-09-26,San Francisco,075,870044,11320,11113,28,11141,100
2020-09-26,San Joaquin,077,732212,20312,19982,57,20039,449
2020-09-26,San Luis Obispo,079,281455,3773,3546,17,3563,31
2020-09-26,San Mateo,081,765935,10215,9509,10,9519,127
2020-09-26,Santa Barbara,083,443738,9237,9061,78,9139,114
2020-09-26,Santa Clara,085,1922200,22230,20967,45,21012,270
2020-09-26,Santa Cruz,087,273765,2473,2336,31,2367,9
2020-09-26,Shasta,089,179085,1139,856,8,864,17
2020-09-26,Sierra,091,2930,6,6,0,6,0
2020-09-26,Siskiyou,093,43540,155,149,10,159,0
2020-09-26,Solano,095,438530,6371,6209,39,6248,51
2020-09-26,Sonoma,097,501317,7742,7285,21,7306,124
2020-09-26,Stanislaus,099,539301,16589,16421,520,16941,336
2020-09-26,Sutter,101,95872,1685,1662,1,1663,10
2020-09-26,Tehama,103,63373,591,560,2,562,2
2020-09-26,Trinity,105,12862,54,16,8,24,0
2020-09-26,Tulare,107,460477,16474,15881,128,16009,270
2020-09-26,Tuolumne,109,53932,233,223,5,228,2
2020-09-26,Ventura,111,848112,13445,12729,168,12897,137
2020-09-26,Yolo,113,214977,2849,2789,7,2796,55
2020-09-26,Yuba,115,75493,1094,1056,5,1061,7
2020-09-25,Alameda,001,1643700,21526,20911,175,21086,367
2020-09-25,Alpine,003,1148,3,2,0,2,0
2020-09-25,Amador,005,37829,295,289,0,289,16
2020-09-25,Butte,007,227075,2930,2819,30,2849,43
2020-09-25,Calaveras,009,45235,310,257,0,257,11
2020-09-25,Colusa,011,21464,532,528,0,528,6
2020-09-25,Contra Costa,013,1133247,17172,16401,80,16481,194
2020-09-25,Del Norte,015,27424,142,138,0,138,2
2020-09-25,El Dorado,017,186661,1208,1104,8,1112,4
2020-09-25,Fresno,019,978130,30760,28199,381,28580,385
2020-09-25,Glenn,021,27897,594,570,0,570,3
2020-09-25,Humboldt,023,135768,506,489,1,490,5
2020-09-25,Imperial,025,180216,11852,10681,9,10690,283
2020-09-25,Inyo,027,18085,189,187,4,191,14
2020-09-25,Kern,029,883053,32016,31333,319,31652,393
2020-09-25,Kings,031,150075,7850,7450,37,7487,77
2020-09-25,Lake,033,64148,585,539,0,539,9
2020-09-25,Lassen,035,31185,749,737,2,739,0
2020-09-25,Los Angeles,037,10098052,268846,265713,1846,267559,6483
2020-09-25,Madera,039,155013,4573,4369,30,4399,48
2020-09-25,Marin,041,260295,6748,6622,17,6639,90
2020-09-25,Mariposa,043,17540,76,74,0,74,2
2020-09-25,Mendocino,045,87422,884,819,3,822,17
2020-09-25,Merced,047,269075,8927,8830,21,8851,135
2020-09-25,Modoc,049,8938,29,26,0,26,0
2020-09-25,Mono,051,14174,169,149,2,151,1
2020-09-25,Monterey,053,433212,9960,9581,32,9613,68
2020-09-25,Napa,055,140530,1751,1669,8,1677,11
2020-09-25,Nevada,057,99092,540,529,16,545,6
2020-09-25,Orange,059,3164182,55027,52031,1463,53494,1184
2020-09-25,Placer,061,380077,3650,3527,13,3540,41
2020-09-25,Plumas,063,18699,49,48,0,48,0
2020-09-25,Riverside,065,2383286,59538,57783,172,57955,1183
2020-09-25,Sacramento,067,1510023,22696,22132,25,22157,418
2020-09-25,San Benito,069,59416,1344,1318,0,1318,11
2020-09-25,San Bernardino,071,2135413,54691,52814,347,53161,987
2020-09-25,San Diego,073,3302833,47877,46003,957,46960,775
2020-09-25,San Francisco,075,870044,11286,11066,27,11093,100
2020-09-25,San Joaquin,077,732212,20260,19909,57,19966,449
2020-09-25,San Luis Obispo,079,281455,3761,3512,17,3529,31
2020-09-25,San Mateo,081,765935,10179,9447,10,9457,127
2020-09-25,Santa Barbara,083,443738,9213,9026,78,9104,114
2020-09-25,Santa Clara,085,1922200,22165,20812,44,20856,265
2020-09-25,Santa Cruz,087,273765,2461,2309,30,2339,9
2020-09-25,Shasta,089,179085,1105,806,8,814,16
2020-09-25,Sierra,091,2930,6,6,0,6,0
2020-09-25,Siskiyou,093,43540,155,149,10,159,0
2020-09-25,Solano,095,438530,6355,6179,39,6218,50
2020-09-25,Sonoma,097,501317,7702,7202,21,7223,124
2020-09-25,Stanislaus,099,539301,16571,16381,518,16899,326
2020-09-25,Sutter,101,95872,1682,1655,1,1656,10
2020-09-25,Tehama,103,63373,583,546,2,548,2
2020-09-25,Trinity,105,12862,54,15,8,23,0
2020-09-25,Tulare,107,460477,16434,15815,127,15942,267
2020-09-25,Tuolumne,109,53932,233,223,5,228,2
2020-09-25,Ventura,111,848112,13402,12664,165,12829,137
2020-09-25,Yolo,113,214977,2841,2784,7,2791,55
2020-09-25,Yuba,115,75493,1089,1049,5,1054,5
2020-09-24,Alameda,001,1643700,21451,20838,172,21010,364
2020-09-24,Alpine,003,1148,3,2,0,2,0
2020-09-24,Amador,005,37829,295,288,0,288,16
2020-09-24,Butte,007,227075,2919,2803,30,2833,43
2020-09-24,Calaveras,009,45235,310,258,0,258,11
2020-09-24,Colusa,011,21464,532,523,0,523,6
2020-09-24,Contra Costa,013,1133247,17090,16252,80,16332,192
2020-09-24,Del Norte,015,27424,138,137,0,137,2
2020-09-24,El Dorado,017,186661,1199,1093,8,1101,4
2020-09-24,Fresno,019,978130,30654,28106,377,28483,375
2020-09-24,Glenn,021,27897,590,567,0,567,3
2020-09-24,Humboldt,023,135768,503,482,1,483,5
2020-09-24,Imperial,025,180216,11828,10622,9,10631,283
2020-09-24,Inyo,027,18085,189,187,4,191,13
2020-09-24,Kern,029,883053,31953,31273,317,31590,388
2020-09-24,Kings,031,150075,7834,7428,37,7465,76
2020-09-24,Lake,033,64148,576,531,0,531,9
2020-09-24,Lassen,035,31185,748,737,2,739,0
2020-09-24,Los Angeles,037,10098052,267804,264374,1829,266203,6452
2020-09-24,Madera,039,155013,4554,4344,30,4374,48
2020-09-24,Marin,041,260295,6720,6588,17,6605,85
2020-09-24,Mariposa,043,17540,76,74,0,74,2
2020-09-24,Mendocino,045,87422,880,810,3,813,17
2020-09-24,Merced,047,269075,8898,8813,20,8833,135
2020-09-24,Modoc,049,8938,29,24,0,24,0
2020-09-24,Mono,051,14174,169,149,2,151,1
2020-09-24,Monterey,053,433212,9894,9544,30,9574,67
2020-09-24,Napa,055,140530,1739,1661,8,1669,11
2020-09-24,Nevada,057,99092,539,527,16,543,6
2020-09-24,Orange,059,3164182,54820,51749,1445,53194,1164
2020-09-24,Placer,061,380077,3635,3514,13,3527,41
2020-09-24,Plumas,063,18699,49,48,0,48,0
2020-09-24,Riverside,065,2383286,59273,57491,166,57657,1172
2020-09-24,Sacramento,067,1510023,22570,21985,24,22009,417
2020-09-24,San Benito,069,59416,1342,1308,0,1308,11
2020-09-24,San Bernardino,071,2135413,54354,52455,346,52801,988
2020-09-24,San Diego,073,3302833,47608,45598,942,46540,773
2020-09-24,San Francisco,075,870044,11239,10992,27,11019,99
2020-09-24,San Joaquin,077,732212,20222,19851,55,19906,444
2020-09-24,San Luis Obispo,079,281455,3745,3480,17,3497,31
2020-09-24,San Mateo,081,765935,10131,9376,10,9386,127
2020-09-24,Santa Barbara,083,443738,9160,8988,77,9065,114
2020-09-24,Santa Clara,085,1922200,22077,20689,44,20733,262
2020-09-24,Santa Cruz,087,273765,2441,2300,28,2328,9
2020-09-24,Shasta,089,179085,1068,773,5,778,14
2020-09-24,Sierra,091,2930,6,6,0,6,0
2020-09-24,Siskiyou,093,43540,155,149,10,159,0
2020-09-24,Solano,095,438530,6322,6137,39,6176,49
2020-09-24,Sonoma,097,501317,7621,7163,21,7184,122
2020-09-24,Stanislaus,099,539301,16534,16326,513,16839,326
2020-09-24,Sutter,101,95872,1679,1646,1,1647,10
2020-09-24,Tehama,103,63373,580,540,2,542,2
2020-09-24,Trinity,105,12862,54,15,8,23,0
2020-09-24,Tulare,107,460477,16369,15754,126,15880,267
2020-09-24,Tuolumne,109,53932,233,224,5,229,2
2020-09-24,Ventura,111,848112,13320,12617,164,12781,138
2020-09-24,Yolo,113,214977,2834,2776,7,2783,55
2020-09-24,Yuba,115,75493,1084,1042,5,1047,5
2020-09-23,Alameda,001,1643700,21383,20718,170,20888,361
2020-09-23,Alpine,003,1148,3,2,0,2,0
2020-09-23,Amador,005,37829,294,288,0,288,16
2020-09-23,Butte,007,227075,2911,2790,30,2820,43
2020-09-23,Calaveras,009,45235,309,258,0,258,11
2020-09-23,Colusa,011,21464,531,521,0,521,6
2020-09-23,Contra Costa,013,1133247,17028,16167,80,16247,192
2020-09-23,Del Norte,015,27424,136,137,0,137,2
2020-09-23,El Dorado,017,186661,1185,1088,8,1096,4
2020-09-23,Fresno,019,978130,30559,28019,375,28394,371
2020-09-23,Glenn,021,27897,583,561,0,561,3
2020-09-23,Humboldt,023,135768,499,477,1,478,5
2020-09-23,Imperial,025,180216,11802,10587,9,10596,284
2020-09-23,Inyo,027,18085,188,177,4,181,13
2020-09-23,Kern,029,883053,31909,31172,315,31487,387
2020-09-23,Kings,031,150075,7812,7406,37,7443,76
2020-09-23,Lake,033,64148,571,519,0,519,9
2020-09-23,Lassen,035,31185,748,736,2,738,0
2020-09-23,Los Angeles,037,10098052,266787,263318,1800,265118,6421
2020-09-23,Madera,039,155013,4539,4311,30,4341,48
2020-09-23,Marin,041,260295,6701,6567,17,6584,85
2020-09-23,Mariposa,043,17540,76,74,0,74,2
2020-09-23,Mendocino,045,87422,879,801,2,803,17
2020-09-23,Merced,047,269075,8877,8785,18,8803,134
2020-09-23,Modoc,049,8938,29,24,0,24,0
2020-09-23,Mono,051,14174,169,149,2,151,1
2020-09-23,Monterey,053,433212,9825,9452,29,9481,67
2020-09-23,Napa,055,140530,1730,1653,8,1661,11
2020-09-23,Nevada,057,99092,538,523,16,539,6
2020-09-23,Orange,059,3164182,54593,51658,1437,53095,1155
2020-09-23,Placer,061,380077,3623,3506,13,3519,41
2020-09-23,Plumas,063,18699,49,48,0,48,0
2020-09-23,Riverside,065,2383286,58967,57257,163,57420,1165
2020-09-23,Sacramento,067,1510023,22493,21821,24,21845,415
2020-09-23,San Benito,069,59416,1336,1305,0,1305,10
2020-09-23,San Bernardino,071,2135413,54061,52132,344,52476,973
2020-09-23,San Diego,073,3302833,47332,45427,923,46350,767
2020-09-23,San Francisco,075,870044,11190,10926,27,10953,95
2020-09-23,San Joaquin,077,732212,20168,19785,55,19840,439
2020-09-23,San Luis Obispo,079,281455,3727,3447,17,3464,31
2020-09-23,San Mateo,081,765935,10091,9351,10,9361,127
2020-09-23,Santa Barbara,083,443738,9131,8952,77,9029,112
2020-09-23,Santa Clara,085,1922200,21966,20575,41,20616,260
2020-09-23,Santa Cruz,087,273765,2422,2283,28,2311,9
2020-09-23,Shasta,089,179085,1029,756,4,760,14
2020-09-23,Sierra,091,2930,6,6,0,6,0
2020-09-23,Siskiyou,093,43540,155,149,10,159,0
2020-09-23,Solano,095,438530,6296,6123,39,6162,50
2020-09-23,Sonoma,097,501317,7545,7091,21,7112,122
2020-09-23,Stanislaus,099,539301,16504,16271,510,16781,317
2020-09-23,Sutter,101,95872,1675,1646,1,1647,10
2020-09-23,Tehama,103,63373,574,533,2,535,2
2020-09-23,Trinity,105,12862,53,15,8,23,0
2020-09-23,Tulare,107,460477,16304,15664,125,15789,266
2020-09-23,Tuolumne,109,53932,233,223,5,228,2
2020-09-23,Ventura,111,848112,13264,12591,162,12753,137
2020-09-23,Yolo,113,214977,2816,2766,7,2773,55
2020-09-23,Yuba,115,75493,1082,1038,5,1043,5
2020-09-22,Alameda,001,1643700,21303,20607,168,20775,355
2020-09-22,Alpine,003,1148,2,2,0,2,0
2020-09-22,Amador,005,37829,293,287,0,287,16
2020-09-22,Butte,007,227075,2906,2776,30,2806,43
2020-09-22,Calaveras,009,45235,309,258,0,258,11
2020-09-22,Colusa,011,21464,529,518,0,518,6
2020-09-22,Contra Costa,013,1133247,16938,16090,80,16170,190
2020-09-22,Del Norte,015,27424,136,137,0,137,2
2020-09-22,El Dorado,017,186661,1166,1076,8,1084,4
2020-09-22,Fresno,019,978130,30464,27944,372,28316,369
2020-09-22,Glenn,021,27897,580,560,0,560,3
2020-09-22,Humboldt,023,135768,498,476,1,477,5
2020-09-22,Imperial,025,180216,11773,10529,9,10538,284
2020-09-22,Inyo,027,18085,188,177,4,181,13
2020-09-22,Kern,029,883053,31841,31110,308,31418,383
2020-09-22,Kings,031,150075,7755,7395,36,7431,76
2020-09-22,Lake,033,64148,563,516,0,516,9
2020-09-22,Lassen,035,31185,747,736,2,738,0
2020-09-22,Los Angeles,037,10098052,265721,262117,1775,263892,6394
2020-09-22,Madera,039,155013,4523,4303,30,4333,47
2020-09-22,Marin,041,260295,6687,6561,17,6578,84
2020-09-22,Mariposa,043,17540,76,74,0,74,2
2020-09-22,Mendocino,045,87422,859,794,1,795,18
2020-09-22,Merced,047,269075,8847,8769,18,8787,132
2020-09-22,Modoc,049,8938,29,24,0,24,0
2020-09-22,Mono,051,14174,168,149,2,151,1
2020-09-22,Monterey,053,433212,9767,9393,28,9421,67
2020-09-22,Napa,055,140530,1713,1652,8,1660,11
2020-09-22,Nevada,057,99092,538,523,16,539,6
2020-09-22,Orange,059,3164182,54343,51528,1428,52956,1132
2020-09-22,Placer,061,380077,3611,3492,13,3505,40
2020-09-22,Plumas,063,18699,49,48,0,48,0
2020-09-22,Riverside,065,2383286,58483,57066,159,57225,1162
2020-09-22,Sacramento,067,1510023,22373,21745,24,21769,410
2020-09-22,San Benito,069,59416,1331,1305,0,1305,10
2020-09-22,San Bernardino,071,2135413,53787,51899,344,52243,971
2020-09-22,San Diego,073,3302833,47025,45149,904,46053,765
2020-09-22,San Francisco,075,870044,11146,10893,26,10919,95
2020-09-22,San Joaquin,077,732212,20121,19755,54,19809,426
2020-09-22,San Luis Obispo,079,281455,3705,3420,17,3437,31
2020-09-22,San Mateo,081,765935,10053,9291,10,9301,127
2020-09-22,Santa Barbara,083,443738,9101,8927,76,9003,111
2020-09-22,Santa Clara,085,1922200,21847,20514,41,20555,253
2020-09-22,Santa Cruz,087,273765,2399,2264,28,2292,8
2020-09-22,Shasta,089,179085,994,723,4,727,14
2020-09-22,Sierra,091,2930,6,6,0,6,0
2020-09-22,Siskiyou,093,43540,155,149,10,159,0
2020-09-22,Solano,095,438530,6265,6107,39,6146,48
2020-09-22,Sonoma,097,501317,7466,7068,20,7088,117
2020-09-22,Stanislaus,099,539301,16481,16231,503,16734,316
2020-09-22,Sutter,101,95872,1669,1638,1,1639,10
2020-09-22,Tehama,103,63373,566,529,2,531,2
2020-09-22,Trinity,105,12862,53,15,8,23,0
2020-09-22,Tulare,107,460477,16237,15616,122,15738,263
2020-09-22,Tuolumne,109,53932,232,224,5,229,1
2020-09-22,Ventura,111,848112,13212,12507,158,12665,136
2020-09-22,Yolo,113,214977,2809,2763,7,2770,54
2020-09-22,Yuba,115,75493,1073,1035,5,1040,5
2020-09-21,Alameda,001,1643700,21224,20501,167,20668,343
2020-09-21,Alpine,003,1148,2,2,0,2,0
2020-09-21,Amador,005,37829,291,286,0,286,16
2020-09-21,Butte,007,227075,2892,2769,30,2799,41
2020-09-21,Calaveras,009,45235,307,256,0,256,10
2020-09-21,Colusa,011,21464,528,517,0,517,6
2020-09-21,Contra Costa,013,1133247,16851,16008,80,16088,189
2020-09-21,Del Norte,015,27424,136,132,0,132,2
2020-09-21,El Dorado,017,186661,1157,1074,8,1082,4
2020-09-21,Fresno,019,978130,30362,27843,365,28208,362
2020-09-21,Glenn,021,27897,576,556,0,556,3
2020-09-21,Humboldt,023,135768,494,473,1,474,5
2020-09-21,Imperial,025,180216,11743,10521,9,10530,284
2020-09-21,Inyo,027,18085,187,177,4,181,12
2020-09-21,Kern,029,883053,31769,31031,306,31337,379
2020-09-21,Kings,031,150075,7642,7297,35,7332,76
2020-09-21,Lake,033,64148,558,508,0,508,8
2020-09-21,Lassen,035,31185,745,735,2,737,0
2020-09-21,Los Angeles,037,10098052,264635,261418,1730,263148,6360
2020-09-21,Madera,039,155013,4512,4275,29,4304,47
2020-09-21,Marin,041,260295,6676,6538,16,6554,84
2020-09-21,Mariposa,043,17540,75,74,0,74,2
2020-09-21,Mendocino,045,87422,844,778,0,778,18
2020-09-21,Merced,047,269075,8828,8749,16,8765,128
2020-09-21,Modoc,049,8938,29,22,0,22,0
2020-09-21,Mono,051,14174,168,147,2,149,1
2020-09-21,Monterey,053,433212,9703,9331,25,9356,66
2020-09-21,Napa,055,140530,1702,1641,8,1649,11
2020-09-21,Nevada,057,99092,536,515,16,531,6
2020-09-21,Orange,059,3164182,54121,51363,1421,52784,1110
2020-09-21,Placer,061,380077,3601,3473,13,3486,40
2020-09-21,Plumas,063,18699,49,47,0,47,0
2020-09-21,Riverside,065,2383286,58211,57001,152,57153,1153
2020-09-21,Sacramento,067,1510023,22192,21568,24,21592,404
2020-09-21,San Benito,069,59416,1329,1298,0,1298,10
2020-09-21,San Bernardino,071,2135413,53501,51654,344,51998,970
2020-09-21,San Diego,073,3302833,46741,44927,883,45810,760
2020-09-21,San Francisco,075,870044,11098,10743,26,10769,95
2020-09-21,San Joaquin,077,732212,20063,19579,54,19633,423
2020-09-21,San Luis Obispo,079,281455,3679,3406,17,3423,27
2020-09-21,San Mateo,081,765935,10001,9239,10,9249,127
2020-09-21,Santa Barbara,083,443738,9073,8911,76,8987,110
2020-09-21,Santa Clara,085,1922200,21746,20432,41,20473,252
2020-09-21,Santa Cruz,087,273765,2382,2257,26,2283,8
2020-09-21,Shasta,089,179085,944,696,4,700,14
2020-09-21,Sierra,091,2930,6,6,0,6,0
2020-09-21,Siskiyou,093,43540,155,146,10,156,0
2020-09-21,Solano,095,438530,6241,6019,39,6058,46
2020-09-21,Sonoma,097,501317,7390,7017,20,7037,117
2020-09-21,Stanislaus,099,539301,16451,16186,503,16689,310
2020-09-21,Sutter,101,95872,1662,1634,1,1635,10
2020-09-21,Tehama,103,63373,547,513,2,515,2
2020-09-21,Trinity,105,12862,53,15,8,23,0
2020-09-21,Tulare,107,460477,16163,15528,113,15641,260
2020-09-21,Tuolumne,109,53932,232,221,5,226,1
2020-09-21,Ventura,111,848112,13128,12477,152,12629,133
2020-09-21,Yolo,113,214977,2803,2752,7,2759,54
2020-09-21,Yuba,115,75493,1069,1033,5,1038,1
2020-09-20,Alameda,001,1643700,21124,20425,164,20589,343
2020-09-20,Alpine,003,1148,2,2,0,2,0
2020-09-20,Amador,005,37829,290,286,0,286,16
2020-09-20,Butte,007,227075,2880,2764,30,2794,39
2020-09-20,Calaveras,009,45235,303,256,0,256,10
2020-09-20,Colusa,011,21464,526,510,0,510,6
2020-09-20,Contra Costa,013,1133247,16717,15917,79,15996,189
2020-09-20,Del Norte,015,27424,134,132,0,132,2
2020-09-20,El Dorado,017,186661,1142,1073,8,1081,4
2020-09-20,Fresno,019,978130,30248,27769,360,28129,362
2020-09-20,Glenn,021,27897,572,550,0,550,3
2020-09-20,Humboldt,023,135768,494,472,1,473,5
2020-09-20,Imperial,025,180216,11716,10496,8,10504,284
2020-09-20,Inyo,027,18085,187,177,4,181,12
2020-09-20,Kern,029,883053,31686,30992,302,31294,379
2020-09-20,Kings,031,150075,7595,7159,34,7193,76
2020-09-20,Lake,033,64148,546,492,0,492,8
2020-09-20,Lassen,035,31185,745,735,2,737,0
2020-09-20,Los Angeles,037,10098052,263407,260770,1705,262475,6347
2020-09-20,Madera,039,155013,4492,4257,29,4286,47
2020-09-20,Marin,041,260295,6650,6533,16,6549,83
2020-09-20,Mariposa,043,17540,75,74,0,74,2
2020-09-20,Mendocino,045,87422,832,765,0,765,18
2020-09-20,Merced,047,269075,8801,8745,16,8761,128
2020-09-20,Modoc,049,8938,27,22,0,22,0
2020-09-20,Mono,051,14174,167,147,2,149,1
2020-09-20,Monterey,053,433212,9624,9312,25,9337,65
2020-09-20,Napa,055,140530,1693,1626,8,1634,11
2020-09-20,Nevada,057,99092,533,511,16,527,6
2020-09-20,Orange,059,3164182,53880,51233,1411,52644,1110
2020-09-20,Placer,061,380077,3586,3452,13,3465,40
2020-09-20,Plumas,063,18699,49,47,0,47,0
2020-09-20,Riverside,065,2383286,58010,56783,146,56929,1147
2020-09-20,Sacramento,067,1510023,22005,21394,23,21417,401
2020-09-20,San Benito,069,59416,1318,1291,0,1291,9
2020-09-20,San Bernardino,071,2135413,53182,51559,342,51901,970
2020-09-20,San Diego,073,3302833,46368,44579,854,45433,760
2020-09-20,San Francisco,075,870044,11044,10743,26,10769,95
2020-09-20,San Joaquin,077,732212,19998,19578,47,19625,423
2020-09-20,San Luis Obispo,079,281455,3652,3393,17,3410,27
2020-09-20,San Mateo,081,765935,9935,9198,10,9208,127
2020-09-20,Santa Barbara,083,443738,9037,8880,75,8955,110
2020-09-20,Santa Clara,085,1922200,21626,20330,40,20370,252
2020-09-20,Santa Cruz,087,273765,2362,2199,26,2225,8
2020-09-20,Shasta,089,179085,903,696,3,699,14
2020-09-20,Sierra,091,2930,6,6,0,6,0
2020-09-20,Siskiyou,093,43540,155,146,10,156,0
2020-09-20,Solano,095,438530,6197,6020,39,6059,46
2020-09-20,Sonoma,097,501317,7286,6954,20,6974,117
2020-09-20,Stanislaus,099,539301,16420,16159,496,16655,310
2020-09-20,Sutter,101,95872,1656,1624,1,1625,10
2020-09-20,Tehama,103,63373,534,509,2,511,2
2020-09-20,Trinity,105,12862,53,15,8,23,0
2020-09-20,Tulare,107,460477,16077,15528,106,15634,260
2020-09-20,Tuolumne,109,53932,232,221,5,226,1
2020-09-20,Ventura,111,848112,13062,12406,148,12554,133
2020-09-20,Yolo,113,214977,2795,2745,7,2752,54
2020-09-20,Yuba,115,75493,1062,1029,5,1034,1
2020-09-19,Alameda,001,1643700,21074,20349,161,20510,343
2020-09-19,Alpine,003,1148,2,2,0,2,0
2020-09-19,Amador,005,37829,290,285,0,285,16
2020-09-19,Butte,007,227075,2874,2748,30,2778,38
2020-09-19,Calaveras,009,45235,303,256,0,256,10
2020-09-19,Colusa,011,21464,526,507,0,507,6
2020-09-19,Contra Costa,013,1133247,16654,15783,79,15862,186
2020-09-19,Del Norte,015,27424,133,132,0,132,2
2020-09-19,El Dorado,017,186661,1136,1068,7,1075,4
2020-09-19,Fresno,019,978130,30175,27668,360,28028,362
2020-09-19,Glenn,021,27897,569,547,0,547,3
2020-09-19,Humboldt,023,135768,493,471,1,472,5
2020-09-19,Imperial,025,180216,11701,10496,8,10504,284
2020-09-19,Inyo,027,18085,187,177,4,181,12
2020-09-19,Kern,029,883053,31632,30886,299,31185,379
2020-09-19,Kings,031,150075,7589,7130,34,7164,76
2020-09-19,Lake,033,64148,546,465,0,465,8
2020-09-19,Lassen,035,31185,745,731,2,733,0
2020-09-19,Los Angeles,037,10098052,262783,259801,1691,261492,6325
2020-09-19,Madera,039,155013,4469,4237,29,4266,47
2020-09-19,Marin,041,260295,6643,6513,15,6528,81
2020-09-19,Mariposa,043,17540,75,74,0,74,2
2020-09-19,Mendocino,045,87422,829,750,0,750,18
2020-09-19,Merced,047,269075,8790,8717,15,8732,128
2020-09-19,Modoc,049,8938,27,22,0,22,0
2020-09-19,Mono,051,14174,167,147,2,149,1
2020-09-19,Monterey,053,433212,9582,9237,25,9262,65
2020-09-19,Napa,055,140530,1685,1614,8,1622,11
2020-09-19,Nevada,057,99092,531,505,16,521,6
2020-09-19,Orange,059,3164182,53752,50999,1404,52403,1105
2020-09-19,Placer,061,380077,3577,3412,13,3425,40
2020-09-19,Plumas,063,18699,49,47,0,47,0
2020-09-19,Riverside,065,2383286,57883,56562,145,56707,1147
2020-09-19,Sacramento,067,1510023,21951,21297,23,21320,396
2020-09-19,San Benito,069,59416,1314,1276,0,1276,9
2020-09-19,San Bernardino,071,2135413,53026,51353,339,51692,971
2020-09-19,San Diego,073,3302833,46140,44295,831,45126,773
2020-09-19,San Francisco,075,870044,11011,10741,26,10767,95
2020-09-19,San Joaquin,077,732212,19961,19580,47,19627,424
2020-09-19,San Luis Obispo,079,281455,3631,3369,17,3386,27
2020-09-19,San Mateo,081,765935,9904,9158,10,9168,127
2020-09-19,Santa Barbara,083,443738,9017,8862,75,8937,106
2020-09-19,Santa Clara,085,1922200,21537,20170,40,20210,251
2020-09-19,Santa Cruz,087,273765,2348,2198,25,2223,8
2020-09-19,Shasta,089,179085,876,687,3,690,14
2020-09-19,Sierra,091,2930,6,6,0,6,0
2020-09-19,Siskiyou,093,43540,155,146,10,156,0
2020-09-19,Solano,095,438530,6181,5998,39,6037,46
2020-09-19,Sonoma,097,501317,7253,6905,20,6925,117
2020-09-19,Stanislaus,099,539301,16380,16109,489,16598,313
2020-09-19,Sutter,101,95872,1655,1602,1,1603,10
2020-09-19,Tehama,103,63373,529,498,2,500,2
2020-09-19,Trinity,105,12862,53,15,8,23,0
2020-09-19,Tulare,107,460477,16028,15485,103,15588,260
2020-09-19,Tuolumne,109,53932,232,217,5,222,1
2020-09-19,Ventura,111,848112,13030,12328,148,12476,133
2020-09-19,Yolo,113,214977,2787,2739,7,2746,54
2020-09-19,Yuba,115,75493,1055,1023,5,1028,1
2020-09-18,Alameda,001,1643700,21009,20222,155,20377,341
2020-09-18,Alpine,003,1148,2,2,0,2,0
2020-09-18,Amador,005,37829,290,285,0,285,16
2020-09-18,Butte,007,227075,2872,2738,30,2768,37
2020-09-18,Calaveras,009,45235,303,255,0,255,9
2020-09-18,Colusa,011,21464,526,504,0,504,6
2020-09-18,Contra Costa,013,1133247,16569,15667,79,15746,185
2020-09-18,Del Norte,015,27424,133,131,0,131,2
2020-09-18,El Dorado,017,186661,1123,1063,7,1070,4
2020-09-18,Fresno,019,978130,30110,27560,360,27920,359
2020-09-18,Glenn,021,27897,566,541,0,541,3
2020-09-18,Humboldt,023,135768,490,470,1,471,5
2020-09-18,Imperial,025,180216,11686,10460,8,10468,283
2020-09-18,Inyo,027,18085,187,177,4,181,12
2020-09-18,Kern,029,883053,31574,30742,296,31038,373
2020-09-18,Kings,031,150075,7579,7062,34,7096,74
2020-09-18,Lake,033,64148,540,458,0,458,8
2020-09-18,Lassen,035,31185,744,731,2,733,0
2020-09-18,Los Angeles,037,10098052,262022,258488,1673,260161,6324
2020-09-18,Madera,039,155013,4457,4211,29,4240,45
2020-09-18,Marin,041,260295,6628,6475,15,6490,81
2020-09-18,Mariposa,043,17540,75,74,0,74,2
2020-09-18,Mendocino,045,87422,821,739,0,739,18
2020-09-18,Merced,047,269075,8778,8691,14,8705,127
2020-09-18,Modoc,049,8938,27,22,0,22,0
2020-09-18,Mono,051,14174,165,147,2,149,1
2020-09-18,Monterey,053,433212,9541,9183,25,9208,64
2020-09-18,Napa,055,140530,1679,1604,8,1612,11
2020-09-18,Nevada,057,99092,528,504,16,520,6
2020-09-18,Orange,059,3164182,53606,50733,1392,52125,1107
2020-09-18,Placer,061,380077,3566,3389,13,3402,40
2020-09-18,Plumas,063,18699,49,45,0,45,0
2020-09-18,Riverside,065,2383286,57761,56248,140,56388,1143
2020-09-18,Sacramento,067,1510023,21868,21105,23,21128,391
2020-09-18,San Benito,069,59416,1306,1257,0,1257,8
2020-09-18,San Bernardino,071,2135413,52881,51106,336,51442,970
2020-09-18,San Diego,073,3302833,45890,44009,826,44835,757
2020-09-18,San Francisco,075,870044,10973,10644,25,10669,95
2020-09-18,San Joaquin,077,732212,19917,19531,46,19577,423
2020-09-18,San Luis Obispo,079,281455,3607,3328,17,3345,27
2020-09-18,San Mateo,081,765935,9864,9062,10,9072,127
2020-09-18,Santa Barbara,083,443738,8996,8824,75,8899,107
2020-09-18,Santa Clara,085,1922200,21439,20058,40,20098,252
2020-09-18,Santa Cruz,087,273765,2327,2180,24,2204,8
2020-09-18,Shasta,089,179085,841,668,3,671,14
2020-09-18,Sierra,091,2930,6,6,0,6,0
2020-09-18,Siskiyou,093,43540,154,146,10,156,0
2020-09-18,Solano,095,438530,6165,5961,39,6000,46
2020-09-18,Sonoma,097,501317,7205,6856,20,6876,114
2020-09-18,Stanislaus,099,539301,16352,16042,483,16525,277
2020-09-18,Sutter,101,95872,1648,1586,1,1587,10
2020-09-18,Tehama,103,63373,529,490,2,492,2
2020-09-18,Trinity,105,12862,53,15,7,22,0
2020-09-18,Tulare,107,460477,15995,15435,99,15534,259
2020-09-18,Tuolumne,109,53932,231,216,5,221,1
2020-09-18,Ventura,111,848112,12969,12236,144,12380,133
2020-09-18,Yolo,113,214977,2781,2732,7,2739,54
2020-09-18,Yuba,115,75493,1051,1020,5,1025,1
2020-09-17,Alameda,001,1643700,20910,20146,155,20301,339
2020-09-17,Alpine,003,1148,2,2,0,2,0
2020-09-17,Amador,005,37829,288,284,0,284,16
2020-09-17,Butte,007,227075,2854,2720,30,2750,38
2020-09-17,Calaveras,009,45235,303,254,0,254,9
2020-09-17,Colusa,011,21464,524,499,0,499,6
2020-09-17,Contra Costa,013,1133247,16481,15576,79,15655,184
2020-09-17,Del Norte,015,27424,133,131,0,131,2
2020-09-17,El Dorado,017,186661,1114,1057,7,1064,4
2020-09-17,Fresno,019,978130,30001,27487,355,27842,355
2020-09-17,Glenn,021,27897,565,541,0,541,3
2020-09-17,Humboldt,023,135768,484,466,1,467,5
2020-09-17,Imperial,025,180216,11669,10436,8,10444,281
2020-09-17,Inyo,027,18085,187,176,4,180,12
2020-09-17,Kern,029,883053,31513,30627,289,30916,372
2020-09-17,Kings,031,150075,7508,7015,34,7049,72
2020-09-17,Lake,033,64148,530,433,0,433,8
2020-09-17,Lassen,035,31185,742,731,2,733,0
2020-09-17,Los Angeles,037,10098052,261079,257246,1659,258905,6318
2020-09-17,Madera,039,155013,4423,4152,29,4181,45
2020-09-17,Marin,041,260295,6607,6457,15,6472,81
2020-09-17,Mariposa,043,17540,75,74,0,74,2
2020-09-17,Mendocino,045,87422,810,737,0,737,18
2020-09-17,Merced,047,269075,8759,8671,14,8685,119
2020-09-17,Modoc,049,8938,27,22,0,22,0
2020-09-17,Mono,051,14174,165,147,2,149,1
2020-09-17,Monterey,053,433212,9479,9113,25,9138,62
2020-09-17,Napa,055,140530,1668,1592,8,1600,11
2020-09-17,Nevada,057,99092,526,494,16,510,6
2020-09-17,Orange,059,3164182,53425,50537,1380,51917,1098
2020-09-17,Placer,061,380077,3545,3368,13,3381,40
2020-09-17,Plumas,063,18699,49,45,0,45,0
2020-09-17,Riverside,065,2383286,57535,56007,139,56146,1134
2020-09-17,Sacramento,067,1510023,21633,20895,23,20918,385
2020-09-17,San Benito,069,59416,1304,1252,0,1252,8
2020-09-17,San Bernardino,071,2135413,52679,50770,336,51106,904
2020-09-17,San Diego,073,3302833,45610,43621,814,44435,754
2020-09-17,San Francisco,075,870044,10879,10564,25,10589,95
2020-09-17,San Joaquin,077,732212,19858,19439,46,19485,416
2020-09-17,San Luis Obispo,079,281455,3577,3299,17,3316,27
2020-09-17,San Mateo,081,765935,9822,8984,10,8994,127
2020-09-17,Santa Barbara,083,443738,8972,8779,75,8854,107
2020-09-17,Santa Clara,085,1922200,21322,19825,40,19865,254
2020-09-17,Santa Cruz,087,273765,2311,2155,24,2179,7
2020-09-17,Shasta,089,179085,802,660,3,663,12
2020-09-17,Sierra,091,2930,6,6,0,6,0
2020-09-17,Siskiyou,093,43540,154,146,10,156,0
2020-09-17,Solano,095,438530,6142,5915,39,5954,44
2020-09-17,Sonoma,097,501317,7141,6754,20,6774,114
2020-09-17,Stanislaus,099,539301,16319,15984,479,16463,277
2020-09-17,Sutter,101,95872,1643,1572,1,1573,10
2020-09-17,Tehama,103,63373,515,487,2,489,2
2020-09-17,Trinity,105,12862,53,15,7,22,0
2020-09-17,Tulare,107,460477,15942,15344,97,15441,258
2020-09-17,Tuolumne,109,53932,230,214,5,219,1
2020-09-17,Ventura,111,848112,12882,12167,141,12308,130
2020-09-17,Yolo,113,214977,2772,2724,7,2731,53
2020-09-17,Yuba,115,75493,1047,1015,5,1020,1
2020-09-16,Alameda,001,1643700,20812,20009,153,20162,333
2020-09-16,Alpine,003,1148,2,2,0,2,0
2020-09-16,Amador,005,37829,288,284,0,284,16
2020-09-16,Butte,007,227075,2844,2704,29,2733,38
2020-09-16,Calaveras,009,45235,303,254,0,254,9
2020-09-16,Colusa,011,21464,522,497,0,497,6
2020-09-16,Contra Costa,013,1133247,16395,15473,79,15552,183
2020-09-16,Del Norte,015,27424,133,131,0,131,2
2020-09-16,El Dorado,017,186661,1106,1049,7,1056,4
2020-09-16,Fresno,019,978130,29894,27381,353,27734,343
2020-09-16,Glenn,021,27897,563,539,0,539,3
2020-09-16,Humboldt,023,135768,483,455,1,456,4
2020-09-16,Imperial,025,180216,11646,10401,8,10409,277
2020-09-16,Inyo,027,18085,186,176,4,180,12
2020-09-16,Kern,029,883053,31453,30570,288,30858,371
2020-09-16,Kings,031,150075,7483,7002,32,7034,71
2020-09-16,Lake,033,64148,519,417,0,417,6
2020-09-16,Lassen,035,31185,741,730,2,732,0
2020-09-16,Los Angeles,037,10098052,260097,256101,1642,257743,6299
2020-09-16,Madera,039,155013,4400,4138,29,4167,45
2020-09-16,Marin,041,260295,6579,6430,15,6445,77
2020-09-16,Mariposa,043,17540,75,74,0,74,2
2020-09-16,Mendocino,045,87422,801,727,0,727,18
2020-09-16,Merced,047,269075,8738,8646,14,8660,118
2020-09-16,Modoc,049,8938,27,22,0,22,0
2020-09-16,Mono,051,14174,165,147,2,149,1
2020-09-16,Monterey,053,433212,9425,8997,25,9022,62
2020-09-16,Napa,055,140530,1654,1587,8,1595,11
2020-09-16,Nevada,057,99092,521,495,15,510,6
2020-09-16,Orange,059,3164182,53224,50414,1371,51785,1096
2020-09-16,Placer,061,380077,3527,3351,13,3364,39
2020-09-16,Plumas,063,18699,49,45,0,45,0
2020-09-16,Riverside,065,2383286,57341,55811,131,55942,1127
2020-09-16,Sacramento,067,1510023,21538,20610,23,20633,377
2020-09-16,San Benito,069,59416,1296,1244,0,1244,8
2020-09-16,San Bernardino,071,2135413,52454,50509,335,50844,907
2020-09-16,San Diego,073,3302833,45318,43447,793,44240,748
2020-09-16,San Francisco,075,870044,10832,10502,25,10527,90
2020-09-16,San Joaquin,077,732212,19804,19377,45,19422,409
2020-09-16,San Luis Obispo,079,281455,3546,3285,17,3302,28
2020-09-16,San Mateo,081,765935,9757,8944,10,8954,127
2020-09-16,Santa Barbara,083,443738,8939,8764,75,8839,107
2020-09-16,Santa Clara,085,1922200,21203,19684,40,19724,253
2020-09-16,Santa Cruz,087,273765,2270,2089,23,2112,7
2020-09-16,Shasta,089,179085,776,635,3,638,11
2020-09-16,Sierra,091,2930,6,6,0,6,0
2020-09-16,Siskiyou,093,43540,153,145,10,155,0
2020-09-16,Solano,095,438530,6113,5899,39,5938,44
2020-09-16,Sonoma,097,501317,7080,6731,20,6751,104
2020-09-16,Stanislaus,099,539301,16271,15897,471,16368,263
2020-09-16,Sutter,101,95872,1630,1567,1,1568,10
2020-09-16,Tehama,103,63373,507,485,2,487,2
2020-09-16,Trinity,105,12862,53,15,7,22,0
2020-09-16,Tulare,107,460477,15897,15314,90,15404,258
2020-09-16,Tuolumne,109,53932,229,210,5,215,1
2020-09-16,Ventura,111,848112,12811,12073,139,12212,130
2020-09-16,Yolo,113,214977,2765,2709,7,2716,53
2020-09-16,Yuba,115,75493,1045,1000,5,1005,1
2020-09-15,Alameda,001,1643700,20705,19931,150,20081,327
2020-09-15,Alpine,003,1148,2,2,0,2,0
2020-09-15,Amador,005,37829,287,282,0,282,16
2020-09-15,Butte,007,227075,2831,2695,27,2722,38
2020-09-15,Calaveras,009,45235,303,248,0,248,5
2020-09-15,Colusa,011,21464,516,497,0,497,6
2020-09-15,Contra Costa,013,1133247,16294,15423,77,15500,180
2020-09-15,Del Norte,015,27424,133,129,0,129,2
2020-09-15,El Dorado,017,186661,1101,1046,7,1053,4
2020-09-15,Fresno,019,978130,29787,27312,348,27660,343
2020-09-15,Glenn,021,27897,562,531,0,531,3
2020-09-15,Humboldt,023,135768,481,456,1,457,4
2020-09-15,Imperial,025,180216,11621,10376,8,10384,277
2020-09-15,Inyo,027,18085,186,176,4,180,12
2020-09-15,Kern,029,883053,31340,30429,285,30714,368
2020-09-15,Kings,031,150075,7325,6977,32,7009,70
2020-09-15,Lake,033,64148,505,416,0,416,4
2020-09-15,Lassen,035,31185,737,719,2,721,0
2020-09-15,Los Angeles,037,10098052,258986,255048,1620,256668,6269
2020-09-15,Madera,039,155013,4381,4122,29,4151,45
2020-09-15,Marin,041,260295,6548,6423,15,6438,77
2020-09-15,Mariposa,043,17540,75,74,0,74,2
2020-09-15,Mendocino,045,87422,783,724,0,724,18
2020-09-15,Merced,047,269075,8708,8633,14,8647,114
2020-09-15,Modoc,049,8938,26,21,0,21,0
2020-09-15,Mono,051,14174,165,147,2,149,1
2020-09-15,Monterey,053,433212,9376,8943,25,8968,62
2020-09-15,Napa,055,140530,1640,1580,8,1588,11
2020-09-15,Nevada,057,99092,516,494,15,509,6
2020-09-15,Orange,059,3164182,53042,50294,1357,51651,1088
2020-09-15,Placer,061,380077,3503,3331,13,3344,38
2020-09-15,Plumas,063,18699,49,44,0,44,0
2020-09-15,Riverside,065,2383286,57047,55569,121,55690,1118
2020-09-15,Sacramento,067,1510023,21395,20487,23,20510,372
2020-09-15,San Benito,069,59416,1289,1237,0,1237,7
2020-09-15,San Bernardino,071,2135413,52238,50333,334,50667,904
2020-09-15,San Diego,073,3302833,44999,43183,773,43956,742
2020-09-15,San Francisco,075,870044,10774,10414,25,10439,90
2020-09-15,San Joaquin,077,732212,19752,19313,45,19358,401
2020-09-15,San Luis Obispo,079,281455,3526,3262,17,3279,28
2020-09-15,San Mateo,081,765935,9687,8895,10,8905,127
2020-09-15,Santa Barbara,083,443738,8914,8724,74,8798,104
2020-09-15,Santa Clara,085,1922200,21069,19610,40,19650,252
2020-09-15,Santa Cruz,087,273765,2244,2079,22,2101,7
2020-09-15,Shasta,089,179085,764,627,3,630,11
2020-09-15,Sierra,091,2930,6,6,0,6,0
2020-09-15,Siskiyou,093,43540,153,143,10,153,0
2020-09-15,Solano,095,438530,6079,5878,39,5917,45
2020-09-15,Sonoma,097,501317,7041,6701,20,6721,104
2020-09-15,Stanislaus,099,539301,16223,15880,469,16349,260
2020-09-15,Sutter,101,95872,1619,1556,1,1557,10
2020-09-15,Tehama,103,63373,495,484,2,486,2
2020-09-15,Trinity,105,12862,53,15,7,22,0
2020-09-15,Tulare,107,460477,15821,15203,88,15291,254
2020-09-15,Tuolumne,109,53932,229,209,5,214,1
2020-09-15,Ventura,111,848112,12758,11932,138,12070,128
2020-09-15,Yolo,113,214977,2761,2708,7,2715,53
2020-09-15,Yuba,115,75493,1039,991,4,995,1
2020-09-14,Alameda,001,1643700,20577,19851,149,20000,306
2020-09-14,Alpine,003,1148,2,2,0,2,0
2020-09-14,Amador,005,37829,285,281,0,281,16
2020-09-14,Butte,007,227075,2814,2642,27,2669,37
2020-09-14,Calaveras,009,45235,303,244,0,244,3
2020-09-14,Colusa,011,21464,515,486,0,486,6
2020-09-14,Contra Costa,013,1133247,16170,15354,76,15430,174
2020-09-14,Del Norte,015,27424,130,116,0,116,2
2020-09-14,El Dorado,017,186661,1097,1039,7,1046,3
2020-09-14,Fresno,019,978130,29703,27232,345,27577,344
2020-09-14,Glenn,021,27897,554,521,0,521,3
2020-09-14,Humboldt,023,135768,478,437,1,438,4
2020-09-14,Imperial,025,180216,11601,10340,8,10348,273
2020-09-14,Inyo,027,18085,186,176,4,180,12
2020-09-14,Kern,029,883053,31252,30344,284,30628,368
2020-09-14,Kings,031,150075,7244,6950,32,6982,70
2020-09-14,Lake,033,64148,485,407,0,407,4
2020-09-14,Lassen,035,31185,737,719,2,721,0
2020-09-14,Los Angeles,037,10098052,257954,254622,1595,256217,6226
2020-09-14,Madera,039,155013,4367,4104,29,4133,45
2020-09-14,Marin,041,260295,6527,6409,15,6424,70
2020-09-14,Mariposa,043,17540,75,74,0,74,2
2020-09-14,Mendocino,045,87422,766,710,0,710,17
2020-09-14,Merced,047,269075,8689,8593,14,8607,112
2020-09-14,Modoc,049,8938,26,21,0,21,0
2020-09-14,Mono,051,14174,165,147,2,149,1
2020-09-14,Monterey,053,433212,9305,8845,24,8869,61
2020-09-14,Napa,055,140530,1623,1576,8,1584,11
2020-09-14,Nevada,057,99092,511,489,15,504,6
2020-09-14,Orange,059,3164182,52881,50149,1341,51490,1079
2020-09-14,Placer,061,380077,3482,3302,13,3315,38
2020-09-14,Plumas,063,18699,48,42,0,42,0
2020-09-14,Riverside,065,2383286,56828,55488,117,55605,1113
2020-09-14,Sacramento,067,1510023,21200,20377,22,20399,367
2020-09-14,San Benito,069,59416,1274,1233,0,1233,7
2020-09-14,San Bernardino,071,2135413,52013,50163,333,50496,895
2020-09-14,San Diego,073,3302833,44688,42889,753,43642,734
2020-09-14,San Francisco,075,870044,10707,10255,23,10278,90
2020-09-14,San Joaquin,077,732212,19678,19111,44,19155,397
2020-09-14,San Luis Obispo,079,281455,3501,3248,17,3265,25
2020-09-14,San Mateo,081,765935,9626,8847,10,8857,127
2020-09-14,Santa Barbara,083,443738,8888,8692,74,8766,104
2020-09-14,Santa Clara,085,1922200,20881,19545,40,19585,247
2020-09-14,Santa Cruz,087,273765,2223,2016,21,2037,7
2020-09-14,Shasta,089,179085,741,584,3,587,10
2020-09-14,Sierra,091,2930,6,6,0,6,0
2020-09-14,Siskiyou,093,43540,152,143,10,153,0
2020-09-14,Solano,095,438530,6044,5834,39,5873,44
2020-09-14,Sonoma,097,501317,6979,6630,20,6650,102
2020-09-14,Stanislaus,099,539301,16178,15812,466,16278,253
2020-09-14,Sutter,101,95872,1608,1549,1,1550,10
2020-09-14,Tehama,103,63373,493,475,2,477,1
2020-09-14,Trinity,105,12862,52,14,7,21,0
2020-09-14,Tulare,107,460477,15751,15096,82,15178,254
2020-09-14,Tuolumne,109,53932,228,208,5,213,1
2020-09-14,Ventura,111,848112,12656,11903,135,12038,125
2020-09-14,Yolo,113,214977,2750,2687,7,2694,53
2020-09-14,Yuba,115,75493,1031,977,4,981,1
2020-09-13,Alameda,001,1643700,20471,19815,146,19961,306
2020-09-13,Alpine,003,1148,2,2,0,2,0
2020-09-13,Amador,005,37829,282,279,0,279,16
2020-09-13,Butte,007,227075,2792,2640,27,2667,37
2020-09-13,Calaveras,009,45235,302,246,0,246,3
2020-09-13,Colusa,011,21464,511,486,0,486,6
2020-09-13,Contra Costa,013,1133247,16064,15284,76,15360,172
2020-09-13,Del Norte,015,27424,127,116,0,116,1
2020-09-13,El Dorado,017,186661,1092,1035,7,1042,2
2020-09-13,Fresno,019,978130,29595,27196,336,27532,345
2020-09-13,Glenn,021,27897,550,517,0,517,3
2020-09-13,Humboldt,023,135768,478,434,1,435,4
2020-09-13,Imperial,025,180216,11564,10304,7,10311,273
2020-09-13,Inyo,027,18085,186,176,4,180,12
2020-09-13,Kern,029,883053,31159,30277,278,30555,368
2020-09-13,Kings,031,150075,7225,6937,32,6969,70
2020-09-13,Lake,033,64148,466,397,0,397,4
2020-09-13,Lassen,035,31185,734,719,2,721,0
2020-09-13,Los Angeles,037,10098052,256802,253950,1580,255530,6203
2020-09-13,Madera,039,155013,4310,4090,29,4119,45
2020-09-13,Marin,041,260295,6506,6395,15,6410,70
2020-09-13,Mariposa,043,17540,75,74,0,74,2
2020-09-13,Mendocino,045,87422,759,707,0,707,17
2020-09-13,Merced,047,269075,8655,8575,14,8589,112
2020-09-13,Modoc,049,8938,26,21,0,21,0
2020-09-13,Mono,051,14174,165,147,2,149,1
2020-09-13,Monterey,053,433212,9223,8826,23,8849,61
2020-09-13,Napa,055,140530,1616,1563,8,1571,11
2020-09-13,Nevada,057,99092,503,486,15,501,6
2020-09-13,Orange,059,3164182,52665,50061,1334,51395,1075
2020-09-13,Placer,061,380077,3452,3291,13,3304,38
2020-09-13,Plumas,063,18699,48,42,0,42,0
2020-09-13,Riverside,065,2383286,56621,55235,106,55341,1108
2020-09-13,Sacramento,067,1510023,20854,20279,22,20301,367
2020-09-13,San Benito,069,59416,1266,1217,0,1217,7
2020-09-13,San Bernardino,071,2135413,51727,49968,331,50299,895
2020-09-13,San Diego,073,3302833,44362,42681,719,43400,734
2020-09-13,San Francisco,075,870044,10629,10254,23,10277,90
2020-09-13,San Joaquin,077,732212,19607,19110,43,19153,396
2020-09-13,San Luis Obispo,079,281455,3464,3240,17,3257,24
2020-09-13,San Mateo,081,765935,9565,8811,10,8821,127
2020-09-13,Santa Barbara,083,443738,8851,8690,74,8764,104
2020-09-13,Santa Clara,085,1922200,20742,19456,39,19495,245
2020-09-13,Santa Cruz,087,273765,2190,2016,19,2035,7
2020-09-13,Shasta,089,179085,729,583,3,586,10
2020-09-13,Sierra,091,2930,6,6,0,6,0
2020-09-13,Siskiyou,093,43540,152,143,9,152,0
2020-09-13,Solano,095,438530,5998,5810,39,5849,43
2020-09-13,Sonoma,097,501317,6914,6592,20,6612,95
2020-09-13,Stanislaus,099,539301,16115,15759,454,16213,253
2020-09-13,Sutter,101,95872,1596,1539,1,1540,10
2020-09-13,Tehama,103,63373,489,476,2,478,1
2020-09-13,Trinity,105,12862,52,14,7,21,0
2020-09-13,Tulare,107,460477,15680,15098,81,15179,254
2020-09-13,Tuolumne,109,53932,224,208,5,213,1
2020-09-13,Ventura,111,848112,12548,11855,134,11989,123
2020-09-13,Yolo,113,214977,2738,2675,7,2682,53
2020-09-13,Yuba,115,75493,1026,967,4,971,1
2020-09-12,Alameda,001,1643700,20412,19758,146,19904,307
2020-09-12,Alpine,003,1148,2,2,0,2,0
2020-09-12,Amador,005,37829,281,278,0,278,16
2020-09-12,Butte,007,227075,2785,2629,26,2655,37
2020-09-12,Calaveras,009,45235,300,246,0,246,3
2020-09-12,Colusa,011,21464,507,486,0,486,6
2020-09-12,Contra Costa,013,1133247,15987,15135,75,15210,174
2020-09-12,Del Norte,015,27424,126,116,0,116,1
2020-09-12,El Dorado,017,186661,1085,1034,7,1041,2
2020-09-12,Fresno,019,978130,29524,27076,336,27412,345
2020-09-12,Glenn,021,27897,549,517,0,517,3
2020-09-12,Humboldt,023,135768,477,430,1,431,4
2020-09-12,Imperial,025,180216,11552,10305,7,10312,273
2020-09-12,Inyo,027,18085,186,177,4,181,12
2020-09-12,Kern,029,883053,31093,30202,278,30480,368
2020-09-12,Kings,031,150075,7215,6895,32,6927,70
2020-09-12,Lake,033,64148,460,393,0,393,4
2020-09-12,Lassen,035,31185,734,719,2,721,0
2020-09-12,Los Angeles,037,10098052,256245,253156,1559,254715,6193
2020-09-12,Madera,039,155013,4299,4058,29,4087,43
2020-09-12,Marin,041,260295,6497,6393,15,6408,69
2020-09-12,Mariposa,043,17540,75,72,0,72,2
2020-09-12,Mendocino,045,87422,756,700,0,700,17
2020-09-12,Merced,047,269075,8646,8533,14,8547,112
2020-09-12,Modoc,049,8938,25,21,0,21,0
2020-09-12,Mono,051,14174,165,147,2,149,1
2020-09-12,Monterey,053,433212,9187,8743,23,8766,61
2020-09-12,Napa,055,140530,1613,1556,8,1564,11
2020-09-12,Nevada,057,99092,502,482,15,497,6
2020-09-12,Orange,059,3164182,52550,49895,1331,51226,1078
2020-09-12,Placer,061,380077,3435,3280,13,3293,38
2020-09-12,Plumas,063,18699,48,42,0,42,0
2020-09-12,Riverside,065,2383286,56493,55058,102,55160,1108
2020-09-12,Sacramento,067,1510023,20785,20184,22,20206,367
2020-09-12,San Benito,069,59416,1263,1208,0,1208,7
2020-09-12,San Bernardino,071,2135413,51636,49945,329,50274,896
2020-09-12,San Diego,073,3302833,44167,42416,710,43126,747
2020-09-12,San Francisco,075,870044,10585,10257,23,10280,90
2020-09-12,San Joaquin,077,732212,19579,19108,43,19151,396
2020-09-12,San Luis Obispo,079,281455,3437,3220,17,3237,24
2020-09-12,San Mateo,081,765935,9520,8759,10,8769,127
2020-09-12,Santa Barbara,083,443738,8837,8642,74,8716,104
2020-09-12,Santa Clara,085,1922200,20658,19330,39,19369,237
2020-09-12,Santa Cruz,087,273765,2178,2016,19,2035,7
2020-09-12,Shasta,089,179085,717,569,3,572,10
2020-09-12,Sierra,091,2930,6,6,0,6,0
2020-09-12,Siskiyou,093,43540,152,141,9,150,0
2020-09-12,Solano,095,438530,5974,5772,39,5811,43
2020-09-12,Sonoma,097,501317,6889,6531,20,6551,95
2020-09-12,Stanislaus,099,539301,16083,15675,451,16126,253
2020-09-12,Sutter,101,95872,1590,1529,1,1530,10
2020-09-12,Tehama,103,63373,486,471,2,473,1
2020-09-12,Trinity,105,12862,52,15,7,22,0
2020-09-12,Tulare,107,460477,15634,15018,80,15098,254
2020-09-12,Tuolumne,109,53932,224,208,5,213,1
2020-09-12,Ventura,111,848112,12497,11759,132,11891,123
2020-09-12,Yolo,113,214977,2731,2646,7,2653,53
2020-09-12,Yuba,115,75493,1022,963,4,967,1
2020-09-11,Alameda,001,1643700,20357,19625,145,19770,298
2020-09-11,Alpine,003,1148,2,2,0,2,0
2020-09-11,Amador,005,37829,281,277,0,277,16
2020-09-11,Butte,007,227075,2774,2605,26,2631,37
2020-09-11,Calaveras,009,45235,299,242,0,242,1
2020-09-11,Colusa,011,21464,506,484,0,484,6
2020-09-11,Contra Costa,013,1133247,15935,15001,72,15073,173
2020-09-11,Del Norte,015,27424,126,115,0,115,1
2020-09-11,El Dorado,017,186661,1082,1024,7,1031,2
2020-09-11,Fresno,019,978130,29446,26917,335,27252,344
2020-09-11,Glenn,021,27897,544,515,0,515,3
2020-09-11,Humboldt,023,135768,475,426,1,427,4
2020-09-11,Imperial,025,180216,11534,10286,7,10293,273
2020-09-11,Inyo,027,18085,186,176,4,180,12
2020-09-11,Kern,029,883053,31025,30059,277,30336,365
2020-09-11,Kings,031,150075,7198,6770,32,6802,70
2020-09-11,Lake,033,64148,453,382,0,382,4
2020-09-11,Lassen,035,31185,734,719,2,721,0
2020-09-11,Los Angeles,037,10098052,255564,252057,1548,253605,6172
2020-09-11,Madera,039,155013,4280,4018,29,4047,43
2020-09-11,Marin,041,260295,6494,6364,15,6379,69
2020-09-11,Mariposa,043,17540,75,72,0,72,2
2020-09-11,Mendocino,045,87422,745,700,0,700,17
2020-09-11,Merced,047,269075,8625,8489,14,8503,109
2020-09-11,Modoc,049,8938,25,21,0,21,0
2020-09-11,Mono,051,14174,165,145,2,147,1
2020-09-11,Monterey,053,433212,9139,8595,23,8618,61
2020-09-11,Napa,055,140530,1602,1543,8,1551,11
2020-09-11,Nevada,057,99092,495,483,15,498,6
2020-09-11,Orange,059,3164182,52421,49755,1319,51074,1068
2020-09-11,Placer,061,380077,3420,3254,13,3267,37
2020-09-11,Plumas,063,18699,48,42,0,42,0
2020-09-11,Riverside,065,2383286,56358,54717,99,54816,1099
2020-09-11,Sacramento,067,1510023,20700,20012,22,20034,358
2020-09-11,San Benito,069,59416,1253,1202,0,1202,7
2020-09-11,San Bernardino,071,2135413,51537,49682,329,50011,871
2020-09-11,San Diego,073,3302833,43947,41971,704,42675,730
2020-09-11,San Francisco,075,870044,10537,10133,22,10155,89
2020-09-11,San Joaquin,077,732212,19531,19019,43,19062,391
2020-09-11,San Luis Obispo,079,281455,3419,3190,17,3207,24
2020-09-11,San Mateo,081,765935,9478,8611,10,8621,127
2020-09-11,Santa Barbara,083,443738,8804,8592,73,8665,103
2020-09-11,Santa Clara,085,1922200,20569,19065,39,19104,234
2020-09-11,Santa Cruz,087,273765,2161,1997,19,2016,7
2020-09-11,Shasta,089,179085,707,568,3,571,10
2020-09-11,Sierra,091,2930,6,6,0,6,0
2020-09-11,Siskiyou,093,43540,151,139,9,148,0
2020-09-11,Solano,095,438530,5957,5742,39,5781,42
2020-09-11,Sonoma,097,501317,6845,6469,20,6489,91
2020-09-11,Stanislaus,099,539301,16045,15613,448,16061,253
2020-09-11,Sutter,101,95872,1580,1505,1,1506,11
2020-09-11,Tehama,103,63373,483,466,2,468,1
2020-09-11,Trinity,105,12862,52,16,7,23,0
2020-09-11,Tulare,107,460477,15603,14932,78,15010,251
2020-09-11,Tuolumne,109,53932,224,208,5,213,1
2020-09-11,Ventura,111,848112,12443,11700,130,11830,123
2020-09-11,Yolo,113,214977,2720,2632,7,2639,53
2020-09-11,Yuba,115,75493,1014,946,4,950,1
2020-09-10,Alameda,001,1643700,20283,19509,145,19654,292
2020-09-10,Alpine,003,1148,2,2,0,2,0
2020-09-10,Amador,005,37829,280,277,0,277,16
2020-09-10,Butte,007,227075,2757,2590,26,2616,37
2020-09-10,Calaveras,009,45235,299,244,0,244,1
2020-09-10,Colusa,011,21464,504,482,0,482,6
2020-09-10,Contra Costa,013,1133247,15865,14909,72,14981,172
2020-09-10,Del Norte,015,27424,125,112,0,112,1
2020-09-10,El Dorado,017,186661,1079,1020,7,1027,2
2020-09-10,Fresno,019,978130,29324,26783,335,27118,338
2020-09-10,Glenn,021,27897,534,511,0,511,3
2020-09-10,Humboldt,023,135768,464,422,1,423,4
2020-09-10,Imperial,025,180216,11518,10251,7,10258,270
2020-09-10,Inyo,027,18085,185,176,4,180,11
2020-09-10,Kern,029,883053,30942,29988,273,30261,363
2020-09-10,Kings,031,150075,7168,6739,32,6771,70
2020-09-10,Lake,033,64148,446,377,0,377,4
2020-09-10,Lassen,035,31185,733,716,2,718,0
2020-09-10,Los Angeles,037,10098052,254585,251003,1527,252530,6132
2020-09-10,Madera,039,155013,4262,3979,29,4008,43
2020-09-10,Marin,041,260295,6482,6344,15,6359,68
2020-09-10,Mariposa,043,17540,75,72,0,72,2
2020-09-10,Mendocino,045,87422,735,697,0,697,16
2020-09-10,Merced,047,269075,8579,8461,14,8475,109
2020-09-10,Modoc,049,8938,25,21,0,21,0
2020-09-10,Mono,051,14174,165,145,2,147,1
2020-09-10,Monterey,053,433212,9069,8570,23,8593,59
2020-09-10,Napa,055,140530,1596,1536,8,1544,11
2020-09-10,Nevada,057,99092,491,478,15,493,6
2020-09-10,Orange,059,3164182,52258,49617,1313,50930,1057
2020-09-10,Placer,061,380077,3400,3233,13,3246,37
2020-09-10,Plumas,063,18699,48,42,0,42,0
2020-09-10,Riverside,065,2383286,56039,54417,96,54513,1091
2020-09-10,Sacramento,067,1510023,20578,19618,21,19639,354
2020-09-10,San Benito,069,59416,1247,1201,0,1201,5
2020-09-10,San Bernardino,071,2135413,51349,49467,327,49794,867
2020-09-10,San Diego,073,3302833,43681,41610,677,42287,725
2020-09-10,San Francisco,075,870044,10460,10082,22,10104,89
2020-09-10,San Joaquin,077,732212,19478,18854,43,18897,389
2020-09-10,San Luis Obispo,079,281455,3405,3161,16,3177,24
2020-09-10,San Mateo,081,765935,9432,8529,10,8539,125
2020-09-10,Santa Barbara,083,443738,8759,8552,73,8625,100
2020-09-10,Santa Clara,085,1922200,20455,18870,39,18909,231
2020-09-10,Santa Cruz,087,273765,2146,1986,17,2003,7
2020-09-10,Shasta,089,179085,696,566,3,569,10
2020-09-10,Sierra,091,2930,6,6,0,6,0
2020-09-10,Siskiyou,093,43540,151,137,9,146,0
2020-09-10,Solano,095,438530,5917,5696,39,5735,42
2020-09-10,Sonoma,097,501317,6796,6424,20,6444,91
2020-09-10,Stanislaus,099,539301,15991,15509,443,15952,243
2020-09-10,Sutter,101,95872,1570,1494,1,1495,11
2020-09-10,Tehama,103,63373,476,466,2,468,1
2020-09-10,Trinity,105,12862,52,15,7,22,0
2020-09-10,Tulare,107,460477,15548,14860,75,14935,250
2020-09-10,Tuolumne,109,53932,223,205,5,210,1
2020-09-10,Ventura,111,848112,12349,11600,123,11723,122
2020-09-10,Yolo,113,214977,2715,2612,7,2619,53
2020-09-10,Yuba,115,75493,1008,941,4,945,1
2020-09-09,Alameda,001,1643700,20204,19399,144,19543,289
2020-09-09,Alpine,003,1148,2,2,0,2,0
2020-09-09,Amador,005,37829,279,276,0,276,16
2020-09-09,Butte,007,227075,2740,2561,26,2587,37
2020-09-09,Calaveras,009,45235,299,242,0,242,1
2020-09-09,Colusa,011,21464,499,479,0,479,6
2020-09-09,Contra Costa,013,1133247,15779,14816,72,14888,171
2020-09-09,Del Norte,015,27424,121,109,0,109,1
2020-09-09,El Dorado,017,186661,1076,1020,7,1027,2
2020-09-09,Fresno,019,978130,29221,26724,330,27054,329
2020-09-09,Glenn,021,27897,531,508,0,508,3
2020-09-09,Humboldt,023,135768,462,420,1,421,4
2020-09-09,Imperial,025,180216,11497,10233,7,10240,268
2020-09-09,Inyo,027,18085,184,173,4,177,2
2020-09-09,Kern,029,883053,30844,29925,270,30195,355
2020-09-09,Kings,031,150075,7150,6721,32,6753,72
2020-09-09,Lake,033,64148,438,371,0,371,4
2020-09-09,Lassen,035,31185,732,714,2,716,0
2020-09-09,Los Angeles,037,10098052,253711,249876,1509,251385,6091
2020-09-09,Madera,039,155013,4236,3926,29,3955,43
2020-09-09,Marin,041,260295,6463,6321,15,6336,68
2020-09-09,Mariposa,043,17540,74,72,0,72,2
2020-09-09,Mendocino,045,87422,727,695,0,695,16
2020-09-09,Merced,047,269075,8553,8441,14,8455,107
2020-09-09,Modoc,049,8938,24,20,0,20,0
2020-09-09,Mono,051,14174,165,145,2,147,1
2020-09-09,Monterey,053,433212,8997,8527,23,8550,59
2020-09-09,Napa,055,140530,1586,1531,8,1539,11
2020-09-09,Nevada,057,99092,487,476,15,491,6
2020-09-09,Orange,059,3164182,52079,49394,1306,50700,1054
2020-09-09,Placer,061,380077,3380,3222,13,3235,36
2020-09-09,Plumas,063,18699,46,42,0,42,0
2020-09-09,Riverside,065,2383286,55809,54320,93,54413,1081
2020-09-09,Sacramento,067,1510023,20472,19474,20,19494,347
2020-09-09,San Benito,069,59416,1243,1199,0,1199,5
2020-09-09,San Bernardino,071,2135413,51151,49264,326,49590,866
2020-09-09,San Diego,073,3302833,43392,41326,665,41991,721
2020-09-09,San Francisco,075,870044,10410,9996,21,10017,86
2020-09-09,San Joaquin,077,732212,19414,18799,42,18841,388
2020-09-09,San Luis Obispo,079,281455,3387,3131,16,3147,24
2020-09-09,San Mateo,081,765935,9372,8478,10,8488,125
2020-09-09,Santa Barbara,083,443738,8716,8528,73,8601,97
2020-09-09,Santa Clara,085,1922200,20323,18759,39,18798,228
2020-09-09,Santa Cruz,087,273765,2123,1967,17,1984,7
2020-09-09,Shasta,089,179085,684,562,3,565,10
2020-09-09,Sierra,091,2930,6,6,0,6,0
2020-09-09,Siskiyou,093,43540,149,137,9,146,0
2020-09-09,Solano,095,438530,5885,5680,39,5719,36
2020-09-09,Sonoma,097,501317,6730,6397,20,6417,92
2020-09-09,Stanislaus,099,539301,15952,15469,432,15901,243
2020-09-09,Sutter,101,95872,1562,1487,1,1488,11
2020-09-09,Tehama,103,63373,473,462,2,464,1
2020-09-09,Trinity,105,12862,52,14,7,21,0
2020-09-09,Tulare,107,460477,15499,14787,70,14857,249
2020-09-09,Tuolumne,109,53932,222,204,4,208,1
2020-09-09,Ventura,111,848112,12258,11497,120,11617,121
2020-09-09,Yolo,113,214977,2704,2604,7,2611,53
2020-09-09,Yuba,115,75493,1003,936,4,940,1
2020-09-08,Alameda,001,1643700,20096,19293,144,19437,288
2020-09-08,Alpine,003,1148,2,2,0,2,0
2020-09-08,Amador,005,37829,279,276,0,276,16
2020-09-08,Butte,007,227075,2722,2453,26,2479,36
2020-09-08,Calaveras,009,45235,297,233,0,233,1
2020-09-08,Colusa,011,21464,497,475,0,475,6
2020-09-08,Contra Costa,013,1133247,15651,14740,69,14809,171
2020-09-08,Del Norte,015,27424,121,109,0,109,2
2020-09-08,El Dorado,017,186661,1073,1011,7,1018,2
2020-09-08,Fresno,019,978130,29101,26640,326,26966,329
2020-09-08,Glenn,021,27897,527,492,0,492,3
2020-09-08,Humboldt,023,135768,460,420,1,421,4
2020-09-08,Imperial,025,180216,11481,10198,7,10205,267
2020-09-08,Inyo,027,18085,184,169,4,173,2
2020-09-08,Kern,029,883053,30759,29850,268,30118,351
2020-09-08,Kings,031,150075,7112,6658,32,6690,72
2020-09-08,Lake,033,64148,428,370,0,370,4
2020-09-08,Lassen,035,31185,732,710,2,712,0
2020-09-08,Los Angeles,037,10098052,252780,249217,1481,250698,6034
2020-09-08,Madera,039,155013,4212,3904,29,3933,43
2020-09-08,Marin,041,260295,6432,6313,15,6328,68
2020-09-08,Mariposa,043,17540,74,72,0,72,2
2020-09-08,Mendocino,045,87422,720,690,0,690,16
2020-09-08,Merced,047,269075,8530,8381,14,8395,104
2020-09-08,Modoc,049,8938,24,20,0,20,0
2020-09-08,Mono,051,14174,165,145,2,147,1
2020-09-08,Monterey,053,433212,8912,8491,23,8514,59
2020-09-08,Napa,055,140530,1582,1518,8,1526,11
2020-09-08,Nevada,057,99092,487,470,15,485,6
2020-09-08,Orange,059,3164182,51937,49214,1302,50516,1044
2020-09-08,Placer,061,380077,3366,3205,13,3218,36
2020-09-08,Plumas,063,18699,46,42,0,42,0
2020-09-08,Riverside,065,2383286,55595,54168,90,54258,1069
2020-09-08,Sacramento,067,1510023,20237,19411,19,19430,347
2020-09-08,San Benito,069,59416,1236,1188,0,1188,5
2020-09-08,San Bernardino,071,2135413,50963,49034,324,49358,856
2020-09-08,San Diego,073,3302833,43076,41079,653,41732,709
2020-09-08,San Francisco,075,870044,10337,9821,21,9842,86
2020-09-08,San Joaquin,077,732212,19336,18550,42,18592,388
2020-09-08,San Luis Obispo,079,281455,3372,3120,16,3136,23
2020-09-08,San Mateo,081,765935,9296,8460,10,8470,125
2020-09-08,Santa Barbara,083,443738,8682,8488,72,8560,96
2020-09-08,Santa Clara,085,1922200,20147,18645,39,18684,228
2020-09-08,Santa Cruz,087,273765,2095,1903,17,1920,7
2020-09-08,Shasta,089,179085,676,556,3,559,10
2020-09-08,Sierra,091,2930,6,6,0,6,0
2020-09-08,Siskiyou,093,43540,147,136,9,145,0
2020-09-08,Solano,095,438530,5848,5654,39,5693,36
2020-09-08,Sonoma,097,501317,6661,6356,20,6376,92
2020-09-08,Stanislaus,099,539301,15888,15415,420,15835,238
2020-09-08,Sutter,101,95872,1546,1473,1,1474,11
2020-09-08,Tehama,103,63373,469,458,2,460,1
2020-09-08,Trinity,105,12862,51,13,7,20,0
2020-09-08,Tulare,107,460477,15419,14635,69,14704,249
2020-09-08,Tuolumne,109,53932,221,197,4,201,1
2020-09-08,Ventura,111,848112,12189,11475,117,11592,118
2020-09-08,Yolo,113,214977,2694,2580,7,2587,53
2020-09-08,Yuba,115,75493,991,923,4,927,1
2020-09-07,Alameda,001,1643700,19975,19188,138,19326,281
2020-09-07,Alpine,003,1148,2,2,0,2,0
2020-09-07,Amador,005,37829,279,276,0,276,16
2020-09-07,Butte,007,227075,2689,2450,25,2475,30
2020-09-07,Calaveras,009,45235,287,234,0,234,1
2020-09-07,Colusa,011,21464,496,475,0,475,6
2020-09-07,Contra Costa,013,1133247,15538,14637,66,14703,172
2020-09-07,Del Norte,015,27424,121,109,0,109,2
2020-09-07,El Dorado,017,186661,1062,1011,7,1018,2
2020-09-07,Fresno,019,978130,29007,26565,323,26888,329
2020-09-07,Glenn,021,27897,522,488,0,488,3
2020-09-07,Humboldt,023,135768,451,416,1,417,4
2020-09-07,Imperial,025,180216,11450,10199,7,10206,267
2020-09-07,Inyo,027,18085,184,169,4,173,2
2020-09-07,Kern,029,883053,30639,29790,263,30053,348
2020-09-07,Kings,031,150075,6988,6630,32,6662,72
2020-09-07,Lake,033,64148,405,367,0,367,2
2020-09-07,Lassen,035,31185,732,709,2,711,0
2020-09-07,Los Angeles,037,10098052,251733,248804,1460,250264,6030
2020-09-07,Madera,039,155013,4181,3889,28,3917,43
2020-09-07,Marin,041,260295,6402,6296,15,6311,67
2020-09-07,Mariposa,043,17540,74,72,0,72,2
2020-09-07,Mendocino,045,87422,712,687,0,687,16
2020-09-07,Merced,047,269075,8483,8381,14,8395,104
2020-09-07,Modoc,049,8938,23,20,0,20,0
2020-09-07,Mono,051,14174,165,145,2,147,1
2020-09-07,Monterey,053,433212,8833,8463,23,8486,57
2020-09-07,Napa,055,140530,1570,1514,8,1522,11
2020-09-07,Nevada,057,99092,485,469,15,484,6
2020-09-07,Orange,059,3164182,51763,49132,1298,50430,1042
2020-09-07,Placer,061,380077,3336,3188,12,3200,36
2020-09-07,Plumas,063,18699,45,42,0,42,0
2020-09-07,Riverside,065,2383286,55320,54178,84,54262,1069
2020-09-07,Sacramento,067,1510023,19995,19292,18,19310,345
2020-09-07,San Benito,069,59416,1230,1180,0,1180,4
2020-09-07,San Bernardino,071,2135413,50735,49043,322,49365,821
2020-09-07,San Diego,073,3302833,42676,40868,626,41494,708
2020-09-07,San Francisco,075,870044,10286,9813,20,9833,85
2020-09-07,San Joaquin,077,732212,19255,18552,40,18592,386
2020-09-07,San Luis Obispo,079,281455,3335,3116,16,3132,23
2020-09-07,San Mateo,081,765935,9214,8409,10,8419,125
2020-09-07,Santa Barbara,083,443738,8638,8479,72,8551,95
2020-09-07,Santa Clara,085,1922200,19989,18596,38,18634,226
2020-09-07,Santa Cruz,087,273765,2067,1902,17,1919,7
2020-09-07,Shasta,089,179085,666,556,3,559,10
2020-09-07,Sierra,091,2930,6,6,0,6,0
2020-09-07,Siskiyou,093,43540,146,133,9,142,0
2020-09-07,Solano,095,438530,5783,5640,39,5679,36
2020-09-07,Sonoma,097,501317,6595,6268,20,6288,85
2020-09-07,Stanislaus,099,539301,15823,15343,408,15751,236
2020-09-07,Sutter,101,95872,1529,1468,1,1469,11
2020-09-07,Tehama,103,63373,466,453,2,455,1
2020-09-07,Trinity,105,12862,51,13,7,20,0
2020-09-07,Tulare,107,460477,15314,14637,67,14704,249
2020-09-07,Tuolumne,109,53932,220,196,4,200,1
2020-09-07,Ventura,111,848112,12094,11463,114,11577,118
2020-09-07,Yolo,113,214977,2677,2565,6,2571,53
2020-09-07,Yuba,115,75493,975,923,3,926,1
2020-09-06,Alameda,001,1643700,19917,19029,136,19165,281
2020-09-06,Alpine,003,1148,2,2,0,2,0
2020-09-06,Amador,005,37829,277,275,0,275,16
2020-09-06,Butte,007,227075,2680,2446,25,2471,30
2020-09-06,Calaveras,009,45235,287,235,0,235,1
2020-09-06,Colusa,011,21464,492,475,0,475,6
2020-09-06,Contra Costa,013,1133247,15458,14565,65,14630,171
2020-09-06,Del Norte,015,27424,121,109,0,109,2
2020-09-06,El Dorado,017,186661,1060,1008,7,1015,2
2020-09-06,Fresno,019,978130,28943,26471,321,26792,329
2020-09-06,Glenn,021,27897,516,474,0,474,3
2020-09-06,Humboldt,023,135768,448,404,1,405,4
2020-09-06,Imperial,025,180216,11433,10152,7,10159,267
2020-09-06,Inyo,027,18085,184,169,4,173,2
2020-09-06,Kern,029,883053,30583,29699,259,29958,348
2020-09-06,Kings,031,150075,6968,6561,31,6592,72
2020-09-06,Lake,033,64148,402,362,0,362,2
2020-09-06,Lassen,035,31185,732,709,2,711,0
2020-09-06,Los Angeles,037,10098052,251101,248316,1446,249762,6004
2020-09-06,Madera,039,155013,4137,3867,28,3895,42
2020-09-06,Marin,041,260295,6390,6276,15,6291,67
2020-09-06,Mariposa,043,17540,74,72,0,72,2
2020-09-06,Mendocino,045,87422,711,672,0,672,16
2020-09-06,Merced,047,269075,8463,8327,14,8341,104
2020-09-06,Modoc,049,8938,23,20,0,20,0
2020-09-06,Mono,051,14174,164,145,2,147,1
2020-09-06,Monterey,053,433212,8793,8403,22,8425,56
2020-09-06,Napa,055,140530,1566,1501,6,1507,11
2020-09-06,Nevada,057,99092,485,467,14,481,6
2020-09-06,Orange,059,3164182,51650,48931,1294,50225,1042
2020-09-06,Placer,061,380077,3319,3169,12,3181,36
2020-09-06,Plumas,063,18699,44,42,0,42,0
2020-09-06,Riverside,065,2383286,55204,53970,82,54052,1069
2020-09-06,Sacramento,067,1510023,19900,19128,18,19146,340
2020-09-06,San Benito,069,59416,1228,1178,0,1178,4
2020-09-06,San Bernardino,071,2135413,50628,48923,322,49245,823
2020-09-06,San Diego,073,3302833,42428,40652,620,41272,707
2020-09-06,San Francisco,075,870044,10212,9813,20,9833,85
2020-09-06,San Joaquin,077,732212,19206,18558,40,18598,386
2020-09-06,San Luis Obispo,079,281455,3324,3101,16,3117,23
2020-09-06,San Mateo,081,765935,9161,8387,10,8397,125
2020-09-06,Santa Barbara,083,443738,8609,8434,72,8506,95
2020-09-06,Santa Clara,085,1922200,19888,18495,38,18533,207
2020-09-06,Santa Cruz,087,273765,2060,1902,17,1919,7
2020-09-06,Shasta,089,179085,660,550,3,553,10
2020-09-06,Sierra,091,2930,6,6,0,6,0
2020-09-06,Siskiyou,093,43540,146,132,9,141,0
2020-09-06,Solano,095,438530,5757,5619,39,5658,37
2020-09-06,Sonoma,097,501317,6566,6212,20,6232,85
2020-09-06,Stanislaus,099,539301,15779,15288,404,15692,236
2020-09-06,Sutter,101,95872,1516,1451,1,1452,11
2020-09-06,Tehama,103,63373,465,455,2,457,1
2020-09-06,Trinity,105,12862,50,13,7,20,0
2020-09-06,Tulare,107,460477,15271,14636,66,14702,249
2020-09-06,Tuolumne,109,53932,217,194,4,198,1
2020-09-06,Ventura,111,848112,12049,11315,114,11429,118
2020-09-06,Yolo,113,214977,2663,2556,6,2562,53
2020-09-06,Yuba,115,75493,966,913,3,916,1
2020-09-05,Alameda,001,1643700,19872,18973,134,19107,279
2020-09-05,Alpine,003,1148,2,2,0,2,0
2020-09-05,Amador,005,37829,277,274,0,274,16
2020-09-05,Butte,007,227075,2664,2406,24,2430,30
2020-09-05,Calaveras,009,45235,287,237,0,237,1
2020-09-05,Colusa,011,21464,488,472,0,472,6
2020-09-05,Contra Costa,013,1133247,15381,14456,63,14519,173
2020-09-05,Del Norte,015,27424,121,109,0,109,2
2020-09-05,El Dorado,017,186661,1060,1007,7,1014,2
2020-09-05,Fresno,019,978130,28875,26325,321,26646,331
2020-09-05,Glenn,021,27897,515,474,0,474,3
2020-09-05,Humboldt,023,135768,446,402,1,403,4
2020-09-05,Imperial,025,180216,11416,10151,7,10158,268
2020-09-05,Inyo,027,18085,184,169,4,173,2
2020-09-05,Kern,029,883053,30523,29645,255,29900,347
2020-09-05,Kings,031,150075,6959,6518,31,6549,66
2020-09-05,Lake,033,64148,399,359,0,359,2
2020-09-05,Lassen,035,31185,732,709,2,711,0
2020-09-05,Los Angeles,037,10098052,250567,247572,1434,249006,6001
2020-09-05,Madera,039,155013,4096,3851,28,3879,42
2020-09-05,Marin,041,260295,6383,6259,15,6274,66
2020-09-05,Mariposa,043,17540,74,72,0,72,2
2020-09-05,Mendocino,045,87422,710,658,0,658,16
2020-09-05,Merced,047,269075,8431,8297,12,8309,104
2020-09-05,Modoc,049,8938,23,19,0,19,0
2020-09-05,Mono,051,14174,164,145,2,147,1
2020-09-05,Monterey,053,433212,8763,8301,22,8323,56
2020-09-05,Napa,055,140530,1560,1484,6,1490,11
2020-09-05,Nevada,057,99092,482,461,14,475,6
2020-09-05,Orange,059,3164182,51548,48726,1289,50015,1039
2020-09-05,Placer,061,380077,3308,3141,12,3153,35
2020-09-05,Plumas,063,18699,44,42,0,42,0
2020-09-05,Riverside,065,2383286,55098,53780,82,53862,1066
2020-09-05,Sacramento,067,1510023,19809,18955,18,18973,339
2020-09-05,San Benito,069,59416,1226,1153,0,1153,4
2020-09-05,San Bernardino,071,2135413,50552,48800,321,49121,825
2020-09-05,San Diego,073,3302833,42235,40344,608,40952,717
2020-09-05,San Francisco,075,870044,10179,9812,19,9831,85
2020-09-05,San Joaquin,077,732212,19177,18557,40,18597,386
2020-09-05,San Luis Obispo,079,281455,3314,3083,16,3099,23
2020-09-05,San Mateo,081,765935,9116,8352,10,8362,124
2020-09-05,Santa Barbara,083,443738,8593,8404,72,8476,96
2020-09-05,Santa Clara,085,1922200,19805,18311,38,18349,207
2020-09-05,Santa Cruz,087,273765,2052,1904,17,1921,7
2020-09-05,Shasta,089,179085,659,544,3,547,10
2020-09-05,Sierra,091,2930,6,6,0,6,0
2020-09-05,Siskiyou,093,43540,145,131,9,140,0
2020-09-05,Solano,095,438530,5745,5579,39,5618,37
2020-09-05,Sonoma,097,501317,6533,6149,20,6169,85
2020-09-05,Stanislaus,099,539301,15731,15198,400,15598,236
2020-09-05,Sutter,101,95872,1509,1445,1,1446,11
2020-09-05,Tehama,103,63373,464,447,2,449,1
2020-09-05,Trinity,105,12862,50,13,7,20,0
2020-09-05,Tulare,107,460477,15213,14576,64,14640,249
2020-09-05,Tuolumne,109,53932,217,194,4,198,1
2020-09-05,Ventura,111,848112,12006,11254,114,11368,118
2020-09-05,Yolo,113,214977,2653,2534,6,2540,53
2020-09-05,Yuba,115,75493,960,902,3,905,1
2020-09-04,Alameda,001,1643700,19804,18843,132,18975,276
2020-09-04,Alpine,003,1148,2,2,0,2,0
2020-09-04,Amador,005,37829,276,274,0,274,16
2020-09-04,Butte,007,227075,2641,2325,24,2349,28
2020-09-04,Calaveras,009,45235,285,237,0,237,1
2020-09-04,Colusa,011,21464,486,467,0,467,6
2020-09-04,Contra Costa,013,1133247,15298,14355,62,14417,164
2020-09-04,Del Norte,015,27424,121,109,0,109,2
2020-09-04,El Dorado,017,186661,1056,992,7,999,2
2020-09-04,Fresno,019,978130,28771,26147,320,26467,321
2020-09-04,Glenn,021,27897,507,463,0,463,3
2020-09-04,Humboldt,023,135768,441,390,1,391,4
2020-09-04,Imperial,025,180216,11407,10136,7,10143,267
2020-09-04,Inyo,027,18085,184,169,4,173,2
2020-09-04,Kern,029,883053,30455,29526,252,29778,345
2020-09-04,Kings,031,150075,6946,6259,31,6290,66
2020-09-04,Lake,033,64148,399,347,0,347,2
2020-09-04,Lassen,035,31185,732,708,2,710,0
2020-09-04,Los Angeles,037,10098052,249999,246396,1414,247810,5977
2020-09-04,Madera,039,155013,4083,3838,28,3866,42
2020-09-04,Marin,041,260295,6371,6251,15,6266,66
2020-09-04,Mariposa,043,17540,74,72,0,72,2
2020-09-04,Mendocino,045,87422,708,646,0,646,16
2020-09-04,Merced,047,269075,8411,8214,12,8226,104
2020-09-04,Modoc,049,8938,23,15,0,15,0
2020-09-04,Mono,051,14174,164,145,2,147,1
2020-09-04,Monterey,053,433212,8718,8208,22,8230,56
2020-09-04,Napa,055,140530,1551,1475,6,1481,11
2020-09-04,Nevada,057,99092,479,455,14,469,6
2020-09-04,Orange,059,3164182,51424,48488,1282,49770,1031
2020-09-04,Placer,061,380077,3296,3101,12,3113,35
2020-09-04,Plumas,063,18699,44,42,0,42,0
2020-09-04,Riverside,065,2383286,54985,53606,77,53683,1066
2020-09-04,Sacramento,067,1510023,19721,18765,18,18783,337
2020-09-04,San Benito,069,59416,1217,1137,0,1137,4
2020-09-04,San Bernardino,071,2135413,50459,48497,319,48816,800
2020-09-04,San Diego,073,3302833,42005,39901,599,40500,701
2020-09-04,San Francisco,075,870044,10139,9694,18,9712,85
2020-09-04,San Joaquin,077,732212,19123,18438,40,18478,376
2020-09-04,San Luis Obispo,079,281455,3299,3049,15,3064,21
2020-09-04,San Mateo,081,765935,9072,8275,10,8285,122
2020-09-04,Santa Barbara,083,443738,8563,8340,72,8412,96
2020-09-04,Santa Clara,085,1922200,19697,18074,38,18112,209
2020-09-04,Santa Cruz,087,273765,2035,1896,16,1912,7
2020-09-04,Shasta,089,179085,656,536,3,539,10
2020-09-04,Sierra,091,2930,6,6,0,6,0
2020-09-04,Siskiyou,093,43540,145,129,9,138,0
2020-09-04,Solano,095,438530,5732,5552,39,5591,37
2020-09-04,Sonoma,097,501317,6468,6050,20,6070,85
2020-09-04,Stanislaus,099,539301,15697,15074,391,15465,233
2020-09-04,Sutter,101,95872,1493,1425,1,1426,11
2020-09-04,Tehama,103,63373,460,442,2,444,1
2020-09-04,Trinity,105,12862,50,13,7,20,0
2020-09-04,Tulare,107,460477,15185,14501,60,14561,247
2020-09-04,Tuolumne,109,53932,217,193,4,197,1
2020-09-04,Ventura,111,848112,11964,11171,114,11285,114
2020-09-04,Yolo,113,214977,2639,2495,6,2501,53
2020-09-04,Yuba,115,75493,955,884,3,887,1
2020-09-03,Alameda,001,1643700,19701,18687,132,18819,275
2020-09-03,Alpine,003,1148,2,2,0,2,0
2020-09-03,Amador,005,37829,276,274,0,274,16
2020-09-03,Butte,007,227075,2597,2274,24,2298,27
2020-09-03,Calaveras,009,45235,284,238,0,238,1
2020-09-03,Colusa,011,21464,484,464,0,464,6
2020-09-03,Contra Costa,013,1133247,15191,14206,59,14265,159
2020-09-03,Del Norte,015,27424,118,109,0,109,2
2020-09-03,El Dorado,017,186661,1052,983,7,990,2
2020-09-03,Fresno,019,978130,28652,25978,315,26293,313
2020-09-03,Glenn,021,27897,503,460,0,460,3
2020-09-03,Humboldt,023,135768,436,390,1,391,4
2020-09-03,Imperial,025,180216,11386,10083,7,10090,255
2020-09-03,Inyo,027,18085,182,171,4,175,3
2020-09-03,Kern,029,883053,30363,29426,238,29664,340
2020-09-03,Kings,031,150075,6866,6200,31,6231,64
2020-09-03,Lake,033,64148,390,347,0,347,2
2020-09-03,Lassen,035,31185,732,707,2,709,0
2020-09-03,Los Angeles,037,10098052,249136,245026,1394,246420,5931
2020-09-03,Madera,039,155013,4064,3780,28,3808,43
2020-09-03,Marin,041,260295,6352,6175,15,6190,66
2020-09-03,Mariposa,043,17540,74,71,0,71,2
2020-09-03,Mendocino,045,87422,699,638,0,638,16
2020-09-03,Merced,047,269075,8369,8136,12,8148,105
2020-09-03,Modoc,049,8938,23,14,0,14,0
2020-09-03,Mono,051,14174,163,144,2,146,1
2020-09-03,Monterey,053,433212,8664,8128,22,8150,56
2020-09-03,Napa,055,140530,1544,1466,6,1472,10
2020-09-03,Nevada,057,99092,476,453,14,467,6
2020-09-03,Orange,059,3164182,51238,48226,1268,49494,1009
2020-09-03,Placer,061,380077,3278,3069,12,3081,34
2020-09-03,Plumas,063,18699,44,39,0,39,0
2020-09-03,Riverside,065,2383286,54805,53341,73,53414,1052
2020-09-03,Sacramento,067,1510023,19593,18553,17,18570,328
2020-09-03,San Benito,069,59416,1206,1121,0,1121,4
2020-09-03,San Bernardino,071,2135413,50293,48165,318,48483,800
2020-09-03,San Diego,073,3302833,41691,39448,583,40031,700
2020-09-03,San Francisco,075,870044,10073,9636,16,9652,84
2020-09-03,San Joaquin,077,732212,19046,18331,40,18371,371
2020-09-03,San Luis Obispo,079,281455,3282,3023,15,3038,21
2020-09-03,San Mateo,081,765935,8998,8211,10,8221,122
2020-09-03,Santa Barbara,083,443738,8516,8277,72,8349,96
2020-09-03,Santa Clara,085,1922200,19516,17879,38,17917,208
2020-09-03,Santa Cruz,087,273765,2020,1870,16,1886,7
2020-09-03,Shasta,089,179085,651,535,3,538,10
2020-09-03,Sierra,091,2930,6,6,0,6,0
2020-09-03,Siskiyou,093,43540,145,128,9,137,0
2020-09-03,Solano,095,438530,5712,5499,38,5537,36
2020-09-03,Sonoma,097,501317,6406,5997,20,6017,62
2020-09-03,Stanislaus,099,539301,15645,14985,387,15372,217
2020-09-03,Sutter,101,95872,1483,1412,1,1413,11
2020-09-03,Tehama,103,63373,456,436,2,438,1
2020-09-03,Trinity,105,12862,48,13,7,20,0
2020-09-03,Tulare,107,460477,15119,14408,59,14467,244
2020-09-03,Tuolumne,109,53932,217,193,4,197,1
2020-09-03,Ventura,111,848112,11846,11109,111,11220,112
2020-09-03,Yolo,113,214977,2623,2475,6,2481,53
2020-09-03,Yuba,115,75493,948,867,3,870,1
2020-09-02,Alameda,001,1643700,19583,18522,129,18651,260
2020-09-02,Alpine,003,1148,2,2,0,2,0
2020-09-02,Amador,005,37829,276,245,0,245,14
2020-09-02,Butte,007,227075,2551,2241,24,2265,27
2020-09-02,Calaveras,009,45235,283,235,0,235,1
2020-09-02,Colusa,011,21464,480,460,0,460,6
2020-09-02,Contra Costa,013,1133247,15102,14097,57,14154,159
2020-09-02,Del Norte,015,27424,117,109,0,109,2
2020-09-02,El Dorado,017,186661,1048,975,6,981,2
2020-09-02,Fresno,019,978130,28504,25785,312,26097,292
2020-09-02,Glenn,021,27897,498,457,0,457,3
2020-09-02,Humboldt,023,135768,433,381,1,382,4
2020-09-02,Imperial,025,180216,11370,9832,7,9839,255
2020-09-02,Inyo,027,18085,182,171,4,175,3
2020-09-02,Kern,029,883053,30271,29288,232,29520,335
2020-09-02,Kings,031,150075,6781,6142,31,6173,64
2020-09-02,Lake,033,64148,386,342,0,342,2
2020-09-02,Lassen,035,31185,730,706,2,708,0
2020-09-02,Los Angeles,037,10098052,248205,243999,1366,245365,5887
2020-09-02,Madera,039,155013,4044,3735,28,3763,41
2020-09-02,Marin,041,260295,6337,6131,15,6146,66
2020-09-02,Mariposa,043,17540,74,71,0,71,2
2020-09-02,Mendocino,045,87422,689,636,0,636,15
2020-09-02,Merced,047,269075,8338,8097,11,8108,103
2020-09-02,Modoc,049,8938,22,11,0,11,0
2020-09-02,Mono,051,14174,163,145,2,147,1
2020-09-02,Monterey,053,433212,8600,8070,22,8092,56
2020-09-02,Napa,055,140530,1532,1454,6,1460,10
2020-09-02,Nevada,057,99092,470,452,13,465,6
2020-09-02,Orange,059,3164182,51057,47871,1258,49129,994
2020-09-02,Placer,061,380077,3253,3047,11,3058,33
2020-09-02,Plumas,063,18699,44,39,0,39,0
2020-09-02,Riverside,065,2383286,54603,52923,70,52993,1032
2020-09-02,Sacramento,067,1510023,19360,18355,16,18371,316
2020-09-02,San Benito,069,59416,1193,1107,0,1107,4
2020-09-02,San Bernardino,071,2135413,50130,47766,315,48081,794
2020-09-02,San Diego,073,3302833,41371,39123,569,39692,695
2020-09-02,San Francisco,075,870044,10004,9587,16,9603,84
2020-09-02,San Joaquin,077,732212,18966,18194,39,18233,352
2020-09-02,San Luis Obispo,079,281455,3256,3002,14,3016,21
2020-09-02,San Mateo,081,765935,8941,8148,10,8158,122
2020-09-02,Santa Barbara,083,443738,8461,8206,71,8277,94
2020-09-02,Santa Clara,085,1922200,19362,17673,38,17711,206
2020-09-02,Santa Cruz,087,273765,1997,1850,16,1866,7
2020-09-02,Shasta,089,179085,650,531,3,534,10
2020-09-02,Sierra,091,2930,6,6,0,6,0
2020-09-02,Siskiyou,093,43540,144,127,9,136,0
2020-09-02,Solano,095,438530,5684,5463,38,5501,36
2020-09-02,Sonoma,097,501317,6344,5846,20,5866,62
2020-09-02,Stanislaus,099,539301,15575,14854,380,15234,220
2020-09-02,Sutter,101,95872,1468,1401,1,1402,10
2020-09-02,Tehama,103,63373,453,429,2,431,1
2020-09-02,Trinity,105,12862,48,13,7,20,0
2020-09-02,Tulare,107,460477,15052,14298,59,14357,244
2020-09-02,Tuolumne,109,53932,217,190,4,194,1
2020-09-02,Ventura,111,848112,11759,11031,110,11141,111
2020-09-02,Yolo,113,214977,2602,2449,6,2455,54
2020-09-02,Yuba,115,75493,941,856,3,859,1
2020-09-01,Alameda,001,1643700,19443,18382,126,18508,248
2020-09-01,Alpine,003,1148,2,2,0,2,0
2020-09-01,Amador,005,37829,275,244,0,244,13
2020-09-01,Butte,007,227075,2494,2146,24,2170,26
2020-09-01,Calaveras,009,45235,275,228,0,228,1
2020-09-01,Colusa,011,21464,476,454,0,454,6
2020-09-01,Contra Costa,013,1133247,15008,13998,55,14053,158
2020-09-01,Del Norte,015,27424,116,108,0,108,2
2020-09-01,El Dorado,017,186661,1040,972,6,978,2
2020-09-01,Fresno,019,978130,28357,25542,309,25851,290
2020-09-01,Glenn,021,27897,491,449,0,449,3
2020-09-01,Humboldt,023,135768,427,378,1,379,4
2020-09-01,Imperial,025,180216,11344,9782,7,9789,250
2020-09-01,Inyo,027,18085,182,171,4,175,3
2020-09-01,Kern,029,883053,30180,29162,227,29389,332
2020-09-01,Kings,031,150075,6750,6088,31,6119,62
2020-09-01,Lake,033,64148,383,341,0,341,2
2020-09-01,Lassen,035,31185,727,706,2,708,0
2020-09-01,Los Angeles,037,10098052,247114,242633,1343,243976,5832
2020-09-01,Madera,039,155013,4015,3703,27,3730,41
2020-09-01,Marin,041,260295,6322,6102,15,6117,67
2020-09-01,Mariposa,043,17540,73,72,0,72,2
2020-09-01,Mendocino,045,87422,674,626,0,626,15
2020-09-01,Merced,047,269075,8285,8046,10,8056,103
2020-09-01,Modoc,049,8938,20,10,0,10,0
2020-09-01,Mono,051,14174,163,145,2,147,1
2020-09-01,Monterey,053,433212,8494,7926,22,7948,56
2020-09-01,Napa,055,140530,1517,1446,6,1452,10
2020-09-01,Nevada,057,99092,464,450,13,463,6
2020-09-01,Orange,059,3164182,50893,47671,1239,48910,976
2020-09-01,Placer,061,380077,3231,3013,11,3024,33
2020-09-01,Plumas,063,18699,44,39,0,39,0
2020-09-01,Riverside,065,2383286,54386,52785,69,52854,1027
2020-09-01,Sacramento,067,1510023,19177,18217,15,18232,305
2020-09-01,San Benito,069,59416,1181,1089,0,1089,4
2020-09-01,San Bernardino,071,2135413,49923,47371,314,47685,786
2020-09-01,San Diego,073,3302833,41013,38873,531,39404,688
2020-09-01,San Francisco,075,870044,9935,9492,16,9508,83
2020-09-01,San Joaquin,077,732212,18884,17915,38,17953,341
2020-09-01,San Luis Obispo,079,281455,3230,2970,14,2984,21
2020-09-01,San Mateo,081,765935,8861,8132,10,8142,122
2020-09-01,Santa Barbara,083,443738,8411,8142,70,8212,93
2020-09-01,Santa Clara,085,1922200,19183,17319,38,17357,204
2020-09-01,Santa Cruz,087,273765,1973,1752,16,1768,7
2020-09-01,Shasta,089,179085,642,527,3,530,9
2020-09-01,Sierra,091,2930,6,6,0,6,0
2020-09-01,Siskiyou,093,43540,141,128,8,136,0
2020-09-01,Solano,095,438530,5658,5438,38,5476,34
2020-09-01,Sonoma,097,501317,6254,5733,20,5753,60
2020-09-01,Stanislaus,099,539301,15499,14784,370,15154,212
2020-09-01,Sutter,101,95872,1457,1389,1,1390,10
2020-09-01,Tehama,103,63373,449,422,2,424,1
2020-09-01,Trinity,105,12862,47,13,6,19,0
2020-09-01,Tulare,107,460477,14969,14156,59,14215,241
2020-09-01,Tuolumne,109,53932,211,183,4,187,1
2020-09-01,Ventura,111,848112,11681,10899,105,11004,108
2020-09-01,Yolo,113,214977,2585,2440,6,2446,51
2020-09-01,Yuba,115,75493,932,841,3,844,1
2020-08-31,Alameda,001,1643700,19298,18148,126,18274,248
2020-08-31,Alpine,003,1148,2,2,0,2,0
2020-08-31,Amador,005,37829,275,243,0,243,13
2020-08-31,Butte,007,227075,2430,2069,24,2093,26
2020-08-31,Calaveras,009,45235,270,212,0,212,1
2020-08-31,Colusa,011,21464,475,443,0,443,6
2020-08-31,Contra Costa,013,1133247,14881,13902,52,13954,153
2020-08-31,Del Norte,015,27424,116,108,0,108,2
2020-08-31,El Dorado,017,186661,1033,965,6,971,2
2020-08-31,Fresno,019,978130,28136,25185,303,25488,290
2020-08-31,Glenn,021,27897,479,437,0,437,3
2020-08-31,Humboldt,023,135768,425,374,1,375,4
2020-08-31,Imperial,025,180216,11313,9759,7,9766,250
2020-08-31,Inyo,027,18085,181,160,4,164,3
2020-08-31,Kern,029,883053,30082,29067,226,29293,318
2020-08-31,Kings,031,150075,6483,6037,31,6068,62
2020-08-31,Lake,033,64148,367,341,0,341,2
2020-08-31,Lassen,035,31185,724,706,2,708,0
2020-08-31,Los Angeles,037,10098052,246007,241793,1316,243109,5787
2020-08-31,Madera,039,155013,3992,3662,26,3688,35
2020-08-31,Marin,041,260295,6286,6074,15,6089,67
2020-08-31,Mariposa,043,17540,73,69,0,69,2
2020-08-31,Mendocino,045,87422,662,618,0,618,15
2020-08-31,Merced,047,269075,8223,7991,10,8001,79
2020-08-31,Modoc,049,8938,18,10,0,10,0
2020-08-31,Mono,051,14174,163,145,2,147,1
2020-08-31,Monterey,053,433212,8387,7839,22,7861,56
2020-08-31,Napa,055,140530,1509,1434,6,1440,10
2020-08-31,Nevada,057,99092,462,447,13,460,6
2020-08-31,Orange,059,3164182,50694,47392,1211,48603,965
2020-08-31,Placer,061,380077,3182,2989,11,3000,33
2020-08-31,Plumas,063,18699,43,39,0,39,0
2020-08-31,Riverside,065,2383286,54164,52508,67,52575,1020
2020-08-31,Sacramento,067,1510023,18940,17999,15,18014,303
2020-08-31,San Benito,069,59416,1165,1080,0,1080,4
2020-08-31,San Bernardino,071,2135413,49711,47370,313,47683,755
2020-08-31,San Diego,073,3302833,40646,38606,498,39104,682
2020-08-31,San Francisco,075,870044,9856,9293,13,9306,83
2020-08-31,San Joaquin,077,732212,18797,17807,37,17844,338
2020-08-31,San Luis Obispo,079,281455,3207,2951,13,2964,21
2020-08-31,San Mateo,081,765935,8791,8065,10,8075,122
2020-08-31,Santa Barbara,083,443738,8365,8124,70,8194,94
2020-08-31,Santa Clara,085,1922200,18994,17211,38,17249,202
2020-08-31,Santa Cruz,087,273765,1948,1742,16,1758,7
2020-08-31,Shasta,089,179085,637,528,3,531,9
2020-08-31,Sierra,091,2930,6,6,0,6,0
2020-08-31,Siskiyou,093,43540,140,127,8,135,0
2020-08-31,Solano,095,438530,5626,5302,37,5339,34
2020-08-31,Sonoma,097,501317,6179,5650,20,5670,60
2020-08-31,Stanislaus,099,539301,15424,14685,361,15046,213
2020-08-31,Sutter,101,95872,1442,1365,1,1366,10
2020-08-31,Tehama,103,63373,446,421,2,423,1
2020-08-31,Trinity,105,12862,47,13,6,19,0
2020-08-31,Tulare,107,460477,14882,13985,57,14042,237
2020-08-31,Tuolumne,109,53932,211,178,4,182,1
2020-08-31,Ventura,111,848112,11593,10866,104,10970,108
2020-08-31,Yolo,113,214977,2567,2423,5,2428,51
2020-08-31,Yuba,115,75493,918,830,3,833,1
2020-08-30,Alameda,001,1643700,19173,18099,124,18223,248
2020-08-30,Alpine,003,1148,2,2,0,2,0
2020-08-30,Amador,005,37829,274,240,0,240,13
2020-08-30,Butte,007,227075,2349,1988,24,2012,26
2020-08-30,Calaveras,009,45235,261,211,0,211,1
2020-08-30,Colusa,011,21464,474,440,0,440,6
2020-08-30,Contra Costa,013,1133247,14744,13780,52,13832,150
2020-08-30,Del Norte,015,27424,115,108,0,108,2
2020-08-30,El Dorado,017,186661,1023,962,6,968,2
2020-08-30,Fresno,019,978130,28010,24963,302,25265,291
2020-08-30,Glenn,021,27897,472,437,0,437,3
2020-08-30,Humboldt,023,135768,414,362,1,363,4
2020-08-30,Imperial,025,180216,11295,9703,7,9710,250
2020-08-30,Inyo,027,18085,181,160,4,164,3
2020-08-30,Kern,029,883053,29989,28987,226,29213,317
2020-08-30,Kings,031,150075,6437,6000,31,6031,62
2020-08-30,Lake,033,64148,362,334,0,334,2
2020-08-30,Lassen,035,31185,722,706,2,708,0
2020-08-30,Los Angeles,037,10098052,244870,240775,1284,242059,5772
2020-08-30,Madera,039,155013,3963,3626,26,3652,33
2020-08-30,Marin,041,260295,6256,6060,15,6075,66
2020-08-30,Mariposa,043,17540,73,69,0,69,2
2020-08-30,Mendocino,045,87422,656,611,0,611,13
2020-08-30,Merced,047,269075,8148,7960,10,7970,79
2020-08-30,Modoc,049,8938,13,10,0,10,0
2020-08-30,Mono,051,14174,163,145,2,147,1
2020-08-30,Monterey,053,433212,8303,7816,22,7838,54
2020-08-30,Napa,055,140530,1497,1423,6,1429,10
2020-08-30,Nevada,057,99092,459,445,13,458,6
2020-08-30,Orange,059,3164182,50498,47283,1197,48480,965
2020-08-30,Placer,061,380077,3149,2961,11,2972,32
2020-08-30,Plumas,063,18699,42,39,0,39,0
2020-08-30,Riverside,065,2383286,53985,52227,66,52293,1017
2020-08-30,Sacramento,067,1510023,18762,17751,15,17766,300
2020-08-30,San Benito,069,59416,1155,1071,0,1071,4
2020-08-30,San Bernardino,071,2135413,49454,47201,313,47514,755
2020-08-30,San Diego,073,3302833,40248,38302,477,38779,682
2020-08-30,San Francisco,075,870044,9759,9294,10,9304,83
2020-08-30,San Joaquin,077,732212,18680,17637,36,17673,338
2020-08-30,San Luis Obispo,079,281455,3182,2934,13,2947,21
2020-08-30,San Mateo,081,765935,8714,8013,10,8023,122
2020-08-30,Santa Barbara,083,443738,8305,8088,70,8158,93
2020-08-30,Santa Clara,085,1922200,18818,17045,38,17083,202
2020-08-30,Santa Cruz,087,273765,1922,1743,16,1759,7
2020-08-30,Shasta,089,179085,634,525,3,528,9
2020-08-30,Sierra,091,2930,6,6,0,6,0
2020-08-30,Siskiyou,093,43540,138,125,8,133,0
2020-08-30,Solano,095,438530,5582,5303,37,5340,34
2020-08-30,Sonoma,097,501317,6119,5590,20,5610,60
2020-08-30,Stanislaus,099,539301,15352,14580,352,14932,209
2020-08-30,Sutter,101,95872,1421,1351,1,1352,10
2020-08-30,Tehama,103,63373,437,419,2,421,1
2020-08-30,Trinity,105,12862,47,13,6,19,0
2020-08-30,Tulare,107,460477,14787,13985,56,14041,236
2020-08-30,Tuolumne,109,53932,207,178,4,182,1
2020-08-30,Ventura,111,848112,11480,10775,99,10874,108
2020-08-30,Yolo,113,214977,2539,2391,4,2395,51
2020-08-30,Yuba,115,75493,904,832,3,835,1
2020-08-29,Alameda,001,1643700,19106,17888,124,18012,250
2020-08-29,Alpine,003,1148,2,2,0,2,0
2020-08-29,Amador,005,37829,274,239,0,239,13
2020-08-29,Butte,007,227075,2318,1948,24,1972,26
2020-08-29,Calaveras,009,45235,257,211,0,211,1
2020-08-29,Colusa,011,21464,471,440,0,440,6
2020-08-29,Contra Costa,013,1133247,14671,13663,51,13714,159
2020-08-29,Del Norte,015,27424,115,108,0,108,1
2020-08-29,El Dorado,017,186661,1020,958,6,964,2
2020-08-29,Fresno,019,978130,27955,24821,302,25123,291
2020-08-29,Glenn,021,27897,466,437,0,437,3
2020-08-29,Humboldt,023,135768,411,363,1,364,4
2020-08-29,Imperial,025,180216,11280,9698,7,9705,250
2020-08-29,Inyo,027,18085,181,160,4,164,3
2020-08-29,Kern,029,883053,29948,28947,225,29172,317
2020-08-29,Kings,031,150075,6422,5906,31,5937,62
2020-08-29,Lake,033,64148,361,329,0,329,2
2020-08-29,Lassen,035,31185,722,706,2,708,0
2020-08-29,Los Angeles,037,10098052,244242,239815,1271,241086,5762
2020-08-29,Madera,039,155013,3954,3605,25,3630,33
2020-08-29,Marin,041,260295,6244,6007,15,6022,64
2020-08-29,Mariposa,043,17540,73,69,0,69,2
2020-08-29,Mendocino,045,87422,652,596,0,596,13
2020-08-29,Merced,047,269075,8118,7867,10,7877,79
2020-08-29,Modoc,049,8938,13,9,0,9,0
2020-08-29,Mono,051,14174,163,145,2,147,1
2020-08-29,Monterey,053,433212,8258,7680,22,7702,53
2020-08-29,Napa,055,140530,1494,1413,6,1419,10
2020-08-29,Nevada,057,99092,459,442,13,455,5
2020-08-29,Orange,059,3164182,50388,47007,1187,48194,960
2020-08-29,Placer,061,380077,3132,2935,11,2946,32
2020-08-29,Plumas,063,18699,41,39,0,39,0
2020-08-29,Riverside,065,2383286,53873,51918,64,51982,1016
2020-08-29,Sacramento,067,1510023,18690,17588,15,17603,291
2020-08-29,San Benito,069,59416,1146,1045,0,1045,4
2020-08-29,San Bernardino,071,2135413,49338,46849,313,47162,755
2020-08-29,San Diego,073,3302833,39982,38049,459,38508,694
2020-08-29,San Francisco,075,870044,9731,9291,9,9300,83
2020-08-29,San Joaquin,077,732212,18636,17493,36,17529,335
2020-08-29,San Luis Obispo,079,281455,3157,2917,13,2930,21
2020-08-29,San Mateo,081,765935,8672,7928,10,7938,122
2020-08-29,Santa Barbara,083,443738,8279,8052,69,8121,93
2020-08-29,Santa Clara,085,1922200,18721,16898,37,16935,202
2020-08-29,Santa Cruz,087,273765,1910,1746,16,1762,7
2020-08-29,Shasta,089,179085,626,522,3,525,9
2020-08-29,Sierra,091,2930,6,6,0,6,0
2020-08-29,Siskiyou,093,43540,138,121,8,129,0
2020-08-29,Solano,095,438530,5561,5303,37,5340,34
2020-08-29,Sonoma,097,501317,6084,5537,20,5557,60
2020-08-29,Stanislaus,099,539301,15303,14479,342,14821,208
2020-08-29,Sutter,101,95872,1416,1333,1,1334,9
2020-08-29,Tehama,103,63373,436,417,2,419,1
2020-08-29,Trinity,105,12862,46,11,6,17,0
2020-08-29,Tulare,107,460477,14749,13890,55,13945,236
2020-08-29,Tuolumne,109,53932,207,178,4,182,1
2020-08-29,Ventura,111,848112,11438,10705,99,10804,108
2020-08-29,Yolo,113,214977,2521,2357,4,2361,51
2020-08-29,Yuba,115,75493,895,822,3,825,1
2020-08-28,Alameda,001,1643700,19023,17729,123,17852,237
2020-08-28,Alpine,003,1148,2,2,0,2,0
2020-08-28,Amador,005,37829,274,234,0,234,13
2020-08-28,Butte,007,227075,2288,1886,24,1910,25
2020-08-28,Calaveras,009,45235,255,207,0,207,1
2020-08-28,Colusa,011,21464,470,441,0,441,6
2020-08-28,Contra Costa,013,1133247,14600,13522,50,13572,158
2020-08-28,Del Norte,015,27424,115,107,0,107,1
2020-08-28,El Dorado,017,186661,1014,949,6,955,2
2020-08-28,Fresno,019,978130,27821,24612,302,24914,282
2020-08-28,Glenn,021,27897,459,429,0,429,3
2020-08-28,Humboldt,023,135768,407,362,1,363,4
2020-08-28,Imperial,025,180216,11266,9656,7,9663,241
2020-08-28,Inyo,027,18085,180,160,4,164,2
2020-08-28,Kern,029,883053,29900,28744,225,28969,306
2020-08-28,Kings,031,150075,6415,5829,30,5859,62
2020-08-28,Lake,033,64148,356,320,0,320,2
2020-08-28,Lassen,035,31185,722,704,2,706,0
2020-08-28,Los Angeles,037,10098052,243430,238544,1246,239790,5740
2020-08-28,Madera,039,155013,3935,3552,25,3577,33
2020-08-28,Marin,041,260295,6222,5991,15,6006,63
2020-08-28,Mariposa,043,17540,73,67,0,67,2
2020-08-28,Mendocino,045,87422,647,588,0,588,11
2020-08-28,Merced,047,269075,8088,7803,10,7813,77
2020-08-28,Modoc,049,8938,13,6,0,6,0
2020-08-28,Mono,051,14174,163,145,2,147,1
2020-08-28,Monterey,053,433212,8201,7591,22,7613,53
2020-08-28,Napa,055,140530,1486,1403,5,1408,10
2020-08-28,Nevada,057,99092,458,438,13,451,5
2020-08-28,Orange,059,3164182,50288,46696,1172,47868,942
2020-08-28,Placer,061,380077,3121,2891,11,2902,32
2020-08-28,Plumas,063,18699,41,39,0,39,0
2020-08-28,Riverside,065,2383286,53742,51510,60,51570,1008
2020-08-28,Sacramento,067,1510023,18593,17119,15,17134,283
2020-08-28,San Benito,069,59416,1130,1016,0,1016,3
2020-08-28,San Bernardino,071,2135413,49219,46553,309,46862,754
2020-08-28,San Diego,073,3302833,39752,37786,444,38230,676
2020-08-28,San Francisco,075,870044,9679,9135,9,9144,83
2020-08-28,San Joaquin,077,732212,18583,17114,35,17149,314
2020-08-28,San Luis Obispo,079,281455,3140,2849,13,2862,20
2020-08-28,San Mateo,081,765935,8626,7783,9,7792,121
2020-08-28,Santa Barbara,083,443738,8247,8001,69,8070,92
2020-08-28,Santa Clara,085,1922200,18590,16696,37,16733,201
2020-08-28,Santa Cruz,087,273765,1898,1747,16,1763,7
2020-08-28,Shasta,089,179085,622,516,3,519,9
2020-08-28,Sierra,091,2930,6,6,0,6,0
2020-08-28,Siskiyou,093,43540,136,119,8,127,0
2020-08-28,Solano,095,438530,5542,5219,37,5256,34
2020-08-28,Sonoma,097,501317,6049,5425,19,5444,58
2020-08-28,Stanislaus,099,539301,15261,14176,338,14514,190
2020-08-28,Sutter,101,95872,1406,1308,1,1309,9
2020-08-28,Tehama,103,63373,431,410,2,412,1
2020-08-28,Trinity,105,12862,46,11,6,17,0
2020-08-28,Tulare,107,460477,14704,13776,55,13831,236
2020-08-28,Tuolumne,109,53932,207,176,4,180,1
2020-08-28,Ventura,111,848112,11402,10606,97,10703,103
2020-08-28,Yolo,113,214977,2512,2323,4,2327,51
2020-08-28,Yuba,115,75493,886,810,3,813,1
2020-08-27,Alameda,001,1643700,18878,17584,120,17704,234
2020-08-27,Alpine,003,1148,2,2,0,2,0
2020-08-27,Amador,005,37829,273,233,0,233,13
2020-08-27,Butte,007,227075,2222,1803,23,1826,25
2020-08-27,Calaveras,009,45235,249,204,0,204,1
2020-08-27,Colusa,011,21464,468,438,0,438,6
2020-08-27,Contra Costa,013,1133247,14499,13379,49,13428,158
2020-08-27,Del Norte,015,27424,115,107,0,107,1
2020-08-27,El Dorado,017,186661,1010,942,6,948,2
2020-08-27,Fresno,019,978130,27639,24367,297,24664,272
2020-08-27,Glenn,021,27897,451,429,0,429,3
2020-08-27,Humboldt,023,135768,399,358,1,359,4
2020-08-27,Imperial,025,180216,11239,9608,7,9615,235
2020-08-27,Inyo,027,18085,180,157,3,160,2
2020-08-27,Kern,029,883053,29828,28635,216,28851,294
2020-08-27,Kings,031,150075,6393,5759,30,5789,62
2020-08-27,Lake,033,64148,354,314,0,314,2
2020-08-27,Lassen,035,31185,722,703,2,705,0
2020-08-27,Los Angeles,037,10098052,242428,237103,1231,238334,5704
2020-08-27,Madera,039,155013,3909,3465,25,3490,33
2020-08-27,Marin,041,260295,6198,5929,15,5944,62
2020-08-27,Mariposa,043,17540,73,67,0,67,2
2020-08-27,Mendocino,045,87422,638,581,0,581,10
2020-08-27,Merced,047,269075,8044,7765,10,7775,75
2020-08-27,Modoc,049,8938,11,5,0,5,0
2020-08-27,Mono,051,14174,163,145,2,147,1
2020-08-27,Monterey,053,433212,8107,7501,22,7523,52
2020-08-27,Napa,055,140530,1480,1397,5,1402,10
2020-08-27,Nevada,057,99092,455,435,13,448,5
2020-08-27,Orange,059,3164182,50131,46449,1161,47610,935
2020-08-27,Placer,061,380077,3090,2869,11,2880,32
2020-08-27,Plumas,063,18699,40,39,0,39,0
2020-08-27,Riverside,065,2383286,53533,51306,57,51363,999
2020-08-27,Sacramento,067,1510023,18395,16875,15,16890,281
2020-08-27,San Benito,069,59416,1114,987,0,987,3
2020-08-27,San Bernardino,071,2135413,48994,46345,303,46648,751
2020-08-27,San Diego,073,3302833,39481,37501,424,37925,673
2020-08-27,San Francisco,075,870044,9613,9014,9,9023,83
2020-08-27,San Joaquin,077,732212,18503,16989,35,17024,314
2020-08-27,San Luis Obispo,079,281455,3115,2808,13,2821,20
2020-08-27,San Mateo,081,765935,8517,7728,9,7737,121
2020-08-27,Santa Barbara,083,443738,8209,7934,69,8003,92
2020-08-27,Santa Clara,085,1922200,18407,16495,37,16532,199
2020-08-27,Santa Cruz,087,273765,1881,1734,16,1750,7
2020-08-27,Shasta,089,179085,616,512,3,515,9
2020-08-27,Sierra,091,2930,6,6,0,6,0
2020-08-27,Siskiyou,093,43540,136,118,8,126,0
2020-08-27,Solano,095,438530,5504,5167,37,5204,34
2020-08-27,Sonoma,097,501317,5938,5357,19,5376,58
2020-08-27,Stanislaus,099,539301,15180,14080,335,14415,186
2020-08-27,Sutter,101,95872,1386,1296,1,1297,9
2020-08-27,Tehama,103,63373,427,398,2,400,1
2020-08-27,Trinity,105,12862,46,11,6,17,0
2020-08-27,Tulare,107,460477,14613,13666,55,13721,231
2020-08-27,Tuolumne,109,53932,202,174,4,178,1
2020-08-27,Ventura,111,848112,11339,10483,93,10576,102
2020-08-27,Yolo,113,214977,2488,2293,4,2297,51
2020-08-27,Yuba,115,75493,875,807,3,810,1
2020-08-26,Alameda,001,1643700,18716,17373,120,17493,233
2020-08-26,Alpine,003,1148,2,2,0,2,0
2020-08-26,Amador,005,37829,273,229,0,229,13
2020-08-26,Butte,007,227075,2154,1765,21,1786,25
2020-08-26,Calaveras,009,45235,242,201,0,201,1
2020-08-26,Colusa,011,21464,462,433,0,433,5
2020-08-26,Contra Costa,013,1133247,14362,13248,49,13297,157
2020-08-26,Del Norte,015,27424,114,86,0,86,1
2020-08-26,El Dorado,017,186661,1008,938,6,944,2
2020-08-26,Fresno,019,978130,27491,24071,295,24366,255
2020-08-26,Glenn,021,27897,449,429,0,429,3
2020-08-26,Humboldt,023,135768,387,357,1,358,4
2020-08-26,Imperial,025,180216,11217,9453,7,9460,227
2020-08-26,Inyo,027,18085,177,157,3,160,2
2020-08-26,Kern,029,883053,29689,28507,213,28720,286
2020-08-26,Kings,031,150075,6372,5720,30,5750,62
2020-08-26,Lake,033,64148,349,308,0,308,2
2020-08-26,Lassen,035,31185,722,702,2,704,0
2020-08-26,Los Angeles,037,10098052,241416,235499,1201,236700,5665
2020-08-26,Madera,039,155013,3880,3458,25,3483,32
2020-08-26,Marin,041,260295,6181,5887,15,5902,56
2020-08-26,Mariposa,043,17540,73,68,0,68,2
2020-08-26,Mendocino,045,87422,627,581,0,581,10
2020-08-26,Merced,047,269075,8011,7720,10,7730,74
2020-08-26,Modoc,049,8938,8,5,0,5,0
2020-08-26,Mono,051,14174,163,141,2,143,1
2020-08-26,Monterey,053,433212,8014,7439,22,7461,51
2020-08-26,Napa,055,140530,1467,1382,5,1387,10
2020-08-26,Nevada,057,99092,452,432,13,445,2
2020-08-26,Orange,059,3164182,49947,46157,1145,47302,905
2020-08-26,Placer,061,380077,3068,2846,9,2855,32
2020-08-26,Plumas,063,18699,39,39,0,39,0
2020-08-26,Riverside,065,2383286,53292,51138,57,51195,987
2020-08-26,Sacramento,067,1510023,18232,16708,15,16723,271
2020-08-26,San Benito,069,59416,1099,978,0,978,3
2020-08-26,San Bernardino,071,2135413,48786,45840,299,46139,743
2020-08-26,San Diego,073,3302833,39143,37224,397,37621,668
2020-08-26,San Francisco,075,870044,9539,8938,9,8947,81
2020-08-26,San Joaquin,077,732212,18414,16845,34,16879,309
2020-08-26,San Luis Obispo,079,281455,3087,2761,13,2774,20
2020-08-26,San Mateo,081,765935,8450,7655,9,7664,121
2020-08-26,Santa Barbara,083,443738,8175,7904,69,7973,90
2020-08-26,Santa Clara,085,1922200,18231,16283,37,16320,198
2020-08-26,Santa Cruz,087,273765,1870,1726,16,1742,7
2020-08-26,Shasta,089,179085,611,511,3,514,9
2020-08-26,Sierra,091,2930,6,6,0,6,0
2020-08-26,Siskiyou,093,43540,133,109,8,117,0
2020-08-26,Solano,095,438530,5480,5131,36,5167,34
2020-08-26,Sonoma,097,501317,5865,5283,19,5302,58
2020-08-26,Stanislaus,099,539301,15103,13964,329,14293,186
2020-08-26,Sutter,101,95872,1368,1275,1,1276,9
2020-08-26,Tehama,103,63373,424,396,2,398,1
2020-08-26,Trinity,105,12862,45,10,6,16,0
2020-08-26,Tulare,107,460477,14546,13568,55,13623,232
2020-08-26,Tuolumne,109,53932,201,172,4,176,1
2020-08-26,Ventura,111,848112,11267,10412,86,10498,100
2020-08-26,Yolo,113,214977,2466,2279,4,2283,49
2020-08-26,Yuba,115,75493,860,779,3,782,1
2020-08-25,Alameda,001,1643700,18559,17278,120,17398,232
2020-08-25,Alpine,003,1148,2,2,0,2,0
2020-08-25,Amador,005,37829,273,227,0,227,13
2020-08-25,Butte,007,227075,2087,1718,21,1739,24
2020-08-25,Calaveras,009,45235,240,196,0,196,1
2020-08-25,Colusa,011,21464,455,430,0,430,5
2020-08-25,Contra Costa,013,1133247,14224,13181,48,13229,156
2020-08-25,Del Norte,015,27424,113,83,0,83,1
2020-08-25,El Dorado,017,186661,1005,928,6,934,2
2020-08-25,Fresno,019,978130,27303,23932,294,24226,250
2020-08-25,Glenn,021,27897,446,429,0,429,3
2020-08-25,Humboldt,023,135768,382,342,1,343,4
2020-08-25,Imperial,025,180216,11189,9381,7,9388,217
2020-08-25,Inyo,027,18085,175,144,3,147,1
2020-08-25,Kern,029,883053,29552,28416,213,28629,285
2020-08-25,Kings,031,150075,6215,5702,30,5732,59
2020-08-25,Lake,033,64148,344,304,0,304,2
2020-08-25,Lassen,035,31185,721,692,2,694,0
2020-08-25,Los Angeles,037,10098052,240117,233961,1152,235113,5612
2020-08-25,Madera,039,155013,3865,3446,24,3470,32
2020-08-25,Marin,041,260295,6143,5860,15,5875,56
2020-08-25,Mariposa,043,17540,73,67,0,67,2
2020-08-25,Mendocino,045,87422,619,571,0,571,10
2020-08-25,Merced,047,269075,7944,7693,9,7702,69
2020-08-25,Modoc,049,8938,8,5,0,5,0
2020-08-25,Mono,051,14174,163,129,2,131,1
2020-08-25,Monterey,053,433212,7934,7333,22,7355,51
2020-08-25,Napa,055,140530,1460,1374,5,1379,10
2020-08-25,Nevada,057,99092,448,430,13,443,2
2020-08-25,Orange,059,3164182,49753,45737,1129,46866,902
2020-08-25,Placer,061,380077,3049,2829,6,2835,31
2020-08-25,Plumas,063,18699,39,39,0,39,0
2020-08-25,Riverside,065,2383286,53060,50889,57,50946,981
2020-08-25,Sacramento,067,1510023,18079,16601,15,16616,265
2020-08-25,San Benito,069,59416,1083,973,0,973,3
2020-08-25,San Bernardino,071,2135413,48551,45544,296,45840,727
2020-08-25,San Diego,073,3302833,38864,36996,375,37371,665
2020-08-25,San Francisco,075,870044,9462,8848,9,8857,81
2020-08-25,San Joaquin,077,732212,18287,16795,34,16829,306
2020-08-25,San Luis Obispo,079,281455,3028,2731,12,2743,20
2020-08-25,San Mateo,081,765935,8390,7636,8,7644,120
2020-08-25,Santa Barbara,083,443738,8123,7854,69,7923,90
2020-08-25,Santa Clara,085,1922200,18059,16199,37,16236,194
2020-08-25,Santa Cruz,087,273765,1851,1708,16,1724,7
2020-08-25,Shasta,089,179085,607,511,3,514,9
2020-08-25,Sierra,091,2930,6,6,0,6,0
2020-08-25,Siskiyou,093,43540,132,109,8,117,0
2020-08-25,Solano,095,438530,5419,5114,36,5150,34
2020-08-25,Sonoma,097,501317,5779,5148,19,5167,56
2020-08-25,Stanislaus,099,539301,14995,13886,318,14204,182
2020-08-25,Sutter,101,95872,1351,1259,1,1260,9
2020-08-25,Tehama,103,63373,421,394,2,396,1
2020-08-25,Trinity,105,12862,44,10,6,16,0
2020-08-25,Tulare,107,460477,14442,13514,54,13568,224
2020-08-25,Tuolumne,109,53932,199,172,4,176,1
2020-08-25,Ventura,111,848112,11182,10313,81,10394,99
2020-08-25,Yolo,113,214977,2453,2254,4,2258,50
2020-08-25,Yuba,115,75493,850,775,3,778,1
2020-08-24,Alameda,001,1643700,18364,16913,119,17032,231
2020-08-24,Alpine,003,1148,2,2,0,2,0
2020-08-24,Amador,005,37829,271,227,0,227,13
2020-08-24,Butte,007,227075,2003,1649,21,1670,23
2020-08-24,Calaveras,009,45235,231,187,0,187,1
2020-08-24,Colusa,011,21464,451,425,0,425,5
2020-08-24,Contra Costa,013,1133247,14108,12906,46,12952,153
2020-08-24,Del Norte,015,27424,113,80,0,80,1
2020-08-24,El Dorado,017,186661,997,908,6,914,2
2020-08-24,Fresno,019,978130,27115,23618,287,23905,235
2020-08-24,Glenn,021,27897,444,421,0,421,2
2020-08-24,Humboldt,023,135768,378,340,1,341,4
2020-08-24,Imperial,025,180216,11156,9323,7,9330,210
2020-08-24,Inyo,027,18085,171,144,3,147,2
2020-08-24,Kern,029,883053,29454,28157,207,28364,277
2020-08-24,Kings,031,150075,6127,5652,30,5682,60
2020-08-24,Lake,033,64148,329,302,0,302,2
2020-08-24,Lassen,035,31185,721,693,2,695,0
2020-08-24,Los Angeles,037,10098052,238755,233036,1134,234170,5562
2020-08-24,Madera,039,155013,3838,3418,24,3442,32
2020-08-24,Marin,041,260295,6080,5834,15,5849,56
2020-08-24,Mariposa,043,17540,71,66,0,66,2
2020-08-24,Mendocino,045,87422,604,550,0,550,10
2020-08-24,Merced,047,269075,7866,7605,9,7614,69
2020-08-24,Modoc,049,8938,8,5,0,5,0
2020-08-24,Mono,051,14174,163,129,2,131,1
2020-08-24,Monterey,053,433212,7825,7212,21,7233,50
2020-08-24,Napa,055,140530,1447,1358,5,1363,10
2020-08-24,Nevada,057,99092,443,423,13,436,2
2020-08-24,Orange,059,3164182,49560,45536,1120,46656,887
2020-08-24,Placer,061,380077,3003,2793,6,2799,31
2020-08-24,Plumas,063,18699,39,37,0,37,0
2020-08-24,Riverside,065,2383286,52782,50496,57,50553,975
2020-08-24,Sacramento,067,1510023,17882,16318,15,16333,249
2020-08-24,San Benito,069,59416,1062,961,0,961,3
2020-08-24,San Bernardino,071,2135413,48287,45199,294,45493,720
2020-08-24,San Diego,073,3302833,38576,36729,347,37076,660
2020-08-24,San Francisco,075,870044,9379,8621,9,8630,81
2020-08-24,San Joaquin,077,732212,18146,16565,33,16598,305
2020-08-24,San Luis Obispo,079,281455,3000,2705,12,2717,20
2020-08-24,San Mateo,081,765935,8323,7502,8,7510,120
2020-08-24,Santa Barbara,083,443738,8082,7784,69,7853,90
2020-08-24,Santa Clara,085,1922200,17855,16049,37,16086,192
2020-08-24,Santa Cruz,087,273765,1831,1627,15,1642,6
2020-08-24,Shasta,089,179085,605,505,3,508,9
2020-08-24,Sierra,091,2930,6,6,0,6,0
2020-08-24,Siskiyou,093,43540,128,107,8,115,0
2020-08-24,Solano,095,438530,5370,4979,34,5013,32
2020-08-24,Sonoma,097,501317,5677,5071,19,5090,56
2020-08-24,Stanislaus,099,539301,14897,13521,304,13825,171
2020-08-24,Sutter,101,95872,1332,1219,1,1220,9
2020-08-24,Tehama,103,63373,416,388,2,390,1
2020-08-24,Trinity,105,12862,44,10,6,16,0
2020-08-24,Tulare,107,460477,14335,13360,53,13413,223
2020-08-24,Tuolumne,109,53932,198,170,4,174,1
2020-08-24,Ventura,111,848112,11102,10261,77,10338,99
2020-08-24,Yolo,113,214977,2419,2239,4,2243,47
2020-08-24,Yuba,115,75493,833,750,3,753,1
2020-08-23,Alameda,001,1643700,18142,16786,118,16904,231
2020-08-23,Alpine,003,1148,2,2,0,2,0
2020-08-23,Amador,005,37829,268,227,0,227,13
2020-08-23,Butte,007,227075,1888,1637,21,1658,23
2020-08-23,Calaveras,009,45235,222,187,0,187,1
2020-08-23,Colusa,011,21464,444,424,0,424,5
2020-08-23,Contra Costa,013,1133247,13948,12642,46,12688,153
2020-08-23,Del Norte,015,27424,113,80,0,80,1
2020-08-23,El Dorado,017,186661,984,901,6,907,2
2020-08-23,Fresno,019,978130,26910,23414,284,23698,235
2020-08-23,Glenn,021,27897,437,421,0,421,2
2020-08-23,Humboldt,023,135768,376,341,1,342,4
2020-08-23,Imperial,025,180216,11127,9243,7,9250,210
2020-08-23,Inyo,027,18085,168,144,3,147,2
2020-08-23,Kern,029,883053,29305,28028,202,28230,277
2020-08-23,Kings,031,150075,6084,5628,30,5658,60
2020-08-23,Lake,033,64148,325,299,0,299,2
2020-08-23,Lassen,035,31185,720,693,2,695,0
2020-08-23,Los Angeles,037,10098052,237157,231833,1066,232899,5549
2020-08-23,Madera,039,155013,3807,3401,23,3424,32
2020-08-23,Marin,041,260295,6041,5807,14,5821,50
2020-08-23,Mariposa,043,17540,71,66,0,66,2
2020-08-23,Mendocino,045,87422,600,550,0,550,10
2020-08-23,Merced,047,269075,7797,7574,8,7582,69
2020-08-23,Modoc,049,8938,7,5,0,5,0
2020-08-23,Mono,051,14174,163,129,2,131,1
2020-08-23,Monterey,053,433212,7735,7173,21,7194,50
2020-08-23,Napa,055,140530,1435,1348,5,1353,10
2020-08-23,Nevada,057,99092,438,421,13,434,2
2020-08-23,Orange,059,3164182,49322,45267,1108,46375,887
2020-08-23,Placer,061,380077,2964,2772,6,2778,31
2020-08-23,Plumas,063,18699,39,37,0,37,0
2020-08-23,Riverside,065,2383286,52512,50293,55,50348,955
2020-08-23,Sacramento,067,1510023,17658,16084,14,16098,243
2020-08-23,San Benito,069,59416,1049,938,0,938,3
2020-08-23,San Bernardino,071,2135413,48019,45010,284,45294,719
2020-08-23,San Diego,073,3302833,38255,36542,320,36862,660
2020-08-23,San Francisco,075,870044,9284,8564,8,8572,80
2020-08-23,San Joaquin,077,732212,18013,16069,32,16101,305
2020-08-23,San Luis Obispo,079,281455,2958,2679,12,2691,20
2020-08-23,San Mateo,081,765935,8228,7450,8,7458,120
2020-08-23,Santa Barbara,083,443738,8014,7725,69,7794,90
2020-08-23,Santa Clara,085,1922200,17660,15912,35,15947,191
2020-08-23,Santa Cruz,087,273765,1805,1627,15,1642,6
2020-08-23,Shasta,089,179085,600,501,3,504,9
2020-08-23,Sierra,091,2930,6,6,0,6,0
2020-08-23,Siskiyou,093,43540,123,107,8,115,0
2020-08-23,Solano,095,438530,5312,4977,32,5009,32
2020-08-23,Sonoma,097,501317,5589,5018,19,5037,56
2020-08-23,Stanislaus,099,539301,14762,13483,281,13764,171
2020-08-23,Sutter,101,95872,1310,1203,1,1204,9
2020-08-23,Tehama,103,63373,406,381,2,383,1
2020-08-23,Trinity,105,12862,44,10,6,16,0
2020-08-23,Tulare,107,460477,14203,13303,50,13353,223
2020-08-23,Tuolumne,109,53932,195,164,4,168,1
2020-08-23,Ventura,111,848112,11001,10126,73,10199,99
2020-08-23,Yolo,113,214977,2391,2210,4,2214,47
2020-08-23,Yuba,115,75493,812,750,3,753,1
2020-08-22,Alameda,001,1643700,18048,16648,117,16765,231
2020-08-22,Alpine,003,1148,2,2,0,2,0
2020-08-22,Amador,005,37829,267,224,0,224,13
2020-08-22,Butte,007,227075,1837,1618,21,1639,22
2020-08-22,Calaveras,009,45235,218,187,0,187,1
2020-08-22,Colusa,011,21464,440,419,0,419,5
2020-08-22,Contra Costa,013,1133247,13861,12522,46,12568,153
2020-08-22,Del Norte,015,27424,112,80,0,80,1
2020-08-22,El Dorado,017,186661,982,900,6,906,2
2020-08-22,Fresno,019,978130,26813,23197,283,23480,235
2020-08-22,Glenn,021,27897,436,421,0,421,2
2020-08-22,Humboldt,023,135768,366,334,1,335,4
2020-08-22,Imperial,025,180216,11119,9244,7,9251,210
2020-08-22,Inyo,027,18085,168,144,3,147,1
2020-08-22,Kern,029,883053,29251,27807,202,28009,277
2020-08-22,Kings,031,150075,6075,5447,30,5477,60
2020-08-22,Lake,033,64148,323,291,0,291,2
2020-08-22,Lassen,035,31185,720,693,2,695,0
2020-08-22,Los Angeles,037,10098052,236497,230858,1049,231907,5540
2020-08-22,Madera,039,155013,3788,3330,23,3353,32
2020-08-22,Marin,041,260295,6029,5789,14,5803,49
2020-08-22,Mariposa,043,17540,71,66,0,66,2
2020-08-22,Mendocino,045,87422,597,529,0,529,10
2020-08-22,Merced,047,269075,7769,7493,8,7501,69
2020-08-22,Modoc,049,8938,7,5,0,5,0
2020-08-22,Mono,051,14174,163,129,2,131,1
2020-08-22,Monterey,053,433212,7687,7081,21,7102,50
2020-08-22,Napa,055,140530,1430,1328,5,1333,11
2020-08-22,Nevada,057,99092,438,411,13,424,2
2020-08-22,Orange,059,3164182,49181,45131,1102,46233,885
2020-08-22,Placer,061,380077,2950,2734,6,2740,30
2020-08-22,Plumas,063,18699,39,37,0,37,0
2020-08-22,Riverside,065,2383286,52364,49944,54,49998,953
2020-08-22,Sacramento,067,1510023,17546,15516,14,15530,239
2020-08-22,San Benito,069,59416,1033,912,0,912,3
2020-08-22,San Bernardino,071,2135413,47890,44803,280,45083,719
2020-08-22,San Diego,073,3302833,38072,36205,309,36514,673
2020-08-22,San Francisco,075,870044,9224,8568,8,8576,80
2020-08-22,San Joaquin,077,732212,17957,16068,32,16100,305
2020-08-22,San Luis Obispo,079,281455,2932,2660,12,2672,20
2020-08-22,San Mateo,081,765935,8181,7361,8,7369,120
2020-08-22,Santa Barbara,083,443738,7988,7685,69,7754,90
2020-08-22,Santa Clara,085,1922200,17552,15590,35,15625,190
2020-08-22,Santa Cruz,087,273765,1789,1628,14,1642,6
2020-08-22,Shasta,089,179085,598,493,3,496,9
2020-08-22,Sierra,091,2930,6,6,0,6,0
2020-08-22,Siskiyou,093,43540,123,106,8,114,0
2020-08-22,Solano,095,438530,5282,4944,31,4975,32
2020-08-22,Sonoma,097,501317,5543,4891,19,4910,57
2020-08-22,Stanislaus,099,539301,14712,13380,264,13644,170
2020-08-22,Sutter,101,95872,1303,1189,1,1190,8
2020-08-22,Tehama,103,63373,405,368,2,370,1
2020-08-22,Trinity,105,12862,44,8,6,14,0
2020-08-22,Tulare,107,460477,14136,13196,50,13246,222
2020-08-22,Tuolumne,109,53932,193,162,4,166,1
2020-08-22,Ventura,111,848112,10946,9959,71,10030,99
2020-08-22,Yolo,113,214977,2375,2188,4,2192,47
2020-08-22,Yuba,115,75493,800,738,3,741,1
2020-08-21,Alameda,001,1643700,17956,16413,117,16530,232
2020-08-21,Alpine,003,1148,2,2,0,2,0
2020-08-21,Amador,005,37829,266,223,0,223,11
2020-08-21,Butte,007,227075,1798,1582,21,1603,19
2020-08-21,Calaveras,009,45235,218,182,0,182,1
2020-08-21,Colusa,011,21464,438,418,0,418,5
2020-08-21,Contra Costa,013,1133247,13771,12333,45,12378,149
2020-08-21,Del Norte,015,27424,112,78,0,78,1
2020-08-21,El Dorado,017,186661,978,885,6,891,2
2020-08-21,Fresno,019,978130,26643,22840,282,23122,232
2020-08-21,Glenn,021,27897,432,418,0,418,2
2020-08-21,Humboldt,023,135768,363,331,1,332,4
2020-08-21,Imperial,025,180216,11103,9166,7,9173,204
2020-08-21,Inyo,027,18085,168,144,3,147,1
2020-08-21,Kern,029,883053,29192,27567,200,27767,269
2020-08-21,Kings,031,150075,6053,5391,30,5421,60
2020-08-21,Lake,033,64148,321,281,0,281,2
2020-08-21,Lassen,035,31185,720,693,2,695,0
2020-08-21,Los Angeles,037,10098052,235624,229235,1029,230264,5494
2020-08-21,Madera,039,155013,3758,3271,23,3294,31
2020-08-21,Marin,041,260295,6009,5762,14,5776,49
2020-08-21,Mariposa,043,17540,71,66,0,66,2
2020-08-21,Mendocino,045,87422,587,505,0,505,10
2020-08-21,Merced,047,269075,7740,7357,8,7365,69
2020-08-21,Modoc,049,8938,7,5,0,5,0
2020-08-21,Mono,051,14174,163,128,2,130,1
2020-08-21,Monterey,053,433212,7615,6974,21,6995,49
2020-08-21,Napa,055,140530,1421,1317,5,1322,10
2020-08-21,Nevada,057,99092,437,406,13,419,2
2020-08-21,Orange,059,3164182,49040,44625,1093,45718,875
2020-08-21,Placer,061,380077,2934,2698,6,2704,30
2020-08-21,Plumas,063,18699,39,36,0,36,0
2020-08-21,Riverside,065,2383286,52169,49409,54,49463,932
2020-08-21,Sacramento,067,1510023,17423,15247,14,15261,237
2020-08-21,San Benito,069,59416,1023,891,0,891,3
2020-08-21,San Bernardino,071,2135413,47770,44249,276,44525,668
2020-08-21,San Diego,073,3302833,37868,35914,292,36206,652
2020-08-21,San Francisco,075,870044,9174,8375,8,8383,80
2020-08-21,San Joaquin,077,732212,17874,15888,30,15918,301
2020-08-21,San Luis Obispo,079,281455,2909,2640,12,2652,19
2020-08-21,San Mateo,081,765935,8124,7253,8,7261,120
2020-08-21,Santa Barbara,083,443738,7947,7645,69,7714,86
2020-08-21,Santa Clara,085,1922200,17400,15399,35,15434,190
2020-08-21,Santa Cruz,087,273765,1777,1617,14,1631,6
2020-08-21,Shasta,089,179085,598,486,3,489,9
2020-08-21,Sierra,091,2930,6,6,0,6,0
2020-08-21,Siskiyou,093,43540,123,103,6,109,0
2020-08-21,Solano,095,438530,5259,4891,30,4921,32
2020-08-21,Sonoma,097,501317,5473,4816,19,4835,57
2020-08-21,Stanislaus,099,539301,14643,13282,250,13532,161
2020-08-21,Sutter,101,95872,1290,1173,1,1174,8
2020-08-21,Tehama,103,63373,403,357,2,359,1
2020-08-21,Trinity,105,12862,44,8,6,14,0
2020-08-21,Tulare,107,460477,14064,13002,49,13051,217
2020-08-21,Tuolumne,109,53932,185,161,4,165,1
2020-08-21,Ventura,111,848112,10881,9865,69,9934,98
2020-08-21,Yolo,113,214977,2360,2164,4,2168,46
2020-08-21,Yuba,115,75493,796,717,3,720,1
2020-08-20,Alameda,001,1643700,17796,16174,117,16291,229
2020-08-20,Alpine,003,1148,2,2,0,2,0
2020-08-20,Amador,005,37829,264,222,0,222,11
2020-08-20,Butte,007,227075,1748,1549,21,1570,18
2020-08-20,Calaveras,009,45235,215,179,0,179,1
2020-08-20,Colusa,011,21464,436,415,0,415,5
2020-08-20,Contra Costa,013,1133247,13643,12108,44,12152,144
2020-08-20,Del Norte,015,27424,112,78,0,78,1
2020-08-20,El Dorado,017,186661,974,881,6,887,2
2020-08-20,Fresno,019,978130,26461,22535,277,22812,228
2020-08-20,Glenn,021,27897,427,414,0,414,2
2020-08-20,Humboldt,023,135768,358,318,1,319,4
2020-08-20,Imperial,025,180216,11084,9086,7,9093,196
2020-08-20,Inyo,027,18085,167,144,3,147,1
2020-08-20,Kern,029,883053,29024,27337,189,27526,267
2020-08-20,Kings,031,150075,6013,5347,29,5376,59
2020-08-20,Lake,033,64148,316,280,0,280,2
2020-08-20,Lassen,035,31185,719,693,2,695,0
2020-08-20,Los Angeles,037,10098052,234390,227492,1010,228502,5445
2020-08-20,Madera,039,155013,3732,3197,23,3220,31
2020-08-20,Marin,041,260295,5991,5745,14,5759,47
2020-08-20,Mariposa,043,17540,71,67,0,67,2
2020-08-20,Mendocino,045,87422,577,497,0,497,10
2020-08-20,Merced,047,269075,7665,7173,8,7181,68
2020-08-20,Modoc,049,8938,7,5,0,5,0
2020-08-20,Mono,051,14174,163,128,2,130,1
2020-08-20,Monterey,053,433212,7544,6892,21,6913,47
2020-08-20,Napa,055,140530,1413,1306,5,1311,10
2020-08-20,Nevada,057,99092,436,401,13,414,2
2020-08-20,Orange,059,3164182,48813,44299,1083,45382,849
2020-08-20,Placer,061,380077,2918,2681,6,2687,30
2020-08-20,Plumas,063,18699,39,36,0,36,0
2020-08-20,Riverside,065,2383286,51950,48953,53,49006,927
2020-08-20,Sacramento,067,1510023,17181,14992,14,15006,231
2020-08-20,San Benito,069,59416,1010,866,0,866,3
2020-08-20,San Bernardino,071,2135413,47514,43627,272,43899,665
2020-08-20,San Diego,073,3302833,37648,35610,274,35884,644
2020-08-20,San Francisco,075,870044,9088,8262,8,8270,72
2020-08-20,San Joaquin,077,732212,17781,15778,30,15808,297
2020-08-20,San Luis Obispo,079,281455,2889,2590,12,2602,19
2020-08-20,San Mateo,081,765935,8059,7188,8,7196,120
2020-08-20,Santa Barbara,083,443738,7909,7571,69,7640,81
2020-08-20,Santa Clara,085,1922200,17227,15162,35,15197,190
2020-08-20,Santa Cruz,087,273765,1764,1581,14,1595,6
2020-08-20,Shasta,089,179085,597,478,3,481,9
2020-08-20,Sierra,091,2930,6,6,0,6,0
2020-08-20,Siskiyou,093,43540,122,102,1,103,0
2020-08-20,Solano,095,438530,5215,4843,30,4873,31
2020-08-20,Sonoma,097,501317,5401,4737,19,4756,54
2020-08-20,Stanislaus,099,539301,14547,13120,241,13361,161
2020-08-20,Sutter,101,95872,1266,1158,1,1159,8
2020-08-20,Tehama,103,63373,398,350,2,352,1
2020-08-20,Trinity,105,12862,44,8,6,14,0
2020-08-20,Tulare,107,460477,13956,12907,48,12955,217
2020-08-20,Tuolumne,109,53932,181,159,4,163,1
2020-08-20,Ventura,111,848112,10768,9744,68,9812,93
2020-08-20,Yolo,113,214977,2338,2150,4,2154,47
2020-08-20,Yuba,115,75493,779,709,3,712,1
2020-08-19,Alameda,001,1643700,17638,15874,116,15990,226
2020-08-19,Alpine,003,1148,2,2,0,2,0
2020-08-19,Amador,005,37829,263,219,0,219,9
2020-08-19,Butte,007,227075,1705,1517,21,1538,16
2020-08-19,Calaveras,009,45235,213,177,0,177,1
2020-08-19,Colusa,011,21464,435,415,0,415,5
2020-08-19,Contra Costa,013,1133247,13531,11895,43,11938,142
2020-08-19,Del Norte,015,27424,112,78,0,78,1
2020-08-19,El Dorado,017,186661,968,870,6,876,2
2020-08-19,Fresno,019,978130,26272,22167,268,22435,221
2020-08-19,Glenn,021,27897,425,414,0,414,2
2020-08-19,Humboldt,023,135768,355,316,1,317,4
2020-08-19,Imperial,025,180216,11056,9041,7,9048,192
2020-08-19,Inyo,027,18085,165,140,3,143,1
2020-08-19,Kern,029,883053,28907,27142,185,27327,263
2020-08-19,Kings,031,150075,5840,5301,27,5328,59
2020-08-19,Lake,033,64148,313,277,0,277,2
2020-08-19,Lassen,035,31185,711,693,2,695,0
2020-08-19,Los Angeles,037,10098052,233113,226006,970,226976,5399
2020-08-19,Madera,039,155013,3698,3158,21,3179,30
2020-08-19,Marin,041,260295,5967,5723,13,5736,46
2020-08-19,Mariposa,043,17540,71,64,0,64,2
2020-08-19,Mendocino,045,87422,560,495,0,495,8
2020-08-19,Merced,047,269075,7538,7082,5,7087,66
2020-08-19,Modoc,049,8938,7,5,0,5,0
2020-08-19,Mono,051,14174,163,128,2,130,1
2020-08-19,Monterey,053,433212,7444,6693,21,6714,45
2020-08-19,Napa,055,140530,1408,1293,5,1298,10
2020-08-19,Nevada,057,99092,429,398,13,411,2
2020-08-19,Orange,059,3164182,48608,43938,1080,45018,829
2020-08-19,Placer,061,380077,2896,2659,6,2665,28
2020-08-19,Plumas,063,18699,39,36,0,36,0
2020-08-19,Riverside,065,2383286,51701,48741,53,48794,922
2020-08-19,Sacramento,067,1510023,17001,14764,14,14778,229
2020-08-19,San Benito,069,59416,993,853,0,853,3
2020-08-19,San Bernardino,071,2135413,47216,43224,266,43490,661
2020-08-19,San Diego,073,3302833,37398,35378,259,35637,638
2020-08-19,San Francisco,075,870044,9024,8236,8,8244,72
2020-08-19,San Joaquin,077,732212,17655,15677,29,15706,296
2020-08-19,San Luis Obispo,079,281455,2849,2553,12,2565,19
2020-08-19,San Mateo,081,765935,7990,7146,8,7154,119
2020-08-19,Santa Barbara,083,443738,7860,7499,69,7568,80
2020-08-19,Santa Clara,085,1922200,17081,14994,35,15029,189
2020-08-19,Santa Cruz,087,273765,1738,1554,14,1568,6
2020-08-19,Shasta,089,179085,593,475,3,478,9
2020-08-19,Sierra,091,2930,6,6,0,6,0
2020-08-19,Siskiyou,093,43540,121,103,1,104,0
2020-08-19,Solano,095,438530,5174,4807,30,4837,31
2020-08-19,Sonoma,097,501317,5322,4614,19,4633,54
2020-08-19,Stanislaus,099,539301,14444,13084,219,13303,160
2020-08-19,Sutter,101,95872,1232,1146,1,1147,8
2020-08-19,Tehama,103,63373,392,342,2,344,1
2020-08-19,Trinity,105,12862,43,8,6,14,0
2020-08-19,Tulare,107,460477,13858,12756,48,12804,217
2020-08-19,Tuolumne,109,53932,178,159,4,163,1
2020-08-19,Ventura,111,848112,10676,9587,66,9653,91
2020-08-19,Yolo,113,214977,2316,2126,4,2130,47
2020-08-19,Yuba,115,75493,767,701,3,704,1
2020-08-18,Alameda,001,1643700,17461,15627,114,15741,223
2020-08-18,Alpine,003,1148,2,2,0,2,0
2020-08-18,Amador,005,37829,262,215,0,215,9
2020-08-18,Butte,007,227075,1672,1491,21,1512,16
2020-08-18,Calaveras,009,45235,210,174,0,174,1
2020-08-18,Colusa,011,21464,434,415,0,415,5
2020-08-18,Contra Costa,013,1133247,13411,11689,41,11730,141
2020-08-18,Del Norte,015,27424,111,78,0,78,0
2020-08-18,El Dorado,017,186661,963,866,6,872,2
2020-08-18,Fresno,019,978130,26051,21798,262,22060,212
2020-08-18,Glenn,021,27897,425,407,0,407,2
2020-08-18,Humboldt,023,135768,353,315,1,316,4
2020-08-18,Imperial,025,180216,11022,8968,7,8975,189
2020-08-18,Inyo,027,18085,164,140,3,143,1
2020-08-18,Kern,029,883053,28754,26978,181,27159,263
2020-08-18,Kings,031,150075,5805,5269,26,5295,58
2020-08-18,Lake,033,64148,310,274,0,274,2
2020-08-18,Lassen,035,31185,711,693,2,695,0
2020-08-18,Los Angeles,037,10098052,231849,224218,933,225151,5339
2020-08-18,Madera,039,155013,3670,3125,21,3146,28
2020-08-18,Marin,041,260295,5937,5708,13,5721,47
2020-08-18,Mariposa,043,17540,71,61,0,61,2
2020-08-18,Mendocino,045,87422,551,468,0,468,8
2020-08-18,Merced,047,269075,7490,6940,5,6945,66
2020-08-18,Modoc,049,8938,7,5,0,5,0
2020-08-18,Mono,051,14174,162,129,2,131,1
2020-08-18,Monterey,053,433212,7352,6691,20,6711,44
2020-08-18,Napa,055,140530,1405,1274,5,1279,10
2020-08-18,Nevada,057,99092,422,389,13,402,2
2020-08-18,Orange,059,3164182,48383,43659,1066,44725,809
2020-08-18,Placer,061,380077,2870,2644,5,2649,28
2020-08-18,Plumas,063,18699,39,34,0,34,0
2020-08-18,Riverside,065,2383286,51369,48447,53,48500,917
2020-08-18,Sacramento,067,1510023,16771,14610,13,14623,222
2020-08-18,San Benito,069,59416,973,836,0,836,3
2020-08-18,San Bernardino,071,2135413,46935,42827,260,43087,648
2020-08-18,San Diego,073,3302833,37105,35164,227,35391,633
2020-08-18,San Francisco,075,870044,8939,8016,8,8024,72
2020-08-18,San Joaquin,077,732212,17539,15509,28,15537,290
2020-08-18,San Luis Obispo,079,281455,2824,2535,11,2546,18
2020-08-18,San Mateo,081,765935,7929,7074,8,7082,119
2020-08-18,Santa Barbara,083,443738,7818,7472,69,7541,81
2020-08-18,Santa Clara,085,1922200,16910,14786,34,14820,184
2020-08-18,Santa Cruz,087,273765,1725,1509,14,1523,6
2020-08-18,Shasta,089,179085,589,468,3,471,9
2020-08-18,Sierra,091,2930,6,6,0,6,0
2020-08-18,Siskiyou,093,43540,120,103,1,104,0
2020-08-18,Solano,095,438530,5147,4700,30,4730,31
2020-08-18,Sonoma,097,501317,5253,4506,19,4525,48
2020-08-18,Stanislaus,099,539301,14346,12935,203,13138,149
2020-08-18,Sutter,101,95872,1213,1126,1,1127,8
2020-08-18,Tehama,103,63373,382,333,2,335,1
2020-08-18,Trinity,105,12862,41,8,6,14,0
2020-08-18,Tulare,107,460477,13727,12637,45,12682,212
2020-08-18,Tuolumne,109,53932,175,159,4,163,1
2020-08-18,Ventura,111,848112,10586,9536,61,9597,89
2020-08-18,Yolo,113,214977,2294,2102,4,2106,47
2020-08-18,Yuba,115,75493,759,679,3,682,1
2020-08-17,Alameda,001,1643700,17268,15454,113,15567,221
2020-08-17,Alpine,003,1148,2,2,0,2,0
2020-08-17,Amador,005,37829,262,215,0,215,9
2020-08-17,Butte,007,227075,1627,1463,21,1484,15
2020-08-17,Calaveras,009,45235,206,167,0,167,1
2020-08-17,Colusa,011,21464,431,408,0,408,5
2020-08-17,Contra Costa,013,1133247,13274,11442,41,11483,141
2020-08-17,Del Norte,015,27424,107,77,0,77,0
2020-08-17,El Dorado,017,186661,960,846,6,852,2
2020-08-17,Fresno,019,978130,25844,21316,255,21571,211
2020-08-17,Glenn,021,27897,424,402,0,402,2
2020-08-17,Humboldt,023,135768,349,302,1,303,4
2020-08-17,Imperial,025,180216,10981,8897,7,8904,188
2020-08-17,Inyo,027,18085,156,124,3,127,1
2020-08-17,Kern,029,883053,28607,26773,171,26944,249
2020-08-17,Kings,031,150075,5767,5249,26,5275,58
2020-08-17,Lake,033,64148,305,270,0,270,2
2020-08-17,Lassen,035,31185,711,666,2,668,0
2020-08-17,Los Angeles,037,10098052,230330,223418,888,224306,5282
2020-08-17,Madera,039,155013,3627,3050,20,3070,26
2020-08-17,Marin,041,260295,5914,5683,12,5695,46
2020-08-17,Mariposa,043,17540,71,61,0,61,2
2020-08-17,Mendocino,045,87422,533,454,0,454,8
2020-08-17,Merced,047,269075,7395,6814,5,6819,66
2020-08-17,Modoc,049,8938,7,5,0,5,0
2020-08-17,Mono,051,14174,162,126,2,128,1
2020-08-17,Monterey,053,433212,7252,6553,20,6573,44
2020-08-17,Napa,055,140530,1384,1255,5,1260,10
2020-08-17,Nevada,057,99092,417,383,13,396,2
2020-08-17,Orange,059,3164182,48173,43621,1053,44674,804
2020-08-17,Placer,061,380077,2845,2609,5,2614,28
2020-08-17,Plumas,063,18699,39,33,0,33,0
2020-08-17,Riverside,065,2383286,51036,48062,51,48113,916
2020-08-17,Sacramento,067,1510023,16551,14333,13,14346,219
2020-08-17,San Benito,069,59416,958,822,0,822,2
2020-08-17,San Bernardino,071,2135413,46591,42005,252,42257,604
2020-08-17,San Diego,073,3302833,36839,34962,213,35175,626
2020-08-17,San Francisco,075,870044,8868,7600,8,7608,72
2020-08-17,San Joaquin,077,732212,17377,15323,27,15350,280
2020-08-17,San Luis Obispo,079,281455,2791,2527,11,2538,18
2020-08-17,San Mateo,081,765935,7872,6987,7,6994,118
2020-08-17,Santa Barbara,083,443738,7776,7438,69,7507,80
2020-08-17,Santa Clara,085,1922200,16686,14546,34,14580,183
2020-08-17,Santa Cruz,087,273765,1709,1453,13,1466,6
2020-08-17,Shasta,089,179085,583,467,3,470,9
2020-08-17,Sierra,091,2930,6,6,0,6,0
2020-08-17,Siskiyou,093,43540,119,103,0,103,0
2020-08-17,Solano,095,438530,5090,4479,30,4509,31
2020-08-17,Sonoma,097,501317,5165,4402,17,4419,48
2020-08-17,Stanislaus,099,539301,14221,12745,196,12941,148
2020-08-17,Sutter,101,95872,1197,1071,1,1072,8
2020-08-17,Tehama,103,63373,372,324,2,326,1
2020-08-17,Trinity,105,12862,41,8,6,14,0
2020-08-17,Tulare,107,460477,13615,12487,44,12531,210
2020-08-17,Tuolumne,109,53932,172,157,4,161,1
2020-08-17,Ventura,111,848112,10463,9490,56,9546,89
2020-08-17,Yolo,113,214977,2267,2083,4,2087,47
2020-08-17,Yuba,115,75493,744,647,3,650,1
2020-08-16,Alameda,001,1643700,16977,15338,113,15451,221
2020-08-16,Alpine,003,1148,2,2,0,2,0
2020-08-16,Amador,005,37829,259,215,0,215,9
2020-08-16,Butte,007,227075,1589,1432,21,1453,15
2020-08-16,Calaveras,009,45235,199,167,0,167,1
2020-08-16,Colusa,011,21464,429,407,0,407,5
2020-08-16,Contra Costa,013,1133247,13088,11255,41,11296,140
2020-08-16,Del Norte,015,27424,103,77,0,77,0
2020-08-16,El Dorado,017,186661,948,843,6,849,2
2020-08-16,Fresno,019,978130,25623,21010,250,21260,211
2020-08-16,Glenn,021,27897,422,400,0,400,2
2020-08-16,Humboldt,023,135768,347,301,1,302,4
2020-08-16,Imperial,025,180216,10937,8883,7,8890,188
2020-08-16,Inyo,027,18085,149,125,2,127,1
2020-08-16,Kern,029,883053,28408,26520,163,26683,249
2020-08-16,Kings,031,150075,5736,5146,26,5172,58
2020-08-16,Lake,033,64148,301,269,0,269,2
2020-08-16,Lassen,035,31185,711,666,2,668,0
2020-08-16,Los Angeles,037,10098052,228760,222236,858,223094,5263
2020-08-16,Madera,039,155013,3582,3013,20,3033,26
2020-08-16,Marin,041,260295,5888,5664,12,5676,46
2020-08-16,Mariposa,043,17540,71,61,0,61,2
2020-08-16,Mendocino,045,87422,525,451,0,451,8
2020-08-16,Merced,047,269075,7313,6744,5,6749,66
2020-08-16,Modoc,049,8938,7,5,0,5,0
2020-08-16,Mono,051,14174,162,126,2,128,1
2020-08-16,Monterey,053,433212,7154,6516,19,6535,44
2020-08-16,Napa,055,140530,1366,1241,3,1244,10
2020-08-16,Nevada,057,99092,408,379,13,392,2
2020-08-16,Orange,059,3164182,47924,43303,1042,44345,803
2020-08-16,Placer,061,380077,2816,2583,4,2587,28
2020-08-16,Plumas,063,18699,39,33,0,33,0
2020-08-16,Riverside,065,2383286,50705,47669,50,47719,910
2020-08-16,Sacramento,067,1510023,16311,14210,13,14223,219
2020-08-16,San Benito,069,59416,929,815,0,815,2
2020-08-16,San Bernardino,071,2135413,46167,41724,244,41968,603
2020-08-16,San Diego,073,3302833,36575,34680,198,34878,626
2020-08-16,San Francisco,075,870044,8781,7602,8,7610,72
2020-08-16,San Joaquin,077,732212,17174,15288,27,15315,280
2020-08-16,San Luis Obispo,079,281455,2762,2494,11,2505,17
2020-08-16,San Mateo,081,765935,7798,6942,7,6949,118
2020-08-16,Santa Barbara,083,443738,7727,7368,69,7437,79
2020-08-16,Santa Clara,085,1922200,16488,14329,34,14363,183
2020-08-16,Santa Cruz,087,273765,1682,1449,12,1461,6
2020-08-16,Shasta,089,179085,576,465,3,468,9
2020-08-16,Sierra,091,2930,6,6,0,6,0
2020-08-16,Siskiyou,093,43540,118,102,0,102,0
2020-08-16,Solano,095,438530,5030,4479,30,4509,31
2020-08-16,Sonoma,097,501317,5061,4329,17,4346,46
2020-08-16,Stanislaus,099,539301,14063,12668,186,12854,148
2020-08-16,Sutter,101,95872,1179,1071,1,1072,8
2020-08-16,Tehama,103,63373,363,318,2,320,1
2020-08-16,Trinity,105,12862,38,8,6,14,0
2020-08-16,Tulare,107,460477,13483,12334,41,12375,211
2020-08-16,Tuolumne,109,53932,172,156,4,160,1
2020-08-16,Ventura,111,848112,10354,9408,51,9459,89
2020-08-16,Yolo,113,214977,2248,2057,4,2061,47
2020-08-16,Yuba,115,75493,735,647,2,649,1
2020-08-15,Alameda,001,1643700,16900,15165,113,15278,221
2020-08-15,Alpine,003,1148,2,2,0,2,0
2020-08-15,Amador,005,37829,259,210,0,210,9
2020-08-15,Butte,007,227075,1567,1409,21,1430,15
2020-08-15,Calaveras,009,45235,197,167,0,167,1
2020-08-15,Colusa,011,21464,428,401,0,401,5
2020-08-15,Contra Costa,013,1133247,12992,11106,41,11147,138
2020-08-15,Del Norte,015,27424,103,77,0,77,0
2020-08-15,El Dorado,017,186661,943,838,6,844,2
2020-08-15,Fresno,019,978130,25507,20603,248,20851,211
2020-08-15,Glenn,021,27897,422,398,0,398,2
2020-08-15,Humboldt,023,135768,346,301,1,302,4
2020-08-15,Imperial,025,180216,10917,8794,7,8801,188
2020-08-15,Inyo,027,18085,149,123,2,125,1
2020-08-15,Kern,029,883053,28320,26338,163,26501,249
2020-08-15,Kings,031,150075,5718,5039,26,5065,56
2020-08-15,Lake,033,64148,299,268,0,268,2
2020-08-15,Lassen,035,31185,711,666,2,668,0
2020-08-15,Los Angeles,037,10098052,228009,221043,848,221891,5252
2020-08-15,Madera,039,155013,3532,2950,20,2970,26
2020-08-15,Marin,041,260295,5881,5628,12,5640,46
2020-08-15,Mariposa,043,17540,71,61,0,61,2
2020-08-15,Mendocino,045,87422,521,444,0,444,8
2020-08-15,Merced,047,269075,7279,6656,5,6661,66
2020-08-15,Modoc,049,8938,7,5,0,5,0
2020-08-15,Mono,051,14174,162,126,2,128,1
2020-08-15,Monterey,053,433212,7109,6162,19,6181,44
2020-08-15,Napa,055,140530,1356,1232,3,1235,10
2020-08-15,Nevada,057,99092,408,376,13,389,2
2020-08-15,Orange,059,3164182,47811,42811,1031,43842,801
2020-08-15,Placer,061,380077,2795,2551,4,2555,27
2020-08-15,Plumas,063,18699,39,33,0,33,0
2020-08-15,Riverside,065,2383286,50554,46720,50,46770,910
2020-08-15,Sacramento,067,1510023,16201,14018,13,14031,219
2020-08-15,San Benito,069,59416,916,805,0,805,2
2020-08-15,San Bernardino,071,2135413,46015,41231,242,41473,602
2020-08-15,San Diego,073,3302833,36409,34346,184,34530,639
2020-08-15,San Francisco,075,870044,8719,7601,8,7609,69
2020-08-15,San Joaquin,077,732212,17101,15113,27,15140,280
2020-08-15,San Luis Obispo,079,281455,2745,2461,11,2472,17
2020-08-15,San Mateo,081,765935,7761,6860,7,6867,118
2020-08-15,Santa Barbara,083,443738,7699,7338,69,7407,79
2020-08-15,Santa Clara,085,1922200,16392,14105,34,14139,183
2020-08-15,Santa Cruz,087,273765,1661,1449,12,1461,6
2020-08-15,Shasta,089,179085,573,458,3,461,9
2020-08-15,Sierra,091,2930,6,6,0,6,0
2020-08-15,Siskiyou,093,43540,117,100,0,100,0
2020-08-15,Solano,095,438530,5008,4477,30,4507,31
2020-08-15,Sonoma,097,501317,5006,4134,17,4151,45
2020-08-15,Stanislaus,099,539301,13999,12541,185,12726,149
2020-08-15,Sutter,101,95872,1168,1046,1,1047,8
2020-08-15,Tehama,103,63373,362,312,2,314,1
2020-08-15,Trinity,105,12862,36,6,6,12,0
2020-08-15,Tulare,107,460477,13444,12262,41,12303,211
2020-08-15,Tuolumne,109,53932,172,155,4,159,1
2020-08-15,Ventura,111,848112,10295,9379,49,9428,89
2020-08-15,Yolo,113,214977,2236,2031,4,2035,46
2020-08-15,Yuba,115,75493,731,623,2,625,1
2020-08-14,Alameda,001,1643700,16760,14909,113,15022,221
2020-08-14,Alpine,003,1148,2,2,0,2,0
2020-08-14,Amador,005,37829,259,209,0,209,9
2020-08-14,Butte,007,227075,1559,1384,21,1405,15
2020-08-14,Calaveras,009,45235,193,165,0,165,1
2020-08-14,Colusa,011,21464,426,399,0,399,5
2020-08-14,Contra Costa,013,1133247,12880,10893,41,10934,137
2020-08-14,Del Norte,015,27424,103,76,0,76,0
2020-08-14,El Dorado,017,186661,935,827,6,833,2
2020-08-14,Fresno,019,978130,25373,19900,248,20148,208
2020-08-14,Glenn,021,27897,420,395,0,395,2
2020-08-14,Humboldt,023,135768,340,294,1,295,4
2020-08-14,Imperial,025,180216,10893,8756,7,8763,185
2020-08-14,Inyo,027,18085,148,115,2,117,1
2020-08-14,Kern,029,883053,28216,25893,162,26055,249
2020-08-14,Kings,031,150075,5704,4953,26,4979,56
2020-08-14,Lake,033,64148,290,267,0,267,2
2020-08-14,Lassen,035,31185,711,665,2,667,0
2020-08-14,Los Angeles,037,10098052,226837,219083,831,219914,5222
2020-08-14,Madera,039,155013,3502,2876,20,2896,26
2020-08-14,Marin,041,260295,5870,5601,12,5613,46
2020-08-14,Mariposa,043,17540,70,61,0,61,2
2020-08-14,Mendocino,045,87422,512,432,0,432,8
2020-08-14,Merced,047,269075,7249,6466,5,6471,67
2020-08-14,Modoc,049,8938,7,5,0,5,0
2020-08-14,Mono,051,14174,162,126,2,128,1
2020-08-14,Monterey,053,433212,7058,6121,19,6140,41
2020-08-14,Napa,055,140530,1346,1230,3,1233,10
2020-08-14,Nevada,057,99092,404,377,13,390,2
2020-08-14,Orange,059,3164182,47661,42399,1019,43418,798
2020-08-14,Placer,061,380077,2776,2546,4,2550,26
2020-08-14,Plumas,063,18699,38,33,0,33,0
2020-08-14,Riverside,065,2383286,50325,46456,50,46506,891
2020-08-14,Sacramento,067,1510023,16052,13645,13,13658,212
2020-08-14,San Benito,069,59416,899,783,0,783,2
2020-08-14,San Bernardino,071,2135413,45828,40442,239,40681,594
2020-08-14,San Diego,073,3302833,36215,34067,177,34244,622
2020-08-14,San Francisco,075,870044,8660,7467,8,7475,69
2020-08-14,San Joaquin,077,732212,17001,14925,27,14952,276
2020-08-14,San Luis Obispo,079,281455,2730,2422,11,2433,17
2020-08-14,San Mateo,081,765935,7702,6655,7,6662,118
2020-08-14,Santa Barbara,083,443738,7649,7302,69,7371,77
2020-08-14,Santa Clara,085,1922200,16226,13785,33,13818,183
2020-08-14,Santa Cruz,087,273765,1639,1418,11,1429,6
2020-08-14,Shasta,089,179085,568,446,3,449,9
2020-08-14,Sierra,091,2930,6,5,0,5,0
2020-08-14,Siskiyou,093,43540,117,98,0,98,0
2020-08-14,Solano,095,438530,4987,4421,30,4451,31
2020-08-14,Sonoma,097,501317,4947,4087,14,4101,45
2020-08-14,Stanislaus,099,539301,13920,12379,181,12560,140
2020-08-14,Sutter,101,95872,1160,1039,1,1040,8
2020-08-14,Tehama,103,63373,357,305,2,307,1
2020-08-14,Trinity,105,12862,36,6,6,12,0
2020-08-14,Tulare,107,460477,13367,12009,41,12050,211
2020-08-14,Tuolumne,109,53932,171,155,4,159,1
2020-08-14,Ventura,111,848112,10220,9313,49,9362,89
2020-08-14,Yolo,113,214977,2222,1991,4,1995,45
2020-08-14,Yuba,115,75493,715,606,2,608,1
2020-08-13,Alameda,001,1643700,16481,14385,113,14498,218
2020-08-13,Alpine,003,1148,2,2,0,2,0
2020-08-13,Amador,005,37829,259,198,0,198,8
2020-08-13,Butte,007,227075,1534,1345,21,1366,15
2020-08-13,Calaveras,009,45235,191,162,0,162,1
2020-08-13,Colusa,011,21464,426,395,0,395,5
2020-08-13,Contra Costa,013,1133247,12726,10545,40,10585,136
2020-08-13,Del Norte,015,27424,102,74,0,74,0
2020-08-13,El Dorado,017,186661,930,803,6,809,2
2020-08-13,Fresno,019,978130,25146,19157,242,19399,201
2020-08-13,Glenn,021,27897,416,392,0,392,1
2020-08-13,Humboldt,023,135768,332,281,1,282,4
2020-08-13,Imperial,025,180216,10862,8640,7,8647,170
2020-08-13,Inyo,027,18085,144,97,2,99,1
2020-08-13,Kern,029,883053,28049,25472,159,25631,242
2020-08-13,Kings,031,150075,5669,4824,26,4850,52
2020-08-13,Lake,033,64148,285,263,0,263,2
2020-08-13,Lassen,035,31185,711,652,2,654,0
2020-08-13,Los Angeles,037,10098052,225455,216497,809,217306,5179
2020-08-13,Madera,039,155013,3458,2675,19,2694,25
2020-08-13,Marin,041,260295,5854,5503,12,5515,44
2020-08-13,Mariposa,043,17540,69,61,0,61,2
2020-08-13,Mendocino,045,87422,507,401,0,401,8
2020-08-13,Merced,047,269075,7132,5945,5,5950,63
2020-08-13,Modoc,049,8938,7,5,0,5,0
2020-08-13,Mono,051,14174,162,124,2,126,1
2020-08-13,Monterey,053,433212,6975,5925,19,5944,38
2020-08-13,Napa,055,140530,1337,1179,3,1182,10
2020-08-13,Nevada,057,99092,400,362,13,375,1
2020-08-13,Orange,059,3164182,47422,42019,1008,43027,773
2020-08-13,Placer,061,380077,2753,2460,4,2464,26
2020-08-13,Plumas,063,18699,38,32,0,32,0
2020-08-13,Riverside,065,2383286,50029,45327,50,45377,885
2020-08-13,Sacramento,067,1510023,15849,13237,13,13250,197
2020-08-13,San Benito,069,59416,870,757,0,757,2
2020-08-13,San Bernardino,071,2135413,45433,39395,232,39627,591
2020-08-13,San Diego,073,3302833,35979,33661,159,33820,627
2020-08-13,San Francisco,075,870044,8566,7277,8,7285,69
2020-08-13,San Joaquin,077,732212,16846,14537,26,14563,261
2020-08-13,San Luis Obispo,079,281455,2708,2283,11,2294,16
2020-08-13,San Mateo,081,765935,7640,6503,7,6510,117
2020-08-13,Santa Barbara,083,443738,7604,7129,68,7197,74
2020-08-13,Santa Clara,085,1922200,16004,13257,33,13290,182
2020-08-13,Santa Cruz,087,273765,1614,1383,11,1394,6
2020-08-13,Shasta,089,179085,563,428,3,431,9
2020-08-13,Sierra,091,2930,6,5,0,5,0
2020-08-13,Siskiyou,093,43540,117,95,0,95,0
2020-08-13,Solano,095,438530,4949,4305,30,4335,31
2020-08-13,Sonoma,097,501317,4873,3902,14,3916,45
2020-08-13,Stanislaus,099,539301,13790,11953,165,12118,136
2020-08-13,Sutter,101,95872,1138,992,1,993,8
2020-08-13,Tehama,103,63373,348,302,2,304,1
2020-08-13,Trinity,105,12862,35,6,6,12,0
2020-08-13,Tulare,107,460477,13223,11692,38,11730,210
2020-08-13,Tuolumne,109,53932,170,152,4,156,1
2020-08-13,Ventura,111,848112,10131,9114,49,9163,90
2020-08-13,Yolo,113,214977,2195,1938,4,1942,44
2020-08-13,Yuba,115,75493,699,568,2,570,1
2020-08-12,Alameda,001,1643700,16267,14214,113,14327,215
2020-08-12,Alpine,003,1148,2,2,0,2,0
2020-08-12,Amador,005,37829,256,197,0,197,8
2020-08-12,Butte,007,227075,1506,1317,21,1338,15
2020-08-12,Calaveras,009,45235,188,157,0,157,1
2020-08-12,Colusa,011,21464,421,394,0,394,5
2020-08-12,Contra Costa,013,1133247,12581,10304,39,10343,134
2020-08-12,Del Norte,015,27424,101,74,0,74,0
2020-08-12,El Dorado,017,186661,912,794,6,800,2
2020-08-12,Fresno,019,978130,24916,18690,236,18926,194
2020-08-12,Glenn,021,27897,413,388,0,388,1
2020-08-12,Humboldt,023,135768,325,281,1,282,4
2020-08-12,Imperial,025,180216,10839,8566,7,8573,167
2020-08-12,Inyo,027,18085,127,97,2,99,1
2020-08-12,Kern,029,883053,27857,25191,157,25348,232
2020-08-12,Kings,031,150075,5630,4736,26,4762,50
2020-08-12,Lake,033,64148,283,253,0,253,2
2020-08-12,Lassen,035,31185,710,651,2,653,0
2020-08-12,Los Angeles,037,10098052,224057,214542,794,215336,5119
2020-08-12,Madera,039,155013,3424,2681,17,2698,23
2020-08-12,Marin,041,260295,5832,5423,12,5435,44
2020-08-12,Mariposa,043,17540,69,61,0,61,2
2020-08-12,Mendocino,045,87422,488,386,0,386,9
2020-08-12,Merced,047,269075,7070,5777,5,5782,66
2020-08-12,Modoc,049,8938,7,5,0,5,0
2020-08-12,Mono,051,14174,161,124,2,126,1
2020-08-12,Monterey,053,433212,6871,5919,19,5938,38
2020-08-12,Napa,055,140530,1327,1161,3,1164,10
2020-08-12,Nevada,057,99092,395,357,13,370,1
2020-08-12,Orange,059,3164182,47171,41576,984,42560,754
2020-08-12,Placer,061,380077,2721,2417,4,2421,25
2020-08-12,Plumas,063,18699,38,31,0,31,0
2020-08-12,Riverside,065,2383286,49681,44747,50,44797,867
2020-08-12,Sacramento,067,1510023,15637,12528,13,12541,189
2020-08-12,San Benito,069,59416,857,751,0,751,2
2020-08-12,San Bernardino,071,2135413,45089,38811,223,39034,589
2020-08-12,San Diego,073,3302833,35770,33395,139,33534,608
2020-08-12,San Francisco,075,870044,8483,7194,8,7202,66
2020-08-12,San Joaquin,077,732212,16700,14154,26,14180,253
2020-08-12,San Luis Obispo,079,281455,2683,2263,11,2274,15
2020-08-12,San Mateo,081,765935,7561,6427,7,6434,117
2020-08-12,Santa Barbara,083,443738,7544,7049,66,7115,74
2020-08-12,Santa Clara,085,1922200,15828,13002,33,13035,182
2020-08-12,Santa Cruz,087,273765,1585,1382,10,1392,6
2020-08-12,Shasta,089,179085,559,417,3,420,9
2020-08-12,Sierra,091,2930,5,4,0,4,0
2020-08-12,Siskiyou,093,43540,116,90,0,90,0
2020-08-12,Solano,095,438530,4904,4258,30,4288,31
2020-08-12,Sonoma,097,501317,4799,3847,14,3861,47
2020-08-12,Stanislaus,099,539301,13651,11682,158,11840,136
2020-08-12,Sutter,101,95872,1114,987,1,988,7
2020-08-12,Tehama,103,63373,338,289,2,291,1
2020-08-12,Trinity,105,12862,34,6,6,12,0
2020-08-12,Tulare,107,460477,13095,11460,38,11498,211
2020-08-12,Tuolumne,109,53932,169,150,4,154,1
2020-08-12,Ventura,111,848112,10044,9005,49,9054,87
2020-08-12,Yolo,113,214977,2171,1921,4,1925,44
2020-08-12,Yuba,115,75493,677,549,1,550,1
2020-08-11,Alameda,001,1643700,16006,13960,110,14070,204
2020-08-11,Alpine,003,1148,2,2,0,2,0
2020-08-11,Amador,005,37829,250,187,0,187,3
2020-08-11,Butte,007,227075,1478,1296,21,1317,15
2020-08-11,Calaveras,009,45235,186,161,0,161,1
2020-08-11,Colusa,011,21464,416,390,0,390,5
2020-08-11,Contra Costa,013,1133247,12392,10012,37,10049,131
2020-08-11,Del Norte,015,27424,100,73,0,73,0
2020-08-11,El Dorado,017,186661,905,786,5,791,2
2020-08-11,Fresno,019,978130,24594,18344,233,18577,187
2020-08-11,Glenn,021,27897,411,380,0,380,1
2020-08-11,Humboldt,023,135768,320,283,1,284,4
2020-08-11,Imperial,025,180216,10784,8518,7,8525,165
2020-08-11,Inyo,027,18085,122,97,2,99,1
2020-08-11,Kern,029,883053,27522,25042,155,25197,230
2020-08-11,Kings,031,150075,5439,4696,26,4722,50
2020-08-11,Lake,033,64148,280,243,0,243,2
2020-08-11,Lassen,035,31185,704,605,2,607,0
2020-08-11,Los Angeles,037,10098052,222556,212421,770,213191,5065
2020-08-11,Madera,039,155013,3370,2673,17,2690,22
2020-08-11,Marin,041,260295,5805,5287,11,5298,44
2020-08-11,Mariposa,043,17540,68,60,0,60,2
2020-08-11,Mendocino,045,87422,478,385,0,385,9
2020-08-11,Merced,047,269075,6975,5322,4,5326,65
2020-08-11,Modoc,049,8938,7,5,0,5,0
2020-08-11,Mono,051,14174,161,124,2,126,1
2020-08-11,Monterey,053,433212,6762,5624,19,5643,36
2020-08-11,Napa,055,140530,1316,1143,2,1145,11
2020-08-11,Nevada,057,99092,392,358,13,371,1
2020-08-11,Orange,059,3164182,46950,41205,963,42168,742
2020-08-11,Placer,061,380077,2689,2393,4,2397,24
2020-08-11,Plumas,063,18699,38,31,0,31,0
2020-08-11,Riverside,065,2383286,49324,44237,50,44287,836
2020-08-11,Sacramento,067,1510023,15346,12298,13,12311,182
2020-08-11,San Benito,069,59416,845,750,0,750,2
2020-08-11,San Bernardino,071,2135413,44749,38467,216,38683,584
2020-08-11,San Diego,073,3302833,35503,33159,120,33279,602
2020-08-11,San Francisco,075,870044,8387,6988,8,6996,66
2020-08-11,San Joaquin,077,732212,16522,13997,21,14018,251
2020-08-11,San Luis Obispo,079,281455,2626,2234,11,2245,15
2020-08-11,San Mateo,081,765935,7487,6339,7,6346,117
2020-08-11,Santa Barbara,083,443738,7495,6942,66,7008,70
2020-08-11,Santa Clara,085,1922200,15607,12920,33,12953,183
2020-08-11,Santa Cruz,087,273765,1562,1352,10,1362,4
2020-08-11,Shasta,089,179085,555,416,3,419,9
2020-08-11,Sierra,091,2930,5,4,0,4,0
2020-08-11,Siskiyou,093,43540,116,90,0,90,0
2020-08-11,Solano,095,438530,4856,4206,29,4235,31
2020-08-11,Sonoma,097,501317,4704,3752,14,3766,45
2020-08-11,Stanislaus,099,539301,13547,11592,146,11738,128
2020-08-11,Sutter,101,95872,1092,964,1,965,7
2020-08-11,Tehama,103,63373,334,289,2,291,1
2020-08-11,Trinity,105,12862,34,5,6,11,0
2020-08-11,Tulare,107,460477,12970,11392,37,11429,201
2020-08-11,Tuolumne,109,53932,164,146,4,150,1
2020-08-11,Ventura,111,848112,9976,8953,48,9001,88
2020-08-11,Yolo,113,214977,2149,1912,4,1916,44
2020-08-11,Yuba,115,75493,666,540,1,541,1
2020-08-10,Alameda,001,1643700,15766,13420,109,13529,203
2020-08-10,Alpine,003,1148,2,2,0,2,0
2020-08-10,Amador,005,37829,249,172,0,172,2
2020-08-10,Butte,007,227075,1454,1174,19,1193,15
2020-08-10,Calaveras,009,45235,175,121,0,121,1
2020-08-10,Colusa,011,21464,414,387,0,387,4
2020-08-10,Contra Costa,013,1133247,12239,9454,35,9489,130
2020-08-10,Del Norte,015,27424,98,69,0,69,0
2020-08-10,El Dorado,017,186661,893,771,5,776,2
2020-08-10,Fresno,019,978130,24313,17978,233,18211,183
2020-08-10,Glenn,021,27897,408,381,0,381,1
2020-08-10,Humboldt,023,135768,314,277,1,278,4
2020-08-10,Imperial,025,180216,10740,8465,7,8472,165
2020-08-10,Inyo,027,18085,122,97,2,99,1
2020-08-10,Kern,029,883053,27296,24499,154,24653,215
2020-08-10,Kings,031,150075,5333,4588,26,4614,50
2020-08-10,Lake,033,64148,273,239,0,239,2
2020-08-10,Lassen,035,31185,704,588,2,590,0
2020-08-10,Los Angeles,037,10098052,220979,211035,752,211787,5003
2020-08-10,Madera,039,155013,3337,2365,17,2382,22
2020-08-10,Marin,041,260295,5760,5242,10,5252,44
2020-08-10,Mariposa,043,17540,68,57,0,57,2
2020-08-10,Mendocino,045,87422,454,364,0,364,1
2020-08-10,Merced,047,269075,6894,4913,4,4917,51
2020-08-10,Modoc,049,8938,7,5,0,5,0
2020-08-10,Mono,051,14174,161,123,2,125,1
2020-08-10,Monterey,053,433212,6652,5358,19,5377,34
2020-08-10,Napa,055,140530,1298,1084,2,1086,8
2020-08-10,Nevada,057,99092,384,356,13,369,1
2020-08-10,Orange,059,3164182,46680,40445,945,41390,721
2020-08-10,Placer,061,380077,2650,2298,4,2302,21
2020-08-10,Plumas,063,18699,38,27,0,27,0
2020-08-10,Riverside,065,2383286,48939,43296,49,43345,830
2020-08-10,Sacramento,067,1510023,15035,12059,13,12072,168
2020-08-10,San Benito,069,59416,832,743,0,743,2
2020-08-10,San Bernardino,071,2135413,44372,37367,207,37574,579
2020-08-10,San Diego,073,3302833,35237,32977,104,33081,594
2020-08-10,San Francisco,075,870044,8297,6816,7,6823,66
2020-08-10,San Joaquin,077,732212,16340,13308,21,13329,240
2020-08-10,San Luis Obispo,079,281455,2527,2208,11,2219,15
2020-08-10,San Mateo,081,765935,7410,6222,7,6229,117
2020-08-10,Santa Barbara,083,443738,7440,6869,66,6935,66
2020-08-10,Santa Clara,085,1922200,15347,12615,32,12647,182
2020-08-10,Santa Cruz,087,273765,1542,1239,9,1248,4
2020-08-10,Shasta,089,179085,551,384,3,387,9
2020-08-10,Sierra,091,2930,5,3,0,3,0
2020-08-10,Siskiyou,093,43540,113,88,0,88,0
2020-08-10,Solano,095,438530,4796,4101,29,4130,31
2020-08-10,Sonoma,097,501317,4535,3640,10,3650,42
2020-08-10,Stanislaus,099,539301,13364,10855,130,10985,106
2020-08-10,Sutter,101,95872,1067,865,1,866,7
2020-08-10,Tehama,103,63373,327,282,2,284,1
2020-08-10,Trinity,105,12862,31,5,6,11,0
2020-08-10,Tulare,107,460477,12797,10750,35,10785,194
2020-08-10,Tuolumne,109,53932,164,143,3,146,1
2020-08-10,Ventura,111,848112,9892,8851,47,8898,85
2020-08-10,Yolo,113,214977,2126,1840,4,1844,45
2020-08-10,Yuba,115,75493,649,527,1,528,1
2020-08-09,Alameda,001,1643700,15485,13241,107,13348,203
2020-08-09,Alpine,003,1148,2,2,0,2,0
2020-08-09,Amador,005,37829,244,153,0,153,2
2020-08-09,Butte,007,227075,1411,1155,19,1174,15
2020-08-09,Calaveras,009,45235,170,122,0,122,1
2020-08-09,Colusa,011,21464,410,371,0,371,4
2020-08-09,Contra Costa,013,1133247,12012,9214,34,9248,130
2020-08-09,Del Norte,015,27424,98,69,0,69,0
2020-08-09,El Dorado,017,186661,885,748,5,753,2
2020-08-09,Fresno,019,978130,24004,17846,229,18075,183
2020-08-09,Glenn,021,27897,406,354,0,354,1
2020-08-09,Humboldt,023,135768,308,279,1,280,4
2020-08-09,Imperial,025,180216,10697,8310,6,8316,165
2020-08-09,Inyo,027,18085,117,86,1,87,1
2020-08-09,Kern,029,883053,27040,23680,154,23834,215
2020-08-09,Kings,031,150075,5290,4446,25,4471,50
2020-08-09,Lake,033,64148,266,225,0,225,2
2020-08-09,Lassen,035,31185,698,589,2,591,0
2020-08-09,Los Angeles,037,10098052,218917,208810,730,209540,4984
2020-08-09,Madera,039,155013,3278,2322,13,2335,22
2020-08-09,Marin,041,260295,5717,5204,10,5214,44
2020-08-09,Mariposa,043,17540,66,56,0,56,2
2020-08-09,Mendocino,045,87422,444,283,0,283,1
2020-08-09,Merced,047,269075,6797,4735,3,4738,51
2020-08-09,Modoc,049,8938,7,4,0,4,0
2020-08-09,Mono,051,14174,160,113,2,115,1
2020-08-09,Monterey,053,433212,6528,5199,19,5218,34
2020-08-09,Napa,055,140530,1279,1062,2,1064,8
2020-08-09,Nevada,057,99092,376,332,13,345,1
2020-08-09,Orange,059,3164182,46381,39244,930,40174,722
2020-08-09,Placer,061,380077,2621,2211,4,2215,20
2020-08-09,Plumas,063,18699,38,27,0,27,0
2020-08-09,Riverside,065,2383286,48594,41894,49,41943,828
2020-08-09,Sacramento,067,1510023,14755,11301,13,11314,167
2020-08-09,San Benito,069,59416,813,687,0,687,2
2020-08-09,San Bernardino,071,2135413,43893,36092,207,36299,579
2020-08-09,San Diego,073,3302833,34946,32749,93,32842,594
2020-08-09,San Francisco,075,870044,8182,6820,7,6827,66
2020-08-09,San Joaquin,077,732212,16136,12933,20,12953,240
2020-08-09,San Luis Obispo,079,281455,2491,2124,11,2135,15
2020-08-09,San Mateo,081,765935,7315,6094,7,6101,117
2020-08-09,Santa Barbara,083,443738,7352,6669,66,6735,66
2020-08-09,Santa Clara,085,1922200,15076,11878,32,11910,181
2020-08-09,Santa Cruz,087,273765,1518,1246,9,1255,4
2020-08-09,Shasta,089,179085,547,361,3,364,9
2020-08-09,Sierra,091,2930,5,3,0,3,0
2020-08-09,Siskiyou,093,43540,112,74,0,74,0
2020-08-09,Solano,095,438530,4743,3954,28,3982,31
2020-08-09,Sonoma,097,501317,4399,3531,8,3539,41
2020-08-09,Stanislaus,099,539301,13156,10264,117,10381,106
2020-08-09,Sutter,101,95872,1033,857,1,858,7
2020-08-09,Tehama,103,63373,319,265,2,267,1
2020-08-09,Trinity,105,12862,31,5,6,11,0
2020-08-09,Tulare,107,460477,12606,10630,32,10662,194
2020-08-09,Tuolumne,109,53932,161,143,3,146,1
2020-08-09,Ventura,111,848112,9744,8633,46,8679,85
2020-08-09,Yolo,113,214977,2095,1765,4,1769,44
2020-08-09,Yuba,115,75493,629,442,1,443,1
2020-08-08,Alameda,001,1643700,15375,13087,107,13194,204
2020-08-08,Alpine,003,1148,2,2,0,2,0
2020-08-08,Amador,005,37829,244,139,0,139,2
2020-08-08,Butte,007,227075,1393,1140,19,1159,15
2020-08-08,Calaveras,009,45235,169,122,0,122,1
2020-08-08,Colusa,011,21464,409,368,0,368,4
2020-08-08,Contra Costa,013,1133247,11903,9104,34,9138,129
2020-08-08,Del Norte,015,27424,97,69,0,69,0
2020-08-08,El Dorado,017,186661,878,734,5,739,2
2020-08-08,Fresno,019,978130,23867,17538,227,17765,183
2020-08-08,Glenn,021,27897,406,344,0,344,1
2020-08-08,Humboldt,023,135768,305,277,1,278,4
2020-08-08,Imperial,025,180216,10682,8213,6,8219,165
2020-08-08,Inyo,027,18085,113,86,1,87,1
2020-08-08,Kern,029,883053,26926,22803,154,22957,215
2020-08-08,Kings,031,150075,5276,4367,25,4392,49
2020-08-08,Lake,033,64148,264,221,0,221,2
2020-08-08,Lassen,035,31185,698,589,2,591,0
2020-08-08,Los Angeles,037,10098052,218032,206971,719,207690,4974
2020-08-08,Madera,039,155013,3247,2275,13,2288,22
2020-08-08,Marin,041,260295,5697,5118,10,5128,44
2020-08-08,Mariposa,043,17540,65,55,0,55,2
2020-08-08,Mendocino,045,87422,442,264,0,264,1
2020-08-08,Merced,047,269075,6757,4570,3,4573,51
2020-08-08,Modoc,049,8938,7,4,0,4,0
2020-08-08,Mono,051,14174,160,113,2,115,1
2020-08-08,Monterey,053,433212,6470,5101,19,5120,33
2020-08-08,Napa,055,140530,1271,1062,2,1064,8
2020-08-08,Nevada,057,99092,374,325,13,338,1
2020-08-08,Orange,059,3164182,46251,38688,921,39609,718
2020-08-08,Placer,061,380077,2604,2153,4,2157,20
2020-08-08,Plumas,063,18699,38,27,0,27,0
2020-08-08,Riverside,065,2383286,48390,41412,49,41461,823
2020-08-08,Sacramento,067,1510023,14626,11144,13,11157,166
2020-08-08,San Benito,069,59416,805,684,0,684,2
2020-08-08,San Bernardino,071,2135413,43698,35691,206,35897,531
2020-08-08,San Diego,073,3302833,34757,32332,84,32416,593
2020-08-08,San Francisco,075,870044,8116,6820,7,6827,66
2020-08-08,San Joaquin,077,732212,16055,12559,19,12578,240
2020-08-08,San Luis Obispo,079,281455,2468,2081,11,2092,15
2020-08-08,San Mateo,081,765935,7257,6021,7,6028,117
2020-08-08,Santa Barbara,083,443738,7314,6598,66,6664,66
2020-08-08,Santa Clara,085,1922200,14924,11615,32,11647,181
2020-08-08,Santa Cruz,087,273765,1504,1247,9,1256,4
2020-08-08,Shasta,089,179085,545,343,3,346,9
2020-08-08,Sierra,091,2930,5,3,0,3,0
2020-08-08,Siskiyou,093,43540,112,73,0,73,0
2020-08-08,Solano,095,438530,4722,3889,27,3916,31
2020-08-08,Sonoma,097,501317,4368,3399,8,3407,41
2020-08-08,Stanislaus,099,539301,13081,9963,112,10075,105
2020-08-08,Sutter,101,95872,1023,830,1,831,7
2020-08-08,Tehama,103,63373,318,251,2,253,1
2020-08-08,Trinity,105,12862,31,5,6,11,0
2020-08-08,Tulare,107,460477,12531,10505,32,10537,192
2020-08-08,Tuolumne,109,53932,161,143,3,146,1
2020-08-08,Ventura,111,848112,9689,8462,45,8507,85
2020-08-08,Yolo,113,214977,2082,1725,4,1729,44
2020-08-08,Yuba,115,75493,620,430,1,431,1
2020-08-07,Alameda,001,1643700,15265,12805,107,12912,204
2020-08-07,Alpine,003,1148,2,2,0,2,0
2020-08-07,Amador,005,37829,242,125,0,125,2
2020-08-07,Butte,007,227075,1375,1092,19,1111,13
2020-08-07,Calaveras,009,45235,169,119,0,119,1
2020-08-07,Colusa,011,21464,408,358,0,358,4
2020-08-07,Contra Costa,013,1133247,11755,8810,34,8844,126
2020-08-07,Del Norte,015,27424,97,69,0,69,0
2020-08-07,El Dorado,017,186661,873,724,5,729,2
2020-08-07,Fresno,019,978130,23707,17290,227,17517,171
2020-08-07,Glenn,021,27897,405,339,0,339,1
2020-08-07,Humboldt,023,135768,301,274,1,275,4
2020-08-07,Imperial,025,180216,10657,8085,6,8091,164
2020-08-07,Inyo,027,18085,112,81,1,82,1
2020-08-07,Kern,029,883053,26800,22143,152,22295,206
2020-08-07,Kings,031,150075,5259,4315,25,4340,48
2020-08-07,Lake,033,64148,262,215,0,215,1
2020-08-07,Lassen,035,31185,697,588,2,590,0
2020-08-07,Los Angeles,037,10098052,216566,204406,708,205114,4924
2020-08-07,Madera,039,155013,3215,2245,13,2258,20
2020-08-07,Marin,041,260295,5668,5094,10,5104,43
2020-08-07,Mariposa,043,17540,65,53,0,53,2
2020-08-07,Mendocino,045,87422,428,262,0,262,1
2020-08-07,Merced,047,269075,6714,4358,3,4361,30
2020-08-07,Modoc,049,8938,7,4,0,4,0
2020-08-07,Mono,051,14174,160,112,2,114,1
2020-08-07,Monterey,053,433212,6395,5041,19,5060,33
2020-08-07,Napa,055,140530,1266,1055,2,1057,8
2020-08-07,Nevada,057,99092,371,324,13,337,1
2020-08-07,Orange,059,3164182,46040,38459,904,39363,701
2020-08-07,Placer,061,380077,2586,2078,4,2082,20
2020-08-07,Plumas,063,18699,38,25,0,25,0
2020-08-07,Riverside,065,2383286,48126,40902,48,40950,810
2020-08-07,Sacramento,067,1510023,14481,10798,13,10811,160
2020-08-07,San Benito,069,59416,799,647,0,647,2
2020-08-07,San Bernardino,071,2135413,43451,35200,205,35405,524
2020-08-07,San Diego,073,3302833,34572,31781,81,31862,586
2020-08-07,San Francisco,075,870044,8038,6765,7,6772,66
2020-08-07,San Joaquin,077,732212,15970,12392,19,12411,223
2020-08-07,San Luis Obispo,079,281455,2437,2050,11,2061,14
2020-08-07,San Mateo,081,765935,7197,5948,7,5955,117
2020-08-07,Santa Barbara,083,443738,7263,6509,66,6575,66
2020-08-07,Santa Clara,085,1922200,14725,11409,32,11441,180
2020-08-07,Santa Cruz,087,273765,1486,1234,9,1243,5
2020-08-07,Shasta,089,179085,540,342,3,345,9
2020-08-07,Sierra,091,2930,5,3,0,3,0
2020-08-07,Siskiyou,093,43540,109,73,0,73,0
2020-08-07,Solano,095,438530,4690,3844,26,3870,31
2020-08-07,Sonoma,097,501317,4304,3329,8,3337,34
2020-08-07,Stanislaus,099,539301,12959,9665,102,9767,98
2020-08-07,Sutter,101,95872,1019,807,1,808,6
2020-08-07,Tehama,103,63373,314,246,2,248,1
2020-08-07,Trinity,105,12862,30,5,6,11,0
2020-08-07,Tulare,107,460477,12454,10292,32,10324,195
2020-08-07,Tuolumne,109,53932,160,136,3,139,1
2020-08-07,Ventura,111,848112,9629,8356,43,8399,84
2020-08-07,Yolo,113,214977,2055,1689,4,1693,37
2020-08-07,Yuba,115,75493,615,413,1,414,1
2020-08-06,Alameda,001,1643700,15044,12474,106,12580,200
2020-08-06,Alpine,003,1148,2,2,0,2,0
2020-08-06,Amador,005,37829,228,125,0,125,0
2020-08-06,Butte,007,227075,1356,1060,19,1079,13
2020-08-06,Calaveras,009,45235,166,117,0,117,1
2020-08-06,Colusa,011,21464,405,358,0,358,3
2020-08-06,Contra Costa,013,1133247,11561,8583,33,8616,124
2020-08-06,Del Norte,015,27424,97,69,0,69,0
2020-08-06,El Dorado,017,186661,862,703,5,708,1
2020-08-06,Fresno,019,978130,23409,17031,220,17251,161
2020-08-06,Glenn,021,27897,400,332,0,332,1
2020-08-06,Humboldt,023,135768,296,266,1,267,4
2020-08-06,Imperial,025,180216,10614,8064,6,8070,163
2020-08-06,Inyo,027,18085,104,83,1,84,1
2020-08-06,Kern,029,883053,26564,21843,151,21994,197
2020-08-06,Kings,031,150075,5197,4264,24,4288,47
2020-08-06,Lake,033,64148,259,209,0,209,1
2020-08-06,Lassen,035,31185,695,588,2,590,0
2020-08-06,Los Angeles,037,10098052,214493,201372,692,202064,4874
2020-08-06,Madera,039,155013,3167,2240,12,2252,19
2020-08-06,Marin,041,260295,5636,5058,10,5068,43
2020-08-06,Mariposa,043,17540,64,52,0,52,2
2020-08-06,Mendocino,045,87422,414,260,0,260,1
2020-08-06,Merced,047,269075,6612,4235,3,4238,30
2020-08-06,Modoc,049,8938,7,4,0,4,0
2020-08-06,Mono,051,14174,159,111,2,113,1
2020-08-06,Monterey,053,433212,6286,5001,18,5019,33
2020-08-06,Napa,055,140530,1252,1032,2,1034,8
2020-08-06,Nevada,057,99092,366,321,13,334,1
2020-08-06,Orange,059,3164182,45748,38399,899,39298,694
2020-08-06,Placer,061,380077,2560,2045,4,2049,20
2020-08-06,Plumas,063,18699,37,25,0,25,0
2020-08-06,Riverside,065,2383286,47732,40269,48,40317,781
2020-08-06,Sacramento,067,1510023,14252,10548,13,10561,153
2020-08-06,San Benito,069,59416,791,626,0,626,2
2020-08-06,San Bernardino,071,2135413,43046,34819,203,35022,516
2020-08-06,San Diego,073,3302833,34305,31129,74,31203,583
2020-08-06,San Francisco,075,870044,7945,6737,6,6743,60
2020-08-06,San Joaquin,077,732212,15810,12269,19,12288,203
2020-08-06,San Luis Obispo,079,281455,2413,2000,10,2010,13
2020-08-06,San Mateo,081,765935,7097,5885,7,5892,117
2020-08-06,Santa Barbara,083,443738,7203,6620,66,6686,65
2020-08-06,Santa Clara,085,1922200,14496,11280,32,11312,178
2020-08-06,Santa Cruz,087,273765,1465,1215,9,1224,4
2020-08-06,Shasta,089,179085,531,343,3,346,9
2020-08-06,Sierra,091,2930,5,3,0,3,0
2020-08-06,Siskiyou,093,43540,109,73,0,73,0
2020-08-06,Solano,095,438530,4646,3784,26,3810,29
2020-08-06,Sonoma,097,501317,4240,3259,8,3267,33
2020-08-06,Stanislaus,099,539301,12809,9566,86,9652,98
2020-08-06,Sutter,101,95872,988,797,1,798,6
2020-08-06,Tehama,103,63373,311,242,2,244,1
2020-08-06,Trinity,105,12862,27,5,6,11,0
2020-08-06,Tulare,107,460477,12294,10169,32,10201,195
2020-08-06,Tuolumne,109,53932,159,136,3,139,1
2020-08-06,Ventura,111,848112,9514,8245,40,8285,80
2020-08-06,Yolo,113,214977,2031,1662,4,1666,36
2020-08-06,Yuba,115,75493,606,407,0,407,1
2020-08-05,Alameda,001,1643700,14829,12140,106,12246,193
2020-08-05,Alpine,003,1148,2,2,0,2,0
2020-08-05,Amador,005,37829,218,123,0,123,0
2020-08-05,Butte,007,227075,1322,1038,18,1056,13
2020-08-05,Calaveras,009,45235,163,116,0,116,1
2020-08-05,Colusa,011,21464,401,354,0,354,3
2020-08-05,Contra Costa,013,1133247,11392,8362,33,8395,122
2020-08-05,Del Norte,015,27424,96,69,0,69,0
2020-08-05,El Dorado,017,186661,854,692,5,697,1
2020-08-05,Fresno,019,978130,23165,16625,215,16840,159
2020-08-05,Glenn,021,27897,397,330,0,330,1
2020-08-05,Humboldt,023,135768,294,249,1,250,4
2020-08-05,Imperial,025,180216,10579,8036,6,8042,163
2020-08-05,Inyo,027,18085,102,62,1,63,1
2020-08-05,Kern,029,883053,26376,21540,146,21686,194
2020-08-05,Kings,031,150075,5152,4192,23,4215,47
2020-08-05,Lake,033,64148,252,209,0,209,1
2020-08-05,Lassen,035,31185,648,557,2,559,0
2020-08-05,Los Angeles,037,10098052,212572,198355,672,199027,4832
2020-08-05,Madera,039,155013,3125,2172,12,2184,19
2020-08-05,Marin,041,260295,5604,5036,10,5046,43
2020-08-05,Mariposa,043,17540,64,52,0,52,2
2020-08-05,Mendocino,045,87422,402,248,0,248,1
2020-08-05,Merced,047,269075,6477,4119,3,4122,30
2020-08-05,Modoc,049,8938,7,3,0,3,0
2020-08-05,Mono,051,14174,159,104,2,106,1
2020-08-05,Monterey,053,433212,6171,4936,18,4954,32
2020-08-05,Napa,055,140530,1240,1020,2,1022,8
2020-08-05,Nevada,057,99092,357,327,13,340,2
2020-08-05,Orange,059,3164182,45439,37907,891,38798,663
2020-08-05,Placer,061,380077,2519,1989,4,1993,18
2020-08-05,Plumas,063,18699,36,25,0,25,0
2020-08-05,Riverside,065,2383286,47340,39454,46,39500,761
2020-08-05,Sacramento,067,1510023,14033,10261,12,10273,151
2020-08-05,San Benito,069,59416,782,613,0,613,2
2020-08-05,San Bernardino,071,2135413,42584,34442,198,34640,504
2020-08-05,San Diego,073,3302833,34081,30866,58,30924,578
2020-08-05,San Francisco,075,870044,7852,6701,6,6707,60
2020-08-05,San Joaquin,077,732212,15647,12148,19,12167,199
2020-08-05,San Luis Obispo,079,281455,2389,1928,10,1938,13
2020-08-05,San Mateo,081,765935,7002,5695,7,5702,116
2020-08-05,Santa Barbara,083,443738,7143,6597,66,6663,63
2020-08-05,Santa Clara,085,1922200,14262,11074,32,11106,176
2020-08-05,Santa Cruz,087,273765,1445,1192,7,1199,4
2020-08-05,Shasta,089,179085,525,338,3,341,9
2020-08-05,Sierra,091,2930,5,3,0,3,0
2020-08-05,Siskiyou,093,43540,105,72,0,72,0
2020-08-05,Solano,095,438530,4595,3750,25,3775,29
2020-08-05,Sonoma,097,501317,4157,3173,8,3181,33
2020-08-05,Stanislaus,099,539301,12650,9408,81,9489,97
2020-08-05,Sutter,101,95872,977,780,1,781,6
2020-08-05,Tehama,103,63373,308,231,2,233,1
2020-08-05,Trinity,105,12862,27,5,6,11,0
2020-08-05,Tulare,107,460477,12153,9924,32,9956,192
2020-08-05,Tuolumne,109,53932,159,137,3,140,0
2020-08-05,Ventura,111,848112,9398,8162,36,8198,75
2020-08-05,Yolo,113,214977,2003,1634,4,1638,36
2020-08-05,Yuba,115,75493,589,400,0,400,1
2020-08-04,Alameda,001,1643700,14612,11983,105,12088,192
2020-08-04,Alpine,003,1148,2,2,0,2,0
2020-08-04,Amador,005,37829,203,123,0,123,0
2020-08-04,Butte,007,227075,1298,1011,18,1029,10
2020-08-04,Calaveras,009,45235,159,116,0,116,1
2020-08-04,Colusa,011,21464,396,354,0,354,3
2020-08-04,Contra Costa,013,1133247,11225,8210,33,8243,122
2020-08-04,Del Norte,015,27424,94,69,0,69,0
2020-08-04,El Dorado,017,186661,844,668,5,673,1
2020-08-04,Fresno,019,978130,22880,16272,208,16480,154
2020-08-04,Glenn,021,27897,396,325,0,325,1
2020-08-04,Humboldt,023,135768,284,241,1,242,4
2020-08-04,Imperial,025,180216,10542,7974,6,7980,163
2020-08-04,Inyo,027,18085,88,59,1,60,1
2020-08-04,Kern,029,883053,26093,21403,146,21549,190
2020-08-04,Kings,031,150075,5087,4163,23,4186,47
2020-08-04,Lake,033,64148,252,206,0,206,1
2020-08-04,Lassen,035,31185,645,556,2,558,0
2020-08-04,Los Angeles,037,10098052,210632,196014,645,196659,4764
2020-08-04,Madera,039,155013,3082,2161,8,2169,19
2020-08-04,Marin,041,260295,5573,5020,9,5029,43
2020-08-04,Mariposa,043,17540,64,51,0,51,2
2020-08-04,Mendocino,045,87422,377,248,0,248,1
2020-08-04,Merced,047,269075,6363,4085,3,4088,30
2020-08-04,Modoc,049,8938,7,3,0,3,0
2020-08-04,Mono,051,14174,158,104,1,105,1
2020-08-04,Monterey,053,433212,6057,4892,18,4910,32
2020-08-04,Napa,055,140530,1227,994,0,994,8
2020-08-04,Nevada,057,99092,356,322,13,335,2
2020-08-04,Orange,059,3164182,45063,37844,885,38729,659
2020-08-04,Placer,061,380077,2482,1964,4,1968,17
2020-08-04,Plumas,063,18699,36,25,0,25,0
2020-08-04,Riverside,065,2383286,46955,38991,45,39036,743
2020-08-04,Sacramento,067,1510023,13815,10205,12,10217,146
2020-08-04,San Benito,069,59416,766,608,0,608,2
2020-08-04,San Bernardino,071,2135413,42034,34215,193,34408,495
2020-08-04,San Diego,073,3302833,33788,30518,46,30564,568
2020-08-04,San Francisco,075,870044,7764,6568,6,6574,60
2020-08-04,San Joaquin,077,732212,15518,12087,16,12103,189
2020-08-04,San Luis Obispo,079,281455,2359,1886,10,1896,13
2020-08-04,San Mateo,081,765935,6896,5690,7,5697,116
2020-08-04,Santa Barbara,083,443738,7083,6591,66,6657,61
2020-08-04,Santa Clara,085,1922200,13960,10986,31,11017,175
2020-08-04,Santa Cruz,087,273765,1426,1202,7,1209,4
2020-08-04,Shasta,089,179085,519,335,3,338,9
2020-08-04,Sierra,091,2930,5,1,0,1,0
2020-08-04,Siskiyou,093,43540,103,71,0,71,0
2020-08-04,Solano,095,438530,4524,3690,25,3715,29
2020-08-04,Sonoma,097,501317,4090,3108,8,3116,33
2020-08-04,Stanislaus,099,539301,12481,9359,74,9433,97
2020-08-04,Sutter,101,95872,963,761,1,762,6
2020-08-04,Tehama,103,63373,301,226,2,228,1
2020-08-04,Trinity,105,12862,27,5,6,11,0
2020-08-04,Tulare,107,460477,11973,9866,32,9898,192
2020-08-04,Tuolumne,109,53932,158,127,3,130,0
2020-08-04,Ventura,111,848112,9284,8134,34,8168,75
2020-08-04,Yolo,113,214977,1977,1626,4,1630,37
2020-08-04,Yuba,115,75493,574,398,0,398,1
2020-08-03,Alameda,001,1643700,14430,11817,102,11919,189
2020-08-03,Alpine,003,1148,2,2,0,2,0
2020-08-03,Amador,005,37829,199,119,0,119,0
2020-08-03,Butte,007,227075,1252,989,17,1006,9
2020-08-03,Calaveras,009,45235,156,117,0,117,1
2020-08-03,Colusa,011,21464,392,336,0,336,2
2020-08-03,Contra Costa,013,1133247,11028,8069,30,8099,120
2020-08-03,Del Norte,015,27424,90,68,0,68,0
2020-08-03,El Dorado,017,186661,833,645,5,650,1
2020-08-03,Fresno,019,978130,22586,15945,202,16147,151
2020-08-03,Glenn,021,27897,389,316,0,316,1
2020-08-03,Humboldt,023,135768,277,234,1,235,4
2020-08-03,Imperial,025,180216,10487,7953,6,7959,161
2020-08-03,Inyo,027,18085,85,57,1,58,1
2020-08-03,Kern,029,883053,25726,21285,139,21424,176
2020-08-03,Kings,031,150075,4975,4107,22,4129,47
2020-08-03,Lake,033,64148,245,201,0,201,1
2020-08-03,Lassen,035,31185,645,555,2,557,0
2020-08-03,Los Angeles,037,10098052,208593,194103,617,194720,4706
2020-08-03,Madera,039,155013,3033,2143,7,2150,18
2020-08-03,Marin,041,260295,5526,5001,9,5010,43
2020-08-03,Mariposa,043,17540,63,52,0,52,2
2020-08-03,Mendocino,045,87422,354,248,0,248,1
2020-08-03,Merced,047,269075,6241,4028,3,4031,29
2020-08-03,Modoc,049,8938,7,2,0,2,0
2020-08-03,Mono,051,14174,158,104,1,105,1
2020-08-03,Monterey,053,433212,5906,4806,15,4821,28
2020-08-03,Napa,055,140530,1213,973,0,973,8
2020-08-03,Nevada,057,99092,352,315,13,328,2
2020-08-03,Orange,059,3164182,44669,37705,875,38580,651
2020-08-03,Placer,061,380077,2426,1947,3,1950,16
2020-08-03,Plumas,063,18699,36,25,0,25,0
2020-08-03,Riverside,065,2383286,46487,38642,45,38687,740
2020-08-03,Sacramento,067,1510023,13620,10143,12,10155,142
2020-08-03,San Benito,069,59416,754,603,0,603,2
2020-08-03,San Bernardino,071,2135413,41509,33979,187,34166,444
2020-08-03,San Diego,073,3302833,33474,30228,36,30264,565
2020-08-03,San Francisco,075,870044,7670,6319,6,6325,60
2020-08-03,San Joaquin,077,732212,15322,12007,15,12022,189
2020-08-03,San Luis Obispo,079,281455,2317,1863,8,1871,14
2020-08-03,San Mateo,081,765935,6815,5661,7,5668,115
2020-08-03,Santa Barbara,083,443738,7039,6580,66,6646,59
2020-08-03,Santa Clara,085,1922200,13684,10747,31,10778,172
2020-08-03,Santa Cruz,087,273765,1406,1154,7,1161,4
2020-08-03,Shasta,089,179085,512,322,3,325,9
2020-08-03,Sierra,091,2930,5,1,0,1,0
2020-08-03,Siskiyou,093,43540,99,67,0,67,0
2020-08-03,Solano,095,438530,4455,3610,24,3634,29
2020-08-03,Sonoma,097,501317,3989,3079,7,3086,33
2020-08-03,Stanislaus,099,539301,12272,9308,66,9374,96
2020-08-03,Sutter,101,95872,939,713,1,714,6
2020-08-03,Tehama,103,63373,293,225,2,227,1
2020-08-03,Trinity,105,12862,27,5,6,11,0
2020-08-03,Tulare,107,460477,11789,9703,32,9735,188
2020-08-03,Tuolumne,109,53932,158,123,3,126,0
2020-08-03,Ventura,111,848112,9193,8084,31,8115,74
2020-08-03,Yolo,113,214977,1942,1598,3,1601,37
2020-08-03,Yuba,115,75493,550,393,0,393,1
2020-08-02,Alameda,001,1643700,14183,11696,90,11786,188
2020-08-02,Alpine,003,1148,2,2,0,2,0
2020-08-02,Amador,005,37829,194,117,0,117,0
2020-08-02,Butte,007,227075,1217,987,17,1004,9
2020-08-02,Calaveras,009,45235,153,116,0,116,1
2020-08-02,Colusa,011,21464,387,335,0,335,2
2020-08-02,Contra Costa,013,1133247,10789,7995,30,8025,118
2020-08-02,Del Norte,015,27424,89,68,0,68,0
2020-08-02,El Dorado,017,186661,823,643,5,648,1
2020-08-02,Fresno,019,978130,22311,15759,196,15955,151
2020-08-02,Glenn,021,27897,388,315,0,315,1
2020-08-02,Humboldt,023,135768,272,232,1,233,4
2020-08-02,Imperial,025,180216,10424,7919,6,7925,157
2020-08-02,Inyo,027,18085,84,45,1,46,1
2020-08-02,Kern,029,883053,25428,21162,137,21299,176
2020-08-02,Kings,031,150075,4913,3964,21,3985,47
2020-08-02,Lake,033,64148,240,201,0,201,1
2020-08-02,Lassen,035,31185,645,555,2,557,0
2020-08-02,Los Angeles,037,10098052,206501,192480,599,193079,4698
2020-08-02,Madera,039,155013,2967,2123,5,2128,18
2020-08-02,Marin,041,260295,5491,4985,9,4994,43
2020-08-02,Mariposa,043,17540,61,52,0,52,2
2020-08-02,Mendocino,045,87422,344,247,0,247,1
2020-08-02,Merced,047,269075,6100,4011,3,4014,29
2020-08-02,Modoc,049,8938,7,2,0,2,0
2020-08-02,Mono,051,14174,151,104,1,105,1
2020-08-02,Monterey,053,433212,5780,4698,15,4713,28
2020-08-02,Napa,055,140530,1198,956,0,956,8
2020-08-02,Nevada,057,99092,349,314,13,327,2
2020-08-02,Orange,059,3164182,44288,37266,864,38130,651
2020-08-02,Placer,061,380077,2387,1920,3,1923,15
2020-08-02,Plumas,063,18699,36,25,0,25,0
2020-08-02,Riverside,065,2383286,46054,38507,44,38551,735
2020-08-02,Sacramento,067,1510023,13341,10099,12,10111,142
2020-08-02,San Benito,069,59416,740,599,0,599,2
2020-08-02,San Bernardino,071,2135413,40907,33643,183,33826,443
2020-08-02,San Diego,073,3302833,33134,29885,27,29912,565
2020-08-02,San Francisco,075,870044,7552,6297,6,6303,60
2020-08-02,San Joaquin,077,732212,15038,11937,13,11950,189
2020-08-02,San Luis Obispo,079,281455,2254,1821,8,1829,14
2020-08-02,San Mateo,081,765935,6700,5618,7,5625,115
2020-08-02,Santa Barbara,083,443738,6949,6532,66,6598,59
2020-08-02,Santa Clara,085,1922200,13465,10577,31,10608,172
2020-08-02,Santa Cruz,087,273765,1386,1162,7,1169,4
2020-08-02,Shasta,089,179085,508,318,3,321,9
2020-08-02,Sierra,091,2930,4,1,0,1,0
2020-08-02,Siskiyou,093,43540,99,65,0,65,0
2020-08-02,Solano,095,438530,4397,3609,24,3633,29
2020-08-02,Sonoma,097,501317,3904,3005,7,3012,33
2020-08-02,Stanislaus,099,539301,12057,9277,61,9338,96
2020-08-02,Sutter,101,95872,904,714,1,715,6
2020-08-02,Tehama,103,63373,287,222,2,224,1
2020-08-02,Trinity,105,12862,27,5,6,11,0
2020-08-02,Tulare,107,460477,11580,9593,32,9625,188
2020-08-02,Tuolumne,109,53932,155,123,3,126,0
2020-08-02,Ventura,111,848112,9046,8014,31,8045,73
2020-08-02,Yolo,113,214977,1917,1588,3,1591,37
2020-08-02,Yuba,115,75493,530,393,0,393,1
2020-08-01,Alameda,001,1643700,14071,11590,90,11680,188
2020-08-01,Alpine,003,1148,2,2,0,2,0
2020-08-01,Amador,005,37829,190,109,0,109,0
2020-08-01,Butte,007,227075,1203,976,17,993,9
2020-08-01,Calaveras,009,45235,149,116,0,116,1
2020-08-01,Colusa,011,21464,386,327,0,327,2
2020-08-01,Contra Costa,013,1133247,10656,7867,29,7896,116
2020-08-01,Del Norte,015,27424,89,68,0,68,0
2020-08-01,El Dorado,017,186661,820,637,5,642,1
2020-08-01,Fresno,019,978130,22174,15448,196,15644,149
2020-08-01,Glenn,021,27897,387,311,0,311,1
2020-08-01,Humboldt,023,135768,271,232,1,233,4
2020-08-01,Imperial,025,180216,10388,7919,6,7925,156
2020-08-01,Inyo,027,18085,82,45,1,46,1
2020-08-01,Kern,029,883053,25270,20796,133,20929,176
2020-08-01,Kings,031,150075,4887,3948,21,3969,47
2020-08-01,Lake,033,64148,238,194,0,194,1
2020-08-01,Lassen,035,31185,644,555,2,557,0
2020-08-01,Los Angeles,037,10098052,205609,191023,572,191595,4674
2020-08-01,Madera,039,155013,2928,2103,5,2108,18
2020-08-01,Marin,041,260295,5476,4945,9,4954,43
2020-08-01,Mariposa,043,17540,61,50,0,50,2
2020-08-01,Mendocino,045,87422,337,243,0,243,1
2020-08-01,Merced,047,269075,6052,3972,3,3975,29
2020-08-01,Modoc,049,8938,7,2,0,2,0
2020-08-01,Mono,051,14174,150,104,1,105,1
2020-08-01,Monterey,053,433212,5713,4611,14,4625,28
2020-08-01,Napa,055,140530,1189,923,0,923,8
2020-08-01,Nevada,057,99092,345,305,13,318,2
2020-08-01,Orange,059,3164182,44061,36703,858,37561,648
2020-08-01,Placer,061,380077,2353,1891,3,1894,14
2020-08-01,Plumas,063,18699,35,25,0,25,0
2020-08-01,Riverside,065,2383286,45842,38216,42,38258,704
2020-08-01,Sacramento,067,1510023,13190,10044,12,10056,141
2020-08-01,San Benito,069,59416,729,579,0,579,2
2020-08-01,San Bernardino,071,2135413,40671,32947,182,33129,440
2020-08-01,San Diego,073,3302833,32917,29579,19,29598,565
2020-08-01,San Francisco,075,870044,7491,6296,6,6302,60
2020-08-01,San Joaquin,077,732212,14964,11807,12,11819,189
2020-08-01,San Luis Obispo,079,281455,2225,1798,8,1806,13
2020-08-01,San Mateo,081,765935,6646,5520,7,5527,115
2020-08-01,Santa Barbara,083,443738,6909,6465,66,6531,59
2020-08-01,Santa Clara,085,1922200,13314,10281,30,10311,171
2020-08-01,Santa Cruz,087,273765,1370,1164,7,1171,4
2020-08-01,Shasta,089,179085,503,312,3,315,9
2020-08-01,Sierra,091,2930,3,1,0,1,0
2020-08-01,Siskiyou,093,43540,99,64,0,64,0
2020-08-01,Solano,095,438530,4363,3591,23,3614,29
2020-08-01,Sonoma,097,501317,3858,2890,7,2897,29
2020-08-01,Stanislaus,099,539301,11939,9221,54,9275,96
2020-08-01,Sutter,101,95872,900,714,1,715,6
2020-08-01,Tehama,103,63373,284,220,2,222,1
2020-08-01,Trinity,105,12862,27,5,6,11,0
2020-08-01,Tulare,107,460477,11512,9520,32,9552,188
2020-08-01,Tuolumne,109,53932,155,123,3,126,0
2020-08-01,Ventura,111,848112,9000,7819,31,7850,73
2020-08-01,Yolo,113,214977,1907,1557,3,1560,37
2020-08-01,Yuba,115,75493,525,387,0,387,1
2020-07-31,Alameda,001,1643700,13942,11441,90,11531,187
2020-07-31,Alpine,003,1148,2,2,0,2,0
2020-07-31,Amador,005,37829,189,98,0,98,0
2020-07-31,Butte,007,227075,1180,925,17,942,7
2020-07-31,Calaveras,009,45235,149,112,0,112,1
2020-07-31,Colusa,011,21464,376,319,0,319,2
2020-07-31,Contra Costa,013,1133247,10508,7697,28,7725,113
2020-07-31,Del Norte,015,27424,88,68,0,68,0
2020-07-31,El Dorado,017,186661,809,616,5,621,1
2020-07-31,Fresno,019,978130,21954,15083,196,15279,133
2020-07-31,Glenn,021,27897,380,304,0,304,1
2020-07-31,Humboldt,023,135768,264,229,1,230,4
2020-07-31,Imperial,025,180216,10356,7886,5,7891,155
2020-07-31,Inyo,027,18085,72,45,1,46,1
2020-07-31,Kern,029,883053,25029,20061,129,20190,173
2020-07-31,Kings,031,150075,4859,3807,21,3828,45
2020-07-31,Lake,033,64148,237,191,0,191,1
2020-07-31,Lassen,035,31185,639,544,2,546,0
2020-07-31,Los Angeles,037,10098052,204011,188688,559,189247,4628
2020-07-31,Madera,039,155013,2881,2036,5,2041,19
2020-07-31,Marin,041,260295,5432,4885,6,4891,43
2020-07-31,Mariposa,043,17540,61,49,0,49,2
2020-07-31,Mendocino,045,87422,322,232,0,232,1
2020-07-31,Merced,047,269075,5969,3789,3,3792,30
2020-07-31,Modoc,049,8938,6,0,0,0,0
2020-07-31,Mono,051,14174,149,104,1,105,1
2020-07-31,Monterey,053,433212,5621,4493,14,4507,24
2020-07-31,Napa,055,140530,1177,897,0,897,7
2020-07-31,Nevada,057,99092,343,302,13,315,2
2020-07-31,Orange,059,3164182,43762,36196,841,37037,620
2020-07-31,Placer,061,380077,2328,1853,3,1856,14
2020-07-31,Plumas,063,18699,34,25,0,25,0
2020-07-31,Riverside,065,2383286,45452,37612,41,37653,694
2020-07-31,Sacramento,067,1510023,13012,9872,12,9884,132
2020-07-31,San Benito,069,59416,721,567,0,567,2
2020-07-31,San Bernardino,071,2135413,40341,32332,181,32513,434
2020-07-31,San Diego,073,3302833,32683,29050,11,29061,561
2020-07-31,San Francisco,075,870044,7392,6126,6,6132,60
2020-07-31,San Joaquin,077,732212,14824,11561,12,11573,177
2020-07-31,San Luis Obispo,079,281455,2156,1746,8,1754,12
2020-07-31,San Mateo,081,765935,6574,5416,7,5423,115
2020-07-31,Santa Barbara,083,443738,6842,6375,66,6441,58
2020-07-31,Santa Clara,085,1922200,13093,9863,30,9893,171
2020-07-31,Santa Cruz,087,273765,1347,1118,7,1125,4
2020-07-31,Shasta,089,179085,493,305,3,308,9
2020-07-31,Sierra,091,2930,3,1,0,1,0
2020-07-31,Siskiyou,093,43540,97,61,0,61,0
2020-07-31,Solano,095,438530,4316,3510,22,3532,29
2020-07-31,Sonoma,097,501317,3800,2745,7,2752,27
2020-07-31,Stanislaus,099,539301,11833,9061,49,9110,94
2020-07-31,Sutter,101,95872,895,714,1,715,6
2020-07-31,Tehama,103,63373,281,213,2,215,1
2020-07-31,Trinity,105,12862,27,5,6,11,0
2020-07-31,Tulare,107,460477,11391,9365,32,9397,184
2020-07-31,Tuolumne,109,53932,155,120,3,123,0
2020-07-31,Ventura,111,848112,8925,7521,31,7552,71
2020-07-31,Yolo,113,214977,1881,1522,3,1525,38
2020-07-31,Yuba,115,75493,516,369,0,369,1
2020-07-30,Alameda,001,1643700,13739,11303,52,11355,185
2020-07-30,Alpine,003,1148,2,2,0,2,0
2020-07-30,Amador,005,37829,171,97,0,97,0
2020-07-30,Butte,007,227075,1164,915,17,932,7
2020-07-30,Calaveras,009,45235,145,111,0,111,1
2020-07-30,Colusa,011,21464,373,315,0,315,2
2020-07-30,Contra Costa,013,1133247,10324,7615,27,7642,112
2020-07-30,Del Norte,015,27424,88,68,0,68,0
2020-07-30,El Dorado,017,186661,802,608,5,613,1
2020-07-30,Fresno,019,978130,21618,14793,190,14983,133
2020-07-30,Glenn,021,27897,373,297,0,297,1
2020-07-30,Humboldt,023,135768,262,228,1,229,4
2020-07-30,Imperial,025,180216,10297,7849,5,7854,151
2020-07-30,Inyo,027,18085,68,44,1,45,1
2020-07-30,Kern,029,883053,24736,19552,125,19677,171
2020-07-30,Kings,031,150075,4755,3785,21,3806,43
2020-07-30,Lake,033,64148,231,181,0,181,1
2020-07-30,Lassen,035,31185,636,544,2,546,0
2020-07-30,Los Angeles,037,10098052,201981,186177,529,186706,4564
2020-07-30,Madera,039,155013,2811,2007,5,2012,18
2020-07-30,Marin,041,260295,5390,4835,5,4840,39
2020-07-30,Mariposa,043,17540,61,49,0,49,1
2020-07-30,Mendocino,045,87422,315,232,0,232,1
2020-07-30,Merced,047,269075,5805,3695,3,3698,30
2020-07-30,Modoc,049,8938,6,0,0,0,0
2020-07-30,Mono,051,14174,148,104,1,105,1
2020-07-30,Monterey,053,433212,5509,4352,14,4366,24
2020-07-30,Napa,055,140530,1160,874,0,874,7
2020-07-30,Nevada,057,99092,338,292,13,305,2
2020-07-30,Orange,059,3164182,43347,36105,817,36922,607
2020-07-30,Placer,061,380077,2277,1821,3,1824,14
2020-07-30,Plumas,063,18699,33,25,0,25,0
2020-07-30,Riverside,065,2383286,44911,37308,41,37349,685
2020-07-30,Sacramento,067,1510023,12793,9704,12,9716,126
2020-07-30,San Benito,069,59416,708,558,0,558,2
2020-07-30,San Bernardino,071,2135413,39818,32010,181,32191,427
2020-07-30,San Diego,073,3302833,32336,28670,9,28679,558
2020-07-30,San Francisco,075,870044,7292,6107,6,6113,59
2020-07-30,San Joaquin,077,732212,14630,11435,12,11447,161
2020-07-30,San Luis Obispo,079,281455,2120,1703,8,1711,12
2020-07-30,San Mateo,081,765935,6479,5369,7,5376,115
2020-07-30,Santa Barbara,083,443738,6762,6273,66,6339,52
2020-07-30,Santa Clara,085,1922200,12859,9708,29,9737,170
2020-07-30,Santa Cruz,087,273765,1319,1087,7,1094,4
2020-07-30,Shasta,089,179085,489,306,3,309,8
2020-07-30,Sierra,091,2930,3,1,0,1,0
2020-07-30,Siskiyou,093,43540,96,60,0,60,0
2020-07-30,Solano,095,438530,4265,3463,22,3485,29
2020-07-30,Sonoma,097,501317,3729,2684,7,2691,25
2020-07-30,Stanislaus,099,539301,11620,8890,41,8931,94
2020-07-30,Sutter,101,95872,876,698,1,699,6
2020-07-30,Tehama,103,63373,278,208,2,210,1
2020-07-30,Trinity,105,12862,26,4,6,10,0
2020-07-30,Tulare,107,460477,11262,9167,32,9199,177
2020-07-30,Tuolumne,109,53932,154,119,3,122,0
2020-07-30,Ventura,111,848112,8813,7304,29,7333,69
2020-07-30,Yolo,113,214977,1861,1511,3,1514,37
2020-07-30,Yuba,115,75493,503,362,0,362,1
2020-07-29,Alameda,001,1643700,13519,11177,47,11224,180
2020-07-29,Alpine,003,1148,2,2,0,2,0
2020-07-29,Amador,005,37829,163,80,0,80,0
2020-07-29,Butte,007,227075,1138,889,15,904,7
2020-07-29,Calaveras,009,45235,139,107,0,107,1
2020-07-29,Colusa,011,21464,369,302,0,302,2
2020-07-29,Contra Costa,013,1133247,10120,7520,27,7547,108
2020-07-29,Del Norte,015,27424,88,68,0,68,0
2020-07-29,El Dorado,017,186661,792,588,5,593,1
2020-07-29,Fresno,019,978130,21326,14312,190,14502,125
2020-07-29,Glenn,021,27897,366,294,0,294,1
2020-07-29,Humboldt,023,135768,259,221,1,222,4
2020-07-29,Imperial,025,180216,10249,7825,5,7830,147
2020-07-29,Inyo,027,18085,63,44,1,45,1
2020-07-29,Kern,029,883053,24398,19073,122,19195,162
2020-07-29,Kings,031,150075,4707,3755,21,3776,43
2020-07-29,Lake,033,64148,229,179,0,179,1
2020-07-29,Lassen,035,31185,621,513,2,515,0
2020-07-29,Los Angeles,037,10098052,199956,183600,512,184112,4523
2020-07-29,Madera,039,155013,2757,1941,5,1946,18
2020-07-29,Marin,041,260295,5352,4747,5,4752,34
2020-07-29,Mariposa,043,17540,60,47,0,47,1
2020-07-29,Mendocino,045,87422,307,228,0,228,0
2020-07-29,Merced,047,269075,5665,3605,3,3608,25
2020-07-29,Modoc,049,8938,5,0,0,0,0
2020-07-29,Mono,051,14174,145,102,1,103,1
2020-07-29,Monterey,053,433212,5409,4252,14,4266,24
2020-07-29,Napa,055,140530,1132,866,0,866,7
2020-07-29,Nevada,057,99092,334,288,13,301,1
2020-07-29,Orange,059,3164182,42913,35339,806,36145,589
2020-07-29,Placer,061,380077,2245,1798,3,1801,14
2020-07-29,Plumas,063,18699,33,25,0,25,0
2020-07-29,Riverside,065,2383286,44319,36968,41,37009,678
2020-07-29,Sacramento,067,1510023,12547,9538,12,9550,122
2020-07-29,San Benito,069,59416,693,537,0,537,2
2020-07-29,San Bernardino,071,2135413,39329,31168,170,31338,417
2020-07-29,San Diego,073,3302833,32011,28289,8,28297,552
2020-07-29,San Francisco,075,870044,7198,6041,6,6047,56
2020-07-29,San Joaquin,077,732212,14382,11249,9,11258,154
2020-07-29,San Luis Obispo,079,281455,2099,1673,8,1681,11
2020-07-29,San Mateo,081,765935,6391,5305,7,5312,114
2020-07-29,Santa Barbara,083,443738,6695,6215,66,6281,31
2020-07-29,Santa Clara,085,1922200,12652,9567,29,9596,165
2020-07-29,Santa Cruz,087,273765,1295,1051,7,1058,4
2020-07-29,Shasta,089,179085,477,297,3,300,8
2020-07-29,Sierra,091,2930,2,1,0,1,0
2020-07-29,Siskiyou,093,43540,94,58,0,58,0
2020-07-29,Solano,095,438530,4211,3380,22,3402,29
2020-07-29,Sonoma,097,501317,3651,2598,7,2605,26
2020-07-29,Stanislaus,099,539301,11399,8745,35,8780,94
2020-07-29,Sutter,101,95872,848,678,1,679,6
2020-07-29,Tehama,103,63373,274,206,2,208,1
2020-07-29,Trinity,105,12862,26,4,6,10,0
2020-07-29,Tulare,107,460477,11091,9028,32,9060,156
2020-07-29,Tuolumne,109,53932,154,118,3,121,0
2020-07-29,Ventura,111,848112,8708,7161,29,7190,68
2020-07-29,Yolo,113,214977,1835,1488,3,1491,36
2020-07-29,Yuba,115,75493,487,350,0,350,1
2020-07-28,Alameda,001,1643700,13290,10875,46,10921,180
2020-07-28,Alpine,003,1148,2,2,0,2,0
2020-07-28,Amador,005,37829,153,77,0,77,0
2020-07-28,Butte,007,227075,1103,857,15,872,7
2020-07-28,Calaveras,009,45235,138,105,0,105,1
2020-07-28,Colusa,011,21464,363,290,0,290,2
2020-07-28,Contra Costa,013,1133247,9898,7426,27,7453,107
2020-07-28,Del Norte,015,27424,87,68,0,68,0
2020-07-28,El Dorado,017,186661,777,558,5,563,1
2020-07-28,Fresno,019,978130,20990,13933,184,14117,125
2020-07-28,Glenn,021,27897,364,289,0,289,1
2020-07-28,Humboldt,023,135768,258,218,1,219,4
2020-07-28,Imperial,025,180216,10213,7804,5,7809,145
2020-07-28,Inyo,027,18085,61,43,1,44,1
2020-07-28,Kern,029,883053,24035,18834,116,18950,155
2020-07-28,Kings,031,150075,4661,3721,21,3742,41
2020-07-28,Lake,033,64148,225,179,0,179,1
2020-07-28,Lassen,035,31185,615,508,2,510,0
2020-07-28,Los Angeles,037,10098052,197725,179107,490,179597,4435
2020-07-28,Madera,039,155013,2691,1889,5,1894,18
2020-07-28,Marin,041,260295,5283,4698,5,4703,23
2020-07-28,Mariposa,043,17540,58,45,0,45,1
2020-07-28,Mendocino,045,87422,296,222,0,222,0
2020-07-28,Merced,047,269075,5520,3446,3,3449,23
2020-07-28,Modoc,049,8938,4,0,0,0,0
2020-07-28,Mono,051,14174,144,102,1,103,1
2020-07-28,Monterey,053,433212,5289,4047,14,4061,22
2020-07-28,Napa,055,140530,1110,824,0,824,6
2020-07-28,Nevada,057,99092,329,278,13,291,1
2020-07-28,Orange,059,3164182,42455,34832,792,35624,582
2020-07-28,Placer,061,380077,2209,1759,3,1762,14
2020-07-28,Plumas,063,18699,33,22,0,22,0
2020-07-28,Riverside,065,2383286,43718,36458,41,36499,668
2020-07-28,Sacramento,067,1510023,12288,9429,11,9440,117
2020-07-28,San Benito,069,59416,683,503,0,503,2
2020-07-28,San Bernardino,071,2135413,38806,30493,166,30659,412
2020-07-28,San Diego,073,3302833,31661,28007,6,28013,547
2020-07-28,San Francisco,075,870044,7085,5888,6,5894,56
2020-07-28,San Joaquin,077,732212,14099,10958,6,10964,141
2020-07-28,San Luis Obispo,079,281455,2066,1636,8,1644,9
2020-07-28,San Mateo,081,765935,6318,5171,7,5178,114
2020-07-28,Santa Barbara,083,443738,6631,6110,64,6174,31
2020-07-28,Santa Clara,085,1922200,12418,9307,29,9336,165
2020-07-28,Santa Cruz,087,273765,1268,1018,7,1025,4
2020-07-28,Shasta,089,179085,465,275,3,278,8
2020-07-28,Sierra,091,2930,2,1,0,1,0
2020-07-28,Siskiyou,093,43540,90,57,0,57,0
2020-07-28,Solano,095,438530,4164,3292,21,3313,29
2020-07-28,Sonoma,097,501317,3577,2553,7,2560,20
2020-07-28,Stanislaus,099,539301,11177,8492,27,8519,92
2020-07-28,Sutter,101,95872,811,653,0,653,2
2020-07-28,Tehama,103,63373,269,199,2,201,1
2020-07-28,Trinity,105,12862,26,3,6,9,0
2020-07-28,Tulare,107,460477,10904,8787,32,8819,96
2020-07-28,Tuolumne,109,53932,153,116,3,119,0
2020-07-28,Ventura,111,848112,8582,7045,28,7073,68
2020-07-28,Yolo,113,214977,1807,1459,3,1462,36
2020-07-28,Yuba,115,75493,470,333,0,333,1
2020-07-27,Alameda,001,1643700,13063,10645,43,10688,176
2020-07-27,Alpine,003,1148,2,2,0,2,0
2020-07-27,Amador,005,37829,148,72,0,72,0
2020-07-27,Butte,007,227075,1076,843,15,858,7
2020-07-27,Calaveras,009,45235,134,103,0,103,1
2020-07-27,Colusa,011,21464,356,271,0,271,2
2020-07-27,Contra Costa,013,1133247,9676,7256,27,7283,104
2020-07-27,Del Norte,015,27424,86,67,0,67,0
2020-07-27,El Dorado,017,186661,765,548,5,553,1
2020-07-27,Fresno,019,978130,20642,13485,178,13663,117
2020-07-27,Glenn,021,27897,362,277,0,277,1
2020-07-27,Humboldt,023,135768,253,218,1,219,4
2020-07-27,Imperial,025,180216,10163,7789,5,7794,144
2020-07-27,Inyo,027,18085,61,43,1,44,1
2020-07-27,Kern,029,883053,23533,17994,110,18104,148
2020-07-27,Kings,031,150075,4412,3685,21,3706,39
2020-07-27,Lake,033,64148,221,176,0,176,1
2020-07-27,Lassen,035,31185,615,503,2,505,0
2020-07-27,Los Angeles,037,10098052,195298,176351,472,176823,4379
2020-07-27,Madera,039,155013,2626,1793,5,1798,17
2020-07-27,Marin,041,260295,5195,4669,5,4674,22
2020-07-27,Mariposa,043,17540,58,43,0,43,1
2020-07-27,Mendocino,045,87422,282,209,0,209,0
2020-07-27,Merced,047,269075,5380,3292,3,3295,23
2020-07-27,Modoc,049,8938,3,0,0,0,0
2020-07-27,Mono,051,14174,140,99,1,100,1
2020-07-27,Monterey,053,433212,5100,3960,14,3974,21
2020-07-27,Napa,055,140530,1095,769,0,769,6
2020-07-27,Nevada,057,99092,325,268,13,281,1
2020-07-27,Orange,059,3164182,42015,34649,776,35425,566
2020-07-27,Placer,061,380077,2159,1679,3,1682,12
2020-07-27,Plumas,063,18699,33,22,0,22,0
2020-07-27,Riverside,065,2383286,43039,35822,41,35863,667
2020-07-27,Sacramento,067,1510023,11995,9091,11,9102,114
2020-07-27,San Benito,069,59416,668,498,0,498,2
2020-07-27,San Bernardino,071,2135413,38214,29928,156,30084,401
2020-07-27,San Diego,073,3302833,31287,27509,5,27514,533
2020-07-27,San Francisco,075,870044,6998,5825,6,5831,55
2020-07-27,San Joaquin,077,732212,13810,10728,6,10734,129
2020-07-27,San Luis Obispo,079,281455,2020,1612,8,1620,9
2020-07-27,San Mateo,081,765935,6209,5108,7,5115,113
2020-07-27,Santa Barbara,083,443738,6552,6026,62,6088,30
2020-07-27,Santa Clara,085,1922200,12149,9157,28,9185,166
2020-07-27,Santa Cruz,087,273765,1244,984,7,991,4
2020-07-27,Shasta,089,179085,458,275,3,278,8
2020-07-27,Sierra,091,2930,2,1,0,1,0
2020-07-27,Siskiyou,093,43540,88,54,0,54,0
2020-07-27,Solano,095,438530,4097,3198,20,3218,29
2020-07-27,Sonoma,097,501317,3486,2504,7,2511,20
2020-07-27,Stanislaus,099,539301,10951,8288,19,8307,84
2020-07-27,Sutter,101,95872,785,620,0,620,2
2020-07-27,Tehama,103,63373,261,192,2,194,1
2020-07-27,Trinity,105,12862,26,3,6,9,0
2020-07-27,Tulare,107,460477,10686,8462,32,8494,172
2020-07-27,Tuolumne,109,53932,150,115,3,118,0
2020-07-27,Ventura,111,848112,8454,6998,27,7025,68
2020-07-27,Yolo,113,214977,1762,1439,3,1442,33
2020-07-27,Yuba,115,75493,450,328,0,328,1
2020-07-26,Alameda,001,1643700,12825,10489,42,10531,176
2020-07-26,Alpine,003,1148,2,2,0,2,0
2020-07-26,Amador,005,37829,142,67,0,67,0
2020-07-26,Butte,007,227075,1039,822,15,837,5
2020-07-26,Calaveras,009,45235,131,103,0,103,1
2020-07-26,Colusa,011,21464,347,270,0,270,2
2020-07-26,Contra Costa,013,1133247,9439,7095,27,7122,104
2020-07-26,Del Norte,015,27424,84,67,0,67,0
2020-07-26,El Dorado,017,186661,747,539,5,544,1
2020-07-26,Fresno,019,978130,20251,13209,170,13379,117
2020-07-26,Glenn,021,27897,354,265,0,265,1
2020-07-26,Humboldt,023,135768,247,214,1,215,4
2020-07-26,Imperial,025,180216,10091,7781,5,7786,144
2020-07-26,Inyo,027,18085,56,43,1,44,1
2020-07-26,Kern,029,883053,23008,17394,107,17501,148
2020-07-26,Kings,031,150075,4353,3591,21,3612,39
2020-07-26,Lake,033,64148,213,174,0,174,1
2020-07-26,Lassen,035,31185,574,503,2,505,0
2020-07-26,Los Angeles,037,10098052,192729,174322,454,174776,4364
2020-07-26,Madera,039,155013,2539,1744,5,1749,17
2020-07-26,Marin,041,260295,5149,4595,5,4600,22
2020-07-26,Mariposa,043,17540,56,43,0,43,1
2020-07-26,Mendocino,045,87422,273,206,0,206,0
2020-07-26,Merced,047,269075,5200,3251,2,3253,23
2020-07-26,Modoc,049,8938,3,0,0,0,0
2020-07-26,Mono,051,14174,136,82,1,83,1
2020-07-26,Monterey,053,433212,4934,3901,14,3915,21
2020-07-26,Napa,055,140530,1076,769,0,769,6
2020-07-26,Nevada,057,99092,322,261,13,274,1
2020-07-26,Orange,059,3164182,41490,34352,745,35097,564
2020-07-26,Placer,061,380077,2095,1628,3,1631,12
2020-07-26,Plumas,063,18699,33,22,0,22,0
2020-07-26,Riverside,065,2383286,42479,35636,41,35677,665
2020-07-26,Sacramento,067,1510023,11690,8972,11,8983,114
2020-07-26,San Benito,069,59416,656,495,0,495,2
2020-07-26,San Bernardino,071,2135413,37573,29545,148,29693,400
2020-07-26,San Diego,073,3302833,30891,26986,4,26990,533
2020-07-26,San Francisco,075,870044,6892,5823,6,5829,55
2020-07-26,San Joaquin,077,732212,13517,10637,6,10643,129
2020-07-26,San Luis Obispo,079,281455,1978,1565,8,1573,8
2020-07-26,San Mateo,081,765935,6104,5078,7,5085,113
2020-07-26,Santa Barbara,083,443738,6451,5939,62,6001,30
2020-07-26,Santa Clara,085,1922200,11920,8986,28,9014,166
2020-07-26,Santa Cruz,087,273765,1217,970,7,977,4
2020-07-26,Shasta,089,179085,451,265,3,268,8
2020-07-26,Sierra,091,2930,2,1,0,1,0
2020-07-26,Siskiyou,093,43540,86,54,0,54,0
2020-07-26,Solano,095,438530,4017,3197,18,3215,29
2020-07-26,Sonoma,097,501317,3397,2503,6,2509,20
2020-07-26,Stanislaus,099,539301,10690,8228,18,8246,84
2020-07-26,Sutter,101,95872,771,612,0,612,2
2020-07-26,Tehama,103,63373,254,175,2,177,1
2020-07-26,Trinity,105,12862,26,3,6,9,0
2020-07-26,Tulare,107,460477,10480,8392,32,8424,172
2020-07-26,Tuolumne,109,53932,145,113,3,116,0
2020-07-26,Ventura,111,848112,8247,6844,27,6871,67
2020-07-26,Yolo,113,214977,1731,1408,3,1411,33
2020-07-26,Yuba,115,75493,431,313,0,313,1
2020-07-25,Alameda,001,1643700,12728,10361,40,10401,176
2020-07-25,Alpine,003,1148,2,2,0,2,0
2020-07-25,Amador,005,37829,139,67,0,67,0
2020-07-25,Butte,007,227075,1030,810,15,825,5
2020-07-25,Calaveras,009,45235,127,103,0,103,1
2020-07-25,Colusa,011,21464,340,265,0,265,2
2020-07-25,Contra Costa,013,1133247,9294,6920,27,6947,104
2020-07-25,Del Norte,015,27424,84,67,0,67,0
2020-07-25,El Dorado,017,186661,736,528,5,533,1
2020-07-25,Fresno,019,978130,20064,12866,170,13036,117
2020-07-25,Glenn,021,27897,352,260,0,260,1
2020-07-25,Humboldt,023,135768,244,212,1,213,4
2020-07-25,Imperial,025,180216,10065,7727,5,7732,144
2020-07-25,Inyo,027,18085,55,43,1,44,1
2020-07-25,Kern,029,883053,22790,16910,106,17016,148
2020-07-25,Kings,031,150075,4336,3516,21,3537,39
2020-07-25,Lake,033,64148,211,173,0,173,1
2020-07-25,Lassen,035,31185,574,503,2,505,0
2020-07-25,Los Angeles,037,10098052,191595,172611,447,173058,4357
2020-07-25,Madera,039,155013,2507,1724,5,1729,17
2020-07-25,Marin,041,260295,5133,4562,5,4567,22
2020-07-25,Mariposa,043,17540,55,43,0,43,1
2020-07-25,Mendocino,045,87422,267,190,0,190,0
2020-07-25,Merced,047,269075,5121,3176,2,3178,23
2020-07-25,Modoc,049,8938,3,0,0,0,0
2020-07-25,Mono,051,14174,136,82,1,83,1
2020-07-25,Monterey,053,433212,4857,3805,14,3819,21
2020-07-25,Napa,055,140530,1063,746,0,746,6
2020-07-25,Nevada,057,99092,320,257,13,270,1
2020-07-25,Orange,059,3164182,41271,33978,724,34702,561
2020-07-25,Placer,061,380077,2079,1596,3,1599,12
2020-07-25,Plumas,063,18699,33,22,0,22,0
2020-07-25,Riverside,065,2383286,42210,34921,41,34962,655
2020-07-25,Sacramento,067,1510023,11544,8674,11,8685,113
2020-07-25,San Benito,069,59416,640,492,0,492,2
2020-07-25,San Bernardino,071,2135413,37295,29265,145,29410,394
2020-07-25,San Diego,073,3302833,30630,26703,3,26706,533
2020-07-25,San Francisco,075,870044,6834,5644,6,5650,55
2020-07-25,San Joaquin,077,732212,13391,10347,5,10352,129
2020-07-25,San Luis Obispo,079,281455,1958,1530,7,1537,8
2020-07-25,San Mateo,081,765935,6041,5023,7,5030,113
2020-07-25,Santa Barbara,083,443738,6416,5880,62,5942,30
2020-07-25,Santa Clara,085,1922200,11786,8767,28,8795,166
2020-07-25,Santa Cruz,087,273765,1200,939,7,946,4
2020-07-25,Shasta,089,179085,446,263,1,264,8
2020-07-25,Sierra,091,2930,2,1,0,1,0
2020-07-25,Siskiyou,093,43540,84,54,0,54,0
2020-07-25,Solano,095,438530,3977,3107,16,3123,29
2020-07-25,Sonoma,097,501317,3358,2412,6,2418,20
2020-07-25,Stanislaus,099,539301,10587,7994,15,8009,84
2020-07-25,Sutter,101,95872,752,603,0,603,2
2020-07-25,Tehama,103,63373,253,169,2,171,1
2020-07-25,Trinity,105,12862,26,3,6,9,0
2020-07-25,Tulare,107,460477,10380,8310,32,8342,172
2020-07-25,Tuolumne,109,53932,144,99,3,102,0
2020-07-25,Ventura,111,848112,8174,6662,27,6689,62
2020-07-25,Yolo,113,214977,1716,1357,3,1360,35
2020-07-25,Yuba,115,75493,425,312,0,312,1
2020-07-24,Alameda,001,1643700,12586,10216,37,10253,176
2020-07-24,Alpine,003,1148,2,2,0,2,0
2020-07-24,Amador,005,37829,137,66,0,66,0
2020-07-24,Butte,007,227075,1018,751,15,766,5
2020-07-24,Calaveras,009,45235,123,102,0,102,0
2020-07-24,Colusa,011,21464,337,255,0,255,2
2020-07-24,Contra Costa,013,1133247,9149,6814,27,6841,100
2020-07-24,Del Norte,015,27424,84,66,0,66,0
2020-07-24,El Dorado,017,186661,714,516,5,521,1
2020-07-24,Fresno,019,978130,19839,12564,170,12734,115
2020-07-24,Glenn,021,27897,349,251,0,251,1
2020-07-24,Humboldt,023,135768,241,210,1,211,4
2020-07-24,Imperial,025,180216,10043,7686,5,7691,141
2020-07-24,Inyo,027,18085,55,41,1,42,1
2020-07-24,Kern,029,883053,22549,16124,106,16230,143
2020-07-24,Kings,031,150075,4306,3471,21,3492,39
2020-07-24,Lake,033,64148,209,167,0,167,1
2020-07-24,Lassen,035,31185,574,503,2,505,0
2020-07-24,Los Angeles,037,10098052,189570,169078,436,169514,4302
2020-07-24,Madera,039,155013,2474,1679,5,1684,16
2020-07-24,Marin,041,260295,5106,4517,5,4522,22
2020-07-24,Mariposa,043,17540,55,41,0,41,1
2020-07-24,Mendocino,045,87422,260,188,0,188,0
2020-07-24,Merced,047,269075,5036,3100,2,3102,23
2020-07-24,Modoc,049,8938,3,0,0,0,0
2020-07-24,Mono,051,14174,135,82,1,83,1
2020-07-24,Monterey,053,433212,4785,3748,14,3762,21
2020-07-24,Napa,055,140530,1050,741,0,741,6
2020-07-24,Nevada,057,99092,317,255,13,268,1
2020-07-24,Orange,059,3164182,40984,33530,708,34238,557
2020-07-24,Placer,061,380077,2048,1551,3,1554,12
2020-07-24,Plumas,063,18699,33,22,0,22,0
2020-07-24,Riverside,065,2383286,41787,34513,40,34553,631
2020-07-24,Sacramento,067,1510023,11356,8570,11,8581,110
2020-07-24,San Benito,069,59416,633,485,0,485,2
2020-07-24,San Bernardino,071,2135413,36922,28990,140,29130,386
2020-07-24,San Diego,073,3302833,30330,26100,3,26103,524
2020-07-24,San Francisco,075,870044,6740,5611,6,5617,55
2020-07-24,San Joaquin,077,732212,13242,10190,5,10195,118
2020-07-24,San Luis Obispo,079,281455,1934,1476,7,1483,8
2020-07-24,San Mateo,081,765935,5978,4954,7,4961,112
2020-07-24,Santa Barbara,083,443738,6363,5776,60,5836,30
2020-07-24,Santa Clara,085,1922200,11621,8658,28,8686,165
2020-07-24,Santa Cruz,087,273765,1180,930,7,937,4
2020-07-24,Shasta,089,179085,438,262,1,263,8
2020-07-24,Sierra,091,2930,2,1,0,1,0
2020-07-24,Siskiyou,093,43540,84,53,0,53,0
2020-07-24,Solano,095,438530,3941,3062,13,3075,29
2020-07-24,Sonoma,097,501317,3306,2345,6,2351,20
2020-07-24,Stanislaus,099,539301,10415,7861,12,7873,82
2020-07-24,Sutter,101,95872,741,593,0,593,2
2020-07-24,Tehama,103,63373,245,170,2,172,1
2020-07-24,Trinity,105,12862,25,3,6,9,0
2020-07-24,Tulare,107,460477,10286,8167,30,8197,167
2020-07-24,Tuolumne,109,53932,138,99,3,102,0
2020-07-24,Ventura,111,848112,8089,6553,27,6580,60
2020-07-24,Yolo,113,214977,1702,1329,3,1332,35
2020-07-24,Yuba,115,75493,410,307,0,307,1
2020-07-23,Alameda,001,1643700,12344,9924,37,9961,171
2020-07-23,Alpine,003,1148,2,2,0,2,0
2020-07-23,Amador,005,37829,120,61,0,61,0
2020-07-23,Butte,007,227075,1003,726,14,740,5
2020-07-23,Calaveras,009,45235,116,102,0,102,0
2020-07-23,Colusa,011,21464,329,242,0,242,2
2020-07-23,Contra Costa,013,1133247,8950,6619,25,6644,98
2020-07-23,Del Norte,015,27424,84,66,0,66,0
2020-07-23,El Dorado,017,186661,703,491,5,496,1
2020-07-23,Fresno,019,978130,19483,12164,167,12331,112
2020-07-23,Glenn,021,27897,344,246,0,246,1
2020-07-23,Humboldt,023,135768,240,208,1,209,4
2020-07-23,Imperial,025,180216,9993,7604,5,7609,138
2020-07-23,Inyo,027,18085,53,38,1,39,1
2020-07-23,Kern,029,883053,22142,14491,102,14593,128
2020-07-23,Kings,031,150075,4194,3371,21,3392,39
2020-07-23,Lake,033,64148,200,160,0,160,1
2020-07-23,Lassen,035,31185,571,503,2,505,0
2020-07-23,Los Angeles,037,10098052,187020,167198,410,167608,4265
2020-07-23,Madera,039,155013,2408,1659,4,1663,13
2020-07-23,Marin,041,260295,5054,4423,5,4428,22
2020-07-23,Mariposa,043,17540,55,40,0,40,1
2020-07-23,Mendocino,045,87422,250,178,0,178,0
2020-07-23,Merced,047,269075,4879,2972,2,2974,22
2020-07-23,Modoc,049,8938,3,0,0,0,0
2020-07-23,Mono,051,14174,131,82,1,83,1
2020-07-23,Monterey,053,433212,4668,3655,14,3669,21
2020-07-23,Napa,055,140530,1026,713,0,713,5
2020-07-23,Nevada,057,99092,314,247,13,260,1
2020-07-23,Orange,059,3164182,40487,32863,678,33541,544
2020-07-23,Placer,061,380077,2004,1519,3,1522,12
2020-07-23,Plumas,063,18699,32,21,0,21,0
2020-07-23,Riverside,065,2383286,41182,33833,40,33873,630
2020-07-23,Sacramento,067,1510023,11123,8222,11,8233,108
2020-07-23,San Benito,069,59416,618,478,0,478,2
2020-07-23,San Bernardino,071,2135413,36402,28121,134,28255,369
2020-07-23,San Diego,073,3302833,29956,25109,3,25112,505
2020-07-23,San Francisco,075,870044,6639,5543,6,5549,55
2020-07-23,San Joaquin,077,732212,13023,9861,5,9866,111
2020-07-23,San Luis Obispo,079,281455,1905,1438,7,1445,7
2020-07-23,San Mateo,081,765935,5873,4895,7,4902,113
2020-07-23,Santa Barbara,083,443738,6290,5628,60,5688,30
2020-07-23,Santa Clara,085,1922200,11402,8458,28,8486,165
2020-07-23,Santa Cruz,087,273765,1144,887,7,894,3
2020-07-23,Shasta,089,179085,427,254,1,255,9
2020-07-23,Sierra,091,2930,2,1,0,1,0
2020-07-23,Siskiyou,093,43540,82,53,0,53,0
2020-07-23,Solano,095,438530,3877,2962,11,2973,29
2020-07-23,Sonoma,097,501317,3230,2289,6,2295,18
2020-07-23,Stanislaus,099,539301,10173,7603,12,7615,71
2020-07-23,Sutter,101,95872,708,570,0,570,2
2020-07-23,Tehama,103,63373,239,158,2,160,1
2020-07-23,Trinity,105,12862,24,3,6,9,0
2020-07-23,Tulare,107,460477,10097,7898,30,7928,168
2020-07-23,Tuolumne,109,53932,138,93,3,96,0
2020-07-23,Ventura,111,848112,7965,6303,27,6330,56
2020-07-23,Yolo,113,214977,1683,1279,3,1282,35
2020-07-23,Yuba,115,75493,390,297,0,297,1
2020-07-22,Alameda,001,1643700,12126,9678,36,9714,169
2020-07-22,Alpine,003,1148,2,2,0,2,0
2020-07-22,Amador,005,37829,118,58,0,58,0
2020-07-22,Butte,007,227075,967,694,14,708,5
2020-07-22,Calaveras,009,45235,116,98,0,98,0
2020-07-22,Colusa,011,21464,322,236,0,236,0
2020-07-22,Contra Costa,013,1133247,8724,6401,25,6426,98
2020-07-22,Del Norte,015,27424,84,66,0,66,0
2020-07-22,El Dorado,017,186661,690,466,5,471,1
2020-07-22,Fresno,019,978130,19120,11756,161,11917,110
2020-07-22,Glenn,021,27897,338,236,0,236,1
2020-07-22,Humboldt,023,135768,238,201,1,202,4
2020-07-22,Imperial,025,180216,9933,7533,5,7538,134
2020-07-22,Inyo,027,18085,49,38,1,39,1
2020-07-22,Kern,029,883053,21710,13513,94,13607,127
2020-07-22,Kings,031,150075,4138,3271,21,3292,38
2020-07-22,Lake,033,64148,197,160,0,160,1
2020-07-22,Lassen,035,31185,568,500,2,502,0
2020-07-22,Los Angeles,037,10098052,184370,165242,389,165631,4218
2020-07-22,Madera,039,155013,2333,1578,4,1582,10
2020-07-22,Marin,041,260295,4998,4373,5,4378,23
2020-07-22,Mariposa,043,17540,55,38,0,38,1
2020-07-22,Mendocino,045,87422,243,166,0,166,0
2020-07-22,Merced,047,269075,4753,2828,2,2830,15
2020-07-22,Modoc,049,8938,3,0,0,0,0
2020-07-22,Mono,051,14174,128,82,1,83,1
2020-07-22,Monterey,053,433212,4567,3533,14,3547,20
2020-07-22,Napa,055,140530,1004,687,0,687,5
2020-07-22,Nevada,057,99092,308,239,12,251,1
2020-07-22,Orange,059,3164182,39988,32047,669,32716,522
2020-07-22,Placer,061,380077,1948,1469,3,1472,12
2020-07-22,Plumas,063,18699,31,20,0,20,0
2020-07-22,Riverside,065,2383286,40546,33093,40,33133,612
2020-07-22,Sacramento,067,1510023,10861,8028,11,8039,106
2020-07-22,San Benito,069,59416,604,465,0,465,2
2020-07-22,San Bernardino,071,2135413,35880,26820,123,26943,348
2020-07-22,San Diego,073,3302833,29568,25109,2,25111,505
2020-07-22,San Francisco,075,870044,6535,5473,5,5478,53
2020-07-22,San Joaquin,077,732212,12747,9628,5,9633,102
2020-07-22,San Luis Obispo,079,281455,1859,1373,7,1380,7
2020-07-22,San Mateo,081,765935,5784,4796,7,4803,112
2020-07-22,Santa Barbara,083,443738,6206,5508,58,5566,29
2020-07-22,Santa Clara,085,1922200,11158,8266,28,8294,166
2020-07-22,Santa Cruz,087,273765,1120,866,7,873,3
2020-07-22,Shasta,089,179085,417,246,1,247,9
2020-07-22,Sierra,091,2930,1,1,0,1,0
2020-07-22,Siskiyou,093,43540,81,52,0,52,0
2020-07-22,Solano,095,438530,3816,2839,10,2849,29
2020-07-22,Sonoma,097,501317,3153,2255,6,2261,17
2020-07-22,Stanislaus,099,539301,10002,7401,12,7413,71
2020-07-22,Sutter,101,95872,684,551,0,551,2
2020-07-22,Tehama,103,63373,231,155,2,157,1
2020-07-22,Trinity,105,12862,23,3,6,9,0
2020-07-22,Tulare,107,460477,9864,7640,30,7670,167
2020-07-22,Tuolumne,109,53932,134,91,3,94,0
2020-07-22,Ventura,111,848112,7837,6223,25,6248,56
2020-07-22,Yolo,113,214977,1640,1233,3,1236,34
2020-07-22,Yuba,115,75493,375,288,0,288,1
2020-07-21,Alameda,001,1643700,11912,9390,36,9426,166
2020-07-21,Alpine,003,1148,2,2,0,2,0
2020-07-21,Amador,005,37829,113,55,0,55,0
2020-07-21,Butte,007,227075,922,659,13,672,5
2020-07-21,Calaveras,009,45235,110,96,0,96,0
2020-07-21,Colusa,011,21464,298,227,0,227,0
2020-07-21,Contra Costa,013,1133247,8482,6210,25,6235,98
2020-07-21,Del Norte,015,27424,84,66,0,66,0
2020-07-21,El Dorado,017,186661,682,440,5,445,1
2020-07-21,Fresno,019,978130,18720,11412,155,11567,107
2020-07-21,Glenn,021,27897,331,229,0,229,1
2020-07-21,Humboldt,023,135768,236,198,1,199,4
2020-07-21,Imperial,025,180216,9884,7458,5,7463,128
2020-07-21,Inyo,027,18085,48,38,1,39,1
2020-07-21,Kern,029,883053,21288,11998,88,12086,119
2020-07-21,Kings,031,150075,4073,3187,20,3207,38
2020-07-21,Lake,033,64148,197,157,0,157,1
2020-07-21,Lassen,035,31185,566,474,2,476,0
2020-07-21,Los Angeles,037,10098052,181380,162205,367,162572,4159
2020-07-21,Madera,039,155013,2268,1508,3,1511,10
2020-07-21,Marin,041,260295,4926,4318,5,4323,21
2020-07-21,Mariposa,043,17540,54,37,0,37,1
2020-07-21,Mendocino,045,87422,232,160,0,160,0
2020-07-21,Merced,047,269075,4574,2725,2,2727,15
2020-07-21,Modoc,049,8938,3,0,0,0,0
2020-07-21,Mono,051,14174,124,79,1,80,1
2020-07-21,Monterey,053,433212,4435,3404,13,3417,20
2020-07-21,Napa,055,140530,977,660,0,660,5
2020-07-21,Nevada,057,99092,306,228,10,238,1
2020-07-21,Orange,059,3164182,39492,31356,637,31993,515
2020-07-21,Placer,061,380077,1907,1413,3,1416,11
2020-07-21,Plumas,063,18699,31,19,0,19,0
2020-07-21,Riverside,065,2383286,39844,32231,40,32271,583
2020-07-21,Sacramento,067,1510023,10589,7789,10,7799,102
2020-07-21,San Benito,069,59416,593,444,0,444,2
2020-07-21,San Bernardino,071,2135413,35233,25323,116,25439,343
2020-07-21,San Diego,073,3302833,29119,24522,2,24524,487
2020-07-21,San Francisco,075,870044,6426,5377,5,5382,53
2020-07-21,San Joaquin,077,732212,12418,9150,5,9155,99
2020-07-21,San Luis Obispo,079,281455,1810,1338,7,1345,7
2020-07-21,San Mateo,081,765935,5692,4733,7,4740,111
2020-07-21,Santa Barbara,083,443738,6126,5422,57,5479,29
2020-07-21,Santa Clara,085,1922200,10895,7989,28,8017,164
2020-07-21,Santa Cruz,087,273765,1087,835,7,842,3
2020-07-21,Shasta,089,179085,409,241,1,242,9
2020-07-21,Sierra,091,2930,1,1,0,1,0
2020-07-21,Siskiyou,093,43540,81,48,0,48,0
2020-07-21,Solano,095,438530,3743,2727,10,2737,27
2020-07-21,Sonoma,097,501317,3096,2200,6,2206,17
2020-07-21,Stanislaus,099,539301,9739,6984,12,6996,69
2020-07-21,Sutter,101,95872,668,533,0,533,2
2020-07-21,Tehama,103,63373,221,150,2,152,1
2020-07-21,Trinity,105,12862,23,2,6,8,0
2020-07-21,Tulare,107,460477,9662,7447,30,7477,167
2020-07-21,Tuolumne,109,53932,132,75,3,78,0
2020-07-21,Ventura,111,848112,7705,6131,25,6156,55
2020-07-21,Yolo,113,214977,1586,1204,3,1207,34
2020-07-21,Yuba,115,75493,369,269,0,269,1
2020-07-20,Alameda,001,1643700,11657,9244,35,9279,162
2020-07-20,Alpine,003,1148,2,2,0,2,0
2020-07-20,Amador,005,37829,110,53,0,53,0
2020-07-20,Butte,007,227075,885,586,13,599,4
2020-07-20,Calaveras,009,45235,107,90,0,90,0
2020-07-20,Colusa,011,21464,287,217,0,217,0
2020-07-20,Contra Costa,013,1133247,8274,5823,25,5848,97
2020-07-20,Del Norte,015,27424,84,61,0,61,0
2020-07-20,El Dorado,017,186661,659,407,5,412,0
2020-07-20,Fresno,019,978130,18278,10891,154,11045,106
2020-07-20,Glenn,021,27897,323,225,0,225,1
2020-07-20,Humboldt,023,135768,229,194,1,195,4
2020-07-20,Imperial,025,180216,9844,7337,5,7342,124
2020-07-20,Inyo,027,18085,46,38,1,39,1
2020-07-20,Kern,029,883053,20778,10908,84,10992,118
2020-07-20,Kings,031,150075,4023,3093,20,3113,37
2020-07-20,Lake,033,64148,194,147,0,147,1
2020-07-20,Lassen,035,31185,564,474,2,476,0
2020-07-20,Los Angeles,037,10098052,178418,159202,341,159543,4108
2020-07-20,Madera,039,155013,2193,1433,3,1436,10
2020-07-20,Marin,041,260295,4844,4255,5,4260,21
2020-07-20,Mariposa,043,17540,53,36,0,36,1
2020-07-20,Mendocino,045,87422,219,153,0,153,0
2020-07-20,Merced,047,269075,4404,2584,2,2586,15
2020-07-20,Modoc,049,8938,3,0,0,0,0
2020-07-20,Mono,051,14174,118,78,1,79,1
2020-07-20,Monterey,053,433212,4329,3205,13,3218,19
2020-07-20,Napa,055,140530,942,632,0,632,5
2020-07-20,Nevada,057,99092,298,218,10,228,1
2020-07-20,Orange,059,3164182,38882,30337,607,30944,507
2020-07-20,Placer,061,380077,1856,1364,3,1367,11
2020-07-20,Plumas,063,18699,30,17,0,17,0
2020-07-20,Riverside,065,2383286,39013,31163,40,31203,581
2020-07-20,Sacramento,067,1510023,10261,7369,10,7379,99
2020-07-20,San Benito,069,59416,575,433,0,433,2
2020-07-20,San Bernardino,071,2135413,34423,24226,112,24338,338
2020-07-20,San Diego,073,3302833,28677,24137,2,24139,478
2020-07-20,San Francisco,075,870044,6305,5090,5,5095,53
2020-07-20,San Joaquin,077,732212,12062,8583,5,8588,97
2020-07-20,San Luis Obispo,079,281455,1768,1282,7,1289,6
2020-07-20,San Mateo,081,765935,5592,4609,7,4616,111
2020-07-20,Santa Barbara,083,443738,6016,5266,55,5321,29
2020-07-20,Santa Clara,085,1922200,10667,7711,27,7738,164
2020-07-20,Santa Cruz,087,273765,1055,758,7,765,3
2020-07-20,Shasta,089,179085,394,233,1,234,9
2020-07-20,Sierra,091,2930,1,1,0,1,0
2020-07-20,Siskiyou,093,43540,77,42,0,42,0
2020-07-20,Solano,095,438530,3660,2537,10,2547,26
2020-07-20,Sonoma,097,501317,2989,2148,6,2154,17
2020-07-20,Stanislaus,099,539301,9455,6835,12,6847,58
2020-07-20,Sutter,101,95872,635,507,0,507,2
2020-07-20,Tehama,103,63373,211,146,2,148,1
2020-07-20,Trinity,105,12862,23,2,6,8,0
2020-07-20,Tulare,107,460477,9428,6974,30,7004,166
2020-07-20,Tuolumne,109,53932,131,75,3,78,0
2020-07-20,Ventura,111,848112,7571,5912,25,5937,52
2020-07-20,Yolo,113,214977,1546,1155,3,1158,30
2020-07-20,Yuba,115,75493,349,258,0,258,1
2020-07-19,Alameda,001,1643700,11416,9227,29,9256,162
2020-07-19,Alpine,003,1148,2,2,0,2,0
2020-07-19,Amador,005,37829,103,51,0,51,0
2020-07-19,Butte,007,227075,860,555,13,568,4
2020-07-19,Calaveras,009,45235,105,89,0,89,0
2020-07-19,Colusa,011,21464,279,187,0,187,0
2020-07-19,Contra Costa,013,1133247,7983,5691,23,5714,95
2020-07-19,Del Norte,015,27424,83,61,0,61,0
2020-07-19,El Dorado,017,186661,641,385,5,390,0
2020-07-19,Fresno,019,978130,17754,10639,142,10781,106
2020-07-19,Glenn,021,27897,309,215,0,215,0
2020-07-19,Humboldt,023,135768,221,195,1,196,4
2020-07-19,Imperial,025,180216,9753,7280,5,7285,124
2020-07-19,Inyo,027,18085,42,38,1,39,1
2020-07-19,Kern,029,883053,20161,10094,77,10171,115
2020-07-19,Kings,031,150075,3937,3035,20,3055,37
2020-07-19,Lake,033,64148,189,144,0,144,1
2020-07-19,Lassen,035,31185,545,474,2,476,0
2020-07-19,Los Angeles,037,10098052,174971,156039,318,156357,4100
2020-07-19,Madera,039,155013,2116,1301,3,1304,10
2020-07-19,Marin,041,260295,4789,4172,5,4177,21
2020-07-19,Mariposa,043,17540,49,35,0,35,1
2020-07-19,Mendocino,045,87422,214,137,0,137,0
2020-07-19,Merced,047,269075,4197,2460,2,2462,15
2020-07-19,Modoc,049,8938,3,0,0,0,0
2020-07-19,Mono,051,14174,107,63,1,64,1
2020-07-19,Monterey,053,433212,4210,3079,13,3092,18
2020-07-19,Napa,055,140530,913,612,0,612,5
2020-07-19,Nevada,057,99092,292,210,10,220,1
2020-07-19,Orange,059,3164182,38318,29941,594,30535,505
2020-07-19,Placer,061,380077,1809,1246,3,1249,11
2020-07-19,Plumas,063,18699,30,17,0,17,0
2020-07-19,Riverside,065,2383286,38308,30340,40,30380,581
2020-07-19,Sacramento,067,1510023,9868,6985,10,6995,97
2020-07-19,San Benito,069,59416,559,412,0,412,2
2020-07-19,San Bernardino,071,2135413,33650,23928,100,24028,337
2020-07-19,San Diego,073,3302833,28176,23684,2,23686,478
2020-07-19,San Francisco,075,870044,6159,5094,5,5099,52
2020-07-19,San Joaquin,077,732212,11656,8308,5,8313,93
2020-07-19,San Luis Obispo,079,281455,1724,1262,7,1269,6
2020-07-19,San Mateo,081,765935,5488,4522,7,4529,110
2020-07-19,Santa Barbara,083,443738,5914,5145,52,5197,29
2020-07-19,Santa Clara,085,1922200,10423,7403,27,7430,164
2020-07-19,Santa Cruz,087,273765,1011,753,7,760,3
2020-07-19,Shasta,089,179085,381,218,1,219,9
2020-07-19,Sierra,091,2930,1,1,0,1,0
2020-07-19,Siskiyou,093,43540,75,42,0,42,0
2020-07-19,Solano,095,438530,3555,2551,10,2561,26
2020-07-19,Sonoma,097,501317,2889,2074,6,2080,17
2020-07-19,Stanislaus,099,539301,9159,6508,12,6520,58
2020-07-19,Sutter,101,95872,604,480,0,480,2
2020-07-19,Tehama,103,63373,207,138,2,140,1
2020-07-19,Trinity,105,12862,23,2,6,8,0
2020-07-19,Tulare,107,460477,9180,6856,30,6886,166
2020-07-19,Tuolumne,109,53932,126,75,3,78,0
2020-07-19,Ventura,111,848112,7381,5706,25,5731,52
2020-07-19,Yolo,113,214977,1506,1127,3,1130,30
2020-07-19,Yuba,115,75493,329,240,0,240,1
2020-07-18,Alameda,001,1643700,11279,9089,28,9117,162
2020-07-18,Alpine,003,1148,2,2,0,2,0
2020-07-18,Amador,005,37829,99,49,0,49,0
2020-07-18,Butte,007,227075,851,551,13,564,4
2020-07-18,Calaveras,009,45235,101,89,0,89,0
2020-07-18,Colusa,011,21464,274,182,0,182,0
2020-07-18,Contra Costa,013,1133247,7849,5617,23,5640,95
2020-07-18,Del Norte,015,27424,83,61,0,61,0
2020-07-18,El Dorado,017,186661,638,385,5,390,0
2020-07-18,Fresno,019,978130,17505,10381,140,10521,106
2020-07-18,Glenn,021,27897,303,212,0,212,0
2020-07-18,Humboldt,023,135768,218,189,1,190,4
2020-07-18,Imperial,025,180216,9722,7268,5,7273,124
2020-07-18,Inyo,027,18085,42,38,1,39,1
2020-07-18,Kern,029,883053,19858,9250,74,9324,114
2020-07-18,Kings,031,150075,3897,2996,19,3015,37
2020-07-18,Lake,033,64148,186,142,0,142,1
2020-07-18,Lassen,035,31185,544,474,2,476,0
2020-07-18,Los Angeles,037,10098052,173525,153265,308,153573,4088
2020-07-18,Madera,039,155013,2070,1260,3,1263,9
2020-07-18,Marin,041,260295,4760,4089,5,4094,21
2020-07-18,Mariposa,043,17540,49,35,0,35,1
2020-07-18,Mendocino,045,87422,208,137,0,137,0
2020-07-18,Merced,047,269075,4078,2424,2,2426,15
2020-07-18,Modoc,049,8938,3,0,0,0,0
2020-07-18,Mono,051,14174,105,54,1,55,1
2020-07-18,Monterey,053,433212,4142,3020,13,3033,17
2020-07-18,Napa,055,140530,902,609,0,609,5
2020-07-18,Nevada,057,99092,288,204,9,213,1
2020-07-18,Orange,059,3164182,37999,29603,574,30177,493
2020-07-18,Placer,061,380077,1786,1233,3,1236,11
2020-07-18,Plumas,063,18699,30,17,0,17,0
2020-07-18,Riverside,065,2383286,37954,30245,39,30284,581
2020-07-18,Sacramento,067,1510023,9623,6739,10,6749,95
2020-07-18,San Benito,069,59416,544,407,0,407,2
2020-07-18,San Bernardino,071,2135413,33190,23680,93,23773,336
2020-07-18,San Diego,073,3302833,27873,23116,2,23118,478
2020-07-18,San Francisco,075,870044,6057,5051,5,5056,52
2020-07-18,San Joaquin,077,732212,11443,8118,5,8123,93
2020-07-18,San Luis Obispo,079,281455,1689,1234,7,1241,6
2020-07-18,San Mateo,081,765935,5428,4488,7,4495,110
2020-07-18,Santa Barbara,083,443738,5854,5110,50,5160,29
2020-07-18,Santa Clara,085,1922200,10274,7255,26,7281,164
2020-07-18,Santa Cruz,087,273765,994,751,7,758,3
2020-07-18,Shasta,089,179085,372,216,1,217,9
2020-07-18,Sierra,091,2930,1,1,0,1,0
2020-07-18,Siskiyou,093,43540,71,42,0,42,0
2020-07-18,Solano,095,438530,3514,2503,10,2513,26
2020-07-18,Sonoma,097,501317,2838,2019,6,2025,15
2020-07-18,Stanislaus,099,539301,9024,6344,12,6356,58
2020-07-18,Sutter,101,95872,598,473,0,473,2
2020-07-18,Tehama,103,63373,202,136,2,138,1
2020-07-18,Trinity,105,12862,23,2,6,8,0
2020-07-18,Tulare,107,460477,9089,6810,29,6839,167
2020-07-18,Tuolumne,109,53932,123,75,3,78,0
2020-07-18,Ventura,111,848112,7299,5630,25,5655,52
2020-07-18,Yolo,113,214977,1478,1077,3,1080,30
2020-07-18,Yuba,115,75493,318,237,0,237,1
2020-07-17,Alameda,001,1643700,11138,8893,27,8920,160
2020-07-17,Alpine,003,1148,2,1,0,1,0
2020-07-17,Amador,005,37829,97,48,0,48,0
2020-07-17,Butte,007,227075,837,497,13,510,4
2020-07-17,Calaveras,009,45235,99,86,0,86,0
2020-07-17,Colusa,011,21464,272,146,0,146,0
2020-07-17,Contra Costa,013,1133247,7701,5483,23,5506,93
2020-07-17,Del Norte,015,27424,82,60,0,60,0
2020-07-17,El Dorado,017,186661,622,368,5,373,0
2020-07-17,Fresno,019,978130,17207,9954,140,10094,104
2020-07-17,Glenn,021,27897,296,203,0,203,0
2020-07-17,Humboldt,023,135768,217,185,1,186,4
2020-07-17,Imperial,025,180216,9700,7193,5,7198,120
2020-07-17,Inyo,027,18085,42,38,1,39,1
2020-07-17,Kern,029,883053,19538,8291,73,8364,113
2020-07-17,Kings,031,150075,3858,2978,19,2997,37
2020-07-17,Lake,033,64148,184,139,0,139,1
2020-07-17,Lassen,035,31185,525,391,2,393,0
2020-07-17,Los Angeles,037,10098052,171153,150481,296,150777,4052
2020-07-17,Madera,039,155013,2026,1214,3,1217,9
2020-07-17,Marin,041,260295,4723,3839,5,3844,21
2020-07-17,Mariposa,043,17540,47,35,0,35,1
2020-07-17,Mendocino,045,87422,200,126,0,126,0
2020-07-17,Merced,047,269075,4002,2328,2,2330,12
2020-07-17,Modoc,049,8938,2,0,0,0,0
2020-07-17,Mono,051,14174,100,54,1,55,1
2020-07-17,Monterey,053,433212,4013,2922,13,2935,18
2020-07-17,Napa,055,140530,888,598,0,598,5
2020-07-17,Nevada,057,99092,281,200,9,209,1
2020-07-17,Orange,059,3164182,37536,28962,541,29503,485
2020-07-17,Placer,061,380077,1757,1207,3,1210,11
2020-07-17,Plumas,063,18699,27,16,0,16,0
2020-07-17,Riverside,065,2383286,37355,29639,39,29678,580
2020-07-17,Sacramento,067,1510023,9379,6563,10,6573,95
2020-07-17,San Benito,069,59416,529,399,0,399,2
2020-07-17,San Bernardino,071,2135413,32670,23057,90,23147,322
2020-07-17,San Diego,073,3302833,27485,22491,2,22493,472
2020-07-17,San Francisco,075,870044,5963,4967,5,4972,52
2020-07-17,San Joaquin,077,732212,11199,7925,5,7930,86
2020-07-17,San Luis Obispo,079,281455,1652,1190,7,1197,6
2020-07-17,San Mateo,081,765935,5331,4407,7,4414,110
2020-07-17,Santa Barbara,083,443738,5782,5001,49,5050,29
2020-07-17,Santa Clara,085,1922200,10056,7080,26,7106,164
2020-07-17,Santa Cruz,087,273765,972,716,7,723,3
2020-07-17,Shasta,089,179085,360,213,1,214,8
2020-07-17,Sierra,091,2930,1,1,0,1,0
2020-07-17,Siskiyou,093,43540,70,40,0,40,0
2020-07-17,Solano,095,438530,3465,2452,10,2462,26
2020-07-17,Sonoma,097,501317,2789,1982,6,1988,15
2020-07-17,Stanislaus,099,539301,8850,6220,12,6232,56
2020-07-17,Sutter,101,95872,585,458,0,458,2
2020-07-17,Tehama,103,63373,198,128,2,130,1
2020-07-17,Trinity,105,12862,23,2,6,8,0
2020-07-17,Tulare,107,460477,8953,6671,29,6700,166
2020-07-17,Tuolumne,109,53932,122,73,3,76,0
2020-07-17,Ventura,111,848112,7215,5451,25,5476,51
2020-07-17,Yolo,113,214977,1454,1055,3,1058,30
2020-07-17,Yuba,115,75493,308,231,0,231,1
2020-07-16,Alameda,001,1643700,10904,8719,22,8741,153
2020-07-16,Alpine,003,1148,2,1,0,1,0
2020-07-16,Amador,005,37829,94,46,0,46,0
2020-07-16,Butte,007,227075,800,465,12,477,4
2020-07-16,Calaveras,009,45235,97,82,0,82,0
2020-07-16,Colusa,011,21464,263,140,0,140,0
2020-07-16,Contra Costa,013,1133247,7488,5338,17,5355,91
2020-07-16,Del Norte,015,27424,82,60,0,60,0
2020-07-16,El Dorado,017,186661,605,357,5,362,0
2020-07-16,Fresno,019,978130,16696,9481,131,9612,101
2020-07-16,Glenn,021,27897,287,190,0,190,0
2020-07-16,Humboldt,023,135768,215,184,1,185,4
2020-07-16,Imperial,025,180216,9606,7148,5,7153,113
2020-07-16,Inyo,027,18085,42,38,1,39,1
2020-07-16,Kern,029,883053,19016,7435,71,7506,112
2020-07-16,Kings,031,150075,3691,2937,19,2956,37
2020-07-16,Lake,033,64148,179,128,0,128,1
2020-07-16,Lassen,035,31185,524,355,2,357,0
2020-07-16,Los Angeles,037,10098052,167931,147759,271,148030,3994
2020-07-16,Madera,039,155013,1962,1192,3,1195,8
2020-07-16,Marin,041,260295,4651,3546,5,3551,21
2020-07-16,Mariposa,043,17540,45,34,0,34,1
2020-07-16,Mendocino,045,87422,195,121,0,121,0
2020-07-16,Merced,047,269075,3840,2228,2,2230,12
2020-07-16,Modoc,049,8938,1,0,0,0,0
2020-07-16,Mono,051,14174,97,53,1,54,1
2020-07-16,Monterey,053,433212,3908,2857,12,2869,18
2020-07-16,Napa,055,140530,859,581,0,581,5
2020-07-16,Nevada,057,99092,278,191,9,200,1
2020-07-16,Orange,059,3164182,36834,28525,505,29030,471
2020-07-16,Placer,061,380077,1709,1168,3,1171,11
2020-07-16,Plumas,063,18699,25,16,0,16,0
2020-07-16,Riverside,065,2383286,36610,28904,37,28941,577
2020-07-16,Sacramento,067,1510023,9066,6440,9,6449,91
2020-07-16,San Benito,069,59416,512,389,0,389,2
2020-07-16,San Bernardino,071,2135413,31809,22355,72,22427,321
2020-07-16,San Diego,073,3302833,26998,21857,2,21859,465
2020-07-16,San Francisco,075,870044,5822,4838,5,4843,52
2020-07-16,San Joaquin,077,732212,10837,7713,5,7718,82
2020-07-16,San Luis Obispo,079,281455,1608,1146,7,1153,6
2020-07-16,San Mateo,081,765935,5227,4336,7,4343,110
2020-07-16,Santa Barbara,083,443738,5687,4872,48,4920,28
2020-07-16,Santa Clara,085,1922200,9776,6990,24,7014,164
2020-07-16,Santa Cruz,087,273765,931,698,7,705,3
2020-07-16,Shasta,089,179085,345,208,1,209,7
2020-07-16,Sierra,091,2930,1,1,0,1,0
2020-07-16,Siskiyou,093,43540,67,39,0,39,0
2020-07-16,Solano,095,438530,3371,2372,10,2382,25
2020-07-16,Sonoma,097,501317,2699,1954,6,1960,14
2020-07-16,Stanislaus,099,539301,8567,6077,11,6088,56
2020-07-16,Sutter,101,95872,569,444,0,444,2
2020-07-16,Tehama,103,63373,188,126,2,128,1
2020-07-16,Trinity,105,12862,23,2,5,7,0
2020-07-16,Tulare,107,460477,8737,6467,28,6495,163
2020-07-16,Tuolumne,109,53932,117,71,3,74,0
2020-07-16,Ventura,111,848112,7053,5231,25,5256,50
2020-07-16,Yolo,113,214977,1412,1034,3,1037,29
2020-07-16,Yuba,115,75493,290,221,0,221,1
2020-07-15,Alameda,001,1643700,10699,8615,17,8632,153
2020-07-15,Alpine,003,1148,2,1,0,1,0
2020-07-15,Amador,005,37829,73,44,0,44,0
2020-07-15,Butte,007,227075,758,420,12,432,4
2020-07-15,Calaveras,009,45235,97,75,0,75,0
2020-07-15,Colusa,011,21464,258,135,0,135,0
2020-07-15,Contra Costa,013,1133247,7257,5246,17,5263,90
2020-07-15,Del Norte,015,27424,81,60,0,60,0
2020-07-15,El Dorado,017,186661,581,339,5,344,0
2020-07-15,Fresno,019,978130,16222,9124,125,9249,101
2020-07-15,Glenn,021,27897,278,184,0,184,0
2020-07-15,Humboldt,023,135768,213,181,1,182,4
2020-07-15,Imperial,025,180216,9539,7110,5,7115,110
2020-07-15,Inyo,027,18085,42,36,1,37,1
2020-07-15,Kern,029,883053,18396,7155,68,7223,108
2020-07-15,Kings,031,150075,3630,2906,19,2925,37
2020-07-15,Lake,033,64148,177,122,0,122,1
2020-07-15,Lassen,035,31185,520,319,2,321,0
2020-07-15,Los Angeles,037,10098052,164465,143343,256,143599,3946
2020-07-15,Madera,039,155013,1893,1147,3,1150,4
2020-07-15,Marin,041,260295,4596,3458,5,3463,21
2020-07-15,Mariposa,043,17540,45,34,0,34,1
2020-07-15,Mendocino,045,87422,192,119,0,119,0
2020-07-15,Merced,047,269075,3690,2156,2,2158,12
2020-07-15,Modoc,049,8938,1,0,0,0,0
2020-07-15,Mono,051,14174,95,52,1,53,1
2020-07-15,Monterey,053,433212,3796,2780,12,2792,18
2020-07-15,Napa,055,140530,833,573,0,573,5
2020-07-15,Nevada,057,99092,274,185,7,192,1
2020-07-15,Orange,059,3164182,36034,27718,471,28189,454
2020-07-15,Placer,061,380077,1651,1145,3,1148,11
2020-07-15,Plumas,063,18699,25,16,0,16,0
2020-07-15,Riverside,065,2383286,35828,28492,35,28527,568
2020-07-15,Sacramento,067,1510023,8686,6217,9,6226,91
2020-07-15,San Benito,069,59416,503,388,0,388,2
2020-07-15,San Bernardino,071,2135413,31020,21508,56,21564,317
2020-07-15,San Diego,073,3302833,26531,21448,2,21450,448
2020-07-15,San Francisco,075,870044,5709,4757,5,4762,50
2020-07-15,San Joaquin,077,732212,10405,7381,4,7385,75
2020-07-15,San Luis Obispo,079,281455,1565,1097,7,1104,6
2020-07-15,San Mateo,081,765935,5114,4258,7,4265,109
2020-07-15,Santa Barbara,083,443738,5573,4733,48,4781,28
2020-07-15,Santa Clara,085,1922200,9472,6900,24,6924,164
2020-07-15,Santa Cruz,087,273765,895,660,6,666,3
2020-07-15,Shasta,089,179085,336,193,1,194,7
2020-07-15,Sierra,091,2930,1,1,0,1,0
2020-07-15,Siskiyou,093,43540,66,38,0,38,0
2020-07-15,Solano,095,438530,3276,2343,10,2353,25
2020-07-15,Sonoma,097,501317,2601,1920,6,1926,14
2020-07-15,Stanislaus,099,539301,8270,5777,11,5788,56
2020-07-15,Sutter,101,95872,543,433,0,433,2
2020-07-15,Tehama,103,63373,180,126,2,128,1
2020-07-15,Trinity,105,12862,22,2,5,7,0
2020-07-15,Tulare,107,460477,8526,6320,27,6347,156
2020-07-15,Tuolumne,109,53932,110,68,3,71,0
2020-07-15,Ventura,111,848112,6876,5087,25,5112,50
2020-07-15,Yolo,113,214977,1379,1002,3,1005,27
2020-07-15,Yuba,115,75493,278,221,0,221,1
2020-07-14,Alameda,001,1643700,10358,8388,11,8399,151
2020-07-14,Alpine,003,1148,2,1,0,1,0
2020-07-14,Amador,005,37829,69,44,0,44,0
2020-07-14,Butte,007,227075,712,382,12,394,4
2020-07-14,Calaveras,009,45235,95,74,0,74,0
2020-07-14,Colusa,011,21464,248,128,0,128,0
2020-07-14,Contra Costa,013,1133247,7020,5110,15,5125,90
2020-07-14,Del Norte,015,27424,80,60,0,60,0
2020-07-14,El Dorado,017,186661,566,324,5,329,0
2020-07-14,Fresno,019,978130,15802,8941,120,9061,98
2020-07-14,Glenn,021,27897,268,177,0,177,0
2020-07-14,Humboldt,023,135768,210,175,1,176,4
2020-07-14,Imperial,025,180216,9411,7095,5,7100,109
2020-07-14,Inyo,027,18085,42,35,1,36,1
2020-07-14,Kern,029,883053,17637,6979,55,7034,107
2020-07-14,Kings,031,150075,3563,2867,18,2885,37
2020-07-14,Lake,033,64148,171,120,0,120,1
2020-07-14,Lassen,035,31185,503,263,2,265,0
2020-07-14,Los Angeles,037,10098052,161332,140632,227,140859,3900
2020-07-14,Madera,039,155013,1819,1118,3,1121,4
2020-07-14,Marin,041,260295,4482,3451,5,3456,21
2020-07-14,Mariposa,043,17540,41,32,0,32,1
2020-07-14,Mendocino,045,87422,184,110,0,110,0
2020-07-14,Merced,047,269075,3511,2084,2,2086,12
2020-07-14,Modoc,049,8938,1,0,0,0,0
2020-07-14,Mono,051,14174,85,48,1,49,1
2020-07-14,Monterey,053,433212,3683,2724,12,2736,18
2020-07-14,Napa,055,140530,777,557,0,557,4
2020-07-14,Nevada,057,99092,257,180,6,186,1
2020-07-14,Orange,059,3164182,35154,26915,423,27338,432
2020-07-14,Placer,061,380077,1593,1122,3,1125,11
2020-07-14,Plumas,063,18699,24,14,0,14,0
2020-07-14,Riverside,065,2383286,35071,27850,34,27884,547
2020-07-14,Sacramento,067,1510023,8332,5978,9,5987,87
2020-07-14,San Benito,069,59416,484,360,0,360,2
2020-07-14,San Bernardino,071,2135413,30169,20489,46,20535,316
2020-07-14,San Diego,073,3302833,25911,20887,2,20889,436
2020-07-14,San Francisco,075,870044,5558,4659,4,4663,50
2020-07-14,San Joaquin,077,732212,9978,7143,4,7147,75
2020-07-14,San Luis Obispo,079,281455,1527,1060,7,1067,5
2020-07-14,San Mateo,081,765935,5021,4173,7,4180,108
2020-07-14,Santa Barbara,083,443738,5449,4641,46,4687,28
2020-07-14,Santa Clara,085,1922200,9144,6686,21,6707,164
2020-07-14,Santa Cruz,087,273765,856,639,6,645,3
2020-07-14,Shasta,089,179085,327,190,1,191,7
2020-07-14,Sierra,091,2930,1,1,0,1,0
2020-07-14,Siskiyou,093,43540,65,38,0,38,0
2020-07-14,Solano,095,438530,3177,2266,9,2275,25
2020-07-14,Sonoma,097,501317,2508,1866,6,1872,14
2020-07-14,Stanislaus,099,539301,7896,5631,10,5641,53
2020-07-14,Sutter,101,95872,524,405,0,405,2
2020-07-14,Tehama,103,63373,168,123,2,125,1
2020-07-14,Trinity,105,12862,21,2,5,7,0
2020-07-14,Tulare,107,460477,8281,6199,27,6226,156
2020-07-14,Tuolumne,109,53932,105,68,3,71,0
2020-07-14,Ventura,111,848112,6715,4950,25,4975,50
2020-07-14,Yolo,113,214977,1331,966,3,969,27
2020-07-14,Yuba,115,75493,261,210,0,210,1
2020-07-13,Alameda,001,1643700,10049,8115,11,8126,148
2020-07-13,Alpine,003,1148,2,1,0,1,0
2020-07-13,Amador,005,37829,65,42,0,42,0
2020-07-13,Butte,007,227075,676,354,12,366,4
2020-07-13,Calaveras,009,45235,87,63,0,63,0
2020-07-13,Colusa,011,21464,242,116,0,116,0
2020-07-13,Contra Costa,013,1133247,6748,4882,13,4895,88
2020-07-13,Del Norte,015,27424,74,59,0,59,0
2020-07-13,El Dorado,017,186661,535,298,5,303,0
2020-07-13,Fresno,019,978130,15373,8666,115,8781,95
2020-07-13,Glenn,021,27897,261,168,0,168,0
2020-07-13,Humboldt,023,135768,205,174,1,175,4
2020-07-13,Imperial,025,180216,9324,7052,5,7057,109
2020-07-13,Inyo,027,18085,41,35,1,36,1
2020-07-13,Kern,029,883053,16952,6808,50,6858,107
2020-07-13,Kings,031,150075,3512,2824,18,2842,37
2020-07-13,Lake,033,64148,166,118,0,118,1
2020-07-13,Lassen,035,31185,498,237,2,239,0
2020-07-13,Los Angeles,037,10098052,158099,136368,213,136581,3829
2020-07-13,Madera,039,155013,1750,1059,3,1062,4
2020-07-13,Marin,041,260295,4378,3402,5,3407,21
2020-07-13,Mariposa,043,17540,40,31,0,31,1
2020-07-13,Mendocino,045,87422,180,87,0,87,0
2020-07-13,Merced,047,269075,3362,2007,2,2009,12
2020-07-13,Modoc,049,8938,1,0,0,0,0
2020-07-13,Mono,051,14174,81,47,0,47,1
2020-07-13,Monterey,053,433212,3560,2613,9,2622,18
2020-07-13,Napa,055,140530,741,534,0,534,4
2020-07-13,Nevada,057,99092,243,172,6,178,1
2020-07-13,Orange,059,3164182,34290,25978,391,26369,423
2020-07-13,Placer,061,380077,1548,1096,3,1099,11
2020-07-13,Plumas,063,18699,22,14,0,14,0
2020-07-13,Riverside,065,2383286,34146,27136,32,27168,545
2020-07-13,Sacramento,067,1510023,8035,5747,9,5756,85
2020-07-13,San Benito,069,59416,471,343,0,343,2
2020-07-13,San Bernardino,071,2135413,29292,19610,40,19650,313
2020-07-13,San Diego,073,3302833,25344,20348,2,20350,422
2020-07-13,San Francisco,075,870044,5431,4534,3,4537,50
2020-07-13,San Joaquin,077,732212,9564,6927,4,6931,71
2020-07-13,San Luis Obispo,079,281455,1496,989,7,996,5
2020-07-13,San Mateo,081,765935,4890,4057,7,4064,108
2020-07-13,Santa Barbara,083,443738,5335,4441,45,4486,28
2020-07-13,Santa Clara,085,1922200,8821,6488,20,6508,164
2020-07-13,Santa Cruz,087,273765,818,574,6,580,3
2020-07-13,Shasta,089,179085,316,185,1,186,6
2020-07-13,Sierra,091,2930,1,1,0,1,0
2020-07-13,Siskiyou,093,43540,61,37,0,37,0
2020-07-13,Solano,095,438530,3065,2046,9,2055,23
2020-07-13,Sonoma,097,501317,2397,1818,6,1824,14
2020-07-13,Stanislaus,099,539301,7593,5324,9,5333,53
2020-07-13,Sutter,101,95872,486,379,0,379,2
2020-07-13,Tehama,103,63373,155,112,2,114,1
2020-07-13,Trinity,105,12862,21,2,5,7,0
2020-07-13,Tulare,107,460477,8020,5930,25,5955,147
2020-07-13,Tuolumne,109,53932,97,56,3,59,0
2020-07-13,Ventura,111,848112,6525,4800,22,4822,50
2020-07-13,Yolo,113,214977,1285,941,3,944,27
2020-07-13,Yuba,115,75493,246,194,0,194,1
2020-07-12,Alameda,001,1643700,9779,8056,11,8067,148
2020-07-12,Alpine,003,1148,2,1,0,1,0
2020-07-12,Amador,005,37829,55,40,0,40,0
2020-07-12,Butte,007,227075,626,341,11,352,4
2020-07-12,Calaveras,009,45235,87,62,0,62,0
2020-07-12,Colusa,011,21464,208,116,0,116,0
2020-07-12,Contra Costa,013,1133247,6479,4708,11,4719,88
2020-07-12,Del Norte,015,27424,63,59,0,59,0
2020-07-12,El Dorado,017,186661,513,290,5,295,0
2020-07-12,Fresno,019,978130,14948,8407,110,8517,95
2020-07-12,Glenn,021,27897,248,166,0,166,0
2020-07-12,Humboldt,023,135768,201,174,1,175,4
2020-07-12,Imperial,025,180216,9209,6999,5,7004,109
2020-07-12,Inyo,027,18085,39,35,1,36,1
2020-07-12,Kern,029,883053,16209,6662,47,6709,105
2020-07-12,Kings,031,150075,3450,2779,18,2797,34
2020-07-12,Lake,033,64148,157,114,0,114,1
2020-07-12,Lassen,035,31185,491,237,2,239,0
2020-07-12,Los Angeles,037,10098052,154675,133830,184,134014,3816
2020-07-12,Madera,039,155013,1695,1025,3,1028,4
2020-07-12,Marin,041,260295,4301,3358,5,3363,21
2020-07-12,Mariposa,043,17540,39,31,0,31,1
2020-07-12,Mendocino,045,87422,161,88,0,88,0
2020-07-12,Merced,047,269075,3232,1908,2,1910,12
2020-07-12,Modoc,049,8938,1,0,0,0,0
2020-07-12,Mono,051,14174,71,45,0,45,1
2020-07-12,Monterey,053,433212,3445,2521,9,2530,18
2020-07-12,Napa,055,140530,709,519,0,519,4
2020-07-12,Nevada,057,99092,233,166,6,172,1
2020-07-12,Orange,059,3164182,33414,25399,382,25781,422
2020-07-12,Placer,061,380077,1491,1058,3,1061,11
2020-07-12,Plumas,063,18699,21,14,0,14,0
2020-07-12,Riverside,065,2383286,33388,26404,31,26435,542
2020-07-12,Sacramento,067,1510023,7723,5515,7,5522,85
2020-07-12,San Benito,069,59416,456,324,0,324,2
2020-07-12,San Bernardino,071,2135413,28381,19042,36,19078,312
2020-07-12,San Diego,073,3302833,24714,19929,2,19931,422
2020-07-12,San Francisco,075,870044,5281,4535,3,4538,50
2020-07-12,San Joaquin,077,732212,9202,6703,4,6707,71
2020-07-12,San Luis Obispo,079,281455,1449,972,7,979,5
2020-07-12,San Mateo,081,765935,4772,3988,7,3995,108
2020-07-12,Santa Barbara,083,443738,5205,4353,44,4397,28
2020-07-12,Santa Clara,085,1922200,8583,6252,19,6271,164
2020-07-12,Santa Cruz,087,273765,776,573,5,578,3
2020-07-12,Shasta,089,179085,310,173,1,174,6
2020-07-12,Sierra,091,2930,1,1,0,1,0
2020-07-12,Siskiyou,093,43540,59,36,0,36,0
2020-07-12,Solano,095,438530,2940,2037,9,2046,23
2020-07-12,Sonoma,097,501317,2303,1743,6,1749,13
2020-07-12,Stanislaus,099,539301,7289,5177,9,5186,53
2020-07-12,Sutter,101,95872,468,362,0,362,2
2020-07-12,Tehama,103,63373,148,111,2,113,1
2020-07-12,Trinity,105,12862,21,2,5,7,0
2020-07-12,Tulare,107,460477,7765,5864,24,5888,146
2020-07-12,Tuolumne,109,53932,89,52,3,55,0
2020-07-12,Ventura,111,848112,6309,4724,21,4745,50
2020-07-12,Yolo,113,214977,1244,889,3,892,27
2020-07-12,Yuba,115,75493,235,188,0,188,1
2020-07-11,Alameda,001,1643700,9677,7845,11,7856,148
2020-07-11,Alpine,003,1148,2,1,0,1,0
2020-07-11,Amador,005,37829,51,37,0,37,0
2020-07-11,Butte,007,227075,610,325,11,336,4
2020-07-11,Calaveras,009,45235,84,62,0,62,0
2020-07-11,Colusa,011,21464,203,110,0,110,0
2020-07-11,Contra Costa,013,1133247,6363,4650,11,4661,87
2020-07-11,Del Norte,015,27424,63,59,0,59,0
2020-07-11,El Dorado,017,186661,502,283,5,288,0
2020-07-11,Fresno,019,978130,14688,8086,108,8194,95
2020-07-11,Glenn,021,27897,240,161,0,161,0
2020-07-11,Humboldt,023,135768,200,174,1,175,4
2020-07-11,Imperial,025,180216,9170,6884,5,6889,109
2020-07-11,Inyo,027,18085,39,35,1,36,1
2020-07-11,Kern,029,883053,15852,6509,46,6555,103
2020-07-11,Kings,031,150075,3423,2753,18,2771,33
2020-07-11,Lake,033,64148,156,110,0,110,1
2020-07-11,Lassen,035,31185,490,237,2,239,0
2020-07-11,Los Angeles,037,10098052,152956,130479,174,130653,3802
2020-07-11,Madera,039,155013,1654,988,3,991,4
2020-07-11,Marin,041,260295,4273,3191,5,3196,21
2020-07-11,Mariposa,043,17540,39,31,0,31,1
2020-07-11,Mendocino,045,87422,157,88,0,88,0
2020-07-11,Merced,047,269075,3151,1851,2,1853,12
2020-07-11,Modoc,049,8938,1,0,0,0,0
2020-07-11,Mono,051,14174,68,45,0,45,1
2020-07-11,Monterey,053,433212,3356,2376,8,2384,18
2020-07-11,Napa,055,140530,697,509,0,509,4
2020-07-11,Nevada,057,99092,224,163,5,168,1
2020-07-11,Orange,059,3164182,33037,24430,368,24798,422
2020-07-11,Placer,061,380077,1456,1029,3,1032,11
2020-07-11,Plumas,063,18699,21,12,0,12,0
2020-07-11,Riverside,065,2383286,32998,25994,31,26025,538
2020-07-11,Sacramento,067,1510023,7549,5367,7,5374,84
2020-07-11,San Benito,069,59416,441,314,0,314,2
2020-07-11,San Bernardino,071,2135413,27944,18907,34,18941,310
2020-07-11,San Diego,073,3302833,24322,19371,2,19373,422
2020-07-11,San Francisco,075,870044,5185,4430,2,4432,50
2020-07-11,San Joaquin,077,732212,9024,6518,4,6522,72
2020-07-11,San Luis Obispo,079,281455,1401,930,7,937,4
2020-07-11,San Mateo,081,765935,4704,3956,7,3963,108
2020-07-11,Santa Barbara,083,443738,5136,4283,43,4326,28
2020-07-11,Santa Clara,085,1922200,8424,5959,19,5978,164
2020-07-11,Santa Cruz,087,273765,745,571,5,576,3
2020-07-11,Shasta,089,179085,303,168,1,169,6
2020-07-11,Sierra,091,2930,1,1,0,1,0
2020-07-11,Siskiyou,093,43540,59,36,0,36,0
2020-07-11,Solano,095,438530,2899,2034,9,2043,23
2020-07-11,Sonoma,097,501317,2265,1690,6,1696,13
2020-07-11,Stanislaus,099,539301,7148,4911,9,4920,51
2020-07-11,Sutter,101,95872,452,352,0,352,2
2020-07-11,Tehama,103,63373,146,111,2,113,1
2020-07-11,Trinity,105,12862,21,2,5,7,0
2020-07-11,Tulare,107,460477,7659,5780,24,5804,149
2020-07-11,Tuolumne,109,53932,87,50,3,53,0
2020-07-11,Ventura,111,848112,6213,4545,20,4565,49
2020-07-11,Yolo,113,214977,1215,833,3,836,27
2020-07-11,Yuba,115,75493,225,175,0,175,1
2020-07-10,Alameda,001,1643700,9520,7551,11,7562,147
2020-07-10,Alpine,003,1148,2,1,0,1,0
2020-07-10,Amador,005,37829,47,37,0,37,0
2020-07-10,Butte,007,227075,599,318,11,329,4
2020-07-10,Calaveras,009,45235,84,61,0,61,0
2020-07-10,Colusa,011,21464,197,103,0,103,0
2020-07-10,Contra Costa,013,1133247,6221,4482,11,4493,86
2020-07-10,Del Norte,015,27424,63,57,0,57,0
2020-07-10,El Dorado,017,186661,484,266,5,271,0
2020-07-10,Fresno,019,978130,14356,7760,105,7865,93
2020-07-10,Glenn,021,27897,235,157,0,157,0
2020-07-10,Humboldt,023,135768,199,168,1,169,4
2020-07-10,Imperial,025,180216,9125,6878,4,6882,98
2020-07-10,Inyo,027,18085,39,35,1,36,1
2020-07-10,Kern,029,883053,15420,6344,45,6389,102
2020-07-10,Kings,031,150075,3387,2707,18,2725,33
2020-07-10,Lake,033,64148,149,104,0,104,1
2020-07-10,Lassen,035,31185,489,235,2,237,0
2020-07-10,Los Angeles,037,10098052,150535,127503,168,127671,3750
2020-07-10,Madera,039,155013,1608,914,3,917,4
2020-07-10,Marin,041,260295,4210,3101,5,3106,21
2020-07-10,Mariposa,043,17540,38,31,0,31,1
2020-07-10,Mendocino,045,87422,149,88,0,88,0
2020-07-10,Merced,047,269075,3072,1802,2,1804,12
2020-07-10,Modoc,049,8938,1,0,0,0,0
2020-07-10,Mono,051,14174,67,45,0,45,1
2020-07-10,Monterey,053,433212,3278,2285,8,2293,18
2020-07-10,Napa,055,140530,686,496,0,496,4
2020-07-10,Nevada,057,99092,219,161,5,166,1
2020-07-10,Orange,059,3164182,32450,23692,365,24057,416
2020-07-10,Placer,061,380077,1414,1002,3,1005,11
2020-07-10,Plumas,063,18699,19,12,0,12,0
2020-07-10,Riverside,065,2383286,32480,25481,31,25512,533
2020-07-10,Sacramento,067,1510023,7294,5181,7,5188,81
2020-07-10,San Benito,069,59416,432,302,0,302,2
2020-07-10,San Bernardino,071,2135413,27420,18242,31,18273,308
2020-07-10,San Diego,073,3302833,23938,18862,2,18864,420
2020-07-10,San Francisco,075,870044,5094,4305,2,4307,50
2020-07-10,San Joaquin,077,732212,8791,6225,4,6229,67
2020-07-10,San Luis Obispo,079,281455,1363,891,7,898,4
2020-07-10,San Mateo,081,765935,4639,3844,7,3851,107
2020-07-10,Santa Barbara,083,443738,5039,4177,42,4219,28
2020-07-10,Santa Clara,085,1922200,8200,5819,19,5838,164
2020-07-10,Santa Cruz,087,273765,717,540,5,545,3
2020-07-10,Shasta,089,179085,299,158,1,159,6
2020-07-10,Sierra,091,2930,1,1,0,1,0
2020-07-10,Siskiyou,093,43540,59,31,0,31,0
2020-07-10,Solano,095,438530,2852,1950,9,1959,23
2020-07-10,Sonoma,097,501317,2218,1606,5,1611,13
2020-07-10,Stanislaus,099,539301,6978,4781,9,4790,46
2020-07-10,Sutter,101,95872,445,338,0,338,2
2020-07-10,Tehama,103,63373,145,107,2,109,1
2020-07-10,Trinity,105,12862,21,2,5,7,0
2020-07-10,Tulare,107,460477,7522,5677,24,5701,150
2020-07-10,Tuolumne,109,53932,86,49,3,52,0
2020-07-10,Ventura,111,848112,6099,4416,20,4436,48
2020-07-10,Yolo,113,214977,1191,794,3,797,27
2020-07-10,Yuba,115,75493,211,164,0,164,1
2020-07-09,Alameda,001,1643700,9284,7433,11,7444,146
2020-07-09,Alpine,003,1148,2,1,0,1,0
2020-07-09,Amador,005,37829,44,36,0,36,0
2020-07-09,Butte,007,227075,567,295,11,306,4
2020-07-09,Calaveras,009,45235,83,59,0,59,0
2020-07-09,Colusa,011,21464,189,97,0,97,0
2020-07-09,Contra Costa,013,1133247,5977,4388,11,4399,86
2020-07-09,Del Norte,015,27424,63,57,0,57,0
2020-07-09,El Dorado,017,186661,459,255,4,259,0
2020-07-09,Fresno,019,978130,13902,7385,102,7487,90
2020-07-09,Glenn,021,27897,225,150,0,150,0
2020-07-09,Humboldt,023,135768,196,166,1,167,4
2020-07-09,Imperial,025,180216,9028,6778,4,6782,87
2020-07-09,Inyo,027,18085,37,35,1,36,1
2020-07-09,Kern,029,883053,14775,6100,43,6143,95
2020-07-09,Kings,031,150075,3323,2686,18,2704,33
2020-07-09,Lake,033,64148,146,99,0,99,1
2020-07-09,Lassen,035,31185,433,221,2,223,0
2020-07-09,Los Angeles,037,10098052,147276,125062,145,125207,3698
2020-07-09,Madera,039,155013,1531,850,3,853,4
2020-07-09,Marin,041,260295,4058,2975,4,2979,20
2020-07-09,Mariposa,043,17540,38,32,0,32,1
2020-07-09,Mendocino,045,87422,145,88,0,88,0
2020-07-09,Merced,047,269075,2939,1728,2,1730,11
2020-07-09,Modoc,049,8938,1,0,0,0,0
2020-07-09,Mono,051,14174,63,45,0,45,1
2020-07-09,Monterey,053,433212,3153,2223,8,2231,17
2020-07-09,Napa,055,140530,669,468,0,468,4
2020-07-09,Nevada,057,99092,213,156,5,161,1
2020-07-09,Orange,059,3164182,31480,22960,347,23307,407
2020-07-09,Placer,061,380077,1372,982,3,985,11
2020-07-09,Plumas,063,18699,19,12,0,12,0
2020-07-09,Riverside,065,2383286,31587,24980,30,25010,529
2020-07-09,Sacramento,067,1510023,6967,4950,7,4957,81
2020-07-09,San Benito,069,59416,416,295,0,295,2
2020-07-09,San Bernardino,071,2135413,26549,17339,25,17364,307
2020-07-09,San Diego,073,3302833,23346,18404,2,18406,415
2020-07-09,San Francisco,075,870044,4962,4143,2,4145,50
2020-07-09,San Joaquin,077,732212,8433,6004,4,6008,66
2020-07-09,San Luis Obispo,079,281455,1323,869,7,876,3
2020-07-09,San Mateo,081,765935,4513,3792,7,3799,106
2020-07-09,Santa Barbara,083,443738,4907,4068,42,4110,28
2020-07-09,Santa Clara,085,1922200,7943,5638,19,5657,164
2020-07-09,Santa Cruz,087,273765,690,526,5,531,3
2020-07-09,Shasta,089,179085,293,155,1,156,5
2020-07-09,Sierra,091,2930,1,1,0,1,0
2020-07-09,Siskiyou,093,43540,55,31,0,31,0
2020-07-09,Solano,095,438530,2754,1892,9,1901,23
2020-07-09,Sonoma,097,501317,2132,1584,5,1589,13
2020-07-09,Stanislaus,099,539301,6663,4633,8,4641,46
2020-07-09,Sutter,101,95872,428,321,0,321,2
2020-07-09,Tehama,103,63373,140,102,2,104,1
2020-07-09,Trinity,105,12862,21,2,5,7,0
2020-07-09,Tulare,107,460477,7303,5501,23,5524,146
2020-07-09,Tuolumne,109,53932,85,47,3,50,0
2020-07-09,Ventura,111,848112,5931,4278,20,4298,47
2020-07-09,Yolo,113,214977,1143,764,3,767,27
2020-07-09,Yuba,115,75493,194,152,0,152,1
2020-07-08,Alameda,001,1643700,8992,7335,11,7346,142
2020-07-08,Alpine,003,1148,2,1,0,1,0
2020-07-08,Amador,005,37829,41,35,0,35,0
2020-07-08,Butte,007,227075,530,281,11,292,3
2020-07-08,Calaveras,009,45235,78,58,0,58,0
2020-07-08,Colusa,011,21464,176,90,0,90,0
2020-07-08,Contra Costa,013,1133247,5731,4268,9,4277,84
2020-07-08,Del Norte,015,27424,61,57,0,57,0
2020-07-08,El Dorado,017,186661,437,248,4,252,0
2020-07-08,Fresno,019,978130,13486,7102,94,7196,86
2020-07-08,Glenn,021,27897,214,146,0,146,0
2020-07-08,Humboldt,023,135768,193,162,1,163,4
2020-07-08,Imperial,025,180216,8941,6727,4,6731,76
2020-07-08,Inyo,027,18085,37,35,1,36,1
2020-07-08,Kern,029,883053,14197,5873,41,5914,91
2020-07-08,Kings,031,150075,3263,2629,15,2644,33
2020-07-08,Lake,033,64148,139,97,0,97,1
2020-07-08,Lassen,035,31185,337,221,2,223,0
2020-07-08,Los Angeles,037,10098052,144071,123462,118,123580,3650
2020-07-08,Madera,039,155013,1461,828,3,831,4
2020-07-08,Marin,041,260295,3959,2756,4,2760,17
2020-07-08,Mariposa,043,17540,38,31,0,31,1
2020-07-08,Mendocino,045,87422,132,84,0,84,0
2020-07-08,Merced,047,269075,2819,1578,2,1580,11
2020-07-08,Modoc,049,8938,1,0,0,0,0
2020-07-08,Mono,051,14174,60,45,0,45,1
2020-07-08,Monterey,053,433212,3035,2182,7,2189,17
2020-07-08,Napa,055,140530,647,468,0,468,4
2020-07-08,Nevada,057,99092,204,156,5,161,1
2020-07-08,Orange,059,3164182,30529,22088,342,22430,378
2020-07-08,Placer,061,380077,1325,948,3,951,11
2020-07-08,Plumas,063,18699,19,12,0,12,0
2020-07-08,Riverside,065,2383286,30623,24042,29,24071,508
2020-07-08,Sacramento,067,1510023,6678,4799,7,4806,80
2020-07-08,San Benito,069,59416,400,282,0,282,2
2020-07-08,San Bernardino,071,2135413,25695,16510,21,16531,296
2020-07-08,San Diego,073,3302833,22776,17844,2,17846,406
2020-07-08,San Francisco,075,870044,4873,4093,2,4095,50
2020-07-08,San Joaquin,077,732212,8090,5759,4,5763,61
2020-07-08,San Luis Obispo,079,281455,1271,825,7,832,2
2020-07-08,San Mateo,081,765935,4392,3733,7,3740,106
2020-07-08,Santa Barbara,083,443738,4788,3985,42,4027,28
2020-07-08,Santa Clara,085,1922200,7710,5510,19,5529,164
2020-07-08,Santa Cruz,087,273765,657,509,4,513,3
2020-07-08,Shasta,089,179085,284,148,1,149,6
2020-07-08,Sierra,091,2930,1,1,0,1,0
2020-07-08,Siskiyou,093,43540,55,31,0,31,0
2020-07-08,Solano,095,438530,2638,1821,9,1830,23
2020-07-08,Sonoma,097,501317,2056,1495,5,1500,9
2020-07-08,Stanislaus,099,539301,6363,4344,8,4352,46
2020-07-08,Sutter,101,95872,403,298,0,298,2
2020-07-08,Tehama,103,63373,134,100,2,102,1
2020-07-08,Trinity,105,12862,20,2,5,7,0
2020-07-08,Tulare,107,460477,7111,5307,18,5325,138
2020-07-08,Tuolumne,109,53932,81,42,3,45,0
2020-07-08,Ventura,111,848112,5766,4139,20,4159,47
2020-07-08,Yolo,113,214977,1099,727,3,730,26
2020-07-08,Yuba,115,75493,181,145,0,145,1
2020-07-07,Alameda,001,1643700,8671,7097,10,7107,141
2020-07-07,Alpine,003,1148,2,1,0,1,0
2020-07-07,Amador,005,37829,41,33,0,33,0
2020-07-07,Butte,007,227075,487,269,11,280,3
2020-07-07,Calaveras,009,45235,76,58,0,58,0
2020-07-07,Colusa,011,21464,143,84,0,84,0
2020-07-07,Contra Costa,013,1133247,5495,4131,8,4139,84
2020-07-07,Del Norte,015,27424,61,57,0,57,0
2020-07-07,El Dorado,017,186661,417,244,4,248,0
2020-07-07,Fresno,019,978130,13033,6738,94,6832,84
2020-07-07,Glenn,021,27897,205,145,0,145,0
2020-07-07,Humboldt,023,135768,190,150,1,151,4
2020-07-07,Imperial,025,180216,8842,6678,4,6682,51
2020-07-07,Inyo,027,18085,36,32,1,33,1
2020-07-07,Kern,029,883053,13498,5645,37,5682,88
2020-07-07,Kings,031,150075,3200,2623,14,2637,33
2020-07-07,Lake,033,64148,129,94,0,94,1
2020-07-07,Lassen,035,31185,266,219,2,221,0
2020-07-07,Los Angeles,037,10098052,140492,121026,111,121137,3588
2020-07-07,Madera,039,155013,1417,794,3,797,4
2020-07-07,Marin,041,260295,3870,2627,4,2631,17
2020-07-07,Mariposa,043,17540,38,31,0,31,1
2020-07-07,Mendocino,045,87422,124,82,0,82,0
2020-07-07,Merced,047,269075,2645,1531,2,1533,10
2020-07-07,Modoc,049,8938,1,0,0,0,0
2020-07-07,Mono,051,14174,59,42,0,42,1
2020-07-07,Monterey,053,433212,2892,2166,7,2173,17
2020-07-07,Napa,055,140530,628,459,0,459,4
2020-07-07,Nevada,057,99092,198,150,5,155,1
2020-07-07,Orange,059,3164182,29518,21741,328,22069,373
2020-07-07,Placer,061,380077,1284,930,3,933,11
2020-07-07,Plumas,063,18699,17,12,0,12,0
2020-07-07,Riverside,065,2383286,29607,23279,29,23308,499
2020-07-07,Sacramento,067,1510023,6336,4592,7,4599,76
2020-07-07,San Benito,069,59416,382,274,0,274,2
2020-07-07,San Bernardino,071,2135413,24826,16004,19,16023,277
2020-07-07,San Diego,073,3302833,22057,17580,2,17582,399
2020-07-07,San Francisco,075,870044,4781,4045,1,4046,50
2020-07-07,San Joaquin,077,732212,7748,5547,4,5551,59
2020-07-07,San Luis Obispo,079,281455,1210,795,7,802,2
2020-07-07,San Mateo,081,765935,4277,3691,7,3698,106
2020-07-07,Santa Barbara,083,443738,4660,3866,41,3907,27
2020-07-07,Santa Clara,085,1922200,7441,5438,19,5457,164
2020-07-07,Santa Cruz,087,273765,623,502,3,505,2
2020-07-07,Shasta,089,179085,271,144,1,145,6
2020-07-07,Sierra,091,2930,1,1,0,1,0
2020-07-07,Siskiyou,093,43540,54,30,0,30,0
2020-07-07,Solano,095,438530,2527,1776,8,1784,22
2020-07-07,Sonoma,097,501317,1985,1473,5,1478,8
2020-07-07,Stanislaus,099,539301,6024,4101,8,4109,46
2020-07-07,Sutter,101,95872,377,273,0,273,2
2020-07-07,Tehama,103,63373,125,95,2,97,1
2020-07-07,Trinity,105,12862,20,2,5,7,0
2020-07-07,Tulare,107,460477,6931,5189,17,5206,137
2020-07-07,Tuolumne,109,53932,75,40,3,43,0
2020-07-07,Ventura,111,848112,5597,3992,18,4010,46
2020-07-07,Yolo,113,214977,1031,706,3,709,26
2020-07-07,Yuba,115,75493,161,138,0,138,1
2020-07-06,Alameda,001,1643700,8433,6970,10,6980,141
2020-07-06,Alpine,003,1148,1,1,0,1,0
2020-07-06,Amador,005,37829,39,33,0,33,0
2020-07-06,Butte,007,227075,431,257,11,268,2
2020-07-06,Calaveras,009,45235,73,45,0,45,0
2020-07-06,Colusa,011,21464,134,80,0,80,0
2020-07-06,Contra Costa,013,1133247,5265,3901,7,3908,83
2020-07-06,Del Norte,015,27424,60,57,0,57,0
2020-07-06,El Dorado,017,186661,402,232,3,235,0
2020-07-06,Fresno,019,978130,12565,6364,88,6452,82
2020-07-06,Glenn,021,27897,197,129,0,129,0
2020-07-06,Humboldt,023,135768,188,148,1,149,3
2020-07-06,Imperial,025,180216,8723,6443,4,6447,47
2020-07-06,Inyo,027,18085,36,32,1,33,1
2020-07-06,Kern,029,883053,12692,5491,37,5528,82
2020-07-06,Kings,031,150075,3149,2583,10,2593,33
2020-07-06,Lake,033,64148,122,93,0,93,1
2020-07-06,Lassen,035,31185,264,219,2,221,0
2020-07-06,Los Angeles,037,10098052,136891,116707,97,116804,3541
2020-07-06,Madera,039,155013,1347,734,3,737,4
2020-07-06,Marin,041,260295,3630,2136,4,2140,17
2020-07-06,Mariposa,043,17540,36,31,0,31,1
2020-07-06,Mendocino,045,87422,107,72,0,72,0
2020-07-06,Merced,047,269075,2494,1396,2,1398,10
2020-07-06,Modoc,049,8938,1,0,0,0,0
2020-07-06,Mono,051,14174,58,40,0,40,1
2020-07-06,Monterey,053,433212,2803,2078,7,2085,15
2020-07-06,Napa,055,140530,610,454,0,454,4
2020-07-06,Nevada,057,99092,192,146,5,151,1
2020-07-06,Orange,059,3164182,28457,20167,291,20458,372
2020-07-06,Placer,061,380077,1222,904,3,907,11
2020-07-06,Plumas,063,18699,17,11,0,11,0
2020-07-06,Riverside,065,2383286,28552,22485,28,22513,477
2020-07-06,Sacramento,067,1510023,5985,4420,7,4427,71
2020-07-06,San Benito,069,59416,367,264,0,264,2
2020-07-06,San Bernardino,071,2135413,23973,15346,16,15362,272
2020-07-06,San Diego,073,3302833,21325,17002,2,17004,387
2020-07-06,San Francisco,075,870044,4660,3861,1,3862,50
2020-07-06,San Joaquin,077,732212,7378,5104,4,5108,57
2020-07-06,San Luis Obispo,079,281455,1152,751,7,758,2
2020-07-06,San Mateo,081,765935,4185,3650,6,3656,106
2020-07-06,Santa Barbara,083,443738,4523,3763,40,3803,27
2020-07-06,Santa Clara,085,1922200,7170,5369,19,5388,165
2020-07-06,Santa Cruz,087,273765,601,466,2,468,2
2020-07-06,Shasta,089,179085,261,143,1,144,6
2020-07-06,Sierra,091,2930,1,1,0,1,0
2020-07-06,Siskiyou,093,43540,50,30,0,30,0
2020-07-06,Solano,095,438530,2394,1668,8,1676,22
2020-07-06,Sonoma,097,501317,1921,1369,5,1374,8
2020-07-06,Stanislaus,099,539301,5622,3983,8,3991,46
2020-07-06,Sutter,101,95872,350,250,0,250,2
2020-07-06,Tehama,103,63373,122,95,2,97,1
2020-07-06,Trinity,105,12862,19,2,5,7,0
2020-07-06,Tulare,107,460477,6726,5039,15,5054,136
2020-07-06,Tuolumne,109,53932,72,30,3,33,0
2020-07-06,Ventura,111,848112,5404,3912,18,3930,44
2020-07-06,Yolo,113,214977,975,685,3,688,26
2020-07-06,Yuba,115,75493,147,124,0,124,1
2020-07-05,Alameda,001,1643700,8181,6861,10,6871,141
2020-07-05,Alpine,003,1148,1,1,0,1,0
2020-07-05,Amador,005,37829,37,31,0,31,0
2020-07-05,Butte,007,227075,396,248,11,259,2
2020-07-05,Calaveras,009,45235,69,45,0,45,0
2020-07-05,Colusa,011,21464,124,79,0,79,0
2020-07-05,Contra Costa,013,1133247,5025,3665,6,3671,80
2020-07-05,Del Norte,015,27424,60,57,0,57,0
2020-07-05,El Dorado,017,186661,384,227,3,230,0
2020-07-05,Fresno,019,978130,11999,6186,87,6273,82
2020-07-05,Glenn,021,27897,194,129,0,129,0
2020-07-05,Humboldt,023,135768,184,147,1,148,3
2020-07-05,Imperial,025,180216,8589,6441,4,6445,47
2020-07-05,Inyo,027,18085,35,32,1,33,1
2020-07-05,Kern,029,883053,11984,5351,37,5388,82
2020-07-05,Kings,031,150075,3066,2546,9,2555,31
2020-07-05,Lake,033,64148,122,92,0,92,1
2020-07-05,Lassen,035,31185,258,219,2,221,0
2020-07-05,Los Angeles,037,10098052,133660,115133,91,115224,3495
2020-07-05,Madera,039,155013,1269,564,3,567,4
2020-07-05,Marin,041,260295,3447,2080,4,2084,17
2020-07-05,Mariposa,043,17540,36,31,0,31,1
2020-07-05,Mendocino,045,87422,104,72,0,72,0
2020-07-05,Merced,047,269075,2349,1340,2,1342,10
2020-07-05,Modoc,049,8938,1,0,0,0,0
2020-07-05,Mono,051,14174,54,39,0,39,1
2020-07-05,Monterey,053,433212,2700,1994,7,2001,15
2020-07-05,Napa,055,140530,580,450,0,450,4
2020-07-05,Nevada,057,99092,186,141,5,146,1
2020-07-05,Orange,059,3164182,27516,19430,278,19708,372
2020-07-05,Placer,061,380077,1165,855,3,858,11
2020-07-05,Plumas,063,18699,16,11,0,11,0
2020-07-05,Riverside,065,2383286,27696,21511,28,21539,474
2020-07-05,Sacramento,067,1510023,5670,4265,6,4271,71
2020-07-05,San Benito,069,59416,348,258,0,258,2
2020-07-05,San Bernardino,071,2135413,23095,15026,16,15042,270
2020-07-05,San Diego,073,3302833,20634,16728,2,16730,387
2020-07-05,San Francisco,075,870044,4543,3861,1,3862,50
2020-07-05,San Joaquin,077,732212,7059,5015,4,5019,57
2020-07-05,San Luis Obispo,079,281455,1073,730,7,737,2
2020-07-05,San Mateo,081,765935,4075,3575,6,3581,106
2020-07-05,Santa Barbara,083,443738,4376,3671,37,3708,27
2020-07-05,Santa Clara,085,1922200,6877,5237,19,5256,162
2020-07-05,Santa Cruz,087,273765,583,467,0,467,2
2020-07-05,Shasta,089,179085,255,138,1,139,6
2020-07-05,Sierra,091,2930,1,1,0,1,0
2020-07-05,Siskiyou,093,43540,46,30,0,30,0
2020-07-05,Solano,095,438530,2274,1547,8,1555,22
2020-07-05,Sonoma,097,501317,1840,1369,5,1374,8
2020-07-05,Stanislaus,099,539301,5291,3777,7,3784,45
2020-07-05,Sutter,101,95872,322,241,0,241,2
2020-07-05,Tehama,103,63373,120,95,2,97,1
2020-07-05,Trinity,105,12862,19,2,5,7,0
2020-07-05,Tulare,107,460477,6467,4981,13,4994,135
2020-07-05,Tuolumne,109,53932,67,30,3,33,0
2020-07-05,Ventura,111,848112,5201,3866,18,3884,44
2020-07-05,Yolo,113,214977,935,644,3,647,26
2020-07-05,Yuba,115,75493,137,115,0,115,1
2020-07-04,Alameda,001,1643700,8069,6737,10,6747,141
2020-07-04,Alpine,003,1148,1,1,0,1,0
2020-07-04,Amador,005,37829,36,31,0,31,0
2020-07-04,Butte,007,227075,378,224,11,235,2
2020-07-04,Calaveras,009,45235,69,45,0,45,0
2020-07-04,Colusa,011,21464,123,76,0,76,0
2020-07-04,Contra Costa,013,1133247,4877,3583,6,3589,80
2020-07-04,Del Norte,015,27424,60,50,0,50,0
2020-07-04,El Dorado,017,186661,365,211,3,214,0
2020-07-04,Fresno,019,978130,11682,5999,85,6084,82
2020-07-04,Glenn,021,27897,187,128,0,128,0
2020-07-04,Humboldt,023,135768,177,144,1,145,3
2020-07-04,Imperial,025,180216,8540,6441,4,6445,47
2020-07-04,Inyo,027,18085,35,32,1,33,1
2020-07-04,Kern,029,883053,11680,5231,37,5268,81
2020-07-04,Kings,031,150075,3023,2509,9,2518,31
2020-07-04,Lake,033,64148,115,86,0,86,1
2020-07-04,Lassen,035,31185,258,219,2,221,0
2020-07-04,Los Angeles,037,10098052,131845,107256,80,107336,3462
2020-07-04,Madera,039,155013,1223,568,3,571,4
2020-07-04,Marin,041,260295,3418,1962,4,1966,17
2020-07-04,Mariposa,043,17540,36,28,0,28,1
2020-07-04,Mendocino,045,87422,104,72,0,72,0
2020-07-04,Merced,047,269075,2247,1252,2,1254,10
2020-07-04,Modoc,049,8938,1,0,0,0,0
2020-07-04,Mono,051,14174,54,37,0,37,1
2020-07-04,Monterey,053,433212,2620,1878,7,1885,15
2020-07-04,Napa,055,140530,571,426,0,426,4
2020-07-04,Nevada,057,99092,183,125,5,130,1
2020-07-04,Orange,059,3164182,27082,19247,265,19512,372
2020-07-04,Placer,061,380077,1130,796,3,799,11
2020-07-04,Plumas,063,18699,16,11,0,11,0
2020-07-04,Riverside,065,2383286,27330,21508,28,21536,474
2020-07-04,Sacramento,067,1510023,5499,4039,6,4045,71
2020-07-04,San Benito,069,59416,335,255,0,255,2
2020-07-04,San Bernardino,071,2135413,22670,14636,14,14650,270
2020-07-04,San Diego,073,3302833,20174,16166,2,16168,387
2020-07-04,San Francisco,075,870044,4451,3861,1,3862,50
2020-07-04,San Joaquin,077,732212,6847,4807,4,4811,57
2020-07-04,San Luis Obispo,079,281455,1033,699,7,706,2
2020-07-04,San Mateo,081,765935,4012,3532,6,3538,106
2020-07-04,Santa Barbara,083,443738,4301,3520,35,3555,27
2020-07-04,Santa Clara,085,1922200,6685,5045,18,5063,161
2020-07-04,Santa Cruz,087,273765,573,466,0,466,2
2020-07-04,Shasta,089,179085,252,135,1,136,6
2020-07-04,Sierra,091,2930,1,1,0,1,0
2020-07-04,Siskiyou,093,43540,39,30,0,30,0
2020-07-04,Solano,095,438530,2238,1548,8,1556,22
2020-07-04,Sonoma,097,501317,1814,1370,5,1375,8
2020-07-04,Stanislaus,099,539301,5133,3572,7,3579,44
2020-07-04,Sutter,101,95872,303,225,0,225,2
2020-07-04,Tehama,103,63373,117,92,2,94,1
2020-07-04,Trinity,105,12862,19,2,5,7,0
2020-07-04,Tulare,107,460477,6355,4802,13,4815,135
2020-07-04,Tuolumne,109,53932,63,30,3,33,0
2020-07-04,Ventura,111,848112,5077,3687,18,3705,44
2020-07-04,Yolo,113,214977,910,615,3,618,26
2020-07-04,Yuba,115,75493,130,102,0,102,1
2020-07-03,Alameda,001,1643700,7948,6486,10,6496,141
2020-07-03,Alpine,003,1148,1,1,0,1,0
2020-07-03,Amador,005,37829,36,25,0,25,0
2020-07-03,Butte,007,227075,366,212,11,223,2
2020-07-03,Calaveras,009,45235,69,44,0,44,0
2020-07-03,Colusa,011,21464,117,70,0,70,0
2020-07-03,Contra Costa,013,1133247,4743,3447,6,3453,78
2020-07-03,Del Norte,015,27424,60,50,0,50,0
2020-07-03,El Dorado,017,186661,353,201,3,204,0
2020-07-03,Fresno,019,978130,11377,5783,83,5866,81
2020-07-03,Glenn,021,27897,182,122,0,122,0
2020-07-03,Humboldt,023,135768,173,143,1,144,3
2020-07-03,Imperial,025,180216,8492,6345,4,6349,47
2020-07-03,Inyo,027,18085,35,32,1,33,1
2020-07-03,Kern,029,883053,11419,5213,37,5250,81
2020-07-03,Kings,031,150075,2987,2492,9,2501,31
2020-07-03,Lake,033,64148,108,83,0,83,0
2020-07-03,Lassen,035,31185,258,219,2,221,0
2020-07-03,Los Angeles,037,10098052,130332,107236,76,107312,3461
2020-07-03,Madera,039,155013,1178,565,3,568,4
2020-07-03,Marin,041,260295,3390,1776,4,1780,17
2020-07-03,Mariposa,043,17540,36,28,0,28,1
2020-07-03,Mendocino,045,87422,103,72,0,72,0
2020-07-03,Merced,047,269075,2181,1188,2,1190,10
2020-07-03,Modoc,049,8938,1,0,0,0,0
2020-07-03,Mono,051,14174,54,37,0,37,1
2020-07-03,Monterey,053,433212,2550,1804,7,1811,15
2020-07-03,Napa,055,140530,553,388,0,388,4
2020-07-03,Nevada,057,99092,182,125,5,130,1
2020-07-03,Orange,059,3164182,26691,18819,257,19076,366
2020-07-03,Placer,061,380077,1103,745,3,748,11
2020-07-03,Plumas,063,18699,16,11,0,11,0
2020-07-03,Riverside,065,2383286,27024,21171,28,21199,472
2020-07-03,Sacramento,067,1510023,5365,3711,6,3717,71
2020-07-03,San Benito,069,59416,328,243,0,243,2
2020-07-03,San Bernardino,071,2135413,22282,14040,14,14054,269
2020-07-03,San Diego,073,3302833,19719,15698,2,15700,387
2020-07-03,San Francisco,075,870044,4405,3781,1,3782,50
2020-07-03,San Joaquin,077,732212,6708,4416,3,4419,56
2020-07-03,San Luis Obispo,079,281455,998,676,7,683,2
2020-07-03,San Mateo,081,765935,3955,3439,6,3445,106
2020-07-03,Santa Barbara,083,443738,4214,3406,34,3440,27
2020-07-03,Santa Clara,085,1922200,6573,4820,18,4838,161
2020-07-03,Santa Cruz,087,273765,559,436,0,436,2
2020-07-03,Shasta,089,179085,244,113,1,114,6
2020-07-03,Sierra,091,2930,1,1,0,1,0
2020-07-03,Siskiyou,093,43540,36,30,0,30,0
2020-07-03,Solano,095,438530,2194,1496,7,1503,22
2020-07-03,Sonoma,097,501317,1766,1282,5,1287,8
2020-07-03,Stanislaus,099,539301,5009,3021,7,3028,43
2020-07-03,Sutter,101,95872,293,205,0,205,2
2020-07-03,Tehama,103,63373,115,89,2,91,1
2020-07-03,Trinity,105,12862,19,2,5,7,0
2020-07-03,Tulare,107,460477,6240,4656,13,4669,134
2020-07-03,Tuolumne,109,53932,61,27,3,30,0
2020-07-03,Ventura,111,848112,4981,3536,18,3554,44
2020-07-03,Yolo,113,214977,876,586,3,589,25
2020-07-03,Yuba,115,75493,125,96,0,96,1
2020-07-02,Alameda,001,1643700,7822,6386,10,6396,139
2020-07-02,Alpine,003,1148,1,1,0,1,0
2020-07-02,Amador,005,37829,35,23,0,23,0
2020-07-02,Butte,007,227075,349,199,11,210,2
2020-07-02,Calaveras,009,45235,65,42,0,42,0
2020-07-02,Colusa,011,21464,109,60,0,60,0
2020-07-02,Contra Costa,013,1133247,4560,3347,6,3353,77
2020-07-02,Del Norte,015,27424,59,50,0,50,0
2020-07-02,El Dorado,017,186661,342,193,3,196,0
2020-07-02,Fresno,019,978130,10917,5402,82,5484,78
2020-07-02,Glenn,021,27897,176,114,0,114,0
2020-07-02,Humboldt,023,135768,169,138,1,139,3
2020-07-02,Imperial,025,180216,8391,6236,4,6240,47
2020-07-02,Inyo,027,18085,35,29,1,30,1
2020-07-02,Kern,029,883053,10884,5036,35,5071,78
2020-07-02,Kings,031,150075,2936,2419,9,2428,31
2020-07-02,Lake,033,64148,104,81,0,81,0
2020-07-02,Lassen,035,31185,256,218,2,220,0
2020-07-02,Los Angeles,037,10098052,128315,107144,53,107197,3458
2020-07-02,Madera,039,155013,1110,548,3,551,4
2020-07-02,Marin,041,260295,3304,1706,4,1710,17
2020-07-02,Mariposa,043,17540,35,28,0,28,1
2020-07-02,Mendocino,045,87422,99,71,0,71,0
2020-07-02,Merced,047,269075,2084,1122,2,1124,10
2020-07-02,Modoc,049,8938,1,0,0,0,0
2020-07-02,Mono,051,14174,54,37,0,37,1
2020-07-02,Monterey,053,433212,2490,1796,7,1803,15
2020-07-02,Napa,055,140530,536,352,0,352,4
2020-07-02,Nevada,057,99092,176,118,4,122,1
2020-07-02,Orange,059,3164182,25928,17056,244,17300,360
2020-07-02,Placer,061,380077,1079,740,3,743,11
2020-07-02,Plumas,063,18699,15,8,0,8,0
2020-07-02,Riverside,065,2383286,26451,20253,28,20281,458
2020-07-02,Sacramento,067,1510023,5138,3587,6,3593,70
2020-07-02,San Benito,069,59416,320,236,0,236,2
2020-07-02,San Bernardino,071,2135413,21746,13185,14,13199,260
2020-07-02,San Diego,073,3302833,19254,15208,2,15210,377
2020-07-02,San Francisco,075,870044,4310,3676,1,3677,50
2020-07-02,San Joaquin,077,732212,6361,4243,3,4246,56
2020-07-02,San Luis Obispo,079,281455,953,659,7,666,2
2020-07-02,San Mateo,081,765935,3875,3390,6,3396,107
2020-07-02,Santa Barbara,083,443738,4114,3385,32,3417,27
2020-07-02,Santa Clara,085,1922200,6447,4722,18,4740,160
2020-07-02,Santa Cruz,087,273765,536,414,0,414,2
2020-07-02,Shasta,089,179085,241,110,1,111,5
2020-07-02,Sierra,091,2930,1,1,0,1,0
2020-07-02,Siskiyou,093,43540,36,30,0,30,0
2020-07-02,Solano,095,438530,2111,1429,7,1436,21
2020-07-02,Sonoma,097,501317,1708,1244,5,1249,6
2020-07-02,Stanislaus,099,539301,4837,2850,7,2857,41
2020-07-02,Sutter,101,95872,282,195,0,195,2
2020-07-02,Tehama,103,63373,113,86,2,88,1
2020-07-02,Trinity,105,12862,19,2,5,7,0
2020-07-02,Tulare,107,460477,6073,4559,12,4571,132
2020-07-02,Tuolumne,109,53932,58,23,2,25,0
2020-07-02,Ventura,111,848112,4825,3394,18,3412,42
2020-07-02,Yolo,113,214977,844,554,3,557,24
2020-07-02,Yuba,115,75493,115,93,0,93,1
2020-07-01,Alameda,001,1643700,7600,6125,10,6135,137
2020-07-01,Alpine,003,1148,1,1,0,1,0
2020-07-01,Amador,005,37829,34,22,0,22,0
2020-07-01,Butte,007,227075,324,185,11,196,2
2020-07-01,Calaveras,009,45235,63,37,0,37,0
2020-07-01,Colusa,011,21464,103,53,0,53,0
2020-07-01,Contra Costa,013,1133247,4348,3259,6,3265,76
2020-07-01,Del Norte,015,27424,59,50,0,50,0
2020-07-01,El Dorado,017,186661,315,183,3,186,0
2020-07-01,Fresno,019,978130,10483,5111,79,5190,76
2020-07-01,Glenn,021,27897,170,110,0,110,0
2020-07-01,Humboldt,023,135768,164,134,0,134,3
2020-07-01,Imperial,025,180216,8294,6150,4,6154,46
2020-07-01,Inyo,027,18085,34,30,1,31,1
2020-07-01,Kern,029,883053,10251,4853,34,4887,78
2020-07-01,Kings,031,150075,2868,2360,9,2369,30
2020-07-01,Lake,033,64148,103,75,0,75,0
2020-07-01,Lassen,035,31185,255,217,2,219,0
2020-07-01,Los Angeles,037,10098052,125115,105325,44,105369,3408
2020-07-01,Madera,039,155013,1069,519,3,522,4
2020-07-01,Marin,041,260295,3147,1636,4,1640,17
2020-07-01,Mariposa,043,17540,35,29,0,29,1
2020-07-01,Mendocino,045,87422,95,70,0,70,0
2020-07-01,Merced,047,269075,1986,1052,2,1054,10
2020-07-01,Modoc,049,8938,1,0,0,0,0
2020-07-01,Mono,051,14174,51,37,0,37,1
2020-07-01,Monterey,053,433212,2382,1703,6,1709,15
2020-07-01,Napa,055,140530,513,347,0,347,4
2020-07-01,Nevada,057,99092,166,115,4,119,1
2020-07-01,Orange,059,3164182,25043,15662,223,15885,343
2020-07-01,Placer,061,380077,1032,713,3,716,11
2020-07-01,Plumas,063,18699,13,8,0,8,0
2020-07-01,Riverside,065,2383286,25609,19537,27,19564,457
2020-07-01,Sacramento,067,1510023,4883,3425,6,3431,64
2020-07-01,San Benito,069,59416,311,219,0,219,2
2020-07-01,San Bernardino,071,2135413,20851,12712,11,12723,253
2020-07-01,San Diego,073,3302833,18686,14624,2,14626,372
2020-07-01,San Francisco,075,870044,4217,3626,1,3627,50
2020-07-01,San Joaquin,077,732212,6003,3990,3,3993,54
2020-07-01,San Luis Obispo,079,281455,926,613,7,620,1
2020-07-01,San Mateo,081,765935,3813,3326,6,3332,84
2020-07-01,Santa Barbara,083,443738,3994,3268,31,3299,27
2020-07-01,Santa Clara,085,1922200,6259,4547,17,4564,159
2020-07-01,Santa Cruz,087,273765,512,398,0,398,2
2020-07-01,Shasta,089,179085,236,104,1,105,5
2020-07-01,Sierra,091,2930,1,1,0,1,0
2020-07-01,Siskiyou,093,43540,36,28,0,28,0
2020-07-01,Solano,095,438530,2022,1350,7,1357,21
2020-07-01,Sonoma,097,501317,1613,1178,5,1183,6
2020-07-01,Stanislaus,099,539301,4558,2619,7,2626,41
2020-07-01,Sutter,101,95872,269,188,0,188,2
2020-07-01,Tehama,103,63373,106,80,2,82,1
2020-07-01,Trinity,105,12862,19,2,4,6,0
2020-07-01,Tulare,107,460477,5895,4359,12,4371,128
2020-07-01,Tuolumne,109,53932,55,17,2,19,0
2020-07-01,Ventura,111,848112,4683,3224,16,3240,41
2020-07-01,Yolo,113,214977,793,526,3,529,24
2020-07-01,Yuba,115,75493,110,57,0,57,1
2020-06-30,Alameda,001,1643700,7351,5959,8,5967,137
2020-06-30,Alpine,003,1148,1,1,0,1,0
2020-06-30,Amador,005,37829,34,21,0,21,0
2020-06-30,Butte,007,227075,307,163,11,174,2
2020-06-30,Calaveras,009,45235,58,31,0,31,0
2020-06-30,Colusa,011,21464,94,33,0,33,0
2020-06-30,Contra Costa,013,1133247,4141,3140,6,3146,75
2020-06-30,Del Norte,015,27424,59,48,0,48,0
2020-06-30,El Dorado,017,186661,302,175,3,178,0
2020-06-30,Fresno,019,978130,10036,4826,74,4900,75
2020-06-30,Glenn,021,27897,165,96,0,96,0
2020-06-30,Humboldt,023,135768,160,132,0,132,3
2020-06-30,Imperial,025,180216,8195,5968,4,5972,45
2020-06-30,Inyo,027,18085,34,30,1,31,1
2020-06-30,Kern,029,883053,9604,4721,31,4752,75
2020-06-30,Kings,031,150075,2819,2315,6,2321,30
2020-06-30,Lake,033,64148,95,56,0,56,0
2020-06-30,Lassen,035,31185,248,215,2,217,0
2020-06-30,Los Angeles,037,10098052,121531,103640,41,103681,3378
2020-06-30,Madera,039,155013,1012,475,3,478,4
2020-06-30,Marin,041,260295,3076,1614,4,1618,17
2020-06-30,Mariposa,043,17540,34,27,0,27,1
2020-06-30,Mendocino,045,87422,90,65,0,65,0
2020-06-30,Merced,047,269075,1849,970,2,972,10
2020-06-30,Modoc,049,8938,1,0,0,0,0
2020-06-30,Mono,051,14174,49,36,0,36,1
2020-06-30,Monterey,053,433212,2285,1657,6,1663,15
2020-06-30,Napa,055,140530,488,342,0,342,4
2020-06-30,Nevada,057,99092,158,113,4,117,1
2020-06-30,Orange,059,3164182,24112,14354,213,14567,335
2020-06-30,Placer,061,380077,1005,667,3,670,11
2020-06-30,Plumas,063,18699,12,8,0,8,0
2020-06-30,Riverside,065,2383286,24892,18656,26,18682,449
2020-06-30,Sacramento,067,1510023,4594,3246,6,3252,64
2020-06-30,San Benito,069,59416,300,200,0,200,2
2020-06-30,San Bernardino,071,2135413,19869,12375,10,12385,249
2020-06-30,San Diego,073,3302833,17981,14150,2,14152,365
2020-06-30,San Francisco,075,870044,4112,3555,1,3556,50
2020-06-30,San Joaquin,077,732212,5628,3744,3,3747,52
2020-06-30,San Luis Obispo,079,281455,888,583,7,590,1
2020-06-30,San Mateo,081,765935,3735,3268,6,3274,84
2020-06-30,Santa Barbara,083,443738,3878,3102,31,3133,25
2020-06-30,Santa Clara,085,1922200,6057,4346,17,4363,157
2020-06-30,Santa Cruz,087,273765,486,379,0,379,2
2020-06-30,Shasta,089,179085,220,100,1,101,5
2020-06-30,Sierra,091,2930,1,1,0,1,0
2020-06-30,Siskiyou,093,43540,35,26,0,26,0
2020-06-30,Solano,095,438530,1930,1256,7,1263,21
2020-06-30,Sonoma,097,501317,1549,1122,5,1127,6
2020-06-30,Stanislaus,099,539301,4261,2578,7,2585,41
2020-06-30,Sutter,101,95872,246,168,0,168,2
2020-06-30,Tehama,103,63373,104,75,2,77,1
2020-06-30,Trinity,105,12862,19,2,4,6,0
2020-06-30,Tulare,107,460477,5686,4207,12,4219,117
2020-06-30,Tuolumne,109,53932,51,16,2,18,0
2020-06-30,Ventura,111,848112,4549,3030,16,3046,40
2020-06-30,Yolo,113,214977,755,515,3,518,24
2020-06-30,Yuba,115,75493,106,55,0,55,1
2020-06-29,Alameda,001,1643700,7142,5766,8,5774,135
2020-06-29,Alpine,003,1148,1,1,0,1,0
2020-06-29,Amador,005,37829,31,20,0,20,0
2020-06-29,Butte,007,227075,286,157,11,168,2
2020-06-29,Calaveras,009,45235,56,30,0,30,0
2020-06-29,Colusa,011,21464,89,17,0,17,0
2020-06-29,Contra Costa,013,1133247,3978,2976,5,2981,75
2020-06-29,Del Norte,015,27424,59,47,0,47,0
2020-06-29,El Dorado,017,186661,288,163,1,164,0
2020-06-29,Fresno,019,978130,9688,4531,72,4603,74
2020-06-29,Glenn,021,27897,156,77,0,77,0
2020-06-29,Humboldt,023,135768,159,128,0,128,3
2020-06-29,Imperial,025,180216,8064,5512,4,5516,45
2020-06-29,Inyo,027,18085,33,29,0,29,1
2020-06-29,Kern,029,883053,8941,4613,29,4642,73
2020-06-29,Kings,031,150075,2754,2280,6,2286,20
2020-06-29,Lake,033,64148,88,53,0,53,0
2020-06-29,Lassen,035,31185,240,77,2,79,0
2020-06-29,Los Angeles,037,10098052,118491,100846,35,100881,3337
2020-06-29,Madera,039,155013,955,422,3,425,4
2020-06-29,Marin,041,260295,3000,1517,4,1521,17
2020-06-29,Mariposa,043,17540,32,25,0,25,1
2020-06-29,Mendocino,045,87422,87,63,0,63,0
2020-06-29,Merced,047,269075,1743,848,2,850,10
2020-06-29,Modoc,049,8938,1,0,0,0,0
2020-06-29,Mono,051,14174,47,35,0,35,1
2020-06-29,Monterey,053,433212,2213,1614,6,1620,14
2020-06-29,Napa,055,140530,466,317,0,317,4
2020-06-29,Nevada,057,99092,155,107,3,110,1
2020-06-29,Orange,059,3164182,23122,13682,198,13880,324
2020-06-29,Placer,061,380077,969,628,3,631,11
2020-06-29,Plumas,063,18699,12,6,0,6,0
2020-06-29,Riverside,065,2383286,23858,17683,26,17709,432
2020-06-29,Sacramento,067,1510023,4307,2985,6,2991,62
2020-06-29,San Benito,069,59416,285,193,0,193,2
2020-06-29,San Bernardino,071,2135413,18907,11643,10,11653,245
2020-06-29,San Diego,073,3302833,17403,13834,2,13836,361
2020-06-29,San Francisco,075,870044,4035,3389,1,3390,50
2020-06-29,San Joaquin,077,732212,5270,3202,3,3205,52
2020-06-29,San Luis Obispo,079,281455,854,544,7,551,1
2020-06-29,San Mateo,081,765935,3681,3170,6,3176,84
2020-06-29,Santa Barbara,083,443738,3769,2933,30,2963,25
2020-06-29,Santa Clara,085,1922200,5886,4231,17,4248,157
2020-06-29,Santa Cruz,087,273765,468,348,0,348,2
2020-06-29,Shasta,089,179085,212,94,1,95,5
2020-06-29,Sierra,091,2930,1,1,0,1,0
2020-06-29,Siskiyou,093,43540,35,25,0,25,0
2020-06-29,Solano,095,438530,1828,1077,7,1084,21
2020-06-29,Sonoma,097,501317,1477,1103,5,1108,5
2020-06-29,Stanislaus,099,539301,4055,2400,6,2406,36
2020-06-29,Sutter,101,95872,224,152,0,152,2
2020-06-29,Tehama,103,63373,100,63,2,65,1
2020-06-29,Trinity,105,12862,18,2,4,6,0
2020-06-29,Tulare,107,460477,5531,3906,11,3917,117
2020-06-29,Tuolumne,109,53932,47,16,2,18,0
2020-06-29,Ventura,111,848112,4402,2794,16,2810,40
2020-06-29,Yolo,113,214977,722,483,3,486,24
2020-06-29,Yuba,115,75493,93,55,0,55,1
2020-06-28,Alameda,001,1643700,6883,5698,8,5706,135
2020-06-28,Alpine,003,1148,1,1,0,1,0
2020-06-28,Amador,005,37829,29,20,0,20,0
2020-06-28,Butte,007,227075,266,150,11,161,2
2020-06-28,Calaveras,009,45235,51,30,0,30,0
2020-06-28,Colusa,011,21464,74,17,0,17,0
2020-06-28,Contra Costa,013,1133247,3787,2803,4,2807,73
2020-06-28,Del Norte,015,27424,58,47,0,47,0
2020-06-28,El Dorado,017,186661,276,162,1,163,0
2020-06-28,Fresno,019,978130,9325,4365,72,4437,74
2020-06-28,Glenn,021,27897,148,77,0,77,0
2020-06-28,Humboldt,023,135768,156,127,0,127,3
2020-06-28,Imperial,025,180216,7875,5513,4,5517,45
2020-06-28,Inyo,027,18085,33,29,0,29,1
2020-06-28,Kern,029,883053,8390,4541,27,4568,72
2020-06-28,Kings,031,150075,2694,2234,6,2240,18
2020-06-28,Lake,033,64148,84,53,0,53,0
2020-06-28,Lassen,035,31185,240,77,2,79,0
2020-06-28,Los Angeles,037,10098052,115288,98003,31,98034,3316
2020-06-28,Madera,039,155013,907,424,3,427,4
2020-06-28,Marin,041,260295,2654,1473,4,1477,17
2020-06-28,Mariposa,043,17540,32,24,0,24,1
2020-06-28,Mendocino,045,87422,85,63,0,63,0
2020-06-28,Merced,047,269075,1630,814,2,816,10
2020-06-28,Modoc,049,8938,1,0,0,0,0
2020-06-28,Mono,051,14174,47,35,0,35,1
2020-06-28,Monterey,053,433212,2131,1560,6,1566,13
2020-06-28,Napa,055,140530,432,307,0,307,4
2020-06-28,Nevada,057,99092,144,102,3,105,1
2020-06-28,Orange,059,3164182,22148,13213,180,13393,324
2020-06-28,Placer,061,380077,930,618,3,621,11
2020-06-28,Plumas,063,18699,11,6,0,6,0
2020-06-28,Riverside,065,2383286,23030,16848,25,16873,432
2020-06-28,Sacramento,067,1510023,4079,2803,6,2809,63
2020-06-28,San Benito,069,59416,274,190,0,190,2
2020-06-28,San Bernardino,071,2135413,18154,11344,9,11353,245
2020-06-28,San Diego,073,3302833,16858,13333,2,13335,361
2020-06-28,San Francisco,075,870044,3957,3388,1,3389,50
2020-06-28,San Joaquin,077,732212,4933,3201,3,3204,52
2020-06-28,San Luis Obispo,079,281455,815,531,6,537,1
2020-06-28,San Mateo,081,765935,3604,3124,5,3129,84
2020-06-28,Santa Barbara,083,443738,3624,2872,30,2902,25
2020-06-28,Santa Clara,085,1922200,5724,4131,17,4148,156
2020-06-28,Santa Cruz,087,273765,445,349,0,349,2
2020-06-28,Shasta,089,179085,199,89,0,89,5
2020-06-28,Sierra,091,2930,1,1,0,1,0
2020-06-28,Siskiyou,093,43540,35,25,0,25,0
2020-06-28,Solano,095,438530,1753,1077,7,1084,21
2020-06-28,Sonoma,097,501317,1423,1084,5,1089,5
2020-06-28,Stanislaus,099,539301,3849,2376,6,2382,36
2020-06-28,Sutter,101,95872,198,145,0,145,2
2020-06-28,Tehama,103,63373,93,63,2,65,1
2020-06-28,Trinity,105,12862,17,2,4,6,0
2020-06-28,Tulare,107,460477,5363,3812,11,3823,117
2020-06-28,Tuolumne,109,53932,42,14,2,16,0
2020-06-28,Ventura,111,848112,4244,2650,16,2666,40
2020-06-28,Yolo,113,214977,687,468,3,471,24
2020-06-28,Yuba,115,75493,89,39,0,39,1
2020-06-27,Alameda,001,1643700,6787,5581,8,5589,135
2020-06-27,Alpine,003,1148,1,1,0,1,0
2020-06-27,Amador,005,37829,27,20,0,20,0
2020-06-27,Butte,007,227075,258,137,11,148,2
2020-06-27,Calaveras,009,45235,49,30,0,30,0
2020-06-27,Colusa,011,21464,68,17,0,17,0
2020-06-27,Contra Costa,013,1133247,3693,2717,3,2720,72
2020-06-27,Del Norte,015,27424,58,47,0,47,0
2020-06-27,El Dorado,017,186661,270,159,1,160,0
2020-06-27,Fresno,019,978130,9079,4238,72,4310,74
2020-06-27,Glenn,021,27897,144,77,0,77,0
2020-06-27,Humboldt,023,135768,154,127,0,127,3
2020-06-27,Imperial,025,180216,7814,5513,4,5517,45
2020-06-27,Inyo,027,18085,33,29,0,29,1
2020-06-27,Kern,029,883053,8127,4411,26,4437,70
2020-06-27,Kings,031,150075,2668,2187,6,2193,18
2020-06-27,Lake,033,64148,81,42,0,42,0
2020-06-27,Lassen,035,31185,240,33,2,35,0
2020-06-27,Los Angeles,037,10098052,113547,95341,28,95369,3291
2020-06-27,Madera,039,155013,864,427,2,429,4
2020-06-27,Marin,041,260295,2609,1423,4,1427,17
2020-06-27,Mariposa,043,17540,31,22,0,22,1
2020-06-27,Mendocino,045,87422,85,63,0,63,0
2020-06-27,Merced,047,269075,1572,807,1,808,10
2020-06-27,Modoc,049,8938,1,0,0,0,0
2020-06-27,Mono,051,14174,46,35,0,35,1
2020-06-27,Monterey,053,433212,2067,1455,6,1461,12
2020-06-27,Napa,055,140530,422,282,0,282,3
2020-06-27,Nevada,057,99092,140,102,2,104,1
2020-06-27,Orange,059,3164182,21637,12951,175,13126,320
2020-06-27,Placer,061,380077,909,584,3,587,10
2020-06-27,Plumas,063,18699,11,6,0,6,0
2020-06-27,Riverside,065,2383286,22641,16209,25,16234,432
2020-06-27,Sacramento,067,1510023,3962,2685,6,2691,63
2020-06-27,San Benito,069,59416,267,182,0,182,2
2020-06-27,San Bernardino,071,2135413,17778,11238,9,11247,243
2020-06-27,San Diego,073,3302833,16493,12836,2,12838,360
2020-06-27,San Francisco,075,870044,3902,3332,1,3333,49
2020-06-27,San Joaquin,077,732212,4767,2995,3,2998,52
2020-06-27,San Luis Obispo,079,281455,792,505,6,511,1
2020-06-27,San Mateo,081,765935,3547,3083,5,3088,83
2020-06-27,Santa Barbara,083,443738,3552,2799,30,2829,25
2020-06-27,Santa Clara,085,1922200,5618,4006,17,4023,157
2020-06-27,Santa Cruz,087,273765,438,347,0,347,2
2020-06-27,Shasta,089,179085,193,87,0,87,5
2020-06-27,Sierra,091,2930,1,1,0,1,0
2020-06-27,Siskiyou,093,43540,35,25,0,25,0
2020-06-27,Solano,095,438530,1720,1076,7,1083,21
2020-06-27,Sonoma,097,501317,1391,1004,5,1009,5
2020-06-27,Stanislaus,099,539301,3749,2164,6,2170,36
2020-06-27,Sutter,101,95872,191,141,0,141,2
2020-06-27,Tehama,103,63373,90,63,2,65,1
2020-06-27,Trinity,105,12862,17,2,4,6,0
2020-06-27,Tulare,107,460477,5267,3810,11,3821,117
2020-06-27,Tuolumne,109,53932,41,13,2,15,0
2020-06-27,Ventura,111,848112,4144,2471,16,2487,40
2020-06-27,Yolo,113,214977,663,432,3,435,24
2020-06-27,Yuba,115,75493,81,39,0,39,1
2020-06-26,Alameda,001,1643700,6701,5502,7,5509,132
2020-06-26,Alpine,003,1148,1,1,0,1,0
2020-06-26,Amador,005,37829,26,20,0,20,0
2020-06-26,Butte,007,227075,243,135,11,146,2
2020-06-26,Calaveras,009,45235,47,30,0,30,0
2020-06-26,Colusa,011,21464,63,17,0,17,0
2020-06-26,Contra Costa,013,1133247,3581,2676,3,2679,72
2020-06-26,Del Norte,015,27424,57,47,0,47,0
2020-06-26,El Dorado,017,186661,262,159,1,160,0
2020-06-26,Fresno,019,978130,8853,4166,72,4238,74
2020-06-26,Glenn,021,27897,137,71,0,71,0
2020-06-26,Humboldt,023,135768,152,126,0,126,3
2020-06-26,Imperial,025,180216,7751,5400,4,5404,44
2020-06-26,Inyo,027,18085,32,29,0,29,1
2020-06-26,Kern,029,883053,7797,4366,26,4392,70
2020-06-26,Kings,031,150075,2636,2176,5,2181,18
2020-06-26,Lake,033,64148,80,42,0,42,0
2020-06-26,Lassen,035,31185,239,30,2,32,0
2020-06-26,Los Angeles,037,10098052,111381,93328,28,93356,3275
2020-06-26,Madera,039,155013,832,409,2,411,4
2020-06-26,Marin,041,260295,2572,1406,4,1410,17
2020-06-26,Mariposa,043,17540,30,21,0,21,1
2020-06-26,Mendocino,045,87422,82,63,0,63,0
2020-06-26,Merced,047,269075,1526,797,1,798,10
2020-06-26,Modoc,049,8938,1,0,0,0,0
2020-06-26,Mono,051,14174,45,35,0,35,1
2020-06-26,Monterey,053,433212,2015,1449,6,1455,12
2020-06-26,Napa,055,140530,412,277,0,277,3
2020-06-26,Nevada,057,99092,136,101,1,102,1
2020-06-26,Orange,059,3164182,20961,12659,172,12831,320
2020-06-26,Placer,061,380077,880,584,3,587,10
2020-06-26,Plumas,063,18699,11,6,0,6,0
2020-06-26,Riverside,065,2383286,22178,15858,25,15883,430
2020-06-26,Sacramento,067,1510023,3797,2687,6,2693,63
2020-06-26,San Benito,069,59416,263,176,0,176,2
2020-06-26,San Bernardino,071,2135413,17400,11111,9,11120,243
2020-06-26,San Diego,073,3302833,16128,12402,2,12404,358
2020-06-26,San Francisco,075,870044,3847,3330,1,3331,49
2020-06-26,San Joaquin,077,732212,4553,2943,3,2946,52
2020-06-26,San Luis Obispo,079,281455,777,498,6,504,1
2020-06-26,San Mateo,081,765935,3495,3055,5,3060,83
2020-06-26,Santa Barbara,083,443738,3462,2784,28,2812,25
2020-06-26,Santa Clara,085,1922200,5517,3968,17,3985,156
2020-06-26,Santa Cruz,087,273765,431,344,0,344,2
2020-06-26,Shasta,089,179085,186,86,0,86,5
2020-06-26,Sierra,091,2930,1,1,0,1,0
2020-06-26,Siskiyou,093,43540,34,24,0,24,0
2020-06-26,Solano,095,438530,1678,1068,7,1075,21
2020-06-26,Sonoma,097,501317,1360,977,5,982,5
2020-06-26,Stanislaus,099,539301,3636,2157,6,2163,36
2020-06-26,Sutter,101,95872,184,138,0,138,2
2020-06-26,Tehama,103,63373,87,63,2,65,1
2020-06-26,Trinity,105,12862,17,2,4,6,0
2020-06-26,Tulare,107,460477,5178,3720,11,3731,117
2020-06-26,Tuolumne,109,53932,39,10,2,12,0
2020-06-26,Ventura,111,848112,4058,2444,16,2460,40
2020-06-26,Yolo,113,214977,640,418,3,421,24
2020-06-26,Yuba,115,75493,75,38,0,38,1
2020-06-25,Alameda,001,1643700,6512,5398,7,5405,130
2020-06-25,Alpine,003,1148,1,1,0,1,0
2020-06-25,Amador,005,37829,25,18,0,18,0
2020-06-25,Butte,007,227075,238,127,11,138,1
2020-06-25,Calaveras,009,45235,42,26,0,26,0
2020-06-25,Colusa,011,21464,53,14,0,14,0
2020-06-25,Contra Costa,013,1133247,3396,2591,3,2594,71
2020-06-25,Del Norte,015,27424,55,47,0,47,0
2020-06-25,El Dorado,017,186661,254,150,1,151,0
2020-06-25,Fresno,019,978130,8540,3938,71,4009,71
2020-06-25,Glenn,021,27897,132,59,0,59,0
2020-06-25,Humboldt,023,135768,151,121,0,121,3
2020-06-25,Imperial,025,180216,7622,5192,4,5196,44
2020-06-25,Inyo,027,18085,29,27,0,27,1
2020-06-25,Kern,029,883053,7373,4236,23,4259,69
2020-06-25,Kings,031,150075,2584,2110,5,2115,17
2020-06-25,Lake,033,64148,79,42,0,42,0
2020-06-25,Lassen,035,31185,233,13,2,15,0
2020-06-25,Los Angeles,037,10098052,108612,91524,28,91552,3239
2020-06-25,Madera,039,155013,788,380,2,382,4
2020-06-25,Marin,041,260295,2470,1321,4,1325,17
2020-06-25,Mariposa,043,17540,29,20,0,20,1
2020-06-25,Mendocino,045,87422,79,61,0,61,0
2020-06-25,Merced,047,269075,1439,747,1,748,10
2020-06-25,Modoc,049,8938,1,0,0,0,0
2020-06-25,Mono,051,14174,44,35,0,35,1
2020-06-25,Monterey,053,433212,1927,1426,5,1431,12
2020-06-25,Napa,055,140530,394,260,0,260,3
2020-06-25,Nevada,057,99092,128,92,1,93,1
2020-06-25,Orange,059,3164182,20040,12221,170,12391,311
2020-06-25,Placer,061,380077,826,574,3,577,10
2020-06-25,Plumas,063,18699,10,6,0,6,0
2020-06-25,Riverside,065,2383286,21423,15224,25,15249,427
2020-06-25,Sacramento,067,1510023,3574,2519,6,2525,62
2020-06-25,San Benito,069,59416,255,174,0,174,2
2020-06-25,San Bernardino,071,2135413,16648,10590,9,10599,242
2020-06-25,San Diego,073,3302833,15589,11963,2,11965,352
2020-06-25,San Francisco,075,870044,3781,3252,1,3253,48
2020-06-25,San Joaquin,077,732212,4281,2803,3,2806,50
2020-06-25,San Luis Obispo,079,281455,745,473,6,479,1
2020-06-25,San Mateo,081,765935,3427,2996,4,3000,82
2020-06-25,Santa Barbara,083,443738,3357,2622,27,2649,25
2020-06-25,Santa Clara,085,1922200,5368,3871,17,3888,156
2020-06-25,Santa Cruz,087,273765,419,335,0,335,2
2020-06-25,Shasta,089,179085,176,84,0,84,5
2020-06-25,Sierra,091,2930,1,1,0,1,0
2020-06-25,Siskiyou,093,43540,33,24,0,24,0
2020-06-25,Solano,095,438530,1625,1034,7,1041,21
2020-06-25,Sonoma,097,501317,1311,953,4,957,5
2020-06-25,Stanislaus,099,539301,3424,2130,6,2136,36
2020-06-25,Sutter,101,95872,172,126,0,126,2
2020-06-25,Tehama,103,63373,83,59,2,61,1
2020-06-25,Trinity,105,12862,17,2,4,6,0
2020-06-25,Tulare,107,460477,5047,3656,11,3667,117
2020-06-25,Tuolumne,109,53932,38,10,1,11,0
2020-06-25,Ventura,111,848112,3876,2346,15,2361,40
2020-06-25,Yolo,113,214977,611,397,3,400,24
2020-06-25,Yuba,115,75493,64,38,0,38,1
2020-06-24,Alameda,001,1643700,6350,5242,7,5249,123
2020-06-24,Alpine,003,1148,1,1,0,1,0
2020-06-24,Amador,005,37829,23,16,0,16,0
2020-06-24,Butte,007,227075,222,119,10,129,1
2020-06-24,Calaveras,009,45235,40,26,0,26,0
2020-06-24,Colusa,011,21464,44,11,0,11,0
2020-06-24,Contra Costa,013,1133247,3240,2520,3,2523,66
2020-06-24,Del Norte,015,27424,49,47,0,47,0
2020-06-24,El Dorado,017,186661,238,149,1,150,0
2020-06-24,Fresno,019,978130,8209,3765,71,3836,71
2020-06-24,Glenn,021,27897,124,54,0,54,0
2020-06-24,Humboldt,023,135768,151,117,0,117,3
2020-06-24,Imperial,025,180216,7504,5138,4,5142,38
2020-06-24,Inyo,027,18085,29,28,0,28,1
2020-06-24,Kern,029,883053,6980,4155,21,4176,67
2020-06-24,Kings,031,150075,2520,2063,5,2068,16
2020-06-24,Lake,033,64148,66,40,0,40,0
2020-06-24,Lassen,035,31185,232,9,2,11,0
2020-06-24,Los Angeles,037,10098052,105849,89566,28,89594,3186
2020-06-24,Madera,039,155013,766,373,2,375,4
2020-06-24,Marin,041,260295,2242,1261,4,1265,17
2020-06-24,Mariposa,043,17540,28,19,0,19,1
2020-06-24,Mendocino,045,87422,79,60,0,60,0
2020-06-24,Merced,047,269075,1353,696,1,697,8
2020-06-24,Modoc,049,8938,1,0,0,0,0
2020-06-24,Mono,051,14174,42,35,0,35,1
2020-06-24,Monterey,053,433212,1850,1407,5,1412,12
2020-06-24,Napa,055,140530,377,258,0,258,3
2020-06-24,Nevada,057,99092,122,92,1,93,1
2020-06-24,Orange,059,3164182,19043,11804,152,11956,303
2020-06-24,Placer,061,380077,787,548,3,551,10
2020-06-24,Plumas,063,18699,10,6,0,6,0
2020-06-24,Riverside,065,2383286,20576,14946,25,14971,410
2020-06-24,Sacramento,067,1510023,3370,2446,5,2451,62
2020-06-24,San Benito,069,59416,251,171,0,171,2
2020-06-24,San Bernardino,071,2135413,15834,10211,9,10220,239
2020-06-24,San Diego,073,3302833,15086,11628,2,11630,347
2020-06-24,San Francisco,075,870044,3718,3216,1,3217,48
2020-06-24,San Joaquin,077,732212,4060,2680,3,2683,49
2020-06-24,San Luis Obispo,079,281455,714,461,5,466,1
2020-06-24,San Mateo,081,765935,3370,2964,4,2968,82
2020-06-24,Santa Barbara,083,443738,3238,2569,25,2594,22
2020-06-24,Santa Clara,085,1922200,5237,3812,17,3829,155
2020-06-24,Santa Cruz,087,273765,407,329,0,329,2
2020-06-24,Shasta,089,179085,168,83,0,83,5
2020-06-24,Sierra,091,2930,1,1,0,1,0
2020-06-24,Siskiyou,093,43540,32,24,0,24,0
2020-06-24,Solano,095,438530,1535,979,6,985,21
2020-06-24,Sonoma,097,501317,1262,933,4,937,4
2020-06-24,Stanislaus,099,539301,3245,2039,6,2045,36
2020-06-24,Sutter,101,95872,159,118,0,118,2
2020-06-24,Tehama,103,63373,81,55,2,57,1
2020-06-24,Trinity,105,12862,16,2,3,5,0
2020-06-24,Tulare,107,460477,4892,3541,10,3551,116
2020-06-24,Tuolumne,109,53932,33,9,1,10,0
2020-06-24,Ventura,111,848112,3535,2314,15,2329,42
2020-06-24,Yolo,113,214977,576,376,3,379,24
2020-06-24,Yuba,115,75493,58,37,0,37,1
2020-06-23,Alameda,001,1643700,6169,5159,7,5166,121
2020-06-23,Alpine,003,1148,1,1,0,1,0
2020-06-23,Amador,005,37829,22,13,0,13,0
2020-06-23,Butte,007,227075,204,111,10,121,1
2020-06-23,Calaveras,009,45235,40,26,0,26,0
2020-06-23,Colusa,011,21464,40,7,0,7,0
2020-06-23,Contra Costa,013,1133247,3114,2453,3,2456,60
2020-06-23,Del Norte,015,27424,48,46,0,46,0
2020-06-23,El Dorado,017,186661,229,142,1,143,0
2020-06-23,Fresno,019,978130,7557,3569,69,3638,67
2020-06-23,Glenn,021,27897,120,47,0,47,0
2020-06-23,Humboldt,023,135768,151,110,0,110,3
2020-06-23,Imperial,025,180216,7341,5025,4,5029,38
2020-06-23,Inyo,027,18085,29,26,0,26,1
2020-06-23,Kern,029,883053,6613,4087,18,4105,64
2020-06-23,Kings,031,150075,2455,1727,5,1732,16
2020-06-23,Lake,033,64148,60,40,0,40,0
2020-06-23,Lassen,035,31185,228,9,2,11,0
2020-06-23,Los Angeles,037,10098052,102907,88433,27,88460,3152
2020-06-23,Madera,039,155013,727,369,2,371,4
2020-06-23,Marin,041,260295,1974,1139,4,1143,17
2020-06-23,Mariposa,043,17540,26,18,0,18,1
2020-06-23,Mendocino,045,87422,78,61,0,61,0
2020-06-23,Merced,047,269075,1255,656,1,657,8
2020-06-23,Modoc,049,8938,1,0,0,0,0
2020-06-23,Mono,051,14174,42,35,0,35,1
2020-06-23,Monterey,053,433212,1780,1346,5,1351,12
2020-06-23,Napa,055,140530,362,230,0,230,3
2020-06-23,Nevada,057,99092,116,81,1,82,1
2020-06-23,Orange,059,3164182,18074,11071,149,11220,278
2020-06-23,Placer,061,380077,761,525,3,528,10
2020-06-23,Plumas,063,18699,9,6,0,6,0
2020-06-23,Riverside,065,2383286,19557,14469,25,14494,406
2020-06-23,Sacramento,067,1510023,3191,2374,5,2379,62
2020-06-23,San Benito,069,59416,237,167,0,167,2
2020-06-23,San Bernardino,071,2135413,15053,9771,9,9780,229
2020-06-23,San Diego,073,3302833,14566,11296,2,11298,341
2020-06-23,San Francisco,075,870044,3645,3177,1,3178,48
2020-06-23,San Joaquin,077,732212,3801,2502,3,2505,48
2020-06-23,San Luis Obispo,079,281455,683,445,5,450,1
2020-06-23,San Mateo,081,765935,3305,2907,4,2911,81
2020-06-23,Santa Barbara,083,443738,3143,2498,25,2523,22
2020-06-23,Santa Clara,085,1922200,5091,3700,17,3717,155
2020-06-23,Santa Cruz,087,273765,397,313,0,313,2
2020-06-23,Shasta,089,179085,159,81,0,81,5
2020-06-23,Sierra,091,2930,1,1,0,1,0
2020-06-23,Siskiyou,093,43540,30,24,0,24,0
2020-06-23,Solano,095,438530,1478,941,5,946,21
2020-06-23,Sonoma,097,501317,1209,912,4,916,4
2020-06-23,Stanislaus,099,539301,3068,1850,6,1856,35
2020-06-23,Sutter,101,95872,149,112,0,112,2
2020-06-23,Tehama,103,63373,79,50,2,52,1
2020-06-23,Trinity,105,12862,16,2,3,5,0
2020-06-23,Tulare,107,460477,4770,3456,10,3466,111
2020-06-23,Tuolumne,109,53932,28,9,0,9,0
2020-06-23,Ventura,111,848112,3375,2209,14,2223,40
2020-06-23,Yolo,113,214977,550,350,0,350,24
2020-06-23,Yuba,115,75493,55,35,0,35,1
2020-06-22,Alameda,001,1643700,6018,4944,7,4951,121
2020-06-22,Alpine,003,1148,1,1,0,1,0
2020-06-22,Amador,005,37829,19,12,0,12,0
2020-06-22,Butte,007,227075,185,104,10,114,1
2020-06-22,Calaveras,009,45235,38,20,0,20,0
2020-06-22,Colusa,011,21464,37,7,0,7,0
2020-06-22,Contra Costa,013,1133247,2972,2363,3,2366,60
2020-06-22,Del Norte,015,27424,48,46,0,46,0
2020-06-22,El Dorado,017,186661,220,137,1,138,0
2020-06-22,Fresno,019,978130,7025,3425,69,3494,67
2020-06-22,Glenn,021,27897,111,40,0,40,0
2020-06-22,Humboldt,023,135768,148,110,0,110,3
2020-06-22,Imperial,025,180216,7184,4700,4,4704,38
2020-06-22,Inyo,027,18085,29,26,0,26,1
2020-06-22,Kern,029,883053,6261,3982,16,3998,60
2020-06-22,Kings,031,150075,2406,1513,5,1518,13
2020-06-22,Lake,033,64148,54,37,0,37,0
2020-06-22,Lassen,035,31185,118,7,2,9,0
2020-06-22,Los Angeles,037,10098052,100008,85925,26,85951,3117
2020-06-22,Madera,039,155013,702,333,2,335,4
2020-06-22,Marin,041,260295,1717,1029,4,1033,17
2020-06-22,Mariposa,043,17540,25,18,0,18,1
2020-06-22,Mendocino,045,87422,73,48,0,48,0
2020-06-22,Merced,047,269075,1166,619,1,620,8
2020-06-22,Modoc,049,8938,1,0,0,0,0
2020-06-22,Mono,051,14174,42,34,0,34,1
2020-06-22,Monterey,053,433212,1719,1293,5,1298,12
2020-06-22,Napa,055,140530,338,222,0,222,3
2020-06-22,Nevada,057,99092,111,79,1,80,1
2020-06-22,Orange,059,3164182,17142,10711,146,10857,275
2020-06-22,Placer,061,380077,735,512,3,515,9
2020-06-22,Plumas,063,18699,7,6,0,6,0
2020-06-22,Riverside,065,2383286,18585,13948,25,13973,403
2020-06-22,Sacramento,067,1510023,2974,2243,5,2248,62
2020-06-22,San Benito,069,59416,228,164,0,164,2
2020-06-22,San Bernardino,071,2135413,14280,9133,9,9142,229
2020-06-22,San Diego,073,3302833,14074,11098,2,11100,338
2020-06-22,San Francisco,075,870044,3552,3000,1,3001,47
2020-06-22,San Joaquin,077,732212,3553,2332,3,2335,48
2020-06-22,San Luis Obispo,079,281455,650,422,5,427,1
2020-06-22,San Mateo,081,765935,3232,2813,3,2816,81
2020-06-22,Santa Barbara,083,443738,3051,2447,25,2472,21
2020-06-22,Santa Clara,085,1922200,4928,3580,17,3597,155
2020-06-22,Santa Cruz,087,273765,384,290,0,290,3
2020-06-22,Shasta,089,179085,156,77,0,77,5
2020-06-22,Sierra,091,2930,1,1,0,1,0
2020-06-22,Siskiyou,093,43540,30,23,0,23,0
2020-06-22,Solano,095,438530,1400,784,4,788,21
2020-06-22,Sonoma,097,501317,1165,860,2,862,4
2020-06-22,Stanislaus,099,539301,2883,1784,6,1790,35
2020-06-22,Sutter,101,95872,140,100,0,100,2
2020-06-22,Tehama,103,63373,75,38,2,40,1
2020-06-22,Trinity,105,12862,16,2,3,5,0
2020-06-22,Tulare,107,460477,4633,3185,10,3195,111
2020-06-22,Tuolumne,109,53932,19,8,0,8,0
2020-06-22,Ventura,111,848112,3227,2065,14,2079,39
2020-06-22,Yolo,113,214977,524,333,0,333,24
2020-06-22,Yuba,115,75493,50,36,0,36,1
2020-06-21,Alameda,001,1643700,5823,4835,7,4842,121
2020-06-21,Alpine,003,1148,1,1,0,1,0
2020-06-21,Amador,005,37829,14,12,0,12,0
2020-06-21,Butte,007,227075,171,97,10,107,1
2020-06-21,Calaveras,009,45235,38,20,0,20,0
2020-06-21,Colusa,011,21464,29,7,0,7,0
2020-06-21,Contra Costa,013,1133247,2847,2282,3,2285,60
2020-06-21,Del Norte,015,27424,47,46,0,46,0
2020-06-21,El Dorado,017,186661,211,132,1,133,0
2020-06-21,Fresno,019,978130,6455,3296,67,3363,67
2020-06-21,Glenn,021,27897,102,40,0,40,0
2020-06-21,Humboldt,023,135768,143,108,0,108,3
2020-06-21,Imperial,025,180216,7001,4701,4,4705,38
2020-06-21,Inyo,027,18085,27,26,0,26,1
2020-06-21,Kern,029,883053,5969,3918,14,3932,60
2020-06-21,Kings,031,150075,2342,1334,5,1339,11
2020-06-21,Lake,033,64148,49,36,0,36,0
2020-06-21,Lassen,035,31185,25,7,2,9,0
2020-06-21,Los Angeles,037,10098052,97115,83383,25,83408,3101
2020-06-21,Madera,039,155013,668,319,2,321,4
2020-06-21,Marin,041,260295,1560,907,4,911,17
2020-06-21,Mariposa,043,17540,22,18,0,18,1
2020-06-21,Mendocino,045,87422,70,48,0,48,0
2020-06-21,Merced,047,269075,1071,577,1,578,8
2020-06-21,Modoc,049,8938,1,0,0,0,0
2020-06-21,Mono,051,14174,42,34,0,34,1
2020-06-21,Monterey,053,433212,1646,1227,5,1232,12
2020-06-21,Napa,055,140530,323,218,0,218,3
2020-06-21,Nevada,057,99092,108,79,1,80,1
2020-06-21,Orange,059,3164182,16309,10563,143,10706,275
2020-06-21,Placer,061,380077,695,498,3,501,9
2020-06-21,Plumas,063,18699,7,6,0,6,0
2020-06-21,Riverside,065,2383286,17879,13528,24,13552,402
2020-06-21,Sacramento,067,1510023,2773,2156,4,2160,62
2020-06-21,San Benito,069,59416,214,151,0,151,2
2020-06-21,San Bernardino,071,2135413,13506,8925,8,8933,229
2020-06-21,San Diego,073,3302833,13528,10796,2,10798,338
2020-06-21,San Francisco,075,870044,3446,3000,1,3001,47
2020-06-21,San Joaquin,077,732212,3317,2188,3,2191,48
2020-06-21,San Luis Obispo,079,281455,624,418,5,423,1
2020-06-21,San Mateo,081,765935,3174,2781,3,2784,81
2020-06-21,Santa Barbara,083,443738,2944,2430,24,2454,21
2020-06-21,Santa Clara,085,1922200,4791,3514,17,3531,154
2020-06-21,Santa Cruz,087,273765,374,290,0,290,3
2020-06-21,Shasta,089,179085,146,75,0,75,5
2020-06-21,Sierra,091,2930,1,1,0,1,0
2020-06-21,Siskiyou,093,43540,30,23,0,23,0
2020-06-21,Solano,095,438530,1300,783,4,787,21
2020-06-21,Sonoma,097,501317,1115,836,2,838,4
2020-06-21,Stanislaus,099,539301,2697,1688,6,1694,35
2020-06-21,Sutter,101,95872,132,96,0,96,2
2020-06-21,Tehama,103,63373,64,35,2,37,1
2020-06-21,Trinity,105,12862,15,2,3,5,0
2020-06-21,Tulare,107,460477,4464,3173,10,3183,111
2020-06-21,Tuolumne,109,53932,17,8,0,8,0
2020-06-21,Ventura,111,848112,3049,2021,14,2035,39
2020-06-21,Yolo,113,214977,492,323,0,323,24
2020-06-21,Yuba,115,75493,46,35,0,35,1
2020-06-20,Alameda,001,1643700,5761,4758,7,4765,119
2020-06-20,Alpine,003,1148,1,1,0,1,0
2020-06-20,Amador,005,37829,14,12,0,12,0
2020-06-20,Butte,007,227075,164,94,10,104,1
2020-06-20,Calaveras,009,45235,38,20,0,20,0
2020-06-20,Colusa,011,21464,26,7,0,7,0
2020-06-20,Contra Costa,013,1133247,2788,2231,3,2234,54
2020-06-20,Del Norte,015,27424,47,46,0,46,0
2020-06-20,El Dorado,017,186661,206,130,1,131,0
2020-06-20,Fresno,019,978130,6329,3222,64,3286,67
2020-06-20,Glenn,021,27897,97,40,0,40,0
2020-06-20,Humboldt,023,135768,143,108,0,108,3
2020-06-20,Imperial,025,180216,6920,4616,4,4620,37
2020-06-20,Inyo,027,18085,27,26,0,26,1
2020-06-20,Kern,029,883053,5804,3836,14,3850,59
2020-06-20,Kings,031,150075,2318,1331,5,1336,9
2020-06-20,Lake,033,64148,49,37,0,37,0
2020-06-20,Lassen,035,31185,24,7,2,9,0
2020-06-20,Los Angeles,037,10098052,95540,81604,24,81628,3093
2020-06-20,Madera,039,155013,635,321,2,323,4
2020-06-20,Marin,041,260295,1540,879,4,883,17
2020-06-20,Mariposa,043,17540,22,18,0,18,1
2020-06-20,Mendocino,045,87422,69,48,0,48,0
2020-06-20,Merced,047,269075,1031,566,1,567,8
2020-06-20,Modoc,049,8938,1,0,0,0,0
2020-06-20,Mono,051,14174,42,34,0,34,1
2020-06-20,Monterey,053,433212,1610,1181,5,1186,12
2020-06-20,Napa,055,140530,314,212,0,212,3
2020-06-20,Nevada,057,99092,105,73,1,74,1
2020-06-20,Orange,059,3164182,15959,10284,139,10423,273
2020-06-20,Placer,061,380077,670,483,3,486,9
2020-06-20,Plumas,063,18699,6,6,0,6,0
2020-06-20,Riverside,065,2383286,17579,13021,24,13045,402
2020-06-20,Sacramento,067,1510023,2702,2069,4,2073,63
2020-06-20,San Benito,069,59416,210,139,0,139,2
2020-06-20,San Bernardino,071,2135413,13143,8718,8,8726,229
2020-06-20,San Diego,073,3302833,13205,10486,2,10488,338
2020-06-20,San Francisco,075,870044,3402,2999,1,3000,47
2020-06-20,San Joaquin,077,732212,3235,2046,3,2049,48
2020-06-20,San Luis Obispo,079,281455,610,405,5,410,1
2020-06-20,San Mateo,081,765935,3126,2755,3,2758,81
2020-06-20,Santa Barbara,083,443738,2887,2358,23,2381,21
2020-06-20,Santa Clara,085,1922200,4717,3435,17,3452,154
2020-06-20,Santa Cruz,087,273765,372,287,0,287,3
2020-06-20,Shasta,089,179085,140,66,0,66,5
2020-06-20,Sierra,091,2930,1,1,0,1,0
2020-06-20,Siskiyou,093,43540,29,22,0,22,0
2020-06-20,Solano,095,438530,1276,784,4,788,21
2020-06-20,Sonoma,097,501317,1079,806,2,808,4
2020-06-20,Stanislaus,099,539301,2589,1598,6,1604,35
2020-06-20,Sutter,101,95872,130,89,0,89,2
2020-06-20,Tehama,103,63373,62,35,2,37,1
2020-06-20,Trinity,105,12862,15,2,3,5,0
2020-06-20,Tulare,107,460477,4391,3172,10,3182,111
2020-06-20,Tuolumne,109,53932,14,8,0,8,0
2020-06-20,Ventura,111,848112,2983,1946,14,1960,37
2020-06-20,Yolo,113,214977,476,309,0,309,24
2020-06-20,Yuba,115,75493,44,34,0,34,1
2020-06-19,Alameda,001,1643700,5688,4646,7,4653,119
2020-06-19,Alpine,003,1148,1,1,0,1,0
2020-06-19,Amador,005,37829,14,12,0,12,0
2020-06-19,Butte,007,227075,159,91,10,101,1
2020-06-19,Calaveras,009,45235,37,20,0,20,0
2020-06-19,Colusa,011,21464,24,7,0,7,0
2020-06-19,Contra Costa,013,1133247,2708,2106,3,2109,54
2020-06-19,Del Norte,015,27424,47,46,0,46,0
2020-06-19,El Dorado,017,186661,198,124,1,125,0
2020-06-19,Fresno,019,978130,6167,3109,63,3172,61
2020-06-19,Glenn,021,27897,91,40,0,40,0
2020-06-19,Humboldt,023,135768,141,106,0,106,3
2020-06-19,Imperial,025,180216,6828,4504,4,4508,36
2020-06-19,Inyo,027,18085,27,26,0,26,1
2020-06-19,Kern,029,883053,5581,3742,13,3755,57
2020-06-19,Kings,031,150075,2297,1285,5,1290,9
2020-06-19,Lake,033,64148,46,36,0,36,0
2020-06-19,Lassen,035,31185,23,7,2,9,0
2020-06-19,Los Angeles,037,10098052,93553,79572,23,79595,3047
2020-06-19,Madera,039,155013,616,300,2,302,4
2020-06-19,Marin,041,260295,1511,829,4,833,17
2020-06-19,Mariposa,043,17540,21,18,0,18,1
2020-06-19,Mendocino,045,87422,68,48,0,48,0
2020-06-19,Merced,047,269075,986,529,1,530,8
2020-06-19,Modoc,049,8938,1,0,0,0,0
2020-06-19,Mono,051,14174,42,34,0,34,1
2020-06-19,Monterey,053,433212,1581,1159,5,1164,12
2020-06-19,Napa,055,140530,304,209,0,209,3
2020-06-19,Nevada,057,99092,102,71,1,72,1
2020-06-19,Orange,059,3164182,15426,9972,132,10104,260
2020-06-19,Placer,061,380077,652,464,3,467,9
2020-06-19,Plumas,063,18699,6,5,0,5,0
2020-06-19,Riverside,065,2383286,17174,12710,24,12734,398
2020-06-19,Sacramento,067,1510023,2619,1976,4,1980,64
2020-06-19,San Benito,069,59416,209,136,0,136,2
2020-06-19,San Bernardino,071,2135413,12738,8454,7,8461,226
2020-06-19,San Diego,073,3302833,12842,10352,2,10354,332
2020-06-19,San Francisco,075,870044,3347,2968,1,2969,47
2020-06-19,San Joaquin,077,732212,3112,1969,3,1972,48
2020-06-19,San Luis Obispo,079,281455,594,392,5,397,1
2020-06-19,San Mateo,081,765935,3087,2713,3,2716,81
2020-06-19,Santa Barbara,083,443738,2814,2284,21,2305,21
2020-06-19,Santa Clara,085,1922200,4643,3376,17,3393,154
2020-06-19,Santa Cruz,087,273765,362,283,0,283,3
2020-06-19,Shasta,089,179085,137,58,0,58,5
2020-06-19,Sierra,091,2930,1,1,0,1,0
2020-06-19,Siskiyou,093,43540,29,21,0,21,0
2020-06-19,Solano,095,438530,1238,755,4,759,21
2020-06-19,Sonoma,097,501317,1052,803,2,805,4
2020-06-19,Stanislaus,099,539301,2479,1549,6,1555,35
2020-06-19,Sutter,101,95872,129,89,0,89,2
2020-06-19,Tehama,103,63373,61,35,2,37,1
2020-06-19,Trinity,105,12862,15,2,3,5,0
2020-06-19,Tulare,107,460477,4321,3053,10,3063,107
2020-06-19,Tuolumne,109,53932,13,8,0,8,0
2020-06-19,Ventura,111,848112,2899,1865,14,1879,37
2020-06-19,Yolo,113,214977,457,303,0,303,24
2020-06-19,Yuba,115,75493,43,33,0,33,1
2020-06-18,Alameda,001,1643700,5558,4589,7,4596,118
2020-06-18,Alpine,003,1148,1,1,0,1,0
2020-06-18,Amador,005,37829,13,12,0,12,0
2020-06-18,Butte,007,227075,154,88,10,98,1
2020-06-18,Calaveras,009,45235,37,20,0,20,0
2020-06-18,Colusa,011,21464,20,7,0,7,0
2020-06-18,Contra Costa,013,1133247,2601,2072,3,2075,53
2020-06-18,Del Norte,015,27424,47,46,0,46,0
2020-06-18,El Dorado,017,186661,194,121,1,122,0
2020-06-18,Fresno,019,978130,5901,2947,62,3009,57
2020-06-18,Glenn,021,27897,82,35,0,35,0
2020-06-18,Humboldt,023,135768,140,106,0,106,3
2020-06-18,Imperial,025,180216,6678,4366,4,4370,36
2020-06-18,Inyo,027,18085,26,25,0,25,1
2020-06-18,Kern,029,883053,5363,3634,13,3647,57
2020-06-18,Kings,031,150075,2238,1141,5,1146,8
2020-06-18,Lake,033,64148,45,36,0,36,0
2020-06-18,Lassen,035,31185,22,5,2,7,0
2020-06-18,Los Angeles,037,10098052,91286,78244,23,78267,3009
2020-06-18,Madera,039,155013,581,288,2,290,4
2020-06-18,Marin,041,260295,1448,819,4,823,17
2020-06-18,Mariposa,043,17540,19,18,0,18,1
2020-06-18,Mendocino,045,87422,64,45,0,45,0
2020-06-18,Merced,047,269075,934,486,1,487,7
2020-06-18,Modoc,049,8938,1,0,0,0,0
2020-06-18,Mono,051,14174,42,34,0,34,1
2020-06-18,Monterey,053,433212,1513,1127,5,1132,12
2020-06-18,Napa,055,140530,289,205,0,205,3
2020-06-18,Nevada,057,99092,98,68,1,69,1
2020-06-18,Orange,059,3164182,14771,9597,113,9710,255
2020-06-18,Placer,061,380077,629,457,3,460,9
2020-06-18,Plumas,063,18699,6,5,0,5,0
2020-06-18,Riverside,065,2383286,16558,12410,24,12434,392
2020-06-18,Sacramento,067,1510023,2503,1938,4,1942,63
2020-06-18,San Benito,069,59416,203,134,0,134,2
2020-06-18,San Bernardino,071,2135413,12097,8141,7,8148,226
2020-06-18,San Diego,073,3302833,12420,10094,2,10096,331
2020-06-18,San Francisco,075,870044,3298,2951,1,2952,47
2020-06-18,San Joaquin,077,732212,2960,1908,3,1911,47
2020-06-18,San Luis Obispo,079,281455,574,378,5,383,1
2020-06-18,San Mateo,081,765935,3048,2674,3,2677,78
2020-06-18,Santa Barbara,083,443738,2740,2201,21,2222,19
2020-06-18,Santa Clara,085,1922200,4540,3338,17,3355,152
2020-06-18,Santa Cruz,087,273765,345,275,0,275,3
2020-06-18,Shasta,089,179085,126,51,0,51,4
2020-06-18,Sierra,091,2930,1,1,0,1,0
2020-06-18,Siskiyou,093,43540,29,18,0,18,0
2020-06-18,Solano,095,438530,1200,735,4,739,21
2020-06-18,Sonoma,097,501317,1010,789,2,791,4
2020-06-18,Stanislaus,099,539301,2346,1495,6,1501,35
2020-06-18,Sutter,101,95872,125,85,0,85,2
2020-06-18,Tehama,103,63373,56,31,2,33,1
2020-06-18,Trinity,105,12862,15,2,3,5,0
2020-06-18,Tulare,107,460477,4198,3005,10,3015,107
2020-06-18,Tuolumne,109,53932,12,8,0,8,0
2020-06-18,Ventura,111,848112,2773,1781,14,1795,37
2020-06-18,Yolo,113,214977,424,294,0,294,24
2020-06-18,Yuba,115,75493,42,32,0,32,1
2020-06-17,Alameda,001,1643700,5435,4485,7,4492,117
2020-06-17,Alpine,003,1148,1,1,0,1,0
2020-06-17,Amador,005,37829,12,10,0,10,0
2020-06-17,Butte,007,227075,145,81,10,91,1
2020-06-17,Calaveras,009,45235,37,20,0,20,0
2020-06-17,Colusa,011,21464,19,7,0,7,0
2020-06-17,Contra Costa,013,1133247,2504,2020,3,2023,45
2020-06-17,Del Norte,015,27424,47,45,0,45,0
2020-06-17,El Dorado,017,186661,187,116,1,117,0
2020-06-17,Fresno,019,978130,5675,2801,60,2861,56
2020-06-17,Glenn,021,27897,75,31,0,31,0
2020-06-17,Humboldt,023,135768,138,105,0,105,3
2020-06-17,Imperial,025,180216,6505,4108,4,4112,36
2020-06-17,Inyo,027,18085,25,25,0,25,1
2020-06-17,Kern,029,883053,5162,3547,13,3560,56
2020-06-17,Kings,031,150075,2208,1097,5,1102,7
2020-06-17,Lake,033,64148,44,32,0,32,0
2020-06-17,Lassen,035,31185,18,5,2,7,0
2020-06-17,Los Angeles,037,10098052,88977,77166,22,77188,2973
2020-06-17,Madera,039,155013,559,258,2,260,4
2020-06-17,Marin,041,260295,1256,771,3,774,17
2020-06-17,Mariposa,043,17540,18,18,0,18,1
2020-06-17,Mendocino,045,87422,62,42,0,42,0
2020-06-17,Merced,047,269075,862,460,1,461,7
2020-06-17,Modoc,049,8938,1,0,0,0,0
2020-06-17,Mono,051,14174,42,34,0,34,1
2020-06-17,Monterey,053,433212,1461,1077,5,1082,12
2020-06-17,Napa,055,140530,274,202,0,202,3
2020-06-17,Nevada,057,99092,94,57,1,58,1
2020-06-17,Orange,059,3164182,14165,9278,107,9385,230
2020-06-17,Placer,061,380077,609,427,3,430,9
2020-06-17,Plumas,063,18699,6,5,0,5,0
2020-06-17,Riverside,065,2383286,15922,11859,24,11883,370
2020-06-17,Sacramento,067,1510023,2396,1889,4,1893,63
2020-06-17,San Benito,069,59416,198,116,0,116,2
2020-06-17,San Bernardino,071,2135413,11548,7670,7,7677,225
2020-06-17,San Diego,073,3302833,12041,9856,2,9858,327
2020-06-17,San Francisco,075,870044,3259,2906,1,2907,46
2020-06-17,San Joaquin,077,732212,2787,1825,3,1828,46
2020-06-17,San Luis Obispo,079,281455,555,362,5,367,1
2020-06-17,San Mateo,081,765935,3001,2649,3,2652,78
2020-06-17,Santa Barbara,083,443738,2668,2147,19,2166,19
2020-06-17,Santa Clara,085,1922200,4447,3264,16,3280,148
2020-06-17,Santa Cruz,087,273765,339,265,0,265,2
2020-06-17,Shasta,089,179085,124,51,0,51,4
2020-06-17,Sierra,091,2930,1,1,0,1,0
2020-06-17,Siskiyou,093,43540,28,16,0,16,0
2020-06-17,Solano,095,438530,1150,722,4,726,21
2020-06-17,Sonoma,097,501317,985,748,2,750,4
2020-06-17,Stanislaus,099,539301,2223,1387,6,1393,35
2020-06-17,Sutter,101,95872,119,79,0,79,2
2020-06-17,Tehama,103,63373,41,24,2,26,1
2020-06-17,Trinity,105,12862,14,2,3,5,0
2020-06-17,Tulare,107,460477,4088,2882,10,2892,106
2020-06-17,Tuolumne,109,53932,12,7,0,7,0
2020-06-17,Ventura,111,848112,2673,1729,14,1743,37
2020-06-17,Yolo,113,214977,404,277,0,277,24
2020-06-17,Yuba,115,75493,41,30,0,30,1
2020-06-16,Alameda,001,1643700,5317,4428,7,4435,113
2020-06-16,Alpine,003,1148,1,1,0,1,0
2020-06-16,Amador,005,37829,12,10,0,10,0
2020-06-16,Butte,007,227075,141,79,10,89,1
2020-06-16,Calaveras,009,45235,34,19,0,19,0
2020-06-16,Colusa,011,21464,16,7,0,7,0
2020-06-16,Contra Costa,013,1133247,2413,1971,2,1973,45
2020-06-16,Del Norte,015,27424,47,45,0,45,0
2020-06-16,El Dorado,017,186661,181,115,1,116,0
2020-06-16,Fresno,019,978130,5437,2731,58,2789,50
2020-06-16,Glenn,021,27897,71,30,0,30,0
2020-06-16,Humboldt,023,135768,135,105,0,105,3
2020-06-16,Imperial,025,180216,6346,3939,4,3943,36
2020-06-16,Inyo,027,18085,25,24,0,24,1
2020-06-16,Kern,029,883053,4939,3496,13,3509,55
2020-06-16,Kings,031,150075,2162,1044,5,1049,6
2020-06-16,Lake,033,64148,44,31,0,31,0
2020-06-16,Lassen,035,31185,15,5,2,7,0
2020-06-16,Los Angeles,037,10098052,86656,75051,22,75073,2942
2020-06-16,Madera,039,155013,533,239,2,241,3
2020-06-16,Marin,041,260295,1203,725,3,728,17
2020-06-16,Mariposa,043,17540,18,17,0,17,1
2020-06-16,Mendocino,045,87422,61,35,0,35,0
2020-06-16,Merced,047,269075,814,436,1,437,7
2020-06-16,Modoc,049,8938,1,0,0,0,0
2020-06-16,Mono,051,14174,42,34,0,34,1
2020-06-16,Monterey,053,433212,1413,1019,5,1024,12
2020-06-16,Napa,055,140530,259,196,0,196,3
2020-06-16,Nevada,057,99092,91,53,1,54,1
2020-06-16,Orange,059,3164182,13581,9163,101,9264,223
2020-06-16,Placer,061,380077,577,392,3,395,9
2020-06-16,Plumas,063,18699,6,5,0,5,0
2020-06-16,Riverside,065,2383286,15247,11638,24,11662,364
2020-06-16,Sacramento,067,1510023,2286,1825,4,1829,60
2020-06-16,San Benito,069,59416,190,110,0,110,2
2020-06-16,San Bernardino,071,2135413,11004,7463,7,7470,225
2020-06-16,San Diego,073,3302833,11679,9732,1,9733,323
2020-06-16,San Francisco,075,870044,3208,2893,1,2894,46
2020-06-16,San Joaquin,077,732212,2634,1718,3,1721,47
2020-06-16,San Luis Obispo,079,281455,531,343,5,348,1
2020-06-16,San Mateo,081,765935,2947,2618,3,2621,77
2020-06-16,Santa Barbara,083,443738,2601,2090,19,2109,16
2020-06-16,Santa Clara,085,1922200,4336,3228,15,3243,148
2020-06-16,Santa Cruz,087,273765,323,257,0,257,2
2020-06-16,Shasta,089,179085,115,51,0,51,4
2020-06-16,Sierra,091,2930,1,1,0,1,0
2020-06-16,Siskiyou,093,43540,27,15,0,15,0
2020-06-16,Solano,095,438530,1060,694,4,698,19
2020-06-16,Sonoma,097,501317,953,739,2,741,4
2020-06-16,Stanislaus,099,539301,2070,1278,6,1284,36
2020-06-16,Sutter,101,95872,112,73,0,73,2
2020-06-16,Tehama,103,63373,37,24,2,26,1
2020-06-16,Trinity,105,12862,14,2,3,5,0
2020-06-16,Tulare,107,460477,3969,2802,10,2812,96
2020-06-16,Tuolumne,109,53932,12,7,0,7,0
2020-06-16,Ventura,111,848112,2573,1676,14,1690,37
2020-06-16,Yolo,113,214977,381,262,0,262,24
2020-06-16,Yuba,115,75493,39,29,0,29,1
2020-06-15,Alameda,001,1643700,5191,4323,7,4330,112
2020-06-15,Alpine,003,1148,1,1,0,1,0
2020-06-15,Amador,005,37829,12,10,0,10,0
2020-06-15,Butte,007,227075,133,78,10,88,1
2020-06-15,Calaveras,009,45235,34,18,0,18,0
2020-06-15,Colusa,011,21464,14,7,0,7,0
2020-06-15,Contra Costa,013,1133247,2336,1918,2,1920,43
2020-06-15,Del Norte,015,27424,47,45,0,45,0
2020-06-15,El Dorado,017,186661,171,114,1,115,0
2020-06-15,Fresno,019,978130,5225,2616,57,2673,48
2020-06-15,Glenn,021,27897,66,21,0,21,0
2020-06-15,Humboldt,023,135768,133,105,0,105,3
2020-06-15,Imperial,025,180216,6171,3726,4,3730,36
2020-06-15,Inyo,027,18085,25,23,0,23,1
2020-06-15,Kern,029,883053,4716,3417,13,3430,55
2020-06-15,Kings,031,150075,2085,1022,5,1027,6
2020-06-15,Lake,033,64148,44,31,0,31,0
2020-06-15,Lassen,035,31185,15,5,2,7,0
2020-06-15,Los Angeles,037,10098052,84467,73705,22,73727,2908
2020-06-15,Madera,039,155013,511,203,2,205,3
2020-06-15,Marin,041,260295,1036,708,3,711,17
2020-06-15,Mariposa,043,17540,18,17,0,17,1
2020-06-15,Mendocino,045,87422,52,33,0,33,0
2020-06-15,Merced,047,269075,768,414,1,415,7
2020-06-15,Modoc,049,8938,1,0,0,0,0
2020-06-15,Mono,051,14174,42,34,0,34,1
2020-06-15,Monterey,053,433212,1347,998,5,1003,12
2020-06-15,Napa,055,140530,251,187,0,187,3
2020-06-15,Nevada,057,99092,85,52,1,53,1
2020-06-15,Orange,059,3164182,13013,8944,93,9037,212
2020-06-15,Placer,061,380077,555,386,3,389,9
2020-06-15,Plumas,063,18699,6,4,0,4,0
2020-06-15,Riverside,065,2383286,14629,11376,23,11399,364
2020-06-15,Sacramento,067,1510023,2170,1791,4,1795,60
2020-06-15,San Benito,069,59416,184,108,0,108,2
2020-06-15,San Bernardino,071,2135413,10501,7189,7,7196,224
2020-06-15,San Diego,073,3302833,11339,9612,1,9613,320
2020-06-15,San Francisco,075,870044,3164,2833,1,2834,45
2020-06-15,San Joaquin,077,732212,2498,1667,3,1670,43
2020-06-15,San Luis Obispo,079,281455,516,332,5,337,1
2020-06-15,San Mateo,081,765935,2900,2591,3,2594,75
2020-06-15,Santa Barbara,083,443738,2533,2054,19,2073,16
2020-06-15,Santa Clara,085,1922200,4236,3204,15,3219,148
2020-06-15,Santa Cruz,087,273765,312,254,0,254,2
2020-06-15,Shasta,089,179085,109,50,0,50,4
2020-06-15,Sierra,091,2930,1,1,0,1,0
2020-06-15,Siskiyou,093,43540,26,14,0,14,0
2020-06-15,Solano,095,438530,1000,638,4,642,19
2020-06-15,Sonoma,097,501317,924,726,2,728,4
2020-06-15,Stanislaus,099,539301,1953,1253,6,1259,35
2020-06-15,Sutter,101,95872,102,71,0,71,2
2020-06-15,Tehama,103,63373,37,17,2,19,1
2020-06-15,Trinity,105,12862,13,2,3,5,0
2020-06-15,Tulare,107,460477,3855,2662,10,2672,96
2020-06-15,Tuolumne,109,53932,11,7,0,7,0
2020-06-15,Ventura,111,848112,2492,1656,14,1670,37
2020-06-15,Yolo,113,214977,361,255,0,255,24
2020-06-15,Yuba,115,75493,39,28,0,28,1
2020-06-14,Alameda,001,1643700,5045,4271,7,4278,112
2020-06-14,Alpine,003,1148,1,1,0,1,0
2020-06-14,Amador,005,37829,12,10,0,10,0
2020-06-14,Butte,007,227075,125,78,10,88,1
2020-06-14,Calaveras,009,45235,33,18,0,18,0
2020-06-14,Colusa,011,21464,13,7,0,7,0
2020-06-14,Contra Costa,013,1133247,2268,1893,2,1895,43
2020-06-14,Del Norte,015,27424,47,45,0,45,0
2020-06-14,El Dorado,017,186661,167,110,1,111,0
2020-06-14,Fresno,019,978130,5040,2585,56,2641,48
2020-06-14,Glenn,021,27897,51,21,0,21,0
2020-06-14,Humboldt,023,135768,129,105,0,105,3
2020-06-14,Imperial,025,180216,5940,3730,4,3734,36
2020-06-14,Inyo,027,18085,24,23,0,23,1
2020-06-14,Kern,029,883053,4505,3328,13,3341,55
2020-06-14,Kings,031,150075,2034,1022,4,1026,6
2020-06-14,Lake,033,64148,41,31,0,31,0
2020-06-14,Lassen,035,31185,15,5,2,7,0
2020-06-14,Los Angeles,037,10098052,82141,72932,21,72953,2887
2020-06-14,Madera,039,155013,492,203,2,205,3
2020-06-14,Marin,041,260295,871,689,2,691,17
2020-06-14,Mariposa,043,17540,18,16,0,16,1
2020-06-14,Mendocino,045,87422,49,33,0,33,0
2020-06-14,Merced,047,269075,717,403,1,404,7
2020-06-14,Modoc,049,8938,1,0,0,0,0
2020-06-14,Mono,051,14174,42,34,0,34,1
2020-06-14,Monterey,053,433212,1286,949,5,954,12
2020-06-14,Napa,055,140530,229,181,0,181,3
2020-06-14,Nevada,057,99092,81,52,1,53,1
2020-06-14,Orange,059,3164182,12586,8744,89,8833,211
2020-06-14,Placer,061,380077,529,369,3,372,9
2020-06-14,Plumas,063,18699,5,4,0,4,0
2020-06-14,Riverside,065,2383286,14186,11218,23,11241,364
2020-06-14,Sacramento,067,1510023,2083,1750,4,1754,60
2020-06-14,San Benito,069,59416,173,104,0,104,2
2020-06-14,San Bernardino,071,2135413,9961,7015,7,7022,224
2020-06-14,San Diego,073,3302833,10964,9442,1,9443,319
2020-06-14,San Francisco,075,870044,3124,2834,1,2835,45
2020-06-14,San Joaquin,077,732212,2347,1603,3,1606,43
2020-06-14,San Luis Obispo,079,281455,501,330,5,335,1
2020-06-14,San Mateo,081,765935,2842,2571,3,2574,75
2020-06-14,Santa Barbara,083,443738,2456,2049,19,2068,17
2020-06-14,Santa Clara,085,1922200,4141,3178,15,3193,148
2020-06-14,Santa Cruz,087,273765,298,254,0,254,2
2020-06-14,Shasta,089,179085,103,48,0,48,4
2020-06-14,Sierra,091,2930,1,1,0,1,0
2020-06-14,Siskiyou,093,43540,25,13,0,13,0
2020-06-14,Solano,095,438530,951,638,4,642,19
2020-06-14,Sonoma,097,501317,896,724,2,726,4
2020-06-14,Stanislaus,099,539301,1805,1159,6,1165,35
2020-06-14,Sutter,101,95872,97,63,0,63,2
2020-06-14,Tehama,103,63373,34,17,2,19,1
2020-06-14,Trinity,105,12862,13,2,3,5,0
2020-06-14,Tulare,107,460477,3721,2646,10,2656,96
2020-06-14,Tuolumne,109,53932,11,7,0,7,0
2020-06-14,Ventura,111,848112,2393,1610,13,1623,37
2020-06-14,Yolo,113,214977,345,254,0,254,24
2020-06-14,Yuba,115,75493,38,28,0,28,1
2020-06-13,Alameda,001,1643700,4982,4196,7,4203,112
2020-06-13,Alpine,003,1148,1,1,0,1,0
2020-06-13,Amador,005,37829,11,10,0,10,0
2020-06-13,Butte,007,227075,116,72,10,82,1
2020-06-13,Calaveras,009,45235,31,18,0,18,0
2020-06-13,Colusa,011,21464,12,7,0,7,0
2020-06-13,Contra Costa,013,1133247,2232,1868,2,1870,43
2020-06-13,Del Norte,015,27424,47,45,0,45,0
2020-06-13,El Dorado,017,186661,163,110,1,111,0
2020-06-13,Fresno,019,978130,4942,2499,56,2555,48
2020-06-13,Glenn,021,27897,49,21,0,21,0
2020-06-13,Humboldt,023,135768,128,104,0,104,3
2020-06-13,Imperial,025,180216,5867,3646,4,3650,36
2020-06-13,Inyo,027,18085,24,23,0,23,1
2020-06-13,Kern,029,883053,4396,3239,13,3252,55
2020-06-13,Kings,031,150075,2014,1023,4,1027,6
2020-06-13,Lake,033,64148,40,29,0,29,0
2020-06-13,Lassen,035,31185,15,5,2,7,0
2020-06-13,Los Angeles,037,10098052,81100,71938,21,71959,2874
2020-06-13,Madera,039,155013,488,203,2,205,3
2020-06-13,Marin,041,260295,840,677,2,679,17
2020-06-13,Mariposa,043,17540,18,16,0,16,1
2020-06-13,Mendocino,045,87422,49,33,0,33,0
2020-06-13,Merced,047,269075,699,376,1,377,7
2020-06-13,Modoc,049,8938,1,0,0,0,0
2020-06-13,Mono,051,14174,42,35,0,35,1
2020-06-13,Monterey,053,433212,1248,900,5,905,11
2020-06-13,Napa,055,140530,226,171,0,171,3
2020-06-13,Nevada,057,99092,79,52,1,53,1
2020-06-13,Orange,059,3164182,12342,8581,86,8667,211
2020-06-13,Placer,061,380077,512,346,3,349,9
2020-06-13,Plumas,063,18699,5,4,0,4,0
2020-06-13,Riverside,065,2383286,13907,10931,23,10954,364
2020-06-13,Sacramento,067,1510023,2028,1713,4,1717,60
2020-06-13,San Benito,069,59416,166,99,0,99,2
2020-06-13,San Bernardino,071,2135413,9738,6885,7,6892,224
2020-06-13,San Diego,073,3302833,10792,9316,1,9317,319
2020-06-13,San Francisco,075,870044,3104,2834,1,2835,44
2020-06-13,San Joaquin,077,732212,2266,1461,3,1464,43
2020-06-13,San Luis Obispo,079,281455,490,326,5,331,1
2020-06-13,San Mateo,081,765935,2819,2551,3,2554,75
2020-06-13,Santa Barbara,083,443738,2398,1999,19,2018,15
2020-06-13,Santa Clara,085,1922200,4098,3141,15,3156,148
2020-06-13,Santa Cruz,087,273765,292,254,0,254,2
2020-06-13,Shasta,089,179085,101,48,0,48,4
2020-06-13,Sierra,091,2930,1,1,0,1,0
2020-06-13,Siskiyou,093,43540,25,13,0,13,0
2020-06-13,Solano,095,438530,923,637,4,641,19
2020-06-13,Sonoma,097,501317,881,711,2,713,4
2020-06-13,Stanislaus,099,539301,1748,1122,6,1128,33
2020-06-13,Sutter,101,95872,96,62,0,62,2
2020-06-13,Tehama,103,63373,33,17,2,19,1
2020-06-13,Trinity,105,12862,13,2,3,5,0
2020-06-13,Tulare,107,460477,3689,2626,10,2636,96
2020-06-13,Tuolumne,109,53932,10,7,0,7,0
2020-06-13,Ventura,111,848112,2347,1567,13,1580,37
2020-06-13,Yolo,113,214977,325,251,0,251,24
2020-06-13,Yuba,115,75493,38,28,0,28,1
2020-06-12,Alameda,001,1643700,4909,4167,7,4174,109
2020-06-12,Alpine,003,1148,1,1,0,1,0
2020-06-12,Amador,005,37829,11,10,0,10,0
2020-06-12,Butte,007,227075,112,71,9,80,1
2020-06-12,Calaveras,009,45235,28,18,0,18,0
2020-06-12,Colusa,011,21464,12,7,0,7,0
2020-06-12,Contra Costa,013,1133247,2195,1827,2,1829,43
2020-06-12,Del Norte,015,27424,47,45,0,45,0
2020-06-12,El Dorado,017,186661,163,110,1,111,0
2020-06-12,Fresno,019,978130,4804,2428,56,2484,47
2020-06-12,Glenn,021,27897,46,21,0,21,0
2020-06-12,Humboldt,023,135768,126,105,0,105,3
2020-06-12,Imperial,025,180216,5783,3543,4,3547,36
2020-06-12,Inyo,027,18085,24,23,0,23,1
2020-06-12,Kern,029,883053,4279,3152,13,3165,54
2020-06-12,Kings,031,150075,2001,987,4,991,6
2020-06-12,Lake,033,64148,39,29,0,29,0
2020-06-12,Lassen,035,31185,15,5,2,7,0
2020-06-12,Los Angeles,037,10098052,79695,70385,21,70406,2814
2020-06-12,Madera,039,155013,463,187,2,189,3
2020-06-12,Marin,041,260295,837,649,2,651,17
2020-06-12,Mariposa,043,17540,18,16,0,16,1
2020-06-12,Mendocino,045,87422,49,33,0,33,0
2020-06-12,Merced,047,269075,665,372,1,373,7
2020-06-12,Modoc,049,8938,1,0,0,0,0
2020-06-12,Mono,051,14174,39,35,0,35,1
2020-06-12,Monterey,053,433212,1207,864,4,868,11
2020-06-12,Napa,055,140530,223,162,0,162,3
2020-06-12,Nevada,057,99092,73,52,1,53,1
2020-06-12,Orange,059,3164182,12036,8440,85,8525,203
2020-06-12,Placer,061,380077,495,333,3,336,9
2020-06-12,Plumas,063,18699,5,4,0,4,0
2020-06-12,Riverside,065,2383286,13570,10616,23,10639,364
2020-06-12,Sacramento,067,1510023,1973,1702,4,1706,60
2020-06-12,San Benito,069,59416,159,96,0,96,2
2020-06-12,San Bernardino,071,2135413,9470,6707,7,6714,223
2020-06-12,San Diego,073,3302833,10622,9132,1,9133,313
2020-06-12,San Francisco,075,870044,3070,2823,1,2824,44
2020-06-12,San Joaquin,077,732212,2186,1406,3,1409,43
2020-06-12,San Luis Obispo,079,281455,474,321,5,326,1
2020-06-12,San Mateo,081,765935,2784,2533,3,2536,75
2020-06-12,Santa Barbara,083,443738,2344,1969,19,1988,14
2020-06-12,Santa Clara,085,1922200,4054,3099,15,3114,149
2020-06-12,Santa Cruz,087,273765,284,251,0,251,2
2020-06-12,Shasta,089,179085,94,48,0,48,5
2020-06-12,Sierra,091,2930,1,1,0,1,0
2020-06-12,Siskiyou,093,43540,25,13,0,13,0
2020-06-12,Solano,095,438530,909,620,4,624,19
2020-06-12,Sonoma,097,501317,862,696,2,698,4
2020-06-12,Stanislaus,099,539301,1689,1092,6,1098,33
2020-06-12,Sutter,101,95872,95,56,0,56,2
2020-06-12,Tehama,103,63373,32,13,2,15,1
2020-06-12,Trinity,105,12862,13,2,3,5,0
2020-06-12,Tulare,107,460477,3635,2552,10,2562,95
2020-06-12,Tuolumne,109,53932,10,7,0,7,0
2020-06-12,Ventura,111,848112,2295,1534,13,1547,35
2020-06-12,Yolo,113,214977,313,243,0,243,24
2020-06-12,Yuba,115,75493,36,27,0,27,1
2020-06-11,Alameda,001,1643700,4779,4073,6,4079,108
2020-06-11,Alpine,003,1148,1,1,0,1,0
2020-06-11,Amador,005,37829,10,10,0,10,0
2020-06-11,Butte,007,227075,106,72,9,81,1
2020-06-11,Calaveras,009,45235,27,16,0,16,0
2020-06-11,Colusa,011,21464,12,7,0,7,0
2020-06-11,Contra Costa,013,1133247,2142,1797,2,1799,43
2020-06-11,Del Norte,015,27424,47,45,0,45,0
2020-06-11,El Dorado,017,186661,155,109,1,110,0
2020-06-11,Fresno,019,978130,4651,2338,56,2394,45
2020-06-11,Glenn,021,27897,42,21,0,21,0
2020-06-11,Humboldt,023,135768,122,113,0,113,3
2020-06-11,Imperial,025,180216,5626,3463,4,3467,36
2020-06-11,Inyo,027,18085,22,23,0,23,1
2020-06-11,Kern,029,883053,4127,3047,11,3058,54
2020-06-11,Kings,031,150075,1968,963,4,967,6
2020-06-11,Lake,033,64148,39,28,0,28,0
2020-06-11,Lassen,035,31185,15,5,2,7,0
2020-06-11,Los Angeles,037,10098052,78028,68807,20,68827,2800
2020-06-11,Madera,039,155013,445,178,2,180,3
2020-06-11,Marin,041,260295,789,637,2,639,17
2020-06-11,Mariposa,043,17540,18,16,0,16,1
2020-06-11,Mendocino,045,87422,40,35,0,35,0
2020-06-11,Merced,047,269075,625,370,1,371,7
2020-06-11,Modoc,049,8938,1,0,0,0,0
2020-06-11,Mono,051,14174,39,35,0,35,1
2020-06-11,Monterey,053,433212,1160,813,4,817,11
2020-06-11,Napa,055,140530,214,162,0,162,3
2020-06-11,Nevada,057,99092,67,50,1,51,1
2020-06-11,Orange,059,3164182,11728,8304,84,8388,188
2020-06-11,Placer,061,380077,476,321,3,324,9
2020-06-11,Plumas,063,18699,5,4,0,4,0
2020-06-11,Riverside,065,2383286,13217,10014,23,10037,361
2020-06-11,Sacramento,067,1510023,1925,1669,4,1673,60
2020-06-11,San Benito,069,59416,153,94,0,94,2
2020-06-11,San Bernardino,071,2135413,9173,6509,7,6516,221
2020-06-11,San Diego,073,3302833,10392,9000,0,9000,308
2020-06-11,San Francisco,075,870044,3041,2766,1,2767,44
2020-06-11,San Joaquin,077,732212,2074,1351,3,1354,43
2020-06-11,San Luis Obispo,079,281455,460,307,5,312,1
2020-06-11,San Mateo,081,765935,2746,2499,3,2502,74
2020-06-11,Santa Barbara,083,443738,2283,1895,19,1914,14
2020-06-11,Santa Clara,085,1922200,3987,3049,15,3064,149
2020-06-11,Santa Cruz,087,273765,280,247,0,247,2
2020-06-11,Shasta,089,179085,87,47,0,47,5
2020-06-11,Sierra,091,2930,1,1,0,1,0
2020-06-11,Siskiyou,093,43540,25,14,0,14,0
2020-06-11,Solano,095,438530,883,616,4,620,19
2020-06-11,Sonoma,097,501317,840,682,2,684,4
2020-06-11,Stanislaus,099,539301,1598,1062,6,1068,30
2020-06-11,Sutter,101,95872,92,56,0,56,2
2020-06-11,Tehama,103,63373,27,10,2,12,1
2020-06-11,Trinity,105,12862,11,2,3,5,0
2020-06-11,Tulare,107,460477,3536,2473,10,2483,95
2020-06-11,Tuolumne,109,53932,10,7,0,7,0
2020-06-11,Ventura,111,848112,2218,1491,12,1503,34
2020-06-11,Yolo,113,214977,305,230,0,230,24
2020-06-11,Yuba,115,75493,36,27,0,27,1
2020-06-10,Alameda,001,1643700,4679,4027,6,4033,107
2020-06-10,Alpine,003,1148,1,1,0,1,0
2020-06-10,Amador,005,37829,10,10,0,10,0
2020-06-10,Butte,007,227075,102,71,9,80,1
2020-06-10,Calaveras,009,45235,27,16,0,16,0
2020-06-10,Colusa,011,21464,11,7,0,7,0
2020-06-10,Contra Costa,013,1133247,2098,1778,2,1780,43
2020-06-10,Del Norte,015,27424,47,45,0,45,0
2020-06-10,El Dorado,017,186661,152,109,1,110,0
2020-06-10,Fresno,019,978130,4474,2324,56,2380,45
2020-06-10,Glenn,021,27897,39,21,0,21,0
2020-06-10,Humboldt,023,135768,118,112,0,112,3
2020-06-10,Imperial,025,180216,5478,3454,4,3458,36
2020-06-10,Inyo,027,18085,22,23,0,23,1
2020-06-10,Kern,029,883053,4002,3000,10,3010,54
2020-06-10,Kings,031,150075,1922,952,3,955,6
2020-06-10,Lake,033,64148,39,28,0,28,0
2020-06-10,Lassen,035,31185,15,5,2,7,0
2020-06-10,Los Angeles,037,10098052,76512,67018,20,67038,2752
2020-06-10,Madera,039,155013,431,176,1,177,3
2020-06-10,Marin,041,260295,757,633,2,635,17
2020-06-10,Mariposa,043,17540,17,16,0,16,1
2020-06-10,Mendocino,045,87422,39,35,0,35,0
2020-06-10,Merced,047,269075,592,370,1,371,7
2020-06-10,Modoc,049,8938,1,0,0,0,0
2020-06-10,Mono,051,14174,39,35,0,35,1
2020-06-10,Monterey,053,433212,1106,791,4,795,11
2020-06-10,Napa,055,140530,211,159,0,159,3
2020-06-10,Nevada,057,99092,65,50,1,51,1
2020-06-10,Orange,059,3164182,11452,8222,80,8302,184
2020-06-10,Placer,061,380077,451,309,3,312,9
2020-06-10,Plumas,063,18699,5,4,0,4,0
2020-06-10,Riverside,065,2383286,12894,9857,23,9880,361
2020-06-10,Sacramento,067,1510023,1886,1643,2,1645,59
2020-06-10,San Benito,069,59416,144,94,0,94,2
2020-06-10,San Bernardino,071,2135413,8880,6438,7,6445,219
2020-06-10,San Diego,073,3302833,10228,8839,0,8839,305
2020-06-10,San Francisco,075,870044,3016,2774,1,2775,44
2020-06-10,San Joaquin,077,732212,1945,1282,3,1285,41
2020-06-10,San Luis Obispo,079,281455,440,306,5,311,1
2020-06-10,San Mateo,081,765935,2706,2492,3,2495,74
2020-06-10,Santa Barbara,083,443738,2227,1878,19,1897,13
2020-06-10,Santa Clara,085,1922200,3936,3032,15,3047,149
2020-06-10,Santa Cruz,087,273765,276,242,0,242,2
2020-06-10,Shasta,089,179085,82,45,0,45,5
2020-06-10,Sierra,091,2930,1,1,0,1,0
2020-06-10,Siskiyou,093,43540,25,14,0,14,0
2020-06-10,Solano,095,438530,847,608,4,612,19
2020-06-10,Sonoma,097,501317,822,673,2,675,4
2020-06-10,Stanislaus,099,539301,1508,1030,6,1036,29
2020-06-10,Sutter,101,95872,91,56,0,56,2
2020-06-10,Tehama,103,63373,25,10,2,12,1
2020-06-10,Trinity,105,12862,11,2,3,5,0
2020-06-10,Tulare,107,460477,3443,2455,10,2465,95
2020-06-10,Tuolumne,109,53932,10,7,0,7,0
2020-06-10,Ventura,111,848112,2172,1446,11,1457,34
2020-06-10,Yolo,113,214977,297,226,0,226,24
2020-06-10,Yuba,115,75493,35,27,0,27,1
2020-06-09,Alameda,001,1643700,4569,3963,6,3969,103
2020-06-09,Alpine,003,1148,1,1,0,1,0
2020-06-09,Amador,005,37829,10,10,0,10,0
2020-06-09,Butte,007,227075,101,70,8,78,1
2020-06-09,Calaveras,009,45235,27,16,0,16,0
2020-06-09,Colusa,011,21464,10,7,0,7,0
2020-06-09,Contra Costa,013,1133247,2057,1744,2,1746,42
2020-06-09,Del Norte,015,27424,47,45,0,45,0
2020-06-09,El Dorado,017,186661,142,108,1,109,0
2020-06-09,Fresno,019,978130,4322,2278,56,2334,43
2020-06-09,Glenn,021,27897,38,19,0,19,0
2020-06-09,Humboldt,023,135768,116,113,0,113,2
2020-06-09,Imperial,025,180216,5327,3067,4,3071,36
2020-06-09,Inyo,027,18085,22,22,0,22,1
2020-06-09,Kern,029,883053,3874,2920,10,2930,51
2020-06-09,Kings,031,150075,1890,934,3,937,6
2020-06-09,Lake,033,64148,39,28,0,28,0
2020-06-09,Lassen,035,31185,15,5,2,7,0
2020-06-09,Los Angeles,037,10098052,74852,65827,20,65847,2692
2020-06-09,Madera,039,155013,416,172,1,173,3
2020-06-09,Marin,041,260295,721,616,2,618,17
2020-06-09,Mariposa,043,17540,17,16,0,16,1
2020-06-09,Mendocino,045,87422,35,35,0,35,0
2020-06-09,Merced,047,269075,563,349,1,350,7
2020-06-09,Modoc,049,8938,1,0,0,0,0
2020-06-09,Mono,051,14174,39,35,0,35,1
2020-06-09,Monterey,053,433212,1065,772,4,776,11
2020-06-09,Napa,055,140530,201,156,0,156,3
2020-06-09,Nevada,057,99092,57,50,1,51,1
2020-06-09,Orange,059,3164182,11211,7991,78,8069,174
2020-06-09,Placer,061,380077,438,301,3,304,9
2020-06-09,Plumas,063,18699,5,4,0,4,0
2020-06-09,Riverside,065,2383286,12516,9511,23,9534,354
2020-06-09,Sacramento,067,1510023,1832,1625,2,1627,59
2020-06-09,San Benito,069,59416,138,95,0,95,2
2020-06-09,San Bernardino,071,2135413,8557,6268,6,6274,217
2020-06-09,San Diego,073,3302833,10043,8731,0,8731,301
2020-06-09,San Francisco,075,870044,2991,2749,1,2750,44
2020-06-09,San Joaquin,077,732212,1839,1240,3,1243,41
2020-06-09,San Luis Obispo,079,281455,427,301,4,305,1
2020-06-09,San Mateo,081,765935,2675,2463,3,2466,74
2020-06-09,Santa Barbara,083,443738,2171,1854,19,1873,13
2020-06-09,Santa Clara,085,1922200,3868,3006,14,3020,147
2020-06-09,Santa Cruz,087,273765,270,237,0,237,2
2020-06-09,Shasta,089,179085,78,44,0,44,4
2020-06-09,Sierra,091,2930,1,1,0,1,0
2020-06-09,Siskiyou,093,43540,20,10,0,10,0
2020-06-09,Solano,095,438530,812,596,4,600,18
2020-06-09,Sonoma,097,501317,799,661,2,663,4
2020-06-09,Stanislaus,099,539301,1407,993,6,999,25
2020-06-09,Sutter,101,95872,88,56,0,56,2
2020-06-09,Tehama,103,63373,25,9,2,11,1
2020-06-09,Trinity,105,12862,10,2,3,5,0
2020-06-09,Tulare,107,460477,3377,2393,10,2403,91
2020-06-09,Tuolumne,109,53932,10,8,0,8,0
2020-06-09,Ventura,111,848112,2106,1407,11,1418,34
2020-06-09,Yolo,113,214977,286,226,0,226,24
2020-06-09,Yuba,115,75493,34,27,0,27,1
2020-06-08,Alameda,001,1643700,4488,3937,6,3943,103
2020-06-08,Alpine,003,1148,1,1,0,1,0
2020-06-08,Amador,005,37829,10,10,0,10,0
2020-06-08,Butte,007,227075,97,68,8,76,1
2020-06-08,Calaveras,009,45235,27,16,0,16,0
2020-06-08,Colusa,011,21464,9,7,0,7,0
2020-06-08,Contra Costa,013,1133247,2014,1714,2,1716,41
2020-06-08,Del Norte,015,27424,47,45,0,45,0
2020-06-08,El Dorado,017,186661,138,107,1,108,0
2020-06-08,Fresno,019,978130,4198,2194,55,2249,42
2020-06-08,Glenn,021,27897,36,17,0,17,0
2020-06-08,Humboldt,023,135768,116,112,0,112,2
2020-06-08,Imperial,025,180216,5175,3051,4,3055,21
2020-06-08,Inyo,027,18085,22,22,0,22,1
2020-06-08,Kern,029,883053,3743,2853,9,2862,49
2020-06-08,Kings,031,150075,1814,892,3,895,6
2020-06-08,Lake,033,64148,39,28,0,28,0
2020-06-08,Lassen,035,31185,15,4,2,6,0
2020-06-08,Los Angeles,037,10098052,73390,64634,20,64654,2640
2020-06-08,Madera,039,155013,386,154,1,155,3
2020-06-08,Marin,041,260295,680,596,2,598,17
2020-06-08,Mariposa,043,17540,16,16,0,16,1
2020-06-08,Mendocino,045,87422,33,32,0,32,0
2020-06-08,Merced,047,269075,529,331,1,332,7
2020-06-08,Modoc,049,8938,1,0,0,0,0
2020-06-08,Mono,051,14174,39,35,0,35,1
2020-06-08,Monterey,053,433212,1014,751,3,754,10
2020-06-08,Napa,055,140530,185,151,0,151,3
2020-06-08,Nevada,057,99092,56,50,1,51,1
2020-06-08,Orange,059,3164182,10960,7786,76,7862,160
2020-06-08,Placer,061,380077,421,290,3,293,9
2020-06-08,Plumas,063,18699,5,4,0,4,0
2020-06-08,Riverside,065,2383286,12147,9246,23,9269,347
2020-06-08,Sacramento,067,1510023,1782,1591,2,1593,59
2020-06-08,San Benito,069,59416,131,93,0,93,2
2020-06-08,San Bernardino,071,2135413,8238,6122,6,6128,214
2020-06-08,San Diego,073,3302833,9886,8621,0,8621,296
2020-06-08,San Francisco,075,870044,2964,2715,1,2716,43
2020-06-08,San Joaquin,077,732212,1732,1198,3,1201,40
2020-06-08,San Luis Obispo,079,281455,421,300,4,304,1
2020-06-08,San Mateo,081,765935,2644,2431,2,2433,74
2020-06-08,Santa Barbara,083,443738,2116,1824,17,1841,13
2020-06-08,Santa Clara,085,1922200,3822,2971,14,2985,146
2020-06-08,Santa Cruz,087,273765,269,234,0,234,2
2020-06-08,Shasta,089,179085,74,43,0,43,4
2020-06-08,Sierra,091,2930,1,1,0,1,0
2020-06-08,Siskiyou,093,43540,20,8,0,8,0
2020-06-08,Solano,095,438530,785,560,4,564,19
2020-06-08,Sonoma,097,501317,783,654,2,656,4
2020-06-08,Stanislaus,099,539301,1325,956,6,962,28
2020-06-08,Sutter,101,95872,81,55,0,55,2
2020-06-08,Tehama,103,63373,19,8,2,10,1
2020-06-08,Trinity,105,12862,10,2,3,5,0
2020-06-08,Tulare,107,460477,3294,2301,10,2311,91
2020-06-08,Tuolumne,109,53932,9,8,0,8,0
2020-06-08,Ventura,111,848112,2048,1382,11,1393,30
2020-06-08,Yolo,113,214977,275,228,0,228,24
2020-06-08,Yuba,115,75493,32,27,0,27,1
2020-06-07,Alameda,001,1643700,4375,3866,6,3872,102
2020-06-07,Alpine,003,1148,1,1,0,1,0
2020-06-07,Amador,005,37829,10,10,0,10,0
2020-06-07,Butte,007,227075,95,64,6,70,1
2020-06-07,Calaveras,009,45235,25,16,0,16,0
2020-06-07,Colusa,011,21464,9,7,0,7,0
2020-06-07,Contra Costa,013,1133247,1963,1653,1,1654,38
2020-06-07,Del Norte,015,27424,45,45,0,45,0
2020-06-07,El Dorado,017,186661,138,104,1,105,0
2020-06-07,Fresno,019,978130,4068,2144,55,2199,41
2020-06-07,Glenn,021,27897,29,16,0,16,0
2020-06-07,Humboldt,023,135768,116,112,0,112,2
2020-06-07,Imperial,025,180216,5025,3048,4,3052,19
2020-06-07,Inyo,027,18085,22,21,0,21,1
2020-06-07,Kern,029,883053,3612,2771,9,2780,46
2020-06-07,Kings,031,150075,1765,882,3,885,6
2020-06-07,Lake,033,64148,36,28,0,28,0
2020-06-07,Lassen,035,31185,14,4,2,6,0
2020-06-07,Los Angeles,037,10098052,71682,63750,20,63770,2629
2020-06-07,Madera,039,155013,369,149,1,150,3
2020-06-07,Marin,041,260295,666,584,2,586,17
2020-06-07,Mariposa,043,17540,16,16,0,16,1
2020-06-07,Mendocino,045,87422,33,32,0,32,0
2020-06-07,Merced,047,269075,496,318,1,319,7
2020-06-07,Modoc,049,8938,1,0,0,0,0
2020-06-07,Mono,051,14174,39,35,0,35,1
2020-06-07,Monterey,053,433212,968,732,3,735,10
2020-06-07,Napa,055,140530,177,142,0,142,3
2020-06-07,Nevada,057,99092,55,50,1,51,1
2020-06-07,Orange,059,3164182,10703,7643,74,7717,158
2020-06-07,Placer,061,380077,400,273,2,275,9
2020-06-07,Plumas,063,18699,5,4,0,4,0
2020-06-07,Riverside,065,2383286,11851,9105,23,9128,344
2020-06-07,Sacramento,067,1510023,1734,1568,2,1570,59
2020-06-07,San Benito,069,59416,128,92,0,92,2
2020-06-07,San Bernardino,071,2135413,7952,6033,6,6039,214
2020-06-07,San Diego,073,3302833,9707,8478,0,8478,296
2020-06-07,San Francisco,075,870044,2920,2674,0,2674,43
2020-06-07,San Joaquin,077,732212,1631,1126,3,1129,37
2020-06-07,San Luis Obispo,079,281455,411,296,4,300,1
2020-06-07,San Mateo,081,765935,2617,2399,2,2401,73
2020-06-07,Santa Barbara,083,443738,2061,1818,17,1835,13
2020-06-07,Santa Clara,085,1922200,3770,2947,14,2961,146
2020-06-07,Santa Cruz,087,273765,261,230,0,230,2
2020-06-07,Shasta,089,179085,73,41,0,41,4
2020-06-07,Sierra,091,2930,1,1,0,1,0
2020-06-07,Siskiyou,093,43540,20,8,0,8,0
2020-06-07,Solano,095,438530,762,560,4,564,19
2020-06-07,Sonoma,097,501317,752,639,2,641,4
2020-06-07,Stanislaus,099,539301,1245,905,5,910,28
2020-06-07,Sutter,101,95872,73,55,0,55,2
2020-06-07,Tehama,103,63373,16,8,2,10,1
2020-06-07,Trinity,105,12862,8,2,3,5,0
2020-06-07,Tulare,107,460477,3172,2219,10,2229,90
2020-06-07,Tuolumne,109,53932,9,4,0,4,0
2020-06-07,Ventura,111,848112,1982,1337,11,1348,30
2020-06-07,Yolo,113,214977,265,224,0,224,24
2020-06-07,Yuba,115,75493,32,27,0,27,1
2020-06-06,Alameda,001,1643700,4330,3801,6,3807,102
2020-06-06,Alpine,003,1148,1,1,0,1,0
2020-06-06,Amador,005,37829,10,10,0,10,0
2020-06-06,Butte,007,227075,94,63,6,69,1
2020-06-06,Calaveras,009,45235,23,16,0,16,0
2020-06-06,Colusa,011,21464,9,7,0,7,0
2020-06-06,Contra Costa,013,1133247,1942,1619,1,1620,37
2020-06-06,Del Norte,015,27424,45,45,0,45,0
2020-06-06,El Dorado,017,186661,133,104,1,105,0
2020-06-06,Fresno,019,978130,4013,2117,55,2172,41
2020-06-06,Glenn,021,27897,27,16,0,16,0
2020-06-06,Humboldt,023,135768,116,112,0,112,2
2020-06-06,Imperial,025,180216,4949,3047,4,3051,19
2020-06-06,Inyo,027,18085,22,21,0,21,1
2020-06-06,Kern,029,883053,3541,2695,9,2704,46
2020-06-06,Kings,031,150075,1746,882,3,885,6
2020-06-06,Lake,033,64148,36,28,0,28,0
2020-06-06,Lassen,035,31185,14,4,2,6,0
2020-06-06,Los Angeles,037,10098052,70929,62269,20,62289,2607
2020-06-06,Madera,039,155013,360,149,1,150,3
2020-06-06,Marin,041,260295,661,556,2,558,17
2020-06-06,Mariposa,043,17540,16,16,0,16,1
2020-06-06,Mendocino,045,87422,33,32,0,32,0
2020-06-06,Merced,047,269075,495,315,1,316,7
2020-06-06,Modoc,049,8938,1,0,0,0,0
2020-06-06,Mono,051,14174,39,35,0,35,1
2020-06-06,Monterey,053,433212,944,679,3,682,10
2020-06-06,Napa,055,140530,171,136,0,136,3
2020-06-06,Nevada,057,99092,54,50,1,51,1
2020-06-06,Orange,059,3164182,10544,7576,73,7649,157
2020-06-06,Placer,061,380077,388,270,2,272,9
2020-06-06,Plumas,063,18699,5,4,0,4,0
2020-06-06,Riverside,065,2383286,11673,8935,23,8958,345
2020-06-06,Sacramento,067,1510023,1711,1533,2,1535,59
2020-06-06,San Benito,069,59416,118,92,0,92,2
2020-06-06,San Bernardino,071,2135413,7803,5946,6,5952,214
2020-06-06,San Diego,073,3302833,9586,8347,0,8347,296
2020-06-06,San Francisco,075,870044,2905,2674,0,2674,43
2020-06-06,San Joaquin,077,732212,1591,1076,3,1079,37
2020-06-06,San Luis Obispo,079,281455,405,295,4,299,1
2020-06-06,San Mateo,081,765935,2602,2342,2,2344,72
2020-06-06,Santa Barbara,083,443738,2022,1815,17,1832,13
2020-06-06,Santa Clara,085,1922200,3729,2934,14,2948,144
2020-06-06,Santa Cruz,087,273765,259,226,0,226,2
2020-06-06,Shasta,089,179085,73,40,0,40,4
2020-06-06,Sierra,091,2930,1,1,0,1,0
2020-06-06,Siskiyou,093,43540,18,8,0,8,0
2020-06-06,Solano,095,438530,747,560,4,564,19
2020-06-06,Sonoma,097,501317,740,622,2,624,4
2020-06-06,Stanislaus,099,539301,1211,858,5,863,27
2020-06-06,Sutter,101,95872,73,51,0,51,2
2020-06-06,Tehama,103,63373,15,8,2,10,1
2020-06-06,Trinity,105,12862,8,2,2,4,0
2020-06-06,Tulare,107,460477,3139,2213,10,2223,90
2020-06-06,Tuolumne,109,53932,9,4,0,4,0
2020-06-06,Ventura,111,848112,1958,1303,11,1314,30
2020-06-06,Yolo,113,214977,263,223,0,223,24
2020-06-06,Yuba,115,75493,32,27,0,27,1
2020-06-05,Alameda,001,1643700,4279,3734,6,3740,102
2020-06-05,Alpine,003,1148,1,1,0,1,0
2020-06-05,Amador,005,37829,10,10,0,10,0
2020-06-05,Butte,007,227075,91,61,6,67,1
2020-06-05,Calaveras,009,45235,22,16,0,16,0
2020-06-05,Colusa,011,21464,9,7,0,7,0
2020-06-05,Contra Costa,013,1133247,1927,1575,1,1576,37
2020-06-05,Del Norte,015,27424,45,45,0,45,0
2020-06-05,El Dorado,017,186661,131,101,1,102,0
2020-06-05,Fresno,019,978130,3949,2051,54,2105,38
2020-06-05,Glenn,021,27897,25,16,0,16,0
2020-06-05,Humboldt,023,135768,115,111,0,111,2
2020-06-05,Imperial,025,180216,4842,2778,4,2782,19
2020-06-05,Inyo,027,18085,22,21,0,21,1
2020-06-05,Kern,029,883053,3452,2624,9,2633,46
2020-06-05,Kings,031,150075,1731,865,3,868,6
2020-06-05,Lake,033,64148,35,28,0,28,0
2020-06-05,Lassen,035,31185,13,4,2,6,0
2020-06-05,Los Angeles,037,10098052,69777,60955,20,60975,2553
2020-06-05,Madera,039,155013,338,144,1,145,3
2020-06-05,Marin,041,260295,652,546,2,548,17
2020-06-05,Mariposa,043,17540,16,16,0,16,1
2020-06-05,Mendocino,045,87422,33,32,0,32,0
2020-06-05,Merced,047,269075,493,309,1,310,7
2020-06-05,Modoc,049,8938,1,0,0,0,0
2020-06-05,Mono,051,14174,39,35,0,35,1
2020-06-05,Monterey,053,433212,912,649,3,652,10
2020-06-05,Napa,055,140530,168,123,0,123,3
2020-06-05,Nevada,057,99092,54,50,1,51,1
2020-06-05,Orange,059,3164182,10349,7391,72,7463,153
2020-06-05,Placer,061,380077,378,265,2,267,9
2020-06-05,Plumas,063,18699,5,4,0,4,0
2020-06-05,Riverside,065,2383286,11414,8700,23,8723,345
2020-06-05,Sacramento,067,1510023,1689,1514,2,1516,59
2020-06-05,San Benito,069,59416,116,92,0,92,2
2020-06-05,San Bernardino,071,2135413,7621,5869,5,5874,212
2020-06-05,San Diego,073,3302833,9471,8182,0,8182,294
2020-06-05,San Francisco,075,870044,2887,2675,0,2675,43
2020-06-05,San Joaquin,077,732212,1512,1046,3,1049,36
2020-06-05,San Luis Obispo,079,281455,398,293,4,297,1
2020-06-05,San Mateo,081,765935,2577,2331,2,2333,72
2020-06-05,Santa Barbara,083,443738,1991,1795,17,1812,13
2020-06-05,Santa Clara,085,1922200,3694,2902,14,2916,144
2020-06-05,Santa Cruz,087,273765,256,222,0,222,2
2020-06-05,Shasta,089,179085,72,40,0,40,4
2020-06-05,Sierra,091,2930,1,1,0,1,0
2020-06-05,Siskiyou,093,43540,16,8,0,8,0
2020-06-05,Solano,095,438530,740,558,4,562,19
2020-06-05,Sonoma,097,501317,719,618,2,620,4
2020-06-05,Stanislaus,099,539301,1178,842,5,847,27
2020-06-05,Sutter,101,95872,73,49,0,49,2
2020-06-05,Tehama,103,63373,15,7,2,9,1
2020-06-05,Trinity,105,12862,8,1,2,3,0
2020-06-05,Tulare,107,460477,3090,2180,10,2190,90
2020-06-05,Tuolumne,109,53932,9,4,0,4,0
2020-06-05,Ventura,111,848112,1925,1274,11,1285,30
2020-06-05,Yolo,113,214977,262,216,0,216,24
2020-06-05,Yuba,115,75493,32,27,0,27,1
2020-06-04,Alameda,001,1643700,4180,3643,6,3649,99
2020-06-04,Alpine,003,1148,1,1,0,1,0
2020-06-04,Amador,005,37829,10,10,0,10,0
2020-06-04,Butte,007,227075,87,57,5,62,1
2020-06-04,Calaveras,009,45235,22,15,0,15,0
2020-06-04,Colusa,011,21464,9,7,0,7,0
2020-06-04,Contra Costa,013,1133247,1869,1551,1,1552,37
2020-06-04,Del Norte,015,27424,45,45,0,45,0
2020-06-04,El Dorado,017,186661,129,101,1,102,0
2020-06-04,Fresno,019,978130,3844,2007,53,2060,35
2020-06-04,Glenn,021,27897,22,16,0,16,0
2020-06-04,Humboldt,023,135768,115,109,0,109,2
2020-06-04,Imperial,025,180216,4660,2631,4,2635,19
2020-06-04,Inyo,027,18085,22,20,0,20,1
2020-06-04,Kern,029,883053,3336,2530,9,2539,46
2020-06-04,Kings,031,150075,1661,842,3,845,6
2020-06-04,Lake,033,64148,34,27,0,27,0
2020-06-04,Lassen,035,31185,11,4,2,6,0
2020-06-04,Los Angeles,037,10098052,68311,59596,20,59616,2515
2020-06-04,Madera,039,155013,330,127,1,128,3
2020-06-04,Marin,041,260295,630,533,2,535,14
2020-06-04,Mariposa,043,17540,16,16,0,16,1
2020-06-04,Mendocino,045,87422,33,29,0,29,0
2020-06-04,Merced,047,269075,473,304,1,305,7
2020-06-04,Modoc,049,8938,1,0,0,0,0
2020-06-04,Mono,051,14174,39,35,0,35,1
2020-06-04,Monterey,053,433212,877,621,2,623,10
2020-06-04,Napa,055,140530,164,117,0,117,3
2020-06-04,Nevada,057,99092,53,49,1,50,1
2020-06-04,Orange,059,3164182,10097,7192,71,7263,148
2020-06-04,Placer,061,380077,362,256,2,258,9
2020-06-04,Plumas,063,18699,4,4,0,4,0
2020-06-04,Riverside,065,2383286,11136,8473,23,8496,341
2020-06-04,Sacramento,067,1510023,1661,1492,2,1494,58
2020-06-04,San Benito,069,59416,114,88,0,88,2
2020-06-04,San Bernardino,071,2135413,7352,5726,5,5731,207
2020-06-04,San Diego,073,3302833,9308,7942,0,7942,288
2020-06-04,San Francisco,075,870044,2854,2636,0,2636,43
2020-06-04,San Joaquin,077,732212,1450,1016,3,1019,36
2020-06-04,San Luis Obispo,079,281455,387,288,4,292,1
2020-06-04,San Mateo,081,765935,2550,2284,2,2286,72
2020-06-04,Santa Barbara,083,443738,1960,1750,16,1766,13
2020-06-04,Santa Clara,085,1922200,3660,2871,14,2885,144
2020-06-04,Santa Cruz,087,273765,250,218,0,218,2
2020-06-04,Shasta,089,179085,66,40,0,40,4
2020-06-04,Sierra,091,2930,1,1,0,1,0
2020-06-04,Siskiyou,093,43540,15,8,0,8,0
2020-06-04,Solano,095,438530,723,551,4,555,19
2020-06-04,Sonoma,097,501317,700,591,1,592,4
2020-06-04,Stanislaus,099,539301,1102,806,5,811,28
2020-06-04,Sutter,101,95872,68,46,0,46,2
2020-06-04,Tehama,103,63373,14,6,1,7,1
2020-06-04,Trinity,105,12862,8,1,2,3,0
2020-06-04,Tulare,107,460477,2973,2086,10,2096,90
2020-06-04,Tuolumne,109,53932,8,4,0,4,0
2020-06-04,Ventura,111,848112,1881,1236,10,1246,30
2020-06-04,Yolo,113,214977,257,216,0,216,24
2020-06-04,Yuba,115,75493,31,27,0,27,1
2020-06-03,Alameda,001,1643700,4121,3589,5,3594,99
2020-06-03,Alpine,003,1148,1,1,0,1,0
2020-06-03,Amador,005,37829,10,10,0,10,0
2020-06-03,Butte,007,227075,85,53,5,58,1
2020-06-03,Calaveras,009,45235,21,15,0,15,0
2020-06-03,Colusa,011,21464,9,7,0,7,0
2020-06-03,Contra Costa,013,1133247,1821,1511,1,1512,37
2020-06-03,Del Norte,015,27424,45,39,0,39,0
2020-06-03,El Dorado,017,186661,126,90,1,91,0
2020-06-03,Fresno,019,978130,3745,1943,53,1996,35
2020-06-03,Glenn,021,27897,22,16,0,16,0
2020-06-03,Humboldt,023,135768,115,103,0,103,2
2020-06-03,Imperial,025,180216,4487,2540,4,2544,19
2020-06-03,Inyo,027,18085,22,20,0,20,1
2020-06-03,Kern,029,883053,3240,2452,8,2460,44
2020-06-03,Kings,031,150075,1596,744,3,747,6
2020-06-03,Lake,033,64148,32,26,0,26,0
2020-06-03,Lassen,035,31185,11,4,2,6,0
2020-06-03,Los Angeles,037,10098052,66702,58166,20,58186,2472
2020-06-03,Madera,039,155013,322,117,1,118,3
2020-06-03,Marin,041,260295,612,527,2,529,14
2020-06-03,Mariposa,043,17540,16,16,0,16,1
2020-06-03,Mendocino,045,87422,32,29,0,29,0
2020-06-03,Merced,047,269075,459,299,1,300,7
2020-06-03,Modoc,049,8938,1,0,0,0,0
2020-06-03,Mono,051,14174,39,35,0,35,1
2020-06-03,Monterey,053,433212,849,592,2,594,10
2020-06-03,Napa,055,140530,163,116,0,116,3
2020-06-03,Nevada,057,99092,52,43,1,44,1
2020-06-03,Orange,059,3164182,9871,6939,70,7009,145
2020-06-03,Placer,061,380077,342,243,2,245,9
2020-06-03,Plumas,063,18699,4,4,0,4,0
2020-06-03,Riverside,065,2383286,10862,8208,23,8231,335
2020-06-03,Sacramento,067,1510023,1632,1457,2,1459,58
2020-06-03,San Benito,069,59416,108,88,0,88,2
2020-06-03,San Bernardino,071,2135413,7129,5565,5,5570,203
2020-06-03,San Diego,073,3302833,9160,7800,0,7800,283
2020-06-03,San Francisco,075,870044,2823,2608,0,2608,43
2020-06-03,San Joaquin,077,732212,1386,1004,3,1007,35
2020-06-03,San Luis Obispo,079,281455,382,279,4,283,1
2020-06-03,San Mateo,081,765935,2522,2243,2,2245,71
2020-06-03,Santa Barbara,083,443738,1926,1722,15,1737,12
2020-06-03,Santa Clara,085,1922200,3618,2836,14,2850,144
2020-06-03,Santa Cruz,087,273765,244,217,0,217,2
2020-06-03,Shasta,089,179085,63,40,0,40,4
2020-06-03,Sierra,091,2930,1,1,0,1,0
2020-06-03,Siskiyou,093,43540,14,8,0,8,0
2020-06-03,Solano,095,438530,698,543,2,545,18
2020-06-03,Sonoma,097,501317,688,578,1,579,4
2020-06-03,Stanislaus,099,539301,1062,780,5,785,27
2020-06-03,Sutter,101,95872,60,45,0,45,2
2020-06-03,Tehama,103,63373,14,6,1,7,1
2020-06-03,Trinity,105,12862,8,1,2,3,0
2020-06-03,Tulare,107,460477,2904,2041,10,2051,88
2020-06-03,Tuolumne,109,53932,6,4,0,4,0
2020-06-03,Ventura,111,848112,1814,1202,10,1212,30
2020-06-03,Yolo,113,214977,253,213,0,213,24
2020-06-03,Yuba,115,75493,31,27,0,27,1
2020-06-02,Alameda,001,1643700,4045,3517,5,3522,99
2020-06-02,Alpine,003,1148,1,1,0,1,0
2020-06-02,Amador,005,37829,10,10,0,10,0
2020-06-02,Butte,007,227075,81,51,4,55,1
2020-06-02,Calaveras,009,45235,21,15,0,15,0
2020-06-02,Colusa,011,21464,9,7,0,7,0
2020-06-02,Contra Costa,013,1133247,1789,1505,1,1506,37
2020-06-02,Del Norte,015,27424,45,39,0,39,0
2020-06-02,El Dorado,017,186661,125,88,1,89,0
2020-06-02,Fresno,019,978130,3632,1917,53,1970,34
2020-06-02,Glenn,021,27897,21,16,0,16,0
2020-06-02,Humboldt,023,135768,115,101,0,101,2
2020-06-02,Imperial,025,180216,4294,2459,4,2463,19
2020-06-02,Inyo,027,18085,20,20,0,20,1
2020-06-02,Kern,029,883053,3141,2406,6,2412,41
2020-06-02,Kings,031,150075,1568,720,3,723,5
2020-06-02,Lake,033,64148,32,25,0,25,0
2020-06-02,Lassen,035,31185,10,4,2,6,0
2020-06-02,Los Angeles,037,10098052,65298,57144,20,57164,2430
2020-06-02,Madera,039,155013,301,110,1,111,2
2020-06-02,Marin,041,260295,585,509,2,511,14
2020-06-02,Mariposa,043,17540,16,16,0,16,1
2020-06-02,Mendocino,045,87422,32,29,0,29,0
2020-06-02,Merced,047,269075,443,297,1,298,6
2020-06-02,Modoc,049,8938,1,0,0,0,0
2020-06-02,Mono,051,14174,39,35,0,35,1
2020-06-02,Monterey,053,433212,819,582,2,584,10
2020-06-02,Napa,055,140530,154,116,0,116,3
2020-06-02,Nevada,057,99092,51,41,1,42,1
2020-06-02,Orange,059,3164182,9670,6790,69,6859,142
2020-06-02,Placer,061,380077,328,226,2,228,9
2020-06-02,Plumas,063,18699,4,4,0,4,0
2020-06-02,Riverside,065,2383286,10566,8091,22,8113,330
2020-06-02,Sacramento,067,1510023,1603,1428,2,1430,58
2020-06-02,San Benito,069,59416,107,86,0,86,2
2020-06-02,San Bernardino,071,2135413,6922,5438,5,5443,202
2020-06-02,San Diego,073,3302833,9014,7676,0,7676,276
2020-06-02,San Francisco,075,870044,2788,2554,0,2554,43
2020-06-02,San Joaquin,077,732212,1320,985,3,988,35
2020-06-02,San Luis Obispo,079,281455,377,275,4,279,1
2020-06-02,San Mateo,081,765935,2487,2203,2,2205,71
2020-06-02,Santa Barbara,083,443738,1886,1703,15,1718,12
2020-06-02,Santa Clara,085,1922200,3568,2819,14,2833,144
2020-06-02,Santa Cruz,087,273765,239,215,0,215,2
2020-06-02,Shasta,089,179085,62,38,0,38,4
2020-06-02,Sierra,091,2930,1,1,0,1,0
2020-06-02,Siskiyou,093,43540,13,8,0,8,0
2020-06-02,Solano,095,438530,683,537,1,538,18
2020-06-02,Sonoma,097,501317,677,571,1,572,4
2020-06-02,Stanislaus,099,539301,1003,772,5,777,27
2020-06-02,Sutter,101,95872,57,43,0,43,2
2020-06-02,Tehama,103,63373,14,6,1,7,1
2020-06-02,Trinity,105,12862,8,1,2,3,0
2020-06-02,Tulare,107,460477,2824,2012,10,2022,86
2020-06-02,Tuolumne,109,53932,6,4,0,4,0
2020-06-02,Ventura,111,848112,1761,1178,10,1188,30
2020-06-02,Yolo,113,214977,251,213,0,213,24
2020-06-02,Yuba,115,75493,31,27,0,27,1
2020-06-01,Alameda,001,1643700,3979,3460,5,3465,98
2020-06-01,Alpine,003,1148,1,1,0,1,0
2020-06-01,Amador,005,37829,10,10,0,10,0
2020-06-01,Butte,007,227075,80,50,3,53,1
2020-06-01,Calaveras,009,45235,21,15,0,15,0
2020-06-01,Colusa,011,21464,9,7,0,7,0
2020-06-01,Contra Costa,013,1133247,1753,1486,1,1487,37
2020-06-01,Del Norte,015,27424,45,38,0,38,0
2020-06-01,El Dorado,017,186661,123,88,1,89,0
2020-06-01,Fresno,019,978130,3537,1854,51,1905,33
2020-06-01,Glenn,021,27897,21,16,0,16,0
2020-06-01,Humboldt,023,135768,115,98,0,98,2
2020-06-01,Imperial,025,180216,4072,2366,4,2370,14
2020-06-01,Inyo,027,18085,20,20,0,20,1
2020-06-01,Kern,029,883053,3058,2366,6,2372,38
2020-06-01,Kings,031,150075,1300,703,3,706,4
2020-06-01,Lake,033,64148,32,22,0,22,0
2020-06-01,Lassen,035,31185,10,4,2,6,0
2020-06-01,Los Angeles,037,10098052,63825,55899,20,55919,2367
2020-06-01,Madera,039,155013,289,103,1,104,2
2020-06-01,Marin,041,260295,544,495,2,497,14
2020-06-01,Mariposa,043,17540,16,16,0,16,1
2020-06-01,Mendocino,045,87422,32,28,0,28,0
2020-06-01,Merced,047,269075,424,289,1,290,6
2020-06-01,Modoc,049,8938,1,0,0,0,0
2020-06-01,Mono,051,14174,39,35,0,35,1
2020-06-01,Monterey,053,433212,795,554,2,556,10
2020-06-01,Napa,055,140530,151,114,0,114,3
2020-06-01,Nevada,057,99092,51,41,1,42,1
2020-06-01,Orange,059,3164182,9473,6640,68,6708,135
2020-06-01,Placer,061,380077,316,218,2,220,9
2020-06-01,Plumas,063,18699,4,4,0,4,0
2020-06-01,Riverside,065,2383286,10114,7921,21,7942,322
2020-06-01,Sacramento,067,1510023,1564,1415,2,1417,58
2020-06-01,San Benito,069,59416,104,86,0,86,2
2020-06-01,San Bernardino,071,2135413,6716,5310,5,5315,202
2020-06-01,San Diego,073,3302833,8834,7556,0,7556,269
2020-06-01,San Francisco,075,870044,2751,2546,0,2546,43
2020-06-01,San Joaquin,077,732212,1255,957,3,960,35
2020-06-01,San Luis Obispo,079,281455,373,275,4,279,1
2020-06-01,San Mateo,081,765935,2457,2190,2,2192,71
2020-06-01,Santa Barbara,083,443738,1852,1671,14,1685,10
2020-06-01,Santa Clara,085,1922200,3530,2797,13,2810,142
2020-06-01,Santa Cruz,087,273765,235,215,0,215,2
2020-06-01,Shasta,089,179085,62,38,0,38,4
2020-06-01,Sierra,091,2930,1,1,0,1,0
2020-06-01,Siskiyou,093,43540,13,7,0,7,0
2020-06-01,Solano,095,438530,659,529,1,530,17
2020-06-01,Sonoma,097,501317,661,565,1,566,4
2020-06-01,Stanislaus,099,539301,966,758,5,763,27
2020-06-01,Sutter,101,95872,52,43,0,43,2
2020-06-01,Tehama,103,63373,11,5,1,6,1
2020-06-01,Trinity,105,12862,7,1,2,3,0
2020-06-01,Tulare,107,460477,2709,1976,10,1986,84
2020-06-01,Tuolumne,109,53932,5,4,0,4,0
2020-06-01,Ventura,111,848112,1708,1163,10,1173,29
2020-06-01,Yolo,113,214977,248,212,0,212,24
2020-06-01,Yuba,115,75493,30,26,0,26,1
2020-05-31,Alameda,001,1643700,3874,3362,5,3367,98
2020-05-31,Alpine,003,1148,1,1,0,1,0
2020-05-31,Amador,005,37829,10,10,0,10,0
2020-05-31,Butte,007,227075,78,51,3,54,0
2020-05-31,Calaveras,009,45235,18,15,0,15,0
2020-05-31,Colusa,011,21464,9,5,0,5,0
2020-05-31,Contra Costa,013,1133247,1719,1458,1,1459,37
2020-05-31,Del Norte,015,27424,45,37,0,37,0
2020-05-31,El Dorado,017,186661,119,88,1,89,0
2020-05-31,Fresno,019,978130,3372,1780,46,1826,31
2020-05-31,Glenn,021,27897,20,16,0,16,0
2020-05-31,Humboldt,023,135768,113,98,0,98,2
2020-05-31,Imperial,025,180216,3805,2197,4,2201,14
2020-05-31,Inyo,027,18085,20,20,0,20,1
2020-05-31,Kern,029,883053,2923,2300,6,2306,38
2020-05-31,Kings,031,150075,1263,703,3,706,3
2020-05-31,Lake,033,64148,32,19,0,19,0
2020-05-31,Lassen,035,31185,10,4,2,6,0
2020-05-31,Los Angeles,037,10098052,62530,54925,20,54945,2344
2020-05-31,Madera,039,155013,271,101,1,102,2
2020-05-31,Marin,041,260295,534,486,2,488,14
2020-05-31,Mariposa,043,17540,16,16,0,16,1
2020-05-31,Mendocino,045,87422,32,24,0,24,0
2020-05-31,Merced,047,269075,397,288,0,288,6
2020-05-31,Modoc,049,8938,0,0,0,0,0
2020-05-31,Mono,051,14174,39,34,0,34,1
2020-05-31,Monterey,053,433212,721,545,2,547,10
2020-05-31,Napa,055,140530,149,114,0,114,3
2020-05-31,Nevada,057,99092,50,41,1,42,1
2020-05-31,Orange,059,3164182,9263,6532,67,6599,135
2020-05-31,Placer,061,380077,294,215,2,217,9
2020-05-31,Plumas,063,18699,4,4,0,4,0
2020-05-31,Riverside,065,2383286,9858,7704,21,7725,321
2020-05-31,Sacramento,067,1510023,1533,1398,2,1400,57
2020-05-31,San Benito,069,59416,98,85,0,85,2
2020-05-31,San Bernardino,071,2135413,6448,5185,5,5190,198
2020-05-31,San Diego,073,3302833,8640,7483,0,7483,269
2020-05-31,San Francisco,075,870044,2715,2501,0,2501,43
2020-05-31,San Joaquin,077,732212,1190,888,3,891,34
2020-05-31,San Luis Obispo,079,281455,363,271,4,275,1
2020-05-31,San Mateo,081,765935,2411,2169,2,2171,71
2020-05-31,Santa Barbara,083,443738,1801,1662,13,1675,9
2020-05-31,Santa Clara,085,1922200,3486,2785,13,2798,142
2020-05-31,Santa Cruz,087,273765,232,210,0,210,2
2020-05-31,Shasta,089,179085,60,38,0,38,4
2020-05-31,Sierra,091,2930,1,1,0,1,0
2020-05-31,Siskiyou,093,43540,12,7,0,7,0
2020-05-31,Solano,095,438530,633,512,1,513,6
2020-05-31,Sonoma,097,501317,641,555,1,556,4
2020-05-31,Stanislaus,099,539301,912,738,5,743,27
2020-05-31,Sutter,101,95872,50,42,0,42,2
2020-05-31,Tehama,103,63373,10,4,1,5,1
2020-05-31,Trinity,105,12862,7,1,2,3,0
2020-05-31,Tulare,107,460477,2636,1884,10,1894,82
2020-05-31,Tuolumne,109,53932,5,4,0,4,0
2020-05-31,Ventura,111,848112,1647,1151,10,1161,30
2020-05-31,Yolo,113,214977,242,211,0,211,24
2020-05-31,Yuba,115,75493,30,26,0,26,1
2020-05-30,Alameda,001,1643700,3848,3304,5,3309,96
2020-05-30,Alpine,003,1148,1,1,0,1,0
2020-05-30,Amador,005,37829,10,10,0,10,0
2020-05-30,Butte,007,227075,77,44,3,47,0
2020-05-30,Calaveras,009,45235,17,15,0,15,0
2020-05-30,Colusa,011,21464,8,5,0,5,0
2020-05-30,Contra Costa,013,1133247,1703,1429,1,1430,37
2020-05-30,Del Norte,015,27424,45,37,0,37,0
2020-05-30,El Dorado,017,186661,118,86,1,87,0
2020-05-30,Fresno,019,978130,3311,1744,45,1789,31
2020-05-30,Glenn,021,27897,19,16,0,16,0
2020-05-30,Humboldt,023,135768,112,98,0,98,2
2020-05-30,Imperial,025,180216,3715,2091,4,2095,14
2020-05-30,Inyo,027,18085,20,20,0,20,1
2020-05-30,Kern,029,883053,2854,2217,6,2223,38
2020-05-30,Kings,031,150075,1249,703,3,706,3
2020-05-30,Lake,033,64148,31,18,0,18,0
2020-05-30,Lassen,035,31185,10,4,2,6,0
2020-05-30,Los Angeles,037,10098052,61994,53627,20,53647,2319
2020-05-30,Madera,039,155013,266,101,1,102,2
2020-05-30,Marin,041,260295,534,462,2,464,14
2020-05-30,Mariposa,043,17540,16,16,0,16,1
2020-05-30,Mendocino,045,87422,32,24,0,24,0
2020-05-30,Merced,047,269075,396,285,0,285,6
2020-05-30,Modoc,049,8938,0,0,0,0,0
2020-05-30,Mono,051,14174,39,34,0,34,1
2020-05-30,Monterey,053,433212,705,520,2,522,10
2020-05-30,Napa,055,140530,147,113,0,113,3
2020-05-30,Nevada,057,99092,50,41,1,42,1
2020-05-30,Orange,059,3164182,9106,6354,67,6421,134
2020-05-30,Placer,061,380077,286,199,1,200,9
2020-05-30,Plumas,063,18699,4,4,0,4,0
2020-05-30,Riverside,065,2383286,9714,7492,21,7513,316
2020-05-30,Sacramento,067,1510023,1522,1384,2,1386,57
2020-05-30,San Benito,069,59416,97,85,0,85,2
2020-05-30,San Bernardino,071,2135413,6339,5122,5,5127,198
2020-05-30,San Diego,073,3302833,8547,7387,0,7387,269
2020-05-30,San Francisco,075,870044,2690,2496,0,2496,41
2020-05-30,San Joaquin,077,732212,1152,888,3,891,34
2020-05-30,San Luis Obispo,079,281455,358,270,4,274,1
2020-05-30,San Mateo,081,765935,2387,2129,2,2131,71
2020-05-30,Santa Barbara,083,443738,1782,1660,13,1673,9
2020-05-30,Santa Clara,085,1922200,3470,2741,13,2754,141
2020-05-30,Santa Cruz,087,273765,232,206,0,206,2
2020-05-30,Shasta,089,179085,60,36,0,36,4
2020-05-30,Sierra,091,2930,1,1,0,1,0
2020-05-30,Siskiyou,093,43540,11,7,0,7,0
2020-05-30,Solano,095,438530,626,512,1,513,6
2020-05-30,Sonoma,097,501317,631,551,1,552,4
2020-05-30,Stanislaus,099,539301,895,712,5,717,27
2020-05-30,Sutter,101,95872,49,40,0,40,2
2020-05-30,Tehama,103,63373,10,4,1,5,1
2020-05-30,Trinity,105,12862,7,1,2,3,0
2020-05-30,Tulare,107,460477,2599,1879,10,1889,81
2020-05-30,Tuolumne,109,53932,5,4,0,4,0
2020-05-30,Ventura,111,848112,1630,1116,10,1126,30
2020-05-30,Yolo,113,214977,238,210,0,210,24
2020-05-30,Yuba,115,75493,30,25,0,25,1
2020-05-29,Alameda,001,1643700,3813,3209,5,3214,96
2020-05-29,Alpine,003,1148,1,1,0,1,0
2020-05-29,Amador,005,37829,10,10,0,10,0
2020-05-29,Butte,007,227075,72,41,3,44,0
2020-05-29,Calaveras,009,45235,17,15,0,15,0
2020-05-29,Colusa,011,21464,8,5,0,5,0
2020-05-29,Contra Costa,013,1133247,1687,1411,1,1412,37
2020-05-29,Del Norte,015,27424,45,37,0,37,0
2020-05-29,El Dorado,017,186661,117,85,1,86,0
2020-05-29,Fresno,019,978130,3261,1687,45,1732,31
2020-05-29,Glenn,021,27897,19,14,0,14,0
2020-05-29,Humboldt,023,135768,111,98,0,98,2
2020-05-29,Imperial,025,180216,3597,1607,4,1611,14
2020-05-29,Inyo,027,18085,20,20,0,20,1
2020-05-29,Kern,029,883053,2796,2128,6,2134,36
2020-05-29,Kings,031,150075,1238,693,3,696,3
2020-05-29,Lake,033,64148,30,17,0,17,0
2020-05-29,Lassen,035,31185,10,0,2,2,0
2020-05-29,Los Angeles,037,10098052,61037,51578,20,51598,2273
2020-05-29,Madera,039,155013,251,98,1,99,2
2020-05-29,Marin,041,260295,526,448,2,450,14
2020-05-29,Mariposa,043,17540,16,16,0,16,1
2020-05-29,Mendocino,045,87422,30,25,0,25,0
2020-05-29,Merced,047,269075,391,285,0,285,7
2020-05-29,Modoc,049,8938,0,0,0,0,0
2020-05-29,Mono,051,14174,38,34,0,34,1
2020-05-29,Monterey,053,433212,675,479,2,481,10
2020-05-29,Napa,055,140530,144,113,0,113,3
2020-05-29,Nevada,057,99092,50,41,1,42,1
2020-05-29,Orange,059,3164182,8920,6176,64,6240,133
2020-05-29,Placer,061,380077,264,199,1,200,9
2020-05-29,Plumas,063,18699,4,4,0,4,0
2020-05-29,Riverside,065,2383286,9528,7376,21,7397,313
2020-05-29,Sacramento,067,1510023,1499,1360,2,1362,57
2020-05-29,San Benito,069,59416,97,84,0,84,2
2020-05-29,San Bernardino,071,2135413,6231,4983,5,4988,196
2020-05-29,San Diego,073,3302833,8424,7242,0,7242,266
2020-05-29,San Francisco,075,870044,2666,2453,0,2453,41
2020-05-29,San Joaquin,077,732212,1115,855,3,858,34
2020-05-29,San Luis Obispo,079,281455,354,270,4,274,1
2020-05-29,San Mateo,081,765935,2371,2103,2,2105,71
2020-05-29,Santa Barbara,083,443738,1755,1656,13,1669,9
2020-05-29,Santa Clara,085,1922200,3442,2707,13,2720,141
2020-05-29,Santa Cruz,087,273765,229,203,0,203,2
2020-05-29,Shasta,089,179085,60,36,0,36,4
2020-05-29,Sierra,091,2930,1,1,0,1,0
2020-05-29,Siskiyou,093,43540,11,7,0,7,0
2020-05-29,Solano,095,438530,618,498,1,499,6
2020-05-29,Sonoma,097,501317,620,537,1,538,4
2020-05-29,Stanislaus,099,539301,865,698,5,703,27
2020-05-29,Sutter,101,95872,47,40,0,40,2
2020-05-29,Tehama,103,63373,9,4,1,5,1
2020-05-29,Trinity,105,12862,7,1,2,3,0
2020-05-29,Tulare,107,460477,2561,1852,10,1862,80
2020-05-29,Tuolumne,109,53932,5,4,0,4,0
2020-05-29,Ventura,111,848112,1606,1093,10,1103,29
2020-05-29,Yolo,113,214977,234,211,0,211,24
2020-05-29,Yuba,115,75493,29,25,0,25,1
2020-05-28,Alameda,001,1643700,3714,3083,5,3088,94
2020-05-28,Alpine,003,1148,1,1,0,1,0
2020-05-28,Amador,005,37829,10,10,0,10,0
2020-05-28,Butte,007,227075,71,40,3,43,0
2020-05-28,Calaveras,009,45235,16,15,0,15,0
2020-05-28,Colusa,011,21464,8,5,0,5,0
2020-05-28,Contra Costa,013,1133247,1648,1392,1,1393,37
2020-05-28,Del Norte,015,27424,45,37,0,37,0
2020-05-28,El Dorado,017,186661,114,82,1,83,0
2020-05-28,Fresno,019,978130,3180,1653,44,1697,31
2020-05-28,Glenn,021,27897,18,14,0,14,0
2020-05-28,Humboldt,023,135768,110,97,0,97,2
2020-05-28,Imperial,025,180216,3403,1430,4,1434,14
2020-05-28,Inyo,027,18085,20,20,0,20,1
2020-05-28,Kern,029,883053,2718,2069,6,2075,36
2020-05-28,Kings,031,150075,901,626,3,629,3
2020-05-28,Lake,033,64148,29,17,0,17,0
2020-05-28,Lassen,035,31185,10,0,2,2,0
2020-05-28,Los Angeles,037,10098052,59460,49861,20,49881,2222
2020-05-28,Madera,039,155013,233,93,1,94,2
2020-05-28,Marin,041,260295,501,443,2,445,14
2020-05-28,Mariposa,043,17540,16,16,0,16,1
2020-05-28,Mendocino,045,87422,28,24,0,24,0
2020-05-28,Merced,047,269075,382,283,0,283,7
2020-05-28,Modoc,049,8938,0,0,0,0,0
2020-05-28,Mono,051,14174,38,34,0,34,1
2020-05-28,Monterey,053,433212,643,471,2,473,10
2020-05-28,Napa,055,140530,141,113,0,113,3
2020-05-28,Nevada,057,99092,45,41,1,42,1
2020-05-28,Orange,059,3164182,8724,6045,64,6109,130
2020-05-28,Placer,061,380077,257,196,1,197,9
2020-05-28,Plumas,063,18699,4,4,0,4,0
2020-05-28,Riverside,065,2383286,9124,7240,20,7260,304
2020-05-28,Sacramento,067,1510023,1479,1339,2,1341,57
2020-05-28,San Benito,069,59416,96,82,0,82,2
2020-05-28,San Bernardino,071,2135413,6066,4831,5,4836,191
2020-05-28,San Diego,073,3302833,8267,7102,0,7102,260
2020-05-28,San Francisco,075,870044,2632,2417,0,2417,40
2020-05-28,San Joaquin,077,732212,1080,840,3,843,34
2020-05-28,San Luis Obispo,079,281455,351,267,4,271,1
2020-05-28,San Mateo,081,765935,2344,2070,2,2072,71
2020-05-28,Santa Barbara,083,443738,1727,1642,12,1654,9
2020-05-28,Santa Clara,085,1922200,3402,2698,13,2711,140
2020-05-28,Santa Cruz,087,273765,228,201,0,201,2
2020-05-28,Shasta,089,179085,58,36,0,36,4
2020-05-28,Sierra,091,2930,1,1,0,1,0
2020-05-28,Siskiyou,093,43540,9,6,0,6,0
2020-05-28,Solano,095,438530,601,489,1,490,6
2020-05-28,Sonoma,097,501317,598,529,1,530,4
2020-05-28,Stanislaus,099,539301,824,684,5,689,27
2020-05-28,Sutter,101,95872,47,40,0,40,2
2020-05-28,Tehama,103,63373,9,4,1,5,1
2020-05-28,Trinity,105,12862,6,1,2,3,0
2020-05-28,Tulare,107,460477,2525,1832,10,1842,79
2020-05-28,Tuolumne,109,53932,5,4,0,4,0
2020-05-28,Ventura,111,848112,1573,1083,10,1093,29
2020-05-28,Yolo,113,214977,231,206,0,206,22
2020-05-28,Yuba,115,75493,28,24,0,24,1
2020-05-27,Alameda,001,1643700,3631,3037,5,3042,94
2020-05-27,Alpine,003,1148,1,1,0,1,0
2020-05-27,Amador,005,37829,10,10,0,10,0
2020-05-27,Butte,007,227075,68,40,2,42,0
2020-05-27,Calaveras,009,45235,15,15,0,15,0
2020-05-27,Colusa,011,21464,8,5,0,5,0
2020-05-27,Contra Costa,013,1133247,1608,1373,1,1374,37
2020-05-27,Del Norte,015,27424,45,34,0,34,0
2020-05-27,El Dorado,017,186661,113,82,1,83,0
2020-05-27,Fresno,019,978130,3092,1620,44,1664,27
2020-05-27,Glenn,021,27897,18,14,0,14,0
2020-05-27,Humboldt,023,135768,110,86,0,86,2
2020-05-27,Imperial,025,180216,3223,1369,4,1373,14
2020-05-27,Inyo,027,18085,20,20,0,20,1
2020-05-27,Kern,029,883053,2653,1999,6,2005,37
2020-05-27,Kings,031,150075,874,586,3,589,3
2020-05-27,Lake,033,64148,29,13,0,13,0
2020-05-27,Lassen,035,31185,10,0,2,2,0
2020-05-27,Los Angeles,037,10098052,58085,48711,20,48731,2177
2020-05-27,Madera,039,155013,224,91,1,92,2
2020-05-27,Marin,041,260295,472,439,2,441,14
2020-05-27,Mariposa,043,17540,16,16,0,16,1
2020-05-27,Mendocino,045,87422,27,21,0,21,0
2020-05-27,Merced,047,269075,378,278,0,278,7
2020-05-27,Modoc,049,8938,0,0,0,0,0
2020-05-27,Mono,051,14174,38,34,0,34,1
2020-05-27,Monterey,053,433212,603,443,2,445,8
2020-05-27,Napa,055,140530,136,112,0,112,3
2020-05-27,Nevada,057,99092,44,41,1,42,1
2020-05-27,Orange,059,3164182,8569,5849,64,5913,121
2020-05-27,Placer,061,380077,238,196,0,196,9
2020-05-27,Plumas,063,18699,4,4,0,4,0
2020-05-27,Riverside,065,2383286,8745,7156,20,7176,299
2020-05-27,Sacramento,067,1510023,1451,1318,2,1320,50
2020-05-27,San Benito,069,59416,93,74,0,74,2
2020-05-27,San Bernardino,071,2135413,5882,4708,5,4713,183
2020-05-27,San Diego,073,3302833,8116,6985,0,6985,255
2020-05-27,San Francisco,075,870044,2603,2394,0,2394,40
2020-05-27,San Joaquin,077,732212,1039,825,3,828,34
2020-05-27,San Luis Obispo,079,281455,346,266,4,270,1
2020-05-27,San Mateo,081,765935,2304,2045,2,2047,71
2020-05-27,Santa Barbara,083,443738,1712,1629,12,1641,9
2020-05-27,Santa Clara,085,1922200,3369,2680,13,2693,140
2020-05-27,Santa Cruz,087,273765,224,202,0,202,2
2020-05-27,Shasta,089,179085,55,36,0,36,4
2020-05-27,Sierra,091,2930,1,1,0,1,0
2020-05-27,Siskiyou,093,43540,9,6,0,6,0
2020-05-27,Solano,095,438530,581,477,1,478,5
2020-05-27,Sonoma,097,501317,584,521,1,522,4
2020-05-27,Stanislaus,099,539301,799,675,5,680,27
2020-05-27,Sutter,101,95872,46,40,0,40,2
2020-05-27,Tehama,103,63373,9,3,1,4,1
2020-05-27,Trinity,105,12862,6,1,2,3,0
2020-05-27,Tulare,107,460477,2473,1817,10,1827,77
2020-05-27,Tuolumne,109,53932,5,4,0,4,0
2020-05-27,Ventura,111,848112,1548,1065,10,1075,28
2020-05-27,Yolo,113,214977,230,204,0,204,22
2020-05-27,Yuba,115,75493,28,24,0,24,1
2020-05-26,Alameda,001,1643700,3536,2956,5,2961,92
2020-05-26,Alpine,003,1148,1,1,0,1,0
2020-05-26,Amador,005,37829,10,10,0,10,0
2020-05-26,Butte,007,227075,66,37,1,38,0
2020-05-26,Calaveras,009,45235,15,13,0,13,0
2020-05-26,Colusa,011,21464,8,4,0,4,0
2020-05-26,Contra Costa,013,1133247,1572,1352,1,1353,37
2020-05-26,Del Norte,015,27424,44,30,0,30,0
2020-05-26,El Dorado,017,186661,109,79,1,80,0
2020-05-26,Fresno,019,978130,3005,1496,44,1540,22
2020-05-26,Glenn,021,27897,16,12,0,12,0
2020-05-26,Humboldt,023,135768,108,81,0,81,2
2020-05-26,Imperial,025,180216,3008,1369,4,1373,14
2020-05-26,Inyo,027,18085,20,20,0,20,1
2020-05-26,Kern,029,883053,2575,1890,6,1896,31
2020-05-26,Kings,031,150075,806,449,2,451,2
2020-05-26,Lake,033,64148,27,12,0,12,0
2020-05-26,Lassen,035,31185,9,0,2,2,0
2020-05-26,Los Angeles,037,10098052,56618,47760,20,47780,2121
2020-05-26,Madera,039,155013,209,83,1,84,2
2020-05-26,Marin,041,260295,460,424,2,426,14
2020-05-26,Mariposa,043,17540,16,16,0,16,1
2020-05-26,Mendocino,045,87422,25,20,0,20,0
2020-05-26,Merced,047,269075,363,266,0,266,7
2020-05-26,Modoc,049,8938,0,1,0,1,0
2020-05-26,Mono,051,14174,37,34,0,34,1
2020-05-26,Monterey,053,433212,575,424,1,425,8
2020-05-26,Napa,055,140530,131,109,0,109,3
2020-05-26,Nevada,057,99092,43,41,1,42,1
2020-05-26,Orange,059,3164182,8299,5651,63,5714,115
2020-05-26,Placer,061,380077,233,188,0,188,9
2020-05-26,Plumas,063,18699,4,4,0,4,0
2020-05-26,Riverside,065,2383286,8298,6917,20,6937,284
2020-05-26,Sacramento,067,1510023,1425,1298,2,1300,50
2020-05-26,San Benito,069,59416,88,69,0,69,2
2020-05-26,San Bernardino,071,2135413,5714,4430,5,4435,175
2020-05-26,San Diego,073,3302833,7973,6884,0,6884,249
2020-05-26,San Francisco,075,870044,2570,2363,0,2363,40
2020-05-26,San Joaquin,077,732212,992,760,3,763,33
2020-05-26,San Luis Obispo,079,281455,344,260,4,264,1
2020-05-26,San Mateo,081,765935,2266,1967,2,1969,71
2020-05-26,Santa Barbara,083,443738,1695,1590,11,1601,9
2020-05-26,Santa Clara,085,1922200,3337,2659,13,2672,139
2020-05-26,Santa Cruz,087,273765,222,197,0,197,2
2020-05-26,Shasta,089,179085,55,36,0,36,4
2020-05-26,Sierra,091,2930,1,1,0,1,0
2020-05-26,Siskiyou,093,43540,8,6,0,6,0
2020-05-26,Solano,095,438530,563,470,1,471,5
2020-05-26,Sonoma,097,501317,576,509,0,509,4
2020-05-26,Stanislaus,099,539301,779,663,5,668,27
2020-05-26,Sutter,101,95872,45,39,0,39,2
2020-05-26,Tehama,103,63373,8,2,1,3,1
2020-05-26,Trinity,105,12862,6,1,2,3,0
2020-05-26,Tulare,107,460477,2417,1768,10,1778,76
2020-05-26,Tuolumne,109,53932,5,2,0,2,0
2020-05-26,Ventura,111,848112,1511,1033,8,1041,27
2020-05-26,Yolo,113,214977,224,198,0,198,22
2020-05-26,Yuba,115,75493,27,24,0,24,1
2020-05-25,Alameda,001,1643700,3442,2900,5,2905,92
2020-05-25,Alpine,003,1148,1,1,0,1,0
2020-05-25,Amador,005,37829,10,10,0,10,0
2020-05-25,Butte,007,227075,63,37,1,38,0
2020-05-25,Calaveras,009,45235,15,13,0,13,0
2020-05-25,Colusa,011,21464,7,4,0,4,0
2020-05-25,Contra Costa,013,1133247,1540,1348,1,1349,37
2020-05-25,Del Norte,015,27424,44,20,0,20,0
2020-05-25,El Dorado,017,186661,101,78,1,79,0
2020-05-25,Fresno,019,978130,2901,1496,42,1538,22
2020-05-25,Glenn,021,27897,16,12,0,12,0
2020-05-25,Humboldt,023,135768,107,81,0,81,2
2020-05-25,Imperial,025,180216,2799,1369,4,1373,14
2020-05-25,Inyo,027,18085,19,20,0,20,1
2020-05-25,Kern,029,883053,2504,1890,6,1896,31
2020-05-25,Kings,031,150075,776,447,2,449,2
2020-05-25,Lake,033,64148,25,13,0,13,0
2020-05-25,Lassen,035,31185,9,0,2,2,0
2020-05-25,Los Angeles,037,10098052,54807,45952,19,45971,2094
2020-05-25,Madera,039,155013,196,83,1,84,2
2020-05-25,Marin,041,260295,442,415,2,417,14
2020-05-25,Mariposa,043,17540,16,15,0,15,1
2020-05-25,Mendocino,045,87422,22,19,0,19,0
2020-05-25,Merced,047,269075,356,262,0,262,6
2020-05-25,Modoc,049,8938,0,1,0,1,0
2020-05-25,Mono,051,14174,37,34,0,34,1
2020-05-25,Monterey,053,433212,545,418,1,419,8
2020-05-25,Napa,055,140530,131,107,0,107,3
2020-05-25,Nevada,057,99092,43,41,1,42,1
2020-05-25,Orange,059,3164182,8077,5601,62,5663,115
2020-05-25,Placer,061,380077,229,186,0,186,9
2020-05-25,Plumas,063,18699,4,4,0,4,0
2020-05-25,Riverside,065,2383286,8067,6900,20,6920,284
2020-05-25,Sacramento,067,1510023,1405,1290,1,1291,50
2020-05-25,San Benito,069,59416,87,70,0,70,2
2020-05-25,San Bernardino,071,2135413,5524,4393,4,4397,175
2020-05-25,San Diego,073,3302833,7797,6799,0,6799,249
2020-05-25,San Francisco,075,870044,2533,2358,0,2358,40
2020-05-25,San Joaquin,077,732212,966,760,3,763,33
2020-05-25,San Luis Obispo,079,281455,341,260,4,264,1
2020-05-25,San Mateo,081,765935,2229,1938,2,1940,71
2020-05-25,Santa Barbara,083,443738,1685,1590,11,1601,9
2020-05-25,Santa Clara,085,1922200,3304,2647,13,2660,139
2020-05-25,Santa Cruz,087,273765,220,191,0,191,2
2020-05-25,Shasta,089,179085,54,36,0,36,4
2020-05-25,Sierra,091,2930,1,1,0,1,0
2020-05-25,Siskiyou,093,43540,8,6,0,6,0
2020-05-25,Solano,095,438530,549,437,1,438,5
2020-05-25,Sonoma,097,501317,564,496,0,496,4
2020-05-25,Stanislaus,099,539301,749,651,5,656,27
2020-05-25,Sutter,101,95872,45,38,0,38,2
2020-05-25,Tehama,103,63373,7,2,1,3,1
2020-05-25,Trinity,105,12862,6,1,2,3,0
2020-05-25,Tulare,107,460477,2353,1747,10,1757,76
2020-05-25,Tuolumne,109,53932,5,2,0,2,0
2020-05-25,Ventura,111,848112,1470,1020,8,1028,27
2020-05-25,Yolo,113,214977,222,197,0,197,22
2020-05-25,Yuba,115,75493,26,24,0,24,1
2020-05-24,Alameda,001,1643700,3369,2830,5,2835,92
2020-05-24,Alpine,003,1148,1,1,0,1,0
2020-05-24,Amador,005,37829,10,9,0,9,0
2020-05-24,Butte,007,227075,61,35,1,36,0
2020-05-24,Calaveras,009,45235,15,13,0,13,0
2020-05-24,Colusa,011,21464,7,4,0,4,0
2020-05-24,Contra Costa,013,1133247,1512,1325,1,1326,37
2020-05-24,Del Norte,015,27424,43,16,0,16,0
2020-05-24,El Dorado,017,186661,100,76,1,77,0
2020-05-24,Fresno,019,978130,2834,1455,41,1496,22
2020-05-24,Glenn,021,27897,15,12,0,12,0
2020-05-24,Humboldt,023,135768,107,81,0,81,2
2020-05-24,Imperial,025,180216,2673,1369,4,1373,14
2020-05-24,Inyo,027,18085,19,20,0,20,1
2020-05-24,Kern,029,883053,2431,1861,5,1866,31
2020-05-24,Kings,031,150075,765,446,2,448,2
2020-05-24,Lake,033,64148,24,12,0,12,0
2020-05-24,Lassen,035,31185,8,0,2,2,0
2020-05-24,Los Angeles,037,10098052,53791,44954,19,44973,2085
2020-05-24,Madera,039,155013,190,83,1,84,2
2020-05-24,Marin,041,260295,440,401,2,403,14
2020-05-24,Mariposa,043,17540,16,15,0,15,1
2020-05-24,Mendocino,045,87422,21,19,0,19,0
2020-05-24,Merced,047,269075,355,258,0,258,6
2020-05-24,Modoc,049,8938,0,0,0,0,0
2020-05-24,Mono,051,14174,37,34,0,34,1
2020-05-24,Monterey,053,433212,517,405,1,406,8
2020-05-24,Napa,055,140530,129,104,0,104,3
2020-05-24,Nevada,057,99092,43,41,1,42,1
2020-05-24,Orange,059,3164182,7923,5439,61,5500,113
2020-05-24,Placer,061,380077,221,184,0,184,9
2020-05-24,Plumas,063,18699,4,4,0,4,0
2020-05-24,Riverside,065,2383286,7926,6571,20,6591,284
2020-05-24,Sacramento,067,1510023,1389,1283,1,1284,50
2020-05-24,San Benito,069,59416,86,67,0,67,2
2020-05-24,San Bernardino,071,2135413,5416,4262,4,4266,175
2020-05-24,San Diego,073,3302833,7654,6703,0,6703,249
2020-05-24,San Francisco,075,870044,2510,2318,0,2318,40
2020-05-24,San Joaquin,077,732212,947,760,3,763,33
2020-05-24,San Luis Obispo,079,281455,339,257,4,261,1
2020-05-24,San Mateo,081,765935,2194,1925,2,1927,71
2020-05-24,Santa Barbara,083,443738,1673,1573,11,1584,9
2020-05-24,Santa Clara,085,1922200,3284,2623,13,2636,139
2020-05-24,Santa Cruz,087,273765,217,185,0,185,2
2020-05-24,Shasta,089,179085,53,36,0,36,4
2020-05-24,Sierra,091,2930,1,1,0,1,0
2020-05-24,Siskiyou,093,43540,7,6,0,6,0
2020-05-24,Solano,095,438530,541,436,0,436,5
2020-05-24,Sonoma,097,501317,553,485,0,485,4
2020-05-24,Stanislaus,099,539301,729,634,5,639,27
2020-05-24,Sutter,101,95872,45,38,0,38,2
2020-05-24,Tehama,103,63373,5,2,1,3,1
2020-05-24,Trinity,105,12862,6,1,2,3,0
2020-05-24,Tulare,107,460477,2307,1684,10,1694,74
2020-05-24,Tuolumne,109,53932,5,2,0,2,0
2020-05-24,Ventura,111,848112,1458,982,8,990,27
2020-05-24,Yolo,113,214977,220,192,0,192,22
2020-05-24,Yuba,115,75493,26,24,0,24,1
2020-05-23,Alameda,001,1643700,3328,2783,5,2788,91
2020-05-23,Alpine,003,1148,1,1,0,1,0
2020-05-23,Amador,005,37829,10,9,0,9,0
2020-05-23,Butte,007,227075,60,34,1,35,0
2020-05-23,Calaveras,009,45235,15,13,0,13,0
2020-05-23,Colusa,011,21464,7,4,0,4,0
2020-05-23,Contra Costa,013,1133247,1501,1302,1,1303,36
2020-05-23,Del Norte,015,27424,43,10,0,10,0
2020-05-23,El Dorado,017,186661,100,74,1,75,0
2020-05-23,Fresno,019,978130,2814,1447,41,1488,21
2020-05-23,Glenn,021,27897,15,12,0,12,0
2020-05-23,Humboldt,023,135768,105,80,0,80,2
2020-05-23,Imperial,025,180216,2585,1283,4,1287,14
2020-05-23,Inyo,027,18085,19,20,0,20,1
2020-05-23,Kern,029,883053,2388,1806,5,1811,31
2020-05-23,Kings,031,150075,761,444,2,446,2
2020-05-23,Lake,033,64148,23,10,0,10,0
2020-05-23,Lassen,035,31185,8,0,2,2,0
2020-05-23,Los Angeles,037,10098052,53246,44029,19,44048,2069
2020-05-23,Madera,039,155013,186,83,1,84,2
2020-05-23,Marin,041,260295,440,393,1,394,14
2020-05-23,Mariposa,043,17540,16,15,0,15,1
2020-05-23,Mendocino,045,87422,21,13,0,13,0
2020-05-23,Merced,047,269075,352,247,0,247,6
2020-05-23,Modoc,049,8938,0,0,0,0,0
2020-05-23,Mono,051,14174,36,34,0,34,1
2020-05-23,Monterey,053,433212,503,397,1,398,8
2020-05-23,Napa,055,140530,125,101,0,101,3
2020-05-23,Nevada,057,99092,43,41,1,42,1
2020-05-23,Orange,059,3164182,7764,5313,60,5373,113
2020-05-23,Placer,061,380077,215,184,0,184,9
2020-05-23,Plumas,063,18699,4,4,0,4,0
2020-05-23,Riverside,065,2383286,7835,6460,20,6480,284
2020-05-23,Sacramento,067,1510023,1373,1275,1,1276,50
2020-05-23,San Benito,069,59416,81,67,0,67,2
2020-05-23,San Bernardino,071,2135413,5322,4172,4,4176,175
2020-05-23,San Diego,073,3302833,7563,6561,0,6561,249
2020-05-23,San Francisco,075,870044,2491,2312,0,2312,40
2020-05-23,San Joaquin,077,732212,932,759,3,762,33
2020-05-23,San Luis Obispo,079,281455,335,256,4,260,1
2020-05-23,San Mateo,081,765935,2166,1862,2,1864,71
2020-05-23,Santa Barbara,083,443738,1665,1566,11,1577,9
2020-05-23,Santa Clara,085,1922200,3270,2593,12,2605,139
2020-05-23,Santa Cruz,087,273765,215,177,0,177,2
2020-05-23,Shasta,089,179085,53,35,0,35,4
2020-05-23,Sierra,091,2930,1,1,0,1,0
2020-05-23,Siskiyou,093,43540,7,6,0,6,0
2020-05-23,Solano,095,438530,536,435,0,435,5
2020-05-23,Sonoma,097,501317,539,462,0,462,4
2020-05-23,Stanislaus,099,539301,721,625,5,630,27
2020-05-23,Sutter,101,95872,44,38,0,38,2
2020-05-23,Tehama,103,63373,5,2,1,3,1
2020-05-23,Trinity,105,12862,6,1,2,3,0
2020-05-23,Tulare,107,460477,2286,1682,10,1692,73
2020-05-23,Tuolumne,109,53932,5,2,0,2,0
2020-05-23,Ventura,111,848112,1438,961,8,969,27
2020-05-23,Yolo,113,214977,219,188,0,188,22
2020-05-23,Yuba,115,75493,26,24,0,24,1
2020-05-22,Alameda,001,1643700,3274,2722,5,2727,91
2020-05-22,Alpine,003,1148,1,1,0,1,0
2020-05-22,Amador,005,37829,10,9,0,9,0
2020-05-22,Butte,007,227075,58,34,1,35,0
2020-05-22,Calaveras,009,45235,15,13,0,13,0
2020-05-22,Colusa,011,21464,7,4,0,4,0
2020-05-22,Contra Costa,013,1133247,1489,1272,1,1273,36
2020-05-22,Del Norte,015,27424,41,9,0,9,0
2020-05-22,El Dorado,017,186661,97,74,1,75,0
2020-05-22,Fresno,019,978130,2755,1399,40,1439,20
2020-05-22,Glenn,021,27897,15,12,0,12,0
2020-05-22,Humboldt,023,135768,105,80,0,80,2
2020-05-22,Imperial,025,180216,2484,1214,4,1218,14
2020-05-22,Inyo,027,18085,19,20,0,20,1
2020-05-22,Kern,029,883053,2339,1749,5,1754,28
2020-05-22,Kings,031,150075,758,428,2,430,2
2020-05-22,Lake,033,64148,22,10,0,10,0
2020-05-22,Lassen,035,31185,6,0,2,2,0
2020-05-22,Los Angeles,037,10098052,52449,43025,19,43044,2027
2020-05-22,Madera,039,155013,182,82,1,83,2
2020-05-22,Marin,041,260295,436,372,1,373,14
2020-05-22,Mariposa,043,17540,16,15,0,15,1
2020-05-22,Mendocino,045,87422,20,13,0,13,0
2020-05-22,Merced,047,269075,352,233,0,233,6
2020-05-22,Modoc,049,8938,0,0,0,0,0
2020-05-22,Mono,051,14174,36,34,0,34,1
2020-05-22,Monterey,053,433212,492,372,1,373,8
2020-05-22,Napa,055,140530,123,97,0,97,3
2020-05-22,Nevada,057,99092,42,41,1,42,1
2020-05-22,Orange,059,3164182,7567,5144,58,5202,113
2020-05-22,Placer,061,380077,215,181,0,181,9
2020-05-22,Plumas,063,18699,4,4,0,4,0
2020-05-22,Riverside,065,2383286,7720,6351,20,6371,283
2020-05-22,Sacramento,067,1510023,1357,1262,1,1263,50
2020-05-22,San Benito,069,59416,80,64,0,64,2
2020-05-22,San Bernardino,071,2135413,5247,4107,4,4111,173
2020-05-22,San Diego,073,3302833,7477,6436,0,6436,242
2020-05-22,San Francisco,075,870044,2473,2251,0,2251,40
2020-05-22,San Joaquin,077,732212,919,747,3,750,33
2020-05-22,San Luis Obispo,079,281455,334,254,4,258,1
2020-05-22,San Mateo,081,765935,2147,1847,2,1849,71
2020-05-22,Santa Barbara,083,443738,1655,1554,11,1565,9
2020-05-22,Santa Clara,085,1922200,3250,2537,12,2549,139
2020-05-22,Santa Cruz,087,273765,212,171,0,171,2
2020-05-22,Shasta,089,179085,53,34,0,34,4
2020-05-22,Sierra,091,2930,1,0,0,0,0
2020-05-22,Siskiyou,093,43540,7,6,0,6,0
2020-05-22,Solano,095,438530,533,431,0,431,4
2020-05-22,Sonoma,097,501317,535,444,0,444,4
2020-05-22,Stanislaus,099,539301,711,616,5,621,27
2020-05-22,Sutter,101,95872,44,38,0,38,2
2020-05-22,Tehama,103,63373,5,2,0,2,1
2020-05-22,Trinity,105,12862,6,1,2,3,0
2020-05-22,Tulare,107,460477,2256,1662,10,1672,73
2020-05-22,Tuolumne,109,53932,5,2,0,2,0
2020-05-22,Ventura,111,848112,1420,937,8,945,27
2020-05-22,Yolo,113,214977,217,187,0,187,22
2020-05-22,Yuba,115,75493,26,24,0,24,1
2020-05-21,Alameda,001,1643700,3208,2606,5,2611,89
2020-05-21,Alpine,003,1148,1,1,0,1,0
2020-05-21,Amador,005,37829,10,9,0,9,0
2020-05-21,Butte,007,227075,57,31,1,32,0
2020-05-21,Calaveras,009,45235,15,13,0,13,0
2020-05-21,Colusa,011,21464,7,4,0,4,0
2020-05-21,Contra Costa,013,1133247,1453,1243,1,1244,36
2020-05-21,Del Norte,015,27424,38,9,0,9,0
2020-05-21,El Dorado,017,186661,95,67,1,68,0
2020-05-21,Fresno,019,978130,2664,1362,39,1401,20
2020-05-21,Glenn,021,27897,14,12,0,12,0
2020-05-21,Humboldt,023,135768,104,79,0,79,0
2020-05-21,Imperial,025,180216,2323,1096,4,1100,14
2020-05-21,Inyo,027,18085,19,20,0,20,1
2020-05-21,Kern,029,883053,2263,1684,4,1688,27
2020-05-21,Kings,031,150075,737,417,2,419,2
2020-05-21,Lake,033,64148,17,10,0,10,0
2020-05-21,Lassen,035,31185,6,0,2,2,0
2020-05-21,Los Angeles,037,10098052,51411,42063,19,42082,1996
2020-05-21,Madera,039,155013,179,82,1,83,2
2020-05-21,Marin,041,260295,425,359,1,360,14
2020-05-21,Mariposa,043,17540,16,15,0,15,1
2020-05-21,Mendocino,045,87422,20,12,0,12,0
2020-05-21,Merced,047,269075,341,226,0,226,6
2020-05-21,Modoc,049,8938,0,0,0,0,0
2020-05-21,Mono,051,14174,36,33,0,33,1
2020-05-21,Monterey,053,433212,481,363,1,364,8
2020-05-21,Napa,055,140530,121,96,0,96,3
2020-05-21,Nevada,057,99092,42,41,1,42,1
2020-05-21,Orange,059,3164182,7364,4975,58,5033,106
2020-05-21,Placer,061,380077,208,176,0,176,8
2020-05-21,Plumas,063,18699,4,4,0,4,0
2020-05-21,Riverside,065,2383286,7534,6245,20,6265,279
2020-05-21,Sacramento,067,1510023,1344,1258,1,1259,56
2020-05-21,San Benito,069,59416,77,61,0,61,2
2020-05-21,San Bernardino,071,2135413,5100,3950,4,3954,167
2020-05-21,San Diego,073,3302833,7341,6317,0,6317,241
2020-05-21,San Francisco,075,870044,2449,2248,0,2248,37
2020-05-21,San Joaquin,077,732212,883,730,3,733,33
2020-05-21,San Luis Obispo,079,281455,334,251,3,254,1
2020-05-21,San Mateo,081,765935,2111,1791,2,1793,74
2020-05-21,Santa Barbara,083,443738,1640,1541,11,1552,10
2020-05-21,Santa Clara,085,1922200,3227,2520,12,2532,138
2020-05-21,Santa Cruz,087,273765,204,164,0,164,3
2020-05-21,Shasta,089,179085,51,34,0,34,4
2020-05-21,Sierra,091,2930,1,0,0,0,0
2020-05-21,Siskiyou,093,43540,7,6,0,6,0
2020-05-21,Solano,095,438530,524,424,0,424,4
2020-05-21,Sonoma,097,501317,517,427,0,427,4
2020-05-21,Stanislaus,099,539301,700,602,5,607,27
2020-05-21,Sutter,101,95872,43,38,0,38,2
2020-05-21,Tehama,103,63373,4,2,0,2,1
2020-05-21,Trinity,105,12862,5,1,2,3,0
2020-05-21,Tulare,107,460477,2206,1606,8,1614,73
2020-05-21,Tuolumne,109,53932,3,2,0,2,0
2020-05-21,Ventura,111,848112,1371,907,8,915,30
2020-05-21,Yolo,113,214977,214,185,0,185,22
2020-05-21,Yuba,115,75493,26,24,0,24,1
2020-05-20,Alameda,001,1643700,3135,2554,5,2559,89
2020-05-20,Alpine,003,1148,1,1,0,1,0
2020-05-20,Amador,005,37829,10,9,0,9,0
2020-05-20,Butte,007,227075,54,30,1,31,0
2020-05-20,Calaveras,009,45235,15,13,0,13,0
2020-05-20,Colusa,011,21464,7,3,0,3,0
2020-05-20,Contra Costa,013,1133247,1423,1223,1,1224,33
2020-05-20,Del Norte,015,27424,31,9,0,9,0
2020-05-20,El Dorado,017,186661,94,67,1,68,0
2020-05-20,Fresno,019,978130,2591,1329,38,1367,17
2020-05-20,Glenn,021,27897,13,12,0,12,0
2020-05-20,Humboldt,023,135768,101,73,0,73,0
2020-05-20,Imperial,025,180216,2210,1047,4,1051,14
2020-05-20,Inyo,027,18085,19,20,0,20,1
2020-05-20,Kern,029,883053,2200,1639,3,1642,27
2020-05-20,Kings,031,150075,593,403,2,405,2
2020-05-20,Lake,033,64148,17,9,0,9,0
2020-05-20,Lassen,035,31185,5,0,2,2,0
2020-05-20,Los Angeles,037,10098052,50414,40932,19,40951,1955
2020-05-20,Madera,039,155013,177,82,1,83,2
2020-05-20,Marin,041,260295,398,348,1,349,14
2020-05-20,Mariposa,043,17540,16,15,0,15,1
2020-05-20,Mendocino,045,87422,20,12,0,12,0
2020-05-20,Merced,047,269075,334,225,0,225,6
2020-05-20,Modoc,049,8938,0,0,0,0,0
2020-05-20,Mono,051,14174,36,33,0,33,1
2020-05-20,Monterey,053,433212,467,356,1,357,8
2020-05-20,Napa,055,140530,114,93,0,93,3
2020-05-20,Nevada,057,99092,42,41,1,42,1
2020-05-20,Orange,059,3164182,7156,4866,56,4922,96
2020-05-20,Placer,061,380077,206,176,0,176,8
2020-05-20,Plumas,063,18699,4,4,0,4,0
2020-05-20,Riverside,065,2383286,7391,6090,20,6110,265
2020-05-20,Sacramento,067,1510023,1334,1244,1,1245,56
2020-05-20,San Benito,069,59416,76,61,0,61,2
2020-05-20,San Bernardino,071,2135413,4972,3771,4,3775,161
2020-05-20,San Diego,073,3302833,7224,6142,0,6142,230
2020-05-20,San Francisco,075,870044,2426,2199,0,2199,37
2020-05-20,San Joaquin,077,732212,847,713,3,716,33
2020-05-20,San Luis Obispo,079,281455,327,249,3,252,1
2020-05-20,San Mateo,081,765935,2058,1739,2,1741,74
2020-05-20,Santa Barbara,083,443738,1621,1524,11,1535,10
2020-05-20,Santa Clara,085,1922200,3206,2508,11,2519,138
2020-05-20,Santa Cruz,087,273765,201,163,0,163,3
2020-05-20,Shasta,089,179085,51,34,0,34,4
2020-05-20,Sierra,091,2930,1,0,0,0,0
2020-05-20,Siskiyou,093,43540,7,6,0,6,0
2020-05-20,Solano,095,438530,519,418,0,418,4
2020-05-20,Sonoma,097,501317,508,411,0,411,4
2020-05-20,Stanislaus,099,539301,684,584,4,588,25
2020-05-20,Sutter,101,95872,43,38,0,38,2
2020-05-20,Tehama,103,63373,4,2,0,2,1
2020-05-20,Trinity,105,12862,4,1,1,2,0
2020-05-20,Tulare,107,460477,2165,1585,8,1593,71
2020-05-20,Tuolumne,109,53932,3,2,0,2,0
2020-05-20,Ventura,111,848112,1335,879,8,887,29
2020-05-20,Yolo,113,214977,211,184,0,184,22
2020-05-20,Yuba,115,75493,26,23,0,23,1
2020-05-19,Alameda,001,1643700,3058,2493,3,2496,88
2020-05-19,Alpine,003,1148,1,1,0,1,0
2020-05-19,Amador,005,37829,10,9,0,9,0
2020-05-19,Butte,007,227075,52,25,1,26,0
2020-05-19,Calaveras,009,45235,15,13,0,13,0
2020-05-19,Colusa,011,21464,5,3,0,3,0
2020-05-19,Contra Costa,013,1133247,1399,1205,1,1206,33
2020-05-19,Del Norte,015,27424,28,8,0,8,0
2020-05-19,El Dorado,017,186661,91,67,0,67,0
2020-05-19,Fresno,019,978130,2477,1288,37,1325,15
2020-05-19,Glenn,021,27897,13,12,0,12,0
2020-05-19,Humboldt,023,135768,101,72,0,72,0
2020-05-19,Imperial,025,180216,2049,1012,4,1016,14
2020-05-19,Inyo,027,18085,19,20,0,20,1
2020-05-19,Kern,029,883053,2102,1601,3,1604,26
2020-05-19,Kings,031,150075,582,393,2,395,2
2020-05-19,Lake,033,64148,14,11,0,11,0
2020-05-19,Lassen,035,31185,5,0,2,2,0
2020-05-19,Los Angeles,037,10098052,49210,39670,19,39689,1906
2020-05-19,Madera,039,155013,173,80,1,81,2
2020-05-19,Marin,041,260295,374,340,1,341,14
2020-05-19,Mariposa,043,17540,16,15,0,15,1
2020-05-19,Mendocino,045,87422,20,12,0,12,0
2020-05-19,Merced,047,269075,326,222,0,222,5
2020-05-19,Modoc,049,8938,0,0,0,0,0
2020-05-19,Mono,051,14174,36,33,0,33,1
2020-05-19,Monterey,053,433212,455,350,1,351,8
2020-05-19,Napa,055,140530,113,93,0,93,3
2020-05-19,Nevada,057,99092,42,41,1,42,1
2020-05-19,Orange,059,3164182,6962,4746,54,4800,90
2020-05-19,Placer,061,380077,204,177,0,177,8
2020-05-19,Plumas,063,18699,4,5,0,5,0
2020-05-19,Riverside,065,2383286,7231,5963,19,5982,265
2020-05-19,Sacramento,067,1510023,1320,1239,1,1240,57
2020-05-19,San Benito,069,59416,74,59,0,59,2
2020-05-19,San Bernardino,071,2135413,4822,3656,4,3660,158
2020-05-19,San Diego,073,3302833,7080,6028,0,6028,222
2020-05-19,San Francisco,075,870044,2392,2186,0,2186,37
2020-05-19,San Joaquin,077,732212,825,705,3,708,33
2020-05-19,San Luis Obispo,079,281455,327,245,3,248,1
2020-05-19,San Mateo,081,765935,2017,1704,2,1706,71
2020-05-19,Santa Barbara,083,443738,1607,1521,11,1532,10
2020-05-19,Santa Clara,085,1922200,3156,2480,11,2491,138
2020-05-19,Santa Cruz,087,273765,190,161,0,161,3
2020-05-19,Shasta,089,179085,51,34,0,34,4
2020-05-19,Sierra,091,2930,0,0,0,0,0
2020-05-19,Siskiyou,093,43540,7,6,0,6,0
2020-05-19,Solano,095,438530,505,415,0,415,4
2020-05-19,Sonoma,097,501317,497,389,0,389,4
2020-05-19,Stanislaus,099,539301,670,582,4,586,25
2020-05-19,Sutter,101,95872,43,38,0,38,2
2020-05-19,Tehama,103,63373,4,2,0,2,1
2020-05-19,Trinity,105,12862,3,1,0,1,0
2020-05-19,Tulare,107,460477,2117,1551,8,1559,68
2020-05-19,Tuolumne,109,53932,3,2,0,2,0
2020-05-19,Ventura,111,848112,1294,861,7,868,28
2020-05-19,Yolo,113,214977,209,183,0,183,22
2020-05-19,Yuba,115,75493,26,23,0,23,1
2020-05-18,Alameda,001,1643700,2985,2442,3,2445,84
2020-05-18,Alpine,003,1148,1,1,0,1,0
2020-05-18,Amador,005,37829,10,8,0,8,0
2020-05-18,Butte,007,227075,50,24,1,25,0
2020-05-18,Calaveras,009,45235,15,13,0,13,0
2020-05-18,Colusa,011,21464,5,3,0,3,0
2020-05-18,Contra Costa,013,1133247,1368,1173,1,1174,33
2020-05-18,Del Norte,015,27424,23,8,0,8,0
2020-05-18,El Dorado,017,186661,89,67,0,67,0
2020-05-18,Fresno,019,978130,2399,1244,36,1280,14
2020-05-18,Glenn,021,27897,13,11,0,11,0
2020-05-18,Humboldt,023,135768,101,70,0,70,0
2020-05-18,Imperial,025,180216,1895,767,4,771,14
2020-05-18,Inyo,027,18085,19,20,0,20,1
2020-05-18,Kern,029,883053,2053,1566,3,1569,26
2020-05-18,Kings,031,150075,551,381,2,383,2
2020-05-18,Lake,033,64148,13,9,0,9,0
2020-05-18,Lassen,035,31185,5,0,2,2,0
2020-05-18,Los Angeles,037,10098052,48182,38477,19,38496,1825
2020-05-18,Madera,039,155013,167,74,1,75,2
2020-05-18,Marin,041,260295,361,329,1,330,14
2020-05-18,Mariposa,043,17540,16,15,0,15,1
2020-05-18,Mendocino,045,87422,15,12,0,12,0
2020-05-18,Merced,047,269075,317,217,0,217,5
2020-05-18,Modoc,049,8938,0,0,0,0,0
2020-05-18,Mono,051,14174,36,33,0,33,1
2020-05-18,Monterey,053,433212,444,345,1,346,8
2020-05-18,Napa,055,140530,109,92,0,92,3
2020-05-18,Nevada,057,99092,42,41,1,42,1
2020-05-18,Orange,059,3164182,6773,4558,52,4610,88
2020-05-18,Placer,061,380077,202,176,0,176,8
2020-05-18,Plumas,063,18699,4,5,0,5,0
2020-05-18,Riverside,065,2383286,7031,5873,18,5891,253
2020-05-18,Sacramento,067,1510023,1314,1233,0,1233,57
2020-05-18,San Benito,069,59416,72,59,0,59,2
2020-05-18,San Bernardino,071,2135413,4675,3558,4,3562,156
2020-05-18,San Diego,073,3302833,6947,5948,0,5948,211
2020-05-18,San Francisco,075,870044,2369,2183,0,2183,36
2020-05-18,San Joaquin,077,732212,813,697,3,700,33
2020-05-18,San Luis Obispo,079,281455,323,243,3,246,1
2020-05-18,San Mateo,081,765935,1979,1701,2,1703,68
2020-05-18,Santa Barbara,083,443738,1596,1501,11,1512,10
2020-05-18,Santa Clara,085,1922200,3123,2468,11,2479,137
2020-05-18,Santa Cruz,087,273765,188,160,0,160,3
2020-05-18,Shasta,089,179085,50,34,0,34,4
2020-05-18,Sierra,091,2930,0,0,0,0,0
2020-05-18,Siskiyou,093,43540,7,6,0,6,0
2020-05-18,Solano,095,438530,495,398,0,398,4
2020-05-18,Sonoma,097,501317,479,387,0,387,4
2020-05-18,Stanislaus,099,539301,658,572,4,576,25
2020-05-18,Sutter,101,95872,43,38,0,38,2
2020-05-18,Tehama,103,63373,4,2,0,2,1
2020-05-18,Trinity,105,12862,3,1,0,1,0
2020-05-18,Tulare,107,460477,2073,1491,8,1499,63
2020-05-18,Tuolumne,109,53932,3,2,0,2,0
2020-05-18,Ventura,111,848112,1271,850,6,856,27
2020-05-18,Yolo,113,214977,204,183,0,183,22
2020-05-18,Yuba,115,75493,26,23,0,23,1
2020-05-17,Alameda,001,1643700,2890,2389,3,2392,83
2020-05-17,Alpine,003,1148,1,1,0,1,0
2020-05-17,Amador,005,37829,10,8,0,8,0
2020-05-17,Butte,007,227075,49,23,1,24,0
2020-05-17,Calaveras,009,45235,15,13,0,13,0
2020-05-17,Colusa,011,21464,3,3,0,3,0
2020-05-17,Contra Costa,013,1133247,1329,1155,1,1156,33
2020-05-17,Del Norte,015,27424,23,7,0,7,0
2020-05-17,El Dorado,017,186661,89,65,0,65,0
2020-05-17,Fresno,019,978130,2293,1213,33,1246,14
2020-05-17,Glenn,021,27897,13,9,0,9,0
2020-05-17,Humboldt,023,135768,94,70,0,70,0
2020-05-17,Imperial,025,180216,1747,715,4,719,14
2020-05-17,Inyo,027,18085,19,20,0,20,1
2020-05-17,Kern,029,883053,1975,1546,3,1549,26
2020-05-17,Kings,031,150075,504,356,2,358,2
2020-05-17,Lake,033,64148,13,7,0,7,0
2020-05-17,Lassen,035,31185,5,0,2,2,0
2020-05-17,Los Angeles,037,10098052,46941,37996,19,38015,1807
2020-05-17,Madera,039,155013,165,69,1,70,2
2020-05-17,Marin,041,260295,350,315,1,316,14
2020-05-17,Mariposa,043,17540,15,15,0,15,1
2020-05-17,Mendocino,045,87422,14,10,0,10,0
2020-05-17,Merced,047,269075,306,214,0,214,5
2020-05-17,Modoc,049,8938,0,0,0,0,0
2020-05-17,Mono,051,14174,36,32,0,32,1
2020-05-17,Monterey,053,433212,424,342,1,343,8
2020-05-17,Napa,055,140530,105,89,0,89,3
2020-05-17,Nevada,057,99092,42,41,1,42,1
2020-05-17,Orange,059,3164182,6594,4466,51,4517,88
2020-05-17,Placer,061,380077,197,175,0,175,8
2020-05-17,Plumas,063,18699,4,4,0,4,0
2020-05-17,Riverside,065,2383286,6858,5776,18,5794,245
2020-05-17,Sacramento,067,1510023,1303,1224,0,1224,56
2020-05-17,San Benito,069,59416,71,59,0,59,2
2020-05-17,San Bernardino,071,2135413,4525,3467,4,3471,155
2020-05-17,San Diego,073,3302833,6815,5838,0,5838,209
2020-05-17,San Francisco,075,870044,2342,2132,0,2132,36
2020-05-17,San Joaquin,077,732212,783,688,3,691,32
2020-05-17,San Luis Obispo,079,281455,321,242,3,245,1
2020-05-17,San Mateo,081,765935,1942,1680,2,1682,68
2020-05-17,Santa Barbara,083,443738,1576,1457,11,1468,10
2020-05-17,Santa Clara,085,1922200,3086,2453,11,2464,135
2020-05-17,Santa Cruz,087,273765,177,155,0,155,3
2020-05-17,Shasta,089,179085,49,34,0,34,4
2020-05-17,Sierra,091,2930,0,0,0,0,0
2020-05-17,Siskiyou,093,43540,7,6,0,6,0
2020-05-17,Solano,095,438530,483,392,0,392,4
2020-05-17,Sonoma,097,501317,458,376,0,376,4
2020-05-17,Stanislaus,099,539301,647,566,4,570,25
2020-05-17,Sutter,101,95872,42,38,0,38,2
2020-05-17,Tehama,103,63373,3,2,0,2,1
2020-05-17,Trinity,105,12862,2,1,0,1,0
2020-05-17,Tulare,107,460477,1997,1430,7,1437,63
2020-05-17,Tuolumne,109,53932,3,2,0,2,0
2020-05-17,Ventura,111,848112,1226,838,6,844,27
2020-05-17,Yolo,113,214977,202,182,0,182,22
2020-05-17,Yuba,115,75493,26,21,0,21,1
2020-05-16,Alameda,001,1643700,2840,2327,3,2330,83
2020-05-16,Alpine,003,1148,1,1,0,1,0
2020-05-16,Amador,005,37829,10,8,0,8,0
2020-05-16,Butte,007,227075,44,22,1,23,0
2020-05-16,Calaveras,009,45235,15,13,0,13,0
2020-05-16,Colusa,011,21464,3,3,0,3,0
2020-05-16,Contra Costa,013,1133247,1311,1136,1,1137,33
2020-05-16,Del Norte,015,27424,19,4,0,4,0
2020-05-16,El Dorado,017,186661,89,65,0,65,0
2020-05-16,Fresno,019,978130,2236,1177,33,1210,14
2020-05-16,Glenn,021,27897,13,9,0,9,0
2020-05-16,Humboldt,023,135768,92,69,0,69,0
2020-05-16,Imperial,025,180216,1683,712,4,716,14
2020-05-16,Inyo,027,18085,19,20,0,20,1
2020-05-16,Kern,029,883053,1939,1509,3,1512,26
2020-05-16,Kings,031,150075,494,356,2,358,2
2020-05-16,Lake,033,64148,13,7,0,7,0
2020-05-16,Lassen,035,31185,4,0,2,2,0
2020-05-16,Los Angeles,037,10098052,46367,37352,19,37371,1778
2020-05-16,Madera,039,155013,163,70,1,71,2
2020-05-16,Marin,041,260295,346,297,1,298,14
2020-05-16,Mariposa,043,17540,15,15,0,15,1
2020-05-16,Mendocino,045,87422,14,10,0,10,0
2020-05-16,Merced,047,269075,304,201,0,201,5
2020-05-16,Modoc,049,8938,0,0,0,0,0
2020-05-16,Mono,051,14174,36,32,0,32,1
2020-05-16,Monterey,053,433212,409,329,1,330,8
2020-05-16,Napa,055,140530,105,86,0,86,3
2020-05-16,Nevada,057,99092,42,41,1,42,1
2020-05-16,Orange,059,3164182,6518,4396,50,4446,87
2020-05-16,Placer,061,380077,195,174,0,174,8
2020-05-16,Plumas,063,18699,4,4,0,4,0
2020-05-16,Riverside,065,2383286,6773,5633,18,5651,243
2020-05-16,Sacramento,067,1510023,1296,1209,0,1209,55
2020-05-16,San Benito,069,59416,66,58,0,58,2
2020-05-16,San Bernardino,071,2135413,4453,3362,4,3366,155
2020-05-16,San Diego,073,3302833,6729,5664,0,5664,209
2020-05-16,San Francisco,075,870044,2319,2094,0,2094,36
2020-05-16,San Joaquin,077,732212,775,668,3,671,32
2020-05-16,San Luis Obispo,079,281455,320,240,3,243,1
2020-05-16,San Mateo,081,765935,1927,1652,2,1654,68
2020-05-16,Santa Barbara,083,443738,1565,1422,10,1432,10
2020-05-16,Santa Clara,085,1922200,3068,2420,11,2431,135
2020-05-16,Santa Cruz,087,273765,174,154,0,154,3
2020-05-16,Shasta,089,179085,49,33,0,33,4
2020-05-16,Sierra,091,2930,0,0,0,0,0
2020-05-16,Siskiyou,093,43540,7,6,0,6,0
2020-05-16,Solano,095,438530,478,392,0,392,4
2020-05-16,Sonoma,097,501317,445,356,0,356,4
2020-05-16,Stanislaus,099,539301,638,546,4,550,24
2020-05-16,Sutter,101,95872,42,35,0,35,2
2020-05-16,Tehama,103,63373,3,2,0,2,1
2020-05-16,Trinity,105,12862,2,1,0,1,0
2020-05-16,Tulare,107,460477,1979,1426,7,1433,63
2020-05-16,Tuolumne,109,53932,3,2,0,2,0
2020-05-16,Ventura,111,848112,1200,813,6,819,25
2020-05-16,Yolo,113,214977,201,181,0,181,22
2020-05-16,Yuba,115,75493,26,21,0,21,1
2020-05-15,Alameda,001,1643700,2806,2289,3,2292,83
2020-05-15,Alpine,003,1148,1,1,0,1,0
2020-05-15,Amador,005,37829,10,8,0,8,0
2020-05-15,Butte,007,227075,42,22,1,23,0
2020-05-15,Calaveras,009,45235,14,13,0,13,0
2020-05-15,Colusa,011,21464,3,3,0,3,0
2020-05-15,Contra Costa,013,1133247,1293,1106,1,1107,33
2020-05-15,Del Norte,015,27424,14,4,0,4,0
2020-05-15,El Dorado,017,186661,89,64,0,64,0
2020-05-15,Fresno,019,978130,2169,1126,33,1159,14
2020-05-15,Glenn,021,27897,13,9,0,9,0
2020-05-15,Humboldt,023,135768,91,60,0,60,0
2020-05-15,Imperial,025,180216,1599,680,0,680,14
2020-05-15,Inyo,027,18085,19,20,0,20,1
2020-05-15,Kern,029,883053,1883,1472,3,1475,25
2020-05-15,Kings,031,150075,491,347,2,349,2
2020-05-15,Lake,033,64148,13,7,0,7,0
2020-05-15,Lassen,035,31185,4,0,2,2,0
2020-05-15,Los Angeles,037,10098052,45580,36317,19,36336,1734
2020-05-15,Madera,039,155013,162,71,1,72,2
2020-05-15,Marin,041,260295,338,295,1,296,14
2020-05-15,Mariposa,043,17540,15,15,0,15,1
2020-05-15,Mendocino,045,87422,14,10,0,10,0
2020-05-15,Merced,047,269075,301,191,0,191,5
2020-05-15,Modoc,049,8938,0,0,0,0,0
2020-05-15,Mono,051,14174,36,31,0,31,1
2020-05-15,Monterey,053,433212,403,321,1,322,8
2020-05-15,Napa,055,140530,105,83,0,83,3
2020-05-15,Nevada,057,99092,42,41,1,42,1
2020-05-15,Orange,059,3164182,6345,4281,50,4331,87
2020-05-15,Placer,061,380077,193,174,0,174,8
2020-05-15,Plumas,063,18699,4,4,0,4,0
2020-05-15,Riverside,065,2383286,6659,5496,18,5514,233
2020-05-15,Sacramento,067,1510023,1286,1203,0,1203,55
2020-05-15,San Benito,069,59416,63,57,0,57,2
2020-05-15,San Bernardino,071,2135413,4375,3225,4,3229,153
2020-05-15,San Diego,073,3302833,6622,5525,0,5525,208
2020-05-15,San Francisco,075,870044,2303,2062,0,2062,36
2020-05-15,San Joaquin,077,732212,769,656,3,659,32
2020-05-15,San Luis Obispo,079,281455,318,237,3,240,1
2020-05-15,San Mateo,081,765935,1905,1612,2,1614,68
2020-05-15,Santa Barbara,083,443738,1556,1409,9,1418,10
2020-05-15,Santa Clara,085,1922200,3025,2395,10,2405,135
2020-05-15,Santa Cruz,087,273765,173,146,0,146,3
2020-05-15,Shasta,089,179085,48,33,0,33,4
2020-05-15,Sierra,091,2930,0,0,0,0,0
2020-05-15,Siskiyou,093,43540,6,5,0,5,0
2020-05-15,Solano,095,438530,474,388,0,388,4
2020-05-15,Sonoma,097,501317,437,349,0,349,4
2020-05-15,Stanislaus,099,539301,631,540,4,544,23
2020-05-15,Sutter,101,95872,41,35,0,35,2
2020-05-15,Tehama,103,63373,3,1,0,1,1
2020-05-15,Trinity,105,12862,2,1,0,1,0
2020-05-15,Tulare,107,460477,1951,1356,7,1363,61
2020-05-15,Tuolumne,109,53932,3,2,0,2,0
2020-05-15,Ventura,111,848112,1182,789,5,794,25
2020-05-15,Yolo,113,214977,200,182,0,182,22
2020-05-15,Yuba,115,75493,26,21,0,21,1
2020-05-14,Alameda,001,1643700,2713,2255,3,2258,80
2020-05-14,Alpine,003,1148,1,1,0,1,0
2020-05-14,Amador,005,37829,10,8,0,8,0
2020-05-14,Butte,007,227075,40,22,1,23,0
2020-05-14,Calaveras,009,45235,14,13,0,13,0
2020-05-14,Colusa,011,21464,3,3,0,3,0
2020-05-14,Contra Costa,013,1133247,1267,1090,1,1091,32
2020-05-14,Del Norte,015,27424,14,4,0,4,0
2020-05-14,El Dorado,017,186661,80,59,0,59,0
2020-05-14,Fresno,019,978130,2109,1038,29,1067,12
2020-05-14,Glenn,021,27897,12,8,0,8,0
2020-05-14,Humboldt,023,135768,89,59,0,59,0
2020-05-14,Imperial,025,180216,1482,652,0,652,13
2020-05-14,Inyo,027,18085,19,20,0,20,1
2020-05-14,Kern,029,883053,1841,1430,3,1433,21
2020-05-14,Kings,031,150075,475,342,2,344,1
2020-05-14,Lake,033,64148,13,7,0,7,0
2020-05-14,Lassen,035,31185,4,0,2,2,0
2020-05-14,Los Angeles,037,10098052,44405,35427,19,35446,1693
2020-05-14,Madera,039,155013,153,69,1,70,2
2020-05-14,Marin,041,260295,320,283,1,284,14
2020-05-14,Mariposa,043,17540,15,15,0,15,0
2020-05-14,Mendocino,045,87422,13,10,0,10,0
2020-05-14,Merced,047,269075,290,182,0,182,3
2020-05-14,Modoc,049,8938,0,0,0,0,0
2020-05-14,Mono,051,14174,36,31,0,31,1
2020-05-14,Monterey,053,433212,393,317,1,318,7
2020-05-14,Napa,055,140530,103,83,0,83,3
2020-05-14,Nevada,057,99092,41,41,1,42,1
2020-05-14,Orange,059,3164182,6170,4163,48,4211,83
2020-05-14,Placer,061,380077,193,172,0,172,8
2020-05-14,Plumas,063,18699,4,4,0,4,0
2020-05-14,Riverside,065,2383286,6475,5339,18,5357,224
2020-05-14,Sacramento,067,1510023,1274,1181,0,1181,55
2020-05-14,San Benito,069,59416,61,56,0,56,2
2020-05-14,San Bernardino,071,2135413,4196,3149,4,3153,149
2020-05-14,San Diego,073,3302833,6487,5393,0,5393,200
2020-05-14,San Francisco,075,870044,2270,2029,0,2029,36
2020-05-14,San Joaquin,077,732212,754,643,3,646,31
2020-05-14,San Luis Obispo,079,281455,315,236,3,239,1
2020-05-14,San Mateo,081,765935,1873,1588,2,1590,67
2020-05-14,Santa Barbara,083,443738,1544,1395,9,1404,11
2020-05-14,Santa Clara,085,1922200,3002,2380,10,2390,134
2020-05-14,Santa Cruz,087,273765,171,145,0,145,3
2020-05-14,Shasta,089,179085,48,33,0,33,4
2020-05-14,Sierra,091,2930,0,0,0,0,0
2020-05-14,Siskiyou,093,43540,6,5,0,5,0
2020-05-14,Solano,095,438530,465,372,0,372,4
2020-05-14,Sonoma,097,501317,420,333,0,333,4
2020-05-14,Stanislaus,099,539301,612,533,4,537,23
2020-05-14,Sutter,101,95872,41,34,0,34,2
2020-05-14,Tehama,103,63373,3,1,0,1,1
2020-05-14,Trinity,105,12862,2,1,0,1,0
2020-05-14,Tulare,107,460477,1912,1317,7,1324,55
2020-05-14,Tuolumne,109,53932,3,2,0,2,0
2020-05-14,Ventura,111,848112,1151,760,5,765,25
2020-05-14,Yolo,113,214977,200,180,0,180,22
2020-05-14,Yuba,115,75493,26,21,0,21,1
2020-05-13,Alameda,001,1643700,2655,2181,3,2184,78
2020-05-13,Alpine,003,1148,1,1,0,1,0
2020-05-13,Amador,005,37829,10,8,0,8,0
2020-05-13,Butte,007,227075,40,21,1,22,0
2020-05-13,Calaveras,009,45235,14,13,0,13,0
2020-05-13,Colusa,011,21464,3,3,0,3,0
2020-05-13,Contra Costa,013,1133247,1245,1082,1,1083,32
2020-05-13,Del Norte,015,27424,13,4,0,4,0
2020-05-13,El Dorado,017,186661,79,58,0,58,0
2020-05-13,Fresno,019,978130,2011,993,29,1022,10
2020-05-13,Glenn,021,27897,11,6,0,6,0
2020-05-13,Humboldt,023,135768,83,58,0,58,0
2020-05-13,Imperial,025,180216,1412,610,0,610,11
2020-05-13,Inyo,027,18085,19,20,0,20,1
2020-05-13,Kern,029,883053,1795,1390,3,1393,19
2020-05-13,Kings,031,150075,461,314,2,316,1
2020-05-13,Lake,033,64148,13,7,0,7,0
2020-05-13,Lassen,035,31185,4,0,2,2,0
2020-05-13,Los Angeles,037,10098052,43094,34574,19,34593,1643
2020-05-13,Madera,039,155013,144,69,1,70,2
2020-05-13,Marin,041,260295,307,278,1,279,14
2020-05-13,Mariposa,043,17540,15,15,0,15,0
2020-05-13,Mendocino,045,87422,13,10,0,10,0
2020-05-13,Merced,047,269075,287,176,0,176,3
2020-05-13,Modoc,049,8938,0,0,0,0,0
2020-05-13,Mono,051,14174,35,31,0,31,1
2020-05-13,Monterey,053,433212,383,309,1,310,6
2020-05-13,Napa,055,140530,103,81,0,81,3
2020-05-13,Nevada,057,99092,41,41,1,42,1
2020-05-13,Orange,059,3164182,5924,4025,46,4071,79
2020-05-13,Placer,061,380077,192,170,0,170,8
2020-05-13,Plumas,063,18699,4,4,0,4,0
2020-05-13,Riverside,065,2383286,6352,5204,18,5222,216
2020-05-13,Sacramento,067,1510023,1259,1173,0,1173,53
2020-05-13,San Benito,069,59416,61,55,0,55,2
2020-05-13,San Bernardino,071,2135413,3940,3064,3,3067,140
2020-05-13,San Diego,073,3302833,6351,5280,0,5280,194
2020-05-13,San Francisco,075,870044,2242,2004,0,2004,35
2020-05-13,San Joaquin,077,732212,733,639,3,642,31
2020-05-13,San Luis Obispo,079,281455,313,231,3,234,1
2020-05-13,San Mateo,081,765935,1841,1550,2,1552,66
2020-05-13,Santa Barbara,083,443738,1533,1382,9,1391,10
2020-05-13,Santa Clara,085,1922200,2982,2370,10,2380,132
2020-05-13,Santa Cruz,087,273765,167,142,0,142,2
2020-05-13,Shasta,089,179085,48,32,0,32,4
2020-05-13,Sierra,091,2930,0,0,0,0,0
2020-05-13,Siskiyou,093,43540,6,5,0,5,0
2020-05-13,Solano,095,438530,452,368,0,368,4
2020-05-13,Sonoma,097,501317,410,330,0,330,4
2020-05-13,Stanislaus,099,539301,603,521,4,525,15
2020-05-13,Sutter,101,95872,41,33,0,33,2
2020-05-13,Tehama,103,63373,3,1,0,1,1
2020-05-13,Trinity,105,12862,2,2,0,2,0
2020-05-13,Tulare,107,460477,1879,1283,7,1290,54
2020-05-13,Tuolumne,109,53932,3,2,0,2,0
2020-05-13,Ventura,111,848112,1120,742,5,747,25
2020-05-13,Yolo,113,214977,198,178,0,178,22
2020-05-13,Yuba,115,75493,24,19,0,19,1
2020-05-12,Alameda,001,1643700,2591,2146,3,2149,74
2020-05-12,Alpine,003,1148,1,1,0,1,0
2020-05-12,Amador,005,37829,10,8,0,8,0
2020-05-12,Butte,007,227075,38,20,1,21,0
2020-05-12,Calaveras,009,45235,13,13,0,13,0
2020-05-12,Colusa,011,21464,3,3,0,3,0
2020-05-12,Contra Costa,013,1133247,1214,1067,1,1068,32
2020-05-12,Del Norte,015,27424,10,3,0,3,0
2020-05-12,El Dorado,017,186661,76,56,0,56,0
2020-05-12,Fresno,019,978130,1927,978,27,1005,9
2020-05-12,Glenn,021,27897,10,6,0,6,0
2020-05-12,Humboldt,023,135768,80,58,0,58,0
2020-05-12,Imperial,025,180216,1281,602,0,602,9
2020-05-12,Inyo,027,18085,19,20,0,20,1
2020-05-12,Kern,029,883053,1754,1363,3,1366,18
2020-05-12,Kings,031,150075,440,302,2,304,1
2020-05-12,Lake,033,64148,13,7,0,7,0
2020-05-12,Lassen,035,31185,4,0,2,2,0
2020-05-12,Los Angeles,037,10098052,42096,33281,18,33299,1601
2020-05-12,Madera,039,155013,138,69,1,70,2
2020-05-12,Marin,041,260295,302,274,1,275,14
2020-05-12,Mariposa,043,17540,15,15,0,15,0
2020-05-12,Mendocino,045,87422,13,10,0,10,0
2020-05-12,Merced,047,269075,276,175,0,175,3
2020-05-12,Modoc,049,8938,0,0,0,0,0
2020-05-12,Mono,051,14174,35,31,0,31,1
2020-05-12,Monterey,053,433212,376,298,1,299,6
2020-05-12,Napa,055,140530,101,80,0,80,3
2020-05-12,Nevada,057,99092,41,41,1,42,1
2020-05-12,Orange,059,3164182,5741,3843,44,3887,78
2020-05-12,Placer,061,380077,191,170,0,170,8
2020-05-12,Plumas,063,18699,4,4,0,4,0
2020-05-12,Riverside,065,2383286,6229,5134,18,5152,210
2020-05-12,Sacramento,067,1510023,1239,1166,0,1166,52
2020-05-12,San Benito,069,59416,61,55,0,55,2
2020-05-12,San Bernardino,071,2135413,3788,2997,3,3000,131
2020-05-12,San Diego,073,3302833,6207,3,0,3,0
2020-05-12,San Francisco,075,870044,2207,1981,0,1981,35
2020-05-12,San Joaquin,077,732212,718,625,3,628,30
2020-05-12,San Luis Obispo,079,281455,310,226,3,229,1
2020-05-12,San Mateo,081,765935,1815,1533,2,1535,66
2020-05-12,Santa Barbara,083,443738,1502,1377,9,1386,10
2020-05-12,Santa Clara,085,1922200,2952,2362,10,2372,131
2020-05-12,Santa Cruz,087,273765,165,141,0,141,2
2020-05-12,Shasta,089,179085,47,33,0,33,4
2020-05-12,Sierra,091,2930,0,0,0,0,0
2020-05-12,Siskiyou,093,43540,6,5,0,5,0
2020-05-12,Solano,095,438530,444,361,0,361,4
2020-05-12,Sonoma,097,501317,387,308,0,308,4
2020-05-12,Stanislaus,099,539301,596,515,4,519,15
2020-05-12,Sutter,101,95872,41,33,0,33,2
2020-05-12,Tehama,103,63373,3,1,0,1,1
2020-05-12,Trinity,105,12862,2,1,0,1,0
2020-05-12,Tulare,107,460477,1847,1261,7,1268,52
2020-05-12,Tuolumne,109,53932,3,2,0,2,0
2020-05-12,Ventura,111,848112,1064,718,5,723,20
2020-05-12,Yolo,113,214977,197,176,0,176,22
2020-05-12,Yuba,115,75493,24,19,0,19,1
2020-05-11,Alameda,001,1643700,2541,2103,3,2106,71
2020-05-11,Alpine,003,1148,1,1,0,1,0
2020-05-11,Amador,005,37829,10,8,0,8,0
2020-05-11,Butte,007,227075,37,19,1,20,0
2020-05-11,Calaveras,009,45235,13,13,0,13,0
2020-05-11,Colusa,011,21464,3,3,0,3,0
2020-05-11,Contra Costa,013,1133247,1200,1052,1,1053,32
2020-05-11,Del Norte,015,27424,8,3,0,3,0
2020-05-11,El Dorado,017,186661,76,55,0,55,0
2020-05-11,Fresno,019,978130,1835,937,26,963,8
2020-05-11,Glenn,021,27897,10,6,0,6,0
2020-05-11,Humboldt,023,135768,77,56,0,56,0
2020-05-11,Imperial,025,180216,1174,562,0,562,9
2020-05-11,Inyo,027,18085,19,20,0,20,1
2020-05-11,Kern,029,883053,1702,1331,3,1334,17
2020-05-11,Kings,031,150075,417,289,1,290,1
2020-05-11,Lake,033,64148,12,7,0,7,0
2020-05-11,Lassen,035,31185,4,0,2,2,0
2020-05-11,Los Angeles,037,10098052,40915,32279,18,32297,1553
2020-05-11,Madera,039,155013,129,68,1,69,2
2020-05-11,Marin,041,260295,293,271,1,272,14
2020-05-11,Mariposa,043,17540,15,15,0,15,0
2020-05-11,Mendocino,045,87422,13,10,0,10,0
2020-05-11,Merced,047,269075,261,158,0,158,3
2020-05-11,Modoc,049,8938,0,0,0,0,0
2020-05-11,Mono,051,14174,35,30,0,30,1
2020-05-11,Monterey,053,433212,373,286,1,287,6
2020-05-11,Napa,055,140530,95,79,0,79,2
2020-05-11,Nevada,057,99092,41,41,1,42,1
2020-05-11,Orange,059,3164182,5527,3699,38,3737,77
2020-05-11,Placer,061,380077,191,170,0,170,8
2020-05-11,Plumas,063,18699,4,4,0,4,0
2020-05-11,Riverside,065,2383286,6071,5082,17,5099,203
2020-05-11,Sacramento,067,1510023,1224,1160,0,1160,52
2020-05-11,San Benito,069,59416,59,52,0,52,2
2020-05-11,San Bernardino,071,2135413,3677,2945,3,2948,124
2020-05-11,San Diego,073,3302833,6054,5067,0,5067,175
2020-05-11,San Francisco,075,870044,2161,1974,0,1974,35
2020-05-11,San Joaquin,077,732212,708,620,3,623,30
2020-05-11,San Luis Obispo,079,281455,308,224,3,227,1
2020-05-11,San Mateo,081,765935,1789,1499,2,1501,66
2020-05-11,Santa Barbara,083,443738,1491,1372,8,1380,10
2020-05-11,Santa Clara,085,1922200,2935,2340,10,2350,129
2020-05-11,Santa Cruz,087,273765,162,140,0,140,2
2020-05-11,Shasta,089,179085,47,31,0,31,4
2020-05-11,Sierra,091,2930,0,0,0,0,0
2020-05-11,Siskiyou,093,43540,6,5,0,5,0
2020-05-11,Solano,095,438530,439,354,0,354,4
2020-05-11,Sonoma,097,501317,377,303,0,303,3
2020-05-11,Stanislaus,099,539301,586,507,4,511,14
2020-05-11,Sutter,101,95872,40,32,0,32,2
2020-05-11,Tehama,103,63373,3,1,0,1,1
2020-05-11,Trinity,105,12862,2,1,0,1,0
2020-05-11,Tulare,107,460477,1798,1203,7,1210,49
2020-05-11,Tuolumne,109,53932,3,2,0,2,0
2020-05-11,Ventura,111,848112,1003,698,4,702,19
2020-05-11,Yolo,113,214977,197,174,0,174,20
2020-05-11,Yuba,115,75493,24,18,0,18,1
2020-05-10,Alameda,001,1643700,2464,2047,3,2050,71
2020-05-10,Alpine,003,1148,1,1,0,1,0
2020-05-10,Amador,005,37829,10,8,0,8,0
2020-05-10,Butte,007,227075,32,18,1,19,0
2020-05-10,Calaveras,009,45235,13,13,0,13,0
2020-05-10,Colusa,011,21464,3,3,0,3,0
2020-05-10,Contra Costa,013,1133247,1186,1046,0,1046,31
2020-05-10,Del Norte,015,27424,7,3,0,3,0
2020-05-10,El Dorado,017,186661,76,55,0,55,0
2020-05-10,Fresno,019,978130,1750,894,26,920,8
2020-05-10,Glenn,021,27897,10,6,0,6,0
2020-05-10,Humboldt,023,135768,73,56,0,56,0
2020-05-10,Imperial,025,180216,1079,509,0,509,7
2020-05-10,Inyo,027,18085,19,20,0,20,1
2020-05-10,Kern,029,883053,1651,1300,2,1302,16
2020-05-10,Kings,031,150075,404,266,1,267,1
2020-05-10,Lake,033,64148,12,7,0,7,0
2020-05-10,Lassen,035,31185,4,0,2,2,0
2020-05-10,Los Angeles,037,10098052,39654,31711,18,31729,1514
2020-05-10,Madera,039,155013,127,65,1,66,2
2020-05-10,Marin,041,260295,285,267,1,268,14
2020-05-10,Mariposa,043,17540,15,15,0,15,0
2020-05-10,Mendocino,045,87422,12,10,0,10,0
2020-05-10,Merced,047,269075,246,154,0,154,3
2020-05-10,Modoc,049,8938,0,0,0,0,0
2020-05-10,Mono,051,14174,35,27,0,27,1
2020-05-10,Monterey,053,433212,359,282,1,283,6
2020-05-10,Napa,055,140530,89,79,0,79,2
2020-05-10,Nevada,057,99092,41,41,1,42,1
2020-05-10,Orange,059,3164182,5384,3627,38,3665,76
2020-05-10,Placer,061,380077,190,168,0,168,8
2020-05-10,Plumas,063,18699,4,4,0,4,0
2020-05-10,Riverside,065,2383286,5949,4951,17,4968,193
2020-05-10,Sacramento,067,1510023,1208,1152,0,1152,52
2020-05-10,San Benito,069,59416,59,52,0,52,2
2020-05-10,San Bernardino,071,2135413,3579,2910,3,2913,121
2020-05-10,San Diego,073,3302833,5902,4928,0,4928,175
2020-05-10,San Francisco,075,870044,2143,1953,0,1953,35
2020-05-10,San Joaquin,077,732212,693,611,3,614,29
2020-05-10,San Luis Obispo,079,281455,305,218,3,221,1
2020-05-10,San Mateo,081,765935,1767,1463,2,1465,65
2020-05-10,Santa Barbara,083,443738,1480,1323,8,1331,10
2020-05-10,Santa Clara,085,1922200,2908,2331,10,2341,129
2020-05-10,Santa Cruz,087,273765,161,139,0,139,2
2020-05-10,Shasta,089,179085,47,31,0,31,4
2020-05-10,Sierra,091,2930,0,0,0,0,0
2020-05-10,Siskiyou,093,43540,5,5,0,5,0
2020-05-10,Solano,095,438530,429,322,0,322,4
2020-05-10,Sonoma,097,501317,367,290,0,290,3
2020-05-10,Stanislaus,099,539301,579,498,4,502,14
2020-05-10,Sutter,101,95872,37,31,0,31,2
2020-05-10,Tehama,103,63373,3,1,0,1,1
2020-05-10,Trinity,105,12862,2,1,0,1,0
2020-05-10,Tulare,107,460477,1727,1143,7,1150,47
2020-05-10,Tuolumne,109,53932,3,2,0,2,0
2020-05-10,Ventura,111,848112,945,690,2,692,19
2020-05-10,Yolo,113,214977,197,173,0,173,20
2020-05-10,Yuba,115,75493,23,17,0,17,1
2020-05-09,Alameda,001,1643700,2421,2011,3,2014,71
2020-05-09,Alpine,003,1148,1,1,0,1,0
2020-05-09,Amador,005,37829,9,8,0,8,0
2020-05-09,Butte,007,227075,31,18,1,19,0
2020-05-09,Calaveras,009,45235,13,13,0,13,0
2020-05-09,Colusa,011,21464,3,3,0,3,0
2020-05-09,Contra Costa,013,1133247,1172,1039,0,1039,31
2020-05-09,Del Norte,015,27424,7,3,0,3,0
2020-05-09,El Dorado,017,186661,73,54,0,54,0
2020-05-09,Fresno,019,978130,1712,861,25,886,8
2020-05-09,Glenn,021,27897,9,6,0,6,0
2020-05-09,Humboldt,023,135768,71,55,0,55,0
2020-05-09,Imperial,025,180216,1023,474,0,474,7
2020-05-09,Inyo,027,18085,19,20,0,20,1
2020-05-09,Kern,029,883053,1615,1262,1,1263,15
2020-05-09,Kings,031,150075,399,264,1,265,1
2020-05-09,Lake,033,64148,12,7,0,7,0
2020-05-09,Lassen,035,31185,4,0,2,2,0
2020-05-09,Los Angeles,037,10098052,39032,31268,18,31286,1499
2020-05-09,Madera,039,155013,126,61,1,62,2
2020-05-09,Marin,041,260295,284,261,1,262,14
2020-05-09,Mariposa,043,17540,15,15,0,15,0
2020-05-09,Mendocino,045,87422,12,10,0,10,0
2020-05-09,Merced,047,269075,242,153,0,153,3
2020-05-09,Modoc,049,8938,0,0,0,0,0
2020-05-09,Mono,051,14174,35,27,0,27,1
2020-05-09,Monterey,053,433212,352,273,0,273,6
2020-05-09,Napa,055,140530,88,78,0,78,2
2020-05-09,Nevada,057,99092,41,41,1,42,1
2020-05-09,Orange,059,3164182,5301,3506,38,3544,75
2020-05-09,Placer,061,380077,189,168,0,168,8
2020-05-09,Plumas,063,18699,4,4,0,4,0
2020-05-09,Riverside,065,2383286,5854,4871,17,4888,183
2020-05-09,Sacramento,067,1510023,1204,1150,0,1150,52
2020-05-09,San Benito,069,59416,58,52,0,52,2
2020-05-09,San Bernardino,071,2135413,3523,2825,3,2828,121
2020-05-09,San Diego,073,3302833,5790,4778,0,4778,175
2020-05-09,San Francisco,075,870044,2128,1944,0,1944,34
2020-05-09,San Joaquin,077,732212,684,605,3,608,28
2020-05-09,San Luis Obispo,079,281455,301,213,3,216,1
2020-05-09,San Mateo,081,765935,1748,1453,2,1455,65
2020-05-09,Santa Barbara,083,443738,1472,1245,8,1253,10
2020-05-09,Santa Clara,085,1922200,2894,2317,10,2327,128
2020-05-09,Santa Cruz,087,273765,160,138,0,138,2
2020-05-09,Shasta,089,179085,47,31,0,31,4
2020-05-09,Sierra,091,2930,0,0,0,0,0
2020-05-09,Siskiyou,093,43540,5,5,0,5,0
2020-05-09,Solano,095,438530,423,321,0,321,4
2020-05-09,Sonoma,097,501317,363,288,0,288,3
2020-05-09,Stanislaus,099,539301,571,491,4,495,12
2020-05-09,Sutter,101,95872,37,31,0,31,2
2020-05-09,Tehama,103,63373,2,1,0,1,1
2020-05-09,Trinity,105,12862,2,1,0,1,0
2020-05-09,Tulare,107,460477,1699,1083,7,1090,47
2020-05-09,Tuolumne,109,53932,3,2,0,2,0
2020-05-09,Ventura,111,848112,924,679,2,681,19
2020-05-09,Yolo,113,214977,197,172,0,172,18
2020-05-09,Yuba,115,75493,23,17,0,17,1
2020-05-08,Alameda,001,1643700,2378,1955,3,1958,70
2020-05-08,Alpine,003,1148,1,1,0,1,0
2020-05-08,Amador,005,37829,9,8,0,8,0
2020-05-08,Butte,007,227075,31,18,1,19,0
2020-05-08,Calaveras,009,45235,13,13,0,13,0
2020-05-08,Colusa,011,21464,3,3,0,3,0
2020-05-08,Contra Costa,013,1133247,1160,1024,0,1024,29
2020-05-08,Del Norte,015,27424,7,3,0,3,0
2020-05-08,El Dorado,017,186661,72,54,0,54,0
2020-05-08,Fresno,019,978130,1670,838,23,861,8
2020-05-08,Glenn,021,27897,8,6,0,6,0
2020-05-08,Humboldt,023,135768,68,54,0,54,0
2020-05-08,Imperial,025,180216,978,467,0,467,7
2020-05-08,Inyo,027,18085,19,20,0,20,1
2020-05-08,Kern,029,883053,1584,1214,1,1215,13
2020-05-08,Kings,031,150075,390,236,1,237,1
2020-05-08,Lake,033,64148,12,7,0,7,0
2020-05-08,Lassen,035,31185,4,0,2,2,0
2020-05-08,Los Angeles,037,10098052,38301,30357,18,30375,1447
2020-05-08,Madera,039,155013,123,57,1,58,2
2020-05-08,Marin,041,260295,284,257,1,258,14
2020-05-08,Mariposa,043,17540,15,15,0,15,0
2020-05-08,Mendocino,045,87422,12,10,0,10,0
2020-05-08,Merced,047,269075,241,151,0,151,3
2020-05-08,Modoc,049,8938,0,0,0,0,0
2020-05-08,Mono,051,14174,32,27,0,27,1
2020-05-08,Monterey,053,433212,344,265,0,265,6
2020-05-08,Napa,055,140530,87,78,0,78,2
2020-05-08,Nevada,057,99092,41,41,1,42,1
2020-05-08,Orange,059,3164182,5154,3395,38,3433,72
2020-05-08,Placer,061,380077,187,166,0,166,8
2020-05-08,Plumas,063,18699,4,4,0,4,0
2020-05-08,Riverside,065,2383286,5754,4672,16,4688,181
2020-05-08,Sacramento,067,1510023,1199,1145,0,1145,51
2020-05-08,San Benito,069,59416,58,51,0,51,2
2020-05-08,San Bernardino,071,2135413,3475,2631,3,2634,119
2020-05-08,San Diego,073,3302833,5683,4664,0,4664,169
2020-05-08,San Francisco,075,870044,2110,1890,0,1890,33
2020-05-08,San Joaquin,077,732212,677,595,3,598,28
2020-05-08,San Luis Obispo,079,281455,298,210,3,213,1
2020-05-08,San Mateo,081,765935,1663,1423,2,1425,62
2020-05-08,Santa Barbara,083,443738,1463,1054,6,1060,8
2020-05-08,Santa Clara,085,1922200,2871,2285,10,2295,128
2020-05-08,Santa Cruz,087,273765,156,137,0,137,2
2020-05-08,Shasta,089,179085,47,31,0,31,4
2020-05-08,Sierra,091,2930,0,0,0,0,0
2020-05-08,Siskiyou,093,43540,5,5,0,5,0
2020-05-08,Solano,095,438530,418,314,0,314,4
2020-05-08,Sonoma,097,501317,358,285,0,285,3
2020-05-08,Stanislaus,099,539301,557,487,4,491,12
2020-05-08,Sutter,101,95872,37,30,0,30,2
2020-05-08,Tehama,103,63373,2,1,0,1,1
2020-05-08,Trinity,105,12862,2,0,0,0,0
2020-05-08,Tulare,107,460477,1654,1050,6,1056,43
2020-05-08,Tuolumne,109,53932,3,2,0,2,0
2020-05-08,Ventura,111,848112,906,665,2,667,19
2020-05-08,Yolo,113,214977,196,172,0,172,18
2020-05-08,Yuba,115,75493,22,16,0,16,1
2020-05-07,Alameda,001,1643700,2318,1914,3,1917,68
2020-05-07,Alpine,003,1148,1,1,0,1,0
2020-05-07,Amador,005,37829,9,8,0,8,0
2020-05-07,Butte,007,227075,31,19,1,20,0
2020-05-07,Calaveras,009,45235,13,13,0,13,0
2020-05-07,Colusa,011,21464,3,3,0,3,0
2020-05-07,Contra Costa,013,1133247,1146,1005,0,1005,29
2020-05-07,Del Norte,015,27424,6,3,0,3,0
2020-05-07,El Dorado,017,186661,71,54,0,54,0
2020-05-07,Fresno,019,978130,1584,812,22,834,8
2020-05-07,Glenn,021,27897,8,5,0,5,0
2020-05-07,Humboldt,023,135768,67,54,0,54,0
2020-05-07,Imperial,025,180216,915,442,0,442,6
2020-05-07,Inyo,027,18085,19,20,0,20,1
2020-05-07,Kern,029,883053,1540,1176,1,1177,13
2020-05-07,Kings,031,150075,367,219,1,220,1
2020-05-07,Lake,033,64148,11,7,0,7,0
2020-05-07,Lassen,035,31185,4,0,2,2,0
2020-05-07,Los Angeles,037,10098052,37179,29544,18,29562,1399
2020-05-07,Madera,039,155013,119,54,1,55,2
2020-05-07,Marin,041,260295,277,252,1,253,14
2020-05-07,Mariposa,043,17540,15,15,0,15,0
2020-05-07,Mendocino,045,87422,12,10,0,10,0
2020-05-07,Merced,047,269075,233,146,0,146,3
2020-05-07,Modoc,049,8938,0,0,0,0,0
2020-05-07,Mono,051,14174,32,26,0,26,1
2020-05-07,Monterey,053,433212,336,249,0,249,6
2020-05-07,Napa,055,140530,87,78,0,78,2
2020-05-07,Nevada,057,99092,41,41,1,42,1
2020-05-07,Orange,059,3164182,4969,3283,37,3320,69
2020-05-07,Placer,061,380077,187,165,0,165,8
2020-05-07,Plumas,063,18699,4,4,0,4,0
2020-05-07,Riverside,065,2383286,5638,4608,16,4624,170
2020-05-07,Sacramento,067,1510023,1193,1139,0,1139,50
2020-05-07,San Benito,069,59416,58,50,0,50,2
2020-05-07,San Bernardino,071,2135413,3383,2522,3,2525,115
2020-05-07,San Diego,073,3302833,5526,4431,0,4431,165
2020-05-07,San Francisco,075,870044,2079,1852,0,1852,33
2020-05-07,San Joaquin,077,732212,664,583,3,586,28
2020-05-07,San Luis Obispo,079,281455,287,209,3,212,1
2020-05-07,San Mateo,081,765935,1641,1398,2,1400,58
2020-05-07,Santa Barbara,083,443738,1436,720,5,725,8
2020-05-07,Santa Clara,085,1922200,2833,2281,10,2291,127
2020-05-07,Santa Cruz,087,273765,153,136,0,136,2
2020-05-07,Shasta,089,179085,46,31,0,31,4
2020-05-07,Sierra,091,2930,0,0,0,0,0
2020-05-07,Siskiyou,093,43540,5,5,0,5,0
2020-05-07,Solano,095,438530,412,307,0,307,4
2020-05-07,Sonoma,097,501317,346,282,0,282,3
2020-05-07,Stanislaus,099,539301,548,466,4,470,10
2020-05-07,Sutter,101,95872,37,29,0,29,2
2020-05-07,Tehama,103,63373,2,1,0,1,1
2020-05-07,Trinity,105,12862,2,0,0,0,0
2020-05-07,Tulare,107,460477,1586,1001,6,1007,41
2020-05-07,Tuolumne,109,53932,3,2,0,2,0
2020-05-07,Ventura,111,848112,882,647,1,648,19
2020-05-07,Yolo,113,214977,195,172,0,172,18
2020-05-07,Yuba,115,75493,22,16,0,16,1
2020-05-06,Alameda,001,1643700,2280,1864,3,1867,67
2020-05-06,Alpine,003,1148,1,1,0,1,0
2020-05-06,Amador,005,37829,9,8,0,8,0
2020-05-06,Butte,007,227075,30,19,1,20,0
2020-05-06,Calaveras,009,45235,13,13,0,13,0
2020-05-06,Colusa,011,21464,3,3,0,3,0
2020-05-06,Contra Costa,013,1133247,1125,990,0,990,29
2020-05-06,Del Norte,015,27424,6,3,0,3,0
2020-05-06,El Dorado,017,186661,69,53,0,53,0
2020-05-06,Fresno,019,978130,1521,773,20,793,8
2020-05-06,Glenn,021,27897,8,3,0,3,0
2020-05-06,Humboldt,023,135768,66,54,0,54,0
2020-05-06,Imperial,025,180216,847,399,0,399,6
2020-05-06,Inyo,027,18085,19,20,0,20,1
2020-05-06,Kern,029,883053,1484,1112,1,1113,12
2020-05-06,Kings,031,150075,349,208,1,209,1
2020-05-06,Lake,033,64148,11,7,0,7,0
2020-05-06,Lassen,035,31185,4,0,2,2,0
2020-05-06,Los Angeles,037,10098052,36171,28687,18,28705,1347
2020-05-06,Madera,039,155013,117,55,1,56,2
2020-05-06,Marin,041,260295,270,244,1,245,14
2020-05-06,Mariposa,043,17540,15,14,0,14,0
2020-05-06,Mendocino,045,87422,12,10,0,10,0
2020-05-06,Merced,047,269075,226,140,0,140,3
2020-05-06,Modoc,049,8938,0,0,0,0,0
2020-05-06,Mono,051,14174,32,26,0,26,1
2020-05-06,Monterey,053,433212,328,246,0,246,6
2020-05-06,Napa,055,140530,86,78,0,78,2
2020-05-06,Nevada,057,99092,41,41,1,42,1
2020-05-06,Orange,059,3164182,4785,3156,36,3192,66
2020-05-06,Placer,061,380077,184,164,0,164,8
2020-05-06,Plumas,063,18699,4,4,0,4,0
2020-05-06,Riverside,065,2383286,5494,4535,16,4551,163
2020-05-06,Sacramento,067,1510023,1187,1135,0,1135,49
2020-05-06,San Benito,069,59416,57,50,0,50,2
2020-05-06,San Bernardino,071,2135413,3261,2426,2,2428,110
2020-05-06,San Diego,073,3302833,5393,4321,0,4321,158
2020-05-06,San Francisco,075,870044,2054,1804,0,1804,32
2020-05-06,San Joaquin,077,732212,651,581,3,584,28
2020-05-06,San Luis Obispo,079,281455,284,207,3,210,1
2020-05-06,San Mateo,081,765935,1610,1348,2,1350,57
2020-05-06,Santa Barbara,083,443738,1395,565,4,569,8
2020-05-06,Santa Clara,085,1922200,2816,2270,9,2279,127
2020-05-06,Santa Cruz,087,273765,149,135,0,135,2
2020-05-06,Shasta,089,179085,45,31,0,31,4
2020-05-06,Sierra,091,2930,0,0,0,0,0
2020-05-06,Siskiyou,093,43540,5,5,0,5,0
2020-05-06,Solano,095,438530,402,300,0,300,4
2020-05-06,Sonoma,097,501317,330,269,0,269,3
2020-05-06,Stanislaus,099,539301,532,434,4,438,9
2020-05-06,Sutter,101,95872,37,29,0,29,2
2020-05-06,Tehama,103,63373,2,1,0,1,1
2020-05-06,Trinity,105,12862,2,0,0,0,0
2020-05-06,Tulare,107,460477,1538,963,6,969,40
2020-05-06,Tuolumne,109,53932,3,2,0,2,0
2020-05-06,Ventura,111,848112,855,619,1,620,19
2020-05-06,Yolo,113,214977,194,172,0,172,18
2020-05-06,Yuba,115,75493,22,15,0,15,1
2020-05-05,Alameda,001,1643700,2237,1819,3,1822,67
2020-05-05,Alpine,003,1148,1,1,0,1,0
2020-05-05,Amador,005,37829,9,8,0,8,0
2020-05-05,Butte,007,227075,29,19,1,20,0
2020-05-05,Calaveras,009,45235,13,13,0,13,0
2020-05-05,Colusa,011,21464,3,3,0,3,0
2020-05-05,Contra Costa,013,1133247,1107,976,0,976,29
2020-05-05,Del Norte,015,27424,6,3,0,3,0
2020-05-05,El Dorado,017,186661,67,54,0,54,0
2020-05-05,Fresno,019,978130,1448,726,18,744,8
2020-05-05,Glenn,021,27897,8,3,0,3,0
2020-05-05,Humboldt,023,135768,63,54,0,54,0
2020-05-05,Imperial,025,180216,792,389,0,389,6
2020-05-05,Inyo,027,18085,19,20,0,20,1
2020-05-05,Kern,029,883053,1432,1084,1,1085,11
2020-05-05,Kings,031,150075,331,187,1,188,1
2020-05-05,Lake,033,64148,10,7,0,7,0
2020-05-05,Lassen,035,31185,4,0,2,2,0
2020-05-05,Los Angeles,037,10098052,35101,27867,18,27885,1289
2020-05-05,Madera,039,155013,113,53,1,54,2
2020-05-05,Marin,041,260295,264,244,1,245,14
2020-05-05,Mariposa,043,17540,15,14,0,14,0
2020-05-05,Mendocino,045,87422,12,10,0,10,0
2020-05-05,Merced,047,269075,221,141,0,141,3
2020-05-05,Modoc,049,8938,0,0,0,0,0
2020-05-05,Mono,051,14174,32,25,0,25,1
2020-05-05,Monterey,053,433212,314,240,0,240,6
2020-05-05,Napa,055,140530,86,74,0,74,2
2020-05-05,Nevada,057,99092,41,41,1,42,1
2020-05-05,Orange,059,3164182,4661,3041,36,3077,63
2020-05-05,Placer,061,380077,184,162,0,162,8
2020-05-05,Plumas,063,18699,4,4,0,4,0
2020-05-05,Riverside,065,2383286,5384,4309,16,4325,161
2020-05-05,Sacramento,067,1510023,1180,1125,0,1125,48
2020-05-05,San Benito,069,59416,56,50,0,50,2
2020-05-05,San Bernardino,071,2135413,3168,2345,2,2347,104
2020-05-05,San Diego,073,3302833,5250,4162,0,4162,150
2020-05-05,San Francisco,075,870044,2019,1779,0,1779,31
2020-05-05,San Joaquin,077,732212,642,577,3,580,26
2020-05-05,San Luis Obispo,079,281455,282,203,3,206,1
2020-05-05,San Mateo,081,765935,1578,1335,2,1337,56
2020-05-05,Santa Barbara,083,443738,1174,541,4,545,7
2020-05-05,Santa Clara,085,1922200,2770,2249,8,2257,124
2020-05-05,Santa Cruz,087,273765,146,134,0,134,2
2020-05-05,Shasta,089,179085,44,31,0,31,4
2020-05-05,Sierra,091,2930,0,0,0,0,0
2020-05-05,Siskiyou,093,43540,5,5,0,5,0
2020-05-05,Solano,095,438530,386,299,0,299,4
2020-05-05,Sonoma,097,501317,327,263,0,263,3
2020-05-05,Stanislaus,099,539301,520,430,4,434,9
2020-05-05,Sutter,101,95872,36,29,0,29,2
2020-05-05,Tehama,103,63373,2,1,0,1,1
2020-05-05,Trinity,105,12862,2,0,0,0,0
2020-05-05,Tulare,107,460477,1440,869,6,875,40
2020-05-05,Tuolumne,109,53932,3,2,0,2,0
2020-05-05,Ventura,111,848112,831,607,1,608,19
2020-05-05,Yolo,113,214977,192,171,0,171,18
2020-05-05,Yuba,115,75493,22,15,0,15,1
2020-05-04,Alameda,001,1643700,2178,1762,2,1764,65
2020-05-04,Alpine,003,1148,1,1,0,1,0
2020-05-04,Amador,005,37829,8,8,0,8,0
2020-05-04,Butte,007,227075,28,16,1,17,0
2020-05-04,Calaveras,009,45235,13,13,0,13,0
2020-05-04,Colusa,011,21464,3,3,0,3,0
2020-05-04,Contra Costa,013,1133247,1089,949,0,949,28
2020-05-04,Del Norte,015,27424,5,3,0,3,0
2020-05-04,El Dorado,017,186661,66,51,0,51,0
2020-05-04,Fresno,019,978130,1378,680,17,697,8
2020-05-04,Glenn,021,27897,8,4,0,4,0
2020-05-04,Humboldt,023,135768,61,54,0,54,0
2020-05-04,Imperial,025,180216,740,351,0,351,6
2020-05-04,Inyo,027,18085,19,20,0,20,1
2020-05-04,Kern,029,883053,1390,1047,1,1048,8
2020-05-04,Kings,031,150075,314,153,1,154,1
2020-05-04,Lake,033,64148,9,7,0,7,0
2020-05-04,Lassen,035,31185,3,0,2,2,0
2020-05-04,Los Angeles,037,10098052,33804,26243,16,26259,1235
2020-05-04,Madera,039,155013,110,52,1,53,2
2020-05-04,Marin,041,260295,259,244,1,245,13
2020-05-04,Mariposa,043,17540,15,13,0,13,0
2020-05-04,Mendocino,045,87422,12,10,0,10,0
2020-05-04,Merced,047,269075,221,138,0,138,3
2020-05-04,Modoc,049,8938,0,0,0,0,0
2020-05-04,Mono,051,14174,32,25,0,25,1
2020-05-04,Monterey,053,433212,303,237,0,237,6
2020-05-04,Napa,055,140530,86,72,0,72,2
2020-05-04,Nevada,057,99092,41,41,1,42,1
2020-05-04,Orange,059,3164182,4523,2931,33,2964,57
2020-05-04,Placer,061,380077,182,162,0,162,8
2020-05-04,Plumas,063,18699,4,4,0,4,0
2020-05-04,Riverside,065,2383286,5290,4221,16,4237,147
2020-05-04,Sacramento,067,1510023,1170,1119,0,1119,44
2020-05-04,San Benito,069,59416,54,49,0,49,2
2020-05-04,San Bernardino,071,2135413,3028,2184,2,2186,99
2020-05-04,San Diego,073,3302833,5109,4022,0,4022,144
2020-05-04,San Francisco,075,870044,1981,1760,0,1760,31
2020-05-04,San Joaquin,077,732212,628,574,3,577,26
2020-05-04,San Luis Obispo,079,281455,279,202,3,205,1
2020-05-04,San Mateo,081,765935,1553,1313,2,1315,53
2020-05-04,Santa Barbara,083,443738,927,524,4,528,7
2020-05-04,Santa Clara,085,1922200,2755,2238,8,2246,119
2020-05-04,Santa Cruz,087,273765,145,133,0,133,2
2020-05-04,Shasta,089,179085,42,31,0,31,4
2020-05-04,Sierra,091,2930,0,0,0,0,0
2020-05-04,Siskiyou,093,43540,5,5,0,5,0
2020-05-04,Solano,095,438530,372,293,0,293,4
2020-05-04,Sonoma,097,501317,313,256,0,256,4
2020-05-04,Stanislaus,099,539301,514,422,4,426,8
2020-05-04,Sutter,101,95872,33,28,0,28,2
2020-05-04,Tehama,103,63373,2,1,0,1,1
2020-05-04,Trinity,105,12862,1,0,0,0,0
2020-05-04,Tulare,107,460477,1361,760,6,766,40
2020-05-04,Tuolumne,109,53932,3,3,0,3,0
2020-05-04,Ventura,111,848112,810,590,1,591,19
2020-05-04,Yolo,113,214977,191,171,0,171,18
2020-05-04,Yuba,115,75493,19,16,0,16,1
2020-05-03,Alameda,001,1643700,2121,1731,2,1733,64
2020-05-03,Alpine,003,1148,1,1,0,1,0
2020-05-03,Amador,005,37829,8,8,0,8,0
2020-05-03,Butte,007,227075,28,17,1,18,0
2020-05-03,Calaveras,009,45235,13,13,0,13,0
2020-05-03,Colusa,011,21464,3,3,0,3,0
2020-05-03,Contra Costa,013,1133247,1073,945,0,945,28
2020-05-03,Del Norte,015,27424,5,3,0,3,0
2020-05-03,El Dorado,017,186661,64,49,0,49,0
2020-05-03,Fresno,019,978130,1286,646,15,661,8
2020-05-03,Glenn,021,27897,7,5,0,5,0
2020-05-03,Humboldt,023,135768,60,54,0,54,0
2020-05-03,Imperial,025,180216,684,351,0,351,6
2020-05-03,Inyo,027,18085,19,20,0,20,1
2020-05-03,Kern,029,883053,1335,1025,1,1026,8
2020-05-03,Kings,031,150075,294,137,1,138,1
2020-05-03,Lake,033,64148,9,7,0,7,0
2020-05-03,Lassen,035,31185,3,0,2,2,0
2020-05-03,Los Angeles,037,10098052,32818,25708,16,25724,1210
2020-05-03,Madera,039,155013,103,46,1,47,2
2020-05-03,Marin,041,260295,254,243,1,244,13
2020-05-03,Mariposa,043,17540,15,13,0,13,0
2020-05-03,Mendocino,045,87422,12,10,0,10,0
2020-05-03,Merced,047,269075,213,134,0,134,3
2020-05-03,Modoc,049,8938,0,0,0,0,0
2020-05-03,Mono,051,14174,32,25,0,25,1
2020-05-03,Monterey,053,433212,294,235,0,235,6
2020-05-03,Napa,055,140530,86,72,0,72,2
2020-05-03,Nevada,057,99092,41,41,1,42,1
2020-05-03,Orange,059,3164182,4349,2859,32,2891,55
2020-05-03,Placer,061,380077,182,161,0,161,8
2020-05-03,Plumas,063,18699,4,4,0,4,0
2020-05-03,Riverside,065,2383286,5185,4034,16,4050,139
2020-05-03,Sacramento,067,1510023,1161,1109,0,1109,43
2020-05-03,San Benito,069,59416,54,49,0,49,2
2020-05-03,San Bernardino,071,2135413,2968,2123,2,2125,99
2020-05-03,San Diego,073,3302833,4972,3929,0,3929,142
2020-05-03,San Francisco,075,870044,1952,1692,0,1692,30
2020-05-03,San Joaquin,077,732212,621,570,3,573,26
2020-05-03,San Luis Obispo,079,281455,276,200,3,203,1
2020-05-03,San Mateo,081,765935,1525,1277,2,1279,53
2020-05-03,Santa Barbara,083,443738,568,512,4,516,7
2020-05-03,Santa Clara,085,1922200,2718,2235,8,2243,116
2020-05-03,Santa Cruz,087,273765,145,133,0,133,2
2020-05-03,Shasta,089,179085,40,31,0,31,4
2020-05-03,Sierra,091,2930,0,0,0,0,0
2020-05-03,Siskiyou,093,43540,5,5,0,5,0
2020-05-03,Solano,095,438530,362,266,0,266,4
2020-05-03,Sonoma,097,501317,304,254,0,254,4
2020-05-03,Stanislaus,099,539301,486,411,4,415,8
2020-05-03,Sutter,101,95872,31,28,0,28,2
2020-05-03,Tehama,103,63373,2,1,0,1,1
2020-05-03,Trinity,105,12862,1,0,0,0,0
2020-05-03,Tulare,107,460477,1282,736,6,742,40
2020-05-03,Tuolumne,109,53932,3,3,0,3,0
2020-05-03,Ventura,111,848112,776,583,1,584,19
2020-05-03,Yolo,113,214977,190,171,0,171,18
2020-05-03,Yuba,115,75493,19,16,0,16,1
2020-05-02,Alameda,001,1643700,2084,1678,2,1680,63
2020-05-02,Alpine,003,1148,1,1,0,1,0
2020-05-02,Amador,005,37829,8,8,0,8,0
2020-05-02,Butte,007,227075,28,17,1,18,0
2020-05-02,Calaveras,009,45235,13,13,0,13,0
2020-05-02,Colusa,011,21464,3,3,0,3,0
2020-05-02,Contra Costa,013,1133247,1055,929,0,929,28
2020-05-02,Del Norte,015,27424,5,3,0,3,0
2020-05-02,El Dorado,017,186661,64,47,0,47,0
2020-05-02,Fresno,019,978130,1260,629,14,643,8
2020-05-02,Glenn,021,27897,7,5,0,5,0
2020-05-02,Humboldt,023,135768,60,54,0,54,0
2020-05-02,Imperial,025,180216,657,345,0,345,6
2020-05-02,Inyo,027,18085,19,20,0,20,1
2020-05-02,Kern,029,883053,1309,1007,1,1008,8
2020-05-02,Kings,031,150075,291,120,1,121,1
2020-05-02,Lake,033,64148,9,7,0,7,0
2020-05-02,Lassen,035,31185,3,0,2,2,0
2020-05-02,Los Angeles,037,10098052,32289,24955,16,24971,1192
2020-05-02,Madera,039,155013,103,46,1,47,2
2020-05-02,Marin,041,260295,253,243,1,244,13
2020-05-02,Mariposa,043,17540,15,13,0,13,0
2020-05-02,Mendocino,045,87422,12,10,0,10,0
2020-05-02,Merced,047,269075,210,131,0,131,3
2020-05-02,Modoc,049,8938,0,0,0,0,0
2020-05-02,Mono,051,14174,32,25,0,25,1
2020-05-02,Monterey,053,433212,288,225,0,225,5
2020-05-02,Napa,055,140530,86,71,0,71,2
2020-05-02,Nevada,057,99092,41,41,1,42,1
2020-05-02,Orange,059,3164182,4235,2774,32,2806,52
2020-05-02,Placer,061,380077,180,150,0,150,8
2020-05-02,Plumas,063,18699,4,4,0,4,0
2020-05-02,Riverside,065,2383286,5119,3997,16,4013,137
2020-05-02,Sacramento,067,1510023,1158,1097,0,1097,43
2020-05-02,San Benito,069,59416,54,49,0,49,2
2020-05-02,San Bernardino,071,2135413,2929,2124,2,2126,99
2020-05-02,San Diego,073,3302833,4870,3844,0,3844,138
2020-05-02,San Francisco,075,870044,1929,1632,0,1632,29
2020-05-02,San Joaquin,077,732212,613,559,3,562,25
2020-05-02,San Luis Obispo,079,281455,270,193,3,196,1
2020-05-02,San Mateo,081,765935,1509,1272,2,1274,52
2020-05-02,Santa Barbara,083,443738,560,506,4,510,7
2020-05-02,Santa Clara,085,1922200,2708,2203,8,2211,115
2020-05-02,Santa Cruz,087,273765,144,131,0,131,2
2020-05-02,Shasta,089,179085,40,31,0,31,4
2020-05-02,Sierra,091,2930,0,0,0,0,0
2020-05-02,Siskiyou,093,43540,5,5,0,5,0
2020-05-02,Solano,095,438530,355,267,0,267,4
2020-05-02,Sonoma,097,501317,301,250,0,250,3
2020-05-02,Stanislaus,099,539301,478,388,4,392,8
2020-05-02,Sutter,101,95872,31,28,0,28,2
2020-05-02,Tehama,103,63373,2,1,0,1,1
2020-05-02,Trinity,105,12862,1,0,0,0,0
2020-05-02,Tulare,107,460477,1239,711,6,717,35
2020-05-02,Tuolumne,109,53932,3,3,0,3,0
2020-05-02,Ventura,111,848112,762,564,1,565,19
2020-05-02,Yolo,113,214977,190,169,0,169,17
2020-05-02,Yuba,115,75493,19,16,0,16,1
2020-05-01,Alameda,001,1643700,2047,1630,2,1632,63
2020-05-01,Alpine,003,1148,1,1,0,1,0
2020-05-01,Amador,005,37829,8,8,0,8,0
2020-05-01,Butte,007,227075,28,17,1,18,0
2020-05-01,Calaveras,009,45235,13,13,0,13,0
2020-05-01,Colusa,011,21464,3,3,0,3,0
2020-05-01,Contra Costa,013,1133247,1041,915,0,915,28
2020-05-01,Del Norte,015,27424,5,3,0,3,0
2020-05-01,El Dorado,017,186661,64,47,0,47,0
2020-05-01,Fresno,019,978130,1229,617,14,631,7
2020-05-01,Glenn,021,27897,7,4,0,4,0
2020-05-01,Humboldt,023,135768,60,54,0,54,0
2020-05-01,Imperial,025,180216,620,337,0,337,6
2020-05-01,Inyo,027,18085,19,20,0,20,1
2020-05-01,Kern,029,883053,1282,972,1,973,8
2020-05-01,Kings,031,150075,274,112,1,113,1
2020-05-01,Lake,033,64148,9,6,0,6,0
2020-05-01,Lassen,035,31185,3,0,2,2,0
2020-05-01,Los Angeles,037,10098052,31533,24306,16,24322,1155
2020-05-01,Madera,039,155013,99,46,1,47,2
2020-05-01,Marin,041,260295,253,242,1,243,13
2020-05-01,Mariposa,043,17540,15,10,0,10,0
2020-05-01,Mendocino,045,87422,12,11,0,11,0
2020-05-01,Merced,047,269075,207,131,0,131,3
2020-05-01,Modoc,049,8938,0,0,0,0,0
2020-05-01,Mono,051,14174,32,25,0,25,1
2020-05-01,Monterey,053,433212,284,222,0,222,5
2020-05-01,Napa,055,140530,86,69,0,69,2
2020-05-01,Nevada,057,99092,41,41,1,42,1
2020-05-01,Orange,059,3164182,4158,2660,30,2690,51
2020-05-01,Placer,061,380077,179,149,0,149,8
2020-05-01,Plumas,063,18699,4,4,0,4,0
2020-05-01,Riverside,065,2383286,5055,3893,16,3909,132
2020-05-01,Sacramento,067,1510023,1153,1081,0,1081,43
2020-05-01,San Benito,069,59416,54,49,0,49,2
2020-05-01,San Bernardino,071,2135413,2874,2084,2,2086,98
2020-05-01,San Diego,073,3302833,4779,3713,0,3713,134
2020-05-01,San Francisco,075,870044,1885,1552,0,1552,29
2020-05-01,San Joaquin,077,732212,609,554,3,557,25
2020-05-01,San Luis Obispo,079,281455,267,186,3,189,1
2020-05-01,San Mateo,081,765935,1487,1222,2,1224,52
2020-05-01,Santa Barbara,083,443738,554,499,3,502,7
2020-05-01,Santa Clara,085,1922200,2696,2176,8,2184,112
2020-05-01,Santa Cruz,087,273765,144,127,0,127,2
2020-05-01,Shasta,089,179085,40,31,0,31,4
2020-05-01,Sierra,091,2930,0,0,0,0,0
2020-05-01,Siskiyou,093,43540,5,5,0,5,0
2020-05-01,Solano,095,438530,347,266,0,266,4
2020-05-01,Sonoma,097,501317,298,242,0,242,3
2020-05-01,Stanislaus,099,539301,473,384,4,388,8
2020-05-01,Sutter,101,95872,31,28,0,28,2
2020-05-01,Tehama,103,63373,2,1,0,1,1
2020-05-01,Trinity,105,12862,1,0,0,0,0
2020-05-01,Tulare,107,460477,1195,685,6,691,32
2020-05-01,Tuolumne,109,53932,3,3,0,3,0
2020-05-01,Ventura,111,848112,749,556,1,557,18
2020-05-01,Yolo,113,214977,190,165,0,165,18
2020-05-01,Yuba,115,75493,19,16,0,16,1
2020-04-30,Alameda,001,1643700,1987,1599,2,1601,60
2020-04-30,Alpine,003,1148,1,1,0,1,0
2020-04-30,Amador,005,37829,8,8,0,8,0
2020-04-30,Butte,007,227075,28,16,1,17,0
2020-04-30,Calaveras,009,45235,13,13,0,13,0
2020-04-30,Colusa,011,21464,3,3,0,3,0
2020-04-30,Contra Costa,013,1133247,1019,900,0,900,25
2020-04-30,Del Norte,015,27424,4,3,0,3,0
2020-04-30,El Dorado,017,186661,64,44,0,44,0
2020-04-30,Fresno,019,978130,1163,562,11,573,7
2020-04-30,Glenn,021,27897,7,4,0,4,0
2020-04-30,Humboldt,023,135768,60,54,0,54,0
2020-04-30,Imperial,025,180216,574,322,0,322,6
2020-04-30,Inyo,027,18085,19,20,0,20,1
2020-04-30,Kern,029,883053,1250,941,1,942,8
2020-04-30,Kings,031,150075,262,87,1,88,1
2020-04-30,Lake,033,64148,9,6,0,6,0
2020-04-30,Lassen,035,31185,3,0,2,2,0
2020-04-30,Los Angeles,037,10098052,30523,23284,16,23300,1099
2020-04-30,Madera,039,155013,88,46,1,47,2
2020-04-30,Marin,041,260295,253,240,1,241,13
2020-04-30,Mariposa,043,17540,15,3,0,3,0
2020-04-30,Mendocino,045,87422,12,11,0,11,0
2020-04-30,Merced,047,269075,200,122,0,122,3
2020-04-30,Modoc,049,8938,0,0,0,0,0
2020-04-30,Mono,051,14174,31,25,0,25,1
2020-04-30,Monterey,053,433212,274,213,0,213,5
2020-04-30,Napa,055,140530,84,69,0,69,2
2020-04-30,Nevada,057,99092,41,41,1,42,1
2020-04-30,Orange,059,3164182,3935,2591,27,2618,46
2020-04-30,Placer,061,380077,178,148,0,148,8
2020-04-30,Plumas,063,18699,4,4,0,4,0
2020-04-30,Riverside,065,2383286,4955,3820,15,3835,124
2020-04-30,Sacramento,067,1510023,1147,1071,0,1071,43
2020-04-30,San Benito,069,59416,54,48,0,48,2
2020-04-30,San Bernardino,071,2135413,2672,2020,2,2022,96
2020-04-30,San Diego,073,3302833,4608,3566,0,3566,124
2020-04-30,San Francisco,075,870044,1851,1518,0,1518,26
2020-04-30,San Joaquin,077,732212,601,548,3,551,25
2020-04-30,San Luis Obispo,079,281455,264,182,3,185,1
2020-04-30,San Mateo,081,765935,1457,1194,2,1196,52
2020-04-30,Santa Barbara,083,443738,542,490,3,493,7
2020-04-30,Santa Clara,085,1922200,2656,2172,8,2180,111
2020-04-30,Santa Cruz,087,273765,143,126,0,126,2
2020-04-30,Shasta,089,179085,39,31,0,31,4
2020-04-30,Sierra,091,2930,0,0,0,0,0
2020-04-30,Siskiyou,093,43540,5,5,0,5,0
2020-04-30,Solano,095,438530,337,262,0,262,4
2020-04-30,Sonoma,097,501317,289,233,0,233,3
2020-04-30,Stanislaus,099,539301,466,378,4,382,7
2020-04-30,Sutter,101,95872,31,28,0,28,2
2020-04-30,Tehama,103,63373,1,1,0,1,1
2020-04-30,Trinity,105,12862,1,0,0,0,0
2020-04-30,Tulare,107,460477,1129,637,6,643,31
2020-04-30,Tuolumne,109,53932,3,3,0,3,0
2020-04-30,Ventura,111,848112,721,547,1,548,18
2020-04-30,Yolo,113,214977,189,164,0,164,16
2020-04-30,Yuba,115,75493,19,15,0,15,1
2020-04-29,Alameda,001,1643700,1929,1564,2,1566,60
2020-04-29,Alpine,003,1148,1,1,0,1,0
2020-04-29,Amador,005,37829,8,8,0,8,0
2020-04-29,Butte,007,227075,28,16,1,17,0
2020-04-29,Calaveras,009,45235,13,13,0,13,0
2020-04-29,Colusa,011,21464,3,3,0,3,0
2020-04-29,Contra Costa,013,1133247,1000,885,0,885,25
2020-04-29,Del Norte,015,27424,4,3,0,3,0
2020-04-29,El Dorado,017,186661,62,44,0,44,0
2020-04-29,Fresno,019,978130,1111,544,11,555,7
2020-04-29,Glenn,021,27897,7,4,0,4,0
2020-04-29,Humboldt,023,135768,60,53,0,53,0
2020-04-29,Imperial,025,180216,544,300,0,300,6
2020-04-29,Inyo,027,18085,19,20,0,20,1
2020-04-29,Kern,029,883053,1207,910,1,911,6
2020-04-29,Kings,031,150075,243,80,1,81,1
2020-04-29,Lake,033,64148,9,6,0,6,0
2020-04-29,Lassen,035,31185,3,0,2,2,0
2020-04-29,Los Angeles,037,10098052,29546,22560,15,22575,1043
2020-04-29,Madera,039,155013,86,45,1,46,2
2020-04-29,Marin,041,260295,250,234,1,235,13
2020-04-29,Mariposa,043,17540,15,1,0,1,0
2020-04-29,Mendocino,045,87422,12,11,0,11,0
2020-04-29,Merced,047,269075,193,116,0,116,3
2020-04-29,Modoc,049,8938,0,0,0,0,0
2020-04-29,Mono,051,14174,31,25,0,25,1
2020-04-29,Monterey,053,433212,266,204,0,204,5
2020-04-29,Napa,055,140530,82,68,0,68,2
2020-04-29,Nevada,057,99092,41,41,1,42,1
2020-04-29,Orange,059,3164182,3800,2421,26,2447,43
2020-04-29,Placer,061,380077,176,145,0,145,8
2020-04-29,Plumas,063,18699,4,4,0,4,0
2020-04-29,Riverside,065,2383286,4878,3700,15,3715,116
2020-04-29,Sacramento,067,1510023,1125,1055,0,1055,41
2020-04-29,San Benito,069,59416,54,48,0,48,2
2020-04-29,San Bernardino,071,2135413,2585,1975,1,1976,91
2020-04-29,San Diego,073,3302833,4466,3434,0,3434,120
2020-04-29,San Francisco,075,870044,1823,1489,0,1489,23
2020-04-29,San Joaquin,077,732212,593,540,3,543,25
2020-04-29,San Luis Obispo,079,281455,262,181,3,184,1
2020-04-29,San Mateo,081,765935,1431,1170,2,1172,50
2020-04-29,Santa Barbara,083,443738,529,477,3,480,7
2020-04-29,Santa Clara,085,1922200,2629,2147,8,2155,108
2020-04-29,Santa Cruz,087,273765,142,124,0,124,2
2020-04-29,Shasta,089,179085,38,31,0,31,4
2020-04-29,Sierra,091,2930,0,0,0,0,0
2020-04-29,Siskiyou,093,43540,5,5,0,5,0
2020-04-29,Solano,095,438530,313,252,0,252,3
2020-04-29,Sonoma,097,501317,281,230,0,230,2
2020-04-29,Stanislaus,099,539301,453,374,4,378,5
2020-04-29,Sutter,101,95872,31,28,0,28,2
2020-04-29,Tehama,103,63373,1,1,0,1,1
2020-04-29,Trinity,105,12862,1,0,0,0,0
2020-04-29,Tulare,107,460477,1056,615,5,620,30
2020-04-29,Tuolumne,109,53932,3,4,0,4,0
2020-04-29,Ventura,111,848112,697,530,1,531,18
2020-04-29,Yolo,113,214977,186,161,0,161,11
2020-04-29,Yuba,115,75493,19,15,0,15,1
2020-04-28,Alameda,001,1643700,1872,1525,2,1527,55
2020-04-28,Alpine,003,1148,1,1,0,1,0
2020-04-28,Amador,005,37829,8,8,0,8,0
2020-04-28,Butte,007,227075,28,16,1,17,0
2020-04-28,Calaveras,009,45235,13,13,0,13,0
2020-04-28,Colusa,011,21464,3,3,0,3,0
2020-04-28,Contra Costa,013,1133247,993,866,0,866,25
2020-04-28,Del Norte,015,27424,4,3,0,3,0
2020-04-28,El Dorado,017,186661,61,43,0,43,0
2020-04-28,Fresno,019,978130,1060,525,9,534,7
2020-04-28,Glenn,021,27897,5,4,0,4,0
2020-04-28,Humboldt,023,135768,59,53,0,53,0
2020-04-28,Imperial,025,180216,510,295,0,295,6
2020-04-28,Inyo,027,18085,19,20,0,20,1
2020-04-28,Kern,029,883053,1164,882,1,883,5
2020-04-28,Kings,031,150075,230,57,1,58,1
2020-04-28,Lake,033,64148,9,6,0,6,0
2020-04-28,Lassen,035,31185,3,0,2,2,0
2020-04-28,Los Angeles,037,10098052,28482,21029,15,21044,984
2020-04-28,Madera,039,155013,86,44,1,45,2
2020-04-28,Marin,041,260295,249,228,1,229,12
2020-04-28,Mariposa,043,17540,15,0,0,0,0
2020-04-28,Mendocino,045,87422,12,10,0,10,0
2020-04-28,Merced,047,269075,186,108,0,108,3
2020-04-28,Modoc,049,8938,0,0,0,0,0
2020-04-28,Mono,051,14174,31,25,0,25,1
2020-04-28,Monterey,053,433212,260,191,0,191,5
2020-04-28,Napa,055,140530,81,67,0,67,2
2020-04-28,Nevada,057,99092,41,41,1,42,1
2020-04-28,Orange,059,3164182,3637,2324,25,2349,42
2020-04-28,Placer,061,380077,166,143,0,143,8
2020-04-28,Plumas,063,18699,4,4,0,4,0
2020-04-28,Riverside,065,2383286,4783,3504,15,3519,113
2020-04-28,Sacramento,067,1510023,1110,1044,0,1044,41
2020-04-28,San Benito,069,59416,52,46,0,46,2
2020-04-28,San Bernardino,071,2135413,2508,1891,1,1892,89
2020-04-28,San Diego,073,3302833,4336,3316,0,3316,118
2020-04-28,San Francisco,075,870044,1788,1471,0,1471,23
2020-04-28,San Joaquin,077,732212,587,532,3,535,25
2020-04-28,San Luis Obispo,079,281455,255,172,3,175,1
2020-04-28,San Mateo,081,765935,1418,1129,2,1131,48
2020-04-28,Santa Barbara,083,443738,524,469,2,471,7
2020-04-28,Santa Clara,085,1922200,2595,2130,8,2138,106
2020-04-28,Santa Cruz,087,273765,142,123,0,123,2
2020-04-28,Shasta,089,179085,38,29,0,29,4
2020-04-28,Sierra,091,2930,0,0,0,0,0
2020-04-28,Siskiyou,093,43540,5,5,0,5,0
2020-04-28,Solano,095,438530,294,246,0,246,3
2020-04-28,Sonoma,097,501317,278,226,0,226,1
2020-04-28,Stanislaus,099,539301,437,330,4,334,5
2020-04-28,Sutter,101,95872,31,25,0,25,2
2020-04-28,Tehama,103,63373,1,1,0,1,1
2020-04-28,Trinity,105,12862,1,0,0,0,0
2020-04-28,Tulare,107,460477,960,579,5,584,30
2020-04-28,Tuolumne,109,53932,3,4,0,4,0
2020-04-28,Ventura,111,848112,677,517,1,518,17
2020-04-28,Yolo,113,214977,186,160,0,160,10
2020-04-28,Yuba,115,75493,19,15,0,15,1
2020-04-27,Alameda,001,1643700,1812,1494,2,1496,53
2020-04-27,Alpine,003,1148,1,1,0,1,0
2020-04-27,Amador,005,37829,8,8,0,8,0
2020-04-27,Butte,007,227075,27,16,1,17,0
2020-04-27,Calaveras,009,45235,13,13,0,13,0
2020-04-27,Colusa,011,21464,3,3,0,3,0
2020-04-27,Contra Costa,013,1133247,981,843,0,843,25
2020-04-27,Del Norte,015,27424,4,3,0,3,0
2020-04-27,El Dorado,017,186661,60,43,0,43,0
2020-04-27,Fresno,019,978130,957,504,8,512,7
2020-04-27,Glenn,021,27897,5,4,0,4,0
2020-04-27,Humboldt,023,135768,59,52,0,52,0
2020-04-27,Imperial,025,180216,480,290,0,290,6
2020-04-27,Inyo,027,18085,19,20,0,20,1
2020-04-27,Kern,029,883053,1125,865,1,866,4
2020-04-27,Kings,031,150075,207,48,1,49,1
2020-04-27,Lake,033,64148,8,6,0,6,0
2020-04-27,Lassen,035,31185,3,0,2,2,0
2020-04-27,Los Angeles,037,10098052,27462,20456,15,20471,931
2020-04-27,Madera,039,155013,84,42,1,43,2
2020-04-27,Marin,041,260295,244,227,1,228,12
2020-04-27,Mariposa,043,17540,14,0,0,0,0
2020-04-27,Mendocino,045,87422,12,10,0,10,0
2020-04-27,Merced,047,269075,183,108,0,108,3
2020-04-27,Modoc,049,8938,0,0,0,0,0
2020-04-27,Mono,051,14174,31,23,0,23,1
2020-04-27,Monterey,053,433212,253,185,0,185,4
2020-04-27,Napa,055,140530,77,64,0,64,2
2020-04-27,Nevada,057,99092,41,39,1,40,1
2020-04-27,Orange,059,3164182,3468,2198,25,2223,42
2020-04-27,Placer,061,380077,166,142,0,142,8
2020-04-27,Plumas,063,18699,4,4,0,4,0
2020-04-27,Riverside,065,2383286,4660,3381,15,3396,100
2020-04-27,Sacramento,067,1510023,1095,1035,0,1035,41
2020-04-27,San Benito,069,59416,50,45,0,45,2
2020-04-27,San Bernardino,071,2135413,2394,1742,1,1743,82
2020-04-27,San Diego,073,3302833,4210,3143,0,3143,113
2020-04-27,San Francisco,075,870044,1734,1453,0,1453,23
2020-04-27,San Joaquin,077,732212,581,522,3,525,25
2020-04-27,San Luis Obispo,079,281455,247,166,3,169,1
2020-04-27,San Mateo,081,765935,1396,1092,2,1094,46
2020-04-27,Santa Barbara,083,443738,516,466,2,468,7
2020-04-27,Santa Clara,085,1922200,2570,2104,7,2111,105
2020-04-27,Santa Cruz,087,273765,142,123,0,123,2
2020-04-27,Shasta,089,179085,38,29,0,29,4
2020-04-27,Sierra,091,2930,0,0,0,0,0
2020-04-27,Siskiyou,093,43540,5,5,0,5,0
2020-04-27,Solano,095,438530,294,222,0,222,3
2020-04-27,Sonoma,097,501317,269,220,0,220,1
2020-04-27,Stanislaus,099,539301,421,316,4,320,5
2020-04-27,Sutter,101,95872,29,26,0,26,2
2020-04-27,Tehama,103,63373,1,1,0,1,1
2020-04-27,Trinity,105,12862,1,0,0,0,0
2020-04-27,Tulare,107,460477,889,535,5,540,28
2020-04-27,Tuolumne,109,53932,3,3,0,3,0
2020-04-27,Ventura,111,848112,658,513,1,514,17
2020-04-27,Yolo,113,214977,183,160,0,160,9
2020-04-27,Yuba,115,75493,19,15,0,15,1
2020-04-26,Alameda,001,1643700,1751,1449,2,1451,52
2020-04-26,Alpine,003,1148,1,1,0,1,0
2020-04-26,Amador,005,37829,8,8,0,8,0
2020-04-26,Butte,007,227075,27,16,1,17,0
2020-04-26,Calaveras,009,45235,13,13,0,13,0
2020-04-26,Colusa,011,21464,3,3,0,3,0
2020-04-26,Contra Costa,013,1133247,965,830,0,830,25
2020-04-26,Del Norte,015,27424,3,3,0,3,0
2020-04-26,El Dorado,017,186661,58,41,0,41,0
2020-04-26,Fresno,019,978130,863,476,7,483,7
2020-04-26,Glenn,021,27897,5,4,0,4,0
2020-04-26,Humboldt,023,135768,59,53,0,53,0
2020-04-26,Imperial,025,180216,446,272,0,272,6
2020-04-26,Inyo,027,18085,19,20,0,20,1
2020-04-26,Kern,029,883053,1075,831,1,832,4
2020-04-26,Kings,031,150075,182,33,1,34,1
2020-04-26,Lake,033,64148,8,6,0,6,0
2020-04-26,Lassen,035,31185,3,0,2,2,0
2020-04-26,Los Angeles,037,10098052,26305,19570,15,19585,901
2020-04-26,Madera,039,155013,82,39,1,40,2
2020-04-26,Marin,041,260295,238,225,1,226,12
2020-04-26,Mariposa,043,17540,14,0,0,0,0
2020-04-26,Mendocino,045,87422,12,5,0,5,0
2020-04-26,Merced,047,269075,166,104,0,104,3
2020-04-26,Modoc,049,8938,0,0,0,0,0
2020-04-26,Mono,051,14174,31,23,0,23,1
2020-04-26,Monterey,053,433212,246,182,0,182,4
2020-04-26,Napa,055,140530,76,62,0,62,2
2020-04-26,Nevada,057,99092,41,37,1,38,1
2020-04-26,Orange,059,3164182,3303,2124,25,2149,40
2020-04-26,Placer,061,380077,165,141,0,141,8
2020-04-26,Plumas,063,18699,4,4,0,4,0
2020-04-26,Riverside,065,2383286,4517,3301,15,3316,95
2020-04-26,Sacramento,067,1510023,1086,1027,0,1027,41
2020-04-26,San Benito,069,59416,50,45,0,45,2
2020-04-26,San Bernardino,071,2135413,2298,1681,1,1682,82
2020-04-26,San Diego,073,3302833,4068,3045,0,3045,111
2020-04-26,San Francisco,075,870044,1695,1403,0,1403,23
2020-04-26,San Joaquin,077,732212,573,514,3,517,25
2020-04-26,San Luis Obispo,079,281455,244,165,3,168,1
2020-04-26,San Mateo,081,765935,1370,1070,2,1072,46
2020-04-26,Santa Barbara,083,443738,509,464,2,466,7
2020-04-26,Santa Clara,085,1922200,2547,2097,6,2103,102
2020-04-26,Santa Cruz,087,273765,142,116,0,116,2
2020-04-26,Shasta,089,179085,35,29,0,29,4
2020-04-26,Sierra,091,2930,0,0,0,0,0
2020-04-26,Siskiyou,093,43540,5,5,0,5,0
2020-04-26,Solano,095,438530,285,205,0,205,3
2020-04-26,Sonoma,097,501317,258,216,0,216,1
2020-04-26,Stanislaus,099,539301,406,294,4,298,4
2020-04-26,Sutter,101,95872,29,26,0,26,2
2020-04-26,Tehama,103,63373,1,1,0,1,1
2020-04-26,Trinity,105,12862,1,0,0,0,0
2020-04-26,Tulare,107,460477,830,497,5,502,28
2020-04-26,Tuolumne,109,53932,3,3,0,3,0
2020-04-26,Ventura,111,848112,640,509,1,510,17
2020-04-26,Yolo,113,214977,182,158,0,158,8
2020-04-26,Yuba,115,75493,18,15,0,15,1
2020-04-25,Alameda,001,1643700,1726,1396,2,1398,52
2020-04-25,Alpine,003,1148,1,1,0,1,0
2020-04-25,Amador,005,37829,8,8,0,8,0
2020-04-25,Butte,007,227075,26,16,1,17,0
2020-04-25,Calaveras,009,45235,13,12,0,12,0
2020-04-25,Colusa,011,21464,3,3,0,3,0
2020-04-25,Contra Costa,013,1133247,951,821,0,821,24
2020-04-25,Del Norte,015,27424,2,2,0,2,0
2020-04-25,El Dorado,017,186661,57,41,0,41,0
2020-04-25,Fresno,019,978130,831,459,6,465,7
2020-04-25,Glenn,021,27897,5,4,0,4,0
2020-04-25,Humboldt,023,135768,59,53,0,53,0
2020-04-25,Imperial,025,180216,429,232,0,232,6
2020-04-25,Inyo,027,18085,19,20,0,20,1
2020-04-25,Kern,029,883053,1044,802,1,803,4
2020-04-25,Kings,031,150075,170,33,1,34,1
2020-04-25,Lake,033,64148,6,6,0,6,0
2020-04-25,Lassen,035,31185,3,0,2,2,0
2020-04-25,Los Angeles,037,10098052,25672,19144,15,19159,881
2020-04-25,Madera,039,155013,79,39,1,40,2
2020-04-25,Marin,041,260295,238,215,1,216,12
2020-04-25,Mariposa,043,17540,14,0,0,0,0
2020-04-25,Mendocino,045,87422,11,5,0,5,0
2020-04-25,Merced,047,269075,166,103,0,103,3
2020-04-25,Modoc,049,8938,0,0,0,0,0
2020-04-25,Mono,051,14174,31,23,0,23,1
2020-04-25,Monterey,053,433212,244,173,0,173,4
2020-04-25,Napa,055,140530,76,60,0,60,2
2020-04-25,Nevada,057,99092,41,37,1,38,1
2020-04-25,Orange,059,3164182,3195,2047,25,2072,40
2020-04-25,Placer,061,380077,165,137,0,137,8
2020-04-25,Plumas,063,18699,4,4,0,4,0
2020-04-25,Riverside,065,2383286,4427,3037,15,3052,93
2020-04-25,Sacramento,067,1510023,1084,1015,0,1015,41
2020-04-25,San Benito,069,59416,50,45,0,45,2
2020-04-25,San Bernardino,071,2135413,2252,1675,1,1676,82
2020-04-25,San Diego,073,3302833,3967,2945,0,2945,111
2020-04-25,San Francisco,075,870044,1670,1341,0,1341,22
2020-04-25,San Joaquin,077,732212,566,497,3,500,24
2020-04-25,San Luis Obispo,079,281455,243,159,3,162,1
2020-04-25,San Mateo,081,765935,1352,1054,2,1056,46
2020-04-25,Santa Barbara,083,443738,502,457,2,459,7
2020-04-25,Santa Clara,085,1922200,2525,2045,5,2050,99
2020-04-25,Santa Cruz,087,273765,142,112,0,112,2
2020-04-25,Shasta,089,179085,35,29,0,29,4
2020-04-25,Sierra,091,2930,0,0,0,0,0
2020-04-25,Siskiyou,093,43540,5,5,0,5,0
2020-04-25,Solano,095,438530,281,203,0,203,3
2020-04-25,Sonoma,097,501317,254,199,0,199,1
2020-04-25,Stanislaus,099,539301,398,276,4,280,4
2020-04-25,Sutter,101,95872,29,24,0,24,2
2020-04-25,Tehama,103,63373,1,1,0,1,1
2020-04-25,Trinity,105,12862,0,0,0,0,0
2020-04-25,Tulare,107,460477,797,478,5,483,28
2020-04-25,Tuolumne,109,53932,3,2,0,2,0
2020-04-25,Ventura,111,848112,626,494,1,495,16
2020-04-25,Yolo,113,214977,182,157,0,157,8
2020-04-25,Yuba,115,75493,17,15,0,15,1
2020-04-24,Alameda,001,1643700,1695,1385,2,1387,50
2020-04-24,Alpine,003,1148,1,1,0,1,0
2020-04-24,Amador,005,37829,8,8,0,8,0
2020-04-24,Butte,007,227075,25,15,1,16,0
2020-04-24,Calaveras,009,45235,13,12,0,12,0
2020-04-24,Colusa,011,21464,3,3,0,3,0
2020-04-24,Contra Costa,013,1133247,942,806,0,806,23
2020-04-24,Del Norte,015,27424,2,2,0,2,0
2020-04-24,El Dorado,017,186661,56,41,0,41,0
2020-04-24,Fresno,019,978130,808,449,6,455,7
2020-04-24,Glenn,021,27897,5,4,0,4,0
2020-04-24,Humboldt,023,135768,59,53,0,53,0
2020-04-24,Imperial,025,180216,413,232,0,232,6
2020-04-24,Inyo,027,18085,19,20,0,20,0
2020-04-24,Kern,029,883053,1020,770,1,771,4
2020-04-24,Kings,031,150075,141,30,1,31,1
2020-04-24,Lake,033,64148,6,6,0,6,0
2020-04-24,Lassen,035,31185,3,0,2,2,0
2020-04-24,Los Angeles,037,10098052,24742,18553,15,18568,836
2020-04-24,Madera,039,155013,79,39,1,40,2
2020-04-24,Marin,041,260295,238,211,1,212,11
2020-04-24,Mariposa,043,17540,8,0,0,0,0
2020-04-24,Mendocino,045,87422,11,5,0,5,0
2020-04-24,Merced,047,269075,163,102,0,102,3
2020-04-24,Modoc,049,8938,0,0,0,0,0
2020-04-24,Mono,051,14174,30,23,0,23,1
2020-04-24,Monterey,053,433212,237,167,0,167,4
2020-04-24,Napa,055,140530,75,59,0,59,2
2020-04-24,Nevada,057,99092,41,36,1,37,1
2020-04-24,Orange,059,3164182,3088,1945,25,1970,39
2020-04-24,Placer,061,380077,163,137,0,137,8
2020-04-24,Plumas,063,18699,4,4,0,4,0
2020-04-24,Riverside,065,2383286,4346,3044,15,3059,87
2020-04-24,Sacramento,067,1510023,1078,1009,0,1009,41
2020-04-24,San Benito,069,59416,50,45,0,45,2
2020-04-24,San Bernardino,071,2135413,2217,1667,1,1668,80
2020-04-24,San Diego,073,3302833,3856,2828,0,2828,102
2020-04-24,San Francisco,075,870044,1612,1345,0,1345,22
2020-04-24,San Joaquin,077,732212,559,484,3,487,24
2020-04-24,San Luis Obispo,079,281455,240,151,3,154,1
2020-04-24,San Mateo,081,765935,1329,1004,2,1006,43
2020-04-24,Santa Barbara,083,443738,496,450,2,452,6
2020-04-24,Santa Clara,085,1922200,2483,2026,5,2031,98
2020-04-24,Santa Cruz,087,273765,138,111,0,111,2
2020-04-24,Shasta,089,179085,35,28,0,28,4
2020-04-24,Sierra,091,2930,0,0,0,0,0
2020-04-24,Siskiyou,093,43540,5,5,0,5,0
2020-04-24,Solano,095,438530,279,203,0,203,3
2020-04-24,Sonoma,097,501317,250,199,0,199,1
2020-04-24,Stanislaus,099,539301,395,273,4,277,4
2020-04-24,Sutter,101,95872,28,24,0,24,2
2020-04-24,Tehama,103,63373,1,1,0,1,1
2020-04-24,Trinity,105,12862,0,0,0,0,0
2020-04-24,Tulare,107,460477,769,459,5,464,27
2020-04-24,Tuolumne,109,53932,3,2,0,2,0
2020-04-24,Ventura,111,848112,616,489,1,490,16
2020-04-24,Yolo,113,214977,181,155,0,155,8
2020-04-24,Yuba,115,75493,16,15,0,15,1
2020-04-23,Alameda,001,1643700,1657,1336,2,1338,46
2020-04-23,Alpine,003,1148,1,1,0,1,0
2020-04-23,Amador,005,37829,8,8,0,8,0
2020-04-23,Butte,007,227075,25,15,1,16,0
2020-04-23,Calaveras,009,45235,13,12,0,12,0
2020-04-23,Colusa,011,21464,3,3,0,3,0
2020-04-23,Contra Costa,013,1133247,921,786,0,786,23
2020-04-23,Del Norte,015,27424,2,2,0,2,0
2020-04-23,El Dorado,017,186661,55,39,0,39,0
2020-04-23,Fresno,019,978130,770,426,6,432,7
2020-04-23,Glenn,021,27897,5,3,0,3,0
2020-04-23,Humboldt,023,135768,59,53,0,53,0
2020-04-23,Imperial,025,180216,392,181,0,181,4
2020-04-23,Inyo,027,18085,19,19,0,19,0
2020-04-23,Kern,029,883053,972,732,1,733,4
2020-04-23,Kings,031,150075,126,28,1,29,1
2020-04-23,Lake,033,64148,6,6,0,6,0
2020-04-23,Lassen,035,31185,3,0,2,2,0
2020-04-23,Los Angeles,037,10098052,23681,17548,14,17562,784
2020-04-23,Madera,039,155013,77,37,1,38,2
2020-04-23,Marin,041,260295,225,209,1,210,11
2020-04-23,Mariposa,043,17540,7,0,0,0,0
2020-04-23,Mendocino,045,87422,9,5,0,5,0
2020-04-23,Merced,047,269075,159,98,0,98,3
2020-04-23,Modoc,049,8938,0,0,0,0,0
2020-04-23,Mono,051,14174,30,23,0,23,1
2020-04-23,Monterey,053,433212,233,161,0,161,4
2020-04-23,Napa,055,140530,68,59,0,59,2
2020-04-23,Nevada,057,99092,41,36,1,37,1
2020-04-23,Orange,059,3164182,2910,1841,24,1865,37
2020-04-23,Placer,061,380077,160,136,0,136,8
2020-04-23,Plumas,063,18699,4,4,0,4,0
2020-04-23,Riverside,065,2383286,4232,2935,14,2949,78
2020-04-23,Sacramento,067,1510023,1066,978,0,978,41
2020-04-23,San Benito,069,59416,47,43,0,43,2
2020-04-23,San Bernardino,071,2135413,2152,1604,1,1605,79
2020-04-23,San Diego,073,3302833,3695,2645,0,2645,100
2020-04-23,San Francisco,075,870044,1587,1312,0,1312,21
2020-04-23,San Joaquin,077,732212,549,479,3,482,20
2020-04-23,San Luis Obispo,079,281455,236,146,3,149,1
2020-04-23,San Mateo,081,765935,1290,970,2,972,42
2020-04-23,Santa Barbara,083,443738,490,445,2,447,6
2020-04-23,Santa Clara,085,1922200,2448,1996,5,2001,95
2020-04-23,Santa Cruz,087,273765,137,110,0,110,2
2020-04-23,Shasta,089,179085,35,27,0,27,3
2020-04-23,Sierra,091,2930,0,0,0,0,0
2020-04-23,Siskiyou,093,43540,5,5,0,5,0
2020-04-23,Solano,095,438530,265,196,0,196,3
2020-04-23,Sonoma,097,501317,238,187,0,187,1
2020-04-23,Stanislaus,099,539301,391,254,4,258,4
2020-04-23,Sutter,101,95872,28,24,0,24,2
2020-04-23,Tehama,103,63373,1,1,0,1,1
2020-04-23,Trinity,105,12862,0,0,0,0,0
2020-04-23,Tulare,107,460477,740,440,5,445,25
2020-04-23,Tuolumne,109,53932,3,2,0,2,0
2020-04-23,Ventura,111,848112,602,479,1,480,16
2020-04-23,Yolo,113,214977,178,151,0,151,8
2020-04-23,Yuba,115,75493,16,15,0,15,1
2020-04-22,Alameda,001,1643700,1608,1275,2,1277,46
2020-04-22,Alpine,003,1148,1,1,0,1,0
2020-04-22,Amador,005,37829,8,7,0,7,0
2020-04-22,Butte,007,227075,24,15,1,16,0
2020-04-22,Calaveras,009,45235,13,12,0,12,0
2020-04-22,Colusa,011,21464,3,3,0,3,0
2020-04-22,Contra Costa,013,1133247,906,772,0,772,22
2020-04-22,Del Norte,015,27424,2,2,0,2,0
2020-04-22,El Dorado,017,186661,55,39,0,39,0
2020-04-22,Fresno,019,978130,730,388,6,394,7
2020-04-22,Glenn,021,27897,5,3,0,3,0
2020-04-22,Humboldt,023,135768,59,53,0,53,0
2020-04-22,Imperial,025,180216,381,170,0,170,3
2020-04-22,Inyo,027,18085,19,18,0,18,0
2020-04-22,Kern,029,883053,950,713,1,714,4
2020-04-22,Kings,031,150075,105,28,1,29,1
2020-04-22,Lake,033,64148,6,6,0,6,0
2020-04-22,Lassen,035,31185,3,0,2,2,0
2020-04-22,Los Angeles,037,10098052,22656,16400,14,16414,715
2020-04-22,Madera,039,155013,75,37,1,38,2
2020-04-22,Marin,041,260295,223,202,1,203,11
2020-04-22,Mariposa,043,17540,6,0,0,0,0
2020-04-22,Mendocino,045,87422,6,5,0,5,0
2020-04-22,Merced,047,269075,147,92,0,92,3
2020-04-22,Modoc,049,8938,0,0,0,0,0
2020-04-22,Mono,051,14174,29,23,0,23,1
2020-04-22,Monterey,053,433212,226,154,0,154,4
2020-04-22,Napa,055,140530,67,58,0,58,2
2020-04-22,Nevada,057,99092,41,36,1,37,1
2020-04-22,Orange,059,3164182,2816,1785,23,1808,36
2020-04-22,Placer,061,380077,158,133,0,133,8
2020-04-22,Plumas,063,18699,4,4,0,4,0
2020-04-22,Riverside,065,2383286,4128,2822,14,2836,76
2020-04-22,Sacramento,067,1510023,1061,959,0,959,36
2020-04-22,San Benito,069,59416,46,43,0,43,2
2020-04-22,San Bernardino,071,2135413,2089,1564,1,1565,74
2020-04-22,San Diego,073,3302833,3567,2493,0,2493,96
2020-04-22,San Francisco,075,870044,1550,1255,0,1255,21
2020-04-22,San Joaquin,077,732212,538,462,3,465,20
2020-04-22,San Luis Obispo,079,281455,227,142,3,145,1
2020-04-22,San Mateo,081,765935,1267,945,2,947,40
2020-04-22,Santa Barbara,083,443738,485,437,2,439,6
2020-04-22,Santa Clara,085,1922200,2432,1969,5,1974,95
2020-04-22,Santa Cruz,087,273765,133,106,0,106,2
2020-04-22,Shasta,089,179085,34,26,0,26,3
2020-04-22,Sierra,091,2930,0,0,0,0,0
2020-04-22,Siskiyou,093,43540,5,5,0,5,0
2020-04-22,Solano,095,438530,247,195,0,195,3
2020-04-22,Sonoma,097,501317,235,185,0,185,1
2020-04-22,Stanislaus,099,539301,334,247,4,251,4
2020-04-22,Sutter,101,95872,28,22,0,22,2
2020-04-22,Tehama,103,63373,1,1,0,1,1
2020-04-22,Trinity,105,12862,0,0,0,0,0
2020-04-22,Tulare,107,460477,706,425,5,430,23
2020-04-22,Tuolumne,109,53932,3,2,0,2,0
2020-04-22,Ventura,111,848112,591,465,1,466,15
2020-04-22,Yolo,113,214977,177,147,0,147,8
2020-04-22,Yuba,115,75493,16,15,0,15,1
2020-04-21,Alameda,001,1643700,1578,1234,2,1236,46
2020-04-21,Alpine,003,1148,1,1,0,1,0
2020-04-21,Amador,005,37829,8,7,0,7,0
2020-04-21,Butte,007,227075,23,15,1,16,0
2020-04-21,Calaveras,009,45235,12,12,0,12,0
2020-04-21,Colusa,011,21464,3,3,0,3,0
2020-04-21,Contra Costa,013,1133247,892,766,0,766,22
2020-04-21,Del Norte,015,27424,2,2,0,2,0
2020-04-21,El Dorado,017,186661,54,36,0,36,0
2020-04-21,Fresno,019,978130,696,372,6,378,7
2020-04-21,Glenn,021,27897,5,3,0,3,0
2020-04-21,Humboldt,023,135768,58,53,0,53,0
2020-04-21,Imperial,025,180216,361,165,0,165,2
2020-04-21,Inyo,027,18085,19,18,0,18,0
2020-04-21,Kern,029,883053,908,676,1,677,4
2020-04-21,Kings,031,150075,91,28,1,29,1
2020-04-21,Lake,033,64148,6,6,0,6,0
2020-04-21,Lassen,035,31185,3,0,2,2,0
2020-04-21,Los Angeles,037,10098052,21795,15096,14,15110,650
2020-04-21,Madera,039,155013,75,37,1,38,2
2020-04-21,Marin,041,260295,217,202,1,203,10
2020-04-21,Mariposa,043,17540,5,0,0,0,0
2020-04-21,Mendocino,045,87422,6,5,0,5,0
2020-04-21,Merced,047,269075,143,89,0,89,3
2020-04-21,Modoc,049,8938,0,0,0,0,0
2020-04-21,Mono,051,14174,29,23,0,23,1
2020-04-21,Monterey,053,433212,223,151,0,151,4
2020-04-21,Napa,055,140530,66,58,0,58,2
2020-04-21,Nevada,057,99092,41,36,1,37,1
2020-04-21,Orange,059,3164182,2693,1717,22,1739,36
2020-04-21,Placer,061,380077,156,133,0,133,8
2020-04-21,Plumas,063,18699,4,4,0,4,0
2020-04-21,Riverside,065,2383286,3996,2631,14,2645,68
2020-04-21,Sacramento,067,1510023,1051,941,0,941,33
2020-04-21,San Benito,069,59416,44,43,0,43,2
2020-04-21,San Bernardino,071,2135413,2029,1499,1,1500,71
2020-04-21,San Diego,073,3302833,3411,2436,0,2436,87
2020-04-21,San Francisco,075,870044,1520,1232,0,1232,20
2020-04-21,San Joaquin,077,732212,528,447,3,450,20
2020-04-21,San Luis Obispo,079,281455,219,134,3,137,1
2020-04-21,San Mateo,081,765935,1221,933,2,935,34
2020-04-21,Santa Barbara,083,443738,476,414,2,416,5
2020-04-21,Santa Clara,085,1922200,2382,1943,5,1948,91
2020-04-21,Santa Cruz,087,273765,131,104,0,104,2
2020-04-21,Shasta,089,179085,33,26,0,26,3
2020-04-21,Sierra,091,2930,0,0,0,0,0
2020-04-21,Siskiyou,093,43540,5,5,0,5,0
2020-04-21,Solano,095,438530,239,193,0,193,3
2020-04-21,Sonoma,097,501317,225,182,0,182,1
2020-04-21,Stanislaus,099,539301,315,235,4,239,4
2020-04-21,Sutter,101,95872,28,22,0,22,2
2020-04-21,Tehama,103,63373,1,1,0,1,1
2020-04-21,Trinity,105,12862,0,0,0,0,0
2020-04-21,Tulare,107,460477,669,410,5,415,23
2020-04-21,Tuolumne,109,53932,3,2,0,2,0
2020-04-21,Ventura,111,848112,579,455,1,456,14
2020-04-21,Yolo,113,214977,175,143,0,143,8
2020-04-21,Yuba,115,75493,16,15,0,15,1
2020-04-20,Alameda,001,1643700,1545,1181,2,1183,42
2020-04-20,Alpine,003,1148,1,1,0,1,0
2020-04-20,Amador,005,37829,8,7,0,7,0
2020-04-20,Butte,007,227075,23,15,1,16,0
2020-04-20,Calaveras,009,45235,12,12,0,12,0
2020-04-20,Colusa,011,21464,3,3,0,3,0
2020-04-20,Contra Costa,013,1133247,882,753,0,753,22
2020-04-20,Del Norte,015,27424,2,2,0,2,0
2020-04-20,El Dorado,017,186661,54,36,0,36,0
2020-04-20,Fresno,019,978130,678,356,6,362,7
2020-04-20,Glenn,021,27897,4,3,0,3,0
2020-04-20,Humboldt,023,135768,58,53,0,53,0
2020-04-20,Imperial,025,180216,342,149,0,149,2
2020-04-20,Inyo,027,18085,19,17,0,17,0
2020-04-20,Kern,029,883053,876,651,1,652,3
2020-04-20,Kings,031,150075,80,19,1,20,1
2020-04-20,Lake,033,64148,6,6,0,6,0
2020-04-20,Lassen,035,31185,3,0,2,2,0
2020-04-20,Los Angeles,037,10098052,20879,13787,14,13801,608
2020-04-20,Madera,039,155013,74,35,1,36,2
2020-04-20,Marin,041,260295,213,200,1,201,10
2020-04-20,Mariposa,043,17540,5,0,0,0,0
2020-04-20,Mendocino,045,87422,6,5,0,5,0
2020-04-20,Merced,047,269075,136,88,0,88,3
2020-04-20,Modoc,049,8938,0,0,0,0,0
2020-04-20,Mono,051,14174,29,23,0,23,1
2020-04-20,Monterey,053,433212,214,147,0,147,4
2020-04-20,Napa,055,140530,66,55,0,55,2
2020-04-20,Nevada,057,99092,41,34,1,35,1
2020-04-20,Orange,059,3164182,2609,1679,22,1701,33
2020-04-20,Placer,061,380077,155,132,0,132,8
2020-04-20,Plumas,063,18699,4,4,0,4,0
2020-04-20,Riverside,065,2383286,3871,2477,14,2491,61
2020-04-20,Sacramento,067,1510023,1041,924,0,924,32
2020-04-20,San Benito,069,59416,44,43,0,43,2
2020-04-20,San Bernardino,071,2135413,1942,1344,1,1345,63
2020-04-20,San Diego,073,3302833,3269,2327,0,2327,72
2020-04-20,San Francisco,075,870044,1488,1223,0,1223,19
2020-04-20,San Joaquin,077,732212,524,422,3,425,17
2020-04-20,San Luis Obispo,079,281455,205,132,3,135,1
2020-04-20,San Mateo,081,765935,1198,890,2,892,31
2020-04-20,Santa Barbara,083,443738,469,388,2,390,4
2020-04-20,Santa Clara,085,1922200,2351,1920,5,1925,84
2020-04-20,Santa Cruz,087,273765,129,102,0,102,2
2020-04-20,Shasta,089,179085,33,26,0,26,3
2020-04-20,Sierra,091,2930,0,0,0,0,0
2020-04-20,Siskiyou,093,43540,5,5,0,5,0
2020-04-20,Solano,095,438530,236,185,0,185,2
2020-04-20,Sonoma,097,501317,217,178,0,178,1
2020-04-20,Stanislaus,099,539301,301,228,4,232,3
2020-04-20,Sutter,101,95872,27,22,0,22,2
2020-04-20,Tehama,103,63373,1,1,0,1,1
2020-04-20,Trinity,105,12862,0,0,0,0,0
2020-04-20,Tulare,107,460477,659,401,5,406,20
2020-04-20,Tuolumne,109,53932,3,2,0,2,0
2020-04-20,Ventura,111,848112,565,426,1,427,13
2020-04-20,Yolo,113,214977,174,125,0,125,5
2020-04-20,Yuba,115,75493,16,15,0,15,1
2020-04-19,Alameda,001,1643700,1495,1134,2,1136,41
2020-04-19,Alpine,003,1148,1,1,0,1,0
2020-04-19,Amador,005,37829,7,7,0,7,0
2020-04-19,Butte,007,227075,22,15,1,16,0
2020-04-19,Calaveras,009,45235,12,12,0,12,0
2020-04-19,Colusa,011,21464,3,3,0,3,0
2020-04-19,Contra Costa,013,1133247,866,731,0,731,20
2020-04-19,Del Norte,015,27424,2,2,0,2,0
2020-04-19,El Dorado,017,186661,54,36,0,36,0
2020-04-19,Fresno,019,978130,642,326,6,332,7
2020-04-19,Glenn,021,27897,4,3,0,3,0
2020-04-19,Humboldt,023,135768,58,53,0,53,0
2020-04-19,Imperial,025,180216,316,144,0,144,2
2020-04-19,Inyo,027,18085,19,17,0,17,0
2020-04-19,Kern,029,883053,851,629,1,630,3
2020-04-19,Kings,031,150075,70,17,1,18,1
2020-04-19,Lake,033,64148,6,6,0,6,0
2020-04-19,Lassen,035,31185,3,0,2,2,0
2020-04-19,Los Angeles,037,10098052,19876,12299,14,12313,589
2020-04-19,Madera,039,155013,72,34,1,35,2
2020-04-19,Marin,041,260295,212,194,1,195,10
2020-04-19,Mariposa,043,17540,2,0,0,0,0
2020-04-19,Mendocino,045,87422,6,4,0,4,0
2020-04-19,Merced,047,269075,131,85,0,85,3
2020-04-19,Modoc,049,8938,0,0,0,0,0
2020-04-19,Mono,051,14174,29,23,0,23,1
2020-04-19,Monterey,053,433212,205,140,0,140,4
2020-04-19,Napa,055,140530,64,49,0,49,2
2020-04-19,Nevada,057,99092,40,34,1,35,1
2020-04-19,Orange,059,3164182,2512,1591,21,1612,32
2020-04-19,Placer,061,380077,154,131,0,131,8
2020-04-19,Plumas,063,18699,4,4,0,4,0
2020-04-19,Riverside,065,2383286,3728,2316,14,2330,56
2020-04-19,Sacramento,067,1510023,1014,912,0,912,32
2020-04-19,San Benito,069,59416,42,40,0,40,2
2020-04-19,San Bernardino,071,2135413,1879,1262,1,1263,58
2020-04-19,San Diego,073,3302833,3102,2270,0,2270,71
2020-04-19,San Francisco,075,870044,1455,1153,0,1153,19
2020-04-19,San Joaquin,077,732212,506,404,3,407,17
2020-04-19,San Luis Obispo,079,281455,200,132,3,135,1
2020-04-19,San Mateo,081,765935,1162,845,2,847,31
2020-04-19,Santa Barbara,083,443738,462,377,2,379,3
2020-04-19,Santa Clara,085,1922200,2306,1878,5,1883,81
2020-04-19,Santa Cruz,087,273765,126,98,0,98,2
2020-04-19,Shasta,089,179085,31,26,0,26,3
2020-04-19,Sierra,091,2930,0,0,0,0,0
2020-04-19,Siskiyou,093,43540,5,5,0,5,0
2020-04-19,Solano,095,438530,228,174,0,174,2
2020-04-19,Sonoma,097,501317,211,172,0,172,1
2020-04-19,Stanislaus,099,539301,293,221,4,225,3
2020-04-19,Sutter,101,95872,26,21,0,21,2
2020-04-19,Tehama,103,63373,1,1,0,1,1
2020-04-19,Trinity,105,12862,0,0,0,0,0
2020-04-19,Tulare,107,460477,613,391,5,396,17
2020-04-19,Tuolumne,109,53932,3,2,0,2,0
2020-04-19,Ventura,111,848112,557,418,1,419,13
2020-04-19,Yolo,113,214977,174,120,0,120,5
2020-04-19,Yuba,115,75493,16,15,0,15,1
2020-04-18,Alameda,001,1643700,1470,1085,2,1087,40
2020-04-18,Alpine,003,1148,1,1,0,1,0
2020-04-18,Amador,005,37829,7,7,0,7,0
2020-04-18,Butte,007,227075,21,15,1,16,0
2020-04-18,Calaveras,009,45235,12,12,0,12,0
2020-04-18,Colusa,011,21464,3,3,0,3,0
2020-04-18,Contra Costa,013,1133247,854,721,0,721,17
2020-04-18,Del Norte,015,27424,2,2,0,2,0
2020-04-18,El Dorado,017,186661,54,36,0,36,0
2020-04-18,Fresno,019,978130,622,319,6,325,7
2020-04-18,Glenn,021,27897,4,3,0,3,0
2020-04-18,Humboldt,023,135768,58,52,0,52,0
2020-04-18,Imperial,025,180216,307,137,0,137,2
2020-04-18,Inyo,027,18085,19,17,0,17,0
2020-04-18,Kern,029,883053,829,626,1,627,3
2020-04-18,Kings,031,150075,69,17,1,18,1
2020-04-18,Lake,033,64148,6,6,0,6,0
2020-04-18,Lassen,035,31185,3,0,2,2,0
2020-04-18,Los Angeles,037,10098052,19346,11984,14,11998,566
2020-04-18,Madera,039,155013,71,34,1,35,2
2020-04-18,Marin,041,260295,210,193,1,194,10
2020-04-18,Mariposa,043,17540,2,0,0,0,0
2020-04-18,Mendocino,045,87422,6,4,0,4,0
2020-04-18,Merced,047,269075,129,82,0,82,3
2020-04-18,Modoc,049,8938,0,0,0,0,0
2020-04-18,Mono,051,14174,29,22,0,22,1
2020-04-18,Monterey,053,433212,201,135,0,135,3
2020-04-18,Napa,055,140530,64,49,0,49,2
2020-04-18,Nevada,057,99092,39,34,1,35,1
2020-04-18,Orange,059,3164182,2448,1569,20,1589,32
2020-04-18,Placer,061,380077,152,130,0,130,8
2020-04-18,Plumas,063,18699,4,4,0,4,0
2020-04-18,Riverside,065,2383286,3653,2257,14,2271,56
2020-04-18,Sacramento,067,1510023,1002,901,0,901,32
2020-04-18,San Benito,069,59416,42,40,0,40,2
2020-04-18,San Bernardino,071,2135413,1834,1255,1,1256,58
2020-04-18,San Diego,073,3302833,3000,2215,0,2215,71
2020-04-18,San Francisco,075,870044,1416,1144,0,1144,19
2020-04-18,San Joaquin,077,732212,497,392,3,395,17
2020-04-18,San Luis Obispo,079,281455,196,129,3,132,1
2020-04-18,San Mateo,081,765935,1140,821,2,823,31
2020-04-18,Santa Barbara,083,443738,456,372,2,374,3
2020-04-18,Santa Clara,085,1922200,2273,1862,5,1867,79
2020-04-18,Santa Cruz,087,273765,124,96,0,96,2
2020-04-18,Shasta,089,179085,31,26,0,26,3
2020-04-18,Sierra,091,2930,0,0,0,0,0
2020-04-18,Siskiyou,093,43540,5,5,0,5,0
2020-04-18,Solano,095,438530,225,175,0,175,2
2020-04-18,Sonoma,097,501317,207,168,0,168,1
2020-04-18,Stanislaus,099,539301,285,216,4,220,3
2020-04-18,Sutter,101,95872,26,21,0,21,2
2020-04-18,Tehama,103,63373,1,1,0,1,1
2020-04-18,Trinity,105,12862,0,0,0,0,0
2020-04-18,Tulare,107,460477,602,385,5,390,17
2020-04-18,Tuolumne,109,53932,3,2,0,2,0
2020-04-18,Ventura,111,848112,549,416,1,417,13
2020-04-18,Yolo,113,214977,172,118,0,118,5
2020-04-18,Yuba,115,75493,16,14,0,14,1
2020-04-17,Alameda,001,1643700,1414,1043,1,1044,40
2020-04-17,Alpine,003,1148,1,1,0,1,0
2020-04-17,Amador,005,37829,7,7,0,7,0
2020-04-17,Butte,007,227075,21,15,1,16,0
2020-04-17,Calaveras,009,45235,12,11,0,11,0
2020-04-17,Colusa,011,21464,3,3,0,3,0
2020-04-17,Contra Costa,013,1133247,843,687,0,687,15
2020-04-17,Del Norte,015,27424,2,2,0,2,0
2020-04-17,El Dorado,017,186661,54,35,0,35,0
2020-04-17,Fresno,019,978130,600,315,6,321,7
2020-04-17,Glenn,021,27897,4,3,0,3,0
2020-04-17,Humboldt,023,135768,57,52,0,52,0
2020-04-17,Imperial,025,180216,298,135,0,135,2
2020-04-17,Inyo,027,18085,19,17,0,17,0
2020-04-17,Kern,029,883053,809,612,1,613,3
2020-04-17,Kings,031,150075,67,15,1,16,1
2020-04-17,Lake,033,64148,6,6,0,6,0
2020-04-17,Lassen,035,31185,3,0,2,2,0
2020-04-17,Los Angeles,037,10098052,18707,11354,14,11368,489
2020-04-17,Madera,039,155013,71,34,1,35,2
2020-04-17,Marin,041,260295,207,189,1,190,10
2020-04-17,Mariposa,043,17540,1,0,0,0,0
2020-04-17,Mendocino,045,87422,6,4,0,4,0
2020-04-17,Merced,047,269075,128,80,0,80,3
2020-04-17,Modoc,049,8938,0,0,0,0,0
2020-04-17,Mono,051,14174,29,22,0,22,1
2020-04-17,Monterey,053,433212,196,119,0,119,3
2020-04-17,Napa,055,140530,62,46,0,46,2
2020-04-17,Nevada,057,99092,38,34,1,35,1
2020-04-17,Orange,059,3164182,2397,1496,20,1516,31
2020-04-17,Placer,061,380077,152,130,0,130,8
2020-04-17,Plumas,063,18699,4,4,0,4,0
2020-04-17,Riverside,065,2383286,3526,2080,14,2094,50
2020-04-17,Sacramento,067,1510023,995,882,0,882,32
2020-04-17,San Benito,069,59416,42,38,0,38,2
2020-04-17,San Bernardino,071,2135413,1795,1229,1,1230,57
2020-04-17,San Diego,073,3302833,2910,2160,0,2160,70
2020-04-17,San Francisco,075,870044,1391,1090,0,1090,19
2020-04-17,San Joaquin,077,732212,486,356,3,359,17
2020-04-17,San Luis Obispo,079,281455,189,116,3,119,1
2020-04-17,San Mateo,081,765935,1124,768,2,770,31
2020-04-17,Santa Barbara,083,443738,451,349,2,351,3
2020-04-17,Santa Clara,085,1922200,2237,1834,5,1839,74
2020-04-17,Santa Cruz,087,273765,123,94,0,94,2
2020-04-17,Shasta,089,179085,31,26,0,26,3
2020-04-17,Sierra,091,2930,0,0,0,0,0
2020-04-17,Siskiyou,093,43540,5,5,0,5,0
2020-04-17,Solano,095,438530,224,173,0,173,2
2020-04-17,Sonoma,097,501317,204,167,0,167,1
2020-04-17,Stanislaus,099,539301,283,201,4,205,3
2020-04-17,Sutter,101,95872,26,20,0,20,2
2020-04-17,Tehama,103,63373,1,1,0,1,1
2020-04-17,Trinity,105,12862,0,0,0,0,0
2020-04-17,Tulare,107,460477,595,370,5,375,17
2020-04-17,Tuolumne,109,53932,3,2,0,2,0
2020-04-17,Ventura,111,848112,544,398,1,399,13
2020-04-17,Yolo,113,214977,171,117,0,117,5
2020-04-17,Yuba,115,75493,16,14,0,14,1
2020-04-16,Alameda,001,1643700,1380,981,1,982,39
2020-04-16,Alpine,003,1148,1,1,0,1,0
2020-04-16,Amador,005,37829,7,7,0,7,0
2020-04-16,Butte,007,227075,20,15,1,16,0
2020-04-16,Calaveras,009,45235,12,10,0,10,0
2020-04-16,Colusa,011,21464,3,3,0,3,0
2020-04-16,Contra Costa,013,1133247,829,675,0,675,14
2020-04-16,Del Norte,015,27424,2,2,0,2,0
2020-04-16,El Dorado,017,186661,53,34,0,34,0
2020-04-16,Fresno,019,978130,570,289,6,295,7
2020-04-16,Glenn,021,27897,4,3,0,3,0
2020-04-16,Humboldt,023,135768,57,47,0,47,0
2020-04-16,Imperial,025,180216,283,132,0,132,2
2020-04-16,Inyo,027,18085,17,17,0,17,0
2020-04-16,Kern,029,883053,782,587,1,588,3
2020-04-16,Kings,031,150075,63,12,1,13,1
2020-04-16,Lake,033,64148,6,6,0,6,0
2020-04-16,Lassen,035,31185,3,0,2,2,0
2020-04-16,Los Angeles,037,10098052,17815,10786,14,10800,447
2020-04-16,Madera,039,155013,69,34,1,35,2
2020-04-16,Marin,041,260295,203,170,1,171,10
2020-04-16,Mariposa,043,17540,1,1,0,1,0
2020-04-16,Mendocino,045,87422,6,4,0,4,0
2020-04-16,Merced,047,269075,122,76,0,76,3
2020-04-16,Modoc,049,8938,0,0,0,0,0
2020-04-16,Mono,051,14174,29,22,0,22,1
2020-04-16,Monterey,053,433212,193,116,0,116,3
2020-04-16,Napa,055,140530,59,44,0,44,2
2020-04-16,Nevada,057,99092,38,34,1,35,1
2020-04-16,Orange,059,3164182,2332,1439,19,1458,28
2020-04-16,Placer,061,380077,150,129,0,129,7
2020-04-16,Plumas,063,18699,4,4,0,4,0
2020-04-16,Riverside,065,2383286,3406,1913,14,1927,45
2020-04-16,Sacramento,067,1510023,987,865,0,865,32
2020-04-16,San Benito,069,59416,42,36,0,36,2
2020-04-16,San Bernardino,071,2135413,1714,1143,0,1143,54
2020-04-16,San Diego,073,3302833,2802,2089,0,2089,63
2020-04-16,San Francisco,075,870044,1347,1039,0,1039,16
2020-04-16,San Joaquin,077,732212,471,345,3,348,17
2020-04-16,San Luis Obispo,079,281455,185,113,3,116,1
2020-04-16,San Mateo,081,765935,1095,745,2,747,29
2020-04-16,Santa Barbara,083,443738,440,331,2,333,3
2020-04-16,Santa Clara,085,1922200,2200,1789,5,1794,70
2020-04-16,Santa Cruz,087,273765,121,90,0,90,2
2020-04-16,Shasta,089,179085,31,25,0,25,3
2020-04-16,Sierra,091,2930,0,0,0,0,0
2020-04-16,Siskiyou,093,43540,5,5,0,5,0
2020-04-16,Solano,095,438530,221,162,0,162,2
2020-04-16,Sonoma,097,501317,199,145,0,145,1
2020-04-16,Stanislaus,099,539301,280,185,4,189,3
2020-04-16,Sutter,101,95872,25,21,0,21,2
2020-04-16,Tehama,103,63373,1,1,0,1,1
2020-04-16,Trinity,105,12862,0,0,0,0,0
2020-04-16,Tulare,107,460477,578,305,5,310,16
2020-04-16,Tuolumne,109,53932,3,1,0,1,0
2020-04-16,Ventura,111,848112,532,384,1,385,13
2020-04-16,Yolo,113,214977,169,98,0,98,4
2020-04-16,Yuba,115,75493,15,14,0,14,1
2020-04-15,Alameda,001,1643700,1330,915,1,916,38
2020-04-15,Alpine,003,1148,1,1,0,1,0
2020-04-15,Amador,005,37829,7,7,0,7,0
2020-04-15,Butte,007,227075,20,14,1,15,0
2020-04-15,Calaveras,009,45235,11,9,0,9,0
2020-04-15,Colusa,011,21464,3,3,0,3,0
2020-04-15,Contra Costa,013,1133247,807,645,0,645,14
2020-04-15,Del Norte,015,27424,2,2,0,2,0
2020-04-15,El Dorado,017,186661,51,33,0,33,0
2020-04-15,Fresno,019,978130,544,264,6,270,7
2020-04-15,Glenn,021,27897,4,3,0,3,0
2020-04-15,Humboldt,023,135768,57,47,0,47,0
2020-04-15,Imperial,025,180216,257,115,0,115,2
2020-04-15,Inyo,027,18085,17,12,0,12,0
2020-04-15,Kern,029,883053,760,500,1,501,3
2020-04-15,Kings,031,150075,59,12,1,13,1
2020-04-15,Lake,033,64148,6,4,0,4,0
2020-04-15,Lassen,035,31185,3,0,2,2,0
2020-04-15,Los Angeles,037,10098052,16991,10416,14,10430,394
2020-04-15,Madera,039,155013,69,30,1,31,2
2020-04-15,Marin,041,260295,200,162,1,163,10
2020-04-15,Mariposa,043,17540,0,0,0,0,0
2020-04-15,Mendocino,045,87422,5,4,0,4,0
2020-04-15,Merced,047,269075,120,74,0,74,3
2020-04-15,Modoc,049,8938,0,0,0,0,0
2020-04-15,Mono,051,14174,29,22,0,22,1
2020-04-15,Monterey,053,433212,185,106,0,106,3
2020-04-15,Napa,055,140530,56,34,0,34,2
2020-04-15,Nevada,057,99092,37,34,1,35,1
2020-04-15,Orange,059,3164182,2229,1377,19,1396,24
2020-04-15,Placer,061,380077,149,123,0,123,6
2020-04-15,Plumas,063,18699,4,4,0,4,0
2020-04-15,Riverside,065,2383286,3211,1723,14,1737,42
2020-04-15,Sacramento,067,1510023,978,839,0,839,32
2020-04-15,San Benito,069,59416,42,34,0,34,2
2020-04-15,San Bernardino,071,2135413,1644,1063,0,1063,45
2020-04-15,San Diego,073,3302833,2714,2014,0,2014,60
2020-04-15,San Francisco,075,870044,1311,1006,0,1006,16
2020-04-15,San Joaquin,077,732212,463,329,3,332,17
2020-04-15,San Luis Obispo,079,281455,177,112,3,115,1
2020-04-15,San Mateo,081,765935,1046,707,2,709,28
2020-04-15,Santa Barbara,083,443738,424,317,2,319,2
2020-04-15,Santa Clara,085,1922200,2161,1692,5,1697,69
2020-04-15,Santa Cruz,087,273765,117,92,0,92,2
2020-04-15,Shasta,089,179085,31,25,0,25,3
2020-04-15,Sierra,091,2930,0,0,0,0,0
2020-04-15,Siskiyou,093,43540,5,5,0,5,0
2020-04-15,Solano,095,438530,216,153,0,153,2
2020-04-15,Sonoma,097,501317,197,140,0,140,1
2020-04-15,Stanislaus,099,539301,273,174,4,178,3
2020-04-15,Sutter,101,95872,25,19,0,19,2
2020-04-15,Tehama,103,63373,1,1,0,1,1
2020-04-15,Trinity,105,12862,0,0,0,0,0
2020-04-15,Tulare,107,460477,560,289,5,294,14
2020-04-15,Tuolumne,109,53932,3,1,0,1,0
2020-04-15,Ventura,111,848112,517,365,1,366,13
2020-04-15,Yolo,113,214977,162,93,0,93,3
2020-04-15,Yuba,115,75493,15,15,0,15,1
2020-04-14,Alameda,001,1643700,1285,843,1,844,30
2020-04-14,Alpine,003,1148,1,1,0,1,0
2020-04-14,Amador,005,37829,7,6,0,6,0
2020-04-14,Butte,007,227075,20,13,1,14,0
2020-04-14,Calaveras,009,45235,11,5,0,5,0
2020-04-14,Colusa,011,21464,3,3,0,3,0
2020-04-14,Contra Costa,013,1133247,795,617,0,617,12
2020-04-14,Del Norte,015,27424,2,2,0,2,0
2020-04-14,El Dorado,017,186661,51,30,0,30,0
2020-04-14,Fresno,019,978130,521,244,6,250,6
2020-04-14,Glenn,021,27897,4,3,0,3,0
2020-04-14,Humboldt,023,135768,57,44,0,44,0
2020-04-14,Imperial,025,180216,237,86,0,86,2
2020-04-14,Inyo,027,18085,17,12,0,12,0
2020-04-14,Kern,029,883053,736,453,1,454,3
2020-04-14,Kings,031,150075,58,12,1,13,1
2020-04-14,Lake,033,64148,6,3,0,3,0
2020-04-14,Lassen,035,31185,3,0,2,2,0
2020-04-14,Los Angeles,037,10098052,16096,9948,13,9961,357
2020-04-14,Madera,039,155013,68,29,1,30,2
2020-04-14,Marin,041,260295,196,147,1,148,9
2020-04-14,Mariposa,043,17540,0,0,0,0,0
2020-04-14,Mendocino,045,87422,5,4,0,4,0
2020-04-14,Merced,047,269075,113,61,0,61,3
2020-04-14,Modoc,049,8938,0,0,0,0,0
2020-04-14,Mono,051,14174,29,22,0,22,1
2020-04-14,Monterey,053,433212,180,98,0,98,3
2020-04-14,Napa,055,140530,56,33,0,33,2
2020-04-14,Nevada,057,99092,37,34,1,35,1
2020-04-14,Orange,059,3164182,2127,1362,19,1381,24
2020-04-14,Placer,061,380077,148,117,0,117,5
2020-04-14,Plumas,063,18699,4,3,0,3,0
2020-04-14,Riverside,065,2383286,3076,1467,14,1481,40
2020-04-14,Sacramento,067,1510023,969,737,0,737,29
2020-04-14,San Benito,069,59416,39,34,0,34,2
2020-04-14,San Bernardino,071,2135413,1589,933,0,933,37
2020-04-14,San Diego,073,3302833,2619,1932,0,1932,53
2020-04-14,San Francisco,075,870044,1257,968,0,968,14
2020-04-14,San Joaquin,077,732212,453,280,3,283,17
2020-04-14,San Luis Obispo,079,281455,174,109,3,112,1
2020-04-14,San Mateo,081,765935,1012,681,2,683,28
2020-04-14,Santa Barbara,083,443738,400,292,2,294,2
2020-04-14,Santa Clara,085,1922200,2128,1561,5,1566,63
2020-04-14,Santa Cruz,087,273765,109,84,0,84,2
2020-04-14,Shasta,089,179085,31,24,0,24,3
2020-04-14,Sierra,091,2930,0,0,0,0,0
2020-04-14,Siskiyou,093,43540,5,5,0,5,0
2020-04-14,Solano,095,438530,213,140,0,140,2
2020-04-14,Sonoma,097,501317,193,133,0,133,1
2020-04-14,Stanislaus,099,539301,260,136,4,140,3
2020-04-14,Sutter,101,95872,24,19,0,19,2
2020-04-14,Tehama,103,63373,1,1,0,1,1
2020-04-14,Trinity,105,12862,0,0,0,0,0
2020-04-14,Tulare,107,460477,536,228,5,233,12
2020-04-14,Tuolumne,109,53932,3,0,0,0,0
2020-04-14,Ventura,111,848112,504,328,1,329,11
2020-04-14,Yolo,113,214977,159,81,0,81,3
2020-04-14,Yuba,115,75493,14,14,0,14,1
2020-04-13,Alameda,001,1643700,1246,821,1,822,23
2020-04-13,Alpine,003,1148,1,1,0,1,0
2020-04-13,Amador,005,37829,7,6,0,6,0
2020-04-13,Butte,007,227075,19,13,1,14,0
2020-04-13,Calaveras,009,45235,10,5,0,5,0
2020-04-13,Colusa,011,21464,3,3,0,3,0
2020-04-13,Contra Costa,013,1133247,779,569,0,569,12
2020-04-13,Del Norte,015,27424,2,2,0,2,0
2020-04-13,El Dorado,017,186661,49,29,0,29,0
2020-04-13,Fresno,019,978130,499,205,5,210,4
2020-04-13,Glenn,021,27897,4,3,0,3,0
2020-04-13,Humboldt,023,135768,57,44,0,44,0
2020-04-13,Imperial,025,180216,219,82,0,82,2
2020-04-13,Inyo,027,18085,17,12,0,12,0
2020-04-13,Kern,029,883053,711,346,1,347,3
2020-04-13,Kings,031,150075,54,9,1,10,0
2020-04-13,Lake,033,64148,6,3,0,3,0
2020-04-13,Lassen,035,31185,3,0,2,2,0
2020-04-13,Los Angeles,037,10098052,15378,9367,13,9380,317
2020-04-13,Madera,039,155013,66,29,1,30,2
2020-04-13,Marin,041,260295,192,144,1,145,6
2020-04-13,Mariposa,043,17540,0,0,0,0,0
2020-04-13,Mendocino,045,87422,5,4,0,4,0
2020-04-13,Merced,047,269075,112,60,0,60,3
2020-04-13,Modoc,049,8938,0,0,0,0,0
2020-04-13,Mono,051,14174,29,21,0,21,1
2020-04-13,Monterey,053,433212,173,86,0,86,3
2020-04-13,Napa,055,140530,55,30,0,30,2
2020-04-13,Nevada,057,99092,37,24,1,25,1
2020-04-13,Orange,059,3164182,2054,1313,19,1332,21
2020-04-13,Placer,061,380077,147,116,0,116,5
2020-04-13,Plumas,063,18699,4,3,0,3,0
2020-04-13,Riverside,065,2383286,2935,1460,13,1473,35
2020-04-13,Sacramento,067,1510023,957,723,0,723,25
2020-04-13,San Benito,069,59416,38,33,0,33,2
2020-04-13,San Bernardino,071,2135413,1514,920,0,920,30
2020-04-13,San Diego,073,3302833,2536,1849,0,1849,47
2020-04-13,San Francisco,075,870044,1219,948,0,948,12
2020-04-13,San Joaquin,077,732212,438,255,3,258,16
2020-04-13,San Luis Obispo,079,281455,169,106,3,109,1
2020-04-13,San Mateo,081,765935,972,679,2,681,25
2020-04-13,Santa Barbara,083,443738,381,271,1,272,2
2020-04-13,Santa Clara,085,1922200,2082,1540,5,1545,58
2020-04-13,Santa Cruz,087,273765,103,82,0,82,1
2020-04-13,Shasta,089,179085,30,24,0,24,3
2020-04-13,Sierra,091,2930,0,0,0,0,0
2020-04-13,Siskiyou,093,43540,5,5,0,5,0
2020-04-13,Solano,095,438530,210,136,0,136,2
2020-04-13,Sonoma,097,501317,186,133,0,133,1
2020-04-13,Stanislaus,099,539301,254,130,4,134,1
2020-04-13,Sutter,101,95872,24,18,0,18,2
2020-04-13,Tehama,103,63373,1,1,0,1,0
2020-04-13,Trinity,105,12862,0,0,0,0,0
2020-04-13,Tulare,107,460477,500,185,5,190,11
2020-04-13,Tuolumne,109,53932,3,0,0,0,0
2020-04-13,Ventura,111,848112,483,309,0,309,9
2020-04-13,Yolo,113,214977,153,81,0,81,3
2020-04-13,Yuba,115,75493,14,13,0,13,1
2020-04-12,Alameda,001,1643700,1203,774,1,775,23
2020-04-12,Alpine,003,1148,1,1,0,1,0
2020-04-12,Amador,005,37829,7,6,0,6,0
2020-04-12,Butte,007,227075,19,13,1,14,0
2020-04-12,Calaveras,009,45235,10,5,0,5,0
2020-04-12,Colusa,011,21464,3,3,0,3,0
2020-04-12,Contra Costa,013,1133247,766,553,0,553,12
2020-04-12,Del Norte,015,27424,2,2,0,2,0
2020-04-12,El Dorado,017,186661,49,28,0,28,0
2020-04-12,Fresno,019,978130,470,205,5,210,4
2020-04-12,Glenn,021,27897,4,3,0,3,0
2020-04-12,Humboldt,023,135768,57,43,0,43,0
2020-04-12,Imperial,025,180216,196,78,0,78,2
2020-04-12,Inyo,027,18085,15,12,0,12,0
2020-04-12,Kern,029,883053,679,319,0,319,3
2020-04-12,Kings,031,150075,52,9,1,10,0
2020-04-12,Lake,033,64148,6,3,0,3,0
2020-04-12,Lassen,035,31185,3,0,2,2,0
2020-04-12,Los Angeles,037,10098052,14658,9133,13,9146,294
2020-04-12,Madera,039,155013,65,29,1,30,2
2020-04-12,Marin,041,260295,181,138,1,139,6
2020-04-12,Mariposa,043,17540,0,0,0,0,0
2020-04-12,Mendocino,045,87422,5,4,0,4,0
2020-04-12,Merced,047,269075,106,58,0,58,3
2020-04-12,Modoc,049,8938,0,0,0,0,0
2020-04-12,Mono,051,14174,29,20,0,20,1
2020-04-12,Monterey,053,433212,159,85,0,85,3
2020-04-12,Napa,055,140530,53,29,0,29,2
2020-04-12,Nevada,057,99092,37,24,1,25,1
2020-04-12,Orange,059,3164182,1994,1283,18,1301,21
2020-04-12,Placer,061,380077,146,114,0,114,4
2020-04-12,Plumas,063,18699,4,3,0,3,0
2020-04-12,Riverside,065,2383286,2753,1330,13,1343,34
2020-04-12,Sacramento,067,1510023,920,689,0,689,25
2020-04-12,San Benito,069,59416,36,33,0,33,2
2020-04-12,San Bernardino,071,2135413,1438,827,0,827,30
2020-04-12,San Diego,073,3302833,2446,1806,0,1806,45
2020-04-12,San Francisco,075,870044,1192,886,0,886,11
2020-04-12,San Joaquin,077,732212,420,246,3,249,15
2020-04-12,San Luis Obispo,079,281455,166,102,2,104,1
2020-04-12,San Mateo,081,765935,946,664,2,666,25
2020-04-12,Santa Barbara,083,443738,362,261,1,262,2
2020-04-12,Santa Clara,085,1922200,2054,1461,5,1466,53
2020-04-12,Santa Cruz,087,273765,102,80,0,80,1
2020-04-12,Shasta,089,179085,30,24,0,24,3
2020-04-12,Sierra,091,2930,0,0,0,0,0
2020-04-12,Siskiyou,093,43540,5,5,0,5,0
2020-04-12,Solano,095,438530,204,136,0,136,2
2020-04-12,Sonoma,097,501317,183,131,0,131,1
2020-04-12,Stanislaus,099,539301,246,117,4,121,1
2020-04-12,Sutter,101,95872,23,18,0,18,2
2020-04-12,Tehama,103,63373,1,1,0,1,0
2020-04-12,Trinity,105,12862,0,0,0,0,0
2020-04-12,Tulare,107,460477,488,166,5,171,11
2020-04-12,Tuolumne,109,53932,3,0,0,0,0
2020-04-12,Ventura,111,848112,473,306,0,306,9
2020-04-12,Yolo,113,214977,139,67,0,67,3
2020-04-12,Yuba,115,75493,14,13,0,13,1
2020-04-11,Alameda,001,1643700,1162,751,1,752,23
2020-04-11,Alpine,003,1148,1,1,0,1,0
2020-04-11,Amador,005,37829,7,6,0,6,0
2020-04-11,Butte,007,227075,19,13,1,14,0
2020-04-11,Calaveras,009,45235,10,5,0,5,0
2020-04-11,Colusa,011,21464,3,3,0,3,0
2020-04-11,Contra Costa,013,1133247,757,550,0,550,12
2020-04-11,Del Norte,015,27424,2,2,0,2,0
2020-04-11,El Dorado,017,186661,48,29,0,29,0
2020-04-11,Fresno,019,978130,460,201,5,206,4
2020-04-11,Glenn,021,27897,4,3,0,3,0
2020-04-11,Humboldt,023,135768,57,38,0,38,0
2020-04-11,Imperial,025,180216,186,78,0,78,2
2020-04-11,Inyo,027,18085,15,12,0,12,0
2020-04-11,Kern,029,883053,651,304,0,304,3
2020-04-11,Kings,031,150075,49,9,1,10,0
2020-04-11,Lake,033,64148,6,3,0,3,0
2020-04-11,Lassen,035,31185,3,0,2,2,0
2020-04-11,Los Angeles,037,10098052,14183,8823,13,8836,262
2020-04-11,Madera,039,155013,64,29,1,30,2
2020-04-11,Marin,041,260295,178,136,1,137,6
2020-04-11,Mariposa,043,17540,0,0,0,0,0
2020-04-11,Mendocino,045,87422,5,4,0,4,0
2020-04-11,Merced,047,269075,103,59,0,59,3
2020-04-11,Modoc,049,8938,0,0,0,0,0
2020-04-11,Mono,051,14174,29,20,0,20,1
2020-04-11,Monterey,053,433212,153,78,0,78,3
2020-04-11,Napa,055,140530,53,29,0,29,2
2020-04-11,Nevada,057,99092,37,24,1,25,1
2020-04-11,Orange,059,3164182,1932,1267,18,1285,21
2020-04-11,Placer,061,380077,146,113,0,113,4
2020-04-11,Plumas,063,18699,4,3,0,3,0
2020-04-11,Riverside,065,2383286,2674,1260,13,1273,33
2020-04-11,Sacramento,067,1510023,909,685,0,685,25
2020-04-11,San Benito,069,59416,36,33,0,33,2
2020-04-11,San Bernardino,071,2135413,1402,826,0,826,28
2020-04-11,San Diego,073,3302833,2380,1763,0,1763,45
2020-04-11,San Francisco,075,870044,1170,860,0,860,11
2020-04-11,San Joaquin,077,732212,415,244,3,247,15
2020-04-11,San Luis Obispo,079,281455,166,100,1,101,1
2020-04-11,San Mateo,081,765935,934,662,2,664,25
2020-04-11,Santa Barbara,083,443738,354,258,1,259,2
2020-04-11,Santa Clara,085,1922200,1995,1441,5,1446,51
2020-04-11,Santa Cruz,087,273765,102,79,0,79,1
2020-04-11,Shasta,089,179085,30,24,0,24,3
2020-04-11,Sierra,091,2930,0,0,0,0,0
2020-04-11,Siskiyou,093,43540,5,5,0,5,0
2020-04-11,Solano,095,438530,200,138,0,138,2
2020-04-11,Sonoma,097,501317,181,131,0,131,1
2020-04-11,Stanislaus,099,539301,238,119,3,122,1
2020-04-11,Sutter,101,95872,23,18,0,18,2
2020-04-11,Tehama,103,63373,1,1,0,1,0
2020-04-11,Trinity,105,12862,0,0,0,0,0
2020-04-11,Tulare,107,460477,466,168,5,173,10
2020-04-11,Tuolumne,109,53932,3,0,0,0,0
2020-04-11,Ventura,111,848112,463,304,0,304,9
2020-04-11,Yolo,113,214977,136,67,0,67,3
2020-04-11,Yuba,115,75493,14,13,0,13,1
2020-04-10,Alameda,001,1643700,1121,706,1,707,21
2020-04-10,Alpine,003,1148,1,1,0,1,0
2020-04-10,Amador,005,37829,7,5,0,5,0
2020-04-10,Butte,007,227075,19,13,1,14,0
2020-04-10,Calaveras,009,45235,10,5,0,5,0
2020-04-10,Colusa,011,21464,3,3,0,3,0
2020-04-10,Contra Costa,013,1133247,744,537,0,537,10
2020-04-10,Del Norte,015,27424,2,2,0,2,0
2020-04-10,El Dorado,017,186661,48,26,0,26,0
2020-04-10,Fresno,019,978130,453,186,4,190,3
2020-04-10,Glenn,021,27897,4,3,0,3,0
2020-04-10,Humboldt,023,135768,57,36,0,36,0
2020-04-10,Imperial,025,180216,179,70,0,70,2
2020-04-10,Inyo,027,18085,13,11,0,11,0
2020-04-10,Kern,029,883053,627,272,0,272,3
2020-04-10,Kings,031,150075,46,7,1,8,0
2020-04-10,Lake,033,64148,6,3,0,3,0
2020-04-10,Lassen,035,31185,3,0,2,2,0
2020-04-10,Los Angeles,037,10098052,13668,8384,12,8396,239
2020-04-10,Madera,039,155013,63,29,1,30,2
2020-04-10,Marin,041,260295,173,128,1,129,6
2020-04-10,Mariposa,043,17540,0,0,0,0,0
2020-04-10,Mendocino,045,87422,5,4,0,4,0
2020-04-10,Merced,047,269075,100,56,0,56,3
2020-04-10,Modoc,049,8938,0,0,0,0,0
2020-04-10,Mono,051,14174,29,20,0,20,1
2020-04-10,Monterey,053,433212,142,78,0,78,3
2020-04-10,Napa,055,140530,50,28,0,28,2
2020-04-10,Nevada,057,99092,37,23,1,24,1
2020-04-10,Orange,059,3164182,1885,1167,18,1185,21
2020-04-10,Placer,061,380077,145,112,0,112,4
2020-04-10,Plumas,063,18699,4,3,0,3,0
2020-04-10,Riverside,065,2383286,2608,1162,13,1175,30
2020-04-10,Sacramento,067,1510023,900,642,0,642,24
2020-04-10,San Benito,069,59416,36,32,0,32,2
2020-04-10,San Bernardino,071,2135413,1354,779,0,779,27
2020-04-10,San Diego,073,3302833,2320,1695,0,1695,44
2020-04-10,San Francisco,075,870044,1139,797,0,797,10
2020-04-10,San Joaquin,077,732212,403,234,3,237,14
2020-04-10,San Luis Obispo,079,281455,166,97,1,98,1
2020-04-10,San Mateo,081,765935,918,642,2,644,24
2020-04-10,Santa Barbara,083,443738,346,254,1,255,2
2020-04-10,Santa Clara,085,1922200,1943,1351,5,1356,50
2020-04-10,Santa Cruz,087,273765,101,75,0,75,1
2020-04-10,Shasta,089,179085,30,24,0,24,3
2020-04-10,Sierra,091,2930,0,0,0,0,0
2020-04-10,Siskiyou,093,43540,5,5,0,5,0
2020-04-10,Solano,095,438530,197,129,0,129,2
2020-04-10,Sonoma,097,501317,180,129,0,129,1
2020-04-10,Stanislaus,099,539301,231,101,3,104,0
2020-04-10,Sutter,101,95872,23,18,0,18,2
2020-04-10,Tehama,103,63373,1,1,0,1,0
2020-04-10,Trinity,105,12862,0,0,0,0,0
2020-04-10,Tulare,107,460477,424,163,5,168,10
2020-04-10,Tuolumne,109,53932,3,0,0,0,0
2020-04-10,Ventura,111,848112,454,290,0,290,9
2020-04-10,Yolo,113,214977,134,62,0,62,3
2020-04-10,Yuba,115,75493,14,13,0,13,1
2020-04-09,Alameda,001,1643700,1071,641,1,642,17
2020-04-09,Alpine,003,1148,1,1,0,1,0
2020-04-09,Amador,005,37829,7,2,0,2,0
2020-04-09,Butte,007,227075,19,12,1,13,0
2020-04-09,Calaveras,009,45235,10,5,0,5,0
2020-04-09,Colusa,011,21464,3,3,0,3,0
2020-04-09,Contra Costa,013,1133247,701,505,0,505,7
2020-04-09,Del Norte,015,27424,2,2,0,2,0
2020-04-09,El Dorado,017,186661,47,25,0,25,0
2020-04-09,Fresno,019,978130,428,165,4,169,3
2020-04-09,Glenn,021,27897,4,2,0,2,0
2020-04-09,Humboldt,023,135768,57,36,0,36,0
2020-04-09,Imperial,025,180216,158,67,0,67,2
2020-04-09,Inyo,027,18085,12,11,0,11,0
2020-04-09,Kern,029,883053,591,241,0,241,2
2020-04-09,Kings,031,150075,43,5,1,6,0
2020-04-09,Lake,033,64148,5,1,0,1,0
2020-04-09,Lassen,035,31185,3,0,2,2,0
2020-04-09,Los Angeles,037,10098052,13037,7919,12,7931,220
2020-04-09,Madera,039,155013,63,28,1,29,2
2020-04-09,Marin,041,260295,171,126,1,127,7
2020-04-09,Mariposa,043,17540,0,0,0,0,0
2020-04-09,Mendocino,045,87422,5,4,0,4,0
2020-04-09,Merced,047,269075,97,41,0,41,3
2020-04-09,Modoc,049,8938,0,0,0,0,0
2020-04-09,Mono,051,14174,29,19,0,19,1
2020-04-09,Monterey,053,433212,124,70,0,70,3
2020-04-09,Napa,055,140530,46,27,0,27,2
2020-04-09,Nevada,057,99092,36,23,1,24,1
2020-04-09,Orange,059,3164182,1811,1105,18,1123,19
2020-04-09,Placer,061,380077,144,107,0,107,4
2020-04-09,Plumas,063,18699,4,3,0,3,0
2020-04-09,Riverside,065,2383286,2465,1083,13,1096,29
2020-04-09,Sacramento,067,1510023,877,601,0,601,21
2020-04-09,San Benito,069,59416,36,32,0,32,2
2020-04-09,San Bernardino,071,2135413,1285,717,0,717,27
2020-04-09,San Diego,073,3302833,2224,1630,0,1630,40
2020-04-09,San Francisco,075,870044,1119,748,0,748,8
2020-04-09,San Joaquin,077,732212,382,223,3,226,14
2020-04-09,San Luis Obispo,079,281455,158,93,1,94,1
2020-04-09,San Mateo,081,765935,902,630,2,632,23
2020-04-09,Santa Barbara,083,443738,336,232,1,233,2
2020-04-09,Santa Clara,085,1922200,1873,1301,5,1306,49
2020-04-09,Santa Cruz,087,273765,101,73,0,73,1
2020-04-09,Shasta,089,179085,30,22,0,22,3
2020-04-09,Sierra,091,2930,0,0,0,0,0
2020-04-09,Siskiyou,093,43540,5,4,0,4,0
2020-04-09,Solano,095,438530,188,118,0,118,2
2020-04-09,Sonoma,097,501317,176,113,0,113,1
2020-04-09,Stanislaus,099,539301,219,93,3,96,0
2020-04-09,Sutter,101,95872,23,17,0,17,2
2020-04-09,Tehama,103,63373,1,1,0,1,0
2020-04-09,Trinity,105,12862,0,0,0,0,0
2020-04-09,Tulare,107,460477,395,147,5,152,9
2020-04-09,Tuolumne,109,53932,3,0,0,0,0
2020-04-09,Ventura,111,848112,435,273,0,273,9
2020-04-09,Yolo,113,214977,125,59,0,59,3
2020-04-09,Yuba,115,75493,14,13,0,13,0
2020-04-08,Alameda,001,1643700,1029,594,1,595,15
2020-04-08,Alpine,003,1148,1,1,0,1,0
2020-04-08,Amador,005,37829,7,2,0,2,0
2020-04-08,Butte,007,227075,18,11,1,12,0
2020-04-08,Calaveras,009,45235,10,5,0,5,0
2020-04-08,Colusa,011,21464,3,3,0,3,0
2020-04-08,Contra Costa,013,1133247,688,481,0,481,7
2020-04-08,Del Norte,015,27424,2,2,0,2,0
2020-04-08,El Dorado,017,186661,47,25,0,25,0
2020-04-08,Fresno,019,978130,408,151,4,155,3
2020-04-08,Glenn,021,27897,4,2,0,2,0
2020-04-08,Humboldt,023,135768,57,40,0,40,0
2020-04-08,Imperial,025,180216,147,59,0,59,2
2020-04-08,Inyo,027,18085,12,11,0,11,0
2020-04-08,Kern,029,883053,550,198,0,198,2
2020-04-08,Kings,031,150075,43,5,1,6,0
2020-04-08,Lake,033,64148,5,1,0,1,0
2020-04-08,Lassen,035,31185,3,0,2,2,0
2020-04-08,Los Angeles,037,10098052,12436,7505,12,7517,196
2020-04-08,Madera,039,155013,62,28,1,29,2
2020-04-08,Marin,041,260295,165,125,1,126,7
2020-04-08,Mariposa,043,17540,0,0,0,0,0
2020-04-08,Mendocino,045,87422,5,4,0,4,0
2020-04-08,Merced,047,269075,82,35,0,35,1
2020-04-08,Modoc,049,8938,0,0,0,0,0
2020-04-08,Mono,051,14174,29,19,0,19,1
2020-04-08,Monterey,053,433212,115,68,0,68,3
2020-04-08,Napa,055,140530,44,21,0,21,2
2020-04-08,Nevada,057,99092,36,21,1,22,1
2020-04-08,Orange,059,3164182,1748,1034,18,1052,19
2020-04-08,Placer,061,380077,144,102,0,102,4
2020-04-08,Plumas,063,18699,4,3,0,3,0
2020-04-08,Riverside,065,2383286,2308,974,13,987,28
2020-04-08,Sacramento,067,1510023,843,565,0,565,21
2020-04-08,San Benito,069,59416,36,31,0,31,2
2020-04-08,San Bernardino,071,2135413,1228,635,0,635,22
2020-04-08,San Diego,073,3302833,2150,1532,0,1532,36
2020-04-08,San Francisco,075,870044,1052,687,0,687,7
2020-04-08,San Joaquin,077,732212,365,211,3,214,12
2020-04-08,San Luis Obispo,079,281455,156,90,1,91,1
2020-04-08,San Mateo,081,765935,887,608,2,610,22
2020-04-08,Santa Barbara,083,443738,319,221,1,222,2
2020-04-08,Santa Clara,085,1922200,1828,1257,5,1262,47
2020-04-08,Santa Cruz,087,273765,100,69,0,69,1
2020-04-08,Shasta,089,179085,30,18,0,18,3
2020-04-08,Sierra,091,2930,0,0,0,0,0
2020-04-08,Siskiyou,093,43540,5,4,0,4,0
2020-04-08,Solano,095,438530,175,111,0,111,2
2020-04-08,Sonoma,097,501317,170,107,0,107,1
2020-04-08,Stanislaus,099,539301,203,86,3,89,0
2020-04-08,Sutter,101,95872,22,17,0,17,2
2020-04-08,Tehama,103,63373,1,1,0,1,0
2020-04-08,Trinity,105,12862,0,0,0,0,0
2020-04-08,Tulare,107,460477,364,145,5,150,6
2020-04-08,Tuolumne,109,53932,3,0,0,0,0
2020-04-08,Ventura,111,848112,426,263,0,263,7
2020-04-08,Yolo,113,214977,108,56,0,56,3
2020-04-08,Yuba,115,75493,14,10,0,10,0
2020-04-07,Alameda,001,1643700,994,560,1,561,14
2020-04-07,Alpine,003,1148,1,1,0,1,0
2020-04-07,Amador,005,37829,7,2,0,2,0
2020-04-07,Butte,007,227075,17,11,1,12,0
2020-04-07,Calaveras,009,45235,9,5,0,5,0
2020-04-07,Colusa,011,21464,3,2,0,2,0
2020-04-07,Contra Costa,013,1133247,668,471,0,471,7
2020-04-07,Del Norte,015,27424,2,2,0,2,0
2020-04-07,El Dorado,017,186661,46,22,0,22,0
2020-04-07,Fresno,019,978130,393,138,4,142,3
2020-04-07,Glenn,021,27897,4,2,0,2,0
2020-04-07,Humboldt,023,135768,56,40,0,40,0
2020-04-07,Imperial,025,180216,128,53,0,53,2
2020-04-07,Inyo,027,18085,12,11,0,11,0
2020-04-07,Kern,029,883053,507,134,0,134,2
2020-04-07,Kings,031,150075,40,5,1,6,0
2020-04-07,Lake,033,64148,4,1,0,1,0
2020-04-07,Lassen,035,31185,3,0,2,2,0
2020-04-07,Los Angeles,037,10098052,11787,6885,12,6897,170
2020-04-07,Madera,039,155013,60,28,0,28,2
2020-04-07,Marin,041,260295,163,122,1,123,7
2020-04-07,Mariposa,043,17540,0,0,0,0,0
2020-04-07,Mendocino,045,87422,5,4,0,4,0
2020-04-07,Merced,047,269075,67,27,0,27,1
2020-04-07,Modoc,049,8938,0,0,0,0,0
2020-04-07,Mono,051,14174,28,18,0,18,1
2020-04-07,Monterey,053,433212,106,63,0,63,2
2020-04-07,Napa,055,140530,42,18,0,18,2
2020-04-07,Nevada,057,99092,36,20,1,21,1
2020-04-07,Orange,059,3164182,1701,971,16,987,19
2020-04-07,Placer,061,380077,139,94,0,94,3
2020-04-07,Plumas,063,18699,4,3,0,3,0
2020-04-07,Riverside,065,2383286,2151,905,13,918,25
2020-04-07,Sacramento,067,1510023,813,513,0,513,18
2020-04-07,San Benito,069,59416,36,26,0,26,2
2020-04-07,San Bernardino,071,2135413,1161,554,0,554,19
2020-04-07,San Diego,073,3302833,2073,1456,0,1456,31
2020-04-07,San Francisco,075,870044,992,636,0,636,6
2020-04-07,San Joaquin,077,732212,347,198,3,201,12
2020-04-07,San Luis Obispo,079,281455,149,87,1,88,1
2020-04-07,San Mateo,081,765935,866,573,2,575,22
2020-04-07,Santa Barbara,083,443738,305,209,1,210,2
2020-04-07,Santa Clara,085,1922200,1759,1193,4,1197,46
2020-04-07,Santa Cruz,087,273765,100,67,0,67,1
2020-04-07,Shasta,089,179085,29,16,0,16,3
2020-04-07,Sierra,091,2930,0,0,0,0,0
2020-04-07,Siskiyou,093,43540,5,4,0,4,0
2020-04-07,Solano,095,438530,170,99,0,99,1
2020-04-07,Sonoma,097,501317,167,102,0,102,1
2020-04-07,Stanislaus,099,539301,186,83,3,86,0
2020-04-07,Sutter,101,95872,22,16,0,16,2
2020-04-07,Tehama,103,63373,1,1,0,1,0
2020-04-07,Trinity,105,12862,0,0,0,0,0
2020-04-07,Tulare,107,460477,335,144,5,149,5
2020-04-07,Tuolumne,109,53932,3,1,0,1,0
2020-04-07,Ventura,111,848112,409,247,0,247,6
2020-04-07,Yolo,113,214977,101,51,0,51,2
2020-04-07,Yuba,115,75493,14,10,0,10,0
2020-04-06,Alameda,001,1643700,963,527,1,528,13
2020-04-06,Alpine,003,1148,1,1,0,1,0
2020-04-06,Amador,005,37829,6,2,0,2,0
2020-04-06,Butte,007,227075,16,11,1,12,0
2020-04-06,Calaveras,009,45235,9,4,0,4,0
2020-04-06,Colusa,011,21464,3,1,0,1,0
2020-04-06,Contra Costa,013,1133247,643,447,0,447,7
2020-04-06,Del Norte,015,27424,2,2,0,2,0
2020-04-06,El Dorado,017,186661,44,23,0,23,0
2020-04-06,Fresno,019,978130,371,122,4,126,1
2020-04-06,Glenn,021,27897,4,2,0,2,0
2020-04-06,Humboldt,023,135768,55,37,0,37,0
2020-04-06,Imperial,025,180216,121,47,0,47,1
2020-04-06,Inyo,027,18085,11,11,0,11,0
2020-04-06,Kern,029,883053,470,117,0,117,2
2020-04-06,Kings,031,150075,40,3,1,4,0
2020-04-06,Lake,033,64148,4,1,0,1,0
2020-04-06,Lassen,035,31185,3,0,2,2,0
2020-04-06,Los Angeles,037,10098052,11054,6346,12,6358,145
2020-04-06,Madera,039,155013,58,29,0,29,2
2020-04-06,Marin,041,260295,160,119,1,120,7
2020-04-06,Mariposa,043,17540,0,0,0,0,0
2020-04-06,Mendocino,045,87422,5,4,0,4,0
2020-04-06,Merced,047,269075,60,25,0,25,1
2020-04-06,Modoc,049,8938,0,0,0,0,0
2020-04-06,Mono,051,14174,28,18,0,18,1
2020-04-06,Monterey,053,433212,101,62,0,62,2
2020-04-06,Napa,055,140530,42,18,0,18,2
2020-04-06,Nevada,057,99092,36,19,1,20,1
2020-04-06,Orange,059,3164182,1657,910,15,925,17
2020-04-06,Placer,061,380077,139,90,0,90,3
2020-04-06,Plumas,063,18699,4,2,0,2,0
2020-04-06,Riverside,065,2383286,2025,854,13,867,17
2020-04-06,Sacramento,067,1510023,783,448,0,448,15
2020-04-06,San Benito,069,59416,34,25,0,25,1
2020-04-06,San Bernardino,071,2135413,1102,550,0,550,13
2020-04-06,San Diego,073,3302833,1991,1406,0,1406,19
2020-04-06,San Francisco,075,870044,952,586,0,586,6
2020-04-06,San Joaquin,077,732212,332,191,3,194,10
2020-04-06,San Luis Obispo,079,281455,147,85,1,86,1
2020-04-06,San Mateo,081,765935,848,569,2,571,20
2020-04-06,Santa Barbara,083,443738,296,189,1,190,2
2020-04-06,Santa Clara,085,1922200,1706,1128,4,1132,43
2020-04-06,Santa Cruz,087,273765,98,65,0,65,1
2020-04-06,Shasta,089,179085,29,16,0,16,3
2020-04-06,Sierra,091,2930,0,0,0,0,0
2020-04-06,Siskiyou,093,43540,4,4,0,4,0
2020-04-06,Solano,095,438530,163,95,0,95,1
2020-04-06,Sonoma,097,501317,166,102,0,102,1
2020-04-06,Stanislaus,099,539301,170,72,3,75,0
2020-04-06,Sutter,101,95872,22,14,0,14,2
2020-04-06,Tehama,103,63373,1,1,0,1,0
2020-04-06,Trinity,105,12862,0,0,0,0,0
2020-04-06,Tulare,107,460477,319,126,5,131,5
2020-04-06,Tuolumne,109,53932,3,1,0,1,0
2020-04-06,Ventura,111,848112,391,234,0,234,6
2020-04-06,Yolo,113,214977,97,43,0,43,1
2020-04-06,Yuba,115,75493,14,8,0,8,0
2020-04-05,Alameda,001,1643700,921,475,1,476,12
2020-04-05,Alpine,003,1148,1,1,0,1,0
2020-04-05,Amador,005,37829,6,2,0,2,0
2020-04-05,Butte,007,227075,16,10,1,11,0
2020-04-05,Calaveras,009,45235,9,3,0,3,0
2020-04-05,Colusa,011,21464,3,1,0,1,0
2020-04-05,Contra Costa,013,1133247,626,415,0,415,6
2020-04-05,Del Norte,015,27424,2,1,0,1,0
2020-04-05,El Dorado,017,186661,42,19,0,19,0
2020-04-05,Fresno,019,978130,337,102,4,106,1
2020-04-05,Glenn,021,27897,4,2,0,2,0
2020-04-05,Humboldt,023,135768,55,29,0,29,0
2020-04-05,Imperial,025,180216,113,42,0,42,1
2020-04-05,Inyo,027,18085,11,10,0,10,0
2020-04-05,Kern,029,883053,415,109,0,109,2
2020-04-05,Kings,031,150075,39,4,1,5,0
2020-04-05,Lake,033,64148,4,0,0,0,0
2020-04-05,Lassen,035,31185,3,0,2,2,0
2020-04-05,Los Angeles,037,10098052,10483,5892,12,5904,130
2020-04-05,Madera,039,155013,57,27,0,27,2
2020-04-05,Marin,041,260295,160,113,1,114,6
2020-04-05,Mariposa,043,17540,0,0,0,0,0
2020-04-05,Mendocino,045,87422,5,4,0,4,0
2020-04-05,Merced,047,269075,53,16,0,16,0
2020-04-05,Modoc,049,8938,0,0,0,0,0
2020-04-05,Mono,051,14174,28,18,0,18,1
2020-04-05,Monterey,053,433212,94,61,0,61,2
2020-04-05,Napa,055,140530,40,15,0,15,2
2020-04-05,Nevada,057,99092,36,19,1,20,1
2020-04-05,Orange,059,3164182,1600,820,15,835,15
2020-04-05,Placer,061,380077,136,86,0,86,3
2020-04-05,Plumas,063,18699,3,2,0,2,0
2020-04-05,Riverside,065,2383286,1896,669,13,682,17
2020-04-05,Sacramento,067,1510023,752,393,0,393,11
2020-04-05,San Benito,069,59416,34,22,0,22,1
2020-04-05,San Bernardino,071,2135413,1029,375,0,375,13
2020-04-05,San Diego,073,3302833,1909,1328,0,1328,19
2020-04-05,San Francisco,075,870044,905,559,0,559,6
2020-04-05,San Joaquin,077,732212,317,179,3,182,10
2020-04-05,San Luis Obispo,079,281455,145,83,1,84,1
2020-04-05,San Mateo,081,765935,828,528,2,530,19
2020-04-05,Santa Barbara,083,443738,280,171,1,172,1
2020-04-05,Santa Clara,085,1922200,1659,1052,4,1056,42
2020-04-05,Santa Cruz,087,273765,98,59,0,59,1
2020-04-05,Shasta,089,179085,28,11,0,11,2
2020-04-05,Sierra,091,2930,0,0,0,0,0
2020-04-05,Siskiyou,093,43540,4,3,0,3,0
2020-04-05,Solano,095,438530,159,78,0,78,1
2020-04-05,Sonoma,097,501317,164,88,0,88,1
2020-04-05,Stanislaus,099,539301,156,51,3,54,0
2020-04-05,Sutter,101,95872,22,14,0,14,1
2020-04-05,Tehama,103,63373,1,1,0,1,0
2020-04-05,Trinity,105,12862,0,0,0,0,0
2020-04-05,Tulare,107,460477,282,81,5,86,4
2020-04-05,Tuolumne,109,53932,3,1,0,1,0
2020-04-05,Ventura,111,848112,377,196,0,196,6
2020-04-05,Yolo,113,214977,78,37,0,37,2
2020-04-05,Yuba,115,75493,14,7,0,7,0
2020-04-04,Alameda,001,1643700,898,468,1,469,12
2020-04-04,Alpine,003,1148,1,1,0,1,0
2020-04-04,Amador,005,37829,5,2,0,2,0
2020-04-04,Butte,007,227075,16,10,1,11,0
2020-04-04,Calaveras,009,45235,9,3,0,3,0
2020-04-04,Colusa,011,21464,3,1,0,1,0
2020-04-04,Contra Costa,013,1133247,618,382,0,382,5
2020-04-04,Del Norte,015,27424,2,1,0,1,0
2020-04-04,El Dorado,017,186661,42,19,0,19,0
2020-04-04,Fresno,019,978130,327,102,4,106,1
2020-04-04,Glenn,021,27897,4,2,0,2,0
2020-04-04,Humboldt,023,135768,55,29,0,29,0
2020-04-04,Imperial,025,180216,112,42,0,42,1
2020-04-04,Inyo,027,18085,11,10,0,10,0
2020-04-04,Kern,029,883053,385,103,0,103,2
2020-04-04,Kings,031,150075,39,3,1,4,0
2020-04-04,Lake,033,64148,4,0,0,0,0
2020-04-04,Lassen,035,31185,3,0,2,2,0
2020-04-04,Los Angeles,037,10098052,9869,5275,12,5287,117
2020-04-04,Madera,039,155013,55,27,0,27,2
2020-04-04,Marin,041,260295,158,111,0,111,6
2020-04-04,Mariposa,043,17540,0,0,0,0,0
2020-04-04,Mendocino,045,87422,5,4,0,4,0
2020-04-04,Merced,047,269075,49,11,0,11,0
2020-04-04,Modoc,049,8938,0,0,0,0,0
2020-04-04,Mono,051,14174,28,18,0,18,1
2020-04-04,Monterey,053,433212,91,61,0,61,2
2020-04-04,Napa,055,140530,40,15,0,15,2
2020-04-04,Nevada,057,99092,36,19,1,20,1
2020-04-04,Orange,059,3164182,1558,781,14,795,15
2020-04-04,Placer,061,380077,135,87,0,87,2
2020-04-04,Plumas,063,18699,3,2,0,2,0
2020-04-04,Riverside,065,2383286,1795,652,13,665,15
2020-04-04,Sacramento,067,1510023,734,393,0,393,11
2020-04-04,San Benito,069,59416,34,22,0,22,1
2020-04-04,San Bernardino,071,2135413,981,373,0,373,13
2020-04-04,San Diego,073,3302833,1861,1211,0,1211,18
2020-04-04,San Francisco,075,870044,867,537,0,537,6
2020-04-04,San Joaquin,077,732212,294,171,3,174,10
2020-04-04,San Luis Obispo,079,281455,145,82,1,83,0
2020-04-04,San Mateo,081,765935,816,520,2,522,17
2020-04-04,Santa Barbara,083,443738,271,167,1,168,1
2020-04-04,Santa Clara,085,1922200,1607,1045,4,1049,39
2020-04-04,Santa Cruz,087,273765,98,56,0,56,1
2020-04-04,Shasta,089,179085,27,11,0,11,2
2020-04-04,Sierra,091,2930,0,0,0,0,0
2020-04-04,Siskiyou,093,43540,4,3,0,3,0
2020-04-04,Solano,095,438530,154,79,0,79,1
2020-04-04,Sonoma,097,501317,161,88,0,88,1
2020-04-04,Stanislaus,099,539301,145,51,3,54,0
2020-04-04,Sutter,101,95872,22,14,0,14,1
2020-04-04,Tehama,103,63373,1,1,0,1,0
2020-04-04,Trinity,105,12862,0,0,0,0,0
2020-04-04,Tulare,107,460477,268,79,5,84,4
2020-04-04,Tuolumne,109,53932,3,1,0,1,0
2020-04-04,Ventura,111,848112,364,194,0,194,6
2020-04-04,Yolo,113,214977,76,40,0,40,2
2020-04-04,Yuba,115,75493,13,7,0,7,0
2020-04-03,Alameda,001,1643700,862,395,1,396,11
2020-04-03,Alpine,003,1148,1,1,0,1,0
2020-04-03,Amador,005,37829,5,2,0,2,0
2020-04-03,Butte,007,227075,16,8,1,9,0
2020-04-03,Calaveras,009,45235,9,3,0,3,0
2020-04-03,Colusa,011,21464,3,1,0,1,0
2020-04-03,Contra Costa,013,1133247,595,327,0,327,5
2020-04-03,Del Norte,015,27424,2,1,0,1,0
2020-04-03,El Dorado,017,186661,40,16,0,16,0
2020-04-03,Fresno,019,978130,315,98,4,102,1
2020-04-03,Glenn,021,27897,4,2,0,2,0
2020-04-03,Humboldt,023,135768,55,34,0,34,0
2020-04-03,Imperial,025,180216,103,35,0,35,0
2020-04-03,Inyo,027,18085,11,10,0,10,0
2020-04-03,Kern,029,883053,359,87,0,87,1
2020-04-03,Kings,031,150075,37,3,1,4,0
2020-04-03,Lake,033,64148,3,0,0,0,0
2020-04-03,Lassen,035,31185,3,0,2,2,0
2020-04-03,Los Angeles,037,10098052,9255,4566,12,4578,91
2020-04-03,Madera,039,155013,54,28,0,28,2
2020-04-03,Marin,041,260295,156,106,0,106,6
2020-04-03,Mariposa,043,17540,0,0,0,0,0
2020-04-03,Mendocino,045,87422,5,4,0,4,0
2020-04-03,Merced,047,269075,46,9,0,9,0
2020-04-03,Modoc,049,8938,0,0,0,0,0
2020-04-03,Mono,051,14174,28,18,0,18,1
2020-04-03,Monterey,053,433212,88,58,0,58,2
2020-04-03,Napa,055,140530,39,13,0,13,1
2020-04-03,Nevada,057,99092,36,19,1,20,1
2020-04-03,Orange,059,3164182,1519,713,14,727,13
2020-04-03,Placer,061,380077,131,76,0,76,2
2020-04-03,Plumas,063,18699,3,2,0,2,0
2020-04-03,Riverside,065,2383286,1715,540,13,553,14
2020-04-03,Sacramento,067,1510023,713,363,0,363,11
2020-04-03,San Benito,069,59416,34,22,0,22,1
2020-04-03,San Bernardino,071,2135413,936,356,0,356,11
2020-04-03,San Diego,073,3302833,1800,1114,0,1114,17
2020-04-03,San Francisco,075,870044,843,506,0,506,6
2020-04-03,San Joaquin,077,732212,282,162,3,165,10
2020-04-03,San Luis Obispo,079,281455,144,82,1,83,0
2020-04-03,San Mateo,081,765935,799,474,2,476,13
2020-04-03,Santa Barbara,083,443738,260,154,1,155,1
2020-04-03,Santa Clara,085,1922200,1571,983,4,987,39
2020-04-03,Santa Cruz,087,273765,98,52,0,52,1
2020-04-03,Shasta,089,179085,27,10,0,10,1
2020-04-03,Sierra,091,2930,0,0,0,0,0
2020-04-03,Siskiyou,093,43540,4,3,0,3,0
2020-04-03,Solano,095,438530,146,72,0,72,1
2020-04-03,Sonoma,097,501317,161,84,0,84,1
2020-04-03,Stanislaus,099,539301,139,48,3,51,0
2020-04-03,Sutter,101,95872,22,12,0,12,1
2020-04-03,Tehama,103,63373,1,1,0,1,0
2020-04-03,Trinity,105,12862,0,0,0,0,0
2020-04-03,Tulare,107,460477,254,73,5,78,3
2020-04-03,Tuolumne,109,53932,3,1,0,1,0
2020-04-03,Ventura,111,848112,354,186,0,186,6
2020-04-03,Yolo,113,214977,75,33,0,33,1
2020-04-03,Yuba,115,75493,13,6,0,6,0
2020-04-02,Alameda,001,1643700,811,345,1,346,10
2020-04-02,Alpine,003,1148,1,1,0,1,0
2020-04-02,Amador,005,37829,5,2,0,2,0
2020-04-02,Butte,007,227075,16,7,0,7,0
2020-04-02,Calaveras,009,45235,7,3,0,3,0
2020-04-02,Colusa,011,21464,3,1,0,1,0
2020-04-02,Contra Costa,013,1133247,565,297,0,297,3
2020-04-02,Del Norte,015,27424,2,0,0,0,0
2020-04-02,El Dorado,017,186661,38,16,0,16,0
2020-04-02,Fresno,019,978130,299,92,4,96,0
2020-04-02,Glenn,021,27897,3,2,0,2,0
2020-04-02,Humboldt,023,135768,51,23,0,23,0
2020-04-02,Imperial,025,180216,99,24,0,24,0
2020-04-02,Inyo,027,18085,10,8,0,8,0
2020-04-02,Kern,029,883053,332,74,0,74,0
2020-04-02,Kings,031,150075,37,3,1,4,0
2020-04-02,Lake,033,64148,3,0,0,0,0
2020-04-02,Lassen,035,31185,3,0,2,2,0
2020-04-02,Los Angeles,037,10098052,8420,4040,12,4052,79
2020-04-02,Madera,039,155013,52,25,0,25,1
2020-04-02,Marin,041,260295,150,102,0,102,1
2020-04-02,Mariposa,043,17540,0,0,0,0,0
2020-04-02,Mendocino,045,87422,5,4,0,4,0
2020-04-02,Merced,047,269075,41,9,0,9,0
2020-04-02,Modoc,049,8938,0,0,0,0,0
2020-04-02,Mono,051,14174,28,16,0,16,1
2020-04-02,Monterey,053,433212,86,50,0,50,2
2020-04-02,Napa,055,140530,39,13,0,13,0
2020-04-02,Nevada,057,99092,35,17,1,18,0
2020-04-02,Orange,059,3164182,1467,640,13,653,12
2020-04-02,Placer,061,380077,130,72,0,72,2
2020-04-02,Plumas,063,18699,3,1,0,1,0
2020-04-02,Riverside,065,2383286,1598,438,13,451,13
2020-04-02,Sacramento,067,1510023,695,322,0,322,9
2020-04-02,San Benito,069,59416,32,18,0,18,1
2020-04-02,San Bernardino,071,2135413,881,335,0,335,8
2020-04-02,San Diego,073,3302833,1733,968,0,968,16
2020-04-02,San Francisco,075,870044,817,473,0,473,6
2020-04-02,San Joaquin,077,732212,263,148,3,151,9
2020-04-02,San Luis Obispo,079,281455,139,79,1,80,0
2020-04-02,San Mateo,081,765935,778,423,2,425,13
2020-04-02,Santa Barbara,083,443738,249,125,1,126,1
2020-04-02,Santa Clara,085,1922200,1520,908,4,912,38
2020-04-02,Santa Cruz,087,273765,96,49,0,49,1
2020-04-02,Shasta,089,179085,26,7,0,7,1
2020-04-02,Sierra,091,2930,0,0,0,0,0
2020-04-02,Siskiyou,093,43540,4,3,0,3,0
2020-04-02,Solano,095,438530,136,65,0,65,0
2020-04-02,Sonoma,097,501317,157,76,0,76,1
2020-04-02,Stanislaus,099,539301,128,40,3,43,0
2020-04-02,Sutter,101,95872,21,10,0,10,1
2020-04-02,Tehama,103,63373,1,1,0,1,0
2020-04-02,Trinity,105,12862,0,0,0,0,0
2020-04-02,Tulare,107,460477,220,64,5,69,1
2020-04-02,Tuolumne,109,53932,3,1,0,1,0
2020-04-02,Ventura,111,848112,336,178,0,178,5
2020-04-02,Yolo,113,214977,73,29,0,29,1
2020-04-02,Yuba,115,75493,10,5,0,5,0
2020-04-01,Alameda,001,1643700,784,287,1,288,8
2020-04-01,Alpine,003,1148,1,1,0,1,0
2020-04-01,Amador,005,37829,5,1,0,1,0
2020-04-01,Butte,007,227075,16,6,0,6,0
2020-04-01,Calaveras,009,45235,6,3,0,3,0
2020-04-01,Colusa,011,21464,3,1,0,1,0
2020-04-01,Contra Costa,013,1133247,522,267,0,267,3
2020-04-01,Del Norte,015,27424,2,0,0,0,0
2020-04-01,El Dorado,017,186661,37,14,0,14,0
2020-04-01,Fresno,019,978130,277,75,3,78,0
2020-04-01,Glenn,021,27897,3,2,0,2,0
2020-04-01,Humboldt,023,135768,51,19,0,19,0
2020-04-01,Imperial,025,180216,93,25,0,25,0
2020-04-01,Inyo,027,18085,10,8,0,8,0
2020-04-01,Kern,029,883053,305,53,0,53,0
2020-04-01,Kings,031,150075,35,3,1,4,0
2020-04-01,Lake,033,64148,3,0,0,0,0
2020-04-01,Lassen,035,31185,3,0,2,2,0
2020-04-01,Los Angeles,037,10098052,7770,3502,12,3514,66
2020-04-01,Madera,039,155013,50,17,0,17,1
2020-04-01,Marin,041,260295,146,87,0,87,1
2020-04-01,Mariposa,043,17540,0,0,0,0,0
2020-04-01,Mendocino,045,87422,5,4,0,4,0
2020-04-01,Merced,047,269075,38,7,0,7,0
2020-04-01,Modoc,049,8938,0,0,0,0,0
2020-04-01,Mono,051,14174,28,12,0,12,1
2020-04-01,Monterey,053,433212,85,47,0,47,2
2020-04-01,Napa,055,140530,36,11,0,11,0
2020-04-01,Nevada,057,99092,35,15,1,16,0
2020-04-01,Orange,059,3164182,1415,579,13,592,11
2020-04-01,Placer,061,380077,128,52,0,52,2
2020-04-01,Plumas,063,18699,3,1,0,1,0
2020-04-01,Riverside,065,2383286,1430,306,12,318,11
2020-04-01,Sacramento,067,1510023,662,299,0,299,8
2020-04-01,San Benito,069,59416,29,14,0,14,1
2020-04-01,San Bernardino,071,2135413,832,245,0,245,5
2020-04-01,San Diego,073,3302833,1663,851,0,851,11
2020-04-01,San Francisco,075,870044,789,432,0,432,6
2020-04-01,San Joaquin,077,732212,251,132,3,135,8
2020-04-01,San Luis Obispo,079,281455,133,69,1,70,0
2020-04-01,San Mateo,081,765935,760,354,2,356,13
2020-04-01,Santa Barbara,083,443738,236,103,1,104,0
2020-04-01,Santa Clara,085,1922200,1478,805,4,809,33
2020-04-01,Santa Cruz,087,273765,91,44,0,44,1
2020-04-01,Shasta,089,179085,25,5,0,5,1
2020-04-01,Sierra,091,2930,0,0,0,0,0
2020-04-01,Siskiyou,093,43540,4,3,0,3,0
2020-04-01,Solano,095,438530,131,57,0,57,0
2020-04-01,Sonoma,097,501317,153,60,0,60,1
2020-04-01,Stanislaus,099,539301,117,29,3,32,0
2020-04-01,Sutter,101,95872,21,9,0,9,1
2020-04-01,Tehama,103,63373,1,0,0,0,0
2020-04-01,Trinity,105,12862,0,0,0,0,0
2020-04-01,Tulare,107,460477,182,43,5,48,1
2020-04-01,Tuolumne,109,53932,3,1,0,1,0
2020-04-01,Ventura,111,848112,323,154,0,154,5
2020-04-01,Yolo,113,214977,68,22,0,22,1
2020-04-01,Yuba,115,75493,9,5,0,5,0
2020-03-31,Alameda,001,1643700,718,269,1,270,7
2020-03-31,Alpine,003,1148,1,1,0,1,0
2020-03-31,Amador,005,37829,5,1,0,1,0
2020-03-31,Butte,007,227075,16,6,0,6,0
2020-03-31,Calaveras,009,45235,6,3,0,3,0
2020-03-31,Colusa,011,21464,3,1,0,1,0
2020-03-31,Contra Costa,013,1133247,497,246,0,246,3
2020-03-31,Del Norte,015,27424,1,0,0,0,0
2020-03-31,El Dorado,017,186661,33,14,0,14,0
2020-03-31,Fresno,019,978130,252,59,3,62,0
2020-03-31,Glenn,021,27897,3,2,0,2,0
2020-03-31,Humboldt,023,135768,51,18,0,18,0
2020-03-31,Imperial,025,180216,88,17,0,17,0
2020-03-31,Inyo,027,18085,10,8,0,8,0
2020-03-31,Kern,029,883053,281,47,0,47,0
2020-03-31,Kings,031,150075,33,2,1,3,0
2020-03-31,Lake,033,64148,1,0,0,0,0
2020-03-31,Lassen,035,31185,3,0,2,2,0
2020-03-31,Los Angeles,037,10098052,7109,3001,12,3013,53
2020-03-31,Madera,039,155013,49,17,0,17,1
2020-03-31,Marin,041,260295,137,85,0,85,1
2020-03-31,Mariposa,043,17540,0,0,0,0,0
2020-03-31,Mendocino,045,87422,5,4,0,4,0
2020-03-31,Merced,047,269075,33,6,0,6,0
2020-03-31,Modoc,049,8938,0,0,0,0,0
2020-03-31,Mono,051,14174,26,12,0,12,0
2020-03-31,Monterey,053,433212,83,43,0,43,2
2020-03-31,Napa,055,140530,35,9,0,9,0
2020-03-31,Nevada,057,99092,35,15,1,16,0
2020-03-31,Orange,059,3164182,1345,506,13,519,7
2020-03-31,Placer,061,380077,121,49,0,49,2
2020-03-31,Plumas,063,18699,1,0,0,0,0
2020-03-31,Riverside,065,2383286,1284,284,12,296,8
2020-03-31,Sacramento,067,1510023,610,271,0,271,8
2020-03-31,San Benito,069,59416,29,14,0,14,1
2020-03-31,San Bernardino,071,2135413,747,193,0,193,5
2020-03-31,San Diego,073,3302833,1581,736,0,736,9
2020-03-31,San Francisco,075,870044,754,404,0,404,5
2020-03-31,San Joaquin,077,732212,235,122,3,125,7
2020-03-31,San Luis Obispo,079,281455,129,67,1,68,0
2020-03-31,San Mateo,081,765935,741,297,2,299,12
2020-03-31,Santa Barbara,083,443738,221,89,1,90,0
2020-03-31,Santa Clara,085,1922200,1428,777,4,781,30
2020-03-31,Santa Cruz,087,273765,84,40,0,40,1
2020-03-31,Shasta,089,179085,22,5,0,5,1
2020-03-31,Sierra,091,2930,0,0,0,0,0
2020-03-31,Siskiyou,093,43540,4,3,0,3,0
2020-03-31,Solano,095,438530,117,56,0,56,0
2020-03-31,Sonoma,097,501317,148,58,0,58,1
2020-03-31,Stanislaus,099,539301,102,28,3,31,0
2020-03-31,Sutter,101,95872,21,8,0,8,0
2020-03-31,Tehama,103,63373,1,0,0,0,0
2020-03-31,Trinity,105,12862,0,0,0,0,0
2020-03-31,Tulare,107,460477,159,42,4,46,1
2020-03-31,Tuolumne,109,53932,3,1,0,1,0
2020-03-31,Ventura,111,848112,312,143,0,143,4
2020-03-31,Yolo,113,214977,61,21,0,21,1
2020-03-31,Yuba,115,75493,9,5,0,5,0
2020-03-30,Alameda,001,1643700,678,250,1,251,7
2020-03-30,Alpine,003,1148,1,1,0,1,0
2020-03-30,Amador,005,37829,5,1,0,1,0
2020-03-30,Butte,007,227075,14,5,0,5,0
2020-03-30,Calaveras,009,45235,6,3,0,3,0
2020-03-30,Colusa,011,21464,3,1,0,1,0
2020-03-30,Contra Costa,013,1133247,471,212,0,212,3
2020-03-30,Del Norte,015,27424,0,0,0,0,0
2020-03-30,El Dorado,017,186661,33,11,0,11,0
2020-03-30,Fresno,019,978130,227,46,3,49,0
2020-03-30,Glenn,021,27897,3,2,0,2,0
2020-03-30,Humboldt,023,135768,49,11,0,11,0
2020-03-30,Imperial,025,180216,85,9,0,9,0
2020-03-30,Inyo,027,18085,10,5,0,5,0
2020-03-30,Kern,029,883053,248,30,0,30,0
2020-03-30,Kings,031,150075,33,1,1,2,0
2020-03-30,Lake,033,64148,1,0,0,0,0
2020-03-30,Lassen,035,31185,3,0,1,1,0
2020-03-30,Los Angeles,037,10098052,6449,2467,12,2479,44
2020-03-30,Madera,039,155013,48,14,0,14,1
2020-03-30,Marin,041,260295,130,78,0,78,0
2020-03-30,Mariposa,043,17540,0,0,0,0,0
2020-03-30,Mendocino,045,87422,5,2,0,2,0
2020-03-30,Merced,047,269075,29,6,0,6,0
2020-03-30,Modoc,049,8938,0,0,0,0,0
2020-03-30,Mono,051,14174,26,11,0,11,0
2020-03-30,Monterey,053,433212,78,41,0,41,1
2020-03-30,Napa,055,140530,34,9,0,9,0
2020-03-30,Nevada,057,99092,34,14,1,15,0
2020-03-30,Orange,059,3164182,1280,418,13,431,5
2020-03-30,Placer,061,380077,118,44,0,44,2
2020-03-30,Plumas,063,18699,1,0,0,0,0
2020-03-30,Riverside,065,2383286,1203,204,12,216,7
2020-03-30,Sacramento,067,1510023,586,238,0,238,8
2020-03-30,San Benito,069,59416,29,11,0,11,1
2020-03-30,San Bernardino,071,2135413,703,145,0,145,4
2020-03-30,San Diego,073,3302833,1511,605,0,605,7
2020-03-30,San Francisco,075,870044,714,368,0,368,5
2020-03-30,San Joaquin,077,732212,228,112,3,115,5
2020-03-30,San Luis Obispo,079,281455,126,62,1,63,0
2020-03-30,San Mateo,081,765935,717,257,2,259,11
2020-03-30,Santa Barbara,083,443738,212,79,1,80,0
2020-03-30,Santa Clara,085,1922200,1397,745,3,748,31
2020-03-30,Santa Cruz,087,273765,81,36,0,36,1
2020-03-30,Shasta,089,179085,21,4,0,4,1
2020-03-30,Sierra,091,2930,0,0,0,0,0
2020-03-30,Siskiyou,093,43540,4,2,0,2,0
2020-03-30,Solano,095,438530,111,50,0,50,0
2020-03-30,Sonoma,097,501317,145,57,0,57,1
2020-03-30,Stanislaus,099,539301,95,28,3,31,0
2020-03-30,Sutter,101,95872,20,6,0,6,0
2020-03-30,Tehama,103,63373,1,0,0,0,0
2020-03-30,Trinity,105,12862,0,0,0,0,0
2020-03-30,Tulare,107,460477,147,40,3,43,1
2020-03-30,Tuolumne,109,53932,3,1,0,1,0
2020-03-30,Ventura,111,848112,301,118,0,118,2
2020-03-30,Yolo,113,214977,58,17,0,17,1
2020-03-30,Yuba,115,75493,8,5,0,5,0
2020-03-29,Alameda,001,1643700,644,207,1,208,6
2020-03-29,Alpine,003,1148,1,0,0,0,0
2020-03-29,Amador,005,37829,5,1,0,1,0
2020-03-29,Butte,007,227075,14,4,0,4,0
2020-03-29,Calaveras,009,45235,6,2,0,2,0
2020-03-29,Colusa,011,21464,3,1,0,1,0
2020-03-29,Contra Costa,013,1133247,441,187,0,187,3
2020-03-29,Del Norte,015,27424,0,0,0,0,0
2020-03-29,El Dorado,017,186661,32,9,0,9,0
2020-03-29,Fresno,019,978130,203,31,3,34,0
2020-03-29,Glenn,021,27897,2,1,0,1,0
2020-03-29,Humboldt,023,135768,46,9,0,9,0
2020-03-29,Imperial,025,180216,79,9,0,9,0
2020-03-29,Inyo,027,18085,9,0,0,0,0
2020-03-29,Kern,029,883053,230,20,0,20,0
2020-03-29,Kings,031,150075,30,1,1,2,0
2020-03-29,Lake,033,64148,0,0,0,0,0
2020-03-29,Lassen,035,31185,3,0,1,1,0
2020-03-29,Los Angeles,037,10098052,5801,2119,11,2130,37
2020-03-29,Madera,039,155013,43,11,0,11,1
2020-03-29,Marin,041,260295,125,60,0,60,0
2020-03-29,Mariposa,043,17540,0,0,0,0,0
2020-03-29,Mendocino,045,87422,5,2,0,2,0
2020-03-29,Merced,047,269075,28,4,0,4,0
2020-03-29,Modoc,049,8938,0,0,0,0,0
2020-03-29,Mono,051,14174,26,8,0,8,0
2020-03-29,Monterey,053,433212,73,36,0,36,1
2020-03-29,Napa,055,140530,32,5,0,5,0
2020-03-29,Nevada,057,99092,32,13,1,14,0
2020-03-29,Orange,059,3164182,1207,343,13,356,2
2020-03-29,Placer,061,380077,117,35,0,35,2
2020-03-29,Plumas,063,18699,1,0,0,0,0
2020-03-29,Riverside,065,2383286,1079,122,12,134,7
2020-03-29,Sacramento,067,1510023,546,217,0,217,7
2020-03-29,San Benito,069,59416,28,10,0,10,1
2020-03-29,San Bernardino,071,2135413,651,94,0,94,2
2020-03-29,San Diego,073,3302833,1439,521,0,521,7
2020-03-29,San Francisco,075,870044,670,333,0,333,5
2020-03-29,San Joaquin,077,732212,219,86,3,89,4
2020-03-29,San Luis Obispo,079,281455,119,55,0,55,0
2020-03-29,San Mateo,081,765935,692,234,2,236,12
2020-03-29,Santa Barbara,083,443738,204,52,1,53,0
2020-03-29,Santa Clara,085,1922200,1340,591,3,594,30
2020-03-29,Santa Cruz,087,273765,81,33,0,33,1
2020-03-29,Shasta,089,179085,20,4,0,4,1
2020-03-29,Sierra,091,2930,0,0,0,0,0
2020-03-29,Siskiyou,093,43540,4,2,0,2,0
2020-03-29,Solano,095,438530,103,48,0,48,0
2020-03-29,Sonoma,097,501317,143,35,0,35,1
2020-03-29,Stanislaus,099,539301,90,19,3,22,0
2020-03-29,Sutter,101,95872,17,6,0,6,0
2020-03-29,Tehama,103,63373,1,0,0,0,0
2020-03-29,Trinity,105,12862,0,0,0,0,0
2020-03-29,Tulare,107,460477,122,24,3,27,1
2020-03-29,Tuolumne,109,53932,2,1,0,1,0
2020-03-29,Ventura,111,848112,274,92,0,92,2
2020-03-29,Yolo,113,214977,53,13,0,13,1
2020-03-29,Yuba,115,75493,8,3,0,3,0
2020-03-28,Alameda,001,1643700,617,410,1,411,12
2020-03-28,Alpine,003,1148,1,0,0,0,0
2020-03-28,Amador,005,37829,5,2,0,2,0
2020-03-28,Butte,007,227075,14,8,0,8,0
2020-03-28,Calaveras,009,45235,6,4,0,4,0
2020-03-28,Colusa,011,21464,3,2,0,2,0
2020-03-28,Contra Costa,013,1133247,418,350,0,350,4
2020-03-28,Del Norte,015,27424,0,0,0,0,0
2020-03-28,El Dorado,017,186661,31,18,0,18,0
2020-03-28,Fresno,019,978130,193,62,3,65,0
2020-03-28,Glenn,021,27897,2,2,0,2,0
2020-03-28,Humboldt,023,135768,46,18,0,18,0
2020-03-28,Imperial,025,180216,74,18,0,18,0
2020-03-28,Inyo,027,18085,9,0,0,0,0
2020-03-28,Kern,029,883053,213,40,0,40,0
2020-03-28,Kings,031,150075,29,2,1,3,0
2020-03-28,Lake,033,64148,0,0,0,0,0
2020-03-28,Lassen,035,31185,3,0,1,1,0
2020-03-28,Los Angeles,037,10098052,5415,3600,10,3610,64
2020-03-28,Madera,039,155013,43,22,0,22,2
2020-03-28,Marin,041,260295,120,116,0,116,0
2020-03-28,Mariposa,043,17540,0,0,0,0,0
2020-03-28,Mendocino,045,87422,5,4,0,4,0
2020-03-28,Merced,047,269075,27,8,0,8,0
2020-03-28,Modoc,049,8938,0,0,0,0,0
2020-03-28,Mono,051,14174,24,12,0,12,0
2020-03-28,Monterey,053,433212,72,64,0,64,2
2020-03-28,Napa,055,140530,27,10,0,10,0
2020-03-28,Nevada,057,99092,32,22,1,23,0
2020-03-28,Orange,059,3164182,1171,656,13,669,4
2020-03-28,Placer,061,380077,112,70,0,70,2
2020-03-28,Plumas,063,18699,1,0,0,0,0
2020-03-28,Riverside,065,2383286,1011,242,12,254,14
2020-03-28,Sacramento,067,1510023,528,406,0,406,14
2020-03-28,San Benito,069,59416,28,20,0,20,2
2020-03-28,San Bernardino,071,2135413,603,162,0,162,4
2020-03-28,San Diego,073,3302833,1380,980,0,980,14
2020-03-28,San Francisco,075,870044,646,600,0,600,6
2020-03-28,San Joaquin,077,732212,212,166,3,169,8
2020-03-28,San Luis Obispo,079,281455,117,104,0,104,0
2020-03-28,San Mateo,081,765935,672,462,2,464,17
2020-03-28,Santa Barbara,083,443738,194,98,1,99,0
2020-03-28,Santa Clara,085,1922200,1321,1174,3,1177,54
2020-03-28,Santa Cruz,087,273765,80,62,0,62,0
2020-03-28,Shasta,089,179085,20,8,0,8,2
2020-03-28,Sierra,091,2930,0,0,0,0,0
2020-03-28,Siskiyou,093,43540,4,4,0,4,0
2020-03-28,Solano,095,438530,99,96,0,96,0
2020-03-28,Sonoma,097,501317,141,70,0,70,2
2020-03-28,Stanislaus,099,539301,85,34,3,37,0
2020-03-28,Sutter,101,95872,17,6,0,6,0
2020-03-28,Tehama,103,63373,1,0,0,0,0
2020-03-28,Trinity,105,12862,0,0,0,0,0
2020-03-28,Tulare,107,460477,114,46,3,49,0
2020-03-28,Tuolumne,109,53932,2,2,0,2,0
2020-03-28,Ventura,111,848112,270,178,0,178,4
2020-03-28,Yolo,113,214977,52,26,0,26,2
2020-03-28,Yuba,115,75493,8,6,0,6,0
2020-03-27,Alameda,001,1643700,598,185,1,186,4
2020-03-27,Alpine,003,1148,1,0,0,0,0
2020-03-27,Amador,005,37829,4,1,0,1,0
2020-03-27,Butte,007,227075,12,4,0,4,0
2020-03-27,Calaveras,009,45235,6,2,0,2,0
2020-03-27,Colusa,011,21464,3,0,0,0,0
2020-03-27,Contra Costa,013,1133247,397,161,0,161,2
2020-03-27,Del Norte,015,27424,0,0,0,0,0
2020-03-27,El Dorado,017,186661,29,9,0,9,0
2020-03-27,Fresno,019,978130,181,29,2,31,0
2020-03-27,Glenn,021,27897,2,0,0,0,0
2020-03-27,Humboldt,023,135768,42,9,0,9,0
2020-03-27,Imperial,025,180216,69,9,0,9,0
2020-03-27,Inyo,027,18085,9,0,0,0,0
2020-03-27,Kern,029,883053,200,20,0,20,0
2020-03-27,Kings,031,150075,28,0,1,1,0
2020-03-27,Lake,033,64148,0,0,0,0,0
2020-03-27,Lassen,035,31185,3,0,1,1,0
2020-03-27,Los Angeles,037,10098052,5009,1474,10,1484,26
2020-03-27,Madera,039,155013,41,10,0,10,1
2020-03-27,Marin,041,260295,115,58,0,58,0
2020-03-27,Mariposa,043,17540,0,0,0,0,0
2020-03-27,Mendocino,045,87422,5,2,0,2,0
2020-03-27,Merced,047,269075,26,3,0,3,0
2020-03-27,Modoc,049,8938,0,0,0,0,0
2020-03-27,Mono,051,14174,24,6,0,6,0
2020-03-27,Monterey,053,433212,69,26,0,26,1
2020-03-27,Napa,055,140530,27,5,0,5,0
2020-03-27,Nevada,057,99092,32,6,1,7,0
2020-03-27,Orange,059,3164182,1121,299,13,312,2
2020-03-27,Placer,061,380077,109,33,0,33,1
2020-03-27,Plumas,063,18699,0,0,0,0,0
2020-03-27,Riverside,065,2383286,955,121,12,133,7
2020-03-27,Sacramento,067,1510023,505,163,0,163,6
2020-03-27,San Benito,069,59416,27,9,0,9,1
2020-03-27,San Bernardino,071,2135413,513,77,0,77,2
2020-03-27,San Diego,073,3302833,1323,419,0,419,5
2020-03-27,San Francisco,075,870044,621,285,0,285,2
2020-03-27,San Joaquin,077,732212,201,73,3,76,3
2020-03-27,San Luis Obispo,079,281455,115,46,0,46,0
2020-03-27,San Mateo,081,765935,646,213,2,215,7
2020-03-27,Santa Barbara,083,443738,180,37,1,38,0
2020-03-27,Santa Clara,085,1922200,1283,557,3,560,25
2020-03-27,Santa Cruz,087,273765,79,31,0,31,0
2020-03-27,Shasta,089,179085,17,3,0,3,1
2020-03-27,Sierra,091,2930,0,0,0,0,0
2020-03-27,Siskiyou,093,43540,4,2,0,2,0
2020-03-27,Solano,095,438530,93,48,0,48,0
2020-03-27,Sonoma,097,501317,133,35,0,35,1
2020-03-27,Stanislaus,099,539301,83,16,3,19,0
2020-03-27,Sutter,101,95872,16,2,0,2,0
2020-03-27,Tehama,103,63373,1,0,0,0,0
2020-03-27,Trinity,105,12862,0,0,0,0,0
2020-03-27,Tulare,107,460477,106,15,3,18,0
2020-03-27,Tuolumne,109,53932,2,1,0,1,0
2020-03-27,Ventura,111,848112,261,80,0,80,2
2020-03-27,Yolo,113,214977,51,13,0,13,1
2020-03-27,Yuba,115,75493,7,3,0,3,0
2020-03-26,Alameda,001,1643700,558,172,1,173,4
2020-03-26,Alpine,003,1148,1,0,0,0,0
2020-03-26,Amador,005,37829,4,1,0,1,0
2020-03-26,Butte,007,227075,12,4,0,4,0
2020-03-26,Calaveras,009,45235,6,2,0,2,0
2020-03-26,Colusa,011,21464,3,0,0,0,0
2020-03-26,Contra Costa,013,1133247,386,147,0,147,2
2020-03-26,Del Norte,015,27424,0,0,0,0,0
2020-03-26,El Dorado,017,186661,27,7,0,7,0
2020-03-26,Fresno,019,978130,172,25,2,27,0
2020-03-26,Glenn,021,27897,2,0,0,0,0
2020-03-26,Humboldt,023,135768,38,8,0,8,0
2020-03-26,Imperial,025,180216,65,8,0,8,0
2020-03-26,Inyo,027,18085,8,0,0,0,0
2020-03-26,Kern,029,883053,184,20,0,20,0
2020-03-26,Kings,031,150075,28,0,1,1,0
2020-03-26,Lake,033,64148,0,0,0,0,0
2020-03-26,Lassen,035,31185,3,0,1,1,0
2020-03-26,Los Angeles,037,10098052,4602,1075,10,1085,19
2020-03-26,Madera,039,155013,39,8,0,8,0
2020-03-26,Marin,041,260295,106,56,0,56,0
2020-03-26,Mariposa,043,17540,0,0,0,0,0
2020-03-26,Mendocino,045,87422,4,1,0,1,0
2020-03-26,Merced,047,269075,23,1,0,1,0
2020-03-26,Modoc,049,8938,0,0,0,0,0
2020-03-26,Mono,051,14174,23,5,0,5,0
2020-03-26,Monterey,053,433212,66,25,0,25,1
2020-03-26,Napa,055,140530,26,5,0,5,0
2020-03-26,Nevada,057,99092,32,7,1,8,0
2020-03-26,Orange,059,3164182,1059,279,11,290,1
2020-03-26,Placer,061,380077,106,34,0,34,1
2020-03-26,Plumas,063,18699,0,0,0,0,0
2020-03-26,Riverside,065,2383286,884,118,12,130,7
2020-03-26,Sacramento,067,1510023,472,147,0,147,5
2020-03-26,San Benito,069,59416,27,8,0,8,1
2020-03-26,San Bernardino,071,2135413,447,57,0,57,1
2020-03-26,San Diego,073,3302833,1256,299,0,299,2
2020-03-26,San Francisco,075,870044,594,261,0,261,1
2020-03-26,San Joaquin,077,732212,190,69,3,72,3
2020-03-26,San Luis Obispo,079,281455,110,38,0,38,0
2020-03-26,San Mateo,081,765935,612,122,2,124,5
2020-03-26,Santa Barbara,083,443738,167,33,1,34,0
2020-03-26,Santa Clara,085,1922200,1238,487,2,489,20
2020-03-26,Santa Cruz,087,273765,75,30,0,30,0
2020-03-26,Shasta,089,179085,17,3,0,3,1
2020-03-26,Sierra,091,2930,0,0,0,0,0
2020-03-26,Siskiyou,093,43540,4,2,0,2,0
2020-03-26,Solano,095,438530,85,41,0,41,0
2020-03-26,Sonoma,097,501317,128,33,0,33,1
2020-03-26,Stanislaus,099,539301,81,15,3,18,0
2020-03-26,Sutter,101,95872,12,2,0,2,0
2020-03-26,Tehama,103,63373,1,0,0,0,0
2020-03-26,Trinity,105,12862,0,0,0,0,0
2020-03-26,Tulare,107,460477,97,15,3,18,0
2020-03-26,Tuolumne,109,53932,2,0,0,0,0
2020-03-26,Ventura,111,848112,245,70,0,70,1
2020-03-26,Yolo,113,214977,47,13,0,13,1
2020-03-26,Yuba,115,75493,7,3,0,3,0
2020-03-25,Alameda,001,1643700,537,134,1,135,3
2020-03-25,Alpine,003,1148,1,0,0,0,0
2020-03-25,Amador,005,37829,4,1,0,1,0
2020-03-25,Butte,007,227075,12,4,0,4,0
2020-03-25,Calaveras,009,45235,6,2,0,2,0
2020-03-25,Colusa,011,21464,2,0,0,0,0
2020-03-25,Contra Costa,013,1133247,372,131,0,131,1
2020-03-25,Del Norte,015,27424,0,0,0,0,0
2020-03-25,El Dorado,017,186661,27,5,0,5,0
2020-03-25,Fresno,019,978130,152,21,2,23,0
2020-03-25,Glenn,021,27897,2,0,0,0,0
2020-03-25,Humboldt,023,135768,35,3,0,3,0
2020-03-25,Imperial,025,180216,57,8,0,8,0
2020-03-25,Inyo,027,18085,5,0,0,0,0
2020-03-25,Kern,029,883053,164,13,0,13,0
2020-03-25,Kings,031,150075,26,0,1,1,0
2020-03-25,Lake,033,64148,0,0,0,0,0
2020-03-25,Lassen,035,31185,3,0,1,1,0
2020-03-25,Los Angeles,037,10098052,4203,725,10,735,10
2020-03-25,Madera,039,155013,37,6,0,6,0
2020-03-25,Marin,041,260295,100,47,0,47,0
2020-03-25,Mariposa,043,17540,0,0,0,0,0
2020-03-25,Mendocino,045,87422,3,1,0,1,0
2020-03-25,Merced,047,269075,19,0,0,0,0
2020-03-25,Modoc,049,8938,0,0,0,0,0
2020-03-25,Mono,051,14174,22,4,0,4,0
2020-03-25,Monterey,053,433212,63,23,0,23,1
2020-03-25,Napa,055,140530,26,5,0,5,0
2020-03-25,Nevada,057,99092,31,5,1,6,0
2020-03-25,Orange,059,3164182,1001,214,9,223,1
2020-03-25,Placer,061,380077,100,30,0,30,1
2020-03-25,Plumas,063,18699,0,1,0,1,0
2020-03-25,Riverside,065,2383286,813,87,12,99,5
2020-03-25,Sacramento,067,1510023,446,114,0,114,5
2020-03-25,San Benito,069,59416,26,4,0,4,1
2020-03-25,San Bernardino,071,2135413,408,46,0,46,1
2020-03-25,San Diego,073,3302833,1194,238,0,238,2
2020-03-25,San Francisco,075,870044,553,212,0,212,1
2020-03-25,San Joaquin,077,732212,177,64,3,67,2
2020-03-25,San Luis Obispo,079,281455,105,35,0,35,0
2020-03-25,San Mateo,081,765935,577,111,2,113,5
2020-03-25,Santa Barbara,083,443738,157,25,1,26,0
2020-03-25,Santa Clara,085,1922200,1194,452,2,454,20
2020-03-25,Santa Cruz,087,273765,72,26,0,26,0
2020-03-25,Shasta,089,179085,16,3,0,3,1
2020-03-25,Sierra,091,2930,0,0,0,0,0
2020-03-25,Siskiyou,093,43540,4,2,0,2,0
2020-03-25,Solano,095,438530,80,39,0,39,0
2020-03-25,Sonoma,097,501317,123,31,0,31,1
2020-03-25,Stanislaus,099,539301,74,14,3,17,0
2020-03-25,Sutter,101,95872,9,1,0,1,0
2020-03-25,Tehama,103,63373,1,0,0,0,0
2020-03-25,Trinity,105,12862,0,0,0,0,0
2020-03-25,Tulare,107,460477,87,11,3,14,0
2020-03-25,Tuolumne,109,53932,2,0,0,0,0
2020-03-25,Ventura,111,848112,229,53,0,53,1
2020-03-25,Yolo,113,214977,45,9,0,9,1
2020-03-25,Yuba,115,75493,7,2,0,2,0
2020-03-24,Alameda,001,1643700,504,96,1,97,2
2020-03-24,Alpine,003,1148,1,0,0,0,0
2020-03-24,Amador,005,37829,2,1,0,1,0
2020-03-24,Butte,007,227075,11,3,0,3,0
2020-03-24,Calaveras,009,45235,5,2,0,2,0
2020-03-24,Colusa,011,21464,2,0,0,0,0
2020-03-24,Contra Costa,013,1133247,359,108,0,108,1
2020-03-24,Del Norte,015,27424,0,0,0,0,0
2020-03-24,El Dorado,017,186661,27,3,0,3,0
2020-03-24,Fresno,019,978130,133,18,2,20,0
2020-03-24,Glenn,021,27897,2,0,0,0,0
2020-03-24,Humboldt,023,135768,33,2,0,2,0
2020-03-24,Imperial,025,180216,54,3,0,3,0
2020-03-24,Inyo,027,18085,5,0,0,0,0
2020-03-24,Kern,029,883053,144,5,0,5,0
2020-03-24,Kings,031,150075,25,0,1,1,0
2020-03-24,Lake,033,64148,0,0,0,0,0
2020-03-24,Lassen,035,31185,3,0,1,1,0
2020-03-24,Los Angeles,037,10098052,3759,633,10,643,7
2020-03-24,Madera,039,155013,36,6,0,6,0
2020-03-24,Marin,041,260295,89,44,0,44,0
2020-03-24,Mariposa,043,17540,0,0,0,0,0
2020-03-24,Mendocino,045,87422,3,1,0,1,0
2020-03-24,Merced,047,269075,17,0,0,0,0
2020-03-24,Modoc,049,8938,0,0,0,0,0
2020-03-24,Mono,051,14174,21,1,0,1,0
2020-03-24,Monterey,053,433212,59,23,0,23,1
2020-03-24,Napa,055,140530,23,2,0,2,0
2020-03-24,Nevada,057,99092,30,4,1,5,0
2020-03-24,Orange,059,3164182,939,166,9,175,0
2020-03-24,Placer,061,380077,93,22,0,22,1
2020-03-24,Plumas,063,18699,0,1,0,1,0
2020-03-24,Riverside,065,2383286,746,56,12,68,5
2020-03-24,Sacramento,067,1510023,426,93,0,93,4
2020-03-24,San Benito,069,59416,25,4,0,4,1
2020-03-24,San Bernardino,071,2135413,364,27,0,27,0
2020-03-24,San Diego,073,3302833,1127,231,0,231,2
2020-03-24,San Francisco,075,870044,521,181,0,181,1
2020-03-24,San Joaquin,077,732212,166,52,3,55,2
2020-03-24,San Luis Obispo,079,281455,102,32,0,32,0
2020-03-24,San Mateo,081,765935,536,100,2,102,2
2020-03-24,Santa Barbara,083,443738,151,20,1,21,0
2020-03-24,Santa Clara,085,1922200,1125,389,2,391,17
2020-03-24,Santa Cruz,087,273765,67,22,0,22,0
2020-03-24,Shasta,089,179085,15,3,0,3,0
2020-03-24,Sierra,091,2930,0,0,0,0,0
2020-03-24,Siskiyou,093,43540,4,2,0,2,0
2020-03-24,Solano,095,438530,78,34,0,34,0
2020-03-24,Sonoma,097,501317,116,27,0,27,1
2020-03-24,Stanislaus,099,539301,65,13,3,16,0
2020-03-24,Sutter,101,95872,9,0,0,0,0
2020-03-24,Tehama,103,63373,1,0,0,0,0
2020-03-24,Trinity,105,12862,0,0,0,0,0
2020-03-24,Tulare,107,460477,77,10,3,13,0
2020-03-24,Tuolumne,109,53932,2,0,0,0,0
2020-03-24,Ventura,111,848112,213,44,0,44,1
2020-03-24,Yolo,113,214977,41,8,0,8,0
2020-03-24,Yuba,115,75493,7,2,0,2,0
2020-03-23,Alameda,001,1643700,473,88,1,89,1
2020-03-23,Alpine,003,1148,1,0,0,0,0
2020-03-23,Amador,005,37829,2,1,0,1,0
2020-03-23,Butte,007,227075,11,2,0,2,0
2020-03-23,Calaveras,009,45235,5,2,0,2,0
2020-03-23,Colusa,011,21464,1,0,0,0,0
2020-03-23,Contra Costa,013,1133247,339,91,0,91,2
2020-03-23,Del Norte,015,27424,0,0,0,0,0
2020-03-23,El Dorado,017,186661,26,3,0,3,0
2020-03-23,Fresno,019,978130,123,10,2,12,0
2020-03-23,Glenn,021,27897,2,0,0,0,0
2020-03-23,Humboldt,023,135768,31,2,0,2,0
2020-03-23,Imperial,025,180216,50,2,0,2,0
2020-03-23,Inyo,027,18085,3,0,0,0,0
2020-03-23,Kern,029,883053,130,5,0,5,0
2020-03-23,Kings,031,150075,25,0,1,1,0
2020-03-23,Lake,033,64148,0,0,0,0,0
2020-03-23,Lassen,035,31185,3,0,1,1,0
2020-03-23,Los Angeles,037,10098052,3451,389,10,399,4
2020-03-23,Madera,039,155013,36,4,0,4,0
2020-03-23,Marin,041,260295,84,30,0,30,0
2020-03-23,Mariposa,043,17540,0,0,0,0,0
2020-03-23,Mendocino,045,87422,3,1,0,1,0
2020-03-23,Merced,047,269075,11,0,0,0,0
2020-03-23,Modoc,049,8938,0,0,0,0,0
2020-03-23,Mono,051,14174,19,1,0,1,0
2020-03-23,Monterey,053,433212,54,14,0,14,1
2020-03-23,Napa,055,140530,21,1,0,1,0
2020-03-23,Nevada,057,99092,27,2,1,3,0
2020-03-23,Orange,059,3164182,884,138,7,145,0
2020-03-23,Placer,061,380077,90,19,0,19,1
2020-03-23,Plumas,063,18699,0,0,0,0,0
2020-03-23,Riverside,065,2383286,703,39,12,51,5
2020-03-23,Sacramento,067,1510023,393,87,0,87,4
2020-03-23,San Benito,069,59416,24,4,0,4,1
2020-03-23,San Bernardino,071,2135413,334,17,0,17,0
2020-03-23,San Diego,073,3302833,1068,178,0,178,1
2020-03-23,San Francisco,075,870044,492,152,0,152,0
2020-03-23,San Joaquin,077,732212,154,37,3,40,2
2020-03-23,San Luis Obispo,079,281455,96,23,0,23,0
2020-03-23,San Mateo,081,765935,497,88,2,90,1
2020-03-23,Santa Barbara,083,443738,133,18,1,19,0
2020-03-23,Santa Clara,085,1922200,1076,336,2,338,13
2020-03-23,Santa Cruz,087,273765,65,21,0,21,0
2020-03-23,Shasta,089,179085,13,2,0,2,0
2020-03-23,Sierra,091,2930,0,0,0,0,0
2020-03-23,Siskiyou,093,43540,4,2,0,2,0
2020-03-23,Solano,095,438530,74,33,0,33,0
2020-03-23,Sonoma,097,501317,104,19,0,19,1
2020-03-23,Stanislaus,099,539301,57,10,3,13,0
2020-03-23,Sutter,101,95872,9,0,0,0,0
2020-03-23,Tehama,103,63373,1,0,0,0,0
2020-03-23,Trinity,105,12862,0,0,0,0,0
2020-03-23,Tulare,107,460477,68,9,3,12,0
2020-03-23,Tuolumne,109,53932,2,0,0,0,0
2020-03-23,Ventura,111,848112,196,30,0,30,0
2020-03-23,Yolo,113,214977,40,8,0,8,0
2020-03-23,Yuba,115,75493,7,2,0,2,0
2020-03-22,Alameda,001,1643700,434,72,1,73,1
2020-03-22,Alpine,003,1148,1,0,0,0,0
2020-03-22,Amador,005,37829,2,1,0,1,0
2020-03-22,Butte,007,227075,8,1,0,1,0
2020-03-22,Calaveras,009,45235,4,2,0,2,0
2020-03-22,Colusa,011,21464,1,0,0,0,0
2020-03-22,Contra Costa,013,1133247,312,79,0,79,1
2020-03-22,Del Norte,015,27424,0,0,0,0,0
2020-03-22,El Dorado,017,186661,24,1,0,1,0
2020-03-22,Fresno,019,978130,103,8,2,10,0
2020-03-22,Glenn,021,27897,2,0,0,0,0
2020-03-22,Humboldt,023,135768,28,1,0,1,0
2020-03-22,Imperial,025,180216,48,2,0,2,0
2020-03-22,Inyo,027,18085,1,0,0,0,0
2020-03-22,Kern,029,883053,114,3,0,3,0
2020-03-22,Kings,031,150075,22,0,1,1,0
2020-03-22,Lake,033,64148,0,0,0,0,0
2020-03-22,Lassen,035,31185,3,0,1,1,0
2020-03-22,Los Angeles,037,10098052,3121,384,10,394,3
2020-03-22,Madera,039,155013,33,4,0,4,0
2020-03-22,Marin,041,260295,74,30,0,30,0
2020-03-22,Mariposa,043,17540,0,0,0,0,0
2020-03-22,Mendocino,045,87422,3,1,0,1,0
2020-03-22,Merced,047,269075,7,0,0,0,0
2020-03-22,Modoc,049,8938,0,0,0,0,0
2020-03-22,Mono,051,14174,14,1,0,1,0
2020-03-22,Monterey,053,433212,51,14,0,14,1
2020-03-22,Napa,055,140530,17,1,0,1,0
2020-03-22,Nevada,057,99092,23,2,1,3,0
2020-03-22,Orange,059,3164182,811,102,4,106,0
2020-03-22,Placer,061,380077,88,18,0,18,1
2020-03-22,Plumas,063,18699,0,0,0,0,0
2020-03-22,Riverside,065,2383286,613,26,8,34,5
2020-03-22,Sacramento,067,1510023,361,82,0,82,4
2020-03-22,San Benito,069,59416,19,4,0,4,1
2020-03-22,San Bernardino,071,2135413,290,16,0,16,0
2020-03-22,San Diego,073,3302833,980,161,0,161,0
2020-03-22,San Francisco,075,870044,455,134,0,134,0
2020-03-22,San Joaquin,077,732212,140,30,3,33,2
2020-03-22,San Luis Obispo,079,281455,89,19,0,19,0
2020-03-22,San Mateo,081,765935,464,82,2,84,1
2020-03-22,Santa Barbara,083,443738,119,16,1,17,0
2020-03-22,Santa Clara,085,1922200,1012,284,2,286,13
2020-03-22,Santa Cruz,087,273765,64,19,0,19,0
2020-03-22,Shasta,089,179085,13,1,0,1,0
2020-03-22,Sierra,091,2930,0,0,0,0,0
2020-03-22,Siskiyou,093,43540,4,2,0,2,0
2020-03-22,Solano,095,438530,65,30,0,30,0
2020-03-22,Sonoma,097,501317,99,18,0,18,1
2020-03-22,Stanislaus,099,539301,51,8,3,11,0
2020-03-22,Sutter,101,95872,8,0,0,0,0
2020-03-22,Tehama,103,63373,0,0,0,0,0
2020-03-22,Trinity,105,12862,0,0,0,0,0
2020-03-22,Tulare,107,460477,62,5,3,8,0
2020-03-22,Tuolumne,109,53932,2,0,0,0,0
2020-03-22,Ventura,111,848112,174,26,0,26,0
2020-03-22,Yolo,113,214977,34,6,0,6,0
2020-03-22,Yuba,115,75493,7,2,0,2,0
2020-03-21,Alameda,001,1643700,410,62,1,63,0
2020-03-21,Alpine,003,1148,1,0,0,0,0
2020-03-21,Amador,005,37829,2,1,0,1,0
2020-03-21,Butte,007,227075,7,1,0,1,0
2020-03-21,Calaveras,009,45235,4,2,0,2,0
2020-03-21,Colusa,011,21464,1,0,0,0,0
2020-03-21,Contra Costa,013,1133247,301,62,0,62,1
2020-03-21,Del Norte,015,27424,0,0,0,0,0
2020-03-21,El Dorado,017,186661,21,1,0,1,0
2020-03-21,Fresno,019,978130,99,8,2,10,0
2020-03-21,Glenn,021,27897,2,0,0,0,0
2020-03-21,Humboldt,023,135768,25,1,0,1,0
2020-03-21,Imperial,025,180216,44,2,0,2,0
2020-03-21,Inyo,027,18085,1,0,0,0,0
2020-03-21,Kern,029,883053,108,3,0,3,0
2020-03-21,Kings,031,150075,22,0,1,1,0
2020-03-21,Lake,033,64148,0,0,0,0,0
2020-03-21,Lassen,035,31185,3,0,1,1,0
2020-03-21,Los Angeles,037,10098052,2844,322,10,332,2
2020-03-21,Madera,039,155013,33,4,0,4,0
2020-03-21,Marin,041,260295,69,30,0,30,0
2020-03-21,Mariposa,043,17540,0,0,0,0,0
2020-03-21,Mendocino,045,87422,3,1,0,1,0
2020-03-21,Merced,047,269075,6,0,0,0,0
2020-03-21,Modoc,049,8938,0,0,0,0,0
2020-03-21,Mono,051,14174,14,1,0,1,0
2020-03-21,Monterey,053,433212,48,8,0,8,1
2020-03-21,Napa,055,140530,17,0,0,0,0
2020-03-21,Nevada,057,99092,23,2,1,3,0
2020-03-21,Orange,059,3164182,762,85,4,89,0
2020-03-21,Placer,061,380077,78,11,0,11,1
2020-03-21,Plumas,063,18699,0,0,0,0,0
2020-03-21,Riverside,065,2383286,566,20,8,28,3
2020-03-21,Sacramento,067,1510023,334,66,0,66,3
2020-03-21,San Benito,069,59416,17,4,0,4,1
2020-03-21,San Bernardino,071,2135413,270,13,0,13,0
2020-03-21,San Diego,073,3302833,903,121,0,121,0
2020-03-21,San Francisco,075,870044,419,106,0,106,0
2020-03-21,San Joaquin,077,732212,131,26,3,29,2
2020-03-21,San Luis Obispo,079,281455,84,16,0,16,0
2020-03-21,San Mateo,081,765935,426,78,2,80,1
2020-03-21,Santa Barbara,083,443738,109,8,1,9,0
2020-03-21,Santa Clara,085,1922200,950,269,2,271,10
2020-03-21,Santa Cruz,087,273765,62,17,0,17,0
2020-03-21,Shasta,089,179085,12,1,0,1,0
2020-03-21,Sierra,091,2930,0,0,0,0,0
2020-03-21,Siskiyou,093,43540,4,0,0,0,0
2020-03-21,Solano,095,438530,63,30,0,30,0
2020-03-21,Sonoma,097,501317,98,15,0,15,1
2020-03-21,Stanislaus,099,539301,45,7,3,10,0
2020-03-21,Sutter,101,95872,7,0,0,0,0
2020-03-21,Tehama,103,63373,0,0,0,0,0
2020-03-21,Trinity,105,12862,0,0,0,0,0
2020-03-21,Tulare,107,460477,54,5,3,8,0
2020-03-21,Tuolumne,109,53932,2,0,0,0,0
2020-03-21,Ventura,111,848112,166,22,0,22,0
2020-03-21,Yolo,113,214977,34,6,0,6,0
2020-03-21,Yuba,115,75493,7,1,0,1,0
2020-03-20,Alameda,001,1643700,389,42,1,43,0
2020-03-20,Alpine,003,1148,1,0,0,0,0
2020-03-20,Amador,005,37829,1,0,0,0,0
2020-03-20,Butte,007,227075,7,0,0,0,0
2020-03-20,Calaveras,009,45235,4,2,0,2,0
2020-03-20,Colusa,011,21464,1,0,0,0,0
2020-03-20,Contra Costa,013,1133247,271,52,0,52,1
2020-03-20,Del Norte,015,27424,0,0,0,0,0
2020-03-20,El Dorado,017,186661,20,1,0,1,0
2020-03-20,Fresno,019,978130,96,7,2,9,0
2020-03-20,Glenn,021,27897,1,0,0,0,0
2020-03-20,Humboldt,023,135768,25,1,0,1,0
2020-03-20,Imperial,025,180216,43,2,0,2,0
2020-03-20,Inyo,027,18085,0,0,0,0,0
2020-03-20,Kern,029,883053,93,3,0,3,0
2020-03-20,Kings,031,150075,21,0,1,1,0
2020-03-20,Lake,033,64148,0,0,0,0,0
2020-03-20,Lassen,035,31185,3,0,1,1,0
2020-03-20,Los Angeles,037,10098052,2615,267,9,276,1
2020-03-20,Madera,039,155013,32,4,0,4,0
2020-03-20,Marin,041,260295,66,30,0,30,0
2020-03-20,Mariposa,043,17540,0,0,0,0,0
2020-03-20,Mendocino,045,87422,3,1,0,1,0
2020-03-20,Merced,047,269075,6,0,0,0,0
2020-03-20,Modoc,049,8938,0,0,0,0,0
2020-03-20,Mono,051,14174,14,0,0,0,0
2020-03-20,Monterey,053,433212,47,4,0,4,0
2020-03-20,Napa,055,140530,16,0,0,0,0
2020-03-20,Nevada,057,99092,20,2,1,3,0
2020-03-20,Orange,059,3164182,715,71,4,75,2
2020-03-20,Placer,061,380077,72,9,0,9,1
2020-03-20,Plumas,063,18699,0,0,0,0,0
2020-03-20,Riverside,065,2383286,507,19,8,27,3
2020-03-20,Sacramento,067,1510023,313,56,0,56,4
2020-03-20,San Benito,069,59416,17,4,0,4,1
2020-03-20,San Bernardino,071,2135413,243,9,0,9,0
2020-03-20,San Diego,073,3302833,851,98,0,98,0
2020-03-20,San Francisco,075,870044,387,87,0,87,0
2020-03-20,San Joaquin,077,732212,116,18,3,21,2
2020-03-20,San Luis Obispo,079,281455,80,11,0,11,0
2020-03-20,San Mateo,081,765935,396,71,2,73,1
2020-03-20,Santa Barbara,083,443738,97,7,1,8,0
2020-03-20,Santa Clara,085,1922200,914,246,2,248,8
2020-03-20,Santa Cruz,087,273765,60,13,0,13,0
2020-03-20,Shasta,089,179085,11,1,0,1,0
2020-03-20,Sierra,091,2930,0,0,0,0,0
2020-03-20,Siskiyou,093,43540,4,0,0,0,0
2020-03-20,Solano,095,438530,59,29,0,29,0
2020-03-20,Sonoma,097,501317,90,7,0,7,0
2020-03-20,Stanislaus,099,539301,39,7,3,10,0
2020-03-20,Sutter,101,95872,7,0,0,0,0
2020-03-20,Tehama,103,63373,0,0,0,0,0
2020-03-20,Trinity,105,12862,0,0,0,0,0
2020-03-20,Tulare,107,460477,50,4,3,7,0
2020-03-20,Tuolumne,109,53932,2,0,0,0,0
2020-03-20,Ventura,111,848112,156,18,0,18,0
2020-03-20,Yolo,113,214977,32,5,0,5,0
2020-03-20,Yuba,115,75493,6,0,0,0,0
2020-03-19,Alameda,001,1643700,353,36,1,37,0
2020-03-19,Alpine,003,1148,1,0,0,0,0
2020-03-19,Amador,005,37829,1,0,0,0,0
2020-03-19,Butte,007,227075,5,0,0,0,0
2020-03-19,Calaveras,009,45235,4,2,0,2,0
2020-03-19,Colusa,011,21464,0,0,0,0,0
2020-03-19,Contra Costa,013,1133247,255,46,0,46,0
2020-03-19,Del Norte,015,27424,0,0,0,0,0
2020-03-19,El Dorado,017,186661,18,0,0,0,0
2020-03-19,Fresno,019,978130,87,6,2,8,0
2020-03-19,Glenn,021,27897,1,0,0,0,0
2020-03-19,Humboldt,023,135768,23,1,0,1,0
2020-03-19,Imperial,025,180216,36,2,0,2,0
2020-03-19,Inyo,027,18085,0,0,0,0,0
2020-03-19,Kern,029,883053,81,3,0,3,0
2020-03-19,Kings,031,150075,17,0,1,1,0
2020-03-19,Lake,033,64148,0,0,0,0,0
2020-03-19,Lassen,035,31185,2,0,1,1,0
2020-03-19,Los Angeles,037,10098052,2324,233,9,242,0
2020-03-19,Madera,039,155013,31,3,0,3,0
2020-03-19,Marin,041,260295,63,19,0,19,0
2020-03-19,Mariposa,043,17540,0,0,0,0,0
2020-03-19,Mendocino,045,87422,2,1,0,1,0
2020-03-19,Merced,047,269075,5,0,0,0,0
2020-03-19,Modoc,049,8938,0,0,0,0,0
2020-03-19,Mono,051,14174,12,0,0,0,0
2020-03-19,Monterey,053,433212,39,3,0,3,0
2020-03-19,Napa,055,140530,14,0,0,0,0
2020-03-19,Nevada,057,99092,18,2,1,3,0
2020-03-19,Orange,059,3164182,634,59,4,63,0
2020-03-19,Placer,061,380077,64,8,0,8,1
2020-03-19,Plumas,063,18699,0,0,0,0,0
2020-03-19,Riverside,065,2383286,396,14,6,20,3
2020-03-19,Sacramento,067,1510023,280,52,0,52,3
2020-03-19,San Benito,069,59416,14,3,0,3,0
2020-03-19,San Bernardino,071,2135413,213,7,0,7,0
2020-03-19,San Diego,073,3302833,768,68,0,68,0
2020-03-19,San Francisco,075,870044,351,80,0,80,0
2020-03-19,San Joaquin,077,732212,102,15,3,18,2
2020-03-19,San Luis Obispo,079,281455,77,6,0,6,0
2020-03-19,San Mateo,081,765935,361,58,2,60,1
2020-03-19,Santa Barbara,083,443738,85,5,0,5,0
2020-03-19,Santa Clara,085,1922200,847,183,2,185,8
2020-03-19,Santa Cruz,087,273765,57,13,0,13,0
2020-03-19,Shasta,089,179085,10,1,0,1,0
2020-03-19,Sierra,091,2930,0,0,0,0,0
2020-03-19,Siskiyou,093,43540,3,0,0,0,0
2020-03-19,Solano,095,438530,55,26,0,26,0
2020-03-19,Sonoma,097,501317,87,8,0,8,0
2020-03-19,Stanislaus,099,539301,38,7,3,10,0
2020-03-19,Sutter,101,95872,7,0,0,0,0
2020-03-19,Tehama,103,63373,0,0,0,0,0
2020-03-19,Trinity,105,12862,0,0,0,0,0
2020-03-19,Tulare,107,460477,44,3,3,6,0
2020-03-19,Tuolumne,109,53932,2,0,0,0,0
2020-03-19,Ventura,111,848112,134,15,0,15,0
2020-03-19,Yolo,113,214977,28,5,0,5,0
2020-03-19,Yuba,115,75493,5,0,0,0,0
2020-03-18,Alameda,001,1643700,325,29,1,30,0
2020-03-18,Alpine,003,1148,1,0,0,0,0
2020-03-18,Amador,005,37829,1,0,0,0,0
2020-03-18,Butte,007,227075,4,0,0,0,0
2020-03-18,Calaveras,009,45235,4,2,0,2,0
2020-03-18,Colusa,011,21464,0,0,0,0,0
2020-03-18,Contra Costa,013,1133247,233,44,0,44,0
2020-03-18,Del Norte,015,27424,0,0,0,0,0
2020-03-18,El Dorado,017,186661,17,0,0,0,0
2020-03-18,Fresno,019,978130,78,3,1,4,0
2020-03-18,Glenn,021,27897,1,0,0,0,0
2020-03-18,Humboldt,023,135768,19,1,0,1,0
2020-03-18,Imperial,025,180216,30,2,0,2,0
2020-03-18,Inyo,027,18085,0,0,0,0,0
2020-03-18,Kern,029,883053,66,1,0,1,0
2020-03-18,Kings,031,150075,15,0,1,1,0
2020-03-18,Lake,033,64148,0,0,0,0,0
2020-03-18,Lassen,035,31185,1,0,1,1,0
2020-03-18,Los Angeles,037,10098052,2078,47,9,56,0
2020-03-18,Madera,039,155013,30,2,0,2,0
2020-03-18,Marin,041,260295,58,10,0,10,0
2020-03-18,Mariposa,043,17540,0,0,0,0,0
2020-03-18,Mendocino,045,87422,2,0,0,0,0
2020-03-18,Merced,047,269075,5,0,0,0,0
2020-03-18,Modoc,049,8938,0,0,0,0,0
2020-03-18,Mono,051,14174,11,0,0,0,0
2020-03-18,Monterey,053,433212,31,1,0,1,0
2020-03-18,Napa,055,140530,11,0,0,0,0
2020-03-18,Nevada,057,99092,16,2,1,3,0
2020-03-18,Orange,059,3164182,576,38,4,42,0
2020-03-18,Placer,061,380077,57,8,0,8,1
2020-03-18,Plumas,063,18699,0,0,0,0,0
2020-03-18,Riverside,065,2383286,333,11,5,16,2
2020-03-18,Sacramento,067,1510023,257,46,0,46,3
2020-03-18,San Benito,069,59416,13,3,0,3,0
2020-03-18,San Bernardino,071,2135413,191,3,0,3,0
2020-03-18,San Diego,073,3302833,683,40,0,40,0
2020-03-18,San Francisco,075,870044,332,65,0,65,0
2020-03-18,San Joaquin,077,732212,90,14,3,17,2
2020-03-18,San Luis Obispo,079,281455,70,5,0,5,0
2020-03-18,San Mateo,081,765935,340,57,2,59,1
2020-03-18,Santa Barbara,083,443738,77,2,0,2,0
2020-03-18,Santa Clara,085,1922200,796,151,2,153,6
2020-03-18,Santa Cruz,087,273765,55,11,0,11,0
2020-03-18,Shasta,089,179085,9,1,0,1,0
2020-03-18,Sierra,091,2930,0,0,0,0,0
2020-03-18,Siskiyou,093,43540,3,0,0,0,0
2020-03-18,Solano,095,438530,51,26,0,26,0
2020-03-18,Sonoma,097,501317,78,6,0,6,0
2020-03-18,Stanislaus,099,539301,34,5,2,7,0
2020-03-18,Sutter,101,95872,5,0,0,0,0
2020-03-18,Tehama,103,63373,0,0,0,0,0
2020-03-18,Trinity,105,12862,0,0,0,0,0
2020-03-18,Tulare,107,460477,34,3,3,6,0
2020-03-18,Tuolumne,109,53932,2,0,0,0,0
2020-03-18,Ventura,111,848112,115,11,0,11,0
2020-03-18,Yolo,113,214977,25,4,0,4,0
2020-03-18,Yuba,115,75493,4,0,0,0,0
2020-03-17,Alameda,001,1643700,293,19,0,19,0
2020-03-17,Alpine,003,1148,0,0,0,0,0
2020-03-17,Amador,005,37829,1,0,0,0,0
2020-03-17,Butte,007,227075,4,0,0,0,0
2020-03-17,Calaveras,009,45235,4,2,0,2,0
2020-03-17,Colusa,011,21464,0,0,0,0,0
2020-03-17,Contra Costa,013,1133247,211,37,0,37,0
2020-03-17,Del Norte,015,27424,0,0,0,0,0
2020-03-17,El Dorado,017,186661,16,0,0,0,0
2020-03-17,Fresno,019,978130,68,2,1,3,0
2020-03-17,Glenn,021,27897,1,0,0,0,0
2020-03-17,Humboldt,023,135768,17,1,0,1,0
2020-03-17,Imperial,025,180216,24,2,0,2,0
2020-03-17,Inyo,027,18085,0,0,0,0,0
2020-03-17,Kern,029,883053,52,0,0,0,0
2020-03-17,Kings,031,150075,12,0,1,1,0
2020-03-17,Lake,033,64148,0,0,0,0,0
2020-03-17,Lassen,035,31185,1,0,1,1,0
2020-03-17,Los Angeles,037,10098052,1869,41,9,50,0
2020-03-17,Madera,039,155013,22,2,0,2,0
2020-03-17,Marin,041,260295,51,4,0,4,0
2020-03-17,Mariposa,043,17540,0,0,0,0,0
2020-03-17,Mendocino,045,87422,2,0,0,0,0
2020-03-17,Merced,047,269075,5,0,0,0,0
2020-03-17,Modoc,049,8938,0,0,0,0,0
2020-03-17,Mono,051,14174,9,0,0,0,0
2020-03-17,Monterey,053,433212,29,0,0,0,0
2020-03-17,Napa,055,140530,8,0,0,0,0
2020-03-17,Nevada,057,99092,15,1,1,2,0
2020-03-17,Orange,059,3164182,498,24,3,27,0
2020-03-17,Placer,061,380077,47,7,0,7,1
2020-03-17,Plumas,063,18699,0,0,0,0,0
2020-03-17,Riverside,065,2383286,271,11,5,16,0
2020-03-17,Sacramento,067,1510023,237,36,0,36,1
2020-03-17,San Benito,069,59416,12,2,0,2,0
2020-03-17,San Bernardino,071,2135413,163,2,0,2,0
2020-03-17,San Diego,073,3302833,616,17,0,17,0
2020-03-17,San Francisco,075,870044,305,46,0,46,0
2020-03-17,San Joaquin,077,732212,84,11,3,14,0
2020-03-17,San Luis Obispo,079,281455,62,1,0,1,0
2020-03-17,San Mateo,081,765935,308,46,2,48,1
2020-03-17,Santa Barbara,083,443738,65,0,0,0,0
2020-03-17,Santa Clara,085,1922200,738,121,2,123,4
2020-03-17,Santa Cruz,087,273765,52,10,0,10,0
2020-03-17,Shasta,089,179085,5,1,0,1,0
2020-03-17,Sierra,091,2930,0,0,0,0,0
2020-03-17,Siskiyou,093,43540,3,0,0,0,0
2020-03-17,Solano,095,438530,48,27,0,27,0
2020-03-17,Sonoma,097,501317,70,4,0,4,0
2020-03-17,Stanislaus,099,539301,31,4,2,6,0
2020-03-17,Sutter,101,95872,5,0,0,0,0
2020-03-17,Tehama,103,63373,0,0,0,0,0
2020-03-17,Trinity,105,12862,0,0,0,0,0
2020-03-17,Tulare,107,460477,29,2,3,5,0
2020-03-17,Tuolumne,109,53932,2,0,0,0,0
2020-03-17,Ventura,111,848112,98,7,0,7,0
2020-03-17,Yolo,113,214977,21,2,0,2,0
2020-03-17,Yuba,115,75493,4,0,0,0,0
2020-03-16,Alameda,001,1643700,264,17,0,17,0
2020-03-16,Alpine,003,1148,0,0,0,0,0
2020-03-16,Amador,005,37829,1,0,0,0,0
2020-03-16,Butte,007,227075,3,0,0,0,0
2020-03-16,Calaveras,009,45235,4,2,0,2,0
2020-03-16,Colusa,011,21464,0,0,0,0,0
2020-03-16,Contra Costa,013,1133247,187,36,0,36,0
2020-03-16,Del Norte,015,27424,0,0,0,0,0
2020-03-16,El Dorado,017,186661,15,0,0,0,0
2020-03-16,Fresno,019,978130,53,2,1,3,0
2020-03-16,Glenn,021,27897,0,0,0,0,0
2020-03-16,Humboldt,023,135768,13,1,0,1,0
2020-03-16,Imperial,025,180216,19,2,0,2,0
2020-03-16,Inyo,027,18085,0,0,0,0,0
2020-03-16,Kern,029,883053,43,0,0,0,0
2020-03-16,Kings,031,150075,11,0,1,1,0
2020-03-16,Lake,033,64148,0,0,0,0,0
2020-03-16,Lassen,035,31185,1,0,0,0,0
2020-03-16,Los Angeles,037,10098052,1631,43,9,52,0
2020-03-16,Madera,039,155013,21,2,0,2,0
2020-03-16,Marin,041,260295,48,4,0,4,0
2020-03-16,Mariposa,043,17540,0,0,0,0,0
2020-03-16,Mendocino,045,87422,2,0,0,0,0
2020-03-16,Merced,047,269075,5,0,0,0,0
2020-03-16,Modoc,049,8938,0,0,0,0,0
2020-03-16,Mono,051,14174,7,0,0,0,0
2020-03-16,Monterey,053,433212,28,0,0,0,0
2020-03-16,Napa,055,140530,7,0,0,0,0
2020-03-16,Nevada,057,99092,11,1,1,2,0
2020-03-16,Orange,059,3164182,415,18,3,21,0
2020-03-16,Placer,061,380077,39,7,0,7,1
2020-03-16,Plumas,063,18699,0,0,0,0,0
2020-03-16,Riverside,065,2383286,235,10,5,15,0
2020-03-16,Sacramento,067,1510023,210,34,0,34,1
2020-03-16,San Benito,069,59416,8,2,0,2,0
2020-03-16,San Bernardino,071,2135413,143,1,0,1,0
2020-03-16,San Diego,073,3302833,525,17,0,17,0
2020-03-16,San Francisco,075,870044,267,40,0,40,0
2020-03-16,San Joaquin,077,732212,74,9,3,12,0
2020-03-16,San Luis Obispo,079,281455,55,1,0,1,0
2020-03-16,San Mateo,081,765935,269,42,2,44,1
2020-03-16,Santa Barbara,083,443738,55,0,0,0,0
2020-03-16,Santa Clara,085,1922200,658,115,1,116,2
2020-03-16,Santa Cruz,087,273765,45,9,0,9,0
2020-03-16,Shasta,089,179085,5,1,0,1,0
2020-03-16,Sierra,091,2930,0,0,0,0,0
2020-03-16,Siskiyou,093,43540,2,0,0,0,0
2020-03-16,Solano,095,438530,43,27,0,27,0
2020-03-16,Sonoma,097,501317,62,4,0,4,0
2020-03-16,Stanislaus,099,539301,27,2,2,4,0
2020-03-16,Sutter,101,95872,3,0,0,0,0
2020-03-16,Tehama,103,63373,0,0,0,0,0
2020-03-16,Trinity,105,12862,0,0,0,0,0
2020-03-16,Tulare,107,460477,25,2,3,5,0
2020-03-16,Tuolumne,109,53932,2,0,0,0,0
2020-03-16,Ventura,111,848112,88,7,0,7,0
2020-03-16,Yolo,113,214977,19,2,0,2,0
2020-03-16,Yuba,115,75493,3,0,0,0,0
2020-03-15,Alameda,001,1643700,216,17,0,17,0
2020-03-15,Alpine,003,1148,0,0,0,0,0
2020-03-15,Amador,005,37829,1,0,0,0,0
2020-03-15,Butte,007,227075,3,0,0,0,0
2020-03-15,Calaveras,009,45235,2,2,0,2,0
2020-03-15,Colusa,011,21464,0,0,0,0,0
2020-03-15,Contra Costa,013,1133247,162,34,0,34,0
2020-03-15,Del Norte,015,27424,0,0,0,0,0
2020-03-15,El Dorado,017,186661,14,0,0,0,0
2020-03-15,Fresno,019,978130,33,1,1,2,0
2020-03-15,Glenn,021,27897,0,0,0,0,0
2020-03-15,Humboldt,023,135768,11,1,0,1,0
2020-03-15,Imperial,025,180216,14,2,0,2,0
2020-03-15,Inyo,027,18085,0,0,0,0,0
2020-03-15,Kern,029,883053,37,0,0,0,0
2020-03-15,Kings,031,150075,11,0,1,1,0
2020-03-15,Lake,033,64148,0,0,0,0,0
2020-03-15,Lassen,035,31185,1,0,0,0,0
2020-03-15,Los Angeles,037,10098052,1382,41,9,50,0
2020-03-15,Madera,039,155013,20,2,0,2,0
2020-03-15,Marin,041,260295,41,3,0,3,0
2020-03-15,Mariposa,043,17540,0,0,0,0,0
2020-03-15,Mendocino,045,87422,2,0,0,0,0
2020-03-15,Merced,047,269075,3,0,0,0,0
2020-03-15,Modoc,049,8938,0,0,0,0,0
2020-03-15,Mono,051,14174,6,0,0,0,0
2020-03-15,Monterey,053,433212,21,0,0,0,0
2020-03-15,Napa,055,140530,7,0,0,0,0
2020-03-15,Nevada,057,99092,11,0,1,1,0
2020-03-15,Orange,059,3164182,347,16,1,17,0
2020-03-15,Placer,061,380077,33,7,0,7,1
2020-03-15,Plumas,063,18699,0,0,0,0,0
2020-03-15,Riverside,065,2383286,183,10,5,15,0
2020-03-15,Sacramento,067,1510023,174,30,0,30,1
2020-03-15,San Benito,069,59416,8,2,0,2,0
2020-03-15,San Bernardino,071,2135413,121,0,0,0,0
2020-03-15,San Diego,073,3302833,438,16,0,16,0
2020-03-15,San Francisco,075,870044,209,31,0,31,0
2020-03-15,San Joaquin,077,732212,63,6,3,9,0
2020-03-15,San Luis Obispo,079,281455,45,1,0,1,0
2020-03-15,San Mateo,081,765935,235,29,1,30,1
2020-03-15,Santa Barbara,083,443738,46,0,0,0,0
2020-03-15,Santa Clara,085,1922200,586,79,1,80,2
2020-03-15,Santa Cruz,087,273765,38,8,0,8,0
2020-03-15,Shasta,089,179085,5,1,0,1,0
2020-03-15,Sierra,091,2930,0,0,0,0,0
2020-03-15,Siskiyou,093,43540,2,0,0,0,0
2020-03-15,Solano,095,438530,42,26,0,26,0
2020-03-15,Sonoma,097,501317,53,4,0,4,0
2020-03-15,Stanislaus,099,539301,26,2,2,4,0
2020-03-15,Sutter,101,95872,2,0,0,0,0
2020-03-15,Tehama,103,63373,0,0,0,0,0
2020-03-15,Trinity,105,12862,0,0,0,0,0
2020-03-15,Tulare,107,460477,19,2,3,5,0
2020-03-15,Tuolumne,109,53932,1,0,0,0,0
2020-03-15,Ventura,111,848112,77,5,0,5,0
2020-03-15,Yolo,113,214977,15,2,0,2,0
2020-03-15,Yuba,115,75493,2,0,0,0,0
2020-03-14,Alameda,001,1643700,197,11,0,11,0
2020-03-14,Alpine,003,1148,0,0,0,0,0
2020-03-14,Amador,005,37829,1,0,0,0,0
2020-03-14,Butte,007,227075,2,0,0,0,0
2020-03-14,Calaveras,009,45235,2,2,0,2,0
2020-03-14,Colusa,011,21464,0,0,0,0,0
2020-03-14,Contra Costa,013,1133247,140,30,0,30,0
2020-03-14,Del Norte,015,27424,0,0,0,0,0
2020-03-14,El Dorado,017,186661,12,0,0,0,0
2020-03-14,Fresno,019,978130,25,1,1,2,0
2020-03-14,Glenn,021,27897,0,0,0,0,0
2020-03-14,Humboldt,023,135768,7,1,0,1,0
2020-03-14,Imperial,025,180216,10,2,0,2,0
2020-03-14,Inyo,027,18085,0,0,0,0,0
2020-03-14,Kern,029,883053,32,0,0,0,0
2020-03-14,Kings,031,150075,11,0,1,1,0
2020-03-14,Lake,033,64148,0,0,0,0,0
2020-03-14,Lassen,035,31185,1,0,0,0,0
2020-03-14,Los Angeles,037,10098052,1200,35,9,44,0
2020-03-14,Madera,039,155013,19,2,0,2,0
2020-03-14,Marin,041,260295,37,3,0,3,0
2020-03-14,Mariposa,043,17540,0,0,0,0,0
2020-03-14,Mendocino,045,87422,2,0,0,0,0
2020-03-14,Merced,047,269075,3,0,0,0,0
2020-03-14,Modoc,049,8938,0,0,0,0,0
2020-03-14,Mono,051,14174,5,0,0,0,0
2020-03-14,Monterey,053,433212,15,0,0,0,0
2020-03-14,Napa,055,140530,5,0,0,0,0
2020-03-14,Nevada,057,99092,8,0,1,1,0
2020-03-14,Orange,059,3164182,308,14,0,14,0
2020-03-14,Placer,061,380077,29,6,0,6,1
2020-03-14,Plumas,063,18699,0,0,0,0,0
2020-03-14,Riverside,065,2383286,163,10,5,15,0
2020-03-14,Sacramento,067,1510023,152,31,0,31,1
2020-03-14,San Benito,069,59416,8,2,0,2,0
2020-03-14,San Bernardino,071,2135413,102,0,0,0,0
2020-03-14,San Diego,073,3302833,363,10,0,10,0
2020-03-14,San Francisco,075,870044,188,29,0,29,0
2020-03-14,San Joaquin,077,732212,54,6,3,9,0
2020-03-14,San Luis Obispo,079,281455,40,0,0,0,0
2020-03-14,San Mateo,081,765935,212,27,1,28,0
2020-03-14,Santa Barbara,083,443738,37,0,0,0,0
2020-03-14,Santa Clara,085,1922200,531,62,1,63,2
2020-03-14,Santa Cruz,087,273765,33,8,0,8,0
2020-03-14,Shasta,089,179085,5,1,0,1,0
2020-03-14,Sierra,091,2930,0,0,0,0,0
2020-03-14,Siskiyou,093,43540,1,0,0,0,0
2020-03-14,Solano,095,438530,40,26,0,26,0
2020-03-14,Sonoma,097,501317,40,2,0,2,0
2020-03-14,Stanislaus,099,539301,22,2,2,4,0
2020-03-14,Sutter,101,95872,2,0,0,0,0
2020-03-14,Tehama,103,63373,0,0,0,0,0
2020-03-14,Trinity,105,12862,0,0,0,0,0
2020-03-14,Tulare,107,460477,17,2,2,4,0
2020-03-14,Tuolumne,109,53932,1,0,0,0,0
2020-03-14,Ventura,111,848112,68,5,0,5,0
2020-03-14,Yolo,113,214977,15,2,0,2,0
2020-03-14,Yuba,115,75493,1,0,0,0,0
2020-03-13,Alameda,001,1643700,178,12,0,12,0
2020-03-13,Alpine,003,1148,0,0,0,0,0
2020-03-13,Amador,005,37829,1,0,0,0,0
2020-03-13,Butte,007,227075,0,0,0,0,0
2020-03-13,Calaveras,009,45235,2,2,0,2,0
2020-03-13,Colusa,011,21464,0,0,0,0,0
2020-03-13,Contra Costa,013,1133247,126,22,0,22,0
2020-03-13,Del Norte,015,27424,0,0,0,0,0
2020-03-13,El Dorado,017,186661,11,0,0,0,0
2020-03-13,Fresno,019,978130,20,1,1,2,0
2020-03-13,Glenn,021,27897,0,0,0,0,0
2020-03-13,Humboldt,023,135768,7,1,0,1,0
2020-03-13,Imperial,025,180216,9,2,0,2,0
2020-03-13,Inyo,027,18085,0,0,0,0,0
2020-03-13,Kern,029,883053,27,0,0,0,0
2020-03-13,Kings,031,150075,10,0,1,1,0
2020-03-13,Lake,033,64148,0,0,0,0,0
2020-03-13,Lassen,035,31185,1,0,0,0,0
2020-03-13,Los Angeles,037,10098052,1043,30,7,37,0
2020-03-13,Madera,039,155013,18,1,0,1,0
2020-03-13,Marin,041,260295,34,3,0,3,0
2020-03-13,Mariposa,043,17540,0,0,0,0,0
2020-03-13,Mendocino,045,87422,2,0,0,0,0
2020-03-13,Merced,047,269075,2,0,0,0,0
2020-03-13,Modoc,049,8938,0,0,0,0,0
2020-03-13,Mono,051,14174,3,0,0,0,0
2020-03-13,Monterey,053,433212,10,0,0,0,0
2020-03-13,Napa,055,140530,3,0,0,0,0
2020-03-13,Nevada,057,99092,7,0,1,1,0
2020-03-13,Orange,059,3164182,268,10,0,10,0
2020-03-13,Placer,061,380077,27,6,0,6,1
2020-03-13,Plumas,063,18699,0,0,0,0,0
2020-03-13,Riverside,065,2383286,133,5,4,9,0
2020-03-13,Sacramento,067,1510023,130,18,0,18,1
2020-03-13,San Benito,069,59416,6,2,0,2,0
2020-03-13,San Bernardino,071,2135413,96,0,0,0,0
2020-03-13,San Diego,073,3302833,313,8,0,8,0
2020-03-13,San Francisco,075,870044,174,28,0,28,0
2020-03-13,San Joaquin,077,732212,50,6,3,9,0
2020-03-13,San Luis Obispo,079,281455,33,0,0,0,0
2020-03-13,San Mateo,081,765935,191,24,1,25,0
2020-03-13,Santa Barbara,083,443738,33,0,0,0,0
2020-03-13,Santa Clara,085,1922200,469,59,1,60,1
2020-03-13,Santa Cruz,087,273765,32,7,0,7,0
2020-03-13,Shasta,089,179085,3,1,0,1,0
2020-03-13,Sierra,091,2930,0,0,0,0,0
2020-03-13,Siskiyou,093,43540,0,0,0,0,0
2020-03-13,Solano,095,438530,39,26,0,26,0
2020-03-13,Sonoma,097,501317,39,2,0,2,0
2020-03-13,Stanislaus,099,539301,17,2,2,4,0
2020-03-13,Sutter,101,95872,2,0,0,0,0
2020-03-13,Tehama,103,63373,0,0,0,0,0
2020-03-13,Trinity,105,12862,0,0,0,0,0
2020-03-13,Tulare,107,460477,14,2,2,4,0
2020-03-13,Tuolumne,109,53932,1,0,0,0,0
2020-03-13,Ventura,111,848112,54,5,0,5,0
2020-03-13,Yolo,113,214977,14,1,0,1,0
2020-03-13,Yuba,115,75493,1,0,0,0,0
2020-03-12,Alameda,001,1643700,152,9,0,9,0
2020-03-12,Alpine,003,1148,0,0,0,0,0
2020-03-12,Amador,005,37829,1,0,0,0,0
2020-03-12,Butte,007,227075,0,0,0,0,0
2020-03-12,Calaveras,009,45235,2,2,0,2,0
2020-03-12,Colusa,011,21464,0,0,0,0,0
2020-03-12,Contra Costa,013,1133247,109,18,0,18,0
2020-03-12,Del Norte,015,27424,0,0,0,0,0
2020-03-12,El Dorado,017,186661,9,0,0,0,0
2020-03-12,Fresno,019,978130,12,1,1,2,0
2020-03-12,Glenn,021,27897,0,0,0,0,0
2020-03-12,Humboldt,023,135768,6,1,0,1,0
2020-03-12,Imperial,025,180216,8,2,0,2,0
2020-03-12,Inyo,027,18085,0,0,0,0,0
2020-03-12,Kern,029,883053,18,0,0,0,0
2020-03-12,Kings,031,150075,7,0,1,1,0
2020-03-12,Lake,033,64148,0,0,0,0,0
2020-03-12,Lassen,035,31185,1,0,0,0,0
2020-03-12,Los Angeles,037,10098052,879,30,7,37,0
2020-03-12,Madera,039,155013,15,1,0,1,0
2020-03-12,Marin,041,260295,24,1,0,1,0
2020-03-12,Mariposa,043,17540,0,0,0,0,0
2020-03-12,Mendocino,045,87422,2,0,0,0,0
2020-03-12,Merced,047,269075,2,0,0,0,0
2020-03-12,Modoc,049,8938,0,0,0,0,0
2020-03-12,Mono,051,14174,3,0,0,0,0
2020-03-12,Monterey,053,433212,8,0,0,0,0
2020-03-12,Napa,055,140530,3,0,0,0,0
2020-03-12,Nevada,057,99092,4,0,1,1,0
2020-03-12,Orange,059,3164182,231,7,0,7,0
2020-03-12,Placer,061,380077,23,6,0,6,1
2020-03-12,Plumas,063,18699,0,0,0,0,0
2020-03-12,Riverside,065,2383286,107,5,2,7,0
2020-03-12,Sacramento,067,1510023,106,17,0,17,1
2020-03-12,San Benito,069,59416,5,2,0,2,0
2020-03-12,San Bernardino,071,2135413,80,0,0,0,0
2020-03-12,San Diego,073,3302833,258,9,0,9,0
2020-03-12,San Francisco,075,870044,149,20,0,20,0
2020-03-12,San Joaquin,077,732212,44,3,3,6,1
2020-03-12,San Luis Obispo,079,281455,26,0,0,0,0
2020-03-12,San Mateo,081,765935,157,21,1,22,0
2020-03-12,Santa Barbara,083,443738,22,0,0,0,0
2020-03-12,Santa Clara,085,1922200,411,51,1,52,1
2020-03-12,Santa Cruz,087,273765,29,5,0,5,0
2020-03-12,Shasta,089,179085,2,1,0,1,0
2020-03-12,Sierra,091,2930,0,0,0,0,0
2020-03-12,Siskiyou,093,43540,0,0,0,0,0
2020-03-12,Solano,095,438530,34,26,0,26,0
2020-03-12,Sonoma,097,501317,34,2,0,2,0
2020-03-12,Stanislaus,099,539301,15,2,2,4,0
2020-03-12,Sutter,101,95872,0,0,0,0,0
2020-03-12,Tehama,103,63373,0,0,0,0,0
2020-03-12,Trinity,105,12862,0,0,0,0,0
2020-03-12,Tulare,107,460477,12,1,1,2,0
2020-03-12,Tuolumne,109,53932,1,0,0,0,0
2020-03-12,Ventura,111,848112,45,3,0,3,0
2020-03-12,Yolo,113,214977,13,1,0,1,0
2020-03-12,Yuba,115,75493,1,0,0,0,0
2020-03-11,Alameda,001,1643700,120,5,0,5,0
2020-03-11,Alpine,003,1148,0,0,0,0,0
2020-03-11,Amador,005,37829,1,0,0,0,0
2020-03-11,Butte,007,227075,0,0,0,0,0
2020-03-11,Calaveras,009,45235,2,2,0,2,0
2020-03-11,Colusa,011,21464,0,0,0,0,0
2020-03-11,Contra Costa,013,1133247,94,16,0,16,0
2020-03-11,Del Norte,015,27424,0,0,0,0,0
2020-03-11,El Dorado,017,186661,8,0,0,0,0
2020-03-11,Fresno,019,978130,9,1,1,2,0
2020-03-11,Glenn,021,27897,0,0,0,0,0
2020-03-11,Humboldt,023,135768,6,1,0,1,0
2020-03-11,Imperial,025,180216,6,0,0,0,0
2020-03-11,Inyo,027,18085,0,0,0,0,0
2020-03-11,Kern,029,883053,16,0,0,0,0
2020-03-11,Kings,031,150075,5,0,1,1,0
2020-03-11,Lake,033,64148,0,0,0,0,0
2020-03-11,Lassen,035,31185,1,0,0,0,0
2020-03-11,Los Angeles,037,10098052,707,21,7,28,0
2020-03-11,Madera,039,155013,12,1,0,1,0
2020-03-11,Marin,041,260295,17,1,0,1,0
2020-03-11,Mariposa,043,17540,0,0,0,0,0
2020-03-11,Mendocino,045,87422,1,0,0,0,0
2020-03-11,Merced,047,269075,2,0,0,0,0
2020-03-11,Modoc,049,8938,0,0,0,0,0
2020-03-11,Mono,051,14174,3,0,0,0,0
2020-03-11,Monterey,053,433212,7,0,0,0,0
2020-03-11,Napa,055,140530,2,0,0,0,0
2020-03-11,Nevada,057,99092,4,0,1,1,0
2020-03-11,Orange,059,3164182,202,6,0,6,0
2020-03-11,Placer,061,380077,18,6,0,6,1
2020-03-11,Plumas,063,18699,0,0,0,0,0
2020-03-11,Riverside,065,2383286,81,4,1,5,0
2020-03-11,Sacramento,067,1510023,88,9,0,9,1
2020-03-11,San Benito,069,59416,5,2,0,2,0
2020-03-11,San Bernardino,071,2135413,73,0,0,0,0
2020-03-11,San Diego,073,3302833,208,4,0,4,0
2020-03-11,San Francisco,075,870044,124,17,0,17,0
2020-03-11,San Joaquin,077,732212,33,1,3,4,0
2020-03-11,San Luis Obispo,079,281455,23,0,0,0,0
2020-03-11,San Mateo,081,765935,139,16,0,16,0
2020-03-11,Santa Barbara,083,443738,13,0,0,0,0
2020-03-11,Santa Clara,085,1922200,370,48,1,49,1
2020-03-11,Santa Cruz,087,273765,26,2,0,2,0
2020-03-11,Shasta,089,179085,2,1,0,1,0
2020-03-11,Sierra,091,2930,0,0,0,0,0
2020-03-11,Siskiyou,093,43540,0,0,0,0,0
2020-03-11,Solano,095,438530,29,26,0,26,0
2020-03-11,Sonoma,097,501317,30,2,0,2,0
2020-03-11,Stanislaus,099,539301,15,2,2,4,0
2020-03-11,Sutter,101,95872,0,0,0,0,0
2020-03-11,Tehama,103,63373,0,0,0,0,0
2020-03-11,Trinity,105,12862,0,0,0,0,0
2020-03-11,Tulare,107,460477,10,0,1,1,0
2020-03-11,Tuolumne,109,53932,1,0,0,0,0
2020-03-11,Ventura,111,848112,37,3,0,3,0
2020-03-11,Yolo,113,214977,9,1,0,1,0
2020-03-11,Yuba,115,75493,1,0,0,0,0
2020-03-10,Alameda,001,1643700,99,4,0,4,0
2020-03-10,Alpine,003,1148,0,0,0,0,0
2020-03-10,Amador,005,37829,1,0,0,0,0
2020-03-10,Butte,007,227075,0,0,0,0,0
2020-03-10,Calaveras,009,45235,2,2,0,2,0
2020-03-10,Colusa,011,21464,0,0,0,0,0
2020-03-10,Contra Costa,013,1133247,84,11,0,11,0
2020-03-10,Del Norte,015,27424,0,0,0,0,0
2020-03-10,El Dorado,017,186661,7,0,0,0,0
2020-03-10,Fresno,019,978130,7,1,1,2,0
2020-03-10,Glenn,021,27897,0,0,0,0,0
2020-03-10,Humboldt,023,135768,6,1,0,1,0
2020-03-10,Imperial,025,180216,5,0,0,0,0
2020-03-10,Inyo,027,18085,0,0,0,0,0
2020-03-10,Kern,029,883053,11,0,0,0,0
2020-03-10,Kings,031,150075,5,0,1,1,0
2020-03-10,Lake,033,64148,0,0,0,0,0
2020-03-10,Lassen,035,31185,1,0,0,0,0
2020-03-10,Los Angeles,037,10098052,571,20,7,27,0
2020-03-10,Madera,039,155013,7,1,0,1,0
2020-03-10,Marin,041,260295,16,1,0,1,0
2020-03-10,Mariposa,043,17540,0,0,0,0,0
2020-03-10,Mendocino,045,87422,0,0,0,0,0
2020-03-10,Merced,047,269075,2,0,0,0,0
2020-03-10,Modoc,049,8938,0,0,0,0,0
2020-03-10,Mono,051,14174,3,0,0,0,0
2020-03-10,Monterey,053,433212,5,0,0,0,0
2020-03-10,Napa,055,140530,2,0,0,0,0
2020-03-10,Nevada,057,99092,3,0,1,1,0
2020-03-10,Orange,059,3164182,182,5,0,5,1
2020-03-10,Placer,061,380077,14,7,0,7,1
2020-03-10,Plumas,063,18699,0,0,0,0,0
2020-03-10,Riverside,065,2383286,59,4,1,5,0
2020-03-10,Sacramento,067,1510023,79,8,0,8,0
2020-03-10,San Benito,069,59416,5,2,0,2,0
2020-03-10,San Bernardino,071,2135413,65,0,0,0,0
2020-03-10,San Diego,073,3302833,165,3,0,3,0
2020-03-10,San Francisco,075,870044,92,16,0,16,0
2020-03-10,San Joaquin,077,732212,30,1,3,4,0
2020-03-10,San Luis Obispo,079,281455,15,0,0,0,0
2020-03-10,San Mateo,081,765935,123,11,0,11,0
2020-03-10,Santa Barbara,083,443738,10,0,0,0,0
2020-03-10,Santa Clara,085,1922200,322,45,1,46,1
2020-03-10,Santa Cruz,087,273765,22,2,0,2,0
2020-03-10,Shasta,089,179085,2,1,0,1,0
2020-03-10,Sierra,091,2930,0,0,0,0,0
2020-03-10,Siskiyou,093,43540,0,0,0,0,0
2020-03-10,Solano,095,438530,27,26,0,26,0
2020-03-10,Sonoma,097,501317,27,2,0,2,0
2020-03-10,Stanislaus,099,539301,11,0,2,2,0
2020-03-10,Sutter,101,95872,0,0,0,0,0
2020-03-10,Tehama,103,63373,0,0,0,0,0
2020-03-10,Trinity,105,12862,0,0,0,0,0
2020-03-10,Tulare,107,460477,9,0,1,1,0
2020-03-10,Tuolumne,109,53932,1,0,0,0,0
2020-03-10,Ventura,111,848112,29,1,0,1,0
2020-03-10,Yolo,113,214977,6,2,0,2,0
2020-03-10,Yuba,115,75493,1,0,0,0,0
2020-03-09,Alameda,001,1643700,71,4,0,4,0
2020-03-09,Alpine,003,1148,0,0,0,0,0
2020-03-09,Amador,005,37829,0,0,0,0,0
2020-03-09,Butte,007,227075,0,0,0,0,0
2020-03-09,Calaveras,009,45235,2,0,0,0,0
2020-03-09,Colusa,011,21464,0,0,0,0,0
2020-03-09,Contra Costa,013,1133247,72,9,0,9,0
2020-03-09,Del Norte,015,27424,0,0,0,0,0
2020-03-09,El Dorado,017,186661,5,0,0,0,0
2020-03-09,Fresno,019,978130,7,1,1,2,0
2020-03-09,Glenn,021,27897,0,0,0,0,0
2020-03-09,Humboldt,023,135768,5,1,0,1,0
2020-03-09,Imperial,025,180216,5,0,0,0,0
2020-03-09,Inyo,027,18085,0,0,0,0,0
2020-03-09,Kern,029,883053,8,0,0,0,0
2020-03-09,Kings,031,150075,4,0,1,1,0
2020-03-09,Lake,033,64148,0,0,0,0,0
2020-03-09,Lassen,035,31185,1,0,0,0,0
2020-03-09,Los Angeles,037,10098052,466,17,6,23,0
2020-03-09,Madera,039,155013,7,1,0,1,0
2020-03-09,Marin,041,260295,15,1,0,1,0
2020-03-09,Mariposa,043,17540,0,0,0,0,0
2020-03-09,Mendocino,045,87422,0,0,0,0,0
2020-03-09,Merced,047,269075,2,0,0,0,0
2020-03-09,Modoc,049,8938,0,0,0,0,0
2020-03-09,Mono,051,14174,3,0,0,0,0
2020-03-09,Monterey,053,433212,3,0,0,0,0
2020-03-09,Napa,055,140530,2,0,0,0,0
2020-03-09,Nevada,057,99092,2,0,1,1,0
2020-03-09,Orange,059,3164182,154,4,0,4,0
2020-03-09,Placer,061,380077,12,7,0,7,1
2020-03-09,Plumas,063,18699,0,0,0,0,0
2020-03-09,Riverside,065,2383286,49,4,1,5,0
2020-03-09,Sacramento,067,1510023,75,8,0,8,0
2020-03-09,San Benito,069,59416,3,2,0,2,0
2020-03-09,San Bernardino,071,2135413,54,0,0,0,0
2020-03-09,San Diego,073,3302833,126,2,0,2,0
2020-03-09,San Francisco,075,870044,72,14,0,14,0
2020-03-09,San Joaquin,077,732212,21,0,3,3,0
2020-03-09,San Luis Obispo,079,281455,15,0,0,0,0
2020-03-09,San Mateo,081,765935,109,6,0,6,0
2020-03-09,Santa Barbara,083,443738,8,0,0,0,0
2020-03-09,Santa Clara,085,1922200,278,42,1,43,1
2020-03-09,Santa Cruz,087,273765,19,2,0,2,0
2020-03-09,Shasta,089,179085,2,1,0,1,0
2020-03-09,Sierra,091,2930,0,0,0,0,0
2020-03-09,Siskiyou,093,43540,0,0,0,0,0
2020-03-09,Solano,095,438530,25,26,0,26,0
2020-03-09,Sonoma,097,501317,22,2,0,2,0
2020-03-09,Stanislaus,099,539301,11,0,2,2,0
2020-03-09,Sutter,101,95872,0,0,0,0,0
2020-03-09,Tehama,103,63373,0,0,0,0,0
2020-03-09,Trinity,105,12862,0,0,0,0,0
2020-03-09,Tulare,107,460477,9,0,1,1,0
2020-03-09,Tuolumne,109,53932,1,0,0,0,0
2020-03-09,Ventura,111,848112,25,1,0,1,0
2020-03-09,Yolo,113,214977,5,2,0,2,0
2020-03-09,Yuba,115,75493,0,0,0,0,0
2020-03-08,Alameda,001,1643700,46,4,0,4,0
2020-03-08,Alpine,003,1148,0,0,0,0,0
2020-03-08,Amador,005,37829,0,0,0,0,0
2020-03-08,Butte,007,227075,0,0,0,0,0
2020-03-08,Calaveras,009,45235,2,0,0,0,0
2020-03-08,Colusa,011,21464,0,0,0,0,0
2020-03-08,Contra Costa,013,1133247,58,9,0,9,0
2020-03-08,Del Norte,015,27424,0,0,0,0,0
2020-03-08,El Dorado,017,186661,5,0,0,0,0
2020-03-08,Fresno,019,978130,5,1,1,2,0
2020-03-08,Glenn,021,27897,0,0,0,0,0
2020-03-08,Humboldt,023,135768,5,1,0,1,0
2020-03-08,Imperial,025,180216,5,0,0,0,0
2020-03-08,Inyo,027,18085,0,0,0,0,0
2020-03-08,Kern,029,883053,8,0,0,0,0
2020-03-08,Kings,031,150075,3,0,1,1,0
2020-03-08,Lake,033,64148,0,0,0,0,0
2020-03-08,Lassen,035,31185,0,0,0,0,0
2020-03-08,Los Angeles,037,10098052,371,14,6,20,0
2020-03-08,Madera,039,155013,7,1,0,1,0
2020-03-08,Marin,041,260295,13,1,0,1,0
2020-03-08,Mariposa,043,17540,0,0,0,0,0
2020-03-08,Mendocino,045,87422,0,0,0,0,0
2020-03-08,Merced,047,269075,2,0,0,0,0
2020-03-08,Modoc,049,8938,0,0,0,0,0
2020-03-08,Mono,051,14174,3,0,0,0,0
2020-03-08,Monterey,053,433212,3,0,0,0,0
2020-03-08,Napa,055,140530,2,0,0,0,0
2020-03-08,Nevada,057,99092,1,0,1,1,0
2020-03-08,Orange,059,3164182,129,4,0,4,0
2020-03-08,Placer,061,380077,11,7,0,7,1
2020-03-08,Plumas,063,18699,0,0,0,0,0
2020-03-08,Riverside,065,2383286,41,1,1,2,0
2020-03-08,Sacramento,067,1510023,65,5,0,5,0
2020-03-08,San Benito,069,59416,3,2,0,2,0
2020-03-08,San Bernardino,071,2135413,43,0,0,0,0
2020-03-08,San Diego,073,3302833,92,2,0,2,0
2020-03-08,San Francisco,075,870044,53,9,0,9,0
2020-03-08,San Joaquin,077,732212,18,0,3,3,0
2020-03-08,San Luis Obispo,079,281455,9,0,0,0,0
2020-03-08,San Mateo,081,765935,96,4,0,4,0
2020-03-08,Santa Barbara,083,443738,5,0,0,0,0
2020-03-08,Santa Clara,085,1922200,236,36,1,37,0
2020-03-08,Santa Cruz,087,273765,17,1,0,1,0
2020-03-08,Shasta,089,179085,2,0,0,0,0
2020-03-08,Sierra,091,2930,0,0,0,0,0
2020-03-08,Siskiyou,093,43540,0,0,0,0,0
2020-03-08,Solano,095,438530,24,26,0,26,0
2020-03-08,Sonoma,097,501317,17,2,0,2,0
2020-03-08,Stanislaus,099,539301,10,0,2,2,0
2020-03-08,Sutter,101,95872,0,0,0,0,0
2020-03-08,Tehama,103,63373,0,0,0,0,0
2020-03-08,Trinity,105,12862,0,0,0,0,0
2020-03-08,Tulare,107,460477,9,0,0,0,0
2020-03-08,Tuolumne,109,53932,1,0,0,0,0
2020-03-08,Ventura,111,848112,21,1,0,1,0
2020-03-08,Yolo,113,214977,2,2,0,2,0
2020-03-08,Yuba,115,75493,0,0,0,0,0
2020-03-07,Alameda,001,1643700,41,3,0,3,0
2020-03-07,Alpine,003,1148,0,0,0,0,0
2020-03-07,Amador,005,37829,0,0,0,0,0
2020-03-07,Butte,007,227075,0,0,0,0,0
2020-03-07,Calaveras,009,45235,2,0,0,0,0
2020-03-07,Colusa,011,21464,0,0,0,0,0
2020-03-07,Contra Costa,013,1133247,55,4,0,4,0
2020-03-07,Del Norte,015,27424,0,0,0,0,0
2020-03-07,El Dorado,017,186661,4,0,0,0,0
2020-03-07,Fresno,019,978130,4,1,1,2,0
2020-03-07,Glenn,021,27897,0,0,0,0,0
2020-03-07,Humboldt,023,135768,5,1,0,1,0
2020-03-07,Imperial,025,180216,4,0,0,0,0
2020-03-07,Inyo,027,18085,0,0,0,0,0
2020-03-07,Kern,029,883053,7,0,0,0,0
2020-03-07,Kings,031,150075,3,0,1,1,0
2020-03-07,Lake,033,64148,0,0,0,0,0
2020-03-07,Lassen,035,31185,0,0,0,0,0
2020-03-07,Los Angeles,037,10098052,320,14,6,20,0
2020-03-07,Madera,039,155013,6,1,0,1,0
2020-03-07,Marin,041,260295,11,0,0,0,0
2020-03-07,Mariposa,043,17540,0,0,0,0,0
2020-03-07,Mendocino,045,87422,0,0,0,0,0
2020-03-07,Merced,047,269075,2,0,0,0,0
2020-03-07,Modoc,049,8938,0,0,0,0,0
2020-03-07,Mono,051,14174,3,0,0,0,0
2020-03-07,Monterey,053,433212,3,0,0,0,0
2020-03-07,Napa,055,140530,1,0,0,0,0
2020-03-07,Nevada,057,99092,1,0,1,1,0
2020-03-07,Orange,059,3164182,121,4,0,4,0
2020-03-07,Placer,061,380077,11,6,0,6,1
2020-03-07,Plumas,063,18699,0,0,0,0,0
2020-03-07,Riverside,065,2383286,31,0,1,1,0
2020-03-07,Sacramento,067,1510023,52,4,0,4,0
2020-03-07,San Benito,069,59416,3,2,0,2,0
2020-03-07,San Bernardino,071,2135413,41,0,0,0,0
2020-03-07,San Diego,073,3302833,74,2,0,2,0
2020-03-07,San Francisco,075,870044,47,9,0,9,0
2020-03-07,San Joaquin,077,732212,16,0,3,3,0
2020-03-07,San Luis Obispo,079,281455,6,0,0,0,0
2020-03-07,San Mateo,081,765935,86,1,0,1,0
2020-03-07,Santa Barbara,083,443738,5,0,0,0,0
2020-03-07,Santa Clara,085,1922200,206,31,1,32,0
2020-03-07,Santa Cruz,087,273765,17,1,0,1,0
2020-03-07,Shasta,089,179085,2,0,0,0,0
2020-03-07,Sierra,091,2930,0,0,0,0,0
2020-03-07,Siskiyou,093,43540,0,0,0,0,0
2020-03-07,Solano,095,438530,23,25,0,25,0
2020-03-07,Sonoma,097,501317,13,2,0,2,0
2020-03-07,Stanislaus,099,539301,9,0,2,2,0
2020-03-07,Sutter,101,95872,0,0,0,0,0
2020-03-07,Tehama,103,63373,0,0,0,0,0
2020-03-07,Trinity,105,12862,0,0,0,0,0
2020-03-07,Tulare,107,460477,6,0,0,0,0
2020-03-07,Tuolumne,109,53932,1,0,0,0,0
2020-03-07,Ventura,111,848112,18,1,0,1,0
2020-03-07,Yolo,113,214977,2,2,0,2,0
2020-03-07,Yuba,115,75493,0,0,0,0,0
2020-03-06,Alameda,001,1643700,39,3,0,3,0
2020-03-06,Alpine,003,1148,0,0,0,0,0
2020-03-06,Amador,005,37829,0,0,0,0,0
2020-03-06,Butte,007,227075,0,0,0,0,0
2020-03-06,Calaveras,009,45235,2,0,0,0,0
2020-03-06,Colusa,011,21464,0,0,0,0,0
2020-03-06,Contra Costa,013,1133247,46,4,0,4,0
2020-03-06,Del Norte,015,27424,0,0,0,0,0
2020-03-06,El Dorado,017,186661,3,0,0,0,0
2020-03-06,Fresno,019,978130,3,0,1,1,0
2020-03-06,Glenn,021,27897,0,0,0,0,0
2020-03-06,Humboldt,023,135768,4,1,0,1,0
2020-03-06,Imperial,025,180216,3,0,0,0,0
2020-03-06,Inyo,027,18085,0,0,0,0,0
2020-03-06,Kern,029,883053,6,0,0,0,0
2020-03-06,Kings,031,150075,3,0,1,1,0
2020-03-06,Lake,033,64148,0,0,0,0,0
2020-03-06,Lassen,035,31185,0,0,0,0,0
2020-03-06,Los Angeles,037,10098052,277,13,6,19,0
2020-03-06,Madera,039,155013,5,0,0,0,0
2020-03-06,Marin,041,260295,10,0,0,0,0
2020-03-06,Mariposa,043,17540,0,0,0,0,0
2020-03-06,Mendocino,045,87422,0,0,0,0,0
2020-03-06,Merced,047,269075,2,0,0,0,0
2020-03-06,Modoc,049,8938,0,0,0,0,0
2020-03-06,Mono,051,14174,1,0,0,0,0
2020-03-06,Monterey,053,433212,3,0,0,0,0
2020-03-06,Napa,055,140530,1,0,0,0,0
2020-03-06,Nevada,057,99092,1,0,1,1,0
2020-03-06,Orange,059,3164182,95,4,0,4,0
2020-03-06,Placer,061,380077,10,5,0,5,1
2020-03-06,Plumas,063,18699,0,0,0,0,0
2020-03-06,Riverside,065,2383286,30,0,1,1,0
2020-03-06,Sacramento,067,1510023,43,2,0,2,0
2020-03-06,San Benito,069,59416,3,2,0,2,0
2020-03-06,San Bernardino,071,2135413,39,0,0,0,0
2020-03-06,San Diego,073,3302833,61,2,0,2,0
2020-03-06,San Francisco,075,870044,41,2,0,2,0
2020-03-06,San Joaquin,077,732212,13,0,3,3,0
2020-03-06,San Luis Obispo,079,281455,4,0,0,0,0
2020-03-06,San Mateo,081,765935,78,1,0,1,0
2020-03-06,Santa Barbara,083,443738,3,0,0,0,0
2020-03-06,Santa Clara,085,1922200,188,20,1,21,0
2020-03-06,Santa Cruz,087,273765,15,0,0,0,0
2020-03-06,Shasta,089,179085,2,0,0,0,0
2020-03-06,Sierra,091,2930,0,0,0,0,0
2020-03-06,Siskiyou,093,43540,0,0,0,0,0
2020-03-06,Solano,095,438530,22,25,0,25,0
2020-03-06,Sonoma,097,501317,13,2,0,2,0
2020-03-06,Stanislaus,099,539301,5,0,2,2,0
2020-03-06,Sutter,101,95872,0,0,0,0,0
2020-03-06,Tehama,103,63373,0,0,0,0,0
2020-03-06,Trinity,105,12862,0,0,0,0,0
2020-03-06,Tulare,107,460477,6,0,0,0,0
2020-03-06,Tuolumne,109,53932,1,0,0,0,0
2020-03-06,Ventura,111,848112,15,1,0,1,0
2020-03-06,Yolo,113,214977,2,1,0,1,0
2020-03-06,Yuba,115,75493,0,0,0,0,0
2020-03-05,Alameda,001,1643700,34,2,0,2,0
2020-03-05,Alpine,003,1148,0,0,0,0,0
2020-03-05,Amador,005,37829,0,0,0,0,0
2020-03-05,Butte,007,227075,0,0,0,0,0
2020-03-05,Calaveras,009,45235,2,0,0,0,0
2020-03-05,Colusa,011,21464,0,0,0,0,0
2020-03-05,Contra Costa,013,1133247,39,1,0,1,0
2020-03-05,Del Norte,015,27424,0,0,0,0,0
2020-03-05,El Dorado,017,186661,1,0,0,0,0
2020-03-05,Fresno,019,978130,3,0,1,1,0
2020-03-05,Glenn,021,27897,0,0,0,0,0
2020-03-05,Humboldt,023,135768,4,1,0,1,0
2020-03-05,Imperial,025,180216,2,0,0,0,0
2020-03-05,Inyo,027,18085,0,0,0,0,0
2020-03-05,Kern,029,883053,6,0,0,0,0
2020-03-05,Kings,031,150075,3,0,1,1,0
2020-03-05,Lake,033,64148,0,0,0,0,0
2020-03-05,Lassen,035,31185,0,0,0,0,0
2020-03-05,Los Angeles,037,10098052,230,11,6,17,0
2020-03-05,Madera,039,155013,5,0,0,0,0
2020-03-05,Marin,041,260295,10,0,0,0,0
2020-03-05,Mariposa,043,17540,0,0,0,0,0
2020-03-05,Mendocino,045,87422,0,0,0,0,0
2020-03-05,Merced,047,269075,2,0,0,0,0
2020-03-05,Modoc,049,8938,0,0,0,0,0
2020-03-05,Mono,051,14174,1,0,0,0,0
2020-03-05,Monterey,053,433212,3,0,0,0,0
2020-03-05,Napa,055,140530,1,0,0,0,0
2020-03-05,Nevada,057,99092,0,0,1,1,0
2020-03-05,Orange,059,3164182,80,3,0,3,0
2020-03-05,Placer,061,380077,10,2,0,2,1
2020-03-05,Plumas,063,18699,0,0,0,0,0
2020-03-05,Riverside,065,2383286,27,0,1,1,0
2020-03-05,Sacramento,067,1510023,37,2,0,2,0
2020-03-05,San Benito,069,59416,1,2,0,2,0
2020-03-05,San Bernardino,071,2135413,34,0,0,0,0
2020-03-05,San Diego,073,3302833,54,2,0,2,0
2020-03-05,San Francisco,075,870044,31,2,0,2,0
2020-03-05,San Joaquin,077,732212,10,0,3,3,0
2020-03-05,San Luis Obispo,079,281455,4,0,0,0,0
2020-03-05,San Mateo,081,765935,65,1,0,1,0
2020-03-05,Santa Barbara,083,443738,2,0,0,0,0
2020-03-05,Santa Clara,085,1922200,164,14,1,15,0
2020-03-05,Santa Cruz,087,273765,13,0,0,0,0
2020-03-05,Shasta,089,179085,2,0,0,0,0
2020-03-05,Sierra,091,2930,0,0,0,0,0
2020-03-05,Siskiyou,093,43540,0,0,0,0,0
2020-03-05,Solano,095,438530,22,24,0,24,0
2020-03-05,Sonoma,097,501317,12,2,0,2,0
2020-03-05,Stanislaus,099,539301,4,0,2,2,0
2020-03-05,Sutter,101,95872,0,0,0,0,0
2020-03-05,Tehama,103,63373,0,0,0,0,0
2020-03-05,Trinity,105,12862,0,0,0,0,0
2020-03-05,Tulare,107,460477,6,0,0,0,0
2020-03-05,Tuolumne,109,53932,1,0,0,0,0
2020-03-05,Ventura,111,848112,13,0,0,0,0
2020-03-05,Yolo,113,214977,2,0,0,0,0
2020-03-05,Yuba,115,75493,0,0,0,0,0
2020-03-04,Alameda,001,1643700,30,2,0,2,0
2020-03-04,Alpine,003,1148,0,0,0,0,0
2020-03-04,Amador,005,37829,0,0,0,0,0
2020-03-04,Butte,007,227075,0,0,0,0,0
2020-03-04,Calaveras,009,45235,0,0,0,0,0
2020-03-04,Colusa,011,21464,0,0,0,0,0
2020-03-04,Contra Costa,013,1133247,34,1,0,1,0
2020-03-04,Del Norte,015,27424,0,0,0,0,0
2020-03-04,El Dorado,017,186661,1,0,0,0,0
2020-03-04,Fresno,019,978130,3,0,1,1,0
2020-03-04,Glenn,021,27897,0,0,0,0,0
2020-03-04,Humboldt,023,135768,1,1,0,1,0
2020-03-04,Imperial,025,180216,2,0,0,0,0
2020-03-04,Inyo,027,18085,0,0,0,0,0
2020-03-04,Kern,029,883053,6,0,0,0,0
2020-03-04,Kings,031,150075,3,0,1,1,0
2020-03-04,Lake,033,64148,0,0,0,0,0
2020-03-04,Lassen,035,31185,0,0,0,0,0
2020-03-04,Los Angeles,037,10098052,194,7,6,13,0
2020-03-04,Madera,039,155013,5,0,0,0,0
2020-03-04,Marin,041,260295,10,0,0,0,0
2020-03-04,Mariposa,043,17540,0,0,0,0,0
2020-03-04,Mendocino,045,87422,0,0,0,0,0
2020-03-04,Merced,047,269075,2,0,0,0,0
2020-03-04,Modoc,049,8938,0,0,0,0,0
2020-03-04,Mono,051,14174,1,0,0,0,0
2020-03-04,Monterey,053,433212,3,0,0,0,0
2020-03-04,Napa,055,140530,1,0,0,0,0
2020-03-04,Nevada,057,99092,0,0,1,1,0
2020-03-04,Orange,059,3164182,77,3,0,3,0
2020-03-04,Placer,061,380077,9,2,0,2,1
2020-03-04,Plumas,063,18699,0,0,0,0,0
2020-03-04,Riverside,065,2383286,23,0,1,1,0
2020-03-04,Sacramento,067,1510023,32,1,0,1,0
2020-03-04,San Benito,069,59416,1,2,0,2,0
2020-03-04,San Bernardino,071,2135413,31,0,0,0,0
2020-03-04,San Diego,073,3302833,41,2,0,2,0
2020-03-04,San Francisco,075,870044,26,0,0,0,0
2020-03-04,San Joaquin,077,732212,9,0,3,3,0
2020-03-04,San Luis Obispo,079,281455,4,0,0,0,0
2020-03-04,San Mateo,081,765935,60,1,0,1,0
2020-03-04,Santa Barbara,083,443738,2,0,0,0,0
2020-03-04,Santa Clara,085,1922200,147,12,1,13,0
2020-03-04,Santa Cruz,087,273765,13,0,0,0,0
2020-03-04,Shasta,089,179085,2,0,0,0,0
2020-03-04,Sierra,091,2930,0,0,0,0,0
2020-03-04,Siskiyou,093,43540,0,0,0,0,0
2020-03-04,Solano,095,438530,21,24,0,24,0
2020-03-04,Sonoma,097,501317,11,2,0,2,0
2020-03-04,Stanislaus,099,539301,4,0,2,2,0
2020-03-04,Sutter,101,95872,0,0,0,0,0
2020-03-04,Tehama,103,63373,0,0,0,0,0
2020-03-04,Trinity,105,12862,0,0,0,0,0
2020-03-04,Tulare,107,460477,6,0,0,0,0
2020-03-04,Tuolumne,109,53932,0,0,0,0,0
2020-03-04,Ventura,111,848112,12,0,0,0,0
2020-03-04,Yolo,113,214977,2,0,0,0,0
2020-03-04,Yuba,115,75493,0,0,0,0,0
2020-03-03,Alameda,001,1643700,24,2,0,2,0
2020-03-03,Alpine,003,1148,0,0,0,0,0
2020-03-03,Amador,005,37829,0,0,0,0,0
2020-03-03,Butte,007,227075,0,0,0,0,0
2020-03-03,Calaveras,009,45235,0,0,0,0,0
2020-03-03,Colusa,011,21464,0,0,0,0,0
2020-03-03,Contra Costa,013,1133247,30,0,0,0,0
2020-03-03,Del Norte,015,27424,0,0,0,0,0
2020-03-03,El Dorado,017,186661,1,0,0,0,0
2020-03-03,Fresno,019,978130,2,0,1,1,0
2020-03-03,Glenn,021,27897,0,0,0,0,0
2020-03-03,Humboldt,023,135768,1,1,0,1,0
2020-03-03,Imperial,025,180216,2,0,0,0,0
2020-03-03,Inyo,027,18085,0,0,0,0,0
2020-03-03,Kern,029,883053,4,0,0,0,0
2020-03-03,Kings,031,150075,3,0,1,1,0
2020-03-03,Lake,033,64148,0,0,0,0,0
2020-03-03,Lassen,035,31185,0,0,0,0,0
2020-03-03,Los Angeles,037,10098052,175,5,6,11,0
2020-03-03,Madera,039,155013,4,0,0,0,0
2020-03-03,Marin,041,260295,6,0,0,0,0
2020-03-03,Mariposa,043,17540,0,0,0,0,0
2020-03-03,Mendocino,045,87422,0,0,0,0,0
2020-03-03,Merced,047,269075,2,0,0,0,0
2020-03-03,Modoc,049,8938,0,0,0,0,0
2020-03-03,Mono,051,14174,1,0,0,0,0
2020-03-03,Monterey,053,433212,2,0,0,0,0
2020-03-03,Napa,055,140530,1,0,0,0,0
2020-03-03,Nevada,057,99092,0,0,1,1,0
2020-03-03,Orange,059,3164182,69,1,0,1,0
2020-03-03,Placer,061,380077,8,2,0,2,0
2020-03-03,Plumas,063,18699,0,0,0,0,0
2020-03-03,Riverside,065,2383286,20,0,1,1,0
2020-03-03,Sacramento,067,1510023,31,1,0,1,0
2020-03-03,San Benito,069,59416,1,2,0,2,0
2020-03-03,San Bernardino,071,2135413,28,0,0,0,0
2020-03-03,San Diego,073,3302833,34,2,0,2,0
2020-03-03,San Francisco,075,870044,24,0,0,0,0
2020-03-03,San Joaquin,077,732212,8,0,3,3,0
2020-03-03,San Luis Obispo,079,281455,2,0,0,0,0
2020-03-03,San Mateo,081,765935,53,1,0,1,0
2020-03-03,Santa Barbara,083,443738,1,0,0,0,0
2020-03-03,Santa Clara,085,1922200,132,11,1,12,0
2020-03-03,Santa Cruz,087,273765,10,0,0,0,0
2020-03-03,Shasta,089,179085,2,0,0,0,0
2020-03-03,Sierra,091,2930,0,0,0,0,0
2020-03-03,Siskiyou,093,43540,0,0,0,0,0
2020-03-03,Solano,095,438530,20,24,0,24,0
2020-03-03,Sonoma,097,501317,11,1,0,1,0
2020-03-03,Stanislaus,099,539301,4,0,2,2,0
2020-03-03,Sutter,101,95872,0,0,0,0,0
2020-03-03,Tehama,103,63373,0,0,0,0,0
2020-03-03,Trinity,105,12862,0,0,0,0,0
2020-03-03,Tulare,107,460477,6,0,0,0,0
2020-03-03,Tuolumne,109,53932,0,0,0,0,0
2020-03-03,Ventura,111,848112,11,0,0,0,0
2020-03-03,Yolo,113,214977,1,0,0,0,0
2020-03-03,Yuba,115,75493,0,0,0,0,0
2020-03-02,Alameda,001,1643700,21,1,0,1,0
2020-03-02,Alpine,003,1148,0,0,0,0,0
2020-03-02,Amador,005,37829,0,0,0,0,0
2020-03-02,Butte,007,227075,0,0,0,0,0
2020-03-02,Calaveras,009,45235,0,0,0,0,0
2020-03-02,Colusa,011,21464,0,0,0,0,0
2020-03-02,Contra Costa,013,1133247,27,0,0,0,0
2020-03-02,Del Norte,015,27424,0,0,0,0,0
2020-03-02,El Dorado,017,186661,1,0,0,0,0
2020-03-02,Fresno,019,978130,2,0,1,1,0
2020-03-02,Glenn,021,27897,0,0,0,0,0
2020-03-02,Humboldt,023,135768,1,1,0,1,0
2020-03-02,Imperial,025,180216,2,0,0,0,0
2020-03-02,Inyo,027,18085,0,0,0,0,0
2020-03-02,Kern,029,883053,4,0,0,0,0
2020-03-02,Kings,031,150075,3,0,1,1,0
2020-03-02,Lake,033,64148,0,0,0,0,0
2020-03-02,Lassen,035,31185,0,0,0,0,0
2020-03-02,Los Angeles,037,10098052,160,1,6,7,0
2020-03-02,Madera,039,155013,4,0,0,0,0
2020-03-02,Marin,041,260295,6,0,0,0,0
2020-03-02,Mariposa,043,17540,0,0,0,0,0
2020-03-02,Mendocino,045,87422,0,0,0,0,0
2020-03-02,Merced,047,269075,1,0,0,0,0
2020-03-02,Modoc,049,8938,0,0,0,0,0
2020-03-02,Mono,051,14174,1,0,0,0,0
2020-03-02,Monterey,053,433212,2,0,0,0,0
2020-03-02,Napa,055,140530,1,0,0,0,0
2020-03-02,Nevada,057,99092,0,0,1,1,0
2020-03-02,Orange,059,3164182,64,1,0,1,0
2020-03-02,Placer,061,380077,8,1,0,1,0
2020-03-02,Plumas,063,18699,0,0,0,0,0
2020-03-02,Riverside,065,2383286,19,0,1,1,0
2020-03-02,Sacramento,067,1510023,25,1,0,1,0
2020-03-02,San Benito,069,59416,1,2,0,2,0
2020-03-02,San Bernardino,071,2135413,28,0,0,0,0
2020-03-02,San Diego,073,3302833,28,2,0,2,0
2020-03-02,San Francisco,075,870044,17,0,0,0,0
2020-03-02,San Joaquin,077,732212,7,0,3,3,0
2020-03-02,San Luis Obispo,079,281455,2,0,0,0,0
2020-03-02,San Mateo,081,765935,44,1,0,1,0
2020-03-02,Santa Barbara,083,443738,1,0,0,0,0
2020-03-02,Santa Clara,085,1922200,110,7,1,8,0
2020-03-02,Santa Cruz,087,273765,9,0,0,0,0
2020-03-02,Shasta,089,179085,2,0,0,0,0
2020-03-02,Sierra,091,2930,0,0,0,0,0
2020-03-02,Siskiyou,093,43540,0,0,0,0,0
2020-03-02,Solano,095,438530,19,24,0,24,0
2020-03-02,Sonoma,097,501317,10,1,0,1,0
2020-03-02,Stanislaus,099,539301,2,0,2,2,0
2020-03-02,Sutter,101,95872,0,0,0,0,0
2020-03-02,Tehama,103,63373,0,0,0,0,0
2020-03-02,Trinity,105,12862,0,0,0,0,0
2020-03-02,Tulare,107,460477,6,0,0,0,0
2020-03-02,Tuolumne,109,53932,0,0,0,0,0
2020-03-02,Ventura,111,848112,10,0,0,0,0
2020-03-02,Yolo,113,214977,1,0,0,0,0
2020-03-02,Yuba,115,75493,0,0,0,0,0
2020-03-01,Alameda,001,1643700,20,1,0,1,0
2020-03-01,Alpine,003,1148,0,0,0,0,0
2020-03-01,Amador,005,37829,0,0,0,0,0
2020-03-01,Butte,007,227075,0,0,0,0,0
2020-03-01,Calaveras,009,45235,0,0,0,0,0
2020-03-01,Colusa,011,21464,0,0,0,0,0
2020-03-01,Contra Costa,013,1133247,24,0,0,0,0
2020-03-01,Del Norte,015,27424,0,0,0,0,0
2020-03-01,El Dorado,017,186661,1,0,0,0,0
2020-03-01,Fresno,019,978130,1,0,1,1,0
2020-03-01,Glenn,021,27897,0,0,0,0,0
2020-03-01,Humboldt,023,135768,1,1,0,1,0
2020-03-01,Imperial,025,180216,2,0,0,0,0
2020-03-01,Inyo,027,18085,0,0,0,0,0
2020-03-01,Kern,029,883053,2,0,0,0,0
2020-03-01,Kings,031,150075,3,0,1,1,0
2020-03-01,Lake,033,64148,0,0,0,0,0
2020-03-01,Lassen,035,31185,0,0,0,0,0
2020-03-01,Los Angeles,037,10098052,141,1,6,7,0
2020-03-01,Madera,039,155013,2,0,0,0,0
2020-03-01,Marin,041,260295,5,0,0,0,0
2020-03-01,Mariposa,043,17540,0,0,0,0,0
2020-03-01,Mendocino,045,87422,0,0,0,0,0
2020-03-01,Merced,047,269075,1,0,0,0,0
2020-03-01,Modoc,049,8938,0,0,0,0,0
2020-03-01,Mono,051,14174,1,0,0,0,0
2020-03-01,Monterey,053,433212,1,0,0,0,0
2020-03-01,Napa,055,140530,1,0,0,0,0
2020-03-01,Nevada,057,99092,0,0,1,1,0
2020-03-01,Orange,059,3164182,61,1,0,1,0
2020-03-01,Placer,061,380077,8,0,0,0,0
2020-03-01,Plumas,063,18699,0,0,0,0,0
2020-03-01,Riverside,065,2383286,18,0,1,1,0
2020-03-01,Sacramento,067,1510023,21,1,0,1,0
2020-03-01,San Benito,069,59416,0,2,0,2,0
2020-03-01,San Bernardino,071,2135413,27,0,0,0,0
2020-03-01,San Diego,073,3302833,21,2,0,2,0
2020-03-01,San Francisco,075,870044,13,0,0,0,0
2020-03-01,San Joaquin,077,732212,7,0,3,3,0
2020-03-01,San Luis Obispo,079,281455,2,0,0,0,0
2020-03-01,San Mateo,081,765935,36,0,0,0,0
2020-03-01,Santa Barbara,083,443738,1,0,0,0,0
2020-03-01,Santa Clara,085,1922200,97,6,1,7,0
2020-03-01,Santa Cruz,087,273765,8,0,0,0,0
2020-03-01,Shasta,089,179085,2,0,0,0,0
2020-03-01,Sierra,091,2930,0,0,0,0,0
2020-03-01,Siskiyou,093,43540,0,0,0,0,0
2020-03-01,Solano,095,438530,19,24,0,24,0
2020-03-01,Sonoma,097,501317,9,0,0,0,0
2020-03-01,Stanislaus,099,539301,2,0,2,2,0
2020-03-01,Sutter,101,95872,0,0,0,0,0
2020-03-01,Tehama,103,63373,0,0,0,0,0
2020-03-01,Trinity,105,12862,0,0,0,0,0
2020-03-01,Tulare,107,460477,6,0,0,0,0
2020-03-01,Tuolumne,109,53932,0,0,0,0,0
2020-03-01,Ventura,111,848112,8,0,0,0,0
2020-03-01,Yolo,113,214977,1,0,0,0,0
2020-03-01,Yuba,115,75493,0,0,0,0,0
2020-02-29,Alameda,001,1643700,16,0,0,0,0
2020-02-29,Alpine,003,1148,0,0,0,0,0
2020-02-29,Amador,005,37829,0,0,0,0,0
2020-02-29,Butte,007,227075,0,0,0,0,0
2020-02-29,Calaveras,009,45235,0,0,0,0,0
2020-02-29,Colusa,011,21464,0,0,0,0,0
2020-02-29,Contra Costa,013,1133247,20,0,0,0,0
2020-02-29,Del Norte,015,27424,0,0,0,0,0
2020-02-29,El Dorado,017,186661,1,0,0,0,0
2020-02-29,Fresno,019,978130,1,0,0,0,0
2020-02-29,Glenn,021,27897,0,0,0,0,0
2020-02-29,Humboldt,023,135768,1,1,0,1,0
2020-02-29,Imperial,025,180216,1,0,0,0,0
2020-02-29,Inyo,027,18085,0,0,0,0,0
2020-02-29,Kern,029,883053,2,0,0,0,0
2020-02-29,Kings,031,150075,3,0,1,1,0
2020-02-29,Lake,033,64148,0,0,0,0,0
2020-02-29,Lassen,035,31185,0,0,0,0,0
2020-02-29,Los Angeles,037,10098052,112,1,6,7,0
2020-02-29,Madera,039,155013,2,0,0,0,0
2020-02-29,Marin,041,260295,4,0,0,0,0
2020-02-29,Mariposa,043,17540,0,0,0,0,0
2020-02-29,Mendocino,045,87422,0,0,0,0,0
2020-02-29,Merced,047,269075,1,0,0,0,0
2020-02-29,Modoc,049,8938,0,0,0,0,0
2020-02-29,Mono,051,14174,1,0,0,0,0
2020-02-29,Monterey,053,433212,1,0,0,0,0
2020-02-29,Napa,055,140530,1,0,0,0,0
2020-02-29,Nevada,057,99092,0,0,1,1,0
2020-02-29,Orange,059,3164182,56,1,0,1,0
2020-02-29,Placer,061,380077,7,0,0,0,0
2020-02-29,Plumas,063,18699,0,0,0,0,0
2020-02-29,Riverside,065,2383286,15,0,1,1,0
2020-02-29,Sacramento,067,1510023,16,1,0,1,0
2020-02-29,San Benito,069,59416,0,2,0,2,0
2020-02-29,San Bernardino,071,2135413,25,0,0,0,0
2020-02-29,San Diego,073,3302833,16,2,0,2,0
2020-02-29,San Francisco,075,870044,12,0,0,0,0
2020-02-29,San Joaquin,077,732212,6,0,3,3,0
2020-02-29,San Luis Obispo,079,281455,2,0,0,0,0
2020-02-29,San Mateo,081,765935,29,0,0,0,0
2020-02-29,Santa Barbara,083,443738,0,0,0,0,0
2020-02-29,Santa Clara,085,1922200,75,3,1,4,0
2020-02-29,Santa Cruz,087,273765,8,0,0,0,0
2020-02-29,Shasta,089,179085,2,0,0,0,0
2020-02-29,Sierra,091,2930,0,0,0,0,0
2020-02-29,Siskiyou,093,43540,0,0,0,0,0
2020-02-29,Solano,095,438530,18,23,0,23,0
2020-02-29,Sonoma,097,501317,6,0,0,0,0
2020-02-29,Stanislaus,099,539301,2,0,2,2,0
2020-02-29,Sutter,101,95872,0,0,0,0,0
2020-02-29,Tehama,103,63373,0,0,0,0,0
2020-02-29,Trinity,105,12862,0,0,0,0,0
2020-02-29,Tulare,107,460477,4,0,0,0,0
2020-02-29,Tuolumne,109,53932,0,0,0,0,0
2020-02-29,Ventura,111,848112,6,0,0,0,0
2020-02-29,Yolo,113,214977,1,0,0,0,0
2020-02-29,Yuba,115,75493,0,0,0,0,0
2020-02-28,Alameda,001,1643700,14,0,0,0,0
2020-02-28,Alpine,003,1148,0,0,0,0,0
2020-02-28,Amador,005,37829,0,0,0,0,0
2020-02-28,Butte,007,227075,0,0,0,0,0
2020-02-28,Calaveras,009,45235,0,0,0,0,0
2020-02-28,Colusa,011,21464,0,0,0,0,0
2020-02-28,Contra Costa,013,1133247,20,0,0,0,0
2020-02-28,Del Norte,015,27424,0,0,0,0,0
2020-02-28,El Dorado,017,186661,0,0,0,0,0
2020-02-28,Fresno,019,978130,1,0,0,0,0
2020-02-28,Glenn,021,27897,0,0,0,0,0
2020-02-28,Humboldt,023,135768,1,1,0,1,0
2020-02-28,Imperial,025,180216,1,0,0,0,0
2020-02-28,Inyo,027,18085,0,0,0,0,0
2020-02-28,Kern,029,883053,2,0,0,0,0
2020-02-28,Kings,031,150075,3,0,1,1,0
2020-02-28,Lake,033,64148,0,0,0,0,0
2020-02-28,Lassen,035,31185,0,0,0,0,0
2020-02-28,Los Angeles,037,10098052,104,1,6,7,0
2020-02-28,Madera,039,155013,2,0,0,0,0
2020-02-28,Marin,041,260295,2,0,0,0,0
2020-02-28,Mariposa,043,17540,0,0,0,0,0
2020-02-28,Mendocino,045,87422,0,0,0,0,0
2020-02-28,Merced,047,269075,1,0,0,0,0
2020-02-28,Modoc,049,8938,0,0,0,0,0
2020-02-28,Mono,051,14174,0,0,0,0,0
2020-02-28,Monterey,053,433212,1,0,0,0,0
2020-02-28,Napa,055,140530,1,0,0,0,0
2020-02-28,Nevada,057,99092,0,0,1,1,0
2020-02-28,Orange,059,3164182,54,1,0,1,0
2020-02-28,Placer,061,380077,7,0,0,0,0
2020-02-28,Plumas,063,18699,0,0,0,0,0
2020-02-28,Riverside,065,2383286,13,0,1,1,0
2020-02-28,Sacramento,067,1510023,10,1,0,1,0
2020-02-28,San Benito,069,59416,0,2,0,2,0
2020-02-28,San Bernardino,071,2135413,25,0,0,0,0
2020-02-28,San Diego,073,3302833,13,2,0,2,0
2020-02-28,San Francisco,075,870044,10,0,0,0,0
2020-02-28,San Joaquin,077,732212,6,0,3,3,0
2020-02-28,San Luis Obispo,079,281455,2,0,0,0,0
2020-02-28,San Mateo,081,765935,24,0,0,0,0
2020-02-28,Santa Barbara,083,443738,0,0,0,0,0
2020-02-28,Santa Clara,085,1922200,70,3,1,4,0
2020-02-28,Santa Cruz,087,273765,8,0,0,0,0
2020-02-28,Shasta,089,179085,2,0,0,0,0
2020-02-28,Sierra,091,2930,0,0,0,0,0
2020-02-28,Siskiyou,093,43540,0,0,0,0,0
2020-02-28,Solano,095,438530,17,23,0,23,0
2020-02-28,Sonoma,097,501317,6,0,0,0,0
2020-02-28,Stanislaus,099,539301,2,0,2,2,0
2020-02-28,Sutter,101,95872,0,0,0,0,0
2020-02-28,Tehama,103,63373,0,0,0,0,0
2020-02-28,Trinity,105,12862,0,0,0,0,0
2020-02-28,Tulare,107,460477,3,0,0,0,0
2020-02-28,Tuolumne,109,53932,0,0,0,0,0
2020-02-28,Ventura,111,848112,6,0,0,0,0
2020-02-28,Yolo,113,214977,1,0,0,0,0
2020-02-28,Yuba,115,75493,0,0,0,0,0
2020-02-27,Alameda,001,1643700,13,0,0,0,0
2020-02-27,Alpine,003,1148,0,0,0,0,0
2020-02-27,Amador,005,37829,0,0,0,0,0
2020-02-27,Butte,007,227075,0,0,0,0,0
2020-02-27,Calaveras,009,45235,0,0,0,0,0
2020-02-27,Colusa,011,21464,0,0,0,0,0
2020-02-27,Contra Costa,013,1133247,14,0,0,0,0
2020-02-27,Del Norte,015,27424,0,0,0,0,0
2020-02-27,El Dorado,017,186661,0,0,0,0,0
2020-02-27,Fresno,019,978130,1,0,0,0,0
2020-02-27,Glenn,021,27897,0,0,0,0,0
2020-02-27,Humboldt,023,135768,1,1,0,1,0
2020-02-27,Imperial,025,180216,1,0,0,0,0
2020-02-27,Inyo,027,18085,0,0,0,0,0
2020-02-27,Kern,029,883053,2,0,0,0,0
2020-02-27,Kings,031,150075,3,0,1,1,0
2020-02-27,Lake,033,64148,0,0,0,0,0
2020-02-27,Lassen,035,31185,0,0,0,0,0
2020-02-27,Los Angeles,037,10098052,96,1,6,7,0
2020-02-27,Madera,039,155013,2,0,0,0,0
2020-02-27,Marin,041,260295,1,0,0,0,0
2020-02-27,Mariposa,043,17540,0,0,0,0,0
2020-02-27,Mendocino,045,87422,0,0,0,0,0
2020-02-27,Merced,047,269075,1,0,0,0,0
2020-02-27,Modoc,049,8938,0,0,0,0,0
2020-02-27,Mono,051,14174,0,0,0,0,0
2020-02-27,Monterey,053,433212,1,0,0,0,0
2020-02-27,Napa,055,140530,1,0,0,0,0
2020-02-27,Nevada,057,99092,0,0,1,1,0
2020-02-27,Orange,059,3164182,48,1,0,1,0
2020-02-27,Placer,061,380077,6,0,0,0,0
2020-02-27,Plumas,063,18699,0,0,0,0,0
2020-02-27,Riverside,065,2383286,12,0,1,1,0
2020-02-27,Sacramento,067,1510023,10,1,0,1,0
2020-02-27,San Benito,069,59416,0,2,0,2,0
2020-02-27,San Bernardino,071,2135413,25,0,0,0,0
2020-02-27,San Diego,073,3302833,12,2,0,2,0
2020-02-27,San Francisco,075,870044,9,0,0,0,0
2020-02-27,San Joaquin,077,732212,5,0,3,3,0
2020-02-27,San Luis Obispo,079,281455,2,0,0,0,0
2020-02-27,San Mateo,081,765935,20,0,0,0,0
2020-02-27,Santa Barbara,083,443738,0,0,0,0,0
2020-02-27,Santa Clara,085,1922200,59,2,1,3,0
2020-02-27,Santa Cruz,087,273765,6,0,0,0,0
2020-02-27,Shasta,089,179085,0,0,0,0,0
2020-02-27,Sierra,091,2930,0,0,0,0,0
2020-02-27,Siskiyou,093,43540,0,0,0,0,0
2020-02-27,Solano,095,438530,17,23,0,23,0
2020-02-27,Sonoma,097,501317,5,0,0,0,0
2020-02-27,Stanislaus,099,539301,2,0,2,2,0
2020-02-27,Sutter,101,95872,0,0,0,0,0
2020-02-27,Tehama,103,63373,0,0,0,0,0
2020-02-27,Trinity,105,12862,0,0,0,0,0
2020-02-27,Tulare,107,460477,3,0,0,0,0
2020-02-27,Tuolumne,109,53932,0,0,0,0,0
2020-02-27,Ventura,111,848112,4,0,0,0,0
2020-02-27,Yolo,113,214977,1,0,0,0,0
2020-02-27,Yuba,115,75493,0,0,0,0,0
2020-02-26,Alameda,001,1643700,13,0,0,0,0
2020-02-26,Alpine,003,1148,0,0,0,0,0
2020-02-26,Amador,005,37829,0,0,0,0,0
2020-02-26,Butte,007,227075,0,0,0,0,0
2020-02-26,Calaveras,009,45235,0,0,0,0,0
2020-02-26,Colusa,011,21464,0,0,0,0,0
2020-02-26,Contra Costa,013,1133247,13,0,0,0,0
2020-02-26,Del Norte,015,27424,0,0,0,0,0
2020-02-26,El Dorado,017,186661,0,0,0,0,0
2020-02-26,Fresno,019,978130,1,0,0,0,0
2020-02-26,Glenn,021,27897,0,0,0,0,0
2020-02-26,Humboldt,023,135768,1,1,0,1,0
2020-02-26,Imperial,025,180216,1,0,0,0,0
2020-02-26,Inyo,027,18085,0,0,0,0,0
2020-02-26,Kern,029,883053,2,0,0,0,0
2020-02-26,Kings,031,150075,3,0,1,1,0
2020-02-26,Lake,033,64148,0,0,0,0,0
2020-02-26,Lassen,035,31185,0,0,0,0,0
2020-02-26,Los Angeles,037,10098052,90,1,6,7,0
2020-02-26,Madera,039,155013,2,0,0,0,0
2020-02-26,Marin,041,260295,1,0,0,0,0
2020-02-26,Mariposa,043,17540,0,0,0,0,0
2020-02-26,Mendocino,045,87422,0,0,0,0,0
2020-02-26,Merced,047,269075,1,0,0,0,0
2020-02-26,Modoc,049,8938,0,0,0,0,0
2020-02-26,Mono,051,14174,0,0,0,0,0
2020-02-26,Monterey,053,433212,1,0,0,0,0
2020-02-26,Napa,055,140530,0,0,0,0,0
2020-02-26,Nevada,057,99092,0,0,1,1,0
2020-02-26,Orange,059,3164182,47,1,0,1,0
2020-02-26,Placer,061,380077,5,0,0,0,0
2020-02-26,Plumas,063,18699,0,0,0,0,0
2020-02-26,Riverside,065,2383286,10,0,1,1,0
2020-02-26,Sacramento,067,1510023,10,1,0,1,0
2020-02-26,San Benito,069,59416,0,2,0,2,0
2020-02-26,San Bernardino,071,2135413,23,0,0,0,0
2020-02-26,San Diego,073,3302833,11,2,0,2,0
2020-02-26,San Francisco,075,870044,9,0,0,0,0
2020-02-26,San Joaquin,077,732212,5,0,3,3,0
2020-02-26,San Luis Obispo,079,281455,2,0,0,0,0
2020-02-26,San Mateo,081,765935,18,0,0,0,0
2020-02-26,Santa Barbara,083,443738,0,0,0,0,0
2020-02-26,Santa Clara,085,1922200,50,2,1,3,0
2020-02-26,Santa Cruz,087,273765,6,0,0,0,0
2020-02-26,Shasta,089,179085,0,0,0,0,0
2020-02-26,Sierra,091,2930,0,0,0,0,0
2020-02-26,Siskiyou,093,43540,0,0,0,0,0
2020-02-26,Solano,095,438530,17,23,0,23,0
2020-02-26,Sonoma,097,501317,5,0,0,0,0
2020-02-26,Stanislaus,099,539301,2,0,2,2,0
2020-02-26,Sutter,101,95872,0,0,0,0,0
2020-02-26,Tehama,103,63373,0,0,0,0,0
2020-02-26,Trinity,105,12862,0,0,0,0,0
2020-02-26,Tulare,107,460477,3,0,0,0,0
2020-02-26,Tuolumne,109,53932,0,0,0,0,0
2020-02-26,Ventura,111,848112,4,0,0,0,0
2020-02-26,Yolo,113,214977,1,0,0,0,0
2020-02-26,Yuba,115,75493,0,0,0,0,0
2020-02-25,Alameda,001,1643700,13,0,0,0,0
2020-02-25,Alpine,003,1148,0,0,0,0,0
2020-02-25,Amador,005,37829,0,0,0,0,0
2020-02-25,Butte,007,227075,0,0,0,0,0
2020-02-25,Calaveras,009,45235,0,0,0,0,0
2020-02-25,Colusa,011,21464,0,0,0,0,0
2020-02-25,Contra Costa,013,1133247,11,0,0,0,0
2020-02-25,Del Norte,015,27424,0,0,0,0,0
2020-02-25,El Dorado,017,186661,0,0,0,0,0
2020-02-25,Fresno,019,978130,1,0,0,0,0
2020-02-25,Glenn,021,27897,0,0,0,0,0
2020-02-25,Humboldt,023,135768,1,1,0,1,0
2020-02-25,Imperial,025,180216,1,0,0,0,0
2020-02-25,Inyo,027,18085,0,0,0,0,0
2020-02-25,Kern,029,883053,2,0,0,0,0
2020-02-25,Kings,031,150075,3,0,1,1,0
2020-02-25,Lake,033,64148,0,0,0,0,0
2020-02-25,Lassen,035,31185,0,0,0,0,0
2020-02-25,Los Angeles,037,10098052,78,1,6,7,0
2020-02-25,Madera,039,155013,2,0,0,0,0
2020-02-25,Marin,041,260295,1,0,0,0,0
2020-02-25,Mariposa,043,17540,0,0,0,0,0
2020-02-25,Mendocino,045,87422,0,0,0,0,0
2020-02-25,Merced,047,269075,0,0,0,0,0
2020-02-25,Modoc,049,8938,0,0,0,0,0
2020-02-25,Mono,051,14174,0,0,0,0,0
2020-02-25,Monterey,053,433212,1,0,0,0,0
2020-02-25,Napa,055,140530,0,0,0,0,0
2020-02-25,Nevada,057,99092,0,0,1,1,0
2020-02-25,Orange,059,3164182,46,1,0,1,0
2020-02-25,Placer,061,380077,5,0,0,0,0
2020-02-25,Plumas,063,18699,0,0,0,0,0
2020-02-25,Riverside,065,2383286,10,0,1,1,0
2020-02-25,Sacramento,067,1510023,8,1,0,1,0
2020-02-25,San Benito,069,59416,0,2,0,2,0
2020-02-25,San Bernardino,071,2135413,21,0,0,0,0
2020-02-25,San Diego,073,3302833,7,2,0,2,0
2020-02-25,San Francisco,075,870044,7,0,0,0,0
2020-02-25,San Joaquin,077,732212,5,0,2,2,0
2020-02-25,San Luis Obispo,079,281455,2,0,0,0,0
2020-02-25,San Mateo,081,765935,17,0,0,0,0
2020-02-25,Santa Barbara,083,443738,0,0,0,0,0
2020-02-25,Santa Clara,085,1922200,40,2,1,3,0
2020-02-25,Santa Cruz,087,273765,5,0,0,0,0
2020-02-25,Shasta,089,179085,0,0,0,0,0
2020-02-25,Sierra,091,2930,0,0,0,0,0
2020-02-25,Siskiyou,093,43540,0,0,0,0,0
2020-02-25,Solano,095,438530,16,21,0,21,0
2020-02-25,Sonoma,097,501317,5,0,0,0,0
2020-02-25,Stanislaus,099,539301,2,0,2,2,0
2020-02-25,Sutter,101,95872,0,0,0,0,0
2020-02-25,Tehama,103,63373,0,0,0,0,0
2020-02-25,Trinity,105,12862,0,0,0,0,0
2020-02-25,Tulare,107,460477,3,0,0,0,0
2020-02-25,Tuolumne,109,53932,0,0,0,0,0
2020-02-25,Ventura,111,848112,4,0,0,0,0
2020-02-25,Yolo,113,214977,1,0,0,0,0
2020-02-25,Yuba,115,75493,0,0,0,0,0
2020-02-24,Alameda,001,1643700,13,0,0,0,0
2020-02-24,Alpine,003,1148,0,0,0,0,0
2020-02-24,Amador,005,37829,0,0,0,0,0
2020-02-24,Butte,007,227075,0,0,0,0,0
2020-02-24,Calaveras,009,45235,0,0,0,0,0
2020-02-24,Colusa,011,21464,0,0,0,0,0
2020-02-24,Contra Costa,013,1133247,9,0,0,0,0
2020-02-24,Del Norte,015,27424,0,0,0,0,0
2020-02-24,El Dorado,017,186661,0,0,0,0,0
2020-02-24,Fresno,019,978130,1,0,0,0,0
2020-02-24,Glenn,021,27897,0,0,0,0,0
2020-02-24,Humboldt,023,135768,1,1,0,1,0
2020-02-24,Imperial,025,180216,1,0,0,0,0
2020-02-24,Inyo,027,18085,0,0,0,0,0
2020-02-24,Kern,029,883053,2,0,0,0,0
2020-02-24,Kings,031,150075,3,0,1,1,0
2020-02-24,Lake,033,64148,0,0,0,0,0
2020-02-24,Lassen,035,31185,0,0,0,0,0
2020-02-24,Los Angeles,037,10098052,72,1,6,7,0
2020-02-24,Madera,039,155013,1,0,0,0,0
2020-02-24,Marin,041,260295,1,0,0,0,0
2020-02-24,Mariposa,043,17540,0,0,0,0,0
2020-02-24,Mendocino,045,87422,0,0,0,0,0
2020-02-24,Merced,047,269075,0,0,0,0,0
2020-02-24,Modoc,049,8938,0,0,0,0,0
2020-02-24,Mono,051,14174,0,0,0,0,0
2020-02-24,Monterey,053,433212,1,0,0,0,0
2020-02-24,Napa,055,140530,0,0,0,0,0
2020-02-24,Nevada,057,99092,0,0,1,1,0
2020-02-24,Orange,059,3164182,44,1,0,1,0
2020-02-24,Placer,061,380077,3,0,0,0,0
2020-02-24,Plumas,063,18699,0,0,0,0,0
2020-02-24,Riverside,065,2383286,9,0,1,1,0
2020-02-24,Sacramento,067,1510023,7,1,0,1,0
2020-02-24,San Benito,069,59416,0,2,0,2,0
2020-02-24,San Bernardino,071,2135413,21,0,0,0,0
2020-02-24,San Diego,073,3302833,7,2,0,2,0
2020-02-24,San Francisco,075,870044,6,0,0,0,0
2020-02-24,San Joaquin,077,732212,5,0,1,1,0
2020-02-24,San Luis Obispo,079,281455,2,0,0,0,0
2020-02-24,San Mateo,081,765935,13,0,0,0,0
2020-02-24,Santa Barbara,083,443738,0,0,0,0,0
2020-02-24,Santa Clara,085,1922200,38,2,1,3,0
2020-02-24,Santa Cruz,087,273765,5,0,0,0,0
2020-02-24,Shasta,089,179085,0,0,0,0,0
2020-02-24,Sierra,091,2930,0,0,0,0,0
2020-02-24,Siskiyou,093,43540,0,0,0,0,0
2020-02-24,Solano,095,438530,13,15,0,15,0
2020-02-24,Sonoma,097,501317,5,0,0,0,0
2020-02-24,Stanislaus,099,539301,2,0,2,2,0
2020-02-24,Sutter,101,95872,0,0,0,0,0
2020-02-24,Tehama,103,63373,0,0,0,0,0
2020-02-24,Trinity,105,12862,0,0,0,0,0
2020-02-24,Tulare,107,460477,3,0,0,0,0
2020-02-24,Tuolumne,109,53932,0,0,0,0,0
2020-02-24,Ventura,111,848112,4,0,0,0,0
2020-02-24,Yolo,113,214977,1,0,0,0,0
2020-02-24,Yuba,115,75493,0,0,0,0,0
2020-02-23,Alameda,001,1643700,11,0,0,0,0
2020-02-23,Alpine,003,1148,0,0,0,0,0
2020-02-23,Amador,005,37829,0,0,0,0,0
2020-02-23,Butte,007,227075,0,0,0,0,0
2020-02-23,Calaveras,009,45235,0,0,0,0,0
2020-02-23,Colusa,011,21464,0,0,0,0,0
2020-02-23,Contra Costa,013,1133247,6,0,0,0,0
2020-02-23,Del Norte,015,27424,0,0,0,0,0
2020-02-23,El Dorado,017,186661,0,0,0,0,0
2020-02-23,Fresno,019,978130,1,0,0,0,0
2020-02-23,Glenn,021,27897,0,0,0,0,0
2020-02-23,Humboldt,023,135768,1,1,0,1,0
2020-02-23,Imperial,025,180216,1,0,0,0,0
2020-02-23,Inyo,027,18085,0,0,0,0,0
2020-02-23,Kern,029,883053,2,0,0,0,0
2020-02-23,Kings,031,150075,3,0,1,1,0
2020-02-23,Lake,033,64148,0,0,0,0,0
2020-02-23,Lassen,035,31185,0,0,0,0,0
2020-02-23,Los Angeles,037,10098052,64,1,6,7,0
2020-02-23,Madera,039,155013,1,0,0,0,0
2020-02-23,Marin,041,260295,1,0,0,0,0
2020-02-23,Mariposa,043,17540,0,0,0,0,0
2020-02-23,Mendocino,045,87422,0,0,0,0,0
2020-02-23,Merced,047,269075,0,0,0,0,0
2020-02-23,Modoc,049,8938,0,0,0,0,0
2020-02-23,Mono,051,14174,0,0,0,0,0
2020-02-23,Monterey,053,433212,1,0,0,0,0
2020-02-23,Napa,055,140530,0,0,0,0,0
2020-02-23,Nevada,057,99092,0,0,1,1,0
2020-02-23,Orange,059,3164182,44,1,0,1,0
2020-02-23,Placer,061,380077,3,0,0,0,0
2020-02-23,Plumas,063,18699,0,0,0,0,0
2020-02-23,Riverside,065,2383286,9,0,0,0,0
2020-02-23,Sacramento,067,1510023,6,1,0,1,0
2020-02-23,San Benito,069,59416,0,2,0,2,0
2020-02-23,San Bernardino,071,2135413,20,0,0,0,0
2020-02-23,San Diego,073,3302833,6,2,0,2,0
2020-02-23,San Francisco,075,870044,5,0,0,0,0
2020-02-23,San Joaquin,077,732212,4,0,1,1,0
2020-02-23,San Luis Obispo,079,281455,2,0,0,0,0
2020-02-23,San Mateo,081,765935,10,0,0,0,0
2020-02-23,Santa Barbara,083,443738,0,0,0,0,0
2020-02-23,Santa Clara,085,1922200,26,2,1,3,0
2020-02-23,Santa Cruz,087,273765,2,0,0,0,0
2020-02-23,Shasta,089,179085,0,0,0,0,0
2020-02-23,Sierra,091,2930,0,0,0,0,0
2020-02-23,Siskiyou,093,43540,0,0,0,0,0
2020-02-23,Solano,095,438530,11,15,0,15,0
2020-02-23,Sonoma,097,501317,5,0,0,0,0
2020-02-23,Stanislaus,099,539301,2,0,2,2,0
2020-02-23,Sutter,101,95872,0,0,0,0,0
2020-02-23,Tehama,103,63373,0,0,0,0,0
2020-02-23,Trinity,105,12862,0,0,0,0,0
2020-02-23,Tulare,107,460477,2,0,0,0,0
2020-02-23,Tuolumne,109,53932,0,0,0,0,0
2020-02-23,Ventura,111,848112,4,0,0,0,0
2020-02-23,Yolo,113,214977,1,0,0,0,0
2020-02-23,Yuba,115,75493,0,0,0,0,0
2020-02-22,Alameda,001,1643700,10,0,0,0,0
2020-02-22,Alpine,003,1148,0,0,0,0,0
2020-02-22,Amador,005,37829,0,0,0,0,0
2020-02-22,Butte,007,227075,0,0,0,0,0
2020-02-22,Calaveras,009,45235,0,0,0,0,0
2020-02-22,Colusa,011,21464,0,0,0,0,0
2020-02-22,Contra Costa,013,1133247,5,0,0,0,0
2020-02-22,Del Norte,015,27424,0,0,0,0,0
2020-02-22,El Dorado,017,186661,0,0,0,0,0
2020-02-22,Fresno,019,978130,1,0,0,0,0
2020-02-22,Glenn,021,27897,0,0,0,0,0
2020-02-22,Humboldt,023,135768,1,1,0,1,0
2020-02-22,Imperial,025,180216,0,0,0,0,0
2020-02-22,Inyo,027,18085,0,0,0,0,0
2020-02-22,Kern,029,883053,2,0,0,0,0
2020-02-22,Kings,031,150075,3,0,1,1,0
2020-02-22,Lake,033,64148,0,0,0,0,0
2020-02-22,Lassen,035,31185,0,0,0,0,0
2020-02-22,Los Angeles,037,10098052,62,1,6,7,0
2020-02-22,Madera,039,155013,0,0,0,0,0
2020-02-22,Marin,041,260295,1,0,0,0,0
2020-02-22,Mariposa,043,17540,0,0,0,0,0
2020-02-22,Mendocino,045,87422,0,0,0,0,0
2020-02-22,Merced,047,269075,0,0,0,0,0
2020-02-22,Modoc,049,8938,0,0,0,0,0
2020-02-22,Mono,051,14174,0,0,0,0,0
2020-02-22,Monterey,053,433212,1,0,0,0,0
2020-02-22,Napa,055,140530,0,0,0,0,0
2020-02-22,Nevada,057,99092,0,0,1,1,0
2020-02-22,Orange,059,3164182,43,1,0,1,0
2020-02-22,Placer,061,380077,3,0,0,0,0
2020-02-22,Plumas,063,18699,0,0,0,0,0
2020-02-22,Riverside,065,2383286,9,0,0,0,0
2020-02-22,Sacramento,067,1510023,6,1,0,1,0
2020-02-22,San Benito,069,59416,0,2,0,2,0
2020-02-22,San Bernardino,071,2135413,18,0,0,0,0
2020-02-22,San Diego,073,3302833,5,2,0,2,0
2020-02-22,San Francisco,075,870044,3,0,0,0,0
2020-02-22,San Joaquin,077,732212,4,0,1,1,0
2020-02-22,San Luis Obispo,079,281455,2,0,0,0,0
2020-02-22,San Mateo,081,765935,8,0,0,0,0
2020-02-22,Santa Barbara,083,443738,0,0,0,0,0
2020-02-22,Santa Clara,085,1922200,23,2,1,3,0
2020-02-22,Santa Cruz,087,273765,2,0,0,0,0
2020-02-22,Shasta,089,179085,0,0,0,0,0
2020-02-22,Sierra,091,2930,0,0,0,0,0
2020-02-22,Siskiyou,093,43540,0,0,0,0,0
2020-02-22,Solano,095,438530,11,11,0,11,0
2020-02-22,Sonoma,097,501317,4,0,0,0,0
2020-02-22,Stanislaus,099,539301,2,0,2,2,0
2020-02-22,Sutter,101,95872,0,0,0,0,0
2020-02-22,Tehama,103,63373,0,0,0,0,0
2020-02-22,Trinity,105,12862,0,0,0,0,0
2020-02-22,Tulare,107,460477,2,0,0,0,0
2020-02-22,Tuolumne,109,53932,0,0,0,0,0
2020-02-22,Ventura,111,848112,4,0,0,0,0
2020-02-22,Yolo,113,214977,0,0,0,0,0
2020-02-22,Yuba,115,75493,0,0,0,0,0
2020-02-21,Alameda,001,1643700,9,0,0,0,0
2020-02-21,Alpine,003,1148,0,0,0,0,0
2020-02-21,Amador,005,37829,0,0,0,0,0
2020-02-21,Butte,007,227075,0,0,0,0,0
2020-02-21,Calaveras,009,45235,0,0,0,0,0
2020-02-21,Colusa,011,21464,0,0,0,0,0
2020-02-21,Contra Costa,013,1133247,4,0,0,0,0
2020-02-21,Del Norte,015,27424,0,0,0,0,0
2020-02-21,El Dorado,017,186661,0,0,0,0,0
2020-02-21,Fresno,019,978130,1,0,0,0,0
2020-02-21,Glenn,021,27897,0,0,0,0,0
2020-02-21,Humboldt,023,135768,1,1,0,1,0
2020-02-21,Imperial,025,180216,0,0,0,0,0
2020-02-21,Inyo,027,18085,0,0,0,0,0
2020-02-21,Kern,029,883053,2,0,0,0,0
2020-02-21,Kings,031,150075,3,0,1,1,0
2020-02-21,Lake,033,64148,0,0,0,0,0
2020-02-21,Lassen,035,31185,0,0,0,0,0
2020-02-21,Los Angeles,037,10098052,58,1,6,7,0
2020-02-21,Madera,039,155013,0,0,0,0,0
2020-02-21,Marin,041,260295,1,0,0,0,0
2020-02-21,Mariposa,043,17540,0,0,0,0,0
2020-02-21,Mendocino,045,87422,0,0,0,0,0
2020-02-21,Merced,047,269075,0,0,0,0,0
2020-02-21,Modoc,049,8938,0,0,0,0,0
2020-02-21,Mono,051,14174,0,0,0,0,0
2020-02-21,Monterey,053,433212,1,0,0,0,0
2020-02-21,Napa,055,140530,0,0,0,0,0
2020-02-21,Nevada,057,99092,0,0,1,1,0
2020-02-21,Orange,059,3164182,41,1,0,1,0
2020-02-21,Placer,061,380077,2,0,0,0,0
2020-02-21,Plumas,063,18699,0,0,0,0,0
2020-02-21,Riverside,065,2383286,9,0,0,0,0
2020-02-21,Sacramento,067,1510023,5,1,0,1,0
2020-02-21,San Benito,069,59416,0,2,0,2,0
2020-02-21,San Bernardino,071,2135413,17,0,0,0,0
2020-02-21,San Diego,073,3302833,5,2,0,2,0
2020-02-21,San Francisco,075,870044,3,0,0,0,0
2020-02-21,San Joaquin,077,732212,2,0,1,1,0
2020-02-21,San Luis Obispo,079,281455,2,0,0,0,0
2020-02-21,San Mateo,081,765935,8,0,0,0,0
2020-02-21,Santa Barbara,083,443738,0,0,0,0,0
2020-02-21,Santa Clara,085,1922200,21,2,1,3,0
2020-02-21,Santa Cruz,087,273765,2,0,0,0,0
2020-02-21,Shasta,089,179085,0,0,0,0,0
2020-02-21,Sierra,091,2930,0,0,0,0,0
2020-02-21,Siskiyou,093,43540,0,0,0,0,0
2020-02-21,Solano,095,438530,10,11,0,11,0
2020-02-21,Sonoma,097,501317,3,0,0,0,0
2020-02-21,Stanislaus,099,539301,2,0,2,2,0
2020-02-21,Sutter,101,95872,0,0,0,0,0
2020-02-21,Tehama,103,63373,0,0,0,0,0
2020-02-21,Trinity,105,12862,0,0,0,0,0
2020-02-21,Tulare,107,460477,2,0,0,0,0
2020-02-21,Tuolumne,109,53932,0,0,0,0,0
2020-02-21,Ventura,111,848112,4,0,0,0,0
2020-02-21,Yolo,113,214977,0,0,0,0,0
2020-02-21,Yuba,115,75493,0,0,0,0,0
2020-02-20,Alameda,001,1643700,7,0,0,0,0
2020-02-20,Alpine,003,1148,0,0,0,0,0
2020-02-20,Amador,005,37829,0,0,0,0,0
2020-02-20,Butte,007,227075,0,0,0,0,0
2020-02-20,Calaveras,009,45235,0,0,0,0,0
2020-02-20,Colusa,011,21464,0,0,0,0,0
2020-02-20,Contra Costa,013,1133247,3,0,0,0,0
2020-02-20,Del Norte,015,27424,0,0,0,0,0
2020-02-20,El Dorado,017,186661,0,0,0,0,0
2020-02-20,Fresno,019,978130,1,0,0,0,0
2020-02-20,Glenn,021,27897,0,0,0,0,0
2020-02-20,Humboldt,023,135768,1,1,0,1,0
2020-02-20,Imperial,025,180216,0,0,0,0,0
2020-02-20,Inyo,027,18085,0,0,0,0,0
2020-02-20,Kern,029,883053,2,0,0,0,0
2020-02-20,Kings,031,150075,3,0,1,1,0
2020-02-20,Lake,033,64148,0,0,0,0,0
2020-02-20,Lassen,035,31185,0,0,0,0,0
2020-02-20,Los Angeles,037,10098052,57,1,5,6,0
2020-02-20,Madera,039,155013,0,0,0,0,0
2020-02-20,Marin,041,260295,0,0,0,0,0
2020-02-20,Mariposa,043,17540,0,0,0,0,0
2020-02-20,Mendocino,045,87422,0,0,0,0,0
2020-02-20,Merced,047,269075,0,0,0,0,0
2020-02-20,Modoc,049,8938,0,0,0,0,0
2020-02-20,Mono,051,14174,0,0,0,0,0
2020-02-20,Monterey,053,433212,1,0,0,0,0
2020-02-20,Napa,055,140530,0,0,0,0,0
2020-02-20,Nevada,057,99092,0,0,1,1,0
2020-02-20,Orange,059,3164182,41,1,0,1,0
2020-02-20,Placer,061,380077,2,0,0,0,0
2020-02-20,Plumas,063,18699,0,0,0,0,0
2020-02-20,Riverside,065,2383286,7,0,0,0,0
2020-02-20,Sacramento,067,1510023,2,1,0,1,0
2020-02-20,San Benito,069,59416,0,2,0,2,0
2020-02-20,San Bernardino,071,2135413,15,0,0,0,0
2020-02-20,San Diego,073,3302833,5,2,0,2,0
2020-02-20,San Francisco,075,870044,3,0,0,0,0
2020-02-20,San Joaquin,077,732212,2,0,1,1,0
2020-02-20,San Luis Obispo,079,281455,2,0,0,0,0
2020-02-20,San Mateo,081,765935,7,0,0,0,0
2020-02-20,Santa Barbara,083,443738,0,0,0,0,0
2020-02-20,Santa Clara,085,1922200,17,2,1,3,0
2020-02-20,Santa Cruz,087,273765,2,0,0,0,0
2020-02-20,Shasta,089,179085,0,0,0,0,0
2020-02-20,Sierra,091,2930,0,0,0,0,0
2020-02-20,Siskiyou,093,43540,0,0,0,0,0
2020-02-20,Solano,095,438530,8,7,0,7,0
2020-02-20,Sonoma,097,501317,2,0,0,0,0
2020-02-20,Stanislaus,099,539301,2,0,2,2,0
2020-02-20,Sutter,101,95872,0,0,0,0,0
2020-02-20,Tehama,103,63373,0,0,0,0,0
2020-02-20,Trinity,105,12862,0,0,0,0,0
2020-02-20,Tulare,107,460477,2,0,0,0,0
2020-02-20,Tuolumne,109,53932,0,0,0,0,0
2020-02-20,Ventura,111,848112,4,0,0,0,0
2020-02-20,Yolo,113,214977,0,0,0,0,0
2020-02-20,Yuba,115,75493,0,0,0,0,0
2020-02-19,Alameda,001,1643700,6,0,0,0,0
2020-02-19,Alpine,003,1148,0,0,0,0,0
2020-02-19,Amador,005,37829,0,0,0,0,0
2020-02-19,Butte,007,227075,0,0,0,0,0
2020-02-19,Calaveras,009,45235,0,0,0,0,0
2020-02-19,Colusa,011,21464,0,0,0,0,0
2020-02-19,Contra Costa,013,1133247,3,0,0,0,0
2020-02-19,Del Norte,015,27424,0,0,0,0,0
2020-02-19,El Dorado,017,186661,0,0,0,0,0
2020-02-19,Fresno,019,978130,1,0,0,0,0
2020-02-19,Glenn,021,27897,0,0,0,0,0
2020-02-19,Humboldt,023,135768,1,0,0,0,0
2020-02-19,Imperial,025,180216,0,0,0,0,0
2020-02-19,Inyo,027,18085,0,0,0,0,0
2020-02-19,Kern,029,883053,2,0,0,0,0
2020-02-19,Kings,031,150075,3,0,1,1,0
2020-02-19,Lake,033,64148,0,0,0,0,0
2020-02-19,Lassen,035,31185,0,0,0,0,0
2020-02-19,Los Angeles,037,10098052,54,1,5,6,0
2020-02-19,Madera,039,155013,0,0,0,0,0
2020-02-19,Marin,041,260295,0,0,0,0,0
2020-02-19,Mariposa,043,17540,0,0,0,0,0
2020-02-19,Mendocino,045,87422,0,0,0,0,0
2020-02-19,Merced,047,269075,0,0,0,0,0
2020-02-19,Modoc,049,8938,0,0,0,0,0
2020-02-19,Mono,051,14174,0,0,0,0,0
2020-02-19,Monterey,053,433212,1,0,0,0,0
2020-02-19,Napa,055,140530,0,0,0,0,0
2020-02-19,Nevada,057,99092,0,0,1,1,0
2020-02-19,Orange,059,3164182,40,1,0,1,0
2020-02-19,Placer,061,380077,2,0,0,0,0
2020-02-19,Plumas,063,18699,0,0,0,0,0
2020-02-19,Riverside,065,2383286,5,0,0,0,0
2020-02-19,Sacramento,067,1510023,2,0,0,0,0
2020-02-19,San Benito,069,59416,0,2,0,2,0
2020-02-19,San Bernardino,071,2135413,14,0,0,0,0
2020-02-19,San Diego,073,3302833,4,2,0,2,0
2020-02-19,San Francisco,075,870044,2,0,0,0,0
2020-02-19,San Joaquin,077,732212,2,0,1,1,0
2020-02-19,San Luis Obispo,079,281455,2,0,0,0,0
2020-02-19,San Mateo,081,765935,6,0,0,0,0
2020-02-19,Santa Barbara,083,443738,0,0,0,0,0
2020-02-19,Santa Clara,085,1922200,15,2,1,3,0
2020-02-19,Santa Cruz,087,273765,0,0,0,0,0
2020-02-19,Shasta,089,179085,0,0,0,0,0
2020-02-19,Sierra,091,2930,0,0,0,0,0
2020-02-19,Siskiyou,093,43540,0,0,0,0,0
2020-02-19,Solano,095,438530,5,7,0,7,0
2020-02-19,Sonoma,097,501317,2,0,0,0,0
2020-02-19,Stanislaus,099,539301,1,0,2,2,0
2020-02-19,Sutter,101,95872,0,0,0,0,0
2020-02-19,Tehama,103,63373,0,0,0,0,0
2020-02-19,Trinity,105,12862,0,0,0,0,0
2020-02-19,Tulare,107,460477,2,0,0,0,0
2020-02-19,Tuolumne,109,53932,0,0,0,0,0
2020-02-19,Ventura,111,848112,2,0,0,0,0
2020-02-19,Yolo,113,214977,0,0,0,0,0
2020-02-19,Yuba,115,75493,0,0,0,0,0
2020-02-18,Alameda,001,1643700,6,0,0,0,0
2020-02-18,Alpine,003,1148,0,0,0,0,0
2020-02-18,Amador,005,37829,0,0,0,0,0
2020-02-18,Butte,007,227075,0,0,0,0,0
2020-02-18,Calaveras,009,45235,0,0,0,0,0
2020-02-18,Colusa,011,21464,0,0,0,0,0
2020-02-18,Contra Costa,013,1133247,3,0,0,0,0
2020-02-18,Del Norte,015,27424,0,0,0,0,0
2020-02-18,El Dorado,017,186661,0,0,0,0,0
2020-02-18,Fresno,019,978130,0,0,0,0,0
2020-02-18,Glenn,021,27897,0,0,0,0,0
2020-02-18,Humboldt,023,135768,1,0,0,0,0
2020-02-18,Imperial,025,180216,0,0,0,0,0
2020-02-18,Inyo,027,18085,0,0,0,0,0
2020-02-18,Kern,029,883053,2,0,0,0,0
2020-02-18,Kings,031,150075,3,0,1,1,0
2020-02-18,Lake,033,64148,0,0,0,0,0
2020-02-18,Lassen,035,31185,0,0,0,0,0
2020-02-18,Los Angeles,037,10098052,51,1,4,5,0
2020-02-18,Madera,039,155013,0,0,0,0,0
2020-02-18,Marin,041,260295,0,0,0,0,0
2020-02-18,Mariposa,043,17540,0,0,0,0,0
2020-02-18,Mendocino,045,87422,0,0,0,0,0
2020-02-18,Merced,047,269075,0,0,0,0,0
2020-02-18,Modoc,049,8938,0,0,0,0,0
2020-02-18,Mono,051,14174,0,0,0,0,0
2020-02-18,Monterey,053,433212,1,0,0,0,0
2020-02-18,Napa,055,140530,0,0,0,0,0
2020-02-18,Nevada,057,99092,0,0,1,1,0
2020-02-18,Orange,059,3164182,39,1,0,1,0
2020-02-18,Placer,061,380077,0,0,0,0,0
2020-02-18,Plumas,063,18699,0,0,0,0,0
2020-02-18,Riverside,065,2383286,5,0,0,0,0
2020-02-18,Sacramento,067,1510023,2,0,0,0,0
2020-02-18,San Benito,069,59416,0,2,0,2,0
2020-02-18,San Bernardino,071,2135413,13,0,0,0,0
2020-02-18,San Diego,073,3302833,4,2,0,2,0
2020-02-18,San Francisco,075,870044,2,0,0,0,0
2020-02-18,San Joaquin,077,732212,1,0,1,1,0
2020-02-18,San Luis Obispo,079,281455,2,0,0,0,0
2020-02-18,San Mateo,081,765935,5,0,0,0,0
2020-02-18,Santa Barbara,083,443738,0,0,0,0,0
2020-02-18,Santa Clara,085,1922200,14,2,1,3,0
2020-02-18,Santa Cruz,087,273765,0,0,0,0,0
2020-02-18,Shasta,089,179085,0,0,0,0,0
2020-02-18,Sierra,091,2930,0,0,0,0,0
2020-02-18,Siskiyou,093,43540,0,0,0,0,0
2020-02-18,Solano,095,438530,5,7,0,7,0
2020-02-18,Sonoma,097,501317,1,0,0,0,0
2020-02-18,Stanislaus,099,539301,1,0,2,2,0
2020-02-18,Sutter,101,95872,0,0,0,0,0
2020-02-18,Tehama,103,63373,0,0,0,0,0
2020-02-18,Trinity,105,12862,0,0,0,0,0
2020-02-18,Tulare,107,460477,2,0,0,0,0
2020-02-18,Tuolumne,109,53932,0,0,0,0,0
2020-02-18,Ventura,111,848112,2,0,0,0,0
2020-02-18,Yolo,113,214977,0,0,0,0,0
2020-02-18,Yuba,115,75493,0,0,0,0,0
2020-02-17,Alameda,001,1643700,6,0,0,0,0
2020-02-17,Alpine,003,1148,0,0,0,0,0
2020-02-17,Amador,005,37829,0,0,0,0,0
2020-02-17,Butte,007,227075,0,0,0,0,0
2020-02-17,Calaveras,009,45235,0,0,0,0,0
2020-02-17,Colusa,011,21464,0,0,0,0,0
2020-02-17,Contra Costa,013,1133247,3,0,0,0,0
2020-02-17,Del Norte,015,27424,0,0,0,0,0
2020-02-17,El Dorado,017,186661,0,0,0,0,0
2020-02-17,Fresno,019,978130,0,0,0,0,0
2020-02-17,Glenn,021,27897,0,0,0,0,0
2020-02-17,Humboldt,023,135768,1,0,0,0,0
2020-02-17,Imperial,025,180216,0,0,0,0,0
2020-02-17,Inyo,027,18085,0,0,0,0,0
2020-02-17,Kern,029,883053,2,0,0,0,0
2020-02-17,Kings,031,150075,3,0,0,0,0
2020-02-17,Lake,033,64148,0,0,0,0,0
2020-02-17,Lassen,035,31185,0,0,0,0,0
2020-02-17,Los Angeles,037,10098052,48,1,4,5,0
2020-02-17,Madera,039,155013,0,0,0,0,0
2020-02-17,Marin,041,260295,0,0,0,0,0
2020-02-17,Mariposa,043,17540,0,0,0,0,0
2020-02-17,Mendocino,045,87422,0,0,0,0,0
2020-02-17,Merced,047,269075,0,0,0,0,0
2020-02-17,Modoc,049,8938,0,0,0,0,0
2020-02-17,Mono,051,14174,0,0,0,0,0
2020-02-17,Monterey,053,433212,1,0,0,0,0
2020-02-17,Napa,055,140530,0,0,0,0,0
2020-02-17,Nevada,057,99092,0,0,1,1,0
2020-02-17,Orange,059,3164182,39,1,0,1,0
2020-02-17,Placer,061,380077,0,0,0,0,0
2020-02-17,Plumas,063,18699,0,0,0,0,0
2020-02-17,Riverside,065,2383286,5,0,0,0,0
2020-02-17,Sacramento,067,1510023,2,0,0,0,0
2020-02-17,San Benito,069,59416,0,2,0,2,0
2020-02-17,San Bernardino,071,2135413,11,0,0,0,0
2020-02-17,San Diego,073,3302833,4,2,0,2,0
2020-02-17,San Francisco,075,870044,2,0,0,0,0
2020-02-17,San Joaquin,077,732212,1,0,1,1,0
2020-02-17,San Luis Obispo,079,281455,1,0,0,0,0
2020-02-17,San Mateo,081,765935,5,0,0,0,0
2020-02-17,Santa Barbara,083,443738,0,0,0,0,0
2020-02-17,Santa Clara,085,1922200,12,2,1,3,0
2020-02-17,Santa Cruz,087,273765,0,0,0,0,0
2020-02-17,Shasta,089,179085,0,0,0,0,0
2020-02-17,Sierra,091,2930,0,0,0,0,0
2020-02-17,Siskiyou,093,43540,0,0,0,0,0
2020-02-17,Solano,095,438530,3,5,0,5,0
2020-02-17,Sonoma,097,501317,1,0,0,0,0
2020-02-17,Stanislaus,099,539301,1,0,2,2,0
2020-02-17,Sutter,101,95872,0,0,0,0,0
2020-02-17,Tehama,103,63373,0,0,0,0,0
2020-02-17,Trinity,105,12862,0,0,0,0,0
2020-02-17,Tulare,107,460477,2,0,0,0,0
2020-02-17,Tuolumne,109,53932,0,0,0,0,0
2020-02-17,Ventura,111,848112,2,0,0,0,0
2020-02-17,Yolo,113,214977,0,0,0,0,0
2020-02-17,Yuba,115,75493,0,0,0,0,0
2020-02-16,Alameda,001,1643700,5,0,0,0,0
2020-02-16,Alpine,003,1148,0,0,0,0,0
2020-02-16,Amador,005,37829,0,0,0,0,0
2020-02-16,Butte,007,227075,0,0,0,0,0
2020-02-16,Calaveras,009,45235,0,0,0,0,0
2020-02-16,Colusa,011,21464,0,0,0,0,0
2020-02-16,Contra Costa,013,1133247,3,0,0,0,0
2020-02-16,Del Norte,015,27424,0,0,0,0,0
2020-02-16,El Dorado,017,186661,0,0,0,0,0
2020-02-16,Fresno,019,978130,0,0,0,0,0
2020-02-16,Glenn,021,27897,0,0,0,0,0
2020-02-16,Humboldt,023,135768,1,0,0,0,0
2020-02-16,Imperial,025,180216,0,0,0,0,0
2020-02-16,Inyo,027,18085,0,0,0,0,0
2020-02-16,Kern,029,883053,2,0,0,0,0
2020-02-16,Kings,031,150075,3,0,0,0,0
2020-02-16,Lake,033,64148,0,0,0,0,0
2020-02-16,Lassen,035,31185,0,0,0,0,0
2020-02-16,Los Angeles,037,10098052,42,1,4,5,0
2020-02-16,Madera,039,155013,0,0,0,0,0
2020-02-16,Marin,041,260295,0,0,0,0,0
2020-02-16,Mariposa,043,17540,0,0,0,0,0
2020-02-16,Mendocino,045,87422,0,0,0,0,0
2020-02-16,Merced,047,269075,0,0,0,0,0
2020-02-16,Modoc,049,8938,0,0,0,0,0
2020-02-16,Mono,051,14174,0,0,0,0,0
2020-02-16,Monterey,053,433212,1,0,0,0,0
2020-02-16,Napa,055,140530,0,0,0,0,0
2020-02-16,Nevada,057,99092,0,0,0,0,0
2020-02-16,Orange,059,3164182,38,1,0,1,0
2020-02-16,Placer,061,380077,0,0,0,0,0
2020-02-16,Plumas,063,18699,0,0,0,0,0
2020-02-16,Riverside,065,2383286,5,0,0,0,0
2020-02-16,Sacramento,067,1510023,2,0,0,0,0
2020-02-16,San Benito,069,59416,0,2,0,2,0
2020-02-16,San Bernardino,071,2135413,10,0,0,0,0
2020-02-16,San Diego,073,3302833,4,2,0,2,0
2020-02-16,San Francisco,075,870044,2,0,0,0,0
2020-02-16,San Joaquin,077,732212,1,0,1,1,0
2020-02-16,San Luis Obispo,079,281455,1,0,0,0,0
2020-02-16,San Mateo,081,765935,4,0,0,0,0
2020-02-16,Santa Barbara,083,443738,0,0,0,0,0
2020-02-16,Santa Clara,085,1922200,10,2,1,3,0
2020-02-16,Santa Cruz,087,273765,0,0,0,0,0
2020-02-16,Shasta,089,179085,0,0,0,0,0
2020-02-16,Sierra,091,2930,0,0,0,0,0
2020-02-16,Siskiyou,093,43540,0,0,0,0,0
2020-02-16,Solano,095,438530,1,0,0,0,0
2020-02-16,Sonoma,097,501317,1,0,0,0,0
2020-02-16,Stanislaus,099,539301,1,0,2,2,0
2020-02-16,Sutter,101,95872,0,0,0,0,0
2020-02-16,Tehama,103,63373,0,0,0,0,0
2020-02-16,Trinity,105,12862,0,0,0,0,0
2020-02-16,Tulare,107,460477,2,0,0,0,0
2020-02-16,Tuolumne,109,53932,0,0,0,0,0
2020-02-16,Ventura,111,848112,2,0,0,0,0
2020-02-16,Yolo,113,214977,0,0,0,0,0
2020-02-16,Yuba,115,75493,0,0,0,0,0
2020-02-15,Alameda,001,1643700,5,0,0,0,0
2020-02-15,Alpine,003,1148,0,0,0,0,0
2020-02-15,Amador,005,37829,0,0,0,0,0
2020-02-15,Butte,007,227075,0,0,0,0,0
2020-02-15,Calaveras,009,45235,0,0,0,0,0
2020-02-15,Colusa,011,21464,0,0,0,0,0
2020-02-15,Contra Costa,013,1133247,3,0,0,0,0
2020-02-15,Del Norte,015,27424,0,0,0,0,0
2020-02-15,El Dorado,017,186661,0,0,0,0,0
2020-02-15,Fresno,019,978130,0,0,0,0,0
2020-02-15,Glenn,021,27897,0,0,0,0,0
2020-02-15,Humboldt,023,135768,1,0,0,0,0
2020-02-15,Imperial,025,180216,0,0,0,0,0
2020-02-15,Inyo,027,18085,0,0,0,0,0
2020-02-15,Kern,029,883053,2,0,0,0,0
2020-02-15,Kings,031,150075,3,0,0,0,0
2020-02-15,Lake,033,64148,0,0,0,0,0
2020-02-15,Lassen,035,31185,0,0,0,0,0
2020-02-15,Los Angeles,037,10098052,39,1,4,5,0
2020-02-15,Madera,039,155013,0,0,0,0,0
2020-02-15,Marin,041,260295,0,0,0,0,0
2020-02-15,Mariposa,043,17540,0,0,0,0,0
2020-02-15,Mendocino,045,87422,0,0,0,0,0
2020-02-15,Merced,047,269075,0,0,0,0,0
2020-02-15,Modoc,049,8938,0,0,0,0,0
2020-02-15,Mono,051,14174,0,0,0,0,0
2020-02-15,Monterey,053,433212,1,0,0,0,0
2020-02-15,Napa,055,140530,0,0,0,0,0
2020-02-15,Nevada,057,99092,0,0,0,0,0
2020-02-15,Orange,059,3164182,37,1,0,1,0
2020-02-15,Placer,061,380077,0,0,0,0,0
2020-02-15,Plumas,063,18699,0,0,0,0,0
2020-02-15,Riverside,065,2383286,4,0,0,0,0
2020-02-15,Sacramento,067,1510023,2,0,0,0,0
2020-02-15,San Benito,069,59416,0,2,0,2,0
2020-02-15,San Bernardino,071,2135413,9,0,0,0,0
2020-02-15,San Diego,073,3302833,4,2,0,2,0
2020-02-15,San Francisco,075,870044,2,0,0,0,0
2020-02-15,San Joaquin,077,732212,1,0,1,1,0
2020-02-15,San Luis Obispo,079,281455,1,0,0,0,0
2020-02-15,San Mateo,081,765935,4,0,0,0,0
2020-02-15,Santa Barbara,083,443738,0,0,0,0,0
2020-02-15,Santa Clara,085,1922200,10,2,1,3,0
2020-02-15,Santa Cruz,087,273765,0,0,0,0,0
2020-02-15,Shasta,089,179085,0,0,0,0,0
2020-02-15,Sierra,091,2930,0,0,0,0,0
2020-02-15,Siskiyou,093,43540,0,0,0,0,0
2020-02-15,Solano,095,438530,1,0,0,0,0
2020-02-15,Sonoma,097,501317,0,0,0,0,0
2020-02-15,Stanislaus,099,539301,1,0,2,2,0
2020-02-15,Sutter,101,95872,0,0,0,0,0
2020-02-15,Tehama,103,63373,0,0,0,0,0
2020-02-15,Trinity,105,12862,0,0,0,0,0
2020-02-15,Tulare,107,460477,2,0,0,0,0
2020-02-15,Tuolumne,109,53932,0,0,0,0,0
2020-02-15,Ventura,111,848112,2,0,0,0,0
2020-02-15,Yolo,113,214977,0,0,0,0,0
2020-02-15,Yuba,115,75493,0,0,0,0,0
2020-02-14,Alameda,001,1643700,4,0,0,0,0
2020-02-14,Alpine,003,1148,0,0,0,0,0
2020-02-14,Amador,005,37829,0,0,0,0,0
2020-02-14,Butte,007,227075,0,0,0,0,0
2020-02-14,Calaveras,009,45235,0,0,0,0,0
2020-02-14,Colusa,011,21464,0,0,0,0,0
2020-02-14,Contra Costa,013,1133247,3,0,0,0,0
2020-02-14,Del Norte,015,27424,0,0,0,0,0
2020-02-14,El Dorado,017,186661,0,0,0,0,0
2020-02-14,Fresno,019,978130,0,0,0,0,0
2020-02-14,Glenn,021,27897,0,0,0,0,0
2020-02-14,Humboldt,023,135768,1,0,0,0,0
2020-02-14,Imperial,025,180216,0,0,0,0,0
2020-02-14,Inyo,027,18085,0,0,0,0,0
2020-02-14,Kern,029,883053,2,0,0,0,0
2020-02-14,Kings,031,150075,1,0,0,0,0
2020-02-14,Lake,033,64148,0,0,0,0,0
2020-02-14,Lassen,035,31185,0,0,0,0,0
2020-02-14,Los Angeles,037,10098052,34,1,4,5,0
2020-02-14,Madera,039,155013,0,0,0,0,0
2020-02-14,Marin,041,260295,0,0,0,0,0
2020-02-14,Mariposa,043,17540,0,0,0,0,0
2020-02-14,Mendocino,045,87422,0,0,0,0,0
2020-02-14,Merced,047,269075,0,0,0,0,0
2020-02-14,Modoc,049,8938,0,0,0,0,0
2020-02-14,Mono,051,14174,0,0,0,0,0
2020-02-14,Monterey,053,433212,1,0,0,0,0
2020-02-14,Napa,055,140530,0,0,0,0,0
2020-02-14,Nevada,057,99092,0,0,0,0,0
2020-02-14,Orange,059,3164182,37,1,0,1,0
2020-02-14,Placer,061,380077,0,0,0,0,0
2020-02-14,Plumas,063,18699,0,0,0,0,0
2020-02-14,Riverside,065,2383286,4,0,0,0,0
2020-02-14,Sacramento,067,1510023,1,0,0,0,0
2020-02-14,San Benito,069,59416,0,2,0,2,0
2020-02-14,San Bernardino,071,2135413,9,0,0,0,0
2020-02-14,San Diego,073,3302833,3,2,0,2,0
2020-02-14,San Francisco,075,870044,2,0,0,0,0
2020-02-14,San Joaquin,077,732212,1,0,1,1,0
2020-02-14,San Luis Obispo,079,281455,0,0,0,0,0
2020-02-14,San Mateo,081,765935,3,0,0,0,0
2020-02-14,Santa Barbara,083,443738,0,0,0,0,0
2020-02-14,Santa Clara,085,1922200,8,2,1,3,0
2020-02-14,Santa Cruz,087,273765,0,0,0,0,0
2020-02-14,Shasta,089,179085,0,0,0,0,0
2020-02-14,Sierra,091,2930,0,0,0,0,0
2020-02-14,Siskiyou,093,43540,0,0,0,0,0
2020-02-14,Solano,095,438530,1,0,0,0,0
2020-02-14,Sonoma,097,501317,0,0,0,0,0
2020-02-14,Stanislaus,099,539301,1,0,2,2,0
2020-02-14,Sutter,101,95872,0,0,0,0,0
2020-02-14,Tehama,103,63373,0,0,0,0,0
2020-02-14,Trinity,105,12862,0,0,0,0,0
2020-02-14,Tulare,107,460477,2,0,0,0,0
2020-02-14,Tuolumne,109,53932,0,0,0,0,0
2020-02-14,Ventura,111,848112,2,0,0,0,0
2020-02-14,Yolo,113,214977,0,0,0,0,0
2020-02-14,Yuba,115,75493,0,0,0,0,0
2020-02-13,Alameda,001,1643700,4,0,0,0,0
2020-02-13,Alpine,003,1148,0,0,0,0,0
2020-02-13,Amador,005,37829,0,0,0,0,0
2020-02-13,Butte,007,227075,0,0,0,0,0
2020-02-13,Calaveras,009,45235,0,0,0,0,0
2020-02-13,Colusa,011,21464,0,0,0,0,0
2020-02-13,Contra Costa,013,1133247,3,0,0,0,0
2020-02-13,Del Norte,015,27424,0,0,0,0,0
2020-02-13,El Dorado,017,186661,0,0,0,0,0
2020-02-13,Fresno,019,978130,0,0,0,0,0
2020-02-13,Glenn,021,27897,0,0,0,0,0
2020-02-13,Humboldt,023,135768,1,0,0,0,0
2020-02-13,Imperial,025,180216,0,0,0,0,0
2020-02-13,Inyo,027,18085,0,0,0,0,0
2020-02-13,Kern,029,883053,2,0,0,0,0
2020-02-13,Kings,031,150075,1,0,0,0,0
2020-02-13,Lake,033,64148,0,0,0,0,0
2020-02-13,Lassen,035,31185,0,0,0,0,0
2020-02-13,Los Angeles,037,10098052,31,1,3,4,0
2020-02-13,Madera,039,155013,0,0,0,0,0
2020-02-13,Marin,041,260295,0,0,0,0,0
2020-02-13,Mariposa,043,17540,0,0,0,0,0
2020-02-13,Mendocino,045,87422,0,0,0,0,0
2020-02-13,Merced,047,269075,0,0,0,0,0
2020-02-13,Modoc,049,8938,0,0,0,0,0
2020-02-13,Mono,051,14174,0,0,0,0,0
2020-02-13,Monterey,053,433212,1,0,0,0,0
2020-02-13,Napa,055,140530,0,0,0,0,0
2020-02-13,Nevada,057,99092,0,0,0,0,0
2020-02-13,Orange,059,3164182,36,1,0,1,0
2020-02-13,Placer,061,380077,0,0,0,0,0
2020-02-13,Plumas,063,18699,0,0,0,0,0
2020-02-13,Riverside,065,2383286,4,0,0,0,0
2020-02-13,Sacramento,067,1510023,1,0,0,0,0
2020-02-13,San Benito,069,59416,0,2,0,2,0
2020-02-13,San Bernardino,071,2135413,8,0,0,0,0
2020-02-13,San Diego,073,3302833,2,2,0,2,0
2020-02-13,San Francisco,075,870044,2,0,0,0,0
2020-02-13,San Joaquin,077,732212,1,0,1,1,0
2020-02-13,San Luis Obispo,079,281455,0,0,0,0,0
2020-02-13,San Mateo,081,765935,2,0,0,0,0
2020-02-13,Santa Barbara,083,443738,0,0,0,0,0
2020-02-13,Santa Clara,085,1922200,7,2,0,2,0
2020-02-13,Santa Cruz,087,273765,0,0,0,0,0
2020-02-13,Shasta,089,179085,0,0,0,0,0
2020-02-13,Sierra,091,2930,0,0,0,0,0
2020-02-13,Siskiyou,093,43540,0,0,0,0,0
2020-02-13,Solano,095,438530,0,0,0,0,0
2020-02-13,Sonoma,097,501317,0,0,0,0,0
2020-02-13,Stanislaus,099,539301,1,0,1,1,0
2020-02-13,Sutter,101,95872,0,0,0,0,0
2020-02-13,Tehama,103,63373,0,0,0,0,0
2020-02-13,Trinity,105,12862,0,0,0,0,0
2020-02-13,Tulare,107,460477,2,0,0,0,0
2020-02-13,Tuolumne,109,53932,0,0,0,0,0
2020-02-13,Ventura,111,848112,2,0,0,0,0
2020-02-13,Yolo,113,214977,0,0,0,0,0
2020-02-13,Yuba,115,75493,0,0,0,0,0
2020-02-12,Alameda,001,1643700,4,0,0,0,0
2020-02-12,Alpine,003,1148,0,0,0,0,0
2020-02-12,Amador,005,37829,0,0,0,0,0
2020-02-12,Butte,007,227075,0,0,0,0,0
2020-02-12,Calaveras,009,45235,0,0,0,0,0
2020-02-12,Colusa,011,21464,0,0,0,0,0
2020-02-12,Contra Costa,013,1133247,3,0,0,0,0
2020-02-12,Del Norte,015,27424,0,0,0,0,0
2020-02-12,El Dorado,017,186661,0,0,0,0,0
2020-02-12,Fresno,019,978130,0,0,0,0,0
2020-02-12,Glenn,021,27897,0,0,0,0,0
2020-02-12,Humboldt,023,135768,1,0,0,0,0
2020-02-12,Imperial,025,180216,0,0,0,0,0
2020-02-12,Inyo,027,18085,0,0,0,0,0
2020-02-12,Kern,029,883053,2,0,0,0,0
2020-02-12,Kings,031,150075,1,0,0,0,0
2020-02-12,Lake,033,64148,0,0,0,0,0
2020-02-12,Lassen,035,31185,0,0,0,0,0
2020-02-12,Los Angeles,037,10098052,30,1,3,4,0
2020-02-12,Madera,039,155013,0,0,0,0,0
2020-02-12,Marin,041,260295,0,0,0,0,0
2020-02-12,Mariposa,043,17540,0,0,0,0,0
2020-02-12,Mendocino,045,87422,0,0,0,0,0
2020-02-12,Merced,047,269075,0,0,0,0,0
2020-02-12,Modoc,049,8938,0,0,0,0,0
2020-02-12,Mono,051,14174,0,0,0,0,0
2020-02-12,Monterey,053,433212,1,0,0,0,0
2020-02-12,Napa,055,140530,0,0,0,0,0
2020-02-12,Nevada,057,99092,0,0,0,0,0
2020-02-12,Orange,059,3164182,36,1,0,1,0
2020-02-12,Placer,061,380077,0,0,0,0,0
2020-02-12,Plumas,063,18699,0,0,0,0,0
2020-02-12,Riverside,065,2383286,4,0,0,0,0
2020-02-12,Sacramento,067,1510023,1,0,0,0,0
2020-02-12,San Benito,069,59416,0,2,0,2,0
2020-02-12,San Bernardino,071,2135413,8,0,0,0,0
2020-02-12,San Diego,073,3302833,2,2,0,2,0
2020-02-12,San Francisco,075,870044,2,0,0,0,0
2020-02-12,San Joaquin,077,732212,1,0,1,1,0
2020-02-12,San Luis Obispo,079,281455,0,0,0,0,0
2020-02-12,San Mateo,081,765935,2,0,0,0,0
2020-02-12,Santa Barbara,083,443738,0,0,0,0,0
2020-02-12,Santa Clara,085,1922200,6,2,0,2,0
2020-02-12,Santa Cruz,087,273765,0,0,0,0,0
2020-02-12,Shasta,089,179085,0,0,0,0,0
2020-02-12,Sierra,091,2930,0,0,0,0,0
2020-02-12,Siskiyou,093,43540,0,0,0,0,0
2020-02-12,Solano,095,438530,0,0,0,0,0
2020-02-12,Sonoma,097,501317,0,0,0,0,0
2020-02-12,Stanislaus,099,539301,1,0,1,1,0
2020-02-12,Sutter,101,95872,0,0,0,0,0
2020-02-12,Tehama,103,63373,0,0,0,0,0
2020-02-12,Trinity,105,12862,0,0,0,0,0
2020-02-12,Tulare,107,460477,2,0,0,0,0
2020-02-12,Tuolumne,109,53932,0,0,0,0,0
2020-02-12,Ventura,111,848112,2,0,0,0,0
2020-02-12,Yolo,113,214977,0,0,0,0,0
2020-02-12,Yuba,115,75493,0,0,0,0,0
2020-02-11,Alameda,001,1643700,4,0,0,0,0
2020-02-11,Alpine,003,1148,0,0,0,0,0
2020-02-11,Amador,005,37829,0,0,0,0,0
2020-02-11,Butte,007,227075,0,0,0,0,0
2020-02-11,Calaveras,009,45235,0,0,0,0,0
2020-02-11,Colusa,011,21464,0,0,0,0,0
2020-02-11,Contra Costa,013,1133247,3,0,0,0,0
2020-02-11,Del Norte,015,27424,0,0,0,0,0
2020-02-11,El Dorado,017,186661,0,0,0,0,0
2020-02-11,Fresno,019,978130,0,0,0,0,0
2020-02-11,Glenn,021,27897,0,0,0,0,0
2020-02-11,Humboldt,023,135768,1,0,0,0,0
2020-02-11,Imperial,025,180216,0,0,0,0,0
2020-02-11,Inyo,027,18085,0,0,0,0,0
2020-02-11,Kern,029,883053,2,0,0,0,0
2020-02-11,Kings,031,150075,1,0,0,0,0
2020-02-11,Lake,033,64148,0,0,0,0,0
2020-02-11,Lassen,035,31185,0,0,0,0,0
2020-02-11,Los Angeles,037,10098052,30,1,3,4,0
2020-02-11,Madera,039,155013,0,0,0,0,0
2020-02-11,Marin,041,260295,0,0,0,0,0
2020-02-11,Mariposa,043,17540,0,0,0,0,0
2020-02-11,Mendocino,045,87422,0,0,0,0,0
2020-02-11,Merced,047,269075,0,0,0,0,0
2020-02-11,Modoc,049,8938,0,0,0,0,0
2020-02-11,Mono,051,14174,0,0,0,0,0
2020-02-11,Monterey,053,433212,1,0,0,0,0
2020-02-11,Napa,055,140530,0,0,0,0,0
2020-02-11,Nevada,057,99092,0,0,0,0,0
2020-02-11,Orange,059,3164182,35,1,0,1,0
2020-02-11,Placer,061,380077,0,0,0,0,0
2020-02-11,Plumas,063,18699,0,0,0,0,0
2020-02-11,Riverside,065,2383286,4,0,0,0,0
2020-02-11,Sacramento,067,1510023,1,0,0,0,0
2020-02-11,San Benito,069,59416,0,2,0,2,0
2020-02-11,San Bernardino,071,2135413,8,0,0,0,0
2020-02-11,San Diego,073,3302833,2,1,0,1,0
2020-02-11,San Francisco,075,870044,2,0,0,0,0
2020-02-11,San Joaquin,077,732212,0,0,1,1,0
2020-02-11,San Luis Obispo,079,281455,0,0,0,0,0
2020-02-11,San Mateo,081,765935,2,0,0,0,0
2020-02-11,Santa Barbara,083,443738,0,0,0,0,0
2020-02-11,Santa Clara,085,1922200,5,2,0,2,0
2020-02-11,Santa Cruz,087,273765,0,0,0,0,0
2020-02-11,Shasta,089,179085,0,0,0,0,0
2020-02-11,Sierra,091,2930,0,0,0,0,0
2020-02-11,Siskiyou,093,43540,0,0,0,0,0
2020-02-11,Solano,095,438530,0,0,0,0,0
2020-02-11,Sonoma,097,501317,0,0,0,0,0
2020-02-11,Stanislaus,099,539301,1,0,1,1,0
2020-02-11,Sutter,101,95872,0,0,0,0,0
2020-02-11,Tehama,103,63373,0,0,0,0,0
2020-02-11,Trinity,105,12862,0,0,0,0,0
2020-02-11,Tulare,107,460477,2,0,0,0,0
2020-02-11,Tuolumne,109,53932,0,0,0,0,0
2020-02-11,Ventura,111,848112,2,0,0,0,0
2020-02-11,Yolo,113,214977,0,0,0,0,0
2020-02-11,Yuba,115,75493,0,0,0,0,0
2020-02-10,Alameda,001,1643700,4,0,0,0,0
2020-02-10,Alpine,003,1148,0,0,0,0,0
2020-02-10,Amador,005,37829,0,0,0,0,0
2020-02-10,Butte,007,227075,0,0,0,0,0
2020-02-10,Calaveras,009,45235,0,0,0,0,0
2020-02-10,Colusa,011,21464,0,0,0,0,0
2020-02-10,Contra Costa,013,1133247,3,0,0,0,0
2020-02-10,Del Norte,015,27424,0,0,0,0,0
2020-02-10,El Dorado,017,186661,0,0,0,0,0
2020-02-10,Fresno,019,978130,0,0,0,0,0
2020-02-10,Glenn,021,27897,0,0,0,0,0
2020-02-10,Humboldt,023,135768,0,0,0,0,0
2020-02-10,Imperial,025,180216,0,0,0,0,0
2020-02-10,Inyo,027,18085,0,0,0,0,0
2020-02-10,Kern,029,883053,2,0,0,0,0
2020-02-10,Kings,031,150075,1,0,0,0,0
2020-02-10,Lake,033,64148,0,0,0,0,0
2020-02-10,Lassen,035,31185,0,0,0,0,0
2020-02-10,Los Angeles,037,10098052,28,1,3,4,0
2020-02-10,Madera,039,155013,0,0,0,0,0
2020-02-10,Marin,041,260295,0,0,0,0,0
2020-02-10,Mariposa,043,17540,0,0,0,0,0
2020-02-10,Mendocino,045,87422,0,0,0,0,0
2020-02-10,Merced,047,269075,0,0,0,0,0
2020-02-10,Modoc,049,8938,0,0,0,0,0
2020-02-10,Mono,051,14174,0,0,0,0,0
2020-02-10,Monterey,053,433212,1,0,0,0,0
2020-02-10,Napa,055,140530,0,0,0,0,0
2020-02-10,Nevada,057,99092,0,0,0,0,0
2020-02-10,Orange,059,3164182,35,1,0,1,0
2020-02-10,Placer,061,380077,0,0,0,0,0
2020-02-10,Plumas,063,18699,0,0,0,0,0
2020-02-10,Riverside,065,2383286,4,0,0,0,0
2020-02-10,Sacramento,067,1510023,1,0,0,0,0
2020-02-10,San Benito,069,59416,0,2,0,2,0
2020-02-10,San Bernardino,071,2135413,7,0,0,0,0
2020-02-10,San Diego,073,3302833,2,0,0,0,0
2020-02-10,San Francisco,075,870044,2,0,0,0,0
2020-02-10,San Joaquin,077,732212,0,0,1,1,0
2020-02-10,San Luis Obispo,079,281455,0,0,0,0,0
2020-02-10,San Mateo,081,765935,2,0,0,0,0
2020-02-10,Santa Barbara,083,443738,0,0,0,0,0
2020-02-10,Santa Clara,085,1922200,5,2,0,2,0
2020-02-10,Santa Cruz,087,273765,0,0,0,0,0
2020-02-10,Shasta,089,179085,0,0,0,0,0
2020-02-10,Sierra,091,2930,0,0,0,0,0
2020-02-10,Siskiyou,093,43540,0,0,0,0,0
2020-02-10,Solano,095,438530,0,0,0,0,0
2020-02-10,Sonoma,097,501317,0,0,0,0,0
2020-02-10,Stanislaus,099,539301,1,0,0,0,0
2020-02-10,Sutter,101,95872,0,0,0,0,0
2020-02-10,Tehama,103,63373,0,0,0,0,0
2020-02-10,Trinity,105,12862,0,0,0,0,0
2020-02-10,Tulare,107,460477,2,0,0,0,0
2020-02-10,Tuolumne,109,53932,0,0,0,0,0
2020-02-10,Ventura,111,848112,2,0,0,0,0
2020-02-10,Yolo,113,214977,0,0,0,0,0
2020-02-10,Yuba,115,75493,0,0,0,0,0
2020-02-09,Alameda,001,1643700,4,0,0,0,0
2020-02-09,Alpine,003,1148,0,0,0,0,0
2020-02-09,Amador,005,37829,0,0,0,0,0
2020-02-09,Butte,007,227075,0,0,0,0,0
2020-02-09,Calaveras,009,45235,0,0,0,0,0
2020-02-09,Colusa,011,21464,0,0,0,0,0
2020-02-09,Contra Costa,013,1133247,3,0,0,0,0
2020-02-09,Del Norte,015,27424,0,0,0,0,0
2020-02-09,El Dorado,017,186661,0,0,0,0,0
2020-02-09,Fresno,019,978130,0,0,0,0,0
2020-02-09,Glenn,021,27897,0,0,0,0,0
2020-02-09,Humboldt,023,135768,0,0,0,0,0
2020-02-09,Imperial,025,180216,0,0,0,0,0
2020-02-09,Inyo,027,18085,0,0,0,0,0
2020-02-09,Kern,029,883053,2,0,0,0,0
2020-02-09,Kings,031,150075,1,0,0,0,0
2020-02-09,Lake,033,64148,0,0,0,0,0
2020-02-09,Lassen,035,31185,0,0,0,0,0
2020-02-09,Los Angeles,037,10098052,27,1,3,4,0
2020-02-09,Madera,039,155013,0,0,0,0,0
2020-02-09,Marin,041,260295,0,0,0,0,0
2020-02-09,Mariposa,043,17540,0,0,0,0,0
2020-02-09,Mendocino,045,87422,0,0,0,0,0
2020-02-09,Merced,047,269075,0,0,0,0,0
2020-02-09,Modoc,049,8938,0,0,0,0,0
2020-02-09,Mono,051,14174,0,0,0,0,0
2020-02-09,Monterey,053,433212,1,0,0,0,0
2020-02-09,Napa,055,140530,0,0,0,0,0
2020-02-09,Nevada,057,99092,0,0,0,0,0
2020-02-09,Orange,059,3164182,35,1,0,1,0
2020-02-09,Placer,061,380077,0,0,0,0,0
2020-02-09,Plumas,063,18699,0,0,0,0,0
2020-02-09,Riverside,065,2383286,4,0,0,0,0
2020-02-09,Sacramento,067,1510023,0,0,0,0,0
2020-02-09,San Benito,069,59416,0,2,0,2,0
2020-02-09,San Bernardino,071,2135413,7,0,0,0,0
2020-02-09,San Diego,073,3302833,2,0,0,0,0
2020-02-09,San Francisco,075,870044,1,0,0,0,0
2020-02-09,San Joaquin,077,732212,0,0,1,1,0
2020-02-09,San Luis Obispo,079,281455,0,0,0,0,0
2020-02-09,San Mateo,081,765935,2,0,0,0,0
2020-02-09,Santa Barbara,083,443738,0,0,0,0,0
2020-02-09,Santa Clara,085,1922200,4,2,0,2,0
2020-02-09,Santa Cruz,087,273765,0,0,0,0,0
2020-02-09,Shasta,089,179085,0,0,0,0,0
2020-02-09,Sierra,091,2930,0,0,0,0,0
2020-02-09,Siskiyou,093,43540,0,0,0,0,0
2020-02-09,Solano,095,438530,0,0,0,0,0
2020-02-09,Sonoma,097,501317,0,0,0,0,0
2020-02-09,Stanislaus,099,539301,0,0,0,0,0
2020-02-09,Sutter,101,95872,0,0,0,0,0
2020-02-09,Tehama,103,63373,0,0,0,0,0
2020-02-09,Trinity,105,12862,0,0,0,0,0
2020-02-09,Tulare,107,460477,2,0,0,0,0
2020-02-09,Tuolumne,109,53932,0,0,0,0,0
2020-02-09,Ventura,111,848112,1,0,0,0,0
2020-02-09,Yolo,113,214977,0,0,0,0,0
2020-02-09,Yuba,115,75493,0,0,0,0,0
2020-02-08,Alameda,001,1643700,3,0,0,0,0
2020-02-08,Alpine,003,1148,0,0,0,0,0
2020-02-08,Amador,005,37829,0,0,0,0,0
2020-02-08,Butte,007,227075,0,0,0,0,0
2020-02-08,Calaveras,009,45235,0,0,0,0,0
2020-02-08,Colusa,011,21464,0,0,0,0,0
2020-02-08,Contra Costa,013,1133247,2,0,0,0,0
2020-02-08,Del Norte,015,27424,0,0,0,0,0
2020-02-08,El Dorado,017,186661,0,0,0,0,0
2020-02-08,Fresno,019,978130,0,0,0,0,0
2020-02-08,Glenn,021,27897,0,0,0,0,0
2020-02-08,Humboldt,023,135768,0,0,0,0,0
2020-02-08,Imperial,025,180216,0,0,0,0,0
2020-02-08,Inyo,027,18085,0,0,0,0,0
2020-02-08,Kern,029,883053,2,0,0,0,0
2020-02-08,Kings,031,150075,1,0,0,0,0
2020-02-08,Lake,033,64148,0,0,0,0,0
2020-02-08,Lassen,035,31185,0,0,0,0,0
2020-02-08,Los Angeles,037,10098052,24,1,1,2,0
2020-02-08,Madera,039,155013,0,0,0,0,0
2020-02-08,Marin,041,260295,0,0,0,0,0
2020-02-08,Mariposa,043,17540,0,0,0,0,0
2020-02-08,Mendocino,045,87422,0,0,0,0,0
2020-02-08,Merced,047,269075,0,0,0,0,0
2020-02-08,Modoc,049,8938,0,0,0,0,0
2020-02-08,Mono,051,14174,0,0,0,0,0
2020-02-08,Monterey,053,433212,1,0,0,0,0
2020-02-08,Napa,055,140530,0,0,0,0,0
2020-02-08,Nevada,057,99092,0,0,0,0,0
2020-02-08,Orange,059,3164182,35,1,0,1,0
2020-02-08,Placer,061,380077,0,0,0,0,0
2020-02-08,Plumas,063,18699,0,0,0,0,0
2020-02-08,Riverside,065,2383286,4,0,0,0,0
2020-02-08,Sacramento,067,1510023,0,0,0,0,0
2020-02-08,San Benito,069,59416,0,2,0,2,0
2020-02-08,San Bernardino,071,2135413,7,0,0,0,0
2020-02-08,San Diego,073,3302833,1,0,0,0,0
2020-02-08,San Francisco,075,870044,1,0,0,0,0
2020-02-08,San Joaquin,077,732212,0,0,1,1,0
2020-02-08,San Luis Obispo,079,281455,0,0,0,0,0
2020-02-08,San Mateo,081,765935,2,0,0,0,0
2020-02-08,Santa Barbara,083,443738,0,0,0,0,0
2020-02-08,Santa Clara,085,1922200,4,2,0,2,0
2020-02-08,Santa Cruz,087,273765,0,0,0,0,0
2020-02-08,Shasta,089,179085,0,0,0,0,0
2020-02-08,Sierra,091,2930,0,0,0,0,0
2020-02-08,Siskiyou,093,43540,0,0,0,0,0
2020-02-08,Solano,095,438530,0,0,0,0,0
2020-02-08,Sonoma,097,501317,0,0,0,0,0
2020-02-08,Stanislaus,099,539301,0,0,0,0,0
2020-02-08,Sutter,101,95872,0,0,0,0,0
2020-02-08,Tehama,103,63373,0,0,0,0,0
2020-02-08,Trinity,105,12862,0,0,0,0,0
2020-02-08,Tulare,107,460477,2,0,0,0,0
2020-02-08,Tuolumne,109,53932,0,0,0,0,0
2020-02-08,Ventura,111,848112,1,0,0,0,0
2020-02-08,Yolo,113,214977,0,0,0,0,0
2020-02-08,Yuba,115,75493,0,0,0,0,0
2020-02-07,Alameda,001,1643700,3,0,0,0,0
2020-02-07,Alpine,003,1148,0,0,0,0,0
2020-02-07,Amador,005,37829,0,0,0,0,0
2020-02-07,Butte,007,227075,0,0,0,0,0
2020-02-07,Calaveras,009,45235,0,0,0,0,0
2020-02-07,Colusa,011,21464,0,0,0,0,0
2020-02-07,Contra Costa,013,1133247,2,0,0,0,0
2020-02-07,Del Norte,015,27424,0,0,0,0,0
2020-02-07,El Dorado,017,186661,0,0,0,0,0
2020-02-07,Fresno,019,978130,0,0,0,0,0
2020-02-07,Glenn,021,27897,0,0,0,0,0
2020-02-07,Humboldt,023,135768,0,0,0,0,0
2020-02-07,Imperial,025,180216,0,0,0,0,0
2020-02-07,Inyo,027,18085,0,0,0,0,0
2020-02-07,Kern,029,883053,2,0,0,0,0
2020-02-07,Kings,031,150075,1,0,0,0,0
2020-02-07,Lake,033,64148,0,0,0,0,0
2020-02-07,Lassen,035,31185,0,0,0,0,0
2020-02-07,Los Angeles,037,10098052,23,1,0,1,0
2020-02-07,Madera,039,155013,0,0,0,0,0
2020-02-07,Marin,041,260295,0,0,0,0,0
2020-02-07,Mariposa,043,17540,0,0,0,0,0
2020-02-07,Mendocino,045,87422,0,0,0,0,0
2020-02-07,Merced,047,269075,0,0,0,0,0
2020-02-07,Modoc,049,8938,0,0,0,0,0
2020-02-07,Mono,051,14174,0,0,0,0,0
2020-02-07,Monterey,053,433212,1,0,0,0,0
2020-02-07,Napa,055,140530,0,0,0,0,0
2020-02-07,Nevada,057,99092,0,0,0,0,0
2020-02-07,Orange,059,3164182,33,1,0,1,0
2020-02-07,Placer,061,380077,0,0,0,0,0
2020-02-07,Plumas,063,18699,0,0,0,0,0
2020-02-07,Riverside,065,2383286,4,0,0,0,0
2020-02-07,Sacramento,067,1510023,0,0,0,0,0
2020-02-07,San Benito,069,59416,0,2,0,2,0
2020-02-07,San Bernardino,071,2135413,4,0,0,0,0
2020-02-07,San Diego,073,3302833,1,0,0,0,0
2020-02-07,San Francisco,075,870044,1,0,0,0,0
2020-02-07,San Joaquin,077,732212,0,0,1,1,0
2020-02-07,San Luis Obispo,079,281455,0,0,0,0,0
2020-02-07,San Mateo,081,765935,1,0,0,0,0
2020-02-07,Santa Barbara,083,443738,0,0,0,0,0
2020-02-07,Santa Clara,085,1922200,4,2,0,2,0
2020-02-07,Santa Cruz,087,273765,0,0,0,0,0
2020-02-07,Shasta,089,179085,0,0,0,0,0
2020-02-07,Sierra,091,2930,0,0,0,0,0
2020-02-07,Siskiyou,093,43540,0,0,0,0,0
2020-02-07,Solano,095,438530,0,0,0,0,0
2020-02-07,Sonoma,097,501317,0,0,0,0,0
2020-02-07,Stanislaus,099,539301,0,0,0,0,0
2020-02-07,Sutter,101,95872,0,0,0,0,0
2020-02-07,Tehama,103,63373,0,0,0,0,0
2020-02-07,Trinity,105,12862,0,0,0,0,0
2020-02-07,Tulare,107,460477,2,0,0,0,0
2020-02-07,Tuolumne,109,53932,0,0,0,0,0
2020-02-07,Ventura,111,848112,1,0,0,0,0
2020-02-07,Yolo,113,214977,0,0,0,0,0
2020-02-07,Yuba,115,75493,0,0,0,0,0
2020-02-06,Alameda,001,1643700,3,0,0,0,0
2020-02-06,Alpine,003,1148,0,0,0,0,0
2020-02-06,Amador,005,37829,0,0,0,0,0
2020-02-06,Butte,007,227075,0,0,0,0,0
2020-02-06,Calaveras,009,45235,0,0,0,0,0
2020-02-06,Colusa,011,21464,0,0,0,0,0
2020-02-06,Contra Costa,013,1133247,2,0,0,0,0
2020-02-06,Del Norte,015,27424,0,0,0,0,0
2020-02-06,El Dorado,017,186661,0,0,0,0,0
2020-02-06,Fresno,019,978130,0,0,0,0,0
2020-02-06,Glenn,021,27897,0,0,0,0,0
2020-02-06,Humboldt,023,135768,0,0,0,0,0
2020-02-06,Imperial,025,180216,0,0,0,0,0
2020-02-06,Inyo,027,18085,0,0,0,0,0
2020-02-06,Kern,029,883053,2,0,0,0,0
2020-02-06,Kings,031,150075,0,0,0,0,0
2020-02-06,Lake,033,64148,0,0,0,0,0
2020-02-06,Lassen,035,31185,0,0,0,0,0
2020-02-06,Los Angeles,037,10098052,22,1,0,1,0
2020-02-06,Madera,039,155013,0,0,0,0,0
2020-02-06,Marin,041,260295,0,0,0,0,0
2020-02-06,Mariposa,043,17540,0,0,0,0,0
2020-02-06,Mendocino,045,87422,0,0,0,0,0
2020-02-06,Merced,047,269075,0,0,0,0,0
2020-02-06,Modoc,049,8938,0,0,0,0,0
2020-02-06,Mono,051,14174,0,0,0,0,0
2020-02-06,Monterey,053,433212,1,0,0,0,0
2020-02-06,Napa,055,140530,0,0,0,0,0
2020-02-06,Nevada,057,99092,0,0,0,0,0
2020-02-06,Orange,059,3164182,3,1,0,1,0
2020-02-06,Placer,061,380077,0,0,0,0,0
2020-02-06,Plumas,063,18699,0,0,0,0,0
2020-02-06,Riverside,065,2383286,4,0,0,0,0
2020-02-06,Sacramento,067,1510023,0,0,0,0,0
2020-02-06,San Benito,069,59416,0,2,0,2,0
2020-02-06,San Bernardino,071,2135413,4,0,0,0,0
2020-02-06,San Diego,073,3302833,1,0,0,0,0
2020-02-06,San Francisco,075,870044,1,0,0,0,0
2020-02-06,San Joaquin,077,732212,0,0,1,1,0
2020-02-06,San Luis Obispo,079,281455,0,0,0,0,0
2020-02-06,San Mateo,081,765935,1,0,0,0,0
2020-02-06,Santa Barbara,083,443738,0,0,0,0,0
2020-02-06,Santa Clara,085,1922200,4,2,0,2,0
2020-02-06,Santa Cruz,087,273765,0,0,0,0,0
2020-02-06,Shasta,089,179085,0,0,0,0,0
2020-02-06,Sierra,091,2930,0,0,0,0,0
2020-02-06,Siskiyou,093,43540,0,0,0,0,0
2020-02-06,Solano,095,438530,0,0,0,0,0
2020-02-06,Sonoma,097,501317,0,0,0,0,0
2020-02-06,Stanislaus,099,539301,0,0,0,0,0
2020-02-06,Sutter,101,95872,0,0,0,0,0
2020-02-06,Tehama,103,63373,0,0,0,0,0
2020-02-06,Trinity,105,12862,0,0,0,0,0
2020-02-06,Tulare,107,460477,2,0,0,0,0
2020-02-06,Tuolumne,109,53932,0,0,0,0,0
2020-02-06,Ventura,111,848112,1,0,0,0,0
2020-02-06,Yolo,113,214977,0,0,0,0,0
2020-02-06,Yuba,115,75493,0,0,0,0,0
2020-02-05,Alameda,001,1643700,3,0,0,0,0
2020-02-05,Alpine,003,1148,0,0,0,0,0
2020-02-05,Amador,005,37829,0,0,0,0,0
2020-02-05,Butte,007,227075,0,0,0,0,0
2020-02-05,Calaveras,009,45235,0,0,0,0,0
2020-02-05,Colusa,011,21464,0,0,0,0,0
2020-02-05,Contra Costa,013,1133247,2,0,0,0,0
2020-02-05,Del Norte,015,27424,0,0,0,0,0
2020-02-05,El Dorado,017,186661,0,0,0,0,0
2020-02-05,Fresno,019,978130,0,0,0,0,0
2020-02-05,Glenn,021,27897,0,0,0,0,0
2020-02-05,Humboldt,023,135768,0,0,0,0,0
2020-02-05,Imperial,025,180216,0,0,0,0,0
2020-02-05,Inyo,027,18085,0,0,0,0,0
2020-02-05,Kern,029,883053,1,0,0,0,0
2020-02-05,Kings,031,150075,0,0,0,0,0
2020-02-05,Lake,033,64148,0,0,0,0,0
2020-02-05,Lassen,035,31185,0,0,0,0,0
2020-02-05,Los Angeles,037,10098052,22,1,0,1,0
2020-02-05,Madera,039,155013,0,0,0,0,0
2020-02-05,Marin,041,260295,0,0,0,0,0
2020-02-05,Mariposa,043,17540,0,0,0,0,0
2020-02-05,Mendocino,045,87422,0,0,0,0,0
2020-02-05,Merced,047,269075,0,0,0,0,0
2020-02-05,Modoc,049,8938,0,0,0,0,0
2020-02-05,Mono,051,14174,0,0,0,0,0
2020-02-05,Monterey,053,433212,1,0,0,0,0
2020-02-05,Napa,055,140530,0,0,0,0,0
2020-02-05,Nevada,057,99092,0,0,0,0,0
2020-02-05,Orange,059,3164182,1,1,0,1,0
2020-02-05,Placer,061,380077,0,0,0,0,0
2020-02-05,Plumas,063,18699,0,0,0,0,0
2020-02-05,Riverside,065,2383286,4,0,0,0,0
2020-02-05,Sacramento,067,1510023,0,0,0,0,0
2020-02-05,San Benito,069,59416,0,2,0,2,0
2020-02-05,San Bernardino,071,2135413,4,0,0,0,0
2020-02-05,San Diego,073,3302833,0,0,0,0,0
2020-02-05,San Francisco,075,870044,1,0,0,0,0
2020-02-05,San Joaquin,077,732212,0,0,1,1,0
2020-02-05,San Luis Obispo,079,281455,0,0,0,0,0
2020-02-05,San Mateo,081,765935,1,0,0,0,0
2020-02-05,Santa Barbara,083,443738,0,0,0,0,0
2020-02-05,Santa Clara,085,1922200,2,2,0,2,0
2020-02-05,Santa Cruz,087,273765,0,0,0,0,0
2020-02-05,Shasta,089,179085,0,0,0,0,0
2020-02-05,Sierra,091,2930,0,0,0,0,0
2020-02-05,Siskiyou,093,43540,0,0,0,0,0
2020-02-05,Solano,095,438530,0,0,0,0,0
2020-02-05,Sonoma,097,501317,0,0,0,0,0
2020-02-05,Stanislaus,099,539301,0,0,0,0,0
2020-02-05,Sutter,101,95872,0,0,0,0,0
2020-02-05,Tehama,103,63373,0,0,0,0,0
2020-02-05,Trinity,105,12862,0,0,0,0,0
2020-02-05,Tulare,107,460477,2,0,0,0,0
2020-02-05,Tuolumne,109,53932,0,0,0,0,0
2020-02-05,Ventura,111,848112,0,0,0,0,0
2020-02-05,Yolo,113,214977,0,0,0,0,0
2020-02-05,Yuba,115,75493,0,0,0,0,0
2020-02-04,Alameda,001,1643700,3,0,0,0,0
2020-02-04,Alpine,003,1148,0,0,0,0,0
2020-02-04,Amador,005,37829,0,0,0,0,0
2020-02-04,Butte,007,227075,0,0,0,0,0
2020-02-04,Calaveras,009,45235,0,0,0,0,0
2020-02-04,Colusa,011,21464,0,0,0,0,0
2020-02-04,Contra Costa,013,1133247,2,0,0,0,0
2020-02-04,Del Norte,015,27424,0,0,0,0,0
2020-02-04,El Dorado,017,186661,0,0,0,0,0
2020-02-04,Fresno,019,978130,0,0,0,0,0
2020-02-04,Glenn,021,27897,0,0,0,0,0
2020-02-04,Humboldt,023,135768,0,0,0,0,0
2020-02-04,Imperial,025,180216,0,0,0,0,0
2020-02-04,Inyo,027,18085,0,0,0,0,0
2020-02-04,Kern,029,883053,0,0,0,0,0
2020-02-04,Kings,031,150075,0,0,0,0,0
2020-02-04,Lake,033,64148,0,0,0,0,0
2020-02-04,Lassen,035,31185,0,0,0,0,0
2020-02-04,Los Angeles,037,10098052,22,1,0,1,0
2020-02-04,Madera,039,155013,0,0,0,0,0
2020-02-04,Marin,041,260295,0,0,0,0,0
2020-02-04,Mariposa,043,17540,0,0,0,0,0
2020-02-04,Mendocino,045,87422,0,0,0,0,0
2020-02-04,Merced,047,269075,0,0,0,0,0
2020-02-04,Modoc,049,8938,0,0,0,0,0
2020-02-04,Mono,051,14174,0,0,0,0,0
2020-02-04,Monterey,053,433212,1,0,0,0,0
2020-02-04,Napa,055,140530,0,0,0,0,0
2020-02-04,Nevada,057,99092,0,0,0,0,0
2020-02-04,Orange,059,3164182,1,1,0,1,0
2020-02-04,Placer,061,380077,0,0,0,0,0
2020-02-04,Plumas,063,18699,0,0,0,0,0
2020-02-04,Riverside,065,2383286,4,0,0,0,0
2020-02-04,Sacramento,067,1510023,0,0,0,0,0
2020-02-04,San Benito,069,59416,0,2,0,2,0
2020-02-04,San Bernardino,071,2135413,3,0,0,0,0
2020-02-04,San Diego,073,3302833,0,0,0,0,0
2020-02-04,San Francisco,075,870044,1,0,0,0,0
2020-02-04,San Joaquin,077,732212,0,0,1,1,0
2020-02-04,San Luis Obispo,079,281455,0,0,0,0,0
2020-02-04,San Mateo,081,765935,0,0,0,0,0
2020-02-04,Santa Barbara,083,443738,0,0,0,0,0
2020-02-04,Santa Clara,085,1922200,2,2,0,2,0
2020-02-04,Santa Cruz,087,273765,0,0,0,0,0
2020-02-04,Shasta,089,179085,0,0,0,0,0
2020-02-04,Sierra,091,2930,0,0,0,0,0
2020-02-04,Siskiyou,093,43540,0,0,0,0,0
2020-02-04,Solano,095,438530,0,0,0,0,0
2020-02-04,Sonoma,097,501317,0,0,0,0,0
2020-02-04,Stanislaus,099,539301,0,0,0,0,0
2020-02-04,Sutter,101,95872,0,0,0,0,0
2020-02-04,Tehama,103,63373,0,0,0,0,0
2020-02-04,Trinity,105,12862,0,0,0,0,0
2020-02-04,Tulare,107,460477,2,0,0,0,0
2020-02-04,Tuolumne,109,53932,0,0,0,0,0
2020-02-04,Ventura,111,848112,0,0,0,0,0
2020-02-04,Yolo,113,214977,0,0,0,0,0
2020-02-04,Yuba,115,75493,0,0,0,0,0
2020-02-03,Alameda,001,1643700,3,0,0,0,0
2020-02-03,Alpine,003,1148,0,0,0,0,0
2020-02-03,Amador,005,37829,0,0,0,0,0
2020-02-03,Butte,007,227075,0,0,0,0,0
2020-02-03,Calaveras,009,45235,0,0,0,0,0
2020-02-03,Colusa,011,21464,0,0,0,0,0
2020-02-03,Contra Costa,013,1133247,2,0,0,0,0
2020-02-03,Del Norte,015,27424,0,0,0,0,0
2020-02-03,El Dorado,017,186661,0,0,0,0,0
2020-02-03,Fresno,019,978130,0,0,0,0,0
2020-02-03,Glenn,021,27897,0,0,0,0,0
2020-02-03,Humboldt,023,135768,0,0,0,0,0
2020-02-03,Imperial,025,180216,0,0,0,0,0
2020-02-03,Inyo,027,18085,0,0,0,0,0
2020-02-03,Kern,029,883053,0,0,0,0,0
2020-02-03,Kings,031,150075,0,0,0,0,0
2020-02-03,Lake,033,64148,0,0,0,0,0
2020-02-03,Lassen,035,31185,0,0,0,0,0
2020-02-03,Los Angeles,037,10098052,21,1,0,1,0
2020-02-03,Madera,039,155013,0,0,0,0,0
2020-02-03,Marin,041,260295,0,0,0,0,0
2020-02-03,Mariposa,043,17540,0,0,0,0,0
2020-02-03,Mendocino,045,87422,0,0,0,0,0
2020-02-03,Merced,047,269075,0,0,0,0,0
2020-02-03,Modoc,049,8938,0,0,0,0,0
2020-02-03,Mono,051,14174,0,0,0,0,0
2020-02-03,Monterey,053,433212,1,0,0,0,0
2020-02-03,Napa,055,140530,0,0,0,0,0
2020-02-03,Nevada,057,99092,0,0,0,0,0
2020-02-03,Orange,059,3164182,1,1,0,1,0
2020-02-03,Placer,061,380077,0,0,0,0,0
2020-02-03,Plumas,063,18699,0,0,0,0,0
2020-02-03,Riverside,065,2383286,4,0,0,0,0
2020-02-03,Sacramento,067,1510023,0,0,0,0,0
2020-02-03,San Benito,069,59416,0,2,0,2,0
2020-02-03,San Bernardino,071,2135413,3,0,0,0,0
2020-02-03,San Diego,073,3302833,0,0,0,0,0
2020-02-03,San Francisco,075,870044,1,0,0,0,0
2020-02-03,San Joaquin,077,732212,0,0,1,1,0
2020-02-03,San Luis Obispo,079,281455,0,0,0,0,0
2020-02-03,San Mateo,081,765935,0,0,0,0,0
2020-02-03,Santa Barbara,083,443738,0,0,0,0,0
2020-02-03,Santa Clara,085,1922200,2,2,0,2,0
2020-02-03,Santa Cruz,087,273765,0,0,0,0,0
2020-02-03,Shasta,089,179085,0,0,0,0,0
2020-02-03,Sierra,091,2930,0,0,0,0,0
2020-02-03,Siskiyou,093,43540,0,0,0,0,0
2020-02-03,Solano,095,438530,0,0,0,0,0
2020-02-03,Sonoma,097,501317,0,0,0,0,0
2020-02-03,Stanislaus,099,539301,0,0,0,0,0
2020-02-03,Sutter,101,95872,0,0,0,0,0
2020-02-03,Tehama,103,63373,0,0,0,0,0
2020-02-03,Trinity,105,12862,0,0,0,0,0
2020-02-03,Tulare,107,460477,2,0,0,0,0
2020-02-03,Tuolumne,109,53932,0,0,0,0,0
2020-02-03,Ventura,111,848112,0,0,0,0,0
2020-02-03,Yolo,113,214977,0,0,0,0,0
2020-02-03,Yuba,115,75493,0,0,0,0,0
2020-02-02,Alameda,001,1643700,3,0,0,0,0
2020-02-02,Alpine,003,1148,0,0,0,0,0
2020-02-02,Amador,005,37829,0,0,0,0,0
2020-02-02,Butte,007,227075,0,0,0,0,0
2020-02-02,Calaveras,009,45235,0,0,0,0,0
2020-02-02,Colusa,011,21464,0,0,0,0,0
2020-02-02,Contra Costa,013,1133247,1,0,0,0,0
2020-02-02,Del Norte,015,27424,0,0,0,0,0
2020-02-02,El Dorado,017,186661,0,0,0,0,0
2020-02-02,Fresno,019,978130,0,0,0,0,0
2020-02-02,Glenn,021,27897,0,0,0,0,0
2020-02-02,Humboldt,023,135768,0,0,0,0,0
2020-02-02,Imperial,025,180216,0,0,0,0,0
2020-02-02,Inyo,027,18085,0,0,0,0,0
2020-02-02,Kern,029,883053,0,0,0,0,0
2020-02-02,Kings,031,150075,0,0,0,0,0
2020-02-02,Lake,033,64148,0,0,0,0,0
2020-02-02,Lassen,035,31185,0,0,0,0,0
2020-02-02,Los Angeles,037,10098052,17,1,0,1,0
2020-02-02,Madera,039,155013,0,0,0,0,0
2020-02-02,Marin,041,260295,0,0,0,0,0
2020-02-02,Mariposa,043,17540,0,0,0,0,0
2020-02-02,Mendocino,045,87422,0,0,0,0,0
2020-02-02,Merced,047,269075,0,0,0,0,0
2020-02-02,Modoc,049,8938,0,0,0,0,0
2020-02-02,Mono,051,14174,0,0,0,0,0
2020-02-02,Monterey,053,433212,1,0,0,0,0
2020-02-02,Napa,055,140530,0,0,0,0,0
2020-02-02,Nevada,057,99092,0,0,0,0,0
2020-02-02,Orange,059,3164182,1,1,0,1,0
2020-02-02,Placer,061,380077,0,0,0,0,0
2020-02-02,Plumas,063,18699,0,0,0,0,0
2020-02-02,Riverside,065,2383286,3,0,0,0,0
2020-02-02,Sacramento,067,1510023,0,0,0,0,0
2020-02-02,San Benito,069,59416,0,2,0,2,0
2020-02-02,San Bernardino,071,2135413,2,0,0,0,0
2020-02-02,San Diego,073,3302833,0,0,0,0,0
2020-02-02,San Francisco,075,870044,1,0,0,0,0
2020-02-02,San Joaquin,077,732212,0,0,1,1,0
2020-02-02,San Luis Obispo,079,281455,0,0,0,0,0
2020-02-02,San Mateo,081,765935,0,0,0,0,0
2020-02-02,Santa Barbara,083,443738,0,0,0,0,0
2020-02-02,Santa Clara,085,1922200,2,2,0,2,0
2020-02-02,Santa Cruz,087,273765,0,0,0,0,0
2020-02-02,Shasta,089,179085,0,0,0,0,0
2020-02-02,Sierra,091,2930,0,0,0,0,0
2020-02-02,Siskiyou,093,43540,0,0,0,0,0
2020-02-02,Solano,095,438530,0,0,0,0,0
2020-02-02,Sonoma,097,501317,0,0,0,0,0
2020-02-02,Stanislaus,099,539301,0,0,0,0,0
2020-02-02,Sutter,101,95872,0,0,0,0,0
2020-02-02,Tehama,103,63373,0,0,0,0,0
2020-02-02,Trinity,105,12862,0,0,0,0,0
2020-02-02,Tulare,107,460477,2,0,0,0,0
2020-02-02,Tuolumne,109,53932,0,0,0,0,0
2020-02-02,Ventura,111,848112,0,0,0,0,0
2020-02-02,Yolo,113,214977,0,0,0,0,0
2020-02-02,Yuba,115,75493,0,0,0,0,0
2020-02-01,Alameda,001,1643700,3,0,0,0,0
2020-02-01,Alpine,003,1148,0,0,0,0,0
2020-02-01,Amador,005,37829,0,0,0,0,0
2020-02-01,Butte,007,227075,0,0,0,0,0
2020-02-01,Calaveras,009,45235,0,0,0,0,0
2020-02-01,Colusa,011,21464,0,0,0,0,0
2020-02-01,Contra Costa,013,1133247,0,0,0,0,0
2020-02-01,Del Norte,015,27424,0,0,0,0,0
2020-02-01,El Dorado,017,186661,0,0,0,0,0
2020-02-01,Fresno,019,978130,0,0,0,0,0
2020-02-01,Glenn,021,27897,0,0,0,0,0
2020-02-01,Humboldt,023,135768,0,0,0,0,0
2020-02-01,Imperial,025,180216,0,0,0,0,0
2020-02-01,Inyo,027,18085,0,0,0,0,0
2020-02-01,Kern,029,883053,0,0,0,0,0
2020-02-01,Kings,031,150075,0,0,0,0,0
2020-02-01,Lake,033,64148,0,0,0,0,0
2020-02-01,Lassen,035,31185,0,0,0,0,0
2020-02-01,Los Angeles,037,10098052,13,1,0,1,0
2020-02-01,Madera,039,155013,0,0,0,0,0
2020-02-01,Marin,041,260295,0,0,0,0,0
2020-02-01,Mariposa,043,17540,0,0,0,0,0
2020-02-01,Mendocino,045,87422,0,0,0,0,0
2020-02-01,Merced,047,269075,0,0,0,0,0
2020-02-01,Modoc,049,8938,0,0,0,0,0
2020-02-01,Mono,051,14174,0,0,0,0,0
2020-02-01,Monterey,053,433212,0,0,0,0,0
2020-02-01,Napa,055,140530,0,0,0,0,0
2020-02-01,Nevada,057,99092,0,0,0,0,0
2020-02-01,Orange,059,3164182,1,1,0,1,0
2020-02-01,Placer,061,380077,0,0,0,0,0
2020-02-01,Plumas,063,18699,0,0,0,0,0
2020-02-01,Riverside,065,2383286,2,0,0,0,0
2020-02-01,Sacramento,067,1510023,0,0,0,0,0
2020-02-01,San Benito,069,59416,0,0,0,0,0
2020-02-01,San Bernardino,071,2135413,1,0,0,0,0
2020-02-01,San Diego,073,3302833,0,0,0,0,0
2020-02-01,San Francisco,075,870044,1,0,0,0,0
2020-02-01,San Joaquin,077,732212,0,0,1,1,0
2020-02-01,San Luis Obispo,079,281455,0,0,0,0,0
2020-02-01,San Mateo,081,765935,0,0,0,0,0
2020-02-01,Santa Barbara,083,443738,0,0,0,0,0
2020-02-01,Santa Clara,085,1922200,2,1,0,1,0
2020-02-01,Santa Cruz,087,273765,0,0,0,0,0
2020-02-01,Shasta,089,179085,0,0,0,0,0
2020-02-01,Sierra,091,2930,0,0,0,0,0
2020-02-01,Siskiyou,093,43540,0,0,0,0,0
2020-02-01,Solano,095,438530,0,0,0,0,0
2020-02-01,Sonoma,097,501317,0,0,0,0,0
2020-02-01,Stanislaus,099,539301,0,0,0,0,0
2020-02-01,Sutter,101,95872,0,0,0,0,0
2020-02-01,Tehama,103,63373,0,0,0,0,0
2020-02-01,Trinity,105,12862,0,0,0,0,0
2020-02-01,Tulare,107,460477,1,0,0,0,0
2020-02-01,Tuolumne,109,53932,0,0,0,0,0
2020-02-01,Ventura,111,848112,0,0,0,0,0
2020-02-01,Yolo,113,214977,0,0,0,0,0
2020-02-01,Yuba,115,75493,0,0,0,0,0
